,Name,Date,Latitude,Longitude,NB,SB,TotalCount
0,58thStGreenway22ndAve,01/01/2014 12:00:00 AM,48,-122,6,12,18
1,58thStGreenway22ndAve,01/01/2014 01:00:00 AM,48,-122,3,3,6
2,58thStGreenway22ndAve,01/01/2014 02:00:00 AM,48,-122,0,3,3
3,58thStGreenway22ndAve,01/01/2014 03:00:00 AM,48,-122,2,2,4
4,58thStGreenway22ndAve,01/01/2014 04:00:00 AM,48,-122,3,2,5
5,58thStGreenway22ndAve,01/01/2014 05:00:00 AM,48,-122,0,0,0
6,58thStGreenway22ndAve,01/01/2014 06:00:00 AM,48,-122,2,0,2
7,58thStGreenway22ndAve,01/01/2014 07:00:00 AM,48,-122,2,4,6
8,58thStGreenway22ndAve,01/01/2014 08:00:00 AM,48,-122,0,2,2
9,58thStGreenway22ndAve,01/01/2014 09:00:00 AM,48,-122,3,2,5
10,58thStGreenway22ndAve,01/01/2014 10:00:00 AM,48,-122,0,16,16
11,58thStGreenway22ndAve,01/01/2014 11:00:00 AM,48,-122,9,7,16
12,58thStGreenway22ndAve,01/01/2014 12:00:00 PM,48,-122,8,21,29
13,58thStGreenway22ndAve,01/01/2014 01:00:00 PM,48,-122,18,12,30
14,58thStGreenway22ndAve,01/01/2014 02:00:00 PM,48,-122,19,12,31
15,58thStGreenway22ndAve,01/01/2014 03:00:00 PM,48,-122,28,13,41
16,58thStGreenway22ndAve,01/01/2014 04:00:00 PM,48,-122,29,8,37
17,58thStGreenway22ndAve,01/01/2014 05:00:00 PM,48,-122,17,13,30
18,58thStGreenway22ndAve,01/01/2014 06:00:00 PM,48,-122,15,5,20
19,58thStGreenway22ndAve,01/01/2014 07:00:00 PM,48,-122,12,3,15
20,58thStGreenway22ndAve,01/01/2014 08:00:00 PM,48,-122,17,10,27
21,58thStGreenway22ndAve,01/01/2014 09:00:00 PM,48,-122,8,9,17
22,58thStGreenway22ndAve,01/01/2014 10:00:00 PM,48,-122,6,4,10
23,58thStGreenway22ndAve,01/01/2014 11:00:00 PM,48,-122,8,6,14
24,58thStGreenway22ndAve,01/02/2014 12:00:00 AM,48,-122,2,1,3
25,58thStGreenway22ndAve,01/02/2014 01:00:00 AM,48,-122,2,0,2
26,58thStGreenway22ndAve,01/02/2014 02:00:00 AM,48,-122,0,0,0
27,58thStGreenway22ndAve,01/02/2014 03:00:00 AM,48,-122,2,2,4
28,58thStGreenway22ndAve,01/02/2014 04:00:00 AM,48,-122,1,0,1
29,58thStGreenway22ndAve,01/02/2014 05:00:00 AM,48,-122,0,2,2
30,58thStGreenway22ndAve,01/02/2014 06:00:00 AM,48,-122,8,1,9
31,58thStGreenway22ndAve,01/02/2014 07:00:00 AM,48,-122,10,6,16
32,58thStGreenway22ndAve,01/02/2014 08:00:00 AM,48,-122,22,5,27
33,58thStGreenway22ndAve,01/02/2014 09:00:00 AM,48,-122,16,10,26
34,58thStGreenway22ndAve,01/02/2014 10:00:00 AM,48,-122,28,18,46
35,58thStGreenway22ndAve,01/02/2014 11:00:00 AM,48,-122,27,16,43
36,58thStGreenway22ndAve,01/02/2014 12:00:00 PM,48,-122,18,8,26
37,58thStGreenway22ndAve,01/02/2014 01:00:00 PM,48,-122,19,5,24
38,58thStGreenway22ndAve,01/02/2014 02:00:00 PM,48,-122,15,3,18
39,58thStGreenway22ndAve,01/02/2014 03:00:00 PM,48,-122,27,15,42
40,58thStGreenway22ndAve,01/02/2014 04:00:00 PM,48,-122,16,10,26
41,58thStGreenway22ndAve,01/02/2014 05:00:00 PM,48,-122,30,23,53
42,58thStGreenway22ndAve,01/02/2014 06:00:00 PM,48,-122,19,8,27
43,58thStGreenway22ndAve,01/02/2014 07:00:00 PM,48,-122,10,8,18
44,58thStGreenway22ndAve,01/02/2014 08:00:00 PM,48,-122,12,2,14
45,58thStGreenway22ndAve,01/02/2014 09:00:00 PM,48,-122,7,2,9
46,58thStGreenway22ndAve,01/02/2014 10:00:00 PM,48,-122,12,4,16
47,58thStGreenway22ndAve,01/02/2014 11:00:00 PM,48,-122,1,2,3
48,58thStGreenway22ndAve,01/03/2014 12:00:00 AM,48,-122,7,0,7
49,58thStGreenway22ndAve,01/03/2014 01:00:00 AM,48,-122,0,1,1
50,58thStGreenway22ndAve,01/03/2014 02:00:00 AM,48,-122,0,0,0
51,58thStGreenway22ndAve,01/03/2014 03:00:00 AM,48,-122,0,6,6
52,58thStGreenway22ndAve,01/03/2014 04:00:00 AM,48,-122,0,0,0
53,58thStGreenway22ndAve,01/03/2014 05:00:00 AM,48,-122,2,2,4
54,58thStGreenway22ndAve,01/03/2014 06:00:00 AM,48,-122,2,2,4
55,58thStGreenway22ndAve,01/03/2014 07:00:00 AM,48,-122,8,3,11
56,58thStGreenway22ndAve,01/03/2014 08:00:00 AM,48,-122,17,10,27
57,58thStGreenway22ndAve,01/03/2014 09:00:00 AM,48,-122,31,9,40
58,58thStGreenway22ndAve,01/03/2014 10:00:00 AM,48,-122,25,14,39
59,58thStGreenway22ndAve,01/03/2014 11:00:00 AM,48,-122,28,12,40
60,58thStGreenway22ndAve,01/03/2014 12:00:00 PM,48,-122,22,17,39
61,58thStGreenway22ndAve,01/03/2014 01:00:00 PM,48,-122,25,26,51
62,58thStGreenway22ndAve,01/03/2014 02:00:00 PM,48,-122,19,23,42
63,58thStGreenway22ndAve,01/03/2014 03:00:00 PM,48,-122,30,20,50
64,58thStGreenway22ndAve,01/03/2014 04:00:00 PM,48,-122,26,26,52
65,58thStGreenway22ndAve,01/03/2014 05:00:00 PM,48,-122,22,23,45
66,58thStGreenway22ndAve,01/03/2014 06:00:00 PM,48,-122,27,22,49
67,58thStGreenway22ndAve,01/03/2014 07:00:00 PM,48,-122,16,7,23
68,58thStGreenway22ndAve,01/03/2014 08:00:00 PM,48,-122,14,2,16
69,58thStGreenway22ndAve,01/03/2014 09:00:00 PM,48,-122,12,2,14
70,58thStGreenway22ndAve,01/03/2014 10:00:00 PM,48,-122,7,2,9
71,58thStGreenway22ndAve,01/03/2014 11:00:00 PM,48,-122,4,4,8
72,58thStGreenway22ndAve,01/04/2014 12:00:00 AM,48,-122,6,2,8
73,58thStGreenway22ndAve,01/04/2014 01:00:00 AM,48,-122,1,1,2
74,58thStGreenway22ndAve,01/04/2014 02:00:00 AM,48,-122,4,0,4
75,58thStGreenway22ndAve,01/04/2014 03:00:00 AM,48,-122,4,0,4
76,58thStGreenway22ndAve,01/04/2014 04:00:00 AM,48,-122,4,0,4
77,58thStGreenway22ndAve,01/04/2014 05:00:00 AM,48,-122,1,0,1
78,58thStGreenway22ndAve,01/04/2014 06:00:00 AM,48,-122,2,0,2
79,58thStGreenway22ndAve,01/04/2014 07:00:00 AM,48,-122,8,4,12
80,58thStGreenway22ndAve,01/04/2014 08:00:00 AM,48,-122,5,8,13
81,58thStGreenway22ndAve,01/04/2014 09:00:00 AM,48,-122,25,9,34
82,58thStGreenway22ndAve,01/04/2014 10:00:00 AM,48,-122,14,12,26
83,58thStGreenway22ndAve,01/04/2014 11:00:00 AM,48,-122,37,25,62
84,58thStGreenway22ndAve,01/04/2014 12:00:00 PM,48,-122,40,24,64
85,58thStGreenway22ndAve,01/04/2014 01:00:00 PM,48,-122,33,26,59
86,58thStGreenway22ndAve,01/04/2014 02:00:00 PM,48,-122,43,34,77
87,58thStGreenway22ndAve,01/04/2014 03:00:00 PM,48,-122,34,11,45
88,58thStGreenway22ndAve,01/04/2014 04:00:00 PM,48,-122,23,14,37
89,58thStGreenway22ndAve,01/04/2014 05:00:00 PM,48,-122,10,9,19
90,58thStGreenway22ndAve,01/04/2014 06:00:00 PM,48,-122,16,7,23
91,58thStGreenway22ndAve,01/04/2014 07:00:00 PM,48,-122,8,6,14
92,58thStGreenway22ndAve,01/04/2014 08:00:00 PM,48,-122,11,1,12
93,58thStGreenway22ndAve,01/04/2014 09:00:00 PM,48,-122,8,9,17
94,58thStGreenway22ndAve,01/04/2014 10:00:00 PM,48,-122,7,3,10
95,58thStGreenway22ndAve,01/04/2014 11:00:00 PM,48,-122,4,2,6
96,58thStGreenway22ndAve,01/05/2014 12:00:00 AM,48,-122,4,1,5
97,58thStGreenway22ndAve,01/05/2014 01:00:00 AM,48,-122,2,0,2
98,58thStGreenway22ndAve,01/05/2014 02:00:00 AM,48,-122,0,3,3
99,58thStGreenway22ndAve,01/05/2014 03:00:00 AM,48,-122,0,4,4
100,58thStGreenway22ndAve,01/05/2014 04:00:00 AM,48,-122,2,2,4
101,58thStGreenway22ndAve,01/05/2014 05:00:00 AM,48,-122,2,0,2
102,58thStGreenway22ndAve,01/05/2014 06:00:00 AM,48,-122,3,2,5
103,58thStGreenway22ndAve,01/05/2014 07:00:00 AM,48,-122,0,1,1
104,58thStGreenway22ndAve,01/05/2014 08:00:00 AM,48,-122,5,7,12
105,58thStGreenway22ndAve,01/05/2014 09:00:00 AM,48,-122,4,8,12
106,58thStGreenway22ndAve,01/05/2014 10:00:00 AM,48,-122,12,9,21
107,58thStGreenway22ndAve,01/05/2014 11:00:00 AM,48,-122,47,26,73
108,58thStGreenway22ndAve,01/05/2014 12:00:00 PM,48,-122,37,31,68
109,58thStGreenway22ndAve,01/05/2014 01:00:00 PM,48,-122,16,42,58
110,58thStGreenway22ndAve,01/05/2014 02:00:00 PM,48,-122,28,41,69
111,58thStGreenway22ndAve,01/05/2014 03:00:00 PM,48,-122,18,18,36
112,58thStGreenway22ndAve,01/05/2014 04:00:00 PM,48,-122,20,7,27
113,58thStGreenway22ndAve,01/05/2014 05:00:00 PM,48,-122,11,9,20
114,58thStGreenway22ndAve,01/05/2014 06:00:00 PM,48,-122,12,7,19
115,58thStGreenway22ndAve,01/05/2014 07:00:00 PM,48,-122,9,4,13
116,58thStGreenway22ndAve,01/05/2014 08:00:00 PM,48,-122,4,5,9
117,58thStGreenway22ndAve,01/05/2014 09:00:00 PM,48,-122,8,5,13
118,58thStGreenway22ndAve,01/05/2014 10:00:00 PM,48,-122,6,2,8
119,58thStGreenway22ndAve,01/05/2014 11:00:00 PM,48,-122,4,0,4
120,58thStGreenway22ndAve,01/06/2014 12:00:00 AM,48,-122,1,0,1
121,58thStGreenway22ndAve,01/06/2014 01:00:00 AM,48,-122,3,1,4
122,58thStGreenway22ndAve,01/06/2014 02:00:00 AM,48,-122,0,0,0
123,58thStGreenway22ndAve,01/06/2014 03:00:00 AM,48,-122,0,1,1
124,58thStGreenway22ndAve,01/06/2014 04:00:00 AM,48,-122,0,0,0
125,58thStGreenway22ndAve,01/06/2014 05:00:00 AM,48,-122,0,0,0
126,58thStGreenway22ndAve,01/06/2014 06:00:00 AM,48,-122,9,5,14
127,58thStGreenway22ndAve,01/06/2014 07:00:00 AM,48,-122,9,4,13
128,58thStGreenway22ndAve,01/06/2014 08:00:00 AM,48,-122,19,6,25
129,58thStGreenway22ndAve,01/06/2014 09:00:00 AM,48,-122,15,9,24
130,58thStGreenway22ndAve,01/06/2014 10:00:00 AM,48,-122,16,12,28
131,58thStGreenway22ndAve,01/06/2014 11:00:00 AM,48,-122,17,17,34
132,58thStGreenway22ndAve,01/06/2014 12:00:00 PM,48,-122,23,8,31
133,58thStGreenway22ndAve,01/06/2014 01:00:00 PM,48,-122,10,13,23
134,58thStGreenway22ndAve,01/06/2014 02:00:00 PM,48,-122,32,10,42
135,58thStGreenway22ndAve,01/06/2014 03:00:00 PM,48,-122,17,9,26
136,58thStGreenway22ndAve,01/06/2014 04:00:00 PM,48,-122,24,11,35
137,58thStGreenway22ndAve,01/06/2014 05:00:00 PM,48,-122,27,23,50
138,58thStGreenway22ndAve,01/06/2014 06:00:00 PM,48,-122,24,15,39
139,58thStGreenway22ndAve,01/06/2014 07:00:00 PM,48,-122,13,7,20
140,58thStGreenway22ndAve,01/06/2014 08:00:00 PM,48,-122,4,2,6
141,58thStGreenway22ndAve,01/06/2014 09:00:00 PM,48,-122,6,5,11
142,58thStGreenway22ndAve,01/06/2014 10:00:00 PM,48,-122,4,0,4
143,58thStGreenway22ndAve,01/06/2014 11:00:00 PM,48,-122,1,0,1
144,58thStGreenway22ndAve,01/07/2014 12:00:00 AM,48,-122,2,0,2
145,58thStGreenway22ndAve,01/07/2014 01:00:00 AM,48,-122,0,1,1
146,58thStGreenway22ndAve,01/07/2014 02:00:00 AM,48,-122,2,0,2
147,58thStGreenway22ndAve,01/07/2014 03:00:00 AM,48,-122,2,0,2
148,58thStGreenway22ndAve,01/07/2014 04:00:00 AM,48,-122,0,0,0
149,58thStGreenway22ndAve,01/07/2014 05:00:00 AM,48,-122,1,4,5
150,58thStGreenway22ndAve,01/07/2014 06:00:00 AM,48,-122,2,1,3
151,58thStGreenway22ndAve,01/07/2014 07:00:00 AM,48,-122,20,7,27
152,58thStGreenway22ndAve,01/07/2014 08:00:00 AM,48,-122,20,9,29
153,58thStGreenway22ndAve,01/07/2014 09:00:00 AM,48,-122,14,18,32
154,58thStGreenway22ndAve,01/07/2014 10:00:00 AM,48,-122,18,4,22
155,58thStGreenway22ndAve,01/07/2014 11:00:00 AM,48,-122,12,1,13
156,58thStGreenway22ndAve,01/07/2014 12:00:00 PM,48,-122,14,10,24
157,58thStGreenway22ndAve,01/07/2014 01:00:00 PM,48,-122,24,17,41
158,58thStGreenway22ndAve,01/07/2014 02:00:00 PM,48,-122,20,3,23
159,58thStGreenway22ndAve,01/07/2014 03:00:00 PM,48,-122,17,7,24
160,58thStGreenway22ndAve,01/07/2014 04:00:00 PM,48,-122,16,14,30
161,58thStGreenway22ndAve,01/07/2014 05:00:00 PM,48,-122,18,17,35
162,58thStGreenway22ndAve,01/07/2014 06:00:00 PM,48,-122,15,7,22
163,58thStGreenway22ndAve,01/07/2014 07:00:00 PM,48,-122,12,14,26
164,58thStGreenway22ndAve,01/07/2014 08:00:00 PM,48,-122,5,7,12
165,58thStGreenway22ndAve,01/07/2014 09:00:00 PM,48,-122,6,5,11
166,58thStGreenway22ndAve,01/07/2014 10:00:00 PM,48,-122,0,0,0
167,58thStGreenway22ndAve,01/07/2014 11:00:00 PM,48,-122,1,0,1
168,58thStGreenway22ndAve,01/08/2014 12:00:00 AM,48,-122,3,2,5
169,58thStGreenway22ndAve,01/08/2014 01:00:00 AM,48,-122,0,0,0
170,58thStGreenway22ndAve,01/08/2014 02:00:00 AM,48,-122,0,0,0
171,58thStGreenway22ndAve,01/08/2014 03:00:00 AM,48,-122,0,2,2
172,58thStGreenway22ndAve,01/08/2014 04:00:00 AM,48,-122,4,0,4
173,58thStGreenway22ndAve,01/08/2014 05:00:00 AM,48,-122,2,2,4
174,58thStGreenway22ndAve,01/08/2014 06:00:00 AM,48,-122,6,2,8
175,58thStGreenway22ndAve,01/08/2014 07:00:00 AM,48,-122,10,5,15
176,58thStGreenway22ndAve,01/08/2014 08:00:00 AM,48,-122,22,12,34
177,58thStGreenway22ndAve,01/08/2014 09:00:00 AM,48,-122,24,11,35
178,58thStGreenway22ndAve,01/08/2014 10:00:00 AM,48,-122,20,5,25
179,58thStGreenway22ndAve,01/08/2014 11:00:00 AM,48,-122,12,7,19
180,58thStGreenway22ndAve,01/08/2014 12:00:00 PM,48,-122,17,11,28
181,58thStGreenway22ndAve,01/08/2014 01:00:00 PM,48,-122,17,7,24
182,58thStGreenway22ndAve,01/08/2014 02:00:00 PM,48,-122,14,11,25
183,58thStGreenway22ndAve,01/08/2014 03:00:00 PM,48,-122,24,9,33
184,58thStGreenway22ndAve,01/08/2014 04:00:00 PM,48,-122,26,12,38
185,58thStGreenway22ndAve,01/08/2014 05:00:00 PM,48,-122,23,21,44
186,58thStGreenway22ndAve,01/08/2014 06:00:00 PM,48,-122,35,18,53
187,58thStGreenway22ndAve,01/08/2014 07:00:00 PM,48,-122,21,3,24
188,58thStGreenway22ndAve,01/08/2014 08:00:00 PM,48,-122,11,5,16
189,58thStGreenway22ndAve,01/08/2014 09:00:00 PM,48,-122,13,7,20
190,58thStGreenway22ndAve,01/08/2014 10:00:00 PM,48,-122,7,1,8
191,58thStGreenway22ndAve,01/08/2014 11:00:00 PM,48,-122,6,2,8
192,58thStGreenway22ndAve,01/09/2014 12:00:00 AM,48,-122,1,0,1
193,58thStGreenway22ndAve,01/09/2014 01:00:00 AM,48,-122,0,2,2
194,58thStGreenway22ndAve,01/09/2014 02:00:00 AM,48,-122,0,0,0
195,58thStGreenway22ndAve,01/09/2014 03:00:00 AM,48,-122,0,0,0
196,58thStGreenway22ndAve,01/09/2014 04:00:00 AM,48,-122,0,0,0
197,58thStGreenway22ndAve,01/09/2014 05:00:00 AM,48,-122,0,0,0
198,58thStGreenway22ndAve,01/09/2014 06:00:00 AM,48,-122,10,1,11
199,58thStGreenway22ndAve,01/09/2014 07:00:00 AM,48,-122,21,4,25
200,58thStGreenway22ndAve,01/09/2014 08:00:00 AM,48,-122,34,6,40
201,58thStGreenway22ndAve,01/09/2014 09:00:00 AM,48,-122,16,6,22
202,58thStGreenway22ndAve,01/09/2014 10:00:00 AM,48,-122,15,6,21
203,58thStGreenway22ndAve,01/09/2014 11:00:00 AM,48,-122,12,2,14
204,58thStGreenway22ndAve,01/09/2014 12:00:00 PM,48,-122,15,5,20
205,58thStGreenway22ndAve,01/09/2014 01:00:00 PM,48,-122,16,9,25
206,58thStGreenway22ndAve,01/09/2014 02:00:00 PM,48,-122,22,2,24
207,58thStGreenway22ndAve,01/09/2014 03:00:00 PM,48,-122,28,9,37
208,58thStGreenway22ndAve,01/09/2014 04:00:00 PM,48,-122,15,6,21
209,58thStGreenway22ndAve,01/09/2014 05:00:00 PM,48,-122,18,10,28
210,58thStGreenway22ndAve,01/09/2014 06:00:00 PM,48,-122,17,21,38
211,58thStGreenway22ndAve,01/09/2014 07:00:00 PM,48,-122,15,5,20
212,58thStGreenway22ndAve,01/09/2014 08:00:00 PM,48,-122,8,1,9
213,58thStGreenway22ndAve,01/09/2014 09:00:00 PM,48,-122,8,0,8
214,58thStGreenway22ndAve,01/09/2014 10:00:00 PM,48,-122,5,0,5
215,58thStGreenway22ndAve,01/09/2014 11:00:00 PM,48,-122,1,0,1
216,58thStGreenway22ndAve,01/10/2014 12:00:00 AM,48,-122,0,3,3
217,58thStGreenway22ndAve,01/10/2014 01:00:00 AM,48,-122,0,1,1
218,58thStGreenway22ndAve,01/10/2014 02:00:00 AM,48,-122,0,2,2
219,58thStGreenway22ndAve,01/10/2014 03:00:00 AM,48,-122,4,2,6
220,58thStGreenway22ndAve,01/10/2014 04:00:00 AM,48,-122,0,0,0
221,58thStGreenway22ndAve,01/10/2014 05:00:00 AM,48,-122,0,0,0
222,58thStGreenway22ndAve,01/10/2014 06:00:00 AM,48,-122,3,2,5
223,58thStGreenway22ndAve,01/10/2014 07:00:00 AM,48,-122,19,3,22
224,58thStGreenway22ndAve,01/10/2014 08:00:00 AM,48,-122,15,14,29
225,58thStGreenway22ndAve,01/10/2014 09:00:00 AM,48,-122,23,12,35
226,58thStGreenway22ndAve,01/10/2014 10:00:00 AM,48,-122,11,10,21
227,58thStGreenway22ndAve,01/10/2014 11:00:00 AM,48,-122,11,5,16
228,58thStGreenway22ndAve,01/10/2014 12:00:00 PM,48,-122,14,10,24
229,58thStGreenway22ndAve,01/10/2014 01:00:00 PM,48,-122,12,5,17
230,58thStGreenway22ndAve,01/10/2014 02:00:00 PM,48,-122,25,14,39
231,58thStGreenway22ndAve,01/10/2014 03:00:00 PM,48,-122,20,15,35
232,58thStGreenway22ndAve,01/10/2014 04:00:00 PM,48,-122,13,10,23
233,58thStGreenway22ndAve,01/10/2014 05:00:00 PM,48,-122,22,13,35
234,58thStGreenway22ndAve,01/10/2014 06:00:00 PM,48,-122,30,23,53
235,58thStGreenway22ndAve,01/10/2014 07:00:00 PM,48,-122,25,26,51
236,58thStGreenway22ndAve,01/10/2014 08:00:00 PM,48,-122,11,8,19
237,58thStGreenway22ndAve,01/10/2014 09:00:00 PM,48,-122,15,4,19
238,58thStGreenway22ndAve,01/10/2014 10:00:00 PM,48,-122,6,7,13
239,58thStGreenway22ndAve,01/10/2014 11:00:00 PM,48,-122,4,7,11
240,58thStGreenway22ndAve,01/11/2014 12:00:00 AM,48,-122,2,4,6
241,58thStGreenway22ndAve,01/11/2014 01:00:00 AM,48,-122,0,0,0
242,58thStGreenway22ndAve,01/11/2014 02:00:00 AM,48,-122,3,0,3
243,58thStGreenway22ndAve,01/11/2014 03:00:00 AM,48,-122,2,0,2
244,58thStGreenway22ndAve,01/11/2014 04:00:00 AM,48,-122,0,0,0
245,58thStGreenway22ndAve,01/11/2014 05:00:00 AM,48,-122,3,0,3
246,58thStGreenway22ndAve,01/11/2014 06:00:00 AM,48,-122,12,3,15
247,58thStGreenway22ndAve,01/11/2014 07:00:00 AM,48,-122,8,5,13
248,58thStGreenway22ndAve,01/11/2014 08:00:00 AM,48,-122,8,9,17
249,58thStGreenway22ndAve,01/11/2014 09:00:00 AM,48,-122,19,12,31
250,58thStGreenway22ndAve,01/11/2014 10:00:00 AM,48,-122,1,0,1
251,58thStGreenway22ndAve,01/11/2014 11:00:00 AM,48,-122,14,14,28
252,58thStGreenway22ndAve,01/11/2014 12:00:00 PM,48,-122,36,22,58
253,58thStGreenway22ndAve,01/11/2014 01:00:00 PM,48,-122,43,29,72
254,58thStGreenway22ndAve,01/11/2014 02:00:00 PM,48,-122,24,27,51
255,58thStGreenway22ndAve,01/11/2014 03:00:00 PM,48,-122,15,2,17
256,58thStGreenway22ndAve,01/11/2014 04:00:00 PM,48,-122,12,1,13
257,58thStGreenway22ndAve,01/11/2014 05:00:00 PM,48,-122,20,17,37
258,58thStGreenway22ndAve,01/11/2014 06:00:00 PM,48,-122,37,19,56
259,58thStGreenway22ndAve,01/11/2014 07:00:00 PM,48,-122,19,5,24
260,58thStGreenway22ndAve,01/11/2014 08:00:00 PM,48,-122,12,20,32
261,58thStGreenway22ndAve,01/11/2014 09:00:00 PM,48,-122,15,1,16
262,58thStGreenway22ndAve,01/11/2014 10:00:00 PM,48,-122,16,1,17
263,58thStGreenway22ndAve,01/11/2014 11:00:00 PM,48,-122,1,4,5
264,58thStGreenway22ndAve,01/12/2014 12:00:00 AM,48,-122,6,0,6
265,58thStGreenway22ndAve,01/12/2014 01:00:00 AM,48,-122,2,1,3
266,58thStGreenway22ndAve,01/12/2014 02:00:00 AM,48,-122,2,2,4
267,58thStGreenway22ndAve,01/12/2014 03:00:00 AM,48,-122,0,3,3
268,58thStGreenway22ndAve,01/12/2014 04:00:00 AM,48,-122,0,0,0
269,58thStGreenway22ndAve,01/12/2014 05:00:00 AM,48,-122,2,0,2
270,58thStGreenway22ndAve,01/12/2014 06:00:00 AM,48,-122,4,0,4
271,58thStGreenway22ndAve,01/12/2014 07:00:00 AM,48,-122,8,0,8
272,58thStGreenway22ndAve,01/12/2014 08:00:00 AM,48,-122,4,2,6
273,58thStGreenway22ndAve,01/12/2014 09:00:00 AM,48,-122,4,4,8
274,58thStGreenway22ndAve,01/12/2014 10:00:00 AM,48,-122,10,9,19
275,58thStGreenway22ndAve,01/12/2014 11:00:00 AM,48,-122,17,11,28
276,58thStGreenway22ndAve,01/12/2014 12:00:00 PM,48,-122,29,37,66
277,58thStGreenway22ndAve,01/12/2014 01:00:00 PM,48,-122,42,30,72
278,58thStGreenway22ndAve,01/12/2014 02:00:00 PM,48,-122,30,48,78
279,58thStGreenway22ndAve,01/12/2014 03:00:00 PM,48,-122,19,19,38
280,58thStGreenway22ndAve,01/12/2014 04:00:00 PM,48,-122,31,7,38
281,58thStGreenway22ndAve,01/12/2014 05:00:00 PM,48,-122,24,15,39
282,58thStGreenway22ndAve,01/12/2014 06:00:00 PM,48,-122,20,16,36
283,58thStGreenway22ndAve,01/12/2014 07:00:00 PM,48,-122,8,6,14
284,58thStGreenway22ndAve,01/12/2014 08:00:00 PM,48,-122,7,4,11
285,58thStGreenway22ndAve,01/12/2014 09:00:00 PM,48,-122,2,4,6
286,58thStGreenway22ndAve,01/12/2014 10:00:00 PM,48,-122,5,2,7
287,58thStGreenway22ndAve,01/12/2014 11:00:00 PM,48,-122,6,1,7
288,58thStGreenway22ndAve,01/13/2014 12:00:00 AM,48,-122,6,0,6
289,58thStGreenway22ndAve,01/13/2014 01:00:00 AM,48,-122,0,1,1
290,58thStGreenway22ndAve,01/13/2014 02:00:00 AM,48,-122,0,5,5
291,58thStGreenway22ndAve,01/13/2014 03:00:00 AM,48,-122,2,0,2
292,58thStGreenway22ndAve,01/13/2014 04:00:00 AM,48,-122,2,0,2
293,58thStGreenway22ndAve,01/13/2014 05:00:00 AM,48,-122,0,0,0
294,58thStGreenway22ndAve,01/13/2014 06:00:00 AM,48,-122,6,13,19
295,58thStGreenway22ndAve,01/13/2014 07:00:00 AM,48,-122,18,5,23
296,58thStGreenway22ndAve,01/13/2014 08:00:00 AM,48,-122,13,9,22
297,58thStGreenway22ndAve,01/13/2014 09:00:00 AM,48,-122,19,17,36
298,58thStGreenway22ndAve,01/13/2014 10:00:00 AM,48,-122,18,13,31
299,58thStGreenway22ndAve,01/13/2014 11:00:00 AM,48,-122,12,15,27
300,58thStGreenway22ndAve,01/13/2014 12:00:00 PM,48,-122,18,19,37
301,58thStGreenway22ndAve,01/13/2014 01:00:00 PM,48,-122,12,12,24
302,58thStGreenway22ndAve,01/13/2014 02:00:00 PM,48,-122,10,18,28
303,58thStGreenway22ndAve,01/13/2014 03:00:00 PM,48,-122,20,9,29
304,58thStGreenway22ndAve,01/13/2014 04:00:00 PM,48,-122,30,20,50
305,58thStGreenway22ndAve,01/13/2014 05:00:00 PM,48,-122,15,14,29
306,58thStGreenway22ndAve,01/13/2014 06:00:00 PM,48,-122,16,19,35
307,58thStGreenway22ndAve,01/13/2014 07:00:00 PM,48,-122,19,18,37
308,58thStGreenway22ndAve,01/13/2014 08:00:00 PM,48,-122,9,13,22
309,58thStGreenway22ndAve,01/13/2014 09:00:00 PM,48,-122,7,15,22
310,58thStGreenway22ndAve,01/13/2014 10:00:00 PM,48,-122,2,6,8
311,58thStGreenway22ndAve,01/13/2014 11:00:00 PM,48,-122,0,3,3
312,58thStGreenway22ndAve,01/14/2014 12:00:00 AM,48,-122,4,0,4
313,58thStGreenway22ndAve,01/14/2014 01:00:00 AM,48,-122,2,0,2
314,58thStGreenway22ndAve,01/14/2014 02:00:00 AM,48,-122,0,0,0
315,58thStGreenway22ndAve,01/14/2014 03:00:00 AM,48,-122,2,0,2
316,58thStGreenway22ndAve,01/14/2014 04:00:00 AM,48,-122,2,1,3
317,58thStGreenway22ndAve,01/14/2014 05:00:00 AM,48,-122,1,2,3
318,58thStGreenway22ndAve,01/14/2014 06:00:00 AM,48,-122,9,8,17
319,58thStGreenway22ndAve,01/14/2014 07:00:00 AM,48,-122,10,6,16
320,58thStGreenway22ndAve,01/14/2014 08:00:00 AM,48,-122,26,13,39
321,58thStGreenway22ndAve,01/14/2014 09:00:00 AM,48,-122,11,11,22
322,58thStGreenway22ndAve,01/14/2014 10:00:00 AM,48,-122,10,6,16
323,58thStGreenway22ndAve,01/14/2014 11:00:00 AM,48,-122,6,9,15
324,58thStGreenway22ndAve,01/14/2014 12:00:00 PM,48,-122,16,12,28
325,58thStGreenway22ndAve,01/14/2014 01:00:00 PM,48,-122,16,8,24
326,58thStGreenway22ndAve,01/14/2014 02:00:00 PM,48,-122,15,2,17
327,58thStGreenway22ndAve,01/14/2014 03:00:00 PM,48,-122,18,24,42
328,58thStGreenway22ndAve,01/14/2014 04:00:00 PM,48,-122,7,14,21
329,58thStGreenway22ndAve,01/14/2014 05:00:00 PM,48,-122,14,29,43
330,58thStGreenway22ndAve,01/14/2014 06:00:00 PM,48,-122,14,14,28
331,58thStGreenway22ndAve,01/14/2014 07:00:00 PM,48,-122,8,5,13
332,58thStGreenway22ndAve,01/14/2014 08:00:00 PM,48,-122,5,8,13
333,58thStGreenway22ndAve,01/14/2014 09:00:00 PM,48,-122,7,8,15
334,58thStGreenway22ndAve,01/14/2014 10:00:00 PM,48,-122,2,2,4
335,58thStGreenway22ndAve,01/14/2014 11:00:00 PM,48,-122,2,2,4
336,58thStGreenway22ndAve,01/15/2014 12:00:00 AM,48,-122,2,0,2
337,58thStGreenway22ndAve,01/15/2014 01:00:00 AM,48,-122,4,0,4
338,58thStGreenway22ndAve,01/15/2014 02:00:00 AM,48,-122,0,0,0
339,58thStGreenway22ndAve,01/15/2014 03:00:00 AM,48,-122,0,5,5
340,58thStGreenway22ndAve,01/15/2014 04:00:00 AM,48,-122,0,0,0
341,58thStGreenway22ndAve,01/15/2014 05:00:00 AM,48,-122,0,4,4
342,58thStGreenway22ndAve,01/15/2014 06:00:00 AM,48,-122,4,3,7
343,58thStGreenway22ndAve,01/15/2014 07:00:00 AM,48,-122,7,4,11
344,58thStGreenway22ndAve,01/15/2014 08:00:00 AM,48,-122,12,11,23
345,58thStGreenway22ndAve,01/15/2014 09:00:00 AM,48,-122,10,12,22
346,58thStGreenway22ndAve,01/15/2014 10:00:00 AM,48,-122,8,11,19
347,58thStGreenway22ndAve,01/15/2014 11:00:00 AM,48,-122,13,24,37
348,58thStGreenway22ndAve,01/15/2014 12:00:00 PM,48,-122,26,13,39
349,58thStGreenway22ndAve,01/15/2014 01:00:00 PM,48,-122,11,17,28
350,58thStGreenway22ndAve,01/15/2014 02:00:00 PM,48,-122,11,11,22
351,58thStGreenway22ndAve,01/15/2014 03:00:00 PM,48,-122,21,10,31
352,58thStGreenway22ndAve,01/15/2014 04:00:00 PM,48,-122,25,27,52
353,58thStGreenway22ndAve,01/15/2014 05:00:00 PM,48,-122,31,15,46
354,58thStGreenway22ndAve,01/15/2014 06:00:00 PM,48,-122,16,6,22
355,58thStGreenway22ndAve,01/15/2014 07:00:00 PM,48,-122,15,16,31
356,58thStGreenway22ndAve,01/15/2014 08:00:00 PM,48,-122,8,4,12
357,58thStGreenway22ndAve,01/15/2014 09:00:00 PM,48,-122,10,0,10
358,58thStGreenway22ndAve,01/15/2014 10:00:00 PM,48,-122,9,7,16
359,58thStGreenway22ndAve,01/15/2014 11:00:00 PM,48,-122,12,9,21
360,58thStGreenway22ndAve,01/16/2014 12:00:00 AM,48,-122,0,0,0
361,58thStGreenway22ndAve,01/16/2014 01:00:00 AM,48,-122,0,0,0
362,58thStGreenway22ndAve,01/16/2014 02:00:00 AM,48,-122,3,0,3
363,58thStGreenway22ndAve,01/16/2014 03:00:00 AM,48,-122,2,0,2
364,58thStGreenway22ndAve,01/16/2014 04:00:00 AM,48,-122,0,0,0
365,58thStGreenway22ndAve,01/16/2014 05:00:00 AM,48,-122,2,0,2
366,58thStGreenway22ndAve,01/16/2014 06:00:00 AM,48,-122,4,2,6
367,58thStGreenway22ndAve,01/16/2014 07:00:00 AM,48,-122,13,9,22
368,58thStGreenway22ndAve,01/16/2014 08:00:00 AM,48,-122,9,9,18
369,58thStGreenway22ndAve,01/16/2014 09:00:00 AM,48,-122,22,18,40
370,58thStGreenway22ndAve,01/16/2014 10:00:00 AM,48,-122,16,12,28
371,58thStGreenway22ndAve,01/16/2014 11:00:00 AM,48,-122,19,17,36
372,58thStGreenway22ndAve,01/16/2014 12:00:00 PM,48,-122,9,5,14
373,58thStGreenway22ndAve,01/16/2014 01:00:00 PM,48,-122,21,15,36
374,58thStGreenway22ndAve,01/16/2014 02:00:00 PM,48,-122,14,6,20
375,58thStGreenway22ndAve,01/16/2014 03:00:00 PM,48,-122,22,13,35
376,58thStGreenway22ndAve,01/16/2014 04:00:00 PM,48,-122,11,6,17
377,58thStGreenway22ndAve,01/16/2014 05:00:00 PM,48,-122,21,17,38
378,58thStGreenway22ndAve,01/16/2014 06:00:00 PM,48,-122,22,14,36
379,58thStGreenway22ndAve,01/16/2014 07:00:00 PM,48,-122,16,3,19
380,58thStGreenway22ndAve,01/16/2014 08:00:00 PM,48,-122,9,2,11
381,58thStGreenway22ndAve,01/16/2014 09:00:00 PM,48,-122,11,5,16
382,58thStGreenway22ndAve,01/16/2014 10:00:00 PM,48,-122,12,1,13
383,58thStGreenway22ndAve,01/16/2014 11:00:00 PM,48,-122,7,2,9
384,58thStGreenway22ndAve,01/17/2014 12:00:00 AM,48,-122,2,0,2
385,58thStGreenway22ndAve,01/17/2014 01:00:00 AM,48,-122,0,0,0
386,58thStGreenway22ndAve,01/17/2014 02:00:00 AM,48,-122,3,2,5
387,58thStGreenway22ndAve,01/17/2014 03:00:00 AM,48,-122,0,0,0
388,58thStGreenway22ndAve,01/17/2014 04:00:00 AM,48,-122,4,0,4
389,58thStGreenway22ndAve,01/17/2014 05:00:00 AM,48,-122,0,0,0
390,58thStGreenway22ndAve,01/17/2014 06:00:00 AM,48,-122,12,7,19
391,58thStGreenway22ndAve,01/17/2014 07:00:00 AM,48,-122,11,3,14
392,58thStGreenway22ndAve,01/17/2014 08:00:00 AM,48,-122,19,10,29
393,58thStGreenway22ndAve,01/17/2014 09:00:00 AM,48,-122,32,19,51
394,58thStGreenway22ndAve,01/17/2014 10:00:00 AM,48,-122,18,25,43
395,58thStGreenway22ndAve,01/17/2014 11:00:00 AM,48,-122,19,16,35
396,58thStGreenway22ndAve,01/17/2014 12:00:00 PM,48,-122,18,20,38
397,58thStGreenway22ndAve,01/17/2014 01:00:00 PM,48,-122,26,17,43
398,58thStGreenway22ndAve,01/17/2014 02:00:00 PM,48,-122,15,5,20
399,58thStGreenway22ndAve,01/17/2014 03:00:00 PM,48,-122,26,13,39
400,58thStGreenway22ndAve,01/17/2014 04:00:00 PM,48,-122,27,13,40
401,58thStGreenway22ndAve,01/17/2014 05:00:00 PM,48,-122,22,5,27
402,58thStGreenway22ndAve,01/17/2014 06:00:00 PM,48,-122,31,31,62
403,58thStGreenway22ndAve,01/17/2014 07:00:00 PM,48,-122,33,18,51
404,58thStGreenway22ndAve,01/17/2014 08:00:00 PM,48,-122,9,6,15
405,58thStGreenway22ndAve,01/17/2014 09:00:00 PM,48,-122,11,3,14
406,58thStGreenway22ndAve,01/17/2014 10:00:00 PM,48,-122,4,1,5
407,58thStGreenway22ndAve,01/17/2014 11:00:00 PM,48,-122,4,9,13
408,58thStGreenway22ndAve,01/18/2014 12:00:00 AM,48,-122,6,0,6
409,58thStGreenway22ndAve,01/18/2014 01:00:00 AM,48,-122,4,0,4
410,58thStGreenway22ndAve,01/18/2014 02:00:00 AM,48,-122,2,2,4
411,58thStGreenway22ndAve,01/18/2014 03:00:00 AM,48,-122,2,2,4
412,58thStGreenway22ndAve,01/18/2014 04:00:00 AM,48,-122,0,2,2
413,58thStGreenway22ndAve,01/18/2014 05:00:00 AM,48,-122,4,2,6
414,58thStGreenway22ndAve,01/18/2014 06:00:00 AM,48,-122,0,0,0
415,58thStGreenway22ndAve,01/18/2014 07:00:00 AM,48,-122,6,1,7
416,58thStGreenway22ndAve,01/18/2014 08:00:00 AM,48,-122,8,5,13
417,58thStGreenway22ndAve,01/18/2014 09:00:00 AM,48,-122,20,9,29
418,58thStGreenway22ndAve,01/18/2014 10:00:00 AM,48,-122,25,20,45
419,58thStGreenway22ndAve,01/18/2014 11:00:00 AM,48,-122,24,12,36
420,58thStGreenway22ndAve,01/18/2014 12:00:00 PM,48,-122,19,22,41
421,58thStGreenway22ndAve,01/18/2014 01:00:00 PM,48,-122,39,17,56
422,58thStGreenway22ndAve,01/18/2014 02:00:00 PM,48,-122,23,14,37
423,58thStGreenway22ndAve,01/18/2014 03:00:00 PM,48,-122,21,27,48
424,58thStGreenway22ndAve,01/18/2014 04:00:00 PM,48,-122,21,22,43
425,58thStGreenway22ndAve,01/18/2014 05:00:00 PM,48,-122,22,7,29
426,58thStGreenway22ndAve,01/18/2014 06:00:00 PM,48,-122,17,4,21
427,58thStGreenway22ndAve,01/18/2014 07:00:00 PM,48,-122,28,25,53
428,58thStGreenway22ndAve,01/18/2014 08:00:00 PM,48,-122,16,4,20
429,58thStGreenway22ndAve,01/18/2014 09:00:00 PM,48,-122,1,2,3
430,58thStGreenway22ndAve,01/18/2014 10:00:00 PM,48,-122,8,3,11
431,58thStGreenway22ndAve,01/18/2014 11:00:00 PM,48,-122,3,1,4
432,58thStGreenway22ndAve,01/19/2014 12:00:00 AM,48,-122,2,2,4
433,58thStGreenway22ndAve,01/19/2014 01:00:00 AM,48,-122,3,0,3
434,58thStGreenway22ndAve,01/19/2014 02:00:00 AM,48,-122,4,0,4
435,58thStGreenway22ndAve,01/19/2014 03:00:00 AM,48,-122,0,3,3
436,58thStGreenway22ndAve,01/19/2014 04:00:00 AM,48,-122,0,3,3
437,58thStGreenway22ndAve,01/19/2014 05:00:00 AM,48,-122,2,2,4
438,58thStGreenway22ndAve,01/19/2014 06:00:00 AM,48,-122,2,0,2
439,58thStGreenway22ndAve,01/19/2014 07:00:00 AM,48,-122,4,3,7
440,58thStGreenway22ndAve,01/19/2014 08:00:00 AM,48,-122,3,5,8
441,58thStGreenway22ndAve,01/19/2014 09:00:00 AM,48,-122,6,18,24
442,58thStGreenway22ndAve,01/19/2014 10:00:00 AM,48,-122,23,21,44
443,58thStGreenway22ndAve,01/19/2014 11:00:00 AM,48,-122,33,22,55
444,58thStGreenway22ndAve,01/19/2014 12:00:00 PM,48,-122,22,22,44
445,58thStGreenway22ndAve,01/19/2014 01:00:00 PM,48,-122,33,29,62
446,58thStGreenway22ndAve,01/19/2014 02:00:00 PM,48,-122,13,14,27
447,58thStGreenway22ndAve,01/19/2014 03:00:00 PM,48,-122,7,11,18
448,58thStGreenway22ndAve,01/19/2014 04:00:00 PM,48,-122,2,6,8
449,58thStGreenway22ndAve,01/19/2014 05:00:00 PM,48,-122,12,2,14
450,58thStGreenway22ndAve,01/19/2014 06:00:00 PM,48,-122,2,0,2
451,58thStGreenway22ndAve,01/19/2014 07:00:00 PM,48,-122,14,11,25
452,58thStGreenway22ndAve,01/19/2014 08:00:00 PM,48,-122,9,3,12
453,58thStGreenway22ndAve,01/19/2014 09:00:00 PM,48,-122,4,2,6
454,58thStGreenway22ndAve,01/19/2014 10:00:00 PM,48,-122,10,0,10
455,58thStGreenway22ndAve,01/19/2014 11:00:00 PM,48,-122,6,0,6
456,58thStGreenway22ndAve,01/20/2014 12:00:00 AM,48,-122,2,1,3
457,58thStGreenway22ndAve,01/20/2014 01:00:00 AM,48,-122,1,0,1
458,58thStGreenway22ndAve,01/20/2014 02:00:00 AM,48,-122,0,0,0
459,58thStGreenway22ndAve,01/20/2014 03:00:00 AM,48,-122,4,0,4
460,58thStGreenway22ndAve,01/20/2014 04:00:00 AM,48,-122,0,0,0
461,58thStGreenway22ndAve,01/20/2014 05:00:00 AM,48,-122,0,1,1
462,58thStGreenway22ndAve,01/20/2014 06:00:00 AM,48,-122,4,6,10
463,58thStGreenway22ndAve,01/20/2014 07:00:00 AM,48,-122,5,0,5
464,58thStGreenway22ndAve,01/20/2014 08:00:00 AM,48,-122,15,11,26
465,58thStGreenway22ndAve,01/20/2014 09:00:00 AM,48,-122,25,7,32
466,58thStGreenway22ndAve,01/20/2014 10:00:00 AM,48,-122,10,21,31
467,58thStGreenway22ndAve,01/20/2014 11:00:00 AM,48,-122,14,3,17
468,58thStGreenway22ndAve,01/20/2014 12:00:00 PM,48,-122,22,8,30
469,58thStGreenway22ndAve,01/20/2014 01:00:00 PM,48,-122,20,19,39
470,58thStGreenway22ndAve,01/20/2014 02:00:00 PM,48,-122,23,22,45
471,58thStGreenway22ndAve,01/20/2014 03:00:00 PM,48,-122,23,12,35
472,58thStGreenway22ndAve,01/20/2014 04:00:00 PM,48,-122,16,9,25
473,58thStGreenway22ndAve,01/20/2014 05:00:00 PM,48,-122,15,5,20
474,58thStGreenway22ndAve,01/20/2014 06:00:00 PM,48,-122,22,15,37
475,58thStGreenway22ndAve,01/20/2014 07:00:00 PM,48,-122,12,3,15
476,58thStGreenway22ndAve,01/20/2014 08:00:00 PM,48,-122,15,6,21
477,58thStGreenway22ndAve,01/20/2014 09:00:00 PM,48,-122,3,1,4
478,58thStGreenway22ndAve,01/20/2014 10:00:00 PM,48,-122,2,0,2
479,58thStGreenway22ndAve,01/20/2014 11:00:00 PM,48,-122,4,0,4
480,58thStGreenway22ndAve,01/21/2014 12:00:00 AM,48,-122,2,0,2
481,58thStGreenway22ndAve,01/21/2014 01:00:00 AM,48,-122,0,0,0
482,58thStGreenway22ndAve,01/21/2014 02:00:00 AM,48,-122,0,0,0
483,58thStGreenway22ndAve,01/21/2014 03:00:00 AM,48,-122,2,0,2
484,58thStGreenway22ndAve,01/21/2014 04:00:00 AM,48,-122,0,0,0
485,58thStGreenway22ndAve,01/21/2014 05:00:00 AM,48,-122,4,0,4
486,58thStGreenway22ndAve,01/21/2014 06:00:00 AM,48,-122,5,6,11
487,58thStGreenway22ndAve,01/21/2014 07:00:00 AM,48,-122,22,1,23
488,58thStGreenway22ndAve,01/21/2014 08:00:00 AM,48,-122,15,12,27
489,58thStGreenway22ndAve,01/21/2014 09:00:00 AM,48,-122,14,9,23
490,58thStGreenway22ndAve,01/21/2014 10:00:00 AM,48,-122,11,5,16
491,58thStGreenway22ndAve,01/21/2014 11:00:00 AM,48,-122,22,18,40
492,58thStGreenway22ndAve,01/21/2014 12:00:00 PM,48,-122,9,17,26
493,58thStGreenway22ndAve,01/21/2014 01:00:00 PM,48,-122,20,11,31
494,58thStGreenway22ndAve,01/21/2014 02:00:00 PM,48,-122,20,19,39
495,58thStGreenway22ndAve,01/21/2014 03:00:00 PM,48,-122,9,17,26
496,58thStGreenway22ndAve,01/21/2014 04:00:00 PM,48,-122,28,13,41
497,58thStGreenway22ndAve,01/21/2014 05:00:00 PM,48,-122,11,17,28
498,58thStGreenway22ndAve,01/21/2014 06:00:00 PM,48,-122,20,7,27
499,58thStGreenway22ndAve,01/21/2014 07:00:00 PM,48,-122,13,8,21
500,58thStGreenway22ndAve,01/21/2014 08:00:00 PM,48,-122,6,2,8
501,58thStGreenway22ndAve,01/21/2014 09:00:00 PM,48,-122,6,2,8
502,58thStGreenway22ndAve,01/21/2014 10:00:00 PM,48,-122,2,0,2
503,58thStGreenway22ndAve,01/21/2014 11:00:00 PM,48,-122,2,0,2
504,58thStGreenway22ndAve,01/22/2014 12:00:00 AM,48,-122,0,2,2
505,58thStGreenway22ndAve,01/22/2014 01:00:00 AM,48,-122,0,6,6
506,58thStGreenway22ndAve,01/22/2014 02:00:00 AM,48,-122,0,1,1
507,58thStGreenway22ndAve,01/22/2014 03:00:00 AM,48,-122,0,0,0
508,58thStGreenway22ndAve,01/22/2014 04:00:00 AM,48,-122,0,0,0
509,58thStGreenway22ndAve,01/22/2014 05:00:00 AM,48,-122,1,0,1
510,58thStGreenway22ndAve,01/22/2014 06:00:00 AM,48,-122,11,4,15
511,58thStGreenway22ndAve,01/22/2014 07:00:00 AM,48,-122,15,4,19
512,58thStGreenway22ndAve,01/22/2014 08:00:00 AM,48,-122,17,9,26
513,58thStGreenway22ndAve,01/22/2014 09:00:00 AM,48,-122,22,7,29
514,58thStGreenway22ndAve,01/22/2014 10:00:00 AM,48,-122,13,14,27
515,58thStGreenway22ndAve,01/22/2014 11:00:00 AM,48,-122,15,12,27
516,58thStGreenway22ndAve,01/22/2014 12:00:00 PM,48,-122,23,18,41
517,58thStGreenway22ndAve,01/22/2014 01:00:00 PM,48,-122,10,15,25
518,58thStGreenway22ndAve,01/22/2014 02:00:00 PM,48,-122,12,10,22
519,58thStGreenway22ndAve,01/22/2014 03:00:00 PM,48,-122,8,22,30
520,58thStGreenway22ndAve,01/22/2014 04:00:00 PM,48,-122,16,14,30
521,58thStGreenway22ndAve,01/22/2014 05:00:00 PM,48,-122,12,25,37
522,58thStGreenway22ndAve,01/22/2014 06:00:00 PM,48,-122,17,20,37
523,58thStGreenway22ndAve,01/22/2014 07:00:00 PM,48,-122,13,15,28
524,58thStGreenway22ndAve,01/22/2014 08:00:00 PM,48,-122,20,12,32
525,58thStGreenway22ndAve,01/22/2014 09:00:00 PM,48,-122,9,3,12
526,58thStGreenway22ndAve,01/22/2014 10:00:00 PM,48,-122,6,5,11
527,58thStGreenway22ndAve,01/22/2014 11:00:00 PM,48,-122,3,2,5
528,58thStGreenway22ndAve,01/23/2014 12:00:00 AM,48,-122,2,0,2
529,58thStGreenway22ndAve,01/23/2014 01:00:00 AM,48,-122,1,1,2
530,58thStGreenway22ndAve,01/23/2014 02:00:00 AM,48,-122,2,0,2
531,58thStGreenway22ndAve,01/23/2014 03:00:00 AM,48,-122,0,2,2
532,58thStGreenway22ndAve,01/23/2014 04:00:00 AM,48,-122,0,0,0
533,58thStGreenway22ndAve,01/23/2014 05:00:00 AM,48,-122,0,0,0
534,58thStGreenway22ndAve,01/23/2014 06:00:00 AM,48,-122,4,1,5
535,58thStGreenway22ndAve,01/23/2014 07:00:00 AM,48,-122,19,7,26
536,58thStGreenway22ndAve,01/23/2014 08:00:00 AM,48,-122,20,18,38
537,58thStGreenway22ndAve,01/23/2014 09:00:00 AM,48,-122,7,12,19
538,58thStGreenway22ndAve,01/23/2014 10:00:00 AM,48,-122,7,14,21
539,58thStGreenway22ndAve,01/23/2014 11:00:00 AM,48,-122,12,13,25
540,58thStGreenway22ndAve,01/23/2014 12:00:00 PM,48,-122,4,16,20
541,58thStGreenway22ndAve,01/23/2014 01:00:00 PM,48,-122,21,14,35
542,58thStGreenway22ndAve,01/23/2014 02:00:00 PM,48,-122,10,19,29
543,58thStGreenway22ndAve,01/23/2014 03:00:00 PM,48,-122,13,20,33
544,58thStGreenway22ndAve,01/23/2014 04:00:00 PM,48,-122,10,14,24
545,58thStGreenway22ndAve,01/23/2014 05:00:00 PM,48,-122,22,13,35
546,58thStGreenway22ndAve,01/23/2014 06:00:00 PM,48,-122,25,17,42
547,58thStGreenway22ndAve,01/23/2014 07:00:00 PM,48,-122,21,15,36
548,58thStGreenway22ndAve,01/23/2014 08:00:00 PM,48,-122,9,6,15
549,58thStGreenway22ndAve,01/23/2014 09:00:00 PM,48,-122,6,2,8
550,58thStGreenway22ndAve,01/23/2014 10:00:00 PM,48,-122,6,0,6
551,58thStGreenway22ndAve,01/23/2014 11:00:00 PM,48,-122,6,1,7
552,58thStGreenway22ndAve,01/24/2014 12:00:00 AM,48,-122,0,0,0
553,58thStGreenway22ndAve,01/24/2014 01:00:00 AM,48,-122,2,2,4
554,58thStGreenway22ndAve,01/24/2014 02:00:00 AM,48,-122,2,0,2
555,58thStGreenway22ndAve,01/24/2014 03:00:00 AM,48,-122,2,1,3
556,58thStGreenway22ndAve,01/24/2014 04:00:00 AM,48,-122,0,0,0
557,58thStGreenway22ndAve,01/24/2014 05:00:00 AM,48,-122,2,0,2
558,58thStGreenway22ndAve,01/24/2014 06:00:00 AM,48,-122,5,3,8
559,58thStGreenway22ndAve,01/24/2014 07:00:00 AM,48,-122,14,9,23
560,58thStGreenway22ndAve,01/24/2014 08:00:00 AM,48,-122,12,6,18
561,58thStGreenway22ndAve,01/24/2014 09:00:00 AM,48,-122,22,11,33
562,58thStGreenway22ndAve,01/24/2014 10:00:00 AM,48,-122,8,17,25
563,58thStGreenway22ndAve,01/24/2014 11:00:00 AM,48,-122,24,15,39
564,58thStGreenway22ndAve,01/24/2014 12:00:00 PM,48,-122,26,18,44
565,58thStGreenway22ndAve,01/24/2014 01:00:00 PM,48,-122,25,22,47
566,58thStGreenway22ndAve,01/24/2014 02:00:00 PM,48,-122,14,11,25
567,58thStGreenway22ndAve,01/24/2014 03:00:00 PM,48,-122,18,14,32
568,58thStGreenway22ndAve,01/24/2014 04:00:00 PM,48,-122,30,28,58
569,58thStGreenway22ndAve,01/24/2014 05:00:00 PM,48,-122,30,15,45
570,58thStGreenway22ndAve,01/24/2014 06:00:00 PM,48,-122,32,9,41
571,58thStGreenway22ndAve,01/24/2014 07:00:00 PM,48,-122,24,12,36
572,58thStGreenway22ndAve,01/24/2014 08:00:00 PM,48,-122,21,2,23
573,58thStGreenway22ndAve,01/24/2014 09:00:00 PM,48,-122,7,6,13
574,58thStGreenway22ndAve,01/24/2014 10:00:00 PM,48,-122,8,5,13
575,58thStGreenway22ndAve,01/24/2014 11:00:00 PM,48,-122,4,3,7
576,58thStGreenway22ndAve,01/25/2014 12:00:00 AM,48,-122,5,4,9
577,58thStGreenway22ndAve,01/25/2014 01:00:00 AM,48,-122,0,2,2
578,58thStGreenway22ndAve,01/25/2014 02:00:00 AM,48,-122,0,3,3
579,58thStGreenway22ndAve,01/25/2014 03:00:00 AM,48,-122,0,0,0
580,58thStGreenway22ndAve,01/25/2014 04:00:00 AM,48,-122,1,0,1
581,58thStGreenway22ndAve,01/25/2014 05:00:00 AM,48,-122,0,0,0
582,58thStGreenway22ndAve,01/25/2014 06:00:00 AM,48,-122,2,1,3
583,58thStGreenway22ndAve,01/25/2014 07:00:00 AM,48,-122,7,0,7
584,58thStGreenway22ndAve,01/25/2014 08:00:00 AM,48,-122,10,8,18
585,58thStGreenway22ndAve,01/25/2014 09:00:00 AM,48,-122,19,7,26
586,58thStGreenway22ndAve,01/25/2014 10:00:00 AM,48,-122,7,26,33
587,58thStGreenway22ndAve,01/25/2014 11:00:00 AM,48,-122,34,34,68
588,58thStGreenway22ndAve,01/25/2014 12:00:00 PM,48,-122,46,35,81
589,58thStGreenway22ndAve,01/25/2014 01:00:00 PM,48,-122,39,43,82
590,58thStGreenway22ndAve,01/25/2014 02:00:00 PM,48,-122,61,40,101
591,58thStGreenway22ndAve,01/25/2014 03:00:00 PM,48,-122,32,20,52
592,58thStGreenway22ndAve,01/25/2014 04:00:00 PM,48,-122,34,25,59
593,58thStGreenway22ndAve,01/25/2014 05:00:00 PM,48,-122,26,10,36
594,58thStGreenway22ndAve,01/25/2014 06:00:00 PM,48,-122,44,15,59
595,58thStGreenway22ndAve,01/25/2014 07:00:00 PM,48,-122,27,18,45
596,58thStGreenway22ndAve,01/25/2014 08:00:00 PM,48,-122,10,8,18
597,58thStGreenway22ndAve,01/25/2014 09:00:00 PM,48,-122,6,9,15
598,58thStGreenway22ndAve,01/25/2014 10:00:00 PM,48,-122,13,11,24
599,58thStGreenway22ndAve,01/25/2014 11:00:00 PM,48,-122,14,4,18
600,58thStGreenway22ndAve,01/26/2014 12:00:00 AM,48,-122,6,0,6
601,58thStGreenway22ndAve,01/26/2014 01:00:00 AM,48,-122,1,3,4
602,58thStGreenway22ndAve,01/26/2014 02:00:00 AM,48,-122,0,0,0
603,58thStGreenway22ndAve,01/26/2014 03:00:00 AM,48,-122,0,1,1
604,58thStGreenway22ndAve,01/26/2014 04:00:00 AM,48,-122,0,0,0
605,58thStGreenway22ndAve,01/26/2014 05:00:00 AM,48,-122,6,0,6
606,58thStGreenway22ndAve,01/26/2014 06:00:00 AM,48,-122,0,1,1
607,58thStGreenway22ndAve,01/26/2014 07:00:00 AM,48,-122,2,0,2
608,58thStGreenway22ndAve,01/26/2014 08:00:00 AM,48,-122,5,1,6
609,58thStGreenway22ndAve,01/26/2014 09:00:00 AM,48,-122,11,7,18
610,58thStGreenway22ndAve,01/26/2014 10:00:00 AM,48,-122,30,24,54
611,58thStGreenway22ndAve,01/26/2014 11:00:00 AM,48,-122,23,24,47
612,58thStGreenway22ndAve,01/26/2014 12:00:00 PM,48,-122,45,26,71
613,58thStGreenway22ndAve,01/26/2014 01:00:00 PM,48,-122,29,25,54
614,58thStGreenway22ndAve,01/26/2014 02:00:00 PM,48,-122,45,14,59
615,58thStGreenway22ndAve,01/26/2014 03:00:00 PM,48,-122,23,17,40
616,58thStGreenway22ndAve,01/26/2014 04:00:00 PM,48,-122,43,14,57
617,58thStGreenway22ndAve,01/26/2014 05:00:00 PM,48,-122,24,14,38
618,58thStGreenway22ndAve,01/26/2014 06:00:00 PM,48,-122,18,9,27
619,58thStGreenway22ndAve,01/26/2014 07:00:00 PM,48,-122,11,1,12
620,58thStGreenway22ndAve,01/26/2014 08:00:00 PM,48,-122,10,5,15
621,58thStGreenway22ndAve,01/26/2014 09:00:00 PM,48,-122,9,3,12
622,58thStGreenway22ndAve,01/26/2014 10:00:00 PM,48,-122,4,4,8
623,58thStGreenway22ndAve,01/26/2014 11:00:00 PM,48,-122,1,2,3
624,58thStGreenway22ndAve,01/27/2014 12:00:00 AM,48,-122,1,0,1
625,58thStGreenway22ndAve,01/27/2014 01:00:00 AM,48,-122,2,2,4
626,58thStGreenway22ndAve,01/27/2014 02:00:00 AM,48,-122,2,0,2
627,58thStGreenway22ndAve,01/27/2014 03:00:00 AM,48,-122,2,0,2
628,58thStGreenway22ndAve,01/27/2014 04:00:00 AM,48,-122,0,0,0
629,58thStGreenway22ndAve,01/27/2014 05:00:00 AM,48,-122,2,1,3
630,58thStGreenway22ndAve,01/27/2014 06:00:00 AM,48,-122,9,1,10
631,58thStGreenway22ndAve,01/27/2014 07:00:00 AM,48,-122,17,10,27
632,58thStGreenway22ndAve,01/27/2014 08:00:00 AM,48,-122,14,13,27
633,58thStGreenway22ndAve,01/27/2014 09:00:00 AM,48,-122,7,17,24
634,58thStGreenway22ndAve,01/27/2014 10:00:00 AM,48,-122,7,6,13
635,58thStGreenway22ndAve,01/27/2014 11:00:00 AM,48,-122,6,14,20
636,58thStGreenway22ndAve,01/27/2014 12:00:00 PM,48,-122,7,9,16
637,58thStGreenway22ndAve,01/27/2014 01:00:00 PM,48,-122,14,10,24
638,58thStGreenway22ndAve,01/27/2014 02:00:00 PM,48,-122,16,19,35
639,58thStGreenway22ndAve,01/27/2014 03:00:00 PM,48,-122,16,17,33
640,58thStGreenway22ndAve,01/27/2014 04:00:00 PM,48,-122,8,14,22
641,58thStGreenway22ndAve,01/27/2014 05:00:00 PM,48,-122,10,12,22
642,58thStGreenway22ndAve,01/27/2014 06:00:00 PM,48,-122,8,10,18
643,58thStGreenway22ndAve,01/27/2014 07:00:00 PM,48,-122,10,13,23
644,58thStGreenway22ndAve,01/27/2014 08:00:00 PM,48,-122,6,6,12
645,58thStGreenway22ndAve,01/27/2014 09:00:00 PM,48,-122,5,4,9
646,58thStGreenway22ndAve,01/27/2014 10:00:00 PM,48,-122,8,3,11
647,58thStGreenway22ndAve,01/27/2014 11:00:00 PM,48,-122,5,3,8
648,58thStGreenway22ndAve,01/28/2014 12:00:00 AM,48,-122,4,2,6
649,58thStGreenway22ndAve,01/28/2014 01:00:00 AM,48,-122,0,0,0
650,58thStGreenway22ndAve,01/28/2014 02:00:00 AM,48,-122,2,0,2
651,58thStGreenway22ndAve,01/28/2014 03:00:00 AM,48,-122,0,0,0
652,58thStGreenway22ndAve,01/28/2014 04:00:00 AM,48,-122,0,0,0
653,58thStGreenway22ndAve,01/28/2014 05:00:00 AM,48,-122,0,6,6
654,58thStGreenway22ndAve,01/28/2014 06:00:00 AM,48,-122,8,7,15
655,58thStGreenway22ndAve,01/28/2014 07:00:00 AM,48,-122,18,6,24
656,58thStGreenway22ndAve,01/28/2014 08:00:00 AM,48,-122,17,12,29
657,58thStGreenway22ndAve,01/28/2014 09:00:00 AM,48,-122,19,21,40
658,58thStGreenway22ndAve,01/28/2014 10:00:00 AM,48,-122,6,8,14
659,58thStGreenway22ndAve,01/28/2014 11:00:00 AM,48,-122,13,1,14
660,58thStGreenway22ndAve,01/28/2014 12:00:00 PM,48,-122,22,12,34
661,58thStGreenway22ndAve,01/28/2014 01:00:00 PM,48,-122,33,17,50
662,58thStGreenway22ndAve,01/28/2014 02:00:00 PM,48,-122,15,14,29
663,58thStGreenway22ndAve,01/28/2014 03:00:00 PM,48,-122,10,7,17
664,58thStGreenway22ndAve,01/28/2014 04:00:00 PM,48,-122,19,21,40
665,58thStGreenway22ndAve,01/28/2014 05:00:00 PM,48,-122,14,12,26
666,58thStGreenway22ndAve,01/28/2014 06:00:00 PM,48,-122,13,21,34
667,58thStGreenway22ndAve,01/28/2014 07:00:00 PM,48,-122,6,9,15
668,58thStGreenway22ndAve,01/28/2014 08:00:00 PM,48,-122,2,2,4
669,58thStGreenway22ndAve,01/28/2014 09:00:00 PM,48,-122,8,10,18
670,58thStGreenway22ndAve,01/28/2014 10:00:00 PM,48,-122,5,13,18
671,58thStGreenway22ndAve,01/28/2014 11:00:00 PM,48,-122,0,0,0
672,58thStGreenway22ndAve,01/29/2014 12:00:00 AM,48,-122,0,3,3
673,58thStGreenway22ndAve,01/29/2014 01:00:00 AM,48,-122,0,2,2
674,58thStGreenway22ndAve,01/29/2014 02:00:00 AM,48,-122,0,2,2
675,58thStGreenway22ndAve,01/29/2014 03:00:00 AM,48,-122,0,2,2
676,58thStGreenway22ndAve,01/29/2014 04:00:00 AM,48,-122,0,0,0
677,58thStGreenway22ndAve,01/29/2014 05:00:00 AM,48,-122,4,3,7
678,58thStGreenway22ndAve,01/29/2014 06:00:00 AM,48,-122,12,3,15
679,58thStGreenway22ndAve,01/29/2014 07:00:00 AM,48,-122,13,8,21
680,58thStGreenway22ndAve,01/29/2014 08:00:00 AM,48,-122,7,7,14
681,58thStGreenway22ndAve,01/29/2014 09:00:00 AM,48,-122,10,16,26
682,58thStGreenway22ndAve,01/29/2014 10:00:00 AM,48,-122,10,7,17
683,58thStGreenway22ndAve,01/29/2014 11:00:00 AM,48,-122,5,18,23
684,58thStGreenway22ndAve,01/29/2014 12:00:00 PM,48,-122,6,13,19
685,58thStGreenway22ndAve,01/29/2014 01:00:00 PM,48,-122,8,4,12
686,58thStGreenway22ndAve,01/29/2014 02:00:00 PM,48,-122,12,17,29
687,58thStGreenway22ndAve,01/29/2014 03:00:00 PM,48,-122,10,8,18
688,58thStGreenway22ndAve,01/29/2014 04:00:00 PM,48,-122,18,16,34
689,58thStGreenway22ndAve,01/29/2014 05:00:00 PM,48,-122,12,18,30
690,58thStGreenway22ndAve,01/29/2014 06:00:00 PM,48,-122,6,17,23
691,58thStGreenway22ndAve,01/29/2014 07:00:00 PM,48,-122,10,12,22
692,58thStGreenway22ndAve,01/29/2014 08:00:00 PM,48,-122,9,11,20
693,58thStGreenway22ndAve,01/29/2014 09:00:00 PM,48,-122,6,3,9
694,58thStGreenway22ndAve,01/29/2014 10:00:00 PM,48,-122,0,8,8
695,58thStGreenway22ndAve,01/29/2014 11:00:00 PM,48,-122,3,3,6
696,58thStGreenway22ndAve,01/30/2014 12:00:00 AM,48,-122,3,2,5
697,58thStGreenway22ndAve,01/30/2014 01:00:00 AM,48,-122,0,0,0
698,58thStGreenway22ndAve,01/30/2014 02:00:00 AM,48,-122,0,1,1
699,58thStGreenway22ndAve,01/30/2014 03:00:00 AM,48,-122,0,1,1
700,58thStGreenway22ndAve,01/30/2014 04:00:00 AM,48,-122,0,2,2
701,58thStGreenway22ndAve,01/30/2014 05:00:00 AM,48,-122,0,2,2
702,58thStGreenway22ndAve,01/30/2014 06:00:00 AM,48,-122,8,6,14
703,58thStGreenway22ndAve,01/30/2014 07:00:00 AM,48,-122,10,7,17
704,58thStGreenway22ndAve,01/30/2014 08:00:00 AM,48,-122,14,10,24
705,58thStGreenway22ndAve,01/30/2014 09:00:00 AM,48,-122,25,14,39
706,58thStGreenway22ndAve,01/30/2014 10:00:00 AM,48,-122,10,11,21
707,58thStGreenway22ndAve,01/30/2014 11:00:00 AM,48,-122,13,5,18
708,58thStGreenway22ndAve,01/30/2014 12:00:00 PM,48,-122,4,11,15
709,58thStGreenway22ndAve,01/30/2014 01:00:00 PM,48,-122,9,4,13
710,58thStGreenway22ndAve,01/30/2014 02:00:00 PM,48,-122,9,18,27
711,58thStGreenway22ndAve,01/30/2014 03:00:00 PM,48,-122,15,11,26
712,58thStGreenway22ndAve,01/30/2014 04:00:00 PM,48,-122,9,7,16
713,58thStGreenway22ndAve,01/30/2014 05:00:00 PM,48,-122,17,10,27
714,58thStGreenway22ndAve,01/30/2014 06:00:00 PM,48,-122,17,16,33
715,58thStGreenway22ndAve,01/30/2014 07:00:00 PM,48,-122,21,13,34
716,58thStGreenway22ndAve,01/30/2014 08:00:00 PM,48,-122,12,12,24
717,58thStGreenway22ndAve,01/30/2014 09:00:00 PM,48,-122,3,3,6
718,58thStGreenway22ndAve,01/30/2014 10:00:00 PM,48,-122,10,4,14
719,58thStGreenway22ndAve,01/30/2014 11:00:00 PM,48,-122,2,1,3
720,58thStGreenway22ndAve,01/31/2014 12:00:00 AM,48,-122,4,5,9
721,58thStGreenway22ndAve,01/31/2014 01:00:00 AM,48,-122,0,2,2
722,58thStGreenway22ndAve,01/31/2014 02:00:00 AM,48,-122,0,8,8
723,58thStGreenway22ndAve,01/31/2014 03:00:00 AM,48,-122,0,2,2
724,58thStGreenway22ndAve,01/31/2014 04:00:00 AM,48,-122,0,0,0
725,58thStGreenway22ndAve,01/31/2014 05:00:00 AM,48,-122,0,0,0
726,58thStGreenway22ndAve,01/31/2014 06:00:00 AM,48,-122,12,6,18
727,58thStGreenway22ndAve,01/31/2014 07:00:00 AM,48,-122,9,11,20
728,58thStGreenway22ndAve,01/31/2014 08:00:00 AM,48,-122,17,10,27
729,58thStGreenway22ndAve,01/31/2014 09:00:00 AM,48,-122,13,9,22
730,58thStGreenway22ndAve,01/31/2014 10:00:00 AM,48,-122,14,22,36
731,58thStGreenway22ndAve,01/31/2014 11:00:00 AM,48,-122,20,24,44
732,58thStGreenway22ndAve,01/31/2014 12:00:00 PM,48,-122,26,16,42
733,58thStGreenway22ndAve,01/31/2014 01:00:00 PM,48,-122,22,12,34
734,58thStGreenway22ndAve,01/31/2014 02:00:00 PM,48,-122,23,30,53
735,58thStGreenway22ndAve,01/31/2014 03:00:00 PM,48,-122,15,14,29
736,58thStGreenway22ndAve,01/31/2014 04:00:00 PM,48,-122,23,18,41
737,58thStGreenway22ndAve,01/31/2014 05:00:00 PM,48,-122,19,30,49
738,58thStGreenway22ndAve,01/31/2014 06:00:00 PM,48,-122,15,15,30
739,58thStGreenway22ndAve,01/31/2014 07:00:00 PM,48,-122,12,29,41
740,58thStGreenway22ndAve,01/31/2014 08:00:00 PM,48,-122,10,15,25
741,58thStGreenway22ndAve,01/31/2014 09:00:00 PM,48,-122,6,6,12
742,58thStGreenway22ndAve,01/31/2014 10:00:00 PM,48,-122,6,9,15
743,58thStGreenway22ndAve,01/31/2014 11:00:00 PM,48,-122,12,6,18
744,58thStGreenway22ndAve,02/01/2014 12:00:00 AM,48,-122,2,0,2
745,58thStGreenway22ndAve,02/01/2014 01:00:00 AM,48,-122,0,0,0
746,58thStGreenway22ndAve,02/01/2014 02:00:00 AM,48,-122,1,0,1
747,58thStGreenway22ndAve,02/01/2014 03:00:00 AM,48,-122,0,0,0
748,58thStGreenway22ndAve,02/01/2014 04:00:00 AM,48,-122,1,3,4
749,58thStGreenway22ndAve,02/01/2014 05:00:00 AM,48,-122,0,0,0
750,58thStGreenway22ndAve,02/01/2014 06:00:00 AM,48,-122,1,0,1
751,58thStGreenway22ndAve,02/01/2014 07:00:00 AM,48,-122,2,0,2
752,58thStGreenway22ndAve,02/01/2014 08:00:00 AM,48,-122,4,7,11
753,58thStGreenway22ndAve,02/01/2014 09:00:00 AM,48,-122,13,10,23
754,58thStGreenway22ndAve,02/01/2014 10:00:00 AM,48,-122,20,10,30
755,58thStGreenway22ndAve,02/01/2014 11:00:00 AM,48,-122,15,28,43
756,58thStGreenway22ndAve,02/01/2014 12:00:00 PM,48,-122,20,35,55
757,58thStGreenway22ndAve,02/01/2014 01:00:00 PM,48,-122,40,39,79
758,58thStGreenway22ndAve,02/01/2014 02:00:00 PM,48,-122,28,36,64
759,58thStGreenway22ndAve,02/01/2014 03:00:00 PM,48,-122,20,12,32
760,58thStGreenway22ndAve,02/01/2014 04:00:00 PM,48,-122,24,23,47
761,58thStGreenway22ndAve,02/01/2014 05:00:00 PM,48,-122,15,18,33
762,58thStGreenway22ndAve,02/01/2014 06:00:00 PM,48,-122,14,16,30
763,58thStGreenway22ndAve,02/01/2014 07:00:00 PM,48,-122,12,16,28
764,58thStGreenway22ndAve,02/01/2014 08:00:00 PM,48,-122,16,3,19
765,58thStGreenway22ndAve,02/01/2014 09:00:00 PM,48,-122,16,8,24
766,58thStGreenway22ndAve,02/01/2014 10:00:00 PM,48,-122,1,14,15
767,58thStGreenway22ndAve,02/01/2014 11:00:00 PM,48,-122,2,3,5
768,58thStGreenway22ndAve,02/02/2014 12:00:00 AM,48,-122,3,3,6
769,58thStGreenway22ndAve,02/02/2014 01:00:00 AM,48,-122,6,0,6
770,58thStGreenway22ndAve,02/02/2014 02:00:00 AM,48,-122,0,0,0
771,58thStGreenway22ndAve,02/02/2014 03:00:00 AM,48,-122,2,2,4
772,58thStGreenway22ndAve,02/02/2014 04:00:00 AM,48,-122,2,2,4
773,58thStGreenway22ndAve,02/02/2014 05:00:00 AM,48,-122,0,3,3
774,58thStGreenway22ndAve,02/02/2014 06:00:00 AM,48,-122,2,0,2
775,58thStGreenway22ndAve,02/02/2014 07:00:00 AM,48,-122,4,1,5
776,58thStGreenway22ndAve,02/02/2014 08:00:00 AM,48,-122,8,3,11
777,58thStGreenway22ndAve,02/02/2014 09:00:00 AM,48,-122,8,2,10
778,58thStGreenway22ndAve,02/02/2014 10:00:00 AM,48,-122,16,20,36
779,58thStGreenway22ndAve,02/02/2014 11:00:00 AM,48,-122,23,21,44
780,58thStGreenway22ndAve,02/02/2014 12:00:00 PM,48,-122,12,18,30
781,58thStGreenway22ndAve,02/02/2014 01:00:00 PM,48,-122,21,21,42
782,58thStGreenway22ndAve,02/02/2014 02:00:00 PM,48,-122,37,37,74
783,58thStGreenway22ndAve,02/02/2014 03:00:00 PM,48,-122,17,8,25
784,58thStGreenway22ndAve,02/02/2014 04:00:00 PM,48,-122,4,10,14
785,58thStGreenway22ndAve,02/02/2014 05:00:00 PM,48,-122,8,2,10
786,58thStGreenway22ndAve,02/02/2014 06:00:00 PM,48,-122,4,0,4
787,58thStGreenway22ndAve,02/02/2014 07:00:00 PM,48,-122,13,7,20
788,58thStGreenway22ndAve,02/02/2014 08:00:00 PM,48,-122,14,10,24
789,58thStGreenway22ndAve,02/02/2014 09:00:00 PM,48,-122,12,10,22
790,58thStGreenway22ndAve,02/02/2014 10:00:00 PM,48,-122,2,4,6
791,58thStGreenway22ndAve,02/02/2014 11:00:00 PM,48,-122,3,4,7
792,58thStGreenway22ndAve,02/03/2014 12:00:00 AM,48,-122,4,2,6
793,58thStGreenway22ndAve,02/03/2014 01:00:00 AM,48,-122,0,2,2
794,58thStGreenway22ndAve,02/03/2014 02:00:00 AM,48,-122,0,0,0
795,58thStGreenway22ndAve,02/03/2014 03:00:00 AM,48,-122,0,0,0
796,58thStGreenway22ndAve,02/03/2014 04:00:00 AM,48,-122,2,0,2
797,58thStGreenway22ndAve,02/03/2014 05:00:00 AM,48,-122,1,1,2
798,58thStGreenway22ndAve,02/03/2014 06:00:00 AM,48,-122,6,9,15
799,58thStGreenway22ndAve,02/03/2014 07:00:00 AM,48,-122,17,4,21
800,58thStGreenway22ndAve,02/03/2014 08:00:00 AM,48,-122,13,17,30
801,58thStGreenway22ndAve,02/03/2014 09:00:00 AM,48,-122,13,17,30
802,58thStGreenway22ndAve,02/03/2014 10:00:00 AM,48,-122,14,19,33
803,58thStGreenway22ndAve,02/03/2014 11:00:00 AM,48,-122,10,7,17
804,58thStGreenway22ndAve,02/03/2014 12:00:00 PM,48,-122,19,17,36
805,58thStGreenway22ndAve,02/03/2014 01:00:00 PM,48,-122,17,18,35
806,58thStGreenway22ndAve,02/03/2014 02:00:00 PM,48,-122,7,14,21
807,58thStGreenway22ndAve,02/03/2014 03:00:00 PM,48,-122,13,22,35
808,58thStGreenway22ndAve,02/03/2014 04:00:00 PM,48,-122,22,15,37
809,58thStGreenway22ndAve,02/03/2014 05:00:00 PM,48,-122,13,17,30
810,58thStGreenway22ndAve,02/03/2014 06:00:00 PM,48,-122,17,19,36
811,58thStGreenway22ndAve,02/03/2014 07:00:00 PM,48,-122,2,12,14
812,58thStGreenway22ndAve,02/03/2014 08:00:00 PM,48,-122,5,5,10
813,58thStGreenway22ndAve,02/03/2014 09:00:00 PM,48,-122,7,4,11
814,58thStGreenway22ndAve,02/03/2014 10:00:00 PM,48,-122,4,0,4
815,58thStGreenway22ndAve,02/03/2014 11:00:00 PM,48,-122,2,0,2
816,58thStGreenway22ndAve,02/04/2014 12:00:00 AM,48,-122,3,0,3
817,58thStGreenway22ndAve,02/04/2014 01:00:00 AM,48,-122,0,0,0
818,58thStGreenway22ndAve,02/04/2014 02:00:00 AM,48,-122,2,0,2
819,58thStGreenway22ndAve,02/04/2014 03:00:00 AM,48,-122,0,0,0
820,58thStGreenway22ndAve,02/04/2014 04:00:00 AM,48,-122,0,0,0
821,58thStGreenway22ndAve,02/04/2014 05:00:00 AM,48,-122,0,2,2
822,58thStGreenway22ndAve,02/04/2014 06:00:00 AM,48,-122,6,7,13
823,58thStGreenway22ndAve,02/04/2014 07:00:00 AM,48,-122,16,7,23
824,58thStGreenway22ndAve,02/04/2014 08:00:00 AM,48,-122,14,11,25
825,58thStGreenway22ndAve,02/04/2014 09:00:00 AM,48,-122,23,20,43
826,58thStGreenway22ndAve,02/04/2014 10:00:00 AM,48,-122,18,23,41
827,58thStGreenway22ndAve,02/04/2014 11:00:00 AM,48,-122,16,21,37
828,58thStGreenway22ndAve,02/04/2014 12:00:00 PM,48,-122,15,8,23
829,58thStGreenway22ndAve,02/04/2014 01:00:00 PM,48,-122,18,10,28
830,58thStGreenway22ndAve,02/04/2014 02:00:00 PM,48,-122,17,10,27
831,58thStGreenway22ndAve,02/04/2014 03:00:00 PM,48,-122,18,16,34
832,58thStGreenway22ndAve,02/04/2014 04:00:00 PM,48,-122,30,16,46
833,58thStGreenway22ndAve,02/04/2014 05:00:00 PM,48,-122,29,46,75
834,58thStGreenway22ndAve,02/04/2014 06:00:00 PM,48,-122,12,24,36
835,58thStGreenway22ndAve,02/04/2014 07:00:00 PM,48,-122,15,14,29
836,58thStGreenway22ndAve,02/04/2014 08:00:00 PM,48,-122,10,7,17
837,58thStGreenway22ndAve,02/04/2014 09:00:00 PM,48,-122,4,6,10
838,58thStGreenway22ndAve,02/04/2014 10:00:00 PM,48,-122,4,2,6
839,58thStGreenway22ndAve,02/04/2014 11:00:00 PM,48,-122,0,4,4
840,58thStGreenway22ndAve,02/05/2014 12:00:00 AM,48,-122,6,0,6
841,58thStGreenway22ndAve,02/05/2014 01:00:00 AM,48,-122,0,0,0
842,58thStGreenway22ndAve,02/05/2014 02:00:00 AM,48,-122,0,6,6
843,58thStGreenway22ndAve,02/05/2014 03:00:00 AM,48,-122,0,4,4
844,58thStGreenway22ndAve,02/05/2014 04:00:00 AM,48,-122,0,0,0
845,58thStGreenway22ndAve,02/05/2014 05:00:00 AM,48,-122,0,0,0
846,58thStGreenway22ndAve,02/05/2014 06:00:00 AM,48,-122,9,3,12
847,58thStGreenway22ndAve,02/05/2014 07:00:00 AM,48,-122,25,9,34
848,58thStGreenway22ndAve,02/05/2014 08:00:00 AM,48,-122,20,25,45
849,58thStGreenway22ndAve,02/05/2014 09:00:00 AM,48,-122,24,24,48
850,58thStGreenway22ndAve,02/05/2014 10:00:00 AM,48,-122,14,10,24
851,58thStGreenway22ndAve,02/05/2014 11:00:00 AM,48,-122,9,16,25
852,58thStGreenway22ndAve,02/05/2014 12:00:00 PM,48,-122,11,11,22
853,58thStGreenway22ndAve,02/05/2014 01:00:00 PM,48,-122,21,8,29
854,58thStGreenway22ndAve,02/05/2014 02:00:00 PM,48,-122,20,22,42
855,58thStGreenway22ndAve,02/05/2014 03:00:00 PM,48,-122,9,19,28
856,58thStGreenway22ndAve,02/05/2014 04:00:00 PM,48,-122,22,28,50
857,58thStGreenway22ndAve,02/05/2014 05:00:00 PM,48,-122,23,7,30
858,58thStGreenway22ndAve,02/05/2014 06:00:00 PM,48,-122,14,33,47
859,58thStGreenway22ndAve,02/05/2014 07:00:00 PM,48,-122,8,7,15
860,58thStGreenway22ndAve,02/05/2014 08:00:00 PM,48,-122,11,4,15
861,58thStGreenway22ndAve,02/05/2014 09:00:00 PM,48,-122,6,3,9
862,58thStGreenway22ndAve,02/05/2014 10:00:00 PM,48,-122,5,0,5
863,58thStGreenway22ndAve,02/05/2014 11:00:00 PM,48,-122,2,1,3
864,58thStGreenway22ndAve,02/06/2014 12:00:00 AM,48,-122,4,1,5
865,58thStGreenway22ndAve,02/06/2014 01:00:00 AM,48,-122,2,0,2
866,58thStGreenway22ndAve,02/06/2014 02:00:00 AM,48,-122,0,2,2
867,58thStGreenway22ndAve,02/06/2014 03:00:00 AM,48,-122,0,0,0
868,58thStGreenway22ndAve,02/06/2014 04:00:00 AM,48,-122,0,0,0
869,58thStGreenway22ndAve,02/06/2014 05:00:00 AM,48,-122,4,5,9
870,58thStGreenway22ndAve,02/06/2014 06:00:00 AM,48,-122,1,6,7
871,58thStGreenway22ndAve,02/06/2014 07:00:00 AM,48,-122,17,11,28
872,58thStGreenway22ndAve,02/06/2014 08:00:00 AM,48,-122,27,23,50
873,58thStGreenway22ndAve,02/06/2014 09:00:00 AM,48,-122,6,37,43
874,58thStGreenway22ndAve,02/06/2014 10:00:00 AM,48,-122,10,17,27
875,58thStGreenway22ndAve,02/06/2014 11:00:00 AM,48,-122,14,36,50
876,58thStGreenway22ndAve,02/06/2014 12:00:00 PM,48,-122,9,26,35
877,58thStGreenway22ndAve,02/06/2014 01:00:00 PM,48,-122,16,23,39
878,58thStGreenway22ndAve,02/06/2014 02:00:00 PM,48,-122,17,21,38
879,58thStGreenway22ndAve,02/06/2014 03:00:00 PM,48,-122,7,23,30
880,58thStGreenway22ndAve,02/06/2014 04:00:00 PM,48,-122,9,12,21
881,58thStGreenway22ndAve,02/06/2014 05:00:00 PM,48,-122,13,30,43
882,58thStGreenway22ndAve,02/06/2014 06:00:00 PM,48,-122,6,19,25
883,58thStGreenway22ndAve,02/06/2014 07:00:00 PM,48,-122,6,15,21
884,58thStGreenway22ndAve,02/06/2014 08:00:00 PM,48,-122,7,7,14
885,58thStGreenway22ndAve,02/06/2014 09:00:00 PM,48,-122,7,8,15
886,58thStGreenway22ndAve,02/06/2014 10:00:00 PM,48,-122,4,2,6
887,58thStGreenway22ndAve,02/06/2014 11:00:00 PM,48,-122,4,1,5
888,58thStGreenway22ndAve,02/07/2014 12:00:00 AM,48,-122,2,0,2
889,58thStGreenway22ndAve,02/07/2014 01:00:00 AM,48,-122,6,0,6
890,58thStGreenway22ndAve,02/07/2014 02:00:00 AM,48,-122,1,0,1
891,58thStGreenway22ndAve,02/07/2014 03:00:00 AM,48,-122,0,2,2
892,58thStGreenway22ndAve,02/07/2014 04:00:00 AM,48,-122,0,0,0
893,58thStGreenway22ndAve,02/07/2014 05:00:00 AM,48,-122,0,3,3
894,58thStGreenway22ndAve,02/07/2014 06:00:00 AM,48,-122,11,5,16
895,58thStGreenway22ndAve,02/07/2014 07:00:00 AM,48,-122,35,23,58
896,58thStGreenway22ndAve,02/07/2014 08:00:00 AM,48,-122,14,7,21
897,58thStGreenway22ndAve,02/07/2014 09:00:00 AM,48,-122,38,13,51
898,58thStGreenway22ndAve,02/07/2014 10:00:00 AM,48,-122,23,9,32
899,58thStGreenway22ndAve,02/07/2014 11:00:00 AM,48,-122,30,22,52
900,58thStGreenway22ndAve,02/07/2014 12:00:00 PM,48,-122,23,39,62
901,58thStGreenway22ndAve,02/07/2014 01:00:00 PM,48,-122,27,30,57
902,58thStGreenway22ndAve,02/07/2014 02:00:00 PM,48,-122,32,18,50
903,58thStGreenway22ndAve,02/07/2014 03:00:00 PM,48,-122,21,19,40
904,58thStGreenway22ndAve,02/07/2014 04:00:00 PM,48,-122,16,24,40
905,58thStGreenway22ndAve,02/07/2014 05:00:00 PM,48,-122,21,34,55
906,58thStGreenway22ndAve,02/07/2014 06:00:00 PM,48,-122,12,30,42
907,58thStGreenway22ndAve,02/07/2014 07:00:00 PM,48,-122,34,37,71
908,58thStGreenway22ndAve,02/07/2014 08:00:00 PM,48,-122,18,5,23
909,58thStGreenway22ndAve,02/07/2014 09:00:00 PM,48,-122,2,8,10
910,58thStGreenway22ndAve,02/07/2014 10:00:00 PM,48,-122,4,0,4
911,58thStGreenway22ndAve,02/07/2014 11:00:00 PM,48,-122,9,6,15
912,58thStGreenway22ndAve,02/08/2014 12:00:00 AM,48,-122,3,1,4
913,58thStGreenway22ndAve,02/08/2014 01:00:00 AM,48,-122,0,0,0
914,58thStGreenway22ndAve,02/08/2014 02:00:00 AM,48,-122,0,0,0
915,58thStGreenway22ndAve,02/08/2014 03:00:00 AM,48,-122,0,2,2
916,58thStGreenway22ndAve,02/08/2014 04:00:00 AM,48,-122,2,6,8
917,58thStGreenway22ndAve,02/08/2014 05:00:00 AM,48,-122,4,1,5
918,58thStGreenway22ndAve,02/08/2014 06:00:00 AM,48,-122,4,0,4
919,58thStGreenway22ndAve,02/08/2014 07:00:00 AM,48,-122,3,6,9
920,58thStGreenway22ndAve,02/08/2014 08:00:00 AM,48,-122,3,9,12
921,58thStGreenway22ndAve,02/08/2014 09:00:00 AM,48,-122,13,14,27
922,58thStGreenway22ndAve,02/08/2014 10:00:00 AM,48,-122,27,26,53
923,58thStGreenway22ndAve,02/08/2014 11:00:00 AM,48,-122,25,50,75
924,58thStGreenway22ndAve,02/08/2014 12:00:00 PM,48,-122,48,33,81
925,58thStGreenway22ndAve,02/08/2014 01:00:00 PM,48,-122,59,34,93
926,58thStGreenway22ndAve,02/08/2014 02:00:00 PM,48,-122,26,37,63
927,58thStGreenway22ndAve,02/08/2014 03:00:00 PM,48,-122,38,21,59
928,58thStGreenway22ndAve,02/08/2014 04:00:00 PM,48,-122,24,35,59
929,58thStGreenway22ndAve,02/08/2014 05:00:00 PM,48,-122,37,24,61
930,58thStGreenway22ndAve,02/08/2014 06:00:00 PM,48,-122,13,18,31
931,58thStGreenway22ndAve,02/08/2014 07:00:00 PM,48,-122,18,23,41
932,58thStGreenway22ndAve,02/08/2014 08:00:00 PM,48,-122,6,10,16
933,58thStGreenway22ndAve,02/08/2014 09:00:00 PM,48,-122,2,3,5
934,58thStGreenway22ndAve,02/08/2014 10:00:00 PM,48,-122,3,4,7
935,58thStGreenway22ndAve,02/08/2014 11:00:00 PM,48,-122,2,0,2
936,58thStGreenway22ndAve,02/09/2014 12:00:00 AM,48,-122,2,2,4
937,58thStGreenway22ndAve,02/09/2014 01:00:00 AM,48,-122,2,0,2
938,58thStGreenway22ndAve,02/09/2014 02:00:00 AM,48,-122,0,0,0
939,58thStGreenway22ndAve,02/09/2014 03:00:00 AM,48,-122,0,2,2
940,58thStGreenway22ndAve,02/09/2014 04:00:00 AM,48,-122,2,2,4
941,58thStGreenway22ndAve,02/09/2014 05:00:00 AM,48,-122,0,0,0
942,58thStGreenway22ndAve,02/09/2014 06:00:00 AM,48,-122,0,0,0
943,58thStGreenway22ndAve,02/09/2014 07:00:00 AM,48,-122,0,0,0
944,58thStGreenway22ndAve,02/09/2014 08:00:00 AM,48,-122,1,4,5
945,58thStGreenway22ndAve,02/09/2014 09:00:00 AM,48,-122,2,5,7
946,58thStGreenway22ndAve,02/09/2014 10:00:00 AM,48,-122,3,6,9
947,58thStGreenway22ndAve,02/09/2014 11:00:00 AM,48,-122,4,10,14
948,58thStGreenway22ndAve,02/09/2014 12:00:00 PM,48,-122,20,17,37
949,58thStGreenway22ndAve,02/09/2014 01:00:00 PM,48,-122,18,32,50
950,58thStGreenway22ndAve,02/09/2014 02:00:00 PM,48,-122,12,21,33
951,58thStGreenway22ndAve,02/09/2014 03:00:00 PM,48,-122,9,11,20
952,58thStGreenway22ndAve,02/09/2014 04:00:00 PM,48,-122,11,14,25
953,58thStGreenway22ndAve,02/09/2014 05:00:00 PM,48,-122,6,14,20
954,58thStGreenway22ndAve,02/09/2014 06:00:00 PM,48,-122,12,10,22
955,58thStGreenway22ndAve,02/09/2014 07:00:00 PM,48,-122,5,4,9
956,58thStGreenway22ndAve,02/09/2014 08:00:00 PM,48,-122,3,0,3
957,58thStGreenway22ndAve,02/09/2014 09:00:00 PM,48,-122,14,7,21
958,58thStGreenway22ndAve,02/09/2014 10:00:00 PM,48,-122,3,1,4
959,58thStGreenway22ndAve,02/09/2014 11:00:00 PM,48,-122,5,2,7
960,58thStGreenway22ndAve,02/10/2014 12:00:00 AM,48,-122,2,2,4
961,58thStGreenway22ndAve,02/10/2014 01:00:00 AM,48,-122,0,3,3
962,58thStGreenway22ndAve,02/10/2014 02:00:00 AM,48,-122,0,0,0
963,58thStGreenway22ndAve,02/10/2014 03:00:00 AM,48,-122,0,0,0
964,58thStGreenway22ndAve,02/10/2014 04:00:00 AM,48,-122,2,0,2
965,58thStGreenway22ndAve,02/10/2014 05:00:00 AM,48,-122,3,2,5
966,58thStGreenway22ndAve,02/10/2014 06:00:00 AM,48,-122,5,5,10
967,58thStGreenway22ndAve,02/10/2014 07:00:00 AM,48,-122,15,6,21
968,58thStGreenway22ndAve,02/10/2014 08:00:00 AM,48,-122,21,20,41
969,58thStGreenway22ndAve,02/10/2014 09:00:00 AM,48,-122,12,28,40
970,58thStGreenway22ndAve,02/10/2014 10:00:00 AM,48,-122,10,26,36
971,58thStGreenway22ndAve,02/10/2014 11:00:00 AM,48,-122,16,27,43
972,58thStGreenway22ndAve,02/10/2014 12:00:00 PM,48,-122,21,24,45
973,58thStGreenway22ndAve,02/10/2014 01:00:00 PM,48,-122,18,29,47
974,58thStGreenway22ndAve,02/10/2014 02:00:00 PM,48,-122,26,23,49
975,58thStGreenway22ndAve,02/10/2014 03:00:00 PM,48,-122,13,31,44
976,58thStGreenway22ndAve,02/10/2014 04:00:00 PM,48,-122,24,38,62
977,58thStGreenway22ndAve,02/10/2014 05:00:00 PM,48,-122,21,34,55
978,58thStGreenway22ndAve,02/10/2014 06:00:00 PM,48,-122,23,28,51
979,58thStGreenway22ndAve,02/10/2014 07:00:00 PM,48,-122,17,27,44
980,58thStGreenway22ndAve,02/10/2014 08:00:00 PM,48,-122,9,10,19
981,58thStGreenway22ndAve,02/10/2014 09:00:00 PM,48,-122,5,4,9
982,58thStGreenway22ndAve,02/10/2014 10:00:00 PM,48,-122,1,1,2
983,58thStGreenway22ndAve,02/10/2014 11:00:00 PM,48,-122,0,0,0
984,58thStGreenway22ndAve,02/11/2014 12:00:00 AM,48,-122,5,1,6
985,58thStGreenway22ndAve,02/11/2014 01:00:00 AM,48,-122,0,2,2
986,58thStGreenway22ndAve,02/11/2014 02:00:00 AM,48,-122,0,0,0
987,58thStGreenway22ndAve,02/11/2014 03:00:00 AM,48,-122,0,0,0
988,58thStGreenway22ndAve,02/11/2014 04:00:00 AM,48,-122,1,0,1
989,58thStGreenway22ndAve,02/11/2014 05:00:00 AM,48,-122,1,5,6
990,58thStGreenway22ndAve,02/11/2014 06:00:00 AM,48,-122,12,6,18
991,58thStGreenway22ndAve,02/11/2014 07:00:00 AM,48,-122,9,14,23
992,58thStGreenway22ndAve,02/11/2014 08:00:00 AM,48,-122,4,22,26
993,58thStGreenway22ndAve,02/11/2014 09:00:00 AM,48,-122,15,16,31
994,58thStGreenway22ndAve,02/11/2014 10:00:00 AM,48,-122,17,17,34
995,58thStGreenway22ndAve,02/11/2014 11:00:00 AM,48,-122,23,30,53
996,58thStGreenway22ndAve,02/11/2014 12:00:00 PM,48,-122,24,26,50
997,58thStGreenway22ndAve,02/11/2014 01:00:00 PM,48,-122,20,13,33
998,58thStGreenway22ndAve,02/11/2014 02:00:00 PM,48,-122,10,17,27
999,58thStGreenway22ndAve,02/11/2014 03:00:00 PM,48,-122,19,32,51
1000,58thStGreenway22ndAve,02/11/2014 04:00:00 PM,48,-122,19,17,36
1001,58thStGreenway22ndAve,02/11/2014 05:00:00 PM,48,-122,17,22,39
1002,58thStGreenway22ndAve,02/11/2014 06:00:00 PM,48,-122,17,30,47
1003,58thStGreenway22ndAve,02/11/2014 07:00:00 PM,48,-122,12,13,25
1004,58thStGreenway22ndAve,02/11/2014 08:00:00 PM,48,-122,7,35,42
1005,58thStGreenway22ndAve,02/11/2014 09:00:00 PM,48,-122,10,8,18
1006,58thStGreenway22ndAve,02/11/2014 10:00:00 PM,48,-122,7,7,14
1007,58thStGreenway22ndAve,02/11/2014 11:00:00 PM,48,-122,6,3,9
1008,58thStGreenway22ndAve,02/12/2014 12:00:00 AM,48,-122,2,2,4
1009,58thStGreenway22ndAve,02/12/2014 01:00:00 AM,48,-122,0,4,4
1010,58thStGreenway22ndAve,02/12/2014 02:00:00 AM,48,-122,0,2,2
1011,58thStGreenway22ndAve,02/12/2014 03:00:00 AM,48,-122,0,2,2
1012,58thStGreenway22ndAve,02/12/2014 04:00:00 AM,48,-122,0,0,0
1013,58thStGreenway22ndAve,02/12/2014 05:00:00 AM,48,-122,2,2,4
1014,58thStGreenway22ndAve,02/12/2014 06:00:00 AM,48,-122,5,10,15
1015,58thStGreenway22ndAve,02/12/2014 07:00:00 AM,48,-122,9,11,20
1016,58thStGreenway22ndAve,02/12/2014 08:00:00 AM,48,-122,25,22,47
1017,58thStGreenway22ndAve,02/12/2014 09:00:00 AM,48,-122,23,18,41
1018,58thStGreenway22ndAve,02/12/2014 10:00:00 AM,48,-122,3,17,20
1019,58thStGreenway22ndAve,02/12/2014 11:00:00 AM,48,-122,13,23,36
1020,58thStGreenway22ndAve,02/12/2014 12:00:00 PM,48,-122,9,29,38
1021,58thStGreenway22ndAve,02/12/2014 01:00:00 PM,48,-122,10,23,33
1022,58thStGreenway22ndAve,02/12/2014 02:00:00 PM,48,-122,23,16,39
1023,58thStGreenway22ndAve,02/12/2014 03:00:00 PM,48,-122,22,14,36
1024,58thStGreenway22ndAve,02/12/2014 04:00:00 PM,48,-122,31,13,44
1025,58thStGreenway22ndAve,02/12/2014 05:00:00 PM,48,-122,13,26,39
1026,58thStGreenway22ndAve,02/12/2014 06:00:00 PM,48,-122,20,21,41
1027,58thStGreenway22ndAve,02/12/2014 07:00:00 PM,48,-122,19,13,32
1028,58thStGreenway22ndAve,02/12/2014 08:00:00 PM,48,-122,11,3,14
1029,58thStGreenway22ndAve,02/12/2014 09:00:00 PM,48,-122,11,8,19
1030,58thStGreenway22ndAve,02/12/2014 10:00:00 PM,48,-122,7,3,10
1031,58thStGreenway22ndAve,02/12/2014 11:00:00 PM,48,-122,2,1,3
1032,58thStGreenway22ndAve,02/13/2014 12:00:00 AM,48,-122,4,3,7
1033,58thStGreenway22ndAve,02/13/2014 01:00:00 AM,48,-122,2,3,5
1034,58thStGreenway22ndAve,02/13/2014 02:00:00 AM,48,-122,2,4,6
1035,58thStGreenway22ndAve,02/13/2014 03:00:00 AM,48,-122,0,1,1
1036,58thStGreenway22ndAve,02/13/2014 04:00:00 AM,48,-122,0,0,0
1037,58thStGreenway22ndAve,02/13/2014 05:00:00 AM,48,-122,0,2,2
1038,58thStGreenway22ndAve,02/13/2014 06:00:00 AM,48,-122,4,1,5
1039,58thStGreenway22ndAve,02/13/2014 07:00:00 AM,48,-122,18,14,32
1040,58thStGreenway22ndAve,02/13/2014 08:00:00 AM,48,-122,18,14,32
1041,58thStGreenway22ndAve,02/13/2014 09:00:00 AM,48,-122,16,22,38
1042,58thStGreenway22ndAve,02/13/2014 10:00:00 AM,48,-122,8,8,16
1043,58thStGreenway22ndAve,02/13/2014 11:00:00 AM,48,-122,24,20,44
1044,58thStGreenway22ndAve,02/13/2014 12:00:00 PM,48,-122,20,26,46
1045,58thStGreenway22ndAve,02/13/2014 01:00:00 PM,48,-122,23,18,41
1046,58thStGreenway22ndAve,02/13/2014 02:00:00 PM,48,-122,21,19,40
1047,58thStGreenway22ndAve,02/13/2014 03:00:00 PM,48,-122,20,20,40
1048,58thStGreenway22ndAve,02/13/2014 04:00:00 PM,48,-122,15,28,43
1049,58thStGreenway22ndAve,02/13/2014 05:00:00 PM,48,-122,26,41,67
1050,58thStGreenway22ndAve,02/13/2014 06:00:00 PM,48,-122,24,29,53
1051,58thStGreenway22ndAve,02/13/2014 07:00:00 PM,48,-122,15,18,33
1052,58thStGreenway22ndAve,02/13/2014 08:00:00 PM,48,-122,7,12,19
1053,58thStGreenway22ndAve,02/13/2014 09:00:00 PM,48,-122,5,3,8
1054,58thStGreenway22ndAve,02/13/2014 10:00:00 PM,48,-122,6,3,9
1055,58thStGreenway22ndAve,02/13/2014 11:00:00 PM,48,-122,3,2,5
1056,58thStGreenway22ndAve,02/14/2014 12:00:00 AM,48,-122,4,5,9
1057,58thStGreenway22ndAve,02/14/2014 01:00:00 AM,48,-122,1,1,2
1058,58thStGreenway22ndAve,02/14/2014 02:00:00 AM,48,-122,0,6,6
1059,58thStGreenway22ndAve,02/14/2014 03:00:00 AM,48,-122,0,1,1
1060,58thStGreenway22ndAve,02/14/2014 04:00:00 AM,48,-122,0,0,0
1061,58thStGreenway22ndAve,02/14/2014 05:00:00 AM,48,-122,6,2,8
1062,58thStGreenway22ndAve,02/14/2014 06:00:00 AM,48,-122,2,10,12
1063,58thStGreenway22ndAve,02/14/2014 07:00:00 AM,48,-122,24,11,35
1064,58thStGreenway22ndAve,02/14/2014 08:00:00 AM,48,-122,21,19,40
1065,58thStGreenway22ndAve,02/14/2014 09:00:00 AM,48,-122,28,28,56
1066,58thStGreenway22ndAve,02/14/2014 10:00:00 AM,48,-122,24,15,39
1067,58thStGreenway22ndAve,02/14/2014 11:00:00 AM,48,-122,26,11,37
1068,58thStGreenway22ndAve,02/14/2014 12:00:00 PM,48,-122,25,26,51
1069,58thStGreenway22ndAve,02/14/2014 01:00:00 PM,48,-122,21,21,42
1070,58thStGreenway22ndAve,02/14/2014 02:00:00 PM,48,-122,32,13,45
1071,58thStGreenway22ndAve,02/14/2014 03:00:00 PM,48,-122,19,24,43
1072,58thStGreenway22ndAve,02/14/2014 04:00:00 PM,48,-122,10,16,26
1073,58thStGreenway22ndAve,02/14/2014 05:00:00 PM,48,-122,27,40,67
1074,58thStGreenway22ndAve,02/14/2014 06:00:00 PM,48,-122,25,29,54
1075,58thStGreenway22ndAve,02/14/2014 07:00:00 PM,48,-122,19,16,35
1076,58thStGreenway22ndAve,02/14/2014 08:00:00 PM,48,-122,8,9,17
1077,58thStGreenway22ndAve,02/14/2014 09:00:00 PM,48,-122,5,14,19
1078,58thStGreenway22ndAve,02/14/2014 10:00:00 PM,48,-122,0,5,5
1079,58thStGreenway22ndAve,02/14/2014 11:00:00 PM,48,-122,3,4,7
1080,58thStGreenway22ndAve,02/15/2014 12:00:00 AM,48,-122,2,4,6
1081,58thStGreenway22ndAve,02/15/2014 01:00:00 AM,48,-122,2,2,4
1082,58thStGreenway22ndAve,02/15/2014 02:00:00 AM,48,-122,0,0,0
1083,58thStGreenway22ndAve,02/15/2014 03:00:00 AM,48,-122,0,6,6
1084,58thStGreenway22ndAve,02/15/2014 04:00:00 AM,48,-122,0,1,1
1085,58thStGreenway22ndAve,02/15/2014 05:00:00 AM,48,-122,0,1,1
1086,58thStGreenway22ndAve,02/15/2014 06:00:00 AM,48,-122,4,4,8
1087,58thStGreenway22ndAve,02/15/2014 07:00:00 AM,48,-122,1,2,3
1088,58thStGreenway22ndAve,02/15/2014 08:00:00 AM,48,-122,11,10,21
1089,58thStGreenway22ndAve,02/15/2014 09:00:00 AM,48,-122,28,21,49
1090,58thStGreenway22ndAve,02/15/2014 10:00:00 AM,48,-122,14,30,44
1091,58thStGreenway22ndAve,02/15/2014 11:00:00 AM,48,-122,17,30,47
1092,58thStGreenway22ndAve,02/15/2014 12:00:00 PM,48,-122,27,32,59
1093,58thStGreenway22ndAve,02/15/2014 01:00:00 PM,48,-122,18,33,51
1094,58thStGreenway22ndAve,02/15/2014 02:00:00 PM,48,-122,29,30,59
1095,58thStGreenway22ndAve,02/15/2014 03:00:00 PM,48,-122,24,21,45
1096,58thStGreenway22ndAve,02/15/2014 04:00:00 PM,48,-122,17,27,44
1097,58thStGreenway22ndAve,02/15/2014 05:00:00 PM,48,-122,16,25,41
1098,58thStGreenway22ndAve,02/15/2014 06:00:00 PM,48,-122,29,25,54
1099,58thStGreenway22ndAve,02/15/2014 07:00:00 PM,48,-122,21,7,28
1100,58thStGreenway22ndAve,02/15/2014 08:00:00 PM,48,-122,10,10,20
1101,58thStGreenway22ndAve,02/15/2014 09:00:00 PM,48,-122,2,6,8
1102,58thStGreenway22ndAve,02/15/2014 10:00:00 PM,48,-122,4,3,7
1103,58thStGreenway22ndAve,02/15/2014 11:00:00 PM,48,-122,2,3,5
1104,58thStGreenway22ndAve,02/16/2014 12:00:00 AM,48,-122,2,3,5
1105,58thStGreenway22ndAve,02/16/2014 01:00:00 AM,48,-122,3,0,3
1106,58thStGreenway22ndAve,02/16/2014 02:00:00 AM,48,-122,0,1,1
1107,58thStGreenway22ndAve,02/16/2014 03:00:00 AM,48,-122,0,0,0
1108,58thStGreenway22ndAve,02/16/2014 04:00:00 AM,48,-122,2,3,5
1109,58thStGreenway22ndAve,02/16/2014 05:00:00 AM,48,-122,0,0,0
1110,58thStGreenway22ndAve,02/16/2014 06:00:00 AM,48,-122,0,0,0
1111,58thStGreenway22ndAve,02/16/2014 07:00:00 AM,48,-122,2,0,2
1112,58thStGreenway22ndAve,02/16/2014 08:00:00 AM,48,-122,2,0,2
1113,58thStGreenway22ndAve,02/16/2014 09:00:00 AM,48,-122,6,8,14
1114,58thStGreenway22ndAve,02/16/2014 10:00:00 AM,48,-122,13,18,31
1115,58thStGreenway22ndAve,02/16/2014 11:00:00 AM,48,-122,21,24,45
1116,58thStGreenway22ndAve,02/16/2014 12:00:00 PM,48,-122,18,28,46
1117,58thStGreenway22ndAve,02/16/2014 01:00:00 PM,48,-122,1,28,29
1118,58thStGreenway22ndAve,02/16/2014 02:00:00 PM,48,-122,6,23,29
1119,58thStGreenway22ndAve,02/16/2014 03:00:00 PM,48,-122,29,28,57
1120,58thStGreenway22ndAve,02/16/2014 04:00:00 PM,48,-122,12,11,23
1121,58thStGreenway22ndAve,02/16/2014 05:00:00 PM,48,-122,16,13,29
1122,58thStGreenway22ndAve,02/16/2014 06:00:00 PM,48,-122,17,6,23
1123,58thStGreenway22ndAve,02/16/2014 07:00:00 PM,48,-122,1,11,12
1124,58thStGreenway22ndAve,02/16/2014 08:00:00 PM,48,-122,9,13,22
1125,58thStGreenway22ndAve,02/16/2014 09:00:00 PM,48,-122,8,9,17
1126,58thStGreenway22ndAve,02/16/2014 10:00:00 PM,48,-122,2,1,3
1127,58thStGreenway22ndAve,02/16/2014 11:00:00 PM,48,-122,5,2,7
1128,58thStGreenway22ndAve,02/17/2014 12:00:00 AM,48,-122,0,6,6
1129,58thStGreenway22ndAve,02/17/2014 01:00:00 AM,48,-122,0,1,1
1130,58thStGreenway22ndAve,02/17/2014 02:00:00 AM,48,-122,0,1,1
1131,58thStGreenway22ndAve,02/17/2014 03:00:00 AM,48,-122,0,0,0
1132,58thStGreenway22ndAve,02/17/2014 04:00:00 AM,48,-122,0,0,0
1133,58thStGreenway22ndAve,02/17/2014 05:00:00 AM,48,-122,0,2,2
1134,58thStGreenway22ndAve,02/17/2014 06:00:00 AM,48,-122,0,2,2
1135,58thStGreenway22ndAve,02/17/2014 07:00:00 AM,48,-122,8,13,21
1136,58thStGreenway22ndAve,02/17/2014 08:00:00 AM,48,-122,8,14,22
1137,58thStGreenway22ndAve,02/17/2014 09:00:00 AM,48,-122,7,21,28
1138,58thStGreenway22ndAve,02/17/2014 10:00:00 AM,48,-122,16,11,27
1139,58thStGreenway22ndAve,02/17/2014 11:00:00 AM,48,-122,20,14,34
1140,58thStGreenway22ndAve,02/17/2014 12:00:00 PM,48,-122,12,24,36
1141,58thStGreenway22ndAve,02/17/2014 01:00:00 PM,48,-122,24,34,58
1142,58thStGreenway22ndAve,02/17/2014 02:00:00 PM,48,-122,28,27,55
1143,58thStGreenway22ndAve,02/17/2014 03:00:00 PM,48,-122,16,24,40
1144,58thStGreenway22ndAve,02/17/2014 04:00:00 PM,48,-122,23,11,34
1145,58thStGreenway22ndAve,02/17/2014 05:00:00 PM,48,-122,18,13,31
1146,58thStGreenway22ndAve,02/17/2014 06:00:00 PM,48,-122,14,7,21
1147,58thStGreenway22ndAve,02/17/2014 07:00:00 PM,48,-122,3,11,14
1148,58thStGreenway22ndAve,02/17/2014 08:00:00 PM,48,-122,10,9,19
1149,58thStGreenway22ndAve,02/17/2014 09:00:00 PM,48,-122,11,2,13
1150,58thStGreenway22ndAve,02/17/2014 10:00:00 PM,48,-122,12,5,17
1151,58thStGreenway22ndAve,02/17/2014 11:00:00 PM,48,-122,3,0,3
1152,58thStGreenway22ndAve,02/18/2014 12:00:00 AM,48,-122,2,0,2
1153,58thStGreenway22ndAve,02/18/2014 01:00:00 AM,48,-122,0,0,0
1154,58thStGreenway22ndAve,02/18/2014 02:00:00 AM,48,-122,0,2,2
1155,58thStGreenway22ndAve,02/18/2014 03:00:00 AM,48,-122,0,0,0
1156,58thStGreenway22ndAve,02/18/2014 04:00:00 AM,48,-122,0,0,0
1157,58thStGreenway22ndAve,02/18/2014 05:00:00 AM,48,-122,0,4,4
1158,58thStGreenway22ndAve,02/18/2014 06:00:00 AM,48,-122,9,6,15
1159,58thStGreenway22ndAve,02/18/2014 07:00:00 AM,48,-122,12,12,24
1160,58thStGreenway22ndAve,02/18/2014 08:00:00 AM,48,-122,10,9,19
1161,58thStGreenway22ndAve,02/18/2014 09:00:00 AM,48,-122,14,19,33
1162,58thStGreenway22ndAve,02/18/2014 10:00:00 AM,48,-122,19,26,45
1163,58thStGreenway22ndAve,02/18/2014 11:00:00 AM,48,-122,12,25,37
1164,58thStGreenway22ndAve,02/18/2014 12:00:00 PM,48,-122,22,8,30
1165,58thStGreenway22ndAve,02/18/2014 01:00:00 PM,48,-122,27,11,38
1166,58thStGreenway22ndAve,02/18/2014 02:00:00 PM,48,-122,18,12,30
1167,58thStGreenway22ndAve,02/18/2014 03:00:00 PM,48,-122,19,16,35
1168,58thStGreenway22ndAve,02/18/2014 04:00:00 PM,48,-122,29,35,64
1169,58thStGreenway22ndAve,02/18/2014 05:00:00 PM,48,-122,19,28,47
1170,58thStGreenway22ndAve,02/18/2014 06:00:00 PM,48,-122,16,17,33
1171,58thStGreenway22ndAve,02/18/2014 07:00:00 PM,48,-122,5,28,33
1172,58thStGreenway22ndAve,02/18/2014 08:00:00 PM,48,-122,12,12,24
1173,58thStGreenway22ndAve,02/18/2014 09:00:00 PM,48,-122,10,2,12
1174,58thStGreenway22ndAve,02/18/2014 10:00:00 PM,48,-122,5,1,6
1175,58thStGreenway22ndAve,02/18/2014 11:00:00 PM,48,-122,0,4,4
1176,58thStGreenway22ndAve,02/19/2014 12:00:00 AM,48,-122,0,2,2
1177,58thStGreenway22ndAve,02/19/2014 01:00:00 AM,48,-122,2,4,6
1178,58thStGreenway22ndAve,02/19/2014 02:00:00 AM,48,-122,0,2,2
1179,58thStGreenway22ndAve,02/19/2014 03:00:00 AM,48,-122,2,0,2
1180,58thStGreenway22ndAve,02/19/2014 04:00:00 AM,48,-122,0,0,0
1181,58thStGreenway22ndAve,02/19/2014 05:00:00 AM,48,-122,0,4,4
1182,58thStGreenway22ndAve,02/19/2014 06:00:00 AM,48,-122,5,6,11
1183,58thStGreenway22ndAve,02/19/2014 07:00:00 AM,48,-122,15,6,21
1184,58thStGreenway22ndAve,02/19/2014 08:00:00 AM,48,-122,22,24,46
1185,58thStGreenway22ndAve,02/19/2014 09:00:00 AM,48,-122,14,19,33
1186,58thStGreenway22ndAve,02/19/2014 10:00:00 AM,48,-122,27,20,47
1187,58thStGreenway22ndAve,02/19/2014 11:00:00 AM,48,-122,22,28,50
1188,58thStGreenway22ndAve,02/19/2014 12:00:00 PM,48,-122,10,20,30
1189,58thStGreenway22ndAve,02/19/2014 01:00:00 PM,48,-122,16,27,43
1190,58thStGreenway22ndAve,02/19/2014 02:00:00 PM,48,-122,24,15,39
1191,58thStGreenway22ndAve,02/19/2014 03:00:00 PM,48,-122,17,11,28
1192,58thStGreenway22ndAve,02/19/2014 04:00:00 PM,48,-122,8,9,17
1193,58thStGreenway22ndAve,02/19/2014 05:00:00 PM,48,-122,18,18,36
1194,58thStGreenway22ndAve,02/19/2014 06:00:00 PM,48,-122,25,19,44
1195,58thStGreenway22ndAve,02/19/2014 07:00:00 PM,48,-122,18,8,26
1196,58thStGreenway22ndAve,02/19/2014 08:00:00 PM,48,-122,13,3,16
1197,58thStGreenway22ndAve,02/19/2014 09:00:00 PM,48,-122,12,2,14
1198,58thStGreenway22ndAve,02/19/2014 10:00:00 PM,48,-122,3,5,8
1199,58thStGreenway22ndAve,02/19/2014 11:00:00 PM,48,-122,4,8,12
1200,58thStGreenway22ndAve,02/20/2014 12:00:00 AM,48,-122,0,3,3
1201,58thStGreenway22ndAve,02/20/2014 01:00:00 AM,48,-122,0,0,0
1202,58thStGreenway22ndAve,02/20/2014 02:00:00 AM,48,-122,0,1,1
1203,58thStGreenway22ndAve,02/20/2014 03:00:00 AM,48,-122,0,0,0
1204,58thStGreenway22ndAve,02/20/2014 04:00:00 AM,48,-122,0,0,0
1205,58thStGreenway22ndAve,02/20/2014 05:00:00 AM,48,-122,2,0,2
1206,58thStGreenway22ndAve,02/20/2014 06:00:00 AM,48,-122,4,4,8
1207,58thStGreenway22ndAve,02/20/2014 07:00:00 AM,48,-122,16,12,28
1208,58thStGreenway22ndAve,02/20/2014 08:00:00 AM,48,-122,18,11,29
1209,58thStGreenway22ndAve,02/20/2014 09:00:00 AM,48,-122,15,15,30
1210,58thStGreenway22ndAve,02/20/2014 10:00:00 AM,48,-122,18,9,27
1211,58thStGreenway22ndAve,02/20/2014 11:00:00 AM,48,-122,20,22,42
1212,58thStGreenway22ndAve,02/20/2014 12:00:00 PM,48,-122,26,24,50
1213,58thStGreenway22ndAve,02/20/2014 01:00:00 PM,48,-122,21,15,36
1214,58thStGreenway22ndAve,02/20/2014 02:00:00 PM,48,-122,33,16,49
1215,58thStGreenway22ndAve,02/20/2014 03:00:00 PM,48,-122,10,17,27
1216,58thStGreenway22ndAve,02/20/2014 04:00:00 PM,48,-122,13,8,21
1217,58thStGreenway22ndAve,02/20/2014 05:00:00 PM,48,-122,25,30,55
1218,58thStGreenway22ndAve,02/20/2014 06:00:00 PM,48,-122,12,13,25
1219,58thStGreenway22ndAve,02/20/2014 07:00:00 PM,48,-122,21,17,38
1220,58thStGreenway22ndAve,02/20/2014 08:00:00 PM,48,-122,20,11,31
1221,58thStGreenway22ndAve,02/20/2014 09:00:00 PM,48,-122,11,1,12
1222,58thStGreenway22ndAve,02/20/2014 10:00:00 PM,48,-122,5,6,11
1223,58thStGreenway22ndAve,02/20/2014 11:00:00 PM,48,-122,6,0,6
1224,58thStGreenway22ndAve,02/21/2014 12:00:00 AM,48,-122,0,1,1
1225,58thStGreenway22ndAve,02/21/2014 01:00:00 AM,48,-122,4,3,7
1226,58thStGreenway22ndAve,02/21/2014 02:00:00 AM,48,-122,0,2,2
1227,58thStGreenway22ndAve,02/21/2014 03:00:00 AM,48,-122,2,0,2
1228,58thStGreenway22ndAve,02/21/2014 04:00:00 AM,48,-122,0,0,0
1229,58thStGreenway22ndAve,02/21/2014 05:00:00 AM,48,-122,0,3,3
1230,58thStGreenway22ndAve,02/21/2014 06:00:00 AM,48,-122,6,7,13
1231,58thStGreenway22ndAve,02/21/2014 07:00:00 AM,48,-122,22,17,39
1232,58thStGreenway22ndAve,02/21/2014 08:00:00 AM,48,-122,10,7,17
1233,58thStGreenway22ndAve,02/21/2014 09:00:00 AM,48,-122,15,18,33
1234,58thStGreenway22ndAve,02/21/2014 10:00:00 AM,48,-122,13,6,19
1235,58thStGreenway22ndAve,02/21/2014 11:00:00 AM,48,-122,9,15,24
1236,58thStGreenway22ndAve,02/21/2014 12:00:00 PM,48,-122,24,22,46
1237,58thStGreenway22ndAve,02/21/2014 01:00:00 PM,48,-122,27,18,45
1238,58thStGreenway22ndAve,02/21/2014 02:00:00 PM,48,-122,16,17,33
1239,58thStGreenway22ndAve,02/21/2014 03:00:00 PM,48,-122,25,23,48
1240,58thStGreenway22ndAve,02/21/2014 04:00:00 PM,48,-122,5,21,26
1241,58thStGreenway22ndAve,02/21/2014 05:00:00 PM,48,-122,27,14,41
1242,58thStGreenway22ndAve,02/21/2014 06:00:00 PM,48,-122,24,16,40
1243,58thStGreenway22ndAve,02/21/2014 07:00:00 PM,48,-122,14,9,23
1244,58thStGreenway22ndAve,02/21/2014 08:00:00 PM,48,-122,17,20,37
1245,58thStGreenway22ndAve,02/21/2014 09:00:00 PM,48,-122,13,9,22
1246,58thStGreenway22ndAve,02/21/2014 10:00:00 PM,48,-122,1,7,8
1247,58thStGreenway22ndAve,02/21/2014 11:00:00 PM,48,-122,4,10,14
1248,58thStGreenway22ndAve,02/22/2014 12:00:00 AM,48,-122,5,2,7
1249,58thStGreenway22ndAve,02/22/2014 01:00:00 AM,48,-122,1,7,8
1250,58thStGreenway22ndAve,02/22/2014 02:00:00 AM,48,-122,2,2,4
1251,58thStGreenway22ndAve,02/22/2014 03:00:00 AM,48,-122,2,2,4
1252,58thStGreenway22ndAve,02/22/2014 04:00:00 AM,48,-122,0,2,2
1253,58thStGreenway22ndAve,02/22/2014 05:00:00 AM,48,-122,2,1,3
1254,58thStGreenway22ndAve,02/22/2014 06:00:00 AM,48,-122,2,2,4
1255,58thStGreenway22ndAve,02/22/2014 07:00:00 AM,48,-122,4,5,9
1256,58thStGreenway22ndAve,02/22/2014 08:00:00 AM,48,-122,4,12,16
1257,58thStGreenway22ndAve,02/22/2014 09:00:00 AM,48,-122,19,19,38
1258,58thStGreenway22ndAve,02/22/2014 10:00:00 AM,48,-122,17,25,42
1259,58thStGreenway22ndAve,02/22/2014 11:00:00 AM,48,-122,22,35,57
1260,58thStGreenway22ndAve,02/22/2014 12:00:00 PM,48,-122,30,38,68
1261,58thStGreenway22ndAve,02/22/2014 01:00:00 PM,48,-122,26,27,53
1262,58thStGreenway22ndAve,02/22/2014 02:00:00 PM,48,-122,44,60,104
1263,58thStGreenway22ndAve,02/22/2014 03:00:00 PM,48,-122,22,39,61
1264,58thStGreenway22ndAve,02/22/2014 04:00:00 PM,48,-122,17,25,42
1265,58thStGreenway22ndAve,02/22/2014 05:00:00 PM,48,-122,37,41,78
1266,58thStGreenway22ndAve,02/22/2014 06:00:00 PM,48,-122,27,21,48
1267,58thStGreenway22ndAve,02/22/2014 07:00:00 PM,48,-122,25,18,43
1268,58thStGreenway22ndAve,02/22/2014 08:00:00 PM,48,-122,13,26,39
1269,58thStGreenway22ndAve,02/22/2014 09:00:00 PM,48,-122,10,10,20
1270,58thStGreenway22ndAve,02/22/2014 10:00:00 PM,48,-122,6,8,14
1271,58thStGreenway22ndAve,02/22/2014 11:00:00 PM,48,-122,0,5,5
1272,58thStGreenway22ndAve,02/23/2014 12:00:00 AM,48,-122,7,7,14
1273,58thStGreenway22ndAve,02/23/2014 01:00:00 AM,48,-122,2,7,9
1274,58thStGreenway22ndAve,02/23/2014 02:00:00 AM,48,-122,0,2,2
1275,58thStGreenway22ndAve,02/23/2014 03:00:00 AM,48,-122,0,1,1
1276,58thStGreenway22ndAve,02/23/2014 04:00:00 AM,48,-122,0,4,4
1277,58thStGreenway22ndAve,02/23/2014 05:00:00 AM,48,-122,0,0,0
1278,58thStGreenway22ndAve,02/23/2014 06:00:00 AM,48,-122,2,1,3
1279,58thStGreenway22ndAve,02/23/2014 07:00:00 AM,48,-122,0,5,5
1280,58thStGreenway22ndAve,02/23/2014 08:00:00 AM,48,-122,15,8,23
1281,58thStGreenway22ndAve,02/23/2014 09:00:00 AM,48,-122,4,6,10
1282,58thStGreenway22ndAve,02/23/2014 10:00:00 AM,48,-122,29,16,45
1283,58thStGreenway22ndAve,02/23/2014 11:00:00 AM,48,-122,31,37,68
1284,58thStGreenway22ndAve,02/23/2014 12:00:00 PM,48,-122,28,33,61
1285,58thStGreenway22ndAve,02/23/2014 01:00:00 PM,48,-122,38,28,66
1286,58thStGreenway22ndAve,02/23/2014 02:00:00 PM,48,-122,38,27,65
1287,58thStGreenway22ndAve,02/23/2014 03:00:00 PM,48,-122,23,21,44
1288,58thStGreenway22ndAve,02/23/2014 04:00:00 PM,48,-122,14,22,36
1289,58thStGreenway22ndAve,02/23/2014 05:00:00 PM,48,-122,18,30,48
1290,58thStGreenway22ndAve,02/23/2014 06:00:00 PM,48,-122,17,16,33
1291,58thStGreenway22ndAve,02/23/2014 07:00:00 PM,48,-122,11,14,25
1292,58thStGreenway22ndAve,02/23/2014 08:00:00 PM,48,-122,14,4,18
1293,58thStGreenway22ndAve,02/23/2014 09:00:00 PM,48,-122,11,6,17
1294,58thStGreenway22ndAve,02/23/2014 10:00:00 PM,48,-122,4,6,10
1295,58thStGreenway22ndAve,02/23/2014 11:00:00 PM,48,-122,2,2,4
1296,58thStGreenway22ndAve,02/24/2014 12:00:00 AM,48,-122,1,0,1
1297,58thStGreenway22ndAve,02/24/2014 01:00:00 AM,48,-122,1,6,7
1298,58thStGreenway22ndAve,02/24/2014 02:00:00 AM,48,-122,0,0,0
1299,58thStGreenway22ndAve,02/24/2014 03:00:00 AM,48,-122,0,0,0
1300,58thStGreenway22ndAve,02/24/2014 04:00:00 AM,48,-122,0,0,0
1301,58thStGreenway22ndAve,02/24/2014 05:00:00 AM,48,-122,2,7,9
1302,58thStGreenway22ndAve,02/24/2014 06:00:00 AM,48,-122,4,3,7
1303,58thStGreenway22ndAve,02/24/2014 07:00:00 AM,48,-122,6,9,15
1304,58thStGreenway22ndAve,02/24/2014 08:00:00 AM,48,-122,18,24,42
1305,58thStGreenway22ndAve,02/24/2014 09:00:00 AM,48,-122,21,15,36
1306,58thStGreenway22ndAve,02/24/2014 10:00:00 AM,48,-122,9,13,22
1307,58thStGreenway22ndAve,02/24/2014 11:00:00 AM,48,-122,14,11,25
1308,58thStGreenway22ndAve,02/24/2014 12:00:00 PM,48,-122,26,13,39
1309,58thStGreenway22ndAve,02/24/2014 01:00:00 PM,48,-122,16,14,30
1310,58thStGreenway22ndAve,02/24/2014 02:00:00 PM,48,-122,16,14,30
1311,58thStGreenway22ndAve,02/24/2014 03:00:00 PM,48,-122,8,14,22
1312,58thStGreenway22ndAve,02/24/2014 04:00:00 PM,48,-122,12,18,30
1313,58thStGreenway22ndAve,02/24/2014 05:00:00 PM,48,-122,28,28,56
1314,58thStGreenway22ndAve,02/24/2014 06:00:00 PM,48,-122,21,18,39
1315,58thStGreenway22ndAve,02/24/2014 07:00:00 PM,48,-122,21,13,34
1316,58thStGreenway22ndAve,02/24/2014 08:00:00 PM,48,-122,15,1,16
1317,58thStGreenway22ndAve,02/24/2014 09:00:00 PM,48,-122,6,5,11
1318,58thStGreenway22ndAve,02/24/2014 10:00:00 PM,48,-122,9,5,14
1319,58thStGreenway22ndAve,02/24/2014 11:00:00 PM,48,-122,2,2,4
1320,58thStGreenway22ndAve,02/25/2014 12:00:00 AM,48,-122,0,0,0
1321,58thStGreenway22ndAve,02/25/2014 01:00:00 AM,48,-122,0,0,0
1322,58thStGreenway22ndAve,02/25/2014 02:00:00 AM,48,-122,0,0,0
1323,58thStGreenway22ndAve,02/25/2014 03:00:00 AM,48,-122,0,0,0
1324,58thStGreenway22ndAve,02/25/2014 04:00:00 AM,48,-122,0,0,0
1325,58thStGreenway22ndAve,02/25/2014 05:00:00 AM,48,-122,0,4,4
1326,58thStGreenway22ndAve,02/25/2014 06:00:00 AM,48,-122,2,2,4
1327,58thStGreenway22ndAve,02/25/2014 07:00:00 AM,48,-122,16,6,22
1328,58thStGreenway22ndAve,02/25/2014 08:00:00 AM,48,-122,23,25,48
1329,58thStGreenway22ndAve,02/25/2014 09:00:00 AM,48,-122,24,25,49
1330,58thStGreenway22ndAve,02/25/2014 10:00:00 AM,48,-122,20,19,39
1331,58thStGreenway22ndAve,02/25/2014 11:00:00 AM,48,-122,14,17,31
1332,58thStGreenway22ndAve,02/25/2014 12:00:00 PM,48,-122,23,28,51
1333,58thStGreenway22ndAve,02/25/2014 01:00:00 PM,48,-122,24,24,48
1334,58thStGreenway22ndAve,02/25/2014 02:00:00 PM,48,-122,21,9,30
1335,58thStGreenway22ndAve,02/25/2014 03:00:00 PM,48,-122,11,13,24
1336,58thStGreenway22ndAve,02/25/2014 04:00:00 PM,48,-122,20,21,41
1337,58thStGreenway22ndAve,02/25/2014 05:00:00 PM,48,-122,28,36,64
1338,58thStGreenway22ndAve,02/25/2014 06:00:00 PM,48,-122,20,29,49
1339,58thStGreenway22ndAve,02/25/2014 07:00:00 PM,48,-122,23,8,31
1340,58thStGreenway22ndAve,02/25/2014 08:00:00 PM,48,-122,3,1,4
1341,58thStGreenway22ndAve,02/25/2014 09:00:00 PM,48,-122,8,2,10
1342,58thStGreenway22ndAve,02/25/2014 10:00:00 PM,48,-122,4,0,4
1343,58thStGreenway22ndAve,02/25/2014 11:00:00 PM,48,-122,1,0,1
1344,58thStGreenway22ndAve,02/26/2014 12:00:00 AM,48,-122,0,0,0
1345,58thStGreenway22ndAve,02/26/2014 01:00:00 AM,48,-122,4,0,4
1346,58thStGreenway22ndAve,02/26/2014 02:00:00 AM,48,-122,0,0,0
1347,58thStGreenway22ndAve,02/26/2014 03:00:00 AM,48,-122,0,0,0
1348,58thStGreenway22ndAve,02/26/2014 04:00:00 AM,48,-122,0,0,0
1349,58thStGreenway22ndAve,02/26/2014 05:00:00 AM,48,-122,1,1,2
1350,58thStGreenway22ndAve,02/26/2014 06:00:00 AM,48,-122,6,6,12
1351,58thStGreenway22ndAve,02/26/2014 07:00:00 AM,48,-122,28,10,38
1352,58thStGreenway22ndAve,02/26/2014 08:00:00 AM,48,-122,19,19,38
1353,58thStGreenway22ndAve,02/26/2014 09:00:00 AM,48,-122,19,20,39
1354,58thStGreenway22ndAve,02/26/2014 10:00:00 AM,48,-122,15,12,27
1355,58thStGreenway22ndAve,02/26/2014 11:00:00 AM,48,-122,19,27,46
1356,58thStGreenway22ndAve,02/26/2014 12:00:00 PM,48,-122,9,18,27
1357,58thStGreenway22ndAve,02/26/2014 01:00:00 PM,48,-122,29,23,52
1358,58thStGreenway22ndAve,02/26/2014 02:00:00 PM,48,-122,23,19,42
1359,58thStGreenway22ndAve,02/26/2014 03:00:00 PM,48,-122,16,17,33
1360,58thStGreenway22ndAve,02/26/2014 04:00:00 PM,48,-122,32,20,52
1361,58thStGreenway22ndAve,02/26/2014 05:00:00 PM,48,-122,24,18,42
1362,58thStGreenway22ndAve,02/26/2014 06:00:00 PM,48,-122,15,9,24
1363,58thStGreenway22ndAve,02/26/2014 07:00:00 PM,48,-122,3,7,10
1364,58thStGreenway22ndAve,02/26/2014 08:00:00 PM,48,-122,10,1,11
1365,58thStGreenway22ndAve,02/26/2014 09:00:00 PM,48,-122,12,4,16
1366,58thStGreenway22ndAve,02/26/2014 10:00:00 PM,48,-122,4,0,4
1367,58thStGreenway22ndAve,02/26/2014 11:00:00 PM,48,-122,2,0,2
1368,58thStGreenway22ndAve,02/27/2014 12:00:00 AM,48,-122,2,2,4
1369,58thStGreenway22ndAve,02/27/2014 01:00:00 AM,48,-122,0,0,0
1370,58thStGreenway22ndAve,02/27/2014 02:00:00 AM,48,-122,0,1,1
1371,58thStGreenway22ndAve,02/27/2014 03:00:00 AM,48,-122,0,2,2
1372,58thStGreenway22ndAve,02/27/2014 04:00:00 AM,48,-122,0,0,0
1373,58thStGreenway22ndAve,02/27/2014 05:00:00 AM,48,-122,2,4,6
1374,58thStGreenway22ndAve,02/27/2014 06:00:00 AM,48,-122,6,7,13
1375,58thStGreenway22ndAve,02/27/2014 07:00:00 AM,48,-122,11,9,20
1376,58thStGreenway22ndAve,02/27/2014 08:00:00 AM,48,-122,22,19,41
1377,58thStGreenway22ndAve,02/27/2014 09:00:00 AM,48,-122,26,21,47
1378,58thStGreenway22ndAve,02/27/2014 10:00:00 AM,48,-122,19,29,48
1379,58thStGreenway22ndAve,02/27/2014 11:00:00 AM,48,-122,15,15,30
1380,58thStGreenway22ndAve,02/27/2014 12:00:00 PM,48,-122,23,29,52
1381,58thStGreenway22ndAve,02/27/2014 01:00:00 PM,48,-122,20,20,40
1382,58thStGreenway22ndAve,02/27/2014 02:00:00 PM,48,-122,16,14,30
1383,58thStGreenway22ndAve,02/27/2014 03:00:00 PM,48,-122,19,28,47
1384,58thStGreenway22ndAve,02/27/2014 04:00:00 PM,48,-122,29,34,63
1385,58thStGreenway22ndAve,02/27/2014 05:00:00 PM,48,-122,20,31,51
1386,58thStGreenway22ndAve,02/27/2014 06:00:00 PM,48,-122,30,20,50
1387,58thStGreenway22ndAve,02/27/2014 07:00:00 PM,48,-122,16,14,30
1388,58thStGreenway22ndAve,02/27/2014 08:00:00 PM,48,-122,14,9,23
1389,58thStGreenway22ndAve,02/27/2014 09:00:00 PM,48,-122,19,2,21
1390,58thStGreenway22ndAve,02/27/2014 10:00:00 PM,48,-122,6,3,9
1391,58thStGreenway22ndAve,02/27/2014 11:00:00 PM,48,-122,6,10,16
1392,58thStGreenway22ndAve,02/28/2014 12:00:00 AM,48,-122,2,4,6
1393,58thStGreenway22ndAve,02/28/2014 01:00:00 AM,48,-122,0,3,3
1394,58thStGreenway22ndAve,02/28/2014 02:00:00 AM,48,-122,0,6,6
1395,58thStGreenway22ndAve,02/28/2014 03:00:00 AM,48,-122,0,2,2
1396,58thStGreenway22ndAve,02/28/2014 04:00:00 AM,48,-122,0,2,2
1397,58thStGreenway22ndAve,02/28/2014 05:00:00 AM,48,-122,0,3,3
1398,58thStGreenway22ndAve,02/28/2014 06:00:00 AM,48,-122,9,7,16
1399,58thStGreenway22ndAve,02/28/2014 07:00:00 AM,48,-122,19,14,33
1400,58thStGreenway22ndAve,02/28/2014 08:00:00 AM,48,-122,31,27,58
1401,58thStGreenway22ndAve,02/28/2014 09:00:00 AM,48,-122,20,21,41
1402,58thStGreenway22ndAve,02/28/2014 10:00:00 AM,48,-122,19,21,40
1403,58thStGreenway22ndAve,02/28/2014 11:00:00 AM,48,-122,34,20,54
1404,58thStGreenway22ndAve,02/28/2014 12:00:00 PM,48,-122,31,26,57
1405,58thStGreenway22ndAve,02/28/2014 01:00:00 PM,48,-122,13,23,36
1406,58thStGreenway22ndAve,02/28/2014 02:00:00 PM,48,-122,21,15,36
1407,58thStGreenway22ndAve,02/28/2014 03:00:00 PM,48,-122,22,20,42
1408,58thStGreenway22ndAve,02/28/2014 04:00:00 PM,48,-122,22,25,47
1409,58thStGreenway22ndAve,02/28/2014 05:00:00 PM,48,-122,34,22,56
1410,58thStGreenway22ndAve,02/28/2014 06:00:00 PM,48,-122,29,18,47
1411,58thStGreenway22ndAve,02/28/2014 07:00:00 PM,48,-122,19,11,30
1412,58thStGreenway22ndAve,02/28/2014 08:00:00 PM,48,-122,18,6,24
1413,58thStGreenway22ndAve,02/28/2014 09:00:00 PM,48,-122,12,8,20
1414,58thStGreenway22ndAve,02/28/2014 10:00:00 PM,48,-122,3,3,6
1415,58thStGreenway22ndAve,02/28/2014 11:00:00 PM,48,-122,2,1,3
1416,58thStGreenway22ndAve,03/01/2014 12:00:00 AM,48,-122,5,3,8
1417,58thStGreenway22ndAve,03/01/2014 01:00:00 AM,48,-122,4,0,4
1418,58thStGreenway22ndAve,03/01/2014 02:00:00 AM,48,-122,2,2,4
1419,58thStGreenway22ndAve,03/01/2014 03:00:00 AM,48,-122,0,0,0
1420,58thStGreenway22ndAve,03/01/2014 04:00:00 AM,48,-122,2,4,6
1421,58thStGreenway22ndAve,03/01/2014 05:00:00 AM,48,-122,0,0,0
1422,58thStGreenway22ndAve,03/01/2014 06:00:00 AM,48,-122,2,0,2
1423,58thStGreenway22ndAve,03/01/2014 07:00:00 AM,48,-122,5,4,9
1424,58thStGreenway22ndAve,03/01/2014 08:00:00 AM,48,-122,6,7,13
1425,58thStGreenway22ndAve,03/01/2014 09:00:00 AM,48,-122,20,9,29
1426,58thStGreenway22ndAve,03/01/2014 10:00:00 AM,48,-122,11,24,35
1427,58thStGreenway22ndAve,03/01/2014 11:00:00 AM,48,-122,29,41,70
1428,58thStGreenway22ndAve,03/01/2014 12:00:00 PM,48,-122,49,42,91
1429,58thStGreenway22ndAve,03/01/2014 01:00:00 PM,48,-122,38,27,65
1430,58thStGreenway22ndAve,03/01/2014 02:00:00 PM,48,-122,26,21,47
1431,58thStGreenway22ndAve,03/01/2014 03:00:00 PM,48,-122,20,25,45
1432,58thStGreenway22ndAve,03/01/2014 04:00:00 PM,48,-122,18,31,49
1433,58thStGreenway22ndAve,03/01/2014 05:00:00 PM,48,-122,15,6,21
1434,58thStGreenway22ndAve,03/01/2014 06:00:00 PM,48,-122,27,16,43
1435,58thStGreenway22ndAve,03/01/2014 07:00:00 PM,48,-122,24,18,42
1436,58thStGreenway22ndAve,03/01/2014 08:00:00 PM,48,-122,9,2,11
1437,58thStGreenway22ndAve,03/01/2014 09:00:00 PM,48,-122,9,10,19
1438,58thStGreenway22ndAve,03/01/2014 10:00:00 PM,48,-122,3,3,6
1439,58thStGreenway22ndAve,03/01/2014 11:00:00 PM,48,-122,4,1,5
1440,58thStGreenway22ndAve,03/02/2014 12:00:00 AM,48,-122,4,2,6
1441,58thStGreenway22ndAve,03/02/2014 01:00:00 AM,48,-122,3,5,8
1442,58thStGreenway22ndAve,03/02/2014 02:00:00 AM,48,-122,2,0,2
1443,58thStGreenway22ndAve,03/02/2014 03:00:00 AM,48,-122,2,0,2
1444,58thStGreenway22ndAve,03/02/2014 04:00:00 AM,48,-122,0,4,4
1445,58thStGreenway22ndAve,03/02/2014 05:00:00 AM,48,-122,1,2,3
1446,58thStGreenway22ndAve,03/02/2014 06:00:00 AM,48,-122,0,3,3
1447,58thStGreenway22ndAve,03/02/2014 07:00:00 AM,48,-122,4,5,9
1448,58thStGreenway22ndAve,03/02/2014 08:00:00 AM,48,-122,3,5,8
1449,58thStGreenway22ndAve,03/02/2014 09:00:00 AM,48,-122,15,16,31
1450,58thStGreenway22ndAve,03/02/2014 10:00:00 AM,48,-122,8,10,18
1451,58thStGreenway22ndAve,03/02/2014 11:00:00 AM,48,-122,14,21,35
1452,58thStGreenway22ndAve,03/02/2014 12:00:00 PM,48,-122,24,26,50
1453,58thStGreenway22ndAve,03/02/2014 01:00:00 PM,48,-122,28,25,53
1454,58thStGreenway22ndAve,03/02/2014 02:00:00 PM,48,-122,28,25,53
1455,58thStGreenway22ndAve,03/02/2014 03:00:00 PM,48,-122,25,18,43
1456,58thStGreenway22ndAve,03/02/2014 04:00:00 PM,48,-122,3,36,39
1457,58thStGreenway22ndAve,03/02/2014 05:00:00 PM,48,-122,8,29,37
1458,58thStGreenway22ndAve,03/02/2014 06:00:00 PM,48,-122,7,11,18
1459,58thStGreenway22ndAve,03/02/2014 07:00:00 PM,48,-122,6,9,15
1460,58thStGreenway22ndAve,03/02/2014 08:00:00 PM,48,-122,6,8,14
1461,58thStGreenway22ndAve,03/02/2014 09:00:00 PM,48,-122,3,13,16
1462,58thStGreenway22ndAve,03/02/2014 10:00:00 PM,48,-122,4,6,10
1463,58thStGreenway22ndAve,03/02/2014 11:00:00 PM,48,-122,0,0,0
1464,58thStGreenway22ndAve,03/03/2014 12:00:00 AM,48,-122,0,0,0
1465,58thStGreenway22ndAve,03/03/2014 01:00:00 AM,48,-122,0,0,0
1466,58thStGreenway22ndAve,03/03/2014 02:00:00 AM,48,-122,0,0,0
1467,58thStGreenway22ndAve,03/03/2014 03:00:00 AM,48,-122,1,1,2
1468,58thStGreenway22ndAve,03/03/2014 04:00:00 AM,48,-122,2,0,2
1469,58thStGreenway22ndAve,03/03/2014 05:00:00 AM,48,-122,4,2,6
1470,58thStGreenway22ndAve,03/03/2014 06:00:00 AM,48,-122,5,2,7
1471,58thStGreenway22ndAve,03/03/2014 07:00:00 AM,48,-122,24,8,32
1472,58thStGreenway22ndAve,03/03/2014 08:00:00 AM,48,-122,8,11,19
1473,58thStGreenway22ndAve,03/03/2014 09:00:00 AM,48,-122,10,23,33
1474,58thStGreenway22ndAve,03/03/2014 10:00:00 AM,48,-122,22,23,45
1475,58thStGreenway22ndAve,03/03/2014 11:00:00 AM,48,-122,15,33,48
1476,58thStGreenway22ndAve,03/03/2014 12:00:00 PM,48,-122,9,19,28
1477,58thStGreenway22ndAve,03/03/2014 01:00:00 PM,48,-122,25,9,34
1478,58thStGreenway22ndAve,03/03/2014 02:00:00 PM,48,-122,23,21,44
1479,58thStGreenway22ndAve,03/03/2014 03:00:00 PM,48,-122,26,21,47
1480,58thStGreenway22ndAve,03/03/2014 04:00:00 PM,48,-122,11,22,33
1481,58thStGreenway22ndAve,03/03/2014 05:00:00 PM,48,-122,25,32,57
1482,58thStGreenway22ndAve,03/03/2014 06:00:00 PM,48,-122,17,16,33
1483,58thStGreenway22ndAve,03/03/2014 07:00:00 PM,48,-122,10,13,23
1484,58thStGreenway22ndAve,03/03/2014 08:00:00 PM,48,-122,16,12,28
1485,58thStGreenway22ndAve,03/03/2014 09:00:00 PM,48,-122,7,2,9
1486,58thStGreenway22ndAve,03/03/2014 10:00:00 PM,48,-122,2,0,2
1487,58thStGreenway22ndAve,03/03/2014 11:00:00 PM,48,-122,4,3,7
1488,58thStGreenway22ndAve,03/04/2014 12:00:00 AM,48,-122,0,0,0
1489,58thStGreenway22ndAve,03/04/2014 01:00:00 AM,48,-122,0,0,0
1490,58thStGreenway22ndAve,03/04/2014 02:00:00 AM,48,-122,0,2,2
1491,58thStGreenway22ndAve,03/04/2014 03:00:00 AM,48,-122,0,0,0
1492,58thStGreenway22ndAve,03/04/2014 04:00:00 AM,48,-122,0,0,0
1493,58thStGreenway22ndAve,03/04/2014 05:00:00 AM,48,-122,2,3,5
1494,58thStGreenway22ndAve,03/04/2014 06:00:00 AM,48,-122,2,0,2
1495,58thStGreenway22ndAve,03/04/2014 07:00:00 AM,48,-122,21,7,28
1496,58thStGreenway22ndAve,03/04/2014 08:00:00 AM,48,-122,24,19,43
1497,58thStGreenway22ndAve,03/04/2014 09:00:00 AM,48,-122,21,20,41
1498,58thStGreenway22ndAve,03/04/2014 10:00:00 AM,48,-122,15,13,28
1499,58thStGreenway22ndAve,03/04/2014 11:00:00 AM,48,-122,13,12,25
1500,58thStGreenway22ndAve,03/04/2014 12:00:00 PM,48,-122,17,31,48
1501,58thStGreenway22ndAve,03/04/2014 01:00:00 PM,48,-122,18,18,36
1502,58thStGreenway22ndAve,03/04/2014 02:00:00 PM,48,-122,10,12,22
1503,58thStGreenway22ndAve,03/04/2014 03:00:00 PM,48,-122,17,26,43
1504,58thStGreenway22ndAve,03/04/2014 04:00:00 PM,48,-122,17,23,40
1505,58thStGreenway22ndAve,03/04/2014 05:00:00 PM,48,-122,29,35,64
1506,58thStGreenway22ndAve,03/04/2014 06:00:00 PM,48,-122,10,16,26
1507,58thStGreenway22ndAve,03/04/2014 07:00:00 PM,48,-122,7,17,24
1508,58thStGreenway22ndAve,03/04/2014 08:00:00 PM,48,-122,7,4,11
1509,58thStGreenway22ndAve,03/04/2014 09:00:00 PM,48,-122,9,6,15
1510,58thStGreenway22ndAve,03/04/2014 10:00:00 PM,48,-122,5,0,5
1511,58thStGreenway22ndAve,03/04/2014 11:00:00 PM,48,-122,1,0,1
1512,58thStGreenway22ndAve,03/05/2014 12:00:00 AM,48,-122,2,1,3
1513,58thStGreenway22ndAve,03/05/2014 01:00:00 AM,48,-122,2,0,2
1514,58thStGreenway22ndAve,03/05/2014 02:00:00 AM,48,-122,2,0,2
1515,58thStGreenway22ndAve,03/05/2014 03:00:00 AM,48,-122,1,1,2
1516,58thStGreenway22ndAve,03/05/2014 04:00:00 AM,48,-122,0,0,0
1517,58thStGreenway22ndAve,03/05/2014 05:00:00 AM,48,-122,1,4,5
1518,58thStGreenway22ndAve,03/05/2014 06:00:00 AM,48,-122,6,8,14
1519,58thStGreenway22ndAve,03/05/2014 07:00:00 AM,48,-122,20,9,29
1520,58thStGreenway22ndAve,03/05/2014 08:00:00 AM,48,-122,24,12,36
1521,58thStGreenway22ndAve,03/05/2014 09:00:00 AM,48,-122,22,32,54
1522,58thStGreenway22ndAve,03/05/2014 10:00:00 AM,48,-122,19,14,33
1523,58thStGreenway22ndAve,03/05/2014 11:00:00 AM,48,-122,21,20,41
1524,58thStGreenway22ndAve,03/05/2014 12:00:00 PM,48,-122,16,21,37
1525,58thStGreenway22ndAve,03/05/2014 01:00:00 PM,48,-122,21,14,35
1526,58thStGreenway22ndAve,03/05/2014 02:00:00 PM,48,-122,13,19,32
1527,58thStGreenway22ndAve,03/05/2014 03:00:00 PM,48,-122,16,13,29
1528,58thStGreenway22ndAve,03/05/2014 04:00:00 PM,48,-122,12,16,28
1529,58thStGreenway22ndAve,03/05/2014 05:00:00 PM,48,-122,29,22,51
1530,58thStGreenway22ndAve,03/05/2014 06:00:00 PM,48,-122,27,20,47
1531,58thStGreenway22ndAve,03/05/2014 07:00:00 PM,48,-122,15,13,28
1532,58thStGreenway22ndAve,03/05/2014 08:00:00 PM,48,-122,5,11,16
1533,58thStGreenway22ndAve,03/05/2014 09:00:00 PM,48,-122,9,4,13
1534,58thStGreenway22ndAve,03/05/2014 10:00:00 PM,48,-122,7,4,11
1535,58thStGreenway22ndAve,03/05/2014 11:00:00 PM,48,-122,5,10,15
1536,58thStGreenway22ndAve,03/06/2014 12:00:00 AM,48,-122,0,0,0
1537,58thStGreenway22ndAve,03/06/2014 01:00:00 AM,48,-122,0,0,0
1538,58thStGreenway22ndAve,03/06/2014 02:00:00 AM,48,-122,0,0,0
1539,58thStGreenway22ndAve,03/06/2014 03:00:00 AM,48,-122,0,0,0
1540,58thStGreenway22ndAve,03/06/2014 04:00:00 AM,48,-122,0,0,0
1541,58thStGreenway22ndAve,03/06/2014 05:00:00 AM,48,-122,0,2,2
1542,58thStGreenway22ndAve,03/06/2014 06:00:00 AM,48,-122,3,6,9
1543,58thStGreenway22ndAve,03/06/2014 07:00:00 AM,48,-122,7,15,22
1544,58thStGreenway22ndAve,03/06/2014 08:00:00 AM,48,-122,14,7,21
1545,58thStGreenway22ndAve,03/06/2014 09:00:00 AM,48,-122,27,16,43
1546,58thStGreenway22ndAve,03/06/2014 10:00:00 AM,48,-122,9,15,24
1547,58thStGreenway22ndAve,03/06/2014 11:00:00 AM,48,-122,20,18,38
1548,58thStGreenway22ndAve,03/06/2014 12:00:00 PM,48,-122,23,29,52
1549,58thStGreenway22ndAve,03/06/2014 01:00:00 PM,48,-122,12,13,25
1550,58thStGreenway22ndAve,03/06/2014 02:00:00 PM,48,-122,20,19,39
1551,58thStGreenway22ndAve,03/06/2014 03:00:00 PM,48,-122,28,21,49
1552,58thStGreenway22ndAve,03/06/2014 04:00:00 PM,48,-122,22,24,46
1553,58thStGreenway22ndAve,03/06/2014 05:00:00 PM,48,-122,20,27,47
1554,58thStGreenway22ndAve,03/06/2014 06:00:00 PM,48,-122,17,31,48
1555,58thStGreenway22ndAve,03/06/2014 07:00:00 PM,48,-122,7,19,26
1556,58thStGreenway22ndAve,03/06/2014 08:00:00 PM,48,-122,10,18,28
1557,58thStGreenway22ndAve,03/06/2014 09:00:00 PM,48,-122,11,2,13
1558,58thStGreenway22ndAve,03/06/2014 10:00:00 PM,48,-122,9,0,9
1559,58thStGreenway22ndAve,03/06/2014 11:00:00 PM,48,-122,4,2,6
1560,58thStGreenway22ndAve,03/07/2014 12:00:00 AM,48,-122,2,0,2
1561,58thStGreenway22ndAve,03/07/2014 01:00:00 AM,48,-122,1,0,1
1562,58thStGreenway22ndAve,03/07/2014 02:00:00 AM,48,-122,2,2,4
1563,58thStGreenway22ndAve,03/07/2014 03:00:00 AM,48,-122,0,2,2
1564,58thStGreenway22ndAve,03/07/2014 04:00:00 AM,48,-122,0,0,0
1565,58thStGreenway22ndAve,03/07/2014 05:00:00 AM,48,-122,0,0,0
1566,58thStGreenway22ndAve,03/07/2014 06:00:00 AM,48,-122,4,1,5
1567,58thStGreenway22ndAve,03/07/2014 07:00:00 AM,48,-122,24,10,34
1568,58thStGreenway22ndAve,03/07/2014 08:00:00 AM,48,-122,17,22,39
1569,58thStGreenway22ndAve,03/07/2014 09:00:00 AM,48,-122,24,17,41
1570,58thStGreenway22ndAve,03/07/2014 10:00:00 AM,48,-122,13,19,32
1571,58thStGreenway22ndAve,03/07/2014 11:00:00 AM,48,-122,18,30,48
1572,58thStGreenway22ndAve,03/07/2014 12:00:00 PM,48,-122,20,20,40
1573,58thStGreenway22ndAve,03/07/2014 01:00:00 PM,48,-122,27,13,40
1574,58thStGreenway22ndAve,03/07/2014 02:00:00 PM,48,-122,33,25,58
1575,58thStGreenway22ndAve,03/07/2014 03:00:00 PM,48,-122,28,17,45
1576,58thStGreenway22ndAve,03/07/2014 04:00:00 PM,48,-122,27,21,48
1577,58thStGreenway22ndAve,03/07/2014 05:00:00 PM,48,-122,20,21,41
1578,58thStGreenway22ndAve,03/07/2014 06:00:00 PM,48,-122,31,19,50
1579,58thStGreenway22ndAve,03/07/2014 07:00:00 PM,48,-122,24,16,40
1580,58thStGreenway22ndAve,03/07/2014 08:00:00 PM,48,-122,16,6,22
1581,58thStGreenway22ndAve,03/07/2014 09:00:00 PM,48,-122,13,4,17
1582,58thStGreenway22ndAve,03/07/2014 10:00:00 PM,48,-122,5,7,12
1583,58thStGreenway22ndAve,03/07/2014 11:00:00 PM,48,-122,0,0,0
1584,58thStGreenway22ndAve,03/08/2014 12:00:00 AM,48,-122,4,3,7
1585,58thStGreenway22ndAve,03/08/2014 01:00:00 AM,48,-122,2,0,2
1586,58thStGreenway22ndAve,03/08/2014 02:00:00 AM,48,-122,6,2,8
1587,58thStGreenway22ndAve,03/08/2014 03:00:00 AM,48,-122,0,2,2
1588,58thStGreenway22ndAve,03/08/2014 04:00:00 AM,48,-122,0,0,0
1589,58thStGreenway22ndAve,03/08/2014 05:00:00 AM,48,-122,2,0,2
1590,58thStGreenway22ndAve,03/08/2014 06:00:00 AM,48,-122,2,0,2
1591,58thStGreenway22ndAve,03/08/2014 07:00:00 AM,48,-122,1,8,9
1592,58thStGreenway22ndAve,03/08/2014 08:00:00 AM,48,-122,13,6,19
1593,58thStGreenway22ndAve,03/08/2014 09:00:00 AM,48,-122,22,12,34
1594,58thStGreenway22ndAve,03/08/2014 10:00:00 AM,48,-122,16,24,40
1595,58thStGreenway22ndAve,03/08/2014 11:00:00 AM,48,-122,35,36,71
1596,58thStGreenway22ndAve,03/08/2014 12:00:00 PM,48,-122,33,47,80
1597,58thStGreenway22ndAve,03/08/2014 01:00:00 PM,48,-122,26,36,62
1598,58thStGreenway22ndAve,03/08/2014 02:00:00 PM,48,-122,33,39,72
1599,58thStGreenway22ndAve,03/08/2014 03:00:00 PM,48,-122,7,41,48
1600,58thStGreenway22ndAve,03/08/2014 04:00:00 PM,48,-122,24,26,50
1601,58thStGreenway22ndAve,03/08/2014 05:00:00 PM,48,-122,23,33,56
1602,58thStGreenway22ndAve,03/08/2014 06:00:00 PM,48,-122,18,20,38
1603,58thStGreenway22ndAve,03/08/2014 07:00:00 PM,48,-122,22,29,51
1604,58thStGreenway22ndAve,03/08/2014 08:00:00 PM,48,-122,22,24,46
1605,58thStGreenway22ndAve,03/08/2014 09:00:00 PM,48,-122,2,14,16
1606,58thStGreenway22ndAve,03/08/2014 10:00:00 PM,48,-122,4,10,14
1607,58thStGreenway22ndAve,03/08/2014 11:00:00 PM,48,-122,4,13,17
1608,58thStGreenway22ndAve,03/09/2014 12:00:00 AM,48,-122,6,0,6
1609,58thStGreenway22ndAve,03/09/2014 01:00:00 AM,48,-122,2,4,6
1610,58thStGreenway22ndAve,03/09/2014 03:00:00 AM,48,-122,,,
1611,58thStGreenway22ndAve,03/09/2014 03:00:00 AM,48,-122,2,2,4
1612,58thStGreenway22ndAve,03/09/2014 04:00:00 AM,48,-122,0,0,0
1613,58thStGreenway22ndAve,03/09/2014 05:00:00 AM,48,-122,0,0,0
1614,58thStGreenway22ndAve,03/09/2014 06:00:00 AM,48,-122,0,0,0
1615,58thStGreenway22ndAve,03/09/2014 07:00:00 AM,48,-122,0,2,2
1616,58thStGreenway22ndAve,03/09/2014 08:00:00 AM,48,-122,0,0,0
1617,58thStGreenway22ndAve,03/09/2014 09:00:00 AM,48,-122,8,4,12
1618,58thStGreenway22ndAve,03/09/2014 10:00:00 AM,48,-122,11,13,24
1619,58thStGreenway22ndAve,03/09/2014 11:00:00 AM,48,-122,18,29,47
1620,58thStGreenway22ndAve,03/09/2014 12:00:00 PM,48,-122,18,32,50
1621,58thStGreenway22ndAve,03/09/2014 01:00:00 PM,48,-122,26,24,50
1622,58thStGreenway22ndAve,03/09/2014 02:00:00 PM,48,-122,45,53,98
1623,58thStGreenway22ndAve,03/09/2014 03:00:00 PM,48,-122,41,28,69
1624,58thStGreenway22ndAve,03/09/2014 04:00:00 PM,48,-122,22,24,46
1625,58thStGreenway22ndAve,03/09/2014 05:00:00 PM,48,-122,21,10,31
1626,58thStGreenway22ndAve,03/09/2014 06:00:00 PM,48,-122,20,14,34
1627,58thStGreenway22ndAve,03/09/2014 07:00:00 PM,48,-122,8,7,15
1628,58thStGreenway22ndAve,03/09/2014 08:00:00 PM,48,-122,14,12,26
1629,58thStGreenway22ndAve,03/09/2014 09:00:00 PM,48,-122,4,4,8
1630,58thStGreenway22ndAve,03/09/2014 10:00:00 PM,48,-122,9,4,13
1631,58thStGreenway22ndAve,03/09/2014 11:00:00 PM,48,-122,2,6,8
1632,58thStGreenway22ndAve,03/10/2014 12:00:00 AM,48,-122,0,2,2
1633,58thStGreenway22ndAve,03/10/2014 01:00:00 AM,48,-122,0,0,0
1634,58thStGreenway22ndAve,03/10/2014 02:00:00 AM,48,-122,2,0,2
1635,58thStGreenway22ndAve,03/10/2014 03:00:00 AM,48,-122,0,0,0
1636,58thStGreenway22ndAve,03/10/2014 04:00:00 AM,48,-122,0,0,0
1637,58thStGreenway22ndAve,03/10/2014 05:00:00 AM,48,-122,0,2,2
1638,58thStGreenway22ndAve,03/10/2014 06:00:00 AM,48,-122,7,5,12
1639,58thStGreenway22ndAve,03/10/2014 07:00:00 AM,48,-122,13,9,22
1640,58thStGreenway22ndAve,03/10/2014 08:00:00 AM,48,-122,23,20,43
1641,58thStGreenway22ndAve,03/10/2014 09:00:00 AM,48,-122,21,11,32
1642,58thStGreenway22ndAve,03/10/2014 10:00:00 AM,48,-122,17,10,27
1643,58thStGreenway22ndAve,03/10/2014 11:00:00 AM,48,-122,10,12,22
1644,58thStGreenway22ndAve,03/10/2014 12:00:00 PM,48,-122,8,20,28
1645,58thStGreenway22ndAve,03/10/2014 01:00:00 PM,48,-122,18,30,48
1646,58thStGreenway22ndAve,03/10/2014 02:00:00 PM,48,-122,20,22,42
1647,58thStGreenway22ndAve,03/10/2014 03:00:00 PM,48,-122,18,22,40
1648,58thStGreenway22ndAve,03/10/2014 04:00:00 PM,48,-122,10,29,39
1649,58thStGreenway22ndAve,03/10/2014 05:00:00 PM,48,-122,22,29,51
1650,58thStGreenway22ndAve,03/10/2014 06:00:00 PM,48,-122,20,21,41
1651,58thStGreenway22ndAve,03/10/2014 07:00:00 PM,48,-122,8,11,19
1652,58thStGreenway22ndAve,03/10/2014 08:00:00 PM,48,-122,6,8,14
1653,58thStGreenway22ndAve,03/10/2014 09:00:00 PM,48,-122,10,9,19
1654,58thStGreenway22ndAve,03/10/2014 10:00:00 PM,48,-122,5,0,5
1655,58thStGreenway22ndAve,03/10/2014 11:00:00 PM,48,-122,3,3,6
1656,58thStGreenway22ndAve,03/11/2014 12:00:00 AM,48,-122,0,0,0
1657,58thStGreenway22ndAve,03/11/2014 01:00:00 AM,48,-122,0,2,2
1658,58thStGreenway22ndAve,03/11/2014 02:00:00 AM,48,-122,2,0,2
1659,58thStGreenway22ndAve,03/11/2014 03:00:00 AM,48,-122,0,0,0
1660,58thStGreenway22ndAve,03/11/2014 04:00:00 AM,48,-122,0,0,0
1661,58thStGreenway22ndAve,03/11/2014 05:00:00 AM,48,-122,3,6,9
1662,58thStGreenway22ndAve,03/11/2014 06:00:00 AM,48,-122,18,2,20
1663,58thStGreenway22ndAve,03/11/2014 07:00:00 AM,48,-122,28,16,44
1664,58thStGreenway22ndAve,03/11/2014 08:00:00 AM,48,-122,11,22,33
1665,58thStGreenway22ndAve,03/11/2014 09:00:00 AM,48,-122,30,15,45
1666,58thStGreenway22ndAve,03/11/2014 10:00:00 AM,48,-122,17,6,23
1667,58thStGreenway22ndAve,03/11/2014 11:00:00 AM,48,-122,16,20,36
1668,58thStGreenway22ndAve,03/11/2014 12:00:00 PM,48,-122,19,21,40
1669,58thStGreenway22ndAve,03/11/2014 01:00:00 PM,48,-122,20,25,45
1670,58thStGreenway22ndAve,03/11/2014 02:00:00 PM,48,-122,15,17,32
1671,58thStGreenway22ndAve,03/11/2014 03:00:00 PM,48,-122,24,12,36
1672,58thStGreenway22ndAve,03/11/2014 04:00:00 PM,48,-122,23,20,43
1673,58thStGreenway22ndAve,03/11/2014 05:00:00 PM,48,-122,14,20,34
1674,58thStGreenway22ndAve,03/11/2014 06:00:00 PM,48,-122,30,17,47
1675,58thStGreenway22ndAve,03/11/2014 07:00:00 PM,48,-122,24,14,38
1676,58thStGreenway22ndAve,03/11/2014 08:00:00 PM,48,-122,13,7,20
1677,58thStGreenway22ndAve,03/11/2014 09:00:00 PM,48,-122,13,8,21
1678,58thStGreenway22ndAve,03/11/2014 10:00:00 PM,48,-122,5,6,11
1679,58thStGreenway22ndAve,03/11/2014 11:00:00 PM,48,-122,3,0,3
1680,58thStGreenway22ndAve,03/12/2014 12:00:00 AM,48,-122,3,0,3
1681,58thStGreenway22ndAve,03/12/2014 01:00:00 AM,48,-122,0,2,2
1682,58thStGreenway22ndAve,03/12/2014 02:00:00 AM,48,-122,0,1,1
1683,58thStGreenway22ndAve,03/12/2014 03:00:00 AM,48,-122,0,0,0
1684,58thStGreenway22ndAve,03/12/2014 04:00:00 AM,48,-122,0,0,0
1685,58thStGreenway22ndAve,03/12/2014 05:00:00 AM,48,-122,4,0,4
1686,58thStGreenway22ndAve,03/12/2014 06:00:00 AM,48,-122,11,3,14
1687,58thStGreenway22ndAve,03/12/2014 07:00:00 AM,48,-122,30,7,37
1688,58thStGreenway22ndAve,03/12/2014 08:00:00 AM,48,-122,9,9,18
1689,58thStGreenway22ndAve,03/12/2014 09:00:00 AM,48,-122,26,17,43
1690,58thStGreenway22ndAve,03/12/2014 10:00:00 AM,48,-122,16,17,33
1691,58thStGreenway22ndAve,03/12/2014 11:00:00 AM,48,-122,21,26,47
1692,58thStGreenway22ndAve,03/12/2014 12:00:00 PM,48,-122,29,21,50
1693,58thStGreenway22ndAve,03/12/2014 01:00:00 PM,48,-122,26,18,44
1694,58thStGreenway22ndAve,03/12/2014 02:00:00 PM,48,-122,23,25,48
1695,58thStGreenway22ndAve,03/12/2014 03:00:00 PM,48,-122,16,16,32
1696,58thStGreenway22ndAve,03/12/2014 04:00:00 PM,48,-122,17,18,35
1697,58thStGreenway22ndAve,03/12/2014 05:00:00 PM,48,-122,36,33,69
1698,58thStGreenway22ndAve,03/12/2014 06:00:00 PM,48,-122,12,28,40
1699,58thStGreenway22ndAve,03/12/2014 07:00:00 PM,48,-122,13,19,32
1700,58thStGreenway22ndAve,03/12/2014 08:00:00 PM,48,-122,9,7,16
1701,58thStGreenway22ndAve,03/12/2014 09:00:00 PM,48,-122,16,5,21
1702,58thStGreenway22ndAve,03/12/2014 10:00:00 PM,48,-122,6,3,9
1703,58thStGreenway22ndAve,03/12/2014 11:00:00 PM,48,-122,6,0,6
1704,58thStGreenway22ndAve,03/13/2014 12:00:00 AM,48,-122,1,1,2
1705,58thStGreenway22ndAve,03/13/2014 01:00:00 AM,48,-122,0,0,0
1706,58thStGreenway22ndAve,03/13/2014 02:00:00 AM,48,-122,0,3,3
1707,58thStGreenway22ndAve,03/13/2014 03:00:00 AM,48,-122,0,1,1
1708,58thStGreenway22ndAve,03/13/2014 04:00:00 AM,48,-122,0,0,0
1709,58thStGreenway22ndAve,03/13/2014 05:00:00 AM,48,-122,0,8,8
1710,58thStGreenway22ndAve,03/13/2014 06:00:00 AM,48,-122,10,6,16
1711,58thStGreenway22ndAve,03/13/2014 07:00:00 AM,48,-122,23,4,27
1712,58thStGreenway22ndAve,03/13/2014 08:00:00 AM,48,-122,25,10,35
1713,58thStGreenway22ndAve,03/13/2014 09:00:00 AM,48,-122,21,22,43
1714,58thStGreenway22ndAve,03/13/2014 10:00:00 AM,48,-122,15,9,24
1715,58thStGreenway22ndAve,03/13/2014 11:00:00 AM,48,-122,15,11,26
1716,58thStGreenway22ndAve,03/13/2014 12:00:00 PM,48,-122,25,23,48
1717,58thStGreenway22ndAve,03/13/2014 01:00:00 PM,48,-122,17,10,27
1718,58thStGreenway22ndAve,03/13/2014 02:00:00 PM,48,-122,25,18,43
1719,58thStGreenway22ndAve,03/13/2014 03:00:00 PM,48,-122,35,13,48
1720,58thStGreenway22ndAve,03/13/2014 04:00:00 PM,48,-122,22,24,46
1721,58thStGreenway22ndAve,03/13/2014 05:00:00 PM,48,-122,33,16,49
1722,58thStGreenway22ndAve,03/13/2014 06:00:00 PM,48,-122,48,24,72
1723,58thStGreenway22ndAve,03/13/2014 07:00:00 PM,48,-122,7,18,25
1724,58thStGreenway22ndAve,03/13/2014 08:00:00 PM,48,-122,23,11,34
1725,58thStGreenway22ndAve,03/13/2014 09:00:00 PM,48,-122,9,5,14
1726,58thStGreenway22ndAve,03/13/2014 10:00:00 PM,48,-122,13,3,16
1727,58thStGreenway22ndAve,03/13/2014 11:00:00 PM,48,-122,6,2,8
1728,58thStGreenway22ndAve,03/14/2014 12:00:00 AM,48,-122,0,0,0
1729,58thStGreenway22ndAve,03/14/2014 01:00:00 AM,48,-122,2,0,2
1730,58thStGreenway22ndAve,03/14/2014 02:00:00 AM,48,-122,0,4,4
1731,58thStGreenway22ndAve,03/14/2014 03:00:00 AM,48,-122,0,1,1
1732,58thStGreenway22ndAve,03/14/2014 04:00:00 AM,48,-122,0,2,2
1733,58thStGreenway22ndAve,03/14/2014 05:00:00 AM,48,-122,2,0,2
1734,58thStGreenway22ndAve,03/14/2014 06:00:00 AM,48,-122,9,3,12
1735,58thStGreenway22ndAve,03/14/2014 07:00:00 AM,48,-122,29,5,34
1736,58thStGreenway22ndAve,03/14/2014 08:00:00 AM,48,-122,21,11,32
1737,58thStGreenway22ndAve,03/14/2014 09:00:00 AM,48,-122,21,19,40
1738,58thStGreenway22ndAve,03/14/2014 10:00:00 AM,48,-122,18,24,42
1739,58thStGreenway22ndAve,03/14/2014 11:00:00 AM,48,-122,15,20,35
1740,58thStGreenway22ndAve,03/14/2014 12:00:00 PM,48,-122,17,32,49
1741,58thStGreenway22ndAve,03/14/2014 01:00:00 PM,48,-122,19,29,48
1742,58thStGreenway22ndAve,03/14/2014 02:00:00 PM,48,-122,25,22,47
1743,58thStGreenway22ndAve,03/14/2014 03:00:00 PM,48,-122,30,8,38
1744,58thStGreenway22ndAve,03/14/2014 04:00:00 PM,48,-122,24,22,46
1745,58thStGreenway22ndAve,03/14/2014 05:00:00 PM,48,-122,28,18,46
1746,58thStGreenway22ndAve,03/14/2014 06:00:00 PM,48,-122,26,26,52
1747,58thStGreenway22ndAve,03/14/2014 07:00:00 PM,48,-122,20,16,36
1748,58thStGreenway22ndAve,03/14/2014 08:00:00 PM,48,-122,33,10,43
1749,58thStGreenway22ndAve,03/14/2014 09:00:00 PM,48,-122,3,7,10
1750,58thStGreenway22ndAve,03/14/2014 10:00:00 PM,48,-122,8,2,10
1751,58thStGreenway22ndAve,03/14/2014 11:00:00 PM,48,-122,9,2,11
1752,58thStGreenway22ndAve,03/15/2014 12:00:00 AM,48,-122,4,0,4
1753,58thStGreenway22ndAve,03/15/2014 01:00:00 AM,48,-122,2,0,2
1754,58thStGreenway22ndAve,03/15/2014 02:00:00 AM,48,-122,0,0,0
1755,58thStGreenway22ndAve,03/15/2014 03:00:00 AM,48,-122,2,0,2
1756,58thStGreenway22ndAve,03/15/2014 04:00:00 AM,48,-122,0,2,2
1757,58thStGreenway22ndAve,03/15/2014 05:00:00 AM,48,-122,6,4,10
1758,58thStGreenway22ndAve,03/15/2014 06:00:00 AM,48,-122,4,0,4
1759,58thStGreenway22ndAve,03/15/2014 07:00:00 AM,48,-122,4,5,9
1760,58thStGreenway22ndAve,03/15/2014 08:00:00 AM,48,-122,2,9,11
1761,58thStGreenway22ndAve,03/15/2014 09:00:00 AM,48,-122,24,9,33
1762,58thStGreenway22ndAve,03/15/2014 10:00:00 AM,48,-122,16,15,31
1763,58thStGreenway22ndAve,03/15/2014 11:00:00 AM,48,-122,29,22,51
1764,58thStGreenway22ndAve,03/15/2014 12:00:00 PM,48,-122,35,21,56
1765,58thStGreenway22ndAve,03/15/2014 01:00:00 PM,48,-122,19,21,40
1766,58thStGreenway22ndAve,03/15/2014 02:00:00 PM,48,-122,30,23,53
1767,58thStGreenway22ndAve,03/15/2014 03:00:00 PM,48,-122,34,29,63
1768,58thStGreenway22ndAve,03/15/2014 04:00:00 PM,48,-122,21,20,41
1769,58thStGreenway22ndAve,03/15/2014 05:00:00 PM,48,-122,13,27,40
1770,58thStGreenway22ndAve,03/15/2014 06:00:00 PM,48,-122,20,20,40
1771,58thStGreenway22ndAve,03/15/2014 07:00:00 PM,48,-122,12,14,26
1772,58thStGreenway22ndAve,03/15/2014 08:00:00 PM,48,-122,7,2,9
1773,58thStGreenway22ndAve,03/15/2014 09:00:00 PM,48,-122,15,18,33
1774,58thStGreenway22ndAve,03/15/2014 10:00:00 PM,48,-122,8,10,18
1775,58thStGreenway22ndAve,03/15/2014 11:00:00 PM,48,-122,4,6,10
1776,58thStGreenway22ndAve,03/16/2014 12:00:00 AM,48,-122,7,4,11
1777,58thStGreenway22ndAve,03/16/2014 01:00:00 AM,48,-122,5,2,7
1778,58thStGreenway22ndAve,03/16/2014 02:00:00 AM,48,-122,2,0,2
1779,58thStGreenway22ndAve,03/16/2014 03:00:00 AM,48,-122,0,0,0
1780,58thStGreenway22ndAve,03/16/2014 04:00:00 AM,48,-122,0,0,0
1781,58thStGreenway22ndAve,03/16/2014 05:00:00 AM,48,-122,0,0,0
1782,58thStGreenway22ndAve,03/16/2014 06:00:00 AM,48,-122,1,0,1
1783,58thStGreenway22ndAve,03/16/2014 07:00:00 AM,48,-122,6,0,6
1784,58thStGreenway22ndAve,03/16/2014 08:00:00 AM,48,-122,3,4,7
1785,58thStGreenway22ndAve,03/16/2014 09:00:00 AM,48,-122,10,6,16
1786,58thStGreenway22ndAve,03/16/2014 10:00:00 AM,48,-122,12,5,17
1787,58thStGreenway22ndAve,03/16/2014 11:00:00 AM,48,-122,21,24,45
1788,58thStGreenway22ndAve,03/16/2014 12:00:00 PM,48,-122,25,14,39
1789,58thStGreenway22ndAve,03/16/2014 01:00:00 PM,48,-122,42,32,74
1790,58thStGreenway22ndAve,03/16/2014 02:00:00 PM,48,-122,18,25,43
1791,58thStGreenway22ndAve,03/16/2014 03:00:00 PM,48,-122,14,20,34
1792,58thStGreenway22ndAve,03/16/2014 04:00:00 PM,48,-122,17,20,37
1793,58thStGreenway22ndAve,03/16/2014 05:00:00 PM,48,-122,26,11,37
1794,58thStGreenway22ndAve,03/16/2014 06:00:00 PM,48,-122,12,14,26
1795,58thStGreenway22ndAve,03/16/2014 07:00:00 PM,48,-122,16,12,28
1796,58thStGreenway22ndAve,03/16/2014 08:00:00 PM,48,-122,6,0,6
1797,58thStGreenway22ndAve,03/16/2014 09:00:00 PM,48,-122,6,1,7
1798,58thStGreenway22ndAve,03/16/2014 10:00:00 PM,48,-122,3,0,3
1799,58thStGreenway22ndAve,03/16/2014 11:00:00 PM,48,-122,8,3,11
1800,58thStGreenway22ndAve,03/17/2014 12:00:00 AM,48,-122,0,1,1
1801,58thStGreenway22ndAve,03/17/2014 01:00:00 AM,48,-122,0,2,2
1802,58thStGreenway22ndAve,03/17/2014 02:00:00 AM,48,-122,0,0,0
1803,58thStGreenway22ndAve,03/17/2014 03:00:00 AM,48,-122,0,0,0
1804,58thStGreenway22ndAve,03/17/2014 04:00:00 AM,48,-122,0,0,0
1805,58thStGreenway22ndAve,03/17/2014 05:00:00 AM,48,-122,0,1,1
1806,58thStGreenway22ndAve,03/17/2014 06:00:00 AM,48,-122,5,3,8
1807,58thStGreenway22ndAve,03/17/2014 07:00:00 AM,48,-122,16,9,25
1808,58thStGreenway22ndAve,03/17/2014 08:00:00 AM,48,-122,21,16,37
1809,58thStGreenway22ndAve,03/17/2014 09:00:00 AM,48,-122,22,28,50
1810,58thStGreenway22ndAve,03/17/2014 10:00:00 AM,48,-122,8,12,20
1811,58thStGreenway22ndAve,03/17/2014 11:00:00 AM,48,-122,23,23,46
1812,58thStGreenway22ndAve,03/17/2014 12:00:00 PM,48,-122,21,25,46
1813,58thStGreenway22ndAve,03/17/2014 01:00:00 PM,48,-122,17,22,39
1814,58thStGreenway22ndAve,03/17/2014 02:00:00 PM,48,-122,12,24,36
1815,58thStGreenway22ndAve,03/17/2014 03:00:00 PM,48,-122,17,20,37
1816,58thStGreenway22ndAve,03/17/2014 04:00:00 PM,48,-122,30,20,50
1817,58thStGreenway22ndAve,03/17/2014 05:00:00 PM,48,-122,14,40,54
1818,58thStGreenway22ndAve,03/17/2014 06:00:00 PM,48,-122,17,25,42
1819,58thStGreenway22ndAve,03/17/2014 07:00:00 PM,48,-122,15,20,35
1820,58thStGreenway22ndAve,03/17/2014 08:00:00 PM,48,-122,14,15,29
1821,58thStGreenway22ndAve,03/17/2014 09:00:00 PM,48,-122,6,0,6
1822,58thStGreenway22ndAve,03/17/2014 10:00:00 PM,48,-122,5,3,8
1823,58thStGreenway22ndAve,03/17/2014 11:00:00 PM,48,-122,3,1,4
1824,58thStGreenway22ndAve,03/18/2014 12:00:00 AM,48,-122,2,1,3
1825,58thStGreenway22ndAve,03/18/2014 01:00:00 AM,48,-122,0,0,0
1826,58thStGreenway22ndAve,03/18/2014 02:00:00 AM,48,-122,0,1,1
1827,58thStGreenway22ndAve,03/18/2014 03:00:00 AM,48,-122,0,0,0
1828,58thStGreenway22ndAve,03/18/2014 04:00:00 AM,48,-122,3,1,4
1829,58thStGreenway22ndAve,03/18/2014 05:00:00 AM,48,-122,4,7,11
1830,58thStGreenway22ndAve,03/18/2014 06:00:00 AM,48,-122,5,1,6
1831,58thStGreenway22ndAve,03/18/2014 07:00:00 AM,48,-122,10,10,20
1832,58thStGreenway22ndAve,03/18/2014 08:00:00 AM,48,-122,24,13,37
1833,58thStGreenway22ndAve,03/18/2014 09:00:00 AM,48,-122,13,17,30
1834,58thStGreenway22ndAve,03/18/2014 10:00:00 AM,48,-122,5,7,12
1835,58thStGreenway22ndAve,03/18/2014 11:00:00 AM,48,-122,18,18,36
1836,58thStGreenway22ndAve,03/18/2014 12:00:00 PM,48,-122,20,19,39
1837,58thStGreenway22ndAve,03/18/2014 01:00:00 PM,48,-122,10,9,19
1838,58thStGreenway22ndAve,03/18/2014 02:00:00 PM,48,-122,17,17,34
1839,58thStGreenway22ndAve,03/18/2014 03:00:00 PM,48,-122,29,19,48
1840,58thStGreenway22ndAve,03/18/2014 04:00:00 PM,48,-122,29,22,51
1841,58thStGreenway22ndAve,03/18/2014 05:00:00 PM,48,-122,32,16,48
1842,58thStGreenway22ndAve,03/18/2014 06:00:00 PM,48,-122,17,22,39
1843,58thStGreenway22ndAve,03/18/2014 07:00:00 PM,48,-122,14,23,37
1844,58thStGreenway22ndAve,03/18/2014 08:00:00 PM,48,-122,12,4,16
1845,58thStGreenway22ndAve,03/18/2014 09:00:00 PM,48,-122,7,6,13
1846,58thStGreenway22ndAve,03/18/2014 10:00:00 PM,48,-122,0,0,0
1847,58thStGreenway22ndAve,03/18/2014 11:00:00 PM,48,-122,3,2,5
1848,58thStGreenway22ndAve,03/19/2014 12:00:00 AM,48,-122,2,2,4
1849,58thStGreenway22ndAve,03/19/2014 01:00:00 AM,48,-122,2,2,4
1850,58thStGreenway22ndAve,03/19/2014 02:00:00 AM,48,-122,2,2,4
1851,58thStGreenway22ndAve,03/19/2014 03:00:00 AM,48,-122,1,1,2
1852,58thStGreenway22ndAve,03/19/2014 04:00:00 AM,48,-122,0,0,0
1853,58thStGreenway22ndAve,03/19/2014 05:00:00 AM,48,-122,5,3,8
1854,58thStGreenway22ndAve,03/19/2014 06:00:00 AM,48,-122,10,4,14
1855,58thStGreenway22ndAve,03/19/2014 07:00:00 AM,48,-122,18,5,23
1856,58thStGreenway22ndAve,03/19/2014 08:00:00 AM,48,-122,13,17,30
1857,58thStGreenway22ndAve,03/19/2014 09:00:00 AM,48,-122,8,23,31
1858,58thStGreenway22ndAve,03/19/2014 10:00:00 AM,48,-122,17,13,30
1859,58thStGreenway22ndAve,03/19/2014 11:00:00 AM,48,-122,7,18,25
1860,58thStGreenway22ndAve,03/19/2014 12:00:00 PM,48,-122,25,13,38
1861,58thStGreenway22ndAve,03/19/2014 01:00:00 PM,48,-122,9,13,22
1862,58thStGreenway22ndAve,03/19/2014 02:00:00 PM,48,-122,18,13,31
1863,58thStGreenway22ndAve,03/19/2014 03:00:00 PM,48,-122,10,10,20
1864,58thStGreenway22ndAve,03/19/2014 04:00:00 PM,48,-122,17,14,31
1865,58thStGreenway22ndAve,03/19/2014 05:00:00 PM,48,-122,26,15,41
1866,58thStGreenway22ndAve,03/19/2014 06:00:00 PM,48,-122,19,13,32
1867,58thStGreenway22ndAve,03/19/2014 07:00:00 PM,48,-122,15,17,32
1868,58thStGreenway22ndAve,03/19/2014 08:00:00 PM,48,-122,11,9,20
1869,58thStGreenway22ndAve,03/19/2014 09:00:00 PM,48,-122,8,4,12
1870,58thStGreenway22ndAve,03/19/2014 10:00:00 PM,48,-122,0,3,3
1871,58thStGreenway22ndAve,03/19/2014 11:00:00 PM,48,-122,3,2,5
1872,58thStGreenway22ndAve,03/20/2014 12:00:00 AM,48,-122,0,2,2
1873,58thStGreenway22ndAve,03/20/2014 01:00:00 AM,48,-122,0,0,0
1874,58thStGreenway22ndAve,03/20/2014 02:00:00 AM,48,-122,0,0,0
1875,58thStGreenway22ndAve,03/20/2014 03:00:00 AM,48,-122,0,0,0
1876,58thStGreenway22ndAve,03/20/2014 04:00:00 AM,48,-122,2,0,2
1877,58thStGreenway22ndAve,03/20/2014 05:00:00 AM,48,-122,5,0,5
1878,58thStGreenway22ndAve,03/20/2014 06:00:00 AM,48,-122,0,1,1
1879,58thStGreenway22ndAve,03/20/2014 07:00:00 AM,48,-122,13,5,18
1880,58thStGreenway22ndAve,03/20/2014 08:00:00 AM,48,-122,24,14,38
1881,58thStGreenway22ndAve,03/20/2014 09:00:00 AM,48,-122,15,9,24
1882,58thStGreenway22ndAve,03/20/2014 10:00:00 AM,48,-122,16,18,34
1883,58thStGreenway22ndAve,03/20/2014 11:00:00 AM,48,-122,11,9,20
1884,58thStGreenway22ndAve,03/20/2014 12:00:00 PM,48,-122,15,17,32
1885,58thStGreenway22ndAve,03/20/2014 01:00:00 PM,48,-122,22,14,36
1886,58thStGreenway22ndAve,03/20/2014 02:00:00 PM,48,-122,21,23,44
1887,58thStGreenway22ndAve,03/20/2014 03:00:00 PM,48,-122,21,11,32
1888,58thStGreenway22ndAve,03/20/2014 04:00:00 PM,48,-122,16,14,30
1889,58thStGreenway22ndAve,03/20/2014 05:00:00 PM,48,-122,17,12,29
1890,58thStGreenway22ndAve,03/20/2014 06:00:00 PM,48,-122,37,33,70
1891,58thStGreenway22ndAve,03/20/2014 07:00:00 PM,48,-122,20,16,36
1892,58thStGreenway22ndAve,03/20/2014 08:00:00 PM,48,-122,13,13,26
1893,58thStGreenway22ndAve,03/20/2014 09:00:00 PM,48,-122,14,7,21
1894,58thStGreenway22ndAve,03/20/2014 10:00:00 PM,48,-122,6,0,6
1895,58thStGreenway22ndAve,03/20/2014 11:00:00 PM,48,-122,9,0,9
1896,58thStGreenway22ndAve,03/21/2014 12:00:00 AM,48,-122,2,0,2
1897,58thStGreenway22ndAve,03/21/2014 01:00:00 AM,48,-122,0,0,0
1898,58thStGreenway22ndAve,03/21/2014 02:00:00 AM,48,-122,2,0,2
1899,58thStGreenway22ndAve,03/21/2014 03:00:00 AM,48,-122,0,0,0
1900,58thStGreenway22ndAve,03/21/2014 04:00:00 AM,48,-122,2,0,2
1901,58thStGreenway22ndAve,03/21/2014 05:00:00 AM,48,-122,4,2,6
1902,58thStGreenway22ndAve,03/21/2014 06:00:00 AM,48,-122,0,4,4
1903,58thStGreenway22ndAve,03/21/2014 07:00:00 AM,48,-122,14,4,18
1904,58thStGreenway22ndAve,03/21/2014 08:00:00 AM,48,-122,20,10,30
1905,58thStGreenway22ndAve,03/21/2014 09:00:00 AM,48,-122,22,9,31
1906,58thStGreenway22ndAve,03/21/2014 10:00:00 AM,48,-122,30,10,40
1907,58thStGreenway22ndAve,03/21/2014 11:00:00 AM,48,-122,26,11,37
1908,58thStGreenway22ndAve,03/21/2014 12:00:00 PM,48,-122,28,19,47
1909,58thStGreenway22ndAve,03/21/2014 01:00:00 PM,48,-122,26,7,33
1910,58thStGreenway22ndAve,03/21/2014 02:00:00 PM,48,-122,16,12,28
1911,58thStGreenway22ndAve,03/21/2014 03:00:00 PM,48,-122,20,8,28
1912,58thStGreenway22ndAve,03/21/2014 04:00:00 PM,48,-122,16,18,34
1913,58thStGreenway22ndAve,03/21/2014 05:00:00 PM,48,-122,29,21,50
1914,58thStGreenway22ndAve,03/21/2014 06:00:00 PM,48,-122,26,23,49
1915,58thStGreenway22ndAve,03/21/2014 07:00:00 PM,48,-122,24,11,35
1916,58thStGreenway22ndAve,03/21/2014 08:00:00 PM,48,-122,25,8,33
1917,58thStGreenway22ndAve,03/21/2014 09:00:00 PM,48,-122,16,2,18
1918,58thStGreenway22ndAve,03/21/2014 10:00:00 PM,48,-122,12,3,15
1919,58thStGreenway22ndAve,03/21/2014 11:00:00 PM,48,-122,8,0,8
1920,58thStGreenway22ndAve,03/22/2014 12:00:00 AM,48,-122,5,1,6
1921,58thStGreenway22ndAve,03/22/2014 01:00:00 AM,48,-122,4,3,7
1922,58thStGreenway22ndAve,03/22/2014 02:00:00 AM,48,-122,2,0,2
1923,58thStGreenway22ndAve,03/22/2014 03:00:00 AM,48,-122,0,0,0
1924,58thStGreenway22ndAve,03/22/2014 04:00:00 AM,48,-122,0,2,2
1925,58thStGreenway22ndAve,03/22/2014 05:00:00 AM,48,-122,2,0,2
1926,58thStGreenway22ndAve,03/22/2014 06:00:00 AM,48,-122,0,0,0
1927,58thStGreenway22ndAve,03/22/2014 07:00:00 AM,48,-122,8,3,11
1928,58thStGreenway22ndAve,03/22/2014 08:00:00 AM,48,-122,3,9,12
1929,58thStGreenway22ndAve,03/22/2014 09:00:00 AM,48,-122,20,8,28
1930,58thStGreenway22ndAve,03/22/2014 10:00:00 AM,48,-122,20,33,53
1931,58thStGreenway22ndAve,03/22/2014 11:00:00 AM,48,-122,20,19,39
1932,58thStGreenway22ndAve,03/22/2014 12:00:00 PM,48,-122,32,19,51
1933,58thStGreenway22ndAve,03/22/2014 01:00:00 PM,48,-122,47,21,68
1934,58thStGreenway22ndAve,03/22/2014 02:00:00 PM,48,-122,29,28,57
1935,58thStGreenway22ndAve,03/22/2014 03:00:00 PM,48,-122,25,27,52
1936,58thStGreenway22ndAve,03/22/2014 04:00:00 PM,48,-122,16,14,30
1937,58thStGreenway22ndAve,03/22/2014 05:00:00 PM,48,-122,18,11,29
1938,58thStGreenway22ndAve,03/22/2014 06:00:00 PM,48,-122,19,15,34
1939,58thStGreenway22ndAve,03/22/2014 07:00:00 PM,48,-122,15,8,23
1940,58thStGreenway22ndAve,03/22/2014 08:00:00 PM,48,-122,18,3,21
1941,58thStGreenway22ndAve,03/22/2014 09:00:00 PM,48,-122,6,5,11
1942,58thStGreenway22ndAve,03/22/2014 10:00:00 PM,48,-122,11,0,11
1943,58thStGreenway22ndAve,03/22/2014 11:00:00 PM,48,-122,2,2,4
1944,58thStGreenway22ndAve,03/23/2014 12:00:00 AM,48,-122,3,0,3
1945,58thStGreenway22ndAve,03/23/2014 01:00:00 AM,48,-122,0,3,3
1946,58thStGreenway22ndAve,03/23/2014 02:00:00 AM,48,-122,3,0,3
1947,58thStGreenway22ndAve,03/23/2014 03:00:00 AM,48,-122,0,0,0
1948,58thStGreenway22ndAve,03/23/2014 04:00:00 AM,48,-122,0,0,0
1949,58thStGreenway22ndAve,03/23/2014 05:00:00 AM,48,-122,0,0,0
1950,58thStGreenway22ndAve,03/23/2014 06:00:00 AM,48,-122,0,0,0
1951,58thStGreenway22ndAve,03/23/2014 07:00:00 AM,48,-122,0,4,4
1952,58thStGreenway22ndAve,03/23/2014 08:00:00 AM,48,-122,8,5,13
1953,58thStGreenway22ndAve,03/23/2014 09:00:00 AM,48,-122,15,3,18
1954,58thStGreenway22ndAve,03/23/2014 10:00:00 AM,48,-122,24,19,43
1955,58thStGreenway22ndAve,03/23/2014 11:00:00 AM,48,-122,30,28,58
1956,58thStGreenway22ndAve,03/23/2014 12:00:00 PM,48,-122,37,37,74
1957,58thStGreenway22ndAve,03/23/2014 01:00:00 PM,48,-122,43,31,74
1958,58thStGreenway22ndAve,03/23/2014 02:00:00 PM,48,-122,21,20,41
1959,58thStGreenway22ndAve,03/23/2014 03:00:00 PM,48,-122,46,26,72
1960,58thStGreenway22ndAve,03/23/2014 04:00:00 PM,48,-122,38,27,65
1961,58thStGreenway22ndAve,03/23/2014 05:00:00 PM,48,-122,26,14,40
1962,58thStGreenway22ndAve,03/23/2014 06:00:00 PM,48,-122,11,8,19
1963,58thStGreenway22ndAve,03/23/2014 07:00:00 PM,48,-122,11,7,18
1964,58thStGreenway22ndAve,03/23/2014 08:00:00 PM,48,-122,16,4,20
1965,58thStGreenway22ndAve,03/23/2014 09:00:00 PM,48,-122,12,0,12
1966,58thStGreenway22ndAve,03/23/2014 10:00:00 PM,48,-122,3,0,3
1967,58thStGreenway22ndAve,03/23/2014 11:00:00 PM,48,-122,6,1,7
1968,58thStGreenway22ndAve,03/24/2014 12:00:00 AM,48,-122,0,0,0
1969,58thStGreenway22ndAve,03/24/2014 01:00:00 AM,48,-122,2,0,2
1970,58thStGreenway22ndAve,03/24/2014 02:00:00 AM,48,-122,0,2,2
1971,58thStGreenway22ndAve,03/24/2014 03:00:00 AM,48,-122,0,1,1
1972,58thStGreenway22ndAve,03/24/2014 04:00:00 AM,48,-122,0,0,0
1973,58thStGreenway22ndAve,03/24/2014 05:00:00 AM,48,-122,8,2,10
1974,58thStGreenway22ndAve,03/24/2014 06:00:00 AM,48,-122,11,1,12
1975,58thStGreenway22ndAve,03/24/2014 07:00:00 AM,48,-122,14,16,30
1976,58thStGreenway22ndAve,03/24/2014 08:00:00 AM,48,-122,22,17,39
1977,58thStGreenway22ndAve,03/24/2014 09:00:00 AM,48,-122,13,11,24
1978,58thStGreenway22ndAve,03/24/2014 10:00:00 AM,48,-122,12,14,26
1979,58thStGreenway22ndAve,03/24/2014 11:00:00 AM,48,-122,19,16,35
1980,58thStGreenway22ndAve,03/24/2014 12:00:00 PM,48,-122,29,23,52
1981,58thStGreenway22ndAve,03/24/2014 01:00:00 PM,48,-122,15,12,27
1982,58thStGreenway22ndAve,03/24/2014 02:00:00 PM,48,-122,34,20,54
1983,58thStGreenway22ndAve,03/24/2014 03:00:00 PM,48,-122,10,23,33
1984,58thStGreenway22ndAve,03/24/2014 04:00:00 PM,48,-122,21,15,36
1985,58thStGreenway22ndAve,03/24/2014 05:00:00 PM,48,-122,34,26,60
1986,58thStGreenway22ndAve,03/24/2014 06:00:00 PM,48,-122,27,18,45
1987,58thStGreenway22ndAve,03/24/2014 07:00:00 PM,48,-122,26,9,35
1988,58thStGreenway22ndAve,03/24/2014 08:00:00 PM,48,-122,4,7,11
1989,58thStGreenway22ndAve,03/24/2014 09:00:00 PM,48,-122,2,0,2
1990,58thStGreenway22ndAve,03/24/2014 10:00:00 PM,48,-122,6,0,6
1991,58thStGreenway22ndAve,03/24/2014 11:00:00 PM,48,-122,5,8,13
1992,58thStGreenway22ndAve,03/25/2014 12:00:00 AM,48,-122,0,1,1
1993,58thStGreenway22ndAve,03/25/2014 01:00:00 AM,48,-122,0,0,0
1994,58thStGreenway22ndAve,03/25/2014 02:00:00 AM,48,-122,1,0,1
1995,58thStGreenway22ndAve,03/25/2014 03:00:00 AM,48,-122,0,0,0
1996,58thStGreenway22ndAve,03/25/2014 04:00:00 AM,48,-122,0,0,0
1997,58thStGreenway22ndAve,03/25/2014 05:00:00 AM,48,-122,0,0,0
1998,58thStGreenway22ndAve,03/25/2014 06:00:00 AM,48,-122,1,1,2
1999,58thStGreenway22ndAve,03/25/2014 07:00:00 AM,48,-122,15,11,26
2000,58thStGreenway22ndAve,03/25/2014 08:00:00 AM,48,-122,14,18,32
2001,58thStGreenway22ndAve,03/25/2014 09:00:00 AM,48,-122,19,7,26
2002,58thStGreenway22ndAve,03/25/2014 10:00:00 AM,48,-122,12,7,19
2003,58thStGreenway22ndAve,03/25/2014 11:00:00 AM,48,-122,21,6,27
2004,58thStGreenway22ndAve,03/25/2014 12:00:00 PM,48,-122,16,17,33
2005,58thStGreenway22ndAve,03/25/2014 01:00:00 PM,48,-122,16,16,32
2006,58thStGreenway22ndAve,03/25/2014 02:00:00 PM,48,-122,17,8,25
2007,58thStGreenway22ndAve,03/25/2014 03:00:00 PM,48,-122,17,17,34
2008,58thStGreenway22ndAve,03/25/2014 04:00:00 PM,48,-122,18,12,30
2009,58thStGreenway22ndAve,03/25/2014 05:00:00 PM,48,-122,22,30,52
2010,58thStGreenway22ndAve,03/25/2014 06:00:00 PM,48,-122,17,24,41
2011,58thStGreenway22ndAve,03/25/2014 07:00:00 PM,48,-122,13,27,40
2012,58thStGreenway22ndAve,03/25/2014 08:00:00 PM,48,-122,6,2,8
2013,58thStGreenway22ndAve,03/25/2014 09:00:00 PM,48,-122,13,3,16
2014,58thStGreenway22ndAve,03/25/2014 10:00:00 PM,48,-122,1,3,4
2015,58thStGreenway22ndAve,03/25/2014 11:00:00 PM,48,-122,7,0,7
2016,58thStGreenway22ndAve,03/26/2014 12:00:00 AM,48,-122,0,3,3
2017,58thStGreenway22ndAve,03/26/2014 01:00:00 AM,48,-122,0,2,2
2018,58thStGreenway22ndAve,03/26/2014 02:00:00 AM,48,-122,0,0,0
2019,58thStGreenway22ndAve,03/26/2014 03:00:00 AM,48,-122,0,0,0
2020,58thStGreenway22ndAve,03/26/2014 04:00:00 AM,48,-122,0,0,0
2021,58thStGreenway22ndAve,03/26/2014 05:00:00 AM,48,-122,4,2,6
2022,58thStGreenway22ndAve,03/26/2014 06:00:00 AM,48,-122,6,4,10
2023,58thStGreenway22ndAve,03/26/2014 07:00:00 AM,48,-122,18,3,21
2024,58thStGreenway22ndAve,03/26/2014 08:00:00 AM,48,-122,25,9,34
2025,58thStGreenway22ndAve,03/26/2014 09:00:00 AM,48,-122,17,9,26
2026,58thStGreenway22ndAve,03/26/2014 10:00:00 AM,48,-122,20,18,38
2027,58thStGreenway22ndAve,03/26/2014 11:00:00 AM,48,-122,24,13,37
2028,58thStGreenway22ndAve,03/26/2014 12:00:00 PM,48,-122,28,19,47
2029,58thStGreenway22ndAve,03/26/2014 01:00:00 PM,48,-122,15,23,38
2030,58thStGreenway22ndAve,03/26/2014 02:00:00 PM,48,-122,17,16,33
2031,58thStGreenway22ndAve,03/26/2014 03:00:00 PM,48,-122,18,11,29
2032,58thStGreenway22ndAve,03/26/2014 04:00:00 PM,48,-122,23,15,38
2033,58thStGreenway22ndAve,03/26/2014 05:00:00 PM,48,-122,22,13,35
2034,58thStGreenway22ndAve,03/26/2014 06:00:00 PM,48,-122,15,29,44
2035,58thStGreenway22ndAve,03/26/2014 07:00:00 PM,48,-122,11,18,29
2036,58thStGreenway22ndAve,03/26/2014 08:00:00 PM,48,-122,6,7,13
2037,58thStGreenway22ndAve,03/26/2014 09:00:00 PM,48,-122,8,6,14
2038,58thStGreenway22ndAve,03/26/2014 10:00:00 PM,48,-122,2,3,5
2039,58thStGreenway22ndAve,03/26/2014 11:00:00 PM,48,-122,4,1,5
2040,58thStGreenway22ndAve,03/27/2014 12:00:00 AM,48,-122,2,1,3
2041,58thStGreenway22ndAve,03/27/2014 01:00:00 AM,48,-122,0,4,4
2042,58thStGreenway22ndAve,03/27/2014 02:00:00 AM,48,-122,0,0,0
2043,58thStGreenway22ndAve,03/27/2014 03:00:00 AM,48,-122,2,0,2
2044,58thStGreenway22ndAve,03/27/2014 04:00:00 AM,48,-122,0,0,0
2045,58thStGreenway22ndAve,03/27/2014 05:00:00 AM,48,-122,2,0,2
2046,58thStGreenway22ndAve,03/27/2014 06:00:00 AM,48,-122,8,3,11
2047,58thStGreenway22ndAve,03/27/2014 07:00:00 AM,48,-122,15,5,20
2048,58thStGreenway22ndAve,03/27/2014 08:00:00 AM,48,-122,4,23,27
2049,58thStGreenway22ndAve,03/27/2014 09:00:00 AM,48,-122,28,12,40
2050,58thStGreenway22ndAve,03/27/2014 10:00:00 AM,48,-122,14,12,26
2051,58thStGreenway22ndAve,03/27/2014 11:00:00 AM,48,-122,21,17,38
2052,58thStGreenway22ndAve,03/27/2014 12:00:00 PM,48,-122,20,27,47
2053,58thStGreenway22ndAve,03/27/2014 01:00:00 PM,48,-122,13,16,29
2054,58thStGreenway22ndAve,03/27/2014 02:00:00 PM,48,-122,29,14,43
2055,58thStGreenway22ndAve,03/27/2014 03:00:00 PM,48,-122,34,28,62
2056,58thStGreenway22ndAve,03/27/2014 04:00:00 PM,48,-122,26,13,39
2057,58thStGreenway22ndAve,03/27/2014 05:00:00 PM,48,-122,29,21,50
2058,58thStGreenway22ndAve,03/27/2014 06:00:00 PM,48,-122,18,24,42
2059,58thStGreenway22ndAve,03/27/2014 07:00:00 PM,48,-122,24,27,51
2060,58thStGreenway22ndAve,03/27/2014 08:00:00 PM,48,-122,12,6,18
2061,58thStGreenway22ndAve,03/27/2014 09:00:00 PM,48,-122,5,3,8
2062,58thStGreenway22ndAve,03/27/2014 10:00:00 PM,48,-122,13,3,16
2063,58thStGreenway22ndAve,03/27/2014 11:00:00 PM,48,-122,5,4,9
2064,58thStGreenway22ndAve,03/28/2014 12:00:00 AM,48,-122,0,2,2
2065,58thStGreenway22ndAve,03/28/2014 01:00:00 AM,48,-122,0,0,0
2066,58thStGreenway22ndAve,03/28/2014 02:00:00 AM,48,-122,0,4,4
2067,58thStGreenway22ndAve,03/28/2014 03:00:00 AM,48,-122,0,2,2
2068,58thStGreenway22ndAve,03/28/2014 04:00:00 AM,48,-122,0,0,0
2069,58thStGreenway22ndAve,03/28/2014 05:00:00 AM,48,-122,4,4,8
2070,58thStGreenway22ndAve,03/28/2014 06:00:00 AM,48,-122,7,4,11
2071,58thStGreenway22ndAve,03/28/2014 07:00:00 AM,48,-122,8,14,22
2072,58thStGreenway22ndAve,03/28/2014 08:00:00 AM,48,-122,15,18,33
2073,58thStGreenway22ndAve,03/28/2014 09:00:00 AM,48,-122,9,21,30
2074,58thStGreenway22ndAve,03/28/2014 10:00:00 AM,48,-122,9,13,22
2075,58thStGreenway22ndAve,03/28/2014 11:00:00 AM,48,-122,14,18,32
2076,58thStGreenway22ndAve,03/28/2014 12:00:00 PM,48,-122,15,24,39
2077,58thStGreenway22ndAve,03/28/2014 01:00:00 PM,48,-122,12,16,28
2078,58thStGreenway22ndAve,03/28/2014 02:00:00 PM,48,-122,10,18,28
2079,58thStGreenway22ndAve,03/28/2014 03:00:00 PM,48,-122,13,23,36
2080,58thStGreenway22ndAve,03/28/2014 04:00:00 PM,48,-122,29,33,62
2081,58thStGreenway22ndAve,03/28/2014 05:00:00 PM,48,-122,24,36,60
2082,58thStGreenway22ndAve,03/28/2014 06:00:00 PM,48,-122,22,26,48
2083,58thStGreenway22ndAve,03/28/2014 07:00:00 PM,48,-122,18,27,45
2084,58thStGreenway22ndAve,03/28/2014 08:00:00 PM,48,-122,13,20,33
2085,58thStGreenway22ndAve,03/28/2014 09:00:00 PM,48,-122,13,10,23
2086,58thStGreenway22ndAve,03/28/2014 10:00:00 PM,48,-122,6,0,6
2087,58thStGreenway22ndAve,03/28/2014 11:00:00 PM,48,-122,10,2,12
2088,58thStGreenway22ndAve,03/29/2014 12:00:00 AM,48,-122,2,0,2
2089,58thStGreenway22ndAve,03/29/2014 01:00:00 AM,48,-122,0,0,0
2090,58thStGreenway22ndAve,03/29/2014 02:00:00 AM,48,-122,2,0,2
2091,58thStGreenway22ndAve,03/29/2014 03:00:00 AM,48,-122,2,0,2
2092,58thStGreenway22ndAve,03/29/2014 04:00:00 AM,48,-122,1,0,1
2093,58thStGreenway22ndAve,03/29/2014 05:00:00 AM,48,-122,0,0,0
2094,58thStGreenway22ndAve,03/29/2014 06:00:00 AM,48,-122,2,2,4
2095,58thStGreenway22ndAve,03/29/2014 07:00:00 AM,48,-122,2,0,2
2096,58thStGreenway22ndAve,03/29/2014 08:00:00 AM,48,-122,13,20,33
2097,58thStGreenway22ndAve,03/29/2014 09:00:00 AM,48,-122,13,22,35
2098,58thStGreenway22ndAve,03/29/2014 10:00:00 AM,48,-122,21,22,43
2099,58thStGreenway22ndAve,03/29/2014 11:00:00 AM,48,-122,17,44,61
2100,58thStGreenway22ndAve,03/29/2014 12:00:00 PM,48,-122,31,33,64
2101,58thStGreenway22ndAve,03/29/2014 01:00:00 PM,48,-122,13,20,33
2102,58thStGreenway22ndAve,03/29/2014 02:00:00 PM,48,-122,37,39,76
2103,58thStGreenway22ndAve,03/29/2014 03:00:00 PM,48,-122,10,23,33
2104,58thStGreenway22ndAve,03/29/2014 04:00:00 PM,48,-122,13,19,32
2105,58thStGreenway22ndAve,03/29/2014 05:00:00 PM,48,-122,7,33,40
2106,58thStGreenway22ndAve,03/29/2014 06:00:00 PM,48,-122,15,16,31
2107,58thStGreenway22ndAve,03/29/2014 07:00:00 PM,48,-122,17,25,42
2108,58thStGreenway22ndAve,03/29/2014 08:00:00 PM,48,-122,8,9,17
2109,58thStGreenway22ndAve,03/29/2014 09:00:00 PM,48,-122,9,12,21
2110,58thStGreenway22ndAve,03/29/2014 10:00:00 PM,48,-122,4,10,14
2111,58thStGreenway22ndAve,03/29/2014 11:00:00 PM,48,-122,1,1,2
2112,58thStGreenway22ndAve,03/30/2014 12:00:00 AM,48,-122,6,2,8
2113,58thStGreenway22ndAve,03/30/2014 01:00:00 AM,48,-122,4,2,6
2114,58thStGreenway22ndAve,03/30/2014 02:00:00 AM,48,-122,1,1,2
2115,58thStGreenway22ndAve,03/30/2014 03:00:00 AM,48,-122,0,0,0
2116,58thStGreenway22ndAve,03/30/2014 04:00:00 AM,48,-122,2,0,2
2117,58thStGreenway22ndAve,03/30/2014 05:00:00 AM,48,-122,0,2,2
2118,58thStGreenway22ndAve,03/30/2014 06:00:00 AM,48,-122,5,1,6
2119,58thStGreenway22ndAve,03/30/2014 07:00:00 AM,48,-122,6,2,8
2120,58thStGreenway22ndAve,03/30/2014 08:00:00 AM,48,-122,1,2,3
2121,58thStGreenway22ndAve,03/30/2014 09:00:00 AM,48,-122,18,14,32
2122,58thStGreenway22ndAve,03/30/2014 10:00:00 AM,48,-122,14,20,34
2123,58thStGreenway22ndAve,03/30/2014 11:00:00 AM,48,-122,20,27,47
2124,58thStGreenway22ndAve,03/30/2014 12:00:00 PM,48,-122,19,37,56
2125,58thStGreenway22ndAve,03/30/2014 01:00:00 PM,48,-122,41,47,88
2126,58thStGreenway22ndAve,03/30/2014 02:00:00 PM,48,-122,35,21,56
2127,58thStGreenway22ndAve,03/30/2014 03:00:00 PM,48,-122,38,14,52
2128,58thStGreenway22ndAve,03/30/2014 04:00:00 PM,48,-122,39,30,69
2129,58thStGreenway22ndAve,03/30/2014 05:00:00 PM,48,-122,26,34,60
2130,58thStGreenway22ndAve,03/30/2014 06:00:00 PM,48,-122,14,20,34
2131,58thStGreenway22ndAve,03/30/2014 07:00:00 PM,48,-122,25,19,44
2132,58thStGreenway22ndAve,03/30/2014 08:00:00 PM,48,-122,7,15,22
2133,58thStGreenway22ndAve,03/30/2014 09:00:00 PM,48,-122,19,12,31
2134,58thStGreenway22ndAve,03/30/2014 10:00:00 PM,48,-122,2,2,4
2135,58thStGreenway22ndAve,03/30/2014 11:00:00 PM,48,-122,7,0,7
2136,58thStGreenway22ndAve,03/31/2014 12:00:00 AM,48,-122,1,1,2
2137,58thStGreenway22ndAve,03/31/2014 01:00:00 AM,48,-122,2,2,4
2138,58thStGreenway22ndAve,03/31/2014 02:00:00 AM,48,-122,0,0,0
2139,58thStGreenway22ndAve,03/31/2014 03:00:00 AM,48,-122,0,2,2
2140,58thStGreenway22ndAve,03/31/2014 04:00:00 AM,48,-122,0,0,0
2141,58thStGreenway22ndAve,03/31/2014 05:00:00 AM,48,-122,2,2,4
2142,58thStGreenway22ndAve,03/31/2014 06:00:00 AM,48,-122,6,3,9
2143,58thStGreenway22ndAve,03/31/2014 07:00:00 AM,48,-122,23,5,28
2144,58thStGreenway22ndAve,03/31/2014 08:00:00 AM,48,-122,19,15,34
2145,58thStGreenway22ndAve,03/31/2014 09:00:00 AM,48,-122,20,24,44
2146,58thStGreenway22ndAve,03/31/2014 10:00:00 AM,48,-122,21,9,30
2147,58thStGreenway22ndAve,03/31/2014 11:00:00 AM,48,-122,29,39,68
2148,58thStGreenway22ndAve,03/31/2014 12:00:00 PM,48,-122,25,38,63
2149,58thStGreenway22ndAve,03/31/2014 01:00:00 PM,48,-122,21,34,55
2150,58thStGreenway22ndAve,03/31/2014 02:00:00 PM,48,-122,23,29,52
2151,58thStGreenway22ndAve,03/31/2014 03:00:00 PM,48,-122,21,29,50
2152,58thStGreenway22ndAve,03/31/2014 04:00:00 PM,48,-122,23,39,62
2153,58thStGreenway22ndAve,03/31/2014 05:00:00 PM,48,-122,30,30,60
2154,58thStGreenway22ndAve,03/31/2014 06:00:00 PM,48,-122,26,22,48
2155,58thStGreenway22ndAve,03/31/2014 07:00:00 PM,48,-122,12,17,29
2156,58thStGreenway22ndAve,03/31/2014 08:00:00 PM,48,-122,5,10,15
2157,58thStGreenway22ndAve,03/31/2014 09:00:00 PM,48,-122,7,9,16
2158,58thStGreenway22ndAve,03/31/2014 10:00:00 PM,48,-122,9,5,14
2159,58thStGreenway22ndAve,03/31/2014 11:00:00 PM,48,-122,3,3,6
2160,58thStGreenway22ndAve,04/01/2014 12:00:00 AM,48,-122,2,2,4
2161,58thStGreenway22ndAve,04/01/2014 01:00:00 AM,48,-122,2,5,7
2162,58thStGreenway22ndAve,04/01/2014 02:00:00 AM,48,-122,0,2,2
2163,58thStGreenway22ndAve,04/01/2014 03:00:00 AM,48,-122,1,0,1
2164,58thStGreenway22ndAve,04/01/2014 04:00:00 AM,48,-122,1,0,1
2165,58thStGreenway22ndAve,04/01/2014 05:00:00 AM,48,-122,3,2,5
2166,58thStGreenway22ndAve,04/01/2014 06:00:00 AM,48,-122,9,4,13
2167,58thStGreenway22ndAve,04/01/2014 07:00:00 AM,48,-122,25,4,29
2168,58thStGreenway22ndAve,04/01/2014 08:00:00 AM,48,-122,21,34,55
2169,58thStGreenway22ndAve,04/01/2014 09:00:00 AM,48,-122,31,24,55
2170,58thStGreenway22ndAve,04/01/2014 10:00:00 AM,48,-122,22,19,41
2171,58thStGreenway22ndAve,04/01/2014 11:00:00 AM,48,-122,17,20,37
2172,58thStGreenway22ndAve,04/01/2014 12:00:00 PM,48,-122,24,20,44
2173,58thStGreenway22ndAve,04/01/2014 01:00:00 PM,48,-122,32,31,63
2174,58thStGreenway22ndAve,04/01/2014 02:00:00 PM,48,-122,14,15,29
2175,58thStGreenway22ndAve,04/01/2014 03:00:00 PM,48,-122,13,9,22
2176,58thStGreenway22ndAve,04/01/2014 04:00:00 PM,48,-122,30,28,58
2177,58thStGreenway22ndAve,04/01/2014 05:00:00 PM,48,-122,27,30,57
2178,58thStGreenway22ndAve,04/01/2014 06:00:00 PM,48,-122,36,20,56
2179,58thStGreenway22ndAve,04/01/2014 07:00:00 PM,48,-122,21,14,35
2180,58thStGreenway22ndAve,04/01/2014 08:00:00 PM,48,-122,23,12,35
2181,58thStGreenway22ndAve,04/01/2014 09:00:00 PM,48,-122,12,2,14
2182,58thStGreenway22ndAve,04/01/2014 10:00:00 PM,48,-122,5,6,11
2183,58thStGreenway22ndAve,04/01/2014 11:00:00 PM,48,-122,1,1,2
2184,58thStGreenway22ndAve,04/02/2014 12:00:00 AM,48,-122,1,0,1
2185,58thStGreenway22ndAve,04/02/2014 01:00:00 AM,48,-122,0,0,0
2186,58thStGreenway22ndAve,04/02/2014 02:00:00 AM,48,-122,0,2,2
2187,58thStGreenway22ndAve,04/02/2014 03:00:00 AM,48,-122,0,0,0
2188,58thStGreenway22ndAve,04/02/2014 04:00:00 AM,48,-122,0,0,0
2189,58thStGreenway22ndAve,04/02/2014 05:00:00 AM,48,-122,4,2,6
2190,58thStGreenway22ndAve,04/02/2014 06:00:00 AM,48,-122,5,1,6
2191,58thStGreenway22ndAve,04/02/2014 07:00:00 AM,48,-122,21,7,28
2192,58thStGreenway22ndAve,04/02/2014 08:00:00 AM,48,-122,23,27,50
2193,58thStGreenway22ndAve,04/02/2014 09:00:00 AM,48,-122,31,14,45
2194,58thStGreenway22ndAve,04/02/2014 10:00:00 AM,48,-122,19,16,35
2195,58thStGreenway22ndAve,04/02/2014 11:00:00 AM,48,-122,9,18,27
2196,58thStGreenway22ndAve,04/02/2014 12:00:00 PM,48,-122,19,25,44
2197,58thStGreenway22ndAve,04/02/2014 01:00:00 PM,48,-122,9,29,38
2198,58thStGreenway22ndAve,04/02/2014 02:00:00 PM,48,-122,18,19,37
2199,58thStGreenway22ndAve,04/02/2014 03:00:00 PM,48,-122,22,19,41
2200,58thStGreenway22ndAve,04/02/2014 04:00:00 PM,48,-122,26,26,52
2201,58thStGreenway22ndAve,04/02/2014 05:00:00 PM,48,-122,23,44,67
2202,58thStGreenway22ndAve,04/02/2014 06:00:00 PM,48,-122,28,26,54
2203,58thStGreenway22ndAve,04/02/2014 07:00:00 PM,48,-122,11,12,23
2204,58thStGreenway22ndAve,04/02/2014 08:00:00 PM,48,-122,19,3,22
2205,58thStGreenway22ndAve,04/02/2014 09:00:00 PM,48,-122,7,5,12
2206,58thStGreenway22ndAve,04/02/2014 10:00:00 PM,48,-122,6,0,6
2207,58thStGreenway22ndAve,04/02/2014 11:00:00 PM,48,-122,2,0,2
2208,58thStGreenway22ndAve,04/03/2014 12:00:00 AM,48,-122,0,0,0
2209,58thStGreenway22ndAve,04/03/2014 01:00:00 AM,48,-122,0,1,1
2210,58thStGreenway22ndAve,04/03/2014 02:00:00 AM,48,-122,0,2,2
2211,58thStGreenway22ndAve,04/03/2014 03:00:00 AM,48,-122,0,0,0
2212,58thStGreenway22ndAve,04/03/2014 04:00:00 AM,48,-122,4,1,5
2213,58thStGreenway22ndAve,04/03/2014 05:00:00 AM,48,-122,7,3,10
2214,58thStGreenway22ndAve,04/03/2014 06:00:00 AM,48,-122,6,5,11
2215,58thStGreenway22ndAve,04/03/2014 07:00:00 AM,48,-122,15,3,18
2216,58thStGreenway22ndAve,04/03/2014 08:00:00 AM,48,-122,16,15,31
2217,58thStGreenway22ndAve,04/03/2014 09:00:00 AM,48,-122,20,14,34
2218,58thStGreenway22ndAve,04/03/2014 10:00:00 AM,48,-122,3,29,32
2219,58thStGreenway22ndAve,04/03/2014 11:00:00 AM,48,-122,9,14,23
2220,58thStGreenway22ndAve,04/03/2014 12:00:00 PM,48,-122,17,11,28
2221,58thStGreenway22ndAve,04/03/2014 01:00:00 PM,48,-122,16,20,36
2222,58thStGreenway22ndAve,04/03/2014 02:00:00 PM,48,-122,33,27,60
2223,58thStGreenway22ndAve,04/03/2014 03:00:00 PM,48,-122,24,12,36
2224,58thStGreenway22ndAve,04/03/2014 04:00:00 PM,48,-122,21,17,38
2225,58thStGreenway22ndAve,04/03/2014 05:00:00 PM,48,-122,26,13,39
2226,58thStGreenway22ndAve,04/03/2014 06:00:00 PM,48,-122,32,34,66
2227,58thStGreenway22ndAve,04/03/2014 07:00:00 PM,48,-122,21,25,46
2228,58thStGreenway22ndAve,04/03/2014 08:00:00 PM,48,-122,12,7,19
2229,58thStGreenway22ndAve,04/03/2014 09:00:00 PM,48,-122,3,11,14
2230,58thStGreenway22ndAve,04/03/2014 10:00:00 PM,48,-122,0,5,5
2231,58thStGreenway22ndAve,04/03/2014 11:00:00 PM,48,-122,8,6,14
2232,58thStGreenway22ndAve,04/04/2014 12:00:00 AM,48,-122,0,0,0
2233,58thStGreenway22ndAve,04/04/2014 01:00:00 AM,48,-122,0,1,1
2234,58thStGreenway22ndAve,04/04/2014 02:00:00 AM,48,-122,0,0,0
2235,58thStGreenway22ndAve,04/04/2014 03:00:00 AM,48,-122,0,0,0
2236,58thStGreenway22ndAve,04/04/2014 04:00:00 AM,48,-122,0,0,0
2237,58thStGreenway22ndAve,04/04/2014 05:00:00 AM,48,-122,3,2,5
2238,58thStGreenway22ndAve,04/04/2014 06:00:00 AM,48,-122,9,11,20
2239,58thStGreenway22ndAve,04/04/2014 07:00:00 AM,48,-122,10,7,17
2240,58thStGreenway22ndAve,04/04/2014 08:00:00 AM,48,-122,23,13,36
2241,58thStGreenway22ndAve,04/04/2014 09:00:00 AM,48,-122,25,25,50
2242,58thStGreenway22ndAve,04/04/2014 10:00:00 AM,48,-122,15,11,26
2243,58thStGreenway22ndAve,04/04/2014 11:00:00 AM,48,-122,9,27,36
2244,58thStGreenway22ndAve,04/04/2014 12:00:00 PM,48,-122,21,35,56
2245,58thStGreenway22ndAve,04/04/2014 01:00:00 PM,48,-122,18,32,50
2246,58thStGreenway22ndAve,04/04/2014 02:00:00 PM,48,-122,26,20,46
2247,58thStGreenway22ndAve,04/04/2014 03:00:00 PM,48,-122,19,20,39
2248,58thStGreenway22ndAve,04/04/2014 04:00:00 PM,48,-122,24,28,52
2249,58thStGreenway22ndAve,04/04/2014 05:00:00 PM,48,-122,38,31,69
2250,58thStGreenway22ndAve,04/04/2014 06:00:00 PM,48,-122,26,29,55
2251,58thStGreenway22ndAve,04/04/2014 07:00:00 PM,48,-122,23,21,44
2252,58thStGreenway22ndAve,04/04/2014 08:00:00 PM,48,-122,15,11,26
2253,58thStGreenway22ndAve,04/04/2014 09:00:00 PM,48,-122,6,5,11
2254,58thStGreenway22ndAve,04/04/2014 10:00:00 PM,48,-122,16,7,23
2255,58thStGreenway22ndAve,04/04/2014 11:00:00 PM,48,-122,1,3,4
2256,58thStGreenway22ndAve,04/05/2014 12:00:00 AM,48,-122,4,3,7
2257,58thStGreenway22ndAve,04/05/2014 01:00:00 AM,48,-122,2,7,9
2258,58thStGreenway22ndAve,04/05/2014 02:00:00 AM,48,-122,3,0,3
2259,58thStGreenway22ndAve,04/05/2014 03:00:00 AM,48,-122,5,2,7
2260,58thStGreenway22ndAve,04/05/2014 04:00:00 AM,48,-122,0,0,0
2261,58thStGreenway22ndAve,04/05/2014 05:00:00 AM,48,-122,2,0,2
2262,58thStGreenway22ndAve,04/05/2014 06:00:00 AM,48,-122,0,0,0
2263,58thStGreenway22ndAve,04/05/2014 07:00:00 AM,48,-122,3,1,4
2264,58thStGreenway22ndAve,04/05/2014 08:00:00 AM,48,-122,16,9,25
2265,58thStGreenway22ndAve,04/05/2014 09:00:00 AM,48,-122,11,13,24
2266,58thStGreenway22ndAve,04/05/2014 10:00:00 AM,48,-122,26,22,48
2267,58thStGreenway22ndAve,04/05/2014 11:00:00 AM,48,-122,26,22,48
2268,58thStGreenway22ndAve,04/05/2014 12:00:00 PM,48,-122,40,35,75
2269,58thStGreenway22ndAve,04/05/2014 01:00:00 PM,48,-122,37,32,69
2270,58thStGreenway22ndAve,04/05/2014 02:00:00 PM,48,-122,29,42,71
2271,58thStGreenway22ndAve,04/05/2014 03:00:00 PM,48,-122,27,19,46
2272,58thStGreenway22ndAve,04/05/2014 04:00:00 PM,48,-122,17,22,39
2273,58thStGreenway22ndAve,04/05/2014 05:00:00 PM,48,-122,35,16,51
2274,58thStGreenway22ndAve,04/05/2014 06:00:00 PM,48,-122,14,26,40
2275,58thStGreenway22ndAve,04/05/2014 07:00:00 PM,48,-122,19,11,30
2276,58thStGreenway22ndAve,04/05/2014 08:00:00 PM,48,-122,13,25,38
2277,58thStGreenway22ndAve,04/05/2014 09:00:00 PM,48,-122,12,3,15
2278,58thStGreenway22ndAve,04/05/2014 10:00:00 PM,48,-122,8,1,9
2279,58thStGreenway22ndAve,04/05/2014 11:00:00 PM,48,-122,0,0,0
2280,58thStGreenway22ndAve,04/06/2014 12:00:00 AM,48,-122,9,6,15
2281,58thStGreenway22ndAve,04/06/2014 01:00:00 AM,48,-122,0,0,0
2282,58thStGreenway22ndAve,04/06/2014 02:00:00 AM,48,-122,2,0,2
2283,58thStGreenway22ndAve,04/06/2014 03:00:00 AM,48,-122,2,1,3
2284,58thStGreenway22ndAve,04/06/2014 04:00:00 AM,48,-122,0,0,0
2285,58thStGreenway22ndAve,04/06/2014 05:00:00 AM,48,-122,0,0,0
2286,58thStGreenway22ndAve,04/06/2014 06:00:00 AM,48,-122,0,0,0
2287,58thStGreenway22ndAve,04/06/2014 07:00:00 AM,48,-122,3,1,4
2288,58thStGreenway22ndAve,04/06/2014 08:00:00 AM,48,-122,4,10,14
2289,58thStGreenway22ndAve,04/06/2014 09:00:00 AM,48,-122,6,8,14
2290,58thStGreenway22ndAve,04/06/2014 10:00:00 AM,48,-122,21,18,39
2291,58thStGreenway22ndAve,04/06/2014 11:00:00 AM,48,-122,14,28,42
2292,58thStGreenway22ndAve,04/06/2014 12:00:00 PM,48,-122,16,25,41
2293,58thStGreenway22ndAve,04/06/2014 01:00:00 PM,48,-122,33,21,54
2294,58thStGreenway22ndAve,04/06/2014 02:00:00 PM,48,-122,32,28,60
2295,58thStGreenway22ndAve,04/06/2014 03:00:00 PM,48,-122,19,16,35
2296,58thStGreenway22ndAve,04/06/2014 04:00:00 PM,48,-122,34,18,52
2297,58thStGreenway22ndAve,04/06/2014 05:00:00 PM,48,-122,20,15,35
2298,58thStGreenway22ndAve,04/06/2014 06:00:00 PM,48,-122,20,13,33
2299,58thStGreenway22ndAve,04/06/2014 07:00:00 PM,48,-122,17,18,35
2300,58thStGreenway22ndAve,04/06/2014 08:00:00 PM,48,-122,8,7,15
2301,58thStGreenway22ndAve,04/06/2014 09:00:00 PM,48,-122,11,7,18
2302,58thStGreenway22ndAve,04/06/2014 10:00:00 PM,48,-122,8,3,11
2303,58thStGreenway22ndAve,04/06/2014 11:00:00 PM,48,-122,3,0,3
2304,58thStGreenway22ndAve,04/07/2014 12:00:00 AM,48,-122,0,0,0
2305,58thStGreenway22ndAve,04/07/2014 01:00:00 AM,48,-122,3,2,5
2306,58thStGreenway22ndAve,04/07/2014 02:00:00 AM,48,-122,0,2,2
2307,58thStGreenway22ndAve,04/07/2014 03:00:00 AM,48,-122,3,0,3
2308,58thStGreenway22ndAve,04/07/2014 04:00:00 AM,48,-122,2,0,2
2309,58thStGreenway22ndAve,04/07/2014 05:00:00 AM,48,-122,2,0,2
2310,58thStGreenway22ndAve,04/07/2014 06:00:00 AM,48,-122,10,4,14
2311,58thStGreenway22ndAve,04/07/2014 07:00:00 AM,48,-122,29,21,50
2312,58thStGreenway22ndAve,04/07/2014 08:00:00 AM,48,-122,49,21,70
2313,58thStGreenway22ndAve,04/07/2014 09:00:00 AM,48,-122,28,11,39
2314,58thStGreenway22ndAve,04/07/2014 10:00:00 AM,48,-122,24,18,42
2315,58thStGreenway22ndAve,04/07/2014 11:00:00 AM,48,-122,25,23,48
2316,58thStGreenway22ndAve,04/07/2014 12:00:00 PM,48,-122,23,17,40
2317,58thStGreenway22ndAve,04/07/2014 01:00:00 PM,48,-122,35,22,57
2318,58thStGreenway22ndAve,04/07/2014 02:00:00 PM,48,-122,21,20,41
2319,58thStGreenway22ndAve,04/07/2014 03:00:00 PM,48,-122,30,13,43
2320,58thStGreenway22ndAve,04/07/2014 04:00:00 PM,48,-122,29,11,40
2321,58thStGreenway22ndAve,04/07/2014 05:00:00 PM,48,-122,27,25,52
2322,58thStGreenway22ndAve,04/07/2014 06:00:00 PM,48,-122,30,27,57
2323,58thStGreenway22ndAve,04/07/2014 07:00:00 PM,48,-122,16,13,29
2324,58thStGreenway22ndAve,04/07/2014 08:00:00 PM,48,-122,9,9,18
2325,58thStGreenway22ndAve,04/07/2014 09:00:00 PM,48,-122,14,3,17
2326,58thStGreenway22ndAve,04/07/2014 10:00:00 PM,48,-122,4,4,8
2327,58thStGreenway22ndAve,04/07/2014 11:00:00 PM,48,-122,3,3,6
2328,58thStGreenway22ndAve,04/08/2014 12:00:00 AM,48,-122,0,2,2
2329,58thStGreenway22ndAve,04/08/2014 01:00:00 AM,48,-122,2,0,2
2330,58thStGreenway22ndAve,04/08/2014 02:00:00 AM,48,-122,0,0,0
2331,58thStGreenway22ndAve,04/08/2014 03:00:00 AM,48,-122,0,0,0
2332,58thStGreenway22ndAve,04/08/2014 04:00:00 AM,48,-122,0,0,0
2333,58thStGreenway22ndAve,04/08/2014 05:00:00 AM,48,-122,4,1,5
2334,58thStGreenway22ndAve,04/08/2014 06:00:00 AM,48,-122,8,5,13
2335,58thStGreenway22ndAve,04/08/2014 07:00:00 AM,48,-122,15,5,20
2336,58thStGreenway22ndAve,04/08/2014 08:00:00 AM,48,-122,15,12,27
2337,58thStGreenway22ndAve,04/08/2014 09:00:00 AM,48,-122,32,6,38
2338,58thStGreenway22ndAve,04/08/2014 10:00:00 AM,48,-122,11,6,17
2339,58thStGreenway22ndAve,04/08/2014 11:00:00 AM,48,-122,23,0,23
2340,58thStGreenway22ndAve,04/08/2014 12:00:00 PM,48,-122,33,10,43
2341,58thStGreenway22ndAve,04/08/2014 01:00:00 PM,48,-122,18,16,34
2342,58thStGreenway22ndAve,04/08/2014 02:00:00 PM,48,-122,10,10,20
2343,58thStGreenway22ndAve,04/08/2014 03:00:00 PM,48,-122,24,11,35
2344,58thStGreenway22ndAve,04/08/2014 04:00:00 PM,48,-122,19,24,43
2345,58thStGreenway22ndAve,04/08/2014 05:00:00 PM,48,-122,11,14,25
2346,58thStGreenway22ndAve,04/08/2014 06:00:00 PM,48,-122,13,15,28
2347,58thStGreenway22ndAve,04/08/2014 07:00:00 PM,48,-122,12,24,36
2348,58thStGreenway22ndAve,04/08/2014 08:00:00 PM,48,-122,8,1,9
2349,58thStGreenway22ndAve,04/08/2014 09:00:00 PM,48,-122,3,5,8
2350,58thStGreenway22ndAve,04/08/2014 10:00:00 PM,48,-122,4,6,10
2351,58thStGreenway22ndAve,04/08/2014 11:00:00 PM,48,-122,3,1,4
2352,58thStGreenway22ndAve,04/09/2014 12:00:00 AM,48,-122,2,0,2
2353,58thStGreenway22ndAve,04/09/2014 01:00:00 AM,48,-122,0,2,2
2354,58thStGreenway22ndAve,04/09/2014 02:00:00 AM,48,-122,0,4,4
2355,58thStGreenway22ndAve,04/09/2014 03:00:00 AM,48,-122,0,0,0
2356,58thStGreenway22ndAve,04/09/2014 04:00:00 AM,48,-122,0,0,0
2357,58thStGreenway22ndAve,04/09/2014 05:00:00 AM,48,-122,0,0,0
2358,58thStGreenway22ndAve,04/09/2014 06:00:00 AM,48,-122,6,4,10
2359,58thStGreenway22ndAve,04/09/2014 07:00:00 AM,48,-122,12,14,26
2360,58thStGreenway22ndAve,04/09/2014 08:00:00 AM,48,-122,5,14,19
2361,58thStGreenway22ndAve,04/09/2014 09:00:00 AM,48,-122,23,14,37
2362,58thStGreenway22ndAve,04/09/2014 10:00:00 AM,48,-122,7,15,22
2363,58thStGreenway22ndAve,04/09/2014 11:00:00 AM,48,-122,31,18,49
2364,58thStGreenway22ndAve,04/09/2014 12:00:00 PM,48,-122,22,10,32
2365,58thStGreenway22ndAve,04/09/2014 01:00:00 PM,48,-122,21,13,34
2366,58thStGreenway22ndAve,04/09/2014 02:00:00 PM,48,-122,24,10,34
2367,58thStGreenway22ndAve,04/09/2014 03:00:00 PM,48,-122,28,9,37
2368,58thStGreenway22ndAve,04/09/2014 04:00:00 PM,48,-122,14,15,29
2369,58thStGreenway22ndAve,04/09/2014 05:00:00 PM,48,-122,20,9,29
2370,58thStGreenway22ndAve,04/09/2014 06:00:00 PM,48,-122,31,23,54
2371,58thStGreenway22ndAve,04/09/2014 07:00:00 PM,48,-122,21,22,43
2372,58thStGreenway22ndAve,04/09/2014 08:00:00 PM,48,-122,18,5,23
2373,58thStGreenway22ndAve,04/09/2014 09:00:00 PM,48,-122,9,7,16
2374,58thStGreenway22ndAve,04/09/2014 10:00:00 PM,48,-122,9,1,10
2375,58thStGreenway22ndAve,04/09/2014 11:00:00 PM,48,-122,5,1,6
2376,58thStGreenway22ndAve,04/10/2014 12:00:00 AM,48,-122,2,0,2
2377,58thStGreenway22ndAve,04/10/2014 01:00:00 AM,48,-122,2,4,6
2378,58thStGreenway22ndAve,04/10/2014 02:00:00 AM,48,-122,0,2,2
2379,58thStGreenway22ndAve,04/10/2014 03:00:00 AM,48,-122,0,0,0
2380,58thStGreenway22ndAve,04/10/2014 04:00:00 AM,48,-122,2,0,2
2381,58thStGreenway22ndAve,04/10/2014 05:00:00 AM,48,-122,0,0,0
2382,58thStGreenway22ndAve,04/10/2014 06:00:00 AM,48,-122,8,1,9
2383,58thStGreenway22ndAve,04/10/2014 07:00:00 AM,48,-122,20,9,29
2384,58thStGreenway22ndAve,04/10/2014 08:00:00 AM,48,-122,28,12,40
2385,58thStGreenway22ndAve,04/10/2014 09:00:00 AM,48,-122,18,9,27
2386,58thStGreenway22ndAve,04/10/2014 10:00:00 AM,48,-122,26,13,39
2387,58thStGreenway22ndAve,04/10/2014 11:00:00 AM,48,-122,12,21,33
2388,58thStGreenway22ndAve,04/10/2014 12:00:00 PM,48,-122,31,24,55
2389,58thStGreenway22ndAve,04/10/2014 01:00:00 PM,48,-122,30,24,54
2390,58thStGreenway22ndAve,04/10/2014 02:00:00 PM,48,-122,23,17,40
2391,58thStGreenway22ndAve,04/10/2014 03:00:00 PM,48,-122,12,13,25
2392,58thStGreenway22ndAve,04/10/2014 04:00:00 PM,48,-122,22,6,28
2393,58thStGreenway22ndAve,04/10/2014 05:00:00 PM,48,-122,20,10,30
2394,58thStGreenway22ndAve,04/10/2014 06:00:00 PM,48,-122,23,23,46
2395,58thStGreenway22ndAve,04/10/2014 07:00:00 PM,48,-122,23,11,34
2396,58thStGreenway22ndAve,04/10/2014 08:00:00 PM,48,-122,7,2,9
2397,58thStGreenway22ndAve,04/10/2014 09:00:00 PM,48,-122,5,6,11
2398,58thStGreenway22ndAve,04/10/2014 10:00:00 PM,48,-122,6,4,10
2399,58thStGreenway22ndAve,04/10/2014 11:00:00 PM,48,-122,6,2,8
2400,58thStGreenway22ndAve,04/11/2014 12:00:00 AM,48,-122,1,2,3
2401,58thStGreenway22ndAve,04/11/2014 01:00:00 AM,48,-122,0,2,2
2402,58thStGreenway22ndAve,04/11/2014 02:00:00 AM,48,-122,0,2,2
2403,58thStGreenway22ndAve,04/11/2014 03:00:00 AM,48,-122,0,0,0
2404,58thStGreenway22ndAve,04/11/2014 04:00:00 AM,48,-122,0,0,0
2405,58thStGreenway22ndAve,04/11/2014 05:00:00 AM,48,-122,4,1,5
2406,58thStGreenway22ndAve,04/11/2014 06:00:00 AM,48,-122,0,2,2
2407,58thStGreenway22ndAve,04/11/2014 07:00:00 AM,48,-122,17,7,24
2408,58thStGreenway22ndAve,04/11/2014 08:00:00 AM,48,-122,22,18,40
2409,58thStGreenway22ndAve,04/11/2014 09:00:00 AM,48,-122,45,15,60
2410,58thStGreenway22ndAve,04/11/2014 10:00:00 AM,48,-122,21,15,36
2411,58thStGreenway22ndAve,04/11/2014 11:00:00 AM,48,-122,15,20,35
2412,58thStGreenway22ndAve,04/11/2014 12:00:00 PM,48,-122,26,15,41
2413,58thStGreenway22ndAve,04/11/2014 01:00:00 PM,48,-122,11,8,19
2414,58thStGreenway22ndAve,04/11/2014 02:00:00 PM,48,-122,30,15,45
2415,58thStGreenway22ndAve,04/11/2014 03:00:00 PM,48,-122,22,13,35
2416,58thStGreenway22ndAve,04/11/2014 04:00:00 PM,48,-122,22,20,42
2417,58thStGreenway22ndAve,04/11/2014 05:00:00 PM,48,-122,30,25,55
2418,58thStGreenway22ndAve,04/11/2014 06:00:00 PM,48,-122,37,27,64
2419,58thStGreenway22ndAve,04/11/2014 07:00:00 PM,48,-122,17,18,35
2420,58thStGreenway22ndAve,04/11/2014 08:00:00 PM,48,-122,19,11,30
2421,58thStGreenway22ndAve,04/11/2014 09:00:00 PM,48,-122,10,2,12
2422,58thStGreenway22ndAve,04/11/2014 10:00:00 PM,48,-122,9,5,14
2423,58thStGreenway22ndAve,04/11/2014 11:00:00 PM,48,-122,12,3,15
2424,58thStGreenway22ndAve,04/12/2014 12:00:00 AM,48,-122,0,0,0
2425,58thStGreenway22ndAve,04/12/2014 01:00:00 AM,48,-122,2,0,2
2426,58thStGreenway22ndAve,04/12/2014 02:00:00 AM,48,-122,0,2,2
2427,58thStGreenway22ndAve,04/12/2014 03:00:00 AM,48,-122,2,1,3
2428,58thStGreenway22ndAve,04/12/2014 04:00:00 AM,48,-122,0,0,0
2429,58thStGreenway22ndAve,04/12/2014 05:00:00 AM,48,-122,1,0,1
2430,58thStGreenway22ndAve,04/12/2014 06:00:00 AM,48,-122,3,2,5
2431,58thStGreenway22ndAve,04/12/2014 07:00:00 AM,48,-122,7,6,13
2432,58thStGreenway22ndAve,04/12/2014 08:00:00 AM,48,-122,15,10,25
2433,58thStGreenway22ndAve,04/12/2014 09:00:00 AM,48,-122,17,22,39
2434,58thStGreenway22ndAve,04/12/2014 10:00:00 AM,48,-122,20,19,39
2435,58thStGreenway22ndAve,04/12/2014 11:00:00 AM,48,-122,43,37,80
2436,58thStGreenway22ndAve,04/12/2014 12:00:00 PM,48,-122,52,35,87
2437,58thStGreenway22ndAve,04/12/2014 01:00:00 PM,48,-122,27,41,68
2438,58thStGreenway22ndAve,04/12/2014 02:00:00 PM,48,-122,19,19,38
2439,58thStGreenway22ndAve,04/12/2014 03:00:00 PM,48,-122,29,27,56
2440,58thStGreenway22ndAve,04/12/2014 04:00:00 PM,48,-122,23,31,54
2441,58thStGreenway22ndAve,04/12/2014 05:00:00 PM,48,-122,31,29,60
2442,58thStGreenway22ndAve,04/12/2014 06:00:00 PM,48,-122,38,21,59
2443,58thStGreenway22ndAve,04/12/2014 07:00:00 PM,48,-122,30,19,49
2444,58thStGreenway22ndAve,04/12/2014 08:00:00 PM,48,-122,18,7,25
2445,58thStGreenway22ndAve,04/12/2014 09:00:00 PM,48,-122,8,6,14
2446,58thStGreenway22ndAve,04/12/2014 10:00:00 PM,48,-122,6,9,15
2447,58thStGreenway22ndAve,04/12/2014 11:00:00 PM,48,-122,5,3,8
2448,58thStGreenway22ndAve,04/13/2014 12:00:00 AM,48,-122,0,0,0
2449,58thStGreenway22ndAve,04/13/2014 01:00:00 AM,48,-122,5,0,5
2450,58thStGreenway22ndAve,04/13/2014 02:00:00 AM,48,-122,3,0,3
2451,58thStGreenway22ndAve,04/13/2014 03:00:00 AM,48,-122,0,2,2
2452,58thStGreenway22ndAve,04/13/2014 04:00:00 AM,48,-122,0,0,0
2453,58thStGreenway22ndAve,04/13/2014 05:00:00 AM,48,-122,0,0,0
2454,58thStGreenway22ndAve,04/13/2014 06:00:00 AM,48,-122,0,0,0
2455,58thStGreenway22ndAve,04/13/2014 07:00:00 AM,48,-122,3,5,8
2456,58thStGreenway22ndAve,04/13/2014 08:00:00 AM,48,-122,3,5,8
2457,58thStGreenway22ndAve,04/13/2014 09:00:00 AM,48,-122,11,12,23
2458,58thStGreenway22ndAve,04/13/2014 10:00:00 AM,48,-122,24,18,42
2459,58thStGreenway22ndAve,04/13/2014 11:00:00 AM,48,-122,22,28,50
2460,58thStGreenway22ndAve,04/13/2014 12:00:00 PM,48,-122,34,29,63
2461,58thStGreenway22ndAve,04/13/2014 01:00:00 PM,48,-122,49,18,67
2462,58thStGreenway22ndAve,04/13/2014 02:00:00 PM,48,-122,30,19,49
2463,58thStGreenway22ndAve,04/13/2014 03:00:00 PM,48,-122,29,22,51
2464,58thStGreenway22ndAve,04/13/2014 04:00:00 PM,48,-122,43,15,58
2465,58thStGreenway22ndAve,04/13/2014 05:00:00 PM,48,-122,44,16,60
2466,58thStGreenway22ndAve,04/13/2014 06:00:00 PM,48,-122,36,18,54
2467,58thStGreenway22ndAve,04/13/2014 07:00:00 PM,48,-122,20,2,22
2468,58thStGreenway22ndAve,04/13/2014 08:00:00 PM,48,-122,16,8,24
2469,58thStGreenway22ndAve,04/13/2014 09:00:00 PM,48,-122,7,2,9
2470,58thStGreenway22ndAve,04/13/2014 10:00:00 PM,48,-122,6,3,9
2471,58thStGreenway22ndAve,04/13/2014 11:00:00 PM,48,-122,8,0,8
2472,58thStGreenway22ndAve,04/14/2014 12:00:00 AM,48,-122,0,0,0
2473,58thStGreenway22ndAve,04/14/2014 01:00:00 AM,48,-122,1,0,1
2474,58thStGreenway22ndAve,04/14/2014 02:00:00 AM,48,-122,1,0,1
2475,58thStGreenway22ndAve,04/14/2014 03:00:00 AM,48,-122,0,0,0
2476,58thStGreenway22ndAve,04/14/2014 04:00:00 AM,48,-122,0,0,0
2477,58thStGreenway22ndAve,04/14/2014 05:00:00 AM,48,-122,3,2,5
2478,58thStGreenway22ndAve,04/14/2014 06:00:00 AM,48,-122,5,4,9
2479,58thStGreenway22ndAve,04/14/2014 07:00:00 AM,48,-122,10,8,18
2480,58thStGreenway22ndAve,04/14/2014 08:00:00 AM,48,-122,18,11,29
2481,58thStGreenway22ndAve,04/14/2014 09:00:00 AM,48,-122,18,15,33
2482,58thStGreenway22ndAve,04/14/2014 10:00:00 AM,48,-122,14,9,23
2483,58thStGreenway22ndAve,04/14/2014 11:00:00 AM,48,-122,17,17,34
2484,58thStGreenway22ndAve,04/14/2014 12:00:00 PM,48,-122,16,17,33
2485,58thStGreenway22ndAve,04/14/2014 01:00:00 PM,48,-122,18,14,32
2486,58thStGreenway22ndAve,04/14/2014 02:00:00 PM,48,-122,22,6,28
2487,58thStGreenway22ndAve,04/14/2014 03:00:00 PM,48,-122,22,13,35
2488,58thStGreenway22ndAve,04/14/2014 04:00:00 PM,48,-122,25,26,51
2489,58thStGreenway22ndAve,04/14/2014 05:00:00 PM,48,-122,33,17,50
2490,58thStGreenway22ndAve,04/14/2014 06:00:00 PM,48,-122,30,20,50
2491,58thStGreenway22ndAve,04/14/2014 07:00:00 PM,48,-122,21,15,36
2492,58thStGreenway22ndAve,04/14/2014 08:00:00 PM,48,-122,22,7,29
2493,58thStGreenway22ndAve,04/14/2014 09:00:00 PM,48,-122,7,4,11
2494,58thStGreenway22ndAve,04/14/2014 10:00:00 PM,48,-122,4,0,4
2495,58thStGreenway22ndAve,04/14/2014 11:00:00 PM,48,-122,5,0,5
2496,58thStGreenway22ndAve,04/15/2014 12:00:00 AM,48,-122,4,0,4
2497,58thStGreenway22ndAve,04/15/2014 01:00:00 AM,48,-122,2,1,3
2498,58thStGreenway22ndAve,04/15/2014 02:00:00 AM,48,-122,0,0,0
2499,58thStGreenway22ndAve,04/15/2014 03:00:00 AM,48,-122,2,3,5
2500,58thStGreenway22ndAve,04/15/2014 04:00:00 AM,48,-122,0,0,0
2501,58thStGreenway22ndAve,04/15/2014 05:00:00 AM,48,-122,2,0,2
2502,58thStGreenway22ndAve,04/15/2014 06:00:00 AM,48,-122,2,5,7
2503,58thStGreenway22ndAve,04/15/2014 07:00:00 AM,48,-122,17,9,26
2504,58thStGreenway22ndAve,04/15/2014 08:00:00 AM,48,-122,36,12,48
2505,58thStGreenway22ndAve,04/15/2014 09:00:00 AM,48,-122,17,15,32
2506,58thStGreenway22ndAve,04/15/2014 10:00:00 AM,48,-122,18,9,27
2507,58thStGreenway22ndAve,04/15/2014 11:00:00 AM,48,-122,22,15,37
2508,58thStGreenway22ndAve,04/15/2014 12:00:00 PM,48,-122,47,19,66
2509,58thStGreenway22ndAve,04/15/2014 01:00:00 PM,48,-122,21,10,31
2510,58thStGreenway22ndAve,04/15/2014 02:00:00 PM,48,-122,12,6,18
2511,58thStGreenway22ndAve,04/15/2014 03:00:00 PM,48,-122,28,16,44
2512,58thStGreenway22ndAve,04/15/2014 04:00:00 PM,48,-122,34,14,48
2513,58thStGreenway22ndAve,04/15/2014 05:00:00 PM,48,-122,22,21,43
2514,58thStGreenway22ndAve,04/15/2014 06:00:00 PM,48,-122,14,8,22
2515,58thStGreenway22ndAve,04/15/2014 07:00:00 PM,48,-122,15,24,39
2516,58thStGreenway22ndAve,04/15/2014 08:00:00 PM,48,-122,13,2,15
2517,58thStGreenway22ndAve,04/15/2014 09:00:00 PM,48,-122,5,5,10
2518,58thStGreenway22ndAve,04/15/2014 10:00:00 PM,48,-122,6,2,8
2519,58thStGreenway22ndAve,04/15/2014 11:00:00 PM,48,-122,3,1,4
2520,58thStGreenway22ndAve,04/16/2014 12:00:00 AM,48,-122,0,0,0
2521,58thStGreenway22ndAve,04/16/2014 01:00:00 AM,48,-122,0,0,0
2522,58thStGreenway22ndAve,04/16/2014 02:00:00 AM,48,-122,0,0,0
2523,58thStGreenway22ndAve,04/16/2014 03:00:00 AM,48,-122,2,0,2
2524,58thStGreenway22ndAve,04/16/2014 04:00:00 AM,48,-122,0,0,0
2525,58thStGreenway22ndAve,04/16/2014 05:00:00 AM,48,-122,3,0,3
2526,58thStGreenway22ndAve,04/16/2014 06:00:00 AM,48,-122,6,6,12
2527,58thStGreenway22ndAve,04/16/2014 07:00:00 AM,48,-122,22,5,27
2528,58thStGreenway22ndAve,04/16/2014 08:00:00 AM,48,-122,29,5,34
2529,58thStGreenway22ndAve,04/16/2014 09:00:00 AM,48,-122,10,7,17
2530,58thStGreenway22ndAve,04/16/2014 10:00:00 AM,48,-122,14,9,23
2531,58thStGreenway22ndAve,04/16/2014 11:00:00 AM,48,-122,17,15,32
2532,58thStGreenway22ndAve,04/16/2014 12:00:00 PM,48,-122,17,20,37
2533,58thStGreenway22ndAve,04/16/2014 01:00:00 PM,48,-122,16,14,30
2534,58thStGreenway22ndAve,04/16/2014 02:00:00 PM,48,-122,17,21,38
2535,58thStGreenway22ndAve,04/16/2014 03:00:00 PM,48,-122,17,17,34
2536,58thStGreenway22ndAve,04/16/2014 04:00:00 PM,48,-122,25,9,34
2537,58thStGreenway22ndAve,04/16/2014 05:00:00 PM,48,-122,23,15,38
2538,58thStGreenway22ndAve,04/16/2014 06:00:00 PM,48,-122,22,18,40
2539,58thStGreenway22ndAve,04/16/2014 07:00:00 PM,48,-122,3,15,18
2540,58thStGreenway22ndAve,04/16/2014 08:00:00 PM,48,-122,10,5,15
2541,58thStGreenway22ndAve,04/16/2014 09:00:00 PM,48,-122,4,3,7
2542,58thStGreenway22ndAve,04/16/2014 10:00:00 PM,48,-122,7,5,12
2543,58thStGreenway22ndAve,04/16/2014 11:00:00 PM,48,-122,2,3,5
2544,58thStGreenway22ndAve,04/17/2014 12:00:00 AM,48,-122,0,0,0
2545,58thStGreenway22ndAve,04/17/2014 01:00:00 AM,48,-122,0,4,4
2546,58thStGreenway22ndAve,04/17/2014 02:00:00 AM,48,-122,0,0,0
2547,58thStGreenway22ndAve,04/17/2014 03:00:00 AM,48,-122,2,0,2
2548,58thStGreenway22ndAve,04/17/2014 04:00:00 AM,48,-122,0,0,0
2549,58thStGreenway22ndAve,04/17/2014 05:00:00 AM,48,-122,2,1,3
2550,58thStGreenway22ndAve,04/17/2014 06:00:00 AM,48,-122,5,2,7
2551,58thStGreenway22ndAve,04/17/2014 07:00:00 AM,48,-122,20,19,39
2552,58thStGreenway22ndAve,04/17/2014 08:00:00 AM,48,-122,19,8,27
2553,58thStGreenway22ndAve,04/17/2014 09:00:00 AM,48,-122,15,4,19
2554,58thStGreenway22ndAve,04/17/2014 10:00:00 AM,48,-122,13,8,21
2555,58thStGreenway22ndAve,04/17/2014 11:00:00 AM,48,-122,18,17,35
2556,58thStGreenway22ndAve,04/17/2014 12:00:00 PM,48,-122,7,17,24
2557,58thStGreenway22ndAve,04/17/2014 01:00:00 PM,48,-122,6,11,17
2558,58thStGreenway22ndAve,04/17/2014 02:00:00 PM,48,-122,14,6,20
2559,58thStGreenway22ndAve,04/17/2014 03:00:00 PM,48,-122,17,7,24
2560,58thStGreenway22ndAve,04/17/2014 04:00:00 PM,48,-122,14,14,28
2561,58thStGreenway22ndAve,04/17/2014 05:00:00 PM,48,-122,11,27,38
2562,58thStGreenway22ndAve,04/17/2014 06:00:00 PM,48,-122,10,22,32
2563,58thStGreenway22ndAve,04/17/2014 07:00:00 PM,48,-122,25,10,35
2564,58thStGreenway22ndAve,04/17/2014 08:00:00 PM,48,-122,9,8,17
2565,58thStGreenway22ndAve,04/17/2014 09:00:00 PM,48,-122,14,0,14
2566,58thStGreenway22ndAve,04/17/2014 10:00:00 PM,48,-122,0,2,2
2567,58thStGreenway22ndAve,04/17/2014 11:00:00 PM,48,-122,6,1,7
2568,58thStGreenway22ndAve,04/18/2014 12:00:00 AM,48,-122,0,0,0
2569,58thStGreenway22ndAve,04/18/2014 01:00:00 AM,48,-122,0,0,0
2570,58thStGreenway22ndAve,04/18/2014 02:00:00 AM,48,-122,2,0,2
2571,58thStGreenway22ndAve,04/18/2014 03:00:00 AM,48,-122,0,2,2
2572,58thStGreenway22ndAve,04/18/2014 04:00:00 AM,48,-122,0,0,0
2573,58thStGreenway22ndAve,04/18/2014 05:00:00 AM,48,-122,3,1,4
2574,58thStGreenway22ndAve,04/18/2014 06:00:00 AM,48,-122,3,4,7
2575,58thStGreenway22ndAve,04/18/2014 07:00:00 AM,48,-122,14,6,20
2576,58thStGreenway22ndAve,04/18/2014 08:00:00 AM,48,-122,22,11,33
2577,58thStGreenway22ndAve,04/18/2014 09:00:00 AM,48,-122,14,8,22
2578,58thStGreenway22ndAve,04/18/2014 10:00:00 AM,48,-122,20,11,31
2579,58thStGreenway22ndAve,04/18/2014 11:00:00 AM,48,-122,25,17,42
2580,58thStGreenway22ndAve,04/18/2014 12:00:00 PM,48,-122,15,18,33
2581,58thStGreenway22ndAve,04/18/2014 01:00:00 PM,48,-122,23,13,36
2582,58thStGreenway22ndAve,04/18/2014 02:00:00 PM,48,-122,25,18,43
2583,58thStGreenway22ndAve,04/18/2014 03:00:00 PM,48,-122,36,14,50
2584,58thStGreenway22ndAve,04/18/2014 04:00:00 PM,48,-122,18,16,34
2585,58thStGreenway22ndAve,04/18/2014 05:00:00 PM,48,-122,36,17,53
2586,58thStGreenway22ndAve,04/18/2014 06:00:00 PM,48,-122,31,29,60
2587,58thStGreenway22ndAve,04/18/2014 07:00:00 PM,48,-122,18,15,33
2588,58thStGreenway22ndAve,04/18/2014 08:00:00 PM,48,-122,19,9,28
2589,58thStGreenway22ndAve,04/18/2014 09:00:00 PM,48,-122,21,5,26
2590,58thStGreenway22ndAve,04/18/2014 10:00:00 PM,48,-122,17,2,19
2591,58thStGreenway22ndAve,04/18/2014 11:00:00 PM,48,-122,5,1,6
2592,58thStGreenway22ndAve,04/19/2014 12:00:00 AM,48,-122,7,1,8
2593,58thStGreenway22ndAve,04/19/2014 01:00:00 AM,48,-122,0,0,0
2594,58thStGreenway22ndAve,04/19/2014 02:00:00 AM,48,-122,4,0,4
2595,58thStGreenway22ndAve,04/19/2014 03:00:00 AM,48,-122,1,0,1
2596,58thStGreenway22ndAve,04/19/2014 04:00:00 AM,48,-122,0,0,0
2597,58thStGreenway22ndAve,04/19/2014 05:00:00 AM,48,-122,1,0,1
2598,58thStGreenway22ndAve,04/19/2014 06:00:00 AM,48,-122,0,0,0
2599,58thStGreenway22ndAve,04/19/2014 07:00:00 AM,48,-122,1,3,4
2600,58thStGreenway22ndAve,04/19/2014 08:00:00 AM,48,-122,12,5,17
2601,58thStGreenway22ndAve,04/19/2014 09:00:00 AM,48,-122,20,15,35
2602,58thStGreenway22ndAve,04/19/2014 10:00:00 AM,48,-122,15,17,32
2603,58thStGreenway22ndAve,04/19/2014 11:00:00 AM,48,-122,27,26,53
2604,58thStGreenway22ndAve,04/19/2014 12:00:00 PM,48,-122,35,22,57
2605,58thStGreenway22ndAve,04/19/2014 01:00:00 PM,48,-122,41,20,61
2606,58thStGreenway22ndAve,04/19/2014 02:00:00 PM,48,-122,32,27,59
2607,58thStGreenway22ndAve,04/19/2014 03:00:00 PM,48,-122,15,35,50
2608,58thStGreenway22ndAve,04/19/2014 04:00:00 PM,48,-122,14,11,25
2609,58thStGreenway22ndAve,04/19/2014 05:00:00 PM,48,-122,21,11,32
2610,58thStGreenway22ndAve,04/19/2014 06:00:00 PM,48,-122,33,11,44
2611,58thStGreenway22ndAve,04/19/2014 07:00:00 PM,48,-122,18,11,29
2612,58thStGreenway22ndAve,04/19/2014 08:00:00 PM,48,-122,26,8,34
2613,58thStGreenway22ndAve,04/19/2014 09:00:00 PM,48,-122,15,9,24
2614,58thStGreenway22ndAve,04/19/2014 10:00:00 PM,48,-122,9,4,13
2615,58thStGreenway22ndAve,04/19/2014 11:00:00 PM,48,-122,4,2,6
2616,58thStGreenway22ndAve,04/20/2014 12:00:00 AM,48,-122,4,0,4
2617,58thStGreenway22ndAve,04/20/2014 01:00:00 AM,48,-122,3,0,3
2618,58thStGreenway22ndAve,04/20/2014 02:00:00 AM,48,-122,5,4,9
2619,58thStGreenway22ndAve,04/20/2014 03:00:00 AM,48,-122,0,0,0
2620,58thStGreenway22ndAve,04/20/2014 04:00:00 AM,48,-122,0,0,0
2621,58thStGreenway22ndAve,04/20/2014 05:00:00 AM,48,-122,0,0,0
2622,58thStGreenway22ndAve,04/20/2014 06:00:00 AM,48,-122,0,1,1
2623,58thStGreenway22ndAve,04/20/2014 07:00:00 AM,48,-122,6,2,8
2624,58thStGreenway22ndAve,04/20/2014 08:00:00 AM,48,-122,6,4,10
2625,58thStGreenway22ndAve,04/20/2014 09:00:00 AM,48,-122,18,8,26
2626,58thStGreenway22ndAve,04/20/2014 10:00:00 AM,48,-122,26,9,35
2627,58thStGreenway22ndAve,04/20/2014 11:00:00 AM,48,-122,21,19,40
2628,58thStGreenway22ndAve,04/20/2014 12:00:00 PM,48,-122,21,25,46
2629,58thStGreenway22ndAve,04/20/2014 01:00:00 PM,48,-122,34,15,49
2630,58thStGreenway22ndAve,04/20/2014 02:00:00 PM,48,-122,17,19,36
2631,58thStGreenway22ndAve,04/20/2014 03:00:00 PM,48,-122,20,9,29
2632,58thStGreenway22ndAve,04/20/2014 04:00:00 PM,48,-122,18,9,27
2633,58thStGreenway22ndAve,04/20/2014 05:00:00 PM,48,-122,19,6,25
2634,58thStGreenway22ndAve,04/20/2014 06:00:00 PM,48,-122,17,6,23
2635,58thStGreenway22ndAve,04/20/2014 07:00:00 PM,48,-122,8,8,16
2636,58thStGreenway22ndAve,04/20/2014 08:00:00 PM,48,-122,9,1,10
2637,58thStGreenway22ndAve,04/20/2014 09:00:00 PM,48,-122,8,5,13
2638,58thStGreenway22ndAve,04/20/2014 10:00:00 PM,48,-122,4,0,4
2639,58thStGreenway22ndAve,04/20/2014 11:00:00 PM,48,-122,4,4,8
2640,58thStGreenway22ndAve,04/21/2014 12:00:00 AM,48,-122,0,1,1
2641,58thStGreenway22ndAve,04/21/2014 01:00:00 AM,48,-122,0,0,0
2642,58thStGreenway22ndAve,04/21/2014 02:00:00 AM,48,-122,0,0,0
2643,58thStGreenway22ndAve,04/21/2014 03:00:00 AM,48,-122,0,0,0
2644,58thStGreenway22ndAve,04/21/2014 04:00:00 AM,48,-122,0,0,0
2645,58thStGreenway22ndAve,04/21/2014 05:00:00 AM,48,-122,1,0,1
2646,58thStGreenway22ndAve,04/21/2014 06:00:00 AM,48,-122,4,5,9
2647,58thStGreenway22ndAve,04/21/2014 07:00:00 AM,48,-122,15,9,24
2648,58thStGreenway22ndAve,04/21/2014 08:00:00 AM,48,-122,9,12,21
2649,58thStGreenway22ndAve,04/21/2014 09:00:00 AM,48,-122,28,13,41
2650,58thStGreenway22ndAve,04/21/2014 10:00:00 AM,48,-122,7,17,24
2651,58thStGreenway22ndAve,04/21/2014 11:00:00 AM,48,-122,16,6,22
2652,58thStGreenway22ndAve,04/21/2014 12:00:00 PM,48,-122,20,22,42
2653,58thStGreenway22ndAve,04/21/2014 01:00:00 PM,48,-122,18,10,28
2654,58thStGreenway22ndAve,04/21/2014 02:00:00 PM,48,-122,18,6,24
2655,58thStGreenway22ndAve,04/21/2014 03:00:00 PM,48,-122,18,6,24
2656,58thStGreenway22ndAve,04/21/2014 04:00:00 PM,48,-122,15,7,22
2657,58thStGreenway22ndAve,04/21/2014 05:00:00 PM,48,-122,30,11,41
2658,58thStGreenway22ndAve,04/21/2014 06:00:00 PM,48,-122,21,22,43
2659,58thStGreenway22ndAve,04/21/2014 07:00:00 PM,48,-122,13,13,26
2660,58thStGreenway22ndAve,04/21/2014 08:00:00 PM,48,-122,15,10,25
2661,58thStGreenway22ndAve,04/21/2014 09:00:00 PM,48,-122,2,3,5
2662,58thStGreenway22ndAve,04/21/2014 10:00:00 PM,48,-122,5,0,5
2663,58thStGreenway22ndAve,04/21/2014 11:00:00 PM,48,-122,7,0,7
2664,58thStGreenway22ndAve,04/22/2014 12:00:00 AM,48,-122,3,0,3
2665,58thStGreenway22ndAve,04/22/2014 01:00:00 AM,48,-122,0,0,0
2666,58thStGreenway22ndAve,04/22/2014 02:00:00 AM,48,-122,0,0,0
2667,58thStGreenway22ndAve,04/22/2014 03:00:00 AM,48,-122,0,0,0
2668,58thStGreenway22ndAve,04/22/2014 04:00:00 AM,48,-122,0,0,0
2669,58thStGreenway22ndAve,04/22/2014 05:00:00 AM,48,-122,2,4,6
2670,58thStGreenway22ndAve,04/22/2014 06:00:00 AM,48,-122,2,3,5
2671,58thStGreenway22ndAve,04/22/2014 07:00:00 AM,48,-122,29,11,40
2672,58thStGreenway22ndAve,04/22/2014 08:00:00 AM,48,-122,15,8,23
2673,58thStGreenway22ndAve,04/22/2014 09:00:00 AM,48,-122,15,16,31
2674,58thStGreenway22ndAve,04/22/2014 10:00:00 AM,48,-122,14,9,23
2675,58thStGreenway22ndAve,04/22/2014 11:00:00 AM,48,-122,22,5,27
2676,58thStGreenway22ndAve,04/22/2014 12:00:00 PM,48,-122,27,13,40
2677,58thStGreenway22ndAve,04/22/2014 01:00:00 PM,48,-122,11,24,35
2678,58thStGreenway22ndAve,04/22/2014 02:00:00 PM,48,-122,20,8,28
2679,58thStGreenway22ndAve,04/22/2014 03:00:00 PM,48,-122,16,15,31
2680,58thStGreenway22ndAve,04/22/2014 04:00:00 PM,48,-122,26,27,53
2681,58thStGreenway22ndAve,04/22/2014 05:00:00 PM,48,-122,23,31,54
2682,58thStGreenway22ndAve,04/22/2014 06:00:00 PM,48,-122,11,15,26
2683,58thStGreenway22ndAve,04/22/2014 07:00:00 PM,48,-122,33,26,59
2684,58thStGreenway22ndAve,04/22/2014 08:00:00 PM,48,-122,25,5,30
2685,58thStGreenway22ndAve,04/22/2014 09:00:00 PM,48,-122,9,8,17
2686,58thStGreenway22ndAve,04/22/2014 10:00:00 PM,48,-122,8,2,10
2687,58thStGreenway22ndAve,04/22/2014 11:00:00 PM,48,-122,3,2,5
2688,58thStGreenway22ndAve,04/23/2014 12:00:00 AM,48,-122,0,1,1
2689,58thStGreenway22ndAve,04/23/2014 01:00:00 AM,48,-122,2,0,2
2690,58thStGreenway22ndAve,04/23/2014 02:00:00 AM,48,-122,1,0,1
2691,58thStGreenway22ndAve,04/23/2014 03:00:00 AM,48,-122,0,0,0
2692,58thStGreenway22ndAve,04/23/2014 04:00:00 AM,48,-122,0,0,0
2693,58thStGreenway22ndAve,04/23/2014 05:00:00 AM,48,-122,2,0,2
2694,58thStGreenway22ndAve,04/23/2014 06:00:00 AM,48,-122,2,2,4
2695,58thStGreenway22ndAve,04/23/2014 07:00:00 AM,48,-122,13,7,20
2696,58thStGreenway22ndAve,04/23/2014 08:00:00 AM,48,-122,18,11,29
2697,58thStGreenway22ndAve,04/23/2014 09:00:00 AM,48,-122,23,8,31
2698,58thStGreenway22ndAve,04/23/2014 10:00:00 AM,48,-122,15,5,20
2699,58thStGreenway22ndAve,04/23/2014 11:00:00 AM,48,-122,10,10,20
2700,58thStGreenway22ndAve,04/23/2014 12:00:00 PM,48,-122,21,5,26
2701,58thStGreenway22ndAve,04/23/2014 01:00:00 PM,48,-122,21,8,29
2702,58thStGreenway22ndAve,04/23/2014 02:00:00 PM,48,-122,17,8,25
2703,58thStGreenway22ndAve,04/23/2014 03:00:00 PM,48,-122,19,14,33
2704,58thStGreenway22ndAve,04/23/2014 04:00:00 PM,48,-122,19,11,30
2705,58thStGreenway22ndAve,04/23/2014 05:00:00 PM,48,-122,9,12,21
2706,58thStGreenway22ndAve,04/23/2014 06:00:00 PM,48,-122,8,8,16
2707,58thStGreenway22ndAve,04/23/2014 07:00:00 PM,48,-122,11,7,18
2708,58thStGreenway22ndAve,04/23/2014 08:00:00 PM,48,-122,8,5,13
2709,58thStGreenway22ndAve,04/23/2014 09:00:00 PM,48,-122,15,5,20
2710,58thStGreenway22ndAve,04/23/2014 10:00:00 PM,48,-122,6,5,11
2711,58thStGreenway22ndAve,04/23/2014 11:00:00 PM,48,-122,3,2,5
2712,58thStGreenway22ndAve,04/24/2014 12:00:00 AM,48,-122,4,1,5
2713,58thStGreenway22ndAve,04/24/2014 01:00:00 AM,48,-122,0,0,0
2714,58thStGreenway22ndAve,04/24/2014 02:00:00 AM,48,-122,0,0,0
2715,58thStGreenway22ndAve,04/24/2014 03:00:00 AM,48,-122,0,0,0
2716,58thStGreenway22ndAve,04/24/2014 04:00:00 AM,48,-122,0,0,0
2717,58thStGreenway22ndAve,04/24/2014 05:00:00 AM,48,-122,4,2,6
2718,58thStGreenway22ndAve,04/24/2014 06:00:00 AM,48,-122,2,3,5
2719,58thStGreenway22ndAve,04/24/2014 07:00:00 AM,48,-122,19,20,39
2720,58thStGreenway22ndAve,04/24/2014 08:00:00 AM,48,-122,17,22,39
2721,58thStGreenway22ndAve,04/24/2014 09:00:00 AM,48,-122,17,10,27
2722,58thStGreenway22ndAve,04/24/2014 10:00:00 AM,48,-122,24,8,32
2723,58thStGreenway22ndAve,04/24/2014 11:00:00 AM,48,-122,8,21,29
2724,58thStGreenway22ndAve,04/24/2014 12:00:00 PM,48,-122,17,12,29
2725,58thStGreenway22ndAve,04/24/2014 01:00:00 PM,48,-122,40,28,68
2726,58thStGreenway22ndAve,04/24/2014 02:00:00 PM,48,-122,21,19,40
2727,58thStGreenway22ndAve,04/24/2014 03:00:00 PM,48,-122,15,13,28
2728,58thStGreenway22ndAve,04/24/2014 04:00:00 PM,48,-122,21,22,43
2729,58thStGreenway22ndAve,04/24/2014 05:00:00 PM,48,-122,38,29,67
2730,58thStGreenway22ndAve,04/24/2014 06:00:00 PM,48,-122,32,18,50
2731,58thStGreenway22ndAve,04/24/2014 07:00:00 PM,48,-122,33,18,51
2732,58thStGreenway22ndAve,04/24/2014 08:00:00 PM,48,-122,6,12,18
2733,58thStGreenway22ndAve,04/24/2014 09:00:00 PM,48,-122,11,7,18
2734,58thStGreenway22ndAve,04/24/2014 10:00:00 PM,48,-122,6,3,9
2735,58thStGreenway22ndAve,04/24/2014 11:00:00 PM,48,-122,11,0,11
2736,58thStGreenway22ndAve,04/25/2014 12:00:00 AM,48,-122,2,2,4
2737,58thStGreenway22ndAve,04/25/2014 01:00:00 AM,48,-122,2,2,4
2738,58thStGreenway22ndAve,04/25/2014 02:00:00 AM,48,-122,0,6,6
2739,58thStGreenway22ndAve,04/25/2014 03:00:00 AM,48,-122,0,0,0
2740,58thStGreenway22ndAve,04/25/2014 04:00:00 AM,48,-122,0,0,0
2741,58thStGreenway22ndAve,04/25/2014 05:00:00 AM,48,-122,3,0,3
2742,58thStGreenway22ndAve,04/25/2014 06:00:00 AM,48,-122,7,5,12
2743,58thStGreenway22ndAve,04/25/2014 07:00:00 AM,48,-122,12,5,17
2744,58thStGreenway22ndAve,04/25/2014 08:00:00 AM,48,-122,22,14,36
2745,58thStGreenway22ndAve,04/25/2014 09:00:00 AM,48,-122,16,20,36
2746,58thStGreenway22ndAve,04/25/2014 10:00:00 AM,48,-122,16,9,25
2747,58thStGreenway22ndAve,04/25/2014 11:00:00 AM,48,-122,24,12,36
2748,58thStGreenway22ndAve,04/25/2014 12:00:00 PM,48,-122,33,11,44
2749,58thStGreenway22ndAve,04/25/2014 01:00:00 PM,48,-122,28,21,49
2750,58thStGreenway22ndAve,04/25/2014 02:00:00 PM,48,-122,12,16,28
2751,58thStGreenway22ndAve,04/25/2014 03:00:00 PM,48,-122,24,11,35
2752,58thStGreenway22ndAve,04/25/2014 04:00:00 PM,48,-122,29,14,43
2753,58thStGreenway22ndAve,04/25/2014 05:00:00 PM,48,-122,26,15,41
2754,58thStGreenway22ndAve,04/25/2014 06:00:00 PM,48,-122,28,27,55
2755,58thStGreenway22ndAve,04/25/2014 07:00:00 PM,48,-122,29,12,41
2756,58thStGreenway22ndAve,04/25/2014 08:00:00 PM,48,-122,7,8,15
2757,58thStGreenway22ndAve,04/25/2014 09:00:00 PM,48,-122,5,5,10
2758,58thStGreenway22ndAve,04/25/2014 10:00:00 PM,48,-122,2,3,5
2759,58thStGreenway22ndAve,04/25/2014 11:00:00 PM,48,-122,6,6,12
2760,58thStGreenway22ndAve,04/26/2014 12:00:00 AM,48,-122,7,1,8
2761,58thStGreenway22ndAve,04/26/2014 01:00:00 AM,48,-122,4,4,8
2762,58thStGreenway22ndAve,04/26/2014 02:00:00 AM,48,-122,0,2,2
2763,58thStGreenway22ndAve,04/26/2014 03:00:00 AM,48,-122,1,0,1
2764,58thStGreenway22ndAve,04/26/2014 04:00:00 AM,48,-122,0,0,0
2765,58thStGreenway22ndAve,04/26/2014 05:00:00 AM,48,-122,4,0,4
2766,58thStGreenway22ndAve,04/26/2014 06:00:00 AM,48,-122,5,0,5
2767,58thStGreenway22ndAve,04/26/2014 07:00:00 AM,48,-122,0,2,2
2768,58thStGreenway22ndAve,04/26/2014 08:00:00 AM,48,-122,15,4,19
2769,58thStGreenway22ndAve,04/26/2014 09:00:00 AM,48,-122,23,8,31
2770,58thStGreenway22ndAve,04/26/2014 10:00:00 AM,48,-122,25,18,43
2771,58thStGreenway22ndAve,04/26/2014 11:00:00 AM,48,-122,34,29,63
2772,58thStGreenway22ndAve,04/26/2014 12:00:00 PM,48,-122,24,28,52
2773,58thStGreenway22ndAve,04/26/2014 01:00:00 PM,48,-122,31,12,43
2774,58thStGreenway22ndAve,04/26/2014 02:00:00 PM,48,-122,37,32,69
2775,58thStGreenway22ndAve,04/26/2014 03:00:00 PM,48,-122,16,22,38
2776,58thStGreenway22ndAve,04/26/2014 04:00:00 PM,48,-122,30,24,54
2777,58thStGreenway22ndAve,04/26/2014 05:00:00 PM,48,-122,53,19,72
2778,58thStGreenway22ndAve,04/26/2014 06:00:00 PM,48,-122,27,18,45
2779,58thStGreenway22ndAve,04/26/2014 07:00:00 PM,48,-122,18,14,32
2780,58thStGreenway22ndAve,04/26/2014 08:00:00 PM,48,-122,18,6,24
2781,58thStGreenway22ndAve,04/26/2014 09:00:00 PM,48,-122,24,3,27
2782,58thStGreenway22ndAve,04/26/2014 10:00:00 PM,48,-122,10,0,10
2783,58thStGreenway22ndAve,04/26/2014 11:00:00 PM,48,-122,4,3,7
2784,58thStGreenway22ndAve,04/27/2014 12:00:00 AM,48,-122,2,1,3
2785,58thStGreenway22ndAve,04/27/2014 01:00:00 AM,48,-122,4,1,5
2786,58thStGreenway22ndAve,04/27/2014 02:00:00 AM,48,-122,0,1,1
2787,58thStGreenway22ndAve,04/27/2014 03:00:00 AM,48,-122,0,0,0
2788,58thStGreenway22ndAve,04/27/2014 04:00:00 AM,48,-122,0,0,0
2789,58thStGreenway22ndAve,04/27/2014 05:00:00 AM,48,-122,2,1,3
2790,58thStGreenway22ndAve,04/27/2014 06:00:00 AM,48,-122,0,0,0
2791,58thStGreenway22ndAve,04/27/2014 07:00:00 AM,48,-122,5,0,5
2792,58thStGreenway22ndAve,04/27/2014 08:00:00 AM,48,-122,5,7,12
2793,58thStGreenway22ndAve,04/27/2014 09:00:00 AM,48,-122,20,10,30
2794,58thStGreenway22ndAve,04/27/2014 10:00:00 AM,48,-122,34,28,62
2795,58thStGreenway22ndAve,04/27/2014 11:00:00 AM,48,-122,48,42,90
2796,58thStGreenway22ndAve,04/27/2014 12:00:00 PM,48,-122,44,23,67
2797,58thStGreenway22ndAve,04/27/2014 01:00:00 PM,48,-122,43,34,77
2798,58thStGreenway22ndAve,04/27/2014 02:00:00 PM,48,-122,38,13,51
2799,58thStGreenway22ndAve,04/27/2014 03:00:00 PM,48,-122,19,17,36
2800,58thStGreenway22ndAve,04/27/2014 04:00:00 PM,48,-122,38,17,55
2801,58thStGreenway22ndAve,04/27/2014 05:00:00 PM,48,-122,11,13,24
2802,58thStGreenway22ndAve,04/27/2014 06:00:00 PM,48,-122,17,21,38
2803,58thStGreenway22ndAve,04/27/2014 07:00:00 PM,48,-122,16,17,33
2804,58thStGreenway22ndAve,04/27/2014 08:00:00 PM,48,-122,10,6,16
2805,58thStGreenway22ndAve,04/27/2014 09:00:00 PM,48,-122,1,2,3
2806,58thStGreenway22ndAve,04/27/2014 10:00:00 PM,48,-122,5,1,6
2807,58thStGreenway22ndAve,04/27/2014 11:00:00 PM,48,-122,5,0,5
2808,58thStGreenway22ndAve,04/28/2014 12:00:00 AM,48,-122,0,0,0
2809,58thStGreenway22ndAve,04/28/2014 01:00:00 AM,48,-122,4,0,4
2810,58thStGreenway22ndAve,04/28/2014 02:00:00 AM,48,-122,0,0,0
2811,58thStGreenway22ndAve,04/28/2014 03:00:00 AM,48,-122,3,1,4
2812,58thStGreenway22ndAve,04/28/2014 04:00:00 AM,48,-122,2,0,2
2813,58thStGreenway22ndAve,04/28/2014 05:00:00 AM,48,-122,0,6,6
2814,58thStGreenway22ndAve,04/28/2014 06:00:00 AM,48,-122,1,1,2
2815,58thStGreenway22ndAve,04/28/2014 07:00:00 AM,48,-122,27,9,36
2816,58thStGreenway22ndAve,04/28/2014 08:00:00 AM,48,-122,18,12,30
2817,58thStGreenway22ndAve,04/28/2014 09:00:00 AM,48,-122,29,11,40
2818,58thStGreenway22ndAve,04/28/2014 10:00:00 AM,48,-122,17,1,18
2819,58thStGreenway22ndAve,04/28/2014 11:00:00 AM,48,-122,17,10,27
2820,58thStGreenway22ndAve,04/28/2014 12:00:00 PM,48,-122,23,17,40
2821,58thStGreenway22ndAve,04/28/2014 01:00:00 PM,48,-122,23,15,38
2822,58thStGreenway22ndAve,04/28/2014 02:00:00 PM,48,-122,21,11,32
2823,58thStGreenway22ndAve,04/28/2014 03:00:00 PM,48,-122,20,15,35
2824,58thStGreenway22ndAve,04/28/2014 04:00:00 PM,48,-122,26,15,41
2825,58thStGreenway22ndAve,04/28/2014 05:00:00 PM,48,-122,20,29,49
2826,58thStGreenway22ndAve,04/28/2014 06:00:00 PM,48,-122,28,19,47
2827,58thStGreenway22ndAve,04/28/2014 07:00:00 PM,48,-122,19,7,26
2828,58thStGreenway22ndAve,04/28/2014 08:00:00 PM,48,-122,17,9,26
2829,58thStGreenway22ndAve,04/28/2014 09:00:00 PM,48,-122,2,2,4
2830,58thStGreenway22ndAve,04/28/2014 10:00:00 PM,48,-122,4,2,6
2831,58thStGreenway22ndAve,04/28/2014 11:00:00 PM,48,-122,2,0,2
2832,58thStGreenway22ndAve,04/29/2014 12:00:00 AM,48,-122,2,0,2
2833,58thStGreenway22ndAve,04/29/2014 01:00:00 AM,48,-122,0,0,0
2834,58thStGreenway22ndAve,04/29/2014 02:00:00 AM,48,-122,0,0,0
2835,58thStGreenway22ndAve,04/29/2014 03:00:00 AM,48,-122,0,0,0
2836,58thStGreenway22ndAve,04/29/2014 04:00:00 AM,48,-122,0,0,0
2837,58thStGreenway22ndAve,04/29/2014 05:00:00 AM,48,-122,5,1,6
2838,58thStGreenway22ndAve,04/29/2014 06:00:00 AM,48,-122,9,4,13
2839,58thStGreenway22ndAve,04/29/2014 07:00:00 AM,48,-122,22,6,28
2840,58thStGreenway22ndAve,04/29/2014 08:00:00 AM,48,-122,13,8,21
2841,58thStGreenway22ndAve,04/29/2014 09:00:00 AM,48,-122,28,21,49
2842,58thStGreenway22ndAve,04/29/2014 10:00:00 AM,48,-122,9,11,20
2843,58thStGreenway22ndAve,04/29/2014 11:00:00 AM,48,-122,18,19,37
2844,58thStGreenway22ndAve,04/29/2014 12:00:00 PM,48,-122,29,17,46
2845,58thStGreenway22ndAve,04/29/2014 01:00:00 PM,48,-122,21,11,32
2846,58thStGreenway22ndAve,04/29/2014 02:00:00 PM,48,-122,16,12,28
2847,58thStGreenway22ndAve,04/29/2014 03:00:00 PM,48,-122,25,14,39
2848,58thStGreenway22ndAve,04/29/2014 04:00:00 PM,48,-122,22,13,35
2849,58thStGreenway22ndAve,04/29/2014 05:00:00 PM,48,-122,34,16,50
2850,58thStGreenway22ndAve,04/29/2014 06:00:00 PM,48,-122,32,37,69
2851,58thStGreenway22ndAve,04/29/2014 07:00:00 PM,48,-122,33,25,58
2852,58thStGreenway22ndAve,04/29/2014 08:00:00 PM,48,-122,21,11,32
2853,58thStGreenway22ndAve,04/29/2014 09:00:00 PM,48,-122,10,2,12
2854,58thStGreenway22ndAve,04/29/2014 10:00:00 PM,48,-122,2,4,6
2855,58thStGreenway22ndAve,04/29/2014 11:00:00 PM,48,-122,2,3,5
2856,58thStGreenway22ndAve,04/30/2014 12:00:00 AM,48,-122,4,2,6
2857,58thStGreenway22ndAve,04/30/2014 01:00:00 AM,48,-122,2,0,2
2858,58thStGreenway22ndAve,04/30/2014 02:00:00 AM,48,-122,2,0,2
2859,58thStGreenway22ndAve,04/30/2014 03:00:00 AM,48,-122,0,0,0
2860,58thStGreenway22ndAve,04/30/2014 04:00:00 AM,48,-122,1,0,1
2861,58thStGreenway22ndAve,04/30/2014 05:00:00 AM,48,-122,2,0,2
2862,58thStGreenway22ndAve,04/30/2014 06:00:00 AM,48,-122,8,3,11
2863,58thStGreenway22ndAve,04/30/2014 07:00:00 AM,48,-122,13,11,24
2864,58thStGreenway22ndAve,04/30/2014 08:00:00 AM,48,-122,13,15,28
2865,58thStGreenway22ndAve,04/30/2014 09:00:00 AM,48,-122,19,18,37
2866,58thStGreenway22ndAve,04/30/2014 10:00:00 AM,48,-122,14,7,21
2867,58thStGreenway22ndAve,04/30/2014 11:00:00 AM,48,-122,31,17,48
2868,58thStGreenway22ndAve,04/30/2014 12:00:00 PM,48,-122,24,14,38
2869,58thStGreenway22ndAve,04/30/2014 01:00:00 PM,48,-122,24,11,35
2870,58thStGreenway22ndAve,04/30/2014 02:00:00 PM,48,-122,33,14,47
2871,58thStGreenway22ndAve,04/30/2014 03:00:00 PM,48,-122,22,19,41
2872,58thStGreenway22ndAve,04/30/2014 04:00:00 PM,48,-122,37,19,56
2873,58thStGreenway22ndAve,04/30/2014 05:00:00 PM,48,-122,39,30,69
2874,58thStGreenway22ndAve,04/30/2014 06:00:00 PM,48,-122,33,27,60
2875,58thStGreenway22ndAve,04/30/2014 07:00:00 PM,48,-122,43,23,66
2876,58thStGreenway22ndAve,04/30/2014 08:00:00 PM,48,-122,15,11,26
2877,58thStGreenway22ndAve,04/30/2014 09:00:00 PM,48,-122,23,9,32
2878,58thStGreenway22ndAve,04/30/2014 10:00:00 PM,48,-122,6,7,13
2879,58thStGreenway22ndAve,04/30/2014 11:00:00 PM,48,-122,5,2,7
2880,58thStGreenway22ndAve,05/01/2014 12:00:00 AM,48,-122,2,0,2
2881,58thStGreenway22ndAve,05/01/2014 01:00:00 AM,48,-122,0,0,0
2882,58thStGreenway22ndAve,05/01/2014 02:00:00 AM,48,-122,0,1,1
2883,58thStGreenway22ndAve,05/01/2014 03:00:00 AM,48,-122,0,1,1
2884,58thStGreenway22ndAve,05/01/2014 04:00:00 AM,48,-122,0,0,0
2885,58thStGreenway22ndAve,05/01/2014 05:00:00 AM,48,-122,5,2,7
2886,58thStGreenway22ndAve,05/01/2014 06:00:00 AM,48,-122,20,6,26
2887,58thStGreenway22ndAve,05/01/2014 07:00:00 AM,48,-122,27,15,42
2888,58thStGreenway22ndAve,05/01/2014 08:00:00 AM,48,-122,37,14,51
2889,58thStGreenway22ndAve,05/01/2014 09:00:00 AM,48,-122,24,10,34
2890,58thStGreenway22ndAve,05/01/2014 10:00:00 AM,48,-122,11,23,34
2891,58thStGreenway22ndAve,05/01/2014 11:00:00 AM,48,-122,24,32,56
2892,58thStGreenway22ndAve,05/01/2014 12:00:00 PM,48,-122,18,20,38
2893,58thStGreenway22ndAve,05/01/2014 01:00:00 PM,48,-122,8,17,25
2894,58thStGreenway22ndAve,05/01/2014 02:00:00 PM,48,-122,25,10,35
2895,58thStGreenway22ndAve,05/01/2014 03:00:00 PM,48,-122,31,23,54
2896,58thStGreenway22ndAve,05/01/2014 04:00:00 PM,48,-122,25,20,45
2897,58thStGreenway22ndAve,05/01/2014 05:00:00 PM,48,-122,27,29,56
2898,58thStGreenway22ndAve,05/01/2014 06:00:00 PM,48,-122,25,17,42
2899,58thStGreenway22ndAve,05/01/2014 07:00:00 PM,48,-122,19,11,30
2900,58thStGreenway22ndAve,05/01/2014 08:00:00 PM,48,-122,18,8,26
2901,58thStGreenway22ndAve,05/01/2014 09:00:00 PM,48,-122,17,8,25
2902,58thStGreenway22ndAve,05/01/2014 10:00:00 PM,48,-122,8,3,11
2903,58thStGreenway22ndAve,05/01/2014 11:00:00 PM,48,-122,5,3,8
2904,58thStGreenway22ndAve,05/02/2014 12:00:00 AM,48,-122,5,1,6
2905,58thStGreenway22ndAve,05/02/2014 01:00:00 AM,48,-122,1,1,2
2906,58thStGreenway22ndAve,05/02/2014 02:00:00 AM,48,-122,2,0,2
2907,58thStGreenway22ndAve,05/02/2014 03:00:00 AM,48,-122,5,0,5
2908,58thStGreenway22ndAve,05/02/2014 04:00:00 AM,48,-122,0,0,0
2909,58thStGreenway22ndAve,05/02/2014 05:00:00 AM,48,-122,2,0,2
2910,58thStGreenway22ndAve,05/02/2014 06:00:00 AM,48,-122,7,4,11
2911,58thStGreenway22ndAve,05/02/2014 07:00:00 AM,48,-122,17,7,24
2912,58thStGreenway22ndAve,05/02/2014 08:00:00 AM,48,-122,42,12,54
2913,58thStGreenway22ndAve,05/02/2014 09:00:00 AM,48,-122,36,14,50
2914,58thStGreenway22ndAve,05/02/2014 10:00:00 AM,48,-122,22,10,32
2915,58thStGreenway22ndAve,05/02/2014 11:00:00 AM,48,-122,25,6,31
2916,58thStGreenway22ndAve,05/02/2014 12:00:00 PM,48,-122,21,13,34
2917,58thStGreenway22ndAve,05/02/2014 01:00:00 PM,48,-122,31,18,49
2918,58thStGreenway22ndAve,05/02/2014 02:00:00 PM,48,-122,26,18,44
2919,58thStGreenway22ndAve,05/02/2014 03:00:00 PM,48,-122,19,11,30
2920,58thStGreenway22ndAve,05/02/2014 04:00:00 PM,48,-122,27,31,58
2921,58thStGreenway22ndAve,05/02/2014 05:00:00 PM,48,-122,44,20,64
2922,58thStGreenway22ndAve,05/02/2014 06:00:00 PM,48,-122,36,28,64
2923,58thStGreenway22ndAve,05/02/2014 07:00:00 PM,48,-122,37,18,55
2924,58thStGreenway22ndAve,05/02/2014 08:00:00 PM,48,-122,16,9,25
2925,58thStGreenway22ndAve,05/02/2014 09:00:00 PM,48,-122,18,8,26
2926,58thStGreenway22ndAve,05/02/2014 10:00:00 PM,48,-122,15,7,22
2927,58thStGreenway22ndAve,05/02/2014 11:00:00 PM,48,-122,5,3,8
2928,58thStGreenway22ndAve,05/03/2014 12:00:00 AM,48,-122,0,2,2
2929,58thStGreenway22ndAve,05/03/2014 01:00:00 AM,48,-122,0,0,0
2930,58thStGreenway22ndAve,05/03/2014 02:00:00 AM,48,-122,3,1,4
2931,58thStGreenway22ndAve,05/03/2014 03:00:00 AM,48,-122,0,0,0
2932,58thStGreenway22ndAve,05/03/2014 04:00:00 AM,48,-122,0,0,0
2933,58thStGreenway22ndAve,05/03/2014 05:00:00 AM,48,-122,2,0,2
2934,58thStGreenway22ndAve,05/03/2014 06:00:00 AM,48,-122,4,0,4
2935,58thStGreenway22ndAve,05/03/2014 07:00:00 AM,48,-122,2,6,8
2936,58thStGreenway22ndAve,05/03/2014 08:00:00 AM,48,-122,20,9,29
2937,58thStGreenway22ndAve,05/03/2014 09:00:00 AM,48,-122,28,23,51
2938,58thStGreenway22ndAve,05/03/2014 10:00:00 AM,48,-122,31,18,49
2939,58thStGreenway22ndAve,05/03/2014 11:00:00 AM,48,-122,33,30,63
2940,58thStGreenway22ndAve,05/03/2014 12:00:00 PM,48,-122,28,21,49
2941,58thStGreenway22ndAve,05/03/2014 01:00:00 PM,48,-122,46,34,80
2942,58thStGreenway22ndAve,05/03/2014 02:00:00 PM,48,-122,39,20,59
2943,58thStGreenway22ndAve,05/03/2014 03:00:00 PM,48,-122,28,25,53
2944,58thStGreenway22ndAve,05/03/2014 04:00:00 PM,48,-122,15,8,23
2945,58thStGreenway22ndAve,05/03/2014 05:00:00 PM,48,-122,19,9,28
2946,58thStGreenway22ndAve,05/03/2014 06:00:00 PM,48,-122,34,7,41
2947,58thStGreenway22ndAve,05/03/2014 07:00:00 PM,48,-122,13,6,19
2948,58thStGreenway22ndAve,05/03/2014 08:00:00 PM,48,-122,14,10,24
2949,58thStGreenway22ndAve,05/03/2014 09:00:00 PM,48,-122,7,12,19
2950,58thStGreenway22ndAve,05/03/2014 10:00:00 PM,48,-122,8,8,16
2951,58thStGreenway22ndAve,05/03/2014 11:00:00 PM,48,-122,15,4,19
2952,58thStGreenway22ndAve,05/04/2014 12:00:00 AM,48,-122,6,0,6
2953,58thStGreenway22ndAve,05/04/2014 01:00:00 AM,48,-122,2,0,2
2954,58thStGreenway22ndAve,05/04/2014 02:00:00 AM,48,-122,0,1,1
2955,58thStGreenway22ndAve,05/04/2014 03:00:00 AM,48,-122,4,5,9
2956,58thStGreenway22ndAve,05/04/2014 04:00:00 AM,48,-122,0,0,0
2957,58thStGreenway22ndAve,05/04/2014 05:00:00 AM,48,-122,3,0,3
2958,58thStGreenway22ndAve,05/04/2014 06:00:00 AM,48,-122,1,0,1
2959,58thStGreenway22ndAve,05/04/2014 07:00:00 AM,48,-122,4,1,5
2960,58thStGreenway22ndAve,05/04/2014 08:00:00 AM,48,-122,7,2,9
2961,58thStGreenway22ndAve,05/04/2014 09:00:00 AM,48,-122,12,4,16
2962,58thStGreenway22ndAve,05/04/2014 10:00:00 AM,48,-122,23,10,33
2963,58thStGreenway22ndAve,05/04/2014 11:00:00 AM,48,-122,13,12,25
2964,58thStGreenway22ndAve,05/04/2014 12:00:00 PM,48,-122,25,18,43
2965,58thStGreenway22ndAve,05/04/2014 01:00:00 PM,48,-122,37,24,61
2966,58thStGreenway22ndAve,05/04/2014 02:00:00 PM,48,-122,28,15,43
2967,58thStGreenway22ndAve,05/04/2014 03:00:00 PM,48,-122,31,9,40
2968,58thStGreenway22ndAve,05/04/2014 04:00:00 PM,48,-122,25,7,32
2969,58thStGreenway22ndAve,05/04/2014 05:00:00 PM,48,-122,23,12,35
2970,58thStGreenway22ndAve,05/04/2014 06:00:00 PM,48,-122,26,7,33
2971,58thStGreenway22ndAve,05/04/2014 07:00:00 PM,48,-122,10,1,11
2972,58thStGreenway22ndAve,05/04/2014 08:00:00 PM,48,-122,12,1,13
2973,58thStGreenway22ndAve,05/04/2014 09:00:00 PM,48,-122,5,0,5
2974,58thStGreenway22ndAve,05/04/2014 10:00:00 PM,48,-122,2,1,3
2975,58thStGreenway22ndAve,05/04/2014 11:00:00 PM,48,-122,9,2,11
2976,58thStGreenway22ndAve,05/05/2014 12:00:00 AM,48,-122,2,0,2
2977,58thStGreenway22ndAve,05/05/2014 01:00:00 AM,48,-122,0,0,0
2978,58thStGreenway22ndAve,05/05/2014 02:00:00 AM,48,-122,4,0,4
2979,58thStGreenway22ndAve,05/05/2014 03:00:00 AM,48,-122,0,0,0
2980,58thStGreenway22ndAve,05/05/2014 04:00:00 AM,48,-122,2,0,2
2981,58thStGreenway22ndAve,05/05/2014 05:00:00 AM,48,-122,3,1,4
2982,58thStGreenway22ndAve,05/05/2014 06:00:00 AM,48,-122,14,7,21
2983,58thStGreenway22ndAve,05/05/2014 07:00:00 AM,48,-122,21,10,31
2984,58thStGreenway22ndAve,05/05/2014 08:00:00 AM,48,-122,33,12,45
2985,58thStGreenway22ndAve,05/05/2014 09:00:00 AM,48,-122,17,12,29
2986,58thStGreenway22ndAve,05/05/2014 10:00:00 AM,48,-122,17,6,23
2987,58thStGreenway22ndAve,05/05/2014 11:00:00 AM,48,-122,25,17,42
2988,58thStGreenway22ndAve,05/05/2014 12:00:00 PM,48,-122,15,25,40
2989,58thStGreenway22ndAve,05/05/2014 01:00:00 PM,48,-122,28,15,43
2990,58thStGreenway22ndAve,05/05/2014 02:00:00 PM,48,-122,24,6,30
2991,58thStGreenway22ndAve,05/05/2014 03:00:00 PM,48,-122,20,14,34
2992,58thStGreenway22ndAve,05/05/2014 04:00:00 PM,48,-122,16,7,23
2993,58thStGreenway22ndAve,05/05/2014 05:00:00 PM,48,-122,25,11,36
2994,58thStGreenway22ndAve,05/05/2014 06:00:00 PM,48,-122,29,19,48
2995,58thStGreenway22ndAve,05/05/2014 07:00:00 PM,48,-122,21,14,35
2996,58thStGreenway22ndAve,05/05/2014 08:00:00 PM,48,-122,15,7,22
2997,58thStGreenway22ndAve,05/05/2014 09:00:00 PM,48,-122,11,3,14
2998,58thStGreenway22ndAve,05/05/2014 10:00:00 PM,48,-122,8,1,9
2999,58thStGreenway22ndAve,05/05/2014 11:00:00 PM,48,-122,6,1,7
3000,58thStGreenway22ndAve,05/06/2014 12:00:00 AM,48,-122,5,1,6
3001,58thStGreenway22ndAve,05/06/2014 01:00:00 AM,48,-122,2,1,3
3002,58thStGreenway22ndAve,05/06/2014 02:00:00 AM,48,-122,0,0,0
3003,58thStGreenway22ndAve,05/06/2014 03:00:00 AM,48,-122,0,0,0
3004,58thStGreenway22ndAve,05/06/2014 04:00:00 AM,48,-122,0,0,0
3005,58thStGreenway22ndAve,05/06/2014 05:00:00 AM,48,-122,2,0,2
3006,58thStGreenway22ndAve,05/06/2014 06:00:00 AM,48,-122,12,4,16
3007,58thStGreenway22ndAve,05/06/2014 07:00:00 AM,48,-122,18,9,27
3008,58thStGreenway22ndAve,05/06/2014 08:00:00 AM,48,-122,17,14,31
3009,58thStGreenway22ndAve,05/06/2014 09:00:00 AM,48,-122,20,13,33
3010,58thStGreenway22ndAve,05/06/2014 10:00:00 AM,48,-122,16,11,27
3011,58thStGreenway22ndAve,05/06/2014 11:00:00 AM,48,-122,11,7,18
3012,58thStGreenway22ndAve,05/06/2014 12:00:00 PM,48,-122,17,6,23
3013,58thStGreenway22ndAve,05/06/2014 01:00:00 PM,48,-122,21,7,28
3014,58thStGreenway22ndAve,05/06/2014 02:00:00 PM,48,-122,23,8,31
3015,58thStGreenway22ndAve,05/06/2014 03:00:00 PM,48,-122,13,4,17
3016,58thStGreenway22ndAve,05/06/2014 04:00:00 PM,48,-122,25,7,32
3017,58thStGreenway22ndAve,05/06/2014 05:00:00 PM,48,-122,25,10,35
3018,58thStGreenway22ndAve,05/06/2014 06:00:00 PM,48,-122,33,17,50
3019,58thStGreenway22ndAve,05/06/2014 07:00:00 PM,48,-122,16,10,26
3020,58thStGreenway22ndAve,05/06/2014 08:00:00 PM,48,-122,28,3,31
3021,58thStGreenway22ndAve,05/06/2014 09:00:00 PM,48,-122,10,6,16
3022,58thStGreenway22ndAve,05/06/2014 10:00:00 PM,48,-122,3,1,4
3023,58thStGreenway22ndAve,05/06/2014 11:00:00 PM,48,-122,4,0,4
3024,58thStGreenway22ndAve,05/07/2014 12:00:00 AM,48,-122,0,0,0
3025,58thStGreenway22ndAve,05/07/2014 01:00:00 AM,48,-122,0,0,0
3026,58thStGreenway22ndAve,05/07/2014 02:00:00 AM,48,-122,0,0,0
3027,58thStGreenway22ndAve,05/07/2014 03:00:00 AM,48,-122,0,0,0
3028,58thStGreenway22ndAve,05/07/2014 04:00:00 AM,48,-122,0,0,0
3029,58thStGreenway22ndAve,05/07/2014 05:00:00 AM,48,-122,2,0,2
3030,58thStGreenway22ndAve,05/07/2014 06:00:00 AM,48,-122,0,3,3
3031,58thStGreenway22ndAve,05/07/2014 07:00:00 AM,48,-122,32,6,38
3032,58thStGreenway22ndAve,05/07/2014 08:00:00 AM,48,-122,23,12,35
3033,58thStGreenway22ndAve,05/07/2014 09:00:00 AM,48,-122,30,14,44
3034,58thStGreenway22ndAve,05/07/2014 10:00:00 AM,48,-122,15,15,30
3035,58thStGreenway22ndAve,05/07/2014 11:00:00 AM,48,-122,15,13,28
3036,58thStGreenway22ndAve,05/07/2014 12:00:00 PM,48,-122,24,9,33
3037,58thStGreenway22ndAve,05/07/2014 01:00:00 PM,48,-122,16,10,26
3038,58thStGreenway22ndAve,05/07/2014 02:00:00 PM,48,-122,22,16,38
3039,58thStGreenway22ndAve,05/07/2014 03:00:00 PM,48,-122,25,24,49
3040,58thStGreenway22ndAve,05/07/2014 04:00:00 PM,48,-122,23,14,37
3041,58thStGreenway22ndAve,05/07/2014 05:00:00 PM,48,-122,26,22,48
3042,58thStGreenway22ndAve,05/07/2014 06:00:00 PM,48,-122,37,19,56
3043,58thStGreenway22ndAve,05/07/2014 07:00:00 PM,48,-122,29,15,44
3044,58thStGreenway22ndAve,05/07/2014 08:00:00 PM,48,-122,15,1,16
3045,58thStGreenway22ndAve,05/07/2014 09:00:00 PM,48,-122,19,2,21
3046,58thStGreenway22ndAve,05/07/2014 10:00:00 PM,48,-122,13,0,13
3047,58thStGreenway22ndAve,05/07/2014 11:00:00 PM,48,-122,5,1,6
3048,58thStGreenway22ndAve,05/08/2014 12:00:00 AM,48,-122,0,0,0
3049,58thStGreenway22ndAve,05/08/2014 01:00:00 AM,48,-122,0,0,0
3050,58thStGreenway22ndAve,05/08/2014 02:00:00 AM,48,-122,2,0,2
3051,58thStGreenway22ndAve,05/08/2014 03:00:00 AM,48,-122,0,0,0
3052,58thStGreenway22ndAve,05/08/2014 04:00:00 AM,48,-122,2,0,2
3053,58thStGreenway22ndAve,05/08/2014 05:00:00 AM,48,-122,0,0,0
3054,58thStGreenway22ndAve,05/08/2014 06:00:00 AM,48,-122,4,3,7
3055,58thStGreenway22ndAve,05/08/2014 07:00:00 AM,48,-122,33,5,38
3056,58thStGreenway22ndAve,05/08/2014 08:00:00 AM,48,-122,32,7,39
3057,58thStGreenway22ndAve,05/08/2014 09:00:00 AM,48,-122,17,5,22
3058,58thStGreenway22ndAve,05/08/2014 10:00:00 AM,48,-122,16,3,19
3059,58thStGreenway22ndAve,05/08/2014 11:00:00 AM,48,-122,11,12,23
3060,58thStGreenway22ndAve,05/08/2014 12:00:00 PM,48,-122,16,2,18
3061,58thStGreenway22ndAve,05/08/2014 01:00:00 PM,48,-122,18,11,29
3062,58thStGreenway22ndAve,05/08/2014 02:00:00 PM,48,-122,14,15,29
3063,58thStGreenway22ndAve,05/08/2014 03:00:00 PM,48,-122,26,14,40
3064,58thStGreenway22ndAve,05/08/2014 04:00:00 PM,48,-122,14,16,30
3065,58thStGreenway22ndAve,05/08/2014 05:00:00 PM,48,-122,39,15,54
3066,58thStGreenway22ndAve,05/08/2014 06:00:00 PM,48,-122,30,5,35
3067,58thStGreenway22ndAve,05/08/2014 07:00:00 PM,48,-122,30,9,39
3068,58thStGreenway22ndAve,05/08/2014 08:00:00 PM,48,-122,15,10,25
3069,58thStGreenway22ndAve,05/08/2014 09:00:00 PM,48,-122,4,5,9
3070,58thStGreenway22ndAve,05/08/2014 10:00:00 PM,48,-122,13,3,16
3071,58thStGreenway22ndAve,05/08/2014 11:00:00 PM,48,-122,6,0,6
3072,58thStGreenway22ndAve,05/09/2014 12:00:00 AM,48,-122,2,0,2
3073,58thStGreenway22ndAve,05/09/2014 01:00:00 AM,48,-122,0,0,0
3074,58thStGreenway22ndAve,05/09/2014 02:00:00 AM,48,-122,0,0,0
3075,58thStGreenway22ndAve,05/09/2014 03:00:00 AM,48,-122,2,0,2
3076,58thStGreenway22ndAve,05/09/2014 04:00:00 AM,48,-122,0,0,0
3077,58thStGreenway22ndAve,05/09/2014 05:00:00 AM,48,-122,0,0,0
3078,58thStGreenway22ndAve,05/09/2014 06:00:00 AM,48,-122,17,1,18
3079,58thStGreenway22ndAve,05/09/2014 07:00:00 AM,48,-122,19,7,26
3080,58thStGreenway22ndAve,05/09/2014 08:00:00 AM,48,-122,11,5,16
3081,58thStGreenway22ndAve,05/09/2014 09:00:00 AM,48,-122,27,10,37
3082,58thStGreenway22ndAve,05/09/2014 10:00:00 AM,48,-122,12,9,21
3083,58thStGreenway22ndAve,05/09/2014 11:00:00 AM,48,-122,12,20,32
3084,58thStGreenway22ndAve,05/09/2014 12:00:00 PM,48,-122,21,12,33
3085,58thStGreenway22ndAve,05/09/2014 01:00:00 PM,48,-122,22,12,34
3086,58thStGreenway22ndAve,05/09/2014 02:00:00 PM,48,-122,15,8,23
3087,58thStGreenway22ndAve,05/09/2014 03:00:00 PM,48,-122,26,12,38
3088,58thStGreenway22ndAve,05/09/2014 04:00:00 PM,48,-122,24,5,29
3089,58thStGreenway22ndAve,05/09/2014 05:00:00 PM,48,-122,35,16,51
3090,58thStGreenway22ndAve,05/09/2014 06:00:00 PM,48,-122,16,12,28
3091,58thStGreenway22ndAve,05/09/2014 07:00:00 PM,48,-122,28,9,37
3092,58thStGreenway22ndAve,05/09/2014 08:00:00 PM,48,-122,14,4,18
3093,58thStGreenway22ndAve,05/09/2014 09:00:00 PM,48,-122,17,7,24
3094,58thStGreenway22ndAve,05/09/2014 10:00:00 PM,48,-122,12,0,12
3095,58thStGreenway22ndAve,05/09/2014 11:00:00 PM,48,-122,6,1,7
3096,58thStGreenway22ndAve,05/10/2014 12:00:00 AM,48,-122,4,0,4
3097,58thStGreenway22ndAve,05/10/2014 01:00:00 AM,48,-122,3,0,3
3098,58thStGreenway22ndAve,05/10/2014 02:00:00 AM,48,-122,6,1,7
3099,58thStGreenway22ndAve,05/10/2014 03:00:00 AM,48,-122,0,0,0
3100,58thStGreenway22ndAve,05/10/2014 04:00:00 AM,48,-122,2,0,2
3101,58thStGreenway22ndAve,05/10/2014 05:00:00 AM,48,-122,2,0,2
3102,58thStGreenway22ndAve,05/10/2014 06:00:00 AM,48,-122,0,0,0
3103,58thStGreenway22ndAve,05/10/2014 07:00:00 AM,48,-122,10,0,10
3104,58thStGreenway22ndAve,05/10/2014 08:00:00 AM,48,-122,14,1,15
3105,58thStGreenway22ndAve,05/10/2014 09:00:00 AM,48,-122,28,10,38
3106,58thStGreenway22ndAve,05/10/2014 10:00:00 AM,48,-122,26,15,41
3107,58thStGreenway22ndAve,05/10/2014 11:00:00 AM,48,-122,34,19,53
3108,58thStGreenway22ndAve,05/10/2014 12:00:00 PM,48,-122,38,13,51
3109,58thStGreenway22ndAve,05/10/2014 01:00:00 PM,48,-122,42,12,54
3110,58thStGreenway22ndAve,05/10/2014 02:00:00 PM,48,-122,27,14,41
3111,58thStGreenway22ndAve,05/10/2014 03:00:00 PM,48,-122,34,8,42
3112,58thStGreenway22ndAve,05/10/2014 04:00:00 PM,48,-122,26,17,43
3113,58thStGreenway22ndAve,05/10/2014 05:00:00 PM,48,-122,30,8,38
3114,58thStGreenway22ndAve,05/10/2014 06:00:00 PM,48,-122,11,11,22
3115,58thStGreenway22ndAve,05/10/2014 07:00:00 PM,48,-122,19,6,25
3116,58thStGreenway22ndAve,05/10/2014 08:00:00 PM,48,-122,9,9,18
3117,58thStGreenway22ndAve,05/10/2014 09:00:00 PM,48,-122,5,0,5
3118,58thStGreenway22ndAve,05/10/2014 10:00:00 PM,48,-122,9,1,10
3119,58thStGreenway22ndAve,05/10/2014 11:00:00 PM,48,-122,2,0,2
3120,58thStGreenway22ndAve,05/11/2014 12:00:00 AM,48,-122,3,1,4
3121,58thStGreenway22ndAve,05/11/2014 01:00:00 AM,48,-122,4,2,6
3122,58thStGreenway22ndAve,05/11/2014 02:00:00 AM,48,-122,2,0,2
3123,58thStGreenway22ndAve,05/11/2014 03:00:00 AM,48,-122,2,0,2
3124,58thStGreenway22ndAve,05/11/2014 04:00:00 AM,48,-122,0,0,0
3125,58thStGreenway22ndAve,05/11/2014 05:00:00 AM,48,-122,0,1,1
3126,58thStGreenway22ndAve,05/11/2014 06:00:00 AM,48,-122,2,0,2
3127,58thStGreenway22ndAve,05/11/2014 07:00:00 AM,48,-122,0,2,2
3128,58thStGreenway22ndAve,05/11/2014 08:00:00 AM,48,-122,1,0,1
3129,58thStGreenway22ndAve,05/11/2014 09:00:00 AM,48,-122,5,10,15
3130,58thStGreenway22ndAve,05/11/2014 10:00:00 AM,48,-122,30,15,45
3131,58thStGreenway22ndAve,05/11/2014 11:00:00 AM,48,-122,28,16,44
3132,58thStGreenway22ndAve,05/11/2014 12:00:00 PM,48,-122,22,27,49
3133,58thStGreenway22ndAve,05/11/2014 01:00:00 PM,48,-122,21,24,45
3134,58thStGreenway22ndAve,05/11/2014 02:00:00 PM,48,-122,41,29,70
3135,58thStGreenway22ndAve,05/11/2014 03:00:00 PM,48,-122,39,16,55
3136,58thStGreenway22ndAve,05/11/2014 04:00:00 PM,48,-122,19,9,28
3137,58thStGreenway22ndAve,05/11/2014 05:00:00 PM,48,-122,20,18,38
3138,58thStGreenway22ndAve,05/11/2014 06:00:00 PM,48,-122,14,7,21
3139,58thStGreenway22ndAve,05/11/2014 07:00:00 PM,48,-122,10,8,18
3140,58thStGreenway22ndAve,05/11/2014 08:00:00 PM,48,-122,12,3,15
3141,58thStGreenway22ndAve,05/11/2014 09:00:00 PM,48,-122,6,4,10
3142,58thStGreenway22ndAve,05/11/2014 10:00:00 PM,48,-122,10,2,12
3143,58thStGreenway22ndAve,05/11/2014 11:00:00 PM,48,-122,5,0,5
3144,58thStGreenway22ndAve,05/12/2014 12:00:00 AM,48,-122,2,2,4
3145,58thStGreenway22ndAve,05/12/2014 01:00:00 AM,48,-122,2,0,2
3146,58thStGreenway22ndAve,05/12/2014 02:00:00 AM,48,-122,0,0,0
3147,58thStGreenway22ndAve,05/12/2014 03:00:00 AM,48,-122,0,0,0
3148,58thStGreenway22ndAve,05/12/2014 04:00:00 AM,48,-122,4,0,4
3149,58thStGreenway22ndAve,05/12/2014 05:00:00 AM,48,-122,5,2,7
3150,58thStGreenway22ndAve,05/12/2014 06:00:00 AM,48,-122,5,4,9
3151,58thStGreenway22ndAve,05/12/2014 07:00:00 AM,48,-122,8,1,9
3152,58thStGreenway22ndAve,05/12/2014 08:00:00 AM,48,-122,16,13,29
3153,58thStGreenway22ndAve,05/12/2014 09:00:00 AM,48,-122,16,7,23
3154,58thStGreenway22ndAve,05/12/2014 10:00:00 AM,48,-122,18,9,27
3155,58thStGreenway22ndAve,05/12/2014 11:00:00 AM,48,-122,16,8,24
3156,58thStGreenway22ndAve,05/12/2014 12:00:00 PM,48,-122,17,11,28
3157,58thStGreenway22ndAve,05/12/2014 01:00:00 PM,48,-122,23,20,43
3158,58thStGreenway22ndAve,05/12/2014 02:00:00 PM,48,-122,14,12,26
3159,58thStGreenway22ndAve,05/12/2014 03:00:00 PM,48,-122,25,13,38
3160,58thStGreenway22ndAve,05/12/2014 04:00:00 PM,48,-122,19,19,38
3161,58thStGreenway22ndAve,05/12/2014 05:00:00 PM,48,-122,32,17,49
3162,58thStGreenway22ndAve,05/12/2014 06:00:00 PM,48,-122,30,16,46
3163,58thStGreenway22ndAve,05/12/2014 07:00:00 PM,48,-122,15,6,21
3164,58thStGreenway22ndAve,05/12/2014 08:00:00 PM,48,-122,17,7,24
3165,58thStGreenway22ndAve,05/12/2014 09:00:00 PM,48,-122,13,3,16
3166,58thStGreenway22ndAve,05/12/2014 10:00:00 PM,48,-122,6,2,8
3167,58thStGreenway22ndAve,05/12/2014 11:00:00 PM,48,-122,3,1,4
3168,58thStGreenway22ndAve,05/13/2014 12:00:00 AM,48,-122,6,0,6
3169,58thStGreenway22ndAve,05/13/2014 01:00:00 AM,48,-122,2,0,2
3170,58thStGreenway22ndAve,05/13/2014 02:00:00 AM,48,-122,0,0,0
3171,58thStGreenway22ndAve,05/13/2014 03:00:00 AM,48,-122,0,0,0
3172,58thStGreenway22ndAve,05/13/2014 04:00:00 AM,48,-122,0,0,0
3173,58thStGreenway22ndAve,05/13/2014 05:00:00 AM,48,-122,4,0,4
3174,58thStGreenway22ndAve,05/13/2014 06:00:00 AM,48,-122,2,8,10
3175,58thStGreenway22ndAve,05/13/2014 07:00:00 AM,48,-122,13,9,22
3176,58thStGreenway22ndAve,05/13/2014 08:00:00 AM,48,-122,15,4,19
3177,58thStGreenway22ndAve,05/13/2014 09:00:00 AM,48,-122,21,8,29
3178,58thStGreenway22ndAve,05/13/2014 10:00:00 AM,48,-122,15,12,27
3179,58thStGreenway22ndAve,05/13/2014 11:00:00 AM,48,-122,10,10,20
3180,58thStGreenway22ndAve,05/13/2014 12:00:00 PM,48,-122,19,16,35
3181,58thStGreenway22ndAve,05/13/2014 01:00:00 PM,48,-122,18,6,24
3182,58thStGreenway22ndAve,05/13/2014 02:00:00 PM,48,-122,21,10,31
3183,58thStGreenway22ndAve,05/13/2014 03:00:00 PM,48,-122,19,9,28
3184,58thStGreenway22ndAve,05/13/2014 04:00:00 PM,48,-122,35,13,48
3185,58thStGreenway22ndAve,05/13/2014 05:00:00 PM,48,-122,40,22,62
3186,58thStGreenway22ndAve,05/13/2014 06:00:00 PM,48,-122,34,30,64
3187,58thStGreenway22ndAve,05/13/2014 07:00:00 PM,48,-122,28,16,44
3188,58thStGreenway22ndAve,05/13/2014 08:00:00 PM,48,-122,25,11,36
3189,58thStGreenway22ndAve,05/13/2014 09:00:00 PM,48,-122,14,2,16
3190,58thStGreenway22ndAve,05/13/2014 10:00:00 PM,48,-122,6,1,7
3191,58thStGreenway22ndAve,05/13/2014 11:00:00 PM,48,-122,4,0,4
3192,58thStGreenway22ndAve,05/14/2014 12:00:00 AM,48,-122,2,0,2
3193,58thStGreenway22ndAve,05/14/2014 01:00:00 AM,48,-122,0,2,2
3194,58thStGreenway22ndAve,05/14/2014 02:00:00 AM,48,-122,0,0,0
3195,58thStGreenway22ndAve,05/14/2014 03:00:00 AM,48,-122,0,0,0
3196,58thStGreenway22ndAve,05/14/2014 04:00:00 AM,48,-122,2,0,2
3197,58thStGreenway22ndAve,05/14/2014 05:00:00 AM,48,-122,3,0,3
3198,58thStGreenway22ndAve,05/14/2014 06:00:00 AM,48,-122,10,4,14
3199,58thStGreenway22ndAve,05/14/2014 07:00:00 AM,48,-122,20,6,26
3200,58thStGreenway22ndAve,05/14/2014 08:00:00 AM,48,-122,17,12,29
3201,58thStGreenway22ndAve,05/14/2014 09:00:00 AM,48,-122,10,9,19
3202,58thStGreenway22ndAve,05/14/2014 10:00:00 AM,48,-122,22,9,31
3203,58thStGreenway22ndAve,05/14/2014 11:00:00 AM,48,-122,17,21,38
3204,58thStGreenway22ndAve,05/14/2014 12:00:00 PM,48,-122,15,9,24
3205,58thStGreenway22ndAve,05/14/2014 01:00:00 PM,48,-122,21,6,27
3206,58thStGreenway22ndAve,05/14/2014 02:00:00 PM,48,-122,14,12,26
3207,58thStGreenway22ndAve,05/14/2014 03:00:00 PM,48,-122,18,13,31
3208,58thStGreenway22ndAve,05/14/2014 04:00:00 PM,48,-122,22,20,42
3209,58thStGreenway22ndAve,05/14/2014 05:00:00 PM,48,-122,21,25,46
3210,58thStGreenway22ndAve,05/14/2014 06:00:00 PM,48,-122,35,25,60
3211,58thStGreenway22ndAve,05/14/2014 07:00:00 PM,48,-122,40,8,48
3212,58thStGreenway22ndAve,05/14/2014 08:00:00 PM,48,-122,19,3,22
3213,58thStGreenway22ndAve,05/14/2014 09:00:00 PM,48,-122,15,3,18
3214,58thStGreenway22ndAve,05/14/2014 10:00:00 PM,48,-122,21,0,21
3215,58thStGreenway22ndAve,05/14/2014 11:00:00 PM,48,-122,7,3,10
3216,58thStGreenway22ndAve,05/15/2014 12:00:00 AM,48,-122,0,1,1
3217,58thStGreenway22ndAve,05/15/2014 01:00:00 AM,48,-122,3,0,3
3218,58thStGreenway22ndAve,05/15/2014 02:00:00 AM,48,-122,3,0,3
3219,58thStGreenway22ndAve,05/15/2014 03:00:00 AM,48,-122,0,0,0
3220,58thStGreenway22ndAve,05/15/2014 04:00:00 AM,48,-122,0,0,0
3221,58thStGreenway22ndAve,05/15/2014 05:00:00 AM,48,-122,2,1,3
3222,58thStGreenway22ndAve,05/15/2014 06:00:00 AM,48,-122,7,0,7
3223,58thStGreenway22ndAve,05/15/2014 07:00:00 AM,48,-122,20,12,32
3224,58thStGreenway22ndAve,05/15/2014 08:00:00 AM,48,-122,39,3,42
3225,58thStGreenway22ndAve,05/15/2014 09:00:00 AM,48,-122,20,7,27
3226,58thStGreenway22ndAve,05/15/2014 10:00:00 AM,48,-122,19,10,29
3227,58thStGreenway22ndAve,05/15/2014 11:00:00 AM,48,-122,23,19,42
3228,58thStGreenway22ndAve,05/15/2014 12:00:00 PM,48,-122,17,15,32
3229,58thStGreenway22ndAve,05/15/2014 01:00:00 PM,48,-122,19,11,30
3230,58thStGreenway22ndAve,05/15/2014 02:00:00 PM,48,-122,29,7,36
3231,58thStGreenway22ndAve,05/15/2014 03:00:00 PM,48,-122,24,11,35
3232,58thStGreenway22ndAve,05/15/2014 04:00:00 PM,48,-122,37,20,57
3233,58thStGreenway22ndAve,05/15/2014 05:00:00 PM,48,-122,22,14,36
3234,58thStGreenway22ndAve,05/15/2014 06:00:00 PM,48,-122,31,22,53
3235,58thStGreenway22ndAve,05/15/2014 07:00:00 PM,48,-122,15,14,29
3236,58thStGreenway22ndAve,05/15/2014 08:00:00 PM,48,-122,16,5,21
3237,58thStGreenway22ndAve,05/15/2014 09:00:00 PM,48,-122,18,6,24
3238,58thStGreenway22ndAve,05/15/2014 10:00:00 PM,48,-122,10,0,10
3239,58thStGreenway22ndAve,05/15/2014 11:00:00 PM,48,-122,9,1,10
3240,58thStGreenway22ndAve,05/16/2014 12:00:00 AM,48,-122,1,5,6
3241,58thStGreenway22ndAve,05/16/2014 01:00:00 AM,48,-122,0,0,0
3242,58thStGreenway22ndAve,05/16/2014 02:00:00 AM,48,-122,1,5,6
3243,58thStGreenway22ndAve,05/16/2014 03:00:00 AM,48,-122,0,0,0
3244,58thStGreenway22ndAve,05/16/2014 04:00:00 AM,48,-122,0,0,0
3245,58thStGreenway22ndAve,05/16/2014 05:00:00 AM,48,-122,6,3,9
3246,58thStGreenway22ndAve,05/16/2014 06:00:00 AM,48,-122,9,5,14
3247,58thStGreenway22ndAve,05/16/2014 07:00:00 AM,48,-122,24,6,30
3248,58thStGreenway22ndAve,05/16/2014 08:00:00 AM,48,-122,37,11,48
3249,58thStGreenway22ndAve,05/16/2014 09:00:00 AM,48,-122,18,11,29
3250,58thStGreenway22ndAve,05/16/2014 10:00:00 AM,48,-122,13,8,21
3251,58thStGreenway22ndAve,05/16/2014 11:00:00 AM,48,-122,21,16,37
3252,58thStGreenway22ndAve,05/16/2014 12:00:00 PM,48,-122,38,11,49
3253,58thStGreenway22ndAve,05/16/2014 01:00:00 PM,48,-122,19,17,36
3254,58thStGreenway22ndAve,05/16/2014 02:00:00 PM,48,-122,15,4,19
3255,58thStGreenway22ndAve,05/16/2014 03:00:00 PM,48,-122,23,18,41
3256,58thStGreenway22ndAve,05/16/2014 04:00:00 PM,48,-122,21,9,30
3257,58thStGreenway22ndAve,05/16/2014 05:00:00 PM,48,-122,26,31,57
3258,58thStGreenway22ndAve,05/16/2014 06:00:00 PM,48,-122,21,11,32
3259,58thStGreenway22ndAve,05/16/2014 07:00:00 PM,48,-122,27,22,49
3260,58thStGreenway22ndAve,05/16/2014 08:00:00 PM,48,-122,11,17,28
3261,58thStGreenway22ndAve,05/16/2014 09:00:00 PM,48,-122,6,8,14
3262,58thStGreenway22ndAve,05/16/2014 10:00:00 PM,48,-122,5,10,15
3263,58thStGreenway22ndAve,05/16/2014 11:00:00 PM,48,-122,8,0,8
3264,58thStGreenway22ndAve,05/17/2014 12:00:00 AM,48,-122,3,0,3
3265,58thStGreenway22ndAve,05/17/2014 01:00:00 AM,48,-122,6,2,8
3266,58thStGreenway22ndAve,05/17/2014 02:00:00 AM,48,-122,0,0,0
3267,58thStGreenway22ndAve,05/17/2014 03:00:00 AM,48,-122,6,4,10
3268,58thStGreenway22ndAve,05/17/2014 04:00:00 AM,48,-122,0,3,3
3269,58thStGreenway22ndAve,05/17/2014 05:00:00 AM,48,-122,4,0,4
3270,58thStGreenway22ndAve,05/17/2014 06:00:00 AM,48,-122,2,0,2
3271,58thStGreenway22ndAve,05/17/2014 07:00:00 AM,48,-122,6,5,11
3272,58thStGreenway22ndAve,05/17/2014 08:00:00 AM,48,-122,12,6,18
3273,58thStGreenway22ndAve,05/17/2014 09:00:00 AM,48,-122,15,12,27
3274,58thStGreenway22ndAve,05/17/2014 10:00:00 AM,48,-122,16,23,39
3275,58thStGreenway22ndAve,05/17/2014 11:00:00 AM,48,-122,43,17,60
3276,58thStGreenway22ndAve,05/17/2014 12:00:00 PM,48,-122,34,14,48
3277,58thStGreenway22ndAve,05/17/2014 01:00:00 PM,48,-122,40,28,68
3278,58thStGreenway22ndAve,05/17/2014 02:00:00 PM,48,-122,31,53,84
3279,58thStGreenway22ndAve,05/17/2014 03:00:00 PM,48,-122,55,36,91
3280,58thStGreenway22ndAve,05/17/2014 04:00:00 PM,48,-122,50,23,73
3281,58thStGreenway22ndAve,05/17/2014 05:00:00 PM,48,-122,53,48,101
3282,58thStGreenway22ndAve,05/17/2014 06:00:00 PM,48,-122,57,43,100
3283,58thStGreenway22ndAve,05/17/2014 07:00:00 PM,48,-122,45,39,84
3284,58thStGreenway22ndAve,05/17/2014 08:00:00 PM,48,-122,23,3,26
3285,58thStGreenway22ndAve,05/17/2014 09:00:00 PM,48,-122,27,1,28
3286,58thStGreenway22ndAve,05/17/2014 10:00:00 PM,48,-122,7,2,9
3287,58thStGreenway22ndAve,05/17/2014 11:00:00 PM,48,-122,8,11,19
3288,58thStGreenway22ndAve,05/18/2014 12:00:00 AM,48,-122,1,0,1
3289,58thStGreenway22ndAve,05/18/2014 01:00:00 AM,48,-122,3,1,4
3290,58thStGreenway22ndAve,05/18/2014 02:00:00 AM,48,-122,2,0,2
3291,58thStGreenway22ndAve,05/18/2014 03:00:00 AM,48,-122,0,0,0
3292,58thStGreenway22ndAve,05/18/2014 04:00:00 AM,48,-122,0,0,0
3293,58thStGreenway22ndAve,05/18/2014 05:00:00 AM,48,-122,2,0,2
3294,58thStGreenway22ndAve,05/18/2014 06:00:00 AM,48,-122,1,0,1
3295,58thStGreenway22ndAve,05/18/2014 07:00:00 AM,48,-122,2,2,4
3296,58thStGreenway22ndAve,05/18/2014 08:00:00 AM,48,-122,9,3,12
3297,58thStGreenway22ndAve,05/18/2014 09:00:00 AM,48,-122,17,1,18
3298,58thStGreenway22ndAve,05/18/2014 10:00:00 AM,48,-122,19,15,34
3299,58thStGreenway22ndAve,05/18/2014 11:00:00 AM,48,-122,36,15,51
3300,58thStGreenway22ndAve,05/18/2014 12:00:00 PM,48,-122,34,16,50
3301,58thStGreenway22ndAve,05/18/2014 01:00:00 PM,48,-122,46,19,65
3302,58thStGreenway22ndAve,05/18/2014 02:00:00 PM,48,-122,42,18,60
3303,58thStGreenway22ndAve,05/18/2014 03:00:00 PM,48,-122,30,6,36
3304,58thStGreenway22ndAve,05/18/2014 04:00:00 PM,48,-122,34,17,51
3305,58thStGreenway22ndAve,05/18/2014 05:00:00 PM,48,-122,31,7,38
3306,58thStGreenway22ndAve,05/18/2014 06:00:00 PM,48,-122,34,7,41
3307,58thStGreenway22ndAve,05/18/2014 07:00:00 PM,48,-122,8,6,14
3308,58thStGreenway22ndAve,05/18/2014 08:00:00 PM,48,-122,17,2,19
3309,58thStGreenway22ndAve,05/18/2014 09:00:00 PM,48,-122,9,3,12
3310,58thStGreenway22ndAve,05/18/2014 10:00:00 PM,48,-122,2,0,2
3311,58thStGreenway22ndAve,05/18/2014 11:00:00 PM,48,-122,2,0,2
3312,58thStGreenway22ndAve,05/19/2014 12:00:00 AM,48,-122,2,0,2
3313,58thStGreenway22ndAve,05/19/2014 01:00:00 AM,48,-122,0,0,0
3314,58thStGreenway22ndAve,05/19/2014 02:00:00 AM,48,-122,0,1,1
3315,58thStGreenway22ndAve,05/19/2014 03:00:00 AM,48,-122,0,0,0
3316,58thStGreenway22ndAve,05/19/2014 04:00:00 AM,48,-122,3,1,4
3317,58thStGreenway22ndAve,05/19/2014 05:00:00 AM,48,-122,2,0,2
3318,58thStGreenway22ndAve,05/19/2014 06:00:00 AM,48,-122,7,2,9
3319,58thStGreenway22ndAve,05/19/2014 07:00:00 AM,48,-122,17,5,22
3320,58thStGreenway22ndAve,05/19/2014 08:00:00 AM,48,-122,23,10,33
3321,58thStGreenway22ndAve,05/19/2014 09:00:00 AM,48,-122,30,9,39
3322,58thStGreenway22ndAve,05/19/2014 10:00:00 AM,48,-122,34,8,42
3323,58thStGreenway22ndAve,05/19/2014 11:00:00 AM,48,-122,28,8,36
3324,58thStGreenway22ndAve,05/19/2014 12:00:00 PM,48,-122,33,21,54
3325,58thStGreenway22ndAve,05/19/2014 01:00:00 PM,48,-122,18,8,26
3326,58thStGreenway22ndAve,05/19/2014 02:00:00 PM,48,-122,14,8,22
3327,58thStGreenway22ndAve,05/19/2014 03:00:00 PM,48,-122,27,11,38
3328,58thStGreenway22ndAve,05/19/2014 04:00:00 PM,48,-122,28,15,43
3329,58thStGreenway22ndAve,05/19/2014 05:00:00 PM,48,-122,37,26,63
3330,58thStGreenway22ndAve,05/19/2014 06:00:00 PM,48,-122,28,27,55
3331,58thStGreenway22ndAve,05/19/2014 07:00:00 PM,48,-122,25,13,38
3332,58thStGreenway22ndAve,05/19/2014 08:00:00 PM,48,-122,11,10,21
3333,58thStGreenway22ndAve,05/19/2014 09:00:00 PM,48,-122,19,7,26
3334,58thStGreenway22ndAve,05/19/2014 10:00:00 PM,48,-122,7,1,8
3335,58thStGreenway22ndAve,05/19/2014 11:00:00 PM,48,-122,6,0,6
3336,58thStGreenway22ndAve,05/20/2014 12:00:00 AM,48,-122,0,0,0
3337,58thStGreenway22ndAve,05/20/2014 01:00:00 AM,48,-122,2,0,2
3338,58thStGreenway22ndAve,05/20/2014 02:00:00 AM,48,-122,2,0,2
3339,58thStGreenway22ndAve,05/20/2014 03:00:00 AM,48,-122,0,0,0
3340,58thStGreenway22ndAve,05/20/2014 04:00:00 AM,48,-122,0,0,0
3341,58thStGreenway22ndAve,05/20/2014 05:00:00 AM,48,-122,2,0,2
3342,58thStGreenway22ndAve,05/20/2014 06:00:00 AM,48,-122,3,2,5
3343,58thStGreenway22ndAve,05/20/2014 07:00:00 AM,48,-122,25,5,30
3344,58thStGreenway22ndAve,05/20/2014 08:00:00 AM,48,-122,22,6,28
3345,58thStGreenway22ndAve,05/20/2014 09:00:00 AM,48,-122,24,13,37
3346,58thStGreenway22ndAve,05/20/2014 10:00:00 AM,48,-122,17,14,31
3347,58thStGreenway22ndAve,05/20/2014 11:00:00 AM,48,-122,15,12,27
3348,58thStGreenway22ndAve,05/20/2014 12:00:00 PM,48,-122,20,26,46
3349,58thStGreenway22ndAve,05/20/2014 01:00:00 PM,48,-122,18,18,36
3350,58thStGreenway22ndAve,05/20/2014 02:00:00 PM,48,-122,13,14,27
3351,58thStGreenway22ndAve,05/20/2014 03:00:00 PM,48,-122,12,19,31
3352,58thStGreenway22ndAve,05/20/2014 04:00:00 PM,48,-122,30,22,52
3353,58thStGreenway22ndAve,05/20/2014 05:00:00 PM,48,-122,14,26,40
3354,58thStGreenway22ndAve,05/20/2014 06:00:00 PM,48,-122,16,32,48
3355,58thStGreenway22ndAve,05/20/2014 07:00:00 PM,48,-122,20,12,32
3356,58thStGreenway22ndAve,05/20/2014 08:00:00 PM,48,-122,12,4,16
3357,58thStGreenway22ndAve,05/20/2014 09:00:00 PM,48,-122,10,2,12
3358,58thStGreenway22ndAve,05/20/2014 10:00:00 PM,48,-122,8,1,9
3359,58thStGreenway22ndAve,05/20/2014 11:00:00 PM,48,-122,7,0,7
3360,58thStGreenway22ndAve,05/21/2014 12:00:00 AM,48,-122,2,1,3
3361,58thStGreenway22ndAve,05/21/2014 01:00:00 AM,48,-122,0,3,3
3362,58thStGreenway22ndAve,05/21/2014 02:00:00 AM,48,-122,0,2,2
3363,58thStGreenway22ndAve,05/21/2014 03:00:00 AM,48,-122,0,0,0
3364,58thStGreenway22ndAve,05/21/2014 04:00:00 AM,48,-122,2,0,2
3365,58thStGreenway22ndAve,05/21/2014 05:00:00 AM,48,-122,2,1,3
3366,58thStGreenway22ndAve,05/21/2014 06:00:00 AM,48,-122,1,2,3
3367,58thStGreenway22ndAve,05/21/2014 07:00:00 AM,48,-122,11,19,30
3368,58thStGreenway22ndAve,05/21/2014 08:00:00 AM,48,-122,13,8,21
3369,58thStGreenway22ndAve,05/21/2014 09:00:00 AM,48,-122,23,6,29
3370,58thStGreenway22ndAve,05/21/2014 10:00:00 AM,48,-122,18,5,23
3371,58thStGreenway22ndAve,05/21/2014 11:00:00 AM,48,-122,4,8,12
3372,58thStGreenway22ndAve,05/21/2014 12:00:00 PM,48,-122,32,14,46
3373,58thStGreenway22ndAve,05/21/2014 01:00:00 PM,48,-122,20,4,24
3374,58thStGreenway22ndAve,05/21/2014 02:00:00 PM,48,-122,17,11,28
3375,58thStGreenway22ndAve,05/21/2014 03:00:00 PM,48,-122,20,13,33
3376,58thStGreenway22ndAve,05/21/2014 04:00:00 PM,48,-122,19,11,30
3377,58thStGreenway22ndAve,05/21/2014 05:00:00 PM,48,-122,30,16,46
3378,58thStGreenway22ndAve,05/21/2014 06:00:00 PM,48,-122,33,26,59
3379,58thStGreenway22ndAve,05/21/2014 07:00:00 PM,48,-122,18,12,30
3380,58thStGreenway22ndAve,05/21/2014 08:00:00 PM,48,-122,16,10,26
3381,58thStGreenway22ndAve,05/21/2014 09:00:00 PM,48,-122,9,4,13
3382,58thStGreenway22ndAve,05/21/2014 10:00:00 PM,48,-122,14,2,16
3383,58thStGreenway22ndAve,05/21/2014 11:00:00 PM,48,-122,9,0,9
3384,58thStGreenway22ndAve,05/22/2014 12:00:00 AM,48,-122,1,1,2
3385,58thStGreenway22ndAve,05/22/2014 01:00:00 AM,48,-122,1,2,3
3386,58thStGreenway22ndAve,05/22/2014 02:00:00 AM,48,-122,0,0,0
3387,58thStGreenway22ndAve,05/22/2014 03:00:00 AM,48,-122,2,0,2
3388,58thStGreenway22ndAve,05/22/2014 04:00:00 AM,48,-122,0,1,1
3389,58thStGreenway22ndAve,05/22/2014 05:00:00 AM,48,-122,0,1,1
3390,58thStGreenway22ndAve,05/22/2014 06:00:00 AM,48,-122,5,1,6
3391,58thStGreenway22ndAve,05/22/2014 07:00:00 AM,48,-122,20,5,25
3392,58thStGreenway22ndAve,05/22/2014 08:00:00 AM,48,-122,22,22,44
3393,58thStGreenway22ndAve,05/22/2014 09:00:00 AM,48,-122,16,11,27
3394,58thStGreenway22ndAve,05/22/2014 10:00:00 AM,48,-122,27,10,37
3395,58thStGreenway22ndAve,05/22/2014 11:00:00 AM,48,-122,36,4,40
3396,58thStGreenway22ndAve,05/22/2014 12:00:00 PM,48,-122,30,8,38
3397,58thStGreenway22ndAve,05/22/2014 01:00:00 PM,48,-122,33,12,45
3398,58thStGreenway22ndAve,05/22/2014 02:00:00 PM,48,-122,34,8,42
3399,58thStGreenway22ndAve,05/22/2014 03:00:00 PM,48,-122,18,8,26
3400,58thStGreenway22ndAve,05/22/2014 04:00:00 PM,48,-122,22,15,37
3401,58thStGreenway22ndAve,05/22/2014 05:00:00 PM,48,-122,30,11,41
3402,58thStGreenway22ndAve,05/22/2014 06:00:00 PM,48,-122,22,16,38
3403,58thStGreenway22ndAve,05/22/2014 07:00:00 PM,48,-122,15,12,27
3404,58thStGreenway22ndAve,05/22/2014 08:00:00 PM,48,-122,13,10,23
3405,58thStGreenway22ndAve,05/22/2014 09:00:00 PM,48,-122,13,8,21
3406,58thStGreenway22ndAve,05/22/2014 10:00:00 PM,48,-122,6,8,14
3407,58thStGreenway22ndAve,05/22/2014 11:00:00 PM,48,-122,12,3,15
3408,58thStGreenway22ndAve,05/23/2014 12:00:00 AM,48,-122,7,1,8
3409,58thStGreenway22ndAve,05/23/2014 01:00:00 AM,48,-122,2,0,2
3410,58thStGreenway22ndAve,05/23/2014 02:00:00 AM,48,-122,0,0,0
3411,58thStGreenway22ndAve,05/23/2014 03:00:00 AM,48,-122,2,0,2
3412,58thStGreenway22ndAve,05/23/2014 04:00:00 AM,48,-122,2,3,5
3413,58thStGreenway22ndAve,05/23/2014 05:00:00 AM,48,-122,6,1,7
3414,58thStGreenway22ndAve,05/23/2014 06:00:00 AM,48,-122,7,3,10
3415,58thStGreenway22ndAve,05/23/2014 07:00:00 AM,48,-122,18,4,22
3416,58thStGreenway22ndAve,05/23/2014 08:00:00 AM,48,-122,29,8,37
3417,58thStGreenway22ndAve,05/23/2014 09:00:00 AM,48,-122,21,11,32
3418,58thStGreenway22ndAve,05/23/2014 10:00:00 AM,48,-122,12,7,19
3419,58thStGreenway22ndAve,05/23/2014 11:00:00 AM,48,-122,17,12,29
3420,58thStGreenway22ndAve,05/23/2014 12:00:00 PM,48,-122,25,9,34
3421,58thStGreenway22ndAve,05/23/2014 01:00:00 PM,48,-122,29,13,42
3422,58thStGreenway22ndAve,05/23/2014 02:00:00 PM,48,-122,31,9,40
3423,58thStGreenway22ndAve,05/23/2014 03:00:00 PM,48,-122,13,11,24
3424,58thStGreenway22ndAve,05/23/2014 04:00:00 PM,48,-122,23,14,37
3425,58thStGreenway22ndAve,05/23/2014 05:00:00 PM,48,-122,23,5,28
3426,58thStGreenway22ndAve,05/23/2014 06:00:00 PM,48,-122,35,12,47
3427,58thStGreenway22ndAve,05/23/2014 07:00:00 PM,48,-122,18,10,28
3428,58thStGreenway22ndAve,05/23/2014 08:00:00 PM,48,-122,8,5,13
3429,58thStGreenway22ndAve,05/23/2014 09:00:00 PM,48,-122,14,6,20
3430,58thStGreenway22ndAve,05/23/2014 10:00:00 PM,48,-122,5,0,5
3431,58thStGreenway22ndAve,05/23/2014 11:00:00 PM,48,-122,5,2,7
3432,58thStGreenway22ndAve,05/24/2014 12:00:00 AM,48,-122,1,1,2
3433,58thStGreenway22ndAve,05/24/2014 01:00:00 AM,48,-122,2,2,4
3434,58thStGreenway22ndAve,05/24/2014 02:00:00 AM,48,-122,4,0,4
3435,58thStGreenway22ndAve,05/24/2014 03:00:00 AM,48,-122,0,0,0
3436,58thStGreenway22ndAve,05/24/2014 04:00:00 AM,48,-122,0,0,0
3437,58thStGreenway22ndAve,05/24/2014 05:00:00 AM,48,-122,1,1,2
3438,58thStGreenway22ndAve,05/24/2014 06:00:00 AM,48,-122,0,0,0
3439,58thStGreenway22ndAve,05/24/2014 07:00:00 AM,48,-122,7,2,9
3440,58thStGreenway22ndAve,05/24/2014 08:00:00 AM,48,-122,11,5,16
3441,58thStGreenway22ndAve,05/24/2014 09:00:00 AM,48,-122,20,6,26
3442,58thStGreenway22ndAve,05/24/2014 10:00:00 AM,48,-122,15,6,21
3443,58thStGreenway22ndAve,05/24/2014 11:00:00 AM,48,-122,13,28,41
3444,58thStGreenway22ndAve,05/24/2014 12:00:00 PM,48,-122,33,23,56
3445,58thStGreenway22ndAve,05/24/2014 01:00:00 PM,48,-122,36,23,59
3446,58thStGreenway22ndAve,05/24/2014 02:00:00 PM,48,-122,29,14,43
3447,58thStGreenway22ndAve,05/24/2014 03:00:00 PM,48,-122,22,13,35
3448,58thStGreenway22ndAve,05/24/2014 04:00:00 PM,48,-122,20,20,40
3449,58thStGreenway22ndAve,05/24/2014 05:00:00 PM,48,-122,16,7,23
3450,58thStGreenway22ndAve,05/24/2014 06:00:00 PM,48,-122,15,14,29
3451,58thStGreenway22ndAve,05/24/2014 07:00:00 PM,48,-122,26,6,32
3452,58thStGreenway22ndAve,05/24/2014 08:00:00 PM,48,-122,7,1,8
3453,58thStGreenway22ndAve,05/24/2014 09:00:00 PM,48,-122,18,5,23
3454,58thStGreenway22ndAve,05/24/2014 10:00:00 PM,48,-122,10,1,11
3455,58thStGreenway22ndAve,05/24/2014 11:00:00 PM,48,-122,5,1,6
3456,58thStGreenway22ndAve,05/25/2014 12:00:00 AM,48,-122,2,0,2
3457,58thStGreenway22ndAve,05/25/2014 01:00:00 AM,48,-122,2,0,2
3458,58thStGreenway22ndAve,05/25/2014 02:00:00 AM,48,-122,0,0,0
3459,58thStGreenway22ndAve,05/25/2014 03:00:00 AM,48,-122,2,0,2
3460,58thStGreenway22ndAve,05/25/2014 04:00:00 AM,48,-122,0,0,0
3461,58thStGreenway22ndAve,05/25/2014 05:00:00 AM,48,-122,0,0,0
3462,58thStGreenway22ndAve,05/25/2014 06:00:00 AM,48,-122,2,0,2
3463,58thStGreenway22ndAve,05/25/2014 07:00:00 AM,48,-122,7,1,8
3464,58thStGreenway22ndAve,05/25/2014 08:00:00 AM,48,-122,3,5,8
3465,58thStGreenway22ndAve,05/25/2014 09:00:00 AM,48,-122,15,4,19
3466,58thStGreenway22ndAve,05/25/2014 10:00:00 AM,48,-122,9,10,19
3467,58thStGreenway22ndAve,05/25/2014 11:00:00 AM,48,-122,25,15,40
3468,58thStGreenway22ndAve,05/25/2014 12:00:00 PM,48,-122,42,9,51
3469,58thStGreenway22ndAve,05/25/2014 01:00:00 PM,48,-122,30,18,48
3470,58thStGreenway22ndAve,05/25/2014 02:00:00 PM,48,-122,24,14,38
3471,58thStGreenway22ndAve,05/25/2014 03:00:00 PM,48,-122,10,4,14
3472,58thStGreenway22ndAve,05/25/2014 04:00:00 PM,48,-122,24,16,40
3473,58thStGreenway22ndAve,05/25/2014 05:00:00 PM,48,-122,10,10,20
3474,58thStGreenway22ndAve,05/25/2014 06:00:00 PM,48,-122,13,1,14
3475,58thStGreenway22ndAve,05/25/2014 07:00:00 PM,48,-122,10,3,13
3476,58thStGreenway22ndAve,05/25/2014 08:00:00 PM,48,-122,10,4,14
3477,58thStGreenway22ndAve,05/25/2014 09:00:00 PM,48,-122,7,3,10
3478,58thStGreenway22ndAve,05/25/2014 10:00:00 PM,48,-122,4,0,4
3479,58thStGreenway22ndAve,05/25/2014 11:00:00 PM,48,-122,4,0,4
3480,58thStGreenway22ndAve,05/26/2014 12:00:00 AM,48,-122,0,0,0
3481,58thStGreenway22ndAve,05/26/2014 01:00:00 AM,48,-122,6,1,7
3482,58thStGreenway22ndAve,05/26/2014 02:00:00 AM,48,-122,3,1,4
3483,58thStGreenway22ndAve,05/26/2014 03:00:00 AM,48,-122,0,0,0
3484,58thStGreenway22ndAve,05/26/2014 04:00:00 AM,48,-122,0,0,0
3485,58thStGreenway22ndAve,05/26/2014 05:00:00 AM,48,-122,2,0,2
3486,58thStGreenway22ndAve,05/26/2014 06:00:00 AM,48,-122,0,0,0
3487,58thStGreenway22ndAve,05/26/2014 07:00:00 AM,48,-122,2,1,3
3488,58thStGreenway22ndAve,05/26/2014 08:00:00 AM,48,-122,4,7,11
3489,58thStGreenway22ndAve,05/26/2014 09:00:00 AM,48,-122,10,4,14
3490,58thStGreenway22ndAve,05/26/2014 10:00:00 AM,48,-122,8,16,24
3491,58thStGreenway22ndAve,05/26/2014 11:00:00 AM,48,-122,27,16,43
3492,58thStGreenway22ndAve,05/26/2014 12:00:00 PM,48,-122,13,23,36
3493,58thStGreenway22ndAve,05/26/2014 01:00:00 PM,48,-122,29,15,44
3494,58thStGreenway22ndAve,05/26/2014 02:00:00 PM,48,-122,24,16,40
3495,58thStGreenway22ndAve,05/26/2014 03:00:00 PM,48,-122,28,10,38
3496,58thStGreenway22ndAve,05/26/2014 04:00:00 PM,48,-122,15,15,30
3497,58thStGreenway22ndAve,05/26/2014 05:00:00 PM,48,-122,14,11,25
3498,58thStGreenway22ndAve,05/26/2014 06:00:00 PM,48,-122,20,11,31
3499,58thStGreenway22ndAve,05/26/2014 07:00:00 PM,48,-122,29,6,35
3500,58thStGreenway22ndAve,05/26/2014 08:00:00 PM,48,-122,13,9,22
3501,58thStGreenway22ndAve,05/26/2014 09:00:00 PM,48,-122,14,0,14
3502,58thStGreenway22ndAve,05/26/2014 10:00:00 PM,48,-122,4,0,4
3503,58thStGreenway22ndAve,05/26/2014 11:00:00 PM,48,-122,1,0,1
3504,58thStGreenway22ndAve,05/27/2014 12:00:00 AM,48,-122,0,0,0
3505,58thStGreenway22ndAve,05/27/2014 01:00:00 AM,48,-122,2,0,2
3506,58thStGreenway22ndAve,05/27/2014 02:00:00 AM,48,-122,0,0,0
3507,58thStGreenway22ndAve,05/27/2014 03:00:00 AM,48,-122,0,3,3
3508,58thStGreenway22ndAve,05/27/2014 04:00:00 AM,48,-122,0,0,0
3509,58thStGreenway22ndAve,05/27/2014 05:00:00 AM,48,-122,0,0,0
3510,58thStGreenway22ndAve,05/27/2014 06:00:00 AM,48,-122,2,3,5
3511,58thStGreenway22ndAve,05/27/2014 07:00:00 AM,48,-122,24,5,29
3512,58thStGreenway22ndAve,05/27/2014 08:00:00 AM,48,-122,24,16,40
3513,58thStGreenway22ndAve,05/27/2014 09:00:00 AM,48,-122,18,7,25
3514,58thStGreenway22ndAve,05/27/2014 10:00:00 AM,48,-122,26,7,33
3515,58thStGreenway22ndAve,05/27/2014 11:00:00 AM,48,-122,16,9,25
3516,58thStGreenway22ndAve,05/27/2014 12:00:00 PM,48,-122,26,18,44
3517,58thStGreenway22ndAve,05/27/2014 01:00:00 PM,48,-122,15,9,24
3518,58thStGreenway22ndAve,05/27/2014 02:00:00 PM,48,-122,19,24,43
3519,58thStGreenway22ndAve,05/27/2014 03:00:00 PM,48,-122,26,18,44
3520,58thStGreenway22ndAve,05/27/2014 04:00:00 PM,48,-122,18,19,37
3521,58thStGreenway22ndAve,05/27/2014 05:00:00 PM,48,-122,28,25,53
3522,58thStGreenway22ndAve,05/27/2014 06:00:00 PM,48,-122,30,19,49
3523,58thStGreenway22ndAve,05/27/2014 07:00:00 PM,48,-122,20,10,30
3524,58thStGreenway22ndAve,05/27/2014 08:00:00 PM,48,-122,20,8,28
3525,58thStGreenway22ndAve,05/27/2014 09:00:00 PM,48,-122,12,3,15
3526,58thStGreenway22ndAve,05/27/2014 10:00:00 PM,48,-122,4,4,8
3527,58thStGreenway22ndAve,05/27/2014 11:00:00 PM,48,-122,6,0,6
3528,58thStGreenway22ndAve,05/28/2014 12:00:00 AM,48,-122,2,0,2
3529,58thStGreenway22ndAve,05/28/2014 01:00:00 AM,48,-122,0,0,0
3530,58thStGreenway22ndAve,05/28/2014 02:00:00 AM,48,-122,0,0,0
3531,58thStGreenway22ndAve,05/28/2014 03:00:00 AM,48,-122,0,0,0
3532,58thStGreenway22ndAve,05/28/2014 04:00:00 AM,48,-122,2,0,2
3533,58thStGreenway22ndAve,05/28/2014 05:00:00 AM,48,-122,0,0,0
3534,58thStGreenway22ndAve,05/28/2014 06:00:00 AM,48,-122,2,3,5
3535,58thStGreenway22ndAve,05/28/2014 07:00:00 AM,48,-122,17,4,21
3536,58thStGreenway22ndAve,05/28/2014 08:00:00 AM,48,-122,22,12,34
3537,58thStGreenway22ndAve,05/28/2014 09:00:00 AM,48,-122,25,21,46
3538,58thStGreenway22ndAve,05/28/2014 10:00:00 AM,48,-122,9,5,14
3539,58thStGreenway22ndAve,05/28/2014 11:00:00 AM,48,-122,16,15,31
3540,58thStGreenway22ndAve,05/28/2014 12:00:00 PM,48,-122,27,11,38
3541,58thStGreenway22ndAve,05/28/2014 01:00:00 PM,48,-122,17,12,29
3542,58thStGreenway22ndAve,05/28/2014 02:00:00 PM,48,-122,19,17,36
3543,58thStGreenway22ndAve,05/28/2014 03:00:00 PM,48,-122,22,19,41
3544,58thStGreenway22ndAve,05/28/2014 04:00:00 PM,48,-122,24,12,36
3545,58thStGreenway22ndAve,05/28/2014 05:00:00 PM,48,-122,24,9,33
3546,58thStGreenway22ndAve,05/28/2014 06:00:00 PM,48,-122,36,18,54
3547,58thStGreenway22ndAve,05/28/2014 07:00:00 PM,48,-122,11,10,21
3548,58thStGreenway22ndAve,05/28/2014 08:00:00 PM,48,-122,22,10,32
3549,58thStGreenway22ndAve,05/28/2014 09:00:00 PM,48,-122,8,6,14
3550,58thStGreenway22ndAve,05/28/2014 10:00:00 PM,48,-122,6,3,9
3551,58thStGreenway22ndAve,05/28/2014 11:00:00 PM,48,-122,4,0,4
3552,58thStGreenway22ndAve,05/29/2014 12:00:00 AM,48,-122,2,0,2
3553,58thStGreenway22ndAve,05/29/2014 01:00:00 AM,48,-122,0,0,0
3554,58thStGreenway22ndAve,05/29/2014 02:00:00 AM,48,-122,4,0,4
3555,58thStGreenway22ndAve,05/29/2014 03:00:00 AM,48,-122,0,0,0
3556,58thStGreenway22ndAve,05/29/2014 04:00:00 AM,48,-122,2,0,2
3557,58thStGreenway22ndAve,05/29/2014 05:00:00 AM,48,-122,3,0,3
3558,58thStGreenway22ndAve,05/29/2014 06:00:00 AM,48,-122,12,5,17
3559,58thStGreenway22ndAve,05/29/2014 07:00:00 AM,48,-122,25,13,38
3560,58thStGreenway22ndAve,05/29/2014 08:00:00 AM,48,-122,16,16,32
3561,58thStGreenway22ndAve,05/29/2014 09:00:00 AM,48,-122,27,5,32
3562,58thStGreenway22ndAve,05/29/2014 10:00:00 AM,48,-122,12,9,21
3563,58thStGreenway22ndAve,05/29/2014 11:00:00 AM,48,-122,14,10,24
3564,58thStGreenway22ndAve,05/29/2014 12:00:00 PM,48,-122,18,13,31
3565,58thStGreenway22ndAve,05/29/2014 01:00:00 PM,48,-122,37,16,53
3566,58thStGreenway22ndAve,05/29/2014 02:00:00 PM,48,-122,5,10,15
3567,58thStGreenway22ndAve,05/29/2014 03:00:00 PM,48,-122,27,48,75
3568,58thStGreenway22ndAve,05/29/2014 04:00:00 PM,48,-122,20,15,35
3569,58thStGreenway22ndAve,05/29/2014 05:00:00 PM,48,-122,48,29,77
3570,58thStGreenway22ndAve,05/29/2014 06:00:00 PM,48,-122,47,14,61
3571,58thStGreenway22ndAve,05/29/2014 07:00:00 PM,48,-122,32,23,55
3572,58thStGreenway22ndAve,05/29/2014 08:00:00 PM,48,-122,17,5,22
3573,58thStGreenway22ndAve,05/29/2014 09:00:00 PM,48,-122,16,4,20
3574,58thStGreenway22ndAve,05/29/2014 10:00:00 PM,48,-122,5,0,5
3575,58thStGreenway22ndAve,05/29/2014 11:00:00 PM,48,-122,4,0,4
3576,58thStGreenway22ndAve,05/30/2014 12:00:00 AM,48,-122,3,0,3
3577,58thStGreenway22ndAve,05/30/2014 01:00:00 AM,48,-122,3,0,3
3578,58thStGreenway22ndAve,05/30/2014 02:00:00 AM,48,-122,4,0,4
3579,58thStGreenway22ndAve,05/30/2014 03:00:00 AM,48,-122,0,0,0
3580,58thStGreenway22ndAve,05/30/2014 04:00:00 AM,48,-122,0,0,0
3581,58thStGreenway22ndAve,05/30/2014 05:00:00 AM,48,-122,0,0,0
3582,58thStGreenway22ndAve,05/30/2014 06:00:00 AM,48,-122,2,5,7
3583,58thStGreenway22ndAve,05/30/2014 07:00:00 AM,48,-122,11,3,14
3584,58thStGreenway22ndAve,05/30/2014 08:00:00 AM,48,-122,12,10,22
3585,58thStGreenway22ndAve,05/30/2014 09:00:00 AM,48,-122,26,6,32
3586,58thStGreenway22ndAve,05/30/2014 10:00:00 AM,48,-122,17,7,24
3587,58thStGreenway22ndAve,05/30/2014 11:00:00 AM,48,-122,16,13,29
3588,58thStGreenway22ndAve,05/30/2014 12:00:00 PM,48,-122,42,14,56
3589,58thStGreenway22ndAve,05/30/2014 01:00:00 PM,48,-122,17,16,33
3590,58thStGreenway22ndAve,05/30/2014 02:00:00 PM,48,-122,29,19,48
3591,58thStGreenway22ndAve,05/30/2014 03:00:00 PM,48,-122,25,21,46
3592,58thStGreenway22ndAve,05/30/2014 04:00:00 PM,48,-122,31,22,53
3593,58thStGreenway22ndAve,05/30/2014 05:00:00 PM,48,-122,34,19,53
3594,58thStGreenway22ndAve,05/30/2014 06:00:00 PM,48,-122,40,37,77
3595,58thStGreenway22ndAve,05/30/2014 07:00:00 PM,48,-122,33,16,49
3596,58thStGreenway22ndAve,05/30/2014 08:00:00 PM,48,-122,18,8,26
3597,58thStGreenway22ndAve,05/30/2014 09:00:00 PM,48,-122,17,7,24
3598,58thStGreenway22ndAve,05/30/2014 10:00:00 PM,48,-122,12,4,16
3599,58thStGreenway22ndAve,05/30/2014 11:00:00 PM,48,-122,4,1,5
3600,58thStGreenway22ndAve,05/31/2014 12:00:00 AM,48,-122,10,3,13
3601,58thStGreenway22ndAve,05/31/2014 01:00:00 AM,48,-122,6,0,6
3602,58thStGreenway22ndAve,05/31/2014 02:00:00 AM,48,-122,0,0,0
3603,58thStGreenway22ndAve,05/31/2014 03:00:00 AM,48,-122,0,0,0
3604,58thStGreenway22ndAve,05/31/2014 04:00:00 AM,48,-122,2,0,2
3605,58thStGreenway22ndAve,05/31/2014 05:00:00 AM,48,-122,4,1,5
3606,58thStGreenway22ndAve,05/31/2014 06:00:00 AM,48,-122,7,2,9
3607,58thStGreenway22ndAve,05/31/2014 07:00:00 AM,48,-122,2,1,3
3608,58thStGreenway22ndAve,05/31/2014 08:00:00 AM,48,-122,14,5,19
3609,58thStGreenway22ndAve,05/31/2014 09:00:00 AM,48,-122,19,17,36
3610,58thStGreenway22ndAve,05/31/2014 10:00:00 AM,48,-122,36,16,52
3611,58thStGreenway22ndAve,05/31/2014 11:00:00 AM,48,-122,35,35,70
3612,58thStGreenway22ndAve,05/31/2014 12:00:00 PM,48,-122,39,35,74
3613,58thStGreenway22ndAve,05/31/2014 01:00:00 PM,48,-122,40,23,63
3614,58thStGreenway22ndAve,05/31/2014 02:00:00 PM,48,-122,44,12,56
3615,58thStGreenway22ndAve,05/31/2014 03:00:00 PM,48,-122,24,21,45
3616,58thStGreenway22ndAve,05/31/2014 04:00:00 PM,48,-122,27,25,52
3617,58thStGreenway22ndAve,05/31/2014 05:00:00 PM,48,-122,29,15,44
3618,58thStGreenway22ndAve,05/31/2014 06:00:00 PM,48,-122,23,7,30
3619,58thStGreenway22ndAve,05/31/2014 07:00:00 PM,48,-122,28,12,40
3620,58thStGreenway22ndAve,05/31/2014 08:00:00 PM,48,-122,16,9,25
3621,58thStGreenway22ndAve,05/31/2014 09:00:00 PM,48,-122,10,2,12
3622,58thStGreenway22ndAve,05/31/2014 10:00:00 PM,48,-122,6,2,8
3623,58thStGreenway22ndAve,05/31/2014 11:00:00 PM,48,-122,6,1,7
3624,58thStGreenway22ndAve,06/01/2014 12:00:00 AM,48,-122,3,1,4
3625,58thStGreenway22ndAve,06/01/2014 01:00:00 AM,48,-122,2,1,3
3626,58thStGreenway22ndAve,06/01/2014 02:00:00 AM,48,-122,2,0,2
3627,58thStGreenway22ndAve,06/01/2014 03:00:00 AM,48,-122,4,0,4
3628,58thStGreenway22ndAve,06/01/2014 04:00:00 AM,48,-122,2,0,2
3629,58thStGreenway22ndAve,06/01/2014 05:00:00 AM,48,-122,2,0,2
3630,58thStGreenway22ndAve,06/01/2014 06:00:00 AM,48,-122,0,0,0
3631,58thStGreenway22ndAve,06/01/2014 07:00:00 AM,48,-122,1,1,2
3632,58thStGreenway22ndAve,06/01/2014 08:00:00 AM,48,-122,7,4,11
3633,58thStGreenway22ndAve,06/01/2014 09:00:00 AM,48,-122,5,12,17
3634,58thStGreenway22ndAve,06/01/2014 10:00:00 AM,48,-122,17,13,30
3635,58thStGreenway22ndAve,06/01/2014 11:00:00 AM,48,-122,29,35,64
3636,58thStGreenway22ndAve,06/01/2014 12:00:00 PM,48,-122,46,30,76
3637,58thStGreenway22ndAve,06/01/2014 01:00:00 PM,48,-122,34,32,66
3638,58thStGreenway22ndAve,06/01/2014 02:00:00 PM,48,-122,47,35,82
3639,58thStGreenway22ndAve,06/01/2014 03:00:00 PM,48,-122,20,21,41
3640,58thStGreenway22ndAve,06/01/2014 04:00:00 PM,48,-122,46,26,72
3641,58thStGreenway22ndAve,06/01/2014 05:00:00 PM,48,-122,40,19,59
3642,58thStGreenway22ndAve,06/01/2014 06:00:00 PM,48,-122,19,18,37
3643,58thStGreenway22ndAve,06/01/2014 07:00:00 PM,48,-122,23,12,35
3644,58thStGreenway22ndAve,06/01/2014 08:00:00 PM,48,-122,20,11,31
3645,58thStGreenway22ndAve,06/01/2014 09:00:00 PM,48,-122,16,4,20
3646,58thStGreenway22ndAve,06/01/2014 10:00:00 PM,48,-122,4,1,5
3647,58thStGreenway22ndAve,06/01/2014 11:00:00 PM,48,-122,2,0,2
3648,58thStGreenway22ndAve,06/02/2014 12:00:00 AM,48,-122,2,1,3
3649,58thStGreenway22ndAve,06/02/2014 01:00:00 AM,48,-122,0,2,2
3650,58thStGreenway22ndAve,06/02/2014 02:00:00 AM,48,-122,0,0,0
3651,58thStGreenway22ndAve,06/02/2014 03:00:00 AM,48,-122,0,0,0
3652,58thStGreenway22ndAve,06/02/2014 04:00:00 AM,48,-122,1,0,1
3653,58thStGreenway22ndAve,06/02/2014 05:00:00 AM,48,-122,2,0,2
3654,58thStGreenway22ndAve,06/02/2014 06:00:00 AM,48,-122,8,2,10
3655,58thStGreenway22ndAve,06/02/2014 07:00:00 AM,48,-122,18,7,25
3656,58thStGreenway22ndAve,06/02/2014 08:00:00 AM,48,-122,15,5,20
3657,58thStGreenway22ndAve,06/02/2014 09:00:00 AM,48,-122,12,6,18
3658,58thStGreenway22ndAve,06/02/2014 10:00:00 AM,48,-122,11,14,25
3659,58thStGreenway22ndAve,06/02/2014 11:00:00 AM,48,-122,27,14,41
3660,58thStGreenway22ndAve,06/02/2014 12:00:00 PM,48,-122,23,22,45
3661,58thStGreenway22ndAve,06/02/2014 01:00:00 PM,48,-122,23,14,37
3662,58thStGreenway22ndAve,06/02/2014 02:00:00 PM,48,-122,19,14,33
3663,58thStGreenway22ndAve,06/02/2014 03:00:00 PM,48,-122,15,10,25
3664,58thStGreenway22ndAve,06/02/2014 04:00:00 PM,48,-122,24,21,45
3665,58thStGreenway22ndAve,06/02/2014 05:00:00 PM,48,-122,20,24,44
3666,58thStGreenway22ndAve,06/02/2014 06:00:00 PM,48,-122,35,18,53
3667,58thStGreenway22ndAve,06/02/2014 07:00:00 PM,48,-122,19,14,33
3668,58thStGreenway22ndAve,06/02/2014 08:00:00 PM,48,-122,14,2,16
3669,58thStGreenway22ndAve,06/02/2014 09:00:00 PM,48,-122,13,4,17
3670,58thStGreenway22ndAve,06/02/2014 10:00:00 PM,48,-122,5,2,7
3671,58thStGreenway22ndAve,06/02/2014 11:00:00 PM,48,-122,4,1,5
3672,58thStGreenway22ndAve,06/03/2014 12:00:00 AM,48,-122,5,0,5
3673,58thStGreenway22ndAve,06/03/2014 01:00:00 AM,48,-122,0,0,0
3674,58thStGreenway22ndAve,06/03/2014 02:00:00 AM,48,-122,0,0,0
3675,58thStGreenway22ndAve,06/03/2014 03:00:00 AM,48,-122,0,0,0
3676,58thStGreenway22ndAve,06/03/2014 04:00:00 AM,48,-122,0,0,0
3677,58thStGreenway22ndAve,06/03/2014 05:00:00 AM,48,-122,0,0,0
3678,58thStGreenway22ndAve,06/03/2014 06:00:00 AM,48,-122,2,2,4
3679,58thStGreenway22ndAve,06/03/2014 07:00:00 AM,48,-122,18,10,28
3680,58thStGreenway22ndAve,06/03/2014 08:00:00 AM,48,-122,11,17,28
3681,58thStGreenway22ndAve,06/03/2014 09:00:00 AM,48,-122,25,13,38
3682,58thStGreenway22ndAve,06/03/2014 10:00:00 AM,48,-122,17,6,23
3683,58thStGreenway22ndAve,06/03/2014 11:00:00 AM,48,-122,16,18,34
3684,58thStGreenway22ndAve,06/03/2014 12:00:00 PM,48,-122,24,12,36
3685,58thStGreenway22ndAve,06/03/2014 01:00:00 PM,48,-122,16,7,23
3686,58thStGreenway22ndAve,06/03/2014 02:00:00 PM,48,-122,15,3,18
3687,58thStGreenway22ndAve,06/03/2014 03:00:00 PM,48,-122,17,7,24
3688,58thStGreenway22ndAve,06/03/2014 04:00:00 PM,48,-122,20,7,27
3689,58thStGreenway22ndAve,06/03/2014 05:00:00 PM,48,-122,27,16,43
3690,58thStGreenway22ndAve,06/03/2014 06:00:00 PM,48,-122,25,19,44
3691,58thStGreenway22ndAve,06/03/2014 07:00:00 PM,48,-122,18,15,33
3692,58thStGreenway22ndAve,06/03/2014 08:00:00 PM,48,-122,24,7,31
3693,58thStGreenway22ndAve,06/03/2014 09:00:00 PM,48,-122,17,2,19
3694,58thStGreenway22ndAve,06/03/2014 10:00:00 PM,48,-122,17,5,22
3695,58thStGreenway22ndAve,06/03/2014 11:00:00 PM,48,-122,6,0,6
3696,58thStGreenway22ndAve,06/04/2014 12:00:00 AM,48,-122,1,0,1
3697,58thStGreenway22ndAve,06/04/2014 01:00:00 AM,48,-122,0,1,1
3698,58thStGreenway22ndAve,06/04/2014 02:00:00 AM,48,-122,0,0,0
3699,58thStGreenway22ndAve,06/04/2014 03:00:00 AM,48,-122,0,0,0
3700,58thStGreenway22ndAve,06/04/2014 04:00:00 AM,48,-122,0,0,0
3701,58thStGreenway22ndAve,06/04/2014 05:00:00 AM,48,-122,8,0,8
3702,58thStGreenway22ndAve,06/04/2014 06:00:00 AM,48,-122,6,1,7
3703,58thStGreenway22ndAve,06/04/2014 07:00:00 AM,48,-122,23,4,27
3704,58thStGreenway22ndAve,06/04/2014 08:00:00 AM,48,-122,37,12,49
3705,58thStGreenway22ndAve,06/04/2014 09:00:00 AM,48,-122,23,8,31
3706,58thStGreenway22ndAve,06/04/2014 10:00:00 AM,48,-122,20,13,33
3707,58thStGreenway22ndAve,06/04/2014 11:00:00 AM,48,-122,24,15,39
3708,58thStGreenway22ndAve,06/04/2014 12:00:00 PM,48,-122,10,20,30
3709,58thStGreenway22ndAve,06/04/2014 01:00:00 PM,48,-122,18,14,32
3710,58thStGreenway22ndAve,06/04/2014 02:00:00 PM,48,-122,25,17,42
3711,58thStGreenway22ndAve,06/04/2014 03:00:00 PM,48,-122,23,15,38
3712,58thStGreenway22ndAve,06/04/2014 04:00:00 PM,48,-122,35,11,46
3713,58thStGreenway22ndAve,06/04/2014 05:00:00 PM,48,-122,19,15,34
3714,58thStGreenway22ndAve,06/04/2014 06:00:00 PM,48,-122,37,29,66
3715,58thStGreenway22ndAve,06/04/2014 07:00:00 PM,48,-122,20,33,53
3716,58thStGreenway22ndAve,06/04/2014 08:00:00 PM,48,-122,17,13,30
3717,58thStGreenway22ndAve,06/04/2014 09:00:00 PM,48,-122,9,7,16
3718,58thStGreenway22ndAve,06/04/2014 10:00:00 PM,48,-122,4,1,5
3719,58thStGreenway22ndAve,06/04/2014 11:00:00 PM,48,-122,6,0,6
3720,58thStGreenway22ndAve,06/05/2014 12:00:00 AM,48,-122,0,0,0
3721,58thStGreenway22ndAve,06/05/2014 01:00:00 AM,48,-122,4,2,6
3722,58thStGreenway22ndAve,06/05/2014 02:00:00 AM,48,-122,1,2,3
3723,58thStGreenway22ndAve,06/05/2014 03:00:00 AM,48,-122,0,0,0
3724,58thStGreenway22ndAve,06/05/2014 04:00:00 AM,48,-122,0,0,0
3725,58thStGreenway22ndAve,06/05/2014 05:00:00 AM,48,-122,0,0,0
3726,58thStGreenway22ndAve,06/05/2014 06:00:00 AM,48,-122,3,1,4
3727,58thStGreenway22ndAve,06/05/2014 07:00:00 AM,48,-122,15,7,22
3728,58thStGreenway22ndAve,06/05/2014 08:00:00 AM,48,-122,22,8,30
3729,58thStGreenway22ndAve,06/05/2014 09:00:00 AM,48,-122,29,9,38
3730,58thStGreenway22ndAve,06/05/2014 10:00:00 AM,48,-122,16,10,26
3731,58thStGreenway22ndAve,06/05/2014 11:00:00 AM,48,-122,27,19,46
3732,58thStGreenway22ndAve,06/05/2014 12:00:00 PM,48,-122,34,22,56
3733,58thStGreenway22ndAve,06/05/2014 01:00:00 PM,48,-122,18,6,24
3734,58thStGreenway22ndAve,06/05/2014 02:00:00 PM,48,-122,37,12,49
3735,58thStGreenway22ndAve,06/05/2014 03:00:00 PM,48,-122,21,8,29
3736,58thStGreenway22ndAve,06/05/2014 04:00:00 PM,48,-122,26,8,34
3737,58thStGreenway22ndAve,06/05/2014 05:00:00 PM,48,-122,29,25,54
3738,58thStGreenway22ndAve,06/05/2014 06:00:00 PM,48,-122,26,20,46
3739,58thStGreenway22ndAve,06/05/2014 07:00:00 PM,48,-122,39,15,54
3740,58thStGreenway22ndAve,06/05/2014 08:00:00 PM,48,-122,9,17,26
3741,58thStGreenway22ndAve,06/05/2014 09:00:00 PM,48,-122,14,6,20
3742,58thStGreenway22ndAve,06/05/2014 10:00:00 PM,48,-122,9,5,14
3743,58thStGreenway22ndAve,06/05/2014 11:00:00 PM,48,-122,13,0,13
3744,58thStGreenway22ndAve,06/06/2014 12:00:00 AM,48,-122,0,0,0
3745,58thStGreenway22ndAve,06/06/2014 01:00:00 AM,48,-122,2,0,2
3746,58thStGreenway22ndAve,06/06/2014 02:00:00 AM,48,-122,0,0,0
3747,58thStGreenway22ndAve,06/06/2014 03:00:00 AM,48,-122,0,0,0
3748,58thStGreenway22ndAve,06/06/2014 04:00:00 AM,48,-122,0,0,0
3749,58thStGreenway22ndAve,06/06/2014 05:00:00 AM,48,-122,1,0,1
3750,58thStGreenway22ndAve,06/06/2014 06:00:00 AM,48,-122,12,3,15
3751,58thStGreenway22ndAve,06/06/2014 07:00:00 AM,48,-122,23,3,26
3752,58thStGreenway22ndAve,06/06/2014 08:00:00 AM,48,-122,28,16,44
3753,58thStGreenway22ndAve,06/06/2014 09:00:00 AM,48,-122,22,10,32
3754,58thStGreenway22ndAve,06/06/2014 10:00:00 AM,48,-122,25,33,58
3755,58thStGreenway22ndAve,06/06/2014 11:00:00 AM,48,-122,21,16,37
3756,58thStGreenway22ndAve,06/06/2014 12:00:00 PM,48,-122,43,10,53
3757,58thStGreenway22ndAve,06/06/2014 01:00:00 PM,48,-122,28,19,47
3758,58thStGreenway22ndAve,06/06/2014 02:00:00 PM,48,-122,26,8,34
3759,58thStGreenway22ndAve,06/06/2014 03:00:00 PM,48,-122,25,13,38
3760,58thStGreenway22ndAve,06/06/2014 04:00:00 PM,48,-122,40,12,52
3761,58thStGreenway22ndAve,06/06/2014 05:00:00 PM,48,-122,35,15,50
3762,58thStGreenway22ndAve,06/06/2014 06:00:00 PM,48,-122,37,23,60
3763,58thStGreenway22ndAve,06/06/2014 07:00:00 PM,48,-122,28,11,39
3764,58thStGreenway22ndAve,06/06/2014 08:00:00 PM,48,-122,17,4,21
3765,58thStGreenway22ndAve,06/06/2014 09:00:00 PM,48,-122,28,5,33
3766,58thStGreenway22ndAve,06/06/2014 10:00:00 PM,48,-122,9,0,9
3767,58thStGreenway22ndAve,06/06/2014 11:00:00 PM,48,-122,0,1,1
3768,58thStGreenway22ndAve,06/07/2014 12:00:00 AM,48,-122,3,1,4
3769,58thStGreenway22ndAve,06/07/2014 01:00:00 AM,48,-122,2,0,2
3770,58thStGreenway22ndAve,06/07/2014 02:00:00 AM,48,-122,0,1,1
3771,58thStGreenway22ndAve,06/07/2014 03:00:00 AM,48,-122,0,0,0
3772,58thStGreenway22ndAve,06/07/2014 04:00:00 AM,48,-122,2,0,2
3773,58thStGreenway22ndAve,06/07/2014 05:00:00 AM,48,-122,2,0,2
3774,58thStGreenway22ndAve,06/07/2014 06:00:00 AM,48,-122,0,1,1
3775,58thStGreenway22ndAve,06/07/2014 07:00:00 AM,48,-122,5,0,5
3776,58thStGreenway22ndAve,06/07/2014 08:00:00 AM,48,-122,9,6,15
3777,58thStGreenway22ndAve,06/07/2014 09:00:00 AM,48,-122,19,16,35
3778,58thStGreenway22ndAve,06/07/2014 10:00:00 AM,48,-122,20,18,38
3779,58thStGreenway22ndAve,06/07/2014 11:00:00 AM,48,-122,19,18,37
3780,58thStGreenway22ndAve,06/07/2014 12:00:00 PM,48,-122,29,25,54
3781,58thStGreenway22ndAve,06/07/2014 01:00:00 PM,48,-122,25,20,45
3782,58thStGreenway22ndAve,06/07/2014 02:00:00 PM,48,-122,39,12,51
3783,58thStGreenway22ndAve,06/07/2014 03:00:00 PM,48,-122,37,31,68
3784,58thStGreenway22ndAve,06/07/2014 04:00:00 PM,48,-122,42,33,75
3785,58thStGreenway22ndAve,06/07/2014 05:00:00 PM,48,-122,45,31,76
3786,58thStGreenway22ndAve,06/07/2014 06:00:00 PM,48,-122,32,26,58
3787,58thStGreenway22ndAve,06/07/2014 07:00:00 PM,48,-122,47,11,58
3788,58thStGreenway22ndAve,06/07/2014 08:00:00 PM,48,-122,22,5,27
3789,58thStGreenway22ndAve,06/07/2014 09:00:00 PM,48,-122,14,8,22
3790,58thStGreenway22ndAve,06/07/2014 10:00:00 PM,48,-122,21,4,25
3791,58thStGreenway22ndAve,06/07/2014 11:00:00 PM,48,-122,3,1,4
3792,58thStGreenway22ndAve,06/08/2014 12:00:00 AM,48,-122,3,2,5
3793,58thStGreenway22ndAve,06/08/2014 01:00:00 AM,48,-122,4,0,4
3794,58thStGreenway22ndAve,06/08/2014 02:00:00 AM,48,-122,2,0,2
3795,58thStGreenway22ndAve,06/08/2014 03:00:00 AM,48,-122,2,0,2
3796,58thStGreenway22ndAve,06/08/2014 04:00:00 AM,48,-122,0,0,0
3797,58thStGreenway22ndAve,06/08/2014 05:00:00 AM,48,-122,0,0,0
3798,58thStGreenway22ndAve,06/08/2014 06:00:00 AM,48,-122,3,3,6
3799,58thStGreenway22ndAve,06/08/2014 07:00:00 AM,48,-122,2,3,5
3800,58thStGreenway22ndAve,06/08/2014 08:00:00 AM,48,-122,6,6,12
3801,58thStGreenway22ndAve,06/08/2014 09:00:00 AM,48,-122,17,6,23
3802,58thStGreenway22ndAve,06/08/2014 10:00:00 AM,48,-122,11,3,14
3803,58thStGreenway22ndAve,06/08/2014 11:00:00 AM,48,-122,32,17,49
3804,58thStGreenway22ndAve,06/08/2014 12:00:00 PM,48,-122,27,39,66
3805,58thStGreenway22ndAve,06/08/2014 01:00:00 PM,48,-122,50,30,80
3806,58thStGreenway22ndAve,06/08/2014 02:00:00 PM,48,-122,32,11,43
3807,58thStGreenway22ndAve,06/08/2014 03:00:00 PM,48,-122,24,27,51
3808,58thStGreenway22ndAve,06/08/2014 04:00:00 PM,48,-122,21,28,49
3809,58thStGreenway22ndAve,06/08/2014 05:00:00 PM,48,-122,33,12,45
3810,58thStGreenway22ndAve,06/08/2014 06:00:00 PM,48,-122,21,15,36
3811,58thStGreenway22ndAve,06/08/2014 07:00:00 PM,48,-122,22,12,34
3812,58thStGreenway22ndAve,06/08/2014 08:00:00 PM,48,-122,11,10,21
3813,58thStGreenway22ndAve,06/08/2014 09:00:00 PM,48,-122,13,3,16
3814,58thStGreenway22ndAve,06/08/2014 10:00:00 PM,48,-122,0,0,0
3815,58thStGreenway22ndAve,06/08/2014 11:00:00 PM,48,-122,5,0,5
3816,58thStGreenway22ndAve,06/09/2014 12:00:00 AM,48,-122,2,0,2
3817,58thStGreenway22ndAve,06/09/2014 01:00:00 AM,48,-122,2,0,2
3818,58thStGreenway22ndAve,06/09/2014 02:00:00 AM,48,-122,0,0,0
3819,58thStGreenway22ndAve,06/09/2014 03:00:00 AM,48,-122,0,0,0
3820,58thStGreenway22ndAve,06/09/2014 04:00:00 AM,48,-122,0,0,0
3821,58thStGreenway22ndAve,06/09/2014 05:00:00 AM,48,-122,0,2,2
3822,58thStGreenway22ndAve,06/09/2014 06:00:00 AM,48,-122,7,4,11
3823,58thStGreenway22ndAve,06/09/2014 07:00:00 AM,48,-122,19,10,29
3824,58thStGreenway22ndAve,06/09/2014 08:00:00 AM,48,-122,23,23,46
3825,58thStGreenway22ndAve,06/09/2014 09:00:00 AM,48,-122,22,22,44
3826,58thStGreenway22ndAve,06/09/2014 10:00:00 AM,48,-122,11,12,23
3827,58thStGreenway22ndAve,06/09/2014 11:00:00 AM,48,-122,15,23,38
3828,58thStGreenway22ndAve,06/09/2014 12:00:00 PM,48,-122,23,18,41
3829,58thStGreenway22ndAve,06/09/2014 01:00:00 PM,48,-122,24,14,38
3830,58thStGreenway22ndAve,06/09/2014 02:00:00 PM,48,-122,27,10,37
3831,58thStGreenway22ndAve,06/09/2014 03:00:00 PM,48,-122,21,16,37
3832,58thStGreenway22ndAve,06/09/2014 04:00:00 PM,48,-122,15,17,32
3833,58thStGreenway22ndAve,06/09/2014 05:00:00 PM,48,-122,21,15,36
3834,58thStGreenway22ndAve,06/09/2014 06:00:00 PM,48,-122,23,19,42
3835,58thStGreenway22ndAve,06/09/2014 07:00:00 PM,48,-122,21,11,32
3836,58thStGreenway22ndAve,06/09/2014 08:00:00 PM,48,-122,9,4,13
3837,58thStGreenway22ndAve,06/09/2014 09:00:00 PM,48,-122,10,4,14
3838,58thStGreenway22ndAve,06/09/2014 10:00:00 PM,48,-122,2,6,8
3839,58thStGreenway22ndAve,06/09/2014 11:00:00 PM,48,-122,0,2,2
3840,58thStGreenway22ndAve,06/10/2014 12:00:00 AM,48,-122,4,1,5
3841,58thStGreenway22ndAve,06/10/2014 01:00:00 AM,48,-122,1,0,1
3842,58thStGreenway22ndAve,06/10/2014 02:00:00 AM,48,-122,0,0,0
3843,58thStGreenway22ndAve,06/10/2014 03:00:00 AM,48,-122,0,0,0
3844,58thStGreenway22ndAve,06/10/2014 04:00:00 AM,48,-122,2,0,2
3845,58thStGreenway22ndAve,06/10/2014 05:00:00 AM,48,-122,0,0,0
3846,58thStGreenway22ndAve,06/10/2014 06:00:00 AM,48,-122,6,3,9
3847,58thStGreenway22ndAve,06/10/2014 07:00:00 AM,48,-122,17,6,23
3848,58thStGreenway22ndAve,06/10/2014 08:00:00 AM,48,-122,27,14,41
3849,58thStGreenway22ndAve,06/10/2014 09:00:00 AM,48,-122,25,21,46
3850,58thStGreenway22ndAve,06/10/2014 10:00:00 AM,48,-122,14,18,32
3851,58thStGreenway22ndAve,06/10/2014 11:00:00 AM,48,-122,17,8,25
3852,58thStGreenway22ndAve,06/10/2014 12:00:00 PM,48,-122,29,24,53
3853,58thStGreenway22ndAve,06/10/2014 01:00:00 PM,48,-122,22,16,38
3854,58thStGreenway22ndAve,06/10/2014 02:00:00 PM,48,-122,14,14,28
3855,58thStGreenway22ndAve,06/10/2014 03:00:00 PM,48,-122,24,17,41
3856,58thStGreenway22ndAve,06/10/2014 04:00:00 PM,48,-122,18,16,34
3857,58thStGreenway22ndAve,06/10/2014 05:00:00 PM,48,-122,27,14,41
3858,58thStGreenway22ndAve,06/10/2014 06:00:00 PM,48,-122,26,16,42
3859,58thStGreenway22ndAve,06/10/2014 07:00:00 PM,48,-122,21,16,37
3860,58thStGreenway22ndAve,06/10/2014 08:00:00 PM,48,-122,11,14,25
3861,58thStGreenway22ndAve,06/10/2014 09:00:00 PM,48,-122,13,7,20
3862,58thStGreenway22ndAve,06/10/2014 10:00:00 PM,48,-122,11,7,18
3863,58thStGreenway22ndAve,06/10/2014 11:00:00 PM,48,-122,2,4,6
3864,58thStGreenway22ndAve,06/11/2014 12:00:00 AM,48,-122,2,3,5
3865,58thStGreenway22ndAve,06/11/2014 01:00:00 AM,48,-122,1,0,1
3866,58thStGreenway22ndAve,06/11/2014 02:00:00 AM,48,-122,0,0,0
3867,58thStGreenway22ndAve,06/11/2014 03:00:00 AM,48,-122,0,0,0
3868,58thStGreenway22ndAve,06/11/2014 04:00:00 AM,48,-122,0,0,0
3869,58thStGreenway22ndAve,06/11/2014 05:00:00 AM,48,-122,2,0,2
3870,58thStGreenway22ndAve,06/11/2014 06:00:00 AM,48,-122,8,2,10
3871,58thStGreenway22ndAve,06/11/2014 07:00:00 AM,48,-122,27,7,34
3872,58thStGreenway22ndAve,06/11/2014 08:00:00 AM,48,-122,24,9,33
3873,58thStGreenway22ndAve,06/11/2014 09:00:00 AM,48,-122,12,9,21
3874,58thStGreenway22ndAve,06/11/2014 10:00:00 AM,48,-122,14,13,27
3875,58thStGreenway22ndAve,06/11/2014 11:00:00 AM,48,-122,32,7,39
3876,58thStGreenway22ndAve,06/11/2014 12:00:00 PM,48,-122,30,12,42
3877,58thStGreenway22ndAve,06/11/2014 01:00:00 PM,48,-122,27,21,48
3878,58thStGreenway22ndAve,06/11/2014 02:00:00 PM,48,-122,21,34,55
3879,58thStGreenway22ndAve,06/11/2014 03:00:00 PM,48,-122,34,21,55
3880,58thStGreenway22ndAve,06/11/2014 04:00:00 PM,48,-122,48,8,56
3881,58thStGreenway22ndAve,06/11/2014 05:00:00 PM,48,-122,37,19,56
3882,58thStGreenway22ndAve,06/11/2014 06:00:00 PM,48,-122,31,23,54
3883,58thStGreenway22ndAve,06/11/2014 07:00:00 PM,48,-122,30,21,51
3884,58thStGreenway22ndAve,06/11/2014 08:00:00 PM,48,-122,12,8,20
3885,58thStGreenway22ndAve,06/11/2014 09:00:00 PM,48,-122,17,6,23
3886,58thStGreenway22ndAve,06/11/2014 10:00:00 PM,48,-122,5,1,6
3887,58thStGreenway22ndAve,06/11/2014 11:00:00 PM,48,-122,0,1,1
3888,58thStGreenway22ndAve,06/12/2014 12:00:00 AM,48,-122,1,0,1
3889,58thStGreenway22ndAve,06/12/2014 01:00:00 AM,48,-122,0,0,0
3890,58thStGreenway22ndAve,06/12/2014 02:00:00 AM,48,-122,0,0,0
3891,58thStGreenway22ndAve,06/12/2014 03:00:00 AM,48,-122,2,1,3
3892,58thStGreenway22ndAve,06/12/2014 04:00:00 AM,48,-122,4,0,4
3893,58thStGreenway22ndAve,06/12/2014 05:00:00 AM,48,-122,1,3,4
3894,58thStGreenway22ndAve,06/12/2014 06:00:00 AM,48,-122,12,7,19
3895,58thStGreenway22ndAve,06/12/2014 07:00:00 AM,48,-122,20,15,35
3896,58thStGreenway22ndAve,06/12/2014 08:00:00 AM,48,-122,12,10,22
3897,58thStGreenway22ndAve,06/12/2014 09:00:00 AM,48,-122,27,19,46
3898,58thStGreenway22ndAve,06/12/2014 10:00:00 AM,48,-122,21,15,36
3899,58thStGreenway22ndAve,06/12/2014 11:00:00 AM,48,-122,20,19,39
3900,58thStGreenway22ndAve,06/12/2014 12:00:00 PM,48,-122,27,13,40
3901,58thStGreenway22ndAve,06/12/2014 01:00:00 PM,48,-122,20,18,38
3902,58thStGreenway22ndAve,06/12/2014 02:00:00 PM,48,-122,16,7,23
3903,58thStGreenway22ndAve,06/12/2014 03:00:00 PM,48,-122,17,12,29
3904,58thStGreenway22ndAve,06/12/2014 04:00:00 PM,48,-122,27,11,38
3905,58thStGreenway22ndAve,06/12/2014 05:00:00 PM,48,-122,26,15,41
3906,58thStGreenway22ndAve,06/12/2014 06:00:00 PM,48,-122,24,23,47
3907,58thStGreenway22ndAve,06/12/2014 07:00:00 PM,48,-122,14,9,23
3908,58thStGreenway22ndAve,06/12/2014 08:00:00 PM,48,-122,23,14,37
3909,58thStGreenway22ndAve,06/12/2014 09:00:00 PM,48,-122,8,3,11
3910,58thStGreenway22ndAve,06/12/2014 10:00:00 PM,48,-122,5,1,6
3911,58thStGreenway22ndAve,06/12/2014 11:00:00 PM,48,-122,10,0,10
3912,58thStGreenway22ndAve,06/13/2014 12:00:00 AM,48,-122,9,4,13
3913,58thStGreenway22ndAve,06/13/2014 01:00:00 AM,48,-122,0,0,0
3914,58thStGreenway22ndAve,06/13/2014 02:00:00 AM,48,-122,0,0,0
3915,58thStGreenway22ndAve,06/13/2014 03:00:00 AM,48,-122,2,0,2
3916,58thStGreenway22ndAve,06/13/2014 04:00:00 AM,48,-122,0,0,0
3917,58thStGreenway22ndAve,06/13/2014 05:00:00 AM,48,-122,2,2,4
3918,58thStGreenway22ndAve,06/13/2014 06:00:00 AM,48,-122,14,6,20
3919,58thStGreenway22ndAve,06/13/2014 07:00:00 AM,48,-122,21,7,28
3920,58thStGreenway22ndAve,06/13/2014 08:00:00 AM,48,-122,19,8,27
3921,58thStGreenway22ndAve,06/13/2014 09:00:00 AM,48,-122,26,10,36
3922,58thStGreenway22ndAve,06/13/2014 10:00:00 AM,48,-122,13,9,22
3923,58thStGreenway22ndAve,06/13/2014 11:00:00 AM,48,-122,11,13,24
3924,58thStGreenway22ndAve,06/13/2014 12:00:00 PM,48,-122,26,13,39
3925,58thStGreenway22ndAve,06/13/2014 01:00:00 PM,48,-122,31,13,44
3926,58thStGreenway22ndAve,06/13/2014 02:00:00 PM,48,-122,22,11,33
3927,58thStGreenway22ndAve,06/13/2014 03:00:00 PM,48,-122,26,6,32
3928,58thStGreenway22ndAve,06/13/2014 04:00:00 PM,48,-122,20,15,35
3929,58thStGreenway22ndAve,06/13/2014 05:00:00 PM,48,-122,32,17,49
3930,58thStGreenway22ndAve,06/13/2014 06:00:00 PM,48,-122,24,22,46
3931,58thStGreenway22ndAve,06/13/2014 07:00:00 PM,48,-122,29,23,52
3932,58thStGreenway22ndAve,06/13/2014 08:00:00 PM,48,-122,17,3,20
3933,58thStGreenway22ndAve,06/13/2014 09:00:00 PM,48,-122,5,3,8
3934,58thStGreenway22ndAve,06/13/2014 10:00:00 PM,48,-122,14,1,15
3935,58thStGreenway22ndAve,06/13/2014 11:00:00 PM,48,-122,11,5,16
3936,58thStGreenway22ndAve,06/14/2014 12:00:00 AM,48,-122,1,0,1
3937,58thStGreenway22ndAve,06/14/2014 01:00:00 AM,48,-122,5,1,6
3938,58thStGreenway22ndAve,06/14/2014 02:00:00 AM,48,-122,2,0,2
3939,58thStGreenway22ndAve,06/14/2014 03:00:00 AM,48,-122,0,1,1
3940,58thStGreenway22ndAve,06/14/2014 04:00:00 AM,48,-122,2,0,2
3941,58thStGreenway22ndAve,06/14/2014 05:00:00 AM,48,-122,0,1,1
3942,58thStGreenway22ndAve,06/14/2014 06:00:00 AM,48,-122,2,1,3
3943,58thStGreenway22ndAve,06/14/2014 07:00:00 AM,48,-122,8,0,8
3944,58thStGreenway22ndAve,06/14/2014 08:00:00 AM,48,-122,6,5,11
3945,58thStGreenway22ndAve,06/14/2014 09:00:00 AM,48,-122,13,11,24
3946,58thStGreenway22ndAve,06/14/2014 10:00:00 AM,48,-122,20,15,35
3947,58thStGreenway22ndAve,06/14/2014 11:00:00 AM,48,-122,29,14,43
3948,58thStGreenway22ndAve,06/14/2014 12:00:00 PM,48,-122,18,23,41
3949,58thStGreenway22ndAve,06/14/2014 01:00:00 PM,48,-122,35,19,54
3950,58thStGreenway22ndAve,06/14/2014 02:00:00 PM,48,-122,36,25,61
3951,58thStGreenway22ndAve,06/14/2014 03:00:00 PM,48,-122,41,16,57
3952,58thStGreenway22ndAve,06/14/2014 04:00:00 PM,48,-122,23,9,32
3953,58thStGreenway22ndAve,06/14/2014 05:00:00 PM,48,-122,13,16,29
3954,58thStGreenway22ndAve,06/14/2014 06:00:00 PM,48,-122,22,15,37
3955,58thStGreenway22ndAve,06/14/2014 07:00:00 PM,48,-122,31,9,40
3956,58thStGreenway22ndAve,06/14/2014 08:00:00 PM,48,-122,20,12,32
3957,58thStGreenway22ndAve,06/14/2014 09:00:00 PM,48,-122,1,7,8
3958,58thStGreenway22ndAve,06/14/2014 10:00:00 PM,48,-122,5,6,11
3959,58thStGreenway22ndAve,06/14/2014 11:00:00 PM,48,-122,4,2,6
3960,58thStGreenway22ndAve,06/15/2014 12:00:00 AM,48,-122,0,3,3
3961,58thStGreenway22ndAve,06/15/2014 01:00:00 AM,48,-122,0,2,2
3962,58thStGreenway22ndAve,06/15/2014 02:00:00 AM,48,-122,0,4,4
3963,58thStGreenway22ndAve,06/15/2014 03:00:00 AM,48,-122,0,2,2
3964,58thStGreenway22ndAve,06/15/2014 04:00:00 AM,48,-122,2,0,2
3965,58thStGreenway22ndAve,06/15/2014 05:00:00 AM,48,-122,0,2,2
3966,58thStGreenway22ndAve,06/15/2014 06:00:00 AM,48,-122,0,1,1
3967,58thStGreenway22ndAve,06/15/2014 07:00:00 AM,48,-122,2,2,4
3968,58thStGreenway22ndAve,06/15/2014 08:00:00 AM,48,-122,7,3,10
3969,58thStGreenway22ndAve,06/15/2014 09:00:00 AM,48,-122,11,15,26
3970,58thStGreenway22ndAve,06/15/2014 10:00:00 AM,48,-122,16,15,31
3971,58thStGreenway22ndAve,06/15/2014 11:00:00 AM,48,-122,38,24,62
3972,58thStGreenway22ndAve,06/15/2014 12:00:00 PM,48,-122,15,20,35
3973,58thStGreenway22ndAve,06/15/2014 01:00:00 PM,48,-122,39,33,72
3974,58thStGreenway22ndAve,06/15/2014 02:00:00 PM,48,-122,3,16,19
3975,58thStGreenway22ndAve,06/15/2014 03:00:00 PM,48,-122,8,9,17
3976,58thStGreenway22ndAve,06/15/2014 04:00:00 PM,48,-122,6,4,10
3977,58thStGreenway22ndAve,06/15/2014 05:00:00 PM,48,-122,13,10,23
3978,58thStGreenway22ndAve,06/15/2014 06:00:00 PM,48,-122,20,5,25
3979,58thStGreenway22ndAve,06/15/2014 07:00:00 PM,48,-122,10,2,12
3980,58thStGreenway22ndAve,06/15/2014 08:00:00 PM,48,-122,17,10,27
3981,58thStGreenway22ndAve,06/15/2014 09:00:00 PM,48,-122,4,3,7
3982,58thStGreenway22ndAve,06/15/2014 10:00:00 PM,48,-122,6,2,8
3983,58thStGreenway22ndAve,06/15/2014 11:00:00 PM,48,-122,1,2,3
3984,58thStGreenway22ndAve,06/16/2014 12:00:00 AM,48,-122,1,0,1
3985,58thStGreenway22ndAve,06/16/2014 01:00:00 AM,48,-122,2,0,2
3986,58thStGreenway22ndAve,06/16/2014 02:00:00 AM,48,-122,0,0,0
3987,58thStGreenway22ndAve,06/16/2014 03:00:00 AM,48,-122,0,0,0
3988,58thStGreenway22ndAve,06/16/2014 04:00:00 AM,48,-122,0,0,0
3989,58thStGreenway22ndAve,06/16/2014 05:00:00 AM,48,-122,1,2,3
3990,58thStGreenway22ndAve,06/16/2014 06:00:00 AM,48,-122,5,4,9
3991,58thStGreenway22ndAve,06/16/2014 07:00:00 AM,48,-122,11,8,19
3992,58thStGreenway22ndAve,06/16/2014 08:00:00 AM,48,-122,11,10,21
3993,58thStGreenway22ndAve,06/16/2014 09:00:00 AM,48,-122,25,18,43
3994,58thStGreenway22ndAve,06/16/2014 10:00:00 AM,48,-122,8,15,23
3995,58thStGreenway22ndAve,06/16/2014 11:00:00 AM,48,-122,25,6,31
3996,58thStGreenway22ndAve,06/16/2014 12:00:00 PM,48,-122,16,12,28
3997,58thStGreenway22ndAve,06/16/2014 01:00:00 PM,48,-122,22,14,36
3998,58thStGreenway22ndAve,06/16/2014 02:00:00 PM,48,-122,26,15,41
3999,58thStGreenway22ndAve,06/16/2014 03:00:00 PM,48,-122,9,18,27
4000,58thStGreenway22ndAve,06/16/2014 04:00:00 PM,48,-122,34,18,52
4001,58thStGreenway22ndAve,06/16/2014 05:00:00 PM,48,-122,29,17,46
4002,58thStGreenway22ndAve,06/16/2014 06:00:00 PM,48,-122,25,14,39
4003,58thStGreenway22ndAve,06/16/2014 07:00:00 PM,48,-122,14,10,24
4004,58thStGreenway22ndAve,06/16/2014 08:00:00 PM,48,-122,20,9,29
4005,58thStGreenway22ndAve,06/16/2014 09:00:00 PM,48,-122,16,2,18
4006,58thStGreenway22ndAve,06/16/2014 10:00:00 PM,48,-122,10,0,10
4007,58thStGreenway22ndAve,06/16/2014 11:00:00 PM,48,-122,1,0,1
4008,58thStGreenway22ndAve,06/17/2014 12:00:00 AM,48,-122,2,0,2
4009,58thStGreenway22ndAve,06/17/2014 01:00:00 AM,48,-122,0,0,0
4010,58thStGreenway22ndAve,06/17/2014 02:00:00 AM,48,-122,0,0,0
4011,58thStGreenway22ndAve,06/17/2014 03:00:00 AM,48,-122,0,0,0
4012,58thStGreenway22ndAve,06/17/2014 04:00:00 AM,48,-122,0,0,0
4013,58thStGreenway22ndAve,06/17/2014 05:00:00 AM,48,-122,0,1,1
4014,58thStGreenway22ndAve,06/17/2014 06:00:00 AM,48,-122,2,4,6
4015,58thStGreenway22ndAve,06/17/2014 07:00:00 AM,48,-122,15,4,19
4016,58thStGreenway22ndAve,06/17/2014 08:00:00 AM,48,-122,18,12,30
4017,58thStGreenway22ndAve,06/17/2014 09:00:00 AM,48,-122,21,6,27
4018,58thStGreenway22ndAve,06/17/2014 10:00:00 AM,48,-122,16,16,32
4019,58thStGreenway22ndAve,06/17/2014 11:00:00 AM,48,-122,11,12,23
4020,58thStGreenway22ndAve,06/17/2014 12:00:00 PM,48,-122,36,22,58
4021,58thStGreenway22ndAve,06/17/2014 01:00:00 PM,48,-122,19,19,38
4022,58thStGreenway22ndAve,06/17/2014 02:00:00 PM,48,-122,25,17,42
4023,58thStGreenway22ndAve,06/17/2014 03:00:00 PM,48,-122,11,14,25
4024,58thStGreenway22ndAve,06/17/2014 04:00:00 PM,48,-122,29,17,46
4025,58thStGreenway22ndAve,06/17/2014 05:00:00 PM,48,-122,26,17,43
4026,58thStGreenway22ndAve,06/17/2014 06:00:00 PM,48,-122,25,16,41
4027,58thStGreenway22ndAve,06/17/2014 07:00:00 PM,48,-122,29,16,45
4028,58thStGreenway22ndAve,06/17/2014 08:00:00 PM,48,-122,14,11,25
4029,58thStGreenway22ndAve,06/17/2014 09:00:00 PM,48,-122,11,2,13
4030,58thStGreenway22ndAve,06/17/2014 10:00:00 PM,48,-122,10,0,10
4031,58thStGreenway22ndAve,06/17/2014 11:00:00 PM,48,-122,1,0,1
4032,58thStGreenway22ndAve,06/18/2014 12:00:00 AM,48,-122,2,0,2
4033,58thStGreenway22ndAve,06/18/2014 01:00:00 AM,48,-122,2,2,4
4034,58thStGreenway22ndAve,06/18/2014 02:00:00 AM,48,-122,4,0,4
4035,58thStGreenway22ndAve,06/18/2014 03:00:00 AM,48,-122,0,0,0
4036,58thStGreenway22ndAve,06/18/2014 04:00:00 AM,48,-122,2,0,2
4037,58thStGreenway22ndAve,06/18/2014 05:00:00 AM,48,-122,0,0,0
4038,58thStGreenway22ndAve,06/18/2014 06:00:00 AM,48,-122,10,5,15
4039,58thStGreenway22ndAve,06/18/2014 07:00:00 AM,48,-122,22,9,31
4040,58thStGreenway22ndAve,06/18/2014 08:00:00 AM,48,-122,12,5,17
4041,58thStGreenway22ndAve,06/18/2014 09:00:00 AM,48,-122,22,7,29
4042,58thStGreenway22ndAve,06/18/2014 10:00:00 AM,48,-122,8,4,12
4043,58thStGreenway22ndAve,06/18/2014 11:00:00 AM,48,-122,23,20,43
4044,58thStGreenway22ndAve,06/18/2014 12:00:00 PM,48,-122,20,13,33
4045,58thStGreenway22ndAve,06/18/2014 01:00:00 PM,48,-122,17,12,29
4046,58thStGreenway22ndAve,06/18/2014 02:00:00 PM,48,-122,23,13,36
4047,58thStGreenway22ndAve,06/18/2014 03:00:00 PM,48,-122,24,10,34
4048,58thStGreenway22ndAve,06/18/2014 04:00:00 PM,48,-122,32,14,46
4049,58thStGreenway22ndAve,06/18/2014 05:00:00 PM,48,-122,40,31,71
4050,58thStGreenway22ndAve,06/18/2014 06:00:00 PM,48,-122,41,15,56
4051,58thStGreenway22ndAve,06/18/2014 07:00:00 PM,48,-122,30,14,44
4052,58thStGreenway22ndAve,06/18/2014 08:00:00 PM,48,-122,27,8,35
4053,58thStGreenway22ndAve,06/18/2014 09:00:00 PM,48,-122,33,3,36
4054,58thStGreenway22ndAve,06/18/2014 10:00:00 PM,48,-122,6,1,7
4055,58thStGreenway22ndAve,06/18/2014 11:00:00 PM,48,-122,8,3,11
4056,58thStGreenway22ndAve,06/19/2014 12:00:00 AM,48,-122,0,1,1
4057,58thStGreenway22ndAve,06/19/2014 01:00:00 AM,48,-122,2,0,2
4058,58thStGreenway22ndAve,06/19/2014 02:00:00 AM,48,-122,3,0,3
4059,58thStGreenway22ndAve,06/19/2014 03:00:00 AM,48,-122,0,0,0
4060,58thStGreenway22ndAve,06/19/2014 04:00:00 AM,48,-122,2,0,2
4061,58thStGreenway22ndAve,06/19/2014 05:00:00 AM,48,-122,2,0,2
4062,58thStGreenway22ndAve,06/19/2014 06:00:00 AM,48,-122,15,3,18
4063,58thStGreenway22ndAve,06/19/2014 07:00:00 AM,48,-122,23,2,25
4064,58thStGreenway22ndAve,06/19/2014 08:00:00 AM,48,-122,24,16,40
4065,58thStGreenway22ndAve,06/19/2014 09:00:00 AM,48,-122,34,12,46
4066,58thStGreenway22ndAve,06/19/2014 10:00:00 AM,48,-122,14,10,24
4067,58thStGreenway22ndAve,06/19/2014 11:00:00 AM,48,-122,22,12,34
4068,58thStGreenway22ndAve,06/19/2014 12:00:00 PM,48,-122,13,20,33
4069,58thStGreenway22ndAve,06/19/2014 01:00:00 PM,48,-122,29,17,46
4070,58thStGreenway22ndAve,06/19/2014 02:00:00 PM,48,-122,32,10,42
4071,58thStGreenway22ndAve,06/19/2014 03:00:00 PM,48,-122,17,21,38
4072,58thStGreenway22ndAve,06/19/2014 04:00:00 PM,48,-122,24,35,59
4073,58thStGreenway22ndAve,06/19/2014 05:00:00 PM,48,-122,38,10,48
4074,58thStGreenway22ndAve,06/19/2014 06:00:00 PM,48,-122,18,17,35
4075,58thStGreenway22ndAve,06/19/2014 07:00:00 PM,48,-122,34,14,48
4076,58thStGreenway22ndAve,06/19/2014 08:00:00 PM,48,-122,13,8,21
4077,58thStGreenway22ndAve,06/19/2014 09:00:00 PM,48,-122,20,4,24
4078,58thStGreenway22ndAve,06/19/2014 10:00:00 PM,48,-122,8,3,11
4079,58thStGreenway22ndAve,06/19/2014 11:00:00 PM,48,-122,3,1,4
4080,58thStGreenway22ndAve,06/20/2014 12:00:00 AM,48,-122,4,1,5
4081,58thStGreenway22ndAve,06/20/2014 01:00:00 AM,48,-122,0,2,2
4082,58thStGreenway22ndAve,06/20/2014 02:00:00 AM,48,-122,0,0,0
4083,58thStGreenway22ndAve,06/20/2014 03:00:00 AM,48,-122,0,0,0
4084,58thStGreenway22ndAve,06/20/2014 04:00:00 AM,48,-122,2,0,2
4085,58thStGreenway22ndAve,06/20/2014 05:00:00 AM,48,-122,0,0,0
4086,58thStGreenway22ndAve,06/20/2014 06:00:00 AM,48,-122,10,4,14
4087,58thStGreenway22ndAve,06/20/2014 07:00:00 AM,48,-122,24,4,28
4088,58thStGreenway22ndAve,06/20/2014 08:00:00 AM,48,-122,16,20,36
4089,58thStGreenway22ndAve,06/20/2014 09:00:00 AM,48,-122,25,13,38
4090,58thStGreenway22ndAve,06/20/2014 10:00:00 AM,48,-122,22,12,34
4091,58thStGreenway22ndAve,06/20/2014 11:00:00 AM,48,-122,13,13,26
4092,58thStGreenway22ndAve,06/20/2014 12:00:00 PM,48,-122,42,28,70
4093,58thStGreenway22ndAve,06/20/2014 01:00:00 PM,48,-122,18,14,32
4094,58thStGreenway22ndAve,06/20/2014 02:00:00 PM,48,-122,27,19,46
4095,58thStGreenway22ndAve,06/20/2014 03:00:00 PM,48,-122,18,19,37
4096,58thStGreenway22ndAve,06/20/2014 04:00:00 PM,48,-122,16,13,29
4097,58thStGreenway22ndAve,06/20/2014 05:00:00 PM,48,-122,31,20,51
4098,58thStGreenway22ndAve,06/20/2014 06:00:00 PM,48,-122,39,19,58
4099,58thStGreenway22ndAve,06/20/2014 07:00:00 PM,48,-122,21,12,33
4100,58thStGreenway22ndAve,06/20/2014 08:00:00 PM,48,-122,14,6,20
4101,58thStGreenway22ndAve,06/20/2014 09:00:00 PM,48,-122,4,6,10
4102,58thStGreenway22ndAve,06/20/2014 10:00:00 PM,48,-122,15,3,18
4103,58thStGreenway22ndAve,06/20/2014 11:00:00 PM,48,-122,13,3,16
4104,58thStGreenway22ndAve,06/21/2014 12:00:00 AM,48,-122,5,2,7
4105,58thStGreenway22ndAve,06/21/2014 01:00:00 AM,48,-122,4,2,6
4106,58thStGreenway22ndAve,06/21/2014 02:00:00 AM,48,-122,4,0,4
4107,58thStGreenway22ndAve,06/21/2014 03:00:00 AM,48,-122,2,0,2
4108,58thStGreenway22ndAve,06/21/2014 04:00:00 AM,48,-122,0,0,0
4109,58thStGreenway22ndAve,06/21/2014 05:00:00 AM,48,-122,2,0,2
4110,58thStGreenway22ndAve,06/21/2014 06:00:00 AM,48,-122,0,4,4
4111,58thStGreenway22ndAve,06/21/2014 07:00:00 AM,48,-122,5,1,6
4112,58thStGreenway22ndAve,06/21/2014 08:00:00 AM,48,-122,8,7,15
4113,58thStGreenway22ndAve,06/21/2014 09:00:00 AM,48,-122,22,15,37
4114,58thStGreenway22ndAve,06/21/2014 10:00:00 AM,48,-122,17,19,36
4115,58thStGreenway22ndAve,06/21/2014 11:00:00 AM,48,-122,7,28,35
4116,58thStGreenway22ndAve,06/21/2014 12:00:00 PM,48,-122,20,12,32
4117,58thStGreenway22ndAve,06/21/2014 01:00:00 PM,48,-122,46,21,67
4118,58thStGreenway22ndAve,06/21/2014 02:00:00 PM,48,-122,65,20,85
4119,58thStGreenway22ndAve,06/21/2014 03:00:00 PM,48,-122,23,21,44
4120,58thStGreenway22ndAve,06/21/2014 04:00:00 PM,48,-122,20,16,36
4121,58thStGreenway22ndAve,06/21/2014 05:00:00 PM,48,-122,27,28,55
4122,58thStGreenway22ndAve,06/21/2014 06:00:00 PM,48,-122,30,18,48
4123,58thStGreenway22ndAve,06/21/2014 07:00:00 PM,48,-122,34,11,45
4124,58thStGreenway22ndAve,06/21/2014 08:00:00 PM,48,-122,20,15,35
4125,58thStGreenway22ndAve,06/21/2014 09:00:00 PM,48,-122,25,7,32
4126,58thStGreenway22ndAve,06/21/2014 10:00:00 PM,48,-122,7,0,7
4127,58thStGreenway22ndAve,06/21/2014 11:00:00 PM,48,-122,2,3,5
4128,58thStGreenway22ndAve,06/22/2014 12:00:00 AM,48,-122,7,3,10
4129,58thStGreenway22ndAve,06/22/2014 01:00:00 AM,48,-122,1,1,2
4130,58thStGreenway22ndAve,06/22/2014 02:00:00 AM,48,-122,3,0,3
4131,58thStGreenway22ndAve,06/22/2014 03:00:00 AM,48,-122,0,0,0
4132,58thStGreenway22ndAve,06/22/2014 04:00:00 AM,48,-122,0,0,0
4133,58thStGreenway22ndAve,06/22/2014 05:00:00 AM,48,-122,4,0,4
4134,58thStGreenway22ndAve,06/22/2014 06:00:00 AM,48,-122,2,0,2
4135,58thStGreenway22ndAve,06/22/2014 07:00:00 AM,48,-122,7,2,9
4136,58thStGreenway22ndAve,06/22/2014 08:00:00 AM,48,-122,5,7,12
4137,58thStGreenway22ndAve,06/22/2014 09:00:00 AM,48,-122,13,7,20
4138,58thStGreenway22ndAve,06/22/2014 10:00:00 AM,48,-122,18,9,27
4139,58thStGreenway22ndAve,06/22/2014 11:00:00 AM,48,-122,17,14,31
4140,58thStGreenway22ndAve,06/22/2014 12:00:00 PM,48,-122,36,31,67
4141,58thStGreenway22ndAve,06/22/2014 01:00:00 PM,48,-122,46,31,77
4142,58thStGreenway22ndAve,06/22/2014 02:00:00 PM,48,-122,41,23,64
4143,58thStGreenway22ndAve,06/22/2014 03:00:00 PM,48,-122,42,13,55
4144,58thStGreenway22ndAve,06/22/2014 04:00:00 PM,48,-122,29,11,40
4145,58thStGreenway22ndAve,06/22/2014 05:00:00 PM,48,-122,36,21,57
4146,58thStGreenway22ndAve,06/22/2014 06:00:00 PM,48,-122,25,22,47
4147,58thStGreenway22ndAve,06/22/2014 07:00:00 PM,48,-122,18,5,23
4148,58thStGreenway22ndAve,06/22/2014 08:00:00 PM,48,-122,17,2,19
4149,58thStGreenway22ndAve,06/22/2014 09:00:00 PM,48,-122,12,3,15
4150,58thStGreenway22ndAve,06/22/2014 10:00:00 PM,48,-122,2,2,4
4151,58thStGreenway22ndAve,06/22/2014 11:00:00 PM,48,-122,6,1,7
4152,58thStGreenway22ndAve,06/23/2014 12:00:00 AM,48,-122,1,0,1
4153,58thStGreenway22ndAve,06/23/2014 01:00:00 AM,48,-122,0,0,0
4154,58thStGreenway22ndAve,06/23/2014 02:00:00 AM,48,-122,0,0,0
4155,58thStGreenway22ndAve,06/23/2014 03:00:00 AM,48,-122,0,0,0
4156,58thStGreenway22ndAve,06/23/2014 04:00:00 AM,48,-122,2,0,2
4157,58thStGreenway22ndAve,06/23/2014 05:00:00 AM,48,-122,4,0,4
4158,58thStGreenway22ndAve,06/23/2014 06:00:00 AM,48,-122,4,4,8
4159,58thStGreenway22ndAve,06/23/2014 07:00:00 AM,48,-122,9,5,14
4160,58thStGreenway22ndAve,06/23/2014 08:00:00 AM,48,-122,16,11,27
4161,58thStGreenway22ndAve,06/23/2014 09:00:00 AM,48,-122,14,13,27
4162,58thStGreenway22ndAve,06/23/2014 10:00:00 AM,48,-122,12,8,20
4163,58thStGreenway22ndAve,06/23/2014 11:00:00 AM,48,-122,31,14,45
4164,58thStGreenway22ndAve,06/23/2014 12:00:00 PM,48,-122,27,12,39
4165,58thStGreenway22ndAve,06/23/2014 01:00:00 PM,48,-122,16,9,25
4166,58thStGreenway22ndAve,06/23/2014 02:00:00 PM,48,-122,11,16,27
4167,58thStGreenway22ndAve,06/23/2014 03:00:00 PM,48,-122,27,6,33
4168,58thStGreenway22ndAve,06/23/2014 04:00:00 PM,48,-122,18,7,25
4169,58thStGreenway22ndAve,06/23/2014 05:00:00 PM,48,-122,36,8,44
4170,58thStGreenway22ndAve,06/23/2014 06:00:00 PM,48,-122,20,12,32
4171,58thStGreenway22ndAve,06/23/2014 07:00:00 PM,48,-122,15,12,27
4172,58thStGreenway22ndAve,06/23/2014 08:00:00 PM,48,-122,19,6,25
4173,58thStGreenway22ndAve,06/23/2014 09:00:00 PM,48,-122,13,4,17
4174,58thStGreenway22ndAve,06/23/2014 10:00:00 PM,48,-122,3,0,3
4175,58thStGreenway22ndAve,06/23/2014 11:00:00 PM,48,-122,4,0,4
4176,58thStGreenway22ndAve,06/24/2014 12:00:00 AM,48,-122,1,0,1
4177,58thStGreenway22ndAve,06/24/2014 01:00:00 AM,48,-122,1,0,1
4178,58thStGreenway22ndAve,06/24/2014 02:00:00 AM,48,-122,4,2,6
4179,58thStGreenway22ndAve,06/24/2014 03:00:00 AM,48,-122,2,0,2
4180,58thStGreenway22ndAve,06/24/2014 04:00:00 AM,48,-122,2,0,2
4181,58thStGreenway22ndAve,06/24/2014 05:00:00 AM,48,-122,4,0,4
4182,58thStGreenway22ndAve,06/24/2014 06:00:00 AM,48,-122,9,2,11
4183,58thStGreenway22ndAve,06/24/2014 07:00:00 AM,48,-122,13,3,16
4184,58thStGreenway22ndAve,06/24/2014 08:00:00 AM,48,-122,10,11,21
4185,58thStGreenway22ndAve,06/24/2014 09:00:00 AM,48,-122,23,11,34
4186,58thStGreenway22ndAve,06/24/2014 10:00:00 AM,48,-122,15,10,25
4187,58thStGreenway22ndAve,06/24/2014 11:00:00 AM,48,-122,12,11,23
4188,58thStGreenway22ndAve,06/24/2014 12:00:00 PM,48,-122,23,11,34
4189,58thStGreenway22ndAve,06/24/2014 01:00:00 PM,48,-122,15,9,24
4190,58thStGreenway22ndAve,06/24/2014 02:00:00 PM,48,-122,18,8,26
4191,58thStGreenway22ndAve,06/24/2014 03:00:00 PM,48,-122,25,8,33
4192,58thStGreenway22ndAve,06/24/2014 04:00:00 PM,48,-122,51,15,66
4193,58thStGreenway22ndAve,06/24/2014 05:00:00 PM,48,-122,26,18,44
4194,58thStGreenway22ndAve,06/24/2014 06:00:00 PM,48,-122,36,12,48
4195,58thStGreenway22ndAve,06/24/2014 07:00:00 PM,48,-122,27,27,54
4196,58thStGreenway22ndAve,06/24/2014 08:00:00 PM,48,-122,17,5,22
4197,58thStGreenway22ndAve,06/24/2014 09:00:00 PM,48,-122,7,2,9
4198,58thStGreenway22ndAve,06/24/2014 10:00:00 PM,48,-122,10,2,12
4199,58thStGreenway22ndAve,06/24/2014 11:00:00 PM,48,-122,5,3,8
4200,58thStGreenway22ndAve,06/25/2014 12:00:00 AM,48,-122,2,0,2
4201,58thStGreenway22ndAve,06/25/2014 01:00:00 AM,48,-122,4,0,4
4202,58thStGreenway22ndAve,06/25/2014 02:00:00 AM,48,-122,0,0,0
4203,58thStGreenway22ndAve,06/25/2014 03:00:00 AM,48,-122,0,0,0
4204,58thStGreenway22ndAve,06/25/2014 04:00:00 AM,48,-122,2,0,2
4205,58thStGreenway22ndAve,06/25/2014 05:00:00 AM,48,-122,0,2,2
4206,58thStGreenway22ndAve,06/25/2014 06:00:00 AM,48,-122,3,2,5
4207,58thStGreenway22ndAve,06/25/2014 07:00:00 AM,48,-122,12,3,15
4208,58thStGreenway22ndAve,06/25/2014 08:00:00 AM,48,-122,28,14,42
4209,58thStGreenway22ndAve,06/25/2014 09:00:00 AM,48,-122,27,8,35
4210,58thStGreenway22ndAve,06/25/2014 10:00:00 AM,48,-122,15,3,18
4211,58thStGreenway22ndAve,06/25/2014 11:00:00 AM,48,-122,34,22,56
4212,58thStGreenway22ndAve,06/25/2014 12:00:00 PM,48,-122,39,17,56
4213,58thStGreenway22ndAve,06/25/2014 01:00:00 PM,48,-122,31,17,48
4214,58thStGreenway22ndAve,06/25/2014 02:00:00 PM,48,-122,30,5,35
4215,58thStGreenway22ndAve,06/25/2014 03:00:00 PM,48,-122,25,7,32
4216,58thStGreenway22ndAve,06/25/2014 04:00:00 PM,48,-122,23,18,41
4217,58thStGreenway22ndAve,06/25/2014 05:00:00 PM,48,-122,28,6,34
4218,58thStGreenway22ndAve,06/25/2014 06:00:00 PM,48,-122,27,13,40
4219,58thStGreenway22ndAve,06/25/2014 07:00:00 PM,48,-122,20,13,33
4220,58thStGreenway22ndAve,06/25/2014 08:00:00 PM,48,-122,22,5,27
4221,58thStGreenway22ndAve,06/25/2014 09:00:00 PM,48,-122,13,3,16
4222,58thStGreenway22ndAve,06/25/2014 10:00:00 PM,48,-122,17,3,20
4223,58thStGreenway22ndAve,06/25/2014 11:00:00 PM,48,-122,5,3,8
4224,58thStGreenway22ndAve,06/26/2014 12:00:00 AM,48,-122,6,0,6
4225,58thStGreenway22ndAve,06/26/2014 01:00:00 AM,48,-122,2,0,2
4226,58thStGreenway22ndAve,06/26/2014 02:00:00 AM,48,-122,5,0,5
4227,58thStGreenway22ndAve,06/26/2014 03:00:00 AM,48,-122,0,0,0
4228,58thStGreenway22ndAve,06/26/2014 04:00:00 AM,48,-122,0,0,0
4229,58thStGreenway22ndAve,06/26/2014 05:00:00 AM,48,-122,1,1,2
4230,58thStGreenway22ndAve,06/26/2014 06:00:00 AM,48,-122,1,1,2
4231,58thStGreenway22ndAve,06/26/2014 07:00:00 AM,48,-122,13,7,20
4232,58thStGreenway22ndAve,06/26/2014 08:00:00 AM,48,-122,34,3,37
4233,58thStGreenway22ndAve,06/26/2014 09:00:00 AM,48,-122,29,16,45
4234,58thStGreenway22ndAve,06/26/2014 10:00:00 AM,48,-122,29,9,38
4235,58thStGreenway22ndAve,06/26/2014 11:00:00 AM,48,-122,31,10,41
4236,58thStGreenway22ndAve,06/26/2014 12:00:00 PM,48,-122,35,7,42
4237,58thStGreenway22ndAve,06/26/2014 01:00:00 PM,48,-122,30,3,33
4238,58thStGreenway22ndAve,06/26/2014 02:00:00 PM,48,-122,25,7,32
4239,58thStGreenway22ndAve,06/26/2014 03:00:00 PM,48,-122,10,4,14
4240,58thStGreenway22ndAve,06/26/2014 04:00:00 PM,48,-122,26,16,42
4241,58thStGreenway22ndAve,06/26/2014 05:00:00 PM,48,-122,22,13,35
4242,58thStGreenway22ndAve,06/26/2014 06:00:00 PM,48,-122,28,16,44
4243,58thStGreenway22ndAve,06/26/2014 07:00:00 PM,48,-122,20,9,29
4244,58thStGreenway22ndAve,06/26/2014 08:00:00 PM,48,-122,15,5,20
4245,58thStGreenway22ndAve,06/26/2014 09:00:00 PM,48,-122,15,10,25
4246,58thStGreenway22ndAve,06/26/2014 10:00:00 PM,48,-122,5,4,9
4247,58thStGreenway22ndAve,06/26/2014 11:00:00 PM,48,-122,5,0,5
4248,58thStGreenway22ndAve,06/27/2014 12:00:00 AM,48,-122,4,0,4
4249,58thStGreenway22ndAve,06/27/2014 01:00:00 AM,48,-122,1,0,1
4250,58thStGreenway22ndAve,06/27/2014 02:00:00 AM,48,-122,0,0,0
4251,58thStGreenway22ndAve,06/27/2014 03:00:00 AM,48,-122,2,0,2
4252,58thStGreenway22ndAve,06/27/2014 04:00:00 AM,48,-122,3,0,3
4253,58thStGreenway22ndAve,06/27/2014 05:00:00 AM,48,-122,2,0,2
4254,58thStGreenway22ndAve,06/27/2014 06:00:00 AM,48,-122,4,3,7
4255,58thStGreenway22ndAve,06/27/2014 07:00:00 AM,48,-122,12,7,19
4256,58thStGreenway22ndAve,06/27/2014 08:00:00 AM,48,-122,14,7,21
4257,58thStGreenway22ndAve,06/27/2014 09:00:00 AM,48,-122,17,10,27
4258,58thStGreenway22ndAve,06/27/2014 10:00:00 AM,48,-122,24,8,32
4259,58thStGreenway22ndAve,06/27/2014 11:00:00 AM,48,-122,21,5,26
4260,58thStGreenway22ndAve,06/27/2014 12:00:00 PM,48,-122,15,11,26
4261,58thStGreenway22ndAve,06/27/2014 01:00:00 PM,48,-122,15,11,26
4262,58thStGreenway22ndAve,06/27/2014 02:00:00 PM,48,-122,18,18,36
4263,58thStGreenway22ndAve,06/27/2014 03:00:00 PM,48,-122,17,6,23
4264,58thStGreenway22ndAve,06/27/2014 04:00:00 PM,48,-122,23,13,36
4265,58thStGreenway22ndAve,06/27/2014 05:00:00 PM,48,-122,27,17,44
4266,58thStGreenway22ndAve,06/27/2014 06:00:00 PM,48,-122,18,10,28
4267,58thStGreenway22ndAve,06/27/2014 07:00:00 PM,48,-122,21,5,26
4268,58thStGreenway22ndAve,06/27/2014 08:00:00 PM,48,-122,7,7,14
4269,58thStGreenway22ndAve,06/27/2014 09:00:00 PM,48,-122,12,4,16
4270,58thStGreenway22ndAve,06/27/2014 10:00:00 PM,48,-122,14,3,17
4271,58thStGreenway22ndAve,06/27/2014 11:00:00 PM,48,-122,4,2,6
4272,58thStGreenway22ndAve,06/28/2014 12:00:00 AM,48,-122,13,4,17
4273,58thStGreenway22ndAve,06/28/2014 01:00:00 AM,48,-122,0,0,0
4274,58thStGreenway22ndAve,06/28/2014 02:00:00 AM,48,-122,1,0,1
4275,58thStGreenway22ndAve,06/28/2014 03:00:00 AM,48,-122,0,1,1
4276,58thStGreenway22ndAve,06/28/2014 04:00:00 AM,48,-122,0,0,0
4277,58thStGreenway22ndAve,06/28/2014 05:00:00 AM,48,-122,3,0,3
4278,58thStGreenway22ndAve,06/28/2014 06:00:00 AM,48,-122,0,1,1
4279,58thStGreenway22ndAve,06/28/2014 07:00:00 AM,48,-122,6,1,7
4280,58thStGreenway22ndAve,06/28/2014 08:00:00 AM,48,-122,9,4,13
4281,58thStGreenway22ndAve,06/28/2014 09:00:00 AM,48,-122,16,11,27
4282,58thStGreenway22ndAve,06/28/2014 10:00:00 AM,48,-122,17,10,27
4283,58thStGreenway22ndAve,06/28/2014 11:00:00 AM,48,-122,26,11,37
4284,58thStGreenway22ndAve,06/28/2014 12:00:00 PM,48,-122,35,24,59
4285,58thStGreenway22ndAve,06/28/2014 01:00:00 PM,48,-122,15,17,32
4286,58thStGreenway22ndAve,06/28/2014 02:00:00 PM,48,-122,33,16,49
4287,58thStGreenway22ndAve,06/28/2014 03:00:00 PM,48,-122,27,15,42
4288,58thStGreenway22ndAve,06/28/2014 04:00:00 PM,48,-122,21,19,40
4289,58thStGreenway22ndAve,06/28/2014 05:00:00 PM,48,-122,17,17,34
4290,58thStGreenway22ndAve,06/28/2014 06:00:00 PM,48,-122,18,9,27
4291,58thStGreenway22ndAve,06/28/2014 07:00:00 PM,48,-122,31,11,42
4292,58thStGreenway22ndAve,06/28/2014 08:00:00 PM,48,-122,10,5,15
4293,58thStGreenway22ndAve,06/28/2014 09:00:00 PM,48,-122,15,4,19
4294,58thStGreenway22ndAve,06/28/2014 10:00:00 PM,48,-122,16,1,17
4295,58thStGreenway22ndAve,06/28/2014 11:00:00 PM,48,-122,9,2,11
4296,58thStGreenway22ndAve,06/29/2014 12:00:00 AM,48,-122,4,0,4
4297,58thStGreenway22ndAve,06/29/2014 01:00:00 AM,48,-122,2,0,2
4298,58thStGreenway22ndAve,06/29/2014 02:00:00 AM,48,-122,1,2,3
4299,58thStGreenway22ndAve,06/29/2014 03:00:00 AM,48,-122,0,0,0
4300,58thStGreenway22ndAve,06/29/2014 04:00:00 AM,48,-122,0,0,0
4301,58thStGreenway22ndAve,06/29/2014 05:00:00 AM,48,-122,2,0,2
4302,58thStGreenway22ndAve,06/29/2014 06:00:00 AM,48,-122,4,1,5
4303,58thStGreenway22ndAve,06/29/2014 07:00:00 AM,48,-122,2,1,3
4304,58thStGreenway22ndAve,06/29/2014 08:00:00 AM,48,-122,4,5,9
4305,58thStGreenway22ndAve,06/29/2014 09:00:00 AM,48,-122,16,7,23
4306,58thStGreenway22ndAve,06/29/2014 10:00:00 AM,48,-122,27,8,35
4307,58thStGreenway22ndAve,06/29/2014 11:00:00 AM,48,-122,24,20,44
4308,58thStGreenway22ndAve,06/29/2014 12:00:00 PM,48,-122,25,13,38
4309,58thStGreenway22ndAve,06/29/2014 01:00:00 PM,48,-122,31,17,48
4310,58thStGreenway22ndAve,06/29/2014 02:00:00 PM,48,-122,33,15,48
4311,58thStGreenway22ndAve,06/29/2014 03:00:00 PM,48,-122,24,18,42
4312,58thStGreenway22ndAve,06/29/2014 04:00:00 PM,48,-122,31,12,43
4313,58thStGreenway22ndAve,06/29/2014 05:00:00 PM,48,-122,13,8,21
4314,58thStGreenway22ndAve,06/29/2014 06:00:00 PM,48,-122,22,10,32
4315,58thStGreenway22ndAve,06/29/2014 07:00:00 PM,48,-122,22,11,33
4316,58thStGreenway22ndAve,06/29/2014 08:00:00 PM,48,-122,8,0,8
4317,58thStGreenway22ndAve,06/29/2014 09:00:00 PM,48,-122,18,3,21
4318,58thStGreenway22ndAve,06/29/2014 10:00:00 PM,48,-122,11,1,12
4319,58thStGreenway22ndAve,06/29/2014 11:00:00 PM,48,-122,1,3,4
4320,58thStGreenway22ndAve,06/30/2014 12:00:00 AM,48,-122,2,0,2
4321,58thStGreenway22ndAve,06/30/2014 01:00:00 AM,48,-122,1,2,3
4322,58thStGreenway22ndAve,06/30/2014 02:00:00 AM,48,-122,0,0,0
4323,58thStGreenway22ndAve,06/30/2014 03:00:00 AM,48,-122,0,0,0
4324,58thStGreenway22ndAve,06/30/2014 04:00:00 AM,48,-122,0,2,2
4325,58thStGreenway22ndAve,06/30/2014 05:00:00 AM,48,-122,2,2,4
4326,58thStGreenway22ndAve,06/30/2014 06:00:00 AM,48,-122,9,3,12
4327,58thStGreenway22ndAve,06/30/2014 07:00:00 AM,48,-122,8,3,11
4328,58thStGreenway22ndAve,06/30/2014 08:00:00 AM,48,-122,32,7,39
4329,58thStGreenway22ndAve,06/30/2014 09:00:00 AM,48,-122,13,7,20
4330,58thStGreenway22ndAve,06/30/2014 10:00:00 AM,48,-122,6,10,16
4331,58thStGreenway22ndAve,06/30/2014 11:00:00 AM,48,-122,16,7,23
4332,58thStGreenway22ndAve,06/30/2014 12:00:00 PM,48,-122,15,10,25
4333,58thStGreenway22ndAve,06/30/2014 01:00:00 PM,48,-122,33,11,44
4334,58thStGreenway22ndAve,06/30/2014 02:00:00 PM,48,-122,29,14,43
4335,58thStGreenway22ndAve,06/30/2014 03:00:00 PM,48,-122,21,17,38
4336,58thStGreenway22ndAve,06/30/2014 04:00:00 PM,48,-122,61,14,75
4337,58thStGreenway22ndAve,06/30/2014 05:00:00 PM,48,-122,67,30,97
4338,58thStGreenway22ndAve,06/30/2014 06:00:00 PM,48,-122,62,14,76
4339,58thStGreenway22ndAve,06/30/2014 07:00:00 PM,48,-122,49,14,63
4340,58thStGreenway22ndAve,06/30/2014 08:00:00 PM,48,-122,15,3,18
4341,58thStGreenway22ndAve,06/30/2014 09:00:00 PM,48,-122,13,1,14
4342,58thStGreenway22ndAve,06/30/2014 10:00:00 PM,48,-122,10,2,12
4343,58thStGreenway22ndAve,06/30/2014 11:00:00 PM,48,-122,8,0,8
4344,58thStGreenway22ndAve,07/01/2014 12:00:00 AM,48,-122,0,1,1
4345,58thStGreenway22ndAve,07/01/2014 01:00:00 AM,48,-122,2,1,3
4346,58thStGreenway22ndAve,07/01/2014 02:00:00 AM,48,-122,0,0,0
4347,58thStGreenway22ndAve,07/01/2014 03:00:00 AM,48,-122,2,0,2
4348,58thStGreenway22ndAve,07/01/2014 04:00:00 AM,48,-122,0,0,0
4349,58thStGreenway22ndAve,07/01/2014 05:00:00 AM,48,-122,2,1,3
4350,58thStGreenway22ndAve,07/01/2014 06:00:00 AM,48,-122,4,4,8
4351,58thStGreenway22ndAve,07/01/2014 07:00:00 AM,48,-122,17,7,24
4352,58thStGreenway22ndAve,07/01/2014 08:00:00 AM,48,-122,41,7,48
4353,58thStGreenway22ndAve,07/01/2014 09:00:00 AM,48,-122,28,11,39
4354,58thStGreenway22ndAve,07/01/2014 10:00:00 AM,48,-122,33,19,52
4355,58thStGreenway22ndAve,07/01/2014 11:00:00 AM,48,-122,36,16,52
4356,58thStGreenway22ndAve,07/01/2014 12:00:00 PM,48,-122,36,17,53
4357,58thStGreenway22ndAve,07/01/2014 01:00:00 PM,48,-122,35,12,47
4358,58thStGreenway22ndAve,07/01/2014 02:00:00 PM,48,-122,34,8,42
4359,58thStGreenway22ndAve,07/01/2014 03:00:00 PM,48,-122,25,20,45
4360,58thStGreenway22ndAve,07/01/2014 04:00:00 PM,48,-122,49,9,58
4361,58thStGreenway22ndAve,07/01/2014 05:00:00 PM,48,-122,36,10,46
4362,58thStGreenway22ndAve,07/01/2014 06:00:00 PM,48,-122,41,17,58
4363,58thStGreenway22ndAve,07/01/2014 07:00:00 PM,48,-122,31,17,48
4364,58thStGreenway22ndAve,07/01/2014 08:00:00 PM,48,-122,24,10,34
4365,58thStGreenway22ndAve,07/01/2014 09:00:00 PM,48,-122,18,8,26
4366,58thStGreenway22ndAve,07/01/2014 10:00:00 PM,48,-122,4,5,9
4367,58thStGreenway22ndAve,07/01/2014 11:00:00 PM,48,-122,9,1,10
4368,58thStGreenway22ndAve,07/02/2014 12:00:00 AM,48,-122,6,0,6
4369,58thStGreenway22ndAve,07/02/2014 01:00:00 AM,48,-122,3,0,3
4370,58thStGreenway22ndAve,07/02/2014 02:00:00 AM,48,-122,0,0,0
4371,58thStGreenway22ndAve,07/02/2014 03:00:00 AM,48,-122,0,0,0
4372,58thStGreenway22ndAve,07/02/2014 04:00:00 AM,48,-122,0,0,0
4373,58thStGreenway22ndAve,07/02/2014 05:00:00 AM,48,-122,3,1,4
4374,58thStGreenway22ndAve,07/02/2014 06:00:00 AM,48,-122,11,4,15
4375,58thStGreenway22ndAve,07/02/2014 07:00:00 AM,48,-122,20,4,24
4376,58thStGreenway22ndAve,07/02/2014 08:00:00 AM,48,-122,18,10,28
4377,58thStGreenway22ndAve,07/02/2014 09:00:00 AM,48,-122,20,6,26
4378,58thStGreenway22ndAve,07/02/2014 10:00:00 AM,48,-122,8,17,25
4379,58thStGreenway22ndAve,07/02/2014 11:00:00 AM,48,-122,16,15,31
4380,58thStGreenway22ndAve,07/02/2014 12:00:00 PM,48,-122,44,16,60
4381,58thStGreenway22ndAve,07/02/2014 01:00:00 PM,48,-122,21,17,38
4382,58thStGreenway22ndAve,07/02/2014 02:00:00 PM,48,-122,28,7,35
4383,58thStGreenway22ndAve,07/02/2014 03:00:00 PM,48,-122,22,9,31
4384,58thStGreenway22ndAve,07/02/2014 04:00:00 PM,48,-122,23,15,38
4385,58thStGreenway22ndAve,07/02/2014 05:00:00 PM,48,-122,28,15,43
4386,58thStGreenway22ndAve,07/02/2014 06:00:00 PM,48,-122,35,20,55
4387,58thStGreenway22ndAve,07/02/2014 07:00:00 PM,48,-122,24,5,29
4388,58thStGreenway22ndAve,07/02/2014 08:00:00 PM,48,-122,13,11,24
4389,58thStGreenway22ndAve,07/02/2014 09:00:00 PM,48,-122,19,4,23
4390,58thStGreenway22ndAve,07/02/2014 10:00:00 PM,48,-122,8,3,11
4391,58thStGreenway22ndAve,07/02/2014 11:00:00 PM,48,-122,11,1,12
4392,58thStGreenway22ndAve,07/03/2014 12:00:00 AM,48,-122,5,0,5
4393,58thStGreenway22ndAve,07/03/2014 01:00:00 AM,48,-122,0,0,0
4394,58thStGreenway22ndAve,07/03/2014 02:00:00 AM,48,-122,1,0,1
4395,58thStGreenway22ndAve,07/03/2014 03:00:00 AM,48,-122,0,1,1
4396,58thStGreenway22ndAve,07/03/2014 04:00:00 AM,48,-122,0,1,1
4397,58thStGreenway22ndAve,07/03/2014 05:00:00 AM,48,-122,0,1,1
4398,58thStGreenway22ndAve,07/03/2014 06:00:00 AM,48,-122,5,3,8
4399,58thStGreenway22ndAve,07/03/2014 07:00:00 AM,48,-122,11,10,21
4400,58thStGreenway22ndAve,07/03/2014 08:00:00 AM,48,-122,28,5,33
4401,58thStGreenway22ndAve,07/03/2014 09:00:00 AM,48,-122,25,8,33
4402,58thStGreenway22ndAve,07/03/2014 10:00:00 AM,48,-122,15,8,23
4403,58thStGreenway22ndAve,07/03/2014 11:00:00 AM,48,-122,23,26,49
4404,58thStGreenway22ndAve,07/03/2014 12:00:00 PM,48,-122,34,15,49
4405,58thStGreenway22ndAve,07/03/2014 01:00:00 PM,48,-122,33,11,44
4406,58thStGreenway22ndAve,07/03/2014 02:00:00 PM,48,-122,18,15,33
4407,58thStGreenway22ndAve,07/03/2014 03:00:00 PM,48,-122,20,14,34
4408,58thStGreenway22ndAve,07/03/2014 04:00:00 PM,48,-122,21,11,32
4409,58thStGreenway22ndAve,07/03/2014 05:00:00 PM,48,-122,21,18,39
4410,58thStGreenway22ndAve,07/03/2014 06:00:00 PM,48,-122,35,15,50
4411,58thStGreenway22ndAve,07/03/2014 07:00:00 PM,48,-122,12,6,18
4412,58thStGreenway22ndAve,07/03/2014 08:00:00 PM,48,-122,24,15,39
4413,58thStGreenway22ndAve,07/03/2014 09:00:00 PM,48,-122,23,5,28
4414,58thStGreenway22ndAve,07/03/2014 10:00:00 PM,48,-122,6,0,6
4415,58thStGreenway22ndAve,07/03/2014 11:00:00 PM,48,-122,6,0,6
4416,58thStGreenway22ndAve,07/04/2014 12:00:00 AM,48,-122,4,1,5
4417,58thStGreenway22ndAve,07/04/2014 01:00:00 AM,48,-122,1,0,1
4418,58thStGreenway22ndAve,07/04/2014 02:00:00 AM,48,-122,2,0,2
4419,58thStGreenway22ndAve,07/04/2014 03:00:00 AM,48,-122,1,0,1
4420,58thStGreenway22ndAve,07/04/2014 04:00:00 AM,48,-122,0,0,0
4421,58thStGreenway22ndAve,07/04/2014 05:00:00 AM,48,-122,0,0,0
4422,58thStGreenway22ndAve,07/04/2014 06:00:00 AM,48,-122,2,4,6
4423,58thStGreenway22ndAve,07/04/2014 07:00:00 AM,48,-122,0,2,2
4424,58thStGreenway22ndAve,07/04/2014 08:00:00 AM,48,-122,3,6,9
4425,58thStGreenway22ndAve,07/04/2014 09:00:00 AM,48,-122,17,11,28
4426,58thStGreenway22ndAve,07/04/2014 10:00:00 AM,48,-122,19,10,29
4427,58thStGreenway22ndAve,07/04/2014 11:00:00 AM,48,-122,20,23,43
4428,58thStGreenway22ndAve,07/04/2014 12:00:00 PM,48,-122,35,15,50
4429,58thStGreenway22ndAve,07/04/2014 01:00:00 PM,48,-122,38,21,59
4430,58thStGreenway22ndAve,07/04/2014 02:00:00 PM,48,-122,16,4,20
4431,58thStGreenway22ndAve,07/04/2014 03:00:00 PM,48,-122,26,14,40
4432,58thStGreenway22ndAve,07/04/2014 04:00:00 PM,48,-122,20,5,25
4433,58thStGreenway22ndAve,07/04/2014 05:00:00 PM,48,-122,22,8,30
4434,58thStGreenway22ndAve,07/04/2014 06:00:00 PM,48,-122,19,5,24
4435,58thStGreenway22ndAve,07/04/2014 07:00:00 PM,48,-122,17,8,25
4436,58thStGreenway22ndAve,07/04/2014 08:00:00 PM,48,-122,17,0,17
4437,58thStGreenway22ndAve,07/04/2014 09:00:00 PM,48,-122,9,0,9
4438,58thStGreenway22ndAve,07/04/2014 10:00:00 PM,48,-122,1,3,4
4439,58thStGreenway22ndAve,07/04/2014 11:00:00 PM,48,-122,16,1,17
4440,58thStGreenway22ndAve,07/05/2014 12:00:00 AM,48,-122,0,0,0
4441,58thStGreenway22ndAve,07/05/2014 01:00:00 AM,48,-122,3,0,3
4442,58thStGreenway22ndAve,07/05/2014 02:00:00 AM,48,-122,0,0,0
4443,58thStGreenway22ndAve,07/05/2014 03:00:00 AM,48,-122,0,0,0
4444,58thStGreenway22ndAve,07/05/2014 04:00:00 AM,48,-122,1,3,4
4445,58thStGreenway22ndAve,07/05/2014 05:00:00 AM,48,-122,3,1,4
4446,58thStGreenway22ndAve,07/05/2014 06:00:00 AM,48,-122,2,0,2
4447,58thStGreenway22ndAve,07/05/2014 07:00:00 AM,48,-122,6,0,6
4448,58thStGreenway22ndAve,07/05/2014 08:00:00 AM,48,-122,10,3,13
4449,58thStGreenway22ndAve,07/05/2014 09:00:00 AM,48,-122,13,5,18
4450,58thStGreenway22ndAve,07/05/2014 10:00:00 AM,48,-122,14,16,30
4451,58thStGreenway22ndAve,07/05/2014 11:00:00 AM,48,-122,30,9,39
4452,58thStGreenway22ndAve,07/05/2014 12:00:00 PM,48,-122,26,10,36
4453,58thStGreenway22ndAve,07/05/2014 01:00:00 PM,48,-122,23,13,36
4454,58thStGreenway22ndAve,07/05/2014 02:00:00 PM,48,-122,26,10,36
4455,58thStGreenway22ndAve,07/05/2014 03:00:00 PM,48,-122,25,15,40
4456,58thStGreenway22ndAve,07/05/2014 04:00:00 PM,48,-122,22,20,42
4457,58thStGreenway22ndAve,07/05/2014 05:00:00 PM,48,-122,24,6,30
4458,58thStGreenway22ndAve,07/05/2014 06:00:00 PM,48,-122,25,4,29
4459,58thStGreenway22ndAve,07/05/2014 07:00:00 PM,48,-122,17,13,30
4460,58thStGreenway22ndAve,07/05/2014 08:00:00 PM,48,-122,19,6,25
4461,58thStGreenway22ndAve,07/05/2014 09:00:00 PM,48,-122,7,7,14
4462,58thStGreenway22ndAve,07/05/2014 10:00:00 PM,48,-122,3,1,4
4463,58thStGreenway22ndAve,07/05/2014 11:00:00 PM,48,-122,4,0,4
4464,58thStGreenway22ndAve,07/06/2014 12:00:00 AM,48,-122,2,0,2
4465,58thStGreenway22ndAve,07/06/2014 01:00:00 AM,48,-122,1,0,1
4466,58thStGreenway22ndAve,07/06/2014 02:00:00 AM,48,-122,0,0,0
4467,58thStGreenway22ndAve,07/06/2014 03:00:00 AM,48,-122,0,2,2
4468,58thStGreenway22ndAve,07/06/2014 04:00:00 AM,48,-122,0,0,0
4469,58thStGreenway22ndAve,07/06/2014 05:00:00 AM,48,-122,6,0,6
4470,58thStGreenway22ndAve,07/06/2014 06:00:00 AM,48,-122,4,1,5
4471,58thStGreenway22ndAve,07/06/2014 07:00:00 AM,48,-122,2,2,4
4472,58thStGreenway22ndAve,07/06/2014 08:00:00 AM,48,-122,6,6,12
4473,58thStGreenway22ndAve,07/06/2014 09:00:00 AM,48,-122,10,9,19
4474,58thStGreenway22ndAve,07/06/2014 10:00:00 AM,48,-122,27,16,43
4475,58thStGreenway22ndAve,07/06/2014 11:00:00 AM,48,-122,29,31,60
4476,58thStGreenway22ndAve,07/06/2014 12:00:00 PM,48,-122,46,26,72
4477,58thStGreenway22ndAve,07/06/2014 01:00:00 PM,48,-122,45,24,69
4478,58thStGreenway22ndAve,07/06/2014 02:00:00 PM,48,-122,50,24,74
4479,58thStGreenway22ndAve,07/06/2014 03:00:00 PM,48,-122,36,27,63
4480,58thStGreenway22ndAve,07/06/2014 04:00:00 PM,48,-122,32,13,45
4481,58thStGreenway22ndAve,07/06/2014 05:00:00 PM,48,-122,23,13,36
4482,58thStGreenway22ndAve,07/06/2014 06:00:00 PM,48,-122,17,3,20
4483,58thStGreenway22ndAve,07/06/2014 07:00:00 PM,48,-122,25,7,32
4484,58thStGreenway22ndAve,07/06/2014 08:00:00 PM,48,-122,9,3,12
4485,58thStGreenway22ndAve,07/06/2014 09:00:00 PM,48,-122,4,5,9
4486,58thStGreenway22ndAve,07/06/2014 10:00:00 PM,48,-122,8,2,10
4487,58thStGreenway22ndAve,07/06/2014 11:00:00 PM,48,-122,4,2,6
4488,58thStGreenway22ndAve,07/07/2014 12:00:00 AM,48,-122,0,0,0
4489,58thStGreenway22ndAve,07/07/2014 01:00:00 AM,48,-122,0,0,0
4490,58thStGreenway22ndAve,07/07/2014 02:00:00 AM,48,-122,0,0,0
4491,58thStGreenway22ndAve,07/07/2014 03:00:00 AM,48,-122,1,1,2
4492,58thStGreenway22ndAve,07/07/2014 04:00:00 AM,48,-122,3,2,5
4493,58thStGreenway22ndAve,07/07/2014 05:00:00 AM,48,-122,0,3,3
4494,58thStGreenway22ndAve,07/07/2014 06:00:00 AM,48,-122,5,2,7
4495,58thStGreenway22ndAve,07/07/2014 07:00:00 AM,48,-122,12,8,20
4496,58thStGreenway22ndAve,07/07/2014 08:00:00 AM,48,-122,14,16,30
4497,58thStGreenway22ndAve,07/07/2014 09:00:00 AM,48,-122,17,8,25
4498,58thStGreenway22ndAve,07/07/2014 10:00:00 AM,48,-122,16,9,25
4499,58thStGreenway22ndAve,07/07/2014 11:00:00 AM,48,-122,21,10,31
4500,58thStGreenway22ndAve,07/07/2014 12:00:00 PM,48,-122,20,24,44
4501,58thStGreenway22ndAve,07/07/2014 01:00:00 PM,48,-122,31,28,59
4502,58thStGreenway22ndAve,07/07/2014 02:00:00 PM,48,-122,32,8,40
4503,58thStGreenway22ndAve,07/07/2014 03:00:00 PM,48,-122,28,10,38
4504,58thStGreenway22ndAve,07/07/2014 04:00:00 PM,48,-122,27,4,31
4505,58thStGreenway22ndAve,07/07/2014 05:00:00 PM,48,-122,33,22,55
4506,58thStGreenway22ndAve,07/07/2014 06:00:00 PM,48,-122,23,21,44
4507,58thStGreenway22ndAve,07/07/2014 07:00:00 PM,48,-122,20,12,32
4508,58thStGreenway22ndAve,07/07/2014 08:00:00 PM,48,-122,23,11,34
4509,58thStGreenway22ndAve,07/07/2014 09:00:00 PM,48,-122,21,2,23
4510,58thStGreenway22ndAve,07/07/2014 10:00:00 PM,48,-122,11,0,11
4511,58thStGreenway22ndAve,07/07/2014 11:00:00 PM,48,-122,3,0,3
4512,58thStGreenway22ndAve,07/08/2014 12:00:00 AM,48,-122,2,1,3
4513,58thStGreenway22ndAve,07/08/2014 01:00:00 AM,48,-122,0,0,0
4514,58thStGreenway22ndAve,07/08/2014 02:00:00 AM,48,-122,0,0,0
4515,58thStGreenway22ndAve,07/08/2014 03:00:00 AM,48,-122,0,0,0
4516,58thStGreenway22ndAve,07/08/2014 04:00:00 AM,48,-122,0,0,0
4517,58thStGreenway22ndAve,07/08/2014 05:00:00 AM,48,-122,2,1,3
4518,58thStGreenway22ndAve,07/08/2014 06:00:00 AM,48,-122,9,5,14
4519,58thStGreenway22ndAve,07/08/2014 07:00:00 AM,48,-122,28,9,37
4520,58thStGreenway22ndAve,07/08/2014 08:00:00 AM,48,-122,21,9,30
4521,58thStGreenway22ndAve,07/08/2014 09:00:00 AM,48,-122,16,11,27
4522,58thStGreenway22ndAve,07/08/2014 10:00:00 AM,48,-122,16,15,31
4523,58thStGreenway22ndAve,07/08/2014 11:00:00 AM,48,-122,22,12,34
4524,58thStGreenway22ndAve,07/08/2014 12:00:00 PM,48,-122,38,9,47
4525,58thStGreenway22ndAve,07/08/2014 01:00:00 PM,48,-122,11,20,31
4526,58thStGreenway22ndAve,07/08/2014 02:00:00 PM,48,-122,43,6,49
4527,58thStGreenway22ndAve,07/08/2014 03:00:00 PM,48,-122,16,11,27
4528,58thStGreenway22ndAve,07/08/2014 04:00:00 PM,48,-122,36,10,46
4529,58thStGreenway22ndAve,07/08/2014 05:00:00 PM,48,-122,36,13,49
4530,58thStGreenway22ndAve,07/08/2014 06:00:00 PM,48,-122,34,26,60
4531,58thStGreenway22ndAve,07/08/2014 07:00:00 PM,48,-122,24,28,52
4532,58thStGreenway22ndAve,07/08/2014 08:00:00 PM,48,-122,18,10,28
4533,58thStGreenway22ndAve,07/08/2014 09:00:00 PM,48,-122,16,10,26
4534,58thStGreenway22ndAve,07/08/2014 10:00:00 PM,48,-122,12,2,14
4535,58thStGreenway22ndAve,07/08/2014 11:00:00 PM,48,-122,4,0,4
4536,58thStGreenway22ndAve,07/09/2014 12:00:00 AM,48,-122,2,0,2
4537,58thStGreenway22ndAve,07/09/2014 01:00:00 AM,48,-122,4,1,5
4538,58thStGreenway22ndAve,07/09/2014 02:00:00 AM,48,-122,1,0,1
4539,58thStGreenway22ndAve,07/09/2014 03:00:00 AM,48,-122,0,2,2
4540,58thStGreenway22ndAve,07/09/2014 04:00:00 AM,48,-122,2,2,4
4541,58thStGreenway22ndAve,07/09/2014 05:00:00 AM,48,-122,2,1,3
4542,58thStGreenway22ndAve,07/09/2014 06:00:00 AM,48,-122,4,4,8
4543,58thStGreenway22ndAve,07/09/2014 07:00:00 AM,48,-122,20,6,26
4544,58thStGreenway22ndAve,07/09/2014 08:00:00 AM,48,-122,28,11,39
4545,58thStGreenway22ndAve,07/09/2014 09:00:00 AM,48,-122,27,21,48
4546,58thStGreenway22ndAve,07/09/2014 10:00:00 AM,48,-122,18,9,27
4547,58thStGreenway22ndAve,07/09/2014 11:00:00 AM,48,-122,24,13,37
4548,58thStGreenway22ndAve,07/09/2014 12:00:00 PM,48,-122,18,12,30
4549,58thStGreenway22ndAve,07/09/2014 01:00:00 PM,48,-122,21,21,42
4550,58thStGreenway22ndAve,07/09/2014 02:00:00 PM,48,-122,26,18,44
4551,58thStGreenway22ndAve,07/09/2014 03:00:00 PM,48,-122,22,14,36
4552,58thStGreenway22ndAve,07/09/2014 04:00:00 PM,48,-122,28,11,39
4553,58thStGreenway22ndAve,07/09/2014 05:00:00 PM,48,-122,27,12,39
4554,58thStGreenway22ndAve,07/09/2014 06:00:00 PM,48,-122,39,20,59
4555,58thStGreenway22ndAve,07/09/2014 07:00:00 PM,48,-122,48,16,64
4556,58thStGreenway22ndAve,07/09/2014 08:00:00 PM,48,-122,28,18,46
4557,58thStGreenway22ndAve,07/09/2014 09:00:00 PM,48,-122,6,6,12
4558,58thStGreenway22ndAve,07/09/2014 10:00:00 PM,48,-122,11,3,14
4559,58thStGreenway22ndAve,07/09/2014 11:00:00 PM,48,-122,6,2,8
4560,58thStGreenway22ndAve,07/10/2014 12:00:00 AM,48,-122,3,0,3
4561,58thStGreenway22ndAve,07/10/2014 01:00:00 AM,48,-122,0,0,0
4562,58thStGreenway22ndAve,07/10/2014 02:00:00 AM,48,-122,9,13,22
4563,58thStGreenway22ndAve,07/10/2014 03:00:00 AM,48,-122,0,4,4
4564,58thStGreenway22ndAve,07/10/2014 04:00:00 AM,48,-122,0,0,0
4565,58thStGreenway22ndAve,07/10/2014 05:00:00 AM,48,-122,6,0,6
4566,58thStGreenway22ndAve,07/10/2014 06:00:00 AM,48,-122,5,8,13
4567,58thStGreenway22ndAve,07/10/2014 07:00:00 AM,48,-122,20,4,24
4568,58thStGreenway22ndAve,07/10/2014 08:00:00 AM,48,-122,22,12,34
4569,58thStGreenway22ndAve,07/10/2014 09:00:00 AM,48,-122,27,13,40
4570,58thStGreenway22ndAve,07/10/2014 10:00:00 AM,48,-122,21,19,40
4571,58thStGreenway22ndAve,07/10/2014 11:00:00 AM,48,-122,26,13,39
4572,58thStGreenway22ndAve,07/10/2014 12:00:00 PM,48,-122,29,13,42
4573,58thStGreenway22ndAve,07/10/2014 01:00:00 PM,48,-122,15,10,25
4574,58thStGreenway22ndAve,07/10/2014 02:00:00 PM,48,-122,8,18,26
4575,58thStGreenway22ndAve,07/10/2014 03:00:00 PM,48,-122,19,14,33
4576,58thStGreenway22ndAve,07/10/2014 04:00:00 PM,48,-122,31,10,41
4577,58thStGreenway22ndAve,07/10/2014 05:00:00 PM,48,-122,33,32,65
4578,58thStGreenway22ndAve,07/10/2014 06:00:00 PM,48,-122,30,31,61
4579,58thStGreenway22ndAve,07/10/2014 07:00:00 PM,48,-122,21,11,32
4580,58thStGreenway22ndAve,07/10/2014 08:00:00 PM,48,-122,19,17,36
4581,58thStGreenway22ndAve,07/10/2014 09:00:00 PM,48,-122,31,12,43
4582,58thStGreenway22ndAve,07/10/2014 10:00:00 PM,48,-122,18,1,19
4583,58thStGreenway22ndAve,07/10/2014 11:00:00 PM,48,-122,11,1,12
4584,58thStGreenway22ndAve,07/11/2014 12:00:00 AM,48,-122,6,3,9
4585,58thStGreenway22ndAve,07/11/2014 01:00:00 AM,48,-122,4,1,5
4586,58thStGreenway22ndAve,07/11/2014 02:00:00 AM,48,-122,2,0,2
4587,58thStGreenway22ndAve,07/11/2014 03:00:00 AM,48,-122,0,0,0
4588,58thStGreenway22ndAve,07/11/2014 04:00:00 AM,48,-122,0,0,0
4589,58thStGreenway22ndAve,07/11/2014 05:00:00 AM,48,-122,0,1,1
4590,58thStGreenway22ndAve,07/11/2014 06:00:00 AM,48,-122,5,4,9
4591,58thStGreenway22ndAve,07/11/2014 07:00:00 AM,48,-122,18,7,25
4592,58thStGreenway22ndAve,07/11/2014 08:00:00 AM,48,-122,13,18,31
4593,58thStGreenway22ndAve,07/11/2014 09:00:00 AM,48,-122,20,22,42
4594,58thStGreenway22ndAve,07/11/2014 10:00:00 AM,48,-122,41,8,49
4595,58thStGreenway22ndAve,07/11/2014 11:00:00 AM,48,-122,31,25,56
4596,58thStGreenway22ndAve,07/11/2014 12:00:00 PM,48,-122,32,12,44
4597,58thStGreenway22ndAve,07/11/2014 01:00:00 PM,48,-122,26,18,44
4598,58thStGreenway22ndAve,07/11/2014 02:00:00 PM,48,-122,39,13,52
4599,58thStGreenway22ndAve,07/11/2014 03:00:00 PM,48,-122,21,16,37
4600,58thStGreenway22ndAve,07/11/2014 04:00:00 PM,48,-122,35,12,47
4601,58thStGreenway22ndAve,07/11/2014 05:00:00 PM,48,-122,31,22,53
4602,58thStGreenway22ndAve,07/11/2014 06:00:00 PM,48,-122,40,9,49
4603,58thStGreenway22ndAve,07/11/2014 07:00:00 PM,48,-122,22,17,39
4604,58thStGreenway22ndAve,07/11/2014 08:00:00 PM,48,-122,31,14,45
4605,58thStGreenway22ndAve,07/11/2014 09:00:00 PM,48,-122,21,3,24
4606,58thStGreenway22ndAve,07/11/2014 10:00:00 PM,48,-122,12,1,13
4607,58thStGreenway22ndAve,07/11/2014 11:00:00 PM,48,-122,22,5,27
4608,58thStGreenway22ndAve,07/12/2014 12:00:00 AM,48,-122,30,5,35
4609,58thStGreenway22ndAve,07/12/2014 01:00:00 AM,48,-122,26,1,27
4610,58thStGreenway22ndAve,07/12/2014 02:00:00 AM,48,-122,21,5,26
4611,58thStGreenway22ndAve,07/12/2014 03:00:00 AM,48,-122,2,2,4
4612,58thStGreenway22ndAve,07/12/2014 04:00:00 AM,48,-122,4,0,4
4613,58thStGreenway22ndAve,07/12/2014 05:00:00 AM,48,-122,6,2,8
4614,58thStGreenway22ndAve,07/12/2014 06:00:00 AM,48,-122,12,16,28
4615,58thStGreenway22ndAve,07/12/2014 07:00:00 AM,48,-122,33,54,87
4616,58thStGreenway22ndAve,07/12/2014 08:00:00 AM,48,-122,78,77,155
4617,58thStGreenway22ndAve,07/12/2014 09:00:00 AM,48,-122,93,122,215
4618,58thStGreenway22ndAve,07/12/2014 10:00:00 AM,48,-122,65,38,103
4619,58thStGreenway22ndAve,07/12/2014 11:00:00 AM,48,-122,45,36,81
4620,58thStGreenway22ndAve,07/12/2014 12:00:00 PM,48,-122,50,44,94
4621,58thStGreenway22ndAve,07/12/2014 01:00:00 PM,48,-122,46,34,80
4622,58thStGreenway22ndAve,07/12/2014 02:00:00 PM,48,-122,54,34,88
4623,58thStGreenway22ndAve,07/12/2014 03:00:00 PM,48,-122,52,36,88
4624,58thStGreenway22ndAve,07/12/2014 04:00:00 PM,48,-122,50,18,68
4625,58thStGreenway22ndAve,07/12/2014 05:00:00 PM,48,-122,32,28,60
4626,58thStGreenway22ndAve,07/12/2014 06:00:00 PM,48,-122,41,14,55
4627,58thStGreenway22ndAve,07/12/2014 07:00:00 PM,48,-122,29,22,51
4628,58thStGreenway22ndAve,07/12/2014 08:00:00 PM,48,-122,28,14,42
4629,58thStGreenway22ndAve,07/12/2014 09:00:00 PM,48,-122,43,27,70
4630,58thStGreenway22ndAve,07/12/2014 10:00:00 PM,48,-122,40,39,79
4631,58thStGreenway22ndAve,07/12/2014 11:00:00 PM,48,-122,25,33,58
4632,58thStGreenway22ndAve,07/13/2014 12:00:00 AM,48,-122,19,21,40
4633,58thStGreenway22ndAve,07/13/2014 01:00:00 AM,48,-122,15,4,19
4634,58thStGreenway22ndAve,07/13/2014 02:00:00 AM,48,-122,8,2,10
4635,58thStGreenway22ndAve,07/13/2014 03:00:00 AM,48,-122,6,1,7
4636,58thStGreenway22ndAve,07/13/2014 04:00:00 AM,48,-122,6,1,7
4637,58thStGreenway22ndAve,07/13/2014 05:00:00 AM,48,-122,3,6,9
4638,58thStGreenway22ndAve,07/13/2014 06:00:00 AM,48,-122,4,12,16
4639,58thStGreenway22ndAve,07/13/2014 07:00:00 AM,48,-122,13,23,36
4640,58thStGreenway22ndAve,07/13/2014 08:00:00 AM,48,-122,25,46,71
4641,58thStGreenway22ndAve,07/13/2014 09:00:00 AM,48,-122,54,69,123
4642,58thStGreenway22ndAve,07/13/2014 10:00:00 AM,48,-122,82,50,132
4643,58thStGreenway22ndAve,07/13/2014 11:00:00 AM,48,-122,62,61,123
4644,58thStGreenway22ndAve,07/13/2014 12:00:00 PM,48,-122,26,61,87
4645,58thStGreenway22ndAve,07/13/2014 01:00:00 PM,48,-122,28,53,81
4646,58thStGreenway22ndAve,07/13/2014 02:00:00 PM,48,-122,35,65,100
4647,58thStGreenway22ndAve,07/13/2014 03:00:00 PM,48,-122,47,63,110
4648,58thStGreenway22ndAve,07/13/2014 04:00:00 PM,48,-122,41,23,64
4649,58thStGreenway22ndAve,07/13/2014 05:00:00 PM,48,-122,44,29,73
4650,58thStGreenway22ndAve,07/13/2014 06:00:00 PM,48,-122,31,20,51
4651,58thStGreenway22ndAve,07/13/2014 07:00:00 PM,48,-122,43,42,85
4652,58thStGreenway22ndAve,07/13/2014 08:00:00 PM,48,-122,64,50,114
4653,58thStGreenway22ndAve,07/13/2014 09:00:00 PM,48,-122,28,15,43
4654,58thStGreenway22ndAve,07/13/2014 10:00:00 PM,48,-122,15,7,22
4655,58thStGreenway22ndAve,07/13/2014 11:00:00 PM,48,-122,1,1,2
4656,58thStGreenway22ndAve,07/14/2014 12:00:00 AM,48,-122,3,2,5
4657,58thStGreenway22ndAve,07/14/2014 01:00:00 AM,48,-122,0,2,2
4658,58thStGreenway22ndAve,07/14/2014 02:00:00 AM,48,-122,5,0,5
4659,58thStGreenway22ndAve,07/14/2014 03:00:00 AM,48,-122,1,0,1
4660,58thStGreenway22ndAve,07/14/2014 04:00:00 AM,48,-122,4,1,5
4661,58thStGreenway22ndAve,07/14/2014 05:00:00 AM,48,-122,5,4,9
4662,58thStGreenway22ndAve,07/14/2014 06:00:00 AM,48,-122,2,6,8
4663,58thStGreenway22ndAve,07/14/2014 07:00:00 AM,48,-122,15,5,20
4664,58thStGreenway22ndAve,07/14/2014 08:00:00 AM,48,-122,39,12,51
4665,58thStGreenway22ndAve,07/14/2014 09:00:00 AM,48,-122,21,17,38
4666,58thStGreenway22ndAve,07/14/2014 10:00:00 AM,48,-122,21,15,36
4667,58thStGreenway22ndAve,07/14/2014 11:00:00 AM,48,-122,26,10,36
4668,58thStGreenway22ndAve,07/14/2014 12:00:00 PM,48,-122,25,17,42
4669,58thStGreenway22ndAve,07/14/2014 01:00:00 PM,48,-122,25,18,43
4670,58thStGreenway22ndAve,07/14/2014 02:00:00 PM,48,-122,50,14,64
4671,58thStGreenway22ndAve,07/14/2014 03:00:00 PM,48,-122,32,16,48
4672,58thStGreenway22ndAve,07/14/2014 04:00:00 PM,48,-122,42,7,49
4673,58thStGreenway22ndAve,07/14/2014 05:00:00 PM,48,-122,45,28,73
4674,58thStGreenway22ndAve,07/14/2014 06:00:00 PM,48,-122,23,18,41
4675,58thStGreenway22ndAve,07/14/2014 07:00:00 PM,48,-122,32,20,52
4676,58thStGreenway22ndAve,07/14/2014 08:00:00 PM,48,-122,16,11,27
4677,58thStGreenway22ndAve,07/14/2014 09:00:00 PM,48,-122,18,5,23
4678,58thStGreenway22ndAve,07/14/2014 10:00:00 PM,48,-122,8,3,11
4679,58thStGreenway22ndAve,07/14/2014 11:00:00 PM,48,-122,1,0,1
4680,58thStGreenway22ndAve,07/15/2014 12:00:00 AM,48,-122,2,1,3
4681,58thStGreenway22ndAve,07/15/2014 01:00:00 AM,48,-122,0,0,0
4682,58thStGreenway22ndAve,07/15/2014 02:00:00 AM,48,-122,0,2,2
4683,58thStGreenway22ndAve,07/15/2014 03:00:00 AM,48,-122,0,0,0
4684,58thStGreenway22ndAve,07/15/2014 04:00:00 AM,48,-122,0,0,0
4685,58thStGreenway22ndAve,07/15/2014 05:00:00 AM,48,-122,4,2,6
4686,58thStGreenway22ndAve,07/15/2014 06:00:00 AM,48,-122,6,4,10
4687,58thStGreenway22ndAve,07/15/2014 07:00:00 AM,48,-122,8,9,17
4688,58thStGreenway22ndAve,07/15/2014 08:00:00 AM,48,-122,27,13,40
4689,58thStGreenway22ndAve,07/15/2014 09:00:00 AM,48,-122,16,16,32
4690,58thStGreenway22ndAve,07/15/2014 10:00:00 AM,48,-122,20,17,37
4691,58thStGreenway22ndAve,07/15/2014 11:00:00 AM,48,-122,27,15,42
4692,58thStGreenway22ndAve,07/15/2014 12:00:00 PM,48,-122,44,30,74
4693,58thStGreenway22ndAve,07/15/2014 01:00:00 PM,48,-122,39,11,50
4694,58thStGreenway22ndAve,07/15/2014 02:00:00 PM,48,-122,36,8,44
4695,58thStGreenway22ndAve,07/15/2014 03:00:00 PM,48,-122,14,14,28
4696,58thStGreenway22ndAve,07/15/2014 04:00:00 PM,48,-122,21,17,38
4697,58thStGreenway22ndAve,07/15/2014 05:00:00 PM,48,-122,29,25,54
4698,58thStGreenway22ndAve,07/15/2014 06:00:00 PM,48,-122,23,35,58
4699,58thStGreenway22ndAve,07/15/2014 07:00:00 PM,48,-122,14,16,30
4700,58thStGreenway22ndAve,07/15/2014 08:00:00 PM,48,-122,18,11,29
4701,58thStGreenway22ndAve,07/15/2014 09:00:00 PM,48,-122,17,16,33
4702,58thStGreenway22ndAve,07/15/2014 10:00:00 PM,48,-122,6,1,7
4703,58thStGreenway22ndAve,07/15/2014 11:00:00 PM,48,-122,7,2,9
4704,58thStGreenway22ndAve,07/16/2014 12:00:00 AM,48,-122,2,0,2
4705,58thStGreenway22ndAve,07/16/2014 01:00:00 AM,48,-122,2,0,2
4706,58thStGreenway22ndAve,07/16/2014 02:00:00 AM,48,-122,0,2,2
4707,58thStGreenway22ndAve,07/16/2014 03:00:00 AM,48,-122,0,0,0
4708,58thStGreenway22ndAve,07/16/2014 04:00:00 AM,48,-122,0,0,0
4709,58thStGreenway22ndAve,07/16/2014 05:00:00 AM,48,-122,2,2,4
4710,58thStGreenway22ndAve,07/16/2014 06:00:00 AM,48,-122,7,3,10
4711,58thStGreenway22ndAve,07/16/2014 07:00:00 AM,48,-122,7,6,13
4712,58thStGreenway22ndAve,07/16/2014 08:00:00 AM,48,-122,20,14,34
4713,58thStGreenway22ndAve,07/16/2014 09:00:00 AM,48,-122,25,10,35
4714,58thStGreenway22ndAve,07/16/2014 10:00:00 AM,48,-122,12,15,27
4715,58thStGreenway22ndAve,07/16/2014 11:00:00 AM,48,-122,24,9,33
4716,58thStGreenway22ndAve,07/16/2014 12:00:00 PM,48,-122,29,9,38
4717,58thStGreenway22ndAve,07/16/2014 01:00:00 PM,48,-122,27,7,34
4718,58thStGreenway22ndAve,07/16/2014 02:00:00 PM,48,-122,23,14,37
4719,58thStGreenway22ndAve,07/16/2014 03:00:00 PM,48,-122,39,15,54
4720,58thStGreenway22ndAve,07/16/2014 04:00:00 PM,48,-122,32,9,41
4721,58thStGreenway22ndAve,07/16/2014 05:00:00 PM,48,-122,16,6,22
4722,58thStGreenway22ndAve,07/16/2014 06:00:00 PM,48,-122,32,20,52
4723,58thStGreenway22ndAve,07/16/2014 07:00:00 PM,48,-122,33,27,60
4724,58thStGreenway22ndAve,07/16/2014 08:00:00 PM,48,-122,33,11,44
4725,58thStGreenway22ndAve,07/16/2014 09:00:00 PM,48,-122,28,4,32
4726,58thStGreenway22ndAve,07/16/2014 10:00:00 PM,48,-122,11,1,12
4727,58thStGreenway22ndAve,07/16/2014 11:00:00 PM,48,-122,4,0,4
4728,58thStGreenway22ndAve,07/17/2014 12:00:00 AM,48,-122,3,0,3
4729,58thStGreenway22ndAve,07/17/2014 01:00:00 AM,48,-122,2,0,2
4730,58thStGreenway22ndAve,07/17/2014 02:00:00 AM,48,-122,0,1,1
4731,58thStGreenway22ndAve,07/17/2014 03:00:00 AM,48,-122,0,0,0
4732,58thStGreenway22ndAve,07/17/2014 04:00:00 AM,48,-122,0,0,0
4733,58thStGreenway22ndAve,07/17/2014 05:00:00 AM,48,-122,6,1,7
4734,58thStGreenway22ndAve,07/17/2014 06:00:00 AM,48,-122,4,7,11
4735,58thStGreenway22ndAve,07/17/2014 07:00:00 AM,48,-122,21,6,27
4736,58thStGreenway22ndAve,07/17/2014 08:00:00 AM,48,-122,25,11,36
4737,58thStGreenway22ndAve,07/17/2014 09:00:00 AM,48,-122,25,20,45
4738,58thStGreenway22ndAve,07/17/2014 10:00:00 AM,48,-122,23,2,25
4739,58thStGreenway22ndAve,07/17/2014 11:00:00 AM,48,-122,24,14,38
4740,58thStGreenway22ndAve,07/17/2014 12:00:00 PM,48,-122,43,14,57
4741,58thStGreenway22ndAve,07/17/2014 01:00:00 PM,48,-122,29,9,38
4742,58thStGreenway22ndAve,07/17/2014 02:00:00 PM,48,-122,31,15,46
4743,58thStGreenway22ndAve,07/17/2014 03:00:00 PM,48,-122,19,6,25
4744,58thStGreenway22ndAve,07/17/2014 04:00:00 PM,48,-122,33,17,50
4745,58thStGreenway22ndAve,07/17/2014 05:00:00 PM,48,-122,32,18,50
4746,58thStGreenway22ndAve,07/17/2014 06:00:00 PM,48,-122,42,18,60
4747,58thStGreenway22ndAve,07/17/2014 07:00:00 PM,48,-122,28,21,49
4748,58thStGreenway22ndAve,07/17/2014 08:00:00 PM,48,-122,21,12,33
4749,58thStGreenway22ndAve,07/17/2014 09:00:00 PM,48,-122,10,5,15
4750,58thStGreenway22ndAve,07/17/2014 10:00:00 PM,48,-122,11,6,17
4751,58thStGreenway22ndAve,07/17/2014 11:00:00 PM,48,-122,4,3,7
4752,58thStGreenway22ndAve,07/18/2014 12:00:00 AM,48,-122,2,0,2
4753,58thStGreenway22ndAve,07/18/2014 01:00:00 AM,48,-122,2,0,2
4754,58thStGreenway22ndAve,07/18/2014 02:00:00 AM,48,-122,0,1,1
4755,58thStGreenway22ndAve,07/18/2014 03:00:00 AM,48,-122,0,0,0
4756,58thStGreenway22ndAve,07/18/2014 04:00:00 AM,48,-122,0,0,0
4757,58thStGreenway22ndAve,07/18/2014 05:00:00 AM,48,-122,0,3,3
4758,58thStGreenway22ndAve,07/18/2014 06:00:00 AM,48,-122,7,4,11
4759,58thStGreenway22ndAve,07/18/2014 07:00:00 AM,48,-122,9,7,16
4760,58thStGreenway22ndAve,07/18/2014 08:00:00 AM,48,-122,41,18,59
4761,58thStGreenway22ndAve,07/18/2014 09:00:00 AM,48,-122,39,11,50
4762,58thStGreenway22ndAve,07/18/2014 10:00:00 AM,48,-122,28,14,42
4763,58thStGreenway22ndAve,07/18/2014 11:00:00 AM,48,-122,18,17,35
4764,58thStGreenway22ndAve,07/18/2014 12:00:00 PM,48,-122,23,11,34
4765,58thStGreenway22ndAve,07/18/2014 01:00:00 PM,48,-122,27,29,56
4766,58thStGreenway22ndAve,07/18/2014 02:00:00 PM,48,-122,35,18,53
4767,58thStGreenway22ndAve,07/18/2014 03:00:00 PM,48,-122,16,16,32
4768,58thStGreenway22ndAve,07/18/2014 04:00:00 PM,48,-122,38,12,50
4769,58thStGreenway22ndAve,07/18/2014 05:00:00 PM,48,-122,39,33,72
4770,58thStGreenway22ndAve,07/18/2014 06:00:00 PM,48,-122,34,20,54
4771,58thStGreenway22ndAve,07/18/2014 07:00:00 PM,48,-122,21,14,35
4772,58thStGreenway22ndAve,07/18/2014 08:00:00 PM,48,-122,15,11,26
4773,58thStGreenway22ndAve,07/18/2014 09:00:00 PM,48,-122,26,13,39
4774,58thStGreenway22ndAve,07/18/2014 10:00:00 PM,48,-122,3,4,7
4775,58thStGreenway22ndAve,07/18/2014 11:00:00 PM,48,-122,6,5,11
4776,58thStGreenway22ndAve,07/19/2014 12:00:00 AM,48,-122,4,3,7
4777,58thStGreenway22ndAve,07/19/2014 01:00:00 AM,48,-122,5,1,6
4778,58thStGreenway22ndAve,07/19/2014 02:00:00 AM,48,-122,0,2,2
4779,58thStGreenway22ndAve,07/19/2014 03:00:00 AM,48,-122,0,2,2
4780,58thStGreenway22ndAve,07/19/2014 04:00:00 AM,48,-122,0,0,0
4781,58thStGreenway22ndAve,07/19/2014 05:00:00 AM,48,-122,9,1,10
4782,58thStGreenway22ndAve,07/19/2014 06:00:00 AM,48,-122,2,0,2
4783,58thStGreenway22ndAve,07/19/2014 07:00:00 AM,48,-122,10,0,10
4784,58thStGreenway22ndAve,07/19/2014 08:00:00 AM,48,-122,13,6,19
4785,58thStGreenway22ndAve,07/19/2014 09:00:00 AM,48,-122,24,14,38
4786,58thStGreenway22ndAve,07/19/2014 10:00:00 AM,48,-122,18,21,39
4787,58thStGreenway22ndAve,07/19/2014 11:00:00 AM,48,-122,19,24,43
4788,58thStGreenway22ndAve,07/19/2014 12:00:00 PM,48,-122,39,25,64
4789,58thStGreenway22ndAve,07/19/2014 01:00:00 PM,48,-122,28,25,53
4790,58thStGreenway22ndAve,07/19/2014 02:00:00 PM,48,-122,38,19,57
4791,58thStGreenway22ndAve,07/19/2014 03:00:00 PM,48,-122,24,32,56
4792,58thStGreenway22ndAve,07/19/2014 04:00:00 PM,48,-122,30,23,53
4793,58thStGreenway22ndAve,07/19/2014 05:00:00 PM,48,-122,36,16,52
4794,58thStGreenway22ndAve,07/19/2014 06:00:00 PM,48,-122,27,16,43
4795,58thStGreenway22ndAve,07/19/2014 07:00:00 PM,48,-122,19,8,27
4796,58thStGreenway22ndAve,07/19/2014 08:00:00 PM,48,-122,18,15,33
4797,58thStGreenway22ndAve,07/19/2014 09:00:00 PM,48,-122,23,7,30
4798,58thStGreenway22ndAve,07/19/2014 10:00:00 PM,48,-122,9,0,9
4799,58thStGreenway22ndAve,07/19/2014 11:00:00 PM,48,-122,7,3,10
4800,58thStGreenway22ndAve,07/20/2014 12:00:00 AM,48,-122,1,2,3
4801,58thStGreenway22ndAve,07/20/2014 01:00:00 AM,48,-122,8,0,8
4802,58thStGreenway22ndAve,07/20/2014 02:00:00 AM,48,-122,1,2,3
4803,58thStGreenway22ndAve,07/20/2014 03:00:00 AM,48,-122,1,0,1
4804,58thStGreenway22ndAve,07/20/2014 04:00:00 AM,48,-122,0,0,0
4805,58thStGreenway22ndAve,07/20/2014 05:00:00 AM,48,-122,2,0,2
4806,58thStGreenway22ndAve,07/20/2014 06:00:00 AM,48,-122,0,2,2
4807,58thStGreenway22ndAve,07/20/2014 07:00:00 AM,48,-122,4,2,6
4808,58thStGreenway22ndAve,07/20/2014 08:00:00 AM,48,-122,10,2,12
4809,58thStGreenway22ndAve,07/20/2014 09:00:00 AM,48,-122,20,8,28
4810,58thStGreenway22ndAve,07/20/2014 10:00:00 AM,48,-122,30,18,48
4811,58thStGreenway22ndAve,07/20/2014 11:00:00 AM,48,-122,42,26,68
4812,58thStGreenway22ndAve,07/20/2014 12:00:00 PM,48,-122,40,32,72
4813,58thStGreenway22ndAve,07/20/2014 01:00:00 PM,48,-122,48,31,79
4814,58thStGreenway22ndAve,07/20/2014 02:00:00 PM,48,-122,37,15,52
4815,58thStGreenway22ndAve,07/20/2014 03:00:00 PM,48,-122,47,18,65
4816,58thStGreenway22ndAve,07/20/2014 04:00:00 PM,48,-122,34,13,47
4817,58thStGreenway22ndAve,07/20/2014 05:00:00 PM,48,-122,23,10,33
4818,58thStGreenway22ndAve,07/20/2014 06:00:00 PM,48,-122,21,8,29
4819,58thStGreenway22ndAve,07/20/2014 07:00:00 PM,48,-122,8,2,10
4820,58thStGreenway22ndAve,07/20/2014 08:00:00 PM,48,-122,21,12,33
4821,58thStGreenway22ndAve,07/20/2014 09:00:00 PM,48,-122,12,4,16
4822,58thStGreenway22ndAve,07/20/2014 10:00:00 PM,48,-122,8,1,9
4823,58thStGreenway22ndAve,07/20/2014 11:00:00 PM,48,-122,3,0,3
4824,58thStGreenway22ndAve,07/21/2014 12:00:00 AM,48,-122,4,1,5
4825,58thStGreenway22ndAve,07/21/2014 01:00:00 AM,48,-122,0,0,0
4826,58thStGreenway22ndAve,07/21/2014 02:00:00 AM,48,-122,0,0,0
4827,58thStGreenway22ndAve,07/21/2014 03:00:00 AM,48,-122,0,0,0
4828,58thStGreenway22ndAve,07/21/2014 04:00:00 AM,48,-122,0,0,0
4829,58thStGreenway22ndAve,07/21/2014 05:00:00 AM,48,-122,3,2,5
4830,58thStGreenway22ndAve,07/21/2014 06:00:00 AM,48,-122,9,4,13
4831,58thStGreenway22ndAve,07/21/2014 07:00:00 AM,48,-122,20,5,25
4832,58thStGreenway22ndAve,07/21/2014 08:00:00 AM,48,-122,23,16,39
4833,58thStGreenway22ndAve,07/21/2014 09:00:00 AM,48,-122,23,20,43
4834,58thStGreenway22ndAve,07/21/2014 10:00:00 AM,48,-122,8,10,18
4835,58thStGreenway22ndAve,07/21/2014 11:00:00 AM,48,-122,29,10,39
4836,58thStGreenway22ndAve,07/21/2014 12:00:00 PM,48,-122,31,4,35
4837,58thStGreenway22ndAve,07/21/2014 01:00:00 PM,48,-122,26,13,39
4838,58thStGreenway22ndAve,07/21/2014 02:00:00 PM,48,-122,39,20,59
4839,58thStGreenway22ndAve,07/21/2014 03:00:00 PM,48,-122,33,11,44
4840,58thStGreenway22ndAve,07/21/2014 04:00:00 PM,48,-122,43,16,59
4841,58thStGreenway22ndAve,07/21/2014 05:00:00 PM,48,-122,40,25,65
4842,58thStGreenway22ndAve,07/21/2014 06:00:00 PM,48,-122,45,18,63
4843,58thStGreenway22ndAve,07/21/2014 07:00:00 PM,48,-122,23,14,37
4844,58thStGreenway22ndAve,07/21/2014 08:00:00 PM,48,-122,29,10,39
4845,58thStGreenway22ndAve,07/21/2014 09:00:00 PM,48,-122,16,5,21
4846,58thStGreenway22ndAve,07/21/2014 10:00:00 PM,48,-122,10,0,10
4847,58thStGreenway22ndAve,07/21/2014 11:00:00 PM,48,-122,13,0,13
4848,58thStGreenway22ndAve,07/22/2014 12:00:00 AM,48,-122,0,0,0
4849,58thStGreenway22ndAve,07/22/2014 01:00:00 AM,48,-122,1,1,2
4850,58thStGreenway22ndAve,07/22/2014 02:00:00 AM,48,-122,3,1,4
4851,58thStGreenway22ndAve,07/22/2014 03:00:00 AM,48,-122,0,0,0
4852,58thStGreenway22ndAve,07/22/2014 04:00:00 AM,48,-122,0,0,0
4853,58thStGreenway22ndAve,07/22/2014 05:00:00 AM,48,-122,2,2,4
4854,58thStGreenway22ndAve,07/22/2014 06:00:00 AM,48,-122,7,3,10
4855,58thStGreenway22ndAve,07/22/2014 07:00:00 AM,48,-122,23,10,33
4856,58thStGreenway22ndAve,07/22/2014 08:00:00 AM,48,-122,23,10,33
4857,58thStGreenway22ndAve,07/22/2014 09:00:00 AM,48,-122,27,7,34
4858,58thStGreenway22ndAve,07/22/2014 10:00:00 AM,48,-122,19,10,29
4859,58thStGreenway22ndAve,07/22/2014 11:00:00 AM,48,-122,21,13,34
4860,58thStGreenway22ndAve,07/22/2014 12:00:00 PM,48,-122,36,15,51
4861,58thStGreenway22ndAve,07/22/2014 01:00:00 PM,48,-122,27,15,42
4862,58thStGreenway22ndAve,07/22/2014 02:00:00 PM,48,-122,26,8,34
4863,58thStGreenway22ndAve,07/22/2014 03:00:00 PM,48,-122,15,14,29
4864,58thStGreenway22ndAve,07/22/2014 04:00:00 PM,48,-122,35,17,52
4865,58thStGreenway22ndAve,07/22/2014 05:00:00 PM,48,-122,19,18,37
4866,58thStGreenway22ndAve,07/22/2014 06:00:00 PM,48,-122,33,19,52
4867,58thStGreenway22ndAve,07/22/2014 07:00:00 PM,48,-122,23,21,44
4868,58thStGreenway22ndAve,07/22/2014 08:00:00 PM,48,-122,18,6,24
4869,58thStGreenway22ndAve,07/22/2014 09:00:00 PM,48,-122,24,11,35
4870,58thStGreenway22ndAve,07/22/2014 10:00:00 PM,48,-122,4,0,4
4871,58thStGreenway22ndAve,07/22/2014 11:00:00 PM,48,-122,8,3,11
4872,58thStGreenway22ndAve,07/23/2014 12:00:00 AM,48,-122,0,0,0
4873,58thStGreenway22ndAve,07/23/2014 01:00:00 AM,48,-122,0,1,1
4874,58thStGreenway22ndAve,07/23/2014 02:00:00 AM,48,-122,0,0,0
4875,58thStGreenway22ndAve,07/23/2014 03:00:00 AM,48,-122,0,1,1
4876,58thStGreenway22ndAve,07/23/2014 04:00:00 AM,48,-122,0,0,0
4877,58thStGreenway22ndAve,07/23/2014 05:00:00 AM,48,-122,2,0,2
4878,58thStGreenway22ndAve,07/23/2014 06:00:00 AM,48,-122,3,7,10
4879,58thStGreenway22ndAve,07/23/2014 07:00:00 AM,48,-122,23,5,28
4880,58thStGreenway22ndAve,07/23/2014 08:00:00 AM,48,-122,16,6,22
4881,58thStGreenway22ndAve,07/23/2014 09:00:00 AM,48,-122,19,17,36
4882,58thStGreenway22ndAve,07/23/2014 10:00:00 AM,48,-122,18,8,26
4883,58thStGreenway22ndAve,07/23/2014 11:00:00 AM,48,-122,21,15,36
4884,58thStGreenway22ndAve,07/23/2014 12:00:00 PM,48,-122,16,20,36
4885,58thStGreenway22ndAve,07/23/2014 01:00:00 PM,48,-122,10,10,20
4886,58thStGreenway22ndAve,07/23/2014 02:00:00 PM,48,-122,6,7,13
4887,58thStGreenway22ndAve,07/23/2014 03:00:00 PM,48,-122,7,10,17
4888,58thStGreenway22ndAve,07/23/2014 04:00:00 PM,48,-122,9,16,25
4889,58thStGreenway22ndAve,07/23/2014 05:00:00 PM,48,-122,33,13,46
4890,58thStGreenway22ndAve,07/23/2014 06:00:00 PM,48,-122,31,19,50
4891,58thStGreenway22ndAve,07/23/2014 07:00:00 PM,48,-122,17,9,26
4892,58thStGreenway22ndAve,07/23/2014 08:00:00 PM,48,-122,21,7,28
4893,58thStGreenway22ndAve,07/23/2014 09:00:00 PM,48,-122,23,6,29
4894,58thStGreenway22ndAve,07/23/2014 10:00:00 PM,48,-122,5,3,8
4895,58thStGreenway22ndAve,07/23/2014 11:00:00 PM,48,-122,9,0,9
4896,58thStGreenway22ndAve,07/24/2014 12:00:00 AM,48,-122,0,2,2
4897,58thStGreenway22ndAve,07/24/2014 01:00:00 AM,48,-122,1,1,2
4898,58thStGreenway22ndAve,07/24/2014 02:00:00 AM,48,-122,0,0,0
4899,58thStGreenway22ndAve,07/24/2014 03:00:00 AM,48,-122,0,1,1
4900,58thStGreenway22ndAve,07/24/2014 04:00:00 AM,48,-122,7,0,7
4901,58thStGreenway22ndAve,07/24/2014 05:00:00 AM,48,-122,4,0,4
4902,58thStGreenway22ndAve,07/24/2014 06:00:00 AM,48,-122,11,6,17
4903,58thStGreenway22ndAve,07/24/2014 07:00:00 AM,48,-122,16,4,20
4904,58thStGreenway22ndAve,07/24/2014 08:00:00 AM,48,-122,17,3,20
4905,58thStGreenway22ndAve,07/24/2014 09:00:00 AM,48,-122,20,3,23
4906,58thStGreenway22ndAve,07/24/2014 10:00:00 AM,48,-122,20,9,29
4907,58thStGreenway22ndAve,07/24/2014 11:00:00 AM,48,-122,25,11,36
4908,58thStGreenway22ndAve,07/24/2014 12:00:00 PM,48,-122,31,15,46
4909,58thStGreenway22ndAve,07/24/2014 01:00:00 PM,48,-122,33,7,40
4910,58thStGreenway22ndAve,07/24/2014 02:00:00 PM,48,-122,40,8,48
4911,58thStGreenway22ndAve,07/24/2014 03:00:00 PM,48,-122,17,9,26
4912,58thStGreenway22ndAve,07/24/2014 04:00:00 PM,48,-122,29,13,42
4913,58thStGreenway22ndAve,07/24/2014 05:00:00 PM,48,-122,26,14,40
4914,58thStGreenway22ndAve,07/24/2014 06:00:00 PM,48,-122,25,17,42
4915,58thStGreenway22ndAve,07/24/2014 07:00:00 PM,48,-122,28,10,38
4916,58thStGreenway22ndAve,07/24/2014 08:00:00 PM,48,-122,5,8,13
4917,58thStGreenway22ndAve,07/24/2014 09:00:00 PM,48,-122,7,4,11
4918,58thStGreenway22ndAve,07/24/2014 10:00:00 PM,48,-122,4,2,6
4919,58thStGreenway22ndAve,07/24/2014 11:00:00 PM,48,-122,1,2,3
4920,58thStGreenway22ndAve,07/25/2014 12:00:00 AM,48,-122,3,1,4
4921,58thStGreenway22ndAve,07/25/2014 01:00:00 AM,48,-122,2,0,2
4922,58thStGreenway22ndAve,07/25/2014 02:00:00 AM,48,-122,0,0,0
4923,58thStGreenway22ndAve,07/25/2014 03:00:00 AM,48,-122,0,0,0
4924,58thStGreenway22ndAve,07/25/2014 04:00:00 AM,48,-122,0,0,0
4925,58thStGreenway22ndAve,07/25/2014 05:00:00 AM,48,-122,2,0,2
4926,58thStGreenway22ndAve,07/25/2014 06:00:00 AM,48,-122,4,5,9
4927,58thStGreenway22ndAve,07/25/2014 07:00:00 AM,48,-122,23,3,26
4928,58thStGreenway22ndAve,07/25/2014 08:00:00 AM,48,-122,28,9,37
4929,58thStGreenway22ndAve,07/25/2014 09:00:00 AM,48,-122,23,12,35
4930,58thStGreenway22ndAve,07/25/2014 10:00:00 AM,48,-122,27,16,43
4931,58thStGreenway22ndAve,07/25/2014 11:00:00 AM,48,-122,24,20,44
4932,58thStGreenway22ndAve,07/25/2014 12:00:00 PM,48,-122,25,20,45
4933,58thStGreenway22ndAve,07/25/2014 01:00:00 PM,48,-122,42,14,56
4934,58thStGreenway22ndAve,07/25/2014 02:00:00 PM,48,-122,29,26,55
4935,58thStGreenway22ndAve,07/25/2014 03:00:00 PM,48,-122,33,23,56
4936,58thStGreenway22ndAve,07/25/2014 04:00:00 PM,48,-122,19,19,38
4937,58thStGreenway22ndAve,07/25/2014 05:00:00 PM,48,-122,24,17,41
4938,58thStGreenway22ndAve,07/25/2014 06:00:00 PM,48,-122,29,14,43
4939,58thStGreenway22ndAve,07/25/2014 07:00:00 PM,48,-122,19,10,29
4940,58thStGreenway22ndAve,07/25/2014 08:00:00 PM,48,-122,21,8,29
4941,58thStGreenway22ndAve,07/25/2014 09:00:00 PM,48,-122,18,8,26
4942,58thStGreenway22ndAve,07/25/2014 10:00:00 PM,48,-122,14,5,19
4943,58thStGreenway22ndAve,07/25/2014 11:00:00 PM,48,-122,12,2,14
4944,58thStGreenway22ndAve,07/26/2014 12:00:00 AM,48,-122,7,0,7
4945,58thStGreenway22ndAve,07/26/2014 01:00:00 AM,48,-122,3,4,7
4946,58thStGreenway22ndAve,07/26/2014 02:00:00 AM,48,-122,0,0,0
4947,58thStGreenway22ndAve,07/26/2014 03:00:00 AM,48,-122,0,0,0
4948,58thStGreenway22ndAve,07/26/2014 04:00:00 AM,48,-122,0,1,1
4949,58thStGreenway22ndAve,07/26/2014 05:00:00 AM,48,-122,6,0,6
4950,58thStGreenway22ndAve,07/26/2014 06:00:00 AM,48,-122,5,2,7
4951,58thStGreenway22ndAve,07/26/2014 07:00:00 AM,48,-122,11,2,13
4952,58thStGreenway22ndAve,07/26/2014 08:00:00 AM,48,-122,8,7,15
4953,58thStGreenway22ndAve,07/26/2014 09:00:00 AM,48,-122,16,13,29
4954,58thStGreenway22ndAve,07/26/2014 10:00:00 AM,48,-122,25,33,58
4955,58thStGreenway22ndAve,07/26/2014 11:00:00 AM,48,-122,36,16,52
4956,58thStGreenway22ndAve,07/26/2014 12:00:00 PM,48,-122,23,17,40
4957,58thStGreenway22ndAve,07/26/2014 01:00:00 PM,48,-122,62,21,83
4958,58thStGreenway22ndAve,07/26/2014 02:00:00 PM,48,-122,45,25,70
4959,58thStGreenway22ndAve,07/26/2014 03:00:00 PM,48,-122,44,20,64
4960,58thStGreenway22ndAve,07/26/2014 04:00:00 PM,48,-122,34,18,52
4961,58thStGreenway22ndAve,07/26/2014 05:00:00 PM,48,-122,31,13,44
4962,58thStGreenway22ndAve,07/26/2014 06:00:00 PM,48,-122,29,8,37
4963,58thStGreenway22ndAve,07/26/2014 07:00:00 PM,48,-122,27,5,32
4964,58thStGreenway22ndAve,07/26/2014 08:00:00 PM,48,-122,11,1,12
4965,58thStGreenway22ndAve,07/26/2014 09:00:00 PM,48,-122,10,13,23
4966,58thStGreenway22ndAve,07/26/2014 10:00:00 PM,48,-122,5,1,6
4967,58thStGreenway22ndAve,07/26/2014 11:00:00 PM,48,-122,8,0,8
4968,58thStGreenway22ndAve,07/27/2014 12:00:00 AM,48,-122,7,0,7
4969,58thStGreenway22ndAve,07/27/2014 01:00:00 AM,48,-122,8,0,8
4970,58thStGreenway22ndAve,07/27/2014 02:00:00 AM,48,-122,1,0,1
4971,58thStGreenway22ndAve,07/27/2014 03:00:00 AM,48,-122,2,0,2
4972,58thStGreenway22ndAve,07/27/2014 04:00:00 AM,48,-122,0,0,0
4973,58thStGreenway22ndAve,07/27/2014 05:00:00 AM,48,-122,2,0,2
4974,58thStGreenway22ndAve,07/27/2014 06:00:00 AM,48,-122,2,2,4
4975,58thStGreenway22ndAve,07/27/2014 07:00:00 AM,48,-122,7,1,8
4976,58thStGreenway22ndAve,07/27/2014 08:00:00 AM,48,-122,4,3,7
4977,58thStGreenway22ndAve,07/27/2014 09:00:00 AM,48,-122,19,2,21
4978,58thStGreenway22ndAve,07/27/2014 10:00:00 AM,48,-122,26,10,36
4979,58thStGreenway22ndAve,07/27/2014 11:00:00 AM,48,-122,36,25,61
4980,58thStGreenway22ndAve,07/27/2014 12:00:00 PM,48,-122,24,23,47
4981,58thStGreenway22ndAve,07/27/2014 01:00:00 PM,48,-122,56,30,86
4982,58thStGreenway22ndAve,07/27/2014 02:00:00 PM,48,-122,44,30,74
4983,58thStGreenway22ndAve,07/27/2014 03:00:00 PM,48,-122,38,13,51
4984,58thStGreenway22ndAve,07/27/2014 04:00:00 PM,48,-122,30,10,40
4985,58thStGreenway22ndAve,07/27/2014 05:00:00 PM,48,-122,33,7,40
4986,58thStGreenway22ndAve,07/27/2014 06:00:00 PM,48,-122,41,12,53
4987,58thStGreenway22ndAve,07/27/2014 07:00:00 PM,48,-122,18,13,31
4988,58thStGreenway22ndAve,07/27/2014 08:00:00 PM,48,-122,16,11,27
4989,58thStGreenway22ndAve,07/27/2014 09:00:00 PM,48,-122,16,4,20
4990,58thStGreenway22ndAve,07/27/2014 10:00:00 PM,48,-122,12,2,14
4991,58thStGreenway22ndAve,07/27/2014 11:00:00 PM,48,-122,8,2,10
4992,58thStGreenway22ndAve,07/28/2014 12:00:00 AM,48,-122,0,0,0
4993,58thStGreenway22ndAve,07/28/2014 01:00:00 AM,48,-122,0,1,1
4994,58thStGreenway22ndAve,07/28/2014 02:00:00 AM,48,-122,0,0,0
4995,58thStGreenway22ndAve,07/28/2014 03:00:00 AM,48,-122,0,0,0
4996,58thStGreenway22ndAve,07/28/2014 04:00:00 AM,48,-122,0,0,0
4997,58thStGreenway22ndAve,07/28/2014 05:00:00 AM,48,-122,0,1,1
4998,58thStGreenway22ndAve,07/28/2014 06:00:00 AM,48,-122,4,3,7
4999,58thStGreenway22ndAve,07/28/2014 07:00:00 AM,48,-122,22,7,29
5000,58thStGreenway22ndAve,07/28/2014 08:00:00 AM,48,-122,28,6,34
5001,58thStGreenway22ndAve,07/28/2014 09:00:00 AM,48,-122,18,10,28
5002,58thStGreenway22ndAve,07/28/2014 10:00:00 AM,48,-122,18,19,37
5003,58thStGreenway22ndAve,07/28/2014 11:00:00 AM,48,-122,21,10,31
5004,58thStGreenway22ndAve,07/28/2014 12:00:00 PM,48,-122,24,8,32
5005,58thStGreenway22ndAve,07/28/2014 01:00:00 PM,48,-122,42,15,57
5006,58thStGreenway22ndAve,07/28/2014 02:00:00 PM,48,-122,32,22,54
5007,58thStGreenway22ndAve,07/28/2014 03:00:00 PM,48,-122,38,13,51
5008,58thStGreenway22ndAve,07/28/2014 04:00:00 PM,48,-122,37,27,64
5009,58thStGreenway22ndAve,07/28/2014 05:00:00 PM,48,-122,32,17,49
5010,58thStGreenway22ndAve,07/28/2014 06:00:00 PM,48,-122,38,22,60
5011,58thStGreenway22ndAve,07/28/2014 07:00:00 PM,48,-122,32,19,51
5012,58thStGreenway22ndAve,07/28/2014 08:00:00 PM,48,-122,19,6,25
5013,58thStGreenway22ndAve,07/28/2014 09:00:00 PM,48,-122,16,11,27
5014,58thStGreenway22ndAve,07/28/2014 10:00:00 PM,48,-122,4,1,5
5015,58thStGreenway22ndAve,07/28/2014 11:00:00 PM,48,-122,1,0,1
5016,58thStGreenway22ndAve,07/29/2014 12:00:00 AM,48,-122,1,0,1
5017,58thStGreenway22ndAve,07/29/2014 01:00:00 AM,48,-122,2,0,2
5018,58thStGreenway22ndAve,07/29/2014 02:00:00 AM,48,-122,0,0,0
5019,58thStGreenway22ndAve,07/29/2014 03:00:00 AM,48,-122,2,0,2
5020,58thStGreenway22ndAve,07/29/2014 04:00:00 AM,48,-122,0,0,0
5021,58thStGreenway22ndAve,07/29/2014 05:00:00 AM,48,-122,2,0,2
5022,58thStGreenway22ndAve,07/29/2014 06:00:00 AM,48,-122,9,8,17
5023,58thStGreenway22ndAve,07/29/2014 07:00:00 AM,48,-122,16,6,22
5024,58thStGreenway22ndAve,07/29/2014 08:00:00 AM,48,-122,37,17,54
5025,58thStGreenway22ndAve,07/29/2014 09:00:00 AM,48,-122,28,16,44
5026,58thStGreenway22ndAve,07/29/2014 10:00:00 AM,48,-122,25,14,39
5027,58thStGreenway22ndAve,07/29/2014 11:00:00 AM,48,-122,25,11,36
5028,58thStGreenway22ndAve,07/29/2014 12:00:00 PM,48,-122,36,14,50
5029,58thStGreenway22ndAve,07/29/2014 01:00:00 PM,48,-122,34,11,45
5030,58thStGreenway22ndAve,07/29/2014 02:00:00 PM,48,-122,43,16,59
5031,58thStGreenway22ndAve,07/29/2014 03:00:00 PM,48,-122,16,12,28
5032,58thStGreenway22ndAve,07/29/2014 04:00:00 PM,48,-122,24,15,39
5033,58thStGreenway22ndAve,07/29/2014 05:00:00 PM,48,-122,29,14,43
5034,58thStGreenway22ndAve,07/29/2014 06:00:00 PM,48,-122,36,25,61
5035,58thStGreenway22ndAve,07/29/2014 07:00:00 PM,48,-122,34,19,53
5036,58thStGreenway22ndAve,07/29/2014 08:00:00 PM,48,-122,24,10,34
5037,58thStGreenway22ndAve,07/29/2014 09:00:00 PM,48,-122,29,3,32
5038,58thStGreenway22ndAve,07/29/2014 10:00:00 PM,48,-122,7,0,7
5039,58thStGreenway22ndAve,07/29/2014 11:00:00 PM,48,-122,5,1,6
5040,58thStGreenway22ndAve,07/30/2014 12:00:00 AM,48,-122,0,1,1
5041,58thStGreenway22ndAve,07/30/2014 01:00:00 AM,48,-122,0,0,0
5042,58thStGreenway22ndAve,07/30/2014 02:00:00 AM,48,-122,0,0,0
5043,58thStGreenway22ndAve,07/30/2014 03:00:00 AM,48,-122,2,0,2
5044,58thStGreenway22ndAve,07/30/2014 04:00:00 AM,48,-122,0,0,0
5045,58thStGreenway22ndAve,07/30/2014 05:00:00 AM,48,-122,0,3,3
5046,58thStGreenway22ndAve,07/30/2014 06:00:00 AM,48,-122,3,6,9
5047,58thStGreenway22ndAve,07/30/2014 07:00:00 AM,48,-122,19,4,23
5048,58thStGreenway22ndAve,07/30/2014 08:00:00 AM,48,-122,22,4,26
5049,58thStGreenway22ndAve,07/30/2014 09:00:00 AM,48,-122,34,16,50
5050,58thStGreenway22ndAve,07/30/2014 10:00:00 AM,48,-122,21,24,45
5051,58thStGreenway22ndAve,07/30/2014 11:00:00 AM,48,-122,15,15,30
5052,58thStGreenway22ndAve,07/30/2014 12:00:00 PM,48,-122,31,20,51
5053,58thStGreenway22ndAve,07/30/2014 01:00:00 PM,48,-122,24,18,42
5054,58thStGreenway22ndAve,07/30/2014 02:00:00 PM,48,-122,20,9,29
5055,58thStGreenway22ndAve,07/30/2014 03:00:00 PM,48,-122,31,19,50
5056,58thStGreenway22ndAve,07/30/2014 04:00:00 PM,48,-122,21,21,42
5057,58thStGreenway22ndAve,07/30/2014 05:00:00 PM,48,-122,28,17,45
5058,58thStGreenway22ndAve,07/30/2014 06:00:00 PM,48,-122,31,21,52
5059,58thStGreenway22ndAve,07/30/2014 07:00:00 PM,48,-122,18,25,43
5060,58thStGreenway22ndAve,07/30/2014 08:00:00 PM,48,-122,29,20,49
5061,58thStGreenway22ndAve,07/30/2014 09:00:00 PM,48,-122,25,13,38
5062,58thStGreenway22ndAve,07/30/2014 10:00:00 PM,48,-122,20,3,23
5063,58thStGreenway22ndAve,07/30/2014 11:00:00 PM,48,-122,4,3,7
5064,58thStGreenway22ndAve,07/31/2014 12:00:00 AM,48,-122,2,1,3
5065,58thStGreenway22ndAve,07/31/2014 01:00:00 AM,48,-122,3,0,3
5066,58thStGreenway22ndAve,07/31/2014 02:00:00 AM,48,-122,0,2,2
5067,58thStGreenway22ndAve,07/31/2014 03:00:00 AM,48,-122,0,0,0
5068,58thStGreenway22ndAve,07/31/2014 04:00:00 AM,48,-122,0,0,0
5069,58thStGreenway22ndAve,07/31/2014 05:00:00 AM,48,-122,0,0,0
5070,58thStGreenway22ndAve,07/31/2014 06:00:00 AM,48,-122,6,6,12
5071,58thStGreenway22ndAve,07/31/2014 07:00:00 AM,48,-122,20,5,25
5072,58thStGreenway22ndAve,07/31/2014 08:00:00 AM,48,-122,14,7,21
5073,58thStGreenway22ndAve,07/31/2014 09:00:00 AM,48,-122,29,15,44
5074,58thStGreenway22ndAve,07/31/2014 10:00:00 AM,48,-122,37,8,45
5075,58thStGreenway22ndAve,07/31/2014 11:00:00 AM,48,-122,37,22,59
5076,58thStGreenway22ndAve,07/31/2014 12:00:00 PM,48,-122,25,20,45
5077,58thStGreenway22ndAve,07/31/2014 01:00:00 PM,48,-122,33,13,46
5078,58thStGreenway22ndAve,07/31/2014 02:00:00 PM,48,-122,36,13,49
5079,58thStGreenway22ndAve,07/31/2014 03:00:00 PM,48,-122,27,32,59
5080,58thStGreenway22ndAve,07/31/2014 04:00:00 PM,48,-122,45,21,66
5081,58thStGreenway22ndAve,07/31/2014 05:00:00 PM,48,-122,39,27,66
5082,58thStGreenway22ndAve,07/31/2014 06:00:00 PM,48,-122,28,27,55
5083,58thStGreenway22ndAve,07/31/2014 07:00:00 PM,48,-122,28,28,56
5084,58thStGreenway22ndAve,07/31/2014 08:00:00 PM,48,-122,17,13,30
5085,58thStGreenway22ndAve,07/31/2014 09:00:00 PM,48,-122,24,8,32
5086,58thStGreenway22ndAve,07/31/2014 10:00:00 PM,48,-122,5,2,7
5087,58thStGreenway22ndAve,07/31/2014 11:00:00 PM,48,-122,8,1,9
5088,58thStGreenway22ndAve,08/01/2014 12:00:00 AM,48,-122,8,0,8
5089,58thStGreenway22ndAve,08/01/2014 01:00:00 AM,48,-122,3,1,4
5090,58thStGreenway22ndAve,08/01/2014 02:00:00 AM,48,-122,0,0,0
5091,58thStGreenway22ndAve,08/01/2014 03:00:00 AM,48,-122,0,0,0
5092,58thStGreenway22ndAve,08/01/2014 04:00:00 AM,48,-122,0,0,0
5093,58thStGreenway22ndAve,08/01/2014 05:00:00 AM,48,-122,0,1,1
5094,58thStGreenway22ndAve,08/01/2014 06:00:00 AM,48,-122,7,4,11
5095,58thStGreenway22ndAve,08/01/2014 07:00:00 AM,48,-122,23,3,26
5096,58thStGreenway22ndAve,08/01/2014 08:00:00 AM,48,-122,17,10,27
5097,58thStGreenway22ndAve,08/01/2014 09:00:00 AM,48,-122,10,4,14
5098,58thStGreenway22ndAve,08/01/2014 10:00:00 AM,48,-122,33,21,54
5099,58thStGreenway22ndAve,08/01/2014 11:00:00 AM,48,-122,37,17,54
5100,58thStGreenway22ndAve,08/01/2014 12:00:00 PM,48,-122,30,13,43
5101,58thStGreenway22ndAve,08/01/2014 01:00:00 PM,48,-122,15,8,23
5102,58thStGreenway22ndAve,08/01/2014 02:00:00 PM,48,-122,19,14,33
5103,58thStGreenway22ndAve,08/01/2014 03:00:00 PM,48,-122,32,18,50
5104,58thStGreenway22ndAve,08/01/2014 04:00:00 PM,48,-122,13,22,35
5105,58thStGreenway22ndAve,08/01/2014 05:00:00 PM,48,-122,31,23,54
5106,58thStGreenway22ndAve,08/01/2014 06:00:00 PM,48,-122,26,23,49
5107,58thStGreenway22ndAve,08/01/2014 07:00:00 PM,48,-122,16,10,26
5108,58thStGreenway22ndAve,08/01/2014 08:00:00 PM,48,-122,13,12,25
5109,58thStGreenway22ndAve,08/01/2014 09:00:00 PM,48,-122,19,10,29
5110,58thStGreenway22ndAve,08/01/2014 10:00:00 PM,48,-122,7,1,8
5111,58thStGreenway22ndAve,08/01/2014 11:00:00 PM,48,-122,12,2,14
5112,58thStGreenway22ndAve,08/02/2014 12:00:00 AM,48,-122,2,0,2
5113,58thStGreenway22ndAve,08/02/2014 01:00:00 AM,48,-122,4,0,4
5114,58thStGreenway22ndAve,08/02/2014 02:00:00 AM,48,-122,2,0,2
5115,58thStGreenway22ndAve,08/02/2014 03:00:00 AM,48,-122,3,0,3
5116,58thStGreenway22ndAve,08/02/2014 04:00:00 AM,48,-122,0,1,1
5117,58thStGreenway22ndAve,08/02/2014 05:00:00 AM,48,-122,2,1,3
5118,58thStGreenway22ndAve,08/02/2014 06:00:00 AM,48,-122,0,0,0
5119,58thStGreenway22ndAve,08/02/2014 07:00:00 AM,48,-122,1,2,3
5120,58thStGreenway22ndAve,08/02/2014 08:00:00 AM,48,-122,11,3,14
5121,58thStGreenway22ndAve,08/02/2014 09:00:00 AM,48,-122,30,9,39
5122,58thStGreenway22ndAve,08/02/2014 10:00:00 AM,48,-122,17,18,35
5123,58thStGreenway22ndAve,08/02/2014 11:00:00 AM,48,-122,21,24,45
5124,58thStGreenway22ndAve,08/02/2014 12:00:00 PM,48,-122,27,34,61
5125,58thStGreenway22ndAve,08/02/2014 01:00:00 PM,48,-122,18,17,35
5126,58thStGreenway22ndAve,08/02/2014 02:00:00 PM,48,-122,26,24,50
5127,58thStGreenway22ndAve,08/02/2014 03:00:00 PM,48,-122,27,22,49
5128,58thStGreenway22ndAve,08/02/2014 04:00:00 PM,48,-122,34,17,51
5129,58thStGreenway22ndAve,08/02/2014 05:00:00 PM,48,-122,34,23,57
5130,58thStGreenway22ndAve,08/02/2014 06:00:00 PM,48,-122,37,11,48
5131,58thStGreenway22ndAve,08/02/2014 07:00:00 PM,48,-122,26,18,44
5132,58thStGreenway22ndAve,08/02/2014 08:00:00 PM,48,-122,25,11,36
5133,58thStGreenway22ndAve,08/02/2014 09:00:00 PM,48,-122,24,14,38
5134,58thStGreenway22ndAve,08/02/2014 10:00:00 PM,48,-122,13,0,13
5135,58thStGreenway22ndAve,08/02/2014 11:00:00 PM,48,-122,5,4,9
5136,58thStGreenway22ndAve,08/03/2014 12:00:00 AM,48,-122,5,4,9
5137,58thStGreenway22ndAve,08/03/2014 01:00:00 AM,48,-122,0,0,0
5138,58thStGreenway22ndAve,08/03/2014 02:00:00 AM,48,-122,1,0,1
5139,58thStGreenway22ndAve,08/03/2014 03:00:00 AM,48,-122,0,2,2
5140,58thStGreenway22ndAve,08/03/2014 04:00:00 AM,48,-122,1,0,1
5141,58thStGreenway22ndAve,08/03/2014 05:00:00 AM,48,-122,2,0,2
5142,58thStGreenway22ndAve,08/03/2014 06:00:00 AM,48,-122,1,0,1
5143,58thStGreenway22ndAve,08/03/2014 07:00:00 AM,48,-122,2,3,5
5144,58thStGreenway22ndAve,08/03/2014 08:00:00 AM,48,-122,12,2,14
5145,58thStGreenway22ndAve,08/03/2014 09:00:00 AM,48,-122,16,12,28
5146,58thStGreenway22ndAve,08/03/2014 10:00:00 AM,48,-122,25,14,39
5147,58thStGreenway22ndAve,08/03/2014 11:00:00 AM,48,-122,26,25,51
5148,58thStGreenway22ndAve,08/03/2014 12:00:00 PM,48,-122,39,27,66
5149,58thStGreenway22ndAve,08/03/2014 01:00:00 PM,48,-122,45,32,77
5150,58thStGreenway22ndAve,08/03/2014 02:00:00 PM,48,-122,33,29,62
5151,58thStGreenway22ndAve,08/03/2014 03:00:00 PM,48,-122,25,24,49
5152,58thStGreenway22ndAve,08/03/2014 04:00:00 PM,48,-122,55,11,66
5153,58thStGreenway22ndAve,08/03/2014 05:00:00 PM,48,-122,26,8,34
5154,58thStGreenway22ndAve,08/03/2014 06:00:00 PM,48,-122,25,10,35
5155,58thStGreenway22ndAve,08/03/2014 07:00:00 PM,48,-122,18,10,28
5156,58thStGreenway22ndAve,08/03/2014 08:00:00 PM,48,-122,29,7,36
5157,58thStGreenway22ndAve,08/03/2014 09:00:00 PM,48,-122,19,4,23
5158,58thStGreenway22ndAve,08/03/2014 10:00:00 PM,48,-122,5,0,5
5159,58thStGreenway22ndAve,08/03/2014 11:00:00 PM,48,-122,2,4,6
5160,58thStGreenway22ndAve,08/04/2014 12:00:00 AM,48,-122,0,1,1
5161,58thStGreenway22ndAve,08/04/2014 01:00:00 AM,48,-122,3,3,6
5162,58thStGreenway22ndAve,08/04/2014 02:00:00 AM,48,-122,0,0,0
5163,58thStGreenway22ndAve,08/04/2014 03:00:00 AM,48,-122,0,0,0
5164,58thStGreenway22ndAve,08/04/2014 04:00:00 AM,48,-122,4,0,4
5165,58thStGreenway22ndAve,08/04/2014 05:00:00 AM,48,-122,0,0,0
5166,58thStGreenway22ndAve,08/04/2014 06:00:00 AM,48,-122,13,7,20
5167,58thStGreenway22ndAve,08/04/2014 07:00:00 AM,48,-122,8,8,16
5168,58thStGreenway22ndAve,08/04/2014 08:00:00 AM,48,-122,20,16,36
5169,58thStGreenway22ndAve,08/04/2014 09:00:00 AM,48,-122,33,14,47
5170,58thStGreenway22ndAve,08/04/2014 10:00:00 AM,48,-122,29,17,46
5171,58thStGreenway22ndAve,08/04/2014 11:00:00 AM,48,-122,36,7,43
5172,58thStGreenway22ndAve,08/04/2014 12:00:00 PM,48,-122,42,15,57
5173,58thStGreenway22ndAve,08/04/2014 01:00:00 PM,48,-122,45,10,55
5174,58thStGreenway22ndAve,08/04/2014 02:00:00 PM,48,-122,42,20,62
5175,58thStGreenway22ndAve,08/04/2014 03:00:00 PM,48,-122,24,22,46
5176,58thStGreenway22ndAve,08/04/2014 04:00:00 PM,48,-122,47,8,55
5177,58thStGreenway22ndAve,08/04/2014 05:00:00 PM,48,-122,45,28,73
5178,58thStGreenway22ndAve,08/04/2014 06:00:00 PM,48,-122,38,32,70
5179,58thStGreenway22ndAve,08/04/2014 07:00:00 PM,48,-122,39,11,50
5180,58thStGreenway22ndAve,08/04/2014 08:00:00 PM,48,-122,18,13,31
5181,58thStGreenway22ndAve,08/04/2014 09:00:00 PM,48,-122,7,8,15
5182,58thStGreenway22ndAve,08/04/2014 10:00:00 PM,48,-122,7,1,8
5183,58thStGreenway22ndAve,08/04/2014 11:00:00 PM,48,-122,6,2,8
5184,58thStGreenway22ndAve,08/05/2014 12:00:00 AM,48,-122,2,1,3
5185,58thStGreenway22ndAve,08/05/2014 01:00:00 AM,48,-122,3,0,3
5186,58thStGreenway22ndAve,08/05/2014 02:00:00 AM,48,-122,0,0,0
5187,58thStGreenway22ndAve,08/05/2014 03:00:00 AM,48,-122,0,0,0
5188,58thStGreenway22ndAve,08/05/2014 04:00:00 AM,48,-122,2,0,2
5189,58thStGreenway22ndAve,08/05/2014 05:00:00 AM,48,-122,2,1,3
5190,58thStGreenway22ndAve,08/05/2014 06:00:00 AM,48,-122,10,7,17
5191,58thStGreenway22ndAve,08/05/2014 07:00:00 AM,48,-122,22,7,29
5192,58thStGreenway22ndAve,08/05/2014 08:00:00 AM,48,-122,40,17,57
5193,58thStGreenway22ndAve,08/05/2014 09:00:00 AM,48,-122,18,15,33
5194,58thStGreenway22ndAve,08/05/2014 10:00:00 AM,48,-122,22,14,36
5195,58thStGreenway22ndAve,08/05/2014 11:00:00 AM,48,-122,26,11,37
5196,58thStGreenway22ndAve,08/05/2014 12:00:00 PM,48,-122,25,12,37
5197,58thStGreenway22ndAve,08/05/2014 01:00:00 PM,48,-122,32,21,53
5198,58thStGreenway22ndAve,08/05/2014 02:00:00 PM,48,-122,25,15,40
5199,58thStGreenway22ndAve,08/05/2014 03:00:00 PM,48,-122,36,18,54
5200,58thStGreenway22ndAve,08/05/2014 04:00:00 PM,48,-122,45,12,57
5201,58thStGreenway22ndAve,08/05/2014 05:00:00 PM,48,-122,44,30,74
5202,58thStGreenway22ndAve,08/05/2014 06:00:00 PM,48,-122,16,13,29
5203,58thStGreenway22ndAve,08/05/2014 07:00:00 PM,48,-122,10,30,40
5204,58thStGreenway22ndAve,08/05/2014 08:00:00 PM,48,-122,10,4,14
5205,58thStGreenway22ndAve,08/05/2014 09:00:00 PM,48,-122,5,2,7
5206,58thStGreenway22ndAve,08/05/2014 10:00:00 PM,48,-122,3,0,3
5207,58thStGreenway22ndAve,08/05/2014 11:00:00 PM,48,-122,4,3,7
5208,58thStGreenway22ndAve,08/06/2014 12:00:00 AM,48,-122,1,0,1
5209,58thStGreenway22ndAve,08/06/2014 01:00:00 AM,48,-122,0,0,0
5210,58thStGreenway22ndAve,08/06/2014 02:00:00 AM,48,-122,0,0,0
5211,58thStGreenway22ndAve,08/06/2014 03:00:00 AM,48,-122,0,0,0
5212,58thStGreenway22ndAve,08/06/2014 04:00:00 AM,48,-122,1,0,1
5213,58thStGreenway22ndAve,08/06/2014 05:00:00 AM,48,-122,1,0,1
5214,58thStGreenway22ndAve,08/06/2014 06:00:00 AM,48,-122,9,4,13
5215,58thStGreenway22ndAve,08/06/2014 07:00:00 AM,48,-122,21,9,30
5216,58thStGreenway22ndAve,08/06/2014 08:00:00 AM,48,-122,29,15,44
5217,58thStGreenway22ndAve,08/06/2014 09:00:00 AM,48,-122,22,18,40
5218,58thStGreenway22ndAve,08/06/2014 10:00:00 AM,48,-122,26,13,39
5219,58thStGreenway22ndAve,08/06/2014 11:00:00 AM,48,-122,18,12,30
5220,58thStGreenway22ndAve,08/06/2014 12:00:00 PM,48,-122,26,13,39
5221,58thStGreenway22ndAve,08/06/2014 01:00:00 PM,48,-122,13,6,19
5222,58thStGreenway22ndAve,08/06/2014 02:00:00 PM,48,-122,19,13,32
5223,58thStGreenway22ndAve,08/06/2014 03:00:00 PM,48,-122,19,17,36
5224,58thStGreenway22ndAve,08/06/2014 04:00:00 PM,48,-122,40,20,60
5225,58thStGreenway22ndAve,08/06/2014 05:00:00 PM,48,-122,32,12,44
5226,58thStGreenway22ndAve,08/06/2014 06:00:00 PM,48,-122,36,30,66
5227,58thStGreenway22ndAve,08/06/2014 07:00:00 PM,48,-122,16,15,31
5228,58thStGreenway22ndAve,08/06/2014 08:00:00 PM,48,-122,22,14,36
5229,58thStGreenway22ndAve,08/06/2014 09:00:00 PM,48,-122,19,3,22
5230,58thStGreenway22ndAve,08/06/2014 10:00:00 PM,48,-122,4,1,5
5231,58thStGreenway22ndAve,08/06/2014 11:00:00 PM,48,-122,3,2,5
5232,58thStGreenway22ndAve,08/07/2014 12:00:00 AM,48,-122,2,0,2
5233,58thStGreenway22ndAve,08/07/2014 01:00:00 AM,48,-122,3,0,3
5234,58thStGreenway22ndAve,08/07/2014 02:00:00 AM,48,-122,0,0,0
5235,58thStGreenway22ndAve,08/07/2014 03:00:00 AM,48,-122,0,1,1
5236,58thStGreenway22ndAve,08/07/2014 04:00:00 AM,48,-122,0,0,0
5237,58thStGreenway22ndAve,08/07/2014 05:00:00 AM,48,-122,4,4,8
5238,58thStGreenway22ndAve,08/07/2014 06:00:00 AM,48,-122,4,4,8
5239,58thStGreenway22ndAve,08/07/2014 07:00:00 AM,48,-122,22,3,25
5240,58thStGreenway22ndAve,08/07/2014 08:00:00 AM,48,-122,26,10,36
5241,58thStGreenway22ndAve,08/07/2014 09:00:00 AM,48,-122,18,15,33
5242,58thStGreenway22ndAve,08/07/2014 10:00:00 AM,48,-122,21,17,38
5243,58thStGreenway22ndAve,08/07/2014 11:00:00 AM,48,-122,25,9,34
5244,58thStGreenway22ndAve,08/07/2014 12:00:00 PM,48,-122,24,17,41
5245,58thStGreenway22ndAve,08/07/2014 01:00:00 PM,48,-122,39,8,47
5246,58thStGreenway22ndAve,08/07/2014 02:00:00 PM,48,-122,42,18,60
5247,58thStGreenway22ndAve,08/07/2014 03:00:00 PM,48,-122,37,12,49
5248,58thStGreenway22ndAve,08/07/2014 04:00:00 PM,48,-122,25,10,35
5249,58thStGreenway22ndAve,08/07/2014 05:00:00 PM,48,-122,47,11,58
5250,58thStGreenway22ndAve,08/07/2014 06:00:00 PM,48,-122,25,28,53
5251,58thStGreenway22ndAve,08/07/2014 07:00:00 PM,48,-122,13,13,26
5252,58thStGreenway22ndAve,08/07/2014 08:00:00 PM,48,-122,11,10,21
5253,58thStGreenway22ndAve,08/07/2014 09:00:00 PM,48,-122,12,5,17
5254,58thStGreenway22ndAve,08/07/2014 10:00:00 PM,48,-122,6,1,7
5255,58thStGreenway22ndAve,08/07/2014 11:00:00 PM,48,-122,7,4,11
5256,58thStGreenway22ndAve,08/08/2014 12:00:00 AM,48,-122,0,1,1
5257,58thStGreenway22ndAve,08/08/2014 01:00:00 AM,48,-122,4,1,5
5258,58thStGreenway22ndAve,08/08/2014 02:00:00 AM,48,-122,0,2,2
5259,58thStGreenway22ndAve,08/08/2014 03:00:00 AM,48,-122,0,1,1
5260,58thStGreenway22ndAve,08/08/2014 04:00:00 AM,48,-122,0,0,0
5261,58thStGreenway22ndAve,08/08/2014 05:00:00 AM,48,-122,2,1,3
5262,58thStGreenway22ndAve,08/08/2014 06:00:00 AM,48,-122,8,3,11
5263,58thStGreenway22ndAve,08/08/2014 07:00:00 AM,48,-122,15,8,23
5264,58thStGreenway22ndAve,08/08/2014 08:00:00 AM,48,-122,20,8,28
5265,58thStGreenway22ndAve,08/08/2014 09:00:00 AM,48,-122,12,12,24
5266,58thStGreenway22ndAve,08/08/2014 10:00:00 AM,48,-122,11,17,28
5267,58thStGreenway22ndAve,08/08/2014 11:00:00 AM,48,-122,37,15,52
5268,58thStGreenway22ndAve,08/08/2014 12:00:00 PM,48,-122,19,29,48
5269,58thStGreenway22ndAve,08/08/2014 01:00:00 PM,48,-122,36,18,54
5270,58thStGreenway22ndAve,08/08/2014 02:00:00 PM,48,-122,27,10,37
5271,58thStGreenway22ndAve,08/08/2014 03:00:00 PM,48,-122,20,9,29
5272,58thStGreenway22ndAve,08/08/2014 04:00:00 PM,48,-122,34,13,47
5273,58thStGreenway22ndAve,08/08/2014 05:00:00 PM,48,-122,38,11,49
5274,58thStGreenway22ndAve,08/08/2014 06:00:00 PM,48,-122,40,29,69
5275,58thStGreenway22ndAve,08/08/2014 07:00:00 PM,48,-122,11,7,18
5276,58thStGreenway22ndAve,08/08/2014 08:00:00 PM,48,-122,21,8,29
5277,58thStGreenway22ndAve,08/08/2014 09:00:00 PM,48,-122,15,6,21
5278,58thStGreenway22ndAve,08/08/2014 10:00:00 PM,48,-122,6,3,9
5279,58thStGreenway22ndAve,08/08/2014 11:00:00 PM,48,-122,7,1,8
5280,58thStGreenway22ndAve,08/09/2014 12:00:00 AM,48,-122,2,0,2
5281,58thStGreenway22ndAve,08/09/2014 01:00:00 AM,48,-122,4,3,7
5282,58thStGreenway22ndAve,08/09/2014 02:00:00 AM,48,-122,0,0,0
5283,58thStGreenway22ndAve,08/09/2014 03:00:00 AM,48,-122,0,1,1
5284,58thStGreenway22ndAve,08/09/2014 04:00:00 AM,48,-122,0,0,0
5285,58thStGreenway22ndAve,08/09/2014 05:00:00 AM,48,-122,2,0,2
5286,58thStGreenway22ndAve,08/09/2014 06:00:00 AM,48,-122,0,1,1
5287,58thStGreenway22ndAve,08/09/2014 07:00:00 AM,48,-122,8,6,14
5288,58thStGreenway22ndAve,08/09/2014 08:00:00 AM,48,-122,15,13,28
5289,58thStGreenway22ndAve,08/09/2014 09:00:00 AM,48,-122,29,7,36
5290,58thStGreenway22ndAve,08/09/2014 10:00:00 AM,48,-122,25,12,37
5291,58thStGreenway22ndAve,08/09/2014 11:00:00 AM,48,-122,30,20,50
5292,58thStGreenway22ndAve,08/09/2014 12:00:00 PM,48,-122,38,15,53
5293,58thStGreenway22ndAve,08/09/2014 01:00:00 PM,48,-122,50,10,60
5294,58thStGreenway22ndAve,08/09/2014 02:00:00 PM,48,-122,21,17,38
5295,58thStGreenway22ndAve,08/09/2014 03:00:00 PM,48,-122,22,16,38
5296,58thStGreenway22ndAve,08/09/2014 04:00:00 PM,48,-122,24,14,38
5297,58thStGreenway22ndAve,08/09/2014 05:00:00 PM,48,-122,28,26,54
5298,58thStGreenway22ndAve,08/09/2014 06:00:00 PM,48,-122,21,6,27
5299,58thStGreenway22ndAve,08/09/2014 07:00:00 PM,48,-122,19,8,27
5300,58thStGreenway22ndAve,08/09/2014 08:00:00 PM,48,-122,26,4,30
5301,58thStGreenway22ndAve,08/09/2014 09:00:00 PM,48,-122,10,2,12
5302,58thStGreenway22ndAve,08/09/2014 10:00:00 PM,48,-122,16,5,21
5303,58thStGreenway22ndAve,08/09/2014 11:00:00 PM,48,-122,6,2,8
5304,58thStGreenway22ndAve,08/10/2014 12:00:00 AM,48,-122,4,3,7
5305,58thStGreenway22ndAve,08/10/2014 01:00:00 AM,48,-122,4,1,5
5306,58thStGreenway22ndAve,08/10/2014 02:00:00 AM,48,-122,3,0,3
5307,58thStGreenway22ndAve,08/10/2014 03:00:00 AM,48,-122,3,0,3
5308,58thStGreenway22ndAve,08/10/2014 04:00:00 AM,48,-122,0,0,0
5309,58thStGreenway22ndAve,08/10/2014 05:00:00 AM,48,-122,2,0,2
5310,58thStGreenway22ndAve,08/10/2014 06:00:00 AM,48,-122,2,0,2
5311,58thStGreenway22ndAve,08/10/2014 07:00:00 AM,48,-122,1,2,3
5312,58thStGreenway22ndAve,08/10/2014 08:00:00 AM,48,-122,3,7,10
5313,58thStGreenway22ndAve,08/10/2014 09:00:00 AM,48,-122,19,12,31
5314,58thStGreenway22ndAve,08/10/2014 10:00:00 AM,48,-122,28,14,42
5315,58thStGreenway22ndAve,08/10/2014 11:00:00 AM,48,-122,18,29,47
5316,58thStGreenway22ndAve,08/10/2014 12:00:00 PM,48,-122,57,30,87
5317,58thStGreenway22ndAve,08/10/2014 01:00:00 PM,48,-122,38,26,64
5318,58thStGreenway22ndAve,08/10/2014 02:00:00 PM,48,-122,36,31,67
5319,58thStGreenway22ndAve,08/10/2014 03:00:00 PM,48,-122,37,16,53
5320,58thStGreenway22ndAve,08/10/2014 04:00:00 PM,48,-122,23,25,48
5321,58thStGreenway22ndAve,08/10/2014 05:00:00 PM,48,-122,31,8,39
5322,58thStGreenway22ndAve,08/10/2014 06:00:00 PM,48,-122,40,16,56
5323,58thStGreenway22ndAve,08/10/2014 07:00:00 PM,48,-122,16,14,30
5324,58thStGreenway22ndAve,08/10/2014 08:00:00 PM,48,-122,11,3,14
5325,58thStGreenway22ndAve,08/10/2014 09:00:00 PM,48,-122,7,1,8
5326,58thStGreenway22ndAve,08/10/2014 10:00:00 PM,48,-122,13,1,14
5327,58thStGreenway22ndAve,08/10/2014 11:00:00 PM,48,-122,3,0,3
5328,58thStGreenway22ndAve,08/11/2014 12:00:00 AM,48,-122,0,1,1
5329,58thStGreenway22ndAve,08/11/2014 01:00:00 AM,48,-122,0,2,2
5330,58thStGreenway22ndAve,08/11/2014 02:00:00 AM,48,-122,0,0,0
5331,58thStGreenway22ndAve,08/11/2014 03:00:00 AM,48,-122,0,0,0
5332,58thStGreenway22ndAve,08/11/2014 04:00:00 AM,48,-122,0,0,0
5333,58thStGreenway22ndAve,08/11/2014 05:00:00 AM,48,-122,0,0,0
5334,58thStGreenway22ndAve,08/11/2014 06:00:00 AM,48,-122,8,2,10
5335,58thStGreenway22ndAve,08/11/2014 07:00:00 AM,48,-122,21,7,28
5336,58thStGreenway22ndAve,08/11/2014 08:00:00 AM,48,-122,33,17,50
5337,58thStGreenway22ndAve,08/11/2014 09:00:00 AM,48,-122,11,14,25
5338,58thStGreenway22ndAve,08/11/2014 10:00:00 AM,48,-122,22,16,38
5339,58thStGreenway22ndAve,08/11/2014 11:00:00 AM,48,-122,20,10,30
5340,58thStGreenway22ndAve,08/11/2014 12:00:00 PM,48,-122,31,21,52
5341,58thStGreenway22ndAve,08/11/2014 01:00:00 PM,48,-122,24,17,41
5342,58thStGreenway22ndAve,08/11/2014 02:00:00 PM,48,-122,29,14,43
5343,58thStGreenway22ndAve,08/11/2014 03:00:00 PM,48,-122,24,8,32
5344,58thStGreenway22ndAve,08/11/2014 04:00:00 PM,48,-122,33,10,43
5345,58thStGreenway22ndAve,08/11/2014 05:00:00 PM,48,-122,38,28,66
5346,58thStGreenway22ndAve,08/11/2014 06:00:00 PM,48,-122,19,27,46
5347,58thStGreenway22ndAve,08/11/2014 07:00:00 PM,48,-122,17,14,31
5348,58thStGreenway22ndAve,08/11/2014 08:00:00 PM,48,-122,15,4,19
5349,58thStGreenway22ndAve,08/11/2014 09:00:00 PM,48,-122,13,3,16
5350,58thStGreenway22ndAve,08/11/2014 10:00:00 PM,48,-122,4,0,4
5351,58thStGreenway22ndAve,08/11/2014 11:00:00 PM,48,-122,0,2,2
5352,58thStGreenway22ndAve,08/12/2014 12:00:00 AM,48,-122,2,0,2
5353,58thStGreenway22ndAve,08/12/2014 01:00:00 AM,48,-122,1,1,2
5354,58thStGreenway22ndAve,08/12/2014 02:00:00 AM,48,-122,1,0,1
5355,58thStGreenway22ndAve,08/12/2014 03:00:00 AM,48,-122,0,0,0
5356,58thStGreenway22ndAve,08/12/2014 04:00:00 AM,48,-122,4,1,5
5357,58thStGreenway22ndAve,08/12/2014 05:00:00 AM,48,-122,6,2,8
5358,58thStGreenway22ndAve,08/12/2014 06:00:00 AM,48,-122,13,3,16
5359,58thStGreenway22ndAve,08/12/2014 07:00:00 AM,48,-122,15,5,20
5360,58thStGreenway22ndAve,08/12/2014 08:00:00 AM,48,-122,18,3,21
5361,58thStGreenway22ndAve,08/12/2014 09:00:00 AM,48,-122,28,12,40
5362,58thStGreenway22ndAve,08/12/2014 10:00:00 AM,48,-122,18,19,37
5363,58thStGreenway22ndAve,08/12/2014 11:00:00 AM,48,-122,25,10,35
5364,58thStGreenway22ndAve,08/12/2014 12:00:00 PM,48,-122,31,15,46
5365,58thStGreenway22ndAve,08/12/2014 01:00:00 PM,48,-122,23,13,36
5366,58thStGreenway22ndAve,08/12/2014 02:00:00 PM,48,-122,26,13,39
5367,58thStGreenway22ndAve,08/12/2014 03:00:00 PM,48,-122,27,18,45
5368,58thStGreenway22ndAve,08/12/2014 04:00:00 PM,48,-122,37,26,63
5369,58thStGreenway22ndAve,08/12/2014 05:00:00 PM,48,-122,27,24,51
5370,58thStGreenway22ndAve,08/12/2014 06:00:00 PM,48,-122,36,42,78
5371,58thStGreenway22ndAve,08/12/2014 07:00:00 PM,48,-122,22,12,34
5372,58thStGreenway22ndAve,08/12/2014 08:00:00 PM,48,-122,26,7,33
5373,58thStGreenway22ndAve,08/12/2014 09:00:00 PM,48,-122,17,3,20
5374,58thStGreenway22ndAve,08/12/2014 10:00:00 PM,48,-122,2,3,5
5375,58thStGreenway22ndAve,08/12/2014 11:00:00 PM,48,-122,2,1,3
5376,58thStGreenway22ndAve,08/13/2014 12:00:00 AM,48,-122,4,1,5
5377,58thStGreenway22ndAve,08/13/2014 01:00:00 AM,48,-122,0,2,2
5378,58thStGreenway22ndAve,08/13/2014 02:00:00 AM,48,-122,2,0,2
5379,58thStGreenway22ndAve,08/13/2014 03:00:00 AM,48,-122,2,0,2
5380,58thStGreenway22ndAve,08/13/2014 04:00:00 AM,48,-122,0,0,0
5381,58thStGreenway22ndAve,08/13/2014 05:00:00 AM,48,-122,5,0,5
5382,58thStGreenway22ndAve,08/13/2014 06:00:00 AM,48,-122,2,4,6
5383,58thStGreenway22ndAve,08/13/2014 07:00:00 AM,48,-122,15,10,25
5384,58thStGreenway22ndAve,08/13/2014 08:00:00 AM,48,-122,24,7,31
5385,58thStGreenway22ndAve,08/13/2014 09:00:00 AM,48,-122,18,3,21
5386,58thStGreenway22ndAve,08/13/2014 10:00:00 AM,48,-122,11,10,21
5387,58thStGreenway22ndAve,08/13/2014 11:00:00 AM,48,-122,10,9,19
5388,58thStGreenway22ndAve,08/13/2014 12:00:00 PM,48,-122,20,13,33
5389,58thStGreenway22ndAve,08/13/2014 01:00:00 PM,48,-122,24,11,35
5390,58thStGreenway22ndAve,08/13/2014 02:00:00 PM,48,-122,32,8,40
5391,58thStGreenway22ndAve,08/13/2014 03:00:00 PM,48,-122,23,4,27
5392,58thStGreenway22ndAve,08/13/2014 04:00:00 PM,48,-122,30,11,41
5393,58thStGreenway22ndAve,08/13/2014 05:00:00 PM,48,-122,22,18,40
5394,58thStGreenway22ndAve,08/13/2014 06:00:00 PM,48,-122,40,33,73
5395,58thStGreenway22ndAve,08/13/2014 07:00:00 PM,48,-122,29,13,42
5396,58thStGreenway22ndAve,08/13/2014 08:00:00 PM,48,-122,13,9,22
5397,58thStGreenway22ndAve,08/13/2014 09:00:00 PM,48,-122,13,9,22
5398,58thStGreenway22ndAve,08/13/2014 10:00:00 PM,48,-122,10,3,13
5399,58thStGreenway22ndAve,08/13/2014 11:00:00 PM,48,-122,7,1,8
5400,58thStGreenway22ndAve,08/14/2014 12:00:00 AM,48,-122,1,0,1
5401,58thStGreenway22ndAve,08/14/2014 01:00:00 AM,48,-122,0,0,0
5402,58thStGreenway22ndAve,08/14/2014 02:00:00 AM,48,-122,1,0,1
5403,58thStGreenway22ndAve,08/14/2014 03:00:00 AM,48,-122,0,1,1
5404,58thStGreenway22ndAve,08/14/2014 04:00:00 AM,48,-122,0,0,0
5405,58thStGreenway22ndAve,08/14/2014 05:00:00 AM,48,-122,0,0,0
5406,58thStGreenway22ndAve,08/14/2014 06:00:00 AM,48,-122,3,3,6
5407,58thStGreenway22ndAve,08/14/2014 07:00:00 AM,48,-122,14,7,21
5408,58thStGreenway22ndAve,08/14/2014 08:00:00 AM,48,-122,21,12,33
5409,58thStGreenway22ndAve,08/14/2014 09:00:00 AM,48,-122,14,18,32
5410,58thStGreenway22ndAve,08/14/2014 10:00:00 AM,48,-122,23,8,31
5411,58thStGreenway22ndAve,08/14/2014 11:00:00 AM,48,-122,15,12,27
5412,58thStGreenway22ndAve,08/14/2014 12:00:00 PM,48,-122,35,10,45
5413,58thStGreenway22ndAve,08/14/2014 01:00:00 PM,48,-122,34,23,57
5414,58thStGreenway22ndAve,08/14/2014 02:00:00 PM,48,-122,31,13,44
5415,58thStGreenway22ndAve,08/14/2014 03:00:00 PM,48,-122,19,20,39
5416,58thStGreenway22ndAve,08/14/2014 04:00:00 PM,48,-122,16,5,21
5417,58thStGreenway22ndAve,08/14/2014 05:00:00 PM,48,-122,35,19,54
5418,58thStGreenway22ndAve,08/14/2014 06:00:00 PM,48,-122,43,21,64
5419,58thStGreenway22ndAve,08/14/2014 07:00:00 PM,48,-122,40,14,54
5420,58thStGreenway22ndAve,08/14/2014 08:00:00 PM,48,-122,17,7,24
5421,58thStGreenway22ndAve,08/14/2014 09:00:00 PM,48,-122,18,5,23
5422,58thStGreenway22ndAve,08/14/2014 10:00:00 PM,48,-122,6,3,9
5423,58thStGreenway22ndAve,08/14/2014 11:00:00 PM,48,-122,6,0,6
5424,58thStGreenway22ndAve,08/15/2014 12:00:00 AM,48,-122,4,0,4
5425,58thStGreenway22ndAve,08/15/2014 01:00:00 AM,48,-122,3,1,4
5426,58thStGreenway22ndAve,08/15/2014 02:00:00 AM,48,-122,0,0,0
5427,58thStGreenway22ndAve,08/15/2014 03:00:00 AM,48,-122,0,0,0
5428,58thStGreenway22ndAve,08/15/2014 04:00:00 AM,48,-122,0,0,0
5429,58thStGreenway22ndAve,08/15/2014 05:00:00 AM,48,-122,3,0,3
5430,58thStGreenway22ndAve,08/15/2014 06:00:00 AM,48,-122,3,2,5
5431,58thStGreenway22ndAve,08/15/2014 07:00:00 AM,48,-122,17,3,20
5432,58thStGreenway22ndAve,08/15/2014 08:00:00 AM,48,-122,14,5,19
5433,58thStGreenway22ndAve,08/15/2014 09:00:00 AM,48,-122,25,6,31
5434,58thStGreenway22ndAve,08/15/2014 10:00:00 AM,48,-122,22,5,27
5435,58thStGreenway22ndAve,08/15/2014 11:00:00 AM,48,-122,31,6,37
5436,58thStGreenway22ndAve,08/15/2014 12:00:00 PM,48,-122,15,14,29
5437,58thStGreenway22ndAve,08/15/2014 01:00:00 PM,48,-122,21,13,34
5438,58thStGreenway22ndAve,08/15/2014 02:00:00 PM,48,-122,39,16,55
5439,58thStGreenway22ndAve,08/15/2014 03:00:00 PM,48,-122,27,5,32
5440,58thStGreenway22ndAve,08/15/2014 04:00:00 PM,48,-122,28,10,38
5441,58thStGreenway22ndAve,08/15/2014 05:00:00 PM,48,-122,37,17,54
5442,58thStGreenway22ndAve,08/15/2014 06:00:00 PM,48,-122,28,14,42
5443,58thStGreenway22ndAve,08/15/2014 07:00:00 PM,48,-122,31,21,52
5444,58thStGreenway22ndAve,08/15/2014 08:00:00 PM,48,-122,14,5,19
5445,58thStGreenway22ndAve,08/15/2014 09:00:00 PM,48,-122,14,6,20
5446,58thStGreenway22ndAve,08/15/2014 10:00:00 PM,48,-122,4,9,13
5447,58thStGreenway22ndAve,08/15/2014 11:00:00 PM,48,-122,4,1,5
5448,58thStGreenway22ndAve,08/16/2014 12:00:00 AM,48,-122,6,0,6
5449,58thStGreenway22ndAve,08/16/2014 01:00:00 AM,48,-122,2,0,2
5450,58thStGreenway22ndAve,08/16/2014 02:00:00 AM,48,-122,1,0,1
5451,58thStGreenway22ndAve,08/16/2014 03:00:00 AM,48,-122,2,2,4
5452,58thStGreenway22ndAve,08/16/2014 04:00:00 AM,48,-122,0,0,0
5453,58thStGreenway22ndAve,08/16/2014 05:00:00 AM,48,-122,7,1,8
5454,58thStGreenway22ndAve,08/16/2014 06:00:00 AM,48,-122,6,2,8
5455,58thStGreenway22ndAve,08/16/2014 07:00:00 AM,48,-122,2,1,3
5456,58thStGreenway22ndAve,08/16/2014 08:00:00 AM,48,-122,6,3,9
5457,58thStGreenway22ndAve,08/16/2014 09:00:00 AM,48,-122,21,11,32
5458,58thStGreenway22ndAve,08/16/2014 10:00:00 AM,48,-122,23,10,33
5459,58thStGreenway22ndAve,08/16/2014 11:00:00 AM,48,-122,19,20,39
5460,58thStGreenway22ndAve,08/16/2014 12:00:00 PM,48,-122,37,12,49
5461,58thStGreenway22ndAve,08/16/2014 01:00:00 PM,48,-122,22,22,44
5462,58thStGreenway22ndAve,08/16/2014 02:00:00 PM,48,-122,37,25,62
5463,58thStGreenway22ndAve,08/16/2014 03:00:00 PM,48,-122,47,13,60
5464,58thStGreenway22ndAve,08/16/2014 04:00:00 PM,48,-122,40,12,52
5465,58thStGreenway22ndAve,08/16/2014 05:00:00 PM,48,-122,25,21,46
5466,58thStGreenway22ndAve,08/16/2014 06:00:00 PM,48,-122,32,13,45
5467,58thStGreenway22ndAve,08/16/2014 07:00:00 PM,48,-122,21,10,31
5468,58thStGreenway22ndAve,08/16/2014 08:00:00 PM,48,-122,23,9,32
5469,58thStGreenway22ndAve,08/16/2014 09:00:00 PM,48,-122,19,0,19
5470,58thStGreenway22ndAve,08/16/2014 10:00:00 PM,48,-122,10,1,11
5471,58thStGreenway22ndAve,08/16/2014 11:00:00 PM,48,-122,1,1,2
5472,58thStGreenway22ndAve,08/17/2014 12:00:00 AM,48,-122,5,0,5
5473,58thStGreenway22ndAve,08/17/2014 01:00:00 AM,48,-122,0,0,0
5474,58thStGreenway22ndAve,08/17/2014 02:00:00 AM,48,-122,4,0,4
5475,58thStGreenway22ndAve,08/17/2014 03:00:00 AM,48,-122,0,1,1
5476,58thStGreenway22ndAve,08/17/2014 04:00:00 AM,48,-122,1,0,1
5477,58thStGreenway22ndAve,08/17/2014 05:00:00 AM,48,-122,2,0,2
5478,58thStGreenway22ndAve,08/17/2014 06:00:00 AM,48,-122,0,1,1
5479,58thStGreenway22ndAve,08/17/2014 07:00:00 AM,48,-122,2,2,4
5480,58thStGreenway22ndAve,08/17/2014 08:00:00 AM,48,-122,8,5,13
5481,58thStGreenway22ndAve,08/17/2014 09:00:00 AM,48,-122,14,8,22
5482,58thStGreenway22ndAve,08/17/2014 10:00:00 AM,48,-122,29,21,50
5483,58thStGreenway22ndAve,08/17/2014 11:00:00 AM,48,-122,45,25,70
5484,58thStGreenway22ndAve,08/17/2014 12:00:00 PM,48,-122,35,18,53
5485,58thStGreenway22ndAve,08/17/2014 01:00:00 PM,48,-122,38,19,57
5486,58thStGreenway22ndAve,08/17/2014 02:00:00 PM,48,-122,38,26,64
5487,58thStGreenway22ndAve,08/17/2014 03:00:00 PM,48,-122,34,27,61
5488,58thStGreenway22ndAve,08/17/2014 04:00:00 PM,48,-122,50,22,72
5489,58thStGreenway22ndAve,08/17/2014 05:00:00 PM,48,-122,41,15,56
5490,58thStGreenway22ndAve,08/17/2014 06:00:00 PM,48,-122,26,12,38
5491,58thStGreenway22ndAve,08/17/2014 07:00:00 PM,48,-122,16,10,26
5492,58thStGreenway22ndAve,08/17/2014 08:00:00 PM,48,-122,16,2,18
5493,58thStGreenway22ndAve,08/17/2014 09:00:00 PM,48,-122,10,4,14
5494,58thStGreenway22ndAve,08/17/2014 10:00:00 PM,48,-122,8,1,9
5495,58thStGreenway22ndAve,08/17/2014 11:00:00 PM,48,-122,9,1,10
5496,58thStGreenway22ndAve,08/18/2014 12:00:00 AM,48,-122,2,0,2
5497,58thStGreenway22ndAve,08/18/2014 01:00:00 AM,48,-122,5,0,5
5498,58thStGreenway22ndAve,08/18/2014 02:00:00 AM,48,-122,2,0,2
5499,58thStGreenway22ndAve,08/18/2014 03:00:00 AM,48,-122,1,0,1
5500,58thStGreenway22ndAve,08/18/2014 04:00:00 AM,48,-122,0,0,0
5501,58thStGreenway22ndAve,08/18/2014 05:00:00 AM,48,-122,0,0,0
5502,58thStGreenway22ndAve,08/18/2014 06:00:00 AM,48,-122,2,4,6
5503,58thStGreenway22ndAve,08/18/2014 07:00:00 AM,48,-122,27,7,34
5504,58thStGreenway22ndAve,08/18/2014 08:00:00 AM,48,-122,10,11,21
5505,58thStGreenway22ndAve,08/18/2014 09:00:00 AM,48,-122,27,15,42
5506,58thStGreenway22ndAve,08/18/2014 10:00:00 AM,48,-122,27,20,47
5507,58thStGreenway22ndAve,08/18/2014 11:00:00 AM,48,-122,31,10,41
5508,58thStGreenway22ndAve,08/18/2014 12:00:00 PM,48,-122,38,17,55
5509,58thStGreenway22ndAve,08/18/2014 01:00:00 PM,48,-122,22,25,47
5510,58thStGreenway22ndAve,08/18/2014 02:00:00 PM,48,-122,28,17,45
5511,58thStGreenway22ndAve,08/18/2014 03:00:00 PM,48,-122,28,9,37
5512,58thStGreenway22ndAve,08/18/2014 04:00:00 PM,48,-122,37,15,52
5513,58thStGreenway22ndAve,08/18/2014 05:00:00 PM,48,-122,32,21,53
5514,58thStGreenway22ndAve,08/18/2014 06:00:00 PM,48,-122,37,29,66
5515,58thStGreenway22ndAve,08/18/2014 07:00:00 PM,48,-122,29,12,41
5516,58thStGreenway22ndAve,08/18/2014 08:00:00 PM,48,-122,16,6,22
5517,58thStGreenway22ndAve,08/18/2014 09:00:00 PM,48,-122,14,2,16
5518,58thStGreenway22ndAve,08/18/2014 10:00:00 PM,48,-122,19,1,20
5519,58thStGreenway22ndAve,08/18/2014 11:00:00 PM,48,-122,2,2,4
5520,58thStGreenway22ndAve,08/19/2014 12:00:00 AM,48,-122,2,0,2
5521,58thStGreenway22ndAve,08/19/2014 01:00:00 AM,48,-122,0,2,2
5522,58thStGreenway22ndAve,08/19/2014 02:00:00 AM,48,-122,0,0,0
5523,58thStGreenway22ndAve,08/19/2014 03:00:00 AM,48,-122,0,0,0
5524,58thStGreenway22ndAve,08/19/2014 04:00:00 AM,48,-122,0,0,0
5525,58thStGreenway22ndAve,08/19/2014 05:00:00 AM,48,-122,7,0,7
5526,58thStGreenway22ndAve,08/19/2014 06:00:00 AM,48,-122,18,11,29
5527,58thStGreenway22ndAve,08/19/2014 07:00:00 AM,48,-122,19,5,24
5528,58thStGreenway22ndAve,08/19/2014 08:00:00 AM,48,-122,28,11,39
5529,58thStGreenway22ndAve,08/19/2014 09:00:00 AM,48,-122,18,10,28
5530,58thStGreenway22ndAve,08/19/2014 10:00:00 AM,48,-122,22,6,28
5531,58thStGreenway22ndAve,08/19/2014 11:00:00 AM,48,-122,10,17,27
5532,58thStGreenway22ndAve,08/19/2014 12:00:00 PM,48,-122,33,17,50
5533,58thStGreenway22ndAve,08/19/2014 01:00:00 PM,48,-122,23,19,42
5534,58thStGreenway22ndAve,08/19/2014 02:00:00 PM,48,-122,28,8,36
5535,58thStGreenway22ndAve,08/19/2014 03:00:00 PM,48,-122,32,14,46
5536,58thStGreenway22ndAve,08/19/2014 04:00:00 PM,48,-122,41,22,63
5537,58thStGreenway22ndAve,08/19/2014 05:00:00 PM,48,-122,27,13,40
5538,58thStGreenway22ndAve,08/19/2014 06:00:00 PM,48,-122,42,9,51
5539,58thStGreenway22ndAve,08/19/2014 07:00:00 PM,48,-122,39,19,58
5540,58thStGreenway22ndAve,08/19/2014 08:00:00 PM,48,-122,16,13,29
5541,58thStGreenway22ndAve,08/19/2014 09:00:00 PM,48,-122,11,3,14
5542,58thStGreenway22ndAve,08/19/2014 10:00:00 PM,48,-122,11,0,11
5543,58thStGreenway22ndAve,08/19/2014 11:00:00 PM,48,-122,0,1,1
5544,58thStGreenway22ndAve,08/20/2014 12:00:00 AM,48,-122,1,0,1
5545,58thStGreenway22ndAve,08/20/2014 01:00:00 AM,48,-122,1,2,3
5546,58thStGreenway22ndAve,08/20/2014 02:00:00 AM,48,-122,0,1,1
5547,58thStGreenway22ndAve,08/20/2014 03:00:00 AM,48,-122,0,0,0
5548,58thStGreenway22ndAve,08/20/2014 04:00:00 AM,48,-122,0,0,0
5549,58thStGreenway22ndAve,08/20/2014 05:00:00 AM,48,-122,5,3,8
5550,58thStGreenway22ndAve,08/20/2014 06:00:00 AM,48,-122,5,7,12
5551,58thStGreenway22ndAve,08/20/2014 07:00:00 AM,48,-122,14,4,18
5552,58thStGreenway22ndAve,08/20/2014 08:00:00 AM,48,-122,17,7,24
5553,58thStGreenway22ndAve,08/20/2014 09:00:00 AM,48,-122,23,3,26
5554,58thStGreenway22ndAve,08/20/2014 10:00:00 AM,48,-122,14,13,27
5555,58thStGreenway22ndAve,08/20/2014 11:00:00 AM,48,-122,15,13,28
5556,58thStGreenway22ndAve,08/20/2014 12:00:00 PM,48,-122,15,13,28
5557,58thStGreenway22ndAve,08/20/2014 01:00:00 PM,48,-122,32,13,45
5558,58thStGreenway22ndAve,08/20/2014 02:00:00 PM,48,-122,28,27,55
5559,58thStGreenway22ndAve,08/20/2014 03:00:00 PM,48,-122,29,15,44
5560,58thStGreenway22ndAve,08/20/2014 04:00:00 PM,48,-122,30,10,40
5561,58thStGreenway22ndAve,08/20/2014 05:00:00 PM,48,-122,40,16,56
5562,58thStGreenway22ndAve,08/20/2014 06:00:00 PM,48,-122,26,19,45
5563,58thStGreenway22ndAve,08/20/2014 07:00:00 PM,48,-122,15,12,27
5564,58thStGreenway22ndAve,08/20/2014 08:00:00 PM,48,-122,17,6,23
5565,58thStGreenway22ndAve,08/20/2014 09:00:00 PM,48,-122,31,7,38
5566,58thStGreenway22ndAve,08/20/2014 10:00:00 PM,48,-122,4,1,5
5567,58thStGreenway22ndAve,08/20/2014 11:00:00 PM,48,-122,8,3,11
5568,58thStGreenway22ndAve,08/21/2014 12:00:00 AM,48,-122,0,1,1
5569,58thStGreenway22ndAve,08/21/2014 01:00:00 AM,48,-122,1,0,1
5570,58thStGreenway22ndAve,08/21/2014 02:00:00 AM,48,-122,0,1,1
5571,58thStGreenway22ndAve,08/21/2014 03:00:00 AM,48,-122,2,0,2
5572,58thStGreenway22ndAve,08/21/2014 04:00:00 AM,48,-122,0,0,0
5573,58thStGreenway22ndAve,08/21/2014 05:00:00 AM,48,-122,0,2,2
5574,58thStGreenway22ndAve,08/21/2014 06:00:00 AM,48,-122,7,6,13
5575,58thStGreenway22ndAve,08/21/2014 07:00:00 AM,48,-122,26,12,38
5576,58thStGreenway22ndAve,08/21/2014 08:00:00 AM,48,-122,21,18,39
5577,58thStGreenway22ndAve,08/21/2014 09:00:00 AM,48,-122,21,23,44
5578,58thStGreenway22ndAve,08/21/2014 10:00:00 AM,48,-122,30,13,43
5579,58thStGreenway22ndAve,08/21/2014 11:00:00 AM,48,-122,28,7,35
5580,58thStGreenway22ndAve,08/21/2014 12:00:00 PM,48,-122,23,22,45
5581,58thStGreenway22ndAve,08/21/2014 01:00:00 PM,48,-122,27,13,40
5582,58thStGreenway22ndAve,08/21/2014 02:00:00 PM,48,-122,24,20,44
5583,58thStGreenway22ndAve,08/21/2014 03:00:00 PM,48,-122,20,8,28
5584,58thStGreenway22ndAve,08/21/2014 04:00:00 PM,48,-122,37,16,53
5585,58thStGreenway22ndAve,08/21/2014 05:00:00 PM,48,-122,32,20,52
5586,58thStGreenway22ndAve,08/21/2014 06:00:00 PM,48,-122,36,11,47
5587,58thStGreenway22ndAve,08/21/2014 07:00:00 PM,48,-122,36,10,46
5588,58thStGreenway22ndAve,08/21/2014 08:00:00 PM,48,-122,16,9,25
5589,58thStGreenway22ndAve,08/21/2014 09:00:00 PM,48,-122,12,8,20
5590,58thStGreenway22ndAve,08/21/2014 10:00:00 PM,48,-122,8,3,11
5591,58thStGreenway22ndAve,08/21/2014 11:00:00 PM,48,-122,6,1,7
5592,58thStGreenway22ndAve,08/22/2014 12:00:00 AM,48,-122,2,3,5
5593,58thStGreenway22ndAve,08/22/2014 01:00:00 AM,48,-122,2,0,2
5594,58thStGreenway22ndAve,08/22/2014 02:00:00 AM,48,-122,0,0,0
5595,58thStGreenway22ndAve,08/22/2014 03:00:00 AM,48,-122,2,0,2
5596,58thStGreenway22ndAve,08/22/2014 04:00:00 AM,48,-122,2,0,2
5597,58thStGreenway22ndAve,08/22/2014 05:00:00 AM,48,-122,0,0,0
5598,58thStGreenway22ndAve,08/22/2014 06:00:00 AM,48,-122,3,1,4
5599,58thStGreenway22ndAve,08/22/2014 07:00:00 AM,48,-122,20,6,26
5600,58thStGreenway22ndAve,08/22/2014 08:00:00 AM,48,-122,30,15,45
5601,58thStGreenway22ndAve,08/22/2014 09:00:00 AM,48,-122,27,6,33
5602,58thStGreenway22ndAve,08/22/2014 10:00:00 AM,48,-122,28,30,58
5603,58thStGreenway22ndAve,08/22/2014 11:00:00 AM,48,-122,26,11,37
5604,58thStGreenway22ndAve,08/22/2014 12:00:00 PM,48,-122,24,23,47
5605,58thStGreenway22ndAve,08/22/2014 01:00:00 PM,48,-122,28,25,53
5606,58thStGreenway22ndAve,08/22/2014 02:00:00 PM,48,-122,29,17,46
5607,58thStGreenway22ndAve,08/22/2014 03:00:00 PM,48,-122,39,21,60
5608,58thStGreenway22ndAve,08/22/2014 04:00:00 PM,48,-122,36,19,55
5609,58thStGreenway22ndAve,08/22/2014 05:00:00 PM,48,-122,53,23,76
5610,58thStGreenway22ndAve,08/22/2014 06:00:00 PM,48,-122,38,19,57
5611,58thStGreenway22ndAve,08/22/2014 07:00:00 PM,48,-122,18,14,32
5612,58thStGreenway22ndAve,08/22/2014 08:00:00 PM,48,-122,23,13,36
5613,58thStGreenway22ndAve,08/22/2014 09:00:00 PM,48,-122,9,3,12
5614,58thStGreenway22ndAve,08/22/2014 10:00:00 PM,48,-122,11,1,12
5615,58thStGreenway22ndAve,08/22/2014 11:00:00 PM,48,-122,8,0,8
5616,58thStGreenway22ndAve,08/23/2014 12:00:00 AM,48,-122,3,1,4
5617,58thStGreenway22ndAve,08/23/2014 01:00:00 AM,48,-122,0,0,0
5618,58thStGreenway22ndAve,08/23/2014 02:00:00 AM,48,-122,2,1,3
5619,58thStGreenway22ndAve,08/23/2014 03:00:00 AM,48,-122,2,0,2
5620,58thStGreenway22ndAve,08/23/2014 04:00:00 AM,48,-122,2,0,2
5621,58thStGreenway22ndAve,08/23/2014 05:00:00 AM,48,-122,3,0,3
5622,58thStGreenway22ndAve,08/23/2014 06:00:00 AM,48,-122,2,0,2
5623,58thStGreenway22ndAve,08/23/2014 07:00:00 AM,48,-122,5,4,9
5624,58thStGreenway22ndAve,08/23/2014 08:00:00 AM,48,-122,13,5,18
5625,58thStGreenway22ndAve,08/23/2014 09:00:00 AM,48,-122,19,15,34
5626,58thStGreenway22ndAve,08/23/2014 10:00:00 AM,48,-122,17,15,32
5627,58thStGreenway22ndAve,08/23/2014 11:00:00 AM,48,-122,46,19,65
5628,58thStGreenway22ndAve,08/23/2014 12:00:00 PM,48,-122,18,20,38
5629,58thStGreenway22ndAve,08/23/2014 01:00:00 PM,48,-122,31,11,42
5630,58thStGreenway22ndAve,08/23/2014 02:00:00 PM,48,-122,35,37,72
5631,58thStGreenway22ndAve,08/23/2014 03:00:00 PM,48,-122,25,20,45
5632,58thStGreenway22ndAve,08/23/2014 04:00:00 PM,48,-122,38,19,57
5633,58thStGreenway22ndAve,08/23/2014 05:00:00 PM,48,-122,24,4,28
5634,58thStGreenway22ndAve,08/23/2014 06:00:00 PM,48,-122,21,12,33
5635,58thStGreenway22ndAve,08/23/2014 07:00:00 PM,48,-122,20,4,24
5636,58thStGreenway22ndAve,08/23/2014 08:00:00 PM,48,-122,19,13,32
5637,58thStGreenway22ndAve,08/23/2014 09:00:00 PM,48,-122,4,3,7
5638,58thStGreenway22ndAve,08/23/2014 10:00:00 PM,48,-122,8,3,11
5639,58thStGreenway22ndAve,08/23/2014 11:00:00 PM,48,-122,4,4,8
5640,58thStGreenway22ndAve,08/24/2014 12:00:00 AM,48,-122,1,2,3
5641,58thStGreenway22ndAve,08/24/2014 01:00:00 AM,48,-122,3,0,3
5642,58thStGreenway22ndAve,08/24/2014 02:00:00 AM,48,-122,0,0,0
5643,58thStGreenway22ndAve,08/24/2014 03:00:00 AM,48,-122,2,0,2
5644,58thStGreenway22ndAve,08/24/2014 04:00:00 AM,48,-122,0,0,0
5645,58thStGreenway22ndAve,08/24/2014 05:00:00 AM,48,-122,1,0,1
5646,58thStGreenway22ndAve,08/24/2014 06:00:00 AM,48,-122,2,0,2
5647,58thStGreenway22ndAve,08/24/2014 07:00:00 AM,48,-122,0,0,0
5648,58thStGreenway22ndAve,08/24/2014 08:00:00 AM,48,-122,8,5,13
5649,58thStGreenway22ndAve,08/24/2014 09:00:00 AM,48,-122,13,8,21
5650,58thStGreenway22ndAve,08/24/2014 10:00:00 AM,48,-122,26,14,40
5651,58thStGreenway22ndAve,08/24/2014 11:00:00 AM,48,-122,35,23,58
5652,58thStGreenway22ndAve,08/24/2014 12:00:00 PM,48,-122,32,11,43
5653,58thStGreenway22ndAve,08/24/2014 01:00:00 PM,48,-122,39,40,79
5654,58thStGreenway22ndAve,08/24/2014 02:00:00 PM,48,-122,36,29,65
5655,58thStGreenway22ndAve,08/24/2014 03:00:00 PM,48,-122,24,8,32
5656,58thStGreenway22ndAve,08/24/2014 04:00:00 PM,48,-122,34,18,52
5657,58thStGreenway22ndAve,08/24/2014 05:00:00 PM,48,-122,22,17,39
5658,58thStGreenway22ndAve,08/24/2014 06:00:00 PM,48,-122,18,13,31
5659,58thStGreenway22ndAve,08/24/2014 07:00:00 PM,48,-122,14,5,19
5660,58thStGreenway22ndAve,08/24/2014 08:00:00 PM,48,-122,14,2,16
5661,58thStGreenway22ndAve,08/24/2014 09:00:00 PM,48,-122,10,7,17
5662,58thStGreenway22ndAve,08/24/2014 10:00:00 PM,48,-122,15,5,20
5663,58thStGreenway22ndAve,08/24/2014 11:00:00 PM,48,-122,3,0,3
5664,58thStGreenway22ndAve,08/25/2014 12:00:00 AM,48,-122,0,1,1
5665,58thStGreenway22ndAve,08/25/2014 01:00:00 AM,48,-122,0,0,0
5666,58thStGreenway22ndAve,08/25/2014 02:00:00 AM,48,-122,0,0,0
5667,58thStGreenway22ndAve,08/25/2014 03:00:00 AM,48,-122,0,0,0
5668,58thStGreenway22ndAve,08/25/2014 04:00:00 AM,48,-122,0,0,0
5669,58thStGreenway22ndAve,08/25/2014 05:00:00 AM,48,-122,3,1,4
5670,58thStGreenway22ndAve,08/25/2014 06:00:00 AM,48,-122,5,1,6
5671,58thStGreenway22ndAve,08/25/2014 07:00:00 AM,48,-122,19,4,23
5672,58thStGreenway22ndAve,08/25/2014 08:00:00 AM,48,-122,14,14,28
5673,58thStGreenway22ndAve,08/25/2014 09:00:00 AM,48,-122,24,12,36
5674,58thStGreenway22ndAve,08/25/2014 10:00:00 AM,48,-122,9,11,20
5675,58thStGreenway22ndAve,08/25/2014 11:00:00 AM,48,-122,17,6,23
5676,58thStGreenway22ndAve,08/25/2014 12:00:00 PM,48,-122,14,13,27
5677,58thStGreenway22ndAve,08/25/2014 01:00:00 PM,48,-122,26,4,30
5678,58thStGreenway22ndAve,08/25/2014 02:00:00 PM,48,-122,17,9,26
5679,58thStGreenway22ndAve,08/25/2014 03:00:00 PM,48,-122,0,5,5
5680,58thStGreenway22ndAve,08/25/2014 04:00:00 PM,48,-122,0,0,0
5681,58thStGreenway22ndAve,08/25/2014 05:00:00 PM,48,-122,0,0,0
5682,58thStGreenway22ndAve,08/25/2014 06:00:00 PM,48,-122,0,0,0
5683,58thStGreenway22ndAve,08/25/2014 07:00:00 PM,48,-122,0,0,0
5684,58thStGreenway22ndAve,08/25/2014 08:00:00 PM,48,-122,0,0,0
5685,58thStGreenway22ndAve,08/25/2014 09:00:00 PM,48,-122,0,0,0
5686,58thStGreenway22ndAve,08/25/2014 10:00:00 PM,48,-122,0,0,0
5687,58thStGreenway22ndAve,08/25/2014 11:00:00 PM,48,-122,0,0,0
5688,58thStGreenway22ndAve,08/26/2014 12:00:00 AM,48,-122,0,0,0
5689,58thStGreenway22ndAve,08/26/2014 01:00:00 AM,48,-122,0,0,0
5690,58thStGreenway22ndAve,08/26/2014 02:00:00 AM,48,-122,0,0,0
5691,58thStGreenway22ndAve,08/26/2014 03:00:00 AM,48,-122,0,0,0
5692,58thStGreenway22ndAve,08/26/2014 04:00:00 AM,48,-122,0,0,0
5693,58thStGreenway22ndAve,08/26/2014 05:00:00 AM,48,-122,0,0,0
5694,58thStGreenway22ndAve,08/26/2014 06:00:00 AM,48,-122,0,0,0
5695,58thStGreenway22ndAve,08/26/2014 07:00:00 AM,48,-122,0,0,0
5696,58thStGreenway22ndAve,08/26/2014 08:00:00 AM,48,-122,0,0,0
5697,58thStGreenway22ndAve,08/26/2014 09:00:00 AM,48,-122,0,0,0
5698,58thStGreenway22ndAve,08/26/2014 10:00:00 AM,48,-122,0,0,0
5699,58thStGreenway22ndAve,08/26/2014 11:00:00 AM,48,-122,0,0,0
5700,58thStGreenway22ndAve,08/26/2014 12:00:00 PM,48,-122,0,0,0
5701,58thStGreenway22ndAve,08/26/2014 01:00:00 PM,48,-122,0,0,0
5702,58thStGreenway22ndAve,08/26/2014 02:00:00 PM,48,-122,0,0,0
5703,58thStGreenway22ndAve,08/26/2014 03:00:00 PM,48,-122,0,0,0
5704,58thStGreenway22ndAve,08/26/2014 04:00:00 PM,48,-122,0,0,0
5705,58thStGreenway22ndAve,08/26/2014 05:00:00 PM,48,-122,0,0,0
5706,58thStGreenway22ndAve,08/26/2014 06:00:00 PM,48,-122,0,0,0
5707,58thStGreenway22ndAve,08/26/2014 07:00:00 PM,48,-122,0,0,0
5708,58thStGreenway22ndAve,08/26/2014 08:00:00 PM,48,-122,0,0,0
5709,58thStGreenway22ndAve,08/26/2014 09:00:00 PM,48,-122,0,0,0
5710,58thStGreenway22ndAve,08/26/2014 10:00:00 PM,48,-122,0,0,0
5711,58thStGreenway22ndAve,08/26/2014 11:00:00 PM,48,-122,0,0,0
5712,58thStGreenway22ndAve,08/27/2014 12:00:00 AM,48,-122,0,0,0
5713,58thStGreenway22ndAve,08/27/2014 01:00:00 AM,48,-122,0,0,0
5714,58thStGreenway22ndAve,08/27/2014 02:00:00 AM,48,-122,0,0,0
5715,58thStGreenway22ndAve,08/27/2014 03:00:00 AM,48,-122,0,0,0
5716,58thStGreenway22ndAve,08/27/2014 04:00:00 AM,48,-122,0,0,0
5717,58thStGreenway22ndAve,08/27/2014 05:00:00 AM,48,-122,0,0,0
5718,58thStGreenway22ndAve,08/27/2014 06:00:00 AM,48,-122,0,0,0
5719,58thStGreenway22ndAve,08/27/2014 07:00:00 AM,48,-122,0,0,0
5720,58thStGreenway22ndAve,08/27/2014 08:00:00 AM,48,-122,0,0,0
5721,58thStGreenway22ndAve,08/27/2014 09:00:00 AM,48,-122,0,0,0
5722,58thStGreenway22ndAve,08/27/2014 10:00:00 AM,48,-122,0,0,0
5723,58thStGreenway22ndAve,08/27/2014 11:00:00 AM,48,-122,0,0,0
5724,58thStGreenway22ndAve,08/27/2014 12:00:00 PM,48,-122,0,0,0
5725,58thStGreenway22ndAve,08/27/2014 01:00:00 PM,48,-122,0,0,0
5726,58thStGreenway22ndAve,08/27/2014 02:00:00 PM,48,-122,0,0,0
5727,58thStGreenway22ndAve,08/27/2014 03:00:00 PM,48,-122,0,0,0
5728,58thStGreenway22ndAve,08/27/2014 04:00:00 PM,48,-122,0,0,0
5729,58thStGreenway22ndAve,08/27/2014 05:00:00 PM,48,-122,0,0,0
5730,58thStGreenway22ndAve,08/27/2014 06:00:00 PM,48,-122,0,0,0
5731,58thStGreenway22ndAve,08/27/2014 07:00:00 PM,48,-122,0,0,0
5732,58thStGreenway22ndAve,08/27/2014 08:00:00 PM,48,-122,0,0,0
5733,58thStGreenway22ndAve,08/27/2014 09:00:00 PM,48,-122,0,0,0
5734,58thStGreenway22ndAve,08/27/2014 10:00:00 PM,48,-122,0,0,0
5735,58thStGreenway22ndAve,08/27/2014 11:00:00 PM,48,-122,0,0,0
5736,58thStGreenway22ndAve,08/28/2014 12:00:00 AM,48,-122,0,0,0
5737,58thStGreenway22ndAve,08/28/2014 01:00:00 AM,48,-122,0,0,0
5738,58thStGreenway22ndAve,08/28/2014 02:00:00 AM,48,-122,0,0,0
5739,58thStGreenway22ndAve,08/28/2014 03:00:00 AM,48,-122,0,0,0
5740,58thStGreenway22ndAve,08/28/2014 04:00:00 AM,48,-122,0,0,0
5741,58thStGreenway22ndAve,08/28/2014 05:00:00 AM,48,-122,0,0,0
5742,58thStGreenway22ndAve,08/28/2014 06:00:00 AM,48,-122,0,0,0
5743,58thStGreenway22ndAve,08/28/2014 07:00:00 AM,48,-122,0,0,0
5744,58thStGreenway22ndAve,08/28/2014 08:00:00 AM,48,-122,0,0,0
5745,58thStGreenway22ndAve,08/28/2014 09:00:00 AM,48,-122,0,0,0
5746,58thStGreenway22ndAve,08/28/2014 10:00:00 AM,48,-122,0,0,0
5747,58thStGreenway22ndAve,08/28/2014 11:00:00 AM,48,-122,0,0,0
5748,58thStGreenway22ndAve,08/28/2014 12:00:00 PM,48,-122,0,0,0
5749,58thStGreenway22ndAve,08/28/2014 01:00:00 PM,48,-122,0,0,0
5750,58thStGreenway22ndAve,08/28/2014 02:00:00 PM,48,-122,3,4,7
5751,58thStGreenway22ndAve,08/28/2014 03:00:00 PM,48,-122,14,7,21
5752,58thStGreenway22ndAve,08/28/2014 04:00:00 PM,48,-122,34,17,51
5753,58thStGreenway22ndAve,08/28/2014 05:00:00 PM,48,-122,41,10,51
5754,58thStGreenway22ndAve,08/28/2014 06:00:00 PM,48,-122,30,23,53
5755,58thStGreenway22ndAve,08/28/2014 07:00:00 PM,48,-122,39,9,48
5756,58thStGreenway22ndAve,08/28/2014 08:00:00 PM,48,-122,30,9,39
5757,58thStGreenway22ndAve,08/28/2014 09:00:00 PM,48,-122,23,5,28
5758,58thStGreenway22ndAve,08/28/2014 10:00:00 PM,48,-122,10,3,13
5759,58thStGreenway22ndAve,08/28/2014 11:00:00 PM,48,-122,8,0,8
5760,58thStGreenway22ndAve,08/29/2014 12:00:00 AM,48,-122,2,0,2
5761,58thStGreenway22ndAve,08/29/2014 01:00:00 AM,48,-122,2,0,2
5762,58thStGreenway22ndAve,08/29/2014 02:00:00 AM,48,-122,1,0,1
5763,58thStGreenway22ndAve,08/29/2014 03:00:00 AM,48,-122,0,1,1
5764,58thStGreenway22ndAve,08/29/2014 04:00:00 AM,48,-122,0,0,0
5765,58thStGreenway22ndAve,08/29/2014 05:00:00 AM,48,-122,4,1,5
5766,58thStGreenway22ndAve,08/29/2014 06:00:00 AM,48,-122,7,1,8
5767,58thStGreenway22ndAve,08/29/2014 07:00:00 AM,48,-122,9,3,12
5768,58thStGreenway22ndAve,08/29/2014 08:00:00 AM,48,-122,23,8,31
5769,58thStGreenway22ndAve,08/29/2014 09:00:00 AM,48,-122,26,10,36
5770,58thStGreenway22ndAve,08/29/2014 10:00:00 AM,48,-122,14,6,20
5771,58thStGreenway22ndAve,08/29/2014 11:00:00 AM,48,-122,20,2,22
5772,58thStGreenway22ndAve,08/29/2014 12:00:00 PM,48,-122,25,6,31
5773,58thStGreenway22ndAve,08/29/2014 01:00:00 PM,48,-122,25,9,34
5774,58thStGreenway22ndAve,08/29/2014 02:00:00 PM,48,-122,25,15,40
5775,58thStGreenway22ndAve,08/29/2014 03:00:00 PM,48,-122,39,8,47
5776,58thStGreenway22ndAve,08/29/2014 04:00:00 PM,48,-122,42,21,63
5777,58thStGreenway22ndAve,08/29/2014 05:00:00 PM,48,-122,21,22,43
5778,58thStGreenway22ndAve,08/29/2014 06:00:00 PM,48,-122,31,10,41
5779,58thStGreenway22ndAve,08/29/2014 07:00:00 PM,48,-122,23,11,34
5780,58thStGreenway22ndAve,08/29/2014 08:00:00 PM,48,-122,18,6,24
5781,58thStGreenway22ndAve,08/29/2014 09:00:00 PM,48,-122,6,2,8
5782,58thStGreenway22ndAve,08/29/2014 10:00:00 PM,48,-122,16,1,17
5783,58thStGreenway22ndAve,08/29/2014 11:00:00 PM,48,-122,6,1,7
5784,58thStGreenway22ndAve,08/30/2014 12:00:00 AM,48,-122,0,2,2
5785,58thStGreenway22ndAve,08/30/2014 01:00:00 AM,48,-122,9,1,10
5786,58thStGreenway22ndAve,08/30/2014 02:00:00 AM,48,-122,4,0,4
5787,58thStGreenway22ndAve,08/30/2014 03:00:00 AM,48,-122,0,0,0
5788,58thStGreenway22ndAve,08/30/2014 04:00:00 AM,48,-122,0,1,1
5789,58thStGreenway22ndAve,08/30/2014 05:00:00 AM,48,-122,4,0,4
5790,58thStGreenway22ndAve,08/30/2014 06:00:00 AM,48,-122,3,0,3
5791,58thStGreenway22ndAve,08/30/2014 07:00:00 AM,48,-122,7,0,7
5792,58thStGreenway22ndAve,08/30/2014 08:00:00 AM,48,-122,11,4,15
5793,58thStGreenway22ndAve,08/30/2014 09:00:00 AM,48,-122,27,9,36
5794,58thStGreenway22ndAve,08/30/2014 10:00:00 AM,48,-122,20,9,29
5795,58thStGreenway22ndAve,08/30/2014 11:00:00 AM,48,-122,23,13,36
5796,58thStGreenway22ndAve,08/30/2014 12:00:00 PM,48,-122,28,14,42
5797,58thStGreenway22ndAve,08/30/2014 01:00:00 PM,48,-122,19,10,29
5798,58thStGreenway22ndAve,08/30/2014 02:00:00 PM,48,-122,11,16,27
5799,58thStGreenway22ndAve,08/30/2014 03:00:00 PM,48,-122,29,11,40
5800,58thStGreenway22ndAve,08/30/2014 04:00:00 PM,48,-122,41,9,50
5801,58thStGreenway22ndAve,08/30/2014 05:00:00 PM,48,-122,25,7,32
5802,58thStGreenway22ndAve,08/30/2014 06:00:00 PM,48,-122,8,7,15
5803,58thStGreenway22ndAve,08/30/2014 07:00:00 PM,48,-122,17,5,22
5804,58thStGreenway22ndAve,08/30/2014 08:00:00 PM,48,-122,19,5,24
5805,58thStGreenway22ndAve,08/30/2014 09:00:00 PM,48,-122,8,6,14
5806,58thStGreenway22ndAve,08/30/2014 10:00:00 PM,48,-122,5,2,7
5807,58thStGreenway22ndAve,08/30/2014 11:00:00 PM,48,-122,8,3,11
5808,58thStGreenway22ndAve,08/31/2014 12:00:00 AM,48,-122,0,0,0
5809,58thStGreenway22ndAve,08/31/2014 01:00:00 AM,48,-122,2,0,2
5810,58thStGreenway22ndAve,08/31/2014 02:00:00 AM,48,-122,2,0,2
5811,58thStGreenway22ndAve,08/31/2014 03:00:00 AM,48,-122,2,2,4
5812,58thStGreenway22ndAve,08/31/2014 04:00:00 AM,48,-122,0,0,0
5813,58thStGreenway22ndAve,08/31/2014 05:00:00 AM,48,-122,2,1,3
5814,58thStGreenway22ndAve,08/31/2014 06:00:00 AM,48,-122,6,0,6
5815,58thStGreenway22ndAve,08/31/2014 07:00:00 AM,48,-122,0,0,0
5816,58thStGreenway22ndAve,08/31/2014 08:00:00 AM,48,-122,5,4,9
5817,58thStGreenway22ndAve,08/31/2014 09:00:00 AM,48,-122,11,10,21
5818,58thStGreenway22ndAve,08/31/2014 10:00:00 AM,48,-122,32,9,41
5819,58thStGreenway22ndAve,08/31/2014 11:00:00 AM,48,-122,28,12,40
5820,58thStGreenway22ndAve,08/31/2014 12:00:00 PM,48,-122,51,14,65
5821,58thStGreenway22ndAve,08/31/2014 01:00:00 PM,48,-122,58,17,75
5822,58thStGreenway22ndAve,08/31/2014 02:00:00 PM,48,-122,31,18,49
5823,58thStGreenway22ndAve,08/31/2014 03:00:00 PM,48,-122,35,10,45
5824,58thStGreenway22ndAve,08/31/2014 04:00:00 PM,48,-122,33,8,41
5825,58thStGreenway22ndAve,08/31/2014 05:00:00 PM,48,-122,22,17,39
5826,58thStGreenway22ndAve,08/31/2014 06:00:00 PM,48,-122,20,6,26
5827,58thStGreenway22ndAve,08/31/2014 07:00:00 PM,48,-122,17,12,29
5828,58thStGreenway22ndAve,08/31/2014 08:00:00 PM,48,-122,12,5,17
5829,58thStGreenway22ndAve,08/31/2014 09:00:00 PM,48,-122,10,2,12
5830,58thStGreenway22ndAve,08/31/2014 10:00:00 PM,48,-122,5,3,8
5831,58thStGreenway22ndAve,08/31/2014 11:00:00 PM,48,-122,4,0,4
5832,58thStGreenway22ndAve,09/01/2014 12:00:00 AM,48,-122,3,0,3
5833,58thStGreenway22ndAve,09/01/2014 01:00:00 AM,48,-122,1,2,3
5834,58thStGreenway22ndAve,09/01/2014 02:00:00 AM,48,-122,6,0,6
5835,58thStGreenway22ndAve,09/01/2014 03:00:00 AM,48,-122,1,0,1
5836,58thStGreenway22ndAve,09/01/2014 04:00:00 AM,48,-122,0,0,0
5837,58thStGreenway22ndAve,09/01/2014 05:00:00 AM,48,-122,6,2,8
5838,58thStGreenway22ndAve,09/01/2014 06:00:00 AM,48,-122,3,0,3
5839,58thStGreenway22ndAve,09/01/2014 07:00:00 AM,48,-122,5,4,9
5840,58thStGreenway22ndAve,09/01/2014 08:00:00 AM,48,-122,2,3,5
5841,58thStGreenway22ndAve,09/01/2014 09:00:00 AM,48,-122,6,8,14
5842,58thStGreenway22ndAve,09/01/2014 10:00:00 AM,48,-122,21,21,42
5843,58thStGreenway22ndAve,09/01/2014 11:00:00 AM,48,-122,25,14,39
5844,58thStGreenway22ndAve,09/01/2014 12:00:00 PM,48,-122,32,8,40
5845,58thStGreenway22ndAve,09/01/2014 01:00:00 PM,48,-122,31,16,47
5846,58thStGreenway22ndAve,09/01/2014 02:00:00 PM,48,-122,33,16,49
5847,58thStGreenway22ndAve,09/01/2014 03:00:00 PM,48,-122,26,25,51
5848,58thStGreenway22ndAve,09/01/2014 04:00:00 PM,48,-122,36,32,68
5849,58thStGreenway22ndAve,09/01/2014 05:00:00 PM,48,-122,26,11,37
5850,58thStGreenway22ndAve,09/01/2014 06:00:00 PM,48,-122,24,11,35
5851,58thStGreenway22ndAve,09/01/2014 07:00:00 PM,48,-122,11,15,26
5852,58thStGreenway22ndAve,09/01/2014 08:00:00 PM,48,-122,8,7,15
5853,58thStGreenway22ndAve,09/01/2014 09:00:00 PM,48,-122,8,4,12
5854,58thStGreenway22ndAve,09/01/2014 10:00:00 PM,48,-122,6,2,8
5855,58thStGreenway22ndAve,09/01/2014 11:00:00 PM,48,-122,1,0,1
5856,58thStGreenway22ndAve,09/02/2014 12:00:00 AM,48,-122,5,0,5
5857,58thStGreenway22ndAve,09/02/2014 01:00:00 AM,48,-122,0,0,0
5858,58thStGreenway22ndAve,09/02/2014 02:00:00 AM,48,-122,0,0,0
5859,58thStGreenway22ndAve,09/02/2014 03:00:00 AM,48,-122,0,1,1
5860,58thStGreenway22ndAve,09/02/2014 04:00:00 AM,48,-122,3,0,3
5861,58thStGreenway22ndAve,09/02/2014 05:00:00 AM,48,-122,1,0,1
5862,58thStGreenway22ndAve,09/02/2014 06:00:00 AM,48,-122,7,3,10
5863,58thStGreenway22ndAve,09/02/2014 07:00:00 AM,48,-122,24,3,27
5864,58thStGreenway22ndAve,09/02/2014 08:00:00 AM,48,-122,22,18,40
5865,58thStGreenway22ndAve,09/02/2014 09:00:00 AM,48,-122,8,8,16
5866,58thStGreenway22ndAve,09/02/2014 10:00:00 AM,48,-122,18,10,28
5867,58thStGreenway22ndAve,09/02/2014 11:00:00 AM,48,-122,19,12,31
5868,58thStGreenway22ndAve,09/02/2014 12:00:00 PM,48,-122,32,18,50
5869,58thStGreenway22ndAve,09/02/2014 01:00:00 PM,48,-122,16,10,26
5870,58thStGreenway22ndAve,09/02/2014 02:00:00 PM,48,-122,30,11,41
5871,58thStGreenway22ndAve,09/02/2014 03:00:00 PM,48,-122,21,13,34
5872,58thStGreenway22ndAve,09/02/2014 04:00:00 PM,48,-122,26,11,37
5873,58thStGreenway22ndAve,09/02/2014 05:00:00 PM,48,-122,29,24,53
5874,58thStGreenway22ndAve,09/02/2014 06:00:00 PM,48,-122,36,17,53
5875,58thStGreenway22ndAve,09/02/2014 07:00:00 PM,48,-122,20,16,36
5876,58thStGreenway22ndAve,09/02/2014 08:00:00 PM,48,-122,17,11,28
5877,58thStGreenway22ndAve,09/02/2014 09:00:00 PM,48,-122,14,14,28
5878,58thStGreenway22ndAve,09/02/2014 10:00:00 PM,48,-122,12,1,13
5879,58thStGreenway22ndAve,09/02/2014 11:00:00 PM,48,-122,0,0,0
5880,58thStGreenway22ndAve,09/03/2014 12:00:00 AM,48,-122,0,0,0
5881,58thStGreenway22ndAve,09/03/2014 01:00:00 AM,48,-122,0,0,0
5882,58thStGreenway22ndAve,09/03/2014 02:00:00 AM,48,-122,0,0,0
5883,58thStGreenway22ndAve,09/03/2014 03:00:00 AM,48,-122,0,0,0
5884,58thStGreenway22ndAve,09/03/2014 04:00:00 AM,48,-122,0,1,1
5885,58thStGreenway22ndAve,09/03/2014 05:00:00 AM,48,-122,2,0,2
5886,58thStGreenway22ndAve,09/03/2014 06:00:00 AM,48,-122,9,2,11
5887,58thStGreenway22ndAve,09/03/2014 07:00:00 AM,48,-122,25,4,29
5888,58thStGreenway22ndAve,09/03/2014 08:00:00 AM,48,-122,16,17,33
5889,58thStGreenway22ndAve,09/03/2014 09:00:00 AM,48,-122,18,14,32
5890,58thStGreenway22ndAve,09/03/2014 10:00:00 AM,48,-122,9,7,16
5891,58thStGreenway22ndAve,09/03/2014 11:00:00 AM,48,-122,21,23,44
5892,58thStGreenway22ndAve,09/03/2014 12:00:00 PM,48,-122,16,20,36
5893,58thStGreenway22ndAve,09/03/2014 01:00:00 PM,48,-122,18,6,24
5894,58thStGreenway22ndAve,09/03/2014 02:00:00 PM,48,-122,25,16,41
5895,58thStGreenway22ndAve,09/03/2014 03:00:00 PM,48,-122,10,14,24
5896,58thStGreenway22ndAve,09/03/2014 04:00:00 PM,48,-122,24,15,39
5897,58thStGreenway22ndAve,09/03/2014 05:00:00 PM,48,-122,47,23,70
5898,58thStGreenway22ndAve,09/03/2014 06:00:00 PM,48,-122,25,22,47
5899,58thStGreenway22ndAve,09/03/2014 07:00:00 PM,48,-122,25,7,32
5900,58thStGreenway22ndAve,09/03/2014 08:00:00 PM,48,-122,41,7,48
5901,58thStGreenway22ndAve,09/03/2014 09:00:00 PM,48,-122,10,3,13
5902,58thStGreenway22ndAve,09/03/2014 10:00:00 PM,48,-122,17,0,17
5903,58thStGreenway22ndAve,09/03/2014 11:00:00 PM,48,-122,3,1,4
5904,58thStGreenway22ndAve,09/04/2014 12:00:00 AM,48,-122,0,0,0
5905,58thStGreenway22ndAve,09/04/2014 01:00:00 AM,48,-122,2,1,3
5906,58thStGreenway22ndAve,09/04/2014 02:00:00 AM,48,-122,0,0,0
5907,58thStGreenway22ndAve,09/04/2014 03:00:00 AM,48,-122,0,0,0
5908,58thStGreenway22ndAve,09/04/2014 04:00:00 AM,48,-122,2,0,2
5909,58thStGreenway22ndAve,09/04/2014 05:00:00 AM,48,-122,5,1,6
5910,58thStGreenway22ndAve,09/04/2014 06:00:00 AM,48,-122,3,2,5
5911,58thStGreenway22ndAve,09/04/2014 07:00:00 AM,48,-122,26,7,33
5912,58thStGreenway22ndAve,09/04/2014 08:00:00 AM,48,-122,31,9,40
5913,58thStGreenway22ndAve,09/04/2014 09:00:00 AM,48,-122,21,11,32
5914,58thStGreenway22ndAve,09/04/2014 10:00:00 AM,48,-122,19,7,26
5915,58thStGreenway22ndAve,09/04/2014 11:00:00 AM,48,-122,19,9,28
5916,58thStGreenway22ndAve,09/04/2014 12:00:00 PM,48,-122,31,20,51
5917,58thStGreenway22ndAve,09/04/2014 01:00:00 PM,48,-122,31,12,43
5918,58thStGreenway22ndAve,09/04/2014 02:00:00 PM,48,-122,32,7,39
5919,58thStGreenway22ndAve,09/04/2014 03:00:00 PM,48,-122,18,18,36
5920,58thStGreenway22ndAve,09/04/2014 04:00:00 PM,48,-122,24,15,39
5921,58thStGreenway22ndAve,09/04/2014 05:00:00 PM,48,-122,41,30,71
5922,58thStGreenway22ndAve,09/04/2014 06:00:00 PM,48,-122,18,16,34
5923,58thStGreenway22ndAve,09/04/2014 07:00:00 PM,48,-122,26,6,32
5924,58thStGreenway22ndAve,09/04/2014 08:00:00 PM,48,-122,12,2,14
5925,58thStGreenway22ndAve,09/04/2014 09:00:00 PM,48,-122,24,2,26
5926,58thStGreenway22ndAve,09/04/2014 10:00:00 PM,48,-122,12,1,13
5927,58thStGreenway22ndAve,09/04/2014 11:00:00 PM,48,-122,10,1,11
5928,58thStGreenway22ndAve,09/05/2014 12:00:00 AM,48,-122,1,0,1
5929,58thStGreenway22ndAve,09/05/2014 01:00:00 AM,48,-122,0,1,1
5930,58thStGreenway22ndAve,09/05/2014 02:00:00 AM,48,-122,0,0,0
5931,58thStGreenway22ndAve,09/05/2014 03:00:00 AM,48,-122,2,0,2
5932,58thStGreenway22ndAve,09/05/2014 04:00:00 AM,48,-122,0,0,0
5933,58thStGreenway22ndAve,09/05/2014 05:00:00 AM,48,-122,0,1,1
5934,58thStGreenway22ndAve,09/05/2014 06:00:00 AM,48,-122,2,1,3
5935,58thStGreenway22ndAve,09/05/2014 07:00:00 AM,48,-122,15,6,21
5936,58thStGreenway22ndAve,09/05/2014 08:00:00 AM,48,-122,26,12,38
5937,58thStGreenway22ndAve,09/05/2014 09:00:00 AM,48,-122,30,9,39
5938,58thStGreenway22ndAve,09/05/2014 10:00:00 AM,48,-122,15,18,33
5939,58thStGreenway22ndAve,09/05/2014 11:00:00 AM,48,-122,33,8,41
5940,58thStGreenway22ndAve,09/05/2014 12:00:00 PM,48,-122,27,17,44
5941,58thStGreenway22ndAve,09/05/2014 01:00:00 PM,48,-122,28,16,44
5942,58thStGreenway22ndAve,09/05/2014 02:00:00 PM,48,-122,27,11,38
5943,58thStGreenway22ndAve,09/05/2014 03:00:00 PM,48,-122,27,13,40
5944,58thStGreenway22ndAve,09/05/2014 04:00:00 PM,48,-122,16,12,28
5945,58thStGreenway22ndAve,09/05/2014 05:00:00 PM,48,-122,31,15,46
5946,58thStGreenway22ndAve,09/05/2014 06:00:00 PM,48,-122,31,18,49
5947,58thStGreenway22ndAve,09/05/2014 07:00:00 PM,48,-122,24,21,45
5948,58thStGreenway22ndAve,09/05/2014 08:00:00 PM,48,-122,24,7,31
5949,58thStGreenway22ndAve,09/05/2014 09:00:00 PM,48,-122,9,1,10
5950,58thStGreenway22ndAve,09/05/2014 10:00:00 PM,48,-122,4,1,5
5951,58thStGreenway22ndAve,09/05/2014 11:00:00 PM,48,-122,3,0,3
5952,58thStGreenway22ndAve,09/06/2014 12:00:00 AM,48,-122,4,0,4
5953,58thStGreenway22ndAve,09/06/2014 01:00:00 AM,48,-122,1,0,1
5954,58thStGreenway22ndAve,09/06/2014 02:00:00 AM,48,-122,0,1,1
5955,58thStGreenway22ndAve,09/06/2014 03:00:00 AM,48,-122,0,1,1
5956,58thStGreenway22ndAve,09/06/2014 04:00:00 AM,48,-122,0,0,0
5957,58thStGreenway22ndAve,09/06/2014 05:00:00 AM,48,-122,4,2,6
5958,58thStGreenway22ndAve,09/06/2014 06:00:00 AM,48,-122,1,0,1
5959,58thStGreenway22ndAve,09/06/2014 07:00:00 AM,48,-122,4,3,7
5960,58thStGreenway22ndAve,09/06/2014 08:00:00 AM,48,-122,12,4,16
5961,58thStGreenway22ndAve,09/06/2014 09:00:00 AM,48,-122,21,14,35
5962,58thStGreenway22ndAve,09/06/2014 10:00:00 AM,48,-122,29,12,41
5963,58thStGreenway22ndAve,09/06/2014 11:00:00 AM,48,-122,26,31,57
5964,58thStGreenway22ndAve,09/06/2014 12:00:00 PM,48,-122,54,19,73
5965,58thStGreenway22ndAve,09/06/2014 01:00:00 PM,48,-122,49,19,68
5966,58thStGreenway22ndAve,09/06/2014 02:00:00 PM,48,-122,32,16,48
5967,58thStGreenway22ndAve,09/06/2014 03:00:00 PM,48,-122,19,11,30
5968,58thStGreenway22ndAve,09/06/2014 04:00:00 PM,48,-122,34,15,49
5969,58thStGreenway22ndAve,09/06/2014 05:00:00 PM,48,-122,26,10,36
5970,58thStGreenway22ndAve,09/06/2014 06:00:00 PM,48,-122,23,12,35
5971,58thStGreenway22ndAve,09/06/2014 07:00:00 PM,48,-122,28,14,42
5972,58thStGreenway22ndAve,09/06/2014 08:00:00 PM,48,-122,12,3,15
5973,58thStGreenway22ndAve,09/06/2014 09:00:00 PM,48,-122,7,4,11
5974,58thStGreenway22ndAve,09/06/2014 10:00:00 PM,48,-122,12,5,17
5975,58thStGreenway22ndAve,09/06/2014 11:00:00 PM,48,-122,6,1,7
5976,58thStGreenway22ndAve,09/07/2014 12:00:00 AM,48,-122,6,2,8
5977,58thStGreenway22ndAve,09/07/2014 01:00:00 AM,48,-122,10,8,18
5978,58thStGreenway22ndAve,09/07/2014 02:00:00 AM,48,-122,3,2,5
5979,58thStGreenway22ndAve,09/07/2014 03:00:00 AM,48,-122,0,1,1
5980,58thStGreenway22ndAve,09/07/2014 04:00:00 AM,48,-122,2,2,4
5981,58thStGreenway22ndAve,09/07/2014 05:00:00 AM,48,-122,2,0,2
5982,58thStGreenway22ndAve,09/07/2014 06:00:00 AM,48,-122,3,0,3
5983,58thStGreenway22ndAve,09/07/2014 07:00:00 AM,48,-122,3,2,5
5984,58thStGreenway22ndAve,09/07/2014 08:00:00 AM,48,-122,5,9,14
5985,58thStGreenway22ndAve,09/07/2014 09:00:00 AM,48,-122,8,8,16
5986,58thStGreenway22ndAve,09/07/2014 10:00:00 AM,48,-122,36,21,57
5987,58thStGreenway22ndAve,09/07/2014 11:00:00 AM,48,-122,39,23,62
5988,58thStGreenway22ndAve,09/07/2014 12:00:00 PM,48,-122,42,19,61
5989,58thStGreenway22ndAve,09/07/2014 01:00:00 PM,48,-122,42,13,55
5990,58thStGreenway22ndAve,09/07/2014 02:00:00 PM,48,-122,33,21,54
5991,58thStGreenway22ndAve,09/07/2014 03:00:00 PM,48,-122,30,11,41
5992,58thStGreenway22ndAve,09/07/2014 04:00:00 PM,48,-122,23,14,37
5993,58thStGreenway22ndAve,09/07/2014 05:00:00 PM,48,-122,25,13,38
5994,58thStGreenway22ndAve,09/07/2014 06:00:00 PM,48,-122,28,17,45
5995,58thStGreenway22ndAve,09/07/2014 07:00:00 PM,48,-122,19,9,28
5996,58thStGreenway22ndAve,09/07/2014 08:00:00 PM,48,-122,16,3,19
5997,58thStGreenway22ndAve,09/07/2014 09:00:00 PM,48,-122,12,2,14
5998,58thStGreenway22ndAve,09/07/2014 10:00:00 PM,48,-122,9,3,12
5999,58thStGreenway22ndAve,09/07/2014 11:00:00 PM,48,-122,2,0,2
6000,58thStGreenway22ndAve,09/08/2014 12:00:00 AM,48,-122,1,1,2
6001,58thStGreenway22ndAve,09/08/2014 01:00:00 AM,48,-122,0,3,3
6002,58thStGreenway22ndAve,09/08/2014 02:00:00 AM,48,-122,0,3,3
6003,58thStGreenway22ndAve,09/08/2014 03:00:00 AM,48,-122,0,0,0
6004,58thStGreenway22ndAve,09/08/2014 04:00:00 AM,48,-122,0,0,0
6005,58thStGreenway22ndAve,09/08/2014 05:00:00 AM,48,-122,0,0,0
6006,58thStGreenway22ndAve,09/08/2014 06:00:00 AM,48,-122,4,7,11
6007,58thStGreenway22ndAve,09/08/2014 07:00:00 AM,48,-122,19,11,30
6008,58thStGreenway22ndAve,09/08/2014 08:00:00 AM,48,-122,18,19,37
6009,58thStGreenway22ndAve,09/08/2014 09:00:00 AM,48,-122,18,11,29
6010,58thStGreenway22ndAve,09/08/2014 10:00:00 AM,48,-122,14,10,24
6011,58thStGreenway22ndAve,09/08/2014 11:00:00 AM,48,-122,17,6,23
6012,58thStGreenway22ndAve,09/08/2014 12:00:00 PM,48,-122,9,9,18
6013,58thStGreenway22ndAve,09/08/2014 01:00:00 PM,48,-122,15,14,29
6014,58thStGreenway22ndAve,09/08/2014 02:00:00 PM,48,-122,9,6,15
6015,58thStGreenway22ndAve,09/08/2014 03:00:00 PM,48,-122,21,16,37
6016,58thStGreenway22ndAve,09/08/2014 04:00:00 PM,48,-122,47,11,58
6017,58thStGreenway22ndAve,09/08/2014 05:00:00 PM,48,-122,30,17,47
6018,58thStGreenway22ndAve,09/08/2014 06:00:00 PM,48,-122,29,16,45
6019,58thStGreenway22ndAve,09/08/2014 07:00:00 PM,48,-122,21,7,28
6020,58thStGreenway22ndAve,09/08/2014 08:00:00 PM,48,-122,12,6,18
6021,58thStGreenway22ndAve,09/08/2014 09:00:00 PM,48,-122,4,1,5
6022,58thStGreenway22ndAve,09/08/2014 10:00:00 PM,48,-122,7,3,10
6023,58thStGreenway22ndAve,09/08/2014 11:00:00 PM,48,-122,4,2,6
6024,58thStGreenway22ndAve,09/09/2014 12:00:00 AM,48,-122,2,1,3
6025,58thStGreenway22ndAve,09/09/2014 01:00:00 AM,48,-122,0,0,0
6026,58thStGreenway22ndAve,09/09/2014 02:00:00 AM,48,-122,0,0,0
6027,58thStGreenway22ndAve,09/09/2014 03:00:00 AM,48,-122,0,1,1
6028,58thStGreenway22ndAve,09/09/2014 04:00:00 AM,48,-122,0,1,1
6029,58thStGreenway22ndAve,09/09/2014 05:00:00 AM,48,-122,4,2,6
6030,58thStGreenway22ndAve,09/09/2014 06:00:00 AM,48,-122,7,7,14
6031,58thStGreenway22ndAve,09/09/2014 07:00:00 AM,48,-122,25,7,32
6032,58thStGreenway22ndAve,09/09/2014 08:00:00 AM,48,-122,48,19,67
6033,58thStGreenway22ndAve,09/09/2014 09:00:00 AM,48,-122,22,11,33
6034,58thStGreenway22ndAve,09/09/2014 10:00:00 AM,48,-122,20,6,26
6035,58thStGreenway22ndAve,09/09/2014 11:00:00 AM,48,-122,21,7,28
6036,58thStGreenway22ndAve,09/09/2014 12:00:00 PM,48,-122,23,4,27
6037,58thStGreenway22ndAve,09/09/2014 01:00:00 PM,48,-122,32,14,46
6038,58thStGreenway22ndAve,09/09/2014 02:00:00 PM,48,-122,36,20,56
6039,58thStGreenway22ndAve,09/09/2014 03:00:00 PM,48,-122,23,13,36
6040,58thStGreenway22ndAve,09/09/2014 04:00:00 PM,48,-122,47,13,60
6041,58thStGreenway22ndAve,09/09/2014 05:00:00 PM,48,-122,39,24,63
6042,58thStGreenway22ndAve,09/09/2014 06:00:00 PM,48,-122,31,11,42
6043,58thStGreenway22ndAve,09/09/2014 07:00:00 PM,48,-122,24,15,39
6044,58thStGreenway22ndAve,09/09/2014 08:00:00 PM,48,-122,18,10,28
6045,58thStGreenway22ndAve,09/09/2014 09:00:00 PM,48,-122,23,6,29
6046,58thStGreenway22ndAve,09/09/2014 10:00:00 PM,48,-122,2,1,3
6047,58thStGreenway22ndAve,09/09/2014 11:00:00 PM,48,-122,5,0,5
6048,58thStGreenway22ndAve,09/10/2014 12:00:00 AM,48,-122,2,1,3
6049,58thStGreenway22ndAve,09/10/2014 01:00:00 AM,48,-122,0,0,0
6050,58thStGreenway22ndAve,09/10/2014 02:00:00 AM,48,-122,0,0,0
6051,58thStGreenway22ndAve,09/10/2014 03:00:00 AM,48,-122,2,0,2
6052,58thStGreenway22ndAve,09/10/2014 04:00:00 AM,48,-122,2,0,2
6053,58thStGreenway22ndAve,09/10/2014 05:00:00 AM,48,-122,2,1,3
6054,58thStGreenway22ndAve,09/10/2014 06:00:00 AM,48,-122,10,1,11
6055,58thStGreenway22ndAve,09/10/2014 07:00:00 AM,48,-122,37,9,46
6056,58thStGreenway22ndAve,09/10/2014 08:00:00 AM,48,-122,39,14,53
6057,58thStGreenway22ndAve,09/10/2014 09:00:00 AM,48,-122,32,12,44
6058,58thStGreenway22ndAve,09/10/2014 10:00:00 AM,48,-122,18,7,25
6059,58thStGreenway22ndAve,09/10/2014 11:00:00 AM,48,-122,23,6,29
6060,58thStGreenway22ndAve,09/10/2014 12:00:00 PM,48,-122,27,12,39
6061,58thStGreenway22ndAve,09/10/2014 01:00:00 PM,48,-122,33,22,55
6062,58thStGreenway22ndAve,09/10/2014 02:00:00 PM,48,-122,29,7,36
6063,58thStGreenway22ndAve,09/10/2014 03:00:00 PM,48,-122,26,13,39
6064,58thStGreenway22ndAve,09/10/2014 04:00:00 PM,48,-122,30,11,41
6065,58thStGreenway22ndAve,09/10/2014 05:00:00 PM,48,-122,28,16,44
6066,58thStGreenway22ndAve,09/10/2014 06:00:00 PM,48,-122,53,17,70
6067,58thStGreenway22ndAve,09/10/2014 07:00:00 PM,48,-122,38,17,55
6068,58thStGreenway22ndAve,09/10/2014 08:00:00 PM,48,-122,24,6,30
6069,58thStGreenway22ndAve,09/10/2014 09:00:00 PM,48,-122,17,7,24
6070,58thStGreenway22ndAve,09/10/2014 10:00:00 PM,48,-122,10,1,11
6071,58thStGreenway22ndAve,09/10/2014 11:00:00 PM,48,-122,7,1,8
6072,58thStGreenway22ndAve,09/11/2014 12:00:00 AM,48,-122,0,0,0
6073,58thStGreenway22ndAve,09/11/2014 01:00:00 AM,48,-122,0,0,0
6074,58thStGreenway22ndAve,09/11/2014 02:00:00 AM,48,-122,0,0,0
6075,58thStGreenway22ndAve,09/11/2014 03:00:00 AM,48,-122,0,0,0
6076,58thStGreenway22ndAve,09/11/2014 04:00:00 AM,48,-122,2,1,3
6077,58thStGreenway22ndAve,09/11/2014 05:00:00 AM,48,-122,8,0,8
6078,58thStGreenway22ndAve,09/11/2014 06:00:00 AM,48,-122,16,4,20
6079,58thStGreenway22ndAve,09/11/2014 07:00:00 AM,48,-122,25,11,36
6080,58thStGreenway22ndAve,09/11/2014 08:00:00 AM,48,-122,16,11,27
6081,58thStGreenway22ndAve,09/11/2014 09:00:00 AM,48,-122,33,12,45
6082,58thStGreenway22ndAve,09/11/2014 10:00:00 AM,48,-122,26,6,32
6083,58thStGreenway22ndAve,09/11/2014 11:00:00 AM,48,-122,24,10,34
6084,58thStGreenway22ndAve,09/11/2014 12:00:00 PM,48,-122,30,14,44
6085,58thStGreenway22ndAve,09/11/2014 01:00:00 PM,48,-122,44,5,49
6086,58thStGreenway22ndAve,09/11/2014 02:00:00 PM,48,-122,31,14,45
6087,58thStGreenway22ndAve,09/11/2014 03:00:00 PM,48,-122,35,17,52
6088,58thStGreenway22ndAve,09/11/2014 04:00:00 PM,48,-122,29,18,47
6089,58thStGreenway22ndAve,09/11/2014 05:00:00 PM,48,-122,46,16,62
6090,58thStGreenway22ndAve,09/11/2014 06:00:00 PM,48,-122,32,16,48
6091,58thStGreenway22ndAve,09/11/2014 07:00:00 PM,48,-122,29,20,49
6092,58thStGreenway22ndAve,09/11/2014 08:00:00 PM,48,-122,23,13,36
6093,58thStGreenway22ndAve,09/11/2014 09:00:00 PM,48,-122,10,3,13
6094,58thStGreenway22ndAve,09/11/2014 10:00:00 PM,48,-122,6,0,6
6095,58thStGreenway22ndAve,09/11/2014 11:00:00 PM,48,-122,4,1,5
6096,58thStGreenway22ndAve,09/12/2014 12:00:00 AM,48,-122,1,1,2
6097,58thStGreenway22ndAve,09/12/2014 01:00:00 AM,48,-122,0,0,0
6098,58thStGreenway22ndAve,09/12/2014 02:00:00 AM,48,-122,0,0,0
6099,58thStGreenway22ndAve,09/12/2014 03:00:00 AM,48,-122,0,0,0
6100,58thStGreenway22ndAve,09/12/2014 04:00:00 AM,48,-122,0,0,0
6101,58thStGreenway22ndAve,09/12/2014 05:00:00 AM,48,-122,3,1,4
6102,58thStGreenway22ndAve,09/12/2014 06:00:00 AM,48,-122,2,1,3
6103,58thStGreenway22ndAve,09/12/2014 07:00:00 AM,48,-122,14,6,20
6104,58thStGreenway22ndAve,09/12/2014 08:00:00 AM,48,-122,21,11,32
6105,58thStGreenway22ndAve,09/12/2014 09:00:00 AM,48,-122,29,9,38
6106,58thStGreenway22ndAve,09/12/2014 10:00:00 AM,48,-122,19,32,51
6107,58thStGreenway22ndAve,09/12/2014 11:00:00 AM,48,-122,23,9,32
6108,58thStGreenway22ndAve,09/12/2014 12:00:00 PM,48,-122,25,14,39
6109,58thStGreenway22ndAve,09/12/2014 01:00:00 PM,48,-122,21,16,37
6110,58thStGreenway22ndAve,09/12/2014 02:00:00 PM,48,-122,58,8,66
6111,58thStGreenway22ndAve,09/12/2014 03:00:00 PM,48,-122,25,20,45
6112,58thStGreenway22ndAve,09/12/2014 04:00:00 PM,48,-122,35,17,52
6113,58thStGreenway22ndAve,09/12/2014 05:00:00 PM,48,-122,30,19,49
6114,58thStGreenway22ndAve,09/12/2014 06:00:00 PM,48,-122,33,12,45
6115,58thStGreenway22ndAve,09/12/2014 07:00:00 PM,48,-122,18,14,32
6116,58thStGreenway22ndAve,09/12/2014 08:00:00 PM,48,-122,16,11,27
6117,58thStGreenway22ndAve,09/12/2014 09:00:00 PM,48,-122,17,3,20
6118,58thStGreenway22ndAve,09/12/2014 10:00:00 PM,48,-122,12,2,14
6119,58thStGreenway22ndAve,09/12/2014 11:00:00 PM,48,-122,6,3,9
6120,58thStGreenway22ndAve,09/13/2014 12:00:00 AM,48,-122,2,6,8
6121,58thStGreenway22ndAve,09/13/2014 01:00:00 AM,48,-122,5,0,5
6122,58thStGreenway22ndAve,09/13/2014 02:00:00 AM,48,-122,0,2,2
6123,58thStGreenway22ndAve,09/13/2014 03:00:00 AM,48,-122,0,0,0
6124,58thStGreenway22ndAve,09/13/2014 04:00:00 AM,48,-122,0,1,1
6125,58thStGreenway22ndAve,09/13/2014 05:00:00 AM,48,-122,3,0,3
6126,58thStGreenway22ndAve,09/13/2014 06:00:00 AM,48,-122,2,0,2
6127,58thStGreenway22ndAve,09/13/2014 07:00:00 AM,48,-122,3,2,5
6128,58thStGreenway22ndAve,09/13/2014 08:00:00 AM,48,-122,11,7,18
6129,58thStGreenway22ndAve,09/13/2014 09:00:00 AM,48,-122,25,18,43
6130,58thStGreenway22ndAve,09/13/2014 10:00:00 AM,48,-122,10,16,26
6131,58thStGreenway22ndAve,09/13/2014 11:00:00 AM,48,-122,44,20,64
6132,58thStGreenway22ndAve,09/13/2014 12:00:00 PM,48,-122,20,20,40
6133,58thStGreenway22ndAve,09/13/2014 01:00:00 PM,48,-122,29,19,48
6134,58thStGreenway22ndAve,09/13/2014 02:00:00 PM,48,-122,28,11,39
6135,58thStGreenway22ndAve,09/13/2014 03:00:00 PM,48,-122,29,21,50
6136,58thStGreenway22ndAve,09/13/2014 04:00:00 PM,48,-122,28,5,33
6137,58thStGreenway22ndAve,09/13/2014 05:00:00 PM,48,-122,41,7,48
6138,58thStGreenway22ndAve,09/13/2014 06:00:00 PM,48,-122,24,16,40
6139,58thStGreenway22ndAve,09/13/2014 07:00:00 PM,48,-122,33,11,44
6140,58thStGreenway22ndAve,09/13/2014 08:00:00 PM,48,-122,17,9,26
6141,58thStGreenway22ndAve,09/13/2014 09:00:00 PM,48,-122,5,2,7
6142,58thStGreenway22ndAve,09/13/2014 10:00:00 PM,48,-122,9,5,14
6143,58thStGreenway22ndAve,09/13/2014 11:00:00 PM,48,-122,6,2,8
6144,58thStGreenway22ndAve,09/14/2014 12:00:00 AM,48,-122,3,1,4
6145,58thStGreenway22ndAve,09/14/2014 01:00:00 AM,48,-122,6,1,7
6146,58thStGreenway22ndAve,09/14/2014 02:00:00 AM,48,-122,1,0,1
6147,58thStGreenway22ndAve,09/14/2014 03:00:00 AM,48,-122,0,0,0
6148,58thStGreenway22ndAve,09/14/2014 04:00:00 AM,48,-122,2,0,2
6149,58thStGreenway22ndAve,09/14/2014 05:00:00 AM,48,-122,4,0,4
6150,58thStGreenway22ndAve,09/14/2014 06:00:00 AM,48,-122,4,0,4
6151,58thStGreenway22ndAve,09/14/2014 07:00:00 AM,48,-122,1,3,4
6152,58thStGreenway22ndAve,09/14/2014 08:00:00 AM,48,-122,9,7,16
6153,58thStGreenway22ndAve,09/14/2014 09:00:00 AM,48,-122,19,12,31
6154,58thStGreenway22ndAve,09/14/2014 10:00:00 AM,48,-122,24,18,42
6155,58thStGreenway22ndAve,09/14/2014 11:00:00 AM,48,-122,34,23,57
6156,58thStGreenway22ndAve,09/14/2014 12:00:00 PM,48,-122,45,20,65
6157,58thStGreenway22ndAve,09/14/2014 01:00:00 PM,48,-122,35,20,55
6158,58thStGreenway22ndAve,09/14/2014 02:00:00 PM,48,-122,27,12,39
6159,58thStGreenway22ndAve,09/14/2014 03:00:00 PM,48,-122,17,10,27
6160,58thStGreenway22ndAve,09/14/2014 04:00:00 PM,48,-122,15,19,34
6161,58thStGreenway22ndAve,09/14/2014 05:00:00 PM,48,-122,31,22,53
6162,58thStGreenway22ndAve,09/14/2014 06:00:00 PM,48,-122,17,11,28
6163,58thStGreenway22ndAve,09/14/2014 07:00:00 PM,48,-122,30,11,41
6164,58thStGreenway22ndAve,09/14/2014 08:00:00 PM,48,-122,17,4,21
6165,58thStGreenway22ndAve,09/14/2014 09:00:00 PM,48,-122,20,2,22
6166,58thStGreenway22ndAve,09/14/2014 10:00:00 PM,48,-122,2,0,2
6167,58thStGreenway22ndAve,09/14/2014 11:00:00 PM,48,-122,3,2,5
6168,58thStGreenway22ndAve,09/15/2014 12:00:00 AM,48,-122,2,0,2
6169,58thStGreenway22ndAve,09/15/2014 01:00:00 AM,48,-122,0,0,0
6170,58thStGreenway22ndAve,09/15/2014 02:00:00 AM,48,-122,0,1,1
6171,58thStGreenway22ndAve,09/15/2014 03:00:00 AM,48,-122,2,0,2
6172,58thStGreenway22ndAve,09/15/2014 04:00:00 AM,48,-122,2,0,2
6173,58thStGreenway22ndAve,09/15/2014 05:00:00 AM,48,-122,3,2,5
6174,58thStGreenway22ndAve,09/15/2014 06:00:00 AM,48,-122,6,3,9
6175,58thStGreenway22ndAve,09/15/2014 07:00:00 AM,48,-122,33,7,40
6176,58thStGreenway22ndAve,09/15/2014 08:00:00 AM,48,-122,9,7,16
6177,58thStGreenway22ndAve,09/15/2014 09:00:00 AM,48,-122,3,6,9
6178,58thStGreenway22ndAve,09/15/2014 10:00:00 AM,48,-122,3,3,6
6179,58thStGreenway22ndAve,09/15/2014 11:00:00 AM,48,-122,3,9,12
6180,58thStGreenway22ndAve,09/15/2014 12:00:00 PM,48,-122,3,8,11
6181,58thStGreenway22ndAve,09/15/2014 01:00:00 PM,48,-122,3,4,7
6182,58thStGreenway22ndAve,09/15/2014 02:00:00 PM,48,-122,14,7,21
6183,58thStGreenway22ndAve,09/15/2014 03:00:00 PM,48,-122,51,14,65
6184,58thStGreenway22ndAve,09/15/2014 04:00:00 PM,48,-122,31,12,43
6185,58thStGreenway22ndAve,09/15/2014 05:00:00 PM,48,-122,29,24,53
6186,58thStGreenway22ndAve,09/15/2014 06:00:00 PM,48,-122,30,16,46
6187,58thStGreenway22ndAve,09/15/2014 07:00:00 PM,48,-122,34,17,51
6188,58thStGreenway22ndAve,09/15/2014 08:00:00 PM,48,-122,27,0,27
6189,58thStGreenway22ndAve,09/15/2014 09:00:00 PM,48,-122,21,5,26
6190,58thStGreenway22ndAve,09/15/2014 10:00:00 PM,48,-122,12,4,16
6191,58thStGreenway22ndAve,09/15/2014 11:00:00 PM,48,-122,1,0,1
6192,58thStGreenway22ndAve,09/16/2014 12:00:00 AM,48,-122,0,0,0
6193,58thStGreenway22ndAve,09/16/2014 01:00:00 AM,48,-122,2,0,2
6194,58thStGreenway22ndAve,09/16/2014 02:00:00 AM,48,-122,2,0,2
6195,58thStGreenway22ndAve,09/16/2014 03:00:00 AM,48,-122,0,0,0
6196,58thStGreenway22ndAve,09/16/2014 04:00:00 AM,48,-122,0,0,0
6197,58thStGreenway22ndAve,09/16/2014 05:00:00 AM,48,-122,3,0,3
6198,58thStGreenway22ndAve,09/16/2014 06:00:00 AM,48,-122,12,3,15
6199,58thStGreenway22ndAve,09/16/2014 07:00:00 AM,48,-122,22,10,32
6200,58thStGreenway22ndAve,09/16/2014 08:00:00 AM,48,-122,24,8,32
6201,58thStGreenway22ndAve,09/16/2014 09:00:00 AM,48,-122,25,10,35
6202,58thStGreenway22ndAve,09/16/2014 10:00:00 AM,48,-122,23,8,31
6203,58thStGreenway22ndAve,09/16/2014 11:00:00 AM,48,-122,21,7,28
6204,58thStGreenway22ndAve,09/16/2014 12:00:00 PM,48,-122,22,6,28
6205,58thStGreenway22ndAve,09/16/2014 01:00:00 PM,48,-122,38,12,50
6206,58thStGreenway22ndAve,09/16/2014 02:00:00 PM,48,-122,28,7,35
6207,58thStGreenway22ndAve,09/16/2014 03:00:00 PM,48,-122,26,14,40
6208,58thStGreenway22ndAve,09/16/2014 04:00:00 PM,48,-122,32,9,41
6209,58thStGreenway22ndAve,09/16/2014 05:00:00 PM,48,-122,44,20,64
6210,58thStGreenway22ndAve,09/16/2014 06:00:00 PM,48,-122,35,14,49
6211,58thStGreenway22ndAve,09/16/2014 07:00:00 PM,48,-122,40,14,54
6212,58thStGreenway22ndAve,09/16/2014 08:00:00 PM,48,-122,23,7,30
6213,58thStGreenway22ndAve,09/16/2014 09:00:00 PM,48,-122,17,0,17
6214,58thStGreenway22ndAve,09/16/2014 10:00:00 PM,48,-122,6,4,10
6215,58thStGreenway22ndAve,09/16/2014 11:00:00 PM,48,-122,6,0,6
6216,58thStGreenway22ndAve,09/17/2014 12:00:00 AM,48,-122,2,1,3
6217,58thStGreenway22ndAve,09/17/2014 01:00:00 AM,48,-122,0,0,0
6218,58thStGreenway22ndAve,09/17/2014 02:00:00 AM,48,-122,0,0,0
6219,58thStGreenway22ndAve,09/17/2014 03:00:00 AM,48,-122,2,0,2
6220,58thStGreenway22ndAve,09/17/2014 04:00:00 AM,48,-122,0,0,0
6221,58thStGreenway22ndAve,09/17/2014 05:00:00 AM,48,-122,4,0,4
6222,58thStGreenway22ndAve,09/17/2014 06:00:00 AM,48,-122,18,2,20
6223,58thStGreenway22ndAve,09/17/2014 07:00:00 AM,48,-122,23,5,28
6224,58thStGreenway22ndAve,09/17/2014 08:00:00 AM,48,-122,33,11,44
6225,58thStGreenway22ndAve,09/17/2014 09:00:00 AM,48,-122,35,11,46
6226,58thStGreenway22ndAve,09/17/2014 10:00:00 AM,48,-122,17,5,22
6227,58thStGreenway22ndAve,09/17/2014 11:00:00 AM,48,-122,35,7,42
6228,58thStGreenway22ndAve,09/17/2014 12:00:00 PM,48,-122,34,14,48
6229,58thStGreenway22ndAve,09/17/2014 01:00:00 PM,48,-122,19,5,24
6230,58thStGreenway22ndAve,09/17/2014 02:00:00 PM,48,-122,39,9,48
6231,58thStGreenway22ndAve,09/17/2014 03:00:00 PM,48,-122,32,10,42
6232,58thStGreenway22ndAve,09/17/2014 04:00:00 PM,48,-122,36,10,46
6233,58thStGreenway22ndAve,09/17/2014 05:00:00 PM,48,-122,23,9,32
6234,58thStGreenway22ndAve,09/17/2014 06:00:00 PM,48,-122,43,21,64
6235,58thStGreenway22ndAve,09/17/2014 07:00:00 PM,48,-122,25,6,31
6236,58thStGreenway22ndAve,09/17/2014 08:00:00 PM,48,-122,28,4,32
6237,58thStGreenway22ndAve,09/17/2014 09:00:00 PM,48,-122,12,11,23
6238,58thStGreenway22ndAve,09/17/2014 10:00:00 PM,48,-122,12,0,12
6239,58thStGreenway22ndAve,09/17/2014 11:00:00 PM,48,-122,8,2,10
6240,58thStGreenway22ndAve,09/18/2014 12:00:00 AM,48,-122,6,0,6
6241,58thStGreenway22ndAve,09/18/2014 01:00:00 AM,48,-122,0,0,0
6242,58thStGreenway22ndAve,09/18/2014 02:00:00 AM,48,-122,0,0,0
6243,58thStGreenway22ndAve,09/18/2014 03:00:00 AM,48,-122,0,0,0
6244,58thStGreenway22ndAve,09/18/2014 04:00:00 AM,48,-122,0,0,0
6245,58thStGreenway22ndAve,09/18/2014 05:00:00 AM,48,-122,4,4,8
6246,58thStGreenway22ndAve,09/18/2014 06:00:00 AM,48,-122,5,4,9
6247,58thStGreenway22ndAve,09/18/2014 07:00:00 AM,48,-122,29,9,38
6248,58thStGreenway22ndAve,09/18/2014 08:00:00 AM,48,-122,21,13,34
6249,58thStGreenway22ndAve,09/18/2014 09:00:00 AM,48,-122,34,7,41
6250,58thStGreenway22ndAve,09/18/2014 10:00:00 AM,48,-122,30,3,33
6251,58thStGreenway22ndAve,09/18/2014 11:00:00 AM,48,-122,26,8,34
6252,58thStGreenway22ndAve,09/18/2014 12:00:00 PM,48,-122,25,10,35
6253,58thStGreenway22ndAve,09/18/2014 01:00:00 PM,48,-122,38,5,43
6254,58thStGreenway22ndAve,09/18/2014 02:00:00 PM,48,-122,26,6,32
6255,58thStGreenway22ndAve,09/18/2014 03:00:00 PM,48,-122,14,5,19
6256,58thStGreenway22ndAve,09/18/2014 04:00:00 PM,48,-122,22,8,30
6257,58thStGreenway22ndAve,09/18/2014 05:00:00 PM,48,-122,16,20,36
6258,58thStGreenway22ndAve,09/18/2014 06:00:00 PM,48,-122,40,15,55
6259,58thStGreenway22ndAve,09/18/2014 07:00:00 PM,48,-122,23,11,34
6260,58thStGreenway22ndAve,09/18/2014 08:00:00 PM,48,-122,29,8,37
6261,58thStGreenway22ndAve,09/18/2014 09:00:00 PM,48,-122,13,3,16
6262,58thStGreenway22ndAve,09/18/2014 10:00:00 PM,48,-122,6,0,6
6263,58thStGreenway22ndAve,09/18/2014 11:00:00 PM,48,-122,8,0,8
6264,58thStGreenway22ndAve,09/19/2014 12:00:00 AM,48,-122,2,0,2
6265,58thStGreenway22ndAve,09/19/2014 01:00:00 AM,48,-122,0,0,0
6266,58thStGreenway22ndAve,09/19/2014 02:00:00 AM,48,-122,0,0,0
6267,58thStGreenway22ndAve,09/19/2014 03:00:00 AM,48,-122,3,0,3
6268,58thStGreenway22ndAve,09/19/2014 04:00:00 AM,48,-122,3,0,3
6269,58thStGreenway22ndAve,09/19/2014 05:00:00 AM,48,-122,4,0,4
6270,58thStGreenway22ndAve,09/19/2014 06:00:00 AM,48,-122,8,4,12
6271,58thStGreenway22ndAve,09/19/2014 07:00:00 AM,48,-122,22,5,27
6272,58thStGreenway22ndAve,09/19/2014 08:00:00 AM,48,-122,27,18,45
6273,58thStGreenway22ndAve,09/19/2014 09:00:00 AM,48,-122,26,8,34
6274,58thStGreenway22ndAve,09/19/2014 10:00:00 AM,48,-122,23,15,38
6275,58thStGreenway22ndAve,09/19/2014 11:00:00 AM,48,-122,38,8,46
6276,58thStGreenway22ndAve,09/19/2014 12:00:00 PM,48,-122,44,13,57
6277,58thStGreenway22ndAve,09/19/2014 01:00:00 PM,48,-122,35,8,43
6278,58thStGreenway22ndAve,09/19/2014 02:00:00 PM,48,-122,40,7,47
6279,58thStGreenway22ndAve,09/19/2014 03:00:00 PM,48,-122,26,4,30
6280,58thStGreenway22ndAve,09/19/2014 04:00:00 PM,48,-122,45,14,59
6281,58thStGreenway22ndAve,09/19/2014 05:00:00 PM,48,-122,44,17,61
6282,58thStGreenway22ndAve,09/19/2014 06:00:00 PM,48,-122,29,14,43
6283,58thStGreenway22ndAve,09/19/2014 07:00:00 PM,48,-122,27,16,43
6284,58thStGreenway22ndAve,09/19/2014 08:00:00 PM,48,-122,19,6,25
6285,58thStGreenway22ndAve,09/19/2014 09:00:00 PM,48,-122,25,7,32
6286,58thStGreenway22ndAve,09/19/2014 10:00:00 PM,48,-122,6,2,8
6287,58thStGreenway22ndAve,09/19/2014 11:00:00 PM,48,-122,9,1,10
6288,58thStGreenway22ndAve,09/20/2014 12:00:00 AM,48,-122,6,0,6
6289,58thStGreenway22ndAve,09/20/2014 01:00:00 AM,48,-122,4,3,7
6290,58thStGreenway22ndAve,09/20/2014 02:00:00 AM,48,-122,0,0,0
6291,58thStGreenway22ndAve,09/20/2014 03:00:00 AM,48,-122,0,0,0
6292,58thStGreenway22ndAve,09/20/2014 04:00:00 AM,48,-122,1,0,1
6293,58thStGreenway22ndAve,09/20/2014 05:00:00 AM,48,-122,6,1,7
6294,58thStGreenway22ndAve,09/20/2014 06:00:00 AM,48,-122,8,2,10
6295,58thStGreenway22ndAve,09/20/2014 07:00:00 AM,48,-122,8,1,9
6296,58thStGreenway22ndAve,09/20/2014 08:00:00 AM,48,-122,17,4,21
6297,58thStGreenway22ndAve,09/20/2014 09:00:00 AM,48,-122,38,8,46
6298,58thStGreenway22ndAve,09/20/2014 10:00:00 AM,48,-122,27,15,42
6299,58thStGreenway22ndAve,09/20/2014 11:00:00 AM,48,-122,40,24,64
6300,58thStGreenway22ndAve,09/20/2014 12:00:00 PM,48,-122,34,18,52
6301,58thStGreenway22ndAve,09/20/2014 01:00:00 PM,48,-122,45,15,60
6302,58thStGreenway22ndAve,09/20/2014 02:00:00 PM,48,-122,27,11,38
6303,58thStGreenway22ndAve,09/20/2014 03:00:00 PM,48,-122,40,18,58
6304,58thStGreenway22ndAve,09/20/2014 04:00:00 PM,48,-122,29,12,41
6305,58thStGreenway22ndAve,09/20/2014 05:00:00 PM,48,-122,31,12,43
6306,58thStGreenway22ndAve,09/20/2014 06:00:00 PM,48,-122,32,9,41
6307,58thStGreenway22ndAve,09/20/2014 07:00:00 PM,48,-122,34,8,42
6308,58thStGreenway22ndAve,09/20/2014 08:00:00 PM,48,-122,24,1,25
6309,58thStGreenway22ndAve,09/20/2014 09:00:00 PM,48,-122,19,5,24
6310,58thStGreenway22ndAve,09/20/2014 10:00:00 PM,48,-122,9,2,11
6311,58thStGreenway22ndAve,09/20/2014 11:00:00 PM,48,-122,5,0,5
6312,58thStGreenway22ndAve,09/21/2014 12:00:00 AM,48,-122,5,2,7
6313,58thStGreenway22ndAve,09/21/2014 01:00:00 AM,48,-122,2,1,3
6314,58thStGreenway22ndAve,09/21/2014 02:00:00 AM,48,-122,3,0,3
6315,58thStGreenway22ndAve,09/21/2014 03:00:00 AM,48,-122,3,0,3
6316,58thStGreenway22ndAve,09/21/2014 04:00:00 AM,48,-122,0,1,1
6317,58thStGreenway22ndAve,09/21/2014 05:00:00 AM,48,-122,2,1,3
6318,58thStGreenway22ndAve,09/21/2014 06:00:00 AM,48,-122,0,0,0
6319,58thStGreenway22ndAve,09/21/2014 07:00:00 AM,48,-122,4,0,4
6320,58thStGreenway22ndAve,09/21/2014 08:00:00 AM,48,-122,4,6,10
6321,58thStGreenway22ndAve,09/21/2014 09:00:00 AM,48,-122,17,5,22
6322,58thStGreenway22ndAve,09/21/2014 10:00:00 AM,48,-122,41,15,56
6323,58thStGreenway22ndAve,09/21/2014 11:00:00 AM,48,-122,23,19,42
6324,58thStGreenway22ndAve,09/21/2014 12:00:00 PM,48,-122,51,22,73
6325,58thStGreenway22ndAve,09/21/2014 01:00:00 PM,48,-122,38,21,59
6326,58thStGreenway22ndAve,09/21/2014 02:00:00 PM,48,-122,39,15,54
6327,58thStGreenway22ndAve,09/21/2014 03:00:00 PM,48,-122,22,8,30
6328,58thStGreenway22ndAve,09/21/2014 04:00:00 PM,48,-122,20,11,31
6329,58thStGreenway22ndAve,09/21/2014 05:00:00 PM,48,-122,30,15,45
6330,58thStGreenway22ndAve,09/21/2014 06:00:00 PM,48,-122,34,13,47
6331,58thStGreenway22ndAve,09/21/2014 07:00:00 PM,48,-122,23,4,27
6332,58thStGreenway22ndAve,09/21/2014 08:00:00 PM,48,-122,7,2,9
6333,58thStGreenway22ndAve,09/21/2014 09:00:00 PM,48,-122,6,3,9
6334,58thStGreenway22ndAve,09/21/2014 10:00:00 PM,48,-122,5,1,6
6335,58thStGreenway22ndAve,09/21/2014 11:00:00 PM,48,-122,3,0,3
6336,58thStGreenway22ndAve,09/22/2014 12:00:00 AM,48,-122,2,1,3
6337,58thStGreenway22ndAve,09/22/2014 01:00:00 AM,48,-122,0,0,0
6338,58thStGreenway22ndAve,09/22/2014 02:00:00 AM,48,-122,0,0,0
6339,58thStGreenway22ndAve,09/22/2014 03:00:00 AM,48,-122,0,0,0
6340,58thStGreenway22ndAve,09/22/2014 04:00:00 AM,48,-122,0,0,0
6341,58thStGreenway22ndAve,09/22/2014 05:00:00 AM,48,-122,2,2,4
6342,58thStGreenway22ndAve,09/22/2014 06:00:00 AM,48,-122,6,1,7
6343,58thStGreenway22ndAve,09/22/2014 07:00:00 AM,48,-122,22,8,30
6344,58thStGreenway22ndAve,09/22/2014 08:00:00 AM,48,-122,25,8,33
6345,58thStGreenway22ndAve,09/22/2014 09:00:00 AM,48,-122,28,10,38
6346,58thStGreenway22ndAve,09/22/2014 10:00:00 AM,48,-122,26,8,34
6347,58thStGreenway22ndAve,09/22/2014 11:00:00 AM,48,-122,28,16,44
6348,58thStGreenway22ndAve,09/22/2014 12:00:00 PM,48,-122,24,16,40
6349,58thStGreenway22ndAve,09/22/2014 01:00:00 PM,48,-122,29,12,41
6350,58thStGreenway22ndAve,09/22/2014 02:00:00 PM,48,-122,22,8,30
6351,58thStGreenway22ndAve,09/22/2014 03:00:00 PM,48,-122,30,9,39
6352,58thStGreenway22ndAve,09/22/2014 04:00:00 PM,48,-122,32,9,41
6353,58thStGreenway22ndAve,09/22/2014 05:00:00 PM,48,-122,47,16,63
6354,58thStGreenway22ndAve,09/22/2014 06:00:00 PM,48,-122,27,20,47
6355,58thStGreenway22ndAve,09/22/2014 07:00:00 PM,48,-122,9,9,18
6356,58thStGreenway22ndAve,09/22/2014 08:00:00 PM,48,-122,7,2,9
6357,58thStGreenway22ndAve,09/22/2014 09:00:00 PM,48,-122,13,0,13
6358,58thStGreenway22ndAve,09/22/2014 10:00:00 PM,48,-122,7,0,7
6359,58thStGreenway22ndAve,09/22/2014 11:00:00 PM,48,-122,4,1,5
6360,58thStGreenway22ndAve,09/23/2014 12:00:00 AM,48,-122,1,0,1
6361,58thStGreenway22ndAve,09/23/2014 01:00:00 AM,48,-122,0,2,2
6362,58thStGreenway22ndAve,09/23/2014 02:00:00 AM,48,-122,0,0,0
6363,58thStGreenway22ndAve,09/23/2014 03:00:00 AM,48,-122,0,0,0
6364,58thStGreenway22ndAve,09/23/2014 04:00:00 AM,48,-122,0,0,0
6365,58thStGreenway22ndAve,09/23/2014 05:00:00 AM,48,-122,2,0,2
6366,58thStGreenway22ndAve,09/23/2014 06:00:00 AM,48,-122,15,1,16
6367,58thStGreenway22ndAve,09/23/2014 07:00:00 AM,48,-122,24,8,32
6368,58thStGreenway22ndAve,09/23/2014 08:00:00 AM,48,-122,37,6,43
6369,58thStGreenway22ndAve,09/23/2014 09:00:00 AM,48,-122,43,7,50
6370,58thStGreenway22ndAve,09/23/2014 10:00:00 AM,48,-122,27,6,33
6371,58thStGreenway22ndAve,09/23/2014 11:00:00 AM,48,-122,23,7,30
6372,58thStGreenway22ndAve,09/23/2014 12:00:00 PM,48,-122,33,6,39
6373,58thStGreenway22ndAve,09/23/2014 01:00:00 PM,48,-122,24,12,36
6374,58thStGreenway22ndAve,09/23/2014 02:00:00 PM,48,-122,36,10,46
6375,58thStGreenway22ndAve,09/23/2014 03:00:00 PM,48,-122,25,17,42
6376,58thStGreenway22ndAve,09/23/2014 04:00:00 PM,48,-122,28,11,39
6377,58thStGreenway22ndAve,09/23/2014 05:00:00 PM,48,-122,24,12,36
6378,58thStGreenway22ndAve,09/23/2014 06:00:00 PM,48,-122,17,11,28
6379,58thStGreenway22ndAve,09/23/2014 07:00:00 PM,48,-122,15,2,17
6380,58thStGreenway22ndAve,09/23/2014 08:00:00 PM,48,-122,9,2,11
6381,58thStGreenway22ndAve,09/23/2014 09:00:00 PM,48,-122,12,2,14
6382,58thStGreenway22ndAve,09/23/2014 10:00:00 PM,48,-122,12,0,12
6383,58thStGreenway22ndAve,09/23/2014 11:00:00 PM,48,-122,0,0,0
6384,58thStGreenway22ndAve,09/24/2014 12:00:00 AM,48,-122,1,2,3
6385,58thStGreenway22ndAve,09/24/2014 01:00:00 AM,48,-122,1,0,1
6386,58thStGreenway22ndAve,09/24/2014 02:00:00 AM,48,-122,2,0,2
6387,58thStGreenway22ndAve,09/24/2014 03:00:00 AM,48,-122,0,0,0
6388,58thStGreenway22ndAve,09/24/2014 04:00:00 AM,48,-122,0,0,0
6389,58thStGreenway22ndAve,09/24/2014 05:00:00 AM,48,-122,5,0,5
6390,58thStGreenway22ndAve,09/24/2014 06:00:00 AM,48,-122,5,7,12
6391,58thStGreenway22ndAve,09/24/2014 07:00:00 AM,48,-122,23,9,32
6392,58thStGreenway22ndAve,09/24/2014 08:00:00 AM,48,-122,29,11,40
6393,58thStGreenway22ndAve,09/24/2014 09:00:00 AM,48,-122,36,5,41
6394,58thStGreenway22ndAve,09/24/2014 10:00:00 AM,48,-122,32,2,34
6395,58thStGreenway22ndAve,09/24/2014 11:00:00 AM,48,-122,29,10,39
6396,58thStGreenway22ndAve,09/24/2014 12:00:00 PM,48,-122,21,9,30
6397,58thStGreenway22ndAve,09/24/2014 01:00:00 PM,48,-122,31,19,50
6398,58thStGreenway22ndAve,09/24/2014 02:00:00 PM,48,-122,25,7,32
6399,58thStGreenway22ndAve,09/24/2014 03:00:00 PM,48,-122,25,6,31
6400,58thStGreenway22ndAve,09/24/2014 04:00:00 PM,48,-122,30,7,37
6401,58thStGreenway22ndAve,09/24/2014 05:00:00 PM,48,-122,30,8,38
6402,58thStGreenway22ndAve,09/24/2014 06:00:00 PM,48,-122,48,16,64
6403,58thStGreenway22ndAve,09/24/2014 07:00:00 PM,48,-122,31,5,36
6404,58thStGreenway22ndAve,09/24/2014 08:00:00 PM,48,-122,16,7,23
6405,58thStGreenway22ndAve,09/24/2014 09:00:00 PM,48,-122,10,0,10
6406,58thStGreenway22ndAve,09/24/2014 10:00:00 PM,48,-122,8,1,9
6407,58thStGreenway22ndAve,09/24/2014 11:00:00 PM,48,-122,2,0,2
6408,58thStGreenway22ndAve,09/25/2014 12:00:00 AM,48,-122,0,1,1
6409,58thStGreenway22ndAve,09/25/2014 01:00:00 AM,48,-122,3,2,5
6410,58thStGreenway22ndAve,09/25/2014 02:00:00 AM,48,-122,0,0,0
6411,58thStGreenway22ndAve,09/25/2014 03:00:00 AM,48,-122,0,0,0
6412,58thStGreenway22ndAve,09/25/2014 04:00:00 AM,48,-122,2,0,2
6413,58thStGreenway22ndAve,09/25/2014 05:00:00 AM,48,-122,4,0,4
6414,58thStGreenway22ndAve,09/25/2014 06:00:00 AM,48,-122,15,3,18
6415,58thStGreenway22ndAve,09/25/2014 07:00:00 AM,48,-122,31,6,37
6416,58thStGreenway22ndAve,09/25/2014 08:00:00 AM,48,-122,25,9,34
6417,58thStGreenway22ndAve,09/25/2014 09:00:00 AM,48,-122,37,7,44
6418,58thStGreenway22ndAve,09/25/2014 10:00:00 AM,48,-122,30,5,35
6419,58thStGreenway22ndAve,09/25/2014 11:00:00 AM,48,-122,30,6,36
6420,58thStGreenway22ndAve,09/25/2014 12:00:00 PM,48,-122,17,15,32
6421,58thStGreenway22ndAve,09/25/2014 01:00:00 PM,48,-122,16,9,25
6422,58thStGreenway22ndAve,09/25/2014 02:00:00 PM,48,-122,22,12,34
6423,58thStGreenway22ndAve,09/25/2014 03:00:00 PM,48,-122,23,8,31
6424,58thStGreenway22ndAve,09/25/2014 04:00:00 PM,48,-122,46,8,54
6425,58thStGreenway22ndAve,09/25/2014 05:00:00 PM,48,-122,38,19,57
6426,58thStGreenway22ndAve,09/25/2014 06:00:00 PM,48,-122,39,25,64
6427,58thStGreenway22ndAve,09/25/2014 07:00:00 PM,48,-122,14,15,29
6428,58thStGreenway22ndAve,09/25/2014 08:00:00 PM,48,-122,14,2,16
6429,58thStGreenway22ndAve,09/25/2014 09:00:00 PM,48,-122,9,1,10
6430,58thStGreenway22ndAve,09/25/2014 10:00:00 PM,48,-122,13,4,17
6431,58thStGreenway22ndAve,09/25/2014 11:00:00 PM,48,-122,5,0,5
6432,58thStGreenway22ndAve,09/26/2014 12:00:00 AM,48,-122,4,0,4
6433,58thStGreenway22ndAve,09/26/2014 01:00:00 AM,48,-122,2,0,2
6434,58thStGreenway22ndAve,09/26/2014 02:00:00 AM,48,-122,0,1,1
6435,58thStGreenway22ndAve,09/26/2014 03:00:00 AM,48,-122,0,0,0
6436,58thStGreenway22ndAve,09/26/2014 04:00:00 AM,48,-122,1,0,1
6437,58thStGreenway22ndAve,09/26/2014 05:00:00 AM,48,-122,3,1,4
6438,58thStGreenway22ndAve,09/26/2014 06:00:00 AM,48,-122,8,5,13
6439,58thStGreenway22ndAve,09/26/2014 07:00:00 AM,48,-122,23,9,32
6440,58thStGreenway22ndAve,09/26/2014 08:00:00 AM,48,-122,30,7,37
6441,58thStGreenway22ndAve,09/26/2014 09:00:00 AM,48,-122,51,9,60
6442,58thStGreenway22ndAve,09/26/2014 10:00:00 AM,48,-122,16,9,25
6443,58thStGreenway22ndAve,09/26/2014 11:00:00 AM,48,-122,30,8,38
6444,58thStGreenway22ndAve,09/26/2014 12:00:00 PM,48,-122,34,15,49
6445,58thStGreenway22ndAve,09/26/2014 01:00:00 PM,48,-122,35,6,41
6446,58thStGreenway22ndAve,09/26/2014 02:00:00 PM,48,-122,23,9,32
6447,58thStGreenway22ndAve,09/26/2014 03:00:00 PM,48,-122,34,8,42
6448,58thStGreenway22ndAve,09/26/2014 04:00:00 PM,48,-122,31,19,50
6449,58thStGreenway22ndAve,09/26/2014 05:00:00 PM,48,-122,31,12,43
6450,58thStGreenway22ndAve,09/26/2014 06:00:00 PM,48,-122,47,10,57
6451,58thStGreenway22ndAve,09/26/2014 07:00:00 PM,48,-122,24,4,28
6452,58thStGreenway22ndAve,09/26/2014 08:00:00 PM,48,-122,23,8,31
6453,58thStGreenway22ndAve,09/26/2014 09:00:00 PM,48,-122,14,5,19
6454,58thStGreenway22ndAve,09/26/2014 10:00:00 PM,48,-122,13,3,16
6455,58thStGreenway22ndAve,09/26/2014 11:00:00 PM,48,-122,5,4,9
6456,58thStGreenway22ndAve,09/27/2014 12:00:00 AM,48,-122,6,4,10
6457,58thStGreenway22ndAve,09/27/2014 01:00:00 AM,48,-122,4,0,4
6458,58thStGreenway22ndAve,09/27/2014 02:00:00 AM,48,-122,4,0,4
6459,58thStGreenway22ndAve,09/27/2014 03:00:00 AM,48,-122,0,0,0
6460,58thStGreenway22ndAve,09/27/2014 04:00:00 AM,48,-122,2,0,2
6461,58thStGreenway22ndAve,09/27/2014 05:00:00 AM,48,-122,0,0,0
6462,58thStGreenway22ndAve,09/27/2014 06:00:00 AM,48,-122,6,2,8
6463,58thStGreenway22ndAve,09/27/2014 07:00:00 AM,48,-122,1,2,3
6464,58thStGreenway22ndAve,09/27/2014 08:00:00 AM,48,-122,8,5,13
6465,58thStGreenway22ndAve,09/27/2014 09:00:00 AM,48,-122,16,9,25
6466,58thStGreenway22ndAve,09/27/2014 10:00:00 AM,48,-122,25,21,46
6467,58thStGreenway22ndAve,09/27/2014 11:00:00 AM,48,-122,36,18,54
6468,58thStGreenway22ndAve,09/27/2014 12:00:00 PM,48,-122,45,16,61
6469,58thStGreenway22ndAve,09/27/2014 01:00:00 PM,48,-122,31,22,53
6470,58thStGreenway22ndAve,09/27/2014 02:00:00 PM,48,-122,29,20,49
6471,58thStGreenway22ndAve,09/27/2014 03:00:00 PM,48,-122,34,18,52
6472,58thStGreenway22ndAve,09/27/2014 04:00:00 PM,48,-122,39,21,60
6473,58thStGreenway22ndAve,09/27/2014 05:00:00 PM,48,-122,50,13,63
6474,58thStGreenway22ndAve,09/27/2014 06:00:00 PM,48,-122,27,11,38
6475,58thStGreenway22ndAve,09/27/2014 07:00:00 PM,48,-122,58,4,62
6476,58thStGreenway22ndAve,09/27/2014 08:00:00 PM,48,-122,27,2,29
6477,58thStGreenway22ndAve,09/27/2014 09:00:00 PM,48,-122,22,4,26
6478,58thStGreenway22ndAve,09/27/2014 10:00:00 PM,48,-122,8,0,8
6479,58thStGreenway22ndAve,09/27/2014 11:00:00 PM,48,-122,13,1,14
6480,58thStGreenway22ndAve,09/28/2014 12:00:00 AM,48,-122,5,0,5
6481,58thStGreenway22ndAve,09/28/2014 01:00:00 AM,48,-122,4,0,4
6482,58thStGreenway22ndAve,09/28/2014 02:00:00 AM,48,-122,7,0,7
6483,58thStGreenway22ndAve,09/28/2014 03:00:00 AM,48,-122,2,0,2
6484,58thStGreenway22ndAve,09/28/2014 04:00:00 AM,48,-122,0,1,1
6485,58thStGreenway22ndAve,09/28/2014 05:00:00 AM,48,-122,0,0,0
6486,58thStGreenway22ndAve,09/28/2014 06:00:00 AM,48,-122,0,0,0
6487,58thStGreenway22ndAve,09/28/2014 07:00:00 AM,48,-122,4,3,7
6488,58thStGreenway22ndAve,09/28/2014 08:00:00 AM,48,-122,16,8,24
6489,58thStGreenway22ndAve,09/28/2014 09:00:00 AM,48,-122,54,16,70
6490,58thStGreenway22ndAve,09/28/2014 10:00:00 AM,48,-122,83,26,109
6491,58thStGreenway22ndAve,09/28/2014 11:00:00 AM,48,-122,87,19,106
6492,58thStGreenway22ndAve,09/28/2014 12:00:00 PM,48,-122,105,44,149
6493,58thStGreenway22ndAve,09/28/2014 01:00:00 PM,48,-122,113,36,149
6494,58thStGreenway22ndAve,09/28/2014 02:00:00 PM,48,-122,147,26,173
6495,58thStGreenway22ndAve,09/28/2014 03:00:00 PM,48,-122,93,24,117
6496,58thStGreenway22ndAve,09/28/2014 04:00:00 PM,48,-122,79,22,101
6497,58thStGreenway22ndAve,09/28/2014 05:00:00 PM,48,-122,70,23,93
6498,58thStGreenway22ndAve,09/28/2014 06:00:00 PM,48,-122,43,11,54
6499,58thStGreenway22ndAve,09/28/2014 07:00:00 PM,48,-122,31,4,35
6500,58thStGreenway22ndAve,09/28/2014 08:00:00 PM,48,-122,13,0,13
6501,58thStGreenway22ndAve,09/28/2014 09:00:00 PM,48,-122,14,0,14
6502,58thStGreenway22ndAve,09/28/2014 10:00:00 PM,48,-122,6,0,6
6503,58thStGreenway22ndAve,09/28/2014 11:00:00 PM,48,-122,6,0,6
6504,58thStGreenway22ndAve,09/29/2014 12:00:00 AM,48,-122,2,0,2
6505,58thStGreenway22ndAve,09/29/2014 01:00:00 AM,48,-122,0,0,0
6506,58thStGreenway22ndAve,09/29/2014 02:00:00 AM,48,-122,0,0,0
6507,58thStGreenway22ndAve,09/29/2014 03:00:00 AM,48,-122,0,0,0
6508,58thStGreenway22ndAve,09/29/2014 04:00:00 AM,48,-122,1,1,2
6509,58thStGreenway22ndAve,09/29/2014 05:00:00 AM,48,-122,2,0,2
6510,58thStGreenway22ndAve,09/29/2014 06:00:00 AM,48,-122,10,1,11
6511,58thStGreenway22ndAve,09/29/2014 07:00:00 AM,48,-122,32,11,43
6512,58thStGreenway22ndAve,09/29/2014 08:00:00 AM,48,-122,45,12,57
6513,58thStGreenway22ndAve,09/29/2014 09:00:00 AM,48,-122,31,6,37
6514,58thStGreenway22ndAve,09/29/2014 10:00:00 AM,48,-122,20,11,31
6515,58thStGreenway22ndAve,09/29/2014 11:00:00 AM,48,-122,25,7,32
6516,58thStGreenway22ndAve,09/29/2014 12:00:00 PM,48,-122,32,8,40
6517,58thStGreenway22ndAve,09/29/2014 01:00:00 PM,48,-122,29,6,35
6518,58thStGreenway22ndAve,09/29/2014 02:00:00 PM,48,-122,16,7,23
6519,58thStGreenway22ndAve,09/29/2014 03:00:00 PM,48,-122,22,14,36
6520,58thStGreenway22ndAve,09/29/2014 04:00:00 PM,48,-122,34,5,39
6521,58thStGreenway22ndAve,09/29/2014 05:00:00 PM,48,-122,18,11,29
6522,58thStGreenway22ndAve,09/29/2014 06:00:00 PM,48,-122,26,12,38
6523,58thStGreenway22ndAve,09/29/2014 07:00:00 PM,48,-122,14,4,18
6524,58thStGreenway22ndAve,09/29/2014 08:00:00 PM,48,-122,24,5,29
6525,58thStGreenway22ndAve,09/29/2014 09:00:00 PM,48,-122,10,2,12
6526,58thStGreenway22ndAve,09/29/2014 10:00:00 PM,48,-122,1,1,2
6527,58thStGreenway22ndAve,09/29/2014 11:00:00 PM,48,-122,4,0,4
6528,58thStGreenway22ndAve,09/30/2014 12:00:00 AM,48,-122,2,0,2
6529,58thStGreenway22ndAve,09/30/2014 01:00:00 AM,48,-122,0,0,0
6530,58thStGreenway22ndAve,09/30/2014 02:00:00 AM,48,-122,0,0,0
6531,58thStGreenway22ndAve,09/30/2014 03:00:00 AM,48,-122,0,0,0
6532,58thStGreenway22ndAve,09/30/2014 04:00:00 AM,48,-122,2,0,2
6533,58thStGreenway22ndAve,09/30/2014 05:00:00 AM,48,-122,0,1,1
6534,58thStGreenway22ndAve,09/30/2014 06:00:00 AM,48,-122,5,5,10
6535,58thStGreenway22ndAve,09/30/2014 07:00:00 AM,48,-122,32,6,38
6536,58thStGreenway22ndAve,09/30/2014 08:00:00 AM,48,-122,36,12,48
6537,58thStGreenway22ndAve,09/30/2014 09:00:00 AM,48,-122,15,15,30
6538,58thStGreenway22ndAve,09/30/2014 10:00:00 AM,48,-122,31,13,44
6539,58thStGreenway22ndAve,09/30/2014 11:00:00 AM,48,-122,21,7,28
6540,58thStGreenway22ndAve,09/30/2014 12:00:00 PM,48,-122,28,13,41
6541,58thStGreenway22ndAve,09/30/2014 01:00:00 PM,48,-122,27,10,37
6542,58thStGreenway22ndAve,09/30/2014 02:00:00 PM,48,-122,43,4,47
6543,58thStGreenway22ndAve,09/30/2014 03:00:00 PM,48,-122,27,13,40
6544,58thStGreenway22ndAve,09/30/2014 04:00:00 PM,48,-122,26,15,41
6545,58thStGreenway22ndAve,09/30/2014 05:00:00 PM,48,-122,31,10,41
6546,58thStGreenway22ndAve,09/30/2014 06:00:00 PM,48,-122,24,15,39
6547,58thStGreenway22ndAve,09/30/2014 07:00:00 PM,48,-122,15,13,28
6548,58thStGreenway22ndAve,09/30/2014 08:00:00 PM,48,-122,18,5,23
6549,58thStGreenway22ndAve,09/30/2014 09:00:00 PM,48,-122,10,2,12
6550,58thStGreenway22ndAve,09/30/2014 10:00:00 PM,48,-122,4,0,4
6551,58thStGreenway22ndAve,09/30/2014 11:00:00 PM,48,-122,0,0,0
6552,58thStGreenway22ndAve,10/01/2014 12:00:00 AM,48,-122,1,1,2
6553,58thStGreenway22ndAve,10/01/2014 01:00:00 AM,48,-122,0,0,0
6554,58thStGreenway22ndAve,10/01/2014 02:00:00 AM,48,-122,0,0,0
6555,58thStGreenway22ndAve,10/01/2014 03:00:00 AM,48,-122,0,0,0
6556,58thStGreenway22ndAve,10/01/2014 04:00:00 AM,48,-122,0,0,0
6557,58thStGreenway22ndAve,10/01/2014 05:00:00 AM,48,-122,2,1,3
6558,58thStGreenway22ndAve,10/01/2014 06:00:00 AM,48,-122,12,3,15
6559,58thStGreenway22ndAve,10/01/2014 07:00:00 AM,48,-122,32,9,41
6560,58thStGreenway22ndAve,10/01/2014 08:00:00 AM,48,-122,32,18,50
6561,58thStGreenway22ndAve,10/01/2014 09:00:00 AM,48,-122,23,5,28
6562,58thStGreenway22ndAve,10/01/2014 10:00:00 AM,48,-122,20,8,28
6563,58thStGreenway22ndAve,10/01/2014 11:00:00 AM,48,-122,35,7,42
6564,58thStGreenway22ndAve,10/01/2014 12:00:00 PM,48,-122,20,8,28
6565,58thStGreenway22ndAve,10/01/2014 01:00:00 PM,48,-122,19,12,31
6566,58thStGreenway22ndAve,10/01/2014 02:00:00 PM,48,-122,29,15,44
6567,58thStGreenway22ndAve,10/01/2014 03:00:00 PM,48,-122,33,13,46
6568,58thStGreenway22ndAve,10/01/2014 04:00:00 PM,48,-122,44,11,55
6569,58thStGreenway22ndAve,10/01/2014 05:00:00 PM,48,-122,45,12,57
6570,58thStGreenway22ndAve,10/01/2014 06:00:00 PM,48,-122,20,6,26
6571,58thStGreenway22ndAve,10/01/2014 07:00:00 PM,48,-122,24,10,34
6572,58thStGreenway22ndAve,10/01/2014 08:00:00 PM,48,-122,15,2,17
6573,58thStGreenway22ndAve,10/01/2014 09:00:00 PM,48,-122,10,3,13
6574,58thStGreenway22ndAve,10/01/2014 10:00:00 PM,48,-122,11,3,14
6575,58thStGreenway22ndAve,10/01/2014 11:00:00 PM,48,-122,10,0,10
6576,58thStGreenway22ndAve,10/02/2014 12:00:00 AM,48,-122,4,0,4
6577,58thStGreenway22ndAve,10/02/2014 01:00:00 AM,48,-122,0,0,0
6578,58thStGreenway22ndAve,10/02/2014 02:00:00 AM,48,-122,0,0,0
6579,58thStGreenway22ndAve,10/02/2014 03:00:00 AM,48,-122,0,0,0
6580,58thStGreenway22ndAve,10/02/2014 04:00:00 AM,48,-122,0,0,0
6581,58thStGreenway22ndAve,10/02/2014 05:00:00 AM,48,-122,3,1,4
6582,58thStGreenway22ndAve,10/02/2014 06:00:00 AM,48,-122,13,1,14
6583,58thStGreenway22ndAve,10/02/2014 07:00:00 AM,48,-122,24,6,30
6584,58thStGreenway22ndAve,10/02/2014 08:00:00 AM,48,-122,34,9,43
6585,58thStGreenway22ndAve,10/02/2014 09:00:00 AM,48,-122,42,9,51
6586,58thStGreenway22ndAve,10/02/2014 10:00:00 AM,48,-122,29,9,38
6587,58thStGreenway22ndAve,10/02/2014 11:00:00 AM,48,-122,25,18,43
6588,58thStGreenway22ndAve,10/02/2014 12:00:00 PM,48,-122,23,14,37
6589,58thStGreenway22ndAve,10/02/2014 01:00:00 PM,48,-122,23,9,32
6590,58thStGreenway22ndAve,10/02/2014 02:00:00 PM,48,-122,30,6,36
6591,58thStGreenway22ndAve,10/02/2014 03:00:00 PM,48,-122,28,7,35
6592,58thStGreenway22ndAve,10/02/2014 04:00:00 PM,48,-122,32,15,47
6593,58thStGreenway22ndAve,10/02/2014 05:00:00 PM,48,-122,33,18,51
6594,58thStGreenway22ndAve,10/02/2014 06:00:00 PM,48,-122,21,18,39
6595,58thStGreenway22ndAve,10/02/2014 07:00:00 PM,48,-122,29,9,38
6596,58thStGreenway22ndAve,10/02/2014 08:00:00 PM,48,-122,11,9,20
6597,58thStGreenway22ndAve,10/02/2014 09:00:00 PM,48,-122,13,2,15
6598,58thStGreenway22ndAve,10/02/2014 10:00:00 PM,48,-122,9,3,12
6599,58thStGreenway22ndAve,10/02/2014 11:00:00 PM,48,-122,6,1,7
6600,58thStGreenway22ndAve,10/03/2014 12:00:00 AM,48,-122,3,1,4
6601,58thStGreenway22ndAve,10/03/2014 01:00:00 AM,48,-122,2,0,2
6602,58thStGreenway22ndAve,10/03/2014 02:00:00 AM,48,-122,1,0,1
6603,58thStGreenway22ndAve,10/03/2014 03:00:00 AM,48,-122,2,1,3
6604,58thStGreenway22ndAve,10/03/2014 04:00:00 AM,48,-122,0,0,0
6605,58thStGreenway22ndAve,10/03/2014 05:00:00 AM,48,-122,0,0,0
6606,58thStGreenway22ndAve,10/03/2014 06:00:00 AM,48,-122,5,1,6
6607,58thStGreenway22ndAve,10/03/2014 07:00:00 AM,48,-122,19,6,25
6608,58thStGreenway22ndAve,10/03/2014 08:00:00 AM,48,-122,18,10,28
6609,58thStGreenway22ndAve,10/03/2014 09:00:00 AM,48,-122,25,11,36
6610,58thStGreenway22ndAve,10/03/2014 10:00:00 AM,48,-122,26,13,39
6611,58thStGreenway22ndAve,10/03/2014 11:00:00 AM,48,-122,29,6,35
6612,58thStGreenway22ndAve,10/03/2014 12:00:00 PM,48,-122,50,14,64
6613,58thStGreenway22ndAve,10/03/2014 01:00:00 PM,48,-122,34,19,53
6614,58thStGreenway22ndAve,10/03/2014 02:00:00 PM,48,-122,33,18,51
6615,58thStGreenway22ndAve,10/03/2014 03:00:00 PM,48,-122,39,12,51
6616,58thStGreenway22ndAve,10/03/2014 04:00:00 PM,48,-122,36,12,48
6617,58thStGreenway22ndAve,10/03/2014 05:00:00 PM,48,-122,48,22,70
6618,58thStGreenway22ndAve,10/03/2014 06:00:00 PM,48,-122,52,17,69
6619,58thStGreenway22ndAve,10/03/2014 07:00:00 PM,48,-122,43,14,57
6620,58thStGreenway22ndAve,10/03/2014 08:00:00 PM,48,-122,17,3,20
6621,58thStGreenway22ndAve,10/03/2014 09:00:00 PM,48,-122,13,3,16
6622,58thStGreenway22ndAve,10/03/2014 10:00:00 PM,48,-122,7,1,8
6623,58thStGreenway22ndAve,10/03/2014 11:00:00 PM,48,-122,11,1,12
6624,58thStGreenway22ndAve,10/04/2014 12:00:00 AM,48,-122,0,0,0
6625,58thStGreenway22ndAve,10/04/2014 01:00:00 AM,48,-122,0,0,0
6626,58thStGreenway22ndAve,10/04/2014 02:00:00 AM,48,-122,1,1,2
6627,58thStGreenway22ndAve,10/04/2014 03:00:00 AM,48,-122,5,0,5
6628,58thStGreenway22ndAve,10/04/2014 04:00:00 AM,48,-122,0,0,0
6629,58thStGreenway22ndAve,10/04/2014 05:00:00 AM,48,-122,3,0,3
6630,58thStGreenway22ndAve,10/04/2014 06:00:00 AM,48,-122,6,1,7
6631,58thStGreenway22ndAve,10/04/2014 07:00:00 AM,48,-122,5,2,7
6632,58thStGreenway22ndAve,10/04/2014 08:00:00 AM,48,-122,9,3,12
6633,58thStGreenway22ndAve,10/04/2014 09:00:00 AM,48,-122,40,5,45
6634,58thStGreenway22ndAve,10/04/2014 10:00:00 AM,48,-122,20,10,30
6635,58thStGreenway22ndAve,10/04/2014 11:00:00 AM,48,-122,28,20,48
6636,58thStGreenway22ndAve,10/04/2014 12:00:00 PM,48,-122,34,23,57
6637,58thStGreenway22ndAve,10/04/2014 01:00:00 PM,48,-122,56,22,78
6638,58thStGreenway22ndAve,10/04/2014 02:00:00 PM,48,-122,43,19,62
6639,58thStGreenway22ndAve,10/04/2014 03:00:00 PM,48,-122,46,11,57
6640,58thStGreenway22ndAve,10/04/2014 04:00:00 PM,48,-122,52,23,75
6641,58thStGreenway22ndAve,10/04/2014 05:00:00 PM,48,-122,23,26,49
6642,58thStGreenway22ndAve,10/04/2014 06:00:00 PM,48,-122,30,25,55
6643,58thStGreenway22ndAve,10/04/2014 07:00:00 PM,48,-122,41,10,51
6644,58thStGreenway22ndAve,10/04/2014 08:00:00 PM,48,-122,25,15,40
6645,58thStGreenway22ndAve,10/04/2014 09:00:00 PM,48,-122,18,14,32
6646,58thStGreenway22ndAve,10/04/2014 10:00:00 PM,48,-122,6,3,9
6647,58thStGreenway22ndAve,10/04/2014 11:00:00 PM,48,-122,3,1,4
6648,58thStGreenway22ndAve,10/05/2014 12:00:00 AM,48,-122,9,0,9
6649,58thStGreenway22ndAve,10/05/2014 01:00:00 AM,48,-122,6,1,7
6650,58thStGreenway22ndAve,10/05/2014 02:00:00 AM,48,-122,4,2,6
6651,58thStGreenway22ndAve,10/05/2014 03:00:00 AM,48,-122,0,0,0
6652,58thStGreenway22ndAve,10/05/2014 04:00:00 AM,48,-122,0,0,0
6653,58thStGreenway22ndAve,10/05/2014 05:00:00 AM,48,-122,2,0,2
6654,58thStGreenway22ndAve,10/05/2014 06:00:00 AM,48,-122,0,0,0
6655,58thStGreenway22ndAve,10/05/2014 07:00:00 AM,48,-122,2,1,3
6656,58thStGreenway22ndAve,10/05/2014 08:00:00 AM,48,-122,19,5,24
6657,58thStGreenway22ndAve,10/05/2014 09:00:00 AM,48,-122,19,6,25
6658,58thStGreenway22ndAve,10/05/2014 10:00:00 AM,48,-122,30,18,48
6659,58thStGreenway22ndAve,10/05/2014 11:00:00 AM,48,-122,16,23,39
6660,58thStGreenway22ndAve,10/05/2014 12:00:00 PM,48,-122,47,29,76
6661,58thStGreenway22ndAve,10/05/2014 01:00:00 PM,48,-122,45,21,66
6662,58thStGreenway22ndAve,10/05/2014 02:00:00 PM,48,-122,36,24,60
6663,58thStGreenway22ndAve,10/05/2014 03:00:00 PM,48,-122,37,17,54
6664,58thStGreenway22ndAve,10/05/2014 04:00:00 PM,48,-122,37,14,51
6665,58thStGreenway22ndAve,10/05/2014 05:00:00 PM,48,-122,30,10,40
6666,58thStGreenway22ndAve,10/05/2014 06:00:00 PM,48,-122,24,9,33
6667,58thStGreenway22ndAve,10/05/2014 07:00:00 PM,48,-122,15,7,22
6668,58thStGreenway22ndAve,10/05/2014 08:00:00 PM,48,-122,17,3,20
6669,58thStGreenway22ndAve,10/05/2014 09:00:00 PM,48,-122,7,1,8
6670,58thStGreenway22ndAve,10/05/2014 10:00:00 PM,48,-122,2,2,4
6671,58thStGreenway22ndAve,10/05/2014 11:00:00 PM,48,-122,4,1,5
6672,58thStGreenway22ndAve,10/06/2014 12:00:00 AM,48,-122,0,0,0
6673,58thStGreenway22ndAve,10/06/2014 01:00:00 AM,48,-122,0,0,0
6674,58thStGreenway22ndAve,10/06/2014 02:00:00 AM,48,-122,0,0,0
6675,58thStGreenway22ndAve,10/06/2014 03:00:00 AM,48,-122,2,0,2
6676,58thStGreenway22ndAve,10/06/2014 04:00:00 AM,48,-122,0,0,0
6677,58thStGreenway22ndAve,10/06/2014 05:00:00 AM,48,-122,0,0,0
6678,58thStGreenway22ndAve,10/06/2014 06:00:00 AM,48,-122,10,5,15
6679,58thStGreenway22ndAve,10/06/2014 07:00:00 AM,48,-122,19,9,28
6680,58thStGreenway22ndAve,10/06/2014 08:00:00 AM,48,-122,29,5,34
6681,58thStGreenway22ndAve,10/06/2014 09:00:00 AM,48,-122,14,11,25
6682,58thStGreenway22ndAve,10/06/2014 10:00:00 AM,48,-122,20,3,23
6683,58thStGreenway22ndAve,10/06/2014 11:00:00 AM,48,-122,25,10,35
6684,58thStGreenway22ndAve,10/06/2014 12:00:00 PM,48,-122,16,12,28
6685,58thStGreenway22ndAve,10/06/2014 01:00:00 PM,48,-122,19,10,29
6686,58thStGreenway22ndAve,10/06/2014 02:00:00 PM,48,-122,44,10,54
6687,58thStGreenway22ndAve,10/06/2014 03:00:00 PM,48,-122,41,10,51
6688,58thStGreenway22ndAve,10/06/2014 04:00:00 PM,48,-122,21,19,40
6689,58thStGreenway22ndAve,10/06/2014 05:00:00 PM,48,-122,41,18,59
6690,58thStGreenway22ndAve,10/06/2014 06:00:00 PM,48,-122,33,9,42
6691,58thStGreenway22ndAve,10/06/2014 07:00:00 PM,48,-122,20,5,25
6692,58thStGreenway22ndAve,10/06/2014 08:00:00 PM,48,-122,15,2,17
6693,58thStGreenway22ndAve,10/06/2014 09:00:00 PM,48,-122,11,6,17
6694,58thStGreenway22ndAve,10/06/2014 10:00:00 PM,48,-122,4,0,4
6695,58thStGreenway22ndAve,10/06/2014 11:00:00 PM,48,-122,4,1,5
6696,58thStGreenway22ndAve,10/07/2014 12:00:00 AM,48,-122,0,0,0
6697,58thStGreenway22ndAve,10/07/2014 01:00:00 AM,48,-122,2,1,3
6698,58thStGreenway22ndAve,10/07/2014 02:00:00 AM,48,-122,1,1,2
6699,58thStGreenway22ndAve,10/07/2014 03:00:00 AM,48,-122,2,0,2
6700,58thStGreenway22ndAve,10/07/2014 04:00:00 AM,48,-122,2,0,2
6701,58thStGreenway22ndAve,10/07/2014 05:00:00 AM,48,-122,2,0,2
6702,58thStGreenway22ndAve,10/07/2014 06:00:00 AM,48,-122,6,4,10
6703,58thStGreenway22ndAve,10/07/2014 07:00:00 AM,48,-122,30,9,39
6704,58thStGreenway22ndAve,10/07/2014 08:00:00 AM,48,-122,46,6,52
6705,58thStGreenway22ndAve,10/07/2014 09:00:00 AM,48,-122,17,9,26
6706,58thStGreenway22ndAve,10/07/2014 10:00:00 AM,48,-122,24,6,30
6707,58thStGreenway22ndAve,10/07/2014 11:00:00 AM,48,-122,39,11,50
6708,58thStGreenway22ndAve,10/07/2014 12:00:00 PM,48,-122,26,12,38
6709,58thStGreenway22ndAve,10/07/2014 01:00:00 PM,48,-122,25,2,27
6710,58thStGreenway22ndAve,10/07/2014 02:00:00 PM,48,-122,28,12,40
6711,58thStGreenway22ndAve,10/07/2014 03:00:00 PM,48,-122,15,9,24
6712,58thStGreenway22ndAve,10/07/2014 04:00:00 PM,48,-122,28,5,33
6713,58thStGreenway22ndAve,10/07/2014 05:00:00 PM,48,-122,41,18,59
6714,58thStGreenway22ndAve,10/07/2014 06:00:00 PM,48,-122,20,17,37
6715,58thStGreenway22ndAve,10/07/2014 07:00:00 PM,48,-122,28,14,42
6716,58thStGreenway22ndAve,10/07/2014 08:00:00 PM,48,-122,16,1,17
6717,58thStGreenway22ndAve,10/07/2014 09:00:00 PM,48,-122,11,3,14
6718,58thStGreenway22ndAve,10/07/2014 10:00:00 PM,48,-122,6,2,8
6719,58thStGreenway22ndAve,10/07/2014 11:00:00 PM,48,-122,4,0,4
6720,58thStGreenway22ndAve,10/08/2014 12:00:00 AM,48,-122,0,1,1
6721,58thStGreenway22ndAve,10/08/2014 01:00:00 AM,48,-122,2,0,2
6722,58thStGreenway22ndAve,10/08/2014 02:00:00 AM,48,-122,0,0,0
6723,58thStGreenway22ndAve,10/08/2014 03:00:00 AM,48,-122,0,0,0
6724,58thStGreenway22ndAve,10/08/2014 04:00:00 AM,48,-122,0,0,0
6725,58thStGreenway22ndAve,10/08/2014 05:00:00 AM,48,-122,3,1,4
6726,58thStGreenway22ndAve,10/08/2014 06:00:00 AM,48,-122,7,3,10
6727,58thStGreenway22ndAve,10/08/2014 07:00:00 AM,48,-122,26,6,32
6728,58thStGreenway22ndAve,10/08/2014 08:00:00 AM,48,-122,36,7,43
6729,58thStGreenway22ndAve,10/08/2014 09:00:00 AM,48,-122,27,5,32
6730,58thStGreenway22ndAve,10/08/2014 10:00:00 AM,48,-122,21,7,28
6731,58thStGreenway22ndAve,10/08/2014 11:00:00 AM,48,-122,26,13,39
6732,58thStGreenway22ndAve,10/08/2014 12:00:00 PM,48,-122,32,10,42
6733,58thStGreenway22ndAve,10/08/2014 01:00:00 PM,48,-122,35,11,46
6734,58thStGreenway22ndAve,10/08/2014 02:00:00 PM,48,-122,13,12,25
6735,58thStGreenway22ndAve,10/08/2014 03:00:00 PM,48,-122,32,7,39
6736,58thStGreenway22ndAve,10/08/2014 04:00:00 PM,48,-122,30,5,35
6737,58thStGreenway22ndAve,10/08/2014 05:00:00 PM,48,-122,35,18,53
6738,58thStGreenway22ndAve,10/08/2014 06:00:00 PM,48,-122,37,18,55
6739,58thStGreenway22ndAve,10/08/2014 07:00:00 PM,48,-122,38,7,45
6740,58thStGreenway22ndAve,10/08/2014 08:00:00 PM,48,-122,12,5,17
6741,58thStGreenway22ndAve,10/08/2014 09:00:00 PM,48,-122,11,0,11
6742,58thStGreenway22ndAve,10/08/2014 10:00:00 PM,48,-122,6,3,9
6743,58thStGreenway22ndAve,10/08/2014 11:00:00 PM,48,-122,4,0,4
6744,58thStGreenway22ndAve,10/09/2014 12:00:00 AM,48,-122,4,0,4
6745,58thStGreenway22ndAve,10/09/2014 01:00:00 AM,48,-122,3,0,3
6746,58thStGreenway22ndAve,10/09/2014 02:00:00 AM,48,-122,0,0,0
6747,58thStGreenway22ndAve,10/09/2014 03:00:00 AM,48,-122,0,1,1
6748,58thStGreenway22ndAve,10/09/2014 04:00:00 AM,48,-122,0,0,0
6749,58thStGreenway22ndAve,10/09/2014 05:00:00 AM,48,-122,7,2,9
6750,58thStGreenway22ndAve,10/09/2014 06:00:00 AM,48,-122,14,2,16
6751,58thStGreenway22ndAve,10/09/2014 07:00:00 AM,48,-122,32,6,38
6752,58thStGreenway22ndAve,10/09/2014 08:00:00 AM,48,-122,19,5,24
6753,58thStGreenway22ndAve,10/09/2014 09:00:00 AM,48,-122,20,4,24
6754,58thStGreenway22ndAve,10/09/2014 10:00:00 AM,48,-122,23,14,37
6755,58thStGreenway22ndAve,10/09/2014 11:00:00 AM,48,-122,19,11,30
6756,58thStGreenway22ndAve,10/09/2014 12:00:00 PM,48,-122,27,16,43
6757,58thStGreenway22ndAve,10/09/2014 01:00:00 PM,48,-122,20,15,35
6758,58thStGreenway22ndAve,10/09/2014 02:00:00 PM,48,-122,26,14,40
6759,58thStGreenway22ndAve,10/09/2014 03:00:00 PM,48,-122,24,9,33
6760,58thStGreenway22ndAve,10/09/2014 04:00:00 PM,48,-122,27,10,37
6761,58thStGreenway22ndAve,10/09/2014 05:00:00 PM,48,-122,32,9,41
6762,58thStGreenway22ndAve,10/09/2014 06:00:00 PM,48,-122,36,13,49
6763,58thStGreenway22ndAve,10/09/2014 07:00:00 PM,48,-122,24,9,33
6764,58thStGreenway22ndAve,10/09/2014 08:00:00 PM,48,-122,15,8,23
6765,58thStGreenway22ndAve,10/09/2014 09:00:00 PM,48,-122,10,3,13
6766,58thStGreenway22ndAve,10/09/2014 10:00:00 PM,48,-122,10,3,13
6767,58thStGreenway22ndAve,10/09/2014 11:00:00 PM,48,-122,14,1,15
6768,58thStGreenway22ndAve,10/10/2014 12:00:00 AM,48,-122,6,0,6
6769,58thStGreenway22ndAve,10/10/2014 01:00:00 AM,48,-122,3,0,3
6770,58thStGreenway22ndAve,10/10/2014 02:00:00 AM,48,-122,4,0,4
6771,58thStGreenway22ndAve,10/10/2014 03:00:00 AM,48,-122,0,2,2
6772,58thStGreenway22ndAve,10/10/2014 04:00:00 AM,48,-122,0,0,0
6773,58thStGreenway22ndAve,10/10/2014 05:00:00 AM,48,-122,2,1,3
6774,58thStGreenway22ndAve,10/10/2014 06:00:00 AM,48,-122,3,4,7
6775,58thStGreenway22ndAve,10/10/2014 07:00:00 AM,48,-122,17,3,20
6776,58thStGreenway22ndAve,10/10/2014 08:00:00 AM,48,-122,35,9,44
6777,58thStGreenway22ndAve,10/10/2014 09:00:00 AM,48,-122,34,3,37
6778,58thStGreenway22ndAve,10/10/2014 10:00:00 AM,48,-122,31,12,43
6779,58thStGreenway22ndAve,10/10/2014 11:00:00 AM,48,-122,40,12,52
6780,58thStGreenway22ndAve,10/10/2014 12:00:00 PM,48,-122,40,27,67
6781,58thStGreenway22ndAve,10/10/2014 01:00:00 PM,48,-122,33,14,47
6782,58thStGreenway22ndAve,10/10/2014 02:00:00 PM,48,-122,30,10,40
6783,58thStGreenway22ndAve,10/10/2014 03:00:00 PM,48,-122,18,12,30
6784,58thStGreenway22ndAve,10/10/2014 04:00:00 PM,48,-122,39,11,50
6785,58thStGreenway22ndAve,10/10/2014 05:00:00 PM,48,-122,51,13,64
6786,58thStGreenway22ndAve,10/10/2014 06:00:00 PM,48,-122,33,18,51
6787,58thStGreenway22ndAve,10/10/2014 07:00:00 PM,48,-122,26,7,33
6788,58thStGreenway22ndAve,10/10/2014 08:00:00 PM,48,-122,17,3,20
6789,58thStGreenway22ndAve,10/10/2014 09:00:00 PM,48,-122,6,1,7
6790,58thStGreenway22ndAve,10/10/2014 10:00:00 PM,48,-122,10,2,12
6791,58thStGreenway22ndAve,10/10/2014 11:00:00 PM,48,-122,7,1,8
6792,58thStGreenway22ndAve,10/11/2014 12:00:00 AM,48,-122,5,2,7
6793,58thStGreenway22ndAve,10/11/2014 01:00:00 AM,48,-122,0,1,1
6794,58thStGreenway22ndAve,10/11/2014 02:00:00 AM,48,-122,4,0,4
6795,58thStGreenway22ndAve,10/11/2014 03:00:00 AM,48,-122,0,1,1
6796,58thStGreenway22ndAve,10/11/2014 04:00:00 AM,48,-122,3,0,3
6797,58thStGreenway22ndAve,10/11/2014 05:00:00 AM,48,-122,3,0,3
6798,58thStGreenway22ndAve,10/11/2014 06:00:00 AM,48,-122,5,0,5
6799,58thStGreenway22ndAve,10/11/2014 07:00:00 AM,48,-122,7,1,8
6800,58thStGreenway22ndAve,10/11/2014 08:00:00 AM,48,-122,13,3,16
6801,58thStGreenway22ndAve,10/11/2014 09:00:00 AM,48,-122,28,15,43
6802,58thStGreenway22ndAve,10/11/2014 10:00:00 AM,48,-122,32,18,50
6803,58thStGreenway22ndAve,10/11/2014 11:00:00 AM,48,-122,43,24,67
6804,58thStGreenway22ndAve,10/11/2014 12:00:00 PM,48,-122,42,19,61
6805,58thStGreenway22ndAve,10/11/2014 01:00:00 PM,48,-122,38,17,55
6806,58thStGreenway22ndAve,10/11/2014 02:00:00 PM,48,-122,53,17,70
6807,58thStGreenway22ndAve,10/11/2014 03:00:00 PM,48,-122,37,17,54
6808,58thStGreenway22ndAve,10/11/2014 04:00:00 PM,48,-122,24,3,27
6809,58thStGreenway22ndAve,10/11/2014 05:00:00 PM,48,-122,42,13,55
6810,58thStGreenway22ndAve,10/11/2014 06:00:00 PM,48,-122,40,14,54
6811,58thStGreenway22ndAve,10/11/2014 07:00:00 PM,48,-122,27,12,39
6812,58thStGreenway22ndAve,10/11/2014 08:00:00 PM,48,-122,14,6,20
6813,58thStGreenway22ndAve,10/11/2014 09:00:00 PM,48,-122,12,11,23
6814,58thStGreenway22ndAve,10/11/2014 10:00:00 PM,48,-122,11,5,16
6815,58thStGreenway22ndAve,10/11/2014 11:00:00 PM,48,-122,15,3,18
6816,58thStGreenway22ndAve,10/12/2014 12:00:00 AM,48,-122,9,0,9
6817,58thStGreenway22ndAve,10/12/2014 01:00:00 AM,48,-122,10,0,10
6818,58thStGreenway22ndAve,10/12/2014 02:00:00 AM,48,-122,4,0,4
6819,58thStGreenway22ndAve,10/12/2014 03:00:00 AM,48,-122,0,0,0
6820,58thStGreenway22ndAve,10/12/2014 04:00:00 AM,48,-122,0,0,0
6821,58thStGreenway22ndAve,10/12/2014 05:00:00 AM,48,-122,0,0,0
6822,58thStGreenway22ndAve,10/12/2014 06:00:00 AM,48,-122,5,0,5
6823,58thStGreenway22ndAve,10/12/2014 07:00:00 AM,48,-122,3,1,4
6824,58thStGreenway22ndAve,10/12/2014 08:00:00 AM,48,-122,9,6,15
6825,58thStGreenway22ndAve,10/12/2014 09:00:00 AM,48,-122,17,9,26
6826,58thStGreenway22ndAve,10/12/2014 10:00:00 AM,48,-122,26,17,43
6827,58thStGreenway22ndAve,10/12/2014 11:00:00 AM,48,-122,49,12,61
6828,58thStGreenway22ndAve,10/12/2014 12:00:00 PM,48,-122,50,15,65
6829,58thStGreenway22ndAve,10/12/2014 01:00:00 PM,48,-122,41,12,53
6830,58thStGreenway22ndAve,10/12/2014 02:00:00 PM,48,-122,32,12,44
6831,58thStGreenway22ndAve,10/12/2014 03:00:00 PM,48,-122,28,10,38
6832,58thStGreenway22ndAve,10/12/2014 04:00:00 PM,48,-122,28,5,33
6833,58thStGreenway22ndAve,10/12/2014 05:00:00 PM,48,-122,26,14,40
6834,58thStGreenway22ndAve,10/12/2014 06:00:00 PM,48,-122,21,6,27
6835,58thStGreenway22ndAve,10/12/2014 07:00:00 PM,48,-122,19,3,22
6836,58thStGreenway22ndAve,10/12/2014 08:00:00 PM,48,-122,14,3,17
6837,58thStGreenway22ndAve,10/12/2014 09:00:00 PM,48,-122,7,5,12
6838,58thStGreenway22ndAve,10/12/2014 10:00:00 PM,48,-122,6,3,9
6839,58thStGreenway22ndAve,10/12/2014 11:00:00 PM,48,-122,2,0,2
6840,58thStGreenway22ndAve,10/13/2014 12:00:00 AM,48,-122,4,0,4
6841,58thStGreenway22ndAve,10/13/2014 01:00:00 AM,48,-122,2,0,2
6842,58thStGreenway22ndAve,10/13/2014 02:00:00 AM,48,-122,4,0,4
6843,58thStGreenway22ndAve,10/13/2014 03:00:00 AM,48,-122,2,0,2
6844,58thStGreenway22ndAve,10/13/2014 04:00:00 AM,48,-122,0,0,0
6845,58thStGreenway22ndAve,10/13/2014 05:00:00 AM,48,-122,0,1,1
6846,58thStGreenway22ndAve,10/13/2014 06:00:00 AM,48,-122,13,3,16
6847,58thStGreenway22ndAve,10/13/2014 07:00:00 AM,48,-122,23,7,30
6848,58thStGreenway22ndAve,10/13/2014 08:00:00 AM,48,-122,24,14,38
6849,58thStGreenway22ndAve,10/13/2014 09:00:00 AM,48,-122,12,11,23
6850,58thStGreenway22ndAve,10/13/2014 10:00:00 AM,48,-122,23,5,28
6851,58thStGreenway22ndAve,10/13/2014 11:00:00 AM,48,-122,24,8,32
6852,58thStGreenway22ndAve,10/13/2014 12:00:00 PM,48,-122,31,17,48
6853,58thStGreenway22ndAve,10/13/2014 01:00:00 PM,48,-122,23,17,40
6854,58thStGreenway22ndAve,10/13/2014 02:00:00 PM,48,-122,35,10,45
6855,58thStGreenway22ndAve,10/13/2014 03:00:00 PM,48,-122,29,15,44
6856,58thStGreenway22ndAve,10/13/2014 04:00:00 PM,48,-122,30,7,37
6857,58thStGreenway22ndAve,10/13/2014 05:00:00 PM,48,-122,35,28,63
6858,58thStGreenway22ndAve,10/13/2014 06:00:00 PM,48,-122,18,14,32
6859,58thStGreenway22ndAve,10/13/2014 07:00:00 PM,48,-122,30,8,38
6860,58thStGreenway22ndAve,10/13/2014 08:00:00 PM,48,-122,12,1,13
6861,58thStGreenway22ndAve,10/13/2014 09:00:00 PM,48,-122,15,1,16
6862,58thStGreenway22ndAve,10/13/2014 10:00:00 PM,48,-122,12,2,14
6863,58thStGreenway22ndAve,10/13/2014 11:00:00 PM,48,-122,4,0,4
6864,58thStGreenway22ndAve,10/14/2014 12:00:00 AM,48,-122,2,0,2
6865,58thStGreenway22ndAve,10/14/2014 01:00:00 AM,48,-122,0,1,1
6866,58thStGreenway22ndAve,10/14/2014 02:00:00 AM,48,-122,6,0,6
6867,58thStGreenway22ndAve,10/14/2014 03:00:00 AM,48,-122,0,0,0
6868,58thStGreenway22ndAve,10/14/2014 04:00:00 AM,48,-122,0,0,0
6869,58thStGreenway22ndAve,10/14/2014 05:00:00 AM,48,-122,0,1,1
6870,58thStGreenway22ndAve,10/14/2014 06:00:00 AM,48,-122,8,5,13
6871,58thStGreenway22ndAve,10/14/2014 07:00:00 AM,48,-122,28,10,38
6872,58thStGreenway22ndAve,10/14/2014 08:00:00 AM,48,-122,27,13,40
6873,58thStGreenway22ndAve,10/14/2014 09:00:00 AM,48,-122,27,20,47
6874,58thStGreenway22ndAve,10/14/2014 10:00:00 AM,48,-122,12,9,21
6875,58thStGreenway22ndAve,10/14/2014 11:00:00 AM,48,-122,13,11,24
6876,58thStGreenway22ndAve,10/14/2014 12:00:00 PM,48,-122,27,17,44
6877,58thStGreenway22ndAve,10/14/2014 01:00:00 PM,48,-122,21,12,33
6878,58thStGreenway22ndAve,10/14/2014 02:00:00 PM,48,-122,27,12,39
6879,58thStGreenway22ndAve,10/14/2014 03:00:00 PM,48,-122,19,12,31
6880,58thStGreenway22ndAve,10/14/2014 04:00:00 PM,48,-122,14,14,28
6881,58thStGreenway22ndAve,10/14/2014 05:00:00 PM,48,-122,34,18,52
6882,58thStGreenway22ndAve,10/14/2014 06:00:00 PM,48,-122,31,16,47
6883,58thStGreenway22ndAve,10/14/2014 07:00:00 PM,48,-122,24,8,32
6884,58thStGreenway22ndAve,10/14/2014 08:00:00 PM,48,-122,13,13,26
6885,58thStGreenway22ndAve,10/14/2014 09:00:00 PM,48,-122,4,1,5
6886,58thStGreenway22ndAve,10/14/2014 10:00:00 PM,48,-122,12,2,14
6887,58thStGreenway22ndAve,10/14/2014 11:00:00 PM,48,-122,4,1,5
6888,58thStGreenway22ndAve,10/15/2014 12:00:00 AM,48,-122,1,1,2
6889,58thStGreenway22ndAve,10/15/2014 01:00:00 AM,48,-122,0,0,0
6890,58thStGreenway22ndAve,10/15/2014 02:00:00 AM,48,-122,2,3,5
6891,58thStGreenway22ndAve,10/15/2014 03:00:00 AM,48,-122,0,1,1
6892,58thStGreenway22ndAve,10/15/2014 04:00:00 AM,48,-122,0,0,0
6893,58thStGreenway22ndAve,10/15/2014 05:00:00 AM,48,-122,2,1,3
6894,58thStGreenway22ndAve,10/15/2014 06:00:00 AM,48,-122,10,2,12
6895,58thStGreenway22ndAve,10/15/2014 07:00:00 AM,48,-122,22,2,24
6896,58thStGreenway22ndAve,10/15/2014 08:00:00 AM,48,-122,39,17,56
6897,58thStGreenway22ndAve,10/15/2014 09:00:00 AM,48,-122,36,13,49
6898,58thStGreenway22ndAve,10/15/2014 10:00:00 AM,48,-122,35,5,40
6899,58thStGreenway22ndAve,10/15/2014 11:00:00 AM,48,-122,29,6,35
6900,58thStGreenway22ndAve,10/15/2014 12:00:00 PM,48,-122,22,19,41
6901,58thStGreenway22ndAve,10/15/2014 01:00:00 PM,48,-122,33,10,43
6902,58thStGreenway22ndAve,10/15/2014 02:00:00 PM,48,-122,33,15,48
6903,58thStGreenway22ndAve,10/15/2014 03:00:00 PM,48,-122,32,9,41
6904,58thStGreenway22ndAve,10/15/2014 04:00:00 PM,48,-122,33,11,44
6905,58thStGreenway22ndAve,10/15/2014 05:00:00 PM,48,-122,26,12,38
6906,58thStGreenway22ndAve,10/15/2014 06:00:00 PM,48,-122,22,18,40
6907,58thStGreenway22ndAve,10/15/2014 07:00:00 PM,48,-122,18,10,28
6908,58thStGreenway22ndAve,10/15/2014 08:00:00 PM,48,-122,8,7,15
6909,58thStGreenway22ndAve,10/15/2014 09:00:00 PM,48,-122,5,5,10
6910,58thStGreenway22ndAve,10/15/2014 10:00:00 PM,48,-122,1,0,1
6911,58thStGreenway22ndAve,10/15/2014 11:00:00 PM,48,-122,5,2,7
6912,58thStGreenway22ndAve,10/16/2014 12:00:00 AM,48,-122,5,0,5
6913,58thStGreenway22ndAve,10/16/2014 01:00:00 AM,48,-122,1,0,1
6914,58thStGreenway22ndAve,10/16/2014 02:00:00 AM,48,-122,0,0,0
6915,58thStGreenway22ndAve,10/16/2014 03:00:00 AM,48,-122,0,0,0
6916,58thStGreenway22ndAve,10/16/2014 04:00:00 AM,48,-122,2,0,2
6917,58thStGreenway22ndAve,10/16/2014 05:00:00 AM,48,-122,2,0,2
6918,58thStGreenway22ndAve,10/16/2014 06:00:00 AM,48,-122,15,2,17
6919,58thStGreenway22ndAve,10/16/2014 07:00:00 AM,48,-122,19,5,24
6920,58thStGreenway22ndAve,10/16/2014 08:00:00 AM,48,-122,28,14,42
6921,58thStGreenway22ndAve,10/16/2014 09:00:00 AM,48,-122,13,4,17
6922,58thStGreenway22ndAve,10/16/2014 10:00:00 AM,48,-122,17,13,30
6923,58thStGreenway22ndAve,10/16/2014 11:00:00 AM,48,-122,27,9,36
6924,58thStGreenway22ndAve,10/16/2014 12:00:00 PM,48,-122,32,12,44
6925,58thStGreenway22ndAve,10/16/2014 01:00:00 PM,48,-122,33,20,53
6926,58thStGreenway22ndAve,10/16/2014 02:00:00 PM,48,-122,18,18,36
6927,58thStGreenway22ndAve,10/16/2014 03:00:00 PM,48,-122,24,20,44
6928,58thStGreenway22ndAve,10/16/2014 04:00:00 PM,48,-122,33,14,47
6929,58thStGreenway22ndAve,10/16/2014 05:00:00 PM,48,-122,33,15,48
6930,58thStGreenway22ndAve,10/16/2014 06:00:00 PM,48,-122,46,12,58
6931,58thStGreenway22ndAve,10/16/2014 07:00:00 PM,48,-122,41,15,56
6932,58thStGreenway22ndAve,10/16/2014 08:00:00 PM,48,-122,21,8,29
6933,58thStGreenway22ndAve,10/16/2014 09:00:00 PM,48,-122,10,2,12
6934,58thStGreenway22ndAve,10/16/2014 10:00:00 PM,48,-122,8,0,8
6935,58thStGreenway22ndAve,10/16/2014 11:00:00 PM,48,-122,3,0,3
6936,58thStGreenway22ndAve,10/17/2014 12:00:00 AM,48,-122,5,2,7
6937,58thStGreenway22ndAve,10/17/2014 01:00:00 AM,48,-122,0,0,0
6938,58thStGreenway22ndAve,10/17/2014 02:00:00 AM,48,-122,2,2,4
6939,58thStGreenway22ndAve,10/17/2014 03:00:00 AM,48,-122,2,1,3
6940,58thStGreenway22ndAve,10/17/2014 04:00:00 AM,48,-122,0,0,0
6941,58thStGreenway22ndAve,10/17/2014 05:00:00 AM,48,-122,4,3,7
6942,58thStGreenway22ndAve,10/17/2014 06:00:00 AM,48,-122,15,2,17
6943,58thStGreenway22ndAve,10/17/2014 07:00:00 AM,48,-122,12,8,20
6944,58thStGreenway22ndAve,10/17/2014 08:00:00 AM,48,-122,22,7,29
6945,58thStGreenway22ndAve,10/17/2014 09:00:00 AM,48,-122,42,8,50
6946,58thStGreenway22ndAve,10/17/2014 10:00:00 AM,48,-122,26,8,34
6947,58thStGreenway22ndAve,10/17/2014 11:00:00 AM,48,-122,37,5,42
6948,58thStGreenway22ndAve,10/17/2014 12:00:00 PM,48,-122,19,8,27
6949,58thStGreenway22ndAve,10/17/2014 01:00:00 PM,48,-122,36,10,46
6950,58thStGreenway22ndAve,10/17/2014 02:00:00 PM,48,-122,42,13,55
6951,58thStGreenway22ndAve,10/17/2014 03:00:00 PM,48,-122,21,9,30
6952,58thStGreenway22ndAve,10/17/2014 04:00:00 PM,48,-122,34,13,47
6953,58thStGreenway22ndAve,10/17/2014 05:00:00 PM,48,-122,37,17,54
6954,58thStGreenway22ndAve,10/17/2014 06:00:00 PM,48,-122,40,28,68
6955,58thStGreenway22ndAve,10/17/2014 07:00:00 PM,48,-122,27,8,35
6956,58thStGreenway22ndAve,10/17/2014 08:00:00 PM,48,-122,31,7,38
6957,58thStGreenway22ndAve,10/17/2014 09:00:00 PM,48,-122,17,6,23
6958,58thStGreenway22ndAve,10/17/2014 10:00:00 PM,48,-122,5,0,5
6959,58thStGreenway22ndAve,10/17/2014 11:00:00 PM,48,-122,3,0,3
6960,58thStGreenway22ndAve,10/18/2014 12:00:00 AM,48,-122,4,0,4
6961,58thStGreenway22ndAve,10/18/2014 01:00:00 AM,48,-122,1,0,1
6962,58thStGreenway22ndAve,10/18/2014 02:00:00 AM,48,-122,2,1,3
6963,58thStGreenway22ndAve,10/18/2014 03:00:00 AM,48,-122,0,0,0
6964,58thStGreenway22ndAve,10/18/2014 04:00:00 AM,48,-122,0,0,0
6965,58thStGreenway22ndAve,10/18/2014 05:00:00 AM,48,-122,4,0,4
6966,58thStGreenway22ndAve,10/18/2014 06:00:00 AM,48,-122,4,0,4
6967,58thStGreenway22ndAve,10/18/2014 07:00:00 AM,48,-122,11,1,12
6968,58thStGreenway22ndAve,10/18/2014 08:00:00 AM,48,-122,15,5,20
6969,58thStGreenway22ndAve,10/18/2014 09:00:00 AM,48,-122,38,9,47
6970,58thStGreenway22ndAve,10/18/2014 10:00:00 AM,48,-122,44,20,64
6971,58thStGreenway22ndAve,10/18/2014 11:00:00 AM,48,-122,54,31,85
6972,58thStGreenway22ndAve,10/18/2014 12:00:00 PM,48,-122,57,28,85
6973,58thStGreenway22ndAve,10/18/2014 01:00:00 PM,48,-122,40,18,58
6974,58thStGreenway22ndAve,10/18/2014 02:00:00 PM,48,-122,31,18,49
6975,58thStGreenway22ndAve,10/18/2014 03:00:00 PM,48,-122,35,22,57
6976,58thStGreenway22ndAve,10/18/2014 04:00:00 PM,48,-122,37,11,48
6977,58thStGreenway22ndAve,10/18/2014 05:00:00 PM,48,-122,48,20,68
6978,58thStGreenway22ndAve,10/18/2014 06:00:00 PM,48,-122,43,13,56
6979,58thStGreenway22ndAve,10/18/2014 07:00:00 PM,48,-122,15,4,19
6980,58thStGreenway22ndAve,10/18/2014 08:00:00 PM,48,-122,23,10,33
6981,58thStGreenway22ndAve,10/18/2014 09:00:00 PM,48,-122,14,5,19
6982,58thStGreenway22ndAve,10/18/2014 10:00:00 PM,48,-122,9,5,14
6983,58thStGreenway22ndAve,10/18/2014 11:00:00 PM,48,-122,6,1,7
6984,58thStGreenway22ndAve,10/19/2014 12:00:00 AM,48,-122,1,1,2
6985,58thStGreenway22ndAve,10/19/2014 01:00:00 AM,48,-122,2,0,2
6986,58thStGreenway22ndAve,10/19/2014 02:00:00 AM,48,-122,3,0,3
6987,58thStGreenway22ndAve,10/19/2014 03:00:00 AM,48,-122,0,0,0
6988,58thStGreenway22ndAve,10/19/2014 04:00:00 AM,48,-122,0,0,0
6989,58thStGreenway22ndAve,10/19/2014 05:00:00 AM,48,-122,4,0,4
6990,58thStGreenway22ndAve,10/19/2014 06:00:00 AM,48,-122,6,0,6
6991,58thStGreenway22ndAve,10/19/2014 07:00:00 AM,48,-122,4,3,7
6992,58thStGreenway22ndAve,10/19/2014 08:00:00 AM,48,-122,2,10,12
6993,58thStGreenway22ndAve,10/19/2014 09:00:00 AM,48,-122,22,7,29
6994,58thStGreenway22ndAve,10/19/2014 10:00:00 AM,48,-122,31,17,48
6995,58thStGreenway22ndAve,10/19/2014 11:00:00 AM,48,-122,41,13,54
6996,58thStGreenway22ndAve,10/19/2014 12:00:00 PM,48,-122,48,20,68
6997,58thStGreenway22ndAve,10/19/2014 01:00:00 PM,48,-122,63,32,95
6998,58thStGreenway22ndAve,10/19/2014 02:00:00 PM,48,-122,48,19,67
6999,58thStGreenway22ndAve,10/19/2014 03:00:00 PM,48,-122,37,14,51
7000,58thStGreenway22ndAve,10/19/2014 04:00:00 PM,48,-122,18,16,34
7001,58thStGreenway22ndAve,10/19/2014 05:00:00 PM,48,-122,33,12,45
7002,58thStGreenway22ndAve,10/19/2014 06:00:00 PM,48,-122,26,9,35
7003,58thStGreenway22ndAve,10/19/2014 07:00:00 PM,48,-122,12,5,17
7004,58thStGreenway22ndAve,10/19/2014 08:00:00 PM,48,-122,11,5,16
7005,58thStGreenway22ndAve,10/19/2014 09:00:00 PM,48,-122,8,0,8
7006,58thStGreenway22ndAve,10/19/2014 10:00:00 PM,48,-122,2,0,2
7007,58thStGreenway22ndAve,10/19/2014 11:00:00 PM,48,-122,3,2,5
7008,58thStGreenway22ndAve,10/20/2014 12:00:00 AM,48,-122,0,0,0
7009,58thStGreenway22ndAve,10/20/2014 01:00:00 AM,48,-122,5,0,5
7010,58thStGreenway22ndAve,10/20/2014 02:00:00 AM,48,-122,0,2,2
7011,58thStGreenway22ndAve,10/20/2014 03:00:00 AM,48,-122,0,0,0
7012,58thStGreenway22ndAve,10/20/2014 04:00:00 AM,48,-122,0,0,0
7013,58thStGreenway22ndAve,10/20/2014 05:00:00 AM,48,-122,0,1,1
7014,58thStGreenway22ndAve,10/20/2014 06:00:00 AM,48,-122,7,4,11
7015,58thStGreenway22ndAve,10/20/2014 07:00:00 AM,48,-122,11,9,20
7016,58thStGreenway22ndAve,10/20/2014 08:00:00 AM,48,-122,10,7,17
7017,58thStGreenway22ndAve,10/20/2014 09:00:00 AM,48,-122,21,10,31
7018,58thStGreenway22ndAve,10/20/2014 10:00:00 AM,48,-122,14,4,18
7019,58thStGreenway22ndAve,10/20/2014 11:00:00 AM,48,-122,21,12,33
7020,58thStGreenway22ndAve,10/20/2014 12:00:00 PM,48,-122,27,17,44
7021,58thStGreenway22ndAve,10/20/2014 01:00:00 PM,48,-122,25,8,33
7022,58thStGreenway22ndAve,10/20/2014 02:00:00 PM,48,-122,36,10,46
7023,58thStGreenway22ndAve,10/20/2014 03:00:00 PM,48,-122,47,14,61
7024,58thStGreenway22ndAve,10/20/2014 04:00:00 PM,48,-122,24,19,43
7025,58thStGreenway22ndAve,10/20/2014 05:00:00 PM,48,-122,20,17,37
7026,58thStGreenway22ndAve,10/20/2014 06:00:00 PM,48,-122,25,19,44
7027,58thStGreenway22ndAve,10/20/2014 07:00:00 PM,48,-122,31,13,44
7028,58thStGreenway22ndAve,10/20/2014 08:00:00 PM,48,-122,15,6,21
7029,58thStGreenway22ndAve,10/20/2014 09:00:00 PM,48,-122,8,0,8
7030,58thStGreenway22ndAve,10/20/2014 10:00:00 PM,48,-122,15,4,19
7031,58thStGreenway22ndAve,10/20/2014 11:00:00 PM,48,-122,6,0,6
7032,58thStGreenway22ndAve,10/21/2014 12:00:00 AM,48,-122,0,0,0
7033,58thStGreenway22ndAve,10/21/2014 01:00:00 AM,48,-122,0,1,1
7034,58thStGreenway22ndAve,10/21/2014 02:00:00 AM,48,-122,0,0,0
7035,58thStGreenway22ndAve,10/21/2014 03:00:00 AM,48,-122,0,0,0
7036,58thStGreenway22ndAve,10/21/2014 04:00:00 AM,48,-122,2,1,3
7037,58thStGreenway22ndAve,10/21/2014 05:00:00 AM,48,-122,2,1,3
7038,58thStGreenway22ndAve,10/21/2014 06:00:00 AM,48,-122,5,2,7
7039,58thStGreenway22ndAve,10/21/2014 07:00:00 AM,48,-122,21,3,24
7040,58thStGreenway22ndAve,10/21/2014 08:00:00 AM,48,-122,30,11,41
7041,58thStGreenway22ndAve,10/21/2014 09:00:00 AM,48,-122,31,4,35
7042,58thStGreenway22ndAve,10/21/2014 10:00:00 AM,48,-122,14,15,29
7043,58thStGreenway22ndAve,10/21/2014 11:00:00 AM,48,-122,34,11,45
7044,58thStGreenway22ndAve,10/21/2014 12:00:00 PM,48,-122,35,18,53
7045,58thStGreenway22ndAve,10/21/2014 01:00:00 PM,48,-122,28,9,37
7046,58thStGreenway22ndAve,10/21/2014 02:00:00 PM,48,-122,32,22,54
7047,58thStGreenway22ndAve,10/21/2014 03:00:00 PM,48,-122,37,8,45
7048,58thStGreenway22ndAve,10/21/2014 04:00:00 PM,48,-122,36,18,54
7049,58thStGreenway22ndAve,10/21/2014 05:00:00 PM,48,-122,34,17,51
7050,58thStGreenway22ndAve,10/21/2014 06:00:00 PM,48,-122,36,12,48
7051,58thStGreenway22ndAve,10/21/2014 07:00:00 PM,48,-122,27,1,28
7052,58thStGreenway22ndAve,10/21/2014 08:00:00 PM,48,-122,16,1,17
7053,58thStGreenway22ndAve,10/21/2014 09:00:00 PM,48,-122,11,3,14
7054,58thStGreenway22ndAve,10/21/2014 10:00:00 PM,48,-122,8,4,12
7055,58thStGreenway22ndAve,10/21/2014 11:00:00 PM,48,-122,2,6,8
7056,58thStGreenway22ndAve,10/22/2014 12:00:00 AM,48,-122,1,1,2
7057,58thStGreenway22ndAve,10/22/2014 01:00:00 AM,48,-122,1,0,1
7058,58thStGreenway22ndAve,10/22/2014 02:00:00 AM,48,-122,0,0,0
7059,58thStGreenway22ndAve,10/22/2014 03:00:00 AM,48,-122,0,0,0
7060,58thStGreenway22ndAve,10/22/2014 04:00:00 AM,48,-122,0,0,0
7061,58thStGreenway22ndAve,10/22/2014 05:00:00 AM,48,-122,1,0,1
7062,58thStGreenway22ndAve,10/22/2014 06:00:00 AM,48,-122,9,6,15
7063,58thStGreenway22ndAve,10/22/2014 07:00:00 AM,48,-122,15,10,25
7064,58thStGreenway22ndAve,10/22/2014 08:00:00 AM,48,-122,40,11,51
7065,58thStGreenway22ndAve,10/22/2014 09:00:00 AM,48,-122,42,13,55
7066,58thStGreenway22ndAve,10/22/2014 10:00:00 AM,48,-122,21,15,36
7067,58thStGreenway22ndAve,10/22/2014 11:00:00 AM,48,-122,30,10,40
7068,58thStGreenway22ndAve,10/22/2014 12:00:00 PM,48,-122,32,26,58
7069,58thStGreenway22ndAve,10/22/2014 01:00:00 PM,48,-122,27,7,34
7070,58thStGreenway22ndAve,10/22/2014 02:00:00 PM,48,-122,27,5,32
7071,58thStGreenway22ndAve,10/22/2014 03:00:00 PM,48,-122,35,20,55
7072,58thStGreenway22ndAve,10/22/2014 04:00:00 PM,48,-122,33,18,51
7073,58thStGreenway22ndAve,10/22/2014 05:00:00 PM,48,-122,41,18,59
7074,58thStGreenway22ndAve,10/22/2014 06:00:00 PM,48,-122,30,13,43
7075,58thStGreenway22ndAve,10/22/2014 07:00:00 PM,48,-122,21,13,34
7076,58thStGreenway22ndAve,10/22/2014 08:00:00 PM,48,-122,10,12,22
7077,58thStGreenway22ndAve,10/22/2014 09:00:00 PM,48,-122,10,6,16
7078,58thStGreenway22ndAve,10/22/2014 10:00:00 PM,48,-122,6,4,10
7079,58thStGreenway22ndAve,10/22/2014 11:00:00 PM,48,-122,10,0,10
7080,58thStGreenway22ndAve,10/23/2014 12:00:00 AM,48,-122,2,0,2
7081,58thStGreenway22ndAve,10/23/2014 01:00:00 AM,48,-122,0,0,0
7082,58thStGreenway22ndAve,10/23/2014 02:00:00 AM,48,-122,0,0,0
7083,58thStGreenway22ndAve,10/23/2014 03:00:00 AM,48,-122,0,0,0
7084,58thStGreenway22ndAve,10/23/2014 04:00:00 AM,48,-122,0,3,3
7085,58thStGreenway22ndAve,10/23/2014 05:00:00 AM,48,-122,0,0,0
7086,58thStGreenway22ndAve,10/23/2014 06:00:00 AM,48,-122,16,11,27
7087,58thStGreenway22ndAve,10/23/2014 07:00:00 AM,48,-122,25,3,28
7088,58thStGreenway22ndAve,10/23/2014 08:00:00 AM,48,-122,28,5,33
7089,58thStGreenway22ndAve,10/23/2014 09:00:00 AM,48,-122,25,1,26
7090,58thStGreenway22ndAve,10/23/2014 10:00:00 AM,48,-122,23,21,44
7091,58thStGreenway22ndAve,10/23/2014 11:00:00 AM,48,-122,35,14,49
7092,58thStGreenway22ndAve,10/23/2014 12:00:00 PM,48,-122,45,17,62
7093,58thStGreenway22ndAve,10/23/2014 01:00:00 PM,48,-122,18,5,23
7094,58thStGreenway22ndAve,10/23/2014 02:00:00 PM,48,-122,43,12,55
7095,58thStGreenway22ndAve,10/23/2014 03:00:00 PM,48,-122,27,7,34
7096,58thStGreenway22ndAve,10/23/2014 04:00:00 PM,48,-122,28,11,39
7097,58thStGreenway22ndAve,10/23/2014 05:00:00 PM,48,-122,35,18,53
7098,58thStGreenway22ndAve,10/23/2014 06:00:00 PM,48,-122,31,8,39
7099,58thStGreenway22ndAve,10/23/2014 07:00:00 PM,48,-122,33,8,41
7100,58thStGreenway22ndAve,10/23/2014 08:00:00 PM,48,-122,27,0,27
7101,58thStGreenway22ndAve,10/23/2014 09:00:00 PM,48,-122,12,2,14
7102,58thStGreenway22ndAve,10/23/2014 10:00:00 PM,48,-122,9,3,12
7103,58thStGreenway22ndAve,10/23/2014 11:00:00 PM,48,-122,2,0,2
7104,58thStGreenway22ndAve,10/24/2014 12:00:00 AM,48,-122,3,0,3
7105,58thStGreenway22ndAve,10/24/2014 01:00:00 AM,48,-122,6,2,8
7106,58thStGreenway22ndAve,10/24/2014 02:00:00 AM,48,-122,3,0,3
7107,58thStGreenway22ndAve,10/24/2014 03:00:00 AM,48,-122,0,0,0
7108,58thStGreenway22ndAve,10/24/2014 04:00:00 AM,48,-122,0,0,0
7109,58thStGreenway22ndAve,10/24/2014 05:00:00 AM,48,-122,3,1,4
7110,58thStGreenway22ndAve,10/24/2014 06:00:00 AM,48,-122,10,1,11
7111,58thStGreenway22ndAve,10/24/2014 07:00:00 AM,48,-122,25,5,30
7112,58thStGreenway22ndAve,10/24/2014 08:00:00 AM,48,-122,33,17,50
7113,58thStGreenway22ndAve,10/24/2014 09:00:00 AM,48,-122,57,9,66
7114,58thStGreenway22ndAve,10/24/2014 10:00:00 AM,48,-122,45,11,56
7115,58thStGreenway22ndAve,10/24/2014 11:00:00 AM,48,-122,50,18,68
7116,58thStGreenway22ndAve,10/24/2014 12:00:00 PM,48,-122,65,31,96
7117,58thStGreenway22ndAve,10/24/2014 01:00:00 PM,48,-122,49,22,71
7118,58thStGreenway22ndAve,10/24/2014 02:00:00 PM,48,-122,64,24,88
7119,58thStGreenway22ndAve,10/24/2014 03:00:00 PM,48,-122,45,17,62
7120,58thStGreenway22ndAve,10/24/2014 04:00:00 PM,48,-122,50,15,65
7121,58thStGreenway22ndAve,10/24/2014 05:00:00 PM,48,-122,33,14,47
7122,58thStGreenway22ndAve,10/24/2014 06:00:00 PM,48,-122,47,23,70
7123,58thStGreenway22ndAve,10/24/2014 07:00:00 PM,48,-122,36,6,42
7124,58thStGreenway22ndAve,10/24/2014 08:00:00 PM,48,-122,20,4,24
7125,58thStGreenway22ndAve,10/24/2014 09:00:00 PM,48,-122,15,8,23
7126,58thStGreenway22ndAve,10/24/2014 10:00:00 PM,48,-122,6,5,11
7127,58thStGreenway22ndAve,10/24/2014 11:00:00 PM,48,-122,10,1,11
7128,58thStGreenway22ndAve,10/25/2014 12:00:00 AM,48,-122,7,0,7
7129,58thStGreenway22ndAve,10/25/2014 01:00:00 AM,48,-122,9,0,9
7130,58thStGreenway22ndAve,10/25/2014 02:00:00 AM,48,-122,1,0,1
7131,58thStGreenway22ndAve,10/25/2014 03:00:00 AM,48,-122,2,2,4
7132,58thStGreenway22ndAve,10/25/2014 04:00:00 AM,48,-122,0,0,0
7133,58thStGreenway22ndAve,10/25/2014 05:00:00 AM,48,-122,2,0,2
7134,58thStGreenway22ndAve,10/25/2014 06:00:00 AM,48,-122,2,2,4
7135,58thStGreenway22ndAve,10/25/2014 07:00:00 AM,48,-122,6,3,9
7136,58thStGreenway22ndAve,10/25/2014 08:00:00 AM,48,-122,12,4,16
7137,58thStGreenway22ndAve,10/25/2014 09:00:00 AM,48,-122,24,11,35
7138,58thStGreenway22ndAve,10/25/2014 10:00:00 AM,48,-122,19,22,41
7139,58thStGreenway22ndAve,10/25/2014 11:00:00 AM,48,-122,34,22,56
7140,58thStGreenway22ndAve,10/25/2014 12:00:00 PM,48,-122,56,28,84
7141,58thStGreenway22ndAve,10/25/2014 01:00:00 PM,48,-122,44,23,67
7142,58thStGreenway22ndAve,10/25/2014 02:00:00 PM,48,-122,40,39,79
7143,58thStGreenway22ndAve,10/25/2014 03:00:00 PM,48,-122,27,21,48
7144,58thStGreenway22ndAve,10/25/2014 04:00:00 PM,48,-122,53,22,75
7145,58thStGreenway22ndAve,10/25/2014 05:00:00 PM,48,-122,,,
7146,58thStGreenway22ndAve,10/25/2014 06:00:00 PM,48,-122,57,31,88
7147,58thStGreenway22ndAve,10/25/2014 07:00:00 PM,48,-122,15,14,29
7148,58thStGreenway22ndAve,10/25/2014 08:00:00 PM,48,-122,21,4,25
7149,58thStGreenway22ndAve,10/25/2014 09:00:00 PM,48,-122,13,7,20
7150,58thStGreenway22ndAve,10/25/2014 10:00:00 PM,48,-122,10,0,10
7151,58thStGreenway22ndAve,10/25/2014 11:00:00 PM,48,-122,6,1,7
7152,58thStGreenway22ndAve,10/26/2014 12:00:00 AM,48,-122,8,6,14
7153,58thStGreenway22ndAve,10/26/2014 01:00:00 AM,48,-122,6,0,6
7154,58thStGreenway22ndAve,10/26/2014 02:00:00 AM,48,-122,4,0,4
7155,58thStGreenway22ndAve,10/26/2014 03:00:00 AM,48,-122,2,0,2
7156,58thStGreenway22ndAve,10/26/2014 04:00:00 AM,48,-122,0,0,0
7157,58thStGreenway22ndAve,10/26/2014 05:00:00 AM,48,-122,2,0,2
7158,58thStGreenway22ndAve,10/26/2014 06:00:00 AM,48,-122,2,1,3
7159,58thStGreenway22ndAve,10/26/2014 07:00:00 AM,48,-122,5,0,5
7160,58thStGreenway22ndAve,10/26/2014 08:00:00 AM,48,-122,12,4,16
7161,58thStGreenway22ndAve,10/26/2014 09:00:00 AM,48,-122,24,5,29
7162,58thStGreenway22ndAve,10/26/2014 10:00:00 AM,48,-122,44,18,62
7163,58thStGreenway22ndAve,10/26/2014 11:00:00 AM,48,-122,36,18,54
7164,58thStGreenway22ndAve,10/26/2014 12:00:00 PM,48,-122,25,33,58
7165,58thStGreenway22ndAve,10/26/2014 01:00:00 PM,48,-122,50,26,76
7166,58thStGreenway22ndAve,10/26/2014 02:00:00 PM,48,-122,47,21,68
7167,58thStGreenway22ndAve,10/26/2014 03:00:00 PM,48,-122,30,14,44
7168,58thStGreenway22ndAve,10/26/2014 04:00:00 PM,48,-122,30,11,41
7169,58thStGreenway22ndAve,10/26/2014 05:00:00 PM,48,-122,29,7,36
7170,58thStGreenway22ndAve,10/26/2014 06:00:00 PM,48,-122,36,4,40
7171,58thStGreenway22ndAve,10/26/2014 07:00:00 PM,48,-122,14,2,16
7172,58thStGreenway22ndAve,10/26/2014 08:00:00 PM,48,-122,17,0,17
7173,58thStGreenway22ndAve,10/26/2014 09:00:00 PM,48,-122,11,1,12
7174,58thStGreenway22ndAve,10/26/2014 10:00:00 PM,48,-122,0,1,1
7175,58thStGreenway22ndAve,10/26/2014 11:00:00 PM,48,-122,7,0,7
7176,58thStGreenway22ndAve,10/27/2014 12:00:00 AM,48,-122,0,0,0
7177,58thStGreenway22ndAve,10/27/2014 01:00:00 AM,48,-122,1,0,1
7178,58thStGreenway22ndAve,10/27/2014 02:00:00 AM,48,-122,4,0,4
7179,58thStGreenway22ndAve,10/27/2014 03:00:00 AM,48,-122,0,0,0
7180,58thStGreenway22ndAve,10/27/2014 04:00:00 AM,48,-122,0,0,0
7181,58thStGreenway22ndAve,10/27/2014 05:00:00 AM,48,-122,2,0,2
7182,58thStGreenway22ndAve,10/27/2014 06:00:00 AM,48,-122,11,5,16
7183,58thStGreenway22ndAve,10/27/2014 07:00:00 AM,48,-122,22,9,31
7184,58thStGreenway22ndAve,10/27/2014 08:00:00 AM,48,-122,15,13,28
7185,58thStGreenway22ndAve,10/27/2014 09:00:00 AM,48,-122,41,9,50
7186,58thStGreenway22ndAve,10/27/2014 10:00:00 AM,48,-122,53,16,69
7187,58thStGreenway22ndAve,10/27/2014 11:00:00 AM,48,-122,35,21,56
7188,58thStGreenway22ndAve,10/27/2014 12:00:00 PM,48,-122,62,30,92
7189,58thStGreenway22ndAve,10/27/2014 01:00:00 PM,48,-122,58,12,70
7190,58thStGreenway22ndAve,10/27/2014 02:00:00 PM,48,-122,48,19,67
7191,58thStGreenway22ndAve,10/27/2014 03:00:00 PM,48,-122,37,24,61
7192,58thStGreenway22ndAve,10/27/2014 04:00:00 PM,48,-122,69,27,96
7193,58thStGreenway22ndAve,10/27/2014 05:00:00 PM,48,-122,74,34,108
7194,58thStGreenway22ndAve,10/27/2014 06:00:00 PM,48,-122,53,33,86
7195,58thStGreenway22ndAve,10/27/2014 07:00:00 PM,48,-122,31,9,40
7196,58thStGreenway22ndAve,10/27/2014 08:00:00 PM,48,-122,24,14,38
7197,58thStGreenway22ndAve,10/27/2014 09:00:00 PM,48,-122,22,5,27
7198,58thStGreenway22ndAve,10/27/2014 10:00:00 PM,48,-122,12,1,13
7199,58thStGreenway22ndAve,10/27/2014 11:00:00 PM,48,-122,4,0,4
7200,58thStGreenway22ndAve,10/28/2014 12:00:00 AM,48,-122,2,0,2
7201,58thStGreenway22ndAve,10/28/2014 01:00:00 AM,48,-122,0,0,0
7202,58thStGreenway22ndAve,10/28/2014 02:00:00 AM,48,-122,0,0,0
7203,58thStGreenway22ndAve,10/28/2014 03:00:00 AM,48,-122,0,0,0
7204,58thStGreenway22ndAve,10/28/2014 04:00:00 AM,48,-122,2,0,2
7205,58thStGreenway22ndAve,10/28/2014 05:00:00 AM,48,-122,5,0,5
7206,58thStGreenway22ndAve,10/28/2014 06:00:00 AM,48,-122,11,9,20
7207,58thStGreenway22ndAve,10/28/2014 07:00:00 AM,48,-122,23,2,25
7208,58thStGreenway22ndAve,10/28/2014 08:00:00 AM,48,-122,39,19,58
7209,58thStGreenway22ndAve,10/28/2014 09:00:00 AM,48,-122,30,11,41
7210,58thStGreenway22ndAve,10/28/2014 10:00:00 AM,48,-122,28,29,57
7211,58thStGreenway22ndAve,10/28/2014 11:00:00 AM,48,-122,38,20,58
7212,58thStGreenway22ndAve,10/28/2014 12:00:00 PM,48,-122,50,16,66
7213,58thStGreenway22ndAve,10/28/2014 01:00:00 PM,48,-122,54,24,78
7214,58thStGreenway22ndAve,10/28/2014 02:00:00 PM,48,-122,45,22,67
7215,58thStGreenway22ndAve,10/28/2014 03:00:00 PM,48,-122,43,11,54
7216,58thStGreenway22ndAve,10/28/2014 04:00:00 PM,48,-122,76,34,110
7217,58thStGreenway22ndAve,10/28/2014 05:00:00 PM,48,-122,41,32,73
7218,58thStGreenway22ndAve,10/28/2014 06:00:00 PM,48,-122,56,32,88
7219,58thStGreenway22ndAve,10/28/2014 07:00:00 PM,48,-122,29,13,42
7220,58thStGreenway22ndAve,10/28/2014 08:00:00 PM,48,-122,17,1,18
7221,58thStGreenway22ndAve,10/28/2014 09:00:00 PM,48,-122,12,0,12
7222,58thStGreenway22ndAve,10/28/2014 10:00:00 PM,48,-122,8,3,11
7223,58thStGreenway22ndAve,10/28/2014 11:00:00 PM,48,-122,4,1,5
7224,58thStGreenway22ndAve,10/29/2014 12:00:00 AM,48,-122,0,0,0
7225,58thStGreenway22ndAve,10/29/2014 01:00:00 AM,48,-122,4,1,5
7226,58thStGreenway22ndAve,10/29/2014 02:00:00 AM,48,-122,2,0,2
7227,58thStGreenway22ndAve,10/29/2014 03:00:00 AM,48,-122,0,0,0
7228,58thStGreenway22ndAve,10/29/2014 04:00:00 AM,48,-122,0,0,0
7229,58thStGreenway22ndAve,10/29/2014 05:00:00 AM,48,-122,4,2,6
7230,58thStGreenway22ndAve,10/29/2014 06:00:00 AM,48,-122,16,7,23
7231,58thStGreenway22ndAve,10/29/2014 07:00:00 AM,48,-122,22,10,32
7232,58thStGreenway22ndAve,10/29/2014 08:00:00 AM,48,-122,49,19,68
7233,58thStGreenway22ndAve,10/29/2014 09:00:00 AM,48,-122,40,14,54
7234,58thStGreenway22ndAve,10/29/2014 10:00:00 AM,48,-122,41,12,53
7235,58thStGreenway22ndAve,10/29/2014 11:00:00 AM,48,-122,31,15,46
7236,58thStGreenway22ndAve,10/29/2014 12:00:00 PM,48,-122,56,15,71
7237,58thStGreenway22ndAve,10/29/2014 01:00:00 PM,48,-122,29,31,60
7238,58thStGreenway22ndAve,10/29/2014 02:00:00 PM,48,-122,50,25,75
7239,58thStGreenway22ndAve,10/29/2014 03:00:00 PM,48,-122,51,27,78
7240,58thStGreenway22ndAve,10/29/2014 04:00:00 PM,48,-122,47,30,77
7241,58thStGreenway22ndAve,10/29/2014 05:00:00 PM,48,-122,40,40,80
7242,58thStGreenway22ndAve,10/29/2014 06:00:00 PM,48,-122,91,40,131
7243,58thStGreenway22ndAve,10/29/2014 07:00:00 PM,48,-122,33,16,49
7244,58thStGreenway22ndAve,10/29/2014 08:00:00 PM,48,-122,18,14,32
7245,58thStGreenway22ndAve,10/29/2014 09:00:00 PM,48,-122,13,5,18
7246,58thStGreenway22ndAve,10/29/2014 10:00:00 PM,48,-122,10,2,12
7247,58thStGreenway22ndAve,10/29/2014 11:00:00 PM,48,-122,4,3,7
7248,58thStGreenway22ndAve,10/30/2014 12:00:00 AM,48,-122,2,0,2
7249,58thStGreenway22ndAve,10/30/2014 01:00:00 AM,48,-122,1,0,1
7250,58thStGreenway22ndAve,10/30/2014 02:00:00 AM,48,-122,4,0,4
7251,58thStGreenway22ndAve,10/30/2014 03:00:00 AM,48,-122,1,0,1
7252,58thStGreenway22ndAve,10/30/2014 04:00:00 AM,48,-122,0,0,0
7253,58thStGreenway22ndAve,10/30/2014 05:00:00 AM,48,-122,0,1,1
7254,58thStGreenway22ndAve,10/30/2014 06:00:00 AM,48,-122,13,1,14
7255,58thStGreenway22ndAve,10/30/2014 07:00:00 AM,48,-122,51,4,55
7256,58thStGreenway22ndAve,10/30/2014 08:00:00 AM,48,-122,29,9,38
7257,58thStGreenway22ndAve,10/30/2014 09:00:00 AM,48,-122,44,22,66
7258,58thStGreenway22ndAve,10/30/2014 10:00:00 AM,48,-122,43,16,59
7259,58thStGreenway22ndAve,10/30/2014 11:00:00 AM,48,-122,43,25,68
7260,58thStGreenway22ndAve,10/30/2014 12:00:00 PM,48,-122,41,15,56
7261,58thStGreenway22ndAve,10/30/2014 01:00:00 PM,48,-122,41,29,70
7262,58thStGreenway22ndAve,10/30/2014 02:00:00 PM,48,-122,50,36,86
7263,58thStGreenway22ndAve,10/30/2014 03:00:00 PM,48,-122,46,27,73
7264,58thStGreenway22ndAve,10/30/2014 04:00:00 PM,48,-122,51,30,81
7265,58thStGreenway22ndAve,10/30/2014 05:00:00 PM,48,-122,72,45,117
7266,58thStGreenway22ndAve,10/30/2014 06:00:00 PM,48,-122,64,41,105
7267,58thStGreenway22ndAve,10/30/2014 07:00:00 PM,48,-122,34,29,63
7268,58thStGreenway22ndAve,10/30/2014 08:00:00 PM,48,-122,32,8,40
7269,58thStGreenway22ndAve,10/30/2014 09:00:00 PM,48,-122,17,6,23
7270,58thStGreenway22ndAve,10/30/2014 10:00:00 PM,48,-122,10,2,12
7271,58thStGreenway22ndAve,10/30/2014 11:00:00 PM,48,-122,8,3,11
7272,58thStGreenway22ndAve,10/31/2014 12:00:00 AM,48,-122,1,2,3
7273,58thStGreenway22ndAve,10/31/2014 01:00:00 AM,48,-122,4,0,4
7274,58thStGreenway22ndAve,10/31/2014 02:00:00 AM,48,-122,2,0,2
7275,58thStGreenway22ndAve,10/31/2014 03:00:00 AM,48,-122,0,0,0
7276,58thStGreenway22ndAve,10/31/2014 04:00:00 AM,48,-122,2,0,2
7277,58thStGreenway22ndAve,10/31/2014 05:00:00 AM,48,-122,0,4,4
7278,58thStGreenway22ndAve,10/31/2014 06:00:00 AM,48,-122,14,4,18
7279,58thStGreenway22ndAve,10/31/2014 07:00:00 AM,48,-122,14,8,22
7280,58thStGreenway22ndAve,10/31/2014 08:00:00 AM,48,-122,36,11,47
7281,58thStGreenway22ndAve,10/31/2014 09:00:00 AM,48,-122,30,23,53
7282,58thStGreenway22ndAve,10/31/2014 10:00:00 AM,48,-122,23,25,48
7283,58thStGreenway22ndAve,10/31/2014 11:00:00 AM,48,-122,40,19,59
7284,58thStGreenway22ndAve,10/31/2014 12:00:00 PM,48,-122,54,34,88
7285,58thStGreenway22ndAve,10/31/2014 01:00:00 PM,48,-122,41,21,62
7286,58thStGreenway22ndAve,10/31/2014 02:00:00 PM,48,-122,37,18,55
7287,58thStGreenway22ndAve,10/31/2014 03:00:00 PM,48,-122,39,22,61
7288,58thStGreenway22ndAve,10/31/2014 04:00:00 PM,48,-122,84,43,127
7289,58thStGreenway22ndAve,10/31/2014 05:00:00 PM,48,-122,58,22,80
7290,58thStGreenway22ndAve,10/31/2014 06:00:00 PM,48,-122,23,24,47
7291,58thStGreenway22ndAve,10/31/2014 07:00:00 PM,48,-122,35,14,49
7292,58thStGreenway22ndAve,10/31/2014 08:00:00 PM,48,-122,21,8,29
7293,58thStGreenway22ndAve,10/31/2014 09:00:00 PM,48,-122,12,9,21
7294,58thStGreenway22ndAve,10/31/2014 10:00:00 PM,48,-122,10,7,17
7295,58thStGreenway22ndAve,10/31/2014 11:00:00 PM,48,-122,6,3,9
7296,58thStGreenway22ndAve,11/01/2014 12:00:00 AM,48,-122,5,2,7
7297,58thStGreenway22ndAve,11/01/2014 01:00:00 AM,48,-122,5,0,5
7298,58thStGreenway22ndAve,11/01/2014 02:00:00 AM,48,-122,5,1,6
7299,58thStGreenway22ndAve,11/01/2014 03:00:00 AM,48,-122,2,1,3
7300,58thStGreenway22ndAve,11/01/2014 04:00:00 AM,48,-122,4,0,4
7301,58thStGreenway22ndAve,11/01/2014 05:00:00 AM,48,-122,2,2,4
7302,58thStGreenway22ndAve,11/01/2014 06:00:00 AM,48,-122,5,1,6
7303,58thStGreenway22ndAve,11/01/2014 07:00:00 AM,48,-122,2,1,3
7304,58thStGreenway22ndAve,11/01/2014 08:00:00 AM,48,-122,10,3,13
7305,58thStGreenway22ndAve,11/01/2014 09:00:00 AM,48,-122,31,7,38
7306,58thStGreenway22ndAve,11/01/2014 10:00:00 AM,48,-122,30,22,52
7307,58thStGreenway22ndAve,11/01/2014 11:00:00 AM,48,-122,54,16,70
7308,58thStGreenway22ndAve,11/01/2014 12:00:00 PM,48,-122,43,20,63
7309,58thStGreenway22ndAve,11/01/2014 01:00:00 PM,48,-122,29,21,50
7310,58thStGreenway22ndAve,11/01/2014 02:00:00 PM,48,-122,45,26,71
7311,58thStGreenway22ndAve,11/01/2014 03:00:00 PM,48,-122,19,23,42
7312,58thStGreenway22ndAve,11/01/2014 04:00:00 PM,48,-122,38,10,48
7313,58thStGreenway22ndAve,11/01/2014 05:00:00 PM,48,-122,31,20,51
7314,58thStGreenway22ndAve,11/01/2014 06:00:00 PM,48,-122,30,14,44
7315,58thStGreenway22ndAve,11/01/2014 07:00:00 PM,48,-122,26,6,32
7316,58thStGreenway22ndAve,11/01/2014 08:00:00 PM,48,-122,15,7,22
7317,58thStGreenway22ndAve,11/01/2014 09:00:00 PM,48,-122,19,6,25
7318,58thStGreenway22ndAve,11/01/2014 10:00:00 PM,48,-122,7,2,9
7319,58thStGreenway22ndAve,11/01/2014 11:00:00 PM,48,-122,3,1,4
7320,58thStGreenway22ndAve,11/02/2014 12:00:00 AM,48,-122,0,2,2
7321,58thStGreenway22ndAve,11/02/2014 01:00:00 AM,48,-122,10,1,11
7322,58thStGreenway22ndAve,11/02/2014 02:00:00 AM,48,-122,0,0,0
7323,58thStGreenway22ndAve,11/02/2014 03:00:00 AM,48,-122,2,1,3
7324,58thStGreenway22ndAve,11/02/2014 04:00:00 AM,48,-122,0,0,0
7325,58thStGreenway22ndAve,11/02/2014 05:00:00 AM,48,-122,0,0,0
7326,58thStGreenway22ndAve,11/02/2014 06:00:00 AM,48,-122,4,3,7
7327,58thStGreenway22ndAve,11/02/2014 07:00:00 AM,48,-122,6,3,9
7328,58thStGreenway22ndAve,11/02/2014 08:00:00 AM,48,-122,7,6,13
7329,58thStGreenway22ndAve,11/02/2014 09:00:00 AM,48,-122,30,14,44
7330,58thStGreenway22ndAve,11/02/2014 10:00:00 AM,48,-122,37,25,62
7331,58thStGreenway22ndAve,11/02/2014 11:00:00 AM,48,-122,31,31,62
7332,58thStGreenway22ndAve,11/02/2014 12:00:00 PM,48,-122,56,23,79
7333,58thStGreenway22ndAve,11/02/2014 01:00:00 PM,48,-122,41,28,69
7334,58thStGreenway22ndAve,11/02/2014 02:00:00 PM,48,-122,43,21,64
7335,58thStGreenway22ndAve,11/02/2014 03:00:00 PM,48,-122,28,11,39
7336,58thStGreenway22ndAve,11/02/2014 04:00:00 PM,48,-122,21,17,38
7337,58thStGreenway22ndAve,11/02/2014 05:00:00 PM,48,-122,30,15,45
7338,58thStGreenway22ndAve,11/02/2014 06:00:00 PM,48,-122,12,6,18
7339,58thStGreenway22ndAve,11/02/2014 07:00:00 PM,48,-122,15,5,20
7340,58thStGreenway22ndAve,11/02/2014 08:00:00 PM,48,-122,5,5,10
7341,58thStGreenway22ndAve,11/02/2014 09:00:00 PM,48,-122,10,3,13
7342,58thStGreenway22ndAve,11/02/2014 10:00:00 PM,48,-122,2,1,3
7343,58thStGreenway22ndAve,11/02/2014 11:00:00 PM,48,-122,0,1,1
7344,58thStGreenway22ndAve,11/03/2014 12:00:00 AM,48,-122,2,1,3
7345,58thStGreenway22ndAve,11/03/2014 01:00:00 AM,48,-122,0,0,0
7346,58thStGreenway22ndAve,11/03/2014 02:00:00 AM,48,-122,0,0,0
7347,58thStGreenway22ndAve,11/03/2014 03:00:00 AM,48,-122,2,0,2
7348,58thStGreenway22ndAve,11/03/2014 04:00:00 AM,48,-122,4,2,6
7349,58thStGreenway22ndAve,11/03/2014 05:00:00 AM,48,-122,4,1,5
7350,58thStGreenway22ndAve,11/03/2014 06:00:00 AM,48,-122,12,6,18
7351,58thStGreenway22ndAve,11/03/2014 07:00:00 AM,48,-122,24,10,34
7352,58thStGreenway22ndAve,11/03/2014 08:00:00 AM,48,-122,19,16,35
7353,58thStGreenway22ndAve,11/03/2014 09:00:00 AM,48,-122,31,11,42
7354,58thStGreenway22ndAve,11/03/2014 10:00:00 AM,48,-122,25,14,39
7355,58thStGreenway22ndAve,11/03/2014 11:00:00 AM,48,-122,38,27,65
7356,58thStGreenway22ndAve,11/03/2014 12:00:00 PM,48,-122,43,13,56
7357,58thStGreenway22ndAve,11/03/2014 01:00:00 PM,48,-122,23,20,43
7358,58thStGreenway22ndAve,11/03/2014 02:00:00 PM,48,-122,17,8,25
7359,58thStGreenway22ndAve,11/03/2014 03:00:00 PM,48,-122,29,10,39
7360,58thStGreenway22ndAve,11/03/2014 04:00:00 PM,48,-122,25,17,42
7361,58thStGreenway22ndAve,11/03/2014 05:00:00 PM,48,-122,35,10,45
7362,58thStGreenway22ndAve,11/03/2014 06:00:00 PM,48,-122,22,9,31
7363,58thStGreenway22ndAve,11/03/2014 07:00:00 PM,48,-122,19,6,25
7364,58thStGreenway22ndAve,11/03/2014 08:00:00 PM,48,-122,6,0,6
7365,58thStGreenway22ndAve,11/03/2014 09:00:00 PM,48,-122,9,3,12
7366,58thStGreenway22ndAve,11/03/2014 10:00:00 PM,48,-122,2,0,2
7367,58thStGreenway22ndAve,11/03/2014 11:00:00 PM,48,-122,3,2,5
7368,58thStGreenway22ndAve,11/04/2014 12:00:00 AM,48,-122,3,0,3
7369,58thStGreenway22ndAve,11/04/2014 01:00:00 AM,48,-122,4,0,4
7370,58thStGreenway22ndAve,11/04/2014 02:00:00 AM,48,-122,0,0,0
7371,58thStGreenway22ndAve,11/04/2014 03:00:00 AM,48,-122,0,0,0
7372,58thStGreenway22ndAve,11/04/2014 04:00:00 AM,48,-122,2,1,3
7373,58thStGreenway22ndAve,11/04/2014 05:00:00 AM,48,-122,8,1,9
7374,58thStGreenway22ndAve,11/04/2014 06:00:00 AM,48,-122,13,6,19
7375,58thStGreenway22ndAve,11/04/2014 07:00:00 AM,48,-122,18,14,32
7376,58thStGreenway22ndAve,11/04/2014 08:00:00 AM,48,-122,36,17,53
7377,58thStGreenway22ndAve,11/04/2014 09:00:00 AM,48,-122,37,24,61
7378,58thStGreenway22ndAve,11/04/2014 10:00:00 AM,48,-122,37,16,53
7379,58thStGreenway22ndAve,11/04/2014 11:00:00 AM,48,-122,32,12,44
7380,58thStGreenway22ndAve,11/04/2014 12:00:00 PM,48,-122,31,21,52
7381,58thStGreenway22ndAve,11/04/2014 01:00:00 PM,48,-122,31,21,52
7382,58thStGreenway22ndAve,11/04/2014 02:00:00 PM,48,-122,32,21,53
7383,58thStGreenway22ndAve,11/04/2014 03:00:00 PM,48,-122,25,11,36
7384,58thStGreenway22ndAve,11/04/2014 04:00:00 PM,48,-122,44,21,65
7385,58thStGreenway22ndAve,11/04/2014 05:00:00 PM,48,-122,58,31,89
7386,58thStGreenway22ndAve,11/04/2014 06:00:00 PM,48,-122,99,66,165
7387,58thStGreenway22ndAve,11/04/2014 07:00:00 PM,48,-122,84,47,131
7388,58thStGreenway22ndAve,11/04/2014 08:00:00 PM,48,-122,18,4,22
7389,58thStGreenway22ndAve,11/04/2014 09:00:00 PM,48,-122,9,1,10
7390,58thStGreenway22ndAve,11/04/2014 10:00:00 PM,48,-122,6,2,8
7391,58thStGreenway22ndAve,11/04/2014 11:00:00 PM,48,-122,2,1,3
7392,58thStGreenway22ndAve,11/05/2014 12:00:00 AM,48,-122,0,0,0
7393,58thStGreenway22ndAve,11/05/2014 01:00:00 AM,48,-122,2,0,2
7394,58thStGreenway22ndAve,11/05/2014 02:00:00 AM,48,-122,0,0,0
7395,58thStGreenway22ndAve,11/05/2014 03:00:00 AM,48,-122,2,0,2
7396,58thStGreenway22ndAve,11/05/2014 04:00:00 AM,48,-122,2,0,2
7397,58thStGreenway22ndAve,11/05/2014 05:00:00 AM,48,-122,0,1,1
7398,58thStGreenway22ndAve,11/05/2014 06:00:00 AM,48,-122,10,3,13
7399,58thStGreenway22ndAve,11/05/2014 07:00:00 AM,48,-122,26,4,30
7400,58thStGreenway22ndAve,11/05/2014 08:00:00 AM,48,-122,24,16,40
7401,58thStGreenway22ndAve,11/05/2014 09:00:00 AM,48,-122,33,14,47
7402,58thStGreenway22ndAve,11/05/2014 10:00:00 AM,48,-122,40,5,45
7403,58thStGreenway22ndAve,11/05/2014 11:00:00 AM,48,-122,29,12,41
7404,58thStGreenway22ndAve,11/05/2014 12:00:00 PM,48,-122,18,8,26
7405,58thStGreenway22ndAve,11/05/2014 01:00:00 PM,48,-122,5,8,13
7406,58thStGreenway22ndAve,11/05/2014 02:00:00 PM,48,-122,18,10,28
7407,58thStGreenway22ndAve,11/05/2014 03:00:00 PM,48,-122,25,12,37
7408,58thStGreenway22ndAve,11/05/2014 04:00:00 PM,48,-122,21,6,27
7409,58thStGreenway22ndAve,11/05/2014 05:00:00 PM,48,-122,20,15,35
7410,58thStGreenway22ndAve,11/05/2014 06:00:00 PM,48,-122,29,16,45
7411,58thStGreenway22ndAve,11/05/2014 07:00:00 PM,48,-122,21,9,30
7412,58thStGreenway22ndAve,11/05/2014 08:00:00 PM,48,-122,16,2,18
7413,58thStGreenway22ndAve,11/05/2014 09:00:00 PM,48,-122,14,2,16
7414,58thStGreenway22ndAve,11/05/2014 10:00:00 PM,48,-122,8,2,10
7415,58thStGreenway22ndAve,11/05/2014 11:00:00 PM,48,-122,6,0,6
7416,58thStGreenway22ndAve,11/06/2014 12:00:00 AM,48,-122,2,3,5
7417,58thStGreenway22ndAve,11/06/2014 01:00:00 AM,48,-122,0,1,1
7418,58thStGreenway22ndAve,11/06/2014 02:00:00 AM,48,-122,0,0,0
7419,58thStGreenway22ndAve,11/06/2014 03:00:00 AM,48,-122,2,0,2
7420,58thStGreenway22ndAve,11/06/2014 04:00:00 AM,48,-122,0,0,0
7421,58thStGreenway22ndAve,11/06/2014 05:00:00 AM,48,-122,3,0,3
7422,58thStGreenway22ndAve,11/06/2014 06:00:00 AM,48,-122,21,3,24
7423,58thStGreenway22ndAve,11/06/2014 07:00:00 AM,48,-122,33,11,44
7424,58thStGreenway22ndAve,11/06/2014 08:00:00 AM,48,-122,37,16,53
7425,58thStGreenway22ndAve,11/06/2014 09:00:00 AM,48,-122,16,3,19
7426,58thStGreenway22ndAve,11/06/2014 10:00:00 AM,48,-122,23,11,34
7427,58thStGreenway22ndAve,11/06/2014 11:00:00 AM,48,-122,13,5,18
7428,58thStGreenway22ndAve,11/06/2014 12:00:00 PM,48,-122,22,9,31
7429,58thStGreenway22ndAve,11/06/2014 01:00:00 PM,48,-122,31,9,40
7430,58thStGreenway22ndAve,11/06/2014 02:00:00 PM,48,-122,18,8,26
7431,58thStGreenway22ndAve,11/06/2014 03:00:00 PM,48,-122,17,8,25
7432,58thStGreenway22ndAve,11/06/2014 04:00:00 PM,48,-122,46,12,58
7433,58thStGreenway22ndAve,11/06/2014 05:00:00 PM,48,-122,24,11,35
7434,58thStGreenway22ndAve,11/06/2014 06:00:00 PM,48,-122,41,10,51
7435,58thStGreenway22ndAve,11/06/2014 07:00:00 PM,48,-122,19,7,26
7436,58thStGreenway22ndAve,11/06/2014 08:00:00 PM,48,-122,16,4,20
7437,58thStGreenway22ndAve,11/06/2014 09:00:00 PM,48,-122,11,3,14
7438,58thStGreenway22ndAve,11/06/2014 10:00:00 PM,48,-122,4,6,10
7439,58thStGreenway22ndAve,11/06/2014 11:00:00 PM,48,-122,11,1,12
7440,58thStGreenway22ndAve,11/07/2014 12:00:00 AM,48,-122,0,0,0
7441,58thStGreenway22ndAve,11/07/2014 01:00:00 AM,48,-122,0,2,2
7442,58thStGreenway22ndAve,11/07/2014 02:00:00 AM,48,-122,6,2,8
7443,58thStGreenway22ndAve,11/07/2014 03:00:00 AM,48,-122,0,0,0
7444,58thStGreenway22ndAve,11/07/2014 04:00:00 AM,48,-122,2,0,2
7445,58thStGreenway22ndAve,11/07/2014 05:00:00 AM,48,-122,2,2,4
7446,58thStGreenway22ndAve,11/07/2014 06:00:00 AM,48,-122,12,1,13
7447,58thStGreenway22ndAve,11/07/2014 07:00:00 AM,48,-122,30,5,35
7448,58thStGreenway22ndAve,11/07/2014 08:00:00 AM,48,-122,28,15,43
7449,58thStGreenway22ndAve,11/07/2014 09:00:00 AM,48,-122,44,7,51
7450,58thStGreenway22ndAve,11/07/2014 10:00:00 AM,48,-122,12,6,18
7451,58thStGreenway22ndAve,11/07/2014 11:00:00 AM,48,-122,45,4,49
7452,58thStGreenway22ndAve,11/07/2014 12:00:00 PM,48,-122,24,14,38
7453,58thStGreenway22ndAve,11/07/2014 01:00:00 PM,48,-122,42,24,66
7454,58thStGreenway22ndAve,11/07/2014 02:00:00 PM,48,-122,28,10,38
7455,58thStGreenway22ndAve,11/07/2014 03:00:00 PM,48,-122,34,7,41
7456,58thStGreenway22ndAve,11/07/2014 04:00:00 PM,48,-122,32,8,40
7457,58thStGreenway22ndAve,11/07/2014 05:00:00 PM,48,-122,33,22,55
7458,58thStGreenway22ndAve,11/07/2014 06:00:00 PM,48,-122,20,10,30
7459,58thStGreenway22ndAve,11/07/2014 07:00:00 PM,48,-122,35,11,46
7460,58thStGreenway22ndAve,11/07/2014 08:00:00 PM,48,-122,12,4,16
7461,58thStGreenway22ndAve,11/07/2014 09:00:00 PM,48,-122,9,5,14
7462,58thStGreenway22ndAve,11/07/2014 10:00:00 PM,48,-122,7,2,9
7463,58thStGreenway22ndAve,11/07/2014 11:00:00 PM,48,-122,12,4,16
7464,58thStGreenway22ndAve,11/08/2014 12:00:00 AM,48,-122,6,1,7
7465,58thStGreenway22ndAve,11/08/2014 01:00:00 AM,48,-122,5,0,5
7466,58thStGreenway22ndAve,11/08/2014 02:00:00 AM,48,-122,5,0,5
7467,58thStGreenway22ndAve,11/08/2014 03:00:00 AM,48,-122,2,0,2
7468,58thStGreenway22ndAve,11/08/2014 04:00:00 AM,48,-122,2,0,2
7469,58thStGreenway22ndAve,11/08/2014 05:00:00 AM,48,-122,2,0,2
7470,58thStGreenway22ndAve,11/08/2014 06:00:00 AM,48,-122,8,0,8
7471,58thStGreenway22ndAve,11/08/2014 07:00:00 AM,48,-122,9,2,11
7472,58thStGreenway22ndAve,11/08/2014 08:00:00 AM,48,-122,9,8,17
7473,58thStGreenway22ndAve,11/08/2014 09:00:00 AM,48,-122,40,8,48
7474,58thStGreenway22ndAve,11/08/2014 10:00:00 AM,48,-122,40,9,49
7475,58thStGreenway22ndAve,11/08/2014 11:00:00 AM,48,-122,32,23,55
7476,58thStGreenway22ndAve,11/08/2014 12:00:00 PM,48,-122,44,11,55
7477,58thStGreenway22ndAve,11/08/2014 01:00:00 PM,48,-122,50,14,64
7478,58thStGreenway22ndAve,11/08/2014 02:00:00 PM,48,-122,53,18,71
7479,58thStGreenway22ndAve,11/08/2014 03:00:00 PM,48,-122,46,10,56
7480,58thStGreenway22ndAve,11/08/2014 04:00:00 PM,48,-122,34,9,43
7481,58thStGreenway22ndAve,11/08/2014 05:00:00 PM,48,-122,19,6,25
7482,58thStGreenway22ndAve,11/08/2014 06:00:00 PM,48,-122,31,8,39
7483,58thStGreenway22ndAve,11/08/2014 07:00:00 PM,48,-122,12,4,16
7484,58thStGreenway22ndAve,11/08/2014 08:00:00 PM,48,-122,16,5,21
7485,58thStGreenway22ndAve,11/08/2014 09:00:00 PM,48,-122,17,1,18
7486,58thStGreenway22ndAve,11/08/2014 10:00:00 PM,48,-122,15,2,17
7487,58thStGreenway22ndAve,11/08/2014 11:00:00 PM,48,-122,9,1,10
7488,58thStGreenway22ndAve,11/09/2014 12:00:00 AM,48,-122,4,2,6
7489,58thStGreenway22ndAve,11/09/2014 01:00:00 AM,48,-122,8,2,10
7490,58thStGreenway22ndAve,11/09/2014 02:00:00 AM,48,-122,2,0,2
7491,58thStGreenway22ndAve,11/09/2014 03:00:00 AM,48,-122,3,2,5
7492,58thStGreenway22ndAve,11/09/2014 04:00:00 AM,48,-122,0,0,0
7493,58thStGreenway22ndAve,11/09/2014 05:00:00 AM,48,-122,4,0,4
7494,58thStGreenway22ndAve,11/09/2014 06:00:00 AM,48,-122,4,1,5
7495,58thStGreenway22ndAve,11/09/2014 07:00:00 AM,48,-122,8,1,9
7496,58thStGreenway22ndAve,11/09/2014 08:00:00 AM,48,-122,12,3,15
7497,58thStGreenway22ndAve,11/09/2014 09:00:00 AM,48,-122,28,14,42
7498,58thStGreenway22ndAve,11/09/2014 10:00:00 AM,48,-122,32,12,44
7499,58thStGreenway22ndAve,11/09/2014 11:00:00 AM,48,-122,40,8,48
7500,58thStGreenway22ndAve,11/09/2014 12:00:00 PM,48,-122,50,26,76
7501,58thStGreenway22ndAve,11/09/2014 01:00:00 PM,48,-122,46,21,67
7502,58thStGreenway22ndAve,11/09/2014 02:00:00 PM,48,-122,24,10,34
7503,58thStGreenway22ndAve,11/09/2014 03:00:00 PM,48,-122,18,5,23
7504,58thStGreenway22ndAve,11/09/2014 04:00:00 PM,48,-122,18,9,27
7505,58thStGreenway22ndAve,11/09/2014 05:00:00 PM,48,-122,9,12,21
7506,58thStGreenway22ndAve,11/09/2014 06:00:00 PM,48,-122,12,4,16
7507,58thStGreenway22ndAve,11/09/2014 07:00:00 PM,48,-122,13,2,15
7508,58thStGreenway22ndAve,11/09/2014 08:00:00 PM,48,-122,8,7,15
7509,58thStGreenway22ndAve,11/09/2014 09:00:00 PM,48,-122,9,1,10
7510,58thStGreenway22ndAve,11/09/2014 10:00:00 PM,48,-122,4,1,5
7511,58thStGreenway22ndAve,11/09/2014 11:00:00 PM,48,-122,3,0,3
7512,58thStGreenway22ndAve,11/10/2014 12:00:00 AM,48,-122,0,1,1
7513,58thStGreenway22ndAve,11/10/2014 01:00:00 AM,48,-122,3,1,4
7514,58thStGreenway22ndAve,11/10/2014 02:00:00 AM,48,-122,0,0,0
7515,58thStGreenway22ndAve,11/10/2014 03:00:00 AM,48,-122,0,0,0
7516,58thStGreenway22ndAve,11/10/2014 04:00:00 AM,48,-122,0,0,0
7517,58thStGreenway22ndAve,11/10/2014 05:00:00 AM,48,-122,0,1,1
7518,58thStGreenway22ndAve,11/10/2014 06:00:00 AM,48,-122,14,3,17
7519,58thStGreenway22ndAve,11/10/2014 07:00:00 AM,48,-122,35,7,42
7520,58thStGreenway22ndAve,11/10/2014 08:00:00 AM,48,-122,33,14,47
7521,58thStGreenway22ndAve,11/10/2014 09:00:00 AM,48,-122,33,9,42
7522,58thStGreenway22ndAve,11/10/2014 10:00:00 AM,48,-122,28,15,43
7523,58thStGreenway22ndAve,11/10/2014 11:00:00 AM,48,-122,24,5,29
7524,58thStGreenway22ndAve,11/10/2014 12:00:00 PM,48,-122,23,16,39
7525,58thStGreenway22ndAve,11/10/2014 01:00:00 PM,48,-122,18,14,32
7526,58thStGreenway22ndAve,11/10/2014 02:00:00 PM,48,-122,43,15,58
7527,58thStGreenway22ndAve,11/10/2014 03:00:00 PM,48,-122,39,16,55
7528,58thStGreenway22ndAve,11/10/2014 04:00:00 PM,48,-122,22,12,34
7529,58thStGreenway22ndAve,11/10/2014 05:00:00 PM,48,-122,35,14,49
7530,58thStGreenway22ndAve,11/10/2014 06:00:00 PM,48,-122,19,4,23
7531,58thStGreenway22ndAve,11/10/2014 07:00:00 PM,48,-122,12,6,18
7532,58thStGreenway22ndAve,11/10/2014 08:00:00 PM,48,-122,17,8,25
7533,58thStGreenway22ndAve,11/10/2014 09:00:00 PM,48,-122,6,3,9
7534,58thStGreenway22ndAve,11/10/2014 10:00:00 PM,48,-122,13,0,13
7535,58thStGreenway22ndAve,11/10/2014 11:00:00 PM,48,-122,2,0,2
7536,58thStGreenway22ndAve,11/11/2014 12:00:00 AM,48,-122,0,1,1
7537,58thStGreenway22ndAve,11/11/2014 01:00:00 AM,48,-122,1,0,1
7538,58thStGreenway22ndAve,11/11/2014 02:00:00 AM,48,-122,0,0,0
7539,58thStGreenway22ndAve,11/11/2014 03:00:00 AM,48,-122,0,0,0
7540,58thStGreenway22ndAve,11/11/2014 04:00:00 AM,48,-122,0,0,0
7541,58thStGreenway22ndAve,11/11/2014 05:00:00 AM,48,-122,0,0,0
7542,58thStGreenway22ndAve,11/11/2014 06:00:00 AM,48,-122,19,2,21
7543,58thStGreenway22ndAve,11/11/2014 07:00:00 AM,48,-122,15,1,16
7544,58thStGreenway22ndAve,11/11/2014 08:00:00 AM,48,-122,29,5,34
7545,58thStGreenway22ndAve,11/11/2014 09:00:00 AM,48,-122,23,4,27
7546,58thStGreenway22ndAve,11/11/2014 10:00:00 AM,48,-122,23,7,30
7547,58thStGreenway22ndAve,11/11/2014 11:00:00 AM,48,-122,37,20,57
7548,58thStGreenway22ndAve,11/11/2014 12:00:00 PM,48,-122,41,11,52
7549,58thStGreenway22ndAve,11/11/2014 01:00:00 PM,48,-122,37,8,45
7550,58thStGreenway22ndAve,11/11/2014 02:00:00 PM,48,-122,25,5,30
7551,58thStGreenway22ndAve,11/11/2014 03:00:00 PM,48,-122,24,10,34
7552,58thStGreenway22ndAve,11/11/2014 04:00:00 PM,48,-122,35,9,44
7553,58thStGreenway22ndAve,11/11/2014 05:00:00 PM,48,-122,31,11,42
7554,58thStGreenway22ndAve,11/11/2014 06:00:00 PM,48,-122,21,4,25
7555,58thStGreenway22ndAve,11/11/2014 07:00:00 PM,48,-122,22,6,28
7556,58thStGreenway22ndAve,11/11/2014 08:00:00 PM,48,-122,12,1,13
7557,58thStGreenway22ndAve,11/11/2014 09:00:00 PM,48,-122,11,0,11
7558,58thStGreenway22ndAve,11/11/2014 10:00:00 PM,48,-122,11,1,12
7559,58thStGreenway22ndAve,11/11/2014 11:00:00 PM,48,-122,0,1,1
7560,58thStGreenway22ndAve,11/12/2014 12:00:00 AM,48,-122,0,1,1
7561,58thStGreenway22ndAve,11/12/2014 01:00:00 AM,48,-122,0,0,0
7562,58thStGreenway22ndAve,11/12/2014 02:00:00 AM,48,-122,0,0,0
7563,58thStGreenway22ndAve,11/12/2014 03:00:00 AM,48,-122,2,0,2
7564,58thStGreenway22ndAve,11/12/2014 04:00:00 AM,48,-122,0,0,0
7565,58thStGreenway22ndAve,11/12/2014 05:00:00 AM,48,-122,0,0,0
7566,58thStGreenway22ndAve,11/12/2014 06:00:00 AM,48,-122,13,3,16
7567,58thStGreenway22ndAve,11/12/2014 07:00:00 AM,48,-122,16,1,17
7568,58thStGreenway22ndAve,11/12/2014 08:00:00 AM,48,-122,35,9,44
7569,58thStGreenway22ndAve,11/12/2014 09:00:00 AM,48,-122,21,8,29
7570,58thStGreenway22ndAve,11/12/2014 10:00:00 AM,48,-122,32,13,45
7571,58thStGreenway22ndAve,11/12/2014 11:00:00 AM,48,-122,28,8,36
7572,58thStGreenway22ndAve,11/12/2014 12:00:00 PM,48,-122,21,3,24
7573,58thStGreenway22ndAve,11/12/2014 01:00:00 PM,48,-122,17,10,27
7574,58thStGreenway22ndAve,11/12/2014 02:00:00 PM,48,-122,31,8,39
7575,58thStGreenway22ndAve,11/12/2014 03:00:00 PM,48,-122,29,10,39
7576,58thStGreenway22ndAve,11/12/2014 04:00:00 PM,48,-122,35,4,39
7577,58thStGreenway22ndAve,11/12/2014 05:00:00 PM,48,-122,22,8,30
7578,58thStGreenway22ndAve,11/12/2014 06:00:00 PM,48,-122,14,18,32
7579,58thStGreenway22ndAve,11/12/2014 07:00:00 PM,48,-122,30,14,44
7580,58thStGreenway22ndAve,11/12/2014 08:00:00 PM,48,-122,23,5,28
7581,58thStGreenway22ndAve,11/12/2014 09:00:00 PM,48,-122,10,1,11
7582,58thStGreenway22ndAve,11/12/2014 10:00:00 PM,48,-122,3,0,3
7583,58thStGreenway22ndAve,11/12/2014 11:00:00 PM,48,-122,0,0,0
7584,58thStGreenway22ndAve,11/13/2014 12:00:00 AM,48,-122,0,0,0
7585,58thStGreenway22ndAve,11/13/2014 01:00:00 AM,48,-122,0,0,0
7586,58thStGreenway22ndAve,11/13/2014 02:00:00 AM,48,-122,0,0,0
7587,58thStGreenway22ndAve,11/13/2014 03:00:00 AM,48,-122,0,0,0
7588,58thStGreenway22ndAve,11/13/2014 04:00:00 AM,48,-122,0,0,0
7589,58thStGreenway22ndAve,11/13/2014 05:00:00 AM,48,-122,3,0,3
7590,58thStGreenway22ndAve,11/13/2014 06:00:00 AM,48,-122,8,2,10
7591,58thStGreenway22ndAve,11/13/2014 07:00:00 AM,48,-122,22,7,29
7592,58thStGreenway22ndAve,11/13/2014 08:00:00 AM,48,-122,30,8,38
7593,58thStGreenway22ndAve,11/13/2014 09:00:00 AM,48,-122,28,8,36
7594,58thStGreenway22ndAve,11/13/2014 10:00:00 AM,48,-122,29,15,44
7595,58thStGreenway22ndAve,11/13/2014 11:00:00 AM,48,-122,15,7,22
7596,58thStGreenway22ndAve,11/13/2014 12:00:00 PM,48,-122,22,7,29
7597,58thStGreenway22ndAve,11/13/2014 01:00:00 PM,48,-122,41,10,51
7598,58thStGreenway22ndAve,11/13/2014 02:00:00 PM,48,-122,23,6,29
7599,58thStGreenway22ndAve,11/13/2014 03:00:00 PM,48,-122,33,5,38
7600,58thStGreenway22ndAve,11/13/2014 04:00:00 PM,48,-122,30,2,32
7601,58thStGreenway22ndAve,11/13/2014 05:00:00 PM,48,-122,22,17,39
7602,58thStGreenway22ndAve,11/13/2014 06:00:00 PM,48,-122,21,10,31
7603,58thStGreenway22ndAve,11/13/2014 07:00:00 PM,48,-122,18,7,25
7604,58thStGreenway22ndAve,11/13/2014 08:00:00 PM,48,-122,14,9,23
7605,58thStGreenway22ndAve,11/13/2014 09:00:00 PM,48,-122,7,3,10
7606,58thStGreenway22ndAve,11/13/2014 10:00:00 PM,48,-122,4,4,8
7607,58thStGreenway22ndAve,11/13/2014 11:00:00 PM,48,-122,2,0,2
7608,58thStGreenway22ndAve,11/14/2014 12:00:00 AM,48,-122,0,0,0
7609,58thStGreenway22ndAve,11/14/2014 01:00:00 AM,48,-122,0,1,1
7610,58thStGreenway22ndAve,11/14/2014 02:00:00 AM,48,-122,0,0,0
7611,58thStGreenway22ndAve,11/14/2014 03:00:00 AM,48,-122,0,0,0
7612,58thStGreenway22ndAve,11/14/2014 04:00:00 AM,48,-122,0,0,0
7613,58thStGreenway22ndAve,11/14/2014 05:00:00 AM,48,-122,4,0,4
7614,58thStGreenway22ndAve,11/14/2014 06:00:00 AM,48,-122,4,1,5
7615,58thStGreenway22ndAve,11/14/2014 07:00:00 AM,48,-122,21,0,21
7616,58thStGreenway22ndAve,11/14/2014 08:00:00 AM,48,-122,19,4,23
7617,58thStGreenway22ndAve,11/14/2014 09:00:00 AM,48,-122,25,6,31
7618,58thStGreenway22ndAve,11/14/2014 10:00:00 AM,48,-122,30,10,40
7619,58thStGreenway22ndAve,11/14/2014 11:00:00 AM,48,-122,29,3,32
7620,58thStGreenway22ndAve,11/14/2014 12:00:00 PM,48,-122,29,4,33
7621,58thStGreenway22ndAve,11/14/2014 01:00:00 PM,48,-122,33,3,36
7622,58thStGreenway22ndAve,11/14/2014 02:00:00 PM,48,-122,36,12,48
7623,58thStGreenway22ndAve,11/14/2014 03:00:00 PM,48,-122,29,11,40
7624,58thStGreenway22ndAve,11/14/2014 04:00:00 PM,48,-122,41,7,48
7625,58thStGreenway22ndAve,11/14/2014 05:00:00 PM,48,-122,34,9,43
7626,58thStGreenway22ndAve,11/14/2014 06:00:00 PM,48,-122,23,9,32
7627,58thStGreenway22ndAve,11/14/2014 07:00:00 PM,48,-122,41,11,52
7628,58thStGreenway22ndAve,11/14/2014 08:00:00 PM,48,-122,26,4,30
7629,58thStGreenway22ndAve,11/14/2014 09:00:00 PM,48,-122,19,4,23
7630,58thStGreenway22ndAve,11/14/2014 10:00:00 PM,48,-122,12,1,13
7631,58thStGreenway22ndAve,11/14/2014 11:00:00 PM,48,-122,4,1,5
7632,58thStGreenway22ndAve,11/15/2014 12:00:00 AM,48,-122,1,1,2
7633,58thStGreenway22ndAve,11/15/2014 01:00:00 AM,48,-122,7,4,11
7634,58thStGreenway22ndAve,11/15/2014 02:00:00 AM,48,-122,2,0,2
7635,58thStGreenway22ndAve,11/15/2014 03:00:00 AM,48,-122,0,0,0
7636,58thStGreenway22ndAve,11/15/2014 04:00:00 AM,48,-122,0,0,0
7637,58thStGreenway22ndAve,11/15/2014 05:00:00 AM,48,-122,2,0,2
7638,58thStGreenway22ndAve,11/15/2014 06:00:00 AM,48,-122,4,0,4
7639,58thStGreenway22ndAve,11/15/2014 07:00:00 AM,48,-122,2,0,2
7640,58thStGreenway22ndAve,11/15/2014 08:00:00 AM,48,-122,13,2,15
7641,58thStGreenway22ndAve,11/15/2014 09:00:00 AM,48,-122,26,9,35
7642,58thStGreenway22ndAve,11/15/2014 10:00:00 AM,48,-122,43,13,56
7643,58thStGreenway22ndAve,11/15/2014 11:00:00 AM,48,-122,31,11,42
7644,58thStGreenway22ndAve,11/15/2014 12:00:00 PM,48,-122,46,17,63
7645,58thStGreenway22ndAve,11/15/2014 01:00:00 PM,48,-122,33,11,44
7646,58thStGreenway22ndAve,11/15/2014 02:00:00 PM,48,-122,37,7,44
7647,58thStGreenway22ndAve,11/15/2014 03:00:00 PM,48,-122,42,14,56
7648,58thStGreenway22ndAve,11/15/2014 04:00:00 PM,48,-122,37,12,49
7649,58thStGreenway22ndAve,11/15/2014 05:00:00 PM,48,-122,27,3,30
7650,58thStGreenway22ndAve,11/15/2014 06:00:00 PM,48,-122,32,7,39
7651,58thStGreenway22ndAve,11/15/2014 07:00:00 PM,48,-122,26,8,34
7652,58thStGreenway22ndAve,11/15/2014 08:00:00 PM,48,-122,16,1,17
7653,58thStGreenway22ndAve,11/15/2014 09:00:00 PM,48,-122,8,4,12
7654,58thStGreenway22ndAve,11/15/2014 10:00:00 PM,48,-122,11,2,13
7655,58thStGreenway22ndAve,11/15/2014 11:00:00 PM,48,-122,8,2,10
7656,58thStGreenway22ndAve,11/16/2014 12:00:00 AM,48,-122,6,0,6
7657,58thStGreenway22ndAve,11/16/2014 01:00:00 AM,48,-122,2,0,2
7658,58thStGreenway22ndAve,11/16/2014 02:00:00 AM,48,-122,0,0,0
7659,58thStGreenway22ndAve,11/16/2014 03:00:00 AM,48,-122,2,0,2
7660,58thStGreenway22ndAve,11/16/2014 04:00:00 AM,48,-122,0,0,0
7661,58thStGreenway22ndAve,11/16/2014 05:00:00 AM,48,-122,0,0,0
7662,58thStGreenway22ndAve,11/16/2014 06:00:00 AM,48,-122,0,0,0
7663,58thStGreenway22ndAve,11/16/2014 07:00:00 AM,48,-122,7,0,7
7664,58thStGreenway22ndAve,11/16/2014 08:00:00 AM,48,-122,6,2,8
7665,58thStGreenway22ndAve,11/16/2014 09:00:00 AM,48,-122,17,3,20
7666,58thStGreenway22ndAve,11/16/2014 10:00:00 AM,48,-122,22,2,24
7667,58thStGreenway22ndAve,11/16/2014 11:00:00 AM,48,-122,31,12,43
7668,58thStGreenway22ndAve,11/16/2014 12:00:00 PM,48,-122,40,12,52
7669,58thStGreenway22ndAve,11/16/2014 01:00:00 PM,48,-122,41,7,48
7670,58thStGreenway22ndAve,11/16/2014 02:00:00 PM,48,-122,32,14,46
7671,58thStGreenway22ndAve,11/16/2014 03:00:00 PM,48,-122,33,12,45
7672,58thStGreenway22ndAve,11/16/2014 04:00:00 PM,48,-122,27,9,36
7673,58thStGreenway22ndAve,11/16/2014 05:00:00 PM,48,-122,15,12,27
7674,58thStGreenway22ndAve,11/16/2014 06:00:00 PM,48,-122,22,4,26
7675,58thStGreenway22ndAve,11/16/2014 07:00:00 PM,48,-122,16,4,20
7676,58thStGreenway22ndAve,11/16/2014 08:00:00 PM,48,-122,10,2,12
7677,58thStGreenway22ndAve,11/16/2014 09:00:00 PM,48,-122,6,0,6
7678,58thStGreenway22ndAve,11/16/2014 10:00:00 PM,48,-122,8,1,9
7679,58thStGreenway22ndAve,11/16/2014 11:00:00 PM,48,-122,2,2,4
7680,58thStGreenway22ndAve,11/17/2014 12:00:00 AM,48,-122,0,1,1
7681,58thStGreenway22ndAve,11/17/2014 01:00:00 AM,48,-122,0,0,0
7682,58thStGreenway22ndAve,11/17/2014 02:00:00 AM,48,-122,0,0,0
7683,58thStGreenway22ndAve,11/17/2014 03:00:00 AM,48,-122,2,0,2
7684,58thStGreenway22ndAve,11/17/2014 04:00:00 AM,48,-122,2,0,2
7685,58thStGreenway22ndAve,11/17/2014 05:00:00 AM,48,-122,2,0,2
7686,58thStGreenway22ndAve,11/17/2014 06:00:00 AM,48,-122,10,1,11
7687,58thStGreenway22ndAve,11/17/2014 07:00:00 AM,48,-122,23,6,29
7688,58thStGreenway22ndAve,11/17/2014 08:00:00 AM,48,-122,25,13,38
7689,58thStGreenway22ndAve,11/17/2014 09:00:00 AM,48,-122,28,10,38
7690,58thStGreenway22ndAve,11/17/2014 10:00:00 AM,48,-122,18,10,28
7691,58thStGreenway22ndAve,11/17/2014 11:00:00 AM,48,-122,33,7,40
7692,58thStGreenway22ndAve,11/17/2014 12:00:00 PM,48,-122,39,5,44
7693,58thStGreenway22ndAve,11/17/2014 01:00:00 PM,48,-122,18,14,32
7694,58thStGreenway22ndAve,11/17/2014 02:00:00 PM,48,-122,30,6,36
7695,58thStGreenway22ndAve,11/17/2014 03:00:00 PM,48,-122,25,11,36
7696,58thStGreenway22ndAve,11/17/2014 04:00:00 PM,48,-122,32,11,43
7697,58thStGreenway22ndAve,11/17/2014 05:00:00 PM,48,-122,29,6,35
7698,58thStGreenway22ndAve,11/17/2014 06:00:00 PM,48,-122,26,12,38
7699,58thStGreenway22ndAve,11/17/2014 07:00:00 PM,48,-122,20,6,26
7700,58thStGreenway22ndAve,11/17/2014 08:00:00 PM,48,-122,17,5,22
7701,58thStGreenway22ndAve,11/17/2014 09:00:00 PM,48,-122,7,1,8
7702,58thStGreenway22ndAve,11/17/2014 10:00:00 PM,48,-122,12,0,12
7703,58thStGreenway22ndAve,11/17/2014 11:00:00 PM,48,-122,2,0,2
7704,58thStGreenway22ndAve,11/18/2014 12:00:00 AM,48,-122,0,0,0
7705,58thStGreenway22ndAve,11/18/2014 01:00:00 AM,48,-122,0,0,0
7706,58thStGreenway22ndAve,11/18/2014 02:00:00 AM,48,-122,0,0,0
7707,58thStGreenway22ndAve,11/18/2014 03:00:00 AM,48,-122,0,0,0
7708,58thStGreenway22ndAve,11/18/2014 04:00:00 AM,48,-122,0,0,0
7709,58thStGreenway22ndAve,11/18/2014 05:00:00 AM,48,-122,4,1,5
7710,58thStGreenway22ndAve,11/18/2014 06:00:00 AM,48,-122,8,4,12
7711,58thStGreenway22ndAve,11/18/2014 07:00:00 AM,48,-122,26,7,33
7712,58thStGreenway22ndAve,11/18/2014 08:00:00 AM,48,-122,34,11,45
7713,58thStGreenway22ndAve,11/18/2014 09:00:00 AM,48,-122,21,10,31
7714,58thStGreenway22ndAve,11/18/2014 10:00:00 AM,48,-122,22,9,31
7715,58thStGreenway22ndAve,11/18/2014 11:00:00 AM,48,-122,11,5,16
7716,58thStGreenway22ndAve,11/18/2014 12:00:00 PM,48,-122,23,14,37
7717,58thStGreenway22ndAve,11/18/2014 01:00:00 PM,48,-122,29,14,43
7718,58thStGreenway22ndAve,11/18/2014 02:00:00 PM,48,-122,35,8,43
7719,58thStGreenway22ndAve,11/18/2014 03:00:00 PM,48,-122,30,9,39
7720,58thStGreenway22ndAve,11/18/2014 04:00:00 PM,48,-122,22,15,37
7721,58thStGreenway22ndAve,11/18/2014 05:00:00 PM,48,-122,35,13,48
7722,58thStGreenway22ndAve,11/18/2014 06:00:00 PM,48,-122,22,12,34
7723,58thStGreenway22ndAve,11/18/2014 07:00:00 PM,48,-122,26,5,31
7724,58thStGreenway22ndAve,11/18/2014 08:00:00 PM,48,-122,15,9,24
7725,58thStGreenway22ndAve,11/18/2014 09:00:00 PM,48,-122,16,5,21
7726,58thStGreenway22ndAve,11/18/2014 10:00:00 PM,48,-122,3,0,3
7727,58thStGreenway22ndAve,11/18/2014 11:00:00 PM,48,-122,1,0,1
7728,58thStGreenway22ndAve,11/19/2014 12:00:00 AM,48,-122,0,0,0
7729,58thStGreenway22ndAve,11/19/2014 01:00:00 AM,48,-122,0,0,0
7730,58thStGreenway22ndAve,11/19/2014 02:00:00 AM,48,-122,0,0,0
7731,58thStGreenway22ndAve,11/19/2014 03:00:00 AM,48,-122,2,0,2
7732,58thStGreenway22ndAve,11/19/2014 04:00:00 AM,48,-122,2,0,2
7733,58thStGreenway22ndAve,11/19/2014 05:00:00 AM,48,-122,2,3,5
7734,58thStGreenway22ndAve,11/19/2014 06:00:00 AM,48,-122,5,3,8
7735,58thStGreenway22ndAve,11/19/2014 07:00:00 AM,48,-122,40,7,47
7736,58thStGreenway22ndAve,11/19/2014 08:00:00 AM,48,-122,29,11,40
7737,58thStGreenway22ndAve,11/19/2014 09:00:00 AM,48,-122,40,6,46
7738,58thStGreenway22ndAve,11/19/2014 10:00:00 AM,48,-122,18,12,30
7739,58thStGreenway22ndAve,11/19/2014 11:00:00 AM,48,-122,25,9,34
7740,58thStGreenway22ndAve,11/19/2014 12:00:00 PM,48,-122,25,6,31
7741,58thStGreenway22ndAve,11/19/2014 01:00:00 PM,48,-122,31,10,41
7742,58thStGreenway22ndAve,11/19/2014 02:00:00 PM,48,-122,21,13,34
7743,58thStGreenway22ndAve,11/19/2014 03:00:00 PM,48,-122,25,7,32
7744,58thStGreenway22ndAve,11/19/2014 04:00:00 PM,48,-122,36,19,55
7745,58thStGreenway22ndAve,11/19/2014 05:00:00 PM,48,-122,19,6,25
7746,58thStGreenway22ndAve,11/19/2014 06:00:00 PM,48,-122,24,13,37
7747,58thStGreenway22ndAve,11/19/2014 07:00:00 PM,48,-122,27,8,35
7748,58thStGreenway22ndAve,11/19/2014 08:00:00 PM,48,-122,22,2,24
7749,58thStGreenway22ndAve,11/19/2014 09:00:00 PM,48,-122,12,2,14
7750,58thStGreenway22ndAve,11/19/2014 10:00:00 PM,48,-122,9,2,11
7751,58thStGreenway22ndAve,11/19/2014 11:00:00 PM,48,-122,4,0,4
7752,58thStGreenway22ndAve,11/20/2014 12:00:00 AM,48,-122,6,0,6
7753,58thStGreenway22ndAve,11/20/2014 01:00:00 AM,48,-122,0,0,0
7754,58thStGreenway22ndAve,11/20/2014 02:00:00 AM,48,-122,0,0,0
7755,58thStGreenway22ndAve,11/20/2014 03:00:00 AM,48,-122,0,0,0
7756,58thStGreenway22ndAve,11/20/2014 04:00:00 AM,48,-122,0,0,0
7757,58thStGreenway22ndAve,11/20/2014 05:00:00 AM,48,-122,2,1,3
7758,58thStGreenway22ndAve,11/20/2014 06:00:00 AM,48,-122,10,6,16
7759,58thStGreenway22ndAve,11/20/2014 07:00:00 AM,48,-122,20,12,32
7760,58thStGreenway22ndAve,11/20/2014 08:00:00 AM,48,-122,33,4,37
7761,58thStGreenway22ndAve,11/20/2014 09:00:00 AM,48,-122,27,6,33
7762,58thStGreenway22ndAve,11/20/2014 10:00:00 AM,48,-122,14,8,22
7763,58thStGreenway22ndAve,11/20/2014 11:00:00 AM,48,-122,24,12,36
7764,58thStGreenway22ndAve,11/20/2014 12:00:00 PM,48,-122,31,13,44
7765,58thStGreenway22ndAve,11/20/2014 01:00:00 PM,48,-122,21,9,30
7766,58thStGreenway22ndAve,11/20/2014 02:00:00 PM,48,-122,29,5,34
7767,58thStGreenway22ndAve,11/20/2014 03:00:00 PM,48,-122,28,13,41
7768,58thStGreenway22ndAve,11/20/2014 04:00:00 PM,48,-122,15,8,23
7769,58thStGreenway22ndAve,11/20/2014 05:00:00 PM,48,-122,22,10,32
7770,58thStGreenway22ndAve,11/20/2014 06:00:00 PM,48,-122,29,22,51
7771,58thStGreenway22ndAve,11/20/2014 07:00:00 PM,48,-122,24,16,40
7772,58thStGreenway22ndAve,11/20/2014 08:00:00 PM,48,-122,13,11,24
7773,58thStGreenway22ndAve,11/20/2014 09:00:00 PM,48,-122,9,4,13
7774,58thStGreenway22ndAve,11/20/2014 10:00:00 PM,48,-122,8,7,15
7775,58thStGreenway22ndAve,11/20/2014 11:00:00 PM,48,-122,1,2,3
7776,58thStGreenway22ndAve,11/21/2014 12:00:00 AM,48,-122,2,2,4
7777,58thStGreenway22ndAve,11/21/2014 01:00:00 AM,48,-122,4,2,6
7778,58thStGreenway22ndAve,11/21/2014 02:00:00 AM,48,-122,2,2,4
7779,58thStGreenway22ndAve,11/21/2014 03:00:00 AM,48,-122,1,0,1
7780,58thStGreenway22ndAve,11/21/2014 04:00:00 AM,48,-122,0,1,1
7781,58thStGreenway22ndAve,11/21/2014 05:00:00 AM,48,-122,0,0,0
7782,58thStGreenway22ndAve,11/21/2014 06:00:00 AM,48,-122,8,5,13
7783,58thStGreenway22ndAve,11/21/2014 07:00:00 AM,48,-122,25,7,32
7784,58thStGreenway22ndAve,11/21/2014 08:00:00 AM,48,-122,24,7,31
7785,58thStGreenway22ndAve,11/21/2014 09:00:00 AM,48,-122,30,8,38
7786,58thStGreenway22ndAve,11/21/2014 10:00:00 AM,48,-122,12,10,22
7787,58thStGreenway22ndAve,11/21/2014 11:00:00 AM,48,-122,26,5,31
7788,58thStGreenway22ndAve,11/21/2014 12:00:00 PM,48,-122,35,11,46
7789,58thStGreenway22ndAve,11/21/2014 01:00:00 PM,48,-122,29,14,43
7790,58thStGreenway22ndAve,11/21/2014 02:00:00 PM,48,-122,22,9,31
7791,58thStGreenway22ndAve,11/21/2014 03:00:00 PM,48,-122,35,9,44
7792,58thStGreenway22ndAve,11/21/2014 04:00:00 PM,48,-122,26,5,31
7793,58thStGreenway22ndAve,11/21/2014 05:00:00 PM,48,-122,45,8,53
7794,58thStGreenway22ndAve,11/21/2014 06:00:00 PM,48,-122,33,6,39
7795,58thStGreenway22ndAve,11/21/2014 07:00:00 PM,48,-122,22,4,26
7796,58thStGreenway22ndAve,11/21/2014 08:00:00 PM,48,-122,29,2,31
7797,58thStGreenway22ndAve,11/21/2014 09:00:00 PM,48,-122,23,0,23
7798,58thStGreenway22ndAve,11/21/2014 10:00:00 PM,48,-122,3,0,3
7799,58thStGreenway22ndAve,11/21/2014 11:00:00 PM,48,-122,6,0,6
7800,58thStGreenway22ndAve,11/22/2014 12:00:00 AM,48,-122,0,1,1
7801,58thStGreenway22ndAve,11/22/2014 01:00:00 AM,48,-122,6,0,6
7802,58thStGreenway22ndAve,11/22/2014 02:00:00 AM,48,-122,0,0,0
7803,58thStGreenway22ndAve,11/22/2014 03:00:00 AM,48,-122,0,0,0
7804,58thStGreenway22ndAve,11/22/2014 04:00:00 AM,48,-122,4,0,4
7805,58thStGreenway22ndAve,11/22/2014 05:00:00 AM,48,-122,4,0,4
7806,58thStGreenway22ndAve,11/22/2014 06:00:00 AM,48,-122,4,1,5
7807,58thStGreenway22ndAve,11/22/2014 07:00:00 AM,48,-122,9,1,10
7808,58thStGreenway22ndAve,11/22/2014 08:00:00 AM,48,-122,15,7,22
7809,58thStGreenway22ndAve,11/22/2014 09:00:00 AM,48,-122,27,8,35
7810,58thStGreenway22ndAve,11/22/2014 10:00:00 AM,48,-122,41,16,57
7811,58thStGreenway22ndAve,11/22/2014 11:00:00 AM,48,-122,49,13,62
7812,58thStGreenway22ndAve,11/22/2014 12:00:00 PM,48,-122,54,27,81
7813,58thStGreenway22ndAve,11/22/2014 01:00:00 PM,48,-122,44,16,60
7814,58thStGreenway22ndAve,11/22/2014 02:00:00 PM,48,-122,56,16,72
7815,58thStGreenway22ndAve,11/22/2014 03:00:00 PM,48,-122,24,17,41
7816,58thStGreenway22ndAve,11/22/2014 04:00:00 PM,48,-122,33,14,47
7817,58thStGreenway22ndAve,11/22/2014 05:00:00 PM,48,-122,47,14,61
7818,58thStGreenway22ndAve,11/22/2014 06:00:00 PM,48,-122,35,13,48
7819,58thStGreenway22ndAve,11/22/2014 07:00:00 PM,48,-122,17,8,25
7820,58thStGreenway22ndAve,11/22/2014 08:00:00 PM,48,-122,13,13,26
7821,58thStGreenway22ndAve,11/22/2014 09:00:00 PM,48,-122,5,3,8
7822,58thStGreenway22ndAve,11/22/2014 10:00:00 PM,48,-122,5,3,8
7823,58thStGreenway22ndAve,11/22/2014 11:00:00 PM,48,-122,9,4,13
7824,58thStGreenway22ndAve,11/23/2014 12:00:00 AM,48,-122,8,1,9
7825,58thStGreenway22ndAve,11/23/2014 01:00:00 AM,48,-122,4,0,4
7826,58thStGreenway22ndAve,11/23/2014 02:00:00 AM,48,-122,0,0,0
7827,58thStGreenway22ndAve,11/23/2014 03:00:00 AM,48,-122,2,0,2
7828,58thStGreenway22ndAve,11/23/2014 04:00:00 AM,48,-122,0,0,0
7829,58thStGreenway22ndAve,11/23/2014 05:00:00 AM,48,-122,0,0,0
7830,58thStGreenway22ndAve,11/23/2014 06:00:00 AM,48,-122,1,0,1
7831,58thStGreenway22ndAve,11/23/2014 07:00:00 AM,48,-122,4,0,4
7832,58thStGreenway22ndAve,11/23/2014 08:00:00 AM,48,-122,4,0,4
7833,58thStGreenway22ndAve,11/23/2014 09:00:00 AM,48,-122,6,6,12
7834,58thStGreenway22ndAve,11/23/2014 10:00:00 AM,48,-122,26,8,34
7835,58thStGreenway22ndAve,11/23/2014 11:00:00 AM,48,-122,23,8,31
7836,58thStGreenway22ndAve,11/23/2014 12:00:00 PM,48,-122,50,21,71
7837,58thStGreenway22ndAve,11/23/2014 01:00:00 PM,48,-122,40,19,59
7838,58thStGreenway22ndAve,11/23/2014 02:00:00 PM,48,-122,28,13,41
7839,58thStGreenway22ndAve,11/23/2014 03:00:00 PM,48,-122,36,11,47
7840,58thStGreenway22ndAve,11/23/2014 04:00:00 PM,48,-122,6,15,21
7841,58thStGreenway22ndAve,11/23/2014 05:00:00 PM,48,-122,22,10,32
7842,58thStGreenway22ndAve,11/23/2014 06:00:00 PM,48,-122,14,5,19
7843,58thStGreenway22ndAve,11/23/2014 07:00:00 PM,48,-122,9,1,10
7844,58thStGreenway22ndAve,11/23/2014 08:00:00 PM,48,-122,6,1,7
7845,58thStGreenway22ndAve,11/23/2014 09:00:00 PM,48,-122,6,1,7
7846,58thStGreenway22ndAve,11/23/2014 10:00:00 PM,48,-122,7,0,7
7847,58thStGreenway22ndAve,11/23/2014 11:00:00 PM,48,-122,5,2,7
7848,58thStGreenway22ndAve,11/24/2014 12:00:00 AM,48,-122,0,0,0
7849,58thStGreenway22ndAve,11/24/2014 01:00:00 AM,48,-122,2,0,2
7850,58thStGreenway22ndAve,11/24/2014 02:00:00 AM,48,-122,0,0,0
7851,58thStGreenway22ndAve,11/24/2014 03:00:00 AM,48,-122,0,0,0
7852,58thStGreenway22ndAve,11/24/2014 04:00:00 AM,48,-122,0,0,0
7853,58thStGreenway22ndAve,11/24/2014 05:00:00 AM,48,-122,0,0,0
7854,58thStGreenway22ndAve,11/24/2014 06:00:00 AM,48,-122,11,9,20
7855,58thStGreenway22ndAve,11/24/2014 07:00:00 AM,48,-122,39,1,40
7856,58thStGreenway22ndAve,11/24/2014 08:00:00 AM,48,-122,28,5,33
7857,58thStGreenway22ndAve,11/24/2014 09:00:00 AM,48,-122,10,6,16
7858,58thStGreenway22ndAve,11/24/2014 10:00:00 AM,48,-122,15,4,19
7859,58thStGreenway22ndAve,11/24/2014 11:00:00 AM,48,-122,21,7,28
7860,58thStGreenway22ndAve,11/24/2014 12:00:00 PM,48,-122,28,15,43
7861,58thStGreenway22ndAve,11/24/2014 01:00:00 PM,48,-122,31,6,37
7862,58thStGreenway22ndAve,11/24/2014 02:00:00 PM,48,-122,39,3,42
7863,58thStGreenway22ndAve,11/24/2014 03:00:00 PM,48,-122,25,8,33
7864,58thStGreenway22ndAve,11/24/2014 04:00:00 PM,48,-122,29,7,36
7865,58thStGreenway22ndAve,11/24/2014 05:00:00 PM,48,-122,27,12,39
7866,58thStGreenway22ndAve,11/24/2014 06:00:00 PM,48,-122,21,16,37
7867,58thStGreenway22ndAve,11/24/2014 07:00:00 PM,48,-122,15,6,21
7868,58thStGreenway22ndAve,11/24/2014 08:00:00 PM,48,-122,13,4,17
7869,58thStGreenway22ndAve,11/24/2014 09:00:00 PM,48,-122,11,3,14
7870,58thStGreenway22ndAve,11/24/2014 10:00:00 PM,48,-122,9,2,11
7871,58thStGreenway22ndAve,11/24/2014 11:00:00 PM,48,-122,2,0,2
7872,58thStGreenway22ndAve,11/25/2014 12:00:00 AM,48,-122,2,0,2
7873,58thStGreenway22ndAve,11/25/2014 01:00:00 AM,48,-122,0,0,0
7874,58thStGreenway22ndAve,11/25/2014 02:00:00 AM,48,-122,0,2,2
7875,58thStGreenway22ndAve,11/25/2014 03:00:00 AM,48,-122,0,0,0
7876,58thStGreenway22ndAve,11/25/2014 04:00:00 AM,48,-122,0,0,0
7877,58thStGreenway22ndAve,11/25/2014 05:00:00 AM,48,-122,0,0,0
7878,58thStGreenway22ndAve,11/25/2014 06:00:00 AM,48,-122,8,2,10
7879,58thStGreenway22ndAve,11/25/2014 07:00:00 AM,48,-122,14,5,19
7880,58thStGreenway22ndAve,11/25/2014 08:00:00 AM,48,-122,24,17,41
7881,58thStGreenway22ndAve,11/25/2014 09:00:00 AM,48,-122,33,6,39
7882,58thStGreenway22ndAve,11/25/2014 10:00:00 AM,48,-122,25,2,27
7883,58thStGreenway22ndAve,11/25/2014 11:00:00 AM,48,-122,10,13,23
7884,58thStGreenway22ndAve,11/25/2014 12:00:00 PM,48,-122,39,8,47
7885,58thStGreenway22ndAve,11/25/2014 01:00:00 PM,48,-122,19,12,31
7886,58thStGreenway22ndAve,11/25/2014 02:00:00 PM,48,-122,24,4,28
7887,58thStGreenway22ndAve,11/25/2014 03:00:00 PM,48,-122,18,7,25
7888,58thStGreenway22ndAve,11/25/2014 04:00:00 PM,48,-122,13,9,22
7889,58thStGreenway22ndAve,11/25/2014 05:00:00 PM,48,-122,23,7,30
7890,58thStGreenway22ndAve,11/25/2014 06:00:00 PM,48,-122,12,5,17
7891,58thStGreenway22ndAve,11/25/2014 07:00:00 PM,48,-122,15,7,22
7892,58thStGreenway22ndAve,11/25/2014 08:00:00 PM,48,-122,11,4,15
7893,58thStGreenway22ndAve,11/25/2014 09:00:00 PM,48,-122,5,3,8
7894,58thStGreenway22ndAve,11/25/2014 10:00:00 PM,48,-122,6,4,10
7895,58thStGreenway22ndAve,11/25/2014 11:00:00 PM,48,-122,0,1,1
7896,58thStGreenway22ndAve,11/26/2014 12:00:00 AM,48,-122,0,0,0
7897,58thStGreenway22ndAve,11/26/2014 01:00:00 AM,48,-122,3,0,3
7898,58thStGreenway22ndAve,11/26/2014 02:00:00 AM,48,-122,0,0,0
7899,58thStGreenway22ndAve,11/26/2014 03:00:00 AM,48,-122,0,0,0
7900,58thStGreenway22ndAve,11/26/2014 04:00:00 AM,48,-122,0,0,0
7901,58thStGreenway22ndAve,11/26/2014 05:00:00 AM,48,-122,2,0,2
7902,58thStGreenway22ndAve,11/26/2014 06:00:00 AM,48,-122,5,2,7
7903,58thStGreenway22ndAve,11/26/2014 07:00:00 AM,48,-122,14,2,16
7904,58thStGreenway22ndAve,11/26/2014 08:00:00 AM,48,-122,17,7,24
7905,58thStGreenway22ndAve,11/26/2014 09:00:00 AM,48,-122,25,11,36
7906,58thStGreenway22ndAve,11/26/2014 10:00:00 AM,48,-122,35,5,40
7907,58thStGreenway22ndAve,11/26/2014 11:00:00 AM,48,-122,13,7,20
7908,58thStGreenway22ndAve,11/26/2014 12:00:00 PM,48,-122,33,7,40
7909,58thStGreenway22ndAve,11/26/2014 01:00:00 PM,48,-122,42,13,55
7910,58thStGreenway22ndAve,11/26/2014 02:00:00 PM,48,-122,36,11,47
7911,58thStGreenway22ndAve,11/26/2014 03:00:00 PM,48,-122,41,9,50
7912,58thStGreenway22ndAve,11/26/2014 04:00:00 PM,48,-122,26,12,38
7913,58thStGreenway22ndAve,11/26/2014 05:00:00 PM,48,-122,21,4,25
7914,58thStGreenway22ndAve,11/26/2014 06:00:00 PM,48,-122,11,6,17
7915,58thStGreenway22ndAve,11/26/2014 07:00:00 PM,48,-122,5,5,10
7916,58thStGreenway22ndAve,11/26/2014 08:00:00 PM,48,-122,12,5,17
7917,58thStGreenway22ndAve,11/26/2014 09:00:00 PM,48,-122,14,0,14
7918,58thStGreenway22ndAve,11/26/2014 10:00:00 PM,48,-122,7,0,7
7919,58thStGreenway22ndAve,11/26/2014 11:00:00 PM,48,-122,5,2,7
7920,58thStGreenway22ndAve,11/27/2014 12:00:00 AM,48,-122,7,1,8
7921,58thStGreenway22ndAve,11/27/2014 01:00:00 AM,48,-122,7,3,10
7922,58thStGreenway22ndAve,11/27/2014 02:00:00 AM,48,-122,0,2,2
7923,58thStGreenway22ndAve,11/27/2014 03:00:00 AM,48,-122,0,0,0
7924,58thStGreenway22ndAve,11/27/2014 04:00:00 AM,48,-122,2,0,2
7925,58thStGreenway22ndAve,11/27/2014 05:00:00 AM,48,-122,0,0,0
7926,58thStGreenway22ndAve,11/27/2014 06:00:00 AM,48,-122,0,0,0
7927,58thStGreenway22ndAve,11/27/2014 07:00:00 AM,48,-122,0,0,0
7928,58thStGreenway22ndAve,11/27/2014 08:00:00 AM,48,-122,9,10,19
7929,58thStGreenway22ndAve,11/27/2014 09:00:00 AM,48,-122,10,1,11
7930,58thStGreenway22ndAve,11/27/2014 10:00:00 AM,48,-122,20,7,27
7931,58thStGreenway22ndAve,11/27/2014 11:00:00 AM,48,-122,4,5,9
7932,58thStGreenway22ndAve,11/27/2014 12:00:00 PM,48,-122,19,4,23
7933,58thStGreenway22ndAve,11/27/2014 01:00:00 PM,48,-122,21,4,25
7934,58thStGreenway22ndAve,11/27/2014 02:00:00 PM,48,-122,5,4,9
7935,58thStGreenway22ndAve,11/27/2014 03:00:00 PM,48,-122,19,1,20
7936,58thStGreenway22ndAve,11/27/2014 04:00:00 PM,48,-122,12,4,16
7937,58thStGreenway22ndAve,11/27/2014 05:00:00 PM,48,-122,4,1,5
7938,58thStGreenway22ndAve,11/27/2014 06:00:00 PM,48,-122,0,2,2
7939,58thStGreenway22ndAve,11/27/2014 07:00:00 PM,48,-122,8,1,9
7940,58thStGreenway22ndAve,11/27/2014 08:00:00 PM,48,-122,5,3,8
7941,58thStGreenway22ndAve,11/27/2014 09:00:00 PM,48,-122,14,5,19
7942,58thStGreenway22ndAve,11/27/2014 10:00:00 PM,48,-122,6,3,9
7943,58thStGreenway22ndAve,11/27/2014 11:00:00 PM,48,-122,5,0,5
7944,58thStGreenway22ndAve,11/28/2014 12:00:00 AM,48,-122,2,0,2
7945,58thStGreenway22ndAve,11/28/2014 01:00:00 AM,48,-122,0,1,1
7946,58thStGreenway22ndAve,11/28/2014 02:00:00 AM,48,-122,2,0,2
7947,58thStGreenway22ndAve,11/28/2014 03:00:00 AM,48,-122,0,0,0
7948,58thStGreenway22ndAve,11/28/2014 04:00:00 AM,48,-122,0,0,0
7949,58thStGreenway22ndAve,11/28/2014 05:00:00 AM,48,-122,1,0,1
7950,58thStGreenway22ndAve,11/28/2014 06:00:00 AM,48,-122,8,1,9
7951,58thStGreenway22ndAve,11/28/2014 07:00:00 AM,48,-122,8,1,9
7952,58thStGreenway22ndAve,11/28/2014 08:00:00 AM,48,-122,14,2,16
7953,58thStGreenway22ndAve,11/28/2014 09:00:00 AM,48,-122,27,6,33
7954,58thStGreenway22ndAve,11/28/2014 10:00:00 AM,48,-122,5,8,13
7955,58thStGreenway22ndAve,11/28/2014 11:00:00 AM,48,-122,1,18,19
7956,58thStGreenway22ndAve,11/28/2014 12:00:00 PM,48,-122,17,18,35
7957,58thStGreenway22ndAve,11/28/2014 01:00:00 PM,48,-122,10,5,15
7958,58thStGreenway22ndAve,11/28/2014 02:00:00 PM,48,-122,6,14,20
7959,58thStGreenway22ndAve,11/28/2014 03:00:00 PM,48,-122,14,9,23
7960,58thStGreenway22ndAve,11/28/2014 04:00:00 PM,48,-122,15,13,28
7961,58thStGreenway22ndAve,11/28/2014 05:00:00 PM,48,-122,27,13,40
7962,58thStGreenway22ndAve,11/28/2014 06:00:00 PM,48,-122,29,8,37
7963,58thStGreenway22ndAve,11/28/2014 07:00:00 PM,48,-122,4,2,6
7964,58thStGreenway22ndAve,11/28/2014 08:00:00 PM,48,-122,14,0,14
7965,58thStGreenway22ndAve,11/28/2014 09:00:00 PM,48,-122,2,1,3
7966,58thStGreenway22ndAve,11/28/2014 10:00:00 PM,48,-122,15,2,17
7967,58thStGreenway22ndAve,11/28/2014 11:00:00 PM,48,-122,2,1,3
7968,58thStGreenway22ndAve,11/29/2014 12:00:00 AM,48,-122,4,0,4
7969,58thStGreenway22ndAve,11/29/2014 01:00:00 AM,48,-122,2,0,2
7970,58thStGreenway22ndAve,11/29/2014 02:00:00 AM,48,-122,0,0,0
7971,58thStGreenway22ndAve,11/29/2014 03:00:00 AM,48,-122,0,1,1
7972,58thStGreenway22ndAve,11/29/2014 04:00:00 AM,48,-122,0,0,0
7973,58thStGreenway22ndAve,11/29/2014 05:00:00 AM,48,-122,3,1,4
7974,58thStGreenway22ndAve,11/29/2014 06:00:00 AM,48,-122,7,0,7
7975,58thStGreenway22ndAve,11/29/2014 07:00:00 AM,48,-122,0,1,1
7976,58thStGreenway22ndAve,11/29/2014 08:00:00 AM,48,-122,2,5,7
7977,58thStGreenway22ndAve,11/29/2014 09:00:00 AM,48,-122,18,5,23
7978,58thStGreenway22ndAve,11/29/2014 10:00:00 AM,48,-122,20,11,31
7979,58thStGreenway22ndAve,11/29/2014 11:00:00 AM,48,-122,14,5,19
7980,58thStGreenway22ndAve,11/29/2014 12:00:00 PM,48,-122,31,12,43
7981,58thStGreenway22ndAve,11/29/2014 01:00:00 PM,48,-122,26,3,29
7982,58thStGreenway22ndAve,11/29/2014 02:00:00 PM,48,-122,16,7,23
7983,58thStGreenway22ndAve,11/29/2014 03:00:00 PM,48,-122,35,11,46
7984,58thStGreenway22ndAve,11/29/2014 04:00:00 PM,48,-122,28,9,37
7985,58thStGreenway22ndAve,11/29/2014 05:00:00 PM,48,-122,13,5,18
7986,58thStGreenway22ndAve,11/29/2014 06:00:00 PM,48,-122,15,5,20
7987,58thStGreenway22ndAve,11/29/2014 07:00:00 PM,48,-122,16,3,19
7988,58thStGreenway22ndAve,11/29/2014 08:00:00 PM,48,-122,11,3,14
7989,58thStGreenway22ndAve,11/29/2014 09:00:00 PM,48,-122,11,2,13
7990,58thStGreenway22ndAve,11/29/2014 10:00:00 PM,48,-122,7,0,7
7991,58thStGreenway22ndAve,11/29/2014 11:00:00 PM,48,-122,3,2,5
7992,58thStGreenway22ndAve,11/30/2014 12:00:00 AM,48,-122,5,0,5
7993,58thStGreenway22ndAve,11/30/2014 01:00:00 AM,48,-122,2,1,3
7994,58thStGreenway22ndAve,11/30/2014 02:00:00 AM,48,-122,0,0,0
7995,58thStGreenway22ndAve,11/30/2014 03:00:00 AM,48,-122,0,0,0
7996,58thStGreenway22ndAve,11/30/2014 04:00:00 AM,48,-122,2,1,3
7997,58thStGreenway22ndAve,11/30/2014 05:00:00 AM,48,-122,0,0,0
7998,58thStGreenway22ndAve,11/30/2014 06:00:00 AM,48,-122,2,1,3
7999,58thStGreenway22ndAve,11/30/2014 07:00:00 AM,48,-122,0,1,1
8000,58thStGreenway22ndAve,11/30/2014 08:00:00 AM,48,-122,2,0,2
8001,58thStGreenway22ndAve,11/30/2014 09:00:00 AM,48,-122,6,3,9
8002,58thStGreenway22ndAve,11/30/2014 10:00:00 AM,48,-122,8,3,11
8003,58thStGreenway22ndAve,11/30/2014 11:00:00 AM,48,-122,8,6,14
8004,58thStGreenway22ndAve,11/30/2014 12:00:00 PM,48,-122,17,15,32
8005,58thStGreenway22ndAve,11/30/2014 01:00:00 PM,48,-122,28,6,34
8006,58thStGreenway22ndAve,11/30/2014 02:00:00 PM,48,-122,24,12,36
8007,58thStGreenway22ndAve,11/30/2014 03:00:00 PM,48,-122,37,9,46
8008,58thStGreenway22ndAve,11/30/2014 04:00:00 PM,48,-122,24,0,24
8009,58thStGreenway22ndAve,11/30/2014 05:00:00 PM,48,-122,21,3,24
8010,58thStGreenway22ndAve,11/30/2014 06:00:00 PM,48,-122,12,5,17
8011,58thStGreenway22ndAve,11/30/2014 07:00:00 PM,48,-122,9,2,11
8012,58thStGreenway22ndAve,11/30/2014 08:00:00 PM,48,-122,6,1,7
8013,58thStGreenway22ndAve,11/30/2014 09:00:00 PM,48,-122,6,2,8
8014,58thStGreenway22ndAve,11/30/2014 10:00:00 PM,48,-122,10,0,10
8015,58thStGreenway22ndAve,11/30/2014 11:00:00 PM,48,-122,6,0,6
8016,58thStGreenway22ndAve,12/01/2014 12:00:00 AM,48,-122,3,0,3
8017,58thStGreenway22ndAve,12/01/2014 01:00:00 AM,48,-122,4,0,4
8018,58thStGreenway22ndAve,12/01/2014 02:00:00 AM,48,-122,1,2,3
8019,58thStGreenway22ndAve,12/01/2014 03:00:00 AM,48,-122,0,0,0
8020,58thStGreenway22ndAve,12/01/2014 04:00:00 AM,48,-122,0,0,0
8021,58thStGreenway22ndAve,12/01/2014 05:00:00 AM,48,-122,2,0,2
8022,58thStGreenway22ndAve,12/01/2014 06:00:00 AM,48,-122,4,1,5
8023,58thStGreenway22ndAve,12/01/2014 07:00:00 AM,48,-122,18,2,20
8024,58thStGreenway22ndAve,12/01/2014 08:00:00 AM,48,-122,14,7,21
8025,58thStGreenway22ndAve,12/01/2014 09:00:00 AM,48,-122,20,14,34
8026,58thStGreenway22ndAve,12/01/2014 10:00:00 AM,48,-122,23,9,32
8027,58thStGreenway22ndAve,12/01/2014 11:00:00 AM,48,-122,16,4,20
8028,58thStGreenway22ndAve,12/01/2014 12:00:00 PM,48,-122,13,7,20
8029,58thStGreenway22ndAve,12/01/2014 01:00:00 PM,48,-122,28,8,36
8030,58thStGreenway22ndAve,12/01/2014 02:00:00 PM,48,-122,23,8,31
8031,58thStGreenway22ndAve,12/01/2014 03:00:00 PM,48,-122,35,16,51
8032,58thStGreenway22ndAve,12/01/2014 04:00:00 PM,48,-122,41,9,50
8033,58thStGreenway22ndAve,12/01/2014 05:00:00 PM,48,-122,17,10,27
8034,58thStGreenway22ndAve,12/01/2014 06:00:00 PM,48,-122,14,5,19
8035,58thStGreenway22ndAve,12/01/2014 07:00:00 PM,48,-122,17,4,21
8036,58thStGreenway22ndAve,12/01/2014 08:00:00 PM,48,-122,9,6,15
8037,58thStGreenway22ndAve,12/01/2014 09:00:00 PM,48,-122,11,2,13
8038,58thStGreenway22ndAve,12/01/2014 10:00:00 PM,48,-122,7,1,8
8039,58thStGreenway22ndAve,12/01/2014 11:00:00 PM,48,-122,3,3,6
8040,58thStGreenway22ndAve,12/02/2014 12:00:00 AM,48,-122,0,0,0
8041,58thStGreenway22ndAve,12/02/2014 01:00:00 AM,48,-122,0,0,0
8042,58thStGreenway22ndAve,12/02/2014 02:00:00 AM,48,-122,0,0,0
8043,58thStGreenway22ndAve,12/02/2014 03:00:00 AM,48,-122,3,0,3
8044,58thStGreenway22ndAve,12/02/2014 04:00:00 AM,48,-122,0,0,0
8045,58thStGreenway22ndAve,12/02/2014 05:00:00 AM,48,-122,0,0,0
8046,58thStGreenway22ndAve,12/02/2014 06:00:00 AM,48,-122,4,1,5
8047,58thStGreenway22ndAve,12/02/2014 07:00:00 AM,48,-122,14,9,23
8048,58thStGreenway22ndAve,12/02/2014 08:00:00 AM,48,-122,30,7,37
8049,58thStGreenway22ndAve,12/02/2014 09:00:00 AM,48,-122,22,6,28
8050,58thStGreenway22ndAve,12/02/2014 10:00:00 AM,48,-122,19,7,26
8051,58thStGreenway22ndAve,12/02/2014 11:00:00 AM,48,-122,20,9,29
8052,58thStGreenway22ndAve,12/02/2014 12:00:00 PM,48,-122,20,3,23
8053,58thStGreenway22ndAve,12/02/2014 01:00:00 PM,48,-122,23,9,32
8054,58thStGreenway22ndAve,12/02/2014 02:00:00 PM,48,-122,42,5,47
8055,58thStGreenway22ndAve,12/02/2014 03:00:00 PM,48,-122,18,2,20
8056,58thStGreenway22ndAve,12/02/2014 04:00:00 PM,48,-122,23,9,32
8057,58thStGreenway22ndAve,12/02/2014 05:00:00 PM,48,-122,23,7,30
8058,58thStGreenway22ndAve,12/02/2014 06:00:00 PM,48,-122,16,14,30
8059,58thStGreenway22ndAve,12/02/2014 07:00:00 PM,48,-122,21,3,24
8060,58thStGreenway22ndAve,12/02/2014 08:00:00 PM,48,-122,4,3,7
8061,58thStGreenway22ndAve,12/02/2014 09:00:00 PM,48,-122,4,2,6
8062,58thStGreenway22ndAve,12/02/2014 10:00:00 PM,48,-122,6,0,6
8063,58thStGreenway22ndAve,12/02/2014 11:00:00 PM,48,-122,1,0,1
8064,58thStGreenway22ndAve,12/03/2014 12:00:00 AM,48,-122,0,0,0
8065,58thStGreenway22ndAve,12/03/2014 01:00:00 AM,48,-122,3,0,3
8066,58thStGreenway22ndAve,12/03/2014 02:00:00 AM,48,-122,0,0,0
8067,58thStGreenway22ndAve,12/03/2014 03:00:00 AM,48,-122,4,1,5
8068,58thStGreenway22ndAve,12/03/2014 04:00:00 AM,48,-122,2,0,2
8069,58thStGreenway22ndAve,12/03/2014 05:00:00 AM,48,-122,2,0,2
8070,58thStGreenway22ndAve,12/03/2014 06:00:00 AM,48,-122,6,4,10
8071,58thStGreenway22ndAve,12/03/2014 07:00:00 AM,48,-122,10,7,17
8072,58thStGreenway22ndAve,12/03/2014 08:00:00 AM,48,-122,21,13,34
8073,58thStGreenway22ndAve,12/03/2014 09:00:00 AM,48,-122,24,7,31
8074,58thStGreenway22ndAve,12/03/2014 10:00:00 AM,48,-122,18,7,25
8075,58thStGreenway22ndAve,12/03/2014 11:00:00 AM,48,-122,23,7,30
8076,58thStGreenway22ndAve,12/03/2014 12:00:00 PM,48,-122,38,9,47
8077,58thStGreenway22ndAve,12/03/2014 01:00:00 PM,48,-122,22,9,31
8078,58thStGreenway22ndAve,12/03/2014 02:00:00 PM,48,-122,22,18,40
8079,58thStGreenway22ndAve,12/03/2014 03:00:00 PM,48,-122,27,10,37
8080,58thStGreenway22ndAve,12/03/2014 04:00:00 PM,48,-122,32,7,39
8081,58thStGreenway22ndAve,12/03/2014 05:00:00 PM,48,-122,20,10,30
8082,58thStGreenway22ndAve,12/03/2014 06:00:00 PM,48,-122,20,4,24
8083,58thStGreenway22ndAve,12/03/2014 07:00:00 PM,48,-122,13,5,18
8084,58thStGreenway22ndAve,12/03/2014 08:00:00 PM,48,-122,24,2,26
8085,58thStGreenway22ndAve,12/03/2014 09:00:00 PM,48,-122,14,4,18
8086,58thStGreenway22ndAve,12/03/2014 10:00:00 PM,48,-122,5,2,7
8087,58thStGreenway22ndAve,12/03/2014 11:00:00 PM,48,-122,1,0,1
8088,58thStGreenway22ndAve,12/04/2014 12:00:00 AM,48,-122,4,0,4
8089,58thStGreenway22ndAve,12/04/2014 01:00:00 AM,48,-122,2,0,2
8090,58thStGreenway22ndAve,12/04/2014 02:00:00 AM,48,-122,0,0,0
8091,58thStGreenway22ndAve,12/04/2014 03:00:00 AM,48,-122,0,0,0
8092,58thStGreenway22ndAve,12/04/2014 04:00:00 AM,48,-122,2,0,2
8093,58thStGreenway22ndAve,12/04/2014 05:00:00 AM,48,-122,0,1,1
8094,58thStGreenway22ndAve,12/04/2014 06:00:00 AM,48,-122,4,1,5
8095,58thStGreenway22ndAve,12/04/2014 07:00:00 AM,48,-122,22,3,25
8096,58thStGreenway22ndAve,12/04/2014 08:00:00 AM,48,-122,27,7,34
8097,58thStGreenway22ndAve,12/04/2014 09:00:00 AM,48,-122,32,6,38
8098,58thStGreenway22ndAve,12/04/2014 10:00:00 AM,48,-122,17,10,27
8099,58thStGreenway22ndAve,12/04/2014 11:00:00 AM,48,-122,21,4,25
8100,58thStGreenway22ndAve,12/04/2014 12:00:00 PM,48,-122,25,13,38
8101,58thStGreenway22ndAve,12/04/2014 01:00:00 PM,48,-122,27,12,39
8102,58thStGreenway22ndAve,12/04/2014 02:00:00 PM,48,-122,25,14,39
8103,58thStGreenway22ndAve,12/04/2014 03:00:00 PM,48,-122,28,10,38
8104,58thStGreenway22ndAve,12/04/2014 04:00:00 PM,48,-122,20,11,31
8105,58thStGreenway22ndAve,12/04/2014 05:00:00 PM,48,-122,32,5,37
8106,58thStGreenway22ndAve,12/04/2014 06:00:00 PM,48,-122,21,4,25
8107,58thStGreenway22ndAve,12/04/2014 07:00:00 PM,48,-122,13,5,18
8108,58thStGreenway22ndAve,12/04/2014 08:00:00 PM,48,-122,23,9,32
8109,58thStGreenway22ndAve,12/04/2014 09:00:00 PM,48,-122,5,2,7
8110,58thStGreenway22ndAve,12/04/2014 10:00:00 PM,48,-122,7,1,8
8111,58thStGreenway22ndAve,12/04/2014 11:00:00 PM,48,-122,4,0,4
8112,58thStGreenway22ndAve,12/05/2014 12:00:00 AM,48,-122,1,0,1
8113,58thStGreenway22ndAve,12/05/2014 01:00:00 AM,48,-122,2,0,2
8114,58thStGreenway22ndAve,12/05/2014 02:00:00 AM,48,-122,0,0,0
8115,58thStGreenway22ndAve,12/05/2014 03:00:00 AM,48,-122,1,1,2
8116,58thStGreenway22ndAve,12/05/2014 04:00:00 AM,48,-122,0,0,0
8117,58thStGreenway22ndAve,12/05/2014 05:00:00 AM,48,-122,2,1,3
8118,58thStGreenway22ndAve,12/05/2014 06:00:00 AM,48,-122,11,4,15
8119,58thStGreenway22ndAve,12/05/2014 07:00:00 AM,48,-122,17,7,24
8120,58thStGreenway22ndAve,12/05/2014 08:00:00 AM,48,-122,36,10,46
8121,58thStGreenway22ndAve,12/05/2014 09:00:00 AM,48,-122,31,11,42
8122,58thStGreenway22ndAve,12/05/2014 10:00:00 AM,48,-122,16,9,25
8123,58thStGreenway22ndAve,12/05/2014 11:00:00 AM,48,-122,14,13,27
8124,58thStGreenway22ndAve,12/05/2014 12:00:00 PM,48,-122,13,9,22
8125,58thStGreenway22ndAve,12/05/2014 01:00:00 PM,48,-122,21,15,36
8126,58thStGreenway22ndAve,12/05/2014 02:00:00 PM,48,-122,27,12,39
8127,58thStGreenway22ndAve,12/05/2014 03:00:00 PM,48,-122,19,9,28
8128,58thStGreenway22ndAve,12/05/2014 04:00:00 PM,48,-122,27,8,35
8129,58thStGreenway22ndAve,12/05/2014 05:00:00 PM,48,-122,35,21,56
8130,58thStGreenway22ndAve,12/05/2014 06:00:00 PM,48,-122,26,13,39
8131,58thStGreenway22ndAve,12/05/2014 07:00:00 PM,48,-122,29,6,35
8132,58thStGreenway22ndAve,12/05/2014 08:00:00 PM,48,-122,12,2,14
8133,58thStGreenway22ndAve,12/05/2014 09:00:00 PM,48,-122,8,2,10
8134,58thStGreenway22ndAve,12/05/2014 10:00:00 PM,48,-122,6,2,8
8135,58thStGreenway22ndAve,12/05/2014 11:00:00 PM,48,-122,2,2,4
8136,58thStGreenway22ndAve,12/06/2014 12:00:00 AM,48,-122,2,0,2
8137,58thStGreenway22ndAve,12/06/2014 01:00:00 AM,48,-122,1,0,1
8138,58thStGreenway22ndAve,12/06/2014 02:00:00 AM,48,-122,0,0,0
8139,58thStGreenway22ndAve,12/06/2014 03:00:00 AM,48,-122,0,1,1
8140,58thStGreenway22ndAve,12/06/2014 04:00:00 AM,48,-122,0,0,0
8141,58thStGreenway22ndAve,12/06/2014 05:00:00 AM,48,-122,2,0,2
8142,58thStGreenway22ndAve,12/06/2014 06:00:00 AM,48,-122,0,0,0
8143,58thStGreenway22ndAve,12/06/2014 07:00:00 AM,48,-122,1,1,2
8144,58thStGreenway22ndAve,12/06/2014 08:00:00 AM,48,-122,11,6,17
8145,58thStGreenway22ndAve,12/06/2014 09:00:00 AM,48,-122,34,4,38
8146,58thStGreenway22ndAve,12/06/2014 10:00:00 AM,48,-122,26,18,44
8147,58thStGreenway22ndAve,12/06/2014 11:00:00 AM,48,-122,38,18,56
8148,58thStGreenway22ndAve,12/06/2014 12:00:00 PM,48,-122,25,18,43
8149,58thStGreenway22ndAve,12/06/2014 01:00:00 PM,48,-122,68,34,102
8150,58thStGreenway22ndAve,12/06/2014 02:00:00 PM,48,-122,38,21,59
8151,58thStGreenway22ndAve,12/06/2014 03:00:00 PM,48,-122,34,10,44
8152,58thStGreenway22ndAve,12/06/2014 04:00:00 PM,48,-122,27,18,45
8153,58thStGreenway22ndAve,12/06/2014 05:00:00 PM,48,-122,43,14,57
8154,58thStGreenway22ndAve,12/06/2014 06:00:00 PM,48,-122,36,15,51
8155,58thStGreenway22ndAve,12/06/2014 07:00:00 PM,48,-122,50,18,68
8156,58thStGreenway22ndAve,12/06/2014 08:00:00 PM,48,-122,11,3,14
8157,58thStGreenway22ndAve,12/06/2014 09:00:00 PM,48,-122,12,1,13
8158,58thStGreenway22ndAve,12/06/2014 10:00:00 PM,48,-122,11,3,14
8159,58thStGreenway22ndAve,12/06/2014 11:00:00 PM,48,-122,10,1,11
8160,58thStGreenway22ndAve,12/07/2014 12:00:00 AM,48,-122,4,0,4
8161,58thStGreenway22ndAve,12/07/2014 01:00:00 AM,48,-122,11,2,13
8162,58thStGreenway22ndAve,12/07/2014 02:00:00 AM,48,-122,2,0,2
8163,58thStGreenway22ndAve,12/07/2014 03:00:00 AM,48,-122,0,0,0
8164,58thStGreenway22ndAve,12/07/2014 04:00:00 AM,48,-122,3,0,3
8165,58thStGreenway22ndAve,12/07/2014 05:00:00 AM,48,-122,4,0,4
8166,58thStGreenway22ndAve,12/07/2014 06:00:00 AM,48,-122,2,0,2
8167,58thStGreenway22ndAve,12/07/2014 07:00:00 AM,48,-122,4,1,5
8168,58thStGreenway22ndAve,12/07/2014 08:00:00 AM,48,-122,12,1,13
8169,58thStGreenway22ndAve,12/07/2014 09:00:00 AM,48,-122,14,4,18
8170,58thStGreenway22ndAve,12/07/2014 10:00:00 AM,48,-122,14,7,21
8171,58thStGreenway22ndAve,12/07/2014 11:00:00 AM,48,-122,30,13,43
8172,58thStGreenway22ndAve,12/07/2014 12:00:00 PM,48,-122,42,10,52
8173,58thStGreenway22ndAve,12/07/2014 01:00:00 PM,48,-122,64,22,86
8174,58thStGreenway22ndAve,12/07/2014 02:00:00 PM,48,-122,58,22,80
8175,58thStGreenway22ndAve,12/07/2014 03:00:00 PM,48,-122,40,8,48
8176,58thStGreenway22ndAve,12/07/2014 04:00:00 PM,48,-122,38,6,44
8177,58thStGreenway22ndAve,12/07/2014 05:00:00 PM,48,-122,19,13,32
8178,58thStGreenway22ndAve,12/07/2014 06:00:00 PM,48,-122,19,10,29
8179,58thStGreenway22ndAve,12/07/2014 07:00:00 PM,48,-122,10,2,12
8180,58thStGreenway22ndAve,12/07/2014 08:00:00 PM,48,-122,4,1,5
8181,58thStGreenway22ndAve,12/07/2014 09:00:00 PM,48,-122,3,1,4
8182,58thStGreenway22ndAve,12/07/2014 10:00:00 PM,48,-122,1,0,1
8183,58thStGreenway22ndAve,12/07/2014 11:00:00 PM,48,-122,2,0,2
8184,58thStGreenway22ndAve,12/08/2014 12:00:00 AM,48,-122,0,0,0
8185,58thStGreenway22ndAve,12/08/2014 01:00:00 AM,48,-122,0,0,0
8186,58thStGreenway22ndAve,12/08/2014 02:00:00 AM,48,-122,3,0,3
8187,58thStGreenway22ndAve,12/08/2014 03:00:00 AM,48,-122,0,1,1
8188,58thStGreenway22ndAve,12/08/2014 04:00:00 AM,48,-122,0,0,0
8189,58thStGreenway22ndAve,12/08/2014 05:00:00 AM,48,-122,0,1,1
8190,58thStGreenway22ndAve,12/08/2014 06:00:00 AM,48,-122,2,2,4
8191,58thStGreenway22ndAve,12/08/2014 07:00:00 AM,48,-122,19,7,26
8192,58thStGreenway22ndAve,12/08/2014 08:00:00 AM,48,-122,22,10,32
8193,58thStGreenway22ndAve,12/08/2014 09:00:00 AM,48,-122,30,9,39
8194,58thStGreenway22ndAve,12/08/2014 10:00:00 AM,48,-122,22,14,36
8195,58thStGreenway22ndAve,12/08/2014 11:00:00 AM,48,-122,29,16,45
8196,58thStGreenway22ndAve,12/08/2014 12:00:00 PM,48,-122,25,18,43
8197,58thStGreenway22ndAve,12/08/2014 01:00:00 PM,48,-122,15,10,25
8198,58thStGreenway22ndAve,12/08/2014 02:00:00 PM,48,-122,28,17,45
8199,58thStGreenway22ndAve,12/08/2014 03:00:00 PM,48,-122,24,11,35
8200,58thStGreenway22ndAve,12/08/2014 04:00:00 PM,48,-122,29,15,44
8201,58thStGreenway22ndAve,12/08/2014 05:00:00 PM,48,-122,25,20,45
8202,58thStGreenway22ndAve,12/08/2014 06:00:00 PM,48,-122,24,16,40
8203,58thStGreenway22ndAve,12/08/2014 07:00:00 PM,48,-122,34,10,44
8204,58thStGreenway22ndAve,12/08/2014 08:00:00 PM,48,-122,20,9,29
8205,58thStGreenway22ndAve,12/08/2014 09:00:00 PM,48,-122,12,2,14
8206,58thStGreenway22ndAve,12/08/2014 10:00:00 PM,48,-122,9,2,11
8207,58thStGreenway22ndAve,12/08/2014 11:00:00 PM,48,-122,4,0,4
8208,58thStGreenway22ndAve,12/09/2014 12:00:00 AM,48,-122,0,2,2
8209,58thStGreenway22ndAve,12/09/2014 01:00:00 AM,48,-122,5,0,5
8210,58thStGreenway22ndAve,12/09/2014 02:00:00 AM,48,-122,0,0,0
8211,58thStGreenway22ndAve,12/09/2014 03:00:00 AM,48,-122,2,0,2
8212,58thStGreenway22ndAve,12/09/2014 04:00:00 AM,48,-122,0,0,0
8213,58thStGreenway22ndAve,12/09/2014 05:00:00 AM,48,-122,0,2,2
8214,58thStGreenway22ndAve,12/09/2014 06:00:00 AM,48,-122,11,4,15
8215,58thStGreenway22ndAve,12/09/2014 07:00:00 AM,48,-122,32,2,34
8216,58thStGreenway22ndAve,12/09/2014 08:00:00 AM,48,-122,24,8,32
8217,58thStGreenway22ndAve,12/09/2014 09:00:00 AM,48,-122,33,10,43
8218,58thStGreenway22ndAve,12/09/2014 10:00:00 AM,48,-122,17,13,30
8219,58thStGreenway22ndAve,12/09/2014 11:00:00 AM,48,-122,35,13,48
8220,58thStGreenway22ndAve,12/09/2014 12:00:00 PM,48,-122,24,5,29
8221,58thStGreenway22ndAve,12/09/2014 01:00:00 PM,48,-122,29,15,44
8222,58thStGreenway22ndAve,12/09/2014 02:00:00 PM,48,-122,22,15,37
8223,58thStGreenway22ndAve,12/09/2014 03:00:00 PM,48,-122,42,13,55
8224,58thStGreenway22ndAve,12/09/2014 04:00:00 PM,48,-122,21,13,34
8225,58thStGreenway22ndAve,12/09/2014 05:00:00 PM,48,-122,31,12,43
8226,58thStGreenway22ndAve,12/09/2014 06:00:00 PM,48,-122,39,16,55
8227,58thStGreenway22ndAve,12/09/2014 07:00:00 PM,48,-122,26,18,44
8228,58thStGreenway22ndAve,12/09/2014 08:00:00 PM,48,-122,21,7,28
8229,58thStGreenway22ndAve,12/09/2014 09:00:00 PM,48,-122,24,5,29
8230,58thStGreenway22ndAve,12/09/2014 10:00:00 PM,48,-122,2,2,4
8231,58thStGreenway22ndAve,12/09/2014 11:00:00 PM,48,-122,4,1,5
8232,58thStGreenway22ndAve,12/10/2014 12:00:00 AM,48,-122,2,0,2
8233,58thStGreenway22ndAve,12/10/2014 01:00:00 AM,48,-122,2,0,2
8234,58thStGreenway22ndAve,12/10/2014 02:00:00 AM,48,-122,0,0,0
8235,58thStGreenway22ndAve,12/10/2014 03:00:00 AM,48,-122,0,1,1
8236,58thStGreenway22ndAve,12/10/2014 04:00:00 AM,48,-122,2,0,2
8237,58thStGreenway22ndAve,12/10/2014 05:00:00 AM,48,-122,5,5,10
8238,58thStGreenway22ndAve,12/10/2014 06:00:00 AM,48,-122,12,6,18
8239,58thStGreenway22ndAve,12/10/2014 07:00:00 AM,48,-122,25,4,29
8240,58thStGreenway22ndAve,12/10/2014 08:00:00 AM,48,-122,31,14,45
8241,58thStGreenway22ndAve,12/10/2014 09:00:00 AM,48,-122,18,8,26
8242,58thStGreenway22ndAve,12/10/2014 10:00:00 AM,48,-122,35,4,39
8243,58thStGreenway22ndAve,12/10/2014 11:00:00 AM,48,-122,32,17,49
8244,58thStGreenway22ndAve,12/10/2014 12:00:00 PM,48,-122,30,4,34
8245,58thStGreenway22ndAve,12/10/2014 01:00:00 PM,48,-122,30,16,46
8246,58thStGreenway22ndAve,12/10/2014 02:00:00 PM,48,-122,30,18,48
8247,58thStGreenway22ndAve,12/10/2014 03:00:00 PM,48,-122,19,10,29
8248,58thStGreenway22ndAve,12/10/2014 04:00:00 PM,48,-122,25,10,35
8249,58thStGreenway22ndAve,12/10/2014 05:00:00 PM,48,-122,37,29,66
8250,58thStGreenway22ndAve,12/10/2014 06:00:00 PM,48,-122,22,11,33
8251,58thStGreenway22ndAve,12/10/2014 07:00:00 PM,48,-122,19,6,25
8252,58thStGreenway22ndAve,12/10/2014 08:00:00 PM,48,-122,27,3,30
8253,58thStGreenway22ndAve,12/10/2014 09:00:00 PM,48,-122,13,1,14
8254,58thStGreenway22ndAve,12/10/2014 10:00:00 PM,48,-122,3,2,5
8255,58thStGreenway22ndAve,12/10/2014 11:00:00 PM,48,-122,3,2,5
8256,58thStGreenway22ndAve,12/11/2014 12:00:00 AM,48,-122,0,1,1
8257,58thStGreenway22ndAve,12/11/2014 01:00:00 AM,48,-122,4,0,4
8258,58thStGreenway22ndAve,12/11/2014 02:00:00 AM,48,-122,0,0,0
8259,58thStGreenway22ndAve,12/11/2014 03:00:00 AM,48,-122,0,0,0
8260,58thStGreenway22ndAve,12/11/2014 04:00:00 AM,48,-122,5,0,5
8261,58thStGreenway22ndAve,12/11/2014 05:00:00 AM,48,-122,3,1,4
8262,58thStGreenway22ndAve,12/11/2014 06:00:00 AM,48,-122,20,0,20
8263,58thStGreenway22ndAve,12/11/2014 07:00:00 AM,48,-122,29,0,29
8264,58thStGreenway22ndAve,12/11/2014 08:00:00 AM,48,-122,25,4,29
8265,58thStGreenway22ndAve,12/11/2014 09:00:00 AM,48,-122,28,9,37
8266,58thStGreenway22ndAve,12/11/2014 10:00:00 AM,48,-122,26,13,39
8267,58thStGreenway22ndAve,12/11/2014 11:00:00 AM,48,-122,26,11,37
8268,58thStGreenway22ndAve,12/11/2014 12:00:00 PM,48,-122,31,9,40
8269,58thStGreenway22ndAve,12/11/2014 01:00:00 PM,48,-122,26,14,40
8270,58thStGreenway22ndAve,12/11/2014 02:00:00 PM,48,-122,25,9,34
8271,58thStGreenway22ndAve,12/11/2014 03:00:00 PM,48,-122,23,4,27
8272,58thStGreenway22ndAve,12/11/2014 04:00:00 PM,48,-122,41,10,51
8273,58thStGreenway22ndAve,12/11/2014 05:00:00 PM,48,-122,48,18,66
8274,58thStGreenway22ndAve,12/11/2014 06:00:00 PM,48,-122,37,16,53
8275,58thStGreenway22ndAve,12/11/2014 07:00:00 PM,48,-122,17,20,37
8276,58thStGreenway22ndAve,12/11/2014 08:00:00 PM,48,-122,20,15,35
8277,58thStGreenway22ndAve,12/11/2014 09:00:00 PM,48,-122,10,1,11
8278,58thStGreenway22ndAve,12/11/2014 10:00:00 PM,48,-122,5,4,9
8279,58thStGreenway22ndAve,12/11/2014 11:00:00 PM,48,-122,4,7,11
8280,58thStGreenway22ndAve,12/12/2014 12:00:00 AM,48,-122,4,1,5
8281,58thStGreenway22ndAve,12/12/2014 01:00:00 AM,48,-122,0,0,0
8282,58thStGreenway22ndAve,12/12/2014 02:00:00 AM,48,-122,0,0,0
8283,58thStGreenway22ndAve,12/12/2014 03:00:00 AM,48,-122,4,0,4
8284,58thStGreenway22ndAve,12/12/2014 04:00:00 AM,48,-122,0,3,3
8285,58thStGreenway22ndAve,12/12/2014 05:00:00 AM,48,-122,1,0,1
8286,58thStGreenway22ndAve,12/12/2014 06:00:00 AM,48,-122,18,2,20
8287,58thStGreenway22ndAve,12/12/2014 07:00:00 AM,48,-122,48,11,59
8288,58thStGreenway22ndAve,12/12/2014 08:00:00 AM,48,-122,31,8,39
8289,58thStGreenway22ndAve,12/12/2014 09:00:00 AM,48,-122,36,17,53
8290,58thStGreenway22ndAve,12/12/2014 10:00:00 AM,48,-122,21,9,30
8291,58thStGreenway22ndAve,12/12/2014 11:00:00 AM,48,-122,39,12,51
8292,58thStGreenway22ndAve,12/12/2014 12:00:00 PM,48,-122,32,11,43
8293,58thStGreenway22ndAve,12/12/2014 01:00:00 PM,48,-122,35,11,46
8294,58thStGreenway22ndAve,12/12/2014 02:00:00 PM,48,-122,5,7,12
8295,58thStGreenway22ndAve,12/12/2014 03:00:00 PM,48,-122,39,11,50
8296,58thStGreenway22ndAve,12/12/2014 04:00:00 PM,48,-122,49,7,56
8297,58thStGreenway22ndAve,12/12/2014 05:00:00 PM,48,-122,31,20,51
8298,58thStGreenway22ndAve,12/12/2014 06:00:00 PM,48,-122,23,15,38
8299,58thStGreenway22ndAve,12/12/2014 07:00:00 PM,48,-122,33,12,45
8300,58thStGreenway22ndAve,12/12/2014 08:00:00 PM,48,-122,16,6,22
8301,58thStGreenway22ndAve,12/12/2014 09:00:00 PM,48,-122,21,4,25
8302,58thStGreenway22ndAve,12/12/2014 10:00:00 PM,48,-122,16,3,19
8303,58thStGreenway22ndAve,12/12/2014 11:00:00 PM,48,-122,21,0,21
8304,58thStGreenway22ndAve,12/13/2014 12:00:00 AM,48,-122,8,1,9
8305,58thStGreenway22ndAve,12/13/2014 01:00:00 AM,48,-122,10,1,11
8306,58thStGreenway22ndAve,12/13/2014 02:00:00 AM,48,-122,2,1,3
8307,58thStGreenway22ndAve,12/13/2014 03:00:00 AM,48,-122,0,0,0
8308,58thStGreenway22ndAve,12/13/2014 04:00:00 AM,48,-122,2,0,2
8309,58thStGreenway22ndAve,12/13/2014 05:00:00 AM,48,-122,2,0,2
8310,58thStGreenway22ndAve,12/13/2014 06:00:00 AM,48,-122,7,3,10
8311,58thStGreenway22ndAve,12/13/2014 07:00:00 AM,48,-122,3,2,5
8312,58thStGreenway22ndAve,12/13/2014 08:00:00 AM,48,-122,6,5,11
8313,58thStGreenway22ndAve,12/13/2014 09:00:00 AM,48,-122,32,4,36
8314,58thStGreenway22ndAve,12/13/2014 10:00:00 AM,48,-122,0,0,0
8315,58thStGreenway22ndAve,12/13/2014 11:00:00 AM,48,-122,0,0,0
8316,58thStGreenway22ndAve,12/13/2014 12:00:00 PM,48,-122,28,13,41
8317,58thStGreenway22ndAve,12/13/2014 01:00:00 PM,48,-122,51,17,68
8318,58thStGreenway22ndAve,12/13/2014 02:00:00 PM,48,-122,36,11,47
8319,58thStGreenway22ndAve,12/13/2014 03:00:00 PM,48,-122,43,13,56
8320,58thStGreenway22ndAve,12/13/2014 04:00:00 PM,48,-122,46,17,63
8321,58thStGreenway22ndAve,12/13/2014 05:00:00 PM,48,-122,35,13,48
8322,58thStGreenway22ndAve,12/13/2014 06:00:00 PM,48,-122,24,13,37
8323,58thStGreenway22ndAve,12/13/2014 07:00:00 PM,48,-122,24,5,29
8324,58thStGreenway22ndAve,12/13/2014 08:00:00 PM,48,-122,13,6,19
8325,58thStGreenway22ndAve,12/13/2014 09:00:00 PM,48,-122,6,3,9
8326,58thStGreenway22ndAve,12/13/2014 10:00:00 PM,48,-122,19,5,24
8327,58thStGreenway22ndAve,12/13/2014 11:00:00 PM,48,-122,9,2,11
8328,58thStGreenway22ndAve,12/14/2014 12:00:00 AM,48,-122,6,2,8
8329,58thStGreenway22ndAve,12/14/2014 01:00:00 AM,48,-122,2,2,4
8330,58thStGreenway22ndAve,12/14/2014 02:00:00 AM,48,-122,2,1,3
8331,58thStGreenway22ndAve,12/14/2014 03:00:00 AM,48,-122,4,2,6
8332,58thStGreenway22ndAve,12/14/2014 04:00:00 AM,48,-122,0,0,0
8333,58thStGreenway22ndAve,12/14/2014 05:00:00 AM,48,-122,3,0,3
8334,58thStGreenway22ndAve,12/14/2014 06:00:00 AM,48,-122,0,0,0
8335,58thStGreenway22ndAve,12/14/2014 07:00:00 AM,48,-122,2,0,2
8336,58thStGreenway22ndAve,12/14/2014 08:00:00 AM,48,-122,3,5,8
8337,58thStGreenway22ndAve,12/14/2014 09:00:00 AM,48,-122,18,8,26
8338,58thStGreenway22ndAve,12/14/2014 10:00:00 AM,48,-122,24,2,26
8339,58thStGreenway22ndAve,12/14/2014 11:00:00 AM,48,-122,53,22,75
8340,58thStGreenway22ndAve,12/14/2014 12:00:00 PM,48,-122,57,23,80
8341,58thStGreenway22ndAve,12/14/2014 01:00:00 PM,48,-122,70,14,84
8342,58thStGreenway22ndAve,12/14/2014 02:00:00 PM,48,-122,41,9,50
8343,58thStGreenway22ndAve,12/14/2014 03:00:00 PM,48,-122,16,10,26
8344,58thStGreenway22ndAve,12/14/2014 04:00:00 PM,48,-122,45,12,57
8345,58thStGreenway22ndAve,12/14/2014 05:00:00 PM,48,-122,35,1,36
8346,58thStGreenway22ndAve,12/14/2014 06:00:00 PM,48,-122,29,8,37
8347,58thStGreenway22ndAve,12/14/2014 07:00:00 PM,48,-122,9,5,14
8348,58thStGreenway22ndAve,12/14/2014 08:00:00 PM,48,-122,10,2,12
8349,58thStGreenway22ndAve,12/14/2014 09:00:00 PM,48,-122,9,1,10
8350,58thStGreenway22ndAve,12/14/2014 10:00:00 PM,48,-122,3,1,4
8351,58thStGreenway22ndAve,12/14/2014 11:00:00 PM,48,-122,3,1,4
8352,58thStGreenway22ndAve,12/15/2014 12:00:00 AM,48,-122,2,0,2
8353,58thStGreenway22ndAve,12/15/2014 01:00:00 AM,48,-122,2,0,2
8354,58thStGreenway22ndAve,12/15/2014 02:00:00 AM,48,-122,1,1,2
8355,58thStGreenway22ndAve,12/15/2014 03:00:00 AM,48,-122,2,0,2
8356,58thStGreenway22ndAve,12/15/2014 04:00:00 AM,48,-122,0,0,0
8357,58thStGreenway22ndAve,12/15/2014 05:00:00 AM,48,-122,0,0,0
8358,58thStGreenway22ndAve,12/15/2014 06:00:00 AM,48,-122,16,4,20
8359,58thStGreenway22ndAve,12/15/2014 07:00:00 AM,48,-122,21,2,23
8360,58thStGreenway22ndAve,12/15/2014 08:00:00 AM,48,-122,32,5,37
8361,58thStGreenway22ndAve,12/15/2014 09:00:00 AM,48,-122,41,18,59
8362,58thStGreenway22ndAve,12/15/2014 10:00:00 AM,48,-122,27,13,40
8363,58thStGreenway22ndAve,12/15/2014 11:00:00 AM,48,-122,30,19,49
8364,58thStGreenway22ndAve,12/15/2014 12:00:00 PM,48,-122,31,11,42
8365,58thStGreenway22ndAve,12/15/2014 01:00:00 PM,48,-122,37,8,45
8366,58thStGreenway22ndAve,12/15/2014 02:00:00 PM,48,-122,30,10,40
8367,58thStGreenway22ndAve,12/15/2014 03:00:00 PM,48,-122,47,6,53
8368,58thStGreenway22ndAve,12/15/2014 04:00:00 PM,48,-122,27,11,38
8369,58thStGreenway22ndAve,12/15/2014 05:00:00 PM,48,-122,26,17,43
8370,58thStGreenway22ndAve,12/15/2014 06:00:00 PM,48,-122,22,14,36
8371,58thStGreenway22ndAve,12/15/2014 07:00:00 PM,48,-122,26,6,32
8372,58thStGreenway22ndAve,12/15/2014 08:00:00 PM,48,-122,14,3,17
8373,58thStGreenway22ndAve,12/15/2014 09:00:00 PM,48,-122,19,1,20
8374,58thStGreenway22ndAve,12/15/2014 10:00:00 PM,48,-122,7,0,7
8375,58thStGreenway22ndAve,12/15/2014 11:00:00 PM,48,-122,5,2,7
8376,58thStGreenway22ndAve,12/16/2014 12:00:00 AM,48,-122,4,3,7
8377,58thStGreenway22ndAve,12/16/2014 01:00:00 AM,48,-122,3,1,4
8378,58thStGreenway22ndAve,12/16/2014 02:00:00 AM,48,-122,4,0,4
8379,58thStGreenway22ndAve,12/16/2014 03:00:00 AM,48,-122,2,0,2
8380,58thStGreenway22ndAve,12/16/2014 04:00:00 AM,48,-122,2,0,2
8381,58thStGreenway22ndAve,12/16/2014 05:00:00 AM,48,-122,4,2,6
8382,58thStGreenway22ndAve,12/16/2014 06:00:00 AM,48,-122,8,2,10
8383,58thStGreenway22ndAve,12/16/2014 07:00:00 AM,48,-122,20,3,23
8384,58thStGreenway22ndAve,12/16/2014 08:00:00 AM,48,-122,37,9,46
8385,58thStGreenway22ndAve,12/16/2014 09:00:00 AM,48,-122,44,13,57
8386,58thStGreenway22ndAve,12/16/2014 10:00:00 AM,48,-122,31,11,42
8387,58thStGreenway22ndAve,12/16/2014 11:00:00 AM,48,-122,19,9,28
8388,58thStGreenway22ndAve,12/16/2014 12:00:00 PM,48,-122,37,13,50
8389,58thStGreenway22ndAve,12/16/2014 01:00:00 PM,48,-122,40,22,62
8390,58thStGreenway22ndAve,12/16/2014 02:00:00 PM,48,-122,47,16,63
8391,58thStGreenway22ndAve,12/16/2014 03:00:00 PM,48,-122,40,7,47
8392,58thStGreenway22ndAve,12/16/2014 04:00:00 PM,48,-122,47,8,55
8393,58thStGreenway22ndAve,12/16/2014 05:00:00 PM,48,-122,44,14,58
8394,58thStGreenway22ndAve,12/16/2014 06:00:00 PM,48,-122,18,11,29
8395,58thStGreenway22ndAve,12/16/2014 07:00:00 PM,48,-122,23,24,47
8396,58thStGreenway22ndAve,12/16/2014 08:00:00 PM,48,-122,17,2,19
8397,58thStGreenway22ndAve,12/16/2014 09:00:00 PM,48,-122,22,1,23
8398,58thStGreenway22ndAve,12/16/2014 10:00:00 PM,48,-122,10,0,10
8399,58thStGreenway22ndAve,12/16/2014 11:00:00 PM,48,-122,4,0,4
8400,58thStGreenway22ndAve,12/17/2014 12:00:00 AM,48,-122,3,0,3
8401,58thStGreenway22ndAve,12/17/2014 01:00:00 AM,48,-122,0,1,1
8402,58thStGreenway22ndAve,12/17/2014 02:00:00 AM,48,-122,2,0,2
8403,58thStGreenway22ndAve,12/17/2014 03:00:00 AM,48,-122,0,0,0
8404,58thStGreenway22ndAve,12/17/2014 04:00:00 AM,48,-122,0,0,0
8405,58thStGreenway22ndAve,12/17/2014 05:00:00 AM,48,-122,0,0,0
8406,58thStGreenway22ndAve,12/17/2014 06:00:00 AM,48,-122,10,2,12
8407,58thStGreenway22ndAve,12/17/2014 07:00:00 AM,48,-122,21,4,25
8408,58thStGreenway22ndAve,12/17/2014 08:00:00 AM,48,-122,42,12,54
8409,58thStGreenway22ndAve,12/17/2014 09:00:00 AM,48,-122,39,14,53
8410,58thStGreenway22ndAve,12/17/2014 10:00:00 AM,48,-122,27,11,38
8411,58thStGreenway22ndAve,12/17/2014 11:00:00 AM,48,-122,21,7,28
8412,58thStGreenway22ndAve,12/17/2014 12:00:00 PM,48,-122,37,24,61
8413,58thStGreenway22ndAve,12/17/2014 01:00:00 PM,48,-122,50,20,70
8414,58thStGreenway22ndAve,12/17/2014 02:00:00 PM,48,-122,46,23,69
8415,58thStGreenway22ndAve,12/17/2014 03:00:00 PM,48,-122,33,16,49
8416,58thStGreenway22ndAve,12/17/2014 04:00:00 PM,48,-122,26,13,39
8417,58thStGreenway22ndAve,12/17/2014 05:00:00 PM,48,-122,31,22,53
8418,58thStGreenway22ndAve,12/17/2014 06:00:00 PM,48,-122,35,16,51
8419,58thStGreenway22ndAve,12/17/2014 07:00:00 PM,48,-122,22,8,30
8420,58thStGreenway22ndAve,12/17/2014 08:00:00 PM,48,-122,24,1,25
8421,58thStGreenway22ndAve,12/17/2014 09:00:00 PM,48,-122,22,2,24
8422,58thStGreenway22ndAve,12/17/2014 10:00:00 PM,48,-122,12,2,14
8423,58thStGreenway22ndAve,12/17/2014 11:00:00 PM,48,-122,1,1,2
8424,58thStGreenway22ndAve,12/18/2014 12:00:00 AM,48,-122,2,0,2
8425,58thStGreenway22ndAve,12/18/2014 01:00:00 AM,48,-122,0,0,0
8426,58thStGreenway22ndAve,12/18/2014 02:00:00 AM,48,-122,3,0,3
8427,58thStGreenway22ndAve,12/18/2014 03:00:00 AM,48,-122,2,0,2
8428,58thStGreenway22ndAve,12/18/2014 04:00:00 AM,48,-122,0,0,0
8429,58thStGreenway22ndAve,12/18/2014 05:00:00 AM,48,-122,5,4,9
8430,58thStGreenway22ndAve,12/18/2014 06:00:00 AM,48,-122,10,2,12
8431,58thStGreenway22ndAve,12/18/2014 07:00:00 AM,48,-122,24,5,29
8432,58thStGreenway22ndAve,12/18/2014 08:00:00 AM,48,-122,34,4,38
8433,58thStGreenway22ndAve,12/18/2014 09:00:00 AM,48,-122,37,8,45
8434,58thStGreenway22ndAve,12/18/2014 10:00:00 AM,48,-122,35,14,49
8435,58thStGreenway22ndAve,12/18/2014 11:00:00 AM,48,-122,49,14,63
8436,58thStGreenway22ndAve,12/18/2014 12:00:00 PM,48,-122,37,18,55
8437,58thStGreenway22ndAve,12/18/2014 01:00:00 PM,48,-122,36,8,44
8438,58thStGreenway22ndAve,12/18/2014 02:00:00 PM,48,-122,33,20,53
8439,58thStGreenway22ndAve,12/18/2014 03:00:00 PM,48,-122,42,13,55
8440,58thStGreenway22ndAve,12/18/2014 04:00:00 PM,48,-122,36,12,48
8441,58thStGreenway22ndAve,12/18/2014 05:00:00 PM,48,-122,32,7,39
8442,58thStGreenway22ndAve,12/18/2014 06:00:00 PM,48,-122,29,14,43
8443,58thStGreenway22ndAve,12/18/2014 07:00:00 PM,48,-122,29,16,45
8444,58thStGreenway22ndAve,12/18/2014 08:00:00 PM,48,-122,40,3,43
8445,58thStGreenway22ndAve,12/18/2014 09:00:00 PM,48,-122,7,3,10
8446,58thStGreenway22ndAve,12/18/2014 10:00:00 PM,48,-122,12,4,16
8447,58thStGreenway22ndAve,12/18/2014 11:00:00 PM,48,-122,6,2,8
8448,58thStGreenway22ndAve,12/19/2014 12:00:00 AM,48,-122,0,2,2
8449,58thStGreenway22ndAve,12/19/2014 01:00:00 AM,48,-122,4,0,4
8450,58thStGreenway22ndAve,12/19/2014 02:00:00 AM,48,-122,0,0,0
8451,58thStGreenway22ndAve,12/19/2014 03:00:00 AM,48,-122,0,1,1
8452,58thStGreenway22ndAve,12/19/2014 04:00:00 AM,48,-122,0,2,2
8453,58thStGreenway22ndAve,12/19/2014 05:00:00 AM,48,-122,2,1,3
8454,58thStGreenway22ndAve,12/19/2014 06:00:00 AM,48,-122,0,5,5
8455,58thStGreenway22ndAve,12/19/2014 07:00:00 AM,48,-122,6,1,7
8456,58thStGreenway22ndAve,12/19/2014 08:00:00 AM,48,-122,6,1,7
8457,58thStGreenway22ndAve,12/19/2014 09:00:00 AM,48,-122,7,1,8
8458,58thStGreenway22ndAve,12/19/2014 10:00:00 AM,48,-122,8,0,8
8459,58thStGreenway22ndAve,12/19/2014 11:00:00 AM,48,-122,14,2,16
8460,58thStGreenway22ndAve,12/19/2014 12:00:00 PM,48,-122,18,1,19
8461,58thStGreenway22ndAve,12/19/2014 01:00:00 PM,48,-122,19,0,19
8462,58thStGreenway22ndAve,12/19/2014 02:00:00 PM,48,-122,7,2,9
8463,58thStGreenway22ndAve,12/19/2014 03:00:00 PM,48,-122,16,2,18
8464,58thStGreenway22ndAve,12/19/2014 04:00:00 PM,48,-122,11,8,19
8465,58thStGreenway22ndAve,12/19/2014 05:00:00 PM,48,-122,20,10,30
8466,58thStGreenway22ndAve,12/19/2014 06:00:00 PM,48,-122,20,3,23
8467,58thStGreenway22ndAve,12/19/2014 07:00:00 PM,48,-122,18,1,19
8468,58thStGreenway22ndAve,12/19/2014 08:00:00 PM,48,-122,13,2,15
8469,58thStGreenway22ndAve,12/19/2014 09:00:00 PM,48,-122,6,0,6
8470,58thStGreenway22ndAve,12/19/2014 10:00:00 PM,48,-122,3,0,3
8471,58thStGreenway22ndAve,12/19/2014 11:00:00 PM,48,-122,5,0,5
8472,58thStGreenway22ndAve,12/20/2014 12:00:00 AM,48,-122,2,0,2
8473,58thStGreenway22ndAve,12/20/2014 01:00:00 AM,48,-122,2,1,3
8474,58thStGreenway22ndAve,12/20/2014 02:00:00 AM,48,-122,0,1,1
8475,58thStGreenway22ndAve,12/20/2014 03:00:00 AM,48,-122,0,0,0
8476,58thStGreenway22ndAve,12/20/2014 04:00:00 AM,48,-122,0,0,0
8477,58thStGreenway22ndAve,12/20/2014 05:00:00 AM,48,-122,0,0,0
8478,58thStGreenway22ndAve,12/20/2014 06:00:00 AM,48,-122,2,0,2
8479,58thStGreenway22ndAve,12/20/2014 07:00:00 AM,48,-122,4,0,4
8480,58thStGreenway22ndAve,12/20/2014 08:00:00 AM,48,-122,7,1,8
8481,58thStGreenway22ndAve,12/20/2014 09:00:00 AM,48,-122,9,1,10
8482,58thStGreenway22ndAve,12/20/2014 10:00:00 AM,48,-122,24,3,27
8483,58thStGreenway22ndAve,12/20/2014 11:00:00 AM,48,-122,29,0,29
8484,58thStGreenway22ndAve,12/20/2014 12:00:00 PM,48,-122,39,2,41
8485,58thStGreenway22ndAve,12/20/2014 01:00:00 PM,48,-122,43,5,48
8486,58thStGreenway22ndAve,12/20/2014 02:00:00 PM,48,-122,38,1,39
8487,58thStGreenway22ndAve,12/20/2014 03:00:00 PM,48,-122,34,1,35
8488,58thStGreenway22ndAve,12/20/2014 04:00:00 PM,48,-122,28,3,31
8489,58thStGreenway22ndAve,12/20/2014 05:00:00 PM,48,-122,13,2,15
8490,58thStGreenway22ndAve,12/20/2014 06:00:00 PM,48,-122,24,2,26
8491,58thStGreenway22ndAve,12/20/2014 07:00:00 PM,48,-122,27,1,28
8492,58thStGreenway22ndAve,12/20/2014 08:00:00 PM,48,-122,17,0,17
8493,58thStGreenway22ndAve,12/20/2014 09:00:00 PM,48,-122,17,0,17
8494,58thStGreenway22ndAve,12/20/2014 10:00:00 PM,48,-122,11,0,11
8495,58thStGreenway22ndAve,12/20/2014 11:00:00 PM,48,-122,8,2,10
8496,58thStGreenway22ndAve,12/21/2014 12:00:00 AM,48,-122,7,0,7
8497,58thStGreenway22ndAve,12/21/2014 01:00:00 AM,48,-122,2,0,2
8498,58thStGreenway22ndAve,12/21/2014 02:00:00 AM,48,-122,4,0,4
8499,58thStGreenway22ndAve,12/21/2014 03:00:00 AM,48,-122,6,0,6
8500,58thStGreenway22ndAve,12/21/2014 04:00:00 AM,48,-122,0,0,0
8501,58thStGreenway22ndAve,12/21/2014 05:00:00 AM,48,-122,0,0,0
8502,58thStGreenway22ndAve,12/21/2014 06:00:00 AM,48,-122,4,0,4
8503,58thStGreenway22ndAve,12/21/2014 07:00:00 AM,48,-122,5,0,5
8504,58thStGreenway22ndAve,12/21/2014 08:00:00 AM,48,-122,5,0,5
8505,58thStGreenway22ndAve,12/21/2014 09:00:00 AM,48,-122,16,0,16
8506,58thStGreenway22ndAve,12/21/2014 10:00:00 AM,48,-122,19,0,19
8507,58thStGreenway22ndAve,12/21/2014 11:00:00 AM,48,-122,48,2,50
8508,58thStGreenway22ndAve,12/21/2014 12:00:00 PM,48,-122,51,1,52
8509,58thStGreenway22ndAve,12/21/2014 01:00:00 PM,48,-122,56,2,58
8510,58thStGreenway22ndAve,12/21/2014 02:00:00 PM,48,-122,54,0,54
8511,58thStGreenway22ndAve,12/21/2014 03:00:00 PM,48,-122,28,2,30
8512,58thStGreenway22ndAve,12/21/2014 04:00:00 PM,48,-122,54,1,55
8513,58thStGreenway22ndAve,12/21/2014 05:00:00 PM,48,-122,34,0,34
8514,58thStGreenway22ndAve,12/21/2014 06:00:00 PM,48,-122,11,0,11
8515,58thStGreenway22ndAve,12/21/2014 07:00:00 PM,48,-122,10,0,10
8516,58thStGreenway22ndAve,12/21/2014 08:00:00 PM,48,-122,8,0,8
8517,58thStGreenway22ndAve,12/21/2014 09:00:00 PM,48,-122,25,0,25
8518,58thStGreenway22ndAve,12/21/2014 10:00:00 PM,48,-122,5,0,5
8519,58thStGreenway22ndAve,12/21/2014 11:00:00 PM,48,-122,4,0,4
8520,58thStGreenway22ndAve,12/22/2014 12:00:00 AM,48,-122,3,0,3
8521,58thStGreenway22ndAve,12/22/2014 01:00:00 AM,48,-122,2,0,2
8522,58thStGreenway22ndAve,12/22/2014 02:00:00 AM,48,-122,1,0,1
8523,58thStGreenway22ndAve,12/22/2014 03:00:00 AM,48,-122,0,0,0
8524,58thStGreenway22ndAve,12/22/2014 04:00:00 AM,48,-122,1,0,1
8525,58thStGreenway22ndAve,12/22/2014 05:00:00 AM,48,-122,0,0,0
8526,58thStGreenway22ndAve,12/22/2014 06:00:00 AM,48,-122,10,0,10
8527,58thStGreenway22ndAve,12/22/2014 07:00:00 AM,48,-122,14,0,14
8528,58thStGreenway22ndAve,12/22/2014 08:00:00 AM,48,-122,39,0,39
8529,58thStGreenway22ndAve,12/22/2014 09:00:00 AM,48,-122,21,1,22
8530,58thStGreenway22ndAve,12/22/2014 10:00:00 AM,48,-122,29,5,34
8531,58thStGreenway22ndAve,12/22/2014 11:00:00 AM,48,-122,36,1,37
8532,58thStGreenway22ndAve,12/22/2014 12:00:00 PM,48,-122,50,1,51
8533,58thStGreenway22ndAve,12/22/2014 01:00:00 PM,48,-122,35,0,35
8534,58thStGreenway22ndAve,12/22/2014 02:00:00 PM,48,-122,35,2,37
8535,58thStGreenway22ndAve,12/22/2014 03:00:00 PM,48,-122,27,2,29
8536,58thStGreenway22ndAve,12/22/2014 04:00:00 PM,48,-122,31,1,32
8537,58thStGreenway22ndAve,12/22/2014 05:00:00 PM,48,-122,35,1,36
8538,58thStGreenway22ndAve,12/22/2014 06:00:00 PM,48,-122,22,0,22
8539,58thStGreenway22ndAve,12/22/2014 07:00:00 PM,48,-122,21,0,21
8540,58thStGreenway22ndAve,12/22/2014 08:00:00 PM,48,-122,23,1,24
8541,58thStGreenway22ndAve,12/22/2014 09:00:00 PM,48,-122,6,0,6
8542,58thStGreenway22ndAve,12/22/2014 10:00:00 PM,48,-122,12,0,12
8543,58thStGreenway22ndAve,12/22/2014 11:00:00 PM,48,-122,1,0,1
8544,58thStGreenway22ndAve,12/23/2014 12:00:00 AM,48,-122,2,0,2
8545,58thStGreenway22ndAve,12/23/2014 01:00:00 AM,48,-122,0,0,0
8546,58thStGreenway22ndAve,12/23/2014 02:00:00 AM,48,-122,1,0,1
8547,58thStGreenway22ndAve,12/23/2014 03:00:00 AM,48,-122,1,0,1
8548,58thStGreenway22ndAve,12/23/2014 04:00:00 AM,48,-122,2,0,2
8549,58thStGreenway22ndAve,12/23/2014 05:00:00 AM,48,-122,2,2,4
8550,58thStGreenway22ndAve,12/23/2014 06:00:00 AM,48,-122,7,0,7
8551,58thStGreenway22ndAve,12/23/2014 07:00:00 AM,48,-122,11,1,12
8552,58thStGreenway22ndAve,12/23/2014 08:00:00 AM,48,-122,19,0,19
8553,58thStGreenway22ndAve,12/23/2014 09:00:00 AM,48,-122,16,0,16
8554,58thStGreenway22ndAve,12/23/2014 10:00:00 AM,48,-122,23,3,26
8555,58thStGreenway22ndAve,12/23/2014 11:00:00 AM,48,-122,31,2,33
8556,58thStGreenway22ndAve,12/23/2014 12:00:00 PM,48,-122,38,3,41
8557,58thStGreenway22ndAve,12/23/2014 01:00:00 PM,48,-122,44,2,46
8558,58thStGreenway22ndAve,12/23/2014 02:00:00 PM,48,-122,36,0,36
8559,58thStGreenway22ndAve,12/23/2014 03:00:00 PM,48,-122,21,5,26
8560,58thStGreenway22ndAve,12/23/2014 04:00:00 PM,48,-122,30,1,31
8561,58thStGreenway22ndAve,12/23/2014 05:00:00 PM,48,-122,25,3,28
8562,58thStGreenway22ndAve,12/23/2014 06:00:00 PM,48,-122,31,0,31
8563,58thStGreenway22ndAve,12/23/2014 07:00:00 PM,48,-122,22,0,22
8564,58thStGreenway22ndAve,12/23/2014 08:00:00 PM,48,-122,16,2,18
8565,58thStGreenway22ndAve,12/23/2014 09:00:00 PM,48,-122,10,0,10
8566,58thStGreenway22ndAve,12/23/2014 10:00:00 PM,48,-122,9,3,12
8567,58thStGreenway22ndAve,12/23/2014 11:00:00 PM,48,-122,4,0,4
8568,58thStGreenway22ndAve,12/24/2014 12:00:00 AM,48,-122,2,0,2
8569,58thStGreenway22ndAve,12/24/2014 01:00:00 AM,48,-122,1,0,1
8570,58thStGreenway22ndAve,12/24/2014 02:00:00 AM,48,-122,0,0,0
8571,58thStGreenway22ndAve,12/24/2014 03:00:00 AM,48,-122,2,0,2
8572,58thStGreenway22ndAve,12/24/2014 04:00:00 AM,48,-122,0,0,0
8573,58thStGreenway22ndAve,12/24/2014 05:00:00 AM,48,-122,6,0,6
8574,58thStGreenway22ndAve,12/24/2014 06:00:00 AM,48,-122,6,0,6
8575,58thStGreenway22ndAve,12/24/2014 07:00:00 AM,48,-122,8,0,8
8576,58thStGreenway22ndAve,12/24/2014 08:00:00 AM,48,-122,15,0,15
8577,58thStGreenway22ndAve,12/24/2014 09:00:00 AM,48,-122,22,0,22
8578,58thStGreenway22ndAve,12/24/2014 10:00:00 AM,48,-122,17,0,17
8579,58thStGreenway22ndAve,12/24/2014 11:00:00 AM,48,-122,38,0,38
8580,58thStGreenway22ndAve,12/24/2014 12:00:00 PM,48,-122,37,0,37
8581,58thStGreenway22ndAve,12/24/2014 01:00:00 PM,48,-122,28,0,28
8582,58thStGreenway22ndAve,12/24/2014 02:00:00 PM,48,-122,33,0,33
8583,58thStGreenway22ndAve,12/24/2014 03:00:00 PM,48,-122,26,0,26
8584,58thStGreenway22ndAve,12/24/2014 04:00:00 PM,48,-122,20,0,20
8585,58thStGreenway22ndAve,12/24/2014 05:00:00 PM,48,-122,13,0,13
8586,58thStGreenway22ndAve,12/24/2014 06:00:00 PM,48,-122,12,0,12
8587,58thStGreenway22ndAve,12/24/2014 07:00:00 PM,48,-122,14,2,16
8588,58thStGreenway22ndAve,12/24/2014 08:00:00 PM,48,-122,8,0,8
8589,58thStGreenway22ndAve,12/24/2014 09:00:00 PM,48,-122,4,0,4
8590,58thStGreenway22ndAve,12/24/2014 10:00:00 PM,48,-122,7,0,7
8591,58thStGreenway22ndAve,12/24/2014 11:00:00 PM,48,-122,5,0,5
8592,58thStGreenway22ndAve,12/25/2014 12:00:00 AM,48,-122,2,0,2
8593,58thStGreenway22ndAve,12/25/2014 01:00:00 AM,48,-122,3,0,3
8594,58thStGreenway22ndAve,12/25/2014 02:00:00 AM,48,-122,0,0,0
8595,58thStGreenway22ndAve,12/25/2014 03:00:00 AM,48,-122,0,0,0
8596,58thStGreenway22ndAve,12/25/2014 04:00:00 AM,48,-122,2,0,2
8597,58thStGreenway22ndAve,12/25/2014 05:00:00 AM,48,-122,0,0,0
8598,58thStGreenway22ndAve,12/25/2014 06:00:00 AM,48,-122,2,0,2
8599,58thStGreenway22ndAve,12/25/2014 07:00:00 AM,48,-122,1,0,1
8600,58thStGreenway22ndAve,12/25/2014 08:00:00 AM,48,-122,4,0,4
8601,58thStGreenway22ndAve,12/25/2014 09:00:00 AM,48,-122,8,0,8
8602,58thStGreenway22ndAve,12/25/2014 10:00:00 AM,48,-122,8,0,8
8603,58thStGreenway22ndAve,12/25/2014 11:00:00 AM,48,-122,12,0,12
8604,58thStGreenway22ndAve,12/25/2014 12:00:00 PM,48,-122,8,1,9
8605,58thStGreenway22ndAve,12/25/2014 01:00:00 PM,48,-122,15,0,15
8606,58thStGreenway22ndAve,12/25/2014 02:00:00 PM,48,-122,10,0,10
8607,58thStGreenway22ndAve,12/25/2014 03:00:00 PM,48,-122,23,1,24
8608,58thStGreenway22ndAve,12/25/2014 04:00:00 PM,48,-122,7,0,7
8609,58thStGreenway22ndAve,12/25/2014 05:00:00 PM,48,-122,4,0,4
8610,58thStGreenway22ndAve,12/25/2014 06:00:00 PM,48,-122,5,2,7
8611,58thStGreenway22ndAve,12/25/2014 07:00:00 PM,48,-122,7,0,7
8612,58thStGreenway22ndAve,12/25/2014 08:00:00 PM,48,-122,1,0,1
8613,58thStGreenway22ndAve,12/25/2014 09:00:00 PM,48,-122,4,0,4
8614,58thStGreenway22ndAve,12/25/2014 10:00:00 PM,48,-122,1,0,1
8615,58thStGreenway22ndAve,12/25/2014 11:00:00 PM,48,-122,3,0,3
8616,58thStGreenway22ndAve,12/26/2014 12:00:00 AM,48,-122,0,0,0
8617,58thStGreenway22ndAve,12/26/2014 01:00:00 AM,48,-122,0,0,0
8618,58thStGreenway22ndAve,12/26/2014 02:00:00 AM,48,-122,1,0,1
8619,58thStGreenway22ndAve,12/26/2014 03:00:00 AM,48,-122,1,0,1
8620,58thStGreenway22ndAve,12/26/2014 04:00:00 AM,48,-122,0,0,0
8621,58thStGreenway22ndAve,12/26/2014 05:00:00 AM,48,-122,3,0,3
8622,58thStGreenway22ndAve,12/26/2014 06:00:00 AM,48,-122,4,0,4
8623,58thStGreenway22ndAve,12/26/2014 07:00:00 AM,48,-122,3,0,3
8624,58thStGreenway22ndAve,12/26/2014 08:00:00 AM,48,-122,6,0,6
8625,58thStGreenway22ndAve,12/26/2014 09:00:00 AM,48,-122,11,0,11
8626,58thStGreenway22ndAve,12/26/2014 10:00:00 AM,48,-122,19,0,19
8627,58thStGreenway22ndAve,12/26/2014 11:00:00 AM,48,-122,18,3,21
8628,58thStGreenway22ndAve,12/26/2014 12:00:00 PM,48,-122,22,2,24
8629,58thStGreenway22ndAve,12/26/2014 01:00:00 PM,48,-122,18,0,18
8630,58thStGreenway22ndAve,12/26/2014 02:00:00 PM,48,-122,23,1,24
8631,58thStGreenway22ndAve,12/26/2014 03:00:00 PM,48,-122,24,0,24
8632,58thStGreenway22ndAve,12/26/2014 04:00:00 PM,48,-122,24,0,24
8633,58thStGreenway22ndAve,12/26/2014 05:00:00 PM,48,-122,25,0,25
8634,58thStGreenway22ndAve,12/26/2014 06:00:00 PM,48,-122,15,0,15
8635,58thStGreenway22ndAve,12/26/2014 07:00:00 PM,48,-122,19,0,19
8636,58thStGreenway22ndAve,12/26/2014 08:00:00 PM,48,-122,13,3,16
8637,58thStGreenway22ndAve,12/26/2014 09:00:00 PM,48,-122,10,0,10
8638,58thStGreenway22ndAve,12/26/2014 10:00:00 PM,48,-122,7,0,7
8639,58thStGreenway22ndAve,12/26/2014 11:00:00 PM,48,-122,4,0,4
8640,58thStGreenway22ndAve,12/27/2014 12:00:00 AM,48,-122,3,0,3
8641,58thStGreenway22ndAve,12/27/2014 01:00:00 AM,48,-122,3,0,3
8642,58thStGreenway22ndAve,12/27/2014 02:00:00 AM,48,-122,2,0,2
8643,58thStGreenway22ndAve,12/27/2014 03:00:00 AM,48,-122,1,0,1
8644,58thStGreenway22ndAve,12/27/2014 04:00:00 AM,48,-122,2,0,2
8645,58thStGreenway22ndAve,12/27/2014 05:00:00 AM,48,-122,1,0,1
8646,58thStGreenway22ndAve,12/27/2014 06:00:00 AM,48,-122,3,0,3
8647,58thStGreenway22ndAve,12/27/2014 07:00:00 AM,48,-122,2,0,2
8648,58thStGreenway22ndAve,12/27/2014 08:00:00 AM,48,-122,7,0,7
8649,58thStGreenway22ndAve,12/27/2014 09:00:00 AM,48,-122,16,0,16
8650,58thStGreenway22ndAve,12/27/2014 10:00:00 AM,48,-122,17,1,18
8651,58thStGreenway22ndAve,12/27/2014 11:00:00 AM,48,-122,21,0,21
8652,58thStGreenway22ndAve,12/27/2014 12:00:00 PM,48,-122,36,0,36
8653,58thStGreenway22ndAve,12/27/2014 01:00:00 PM,48,-122,24,0,24
8654,58thStGreenway22ndAve,12/27/2014 02:00:00 PM,48,-122,21,0,21
8655,58thStGreenway22ndAve,12/27/2014 03:00:00 PM,48,-122,23,0,23
8656,58thStGreenway22ndAve,12/27/2014 04:00:00 PM,48,-122,15,1,16
8657,58thStGreenway22ndAve,12/27/2014 05:00:00 PM,48,-122,21,0,21
8658,58thStGreenway22ndAve,12/27/2014 06:00:00 PM,48,-122,19,0,19
8659,58thStGreenway22ndAve,12/27/2014 07:00:00 PM,48,-122,14,5,19
8660,58thStGreenway22ndAve,12/27/2014 08:00:00 PM,48,-122,12,0,12
8661,58thStGreenway22ndAve,12/27/2014 09:00:00 PM,48,-122,10,0,10
8662,58thStGreenway22ndAve,12/27/2014 10:00:00 PM,48,-122,9,0,9
8663,58thStGreenway22ndAve,12/27/2014 11:00:00 PM,48,-122,0,0,0
8664,58thStGreenway22ndAve,12/28/2014 12:00:00 AM,48,-122,2,0,2
8665,58thStGreenway22ndAve,12/28/2014 01:00:00 AM,48,-122,3,0,3
8666,58thStGreenway22ndAve,12/28/2014 02:00:00 AM,48,-122,5,0,5
8667,58thStGreenway22ndAve,12/28/2014 03:00:00 AM,48,-122,0,0,0
8668,58thStGreenway22ndAve,12/28/2014 04:00:00 AM,48,-122,0,0,0
8669,58thStGreenway22ndAve,12/28/2014 05:00:00 AM,48,-122,0,0,0
8670,58thStGreenway22ndAve,12/28/2014 06:00:00 AM,48,-122,1,0,1
8671,58thStGreenway22ndAve,12/28/2014 07:00:00 AM,48,-122,2,0,2
8672,58thStGreenway22ndAve,12/28/2014 08:00:00 AM,48,-122,3,0,3
8673,58thStGreenway22ndAve,12/28/2014 09:00:00 AM,48,-122,16,0,16
8674,58thStGreenway22ndAve,12/28/2014 10:00:00 AM,48,-122,13,0,13
8675,58thStGreenway22ndAve,12/28/2014 11:00:00 AM,48,-122,23,3,26
8676,58thStGreenway22ndAve,12/28/2014 12:00:00 PM,48,-122,26,4,30
8677,58thStGreenway22ndAve,12/28/2014 01:00:00 PM,48,-122,23,1,24
8678,58thStGreenway22ndAve,12/28/2014 02:00:00 PM,48,-122,13,0,13
8679,58thStGreenway22ndAve,12/28/2014 03:00:00 PM,48,-122,12,0,12
8680,58thStGreenway22ndAve,12/28/2014 04:00:00 PM,48,-122,8,0,8
8681,58thStGreenway22ndAve,12/28/2014 05:00:00 PM,48,-122,16,3,19
8682,58thStGreenway22ndAve,12/28/2014 06:00:00 PM,48,-122,11,0,11
8683,58thStGreenway22ndAve,12/28/2014 07:00:00 PM,48,-122,12,0,12
8684,58thStGreenway22ndAve,12/28/2014 08:00:00 PM,48,-122,3,0,3
8685,58thStGreenway22ndAve,12/28/2014 09:00:00 PM,48,-122,5,0,5
8686,58thStGreenway22ndAve,12/28/2014 10:00:00 PM,48,-122,3,1,4
8687,58thStGreenway22ndAve,12/28/2014 11:00:00 PM,48,-122,4,0,4
8688,58thStGreenway22ndAve,12/29/2014 12:00:00 AM,48,-122,4,0,4
8689,58thStGreenway22ndAve,12/29/2014 01:00:00 AM,48,-122,3,0,3
8690,58thStGreenway22ndAve,12/29/2014 02:00:00 AM,48,-122,1,0,1
8691,58thStGreenway22ndAve,12/29/2014 03:00:00 AM,48,-122,1,0,1
8692,58thStGreenway22ndAve,12/29/2014 04:00:00 AM,48,-122,0,0,0
8693,58thStGreenway22ndAve,12/29/2014 05:00:00 AM,48,-122,0,0,0
8694,58thStGreenway22ndAve,12/29/2014 06:00:00 AM,48,-122,4,0,4
8695,58thStGreenway22ndAve,12/29/2014 07:00:00 AM,48,-122,11,3,14
8696,58thStGreenway22ndAve,12/29/2014 08:00:00 AM,48,-122,7,0,7
8697,58thStGreenway22ndAve,12/29/2014 09:00:00 AM,48,-122,25,0,25
8698,58thStGreenway22ndAve,12/29/2014 10:00:00 AM,48,-122,16,4,20
8699,58thStGreenway22ndAve,12/29/2014 11:00:00 AM,48,-122,18,0,18
8700,58thStGreenway22ndAve,12/29/2014 12:00:00 PM,48,-122,25,1,26
8701,58thStGreenway22ndAve,12/29/2014 01:00:00 PM,48,-122,32,4,36
8702,58thStGreenway22ndAve,12/29/2014 02:00:00 PM,48,-122,23,0,23
8703,58thStGreenway22ndAve,12/29/2014 03:00:00 PM,48,-122,24,0,24
8704,58thStGreenway22ndAve,12/29/2014 04:00:00 PM,48,-122,22,0,22
8705,58thStGreenway22ndAve,12/29/2014 05:00:00 PM,48,-122,15,0,15
8706,58thStGreenway22ndAve,12/29/2014 06:00:00 PM,48,-122,17,2,19
8707,58thStGreenway22ndAve,12/29/2014 07:00:00 PM,48,-122,7,0,7
8708,58thStGreenway22ndAve,12/29/2014 08:00:00 PM,48,-122,11,0,11
8709,58thStGreenway22ndAve,12/29/2014 09:00:00 PM,48,-122,8,0,8
8710,58thStGreenway22ndAve,12/29/2014 10:00:00 PM,48,-122,3,0,3
8711,58thStGreenway22ndAve,12/29/2014 11:00:00 PM,48,-122,4,0,4
8712,58thStGreenway22ndAve,12/30/2014 12:00:00 AM,48,-122,2,0,2
8713,58thStGreenway22ndAve,12/30/2014 01:00:00 AM,48,-122,1,0,1
8714,58thStGreenway22ndAve,12/30/2014 02:00:00 AM,48,-122,0,0,0
8715,58thStGreenway22ndAve,12/30/2014 03:00:00 AM,48,-122,0,0,0
8716,58thStGreenway22ndAve,12/30/2014 04:00:00 AM,48,-122,0,0,0
8717,58thStGreenway22ndAve,12/30/2014 05:00:00 AM,48,-122,0,0,0
8718,58thStGreenway22ndAve,12/30/2014 06:00:00 AM,48,-122,0,0,0
8719,58thStGreenway22ndAve,12/30/2014 07:00:00 AM,48,-122,0,0,0
8720,58thStGreenway22ndAve,12/30/2014 08:00:00 AM,48,-122,0,0,0
8721,58thStGreenway22ndAve,12/30/2014 09:00:00 AM,48,-122,0,0,0
8722,58thStGreenway22ndAve,12/30/2014 10:00:00 AM,48,-122,0,0,0
8723,58thStGreenway22ndAve,12/30/2014 11:00:00 AM,48,-122,0,0,0
8724,58thStGreenway22ndAve,12/30/2014 12:00:00 PM,48,-122,0,0,0
8725,58thStGreenway22ndAve,12/30/2014 01:00:00 PM,48,-122,0,0,0
8726,58thStGreenway22ndAve,12/30/2014 02:00:00 PM,48,-122,0,0,0
8727,58thStGreenway22ndAve,12/30/2014 03:00:00 PM,48,-122,0,0,0
8728,58thStGreenway22ndAve,12/30/2014 04:00:00 PM,48,-122,0,0,0
8729,58thStGreenway22ndAve,12/30/2014 05:00:00 PM,48,-122,0,0,0
8730,58thStGreenway22ndAve,12/30/2014 06:00:00 PM,48,-122,0,0,0
8731,58thStGreenway22ndAve,12/30/2014 07:00:00 PM,48,-122,0,0,0
8732,58thStGreenway22ndAve,12/30/2014 08:00:00 PM,48,-122,0,0,0
8733,58thStGreenway22ndAve,12/30/2014 09:00:00 PM,48,-122,0,0,0
8734,58thStGreenway22ndAve,12/30/2014 10:00:00 PM,48,-122,0,0,0
8735,58thStGreenway22ndAve,12/30/2014 11:00:00 PM,48,-122,0,0,0
8736,58thStGreenway22ndAve,12/31/2014 12:00:00 AM,48,-122,0,0,0
8737,58thStGreenway22ndAve,12/31/2014 01:00:00 AM,48,-122,0,0,0
8738,58thStGreenway22ndAve,12/31/2014 02:00:00 AM,48,-122,0,0,0
8739,58thStGreenway22ndAve,12/31/2014 03:00:00 AM,48,-122,0,0,0
8740,58thStGreenway22ndAve,12/31/2014 04:00:00 AM,48,-122,0,0,0
8741,58thStGreenway22ndAve,12/31/2014 05:00:00 AM,48,-122,0,0,0
8742,58thStGreenway22ndAve,12/31/2014 06:00:00 AM,48,-122,0,0,0
8743,58thStGreenway22ndAve,12/31/2014 07:00:00 AM,48,-122,0,0,0
8744,58thStGreenway22ndAve,12/31/2014 08:00:00 AM,48,-122,0,0,0
8745,58thStGreenway22ndAve,12/31/2014 09:00:00 AM,48,-122,1,0,1
8746,58thStGreenway22ndAve,12/31/2014 10:00:00 AM,48,-122,0,0,0
8747,58thStGreenway22ndAve,12/31/2014 11:00:00 AM,48,-122,0,0,0
8748,58thStGreenway22ndAve,12/31/2014 12:00:00 PM,48,-122,0,0,0
8749,58thStGreenway22ndAve,12/31/2014 01:00:00 PM,48,-122,0,0,0
8750,58thStGreenway22ndAve,12/31/2014 02:00:00 PM,48,-122,1,0,1
8751,58thStGreenway22ndAve,12/31/2014 03:00:00 PM,48,-122,1,0,1
8752,58thStGreenway22ndAve,12/31/2014 04:00:00 PM,48,-122,0,0,0
8753,58thStGreenway22ndAve,12/31/2014 05:00:00 PM,48,-122,0,0,0
8754,58thStGreenway22ndAve,12/31/2014 06:00:00 PM,48,-122,0,0,0
8755,58thStGreenway22ndAve,12/31/2014 07:00:00 PM,48,-122,0,0,0
8756,58thStGreenway22ndAve,12/31/2014 08:00:00 PM,48,-122,0,0,0
8757,58thStGreenway22ndAve,12/31/2014 09:00:00 PM,48,-122,0,0,0
8758,58thStGreenway22ndAve,12/31/2014 10:00:00 PM,48,-122,0,0,0
8759,58thStGreenway22ndAve,12/31/2014 11:00:00 PM,48,-122,0,0,0
8760,58thStGreenway22ndAve,01/01/2015 12:00:00 AM,48,-122,0,0,0
8761,58thStGreenway22ndAve,01/01/2015 01:00:00 AM,48,-122,0,0,0
8762,58thStGreenway22ndAve,01/01/2015 02:00:00 AM,48,-122,0,0,0
8763,58thStGreenway22ndAve,01/01/2015 03:00:00 AM,48,-122,0,0,0
8764,58thStGreenway22ndAve,01/01/2015 04:00:00 AM,48,-122,0,0,0
8765,58thStGreenway22ndAve,01/01/2015 05:00:00 AM,48,-122,0,0,0
8766,58thStGreenway22ndAve,01/01/2015 06:00:00 AM,48,-122,0,0,0
8767,58thStGreenway22ndAve,01/01/2015 07:00:00 AM,48,-122,0,0,0
8768,58thStGreenway22ndAve,01/01/2015 08:00:00 AM,48,-122,0,0,0
8769,58thStGreenway22ndAve,01/01/2015 09:00:00 AM,48,-122,0,0,0
8770,58thStGreenway22ndAve,01/01/2015 10:00:00 AM,48,-122,0,0,0
8771,58thStGreenway22ndAve,01/01/2015 11:00:00 AM,48,-122,0,0,0
8772,58thStGreenway22ndAve,01/01/2015 12:00:00 PM,48,-122,0,0,0
8773,58thStGreenway22ndAve,01/01/2015 01:00:00 PM,48,-122,9,0,9
8774,58thStGreenway22ndAve,01/01/2015 02:00:00 PM,48,-122,16,0,16
8775,58thStGreenway22ndAve,01/01/2015 03:00:00 PM,48,-122,22,1,23
8776,58thStGreenway22ndAve,01/01/2015 04:00:00 PM,48,-122,16,0,16
8777,58thStGreenway22ndAve,01/01/2015 05:00:00 PM,48,-122,18,0,18
8778,58thStGreenway22ndAve,01/01/2015 06:00:00 PM,48,-122,2,0,2
8779,58thStGreenway22ndAve,01/01/2015 07:00:00 PM,48,-122,0,0,0
8780,58thStGreenway22ndAve,01/01/2015 08:00:00 PM,48,-122,0,0,0
8781,58thStGreenway22ndAve,01/01/2015 09:00:00 PM,48,-122,0,0,0
8782,58thStGreenway22ndAve,01/01/2015 10:00:00 PM,48,-122,0,0,0
8783,58thStGreenway22ndAve,01/01/2015 11:00:00 PM,48,-122,0,0,0
8784,58thStGreenway22ndAve,01/02/2015 12:00:00 AM,48,-122,0,0,0
8785,58thStGreenway22ndAve,01/02/2015 01:00:00 AM,48,-122,0,0,0
8786,58thStGreenway22ndAve,01/02/2015 02:00:00 AM,48,-122,0,0,0
8787,58thStGreenway22ndAve,01/02/2015 03:00:00 AM,48,-122,0,0,0
8788,58thStGreenway22ndAve,01/02/2015 04:00:00 AM,48,-122,0,0,0
8789,58thStGreenway22ndAve,01/02/2015 05:00:00 AM,48,-122,0,0,0
8790,58thStGreenway22ndAve,01/02/2015 06:00:00 AM,48,-122,0,0,0
8791,58thStGreenway22ndAve,01/02/2015 07:00:00 AM,48,-122,0,0,0
8792,58thStGreenway22ndAve,01/02/2015 08:00:00 AM,48,-122,0,0,0
8793,58thStGreenway22ndAve,01/02/2015 09:00:00 AM,48,-122,16,1,17
8794,58thStGreenway22ndAve,01/02/2015 10:00:00 AM,48,-122,22,0,22
8795,58thStGreenway22ndAve,01/02/2015 11:00:00 AM,48,-122,51,0,51
8796,58thStGreenway22ndAve,01/02/2015 12:00:00 PM,48,-122,40,2,42
8797,58thStGreenway22ndAve,01/02/2015 01:00:00 PM,48,-122,44,0,44
8798,58thStGreenway22ndAve,01/02/2015 02:00:00 PM,48,-122,39,0,39
8799,58thStGreenway22ndAve,01/02/2015 03:00:00 PM,48,-122,35,0,35
8800,58thStGreenway22ndAve,01/02/2015 04:00:00 PM,48,-122,28,2,30
8801,58thStGreenway22ndAve,01/02/2015 05:00:00 PM,48,-122,23,1,24
8802,58thStGreenway22ndAve,01/02/2015 06:00:00 PM,48,-122,17,0,17
8803,58thStGreenway22ndAve,01/02/2015 07:00:00 PM,48,-122,16,0,16
8804,58thStGreenway22ndAve,01/02/2015 08:00:00 PM,48,-122,19,0,19
8805,58thStGreenway22ndAve,01/02/2015 09:00:00 PM,48,-122,19,1,20
8806,58thStGreenway22ndAve,01/02/2015 10:00:00 PM,48,-122,10,0,10
8807,58thStGreenway22ndAve,01/02/2015 11:00:00 PM,48,-122,5,5,10
8808,58thStGreenway22ndAve,01/03/2015 12:00:00 AM,48,-122,3,0,3
8809,58thStGreenway22ndAve,01/03/2015 01:00:00 AM,48,-122,4,0,4
8810,58thStGreenway22ndAve,01/03/2015 02:00:00 AM,48,-122,1,0,1
8811,58thStGreenway22ndAve,01/03/2015 03:00:00 AM,48,-122,2,0,2
8812,58thStGreenway22ndAve,01/03/2015 04:00:00 AM,48,-122,1,0,1
8813,58thStGreenway22ndAve,01/03/2015 05:00:00 AM,48,-122,0,0,0
8814,58thStGreenway22ndAve,01/03/2015 06:00:00 AM,48,-122,3,0,3
8815,58thStGreenway22ndAve,01/03/2015 07:00:00 AM,48,-122,10,0,10
8816,58thStGreenway22ndAve,01/03/2015 08:00:00 AM,48,-122,7,0,7
8817,58thStGreenway22ndAve,01/03/2015 09:00:00 AM,48,-122,15,0,15
8818,58thStGreenway22ndAve,01/03/2015 10:00:00 AM,48,-122,17,1,18
8819,58thStGreenway22ndAve,01/03/2015 11:00:00 AM,48,-122,23,1,24
8820,58thStGreenway22ndAve,01/03/2015 12:00:00 PM,48,-122,25,0,25
8821,58thStGreenway22ndAve,01/03/2015 01:00:00 PM,48,-122,44,1,45
8822,58thStGreenway22ndAve,01/03/2015 02:00:00 PM,48,-122,41,0,41
8823,58thStGreenway22ndAve,01/03/2015 03:00:00 PM,48,-122,26,0,26
8824,58thStGreenway22ndAve,01/03/2015 04:00:00 PM,48,-122,20,0,20
8825,58thStGreenway22ndAve,01/03/2015 05:00:00 PM,48,-122,28,1,29
8826,58thStGreenway22ndAve,01/03/2015 06:00:00 PM,48,-122,27,0,27
8827,58thStGreenway22ndAve,01/03/2015 07:00:00 PM,48,-122,28,0,28
8828,58thStGreenway22ndAve,01/03/2015 08:00:00 PM,48,-122,14,0,14
8829,58thStGreenway22ndAve,01/03/2015 09:00:00 PM,48,-122,17,0,17
8830,58thStGreenway22ndAve,01/03/2015 10:00:00 PM,48,-122,7,0,7
8831,58thStGreenway22ndAve,01/03/2015 11:00:00 PM,48,-122,8,0,8
8832,58thStGreenway22ndAve,01/04/2015 12:00:00 AM,48,-122,3,0,3
8833,58thStGreenway22ndAve,01/04/2015 01:00:00 AM,48,-122,6,0,6
8834,58thStGreenway22ndAve,01/04/2015 02:00:00 AM,48,-122,4,0,4
8835,58thStGreenway22ndAve,01/04/2015 03:00:00 AM,48,-122,1,0,1
8836,58thStGreenway22ndAve,01/04/2015 04:00:00 AM,48,-122,2,0,2
8837,58thStGreenway22ndAve,01/04/2015 05:00:00 AM,48,-122,0,0,0
8838,58thStGreenway22ndAve,01/04/2015 06:00:00 AM,48,-122,5,0,5
8839,58thStGreenway22ndAve,01/04/2015 07:00:00 AM,48,-122,4,0,4
8840,58thStGreenway22ndAve,01/04/2015 08:00:00 AM,48,-122,7,1,8
8841,58thStGreenway22ndAve,01/04/2015 09:00:00 AM,48,-122,15,0,15
8842,58thStGreenway22ndAve,01/04/2015 10:00:00 AM,48,-122,12,0,12
8843,58thStGreenway22ndAve,01/04/2015 11:00:00 AM,48,-122,22,0,22
8844,58thStGreenway22ndAve,01/04/2015 12:00:00 PM,48,-122,42,0,42
8845,58thStGreenway22ndAve,01/04/2015 01:00:00 PM,48,-122,43,0,43
8846,58thStGreenway22ndAve,01/04/2015 02:00:00 PM,48,-122,19,1,20
8847,58thStGreenway22ndAve,01/04/2015 03:00:00 PM,48,-122,20,0,20
8848,58thStGreenway22ndAve,01/04/2015 04:00:00 PM,48,-122,21,0,21
8849,58thStGreenway22ndAve,01/04/2015 05:00:00 PM,48,-122,22,0,22
8850,58thStGreenway22ndAve,01/04/2015 06:00:00 PM,48,-122,10,1,11
8851,58thStGreenway22ndAve,01/04/2015 07:00:00 PM,48,-122,12,0,12
8852,58thStGreenway22ndAve,01/04/2015 08:00:00 PM,48,-122,9,0,9
8853,58thStGreenway22ndAve,01/04/2015 09:00:00 PM,48,-122,9,0,9
8854,58thStGreenway22ndAve,01/04/2015 10:00:00 PM,48,-122,12,0,12
8855,58thStGreenway22ndAve,01/04/2015 11:00:00 PM,48,-122,0,0,0
8856,58thStGreenway22ndAve,01/05/2015 12:00:00 AM,48,-122,0,0,0
8857,58thStGreenway22ndAve,01/05/2015 01:00:00 AM,48,-122,1,0,1
8858,58thStGreenway22ndAve,01/05/2015 02:00:00 AM,48,-122,0,0,0
8859,58thStGreenway22ndAve,01/05/2015 03:00:00 AM,48,-122,1,0,1
8860,58thStGreenway22ndAve,01/05/2015 04:00:00 AM,48,-122,0,0,0
8861,58thStGreenway22ndAve,01/05/2015 05:00:00 AM,48,-122,6,0,6
8862,58thStGreenway22ndAve,01/05/2015 06:00:00 AM,48,-122,5,2,7
8863,58thStGreenway22ndAve,01/05/2015 07:00:00 AM,48,-122,16,0,16
8864,58thStGreenway22ndAve,01/05/2015 08:00:00 AM,48,-122,21,0,21
8865,58thStGreenway22ndAve,01/05/2015 09:00:00 AM,48,-122,24,2,26
8866,58thStGreenway22ndAve,01/05/2015 10:00:00 AM,48,-122,19,0,19
8867,58thStGreenway22ndAve,01/05/2015 11:00:00 AM,48,-122,26,0,26
8868,58thStGreenway22ndAve,01/05/2015 12:00:00 PM,48,-122,26,2,28
8869,58thStGreenway22ndAve,01/05/2015 01:00:00 PM,48,-122,27,0,27
8870,58thStGreenway22ndAve,01/05/2015 02:00:00 PM,48,-122,36,2,38
8871,58thStGreenway22ndAve,01/05/2015 03:00:00 PM,48,-122,38,0,38
8872,58thStGreenway22ndAve,01/05/2015 04:00:00 PM,48,-122,35,0,35
8873,58thStGreenway22ndAve,01/05/2015 05:00:00 PM,48,-122,37,0,37
8874,58thStGreenway22ndAve,01/05/2015 06:00:00 PM,48,-122,47,0,47
8875,58thStGreenway22ndAve,01/05/2015 07:00:00 PM,48,-122,23,0,23
8876,58thStGreenway22ndAve,01/05/2015 08:00:00 PM,48,-122,12,0,12
8877,58thStGreenway22ndAve,01/05/2015 09:00:00 PM,48,-122,17,0,17
8878,58thStGreenway22ndAve,01/05/2015 10:00:00 PM,48,-122,2,0,2
8879,58thStGreenway22ndAve,01/05/2015 11:00:00 PM,48,-122,9,0,9
8880,58thStGreenway22ndAve,01/06/2015 12:00:00 AM,48,-122,2,0,2
8881,58thStGreenway22ndAve,01/06/2015 01:00:00 AM,48,-122,0,0,0
8882,58thStGreenway22ndAve,01/06/2015 02:00:00 AM,48,-122,2,0,2
8883,58thStGreenway22ndAve,01/06/2015 03:00:00 AM,48,-122,0,0,0
8884,58thStGreenway22ndAve,01/06/2015 04:00:00 AM,48,-122,1,0,1
8885,58thStGreenway22ndAve,01/06/2015 05:00:00 AM,48,-122,4,0,4
8886,58thStGreenway22ndAve,01/06/2015 06:00:00 AM,48,-122,8,0,8
8887,58thStGreenway22ndAve,01/06/2015 07:00:00 AM,48,-122,24,0,24
8888,58thStGreenway22ndAve,01/06/2015 08:00:00 AM,48,-122,41,0,41
8889,58thStGreenway22ndAve,01/06/2015 09:00:00 AM,48,-122,42,0,42
8890,58thStGreenway22ndAve,01/06/2015 10:00:00 AM,48,-122,28,1,29
8891,58thStGreenway22ndAve,01/06/2015 11:00:00 AM,48,-122,41,0,41
8892,58thStGreenway22ndAve,01/06/2015 12:00:00 PM,48,-122,36,0,36
8893,58thStGreenway22ndAve,01/06/2015 01:00:00 PM,48,-122,46,0,46
8894,58thStGreenway22ndAve,01/06/2015 02:00:00 PM,48,-122,45,0,45
8895,58thStGreenway22ndAve,01/06/2015 03:00:00 PM,48,-122,48,0,48
8896,58thStGreenway22ndAve,01/06/2015 04:00:00 PM,48,-122,47,0,47
8897,58thStGreenway22ndAve,01/06/2015 05:00:00 PM,48,-122,21,0,21
8898,58thStGreenway22ndAve,01/06/2015 06:00:00 PM,48,-122,24,0,24
8899,58thStGreenway22ndAve,01/06/2015 07:00:00 PM,48,-122,28,0,28
8900,58thStGreenway22ndAve,01/06/2015 08:00:00 PM,48,-122,22,0,22
8901,58thStGreenway22ndAve,01/06/2015 09:00:00 PM,48,-122,8,0,8
8902,58thStGreenway22ndAve,01/06/2015 10:00:00 PM,48,-122,9,0,9
8903,58thStGreenway22ndAve,01/06/2015 11:00:00 PM,48,-122,2,0,2
8904,58thStGreenway22ndAve,01/07/2015 12:00:00 AM,48,-122,2,0,2
8905,58thStGreenway22ndAve,01/07/2015 01:00:00 AM,48,-122,0,0,0
8906,58thStGreenway22ndAve,01/07/2015 02:00:00 AM,48,-122,2,0,2
8907,58thStGreenway22ndAve,01/07/2015 03:00:00 AM,48,-122,1,0,1
8908,58thStGreenway22ndAve,01/07/2015 04:00:00 AM,48,-122,0,0,0
8909,58thStGreenway22ndAve,01/07/2015 05:00:00 AM,48,-122,3,0,3
8910,58thStGreenway22ndAve,01/07/2015 06:00:00 AM,48,-122,13,0,13
8911,58thStGreenway22ndAve,01/07/2015 07:00:00 AM,48,-122,32,1,33
8912,58thStGreenway22ndAve,01/07/2015 08:00:00 AM,48,-122,28,1,29
8913,58thStGreenway22ndAve,01/07/2015 09:00:00 AM,48,-122,36,0,36
8914,58thStGreenway22ndAve,01/07/2015 10:00:00 AM,48,-122,28,0,28
8915,58thStGreenway22ndAve,01/07/2015 11:00:00 AM,48,-122,26,1,27
8916,58thStGreenway22ndAve,01/07/2015 12:00:00 PM,48,-122,37,0,37
8917,58thStGreenway22ndAve,01/07/2015 01:00:00 PM,48,-122,27,0,27
8918,58thStGreenway22ndAve,01/07/2015 02:00:00 PM,48,-122,36,0,36
8919,58thStGreenway22ndAve,01/07/2015 03:00:00 PM,48,-122,33,0,33
8920,58thStGreenway22ndAve,01/07/2015 04:00:00 PM,48,-122,44,0,44
8921,58thStGreenway22ndAve,01/07/2015 05:00:00 PM,48,-122,15,0,15
8922,58thStGreenway22ndAve,01/07/2015 06:00:00 PM,48,-122,0,0,0
8923,58thStGreenway22ndAve,01/07/2015 07:00:00 PM,48,-122,0,0,0
8924,58thStGreenway22ndAve,01/07/2015 08:00:00 PM,48,-122,0,0,0
8925,58thStGreenway22ndAve,01/07/2015 09:00:00 PM,48,-122,0,0,0
8926,58thStGreenway22ndAve,01/07/2015 10:00:00 PM,48,-122,0,0,0
8927,58thStGreenway22ndAve,01/07/2015 11:00:00 PM,48,-122,0,0,0
8928,58thStGreenway22ndAve,01/08/2015 12:00:00 AM,48,-122,0,0,0
8929,58thStGreenway22ndAve,01/08/2015 01:00:00 AM,48,-122,0,0,0
8930,58thStGreenway22ndAve,01/08/2015 02:00:00 AM,48,-122,0,0,0
8931,58thStGreenway22ndAve,01/08/2015 03:00:00 AM,48,-122,0,0,0
8932,58thStGreenway22ndAve,01/08/2015 04:00:00 AM,48,-122,0,0,0
8933,58thStGreenway22ndAve,01/08/2015 05:00:00 AM,48,-122,0,0,0
8934,58thStGreenway22ndAve,01/08/2015 06:00:00 AM,48,-122,0,0,0
8935,58thStGreenway22ndAve,01/08/2015 07:00:00 AM,48,-122,13,1,14
8936,58thStGreenway22ndAve,01/08/2015 08:00:00 AM,48,-122,34,0,34
8937,58thStGreenway22ndAve,01/08/2015 09:00:00 AM,48,-122,18,0,18
8938,58thStGreenway22ndAve,01/08/2015 10:00:00 AM,48,-122,22,0,22
8939,58thStGreenway22ndAve,01/08/2015 11:00:00 AM,48,-122,18,0,18
8940,58thStGreenway22ndAve,01/08/2015 12:00:00 PM,48,-122,22,0,22
8941,58thStGreenway22ndAve,01/08/2015 01:00:00 PM,48,-122,24,0,24
8942,58thStGreenway22ndAve,01/08/2015 02:00:00 PM,48,-122,25,1,26
8943,58thStGreenway22ndAve,01/08/2015 03:00:00 PM,48,-122,39,1,40
8944,58thStGreenway22ndAve,01/08/2015 04:00:00 PM,48,-122,41,0,41
8945,58thStGreenway22ndAve,01/08/2015 05:00:00 PM,48,-122,23,0,23
8946,58thStGreenway22ndAve,01/08/2015 06:00:00 PM,48,-122,28,1,29
8947,58thStGreenway22ndAve,01/08/2015 07:00:00 PM,48,-122,17,0,17
8948,58thStGreenway22ndAve,01/08/2015 08:00:00 PM,48,-122,20,0,20
8949,58thStGreenway22ndAve,01/08/2015 09:00:00 PM,48,-122,17,0,17
8950,58thStGreenway22ndAve,01/08/2015 10:00:00 PM,48,-122,14,0,14
8951,58thStGreenway22ndAve,01/08/2015 11:00:00 PM,48,-122,2,0,2
8952,58thStGreenway22ndAve,01/09/2015 12:00:00 AM,48,-122,4,0,4
8953,58thStGreenway22ndAve,01/09/2015 01:00:00 AM,48,-122,1,0,1
8954,58thStGreenway22ndAve,01/09/2015 02:00:00 AM,48,-122,1,0,1
8955,58thStGreenway22ndAve,01/09/2015 03:00:00 AM,48,-122,1,0,1
8956,58thStGreenway22ndAve,01/09/2015 04:00:00 AM,48,-122,1,0,1
8957,58thStGreenway22ndAve,01/09/2015 05:00:00 AM,48,-122,4,0,4
8958,58thStGreenway22ndAve,01/09/2015 06:00:00 AM,48,-122,9,1,10
8959,58thStGreenway22ndAve,01/09/2015 07:00:00 AM,48,-122,12,0,12
8960,58thStGreenway22ndAve,01/09/2015 08:00:00 AM,48,-122,15,0,15
8961,58thStGreenway22ndAve,01/09/2015 09:00:00 AM,48,-122,20,0,20
8962,58thStGreenway22ndAve,01/09/2015 10:00:00 AM,48,-122,14,0,14
8963,58thStGreenway22ndAve,01/09/2015 11:00:00 AM,48,-122,23,0,23
8964,58thStGreenway22ndAve,01/09/2015 12:00:00 PM,48,-122,19,0,19
8965,58thStGreenway22ndAve,01/09/2015 01:00:00 PM,48,-122,18,0,18
8966,58thStGreenway22ndAve,01/09/2015 02:00:00 PM,48,-122,36,1,37
8967,58thStGreenway22ndAve,01/09/2015 03:00:00 PM,48,-122,24,0,24
8968,58thStGreenway22ndAve,01/09/2015 04:00:00 PM,48,-122,31,0,31
8969,58thStGreenway22ndAve,01/09/2015 05:00:00 PM,48,-122,40,0,40
8970,58thStGreenway22ndAve,01/09/2015 06:00:00 PM,48,-122,34,0,34
8971,58thStGreenway22ndAve,01/09/2015 07:00:00 PM,48,-122,33,0,33
8972,58thStGreenway22ndAve,01/09/2015 08:00:00 PM,48,-122,20,1,21
8973,58thStGreenway22ndAve,01/09/2015 09:00:00 PM,48,-122,11,0,11
8974,58thStGreenway22ndAve,01/09/2015 10:00:00 PM,48,-122,9,0,9
8975,58thStGreenway22ndAve,01/09/2015 11:00:00 PM,48,-122,8,0,8
8976,58thStGreenway22ndAve,01/10/2015 12:00:00 AM,48,-122,7,0,7
8977,58thStGreenway22ndAve,01/10/2015 01:00:00 AM,48,-122,4,0,4
8978,58thStGreenway22ndAve,01/10/2015 02:00:00 AM,48,-122,2,0,2
8979,58thStGreenway22ndAve,01/10/2015 03:00:00 AM,48,-122,3,0,3
8980,58thStGreenway22ndAve,01/10/2015 04:00:00 AM,48,-122,0,0,0
8981,58thStGreenway22ndAve,01/10/2015 05:00:00 AM,48,-122,1,0,1
8982,58thStGreenway22ndAve,01/10/2015 06:00:00 AM,48,-122,4,0,4
8983,58thStGreenway22ndAve,01/10/2015 07:00:00 AM,48,-122,3,0,3
8984,58thStGreenway22ndAve,01/10/2015 08:00:00 AM,48,-122,9,0,9
8985,58thStGreenway22ndAve,01/10/2015 09:00:00 AM,48,-122,21,0,21
8986,58thStGreenway22ndAve,01/10/2015 10:00:00 AM,48,-122,22,0,22
8987,58thStGreenway22ndAve,01/10/2015 11:00:00 AM,48,-122,33,2,35
8988,58thStGreenway22ndAve,01/10/2015 12:00:00 PM,48,-122,40,2,42
8989,58thStGreenway22ndAve,01/10/2015 01:00:00 PM,48,-122,48,2,50
8990,58thStGreenway22ndAve,01/10/2015 02:00:00 PM,48,-122,36,0,36
8991,58thStGreenway22ndAve,01/10/2015 03:00:00 PM,48,-122,40,0,40
8992,58thStGreenway22ndAve,01/10/2015 04:00:00 PM,48,-122,36,0,36
8993,58thStGreenway22ndAve,01/10/2015 05:00:00 PM,48,-122,29,0,29
8994,58thStGreenway22ndAve,01/10/2015 06:00:00 PM,48,-122,16,0,16
8995,58thStGreenway22ndAve,01/10/2015 07:00:00 PM,48,-122,12,0,12
8996,58thStGreenway22ndAve,01/10/2015 08:00:00 PM,48,-122,23,0,23
8997,58thStGreenway22ndAve,01/10/2015 09:00:00 PM,48,-122,21,0,21
8998,58thStGreenway22ndAve,01/10/2015 10:00:00 PM,48,-122,5,0,5
8999,58thStGreenway22ndAve,01/10/2015 11:00:00 PM,48,-122,9,0,9
9000,58thStGreenway22ndAve,01/11/2015 12:00:00 AM,48,-122,6,0,6
9001,58thStGreenway22ndAve,01/11/2015 01:00:00 AM,48,-122,8,0,8
9002,58thStGreenway22ndAve,01/11/2015 02:00:00 AM,48,-122,5,0,5
9003,58thStGreenway22ndAve,01/11/2015 03:00:00 AM,48,-122,0,0,0
9004,58thStGreenway22ndAve,01/11/2015 04:00:00 AM,48,-122,2,0,2
9005,58thStGreenway22ndAve,01/11/2015 05:00:00 AM,48,-122,0,0,0
9006,58thStGreenway22ndAve,01/11/2015 06:00:00 AM,48,-122,4,0,4
9007,58thStGreenway22ndAve,01/11/2015 07:00:00 AM,48,-122,7,0,7
9008,58thStGreenway22ndAve,01/11/2015 08:00:00 AM,48,-122,10,0,10
9009,58thStGreenway22ndAve,01/11/2015 09:00:00 AM,48,-122,16,0,16
9010,58thStGreenway22ndAve,01/11/2015 10:00:00 AM,48,-122,31,0,31
9011,58thStGreenway22ndAve,01/11/2015 11:00:00 AM,48,-122,39,0,39
9012,58thStGreenway22ndAve,01/11/2015 12:00:00 PM,48,-122,62,0,62
9013,58thStGreenway22ndAve,01/11/2015 01:00:00 PM,48,-122,64,0,64
9014,58thStGreenway22ndAve,01/11/2015 02:00:00 PM,48,-122,44,1,45
9015,58thStGreenway22ndAve,01/11/2015 03:00:00 PM,48,-122,30,0,30
9016,58thStGreenway22ndAve,01/11/2015 04:00:00 PM,48,-122,40,0,40
9017,58thStGreenway22ndAve,01/11/2015 05:00:00 PM,48,-122,34,1,35
9018,58thStGreenway22ndAve,01/11/2015 06:00:00 PM,48,-122,22,0,22
9019,58thStGreenway22ndAve,01/11/2015 07:00:00 PM,48,-122,16,0,16
9020,58thStGreenway22ndAve,01/11/2015 08:00:00 PM,48,-122,12,0,12
9021,58thStGreenway22ndAve,01/11/2015 09:00:00 PM,48,-122,11,0,11
9022,58thStGreenway22ndAve,01/11/2015 10:00:00 PM,48,-122,6,0,6
9023,58thStGreenway22ndAve,01/11/2015 11:00:00 PM,48,-122,2,0,2
9024,58thStGreenway22ndAve,01/12/2015 12:00:00 AM,48,-122,0,0,0
9025,58thStGreenway22ndAve,01/12/2015 01:00:00 AM,48,-122,0,0,0
9026,58thStGreenway22ndAve,01/12/2015 02:00:00 AM,48,-122,3,0,3
9027,58thStGreenway22ndAve,01/12/2015 03:00:00 AM,48,-122,0,0,0
9028,58thStGreenway22ndAve,01/12/2015 04:00:00 AM,48,-122,0,0,0
9029,58thStGreenway22ndAve,01/12/2015 05:00:00 AM,48,-122,2,0,2
9030,58thStGreenway22ndAve,01/12/2015 06:00:00 AM,48,-122,7,0,7
9031,58thStGreenway22ndAve,01/12/2015 07:00:00 AM,48,-122,21,0,21
9032,58thStGreenway22ndAve,01/12/2015 08:00:00 AM,48,-122,20,0,20
9033,58thStGreenway22ndAve,01/12/2015 09:00:00 AM,48,-122,21,0,21
9034,58thStGreenway22ndAve,01/12/2015 10:00:00 AM,48,-122,15,0,15
9035,58thStGreenway22ndAve,01/12/2015 11:00:00 AM,48,-122,13,1,14
9036,58thStGreenway22ndAve,01/12/2015 12:00:00 PM,48,-122,23,0,23
9037,58thStGreenway22ndAve,01/12/2015 01:00:00 PM,48,-122,35,0,35
9038,58thStGreenway22ndAve,01/12/2015 02:00:00 PM,48,-122,35,0,35
9039,58thStGreenway22ndAve,01/12/2015 03:00:00 PM,48,-122,39,0,39
9040,58thStGreenway22ndAve,01/12/2015 04:00:00 PM,48,-122,34,0,34
9041,58thStGreenway22ndAve,01/12/2015 05:00:00 PM,48,-122,27,1,28
9042,58thStGreenway22ndAve,01/12/2015 06:00:00 PM,48,-122,27,0,27
9043,58thStGreenway22ndAve,01/12/2015 07:00:00 PM,48,-122,20,0,20
9044,58thStGreenway22ndAve,01/12/2015 08:00:00 PM,48,-122,8,0,8
9045,58thStGreenway22ndAve,01/12/2015 09:00:00 PM,48,-122,17,0,17
9046,58thStGreenway22ndAve,01/12/2015 10:00:00 PM,48,-122,9,0,9
9047,58thStGreenway22ndAve,01/12/2015 11:00:00 PM,48,-122,4,0,4
9048,58thStGreenway22ndAve,01/13/2015 12:00:00 AM,48,-122,4,0,4
9049,58thStGreenway22ndAve,01/13/2015 01:00:00 AM,48,-122,3,0,3
9050,58thStGreenway22ndAve,01/13/2015 02:00:00 AM,48,-122,3,0,3
9051,58thStGreenway22ndAve,01/13/2015 03:00:00 AM,48,-122,2,0,2
9052,58thStGreenway22ndAve,01/13/2015 04:00:00 AM,48,-122,0,0,0
9053,58thStGreenway22ndAve,01/13/2015 05:00:00 AM,48,-122,1,0,1
9054,58thStGreenway22ndAve,01/13/2015 06:00:00 AM,48,-122,6,0,6
9055,58thStGreenway22ndAve,01/13/2015 07:00:00 AM,48,-122,24,0,24
9056,58thStGreenway22ndAve,01/13/2015 08:00:00 AM,48,-122,25,0,25
9057,58thStGreenway22ndAve,01/13/2015 09:00:00 AM,48,-122,28,0,28
9058,58thStGreenway22ndAve,01/13/2015 10:00:00 AM,48,-122,27,0,27
9059,58thStGreenway22ndAve,01/13/2015 11:00:00 AM,48,-122,29,1,30
9060,58thStGreenway22ndAve,01/13/2015 12:00:00 PM,48,-122,29,0,29
9061,58thStGreenway22ndAve,01/13/2015 01:00:00 PM,48,-122,22,1,23
9062,58thStGreenway22ndAve,01/13/2015 02:00:00 PM,48,-122,31,0,31
9063,58thStGreenway22ndAve,01/13/2015 03:00:00 PM,48,-122,34,0,34
9064,58thStGreenway22ndAve,01/13/2015 04:00:00 PM,48,-122,26,0,26
9065,58thStGreenway22ndAve,01/13/2015 05:00:00 PM,48,-122,42,1,43
9066,58thStGreenway22ndAve,01/13/2015 06:00:00 PM,48,-122,27,0,27
9067,58thStGreenway22ndAve,01/13/2015 07:00:00 PM,48,-122,21,0,21
9068,58thStGreenway22ndAve,01/13/2015 08:00:00 PM,48,-122,17,0,17
9069,58thStGreenway22ndAve,01/13/2015 09:00:00 PM,48,-122,14,0,14
9070,58thStGreenway22ndAve,01/13/2015 10:00:00 PM,48,-122,14,0,14
9071,58thStGreenway22ndAve,01/13/2015 11:00:00 PM,48,-122,4,0,4
9072,58thStGreenway22ndAve,01/14/2015 12:00:00 AM,48,-122,1,0,1
9073,58thStGreenway22ndAve,01/14/2015 01:00:00 AM,48,-122,0,0,0
9074,58thStGreenway22ndAve,01/14/2015 02:00:00 AM,48,-122,0,0,0
9075,58thStGreenway22ndAve,01/14/2015 03:00:00 AM,48,-122,2,0,2
9076,58thStGreenway22ndAve,01/14/2015 04:00:00 AM,48,-122,2,0,2
9077,58thStGreenway22ndAve,01/14/2015 05:00:00 AM,48,-122,4,0,4
9078,58thStGreenway22ndAve,01/14/2015 06:00:00 AM,48,-122,10,0,10
9079,58thStGreenway22ndAve,01/14/2015 07:00:00 AM,48,-122,20,0,20
9080,58thStGreenway22ndAve,01/14/2015 08:00:00 AM,48,-122,26,1,27
9081,58thStGreenway22ndAve,01/14/2015 09:00:00 AM,48,-122,22,0,22
9082,58thStGreenway22ndAve,01/14/2015 10:00:00 AM,48,-122,18,0,18
9083,58thStGreenway22ndAve,01/14/2015 11:00:00 AM,48,-122,13,0,13
9084,58thStGreenway22ndAve,01/14/2015 12:00:00 PM,48,-122,21,1,22
9085,58thStGreenway22ndAve,01/14/2015 01:00:00 PM,48,-122,31,0,31
9086,58thStGreenway22ndAve,01/14/2015 02:00:00 PM,48,-122,32,0,32
9087,58thStGreenway22ndAve,01/14/2015 03:00:00 PM,48,-122,20,0,20
9088,58thStGreenway22ndAve,01/14/2015 04:00:00 PM,48,-122,25,0,25
9089,58thStGreenway22ndAve,01/14/2015 05:00:00 PM,48,-122,28,0,28
9090,58thStGreenway22ndAve,01/14/2015 06:00:00 PM,48,-122,25,1,26
9091,58thStGreenway22ndAve,01/14/2015 07:00:00 PM,48,-122,31,0,31
9092,58thStGreenway22ndAve,01/14/2015 08:00:00 PM,48,-122,16,0,16
9093,58thStGreenway22ndAve,01/14/2015 09:00:00 PM,48,-122,16,0,16
9094,58thStGreenway22ndAve,01/14/2015 10:00:00 PM,48,-122,10,0,10
9095,58thStGreenway22ndAve,01/14/2015 11:00:00 PM,48,-122,5,0,5
9096,58thStGreenway22ndAve,01/15/2015 12:00:00 AM,48,-122,6,0,6
9097,58thStGreenway22ndAve,01/15/2015 01:00:00 AM,48,-122,0,0,0
9098,58thStGreenway22ndAve,01/15/2015 02:00:00 AM,48,-122,2,0,2
9099,58thStGreenway22ndAve,01/15/2015 03:00:00 AM,48,-122,1,0,1
9100,58thStGreenway22ndAve,01/15/2015 04:00:00 AM,48,-122,0,0,0
9101,58thStGreenway22ndAve,01/15/2015 05:00:00 AM,48,-122,5,0,5
9102,58thStGreenway22ndAve,01/15/2015 06:00:00 AM,48,-122,6,0,6
9103,58thStGreenway22ndAve,01/15/2015 07:00:00 AM,48,-122,15,0,15
9104,58thStGreenway22ndAve,01/15/2015 08:00:00 AM,48,-122,15,0,15
9105,58thStGreenway22ndAve,01/15/2015 09:00:00 AM,48,-122,25,0,25
9106,58thStGreenway22ndAve,01/15/2015 10:00:00 AM,48,-122,17,0,17
9107,58thStGreenway22ndAve,01/15/2015 11:00:00 AM,48,-122,28,0,28
9108,58thStGreenway22ndAve,01/15/2015 12:00:00 PM,48,-122,29,1,30
9109,58thStGreenway22ndAve,01/15/2015 01:00:00 PM,48,-122,25,0,25
9110,58thStGreenway22ndAve,01/15/2015 02:00:00 PM,48,-122,28,0,28
9111,58thStGreenway22ndAve,01/15/2015 03:00:00 PM,48,-122,34,0,34
9112,58thStGreenway22ndAve,01/15/2015 04:00:00 PM,48,-122,37,1,38
9113,58thStGreenway22ndAve,01/15/2015 05:00:00 PM,48,-122,24,0,24
9114,58thStGreenway22ndAve,01/15/2015 06:00:00 PM,48,-122,21,0,21
9115,58thStGreenway22ndAve,01/15/2015 07:00:00 PM,48,-122,30,0,30
9116,58thStGreenway22ndAve,01/15/2015 08:00:00 PM,48,-122,8,1,9
9117,58thStGreenway22ndAve,01/15/2015 09:00:00 PM,48,-122,26,0,26
9118,58thStGreenway22ndAve,01/15/2015 10:00:00 PM,48,-122,12,0,12
9119,58thStGreenway22ndAve,01/15/2015 11:00:00 PM,48,-122,2,0,2
9120,58thStGreenway22ndAve,01/16/2015 12:00:00 AM,48,-122,4,0,4
9121,58thStGreenway22ndAve,01/16/2015 01:00:00 AM,48,-122,1,0,1
9122,58thStGreenway22ndAve,01/16/2015 02:00:00 AM,48,-122,3,0,3
9123,58thStGreenway22ndAve,01/16/2015 03:00:00 AM,48,-122,2,0,2
9124,58thStGreenway22ndAve,01/16/2015 04:00:00 AM,48,-122,1,0,1
9125,58thStGreenway22ndAve,01/16/2015 05:00:00 AM,48,-122,3,0,3
9126,58thStGreenway22ndAve,01/16/2015 06:00:00 AM,48,-122,10,0,10
9127,58thStGreenway22ndAve,01/16/2015 07:00:00 AM,48,-122,17,0,17
9128,58thStGreenway22ndAve,01/16/2015 08:00:00 AM,48,-122,26,0,26
9129,58thStGreenway22ndAve,01/16/2015 09:00:00 AM,48,-122,24,0,24
9130,58thStGreenway22ndAve,01/16/2015 10:00:00 AM,48,-122,32,0,32
9131,58thStGreenway22ndAve,01/16/2015 11:00:00 AM,48,-122,43,0,43
9132,58thStGreenway22ndAve,01/16/2015 12:00:00 PM,48,-122,36,1,37
9133,58thStGreenway22ndAve,01/16/2015 01:00:00 PM,48,-122,40,0,40
9134,58thStGreenway22ndAve,01/16/2015 02:00:00 PM,48,-122,33,0,33
9135,58thStGreenway22ndAve,01/16/2015 03:00:00 PM,48,-122,42,0,42
9136,58thStGreenway22ndAve,01/16/2015 04:00:00 PM,48,-122,31,0,31
9137,58thStGreenway22ndAve,01/16/2015 05:00:00 PM,48,-122,47,0,47
9138,58thStGreenway22ndAve,01/16/2015 06:00:00 PM,48,-122,47,0,47
9139,58thStGreenway22ndAve,01/16/2015 07:00:00 PM,48,-122,56,0,56
9140,58thStGreenway22ndAve,01/16/2015 08:00:00 PM,48,-122,50,6,56
9141,58thStGreenway22ndAve,01/16/2015 09:00:00 PM,48,-122,29,0,29
9142,58thStGreenway22ndAve,01/16/2015 10:00:00 PM,48,-122,13,0,13
9143,58thStGreenway22ndAve,01/16/2015 11:00:00 PM,48,-122,14,0,14
9144,58thStGreenway22ndAve,01/17/2015 12:00:00 AM,48,-122,7,0,7
9145,58thStGreenway22ndAve,01/17/2015 01:00:00 AM,48,-122,5,0,5
9146,58thStGreenway22ndAve,01/17/2015 02:00:00 AM,48,-122,1,0,1
9147,58thStGreenway22ndAve,01/17/2015 03:00:00 AM,48,-122,0,0,0
9148,58thStGreenway22ndAve,01/17/2015 04:00:00 AM,48,-122,2,0,2
9149,58thStGreenway22ndAve,01/17/2015 05:00:00 AM,48,-122,3,0,3
9150,58thStGreenway22ndAve,01/17/2015 06:00:00 AM,48,-122,5,0,5
9151,58thStGreenway22ndAve,01/17/2015 07:00:00 AM,48,-122,6,0,6
9152,58thStGreenway22ndAve,01/17/2015 08:00:00 AM,48,-122,14,0,14
9153,58thStGreenway22ndAve,01/17/2015 09:00:00 AM,48,-122,34,0,34
9154,58thStGreenway22ndAve,01/17/2015 10:00:00 AM,48,-122,50,0,50
9155,58thStGreenway22ndAve,01/17/2015 11:00:00 AM,48,-122,57,1,58
9156,58thStGreenway22ndAve,01/17/2015 12:00:00 PM,48,-122,76,0,76
9157,58thStGreenway22ndAve,01/17/2015 01:00:00 PM,48,-122,63,0,63
9158,58thStGreenway22ndAve,01/17/2015 02:00:00 PM,48,-122,64,1,65
9159,58thStGreenway22ndAve,01/17/2015 03:00:00 PM,48,-122,54,0,54
9160,58thStGreenway22ndAve,01/17/2015 04:00:00 PM,48,-122,39,0,39
9161,58thStGreenway22ndAve,01/17/2015 05:00:00 PM,48,-122,37,0,37
9162,58thStGreenway22ndAve,01/17/2015 06:00:00 PM,48,-122,41,0,41
9163,58thStGreenway22ndAve,01/17/2015 07:00:00 PM,48,-122,25,0,25
9164,58thStGreenway22ndAve,01/17/2015 08:00:00 PM,48,-122,21,0,21
9165,58thStGreenway22ndAve,01/17/2015 09:00:00 PM,48,-122,19,0,19
9166,58thStGreenway22ndAve,01/17/2015 10:00:00 PM,48,-122,12,0,12
9167,58thStGreenway22ndAve,01/17/2015 11:00:00 PM,48,-122,7,0,7
9168,58thStGreenway22ndAve,01/18/2015 12:00:00 AM,48,-122,10,0,10
9169,58thStGreenway22ndAve,01/18/2015 01:00:00 AM,48,-122,4,0,4
9170,58thStGreenway22ndAve,01/18/2015 02:00:00 AM,48,-122,3,0,3
9171,58thStGreenway22ndAve,01/18/2015 03:00:00 AM,48,-122,0,0,0
9172,58thStGreenway22ndAve,01/18/2015 04:00:00 AM,48,-122,1,0,1
9173,58thStGreenway22ndAve,01/18/2015 05:00:00 AM,48,-122,1,0,1
9174,58thStGreenway22ndAve,01/18/2015 06:00:00 AM,48,-122,3,0,3
9175,58thStGreenway22ndAve,01/18/2015 07:00:00 AM,48,-122,4,0,4
9176,58thStGreenway22ndAve,01/18/2015 08:00:00 AM,48,-122,14,1,15
9177,58thStGreenway22ndAve,01/18/2015 09:00:00 AM,48,-122,26,0,26
9178,58thStGreenway22ndAve,01/18/2015 10:00:00 AM,48,-122,28,0,28
9179,58thStGreenway22ndAve,01/18/2015 11:00:00 AM,48,-122,53,1,54
9180,58thStGreenway22ndAve,01/18/2015 12:00:00 PM,48,-122,35,0,35
9181,58thStGreenway22ndAve,01/18/2015 01:00:00 PM,48,-122,29,0,29
9182,58thStGreenway22ndAve,01/18/2015 02:00:00 PM,48,-122,26,0,26
9183,58thStGreenway22ndAve,01/18/2015 03:00:00 PM,48,-122,21,0,21
9184,58thStGreenway22ndAve,01/18/2015 04:00:00 PM,48,-122,29,0,29
9185,58thStGreenway22ndAve,01/18/2015 05:00:00 PM,48,-122,14,0,14
9186,58thStGreenway22ndAve,01/18/2015 06:00:00 PM,48,-122,23,0,23
9187,58thStGreenway22ndAve,01/18/2015 07:00:00 PM,48,-122,15,0,15
9188,58thStGreenway22ndAve,01/18/2015 08:00:00 PM,48,-122,9,0,9
9189,58thStGreenway22ndAve,01/18/2015 09:00:00 PM,48,-122,14,0,14
9190,58thStGreenway22ndAve,01/18/2015 10:00:00 PM,48,-122,6,0,6
9191,58thStGreenway22ndAve,01/18/2015 11:00:00 PM,48,-122,2,0,2
9192,58thStGreenway22ndAve,01/19/2015 12:00:00 AM,48,-122,2,0,2
9193,58thStGreenway22ndAve,01/19/2015 01:00:00 AM,48,-122,0,0,0
9194,58thStGreenway22ndAve,01/19/2015 02:00:00 AM,48,-122,0,0,0
9195,58thStGreenway22ndAve,01/19/2015 03:00:00 AM,48,-122,1,0,1
9196,58thStGreenway22ndAve,01/19/2015 04:00:00 AM,48,-122,2,0,2
9197,58thStGreenway22ndAve,01/19/2015 05:00:00 AM,48,-122,2,0,2
9198,58thStGreenway22ndAve,01/19/2015 06:00:00 AM,48,-122,7,0,7
9199,58thStGreenway22ndAve,01/19/2015 07:00:00 AM,48,-122,7,0,7
9200,58thStGreenway22ndAve,01/19/2015 08:00:00 AM,48,-122,8,0,8
9201,58thStGreenway22ndAve,01/19/2015 09:00:00 AM,48,-122,14,0,14
9202,58thStGreenway22ndAve,01/19/2015 10:00:00 AM,48,-122,21,1,22
9203,58thStGreenway22ndAve,01/19/2015 11:00:00 AM,48,-122,36,1,37
9204,58thStGreenway22ndAve,01/19/2015 12:00:00 PM,48,-122,54,0,54
9205,58thStGreenway22ndAve,01/19/2015 01:00:00 PM,48,-122,42,2,44
9206,58thStGreenway22ndAve,01/19/2015 02:00:00 PM,48,-122,43,0,43
9207,58thStGreenway22ndAve,01/19/2015 03:00:00 PM,48,-122,36,0,36
9208,58thStGreenway22ndAve,01/19/2015 04:00:00 PM,48,-122,35,0,35
9209,58thStGreenway22ndAve,01/19/2015 05:00:00 PM,48,-122,27,0,27
9210,58thStGreenway22ndAve,01/19/2015 06:00:00 PM,48,-122,33,0,33
9211,58thStGreenway22ndAve,01/19/2015 07:00:00 PM,48,-122,23,0,23
9212,58thStGreenway22ndAve,01/19/2015 08:00:00 PM,48,-122,14,0,14
9213,58thStGreenway22ndAve,01/19/2015 09:00:00 PM,48,-122,15,0,15
9214,58thStGreenway22ndAve,01/19/2015 10:00:00 PM,48,-122,9,0,9
9215,58thStGreenway22ndAve,01/19/2015 11:00:00 PM,48,-122,4,0,4
9216,58thStGreenway22ndAve,01/20/2015 12:00:00 AM,48,-122,0,0,0
9217,58thStGreenway22ndAve,01/20/2015 01:00:00 AM,48,-122,0,0,0
9218,58thStGreenway22ndAve,01/20/2015 02:00:00 AM,48,-122,1,0,1
9219,58thStGreenway22ndAve,01/20/2015 03:00:00 AM,48,-122,2,0,2
9220,58thStGreenway22ndAve,01/20/2015 04:00:00 AM,48,-122,0,0,0
9221,58thStGreenway22ndAve,01/20/2015 05:00:00 AM,48,-122,2,0,2
9222,58thStGreenway22ndAve,01/20/2015 06:00:00 AM,48,-122,12,0,12
9223,58thStGreenway22ndAve,01/20/2015 07:00:00 AM,48,-122,15,0,15
9224,58thStGreenway22ndAve,01/20/2015 08:00:00 AM,48,-122,26,0,26
9225,58thStGreenway22ndAve,01/20/2015 09:00:00 AM,48,-122,34,0,34
9226,58thStGreenway22ndAve,01/20/2015 10:00:00 AM,48,-122,23,0,23
9227,58thStGreenway22ndAve,01/20/2015 11:00:00 AM,48,-122,24,0,24
9228,58thStGreenway22ndAve,01/20/2015 12:00:00 PM,48,-122,34,0,34
9229,58thStGreenway22ndAve,01/20/2015 01:00:00 PM,48,-122,40,1,41
9230,58thStGreenway22ndAve,01/20/2015 02:00:00 PM,48,-122,38,0,38
9231,58thStGreenway22ndAve,01/20/2015 03:00:00 PM,48,-122,31,1,32
9232,58thStGreenway22ndAve,01/20/2015 04:00:00 PM,48,-122,28,1,29
9233,58thStGreenway22ndAve,01/20/2015 05:00:00 PM,48,-122,27,0,27
9234,58thStGreenway22ndAve,01/20/2015 06:00:00 PM,48,-122,31,0,31
9235,58thStGreenway22ndAve,01/20/2015 07:00:00 PM,48,-122,24,0,24
9236,58thStGreenway22ndAve,01/20/2015 08:00:00 PM,48,-122,21,0,21
9237,58thStGreenway22ndAve,01/20/2015 09:00:00 PM,48,-122,15,0,15
9238,58thStGreenway22ndAve,01/20/2015 10:00:00 PM,48,-122,13,0,13
9239,58thStGreenway22ndAve,01/20/2015 11:00:00 PM,48,-122,4,0,4
9240,58thStGreenway22ndAve,01/21/2015 12:00:00 AM,48,-122,3,0,3
9241,58thStGreenway22ndAve,01/21/2015 01:00:00 AM,48,-122,0,0,0
9242,58thStGreenway22ndAve,01/21/2015 02:00:00 AM,48,-122,0,0,0
9243,58thStGreenway22ndAve,01/21/2015 03:00:00 AM,48,-122,3,0,3
9244,58thStGreenway22ndAve,01/21/2015 04:00:00 AM,48,-122,1,0,1
9245,58thStGreenway22ndAve,01/21/2015 05:00:00 AM,48,-122,2,0,2
9246,58thStGreenway22ndAve,01/21/2015 06:00:00 AM,48,-122,5,0,5
9247,58thStGreenway22ndAve,01/21/2015 07:00:00 AM,48,-122,11,0,11
9248,58thStGreenway22ndAve,01/21/2015 08:00:00 AM,48,-122,10,0,10
9249,58thStGreenway22ndAve,01/21/2015 09:00:00 AM,48,-122,22,0,22
9250,58thStGreenway22ndAve,01/21/2015 10:00:00 AM,48,-122,20,0,20
9251,58thStGreenway22ndAve,01/21/2015 11:00:00 AM,48,-122,27,0,27
9252,58thStGreenway22ndAve,01/21/2015 12:00:00 PM,48,-122,20,0,20
9253,58thStGreenway22ndAve,01/21/2015 01:00:00 PM,48,-122,38,0,38
9254,58thStGreenway22ndAve,01/21/2015 02:00:00 PM,48,-122,30,0,30
9255,58thStGreenway22ndAve,01/21/2015 03:00:00 PM,48,-122,33,0,33
9256,58thStGreenway22ndAve,01/21/2015 04:00:00 PM,48,-122,27,4,31
9257,58thStGreenway22ndAve,01/21/2015 05:00:00 PM,48,-122,27,1,28
9258,58thStGreenway22ndAve,01/21/2015 06:00:00 PM,48,-122,25,0,25
9259,58thStGreenway22ndAve,01/21/2015 07:00:00 PM,48,-122,26,0,26
9260,58thStGreenway22ndAve,01/21/2015 08:00:00 PM,48,-122,19,0,19
9261,58thStGreenway22ndAve,01/21/2015 09:00:00 PM,48,-122,14,0,14
9262,58thStGreenway22ndAve,01/21/2015 10:00:00 PM,48,-122,10,0,10
9263,58thStGreenway22ndAve,01/21/2015 11:00:00 PM,48,-122,2,0,2
9264,58thStGreenway22ndAve,01/22/2015 12:00:00 AM,48,-122,2,0,2
9265,58thStGreenway22ndAve,01/22/2015 01:00:00 AM,48,-122,1,0,1
9266,58thStGreenway22ndAve,01/22/2015 02:00:00 AM,48,-122,0,0,0
9267,58thStGreenway22ndAve,01/22/2015 03:00:00 AM,48,-122,0,0,0
9268,58thStGreenway22ndAve,01/22/2015 04:00:00 AM,48,-122,0,0,0
9269,58thStGreenway22ndAve,01/22/2015 05:00:00 AM,48,-122,3,0,3
9270,58thStGreenway22ndAve,01/22/2015 06:00:00 AM,48,-122,12,0,12
9271,58thStGreenway22ndAve,01/22/2015 07:00:00 AM,48,-122,15,0,15
9272,58thStGreenway22ndAve,01/22/2015 08:00:00 AM,48,-122,21,0,21
9273,58thStGreenway22ndAve,01/22/2015 09:00:00 AM,48,-122,21,0,21
9274,58thStGreenway22ndAve,01/22/2015 10:00:00 AM,48,-122,26,0,26
9275,58thStGreenway22ndAve,01/22/2015 11:00:00 AM,48,-122,34,0,34
9276,58thStGreenway22ndAve,01/22/2015 12:00:00 PM,48,-122,35,0,35
9277,58thStGreenway22ndAve,01/22/2015 01:00:00 PM,48,-122,32,0,32
9278,58thStGreenway22ndAve,01/22/2015 02:00:00 PM,48,-122,45,1,46
9279,58thStGreenway22ndAve,01/22/2015 03:00:00 PM,48,-122,30,0,30
9280,58thStGreenway22ndAve,01/22/2015 04:00:00 PM,48,-122,35,0,35
9281,58thStGreenway22ndAve,01/22/2015 05:00:00 PM,48,-122,48,1,49
9282,58thStGreenway22ndAve,01/22/2015 06:00:00 PM,48,-122,30,0,30
9283,58thStGreenway22ndAve,01/22/2015 07:00:00 PM,48,-122,25,0,25
9284,58thStGreenway22ndAve,01/22/2015 08:00:00 PM,48,-122,17,0,17
9285,58thStGreenway22ndAve,01/22/2015 09:00:00 PM,48,-122,14,0,14
9286,58thStGreenway22ndAve,01/22/2015 10:00:00 PM,48,-122,13,0,13
9287,58thStGreenway22ndAve,01/22/2015 11:00:00 PM,48,-122,8,0,8
9288,58thStGreenway22ndAve,01/23/2015 12:00:00 AM,48,-122,1,0,1
9289,58thStGreenway22ndAve,01/23/2015 01:00:00 AM,48,-122,0,0,0
9290,58thStGreenway22ndAve,01/23/2015 02:00:00 AM,48,-122,4,0,4
9291,58thStGreenway22ndAve,01/23/2015 03:00:00 AM,48,-122,1,0,1
9292,58thStGreenway22ndAve,01/23/2015 04:00:00 AM,48,-122,0,0,0
9293,58thStGreenway22ndAve,01/23/2015 05:00:00 AM,48,-122,0,0,0
9294,58thStGreenway22ndAve,01/23/2015 06:00:00 AM,48,-122,10,0,10
9295,58thStGreenway22ndAve,01/23/2015 07:00:00 AM,48,-122,30,0,30
9296,58thStGreenway22ndAve,01/23/2015 08:00:00 AM,48,-122,40,0,40
9297,58thStGreenway22ndAve,01/23/2015 09:00:00 AM,48,-122,29,0,29
9298,58thStGreenway22ndAve,01/23/2015 10:00:00 AM,48,-122,16,1,17
9299,58thStGreenway22ndAve,01/23/2015 11:00:00 AM,48,-122,52,1,53
9300,58thStGreenway22ndAve,01/23/2015 12:00:00 PM,48,-122,36,1,37
9301,58thStGreenway22ndAve,01/23/2015 01:00:00 PM,48,-122,37,0,37
9302,58thStGreenway22ndAve,01/23/2015 02:00:00 PM,48,-122,44,0,44
9303,58thStGreenway22ndAve,01/23/2015 03:00:00 PM,48,-122,41,0,41
9304,58thStGreenway22ndAve,01/23/2015 04:00:00 PM,48,-122,41,0,41
9305,58thStGreenway22ndAve,01/23/2015 05:00:00 PM,48,-122,42,0,42
9306,58thStGreenway22ndAve,01/23/2015 06:00:00 PM,48,-122,49,0,49
9307,58thStGreenway22ndAve,01/23/2015 07:00:00 PM,48,-122,50,4,54
9308,58thStGreenway22ndAve,01/23/2015 08:00:00 PM,48,-122,36,0,36
9309,58thStGreenway22ndAve,01/23/2015 09:00:00 PM,48,-122,21,1,22
9310,58thStGreenway22ndAve,01/23/2015 10:00:00 PM,48,-122,12,0,12
9311,58thStGreenway22ndAve,01/23/2015 11:00:00 PM,48,-122,9,0,9
9312,58thStGreenway22ndAve,01/24/2015 12:00:00 AM,48,-122,4,0,4
9313,58thStGreenway22ndAve,01/24/2015 01:00:00 AM,48,-122,7,0,7
9314,58thStGreenway22ndAve,01/24/2015 02:00:00 AM,48,-122,2,0,2
9315,58thStGreenway22ndAve,01/24/2015 03:00:00 AM,48,-122,2,0,2
9316,58thStGreenway22ndAve,01/24/2015 04:00:00 AM,48,-122,0,0,0
9317,58thStGreenway22ndAve,01/24/2015 05:00:00 AM,48,-122,2,0,2
9318,58thStGreenway22ndAve,01/24/2015 06:00:00 AM,48,-122,2,0,2
9319,58thStGreenway22ndAve,01/24/2015 07:00:00 AM,48,-122,8,0,8
9320,58thStGreenway22ndAve,01/24/2015 08:00:00 AM,48,-122,11,0,11
9321,58thStGreenway22ndAve,01/24/2015 09:00:00 AM,48,-122,33,0,33
9322,58thStGreenway22ndAve,01/24/2015 10:00:00 AM,48,-122,43,2,45
9323,58thStGreenway22ndAve,01/24/2015 11:00:00 AM,48,-122,35,0,35
9324,58thStGreenway22ndAve,01/24/2015 12:00:00 PM,48,-122,72,0,72
9325,58thStGreenway22ndAve,01/24/2015 01:00:00 PM,48,-122,69,0,69
9326,58thStGreenway22ndAve,01/24/2015 02:00:00 PM,48,-122,76,0,76
9327,58thStGreenway22ndAve,01/24/2015 03:00:00 PM,48,-122,42,0,42
9328,58thStGreenway22ndAve,01/24/2015 04:00:00 PM,48,-122,31,0,31
9329,58thStGreenway22ndAve,01/24/2015 05:00:00 PM,48,-122,49,0,49
9330,58thStGreenway22ndAve,01/24/2015 06:00:00 PM,48,-122,48,0,48
9331,58thStGreenway22ndAve,01/24/2015 07:00:00 PM,48,-122,49,0,49
9332,58thStGreenway22ndAve,01/24/2015 08:00:00 PM,48,-122,22,1,23
9333,58thStGreenway22ndAve,01/24/2015 09:00:00 PM,48,-122,21,1,22
9334,58thStGreenway22ndAve,01/24/2015 10:00:00 PM,48,-122,17,0,17
9335,58thStGreenway22ndAve,01/24/2015 11:00:00 PM,48,-122,11,0,11
9336,58thStGreenway22ndAve,01/25/2015 12:00:00 AM,48,-122,14,0,14
9337,58thStGreenway22ndAve,01/25/2015 01:00:00 AM,48,-122,3,0,3
9338,58thStGreenway22ndAve,01/25/2015 02:00:00 AM,48,-122,1,0,1
9339,58thStGreenway22ndAve,01/25/2015 03:00:00 AM,48,-122,2,0,2
9340,58thStGreenway22ndAve,01/25/2015 04:00:00 AM,48,-122,0,0,0
9341,58thStGreenway22ndAve,01/25/2015 05:00:00 AM,48,-122,0,0,0
9342,58thStGreenway22ndAve,01/25/2015 06:00:00 AM,48,-122,3,0,3
9343,58thStGreenway22ndAve,01/25/2015 07:00:00 AM,48,-122,5,0,5
9344,58thStGreenway22ndAve,01/25/2015 08:00:00 AM,48,-122,5,0,5
9345,58thStGreenway22ndAve,01/25/2015 09:00:00 AM,48,-122,17,0,17
9346,58thStGreenway22ndAve,01/25/2015 10:00:00 AM,48,-122,19,0,19
9347,58thStGreenway22ndAve,01/25/2015 11:00:00 AM,48,-122,40,0,40
9348,58thStGreenway22ndAve,01/25/2015 12:00:00 PM,48,-122,54,0,54
9349,58thStGreenway22ndAve,01/25/2015 01:00:00 PM,48,-122,62,0,62
9350,58thStGreenway22ndAve,01/25/2015 02:00:00 PM,48,-122,44,0,44
9351,58thStGreenway22ndAve,01/25/2015 03:00:00 PM,48,-122,43,0,43
9352,58thStGreenway22ndAve,01/25/2015 04:00:00 PM,48,-122,55,1,56
9353,58thStGreenway22ndAve,01/25/2015 05:00:00 PM,48,-122,38,0,38
9354,58thStGreenway22ndAve,01/25/2015 06:00:00 PM,48,-122,30,0,30
9355,58thStGreenway22ndAve,01/25/2015 07:00:00 PM,48,-122,22,0,22
9356,58thStGreenway22ndAve,01/25/2015 08:00:00 PM,48,-122,10,0,10
9357,58thStGreenway22ndAve,01/25/2015 09:00:00 PM,48,-122,17,0,17
9358,58thStGreenway22ndAve,01/25/2015 10:00:00 PM,48,-122,7,0,7
9359,58thStGreenway22ndAve,01/25/2015 11:00:00 PM,48,-122,8,0,8
9360,58thStGreenway22ndAve,01/26/2015 12:00:00 AM,48,-122,8,0,8
9361,58thStGreenway22ndAve,01/26/2015 01:00:00 AM,48,-122,2,0,2
9362,58thStGreenway22ndAve,01/26/2015 02:00:00 AM,48,-122,2,0,2
9363,58thStGreenway22ndAve,01/26/2015 03:00:00 AM,48,-122,3,0,3
9364,58thStGreenway22ndAve,01/26/2015 04:00:00 AM,48,-122,2,0,2
9365,58thStGreenway22ndAve,01/26/2015 05:00:00 AM,48,-122,0,0,0
9366,58thStGreenway22ndAve,01/26/2015 06:00:00 AM,48,-122,11,0,11
9367,58thStGreenway22ndAve,01/26/2015 07:00:00 AM,48,-122,22,0,22
9368,58thStGreenway22ndAve,01/26/2015 08:00:00 AM,48,-122,32,0,32
9369,58thStGreenway22ndAve,01/26/2015 09:00:00 AM,48,-122,21,0,21
9370,58thStGreenway22ndAve,01/26/2015 10:00:00 AM,48,-122,25,1,26
9371,58thStGreenway22ndAve,01/26/2015 11:00:00 AM,48,-122,21,0,21
9372,58thStGreenway22ndAve,01/26/2015 12:00:00 PM,48,-122,38,0,38
9373,58thStGreenway22ndAve,01/26/2015 01:00:00 PM,48,-122,30,0,30
9374,58thStGreenway22ndAve,01/26/2015 02:00:00 PM,48,-122,39,0,39
9375,58thStGreenway22ndAve,01/26/2015 03:00:00 PM,48,-122,29,0,29
9376,58thStGreenway22ndAve,01/26/2015 04:00:00 PM,48,-122,39,0,39
9377,58thStGreenway22ndAve,01/26/2015 05:00:00 PM,48,-122,35,0,35
9378,58thStGreenway22ndAve,01/26/2015 06:00:00 PM,48,-122,34,0,34
9379,58thStGreenway22ndAve,01/26/2015 07:00:00 PM,48,-122,32,0,32
9380,58thStGreenway22ndAve,01/26/2015 08:00:00 PM,48,-122,19,0,19
9381,58thStGreenway22ndAve,01/26/2015 09:00:00 PM,48,-122,24,0,24
9382,58thStGreenway22ndAve,01/26/2015 10:00:00 PM,48,-122,8,0,8
9383,58thStGreenway22ndAve,01/26/2015 11:00:00 PM,48,-122,4,0,4
9384,58thStGreenway22ndAve,01/27/2015 12:00:00 AM,48,-122,3,0,3
9385,58thStGreenway22ndAve,01/27/2015 01:00:00 AM,48,-122,4,0,4
9386,58thStGreenway22ndAve,01/27/2015 02:00:00 AM,48,-122,2,0,2
9387,58thStGreenway22ndAve,01/27/2015 03:00:00 AM,48,-122,3,0,3
9388,58thStGreenway22ndAve,01/27/2015 04:00:00 AM,48,-122,0,0,0
9389,58thStGreenway22ndAve,01/27/2015 05:00:00 AM,48,-122,1,0,1
9390,58thStGreenway22ndAve,01/27/2015 06:00:00 AM,48,-122,13,0,13
9391,58thStGreenway22ndAve,01/27/2015 07:00:00 AM,48,-122,26,0,26
9392,58thStGreenway22ndAve,01/27/2015 08:00:00 AM,48,-122,37,1,38
9393,58thStGreenway22ndAve,01/27/2015 09:00:00 AM,48,-122,37,0,37
9394,58thStGreenway22ndAve,01/27/2015 10:00:00 AM,48,-122,19,0,19
9395,58thStGreenway22ndAve,01/27/2015 11:00:00 AM,48,-122,34,3,37
9396,58thStGreenway22ndAve,01/27/2015 12:00:00 PM,48,-122,39,0,39
9397,58thStGreenway22ndAve,01/27/2015 01:00:00 PM,48,-122,54,1,55
9398,58thStGreenway22ndAve,01/27/2015 02:00:00 PM,48,-122,42,0,42
9399,58thStGreenway22ndAve,01/27/2015 03:00:00 PM,48,-122,40,0,40
9400,58thStGreenway22ndAve,01/27/2015 04:00:00 PM,48,-122,39,0,39
9401,58thStGreenway22ndAve,01/27/2015 05:00:00 PM,48,-122,45,0,45
9402,58thStGreenway22ndAve,01/27/2015 06:00:00 PM,48,-122,27,0,27
9403,58thStGreenway22ndAve,01/27/2015 07:00:00 PM,48,-122,24,0,24
9404,58thStGreenway22ndAve,01/27/2015 08:00:00 PM,48,-122,10,0,10
9405,58thStGreenway22ndAve,01/27/2015 09:00:00 PM,48,-122,10,0,10
9406,58thStGreenway22ndAve,01/27/2015 10:00:00 PM,48,-122,6,0,6
9407,58thStGreenway22ndAve,01/27/2015 11:00:00 PM,48,-122,5,0,5
9408,58thStGreenway22ndAve,01/28/2015 12:00:00 AM,48,-122,2,0,2
9409,58thStGreenway22ndAve,01/28/2015 01:00:00 AM,48,-122,0,0,0
9410,58thStGreenway22ndAve,01/28/2015 02:00:00 AM,48,-122,1,0,1
9411,58thStGreenway22ndAve,01/28/2015 03:00:00 AM,48,-122,0,0,0
9412,58thStGreenway22ndAve,01/28/2015 04:00:00 AM,48,-122,3,0,3
9413,58thStGreenway22ndAve,01/28/2015 05:00:00 AM,48,-122,1,0,1
9414,58thStGreenway22ndAve,01/28/2015 06:00:00 AM,48,-122,9,0,9
9415,58thStGreenway22ndAve,01/28/2015 07:00:00 AM,48,-122,28,0,28
9416,58thStGreenway22ndAve,01/28/2015 08:00:00 AM,48,-122,21,2,23
9417,58thStGreenway22ndAve,01/28/2015 09:00:00 AM,48,-122,30,1,31
9418,58thStGreenway22ndAve,01/28/2015 10:00:00 AM,48,-122,29,0,29
9419,58thStGreenway22ndAve,01/28/2015 11:00:00 AM,48,-122,25,1,26
9420,58thStGreenway22ndAve,01/28/2015 12:00:00 PM,48,-122,37,0,37
9421,58thStGreenway22ndAve,01/28/2015 01:00:00 PM,48,-122,33,0,33
9422,58thStGreenway22ndAve,01/28/2015 02:00:00 PM,48,-122,43,0,43
9423,58thStGreenway22ndAve,01/28/2015 03:00:00 PM,48,-122,35,0,35
9424,58thStGreenway22ndAve,01/28/2015 04:00:00 PM,48,-122,35,0,35
9425,58thStGreenway22ndAve,01/28/2015 05:00:00 PM,48,-122,42,0,42
9426,58thStGreenway22ndAve,01/28/2015 06:00:00 PM,48,-122,38,1,39
9427,58thStGreenway22ndAve,01/28/2015 07:00:00 PM,48,-122,31,0,31
9428,58thStGreenway22ndAve,01/28/2015 08:00:00 PM,48,-122,27,0,27
9429,58thStGreenway22ndAve,01/28/2015 09:00:00 PM,48,-122,14,0,14
9430,58thStGreenway22ndAve,01/28/2015 10:00:00 PM,48,-122,8,0,8
9431,58thStGreenway22ndAve,01/28/2015 11:00:00 PM,48,-122,0,0,0
9432,58thStGreenway22ndAve,01/29/2015 12:00:00 AM,48,-122,4,0,4
9433,58thStGreenway22ndAve,01/29/2015 01:00:00 AM,48,-122,1,0,1
9434,58thStGreenway22ndAve,01/29/2015 02:00:00 AM,48,-122,2,0,2
9435,58thStGreenway22ndAve,01/29/2015 03:00:00 AM,48,-122,2,0,2
9436,58thStGreenway22ndAve,01/29/2015 04:00:00 AM,48,-122,0,0,0
9437,58thStGreenway22ndAve,01/29/2015 05:00:00 AM,48,-122,4,0,4
9438,58thStGreenway22ndAve,01/29/2015 06:00:00 AM,48,-122,3,0,3
9439,58thStGreenway22ndAve,01/29/2015 07:00:00 AM,48,-122,28,2,30
9440,58thStGreenway22ndAve,01/29/2015 08:00:00 AM,48,-122,25,0,25
9441,58thStGreenway22ndAve,01/29/2015 09:00:00 AM,48,-122,38,0,38
9442,58thStGreenway22ndAve,01/29/2015 10:00:00 AM,48,-122,41,0,41
9443,58thStGreenway22ndAve,01/29/2015 11:00:00 AM,48,-122,41,0,41
9444,58thStGreenway22ndAve,01/29/2015 12:00:00 PM,48,-122,33,0,33
9445,58thStGreenway22ndAve,01/29/2015 01:00:00 PM,48,-122,39,1,40
9446,58thStGreenway22ndAve,01/29/2015 02:00:00 PM,48,-122,22,0,22
9447,58thStGreenway22ndAve,01/29/2015 03:00:00 PM,48,-122,43,0,43
9448,58thStGreenway22ndAve,01/29/2015 04:00:00 PM,48,-122,39,0,39
9449,58thStGreenway22ndAve,01/29/2015 05:00:00 PM,48,-122,39,0,39
9450,58thStGreenway22ndAve,01/29/2015 06:00:00 PM,48,-122,34,0,34
9451,58thStGreenway22ndAve,01/29/2015 07:00:00 PM,48,-122,27,0,27
9452,58thStGreenway22ndAve,01/29/2015 08:00:00 PM,48,-122,15,0,15
9453,58thStGreenway22ndAve,01/29/2015 09:00:00 PM,48,-122,13,0,13
9454,58thStGreenway22ndAve,01/29/2015 10:00:00 PM,48,-122,13,0,13
9455,58thStGreenway22ndAve,01/29/2015 11:00:00 PM,48,-122,5,0,5
9456,58thStGreenway22ndAve,01/30/2015 12:00:00 AM,48,-122,2,0,2
9457,58thStGreenway22ndAve,01/30/2015 01:00:00 AM,48,-122,3,0,3
9458,58thStGreenway22ndAve,01/30/2015 02:00:00 AM,48,-122,5,0,5
9459,58thStGreenway22ndAve,01/30/2015 03:00:00 AM,48,-122,0,0,0
9460,58thStGreenway22ndAve,01/30/2015 04:00:00 AM,48,-122,0,0,0
9461,58thStGreenway22ndAve,01/30/2015 05:00:00 AM,48,-122,3,0,3
9462,58thStGreenway22ndAve,01/30/2015 06:00:00 AM,48,-122,6,0,6
9463,58thStGreenway22ndAve,01/30/2015 07:00:00 AM,48,-122,16,0,16
9464,58thStGreenway22ndAve,01/30/2015 08:00:00 AM,48,-122,26,0,26
9465,58thStGreenway22ndAve,01/30/2015 09:00:00 AM,48,-122,21,0,21
9466,58thStGreenway22ndAve,01/30/2015 10:00:00 AM,48,-122,43,0,43
9467,58thStGreenway22ndAve,01/30/2015 11:00:00 AM,48,-122,35,1,36
9468,58thStGreenway22ndAve,01/30/2015 12:00:00 PM,48,-122,33,0,33
9469,58thStGreenway22ndAve,01/30/2015 01:00:00 PM,48,-122,56,0,56
9470,58thStGreenway22ndAve,01/30/2015 02:00:00 PM,48,-122,44,0,44
9471,58thStGreenway22ndAve,01/30/2015 03:00:00 PM,48,-122,42,0,42
9472,58thStGreenway22ndAve,01/30/2015 04:00:00 PM,48,-122,36,0,36
9473,58thStGreenway22ndAve,01/30/2015 05:00:00 PM,48,-122,26,0,26
9474,58thStGreenway22ndAve,01/30/2015 06:00:00 PM,48,-122,49,0,49
9475,58thStGreenway22ndAve,01/30/2015 07:00:00 PM,48,-122,46,0,46
9476,58thStGreenway22ndAve,01/30/2015 08:00:00 PM,48,-122,27,0,27
9477,58thStGreenway22ndAve,01/30/2015 09:00:00 PM,48,-122,20,0,20
9478,58thStGreenway22ndAve,01/30/2015 10:00:00 PM,48,-122,6,0,6
9479,58thStGreenway22ndAve,01/30/2015 11:00:00 PM,48,-122,13,0,13
9480,58thStGreenway22ndAve,01/31/2015 12:00:00 AM,48,-122,3,0,3
9481,58thStGreenway22ndAve,01/31/2015 01:00:00 AM,48,-122,2,0,2
9482,58thStGreenway22ndAve,01/31/2015 02:00:00 AM,48,-122,2,1,3
9483,58thStGreenway22ndAve,01/31/2015 03:00:00 AM,48,-122,0,0,0
9484,58thStGreenway22ndAve,01/31/2015 04:00:00 AM,48,-122,2,0,2
9485,58thStGreenway22ndAve,01/31/2015 05:00:00 AM,48,-122,2,0,2
9486,58thStGreenway22ndAve,01/31/2015 06:00:00 AM,48,-122,0,0,0
9487,58thStGreenway22ndAve,01/31/2015 07:00:00 AM,48,-122,7,0,7
9488,58thStGreenway22ndAve,01/31/2015 08:00:00 AM,48,-122,15,0,15
9489,58thStGreenway22ndAve,01/31/2015 09:00:00 AM,48,-122,28,0,28
9490,58thStGreenway22ndAve,01/31/2015 10:00:00 AM,48,-122,50,0,50
9491,58thStGreenway22ndAve,01/31/2015 11:00:00 AM,48,-122,60,0,60
9492,58thStGreenway22ndAve,01/31/2015 12:00:00 PM,48,-122,60,0,60
9493,58thStGreenway22ndAve,01/31/2015 01:00:00 PM,48,-122,52,0,52
9494,58thStGreenway22ndAve,01/31/2015 02:00:00 PM,48,-122,59,2,61
9495,58thStGreenway22ndAve,01/31/2015 03:00:00 PM,48,-122,54,0,54
9496,58thStGreenway22ndAve,01/31/2015 04:00:00 PM,48,-122,44,1,45
9497,58thStGreenway22ndAve,01/31/2015 05:00:00 PM,48,-122,37,1,38
9498,58thStGreenway22ndAve,01/31/2015 06:00:00 PM,48,-122,55,0,55
9499,58thStGreenway22ndAve,01/31/2015 07:00:00 PM,48,-122,41,0,41
9500,58thStGreenway22ndAve,01/31/2015 08:00:00 PM,48,-122,16,0,16
9501,58thStGreenway22ndAve,01/31/2015 09:00:00 PM,48,-122,19,0,19
9502,58thStGreenway22ndAve,01/31/2015 10:00:00 PM,48,-122,13,0,13
9503,58thStGreenway22ndAve,01/31/2015 11:00:00 PM,48,-122,4,0,4
9504,58thStGreenway22ndAve,03/01/2015 12:00:00 AM,48,-122,0,1,1
9505,58thStGreenway22ndAve,03/01/2015 01:00:00 AM,48,-122,0,0,0
9506,58thStGreenway22ndAve,03/01/2015 02:00:00 AM,48,-122,0,0,0
9507,58thStGreenway22ndAve,03/01/2015 03:00:00 AM,48,-122,0,0,0
9508,58thStGreenway22ndAve,03/01/2015 04:00:00 AM,48,-122,0,0,0
9509,58thStGreenway22ndAve,03/01/2015 05:00:00 AM,48,-122,0,0,0
9510,58thStGreenway22ndAve,03/01/2015 06:00:00 AM,48,-122,0,0,0
9511,58thStGreenway22ndAve,03/01/2015 07:00:00 AM,48,-122,2,0,2
9512,58thStGreenway22ndAve,03/01/2015 08:00:00 AM,48,-122,3,2,5
9513,58thStGreenway22ndAve,03/01/2015 09:00:00 AM,48,-122,1,3,4
9514,58thStGreenway22ndAve,03/01/2015 10:00:00 AM,48,-122,5,5,10
9515,58thStGreenway22ndAve,03/01/2015 11:00:00 AM,48,-122,3,12,15
9516,58thStGreenway22ndAve,03/01/2015 12:00:00 PM,48,-122,18,9,27
9517,58thStGreenway22ndAve,03/01/2015 01:00:00 PM,48,-122,10,17,27
9518,58thStGreenway22ndAve,03/01/2015 02:00:00 PM,48,-122,10,5,15
9519,58thStGreenway22ndAve,03/01/2015 03:00:00 PM,48,-122,8,7,15
9520,58thStGreenway22ndAve,03/01/2015 04:00:00 PM,48,-122,17,10,27
9521,58thStGreenway22ndAve,03/01/2015 05:00:00 PM,48,-122,6,3,9
9522,58thStGreenway22ndAve,03/01/2015 06:00:00 PM,48,-122,4,5,9
9523,58thStGreenway22ndAve,03/01/2015 07:00:00 PM,48,-122,1,0,1
9524,58thStGreenway22ndAve,03/01/2015 08:00:00 PM,48,-122,3,1,4
9525,58thStGreenway22ndAve,03/01/2015 09:00:00 PM,48,-122,1,0,1
9526,58thStGreenway22ndAve,03/01/2015 10:00:00 PM,48,-122,2,0,2
9527,58thStGreenway22ndAve,03/01/2015 11:00:00 PM,48,-122,0,1,1
9528,58thStGreenway22ndAve,03/02/2015 12:00:00 AM,48,-122,0,0,0
9529,58thStGreenway22ndAve,03/02/2015 01:00:00 AM,48,-122,0,1,1
9530,58thStGreenway22ndAve,03/02/2015 02:00:00 AM,48,-122,0,0,0
9531,58thStGreenway22ndAve,03/02/2015 03:00:00 AM,48,-122,0,0,0
9532,58thStGreenway22ndAve,03/02/2015 04:00:00 AM,48,-122,0,0,0
9533,58thStGreenway22ndAve,03/02/2015 05:00:00 AM,48,-122,0,0,0
9534,58thStGreenway22ndAve,03/02/2015 06:00:00 AM,48,-122,1,1,2
9535,58thStGreenway22ndAve,03/02/2015 07:00:00 AM,48,-122,5,0,5
9536,58thStGreenway22ndAve,03/02/2015 08:00:00 AM,48,-122,3,5,8
9537,58thStGreenway22ndAve,03/02/2015 09:00:00 AM,48,-122,4,6,10
9538,58thStGreenway22ndAve,03/02/2015 10:00:00 AM,48,-122,3,3,6
9539,58thStGreenway22ndAve,03/02/2015 11:00:00 AM,48,-122,1,6,7
9540,58thStGreenway22ndAve,03/02/2015 12:00:00 PM,48,-122,1,6,7
9541,58thStGreenway22ndAve,03/02/2015 01:00:00 PM,48,-122,4,5,9
9542,58thStGreenway22ndAve,03/02/2015 02:00:00 PM,48,-122,5,5,10
9543,58thStGreenway22ndAve,03/02/2015 03:00:00 PM,48,-122,1,2,3
9544,58thStGreenway22ndAve,03/02/2015 04:00:00 PM,48,-122,4,0,4
9545,58thStGreenway22ndAve,03/02/2015 05:00:00 PM,48,-122,6,6,12
9546,58thStGreenway22ndAve,03/02/2015 06:00:00 PM,48,-122,4,4,8
9547,58thStGreenway22ndAve,03/02/2015 07:00:00 PM,48,-122,6,1,7
9548,58thStGreenway22ndAve,03/02/2015 08:00:00 PM,48,-122,0,2,2
9549,58thStGreenway22ndAve,03/02/2015 09:00:00 PM,48,-122,0,0,0
9550,58thStGreenway22ndAve,03/02/2015 10:00:00 PM,48,-122,2,0,2
9551,58thStGreenway22ndAve,03/02/2015 11:00:00 PM,48,-122,0,0,0
9552,58thStGreenway22ndAve,03/03/2015 12:00:00 AM,48,-122,0,0,0
9553,58thStGreenway22ndAve,03/03/2015 01:00:00 AM,48,-122,0,0,0
9554,58thStGreenway22ndAve,03/03/2015 02:00:00 AM,48,-122,0,0,0
9555,58thStGreenway22ndAve,03/03/2015 03:00:00 AM,48,-122,0,0,0
9556,58thStGreenway22ndAve,03/03/2015 04:00:00 AM,48,-122,0,1,1
9557,58thStGreenway22ndAve,03/03/2015 05:00:00 AM,48,-122,0,0,0
9558,58thStGreenway22ndAve,03/03/2015 06:00:00 AM,48,-122,0,2,2
9559,58thStGreenway22ndAve,03/03/2015 07:00:00 AM,48,-122,10,0,10
9560,58thStGreenway22ndAve,03/03/2015 08:00:00 AM,48,-122,2,7,9
9561,58thStGreenway22ndAve,03/03/2015 09:00:00 AM,48,-122,6,7,13
9562,58thStGreenway22ndAve,03/03/2015 10:00:00 AM,48,-122,1,6,7
9563,58thStGreenway22ndAve,03/03/2015 11:00:00 AM,48,-122,6,7,13
9564,58thStGreenway22ndAve,03/03/2015 12:00:00 PM,48,-122,4,10,14
9565,58thStGreenway22ndAve,03/03/2015 01:00:00 PM,48,-122,6,5,11
9566,58thStGreenway22ndAve,03/03/2015 02:00:00 PM,48,-122,8,9,17
9567,58thStGreenway22ndAve,03/03/2015 03:00:00 PM,48,-122,6,6,12
9568,58thStGreenway22ndAve,03/03/2015 04:00:00 PM,48,-122,8,11,19
9569,58thStGreenway22ndAve,03/03/2015 05:00:00 PM,48,-122,12,14,26
9570,58thStGreenway22ndAve,03/03/2015 06:00:00 PM,48,-122,6,7,13
9571,58thStGreenway22ndAve,03/03/2015 07:00:00 PM,48,-122,4,8,12
9572,58thStGreenway22ndAve,03/03/2015 08:00:00 PM,48,-122,3,1,4
9573,58thStGreenway22ndAve,03/03/2015 09:00:00 PM,48,-122,4,0,4
9574,58thStGreenway22ndAve,03/03/2015 10:00:00 PM,48,-122,2,0,2
9575,58thStGreenway22ndAve,03/03/2015 11:00:00 PM,48,-122,0,0,0
9576,58thStGreenway22ndAve,03/04/2015 12:00:00 AM,48,-122,0,0,0
9577,58thStGreenway22ndAve,03/04/2015 01:00:00 AM,48,-122,0,0,0
9578,58thStGreenway22ndAve,03/04/2015 02:00:00 AM,48,-122,0,0,0
9579,58thStGreenway22ndAve,03/04/2015 03:00:00 AM,48,-122,0,0,0
9580,58thStGreenway22ndAve,03/04/2015 04:00:00 AM,48,-122,0,0,0
9581,58thStGreenway22ndAve,03/04/2015 05:00:00 AM,48,-122,0,0,0
9582,58thStGreenway22ndAve,03/04/2015 06:00:00 AM,48,-122,0,3,3
9583,58thStGreenway22ndAve,03/04/2015 07:00:00 AM,48,-122,4,3,7
9584,58thStGreenway22ndAve,03/04/2015 08:00:00 AM,48,-122,3,3,6
9585,58thStGreenway22ndAve,03/04/2015 09:00:00 AM,48,-122,7,6,13
9586,58thStGreenway22ndAve,03/04/2015 10:00:00 AM,48,-122,4,5,9
9587,58thStGreenway22ndAve,03/04/2015 11:00:00 AM,48,-122,4,7,11
9588,58thStGreenway22ndAve,03/04/2015 12:00:00 PM,48,-122,3,5,8
9589,58thStGreenway22ndAve,03/04/2015 01:00:00 PM,48,-122,14,9,23
9590,58thStGreenway22ndAve,03/04/2015 02:00:00 PM,48,-122,1,6,7
9591,58thStGreenway22ndAve,03/04/2015 03:00:00 PM,48,-122,7,3,10
9592,58thStGreenway22ndAve,03/04/2015 04:00:00 PM,48,-122,9,5,14
9593,58thStGreenway22ndAve,03/04/2015 05:00:00 PM,48,-122,9,4,13
9594,58thStGreenway22ndAve,03/04/2015 06:00:00 PM,48,-122,1,8,9
9595,58thStGreenway22ndAve,03/04/2015 07:00:00 PM,48,-122,4,3,7
9596,58thStGreenway22ndAve,03/04/2015 08:00:00 PM,48,-122,1,1,2
9597,58thStGreenway22ndAve,03/04/2015 09:00:00 PM,48,-122,2,0,2
9598,58thStGreenway22ndAve,03/04/2015 10:00:00 PM,48,-122,1,0,1
9599,58thStGreenway22ndAve,03/04/2015 11:00:00 PM,48,-122,3,1,4
9600,58thStGreenway22ndAve,03/05/2015 12:00:00 AM,48,-122,0,0,0
9601,58thStGreenway22ndAve,03/05/2015 01:00:00 AM,48,-122,0,0,0
9602,58thStGreenway22ndAve,03/05/2015 02:00:00 AM,48,-122,0,0,0
9603,58thStGreenway22ndAve,03/05/2015 03:00:00 AM,48,-122,0,0,0
9604,58thStGreenway22ndAve,03/05/2015 04:00:00 AM,48,-122,0,0,0
9605,58thStGreenway22ndAve,03/05/2015 05:00:00 AM,48,-122,0,0,0
9606,58thStGreenway22ndAve,03/05/2015 06:00:00 AM,48,-122,3,3,6
9607,58thStGreenway22ndAve,03/05/2015 07:00:00 AM,48,-122,3,0,3
9608,58thStGreenway22ndAve,03/05/2015 08:00:00 AM,48,-122,7,2,9
9609,58thStGreenway22ndAve,03/05/2015 09:00:00 AM,48,-122,4,3,7
9610,58thStGreenway22ndAve,03/05/2015 10:00:00 AM,48,-122,2,3,5
9611,58thStGreenway22ndAve,03/05/2015 11:00:00 AM,48,-122,1,3,4
9612,58thStGreenway22ndAve,03/05/2015 12:00:00 PM,48,-122,9,7,16
9613,58thStGreenway22ndAve,03/05/2015 01:00:00 PM,48,-122,3,6,9
9614,58thStGreenway22ndAve,03/05/2015 02:00:00 PM,48,-122,4,1,5
9615,58thStGreenway22ndAve,03/05/2015 03:00:00 PM,48,-122,4,6,10
9616,58thStGreenway22ndAve,03/05/2015 04:00:00 PM,48,-122,8,7,15
9617,58thStGreenway22ndAve,03/05/2015 05:00:00 PM,48,-122,13,9,22
9618,58thStGreenway22ndAve,03/05/2015 06:00:00 PM,48,-122,8,7,15
9619,58thStGreenway22ndAve,03/05/2015 07:00:00 PM,48,-122,3,2,5
9620,58thStGreenway22ndAve,03/05/2015 08:00:00 PM,48,-122,3,5,8
9621,58thStGreenway22ndAve,03/05/2015 09:00:00 PM,48,-122,5,1,6
9622,58thStGreenway22ndAve,03/05/2015 10:00:00 PM,48,-122,1,2,3
9623,58thStGreenway22ndAve,03/05/2015 11:00:00 PM,48,-122,6,1,7
9624,58thStGreenway22ndAve,03/06/2015 12:00:00 AM,48,-122,0,0,0
9625,58thStGreenway22ndAve,03/06/2015 01:00:00 AM,48,-122,0,1,1
9626,58thStGreenway22ndAve,03/06/2015 02:00:00 AM,48,-122,0,0,0
9627,58thStGreenway22ndAve,03/06/2015 03:00:00 AM,48,-122,0,0,0
9628,58thStGreenway22ndAve,03/06/2015 04:00:00 AM,48,-122,0,0,0
9629,58thStGreenway22ndAve,03/06/2015 05:00:00 AM,48,-122,0,0,0
9630,58thStGreenway22ndAve,03/06/2015 06:00:00 AM,48,-122,2,0,2
9631,58thStGreenway22ndAve,03/06/2015 07:00:00 AM,48,-122,1,2,3
9632,58thStGreenway22ndAve,03/06/2015 08:00:00 AM,48,-122,2,8,10
9633,58thStGreenway22ndAve,03/06/2015 09:00:00 AM,48,-122,2,7,9
9634,58thStGreenway22ndAve,03/06/2015 10:00:00 AM,48,-122,4,4,8
9635,58thStGreenway22ndAve,03/06/2015 11:00:00 AM,48,-122,5,12,17
9636,58thStGreenway22ndAve,03/06/2015 12:00:00 PM,48,-122,7,4,11
9637,58thStGreenway22ndAve,03/06/2015 01:00:00 PM,48,-122,11,10,21
9638,58thStGreenway22ndAve,03/06/2015 02:00:00 PM,48,-122,11,3,14
9639,58thStGreenway22ndAve,03/06/2015 03:00:00 PM,48,-122,11,9,20
9640,58thStGreenway22ndAve,03/06/2015 04:00:00 PM,48,-122,4,3,7
9641,58thStGreenway22ndAve,03/06/2015 05:00:00 PM,48,-122,6,8,14
9642,58thStGreenway22ndAve,03/06/2015 06:00:00 PM,48,-122,9,8,17
9643,58thStGreenway22ndAve,03/06/2015 07:00:00 PM,48,-122,1,5,6
9644,58thStGreenway22ndAve,03/06/2015 08:00:00 PM,48,-122,4,1,5
9645,58thStGreenway22ndAve,03/06/2015 09:00:00 PM,48,-122,2,1,3
9646,58thStGreenway22ndAve,03/06/2015 10:00:00 PM,48,-122,4,0,4
9647,58thStGreenway22ndAve,03/06/2015 11:00:00 PM,48,-122,1,1,2
9648,58thStGreenway22ndAve,03/07/2015 12:00:00 AM,48,-122,5,1,6
9649,58thStGreenway22ndAve,03/07/2015 01:00:00 AM,48,-122,1,0,1
9650,58thStGreenway22ndAve,03/07/2015 02:00:00 AM,48,-122,3,0,3
9651,58thStGreenway22ndAve,03/07/2015 03:00:00 AM,48,-122,0,0,0
9652,58thStGreenway22ndAve,03/07/2015 04:00:00 AM,48,-122,0,0,0
9653,58thStGreenway22ndAve,03/07/2015 05:00:00 AM,48,-122,0,0,0
9654,58thStGreenway22ndAve,03/07/2015 06:00:00 AM,48,-122,2,0,2
9655,58thStGreenway22ndAve,03/07/2015 07:00:00 AM,48,-122,0,1,1
9656,58thStGreenway22ndAve,03/07/2015 08:00:00 AM,48,-122,4,3,7
9657,58thStGreenway22ndAve,03/07/2015 09:00:00 AM,48,-122,5,3,8
9658,58thStGreenway22ndAve,03/07/2015 10:00:00 AM,48,-122,12,7,19
9659,58thStGreenway22ndAve,03/07/2015 11:00:00 AM,48,-122,12,9,21
9660,58thStGreenway22ndAve,03/07/2015 12:00:00 PM,48,-122,20,4,24
9661,58thStGreenway22ndAve,03/07/2015 01:00:00 PM,48,-122,7,11,18
9662,58thStGreenway22ndAve,03/07/2015 02:00:00 PM,48,-122,9,10,19
9663,58thStGreenway22ndAve,03/07/2015 03:00:00 PM,48,-122,16,16,32
9664,58thStGreenway22ndAve,03/07/2015 04:00:00 PM,48,-122,13,10,23
9665,58thStGreenway22ndAve,03/07/2015 05:00:00 PM,48,-122,17,10,27
9666,58thStGreenway22ndAve,03/07/2015 06:00:00 PM,48,-122,8,9,17
9667,58thStGreenway22ndAve,03/07/2015 07:00:00 PM,48,-122,1,3,4
9668,58thStGreenway22ndAve,03/07/2015 08:00:00 PM,48,-122,1,1,2
9669,58thStGreenway22ndAve,03/07/2015 09:00:00 PM,48,-122,2,2,4
9670,58thStGreenway22ndAve,03/07/2015 10:00:00 PM,48,-122,0,1,1
9671,58thStGreenway22ndAve,03/07/2015 11:00:00 PM,48,-122,3,1,4
9672,58thStGreenway22ndAve,03/08/2015 12:00:00 AM,48,-122,1,1,2
9673,58thStGreenway22ndAve,03/08/2015 01:00:00 AM,48,-122,1,0,1
9674,58thStGreenway22ndAve,03/08/2015 03:00:00 AM,48,-122,,,
9675,58thStGreenway22ndAve,03/08/2015 03:00:00 AM,48,-122,0,0,0
9676,58thStGreenway22ndAve,03/08/2015 04:00:00 AM,48,-122,0,0,0
9677,58thStGreenway22ndAve,03/08/2015 05:00:00 AM,48,-122,0,0,0
9678,58thStGreenway22ndAve,03/08/2015 06:00:00 AM,48,-122,0,0,0
9679,58thStGreenway22ndAve,03/08/2015 07:00:00 AM,48,-122,0,0,0
9680,58thStGreenway22ndAve,03/08/2015 08:00:00 AM,48,-122,0,2,2
9681,58thStGreenway22ndAve,03/08/2015 09:00:00 AM,48,-122,1,3,4
9682,58thStGreenway22ndAve,03/08/2015 10:00:00 AM,48,-122,2,6,8
9683,58thStGreenway22ndAve,03/08/2015 11:00:00 AM,48,-122,6,10,16
9684,58thStGreenway22ndAve,03/08/2015 12:00:00 PM,48,-122,11,11,22
9685,58thStGreenway22ndAve,03/08/2015 01:00:00 PM,48,-122,11,18,29
9686,58thStGreenway22ndAve,03/08/2015 02:00:00 PM,48,-122,17,15,32
9687,58thStGreenway22ndAve,03/08/2015 03:00:00 PM,48,-122,16,17,33
9688,58thStGreenway22ndAve,03/08/2015 04:00:00 PM,48,-122,19,16,35
9689,58thStGreenway22ndAve,03/08/2015 05:00:00 PM,48,-122,8,3,11
9690,58thStGreenway22ndAve,03/08/2015 06:00:00 PM,48,-122,4,2,6
9691,58thStGreenway22ndAve,03/08/2015 07:00:00 PM,48,-122,4,3,7
9692,58thStGreenway22ndAve,03/08/2015 08:00:00 PM,48,-122,0,0,0
9693,58thStGreenway22ndAve,03/08/2015 09:00:00 PM,48,-122,1,1,2
9694,58thStGreenway22ndAve,03/08/2015 10:00:00 PM,48,-122,2,1,3
9695,58thStGreenway22ndAve,03/08/2015 11:00:00 PM,48,-122,0,0,0
9696,58thStGreenway22ndAve,03/09/2015 12:00:00 AM,48,-122,0,0,0
9697,58thStGreenway22ndAve,03/09/2015 01:00:00 AM,48,-122,0,1,1
9698,58thStGreenway22ndAve,03/09/2015 02:00:00 AM,48,-122,0,0,0
9699,58thStGreenway22ndAve,03/09/2015 03:00:00 AM,48,-122,0,0,0
9700,58thStGreenway22ndAve,03/09/2015 04:00:00 AM,48,-122,0,0,0
9701,58thStGreenway22ndAve,03/09/2015 05:00:00 AM,48,-122,0,1,1
9702,58thStGreenway22ndAve,03/09/2015 06:00:00 AM,48,-122,1,1,2
9703,58thStGreenway22ndAve,03/09/2015 07:00:00 AM,48,-122,7,1,8
9704,58thStGreenway22ndAve,03/09/2015 08:00:00 AM,48,-122,1,7,8
9705,58thStGreenway22ndAve,03/09/2015 09:00:00 AM,48,-122,5,5,10
9706,58thStGreenway22ndAve,03/09/2015 10:00:00 AM,48,-122,1,3,4
9707,58thStGreenway22ndAve,03/09/2015 11:00:00 AM,48,-122,2,5,7
9708,58thStGreenway22ndAve,03/09/2015 12:00:00 PM,48,-122,1,6,7
9709,58thStGreenway22ndAve,03/09/2015 01:00:00 PM,48,-122,1,0,1
9710,58thStGreenway22ndAve,03/09/2015 02:00:00 PM,48,-122,3,5,8
9711,58thStGreenway22ndAve,03/09/2015 03:00:00 PM,48,-122,6,3,9
9712,58thStGreenway22ndAve,03/09/2015 04:00:00 PM,48,-122,7,5,12
9713,58thStGreenway22ndAve,03/09/2015 05:00:00 PM,48,-122,5,12,17
9714,58thStGreenway22ndAve,03/09/2015 06:00:00 PM,48,-122,5,3,8
9715,58thStGreenway22ndAve,03/09/2015 07:00:00 PM,48,-122,16,6,22
9716,58thStGreenway22ndAve,03/09/2015 08:00:00 PM,48,-122,1,2,3
9717,58thStGreenway22ndAve,03/09/2015 09:00:00 PM,48,-122,3,2,5
9718,58thStGreenway22ndAve,03/09/2015 10:00:00 PM,48,-122,0,0,0
9719,58thStGreenway22ndAve,03/09/2015 11:00:00 PM,48,-122,5,0,5
9720,58thStGreenway22ndAve,03/10/2015 12:00:00 AM,48,-122,0,1,1
9721,58thStGreenway22ndAve,03/10/2015 01:00:00 AM,48,-122,1,0,1
9722,58thStGreenway22ndAve,03/10/2015 02:00:00 AM,48,-122,0,0,0
9723,58thStGreenway22ndAve,03/10/2015 03:00:00 AM,48,-122,0,0,0
9724,58thStGreenway22ndAve,03/10/2015 04:00:00 AM,48,-122,0,0,0
9725,58thStGreenway22ndAve,03/10/2015 05:00:00 AM,48,-122,0,0,0
9726,58thStGreenway22ndAve,03/10/2015 06:00:00 AM,48,-122,5,2,7
9727,58thStGreenway22ndAve,03/10/2015 07:00:00 AM,48,-122,3,0,3
9728,58thStGreenway22ndAve,03/10/2015 08:00:00 AM,48,-122,9,7,16
9729,58thStGreenway22ndAve,03/10/2015 09:00:00 AM,48,-122,10,12,22
9730,58thStGreenway22ndAve,03/10/2015 10:00:00 AM,48,-122,2,1,3
9731,58thStGreenway22ndAve,03/10/2015 11:00:00 AM,48,-122,3,5,8
9732,58thStGreenway22ndAve,03/10/2015 12:00:00 PM,48,-122,8,5,13
9733,58thStGreenway22ndAve,03/10/2015 01:00:00 PM,48,-122,8,2,10
9734,58thStGreenway22ndAve,03/10/2015 02:00:00 PM,48,-122,4,3,7
9735,58thStGreenway22ndAve,03/10/2015 03:00:00 PM,48,-122,7,1,8
9736,58thStGreenway22ndAve,03/10/2015 04:00:00 PM,48,-122,2,3,5
9737,58thStGreenway22ndAve,03/10/2015 05:00:00 PM,48,-122,10,11,21
9738,58thStGreenway22ndAve,03/10/2015 06:00:00 PM,48,-122,8,9,17
9739,58thStGreenway22ndAve,03/10/2015 07:00:00 PM,48,-122,2,4,6
9740,58thStGreenway22ndAve,03/10/2015 08:00:00 PM,48,-122,0,5,5
9741,58thStGreenway22ndAve,03/10/2015 09:00:00 PM,48,-122,8,0,8
9742,58thStGreenway22ndAve,03/10/2015 10:00:00 PM,48,-122,1,2,3
9743,58thStGreenway22ndAve,03/10/2015 11:00:00 PM,48,-122,0,2,2
9744,58thStGreenway22ndAve,03/11/2015 12:00:00 AM,48,-122,0,1,1
9745,58thStGreenway22ndAve,03/11/2015 01:00:00 AM,48,-122,0,1,1
9746,58thStGreenway22ndAve,03/11/2015 02:00:00 AM,48,-122,0,0,0
9747,58thStGreenway22ndAve,03/11/2015 03:00:00 AM,48,-122,0,0,0
9748,58thStGreenway22ndAve,03/11/2015 04:00:00 AM,48,-122,0,0,0
9749,58thStGreenway22ndAve,03/11/2015 05:00:00 AM,48,-122,0,0,0
9750,58thStGreenway22ndAve,03/11/2015 06:00:00 AM,48,-122,0,2,2
9751,58thStGreenway22ndAve,03/11/2015 07:00:00 AM,48,-122,3,1,4
9752,58thStGreenway22ndAve,03/11/2015 08:00:00 AM,48,-122,4,2,6
9753,58thStGreenway22ndAve,03/11/2015 09:00:00 AM,48,-122,6,9,15
9754,58thStGreenway22ndAve,03/11/2015 10:00:00 AM,48,-122,0,2,2
9755,58thStGreenway22ndAve,03/11/2015 11:00:00 AM,48,-122,4,0,4
9756,58thStGreenway22ndAve,03/11/2015 12:00:00 PM,48,-122,3,2,5
9757,58thStGreenway22ndAve,03/11/2015 01:00:00 PM,48,-122,9,6,15
9758,58thStGreenway22ndAve,03/11/2015 02:00:00 PM,48,-122,7,7,14
9759,58thStGreenway22ndAve,03/11/2015 03:00:00 PM,48,-122,0,3,3
9760,58thStGreenway22ndAve,03/11/2015 04:00:00 PM,48,-122,3,2,5
9761,58thStGreenway22ndAve,03/11/2015 05:00:00 PM,48,-122,11,4,15
9762,58thStGreenway22ndAve,03/11/2015 06:00:00 PM,48,-122,6,2,8
9763,58thStGreenway22ndAve,03/11/2015 07:00:00 PM,48,-122,6,8,14
9764,58thStGreenway22ndAve,03/11/2015 08:00:00 PM,48,-122,2,1,3
9765,58thStGreenway22ndAve,03/11/2015 09:00:00 PM,48,-122,4,2,6
9766,58thStGreenway22ndAve,03/11/2015 10:00:00 PM,48,-122,2,0,2
9767,58thStGreenway22ndAve,03/11/2015 11:00:00 PM,48,-122,1,0,1
9768,58thStGreenway22ndAve,03/12/2015 12:00:00 AM,48,-122,0,0,0
9769,58thStGreenway22ndAve,03/12/2015 01:00:00 AM,48,-122,0,2,2
9770,58thStGreenway22ndAve,03/12/2015 02:00:00 AM,48,-122,0,0,0
9771,58thStGreenway22ndAve,03/12/2015 03:00:00 AM,48,-122,0,0,0
9772,58thStGreenway22ndAve,03/12/2015 04:00:00 AM,48,-122,0,0,0
9773,58thStGreenway22ndAve,03/12/2015 05:00:00 AM,48,-122,3,0,3
9774,58thStGreenway22ndAve,03/12/2015 06:00:00 AM,48,-122,6,1,7
9775,58thStGreenway22ndAve,03/12/2015 07:00:00 AM,48,-122,2,0,2
9776,58thStGreenway22ndAve,03/12/2015 08:00:00 AM,48,-122,5,5,10
9777,58thStGreenway22ndAve,03/12/2015 09:00:00 AM,48,-122,3,5,8
9778,58thStGreenway22ndAve,03/12/2015 10:00:00 AM,48,-122,6,3,9
9779,58thStGreenway22ndAve,03/12/2015 11:00:00 AM,48,-122,6,2,8
9780,58thStGreenway22ndAve,03/12/2015 12:00:00 PM,48,-122,3,5,8
9781,58thStGreenway22ndAve,03/12/2015 01:00:00 PM,48,-122,8,2,10
9782,58thStGreenway22ndAve,03/12/2015 02:00:00 PM,48,-122,1,3,4
9783,58thStGreenway22ndAve,03/12/2015 03:00:00 PM,48,-122,6,2,8
9784,58thStGreenway22ndAve,03/12/2015 04:00:00 PM,48,-122,12,2,14
9785,58thStGreenway22ndAve,03/12/2015 05:00:00 PM,48,-122,11,11,22
9786,58thStGreenway22ndAve,03/12/2015 06:00:00 PM,48,-122,4,9,13
9787,58thStGreenway22ndAve,03/12/2015 07:00:00 PM,48,-122,6,4,10
9788,58thStGreenway22ndAve,03/12/2015 08:00:00 PM,48,-122,5,5,10
9789,58thStGreenway22ndAve,03/12/2015 09:00:00 PM,48,-122,3,2,5
9790,58thStGreenway22ndAve,03/12/2015 10:00:00 PM,48,-122,3,0,3
9791,58thStGreenway22ndAve,03/12/2015 11:00:00 PM,48,-122,1,0,1
9792,58thStGreenway22ndAve,03/13/2015 12:00:00 AM,48,-122,2,0,2
9793,58thStGreenway22ndAve,03/13/2015 01:00:00 AM,48,-122,0,0,0
9794,58thStGreenway22ndAve,03/13/2015 02:00:00 AM,48,-122,0,0,0
9795,58thStGreenway22ndAve,03/13/2015 03:00:00 AM,48,-122,0,0,0
9796,58thStGreenway22ndAve,03/13/2015 04:00:00 AM,48,-122,0,0,0
9797,58thStGreenway22ndAve,03/13/2015 05:00:00 AM,48,-122,0,1,1
9798,58thStGreenway22ndAve,03/13/2015 06:00:00 AM,48,-122,5,0,5
9799,58thStGreenway22ndAve,03/13/2015 07:00:00 AM,48,-122,1,1,2
9800,58thStGreenway22ndAve,03/13/2015 08:00:00 AM,48,-122,8,7,15
9801,58thStGreenway22ndAve,03/13/2015 09:00:00 AM,48,-122,3,3,6
9802,58thStGreenway22ndAve,03/13/2015 10:00:00 AM,48,-122,4,4,8
9803,58thStGreenway22ndAve,03/13/2015 11:00:00 AM,48,-122,2,2,4
9804,58thStGreenway22ndAve,03/13/2015 12:00:00 PM,48,-122,5,10,15
9805,58thStGreenway22ndAve,03/13/2015 01:00:00 PM,48,-122,5,5,10
9806,58thStGreenway22ndAve,03/13/2015 02:00:00 PM,48,-122,10,6,16
9807,58thStGreenway22ndAve,03/13/2015 03:00:00 PM,48,-122,2,6,8
9808,58thStGreenway22ndAve,03/13/2015 04:00:00 PM,48,-122,8,6,14
9809,58thStGreenway22ndAve,03/13/2015 05:00:00 PM,48,-122,6,11,17
9810,58thStGreenway22ndAve,03/13/2015 06:00:00 PM,48,-122,4,4,8
9811,58thStGreenway22ndAve,03/13/2015 07:00:00 PM,48,-122,3,3,6
9812,58thStGreenway22ndAve,03/13/2015 08:00:00 PM,48,-122,2,2,4
9813,58thStGreenway22ndAve,03/13/2015 09:00:00 PM,48,-122,1,3,4
9814,58thStGreenway22ndAve,03/13/2015 10:00:00 PM,48,-122,3,1,4
9815,58thStGreenway22ndAve,03/13/2015 11:00:00 PM,48,-122,1,0,1
9816,58thStGreenway22ndAve,03/14/2015 12:00:00 AM,48,-122,0,0,0
9817,58thStGreenway22ndAve,03/14/2015 01:00:00 AM,48,-122,0,0,0
9818,58thStGreenway22ndAve,03/14/2015 02:00:00 AM,48,-122,0,0,0
9819,58thStGreenway22ndAve,03/14/2015 03:00:00 AM,48,-122,0,0,0
9820,58thStGreenway22ndAve,03/14/2015 04:00:00 AM,48,-122,0,0,0
9821,58thStGreenway22ndAve,03/14/2015 05:00:00 AM,48,-122,1,0,1
9822,58thStGreenway22ndAve,03/14/2015 06:00:00 AM,48,-122,2,1,3
9823,58thStGreenway22ndAve,03/14/2015 07:00:00 AM,48,-122,1,0,1
9824,58thStGreenway22ndAve,03/14/2015 08:00:00 AM,48,-122,1,1,2
9825,58thStGreenway22ndAve,03/14/2015 09:00:00 AM,48,-122,3,0,3
9826,58thStGreenway22ndAve,03/14/2015 10:00:00 AM,48,-122,3,2,5
9827,58thStGreenway22ndAve,03/14/2015 11:00:00 AM,48,-122,6,4,10
9828,58thStGreenway22ndAve,03/14/2015 12:00:00 PM,48,-122,4,0,4
9829,58thStGreenway22ndAve,03/14/2015 01:00:00 PM,48,-122,6,11,17
9830,58thStGreenway22ndAve,03/14/2015 02:00:00 PM,48,-122,7,4,11
9831,58thStGreenway22ndAve,03/14/2015 03:00:00 PM,48,-122,3,6,9
9832,58thStGreenway22ndAve,03/14/2015 04:00:00 PM,48,-122,5,4,9
9833,58thStGreenway22ndAve,03/14/2015 05:00:00 PM,48,-122,5,6,11
9834,58thStGreenway22ndAve,03/14/2015 06:00:00 PM,48,-122,5,6,11
9835,58thStGreenway22ndAve,03/14/2015 07:00:00 PM,48,-122,4,5,9
9836,58thStGreenway22ndAve,03/14/2015 08:00:00 PM,48,-122,5,0,5
9837,58thStGreenway22ndAve,03/14/2015 09:00:00 PM,48,-122,2,1,3
9838,58thStGreenway22ndAve,03/14/2015 10:00:00 PM,48,-122,2,0,2
9839,58thStGreenway22ndAve,03/14/2015 11:00:00 PM,48,-122,0,1,1
9840,58thStGreenway22ndAve,03/15/2015 12:00:00 AM,48,-122,0,0,0
9841,58thStGreenway22ndAve,03/15/2015 01:00:00 AM,48,-122,0,0,0
9842,58thStGreenway22ndAve,03/15/2015 02:00:00 AM,48,-122,1,0,1
9843,58thStGreenway22ndAve,03/15/2015 03:00:00 AM,48,-122,0,0,0
9844,58thStGreenway22ndAve,03/15/2015 04:00:00 AM,48,-122,0,0,0
9845,58thStGreenway22ndAve,03/15/2015 05:00:00 AM,48,-122,0,0,0
9846,58thStGreenway22ndAve,03/15/2015 06:00:00 AM,48,-122,0,0,0
9847,58thStGreenway22ndAve,03/15/2015 07:00:00 AM,48,-122,0,0,0
9848,58thStGreenway22ndAve,03/15/2015 08:00:00 AM,48,-122,0,1,1
9849,58thStGreenway22ndAve,03/15/2015 09:00:00 AM,48,-122,2,2,4
9850,58thStGreenway22ndAve,03/15/2015 10:00:00 AM,48,-122,1,1,2
9851,58thStGreenway22ndAve,03/15/2015 11:00:00 AM,48,-122,0,0,0
9852,58thStGreenway22ndAve,03/15/2015 12:00:00 PM,48,-122,2,1,3
9853,58thStGreenway22ndAve,03/15/2015 01:00:00 PM,48,-122,6,8,14
9854,58thStGreenway22ndAve,03/15/2015 02:00:00 PM,48,-122,3,7,10
9855,58thStGreenway22ndAve,03/15/2015 03:00:00 PM,48,-122,1,7,8
9856,58thStGreenway22ndAve,03/15/2015 04:00:00 PM,48,-122,1,2,3
9857,58thStGreenway22ndAve,03/15/2015 05:00:00 PM,48,-122,0,1,1
9858,58thStGreenway22ndAve,03/15/2015 06:00:00 PM,48,-122,2,0,2
9859,58thStGreenway22ndAve,03/15/2015 07:00:00 PM,48,-122,4,0,4
9860,58thStGreenway22ndAve,03/15/2015 08:00:00 PM,48,-122,2,2,4
9861,58thStGreenway22ndAve,03/15/2015 09:00:00 PM,48,-122,2,2,4
9862,58thStGreenway22ndAve,03/15/2015 10:00:00 PM,48,-122,2,0,2
9863,58thStGreenway22ndAve,03/15/2015 11:00:00 PM,48,-122,5,0,5
9864,58thStGreenway22ndAve,03/16/2015 12:00:00 AM,48,-122,0,0,0
9865,58thStGreenway22ndAve,03/16/2015 01:00:00 AM,48,-122,0,0,0
9866,58thStGreenway22ndAve,03/16/2015 02:00:00 AM,48,-122,0,0,0
9867,58thStGreenway22ndAve,03/16/2015 03:00:00 AM,48,-122,0,0,0
9868,58thStGreenway22ndAve,03/16/2015 04:00:00 AM,48,-122,0,0,0
9869,58thStGreenway22ndAve,03/16/2015 05:00:00 AM,48,-122,0,1,1
9870,58thStGreenway22ndAve,03/16/2015 06:00:00 AM,48,-122,0,2,2
9871,58thStGreenway22ndAve,03/16/2015 07:00:00 AM,48,-122,1,3,4
9872,58thStGreenway22ndAve,03/16/2015 08:00:00 AM,48,-122,1,8,9
9873,58thStGreenway22ndAve,03/16/2015 09:00:00 AM,48,-122,2,6,8
9874,58thStGreenway22ndAve,03/16/2015 10:00:00 AM,48,-122,4,2,6
9875,58thStGreenway22ndAve,03/16/2015 11:00:00 AM,48,-122,3,4,7
9876,58thStGreenway22ndAve,03/16/2015 12:00:00 PM,48,-122,4,3,7
9877,58thStGreenway22ndAve,03/16/2015 01:00:00 PM,48,-122,1,2,3
9878,58thStGreenway22ndAve,03/16/2015 02:00:00 PM,48,-122,3,1,4
9879,58thStGreenway22ndAve,03/16/2015 03:00:00 PM,48,-122,3,3,6
9880,58thStGreenway22ndAve,03/16/2015 04:00:00 PM,48,-122,6,7,13
9881,58thStGreenway22ndAve,03/16/2015 05:00:00 PM,48,-122,11,3,14
9882,58thStGreenway22ndAve,03/16/2015 06:00:00 PM,48,-122,3,10,13
9883,58thStGreenway22ndAve,03/16/2015 07:00:00 PM,48,-122,5,6,11
9884,58thStGreenway22ndAve,03/16/2015 08:00:00 PM,48,-122,4,2,6
9885,58thStGreenway22ndAve,03/16/2015 09:00:00 PM,48,-122,3,1,4
9886,58thStGreenway22ndAve,03/16/2015 10:00:00 PM,48,-122,2,0,2
9887,58thStGreenway22ndAve,03/16/2015 11:00:00 PM,48,-122,0,0,0
9888,58thStGreenway22ndAve,03/17/2015 12:00:00 AM,48,-122,0,0,0
9889,58thStGreenway22ndAve,03/17/2015 01:00:00 AM,48,-122,0,0,0
9890,58thStGreenway22ndAve,03/17/2015 02:00:00 AM,48,-122,0,0,0
9891,58thStGreenway22ndAve,03/17/2015 03:00:00 AM,48,-122,0,0,0
9892,58thStGreenway22ndAve,03/17/2015 04:00:00 AM,48,-122,0,0,0
9893,58thStGreenway22ndAve,03/17/2015 05:00:00 AM,48,-122,0,0,0
9894,58thStGreenway22ndAve,03/17/2015 06:00:00 AM,48,-122,0,1,1
9895,58thStGreenway22ndAve,03/17/2015 07:00:00 AM,48,-122,5,1,6
9896,58thStGreenway22ndAve,03/17/2015 08:00:00 AM,48,-122,2,6,8
9897,58thStGreenway22ndAve,03/17/2015 09:00:00 AM,48,-122,5,5,10
9898,58thStGreenway22ndAve,03/17/2015 10:00:00 AM,48,-122,2,5,7
9899,58thStGreenway22ndAve,03/17/2015 11:00:00 AM,48,-122,1,1,2
9900,58thStGreenway22ndAve,03/17/2015 12:00:00 PM,48,-122,5,1,6
9901,58thStGreenway22ndAve,03/17/2015 01:00:00 PM,48,-122,6,6,12
9902,58thStGreenway22ndAve,03/17/2015 02:00:00 PM,48,-122,4,1,5
9903,58thStGreenway22ndAve,03/17/2015 03:00:00 PM,48,-122,4,7,11
9904,58thStGreenway22ndAve,03/17/2015 04:00:00 PM,48,-122,5,6,11
9905,58thStGreenway22ndAve,03/17/2015 05:00:00 PM,48,-122,10,2,12
9906,58thStGreenway22ndAve,03/17/2015 06:00:00 PM,48,-122,4,13,17
9907,58thStGreenway22ndAve,03/17/2015 07:00:00 PM,48,-122,1,6,7
9908,58thStGreenway22ndAve,03/17/2015 08:00:00 PM,48,-122,4,0,4
9909,58thStGreenway22ndAve,03/17/2015 09:00:00 PM,48,-122,4,0,4
9910,58thStGreenway22ndAve,03/17/2015 10:00:00 PM,48,-122,0,2,2
9911,58thStGreenway22ndAve,03/17/2015 11:00:00 PM,48,-122,2,0,2
9912,58thStGreenway22ndAve,03/18/2015 12:00:00 AM,48,-122,0,1,1
9913,58thStGreenway22ndAve,03/18/2015 01:00:00 AM,48,-122,0,1,1
9914,58thStGreenway22ndAve,03/18/2015 02:00:00 AM,48,-122,0,0,0
9915,58thStGreenway22ndAve,03/18/2015 03:00:00 AM,48,-122,0,0,0
9916,58thStGreenway22ndAve,03/18/2015 04:00:00 AM,48,-122,0,0,0
9917,58thStGreenway22ndAve,03/18/2015 05:00:00 AM,48,-122,0,0,0
9918,58thStGreenway22ndAve,03/18/2015 06:00:00 AM,48,-122,6,1,7
9919,58thStGreenway22ndAve,03/18/2015 07:00:00 AM,48,-122,2,3,5
9920,58thStGreenway22ndAve,03/18/2015 08:00:00 AM,48,-122,3,7,10
9921,58thStGreenway22ndAve,03/18/2015 09:00:00 AM,48,-122,2,6,8
9922,58thStGreenway22ndAve,03/18/2015 10:00:00 AM,48,-122,3,1,4
9923,58thStGreenway22ndAve,03/18/2015 11:00:00 AM,48,-122,8,4,12
9924,58thStGreenway22ndAve,03/18/2015 12:00:00 PM,48,-122,5,5,10
9925,58thStGreenway22ndAve,03/18/2015 01:00:00 PM,48,-122,6,7,13
9926,58thStGreenway22ndAve,03/18/2015 02:00:00 PM,48,-122,2,4,6
9927,58thStGreenway22ndAve,03/18/2015 03:00:00 PM,48,-122,4,4,8
9928,58thStGreenway22ndAve,03/18/2015 04:00:00 PM,48,-122,5,8,13
9929,58thStGreenway22ndAve,03/18/2015 05:00:00 PM,48,-122,16,12,28
9930,58thStGreenway22ndAve,03/18/2015 06:00:00 PM,48,-122,6,7,13
9931,58thStGreenway22ndAve,03/18/2015 07:00:00 PM,48,-122,8,2,10
9932,58thStGreenway22ndAve,03/18/2015 08:00:00 PM,48,-122,3,4,7
9933,58thStGreenway22ndAve,03/18/2015 09:00:00 PM,48,-122,0,0,0
9934,58thStGreenway22ndAve,03/18/2015 10:00:00 PM,48,-122,1,0,1
9935,58thStGreenway22ndAve,03/18/2015 11:00:00 PM,48,-122,0,1,1
9936,58thStGreenway22ndAve,03/19/2015 12:00:00 AM,48,-122,0,0,0
9937,58thStGreenway22ndAve,03/19/2015 01:00:00 AM,48,-122,0,0,0
9938,58thStGreenway22ndAve,03/19/2015 02:00:00 AM,48,-122,0,0,0
9939,58thStGreenway22ndAve,03/19/2015 03:00:00 AM,48,-122,0,0,0
9940,58thStGreenway22ndAve,03/19/2015 04:00:00 AM,48,-122,0,0,0
9941,58thStGreenway22ndAve,03/19/2015 05:00:00 AM,48,-122,1,0,1
9942,58thStGreenway22ndAve,03/19/2015 06:00:00 AM,48,-122,2,3,5
9943,58thStGreenway22ndAve,03/19/2015 07:00:00 AM,48,-122,3,1,4
9944,58thStGreenway22ndAve,03/19/2015 08:00:00 AM,48,-122,2,6,8
9945,58thStGreenway22ndAve,03/19/2015 09:00:00 AM,48,-122,4,1,5
9946,58thStGreenway22ndAve,03/19/2015 10:00:00 AM,48,-122,3,2,5
9947,58thStGreenway22ndAve,03/19/2015 11:00:00 AM,48,-122,2,3,5
9948,58thStGreenway22ndAve,03/19/2015 12:00:00 PM,48,-122,5,4,9
9949,58thStGreenway22ndAve,03/19/2015 01:00:00 PM,48,-122,8,2,10
9950,58thStGreenway22ndAve,03/19/2015 02:00:00 PM,48,-122,5,3,8
9951,58thStGreenway22ndAve,03/19/2015 03:00:00 PM,48,-122,2,1,3
9952,58thStGreenway22ndAve,03/19/2015 04:00:00 PM,48,-122,7,3,10
9953,58thStGreenway22ndAve,03/19/2015 05:00:00 PM,48,-122,9,8,17
9954,58thStGreenway22ndAve,03/19/2015 06:00:00 PM,48,-122,4,2,6
9955,58thStGreenway22ndAve,03/19/2015 07:00:00 PM,48,-122,5,7,12
9956,58thStGreenway22ndAve,03/19/2015 08:00:00 PM,48,-122,4,3,7
9957,58thStGreenway22ndAve,03/19/2015 09:00:00 PM,48,-122,5,3,8
9958,58thStGreenway22ndAve,03/19/2015 10:00:00 PM,48,-122,0,0,0
9959,58thStGreenway22ndAve,03/19/2015 11:00:00 PM,48,-122,2,1,3
9960,58thStGreenway22ndAve,03/20/2015 12:00:00 AM,48,-122,1,1,2
9961,58thStGreenway22ndAve,03/20/2015 01:00:00 AM,48,-122,0,0,0
9962,58thStGreenway22ndAve,03/20/2015 02:00:00 AM,48,-122,0,0,0
9963,58thStGreenway22ndAve,03/20/2015 03:00:00 AM,48,-122,0,0,0
9964,58thStGreenway22ndAve,03/20/2015 04:00:00 AM,48,-122,0,0,0
9965,58thStGreenway22ndAve,03/20/2015 05:00:00 AM,48,-122,0,1,1
9966,58thStGreenway22ndAve,03/20/2015 06:00:00 AM,48,-122,2,0,2
9967,58thStGreenway22ndAve,03/20/2015 07:00:00 AM,48,-122,3,0,3
9968,58thStGreenway22ndAve,03/20/2015 08:00:00 AM,48,-122,4,3,7
9969,58thStGreenway22ndAve,03/20/2015 09:00:00 AM,48,-122,2,10,12
9970,58thStGreenway22ndAve,03/20/2015 10:00:00 AM,48,-122,3,3,6
9971,58thStGreenway22ndAve,03/20/2015 11:00:00 AM,48,-122,4,2,6
9972,58thStGreenway22ndAve,03/20/2015 12:00:00 PM,48,-122,9,7,16
9973,58thStGreenway22ndAve,03/20/2015 01:00:00 PM,48,-122,2,3,5
9974,58thStGreenway22ndAve,03/20/2015 02:00:00 PM,48,-122,2,2,4
9975,58thStGreenway22ndAve,03/20/2015 03:00:00 PM,48,-122,2,2,4
9976,58thStGreenway22ndAve,03/20/2015 04:00:00 PM,48,-122,7,2,9
9977,58thStGreenway22ndAve,03/20/2015 05:00:00 PM,48,-122,2,4,6
9978,58thStGreenway22ndAve,03/20/2015 06:00:00 PM,48,-122,1,10,11
9979,58thStGreenway22ndAve,03/20/2015 07:00:00 PM,48,-122,0,0,0
9980,58thStGreenway22ndAve,03/20/2015 08:00:00 PM,48,-122,0,2,2
9981,58thStGreenway22ndAve,03/20/2015 09:00:00 PM,48,-122,0,0,0
9982,58thStGreenway22ndAve,03/20/2015 10:00:00 PM,48,-122,2,1,3
9983,58thStGreenway22ndAve,03/20/2015 11:00:00 PM,48,-122,0,0,0
9984,58thStGreenway22ndAve,03/21/2015 12:00:00 AM,48,-122,0,0,0
9985,58thStGreenway22ndAve,03/21/2015 01:00:00 AM,48,-122,0,0,0
9986,58thStGreenway22ndAve,03/21/2015 02:00:00 AM,48,-122,0,1,1
9987,58thStGreenway22ndAve,03/21/2015 03:00:00 AM,48,-122,0,0,0
9988,58thStGreenway22ndAve,03/21/2015 04:00:00 AM,48,-122,0,0,0
9989,58thStGreenway22ndAve,03/21/2015 05:00:00 AM,48,-122,0,0,0
9990,58thStGreenway22ndAve,03/21/2015 06:00:00 AM,48,-122,0,1,1
9991,58thStGreenway22ndAve,03/21/2015 07:00:00 AM,48,-122,0,0,0
9992,58thStGreenway22ndAve,03/21/2015 08:00:00 AM,48,-122,0,2,2
9993,58thStGreenway22ndAve,03/21/2015 09:00:00 AM,48,-122,4,3,7
9994,58thStGreenway22ndAve,03/21/2015 10:00:00 AM,48,-122,3,8,11
9995,58thStGreenway22ndAve,03/21/2015 11:00:00 AM,48,-122,10,34,44
9996,58thStGreenway22ndAve,03/21/2015 12:00:00 PM,48,-122,3,9,12
9997,58thStGreenway22ndAve,03/21/2015 01:00:00 PM,48,-122,10,6,16
9998,58thStGreenway22ndAve,03/21/2015 02:00:00 PM,48,-122,10,9,19
9999,58thStGreenway22ndAve,03/21/2015 03:00:00 PM,48,-122,9,13,22
10000,58thStGreenway22ndAve,03/21/2015 04:00:00 PM,48,-122,7,7,14
10001,58thStGreenway22ndAve,03/21/2015 05:00:00 PM,48,-122,5,12,17
10002,58thStGreenway22ndAve,03/21/2015 06:00:00 PM,48,-122,8,5,13
10003,58thStGreenway22ndAve,03/21/2015 07:00:00 PM,48,-122,5,3,8
10004,58thStGreenway22ndAve,03/21/2015 08:00:00 PM,48,-122,3,2,5
10005,58thStGreenway22ndAve,03/21/2015 09:00:00 PM,48,-122,5,1,6
10006,58thStGreenway22ndAve,03/21/2015 10:00:00 PM,48,-122,0,1,1
10007,58thStGreenway22ndAve,03/21/2015 11:00:00 PM,48,-122,0,0,0
10008,58thStGreenway22ndAve,03/22/2015 12:00:00 AM,48,-122,0,1,1
10009,58thStGreenway22ndAve,03/22/2015 01:00:00 AM,48,-122,1,0,1
10010,58thStGreenway22ndAve,03/22/2015 02:00:00 AM,48,-122,0,0,0
10011,58thStGreenway22ndAve,03/22/2015 03:00:00 AM,48,-122,0,0,0
10012,58thStGreenway22ndAve,03/22/2015 04:00:00 AM,48,-122,0,0,0
10013,58thStGreenway22ndAve,03/22/2015 05:00:00 AM,48,-122,0,0,0
10014,58thStGreenway22ndAve,03/22/2015 06:00:00 AM,48,-122,0,0,0
10015,58thStGreenway22ndAve,03/22/2015 07:00:00 AM,48,-122,0,0,0
10016,58thStGreenway22ndAve,03/22/2015 08:00:00 AM,48,-122,1,5,6
10017,58thStGreenway22ndAve,03/22/2015 09:00:00 AM,48,-122,2,1,3
10018,58thStGreenway22ndAve,03/22/2015 10:00:00 AM,48,-122,4,6,10
10019,58thStGreenway22ndAve,03/22/2015 11:00:00 AM,48,-122,1,5,6
10020,58thStGreenway22ndAve,03/22/2015 12:00:00 PM,48,-122,2,6,8
10021,58thStGreenway22ndAve,03/22/2015 01:00:00 PM,48,-122,8,7,15
10022,58thStGreenway22ndAve,03/22/2015 02:00:00 PM,48,-122,1,2,3
10023,58thStGreenway22ndAve,03/22/2015 03:00:00 PM,48,-122,2,4,6
10024,58thStGreenway22ndAve,03/22/2015 04:00:00 PM,48,-122,5,8,13
10025,58thStGreenway22ndAve,03/22/2015 05:00:00 PM,48,-122,2,5,7
10026,58thStGreenway22ndAve,03/22/2015 06:00:00 PM,48,-122,1,4,5
10027,58thStGreenway22ndAve,03/22/2015 07:00:00 PM,48,-122,1,0,1
10028,58thStGreenway22ndAve,03/22/2015 08:00:00 PM,48,-122,3,0,3
10029,58thStGreenway22ndAve,03/22/2015 09:00:00 PM,48,-122,2,0,2
10030,58thStGreenway22ndAve,03/22/2015 10:00:00 PM,48,-122,1,0,1
10031,58thStGreenway22ndAve,03/22/2015 11:00:00 PM,48,-122,1,0,1
10032,58thStGreenway22ndAve,03/23/2015 12:00:00 AM,48,-122,0,0,0
10033,58thStGreenway22ndAve,03/23/2015 01:00:00 AM,48,-122,0,0,0
10034,58thStGreenway22ndAve,03/23/2015 02:00:00 AM,48,-122,0,0,0
10035,58thStGreenway22ndAve,03/23/2015 03:00:00 AM,48,-122,0,0,0
10036,58thStGreenway22ndAve,03/23/2015 04:00:00 AM,48,-122,0,0,0
10037,58thStGreenway22ndAve,03/23/2015 05:00:00 AM,48,-122,0,0,0
10038,58thStGreenway22ndAve,03/23/2015 06:00:00 AM,48,-122,0,0,0
10039,58thStGreenway22ndAve,03/23/2015 07:00:00 AM,48,-122,3,4,7
10040,58thStGreenway22ndAve,03/23/2015 08:00:00 AM,48,-122,0,2,2
10041,58thStGreenway22ndAve,03/23/2015 09:00:00 AM,48,-122,1,6,7
10042,58thStGreenway22ndAve,03/23/2015 10:00:00 AM,48,-122,4,3,7
10043,58thStGreenway22ndAve,03/23/2015 11:00:00 AM,48,-122,3,2,5
10044,58thStGreenway22ndAve,03/23/2015 12:00:00 PM,48,-122,2,2,4
10045,58thStGreenway22ndAve,03/23/2015 01:00:00 PM,48,-122,3,3,6
10046,58thStGreenway22ndAve,03/23/2015 02:00:00 PM,48,-122,2,1,3
10047,58thStGreenway22ndAve,03/23/2015 03:00:00 PM,48,-122,1,2,3
10048,58thStGreenway22ndAve,03/23/2015 04:00:00 PM,48,-122,4,8,12
10049,58thStGreenway22ndAve,03/23/2015 05:00:00 PM,48,-122,7,7,14
10050,58thStGreenway22ndAve,03/23/2015 06:00:00 PM,48,-122,0,7,7
10051,58thStGreenway22ndAve,03/23/2015 07:00:00 PM,48,-122,3,0,3
10052,58thStGreenway22ndAve,03/23/2015 08:00:00 PM,48,-122,1,0,1
10053,58thStGreenway22ndAve,03/23/2015 09:00:00 PM,48,-122,3,0,3
10054,58thStGreenway22ndAve,03/23/2015 10:00:00 PM,48,-122,2,0,2
10055,58thStGreenway22ndAve,03/23/2015 11:00:00 PM,48,-122,1,2,3
10056,58thStGreenway22ndAve,03/24/2015 12:00:00 AM,48,-122,2,1,3
10057,58thStGreenway22ndAve,03/24/2015 01:00:00 AM,48,-122,1,0,1
10058,58thStGreenway22ndAve,03/24/2015 02:00:00 AM,48,-122,0,1,1
10059,58thStGreenway22ndAve,03/24/2015 03:00:00 AM,48,-122,0,0,0
10060,58thStGreenway22ndAve,03/24/2015 04:00:00 AM,48,-122,0,0,0
10061,58thStGreenway22ndAve,03/24/2015 05:00:00 AM,48,-122,0,0,0
10062,58thStGreenway22ndAve,03/24/2015 06:00:00 AM,48,-122,2,1,3
10063,58thStGreenway22ndAve,03/24/2015 07:00:00 AM,48,-122,0,3,3
10064,58thStGreenway22ndAve,03/24/2015 08:00:00 AM,48,-122,3,8,11
10065,58thStGreenway22ndAve,03/24/2015 09:00:00 AM,48,-122,1,8,9
10066,58thStGreenway22ndAve,03/24/2015 10:00:00 AM,48,-122,4,7,11
10067,58thStGreenway22ndAve,03/24/2015 11:00:00 AM,48,-122,4,4,8
10068,58thStGreenway22ndAve,03/24/2015 12:00:00 PM,48,-122,7,1,8
10069,58thStGreenway22ndAve,03/24/2015 01:00:00 PM,48,-122,4,1,5
10070,58thStGreenway22ndAve,03/24/2015 02:00:00 PM,48,-122,5,3,8
10071,58thStGreenway22ndAve,03/24/2015 03:00:00 PM,48,-122,5,2,7
10072,58thStGreenway22ndAve,03/24/2015 04:00:00 PM,48,-122,5,5,10
10073,58thStGreenway22ndAve,03/24/2015 05:00:00 PM,48,-122,5,9,14
10074,58thStGreenway22ndAve,03/24/2015 06:00:00 PM,48,-122,6,9,15
10075,58thStGreenway22ndAve,03/24/2015 07:00:00 PM,48,-122,1,8,9
10076,58thStGreenway22ndAve,03/24/2015 08:00:00 PM,48,-122,2,2,4
10077,58thStGreenway22ndAve,03/24/2015 09:00:00 PM,48,-122,1,1,2
10078,58thStGreenway22ndAve,03/24/2015 10:00:00 PM,48,-122,3,1,4
10079,58thStGreenway22ndAve,03/24/2015 11:00:00 PM,48,-122,1,0,1
10080,58thStGreenway22ndAve,03/25/2015 12:00:00 AM,48,-122,1,2,3
10081,58thStGreenway22ndAve,03/25/2015 01:00:00 AM,48,-122,0,0,0
10082,58thStGreenway22ndAve,03/25/2015 02:00:00 AM,48,-122,0,0,0
10083,58thStGreenway22ndAve,03/25/2015 03:00:00 AM,48,-122,0,0,0
10084,58thStGreenway22ndAve,03/25/2015 04:00:00 AM,48,-122,0,0,0
10085,58thStGreenway22ndAve,03/25/2015 05:00:00 AM,48,-122,0,1,1
10086,58thStGreenway22ndAve,03/25/2015 06:00:00 AM,48,-122,0,1,1
10087,58thStGreenway22ndAve,03/25/2015 07:00:00 AM,48,-122,5,3,8
10088,58thStGreenway22ndAve,03/25/2015 08:00:00 AM,48,-122,3,0,3
10089,58thStGreenway22ndAve,03/25/2015 09:00:00 AM,48,-122,2,7,9
10090,58thStGreenway22ndAve,03/25/2015 10:00:00 AM,48,-122,8,5,13
10091,58thStGreenway22ndAve,03/25/2015 11:00:00 AM,48,-122,2,6,8
10092,58thStGreenway22ndAve,03/25/2015 12:00:00 PM,48,-122,6,2,8
10093,58thStGreenway22ndAve,03/25/2015 01:00:00 PM,48,-122,6,2,8
10094,58thStGreenway22ndAve,03/25/2015 02:00:00 PM,48,-122,3,1,4
10095,58thStGreenway22ndAve,03/25/2015 03:00:00 PM,48,-122,6,2,8
10096,58thStGreenway22ndAve,03/25/2015 04:00:00 PM,48,-122,6,1,7
10097,58thStGreenway22ndAve,03/25/2015 05:00:00 PM,48,-122,2,7,9
10098,58thStGreenway22ndAve,03/25/2015 06:00:00 PM,48,-122,4,11,15
10099,58thStGreenway22ndAve,03/25/2015 07:00:00 PM,48,-122,5,3,8
10100,58thStGreenway22ndAve,03/25/2015 08:00:00 PM,48,-122,0,2,2
10101,58thStGreenway22ndAve,03/25/2015 09:00:00 PM,48,-122,5,3,8
10102,58thStGreenway22ndAve,03/25/2015 10:00:00 PM,48,-122,0,1,1
10103,58thStGreenway22ndAve,03/25/2015 11:00:00 PM,48,-122,1,1,2
10104,58thStGreenway22ndAve,03/26/2015 12:00:00 AM,48,-122,0,0,0
10105,58thStGreenway22ndAve,03/26/2015 01:00:00 AM,48,-122,0,0,0
10106,58thStGreenway22ndAve,03/26/2015 02:00:00 AM,48,-122,0,0,0
10107,58thStGreenway22ndAve,03/26/2015 03:00:00 AM,48,-122,0,0,0
10108,58thStGreenway22ndAve,03/26/2015 04:00:00 AM,48,-122,0,0,0
10109,58thStGreenway22ndAve,03/26/2015 05:00:00 AM,48,-122,0,0,0
10110,58thStGreenway22ndAve,03/26/2015 06:00:00 AM,48,-122,5,3,8
10111,58thStGreenway22ndAve,03/26/2015 07:00:00 AM,48,-122,4,4,8
10112,58thStGreenway22ndAve,03/26/2015 08:00:00 AM,48,-122,2,7,9
10113,58thStGreenway22ndAve,03/26/2015 09:00:00 AM,48,-122,4,4,8
10114,58thStGreenway22ndAve,03/26/2015 10:00:00 AM,48,-122,3,7,10
10115,58thStGreenway22ndAve,03/26/2015 11:00:00 AM,48,-122,4,0,4
10116,58thStGreenway22ndAve,03/26/2015 12:00:00 PM,48,-122,8,6,14
10117,58thStGreenway22ndAve,03/26/2015 01:00:00 PM,48,-122,10,1,11
10118,58thStGreenway22ndAve,03/26/2015 02:00:00 PM,48,-122,7,2,9
10119,58thStGreenway22ndAve,03/26/2015 03:00:00 PM,48,-122,7,4,11
10120,58thStGreenway22ndAve,03/26/2015 04:00:00 PM,48,-122,10,9,19
10121,58thStGreenway22ndAve,03/26/2015 05:00:00 PM,48,-122,9,6,15
10122,58thStGreenway22ndAve,03/26/2015 06:00:00 PM,48,-122,7,11,18
10123,58thStGreenway22ndAve,03/26/2015 07:00:00 PM,48,-122,8,1,9
10124,58thStGreenway22ndAve,03/26/2015 08:00:00 PM,48,-122,5,3,8
10125,58thStGreenway22ndAve,03/26/2015 09:00:00 PM,48,-122,0,5,5
10126,58thStGreenway22ndAve,03/26/2015 10:00:00 PM,48,-122,0,2,2
10127,58thStGreenway22ndAve,03/26/2015 11:00:00 PM,48,-122,6,0,6
10128,58thStGreenway22ndAve,03/27/2015 12:00:00 AM,48,-122,0,0,0
10129,58thStGreenway22ndAve,03/27/2015 01:00:00 AM,48,-122,0,0,0
10130,58thStGreenway22ndAve,03/27/2015 02:00:00 AM,48,-122,0,0,0
10131,58thStGreenway22ndAve,03/27/2015 03:00:00 AM,48,-122,0,0,0
10132,58thStGreenway22ndAve,03/27/2015 04:00:00 AM,48,-122,0,0,0
10133,58thStGreenway22ndAve,03/27/2015 05:00:00 AM,48,-122,0,0,0
10134,58thStGreenway22ndAve,03/27/2015 06:00:00 AM,48,-122,0,0,0
10135,58thStGreenway22ndAve,03/27/2015 07:00:00 AM,48,-122,2,2,4
10136,58thStGreenway22ndAve,03/27/2015 08:00:00 AM,48,-122,9,4,13
10137,58thStGreenway22ndAve,03/27/2015 09:00:00 AM,48,-122,2,10,12
10138,58thStGreenway22ndAve,03/27/2015 10:00:00 AM,48,-122,3,4,7
10139,58thStGreenway22ndAve,03/27/2015 11:00:00 AM,48,-122,9,3,12
10140,58thStGreenway22ndAve,03/27/2015 12:00:00 PM,48,-122,4,7,11
10141,58thStGreenway22ndAve,03/27/2015 01:00:00 PM,48,-122,3,5,8
10142,58thStGreenway22ndAve,03/27/2015 02:00:00 PM,48,-122,7,4,11
10143,58thStGreenway22ndAve,03/27/2015 03:00:00 PM,48,-122,5,6,11
10144,58thStGreenway22ndAve,03/27/2015 04:00:00 PM,48,-122,6,9,15
10145,58thStGreenway22ndAve,03/27/2015 05:00:00 PM,48,-122,11,7,18
10146,58thStGreenway22ndAve,03/27/2015 06:00:00 PM,48,-122,8,10,18
10147,58thStGreenway22ndAve,03/27/2015 07:00:00 PM,48,-122,7,8,15
10148,58thStGreenway22ndAve,03/27/2015 08:00:00 PM,48,-122,1,4,5
10149,58thStGreenway22ndAve,03/27/2015 09:00:00 PM,48,-122,7,2,9
10150,58thStGreenway22ndAve,03/27/2015 10:00:00 PM,48,-122,0,0,0
10151,58thStGreenway22ndAve,03/27/2015 11:00:00 PM,48,-122,0,2,2
10152,58thStGreenway22ndAve,03/28/2015 12:00:00 AM,48,-122,2,0,2
10153,58thStGreenway22ndAve,03/28/2015 01:00:00 AM,48,-122,0,0,0
10154,58thStGreenway22ndAve,03/28/2015 02:00:00 AM,48,-122,0,0,0
10155,58thStGreenway22ndAve,03/28/2015 03:00:00 AM,48,-122,0,0,0
10156,58thStGreenway22ndAve,03/28/2015 04:00:00 AM,48,-122,0,0,0
10157,58thStGreenway22ndAve,03/28/2015 05:00:00 AM,48,-122,0,0,0
10158,58thStGreenway22ndAve,03/28/2015 06:00:00 AM,48,-122,2,0,2
10159,58thStGreenway22ndAve,03/28/2015 07:00:00 AM,48,-122,0,0,0
10160,58thStGreenway22ndAve,03/28/2015 08:00:00 AM,48,-122,1,5,6
10161,58thStGreenway22ndAve,03/28/2015 09:00:00 AM,48,-122,4,4,8
10162,58thStGreenway22ndAve,03/28/2015 10:00:00 AM,48,-122,3,7,10
10163,58thStGreenway22ndAve,03/28/2015 11:00:00 AM,48,-122,9,7,16
10164,58thStGreenway22ndAve,03/28/2015 12:00:00 PM,48,-122,18,6,24
10165,58thStGreenway22ndAve,03/28/2015 01:00:00 PM,48,-122,3,21,24
10166,58thStGreenway22ndAve,03/28/2015 02:00:00 PM,48,-122,4,4,8
10167,58thStGreenway22ndAve,03/28/2015 03:00:00 PM,48,-122,9,8,17
10168,58thStGreenway22ndAve,03/28/2015 04:00:00 PM,48,-122,11,7,18
10169,58thStGreenway22ndAve,03/28/2015 05:00:00 PM,48,-122,8,8,16
10170,58thStGreenway22ndAve,03/28/2015 06:00:00 PM,48,-122,6,3,9
10171,58thStGreenway22ndAve,03/28/2015 07:00:00 PM,48,-122,3,1,4
10172,58thStGreenway22ndAve,03/28/2015 08:00:00 PM,48,-122,6,3,9
10173,58thStGreenway22ndAve,03/28/2015 09:00:00 PM,48,-122,1,2,3
10174,58thStGreenway22ndAve,03/28/2015 10:00:00 PM,48,-122,0,1,1
10175,58thStGreenway22ndAve,03/28/2015 11:00:00 PM,48,-122,2,3,5
10176,58thStGreenway22ndAve,03/29/2015 12:00:00 AM,48,-122,0,0,0
10177,58thStGreenway22ndAve,03/29/2015 01:00:00 AM,48,-122,0,0,0
10178,58thStGreenway22ndAve,03/29/2015 02:00:00 AM,48,-122,0,0,0
10179,58thStGreenway22ndAve,03/29/2015 03:00:00 AM,48,-122,0,0,0
10180,58thStGreenway22ndAve,03/29/2015 04:00:00 AM,48,-122,0,0,0
10181,58thStGreenway22ndAve,03/29/2015 05:00:00 AM,48,-122,0,0,0
10182,58thStGreenway22ndAve,03/29/2015 06:00:00 AM,48,-122,0,0,0
10183,58thStGreenway22ndAve,03/29/2015 07:00:00 AM,48,-122,0,0,0
10184,58thStGreenway22ndAve,03/29/2015 08:00:00 AM,48,-122,1,2,3
10185,58thStGreenway22ndAve,03/29/2015 09:00:00 AM,48,-122,3,3,6
10186,58thStGreenway22ndAve,03/29/2015 10:00:00 AM,48,-122,0,4,4
10187,58thStGreenway22ndAve,03/29/2015 11:00:00 AM,48,-122,4,6,10
10188,58thStGreenway22ndAve,03/29/2015 12:00:00 PM,48,-122,10,6,16
10189,58thStGreenway22ndAve,03/29/2015 01:00:00 PM,48,-122,4,6,10
10190,58thStGreenway22ndAve,03/29/2015 02:00:00 PM,48,-122,4,6,10
10191,58thStGreenway22ndAve,03/29/2015 03:00:00 PM,48,-122,4,6,10
10192,58thStGreenway22ndAve,03/29/2015 04:00:00 PM,48,-122,4,5,9
10193,58thStGreenway22ndAve,03/29/2015 05:00:00 PM,48,-122,8,5,13
10194,58thStGreenway22ndAve,03/29/2015 06:00:00 PM,48,-122,2,0,2
10195,58thStGreenway22ndAve,03/29/2015 07:00:00 PM,48,-122,5,2,7
10196,58thStGreenway22ndAve,03/29/2015 08:00:00 PM,48,-122,8,0,8
10197,58thStGreenway22ndAve,03/29/2015 09:00:00 PM,48,-122,1,1,2
10198,58thStGreenway22ndAve,03/29/2015 10:00:00 PM,48,-122,0,0,0
10199,58thStGreenway22ndAve,03/29/2015 11:00:00 PM,48,-122,1,0,1
10200,58thStGreenway22ndAve,03/30/2015 12:00:00 AM,48,-122,0,0,0
10201,58thStGreenway22ndAve,03/30/2015 01:00:00 AM,48,-122,0,0,0
10202,58thStGreenway22ndAve,03/30/2015 02:00:00 AM,48,-122,0,0,0
10203,58thStGreenway22ndAve,03/30/2015 03:00:00 AM,48,-122,0,0,0
10204,58thStGreenway22ndAve,03/30/2015 04:00:00 AM,48,-122,0,1,1
10205,58thStGreenway22ndAve,03/30/2015 05:00:00 AM,48,-122,0,0,0
10206,58thStGreenway22ndAve,03/30/2015 06:00:00 AM,48,-122,2,2,4
10207,58thStGreenway22ndAve,03/30/2015 07:00:00 AM,48,-122,7,3,10
10208,58thStGreenway22ndAve,03/30/2015 08:00:00 AM,48,-122,0,10,10
10209,58thStGreenway22ndAve,03/30/2015 09:00:00 AM,48,-122,6,4,10
10210,58thStGreenway22ndAve,03/30/2015 10:00:00 AM,48,-122,2,4,6
10211,58thStGreenway22ndAve,03/30/2015 11:00:00 AM,48,-122,4,3,7
10212,58thStGreenway22ndAve,03/30/2015 12:00:00 PM,48,-122,3,3,6
10213,58thStGreenway22ndAve,03/30/2015 01:00:00 PM,48,-122,6,5,11
10214,58thStGreenway22ndAve,03/30/2015 02:00:00 PM,48,-122,1,6,7
10215,58thStGreenway22ndAve,03/30/2015 03:00:00 PM,48,-122,7,7,14
10216,58thStGreenway22ndAve,03/30/2015 04:00:00 PM,48,-122,9,9,18
10217,58thStGreenway22ndAve,03/30/2015 05:00:00 PM,48,-122,6,9,15
10218,58thStGreenway22ndAve,03/30/2015 06:00:00 PM,48,-122,8,9,17
10219,58thStGreenway22ndAve,03/30/2015 07:00:00 PM,48,-122,7,1,8
10220,58thStGreenway22ndAve,03/30/2015 08:00:00 PM,48,-122,2,5,7
10221,58thStGreenway22ndAve,03/30/2015 09:00:00 PM,48,-122,1,0,1
10222,58thStGreenway22ndAve,03/30/2015 10:00:00 PM,48,-122,2,1,3
10223,58thStGreenway22ndAve,03/30/2015 11:00:00 PM,48,-122,1,1,2
10224,58thStGreenway22ndAve,03/31/2015 12:00:00 AM,48,-122,0,0,0
10225,58thStGreenway22ndAve,03/31/2015 01:00:00 AM,48,-122,0,1,1
10226,58thStGreenway22ndAve,03/31/2015 02:00:00 AM,48,-122,0,0,0
10227,58thStGreenway22ndAve,03/31/2015 03:00:00 AM,48,-122,0,0,0
10228,58thStGreenway22ndAve,03/31/2015 04:00:00 AM,48,-122,0,1,1
10229,58thStGreenway22ndAve,03/31/2015 05:00:00 AM,48,-122,2,0,2
10230,58thStGreenway22ndAve,03/31/2015 06:00:00 AM,48,-122,1,1,2
10231,58thStGreenway22ndAve,03/31/2015 07:00:00 AM,48,-122,2,1,3
10232,58thStGreenway22ndAve,03/31/2015 08:00:00 AM,48,-122,2,4,6
10233,58thStGreenway22ndAve,03/31/2015 09:00:00 AM,48,-122,4,1,5
10234,58thStGreenway22ndAve,03/31/2015 10:00:00 AM,48,-122,0,3,3
10235,58thStGreenway22ndAve,03/31/2015 11:00:00 AM,48,-122,2,4,6
10236,58thStGreenway22ndAve,03/31/2015 12:00:00 PM,48,-122,2,1,3
10237,58thStGreenway22ndAve,03/31/2015 01:00:00 PM,48,-122,3,3,6
10238,58thStGreenway22ndAve,03/31/2015 02:00:00 PM,48,-122,4,7,11
10239,58thStGreenway22ndAve,03/31/2015 03:00:00 PM,48,-122,4,6,10
10240,58thStGreenway22ndAve,03/31/2015 04:00:00 PM,48,-122,5,1,6
10241,58thStGreenway22ndAve,03/31/2015 05:00:00 PM,48,-122,5,1,6
10242,58thStGreenway22ndAve,03/31/2015 06:00:00 PM,48,-122,1,2,3
10243,58thStGreenway22ndAve,03/31/2015 07:00:00 PM,48,-122,4,6,10
10244,58thStGreenway22ndAve,03/31/2015 08:00:00 PM,48,-122,3,0,3
10245,58thStGreenway22ndAve,03/31/2015 09:00:00 PM,48,-122,1,0,1
10246,58thStGreenway22ndAve,03/31/2015 10:00:00 PM,48,-122,0,1,1
10247,58thStGreenway22ndAve,03/31/2015 11:00:00 PM,48,-122,2,1,3
10248,58thStGreenway22ndAve,04/01/2015 12:00:00 AM,48,-122,5,0,5
10249,58thStGreenway22ndAve,04/01/2015 01:00:00 AM,48,-122,0,0,0
10250,58thStGreenway22ndAve,04/01/2015 02:00:00 AM,48,-122,0,0,0
10251,58thStGreenway22ndAve,04/01/2015 03:00:00 AM,48,-122,0,0,0
10252,58thStGreenway22ndAve,04/01/2015 04:00:00 AM,48,-122,0,1,1
10253,58thStGreenway22ndAve,04/01/2015 05:00:00 AM,48,-122,0,1,1
10254,58thStGreenway22ndAve,04/01/2015 06:00:00 AM,48,-122,0,0,0
10255,58thStGreenway22ndAve,04/01/2015 07:00:00 AM,48,-122,6,3,9
10256,58thStGreenway22ndAve,04/01/2015 08:00:00 AM,48,-122,4,4,8
10257,58thStGreenway22ndAve,04/01/2015 09:00:00 AM,48,-122,3,6,9
10258,58thStGreenway22ndAve,04/01/2015 10:00:00 AM,48,-122,4,3,7
10259,58thStGreenway22ndAve,04/01/2015 11:00:00 AM,48,-122,2,2,4
10260,58thStGreenway22ndAve,04/01/2015 12:00:00 PM,48,-122,4,6,10
10261,58thStGreenway22ndAve,04/01/2015 01:00:00 PM,48,-122,6,4,10
10262,58thStGreenway22ndAve,04/01/2015 02:00:00 PM,48,-122,3,4,7
10263,58thStGreenway22ndAve,04/01/2015 03:00:00 PM,48,-122,4,2,6
10264,58thStGreenway22ndAve,04/01/2015 04:00:00 PM,48,-122,3,3,6
10265,58thStGreenway22ndAve,04/01/2015 05:00:00 PM,48,-122,11,7,18
10266,58thStGreenway22ndAve,04/01/2015 06:00:00 PM,48,-122,4,9,13
10267,58thStGreenway22ndAve,04/01/2015 07:00:00 PM,48,-122,4,1,5
10268,58thStGreenway22ndAve,04/01/2015 08:00:00 PM,48,-122,1,1,2
10269,58thStGreenway22ndAve,04/01/2015 09:00:00 PM,48,-122,0,1,1
10270,58thStGreenway22ndAve,04/01/2015 10:00:00 PM,48,-122,1,3,4
10271,58thStGreenway22ndAve,04/01/2015 11:00:00 PM,48,-122,1,0,1
10272,58thStGreenway22ndAve,04/02/2015 12:00:00 AM,48,-122,0,0,0
10273,58thStGreenway22ndAve,04/02/2015 01:00:00 AM,48,-122,0,1,1
10274,58thStGreenway22ndAve,04/02/2015 02:00:00 AM,48,-122,0,0,0
10275,58thStGreenway22ndAve,04/02/2015 03:00:00 AM,48,-122,0,0,0
10276,58thStGreenway22ndAve,04/02/2015 04:00:00 AM,48,-122,0,1,1
10277,58thStGreenway22ndAve,04/02/2015 05:00:00 AM,48,-122,0,1,1
10278,58thStGreenway22ndAve,04/02/2015 06:00:00 AM,48,-122,0,1,1
10279,58thStGreenway22ndAve,04/02/2015 07:00:00 AM,48,-122,2,3,5
10280,58thStGreenway22ndAve,04/02/2015 08:00:00 AM,48,-122,1,4,5
10281,58thStGreenway22ndAve,04/02/2015 09:00:00 AM,48,-122,1,2,3
10282,58thStGreenway22ndAve,04/02/2015 10:00:00 AM,48,-122,3,0,3
10283,58thStGreenway22ndAve,04/02/2015 11:00:00 AM,48,-122,2,2,4
10284,58thStGreenway22ndAve,04/02/2015 12:00:00 PM,48,-122,3,2,5
10285,58thStGreenway22ndAve,04/02/2015 01:00:00 PM,48,-122,2,6,8
10286,58thStGreenway22ndAve,04/02/2015 02:00:00 PM,48,-122,1,2,3
10287,58thStGreenway22ndAve,04/02/2015 03:00:00 PM,48,-122,2,5,7
10288,58thStGreenway22ndAve,04/02/2015 04:00:00 PM,48,-122,10,13,23
10289,58thStGreenway22ndAve,04/02/2015 05:00:00 PM,48,-122,8,12,20
10290,58thStGreenway22ndAve,04/02/2015 06:00:00 PM,48,-122,11,12,23
10291,58thStGreenway22ndAve,04/02/2015 07:00:00 PM,48,-122,9,3,12
10292,58thStGreenway22ndAve,04/02/2015 08:00:00 PM,48,-122,3,0,3
10293,58thStGreenway22ndAve,04/02/2015 09:00:00 PM,48,-122,1,2,3
10294,58thStGreenway22ndAve,04/02/2015 10:00:00 PM,48,-122,1,1,2
10295,58thStGreenway22ndAve,04/02/2015 11:00:00 PM,48,-122,2,1,3
10296,58thStGreenway22ndAve,04/03/2015 12:00:00 AM,48,-122,0,0,0
10297,58thStGreenway22ndAve,04/03/2015 01:00:00 AM,48,-122,0,0,0
10298,58thStGreenway22ndAve,04/03/2015 02:00:00 AM,48,-122,0,0,0
10299,58thStGreenway22ndAve,04/03/2015 03:00:00 AM,48,-122,0,0,0
10300,58thStGreenway22ndAve,04/03/2015 04:00:00 AM,48,-122,0,0,0
10301,58thStGreenway22ndAve,04/03/2015 05:00:00 AM,48,-122,0,1,1
10302,58thStGreenway22ndAve,04/03/2015 06:00:00 AM,48,-122,0,1,1
10303,58thStGreenway22ndAve,04/03/2015 07:00:00 AM,48,-122,2,2,4
10304,58thStGreenway22ndAve,04/03/2015 08:00:00 AM,48,-122,4,8,12
10305,58thStGreenway22ndAve,04/03/2015 09:00:00 AM,48,-122,9,3,12
10306,58thStGreenway22ndAve,04/03/2015 10:00:00 AM,48,-122,4,2,6
10307,58thStGreenway22ndAve,04/03/2015 11:00:00 AM,48,-122,8,1,9
10308,58thStGreenway22ndAve,04/03/2015 12:00:00 PM,48,-122,2,3,5
10309,58thStGreenway22ndAve,04/03/2015 01:00:00 PM,48,-122,6,5,11
10310,58thStGreenway22ndAve,04/03/2015 02:00:00 PM,48,-122,1,4,5
10311,58thStGreenway22ndAve,04/03/2015 03:00:00 PM,48,-122,5,0,5
10312,58thStGreenway22ndAve,04/03/2015 04:00:00 PM,48,-122,1,1,2
10313,58thStGreenway22ndAve,04/03/2015 05:00:00 PM,48,-122,8,9,17
10314,58thStGreenway22ndAve,04/03/2015 06:00:00 PM,48,-122,5,3,8
10315,58thStGreenway22ndAve,04/03/2015 07:00:00 PM,48,-122,1,4,5
10316,58thStGreenway22ndAve,04/03/2015 08:00:00 PM,48,-122,0,1,1
10317,58thStGreenway22ndAve,04/03/2015 09:00:00 PM,48,-122,0,2,2
10318,58thStGreenway22ndAve,04/03/2015 10:00:00 PM,48,-122,2,0,2
10319,58thStGreenway22ndAve,04/03/2015 11:00:00 PM,48,-122,0,1,1
10320,58thStGreenway22ndAve,04/04/2015 12:00:00 AM,48,-122,0,0,0
10321,58thStGreenway22ndAve,04/04/2015 01:00:00 AM,48,-122,0,0,0
10322,58thStGreenway22ndAve,04/04/2015 02:00:00 AM,48,-122,1,0,1
10323,58thStGreenway22ndAve,04/04/2015 03:00:00 AM,48,-122,0,0,0
10324,58thStGreenway22ndAve,04/04/2015 04:00:00 AM,48,-122,0,0,0
10325,58thStGreenway22ndAve,04/04/2015 05:00:00 AM,48,-122,0,0,0
10326,58thStGreenway22ndAve,04/04/2015 06:00:00 AM,48,-122,0,1,1
10327,58thStGreenway22ndAve,04/04/2015 07:00:00 AM,48,-122,0,0,0
10328,58thStGreenway22ndAve,04/04/2015 08:00:00 AM,48,-122,0,4,4
10329,58thStGreenway22ndAve,04/04/2015 09:00:00 AM,48,-122,1,5,6
10330,58thStGreenway22ndAve,04/04/2015 10:00:00 AM,48,-122,4,5,9
10331,58thStGreenway22ndAve,04/04/2015 11:00:00 AM,48,-122,5,4,9
10332,58thStGreenway22ndAve,04/04/2015 12:00:00 PM,48,-122,5,4,9
10333,58thStGreenway22ndAve,04/04/2015 01:00:00 PM,48,-122,21,6,27
10334,58thStGreenway22ndAve,04/04/2015 02:00:00 PM,48,-122,10,4,14
10335,58thStGreenway22ndAve,04/04/2015 03:00:00 PM,48,-122,7,4,11
10336,58thStGreenway22ndAve,04/04/2015 04:00:00 PM,48,-122,8,8,16
10337,58thStGreenway22ndAve,04/04/2015 05:00:00 PM,48,-122,6,12,18
10338,58thStGreenway22ndAve,04/04/2015 06:00:00 PM,48,-122,9,3,12
10339,58thStGreenway22ndAve,04/04/2015 07:00:00 PM,48,-122,7,8,15
10340,58thStGreenway22ndAve,04/04/2015 08:00:00 PM,48,-122,1,3,4
10341,58thStGreenway22ndAve,04/04/2015 09:00:00 PM,48,-122,3,2,5
10342,58thStGreenway22ndAve,04/04/2015 10:00:00 PM,48,-122,1,1,2
10343,58thStGreenway22ndAve,04/04/2015 11:00:00 PM,48,-122,1,0,1
10344,58thStGreenway22ndAve,04/05/2015 12:00:00 AM,48,-122,2,0,2
10345,58thStGreenway22ndAve,04/05/2015 01:00:00 AM,48,-122,0,2,2
10346,58thStGreenway22ndAve,04/05/2015 02:00:00 AM,48,-122,0,0,0
10347,58thStGreenway22ndAve,04/05/2015 03:00:00 AM,48,-122,1,0,1
10348,58thStGreenway22ndAve,04/05/2015 04:00:00 AM,48,-122,0,1,1
10349,58thStGreenway22ndAve,04/05/2015 05:00:00 AM,48,-122,0,1,1
10350,58thStGreenway22ndAve,04/05/2015 06:00:00 AM,48,-122,1,1,2
10351,58thStGreenway22ndAve,04/05/2015 07:00:00 AM,48,-122,0,1,1
10352,58thStGreenway22ndAve,04/05/2015 08:00:00 AM,48,-122,0,2,2
10353,58thStGreenway22ndAve,04/05/2015 09:00:00 AM,48,-122,1,9,10
10354,58thStGreenway22ndAve,04/05/2015 10:00:00 AM,48,-122,10,6,16
10355,58thStGreenway22ndAve,04/05/2015 11:00:00 AM,48,-122,8,5,13
10356,58thStGreenway22ndAve,04/05/2015 12:00:00 PM,48,-122,5,17,22
10357,58thStGreenway22ndAve,04/05/2015 01:00:00 PM,48,-122,3,8,11
10358,58thStGreenway22ndAve,04/05/2015 02:00:00 PM,48,-122,19,3,22
10359,58thStGreenway22ndAve,04/05/2015 03:00:00 PM,48,-122,12,6,18
10360,58thStGreenway22ndAve,04/05/2015 04:00:00 PM,48,-122,5,3,8
10361,58thStGreenway22ndAve,04/05/2015 05:00:00 PM,48,-122,12,8,20
10362,58thStGreenway22ndAve,04/05/2015 06:00:00 PM,48,-122,7,0,7
10363,58thStGreenway22ndAve,04/05/2015 07:00:00 PM,48,-122,0,7,7
10364,58thStGreenway22ndAve,04/05/2015 08:00:00 PM,48,-122,5,3,8
10365,58thStGreenway22ndAve,04/05/2015 09:00:00 PM,48,-122,0,0,0
10366,58thStGreenway22ndAve,04/05/2015 10:00:00 PM,48,-122,0,0,0
10367,58thStGreenway22ndAve,04/05/2015 11:00:00 PM,48,-122,0,0,0
10368,58thStGreenway22ndAve,04/06/2015 12:00:00 AM,48,-122,0,0,0
10369,58thStGreenway22ndAve,04/06/2015 01:00:00 AM,48,-122,0,0,0
10370,58thStGreenway22ndAve,04/06/2015 02:00:00 AM,48,-122,0,0,0
10371,58thStGreenway22ndAve,04/06/2015 03:00:00 AM,48,-122,0,0,0
10372,58thStGreenway22ndAve,04/06/2015 04:00:00 AM,48,-122,0,0,0
10373,58thStGreenway22ndAve,04/06/2015 05:00:00 AM,48,-122,0,1,1
10374,58thStGreenway22ndAve,04/06/2015 06:00:00 AM,48,-122,0,4,4
10375,58thStGreenway22ndAve,04/06/2015 07:00:00 AM,48,-122,3,5,8
10376,58thStGreenway22ndAve,04/06/2015 08:00:00 AM,48,-122,7,5,12
10377,58thStGreenway22ndAve,04/06/2015 09:00:00 AM,48,-122,7,3,10
10378,58thStGreenway22ndAve,04/06/2015 10:00:00 AM,48,-122,3,7,10
10379,58thStGreenway22ndAve,04/06/2015 11:00:00 AM,48,-122,2,2,4
10380,58thStGreenway22ndAve,04/06/2015 12:00:00 PM,48,-122,8,7,15
10381,58thStGreenway22ndAve,04/06/2015 01:00:00 PM,48,-122,4,4,8
10382,58thStGreenway22ndAve,04/06/2015 02:00:00 PM,48,-122,6,4,10
10383,58thStGreenway22ndAve,04/06/2015 03:00:00 PM,48,-122,6,3,9
10384,58thStGreenway22ndAve,04/06/2015 04:00:00 PM,48,-122,7,4,11
10385,58thStGreenway22ndAve,04/06/2015 05:00:00 PM,48,-122,11,9,20
10386,58thStGreenway22ndAve,04/06/2015 06:00:00 PM,48,-122,6,5,11
10387,58thStGreenway22ndAve,04/06/2015 07:00:00 PM,48,-122,4,4,8
10388,58thStGreenway22ndAve,04/06/2015 08:00:00 PM,48,-122,6,1,7
10389,58thStGreenway22ndAve,04/06/2015 09:00:00 PM,48,-122,4,4,8
10390,58thStGreenway22ndAve,04/06/2015 10:00:00 PM,48,-122,2,0,2
10391,58thStGreenway22ndAve,04/06/2015 11:00:00 PM,48,-122,0,0,0
10392,58thStGreenway22ndAve,04/07/2015 12:00:00 AM,48,-122,2,0,2
10393,58thStGreenway22ndAve,04/07/2015 01:00:00 AM,48,-122,0,2,2
10394,58thStGreenway22ndAve,04/07/2015 02:00:00 AM,48,-122,0,0,0
10395,58thStGreenway22ndAve,04/07/2015 03:00:00 AM,48,-122,1,0,1
10396,58thStGreenway22ndAve,04/07/2015 04:00:00 AM,48,-122,0,1,1
10397,58thStGreenway22ndAve,04/07/2015 05:00:00 AM,48,-122,0,0,0
10398,58thStGreenway22ndAve,04/07/2015 06:00:00 AM,48,-122,0,1,1
10399,58thStGreenway22ndAve,04/07/2015 07:00:00 AM,48,-122,3,0,3
10400,58thStGreenway22ndAve,04/07/2015 08:00:00 AM,48,-122,3,4,7
10401,58thStGreenway22ndAve,04/07/2015 09:00:00 AM,48,-122,5,5,10
10402,58thStGreenway22ndAve,04/07/2015 10:00:00 AM,48,-122,6,0,6
10403,58thStGreenway22ndAve,04/07/2015 11:00:00 AM,48,-122,2,1,3
10404,58thStGreenway22ndAve,04/07/2015 12:00:00 PM,48,-122,8,1,9
10405,58thStGreenway22ndAve,04/07/2015 01:00:00 PM,48,-122,5,4,9
10406,58thStGreenway22ndAve,04/07/2015 02:00:00 PM,48,-122,4,2,6
10407,58thStGreenway22ndAve,04/07/2015 03:00:00 PM,48,-122,4,2,6
10408,58thStGreenway22ndAve,04/07/2015 04:00:00 PM,48,-122,2,1,3
10409,58thStGreenway22ndAve,04/07/2015 05:00:00 PM,48,-122,10,11,21
10410,58thStGreenway22ndAve,04/07/2015 06:00:00 PM,48,-122,3,8,11
10411,58thStGreenway22ndAve,04/07/2015 07:00:00 PM,48,-122,1,14,15
10412,58thStGreenway22ndAve,04/07/2015 08:00:00 PM,48,-122,0,2,2
10413,58thStGreenway22ndAve,04/07/2015 09:00:00 PM,48,-122,6,1,7
10414,58thStGreenway22ndAve,04/07/2015 10:00:00 PM,48,-122,1,0,1
10415,58thStGreenway22ndAve,04/07/2015 11:00:00 PM,48,-122,2,0,2
10416,58thStGreenway22ndAve,04/08/2015 12:00:00 AM,48,-122,0,1,1
10417,58thStGreenway22ndAve,04/08/2015 01:00:00 AM,48,-122,0,0,0
10418,58thStGreenway22ndAve,04/08/2015 02:00:00 AM,48,-122,0,0,0
10419,58thStGreenway22ndAve,04/08/2015 03:00:00 AM,48,-122,0,0,0
10420,58thStGreenway22ndAve,04/08/2015 04:00:00 AM,48,-122,0,0,0
10421,58thStGreenway22ndAve,04/08/2015 05:00:00 AM,48,-122,0,0,0
10422,58thStGreenway22ndAve,04/08/2015 06:00:00 AM,48,-122,0,2,2
10423,58thStGreenway22ndAve,04/08/2015 07:00:00 AM,48,-122,3,3,6
10424,58thStGreenway22ndAve,04/08/2015 08:00:00 AM,48,-122,4,9,13
10425,58thStGreenway22ndAve,04/08/2015 09:00:00 AM,48,-122,2,5,7
10426,58thStGreenway22ndAve,04/08/2015 10:00:00 AM,48,-122,4,1,5
10427,58thStGreenway22ndAve,04/08/2015 11:00:00 AM,48,-122,3,2,5
10428,58thStGreenway22ndAve,04/08/2015 12:00:00 PM,48,-122,3,2,5
10429,58thStGreenway22ndAve,04/08/2015 01:00:00 PM,48,-122,5,6,11
10430,58thStGreenway22ndAve,04/08/2015 02:00:00 PM,48,-122,3,3,6
10431,58thStGreenway22ndAve,04/08/2015 03:00:00 PM,48,-122,2,2,4
10432,58thStGreenway22ndAve,04/08/2015 04:00:00 PM,48,-122,4,8,12
10433,58thStGreenway22ndAve,04/08/2015 05:00:00 PM,48,-122,7,12,19
10434,58thStGreenway22ndAve,04/08/2015 06:00:00 PM,48,-122,12,14,26
10435,58thStGreenway22ndAve,04/08/2015 07:00:00 PM,48,-122,8,5,13
10436,58thStGreenway22ndAve,04/08/2015 08:00:00 PM,48,-122,9,7,16
10437,58thStGreenway22ndAve,04/08/2015 09:00:00 PM,48,-122,2,0,2
10438,58thStGreenway22ndAve,04/08/2015 10:00:00 PM,48,-122,2,1,3
10439,58thStGreenway22ndAve,04/08/2015 11:00:00 PM,48,-122,1,0,1
10440,58thStGreenway22ndAve,04/09/2015 12:00:00 AM,48,-122,0,0,0
10441,58thStGreenway22ndAve,04/09/2015 01:00:00 AM,48,-122,0,0,0
10442,58thStGreenway22ndAve,04/09/2015 02:00:00 AM,48,-122,0,0,0
10443,58thStGreenway22ndAve,04/09/2015 03:00:00 AM,48,-122,0,0,0
10444,58thStGreenway22ndAve,04/09/2015 04:00:00 AM,48,-122,0,1,1
10445,58thStGreenway22ndAve,04/09/2015 05:00:00 AM,48,-122,2,0,2
10446,58thStGreenway22ndAve,04/09/2015 06:00:00 AM,48,-122,0,3,3
10447,58thStGreenway22ndAve,04/09/2015 07:00:00 AM,48,-122,3,5,8
10448,58thStGreenway22ndAve,04/09/2015 08:00:00 AM,48,-122,8,5,13
10449,58thStGreenway22ndAve,04/09/2015 09:00:00 AM,48,-122,2,4,6
10450,58thStGreenway22ndAve,04/09/2015 10:00:00 AM,48,-122,4,5,9
10451,58thStGreenway22ndAve,04/09/2015 11:00:00 AM,48,-122,2,2,4
10452,58thStGreenway22ndAve,04/09/2015 12:00:00 PM,48,-122,3,4,7
10453,58thStGreenway22ndAve,04/09/2015 01:00:00 PM,48,-122,5,5,10
10454,58thStGreenway22ndAve,04/09/2015 02:00:00 PM,48,-122,8,1,9
10455,58thStGreenway22ndAve,04/09/2015 03:00:00 PM,48,-122,3,9,12
10456,58thStGreenway22ndAve,04/09/2015 04:00:00 PM,48,-122,5,9,14
10457,58thStGreenway22ndAve,04/09/2015 05:00:00 PM,48,-122,17,10,27
10458,58thStGreenway22ndAve,04/09/2015 06:00:00 PM,48,-122,8,15,23
10459,58thStGreenway22ndAve,04/09/2015 07:00:00 PM,48,-122,11,0,11
10460,58thStGreenway22ndAve,04/09/2015 08:00:00 PM,48,-122,4,2,6
10461,58thStGreenway22ndAve,04/09/2015 09:00:00 PM,48,-122,4,0,4
10462,58thStGreenway22ndAve,04/09/2015 10:00:00 PM,48,-122,0,2,2
10463,58thStGreenway22ndAve,04/09/2015 11:00:00 PM,48,-122,2,0,2
10464,58thStGreenway22ndAve,04/10/2015 12:00:00 AM,48,-122,0,0,0
10465,58thStGreenway22ndAve,04/10/2015 01:00:00 AM,48,-122,0,0,0
10466,58thStGreenway22ndAve,04/10/2015 02:00:00 AM,48,-122,2,0,2
10467,58thStGreenway22ndAve,04/10/2015 03:00:00 AM,48,-122,0,0,0
10468,58thStGreenway22ndAve,04/10/2015 04:00:00 AM,48,-122,0,0,0
10469,58thStGreenway22ndAve,04/10/2015 05:00:00 AM,48,-122,0,1,1
10470,58thStGreenway22ndAve,04/10/2015 06:00:00 AM,48,-122,0,1,1
10471,58thStGreenway22ndAve,04/10/2015 07:00:00 AM,48,-122,8,1,9
10472,58thStGreenway22ndAve,04/10/2015 08:00:00 AM,48,-122,0,6,6
10473,58thStGreenway22ndAve,04/10/2015 09:00:00 AM,48,-122,6,6,12
10474,58thStGreenway22ndAve,04/10/2015 10:00:00 AM,48,-122,2,4,6
10475,58thStGreenway22ndAve,04/10/2015 11:00:00 AM,48,-122,3,10,13
10476,58thStGreenway22ndAve,04/10/2015 12:00:00 PM,48,-122,4,6,10
10477,58thStGreenway22ndAve,04/10/2015 01:00:00 PM,48,-122,4,1,5
10478,58thStGreenway22ndAve,04/10/2015 02:00:00 PM,48,-122,5,4,9
10479,58thStGreenway22ndAve,04/10/2015 03:00:00 PM,48,-122,5,2,7
10480,58thStGreenway22ndAve,04/10/2015 04:00:00 PM,48,-122,5,1,6
10481,58thStGreenway22ndAve,04/10/2015 05:00:00 PM,48,-122,5,8,13
10482,58thStGreenway22ndAve,04/10/2015 06:00:00 PM,48,-122,2,3,5
10483,58thStGreenway22ndAve,04/10/2015 07:00:00 PM,48,-122,2,1,3
10484,58thStGreenway22ndAve,04/10/2015 08:00:00 PM,48,-122,1,0,1
10485,58thStGreenway22ndAve,04/10/2015 09:00:00 PM,48,-122,0,2,2
10486,58thStGreenway22ndAve,04/10/2015 10:00:00 PM,48,-122,0,0,0
10487,58thStGreenway22ndAve,04/10/2015 11:00:00 PM,48,-122,2,1,3
10488,58thStGreenway22ndAve,04/11/2015 12:00:00 AM,48,-122,0,0,0
10489,58thStGreenway22ndAve,04/11/2015 01:00:00 AM,48,-122,0,0,0
10490,58thStGreenway22ndAve,04/11/2015 02:00:00 AM,48,-122,0,0,0
10491,58thStGreenway22ndAve,04/11/2015 03:00:00 AM,48,-122,0,0,0
10492,58thStGreenway22ndAve,04/11/2015 04:00:00 AM,48,-122,0,0,0
10493,58thStGreenway22ndAve,04/11/2015 05:00:00 AM,48,-122,0,0,0
10494,58thStGreenway22ndAve,04/11/2015 06:00:00 AM,48,-122,0,0,0
10495,58thStGreenway22ndAve,04/11/2015 07:00:00 AM,48,-122,0,0,0
10496,58thStGreenway22ndAve,04/11/2015 08:00:00 AM,48,-122,0,0,0
10497,58thStGreenway22ndAve,04/11/2015 09:00:00 AM,48,-122,0,0,0
10498,58thStGreenway22ndAve,04/11/2015 10:00:00 AM,48,-122,0,0,0
10499,58thStGreenway22ndAve,04/11/2015 11:00:00 AM,48,-122,0,0,0
10500,58thStGreenway22ndAve,04/11/2015 12:00:00 PM,48,-122,0,0,0
10501,58thStGreenway22ndAve,04/11/2015 01:00:00 PM,48,-122,0,0,0
10502,58thStGreenway22ndAve,04/11/2015 02:00:00 PM,48,-122,0,0,0
10503,58thStGreenway22ndAve,04/11/2015 03:00:00 PM,48,-122,0,0,0
10504,58thStGreenway22ndAve,04/11/2015 04:00:00 PM,48,-122,0,0,0
10505,58thStGreenway22ndAve,04/11/2015 05:00:00 PM,48,-122,0,0,0
10506,58thStGreenway22ndAve,04/11/2015 06:00:00 PM,48,-122,0,0,0
10507,58thStGreenway22ndAve,04/11/2015 07:00:00 PM,48,-122,0,0,0
10508,58thStGreenway22ndAve,04/11/2015 08:00:00 PM,48,-122,0,0,0
10509,58thStGreenway22ndAve,04/11/2015 09:00:00 PM,48,-122,0,0,0
10510,58thStGreenway22ndAve,04/11/2015 10:00:00 PM,48,-122,0,0,0
10511,58thStGreenway22ndAve,04/11/2015 11:00:00 PM,48,-122,0,0,0
10512,58thStGreenway22ndAve,04/12/2015 12:00:00 AM,48,-122,0,0,0
10513,58thStGreenway22ndAve,04/12/2015 01:00:00 AM,48,-122,0,0,0
10514,58thStGreenway22ndAve,04/12/2015 02:00:00 AM,48,-122,0,0,0
10515,58thStGreenway22ndAve,04/12/2015 03:00:00 AM,48,-122,0,0,0
10516,58thStGreenway22ndAve,04/12/2015 04:00:00 AM,48,-122,0,0,0
10517,58thStGreenway22ndAve,04/12/2015 05:00:00 AM,48,-122,0,0,0
10518,58thStGreenway22ndAve,04/12/2015 06:00:00 AM,48,-122,0,0,0
10519,58thStGreenway22ndAve,04/12/2015 07:00:00 AM,48,-122,0,0,0
10520,58thStGreenway22ndAve,04/12/2015 08:00:00 AM,48,-122,0,0,0
10521,58thStGreenway22ndAve,04/12/2015 09:00:00 AM,48,-122,0,0,0
10522,58thStGreenway22ndAve,04/12/2015 10:00:00 AM,48,-122,0,0,0
10523,58thStGreenway22ndAve,04/12/2015 11:00:00 AM,48,-122,0,0,0
10524,58thStGreenway22ndAve,04/12/2015 12:00:00 PM,48,-122,0,0,0
10525,58thStGreenway22ndAve,04/12/2015 01:00:00 PM,48,-122,0,0,0
10526,58thStGreenway22ndAve,04/12/2015 02:00:00 PM,48,-122,0,0,0
10527,58thStGreenway22ndAve,04/12/2015 03:00:00 PM,48,-122,0,0,0
10528,58thStGreenway22ndAve,04/12/2015 04:00:00 PM,48,-122,0,0,0
10529,58thStGreenway22ndAve,04/12/2015 05:00:00 PM,48,-122,0,0,0
10530,58thStGreenway22ndAve,04/12/2015 06:00:00 PM,48,-122,0,0,0
10531,58thStGreenway22ndAve,04/12/2015 07:00:00 PM,48,-122,0,0,0
10532,58thStGreenway22ndAve,04/12/2015 08:00:00 PM,48,-122,0,0,0
10533,58thStGreenway22ndAve,04/12/2015 09:00:00 PM,48,-122,0,0,0
10534,58thStGreenway22ndAve,04/12/2015 10:00:00 PM,48,-122,0,0,0
10535,58thStGreenway22ndAve,04/12/2015 11:00:00 PM,48,-122,0,0,0
10536,58thStGreenway22ndAve,04/13/2015 12:00:00 AM,48,-122,0,0,0
10537,58thStGreenway22ndAve,04/13/2015 01:00:00 AM,48,-122,0,0,0
10538,58thStGreenway22ndAve,04/13/2015 02:00:00 AM,48,-122,0,0,0
10539,58thStGreenway22ndAve,04/13/2015 03:00:00 AM,48,-122,0,0,0
10540,58thStGreenway22ndAve,04/13/2015 04:00:00 AM,48,-122,0,0,0
10541,58thStGreenway22ndAve,04/13/2015 05:00:00 AM,48,-122,0,0,0
10542,58thStGreenway22ndAve,04/13/2015 06:00:00 AM,48,-122,0,0,0
10543,58thStGreenway22ndAve,04/13/2015 07:00:00 AM,48,-122,3,1,4
10544,58thStGreenway22ndAve,04/13/2015 08:00:00 AM,48,-122,3,3,6
10545,58thStGreenway22ndAve,04/13/2015 09:00:00 AM,48,-122,2,5,7
10546,58thStGreenway22ndAve,04/13/2015 10:00:00 AM,48,-122,0,1,1
10547,58thStGreenway22ndAve,04/13/2015 11:00:00 AM,48,-122,1,4,5
10548,58thStGreenway22ndAve,04/13/2015 12:00:00 PM,48,-122,4,2,6
10549,58thStGreenway22ndAve,04/13/2015 01:00:00 PM,48,-122,5,2,7
10550,58thStGreenway22ndAve,04/13/2015 02:00:00 PM,48,-122,4,2,6
10551,58thStGreenway22ndAve,04/13/2015 03:00:00 PM,48,-122,0,1,1
10552,58thStGreenway22ndAve,04/13/2015 04:00:00 PM,48,-122,3,0,3
10553,58thStGreenway22ndAve,04/13/2015 05:00:00 PM,48,-122,9,7,16
10554,58thStGreenway22ndAve,04/13/2015 06:00:00 PM,48,-122,1,3,4
10555,58thStGreenway22ndAve,04/13/2015 07:00:00 PM,48,-122,2,0,2
10556,58thStGreenway22ndAve,04/13/2015 08:00:00 PM,48,-122,0,0,0
10557,58thStGreenway22ndAve,04/13/2015 09:00:00 PM,48,-122,0,0,0
10558,58thStGreenway22ndAve,04/13/2015 10:00:00 PM,48,-122,0,0,0
10559,58thStGreenway22ndAve,04/13/2015 11:00:00 PM,48,-122,0,0,0
10560,58thStGreenway22ndAve,04/14/2015 12:00:00 AM,48,-122,0,0,0
10561,58thStGreenway22ndAve,04/14/2015 01:00:00 AM,48,-122,0,0,0
10562,58thStGreenway22ndAve,04/14/2015 02:00:00 AM,48,-122,0,0,0
10563,58thStGreenway22ndAve,04/14/2015 03:00:00 AM,48,-122,0,0,0
10564,58thStGreenway22ndAve,04/14/2015 04:00:00 AM,48,-122,0,0,0
10565,58thStGreenway22ndAve,04/14/2015 05:00:00 AM,48,-122,0,0,0
10566,58thStGreenway22ndAve,04/14/2015 06:00:00 AM,48,-122,0,0,0
10567,58thStGreenway22ndAve,04/14/2015 07:00:00 AM,48,-122,1,1,2
10568,58thStGreenway22ndAve,04/14/2015 08:00:00 AM,48,-122,4,6,10
10569,58thStGreenway22ndAve,04/14/2015 09:00:00 AM,48,-122,3,3,6
10570,58thStGreenway22ndAve,04/14/2015 10:00:00 AM,48,-122,0,2,2
10571,58thStGreenway22ndAve,04/14/2015 11:00:00 AM,48,-122,4,8,12
10572,58thStGreenway22ndAve,04/14/2015 12:00:00 PM,48,-122,7,6,13
10573,58thStGreenway22ndAve,04/14/2015 01:00:00 PM,48,-122,4,1,5
10574,58thStGreenway22ndAve,04/14/2015 02:00:00 PM,48,-122,6,5,11
10575,58thStGreenway22ndAve,04/14/2015 03:00:00 PM,48,-122,2,5,7
10576,58thStGreenway22ndAve,04/14/2015 04:00:00 PM,48,-122,1,1,2
10577,58thStGreenway22ndAve,04/14/2015 05:00:00 PM,48,-122,12,5,17
10578,58thStGreenway22ndAve,04/14/2015 06:00:00 PM,48,-122,4,7,11
10579,58thStGreenway22ndAve,04/14/2015 07:00:00 PM,48,-122,2,3,5
10580,58thStGreenway22ndAve,04/14/2015 08:00:00 PM,48,-122,3,1,4
10581,58thStGreenway22ndAve,04/14/2015 09:00:00 PM,48,-122,5,1,6
10582,58thStGreenway22ndAve,04/14/2015 10:00:00 PM,48,-122,1,0,1
10583,58thStGreenway22ndAve,04/14/2015 11:00:00 PM,48,-122,2,0,2
10584,58thStGreenway22ndAve,04/15/2015 12:00:00 AM,48,-122,0,0,0
10585,58thStGreenway22ndAve,04/15/2015 01:00:00 AM,48,-122,1,0,1
10586,58thStGreenway22ndAve,04/15/2015 02:00:00 AM,48,-122,0,0,0
10587,58thStGreenway22ndAve,04/15/2015 03:00:00 AM,48,-122,0,0,0
10588,58thStGreenway22ndAve,04/15/2015 04:00:00 AM,48,-122,0,0,0
10589,58thStGreenway22ndAve,04/15/2015 05:00:00 AM,48,-122,0,0,0
10590,58thStGreenway22ndAve,04/15/2015 06:00:00 AM,48,-122,0,1,1
10591,58thStGreenway22ndAve,04/15/2015 07:00:00 AM,48,-122,4,2,6
10592,58thStGreenway22ndAve,04/15/2015 08:00:00 AM,48,-122,5,5,10
10593,58thStGreenway22ndAve,04/15/2015 09:00:00 AM,48,-122,3,4,7
10594,58thStGreenway22ndAve,04/15/2015 10:00:00 AM,48,-122,2,0,2
10595,58thStGreenway22ndAve,04/15/2015 11:00:00 AM,48,-122,5,5,10
10596,58thStGreenway22ndAve,04/15/2015 12:00:00 PM,48,-122,5,2,7
10597,58thStGreenway22ndAve,04/15/2015 01:00:00 PM,48,-122,6,7,13
10598,58thStGreenway22ndAve,04/15/2015 02:00:00 PM,48,-122,2,1,3
10599,58thStGreenway22ndAve,04/15/2015 03:00:00 PM,48,-122,2,4,6
10600,58thStGreenway22ndAve,04/15/2015 04:00:00 PM,48,-122,10,4,14
10601,58thStGreenway22ndAve,04/15/2015 05:00:00 PM,48,-122,3,3,6
10602,58thStGreenway22ndAve,04/15/2015 06:00:00 PM,48,-122,0,0,0
10603,58thStGreenway22ndAve,04/15/2015 07:00:00 PM,48,-122,0,0,0
10604,58thStGreenway22ndAve,04/15/2015 08:00:00 PM,48,-122,0,0,0
10605,58thStGreenway22ndAve,04/15/2015 09:00:00 PM,48,-122,0,0,0
10606,58thStGreenway22ndAve,04/15/2015 10:00:00 PM,48,-122,0,0,0
10607,58thStGreenway22ndAve,04/15/2015 11:00:00 PM,48,-122,0,0,0
10608,58thStGreenway22ndAve,04/16/2015 12:00:00 AM,48,-122,0,0,0
10609,58thStGreenway22ndAve,04/16/2015 01:00:00 AM,48,-122,0,0,0
10610,58thStGreenway22ndAve,04/16/2015 02:00:00 AM,48,-122,0,0,0
10611,58thStGreenway22ndAve,04/16/2015 03:00:00 AM,48,-122,0,0,0
10612,58thStGreenway22ndAve,04/16/2015 04:00:00 AM,48,-122,0,0,0
10613,58thStGreenway22ndAve,04/16/2015 05:00:00 AM,48,-122,0,0,0
10614,58thStGreenway22ndAve,04/16/2015 06:00:00 AM,48,-122,0,0,0
10615,58thStGreenway22ndAve,04/16/2015 07:00:00 AM,48,-122,3,2,5
10616,58thStGreenway22ndAve,04/16/2015 08:00:00 AM,48,-122,1,3,4
10617,58thStGreenway22ndAve,04/16/2015 09:00:00 AM,48,-122,6,12,18
10618,58thStGreenway22ndAve,04/16/2015 10:00:00 AM,48,-122,4,3,7
10619,58thStGreenway22ndAve,04/16/2015 11:00:00 AM,48,-122,4,3,7
10620,58thStGreenway22ndAve,04/16/2015 12:00:00 PM,48,-122,4,3,7
10621,58thStGreenway22ndAve,04/16/2015 01:00:00 PM,48,-122,12,8,20
10622,58thStGreenway22ndAve,04/16/2015 02:00:00 PM,48,-122,2,5,7
10623,58thStGreenway22ndAve,04/16/2015 03:00:00 PM,48,-122,5,4,9
10624,58thStGreenway22ndAve,04/16/2015 04:00:00 PM,48,-122,8,4,12
10625,58thStGreenway22ndAve,04/16/2015 05:00:00 PM,48,-122,8,6,14
10626,58thStGreenway22ndAve,04/16/2015 06:00:00 PM,48,-122,10,7,17
10627,58thStGreenway22ndAve,04/16/2015 07:00:00 PM,48,-122,3,7,10
10628,58thStGreenway22ndAve,04/16/2015 08:00:00 PM,48,-122,1,2,3
10629,58thStGreenway22ndAve,04/16/2015 09:00:00 PM,48,-122,0,1,1
10630,58thStGreenway22ndAve,04/16/2015 10:00:00 PM,48,-122,2,0,2
10631,58thStGreenway22ndAve,04/16/2015 11:00:00 PM,48,-122,3,0,3
10632,58thStGreenway22ndAve,04/17/2015 12:00:00 AM,48,-122,1,3,4
10633,58thStGreenway22ndAve,04/17/2015 01:00:00 AM,48,-122,0,0,0
10634,58thStGreenway22ndAve,04/17/2015 02:00:00 AM,48,-122,0,1,1
10635,58thStGreenway22ndAve,04/17/2015 03:00:00 AM,48,-122,0,0,0
10636,58thStGreenway22ndAve,04/17/2015 04:00:00 AM,48,-122,0,0,0
10637,58thStGreenway22ndAve,04/17/2015 05:00:00 AM,48,-122,0,1,1
10638,58thStGreenway22ndAve,04/17/2015 06:00:00 AM,48,-122,2,0,2
10639,58thStGreenway22ndAve,04/17/2015 07:00:00 AM,48,-122,3,4,7
10640,58thStGreenway22ndAve,04/17/2015 08:00:00 AM,48,-122,1,2,3
10641,58thStGreenway22ndAve,04/17/2015 09:00:00 AM,48,-122,1,4,5
10642,58thStGreenway22ndAve,04/17/2015 10:00:00 AM,48,-122,0,2,2
10643,58thStGreenway22ndAve,04/17/2015 11:00:00 AM,48,-122,6,7,13
10644,58thStGreenway22ndAve,04/17/2015 12:00:00 PM,48,-122,10,8,18
10645,58thStGreenway22ndAve,04/17/2015 01:00:00 PM,48,-122,1,5,6
10646,58thStGreenway22ndAve,04/17/2015 02:00:00 PM,48,-122,8,5,13
10647,58thStGreenway22ndAve,04/17/2015 03:00:00 PM,48,-122,4,1,5
10648,58thStGreenway22ndAve,04/17/2015 04:00:00 PM,48,-122,5,10,15
10649,58thStGreenway22ndAve,04/17/2015 05:00:00 PM,48,-122,10,2,12
10650,58thStGreenway22ndAve,04/17/2015 06:00:00 PM,48,-122,3,9,12
10651,58thStGreenway22ndAve,04/17/2015 07:00:00 PM,48,-122,6,7,13
10652,58thStGreenway22ndAve,04/17/2015 08:00:00 PM,48,-122,0,0,0
10653,58thStGreenway22ndAve,04/17/2015 09:00:00 PM,48,-122,0,2,2
10654,58thStGreenway22ndAve,04/17/2015 10:00:00 PM,48,-122,1,1,2
10655,58thStGreenway22ndAve,04/17/2015 11:00:00 PM,48,-122,0,1,1
10656,58thStGreenway22ndAve,04/18/2015 12:00:00 AM,48,-122,2,1,3
10657,58thStGreenway22ndAve,04/18/2015 01:00:00 AM,48,-122,1,1,2
10658,58thStGreenway22ndAve,04/18/2015 02:00:00 AM,48,-122,0,1,1
10659,58thStGreenway22ndAve,04/18/2015 03:00:00 AM,48,-122,0,0,0
10660,58thStGreenway22ndAve,04/18/2015 04:00:00 AM,48,-122,1,1,2
10661,58thStGreenway22ndAve,04/18/2015 05:00:00 AM,48,-122,0,0,0
10662,58thStGreenway22ndAve,04/18/2015 06:00:00 AM,48,-122,0,0,0
10663,58thStGreenway22ndAve,04/18/2015 07:00:00 AM,48,-122,1,0,1
10664,58thStGreenway22ndAve,04/18/2015 08:00:00 AM,48,-122,1,1,2
10665,58thStGreenway22ndAve,04/18/2015 09:00:00 AM,48,-122,3,5,8
10666,58thStGreenway22ndAve,04/18/2015 10:00:00 AM,48,-122,2,6,8
10667,58thStGreenway22ndAve,04/18/2015 11:00:00 AM,48,-122,6,15,21
10668,58thStGreenway22ndAve,04/18/2015 12:00:00 PM,48,-122,6,13,19
10669,58thStGreenway22ndAve,04/18/2015 01:00:00 PM,48,-122,4,11,15
10670,58thStGreenway22ndAve,04/18/2015 02:00:00 PM,48,-122,12,3,15
10671,58thStGreenway22ndAve,04/18/2015 03:00:00 PM,48,-122,3,10,13
10672,58thStGreenway22ndAve,04/18/2015 04:00:00 PM,48,-122,14,8,22
10673,58thStGreenway22ndAve,04/18/2015 05:00:00 PM,48,-122,9,1,10
10674,58thStGreenway22ndAve,04/18/2015 06:00:00 PM,48,-122,0,0,0
10675,58thStGreenway22ndAve,04/18/2015 07:00:00 PM,48,-122,0,0,0
10676,58thStGreenway22ndAve,04/18/2015 08:00:00 PM,48,-122,0,0,0
10677,58thStGreenway22ndAve,04/18/2015 09:00:00 PM,48,-122,0,0,0
10678,58thStGreenway22ndAve,04/18/2015 10:00:00 PM,48,-122,0,0,0
10679,58thStGreenway22ndAve,04/18/2015 11:00:00 PM,48,-122,0,0,0
10680,58thStGreenway22ndAve,04/19/2015 12:00:00 AM,48,-122,0,0,0
10681,58thStGreenway22ndAve,04/19/2015 01:00:00 AM,48,-122,0,0,0
10682,58thStGreenway22ndAve,04/19/2015 02:00:00 AM,48,-122,0,0,0
10683,58thStGreenway22ndAve,04/19/2015 03:00:00 AM,48,-122,0,0,0
10684,58thStGreenway22ndAve,04/19/2015 04:00:00 AM,48,-122,0,0,0
10685,58thStGreenway22ndAve,04/19/2015 05:00:00 AM,48,-122,0,0,0
10686,58thStGreenway22ndAve,04/19/2015 06:00:00 AM,48,-122,0,0,0
10687,58thStGreenway22ndAve,04/19/2015 07:00:00 AM,48,-122,0,1,1
10688,58thStGreenway22ndAve,04/19/2015 08:00:00 AM,48,-122,1,2,3
10689,58thStGreenway22ndAve,04/19/2015 09:00:00 AM,48,-122,3,5,8
10690,58thStGreenway22ndAve,04/19/2015 10:00:00 AM,48,-122,7,4,11
10691,58thStGreenway22ndAve,04/19/2015 11:00:00 AM,48,-122,4,18,22
10692,58thStGreenway22ndAve,04/19/2015 12:00:00 PM,48,-122,4,10,14
10693,58thStGreenway22ndAve,04/19/2015 01:00:00 PM,48,-122,0,0,0
10694,58thStGreenway22ndAve,04/19/2015 02:00:00 PM,48,-122,6,8,14
10695,58thStGreenway22ndAve,04/19/2015 03:00:00 PM,48,-122,8,9,17
10696,58thStGreenway22ndAve,04/19/2015 04:00:00 PM,48,-122,13,7,20
10697,58thStGreenway22ndAve,04/19/2015 05:00:00 PM,48,-122,5,7,12
10698,58thStGreenway22ndAve,04/19/2015 06:00:00 PM,48,-122,4,6,10
10699,58thStGreenway22ndAve,04/19/2015 07:00:00 PM,48,-122,10,8,18
10700,58thStGreenway22ndAve,04/19/2015 08:00:00 PM,48,-122,0,2,2
10701,58thStGreenway22ndAve,04/19/2015 09:00:00 PM,48,-122,0,0,0
10702,58thStGreenway22ndAve,04/19/2015 10:00:00 PM,48,-122,0,0,0
10703,58thStGreenway22ndAve,04/19/2015 11:00:00 PM,48,-122,0,0,0
10704,58thStGreenway22ndAve,04/20/2015 12:00:00 AM,48,-122,0,0,0
10705,58thStGreenway22ndAve,04/20/2015 01:00:00 AM,48,-122,0,4,4
10706,58thStGreenway22ndAve,04/20/2015 02:00:00 AM,48,-122,0,0,0
10707,58thStGreenway22ndAve,04/20/2015 03:00:00 AM,48,-122,0,0,0
10708,58thStGreenway22ndAve,04/20/2015 04:00:00 AM,48,-122,0,0,0
10709,58thStGreenway22ndAve,04/20/2015 05:00:00 AM,48,-122,0,0,0
10710,58thStGreenway22ndAve,04/20/2015 06:00:00 AM,48,-122,1,1,2
10711,58thStGreenway22ndAve,04/20/2015 07:00:00 AM,48,-122,0,6,6
10712,58thStGreenway22ndAve,04/20/2015 08:00:00 AM,48,-122,4,8,12
10713,58thStGreenway22ndAve,04/20/2015 09:00:00 AM,48,-122,3,5,8
10714,58thStGreenway22ndAve,04/20/2015 10:00:00 AM,48,-122,4,1,5
10715,58thStGreenway22ndAve,04/20/2015 11:00:00 AM,48,-122,4,3,7
10716,58thStGreenway22ndAve,04/20/2015 12:00:00 PM,48,-122,8,3,11
10717,58thStGreenway22ndAve,04/20/2015 01:00:00 PM,48,-122,10,5,15
10718,58thStGreenway22ndAve,04/20/2015 02:00:00 PM,48,-122,6,15,21
10719,58thStGreenway22ndAve,04/20/2015 03:00:00 PM,48,-122,7,5,12
10720,58thStGreenway22ndAve,04/20/2015 04:00:00 PM,48,-122,10,7,17
10721,58thStGreenway22ndAve,04/20/2015 05:00:00 PM,48,-122,9,13,22
10722,58thStGreenway22ndAve,04/20/2015 06:00:00 PM,48,-122,9,5,14
10723,58thStGreenway22ndAve,04/20/2015 07:00:00 PM,48,-122,5,7,12
10724,58thStGreenway22ndAve,04/20/2015 08:00:00 PM,48,-122,4,3,7
10725,58thStGreenway22ndAve,04/20/2015 09:00:00 PM,48,-122,2,3,5
10726,58thStGreenway22ndAve,04/20/2015 10:00:00 PM,48,-122,2,1,3
10727,58thStGreenway22ndAve,04/20/2015 11:00:00 PM,48,-122,0,0,0
10728,58thStGreenway22ndAve,04/21/2015 12:00:00 AM,48,-122,2,0,2
10729,58thStGreenway22ndAve,04/21/2015 01:00:00 AM,48,-122,0,0,0
10730,58thStGreenway22ndAve,04/21/2015 02:00:00 AM,48,-122,0,0,0
10731,58thStGreenway22ndAve,04/21/2015 03:00:00 AM,48,-122,0,0,0
10732,58thStGreenway22ndAve,04/21/2015 04:00:00 AM,48,-122,0,1,1
10733,58thStGreenway22ndAve,04/21/2015 05:00:00 AM,48,-122,0,0,0
10734,58thStGreenway22ndAve,04/21/2015 06:00:00 AM,48,-122,1,0,1
10735,58thStGreenway22ndAve,04/21/2015 07:00:00 AM,48,-122,7,1,8
10736,58thStGreenway22ndAve,04/21/2015 08:00:00 AM,48,-122,3,6,9
10737,58thStGreenway22ndAve,04/21/2015 09:00:00 AM,48,-122,4,9,13
10738,58thStGreenway22ndAve,04/21/2015 10:00:00 AM,48,-122,6,1,7
10739,58thStGreenway22ndAve,04/21/2015 11:00:00 AM,48,-122,3,8,11
10740,58thStGreenway22ndAve,04/21/2015 12:00:00 PM,48,-122,5,1,6
10741,58thStGreenway22ndAve,04/21/2015 01:00:00 PM,48,-122,9,9,18
10742,58thStGreenway22ndAve,04/21/2015 02:00:00 PM,48,-122,0,3,3
10743,58thStGreenway22ndAve,04/21/2015 03:00:00 PM,48,-122,7,5,12
10744,58thStGreenway22ndAve,04/21/2015 04:00:00 PM,48,-122,11,6,17
10745,58thStGreenway22ndAve,04/21/2015 05:00:00 PM,48,-122,4,5,9
10746,58thStGreenway22ndAve,04/21/2015 06:00:00 PM,48,-122,1,7,8
10747,58thStGreenway22ndAve,04/21/2015 07:00:00 PM,48,-122,2,1,3
10748,58thStGreenway22ndAve,04/21/2015 08:00:00 PM,48,-122,3,0,3
10749,58thStGreenway22ndAve,04/21/2015 09:00:00 PM,48,-122,5,1,6
10750,58thStGreenway22ndAve,04/21/2015 10:00:00 PM,48,-122,2,2,4
10751,58thStGreenway22ndAve,04/21/2015 11:00:00 PM,48,-122,0,0,0
10752,58thStGreenway22ndAve,04/22/2015 12:00:00 AM,48,-122,0,1,1
10753,58thStGreenway22ndAve,04/22/2015 01:00:00 AM,48,-122,0,0,0
10754,58thStGreenway22ndAve,04/22/2015 02:00:00 AM,48,-122,2,0,2
10755,58thStGreenway22ndAve,04/22/2015 03:00:00 AM,48,-122,0,0,0
10756,58thStGreenway22ndAve,04/22/2015 04:00:00 AM,48,-122,0,0,0
10757,58thStGreenway22ndAve,04/22/2015 05:00:00 AM,48,-122,0,0,0
10758,58thStGreenway22ndAve,04/22/2015 06:00:00 AM,48,-122,0,1,1
10759,58thStGreenway22ndAve,04/22/2015 07:00:00 AM,48,-122,2,2,4
10760,58thStGreenway22ndAve,04/22/2015 08:00:00 AM,48,-122,2,5,7
10761,58thStGreenway22ndAve,04/22/2015 09:00:00 AM,48,-122,8,11,19
10762,58thStGreenway22ndAve,04/22/2015 10:00:00 AM,48,-122,5,4,9
10763,58thStGreenway22ndAve,04/22/2015 11:00:00 AM,48,-122,3,4,7
10764,58thStGreenway22ndAve,04/22/2015 12:00:00 PM,48,-122,8,3,11
10765,58thStGreenway22ndAve,04/22/2015 01:00:00 PM,48,-122,4,4,8
10766,58thStGreenway22ndAve,04/22/2015 02:00:00 PM,48,-122,3,3,6
10767,58thStGreenway22ndAve,04/22/2015 03:00:00 PM,48,-122,4,1,5
10768,58thStGreenway22ndAve,04/22/2015 04:00:00 PM,48,-122,9,7,16
10769,58thStGreenway22ndAve,04/22/2015 05:00:00 PM,48,-122,3,10,13
10770,58thStGreenway22ndAve,04/22/2015 06:00:00 PM,48,-122,8,8,16
10771,58thStGreenway22ndAve,04/22/2015 07:00:00 PM,48,-122,0,1,1
10772,58thStGreenway22ndAve,04/22/2015 08:00:00 PM,48,-122,4,3,7
10773,58thStGreenway22ndAve,04/22/2015 09:00:00 PM,48,-122,0,0,0
10774,58thStGreenway22ndAve,04/22/2015 10:00:00 PM,48,-122,1,1,2
10775,58thStGreenway22ndAve,04/22/2015 11:00:00 PM,48,-122,0,0,0
10776,58thStGreenway22ndAve,04/23/2015 12:00:00 AM,48,-122,1,1,2
10777,58thStGreenway22ndAve,04/23/2015 01:00:00 AM,48,-122,0,0,0
10778,58thStGreenway22ndAve,04/23/2015 02:00:00 AM,48,-122,0,0,0
10779,58thStGreenway22ndAve,04/23/2015 03:00:00 AM,48,-122,0,0,0
10780,58thStGreenway22ndAve,04/23/2015 04:00:00 AM,48,-122,0,0,0
10781,58thStGreenway22ndAve,04/23/2015 05:00:00 AM,48,-122,0,1,1
10782,58thStGreenway22ndAve,04/23/2015 06:00:00 AM,48,-122,0,2,2
10783,58thStGreenway22ndAve,04/23/2015 07:00:00 AM,48,-122,4,0,4
10784,58thStGreenway22ndAve,04/23/2015 08:00:00 AM,48,-122,3,8,11
10785,58thStGreenway22ndAve,04/23/2015 09:00:00 AM,48,-122,1,2,3
10786,58thStGreenway22ndAve,04/23/2015 10:00:00 AM,48,-122,3,3,6
10787,58thStGreenway22ndAve,04/23/2015 11:00:00 AM,48,-122,3,4,7
10788,58thStGreenway22ndAve,04/23/2015 12:00:00 PM,48,-122,6,3,9
10789,58thStGreenway22ndAve,04/23/2015 01:00:00 PM,48,-122,1,2,3
10790,58thStGreenway22ndAve,04/23/2015 02:00:00 PM,48,-122,1,2,3
10791,58thStGreenway22ndAve,04/23/2015 03:00:00 PM,48,-122,5,4,9
10792,58thStGreenway22ndAve,04/23/2015 04:00:00 PM,48,-122,2,0,2
10793,58thStGreenway22ndAve,04/23/2015 05:00:00 PM,48,-122,1,6,7
10794,58thStGreenway22ndAve,04/23/2015 06:00:00 PM,48,-122,8,4,12
10795,58thStGreenway22ndAve,04/23/2015 07:00:00 PM,48,-122,1,5,6
10796,58thStGreenway22ndAve,04/23/2015 08:00:00 PM,48,-122,2,2,4
10797,58thStGreenway22ndAve,04/23/2015 09:00:00 PM,48,-122,1,0,1
10798,58thStGreenway22ndAve,04/23/2015 10:00:00 PM,48,-122,0,0,0
10799,58thStGreenway22ndAve,04/23/2015 11:00:00 PM,48,-122,1,0,1
10800,58thStGreenway22ndAve,04/24/2015 12:00:00 AM,48,-122,0,0,0
10801,58thStGreenway22ndAve,04/24/2015 01:00:00 AM,48,-122,0,0,0
10802,58thStGreenway22ndAve,04/24/2015 02:00:00 AM,48,-122,0,0,0
10803,58thStGreenway22ndAve,04/24/2015 03:00:00 AM,48,-122,0,0,0
10804,58thStGreenway22ndAve,04/24/2015 04:00:00 AM,48,-122,0,0,0
10805,58thStGreenway22ndAve,04/24/2015 05:00:00 AM,48,-122,1,0,1
10806,58thStGreenway22ndAve,04/24/2015 06:00:00 AM,48,-122,0,4,4
10807,58thStGreenway22ndAve,04/24/2015 07:00:00 AM,48,-122,2,0,2
10808,58thStGreenway22ndAve,04/24/2015 08:00:00 AM,48,-122,0,6,6
10809,58thStGreenway22ndAve,04/24/2015 09:00:00 AM,48,-122,2,10,12
10810,58thStGreenway22ndAve,04/24/2015 10:00:00 AM,48,-122,0,4,4
10811,58thStGreenway22ndAve,04/24/2015 11:00:00 AM,48,-122,2,0,2
10812,58thStGreenway22ndAve,04/24/2015 12:00:00 PM,48,-122,4,3,7
10813,58thStGreenway22ndAve,04/24/2015 01:00:00 PM,48,-122,5,3,8
10814,58thStGreenway22ndAve,04/24/2015 02:00:00 PM,48,-122,4,3,7
10815,58thStGreenway22ndAve,04/24/2015 03:00:00 PM,48,-122,1,0,1
10816,58thStGreenway22ndAve,04/24/2015 04:00:00 PM,48,-122,2,7,9
10817,58thStGreenway22ndAve,04/24/2015 05:00:00 PM,48,-122,1,2,3
10818,58thStGreenway22ndAve,04/24/2015 06:00:00 PM,48,-122,14,1,15
10819,58thStGreenway22ndAve,04/24/2015 07:00:00 PM,48,-122,0,0,0
10820,58thStGreenway22ndAve,04/24/2015 08:00:00 PM,48,-122,0,0,0
10821,58thStGreenway22ndAve,04/24/2015 09:00:00 PM,48,-122,0,0,0
10822,58thStGreenway22ndAve,04/24/2015 10:00:00 PM,48,-122,0,0,0
10823,58thStGreenway22ndAve,04/24/2015 11:00:00 PM,48,-122,0,0,0
10824,58thStGreenway22ndAve,04/25/2015 12:00:00 AM,48,-122,0,0,0
10825,58thStGreenway22ndAve,04/25/2015 01:00:00 AM,48,-122,0,0,0
10826,58thStGreenway22ndAve,04/25/2015 02:00:00 AM,48,-122,0,0,0
10827,58thStGreenway22ndAve,04/25/2015 03:00:00 AM,48,-122,0,0,0
10828,58thStGreenway22ndAve,04/25/2015 04:00:00 AM,48,-122,0,0,0
10829,58thStGreenway22ndAve,04/25/2015 05:00:00 AM,48,-122,0,0,0
10830,58thStGreenway22ndAve,04/25/2015 06:00:00 AM,48,-122,0,0,0
10831,58thStGreenway22ndAve,04/25/2015 07:00:00 AM,48,-122,0,0,0
10832,58thStGreenway22ndAve,04/25/2015 08:00:00 AM,48,-122,0,0,0
10833,58thStGreenway22ndAve,04/25/2015 09:00:00 AM,48,-122,0,0,0
10834,58thStGreenway22ndAve,04/25/2015 10:00:00 AM,48,-122,0,0,0
10835,58thStGreenway22ndAve,04/25/2015 11:00:00 AM,48,-122,0,4,4
10836,58thStGreenway22ndAve,04/25/2015 12:00:00 PM,48,-122,3,12,15
10837,58thStGreenway22ndAve,04/25/2015 01:00:00 PM,48,-122,11,4,15
10838,58thStGreenway22ndAve,04/25/2015 02:00:00 PM,48,-122,3,7,10
10839,58thStGreenway22ndAve,04/25/2015 03:00:00 PM,48,-122,3,5,8
10840,58thStGreenway22ndAve,04/25/2015 04:00:00 PM,48,-122,4,3,7
10841,58thStGreenway22ndAve,04/25/2015 05:00:00 PM,48,-122,5,8,13
10842,58thStGreenway22ndAve,04/25/2015 06:00:00 PM,48,-122,3,4,7
10843,58thStGreenway22ndAve,04/25/2015 07:00:00 PM,48,-122,3,6,9
10844,58thStGreenway22ndAve,04/25/2015 08:00:00 PM,48,-122,2,1,3
10845,58thStGreenway22ndAve,04/25/2015 09:00:00 PM,48,-122,2,0,2
10846,58thStGreenway22ndAve,04/25/2015 10:00:00 PM,48,-122,1,0,1
10847,58thStGreenway22ndAve,04/25/2015 11:00:00 PM,48,-122,3,0,3
10848,58thStGreenway22ndAve,04/26/2015 12:00:00 AM,48,-122,3,2,5
10849,58thStGreenway22ndAve,04/26/2015 01:00:00 AM,48,-122,1,1,2
10850,58thStGreenway22ndAve,04/26/2015 02:00:00 AM,48,-122,0,1,1
10851,58thStGreenway22ndAve,04/26/2015 03:00:00 AM,48,-122,0,0,0
10852,58thStGreenway22ndAve,04/26/2015 04:00:00 AM,48,-122,0,0,0
10853,58thStGreenway22ndAve,04/26/2015 05:00:00 AM,48,-122,0,0,0
10854,58thStGreenway22ndAve,04/26/2015 06:00:00 AM,48,-122,0,0,0
10855,58thStGreenway22ndAve,04/26/2015 07:00:00 AM,48,-122,0,1,1
10856,58thStGreenway22ndAve,04/26/2015 08:00:00 AM,48,-122,0,1,1
10857,58thStGreenway22ndAve,04/26/2015 09:00:00 AM,48,-122,5,2,7
10858,58thStGreenway22ndAve,04/26/2015 10:00:00 AM,48,-122,5,6,11
10859,58thStGreenway22ndAve,04/26/2015 11:00:00 AM,48,-122,4,8,12
10860,58thStGreenway22ndAve,04/26/2015 12:00:00 PM,48,-122,8,9,17
10861,58thStGreenway22ndAve,04/26/2015 01:00:00 PM,48,-122,4,8,12
10862,58thStGreenway22ndAve,04/26/2015 02:00:00 PM,48,-122,5,4,9
10863,58thStGreenway22ndAve,04/26/2015 03:00:00 PM,48,-122,6,12,18
10864,58thStGreenway22ndAve,04/26/2015 04:00:00 PM,48,-122,6,5,11
10865,58thStGreenway22ndAve,04/26/2015 05:00:00 PM,48,-122,3,6,9
10866,58thStGreenway22ndAve,04/26/2015 06:00:00 PM,48,-122,5,5,10
10867,58thStGreenway22ndAve,04/26/2015 07:00:00 PM,48,-122,4,7,11
10868,58thStGreenway22ndAve,04/26/2015 08:00:00 PM,48,-122,0,1,1
10869,58thStGreenway22ndAve,04/26/2015 09:00:00 PM,48,-122,1,3,4
10870,58thStGreenway22ndAve,04/26/2015 10:00:00 PM,48,-122,1,0,1
10871,58thStGreenway22ndAve,04/26/2015 11:00:00 PM,48,-122,0,0,0
10872,58thStGreenway22ndAve,04/27/2015 12:00:00 AM,48,-122,0,0,0
10873,58thStGreenway22ndAve,04/27/2015 01:00:00 AM,48,-122,0,0,0
10874,58thStGreenway22ndAve,04/27/2015 02:00:00 AM,48,-122,0,0,0
10875,58thStGreenway22ndAve,04/27/2015 03:00:00 AM,48,-122,0,0,0
10876,58thStGreenway22ndAve,04/27/2015 04:00:00 AM,48,-122,0,0,0
10877,58thStGreenway22ndAve,04/27/2015 05:00:00 AM,48,-122,1,2,3
10878,58thStGreenway22ndAve,04/27/2015 06:00:00 AM,48,-122,1,1,2
10879,58thStGreenway22ndAve,04/27/2015 07:00:00 AM,48,-122,2,4,6
10880,58thStGreenway22ndAve,04/27/2015 08:00:00 AM,48,-122,1,6,7
10881,58thStGreenway22ndAve,04/27/2015 09:00:00 AM,48,-122,3,5,8
10882,58thStGreenway22ndAve,04/27/2015 10:00:00 AM,48,-122,6,3,9
10883,58thStGreenway22ndAve,04/27/2015 11:00:00 AM,48,-122,2,2,4
10884,58thStGreenway22ndAve,04/27/2015 12:00:00 PM,48,-122,6,8,14
10885,58thStGreenway22ndAve,04/27/2015 01:00:00 PM,48,-122,9,5,14
10886,58thStGreenway22ndAve,04/27/2015 02:00:00 PM,48,-122,11,1,12
10887,58thStGreenway22ndAve,04/27/2015 03:00:00 PM,48,-122,2,8,10
10888,58thStGreenway22ndAve,04/27/2015 04:00:00 PM,48,-122,3,6,9
10889,58thStGreenway22ndAve,04/27/2015 05:00:00 PM,48,-122,11,8,19
10890,58thStGreenway22ndAve,04/27/2015 06:00:00 PM,48,-122,12,9,21
10891,58thStGreenway22ndAve,04/27/2015 07:00:00 PM,48,-122,14,5,19
10892,58thStGreenway22ndAve,04/27/2015 08:00:00 PM,48,-122,16,2,18
10893,58thStGreenway22ndAve,04/27/2015 09:00:00 PM,48,-122,3,0,3
10894,58thStGreenway22ndAve,04/27/2015 10:00:00 PM,48,-122,0,0,0
10895,58thStGreenway22ndAve,04/27/2015 11:00:00 PM,48,-122,0,0,0
10896,58thStGreenway22ndAve,04/28/2015 12:00:00 AM,48,-122,2,1,3
10897,58thStGreenway22ndAve,04/28/2015 01:00:00 AM,48,-122,0,0,0
10898,58thStGreenway22ndAve,04/28/2015 02:00:00 AM,48,-122,0,1,1
10899,58thStGreenway22ndAve,04/28/2015 03:00:00 AM,48,-122,0,0,0
10900,58thStGreenway22ndAve,04/28/2015 04:00:00 AM,48,-122,0,0,0
10901,58thStGreenway22ndAve,04/28/2015 05:00:00 AM,48,-122,0,1,1
10902,58thStGreenway22ndAve,04/28/2015 06:00:00 AM,48,-122,2,1,3
10903,58thStGreenway22ndAve,04/28/2015 07:00:00 AM,48,-122,6,0,6
10904,58thStGreenway22ndAve,04/28/2015 08:00:00 AM,48,-122,5,8,13
10905,58thStGreenway22ndAve,04/28/2015 09:00:00 AM,48,-122,4,7,11
10906,58thStGreenway22ndAve,04/28/2015 10:00:00 AM,48,-122,4,1,5
10907,58thStGreenway22ndAve,04/28/2015 11:00:00 AM,48,-122,0,6,6
10908,58thStGreenway22ndAve,04/28/2015 12:00:00 PM,48,-122,1,0,1
10909,58thStGreenway22ndAve,04/28/2015 01:00:00 PM,48,-122,5,5,10
10910,58thStGreenway22ndAve,04/28/2015 02:00:00 PM,48,-122,9,5,14
10911,58thStGreenway22ndAve,04/28/2015 03:00:00 PM,48,-122,7,1,8
10912,58thStGreenway22ndAve,04/28/2015 04:00:00 PM,48,-122,5,5,10
10913,58thStGreenway22ndAve,04/28/2015 05:00:00 PM,48,-122,9,3,12
10914,58thStGreenway22ndAve,04/28/2015 06:00:00 PM,48,-122,4,3,7
10915,58thStGreenway22ndAve,04/28/2015 07:00:00 PM,48,-122,5,1,6
10916,58thStGreenway22ndAve,04/28/2015 08:00:00 PM,48,-122,1,3,4
10917,58thStGreenway22ndAve,04/28/2015 09:00:00 PM,48,-122,5,0,5
10918,58thStGreenway22ndAve,04/28/2015 10:00:00 PM,48,-122,0,1,1
10919,58thStGreenway22ndAve,04/28/2015 11:00:00 PM,48,-122,0,0,0
10920,58thStGreenway22ndAve,04/29/2015 12:00:00 AM,48,-122,1,1,2
10921,58thStGreenway22ndAve,04/29/2015 01:00:00 AM,48,-122,0,0,0
10922,58thStGreenway22ndAve,04/29/2015 02:00:00 AM,48,-122,0,0,0
10923,58thStGreenway22ndAve,04/29/2015 03:00:00 AM,48,-122,0,0,0
10924,58thStGreenway22ndAve,04/29/2015 04:00:00 AM,48,-122,0,0,0
10925,58thStGreenway22ndAve,04/29/2015 05:00:00 AM,48,-122,0,1,1
10926,58thStGreenway22ndAve,04/29/2015 06:00:00 AM,48,-122,0,0,0
10927,58thStGreenway22ndAve,04/29/2015 07:00:00 AM,48,-122,5,2,7
10928,58thStGreenway22ndAve,04/29/2015 08:00:00 AM,48,-122,6,8,14
10929,58thStGreenway22ndAve,04/29/2015 09:00:00 AM,48,-122,4,9,13
10930,58thStGreenway22ndAve,04/29/2015 10:00:00 AM,48,-122,3,6,9
10931,58thStGreenway22ndAve,04/29/2015 11:00:00 AM,48,-122,5,8,13
10932,58thStGreenway22ndAve,04/29/2015 12:00:00 PM,48,-122,5,5,10
10933,58thStGreenway22ndAve,04/29/2015 01:00:00 PM,48,-122,8,6,14
10934,58thStGreenway22ndAve,04/29/2015 02:00:00 PM,48,-122,2,10,12
10935,58thStGreenway22ndAve,04/29/2015 03:00:00 PM,48,-122,7,1,8
10936,58thStGreenway22ndAve,04/29/2015 04:00:00 PM,48,-122,5,7,12
10937,58thStGreenway22ndAve,04/29/2015 05:00:00 PM,48,-122,4,8,12
10938,58thStGreenway22ndAve,04/29/2015 06:00:00 PM,48,-122,5,9,14
10939,58thStGreenway22ndAve,04/29/2015 07:00:00 PM,48,-122,8,11,19
10940,58thStGreenway22ndAve,04/29/2015 08:00:00 PM,48,-122,6,1,7
10941,58thStGreenway22ndAve,04/29/2015 09:00:00 PM,48,-122,5,3,8
10942,58thStGreenway22ndAve,04/29/2015 10:00:00 PM,48,-122,0,0,0
10943,58thStGreenway22ndAve,04/29/2015 11:00:00 PM,48,-122,0,1,1
10944,58thStGreenway22ndAve,04/30/2015 12:00:00 AM,48,-122,0,0,0
10945,58thStGreenway22ndAve,04/30/2015 01:00:00 AM,48,-122,0,0,0
10946,58thStGreenway22ndAve,04/30/2015 02:00:00 AM,48,-122,0,0,0
10947,58thStGreenway22ndAve,04/30/2015 03:00:00 AM,48,-122,0,0,0
10948,58thStGreenway22ndAve,04/30/2015 04:00:00 AM,48,-122,0,0,0
10949,58thStGreenway22ndAve,04/30/2015 05:00:00 AM,48,-122,0,1,1
10950,58thStGreenway22ndAve,04/30/2015 06:00:00 AM,48,-122,0,0,0
10951,58thStGreenway22ndAve,04/30/2015 07:00:00 AM,48,-122,5,0,5
10952,58thStGreenway22ndAve,04/30/2015 08:00:00 AM,48,-122,5,5,10
10953,58thStGreenway22ndAve,04/30/2015 09:00:00 AM,48,-122,2,1,3
10954,58thStGreenway22ndAve,04/30/2015 10:00:00 AM,48,-122,3,0,3
10955,58thStGreenway22ndAve,04/30/2015 11:00:00 AM,48,-122,3,7,10
10956,58thStGreenway22ndAve,04/30/2015 12:00:00 PM,48,-122,11,8,19
10957,58thStGreenway22ndAve,04/30/2015 01:00:00 PM,48,-122,5,3,8
10958,58thStGreenway22ndAve,04/30/2015 02:00:00 PM,48,-122,1,1,2
10959,58thStGreenway22ndAve,04/30/2015 03:00:00 PM,48,-122,3,6,9
10960,58thStGreenway22ndAve,04/30/2015 04:00:00 PM,48,-122,7,2,9
10961,58thStGreenway22ndAve,04/30/2015 05:00:00 PM,48,-122,9,13,22
10962,58thStGreenway22ndAve,04/30/2015 06:00:00 PM,48,-122,6,7,13
10963,58thStGreenway22ndAve,04/30/2015 07:00:00 PM,48,-122,2,5,7
10964,58thStGreenway22ndAve,04/30/2015 08:00:00 PM,48,-122,4,2,6
10965,58thStGreenway22ndAve,04/30/2015 09:00:00 PM,48,-122,4,0,4
10966,58thStGreenway22ndAve,04/30/2015 10:00:00 PM,48,-122,4,1,5
10967,58thStGreenway22ndAve,04/30/2015 11:00:00 PM,48,-122,0,0,0
10968,58thStGreenway22ndAve,05/01/2015 12:00:00 AM,48,-122,1,1,2
10969,58thStGreenway22ndAve,05/01/2015 01:00:00 AM,48,-122,0,1,1
10970,58thStGreenway22ndAve,05/01/2015 02:00:00 AM,48,-122,0,0,0
10971,58thStGreenway22ndAve,05/01/2015 03:00:00 AM,48,-122,0,1,1
10972,58thStGreenway22ndAve,05/01/2015 04:00:00 AM,48,-122,0,0,0
10973,58thStGreenway22ndAve,05/01/2015 05:00:00 AM,48,-122,0,0,0
10974,58thStGreenway22ndAve,05/01/2015 06:00:00 AM,48,-122,1,2,3
10975,58thStGreenway22ndAve,05/01/2015 07:00:00 AM,48,-122,9,3,12
10976,58thStGreenway22ndAve,05/01/2015 08:00:00 AM,48,-122,4,7,11
10977,58thStGreenway22ndAve,05/01/2015 09:00:00 AM,48,-122,8,3,11
10978,58thStGreenway22ndAve,05/01/2015 10:00:00 AM,48,-122,3,6,9
10979,58thStGreenway22ndAve,05/01/2015 11:00:00 AM,48,-122,2,5,7
10980,58thStGreenway22ndAve,05/01/2015 12:00:00 PM,48,-122,4,4,8
10981,58thStGreenway22ndAve,05/01/2015 01:00:00 PM,48,-122,5,2,7
10982,58thStGreenway22ndAve,05/01/2015 02:00:00 PM,48,-122,5,6,11
10983,58thStGreenway22ndAve,05/01/2015 03:00:00 PM,48,-122,6,16,22
10984,58thStGreenway22ndAve,05/01/2015 04:00:00 PM,48,-122,21,9,30
10985,58thStGreenway22ndAve,05/01/2015 05:00:00 PM,48,-122,9,12,21
10986,58thStGreenway22ndAve,05/01/2015 06:00:00 PM,48,-122,6,4,10
10987,58thStGreenway22ndAve,05/01/2015 07:00:00 PM,48,-122,7,4,11
10988,58thStGreenway22ndAve,05/01/2015 08:00:00 PM,48,-122,1,7,8
10989,58thStGreenway22ndAve,05/01/2015 09:00:00 PM,48,-122,3,1,4
10990,58thStGreenway22ndAve,05/01/2015 10:00:00 PM,48,-122,2,1,3
10991,58thStGreenway22ndAve,05/01/2015 11:00:00 PM,48,-122,2,0,2
10992,58thStGreenway22ndAve,05/02/2015 12:00:00 AM,48,-122,0,0,0
10993,58thStGreenway22ndAve,05/02/2015 01:00:00 AM,48,-122,1,0,1
10994,58thStGreenway22ndAve,05/02/2015 02:00:00 AM,48,-122,0,0,0
10995,58thStGreenway22ndAve,05/02/2015 03:00:00 AM,48,-122,0,0,0
10996,58thStGreenway22ndAve,05/02/2015 04:00:00 AM,48,-122,0,0,0
10997,58thStGreenway22ndAve,05/02/2015 05:00:00 AM,48,-122,0,0,0
10998,58thStGreenway22ndAve,05/02/2015 06:00:00 AM,48,-122,0,0,0
10999,58thStGreenway22ndAve,05/02/2015 07:00:00 AM,48,-122,0,0,0
11000,58thStGreenway22ndAve,05/02/2015 08:00:00 AM,48,-122,4,2,6
11001,58thStGreenway22ndAve,05/02/2015 09:00:00 AM,48,-122,4,4,8
11002,58thStGreenway22ndAve,05/02/2015 10:00:00 AM,48,-122,9,8,17
11003,58thStGreenway22ndAve,05/02/2015 11:00:00 AM,48,-122,13,8,21
11004,58thStGreenway22ndAve,05/02/2015 12:00:00 PM,48,-122,18,19,37
11005,58thStGreenway22ndAve,05/02/2015 01:00:00 PM,48,-122,10,10,20
11006,58thStGreenway22ndAve,05/02/2015 02:00:00 PM,48,-122,21,2,23
11007,58thStGreenway22ndAve,05/02/2015 03:00:00 PM,48,-122,9,10,19
11008,58thStGreenway22ndAve,05/02/2015 04:00:00 PM,48,-122,10,7,17
11009,58thStGreenway22ndAve,05/02/2015 05:00:00 PM,48,-122,11,3,14
11010,58thStGreenway22ndAve,05/02/2015 06:00:00 PM,48,-122,10,12,22
11011,58thStGreenway22ndAve,05/02/2015 07:00:00 PM,48,-122,2,7,9
11012,58thStGreenway22ndAve,05/02/2015 08:00:00 PM,48,-122,2,5,7
11013,58thStGreenway22ndAve,05/02/2015 09:00:00 PM,48,-122,3,2,5
11014,58thStGreenway22ndAve,05/02/2015 10:00:00 PM,48,-122,3,2,5
11015,58thStGreenway22ndAve,05/02/2015 11:00:00 PM,48,-122,2,2,4
11016,58thStGreenway22ndAve,05/03/2015 12:00:00 AM,48,-122,2,0,2
11017,58thStGreenway22ndAve,05/03/2015 01:00:00 AM,48,-122,1,1,2
11018,58thStGreenway22ndAve,05/03/2015 02:00:00 AM,48,-122,0,0,0
11019,58thStGreenway22ndAve,05/03/2015 03:00:00 AM,48,-122,0,0,0
11020,58thStGreenway22ndAve,05/03/2015 04:00:00 AM,48,-122,0,0,0
11021,58thStGreenway22ndAve,05/03/2015 05:00:00 AM,48,-122,0,0,0
11022,58thStGreenway22ndAve,05/03/2015 06:00:00 AM,48,-122,0,0,0
11023,58thStGreenway22ndAve,05/03/2015 07:00:00 AM,48,-122,0,0,0
11024,58thStGreenway22ndAve,05/03/2015 08:00:00 AM,48,-122,0,4,4
11025,58thStGreenway22ndAve,05/03/2015 09:00:00 AM,48,-122,4,3,7
11026,58thStGreenway22ndAve,05/03/2015 10:00:00 AM,48,-122,8,8,16
11027,58thStGreenway22ndAve,05/03/2015 11:00:00 AM,48,-122,5,7,12
11028,58thStGreenway22ndAve,05/03/2015 12:00:00 PM,48,-122,20,8,28
11029,58thStGreenway22ndAve,05/03/2015 01:00:00 PM,48,-122,0,0,0
11030,58thStGreenway22ndAve,05/03/2015 02:00:00 PM,48,-122,0,0,0
11031,58thStGreenway22ndAve,05/03/2015 03:00:00 PM,48,-122,14,9,23
11032,58thStGreenway22ndAve,05/03/2015 04:00:00 PM,48,-122,11,5,16
11033,58thStGreenway22ndAve,05/03/2015 05:00:00 PM,48,-122,17,5,22
11034,58thStGreenway22ndAve,05/03/2015 06:00:00 PM,48,-122,5,4,9
11035,58thStGreenway22ndAve,05/03/2015 07:00:00 PM,48,-122,4,2,6
11036,58thStGreenway22ndAve,05/03/2015 08:00:00 PM,48,-122,4,0,4
11037,58thStGreenway22ndAve,05/03/2015 09:00:00 PM,48,-122,0,0,0
11038,58thStGreenway22ndAve,05/03/2015 10:00:00 PM,48,-122,1,0,1
11039,58thStGreenway22ndAve,05/03/2015 11:00:00 PM,48,-122,2,0,2
11040,58thStGreenway22ndAve,05/04/2015 12:00:00 AM,48,-122,0,0,0
11041,58thStGreenway22ndAve,05/04/2015 01:00:00 AM,48,-122,2,0,2
11042,58thStGreenway22ndAve,05/04/2015 02:00:00 AM,48,-122,0,1,1
11043,58thStGreenway22ndAve,05/04/2015 03:00:00 AM,48,-122,0,0,0
11044,58thStGreenway22ndAve,05/04/2015 04:00:00 AM,48,-122,0,0,0
11045,58thStGreenway22ndAve,05/04/2015 05:00:00 AM,48,-122,0,1,1
11046,58thStGreenway22ndAve,05/04/2015 06:00:00 AM,48,-122,1,5,6
11047,58thStGreenway22ndAve,05/04/2015 07:00:00 AM,48,-122,7,4,11
11048,58thStGreenway22ndAve,05/04/2015 08:00:00 AM,48,-122,8,8,16
11049,58thStGreenway22ndAve,05/04/2015 09:00:00 AM,48,-122,4,8,12
11050,58thStGreenway22ndAve,05/04/2015 10:00:00 AM,48,-122,0,6,6
11051,58thStGreenway22ndAve,05/04/2015 11:00:00 AM,48,-122,3,4,7
11052,58thStGreenway22ndAve,05/04/2015 12:00:00 PM,48,-122,3,5,8
11053,58thStGreenway22ndAve,05/04/2015 01:00:00 PM,48,-122,8,5,13
11054,58thStGreenway22ndAve,05/04/2015 02:00:00 PM,48,-122,5,2,7
11055,58thStGreenway22ndAve,05/04/2015 03:00:00 PM,48,-122,3,6,9
11056,58thStGreenway22ndAve,05/04/2015 04:00:00 PM,48,-122,9,5,14
11057,58thStGreenway22ndAve,05/04/2015 05:00:00 PM,48,-122,11,8,19
11058,58thStGreenway22ndAve,05/04/2015 06:00:00 PM,48,-122,5,3,8
11059,58thStGreenway22ndAve,05/04/2015 07:00:00 PM,48,-122,11,8,19
11060,58thStGreenway22ndAve,05/04/2015 08:00:00 PM,48,-122,4,2,6
11061,58thStGreenway22ndAve,05/04/2015 09:00:00 PM,48,-122,3,2,5
11062,58thStGreenway22ndAve,05/04/2015 10:00:00 PM,48,-122,4,0,4
11063,58thStGreenway22ndAve,05/04/2015 11:00:00 PM,48,-122,0,1,1
11064,58thStGreenway22ndAve,05/05/2015 12:00:00 AM,48,-122,1,0,1
11065,58thStGreenway22ndAve,05/05/2015 01:00:00 AM,48,-122,0,0,0
11066,58thStGreenway22ndAve,05/05/2015 02:00:00 AM,48,-122,0,0,0
11067,58thStGreenway22ndAve,05/05/2015 03:00:00 AM,48,-122,0,0,0
11068,58thStGreenway22ndAve,05/05/2015 04:00:00 AM,48,-122,0,0,0
11069,58thStGreenway22ndAve,05/05/2015 05:00:00 AM,48,-122,0,1,1
11070,58thStGreenway22ndAve,05/05/2015 06:00:00 AM,48,-122,2,4,6
11071,58thStGreenway22ndAve,05/05/2015 07:00:00 AM,48,-122,4,0,4
11072,58thStGreenway22ndAve,05/05/2015 08:00:00 AM,48,-122,11,8,19
11073,58thStGreenway22ndAve,05/05/2015 09:00:00 AM,48,-122,1,2,3
11074,58thStGreenway22ndAve,05/05/2015 10:00:00 AM,48,-122,3,3,6
11075,58thStGreenway22ndAve,05/05/2015 11:00:00 AM,48,-122,1,3,4
11076,58thStGreenway22ndAve,05/05/2015 12:00:00 PM,48,-122,3,10,13
11077,58thStGreenway22ndAve,05/05/2015 01:00:00 PM,48,-122,2,2,4
11078,58thStGreenway22ndAve,05/05/2015 02:00:00 PM,48,-122,3,4,7
11079,58thStGreenway22ndAve,05/05/2015 03:00:00 PM,48,-122,5,2,7
11080,58thStGreenway22ndAve,05/05/2015 04:00:00 PM,48,-122,2,1,3
11081,58thStGreenway22ndAve,05/05/2015 05:00:00 PM,48,-122,3,3,6
11082,58thStGreenway22ndAve,05/05/2015 06:00:00 PM,48,-122,7,4,11
11083,58thStGreenway22ndAve,05/05/2015 07:00:00 PM,48,-122,4,2,6
11084,58thStGreenway22ndAve,05/05/2015 08:00:00 PM,48,-122,1,0,1
11085,58thStGreenway22ndAve,05/05/2015 09:00:00 PM,48,-122,0,0,0
11086,58thStGreenway22ndAve,05/05/2015 10:00:00 PM,48,-122,0,0,0
11087,58thStGreenway22ndAve,05/05/2015 11:00:00 PM,48,-122,0,0,0
11088,58thStGreenway22ndAve,05/06/2015 12:00:00 AM,48,-122,0,0,0
11089,58thStGreenway22ndAve,05/06/2015 01:00:00 AM,48,-122,0,0,0
11090,58thStGreenway22ndAve,05/06/2015 02:00:00 AM,48,-122,0,0,0
11091,58thStGreenway22ndAve,05/06/2015 03:00:00 AM,48,-122,0,0,0
11092,58thStGreenway22ndAve,05/06/2015 04:00:00 AM,48,-122,0,0,0
11093,58thStGreenway22ndAve,05/06/2015 05:00:00 AM,48,-122,0,0,0
11094,58thStGreenway22ndAve,05/06/2015 06:00:00 AM,48,-122,1,1,2
11095,58thStGreenway22ndAve,05/06/2015 07:00:00 AM,48,-122,7,4,11
11096,58thStGreenway22ndAve,05/06/2015 08:00:00 AM,48,-122,12,13,25
11097,58thStGreenway22ndAve,05/06/2015 09:00:00 AM,48,-122,4,5,9
11098,58thStGreenway22ndAve,05/06/2015 10:00:00 AM,48,-122,2,4,6
11099,58thStGreenway22ndAve,05/06/2015 11:00:00 AM,48,-122,5,4,9
11100,58thStGreenway22ndAve,05/06/2015 12:00:00 PM,48,-122,6,4,10
11101,58thStGreenway22ndAve,05/06/2015 01:00:00 PM,48,-122,3,4,7
11102,58thStGreenway22ndAve,05/06/2015 02:00:00 PM,48,-122,3,8,11
11103,58thStGreenway22ndAve,05/06/2015 03:00:00 PM,48,-122,9,8,17
11104,58thStGreenway22ndAve,05/06/2015 04:00:00 PM,48,-122,7,7,14
11105,58thStGreenway22ndAve,05/06/2015 05:00:00 PM,48,-122,10,14,24
11106,58thStGreenway22ndAve,05/06/2015 06:00:00 PM,48,-122,13,9,22
11107,58thStGreenway22ndAve,05/06/2015 07:00:00 PM,48,-122,6,4,10
11108,58thStGreenway22ndAve,05/06/2015 08:00:00 PM,48,-122,6,1,7
11109,58thStGreenway22ndAve,05/06/2015 09:00:00 PM,48,-122,3,0,3
11110,58thStGreenway22ndAve,05/06/2015 10:00:00 PM,48,-122,1,2,3
11111,58thStGreenway22ndAve,05/06/2015 11:00:00 PM,48,-122,0,1,1
11112,58thStGreenway22ndAve,05/07/2015 12:00:00 AM,48,-122,0,0,0
11113,58thStGreenway22ndAve,05/07/2015 01:00:00 AM,48,-122,0,1,1
11114,58thStGreenway22ndAve,05/07/2015 02:00:00 AM,48,-122,0,0,0
11115,58thStGreenway22ndAve,05/07/2015 03:00:00 AM,48,-122,0,0,0
11116,58thStGreenway22ndAve,05/07/2015 04:00:00 AM,48,-122,0,0,0
11117,58thStGreenway22ndAve,05/07/2015 05:00:00 AM,48,-122,0,0,0
11118,58thStGreenway22ndAve,05/07/2015 06:00:00 AM,48,-122,0,4,4
11119,58thStGreenway22ndAve,05/07/2015 07:00:00 AM,48,-122,5,1,6
11120,58thStGreenway22ndAve,05/07/2015 08:00:00 AM,48,-122,9,7,16
11121,58thStGreenway22ndAve,05/07/2015 09:00:00 AM,48,-122,9,5,14
11122,58thStGreenway22ndAve,05/07/2015 10:00:00 AM,48,-122,2,2,4
11123,58thStGreenway22ndAve,05/07/2015 11:00:00 AM,48,-122,5,5,10
11124,58thStGreenway22ndAve,05/07/2015 12:00:00 PM,48,-122,2,6,8
11125,58thStGreenway22ndAve,05/07/2015 01:00:00 PM,48,-122,3,2,5
11126,58thStGreenway22ndAve,05/07/2015 02:00:00 PM,48,-122,8,5,13
11127,58thStGreenway22ndAve,05/07/2015 03:00:00 PM,48,-122,9,5,14
11128,58thStGreenway22ndAve,05/07/2015 04:00:00 PM,48,-122,6,3,9
11129,58thStGreenway22ndAve,05/07/2015 05:00:00 PM,48,-122,9,8,17
11130,58thStGreenway22ndAve,05/07/2015 06:00:00 PM,48,-122,12,16,28
11131,58thStGreenway22ndAve,05/07/2015 07:00:00 PM,48,-122,10,8,18
11132,58thStGreenway22ndAve,05/07/2015 08:00:00 PM,48,-122,4,3,7
11133,58thStGreenway22ndAve,05/07/2015 09:00:00 PM,48,-122,5,2,7
11134,58thStGreenway22ndAve,05/07/2015 10:00:00 PM,48,-122,0,2,2
11135,58thStGreenway22ndAve,05/07/2015 11:00:00 PM,48,-122,0,1,1
11136,58thStGreenway22ndAve,05/08/2015 12:00:00 AM,48,-122,1,0,1
11137,58thStGreenway22ndAve,05/08/2015 01:00:00 AM,48,-122,0,0,0
11138,58thStGreenway22ndAve,05/08/2015 02:00:00 AM,48,-122,0,0,0
11139,58thStGreenway22ndAve,05/08/2015 03:00:00 AM,48,-122,0,0,0
11140,58thStGreenway22ndAve,05/08/2015 04:00:00 AM,48,-122,0,0,0
11141,58thStGreenway22ndAve,05/08/2015 05:00:00 AM,48,-122,0,1,1
11142,58thStGreenway22ndAve,05/08/2015 06:00:00 AM,48,-122,0,1,1
11143,58thStGreenway22ndAve,05/08/2015 07:00:00 AM,48,-122,3,2,5
11144,58thStGreenway22ndAve,05/08/2015 08:00:00 AM,48,-122,5,3,8
11145,58thStGreenway22ndAve,05/08/2015 09:00:00 AM,48,-122,6,5,11
11146,58thStGreenway22ndAve,05/08/2015 10:00:00 AM,48,-122,4,9,13
11147,58thStGreenway22ndAve,05/08/2015 11:00:00 AM,48,-122,3,2,5
11148,58thStGreenway22ndAve,05/08/2015 12:00:00 PM,48,-122,6,10,16
11149,58thStGreenway22ndAve,05/08/2015 01:00:00 PM,48,-122,7,1,8
11150,58thStGreenway22ndAve,05/08/2015 02:00:00 PM,48,-122,6,8,14
11151,58thStGreenway22ndAve,05/08/2015 03:00:00 PM,48,-122,13,14,27
11152,58thStGreenway22ndAve,05/08/2015 04:00:00 PM,48,-122,8,11,19
11153,58thStGreenway22ndAve,05/08/2015 05:00:00 PM,48,-122,9,16,25
11154,58thStGreenway22ndAve,05/08/2015 06:00:00 PM,48,-122,10,3,13
11155,58thStGreenway22ndAve,05/08/2015 07:00:00 PM,48,-122,3,7,10
11156,58thStGreenway22ndAve,05/08/2015 08:00:00 PM,48,-122,7,1,8
11157,58thStGreenway22ndAve,05/08/2015 09:00:00 PM,48,-122,3,0,3
11158,58thStGreenway22ndAve,05/08/2015 10:00:00 PM,48,-122,2,1,3
11159,58thStGreenway22ndAve,05/08/2015 11:00:00 PM,48,-122,0,0,0
11160,58thStGreenway22ndAve,05/09/2015 12:00:00 AM,48,-122,3,0,3
11161,58thStGreenway22ndAve,05/09/2015 01:00:00 AM,48,-122,0,0,0
11162,58thStGreenway22ndAve,05/09/2015 02:00:00 AM,48,-122,2,0,2
11163,58thStGreenway22ndAve,05/09/2015 03:00:00 AM,48,-122,0,0,0
11164,58thStGreenway22ndAve,05/09/2015 04:00:00 AM,48,-122,0,0,0
11165,58thStGreenway22ndAve,05/09/2015 05:00:00 AM,48,-122,0,0,0
11166,58thStGreenway22ndAve,05/09/2015 06:00:00 AM,48,-122,0,0,0
11167,58thStGreenway22ndAve,05/09/2015 07:00:00 AM,48,-122,0,2,2
11168,58thStGreenway22ndAve,05/09/2015 08:00:00 AM,48,-122,3,5,8
11169,58thStGreenway22ndAve,05/09/2015 09:00:00 AM,48,-122,8,10,18
11170,58thStGreenway22ndAve,05/09/2015 10:00:00 AM,48,-122,5,5,10
11171,58thStGreenway22ndAve,05/09/2015 11:00:00 AM,48,-122,8,9,17
11172,58thStGreenway22ndAve,05/09/2015 12:00:00 PM,48,-122,12,11,23
11173,58thStGreenway22ndAve,05/09/2015 01:00:00 PM,48,-122,6,6,12
11174,58thStGreenway22ndAve,05/09/2015 02:00:00 PM,48,-122,10,15,25
11175,58thStGreenway22ndAve,05/09/2015 03:00:00 PM,48,-122,16,4,20
11176,58thStGreenway22ndAve,05/09/2015 04:00:00 PM,48,-122,12,14,26
11177,58thStGreenway22ndAve,05/09/2015 05:00:00 PM,48,-122,17,5,22
11178,58thStGreenway22ndAve,05/09/2015 06:00:00 PM,48,-122,4,5,9
11179,58thStGreenway22ndAve,05/09/2015 07:00:00 PM,48,-122,5,7,12
11180,58thStGreenway22ndAve,05/09/2015 08:00:00 PM,48,-122,5,0,5
11181,58thStGreenway22ndAve,05/09/2015 09:00:00 PM,48,-122,1,1,2
11182,58thStGreenway22ndAve,05/09/2015 10:00:00 PM,48,-122,5,0,5
11183,58thStGreenway22ndAve,05/09/2015 11:00:00 PM,48,-122,3,0,3
11184,58thStGreenway22ndAve,05/10/2015 12:00:00 AM,48,-122,3,1,4
11185,58thStGreenway22ndAve,05/10/2015 01:00:00 AM,48,-122,0,1,1
11186,58thStGreenway22ndAve,05/10/2015 02:00:00 AM,48,-122,0,0,0
11187,58thStGreenway22ndAve,05/10/2015 03:00:00 AM,48,-122,0,0,0
11188,58thStGreenway22ndAve,05/10/2015 04:00:00 AM,48,-122,0,0,0
11189,58thStGreenway22ndAve,05/10/2015 05:00:00 AM,48,-122,1,0,1
11190,58thStGreenway22ndAve,05/10/2015 06:00:00 AM,48,-122,0,0,0
11191,58thStGreenway22ndAve,05/10/2015 07:00:00 AM,48,-122,2,0,2
11192,58thStGreenway22ndAve,05/10/2015 08:00:00 AM,48,-122,0,3,3
11193,58thStGreenway22ndAve,05/10/2015 09:00:00 AM,48,-122,5,5,10
11194,58thStGreenway22ndAve,05/10/2015 10:00:00 AM,48,-122,5,9,14
11195,58thStGreenway22ndAve,05/10/2015 11:00:00 AM,48,-122,9,12,21
11196,58thStGreenway22ndAve,05/10/2015 12:00:00 PM,48,-122,10,12,22
11197,58thStGreenway22ndAve,05/10/2015 01:00:00 PM,48,-122,19,13,32
11198,58thStGreenway22ndAve,05/10/2015 02:00:00 PM,48,-122,24,15,39
11199,58thStGreenway22ndAve,05/10/2015 03:00:00 PM,48,-122,13,11,24
11200,58thStGreenway22ndAve,05/10/2015 04:00:00 PM,48,-122,9,6,15
11201,58thStGreenway22ndAve,05/10/2015 05:00:00 PM,48,-122,11,7,18
11202,58thStGreenway22ndAve,05/10/2015 06:00:00 PM,48,-122,13,4,17
11203,58thStGreenway22ndAve,05/10/2015 07:00:00 PM,48,-122,5,4,9
11204,58thStGreenway22ndAve,05/10/2015 08:00:00 PM,48,-122,0,1,1
11205,58thStGreenway22ndAve,05/10/2015 09:00:00 PM,48,-122,2,2,4
11206,58thStGreenway22ndAve,05/10/2015 10:00:00 PM,48,-122,2,1,3
11207,58thStGreenway22ndAve,05/10/2015 11:00:00 PM,48,-122,0,0,0
11208,58thStGreenway22ndAve,05/11/2015 12:00:00 AM,48,-122,0,1,1
11209,58thStGreenway22ndAve,05/11/2015 01:00:00 AM,48,-122,0,0,0
11210,58thStGreenway22ndAve,05/11/2015 02:00:00 AM,48,-122,0,0,0
11211,58thStGreenway22ndAve,05/11/2015 03:00:00 AM,48,-122,0,0,0
11212,58thStGreenway22ndAve,05/11/2015 04:00:00 AM,48,-122,0,0,0
11213,58thStGreenway22ndAve,05/11/2015 05:00:00 AM,48,-122,0,0,0
11214,58thStGreenway22ndAve,05/11/2015 06:00:00 AM,48,-122,1,3,4
11215,58thStGreenway22ndAve,05/11/2015 07:00:00 AM,48,-122,2,3,5
11216,58thStGreenway22ndAve,05/11/2015 08:00:00 AM,48,-122,4,4,8
11217,58thStGreenway22ndAve,05/11/2015 09:00:00 AM,48,-122,3,4,7
11218,58thStGreenway22ndAve,05/11/2015 10:00:00 AM,48,-122,2,5,7
11219,58thStGreenway22ndAve,05/11/2015 11:00:00 AM,48,-122,2,0,2
11220,58thStGreenway22ndAve,05/11/2015 12:00:00 PM,48,-122,3,2,5
11221,58thStGreenway22ndAve,05/11/2015 01:00:00 PM,48,-122,0,2,2
11222,58thStGreenway22ndAve,05/11/2015 02:00:00 PM,48,-122,6,4,10
11223,58thStGreenway22ndAve,05/11/2015 03:00:00 PM,48,-122,2,3,5
11224,58thStGreenway22ndAve,05/11/2015 04:00:00 PM,48,-122,11,5,16
11225,58thStGreenway22ndAve,05/11/2015 05:00:00 PM,48,-122,7,4,11
11226,58thStGreenway22ndAve,05/11/2015 06:00:00 PM,48,-122,5,1,6
11227,58thStGreenway22ndAve,05/11/2015 07:00:00 PM,48,-122,7,5,12
11228,58thStGreenway22ndAve,05/11/2015 08:00:00 PM,48,-122,1,1,2
11229,58thStGreenway22ndAve,05/11/2015 09:00:00 PM,48,-122,3,0,3
11230,58thStGreenway22ndAve,05/11/2015 10:00:00 PM,48,-122,0,1,1
11231,58thStGreenway22ndAve,05/11/2015 11:00:00 PM,48,-122,0,1,1
11232,58thStGreenway22ndAve,05/12/2015 12:00:00 AM,48,-122,0,1,1
11233,58thStGreenway22ndAve,05/12/2015 01:00:00 AM,48,-122,0,1,1
11234,58thStGreenway22ndAve,05/12/2015 02:00:00 AM,48,-122,0,0,0
11235,58thStGreenway22ndAve,05/12/2015 03:00:00 AM,48,-122,0,0,0
11236,58thStGreenway22ndAve,05/12/2015 04:00:00 AM,48,-122,0,0,0
11237,58thStGreenway22ndAve,05/12/2015 05:00:00 AM,48,-122,0,1,1
11238,58thStGreenway22ndAve,05/12/2015 06:00:00 AM,48,-122,0,1,1
11239,58thStGreenway22ndAve,05/12/2015 07:00:00 AM,48,-122,8,4,12
11240,58thStGreenway22ndAve,05/12/2015 08:00:00 AM,48,-122,4,5,9
11241,58thStGreenway22ndAve,05/12/2015 09:00:00 AM,48,-122,4,2,6
11242,58thStGreenway22ndAve,05/12/2015 10:00:00 AM,48,-122,1,4,5
11243,58thStGreenway22ndAve,05/12/2015 11:00:00 AM,48,-122,1,1,2
11244,58thStGreenway22ndAve,05/12/2015 12:00:00 PM,48,-122,2,3,5
11245,58thStGreenway22ndAve,05/12/2015 01:00:00 PM,48,-122,1,2,3
11246,58thStGreenway22ndAve,05/12/2015 02:00:00 PM,48,-122,3,2,5
11247,58thStGreenway22ndAve,05/12/2015 03:00:00 PM,48,-122,2,0,2
11248,58thStGreenway22ndAve,05/12/2015 04:00:00 PM,48,-122,2,6,8
11249,58thStGreenway22ndAve,05/12/2015 05:00:00 PM,48,-122,10,6,16
11250,58thStGreenway22ndAve,05/12/2015 06:00:00 PM,48,-122,4,8,12
11251,58thStGreenway22ndAve,05/12/2015 07:00:00 PM,48,-122,5,4,9
11252,58thStGreenway22ndAve,05/12/2015 08:00:00 PM,48,-122,3,1,4
11253,58thStGreenway22ndAve,05/12/2015 09:00:00 PM,48,-122,7,1,8
11254,58thStGreenway22ndAve,05/12/2015 10:00:00 PM,48,-122,2,0,2
11255,58thStGreenway22ndAve,05/12/2015 11:00:00 PM,48,-122,0,0,0
11256,58thStGreenway22ndAve,05/13/2015 12:00:00 AM,48,-122,0,1,1
11257,58thStGreenway22ndAve,05/13/2015 01:00:00 AM,48,-122,0,0,0
11258,58thStGreenway22ndAve,05/13/2015 02:00:00 AM,48,-122,0,0,0
11259,58thStGreenway22ndAve,05/13/2015 03:00:00 AM,48,-122,0,0,0
11260,58thStGreenway22ndAve,05/13/2015 04:00:00 AM,48,-122,0,0,0
11261,58thStGreenway22ndAve,05/13/2015 05:00:00 AM,48,-122,0,1,1
11262,58thStGreenway22ndAve,05/13/2015 06:00:00 AM,48,-122,3,1,4
11263,58thStGreenway22ndAve,05/13/2015 07:00:00 AM,48,-122,1,5,6
11264,58thStGreenway22ndAve,05/13/2015 08:00:00 AM,48,-122,3,3,6
11265,58thStGreenway22ndAve,05/13/2015 09:00:00 AM,48,-122,4,5,9
11266,58thStGreenway22ndAve,05/13/2015 10:00:00 AM,48,-122,1,3,4
11267,58thStGreenway22ndAve,05/13/2015 11:00:00 AM,48,-122,1,2,3
11268,58thStGreenway22ndAve,05/13/2015 12:00:00 PM,48,-122,4,4,8
11269,58thStGreenway22ndAve,05/13/2015 01:00:00 PM,48,-122,3,1,4
11270,58thStGreenway22ndAve,05/13/2015 02:00:00 PM,48,-122,3,3,6
11271,58thStGreenway22ndAve,05/13/2015 03:00:00 PM,48,-122,5,0,5
11272,58thStGreenway22ndAve,05/13/2015 04:00:00 PM,48,-122,3,0,3
11273,58thStGreenway22ndAve,05/13/2015 05:00:00 PM,48,-122,2,0,2
11274,58thStGreenway22ndAve,05/13/2015 06:00:00 PM,48,-122,7,9,16
11275,58thStGreenway22ndAve,05/13/2015 07:00:00 PM,48,-122,3,3,6
11276,58thStGreenway22ndAve,05/13/2015 08:00:00 PM,48,-122,1,0,1
11277,58thStGreenway22ndAve,05/13/2015 09:00:00 PM,48,-122,2,1,3
11278,58thStGreenway22ndAve,05/13/2015 10:00:00 PM,48,-122,1,0,1
11279,58thStGreenway22ndAve,05/13/2015 11:00:00 PM,48,-122,0,0,0
11280,58thStGreenway22ndAve,05/14/2015 12:00:00 AM,48,-122,0,0,0
11281,58thStGreenway22ndAve,05/14/2015 01:00:00 AM,48,-122,0,0,0
11282,58thStGreenway22ndAve,05/14/2015 02:00:00 AM,48,-122,0,0,0
11283,58thStGreenway22ndAve,05/14/2015 03:00:00 AM,48,-122,0,0,0
11284,58thStGreenway22ndAve,05/14/2015 04:00:00 AM,48,-122,0,0,0
11285,58thStGreenway22ndAve,05/14/2015 05:00:00 AM,48,-122,0,1,1
11286,58thStGreenway22ndAve,05/14/2015 06:00:00 AM,48,-122,0,2,2
11287,58thStGreenway22ndAve,05/14/2015 07:00:00 AM,48,-122,4,3,7
11288,58thStGreenway22ndAve,05/14/2015 08:00:00 AM,48,-122,1,6,7
11289,58thStGreenway22ndAve,05/14/2015 09:00:00 AM,48,-122,7,4,11
11290,58thStGreenway22ndAve,05/14/2015 10:00:00 AM,48,-122,3,4,7
11291,58thStGreenway22ndAve,05/14/2015 11:00:00 AM,48,-122,2,1,3
11292,58thStGreenway22ndAve,05/14/2015 12:00:00 PM,48,-122,5,4,9
11293,58thStGreenway22ndAve,05/14/2015 01:00:00 PM,48,-122,3,4,7
11294,58thStGreenway22ndAve,05/14/2015 02:00:00 PM,48,-122,2,4,6
11295,58thStGreenway22ndAve,05/14/2015 03:00:00 PM,48,-122,2,2,4
11296,58thStGreenway22ndAve,05/14/2015 04:00:00 PM,48,-122,8,6,14
11297,58thStGreenway22ndAve,05/14/2015 05:00:00 PM,48,-122,12,12,24
11298,58thStGreenway22ndAve,05/14/2015 06:00:00 PM,48,-122,9,11,20
11299,58thStGreenway22ndAve,05/14/2015 07:00:00 PM,48,-122,7,3,10
11300,58thStGreenway22ndAve,05/14/2015 08:00:00 PM,48,-122,6,3,9
11301,58thStGreenway22ndAve,05/14/2015 09:00:00 PM,48,-122,1,2,3
11302,58thStGreenway22ndAve,05/14/2015 10:00:00 PM,48,-122,3,0,3
11303,58thStGreenway22ndAve,05/14/2015 11:00:00 PM,48,-122,0,0,0
11304,58thStGreenway22ndAve,05/15/2015 12:00:00 AM,48,-122,0,1,1
11305,58thStGreenway22ndAve,05/15/2015 01:00:00 AM,48,-122,0,0,0
11306,58thStGreenway22ndAve,05/15/2015 02:00:00 AM,48,-122,0,0,0
11307,58thStGreenway22ndAve,05/15/2015 03:00:00 AM,48,-122,0,0,0
11308,58thStGreenway22ndAve,05/15/2015 04:00:00 AM,48,-122,0,0,0
11309,58thStGreenway22ndAve,05/15/2015 05:00:00 AM,48,-122,1,1,2
11310,58thStGreenway22ndAve,05/15/2015 06:00:00 AM,48,-122,4,1,5
11311,58thStGreenway22ndAve,05/15/2015 07:00:00 AM,48,-122,5,6,11
11312,58thStGreenway22ndAve,05/15/2015 08:00:00 AM,48,-122,8,4,12
11313,58thStGreenway22ndAve,05/15/2015 09:00:00 AM,48,-122,3,6,9
11314,58thStGreenway22ndAve,05/15/2015 10:00:00 AM,48,-122,1,1,2
11315,58thStGreenway22ndAve,05/15/2015 11:00:00 AM,48,-122,1,0,1
11316,58thStGreenway22ndAve,05/15/2015 12:00:00 PM,48,-122,11,3,14
11317,58thStGreenway22ndAve,05/15/2015 01:00:00 PM,48,-122,5,1,6
11318,58thStGreenway22ndAve,05/15/2015 02:00:00 PM,48,-122,8,5,13
11319,58thStGreenway22ndAve,05/15/2015 03:00:00 PM,48,-122,11,8,19
11320,58thStGreenway22ndAve,05/15/2015 04:00:00 PM,48,-122,11,6,17
11321,58thStGreenway22ndAve,05/15/2015 05:00:00 PM,48,-122,12,6,18
11322,58thStGreenway22ndAve,05/15/2015 06:00:00 PM,48,-122,0,0,0
11323,58thStGreenway22ndAve,05/15/2015 07:00:00 PM,48,-122,0,0,0
11324,58thStGreenway22ndAve,05/15/2015 08:00:00 PM,48,-122,0,0,0
11325,58thStGreenway22ndAve,05/15/2015 09:00:00 PM,48,-122,0,0,0
11326,58thStGreenway22ndAve,05/15/2015 10:00:00 PM,48,-122,0,0,0
11327,58thStGreenway22ndAve,05/15/2015 11:00:00 PM,48,-122,0,0,0
11328,58thStGreenway22ndAve,05/16/2015 12:00:00 AM,48,-122,0,0,0
11329,58thStGreenway22ndAve,05/16/2015 01:00:00 AM,48,-122,0,0,0
11330,58thStGreenway22ndAve,05/16/2015 02:00:00 AM,48,-122,0,0,0
11331,58thStGreenway22ndAve,05/16/2015 03:00:00 AM,48,-122,0,0,0
11332,58thStGreenway22ndAve,05/16/2015 04:00:00 AM,48,-122,0,0,0
11333,58thStGreenway22ndAve,05/16/2015 05:00:00 AM,48,-122,0,0,0
11334,58thStGreenway22ndAve,05/16/2015 06:00:00 AM,48,-122,0,0,0
11335,58thStGreenway22ndAve,05/16/2015 07:00:00 AM,48,-122,0,0,0
11336,58thStGreenway22ndAve,05/16/2015 08:00:00 AM,48,-122,0,0,0
11337,58thStGreenway22ndAve,05/16/2015 09:00:00 AM,48,-122,0,0,0
11338,58thStGreenway22ndAve,05/16/2015 10:00:00 AM,48,-122,0,0,0
11339,58thStGreenway22ndAve,05/16/2015 11:00:00 AM,48,-122,0,0,0
11340,58thStGreenway22ndAve,05/16/2015 12:00:00 PM,48,-122,0,0,0
11341,58thStGreenway22ndAve,05/16/2015 01:00:00 PM,48,-122,0,0,0
11342,58thStGreenway22ndAve,05/16/2015 02:00:00 PM,48,-122,0,0,0
11343,58thStGreenway22ndAve,05/16/2015 03:00:00 PM,48,-122,0,0,0
11344,58thStGreenway22ndAve,05/16/2015 04:00:00 PM,48,-122,0,0,0
11345,58thStGreenway22ndAve,05/16/2015 05:00:00 PM,48,-122,0,0,0
11346,58thStGreenway22ndAve,05/16/2015 06:00:00 PM,48,-122,0,0,0
11347,58thStGreenway22ndAve,05/16/2015 07:00:00 PM,48,-122,0,0,0
11348,58thStGreenway22ndAve,05/16/2015 08:00:00 PM,48,-122,0,0,0
11349,58thStGreenway22ndAve,05/16/2015 09:00:00 PM,48,-122,0,0,0
11350,58thStGreenway22ndAve,05/16/2015 10:00:00 PM,48,-122,0,0,0
11351,58thStGreenway22ndAve,05/16/2015 11:00:00 PM,48,-122,0,0,0
11352,58thStGreenway22ndAve,05/17/2015 12:00:00 AM,48,-122,0,0,0
11353,58thStGreenway22ndAve,05/17/2015 01:00:00 AM,48,-122,0,0,0
11354,58thStGreenway22ndAve,05/17/2015 02:00:00 AM,48,-122,0,0,0
11355,58thStGreenway22ndAve,05/17/2015 03:00:00 AM,48,-122,0,0,0
11356,58thStGreenway22ndAve,05/17/2015 04:00:00 AM,48,-122,0,0,0
11357,58thStGreenway22ndAve,05/17/2015 05:00:00 AM,48,-122,0,0,0
11358,58thStGreenway22ndAve,05/17/2015 06:00:00 AM,48,-122,0,0,0
11359,58thStGreenway22ndAve,05/17/2015 07:00:00 AM,48,-122,0,1,1
11360,58thStGreenway22ndAve,05/17/2015 08:00:00 AM,48,-122,1,2,3
11361,58thStGreenway22ndAve,05/17/2015 09:00:00 AM,48,-122,3,9,12
11362,58thStGreenway22ndAve,05/17/2015 10:00:00 AM,48,-122,3,1,4
11363,58thStGreenway22ndAve,05/17/2015 11:00:00 AM,48,-122,11,11,22
11364,58thStGreenway22ndAve,05/17/2015 12:00:00 PM,48,-122,3,7,10
11365,58thStGreenway22ndAve,05/17/2015 01:00:00 PM,48,-122,8,20,28
11366,58thStGreenway22ndAve,05/17/2015 02:00:00 PM,48,-122,12,20,32
11367,58thStGreenway22ndAve,05/17/2015 03:00:00 PM,48,-122,9,28,37
11368,58thStGreenway22ndAve,05/17/2015 04:00:00 PM,48,-122,3,7,10
11369,58thStGreenway22ndAve,05/17/2015 05:00:00 PM,48,-122,16,8,24
11370,58thStGreenway22ndAve,05/17/2015 06:00:00 PM,48,-122,20,9,29
11371,58thStGreenway22ndAve,05/17/2015 07:00:00 PM,48,-122,2,4,6
11372,58thStGreenway22ndAve,05/17/2015 08:00:00 PM,48,-122,5,0,5
11373,58thStGreenway22ndAve,05/17/2015 09:00:00 PM,48,-122,0,0,0
11374,58thStGreenway22ndAve,05/17/2015 10:00:00 PM,48,-122,0,0,0
11375,58thStGreenway22ndAve,05/17/2015 11:00:00 PM,48,-122,0,1,1
11376,58thStGreenway22ndAve,05/18/2015 12:00:00 AM,48,-122,0,0,0
11377,58thStGreenway22ndAve,05/18/2015 01:00:00 AM,48,-122,0,0,0
11378,58thStGreenway22ndAve,05/18/2015 02:00:00 AM,48,-122,0,0,0
11379,58thStGreenway22ndAve,05/18/2015 03:00:00 AM,48,-122,0,0,0
11380,58thStGreenway22ndAve,05/18/2015 04:00:00 AM,48,-122,0,0,0
11381,58thStGreenway22ndAve,05/18/2015 05:00:00 AM,48,-122,1,1,2
11382,58thStGreenway22ndAve,05/18/2015 06:00:00 AM,48,-122,1,2,3
11383,58thStGreenway22ndAve,05/18/2015 07:00:00 AM,48,-122,10,5,15
11384,58thStGreenway22ndAve,05/18/2015 08:00:00 AM,48,-122,8,6,14
11385,58thStGreenway22ndAve,05/18/2015 09:00:00 AM,48,-122,2,6,8
11386,58thStGreenway22ndAve,05/18/2015 10:00:00 AM,48,-122,1,5,6
11387,58thStGreenway22ndAve,05/18/2015 11:00:00 AM,48,-122,3,2,5
11388,58thStGreenway22ndAve,05/18/2015 12:00:00 PM,48,-122,5,3,8
11389,58thStGreenway22ndAve,05/18/2015 01:00:00 PM,48,-122,4,7,11
11390,58thStGreenway22ndAve,05/18/2015 02:00:00 PM,48,-122,9,6,15
11391,58thStGreenway22ndAve,05/18/2015 03:00:00 PM,48,-122,7,6,13
11392,58thStGreenway22ndAve,05/18/2015 04:00:00 PM,48,-122,13,10,23
11393,58thStGreenway22ndAve,05/18/2015 05:00:00 PM,48,-122,14,16,30
11394,58thStGreenway22ndAve,05/18/2015 06:00:00 PM,48,-122,10,7,17
11395,58thStGreenway22ndAve,05/18/2015 07:00:00 PM,48,-122,11,3,14
11396,58thStGreenway22ndAve,05/18/2015 08:00:00 PM,48,-122,5,6,11
11397,58thStGreenway22ndAve,05/18/2015 09:00:00 PM,48,-122,4,1,5
11398,58thStGreenway22ndAve,05/18/2015 10:00:00 PM,48,-122,1,0,1
11399,58thStGreenway22ndAve,05/18/2015 11:00:00 PM,48,-122,1,1,2
11400,58thStGreenway22ndAve,05/19/2015 12:00:00 AM,48,-122,1,1,2
11401,58thStGreenway22ndAve,05/19/2015 01:00:00 AM,48,-122,0,0,0
11402,58thStGreenway22ndAve,05/19/2015 02:00:00 AM,48,-122,1,0,1
11403,58thStGreenway22ndAve,05/19/2015 03:00:00 AM,48,-122,0,0,0
11404,58thStGreenway22ndAve,05/19/2015 04:00:00 AM,48,-122,0,0,0
11405,58thStGreenway22ndAve,05/19/2015 05:00:00 AM,48,-122,0,1,1
11406,58thStGreenway22ndAve,05/19/2015 06:00:00 AM,48,-122,2,1,3
11407,58thStGreenway22ndAve,05/19/2015 07:00:00 AM,48,-122,7,5,12
11408,58thStGreenway22ndAve,05/19/2015 08:00:00 AM,48,-122,7,4,11
11409,58thStGreenway22ndAve,05/19/2015 09:00:00 AM,48,-122,2,9,11
11410,58thStGreenway22ndAve,05/19/2015 10:00:00 AM,48,-122,5,5,10
11411,58thStGreenway22ndAve,05/19/2015 11:00:00 AM,48,-122,0,2,2
11412,58thStGreenway22ndAve,05/19/2015 12:00:00 PM,48,-122,2,1,3
11413,58thStGreenway22ndAve,05/19/2015 01:00:00 PM,48,-122,8,8,16
11414,58thStGreenway22ndAve,05/19/2015 02:00:00 PM,48,-122,7,3,10
11415,58thStGreenway22ndAve,05/19/2015 03:00:00 PM,48,-122,6,2,8
11416,58thStGreenway22ndAve,05/19/2015 04:00:00 PM,48,-122,7,4,11
11417,58thStGreenway22ndAve,05/19/2015 05:00:00 PM,48,-122,13,8,21
11418,58thStGreenway22ndAve,05/19/2015 06:00:00 PM,48,-122,8,10,18
11419,58thStGreenway22ndAve,05/19/2015 07:00:00 PM,48,-122,8,14,22
11420,58thStGreenway22ndAve,05/19/2015 08:00:00 PM,48,-122,5,7,12
11421,58thStGreenway22ndAve,05/19/2015 09:00:00 PM,48,-122,6,1,7
11422,58thStGreenway22ndAve,05/19/2015 10:00:00 PM,48,-122,6,3,9
11423,58thStGreenway22ndAve,05/19/2015 11:00:00 PM,48,-122,0,0,0
11424,58thStGreenway22ndAve,05/20/2015 12:00:00 AM,48,-122,0,0,0
11425,58thStGreenway22ndAve,05/20/2015 01:00:00 AM,48,-122,0,1,1
11426,58thStGreenway22ndAve,05/20/2015 02:00:00 AM,48,-122,0,0,0
11427,58thStGreenway22ndAve,05/20/2015 03:00:00 AM,48,-122,0,0,0
11428,58thStGreenway22ndAve,05/20/2015 04:00:00 AM,48,-122,0,0,0
11429,58thStGreenway22ndAve,05/20/2015 05:00:00 AM,48,-122,0,0,0
11430,58thStGreenway22ndAve,05/20/2015 06:00:00 AM,48,-122,0,0,0
11431,58thStGreenway22ndAve,05/20/2015 07:00:00 AM,48,-122,9,3,12
11432,58thStGreenway22ndAve,05/20/2015 08:00:00 AM,48,-122,4,8,12
11433,58thStGreenway22ndAve,05/20/2015 09:00:00 AM,48,-122,5,7,12
11434,58thStGreenway22ndAve,05/20/2015 10:00:00 AM,48,-122,0,2,2
11435,58thStGreenway22ndAve,05/20/2015 11:00:00 AM,48,-122,2,5,7
11436,58thStGreenway22ndAve,05/20/2015 12:00:00 PM,48,-122,6,3,9
11437,58thStGreenway22ndAve,05/20/2015 01:00:00 PM,48,-122,3,5,8
11438,58thStGreenway22ndAve,05/20/2015 02:00:00 PM,48,-122,4,9,13
11439,58thStGreenway22ndAve,05/20/2015 03:00:00 PM,48,-122,8,3,11
11440,58thStGreenway22ndAve,05/20/2015 04:00:00 PM,48,-122,8,10,18
11441,58thStGreenway22ndAve,05/20/2015 05:00:00 PM,48,-122,16,13,29
11442,58thStGreenway22ndAve,05/20/2015 06:00:00 PM,48,-122,13,4,17
11443,58thStGreenway22ndAve,05/20/2015 07:00:00 PM,48,-122,25,8,33
11444,58thStGreenway22ndAve,05/20/2015 08:00:00 PM,48,-122,10,7,17
11445,58thStGreenway22ndAve,05/20/2015 09:00:00 PM,48,-122,4,2,6
11446,58thStGreenway22ndAve,05/20/2015 10:00:00 PM,48,-122,7,2,9
11447,58thStGreenway22ndAve,05/20/2015 11:00:00 PM,48,-122,1,0,1
11448,58thStGreenway22ndAve,05/21/2015 12:00:00 AM,48,-122,0,0,0
11449,58thStGreenway22ndAve,05/21/2015 01:00:00 AM,48,-122,0,1,1
11450,58thStGreenway22ndAve,05/21/2015 02:00:00 AM,48,-122,0,0,0
11451,58thStGreenway22ndAve,05/21/2015 03:00:00 AM,48,-122,0,1,1
11452,58thStGreenway22ndAve,05/21/2015 04:00:00 AM,48,-122,0,0,0
11453,58thStGreenway22ndAve,05/21/2015 05:00:00 AM,48,-122,0,2,2
11454,58thStGreenway22ndAve,05/21/2015 06:00:00 AM,48,-122,2,3,5
11455,58thStGreenway22ndAve,05/21/2015 07:00:00 AM,48,-122,5,4,9
11456,58thStGreenway22ndAve,05/21/2015 08:00:00 AM,48,-122,8,7,15
11457,58thStGreenway22ndAve,05/21/2015 09:00:00 AM,48,-122,3,8,11
11458,58thStGreenway22ndAve,05/21/2015 10:00:00 AM,48,-122,3,2,5
11459,58thStGreenway22ndAve,05/21/2015 11:00:00 AM,48,-122,10,3,13
11460,58thStGreenway22ndAve,05/21/2015 12:00:00 PM,48,-122,5,1,6
11461,58thStGreenway22ndAve,05/21/2015 01:00:00 PM,48,-122,10,6,16
11462,58thStGreenway22ndAve,05/21/2015 02:00:00 PM,48,-122,4,6,10
11463,58thStGreenway22ndAve,05/21/2015 03:00:00 PM,48,-122,1,8,9
11464,58thStGreenway22ndAve,05/21/2015 04:00:00 PM,48,-122,9,6,15
11465,58thStGreenway22ndAve,05/21/2015 05:00:00 PM,48,-122,15,12,27
11466,58thStGreenway22ndAve,05/21/2015 06:00:00 PM,48,-122,13,12,25
11467,58thStGreenway22ndAve,05/21/2015 07:00:00 PM,48,-122,8,5,13
11468,58thStGreenway22ndAve,05/21/2015 08:00:00 PM,48,-122,2,5,7
11469,58thStGreenway22ndAve,05/21/2015 09:00:00 PM,48,-122,6,5,11
11470,58thStGreenway22ndAve,05/21/2015 10:00:00 PM,48,-122,3,0,3
11471,58thStGreenway22ndAve,05/21/2015 11:00:00 PM,48,-122,3,0,3
11472,58thStGreenway22ndAve,05/22/2015 12:00:00 AM,48,-122,0,0,0
11473,58thStGreenway22ndAve,05/22/2015 01:00:00 AM,48,-122,0,1,1
11474,58thStGreenway22ndAve,05/22/2015 02:00:00 AM,48,-122,3,0,3
11475,58thStGreenway22ndAve,05/22/2015 03:00:00 AM,48,-122,0,0,0
11476,58thStGreenway22ndAve,05/22/2015 04:00:00 AM,48,-122,0,0,0
11477,58thStGreenway22ndAve,05/22/2015 05:00:00 AM,48,-122,0,3,3
11478,58thStGreenway22ndAve,05/22/2015 06:00:00 AM,48,-122,1,2,3
11479,58thStGreenway22ndAve,05/22/2015 07:00:00 AM,48,-122,3,3,6
11480,58thStGreenway22ndAve,05/22/2015 08:00:00 AM,48,-122,6,2,8
11481,58thStGreenway22ndAve,05/22/2015 09:00:00 AM,48,-122,2,4,6
11482,58thStGreenway22ndAve,05/22/2015 10:00:00 AM,48,-122,1,3,4
11483,58thStGreenway22ndAve,05/22/2015 11:00:00 AM,48,-122,2,3,5
11484,58thStGreenway22ndAve,05/22/2015 12:00:00 PM,48,-122,1,4,5
11485,58thStGreenway22ndAve,05/22/2015 01:00:00 PM,48,-122,9,4,13
11486,58thStGreenway22ndAve,05/22/2015 02:00:00 PM,48,-122,4,4,8
11487,58thStGreenway22ndAve,05/22/2015 03:00:00 PM,48,-122,8,4,12
11488,58thStGreenway22ndAve,05/22/2015 04:00:00 PM,48,-122,8,4,12
11489,58thStGreenway22ndAve,05/22/2015 05:00:00 PM,48,-122,9,9,18
11490,58thStGreenway22ndAve,05/22/2015 06:00:00 PM,48,-122,3,4,7
11491,58thStGreenway22ndAve,05/22/2015 07:00:00 PM,48,-122,7,2,9
11492,58thStGreenway22ndAve,05/22/2015 08:00:00 PM,48,-122,7,4,11
11493,58thStGreenway22ndAve,05/22/2015 09:00:00 PM,48,-122,1,5,6
11494,58thStGreenway22ndAve,05/22/2015 10:00:00 PM,48,-122,2,2,4
11495,58thStGreenway22ndAve,05/22/2015 11:00:00 PM,48,-122,1,1,2
11496,58thStGreenway22ndAve,05/23/2015 12:00:00 AM,48,-122,1,0,1
11497,58thStGreenway22ndAve,05/23/2015 01:00:00 AM,48,-122,1,0,1
11498,58thStGreenway22ndAve,05/23/2015 02:00:00 AM,48,-122,0,0,0
11499,58thStGreenway22ndAve,05/23/2015 03:00:00 AM,48,-122,0,0,0
11500,58thStGreenway22ndAve,05/23/2015 04:00:00 AM,48,-122,0,0,0
11501,58thStGreenway22ndAve,05/23/2015 05:00:00 AM,48,-122,0,0,0
11502,58thStGreenway22ndAve,05/23/2015 06:00:00 AM,48,-122,0,0,0
11503,58thStGreenway22ndAve,05/23/2015 07:00:00 AM,48,-122,0,3,3
11504,58thStGreenway22ndAve,05/23/2015 08:00:00 AM,48,-122,1,2,3
11505,58thStGreenway22ndAve,05/23/2015 09:00:00 AM,48,-122,4,3,7
11506,58thStGreenway22ndAve,05/23/2015 10:00:00 AM,48,-122,5,4,9
11507,58thStGreenway22ndAve,05/23/2015 11:00:00 AM,48,-122,2,3,5
11508,58thStGreenway22ndAve,05/23/2015 12:00:00 PM,48,-122,3,0,3
11509,58thStGreenway22ndAve,05/23/2015 01:00:00 PM,48,-122,5,3,8
11510,58thStGreenway22ndAve,05/23/2015 02:00:00 PM,48,-122,4,3,7
11511,58thStGreenway22ndAve,05/23/2015 03:00:00 PM,48,-122,7,5,12
11512,58thStGreenway22ndAve,05/23/2015 04:00:00 PM,48,-122,5,8,13
11513,58thStGreenway22ndAve,05/23/2015 05:00:00 PM,48,-122,1,4,5
11514,58thStGreenway22ndAve,05/23/2015 06:00:00 PM,48,-122,6,10,16
11515,58thStGreenway22ndAve,05/23/2015 07:00:00 PM,48,-122,0,5,5
11516,58thStGreenway22ndAve,05/23/2015 08:00:00 PM,48,-122,4,1,5
11517,58thStGreenway22ndAve,05/23/2015 09:00:00 PM,48,-122,1,2,3
11518,58thStGreenway22ndAve,05/23/2015 10:00:00 PM,48,-122,1,1,2
11519,58thStGreenway22ndAve,05/23/2015 11:00:00 PM,48,-122,2,1,3
11520,58thStGreenway22ndAve,05/24/2015 12:00:00 AM,48,-122,2,1,3
11521,58thStGreenway22ndAve,05/24/2015 01:00:00 AM,48,-122,1,0,1
11522,58thStGreenway22ndAve,05/24/2015 02:00:00 AM,48,-122,1,0,1
11523,58thStGreenway22ndAve,05/24/2015 03:00:00 AM,48,-122,0,0,0
11524,58thStGreenway22ndAve,05/24/2015 04:00:00 AM,48,-122,0,0,0
11525,58thStGreenway22ndAve,05/24/2015 05:00:00 AM,48,-122,0,0,0
11526,58thStGreenway22ndAve,05/24/2015 06:00:00 AM,48,-122,0,1,1
11527,58thStGreenway22ndAve,05/24/2015 07:00:00 AM,48,-122,1,0,1
11528,58thStGreenway22ndAve,05/24/2015 08:00:00 AM,48,-122,1,2,3
11529,58thStGreenway22ndAve,05/24/2015 09:00:00 AM,48,-122,3,4,7
11530,58thStGreenway22ndAve,05/24/2015 10:00:00 AM,48,-122,6,4,10
11531,58thStGreenway22ndAve,05/24/2015 11:00:00 AM,48,-122,10,1,11
11532,58thStGreenway22ndAve,05/24/2015 12:00:00 PM,48,-122,8,12,20
11533,58thStGreenway22ndAve,05/24/2015 01:00:00 PM,48,-122,4,5,9
11534,58thStGreenway22ndAve,05/24/2015 02:00:00 PM,48,-122,9,9,18
11535,58thStGreenway22ndAve,05/24/2015 03:00:00 PM,48,-122,14,8,22
11536,58thStGreenway22ndAve,05/24/2015 04:00:00 PM,48,-122,8,7,15
11537,58thStGreenway22ndAve,05/24/2015 05:00:00 PM,48,-122,8,4,12
11538,58thStGreenway22ndAve,05/24/2015 06:00:00 PM,48,-122,9,6,15
11539,58thStGreenway22ndAve,05/24/2015 07:00:00 PM,48,-122,1,3,4
11540,58thStGreenway22ndAve,05/24/2015 08:00:00 PM,48,-122,1,3,4
11541,58thStGreenway22ndAve,05/24/2015 09:00:00 PM,48,-122,2,0,2
11542,58thStGreenway22ndAve,05/24/2015 10:00:00 PM,48,-122,0,2,2
11543,58thStGreenway22ndAve,05/24/2015 11:00:00 PM,48,-122,5,1,6
11544,58thStGreenway22ndAve,05/25/2015 12:00:00 AM,48,-122,1,1,2
11545,58thStGreenway22ndAve,05/25/2015 01:00:00 AM,48,-122,0,1,1
11546,58thStGreenway22ndAve,05/25/2015 02:00:00 AM,48,-122,0,0,0
11547,58thStGreenway22ndAve,05/25/2015 03:00:00 AM,48,-122,0,0,0
11548,58thStGreenway22ndAve,05/25/2015 04:00:00 AM,48,-122,0,0,0
11549,58thStGreenway22ndAve,05/25/2015 05:00:00 AM,48,-122,0,0,0
11550,58thStGreenway22ndAve,05/25/2015 06:00:00 AM,48,-122,0,0,0
11551,58thStGreenway22ndAve,05/25/2015 07:00:00 AM,48,-122,3,0,3
11552,58thStGreenway22ndAve,05/25/2015 08:00:00 AM,48,-122,0,0,0
11553,58thStGreenway22ndAve,05/25/2015 09:00:00 AM,48,-122,2,8,10
11554,58thStGreenway22ndAve,05/25/2015 10:00:00 AM,48,-122,1,4,5
11555,58thStGreenway22ndAve,05/25/2015 11:00:00 AM,48,-122,12,5,17
11556,58thStGreenway22ndAve,05/25/2015 12:00:00 PM,48,-122,9,0,9
11557,58thStGreenway22ndAve,05/25/2015 01:00:00 PM,48,-122,3,4,7
11558,58thStGreenway22ndAve,05/25/2015 02:00:00 PM,48,-122,5,6,11
11559,58thStGreenway22ndAve,05/25/2015 03:00:00 PM,48,-122,2,7,9
11560,58thStGreenway22ndAve,05/25/2015 04:00:00 PM,48,-122,6,11,17
11561,58thStGreenway22ndAve,05/25/2015 05:00:00 PM,48,-122,5,2,7
11562,58thStGreenway22ndAve,05/25/2015 06:00:00 PM,48,-122,12,4,16
11563,58thStGreenway22ndAve,05/25/2015 07:00:00 PM,48,-122,4,0,4
11564,58thStGreenway22ndAve,05/25/2015 08:00:00 PM,48,-122,0,2,2
11565,58thStGreenway22ndAve,05/25/2015 09:00:00 PM,48,-122,1,1,2
11566,58thStGreenway22ndAve,05/25/2015 10:00:00 PM,48,-122,0,1,1
11567,58thStGreenway22ndAve,05/25/2015 11:00:00 PM,48,-122,1,0,1
11568,58thStGreenway22ndAve,05/26/2015 12:00:00 AM,48,-122,0,0,0
11569,58thStGreenway22ndAve,05/26/2015 01:00:00 AM,48,-122,0,0,0
11570,58thStGreenway22ndAve,05/26/2015 02:00:00 AM,48,-122,0,0,0
11571,58thStGreenway22ndAve,05/26/2015 03:00:00 AM,48,-122,0,0,0
11572,58thStGreenway22ndAve,05/26/2015 04:00:00 AM,48,-122,0,0,0
11573,58thStGreenway22ndAve,05/26/2015 05:00:00 AM,48,-122,0,1,1
11574,58thStGreenway22ndAve,05/26/2015 06:00:00 AM,48,-122,0,1,1
11575,58thStGreenway22ndAve,05/26/2015 07:00:00 AM,48,-122,8,5,13
11576,58thStGreenway22ndAve,05/26/2015 08:00:00 AM,48,-122,9,10,19
11577,58thStGreenway22ndAve,05/26/2015 09:00:00 AM,48,-122,7,9,16
11578,58thStGreenway22ndAve,05/26/2015 10:00:00 AM,48,-122,2,5,7
11579,58thStGreenway22ndAve,05/26/2015 11:00:00 AM,48,-122,3,3,6
11580,58thStGreenway22ndAve,05/26/2015 12:00:00 PM,48,-122,3,6,9
11581,58thStGreenway22ndAve,05/26/2015 01:00:00 PM,48,-122,6,2,8
11582,58thStGreenway22ndAve,05/26/2015 02:00:00 PM,48,-122,3,4,7
11583,58thStGreenway22ndAve,05/26/2015 03:00:00 PM,48,-122,7,5,12
11584,58thStGreenway22ndAve,05/26/2015 04:00:00 PM,48,-122,9,9,18
11585,58thStGreenway22ndAve,05/26/2015 05:00:00 PM,48,-122,13,10,23
11586,58thStGreenway22ndAve,05/26/2015 06:00:00 PM,48,-122,10,9,19
11587,58thStGreenway22ndAve,05/26/2015 07:00:00 PM,48,-122,9,8,17
11588,58thStGreenway22ndAve,05/26/2015 08:00:00 PM,48,-122,7,2,9
11589,58thStGreenway22ndAve,05/26/2015 09:00:00 PM,48,-122,3,4,7
11590,58thStGreenway22ndAve,05/26/2015 10:00:00 PM,48,-122,0,1,1
11591,58thStGreenway22ndAve,05/26/2015 11:00:00 PM,48,-122,4,1,5
11592,58thStGreenway22ndAve,05/27/2015 12:00:00 AM,48,-122,3,2,5
11593,58thStGreenway22ndAve,05/27/2015 01:00:00 AM,48,-122,0,0,0
11594,58thStGreenway22ndAve,05/27/2015 02:00:00 AM,48,-122,0,1,1
11595,58thStGreenway22ndAve,05/27/2015 03:00:00 AM,48,-122,0,0,0
11596,58thStGreenway22ndAve,05/27/2015 04:00:00 AM,48,-122,0,1,1
11597,58thStGreenway22ndAve,05/27/2015 05:00:00 AM,48,-122,0,0,0
11598,58thStGreenway22ndAve,05/27/2015 06:00:00 AM,48,-122,1,2,3
11599,58thStGreenway22ndAve,05/27/2015 07:00:00 AM,48,-122,3,6,9
11600,58thStGreenway22ndAve,05/27/2015 08:00:00 AM,48,-122,15,8,23
11601,58thStGreenway22ndAve,05/27/2015 09:00:00 AM,48,-122,4,5,9
11602,58thStGreenway22ndAve,05/27/2015 10:00:00 AM,48,-122,2,7,9
11603,58thStGreenway22ndAve,05/27/2015 11:00:00 AM,48,-122,4,2,6
11604,58thStGreenway22ndAve,05/27/2015 12:00:00 PM,48,-122,7,5,12
11605,58thStGreenway22ndAve,05/27/2015 01:00:00 PM,48,-122,2,2,4
11606,58thStGreenway22ndAve,05/27/2015 02:00:00 PM,48,-122,5,8,13
11607,58thStGreenway22ndAve,05/27/2015 03:00:00 PM,48,-122,3,6,9
11608,58thStGreenway22ndAve,05/27/2015 04:00:00 PM,48,-122,8,5,13
11609,58thStGreenway22ndAve,05/27/2015 05:00:00 PM,48,-122,21,13,34
11610,58thStGreenway22ndAve,05/27/2015 06:00:00 PM,48,-122,12,7,19
11611,58thStGreenway22ndAve,05/27/2015 07:00:00 PM,48,-122,15,12,27
11612,58thStGreenway22ndAve,05/27/2015 08:00:00 PM,48,-122,3,4,7
11613,58thStGreenway22ndAve,05/27/2015 09:00:00 PM,48,-122,6,3,9
11614,58thStGreenway22ndAve,05/27/2015 10:00:00 PM,48,-122,3,0,3
11615,58thStGreenway22ndAve,05/27/2015 11:00:00 PM,48,-122,0,1,1
11616,58thStGreenway22ndAve,05/28/2015 12:00:00 AM,48,-122,0,0,0
11617,58thStGreenway22ndAve,05/28/2015 01:00:00 AM,48,-122,0,0,0
11618,58thStGreenway22ndAve,05/28/2015 02:00:00 AM,48,-122,0,0,0
11619,58thStGreenway22ndAve,05/28/2015 03:00:00 AM,48,-122,0,0,0
11620,58thStGreenway22ndAve,05/28/2015 04:00:00 AM,48,-122,0,1,1
11621,58thStGreenway22ndAve,05/28/2015 05:00:00 AM,48,-122,0,0,0
11622,58thStGreenway22ndAve,05/28/2015 06:00:00 AM,48,-122,0,2,2
11623,58thStGreenway22ndAve,05/28/2015 07:00:00 AM,48,-122,8,6,14
11624,58thStGreenway22ndAve,05/28/2015 08:00:00 AM,48,-122,9,7,16
11625,58thStGreenway22ndAve,05/28/2015 09:00:00 AM,48,-122,8,4,12
11626,58thStGreenway22ndAve,05/28/2015 10:00:00 AM,48,-122,3,8,11
11627,58thStGreenway22ndAve,05/28/2015 11:00:00 AM,48,-122,5,3,8
11628,58thStGreenway22ndAve,05/28/2015 12:00:00 PM,48,-122,3,4,7
11629,58thStGreenway22ndAve,05/28/2015 01:00:00 PM,48,-122,8,5,13
11630,58thStGreenway22ndAve,05/28/2015 02:00:00 PM,48,-122,5,4,9
11631,58thStGreenway22ndAve,05/28/2015 03:00:00 PM,48,-122,2,1,3
11632,58thStGreenway22ndAve,05/28/2015 04:00:00 PM,48,-122,4,9,13
11633,58thStGreenway22ndAve,05/28/2015 05:00:00 PM,48,-122,4,8,12
11634,58thStGreenway22ndAve,05/28/2015 06:00:00 PM,48,-122,8,11,19
11635,58thStGreenway22ndAve,05/28/2015 07:00:00 PM,48,-122,6,8,14
11636,58thStGreenway22ndAve,05/28/2015 08:00:00 PM,48,-122,6,5,11
11637,58thStGreenway22ndAve,05/28/2015 09:00:00 PM,48,-122,5,2,7
11638,58thStGreenway22ndAve,05/28/2015 10:00:00 PM,48,-122,1,2,3
11639,58thStGreenway22ndAve,05/28/2015 11:00:00 PM,48,-122,1,0,1
11640,58thStGreenway22ndAve,05/29/2015 12:00:00 AM,48,-122,1,0,1
11641,58thStGreenway22ndAve,05/29/2015 01:00:00 AM,48,-122,0,0,0
11642,58thStGreenway22ndAve,05/29/2015 02:00:00 AM,48,-122,0,0,0
11643,58thStGreenway22ndAve,05/29/2015 03:00:00 AM,48,-122,0,0,0
11644,58thStGreenway22ndAve,05/29/2015 04:00:00 AM,48,-122,0,1,1
11645,58thStGreenway22ndAve,05/29/2015 05:00:00 AM,48,-122,1,2,3
11646,58thStGreenway22ndAve,05/29/2015 06:00:00 AM,48,-122,2,1,3
11647,58thStGreenway22ndAve,05/29/2015 07:00:00 AM,48,-122,7,8,15
11648,58thStGreenway22ndAve,05/29/2015 08:00:00 AM,48,-122,3,9,12
11649,58thStGreenway22ndAve,05/29/2015 09:00:00 AM,48,-122,1,4,5
11650,58thStGreenway22ndAve,05/29/2015 10:00:00 AM,48,-122,1,5,6
11651,58thStGreenway22ndAve,05/29/2015 11:00:00 AM,48,-122,4,6,10
11652,58thStGreenway22ndAve,05/29/2015 12:00:00 PM,48,-122,3,0,3
11653,58thStGreenway22ndAve,05/29/2015 01:00:00 PM,48,-122,2,0,2
11654,58thStGreenway22ndAve,05/29/2015 02:00:00 PM,48,-122,11,4,15
11655,58thStGreenway22ndAve,05/29/2015 03:00:00 PM,48,-122,6,6,12
11656,58thStGreenway22ndAve,05/29/2015 04:00:00 PM,48,-122,11,12,23
11657,58thStGreenway22ndAve,05/29/2015 05:00:00 PM,48,-122,16,8,24
11658,58thStGreenway22ndAve,05/29/2015 06:00:00 PM,48,-122,8,10,18
11659,58thStGreenway22ndAve,05/29/2015 07:00:00 PM,48,-122,8,4,12
11660,58thStGreenway22ndAve,05/29/2015 08:00:00 PM,48,-122,7,12,19
11661,58thStGreenway22ndAve,05/29/2015 09:00:00 PM,48,-122,2,1,3
11662,58thStGreenway22ndAve,05/29/2015 10:00:00 PM,48,-122,0,5,5
11663,58thStGreenway22ndAve,05/29/2015 11:00:00 PM,48,-122,2,2,4
11664,58thStGreenway22ndAve,05/30/2015 12:00:00 AM,48,-122,2,0,2
11665,58thStGreenway22ndAve,05/30/2015 01:00:00 AM,48,-122,0,0,0
11666,58thStGreenway22ndAve,05/30/2015 02:00:00 AM,48,-122,0,0,0
11667,58thStGreenway22ndAve,05/30/2015 03:00:00 AM,48,-122,0,0,0
11668,58thStGreenway22ndAve,05/30/2015 04:00:00 AM,48,-122,0,0,0
11669,58thStGreenway22ndAve,05/30/2015 05:00:00 AM,48,-122,0,0,0
11670,58thStGreenway22ndAve,05/30/2015 06:00:00 AM,48,-122,1,0,1
11671,58thStGreenway22ndAve,05/30/2015 07:00:00 AM,48,-122,0,0,0
11672,58thStGreenway22ndAve,05/30/2015 08:00:00 AM,48,-122,0,2,2
11673,58thStGreenway22ndAve,05/30/2015 09:00:00 AM,48,-122,1,5,6
11674,58thStGreenway22ndAve,05/30/2015 10:00:00 AM,48,-122,5,4,9
11675,58thStGreenway22ndAve,05/30/2015 11:00:00 AM,48,-122,3,6,9
11676,58thStGreenway22ndAve,05/30/2015 12:00:00 PM,48,-122,8,12,20
11677,58thStGreenway22ndAve,05/30/2015 01:00:00 PM,48,-122,9,6,15
11678,58thStGreenway22ndAve,05/30/2015 02:00:00 PM,48,-122,21,17,38
11679,58thStGreenway22ndAve,05/30/2015 03:00:00 PM,48,-122,2,17,19
11680,58thStGreenway22ndAve,05/30/2015 04:00:00 PM,48,-122,12,8,20
11681,58thStGreenway22ndAve,05/30/2015 05:00:00 PM,48,-122,16,8,24
11682,58thStGreenway22ndAve,05/30/2015 06:00:00 PM,48,-122,9,5,14
11683,58thStGreenway22ndAve,05/30/2015 07:00:00 PM,48,-122,7,5,12
11684,58thStGreenway22ndAve,05/30/2015 08:00:00 PM,48,-122,4,6,10
11685,58thStGreenway22ndAve,05/30/2015 09:00:00 PM,48,-122,5,2,7
11686,58thStGreenway22ndAve,05/30/2015 10:00:00 PM,48,-122,1,4,5
11687,58thStGreenway22ndAve,05/30/2015 11:00:00 PM,48,-122,1,3,4
11688,58thStGreenway22ndAve,05/31/2015 12:00:00 AM,48,-122,0,2,2
11689,58thStGreenway22ndAve,05/31/2015 01:00:00 AM,48,-122,4,1,5
11690,58thStGreenway22ndAve,05/31/2015 02:00:00 AM,48,-122,0,0,0
11691,58thStGreenway22ndAve,05/31/2015 03:00:00 AM,48,-122,0,0,0
11692,58thStGreenway22ndAve,05/31/2015 04:00:00 AM,48,-122,0,0,0
11693,58thStGreenway22ndAve,05/31/2015 05:00:00 AM,48,-122,1,1,2
11694,58thStGreenway22ndAve,05/31/2015 06:00:00 AM,48,-122,3,0,3
11695,58thStGreenway22ndAve,05/31/2015 07:00:00 AM,48,-122,1,4,5
11696,58thStGreenway22ndAve,05/31/2015 08:00:00 AM,48,-122,3,2,5
11697,58thStGreenway22ndAve,05/31/2015 09:00:00 AM,48,-122,3,2,5
11698,58thStGreenway22ndAve,05/31/2015 10:00:00 AM,48,-122,11,14,25
11699,58thStGreenway22ndAve,05/31/2015 11:00:00 AM,48,-122,21,15,36
11700,58thStGreenway22ndAve,05/31/2015 12:00:00 PM,48,-122,7,14,21
11701,58thStGreenway22ndAve,05/31/2015 01:00:00 PM,48,-122,20,7,27
11702,58thStGreenway22ndAve,05/31/2015 02:00:00 PM,48,-122,8,7,15
11703,58thStGreenway22ndAve,05/31/2015 03:00:00 PM,48,-122,6,10,16
11704,58thStGreenway22ndAve,05/31/2015 04:00:00 PM,48,-122,18,5,23
11705,58thStGreenway22ndAve,05/31/2015 05:00:00 PM,48,-122,16,7,23
11706,58thStGreenway22ndAve,05/31/2015 06:00:00 PM,48,-122,7,3,10
11707,58thStGreenway22ndAve,05/31/2015 07:00:00 PM,48,-122,6,4,10
11708,58thStGreenway22ndAve,05/31/2015 08:00:00 PM,48,-122,2,4,6
11709,58thStGreenway22ndAve,05/31/2015 09:00:00 PM,48,-122,3,1,4
11710,58thStGreenway22ndAve,05/31/2015 10:00:00 PM,48,-122,1,1,2
11711,58thStGreenway22ndAve,05/31/2015 11:00:00 PM,48,-122,1,0,1
11712,58thStGreenway22ndAve,06/01/2015 12:00:00 AM,48,-122,0,0,0
11713,58thStGreenway22ndAve,06/01/2015 01:00:00 AM,48,-122,0,2,2
11714,58thStGreenway22ndAve,06/01/2015 02:00:00 AM,48,-122,0,0,0
11715,58thStGreenway22ndAve,06/01/2015 03:00:00 AM,48,-122,0,0,0
11716,58thStGreenway22ndAve,06/01/2015 04:00:00 AM,48,-122,0,0,0
11717,58thStGreenway22ndAve,06/01/2015 05:00:00 AM,48,-122,0,1,1
11718,58thStGreenway22ndAve,06/01/2015 06:00:00 AM,48,-122,1,1,2
11719,58thStGreenway22ndAve,06/01/2015 07:00:00 AM,48,-122,2,3,5
11720,58thStGreenway22ndAve,06/01/2015 08:00:00 AM,48,-122,1,8,9
11721,58thStGreenway22ndAve,06/01/2015 09:00:00 AM,48,-122,5,3,8
11722,58thStGreenway22ndAve,06/01/2015 10:00:00 AM,48,-122,1,3,4
11723,58thStGreenway22ndAve,06/01/2015 11:00:00 AM,48,-122,1,0,1
11724,58thStGreenway22ndAve,06/01/2015 12:00:00 PM,48,-122,2,1,3
11725,58thStGreenway22ndAve,06/01/2015 01:00:00 PM,48,-122,5,2,7
11726,58thStGreenway22ndAve,06/01/2015 02:00:00 PM,48,-122,6,2,8
11727,58thStGreenway22ndAve,06/01/2015 03:00:00 PM,48,-122,3,5,8
11728,58thStGreenway22ndAve,06/01/2015 04:00:00 PM,48,-122,5,0,5
11729,58thStGreenway22ndAve,06/01/2015 05:00:00 PM,48,-122,3,3,6
11730,58thStGreenway22ndAve,06/01/2015 06:00:00 PM,48,-122,7,6,13
11731,58thStGreenway22ndAve,06/01/2015 07:00:00 PM,48,-122,4,5,9
11732,58thStGreenway22ndAve,06/01/2015 08:00:00 PM,48,-122,4,3,7
11733,58thStGreenway22ndAve,06/01/2015 09:00:00 PM,48,-122,1,0,1
11734,58thStGreenway22ndAve,06/01/2015 10:00:00 PM,48,-122,1,0,1
11735,58thStGreenway22ndAve,06/01/2015 11:00:00 PM,48,-122,0,0,0
11736,58thStGreenway22ndAve,06/02/2015 12:00:00 AM,48,-122,0,0,0
11737,58thStGreenway22ndAve,06/02/2015 01:00:00 AM,48,-122,0,0,0
11738,58thStGreenway22ndAve,06/02/2015 02:00:00 AM,48,-122,0,0,0
11739,58thStGreenway22ndAve,06/02/2015 03:00:00 AM,48,-122,0,0,0
11740,58thStGreenway22ndAve,06/02/2015 04:00:00 AM,48,-122,0,0,0
11741,58thStGreenway22ndAve,06/02/2015 05:00:00 AM,48,-122,0,1,1
11742,58thStGreenway22ndAve,06/02/2015 06:00:00 AM,48,-122,0,1,1
11743,58thStGreenway22ndAve,06/02/2015 07:00:00 AM,48,-122,9,4,13
11744,58thStGreenway22ndAve,06/02/2015 08:00:00 AM,48,-122,2,4,6
11745,58thStGreenway22ndAve,06/02/2015 09:00:00 AM,48,-122,2,5,7
11746,58thStGreenway22ndAve,06/02/2015 10:00:00 AM,48,-122,2,6,8
11747,58thStGreenway22ndAve,06/02/2015 11:00:00 AM,48,-122,7,0,7
11748,58thStGreenway22ndAve,06/02/2015 12:00:00 PM,48,-122,4,5,9
11749,58thStGreenway22ndAve,06/02/2015 01:00:00 PM,48,-122,0,1,1
11750,58thStGreenway22ndAve,06/02/2015 02:00:00 PM,48,-122,3,2,5
11751,58thStGreenway22ndAve,06/02/2015 03:00:00 PM,48,-122,4,4,8
11752,58thStGreenway22ndAve,06/02/2015 04:00:00 PM,48,-122,4,7,11
11753,58thStGreenway22ndAve,06/02/2015 05:00:00 PM,48,-122,8,2,10
11754,58thStGreenway22ndAve,06/02/2015 06:00:00 PM,48,-122,9,7,16
11755,58thStGreenway22ndAve,06/02/2015 07:00:00 PM,48,-122,1,9,10
11756,58thStGreenway22ndAve,06/02/2015 08:00:00 PM,48,-122,3,2,5
11757,58thStGreenway22ndAve,06/02/2015 09:00:00 PM,48,-122,4,1,5
11758,58thStGreenway22ndAve,06/02/2015 10:00:00 PM,48,-122,0,0,0
11759,58thStGreenway22ndAve,06/02/2015 11:00:00 PM,48,-122,0,0,0
11760,58thStGreenway22ndAve,06/03/2015 12:00:00 AM,48,-122,0,0,0
11761,58thStGreenway22ndAve,06/03/2015 01:00:00 AM,48,-122,0,1,1
11762,58thStGreenway22ndAve,06/03/2015 02:00:00 AM,48,-122,0,1,1
11763,58thStGreenway22ndAve,06/03/2015 03:00:00 AM,48,-122,1,1,2
11764,58thStGreenway22ndAve,06/03/2015 04:00:00 AM,48,-122,0,0,0
11765,58thStGreenway22ndAve,06/03/2015 05:00:00 AM,48,-122,0,1,1
11766,58thStGreenway22ndAve,06/03/2015 06:00:00 AM,48,-122,3,3,6
11767,58thStGreenway22ndAve,06/03/2015 07:00:00 AM,48,-122,2,4,6
11768,58thStGreenway22ndAve,06/03/2015 08:00:00 AM,48,-122,3,5,8
11769,58thStGreenway22ndAve,06/03/2015 09:00:00 AM,48,-122,3,2,5
11770,58thStGreenway22ndAve,06/03/2015 10:00:00 AM,48,-122,4,1,5
11771,58thStGreenway22ndAve,06/03/2015 11:00:00 AM,48,-122,5,3,8
11772,58thStGreenway22ndAve,06/03/2015 12:00:00 PM,48,-122,2,1,3
11773,58thStGreenway22ndAve,06/03/2015 01:00:00 PM,48,-122,5,3,8
11774,58thStGreenway22ndAve,06/03/2015 02:00:00 PM,48,-122,7,7,14
11775,58thStGreenway22ndAve,06/03/2015 03:00:00 PM,48,-122,1,4,5
11776,58thStGreenway22ndAve,06/03/2015 04:00:00 PM,48,-122,7,2,9
11777,58thStGreenway22ndAve,06/03/2015 05:00:00 PM,48,-122,10,12,22
11778,58thStGreenway22ndAve,06/03/2015 06:00:00 PM,48,-122,15,8,23
11779,58thStGreenway22ndAve,06/03/2015 07:00:00 PM,48,-122,8,7,15
11780,58thStGreenway22ndAve,06/03/2015 08:00:00 PM,48,-122,6,1,7
11781,58thStGreenway22ndAve,06/03/2015 09:00:00 PM,48,-122,1,4,5
11782,58thStGreenway22ndAve,06/03/2015 10:00:00 PM,48,-122,2,1,3
11783,58thStGreenway22ndAve,06/03/2015 11:00:00 PM,48,-122,0,0,0
11784,58thStGreenway22ndAve,06/04/2015 12:00:00 AM,48,-122,0,0,0
11785,58thStGreenway22ndAve,06/04/2015 01:00:00 AM,48,-122,0,0,0
11786,58thStGreenway22ndAve,06/04/2015 02:00:00 AM,48,-122,0,0,0
11787,58thStGreenway22ndAve,06/04/2015 03:00:00 AM,48,-122,0,0,0
11788,58thStGreenway22ndAve,06/04/2015 04:00:00 AM,48,-122,0,0,0
11789,58thStGreenway22ndAve,06/04/2015 05:00:00 AM,48,-122,0,1,1
11790,58thStGreenway22ndAve,06/04/2015 06:00:00 AM,48,-122,3,4,7
11791,58thStGreenway22ndAve,06/04/2015 07:00:00 AM,48,-122,3,6,9
11792,58thStGreenway22ndAve,06/04/2015 08:00:00 AM,48,-122,4,7,11
11793,58thStGreenway22ndAve,06/04/2015 09:00:00 AM,48,-122,4,8,12
11794,58thStGreenway22ndAve,06/04/2015 10:00:00 AM,48,-122,2,1,3
11795,58thStGreenway22ndAve,06/04/2015 11:00:00 AM,48,-122,4,0,4
11796,58thStGreenway22ndAve,06/04/2015 12:00:00 PM,48,-122,3,3,6
11797,58thStGreenway22ndAve,06/04/2015 01:00:00 PM,48,-122,2,3,5
11798,58thStGreenway22ndAve,06/04/2015 02:00:00 PM,48,-122,7,7,14
11799,58thStGreenway22ndAve,06/04/2015 03:00:00 PM,48,-122,6,1,7
11800,58thStGreenway22ndAve,06/04/2015 04:00:00 PM,48,-122,13,9,22
11801,58thStGreenway22ndAve,06/04/2015 05:00:00 PM,48,-122,14,7,21
11802,58thStGreenway22ndAve,06/04/2015 06:00:00 PM,48,-122,5,13,18
11803,58thStGreenway22ndAve,06/04/2015 07:00:00 PM,48,-122,10,5,15
11804,58thStGreenway22ndAve,06/04/2015 08:00:00 PM,48,-122,4,5,9
11805,58thStGreenway22ndAve,06/04/2015 09:00:00 PM,48,-122,2,2,4
11806,58thStGreenway22ndAve,06/04/2015 10:00:00 PM,48,-122,2,0,2
11807,58thStGreenway22ndAve,06/04/2015 11:00:00 PM,48,-122,8,1,9
11808,58thStGreenway22ndAve,06/05/2015 12:00:00 AM,48,-122,0,0,0
11809,58thStGreenway22ndAve,06/05/2015 01:00:00 AM,48,-122,1,0,1
11810,58thStGreenway22ndAve,06/05/2015 02:00:00 AM,48,-122,0,0,0
11811,58thStGreenway22ndAve,06/05/2015 03:00:00 AM,48,-122,0,0,0
11812,58thStGreenway22ndAve,06/05/2015 04:00:00 AM,48,-122,2,0,2
11813,58thStGreenway22ndAve,06/05/2015 05:00:00 AM,48,-122,3,1,4
11814,58thStGreenway22ndAve,06/05/2015 06:00:00 AM,48,-122,1,2,3
11815,58thStGreenway22ndAve,06/05/2015 07:00:00 AM,48,-122,4,2,6
11816,58thStGreenway22ndAve,06/05/2015 08:00:00 AM,48,-122,7,15,22
11817,58thStGreenway22ndAve,06/05/2015 09:00:00 AM,48,-122,4,11,15
11818,58thStGreenway22ndAve,06/05/2015 10:00:00 AM,48,-122,6,6,12
11819,58thStGreenway22ndAve,06/05/2015 11:00:00 AM,48,-122,12,5,17
11820,58thStGreenway22ndAve,06/05/2015 12:00:00 PM,48,-122,7,2,9
11821,58thStGreenway22ndAve,06/05/2015 01:00:00 PM,48,-122,3,5,8
11822,58thStGreenway22ndAve,06/05/2015 02:00:00 PM,48,-122,6,6,12
11823,58thStGreenway22ndAve,06/05/2015 03:00:00 PM,48,-122,12,3,15
11824,58thStGreenway22ndAve,06/05/2015 04:00:00 PM,48,-122,9,8,17
11825,58thStGreenway22ndAve,06/05/2015 05:00:00 PM,48,-122,7,11,18
11826,58thStGreenway22ndAve,06/05/2015 06:00:00 PM,48,-122,8,18,26
11827,58thStGreenway22ndAve,06/05/2015 07:00:00 PM,48,-122,10,4,14
11828,58thStGreenway22ndAve,06/05/2015 08:00:00 PM,48,-122,6,5,11
11829,58thStGreenway22ndAve,06/05/2015 09:00:00 PM,48,-122,5,4,9
11830,58thStGreenway22ndAve,06/05/2015 10:00:00 PM,48,-122,3,4,7
11831,58thStGreenway22ndAve,06/05/2015 11:00:00 PM,48,-122,0,1,1
11832,58thStGreenway22ndAve,06/06/2015 12:00:00 AM,48,-122,4,0,4
11833,58thStGreenway22ndAve,06/06/2015 01:00:00 AM,48,-122,1,1,2
11834,58thStGreenway22ndAve,06/06/2015 02:00:00 AM,48,-122,0,1,1
11835,58thStGreenway22ndAve,06/06/2015 03:00:00 AM,48,-122,0,0,0
11836,58thStGreenway22ndAve,06/06/2015 04:00:00 AM,48,-122,0,0,0
11837,58thStGreenway22ndAve,06/06/2015 05:00:00 AM,48,-122,0,0,0
11838,58thStGreenway22ndAve,06/06/2015 06:00:00 AM,48,-122,0,1,1
11839,58thStGreenway22ndAve,06/06/2015 07:00:00 AM,48,-122,2,2,4
11840,58thStGreenway22ndAve,06/06/2015 08:00:00 AM,48,-122,1,7,8
11841,58thStGreenway22ndAve,06/06/2015 09:00:00 AM,48,-122,6,5,11
11842,58thStGreenway22ndAve,06/06/2015 10:00:00 AM,48,-122,6,11,17
11843,58thStGreenway22ndAve,06/06/2015 11:00:00 AM,48,-122,11,10,21
11844,58thStGreenway22ndAve,06/06/2015 12:00:00 PM,48,-122,9,10,19
11845,58thStGreenway22ndAve,06/06/2015 01:00:00 PM,48,-122,3,10,13
11846,58thStGreenway22ndAve,06/06/2015 02:00:00 PM,48,-122,15,8,23
11847,58thStGreenway22ndAve,06/06/2015 03:00:00 PM,48,-122,14,9,23
11848,58thStGreenway22ndAve,06/06/2015 04:00:00 PM,48,-122,8,4,12
11849,58thStGreenway22ndAve,06/06/2015 05:00:00 PM,48,-122,10,5,15
11850,58thStGreenway22ndAve,06/06/2015 06:00:00 PM,48,-122,5,9,14
11851,58thStGreenway22ndAve,06/06/2015 07:00:00 PM,48,-122,15,6,21
11852,58thStGreenway22ndAve,06/06/2015 08:00:00 PM,48,-122,3,5,8
11853,58thStGreenway22ndAve,06/06/2015 09:00:00 PM,48,-122,8,4,12
11854,58thStGreenway22ndAve,06/06/2015 10:00:00 PM,48,-122,4,6,10
11855,58thStGreenway22ndAve,06/06/2015 11:00:00 PM,48,-122,2,1,3
11856,58thStGreenway22ndAve,06/07/2015 12:00:00 AM,48,-122,3,2,5
11857,58thStGreenway22ndAve,06/07/2015 01:00:00 AM,48,-122,1,0,1
11858,58thStGreenway22ndAve,06/07/2015 02:00:00 AM,48,-122,0,1,1
11859,58thStGreenway22ndAve,06/07/2015 03:00:00 AM,48,-122,0,0,0
11860,58thStGreenway22ndAve,06/07/2015 04:00:00 AM,48,-122,0,0,0
11861,58thStGreenway22ndAve,06/07/2015 05:00:00 AM,48,-122,0,0,0
11862,58thStGreenway22ndAve,06/07/2015 06:00:00 AM,48,-122,0,0,0
11863,58thStGreenway22ndAve,06/07/2015 07:00:00 AM,48,-122,0,3,3
11864,58thStGreenway22ndAve,06/07/2015 08:00:00 AM,48,-122,4,4,8
11865,58thStGreenway22ndAve,06/07/2015 09:00:00 AM,48,-122,7,4,11
11866,58thStGreenway22ndAve,06/07/2015 10:00:00 AM,48,-122,4,11,15
11867,58thStGreenway22ndAve,06/07/2015 11:00:00 AM,48,-122,13,15,28
11868,58thStGreenway22ndAve,06/07/2015 12:00:00 PM,48,-122,10,11,21
11869,58thStGreenway22ndAve,06/07/2015 01:00:00 PM,48,-122,5,11,16
11870,58thStGreenway22ndAve,06/07/2015 02:00:00 PM,48,-122,10,7,17
11871,58thStGreenway22ndAve,06/07/2015 03:00:00 PM,48,-122,17,16,33
11872,58thStGreenway22ndAve,06/07/2015 04:00:00 PM,48,-122,19,13,32
11873,58thStGreenway22ndAve,06/07/2015 05:00:00 PM,48,-122,9,7,16
11874,58thStGreenway22ndAve,06/07/2015 06:00:00 PM,48,-122,4,7,11
11875,58thStGreenway22ndAve,06/07/2015 07:00:00 PM,48,-122,4,3,7
11876,58thStGreenway22ndAve,06/07/2015 08:00:00 PM,48,-122,8,0,8
11877,58thStGreenway22ndAve,06/07/2015 09:00:00 PM,48,-122,4,3,7
11878,58thStGreenway22ndAve,06/07/2015 10:00:00 PM,48,-122,1,0,1
11879,58thStGreenway22ndAve,06/07/2015 11:00:00 PM,48,-122,1,0,1
11880,58thStGreenway22ndAve,06/08/2015 12:00:00 AM,48,-122,1,0,1
11881,58thStGreenway22ndAve,06/08/2015 01:00:00 AM,48,-122,0,0,0
11882,58thStGreenway22ndAve,06/08/2015 02:00:00 AM,48,-122,0,0,0
11883,58thStGreenway22ndAve,06/08/2015 03:00:00 AM,48,-122,0,0,0
11884,58thStGreenway22ndAve,06/08/2015 04:00:00 AM,48,-122,0,0,0
11885,58thStGreenway22ndAve,06/08/2015 05:00:00 AM,48,-122,0,1,1
11886,58thStGreenway22ndAve,06/08/2015 06:00:00 AM,48,-122,2,2,4
11887,58thStGreenway22ndAve,06/08/2015 07:00:00 AM,48,-122,5,3,8
11888,58thStGreenway22ndAve,06/08/2015 08:00:00 AM,48,-122,9,7,16
11889,58thStGreenway22ndAve,06/08/2015 09:00:00 AM,48,-122,3,16,19
11890,58thStGreenway22ndAve,06/08/2015 10:00:00 AM,48,-122,1,3,4
11891,58thStGreenway22ndAve,06/08/2015 11:00:00 AM,48,-122,4,9,13
11892,58thStGreenway22ndAve,06/08/2015 12:00:00 PM,48,-122,5,4,9
11893,58thStGreenway22ndAve,06/08/2015 01:00:00 PM,48,-122,2,5,7
11894,58thStGreenway22ndAve,06/08/2015 02:00:00 PM,48,-122,7,3,10
11895,58thStGreenway22ndAve,06/08/2015 03:00:00 PM,48,-122,7,4,11
11896,58thStGreenway22ndAve,06/08/2015 04:00:00 PM,48,-122,8,12,20
11897,58thStGreenway22ndAve,06/08/2015 05:00:00 PM,48,-122,18,12,30
11898,58thStGreenway22ndAve,06/08/2015 06:00:00 PM,48,-122,13,9,22
11899,58thStGreenway22ndAve,06/08/2015 07:00:00 PM,48,-122,9,7,16
11900,58thStGreenway22ndAve,06/08/2015 08:00:00 PM,48,-122,3,4,7
11901,58thStGreenway22ndAve,06/08/2015 09:00:00 PM,48,-122,5,2,7
11902,58thStGreenway22ndAve,06/08/2015 10:00:00 PM,48,-122,3,2,5
11903,58thStGreenway22ndAve,06/08/2015 11:00:00 PM,48,-122,2,0,2
11904,58thStGreenway22ndAve,06/09/2015 12:00:00 AM,48,-122,0,2,2
11905,58thStGreenway22ndAve,06/09/2015 01:00:00 AM,48,-122,0,1,1
11906,58thStGreenway22ndAve,06/09/2015 02:00:00 AM,48,-122,0,0,0
11907,58thStGreenway22ndAve,06/09/2015 03:00:00 AM,48,-122,0,0,0
11908,58thStGreenway22ndAve,06/09/2015 04:00:00 AM,48,-122,0,1,1
11909,58thStGreenway22ndAve,06/09/2015 05:00:00 AM,48,-122,0,1,1
11910,58thStGreenway22ndAve,06/09/2015 06:00:00 AM,48,-122,1,2,3
11911,58thStGreenway22ndAve,06/09/2015 07:00:00 AM,48,-122,8,2,10
11912,58thStGreenway22ndAve,06/09/2015 08:00:00 AM,48,-122,3,7,10
11913,58thStGreenway22ndAve,06/09/2015 09:00:00 AM,48,-122,6,2,8
11914,58thStGreenway22ndAve,06/09/2015 10:00:00 AM,48,-122,4,3,7
11915,58thStGreenway22ndAve,06/09/2015 11:00:00 AM,48,-122,5,5,10
11916,58thStGreenway22ndAve,06/09/2015 12:00:00 PM,48,-122,4,6,10
11917,58thStGreenway22ndAve,06/09/2015 01:00:00 PM,48,-122,3,4,7
11918,58thStGreenway22ndAve,06/09/2015 02:00:00 PM,48,-122,13,5,18
11919,58thStGreenway22ndAve,06/09/2015 03:00:00 PM,48,-122,7,7,14
11920,58thStGreenway22ndAve,06/09/2015 04:00:00 PM,48,-122,8,6,14
11921,58thStGreenway22ndAve,06/09/2015 05:00:00 PM,48,-122,17,5,22
11922,58thStGreenway22ndAve,06/09/2015 06:00:00 PM,48,-122,13,13,26
11923,58thStGreenway22ndAve,06/09/2015 07:00:00 PM,48,-122,9,11,20
11924,58thStGreenway22ndAve,06/09/2015 08:00:00 PM,48,-122,3,6,9
11925,58thStGreenway22ndAve,06/09/2015 09:00:00 PM,48,-122,12,5,17
11926,58thStGreenway22ndAve,06/09/2015 10:00:00 PM,48,-122,0,0,0
11927,58thStGreenway22ndAve,06/09/2015 11:00:00 PM,48,-122,0,0,0
11928,58thStGreenway22ndAve,06/10/2015 12:00:00 AM,48,-122,0,1,1
11929,58thStGreenway22ndAve,06/10/2015 01:00:00 AM,48,-122,0,0,0
11930,58thStGreenway22ndAve,06/10/2015 02:00:00 AM,48,-122,0,0,0
11931,58thStGreenway22ndAve,06/10/2015 03:00:00 AM,48,-122,0,0,0
11932,58thStGreenway22ndAve,06/10/2015 04:00:00 AM,48,-122,0,1,1
11933,58thStGreenway22ndAve,06/10/2015 05:00:00 AM,48,-122,0,1,1
11934,58thStGreenway22ndAve,06/10/2015 06:00:00 AM,48,-122,0,1,1
11935,58thStGreenway22ndAve,06/10/2015 07:00:00 AM,48,-122,5,6,11
11936,58thStGreenway22ndAve,06/10/2015 08:00:00 AM,48,-122,7,7,14
11937,58thStGreenway22ndAve,06/10/2015 09:00:00 AM,48,-122,6,5,11
11938,58thStGreenway22ndAve,06/10/2015 10:00:00 AM,48,-122,4,3,7
11939,58thStGreenway22ndAve,06/10/2015 11:00:00 AM,48,-122,5,4,9
11940,58thStGreenway22ndAve,06/10/2015 12:00:00 PM,48,-122,4,6,10
11941,58thStGreenway22ndAve,06/10/2015 01:00:00 PM,48,-122,5,3,8
11942,58thStGreenway22ndAve,06/10/2015 02:00:00 PM,48,-122,3,6,9
11943,58thStGreenway22ndAve,06/10/2015 03:00:00 PM,48,-122,9,4,13
11944,58thStGreenway22ndAve,06/10/2015 04:00:00 PM,48,-122,13,4,17
11945,58thStGreenway22ndAve,06/10/2015 05:00:00 PM,48,-122,10,8,18
11946,58thStGreenway22ndAve,06/10/2015 06:00:00 PM,48,-122,19,27,46
11947,58thStGreenway22ndAve,06/10/2015 07:00:00 PM,48,-122,12,8,20
11948,58thStGreenway22ndAve,06/10/2015 08:00:00 PM,48,-122,10,13,23
11949,58thStGreenway22ndAve,06/10/2015 09:00:00 PM,48,-122,10,4,14
11950,58thStGreenway22ndAve,06/10/2015 10:00:00 PM,48,-122,6,0,6
11951,58thStGreenway22ndAve,06/10/2015 11:00:00 PM,48,-122,3,1,4
11952,58thStGreenway22ndAve,06/11/2015 12:00:00 AM,48,-122,0,0,0
11953,58thStGreenway22ndAve,06/11/2015 01:00:00 AM,48,-122,0,0,0
11954,58thStGreenway22ndAve,06/11/2015 02:00:00 AM,48,-122,0,0,0
11955,58thStGreenway22ndAve,06/11/2015 03:00:00 AM,48,-122,0,0,0
11956,58thStGreenway22ndAve,06/11/2015 04:00:00 AM,48,-122,0,1,1
11957,58thStGreenway22ndAve,06/11/2015 05:00:00 AM,48,-122,0,2,2
11958,58thStGreenway22ndAve,06/11/2015 06:00:00 AM,48,-122,1,2,3
11959,58thStGreenway22ndAve,06/11/2015 07:00:00 AM,48,-122,7,6,13
11960,58thStGreenway22ndAve,06/11/2015 08:00:00 AM,48,-122,3,7,10
11961,58thStGreenway22ndAve,06/11/2015 09:00:00 AM,48,-122,7,7,14
11962,58thStGreenway22ndAve,06/11/2015 10:00:00 AM,48,-122,5,3,8
11963,58thStGreenway22ndAve,06/11/2015 11:00:00 AM,48,-122,5,4,9
11964,58thStGreenway22ndAve,06/11/2015 12:00:00 PM,48,-122,1,2,3
11965,58thStGreenway22ndAve,06/11/2015 01:00:00 PM,48,-122,4,0,4
11966,58thStGreenway22ndAve,06/11/2015 02:00:00 PM,48,-122,5,4,9
11967,58thStGreenway22ndAve,06/11/2015 03:00:00 PM,48,-122,2,7,9
11968,58thStGreenway22ndAve,06/11/2015 04:00:00 PM,48,-122,8,8,16
11969,58thStGreenway22ndAve,06/11/2015 05:00:00 PM,48,-122,8,12,20
11970,58thStGreenway22ndAve,06/11/2015 06:00:00 PM,48,-122,12,16,28
11971,58thStGreenway22ndAve,06/11/2015 07:00:00 PM,48,-122,5,11,16
11972,58thStGreenway22ndAve,06/11/2015 08:00:00 PM,48,-122,6,6,12
11973,58thStGreenway22ndAve,06/11/2015 09:00:00 PM,48,-122,2,0,2
11974,58thStGreenway22ndAve,06/11/2015 10:00:00 PM,48,-122,3,0,3
11975,58thStGreenway22ndAve,06/11/2015 11:00:00 PM,48,-122,4,0,4
11976,58thStGreenway22ndAve,06/12/2015 12:00:00 AM,48,-122,1,0,1
11977,58thStGreenway22ndAve,06/12/2015 01:00:00 AM,48,-122,0,0,0
11978,58thStGreenway22ndAve,06/12/2015 02:00:00 AM,48,-122,1,0,1
11979,58thStGreenway22ndAve,06/12/2015 03:00:00 AM,48,-122,0,0,0
11980,58thStGreenway22ndAve,06/12/2015 04:00:00 AM,48,-122,0,1,1
11981,58thStGreenway22ndAve,06/12/2015 05:00:00 AM,48,-122,1,1,2
11982,58thStGreenway22ndAve,06/12/2015 06:00:00 AM,48,-122,1,2,3
11983,58thStGreenway22ndAve,06/12/2015 07:00:00 AM,48,-122,3,3,6
11984,58thStGreenway22ndAve,06/12/2015 08:00:00 AM,48,-122,10,11,21
11985,58thStGreenway22ndAve,06/12/2015 09:00:00 AM,48,-122,4,4,8
11986,58thStGreenway22ndAve,06/12/2015 10:00:00 AM,48,-122,5,3,8
11987,58thStGreenway22ndAve,06/12/2015 11:00:00 AM,48,-122,3,3,6
11988,58thStGreenway22ndAve,06/12/2015 12:00:00 PM,48,-122,4,5,9
11989,58thStGreenway22ndAve,06/12/2015 01:00:00 PM,48,-122,7,3,10
11990,58thStGreenway22ndAve,06/12/2015 02:00:00 PM,48,-122,6,3,9
11991,58thStGreenway22ndAve,06/12/2015 03:00:00 PM,48,-122,3,8,11
11992,58thStGreenway22ndAve,06/12/2015 04:00:00 PM,48,-122,5,8,13
11993,58thStGreenway22ndAve,06/12/2015 05:00:00 PM,48,-122,9,3,12
11994,58thStGreenway22ndAve,06/12/2015 06:00:00 PM,48,-122,10,10,20
11995,58thStGreenway22ndAve,06/12/2015 07:00:00 PM,48,-122,7,2,9
11996,58thStGreenway22ndAve,06/12/2015 08:00:00 PM,48,-122,5,3,8
11997,58thStGreenway22ndAve,06/12/2015 09:00:00 PM,48,-122,1,0,1
11998,58thStGreenway22ndAve,06/12/2015 10:00:00 PM,48,-122,3,0,3
11999,58thStGreenway22ndAve,06/12/2015 11:00:00 PM,48,-122,3,0,3
12000,58thStGreenway22ndAve,06/13/2015 12:00:00 AM,48,-122,1,0,1
12001,58thStGreenway22ndAve,06/13/2015 01:00:00 AM,48,-122,1,1,2
12002,58thStGreenway22ndAve,06/13/2015 02:00:00 AM,48,-122,0,0,0
12003,58thStGreenway22ndAve,06/13/2015 03:00:00 AM,48,-122,0,0,0
12004,58thStGreenway22ndAve,06/13/2015 04:00:00 AM,48,-122,0,0,0
12005,58thStGreenway22ndAve,06/13/2015 05:00:00 AM,48,-122,0,0,0
12006,58thStGreenway22ndAve,06/13/2015 06:00:00 AM,48,-122,0,2,2
12007,58thStGreenway22ndAve,06/13/2015 07:00:00 AM,48,-122,1,3,4
12008,58thStGreenway22ndAve,06/13/2015 08:00:00 AM,48,-122,1,3,4
12009,58thStGreenway22ndAve,06/13/2015 09:00:00 AM,48,-122,5,4,9
12010,58thStGreenway22ndAve,06/13/2015 10:00:00 AM,48,-122,6,6,12
12011,58thStGreenway22ndAve,06/13/2015 11:00:00 AM,48,-122,10,8,18
12012,58thStGreenway22ndAve,06/13/2015 12:00:00 PM,48,-122,1,21,22
12013,58thStGreenway22ndAve,06/13/2015 01:00:00 PM,48,-122,13,8,21
12014,58thStGreenway22ndAve,06/13/2015 02:00:00 PM,48,-122,13,10,23
12015,58thStGreenway22ndAve,06/13/2015 03:00:00 PM,48,-122,4,4,8
12016,58thStGreenway22ndAve,06/13/2015 04:00:00 PM,48,-122,17,4,21
12017,58thStGreenway22ndAve,06/13/2015 05:00:00 PM,48,-122,7,11,18
12018,58thStGreenway22ndAve,06/13/2015 06:00:00 PM,48,-122,6,7,13
12019,58thStGreenway22ndAve,06/13/2015 07:00:00 PM,48,-122,4,6,10
12020,58thStGreenway22ndAve,06/13/2015 08:00:00 PM,48,-122,7,2,9
12021,58thStGreenway22ndAve,06/13/2015 09:00:00 PM,48,-122,5,2,7
12022,58thStGreenway22ndAve,06/13/2015 10:00:00 PM,48,-122,4,0,4
12023,58thStGreenway22ndAve,06/13/2015 11:00:00 PM,48,-122,1,0,1
12024,58thStGreenway22ndAve,06/14/2015 12:00:00 AM,48,-122,4,0,4
12025,58thStGreenway22ndAve,06/14/2015 01:00:00 AM,48,-122,5,0,5
12026,58thStGreenway22ndAve,06/14/2015 02:00:00 AM,48,-122,0,0,0
12027,58thStGreenway22ndAve,06/14/2015 03:00:00 AM,48,-122,1,0,1
12028,58thStGreenway22ndAve,06/14/2015 04:00:00 AM,48,-122,0,0,0
12029,58thStGreenway22ndAve,06/14/2015 05:00:00 AM,48,-122,0,2,2
12030,58thStGreenway22ndAve,06/14/2015 06:00:00 AM,48,-122,1,0,1
12031,58thStGreenway22ndAve,06/14/2015 07:00:00 AM,48,-122,0,0,0
12032,58thStGreenway22ndAve,06/14/2015 08:00:00 AM,48,-122,7,3,10
12033,58thStGreenway22ndAve,06/14/2015 09:00:00 AM,48,-122,6,6,12
12034,58thStGreenway22ndAve,06/14/2015 10:00:00 AM,48,-122,6,9,15
12035,58thStGreenway22ndAve,06/14/2015 11:00:00 AM,48,-122,11,7,18
12036,58thStGreenway22ndAve,06/14/2015 12:00:00 PM,48,-122,11,11,22
12037,58thStGreenway22ndAve,06/14/2015 01:00:00 PM,48,-122,9,13,22
12038,58thStGreenway22ndAve,06/14/2015 02:00:00 PM,48,-122,6,11,17
12039,58thStGreenway22ndAve,06/14/2015 03:00:00 PM,48,-122,17,5,22
12040,58thStGreenway22ndAve,06/14/2015 04:00:00 PM,48,-122,8,14,22
12041,58thStGreenway22ndAve,06/14/2015 05:00:00 PM,48,-122,8,7,15
12042,58thStGreenway22ndAve,06/14/2015 06:00:00 PM,48,-122,7,4,11
12043,58thStGreenway22ndAve,06/14/2015 07:00:00 PM,48,-122,7,5,12
12044,58thStGreenway22ndAve,06/14/2015 08:00:00 PM,48,-122,6,2,8
12045,58thStGreenway22ndAve,06/14/2015 09:00:00 PM,48,-122,2,3,5
12046,58thStGreenway22ndAve,06/14/2015 10:00:00 PM,48,-122,2,0,2
12047,58thStGreenway22ndAve,06/14/2015 11:00:00 PM,48,-122,1,0,1
12048,58thStGreenway22ndAve,06/15/2015 12:00:00 AM,48,-122,1,0,1
12049,58thStGreenway22ndAve,06/15/2015 01:00:00 AM,48,-122,0,0,0
12050,58thStGreenway22ndAve,06/15/2015 02:00:00 AM,48,-122,0,1,1
12051,58thStGreenway22ndAve,06/15/2015 03:00:00 AM,48,-122,0,0,0
12052,58thStGreenway22ndAve,06/15/2015 04:00:00 AM,48,-122,0,1,1
12053,58thStGreenway22ndAve,06/15/2015 05:00:00 AM,48,-122,1,1,2
12054,58thStGreenway22ndAve,06/15/2015 06:00:00 AM,48,-122,2,1,3
12055,58thStGreenway22ndAve,06/15/2015 07:00:00 AM,48,-122,2,5,7
12056,58thStGreenway22ndAve,06/15/2015 08:00:00 AM,48,-122,7,8,15
12057,58thStGreenway22ndAve,06/15/2015 09:00:00 AM,48,-122,1,7,8
12058,58thStGreenway22ndAve,06/15/2015 10:00:00 AM,48,-122,10,5,15
12059,58thStGreenway22ndAve,06/15/2015 11:00:00 AM,48,-122,2,3,5
12060,58thStGreenway22ndAve,06/15/2015 12:00:00 PM,48,-122,7,2,9
12061,58thStGreenway22ndAve,06/15/2015 01:00:00 PM,48,-122,7,6,13
12062,58thStGreenway22ndAve,06/15/2015 02:00:00 PM,48,-122,10,4,14
12063,58thStGreenway22ndAve,06/15/2015 03:00:00 PM,48,-122,5,5,10
12064,58thStGreenway22ndAve,06/15/2015 04:00:00 PM,48,-122,6,9,15
12065,58thStGreenway22ndAve,06/15/2015 05:00:00 PM,48,-122,17,8,25
12066,58thStGreenway22ndAve,06/15/2015 06:00:00 PM,48,-122,3,8,11
12067,58thStGreenway22ndAve,06/15/2015 07:00:00 PM,48,-122,2,8,10
12068,58thStGreenway22ndAve,06/15/2015 08:00:00 PM,48,-122,3,3,6
12069,58thStGreenway22ndAve,06/15/2015 09:00:00 PM,48,-122,4,3,7
12070,58thStGreenway22ndAve,06/15/2015 10:00:00 PM,48,-122,6,2,8
12071,58thStGreenway22ndAve,06/15/2015 11:00:00 PM,48,-122,1,0,1
12072,58thStGreenway22ndAve,06/16/2015 12:00:00 AM,48,-122,1,0,1
12073,58thStGreenway22ndAve,06/16/2015 01:00:00 AM,48,-122,0,0,0
12074,58thStGreenway22ndAve,06/16/2015 02:00:00 AM,48,-122,0,1,1
12075,58thStGreenway22ndAve,06/16/2015 03:00:00 AM,48,-122,0,0,0
12076,58thStGreenway22ndAve,06/16/2015 04:00:00 AM,48,-122,0,1,1
12077,58thStGreenway22ndAve,06/16/2015 05:00:00 AM,48,-122,0,1,1
12078,58thStGreenway22ndAve,06/16/2015 06:00:00 AM,48,-122,2,1,3
12079,58thStGreenway22ndAve,06/16/2015 07:00:00 AM,48,-122,5,3,8
12080,58thStGreenway22ndAve,06/16/2015 08:00:00 AM,48,-122,7,8,15
12081,58thStGreenway22ndAve,06/16/2015 09:00:00 AM,48,-122,3,9,12
12082,58thStGreenway22ndAve,06/16/2015 10:00:00 AM,48,-122,4,6,10
12083,58thStGreenway22ndAve,06/16/2015 11:00:00 AM,48,-122,2,5,7
12084,58thStGreenway22ndAve,06/16/2015 12:00:00 PM,48,-122,6,3,9
12085,58thStGreenway22ndAve,06/16/2015 01:00:00 PM,48,-122,3,2,5
12086,58thStGreenway22ndAve,06/16/2015 02:00:00 PM,48,-122,3,4,7
12087,58thStGreenway22ndAve,06/16/2015 03:00:00 PM,48,-122,3,6,9
12088,58thStGreenway22ndAve,06/16/2015 04:00:00 PM,48,-122,12,6,18
12089,58thStGreenway22ndAve,06/16/2015 05:00:00 PM,48,-122,14,1,15
12090,58thStGreenway22ndAve,06/16/2015 06:00:00 PM,48,-122,7,14,21
12091,58thStGreenway22ndAve,06/16/2015 07:00:00 PM,48,-122,10,3,13
12092,58thStGreenway22ndAve,06/16/2015 08:00:00 PM,48,-122,7,3,10
12093,58thStGreenway22ndAve,06/16/2015 09:00:00 PM,48,-122,4,2,6
12094,58thStGreenway22ndAve,06/16/2015 10:00:00 PM,48,-122,3,2,5
12095,58thStGreenway22ndAve,06/16/2015 11:00:00 PM,48,-122,2,1,3
12096,58thStGreenway22ndAve,06/17/2015 12:00:00 AM,48,-122,0,0,0
12097,58thStGreenway22ndAve,06/17/2015 01:00:00 AM,48,-122,0,0,0
12098,58thStGreenway22ndAve,06/17/2015 02:00:00 AM,48,-122,1,0,1
12099,58thStGreenway22ndAve,06/17/2015 03:00:00 AM,48,-122,0,0,0
12100,58thStGreenway22ndAve,06/17/2015 04:00:00 AM,48,-122,0,1,1
12101,58thStGreenway22ndAve,06/17/2015 05:00:00 AM,48,-122,1,1,2
12102,58thStGreenway22ndAve,06/17/2015 06:00:00 AM,48,-122,2,3,5
12103,58thStGreenway22ndAve,06/17/2015 07:00:00 AM,48,-122,4,5,9
12104,58thStGreenway22ndAve,06/17/2015 08:00:00 AM,48,-122,2,7,9
12105,58thStGreenway22ndAve,06/17/2015 09:00:00 AM,48,-122,4,8,12
12106,58thStGreenway22ndAve,06/17/2015 10:00:00 AM,48,-122,7,2,9
12107,58thStGreenway22ndAve,06/17/2015 11:00:00 AM,48,-122,6,4,10
12108,58thStGreenway22ndAve,06/17/2015 12:00:00 PM,48,-122,9,2,11
12109,58thStGreenway22ndAve,06/17/2015 01:00:00 PM,48,-122,3,6,9
12110,58thStGreenway22ndAve,06/17/2015 02:00:00 PM,48,-122,2,9,11
12111,58thStGreenway22ndAve,06/17/2015 03:00:00 PM,48,-122,5,4,9
12112,58thStGreenway22ndAve,06/17/2015 04:00:00 PM,48,-122,10,5,15
12113,58thStGreenway22ndAve,06/17/2015 05:00:00 PM,48,-122,14,7,21
12114,58thStGreenway22ndAve,06/17/2015 06:00:00 PM,48,-122,14,16,30
12115,58thStGreenway22ndAve,06/17/2015 07:00:00 PM,48,-122,6,16,22
12116,58thStGreenway22ndAve,06/17/2015 08:00:00 PM,48,-122,4,2,6
12117,58thStGreenway22ndAve,06/17/2015 09:00:00 PM,48,-122,5,3,8
12118,58thStGreenway22ndAve,06/17/2015 10:00:00 PM,48,-122,2,1,3
12119,58thStGreenway22ndAve,06/17/2015 11:00:00 PM,48,-122,2,0,2
12120,58thStGreenway22ndAve,06/18/2015 12:00:00 AM,48,-122,0,0,0
12121,58thStGreenway22ndAve,06/18/2015 01:00:00 AM,48,-122,1,0,1
12122,58thStGreenway22ndAve,06/18/2015 02:00:00 AM,48,-122,1,1,2
12123,58thStGreenway22ndAve,06/18/2015 03:00:00 AM,48,-122,0,0,0
12124,58thStGreenway22ndAve,06/18/2015 04:00:00 AM,48,-122,0,1,1
12125,58thStGreenway22ndAve,06/18/2015 05:00:00 AM,48,-122,1,1,2
12126,58thStGreenway22ndAve,06/18/2015 06:00:00 AM,48,-122,0,1,1
12127,58thStGreenway22ndAve,06/18/2015 07:00:00 AM,48,-122,6,3,9
12128,58thStGreenway22ndAve,06/18/2015 08:00:00 AM,48,-122,4,3,7
12129,58thStGreenway22ndAve,06/18/2015 09:00:00 AM,48,-122,4,3,7
12130,58thStGreenway22ndAve,06/18/2015 10:00:00 AM,48,-122,5,4,9
12131,58thStGreenway22ndAve,06/18/2015 11:00:00 AM,48,-122,4,3,7
12132,58thStGreenway22ndAve,06/18/2015 12:00:00 PM,48,-122,4,1,5
12133,58thStGreenway22ndAve,06/18/2015 01:00:00 PM,48,-122,6,7,13
12134,58thStGreenway22ndAve,06/18/2015 02:00:00 PM,48,-122,4,1,5
12135,58thStGreenway22ndAve,06/18/2015 03:00:00 PM,48,-122,3,4,7
12136,58thStGreenway22ndAve,06/18/2015 04:00:00 PM,48,-122,3,2,5
12137,58thStGreenway22ndAve,06/18/2015 05:00:00 PM,48,-122,22,3,25
12138,58thStGreenway22ndAve,06/18/2015 06:00:00 PM,48,-122,13,7,20
12139,58thStGreenway22ndAve,06/18/2015 07:00:00 PM,48,-122,3,2,5
12140,58thStGreenway22ndAve,06/18/2015 08:00:00 PM,48,-122,5,3,8
12141,58thStGreenway22ndAve,06/18/2015 09:00:00 PM,48,-122,2,0,2
12142,58thStGreenway22ndAve,06/18/2015 10:00:00 PM,48,-122,1,0,1
12143,58thStGreenway22ndAve,06/18/2015 11:00:00 PM,48,-122,1,0,1
12144,58thStGreenway22ndAve,06/19/2015 12:00:00 AM,48,-122,0,0,0
12145,58thStGreenway22ndAve,06/19/2015 01:00:00 AM,48,-122,0,0,0
12146,58thStGreenway22ndAve,06/19/2015 02:00:00 AM,48,-122,2,0,2
12147,58thStGreenway22ndAve,06/19/2015 03:00:00 AM,48,-122,0,0,0
12148,58thStGreenway22ndAve,06/19/2015 04:00:00 AM,48,-122,0,1,1
12149,58thStGreenway22ndAve,06/19/2015 05:00:00 AM,48,-122,1,1,2
12150,58thStGreenway22ndAve,06/19/2015 06:00:00 AM,48,-122,1,1,2
12151,58thStGreenway22ndAve,06/19/2015 07:00:00 AM,48,-122,4,3,7
12152,58thStGreenway22ndAve,06/19/2015 08:00:00 AM,48,-122,5,8,13
12153,58thStGreenway22ndAve,06/19/2015 09:00:00 AM,48,-122,3,6,9
12154,58thStGreenway22ndAve,06/19/2015 10:00:00 AM,48,-122,5,4,9
12155,58thStGreenway22ndAve,06/19/2015 11:00:00 AM,48,-122,2,10,12
12156,58thStGreenway22ndAve,06/19/2015 12:00:00 PM,48,-122,5,2,7
12157,58thStGreenway22ndAve,06/19/2015 01:00:00 PM,48,-122,1,2,3
12158,58thStGreenway22ndAve,06/19/2015 02:00:00 PM,48,-122,7,6,13
12159,58thStGreenway22ndAve,06/19/2015 03:00:00 PM,48,-122,9,9,18
12160,58thStGreenway22ndAve,06/19/2015 04:00:00 PM,48,-122,5,5,10
12161,58thStGreenway22ndAve,06/19/2015 05:00:00 PM,48,-122,7,6,13
12162,58thStGreenway22ndAve,06/19/2015 06:00:00 PM,48,-122,8,4,12
12163,58thStGreenway22ndAve,06/19/2015 07:00:00 PM,48,-122,2,9,11
12164,58thStGreenway22ndAve,06/19/2015 08:00:00 PM,48,-122,8,2,10
12165,58thStGreenway22ndAve,06/19/2015 09:00:00 PM,48,-122,5,0,5
12166,58thStGreenway22ndAve,06/19/2015 10:00:00 PM,48,-122,1,0,1
12167,58thStGreenway22ndAve,06/19/2015 11:00:00 PM,48,-122,2,0,2
12168,58thStGreenway22ndAve,06/20/2015 12:00:00 AM,48,-122,0,2,2
12169,58thStGreenway22ndAve,06/20/2015 01:00:00 AM,48,-122,1,0,1
12170,58thStGreenway22ndAve,06/20/2015 02:00:00 AM,48,-122,0,0,0
12171,58thStGreenway22ndAve,06/20/2015 03:00:00 AM,48,-122,0,0,0
12172,58thStGreenway22ndAve,06/20/2015 04:00:00 AM,48,-122,0,1,1
12173,58thStGreenway22ndAve,06/20/2015 05:00:00 AM,48,-122,0,0,0
12174,58thStGreenway22ndAve,06/20/2015 06:00:00 AM,48,-122,1,1,2
12175,58thStGreenway22ndAve,06/20/2015 07:00:00 AM,48,-122,1,1,2
12176,58thStGreenway22ndAve,06/20/2015 08:00:00 AM,48,-122,3,4,7
12177,58thStGreenway22ndAve,06/20/2015 09:00:00 AM,48,-122,5,5,10
12178,58thStGreenway22ndAve,06/20/2015 10:00:00 AM,48,-122,5,8,13
12179,58thStGreenway22ndAve,06/20/2015 11:00:00 AM,48,-122,3,4,7
12180,58thStGreenway22ndAve,06/20/2015 12:00:00 PM,48,-122,17,10,27
12181,58thStGreenway22ndAve,06/20/2015 01:00:00 PM,48,-122,23,9,32
12182,58thStGreenway22ndAve,06/20/2015 02:00:00 PM,48,-122,25,11,36
12183,58thStGreenway22ndAve,06/20/2015 03:00:00 PM,48,-122,3,8,11
12184,58thStGreenway22ndAve,06/20/2015 04:00:00 PM,48,-122,5,14,19
12185,58thStGreenway22ndAve,06/20/2015 05:00:00 PM,48,-122,8,5,13
12186,58thStGreenway22ndAve,06/20/2015 06:00:00 PM,48,-122,4,2,6
12187,58thStGreenway22ndAve,06/20/2015 07:00:00 PM,48,-122,6,2,8
12188,58thStGreenway22ndAve,06/20/2015 08:00:00 PM,48,-122,2,8,10
12189,58thStGreenway22ndAve,06/20/2015 09:00:00 PM,48,-122,3,4,7
12190,58thStGreenway22ndAve,06/20/2015 10:00:00 PM,48,-122,2,3,5
12191,58thStGreenway22ndAve,06/20/2015 11:00:00 PM,48,-122,3,1,4
12192,58thStGreenway22ndAve,06/21/2015 12:00:00 AM,48,-122,0,0,0
12193,58thStGreenway22ndAve,06/21/2015 01:00:00 AM,48,-122,1,3,4
12194,58thStGreenway22ndAve,06/21/2015 02:00:00 AM,48,-122,0,1,1
12195,58thStGreenway22ndAve,06/21/2015 03:00:00 AM,48,-122,0,0,0
12196,58thStGreenway22ndAve,06/21/2015 04:00:00 AM,48,-122,0,0,0
12197,58thStGreenway22ndAve,06/21/2015 05:00:00 AM,48,-122,0,0,0
12198,58thStGreenway22ndAve,06/21/2015 06:00:00 AM,48,-122,0,0,0
12199,58thStGreenway22ndAve,06/21/2015 07:00:00 AM,48,-122,1,0,1
12200,58thStGreenway22ndAve,06/21/2015 08:00:00 AM,48,-122,1,2,3
12201,58thStGreenway22ndAve,06/21/2015 09:00:00 AM,48,-122,3,7,10
12202,58thStGreenway22ndAve,06/21/2015 10:00:00 AM,48,-122,6,6,12
12203,58thStGreenway22ndAve,06/21/2015 11:00:00 AM,48,-122,6,6,12
12204,58thStGreenway22ndAve,06/21/2015 12:00:00 PM,48,-122,5,7,12
12205,58thStGreenway22ndAve,06/21/2015 01:00:00 PM,48,-122,6,5,11
12206,58thStGreenway22ndAve,06/21/2015 02:00:00 PM,48,-122,3,6,9
12207,58thStGreenway22ndAve,06/21/2015 03:00:00 PM,48,-122,2,9,11
12208,58thStGreenway22ndAve,06/21/2015 04:00:00 PM,48,-122,12,4,16
12209,58thStGreenway22ndAve,06/21/2015 05:00:00 PM,48,-122,9,5,14
12210,58thStGreenway22ndAve,06/21/2015 06:00:00 PM,48,-122,10,2,12
12211,58thStGreenway22ndAve,06/21/2015 07:00:00 PM,48,-122,9,6,15
12212,58thStGreenway22ndAve,06/21/2015 08:00:00 PM,48,-122,3,3,6
12213,58thStGreenway22ndAve,06/21/2015 09:00:00 PM,48,-122,3,3,6
12214,58thStGreenway22ndAve,06/21/2015 10:00:00 PM,48,-122,2,0,2
12215,58thStGreenway22ndAve,06/21/2015 11:00:00 PM,48,-122,1,0,1
12216,58thStGreenway22ndAve,06/22/2015 12:00:00 AM,48,-122,1,0,1
12217,58thStGreenway22ndAve,06/22/2015 01:00:00 AM,48,-122,0,0,0
12218,58thStGreenway22ndAve,06/22/2015 02:00:00 AM,48,-122,0,0,0
12219,58thStGreenway22ndAve,06/22/2015 03:00:00 AM,48,-122,0,0,0
12220,58thStGreenway22ndAve,06/22/2015 04:00:00 AM,48,-122,1,1,2
12221,58thStGreenway22ndAve,06/22/2015 05:00:00 AM,48,-122,2,1,3
12222,58thStGreenway22ndAve,06/22/2015 06:00:00 AM,48,-122,2,2,4
12223,58thStGreenway22ndAve,06/22/2015 07:00:00 AM,48,-122,4,2,6
12224,58thStGreenway22ndAve,06/22/2015 08:00:00 AM,48,-122,4,12,16
12225,58thStGreenway22ndAve,06/22/2015 09:00:00 AM,48,-122,3,6,9
12226,58thStGreenway22ndAve,06/22/2015 10:00:00 AM,48,-122,4,4,8
12227,58thStGreenway22ndAve,06/22/2015 11:00:00 AM,48,-122,5,7,12
12228,58thStGreenway22ndAve,06/22/2015 12:00:00 PM,48,-122,4,1,5
12229,58thStGreenway22ndAve,06/22/2015 01:00:00 PM,48,-122,6,3,9
12230,58thStGreenway22ndAve,06/22/2015 02:00:00 PM,48,-122,2,3,5
12231,58thStGreenway22ndAve,06/22/2015 03:00:00 PM,48,-122,2,5,7
12232,58thStGreenway22ndAve,06/22/2015 04:00:00 PM,48,-122,5,9,14
12233,58thStGreenway22ndAve,06/22/2015 05:00:00 PM,48,-122,11,12,23
12234,58thStGreenway22ndAve,06/22/2015 06:00:00 PM,48,-122,24,13,37
12235,58thStGreenway22ndAve,06/22/2015 07:00:00 PM,48,-122,8,7,15
12236,58thStGreenway22ndAve,06/22/2015 08:00:00 PM,48,-122,11,2,13
12237,58thStGreenway22ndAve,06/22/2015 09:00:00 PM,48,-122,2,5,7
12238,58thStGreenway22ndAve,06/22/2015 10:00:00 PM,48,-122,3,0,3
12239,58thStGreenway22ndAve,06/22/2015 11:00:00 PM,48,-122,2,0,2
12240,58thStGreenway22ndAve,06/23/2015 12:00:00 AM,48,-122,0,0,0
12241,58thStGreenway22ndAve,06/23/2015 01:00:00 AM,48,-122,0,0,0
12242,58thStGreenway22ndAve,06/23/2015 02:00:00 AM,48,-122,0,1,1
12243,58thStGreenway22ndAve,06/23/2015 03:00:00 AM,48,-122,0,0,0
12244,58thStGreenway22ndAve,06/23/2015 04:00:00 AM,48,-122,0,1,1
12245,58thStGreenway22ndAve,06/23/2015 05:00:00 AM,48,-122,1,1,2
12246,58thStGreenway22ndAve,06/23/2015 06:00:00 AM,48,-122,1,1,2
12247,58thStGreenway22ndAve,06/23/2015 07:00:00 AM,48,-122,6,7,13
12248,58thStGreenway22ndAve,06/23/2015 08:00:00 AM,48,-122,4,9,13
12249,58thStGreenway22ndAve,06/23/2015 09:00:00 AM,48,-122,5,6,11
12250,58thStGreenway22ndAve,06/23/2015 10:00:00 AM,48,-122,5,1,6
12251,58thStGreenway22ndAve,06/23/2015 11:00:00 AM,48,-122,5,2,7
12252,58thStGreenway22ndAve,06/23/2015 12:00:00 PM,48,-122,7,0,7
12253,58thStGreenway22ndAve,06/23/2015 01:00:00 PM,48,-122,2,9,11
12254,58thStGreenway22ndAve,06/23/2015 02:00:00 PM,48,-122,4,1,5
12255,58thStGreenway22ndAve,06/23/2015 03:00:00 PM,48,-122,6,6,12
12256,58thStGreenway22ndAve,06/23/2015 04:00:00 PM,48,-122,9,7,16
12257,58thStGreenway22ndAve,06/23/2015 05:00:00 PM,48,-122,15,8,23
12258,58thStGreenway22ndAve,06/23/2015 06:00:00 PM,48,-122,6,13,19
12259,58thStGreenway22ndAve,06/23/2015 07:00:00 PM,48,-122,11,7,18
12260,58thStGreenway22ndAve,06/23/2015 08:00:00 PM,48,-122,10,2,12
12261,58thStGreenway22ndAve,06/23/2015 09:00:00 PM,48,-122,5,1,6
12262,58thStGreenway22ndAve,06/23/2015 10:00:00 PM,48,-122,2,1,3
12263,58thStGreenway22ndAve,06/23/2015 11:00:00 PM,48,-122,0,1,1
12264,58thStGreenway22ndAve,06/24/2015 12:00:00 AM,48,-122,0,0,0
12265,58thStGreenway22ndAve,06/24/2015 01:00:00 AM,48,-122,0,0,0
12266,58thStGreenway22ndAve,06/24/2015 02:00:00 AM,48,-122,0,1,1
12267,58thStGreenway22ndAve,06/24/2015 03:00:00 AM,48,-122,0,0,0
12268,58thStGreenway22ndAve,06/24/2015 04:00:00 AM,48,-122,0,1,1
12269,58thStGreenway22ndAve,06/24/2015 05:00:00 AM,48,-122,1,1,2
12270,58thStGreenway22ndAve,06/24/2015 06:00:00 AM,48,-122,2,2,4
12271,58thStGreenway22ndAve,06/24/2015 07:00:00 AM,48,-122,3,4,7
12272,58thStGreenway22ndAve,06/24/2015 08:00:00 AM,48,-122,7,6,13
12273,58thStGreenway22ndAve,06/24/2015 09:00:00 AM,48,-122,3,8,11
12274,58thStGreenway22ndAve,06/24/2015 10:00:00 AM,48,-122,3,3,6
12275,58thStGreenway22ndAve,06/24/2015 11:00:00 AM,48,-122,4,4,8
12276,58thStGreenway22ndAve,06/24/2015 12:00:00 PM,48,-122,6,1,7
12277,58thStGreenway22ndAve,06/24/2015 01:00:00 PM,48,-122,1,11,12
12278,58thStGreenway22ndAve,06/24/2015 02:00:00 PM,48,-122,7,5,12
12279,58thStGreenway22ndAve,06/24/2015 03:00:00 PM,48,-122,5,5,10
12280,58thStGreenway22ndAve,06/24/2015 04:00:00 PM,48,-122,13,10,23
12281,58thStGreenway22ndAve,06/24/2015 05:00:00 PM,48,-122,10,7,17
12282,58thStGreenway22ndAve,06/24/2015 06:00:00 PM,48,-122,7,12,19
12283,58thStGreenway22ndAve,06/24/2015 07:00:00 PM,48,-122,8,8,16
12284,58thStGreenway22ndAve,06/24/2015 08:00:00 PM,48,-122,10,2,12
12285,58thStGreenway22ndAve,06/24/2015 09:00:00 PM,48,-122,3,1,4
12286,58thStGreenway22ndAve,06/24/2015 10:00:00 PM,48,-122,5,6,11
12287,58thStGreenway22ndAve,06/24/2015 11:00:00 PM,48,-122,7,0,7
12288,58thStGreenway22ndAve,06/25/2015 12:00:00 AM,48,-122,2,0,2
12289,58thStGreenway22ndAve,06/25/2015 01:00:00 AM,48,-122,0,0,0
12290,58thStGreenway22ndAve,06/25/2015 02:00:00 AM,48,-122,0,0,0
12291,58thStGreenway22ndAve,06/25/2015 03:00:00 AM,48,-122,0,0,0
12292,58thStGreenway22ndAve,06/25/2015 04:00:00 AM,48,-122,0,1,1
12293,58thStGreenway22ndAve,06/25/2015 05:00:00 AM,48,-122,0,1,1
12294,58thStGreenway22ndAve,06/25/2015 06:00:00 AM,48,-122,4,2,6
12295,58thStGreenway22ndAve,06/25/2015 07:00:00 AM,48,-122,2,5,7
12296,58thStGreenway22ndAve,06/25/2015 08:00:00 AM,48,-122,7,7,14
12297,58thStGreenway22ndAve,06/25/2015 09:00:00 AM,48,-122,5,12,17
12298,58thStGreenway22ndAve,06/25/2015 10:00:00 AM,48,-122,3,5,8
12299,58thStGreenway22ndAve,06/25/2015 11:00:00 AM,48,-122,2,6,8
12300,58thStGreenway22ndAve,06/25/2015 12:00:00 PM,48,-122,4,4,8
12301,58thStGreenway22ndAve,06/25/2015 01:00:00 PM,48,-122,5,8,13
12302,58thStGreenway22ndAve,06/25/2015 02:00:00 PM,48,-122,5,1,6
12303,58thStGreenway22ndAve,06/25/2015 03:00:00 PM,48,-122,4,3,7
12304,58thStGreenway22ndAve,06/25/2015 04:00:00 PM,48,-122,7,5,12
12305,58thStGreenway22ndAve,06/25/2015 05:00:00 PM,48,-122,13,11,24
12306,58thStGreenway22ndAve,06/25/2015 06:00:00 PM,48,-122,10,7,17
12307,58thStGreenway22ndAve,06/25/2015 07:00:00 PM,48,-122,15,10,25
12308,58thStGreenway22ndAve,06/25/2015 08:00:00 PM,48,-122,2,2,4
12309,58thStGreenway22ndAve,06/25/2015 09:00:00 PM,48,-122,3,4,7
12310,58thStGreenway22ndAve,06/25/2015 10:00:00 PM,48,-122,2,1,3
12311,58thStGreenway22ndAve,06/25/2015 11:00:00 PM,48,-122,0,0,0
12312,58thStGreenway22ndAve,06/26/2015 12:00:00 AM,48,-122,0,0,0
12313,58thStGreenway22ndAve,06/26/2015 01:00:00 AM,48,-122,3,1,4
12314,58thStGreenway22ndAve,06/26/2015 02:00:00 AM,48,-122,0,0,0
12315,58thStGreenway22ndAve,06/26/2015 03:00:00 AM,48,-122,0,0,0
12316,58thStGreenway22ndAve,06/26/2015 04:00:00 AM,48,-122,0,1,1
12317,58thStGreenway22ndAve,06/26/2015 05:00:00 AM,48,-122,1,1,2
12318,58thStGreenway22ndAve,06/26/2015 06:00:00 AM,48,-122,3,3,6
12319,58thStGreenway22ndAve,06/26/2015 07:00:00 AM,48,-122,5,6,11
12320,58thStGreenway22ndAve,06/26/2015 08:00:00 AM,48,-122,9,13,22
12321,58thStGreenway22ndAve,06/26/2015 09:00:00 AM,48,-122,5,8,13
12322,58thStGreenway22ndAve,06/26/2015 10:00:00 AM,48,-122,3,4,7
12323,58thStGreenway22ndAve,06/26/2015 11:00:00 AM,48,-122,7,5,12
12324,58thStGreenway22ndAve,06/26/2015 12:00:00 PM,48,-122,5,9,14
12325,58thStGreenway22ndAve,06/26/2015 01:00:00 PM,48,-122,1,7,8
12326,58thStGreenway22ndAve,06/26/2015 02:00:00 PM,48,-122,4,4,8
12327,58thStGreenway22ndAve,06/26/2015 03:00:00 PM,48,-122,4,4,8
12328,58thStGreenway22ndAve,06/26/2015 04:00:00 PM,48,-122,12,6,18
12329,58thStGreenway22ndAve,06/26/2015 05:00:00 PM,48,-122,8,7,15
12330,58thStGreenway22ndAve,06/26/2015 06:00:00 PM,48,-122,0,8,8
12331,58thStGreenway22ndAve,06/26/2015 07:00:00 PM,48,-122,6,4,10
12332,58thStGreenway22ndAve,06/26/2015 08:00:00 PM,48,-122,6,3,9
12333,58thStGreenway22ndAve,06/26/2015 09:00:00 PM,48,-122,5,4,9
12334,58thStGreenway22ndAve,06/26/2015 10:00:00 PM,48,-122,1,0,1
12335,58thStGreenway22ndAve,06/26/2015 11:00:00 PM,48,-122,2,2,4
12336,58thStGreenway22ndAve,06/27/2015 12:00:00 AM,48,-122,0,1,1
12337,58thStGreenway22ndAve,06/27/2015 01:00:00 AM,48,-122,0,1,1
12338,58thStGreenway22ndAve,06/27/2015 02:00:00 AM,48,-122,0,0,0
12339,58thStGreenway22ndAve,06/27/2015 03:00:00 AM,48,-122,0,0,0
12340,58thStGreenway22ndAve,06/27/2015 04:00:00 AM,48,-122,0,0,0
12341,58thStGreenway22ndAve,06/27/2015 05:00:00 AM,48,-122,0,0,0
12342,58thStGreenway22ndAve,06/27/2015 06:00:00 AM,48,-122,0,1,1
12343,58thStGreenway22ndAve,06/27/2015 07:00:00 AM,48,-122,0,4,4
12344,58thStGreenway22ndAve,06/27/2015 08:00:00 AM,48,-122,1,7,8
12345,58thStGreenway22ndAve,06/27/2015 09:00:00 AM,48,-122,5,4,9
12346,58thStGreenway22ndAve,06/27/2015 10:00:00 AM,48,-122,12,6,18
12347,58thStGreenway22ndAve,06/27/2015 11:00:00 AM,48,-122,10,7,17
12348,58thStGreenway22ndAve,06/27/2015 12:00:00 PM,48,-122,10,4,14
12349,58thStGreenway22ndAve,06/27/2015 01:00:00 PM,48,-122,8,13,21
12350,58thStGreenway22ndAve,06/27/2015 02:00:00 PM,48,-122,11,4,15
12351,58thStGreenway22ndAve,06/27/2015 03:00:00 PM,48,-122,4,8,12
12352,58thStGreenway22ndAve,06/27/2015 04:00:00 PM,48,-122,7,10,17
12353,58thStGreenway22ndAve,06/27/2015 05:00:00 PM,48,-122,9,3,12
12354,58thStGreenway22ndAve,06/27/2015 06:00:00 PM,48,-122,5,6,11
12355,58thStGreenway22ndAve,06/27/2015 07:00:00 PM,48,-122,2,0,2
12356,58thStGreenway22ndAve,06/27/2015 08:00:00 PM,48,-122,1,2,3
12357,58thStGreenway22ndAve,06/27/2015 09:00:00 PM,48,-122,2,0,2
12358,58thStGreenway22ndAve,06/27/2015 10:00:00 PM,48,-122,0,1,1
12359,58thStGreenway22ndAve,06/27/2015 11:00:00 PM,48,-122,2,0,2
12360,58thStGreenway22ndAve,06/28/2015 12:00:00 AM,48,-122,0,0,0
12361,58thStGreenway22ndAve,06/28/2015 01:00:00 AM,48,-122,0,0,0
12362,58thStGreenway22ndAve,06/28/2015 02:00:00 AM,48,-122,0,1,1
12363,58thStGreenway22ndAve,06/28/2015 03:00:00 AM,48,-122,0,0,0
12364,58thStGreenway22ndAve,06/28/2015 04:00:00 AM,48,-122,1,1,2
12365,58thStGreenway22ndAve,06/28/2015 05:00:00 AM,48,-122,0,4,4
12366,58thStGreenway22ndAve,06/28/2015 06:00:00 AM,48,-122,1,0,1
12367,58thStGreenway22ndAve,06/28/2015 07:00:00 AM,48,-122,0,2,2
12368,58thStGreenway22ndAve,06/28/2015 08:00:00 AM,48,-122,2,4,6
12369,58thStGreenway22ndAve,06/28/2015 09:00:00 AM,48,-122,4,4,8
12370,58thStGreenway22ndAve,06/28/2015 10:00:00 AM,48,-122,4,4,8
12371,58thStGreenway22ndAve,06/28/2015 11:00:00 AM,48,-122,5,5,10
12372,58thStGreenway22ndAve,06/28/2015 12:00:00 PM,48,-122,7,7,14
12373,58thStGreenway22ndAve,06/28/2015 01:00:00 PM,48,-122,3,7,10
12374,58thStGreenway22ndAve,06/28/2015 02:00:00 PM,48,-122,7,10,17
12375,58thStGreenway22ndAve,06/28/2015 03:00:00 PM,48,-122,7,10,17
12376,58thStGreenway22ndAve,06/28/2015 04:00:00 PM,48,-122,6,5,11
12377,58thStGreenway22ndAve,06/28/2015 05:00:00 PM,48,-122,5,14,19
12378,58thStGreenway22ndAve,06/28/2015 06:00:00 PM,48,-122,8,4,12
12379,58thStGreenway22ndAve,06/28/2015 07:00:00 PM,48,-122,6,5,11
12380,58thStGreenway22ndAve,06/28/2015 08:00:00 PM,48,-122,3,4,7
12381,58thStGreenway22ndAve,06/28/2015 09:00:00 PM,48,-122,1,0,1
12382,58thStGreenway22ndAve,06/28/2015 10:00:00 PM,48,-122,1,0,1
12383,58thStGreenway22ndAve,06/28/2015 11:00:00 PM,48,-122,0,2,2
12384,58thStGreenway22ndAve,06/29/2015 12:00:00 AM,48,-122,2,0,2
12385,58thStGreenway22ndAve,06/29/2015 01:00:00 AM,48,-122,0,1,1
12386,58thStGreenway22ndAve,06/29/2015 02:00:00 AM,48,-122,2,0,2
12387,58thStGreenway22ndAve,06/29/2015 03:00:00 AM,48,-122,0,0,0
12388,58thStGreenway22ndAve,06/29/2015 04:00:00 AM,48,-122,0,1,1
12389,58thStGreenway22ndAve,06/29/2015 05:00:00 AM,48,-122,0,2,2
12390,58thStGreenway22ndAve,06/29/2015 06:00:00 AM,48,-122,0,1,1
12391,58thStGreenway22ndAve,06/29/2015 07:00:00 AM,48,-122,3,4,7
12392,58thStGreenway22ndAve,06/29/2015 08:00:00 AM,48,-122,7,4,11
12393,58thStGreenway22ndAve,06/29/2015 09:00:00 AM,48,-122,8,9,17
12394,58thStGreenway22ndAve,06/29/2015 10:00:00 AM,48,-122,4,7,11
12395,58thStGreenway22ndAve,06/29/2015 11:00:00 AM,48,-122,2,3,5
12396,58thStGreenway22ndAve,06/29/2015 12:00:00 PM,48,-122,5,1,6
12397,58thStGreenway22ndAve,06/29/2015 01:00:00 PM,48,-122,6,7,13
12398,58thStGreenway22ndAve,06/29/2015 02:00:00 PM,48,-122,8,2,10
12399,58thStGreenway22ndAve,06/29/2015 03:00:00 PM,48,-122,5,2,7
12400,58thStGreenway22ndAve,06/29/2015 04:00:00 PM,48,-122,5,9,14
12401,58thStGreenway22ndAve,06/29/2015 05:00:00 PM,48,-122,15,5,20
12402,58thStGreenway22ndAve,06/29/2015 06:00:00 PM,48,-122,7,10,17
12403,58thStGreenway22ndAve,06/29/2015 07:00:00 PM,48,-122,4,12,16
12404,58thStGreenway22ndAve,06/29/2015 08:00:00 PM,48,-122,8,9,17
12405,58thStGreenway22ndAve,06/29/2015 09:00:00 PM,48,-122,4,3,7
12406,58thStGreenway22ndAve,06/29/2015 10:00:00 PM,48,-122,2,1,3
12407,58thStGreenway22ndAve,06/29/2015 11:00:00 PM,48,-122,1,0,1
12408,58thStGreenway22ndAve,06/30/2015 12:00:00 AM,48,-122,0,0,0
12409,58thStGreenway22ndAve,06/30/2015 01:00:00 AM,48,-122,0,1,1
12410,58thStGreenway22ndAve,06/30/2015 02:00:00 AM,48,-122,0,0,0
12411,58thStGreenway22ndAve,06/30/2015 03:00:00 AM,48,-122,0,1,1
12412,58thStGreenway22ndAve,06/30/2015 04:00:00 AM,48,-122,0,1,1
12413,58thStGreenway22ndAve,06/30/2015 05:00:00 AM,48,-122,2,1,3
12414,58thStGreenway22ndAve,06/30/2015 06:00:00 AM,48,-122,4,3,7
12415,58thStGreenway22ndAve,06/30/2015 07:00:00 AM,48,-122,5,2,7
12416,58thStGreenway22ndAve,06/30/2015 08:00:00 AM,48,-122,2,8,10
12417,58thStGreenway22ndAve,06/30/2015 09:00:00 AM,48,-122,8,7,15
12418,58thStGreenway22ndAve,06/30/2015 10:00:00 AM,48,-122,6,7,13
12419,58thStGreenway22ndAve,06/30/2015 11:00:00 AM,48,-122,5,4,9
12420,58thStGreenway22ndAve,06/30/2015 12:00:00 PM,48,-122,8,9,17
12421,58thStGreenway22ndAve,06/30/2015 01:00:00 PM,48,-122,3,9,12
12422,58thStGreenway22ndAve,06/30/2015 02:00:00 PM,48,-122,3,11,14
12423,58thStGreenway22ndAve,06/30/2015 03:00:00 PM,48,-122,9,10,19
12424,58thStGreenway22ndAve,06/30/2015 04:00:00 PM,48,-122,7,2,9
12425,58thStGreenway22ndAve,06/30/2015 05:00:00 PM,48,-122,7,5,12
12426,58thStGreenway22ndAve,06/30/2015 06:00:00 PM,48,-122,11,9,20
12427,58thStGreenway22ndAve,06/30/2015 07:00:00 PM,48,-122,11,5,16
12428,58thStGreenway22ndAve,06/30/2015 08:00:00 PM,48,-122,5,4,9
12429,58thStGreenway22ndAve,06/30/2015 09:00:00 PM,48,-122,8,8,16
12430,58thStGreenway22ndAve,06/30/2015 10:00:00 PM,48,-122,7,1,8
12431,58thStGreenway22ndAve,06/30/2015 11:00:00 PM,48,-122,3,2,5
12432,58thStGreenway22ndAve,07/01/2015 12:00:00 AM,48,-122,0,0,0
12433,58thStGreenway22ndAve,07/01/2015 01:00:00 AM,48,-122,0,0,0
12434,58thStGreenway22ndAve,07/01/2015 02:00:00 AM,48,-122,0,0,0
12435,58thStGreenway22ndAve,07/01/2015 03:00:00 AM,48,-122,0,0,0
12436,58thStGreenway22ndAve,07/01/2015 04:00:00 AM,48,-122,1,1,2
12437,58thStGreenway22ndAve,07/01/2015 05:00:00 AM,48,-122,2,0,2
12438,58thStGreenway22ndAve,07/01/2015 06:00:00 AM,48,-122,1,2,3
12439,58thStGreenway22ndAve,07/01/2015 07:00:00 AM,48,-122,7,6,13
12440,58thStGreenway22ndAve,07/01/2015 08:00:00 AM,48,-122,3,8,11
12441,58thStGreenway22ndAve,07/01/2015 09:00:00 AM,48,-122,3,7,10
12442,58thStGreenway22ndAve,07/01/2015 10:00:00 AM,48,-122,2,7,9
12443,58thStGreenway22ndAve,07/01/2015 11:00:00 AM,48,-122,9,5,14
12444,58thStGreenway22ndAve,07/01/2015 12:00:00 PM,48,-122,4,3,7
12445,58thStGreenway22ndAve,07/01/2015 01:00:00 PM,48,-122,5,5,10
12446,58thStGreenway22ndAve,07/01/2015 02:00:00 PM,48,-122,4,1,5
12447,58thStGreenway22ndAve,07/01/2015 03:00:00 PM,48,-122,5,5,10
12448,58thStGreenway22ndAve,07/01/2015 04:00:00 PM,48,-122,7,9,16
12449,58thStGreenway22ndAve,07/01/2015 05:00:00 PM,48,-122,14,8,22
12450,58thStGreenway22ndAve,07/01/2015 06:00:00 PM,48,-122,13,6,19
12451,58thStGreenway22ndAve,07/01/2015 07:00:00 PM,48,-122,9,1,10
12452,58thStGreenway22ndAve,07/01/2015 08:00:00 PM,48,-122,3,6,9
12453,58thStGreenway22ndAve,07/01/2015 09:00:00 PM,48,-122,2,6,8
12454,58thStGreenway22ndAve,07/01/2015 10:00:00 PM,48,-122,3,1,4
12455,58thStGreenway22ndAve,07/01/2015 11:00:00 PM,48,-122,2,2,4
12456,58thStGreenway22ndAve,07/02/2015 12:00:00 AM,48,-122,1,1,2
12457,58thStGreenway22ndAve,07/02/2015 01:00:00 AM,48,-122,0,0,0
12458,58thStGreenway22ndAve,07/02/2015 02:00:00 AM,48,-122,0,0,0
12459,58thStGreenway22ndAve,07/02/2015 03:00:00 AM,48,-122,0,0,0
12460,58thStGreenway22ndAve,07/02/2015 04:00:00 AM,48,-122,0,1,1
12461,58thStGreenway22ndAve,07/02/2015 05:00:00 AM,48,-122,1,0,1
12462,58thStGreenway22ndAve,07/02/2015 06:00:00 AM,48,-122,4,1,5
12463,58thStGreenway22ndAve,07/02/2015 07:00:00 AM,48,-122,5,4,9
12464,58thStGreenway22ndAve,07/02/2015 08:00:00 AM,48,-122,7,11,18
12465,58thStGreenway22ndAve,07/02/2015 09:00:00 AM,48,-122,6,4,10
12466,58thStGreenway22ndAve,07/02/2015 10:00:00 AM,48,-122,1,5,6
12467,58thStGreenway22ndAve,07/02/2015 11:00:00 AM,48,-122,5,5,10
12468,58thStGreenway22ndAve,07/02/2015 12:00:00 PM,48,-122,20,2,22
12469,58thStGreenway22ndAve,07/02/2015 01:00:00 PM,48,-122,8,6,14
12470,58thStGreenway22ndAve,07/02/2015 02:00:00 PM,48,-122,4,2,6
12471,58thStGreenway22ndAve,07/02/2015 03:00:00 PM,48,-122,3,3,6
12472,58thStGreenway22ndAve,07/02/2015 04:00:00 PM,48,-122,7,9,16
12473,58thStGreenway22ndAve,07/02/2015 05:00:00 PM,48,-122,8,13,21
12474,58thStGreenway22ndAve,07/02/2015 06:00:00 PM,48,-122,4,2,6
12475,58thStGreenway22ndAve,07/02/2015 07:00:00 PM,48,-122,7,3,10
12476,58thStGreenway22ndAve,07/02/2015 08:00:00 PM,48,-122,4,3,7
12477,58thStGreenway22ndAve,07/02/2015 09:00:00 PM,48,-122,9,6,15
12478,58thStGreenway22ndAve,07/02/2015 10:00:00 PM,48,-122,5,0,5
12479,58thStGreenway22ndAve,07/02/2015 11:00:00 PM,48,-122,0,1,1
12480,58thStGreenway22ndAve,07/03/2015 12:00:00 AM,48,-122,0,0,0
12481,58thStGreenway22ndAve,07/03/2015 01:00:00 AM,48,-122,0,0,0
12482,58thStGreenway22ndAve,07/03/2015 02:00:00 AM,48,-122,0,0,0
12483,58thStGreenway22ndAve,07/03/2015 03:00:00 AM,48,-122,0,0,0
12484,58thStGreenway22ndAve,07/03/2015 04:00:00 AM,48,-122,0,1,1
12485,58thStGreenway22ndAve,07/03/2015 05:00:00 AM,48,-122,0,0,0
12486,58thStGreenway22ndAve,07/03/2015 06:00:00 AM,48,-122,2,0,2
12487,58thStGreenway22ndAve,07/03/2015 07:00:00 AM,48,-122,1,0,1
12488,58thStGreenway22ndAve,07/03/2015 08:00:00 AM,48,-122,0,11,11
12489,58thStGreenway22ndAve,07/03/2015 09:00:00 AM,48,-122,3,7,10
12490,58thStGreenway22ndAve,07/03/2015 10:00:00 AM,48,-122,4,9,13
12491,58thStGreenway22ndAve,07/03/2015 11:00:00 AM,48,-122,14,14,28
12492,58thStGreenway22ndAve,07/03/2015 12:00:00 PM,48,-122,8,10,18
12493,58thStGreenway22ndAve,07/03/2015 01:00:00 PM,48,-122,6,6,12
12494,58thStGreenway22ndAve,07/03/2015 02:00:00 PM,48,-122,6,6,12
12495,58thStGreenway22ndAve,07/03/2015 03:00:00 PM,48,-122,5,9,14
12496,58thStGreenway22ndAve,07/03/2015 04:00:00 PM,48,-122,10,11,21
12497,58thStGreenway22ndAve,07/03/2015 05:00:00 PM,48,-122,6,5,11
12498,58thStGreenway22ndAve,07/03/2015 06:00:00 PM,48,-122,5,7,12
12499,58thStGreenway22ndAve,07/03/2015 07:00:00 PM,48,-122,5,6,11
12500,58thStGreenway22ndAve,07/03/2015 08:00:00 PM,48,-122,7,3,10
12501,58thStGreenway22ndAve,07/03/2015 09:00:00 PM,48,-122,11,2,13
12502,58thStGreenway22ndAve,07/03/2015 10:00:00 PM,48,-122,3,5,8
12503,58thStGreenway22ndAve,07/03/2015 11:00:00 PM,48,-122,0,1,1
12504,58thStGreenway22ndAve,07/04/2015 12:00:00 AM,48,-122,0,0,0
12505,58thStGreenway22ndAve,07/04/2015 01:00:00 AM,48,-122,0,0,0
12506,58thStGreenway22ndAve,07/04/2015 02:00:00 AM,48,-122,0,1,1
12507,58thStGreenway22ndAve,07/04/2015 03:00:00 AM,48,-122,0,0,0
12508,58thStGreenway22ndAve,07/04/2015 04:00:00 AM,48,-122,0,0,0
12509,58thStGreenway22ndAve,07/04/2015 05:00:00 AM,48,-122,1,0,1
12510,58thStGreenway22ndAve,07/04/2015 06:00:00 AM,48,-122,0,0,0
12511,58thStGreenway22ndAve,07/04/2015 07:00:00 AM,48,-122,0,1,1
12512,58thStGreenway22ndAve,07/04/2015 08:00:00 AM,48,-122,0,6,6
12513,58thStGreenway22ndAve,07/04/2015 09:00:00 AM,48,-122,4,4,8
12514,58thStGreenway22ndAve,07/04/2015 10:00:00 AM,48,-122,14,8,22
12515,58thStGreenway22ndAve,07/04/2015 11:00:00 AM,48,-122,7,10,17
12516,58thStGreenway22ndAve,07/04/2015 12:00:00 PM,48,-122,4,7,11
12517,58thStGreenway22ndAve,07/04/2015 01:00:00 PM,48,-122,5,8,13
12518,58thStGreenway22ndAve,07/04/2015 02:00:00 PM,48,-122,7,3,10
12519,58thStGreenway22ndAve,07/04/2015 03:00:00 PM,48,-122,7,5,12
12520,58thStGreenway22ndAve,07/04/2015 04:00:00 PM,48,-122,6,2,8
12521,58thStGreenway22ndAve,07/04/2015 05:00:00 PM,48,-122,4,3,7
12522,58thStGreenway22ndAve,07/04/2015 06:00:00 PM,48,-122,4,2,6
12523,58thStGreenway22ndAve,07/04/2015 07:00:00 PM,48,-122,4,2,6
12524,58thStGreenway22ndAve,07/04/2015 08:00:00 PM,48,-122,6,1,7
12525,58thStGreenway22ndAve,07/04/2015 09:00:00 PM,48,-122,12,1,13
12526,58thStGreenway22ndAve,07/04/2015 10:00:00 PM,48,-122,2,0,2
12527,58thStGreenway22ndAve,07/04/2015 11:00:00 PM,48,-122,3,7,10
12528,58thStGreenway22ndAve,07/05/2015 12:00:00 AM,48,-122,0,5,5
12529,58thStGreenway22ndAve,07/05/2015 01:00:00 AM,48,-122,0,1,1
12530,58thStGreenway22ndAve,07/05/2015 02:00:00 AM,48,-122,1,1,2
12531,58thStGreenway22ndAve,07/05/2015 03:00:00 AM,48,-122,0,0,0
12532,58thStGreenway22ndAve,07/05/2015 04:00:00 AM,48,-122,1,0,1
12533,58thStGreenway22ndAve,07/05/2015 05:00:00 AM,48,-122,0,0,0
12534,58thStGreenway22ndAve,07/05/2015 06:00:00 AM,48,-122,1,1,2
12535,58thStGreenway22ndAve,07/05/2015 07:00:00 AM,48,-122,0,0,0
12536,58thStGreenway22ndAve,07/05/2015 08:00:00 AM,48,-122,1,2,3
12537,58thStGreenway22ndAve,07/05/2015 09:00:00 AM,48,-122,4,7,11
12538,58thStGreenway22ndAve,07/05/2015 10:00:00 AM,48,-122,5,4,9
12539,58thStGreenway22ndAve,07/05/2015 11:00:00 AM,48,-122,9,9,18
12540,58thStGreenway22ndAve,07/05/2015 12:00:00 PM,48,-122,5,9,14
12541,58thStGreenway22ndAve,07/05/2015 01:00:00 PM,48,-122,21,6,27
12542,58thStGreenway22ndAve,07/05/2015 02:00:00 PM,48,-122,4,7,11
12543,58thStGreenway22ndAve,07/05/2015 03:00:00 PM,48,-122,4,9,13
12544,58thStGreenway22ndAve,07/05/2015 04:00:00 PM,48,-122,7,1,8
12545,58thStGreenway22ndAve,07/05/2015 05:00:00 PM,48,-122,1,7,8
12546,58thStGreenway22ndAve,07/05/2015 06:00:00 PM,48,-122,7,1,8
12547,58thStGreenway22ndAve,07/05/2015 07:00:00 PM,48,-122,6,9,15
12548,58thStGreenway22ndAve,07/05/2015 08:00:00 PM,48,-122,3,6,9
12549,58thStGreenway22ndAve,07/05/2015 09:00:00 PM,48,-122,5,2,7
12550,58thStGreenway22ndAve,07/05/2015 10:00:00 PM,48,-122,8,0,8
12551,58thStGreenway22ndAve,07/05/2015 11:00:00 PM,48,-122,3,0,3
12552,58thStGreenway22ndAve,07/06/2015 12:00:00 AM,48,-122,0,1,1
12553,58thStGreenway22ndAve,07/06/2015 01:00:00 AM,48,-122,2,0,2
12554,58thStGreenway22ndAve,07/06/2015 02:00:00 AM,48,-122,0,0,0
12555,58thStGreenway22ndAve,07/06/2015 03:00:00 AM,48,-122,0,0,0
12556,58thStGreenway22ndAve,07/06/2015 04:00:00 AM,48,-122,0,1,1
12557,58thStGreenway22ndAve,07/06/2015 05:00:00 AM,48,-122,0,0,0
12558,58thStGreenway22ndAve,07/06/2015 06:00:00 AM,48,-122,1,2,3
12559,58thStGreenway22ndAve,07/06/2015 07:00:00 AM,48,-122,2,3,5
12560,58thStGreenway22ndAve,07/06/2015 08:00:00 AM,48,-122,2,7,9
12561,58thStGreenway22ndAve,07/06/2015 09:00:00 AM,48,-122,6,15,21
12562,58thStGreenway22ndAve,07/06/2015 10:00:00 AM,48,-122,0,1,1
12563,58thStGreenway22ndAve,07/06/2015 11:00:00 AM,48,-122,0,0,0
12564,58thStGreenway22ndAve,07/06/2015 12:00:00 PM,48,-122,0,0,0
12565,58thStGreenway22ndAve,07/06/2015 01:00:00 PM,48,-122,0,1,1
12566,58thStGreenway22ndAve,07/06/2015 02:00:00 PM,48,-122,6,1,7
12567,58thStGreenway22ndAve,07/06/2015 03:00:00 PM,48,-122,8,2,10
12568,58thStGreenway22ndAve,07/06/2015 04:00:00 PM,48,-122,10,8,18
12569,58thStGreenway22ndAve,07/06/2015 05:00:00 PM,48,-122,9,3,12
12570,58thStGreenway22ndAve,07/06/2015 06:00:00 PM,48,-122,13,8,21
12571,58thStGreenway22ndAve,07/06/2015 07:00:00 PM,48,-122,3,5,8
12572,58thStGreenway22ndAve,07/06/2015 08:00:00 PM,48,-122,3,4,7
12573,58thStGreenway22ndAve,07/06/2015 09:00:00 PM,48,-122,4,3,7
12574,58thStGreenway22ndAve,07/06/2015 10:00:00 PM,48,-122,3,2,5
12575,58thStGreenway22ndAve,07/06/2015 11:00:00 PM,48,-122,3,0,3
12576,58thStGreenway22ndAve,07/07/2015 12:00:00 AM,48,-122,0,0,0
12577,58thStGreenway22ndAve,07/07/2015 01:00:00 AM,48,-122,0,0,0
12578,58thStGreenway22ndAve,07/07/2015 02:00:00 AM,48,-122,0,0,0
12579,58thStGreenway22ndAve,07/07/2015 03:00:00 AM,48,-122,0,0,0
12580,58thStGreenway22ndAve,07/07/2015 04:00:00 AM,48,-122,0,1,1
12581,58thStGreenway22ndAve,07/07/2015 05:00:00 AM,48,-122,1,0,1
12582,58thStGreenway22ndAve,07/07/2015 06:00:00 AM,48,-122,0,1,1
12583,58thStGreenway22ndAve,07/07/2015 07:00:00 AM,48,-122,2,5,7
12584,58thStGreenway22ndAve,07/07/2015 08:00:00 AM,48,-122,6,7,13
12585,58thStGreenway22ndAve,07/07/2015 09:00:00 AM,48,-122,3,5,8
12586,58thStGreenway22ndAve,07/07/2015 10:00:00 AM,48,-122,2,7,9
12587,58thStGreenway22ndAve,07/07/2015 11:00:00 AM,48,-122,3,2,5
12588,58thStGreenway22ndAve,07/07/2015 12:00:00 PM,48,-122,10,5,15
12589,58thStGreenway22ndAve,07/07/2015 01:00:00 PM,48,-122,3,1,4
12590,58thStGreenway22ndAve,07/07/2015 02:00:00 PM,48,-122,1,1,2
12591,58thStGreenway22ndAve,07/07/2015 03:00:00 PM,48,-122,7,4,11
12592,58thStGreenway22ndAve,07/07/2015 04:00:00 PM,48,-122,7,9,16
12593,58thStGreenway22ndAve,07/07/2015 05:00:00 PM,48,-122,6,12,18
12594,58thStGreenway22ndAve,07/07/2015 06:00:00 PM,48,-122,10,5,15
12595,58thStGreenway22ndAve,07/07/2015 07:00:00 PM,48,-122,10,8,18
12596,58thStGreenway22ndAve,07/07/2015 08:00:00 PM,48,-122,5,3,8
12597,58thStGreenway22ndAve,07/07/2015 09:00:00 PM,48,-122,2,0,2
12598,58thStGreenway22ndAve,07/07/2015 10:00:00 PM,48,-122,1,2,3
12599,58thStGreenway22ndAve,07/07/2015 11:00:00 PM,48,-122,0,0,0
12600,58thStGreenway22ndAve,07/08/2015 12:00:00 AM,48,-122,0,0,0
12601,58thStGreenway22ndAve,07/08/2015 01:00:00 AM,48,-122,0,0,0
12602,58thStGreenway22ndAve,07/08/2015 02:00:00 AM,48,-122,0,1,1
12603,58thStGreenway22ndAve,07/08/2015 03:00:00 AM,48,-122,0,0,0
12604,58thStGreenway22ndAve,07/08/2015 04:00:00 AM,48,-122,0,1,1
12605,58thStGreenway22ndAve,07/08/2015 05:00:00 AM,48,-122,1,0,1
12606,58thStGreenway22ndAve,07/08/2015 06:00:00 AM,48,-122,3,6,9
12607,58thStGreenway22ndAve,07/08/2015 07:00:00 AM,48,-122,4,3,7
12608,58thStGreenway22ndAve,07/08/2015 08:00:00 AM,48,-122,5,6,11
12609,58thStGreenway22ndAve,07/08/2015 09:00:00 AM,48,-122,4,6,10
12610,58thStGreenway22ndAve,07/08/2015 10:00:00 AM,48,-122,2,9,11
12611,58thStGreenway22ndAve,07/08/2015 11:00:00 AM,48,-122,6,1,7
12612,58thStGreenway22ndAve,07/08/2015 12:00:00 PM,48,-122,7,4,11
12613,58thStGreenway22ndAve,07/08/2015 01:00:00 PM,48,-122,2,5,7
12614,58thStGreenway22ndAve,07/08/2015 02:00:00 PM,48,-122,1,1,2
12615,58thStGreenway22ndAve,07/08/2015 03:00:00 PM,48,-122,6,2,8
12616,58thStGreenway22ndAve,07/08/2015 04:00:00 PM,48,-122,9,8,17
12617,58thStGreenway22ndAve,07/08/2015 05:00:00 PM,48,-122,12,9,21
12618,58thStGreenway22ndAve,07/08/2015 06:00:00 PM,48,-122,10,8,18
12619,58thStGreenway22ndAve,07/08/2015 07:00:00 PM,48,-122,6,7,13
12620,58thStGreenway22ndAve,07/08/2015 08:00:00 PM,48,-122,5,4,9
12621,58thStGreenway22ndAve,07/08/2015 09:00:00 PM,48,-122,4,2,6
12622,58thStGreenway22ndAve,07/08/2015 10:00:00 PM,48,-122,5,3,8
12623,58thStGreenway22ndAve,07/08/2015 11:00:00 PM,48,-122,1,0,1
12624,58thStGreenway22ndAve,07/09/2015 12:00:00 AM,48,-122,0,0,0
12625,58thStGreenway22ndAve,07/09/2015 01:00:00 AM,48,-122,0,0,0
12626,58thStGreenway22ndAve,07/09/2015 02:00:00 AM,48,-122,0,1,1
12627,58thStGreenway22ndAve,07/09/2015 03:00:00 AM,48,-122,0,1,1
12628,58thStGreenway22ndAve,07/09/2015 04:00:00 AM,48,-122,0,0,0
12629,58thStGreenway22ndAve,07/09/2015 05:00:00 AM,48,-122,2,0,2
12630,58thStGreenway22ndAve,07/09/2015 06:00:00 AM,48,-122,0,0,0
12631,58thStGreenway22ndAve,07/09/2015 07:00:00 AM,48,-122,1,7,8
12632,58thStGreenway22ndAve,07/09/2015 08:00:00 AM,48,-122,2,7,9
12633,58thStGreenway22ndAve,07/09/2015 09:00:00 AM,48,-122,2,7,9
12634,58thStGreenway22ndAve,07/09/2015 10:00:00 AM,48,-122,5,4,9
12635,58thStGreenway22ndAve,07/09/2015 11:00:00 AM,48,-122,5,2,7
12636,58thStGreenway22ndAve,07/09/2015 12:00:00 PM,48,-122,7,2,9
12637,58thStGreenway22ndAve,07/09/2015 01:00:00 PM,48,-122,2,6,8
12638,58thStGreenway22ndAve,07/09/2015 02:00:00 PM,48,-122,1,2,3
12639,58thStGreenway22ndAve,07/09/2015 03:00:00 PM,48,-122,6,4,10
12640,58thStGreenway22ndAve,07/09/2015 04:00:00 PM,48,-122,6,6,12
12641,58thStGreenway22ndAve,07/09/2015 05:00:00 PM,48,-122,10,4,14
12642,58thStGreenway22ndAve,07/09/2015 06:00:00 PM,48,-122,12,4,16
12643,58thStGreenway22ndAve,07/09/2015 07:00:00 PM,48,-122,10,8,18
12644,58thStGreenway22ndAve,07/09/2015 08:00:00 PM,48,-122,5,5,10
12645,58thStGreenway22ndAve,07/09/2015 09:00:00 PM,48,-122,3,2,5
12646,58thStGreenway22ndAve,07/09/2015 10:00:00 PM,48,-122,2,0,2
12647,58thStGreenway22ndAve,07/09/2015 11:00:00 PM,48,-122,0,2,2
12648,58thStGreenway22ndAve,07/10/2015 12:00:00 AM,48,-122,0,0,0
12649,58thStGreenway22ndAve,07/10/2015 01:00:00 AM,48,-122,0,0,0
12650,58thStGreenway22ndAve,07/10/2015 02:00:00 AM,48,-122,0,0,0
12651,58thStGreenway22ndAve,07/10/2015 03:00:00 AM,48,-122,0,0,0
12652,58thStGreenway22ndAve,07/10/2015 04:00:00 AM,48,-122,0,1,1
12653,58thStGreenway22ndAve,07/10/2015 05:00:00 AM,48,-122,1,0,1
12654,58thStGreenway22ndAve,07/10/2015 06:00:00 AM,48,-122,0,5,5
12655,58thStGreenway22ndAve,07/10/2015 07:00:00 AM,48,-122,2,2,4
12656,58thStGreenway22ndAve,07/10/2015 08:00:00 AM,48,-122,2,2,4
12657,58thStGreenway22ndAve,07/10/2015 09:00:00 AM,48,-122,3,2,5
12658,58thStGreenway22ndAve,07/10/2015 10:00:00 AM,48,-122,2,8,10
12659,58thStGreenway22ndAve,07/10/2015 11:00:00 AM,48,-122,2,5,7
12660,58thStGreenway22ndAve,07/10/2015 12:00:00 PM,48,-122,8,2,10
12661,58thStGreenway22ndAve,07/10/2015 01:00:00 PM,48,-122,4,2,6
12662,58thStGreenway22ndAve,07/10/2015 02:00:00 PM,48,-122,4,2,6
12663,58thStGreenway22ndAve,07/10/2015 03:00:00 PM,48,-122,6,3,9
12664,58thStGreenway22ndAve,07/10/2015 04:00:00 PM,48,-122,7,9,16
12665,58thStGreenway22ndAve,07/10/2015 05:00:00 PM,48,-122,9,2,11
12666,58thStGreenway22ndAve,07/10/2015 06:00:00 PM,48,-122,4,8,12
12667,58thStGreenway22ndAve,07/10/2015 07:00:00 PM,48,-122,1,0,1
12668,58thStGreenway22ndAve,07/10/2015 08:00:00 PM,48,-122,5,6,11
12669,58thStGreenway22ndAve,07/10/2015 09:00:00 PM,48,-122,4,0,4
12670,58thStGreenway22ndAve,07/10/2015 10:00:00 PM,48,-122,2,2,4
12671,58thStGreenway22ndAve,07/10/2015 11:00:00 PM,48,-122,1,0,1
12672,58thStGreenway22ndAve,07/11/2015 12:00:00 AM,48,-122,2,0,2
12673,58thStGreenway22ndAve,07/11/2015 01:00:00 AM,48,-122,0,0,0
12674,58thStGreenway22ndAve,07/11/2015 02:00:00 AM,48,-122,2,1,3
12675,58thStGreenway22ndAve,07/11/2015 03:00:00 AM,48,-122,0,1,1
12676,58thStGreenway22ndAve,07/11/2015 04:00:00 AM,48,-122,0,0,0
12677,58thStGreenway22ndAve,07/11/2015 05:00:00 AM,48,-122,1,0,1
12678,58thStGreenway22ndAve,07/11/2015 06:00:00 AM,48,-122,0,2,2
12679,58thStGreenway22ndAve,07/11/2015 07:00:00 AM,48,-122,2,4,6
12680,58thStGreenway22ndAve,07/11/2015 08:00:00 AM,48,-122,4,5,9
12681,58thStGreenway22ndAve,07/11/2015 09:00:00 AM,48,-122,7,9,16
12682,58thStGreenway22ndAve,07/11/2015 10:00:00 AM,48,-122,8,14,22
12683,58thStGreenway22ndAve,07/11/2015 11:00:00 AM,48,-122,2,9,11
12684,58thStGreenway22ndAve,07/11/2015 12:00:00 PM,48,-122,5,8,13
12685,58thStGreenway22ndAve,07/11/2015 01:00:00 PM,48,-122,4,15,19
12686,58thStGreenway22ndAve,07/11/2015 02:00:00 PM,48,-122,10,6,16
12687,58thStGreenway22ndAve,07/11/2015 03:00:00 PM,48,-122,10,12,22
12688,58thStGreenway22ndAve,07/11/2015 04:00:00 PM,48,-122,1,5,6
12689,58thStGreenway22ndAve,07/11/2015 05:00:00 PM,48,-122,11,12,23
12690,58thStGreenway22ndAve,07/11/2015 06:00:00 PM,48,-122,9,16,25
12691,58thStGreenway22ndAve,07/11/2015 07:00:00 PM,48,-122,6,4,10
12692,58thStGreenway22ndAve,07/11/2015 08:00:00 PM,48,-122,0,9,9
12693,58thStGreenway22ndAve,07/11/2015 09:00:00 PM,48,-122,5,5,10
12694,58thStGreenway22ndAve,07/11/2015 10:00:00 PM,48,-122,2,3,5
12695,58thStGreenway22ndAve,07/11/2015 11:00:00 PM,48,-122,3,0,3
12696,58thStGreenway22ndAve,07/12/2015 12:00:00 AM,48,-122,1,0,1
12697,58thStGreenway22ndAve,07/12/2015 01:00:00 AM,48,-122,1,0,1
12698,58thStGreenway22ndAve,07/12/2015 02:00:00 AM,48,-122,4,0,4
12699,58thStGreenway22ndAve,07/12/2015 03:00:00 AM,48,-122,3,1,4
12700,58thStGreenway22ndAve,07/12/2015 04:00:00 AM,48,-122,0,1,1
12701,58thStGreenway22ndAve,07/12/2015 05:00:00 AM,48,-122,0,0,0
12702,58thStGreenway22ndAve,07/12/2015 06:00:00 AM,48,-122,0,1,1
12703,58thStGreenway22ndAve,07/12/2015 07:00:00 AM,48,-122,1,2,3
12704,58thStGreenway22ndAve,07/12/2015 08:00:00 AM,48,-122,1,4,5
12705,58thStGreenway22ndAve,07/12/2015 09:00:00 AM,48,-122,7,3,10
12706,58thStGreenway22ndAve,07/12/2015 10:00:00 AM,48,-122,9,17,26
12707,58thStGreenway22ndAve,07/12/2015 11:00:00 AM,48,-122,6,20,26
12708,58thStGreenway22ndAve,07/12/2015 12:00:00 PM,48,-122,6,21,27
12709,58thStGreenway22ndAve,07/12/2015 01:00:00 PM,48,-122,11,11,22
12710,58thStGreenway22ndAve,07/12/2015 02:00:00 PM,48,-122,19,7,26
12711,58thStGreenway22ndAve,07/12/2015 03:00:00 PM,48,-122,4,12,16
12712,58thStGreenway22ndAve,07/12/2015 04:00:00 PM,48,-122,16,12,28
12713,58thStGreenway22ndAve,07/12/2015 05:00:00 PM,48,-122,12,10,22
12714,58thStGreenway22ndAve,07/12/2015 06:00:00 PM,48,-122,10,6,16
12715,58thStGreenway22ndAve,07/12/2015 07:00:00 PM,48,-122,17,9,26
12716,58thStGreenway22ndAve,07/12/2015 08:00:00 PM,48,-122,0,5,5
12717,58thStGreenway22ndAve,07/12/2015 09:00:00 PM,48,-122,4,2,6
12718,58thStGreenway22ndAve,07/12/2015 10:00:00 PM,48,-122,3,1,4
12719,58thStGreenway22ndAve,07/12/2015 11:00:00 PM,48,-122,0,2,2
12720,58thStGreenway22ndAve,07/13/2015 12:00:00 AM,48,-122,1,0,1
12721,58thStGreenway22ndAve,07/13/2015 01:00:00 AM,48,-122,0,0,0
12722,58thStGreenway22ndAve,07/13/2015 02:00:00 AM,48,-122,0,0,0
12723,58thStGreenway22ndAve,07/13/2015 03:00:00 AM,48,-122,0,0,0
12724,58thStGreenway22ndAve,07/13/2015 04:00:00 AM,48,-122,0,1,1
12725,58thStGreenway22ndAve,07/13/2015 05:00:00 AM,48,-122,0,0,0
12726,58thStGreenway22ndAve,07/13/2015 06:00:00 AM,48,-122,0,3,3
12727,58thStGreenway22ndAve,07/13/2015 07:00:00 AM,48,-122,5,3,8
12728,58thStGreenway22ndAve,07/13/2015 08:00:00 AM,48,-122,7,6,13
12729,58thStGreenway22ndAve,07/13/2015 09:00:00 AM,48,-122,1,5,6
12730,58thStGreenway22ndAve,07/13/2015 10:00:00 AM,48,-122,3,6,9
12731,58thStGreenway22ndAve,07/13/2015 11:00:00 AM,48,-122,1,4,5
12732,58thStGreenway22ndAve,07/13/2015 12:00:00 PM,48,-122,5,4,9
12733,58thStGreenway22ndAve,07/13/2015 01:00:00 PM,48,-122,4,4,8
12734,58thStGreenway22ndAve,07/13/2015 02:00:00 PM,48,-122,3,7,10
12735,58thStGreenway22ndAve,07/13/2015 03:00:00 PM,48,-122,1,6,7
12736,58thStGreenway22ndAve,07/13/2015 04:00:00 PM,48,-122,7,4,11
12737,58thStGreenway22ndAve,07/13/2015 05:00:00 PM,48,-122,10,9,19
12738,58thStGreenway22ndAve,07/13/2015 06:00:00 PM,48,-122,8,7,15
12739,58thStGreenway22ndAve,07/13/2015 07:00:00 PM,48,-122,10,6,16
12740,58thStGreenway22ndAve,07/13/2015 08:00:00 PM,48,-122,4,5,9
12741,58thStGreenway22ndAve,07/13/2015 09:00:00 PM,48,-122,2,7,9
12742,58thStGreenway22ndAve,07/13/2015 10:00:00 PM,48,-122,1,0,1
12743,58thStGreenway22ndAve,07/13/2015 11:00:00 PM,48,-122,2,0,2
12744,58thStGreenway22ndAve,07/14/2015 12:00:00 AM,48,-122,0,0,0
12745,58thStGreenway22ndAve,07/14/2015 01:00:00 AM,48,-122,0,0,0
12746,58thStGreenway22ndAve,07/14/2015 02:00:00 AM,48,-122,0,0,0
12747,58thStGreenway22ndAve,07/14/2015 03:00:00 AM,48,-122,1,0,1
12748,58thStGreenway22ndAve,07/14/2015 04:00:00 AM,48,-122,1,1,2
12749,58thStGreenway22ndAve,07/14/2015 05:00:00 AM,48,-122,2,0,2
12750,58thStGreenway22ndAve,07/14/2015 06:00:00 AM,48,-122,0,1,1
12751,58thStGreenway22ndAve,07/14/2015 07:00:00 AM,48,-122,2,5,7
12752,58thStGreenway22ndAve,07/14/2015 08:00:00 AM,48,-122,7,8,15
12753,58thStGreenway22ndAve,07/14/2015 09:00:00 AM,48,-122,5,11,16
12754,58thStGreenway22ndAve,07/14/2015 10:00:00 AM,48,-122,3,5,8
12755,58thStGreenway22ndAve,07/14/2015 11:00:00 AM,48,-122,3,4,7
12756,58thStGreenway22ndAve,07/14/2015 12:00:00 PM,48,-122,6,3,9
12757,58thStGreenway22ndAve,07/14/2015 01:00:00 PM,48,-122,3,0,3
12758,58thStGreenway22ndAve,07/14/2015 02:00:00 PM,48,-122,4,3,7
12759,58thStGreenway22ndAve,07/14/2015 03:00:00 PM,48,-122,9,3,12
12760,58thStGreenway22ndAve,07/14/2015 04:00:00 PM,48,-122,8,6,14
12761,58thStGreenway22ndAve,07/14/2015 05:00:00 PM,48,-122,18,13,31
12762,58thStGreenway22ndAve,07/14/2015 06:00:00 PM,48,-122,11,8,19
12763,58thStGreenway22ndAve,07/14/2015 07:00:00 PM,48,-122,9,9,18
12764,58thStGreenway22ndAve,07/14/2015 08:00:00 PM,48,-122,7,4,11
12765,58thStGreenway22ndAve,07/14/2015 09:00:00 PM,48,-122,6,4,10
12766,58thStGreenway22ndAve,07/14/2015 10:00:00 PM,48,-122,2,4,6
12767,58thStGreenway22ndAve,07/14/2015 11:00:00 PM,48,-122,5,1,6
12768,58thStGreenway22ndAve,07/15/2015 12:00:00 AM,48,-122,0,1,1
12769,58thStGreenway22ndAve,07/15/2015 01:00:00 AM,48,-122,0,0,0
12770,58thStGreenway22ndAve,07/15/2015 02:00:00 AM,48,-122,0,0,0
12771,58thStGreenway22ndAve,07/15/2015 03:00:00 AM,48,-122,1,0,1
12772,58thStGreenway22ndAve,07/15/2015 04:00:00 AM,48,-122,2,1,3
12773,58thStGreenway22ndAve,07/15/2015 05:00:00 AM,48,-122,0,0,0
12774,58thStGreenway22ndAve,07/15/2015 06:00:00 AM,48,-122,0,2,2
12775,58thStGreenway22ndAve,07/15/2015 07:00:00 AM,48,-122,6,5,11
12776,58thStGreenway22ndAve,07/15/2015 08:00:00 AM,48,-122,4,5,9
12777,58thStGreenway22ndAve,07/15/2015 09:00:00 AM,48,-122,5,8,13
12778,58thStGreenway22ndAve,07/15/2015 10:00:00 AM,48,-122,2,2,4
12779,58thStGreenway22ndAve,07/15/2015 11:00:00 AM,48,-122,2,2,4
12780,58thStGreenway22ndAve,07/15/2015 12:00:00 PM,48,-122,7,6,13
12781,58thStGreenway22ndAve,07/15/2015 01:00:00 PM,48,-122,3,3,6
12782,58thStGreenway22ndAve,07/15/2015 02:00:00 PM,48,-122,1,3,4
12783,58thStGreenway22ndAve,07/15/2015 03:00:00 PM,48,-122,11,9,20
12784,58thStGreenway22ndAve,07/15/2015 04:00:00 PM,48,-122,8,3,11
12785,58thStGreenway22ndAve,07/15/2015 05:00:00 PM,48,-122,10,7,17
12786,58thStGreenway22ndAve,07/15/2015 06:00:00 PM,48,-122,10,15,25
12787,58thStGreenway22ndAve,07/15/2015 07:00:00 PM,48,-122,6,10,16
12788,58thStGreenway22ndAve,07/15/2015 08:00:00 PM,48,-122,10,0,10
12789,58thStGreenway22ndAve,07/15/2015 09:00:00 PM,48,-122,1,1,2
12790,58thStGreenway22ndAve,07/15/2015 10:00:00 PM,48,-122,5,2,7
12791,58thStGreenway22ndAve,07/15/2015 11:00:00 PM,48,-122,0,0,0
12792,58thStGreenway22ndAve,07/16/2015 12:00:00 AM,48,-122,0,0,0
12793,58thStGreenway22ndAve,07/16/2015 01:00:00 AM,48,-122,0,0,0
12794,58thStGreenway22ndAve,07/16/2015 02:00:00 AM,48,-122,0,0,0
12795,58thStGreenway22ndAve,07/16/2015 03:00:00 AM,48,-122,0,0,0
12796,58thStGreenway22ndAve,07/16/2015 04:00:00 AM,48,-122,0,1,1
12797,58thStGreenway22ndAve,07/16/2015 05:00:00 AM,48,-122,0,0,0
12798,58thStGreenway22ndAve,07/16/2015 06:00:00 AM,48,-122,1,2,3
12799,58thStGreenway22ndAve,07/16/2015 07:00:00 AM,48,-122,2,3,5
12800,58thStGreenway22ndAve,07/16/2015 08:00:00 AM,48,-122,5,10,15
12801,58thStGreenway22ndAve,07/16/2015 09:00:00 AM,48,-122,5,6,11
12802,58thStGreenway22ndAve,07/16/2015 10:00:00 AM,48,-122,3,12,15
12803,58thStGreenway22ndAve,07/16/2015 11:00:00 AM,48,-122,7,5,12
12804,58thStGreenway22ndAve,07/16/2015 12:00:00 PM,48,-122,11,4,15
12805,58thStGreenway22ndAve,07/16/2015 01:00:00 PM,48,-122,2,2,4
12806,58thStGreenway22ndAve,07/16/2015 02:00:00 PM,48,-122,4,2,6
12807,58thStGreenway22ndAve,07/16/2015 03:00:00 PM,48,-122,1,7,8
12808,58thStGreenway22ndAve,07/16/2015 04:00:00 PM,48,-122,5,5,10
12809,58thStGreenway22ndAve,07/16/2015 05:00:00 PM,48,-122,8,5,13
12810,58thStGreenway22ndAve,07/16/2015 06:00:00 PM,48,-122,13,14,27
12811,58thStGreenway22ndAve,07/16/2015 07:00:00 PM,48,-122,9,10,19
12812,58thStGreenway22ndAve,07/16/2015 08:00:00 PM,48,-122,6,7,13
12813,58thStGreenway22ndAve,07/16/2015 09:00:00 PM,48,-122,4,6,10
12814,58thStGreenway22ndAve,07/16/2015 10:00:00 PM,48,-122,0,1,1
12815,58thStGreenway22ndAve,07/16/2015 11:00:00 PM,48,-122,6,0,6
12816,58thStGreenway22ndAve,07/17/2015 12:00:00 AM,48,-122,0,0,0
12817,58thStGreenway22ndAve,07/17/2015 01:00:00 AM,48,-122,0,0,0
12818,58thStGreenway22ndAve,07/17/2015 02:00:00 AM,48,-122,1,1,2
12819,58thStGreenway22ndAve,07/17/2015 03:00:00 AM,48,-122,0,0,0
12820,58thStGreenway22ndAve,07/17/2015 04:00:00 AM,48,-122,0,1,1
12821,58thStGreenway22ndAve,07/17/2015 05:00:00 AM,48,-122,1,0,1
12822,58thStGreenway22ndAve,07/17/2015 06:00:00 AM,48,-122,1,5,6
12823,58thStGreenway22ndAve,07/17/2015 07:00:00 AM,48,-122,2,4,6
12824,58thStGreenway22ndAve,07/17/2015 08:00:00 AM,48,-122,4,9,13
12825,58thStGreenway22ndAve,07/17/2015 09:00:00 AM,48,-122,3,8,11
12826,58thStGreenway22ndAve,07/17/2015 10:00:00 AM,48,-122,2,5,7
12827,58thStGreenway22ndAve,07/17/2015 11:00:00 AM,48,-122,4,2,6
12828,58thStGreenway22ndAve,07/17/2015 12:00:00 PM,48,-122,6,4,10
12829,58thStGreenway22ndAve,07/17/2015 01:00:00 PM,48,-122,9,5,14
12830,58thStGreenway22ndAve,07/17/2015 02:00:00 PM,48,-122,4,5,9
12831,58thStGreenway22ndAve,07/17/2015 03:00:00 PM,48,-122,4,7,11
12832,58thStGreenway22ndAve,07/17/2015 04:00:00 PM,48,-122,20,4,24
12833,58thStGreenway22ndAve,07/17/2015 05:00:00 PM,48,-122,9,7,16
12834,58thStGreenway22ndAve,07/17/2015 06:00:00 PM,48,-122,7,5,12
12835,58thStGreenway22ndAve,07/17/2015 07:00:00 PM,48,-122,13,6,19
12836,58thStGreenway22ndAve,07/17/2015 08:00:00 PM,48,-122,8,3,11
12837,58thStGreenway22ndAve,07/17/2015 09:00:00 PM,48,-122,2,2,4
12838,58thStGreenway22ndAve,07/17/2015 10:00:00 PM,48,-122,2,1,3
12839,58thStGreenway22ndAve,07/17/2015 11:00:00 PM,48,-122,4,0,4
12840,58thStGreenway22ndAve,07/18/2015 12:00:00 AM,48,-122,1,1,2
12841,58thStGreenway22ndAve,07/18/2015 01:00:00 AM,48,-122,0,0,0
12842,58thStGreenway22ndAve,07/18/2015 02:00:00 AM,48,-122,2,0,2
12843,58thStGreenway22ndAve,07/18/2015 03:00:00 AM,48,-122,0,0,0
12844,58thStGreenway22ndAve,07/18/2015 04:00:00 AM,48,-122,0,0,0
12845,58thStGreenway22ndAve,07/18/2015 05:00:00 AM,48,-122,0,0,0
12846,58thStGreenway22ndAve,07/18/2015 06:00:00 AM,48,-122,0,0,0
12847,58thStGreenway22ndAve,07/18/2015 07:00:00 AM,48,-122,0,0,0
12848,58thStGreenway22ndAve,07/18/2015 08:00:00 AM,48,-122,0,6,6
12849,58thStGreenway22ndAve,07/18/2015 09:00:00 AM,48,-122,8,2,10
12850,58thStGreenway22ndAve,07/18/2015 10:00:00 AM,48,-122,10,7,17
12851,58thStGreenway22ndAve,07/18/2015 11:00:00 AM,48,-122,8,8,16
12852,58thStGreenway22ndAve,07/18/2015 12:00:00 PM,48,-122,5,2,7
12853,58thStGreenway22ndAve,07/18/2015 01:00:00 PM,48,-122,14,12,26
12854,58thStGreenway22ndAve,07/18/2015 02:00:00 PM,48,-122,6,16,22
12855,58thStGreenway22ndAve,07/18/2015 03:00:00 PM,48,-122,6,5,11
12856,58thStGreenway22ndAve,07/18/2015 04:00:00 PM,48,-122,7,4,11
12857,58thStGreenway22ndAve,07/18/2015 05:00:00 PM,48,-122,8,4,12
12858,58thStGreenway22ndAve,07/18/2015 06:00:00 PM,48,-122,4,3,7
12859,58thStGreenway22ndAve,07/18/2015 07:00:00 PM,48,-122,4,3,7
12860,58thStGreenway22ndAve,07/18/2015 08:00:00 PM,48,-122,3,5,8
12861,58thStGreenway22ndAve,07/18/2015 09:00:00 PM,48,-122,11,0,11
12862,58thStGreenway22ndAve,07/18/2015 10:00:00 PM,48,-122,6,1,7
12863,58thStGreenway22ndAve,07/18/2015 11:00:00 PM,48,-122,0,0,0
12864,58thStGreenway22ndAve,07/19/2015 12:00:00 AM,48,-122,0,0,0
12865,58thStGreenway22ndAve,07/19/2015 01:00:00 AM,48,-122,2,0,2
12866,58thStGreenway22ndAve,07/19/2015 02:00:00 AM,48,-122,0,0,0
12867,58thStGreenway22ndAve,07/19/2015 03:00:00 AM,48,-122,0,0,0
12868,58thStGreenway22ndAve,07/19/2015 04:00:00 AM,48,-122,0,0,0
12869,58thStGreenway22ndAve,07/19/2015 05:00:00 AM,48,-122,0,0,0
12870,58thStGreenway22ndAve,07/19/2015 06:00:00 AM,48,-122,0,0,0
12871,58thStGreenway22ndAve,07/19/2015 07:00:00 AM,48,-122,1,1,2
12872,58thStGreenway22ndAve,07/19/2015 08:00:00 AM,48,-122,0,5,5
12873,58thStGreenway22ndAve,07/19/2015 09:00:00 AM,48,-122,6,5,11
12874,58thStGreenway22ndAve,07/19/2015 10:00:00 AM,48,-122,19,9,28
12875,58thStGreenway22ndAve,07/19/2015 11:00:00 AM,48,-122,13,13,26
12876,58thStGreenway22ndAve,07/19/2015 12:00:00 PM,48,-122,11,10,21
12877,58thStGreenway22ndAve,07/19/2015 01:00:00 PM,48,-122,3,7,10
12878,58thStGreenway22ndAve,07/19/2015 02:00:00 PM,48,-122,15,16,31
12879,58thStGreenway22ndAve,07/19/2015 03:00:00 PM,48,-122,9,7,16
12880,58thStGreenway22ndAve,07/19/2015 04:00:00 PM,48,-122,6,2,8
12881,58thStGreenway22ndAve,07/19/2015 05:00:00 PM,48,-122,14,5,19
12882,58thStGreenway22ndAve,07/19/2015 06:00:00 PM,48,-122,5,2,7
12883,58thStGreenway22ndAve,07/19/2015 07:00:00 PM,48,-122,3,5,8
12884,58thStGreenway22ndAve,07/19/2015 08:00:00 PM,48,-122,6,3,9
12885,58thStGreenway22ndAve,07/19/2015 09:00:00 PM,48,-122,7,1,8
12886,58thStGreenway22ndAve,07/19/2015 10:00:00 PM,48,-122,0,0,0
12887,58thStGreenway22ndAve,07/19/2015 11:00:00 PM,48,-122,0,1,1
12888,58thStGreenway22ndAve,07/20/2015 12:00:00 AM,48,-122,2,0,2
12889,58thStGreenway22ndAve,07/20/2015 01:00:00 AM,48,-122,1,0,1
12890,58thStGreenway22ndAve,07/20/2015 02:00:00 AM,48,-122,2,0,2
12891,58thStGreenway22ndAve,07/20/2015 03:00:00 AM,48,-122,0,0,0
12892,58thStGreenway22ndAve,07/20/2015 04:00:00 AM,48,-122,0,1,1
12893,58thStGreenway22ndAve,07/20/2015 05:00:00 AM,48,-122,1,0,1
12894,58thStGreenway22ndAve,07/20/2015 06:00:00 AM,48,-122,0,3,3
12895,58thStGreenway22ndAve,07/20/2015 07:00:00 AM,48,-122,3,4,7
12896,58thStGreenway22ndAve,07/20/2015 08:00:00 AM,48,-122,8,4,12
12897,58thStGreenway22ndAve,07/20/2015 09:00:00 AM,48,-122,6,14,20
12898,58thStGreenway22ndAve,07/20/2015 10:00:00 AM,48,-122,2,4,6
12899,58thStGreenway22ndAve,07/20/2015 11:00:00 AM,48,-122,4,3,7
12900,58thStGreenway22ndAve,07/20/2015 12:00:00 PM,48,-122,6,2,8
12901,58thStGreenway22ndAve,07/20/2015 01:00:00 PM,48,-122,2,4,6
12902,58thStGreenway22ndAve,07/20/2015 02:00:00 PM,48,-122,6,2,8
12903,58thStGreenway22ndAve,07/20/2015 03:00:00 PM,48,-122,2,6,8
12904,58thStGreenway22ndAve,07/20/2015 04:00:00 PM,48,-122,10,2,12
12905,58thStGreenway22ndAve,07/20/2015 05:00:00 PM,48,-122,13,10,23
12906,58thStGreenway22ndAve,07/20/2015 06:00:00 PM,48,-122,10,11,21
12907,58thStGreenway22ndAve,07/20/2015 07:00:00 PM,48,-122,8,7,15
12908,58thStGreenway22ndAve,07/20/2015 08:00:00 PM,48,-122,4,3,7
12909,58thStGreenway22ndAve,07/20/2015 09:00:00 PM,48,-122,2,2,4
12910,58thStGreenway22ndAve,07/20/2015 10:00:00 PM,48,-122,3,1,4
12911,58thStGreenway22ndAve,07/20/2015 11:00:00 PM,48,-122,2,0,2
12912,58thStGreenway22ndAve,07/21/2015 12:00:00 AM,48,-122,0,0,0
12913,58thStGreenway22ndAve,07/21/2015 01:00:00 AM,48,-122,1,0,1
12914,58thStGreenway22ndAve,07/21/2015 02:00:00 AM,48,-122,0,0,0
12915,58thStGreenway22ndAve,07/21/2015 03:00:00 AM,48,-122,0,0,0
12916,58thStGreenway22ndAve,07/21/2015 04:00:00 AM,48,-122,0,1,1
12917,58thStGreenway22ndAve,07/21/2015 05:00:00 AM,48,-122,1,0,1
12918,58thStGreenway22ndAve,07/21/2015 06:00:00 AM,48,-122,1,0,1
12919,58thStGreenway22ndAve,07/21/2015 07:00:00 AM,48,-122,3,3,6
12920,58thStGreenway22ndAve,07/21/2015 08:00:00 AM,48,-122,7,4,11
12921,58thStGreenway22ndAve,07/21/2015 09:00:00 AM,48,-122,3,8,11
12922,58thStGreenway22ndAve,07/21/2015 10:00:00 AM,48,-122,0,5,5
12923,58thStGreenway22ndAve,07/21/2015 11:00:00 AM,48,-122,1,6,7
12924,58thStGreenway22ndAve,07/21/2015 12:00:00 PM,48,-122,8,5,13
12925,58thStGreenway22ndAve,07/21/2015 01:00:00 PM,48,-122,4,5,9
12926,58thStGreenway22ndAve,07/21/2015 02:00:00 PM,48,-122,2,4,6
12927,58thStGreenway22ndAve,07/21/2015 03:00:00 PM,48,-122,7,1,8
12928,58thStGreenway22ndAve,07/21/2015 04:00:00 PM,48,-122,4,3,7
12929,58thStGreenway22ndAve,07/21/2015 05:00:00 PM,48,-122,13,5,18
12930,58thStGreenway22ndAve,07/21/2015 06:00:00 PM,48,-122,6,7,13
12931,58thStGreenway22ndAve,07/21/2015 07:00:00 PM,48,-122,9,23,32
12932,58thStGreenway22ndAve,07/21/2015 08:00:00 PM,48,-122,3,6,9
12933,58thStGreenway22ndAve,07/21/2015 09:00:00 PM,48,-122,3,3,6
12934,58thStGreenway22ndAve,07/21/2015 10:00:00 PM,48,-122,8,1,9
12935,58thStGreenway22ndAve,07/21/2015 11:00:00 PM,48,-122,2,0,2
12936,58thStGreenway22ndAve,07/22/2015 12:00:00 AM,48,-122,0,0,0
12937,58thStGreenway22ndAve,07/22/2015 01:00:00 AM,48,-122,0,0,0
12938,58thStGreenway22ndAve,07/22/2015 02:00:00 AM,48,-122,0,0,0
12939,58thStGreenway22ndAve,07/22/2015 03:00:00 AM,48,-122,1,0,1
12940,58thStGreenway22ndAve,07/22/2015 04:00:00 AM,48,-122,0,1,1
12941,58thStGreenway22ndAve,07/22/2015 05:00:00 AM,48,-122,1,0,1
12942,58thStGreenway22ndAve,07/22/2015 06:00:00 AM,48,-122,1,1,2
12943,58thStGreenway22ndAve,07/22/2015 07:00:00 AM,48,-122,4,3,7
12944,58thStGreenway22ndAve,07/22/2015 08:00:00 AM,48,-122,2,8,10
12945,58thStGreenway22ndAve,07/22/2015 09:00:00 AM,48,-122,3,9,12
12946,58thStGreenway22ndAve,07/22/2015 10:00:00 AM,48,-122,5,9,14
12947,58thStGreenway22ndAve,07/22/2015 11:00:00 AM,48,-122,8,3,11
12948,58thStGreenway22ndAve,07/22/2015 12:00:00 PM,48,-122,0,2,2
12949,58thStGreenway22ndAve,07/22/2015 01:00:00 PM,48,-122,3,2,5
12950,58thStGreenway22ndAve,07/22/2015 02:00:00 PM,48,-122,3,1,4
12951,58thStGreenway22ndAve,07/22/2015 03:00:00 PM,48,-122,5,1,6
12952,58thStGreenway22ndAve,07/22/2015 04:00:00 PM,48,-122,8,5,13
12953,58thStGreenway22ndAve,07/22/2015 05:00:00 PM,48,-122,8,11,19
12954,58thStGreenway22ndAve,07/22/2015 06:00:00 PM,48,-122,11,6,17
12955,58thStGreenway22ndAve,07/22/2015 07:00:00 PM,48,-122,6,5,11
12956,58thStGreenway22ndAve,07/22/2015 08:00:00 PM,48,-122,2,3,5
12957,58thStGreenway22ndAve,07/22/2015 09:00:00 PM,48,-122,7,4,11
12958,58thStGreenway22ndAve,07/22/2015 10:00:00 PM,48,-122,0,1,1
12959,58thStGreenway22ndAve,07/22/2015 11:00:00 PM,48,-122,0,0,0
12960,58thStGreenway22ndAve,07/23/2015 12:00:00 AM,48,-122,0,2,2
12961,58thStGreenway22ndAve,07/23/2015 01:00:00 AM,48,-122,0,1,1
12962,58thStGreenway22ndAve,07/23/2015 02:00:00 AM,48,-122,0,0,0
12963,58thStGreenway22ndAve,07/23/2015 03:00:00 AM,48,-122,0,0,0
12964,58thStGreenway22ndAve,07/23/2015 04:00:00 AM,48,-122,0,1,1
12965,58thStGreenway22ndAve,07/23/2015 05:00:00 AM,48,-122,1,0,1
12966,58thStGreenway22ndAve,07/23/2015 06:00:00 AM,48,-122,0,2,2
12967,58thStGreenway22ndAve,07/23/2015 07:00:00 AM,48,-122,3,4,7
12968,58thStGreenway22ndAve,07/23/2015 08:00:00 AM,48,-122,8,6,14
12969,58thStGreenway22ndAve,07/23/2015 09:00:00 AM,48,-122,4,6,10
12970,58thStGreenway22ndAve,07/23/2015 10:00:00 AM,48,-122,3,3,6
12971,58thStGreenway22ndAve,07/23/2015 11:00:00 AM,48,-122,4,5,9
12972,58thStGreenway22ndAve,07/23/2015 12:00:00 PM,48,-122,2,3,5
12973,58thStGreenway22ndAve,07/23/2015 01:00:00 PM,48,-122,7,5,12
12974,58thStGreenway22ndAve,07/23/2015 02:00:00 PM,48,-122,2,0,2
12975,58thStGreenway22ndAve,07/23/2015 03:00:00 PM,48,-122,2,5,7
12976,58thStGreenway22ndAve,07/23/2015 04:00:00 PM,48,-122,3,9,12
12977,58thStGreenway22ndAve,07/23/2015 05:00:00 PM,48,-122,13,4,17
12978,58thStGreenway22ndAve,07/23/2015 06:00:00 PM,48,-122,9,4,13
12979,58thStGreenway22ndAve,07/23/2015 07:00:00 PM,48,-122,8,6,14
12980,58thStGreenway22ndAve,07/23/2015 08:00:00 PM,48,-122,6,6,12
12981,58thStGreenway22ndAve,07/23/2015 09:00:00 PM,48,-122,5,2,7
12982,58thStGreenway22ndAve,07/23/2015 10:00:00 PM,48,-122,2,3,5
12983,58thStGreenway22ndAve,07/23/2015 11:00:00 PM,48,-122,4,0,4
12984,58thStGreenway22ndAve,07/24/2015 12:00:00 AM,48,-122,0,0,0
12985,58thStGreenway22ndAve,07/24/2015 01:00:00 AM,48,-122,0,1,1
12986,58thStGreenway22ndAve,07/24/2015 02:00:00 AM,48,-122,1,0,1
12987,58thStGreenway22ndAve,07/24/2015 03:00:00 AM,48,-122,0,0,0
12988,58thStGreenway22ndAve,07/24/2015 04:00:00 AM,48,-122,0,1,1
12989,58thStGreenway22ndAve,07/24/2015 05:00:00 AM,48,-122,0,0,0
12990,58thStGreenway22ndAve,07/24/2015 06:00:00 AM,48,-122,0,2,2
12991,58thStGreenway22ndAve,07/24/2015 07:00:00 AM,48,-122,4,7,11
12992,58thStGreenway22ndAve,07/24/2015 08:00:00 AM,48,-122,3,4,7
12993,58thStGreenway22ndAve,07/24/2015 09:00:00 AM,48,-122,6,6,12
12994,58thStGreenway22ndAve,07/24/2015 10:00:00 AM,48,-122,1,3,4
12995,58thStGreenway22ndAve,07/24/2015 11:00:00 AM,48,-122,5,1,6
12996,58thStGreenway22ndAve,07/24/2015 12:00:00 PM,48,-122,1,4,5
12997,58thStGreenway22ndAve,07/24/2015 01:00:00 PM,48,-122,6,6,12
12998,58thStGreenway22ndAve,07/24/2015 02:00:00 PM,48,-122,4,2,6
12999,58thStGreenway22ndAve,07/24/2015 03:00:00 PM,48,-122,7,4,11
13000,58thStGreenway22ndAve,07/24/2015 04:00:00 PM,48,-122,8,6,14
13001,58thStGreenway22ndAve,07/24/2015 05:00:00 PM,48,-122,13,8,21
13002,58thStGreenway22ndAve,07/24/2015 06:00:00 PM,48,-122,4,9,13
13003,58thStGreenway22ndAve,07/24/2015 07:00:00 PM,48,-122,3,0,3
13004,58thStGreenway22ndAve,07/24/2015 08:00:00 PM,48,-122,3,3,6
13005,58thStGreenway22ndAve,07/24/2015 09:00:00 PM,48,-122,5,3,8
13006,58thStGreenway22ndAve,07/24/2015 10:00:00 PM,48,-122,0,0,0
13007,58thStGreenway22ndAve,07/24/2015 11:00:00 PM,48,-122,1,8,9
13008,58thStGreenway22ndAve,07/25/2015 12:00:00 AM,48,-122,0,0,0
13009,58thStGreenway22ndAve,07/25/2015 01:00:00 AM,48,-122,2,0,2
13010,58thStGreenway22ndAve,07/25/2015 02:00:00 AM,48,-122,0,1,1
13011,58thStGreenway22ndAve,07/25/2015 03:00:00 AM,48,-122,0,0,0
13012,58thStGreenway22ndAve,07/25/2015 04:00:00 AM,48,-122,0,0,0
13013,58thStGreenway22ndAve,07/25/2015 05:00:00 AM,48,-122,0,0,0
13014,58thStGreenway22ndAve,07/25/2015 06:00:00 AM,48,-122,0,0,0
13015,58thStGreenway22ndAve,07/25/2015 07:00:00 AM,48,-122,0,1,1
13016,58thStGreenway22ndAve,07/25/2015 08:00:00 AM,48,-122,0,2,2
13017,58thStGreenway22ndAve,07/25/2015 09:00:00 AM,48,-122,3,4,7
13018,58thStGreenway22ndAve,07/25/2015 10:00:00 AM,48,-122,3,4,7
13019,58thStGreenway22ndAve,07/25/2015 11:00:00 AM,48,-122,1,2,3
13020,58thStGreenway22ndAve,07/25/2015 12:00:00 PM,48,-122,5,4,9
13021,58thStGreenway22ndAve,07/25/2015 01:00:00 PM,48,-122,1,8,9
13022,58thStGreenway22ndAve,07/25/2015 02:00:00 PM,48,-122,0,1,1
13023,58thStGreenway22ndAve,07/25/2015 03:00:00 PM,48,-122,4,0,4
13024,58thStGreenway22ndAve,07/25/2015 04:00:00 PM,48,-122,5,9,14
13025,58thStGreenway22ndAve,07/25/2015 05:00:00 PM,48,-122,7,7,14
13026,58thStGreenway22ndAve,07/25/2015 06:00:00 PM,48,-122,3,1,4
13027,58thStGreenway22ndAve,07/25/2015 07:00:00 PM,48,-122,0,4,4
13028,58thStGreenway22ndAve,07/25/2015 08:00:00 PM,48,-122,1,0,1
13029,58thStGreenway22ndAve,07/25/2015 09:00:00 PM,48,-122,4,2,6
13030,58thStGreenway22ndAve,07/25/2015 10:00:00 PM,48,-122,0,0,0
13031,58thStGreenway22ndAve,07/25/2015 11:00:00 PM,48,-122,1,0,1
13032,58thStGreenway22ndAve,07/26/2015 12:00:00 AM,48,-122,0,0,0
13033,58thStGreenway22ndAve,07/26/2015 01:00:00 AM,48,-122,0,2,2
13034,58thStGreenway22ndAve,07/26/2015 02:00:00 AM,48,-122,0,0,0
13035,58thStGreenway22ndAve,07/26/2015 03:00:00 AM,48,-122,0,0,0
13036,58thStGreenway22ndAve,07/26/2015 04:00:00 AM,48,-122,0,0,0
13037,58thStGreenway22ndAve,07/26/2015 05:00:00 AM,48,-122,0,1,1
13038,58thStGreenway22ndAve,07/26/2015 06:00:00 AM,48,-122,0,0,0
13039,58thStGreenway22ndAve,07/26/2015 07:00:00 AM,48,-122,1,0,1
13040,58thStGreenway22ndAve,07/26/2015 08:00:00 AM,48,-122,0,4,4
13041,58thStGreenway22ndAve,07/26/2015 09:00:00 AM,48,-122,8,4,12
13042,58thStGreenway22ndAve,07/26/2015 10:00:00 AM,48,-122,5,12,17
13043,58thStGreenway22ndAve,07/26/2015 11:00:00 AM,48,-122,4,8,12
13044,58thStGreenway22ndAve,07/26/2015 12:00:00 PM,48,-122,6,6,12
13045,58thStGreenway22ndAve,07/26/2015 01:00:00 PM,48,-122,9,8,17
13046,58thStGreenway22ndAve,07/26/2015 02:00:00 PM,48,-122,8,9,17
13047,58thStGreenway22ndAve,07/26/2015 03:00:00 PM,48,-122,10,4,14
13048,58thStGreenway22ndAve,07/26/2015 04:00:00 PM,48,-122,7,1,8
13049,58thStGreenway22ndAve,07/26/2015 05:00:00 PM,48,-122,0,4,4
13050,58thStGreenway22ndAve,07/26/2015 06:00:00 PM,48,-122,0,3,3
13051,58thStGreenway22ndAve,07/26/2015 07:00:00 PM,48,-122,4,1,5
13052,58thStGreenway22ndAve,07/26/2015 08:00:00 PM,48,-122,2,4,6
13053,58thStGreenway22ndAve,07/26/2015 09:00:00 PM,48,-122,0,0,0
13054,58thStGreenway22ndAve,07/26/2015 10:00:00 PM,48,-122,1,0,1
13055,58thStGreenway22ndAve,07/26/2015 11:00:00 PM,48,-122,0,0,0
13056,58thStGreenway22ndAve,07/27/2015 12:00:00 AM,48,-122,1,0,1
13057,58thStGreenway22ndAve,07/27/2015 01:00:00 AM,48,-122,0,0,0
13058,58thStGreenway22ndAve,07/27/2015 02:00:00 AM,48,-122,1,0,1
13059,58thStGreenway22ndAve,07/27/2015 03:00:00 AM,48,-122,0,0,0
13060,58thStGreenway22ndAve,07/27/2015 04:00:00 AM,48,-122,0,1,1
13061,58thStGreenway22ndAve,07/27/2015 05:00:00 AM,48,-122,1,0,1
13062,58thStGreenway22ndAve,07/27/2015 06:00:00 AM,48,-122,0,1,1
13063,58thStGreenway22ndAve,07/27/2015 07:00:00 AM,48,-122,2,2,4
13064,58thStGreenway22ndAve,07/27/2015 08:00:00 AM,48,-122,7,7,14
13065,58thStGreenway22ndAve,07/27/2015 09:00:00 AM,48,-122,4,4,8
13066,58thStGreenway22ndAve,07/27/2015 10:00:00 AM,48,-122,5,2,7
13067,58thStGreenway22ndAve,07/27/2015 11:00:00 AM,48,-122,0,3,3
13068,58thStGreenway22ndAve,07/27/2015 12:00:00 PM,48,-122,5,2,7
13069,58thStGreenway22ndAve,07/27/2015 01:00:00 PM,48,-122,3,7,10
13070,58thStGreenway22ndAve,07/27/2015 02:00:00 PM,48,-122,1,2,3
13071,58thStGreenway22ndAve,07/27/2015 03:00:00 PM,48,-122,3,5,8
13072,58thStGreenway22ndAve,07/27/2015 04:00:00 PM,48,-122,5,5,10
13073,58thStGreenway22ndAve,07/27/2015 05:00:00 PM,48,-122,13,10,23
13074,58thStGreenway22ndAve,07/27/2015 06:00:00 PM,48,-122,17,8,25
13075,58thStGreenway22ndAve,07/27/2015 07:00:00 PM,48,-122,7,1,8
13076,58thStGreenway22ndAve,07/27/2015 08:00:00 PM,48,-122,2,7,9
13077,58thStGreenway22ndAve,07/27/2015 09:00:00 PM,48,-122,3,1,4
13078,58thStGreenway22ndAve,07/27/2015 10:00:00 PM,48,-122,3,0,3
13079,58thStGreenway22ndAve,07/27/2015 11:00:00 PM,48,-122,2,0,2
13080,58thStGreenway22ndAve,07/28/2015 12:00:00 AM,48,-122,1,1,2
13081,58thStGreenway22ndAve,07/28/2015 01:00:00 AM,48,-122,0,1,1
13082,58thStGreenway22ndAve,07/28/2015 02:00:00 AM,48,-122,0,0,0
13083,58thStGreenway22ndAve,07/28/2015 03:00:00 AM,48,-122,0,0,0
13084,58thStGreenway22ndAve,07/28/2015 04:00:00 AM,48,-122,0,1,1
13085,58thStGreenway22ndAve,07/28/2015 05:00:00 AM,48,-122,1,0,1
13086,58thStGreenway22ndAve,07/28/2015 06:00:00 AM,48,-122,1,1,2
13087,58thStGreenway22ndAve,07/28/2015 07:00:00 AM,48,-122,2,5,7
13088,58thStGreenway22ndAve,07/28/2015 08:00:00 AM,48,-122,5,2,7
13089,58thStGreenway22ndAve,07/28/2015 09:00:00 AM,48,-122,3,7,10
13090,58thStGreenway22ndAve,07/28/2015 10:00:00 AM,48,-122,3,7,10
13091,58thStGreenway22ndAve,07/28/2015 11:00:00 AM,48,-122,2,4,6
13092,58thStGreenway22ndAve,07/28/2015 12:00:00 PM,48,-122,6,8,14
13093,58thStGreenway22ndAve,07/28/2015 01:00:00 PM,48,-122,6,8,14
13094,58thStGreenway22ndAve,07/28/2015 02:00:00 PM,48,-122,6,8,14
13095,58thStGreenway22ndAve,07/28/2015 03:00:00 PM,48,-122,13,4,17
13096,58thStGreenway22ndAve,07/28/2015 04:00:00 PM,48,-122,7,10,17
13097,58thStGreenway22ndAve,07/28/2015 05:00:00 PM,48,-122,10,14,24
13098,58thStGreenway22ndAve,07/28/2015 06:00:00 PM,48,-122,14,11,25
13099,58thStGreenway22ndAve,07/28/2015 07:00:00 PM,48,-122,5,15,20
13100,58thStGreenway22ndAve,07/28/2015 08:00:00 PM,48,-122,8,4,12
13101,58thStGreenway22ndAve,07/28/2015 09:00:00 PM,48,-122,7,5,12
13102,58thStGreenway22ndAve,07/28/2015 10:00:00 PM,48,-122,4,0,4
13103,58thStGreenway22ndAve,07/28/2015 11:00:00 PM,48,-122,1,1,2
13104,58thStGreenway22ndAve,07/29/2015 12:00:00 AM,48,-122,0,0,0
13105,58thStGreenway22ndAve,07/29/2015 01:00:00 AM,48,-122,0,0,0
13106,58thStGreenway22ndAve,07/29/2015 02:00:00 AM,48,-122,0,0,0
13107,58thStGreenway22ndAve,07/29/2015 03:00:00 AM,48,-122,0,1,1
13108,58thStGreenway22ndAve,07/29/2015 04:00:00 AM,48,-122,0,0,0
13109,58thStGreenway22ndAve,07/29/2015 05:00:00 AM,48,-122,1,0,1
13110,58thStGreenway22ndAve,07/29/2015 06:00:00 AM,48,-122,1,1,2
13111,58thStGreenway22ndAve,07/29/2015 07:00:00 AM,48,-122,1,3,4
13112,58thStGreenway22ndAve,07/29/2015 08:00:00 AM,48,-122,3,4,7
13113,58thStGreenway22ndAve,07/29/2015 09:00:00 AM,48,-122,4,2,6
13114,58thStGreenway22ndAve,07/29/2015 10:00:00 AM,48,-122,1,5,6
13115,58thStGreenway22ndAve,07/29/2015 11:00:00 AM,48,-122,6,1,7
13116,58thStGreenway22ndAve,07/29/2015 12:00:00 PM,48,-122,4,1,5
13117,58thStGreenway22ndAve,07/29/2015 01:00:00 PM,48,-122,1,2,3
13118,58thStGreenway22ndAve,07/29/2015 02:00:00 PM,48,-122,7,5,12
13119,58thStGreenway22ndAve,07/29/2015 03:00:00 PM,48,-122,9,5,14
13120,58thStGreenway22ndAve,07/29/2015 04:00:00 PM,48,-122,8,8,16
13121,58thStGreenway22ndAve,07/29/2015 05:00:00 PM,48,-122,12,6,18
13122,58thStGreenway22ndAve,07/29/2015 06:00:00 PM,48,-122,13,12,25
13123,58thStGreenway22ndAve,07/29/2015 07:00:00 PM,48,-122,7,6,13
13124,58thStGreenway22ndAve,07/29/2015 08:00:00 PM,48,-122,4,5,9
13125,58thStGreenway22ndAve,07/29/2015 09:00:00 PM,48,-122,4,5,9
13126,58thStGreenway22ndAve,07/29/2015 10:00:00 PM,48,-122,6,5,11
13127,58thStGreenway22ndAve,07/29/2015 11:00:00 PM,48,-122,0,0,0
13128,58thStGreenway22ndAve,07/30/2015 12:00:00 AM,48,-122,1,2,3
13129,58thStGreenway22ndAve,07/30/2015 01:00:00 AM,48,-122,1,0,1
13130,58thStGreenway22ndAve,07/30/2015 02:00:00 AM,48,-122,1,0,1
13131,58thStGreenway22ndAve,07/30/2015 03:00:00 AM,48,-122,0,0,0
13132,58thStGreenway22ndAve,07/30/2015 04:00:00 AM,48,-122,1,1,2
13133,58thStGreenway22ndAve,07/30/2015 05:00:00 AM,48,-122,1,0,1
13134,58thStGreenway22ndAve,07/30/2015 06:00:00 AM,48,-122,0,2,2
13135,58thStGreenway22ndAve,07/30/2015 07:00:00 AM,48,-122,2,5,7
13136,58thStGreenway22ndAve,07/30/2015 08:00:00 AM,48,-122,10,2,12
13137,58thStGreenway22ndAve,07/30/2015 09:00:00 AM,48,-122,8,5,13
13138,58thStGreenway22ndAve,07/30/2015 10:00:00 AM,48,-122,6,3,9
13139,58thStGreenway22ndAve,07/30/2015 11:00:00 AM,48,-122,10,2,12
13140,58thStGreenway22ndAve,07/30/2015 12:00:00 PM,48,-122,4,2,6
13141,58thStGreenway22ndAve,07/30/2015 01:00:00 PM,48,-122,3,11,14
13142,58thStGreenway22ndAve,07/30/2015 02:00:00 PM,48,-122,5,3,8
13143,58thStGreenway22ndAve,07/30/2015 03:00:00 PM,48,-122,7,2,9
13144,58thStGreenway22ndAve,07/30/2015 04:00:00 PM,48,-122,7,2,9
13145,58thStGreenway22ndAve,07/30/2015 05:00:00 PM,48,-122,10,11,21
13146,58thStGreenway22ndAve,07/30/2015 06:00:00 PM,48,-122,7,10,17
13147,58thStGreenway22ndAve,07/30/2015 07:00:00 PM,48,-122,12,10,22
13148,58thStGreenway22ndAve,07/30/2015 08:00:00 PM,48,-122,8,6,14
13149,58thStGreenway22ndAve,07/30/2015 09:00:00 PM,48,-122,4,0,4
13150,58thStGreenway22ndAve,07/30/2015 10:00:00 PM,48,-122,4,1,5
13151,58thStGreenway22ndAve,07/30/2015 11:00:00 PM,48,-122,5,0,5
13152,58thStGreenway22ndAve,07/31/2015 12:00:00 AM,48,-122,0,0,0
13153,58thStGreenway22ndAve,07/31/2015 01:00:00 AM,48,-122,0,0,0
13154,58thStGreenway22ndAve,07/31/2015 02:00:00 AM,48,-122,0,0,0
13155,58thStGreenway22ndAve,07/31/2015 03:00:00 AM,48,-122,0,0,0
13156,58thStGreenway22ndAve,07/31/2015 04:00:00 AM,48,-122,0,1,1
13157,58thStGreenway22ndAve,07/31/2015 05:00:00 AM,48,-122,1,1,2
13158,58thStGreenway22ndAve,07/31/2015 06:00:00 AM,48,-122,1,0,1
13159,58thStGreenway22ndAve,07/31/2015 07:00:00 AM,48,-122,4,3,7
13160,58thStGreenway22ndAve,07/31/2015 08:00:00 AM,48,-122,6,2,8
13161,58thStGreenway22ndAve,07/31/2015 09:00:00 AM,48,-122,3,8,11
13162,58thStGreenway22ndAve,07/31/2015 10:00:00 AM,48,-122,2,10,12
13163,58thStGreenway22ndAve,07/31/2015 11:00:00 AM,48,-122,2,5,7
13164,58thStGreenway22ndAve,07/31/2015 12:00:00 PM,48,-122,3,5,8
13165,58thStGreenway22ndAve,07/31/2015 01:00:00 PM,48,-122,6,2,8
13166,58thStGreenway22ndAve,07/31/2015 02:00:00 PM,48,-122,3,11,14
13167,58thStGreenway22ndAve,07/31/2015 03:00:00 PM,48,-122,5,3,8
13168,58thStGreenway22ndAve,07/31/2015 04:00:00 PM,48,-122,12,9,21
13169,58thStGreenway22ndAve,07/31/2015 05:00:00 PM,48,-122,11,12,23
13170,58thStGreenway22ndAve,07/31/2015 06:00:00 PM,48,-122,8,7,15
13171,58thStGreenway22ndAve,07/31/2015 07:00:00 PM,48,-122,7,7,14
13172,58thStGreenway22ndAve,07/31/2015 08:00:00 PM,48,-122,4,6,10
13173,58thStGreenway22ndAve,07/31/2015 09:00:00 PM,48,-122,6,4,10
13174,58thStGreenway22ndAve,07/31/2015 10:00:00 PM,48,-122,1,2,3
13175,58thStGreenway22ndAve,07/31/2015 11:00:00 PM,48,-122,2,0,2
13176,58thStGreenway22ndAve,08/01/2015 12:00:00 AM,48,-122,1,2,3
13177,58thStGreenway22ndAve,08/01/2015 01:00:00 AM,48,-122,2,0,2
13178,58thStGreenway22ndAve,08/01/2015 02:00:00 AM,48,-122,0,0,0
13179,58thStGreenway22ndAve,08/01/2015 03:00:00 AM,48,-122,0,1,1
13180,58thStGreenway22ndAve,08/01/2015 04:00:00 AM,48,-122,0,1,1
13181,58thStGreenway22ndAve,08/01/2015 05:00:00 AM,48,-122,0,0,0
13182,58thStGreenway22ndAve,08/01/2015 06:00:00 AM,48,-122,3,1,4
13183,58thStGreenway22ndAve,08/01/2015 07:00:00 AM,48,-122,2,1,3
13184,58thStGreenway22ndAve,08/01/2015 08:00:00 AM,48,-122,2,2,4
13185,58thStGreenway22ndAve,08/01/2015 09:00:00 AM,48,-122,5,3,8
13186,58thStGreenway22ndAve,08/01/2015 10:00:00 AM,48,-122,5,6,11
13187,58thStGreenway22ndAve,08/01/2015 11:00:00 AM,48,-122,2,5,7
13188,58thStGreenway22ndAve,08/01/2015 12:00:00 PM,48,-122,2,6,8
13189,58thStGreenway22ndAve,08/01/2015 01:00:00 PM,48,-122,4,8,12
13190,58thStGreenway22ndAve,08/01/2015 02:00:00 PM,48,-122,7,10,17
13191,58thStGreenway22ndAve,08/01/2015 03:00:00 PM,48,-122,9,5,14
13192,58thStGreenway22ndAve,08/01/2015 04:00:00 PM,48,-122,5,6,11
13193,58thStGreenway22ndAve,08/01/2015 05:00:00 PM,48,-122,0,5,5
13194,58thStGreenway22ndAve,08/01/2015 06:00:00 PM,48,-122,10,4,14
13195,58thStGreenway22ndAve,08/01/2015 07:00:00 PM,48,-122,2,5,7
13196,58thStGreenway22ndAve,08/01/2015 08:00:00 PM,48,-122,5,3,8
13197,58thStGreenway22ndAve,08/01/2015 09:00:00 PM,48,-122,2,3,5
13198,58thStGreenway22ndAve,08/01/2015 10:00:00 PM,48,-122,2,0,2
13199,58thStGreenway22ndAve,08/01/2015 11:00:00 PM,48,-122,3,1,4
13200,58thStGreenway22ndAve,08/02/2015 12:00:00 AM,48,-122,2,1,3
13201,58thStGreenway22ndAve,08/02/2015 01:00:00 AM,48,-122,0,1,1
13202,58thStGreenway22ndAve,08/02/2015 02:00:00 AM,48,-122,1,0,1
13203,58thStGreenway22ndAve,08/02/2015 03:00:00 AM,48,-122,1,0,1
13204,58thStGreenway22ndAve,08/02/2015 04:00:00 AM,48,-122,0,0,0
13205,58thStGreenway22ndAve,08/02/2015 05:00:00 AM,48,-122,0,0,0
13206,58thStGreenway22ndAve,08/02/2015 06:00:00 AM,48,-122,0,1,1
13207,58thStGreenway22ndAve,08/02/2015 07:00:00 AM,48,-122,0,0,0
13208,58thStGreenway22ndAve,08/02/2015 08:00:00 AM,48,-122,3,0,3
13209,58thStGreenway22ndAve,08/02/2015 09:00:00 AM,48,-122,5,13,18
13210,58thStGreenway22ndAve,08/02/2015 10:00:00 AM,48,-122,3,5,8
13211,58thStGreenway22ndAve,08/02/2015 11:00:00 AM,48,-122,4,24,28
13212,58thStGreenway22ndAve,08/02/2015 12:00:00 PM,48,-122,6,4,10
13213,58thStGreenway22ndAve,08/02/2015 01:00:00 PM,48,-122,7,4,11
13214,58thStGreenway22ndAve,08/02/2015 02:00:00 PM,48,-122,22,8,30
13215,58thStGreenway22ndAve,08/02/2015 03:00:00 PM,48,-122,17,9,26
13216,58thStGreenway22ndAve,08/02/2015 04:00:00 PM,48,-122,6,4,10
13217,58thStGreenway22ndAve,08/02/2015 05:00:00 PM,48,-122,1,8,9
13218,58thStGreenway22ndAve,08/02/2015 06:00:00 PM,48,-122,9,6,15
13219,58thStGreenway22ndAve,08/02/2015 07:00:00 PM,48,-122,7,0,7
13220,58thStGreenway22ndAve,08/02/2015 08:00:00 PM,48,-122,4,0,4
13221,58thStGreenway22ndAve,08/02/2015 09:00:00 PM,48,-122,0,1,1
13222,58thStGreenway22ndAve,08/02/2015 10:00:00 PM,48,-122,0,0,0
13223,58thStGreenway22ndAve,08/02/2015 11:00:00 PM,48,-122,3,0,3
13224,58thStGreenway22ndAve,08/03/2015 12:00:00 AM,48,-122,1,0,1
13225,58thStGreenway22ndAve,08/03/2015 01:00:00 AM,48,-122,0,0,0
13226,58thStGreenway22ndAve,08/03/2015 02:00:00 AM,48,-122,0,0,0
13227,58thStGreenway22ndAve,08/03/2015 03:00:00 AM,48,-122,0,1,1
13228,58thStGreenway22ndAve,08/03/2015 04:00:00 AM,48,-122,0,0,0
13229,58thStGreenway22ndAve,08/03/2015 05:00:00 AM,48,-122,1,1,2
13230,58thStGreenway22ndAve,08/03/2015 06:00:00 AM,48,-122,1,2,3
13231,58thStGreenway22ndAve,08/03/2015 07:00:00 AM,48,-122,4,2,6
13232,58thStGreenway22ndAve,08/03/2015 08:00:00 AM,48,-122,5,7,12
13233,58thStGreenway22ndAve,08/03/2015 09:00:00 AM,48,-122,7,6,13
13234,58thStGreenway22ndAve,08/03/2015 10:00:00 AM,48,-122,0,5,5
13235,58thStGreenway22ndAve,08/03/2015 11:00:00 AM,48,-122,5,6,11
13236,58thStGreenway22ndAve,08/03/2015 12:00:00 PM,48,-122,8,4,12
13237,58thStGreenway22ndAve,08/03/2015 01:00:00 PM,48,-122,4,6,10
13238,58thStGreenway22ndAve,08/03/2015 02:00:00 PM,48,-122,5,4,9
13239,58thStGreenway22ndAve,08/03/2015 03:00:00 PM,48,-122,4,6,10
13240,58thStGreenway22ndAve,08/03/2015 04:00:00 PM,48,-122,6,3,9
13241,58thStGreenway22ndAve,08/03/2015 05:00:00 PM,48,-122,14,5,19
13242,58thStGreenway22ndAve,08/03/2015 06:00:00 PM,48,-122,13,12,25
13243,58thStGreenway22ndAve,08/03/2015 07:00:00 PM,48,-122,9,10,19
13244,58thStGreenway22ndAve,08/03/2015 08:00:00 PM,48,-122,1,3,4
13245,58thStGreenway22ndAve,08/03/2015 09:00:00 PM,48,-122,9,2,11
13246,58thStGreenway22ndAve,08/03/2015 10:00:00 PM,48,-122,3,0,3
13247,58thStGreenway22ndAve,08/03/2015 11:00:00 PM,48,-122,3,1,4
13248,58thStGreenway22ndAve,08/04/2015 12:00:00 AM,48,-122,0,0,0
13249,58thStGreenway22ndAve,08/04/2015 01:00:00 AM,48,-122,0,0,0
13250,58thStGreenway22ndAve,08/04/2015 02:00:00 AM,48,-122,0,0,0
13251,58thStGreenway22ndAve,08/04/2015 03:00:00 AM,48,-122,0,1,1
13252,58thStGreenway22ndAve,08/04/2015 04:00:00 AM,48,-122,0,0,0
13253,58thStGreenway22ndAve,08/04/2015 05:00:00 AM,48,-122,1,0,1
13254,58thStGreenway22ndAve,08/04/2015 06:00:00 AM,48,-122,3,2,5
13255,58thStGreenway22ndAve,08/04/2015 07:00:00 AM,48,-122,2,6,8
13256,58thStGreenway22ndAve,08/04/2015 08:00:00 AM,48,-122,10,10,20
13257,58thStGreenway22ndAve,08/04/2015 09:00:00 AM,48,-122,2,3,5
13258,58thStGreenway22ndAve,08/04/2015 10:00:00 AM,48,-122,5,5,10
13259,58thStGreenway22ndAve,08/04/2015 11:00:00 AM,48,-122,5,5,10
13260,58thStGreenway22ndAve,08/04/2015 12:00:00 PM,48,-122,8,4,12
13261,58thStGreenway22ndAve,08/04/2015 01:00:00 PM,48,-122,8,9,17
13262,58thStGreenway22ndAve,08/04/2015 02:00:00 PM,48,-122,2,3,5
13263,58thStGreenway22ndAve,08/04/2015 03:00:00 PM,48,-122,5,5,10
13264,58thStGreenway22ndAve,08/04/2015 04:00:00 PM,48,-122,12,10,22
13265,58thStGreenway22ndAve,08/04/2015 05:00:00 PM,48,-122,11,15,26
13266,58thStGreenway22ndAve,08/04/2015 06:00:00 PM,48,-122,18,9,27
13267,58thStGreenway22ndAve,08/04/2015 07:00:00 PM,48,-122,10,11,21
13268,58thStGreenway22ndAve,08/04/2015 08:00:00 PM,48,-122,4,3,7
13269,58thStGreenway22ndAve,08/04/2015 09:00:00 PM,48,-122,8,1,9
13270,58thStGreenway22ndAve,08/04/2015 10:00:00 PM,48,-122,2,1,3
13271,58thStGreenway22ndAve,08/04/2015 11:00:00 PM,48,-122,0,0,0
13272,58thStGreenway22ndAve,08/05/2015 12:00:00 AM,48,-122,0,1,1
13273,58thStGreenway22ndAve,08/05/2015 01:00:00 AM,48,-122,2,0,2
13274,58thStGreenway22ndAve,08/05/2015 02:00:00 AM,48,-122,0,0,0
13275,58thStGreenway22ndAve,08/05/2015 03:00:00 AM,48,-122,0,0,0
13276,58thStGreenway22ndAve,08/05/2015 04:00:00 AM,48,-122,0,1,1
13277,58thStGreenway22ndAve,08/05/2015 05:00:00 AM,48,-122,2,0,2
13278,58thStGreenway22ndAve,08/05/2015 06:00:00 AM,48,-122,3,2,5
13279,58thStGreenway22ndAve,08/05/2015 07:00:00 AM,48,-122,5,6,11
13280,58thStGreenway22ndAve,08/05/2015 08:00:00 AM,48,-122,6,2,8
13281,58thStGreenway22ndAve,08/05/2015 09:00:00 AM,48,-122,1,8,9
13282,58thStGreenway22ndAve,08/05/2015 10:00:00 AM,48,-122,0,3,3
13283,58thStGreenway22ndAve,08/05/2015 11:00:00 AM,48,-122,12,6,18
13284,58thStGreenway22ndAve,08/05/2015 12:00:00 PM,48,-122,6,0,6
13285,58thStGreenway22ndAve,08/05/2015 01:00:00 PM,48,-122,4,3,7
13286,58thStGreenway22ndAve,08/05/2015 02:00:00 PM,48,-122,6,4,10
13287,58thStGreenway22ndAve,08/05/2015 03:00:00 PM,48,-122,4,2,6
13288,58thStGreenway22ndAve,08/05/2015 04:00:00 PM,48,-122,6,6,12
13289,58thStGreenway22ndAve,08/05/2015 05:00:00 PM,48,-122,6,5,11
13290,58thStGreenway22ndAve,08/05/2015 06:00:00 PM,48,-122,15,12,27
13291,58thStGreenway22ndAve,08/05/2015 07:00:00 PM,48,-122,3,7,10
13292,58thStGreenway22ndAve,08/05/2015 08:00:00 PM,48,-122,6,2,8
13293,58thStGreenway22ndAve,08/05/2015 09:00:00 PM,48,-122,2,2,4
13294,58thStGreenway22ndAve,08/05/2015 10:00:00 PM,48,-122,0,1,1
13295,58thStGreenway22ndAve,08/05/2015 11:00:00 PM,48,-122,0,1,1
13296,58thStGreenway22ndAve,08/06/2015 12:00:00 AM,48,-122,0,2,2
13297,58thStGreenway22ndAve,08/06/2015 01:00:00 AM,48,-122,0,0,0
13298,58thStGreenway22ndAve,08/06/2015 02:00:00 AM,48,-122,0,0,0
13299,58thStGreenway22ndAve,08/06/2015 03:00:00 AM,48,-122,1,1,2
13300,58thStGreenway22ndAve,08/06/2015 04:00:00 AM,48,-122,1,1,2
13301,58thStGreenway22ndAve,08/06/2015 05:00:00 AM,48,-122,1,1,2
13302,58thStGreenway22ndAve,08/06/2015 06:00:00 AM,48,-122,2,3,5
13303,58thStGreenway22ndAve,08/06/2015 07:00:00 AM,48,-122,0,2,2
13304,58thStGreenway22ndAve,08/06/2015 08:00:00 AM,48,-122,3,3,6
13305,58thStGreenway22ndAve,08/06/2015 09:00:00 AM,48,-122,5,4,9
13306,58thStGreenway22ndAve,08/06/2015 10:00:00 AM,48,-122,1,15,16
13307,58thStGreenway22ndAve,08/06/2015 11:00:00 AM,48,-122,3,3,6
13308,58thStGreenway22ndAve,08/06/2015 12:00:00 PM,48,-122,10,1,11
13309,58thStGreenway22ndAve,08/06/2015 01:00:00 PM,48,-122,3,5,8
13310,58thStGreenway22ndAve,08/06/2015 02:00:00 PM,48,-122,6,2,8
13311,58thStGreenway22ndAve,08/06/2015 03:00:00 PM,48,-122,6,5,11
13312,58thStGreenway22ndAve,08/06/2015 04:00:00 PM,48,-122,10,9,19
13313,58thStGreenway22ndAve,08/06/2015 05:00:00 PM,48,-122,8,3,11
13314,58thStGreenway22ndAve,08/06/2015 06:00:00 PM,48,-122,7,7,14
13315,58thStGreenway22ndAve,08/06/2015 07:00:00 PM,48,-122,15,8,23
13316,58thStGreenway22ndAve,08/06/2015 08:00:00 PM,48,-122,10,6,16
13317,58thStGreenway22ndAve,08/06/2015 09:00:00 PM,48,-122,5,3,8
13318,58thStGreenway22ndAve,08/06/2015 10:00:00 PM,48,-122,2,0,2
13319,58thStGreenway22ndAve,08/06/2015 11:00:00 PM,48,-122,2,0,2
13320,58thStGreenway22ndAve,08/07/2015 12:00:00 AM,48,-122,0,0,0
13321,58thStGreenway22ndAve,08/07/2015 01:00:00 AM,48,-122,1,0,1
13322,58thStGreenway22ndAve,08/07/2015 02:00:00 AM,48,-122,0,0,0
13323,58thStGreenway22ndAve,08/07/2015 03:00:00 AM,48,-122,0,0,0
13324,58thStGreenway22ndAve,08/07/2015 04:00:00 AM,48,-122,0,1,1
13325,58thStGreenway22ndAve,08/07/2015 05:00:00 AM,48,-122,0,0,0
13326,58thStGreenway22ndAve,08/07/2015 06:00:00 AM,48,-122,3,2,5
13327,58thStGreenway22ndAve,08/07/2015 07:00:00 AM,48,-122,5,8,13
13328,58thStGreenway22ndAve,08/07/2015 08:00:00 AM,48,-122,7,3,10
13329,58thStGreenway22ndAve,08/07/2015 09:00:00 AM,48,-122,7,5,12
13330,58thStGreenway22ndAve,08/07/2015 10:00:00 AM,48,-122,3,6,9
13331,58thStGreenway22ndAve,08/07/2015 11:00:00 AM,48,-122,1,3,4
13332,58thStGreenway22ndAve,08/07/2015 12:00:00 PM,48,-122,13,2,15
13333,58thStGreenway22ndAve,08/07/2015 01:00:00 PM,48,-122,4,8,12
13334,58thStGreenway22ndAve,08/07/2015 02:00:00 PM,48,-122,2,11,13
13335,58thStGreenway22ndAve,08/07/2015 03:00:00 PM,48,-122,7,10,17
13336,58thStGreenway22ndAve,08/07/2015 04:00:00 PM,48,-122,9,3,12
13337,58thStGreenway22ndAve,08/07/2015 05:00:00 PM,48,-122,10,7,17
13338,58thStGreenway22ndAve,08/07/2015 06:00:00 PM,48,-122,14,6,20
13339,58thStGreenway22ndAve,08/07/2015 07:00:00 PM,48,-122,9,4,13
13340,58thStGreenway22ndAve,08/07/2015 08:00:00 PM,48,-122,3,1,4
13341,58thStGreenway22ndAve,08/07/2015 09:00:00 PM,48,-122,6,3,9
13342,58thStGreenway22ndAve,08/07/2015 10:00:00 PM,48,-122,1,2,3
13343,58thStGreenway22ndAve,08/07/2015 11:00:00 PM,48,-122,1,0,1
13344,58thStGreenway22ndAve,08/08/2015 12:00:00 AM,48,-122,3,1,4
13345,58thStGreenway22ndAve,08/08/2015 01:00:00 AM,48,-122,2,0,2
13346,58thStGreenway22ndAve,08/08/2015 02:00:00 AM,48,-122,0,0,0
13347,58thStGreenway22ndAve,08/08/2015 03:00:00 AM,48,-122,0,0,0
13348,58thStGreenway22ndAve,08/08/2015 04:00:00 AM,48,-122,0,0,0
13349,58thStGreenway22ndAve,08/08/2015 05:00:00 AM,48,-122,0,0,0
13350,58thStGreenway22ndAve,08/08/2015 06:00:00 AM,48,-122,1,0,1
13351,58thStGreenway22ndAve,08/08/2015 07:00:00 AM,48,-122,3,1,4
13352,58thStGreenway22ndAve,08/08/2015 08:00:00 AM,48,-122,4,12,16
13353,58thStGreenway22ndAve,08/08/2015 09:00:00 AM,48,-122,4,3,7
13354,58thStGreenway22ndAve,08/08/2015 10:00:00 AM,48,-122,0,6,6
13355,58thStGreenway22ndAve,08/08/2015 11:00:00 AM,48,-122,3,9,12
13356,58thStGreenway22ndAve,08/08/2015 12:00:00 PM,48,-122,15,8,23
13357,58thStGreenway22ndAve,08/08/2015 01:00:00 PM,48,-122,5,6,11
13358,58thStGreenway22ndAve,08/08/2015 02:00:00 PM,48,-122,8,6,14
13359,58thStGreenway22ndAve,08/08/2015 03:00:00 PM,48,-122,11,2,13
13360,58thStGreenway22ndAve,08/08/2015 04:00:00 PM,48,-122,3,6,9
13361,58thStGreenway22ndAve,08/08/2015 05:00:00 PM,48,-122,5,10,15
13362,58thStGreenway22ndAve,08/08/2015 06:00:00 PM,48,-122,8,1,9
13363,58thStGreenway22ndAve,08/08/2015 07:00:00 PM,48,-122,0,0,0
13364,58thStGreenway22ndAve,08/08/2015 08:00:00 PM,48,-122,4,3,7
13365,58thStGreenway22ndAve,08/08/2015 09:00:00 PM,48,-122,2,0,2
13366,58thStGreenway22ndAve,08/08/2015 10:00:00 PM,48,-122,6,0,6
13367,58thStGreenway22ndAve,08/08/2015 11:00:00 PM,48,-122,0,0,0
13368,58thStGreenway22ndAve,08/09/2015 12:00:00 AM,48,-122,2,0,2
13369,58thStGreenway22ndAve,08/09/2015 01:00:00 AM,48,-122,1,0,1
13370,58thStGreenway22ndAve,08/09/2015 02:00:00 AM,48,-122,0,0,0
13371,58thStGreenway22ndAve,08/09/2015 03:00:00 AM,48,-122,0,0,0
13372,58thStGreenway22ndAve,08/09/2015 04:00:00 AM,48,-122,0,0,0
13373,58thStGreenway22ndAve,08/09/2015 05:00:00 AM,48,-122,0,0,0
13374,58thStGreenway22ndAve,08/09/2015 06:00:00 AM,48,-122,0,0,0
13375,58thStGreenway22ndAve,08/09/2015 07:00:00 AM,48,-122,0,2,2
13376,58thStGreenway22ndAve,08/09/2015 08:00:00 AM,48,-122,1,3,4
13377,58thStGreenway22ndAve,08/09/2015 09:00:00 AM,48,-122,5,2,7
13378,58thStGreenway22ndAve,08/09/2015 10:00:00 AM,48,-122,3,6,9
13379,58thStGreenway22ndAve,08/09/2015 11:00:00 AM,48,-122,7,15,22
13380,58thStGreenway22ndAve,08/09/2015 12:00:00 PM,48,-122,10,7,17
13381,58thStGreenway22ndAve,08/09/2015 01:00:00 PM,48,-122,24,25,49
13382,58thStGreenway22ndAve,08/09/2015 02:00:00 PM,48,-122,18,13,31
13383,58thStGreenway22ndAve,08/09/2015 03:00:00 PM,48,-122,3,7,10
13384,58thStGreenway22ndAve,08/09/2015 04:00:00 PM,48,-122,6,19,25
13385,58thStGreenway22ndAve,08/09/2015 05:00:00 PM,48,-122,4,5,9
13386,58thStGreenway22ndAve,08/09/2015 06:00:00 PM,48,-122,0,0,0
13387,58thStGreenway22ndAve,08/09/2015 07:00:00 PM,48,-122,0,0,0
13388,58thStGreenway22ndAve,08/09/2015 08:00:00 PM,48,-122,8,2,10
13389,58thStGreenway22ndAve,08/09/2015 09:00:00 PM,48,-122,3,0,3
13390,58thStGreenway22ndAve,08/09/2015 10:00:00 PM,48,-122,4,0,4
13391,58thStGreenway22ndAve,08/09/2015 11:00:00 PM,48,-122,0,2,2
13392,58thStGreenway22ndAve,08/10/2015 12:00:00 AM,48,-122,1,1,2
13393,58thStGreenway22ndAve,08/10/2015 01:00:00 AM,48,-122,0,0,0
13394,58thStGreenway22ndAve,08/10/2015 02:00:00 AM,48,-122,0,0,0
13395,58thStGreenway22ndAve,08/10/2015 03:00:00 AM,48,-122,0,0,0
13396,58thStGreenway22ndAve,08/10/2015 04:00:00 AM,48,-122,1,1,2
13397,58thStGreenway22ndAve,08/10/2015 05:00:00 AM,48,-122,0,0,0
13398,58thStGreenway22ndAve,08/10/2015 06:00:00 AM,48,-122,1,3,4
13399,58thStGreenway22ndAve,08/10/2015 07:00:00 AM,48,-122,1,3,4
13400,58thStGreenway22ndAve,08/10/2015 08:00:00 AM,48,-122,4,6,10
13401,58thStGreenway22ndAve,08/10/2015 09:00:00 AM,48,-122,2,6,8
13402,58thStGreenway22ndAve,08/10/2015 10:00:00 AM,48,-122,5,2,7
13403,58thStGreenway22ndAve,08/10/2015 11:00:00 AM,48,-122,2,4,6
13404,58thStGreenway22ndAve,08/10/2015 12:00:00 PM,48,-122,3,9,12
13405,58thStGreenway22ndAve,08/10/2015 01:00:00 PM,48,-122,5,3,8
13406,58thStGreenway22ndAve,08/10/2015 02:00:00 PM,48,-122,5,7,12
13407,58thStGreenway22ndAve,08/10/2015 03:00:00 PM,48,-122,2,7,9
13408,58thStGreenway22ndAve,08/10/2015 04:00:00 PM,48,-122,12,7,19
13409,58thStGreenway22ndAve,08/10/2015 05:00:00 PM,48,-122,5,10,15
13410,58thStGreenway22ndAve,08/10/2015 06:00:00 PM,48,-122,16,7,23
13411,58thStGreenway22ndAve,08/10/2015 07:00:00 PM,48,-122,13,11,24
13412,58thStGreenway22ndAve,08/10/2015 08:00:00 PM,48,-122,9,4,13
13413,58thStGreenway22ndAve,08/10/2015 09:00:00 PM,48,-122,3,3,6
13414,58thStGreenway22ndAve,08/10/2015 10:00:00 PM,48,-122,0,3,3
13415,58thStGreenway22ndAve,08/10/2015 11:00:00 PM,48,-122,0,0,0
13416,58thStGreenway22ndAve,08/11/2015 12:00:00 AM,48,-122,0,0,0
13417,58thStGreenway22ndAve,08/11/2015 01:00:00 AM,48,-122,0,0,0
13418,58thStGreenway22ndAve,08/11/2015 02:00:00 AM,48,-122,2,0,2
13419,58thStGreenway22ndAve,08/11/2015 03:00:00 AM,48,-122,0,0,0
13420,58thStGreenway22ndAve,08/11/2015 04:00:00 AM,48,-122,1,1,2
13421,58thStGreenway22ndAve,08/11/2015 05:00:00 AM,48,-122,0,1,1
13422,58thStGreenway22ndAve,08/11/2015 06:00:00 AM,48,-122,0,4,4
13423,58thStGreenway22ndAve,08/11/2015 07:00:00 AM,48,-122,5,11,16
13424,58thStGreenway22ndAve,08/11/2015 08:00:00 AM,48,-122,5,4,9
13425,58thStGreenway22ndAve,08/11/2015 09:00:00 AM,48,-122,4,4,8
13426,58thStGreenway22ndAve,08/11/2015 10:00:00 AM,48,-122,2,4,6
13427,58thStGreenway22ndAve,08/11/2015 11:00:00 AM,48,-122,3,4,7
13428,58thStGreenway22ndAve,08/11/2015 12:00:00 PM,48,-122,11,4,15
13429,58thStGreenway22ndAve,08/11/2015 01:00:00 PM,48,-122,3,7,10
13430,58thStGreenway22ndAve,08/11/2015 02:00:00 PM,48,-122,1,5,6
13431,58thStGreenway22ndAve,08/11/2015 03:00:00 PM,48,-122,2,6,8
13432,58thStGreenway22ndAve,08/11/2015 04:00:00 PM,48,-122,12,4,16
13433,58thStGreenway22ndAve,08/11/2015 05:00:00 PM,48,-122,9,10,19
13434,58thStGreenway22ndAve,08/11/2015 06:00:00 PM,48,-122,11,9,20
13435,58thStGreenway22ndAve,08/11/2015 07:00:00 PM,48,-122,5,6,11
13436,58thStGreenway22ndAve,08/11/2015 08:00:00 PM,48,-122,5,2,7
13437,58thStGreenway22ndAve,08/11/2015 09:00:00 PM,48,-122,0,4,4
13438,58thStGreenway22ndAve,08/11/2015 10:00:00 PM,48,-122,4,1,5
13439,58thStGreenway22ndAve,08/11/2015 11:00:00 PM,48,-122,4,1,5
13440,58thStGreenway22ndAve,08/12/2015 12:00:00 AM,48,-122,0,2,2
13441,58thStGreenway22ndAve,08/12/2015 01:00:00 AM,48,-122,1,0,1
13442,58thStGreenway22ndAve,08/12/2015 02:00:00 AM,48,-122,0,0,0
13443,58thStGreenway22ndAve,08/12/2015 03:00:00 AM,48,-122,0,0,0
13444,58thStGreenway22ndAve,08/12/2015 04:00:00 AM,48,-122,0,1,1
13445,58thStGreenway22ndAve,08/12/2015 05:00:00 AM,48,-122,0,0,0
13446,58thStGreenway22ndAve,08/12/2015 06:00:00 AM,48,-122,4,1,5
13447,58thStGreenway22ndAve,08/12/2015 07:00:00 AM,48,-122,3,5,8
13448,58thStGreenway22ndAve,08/12/2015 08:00:00 AM,48,-122,5,11,16
13449,58thStGreenway22ndAve,08/12/2015 09:00:00 AM,48,-122,2,4,6
13450,58thStGreenway22ndAve,08/12/2015 10:00:00 AM,48,-122,1,12,13
13451,58thStGreenway22ndAve,08/12/2015 11:00:00 AM,48,-122,2,4,6
13452,58thStGreenway22ndAve,08/12/2015 12:00:00 PM,48,-122,2,4,6
13453,58thStGreenway22ndAve,08/12/2015 01:00:00 PM,48,-122,6,6,12
13454,58thStGreenway22ndAve,08/12/2015 02:00:00 PM,48,-122,0,2,2
13455,58thStGreenway22ndAve,08/12/2015 03:00:00 PM,48,-122,3,1,4
13456,58thStGreenway22ndAve,08/12/2015 04:00:00 PM,48,-122,4,6,10
13457,58thStGreenway22ndAve,08/12/2015 05:00:00 PM,48,-122,11,11,22
13458,58thStGreenway22ndAve,08/12/2015 06:00:00 PM,48,-122,11,15,26
13459,58thStGreenway22ndAve,08/12/2015 07:00:00 PM,48,-122,4,5,9
13460,58thStGreenway22ndAve,08/12/2015 08:00:00 PM,48,-122,19,5,24
13461,58thStGreenway22ndAve,08/12/2015 09:00:00 PM,48,-122,5,2,7
13462,58thStGreenway22ndAve,08/12/2015 10:00:00 PM,48,-122,6,3,9
13463,58thStGreenway22ndAve,08/12/2015 11:00:00 PM,48,-122,0,1,1
13464,58thStGreenway22ndAve,08/13/2015 12:00:00 AM,48,-122,0,0,0
13465,58thStGreenway22ndAve,08/13/2015 01:00:00 AM,48,-122,0,0,0
13466,58thStGreenway22ndAve,08/13/2015 02:00:00 AM,48,-122,1,0,1
13467,58thStGreenway22ndAve,08/13/2015 03:00:00 AM,48,-122,0,0,0
13468,58thStGreenway22ndAve,08/13/2015 04:00:00 AM,48,-122,0,1,1
13469,58thStGreenway22ndAve,08/13/2015 05:00:00 AM,48,-122,2,1,3
13470,58thStGreenway22ndAve,08/13/2015 06:00:00 AM,48,-122,2,4,6
13471,58thStGreenway22ndAve,08/13/2015 07:00:00 AM,48,-122,3,2,5
13472,58thStGreenway22ndAve,08/13/2015 08:00:00 AM,48,-122,7,7,14
13473,58thStGreenway22ndAve,08/13/2015 09:00:00 AM,48,-122,4,5,9
13474,58thStGreenway22ndAve,08/13/2015 10:00:00 AM,48,-122,9,4,13
13475,58thStGreenway22ndAve,08/13/2015 11:00:00 AM,48,-122,3,4,7
13476,58thStGreenway22ndAve,08/13/2015 12:00:00 PM,48,-122,6,11,17
13477,58thStGreenway22ndAve,08/13/2015 01:00:00 PM,48,-122,4,5,9
13478,58thStGreenway22ndAve,08/13/2015 02:00:00 PM,48,-122,8,6,14
13479,58thStGreenway22ndAve,08/13/2015 03:00:00 PM,48,-122,5,3,8
13480,58thStGreenway22ndAve,08/13/2015 04:00:00 PM,48,-122,8,6,14
13481,58thStGreenway22ndAve,08/13/2015 05:00:00 PM,48,-122,13,5,18
13482,58thStGreenway22ndAve,08/13/2015 06:00:00 PM,48,-122,6,4,10
13483,58thStGreenway22ndAve,08/13/2015 07:00:00 PM,48,-122,10,13,23
13484,58thStGreenway22ndAve,08/13/2015 08:00:00 PM,48,-122,12,7,19
13485,58thStGreenway22ndAve,08/13/2015 09:00:00 PM,48,-122,3,1,4
13486,58thStGreenway22ndAve,08/13/2015 10:00:00 PM,48,-122,2,1,3
13487,58thStGreenway22ndAve,08/13/2015 11:00:00 PM,48,-122,1,1,2
13488,58thStGreenway22ndAve,08/14/2015 12:00:00 AM,48,-122,0,0,0
13489,58thStGreenway22ndAve,08/14/2015 01:00:00 AM,48,-122,0,0,0
13490,58thStGreenway22ndAve,08/14/2015 02:00:00 AM,48,-122,2,0,2
13491,58thStGreenway22ndAve,08/14/2015 03:00:00 AM,48,-122,0,0,0
13492,58thStGreenway22ndAve,08/14/2015 04:00:00 AM,48,-122,1,1,2
13493,58thStGreenway22ndAve,08/14/2015 05:00:00 AM,48,-122,0,1,1
13494,58thStGreenway22ndAve,08/14/2015 06:00:00 AM,48,-122,1,2,3
13495,58thStGreenway22ndAve,08/14/2015 07:00:00 AM,48,-122,1,3,4
13496,58thStGreenway22ndAve,08/14/2015 08:00:00 AM,48,-122,3,3,6
13497,58thStGreenway22ndAve,08/14/2015 09:00:00 AM,48,-122,3,5,8
13498,58thStGreenway22ndAve,08/14/2015 10:00:00 AM,48,-122,3,7,10
13499,58thStGreenway22ndAve,08/14/2015 11:00:00 AM,48,-122,3,1,4
13500,58thStGreenway22ndAve,08/14/2015 12:00:00 PM,48,-122,4,0,4
13501,58thStGreenway22ndAve,08/14/2015 01:00:00 PM,48,-122,1,4,5
13502,58thStGreenway22ndAve,08/14/2015 02:00:00 PM,48,-122,1,1,2
13503,58thStGreenway22ndAve,08/14/2015 03:00:00 PM,48,-122,1,0,1
13504,58thStGreenway22ndAve,08/14/2015 04:00:00 PM,48,-122,1,1,2
13505,58thStGreenway22ndAve,08/14/2015 05:00:00 PM,48,-122,4,4,8
13506,58thStGreenway22ndAve,08/14/2015 06:00:00 PM,48,-122,5,2,7
13507,58thStGreenway22ndAve,08/14/2015 07:00:00 PM,48,-122,2,0,2
13508,58thStGreenway22ndAve,08/14/2015 08:00:00 PM,48,-122,0,0,0
13509,58thStGreenway22ndAve,08/14/2015 09:00:00 PM,48,-122,0,2,2
13510,58thStGreenway22ndAve,08/14/2015 10:00:00 PM,48,-122,0,0,0
13511,58thStGreenway22ndAve,08/14/2015 11:00:00 PM,48,-122,1,0,1
13512,58thStGreenway22ndAve,08/15/2015 12:00:00 AM,48,-122,2,0,2
13513,58thStGreenway22ndAve,08/15/2015 01:00:00 AM,48,-122,0,0,0
13514,58thStGreenway22ndAve,08/15/2015 02:00:00 AM,48,-122,0,0,0
13515,58thStGreenway22ndAve,08/15/2015 03:00:00 AM,48,-122,0,0,0
13516,58thStGreenway22ndAve,08/15/2015 04:00:00 AM,48,-122,0,0,0
13517,58thStGreenway22ndAve,08/15/2015 05:00:00 AM,48,-122,1,0,1
13518,58thStGreenway22ndAve,08/15/2015 06:00:00 AM,48,-122,1,0,1
13519,58thStGreenway22ndAve,08/15/2015 07:00:00 AM,48,-122,1,1,2
13520,58thStGreenway22ndAve,08/15/2015 08:00:00 AM,48,-122,1,4,5
13521,58thStGreenway22ndAve,08/15/2015 09:00:00 AM,48,-122,5,0,5
13522,58thStGreenway22ndAve,08/15/2015 10:00:00 AM,48,-122,5,5,10
13523,58thStGreenway22ndAve,08/15/2015 11:00:00 AM,48,-122,9,7,16
13524,58thStGreenway22ndAve,08/15/2015 12:00:00 PM,48,-122,15,9,24
13525,58thStGreenway22ndAve,08/15/2015 01:00:00 PM,48,-122,3,14,17
13526,58thStGreenway22ndAve,08/15/2015 02:00:00 PM,48,-122,10,10,20
13527,58thStGreenway22ndAve,08/15/2015 03:00:00 PM,48,-122,8,8,16
13528,58thStGreenway22ndAve,08/15/2015 04:00:00 PM,48,-122,4,3,7
13529,58thStGreenway22ndAve,08/15/2015 05:00:00 PM,48,-122,7,6,13
13530,58thStGreenway22ndAve,08/15/2015 06:00:00 PM,48,-122,5,6,11
13531,58thStGreenway22ndAve,08/15/2015 07:00:00 PM,48,-122,3,3,6
13532,58thStGreenway22ndAve,08/15/2015 08:00:00 PM,48,-122,2,3,5
13533,58thStGreenway22ndAve,08/15/2015 09:00:00 PM,48,-122,4,0,4
13534,58thStGreenway22ndAve,08/15/2015 10:00:00 PM,48,-122,2,3,5
13535,58thStGreenway22ndAve,08/15/2015 11:00:00 PM,48,-122,0,0,0
13536,58thStGreenway22ndAve,08/16/2015 12:00:00 AM,48,-122,0,1,1
13537,58thStGreenway22ndAve,08/16/2015 01:00:00 AM,48,-122,1,1,2
13538,58thStGreenway22ndAve,08/16/2015 02:00:00 AM,48,-122,0,0,0
13539,58thStGreenway22ndAve,08/16/2015 03:00:00 AM,48,-122,0,0,0
13540,58thStGreenway22ndAve,08/16/2015 04:00:00 AM,48,-122,0,0,0
13541,58thStGreenway22ndAve,08/16/2015 05:00:00 AM,48,-122,1,1,2
13542,58thStGreenway22ndAve,08/16/2015 06:00:00 AM,48,-122,1,0,1
13543,58thStGreenway22ndAve,08/16/2015 07:00:00 AM,48,-122,2,1,3
13544,58thStGreenway22ndAve,08/16/2015 08:00:00 AM,48,-122,1,3,4
13545,58thStGreenway22ndAve,08/16/2015 09:00:00 AM,48,-122,6,5,11
13546,58thStGreenway22ndAve,08/16/2015 10:00:00 AM,48,-122,8,6,14
13547,58thStGreenway22ndAve,08/16/2015 11:00:00 AM,48,-122,5,11,16
13548,58thStGreenway22ndAve,08/16/2015 12:00:00 PM,48,-122,4,11,15
13549,58thStGreenway22ndAve,08/16/2015 01:00:00 PM,48,-122,8,13,21
13550,58thStGreenway22ndAve,08/16/2015 02:00:00 PM,48,-122,13,11,24
13551,58thStGreenway22ndAve,08/16/2015 03:00:00 PM,48,-122,11,7,18
13552,58thStGreenway22ndAve,08/16/2015 04:00:00 PM,48,-122,10,7,17
13553,58thStGreenway22ndAve,08/16/2015 05:00:00 PM,48,-122,12,8,20
13554,58thStGreenway22ndAve,08/16/2015 06:00:00 PM,48,-122,4,13,17
13555,58thStGreenway22ndAve,08/16/2015 07:00:00 PM,48,-122,3,4,7
13556,58thStGreenway22ndAve,08/16/2015 08:00:00 PM,48,-122,2,1,3
13557,58thStGreenway22ndAve,08/16/2015 09:00:00 PM,48,-122,6,4,10
13558,58thStGreenway22ndAve,08/16/2015 10:00:00 PM,48,-122,2,1,3
13559,58thStGreenway22ndAve,08/16/2015 11:00:00 PM,48,-122,0,0,0
13560,58thStGreenway22ndAve,08/17/2015 12:00:00 AM,48,-122,1,0,1
13561,58thStGreenway22ndAve,08/17/2015 01:00:00 AM,48,-122,2,0,2
13562,58thStGreenway22ndAve,08/17/2015 02:00:00 AM,48,-122,0,1,1
13563,58thStGreenway22ndAve,08/17/2015 03:00:00 AM,48,-122,0,0,0
13564,58thStGreenway22ndAve,08/17/2015 04:00:00 AM,48,-122,0,1,1
13565,58thStGreenway22ndAve,08/17/2015 05:00:00 AM,48,-122,1,0,1
13566,58thStGreenway22ndAve,08/17/2015 06:00:00 AM,48,-122,0,2,2
13567,58thStGreenway22ndAve,08/17/2015 07:00:00 AM,48,-122,6,4,10
13568,58thStGreenway22ndAve,08/17/2015 08:00:00 AM,48,-122,3,5,8
13569,58thStGreenway22ndAve,08/17/2015 09:00:00 AM,48,-122,2,9,11
13570,58thStGreenway22ndAve,08/17/2015 10:00:00 AM,48,-122,0,3,3
13571,58thStGreenway22ndAve,08/17/2015 11:00:00 AM,48,-122,2,4,6
13572,58thStGreenway22ndAve,08/17/2015 12:00:00 PM,48,-122,15,3,18
13573,58thStGreenway22ndAve,08/17/2015 01:00:00 PM,48,-122,7,6,13
13574,58thStGreenway22ndAve,08/17/2015 02:00:00 PM,48,-122,2,5,7
13575,58thStGreenway22ndAve,08/17/2015 03:00:00 PM,48,-122,7,2,9
13576,58thStGreenway22ndAve,08/17/2015 04:00:00 PM,48,-122,12,18,30
13577,58thStGreenway22ndAve,08/17/2015 05:00:00 PM,48,-122,11,6,17
13578,58thStGreenway22ndAve,08/17/2015 06:00:00 PM,48,-122,9,6,15
13579,58thStGreenway22ndAve,08/17/2015 07:00:00 PM,48,-122,10,7,17
13580,58thStGreenway22ndAve,08/17/2015 08:00:00 PM,48,-122,3,6,9
13581,58thStGreenway22ndAve,08/17/2015 09:00:00 PM,48,-122,3,0,3
13582,58thStGreenway22ndAve,08/17/2015 10:00:00 PM,48,-122,0,3,3
13583,58thStGreenway22ndAve,08/17/2015 11:00:00 PM,48,-122,0,0,0
13584,58thStGreenway22ndAve,08/18/2015 12:00:00 AM,48,-122,1,1,2
13585,58thStGreenway22ndAve,08/18/2015 01:00:00 AM,48,-122,1,2,3
13586,58thStGreenway22ndAve,08/18/2015 02:00:00 AM,48,-122,2,2,4
13587,58thStGreenway22ndAve,08/18/2015 03:00:00 AM,48,-122,0,1,1
13588,58thStGreenway22ndAve,08/18/2015 04:00:00 AM,48,-122,0,1,1
13589,58thStGreenway22ndAve,08/18/2015 05:00:00 AM,48,-122,0,0,0
13590,58thStGreenway22ndAve,08/18/2015 06:00:00 AM,48,-122,2,4,6
13591,58thStGreenway22ndAve,08/18/2015 07:00:00 AM,48,-122,9,5,14
13592,58thStGreenway22ndAve,08/18/2015 08:00:00 AM,48,-122,4,7,11
13593,58thStGreenway22ndAve,08/18/2015 09:00:00 AM,48,-122,2,7,9
13594,58thStGreenway22ndAve,08/18/2015 10:00:00 AM,48,-122,5,4,9
13595,58thStGreenway22ndAve,08/18/2015 11:00:00 AM,48,-122,3,7,10
13596,58thStGreenway22ndAve,08/18/2015 12:00:00 PM,48,-122,6,7,13
13597,58thStGreenway22ndAve,08/18/2015 01:00:00 PM,48,-122,5,4,9
13598,58thStGreenway22ndAve,08/18/2015 02:00:00 PM,48,-122,4,7,11
13599,58thStGreenway22ndAve,08/18/2015 03:00:00 PM,48,-122,7,5,12
13600,58thStGreenway22ndAve,08/18/2015 04:00:00 PM,48,-122,12,5,17
13601,58thStGreenway22ndAve,08/18/2015 05:00:00 PM,48,-122,11,12,23
13602,58thStGreenway22ndAve,08/18/2015 06:00:00 PM,48,-122,16,11,27
13603,58thStGreenway22ndAve,08/18/2015 07:00:00 PM,48,-122,9,12,21
13604,58thStGreenway22ndAve,08/18/2015 08:00:00 PM,48,-122,5,6,11
13605,58thStGreenway22ndAve,08/18/2015 09:00:00 PM,48,-122,8,1,9
13606,58thStGreenway22ndAve,08/18/2015 10:00:00 PM,48,-122,2,0,2
13607,58thStGreenway22ndAve,08/18/2015 11:00:00 PM,48,-122,2,1,3
13608,58thStGreenway22ndAve,08/19/2015 12:00:00 AM,48,-122,1,0,1
13609,58thStGreenway22ndAve,08/19/2015 01:00:00 AM,48,-122,0,0,0
13610,58thStGreenway22ndAve,08/19/2015 02:00:00 AM,48,-122,0,0,0
13611,58thStGreenway22ndAve,08/19/2015 03:00:00 AM,48,-122,0,0,0
13612,58thStGreenway22ndAve,08/19/2015 04:00:00 AM,48,-122,0,1,1
13613,58thStGreenway22ndAve,08/19/2015 05:00:00 AM,48,-122,0,1,1
13614,58thStGreenway22ndAve,08/19/2015 06:00:00 AM,48,-122,1,2,3
13615,58thStGreenway22ndAve,08/19/2015 07:00:00 AM,48,-122,10,3,13
13616,58thStGreenway22ndAve,08/19/2015 08:00:00 AM,48,-122,7,9,16
13617,58thStGreenway22ndAve,08/19/2015 09:00:00 AM,48,-122,7,6,13
13618,58thStGreenway22ndAve,08/19/2015 10:00:00 AM,48,-122,2,6,8
13619,58thStGreenway22ndAve,08/19/2015 11:00:00 AM,48,-122,7,4,11
13620,58thStGreenway22ndAve,08/19/2015 12:00:00 PM,48,-122,7,7,14
13621,58thStGreenway22ndAve,08/19/2015 01:00:00 PM,48,-122,6,4,10
13622,58thStGreenway22ndAve,08/19/2015 02:00:00 PM,48,-122,11,7,18
13623,58thStGreenway22ndAve,08/19/2015 03:00:00 PM,48,-122,7,4,11
13624,58thStGreenway22ndAve,08/19/2015 04:00:00 PM,48,-122,5,9,14
13625,58thStGreenway22ndAve,08/19/2015 05:00:00 PM,48,-122,14,5,19
13626,58thStGreenway22ndAve,08/19/2015 06:00:00 PM,48,-122,19,7,26
13627,58thStGreenway22ndAve,08/19/2015 07:00:00 PM,48,-122,13,10,23
13628,58thStGreenway22ndAve,08/19/2015 08:00:00 PM,48,-122,5,3,8
13629,58thStGreenway22ndAve,08/19/2015 09:00:00 PM,48,-122,0,4,4
13630,58thStGreenway22ndAve,08/19/2015 10:00:00 PM,48,-122,3,1,4
13631,58thStGreenway22ndAve,08/19/2015 11:00:00 PM,48,-122,1,0,1
13632,58thStGreenway22ndAve,08/20/2015 12:00:00 AM,48,-122,3,1,4
13633,58thStGreenway22ndAve,08/20/2015 01:00:00 AM,48,-122,1,0,1
13634,58thStGreenway22ndAve,08/20/2015 02:00:00 AM,48,-122,0,0,0
13635,58thStGreenway22ndAve,08/20/2015 03:00:00 AM,48,-122,0,0,0
13636,58thStGreenway22ndAve,08/20/2015 04:00:00 AM,48,-122,0,1,1
13637,58thStGreenway22ndAve,08/20/2015 05:00:00 AM,48,-122,0,1,1
13638,58thStGreenway22ndAve,08/20/2015 06:00:00 AM,48,-122,0,1,1
13639,58thStGreenway22ndAve,08/20/2015 07:00:00 AM,48,-122,5,1,6
13640,58thStGreenway22ndAve,08/20/2015 08:00:00 AM,48,-122,6,4,10
13641,58thStGreenway22ndAve,08/20/2015 09:00:00 AM,48,-122,4,4,8
13642,58thStGreenway22ndAve,08/20/2015 10:00:00 AM,48,-122,7,11,18
13643,58thStGreenway22ndAve,08/20/2015 11:00:00 AM,48,-122,6,1,7
13644,58thStGreenway22ndAve,08/20/2015 12:00:00 PM,48,-122,4,3,7
13645,58thStGreenway22ndAve,08/20/2015 01:00:00 PM,48,-122,5,4,9
13646,58thStGreenway22ndAve,08/20/2015 02:00:00 PM,48,-122,0,4,4
13647,58thStGreenway22ndAve,08/20/2015 03:00:00 PM,48,-122,2,7,9
13648,58thStGreenway22ndAve,08/20/2015 04:00:00 PM,48,-122,4,4,8
13649,58thStGreenway22ndAve,08/20/2015 05:00:00 PM,48,-122,9,4,13
13650,58thStGreenway22ndAve,08/20/2015 06:00:00 PM,48,-122,20,9,29
13651,58thStGreenway22ndAve,08/20/2015 07:00:00 PM,48,-122,5,10,15
13652,58thStGreenway22ndAve,08/20/2015 08:00:00 PM,48,-122,2,4,6
13653,58thStGreenway22ndAve,08/20/2015 09:00:00 PM,48,-122,5,0,5
13654,58thStGreenway22ndAve,08/20/2015 10:00:00 PM,48,-122,5,0,5
13655,58thStGreenway22ndAve,08/20/2015 11:00:00 PM,48,-122,5,1,6
13656,58thStGreenway22ndAve,08/21/2015 12:00:00 AM,48,-122,1,1,2
13657,58thStGreenway22ndAve,08/21/2015 01:00:00 AM,48,-122,0,0,0
13658,58thStGreenway22ndAve,08/21/2015 02:00:00 AM,48,-122,0,0,0
13659,58thStGreenway22ndAve,08/21/2015 03:00:00 AM,48,-122,0,1,1
13660,58thStGreenway22ndAve,08/21/2015 04:00:00 AM,48,-122,0,1,1
13661,58thStGreenway22ndAve,08/21/2015 05:00:00 AM,48,-122,0,0,0
13662,58thStGreenway22ndAve,08/21/2015 06:00:00 AM,48,-122,4,1,5
13663,58thStGreenway22ndAve,08/21/2015 07:00:00 AM,48,-122,1,1,2
13664,58thStGreenway22ndAve,08/21/2015 08:00:00 AM,48,-122,8,4,12
13665,58thStGreenway22ndAve,08/21/2015 09:00:00 AM,48,-122,1,6,7
13666,58thStGreenway22ndAve,08/21/2015 10:00:00 AM,48,-122,7,4,11
13667,58thStGreenway22ndAve,08/21/2015 11:00:00 AM,48,-122,5,9,14
13668,58thStGreenway22ndAve,08/21/2015 12:00:00 PM,48,-122,15,2,17
13669,58thStGreenway22ndAve,08/21/2015 01:00:00 PM,48,-122,5,7,12
13670,58thStGreenway22ndAve,08/21/2015 02:00:00 PM,48,-122,2,3,5
13671,58thStGreenway22ndAve,08/21/2015 03:00:00 PM,48,-122,7,8,15
13672,58thStGreenway22ndAve,08/21/2015 04:00:00 PM,48,-122,6,5,11
13673,58thStGreenway22ndAve,08/21/2015 05:00:00 PM,48,-122,15,6,21
13674,58thStGreenway22ndAve,08/21/2015 06:00:00 PM,48,-122,3,11,14
13675,58thStGreenway22ndAve,08/21/2015 07:00:00 PM,48,-122,7,5,12
13676,58thStGreenway22ndAve,08/21/2015 08:00:00 PM,48,-122,5,7,12
13677,58thStGreenway22ndAve,08/21/2015 09:00:00 PM,48,-122,2,0,2
13678,58thStGreenway22ndAve,08/21/2015 10:00:00 PM,48,-122,3,3,6
13679,58thStGreenway22ndAve,08/21/2015 11:00:00 PM,48,-122,3,0,3
13680,58thStGreenway22ndAve,08/22/2015 12:00:00 AM,48,-122,0,0,0
13681,58thStGreenway22ndAve,08/22/2015 01:00:00 AM,48,-122,0,0,0
13682,58thStGreenway22ndAve,08/22/2015 02:00:00 AM,48,-122,2,0,2
13683,58thStGreenway22ndAve,08/22/2015 03:00:00 AM,48,-122,0,0,0
13684,58thStGreenway22ndAve,08/22/2015 04:00:00 AM,48,-122,0,0,0
13685,58thStGreenway22ndAve,08/22/2015 05:00:00 AM,48,-122,0,0,0
13686,58thStGreenway22ndAve,08/22/2015 06:00:00 AM,48,-122,0,0,0
13687,58thStGreenway22ndAve,08/22/2015 07:00:00 AM,48,-122,2,1,3
13688,58thStGreenway22ndAve,08/22/2015 08:00:00 AM,48,-122,1,1,2
13689,58thStGreenway22ndAve,08/22/2015 09:00:00 AM,48,-122,5,5,10
13690,58thStGreenway22ndAve,08/22/2015 10:00:00 AM,48,-122,3,12,15
13691,58thStGreenway22ndAve,08/22/2015 11:00:00 AM,48,-122,9,7,16
13692,58thStGreenway22ndAve,08/22/2015 12:00:00 PM,48,-122,9,13,22
13693,58thStGreenway22ndAve,08/22/2015 01:00:00 PM,48,-122,7,14,21
13694,58thStGreenway22ndAve,08/22/2015 02:00:00 PM,48,-122,4,5,9
13695,58thStGreenway22ndAve,08/22/2015 03:00:00 PM,48,-122,4,6,10
13696,58thStGreenway22ndAve,08/22/2015 04:00:00 PM,48,-122,9,8,17
13697,58thStGreenway22ndAve,08/22/2015 05:00:00 PM,48,-122,8,3,11
13698,58thStGreenway22ndAve,08/22/2015 06:00:00 PM,48,-122,5,6,11
13699,58thStGreenway22ndAve,08/22/2015 07:00:00 PM,48,-122,9,5,14
13700,58thStGreenway22ndAve,08/22/2015 08:00:00 PM,48,-122,7,5,12
13701,58thStGreenway22ndAve,08/22/2015 09:00:00 PM,48,-122,4,1,5
13702,58thStGreenway22ndAve,08/22/2015 10:00:00 PM,48,-122,3,1,4
13703,58thStGreenway22ndAve,08/22/2015 11:00:00 PM,48,-122,2,0,2
13704,58thStGreenway22ndAve,08/23/2015 12:00:00 AM,48,-122,1,0,1
13705,58thStGreenway22ndAve,08/23/2015 01:00:00 AM,48,-122,0,0,0
13706,58thStGreenway22ndAve,08/23/2015 02:00:00 AM,48,-122,0,1,1
13707,58thStGreenway22ndAve,08/23/2015 03:00:00 AM,48,-122,0,0,0
13708,58thStGreenway22ndAve,08/23/2015 04:00:00 AM,48,-122,0,0,0
13709,58thStGreenway22ndAve,08/23/2015 05:00:00 AM,48,-122,0,0,0
13710,58thStGreenway22ndAve,08/23/2015 06:00:00 AM,48,-122,0,1,1
13711,58thStGreenway22ndAve,08/23/2015 07:00:00 AM,48,-122,1,0,1
13712,58thStGreenway22ndAve,08/23/2015 08:00:00 AM,48,-122,2,5,7
13713,58thStGreenway22ndAve,08/23/2015 09:00:00 AM,48,-122,4,6,10
13714,58thStGreenway22ndAve,08/23/2015 10:00:00 AM,48,-122,4,8,12
13715,58thStGreenway22ndAve,08/23/2015 11:00:00 AM,48,-122,7,14,21
13716,58thStGreenway22ndAve,08/23/2015 12:00:00 PM,48,-122,12,18,30
13717,58thStGreenway22ndAve,08/23/2015 01:00:00 PM,48,-122,7,9,16
13718,58thStGreenway22ndAve,08/23/2015 02:00:00 PM,48,-122,3,11,14
13719,58thStGreenway22ndAve,08/23/2015 03:00:00 PM,48,-122,11,8,19
13720,58thStGreenway22ndAve,08/23/2015 04:00:00 PM,48,-122,6,7,13
13721,58thStGreenway22ndAve,08/23/2015 05:00:00 PM,48,-122,10,2,12
13722,58thStGreenway22ndAve,08/23/2015 06:00:00 PM,48,-122,2,2,4
13723,58thStGreenway22ndAve,08/23/2015 07:00:00 PM,48,-122,5,4,9
13724,58thStGreenway22ndAve,08/23/2015 08:00:00 PM,48,-122,1,1,2
13725,58thStGreenway22ndAve,08/23/2015 09:00:00 PM,48,-122,2,1,3
13726,58thStGreenway22ndAve,08/23/2015 10:00:00 PM,48,-122,1,0,1
13727,58thStGreenway22ndAve,08/23/2015 11:00:00 PM,48,-122,0,2,2
13728,58thStGreenway22ndAve,08/24/2015 12:00:00 AM,48,-122,0,1,1
13729,58thStGreenway22ndAve,08/24/2015 01:00:00 AM,48,-122,0,0,0
13730,58thStGreenway22ndAve,08/24/2015 02:00:00 AM,48,-122,0,0,0
13731,58thStGreenway22ndAve,08/24/2015 03:00:00 AM,48,-122,1,0,1
13732,58thStGreenway22ndAve,08/24/2015 04:00:00 AM,48,-122,1,2,3
13733,58thStGreenway22ndAve,08/24/2015 05:00:00 AM,48,-122,0,1,1
13734,58thStGreenway22ndAve,08/24/2015 06:00:00 AM,48,-122,1,5,6
13735,58thStGreenway22ndAve,08/24/2015 07:00:00 AM,48,-122,6,1,7
13736,58thStGreenway22ndAve,08/24/2015 08:00:00 AM,48,-122,7,3,10
13737,58thStGreenway22ndAve,08/24/2015 09:00:00 AM,48,-122,3,7,10
13738,58thStGreenway22ndAve,08/24/2015 10:00:00 AM,48,-122,4,5,9
13739,58thStGreenway22ndAve,08/24/2015 11:00:00 AM,48,-122,6,3,9
13740,58thStGreenway22ndAve,08/24/2015 12:00:00 PM,48,-122,6,2,8
13741,58thStGreenway22ndAve,08/24/2015 01:00:00 PM,48,-122,5,1,6
13742,58thStGreenway22ndAve,08/24/2015 02:00:00 PM,48,-122,8,5,13
13743,58thStGreenway22ndAve,08/24/2015 03:00:00 PM,48,-122,1,5,6
13744,58thStGreenway22ndAve,08/24/2015 04:00:00 PM,48,-122,9,14,23
13745,58thStGreenway22ndAve,08/24/2015 05:00:00 PM,48,-122,9,11,20
13746,58thStGreenway22ndAve,08/24/2015 06:00:00 PM,48,-122,9,10,19
13747,58thStGreenway22ndAve,08/24/2015 07:00:00 PM,48,-122,2,3,5
13748,58thStGreenway22ndAve,08/24/2015 08:00:00 PM,48,-122,0,0,0
13749,58thStGreenway22ndAve,08/24/2015 09:00:00 PM,48,-122,0,0,0
13750,58thStGreenway22ndAve,08/24/2015 10:00:00 PM,48,-122,0,0,0
13751,58thStGreenway22ndAve,08/24/2015 11:00:00 PM,48,-122,0,0,0
13752,58thStGreenway22ndAve,08/25/2015 12:00:00 AM,48,-122,0,0,0
13753,58thStGreenway22ndAve,08/25/2015 01:00:00 AM,48,-122,0,0,0
13754,58thStGreenway22ndAve,08/25/2015 02:00:00 AM,48,-122,0,0,0
13755,58thStGreenway22ndAve,08/25/2015 03:00:00 AM,48,-122,0,0,0
13756,58thStGreenway22ndAve,08/25/2015 04:00:00 AM,48,-122,0,0,0
13757,58thStGreenway22ndAve,08/25/2015 05:00:00 AM,48,-122,0,0,0
13758,58thStGreenway22ndAve,08/25/2015 06:00:00 AM,48,-122,0,0,0
13759,58thStGreenway22ndAve,08/25/2015 07:00:00 AM,48,-122,4,2,6
13760,58thStGreenway22ndAve,08/25/2015 08:00:00 AM,48,-122,5,10,15
13761,58thStGreenway22ndAve,08/25/2015 09:00:00 AM,48,-122,5,4,9
13762,58thStGreenway22ndAve,08/25/2015 10:00:00 AM,48,-122,1,3,4
13763,58thStGreenway22ndAve,08/25/2015 11:00:00 AM,48,-122,5,4,9
13764,58thStGreenway22ndAve,08/25/2015 12:00:00 PM,48,-122,7,2,9
13765,58thStGreenway22ndAve,08/25/2015 01:00:00 PM,48,-122,10,5,15
13766,58thStGreenway22ndAve,08/25/2015 02:00:00 PM,48,-122,4,4,8
13767,58thStGreenway22ndAve,08/25/2015 03:00:00 PM,48,-122,5,1,6
13768,58thStGreenway22ndAve,08/25/2015 04:00:00 PM,48,-122,8,6,14
13769,58thStGreenway22ndAve,08/25/2015 05:00:00 PM,48,-122,14,8,22
13770,58thStGreenway22ndAve,08/25/2015 06:00:00 PM,48,-122,11,8,19
13771,58thStGreenway22ndAve,08/25/2015 07:00:00 PM,48,-122,5,4,9
13772,58thStGreenway22ndAve,08/25/2015 08:00:00 PM,48,-122,4,3,7
13773,58thStGreenway22ndAve,08/25/2015 09:00:00 PM,48,-122,2,2,4
13774,58thStGreenway22ndAve,08/25/2015 10:00:00 PM,48,-122,3,3,6
13775,58thStGreenway22ndAve,08/25/2015 11:00:00 PM,48,-122,0,2,2
13776,58thStGreenway22ndAve,08/26/2015 12:00:00 AM,48,-122,0,0,0
13777,58thStGreenway22ndAve,08/26/2015 01:00:00 AM,48,-122,0,1,1
13778,58thStGreenway22ndAve,08/26/2015 02:00:00 AM,48,-122,2,0,2
13779,58thStGreenway22ndAve,08/26/2015 03:00:00 AM,48,-122,0,0,0
13780,58thStGreenway22ndAve,08/26/2015 04:00:00 AM,48,-122,0,1,1
13781,58thStGreenway22ndAve,08/26/2015 05:00:00 AM,48,-122,0,1,1
13782,58thStGreenway22ndAve,08/26/2015 06:00:00 AM,48,-122,1,3,4
13783,58thStGreenway22ndAve,08/26/2015 07:00:00 AM,48,-122,3,7,10
13784,58thStGreenway22ndAve,08/26/2015 08:00:00 AM,48,-122,8,6,14
13785,58thStGreenway22ndAve,08/26/2015 09:00:00 AM,48,-122,3,5,8
13786,58thStGreenway22ndAve,08/26/2015 10:00:00 AM,48,-122,2,4,6
13787,58thStGreenway22ndAve,08/26/2015 11:00:00 AM,48,-122,0,4,4
13788,58thStGreenway22ndAve,08/26/2015 12:00:00 PM,48,-122,4,5,9
13789,58thStGreenway22ndAve,08/26/2015 01:00:00 PM,48,-122,0,4,4
13790,58thStGreenway22ndAve,08/26/2015 02:00:00 PM,48,-122,5,6,11
13791,58thStGreenway22ndAve,08/26/2015 03:00:00 PM,48,-122,1,2,3
13792,58thStGreenway22ndAve,08/26/2015 04:00:00 PM,48,-122,8,9,17
13793,58thStGreenway22ndAve,08/26/2015 05:00:00 PM,48,-122,9,13,22
13794,58thStGreenway22ndAve,08/26/2015 06:00:00 PM,48,-122,12,11,23
13795,58thStGreenway22ndAve,08/26/2015 07:00:00 PM,48,-122,13,10,23
13796,58thStGreenway22ndAve,08/26/2015 08:00:00 PM,48,-122,5,3,8
13797,58thStGreenway22ndAve,08/26/2015 09:00:00 PM,48,-122,4,1,5
13798,58thStGreenway22ndAve,08/26/2015 10:00:00 PM,48,-122,4,2,6
13799,58thStGreenway22ndAve,08/26/2015 11:00:00 PM,48,-122,1,1,2
13800,58thStGreenway22ndAve,08/27/2015 12:00:00 AM,48,-122,0,2,2
13801,58thStGreenway22ndAve,08/27/2015 01:00:00 AM,48,-122,0,0,0
13802,58thStGreenway22ndAve,08/27/2015 02:00:00 AM,48,-122,0,0,0
13803,58thStGreenway22ndAve,08/27/2015 03:00:00 AM,48,-122,0,0,0
13804,58thStGreenway22ndAve,08/27/2015 04:00:00 AM,48,-122,1,1,2
13805,58thStGreenway22ndAve,08/27/2015 05:00:00 AM,48,-122,0,1,1
13806,58thStGreenway22ndAve,08/27/2015 06:00:00 AM,48,-122,1,1,2
13807,58thStGreenway22ndAve,08/27/2015 07:00:00 AM,48,-122,5,4,9
13808,58thStGreenway22ndAve,08/27/2015 08:00:00 AM,48,-122,10,9,19
13809,58thStGreenway22ndAve,08/27/2015 09:00:00 AM,48,-122,3,6,9
13810,58thStGreenway22ndAve,08/27/2015 10:00:00 AM,48,-122,2,3,5
13811,58thStGreenway22ndAve,08/27/2015 11:00:00 AM,48,-122,2,4,6
13812,58thStGreenway22ndAve,08/27/2015 12:00:00 PM,48,-122,7,4,11
13813,58thStGreenway22ndAve,08/27/2015 01:00:00 PM,48,-122,4,5,9
13814,58thStGreenway22ndAve,08/27/2015 02:00:00 PM,48,-122,3,3,6
13815,58thStGreenway22ndAve,08/27/2015 03:00:00 PM,48,-122,4,4,8
13816,58thStGreenway22ndAve,08/27/2015 04:00:00 PM,48,-122,4,7,11
13817,58thStGreenway22ndAve,08/27/2015 05:00:00 PM,48,-122,12,11,23
13818,58thStGreenway22ndAve,08/27/2015 06:00:00 PM,48,-122,7,3,10
13819,58thStGreenway22ndAve,08/27/2015 07:00:00 PM,48,-122,8,10,18
13820,58thStGreenway22ndAve,08/27/2015 08:00:00 PM,48,-122,1,5,6
13821,58thStGreenway22ndAve,08/27/2015 09:00:00 PM,48,-122,3,0,3
13822,58thStGreenway22ndAve,08/27/2015 10:00:00 PM,48,-122,2,1,3
13823,58thStGreenway22ndAve,08/27/2015 11:00:00 PM,48,-122,3,0,3
13824,58thStGreenway22ndAve,08/28/2015 12:00:00 AM,48,-122,0,0,0
13825,58thStGreenway22ndAve,08/28/2015 01:00:00 AM,48,-122,0,0,0
13826,58thStGreenway22ndAve,08/28/2015 02:00:00 AM,48,-122,0,0,0
13827,58thStGreenway22ndAve,08/28/2015 03:00:00 AM,48,-122,0,0,0
13828,58thStGreenway22ndAve,08/28/2015 04:00:00 AM,48,-122,1,1,2
13829,58thStGreenway22ndAve,08/28/2015 05:00:00 AM,48,-122,0,0,0
13830,58thStGreenway22ndAve,08/28/2015 06:00:00 AM,48,-122,1,1,2
13831,58thStGreenway22ndAve,08/28/2015 07:00:00 AM,48,-122,4,2,6
13832,58thStGreenway22ndAve,08/28/2015 08:00:00 AM,48,-122,2,4,6
13833,58thStGreenway22ndAve,08/28/2015 09:00:00 AM,48,-122,0,6,6
13834,58thStGreenway22ndAve,08/28/2015 10:00:00 AM,48,-122,2,7,9
13835,58thStGreenway22ndAve,08/28/2015 11:00:00 AM,48,-122,1,7,8
13836,58thStGreenway22ndAve,08/28/2015 12:00:00 PM,48,-122,10,7,17
13837,58thStGreenway22ndAve,08/28/2015 01:00:00 PM,48,-122,7,2,9
13838,58thStGreenway22ndAve,08/28/2015 02:00:00 PM,48,-122,6,2,8
13839,58thStGreenway22ndAve,08/28/2015 03:00:00 PM,48,-122,5,5,10
13840,58thStGreenway22ndAve,08/28/2015 04:00:00 PM,48,-122,17,3,20
13841,58thStGreenway22ndAve,08/28/2015 05:00:00 PM,48,-122,9,9,18
13842,58thStGreenway22ndAve,08/28/2015 06:00:00 PM,48,-122,8,0,8
13843,58thStGreenway22ndAve,08/28/2015 07:00:00 PM,48,-122,7,1,8
13844,58thStGreenway22ndAve,08/28/2015 08:00:00 PM,48,-122,3,4,7
13845,58thStGreenway22ndAve,08/28/2015 09:00:00 PM,48,-122,2,4,6
13846,58thStGreenway22ndAve,08/28/2015 10:00:00 PM,48,-122,1,0,1
13847,58thStGreenway22ndAve,08/28/2015 11:00:00 PM,48,-122,0,0,0
13848,58thStGreenway22ndAve,08/29/2015 12:00:00 AM,48,-122,1,0,1
13849,58thStGreenway22ndAve,08/29/2015 01:00:00 AM,48,-122,5,0,5
13850,58thStGreenway22ndAve,08/29/2015 02:00:00 AM,48,-122,0,0,0
13851,58thStGreenway22ndAve,08/29/2015 03:00:00 AM,48,-122,0,0,0
13852,58thStGreenway22ndAve,08/29/2015 04:00:00 AM,48,-122,0,0,0
13853,58thStGreenway22ndAve,08/29/2015 05:00:00 AM,48,-122,1,0,1
13854,58thStGreenway22ndAve,08/29/2015 06:00:00 AM,48,-122,1,0,1
13855,58thStGreenway22ndAve,08/29/2015 07:00:00 AM,48,-122,0,0,0
13856,58thStGreenway22ndAve,08/29/2015 08:00:00 AM,48,-122,1,2,3
13857,58thStGreenway22ndAve,08/29/2015 09:00:00 AM,48,-122,4,3,7
13858,58thStGreenway22ndAve,08/29/2015 10:00:00 AM,48,-122,0,4,4
13859,58thStGreenway22ndAve,08/29/2015 11:00:00 AM,48,-122,1,1,2
13860,58thStGreenway22ndAve,08/29/2015 12:00:00 PM,48,-122,2,2,4
13861,58thStGreenway22ndAve,08/29/2015 01:00:00 PM,48,-122,2,3,5
13862,58thStGreenway22ndAve,08/29/2015 02:00:00 PM,48,-122,3,3,6
13863,58thStGreenway22ndAve,08/29/2015 03:00:00 PM,48,-122,4,1,5
13864,58thStGreenway22ndAve,08/29/2015 04:00:00 PM,48,-122,2,2,4
13865,58thStGreenway22ndAve,08/29/2015 05:00:00 PM,48,-122,2,1,3
13866,58thStGreenway22ndAve,08/29/2015 06:00:00 PM,48,-122,1,1,2
13867,58thStGreenway22ndAve,08/29/2015 07:00:00 PM,48,-122,0,3,3
13868,58thStGreenway22ndAve,08/29/2015 08:00:00 PM,48,-122,1,1,2
13869,58thStGreenway22ndAve,08/29/2015 09:00:00 PM,48,-122,3,2,5
13870,58thStGreenway22ndAve,08/29/2015 10:00:00 PM,48,-122,3,0,3
13871,58thStGreenway22ndAve,08/29/2015 11:00:00 PM,48,-122,1,0,1
13872,58thStGreenway22ndAve,08/30/2015 12:00:00 AM,48,-122,0,0,0
13873,58thStGreenway22ndAve,08/30/2015 01:00:00 AM,48,-122,0,0,0
13874,58thStGreenway22ndAve,08/30/2015 02:00:00 AM,48,-122,0,0,0
13875,58thStGreenway22ndAve,08/30/2015 03:00:00 AM,48,-122,0,0,0
13876,58thStGreenway22ndAve,08/30/2015 04:00:00 AM,48,-122,0,0,0
13877,58thStGreenway22ndAve,08/30/2015 05:00:00 AM,48,-122,0,0,0
13878,58thStGreenway22ndAve,08/30/2015 06:00:00 AM,48,-122,0,0,0
13879,58thStGreenway22ndAve,08/30/2015 07:00:00 AM,48,-122,0,1,1
13880,58thStGreenway22ndAve,08/30/2015 08:00:00 AM,48,-122,1,2,3
13881,58thStGreenway22ndAve,08/30/2015 09:00:00 AM,48,-122,1,5,6
13882,58thStGreenway22ndAve,08/30/2015 10:00:00 AM,48,-122,5,3,8
13883,58thStGreenway22ndAve,08/30/2015 11:00:00 AM,48,-122,11,5,16
13884,58thStGreenway22ndAve,08/30/2015 12:00:00 PM,48,-122,3,11,14
13885,58thStGreenway22ndAve,08/30/2015 01:00:00 PM,48,-122,5,10,15
13886,58thStGreenway22ndAve,08/30/2015 02:00:00 PM,48,-122,7,2,9
13887,58thStGreenway22ndAve,08/30/2015 03:00:00 PM,48,-122,10,2,12
13888,58thStGreenway22ndAve,08/30/2015 04:00:00 PM,48,-122,5,6,11
13889,58thStGreenway22ndAve,08/30/2015 05:00:00 PM,48,-122,5,3,8
13890,58thStGreenway22ndAve,08/30/2015 06:00:00 PM,48,-122,1,4,5
13891,58thStGreenway22ndAve,08/30/2015 07:00:00 PM,48,-122,4,1,5
13892,58thStGreenway22ndAve,08/30/2015 08:00:00 PM,48,-122,1,2,3
13893,58thStGreenway22ndAve,08/30/2015 09:00:00 PM,48,-122,3,2,5
13894,58thStGreenway22ndAve,08/30/2015 10:00:00 PM,48,-122,1,0,1
13895,58thStGreenway22ndAve,08/30/2015 11:00:00 PM,48,-122,1,0,1
13896,58thStGreenway22ndAve,08/31/2015 12:00:00 AM,48,-122,1,0,1
13897,58thStGreenway22ndAve,08/31/2015 01:00:00 AM,48,-122,0,1,1
13898,58thStGreenway22ndAve,08/31/2015 02:00:00 AM,48,-122,0,1,1
13899,58thStGreenway22ndAve,08/31/2015 03:00:00 AM,48,-122,0,0,0
13900,58thStGreenway22ndAve,08/31/2015 04:00:00 AM,48,-122,0,1,1
13901,58thStGreenway22ndAve,08/31/2015 05:00:00 AM,48,-122,0,1,1
13902,58thStGreenway22ndAve,08/31/2015 06:00:00 AM,48,-122,1,4,5
13903,58thStGreenway22ndAve,08/31/2015 07:00:00 AM,48,-122,6,3,9
13904,58thStGreenway22ndAve,08/31/2015 08:00:00 AM,48,-122,3,2,5
13905,58thStGreenway22ndAve,08/31/2015 09:00:00 AM,48,-122,2,6,8
13906,58thStGreenway22ndAve,08/31/2015 10:00:00 AM,48,-122,3,3,6
13907,58thStGreenway22ndAve,08/31/2015 11:00:00 AM,48,-122,0,1,1
13908,58thStGreenway22ndAve,08/31/2015 12:00:00 PM,48,-122,5,3,8
13909,58thStGreenway22ndAve,08/31/2015 01:00:00 PM,48,-122,1,3,4
13910,58thStGreenway22ndAve,08/31/2015 02:00:00 PM,48,-122,3,3,6
13911,58thStGreenway22ndAve,08/31/2015 03:00:00 PM,48,-122,6,4,10
13912,58thStGreenway22ndAve,08/31/2015 04:00:00 PM,48,-122,5,0,5
13913,58thStGreenway22ndAve,08/31/2015 05:00:00 PM,48,-122,7,2,9
13914,58thStGreenway22ndAve,08/31/2015 06:00:00 PM,48,-122,7,3,10
13915,58thStGreenway22ndAve,08/31/2015 07:00:00 PM,48,-122,4,4,8
13916,58thStGreenway22ndAve,08/31/2015 08:00:00 PM,48,-122,4,1,5
13917,58thStGreenway22ndAve,08/31/2015 09:00:00 PM,48,-122,0,5,5
13918,58thStGreenway22ndAve,08/31/2015 10:00:00 PM,48,-122,3,1,4
13919,58thStGreenway22ndAve,08/31/2015 11:00:00 PM,48,-122,0,0,0
13920,58thStGreenway22ndAve,09/01/2015 12:00:00 AM,48,-122,0,0,0
13921,58thStGreenway22ndAve,09/01/2015 01:00:00 AM,48,-122,0,1,1
13922,58thStGreenway22ndAve,09/01/2015 02:00:00 AM,48,-122,1,0,1
13923,58thStGreenway22ndAve,09/01/2015 03:00:00 AM,48,-122,1,0,1
13924,58thStGreenway22ndAve,09/01/2015 04:00:00 AM,48,-122,0,0,0
13925,58thStGreenway22ndAve,09/01/2015 05:00:00 AM,48,-122,0,1,1
13926,58thStGreenway22ndAve,09/01/2015 06:00:00 AM,48,-122,3,1,4
13927,58thStGreenway22ndAve,09/01/2015 07:00:00 AM,48,-122,4,3,7
13928,58thStGreenway22ndAve,09/01/2015 08:00:00 AM,48,-122,4,5,9
13929,58thStGreenway22ndAve,09/01/2015 09:00:00 AM,48,-122,2,7,9
13930,58thStGreenway22ndAve,09/01/2015 10:00:00 AM,48,-122,5,1,6
13931,58thStGreenway22ndAve,09/01/2015 11:00:00 AM,48,-122,1,4,5
13932,58thStGreenway22ndAve,09/01/2015 12:00:00 PM,48,-122,5,5,10
13933,58thStGreenway22ndAve,09/01/2015 01:00:00 PM,48,-122,1,4,5
13934,58thStGreenway22ndAve,09/01/2015 02:00:00 PM,48,-122,3,6,9
13935,58thStGreenway22ndAve,09/01/2015 03:00:00 PM,48,-122,2,2,4
13936,58thStGreenway22ndAve,09/01/2015 04:00:00 PM,48,-122,5,4,9
13937,58thStGreenway22ndAve,09/01/2015 05:00:00 PM,48,-122,8,6,14
13938,58thStGreenway22ndAve,09/01/2015 06:00:00 PM,48,-122,4,6,10
13939,58thStGreenway22ndAve,09/01/2015 07:00:00 PM,48,-122,5,6,11
13940,58thStGreenway22ndAve,09/01/2015 08:00:00 PM,48,-122,0,0,0
13941,58thStGreenway22ndAve,09/01/2015 09:00:00 PM,48,-122,1,2,3
13942,58thStGreenway22ndAve,09/01/2015 10:00:00 PM,48,-122,0,2,2
13943,58thStGreenway22ndAve,09/01/2015 11:00:00 PM,48,-122,0,0,0
13944,58thStGreenway22ndAve,09/02/2015 12:00:00 AM,48,-122,0,0,0
13945,58thStGreenway22ndAve,09/02/2015 01:00:00 AM,48,-122,0,1,1
13946,58thStGreenway22ndAve,09/02/2015 02:00:00 AM,48,-122,0,0,0
13947,58thStGreenway22ndAve,09/02/2015 03:00:00 AM,48,-122,0,0,0
13948,58thStGreenway22ndAve,09/02/2015 04:00:00 AM,48,-122,0,0,0
13949,58thStGreenway22ndAve,09/02/2015 05:00:00 AM,48,-122,0,1,1
13950,58thStGreenway22ndAve,09/02/2015 06:00:00 AM,48,-122,2,3,5
13951,58thStGreenway22ndAve,09/02/2015 07:00:00 AM,48,-122,6,7,13
13952,58thStGreenway22ndAve,09/02/2015 08:00:00 AM,48,-122,6,4,10
13953,58thStGreenway22ndAve,09/02/2015 09:00:00 AM,48,-122,6,6,12
13954,58thStGreenway22ndAve,09/02/2015 10:00:00 AM,48,-122,2,3,5
13955,58thStGreenway22ndAve,09/02/2015 11:00:00 AM,48,-122,0,0,0
13956,58thStGreenway22ndAve,09/02/2015 12:00:00 PM,48,-122,5,3,8
13957,58thStGreenway22ndAve,09/02/2015 01:00:00 PM,48,-122,4,2,6
13958,58thStGreenway22ndAve,09/02/2015 02:00:00 PM,48,-122,7,4,11
13959,58thStGreenway22ndAve,09/02/2015 03:00:00 PM,48,-122,4,4,8
13960,58thStGreenway22ndAve,09/02/2015 04:00:00 PM,48,-122,9,2,11
13961,58thStGreenway22ndAve,09/02/2015 05:00:00 PM,48,-122,4,5,9
13962,58thStGreenway22ndAve,09/02/2015 06:00:00 PM,48,-122,18,16,34
13963,58thStGreenway22ndAve,09/02/2015 07:00:00 PM,48,-122,8,5,13
13964,58thStGreenway22ndAve,09/02/2015 08:00:00 PM,48,-122,1,1,2
13965,58thStGreenway22ndAve,09/02/2015 09:00:00 PM,48,-122,1,2,3
13966,58thStGreenway22ndAve,09/02/2015 10:00:00 PM,48,-122,1,3,4
13967,58thStGreenway22ndAve,09/02/2015 11:00:00 PM,48,-122,0,1,1
13968,58thStGreenway22ndAve,09/03/2015 12:00:00 AM,48,-122,0,1,1
13969,58thStGreenway22ndAve,09/03/2015 01:00:00 AM,48,-122,2,0,2
13970,58thStGreenway22ndAve,09/03/2015 02:00:00 AM,48,-122,1,0,1
13971,58thStGreenway22ndAve,09/03/2015 03:00:00 AM,48,-122,0,0,0
13972,58thStGreenway22ndAve,09/03/2015 04:00:00 AM,48,-122,0,1,1
13973,58thStGreenway22ndAve,09/03/2015 05:00:00 AM,48,-122,0,1,1
13974,58thStGreenway22ndAve,09/03/2015 06:00:00 AM,48,-122,0,3,3
13975,58thStGreenway22ndAve,09/03/2015 07:00:00 AM,48,-122,5,2,7
13976,58thStGreenway22ndAve,09/03/2015 08:00:00 AM,48,-122,5,8,13
13977,58thStGreenway22ndAve,09/03/2015 09:00:00 AM,48,-122,4,2,6
13978,58thStGreenway22ndAve,09/03/2015 10:00:00 AM,48,-122,2,2,4
13979,58thStGreenway22ndAve,09/03/2015 11:00:00 AM,48,-122,5,5,10
13980,58thStGreenway22ndAve,09/03/2015 12:00:00 PM,48,-122,14,5,19
13981,58thStGreenway22ndAve,09/03/2015 01:00:00 PM,48,-122,3,8,11
13982,58thStGreenway22ndAve,09/03/2015 02:00:00 PM,48,-122,0,5,5
13983,58thStGreenway22ndAve,09/03/2015 03:00:00 PM,48,-122,13,4,17
13984,58thStGreenway22ndAve,09/03/2015 04:00:00 PM,48,-122,7,4,11
13985,58thStGreenway22ndAve,09/03/2015 05:00:00 PM,48,-122,9,2,11
13986,58thStGreenway22ndAve,09/03/2015 06:00:00 PM,48,-122,10,9,19
13987,58thStGreenway22ndAve,09/03/2015 07:00:00 PM,48,-122,3,3,6
13988,58thStGreenway22ndAve,09/03/2015 08:00:00 PM,48,-122,6,3,9
13989,58thStGreenway22ndAve,09/03/2015 09:00:00 PM,48,-122,1,0,1
13990,58thStGreenway22ndAve,09/03/2015 10:00:00 PM,48,-122,0,1,1
13991,58thStGreenway22ndAve,09/03/2015 11:00:00 PM,48,-122,2,2,4
13992,58thStGreenway22ndAve,09/04/2015 12:00:00 AM,48,-122,0,0,0
13993,58thStGreenway22ndAve,09/04/2015 01:00:00 AM,48,-122,0,0,0
13994,58thStGreenway22ndAve,09/04/2015 02:00:00 AM,48,-122,0,1,1
13995,58thStGreenway22ndAve,09/04/2015 03:00:00 AM,48,-122,0,0,0
13996,58thStGreenway22ndAve,09/04/2015 04:00:00 AM,48,-122,0,0,0
13997,58thStGreenway22ndAve,09/04/2015 05:00:00 AM,48,-122,0,1,1
13998,58thStGreenway22ndAve,09/04/2015 06:00:00 AM,48,-122,2,0,2
13999,58thStGreenway22ndAve,09/04/2015 07:00:00 AM,48,-122,1,3,4
14000,58thStGreenway22ndAve,09/04/2015 08:00:00 AM,48,-122,6,8,14
14001,58thStGreenway22ndAve,09/04/2015 09:00:00 AM,48,-122,3,4,7
14002,58thStGreenway22ndAve,09/04/2015 10:00:00 AM,48,-122,3,3,6
14003,58thStGreenway22ndAve,09/04/2015 11:00:00 AM,48,-122,5,5,10
14004,58thStGreenway22ndAve,09/04/2015 12:00:00 PM,48,-122,3,1,4
14005,58thStGreenway22ndAve,09/04/2015 01:00:00 PM,48,-122,6,3,9
14006,58thStGreenway22ndAve,09/04/2015 02:00:00 PM,48,-122,3,3,6
14007,58thStGreenway22ndAve,09/04/2015 03:00:00 PM,48,-122,3,3,6
14008,58thStGreenway22ndAve,09/04/2015 04:00:00 PM,48,-122,8,7,15
14009,58thStGreenway22ndAve,09/04/2015 05:00:00 PM,48,-122,8,6,14
14010,58thStGreenway22ndAve,09/04/2015 06:00:00 PM,48,-122,6,4,10
14011,58thStGreenway22ndAve,09/04/2015 07:00:00 PM,48,-122,4,4,8
14012,58thStGreenway22ndAve,09/04/2015 08:00:00 PM,48,-122,0,2,2
14013,58thStGreenway22ndAve,09/04/2015 09:00:00 PM,48,-122,2,3,5
14014,58thStGreenway22ndAve,09/04/2015 10:00:00 PM,48,-122,0,1,1
14015,58thStGreenway22ndAve,09/04/2015 11:00:00 PM,48,-122,1,1,2
14016,58thStGreenway22ndAve,09/05/2015 12:00:00 AM,48,-122,3,0,3
14017,58thStGreenway22ndAve,09/05/2015 01:00:00 AM,48,-122,1,0,1
14018,58thStGreenway22ndAve,09/05/2015 02:00:00 AM,48,-122,0,1,1
14019,58thStGreenway22ndAve,09/05/2015 03:00:00 AM,48,-122,0,0,0
14020,58thStGreenway22ndAve,09/05/2015 04:00:00 AM,48,-122,0,0,0
14021,58thStGreenway22ndAve,09/05/2015 05:00:00 AM,48,-122,0,0,0
14022,58thStGreenway22ndAve,09/05/2015 06:00:00 AM,48,-122,0,0,0
14023,58thStGreenway22ndAve,09/05/2015 07:00:00 AM,48,-122,1,3,4
14024,58thStGreenway22ndAve,09/05/2015 08:00:00 AM,48,-122,3,2,5
14025,58thStGreenway22ndAve,09/05/2015 09:00:00 AM,48,-122,1,2,3
14026,58thStGreenway22ndAve,09/05/2015 10:00:00 AM,48,-122,1,6,7
14027,58thStGreenway22ndAve,09/05/2015 11:00:00 AM,48,-122,10,5,15
14028,58thStGreenway22ndAve,09/05/2015 12:00:00 PM,48,-122,5,14,19
14029,58thStGreenway22ndAve,09/05/2015 01:00:00 PM,48,-122,1,3,4
14030,58thStGreenway22ndAve,09/05/2015 02:00:00 PM,48,-122,18,9,27
14031,58thStGreenway22ndAve,09/05/2015 03:00:00 PM,48,-122,2,4,6
14032,58thStGreenway22ndAve,09/05/2015 04:00:00 PM,48,-122,5,7,12
14033,58thStGreenway22ndAve,09/05/2015 05:00:00 PM,48,-122,3,3,6
14034,58thStGreenway22ndAve,09/05/2015 06:00:00 PM,48,-122,2,0,2
14035,58thStGreenway22ndAve,09/05/2015 07:00:00 PM,48,-122,0,0,0
14036,58thStGreenway22ndAve,09/05/2015 08:00:00 PM,48,-122,4,3,7
14037,58thStGreenway22ndAve,09/05/2015 09:00:00 PM,48,-122,2,2,4
14038,58thStGreenway22ndAve,09/05/2015 10:00:00 PM,48,-122,0,0,0
14039,58thStGreenway22ndAve,09/05/2015 11:00:00 PM,48,-122,1,0,1
14040,58thStGreenway22ndAve,09/06/2015 12:00:00 AM,48,-122,1,0,1
14041,58thStGreenway22ndAve,09/06/2015 01:00:00 AM,48,-122,0,0,0
14042,58thStGreenway22ndAve,09/06/2015 02:00:00 AM,48,-122,0,0,0
14043,58thStGreenway22ndAve,09/06/2015 03:00:00 AM,48,-122,0,0,0
14044,58thStGreenway22ndAve,09/06/2015 04:00:00 AM,48,-122,0,0,0
14045,58thStGreenway22ndAve,09/06/2015 05:00:00 AM,48,-122,1,0,1
14046,58thStGreenway22ndAve,09/06/2015 06:00:00 AM,48,-122,0,0,0
14047,58thStGreenway22ndAve,09/06/2015 07:00:00 AM,48,-122,1,1,2
14048,58thStGreenway22ndAve,09/06/2015 08:00:00 AM,48,-122,2,1,3
14049,58thStGreenway22ndAve,09/06/2015 09:00:00 AM,48,-122,2,2,4
14050,58thStGreenway22ndAve,09/06/2015 10:00:00 AM,48,-122,1,0,1
14051,58thStGreenway22ndAve,09/06/2015 11:00:00 AM,48,-122,2,2,4
14052,58thStGreenway22ndAve,09/06/2015 12:00:00 PM,48,-122,3,3,6
14053,58thStGreenway22ndAve,09/06/2015 01:00:00 PM,48,-122,3,1,4
14054,58thStGreenway22ndAve,09/06/2015 02:00:00 PM,48,-122,8,7,15
14055,58thStGreenway22ndAve,09/06/2015 03:00:00 PM,48,-122,5,6,11
14056,58thStGreenway22ndAve,09/06/2015 04:00:00 PM,48,-122,4,8,12
14057,58thStGreenway22ndAve,09/06/2015 05:00:00 PM,48,-122,4,0,4
14058,58thStGreenway22ndAve,09/06/2015 06:00:00 PM,48,-122,1,1,2
14059,58thStGreenway22ndAve,09/06/2015 07:00:00 PM,48,-122,3,1,4
14060,58thStGreenway22ndAve,09/06/2015 08:00:00 PM,48,-122,1,1,2
14061,58thStGreenway22ndAve,09/06/2015 09:00:00 PM,48,-122,0,0,0
14062,58thStGreenway22ndAve,09/06/2015 10:00:00 PM,48,-122,0,0,0
14063,58thStGreenway22ndAve,09/06/2015 11:00:00 PM,48,-122,0,1,1
14064,58thStGreenway22ndAve,09/07/2015 12:00:00 AM,48,-122,1,0,1
14065,58thStGreenway22ndAve,09/07/2015 01:00:00 AM,48,-122,0,1,1
14066,58thStGreenway22ndAve,09/07/2015 02:00:00 AM,48,-122,0,0,0
14067,58thStGreenway22ndAve,09/07/2015 03:00:00 AM,48,-122,0,0,0
14068,58thStGreenway22ndAve,09/07/2015 04:00:00 AM,48,-122,1,0,1
14069,58thStGreenway22ndAve,09/07/2015 05:00:00 AM,48,-122,0,0,0
14070,58thStGreenway22ndAve,09/07/2015 06:00:00 AM,48,-122,0,0,0
14071,58thStGreenway22ndAve,09/07/2015 07:00:00 AM,48,-122,0,2,2
14072,58thStGreenway22ndAve,09/07/2015 08:00:00 AM,48,-122,0,3,3
14073,58thStGreenway22ndAve,09/07/2015 09:00:00 AM,48,-122,7,9,16
14074,58thStGreenway22ndAve,09/07/2015 10:00:00 AM,48,-122,3,7,10
14075,58thStGreenway22ndAve,09/07/2015 11:00:00 AM,48,-122,3,1,4
14076,58thStGreenway22ndAve,09/07/2015 12:00:00 PM,48,-122,11,9,20
14077,58thStGreenway22ndAve,09/07/2015 01:00:00 PM,48,-122,13,2,15
14078,58thStGreenway22ndAve,09/07/2015 02:00:00 PM,48,-122,18,4,22
14079,58thStGreenway22ndAve,09/07/2015 03:00:00 PM,48,-122,9,8,17
14080,58thStGreenway22ndAve,09/07/2015 04:00:00 PM,48,-122,11,3,14
14081,58thStGreenway22ndAve,09/07/2015 05:00:00 PM,48,-122,8,12,20
14082,58thStGreenway22ndAve,09/07/2015 06:00:00 PM,48,-122,6,5,11
14083,58thStGreenway22ndAve,09/07/2015 07:00:00 PM,48,-122,5,3,8
14084,58thStGreenway22ndAve,09/07/2015 08:00:00 PM,48,-122,3,4,7
14085,58thStGreenway22ndAve,09/07/2015 09:00:00 PM,48,-122,4,2,6
14086,58thStGreenway22ndAve,09/07/2015 10:00:00 PM,48,-122,3,0,3
14087,58thStGreenway22ndAve,09/07/2015 11:00:00 PM,48,-122,0,0,0
14088,58thStGreenway22ndAve,09/08/2015 12:00:00 AM,48,-122,0,0,0
14089,58thStGreenway22ndAve,09/08/2015 01:00:00 AM,48,-122,0,1,1
14090,58thStGreenway22ndAve,09/08/2015 02:00:00 AM,48,-122,0,0,0
14091,58thStGreenway22ndAve,09/08/2015 03:00:00 AM,48,-122,0,0,0
14092,58thStGreenway22ndAve,09/08/2015 04:00:00 AM,48,-122,0,1,1
14093,58thStGreenway22ndAve,09/08/2015 05:00:00 AM,48,-122,0,0,0
14094,58thStGreenway22ndAve,09/08/2015 06:00:00 AM,48,-122,0,2,2
14095,58thStGreenway22ndAve,09/08/2015 07:00:00 AM,48,-122,5,2,7
14096,58thStGreenway22ndAve,09/08/2015 08:00:00 AM,48,-122,9,8,17
14097,58thStGreenway22ndAve,09/08/2015 09:00:00 AM,48,-122,3,3,6
14098,58thStGreenway22ndAve,09/08/2015 10:00:00 AM,48,-122,5,2,7
14099,58thStGreenway22ndAve,09/08/2015 11:00:00 AM,48,-122,4,4,8
14100,58thStGreenway22ndAve,09/08/2015 12:00:00 PM,48,-122,1,4,5
14101,58thStGreenway22ndAve,09/08/2015 01:00:00 PM,48,-122,4,4,8
14102,58thStGreenway22ndAve,09/08/2015 02:00:00 PM,48,-122,5,3,8
14103,58thStGreenway22ndAve,09/08/2015 03:00:00 PM,48,-122,3,2,5
14104,58thStGreenway22ndAve,09/08/2015 04:00:00 PM,48,-122,3,5,8
14105,58thStGreenway22ndAve,09/08/2015 05:00:00 PM,48,-122,2,0,2
14106,58thStGreenway22ndAve,09/08/2015 06:00:00 PM,48,-122,4,3,7
14107,58thStGreenway22ndAve,09/08/2015 07:00:00 PM,48,-122,0,4,4
14108,58thStGreenway22ndAve,09/08/2015 08:00:00 PM,48,-122,3,1,4
14109,58thStGreenway22ndAve,09/08/2015 09:00:00 PM,48,-122,2,4,6
14110,58thStGreenway22ndAve,09/08/2015 10:00:00 PM,48,-122,2,1,3
14111,58thStGreenway22ndAve,09/08/2015 11:00:00 PM,48,-122,0,0,0
14112,58thStGreenway22ndAve,09/09/2015 12:00:00 AM,48,-122,0,0,0
14113,58thStGreenway22ndAve,09/09/2015 01:00:00 AM,48,-122,0,0,0
14114,58thStGreenway22ndAve,09/09/2015 02:00:00 AM,48,-122,0,2,2
14115,58thStGreenway22ndAve,09/09/2015 03:00:00 AM,48,-122,0,0,0
14116,58thStGreenway22ndAve,09/09/2015 04:00:00 AM,48,-122,0,1,1
14117,58thStGreenway22ndAve,09/09/2015 05:00:00 AM,48,-122,1,2,3
14118,58thStGreenway22ndAve,09/09/2015 06:00:00 AM,48,-122,2,4,6
14119,58thStGreenway22ndAve,09/09/2015 07:00:00 AM,48,-122,2,8,10
14120,58thStGreenway22ndAve,09/09/2015 08:00:00 AM,48,-122,8,3,11
14121,58thStGreenway22ndAve,09/09/2015 09:00:00 AM,48,-122,0,5,5
14122,58thStGreenway22ndAve,09/09/2015 10:00:00 AM,48,-122,4,5,9
14123,58thStGreenway22ndAve,09/09/2015 11:00:00 AM,48,-122,4,6,10
14124,58thStGreenway22ndAve,09/09/2015 12:00:00 PM,48,-122,8,7,15
14125,58thStGreenway22ndAve,09/09/2015 01:00:00 PM,48,-122,4,4,8
14126,58thStGreenway22ndAve,09/09/2015 02:00:00 PM,48,-122,4,6,10
14127,58thStGreenway22ndAve,09/09/2015 03:00:00 PM,48,-122,7,4,11
14128,58thStGreenway22ndAve,09/09/2015 04:00:00 PM,48,-122,11,8,19
14129,58thStGreenway22ndAve,09/09/2015 05:00:00 PM,48,-122,11,5,16
14130,58thStGreenway22ndAve,09/09/2015 06:00:00 PM,48,-122,18,21,39
14131,58thStGreenway22ndAve,09/09/2015 07:00:00 PM,48,-122,10,8,18
14132,58thStGreenway22ndAve,09/09/2015 08:00:00 PM,48,-122,11,4,15
14133,58thStGreenway22ndAve,09/09/2015 09:00:00 PM,48,-122,4,1,5
14134,58thStGreenway22ndAve,09/09/2015 10:00:00 PM,48,-122,0,2,2
14135,58thStGreenway22ndAve,09/09/2015 11:00:00 PM,48,-122,1,0,1
14136,58thStGreenway22ndAve,09/10/2015 12:00:00 AM,48,-122,0,0,0
14137,58thStGreenway22ndAve,09/10/2015 01:00:00 AM,48,-122,0,1,1
14138,58thStGreenway22ndAve,09/10/2015 02:00:00 AM,48,-122,0,0,0
14139,58thStGreenway22ndAve,09/10/2015 03:00:00 AM,48,-122,0,0,0
14140,58thStGreenway22ndAve,09/10/2015 04:00:00 AM,48,-122,0,0,0
14141,58thStGreenway22ndAve,09/10/2015 05:00:00 AM,48,-122,0,0,0
14142,58thStGreenway22ndAve,09/10/2015 06:00:00 AM,48,-122,2,1,3
14143,58thStGreenway22ndAve,09/10/2015 07:00:00 AM,48,-122,5,6,11
14144,58thStGreenway22ndAve,09/10/2015 08:00:00 AM,48,-122,12,7,19
14145,58thStGreenway22ndAve,09/10/2015 09:00:00 AM,48,-122,2,6,8
14146,58thStGreenway22ndAve,09/10/2015 10:00:00 AM,48,-122,2,4,6
14147,58thStGreenway22ndAve,09/10/2015 11:00:00 AM,48,-122,3,5,8
14148,58thStGreenway22ndAve,09/10/2015 12:00:00 PM,48,-122,3,1,4
14149,58thStGreenway22ndAve,09/10/2015 01:00:00 PM,48,-122,3,5,8
14150,58thStGreenway22ndAve,09/10/2015 02:00:00 PM,48,-122,11,3,14
14151,58thStGreenway22ndAve,09/10/2015 03:00:00 PM,48,-122,4,3,7
14152,58thStGreenway22ndAve,09/10/2015 04:00:00 PM,48,-122,10,5,15
14153,58thStGreenway22ndAve,09/10/2015 05:00:00 PM,48,-122,6,10,16
14154,58thStGreenway22ndAve,09/10/2015 06:00:00 PM,48,-122,5,8,13
14155,58thStGreenway22ndAve,09/10/2015 07:00:00 PM,48,-122,4,10,14
14156,58thStGreenway22ndAve,09/10/2015 08:00:00 PM,48,-122,8,1,9
14157,58thStGreenway22ndAve,09/10/2015 09:00:00 PM,48,-122,1,0,1
14158,58thStGreenway22ndAve,09/10/2015 10:00:00 PM,48,-122,1,1,2
14159,58thStGreenway22ndAve,09/10/2015 11:00:00 PM,48,-122,2,0,2
14160,58thStGreenway22ndAve,09/11/2015 12:00:00 AM,48,-122,2,0,2
14161,58thStGreenway22ndAve,09/11/2015 01:00:00 AM,48,-122,0,0,0
14162,58thStGreenway22ndAve,09/11/2015 02:00:00 AM,48,-122,2,1,3
14163,58thStGreenway22ndAve,09/11/2015 03:00:00 AM,48,-122,0,0,0
14164,58thStGreenway22ndAve,09/11/2015 04:00:00 AM,48,-122,0,0,0
14165,58thStGreenway22ndAve,09/11/2015 05:00:00 AM,48,-122,0,0,0
14166,58thStGreenway22ndAve,09/11/2015 06:00:00 AM,48,-122,0,1,1
14167,58thStGreenway22ndAve,09/11/2015 07:00:00 AM,48,-122,1,1,2
14168,58thStGreenway22ndAve,09/11/2015 08:00:00 AM,48,-122,10,6,16
14169,58thStGreenway22ndAve,09/11/2015 09:00:00 AM,48,-122,2,5,7
14170,58thStGreenway22ndAve,09/11/2015 10:00:00 AM,48,-122,3,3,6
14171,58thStGreenway22ndAve,09/11/2015 11:00:00 AM,48,-122,2,6,8
14172,58thStGreenway22ndAve,09/11/2015 12:00:00 PM,48,-122,4,4,8
14173,58thStGreenway22ndAve,09/11/2015 01:00:00 PM,48,-122,4,5,9
14174,58thStGreenway22ndAve,09/11/2015 02:00:00 PM,48,-122,3,5,8
14175,58thStGreenway22ndAve,09/11/2015 03:00:00 PM,48,-122,2,4,6
14176,58thStGreenway22ndAve,09/11/2015 04:00:00 PM,48,-122,9,3,12
14177,58thStGreenway22ndAve,09/11/2015 05:00:00 PM,48,-122,6,10,16
14178,58thStGreenway22ndAve,09/11/2015 06:00:00 PM,48,-122,9,16,25
14179,58thStGreenway22ndAve,09/11/2015 07:00:00 PM,48,-122,8,8,16
14180,58thStGreenway22ndAve,09/11/2015 08:00:00 PM,48,-122,6,2,8
14181,58thStGreenway22ndAve,09/11/2015 09:00:00 PM,48,-122,3,3,6
14182,58thStGreenway22ndAve,09/11/2015 10:00:00 PM,48,-122,1,1,2
14183,58thStGreenway22ndAve,09/11/2015 11:00:00 PM,48,-122,0,0,0
14184,58thStGreenway22ndAve,09/12/2015 12:00:00 AM,48,-122,1,1,2
14185,58thStGreenway22ndAve,09/12/2015 01:00:00 AM,48,-122,0,0,0
14186,58thStGreenway22ndAve,09/12/2015 02:00:00 AM,48,-122,0,1,1
14187,58thStGreenway22ndAve,09/12/2015 03:00:00 AM,48,-122,0,1,1
14188,58thStGreenway22ndAve,09/12/2015 04:00:00 AM,48,-122,0,0,0
14189,58thStGreenway22ndAve,09/12/2015 05:00:00 AM,48,-122,0,0,0
14190,58thStGreenway22ndAve,09/12/2015 06:00:00 AM,48,-122,0,1,1
14191,58thStGreenway22ndAve,09/12/2015 07:00:00 AM,48,-122,0,1,1
14192,58thStGreenway22ndAve,09/12/2015 08:00:00 AM,48,-122,1,3,4
14193,58thStGreenway22ndAve,09/12/2015 09:00:00 AM,48,-122,5,6,11
14194,58thStGreenway22ndAve,09/12/2015 10:00:00 AM,48,-122,5,5,10
14195,58thStGreenway22ndAve,09/12/2015 11:00:00 AM,48,-122,3,6,9
14196,58thStGreenway22ndAve,09/12/2015 12:00:00 PM,48,-122,8,8,16
14197,58thStGreenway22ndAve,09/12/2015 01:00:00 PM,48,-122,7,13,20
14198,58thStGreenway22ndAve,09/12/2015 02:00:00 PM,48,-122,9,7,16
14199,58thStGreenway22ndAve,09/12/2015 03:00:00 PM,48,-122,12,4,16
14200,58thStGreenway22ndAve,09/12/2015 04:00:00 PM,48,-122,3,9,12
14201,58thStGreenway22ndAve,09/12/2015 05:00:00 PM,48,-122,12,12,24
14202,58thStGreenway22ndAve,09/12/2015 06:00:00 PM,48,-122,20,8,28
14203,58thStGreenway22ndAve,09/12/2015 07:00:00 PM,48,-122,6,3,9
14204,58thStGreenway22ndAve,09/12/2015 08:00:00 PM,48,-122,4,4,8
14205,58thStGreenway22ndAve,09/12/2015 09:00:00 PM,48,-122,0,3,3
14206,58thStGreenway22ndAve,09/12/2015 10:00:00 PM,48,-122,2,2,4
14207,58thStGreenway22ndAve,09/12/2015 11:00:00 PM,48,-122,0,0,0
14208,58thStGreenway22ndAve,09/13/2015 12:00:00 AM,48,-122,0,0,0
14209,58thStGreenway22ndAve,09/13/2015 01:00:00 AM,48,-122,0,1,1
14210,58thStGreenway22ndAve,09/13/2015 02:00:00 AM,48,-122,0,0,0
14211,58thStGreenway22ndAve,09/13/2015 03:00:00 AM,48,-122,0,0,0
14212,58thStGreenway22ndAve,09/13/2015 04:00:00 AM,48,-122,0,0,0
14213,58thStGreenway22ndAve,09/13/2015 05:00:00 AM,48,-122,0,0,0
14214,58thStGreenway22ndAve,09/13/2015 06:00:00 AM,48,-122,0,1,1
14215,58thStGreenway22ndAve,09/13/2015 07:00:00 AM,48,-122,0,0,0
14216,58thStGreenway22ndAve,09/13/2015 08:00:00 AM,48,-122,1,3,4
14217,58thStGreenway22ndAve,09/13/2015 09:00:00 AM,48,-122,5,4,9
14218,58thStGreenway22ndAve,09/13/2015 10:00:00 AM,48,-122,5,3,8
14219,58thStGreenway22ndAve,09/13/2015 11:00:00 AM,48,-122,2,1,3
14220,58thStGreenway22ndAve,09/13/2015 12:00:00 PM,48,-122,5,2,7
14221,58thStGreenway22ndAve,09/13/2015 01:00:00 PM,48,-122,3,6,9
14222,58thStGreenway22ndAve,09/13/2015 02:00:00 PM,48,-122,2,4,6
14223,58thStGreenway22ndAve,09/13/2015 03:00:00 PM,48,-122,3,2,5
14224,58thStGreenway22ndAve,09/13/2015 04:00:00 PM,48,-122,6,1,7
14225,58thStGreenway22ndAve,09/13/2015 05:00:00 PM,48,-122,2,4,6
14226,58thStGreenway22ndAve,09/13/2015 06:00:00 PM,48,-122,4,6,10
14227,58thStGreenway22ndAve,09/13/2015 07:00:00 PM,48,-122,5,2,7
14228,58thStGreenway22ndAve,09/13/2015 08:00:00 PM,48,-122,4,1,5
14229,58thStGreenway22ndAve,09/13/2015 09:00:00 PM,48,-122,2,0,2
14230,58thStGreenway22ndAve,09/13/2015 10:00:00 PM,48,-122,0,0,0
14231,58thStGreenway22ndAve,09/13/2015 11:00:00 PM,48,-122,0,1,1
14232,58thStGreenway22ndAve,09/14/2015 12:00:00 AM,48,-122,0,1,1
14233,58thStGreenway22ndAve,09/14/2015 01:00:00 AM,48,-122,0,0,0
14234,58thStGreenway22ndAve,09/14/2015 02:00:00 AM,48,-122,0,1,1
14235,58thStGreenway22ndAve,09/14/2015 03:00:00 AM,48,-122,0,1,1
14236,58thStGreenway22ndAve,09/14/2015 04:00:00 AM,48,-122,0,0,0
14237,58thStGreenway22ndAve,09/14/2015 05:00:00 AM,48,-122,0,1,1
14238,58thStGreenway22ndAve,09/14/2015 06:00:00 AM,48,-122,0,3,3
14239,58thStGreenway22ndAve,09/14/2015 07:00:00 AM,48,-122,6,2,8
14240,58thStGreenway22ndAve,09/14/2015 08:00:00 AM,48,-122,7,6,13
14241,58thStGreenway22ndAve,09/14/2015 09:00:00 AM,48,-122,1,5,6
14242,58thStGreenway22ndAve,09/14/2015 10:00:00 AM,48,-122,4,3,7
14243,58thStGreenway22ndAve,09/14/2015 11:00:00 AM,48,-122,2,1,3
14244,58thStGreenway22ndAve,09/14/2015 12:00:00 PM,48,-122,4,4,8
14245,58thStGreenway22ndAve,09/14/2015 01:00:00 PM,48,-122,5,2,7
14246,58thStGreenway22ndAve,09/14/2015 02:00:00 PM,48,-122,5,9,14
14247,58thStGreenway22ndAve,09/14/2015 03:00:00 PM,48,-122,5,2,7
14248,58thStGreenway22ndAve,09/14/2015 04:00:00 PM,48,-122,15,2,17
14249,58thStGreenway22ndAve,09/14/2015 05:00:00 PM,48,-122,8,7,15
14250,58thStGreenway22ndAve,09/14/2015 06:00:00 PM,48,-122,1,9,10
14251,58thStGreenway22ndAve,09/14/2015 07:00:00 PM,48,-122,7,7,14
14252,58thStGreenway22ndAve,09/14/2015 08:00:00 PM,48,-122,2,2,4
14253,58thStGreenway22ndAve,09/14/2015 09:00:00 PM,48,-122,0,0,0
14254,58thStGreenway22ndAve,09/14/2015 10:00:00 PM,48,-122,1,0,1
14255,58thStGreenway22ndAve,09/14/2015 11:00:00 PM,48,-122,0,2,2
14256,58thStGreenway22ndAve,09/15/2015 12:00:00 AM,48,-122,0,0,0
14257,58thStGreenway22ndAve,09/15/2015 01:00:00 AM,48,-122,0,0,0
14258,58thStGreenway22ndAve,09/15/2015 02:00:00 AM,48,-122,0,0,0
14259,58thStGreenway22ndAve,09/15/2015 03:00:00 AM,48,-122,0,1,1
14260,58thStGreenway22ndAve,09/15/2015 04:00:00 AM,48,-122,0,0,0
14261,58thStGreenway22ndAve,09/15/2015 05:00:00 AM,48,-122,0,1,1
14262,58thStGreenway22ndAve,09/15/2015 06:00:00 AM,48,-122,1,3,4
14263,58thStGreenway22ndAve,09/15/2015 07:00:00 AM,48,-122,6,3,9
14264,58thStGreenway22ndAve,09/15/2015 08:00:00 AM,48,-122,7,2,9
14265,58thStGreenway22ndAve,09/15/2015 09:00:00 AM,48,-122,2,6,8
14266,58thStGreenway22ndAve,09/15/2015 10:00:00 AM,48,-122,4,2,6
14267,58thStGreenway22ndAve,09/15/2015 11:00:00 AM,48,-122,3,3,6
14268,58thStGreenway22ndAve,09/15/2015 12:00:00 PM,48,-122,3,5,8
14269,58thStGreenway22ndAve,09/15/2015 01:00:00 PM,48,-122,7,1,8
14270,58thStGreenway22ndAve,09/15/2015 02:00:00 PM,48,-122,1,2,3
14271,58thStGreenway22ndAve,09/15/2015 03:00:00 PM,48,-122,9,5,14
14272,58thStGreenway22ndAve,09/15/2015 04:00:00 PM,48,-122,9,4,13
14273,58thStGreenway22ndAve,09/15/2015 05:00:00 PM,48,-122,7,6,13
14274,58thStGreenway22ndAve,09/15/2015 06:00:00 PM,48,-122,3,11,14
14275,58thStGreenway22ndAve,09/15/2015 07:00:00 PM,48,-122,2,4,6
14276,58thStGreenway22ndAve,09/15/2015 08:00:00 PM,48,-122,5,1,6
14277,58thStGreenway22ndAve,09/15/2015 09:00:00 PM,48,-122,4,1,5
14278,58thStGreenway22ndAve,09/15/2015 10:00:00 PM,48,-122,1,1,2
14279,58thStGreenway22ndAve,09/15/2015 11:00:00 PM,48,-122,1,1,2
14280,58thStGreenway22ndAve,09/16/2015 12:00:00 AM,48,-122,0,0,0
14281,58thStGreenway22ndAve,09/16/2015 01:00:00 AM,48,-122,3,0,3
14282,58thStGreenway22ndAve,09/16/2015 02:00:00 AM,48,-122,1,1,2
14283,58thStGreenway22ndAve,09/16/2015 03:00:00 AM,48,-122,0,1,1
14284,58thStGreenway22ndAve,09/16/2015 04:00:00 AM,48,-122,0,0,0
14285,58thStGreenway22ndAve,09/16/2015 05:00:00 AM,48,-122,0,0,0
14286,58thStGreenway22ndAve,09/16/2015 06:00:00 AM,48,-122,1,4,5
14287,58thStGreenway22ndAve,09/16/2015 07:00:00 AM,48,-122,3,6,9
14288,58thStGreenway22ndAve,09/16/2015 08:00:00 AM,48,-122,5,4,9
14289,58thStGreenway22ndAve,09/16/2015 09:00:00 AM,48,-122,4,9,13
14290,58thStGreenway22ndAve,09/16/2015 10:00:00 AM,48,-122,9,5,14
14291,58thStGreenway22ndAve,09/16/2015 11:00:00 AM,48,-122,0,0,0
14292,58thStGreenway22ndAve,09/16/2015 12:00:00 PM,48,-122,7,4,11
14293,58thStGreenway22ndAve,09/16/2015 01:00:00 PM,48,-122,8,2,10
14294,58thStGreenway22ndAve,09/16/2015 02:00:00 PM,48,-122,7,5,12
14295,58thStGreenway22ndAve,09/16/2015 03:00:00 PM,48,-122,0,9,9
14296,58thStGreenway22ndAve,09/16/2015 04:00:00 PM,48,-122,12,4,16
14297,58thStGreenway22ndAve,09/16/2015 05:00:00 PM,48,-122,16,12,28
14298,58thStGreenway22ndAve,09/16/2015 06:00:00 PM,48,-122,11,12,23
14299,58thStGreenway22ndAve,09/16/2015 07:00:00 PM,48,-122,10,3,13
14300,58thStGreenway22ndAve,09/16/2015 08:00:00 PM,48,-122,5,4,9
14301,58thStGreenway22ndAve,09/16/2015 09:00:00 PM,48,-122,3,1,4
14302,58thStGreenway22ndAve,09/16/2015 10:00:00 PM,48,-122,1,1,2
14303,58thStGreenway22ndAve,09/16/2015 11:00:00 PM,48,-122,1,0,1
14304,58thStGreenway22ndAve,09/17/2015 12:00:00 AM,48,-122,0,2,2
14305,58thStGreenway22ndAve,09/17/2015 01:00:00 AM,48,-122,0,1,1
14306,58thStGreenway22ndAve,09/17/2015 02:00:00 AM,48,-122,0,1,1
14307,58thStGreenway22ndAve,09/17/2015 03:00:00 AM,48,-122,0,0,0
14308,58thStGreenway22ndAve,09/17/2015 04:00:00 AM,48,-122,0,0,0
14309,58thStGreenway22ndAve,09/17/2015 05:00:00 AM,48,-122,0,2,2
14310,58thStGreenway22ndAve,09/17/2015 06:00:00 AM,48,-122,0,3,3
14311,58thStGreenway22ndAve,09/17/2015 07:00:00 AM,48,-122,1,0,1
14312,58thStGreenway22ndAve,09/17/2015 08:00:00 AM,48,-122,4,4,8
14313,58thStGreenway22ndAve,09/17/2015 09:00:00 AM,48,-122,4,2,6
14314,58thStGreenway22ndAve,09/17/2015 10:00:00 AM,48,-122,1,1,2
14315,58thStGreenway22ndAve,09/17/2015 11:00:00 AM,48,-122,1,1,2
14316,58thStGreenway22ndAve,09/17/2015 12:00:00 PM,48,-122,0,0,0
14317,58thStGreenway22ndAve,09/17/2015 01:00:00 PM,48,-122,4,2,6
14318,58thStGreenway22ndAve,09/17/2015 02:00:00 PM,48,-122,3,2,5
14319,58thStGreenway22ndAve,09/17/2015 03:00:00 PM,48,-122,8,3,11
14320,58thStGreenway22ndAve,09/17/2015 04:00:00 PM,48,-122,5,6,11
14321,58thStGreenway22ndAve,09/17/2015 05:00:00 PM,48,-122,2,5,7
14322,58thStGreenway22ndAve,09/17/2015 06:00:00 PM,48,-122,0,2,2
14323,58thStGreenway22ndAve,09/17/2015 07:00:00 PM,48,-122,3,1,4
14324,58thStGreenway22ndAve,09/17/2015 08:00:00 PM,48,-122,1,0,1
14325,58thStGreenway22ndAve,09/17/2015 09:00:00 PM,48,-122,3,2,5
14326,58thStGreenway22ndAve,09/17/2015 10:00:00 PM,48,-122,0,1,1
14327,58thStGreenway22ndAve,09/17/2015 11:00:00 PM,48,-122,0,1,1
14328,58thStGreenway22ndAve,09/18/2015 12:00:00 AM,48,-122,1,0,1
14329,58thStGreenway22ndAve,09/18/2015 01:00:00 AM,48,-122,0,0,0
14330,58thStGreenway22ndAve,09/18/2015 02:00:00 AM,48,-122,2,1,3
14331,58thStGreenway22ndAve,09/18/2015 03:00:00 AM,48,-122,0,0,0
14332,58thStGreenway22ndAve,09/18/2015 04:00:00 AM,48,-122,0,0,0
14333,58thStGreenway22ndAve,09/18/2015 05:00:00 AM,48,-122,0,0,0
14334,58thStGreenway22ndAve,09/18/2015 06:00:00 AM,48,-122,0,1,1
14335,58thStGreenway22ndAve,09/18/2015 07:00:00 AM,48,-122,3,3,6
14336,58thStGreenway22ndAve,09/18/2015 08:00:00 AM,48,-122,7,5,12
14337,58thStGreenway22ndAve,09/18/2015 09:00:00 AM,48,-122,5,12,17
14338,58thStGreenway22ndAve,09/18/2015 10:00:00 AM,48,-122,1,4,5
14339,58thStGreenway22ndAve,09/18/2015 11:00:00 AM,48,-122,4,4,8
14340,58thStGreenway22ndAve,09/18/2015 12:00:00 PM,48,-122,1,4,5
14341,58thStGreenway22ndAve,09/18/2015 01:00:00 PM,48,-122,6,2,8
14342,58thStGreenway22ndAve,09/18/2015 02:00:00 PM,48,-122,6,5,11
14343,58thStGreenway22ndAve,09/18/2015 03:00:00 PM,48,-122,3,4,7
14344,58thStGreenway22ndAve,09/18/2015 04:00:00 PM,48,-122,9,7,16
14345,58thStGreenway22ndAve,09/18/2015 05:00:00 PM,48,-122,11,3,14
14346,58thStGreenway22ndAve,09/18/2015 06:00:00 PM,48,-122,7,12,19
14347,58thStGreenway22ndAve,09/18/2015 07:00:00 PM,48,-122,4,6,10
14348,58thStGreenway22ndAve,09/18/2015 08:00:00 PM,48,-122,3,1,4
14349,58thStGreenway22ndAve,09/18/2015 09:00:00 PM,48,-122,2,1,3
14350,58thStGreenway22ndAve,09/18/2015 10:00:00 PM,48,-122,2,0,2
14351,58thStGreenway22ndAve,09/18/2015 11:00:00 PM,48,-122,1,1,2
14352,58thStGreenway22ndAve,09/19/2015 12:00:00 AM,48,-122,2,2,4
14353,58thStGreenway22ndAve,09/19/2015 01:00:00 AM,48,-122,0,0,0
14354,58thStGreenway22ndAve,09/19/2015 02:00:00 AM,48,-122,2,0,2
14355,58thStGreenway22ndAve,09/19/2015 03:00:00 AM,48,-122,0,0,0
14356,58thStGreenway22ndAve,09/19/2015 04:00:00 AM,48,-122,1,0,1
14357,58thStGreenway22ndAve,09/19/2015 05:00:00 AM,48,-122,0,1,1
14358,58thStGreenway22ndAve,09/19/2015 06:00:00 AM,48,-122,0,0,0
14359,58thStGreenway22ndAve,09/19/2015 07:00:00 AM,48,-122,1,3,4
14360,58thStGreenway22ndAve,09/19/2015 08:00:00 AM,48,-122,4,3,7
14361,58thStGreenway22ndAve,09/19/2015 09:00:00 AM,48,-122,9,43,52
14362,58thStGreenway22ndAve,09/19/2015 10:00:00 AM,48,-122,14,11,25
14363,58thStGreenway22ndAve,09/19/2015 11:00:00 AM,48,-122,14,62,76
14364,58thStGreenway22ndAve,09/19/2015 12:00:00 PM,48,-122,61,52,113
14365,58thStGreenway22ndAve,09/19/2015 01:00:00 PM,48,-122,116,63,179
14366,58thStGreenway22ndAve,09/19/2015 02:00:00 PM,48,-122,109,83,192
14367,58thStGreenway22ndAve,09/19/2015 03:00:00 PM,48,-122,50,32,82
14368,58thStGreenway22ndAve,09/19/2015 04:00:00 PM,48,-122,21,9,30
14369,58thStGreenway22ndAve,09/19/2015 05:00:00 PM,48,-122,9,18,27
14370,58thStGreenway22ndAve,09/19/2015 06:00:00 PM,48,-122,5,3,8
14371,58thStGreenway22ndAve,09/19/2015 07:00:00 PM,48,-122,15,3,18
14372,58thStGreenway22ndAve,09/19/2015 08:00:00 PM,48,-122,5,0,5
14373,58thStGreenway22ndAve,09/19/2015 09:00:00 PM,48,-122,1,0,1
14374,58thStGreenway22ndAve,09/19/2015 10:00:00 PM,48,-122,1,2,3
14375,58thStGreenway22ndAve,09/19/2015 11:00:00 PM,48,-122,2,4,6
14376,58thStGreenway22ndAve,09/20/2015 12:00:00 AM,48,-122,0,2,2
14377,58thStGreenway22ndAve,09/20/2015 01:00:00 AM,48,-122,0,0,0
14378,58thStGreenway22ndAve,09/20/2015 02:00:00 AM,48,-122,1,0,1
14379,58thStGreenway22ndAve,09/20/2015 03:00:00 AM,48,-122,0,1,1
14380,58thStGreenway22ndAve,09/20/2015 04:00:00 AM,48,-122,0,0,0
14381,58thStGreenway22ndAve,09/20/2015 05:00:00 AM,48,-122,0,0,0
14382,58thStGreenway22ndAve,09/20/2015 06:00:00 AM,48,-122,2,1,3
14383,58thStGreenway22ndAve,09/20/2015 07:00:00 AM,48,-122,0,1,1
14384,58thStGreenway22ndAve,09/20/2015 08:00:00 AM,48,-122,2,0,2
14385,58thStGreenway22ndAve,09/20/2015 09:00:00 AM,48,-122,5,6,11
14386,58thStGreenway22ndAve,09/20/2015 10:00:00 AM,48,-122,5,9,14
14387,58thStGreenway22ndAve,09/20/2015 11:00:00 AM,48,-122,13,10,23
14388,58thStGreenway22ndAve,09/20/2015 12:00:00 PM,48,-122,11,7,18
14389,58thStGreenway22ndAve,09/20/2015 01:00:00 PM,48,-122,6,10,16
14390,58thStGreenway22ndAve,09/20/2015 02:00:00 PM,48,-122,5,6,11
14391,58thStGreenway22ndAve,09/20/2015 03:00:00 PM,48,-122,14,8,22
14392,58thStGreenway22ndAve,09/20/2015 04:00:00 PM,48,-122,11,15,26
14393,58thStGreenway22ndAve,09/20/2015 05:00:00 PM,48,-122,7,11,18
14394,58thStGreenway22ndAve,09/20/2015 06:00:00 PM,48,-122,5,5,10
14395,58thStGreenway22ndAve,09/20/2015 07:00:00 PM,48,-122,0,2,2
14396,58thStGreenway22ndAve,09/20/2015 08:00:00 PM,48,-122,2,2,4
14397,58thStGreenway22ndAve,09/20/2015 09:00:00 PM,48,-122,5,1,6
14398,58thStGreenway22ndAve,09/20/2015 10:00:00 PM,48,-122,1,1,2
14399,58thStGreenway22ndAve,09/20/2015 11:00:00 PM,48,-122,1,0,1
14400,58thStGreenway22ndAve,09/21/2015 12:00:00 AM,48,-122,0,0,0
14401,58thStGreenway22ndAve,09/21/2015 01:00:00 AM,48,-122,1,1,2
14402,58thStGreenway22ndAve,09/21/2015 02:00:00 AM,48,-122,0,1,1
14403,58thStGreenway22ndAve,09/21/2015 03:00:00 AM,48,-122,0,0,0
14404,58thStGreenway22ndAve,09/21/2015 04:00:00 AM,48,-122,0,0,0
14405,58thStGreenway22ndAve,09/21/2015 05:00:00 AM,48,-122,0,1,1
14406,58thStGreenway22ndAve,09/21/2015 06:00:00 AM,48,-122,1,2,3
14407,58thStGreenway22ndAve,09/21/2015 07:00:00 AM,48,-122,5,2,7
14408,58thStGreenway22ndAve,09/21/2015 08:00:00 AM,48,-122,9,5,14
14409,58thStGreenway22ndAve,09/21/2015 09:00:00 AM,48,-122,4,6,10
14410,58thStGreenway22ndAve,09/21/2015 10:00:00 AM,48,-122,3,5,8
14411,58thStGreenway22ndAve,09/21/2015 11:00:00 AM,48,-122,5,8,13
14412,58thStGreenway22ndAve,09/21/2015 12:00:00 PM,48,-122,7,1,8
14413,58thStGreenway22ndAve,09/21/2015 01:00:00 PM,48,-122,5,7,12
14414,58thStGreenway22ndAve,09/21/2015 02:00:00 PM,48,-122,9,5,14
14415,58thStGreenway22ndAve,09/21/2015 03:00:00 PM,48,-122,2,5,7
14416,58thStGreenway22ndAve,09/21/2015 04:00:00 PM,48,-122,16,4,20
14417,58thStGreenway22ndAve,09/21/2015 05:00:00 PM,48,-122,12,10,22
14418,58thStGreenway22ndAve,09/21/2015 06:00:00 PM,48,-122,10,12,22
14419,58thStGreenway22ndAve,09/21/2015 07:00:00 PM,48,-122,6,4,10
14420,58thStGreenway22ndAve,09/21/2015 08:00:00 PM,48,-122,5,1,6
14421,58thStGreenway22ndAve,09/21/2015 09:00:00 PM,48,-122,2,1,3
14422,58thStGreenway22ndAve,09/21/2015 10:00:00 PM,48,-122,1,0,1
14423,58thStGreenway22ndAve,09/21/2015 11:00:00 PM,48,-122,0,0,0
14424,58thStGreenway22ndAve,09/22/2015 12:00:00 AM,48,-122,0,0,0
14425,58thStGreenway22ndAve,09/22/2015 01:00:00 AM,48,-122,0,0,0
14426,58thStGreenway22ndAve,09/22/2015 02:00:00 AM,48,-122,0,0,0
14427,58thStGreenway22ndAve,09/22/2015 03:00:00 AM,48,-122,2,0,2
14428,58thStGreenway22ndAve,09/22/2015 04:00:00 AM,48,-122,0,1,1
14429,58thStGreenway22ndAve,09/22/2015 05:00:00 AM,48,-122,1,1,2
14430,58thStGreenway22ndAve,09/22/2015 06:00:00 AM,48,-122,0,5,5
14431,58thStGreenway22ndAve,09/22/2015 07:00:00 AM,48,-122,5,1,6
14432,58thStGreenway22ndAve,09/22/2015 08:00:00 AM,48,-122,7,4,11
14433,58thStGreenway22ndAve,09/22/2015 09:00:00 AM,48,-122,6,5,11
14434,58thStGreenway22ndAve,09/22/2015 10:00:00 AM,48,-122,0,2,2
14435,58thStGreenway22ndAve,09/22/2015 11:00:00 AM,48,-122,8,2,10
14436,58thStGreenway22ndAve,09/22/2015 12:00:00 PM,48,-122,2,5,7
14437,58thStGreenway22ndAve,09/22/2015 01:00:00 PM,48,-122,5,5,10
14438,58thStGreenway22ndAve,09/22/2015 02:00:00 PM,48,-122,3,7,10
14439,58thStGreenway22ndAve,09/22/2015 03:00:00 PM,48,-122,8,2,10
14440,58thStGreenway22ndAve,09/22/2015 04:00:00 PM,48,-122,6,4,10
14441,58thStGreenway22ndAve,09/22/2015 05:00:00 PM,48,-122,15,15,30
14442,58thStGreenway22ndAve,09/22/2015 06:00:00 PM,48,-122,5,7,12
14443,58thStGreenway22ndAve,09/22/2015 07:00:00 PM,48,-122,10,6,16
14444,58thStGreenway22ndAve,09/22/2015 08:00:00 PM,48,-122,6,5,11
14445,58thStGreenway22ndAve,09/22/2015 09:00:00 PM,48,-122,7,3,10
14446,58thStGreenway22ndAve,09/22/2015 10:00:00 PM,48,-122,0,1,1
14447,58thStGreenway22ndAve,09/22/2015 11:00:00 PM,48,-122,2,0,2
14448,58thStGreenway22ndAve,09/23/2015 12:00:00 AM,48,-122,0,0,0
14449,58thStGreenway22ndAve,09/23/2015 01:00:00 AM,48,-122,0,0,0
14450,58thStGreenway22ndAve,09/23/2015 02:00:00 AM,48,-122,0,0,0
14451,58thStGreenway22ndAve,09/23/2015 03:00:00 AM,48,-122,0,0,0
14452,58thStGreenway22ndAve,09/23/2015 04:00:00 AM,48,-122,0,0,0
14453,58thStGreenway22ndAve,09/23/2015 05:00:00 AM,48,-122,0,2,2
14454,58thStGreenway22ndAve,09/23/2015 06:00:00 AM,48,-122,2,2,4
14455,58thStGreenway22ndAve,09/23/2015 07:00:00 AM,48,-122,5,4,9
14456,58thStGreenway22ndAve,09/23/2015 08:00:00 AM,48,-122,3,8,11
14457,58thStGreenway22ndAve,09/23/2015 09:00:00 AM,48,-122,3,2,5
14458,58thStGreenway22ndAve,09/23/2015 10:00:00 AM,48,-122,0,4,4
14459,58thStGreenway22ndAve,09/23/2015 11:00:00 AM,48,-122,0,5,5
14460,58thStGreenway22ndAve,09/23/2015 12:00:00 PM,48,-122,5,3,8
14461,58thStGreenway22ndAve,09/23/2015 01:00:00 PM,48,-122,2,3,5
14462,58thStGreenway22ndAve,09/23/2015 02:00:00 PM,48,-122,9,4,13
14463,58thStGreenway22ndAve,09/23/2015 03:00:00 PM,48,-122,8,4,12
14464,58thStGreenway22ndAve,09/23/2015 04:00:00 PM,48,-122,9,8,17
14465,58thStGreenway22ndAve,09/23/2015 05:00:00 PM,48,-122,16,8,24
14466,58thStGreenway22ndAve,09/23/2015 06:00:00 PM,48,-122,10,14,24
14467,58thStGreenway22ndAve,09/23/2015 07:00:00 PM,48,-122,11,8,19
14468,58thStGreenway22ndAve,09/23/2015 08:00:00 PM,48,-122,1,3,4
14469,58thStGreenway22ndAve,09/23/2015 09:00:00 PM,48,-122,4,0,4
14470,58thStGreenway22ndAve,09/23/2015 10:00:00 PM,48,-122,2,1,3
14471,58thStGreenway22ndAve,09/23/2015 11:00:00 PM,48,-122,2,0,2
14472,58thStGreenway22ndAve,09/24/2015 12:00:00 AM,48,-122,0,0,0
14473,58thStGreenway22ndAve,09/24/2015 01:00:00 AM,48,-122,0,0,0
14474,58thStGreenway22ndAve,09/24/2015 02:00:00 AM,48,-122,0,0,0
14475,58thStGreenway22ndAve,09/24/2015 03:00:00 AM,48,-122,1,1,2
14476,58thStGreenway22ndAve,09/24/2015 04:00:00 AM,48,-122,0,0,0
14477,58thStGreenway22ndAve,09/24/2015 05:00:00 AM,48,-122,0,1,1
14478,58thStGreenway22ndAve,09/24/2015 06:00:00 AM,48,-122,0,3,3
14479,58thStGreenway22ndAve,09/24/2015 07:00:00 AM,48,-122,7,1,8
14480,58thStGreenway22ndAve,09/24/2015 08:00:00 AM,48,-122,8,6,14
14481,58thStGreenway22ndAve,09/24/2015 09:00:00 AM,48,-122,5,3,8
14482,58thStGreenway22ndAve,09/24/2015 10:00:00 AM,48,-122,5,7,12
14483,58thStGreenway22ndAve,09/24/2015 11:00:00 AM,48,-122,2,3,5
14484,58thStGreenway22ndAve,09/24/2015 12:00:00 PM,48,-122,3,2,5
14485,58thStGreenway22ndAve,09/24/2015 01:00:00 PM,48,-122,2,7,9
14486,58thStGreenway22ndAve,09/24/2015 02:00:00 PM,48,-122,8,6,14
14487,58thStGreenway22ndAve,09/24/2015 03:00:00 PM,48,-122,7,3,10
14488,58thStGreenway22ndAve,09/24/2015 04:00:00 PM,48,-122,9,9,18
14489,58thStGreenway22ndAve,09/24/2015 05:00:00 PM,48,-122,9,5,14
14490,58thStGreenway22ndAve,09/24/2015 06:00:00 PM,48,-122,7,6,13
14491,58thStGreenway22ndAve,09/24/2015 07:00:00 PM,48,-122,11,8,19
14492,58thStGreenway22ndAve,09/24/2015 08:00:00 PM,48,-122,1,5,6
14493,58thStGreenway22ndAve,09/24/2015 09:00:00 PM,48,-122,7,1,8
14494,58thStGreenway22ndAve,09/24/2015 10:00:00 PM,48,-122,3,1,4
14495,58thStGreenway22ndAve,09/24/2015 11:00:00 PM,48,-122,0,0,0
14496,58thStGreenway22ndAve,09/25/2015 12:00:00 AM,48,-122,0,0,0
14497,58thStGreenway22ndAve,09/25/2015 01:00:00 AM,48,-122,0,0,0
14498,58thStGreenway22ndAve,09/25/2015 02:00:00 AM,48,-122,0,0,0
14499,58thStGreenway22ndAve,09/25/2015 03:00:00 AM,48,-122,2,0,2
14500,58thStGreenway22ndAve,09/25/2015 04:00:00 AM,48,-122,0,0,0
14501,58thStGreenway22ndAve,09/25/2015 05:00:00 AM,48,-122,0,0,0
14502,58thStGreenway22ndAve,09/25/2015 06:00:00 AM,48,-122,3,1,4
14503,58thStGreenway22ndAve,09/25/2015 07:00:00 AM,48,-122,4,3,7
14504,58thStGreenway22ndAve,09/25/2015 08:00:00 AM,48,-122,9,6,15
14505,58thStGreenway22ndAve,09/25/2015 09:00:00 AM,48,-122,3,3,6
14506,58thStGreenway22ndAve,09/25/2015 10:00:00 AM,48,-122,3,2,5
14507,58thStGreenway22ndAve,09/25/2015 11:00:00 AM,48,-122,1,2,3
14508,58thStGreenway22ndAve,09/25/2015 12:00:00 PM,48,-122,6,5,11
14509,58thStGreenway22ndAve,09/25/2015 01:00:00 PM,48,-122,6,2,8
14510,58thStGreenway22ndAve,09/25/2015 02:00:00 PM,48,-122,5,4,9
14511,58thStGreenway22ndAve,09/25/2015 03:00:00 PM,48,-122,6,4,10
14512,58thStGreenway22ndAve,09/25/2015 04:00:00 PM,48,-122,2,4,6
14513,58thStGreenway22ndAve,09/25/2015 05:00:00 PM,48,-122,13,9,22
14514,58thStGreenway22ndAve,09/25/2015 06:00:00 PM,48,-122,1,7,8
14515,58thStGreenway22ndAve,09/25/2015 07:00:00 PM,48,-122,7,4,11
14516,58thStGreenway22ndAve,09/25/2015 08:00:00 PM,48,-122,1,4,5
14517,58thStGreenway22ndAve,09/25/2015 09:00:00 PM,48,-122,2,0,2
14518,58thStGreenway22ndAve,09/25/2015 10:00:00 PM,48,-122,0,1,1
14519,58thStGreenway22ndAve,09/25/2015 11:00:00 PM,48,-122,0,0,0
14520,58thStGreenway22ndAve,09/26/2015 12:00:00 AM,48,-122,0,2,2
14521,58thStGreenway22ndAve,09/26/2015 01:00:00 AM,48,-122,3,2,5
14522,58thStGreenway22ndAve,09/26/2015 02:00:00 AM,48,-122,0,0,0
14523,58thStGreenway22ndAve,09/26/2015 03:00:00 AM,48,-122,0,0,0
14524,58thStGreenway22ndAve,09/26/2015 04:00:00 AM,48,-122,0,0,0
14525,58thStGreenway22ndAve,09/26/2015 05:00:00 AM,48,-122,0,0,0
14526,58thStGreenway22ndAve,09/26/2015 06:00:00 AM,48,-122,3,3,6
14527,58thStGreenway22ndAve,09/26/2015 07:00:00 AM,48,-122,1,1,2
14528,58thStGreenway22ndAve,09/26/2015 08:00:00 AM,48,-122,1,6,7
14529,58thStGreenway22ndAve,09/26/2015 09:00:00 AM,48,-122,1,5,6
14530,58thStGreenway22ndAve,09/26/2015 10:00:00 AM,48,-122,6,8,14
14531,58thStGreenway22ndAve,09/26/2015 11:00:00 AM,48,-122,25,8,33
14532,58thStGreenway22ndAve,09/26/2015 12:00:00 PM,48,-122,10,7,17
14533,58thStGreenway22ndAve,09/26/2015 01:00:00 PM,48,-122,11,5,16
14534,58thStGreenway22ndAve,09/26/2015 02:00:00 PM,48,-122,4,1,5
14535,58thStGreenway22ndAve,09/26/2015 03:00:00 PM,48,-122,4,7,11
14536,58thStGreenway22ndAve,09/26/2015 04:00:00 PM,48,-122,6,6,12
14537,58thStGreenway22ndAve,09/26/2015 05:00:00 PM,48,-122,7,2,9
14538,58thStGreenway22ndAve,09/26/2015 06:00:00 PM,48,-122,3,3,6
14539,58thStGreenway22ndAve,09/26/2015 07:00:00 PM,48,-122,2,4,6
14540,58thStGreenway22ndAve,09/26/2015 08:00:00 PM,48,-122,1,0,1
14541,58thStGreenway22ndAve,09/26/2015 09:00:00 PM,48,-122,0,0,0
14542,58thStGreenway22ndAve,09/26/2015 10:00:00 PM,48,-122,3,3,6
14543,58thStGreenway22ndAve,09/26/2015 11:00:00 PM,48,-122,1,0,1
14544,58thStGreenway22ndAve,09/27/2015 12:00:00 AM,48,-122,1,0,1
14545,58thStGreenway22ndAve,09/27/2015 01:00:00 AM,48,-122,1,1,2
14546,58thStGreenway22ndAve,09/27/2015 02:00:00 AM,48,-122,0,0,0
14547,58thStGreenway22ndAve,09/27/2015 03:00:00 AM,48,-122,0,0,0
14548,58thStGreenway22ndAve,09/27/2015 04:00:00 AM,48,-122,0,0,0
14549,58thStGreenway22ndAve,09/27/2015 05:00:00 AM,48,-122,0,0,0
14550,58thStGreenway22ndAve,09/27/2015 06:00:00 AM,48,-122,0,0,0
14551,58thStGreenway22ndAve,09/27/2015 07:00:00 AM,48,-122,0,3,3
14552,58thStGreenway22ndAve,09/27/2015 08:00:00 AM,48,-122,3,3,6
14553,58thStGreenway22ndAve,09/27/2015 09:00:00 AM,48,-122,4,7,11
14554,58thStGreenway22ndAve,09/27/2015 10:00:00 AM,48,-122,7,9,16
14555,58thStGreenway22ndAve,09/27/2015 11:00:00 AM,48,-122,9,7,16
14556,58thStGreenway22ndAve,09/27/2015 12:00:00 PM,48,-122,13,7,20
14557,58thStGreenway22ndAve,09/27/2015 01:00:00 PM,48,-122,9,6,15
14558,58thStGreenway22ndAve,09/27/2015 02:00:00 PM,48,-122,6,5,11
14559,58thStGreenway22ndAve,09/27/2015 03:00:00 PM,48,-122,12,3,15
14560,58thStGreenway22ndAve,09/27/2015 04:00:00 PM,48,-122,3,5,8
14561,58thStGreenway22ndAve,09/27/2015 05:00:00 PM,48,-122,3,4,7
14562,58thStGreenway22ndAve,09/27/2015 06:00:00 PM,48,-122,3,1,4
14563,58thStGreenway22ndAve,09/27/2015 07:00:00 PM,48,-122,1,2,3
14564,58thStGreenway22ndAve,09/27/2015 08:00:00 PM,48,-122,4,2,6
14565,58thStGreenway22ndAve,09/27/2015 09:00:00 PM,48,-122,0,0,0
14566,58thStGreenway22ndAve,09/27/2015 10:00:00 PM,48,-122,0,0,0
14567,58thStGreenway22ndAve,09/27/2015 11:00:00 PM,48,-122,1,0,1
14568,58thStGreenway22ndAve,09/28/2015 12:00:00 AM,48,-122,0,0,0
14569,58thStGreenway22ndAve,09/28/2015 01:00:00 AM,48,-122,0,0,0
14570,58thStGreenway22ndAve,09/28/2015 02:00:00 AM,48,-122,0,0,0
14571,58thStGreenway22ndAve,09/28/2015 03:00:00 AM,48,-122,0,0,0
14572,58thStGreenway22ndAve,09/28/2015 04:00:00 AM,48,-122,0,0,0
14573,58thStGreenway22ndAve,09/28/2015 05:00:00 AM,48,-122,0,1,1
14574,58thStGreenway22ndAve,09/28/2015 06:00:00 AM,48,-122,0,1,1
14575,58thStGreenway22ndAve,09/28/2015 07:00:00 AM,48,-122,4,3,7
14576,58thStGreenway22ndAve,09/28/2015 08:00:00 AM,48,-122,4,2,6
14577,58thStGreenway22ndAve,09/28/2015 09:00:00 AM,48,-122,5,8,13
14578,58thStGreenway22ndAve,09/28/2015 10:00:00 AM,48,-122,3,3,6
14579,58thStGreenway22ndAve,09/28/2015 11:00:00 AM,48,-122,4,3,7
14580,58thStGreenway22ndAve,09/28/2015 12:00:00 PM,48,-122,6,6,12
14581,58thStGreenway22ndAve,09/28/2015 01:00:00 PM,48,-122,4,4,8
14582,58thStGreenway22ndAve,09/28/2015 02:00:00 PM,48,-122,3,7,10
14583,58thStGreenway22ndAve,09/28/2015 03:00:00 PM,48,-122,1,6,7
14584,58thStGreenway22ndAve,09/28/2015 04:00:00 PM,48,-122,7,2,9
14585,58thStGreenway22ndAve,09/28/2015 05:00:00 PM,48,-122,8,7,15
14586,58thStGreenway22ndAve,09/28/2015 06:00:00 PM,48,-122,9,9,18
14587,58thStGreenway22ndAve,09/28/2015 07:00:00 PM,48,-122,6,7,13
14588,58thStGreenway22ndAve,09/28/2015 08:00:00 PM,48,-122,4,4,8
14589,58thStGreenway22ndAve,09/28/2015 09:00:00 PM,48,-122,6,0,6
14590,58thStGreenway22ndAve,09/28/2015 10:00:00 PM,48,-122,1,0,1
14591,58thStGreenway22ndAve,09/28/2015 11:00:00 PM,48,-122,2,0,2
14592,58thStGreenway22ndAve,09/29/2015 12:00:00 AM,48,-122,1,0,1
14593,58thStGreenway22ndAve,09/29/2015 01:00:00 AM,48,-122,0,0,0
14594,58thStGreenway22ndAve,09/29/2015 02:00:00 AM,48,-122,0,0,0
14595,58thStGreenway22ndAve,09/29/2015 03:00:00 AM,48,-122,0,0,0
14596,58thStGreenway22ndAve,09/29/2015 04:00:00 AM,48,-122,0,0,0
14597,58thStGreenway22ndAve,09/29/2015 05:00:00 AM,48,-122,2,1,3
14598,58thStGreenway22ndAve,09/29/2015 06:00:00 AM,48,-122,0,2,2
14599,58thStGreenway22ndAve,09/29/2015 07:00:00 AM,48,-122,5,3,8
14600,58thStGreenway22ndAve,09/29/2015 08:00:00 AM,48,-122,11,7,18
14601,58thStGreenway22ndAve,09/29/2015 09:00:00 AM,48,-122,4,6,10
14602,58thStGreenway22ndAve,09/29/2015 10:00:00 AM,48,-122,4,3,7
14603,58thStGreenway22ndAve,09/29/2015 11:00:00 AM,48,-122,2,4,6
14604,58thStGreenway22ndAve,09/29/2015 12:00:00 PM,48,-122,3,4,7
14605,58thStGreenway22ndAve,09/29/2015 01:00:00 PM,48,-122,1,6,7
14606,58thStGreenway22ndAve,09/29/2015 02:00:00 PM,48,-122,6,7,13
14607,58thStGreenway22ndAve,09/29/2015 03:00:00 PM,48,-122,5,7,12
14608,58thStGreenway22ndAve,09/29/2015 04:00:00 PM,48,-122,4,8,12
14609,58thStGreenway22ndAve,09/29/2015 05:00:00 PM,48,-122,15,9,24
14610,58thStGreenway22ndAve,09/29/2015 06:00:00 PM,48,-122,6,10,16
14611,58thStGreenway22ndAve,09/29/2015 07:00:00 PM,48,-122,6,14,20
14612,58thStGreenway22ndAve,09/29/2015 08:00:00 PM,48,-122,3,1,4
14613,58thStGreenway22ndAve,09/29/2015 09:00:00 PM,48,-122,7,0,7
14614,58thStGreenway22ndAve,09/29/2015 10:00:00 PM,48,-122,0,1,1
14615,58thStGreenway22ndAve,09/29/2015 11:00:00 PM,48,-122,1,2,3
14616,58thStGreenway22ndAve,09/30/2015 12:00:00 AM,48,-122,2,0,2
14617,58thStGreenway22ndAve,09/30/2015 01:00:00 AM,48,-122,0,0,0
14618,58thStGreenway22ndAve,09/30/2015 02:00:00 AM,48,-122,0,1,1
14619,58thStGreenway22ndAve,09/30/2015 03:00:00 AM,48,-122,0,0,0
14620,58thStGreenway22ndAve,09/30/2015 04:00:00 AM,48,-122,0,0,0
14621,58thStGreenway22ndAve,09/30/2015 05:00:00 AM,48,-122,2,1,3
14622,58thStGreenway22ndAve,09/30/2015 06:00:00 AM,48,-122,0,2,2
14623,58thStGreenway22ndAve,09/30/2015 07:00:00 AM,48,-122,7,5,12
14624,58thStGreenway22ndAve,09/30/2015 08:00:00 AM,48,-122,8,1,9
14625,58thStGreenway22ndAve,09/30/2015 09:00:00 AM,48,-122,5,8,13
14626,58thStGreenway22ndAve,09/30/2015 10:00:00 AM,48,-122,1,7,8
14627,58thStGreenway22ndAve,09/30/2015 11:00:00 AM,48,-122,0,2,2
14628,58thStGreenway22ndAve,09/30/2015 12:00:00 PM,48,-122,9,4,13
14629,58thStGreenway22ndAve,09/30/2015 01:00:00 PM,48,-122,5,4,9
14630,58thStGreenway22ndAve,09/30/2015 02:00:00 PM,48,-122,3,3,6
14631,58thStGreenway22ndAve,09/30/2015 03:00:00 PM,48,-122,4,6,10
14632,58thStGreenway22ndAve,09/30/2015 04:00:00 PM,48,-122,7,1,8
14633,58thStGreenway22ndAve,09/30/2015 05:00:00 PM,48,-122,6,11,17
14634,58thStGreenway22ndAve,09/30/2015 06:00:00 PM,48,-122,7,13,20
14635,58thStGreenway22ndAve,09/30/2015 07:00:00 PM,48,-122,5,4,9
14636,58thStGreenway22ndAve,09/30/2015 08:00:00 PM,48,-122,3,3,6
14637,58thStGreenway22ndAve,09/30/2015 09:00:00 PM,48,-122,1,1,2
14638,58thStGreenway22ndAve,09/30/2015 10:00:00 PM,48,-122,2,1,3
14639,58thStGreenway22ndAve,09/30/2015 11:00:00 PM,48,-122,1,0,1
14640,58thStGreenway22ndAve,10/01/2015 12:00:00 AM,48,-122,0,0,0
14641,58thStGreenway22ndAve,10/01/2015 01:00:00 AM,48,-122,0,0,0
14642,58thStGreenway22ndAve,10/01/2015 02:00:00 AM,48,-122,0,0,0
14643,58thStGreenway22ndAve,10/01/2015 03:00:00 AM,48,-122,0,0,0
14644,58thStGreenway22ndAve,10/01/2015 04:00:00 AM,48,-122,0,2,2
14645,58thStGreenway22ndAve,10/01/2015 05:00:00 AM,48,-122,0,1,1
14646,58thStGreenway22ndAve,10/01/2015 06:00:00 AM,48,-122,1,5,6
14647,58thStGreenway22ndAve,10/01/2015 07:00:00 AM,48,-122,5,2,7
14648,58thStGreenway22ndAve,10/01/2015 08:00:00 AM,48,-122,8,5,13
14649,58thStGreenway22ndAve,10/01/2015 09:00:00 AM,48,-122,3,2,5
14650,58thStGreenway22ndAve,10/01/2015 10:00:00 AM,48,-122,3,3,6
14651,58thStGreenway22ndAve,10/01/2015 11:00:00 AM,48,-122,3,1,4
14652,58thStGreenway22ndAve,10/01/2015 12:00:00 PM,48,-122,1,2,3
14653,58thStGreenway22ndAve,10/01/2015 01:00:00 PM,48,-122,9,7,16
14654,58thStGreenway22ndAve,10/01/2015 02:00:00 PM,48,-122,5,4,9
14655,58thStGreenway22ndAve,10/01/2015 03:00:00 PM,48,-122,2,6,8
14656,58thStGreenway22ndAve,10/01/2015 04:00:00 PM,48,-122,6,8,14
14657,58thStGreenway22ndAve,10/01/2015 05:00:00 PM,48,-122,10,5,15
14658,58thStGreenway22ndAve,10/01/2015 06:00:00 PM,48,-122,8,5,13
14659,58thStGreenway22ndAve,10/01/2015 07:00:00 PM,48,-122,2,5,7
14660,58thStGreenway22ndAve,10/01/2015 08:00:00 PM,48,-122,2,3,5
14661,58thStGreenway22ndAve,10/01/2015 09:00:00 PM,48,-122,1,1,2
14662,58thStGreenway22ndAve,10/01/2015 10:00:00 PM,48,-122,0,0,0
14663,58thStGreenway22ndAve,10/01/2015 11:00:00 PM,48,-122,2,0,2
14664,58thStGreenway22ndAve,10/02/2015 12:00:00 AM,48,-122,0,1,1
14665,58thStGreenway22ndAve,10/02/2015 01:00:00 AM,48,-122,0,0,0
14666,58thStGreenway22ndAve,10/02/2015 02:00:00 AM,48,-122,3,1,4
14667,58thStGreenway22ndAve,10/02/2015 03:00:00 AM,48,-122,0,0,0
14668,58thStGreenway22ndAve,10/02/2015 04:00:00 AM,48,-122,0,0,0
14669,58thStGreenway22ndAve,10/02/2015 05:00:00 AM,48,-122,0,0,0
14670,58thStGreenway22ndAve,10/02/2015 06:00:00 AM,48,-122,1,1,2
14671,58thStGreenway22ndAve,10/02/2015 07:00:00 AM,48,-122,4,3,7
14672,58thStGreenway22ndAve,10/02/2015 08:00:00 AM,48,-122,4,2,6
14673,58thStGreenway22ndAve,10/02/2015 09:00:00 AM,48,-122,3,5,8
14674,58thStGreenway22ndAve,10/02/2015 10:00:00 AM,48,-122,2,1,3
14675,58thStGreenway22ndAve,10/02/2015 11:00:00 AM,48,-122,3,2,5
14676,58thStGreenway22ndAve,10/02/2015 12:00:00 PM,48,-122,5,6,11
14677,58thStGreenway22ndAve,10/02/2015 01:00:00 PM,48,-122,1,2,3
14678,58thStGreenway22ndAve,10/02/2015 02:00:00 PM,48,-122,0,3,3
14679,58thStGreenway22ndAve,10/02/2015 03:00:00 PM,48,-122,4,6,10
14680,58thStGreenway22ndAve,10/02/2015 04:00:00 PM,48,-122,4,10,14
14681,58thStGreenway22ndAve,10/02/2015 05:00:00 PM,48,-122,8,10,18
14682,58thStGreenway22ndAve,10/02/2015 06:00:00 PM,48,-122,9,10,19
14683,58thStGreenway22ndAve,10/02/2015 07:00:00 PM,48,-122,3,8,11
14684,58thStGreenway22ndAve,10/02/2015 08:00:00 PM,48,-122,2,3,5
14685,58thStGreenway22ndAve,10/02/2015 09:00:00 PM,48,-122,3,0,3
14686,58thStGreenway22ndAve,10/02/2015 10:00:00 PM,48,-122,3,0,3
14687,58thStGreenway22ndAve,10/02/2015 11:00:00 PM,48,-122,0,0,0
14688,58thStGreenway22ndAve,10/03/2015 12:00:00 AM,48,-122,0,1,1
14689,58thStGreenway22ndAve,10/03/2015 01:00:00 AM,48,-122,0,0,0
14690,58thStGreenway22ndAve,10/03/2015 02:00:00 AM,48,-122,0,0,0
14691,58thStGreenway22ndAve,10/03/2015 03:00:00 AM,48,-122,0,1,1
14692,58thStGreenway22ndAve,10/03/2015 04:00:00 AM,48,-122,0,0,0
14693,58thStGreenway22ndAve,10/03/2015 05:00:00 AM,48,-122,0,0,0
14694,58thStGreenway22ndAve,10/03/2015 06:00:00 AM,48,-122,1,0,1
14695,58thStGreenway22ndAve,10/03/2015 07:00:00 AM,48,-122,3,0,3
14696,58thStGreenway22ndAve,10/03/2015 08:00:00 AM,48,-122,1,1,2
14697,58thStGreenway22ndAve,10/03/2015 09:00:00 AM,48,-122,1,5,6
14698,58thStGreenway22ndAve,10/03/2015 10:00:00 AM,48,-122,5,5,10
14699,58thStGreenway22ndAve,10/03/2015 11:00:00 AM,48,-122,2,6,8
14700,58thStGreenway22ndAve,10/03/2015 12:00:00 PM,48,-122,6,8,14
14701,58thStGreenway22ndAve,10/03/2015 01:00:00 PM,48,-122,5,7,12
14702,58thStGreenway22ndAve,10/03/2015 02:00:00 PM,48,-122,3,4,7
14703,58thStGreenway22ndAve,10/03/2015 03:00:00 PM,48,-122,5,4,9
14704,58thStGreenway22ndAve,10/03/2015 04:00:00 PM,48,-122,12,5,17
14705,58thStGreenway22ndAve,10/03/2015 05:00:00 PM,48,-122,3,6,9
14706,58thStGreenway22ndAve,10/03/2015 06:00:00 PM,48,-122,4,4,8
14707,58thStGreenway22ndAve,10/03/2015 07:00:00 PM,48,-122,8,4,12
14708,58thStGreenway22ndAve,10/03/2015 08:00:00 PM,48,-122,0,1,1
14709,58thStGreenway22ndAve,10/03/2015 09:00:00 PM,48,-122,2,1,3
14710,58thStGreenway22ndAve,10/03/2015 10:00:00 PM,48,-122,0,0,0
14711,58thStGreenway22ndAve,10/03/2015 11:00:00 PM,48,-122,1,1,2
14712,58thStGreenway22ndAve,10/04/2015 12:00:00 AM,48,-122,3,0,3
14713,58thStGreenway22ndAve,10/04/2015 01:00:00 AM,48,-122,0,0,0
14714,58thStGreenway22ndAve,10/04/2015 02:00:00 AM,48,-122,0,1,1
14715,58thStGreenway22ndAve,10/04/2015 03:00:00 AM,48,-122,0,0,0
14716,58thStGreenway22ndAve,10/04/2015 04:00:00 AM,48,-122,1,0,1
14717,58thStGreenway22ndAve,10/04/2015 05:00:00 AM,48,-122,0,1,1
14718,58thStGreenway22ndAve,10/04/2015 06:00:00 AM,48,-122,0,3,3
14719,58thStGreenway22ndAve,10/04/2015 07:00:00 AM,48,-122,1,0,1
14720,58thStGreenway22ndAve,10/04/2015 08:00:00 AM,48,-122,0,3,3
14721,58thStGreenway22ndAve,10/04/2015 09:00:00 AM,48,-122,4,3,7
14722,58thStGreenway22ndAve,10/04/2015 10:00:00 AM,48,-122,9,13,22
14723,58thStGreenway22ndAve,10/04/2015 11:00:00 AM,48,-122,15,12,27
14724,58thStGreenway22ndAve,10/04/2015 12:00:00 PM,48,-122,13,12,25
14725,58thStGreenway22ndAve,10/04/2015 01:00:00 PM,48,-122,8,7,15
14726,58thStGreenway22ndAve,10/04/2015 02:00:00 PM,48,-122,7,11,18
14727,58thStGreenway22ndAve,10/04/2015 03:00:00 PM,48,-122,7,13,20
14728,58thStGreenway22ndAve,10/04/2015 04:00:00 PM,48,-122,14,4,18
14729,58thStGreenway22ndAve,10/04/2015 05:00:00 PM,48,-122,9,7,16
14730,58thStGreenway22ndAve,10/04/2015 06:00:00 PM,48,-122,4,3,7
14731,58thStGreenway22ndAve,10/04/2015 07:00:00 PM,48,-122,4,2,6
14732,58thStGreenway22ndAve,10/04/2015 08:00:00 PM,48,-122,3,0,3
14733,58thStGreenway22ndAve,10/04/2015 09:00:00 PM,48,-122,1,0,1
14734,58thStGreenway22ndAve,10/04/2015 10:00:00 PM,48,-122,0,2,2
14735,58thStGreenway22ndAve,10/04/2015 11:00:00 PM,48,-122,0,0,0
14736,58thStGreenway22ndAve,10/05/2015 12:00:00 AM,48,-122,0,0,0
14737,58thStGreenway22ndAve,10/05/2015 01:00:00 AM,48,-122,0,1,1
14738,58thStGreenway22ndAve,10/05/2015 02:00:00 AM,48,-122,0,1,1
14739,58thStGreenway22ndAve,10/05/2015 03:00:00 AM,48,-122,0,0,0
14740,58thStGreenway22ndAve,10/05/2015 04:00:00 AM,48,-122,0,0,0
14741,58thStGreenway22ndAve,10/05/2015 05:00:00 AM,48,-122,0,0,0
14742,58thStGreenway22ndAve,10/05/2015 06:00:00 AM,48,-122,0,2,2
14743,58thStGreenway22ndAve,10/05/2015 07:00:00 AM,48,-122,5,2,7
14744,58thStGreenway22ndAve,10/05/2015 08:00:00 AM,48,-122,6,3,9
14745,58thStGreenway22ndAve,10/05/2015 09:00:00 AM,48,-122,5,3,8
14746,58thStGreenway22ndAve,10/05/2015 10:00:00 AM,48,-122,5,3,8
14747,58thStGreenway22ndAve,10/05/2015 11:00:00 AM,48,-122,2,4,6
14748,58thStGreenway22ndAve,10/05/2015 12:00:00 PM,48,-122,2,4,6
14749,58thStGreenway22ndAve,10/05/2015 01:00:00 PM,48,-122,7,5,12
14750,58thStGreenway22ndAve,10/05/2015 02:00:00 PM,48,-122,12,8,20
14751,58thStGreenway22ndAve,10/05/2015 03:00:00 PM,48,-122,7,11,18
14752,58thStGreenway22ndAve,10/05/2015 04:00:00 PM,48,-122,11,9,20
14753,58thStGreenway22ndAve,10/05/2015 05:00:00 PM,48,-122,15,11,26
14754,58thStGreenway22ndAve,10/05/2015 06:00:00 PM,48,-122,5,7,12
14755,58thStGreenway22ndAve,10/05/2015 07:00:00 PM,48,-122,3,7,10
14756,58thStGreenway22ndAve,10/05/2015 08:00:00 PM,48,-122,8,2,10
14757,58thStGreenway22ndAve,10/05/2015 09:00:00 PM,48,-122,3,2,5
14758,58thStGreenway22ndAve,10/05/2015 10:00:00 PM,48,-122,3,6,9
14759,58thStGreenway22ndAve,10/05/2015 11:00:00 PM,48,-122,1,1,2
14760,58thStGreenway22ndAve,10/06/2015 12:00:00 AM,48,-122,0,0,0
14761,58thStGreenway22ndAve,10/06/2015 01:00:00 AM,48,-122,0,0,0
14762,58thStGreenway22ndAve,10/06/2015 02:00:00 AM,48,-122,2,0,2
14763,58thStGreenway22ndAve,10/06/2015 03:00:00 AM,48,-122,0,0,0
14764,58thStGreenway22ndAve,10/06/2015 04:00:00 AM,48,-122,0,0,0
14765,58thStGreenway22ndAve,10/06/2015 05:00:00 AM,48,-122,0,1,1
14766,58thStGreenway22ndAve,10/06/2015 06:00:00 AM,48,-122,0,2,2
14767,58thStGreenway22ndAve,10/06/2015 07:00:00 AM,48,-122,8,4,12
14768,58thStGreenway22ndAve,10/06/2015 08:00:00 AM,48,-122,5,6,11
14769,58thStGreenway22ndAve,10/06/2015 09:00:00 AM,48,-122,4,5,9
14770,58thStGreenway22ndAve,10/06/2015 10:00:00 AM,48,-122,6,2,8
14771,58thStGreenway22ndAve,10/06/2015 11:00:00 AM,48,-122,2,3,5
14772,58thStGreenway22ndAve,10/06/2015 12:00:00 PM,48,-122,3,2,5
14773,58thStGreenway22ndAve,10/06/2015 01:00:00 PM,48,-122,4,4,8
14774,58thStGreenway22ndAve,10/06/2015 02:00:00 PM,48,-122,3,3,6
14775,58thStGreenway22ndAve,10/06/2015 03:00:00 PM,48,-122,1,4,5
14776,58thStGreenway22ndAve,10/06/2015 04:00:00 PM,48,-122,10,3,13
14777,58thStGreenway22ndAve,10/06/2015 05:00:00 PM,48,-122,8,6,14
14778,58thStGreenway22ndAve,10/06/2015 06:00:00 PM,48,-122,5,7,12
14779,58thStGreenway22ndAve,10/06/2015 07:00:00 PM,48,-122,8,6,14
14780,58thStGreenway22ndAve,10/06/2015 08:00:00 PM,48,-122,7,5,12
14781,58thStGreenway22ndAve,10/06/2015 09:00:00 PM,48,-122,5,0,5
14782,58thStGreenway22ndAve,10/06/2015 10:00:00 PM,48,-122,0,2,2
14783,58thStGreenway22ndAve,10/06/2015 11:00:00 PM,48,-122,0,0,0
14784,58thStGreenway22ndAve,10/07/2015 12:00:00 AM,48,-122,0,1,1
14785,58thStGreenway22ndAve,10/07/2015 01:00:00 AM,48,-122,1,0,1
14786,58thStGreenway22ndAve,10/07/2015 02:00:00 AM,48,-122,0,0,0
14787,58thStGreenway22ndAve,10/07/2015 03:00:00 AM,48,-122,0,0,0
14788,58thStGreenway22ndAve,10/07/2015 04:00:00 AM,48,-122,0,0,0
14789,58thStGreenway22ndAve,10/07/2015 05:00:00 AM,48,-122,0,1,1
14790,58thStGreenway22ndAve,10/07/2015 06:00:00 AM,48,-122,0,2,2
14791,58thStGreenway22ndAve,10/07/2015 07:00:00 AM,48,-122,4,1,5
14792,58thStGreenway22ndAve,10/07/2015 08:00:00 AM,48,-122,8,1,9
14793,58thStGreenway22ndAve,10/07/2015 09:00:00 AM,48,-122,3,1,4
14794,58thStGreenway22ndAve,10/07/2015 10:00:00 AM,48,-122,0,1,1
14795,58thStGreenway22ndAve,10/07/2015 11:00:00 AM,48,-122,4,2,6
14796,58thStGreenway22ndAve,10/07/2015 12:00:00 PM,48,-122,0,1,1
14797,58thStGreenway22ndAve,10/07/2015 01:00:00 PM,48,-122,0,0,0
14798,58thStGreenway22ndAve,10/07/2015 02:00:00 PM,48,-122,1,0,1
14799,58thStGreenway22ndAve,10/07/2015 03:00:00 PM,48,-122,2,1,3
14800,58thStGreenway22ndAve,10/07/2015 04:00:00 PM,48,-122,2,1,3
14801,58thStGreenway22ndAve,10/07/2015 05:00:00 PM,48,-122,6,5,11
14802,58thStGreenway22ndAve,10/07/2015 06:00:00 PM,48,-122,1,8,9
14803,58thStGreenway22ndAve,10/07/2015 07:00:00 PM,48,-122,7,5,12
14804,58thStGreenway22ndAve,10/07/2015 08:00:00 PM,48,-122,2,1,3
14805,58thStGreenway22ndAve,10/07/2015 09:00:00 PM,48,-122,2,1,3
14806,58thStGreenway22ndAve,10/07/2015 10:00:00 PM,48,-122,0,0,0
14807,58thStGreenway22ndAve,10/07/2015 11:00:00 PM,48,-122,0,0,0
14808,58thStGreenway22ndAve,10/08/2015 12:00:00 AM,48,-122,0,0,0
14809,58thStGreenway22ndAve,10/08/2015 01:00:00 AM,48,-122,0,0,0
14810,58thStGreenway22ndAve,10/08/2015 02:00:00 AM,48,-122,0,0,0
14811,58thStGreenway22ndAve,10/08/2015 03:00:00 AM,48,-122,0,1,1
14812,58thStGreenway22ndAve,10/08/2015 04:00:00 AM,48,-122,0,0,0
14813,58thStGreenway22ndAve,10/08/2015 05:00:00 AM,48,-122,0,2,2
14814,58thStGreenway22ndAve,10/08/2015 06:00:00 AM,48,-122,1,2,3
14815,58thStGreenway22ndAve,10/08/2015 07:00:00 AM,48,-122,3,0,3
14816,58thStGreenway22ndAve,10/08/2015 08:00:00 AM,48,-122,5,2,7
14817,58thStGreenway22ndAve,10/08/2015 09:00:00 AM,48,-122,3,3,6
14818,58thStGreenway22ndAve,10/08/2015 10:00:00 AM,48,-122,3,2,5
14819,58thStGreenway22ndAve,10/08/2015 11:00:00 AM,48,-122,2,2,4
14820,58thStGreenway22ndAve,10/08/2015 12:00:00 PM,48,-122,4,7,11
14821,58thStGreenway22ndAve,10/08/2015 01:00:00 PM,48,-122,2,0,2
14822,58thStGreenway22ndAve,10/08/2015 02:00:00 PM,48,-122,2,6,8
14823,58thStGreenway22ndAve,10/08/2015 03:00:00 PM,48,-122,3,2,5
14824,58thStGreenway22ndAve,10/08/2015 04:00:00 PM,48,-122,5,7,12
14825,58thStGreenway22ndAve,10/08/2015 05:00:00 PM,48,-122,10,8,18
14826,58thStGreenway22ndAve,10/08/2015 06:00:00 PM,48,-122,13,4,17
14827,58thStGreenway22ndAve,10/08/2015 07:00:00 PM,48,-122,12,0,12
14828,58thStGreenway22ndAve,10/08/2015 08:00:00 PM,48,-122,7,0,7
14829,58thStGreenway22ndAve,10/08/2015 09:00:00 PM,48,-122,8,0,8
14830,58thStGreenway22ndAve,10/08/2015 10:00:00 PM,48,-122,3,0,3
14831,58thStGreenway22ndAve,10/08/2015 11:00:00 PM,48,-122,1,0,1
14832,58thStGreenway22ndAve,10/09/2015 12:00:00 AM,48,-122,1,0,1
14833,58thStGreenway22ndAve,10/09/2015 01:00:00 AM,48,-122,0,0,0
14834,58thStGreenway22ndAve,10/09/2015 02:00:00 AM,48,-122,1,0,1
14835,58thStGreenway22ndAve,10/09/2015 03:00:00 AM,48,-122,0,0,0
14836,58thStGreenway22ndAve,10/09/2015 04:00:00 AM,48,-122,0,0,0
14837,58thStGreenway22ndAve,10/09/2015 05:00:00 AM,48,-122,0,0,0
14838,58thStGreenway22ndAve,10/09/2015 06:00:00 AM,48,-122,3,0,3
14839,58thStGreenway22ndAve,10/09/2015 07:00:00 AM,48,-122,6,0,6
14840,58thStGreenway22ndAve,10/09/2015 08:00:00 AM,48,-122,4,6,10
14841,58thStGreenway22ndAve,10/09/2015 09:00:00 AM,48,-122,5,3,8
14842,58thStGreenway22ndAve,10/09/2015 10:00:00 AM,48,-122,3,4,7
14843,58thStGreenway22ndAve,10/09/2015 11:00:00 AM,48,-122,6,0,6
14844,58thStGreenway22ndAve,10/09/2015 12:00:00 PM,48,-122,2,1,3
14845,58thStGreenway22ndAve,10/09/2015 01:00:00 PM,48,-122,3,2,5
14846,58thStGreenway22ndAve,10/09/2015 02:00:00 PM,48,-122,1,3,4
14847,58thStGreenway22ndAve,10/09/2015 03:00:00 PM,48,-122,3,3,6
14848,58thStGreenway22ndAve,10/09/2015 04:00:00 PM,48,-122,7,5,12
14849,58thStGreenway22ndAve,10/09/2015 05:00:00 PM,48,-122,8,7,15
14850,58thStGreenway22ndAve,10/09/2015 06:00:00 PM,48,-122,6,9,15
14851,58thStGreenway22ndAve,10/09/2015 07:00:00 PM,48,-122,1,4,5
14852,58thStGreenway22ndAve,10/09/2015 08:00:00 PM,48,-122,2,2,4
14853,58thStGreenway22ndAve,10/09/2015 09:00:00 PM,48,-122,2,2,4
14854,58thStGreenway22ndAve,10/09/2015 10:00:00 PM,48,-122,1,1,2
14855,58thStGreenway22ndAve,10/09/2015 11:00:00 PM,48,-122,1,0,1
14856,58thStGreenway22ndAve,10/10/2015 12:00:00 AM,48,-122,2,0,2
14857,58thStGreenway22ndAve,10/10/2015 01:00:00 AM,48,-122,0,1,1
14858,58thStGreenway22ndAve,10/10/2015 02:00:00 AM,48,-122,0,0,0
14859,58thStGreenway22ndAve,10/10/2015 03:00:00 AM,48,-122,0,0,0
14860,58thStGreenway22ndAve,10/10/2015 04:00:00 AM,48,-122,0,0,0
14861,58thStGreenway22ndAve,10/10/2015 05:00:00 AM,48,-122,0,0,0
14862,58thStGreenway22ndAve,10/10/2015 06:00:00 AM,48,-122,0,0,0
14863,58thStGreenway22ndAve,10/10/2015 07:00:00 AM,48,-122,1,0,1
14864,58thStGreenway22ndAve,10/10/2015 08:00:00 AM,48,-122,2,2,4
14865,58thStGreenway22ndAve,10/10/2015 09:00:00 AM,48,-122,3,4,7
14866,58thStGreenway22ndAve,10/10/2015 10:00:00 AM,48,-122,2,0,2
14867,58thStGreenway22ndAve,10/10/2015 11:00:00 AM,48,-122,2,3,5
14868,58thStGreenway22ndAve,10/10/2015 12:00:00 PM,48,-122,4,2,6
14869,58thStGreenway22ndAve,10/10/2015 01:00:00 PM,48,-122,1,0,1
14870,58thStGreenway22ndAve,10/10/2015 02:00:00 PM,48,-122,1,4,5
14871,58thStGreenway22ndAve,10/10/2015 03:00:00 PM,48,-122,2,1,3
14872,58thStGreenway22ndAve,10/10/2015 04:00:00 PM,48,-122,3,2,5
14873,58thStGreenway22ndAve,10/10/2015 05:00:00 PM,48,-122,1,2,3
14874,58thStGreenway22ndAve,10/10/2015 06:00:00 PM,48,-122,5,5,10
14875,58thStGreenway22ndAve,10/10/2015 07:00:00 PM,48,-122,1,0,1
14876,58thStGreenway22ndAve,10/10/2015 08:00:00 PM,48,-122,2,0,2
14877,58thStGreenway22ndAve,10/10/2015 09:00:00 PM,48,-122,2,0,2
14878,58thStGreenway22ndAve,10/10/2015 10:00:00 PM,48,-122,1,0,1
14879,58thStGreenway22ndAve,10/10/2015 11:00:00 PM,48,-122,2,0,2
14880,58thStGreenway22ndAve,10/11/2015 12:00:00 AM,48,-122,4,0,4
14881,58thStGreenway22ndAve,10/11/2015 01:00:00 AM,48,-122,0,1,1
14882,58thStGreenway22ndAve,10/11/2015 02:00:00 AM,48,-122,0,1,1
14883,58thStGreenway22ndAve,10/11/2015 03:00:00 AM,48,-122,0,1,1
14884,58thStGreenway22ndAve,10/11/2015 04:00:00 AM,48,-122,0,0,0
14885,58thStGreenway22ndAve,10/11/2015 05:00:00 AM,48,-122,0,0,0
14886,58thStGreenway22ndAve,10/11/2015 06:00:00 AM,48,-122,0,0,0
14887,58thStGreenway22ndAve,10/11/2015 07:00:00 AM,48,-122,0,1,1
14888,58thStGreenway22ndAve,10/11/2015 08:00:00 AM,48,-122,1,4,5
14889,58thStGreenway22ndAve,10/11/2015 09:00:00 AM,48,-122,2,8,10
14890,58thStGreenway22ndAve,10/11/2015 10:00:00 AM,48,-122,8,7,15
14891,58thStGreenway22ndAve,10/11/2015 11:00:00 AM,48,-122,3,1,4
14892,58thStGreenway22ndAve,10/11/2015 12:00:00 PM,48,-122,7,7,14
14893,58thStGreenway22ndAve,10/11/2015 01:00:00 PM,48,-122,10,13,23
14894,58thStGreenway22ndAve,10/11/2015 02:00:00 PM,48,-122,9,8,17
14895,58thStGreenway22ndAve,10/11/2015 03:00:00 PM,48,-122,15,7,22
14896,58thStGreenway22ndAve,10/11/2015 04:00:00 PM,48,-122,12,7,19
14897,58thStGreenway22ndAve,10/11/2015 05:00:00 PM,48,-122,1,5,6
14898,58thStGreenway22ndAve,10/11/2015 06:00:00 PM,48,-122,6,4,10
14899,58thStGreenway22ndAve,10/11/2015 07:00:00 PM,48,-122,1,2,3
14900,58thStGreenway22ndAve,10/11/2015 08:00:00 PM,48,-122,2,3,5
14901,58thStGreenway22ndAve,10/11/2015 09:00:00 PM,48,-122,0,1,1
14902,58thStGreenway22ndAve,10/11/2015 10:00:00 PM,48,-122,0,1,1
14903,58thStGreenway22ndAve,10/11/2015 11:00:00 PM,48,-122,0,0,0
14904,58thStGreenway22ndAve,10/12/2015 12:00:00 AM,48,-122,0,0,0
14905,58thStGreenway22ndAve,10/12/2015 01:00:00 AM,48,-122,0,0,0
14906,58thStGreenway22ndAve,10/12/2015 02:00:00 AM,48,-122,0,0,0
14907,58thStGreenway22ndAve,10/12/2015 03:00:00 AM,48,-122,0,0,0
14908,58thStGreenway22ndAve,10/12/2015 04:00:00 AM,48,-122,0,0,0
14909,58thStGreenway22ndAve,10/12/2015 05:00:00 AM,48,-122,0,0,0
14910,58thStGreenway22ndAve,10/12/2015 06:00:00 AM,48,-122,0,1,1
14911,58thStGreenway22ndAve,10/12/2015 07:00:00 AM,48,-122,2,2,4
14912,58thStGreenway22ndAve,10/12/2015 08:00:00 AM,48,-122,5,3,8
14913,58thStGreenway22ndAve,10/12/2015 09:00:00 AM,48,-122,5,3,8
14914,58thStGreenway22ndAve,10/12/2015 10:00:00 AM,48,-122,2,4,6
14915,58thStGreenway22ndAve,10/12/2015 11:00:00 AM,48,-122,0,3,3
14916,58thStGreenway22ndAve,10/12/2015 12:00:00 PM,48,-122,3,2,5
14917,58thStGreenway22ndAve,10/12/2015 01:00:00 PM,48,-122,1,2,3
14918,58thStGreenway22ndAve,10/12/2015 02:00:00 PM,48,-122,6,6,12
14919,58thStGreenway22ndAve,10/12/2015 03:00:00 PM,48,-122,3,2,5
14920,58thStGreenway22ndAve,10/12/2015 04:00:00 PM,48,-122,3,3,6
14921,58thStGreenway22ndAve,10/12/2015 05:00:00 PM,48,-122,5,4,9
14922,58thStGreenway22ndAve,10/12/2015 06:00:00 PM,48,-122,4,3,7
14923,58thStGreenway22ndAve,10/12/2015 07:00:00 PM,48,-122,0,3,3
14924,58thStGreenway22ndAve,10/12/2015 08:00:00 PM,48,-122,4,1,5
14925,58thStGreenway22ndAve,10/12/2015 09:00:00 PM,48,-122,0,0,0
14926,58thStGreenway22ndAve,10/12/2015 10:00:00 PM,48,-122,1,2,3
14927,58thStGreenway22ndAve,10/12/2015 11:00:00 PM,48,-122,0,1,1
14928,58thStGreenway22ndAve,10/13/2015 12:00:00 AM,48,-122,0,0,0
14929,58thStGreenway22ndAve,10/13/2015 01:00:00 AM,48,-122,0,0,0
14930,58thStGreenway22ndAve,10/13/2015 02:00:00 AM,48,-122,0,0,0
14931,58thStGreenway22ndAve,10/13/2015 03:00:00 AM,48,-122,0,0,0
14932,58thStGreenway22ndAve,10/13/2015 04:00:00 AM,48,-122,0,0,0
14933,58thStGreenway22ndAve,10/13/2015 05:00:00 AM,48,-122,0,1,1
14934,58thStGreenway22ndAve,10/13/2015 06:00:00 AM,48,-122,2,0,2
14935,58thStGreenway22ndAve,10/13/2015 07:00:00 AM,48,-122,6,4,10
14936,58thStGreenway22ndAve,10/13/2015 08:00:00 AM,48,-122,6,5,11
14937,58thStGreenway22ndAve,10/13/2015 09:00:00 AM,48,-122,3,5,8
14938,58thStGreenway22ndAve,10/13/2015 10:00:00 AM,48,-122,3,1,4
14939,58thStGreenway22ndAve,10/13/2015 11:00:00 AM,48,-122,4,4,8
14940,58thStGreenway22ndAve,10/13/2015 12:00:00 PM,48,-122,12,7,19
14941,58thStGreenway22ndAve,10/13/2015 01:00:00 PM,48,-122,4,2,6
14942,58thStGreenway22ndAve,10/13/2015 02:00:00 PM,48,-122,2,5,7
14943,58thStGreenway22ndAve,10/13/2015 03:00:00 PM,48,-122,3,5,8
14944,58thStGreenway22ndAve,10/13/2015 04:00:00 PM,48,-122,5,3,8
14945,58thStGreenway22ndAve,10/13/2015 05:00:00 PM,48,-122,10,15,25
14946,58thStGreenway22ndAve,10/13/2015 06:00:00 PM,48,-122,7,6,13
14947,58thStGreenway22ndAve,10/13/2015 07:00:00 PM,48,-122,6,6,12
14948,58thStGreenway22ndAve,10/13/2015 08:00:00 PM,48,-122,3,0,3
14949,58thStGreenway22ndAve,10/13/2015 09:00:00 PM,48,-122,4,2,6
14950,58thStGreenway22ndAve,10/13/2015 10:00:00 PM,48,-122,5,0,5
14951,58thStGreenway22ndAve,10/13/2015 11:00:00 PM,48,-122,1,1,2
14952,58thStGreenway22ndAve,10/14/2015 12:00:00 AM,48,-122,0,0,0
14953,58thStGreenway22ndAve,10/14/2015 01:00:00 AM,48,-122,0,0,0
14954,58thStGreenway22ndAve,10/14/2015 02:00:00 AM,48,-122,0,0,0
14955,58thStGreenway22ndAve,10/14/2015 03:00:00 AM,48,-122,0,0,0
14956,58thStGreenway22ndAve,10/14/2015 04:00:00 AM,48,-122,0,0,0
14957,58thStGreenway22ndAve,10/14/2015 05:00:00 AM,48,-122,0,1,1
14958,58thStGreenway22ndAve,10/14/2015 06:00:00 AM,48,-122,0,1,1
14959,58thStGreenway22ndAve,10/14/2015 07:00:00 AM,48,-122,7,3,10
14960,58thStGreenway22ndAve,10/14/2015 08:00:00 AM,48,-122,9,5,14
14961,58thStGreenway22ndAve,10/14/2015 09:00:00 AM,48,-122,8,3,11
14962,58thStGreenway22ndAve,10/14/2015 10:00:00 AM,48,-122,2,5,7
14963,58thStGreenway22ndAve,10/14/2015 11:00:00 AM,48,-122,2,2,4
14964,58thStGreenway22ndAve,10/14/2015 12:00:00 PM,48,-122,4,5,9
14965,58thStGreenway22ndAve,10/14/2015 01:00:00 PM,48,-122,1,0,1
14966,58thStGreenway22ndAve,10/14/2015 02:00:00 PM,48,-122,6,5,11
14967,58thStGreenway22ndAve,10/14/2015 03:00:00 PM,48,-122,2,6,8
14968,58thStGreenway22ndAve,10/14/2015 04:00:00 PM,48,-122,2,1,3
14969,58thStGreenway22ndAve,10/14/2015 05:00:00 PM,48,-122,8,5,13
14970,58thStGreenway22ndAve,10/14/2015 06:00:00 PM,48,-122,5,14,19
14971,58thStGreenway22ndAve,10/14/2015 07:00:00 PM,48,-122,3,4,7
14972,58thStGreenway22ndAve,10/14/2015 08:00:00 PM,48,-122,7,1,8
14973,58thStGreenway22ndAve,10/14/2015 09:00:00 PM,48,-122,3,0,3
14974,58thStGreenway22ndAve,10/14/2015 10:00:00 PM,48,-122,0,2,2
14975,58thStGreenway22ndAve,10/14/2015 11:00:00 PM,48,-122,1,2,3
14976,58thStGreenway22ndAve,10/15/2015 12:00:00 AM,48,-122,0,0,0
14977,58thStGreenway22ndAve,10/15/2015 01:00:00 AM,48,-122,0,0,0
14978,58thStGreenway22ndAve,10/15/2015 02:00:00 AM,48,-122,0,0,0
14979,58thStGreenway22ndAve,10/15/2015 03:00:00 AM,48,-122,0,0,0
14980,58thStGreenway22ndAve,10/15/2015 04:00:00 AM,48,-122,0,0,0
14981,58thStGreenway22ndAve,10/15/2015 05:00:00 AM,48,-122,0,1,1
14982,58thStGreenway22ndAve,10/15/2015 06:00:00 AM,48,-122,0,1,1
14983,58thStGreenway22ndAve,10/15/2015 07:00:00 AM,48,-122,7,6,13
14984,58thStGreenway22ndAve,10/15/2015 08:00:00 AM,48,-122,6,4,10
14985,58thStGreenway22ndAve,10/15/2015 09:00:00 AM,48,-122,5,2,7
14986,58thStGreenway22ndAve,10/15/2015 10:00:00 AM,48,-122,7,2,9
14987,58thStGreenway22ndAve,10/15/2015 11:00:00 AM,48,-122,5,3,8
14988,58thStGreenway22ndAve,10/15/2015 12:00:00 PM,48,-122,5,5,10
14989,58thStGreenway22ndAve,10/15/2015 01:00:00 PM,48,-122,9,6,15
14990,58thStGreenway22ndAve,10/15/2015 02:00:00 PM,48,-122,4,3,7
14991,58thStGreenway22ndAve,10/15/2015 03:00:00 PM,48,-122,3,4,7
14992,58thStGreenway22ndAve,10/15/2015 04:00:00 PM,48,-122,8,9,17
14993,58thStGreenway22ndAve,10/15/2015 05:00:00 PM,48,-122,7,9,16
14994,58thStGreenway22ndAve,10/15/2015 06:00:00 PM,48,-122,6,6,12
14995,58thStGreenway22ndAve,10/15/2015 07:00:00 PM,48,-122,8,7,15
14996,58thStGreenway22ndAve,10/15/2015 08:00:00 PM,48,-122,1,3,4
14997,58thStGreenway22ndAve,10/15/2015 09:00:00 PM,48,-122,3,1,4
14998,58thStGreenway22ndAve,10/15/2015 10:00:00 PM,48,-122,2,0,2
14999,58thStGreenway22ndAve,10/15/2015 11:00:00 PM,48,-122,0,0,0
15000,58thStGreenway22ndAve,10/16/2015 12:00:00 AM,48,-122,0,0,0
15001,58thStGreenway22ndAve,10/16/2015 01:00:00 AM,48,-122,1,0,1
15002,58thStGreenway22ndAve,10/16/2015 02:00:00 AM,48,-122,0,0,0
15003,58thStGreenway22ndAve,10/16/2015 03:00:00 AM,48,-122,0,0,0
15004,58thStGreenway22ndAve,10/16/2015 04:00:00 AM,48,-122,0,0,0
15005,58thStGreenway22ndAve,10/16/2015 05:00:00 AM,48,-122,0,1,1
15006,58thStGreenway22ndAve,10/16/2015 06:00:00 AM,48,-122,0,0,0
15007,58thStGreenway22ndAve,10/16/2015 07:00:00 AM,48,-122,4,0,4
15008,58thStGreenway22ndAve,10/16/2015 08:00:00 AM,48,-122,4,7,11
15009,58thStGreenway22ndAve,10/16/2015 09:00:00 AM,48,-122,10,3,13
15010,58thStGreenway22ndAve,10/16/2015 10:00:00 AM,48,-122,6,7,13
15011,58thStGreenway22ndAve,10/16/2015 11:00:00 AM,48,-122,6,1,7
15012,58thStGreenway22ndAve,10/16/2015 12:00:00 PM,48,-122,1,2,3
15013,58thStGreenway22ndAve,10/16/2015 01:00:00 PM,48,-122,3,3,6
15014,58thStGreenway22ndAve,10/16/2015 02:00:00 PM,48,-122,4,6,10
15015,58thStGreenway22ndAve,10/16/2015 03:00:00 PM,48,-122,5,6,11
15016,58thStGreenway22ndAve,10/16/2015 04:00:00 PM,48,-122,10,6,16
15017,58thStGreenway22ndAve,10/16/2015 05:00:00 PM,48,-122,11,13,24
15018,58thStGreenway22ndAve,10/16/2015 06:00:00 PM,48,-122,9,7,16
15019,58thStGreenway22ndAve,10/16/2015 07:00:00 PM,48,-122,4,6,10
15020,58thStGreenway22ndAve,10/16/2015 08:00:00 PM,48,-122,6,2,8
15021,58thStGreenway22ndAve,10/16/2015 09:00:00 PM,48,-122,1,0,1
15022,58thStGreenway22ndAve,10/16/2015 10:00:00 PM,48,-122,4,1,5
15023,58thStGreenway22ndAve,10/16/2015 11:00:00 PM,48,-122,2,0,2
15024,58thStGreenway22ndAve,10/17/2015 12:00:00 AM,48,-122,0,1,1
15025,58thStGreenway22ndAve,10/17/2015 01:00:00 AM,48,-122,0,0,0
15026,58thStGreenway22ndAve,10/17/2015 02:00:00 AM,48,-122,0,0,0
15027,58thStGreenway22ndAve,10/17/2015 03:00:00 AM,48,-122,0,0,0
15028,58thStGreenway22ndAve,10/17/2015 04:00:00 AM,48,-122,2,1,3
15029,58thStGreenway22ndAve,10/17/2015 05:00:00 AM,48,-122,0,0,0
15030,58thStGreenway22ndAve,10/17/2015 06:00:00 AM,48,-122,0,1,1
15031,58thStGreenway22ndAve,10/17/2015 07:00:00 AM,48,-122,0,0,0
15032,58thStGreenway22ndAve,10/17/2015 08:00:00 AM,48,-122,2,3,5
15033,58thStGreenway22ndAve,10/17/2015 09:00:00 AM,48,-122,7,2,9
15034,58thStGreenway22ndAve,10/17/2015 10:00:00 AM,48,-122,13,7,20
15035,58thStGreenway22ndAve,10/17/2015 11:00:00 AM,48,-122,5,13,18
15036,58thStGreenway22ndAve,10/17/2015 12:00:00 PM,48,-122,9,9,18
15037,58thStGreenway22ndAve,10/17/2015 01:00:00 PM,48,-122,10,12,22
15038,58thStGreenway22ndAve,10/17/2015 02:00:00 PM,48,-122,9,6,15
15039,58thStGreenway22ndAve,10/17/2015 03:00:00 PM,48,-122,8,2,10
15040,58thStGreenway22ndAve,10/17/2015 04:00:00 PM,48,-122,4,7,11
15041,58thStGreenway22ndAve,10/17/2015 05:00:00 PM,48,-122,9,3,12
15042,58thStGreenway22ndAve,10/17/2015 06:00:00 PM,48,-122,1,4,5
15043,58thStGreenway22ndAve,10/17/2015 07:00:00 PM,48,-122,1,0,1
15044,58thStGreenway22ndAve,10/17/2015 08:00:00 PM,48,-122,1,1,2
15045,58thStGreenway22ndAve,10/17/2015 09:00:00 PM,48,-122,1,2,3
15046,58thStGreenway22ndAve,10/17/2015 10:00:00 PM,48,-122,1,1,2
15047,58thStGreenway22ndAve,10/17/2015 11:00:00 PM,48,-122,0,0,0
15048,58thStGreenway22ndAve,10/18/2015 12:00:00 AM,48,-122,0,0,0
15049,58thStGreenway22ndAve,10/18/2015 01:00:00 AM,48,-122,0,0,0
15050,58thStGreenway22ndAve,10/18/2015 02:00:00 AM,48,-122,0,1,1
15051,58thStGreenway22ndAve,10/18/2015 03:00:00 AM,48,-122,0,3,3
15052,58thStGreenway22ndAve,10/18/2015 04:00:00 AM,48,-122,0,1,1
15053,58thStGreenway22ndAve,10/18/2015 05:00:00 AM,48,-122,0,1,1
15054,58thStGreenway22ndAve,10/18/2015 06:00:00 AM,48,-122,0,0,0
15055,58thStGreenway22ndAve,10/18/2015 07:00:00 AM,48,-122,0,0,0
15056,58thStGreenway22ndAve,10/18/2015 08:00:00 AM,48,-122,1,0,1
15057,58thStGreenway22ndAve,10/18/2015 09:00:00 AM,48,-122,3,4,7
15058,58thStGreenway22ndAve,10/18/2015 10:00:00 AM,48,-122,3,3,6
15059,58thStGreenway22ndAve,10/18/2015 11:00:00 AM,48,-122,2,5,7
15060,58thStGreenway22ndAve,10/18/2015 12:00:00 PM,48,-122,9,4,13
15061,58thStGreenway22ndAve,10/18/2015 01:00:00 PM,48,-122,1,7,8
15062,58thStGreenway22ndAve,10/18/2015 02:00:00 PM,48,-122,3,5,8
15063,58thStGreenway22ndAve,10/18/2015 03:00:00 PM,48,-122,2,1,3
15064,58thStGreenway22ndAve,10/18/2015 04:00:00 PM,48,-122,5,8,13
15065,58thStGreenway22ndAve,10/18/2015 05:00:00 PM,48,-122,0,3,3
15066,58thStGreenway22ndAve,10/18/2015 06:00:00 PM,48,-122,5,3,8
15067,58thStGreenway22ndAve,10/18/2015 07:00:00 PM,48,-122,4,4,8
15068,58thStGreenway22ndAve,10/18/2015 08:00:00 PM,48,-122,0,3,3
15069,58thStGreenway22ndAve,10/18/2015 09:00:00 PM,48,-122,1,0,1
15070,58thStGreenway22ndAve,10/18/2015 10:00:00 PM,48,-122,0,0,0
15071,58thStGreenway22ndAve,10/18/2015 11:00:00 PM,48,-122,0,2,2
15072,58thStGreenway22ndAve,10/19/2015 12:00:00 AM,48,-122,0,0,0
15073,58thStGreenway22ndAve,10/19/2015 01:00:00 AM,48,-122,0,0,0
15074,58thStGreenway22ndAve,10/19/2015 02:00:00 AM,48,-122,0,0,0
15075,58thStGreenway22ndAve,10/19/2015 03:00:00 AM,48,-122,0,2,2
15076,58thStGreenway22ndAve,10/19/2015 04:00:00 AM,48,-122,0,0,0
15077,58thStGreenway22ndAve,10/19/2015 05:00:00 AM,48,-122,1,1,2
15078,58thStGreenway22ndAve,10/19/2015 06:00:00 AM,48,-122,1,3,4
15079,58thStGreenway22ndAve,10/19/2015 07:00:00 AM,48,-122,5,2,7
15080,58thStGreenway22ndAve,10/19/2015 08:00:00 AM,48,-122,4,2,6
15081,58thStGreenway22ndAve,10/19/2015 09:00:00 AM,48,-122,7,3,10
15082,58thStGreenway22ndAve,10/19/2015 10:00:00 AM,48,-122,5,5,10
15083,58thStGreenway22ndAve,10/19/2015 11:00:00 AM,48,-122,3,5,8
15084,58thStGreenway22ndAve,10/19/2015 12:00:00 PM,48,-122,5,5,10
15085,58thStGreenway22ndAve,10/19/2015 01:00:00 PM,48,-122,4,1,5
15086,58thStGreenway22ndAve,10/19/2015 02:00:00 PM,48,-122,4,5,9
15087,58thStGreenway22ndAve,10/19/2015 03:00:00 PM,48,-122,0,3,3
15088,58thStGreenway22ndAve,10/19/2015 04:00:00 PM,48,-122,13,4,17
15089,58thStGreenway22ndAve,10/19/2015 05:00:00 PM,48,-122,3,2,5
15090,58thStGreenway22ndAve,10/19/2015 06:00:00 PM,48,-122,3,6,9
15091,58thStGreenway22ndAve,10/19/2015 07:00:00 PM,48,-122,2,4,6
15092,58thStGreenway22ndAve,10/19/2015 08:00:00 PM,48,-122,1,0,1
15093,58thStGreenway22ndAve,10/19/2015 09:00:00 PM,48,-122,4,0,4
15094,58thStGreenway22ndAve,10/19/2015 10:00:00 PM,48,-122,0,1,1
15095,58thStGreenway22ndAve,10/19/2015 11:00:00 PM,48,-122,0,0,0
15096,58thStGreenway22ndAve,10/20/2015 12:00:00 AM,48,-122,0,0,0
15097,58thStGreenway22ndAve,10/20/2015 01:00:00 AM,48,-122,0,1,1
15098,58thStGreenway22ndAve,10/20/2015 02:00:00 AM,48,-122,0,0,0
15099,58thStGreenway22ndAve,10/20/2015 03:00:00 AM,48,-122,0,0,0
15100,58thStGreenway22ndAve,10/20/2015 04:00:00 AM,48,-122,0,0,0
15101,58thStGreenway22ndAve,10/20/2015 05:00:00 AM,48,-122,0,1,1
15102,58thStGreenway22ndAve,10/20/2015 06:00:00 AM,48,-122,1,3,4
15103,58thStGreenway22ndAve,10/20/2015 07:00:00 AM,48,-122,7,1,8
15104,58thStGreenway22ndAve,10/20/2015 08:00:00 AM,48,-122,10,8,18
15105,58thStGreenway22ndAve,10/20/2015 09:00:00 AM,48,-122,5,6,11
15106,58thStGreenway22ndAve,10/20/2015 10:00:00 AM,48,-122,0,3,3
15107,58thStGreenway22ndAve,10/20/2015 11:00:00 AM,48,-122,7,7,14
15108,58thStGreenway22ndAve,10/20/2015 12:00:00 PM,48,-122,5,4,9
15109,58thStGreenway22ndAve,10/20/2015 01:00:00 PM,48,-122,6,6,12
15110,58thStGreenway22ndAve,10/20/2015 02:00:00 PM,48,-122,2,2,4
15111,58thStGreenway22ndAve,10/20/2015 03:00:00 PM,48,-122,3,2,5
15112,58thStGreenway22ndAve,10/20/2015 04:00:00 PM,48,-122,14,4,18
15113,58thStGreenway22ndAve,10/20/2015 05:00:00 PM,48,-122,13,9,22
15114,58thStGreenway22ndAve,10/20/2015 06:00:00 PM,48,-122,3,10,13
15115,58thStGreenway22ndAve,10/20/2015 07:00:00 PM,48,-122,9,9,18
15116,58thStGreenway22ndAve,10/20/2015 08:00:00 PM,48,-122,1,1,2
15117,58thStGreenway22ndAve,10/20/2015 09:00:00 PM,48,-122,3,0,3
15118,58thStGreenway22ndAve,10/20/2015 10:00:00 PM,48,-122,1,1,2
15119,58thStGreenway22ndAve,10/20/2015 11:00:00 PM,48,-122,0,0,0
15120,58thStGreenway22ndAve,10/21/2015 12:00:00 AM,48,-122,0,0,0
15121,58thStGreenway22ndAve,10/21/2015 01:00:00 AM,48,-122,0,0,0
15122,58thStGreenway22ndAve,10/21/2015 02:00:00 AM,48,-122,0,0,0
15123,58thStGreenway22ndAve,10/21/2015 03:00:00 AM,48,-122,0,0,0
15124,58thStGreenway22ndAve,10/21/2015 04:00:00 AM,48,-122,0,0,0
15125,58thStGreenway22ndAve,10/21/2015 05:00:00 AM,48,-122,0,0,0
15126,58thStGreenway22ndAve,10/21/2015 06:00:00 AM,48,-122,0,2,2
15127,58thStGreenway22ndAve,10/21/2015 07:00:00 AM,48,-122,6,2,8
15128,58thStGreenway22ndAve,10/21/2015 08:00:00 AM,48,-122,3,4,7
15129,58thStGreenway22ndAve,10/21/2015 09:00:00 AM,48,-122,3,5,8
15130,58thStGreenway22ndAve,10/21/2015 10:00:00 AM,48,-122,2,4,6
15131,58thStGreenway22ndAve,10/21/2015 11:00:00 AM,48,-122,3,2,5
15132,58thStGreenway22ndAve,10/21/2015 12:00:00 PM,48,-122,3,3,6
15133,58thStGreenway22ndAve,10/21/2015 01:00:00 PM,48,-122,5,1,6
15134,58thStGreenway22ndAve,10/21/2015 02:00:00 PM,48,-122,9,2,11
15135,58thStGreenway22ndAve,10/21/2015 03:00:00 PM,48,-122,7,3,10
15136,58thStGreenway22ndAve,10/21/2015 04:00:00 PM,48,-122,4,1,5
15137,58thStGreenway22ndAve,10/21/2015 05:00:00 PM,48,-122,5,9,14
15138,58thStGreenway22ndAve,10/21/2015 06:00:00 PM,48,-122,6,8,14
15139,58thStGreenway22ndAve,10/21/2015 07:00:00 PM,48,-122,5,3,8
15140,58thStGreenway22ndAve,10/21/2015 08:00:00 PM,48,-122,1,1,2
15141,58thStGreenway22ndAve,10/21/2015 09:00:00 PM,48,-122,0,2,2
15142,58thStGreenway22ndAve,10/21/2015 10:00:00 PM,48,-122,0,1,1
15143,58thStGreenway22ndAve,10/21/2015 11:00:00 PM,48,-122,0,3,3
15144,58thStGreenway22ndAve,10/22/2015 12:00:00 AM,48,-122,0,0,0
15145,58thStGreenway22ndAve,10/22/2015 01:00:00 AM,48,-122,0,0,0
15146,58thStGreenway22ndAve,10/22/2015 02:00:00 AM,48,-122,0,0,0
15147,58thStGreenway22ndAve,10/22/2015 03:00:00 AM,48,-122,0,0,0
15148,58thStGreenway22ndAve,10/22/2015 04:00:00 AM,48,-122,1,0,1
15149,58thStGreenway22ndAve,10/22/2015 05:00:00 AM,48,-122,0,0,0
15150,58thStGreenway22ndAve,10/22/2015 06:00:00 AM,48,-122,1,5,6
15151,58thStGreenway22ndAve,10/22/2015 07:00:00 AM,48,-122,4,2,6
15152,58thStGreenway22ndAve,10/22/2015 08:00:00 AM,48,-122,6,7,13
15153,58thStGreenway22ndAve,10/22/2015 09:00:00 AM,48,-122,5,1,6
15154,58thStGreenway22ndAve,10/22/2015 10:00:00 AM,48,-122,6,1,7
15155,58thStGreenway22ndAve,10/22/2015 11:00:00 AM,48,-122,1,2,3
15156,58thStGreenway22ndAve,10/22/2015 12:00:00 PM,48,-122,3,4,7
15157,58thStGreenway22ndAve,10/22/2015 01:00:00 PM,48,-122,2,2,4
15158,58thStGreenway22ndAve,10/22/2015 02:00:00 PM,48,-122,5,5,10
15159,58thStGreenway22ndAve,10/22/2015 03:00:00 PM,48,-122,7,3,10
15160,58thStGreenway22ndAve,10/22/2015 04:00:00 PM,48,-122,3,7,10
15161,58thStGreenway22ndAve,10/22/2015 05:00:00 PM,48,-122,7,13,20
15162,58thStGreenway22ndAve,10/22/2015 06:00:00 PM,48,-122,6,4,10
15163,58thStGreenway22ndAve,10/22/2015 07:00:00 PM,48,-122,3,1,4
15164,58thStGreenway22ndAve,10/22/2015 08:00:00 PM,48,-122,4,4,8
15165,58thStGreenway22ndAve,10/22/2015 09:00:00 PM,48,-122,2,1,3
15166,58thStGreenway22ndAve,10/22/2015 10:00:00 PM,48,-122,2,0,2
15167,58thStGreenway22ndAve,10/22/2015 11:00:00 PM,48,-122,0,1,1
15168,58thStGreenway22ndAve,10/23/2015 12:00:00 AM,48,-122,1,0,1
15169,58thStGreenway22ndAve,10/23/2015 01:00:00 AM,48,-122,1,0,1
15170,58thStGreenway22ndAve,10/23/2015 02:00:00 AM,48,-122,0,1,1
15171,58thStGreenway22ndAve,10/23/2015 03:00:00 AM,48,-122,0,1,1
15172,58thStGreenway22ndAve,10/23/2015 04:00:00 AM,48,-122,1,1,2
15173,58thStGreenway22ndAve,10/23/2015 05:00:00 AM,48,-122,0,0,0
15174,58thStGreenway22ndAve,10/23/2015 06:00:00 AM,48,-122,2,2,4
15175,58thStGreenway22ndAve,10/23/2015 07:00:00 AM,48,-122,4,2,6
15176,58thStGreenway22ndAve,10/23/2015 08:00:00 AM,48,-122,7,4,11
15177,58thStGreenway22ndAve,10/23/2015 09:00:00 AM,48,-122,4,4,8
15178,58thStGreenway22ndAve,10/23/2015 10:00:00 AM,48,-122,2,3,5
15179,58thStGreenway22ndAve,10/23/2015 11:00:00 AM,48,-122,7,2,9
15180,58thStGreenway22ndAve,10/23/2015 12:00:00 PM,48,-122,2,3,5
15181,58thStGreenway22ndAve,10/23/2015 01:00:00 PM,48,-122,3,3,6
15182,58thStGreenway22ndAve,10/23/2015 02:00:00 PM,48,-122,3,5,8
15183,58thStGreenway22ndAve,10/23/2015 03:00:00 PM,48,-122,2,2,4
15184,58thStGreenway22ndAve,10/23/2015 04:00:00 PM,48,-122,3,3,6
15185,58thStGreenway22ndAve,10/23/2015 05:00:00 PM,48,-122,10,8,18
15186,58thStGreenway22ndAve,10/23/2015 06:00:00 PM,48,-122,7,3,10
15187,58thStGreenway22ndAve,10/23/2015 07:00:00 PM,48,-122,3,3,6
15188,58thStGreenway22ndAve,10/23/2015 08:00:00 PM,48,-122,6,0,6
15189,58thStGreenway22ndAve,10/23/2015 09:00:00 PM,48,-122,1,0,1
15190,58thStGreenway22ndAve,10/23/2015 10:00:00 PM,48,-122,4,3,7
15191,58thStGreenway22ndAve,10/23/2015 11:00:00 PM,48,-122,0,0,0
15192,58thStGreenway22ndAve,10/24/2015 12:00:00 AM,48,-122,1,1,2
15193,58thStGreenway22ndAve,10/24/2015 01:00:00 AM,48,-122,1,0,1
15194,58thStGreenway22ndAve,10/24/2015 02:00:00 AM,48,-122,0,1,1
15195,58thStGreenway22ndAve,10/24/2015 03:00:00 AM,48,-122,0,1,1
15196,58thStGreenway22ndAve,10/24/2015 04:00:00 AM,48,-122,0,0,0
15197,58thStGreenway22ndAve,10/24/2015 05:00:00 AM,48,-122,1,0,1
15198,58thStGreenway22ndAve,10/24/2015 06:00:00 AM,48,-122,0,0,0
15199,58thStGreenway22ndAve,10/24/2015 07:00:00 AM,48,-122,0,0,0
15200,58thStGreenway22ndAve,10/24/2015 08:00:00 AM,48,-122,1,1,2
15201,58thStGreenway22ndAve,10/24/2015 09:00:00 AM,48,-122,0,51,51
15202,58thStGreenway22ndAve,10/24/2015 10:00:00 AM,48,-122,10,8,18
15203,58thStGreenway22ndAve,10/24/2015 11:00:00 AM,48,-122,5,2,7
15204,58thStGreenway22ndAve,10/24/2015 12:00:00 PM,48,-122,5,5,10
15205,58thStGreenway22ndAve,10/24/2015 01:00:00 PM,48,-122,3,7,10
15206,58thStGreenway22ndAve,10/24/2015 02:00:00 PM,48,-122,5,6,11
15207,58thStGreenway22ndAve,10/24/2015 03:00:00 PM,48,-122,7,9,16
15208,58thStGreenway22ndAve,10/24/2015 04:00:00 PM,48,-122,10,6,16
15209,58thStGreenway22ndAve,10/24/2015 05:00:00 PM,48,-122,3,7,10
15210,58thStGreenway22ndAve,10/24/2015 06:00:00 PM,48,-122,4,4,8
15211,58thStGreenway22ndAve,10/24/2015 07:00:00 PM,48,-122,1,1,2
15212,58thStGreenway22ndAve,10/24/2015 08:00:00 PM,48,-122,3,0,3
15213,58thStGreenway22ndAve,10/24/2015 09:00:00 PM,48,-122,2,0,2
15214,58thStGreenway22ndAve,10/24/2015 10:00:00 PM,48,-122,0,0,0
15215,58thStGreenway22ndAve,10/24/2015 11:00:00 PM,48,-122,1,1,2
15216,58thStGreenway22ndAve,10/25/2015 12:00:00 AM,48,-122,0,0,0
15217,58thStGreenway22ndAve,10/25/2015 01:00:00 AM,48,-122,0,0,0
15218,58thStGreenway22ndAve,10/25/2015 02:00:00 AM,48,-122,0,0,0
15219,58thStGreenway22ndAve,10/25/2015 03:00:00 AM,48,-122,0,0,0
15220,58thStGreenway22ndAve,10/25/2015 04:00:00 AM,48,-122,0,0,0
15221,58thStGreenway22ndAve,10/25/2015 05:00:00 AM,48,-122,0,0,0
15222,58thStGreenway22ndAve,10/25/2015 06:00:00 AM,48,-122,0,1,1
15223,58thStGreenway22ndAve,10/25/2015 07:00:00 AM,48,-122,0,0,0
15224,58thStGreenway22ndAve,10/25/2015 08:00:00 AM,48,-122,3,2,5
15225,58thStGreenway22ndAve,10/25/2015 09:00:00 AM,48,-122,2,1,3
15226,58thStGreenway22ndAve,10/25/2015 10:00:00 AM,48,-122,3,10,13
15227,58thStGreenway22ndAve,10/25/2015 11:00:00 AM,48,-122,6,5,11
15228,58thStGreenway22ndAve,10/25/2015 12:00:00 PM,48,-122,8,9,17
15229,58thStGreenway22ndAve,10/25/2015 01:00:00 PM,48,-122,9,4,13
15230,58thStGreenway22ndAve,10/25/2015 02:00:00 PM,48,-122,6,13,19
15231,58thStGreenway22ndAve,10/25/2015 03:00:00 PM,48,-122,11,5,16
15232,58thStGreenway22ndAve,10/25/2015 04:00:00 PM,48,-122,4,3,7
15233,58thStGreenway22ndAve,10/25/2015 05:00:00 PM,48,-122,0,6,6
15234,58thStGreenway22ndAve,10/25/2015 06:00:00 PM,48,-122,2,2,4
15235,58thStGreenway22ndAve,10/25/2015 07:00:00 PM,48,-122,1,0,1
15236,58thStGreenway22ndAve,10/25/2015 08:00:00 PM,48,-122,3,0,3
15237,58thStGreenway22ndAve,10/25/2015 09:00:00 PM,48,-122,0,1,1
15238,58thStGreenway22ndAve,10/25/2015 10:00:00 PM,48,-122,0,0,0
15239,58thStGreenway22ndAve,10/25/2015 11:00:00 PM,48,-122,0,0,0
15240,58thStGreenway22ndAve,10/26/2015 12:00:00 AM,48,-122,0,0,0
15241,58thStGreenway22ndAve,10/26/2015 01:00:00 AM,48,-122,0,0,0
15242,58thStGreenway22ndAve,10/26/2015 02:00:00 AM,48,-122,0,0,0
15243,58thStGreenway22ndAve,10/26/2015 03:00:00 AM,48,-122,0,0,0
15244,58thStGreenway22ndAve,10/26/2015 04:00:00 AM,48,-122,0,0,0
15245,58thStGreenway22ndAve,10/26/2015 05:00:00 AM,48,-122,0,1,1
15246,58thStGreenway22ndAve,10/26/2015 06:00:00 AM,48,-122,0,2,2
15247,58thStGreenway22ndAve,10/26/2015 07:00:00 AM,48,-122,6,2,8
15248,58thStGreenway22ndAve,10/26/2015 08:00:00 AM,48,-122,4,6,10
15249,58thStGreenway22ndAve,10/26/2015 09:00:00 AM,48,-122,1,2,3
15250,58thStGreenway22ndAve,10/26/2015 10:00:00 AM,48,-122,0,5,5
15251,58thStGreenway22ndAve,10/26/2015 11:00:00 AM,48,-122,0,0,0
15252,58thStGreenway22ndAve,10/26/2015 12:00:00 PM,48,-122,0,3,3
15253,58thStGreenway22ndAve,10/26/2015 01:00:00 PM,48,-122,2,1,3
15254,58thStGreenway22ndAve,10/26/2015 02:00:00 PM,48,-122,2,4,6
15255,58thStGreenway22ndAve,10/26/2015 03:00:00 PM,48,-122,5,2,7
15256,58thStGreenway22ndAve,10/26/2015 04:00:00 PM,48,-122,4,2,6
15257,58thStGreenway22ndAve,10/26/2015 05:00:00 PM,48,-122,8,9,17
15258,58thStGreenway22ndAve,10/26/2015 06:00:00 PM,48,-122,4,1,5
15259,58thStGreenway22ndAve,10/26/2015 07:00:00 PM,48,-122,3,1,4
15260,58thStGreenway22ndAve,10/26/2015 08:00:00 PM,48,-122,1,1,2
15261,58thStGreenway22ndAve,10/26/2015 09:00:00 PM,48,-122,0,0,0
15262,58thStGreenway22ndAve,10/26/2015 10:00:00 PM,48,-122,2,1,3
15263,58thStGreenway22ndAve,10/26/2015 11:00:00 PM,48,-122,0,0,0
15264,58thStGreenway22ndAve,10/27/2015 12:00:00 AM,48,-122,0,0,0
15265,58thStGreenway22ndAve,10/27/2015 01:00:00 AM,48,-122,0,0,0
15266,58thStGreenway22ndAve,10/27/2015 02:00:00 AM,48,-122,0,1,1
15267,58thStGreenway22ndAve,10/27/2015 03:00:00 AM,48,-122,0,0,0
15268,58thStGreenway22ndAve,10/27/2015 04:00:00 AM,48,-122,0,1,1
15269,58thStGreenway22ndAve,10/27/2015 05:00:00 AM,48,-122,0,0,0
15270,58thStGreenway22ndAve,10/27/2015 06:00:00 AM,48,-122,0,3,3
15271,58thStGreenway22ndAve,10/27/2015 07:00:00 AM,48,-122,5,4,9
15272,58thStGreenway22ndAve,10/27/2015 08:00:00 AM,48,-122,5,5,10
15273,58thStGreenway22ndAve,10/27/2015 09:00:00 AM,48,-122,5,3,8
15274,58thStGreenway22ndAve,10/27/2015 10:00:00 AM,48,-122,0,7,7
15275,58thStGreenway22ndAve,10/27/2015 11:00:00 AM,48,-122,5,1,6
15276,58thStGreenway22ndAve,10/27/2015 12:00:00 PM,48,-122,5,4,9
15277,58thStGreenway22ndAve,10/27/2015 01:00:00 PM,48,-122,4,5,9
15278,58thStGreenway22ndAve,10/27/2015 02:00:00 PM,48,-122,0,4,4
15279,58thStGreenway22ndAve,10/27/2015 03:00:00 PM,48,-122,7,4,11
15280,58thStGreenway22ndAve,10/27/2015 04:00:00 PM,48,-122,8,4,12
15281,58thStGreenway22ndAve,10/27/2015 05:00:00 PM,48,-122,7,9,16
15282,58thStGreenway22ndAve,10/27/2015 06:00:00 PM,48,-122,7,8,15
15283,58thStGreenway22ndAve,10/27/2015 07:00:00 PM,48,-122,2,5,7
15284,58thStGreenway22ndAve,10/27/2015 08:00:00 PM,48,-122,6,2,8
15285,58thStGreenway22ndAve,10/27/2015 09:00:00 PM,48,-122,3,2,5
15286,58thStGreenway22ndAve,10/27/2015 10:00:00 PM,48,-122,2,0,2
15287,58thStGreenway22ndAve,10/27/2015 11:00:00 PM,48,-122,1,1,2
15288,58thStGreenway22ndAve,10/28/2015 12:00:00 AM,48,-122,0,2,2
15289,58thStGreenway22ndAve,10/28/2015 01:00:00 AM,48,-122,0,0,0
15290,58thStGreenway22ndAve,10/28/2015 02:00:00 AM,48,-122,0,2,2
15291,58thStGreenway22ndAve,10/28/2015 03:00:00 AM,48,-122,1,0,1
15292,58thStGreenway22ndAve,10/28/2015 04:00:00 AM,48,-122,1,1,2
15293,58thStGreenway22ndAve,10/28/2015 05:00:00 AM,48,-122,0,0,0
15294,58thStGreenway22ndAve,10/28/2015 06:00:00 AM,48,-122,0,2,2
15295,58thStGreenway22ndAve,10/28/2015 07:00:00 AM,48,-122,2,3,5
15296,58thStGreenway22ndAve,10/28/2015 08:00:00 AM,48,-122,1,3,4
15297,58thStGreenway22ndAve,10/28/2015 09:00:00 AM,48,-122,3,3,6
15298,58thStGreenway22ndAve,10/28/2015 10:00:00 AM,48,-122,3,1,4
15299,58thStGreenway22ndAve,10/28/2015 11:00:00 AM,48,-122,1,5,6
15300,58thStGreenway22ndAve,10/28/2015 12:00:00 PM,48,-122,3,2,5
15301,58thStGreenway22ndAve,10/28/2015 01:00:00 PM,48,-122,6,2,8
15302,58thStGreenway22ndAve,10/28/2015 02:00:00 PM,48,-122,0,1,1
15303,58thStGreenway22ndAve,10/28/2015 03:00:00 PM,48,-122,4,1,5
15304,58thStGreenway22ndAve,10/28/2015 04:00:00 PM,48,-122,2,3,5
15305,58thStGreenway22ndAve,10/28/2015 05:00:00 PM,48,-122,10,12,22
15306,58thStGreenway22ndAve,10/28/2015 06:00:00 PM,48,-122,2,6,8
15307,58thStGreenway22ndAve,10/28/2015 07:00:00 PM,48,-122,7,2,9
15308,58thStGreenway22ndAve,10/28/2015 08:00:00 PM,48,-122,3,1,4
15309,58thStGreenway22ndAve,10/28/2015 09:00:00 PM,48,-122,2,1,3
15310,58thStGreenway22ndAve,10/28/2015 10:00:00 PM,48,-122,0,0,0
15311,58thStGreenway22ndAve,10/28/2015 11:00:00 PM,48,-122,2,2,4
15312,58thStGreenway22ndAve,10/29/2015 12:00:00 AM,48,-122,0,0,0
15313,58thStGreenway22ndAve,10/29/2015 01:00:00 AM,48,-122,1,1,2
15314,58thStGreenway22ndAve,10/29/2015 02:00:00 AM,48,-122,0,0,0
15315,58thStGreenway22ndAve,10/29/2015 03:00:00 AM,48,-122,0,0,0
15316,58thStGreenway22ndAve,10/29/2015 04:00:00 AM,48,-122,2,1,3
15317,58thStGreenway22ndAve,10/29/2015 05:00:00 AM,48,-122,0,1,1
15318,58thStGreenway22ndAve,10/29/2015 06:00:00 AM,48,-122,0,4,4
15319,58thStGreenway22ndAve,10/29/2015 07:00:00 AM,48,-122,3,2,5
15320,58thStGreenway22ndAve,10/29/2015 08:00:00 AM,48,-122,3,2,5
15321,58thStGreenway22ndAve,10/29/2015 09:00:00 AM,48,-122,4,1,5
15322,58thStGreenway22ndAve,10/29/2015 10:00:00 AM,48,-122,3,0,3
15323,58thStGreenway22ndAve,10/29/2015 11:00:00 AM,48,-122,0,4,4
15324,58thStGreenway22ndAve,10/29/2015 12:00:00 PM,48,-122,2,2,4
15325,58thStGreenway22ndAve,10/29/2015 01:00:00 PM,48,-122,1,1,2
15326,58thStGreenway22ndAve,10/29/2015 02:00:00 PM,48,-122,1,3,4
15327,58thStGreenway22ndAve,10/29/2015 03:00:00 PM,48,-122,2,2,4
15328,58thStGreenway22ndAve,10/29/2015 04:00:00 PM,48,-122,3,2,5
15329,58thStGreenway22ndAve,10/29/2015 05:00:00 PM,48,-122,4,5,9
15330,58thStGreenway22ndAve,10/29/2015 06:00:00 PM,48,-122,2,6,8
15331,58thStGreenway22ndAve,10/29/2015 07:00:00 PM,48,-122,2,7,9
15332,58thStGreenway22ndAve,10/29/2015 08:00:00 PM,48,-122,2,3,5
15333,58thStGreenway22ndAve,10/29/2015 09:00:00 PM,48,-122,4,0,4
15334,58thStGreenway22ndAve,10/29/2015 10:00:00 PM,48,-122,1,3,4
15335,58thStGreenway22ndAve,10/29/2015 11:00:00 PM,48,-122,2,0,2
15336,58thStGreenway22ndAve,10/30/2015 12:00:00 AM,48,-122,0,1,1
15337,58thStGreenway22ndAve,10/30/2015 01:00:00 AM,48,-122,0,0,0
15338,58thStGreenway22ndAve,10/30/2015 02:00:00 AM,48,-122,0,0,0
15339,58thStGreenway22ndAve,10/30/2015 03:00:00 AM,48,-122,0,0,0
15340,58thStGreenway22ndAve,10/30/2015 04:00:00 AM,48,-122,0,0,0
15341,58thStGreenway22ndAve,10/30/2015 05:00:00 AM,48,-122,0,0,0
15342,58thStGreenway22ndAve,10/30/2015 06:00:00 AM,48,-122,0,0,0
15343,58thStGreenway22ndAve,10/30/2015 07:00:00 AM,48,-122,3,3,6
15344,58thStGreenway22ndAve,10/30/2015 08:00:00 AM,48,-122,2,2,4
15345,58thStGreenway22ndAve,10/30/2015 09:00:00 AM,48,-122,1,3,4
15346,58thStGreenway22ndAve,10/30/2015 10:00:00 AM,48,-122,1,4,5
15347,58thStGreenway22ndAve,10/30/2015 11:00:00 AM,48,-122,2,0,2
15348,58thStGreenway22ndAve,10/30/2015 12:00:00 PM,48,-122,2,3,5
15349,58thStGreenway22ndAve,10/30/2015 01:00:00 PM,48,-122,4,4,8
15350,58thStGreenway22ndAve,10/30/2015 02:00:00 PM,48,-122,2,6,8
15351,58thStGreenway22ndAve,10/30/2015 03:00:00 PM,48,-122,2,3,5
15352,58thStGreenway22ndAve,10/30/2015 04:00:00 PM,48,-122,4,5,9
15353,58thStGreenway22ndAve,10/30/2015 05:00:00 PM,48,-122,3,2,5
15354,58thStGreenway22ndAve,10/30/2015 06:00:00 PM,48,-122,1,1,2
15355,58thStGreenway22ndAve,10/30/2015 07:00:00 PM,48,-122,1,1,2
15356,58thStGreenway22ndAve,10/30/2015 08:00:00 PM,48,-122,2,0,2
15357,58thStGreenway22ndAve,10/30/2015 09:00:00 PM,48,-122,1,0,1
15358,58thStGreenway22ndAve,10/30/2015 10:00:00 PM,48,-122,0,1,1
15359,58thStGreenway22ndAve,10/30/2015 11:00:00 PM,48,-122,0,1,1
15360,58thStGreenway22ndAve,10/31/2015 12:00:00 AM,48,-122,0,0,0
15361,58thStGreenway22ndAve,10/31/2015 01:00:00 AM,48,-122,0,0,0
15362,58thStGreenway22ndAve,10/31/2015 02:00:00 AM,48,-122,0,0,0
15363,58thStGreenway22ndAve,10/31/2015 03:00:00 AM,48,-122,0,0,0
15364,58thStGreenway22ndAve,10/31/2015 04:00:00 AM,48,-122,1,2,3
15365,58thStGreenway22ndAve,10/31/2015 05:00:00 AM,48,-122,2,1,3
15366,58thStGreenway22ndAve,10/31/2015 06:00:00 AM,48,-122,0,0,0
15367,58thStGreenway22ndAve,10/31/2015 07:00:00 AM,48,-122,0,0,0
15368,58thStGreenway22ndAve,10/31/2015 08:00:00 AM,48,-122,1,0,1
15369,58thStGreenway22ndAve,10/31/2015 09:00:00 AM,48,-122,0,4,4
15370,58thStGreenway22ndAve,10/31/2015 10:00:00 AM,48,-122,0,0,0
15371,58thStGreenway22ndAve,10/31/2015 11:00:00 AM,48,-122,1,2,3
15372,58thStGreenway22ndAve,10/31/2015 12:00:00 PM,48,-122,1,0,1
15373,58thStGreenway22ndAve,10/31/2015 01:00:00 PM,48,-122,0,2,2
15374,58thStGreenway22ndAve,10/31/2015 02:00:00 PM,48,-122,2,8,10
15375,58thStGreenway22ndAve,10/31/2015 03:00:00 PM,48,-122,4,4,8
15376,58thStGreenway22ndAve,10/31/2015 04:00:00 PM,48,-122,2,2,4
15377,58thStGreenway22ndAve,10/31/2015 05:00:00 PM,48,-122,0,3,3
15378,58thStGreenway22ndAve,10/31/2015 06:00:00 PM,48,-122,0,1,1
15379,58thStGreenway22ndAve,10/31/2015 07:00:00 PM,48,-122,2,0,2
15380,58thStGreenway22ndAve,10/31/2015 08:00:00 PM,48,-122,1,0,1
15381,58thStGreenway22ndAve,10/31/2015 09:00:00 PM,48,-122,0,0,0
15382,58thStGreenway22ndAve,10/31/2015 10:00:00 PM,48,-122,2,0,2
15383,58thStGreenway22ndAve,10/31/2015 11:00:00 PM,48,-122,0,2,2
15384,58thStGreenway22ndAve,11/01/2015 12:00:00 AM,48,-122,0,1,1
15385,58thStGreenway22ndAve,11/01/2015 01:00:00 AM,48,-122,0,0,0
15386,58thStGreenway22ndAve,11/01/2015 02:00:00 AM,48,-122,0,0,0
15387,58thStGreenway22ndAve,11/01/2015 03:00:00 AM,48,-122,0,0,0
15388,58thStGreenway22ndAve,11/01/2015 04:00:00 AM,48,-122,0,1,1
15389,58thStGreenway22ndAve,11/01/2015 05:00:00 AM,48,-122,0,0,0
15390,58thStGreenway22ndAve,11/01/2015 06:00:00 AM,48,-122,1,0,1
15391,58thStGreenway22ndAve,11/01/2015 07:00:00 AM,48,-122,1,2,3
15392,58thStGreenway22ndAve,11/01/2015 08:00:00 AM,48,-122,2,3,5
15393,58thStGreenway22ndAve,11/01/2015 09:00:00 AM,48,-122,2,7,9
15394,58thStGreenway22ndAve,11/01/2015 10:00:00 AM,48,-122,2,3,5
15395,58thStGreenway22ndAve,11/01/2015 11:00:00 AM,48,-122,2,4,6
15396,58thStGreenway22ndAve,11/01/2015 12:00:00 PM,48,-122,2,4,6
15397,58thStGreenway22ndAve,11/01/2015 01:00:00 PM,48,-122,3,2,5
15398,58thStGreenway22ndAve,11/01/2015 02:00:00 PM,48,-122,6,2,8
15399,58thStGreenway22ndAve,11/01/2015 03:00:00 PM,48,-122,2,1,3
15400,58thStGreenway22ndAve,11/01/2015 04:00:00 PM,48,-122,0,2,2
15401,58thStGreenway22ndAve,11/01/2015 05:00:00 PM,48,-122,0,1,1
15402,58thStGreenway22ndAve,11/01/2015 06:00:00 PM,48,-122,5,4,9
15403,58thStGreenway22ndAve,11/01/2015 07:00:00 PM,48,-122,1,0,1
15404,58thStGreenway22ndAve,11/01/2015 08:00:00 PM,48,-122,1,0,1
15405,58thStGreenway22ndAve,11/01/2015 09:00:00 PM,48,-122,0,0,0
15406,58thStGreenway22ndAve,11/01/2015 10:00:00 PM,48,-122,0,0,0
15407,58thStGreenway22ndAve,11/01/2015 11:00:00 PM,48,-122,0,3,3
15408,58thStGreenway22ndAve,11/02/2015 12:00:00 AM,48,-122,0,0,0
15409,58thStGreenway22ndAve,11/02/2015 01:00:00 AM,48,-122,1,0,1
15410,58thStGreenway22ndAve,11/02/2015 02:00:00 AM,48,-122,0,1,1
15411,58thStGreenway22ndAve,11/02/2015 03:00:00 AM,48,-122,0,1,1
15412,58thStGreenway22ndAve,11/02/2015 04:00:00 AM,48,-122,0,1,1
15413,58thStGreenway22ndAve,11/02/2015 05:00:00 AM,48,-122,0,1,1
15414,58thStGreenway22ndAve,11/02/2015 06:00:00 AM,48,-122,0,2,2
15415,58thStGreenway22ndAve,11/02/2015 07:00:00 AM,48,-122,7,2,9
15416,58thStGreenway22ndAve,11/02/2015 08:00:00 AM,48,-122,7,6,13
15417,58thStGreenway22ndAve,11/02/2015 09:00:00 AM,48,-122,1,4,5
15418,58thStGreenway22ndAve,11/02/2015 10:00:00 AM,48,-122,1,1,2
15419,58thStGreenway22ndAve,11/02/2015 11:00:00 AM,48,-122,3,4,7
15420,58thStGreenway22ndAve,11/02/2015 12:00:00 PM,48,-122,3,3,6
15421,58thStGreenway22ndAve,11/02/2015 01:00:00 PM,48,-122,6,6,12
15422,58thStGreenway22ndAve,11/02/2015 02:00:00 PM,48,-122,8,4,12
15423,58thStGreenway22ndAve,11/02/2015 03:00:00 PM,48,-122,6,4,10
15424,58thStGreenway22ndAve,11/02/2015 04:00:00 PM,48,-122,6,13,19
15425,58thStGreenway22ndAve,11/02/2015 05:00:00 PM,48,-122,11,10,21
15426,58thStGreenway22ndAve,11/02/2015 06:00:00 PM,48,-122,2,3,5
15427,58thStGreenway22ndAve,11/02/2015 07:00:00 PM,48,-122,3,3,6
15428,58thStGreenway22ndAve,11/02/2015 08:00:00 PM,48,-122,1,2,3
15429,58thStGreenway22ndAve,11/02/2015 09:00:00 PM,48,-122,5,5,10
15430,58thStGreenway22ndAve,11/02/2015 10:00:00 PM,48,-122,0,0,0
15431,58thStGreenway22ndAve,11/02/2015 11:00:00 PM,48,-122,0,0,0
15432,58thStGreenway22ndAve,11/03/2015 12:00:00 AM,48,-122,0,0,0
15433,58thStGreenway22ndAve,11/03/2015 01:00:00 AM,48,-122,0,1,1
15434,58thStGreenway22ndAve,11/03/2015 02:00:00 AM,48,-122,0,0,0
15435,58thStGreenway22ndAve,11/03/2015 03:00:00 AM,48,-122,0,1,1
15436,58thStGreenway22ndAve,11/03/2015 04:00:00 AM,48,-122,1,0,1
15437,58thStGreenway22ndAve,11/03/2015 05:00:00 AM,48,-122,0,1,1
15438,58thStGreenway22ndAve,11/03/2015 06:00:00 AM,48,-122,1,2,3
15439,58thStGreenway22ndAve,11/03/2015 07:00:00 AM,48,-122,7,10,17
15440,58thStGreenway22ndAve,11/03/2015 08:00:00 AM,48,-122,5,10,15
15441,58thStGreenway22ndAve,11/03/2015 09:00:00 AM,48,-122,2,8,10
15442,58thStGreenway22ndAve,11/03/2015 10:00:00 AM,48,-122,2,4,6
15443,58thStGreenway22ndAve,11/03/2015 11:00:00 AM,48,-122,3,3,6
15444,58thStGreenway22ndAve,11/03/2015 12:00:00 PM,48,-122,5,3,8
15445,58thStGreenway22ndAve,11/03/2015 01:00:00 PM,48,-122,3,8,11
15446,58thStGreenway22ndAve,11/03/2015 02:00:00 PM,48,-122,7,8,15
15447,58thStGreenway22ndAve,11/03/2015 03:00:00 PM,48,-122,3,6,9
15448,58thStGreenway22ndAve,11/03/2015 04:00:00 PM,48,-122,3,10,13
15449,58thStGreenway22ndAve,11/03/2015 05:00:00 PM,48,-122,14,11,25
15450,58thStGreenway22ndAve,11/03/2015 06:00:00 PM,48,-122,8,10,18
15451,58thStGreenway22ndAve,11/03/2015 07:00:00 PM,48,-122,9,15,24
15452,58thStGreenway22ndAve,11/03/2015 08:00:00 PM,48,-122,4,4,8
15453,58thStGreenway22ndAve,11/03/2015 09:00:00 PM,48,-122,3,0,3
15454,58thStGreenway22ndAve,11/03/2015 10:00:00 PM,48,-122,1,0,1
15455,58thStGreenway22ndAve,11/03/2015 11:00:00 PM,48,-122,0,0,0
15456,58thStGreenway22ndAve,11/04/2015 12:00:00 AM,48,-122,2,1,3
15457,58thStGreenway22ndAve,11/04/2015 01:00:00 AM,48,-122,0,0,0
15458,58thStGreenway22ndAve,11/04/2015 02:00:00 AM,48,-122,0,0,0
15459,58thStGreenway22ndAve,11/04/2015 03:00:00 AM,48,-122,0,1,1
15460,58thStGreenway22ndAve,11/04/2015 04:00:00 AM,48,-122,0,0,0
15461,58thStGreenway22ndAve,11/04/2015 05:00:00 AM,48,-122,0,1,1
15462,58thStGreenway22ndAve,11/04/2015 06:00:00 AM,48,-122,2,4,6
15463,58thStGreenway22ndAve,11/04/2015 07:00:00 AM,48,-122,4,2,6
15464,58thStGreenway22ndAve,11/04/2015 08:00:00 AM,48,-122,1,4,5
15465,58thStGreenway22ndAve,11/04/2015 09:00:00 AM,48,-122,4,5,9
15466,58thStGreenway22ndAve,11/04/2015 10:00:00 AM,48,-122,1,3,4
15467,58thStGreenway22ndAve,11/04/2015 11:00:00 AM,48,-122,2,3,5
15468,58thStGreenway22ndAve,11/04/2015 12:00:00 PM,48,-122,4,9,13
15469,58thStGreenway22ndAve,11/04/2015 01:00:00 PM,48,-122,7,5,12
15470,58thStGreenway22ndAve,11/04/2015 02:00:00 PM,48,-122,7,0,7
15471,58thStGreenway22ndAve,11/04/2015 03:00:00 PM,48,-122,4,7,11
15472,58thStGreenway22ndAve,11/04/2015 04:00:00 PM,48,-122,8,6,14
15473,58thStGreenway22ndAve,11/04/2015 05:00:00 PM,48,-122,9,15,24
15474,58thStGreenway22ndAve,11/04/2015 06:00:00 PM,48,-122,5,8,13
15475,58thStGreenway22ndAve,11/04/2015 07:00:00 PM,48,-122,3,2,5
15476,58thStGreenway22ndAve,11/04/2015 08:00:00 PM,48,-122,3,3,6
15477,58thStGreenway22ndAve,11/04/2015 09:00:00 PM,48,-122,2,0,2
15478,58thStGreenway22ndAve,11/04/2015 10:00:00 PM,48,-122,2,1,3
15479,58thStGreenway22ndAve,11/04/2015 11:00:00 PM,48,-122,1,2,3
15480,58thStGreenway22ndAve,11/05/2015 12:00:00 AM,48,-122,0,0,0
15481,58thStGreenway22ndAve,11/05/2015 01:00:00 AM,48,-122,0,0,0
15482,58thStGreenway22ndAve,11/05/2015 02:00:00 AM,48,-122,0,0,0
15483,58thStGreenway22ndAve,11/05/2015 03:00:00 AM,48,-122,0,1,1
15484,58thStGreenway22ndAve,11/05/2015 04:00:00 AM,48,-122,1,1,2
15485,58thStGreenway22ndAve,11/05/2015 05:00:00 AM,48,-122,0,0,0
15486,58thStGreenway22ndAve,11/05/2015 06:00:00 AM,48,-122,0,2,2
15487,58thStGreenway22ndAve,11/05/2015 07:00:00 AM,48,-122,9,0,9
15488,58thStGreenway22ndAve,11/05/2015 08:00:00 AM,48,-122,5,5,10
15489,58thStGreenway22ndAve,11/05/2015 09:00:00 AM,48,-122,5,2,7
15490,58thStGreenway22ndAve,11/05/2015 10:00:00 AM,48,-122,3,3,6
15491,58thStGreenway22ndAve,11/05/2015 11:00:00 AM,48,-122,3,0,3
15492,58thStGreenway22ndAve,11/05/2015 12:00:00 PM,48,-122,5,0,5
15493,58thStGreenway22ndAve,11/05/2015 01:00:00 PM,48,-122,1,3,4
15494,58thStGreenway22ndAve,11/05/2015 02:00:00 PM,48,-122,1,2,3
15495,58thStGreenway22ndAve,11/05/2015 03:00:00 PM,48,-122,5,6,11
15496,58thStGreenway22ndAve,11/05/2015 04:00:00 PM,48,-122,5,4,9
15497,58thStGreenway22ndAve,11/05/2015 05:00:00 PM,48,-122,3,8,11
15498,58thStGreenway22ndAve,11/05/2015 06:00:00 PM,48,-122,5,10,15
15499,58thStGreenway22ndAve,11/05/2015 07:00:00 PM,48,-122,4,3,7
15500,58thStGreenway22ndAve,11/05/2015 08:00:00 PM,48,-122,0,3,3
15501,58thStGreenway22ndAve,11/05/2015 09:00:00 PM,48,-122,5,1,6
15502,58thStGreenway22ndAve,11/05/2015 10:00:00 PM,48,-122,2,0,2
15503,58thStGreenway22ndAve,11/05/2015 11:00:00 PM,48,-122,1,0,1
15504,58thStGreenway22ndAve,11/06/2015 12:00:00 AM,48,-122,0,0,0
15505,58thStGreenway22ndAve,11/06/2015 01:00:00 AM,48,-122,0,0,0
15506,58thStGreenway22ndAve,11/06/2015 02:00:00 AM,48,-122,1,0,1
15507,58thStGreenway22ndAve,11/06/2015 03:00:00 AM,48,-122,0,0,0
15508,58thStGreenway22ndAve,11/06/2015 04:00:00 AM,48,-122,0,0,0
15509,58thStGreenway22ndAve,11/06/2015 05:00:00 AM,48,-122,0,0,0
15510,58thStGreenway22ndAve,11/06/2015 06:00:00 AM,48,-122,1,4,5
15511,58thStGreenway22ndAve,11/06/2015 07:00:00 AM,48,-122,3,0,3
15512,58thStGreenway22ndAve,11/06/2015 08:00:00 AM,48,-122,5,0,5
15513,58thStGreenway22ndAve,11/06/2015 09:00:00 AM,48,-122,6,5,11
15514,58thStGreenway22ndAve,11/06/2015 10:00:00 AM,48,-122,4,2,6
15515,58thStGreenway22ndAve,11/06/2015 11:00:00 AM,48,-122,4,1,5
15516,58thStGreenway22ndAve,11/06/2015 12:00:00 PM,48,-122,2,7,9
15517,58thStGreenway22ndAve,11/06/2015 01:00:00 PM,48,-122,4,11,15
15518,58thStGreenway22ndAve,11/06/2015 02:00:00 PM,48,-122,2,0,2
15519,58thStGreenway22ndAve,11/06/2015 03:00:00 PM,48,-122,1,0,1
15520,58thStGreenway22ndAve,11/06/2015 04:00:00 PM,48,-122,6,2,8
15521,58thStGreenway22ndAve,11/06/2015 05:00:00 PM,48,-122,3,7,10
15522,58thStGreenway22ndAve,11/06/2015 06:00:00 PM,48,-122,6,3,9
15523,58thStGreenway22ndAve,11/06/2015 07:00:00 PM,48,-122,5,0,5
15524,58thStGreenway22ndAve,11/06/2015 08:00:00 PM,48,-122,0,2,2
15525,58thStGreenway22ndAve,11/06/2015 09:00:00 PM,48,-122,0,0,0
15526,58thStGreenway22ndAve,11/06/2015 10:00:00 PM,48,-122,0,1,1
15527,58thStGreenway22ndAve,11/06/2015 11:00:00 PM,48,-122,0,1,1
15528,58thStGreenway22ndAve,11/07/2015 12:00:00 AM,48,-122,0,1,1
15529,58thStGreenway22ndAve,11/07/2015 01:00:00 AM,48,-122,0,0,0
15530,58thStGreenway22ndAve,11/07/2015 02:00:00 AM,48,-122,0,0,0
15531,58thStGreenway22ndAve,11/07/2015 03:00:00 AM,48,-122,0,1,1
15532,58thStGreenway22ndAve,11/07/2015 04:00:00 AM,48,-122,0,0,0
15533,58thStGreenway22ndAve,11/07/2015 05:00:00 AM,48,-122,0,0,0
15534,58thStGreenway22ndAve,11/07/2015 06:00:00 AM,48,-122,0,1,1
15535,58thStGreenway22ndAve,11/07/2015 07:00:00 AM,48,-122,0,0,0
15536,58thStGreenway22ndAve,11/07/2015 08:00:00 AM,48,-122,2,0,2
15537,58thStGreenway22ndAve,11/07/2015 09:00:00 AM,48,-122,0,0,0
15538,58thStGreenway22ndAve,11/07/2015 10:00:00 AM,48,-122,0,1,1
15539,58thStGreenway22ndAve,11/07/2015 11:00:00 AM,48,-122,0,1,1
15540,58thStGreenway22ndAve,11/07/2015 12:00:00 PM,48,-122,0,3,3
15541,58thStGreenway22ndAve,11/07/2015 01:00:00 PM,48,-122,2,2,4
15542,58thStGreenway22ndAve,11/07/2015 02:00:00 PM,48,-122,2,0,2
15543,58thStGreenway22ndAve,11/07/2015 03:00:00 PM,48,-122,1,0,1
15544,58thStGreenway22ndAve,11/07/2015 04:00:00 PM,48,-122,1,4,5
15545,58thStGreenway22ndAve,11/07/2015 05:00:00 PM,48,-122,3,1,4
15546,58thStGreenway22ndAve,11/07/2015 06:00:00 PM,48,-122,1,0,1
15547,58thStGreenway22ndAve,11/07/2015 07:00:00 PM,48,-122,2,1,3
15548,58thStGreenway22ndAve,11/07/2015 08:00:00 PM,48,-122,0,1,1
15549,58thStGreenway22ndAve,11/07/2015 09:00:00 PM,48,-122,0,0,0
15550,58thStGreenway22ndAve,11/07/2015 10:00:00 PM,48,-122,0,0,0
15551,58thStGreenway22ndAve,11/07/2015 11:00:00 PM,48,-122,1,0,1
15552,58thStGreenway22ndAve,11/08/2015 12:00:00 AM,48,-122,0,0,0
15553,58thStGreenway22ndAve,11/08/2015 01:00:00 AM,48,-122,0,1,1
15554,58thStGreenway22ndAve,11/08/2015 02:00:00 AM,48,-122,0,0,0
15555,58thStGreenway22ndAve,11/08/2015 03:00:00 AM,48,-122,0,0,0
15556,58thStGreenway22ndAve,11/08/2015 04:00:00 AM,48,-122,0,0,0
15557,58thStGreenway22ndAve,11/08/2015 05:00:00 AM,48,-122,0,0,0
15558,58thStGreenway22ndAve,11/08/2015 06:00:00 AM,48,-122,0,0,0
15559,58thStGreenway22ndAve,11/08/2015 07:00:00 AM,48,-122,1,0,1
15560,58thStGreenway22ndAve,11/08/2015 08:00:00 AM,48,-122,1,1,2
15561,58thStGreenway22ndAve,11/08/2015 09:00:00 AM,48,-122,0,3,3
15562,58thStGreenway22ndAve,11/08/2015 10:00:00 AM,48,-122,2,1,3
15563,58thStGreenway22ndAve,11/08/2015 11:00:00 AM,48,-122,3,2,5
15564,58thStGreenway22ndAve,11/08/2015 12:00:00 PM,48,-122,4,4,8
15565,58thStGreenway22ndAve,11/08/2015 01:00:00 PM,48,-122,4,4,8
15566,58thStGreenway22ndAve,11/08/2015 02:00:00 PM,48,-122,6,9,15
15567,58thStGreenway22ndAve,11/08/2015 03:00:00 PM,48,-122,4,3,7
15568,58thStGreenway22ndAve,11/08/2015 04:00:00 PM,48,-122,7,7,14
15569,58thStGreenway22ndAve,11/08/2015 05:00:00 PM,48,-122,2,0,2
15570,58thStGreenway22ndAve,11/08/2015 06:00:00 PM,48,-122,2,1,3
15571,58thStGreenway22ndAve,11/08/2015 07:00:00 PM,48,-122,1,0,1
15572,58thStGreenway22ndAve,11/08/2015 08:00:00 PM,48,-122,3,0,3
15573,58thStGreenway22ndAve,11/08/2015 09:00:00 PM,48,-122,0,2,2
15574,58thStGreenway22ndAve,11/08/2015 10:00:00 PM,48,-122,2,0,2
15575,58thStGreenway22ndAve,11/08/2015 11:00:00 PM,48,-122,0,0,0
15576,58thStGreenway22ndAve,11/09/2015 12:00:00 AM,48,-122,0,0,0
15577,58thStGreenway22ndAve,11/09/2015 01:00:00 AM,48,-122,0,1,1
15578,58thStGreenway22ndAve,11/09/2015 02:00:00 AM,48,-122,0,0,0
15579,58thStGreenway22ndAve,11/09/2015 03:00:00 AM,48,-122,0,0,0
15580,58thStGreenway22ndAve,11/09/2015 04:00:00 AM,48,-122,0,0,0
15581,58thStGreenway22ndAve,11/09/2015 05:00:00 AM,48,-122,0,2,2
15582,58thStGreenway22ndAve,11/09/2015 06:00:00 AM,48,-122,3,2,5
15583,58thStGreenway22ndAve,11/09/2015 07:00:00 AM,48,-122,4,0,4
15584,58thStGreenway22ndAve,11/09/2015 08:00:00 AM,48,-122,4,4,8
15585,58thStGreenway22ndAve,11/09/2015 09:00:00 AM,48,-122,4,4,8
15586,58thStGreenway22ndAve,11/09/2015 10:00:00 AM,48,-122,0,1,1
15587,58thStGreenway22ndAve,11/09/2015 11:00:00 AM,48,-122,1,1,2
15588,58thStGreenway22ndAve,11/09/2015 12:00:00 PM,48,-122,4,2,6
15589,58thStGreenway22ndAve,11/09/2015 01:00:00 PM,48,-122,0,4,4
15590,58thStGreenway22ndAve,11/09/2015 02:00:00 PM,48,-122,4,3,7
15591,58thStGreenway22ndAve,11/09/2015 03:00:00 PM,48,-122,2,1,3
15592,58thStGreenway22ndAve,11/09/2015 04:00:00 PM,48,-122,1,4,5
15593,58thStGreenway22ndAve,11/09/2015 05:00:00 PM,48,-122,3,5,8
15594,58thStGreenway22ndAve,11/09/2015 06:00:00 PM,48,-122,1,3,4
15595,58thStGreenway22ndAve,11/09/2015 07:00:00 PM,48,-122,2,5,7
15596,58thStGreenway22ndAve,11/09/2015 08:00:00 PM,48,-122,7,2,9
15597,58thStGreenway22ndAve,11/09/2015 09:00:00 PM,48,-122,1,2,3
15598,58thStGreenway22ndAve,11/09/2015 10:00:00 PM,48,-122,2,0,2
15599,58thStGreenway22ndAve,11/09/2015 11:00:00 PM,48,-122,0,1,1
15600,58thStGreenway22ndAve,11/10/2015 12:00:00 AM,48,-122,0,0,0
15601,58thStGreenway22ndAve,11/10/2015 01:00:00 AM,48,-122,0,1,1
15602,58thStGreenway22ndAve,11/10/2015 02:00:00 AM,48,-122,0,0,0
15603,58thStGreenway22ndAve,11/10/2015 03:00:00 AM,48,-122,0,0,0
15604,58thStGreenway22ndAve,11/10/2015 04:00:00 AM,48,-122,0,0,0
15605,58thStGreenway22ndAve,11/10/2015 05:00:00 AM,48,-122,0,2,2
15606,58thStGreenway22ndAve,11/10/2015 06:00:00 AM,48,-122,0,1,1
15607,58thStGreenway22ndAve,11/10/2015 07:00:00 AM,48,-122,6,2,8
15608,58thStGreenway22ndAve,11/10/2015 08:00:00 AM,48,-122,2,6,8
15609,58thStGreenway22ndAve,11/10/2015 09:00:00 AM,48,-122,6,10,16
15610,58thStGreenway22ndAve,11/10/2015 10:00:00 AM,48,-122,1,2,3
15611,58thStGreenway22ndAve,11/10/2015 11:00:00 AM,48,-122,1,4,5
15612,58thStGreenway22ndAve,11/10/2015 12:00:00 PM,48,-122,4,6,10
15613,58thStGreenway22ndAve,11/10/2015 01:00:00 PM,48,-122,1,5,6
15614,58thStGreenway22ndAve,11/10/2015 02:00:00 PM,48,-122,6,2,8
15615,58thStGreenway22ndAve,11/10/2015 03:00:00 PM,48,-122,2,3,5
15616,58thStGreenway22ndAve,11/10/2015 04:00:00 PM,48,-122,5,6,11
15617,58thStGreenway22ndAve,11/10/2015 05:00:00 PM,48,-122,5,3,8
15618,58thStGreenway22ndAve,11/10/2015 06:00:00 PM,48,-122,2,6,8
15619,58thStGreenway22ndAve,11/10/2015 07:00:00 PM,48,-122,3,4,7
15620,58thStGreenway22ndAve,11/10/2015 08:00:00 PM,48,-122,3,2,5
15621,58thStGreenway22ndAve,11/10/2015 09:00:00 PM,48,-122,1,2,3
15622,58thStGreenway22ndAve,11/10/2015 10:00:00 PM,48,-122,2,0,2
15623,58thStGreenway22ndAve,11/10/2015 11:00:00 PM,48,-122,0,0,0
15624,58thStGreenway22ndAve,11/11/2015 12:00:00 AM,48,-122,0,0,0
15625,58thStGreenway22ndAve,11/11/2015 01:00:00 AM,48,-122,0,0,0
15626,58thStGreenway22ndAve,11/11/2015 02:00:00 AM,48,-122,0,0,0
15627,58thStGreenway22ndAve,11/11/2015 03:00:00 AM,48,-122,0,0,0
15628,58thStGreenway22ndAve,11/11/2015 04:00:00 AM,48,-122,0,0,0
15629,58thStGreenway22ndAve,11/11/2015 05:00:00 AM,48,-122,0,0,0
15630,58thStGreenway22ndAve,11/11/2015 06:00:00 AM,48,-122,0,3,3
15631,58thStGreenway22ndAve,11/11/2015 07:00:00 AM,48,-122,4,3,7
15632,58thStGreenway22ndAve,11/11/2015 08:00:00 AM,48,-122,1,1,2
15633,58thStGreenway22ndAve,11/11/2015 09:00:00 AM,48,-122,5,2,7
15634,58thStGreenway22ndAve,11/11/2015 10:00:00 AM,48,-122,5,10,15
15635,58thStGreenway22ndAve,11/11/2015 11:00:00 AM,48,-122,4,6,10
15636,58thStGreenway22ndAve,11/11/2015 12:00:00 PM,48,-122,10,5,15
15637,58thStGreenway22ndAve,11/11/2015 01:00:00 PM,48,-122,6,4,10
15638,58thStGreenway22ndAve,11/11/2015 02:00:00 PM,48,-122,2,2,4
15639,58thStGreenway22ndAve,11/11/2015 03:00:00 PM,48,-122,8,3,11
15640,58thStGreenway22ndAve,11/11/2015 04:00:00 PM,48,-122,2,1,3
15641,58thStGreenway22ndAve,11/11/2015 05:00:00 PM,48,-122,10,4,14
15642,58thStGreenway22ndAve,11/11/2015 06:00:00 PM,48,-122,5,4,9
15643,58thStGreenway22ndAve,11/11/2015 07:00:00 PM,48,-122,2,1,3
15644,58thStGreenway22ndAve,11/11/2015 08:00:00 PM,48,-122,0,2,2
15645,58thStGreenway22ndAve,11/11/2015 09:00:00 PM,48,-122,3,3,6
15646,58thStGreenway22ndAve,11/11/2015 10:00:00 PM,48,-122,0,0,0
15647,58thStGreenway22ndAve,11/11/2015 11:00:00 PM,48,-122,1,1,2
15648,58thStGreenway22ndAve,11/12/2015 12:00:00 AM,48,-122,0,0,0
15649,58thStGreenway22ndAve,11/12/2015 01:00:00 AM,48,-122,1,0,1
15650,58thStGreenway22ndAve,11/12/2015 02:00:00 AM,48,-122,0,0,0
15651,58thStGreenway22ndAve,11/12/2015 03:00:00 AM,48,-122,0,1,1
15652,58thStGreenway22ndAve,11/12/2015 04:00:00 AM,48,-122,0,0,0
15653,58thStGreenway22ndAve,11/12/2015 05:00:00 AM,48,-122,0,0,0
15654,58thStGreenway22ndAve,11/12/2015 06:00:00 AM,48,-122,0,2,2
15655,58thStGreenway22ndAve,11/12/2015 07:00:00 AM,48,-122,2,2,4
15656,58thStGreenway22ndAve,11/12/2015 08:00:00 AM,48,-122,6,7,13
15657,58thStGreenway22ndAve,11/12/2015 09:00:00 AM,48,-122,2,2,4
15658,58thStGreenway22ndAve,11/12/2015 10:00:00 AM,48,-122,1,4,5
15659,58thStGreenway22ndAve,11/12/2015 11:00:00 AM,48,-122,5,7,12
15660,58thStGreenway22ndAve,11/12/2015 12:00:00 PM,48,-122,9,3,12
15661,58thStGreenway22ndAve,11/12/2015 01:00:00 PM,48,-122,4,1,5
15662,58thStGreenway22ndAve,11/12/2015 02:00:00 PM,48,-122,2,2,4
15663,58thStGreenway22ndAve,11/12/2015 03:00:00 PM,48,-122,3,1,4
15664,58thStGreenway22ndAve,11/12/2015 04:00:00 PM,48,-122,3,1,4
15665,58thStGreenway22ndAve,11/12/2015 05:00:00 PM,48,-122,2,1,3
15666,58thStGreenway22ndAve,11/12/2015 06:00:00 PM,48,-122,1,3,4
15667,58thStGreenway22ndAve,11/12/2015 07:00:00 PM,48,-122,3,3,6
15668,58thStGreenway22ndAve,11/12/2015 08:00:00 PM,48,-122,2,0,2
15669,58thStGreenway22ndAve,11/12/2015 09:00:00 PM,48,-122,1,0,1
15670,58thStGreenway22ndAve,11/12/2015 10:00:00 PM,48,-122,2,0,2
15671,58thStGreenway22ndAve,11/12/2015 11:00:00 PM,48,-122,1,1,2
15672,58thStGreenway22ndAve,11/13/2015 12:00:00 AM,48,-122,0,0,0
15673,58thStGreenway22ndAve,11/13/2015 01:00:00 AM,48,-122,0,0,0
15674,58thStGreenway22ndAve,11/13/2015 02:00:00 AM,48,-122,1,0,1
15675,58thStGreenway22ndAve,11/13/2015 03:00:00 AM,48,-122,0,0,0
15676,58thStGreenway22ndAve,11/13/2015 04:00:00 AM,48,-122,0,0,0
15677,58thStGreenway22ndAve,11/13/2015 05:00:00 AM,48,-122,0,1,1
15678,58thStGreenway22ndAve,11/13/2015 06:00:00 AM,48,-122,0,2,2
15679,58thStGreenway22ndAve,11/13/2015 07:00:00 AM,48,-122,1,1,2
15680,58thStGreenway22ndAve,11/13/2015 08:00:00 AM,48,-122,2,5,7
15681,58thStGreenway22ndAve,11/13/2015 09:00:00 AM,48,-122,1,0,1
15682,58thStGreenway22ndAve,11/13/2015 10:00:00 AM,48,-122,1,2,3
15683,58thStGreenway22ndAve,11/13/2015 11:00:00 AM,48,-122,2,0,2
15684,58thStGreenway22ndAve,11/13/2015 12:00:00 PM,48,-122,0,0,0
15685,58thStGreenway22ndAve,11/13/2015 01:00:00 PM,48,-122,1,0,1
15686,58thStGreenway22ndAve,11/13/2015 02:00:00 PM,48,-122,1,0,1
15687,58thStGreenway22ndAve,11/13/2015 03:00:00 PM,48,-122,0,0,0
15688,58thStGreenway22ndAve,11/13/2015 04:00:00 PM,48,-122,3,0,3
15689,58thStGreenway22ndAve,11/13/2015 05:00:00 PM,48,-122,1,0,1
15690,58thStGreenway22ndAve,11/13/2015 06:00:00 PM,48,-122,1,6,7
15691,58thStGreenway22ndAve,11/13/2015 07:00:00 PM,48,-122,1,2,3
15692,58thStGreenway22ndAve,11/13/2015 08:00:00 PM,48,-122,0,0,0
15693,58thStGreenway22ndAve,11/13/2015 09:00:00 PM,48,-122,2,2,4
15694,58thStGreenway22ndAve,11/13/2015 10:00:00 PM,48,-122,3,0,3
15695,58thStGreenway22ndAve,11/13/2015 11:00:00 PM,48,-122,1,0,1
15696,58thStGreenway22ndAve,11/14/2015 12:00:00 AM,48,-122,0,0,0
15697,58thStGreenway22ndAve,11/14/2015 01:00:00 AM,48,-122,1,1,2
15698,58thStGreenway22ndAve,11/14/2015 02:00:00 AM,48,-122,0,0,0
15699,58thStGreenway22ndAve,11/14/2015 03:00:00 AM,48,-122,0,0,0
15700,58thStGreenway22ndAve,11/14/2015 04:00:00 AM,48,-122,0,0,0
15701,58thStGreenway22ndAve,11/14/2015 05:00:00 AM,48,-122,0,0,0
15702,58thStGreenway22ndAve,11/14/2015 06:00:00 AM,48,-122,2,2,4
15703,58thStGreenway22ndAve,11/14/2015 07:00:00 AM,48,-122,1,4,5
15704,58thStGreenway22ndAve,11/14/2015 08:00:00 AM,48,-122,0,0,0
15705,58thStGreenway22ndAve,11/14/2015 09:00:00 AM,48,-122,2,2,4
15706,58thStGreenway22ndAve,11/14/2015 10:00:00 AM,48,-122,2,3,5
15707,58thStGreenway22ndAve,11/14/2015 11:00:00 AM,48,-122,1,4,5
15708,58thStGreenway22ndAve,11/14/2015 12:00:00 PM,48,-122,1,5,6
15709,58thStGreenway22ndAve,11/14/2015 01:00:00 PM,48,-122,4,0,4
15710,58thStGreenway22ndAve,11/14/2015 02:00:00 PM,48,-122,3,0,3
15711,58thStGreenway22ndAve,11/14/2015 03:00:00 PM,48,-122,1,1,2
15712,58thStGreenway22ndAve,11/14/2015 04:00:00 PM,48,-122,1,1,2
15713,58thStGreenway22ndAve,11/14/2015 05:00:00 PM,48,-122,3,2,5
15714,58thStGreenway22ndAve,11/14/2015 06:00:00 PM,48,-122,1,0,1
15715,58thStGreenway22ndAve,11/14/2015 07:00:00 PM,48,-122,0,3,3
15716,58thStGreenway22ndAve,11/14/2015 08:00:00 PM,48,-122,2,0,2
15717,58thStGreenway22ndAve,11/14/2015 09:00:00 PM,48,-122,1,0,1
15718,58thStGreenway22ndAve,11/14/2015 10:00:00 PM,48,-122,0,0,0
15719,58thStGreenway22ndAve,11/14/2015 11:00:00 PM,48,-122,1,1,2
15720,58thStGreenway22ndAve,11/15/2015 12:00:00 AM,48,-122,0,0,0
15721,58thStGreenway22ndAve,11/15/2015 01:00:00 AM,48,-122,1,1,2
15722,58thStGreenway22ndAve,11/15/2015 02:00:00 AM,48,-122,0,0,0
15723,58thStGreenway22ndAve,11/15/2015 03:00:00 AM,48,-122,0,0,0
15724,58thStGreenway22ndAve,11/15/2015 04:00:00 AM,48,-122,0,0,0
15725,58thStGreenway22ndAve,11/15/2015 05:00:00 AM,48,-122,0,0,0
15726,58thStGreenway22ndAve,11/15/2015 06:00:00 AM,48,-122,0,1,1
15727,58thStGreenway22ndAve,11/15/2015 07:00:00 AM,48,-122,0,0,0
15728,58thStGreenway22ndAve,11/15/2015 08:00:00 AM,48,-122,0,0,0
15729,58thStGreenway22ndAve,11/15/2015 09:00:00 AM,48,-122,2,3,5
15730,58thStGreenway22ndAve,11/15/2015 10:00:00 AM,48,-122,4,1,5
15731,58thStGreenway22ndAve,11/15/2015 11:00:00 AM,48,-122,1,8,9
15732,58thStGreenway22ndAve,11/15/2015 12:00:00 PM,48,-122,4,5,9
15733,58thStGreenway22ndAve,11/15/2015 01:00:00 PM,48,-122,7,4,11
15734,58thStGreenway22ndAve,11/15/2015 02:00:00 PM,48,-122,7,2,9
15735,58thStGreenway22ndAve,11/15/2015 03:00:00 PM,48,-122,4,6,10
15736,58thStGreenway22ndAve,11/15/2015 04:00:00 PM,48,-122,2,5,7
15737,58thStGreenway22ndAve,11/15/2015 05:00:00 PM,48,-122,5,3,8
15738,58thStGreenway22ndAve,11/15/2015 06:00:00 PM,48,-122,3,3,6
15739,58thStGreenway22ndAve,11/15/2015 07:00:00 PM,48,-122,4,1,5
15740,58thStGreenway22ndAve,11/15/2015 08:00:00 PM,48,-122,3,1,4
15741,58thStGreenway22ndAve,11/15/2015 09:00:00 PM,48,-122,1,1,2
15742,58thStGreenway22ndAve,11/15/2015 10:00:00 PM,48,-122,0,2,2
15743,58thStGreenway22ndAve,11/15/2015 11:00:00 PM,48,-122,0,0,0
15744,58thStGreenway22ndAve,11/16/2015 12:00:00 AM,48,-122,0,0,0
15745,58thStGreenway22ndAve,11/16/2015 01:00:00 AM,48,-122,0,0,0
15746,58thStGreenway22ndAve,11/16/2015 02:00:00 AM,48,-122,0,0,0
15747,58thStGreenway22ndAve,11/16/2015 03:00:00 AM,48,-122,0,0,0
15748,58thStGreenway22ndAve,11/16/2015 04:00:00 AM,48,-122,0,0,0
15749,58thStGreenway22ndAve,11/16/2015 05:00:00 AM,48,-122,0,0,0
15750,58thStGreenway22ndAve,11/16/2015 06:00:00 AM,48,-122,0,2,2
15751,58thStGreenway22ndAve,11/16/2015 07:00:00 AM,48,-122,3,3,6
15752,58thStGreenway22ndAve,11/16/2015 08:00:00 AM,48,-122,2,4,6
15753,58thStGreenway22ndAve,11/16/2015 09:00:00 AM,48,-122,2,4,6
15754,58thStGreenway22ndAve,11/16/2015 10:00:00 AM,48,-122,2,1,3
15755,58thStGreenway22ndAve,11/16/2015 11:00:00 AM,48,-122,1,1,2
15756,58thStGreenway22ndAve,11/16/2015 12:00:00 PM,48,-122,0,1,1
15757,58thStGreenway22ndAve,11/16/2015 01:00:00 PM,48,-122,1,2,3
15758,58thStGreenway22ndAve,11/16/2015 02:00:00 PM,48,-122,1,0,1
15759,58thStGreenway22ndAve,11/16/2015 03:00:00 PM,48,-122,1,0,1
15760,58thStGreenway22ndAve,11/16/2015 04:00:00 PM,48,-122,3,1,4
15761,58thStGreenway22ndAve,11/16/2015 05:00:00 PM,48,-122,4,4,8
15762,58thStGreenway22ndAve,11/16/2015 06:00:00 PM,48,-122,2,6,8
15763,58thStGreenway22ndAve,11/16/2015 07:00:00 PM,48,-122,2,1,3
15764,58thStGreenway22ndAve,11/16/2015 08:00:00 PM,48,-122,1,3,4
15765,58thStGreenway22ndAve,11/16/2015 09:00:00 PM,48,-122,1,0,1
15766,58thStGreenway22ndAve,11/16/2015 10:00:00 PM,48,-122,1,0,1
15767,58thStGreenway22ndAve,11/16/2015 11:00:00 PM,48,-122,0,1,1
15768,58thStGreenway22ndAve,11/17/2015 12:00:00 AM,48,-122,0,0,0
15769,58thStGreenway22ndAve,11/17/2015 01:00:00 AM,48,-122,0,0,0
15770,58thStGreenway22ndAve,11/17/2015 02:00:00 AM,48,-122,0,0,0
15771,58thStGreenway22ndAve,11/17/2015 03:00:00 AM,48,-122,2,0,2
15772,58thStGreenway22ndAve,11/17/2015 04:00:00 AM,48,-122,0,0,0
15773,58thStGreenway22ndAve,11/17/2015 05:00:00 AM,48,-122,0,0,0
15774,58thStGreenway22ndAve,11/17/2015 06:00:00 AM,48,-122,0,1,1
15775,58thStGreenway22ndAve,11/17/2015 07:00:00 AM,48,-122,2,1,3
15776,58thStGreenway22ndAve,11/17/2015 08:00:00 AM,48,-122,2,4,6
15777,58thStGreenway22ndAve,11/17/2015 09:00:00 AM,48,-122,1,4,5
15778,58thStGreenway22ndAve,11/17/2015 10:00:00 AM,48,-122,1,0,1
15779,58thStGreenway22ndAve,11/17/2015 11:00:00 AM,48,-122,1,3,4
15780,58thStGreenway22ndAve,11/17/2015 12:00:00 PM,48,-122,1,1,2
15781,58thStGreenway22ndAve,11/17/2015 01:00:00 PM,48,-122,3,1,4
15782,58thStGreenway22ndAve,11/17/2015 02:00:00 PM,48,-122,2,2,4
15783,58thStGreenway22ndAve,11/17/2015 03:00:00 PM,48,-122,1,5,6
15784,58thStGreenway22ndAve,11/17/2015 04:00:00 PM,48,-122,1,0,1
15785,58thStGreenway22ndAve,11/17/2015 05:00:00 PM,48,-122,3,1,4
15786,58thStGreenway22ndAve,11/17/2015 06:00:00 PM,48,-122,1,6,7
15787,58thStGreenway22ndAve,11/17/2015 07:00:00 PM,48,-122,4,0,4
15788,58thStGreenway22ndAve,11/17/2015 08:00:00 PM,48,-122,2,1,3
15789,58thStGreenway22ndAve,11/17/2015 09:00:00 PM,48,-122,0,0,0
15790,58thStGreenway22ndAve,11/17/2015 10:00:00 PM,48,-122,1,1,2
15791,58thStGreenway22ndAve,11/17/2015 11:00:00 PM,48,-122,0,0,0
15792,58thStGreenway22ndAve,11/18/2015 12:00:00 AM,48,-122,0,0,0
15793,58thStGreenway22ndAve,11/18/2015 01:00:00 AM,48,-122,0,0,0
15794,58thStGreenway22ndAve,11/18/2015 02:00:00 AM,48,-122,0,0,0
15795,58thStGreenway22ndAve,11/18/2015 03:00:00 AM,48,-122,0,0,0
15796,58thStGreenway22ndAve,11/18/2015 04:00:00 AM,48,-122,0,0,0
15797,58thStGreenway22ndAve,11/18/2015 05:00:00 AM,48,-122,0,0,0
15798,58thStGreenway22ndAve,11/18/2015 06:00:00 AM,48,-122,0,6,6
15799,58thStGreenway22ndAve,11/18/2015 07:00:00 AM,48,-122,7,8,15
15800,58thStGreenway22ndAve,11/18/2015 08:00:00 AM,48,-122,4,2,6
15801,58thStGreenway22ndAve,11/18/2015 09:00:00 AM,48,-122,1,3,4
15802,58thStGreenway22ndAve,11/18/2015 10:00:00 AM,48,-122,3,4,7
15803,58thStGreenway22ndAve,11/18/2015 11:00:00 AM,48,-122,2,1,3
15804,58thStGreenway22ndAve,11/18/2015 12:00:00 PM,48,-122,5,3,8
15805,58thStGreenway22ndAve,11/18/2015 01:00:00 PM,48,-122,2,5,7
15806,58thStGreenway22ndAve,11/18/2015 02:00:00 PM,48,-122,2,2,4
15807,58thStGreenway22ndAve,11/18/2015 03:00:00 PM,48,-122,2,0,2
15808,58thStGreenway22ndAve,11/18/2015 04:00:00 PM,48,-122,6,2,8
15809,58thStGreenway22ndAve,11/18/2015 05:00:00 PM,48,-122,7,8,15
15810,58thStGreenway22ndAve,11/18/2015 06:00:00 PM,48,-122,8,11,19
15811,58thStGreenway22ndAve,11/18/2015 07:00:00 PM,48,-122,4,2,6
15812,58thStGreenway22ndAve,11/18/2015 08:00:00 PM,48,-122,2,0,2
15813,58thStGreenway22ndAve,11/18/2015 09:00:00 PM,48,-122,0,0,0
15814,58thStGreenway22ndAve,11/18/2015 10:00:00 PM,48,-122,0,1,1
15815,58thStGreenway22ndAve,11/18/2015 11:00:00 PM,48,-122,1,1,2
15816,58thStGreenway22ndAve,11/19/2015 12:00:00 AM,48,-122,0,1,1
15817,58thStGreenway22ndAve,11/19/2015 01:00:00 AM,48,-122,0,0,0
15818,58thStGreenway22ndAve,11/19/2015 02:00:00 AM,48,-122,0,0,0
15819,58thStGreenway22ndAve,11/19/2015 03:00:00 AM,48,-122,0,0,0
15820,58thStGreenway22ndAve,11/19/2015 04:00:00 AM,48,-122,0,1,1
15821,58thStGreenway22ndAve,11/19/2015 05:00:00 AM,48,-122,0,0,0
15822,58thStGreenway22ndAve,11/19/2015 06:00:00 AM,48,-122,0,4,4
15823,58thStGreenway22ndAve,11/19/2015 07:00:00 AM,48,-122,2,1,3
15824,58thStGreenway22ndAve,11/19/2015 08:00:00 AM,48,-122,8,2,10
15825,58thStGreenway22ndAve,11/19/2015 09:00:00 AM,48,-122,2,3,5
15826,58thStGreenway22ndAve,11/19/2015 10:00:00 AM,48,-122,3,3,6
15827,58thStGreenway22ndAve,11/19/2015 11:00:00 AM,48,-122,3,4,7
15828,58thStGreenway22ndAve,11/19/2015 12:00:00 PM,48,-122,6,4,10
15829,58thStGreenway22ndAve,11/19/2015 01:00:00 PM,48,-122,2,2,4
15830,58thStGreenway22ndAve,11/19/2015 02:00:00 PM,48,-122,1,2,3
15831,58thStGreenway22ndAve,11/19/2015 03:00:00 PM,48,-122,4,5,9
15832,58thStGreenway22ndAve,11/19/2015 04:00:00 PM,48,-122,5,6,11
15833,58thStGreenway22ndAve,11/19/2015 05:00:00 PM,48,-122,9,1,10
15834,58thStGreenway22ndAve,11/19/2015 06:00:00 PM,48,-122,1,6,7
15835,58thStGreenway22ndAve,11/19/2015 07:00:00 PM,48,-122,3,3,6
15836,58thStGreenway22ndAve,11/19/2015 08:00:00 PM,48,-122,1,2,3
15837,58thStGreenway22ndAve,11/19/2015 09:00:00 PM,48,-122,2,0,2
15838,58thStGreenway22ndAve,11/19/2015 10:00:00 PM,48,-122,1,0,1
15839,58thStGreenway22ndAve,11/19/2015 11:00:00 PM,48,-122,0,0,0
15840,58thStGreenway22ndAve,11/20/2015 12:00:00 AM,48,-122,0,1,1
15841,58thStGreenway22ndAve,11/20/2015 01:00:00 AM,48,-122,0,0,0
15842,58thStGreenway22ndAve,11/20/2015 02:00:00 AM,48,-122,0,0,0
15843,58thStGreenway22ndAve,11/20/2015 03:00:00 AM,48,-122,0,0,0
15844,58thStGreenway22ndAve,11/20/2015 04:00:00 AM,48,-122,1,0,1
15845,58thStGreenway22ndAve,11/20/2015 05:00:00 AM,48,-122,0,1,1
15846,58thStGreenway22ndAve,11/20/2015 06:00:00 AM,48,-122,0,2,2
15847,58thStGreenway22ndAve,11/20/2015 07:00:00 AM,48,-122,2,2,4
15848,58thStGreenway22ndAve,11/20/2015 08:00:00 AM,48,-122,4,3,7
15849,58thStGreenway22ndAve,11/20/2015 09:00:00 AM,48,-122,2,3,5
15850,58thStGreenway22ndAve,11/20/2015 10:00:00 AM,48,-122,5,3,8
15851,58thStGreenway22ndAve,11/20/2015 11:00:00 AM,48,-122,2,3,5
15852,58thStGreenway22ndAve,11/20/2015 12:00:00 PM,48,-122,2,5,7
15853,58thStGreenway22ndAve,11/20/2015 01:00:00 PM,48,-122,7,11,18
15854,58thStGreenway22ndAve,11/20/2015 02:00:00 PM,48,-122,2,5,7
15855,58thStGreenway22ndAve,11/20/2015 03:00:00 PM,48,-122,5,1,6
15856,58thStGreenway22ndAve,11/20/2015 04:00:00 PM,48,-122,7,4,11
15857,58thStGreenway22ndAve,11/20/2015 05:00:00 PM,48,-122,8,4,12
15858,58thStGreenway22ndAve,11/20/2015 06:00:00 PM,48,-122,2,5,7
15859,58thStGreenway22ndAve,11/20/2015 07:00:00 PM,48,-122,3,2,5
15860,58thStGreenway22ndAve,11/20/2015 08:00:00 PM,48,-122,0,0,0
15861,58thStGreenway22ndAve,11/20/2015 09:00:00 PM,48,-122,6,3,9
15862,58thStGreenway22ndAve,11/20/2015 10:00:00 PM,48,-122,0,1,1
15863,58thStGreenway22ndAve,11/20/2015 11:00:00 PM,48,-122,0,1,1
15864,58thStGreenway22ndAve,11/21/2015 12:00:00 AM,48,-122,1,1,2
15865,58thStGreenway22ndAve,11/21/2015 01:00:00 AM,48,-122,1,0,1
15866,58thStGreenway22ndAve,11/21/2015 02:00:00 AM,48,-122,0,0,0
15867,58thStGreenway22ndAve,11/21/2015 03:00:00 AM,48,-122,0,0,0
15868,58thStGreenway22ndAve,11/21/2015 04:00:00 AM,48,-122,1,1,2
15869,58thStGreenway22ndAve,11/21/2015 05:00:00 AM,48,-122,0,0,0
15870,58thStGreenway22ndAve,11/21/2015 06:00:00 AM,48,-122,0,0,0
15871,58thStGreenway22ndAve,11/21/2015 07:00:00 AM,48,-122,0,0,0
15872,58thStGreenway22ndAve,11/21/2015 08:00:00 AM,48,-122,1,0,1
15873,58thStGreenway22ndAve,11/21/2015 09:00:00 AM,48,-122,2,7,9
15874,58thStGreenway22ndAve,11/21/2015 10:00:00 AM,48,-122,1,3,4
15875,58thStGreenway22ndAve,11/21/2015 11:00:00 AM,48,-122,0,15,15
15876,58thStGreenway22ndAve,11/21/2015 12:00:00 PM,48,-122,9,6,15
15877,58thStGreenway22ndAve,11/21/2015 01:00:00 PM,48,-122,5,8,13
15878,58thStGreenway22ndAve,11/21/2015 02:00:00 PM,48,-122,7,6,13
15879,58thStGreenway22ndAve,11/21/2015 03:00:00 PM,48,-122,8,7,15
15880,58thStGreenway22ndAve,11/21/2015 04:00:00 PM,48,-122,7,7,14
15881,58thStGreenway22ndAve,11/21/2015 05:00:00 PM,48,-122,1,6,7
15882,58thStGreenway22ndAve,11/21/2015 06:00:00 PM,48,-122,1,0,1
15883,58thStGreenway22ndAve,11/21/2015 07:00:00 PM,48,-122,1,0,1
15884,58thStGreenway22ndAve,11/21/2015 08:00:00 PM,48,-122,1,3,4
15885,58thStGreenway22ndAve,11/21/2015 09:00:00 PM,48,-122,0,0,0
15886,58thStGreenway22ndAve,11/21/2015 10:00:00 PM,48,-122,0,2,2
15887,58thStGreenway22ndAve,11/21/2015 11:00:00 PM,48,-122,3,0,3
15888,58thStGreenway22ndAve,11/22/2015 12:00:00 AM,48,-122,0,2,2
15889,58thStGreenway22ndAve,11/22/2015 01:00:00 AM,48,-122,0,1,1
15890,58thStGreenway22ndAve,11/22/2015 02:00:00 AM,48,-122,0,0,0
15891,58thStGreenway22ndAve,11/22/2015 03:00:00 AM,48,-122,0,0,0
15892,58thStGreenway22ndAve,11/22/2015 04:00:00 AM,48,-122,0,0,0
15893,58thStGreenway22ndAve,11/22/2015 05:00:00 AM,48,-122,0,0,0
15894,58thStGreenway22ndAve,11/22/2015 06:00:00 AM,48,-122,0,0,0
15895,58thStGreenway22ndAve,11/22/2015 07:00:00 AM,48,-122,1,1,2
15896,58thStGreenway22ndAve,11/22/2015 08:00:00 AM,48,-122,0,0,0
15897,58thStGreenway22ndAve,11/22/2015 09:00:00 AM,48,-122,4,5,9
15898,58thStGreenway22ndAve,11/22/2015 10:00:00 AM,48,-122,1,1,2
15899,58thStGreenway22ndAve,11/22/2015 11:00:00 AM,48,-122,3,19,22
15900,58thStGreenway22ndAve,11/22/2015 12:00:00 PM,48,-122,16,5,21
15901,58thStGreenway22ndAve,11/22/2015 01:00:00 PM,48,-122,5,7,12
15902,58thStGreenway22ndAve,11/22/2015 02:00:00 PM,48,-122,8,6,14
15903,58thStGreenway22ndAve,11/22/2015 03:00:00 PM,48,-122,5,5,10
15904,58thStGreenway22ndAve,11/22/2015 04:00:00 PM,48,-122,6,6,12
15905,58thStGreenway22ndAve,11/22/2015 05:00:00 PM,48,-122,0,4,4
15906,58thStGreenway22ndAve,11/22/2015 06:00:00 PM,48,-122,1,0,1
15907,58thStGreenway22ndAve,11/22/2015 07:00:00 PM,48,-122,2,2,4
15908,58thStGreenway22ndAve,11/22/2015 08:00:00 PM,48,-122,4,2,6
15909,58thStGreenway22ndAve,11/22/2015 09:00:00 PM,48,-122,0,1,1
15910,58thStGreenway22ndAve,11/22/2015 10:00:00 PM,48,-122,0,0,0
15911,58thStGreenway22ndAve,11/22/2015 11:00:00 PM,48,-122,0,1,1
15912,58thStGreenway22ndAve,11/23/2015 12:00:00 AM,48,-122,0,0,0
15913,58thStGreenway22ndAve,11/23/2015 01:00:00 AM,48,-122,0,0,0
15914,58thStGreenway22ndAve,11/23/2015 02:00:00 AM,48,-122,0,0,0
15915,58thStGreenway22ndAve,11/23/2015 03:00:00 AM,48,-122,0,0,0
15916,58thStGreenway22ndAve,11/23/2015 04:00:00 AM,48,-122,1,1,2
15917,58thStGreenway22ndAve,11/23/2015 05:00:00 AM,48,-122,0,1,1
15918,58thStGreenway22ndAve,11/23/2015 06:00:00 AM,48,-122,0,2,2
15919,58thStGreenway22ndAve,11/23/2015 07:00:00 AM,48,-122,2,2,4
15920,58thStGreenway22ndAve,11/23/2015 08:00:00 AM,48,-122,6,5,11
15921,58thStGreenway22ndAve,11/23/2015 09:00:00 AM,48,-122,0,3,3
15922,58thStGreenway22ndAve,11/23/2015 10:00:00 AM,48,-122,2,6,8
15923,58thStGreenway22ndAve,11/23/2015 11:00:00 AM,48,-122,0,3,3
15924,58thStGreenway22ndAve,11/23/2015 12:00:00 PM,48,-122,3,1,4
15925,58thStGreenway22ndAve,11/23/2015 01:00:00 PM,48,-122,0,1,1
15926,58thStGreenway22ndAve,11/23/2015 02:00:00 PM,48,-122,6,0,6
15927,58thStGreenway22ndAve,11/23/2015 03:00:00 PM,48,-122,0,0,0
15928,58thStGreenway22ndAve,11/23/2015 04:00:00 PM,48,-122,4,2,6
15929,58thStGreenway22ndAve,11/23/2015 05:00:00 PM,48,-122,6,3,9
15930,58thStGreenway22ndAve,11/23/2015 06:00:00 PM,48,-122,3,4,7
15931,58thStGreenway22ndAve,11/23/2015 07:00:00 PM,48,-122,1,2,3
15932,58thStGreenway22ndAve,11/23/2015 08:00:00 PM,48,-122,2,2,4
15933,58thStGreenway22ndAve,11/23/2015 09:00:00 PM,48,-122,0,0,0
15934,58thStGreenway22ndAve,11/23/2015 10:00:00 PM,48,-122,1,1,2
15935,58thStGreenway22ndAve,11/23/2015 11:00:00 PM,48,-122,1,0,1
15936,58thStGreenway22ndAve,11/24/2015 12:00:00 AM,48,-122,0,0,0
15937,58thStGreenway22ndAve,11/24/2015 01:00:00 AM,48,-122,0,0,0
15938,58thStGreenway22ndAve,11/24/2015 02:00:00 AM,48,-122,0,0,0
15939,58thStGreenway22ndAve,11/24/2015 03:00:00 AM,48,-122,0,0,0
15940,58thStGreenway22ndAve,11/24/2015 04:00:00 AM,48,-122,0,1,1
15941,58thStGreenway22ndAve,11/24/2015 05:00:00 AM,48,-122,1,4,5
15942,58thStGreenway22ndAve,11/24/2015 06:00:00 AM,48,-122,4,1,5
15943,58thStGreenway22ndAve,11/24/2015 07:00:00 AM,48,-122,4,0,4
15944,58thStGreenway22ndAve,11/24/2015 08:00:00 AM,48,-122,1,1,2
15945,58thStGreenway22ndAve,11/24/2015 09:00:00 AM,48,-122,2,4,6
15946,58thStGreenway22ndAve,11/24/2015 10:00:00 AM,48,-122,2,3,5
15947,58thStGreenway22ndAve,11/24/2015 11:00:00 AM,48,-122,2,2,4
15948,58thStGreenway22ndAve,11/24/2015 12:00:00 PM,48,-122,8,3,11
15949,58thStGreenway22ndAve,11/24/2015 01:00:00 PM,48,-122,3,3,6
15950,58thStGreenway22ndAve,11/24/2015 02:00:00 PM,48,-122,1,5,6
15951,58thStGreenway22ndAve,11/24/2015 03:00:00 PM,48,-122,2,2,4
15952,58thStGreenway22ndAve,11/24/2015 04:00:00 PM,48,-122,1,2,3
15953,58thStGreenway22ndAve,11/24/2015 05:00:00 PM,48,-122,2,3,5
15954,58thStGreenway22ndAve,11/24/2015 06:00:00 PM,48,-122,1,6,7
15955,58thStGreenway22ndAve,11/24/2015 07:00:00 PM,48,-122,6,1,7
15956,58thStGreenway22ndAve,11/24/2015 08:00:00 PM,48,-122,1,3,4
15957,58thStGreenway22ndAve,11/24/2015 09:00:00 PM,48,-122,1,0,1
15958,58thStGreenway22ndAve,11/24/2015 10:00:00 PM,48,-122,1,0,1
15959,58thStGreenway22ndAve,11/24/2015 11:00:00 PM,48,-122,0,0,0
15960,58thStGreenway22ndAve,11/25/2015 12:00:00 AM,48,-122,0,1,1
15961,58thStGreenway22ndAve,11/25/2015 01:00:00 AM,48,-122,0,0,0
15962,58thStGreenway22ndAve,11/25/2015 02:00:00 AM,48,-122,0,0,0
15963,58thStGreenway22ndAve,11/25/2015 03:00:00 AM,48,-122,0,0,0
15964,58thStGreenway22ndAve,11/25/2015 04:00:00 AM,48,-122,0,1,1
15965,58thStGreenway22ndAve,11/25/2015 05:00:00 AM,48,-122,0,1,1
15966,58thStGreenway22ndAve,11/25/2015 06:00:00 AM,48,-122,1,1,2
15967,58thStGreenway22ndAve,11/25/2015 07:00:00 AM,48,-122,6,5,11
15968,58thStGreenway22ndAve,11/25/2015 08:00:00 AM,48,-122,1,4,5
15969,58thStGreenway22ndAve,11/25/2015 09:00:00 AM,48,-122,3,1,4
15970,58thStGreenway22ndAve,11/25/2015 10:00:00 AM,48,-122,4,5,9
15971,58thStGreenway22ndAve,11/25/2015 11:00:00 AM,48,-122,3,4,7
15972,58thStGreenway22ndAve,11/25/2015 12:00:00 PM,48,-122,3,3,6
15973,58thStGreenway22ndAve,11/25/2015 01:00:00 PM,48,-122,1,5,6
15974,58thStGreenway22ndAve,11/25/2015 02:00:00 PM,48,-122,2,3,5
15975,58thStGreenway22ndAve,11/25/2015 03:00:00 PM,48,-122,5,2,7
15976,58thStGreenway22ndAve,11/25/2015 04:00:00 PM,48,-122,6,8,14
15977,58thStGreenway22ndAve,11/25/2015 05:00:00 PM,48,-122,2,5,7
15978,58thStGreenway22ndAve,11/25/2015 06:00:00 PM,48,-122,6,3,9
15979,58thStGreenway22ndAve,11/25/2015 07:00:00 PM,48,-122,0,1,1
15980,58thStGreenway22ndAve,11/25/2015 08:00:00 PM,48,-122,1,0,1
15981,58thStGreenway22ndAve,11/25/2015 09:00:00 PM,48,-122,0,0,0
15982,58thStGreenway22ndAve,11/25/2015 10:00:00 PM,48,-122,0,2,2
15983,58thStGreenway22ndAve,11/25/2015 11:00:00 PM,48,-122,0,0,0
15984,58thStGreenway22ndAve,11/26/2015 12:00:00 AM,48,-122,0,0,0
15985,58thStGreenway22ndAve,11/26/2015 01:00:00 AM,48,-122,0,0,0
15986,58thStGreenway22ndAve,11/26/2015 02:00:00 AM,48,-122,1,1,2
15987,58thStGreenway22ndAve,11/26/2015 03:00:00 AM,48,-122,0,1,1
15988,58thStGreenway22ndAve,11/26/2015 04:00:00 AM,48,-122,0,0,0
15989,58thStGreenway22ndAve,11/26/2015 05:00:00 AM,48,-122,0,0,0
15990,58thStGreenway22ndAve,11/26/2015 06:00:00 AM,48,-122,0,0,0
15991,58thStGreenway22ndAve,11/26/2015 07:00:00 AM,48,-122,0,0,0
15992,58thStGreenway22ndAve,11/26/2015 08:00:00 AM,48,-122,1,0,1
15993,58thStGreenway22ndAve,11/26/2015 09:00:00 AM,48,-122,0,0,0
15994,58thStGreenway22ndAve,11/26/2015 10:00:00 AM,48,-122,1,1,2
15995,58thStGreenway22ndAve,11/26/2015 11:00:00 AM,48,-122,1,7,8
15996,58thStGreenway22ndAve,11/26/2015 12:00:00 PM,48,-122,2,2,4
15997,58thStGreenway22ndAve,11/26/2015 01:00:00 PM,48,-122,2,2,4
15998,58thStGreenway22ndAve,11/26/2015 02:00:00 PM,48,-122,3,3,6
15999,58thStGreenway22ndAve,11/26/2015 03:00:00 PM,48,-122,0,1,1
16000,58thStGreenway22ndAve,11/26/2015 04:00:00 PM,48,-122,0,0,0
16001,58thStGreenway22ndAve,11/26/2015 05:00:00 PM,48,-122,0,4,4
16002,58thStGreenway22ndAve,11/26/2015 06:00:00 PM,48,-122,4,1,5
16003,58thStGreenway22ndAve,11/26/2015 07:00:00 PM,48,-122,0,0,0
16004,58thStGreenway22ndAve,11/26/2015 08:00:00 PM,48,-122,2,0,2
16005,58thStGreenway22ndAve,11/26/2015 09:00:00 PM,48,-122,0,0,0
16006,58thStGreenway22ndAve,11/26/2015 10:00:00 PM,48,-122,1,0,1
16007,58thStGreenway22ndAve,11/26/2015 11:00:00 PM,48,-122,0,0,0
16008,58thStGreenway22ndAve,11/27/2015 12:00:00 AM,48,-122,0,3,3
16009,58thStGreenway22ndAve,11/27/2015 01:00:00 AM,48,-122,0,0,0
16010,58thStGreenway22ndAve,11/27/2015 02:00:00 AM,48,-122,0,0,0
16011,58thStGreenway22ndAve,11/27/2015 03:00:00 AM,48,-122,0,0,0
16012,58thStGreenway22ndAve,11/27/2015 04:00:00 AM,48,-122,0,0,0
16013,58thStGreenway22ndAve,11/27/2015 05:00:00 AM,48,-122,0,0,0
16014,58thStGreenway22ndAve,11/27/2015 06:00:00 AM,48,-122,0,0,0
16015,58thStGreenway22ndAve,11/27/2015 07:00:00 AM,48,-122,0,0,0
16016,58thStGreenway22ndAve,11/27/2015 08:00:00 AM,48,-122,0,0,0
16017,58thStGreenway22ndAve,11/27/2015 09:00:00 AM,48,-122,2,2,4
16018,58thStGreenway22ndAve,11/27/2015 10:00:00 AM,48,-122,1,1,2
16019,58thStGreenway22ndAve,11/27/2015 11:00:00 AM,48,-122,1,2,3
16020,58thStGreenway22ndAve,11/27/2015 12:00:00 PM,48,-122,4,7,11
16021,58thStGreenway22ndAve,11/27/2015 01:00:00 PM,48,-122,5,5,10
16022,58thStGreenway22ndAve,11/27/2015 02:00:00 PM,48,-122,1,0,1
16023,58thStGreenway22ndAve,11/27/2015 03:00:00 PM,48,-122,2,2,4
16024,58thStGreenway22ndAve,11/27/2015 04:00:00 PM,48,-122,3,4,7
16025,58thStGreenway22ndAve,11/27/2015 05:00:00 PM,48,-122,1,2,3
16026,58thStGreenway22ndAve,11/27/2015 06:00:00 PM,48,-122,1,0,1
16027,58thStGreenway22ndAve,11/27/2015 07:00:00 PM,48,-122,0,0,0
16028,58thStGreenway22ndAve,11/27/2015 08:00:00 PM,48,-122,3,1,4
16029,58thStGreenway22ndAve,11/27/2015 09:00:00 PM,48,-122,0,0,0
16030,58thStGreenway22ndAve,11/27/2015 10:00:00 PM,48,-122,0,2,2
16031,58thStGreenway22ndAve,11/27/2015 11:00:00 PM,48,-122,1,0,1
16032,58thStGreenway22ndAve,11/28/2015 12:00:00 AM,48,-122,0,0,0
16033,58thStGreenway22ndAve,11/28/2015 01:00:00 AM,48,-122,0,1,1
16034,58thStGreenway22ndAve,11/28/2015 02:00:00 AM,48,-122,0,0,0
16035,58thStGreenway22ndAve,11/28/2015 03:00:00 AM,48,-122,0,0,0
16036,58thStGreenway22ndAve,11/28/2015 04:00:00 AM,48,-122,0,1,1
16037,58thStGreenway22ndAve,11/28/2015 05:00:00 AM,48,-122,0,0,0
16038,58thStGreenway22ndAve,11/28/2015 06:00:00 AM,48,-122,0,0,0
16039,58thStGreenway22ndAve,11/28/2015 07:00:00 AM,48,-122,0,0,0
16040,58thStGreenway22ndAve,11/28/2015 08:00:00 AM,48,-122,1,3,4
16041,58thStGreenway22ndAve,11/28/2015 09:00:00 AM,48,-122,1,3,4
16042,58thStGreenway22ndAve,11/28/2015 10:00:00 AM,48,-122,5,2,7
16043,58thStGreenway22ndAve,11/28/2015 11:00:00 AM,48,-122,4,3,7
16044,58thStGreenway22ndAve,11/28/2015 12:00:00 PM,48,-122,2,1,3
16045,58thStGreenway22ndAve,11/28/2015 01:00:00 PM,48,-122,3,2,5
16046,58thStGreenway22ndAve,11/28/2015 02:00:00 PM,48,-122,6,4,10
16047,58thStGreenway22ndAve,11/28/2015 03:00:00 PM,48,-122,2,2,4
16048,58thStGreenway22ndAve,11/28/2015 04:00:00 PM,48,-122,4,5,9
16049,58thStGreenway22ndAve,11/28/2015 05:00:00 PM,48,-122,4,3,7
16050,58thStGreenway22ndAve,11/28/2015 06:00:00 PM,48,-122,0,2,2
16051,58thStGreenway22ndAve,11/28/2015 07:00:00 PM,48,-122,0,1,1
16052,58thStGreenway22ndAve,11/28/2015 08:00:00 PM,48,-122,0,0,0
16053,58thStGreenway22ndAve,11/28/2015 09:00:00 PM,48,-122,3,0,3
16054,58thStGreenway22ndAve,11/28/2015 10:00:00 PM,48,-122,2,0,2
16055,58thStGreenway22ndAve,11/28/2015 11:00:00 PM,48,-122,1,3,4
16056,58thStGreenway22ndAve,11/29/2015 12:00:00 AM,48,-122,0,0,0
16057,58thStGreenway22ndAve,11/29/2015 01:00:00 AM,48,-122,0,2,2
16058,58thStGreenway22ndAve,11/29/2015 02:00:00 AM,48,-122,0,0,0
16059,58thStGreenway22ndAve,11/29/2015 03:00:00 AM,48,-122,1,0,1
16060,58thStGreenway22ndAve,11/29/2015 04:00:00 AM,48,-122,0,0,0
16061,58thStGreenway22ndAve,11/29/2015 05:00:00 AM,48,-122,0,0,0
16062,58thStGreenway22ndAve,11/29/2015 06:00:00 AM,48,-122,0,0,0
16063,58thStGreenway22ndAve,11/29/2015 07:00:00 AM,48,-122,1,0,1
16064,58thStGreenway22ndAve,11/29/2015 08:00:00 AM,48,-122,0,1,1
16065,58thStGreenway22ndAve,11/29/2015 09:00:00 AM,48,-122,2,7,9
16066,58thStGreenway22ndAve,11/29/2015 10:00:00 AM,48,-122,4,1,5
16067,58thStGreenway22ndAve,11/29/2015 11:00:00 AM,48,-122,1,21,22
16068,58thStGreenway22ndAve,11/29/2015 12:00:00 PM,48,-122,3,1,4
16069,58thStGreenway22ndAve,11/29/2015 01:00:00 PM,48,-122,2,5,7
16070,58thStGreenway22ndAve,11/29/2015 02:00:00 PM,48,-122,3,3,6
16071,58thStGreenway22ndAve,11/29/2015 03:00:00 PM,48,-122,8,2,10
16072,58thStGreenway22ndAve,11/29/2015 04:00:00 PM,48,-122,3,5,8
16073,58thStGreenway22ndAve,11/29/2015 05:00:00 PM,48,-122,0,2,2
16074,58thStGreenway22ndAve,11/29/2015 06:00:00 PM,48,-122,2,2,4
16075,58thStGreenway22ndAve,11/29/2015 07:00:00 PM,48,-122,2,1,3
16076,58thStGreenway22ndAve,11/29/2015 08:00:00 PM,48,-122,1,1,2
16077,58thStGreenway22ndAve,11/29/2015 09:00:00 PM,48,-122,0,0,0
16078,58thStGreenway22ndAve,11/29/2015 10:00:00 PM,48,-122,0,0,0
16079,58thStGreenway22ndAve,11/29/2015 11:00:00 PM,48,-122,0,1,1
16080,58thStGreenway22ndAve,11/30/2015 12:00:00 AM,48,-122,0,0,0
16081,58thStGreenway22ndAve,11/30/2015 01:00:00 AM,48,-122,0,0,0
16082,58thStGreenway22ndAve,11/30/2015 02:00:00 AM,48,-122,0,0,0
16083,58thStGreenway22ndAve,11/30/2015 03:00:00 AM,48,-122,0,0,0
16084,58thStGreenway22ndAve,11/30/2015 04:00:00 AM,48,-122,0,0,0
16085,58thStGreenway22ndAve,11/30/2015 05:00:00 AM,48,-122,0,0,0
16086,58thStGreenway22ndAve,11/30/2015 06:00:00 AM,48,-122,0,2,2
16087,58thStGreenway22ndAve,11/30/2015 07:00:00 AM,48,-122,4,2,6
16088,58thStGreenway22ndAve,11/30/2015 08:00:00 AM,48,-122,5,3,8
16089,58thStGreenway22ndAve,11/30/2015 09:00:00 AM,48,-122,2,2,4
16090,58thStGreenway22ndAve,11/30/2015 10:00:00 AM,48,-122,3,1,4
16091,58thStGreenway22ndAve,11/30/2015 11:00:00 AM,48,-122,1,1,2
16092,58thStGreenway22ndAve,11/30/2015 12:00:00 PM,48,-122,3,5,8
16093,58thStGreenway22ndAve,11/30/2015 01:00:00 PM,48,-122,1,4,5
16094,58thStGreenway22ndAve,11/30/2015 02:00:00 PM,48,-122,4,4,8
16095,58thStGreenway22ndAve,11/30/2015 03:00:00 PM,48,-122,3,3,6
16096,58thStGreenway22ndAve,11/30/2015 04:00:00 PM,48,-122,2,3,5
16097,58thStGreenway22ndAve,11/30/2015 05:00:00 PM,48,-122,6,1,7
16098,58thStGreenway22ndAve,11/30/2015 06:00:00 PM,48,-122,1,8,9
16099,58thStGreenway22ndAve,11/30/2015 07:00:00 PM,48,-122,2,0,2
16100,58thStGreenway22ndAve,11/30/2015 08:00:00 PM,48,-122,1,2,3
16101,58thStGreenway22ndAve,11/30/2015 09:00:00 PM,48,-122,2,0,2
16102,58thStGreenway22ndAve,11/30/2015 10:00:00 PM,48,-122,1,1,2
16103,58thStGreenway22ndAve,11/30/2015 11:00:00 PM,48,-122,0,1,1
16104,58thStGreenway22ndAve,12/01/2015 12:00:00 AM,48,-122,0,1,1
16105,58thStGreenway22ndAve,12/01/2015 01:00:00 AM,48,-122,0,0,0
16106,58thStGreenway22ndAve,12/01/2015 02:00:00 AM,48,-122,0,1,1
16107,58thStGreenway22ndAve,12/01/2015 03:00:00 AM,48,-122,1,0,1
16108,58thStGreenway22ndAve,12/01/2015 04:00:00 AM,48,-122,0,1,1
16109,58thStGreenway22ndAve,12/01/2015 05:00:00 AM,48,-122,0,1,1
16110,58thStGreenway22ndAve,12/01/2015 06:00:00 AM,48,-122,0,2,2
16111,58thStGreenway22ndAve,12/01/2015 07:00:00 AM,48,-122,5,0,5
16112,58thStGreenway22ndAve,12/01/2015 08:00:00 AM,48,-122,3,3,6
16113,58thStGreenway22ndAve,12/01/2015 09:00:00 AM,48,-122,6,8,14
16114,58thStGreenway22ndAve,12/01/2015 10:00:00 AM,48,-122,1,2,3
16115,58thStGreenway22ndAve,12/01/2015 11:00:00 AM,48,-122,1,4,5
16116,58thStGreenway22ndAve,12/01/2015 12:00:00 PM,48,-122,4,2,6
16117,58thStGreenway22ndAve,12/01/2015 01:00:00 PM,48,-122,0,1,1
16118,58thStGreenway22ndAve,12/01/2015 02:00:00 PM,48,-122,1,1,2
16119,58thStGreenway22ndAve,12/01/2015 03:00:00 PM,48,-122,5,2,7
16120,58thStGreenway22ndAve,12/01/2015 04:00:00 PM,48,-122,3,4,7
16121,58thStGreenway22ndAve,12/01/2015 05:00:00 PM,48,-122,4,4,8
16122,58thStGreenway22ndAve,12/01/2015 06:00:00 PM,48,-122,4,8,12
16123,58thStGreenway22ndAve,12/01/2015 07:00:00 PM,48,-122,4,4,8
16124,58thStGreenway22ndAve,12/01/2015 08:00:00 PM,48,-122,0,1,1
16125,58thStGreenway22ndAve,12/01/2015 09:00:00 PM,48,-122,1,0,1
16126,58thStGreenway22ndAve,12/01/2015 10:00:00 PM,48,-122,1,1,2
16127,58thStGreenway22ndAve,12/01/2015 11:00:00 PM,48,-122,0,2,2
16128,58thStGreenway22ndAve,12/02/2015 12:00:00 AM,48,-122,1,0,1
16129,58thStGreenway22ndAve,12/02/2015 01:00:00 AM,48,-122,0,0,0
16130,58thStGreenway22ndAve,12/02/2015 02:00:00 AM,48,-122,0,0,0
16131,58thStGreenway22ndAve,12/02/2015 03:00:00 AM,48,-122,1,0,1
16132,58thStGreenway22ndAve,12/02/2015 04:00:00 AM,48,-122,0,1,1
16133,58thStGreenway22ndAve,12/02/2015 05:00:00 AM,48,-122,0,0,0
16134,58thStGreenway22ndAve,12/02/2015 06:00:00 AM,48,-122,0,2,2
16135,58thStGreenway22ndAve,12/02/2015 07:00:00 AM,48,-122,7,2,9
16136,58thStGreenway22ndAve,12/02/2015 08:00:00 AM,48,-122,2,0,2
16137,58thStGreenway22ndAve,12/02/2015 09:00:00 AM,48,-122,5,5,10
16138,58thStGreenway22ndAve,12/02/2015 10:00:00 AM,48,-122,4,3,7
16139,58thStGreenway22ndAve,12/02/2015 11:00:00 AM,48,-122,3,4,7
16140,58thStGreenway22ndAve,12/02/2015 12:00:00 PM,48,-122,1,1,2
16141,58thStGreenway22ndAve,12/02/2015 01:00:00 PM,48,-122,4,1,5
16142,58thStGreenway22ndAve,12/02/2015 02:00:00 PM,48,-122,3,2,5
16143,58thStGreenway22ndAve,12/02/2015 03:00:00 PM,48,-122,2,1,3
16144,58thStGreenway22ndAve,12/02/2015 04:00:00 PM,48,-122,7,2,9
16145,58thStGreenway22ndAve,12/02/2015 05:00:00 PM,48,-122,7,0,7
16146,58thStGreenway22ndAve,12/02/2015 06:00:00 PM,48,-122,0,6,6
16147,58thStGreenway22ndAve,12/02/2015 07:00:00 PM,48,-122,3,3,6
16148,58thStGreenway22ndAve,12/02/2015 08:00:00 PM,48,-122,0,1,1
16149,58thStGreenway22ndAve,12/02/2015 09:00:00 PM,48,-122,2,3,5
16150,58thStGreenway22ndAve,12/02/2015 10:00:00 PM,48,-122,3,2,5
16151,58thStGreenway22ndAve,12/02/2015 11:00:00 PM,48,-122,1,1,2
16152,58thStGreenway22ndAve,12/03/2015 12:00:00 AM,48,-122,0,0,0
16153,58thStGreenway22ndAve,12/03/2015 01:00:00 AM,48,-122,2,0,2
16154,58thStGreenway22ndAve,12/03/2015 02:00:00 AM,48,-122,0,0,0
16155,58thStGreenway22ndAve,12/03/2015 03:00:00 AM,48,-122,1,1,2
16156,58thStGreenway22ndAve,12/03/2015 04:00:00 AM,48,-122,0,0,0
16157,58thStGreenway22ndAve,12/03/2015 05:00:00 AM,48,-122,0,0,0
16158,58thStGreenway22ndAve,12/03/2015 06:00:00 AM,48,-122,2,2,4
16159,58thStGreenway22ndAve,12/03/2015 07:00:00 AM,48,-122,5,3,8
16160,58thStGreenway22ndAve,12/03/2015 08:00:00 AM,48,-122,2,1,3
16161,58thStGreenway22ndAve,12/03/2015 09:00:00 AM,48,-122,1,2,3
16162,58thStGreenway22ndAve,12/03/2015 10:00:00 AM,48,-122,1,0,1
16163,58thStGreenway22ndAve,12/03/2015 11:00:00 AM,48,-122,2,4,6
16164,58thStGreenway22ndAve,12/03/2015 12:00:00 PM,48,-122,3,1,4
16165,58thStGreenway22ndAve,12/03/2015 01:00:00 PM,48,-122,0,5,5
16166,58thStGreenway22ndAve,12/03/2015 02:00:00 PM,48,-122,3,3,6
16167,58thStGreenway22ndAve,12/03/2015 03:00:00 PM,48,-122,4,2,6
16168,58thStGreenway22ndAve,12/03/2015 04:00:00 PM,48,-122,3,0,3
16169,58thStGreenway22ndAve,12/03/2015 05:00:00 PM,48,-122,2,6,8
16170,58thStGreenway22ndAve,12/03/2015 06:00:00 PM,48,-122,2,1,3
16171,58thStGreenway22ndAve,12/03/2015 07:00:00 PM,48,-122,2,2,4
16172,58thStGreenway22ndAve,12/03/2015 08:00:00 PM,48,-122,3,0,3
16173,58thStGreenway22ndAve,12/03/2015 09:00:00 PM,48,-122,1,0,1
16174,58thStGreenway22ndAve,12/03/2015 10:00:00 PM,48,-122,0,0,0
16175,58thStGreenway22ndAve,12/03/2015 11:00:00 PM,48,-122,0,0,0
16176,58thStGreenway22ndAve,12/04/2015 12:00:00 AM,48,-122,0,0,0
16177,58thStGreenway22ndAve,12/04/2015 01:00:00 AM,48,-122,0,0,0
16178,58thStGreenway22ndAve,12/04/2015 02:00:00 AM,48,-122,0,1,1
16179,58thStGreenway22ndAve,12/04/2015 03:00:00 AM,48,-122,0,0,0
16180,58thStGreenway22ndAve,12/04/2015 04:00:00 AM,48,-122,0,0,0
16181,58thStGreenway22ndAve,12/04/2015 05:00:00 AM,48,-122,1,0,1
16182,58thStGreenway22ndAve,12/04/2015 06:00:00 AM,48,-122,0,2,2
16183,58thStGreenway22ndAve,12/04/2015 07:00:00 AM,48,-122,2,0,2
16184,58thStGreenway22ndAve,12/04/2015 08:00:00 AM,48,-122,4,5,9
16185,58thStGreenway22ndAve,12/04/2015 09:00:00 AM,48,-122,3,2,5
16186,58thStGreenway22ndAve,12/04/2015 10:00:00 AM,48,-122,3,0,3
16187,58thStGreenway22ndAve,12/04/2015 11:00:00 AM,48,-122,2,1,3
16188,58thStGreenway22ndAve,12/04/2015 12:00:00 PM,48,-122,2,0,2
16189,58thStGreenway22ndAve,12/04/2015 01:00:00 PM,48,-122,7,4,11
16190,58thStGreenway22ndAve,12/04/2015 02:00:00 PM,48,-122,1,1,2
16191,58thStGreenway22ndAve,12/04/2015 03:00:00 PM,48,-122,3,2,5
16192,58thStGreenway22ndAve,12/04/2015 04:00:00 PM,48,-122,4,3,7
16193,58thStGreenway22ndAve,12/04/2015 05:00:00 PM,48,-122,10,6,16
16194,58thStGreenway22ndAve,12/04/2015 06:00:00 PM,48,-122,0,5,5
16195,58thStGreenway22ndAve,12/04/2015 07:00:00 PM,48,-122,0,2,2
16196,58thStGreenway22ndAve,12/04/2015 08:00:00 PM,48,-122,0,2,2
16197,58thStGreenway22ndAve,12/04/2015 09:00:00 PM,48,-122,0,0,0
16198,58thStGreenway22ndAve,12/04/2015 10:00:00 PM,48,-122,0,2,2
16199,58thStGreenway22ndAve,12/04/2015 11:00:00 PM,48,-122,1,1,2
16200,58thStGreenway22ndAve,12/05/2015 12:00:00 AM,48,-122,0,2,2
16201,58thStGreenway22ndAve,12/05/2015 01:00:00 AM,48,-122,0,0,0
16202,58thStGreenway22ndAve,12/05/2015 02:00:00 AM,48,-122,0,0,0
16203,58thStGreenway22ndAve,12/05/2015 03:00:00 AM,48,-122,0,0,0
16204,58thStGreenway22ndAve,12/05/2015 04:00:00 AM,48,-122,0,0,0
16205,58thStGreenway22ndAve,12/05/2015 05:00:00 AM,48,-122,0,0,0
16206,58thStGreenway22ndAve,12/05/2015 06:00:00 AM,48,-122,2,0,2
16207,58thStGreenway22ndAve,12/05/2015 07:00:00 AM,48,-122,0,0,0
16208,58thStGreenway22ndAve,12/05/2015 08:00:00 AM,48,-122,1,1,2
16209,58thStGreenway22ndAve,12/05/2015 09:00:00 AM,48,-122,2,1,3
16210,58thStGreenway22ndAve,12/05/2015 10:00:00 AM,48,-122,0,0,0
16211,58thStGreenway22ndAve,12/05/2015 11:00:00 AM,48,-122,0,3,3
16212,58thStGreenway22ndAve,12/05/2015 12:00:00 PM,48,-122,0,1,1
16213,58thStGreenway22ndAve,12/05/2015 01:00:00 PM,48,-122,0,1,1
16214,58thStGreenway22ndAve,12/05/2015 02:00:00 PM,48,-122,0,0,0
16215,58thStGreenway22ndAve,12/05/2015 03:00:00 PM,48,-122,0,1,1
16216,58thStGreenway22ndAve,12/05/2015 04:00:00 PM,48,-122,4,2,6
16217,58thStGreenway22ndAve,12/05/2015 05:00:00 PM,48,-122,2,2,4
16218,58thStGreenway22ndAve,12/05/2015 06:00:00 PM,48,-122,3,1,4
16219,58thStGreenway22ndAve,12/05/2015 07:00:00 PM,48,-122,1,1,2
16220,58thStGreenway22ndAve,12/05/2015 08:00:00 PM,48,-122,0,0,0
16221,58thStGreenway22ndAve,12/05/2015 09:00:00 PM,48,-122,0,0,0
16222,58thStGreenway22ndAve,12/05/2015 10:00:00 PM,48,-122,0,0,0
16223,58thStGreenway22ndAve,12/05/2015 11:00:00 PM,48,-122,0,0,0
16224,58thStGreenway22ndAve,12/06/2015 12:00:00 AM,48,-122,0,1,1
16225,58thStGreenway22ndAve,12/06/2015 01:00:00 AM,48,-122,0,0,0
16226,58thStGreenway22ndAve,12/06/2015 02:00:00 AM,48,-122,0,0,0
16227,58thStGreenway22ndAve,12/06/2015 03:00:00 AM,48,-122,0,0,0
16228,58thStGreenway22ndAve,12/06/2015 04:00:00 AM,48,-122,0,0,0
16229,58thStGreenway22ndAve,12/06/2015 05:00:00 AM,48,-122,0,0,0
16230,58thStGreenway22ndAve,12/06/2015 06:00:00 AM,48,-122,0,1,1
16231,58thStGreenway22ndAve,12/06/2015 07:00:00 AM,48,-122,2,0,2
16232,58thStGreenway22ndAve,12/06/2015 08:00:00 AM,48,-122,2,1,3
16233,58thStGreenway22ndAve,12/06/2015 09:00:00 AM,48,-122,1,3,4
16234,58thStGreenway22ndAve,12/06/2015 10:00:00 AM,48,-122,2,3,5
16235,58thStGreenway22ndAve,12/06/2015 11:00:00 AM,48,-122,3,2,5
16236,58thStGreenway22ndAve,12/06/2015 12:00:00 PM,48,-122,3,2,5
16237,58thStGreenway22ndAve,12/06/2015 01:00:00 PM,48,-122,1,4,5
16238,58thStGreenway22ndAve,12/06/2015 02:00:00 PM,48,-122,2,4,6
16239,58thStGreenway22ndAve,12/06/2015 03:00:00 PM,48,-122,7,5,12
16240,58thStGreenway22ndAve,12/06/2015 04:00:00 PM,48,-122,2,4,6
16241,58thStGreenway22ndAve,12/06/2015 05:00:00 PM,48,-122,2,0,2
16242,58thStGreenway22ndAve,12/06/2015 06:00:00 PM,48,-122,4,1,5
16243,58thStGreenway22ndAve,12/06/2015 07:00:00 PM,48,-122,1,1,2
16244,58thStGreenway22ndAve,12/06/2015 08:00:00 PM,48,-122,0,1,1
16245,58thStGreenway22ndAve,12/06/2015 09:00:00 PM,48,-122,0,0,0
16246,58thStGreenway22ndAve,12/06/2015 10:00:00 PM,48,-122,0,0,0
16247,58thStGreenway22ndAve,12/06/2015 11:00:00 PM,48,-122,0,0,0
16248,58thStGreenway22ndAve,12/07/2015 12:00:00 AM,48,-122,0,0,0
16249,58thStGreenway22ndAve,12/07/2015 01:00:00 AM,48,-122,0,0,0
16250,58thStGreenway22ndAve,12/07/2015 02:00:00 AM,48,-122,1,0,1
16251,58thStGreenway22ndAve,12/07/2015 03:00:00 AM,48,-122,0,0,0
16252,58thStGreenway22ndAve,12/07/2015 04:00:00 AM,48,-122,0,0,0
16253,58thStGreenway22ndAve,12/07/2015 05:00:00 AM,48,-122,0,1,1
16254,58thStGreenway22ndAve,12/07/2015 06:00:00 AM,48,-122,1,3,4
16255,58thStGreenway22ndAve,12/07/2015 07:00:00 AM,48,-122,5,0,5
16256,58thStGreenway22ndAve,12/07/2015 08:00:00 AM,48,-122,3,4,7
16257,58thStGreenway22ndAve,12/07/2015 09:00:00 AM,48,-122,7,4,11
16258,58thStGreenway22ndAve,12/07/2015 10:00:00 AM,48,-122,1,0,1
16259,58thStGreenway22ndAve,12/07/2015 11:00:00 AM,48,-122,1,2,3
16260,58thStGreenway22ndAve,12/07/2015 12:00:00 PM,48,-122,7,0,7
16261,58thStGreenway22ndAve,12/07/2015 01:00:00 PM,48,-122,0,1,1
16262,58thStGreenway22ndAve,12/07/2015 02:00:00 PM,48,-122,3,3,6
16263,58thStGreenway22ndAve,12/07/2015 03:00:00 PM,48,-122,1,0,1
16264,58thStGreenway22ndAve,12/07/2015 04:00:00 PM,48,-122,6,3,9
16265,58thStGreenway22ndAve,12/07/2015 05:00:00 PM,48,-122,7,2,9
16266,58thStGreenway22ndAve,12/07/2015 06:00:00 PM,48,-122,2,3,5
16267,58thStGreenway22ndAve,12/07/2015 07:00:00 PM,48,-122,1,3,4
16268,58thStGreenway22ndAve,12/07/2015 08:00:00 PM,48,-122,1,3,4
16269,58thStGreenway22ndAve,12/07/2015 09:00:00 PM,48,-122,3,1,4
16270,58thStGreenway22ndAve,12/07/2015 10:00:00 PM,48,-122,0,0,0
16271,58thStGreenway22ndAve,12/07/2015 11:00:00 PM,48,-122,0,0,0
16272,58thStGreenway22ndAve,12/08/2015 12:00:00 AM,48,-122,0,0,0
16273,58thStGreenway22ndAve,12/08/2015 01:00:00 AM,48,-122,0,1,1
16274,58thStGreenway22ndAve,12/08/2015 02:00:00 AM,48,-122,0,1,1
16275,58thStGreenway22ndAve,12/08/2015 03:00:00 AM,48,-122,0,0,0
16276,58thStGreenway22ndAve,12/08/2015 04:00:00 AM,48,-122,0,0,0
16277,58thStGreenway22ndAve,12/08/2015 05:00:00 AM,48,-122,0,0,0
16278,58thStGreenway22ndAve,12/08/2015 06:00:00 AM,48,-122,0,4,4
16279,58thStGreenway22ndAve,12/08/2015 07:00:00 AM,48,-122,2,0,2
16280,58thStGreenway22ndAve,12/08/2015 08:00:00 AM,48,-122,2,3,5
16281,58thStGreenway22ndAve,12/08/2015 09:00:00 AM,48,-122,2,5,7
16282,58thStGreenway22ndAve,12/08/2015 10:00:00 AM,48,-122,3,2,5
16283,58thStGreenway22ndAve,12/08/2015 11:00:00 AM,48,-122,2,2,4
16284,58thStGreenway22ndAve,12/08/2015 12:00:00 PM,48,-122,0,0,0
16285,58thStGreenway22ndAve,12/08/2015 01:00:00 PM,48,-122,0,0,0
16286,58thStGreenway22ndAve,12/08/2015 02:00:00 PM,48,-122,0,1,1
16287,58thStGreenway22ndAve,12/08/2015 03:00:00 PM,48,-122,2,2,4
16288,58thStGreenway22ndAve,12/08/2015 04:00:00 PM,48,-122,4,1,5
16289,58thStGreenway22ndAve,12/08/2015 05:00:00 PM,48,-122,2,0,2
16290,58thStGreenway22ndAve,12/08/2015 06:00:00 PM,48,-122,1,5,6
16291,58thStGreenway22ndAve,12/08/2015 07:00:00 PM,48,-122,1,0,1
16292,58thStGreenway22ndAve,12/08/2015 08:00:00 PM,48,-122,1,0,1
16293,58thStGreenway22ndAve,12/08/2015 09:00:00 PM,48,-122,1,1,2
16294,58thStGreenway22ndAve,12/08/2015 10:00:00 PM,48,-122,0,0,0
16295,58thStGreenway22ndAve,12/08/2015 11:00:00 PM,48,-122,0,0,0
16296,58thStGreenway22ndAve,12/09/2015 12:00:00 AM,48,-122,2,0,2
16297,58thStGreenway22ndAve,12/09/2015 01:00:00 AM,48,-122,1,0,1
16298,58thStGreenway22ndAve,12/09/2015 02:00:00 AM,48,-122,0,1,1
16299,58thStGreenway22ndAve,12/09/2015 03:00:00 AM,48,-122,0,0,0
16300,58thStGreenway22ndAve,12/09/2015 04:00:00 AM,48,-122,0,0,0
16301,58thStGreenway22ndAve,12/09/2015 05:00:00 AM,48,-122,0,0,0
16302,58thStGreenway22ndAve,12/09/2015 06:00:00 AM,48,-122,0,3,3
16303,58thStGreenway22ndAve,12/09/2015 07:00:00 AM,48,-122,3,1,4
16304,58thStGreenway22ndAve,12/09/2015 08:00:00 AM,48,-122,4,1,5
16305,58thStGreenway22ndAve,12/09/2015 09:00:00 AM,48,-122,9,2,11
16306,58thStGreenway22ndAve,12/09/2015 10:00:00 AM,48,-122,2,1,3
16307,58thStGreenway22ndAve,12/09/2015 11:00:00 AM,48,-122,0,4,4
16308,58thStGreenway22ndAve,12/09/2015 12:00:00 PM,48,-122,6,3,9
16309,58thStGreenway22ndAve,12/09/2015 01:00:00 PM,48,-122,1,5,6
16310,58thStGreenway22ndAve,12/09/2015 02:00:00 PM,48,-122,3,6,9
16311,58thStGreenway22ndAve,12/09/2015 03:00:00 PM,48,-122,1,1,2
16312,58thStGreenway22ndAve,12/09/2015 04:00:00 PM,48,-122,2,1,3
16313,58thStGreenway22ndAve,12/09/2015 05:00:00 PM,48,-122,4,3,7
16314,58thStGreenway22ndAve,12/09/2015 06:00:00 PM,48,-122,3,1,4
16315,58thStGreenway22ndAve,12/09/2015 07:00:00 PM,48,-122,7,3,10
16316,58thStGreenway22ndAve,12/09/2015 08:00:00 PM,48,-122,2,3,5
16317,58thStGreenway22ndAve,12/09/2015 09:00:00 PM,48,-122,3,1,4
16318,58thStGreenway22ndAve,12/09/2015 10:00:00 PM,48,-122,1,1,2
16319,58thStGreenway22ndAve,12/09/2015 11:00:00 PM,48,-122,0,0,0
16320,58thStGreenway22ndAve,12/10/2015 12:00:00 AM,48,-122,0,1,1
16321,58thStGreenway22ndAve,12/10/2015 01:00:00 AM,48,-122,0,0,0
16322,58thStGreenway22ndAve,12/10/2015 02:00:00 AM,48,-122,0,0,0
16323,58thStGreenway22ndAve,12/10/2015 03:00:00 AM,48,-122,0,1,1
16324,58thStGreenway22ndAve,12/10/2015 04:00:00 AM,48,-122,0,0,0
16325,58thStGreenway22ndAve,12/10/2015 05:00:00 AM,48,-122,0,0,0
16326,58thStGreenway22ndAve,12/10/2015 06:00:00 AM,48,-122,1,2,3
16327,58thStGreenway22ndAve,12/10/2015 07:00:00 AM,48,-122,1,2,3
16328,58thStGreenway22ndAve,12/10/2015 08:00:00 AM,48,-122,1,2,3
16329,58thStGreenway22ndAve,12/10/2015 09:00:00 AM,48,-122,5,0,5
16330,58thStGreenway22ndAve,12/10/2015 10:00:00 AM,48,-122,0,0,0
16331,58thStGreenway22ndAve,12/10/2015 11:00:00 AM,48,-122,2,1,3
16332,58thStGreenway22ndAve,12/10/2015 12:00:00 PM,48,-122,2,0,2
16333,58thStGreenway22ndAve,12/10/2015 01:00:00 PM,48,-122,1,0,1
16334,58thStGreenway22ndAve,12/10/2015 02:00:00 PM,48,-122,1,0,1
16335,58thStGreenway22ndAve,12/10/2015 03:00:00 PM,48,-122,2,2,4
16336,58thStGreenway22ndAve,12/10/2015 04:00:00 PM,48,-122,1,1,2
16337,58thStGreenway22ndAve,12/10/2015 05:00:00 PM,48,-122,2,2,4
16338,58thStGreenway22ndAve,12/10/2015 06:00:00 PM,48,-122,4,2,6
16339,58thStGreenway22ndAve,12/10/2015 07:00:00 PM,48,-122,2,2,4
16340,58thStGreenway22ndAve,12/10/2015 08:00:00 PM,48,-122,0,0,0
16341,58thStGreenway22ndAve,12/10/2015 09:00:00 PM,48,-122,1,0,1
16342,58thStGreenway22ndAve,12/10/2015 10:00:00 PM,48,-122,1,0,1
16343,58thStGreenway22ndAve,12/10/2015 11:00:00 PM,48,-122,0,0,0
16344,58thStGreenway22ndAve,12/11/2015 12:00:00 AM,48,-122,0,1,1
16345,58thStGreenway22ndAve,12/11/2015 01:00:00 AM,48,-122,0,0,0
16346,58thStGreenway22ndAve,12/11/2015 02:00:00 AM,48,-122,1,2,3
16347,58thStGreenway22ndAve,12/11/2015 03:00:00 AM,48,-122,0,0,0
16348,58thStGreenway22ndAve,12/11/2015 04:00:00 AM,48,-122,0,0,0
16349,58thStGreenway22ndAve,12/11/2015 05:00:00 AM,48,-122,0,0,0
16350,58thStGreenway22ndAve,12/11/2015 06:00:00 AM,48,-122,0,2,2
16351,58thStGreenway22ndAve,12/11/2015 07:00:00 AM,48,-122,6,0,6
16352,58thStGreenway22ndAve,12/11/2015 08:00:00 AM,48,-122,4,5,9
16353,58thStGreenway22ndAve,12/11/2015 09:00:00 AM,48,-122,2,3,5
16354,58thStGreenway22ndAve,12/11/2015 10:00:00 AM,48,-122,4,2,6
16355,58thStGreenway22ndAve,12/11/2015 11:00:00 AM,48,-122,4,4,8
16356,58thStGreenway22ndAve,12/11/2015 12:00:00 PM,48,-122,2,1,3
16357,58thStGreenway22ndAve,12/11/2015 01:00:00 PM,48,-122,0,3,3
16358,58thStGreenway22ndAve,12/11/2015 02:00:00 PM,48,-122,7,5,12
16359,58thStGreenway22ndAve,12/11/2015 03:00:00 PM,48,-122,4,2,6
16360,58thStGreenway22ndAve,12/11/2015 04:00:00 PM,48,-122,6,6,12
16361,58thStGreenway22ndAve,12/11/2015 05:00:00 PM,48,-122,4,3,7
16362,58thStGreenway22ndAve,12/11/2015 06:00:00 PM,48,-122,7,5,12
16363,58thStGreenway22ndAve,12/11/2015 07:00:00 PM,48,-122,3,2,5
16364,58thStGreenway22ndAve,12/11/2015 08:00:00 PM,48,-122,0,1,1
16365,58thStGreenway22ndAve,12/11/2015 09:00:00 PM,48,-122,0,0,0
16366,58thStGreenway22ndAve,12/11/2015 10:00:00 PM,48,-122,0,0,0
16367,58thStGreenway22ndAve,12/11/2015 11:00:00 PM,48,-122,3,1,4
16368,58thStGreenway22ndAve,12/12/2015 12:00:00 AM,48,-122,0,3,3
16369,58thStGreenway22ndAve,12/12/2015 01:00:00 AM,48,-122,0,0,0
16370,58thStGreenway22ndAve,12/12/2015 02:00:00 AM,48,-122,0,0,0
16371,58thStGreenway22ndAve,12/12/2015 03:00:00 AM,48,-122,0,0,0
16372,58thStGreenway22ndAve,12/12/2015 04:00:00 AM,48,-122,0,0,0
16373,58thStGreenway22ndAve,12/12/2015 05:00:00 AM,48,-122,0,0,0
16374,58thStGreenway22ndAve,12/12/2015 06:00:00 AM,48,-122,0,1,1
16375,58thStGreenway22ndAve,12/12/2015 07:00:00 AM,48,-122,0,0,0
16376,58thStGreenway22ndAve,12/12/2015 08:00:00 AM,48,-122,0,0,0
16377,58thStGreenway22ndAve,12/12/2015 09:00:00 AM,48,-122,0,1,1
16378,58thStGreenway22ndAve,12/12/2015 10:00:00 AM,48,-122,2,1,3
16379,58thStGreenway22ndAve,12/12/2015 11:00:00 AM,48,-122,1,2,3
16380,58thStGreenway22ndAve,12/12/2015 12:00:00 PM,48,-122,5,1,6
16381,58thStGreenway22ndAve,12/12/2015 01:00:00 PM,48,-122,1,2,3
16382,58thStGreenway22ndAve,12/12/2015 02:00:00 PM,48,-122,2,2,4
16383,58thStGreenway22ndAve,12/12/2015 03:00:00 PM,48,-122,3,0,3
16384,58thStGreenway22ndAve,12/12/2015 04:00:00 PM,48,-122,1,0,1
16385,58thStGreenway22ndAve,12/12/2015 05:00:00 PM,48,-122,3,2,5
16386,58thStGreenway22ndAve,12/12/2015 06:00:00 PM,48,-122,1,3,4
16387,58thStGreenway22ndAve,12/12/2015 07:00:00 PM,48,-122,1,1,2
16388,58thStGreenway22ndAve,12/12/2015 08:00:00 PM,48,-122,1,1,2
16389,58thStGreenway22ndAve,12/12/2015 09:00:00 PM,48,-122,0,0,0
16390,58thStGreenway22ndAve,12/12/2015 10:00:00 PM,48,-122,0,0,0
16391,58thStGreenway22ndAve,12/12/2015 11:00:00 PM,48,-122,2,0,2
16392,58thStGreenway22ndAve,12/13/2015 12:00:00 AM,48,-122,0,1,1
16393,58thStGreenway22ndAve,12/13/2015 01:00:00 AM,48,-122,0,0,0
16394,58thStGreenway22ndAve,12/13/2015 02:00:00 AM,48,-122,0,0,0
16395,58thStGreenway22ndAve,12/13/2015 03:00:00 AM,48,-122,0,0,0
16396,58thStGreenway22ndAve,12/13/2015 04:00:00 AM,48,-122,0,0,0
16397,58thStGreenway22ndAve,12/13/2015 05:00:00 AM,48,-122,0,0,0
16398,58thStGreenway22ndAve,12/13/2015 06:00:00 AM,48,-122,0,0,0
16399,58thStGreenway22ndAve,12/13/2015 07:00:00 AM,48,-122,0,0,0
16400,58thStGreenway22ndAve,12/13/2015 08:00:00 AM,48,-122,1,1,2
16401,58thStGreenway22ndAve,12/13/2015 09:00:00 AM,48,-122,1,1,2
16402,58thStGreenway22ndAve,12/13/2015 10:00:00 AM,48,-122,1,3,4
16403,58thStGreenway22ndAve,12/13/2015 11:00:00 AM,48,-122,0,2,2
16404,58thStGreenway22ndAve,12/13/2015 12:00:00 PM,48,-122,3,0,3
16405,58thStGreenway22ndAve,12/13/2015 01:00:00 PM,48,-122,2,2,4
16406,58thStGreenway22ndAve,12/13/2015 02:00:00 PM,48,-122,3,5,8
16407,58thStGreenway22ndAve,12/13/2015 03:00:00 PM,48,-122,3,1,4
16408,58thStGreenway22ndAve,12/13/2015 04:00:00 PM,48,-122,2,0,2
16409,58thStGreenway22ndAve,12/13/2015 05:00:00 PM,48,-122,2,4,6
16410,58thStGreenway22ndAve,12/13/2015 06:00:00 PM,48,-122,0,0,0
16411,58thStGreenway22ndAve,12/13/2015 07:00:00 PM,48,-122,0,0,0
16412,58thStGreenway22ndAve,12/13/2015 08:00:00 PM,48,-122,0,0,0
16413,58thStGreenway22ndAve,12/13/2015 09:00:00 PM,48,-122,0,0,0
16414,58thStGreenway22ndAve,12/13/2015 10:00:00 PM,48,-122,0,1,1
16415,58thStGreenway22ndAve,12/13/2015 11:00:00 PM,48,-122,0,0,0
16416,58thStGreenway22ndAve,12/14/2015 12:00:00 AM,48,-122,0,0,0
16417,58thStGreenway22ndAve,12/14/2015 01:00:00 AM,48,-122,0,0,0
16418,58thStGreenway22ndAve,12/14/2015 02:00:00 AM,48,-122,0,0,0
16419,58thStGreenway22ndAve,12/14/2015 03:00:00 AM,48,-122,0,0,0
16420,58thStGreenway22ndAve,12/14/2015 04:00:00 AM,48,-122,0,0,0
16421,58thStGreenway22ndAve,12/14/2015 05:00:00 AM,48,-122,0,1,1
16422,58thStGreenway22ndAve,12/14/2015 06:00:00 AM,48,-122,0,2,2
16423,58thStGreenway22ndAve,12/14/2015 07:00:00 AM,48,-122,0,6,6
16424,58thStGreenway22ndAve,12/14/2015 08:00:00 AM,48,-122,7,6,13
16425,58thStGreenway22ndAve,12/14/2015 09:00:00 AM,48,-122,7,4,11
16426,58thStGreenway22ndAve,12/14/2015 10:00:00 AM,48,-122,0,0,0
16427,58thStGreenway22ndAve,12/14/2015 11:00:00 AM,48,-122,2,2,4
16428,58thStGreenway22ndAve,12/14/2015 12:00:00 PM,48,-122,1,4,5
16429,58thStGreenway22ndAve,12/14/2015 01:00:00 PM,48,-122,3,4,7
16430,58thStGreenway22ndAve,12/14/2015 02:00:00 PM,48,-122,6,3,9
16431,58thStGreenway22ndAve,12/14/2015 03:00:00 PM,48,-122,6,1,7
16432,58thStGreenway22ndAve,12/14/2015 04:00:00 PM,48,-122,4,2,6
16433,58thStGreenway22ndAve,12/14/2015 05:00:00 PM,48,-122,2,2,4
16434,58thStGreenway22ndAve,12/14/2015 06:00:00 PM,48,-122,3,4,7
16435,58thStGreenway22ndAve,12/14/2015 07:00:00 PM,48,-122,3,3,6
16436,58thStGreenway22ndAve,12/14/2015 08:00:00 PM,48,-122,4,1,5
16437,58thStGreenway22ndAve,12/14/2015 09:00:00 PM,48,-122,1,0,1
16438,58thStGreenway22ndAve,12/14/2015 10:00:00 PM,48,-122,0,0,0
16439,58thStGreenway22ndAve,12/14/2015 11:00:00 PM,48,-122,0,0,0
16440,58thStGreenway22ndAve,12/15/2015 12:00:00 AM,48,-122,0,1,1
16441,58thStGreenway22ndAve,12/15/2015 01:00:00 AM,48,-122,0,1,1
16442,58thStGreenway22ndAve,12/15/2015 02:00:00 AM,48,-122,0,1,1
16443,58thStGreenway22ndAve,12/15/2015 03:00:00 AM,48,-122,0,1,1
16444,58thStGreenway22ndAve,12/15/2015 04:00:00 AM,48,-122,0,0,0
16445,58thStGreenway22ndAve,12/15/2015 05:00:00 AM,48,-122,0,1,1
16446,58thStGreenway22ndAve,12/15/2015 06:00:00 AM,48,-122,0,2,2
16447,58thStGreenway22ndAve,12/15/2015 07:00:00 AM,48,-122,2,0,2
16448,58thStGreenway22ndAve,12/15/2015 08:00:00 AM,48,-122,4,3,7
16449,58thStGreenway22ndAve,12/15/2015 09:00:00 AM,48,-122,5,5,10
16450,58thStGreenway22ndAve,12/15/2015 10:00:00 AM,48,-122,2,3,5
16451,58thStGreenway22ndAve,12/15/2015 11:00:00 AM,48,-122,3,5,8
16452,58thStGreenway22ndAve,12/15/2015 12:00:00 PM,48,-122,2,1,3
16453,58thStGreenway22ndAve,12/15/2015 01:00:00 PM,48,-122,4,1,5
16454,58thStGreenway22ndAve,12/15/2015 02:00:00 PM,48,-122,5,1,6
16455,58thStGreenway22ndAve,12/15/2015 03:00:00 PM,48,-122,3,0,3
16456,58thStGreenway22ndAve,12/15/2015 04:00:00 PM,48,-122,4,1,5
16457,58thStGreenway22ndAve,12/15/2015 05:00:00 PM,48,-122,4,4,8
16458,58thStGreenway22ndAve,12/15/2015 06:00:00 PM,48,-122,0,4,4
16459,58thStGreenway22ndAve,12/15/2015 07:00:00 PM,48,-122,2,1,3
16460,58thStGreenway22ndAve,12/15/2015 08:00:00 PM,48,-122,2,3,5
16461,58thStGreenway22ndAve,12/15/2015 09:00:00 PM,48,-122,1,0,1
16462,58thStGreenway22ndAve,12/15/2015 10:00:00 PM,48,-122,0,1,1
16463,58thStGreenway22ndAve,12/15/2015 11:00:00 PM,48,-122,0,0,0
16464,58thStGreenway22ndAve,12/16/2015 12:00:00 AM,48,-122,2,1,3
16465,58thStGreenway22ndAve,12/16/2015 01:00:00 AM,48,-122,0,0,0
16466,58thStGreenway22ndAve,12/16/2015 02:00:00 AM,48,-122,0,0,0
16467,58thStGreenway22ndAve,12/16/2015 03:00:00 AM,48,-122,0,0,0
16468,58thStGreenway22ndAve,12/16/2015 04:00:00 AM,48,-122,0,0,0
16469,58thStGreenway22ndAve,12/16/2015 05:00:00 AM,48,-122,0,1,1
16470,58thStGreenway22ndAve,12/16/2015 06:00:00 AM,48,-122,0,2,2
16471,58thStGreenway22ndAve,12/16/2015 07:00:00 AM,48,-122,3,2,5
16472,58thStGreenway22ndAve,12/16/2015 08:00:00 AM,48,-122,5,4,9
16473,58thStGreenway22ndAve,12/16/2015 09:00:00 AM,48,-122,1,3,4
16474,58thStGreenway22ndAve,12/16/2015 10:00:00 AM,48,-122,2,2,4
16475,58thStGreenway22ndAve,12/16/2015 11:00:00 AM,48,-122,3,0,3
16476,58thStGreenway22ndAve,12/16/2015 12:00:00 PM,48,-122,2,2,4
16477,58thStGreenway22ndAve,12/16/2015 01:00:00 PM,48,-122,2,2,4
16478,58thStGreenway22ndAve,12/16/2015 02:00:00 PM,48,-122,3,3,6
16479,58thStGreenway22ndAve,12/16/2015 03:00:00 PM,48,-122,5,1,6
16480,58thStGreenway22ndAve,12/16/2015 04:00:00 PM,48,-122,3,1,4
16481,58thStGreenway22ndAve,12/16/2015 05:00:00 PM,48,-122,7,3,10
16482,58thStGreenway22ndAve,12/16/2015 06:00:00 PM,48,-122,1,4,5
16483,58thStGreenway22ndAve,12/16/2015 07:00:00 PM,48,-122,3,6,9
16484,58thStGreenway22ndAve,12/16/2015 08:00:00 PM,48,-122,1,1,2
16485,58thStGreenway22ndAve,12/16/2015 09:00:00 PM,48,-122,2,1,3
16486,58thStGreenway22ndAve,12/16/2015 10:00:00 PM,48,-122,1,0,1
16487,58thStGreenway22ndAve,12/16/2015 11:00:00 PM,48,-122,0,3,3
16488,58thStGreenway22ndAve,12/17/2015 12:00:00 AM,48,-122,0,0,0
16489,58thStGreenway22ndAve,12/17/2015 01:00:00 AM,48,-122,0,0,0
16490,58thStGreenway22ndAve,12/17/2015 02:00:00 AM,48,-122,0,0,0
16491,58thStGreenway22ndAve,12/17/2015 03:00:00 AM,48,-122,0,0,0
16492,58thStGreenway22ndAve,12/17/2015 04:00:00 AM,48,-122,0,0,0
16493,58thStGreenway22ndAve,12/17/2015 05:00:00 AM,48,-122,0,1,1
16494,58thStGreenway22ndAve,12/17/2015 06:00:00 AM,48,-122,0,3,3
16495,58thStGreenway22ndAve,12/17/2015 07:00:00 AM,48,-122,3,1,4
16496,58thStGreenway22ndAve,12/17/2015 08:00:00 AM,48,-122,7,2,9
16497,58thStGreenway22ndAve,12/17/2015 09:00:00 AM,48,-122,1,0,1
16498,58thStGreenway22ndAve,12/17/2015 10:00:00 AM,48,-122,1,3,4
16499,58thStGreenway22ndAve,12/17/2015 11:00:00 AM,48,-122,0,1,1
16500,58thStGreenway22ndAve,12/17/2015 12:00:00 PM,48,-122,0,0,0
16501,58thStGreenway22ndAve,12/17/2015 01:00:00 PM,48,-122,0,0,0
16502,58thStGreenway22ndAve,12/17/2015 02:00:00 PM,48,-122,3,1,4
16503,58thStGreenway22ndAve,12/17/2015 03:00:00 PM,48,-122,2,1,3
16504,58thStGreenway22ndAve,12/17/2015 04:00:00 PM,48,-122,2,1,3
16505,58thStGreenway22ndAve,12/17/2015 05:00:00 PM,48,-122,4,4,8
16506,58thStGreenway22ndAve,12/17/2015 06:00:00 PM,48,-122,0,3,3
16507,58thStGreenway22ndAve,12/17/2015 07:00:00 PM,48,-122,5,0,5
16508,58thStGreenway22ndAve,12/17/2015 08:00:00 PM,48,-122,2,0,2
16509,58thStGreenway22ndAve,12/17/2015 09:00:00 PM,48,-122,0,0,0
16510,58thStGreenway22ndAve,12/17/2015 10:00:00 PM,48,-122,1,1,2
16511,58thStGreenway22ndAve,12/17/2015 11:00:00 PM,48,-122,0,0,0
16512,58thStGreenway22ndAve,12/18/2015 12:00:00 AM,48,-122,0,0,0
16513,58thStGreenway22ndAve,12/18/2015 01:00:00 AM,48,-122,0,0,0
16514,58thStGreenway22ndAve,12/18/2015 02:00:00 AM,48,-122,0,0,0
16515,58thStGreenway22ndAve,12/18/2015 03:00:00 AM,48,-122,0,0,0
16516,58thStGreenway22ndAve,12/18/2015 04:00:00 AM,48,-122,0,0,0
16517,58thStGreenway22ndAve,12/18/2015 05:00:00 AM,48,-122,0,1,1
16518,58thStGreenway22ndAve,12/18/2015 06:00:00 AM,48,-122,0,2,2
16519,58thStGreenway22ndAve,12/18/2015 07:00:00 AM,48,-122,1,2,3
16520,58thStGreenway22ndAve,12/18/2015 08:00:00 AM,48,-122,3,0,3
16521,58thStGreenway22ndAve,12/18/2015 09:00:00 AM,48,-122,2,3,5
16522,58thStGreenway22ndAve,12/18/2015 10:00:00 AM,48,-122,2,1,3
16523,58thStGreenway22ndAve,12/18/2015 11:00:00 AM,48,-122,4,5,9
16524,58thStGreenway22ndAve,12/18/2015 12:00:00 PM,48,-122,4,3,7
16525,58thStGreenway22ndAve,12/18/2015 01:00:00 PM,48,-122,3,6,9
16526,58thStGreenway22ndAve,12/18/2015 02:00:00 PM,48,-122,1,2,3
16527,58thStGreenway22ndAve,12/18/2015 03:00:00 PM,48,-122,4,4,8
16528,58thStGreenway22ndAve,12/18/2015 04:00:00 PM,48,-122,5,3,8
16529,58thStGreenway22ndAve,12/18/2015 05:00:00 PM,48,-122,6,4,10
16530,58thStGreenway22ndAve,12/18/2015 06:00:00 PM,48,-122,2,3,5
16531,58thStGreenway22ndAve,12/18/2015 07:00:00 PM,48,-122,1,1,2
16532,58thStGreenway22ndAve,12/18/2015 08:00:00 PM,48,-122,0,0,0
16533,58thStGreenway22ndAve,12/18/2015 09:00:00 PM,48,-122,4,0,4
16534,58thStGreenway22ndAve,12/18/2015 10:00:00 PM,48,-122,3,0,3
16535,58thStGreenway22ndAve,12/18/2015 11:00:00 PM,48,-122,0,0,0
16536,58thStGreenway22ndAve,12/19/2015 12:00:00 AM,48,-122,0,0,0
16537,58thStGreenway22ndAve,12/19/2015 01:00:00 AM,48,-122,0,0,0
16538,58thStGreenway22ndAve,12/19/2015 02:00:00 AM,48,-122,0,0,0
16539,58thStGreenway22ndAve,12/19/2015 03:00:00 AM,48,-122,0,0,0
16540,58thStGreenway22ndAve,12/19/2015 04:00:00 AM,48,-122,0,0,0
16541,58thStGreenway22ndAve,12/19/2015 05:00:00 AM,48,-122,0,0,0
16542,58thStGreenway22ndAve,12/19/2015 06:00:00 AM,48,-122,1,0,1
16543,58thStGreenway22ndAve,12/19/2015 07:00:00 AM,48,-122,0,0,0
16544,58thStGreenway22ndAve,12/19/2015 08:00:00 AM,48,-122,1,1,2
16545,58thStGreenway22ndAve,12/19/2015 09:00:00 AM,48,-122,0,1,1
16546,58thStGreenway22ndAve,12/19/2015 10:00:00 AM,48,-122,4,2,6
16547,58thStGreenway22ndAve,12/19/2015 11:00:00 AM,48,-122,0,5,5
16548,58thStGreenway22ndAve,12/19/2015 12:00:00 PM,48,-122,3,2,5
16549,58thStGreenway22ndAve,12/19/2015 01:00:00 PM,48,-122,1,0,1
16550,58thStGreenway22ndAve,12/19/2015 02:00:00 PM,48,-122,1,2,3
16551,58thStGreenway22ndAve,12/19/2015 03:00:00 PM,48,-122,2,1,3
16552,58thStGreenway22ndAve,12/19/2015 04:00:00 PM,48,-122,5,2,7
16553,58thStGreenway22ndAve,12/19/2015 05:00:00 PM,48,-122,6,3,9
16554,58thStGreenway22ndAve,12/19/2015 06:00:00 PM,48,-122,7,6,13
16555,58thStGreenway22ndAve,12/19/2015 07:00:00 PM,48,-122,1,0,1
16556,58thStGreenway22ndAve,12/19/2015 08:00:00 PM,48,-122,0,2,2
16557,58thStGreenway22ndAve,12/19/2015 09:00:00 PM,48,-122,1,0,1
16558,58thStGreenway22ndAve,12/19/2015 10:00:00 PM,48,-122,1,1,2
16559,58thStGreenway22ndAve,12/19/2015 11:00:00 PM,48,-122,2,0,2
16560,58thStGreenway22ndAve,12/20/2015 12:00:00 AM,48,-122,1,0,1
16561,58thStGreenway22ndAve,12/20/2015 01:00:00 AM,48,-122,0,0,0
16562,58thStGreenway22ndAve,12/20/2015 02:00:00 AM,48,-122,0,0,0
16563,58thStGreenway22ndAve,12/20/2015 03:00:00 AM,48,-122,0,0,0
16564,58thStGreenway22ndAve,12/20/2015 04:00:00 AM,48,-122,0,0,0
16565,58thStGreenway22ndAve,12/20/2015 05:00:00 AM,48,-122,0,0,0
16566,58thStGreenway22ndAve,12/20/2015 06:00:00 AM,48,-122,0,1,1
16567,58thStGreenway22ndAve,12/20/2015 07:00:00 AM,48,-122,0,0,0
16568,58thStGreenway22ndAve,12/20/2015 08:00:00 AM,48,-122,0,0,0
16569,58thStGreenway22ndAve,12/20/2015 09:00:00 AM,48,-122,1,1,2
16570,58thStGreenway22ndAve,12/20/2015 10:00:00 AM,48,-122,1,1,2
16571,58thStGreenway22ndAve,12/20/2015 11:00:00 AM,48,-122,5,0,5
16572,58thStGreenway22ndAve,12/20/2015 12:00:00 PM,48,-122,3,3,6
16573,58thStGreenway22ndAve,12/20/2015 01:00:00 PM,48,-122,6,3,9
16574,58thStGreenway22ndAve,12/20/2015 02:00:00 PM,48,-122,3,10,13
16575,58thStGreenway22ndAve,12/20/2015 03:00:00 PM,48,-122,7,1,8
16576,58thStGreenway22ndAve,12/20/2015 04:00:00 PM,48,-122,4,4,8
16577,58thStGreenway22ndAve,12/20/2015 05:00:00 PM,48,-122,0,1,1
16578,58thStGreenway22ndAve,12/20/2015 06:00:00 PM,48,-122,2,1,3
16579,58thStGreenway22ndAve,12/20/2015 07:00:00 PM,48,-122,2,0,2
16580,58thStGreenway22ndAve,12/20/2015 08:00:00 PM,48,-122,5,0,5
16581,58thStGreenway22ndAve,12/20/2015 09:00:00 PM,48,-122,1,0,1
16582,58thStGreenway22ndAve,12/20/2015 10:00:00 PM,48,-122,1,0,1
16583,58thStGreenway22ndAve,12/20/2015 11:00:00 PM,48,-122,0,1,1
16584,58thStGreenway22ndAve,12/21/2015 12:00:00 AM,48,-122,0,0,0
16585,58thStGreenway22ndAve,12/21/2015 01:00:00 AM,48,-122,0,0,0
16586,58thStGreenway22ndAve,12/21/2015 02:00:00 AM,48,-122,0,0,0
16587,58thStGreenway22ndAve,12/21/2015 03:00:00 AM,48,-122,0,0,0
16588,58thStGreenway22ndAve,12/21/2015 04:00:00 AM,48,-122,0,0,0
16589,58thStGreenway22ndAve,12/21/2015 05:00:00 AM,48,-122,0,1,1
16590,58thStGreenway22ndAve,12/21/2015 06:00:00 AM,48,-122,0,0,0
16591,58thStGreenway22ndAve,12/21/2015 07:00:00 AM,48,-122,2,1,3
16592,58thStGreenway22ndAve,12/21/2015 08:00:00 AM,48,-122,3,2,5
16593,58thStGreenway22ndAve,12/21/2015 09:00:00 AM,48,-122,1,2,3
16594,58thStGreenway22ndAve,12/21/2015 10:00:00 AM,48,-122,0,0,0
16595,58thStGreenway22ndAve,12/21/2015 11:00:00 AM,48,-122,0,1,1
16596,58thStGreenway22ndAve,12/21/2015 12:00:00 PM,48,-122,0,1,1
16597,58thStGreenway22ndAve,12/21/2015 01:00:00 PM,48,-122,1,3,4
16598,58thStGreenway22ndAve,12/21/2015 02:00:00 PM,48,-122,1,0,1
16599,58thStGreenway22ndAve,12/21/2015 03:00:00 PM,48,-122,2,0,2
16600,58thStGreenway22ndAve,12/21/2015 04:00:00 PM,48,-122,1,2,3
16601,58thStGreenway22ndAve,12/21/2015 05:00:00 PM,48,-122,3,3,6
16602,58thStGreenway22ndAve,12/21/2015 06:00:00 PM,48,-122,2,0,2
16603,58thStGreenway22ndAve,12/21/2015 07:00:00 PM,48,-122,3,1,4
16604,58thStGreenway22ndAve,12/21/2015 08:00:00 PM,48,-122,0,0,0
16605,58thStGreenway22ndAve,12/21/2015 09:00:00 PM,48,-122,0,0,0
16606,58thStGreenway22ndAve,12/21/2015 10:00:00 PM,48,-122,0,0,0
16607,58thStGreenway22ndAve,12/21/2015 11:00:00 PM,48,-122,0,0,0
16608,58thStGreenway22ndAve,12/22/2015 12:00:00 AM,48,-122,0,0,0
16609,58thStGreenway22ndAve,12/22/2015 01:00:00 AM,48,-122,0,0,0
16610,58thStGreenway22ndAve,12/22/2015 02:00:00 AM,48,-122,0,0,0
16611,58thStGreenway22ndAve,12/22/2015 03:00:00 AM,48,-122,0,1,1
16612,58thStGreenway22ndAve,12/22/2015 04:00:00 AM,48,-122,0,0,0
16613,58thStGreenway22ndAve,12/22/2015 05:00:00 AM,48,-122,0,1,1
16614,58thStGreenway22ndAve,12/22/2015 06:00:00 AM,48,-122,0,1,1
16615,58thStGreenway22ndAve,12/22/2015 07:00:00 AM,48,-122,3,1,4
16616,58thStGreenway22ndAve,12/22/2015 08:00:00 AM,48,-122,1,4,5
16617,58thStGreenway22ndAve,12/22/2015 09:00:00 AM,48,-122,4,3,7
16618,58thStGreenway22ndAve,12/22/2015 10:00:00 AM,48,-122,1,4,5
16619,58thStGreenway22ndAve,12/22/2015 11:00:00 AM,48,-122,4,7,11
16620,58thStGreenway22ndAve,12/22/2015 12:00:00 PM,48,-122,2,3,5
16621,58thStGreenway22ndAve,12/22/2015 01:00:00 PM,48,-122,3,2,5
16622,58thStGreenway22ndAve,12/22/2015 02:00:00 PM,48,-122,1,2,3
16623,58thStGreenway22ndAve,12/22/2015 03:00:00 PM,48,-122,2,2,4
16624,58thStGreenway22ndAve,12/22/2015 04:00:00 PM,48,-122,4,2,6
16625,58thStGreenway22ndAve,12/22/2015 05:00:00 PM,48,-122,4,1,5
16626,58thStGreenway22ndAve,12/22/2015 06:00:00 PM,48,-122,1,2,3
16627,58thStGreenway22ndAve,12/22/2015 07:00:00 PM,48,-122,0,0,0
16628,58thStGreenway22ndAve,12/22/2015 08:00:00 PM,48,-122,1,0,1
16629,58thStGreenway22ndAve,12/22/2015 09:00:00 PM,48,-122,2,0,2
16630,58thStGreenway22ndAve,12/22/2015 10:00:00 PM,48,-122,1,0,1
16631,58thStGreenway22ndAve,12/22/2015 11:00:00 PM,48,-122,0,0,0
16632,58thStGreenway22ndAve,12/23/2015 12:00:00 AM,48,-122,0,0,0
16633,58thStGreenway22ndAve,12/23/2015 01:00:00 AM,48,-122,0,0,0
16634,58thStGreenway22ndAve,12/23/2015 02:00:00 AM,48,-122,0,0,0
16635,58thStGreenway22ndAve,12/23/2015 03:00:00 AM,48,-122,0,0,0
16636,58thStGreenway22ndAve,12/23/2015 04:00:00 AM,48,-122,0,0,0
16637,58thStGreenway22ndAve,12/23/2015 05:00:00 AM,48,-122,0,2,2
16638,58thStGreenway22ndAve,12/23/2015 06:00:00 AM,48,-122,0,1,1
16639,58thStGreenway22ndAve,12/23/2015 07:00:00 AM,48,-122,2,0,2
16640,58thStGreenway22ndAve,12/23/2015 08:00:00 AM,48,-122,1,3,4
16641,58thStGreenway22ndAve,12/23/2015 09:00:00 AM,48,-122,1,1,2
16642,58thStGreenway22ndAve,12/23/2015 10:00:00 AM,48,-122,0,0,0
16643,58thStGreenway22ndAve,12/23/2015 11:00:00 AM,48,-122,4,1,5
16644,58thStGreenway22ndAve,12/23/2015 12:00:00 PM,48,-122,1,5,6
16645,58thStGreenway22ndAve,12/23/2015 01:00:00 PM,48,-122,5,0,5
16646,58thStGreenway22ndAve,12/23/2015 02:00:00 PM,48,-122,0,1,1
16647,58thStGreenway22ndAve,12/23/2015 03:00:00 PM,48,-122,3,3,6
16648,58thStGreenway22ndAve,12/23/2015 04:00:00 PM,48,-122,7,4,11
16649,58thStGreenway22ndAve,12/23/2015 05:00:00 PM,48,-122,3,3,6
16650,58thStGreenway22ndAve,12/23/2015 06:00:00 PM,48,-122,3,0,3
16651,58thStGreenway22ndAve,12/23/2015 07:00:00 PM,48,-122,2,3,5
16652,58thStGreenway22ndAve,12/23/2015 08:00:00 PM,48,-122,2,1,3
16653,58thStGreenway22ndAve,12/23/2015 09:00:00 PM,48,-122,0,0,0
16654,58thStGreenway22ndAve,12/23/2015 10:00:00 PM,48,-122,0,0,0
16655,58thStGreenway22ndAve,12/23/2015 11:00:00 PM,48,-122,0,0,0
16656,58thStGreenway22ndAve,12/24/2015 12:00:00 AM,48,-122,0,0,0
16657,58thStGreenway22ndAve,12/24/2015 01:00:00 AM,48,-122,0,1,1
16658,58thStGreenway22ndAve,12/24/2015 02:00:00 AM,48,-122,0,0,0
16659,58thStGreenway22ndAve,12/24/2015 03:00:00 AM,48,-122,0,0,0
16660,58thStGreenway22ndAve,12/24/2015 04:00:00 AM,48,-122,0,0,0
16661,58thStGreenway22ndAve,12/24/2015 05:00:00 AM,48,-122,0,0,0
16662,58thStGreenway22ndAve,12/24/2015 06:00:00 AM,48,-122,0,1,1
16663,58thStGreenway22ndAve,12/24/2015 07:00:00 AM,48,-122,0,0,0
16664,58thStGreenway22ndAve,12/24/2015 08:00:00 AM,48,-122,2,0,2
16665,58thStGreenway22ndAve,12/24/2015 09:00:00 AM,48,-122,1,1,2
16666,58thStGreenway22ndAve,12/24/2015 10:00:00 AM,48,-122,0,3,3
16667,58thStGreenway22ndAve,12/24/2015 11:00:00 AM,48,-122,3,5,8
16668,58thStGreenway22ndAve,12/24/2015 12:00:00 PM,48,-122,5,4,9
16669,58thStGreenway22ndAve,12/24/2015 01:00:00 PM,48,-122,2,0,2
16670,58thStGreenway22ndAve,12/24/2015 02:00:00 PM,48,-122,4,3,7
16671,58thStGreenway22ndAve,12/24/2015 03:00:00 PM,48,-122,0,2,2
16672,58thStGreenway22ndAve,12/24/2015 04:00:00 PM,48,-122,2,1,3
16673,58thStGreenway22ndAve,12/24/2015 05:00:00 PM,48,-122,3,0,3
16674,58thStGreenway22ndAve,12/24/2015 06:00:00 PM,48,-122,0,0,0
16675,58thStGreenway22ndAve,12/24/2015 07:00:00 PM,48,-122,0,2,2
16676,58thStGreenway22ndAve,12/24/2015 08:00:00 PM,48,-122,2,0,2
16677,58thStGreenway22ndAve,12/24/2015 09:00:00 PM,48,-122,0,0,0
16678,58thStGreenway22ndAve,12/24/2015 10:00:00 PM,48,-122,0,0,0
16679,58thStGreenway22ndAve,12/24/2015 11:00:00 PM,48,-122,0,0,0
16680,58thStGreenway22ndAve,12/25/2015 12:00:00 AM,48,-122,0,0,0
16681,58thStGreenway22ndAve,12/25/2015 01:00:00 AM,48,-122,0,0,0
16682,58thStGreenway22ndAve,12/25/2015 02:00:00 AM,48,-122,0,0,0
16683,58thStGreenway22ndAve,12/25/2015 03:00:00 AM,48,-122,0,0,0
16684,58thStGreenway22ndAve,12/25/2015 04:00:00 AM,48,-122,0,0,0
16685,58thStGreenway22ndAve,12/25/2015 05:00:00 AM,48,-122,0,0,0
16686,58thStGreenway22ndAve,12/25/2015 06:00:00 AM,48,-122,0,0,0
16687,58thStGreenway22ndAve,12/25/2015 07:00:00 AM,48,-122,0,2,2
16688,58thStGreenway22ndAve,12/25/2015 08:00:00 AM,48,-122,0,0,0
16689,58thStGreenway22ndAve,12/25/2015 09:00:00 AM,48,-122,0,0,0
16690,58thStGreenway22ndAve,12/25/2015 10:00:00 AM,48,-122,0,1,1
16691,58thStGreenway22ndAve,12/25/2015 11:00:00 AM,48,-122,0,0,0
16692,58thStGreenway22ndAve,12/25/2015 12:00:00 PM,48,-122,2,0,2
16693,58thStGreenway22ndAve,12/25/2015 01:00:00 PM,48,-122,1,1,2
16694,58thStGreenway22ndAve,12/25/2015 02:00:00 PM,48,-122,2,0,2
16695,58thStGreenway22ndAve,12/25/2015 03:00:00 PM,48,-122,0,1,1
16696,58thStGreenway22ndAve,12/25/2015 04:00:00 PM,48,-122,0,2,2
16697,58thStGreenway22ndAve,12/25/2015 05:00:00 PM,48,-122,0,0,0
16698,58thStGreenway22ndAve,12/25/2015 06:00:00 PM,48,-122,0,0,0
16699,58thStGreenway22ndAve,12/25/2015 07:00:00 PM,48,-122,0,0,0
16700,58thStGreenway22ndAve,12/25/2015 08:00:00 PM,48,-122,0,0,0
16701,58thStGreenway22ndAve,12/25/2015 09:00:00 PM,48,-122,0,0,0
16702,58thStGreenway22ndAve,12/25/2015 10:00:00 PM,48,-122,0,0,0
16703,58thStGreenway22ndAve,12/25/2015 11:00:00 PM,48,-122,0,0,0
16704,58thStGreenway22ndAve,12/26/2015 12:00:00 AM,48,-122,0,0,0
16705,58thStGreenway22ndAve,12/26/2015 01:00:00 AM,48,-122,0,0,0
16706,58thStGreenway22ndAve,12/26/2015 02:00:00 AM,48,-122,0,0,0
16707,58thStGreenway22ndAve,12/26/2015 03:00:00 AM,48,-122,0,0,0
16708,58thStGreenway22ndAve,12/26/2015 04:00:00 AM,48,-122,0,0,0
16709,58thStGreenway22ndAve,12/26/2015 05:00:00 AM,48,-122,0,0,0
16710,58thStGreenway22ndAve,12/26/2015 06:00:00 AM,48,-122,0,0,0
16711,58thStGreenway22ndAve,12/26/2015 07:00:00 AM,48,-122,0,0,0
16712,58thStGreenway22ndAve,12/26/2015 08:00:00 AM,48,-122,0,0,0
16713,58thStGreenway22ndAve,12/26/2015 09:00:00 AM,48,-122,0,0,0
16714,58thStGreenway22ndAve,12/26/2015 10:00:00 AM,48,-122,4,0,4
16715,58thStGreenway22ndAve,12/26/2015 11:00:00 AM,48,-122,0,0,0
16716,58thStGreenway22ndAve,12/26/2015 12:00:00 PM,48,-122,1,4,5
16717,58thStGreenway22ndAve,12/26/2015 01:00:00 PM,48,-122,5,6,11
16718,58thStGreenway22ndAve,12/26/2015 02:00:00 PM,48,-122,6,3,9
16719,58thStGreenway22ndAve,12/26/2015 03:00:00 PM,48,-122,0,2,2
16720,58thStGreenway22ndAve,12/26/2015 04:00:00 PM,48,-122,0,0,0
16721,58thStGreenway22ndAve,12/26/2015 05:00:00 PM,48,-122,7,5,12
16722,58thStGreenway22ndAve,12/26/2015 06:00:00 PM,48,-122,3,0,3
16723,58thStGreenway22ndAve,12/26/2015 07:00:00 PM,48,-122,0,1,1
16724,58thStGreenway22ndAve,12/26/2015 08:00:00 PM,48,-122,0,1,1
16725,58thStGreenway22ndAve,12/26/2015 09:00:00 PM,48,-122,0,1,1
16726,58thStGreenway22ndAve,12/26/2015 10:00:00 PM,48,-122,0,0,0
16727,58thStGreenway22ndAve,12/26/2015 11:00:00 PM,48,-122,1,1,2
16728,58thStGreenway22ndAve,12/27/2015 12:00:00 AM,48,-122,0,0,0
16729,58thStGreenway22ndAve,12/27/2015 01:00:00 AM,48,-122,0,0,0
16730,58thStGreenway22ndAve,12/27/2015 02:00:00 AM,48,-122,0,0,0
16731,58thStGreenway22ndAve,12/27/2015 03:00:00 AM,48,-122,0,0,0
16732,58thStGreenway22ndAve,12/27/2015 04:00:00 AM,48,-122,0,0,0
16733,58thStGreenway22ndAve,12/27/2015 05:00:00 AM,48,-122,0,0,0
16734,58thStGreenway22ndAve,12/27/2015 06:00:00 AM,48,-122,0,0,0
16735,58thStGreenway22ndAve,12/27/2015 07:00:00 AM,48,-122,0,0,0
16736,58thStGreenway22ndAve,12/27/2015 08:00:00 AM,48,-122,1,0,1
16737,58thStGreenway22ndAve,12/27/2015 09:00:00 AM,48,-122,0,2,2
16738,58thStGreenway22ndAve,12/27/2015 10:00:00 AM,48,-122,1,0,1
16739,58thStGreenway22ndAve,12/27/2015 11:00:00 AM,48,-122,2,1,3
16740,58thStGreenway22ndAve,12/27/2015 12:00:00 PM,48,-122,2,1,3
16741,58thStGreenway22ndAve,12/27/2015 01:00:00 PM,48,-122,0,0,0
16742,58thStGreenway22ndAve,12/27/2015 02:00:00 PM,48,-122,0,0,0
16743,58thStGreenway22ndAve,12/27/2015 03:00:00 PM,48,-122,0,0,0
16744,58thStGreenway22ndAve,12/27/2015 04:00:00 PM,48,-122,1,0,1
16745,58thStGreenway22ndAve,12/27/2015 05:00:00 PM,48,-122,1,1,2
16746,58thStGreenway22ndAve,12/27/2015 06:00:00 PM,48,-122,1,0,1
16747,58thStGreenway22ndAve,12/27/2015 07:00:00 PM,48,-122,0,0,0
16748,58thStGreenway22ndAve,12/27/2015 08:00:00 PM,48,-122,0,0,0
16749,58thStGreenway22ndAve,12/27/2015 09:00:00 PM,48,-122,0,0,0
16750,58thStGreenway22ndAve,12/27/2015 10:00:00 PM,48,-122,0,1,1
16751,58thStGreenway22ndAve,12/27/2015 11:00:00 PM,48,-122,0,0,0
16752,58thStGreenway22ndAve,12/28/2015 12:00:00 AM,48,-122,0,0,0
16753,58thStGreenway22ndAve,12/28/2015 01:00:00 AM,48,-122,0,0,0
16754,58thStGreenway22ndAve,12/28/2015 02:00:00 AM,48,-122,0,0,0
16755,58thStGreenway22ndAve,12/28/2015 03:00:00 AM,48,-122,0,0,0
16756,58thStGreenway22ndAve,12/28/2015 04:00:00 AM,48,-122,0,0,0
16757,58thStGreenway22ndAve,12/28/2015 05:00:00 AM,48,-122,0,2,2
16758,58thStGreenway22ndAve,12/28/2015 06:00:00 AM,48,-122,0,1,1
16759,58thStGreenway22ndAve,12/28/2015 07:00:00 AM,48,-122,1,1,2
16760,58thStGreenway22ndAve,12/28/2015 08:00:00 AM,48,-122,3,1,4
16761,58thStGreenway22ndAve,12/28/2015 09:00:00 AM,48,-122,5,3,8
16762,58thStGreenway22ndAve,12/28/2015 10:00:00 AM,48,-122,1,2,3
16763,58thStGreenway22ndAve,12/28/2015 11:00:00 AM,48,-122,4,7,11
16764,58thStGreenway22ndAve,12/28/2015 12:00:00 PM,48,-122,6,0,6
16765,58thStGreenway22ndAve,12/28/2015 01:00:00 PM,48,-122,5,5,10
16766,58thStGreenway22ndAve,12/28/2015 02:00:00 PM,48,-122,6,1,7
16767,58thStGreenway22ndAve,12/28/2015 03:00:00 PM,48,-122,5,4,9
16768,58thStGreenway22ndAve,12/28/2015 04:00:00 PM,48,-122,3,5,8
16769,58thStGreenway22ndAve,12/28/2015 05:00:00 PM,48,-122,0,2,2
16770,58thStGreenway22ndAve,12/28/2015 06:00:00 PM,48,-122,5,3,8
16771,58thStGreenway22ndAve,12/28/2015 07:00:00 PM,48,-122,1,2,3
16772,58thStGreenway22ndAve,12/28/2015 08:00:00 PM,48,-122,2,0,2
16773,58thStGreenway22ndAve,12/28/2015 09:00:00 PM,48,-122,1,0,1
16774,58thStGreenway22ndAve,12/28/2015 10:00:00 PM,48,-122,0,0,0
16775,58thStGreenway22ndAve,12/28/2015 11:00:00 PM,48,-122,1,0,1
16776,58thStGreenway22ndAve,12/29/2015 12:00:00 AM,48,-122,0,0,0
16777,58thStGreenway22ndAve,12/29/2015 01:00:00 AM,48,-122,0,0,0
16778,58thStGreenway22ndAve,12/29/2015 02:00:00 AM,48,-122,0,0,0
16779,58thStGreenway22ndAve,12/29/2015 03:00:00 AM,48,-122,0,0,0
16780,58thStGreenway22ndAve,12/29/2015 04:00:00 AM,48,-122,0,0,0
16781,58thStGreenway22ndAve,12/29/2015 05:00:00 AM,48,-122,0,1,1
16782,58thStGreenway22ndAve,12/29/2015 06:00:00 AM,48,-122,0,3,3
16783,58thStGreenway22ndAve,12/29/2015 07:00:00 AM,48,-122,1,0,1
16784,58thStGreenway22ndAve,12/29/2015 08:00:00 AM,48,-122,1,2,3
16785,58thStGreenway22ndAve,12/29/2015 09:00:00 AM,48,-122,3,3,6
16786,58thStGreenway22ndAve,12/29/2015 10:00:00 AM,48,-122,2,1,3
16787,58thStGreenway22ndAve,12/29/2015 11:00:00 AM,48,-122,1,5,6
16788,58thStGreenway22ndAve,12/29/2015 12:00:00 PM,48,-122,4,2,6
16789,58thStGreenway22ndAve,12/29/2015 01:00:00 PM,48,-122,4,2,6
16790,58thStGreenway22ndAve,12/29/2015 02:00:00 PM,48,-122,0,1,1
16791,58thStGreenway22ndAve,12/29/2015 03:00:00 PM,48,-122,2,0,2
16792,58thStGreenway22ndAve,12/29/2015 04:00:00 PM,48,-122,4,3,7
16793,58thStGreenway22ndAve,12/29/2015 05:00:00 PM,48,-122,6,7,13
16794,58thStGreenway22ndAve,12/29/2015 06:00:00 PM,48,-122,4,4,8
16795,58thStGreenway22ndAve,12/29/2015 07:00:00 PM,48,-122,4,1,5
16796,58thStGreenway22ndAve,12/29/2015 08:00:00 PM,48,-122,2,2,4
16797,58thStGreenway22ndAve,12/29/2015 09:00:00 PM,48,-122,1,0,1
16798,58thStGreenway22ndAve,12/29/2015 10:00:00 PM,48,-122,0,4,4
16799,58thStGreenway22ndAve,12/29/2015 11:00:00 PM,48,-122,0,0,0
16800,58thStGreenway22ndAve,12/30/2015 12:00:00 AM,48,-122,0,0,0
16801,58thStGreenway22ndAve,12/30/2015 01:00:00 AM,48,-122,0,0,0
16802,58thStGreenway22ndAve,12/30/2015 02:00:00 AM,48,-122,0,0,0
16803,58thStGreenway22ndAve,12/30/2015 03:00:00 AM,48,-122,0,0,0
16804,58thStGreenway22ndAve,12/30/2015 04:00:00 AM,48,-122,0,0,0
16805,58thStGreenway22ndAve,12/30/2015 05:00:00 AM,48,-122,0,0,0
16806,58thStGreenway22ndAve,12/30/2015 06:00:00 AM,48,-122,0,2,2
16807,58thStGreenway22ndAve,12/30/2015 07:00:00 AM,48,-122,0,1,1
16808,58thStGreenway22ndAve,12/30/2015 08:00:00 AM,48,-122,5,1,6
16809,58thStGreenway22ndAve,12/30/2015 09:00:00 AM,48,-122,3,1,4
16810,58thStGreenway22ndAve,12/30/2015 10:00:00 AM,48,-122,2,0,2
16811,58thStGreenway22ndAve,12/30/2015 11:00:00 AM,48,-122,1,3,4
16812,58thStGreenway22ndAve,12/30/2015 12:00:00 PM,48,-122,2,1,3
16813,58thStGreenway22ndAve,12/30/2015 01:00:00 PM,48,-122,2,1,3
16814,58thStGreenway22ndAve,12/30/2015 02:00:00 PM,48,-122,6,3,9
16815,58thStGreenway22ndAve,12/30/2015 03:00:00 PM,48,-122,2,2,4
16816,58thStGreenway22ndAve,12/30/2015 04:00:00 PM,48,-122,2,2,4
16817,58thStGreenway22ndAve,12/30/2015 05:00:00 PM,48,-122,7,4,11
16818,58thStGreenway22ndAve,12/30/2015 06:00:00 PM,48,-122,6,3,9
16819,58thStGreenway22ndAve,12/30/2015 07:00:00 PM,48,-122,1,2,3
16820,58thStGreenway22ndAve,12/30/2015 08:00:00 PM,48,-122,2,1,3
16821,58thStGreenway22ndAve,12/30/2015 09:00:00 PM,48,-122,1,0,1
16822,58thStGreenway22ndAve,12/30/2015 10:00:00 PM,48,-122,0,0,0
16823,58thStGreenway22ndAve,12/30/2015 11:00:00 PM,48,-122,1,1,2
16824,58thStGreenway22ndAve,12/31/2015 12:00:00 AM,48,-122,0,1,1
16825,58thStGreenway22ndAve,12/31/2015 01:00:00 AM,48,-122,0,0,0
16826,58thStGreenway22ndAve,12/31/2015 02:00:00 AM,48,-122,0,0,0
16827,58thStGreenway22ndAve,12/31/2015 03:00:00 AM,48,-122,0,0,0
16828,58thStGreenway22ndAve,12/31/2015 04:00:00 AM,48,-122,0,0,0
16829,58thStGreenway22ndAve,12/31/2015 05:00:00 AM,48,-122,0,0,0
16830,58thStGreenway22ndAve,12/31/2015 06:00:00 AM,48,-122,0,2,2
16831,58thStGreenway22ndAve,12/31/2015 07:00:00 AM,48,-122,0,2,2
16832,58thStGreenway22ndAve,12/31/2015 08:00:00 AM,48,-122,4,0,4
16833,58thStGreenway22ndAve,12/31/2015 09:00:00 AM,48,-122,1,1,2
16834,58thStGreenway22ndAve,12/31/2015 10:00:00 AM,48,-122,0,0,0
16835,58thStGreenway22ndAve,12/31/2015 11:00:00 AM,48,-122,1,4,5
16836,58thStGreenway22ndAve,12/31/2015 12:00:00 PM,48,-122,3,1,4
16837,58thStGreenway22ndAve,12/31/2015 01:00:00 PM,48,-122,3,4,7
16838,58thStGreenway22ndAve,12/31/2015 02:00:00 PM,48,-122,5,3,8
16839,58thStGreenway22ndAve,12/31/2015 03:00:00 PM,48,-122,4,2,6
16840,58thStGreenway22ndAve,12/31/2015 04:00:00 PM,48,-122,4,3,7
16841,58thStGreenway22ndAve,12/31/2015 05:00:00 PM,48,-122,0,1,1
16842,58thStGreenway22ndAve,12/31/2015 06:00:00 PM,48,-122,0,0,0
16843,58thStGreenway22ndAve,12/31/2015 07:00:00 PM,48,-122,2,0,2
16844,58thStGreenway22ndAve,12/31/2015 08:00:00 PM,48,-122,0,0,0
16845,58thStGreenway22ndAve,12/31/2015 09:00:00 PM,48,-122,0,3,3
16846,58thStGreenway22ndAve,12/31/2015 10:00:00 PM,48,-122,2,0,2
16847,58thStGreenway22ndAve,12/31/2015 11:00:00 PM,48,-122,0,0,0
16848,58thStGreenway22ndAve,01/01/2016 12:00:00 AM,48,-122,0,0,0
16849,58thStGreenway22ndAve,01/01/2016 01:00:00 AM,48,-122,0,0,0
16850,58thStGreenway22ndAve,01/01/2016 02:00:00 AM,48,-122,0,1,1
16851,58thStGreenway22ndAve,01/01/2016 03:00:00 AM,48,-122,0,0,0
16852,58thStGreenway22ndAve,01/01/2016 04:00:00 AM,48,-122,0,0,0
16853,58thStGreenway22ndAve,01/01/2016 05:00:00 AM,48,-122,0,0,0
16854,58thStGreenway22ndAve,01/01/2016 06:00:00 AM,48,-122,0,0,0
16855,58thStGreenway22ndAve,01/01/2016 07:00:00 AM,48,-122,0,1,1
16856,58thStGreenway22ndAve,01/01/2016 08:00:00 AM,48,-122,0,0,0
16857,58thStGreenway22ndAve,01/01/2016 09:00:00 AM,48,-122,0,0,0
16858,58thStGreenway22ndAve,01/01/2016 10:00:00 AM,48,-122,0,2,2
16859,58thStGreenway22ndAve,01/01/2016 11:00:00 AM,48,-122,0,7,7
16860,58thStGreenway22ndAve,01/01/2016 12:00:00 PM,48,-122,0,1,1
16861,58thStGreenway22ndAve,01/01/2016 01:00:00 PM,48,-122,7,7,14
16862,58thStGreenway22ndAve,01/01/2016 02:00:00 PM,48,-122,2,7,9
16863,58thStGreenway22ndAve,01/01/2016 03:00:00 PM,48,-122,5,7,12
16864,58thStGreenway22ndAve,01/01/2016 04:00:00 PM,48,-122,4,0,4
16865,58thStGreenway22ndAve,01/01/2016 05:00:00 PM,48,-122,1,3,4
16866,58thStGreenway22ndAve,01/01/2016 06:00:00 PM,48,-122,0,3,3
16867,58thStGreenway22ndAve,01/01/2016 07:00:00 PM,48,-122,0,2,2
16868,58thStGreenway22ndAve,01/01/2016 08:00:00 PM,48,-122,0,0,0
16869,58thStGreenway22ndAve,01/01/2016 09:00:00 PM,48,-122,0,1,1
16870,58thStGreenway22ndAve,01/01/2016 10:00:00 PM,48,-122,0,0,0
16871,58thStGreenway22ndAve,01/01/2016 11:00:00 PM,48,-122,0,1,1
16872,58thStGreenway22ndAve,01/02/2016 12:00:00 AM,48,-122,0,0,0
16873,58thStGreenway22ndAve,01/02/2016 01:00:00 AM,48,-122,0,0,0
16874,58thStGreenway22ndAve,01/02/2016 02:00:00 AM,48,-122,0,0,0
16875,58thStGreenway22ndAve,01/02/2016 03:00:00 AM,48,-122,0,0,0
16876,58thStGreenway22ndAve,01/02/2016 04:00:00 AM,48,-122,0,0,0
16877,58thStGreenway22ndAve,01/02/2016 05:00:00 AM,48,-122,0,0,0
16878,58thStGreenway22ndAve,01/02/2016 06:00:00 AM,48,-122,0,1,1
16879,58thStGreenway22ndAve,01/02/2016 07:00:00 AM,48,-122,0,0,0
16880,58thStGreenway22ndAve,01/02/2016 08:00:00 AM,48,-122,0,1,1
16881,58thStGreenway22ndAve,01/02/2016 09:00:00 AM,48,-122,1,3,4
16882,58thStGreenway22ndAve,01/02/2016 10:00:00 AM,48,-122,0,1,1
16883,58thStGreenway22ndAve,01/02/2016 11:00:00 AM,48,-122,2,3,5
16884,58thStGreenway22ndAve,01/02/2016 12:00:00 PM,48,-122,4,4,8
16885,58thStGreenway22ndAve,01/02/2016 01:00:00 PM,48,-122,4,4,8
16886,58thStGreenway22ndAve,01/02/2016 02:00:00 PM,48,-122,3,6,9
16887,58thStGreenway22ndAve,01/02/2016 03:00:00 PM,48,-122,5,5,10
16888,58thStGreenway22ndAve,01/02/2016 04:00:00 PM,48,-122,6,1,7
16889,58thStGreenway22ndAve,01/02/2016 05:00:00 PM,48,-122,2,0,2
16890,58thStGreenway22ndAve,01/02/2016 06:00:00 PM,48,-122,1,1,2
16891,58thStGreenway22ndAve,01/02/2016 07:00:00 PM,48,-122,1,2,3
16892,58thStGreenway22ndAve,01/02/2016 08:00:00 PM,48,-122,1,1,2
16893,58thStGreenway22ndAve,01/02/2016 09:00:00 PM,48,-122,1,0,1
16894,58thStGreenway22ndAve,01/02/2016 10:00:00 PM,48,-122,0,0,0
16895,58thStGreenway22ndAve,01/02/2016 11:00:00 PM,48,-122,0,0,0
16896,58thStGreenway22ndAve,01/03/2016 12:00:00 AM,48,-122,0,1,1
16897,58thStGreenway22ndAve,01/03/2016 01:00:00 AM,48,-122,0,0,0
16898,58thStGreenway22ndAve,01/03/2016 02:00:00 AM,48,-122,0,0,0
16899,58thStGreenway22ndAve,01/03/2016 03:00:00 AM,48,-122,0,0,0
16900,58thStGreenway22ndAve,01/03/2016 04:00:00 AM,48,-122,0,0,0
16901,58thStGreenway22ndAve,01/03/2016 05:00:00 AM,48,-122,0,1,1
16902,58thStGreenway22ndAve,01/03/2016 06:00:00 AM,48,-122,1,0,1
16903,58thStGreenway22ndAve,01/03/2016 07:00:00 AM,48,-122,0,1,1
16904,58thStGreenway22ndAve,01/03/2016 08:00:00 AM,48,-122,0,0,0
16905,58thStGreenway22ndAve,01/03/2016 09:00:00 AM,48,-122,0,0,0
16906,58thStGreenway22ndAve,01/03/2016 10:00:00 AM,48,-122,4,4,8
16907,58thStGreenway22ndAve,01/03/2016 11:00:00 AM,48,-122,10,1,11
16908,58thStGreenway22ndAve,01/03/2016 12:00:00 PM,48,-122,3,6,9
16909,58thStGreenway22ndAve,01/03/2016 01:00:00 PM,48,-122,2,0,2
16910,58thStGreenway22ndAve,01/03/2016 02:00:00 PM,48,-122,0,3,3
16911,58thStGreenway22ndAve,01/03/2016 03:00:00 PM,48,-122,1,2,3
16912,58thStGreenway22ndAve,01/03/2016 04:00:00 PM,48,-122,4,4,8
16913,58thStGreenway22ndAve,01/03/2016 05:00:00 PM,48,-122,0,2,2
16914,58thStGreenway22ndAve,01/03/2016 06:00:00 PM,48,-122,0,0,0
16915,58thStGreenway22ndAve,01/03/2016 07:00:00 PM,48,-122,0,0,0
16916,58thStGreenway22ndAve,01/03/2016 08:00:00 PM,48,-122,0,0,0
16917,58thStGreenway22ndAve,01/03/2016 09:00:00 PM,48,-122,0,0,0
16918,58thStGreenway22ndAve,01/03/2016 10:00:00 PM,48,-122,0,0,0
16919,58thStGreenway22ndAve,01/03/2016 11:00:00 PM,48,-122,0,0,0
16920,58thStGreenway22ndAve,01/04/2016 12:00:00 AM,48,-122,0,0,0
16921,58thStGreenway22ndAve,01/04/2016 01:00:00 AM,48,-122,0,1,1
16922,58thStGreenway22ndAve,01/04/2016 02:00:00 AM,48,-122,0,0,0
16923,58thStGreenway22ndAve,01/04/2016 03:00:00 AM,48,-122,0,0,0
16924,58thStGreenway22ndAve,01/04/2016 04:00:00 AM,48,-122,0,0,0
16925,58thStGreenway22ndAve,01/04/2016 05:00:00 AM,48,-122,0,1,1
16926,58thStGreenway22ndAve,01/04/2016 06:00:00 AM,48,-122,1,3,4
16927,58thStGreenway22ndAve,01/04/2016 07:00:00 AM,48,-122,1,1,2
16928,58thStGreenway22ndAve,01/04/2016 08:00:00 AM,48,-122,4,3,7
16929,58thStGreenway22ndAve,01/04/2016 09:00:00 AM,48,-122,5,2,7
16930,58thStGreenway22ndAve,01/04/2016 10:00:00 AM,48,-122,0,1,1
16931,58thStGreenway22ndAve,01/04/2016 11:00:00 AM,48,-122,1,3,4
16932,58thStGreenway22ndAve,01/04/2016 12:00:00 PM,48,-122,0,0,0
16933,58thStGreenway22ndAve,01/04/2016 01:00:00 PM,48,-122,3,2,5
16934,58thStGreenway22ndAve,01/04/2016 02:00:00 PM,48,-122,0,1,1
16935,58thStGreenway22ndAve,01/04/2016 03:00:00 PM,48,-122,1,0,1
16936,58thStGreenway22ndAve,01/04/2016 04:00:00 PM,48,-122,6,4,10
16937,58thStGreenway22ndAve,01/04/2016 05:00:00 PM,48,-122,4,4,8
16938,58thStGreenway22ndAve,01/04/2016 06:00:00 PM,48,-122,1,1,2
16939,58thStGreenway22ndAve,01/04/2016 07:00:00 PM,48,-122,1,3,4
16940,58thStGreenway22ndAve,01/04/2016 08:00:00 PM,48,-122,3,0,3
16941,58thStGreenway22ndAve,01/04/2016 09:00:00 PM,48,-122,0,0,0
16942,58thStGreenway22ndAve,01/04/2016 10:00:00 PM,48,-122,0,2,2
16943,58thStGreenway22ndAve,01/04/2016 11:00:00 PM,48,-122,0,0,0
16944,58thStGreenway22ndAve,01/05/2016 12:00:00 AM,48,-122,0,0,0
16945,58thStGreenway22ndAve,01/05/2016 01:00:00 AM,48,-122,1,2,3
16946,58thStGreenway22ndAve,01/05/2016 02:00:00 AM,48,-122,0,0,0
16947,58thStGreenway22ndAve,01/05/2016 03:00:00 AM,48,-122,0,0,0
16948,58thStGreenway22ndAve,01/05/2016 04:00:00 AM,48,-122,0,0,0
16949,58thStGreenway22ndAve,01/05/2016 05:00:00 AM,48,-122,0,2,2
16950,58thStGreenway22ndAve,01/05/2016 06:00:00 AM,48,-122,1,2,3
16951,58thStGreenway22ndAve,01/05/2016 07:00:00 AM,48,-122,4,2,6
16952,58thStGreenway22ndAve,01/05/2016 08:00:00 AM,48,-122,0,2,2
16953,58thStGreenway22ndAve,01/05/2016 09:00:00 AM,48,-122,4,3,7
16954,58thStGreenway22ndAve,01/05/2016 10:00:00 AM,48,-122,1,4,5
16955,58thStGreenway22ndAve,01/05/2016 11:00:00 AM,48,-122,1,3,4
16956,58thStGreenway22ndAve,01/05/2016 12:00:00 PM,48,-122,3,2,5
16957,58thStGreenway22ndAve,01/05/2016 01:00:00 PM,48,-122,3,2,5
16958,58thStGreenway22ndAve,01/05/2016 02:00:00 PM,48,-122,3,0,3
16959,58thStGreenway22ndAve,01/05/2016 03:00:00 PM,48,-122,0,1,1
16960,58thStGreenway22ndAve,01/05/2016 04:00:00 PM,48,-122,5,5,10
16961,58thStGreenway22ndAve,01/05/2016 05:00:00 PM,48,-122,2,2,4
16962,58thStGreenway22ndAve,01/05/2016 06:00:00 PM,48,-122,1,4,5
16963,58thStGreenway22ndAve,01/05/2016 07:00:00 PM,48,-122,2,2,4
16964,58thStGreenway22ndAve,01/05/2016 08:00:00 PM,48,-122,1,1,2
16965,58thStGreenway22ndAve,01/05/2016 09:00:00 PM,48,-122,1,1,2
16966,58thStGreenway22ndAve,01/05/2016 10:00:00 PM,48,-122,1,3,4
16967,58thStGreenway22ndAve,01/05/2016 11:00:00 PM,48,-122,1,1,2
16968,58thStGreenway22ndAve,01/06/2016 12:00:00 AM,48,-122,0,0,0
16969,58thStGreenway22ndAve,01/06/2016 01:00:00 AM,48,-122,0,0,0
16970,58thStGreenway22ndAve,01/06/2016 02:00:00 AM,48,-122,0,0,0
16971,58thStGreenway22ndAve,01/06/2016 03:00:00 AM,48,-122,0,0,0
16972,58thStGreenway22ndAve,01/06/2016 04:00:00 AM,48,-122,0,0,0
16973,58thStGreenway22ndAve,01/06/2016 05:00:00 AM,48,-122,0,1,1
16974,58thStGreenway22ndAve,01/06/2016 06:00:00 AM,48,-122,1,3,4
16975,58thStGreenway22ndAve,01/06/2016 07:00:00 AM,48,-122,4,3,7
16976,58thStGreenway22ndAve,01/06/2016 08:00:00 AM,48,-122,3,1,4
16977,58thStGreenway22ndAve,01/06/2016 09:00:00 AM,48,-122,5,5,10
16978,58thStGreenway22ndAve,01/06/2016 10:00:00 AM,48,-122,1,5,6
16979,58thStGreenway22ndAve,01/06/2016 11:00:00 AM,48,-122,4,2,6
16980,58thStGreenway22ndAve,01/06/2016 12:00:00 PM,48,-122,2,2,4
16981,58thStGreenway22ndAve,01/06/2016 01:00:00 PM,48,-122,7,4,11
16982,58thStGreenway22ndAve,01/06/2016 02:00:00 PM,48,-122,5,5,10
16983,58thStGreenway22ndAve,01/06/2016 03:00:00 PM,48,-122,4,2,6
16984,58thStGreenway22ndAve,01/06/2016 04:00:00 PM,48,-122,4,2,6
16985,58thStGreenway22ndAve,01/06/2016 05:00:00 PM,48,-122,6,1,7
16986,58thStGreenway22ndAve,01/06/2016 06:00:00 PM,48,-122,3,6,9
16987,58thStGreenway22ndAve,01/06/2016 07:00:00 PM,48,-122,0,2,2
16988,58thStGreenway22ndAve,01/06/2016 08:00:00 PM,48,-122,1,1,2
16989,58thStGreenway22ndAve,01/06/2016 09:00:00 PM,48,-122,3,0,3
16990,58thStGreenway22ndAve,01/06/2016 10:00:00 PM,48,-122,0,1,1
16991,58thStGreenway22ndAve,01/06/2016 11:00:00 PM,48,-122,1,2,3
16992,58thStGreenway22ndAve,01/07/2016 12:00:00 AM,48,-122,1,0,1
16993,58thStGreenway22ndAve,01/07/2016 01:00:00 AM,48,-122,0,0,0
16994,58thStGreenway22ndAve,01/07/2016 02:00:00 AM,48,-122,0,0,0
16995,58thStGreenway22ndAve,01/07/2016 03:00:00 AM,48,-122,0,0,0
16996,58thStGreenway22ndAve,01/07/2016 04:00:00 AM,48,-122,0,0,0
16997,58thStGreenway22ndAve,01/07/2016 05:00:00 AM,48,-122,0,0,0
16998,58thStGreenway22ndAve,01/07/2016 06:00:00 AM,48,-122,0,3,3
16999,58thStGreenway22ndAve,01/07/2016 07:00:00 AM,48,-122,3,1,4
17000,58thStGreenway22ndAve,01/07/2016 08:00:00 AM,48,-122,0,2,2
17001,58thStGreenway22ndAve,01/07/2016 09:00:00 AM,48,-122,3,3,6
17002,58thStGreenway22ndAve,01/07/2016 10:00:00 AM,48,-122,0,1,1
17003,58thStGreenway22ndAve,01/07/2016 11:00:00 AM,48,-122,3,2,5
17004,58thStGreenway22ndAve,01/07/2016 12:00:00 PM,48,-122,1,0,1
17005,58thStGreenway22ndAve,01/07/2016 01:00:00 PM,48,-122,0,1,1
17006,58thStGreenway22ndAve,01/07/2016 02:00:00 PM,48,-122,5,2,7
17007,58thStGreenway22ndAve,01/07/2016 03:00:00 PM,48,-122,5,1,6
17008,58thStGreenway22ndAve,01/07/2016 04:00:00 PM,48,-122,4,2,6
17009,58thStGreenway22ndAve,01/07/2016 05:00:00 PM,48,-122,3,6,9
17010,58thStGreenway22ndAve,01/07/2016 06:00:00 PM,48,-122,6,4,10
17011,58thStGreenway22ndAve,01/07/2016 07:00:00 PM,48,-122,0,2,2
17012,58thStGreenway22ndAve,01/07/2016 08:00:00 PM,48,-122,4,0,4
17013,58thStGreenway22ndAve,01/07/2016 09:00:00 PM,48,-122,1,3,4
17014,58thStGreenway22ndAve,01/07/2016 10:00:00 PM,48,-122,2,1,3
17015,58thStGreenway22ndAve,01/07/2016 11:00:00 PM,48,-122,2,1,3
17016,58thStGreenway22ndAve,01/08/2016 12:00:00 AM,48,-122,1,0,1
17017,58thStGreenway22ndAve,01/08/2016 01:00:00 AM,48,-122,0,0,0
17018,58thStGreenway22ndAve,01/08/2016 02:00:00 AM,48,-122,1,0,1
17019,58thStGreenway22ndAve,01/08/2016 03:00:00 AM,48,-122,0,1,1
17020,58thStGreenway22ndAve,01/08/2016 04:00:00 AM,48,-122,2,0,2
17021,58thStGreenway22ndAve,01/08/2016 05:00:00 AM,48,-122,0,0,0
17022,58thStGreenway22ndAve,01/08/2016 06:00:00 AM,48,-122,0,0,0
17023,58thStGreenway22ndAve,01/08/2016 07:00:00 AM,48,-122,2,1,3
17024,58thStGreenway22ndAve,01/08/2016 08:00:00 AM,48,-122,6,4,10
17025,58thStGreenway22ndAve,01/08/2016 09:00:00 AM,48,-122,5,2,7
17026,58thStGreenway22ndAve,01/08/2016 10:00:00 AM,48,-122,3,4,7
17027,58thStGreenway22ndAve,01/08/2016 11:00:00 AM,48,-122,2,4,6
17028,58thStGreenway22ndAve,01/08/2016 12:00:00 PM,48,-122,2,4,6
17029,58thStGreenway22ndAve,01/08/2016 01:00:00 PM,48,-122,2,1,3
17030,58thStGreenway22ndAve,01/08/2016 02:00:00 PM,48,-122,2,2,4
17031,58thStGreenway22ndAve,01/08/2016 03:00:00 PM,48,-122,3,3,6
17032,58thStGreenway22ndAve,01/08/2016 04:00:00 PM,48,-122,3,0,3
17033,58thStGreenway22ndAve,01/08/2016 05:00:00 PM,48,-122,4,5,9
17034,58thStGreenway22ndAve,01/08/2016 06:00:00 PM,48,-122,1,2,3
17035,58thStGreenway22ndAve,01/08/2016 07:00:00 PM,48,-122,2,8,10
17036,58thStGreenway22ndAve,01/08/2016 08:00:00 PM,48,-122,2,0,2
17037,58thStGreenway22ndAve,01/08/2016 09:00:00 PM,48,-122,2,0,2
17038,58thStGreenway22ndAve,01/08/2016 10:00:00 PM,48,-122,0,1,1
17039,58thStGreenway22ndAve,01/08/2016 11:00:00 PM,48,-122,0,1,1
17040,58thStGreenway22ndAve,01/09/2016 12:00:00 AM,48,-122,2,1,3
17041,58thStGreenway22ndAve,01/09/2016 01:00:00 AM,48,-122,0,0,0
17042,58thStGreenway22ndAve,01/09/2016 02:00:00 AM,48,-122,0,0,0
17043,58thStGreenway22ndAve,01/09/2016 03:00:00 AM,48,-122,1,1,2
17044,58thStGreenway22ndAve,01/09/2016 04:00:00 AM,48,-122,0,0,0
17045,58thStGreenway22ndAve,01/09/2016 05:00:00 AM,48,-122,0,0,0
17046,58thStGreenway22ndAve,01/09/2016 06:00:00 AM,48,-122,2,2,4
17047,58thStGreenway22ndAve,01/09/2016 07:00:00 AM,48,-122,1,0,1
17048,58thStGreenway22ndAve,01/09/2016 08:00:00 AM,48,-122,0,1,1
17049,58thStGreenway22ndAve,01/09/2016 09:00:00 AM,48,-122,7,1,8
17050,58thStGreenway22ndAve,01/09/2016 10:00:00 AM,48,-122,1,6,7
17051,58thStGreenway22ndAve,01/09/2016 11:00:00 AM,48,-122,7,4,11
17052,58thStGreenway22ndAve,01/09/2016 12:00:00 PM,48,-122,4,3,7
17053,58thStGreenway22ndAve,01/09/2016 01:00:00 PM,48,-122,1,8,9
17054,58thStGreenway22ndAve,01/09/2016 02:00:00 PM,48,-122,0,3,3
17055,58thStGreenway22ndAve,01/09/2016 03:00:00 PM,48,-122,6,2,8
17056,58thStGreenway22ndAve,01/09/2016 04:00:00 PM,48,-122,5,2,7
17057,58thStGreenway22ndAve,01/09/2016 05:00:00 PM,48,-122,3,0,3
17058,58thStGreenway22ndAve,01/09/2016 06:00:00 PM,48,-122,0,1,1
17059,58thStGreenway22ndAve,01/09/2016 07:00:00 PM,48,-122,0,0,0
17060,58thStGreenway22ndAve,01/09/2016 08:00:00 PM,48,-122,0,1,1
17061,58thStGreenway22ndAve,01/09/2016 09:00:00 PM,48,-122,0,0,0
17062,58thStGreenway22ndAve,01/09/2016 10:00:00 PM,48,-122,0,0,0
17063,58thStGreenway22ndAve,01/09/2016 11:00:00 PM,48,-122,0,0,0
17064,58thStGreenway22ndAve,01/10/2016 12:00:00 AM,48,-122,0,0,0
17065,58thStGreenway22ndAve,01/10/2016 01:00:00 AM,48,-122,0,0,0
17066,58thStGreenway22ndAve,01/10/2016 02:00:00 AM,48,-122,0,0,0
17067,58thStGreenway22ndAve,01/10/2016 03:00:00 AM,48,-122,0,0,0
17068,58thStGreenway22ndAve,01/10/2016 04:00:00 AM,48,-122,0,0,0
17069,58thStGreenway22ndAve,01/10/2016 05:00:00 AM,48,-122,1,0,1
17070,58thStGreenway22ndAve,01/10/2016 06:00:00 AM,48,-122,0,1,1
17071,58thStGreenway22ndAve,01/10/2016 07:00:00 AM,48,-122,0,0,0
17072,58thStGreenway22ndAve,01/10/2016 08:00:00 AM,48,-122,2,2,4
17073,58thStGreenway22ndAve,01/10/2016 09:00:00 AM,48,-122,0,5,5
17074,58thStGreenway22ndAve,01/10/2016 10:00:00 AM,48,-122,2,4,6
17075,58thStGreenway22ndAve,01/10/2016 11:00:00 AM,48,-122,5,1,6
17076,58thStGreenway22ndAve,01/10/2016 12:00:00 PM,48,-122,6,10,16
17077,58thStGreenway22ndAve,01/10/2016 01:00:00 PM,48,-122,1,1,2
17078,58thStGreenway22ndAve,01/10/2016 02:00:00 PM,48,-122,7,5,12
17079,58thStGreenway22ndAve,01/10/2016 03:00:00 PM,48,-122,5,8,13
17080,58thStGreenway22ndAve,01/10/2016 04:00:00 PM,48,-122,2,2,4
17081,58thStGreenway22ndAve,01/10/2016 05:00:00 PM,48,-122,2,0,2
17082,58thStGreenway22ndAve,01/10/2016 06:00:00 PM,48,-122,1,3,4
17083,58thStGreenway22ndAve,01/10/2016 07:00:00 PM,48,-122,1,0,1
17084,58thStGreenway22ndAve,01/10/2016 08:00:00 PM,48,-122,1,0,1
17085,58thStGreenway22ndAve,01/10/2016 09:00:00 PM,48,-122,0,0,0
17086,58thStGreenway22ndAve,01/10/2016 10:00:00 PM,48,-122,0,0,0
17087,58thStGreenway22ndAve,01/10/2016 11:00:00 PM,48,-122,0,0,0
17088,58thStGreenway22ndAve,01/11/2016 12:00:00 AM,48,-122,0,0,0
17089,58thStGreenway22ndAve,01/11/2016 01:00:00 AM,48,-122,0,0,0
17090,58thStGreenway22ndAve,01/11/2016 02:00:00 AM,48,-122,0,0,0
17091,58thStGreenway22ndAve,01/11/2016 03:00:00 AM,48,-122,1,1,2
17092,58thStGreenway22ndAve,01/11/2016 04:00:00 AM,48,-122,0,0,0
17093,58thStGreenway22ndAve,01/11/2016 05:00:00 AM,48,-122,0,0,0
17094,58thStGreenway22ndAve,01/11/2016 06:00:00 AM,48,-122,0,1,1
17095,58thStGreenway22ndAve,01/11/2016 07:00:00 AM,48,-122,3,1,4
17096,58thStGreenway22ndAve,01/11/2016 08:00:00 AM,48,-122,2,7,9
17097,58thStGreenway22ndAve,01/11/2016 09:00:00 AM,48,-122,5,6,11
17098,58thStGreenway22ndAve,01/11/2016 10:00:00 AM,48,-122,0,2,2
17099,58thStGreenway22ndAve,01/11/2016 11:00:00 AM,48,-122,0,0,0
17100,58thStGreenway22ndAve,01/11/2016 12:00:00 PM,48,-122,0,2,2
17101,58thStGreenway22ndAve,01/11/2016 01:00:00 PM,48,-122,0,1,1
17102,58thStGreenway22ndAve,01/11/2016 02:00:00 PM,48,-122,3,2,5
17103,58thStGreenway22ndAve,01/11/2016 03:00:00 PM,48,-122,3,2,5
17104,58thStGreenway22ndAve,01/11/2016 04:00:00 PM,48,-122,9,3,12
17105,58thStGreenway22ndAve,01/11/2016 05:00:00 PM,48,-122,10,6,16
17106,58thStGreenway22ndAve,01/11/2016 06:00:00 PM,48,-122,4,6,10
17107,58thStGreenway22ndAve,01/11/2016 07:00:00 PM,48,-122,3,3,6
17108,58thStGreenway22ndAve,01/11/2016 08:00:00 PM,48,-122,2,0,2
17109,58thStGreenway22ndAve,01/11/2016 09:00:00 PM,48,-122,1,1,2
17110,58thStGreenway22ndAve,01/11/2016 10:00:00 PM,48,-122,2,1,3
17111,58thStGreenway22ndAve,01/11/2016 11:00:00 PM,48,-122,0,1,1
17112,58thStGreenway22ndAve,01/12/2016 12:00:00 AM,48,-122,0,0,0
17113,58thStGreenway22ndAve,01/12/2016 01:00:00 AM,48,-122,0,0,0
17114,58thStGreenway22ndAve,01/12/2016 02:00:00 AM,48,-122,0,0,0
17115,58thStGreenway22ndAve,01/12/2016 03:00:00 AM,48,-122,1,1,2
17116,58thStGreenway22ndAve,01/12/2016 04:00:00 AM,48,-122,0,0,0
17117,58thStGreenway22ndAve,01/12/2016 05:00:00 AM,48,-122,0,2,2
17118,58thStGreenway22ndAve,01/12/2016 06:00:00 AM,48,-122,1,1,2
17119,58thStGreenway22ndAve,01/12/2016 07:00:00 AM,48,-122,5,3,8
17120,58thStGreenway22ndAve,01/12/2016 08:00:00 AM,48,-122,6,5,11
17121,58thStGreenway22ndAve,01/12/2016 09:00:00 AM,48,-122,4,3,7
17122,58thStGreenway22ndAve,01/12/2016 10:00:00 AM,48,-122,0,3,3
17123,58thStGreenway22ndAve,01/12/2016 11:00:00 AM,48,-122,2,3,5
17124,58thStGreenway22ndAve,01/12/2016 12:00:00 PM,48,-122,0,1,1
17125,58thStGreenway22ndAve,01/12/2016 01:00:00 PM,48,-122,3,3,6
17126,58thStGreenway22ndAve,01/12/2016 02:00:00 PM,48,-122,0,3,3
17127,58thStGreenway22ndAve,01/12/2016 03:00:00 PM,48,-122,1,2,3
17128,58thStGreenway22ndAve,01/12/2016 04:00:00 PM,48,-122,2,2,4
17129,58thStGreenway22ndAve,01/12/2016 05:00:00 PM,48,-122,3,4,7
17130,58thStGreenway22ndAve,01/12/2016 06:00:00 PM,48,-122,6,5,11
17131,58thStGreenway22ndAve,01/12/2016 07:00:00 PM,48,-122,3,2,5
17132,58thStGreenway22ndAve,01/12/2016 08:00:00 PM,48,-122,1,2,3
17133,58thStGreenway22ndAve,01/12/2016 09:00:00 PM,48,-122,1,1,2
17134,58thStGreenway22ndAve,01/12/2016 10:00:00 PM,48,-122,1,0,1
17135,58thStGreenway22ndAve,01/12/2016 11:00:00 PM,48,-122,0,0,0
17136,58thStGreenway22ndAve,01/13/2016 12:00:00 AM,48,-122,0,0,0
17137,58thStGreenway22ndAve,01/13/2016 01:00:00 AM,48,-122,0,0,0
17138,58thStGreenway22ndAve,01/13/2016 02:00:00 AM,48,-122,0,0,0
17139,58thStGreenway22ndAve,01/13/2016 03:00:00 AM,48,-122,0,0,0
17140,58thStGreenway22ndAve,01/13/2016 04:00:00 AM,48,-122,0,0,0
17141,58thStGreenway22ndAve,01/13/2016 05:00:00 AM,48,-122,0,0,0
17142,58thStGreenway22ndAve,01/13/2016 06:00:00 AM,48,-122,0,2,2
17143,58thStGreenway22ndAve,01/13/2016 07:00:00 AM,48,-122,3,0,3
17144,58thStGreenway22ndAve,01/13/2016 08:00:00 AM,48,-122,3,1,4
17145,58thStGreenway22ndAve,01/13/2016 09:00:00 AM,48,-122,2,2,4
17146,58thStGreenway22ndAve,01/13/2016 10:00:00 AM,48,-122,2,3,5
17147,58thStGreenway22ndAve,01/13/2016 11:00:00 AM,48,-122,0,2,2
17148,58thStGreenway22ndAve,01/13/2016 12:00:00 PM,48,-122,1,2,3
17149,58thStGreenway22ndAve,01/13/2016 01:00:00 PM,48,-122,0,0,0
17150,58thStGreenway22ndAve,01/13/2016 02:00:00 PM,48,-122,1,2,3
17151,58thStGreenway22ndAve,01/13/2016 03:00:00 PM,48,-122,6,0,6
17152,58thStGreenway22ndAve,01/13/2016 04:00:00 PM,48,-122,4,0,4
17153,58thStGreenway22ndAve,01/13/2016 05:00:00 PM,48,-122,1,0,1
17154,58thStGreenway22ndAve,01/13/2016 06:00:00 PM,48,-122,1,3,4
17155,58thStGreenway22ndAve,01/13/2016 07:00:00 PM,48,-122,1,4,5
17156,58thStGreenway22ndAve,01/13/2016 08:00:00 PM,48,-122,0,2,2
17157,58thStGreenway22ndAve,01/13/2016 09:00:00 PM,48,-122,1,2,3
17158,58thStGreenway22ndAve,01/13/2016 10:00:00 PM,48,-122,1,0,1
17159,58thStGreenway22ndAve,01/13/2016 11:00:00 PM,48,-122,0,2,2
17160,58thStGreenway22ndAve,01/14/2016 12:00:00 AM,48,-122,0,1,1
17161,58thStGreenway22ndAve,01/14/2016 01:00:00 AM,48,-122,0,0,0
17162,58thStGreenway22ndAve,01/14/2016 02:00:00 AM,48,-122,0,0,0
17163,58thStGreenway22ndAve,01/14/2016 03:00:00 AM,48,-122,0,0,0
17164,58thStGreenway22ndAve,01/14/2016 04:00:00 AM,48,-122,0,0,0
17165,58thStGreenway22ndAve,01/14/2016 05:00:00 AM,48,-122,1,1,2
17166,58thStGreenway22ndAve,01/14/2016 06:00:00 AM,48,-122,0,3,3
17167,58thStGreenway22ndAve,01/14/2016 07:00:00 AM,48,-122,2,1,3
17168,58thStGreenway22ndAve,01/14/2016 08:00:00 AM,48,-122,3,3,6
17169,58thStGreenway22ndAve,01/14/2016 09:00:00 AM,48,-122,9,0,9
17170,58thStGreenway22ndAve,01/14/2016 10:00:00 AM,48,-122,1,2,3
17171,58thStGreenway22ndAve,01/14/2016 11:00:00 AM,48,-122,1,5,6
17172,58thStGreenway22ndAve,01/14/2016 12:00:00 PM,48,-122,6,3,9
17173,58thStGreenway22ndAve,01/14/2016 01:00:00 PM,48,-122,4,6,10
17174,58thStGreenway22ndAve,01/14/2016 02:00:00 PM,48,-122,4,1,5
17175,58thStGreenway22ndAve,01/14/2016 03:00:00 PM,48,-122,2,1,3
17176,58thStGreenway22ndAve,01/14/2016 04:00:00 PM,48,-122,4,4,8
17177,58thStGreenway22ndAve,01/14/2016 05:00:00 PM,48,-122,5,5,10
17178,58thStGreenway22ndAve,01/14/2016 06:00:00 PM,48,-122,3,9,12
17179,58thStGreenway22ndAve,01/14/2016 07:00:00 PM,48,-122,8,2,10
17180,58thStGreenway22ndAve,01/14/2016 08:00:00 PM,48,-122,0,1,1
17181,58thStGreenway22ndAve,01/14/2016 09:00:00 PM,48,-122,3,1,4
17182,58thStGreenway22ndAve,01/14/2016 10:00:00 PM,48,-122,0,1,1
17183,58thStGreenway22ndAve,01/14/2016 11:00:00 PM,48,-122,1,1,2
17184,58thStGreenway22ndAve,01/15/2016 12:00:00 AM,48,-122,0,0,0
17185,58thStGreenway22ndAve,01/15/2016 01:00:00 AM,48,-122,0,0,0
17186,58thStGreenway22ndAve,01/15/2016 02:00:00 AM,48,-122,0,0,0
17187,58thStGreenway22ndAve,01/15/2016 03:00:00 AM,48,-122,1,1,2
17188,58thStGreenway22ndAve,01/15/2016 04:00:00 AM,48,-122,0,0,0
17189,58thStGreenway22ndAve,01/15/2016 05:00:00 AM,48,-122,0,0,0
17190,58thStGreenway22ndAve,01/15/2016 06:00:00 AM,48,-122,0,3,3
17191,58thStGreenway22ndAve,01/15/2016 07:00:00 AM,48,-122,0,2,2
17192,58thStGreenway22ndAve,01/15/2016 08:00:00 AM,48,-122,5,0,5
17193,58thStGreenway22ndAve,01/15/2016 09:00:00 AM,48,-122,4,1,5
17194,58thStGreenway22ndAve,01/15/2016 10:00:00 AM,48,-122,0,1,1
17195,58thStGreenway22ndAve,01/15/2016 11:00:00 AM,48,-122,2,2,4
17196,58thStGreenway22ndAve,01/15/2016 12:00:00 PM,48,-122,2,1,3
17197,58thStGreenway22ndAve,01/15/2016 01:00:00 PM,48,-122,3,5,8
17198,58thStGreenway22ndAve,01/15/2016 02:00:00 PM,48,-122,3,2,5
17199,58thStGreenway22ndAve,01/15/2016 03:00:00 PM,48,-122,3,7,10
17200,58thStGreenway22ndAve,01/15/2016 04:00:00 PM,48,-122,6,3,9
17201,58thStGreenway22ndAve,01/15/2016 05:00:00 PM,48,-122,4,4,8
17202,58thStGreenway22ndAve,01/15/2016 06:00:00 PM,48,-122,6,5,11
17203,58thStGreenway22ndAve,01/15/2016 07:00:00 PM,48,-122,1,2,3
17204,58thStGreenway22ndAve,01/15/2016 08:00:00 PM,48,-122,2,3,5
17205,58thStGreenway22ndAve,01/15/2016 09:00:00 PM,48,-122,1,0,1
17206,58thStGreenway22ndAve,01/15/2016 10:00:00 PM,48,-122,0,1,1
17207,58thStGreenway22ndAve,01/15/2016 11:00:00 PM,48,-122,1,2,3
17208,58thStGreenway22ndAve,01/16/2016 12:00:00 AM,48,-122,0,0,0
17209,58thStGreenway22ndAve,01/16/2016 01:00:00 AM,48,-122,0,0,0
17210,58thStGreenway22ndAve,01/16/2016 02:00:00 AM,48,-122,0,0,0
17211,58thStGreenway22ndAve,01/16/2016 03:00:00 AM,48,-122,0,0,0
17212,58thStGreenway22ndAve,01/16/2016 04:00:00 AM,48,-122,0,0,0
17213,58thStGreenway22ndAve,01/16/2016 05:00:00 AM,48,-122,0,0,0
17214,58thStGreenway22ndAve,01/16/2016 06:00:00 AM,48,-122,0,0,0
17215,58thStGreenway22ndAve,01/16/2016 07:00:00 AM,48,-122,1,0,1
17216,58thStGreenway22ndAve,01/16/2016 08:00:00 AM,48,-122,1,1,2
17217,58thStGreenway22ndAve,01/16/2016 09:00:00 AM,48,-122,0,2,2
17218,58thStGreenway22ndAve,01/16/2016 10:00:00 AM,48,-122,1,1,2
17219,58thStGreenway22ndAve,01/16/2016 11:00:00 AM,48,-122,1,2,3
17220,58thStGreenway22ndAve,01/16/2016 12:00:00 PM,48,-122,2,3,5
17221,58thStGreenway22ndAve,01/16/2016 01:00:00 PM,48,-122,8,4,12
17222,58thStGreenway22ndAve,01/16/2016 02:00:00 PM,48,-122,5,4,9
17223,58thStGreenway22ndAve,01/16/2016 03:00:00 PM,48,-122,2,1,3
17224,58thStGreenway22ndAve,01/16/2016 04:00:00 PM,48,-122,1,0,1
17225,58thStGreenway22ndAve,01/16/2016 05:00:00 PM,48,-122,2,0,2
17226,58thStGreenway22ndAve,01/16/2016 06:00:00 PM,48,-122,3,2,5
17227,58thStGreenway22ndAve,01/16/2016 07:00:00 PM,48,-122,0,0,0
17228,58thStGreenway22ndAve,01/16/2016 08:00:00 PM,48,-122,0,0,0
17229,58thStGreenway22ndAve,01/16/2016 09:00:00 PM,48,-122,1,0,1
17230,58thStGreenway22ndAve,01/16/2016 10:00:00 PM,48,-122,1,1,2
17231,58thStGreenway22ndAve,01/16/2016 11:00:00 PM,48,-122,0,0,0
17232,58thStGreenway22ndAve,01/17/2016 12:00:00 AM,48,-122,2,0,2
17233,58thStGreenway22ndAve,01/17/2016 01:00:00 AM,48,-122,0,2,2
17234,58thStGreenway22ndAve,01/17/2016 02:00:00 AM,48,-122,1,0,1
17235,58thStGreenway22ndAve,01/17/2016 03:00:00 AM,48,-122,0,0,0
17236,58thStGreenway22ndAve,01/17/2016 04:00:00 AM,48,-122,0,0,0
17237,58thStGreenway22ndAve,01/17/2016 05:00:00 AM,48,-122,0,0,0
17238,58thStGreenway22ndAve,01/17/2016 06:00:00 AM,48,-122,0,1,1
17239,58thStGreenway22ndAve,01/17/2016 07:00:00 AM,48,-122,0,0,0
17240,58thStGreenway22ndAve,01/17/2016 08:00:00 AM,48,-122,0,0,0
17241,58thStGreenway22ndAve,01/17/2016 09:00:00 AM,48,-122,1,2,3
17242,58thStGreenway22ndAve,01/17/2016 10:00:00 AM,48,-122,2,1,3
17243,58thStGreenway22ndAve,01/17/2016 11:00:00 AM,48,-122,1,0,1
17244,58thStGreenway22ndAve,01/17/2016 12:00:00 PM,48,-122,1,0,1
17245,58thStGreenway22ndAve,01/17/2016 01:00:00 PM,48,-122,0,2,2
17246,58thStGreenway22ndAve,01/17/2016 02:00:00 PM,48,-122,0,2,2
17247,58thStGreenway22ndAve,01/17/2016 03:00:00 PM,48,-122,3,0,3
17248,58thStGreenway22ndAve,01/17/2016 04:00:00 PM,48,-122,0,3,3
17249,58thStGreenway22ndAve,01/17/2016 05:00:00 PM,48,-122,1,0,1
17250,58thStGreenway22ndAve,01/17/2016 06:00:00 PM,48,-122,2,1,3
17251,58thStGreenway22ndAve,01/17/2016 07:00:00 PM,48,-122,1,0,1
17252,58thStGreenway22ndAve,01/17/2016 08:00:00 PM,48,-122,0,0,0
17253,58thStGreenway22ndAve,01/17/2016 09:00:00 PM,48,-122,2,1,3
17254,58thStGreenway22ndAve,01/17/2016 10:00:00 PM,48,-122,0,0,0
17255,58thStGreenway22ndAve,01/17/2016 11:00:00 PM,48,-122,1,1,2
17256,58thStGreenway22ndAve,01/18/2016 12:00:00 AM,48,-122,0,0,0
17257,58thStGreenway22ndAve,01/18/2016 01:00:00 AM,48,-122,0,0,0
17258,58thStGreenway22ndAve,01/18/2016 02:00:00 AM,48,-122,0,1,1
17259,58thStGreenway22ndAve,01/18/2016 03:00:00 AM,48,-122,0,0,0
17260,58thStGreenway22ndAve,01/18/2016 04:00:00 AM,48,-122,0,1,1
17261,58thStGreenway22ndAve,01/18/2016 05:00:00 AM,48,-122,0,0,0
17262,58thStGreenway22ndAve,01/18/2016 06:00:00 AM,48,-122,0,1,1
17263,58thStGreenway22ndAve,01/18/2016 07:00:00 AM,48,-122,4,3,7
17264,58thStGreenway22ndAve,01/18/2016 08:00:00 AM,48,-122,5,4,9
17265,58thStGreenway22ndAve,01/18/2016 09:00:00 AM,48,-122,1,3,4
17266,58thStGreenway22ndAve,01/18/2016 10:00:00 AM,48,-122,5,7,12
17267,58thStGreenway22ndAve,01/18/2016 11:00:00 AM,48,-122,2,7,9
17268,58thStGreenway22ndAve,01/18/2016 12:00:00 PM,48,-122,3,2,5
17269,58thStGreenway22ndAve,01/18/2016 01:00:00 PM,48,-122,5,8,13
17270,58thStGreenway22ndAve,01/18/2016 02:00:00 PM,48,-122,4,2,6
17271,58thStGreenway22ndAve,01/18/2016 03:00:00 PM,48,-122,12,3,15
17272,58thStGreenway22ndAve,01/18/2016 04:00:00 PM,48,-122,4,1,5
17273,58thStGreenway22ndAve,01/18/2016 05:00:00 PM,48,-122,5,0,5
17274,58thStGreenway22ndAve,01/18/2016 06:00:00 PM,48,-122,2,5,7
17275,58thStGreenway22ndAve,01/18/2016 07:00:00 PM,48,-122,4,1,5
17276,58thStGreenway22ndAve,01/18/2016 08:00:00 PM,48,-122,0,0,0
17277,58thStGreenway22ndAve,01/18/2016 09:00:00 PM,48,-122,1,1,2
17278,58thStGreenway22ndAve,01/18/2016 10:00:00 PM,48,-122,0,0,0
17279,58thStGreenway22ndAve,01/18/2016 11:00:00 PM,48,-122,1,1,2
17280,58thStGreenway22ndAve,01/19/2016 12:00:00 AM,48,-122,0,0,0
17281,58thStGreenway22ndAve,01/19/2016 01:00:00 AM,48,-122,0,1,1
17282,58thStGreenway22ndAve,01/19/2016 02:00:00 AM,48,-122,0,0,0
17283,58thStGreenway22ndAve,01/19/2016 03:00:00 AM,48,-122,1,1,2
17284,58thStGreenway22ndAve,01/19/2016 04:00:00 AM,48,-122,0,0,0
17285,58thStGreenway22ndAve,01/19/2016 05:00:00 AM,48,-122,0,0,0
17286,58thStGreenway22ndAve,01/19/2016 06:00:00 AM,48,-122,1,3,4
17287,58thStGreenway22ndAve,01/19/2016 07:00:00 AM,48,-122,5,0,5
17288,58thStGreenway22ndAve,01/19/2016 08:00:00 AM,48,-122,3,3,6
17289,58thStGreenway22ndAve,01/19/2016 09:00:00 AM,48,-122,3,5,8
17290,58thStGreenway22ndAve,01/19/2016 10:00:00 AM,48,-122,1,4,5
17291,58thStGreenway22ndAve,01/19/2016 11:00:00 AM,48,-122,1,1,2
17292,58thStGreenway22ndAve,01/19/2016 12:00:00 PM,48,-122,6,5,11
17293,58thStGreenway22ndAve,01/19/2016 01:00:00 PM,48,-122,2,2,4
17294,58thStGreenway22ndAve,01/19/2016 02:00:00 PM,48,-122,4,0,4
17295,58thStGreenway22ndAve,01/19/2016 03:00:00 PM,48,-122,1,1,2
17296,58thStGreenway22ndAve,01/19/2016 04:00:00 PM,48,-122,2,1,3
17297,58thStGreenway22ndAve,01/19/2016 05:00:00 PM,48,-122,4,2,6
17298,58thStGreenway22ndAve,01/19/2016 06:00:00 PM,48,-122,6,3,9
17299,58thStGreenway22ndAve,01/19/2016 07:00:00 PM,48,-122,3,4,7
17300,58thStGreenway22ndAve,01/19/2016 08:00:00 PM,48,-122,0,1,1
17301,58thStGreenway22ndAve,01/19/2016 09:00:00 PM,48,-122,3,0,3
17302,58thStGreenway22ndAve,01/19/2016 10:00:00 PM,48,-122,0,0,0
17303,58thStGreenway22ndAve,01/19/2016 11:00:00 PM,48,-122,0,1,1
17304,58thStGreenway22ndAve,01/20/2016 12:00:00 AM,48,-122,0,0,0
17305,58thStGreenway22ndAve,01/20/2016 01:00:00 AM,48,-122,1,0,1
17306,58thStGreenway22ndAve,01/20/2016 02:00:00 AM,48,-122,0,0,0
17307,58thStGreenway22ndAve,01/20/2016 03:00:00 AM,48,-122,0,0,0
17308,58thStGreenway22ndAve,01/20/2016 04:00:00 AM,48,-122,0,0,0
17309,58thStGreenway22ndAve,01/20/2016 05:00:00 AM,48,-122,0,1,1
17310,58thStGreenway22ndAve,01/20/2016 06:00:00 AM,48,-122,1,2,3
17311,58thStGreenway22ndAve,01/20/2016 07:00:00 AM,48,-122,6,1,7
17312,58thStGreenway22ndAve,01/20/2016 08:00:00 AM,48,-122,4,2,6
17313,58thStGreenway22ndAve,01/20/2016 09:00:00 AM,48,-122,3,6,9
17314,58thStGreenway22ndAve,01/20/2016 10:00:00 AM,48,-122,1,1,2
17315,58thStGreenway22ndAve,01/20/2016 11:00:00 AM,48,-122,1,6,7
17316,58thStGreenway22ndAve,01/20/2016 12:00:00 PM,48,-122,5,3,8
17317,58thStGreenway22ndAve,01/20/2016 01:00:00 PM,48,-122,6,2,8
17318,58thStGreenway22ndAve,01/20/2016 02:00:00 PM,48,-122,3,3,6
17319,58thStGreenway22ndAve,01/20/2016 03:00:00 PM,48,-122,4,2,6
17320,58thStGreenway22ndAve,01/20/2016 04:00:00 PM,48,-122,6,1,7
17321,58thStGreenway22ndAve,01/20/2016 05:00:00 PM,48,-122,4,0,4
17322,58thStGreenway22ndAve,01/20/2016 06:00:00 PM,48,-122,1,4,5
17323,58thStGreenway22ndAve,01/20/2016 07:00:00 PM,48,-122,3,5,8
17324,58thStGreenway22ndAve,01/20/2016 08:00:00 PM,48,-122,2,2,4
17325,58thStGreenway22ndAve,01/20/2016 09:00:00 PM,48,-122,1,1,2
17326,58thStGreenway22ndAve,01/20/2016 10:00:00 PM,48,-122,3,0,3
17327,58thStGreenway22ndAve,01/20/2016 11:00:00 PM,48,-122,0,0,0
17328,58thStGreenway22ndAve,01/21/2016 12:00:00 AM,48,-122,0,0,0
17329,58thStGreenway22ndAve,01/21/2016 01:00:00 AM,48,-122,2,0,2
17330,58thStGreenway22ndAve,01/21/2016 02:00:00 AM,48,-122,0,0,0
17331,58thStGreenway22ndAve,01/21/2016 03:00:00 AM,48,-122,0,0,0
17332,58thStGreenway22ndAve,01/21/2016 04:00:00 AM,48,-122,0,0,0
17333,58thStGreenway22ndAve,01/21/2016 05:00:00 AM,48,-122,1,1,2
17334,58thStGreenway22ndAve,01/21/2016 06:00:00 AM,48,-122,0,2,2
17335,58thStGreenway22ndAve,01/21/2016 07:00:00 AM,48,-122,4,1,5
17336,58thStGreenway22ndAve,01/21/2016 08:00:00 AM,48,-122,2,1,3
17337,58thStGreenway22ndAve,01/21/2016 09:00:00 AM,48,-122,1,1,2
17338,58thStGreenway22ndAve,01/21/2016 10:00:00 AM,48,-122,0,0,0
17339,58thStGreenway22ndAve,01/21/2016 11:00:00 AM,48,-122,0,2,2
17340,58thStGreenway22ndAve,01/21/2016 12:00:00 PM,48,-122,0,0,0
17341,58thStGreenway22ndAve,01/21/2016 01:00:00 PM,48,-122,2,2,4
17342,58thStGreenway22ndAve,01/21/2016 02:00:00 PM,48,-122,2,0,2
17343,58thStGreenway22ndAve,01/21/2016 03:00:00 PM,48,-122,5,4,9
17344,58thStGreenway22ndAve,01/21/2016 04:00:00 PM,48,-122,1,1,2
17345,58thStGreenway22ndAve,01/21/2016 05:00:00 PM,48,-122,1,1,2
17346,58thStGreenway22ndAve,01/21/2016 06:00:00 PM,48,-122,1,4,5
17347,58thStGreenway22ndAve,01/21/2016 07:00:00 PM,48,-122,1,0,1
17348,58thStGreenway22ndAve,01/21/2016 08:00:00 PM,48,-122,0,0,0
17349,58thStGreenway22ndAve,01/21/2016 09:00:00 PM,48,-122,2,0,2
17350,58thStGreenway22ndAve,01/21/2016 10:00:00 PM,48,-122,0,1,1
17351,58thStGreenway22ndAve,01/21/2016 11:00:00 PM,48,-122,0,1,1
17352,58thStGreenway22ndAve,01/22/2016 12:00:00 AM,48,-122,1,1,2
17353,58thStGreenway22ndAve,01/22/2016 01:00:00 AM,48,-122,0,0,0
17354,58thStGreenway22ndAve,01/22/2016 02:00:00 AM,48,-122,0,1,1
17355,58thStGreenway22ndAve,01/22/2016 03:00:00 AM,48,-122,0,0,0
17356,58thStGreenway22ndAve,01/22/2016 04:00:00 AM,48,-122,2,1,3
17357,58thStGreenway22ndAve,01/22/2016 05:00:00 AM,48,-122,0,1,1
17358,58thStGreenway22ndAve,01/22/2016 06:00:00 AM,48,-122,1,1,2
17359,58thStGreenway22ndAve,01/22/2016 07:00:00 AM,48,-122,4,2,6
17360,58thStGreenway22ndAve,01/22/2016 08:00:00 AM,48,-122,0,4,4
17361,58thStGreenway22ndAve,01/22/2016 09:00:00 AM,48,-122,3,1,4
17362,58thStGreenway22ndAve,01/22/2016 10:00:00 AM,48,-122,1,1,2
17363,58thStGreenway22ndAve,01/22/2016 11:00:00 AM,48,-122,3,9,12
17364,58thStGreenway22ndAve,01/22/2016 12:00:00 PM,48,-122,6,4,10
17365,58thStGreenway22ndAve,01/22/2016 01:00:00 PM,48,-122,4,3,7
17366,58thStGreenway22ndAve,01/22/2016 02:00:00 PM,48,-122,3,3,6
17367,58thStGreenway22ndAve,01/22/2016 03:00:00 PM,48,-122,4,4,8
17368,58thStGreenway22ndAve,01/22/2016 04:00:00 PM,48,-122,3,6,9
17369,58thStGreenway22ndAve,01/22/2016 05:00:00 PM,48,-122,8,4,12
17370,58thStGreenway22ndAve,01/22/2016 06:00:00 PM,48,-122,4,6,10
17371,58thStGreenway22ndAve,01/22/2016 07:00:00 PM,48,-122,1,1,2
17372,58thStGreenway22ndAve,01/22/2016 08:00:00 PM,48,-122,0,1,1
17373,58thStGreenway22ndAve,01/22/2016 09:00:00 PM,48,-122,2,1,3
17374,58thStGreenway22ndAve,01/22/2016 10:00:00 PM,48,-122,0,2,2
17375,58thStGreenway22ndAve,01/22/2016 11:00:00 PM,48,-122,0,1,1
17376,58thStGreenway22ndAve,01/23/2016 12:00:00 AM,48,-122,1,0,1
17377,58thStGreenway22ndAve,01/23/2016 01:00:00 AM,48,-122,0,0,0
17378,58thStGreenway22ndAve,01/23/2016 02:00:00 AM,48,-122,0,1,1
17379,58thStGreenway22ndAve,01/23/2016 03:00:00 AM,48,-122,1,1,2
17380,58thStGreenway22ndAve,01/23/2016 04:00:00 AM,48,-122,0,0,0
17381,58thStGreenway22ndAve,01/23/2016 05:00:00 AM,48,-122,0,0,0
17382,58thStGreenway22ndAve,01/23/2016 06:00:00 AM,48,-122,0,0,0
17383,58thStGreenway22ndAve,01/23/2016 07:00:00 AM,48,-122,1,0,1
17384,58thStGreenway22ndAve,01/23/2016 08:00:00 AM,48,-122,0,1,1
17385,58thStGreenway22ndAve,01/23/2016 09:00:00 AM,48,-122,0,1,1
17386,58thStGreenway22ndAve,01/23/2016 10:00:00 AM,48,-122,1,3,4
17387,58thStGreenway22ndAve,01/23/2016 11:00:00 AM,48,-122,0,4,4
17388,58thStGreenway22ndAve,01/23/2016 12:00:00 PM,48,-122,3,3,6
17389,58thStGreenway22ndAve,01/23/2016 01:00:00 PM,48,-122,2,1,3
17390,58thStGreenway22ndAve,01/23/2016 02:00:00 PM,48,-122,1,0,1
17391,58thStGreenway22ndAve,01/23/2016 03:00:00 PM,48,-122,1,5,6
17392,58thStGreenway22ndAve,01/23/2016 04:00:00 PM,48,-122,2,2,4
17393,58thStGreenway22ndAve,01/23/2016 05:00:00 PM,48,-122,0,0,0
17394,58thStGreenway22ndAve,01/23/2016 06:00:00 PM,48,-122,0,1,1
17395,58thStGreenway22ndAve,01/23/2016 07:00:00 PM,48,-122,1,0,1
17396,58thStGreenway22ndAve,01/23/2016 08:00:00 PM,48,-122,0,0,0
17397,58thStGreenway22ndAve,01/23/2016 09:00:00 PM,48,-122,1,2,3
17398,58thStGreenway22ndAve,01/23/2016 10:00:00 PM,48,-122,1,0,1
17399,58thStGreenway22ndAve,01/23/2016 11:00:00 PM,48,-122,0,1,1
17400,58thStGreenway22ndAve,01/24/2016 12:00:00 AM,48,-122,1,1,2
17401,58thStGreenway22ndAve,01/24/2016 01:00:00 AM,48,-122,0,0,0
17402,58thStGreenway22ndAve,01/24/2016 02:00:00 AM,48,-122,0,0,0
17403,58thStGreenway22ndAve,01/24/2016 03:00:00 AM,48,-122,1,0,1
17404,58thStGreenway22ndAve,01/24/2016 04:00:00 AM,48,-122,1,1,2
17405,58thStGreenway22ndAve,01/24/2016 05:00:00 AM,48,-122,0,0,0
17406,58thStGreenway22ndAve,01/24/2016 06:00:00 AM,48,-122,0,1,1
17407,58thStGreenway22ndAve,01/24/2016 07:00:00 AM,48,-122,1,0,1
17408,58thStGreenway22ndAve,01/24/2016 08:00:00 AM,48,-122,0,2,2
17409,58thStGreenway22ndAve,01/24/2016 09:00:00 AM,48,-122,3,3,6
17410,58thStGreenway22ndAve,01/24/2016 10:00:00 AM,48,-122,4,7,11
17411,58thStGreenway22ndAve,01/24/2016 11:00:00 AM,48,-122,6,8,14
17412,58thStGreenway22ndAve,01/24/2016 12:00:00 PM,48,-122,11,4,15
17413,58thStGreenway22ndAve,01/24/2016 01:00:00 PM,48,-122,9,8,17
17414,58thStGreenway22ndAve,01/24/2016 02:00:00 PM,48,-122,5,6,11
17415,58thStGreenway22ndAve,01/24/2016 03:00:00 PM,48,-122,1,4,5
17416,58thStGreenway22ndAve,01/24/2016 04:00:00 PM,48,-122,12,9,21
17417,58thStGreenway22ndAve,01/24/2016 05:00:00 PM,48,-122,5,0,5
17418,58thStGreenway22ndAve,01/24/2016 06:00:00 PM,48,-122,3,2,5
17419,58thStGreenway22ndAve,01/24/2016 07:00:00 PM,48,-122,1,0,1
17420,58thStGreenway22ndAve,01/24/2016 08:00:00 PM,48,-122,1,0,1
17421,58thStGreenway22ndAve,01/24/2016 09:00:00 PM,48,-122,0,0,0
17422,58thStGreenway22ndAve,01/24/2016 10:00:00 PM,48,-122,0,2,2
17423,58thStGreenway22ndAve,01/24/2016 11:00:00 PM,48,-122,0,1,1
17424,58thStGreenway22ndAve,01/25/2016 12:00:00 AM,48,-122,0,0,0
17425,58thStGreenway22ndAve,01/25/2016 01:00:00 AM,48,-122,0,0,0
17426,58thStGreenway22ndAve,01/25/2016 02:00:00 AM,48,-122,0,0,0
17427,58thStGreenway22ndAve,01/25/2016 03:00:00 AM,48,-122,0,0,0
17428,58thStGreenway22ndAve,01/25/2016 04:00:00 AM,48,-122,1,1,2
17429,58thStGreenway22ndAve,01/25/2016 05:00:00 AM,48,-122,0,1,1
17430,58thStGreenway22ndAve,01/25/2016 06:00:00 AM,48,-122,2,3,5
17431,58thStGreenway22ndAve,01/25/2016 07:00:00 AM,48,-122,5,2,7
17432,58thStGreenway22ndAve,01/25/2016 08:00:00 AM,48,-122,5,4,9
17433,58thStGreenway22ndAve,01/25/2016 09:00:00 AM,48,-122,3,2,5
17434,58thStGreenway22ndAve,01/25/2016 10:00:00 AM,48,-122,1,2,3
17435,58thStGreenway22ndAve,01/25/2016 11:00:00 AM,48,-122,0,3,3
17436,58thStGreenway22ndAve,01/25/2016 12:00:00 PM,48,-122,8,4,12
17437,58thStGreenway22ndAve,01/25/2016 01:00:00 PM,48,-122,3,2,5
17438,58thStGreenway22ndAve,01/25/2016 02:00:00 PM,48,-122,3,5,8
17439,58thStGreenway22ndAve,01/25/2016 03:00:00 PM,48,-122,5,3,8
17440,58thStGreenway22ndAve,01/25/2016 04:00:00 PM,48,-122,16,3,19
17441,58thStGreenway22ndAve,01/25/2016 05:00:00 PM,48,-122,5,2,7
17442,58thStGreenway22ndAve,01/25/2016 06:00:00 PM,48,-122,4,8,12
17443,58thStGreenway22ndAve,01/25/2016 07:00:00 PM,48,-122,3,0,3
17444,58thStGreenway22ndAve,01/25/2016 08:00:00 PM,48,-122,3,0,3
17445,58thStGreenway22ndAve,01/25/2016 09:00:00 PM,48,-122,2,1,3
17446,58thStGreenway22ndAve,01/25/2016 10:00:00 PM,48,-122,2,2,4
17447,58thStGreenway22ndAve,01/25/2016 11:00:00 PM,48,-122,0,2,2
17448,58thStGreenway22ndAve,01/26/2016 12:00:00 AM,48,-122,0,2,2
17449,58thStGreenway22ndAve,01/26/2016 01:00:00 AM,48,-122,1,0,1
17450,58thStGreenway22ndAve,01/26/2016 02:00:00 AM,48,-122,0,0,0
17451,58thStGreenway22ndAve,01/26/2016 03:00:00 AM,48,-122,0,0,0
17452,58thStGreenway22ndAve,01/26/2016 04:00:00 AM,48,-122,1,0,1
17453,58thStGreenway22ndAve,01/26/2016 05:00:00 AM,48,-122,0,1,1
17454,58thStGreenway22ndAve,01/26/2016 06:00:00 AM,48,-122,0,2,2
17455,58thStGreenway22ndAve,01/26/2016 07:00:00 AM,48,-122,6,1,7
17456,58thStGreenway22ndAve,01/26/2016 08:00:00 AM,48,-122,3,4,7
17457,58thStGreenway22ndAve,01/26/2016 09:00:00 AM,48,-122,3,2,5
17458,58thStGreenway22ndAve,01/26/2016 10:00:00 AM,48,-122,1,3,4
17459,58thStGreenway22ndAve,01/26/2016 11:00:00 AM,48,-122,3,2,5
17460,58thStGreenway22ndAve,01/26/2016 12:00:00 PM,48,-122,0,5,5
17461,58thStGreenway22ndAve,01/26/2016 01:00:00 PM,48,-122,1,1,2
17462,58thStGreenway22ndAve,01/26/2016 02:00:00 PM,48,-122,3,0,3
17463,58thStGreenway22ndAve,01/26/2016 03:00:00 PM,48,-122,1,4,5
17464,58thStGreenway22ndAve,01/26/2016 04:00:00 PM,48,-122,2,3,5
17465,58thStGreenway22ndAve,01/26/2016 05:00:00 PM,48,-122,6,2,8
17466,58thStGreenway22ndAve,01/26/2016 06:00:00 PM,48,-122,5,3,8
17467,58thStGreenway22ndAve,01/26/2016 07:00:00 PM,48,-122,2,2,4
17468,58thStGreenway22ndAve,01/26/2016 08:00:00 PM,48,-122,0,0,0
17469,58thStGreenway22ndAve,01/26/2016 09:00:00 PM,48,-122,0,1,1
17470,58thStGreenway22ndAve,01/26/2016 10:00:00 PM,48,-122,3,0,3
17471,58thStGreenway22ndAve,01/26/2016 11:00:00 PM,48,-122,1,0,1
17472,58thStGreenway22ndAve,01/27/2016 12:00:00 AM,48,-122,0,0,0
17473,58thStGreenway22ndAve,01/27/2016 01:00:00 AM,48,-122,0,0,0
17474,58thStGreenway22ndAve,01/27/2016 02:00:00 AM,48,-122,0,1,1
17475,58thStGreenway22ndAve,01/27/2016 03:00:00 AM,48,-122,0,0,0
17476,58thStGreenway22ndAve,01/27/2016 04:00:00 AM,48,-122,0,1,1
17477,58thStGreenway22ndAve,01/27/2016 05:00:00 AM,48,-122,0,1,1
17478,58thStGreenway22ndAve,01/27/2016 06:00:00 AM,48,-122,1,3,4
17479,58thStGreenway22ndAve,01/27/2016 07:00:00 AM,48,-122,5,4,9
17480,58thStGreenway22ndAve,01/27/2016 08:00:00 AM,48,-122,4,2,6
17481,58thStGreenway22ndAve,01/27/2016 09:00:00 AM,48,-122,6,2,8
17482,58thStGreenway22ndAve,01/27/2016 10:00:00 AM,48,-122,1,3,4
17483,58thStGreenway22ndAve,01/27/2016 11:00:00 AM,48,-122,0,1,1
17484,58thStGreenway22ndAve,01/27/2016 12:00:00 PM,48,-122,1,3,4
17485,58thStGreenway22ndAve,01/27/2016 01:00:00 PM,48,-122,4,2,6
17486,58thStGreenway22ndAve,01/27/2016 02:00:00 PM,48,-122,4,4,8
17487,58thStGreenway22ndAve,01/27/2016 03:00:00 PM,48,-122,1,0,1
17488,58thStGreenway22ndAve,01/27/2016 04:00:00 PM,48,-122,6,6,12
17489,58thStGreenway22ndAve,01/27/2016 05:00:00 PM,48,-122,4,0,4
17490,58thStGreenway22ndAve,01/27/2016 06:00:00 PM,48,-122,1,5,6
17491,58thStGreenway22ndAve,01/27/2016 07:00:00 PM,48,-122,3,1,4
17492,58thStGreenway22ndAve,01/27/2016 08:00:00 PM,48,-122,3,0,3
17493,58thStGreenway22ndAve,01/27/2016 09:00:00 PM,48,-122,0,1,1
17494,58thStGreenway22ndAve,01/27/2016 10:00:00 PM,48,-122,0,0,0
17495,58thStGreenway22ndAve,01/27/2016 11:00:00 PM,48,-122,0,1,1
17496,58thStGreenway22ndAve,01/28/2016 12:00:00 AM,48,-122,0,0,0
17497,58thStGreenway22ndAve,01/28/2016 01:00:00 AM,48,-122,0,0,0
17498,58thStGreenway22ndAve,01/28/2016 02:00:00 AM,48,-122,0,0,0
17499,58thStGreenway22ndAve,01/28/2016 03:00:00 AM,48,-122,1,0,1
17500,58thStGreenway22ndAve,01/28/2016 04:00:00 AM,48,-122,0,1,1
17501,58thStGreenway22ndAve,01/28/2016 05:00:00 AM,48,-122,0,1,1
17502,58thStGreenway22ndAve,01/28/2016 06:00:00 AM,48,-122,1,3,4
17503,58thStGreenway22ndAve,01/28/2016 07:00:00 AM,48,-122,4,1,5
17504,58thStGreenway22ndAve,01/28/2016 08:00:00 AM,48,-122,0,0,0
17505,58thStGreenway22ndAve,01/28/2016 09:00:00 AM,48,-122,2,2,4
17506,58thStGreenway22ndAve,01/28/2016 10:00:00 AM,48,-122,1,1,2
17507,58thStGreenway22ndAve,01/28/2016 11:00:00 AM,48,-122,2,2,4
17508,58thStGreenway22ndAve,01/28/2016 12:00:00 PM,48,-122,5,0,5
17509,58thStGreenway22ndAve,01/28/2016 01:00:00 PM,48,-122,3,2,5
17510,58thStGreenway22ndAve,01/28/2016 02:00:00 PM,48,-122,2,2,4
17511,58thStGreenway22ndAve,01/28/2016 03:00:00 PM,48,-122,6,7,13
17512,58thStGreenway22ndAve,01/28/2016 04:00:00 PM,48,-122,4,4,8
17513,58thStGreenway22ndAve,01/28/2016 05:00:00 PM,48,-122,2,2,4
17514,58thStGreenway22ndAve,01/28/2016 06:00:00 PM,48,-122,1,2,3
17515,58thStGreenway22ndAve,01/28/2016 07:00:00 PM,48,-122,5,2,7
17516,58thStGreenway22ndAve,01/28/2016 08:00:00 PM,48,-122,2,4,6
17517,58thStGreenway22ndAve,01/28/2016 09:00:00 PM,48,-122,2,0,2
17518,58thStGreenway22ndAve,01/28/2016 10:00:00 PM,48,-122,0,1,1
17519,58thStGreenway22ndAve,01/28/2016 11:00:00 PM,48,-122,0,3,3
17520,58thStGreenway22ndAve,01/29/2016 12:00:00 AM,48,-122,0,0,0
17521,58thStGreenway22ndAve,01/29/2016 01:00:00 AM,48,-122,0,1,1
17522,58thStGreenway22ndAve,01/29/2016 02:00:00 AM,48,-122,0,0,0
17523,58thStGreenway22ndAve,01/29/2016 03:00:00 AM,48,-122,0,0,0
17524,58thStGreenway22ndAve,01/29/2016 04:00:00 AM,48,-122,0,0,0
17525,58thStGreenway22ndAve,01/29/2016 05:00:00 AM,48,-122,1,1,2
17526,58thStGreenway22ndAve,01/29/2016 06:00:00 AM,48,-122,0,4,4
17527,58thStGreenway22ndAve,01/29/2016 07:00:00 AM,48,-122,3,5,8
17528,58thStGreenway22ndAve,01/29/2016 08:00:00 AM,48,-122,2,2,4
17529,58thStGreenway22ndAve,01/29/2016 09:00:00 AM,48,-122,3,0,3
17530,58thStGreenway22ndAve,01/29/2016 10:00:00 AM,48,-122,0,0,0
17531,58thStGreenway22ndAve,01/29/2016 11:00:00 AM,48,-122,0,1,1
17532,58thStGreenway22ndAve,01/29/2016 12:00:00 PM,48,-122,3,1,4
17533,58thStGreenway22ndAve,01/29/2016 01:00:00 PM,48,-122,5,5,10
17534,58thStGreenway22ndAve,01/29/2016 02:00:00 PM,48,-122,1,2,3
17535,58thStGreenway22ndAve,01/29/2016 03:00:00 PM,48,-122,4,3,7
17536,58thStGreenway22ndAve,01/29/2016 04:00:00 PM,48,-122,8,2,10
17537,58thStGreenway22ndAve,01/29/2016 05:00:00 PM,48,-122,5,1,6
17538,58thStGreenway22ndAve,01/29/2016 06:00:00 PM,48,-122,2,2,4
17539,58thStGreenway22ndAve,01/29/2016 07:00:00 PM,48,-122,5,1,6
17540,58thStGreenway22ndAve,01/29/2016 08:00:00 PM,48,-122,1,1,2
17541,58thStGreenway22ndAve,01/29/2016 09:00:00 PM,48,-122,2,0,2
17542,58thStGreenway22ndAve,01/29/2016 10:00:00 PM,48,-122,0,3,3
17543,58thStGreenway22ndAve,01/29/2016 11:00:00 PM,48,-122,0,3,3
17544,58thStGreenway22ndAve,01/30/2016 12:00:00 AM,48,-122,3,1,4
17545,58thStGreenway22ndAve,01/30/2016 01:00:00 AM,48,-122,0,1,1
17546,58thStGreenway22ndAve,01/30/2016 02:00:00 AM,48,-122,0,0,0
17547,58thStGreenway22ndAve,01/30/2016 03:00:00 AM,48,-122,1,1,2
17548,58thStGreenway22ndAve,01/30/2016 04:00:00 AM,48,-122,0,0,0
17549,58thStGreenway22ndAve,01/30/2016 05:00:00 AM,48,-122,0,0,0
17550,58thStGreenway22ndAve,01/30/2016 06:00:00 AM,48,-122,0,0,0
17551,58thStGreenway22ndAve,01/30/2016 07:00:00 AM,48,-122,1,0,1
17552,58thStGreenway22ndAve,01/30/2016 08:00:00 AM,48,-122,2,1,3
17553,58thStGreenway22ndAve,01/30/2016 09:00:00 AM,48,-122,3,3,6
17554,58thStGreenway22ndAve,01/30/2016 10:00:00 AM,48,-122,2,5,7
17555,58thStGreenway22ndAve,01/30/2016 11:00:00 AM,48,-122,0,6,6
17556,58thStGreenway22ndAve,01/30/2016 12:00:00 PM,48,-122,9,3,12
17557,58thStGreenway22ndAve,01/30/2016 01:00:00 PM,48,-122,9,5,14
17558,58thStGreenway22ndAve,01/30/2016 02:00:00 PM,48,-122,7,6,13
17559,58thStGreenway22ndAve,01/30/2016 03:00:00 PM,48,-122,5,4,9
17560,58thStGreenway22ndAve,01/30/2016 04:00:00 PM,48,-122,9,8,17
17561,58thStGreenway22ndAve,01/30/2016 05:00:00 PM,48,-122,4,0,4
17562,58thStGreenway22ndAve,01/30/2016 06:00:00 PM,48,-122,2,3,5
17563,58thStGreenway22ndAve,01/30/2016 07:00:00 PM,48,-122,1,0,1
17564,58thStGreenway22ndAve,01/30/2016 08:00:00 PM,48,-122,2,0,2
17565,58thStGreenway22ndAve,01/30/2016 09:00:00 PM,48,-122,1,2,3
17566,58thStGreenway22ndAve,01/30/2016 10:00:00 PM,48,-122,0,0,0
17567,58thStGreenway22ndAve,01/30/2016 11:00:00 PM,48,-122,2,2,4
17568,58thStGreenway22ndAve,01/31/2016 12:00:00 AM,48,-122,1,2,3
17569,58thStGreenway22ndAve,01/31/2016 01:00:00 AM,48,-122,0,1,1
17570,58thStGreenway22ndAve,01/31/2016 02:00:00 AM,48,-122,0,0,0
17571,58thStGreenway22ndAve,01/31/2016 03:00:00 AM,48,-122,0,0,0
17572,58thStGreenway22ndAve,01/31/2016 04:00:00 AM,48,-122,1,0,1
17573,58thStGreenway22ndAve,01/31/2016 05:00:00 AM,48,-122,1,0,1
17574,58thStGreenway22ndAve,01/31/2016 06:00:00 AM,48,-122,0,1,1
17575,58thStGreenway22ndAve,01/31/2016 07:00:00 AM,48,-122,0,0,0
17576,58thStGreenway22ndAve,01/31/2016 08:00:00 AM,48,-122,1,4,5
17577,58thStGreenway22ndAve,01/31/2016 09:00:00 AM,48,-122,2,1,3
17578,58thStGreenway22ndAve,01/31/2016 10:00:00 AM,48,-122,2,5,7
17579,58thStGreenway22ndAve,01/31/2016 11:00:00 AM,48,-122,4,1,5
17580,58thStGreenway22ndAve,01/31/2016 12:00:00 PM,48,-122,24,3,27
17581,58thStGreenway22ndAve,01/31/2016 01:00:00 PM,48,-122,3,5,8
17582,58thStGreenway22ndAve,01/31/2016 02:00:00 PM,48,-122,3,5,8
17583,58thStGreenway22ndAve,01/31/2016 03:00:00 PM,48,-122,3,3,6
17584,58thStGreenway22ndAve,01/31/2016 04:00:00 PM,48,-122,2,6,8
17585,58thStGreenway22ndAve,01/31/2016 05:00:00 PM,48,-122,1,3,4
17586,58thStGreenway22ndAve,01/31/2016 06:00:00 PM,48,-122,0,1,1
17587,58thStGreenway22ndAve,01/31/2016 07:00:00 PM,48,-122,0,0,0
17588,58thStGreenway22ndAve,01/31/2016 08:00:00 PM,48,-122,0,1,1
17589,58thStGreenway22ndAve,01/31/2016 09:00:00 PM,48,-122,0,0,0
17590,58thStGreenway22ndAve,01/31/2016 10:00:00 PM,48,-122,0,0,0
17591,58thStGreenway22ndAve,01/31/2016 11:00:00 PM,48,-122,0,1,1
17592,58thStGreenway22ndAve,02/01/2016 12:00:00 AM,48,-122,1,0,1
17593,58thStGreenway22ndAve,02/01/2016 01:00:00 AM,48,-122,0,1,1
17594,58thStGreenway22ndAve,02/01/2016 02:00:00 AM,48,-122,0,0,0
17595,58thStGreenway22ndAve,02/01/2016 03:00:00 AM,48,-122,0,0,0
17596,58thStGreenway22ndAve,02/01/2016 04:00:00 AM,48,-122,1,1,2
17597,58thStGreenway22ndAve,02/01/2016 05:00:00 AM,48,-122,0,1,1
17598,58thStGreenway22ndAve,02/01/2016 06:00:00 AM,48,-122,0,3,3
17599,58thStGreenway22ndAve,02/01/2016 07:00:00 AM,48,-122,5,3,8
17600,58thStGreenway22ndAve,02/01/2016 08:00:00 AM,48,-122,6,5,11
17601,58thStGreenway22ndAve,02/01/2016 09:00:00 AM,48,-122,6,4,10
17602,58thStGreenway22ndAve,02/01/2016 10:00:00 AM,48,-122,,,
17603,58thStGreenway22ndAve,02/01/2016 11:00:00 AM,48,-122,3,3,6
17604,58thStGreenway22ndAve,02/01/2016 12:00:00 PM,48,-122,6,4,10
17605,58thStGreenway22ndAve,02/01/2016 01:00:00 PM,48,-122,7,2,9
17606,58thStGreenway22ndAve,02/01/2016 02:00:00 PM,48,-122,2,1,3
17607,58thStGreenway22ndAve,02/01/2016 03:00:00 PM,48,-122,3,3,6
17608,58thStGreenway22ndAve,02/01/2016 04:00:00 PM,48,-122,8,2,10
17609,58thStGreenway22ndAve,02/01/2016 05:00:00 PM,48,-122,8,8,16
17610,58thStGreenway22ndAve,02/01/2016 06:00:00 PM,48,-122,3,5,8
17611,58thStGreenway22ndAve,02/01/2016 07:00:00 PM,48,-122,2,3,5
17612,58thStGreenway22ndAve,02/01/2016 08:00:00 PM,48,-122,0,0,0
17613,58thStGreenway22ndAve,02/01/2016 09:00:00 PM,48,-122,0,1,1
17614,58thStGreenway22ndAve,02/01/2016 10:00:00 PM,48,-122,0,0,0
17615,58thStGreenway22ndAve,02/01/2016 11:00:00 PM,48,-122,0,0,0
17616,58thStGreenway22ndAve,02/02/2016 12:00:00 AM,48,-122,1,0,1
17617,58thStGreenway22ndAve,02/02/2016 01:00:00 AM,48,-122,0,1,1
17618,58thStGreenway22ndAve,02/02/2016 02:00:00 AM,48,-122,1,0,1
17619,58thStGreenway22ndAve,02/02/2016 03:00:00 AM,48,-122,0,0,0
17620,58thStGreenway22ndAve,02/02/2016 04:00:00 AM,48,-122,0,0,0
17621,58thStGreenway22ndAve,02/02/2016 05:00:00 AM,48,-122,0,1,1
17622,58thStGreenway22ndAve,02/02/2016 06:00:00 AM,48,-122,0,1,1
17623,58thStGreenway22ndAve,02/02/2016 07:00:00 AM,48,-122,3,2,5
17624,58thStGreenway22ndAve,02/02/2016 08:00:00 AM,48,-122,4,5,9
17625,58thStGreenway22ndAve,02/02/2016 09:00:00 AM,48,-122,2,4,6
17626,58thStGreenway22ndAve,02/02/2016 10:00:00 AM,48,-122,2,4,6
17627,58thStGreenway22ndAve,02/02/2016 11:00:00 AM,48,-122,1,5,6
17628,58thStGreenway22ndAve,02/02/2016 12:00:00 PM,48,-122,3,6,9
17629,58thStGreenway22ndAve,02/02/2016 01:00:00 PM,48,-122,1,2,3
17630,58thStGreenway22ndAve,02/02/2016 02:00:00 PM,48,-122,4,0,4
17631,58thStGreenway22ndAve,02/02/2016 03:00:00 PM,48,-122,4,2,6
17632,58thStGreenway22ndAve,02/02/2016 04:00:00 PM,48,-122,9,2,11
17633,58thStGreenway22ndAve,02/02/2016 05:00:00 PM,48,-122,5,4,9
17634,58thStGreenway22ndAve,02/02/2016 06:00:00 PM,48,-122,3,7,10
17635,58thStGreenway22ndAve,02/02/2016 07:00:00 PM,48,-122,5,5,10
17636,58thStGreenway22ndAve,02/02/2016 08:00:00 PM,48,-122,2,2,4
17637,58thStGreenway22ndAve,02/02/2016 09:00:00 PM,48,-122,4,0,4
17638,58thStGreenway22ndAve,02/02/2016 10:00:00 PM,48,-122,1,2,3
17639,58thStGreenway22ndAve,02/02/2016 11:00:00 PM,48,-122,0,1,1
17640,58thStGreenway22ndAve,02/03/2016 12:00:00 AM,48,-122,1,0,1
17641,58thStGreenway22ndAve,02/03/2016 01:00:00 AM,48,-122,2,2,4
17642,58thStGreenway22ndAve,02/03/2016 02:00:00 AM,48,-122,0,0,0
17643,58thStGreenway22ndAve,02/03/2016 03:00:00 AM,48,-122,1,0,1
17644,58thStGreenway22ndAve,02/03/2016 04:00:00 AM,48,-122,0,0,0
17645,58thStGreenway22ndAve,02/03/2016 05:00:00 AM,48,-122,0,1,1
17646,58thStGreenway22ndAve,02/03/2016 06:00:00 AM,48,-122,0,3,3
17647,58thStGreenway22ndAve,02/03/2016 07:00:00 AM,48,-122,3,2,5
17648,58thStGreenway22ndAve,02/03/2016 08:00:00 AM,48,-122,5,2,7
17649,58thStGreenway22ndAve,02/03/2016 09:00:00 AM,48,-122,1,3,4
17650,58thStGreenway22ndAve,02/03/2016 10:00:00 AM,48,-122,1,3,4
17651,58thStGreenway22ndAve,02/03/2016 11:00:00 AM,48,-122,1,1,2
17652,58thStGreenway22ndAve,02/03/2016 12:00:00 PM,48,-122,0,1,1
17653,58thStGreenway22ndAve,02/03/2016 01:00:00 PM,48,-122,1,2,3
17654,58thStGreenway22ndAve,02/03/2016 02:00:00 PM,48,-122,3,2,5
17655,58thStGreenway22ndAve,02/03/2016 03:00:00 PM,48,-122,0,1,1
17656,58thStGreenway22ndAve,02/03/2016 04:00:00 PM,48,-122,4,2,6
17657,58thStGreenway22ndAve,02/03/2016 05:00:00 PM,48,-122,2,1,3
17658,58thStGreenway22ndAve,02/03/2016 06:00:00 PM,48,-122,5,3,8
17659,58thStGreenway22ndAve,02/03/2016 07:00:00 PM,48,-122,3,2,5
17660,58thStGreenway22ndAve,02/03/2016 08:00:00 PM,48,-122,3,1,4
17661,58thStGreenway22ndAve,02/03/2016 09:00:00 PM,48,-122,2,2,4
17662,58thStGreenway22ndAve,02/03/2016 10:00:00 PM,48,-122,0,0,0
17663,58thStGreenway22ndAve,02/03/2016 11:00:00 PM,48,-122,0,0,0
17664,58thStGreenway22ndAve,02/04/2016 12:00:00 AM,48,-122,0,0,0
17665,58thStGreenway22ndAve,02/04/2016 01:00:00 AM,48,-122,0,0,0
17666,58thStGreenway22ndAve,02/04/2016 02:00:00 AM,48,-122,0,0,0
17667,58thStGreenway22ndAve,02/04/2016 03:00:00 AM,48,-122,1,0,1
17668,58thStGreenway22ndAve,02/04/2016 04:00:00 AM,48,-122,0,0,0
17669,58thStGreenway22ndAve,02/04/2016 05:00:00 AM,48,-122,0,0,0
17670,58thStGreenway22ndAve,02/04/2016 06:00:00 AM,48,-122,0,2,2
17671,58thStGreenway22ndAve,02/04/2016 07:00:00 AM,48,-122,5,3,8
17672,58thStGreenway22ndAve,02/04/2016 08:00:00 AM,48,-122,5,2,7
17673,58thStGreenway22ndAve,02/04/2016 09:00:00 AM,48,-122,3,5,8
17674,58thStGreenway22ndAve,02/04/2016 10:00:00 AM,48,-122,1,2,3
17675,58thStGreenway22ndAve,02/04/2016 11:00:00 AM,48,-122,3,2,5
17676,58thStGreenway22ndAve,02/04/2016 12:00:00 PM,48,-122,0,1,1
17677,58thStGreenway22ndAve,02/04/2016 01:00:00 PM,48,-122,1,2,3
17678,58thStGreenway22ndAve,02/04/2016 02:00:00 PM,48,-122,2,1,3
17679,58thStGreenway22ndAve,02/04/2016 03:00:00 PM,48,-122,0,0,0
17680,58thStGreenway22ndAve,02/04/2016 04:00:00 PM,48,-122,9,5,14
17681,58thStGreenway22ndAve,02/04/2016 05:00:00 PM,48,-122,3,1,4
17682,58thStGreenway22ndAve,02/04/2016 06:00:00 PM,48,-122,0,5,5
17683,58thStGreenway22ndAve,02/04/2016 07:00:00 PM,48,-122,2,1,3
17684,58thStGreenway22ndAve,02/04/2016 08:00:00 PM,48,-122,1,0,1
17685,58thStGreenway22ndAve,02/04/2016 09:00:00 PM,48,-122,1,1,2
17686,58thStGreenway22ndAve,02/04/2016 10:00:00 PM,48,-122,0,0,0
17687,58thStGreenway22ndAve,02/04/2016 11:00:00 PM,48,-122,1,1,2
17688,58thStGreenway22ndAve,02/05/2016 12:00:00 AM,48,-122,0,0,0
17689,58thStGreenway22ndAve,02/05/2016 01:00:00 AM,48,-122,0,0,0
17690,58thStGreenway22ndAve,02/05/2016 02:00:00 AM,48,-122,0,0,0
17691,58thStGreenway22ndAve,02/05/2016 03:00:00 AM,48,-122,0,0,0
17692,58thStGreenway22ndAve,02/05/2016 04:00:00 AM,48,-122,0,0,0
17693,58thStGreenway22ndAve,02/05/2016 05:00:00 AM,48,-122,0,1,1
17694,58thStGreenway22ndAve,02/05/2016 06:00:00 AM,48,-122,2,1,3
17695,58thStGreenway22ndAve,02/05/2016 07:00:00 AM,48,-122,3,4,7
17696,58thStGreenway22ndAve,02/05/2016 08:00:00 AM,48,-122,1,5,6
17697,58thStGreenway22ndAve,02/05/2016 09:00:00 AM,48,-122,2,2,4
17698,58thStGreenway22ndAve,02/05/2016 10:00:00 AM,48,-122,2,2,4
17699,58thStGreenway22ndAve,02/05/2016 11:00:00 AM,48,-122,6,3,9
17700,58thStGreenway22ndAve,02/05/2016 12:00:00 PM,48,-122,2,2,4
17701,58thStGreenway22ndAve,02/05/2016 01:00:00 PM,48,-122,1,5,6
17702,58thStGreenway22ndAve,02/05/2016 02:00:00 PM,48,-122,4,2,6
17703,58thStGreenway22ndAve,02/05/2016 03:00:00 PM,48,-122,4,4,8
17704,58thStGreenway22ndAve,02/05/2016 04:00:00 PM,48,-122,8,4,12
17705,58thStGreenway22ndAve,02/05/2016 05:00:00 PM,48,-122,0,4,4
17706,58thStGreenway22ndAve,02/05/2016 06:00:00 PM,48,-122,3,2,5
17707,58thStGreenway22ndAve,02/05/2016 07:00:00 PM,48,-122,1,1,2
17708,58thStGreenway22ndAve,02/05/2016 08:00:00 PM,48,-122,0,0,0
17709,58thStGreenway22ndAve,02/05/2016 09:00:00 PM,48,-122,1,0,1
17710,58thStGreenway22ndAve,02/05/2016 10:00:00 PM,48,-122,2,0,2
17711,58thStGreenway22ndAve,02/05/2016 11:00:00 PM,48,-122,0,0,0
17712,58thStGreenway22ndAve,02/06/2016 12:00:00 AM,48,-122,1,0,1
17713,58thStGreenway22ndAve,02/06/2016 01:00:00 AM,48,-122,0,0,0
17714,58thStGreenway22ndAve,02/06/2016 02:00:00 AM,48,-122,0,0,0
17715,58thStGreenway22ndAve,02/06/2016 03:00:00 AM,48,-122,0,0,0
17716,58thStGreenway22ndAve,02/06/2016 04:00:00 AM,48,-122,0,0,0
17717,58thStGreenway22ndAve,02/06/2016 05:00:00 AM,48,-122,0,0,0
17718,58thStGreenway22ndAve,02/06/2016 06:00:00 AM,48,-122,0,2,2
17719,58thStGreenway22ndAve,02/06/2016 07:00:00 AM,48,-122,0,0,0
17720,58thStGreenway22ndAve,02/06/2016 08:00:00 AM,48,-122,0,0,0
17721,58thStGreenway22ndAve,02/06/2016 09:00:00 AM,48,-122,0,4,4
17722,58thStGreenway22ndAve,02/06/2016 10:00:00 AM,48,-122,5,6,11
17723,58thStGreenway22ndAve,02/06/2016 11:00:00 AM,48,-122,2,7,9
17724,58thStGreenway22ndAve,02/06/2016 12:00:00 PM,48,-122,13,5,18
17725,58thStGreenway22ndAve,02/06/2016 01:00:00 PM,48,-122,3,6,9
17726,58thStGreenway22ndAve,02/06/2016 02:00:00 PM,48,-122,2,1,3
17727,58thStGreenway22ndAve,02/06/2016 03:00:00 PM,48,-122,5,5,10
17728,58thStGreenway22ndAve,02/06/2016 04:00:00 PM,48,-122,7,8,15
17729,58thStGreenway22ndAve,02/06/2016 05:00:00 PM,48,-122,0,2,2
17730,58thStGreenway22ndAve,02/06/2016 06:00:00 PM,48,-122,1,4,5
17731,58thStGreenway22ndAve,02/06/2016 07:00:00 PM,48,-122,0,2,2
17732,58thStGreenway22ndAve,02/06/2016 08:00:00 PM,48,-122,0,2,2
17733,58thStGreenway22ndAve,02/06/2016 09:00:00 PM,48,-122,3,1,4
17734,58thStGreenway22ndAve,02/06/2016 10:00:00 PM,48,-122,2,1,3
17735,58thStGreenway22ndAve,02/06/2016 11:00:00 PM,48,-122,0,2,2
17736,58thStGreenway22ndAve,02/07/2016 12:00:00 AM,48,-122,0,0,0
17737,58thStGreenway22ndAve,02/07/2016 01:00:00 AM,48,-122,0,0,0
17738,58thStGreenway22ndAve,02/07/2016 02:00:00 AM,48,-122,0,1,1
17739,58thStGreenway22ndAve,02/07/2016 03:00:00 AM,48,-122,0,0,0
17740,58thStGreenway22ndAve,02/07/2016 04:00:00 AM,48,-122,0,0,0
17741,58thStGreenway22ndAve,02/07/2016 05:00:00 AM,48,-122,0,0,0
17742,58thStGreenway22ndAve,02/07/2016 06:00:00 AM,48,-122,0,1,1
17743,58thStGreenway22ndAve,02/07/2016 07:00:00 AM,48,-122,0,0,0
17744,58thStGreenway22ndAve,02/07/2016 08:00:00 AM,48,-122,0,3,3
17745,58thStGreenway22ndAve,02/07/2016 09:00:00 AM,48,-122,3,1,4
17746,58thStGreenway22ndAve,02/07/2016 10:00:00 AM,48,-122,7,5,12
17747,58thStGreenway22ndAve,02/07/2016 11:00:00 AM,48,-122,2,8,10
17748,58thStGreenway22ndAve,02/07/2016 12:00:00 PM,48,-122,12,8,20
17749,58thStGreenway22ndAve,02/07/2016 01:00:00 PM,48,-122,4,4,8
17750,58thStGreenway22ndAve,02/07/2016 02:00:00 PM,48,-122,11,8,19
17751,58thStGreenway22ndAve,02/07/2016 03:00:00 PM,48,-122,14,9,23
17752,58thStGreenway22ndAve,02/07/2016 04:00:00 PM,48,-122,1,4,5
17753,58thStGreenway22ndAve,02/07/2016 05:00:00 PM,48,-122,3,2,5
17754,58thStGreenway22ndAve,02/07/2016 06:00:00 PM,48,-122,1,1,2
17755,58thStGreenway22ndAve,02/07/2016 07:00:00 PM,48,-122,4,0,4
17756,58thStGreenway22ndAve,02/07/2016 08:00:00 PM,48,-122,0,3,3
17757,58thStGreenway22ndAve,02/07/2016 09:00:00 PM,48,-122,0,0,0
17758,58thStGreenway22ndAve,02/07/2016 10:00:00 PM,48,-122,0,0,0
17759,58thStGreenway22ndAve,02/07/2016 11:00:00 PM,48,-122,2,0,2
17760,58thStGreenway22ndAve,02/08/2016 12:00:00 AM,48,-122,0,0,0
17761,58thStGreenway22ndAve,02/08/2016 01:00:00 AM,48,-122,0,1,1
17762,58thStGreenway22ndAve,02/08/2016 02:00:00 AM,48,-122,0,0,0
17763,58thStGreenway22ndAve,02/08/2016 03:00:00 AM,48,-122,0,0,0
17764,58thStGreenway22ndAve,02/08/2016 04:00:00 AM,48,-122,1,0,1
17765,58thStGreenway22ndAve,02/08/2016 05:00:00 AM,48,-122,0,1,1
17766,58thStGreenway22ndAve,02/08/2016 06:00:00 AM,48,-122,0,2,2
17767,58thStGreenway22ndAve,02/08/2016 07:00:00 AM,48,-122,7,3,10
17768,58thStGreenway22ndAve,02/08/2016 08:00:00 AM,48,-122,5,5,10
17769,58thStGreenway22ndAve,02/08/2016 09:00:00 AM,48,-122,4,3,7
17770,58thStGreenway22ndAve,02/08/2016 10:00:00 AM,48,-122,3,4,7
17771,58thStGreenway22ndAve,02/08/2016 11:00:00 AM,48,-122,2,2,4
17772,58thStGreenway22ndAve,02/08/2016 12:00:00 PM,48,-122,3,2,5
17773,58thStGreenway22ndAve,02/08/2016 01:00:00 PM,48,-122,3,6,9
17774,58thStGreenway22ndAve,02/08/2016 02:00:00 PM,48,-122,5,2,7
17775,58thStGreenway22ndAve,02/08/2016 03:00:00 PM,48,-122,5,4,9
17776,58thStGreenway22ndAve,02/08/2016 04:00:00 PM,48,-122,6,9,15
17777,58thStGreenway22ndAve,02/08/2016 05:00:00 PM,48,-122,11,9,20
17778,58thStGreenway22ndAve,02/08/2016 06:00:00 PM,48,-122,6,4,10
17779,58thStGreenway22ndAve,02/08/2016 07:00:00 PM,48,-122,3,2,5
17780,58thStGreenway22ndAve,02/08/2016 08:00:00 PM,48,-122,0,1,1
17781,58thStGreenway22ndAve,02/08/2016 09:00:00 PM,48,-122,1,0,1
17782,58thStGreenway22ndAve,02/08/2016 10:00:00 PM,48,-122,1,1,2
17783,58thStGreenway22ndAve,02/08/2016 11:00:00 PM,48,-122,0,0,0
17784,58thStGreenway22ndAve,02/09/2016 12:00:00 AM,48,-122,1,0,1
17785,58thStGreenway22ndAve,02/09/2016 01:00:00 AM,48,-122,0,2,2
17786,58thStGreenway22ndAve,02/09/2016 02:00:00 AM,48,-122,0,0,0
17787,58thStGreenway22ndAve,02/09/2016 03:00:00 AM,48,-122,0,0,0
17788,58thStGreenway22ndAve,02/09/2016 04:00:00 AM,48,-122,0,0,0
17789,58thStGreenway22ndAve,02/09/2016 05:00:00 AM,48,-122,0,1,1
17790,58thStGreenway22ndAve,02/09/2016 06:00:00 AM,48,-122,1,1,2
17791,58thStGreenway22ndAve,02/09/2016 07:00:00 AM,48,-122,5,1,6
17792,58thStGreenway22ndAve,02/09/2016 08:00:00 AM,48,-122,2,6,8
17793,58thStGreenway22ndAve,02/09/2016 09:00:00 AM,48,-122,4,5,9
17794,58thStGreenway22ndAve,02/09/2016 10:00:00 AM,48,-122,2,3,5
17795,58thStGreenway22ndAve,02/09/2016 11:00:00 AM,48,-122,0,2,2
17796,58thStGreenway22ndAve,02/09/2016 12:00:00 PM,48,-122,5,5,10
17797,58thStGreenway22ndAve,02/09/2016 01:00:00 PM,48,-122,3,3,6
17798,58thStGreenway22ndAve,02/09/2016 02:00:00 PM,48,-122,3,4,7
17799,58thStGreenway22ndAve,02/09/2016 03:00:00 PM,48,-122,9,6,15
17800,58thStGreenway22ndAve,02/09/2016 04:00:00 PM,48,-122,12,6,18
17801,58thStGreenway22ndAve,02/09/2016 05:00:00 PM,48,-122,9,4,13
17802,58thStGreenway22ndAve,02/09/2016 06:00:00 PM,48,-122,6,7,13
17803,58thStGreenway22ndAve,02/09/2016 07:00:00 PM,48,-122,3,4,7
17804,58thStGreenway22ndAve,02/09/2016 08:00:00 PM,48,-122,2,2,4
17805,58thStGreenway22ndAve,02/09/2016 09:00:00 PM,48,-122,4,0,4
17806,58thStGreenway22ndAve,02/09/2016 10:00:00 PM,48,-122,0,1,1
17807,58thStGreenway22ndAve,02/09/2016 11:00:00 PM,48,-122,0,0,0
17808,58thStGreenway22ndAve,02/10/2016 12:00:00 AM,48,-122,0,1,1
17809,58thStGreenway22ndAve,02/10/2016 01:00:00 AM,48,-122,0,0,0
17810,58thStGreenway22ndAve,02/10/2016 02:00:00 AM,48,-122,0,0,0
17811,58thStGreenway22ndAve,02/10/2016 03:00:00 AM,48,-122,0,0,0
17812,58thStGreenway22ndAve,02/10/2016 04:00:00 AM,48,-122,0,0,0
17813,58thStGreenway22ndAve,02/10/2016 05:00:00 AM,48,-122,1,2,3
17814,58thStGreenway22ndAve,02/10/2016 06:00:00 AM,48,-122,0,3,3
17815,58thStGreenway22ndAve,02/10/2016 07:00:00 AM,48,-122,7,2,9
17816,58thStGreenway22ndAve,02/10/2016 08:00:00 AM,48,-122,3,5,8
17817,58thStGreenway22ndAve,02/10/2016 09:00:00 AM,48,-122,2,3,5
17818,58thStGreenway22ndAve,02/10/2016 10:00:00 AM,48,-122,2,6,8
17819,58thStGreenway22ndAve,02/10/2016 11:00:00 AM,48,-122,0,0,0
17820,58thStGreenway22ndAve,02/10/2016 12:00:00 PM,48,-122,1,1,2
17821,58thStGreenway22ndAve,02/10/2016 01:00:00 PM,48,-122,3,4,7
17822,58thStGreenway22ndAve,02/10/2016 02:00:00 PM,48,-122,3,1,4
17823,58thStGreenway22ndAve,02/10/2016 03:00:00 PM,48,-122,3,3,6
17824,58thStGreenway22ndAve,02/10/2016 04:00:00 PM,48,-122,5,3,8
17825,58thStGreenway22ndAve,02/10/2016 05:00:00 PM,48,-122,3,2,5
17826,58thStGreenway22ndAve,02/10/2016 06:00:00 PM,48,-122,3,4,7
17827,58thStGreenway22ndAve,02/10/2016 07:00:00 PM,48,-122,4,6,10
17828,58thStGreenway22ndAve,02/10/2016 08:00:00 PM,48,-122,2,1,3
17829,58thStGreenway22ndAve,02/10/2016 09:00:00 PM,48,-122,2,0,2
17830,58thStGreenway22ndAve,02/10/2016 10:00:00 PM,48,-122,1,0,1
17831,58thStGreenway22ndAve,02/10/2016 11:00:00 PM,48,-122,0,1,1
17832,58thStGreenway22ndAve,02/11/2016 12:00:00 AM,48,-122,0,1,1
17833,58thStGreenway22ndAve,02/11/2016 01:00:00 AM,48,-122,0,0,0
17834,58thStGreenway22ndAve,02/11/2016 02:00:00 AM,48,-122,0,0,0
17835,58thStGreenway22ndAve,02/11/2016 03:00:00 AM,48,-122,0,0,0
17836,58thStGreenway22ndAve,02/11/2016 04:00:00 AM,48,-122,0,0,0
17837,58thStGreenway22ndAve,02/11/2016 05:00:00 AM,48,-122,0,1,1
17838,58thStGreenway22ndAve,02/11/2016 06:00:00 AM,48,-122,0,1,1
17839,58thStGreenway22ndAve,02/11/2016 07:00:00 AM,48,-122,4,2,6
17840,58thStGreenway22ndAve,02/11/2016 08:00:00 AM,48,-122,2,1,3
17841,58thStGreenway22ndAve,02/11/2016 09:00:00 AM,48,-122,4,3,7
17842,58thStGreenway22ndAve,02/11/2016 10:00:00 AM,48,-122,4,7,11
17843,58thStGreenway22ndAve,02/11/2016 11:00:00 AM,48,-122,0,1,1
17844,58thStGreenway22ndAve,02/11/2016 12:00:00 PM,48,-122,1,0,1
17845,58thStGreenway22ndAve,02/11/2016 01:00:00 PM,48,-122,3,3,6
17846,58thStGreenway22ndAve,02/11/2016 02:00:00 PM,48,-122,3,2,5
17847,58thStGreenway22ndAve,02/11/2016 03:00:00 PM,48,-122,2,3,5
17848,58thStGreenway22ndAve,02/11/2016 04:00:00 PM,48,-122,4,0,4
17849,58thStGreenway22ndAve,02/11/2016 05:00:00 PM,48,-122,5,4,9
17850,58thStGreenway22ndAve,02/11/2016 06:00:00 PM,48,-122,0,7,7
17851,58thStGreenway22ndAve,02/11/2016 07:00:00 PM,48,-122,3,3,6
17852,58thStGreenway22ndAve,02/11/2016 08:00:00 PM,48,-122,3,0,3
17853,58thStGreenway22ndAve,02/11/2016 09:00:00 PM,48,-122,2,1,3
17854,58thStGreenway22ndAve,02/11/2016 10:00:00 PM,48,-122,0,0,0
17855,58thStGreenway22ndAve,02/11/2016 11:00:00 PM,48,-122,0,0,0
17856,58thStGreenway22ndAve,02/12/2016 12:00:00 AM,48,-122,0,0,0
17857,58thStGreenway22ndAve,02/12/2016 01:00:00 AM,48,-122,0,0,0
17858,58thStGreenway22ndAve,02/12/2016 02:00:00 AM,48,-122,0,0,0
17859,58thStGreenway22ndAve,02/12/2016 03:00:00 AM,48,-122,0,0,0
17860,58thStGreenway22ndAve,02/12/2016 04:00:00 AM,48,-122,0,0,0
17861,58thStGreenway22ndAve,02/12/2016 05:00:00 AM,48,-122,0,1,1
17862,58thStGreenway22ndAve,02/12/2016 06:00:00 AM,48,-122,0,1,1
17863,58thStGreenway22ndAve,02/12/2016 07:00:00 AM,48,-122,3,3,6
17864,58thStGreenway22ndAve,02/12/2016 08:00:00 AM,48,-122,2,2,4
17865,58thStGreenway22ndAve,02/12/2016 09:00:00 AM,48,-122,2,0,2
17866,58thStGreenway22ndAve,02/12/2016 10:00:00 AM,48,-122,0,1,1
17867,58thStGreenway22ndAve,02/12/2016 11:00:00 AM,48,-122,0,1,1
17868,58thStGreenway22ndAve,02/12/2016 12:00:00 PM,48,-122,2,0,2
17869,58thStGreenway22ndAve,02/12/2016 01:00:00 PM,48,-122,2,3,5
17870,58thStGreenway22ndAve,02/12/2016 02:00:00 PM,48,-122,3,6,9
17871,58thStGreenway22ndAve,02/12/2016 03:00:00 PM,48,-122,1,7,8
17872,58thStGreenway22ndAve,02/12/2016 04:00:00 PM,48,-122,7,2,9
17873,58thStGreenway22ndAve,02/12/2016 05:00:00 PM,48,-122,3,5,8
17874,58thStGreenway22ndAve,02/12/2016 06:00:00 PM,48,-122,4,2,6
17875,58thStGreenway22ndAve,02/12/2016 07:00:00 PM,48,-122,3,2,5
17876,58thStGreenway22ndAve,02/12/2016 08:00:00 PM,48,-122,3,4,7
17877,58thStGreenway22ndAve,02/12/2016 09:00:00 PM,48,-122,0,1,1
17878,58thStGreenway22ndAve,02/12/2016 10:00:00 PM,48,-122,1,0,1
17879,58thStGreenway22ndAve,02/12/2016 11:00:00 PM,48,-122,1,0,1
17880,58thStGreenway22ndAve,02/13/2016 12:00:00 AM,48,-122,0,0,0
17881,58thStGreenway22ndAve,02/13/2016 01:00:00 AM,48,-122,0,1,1
17882,58thStGreenway22ndAve,02/13/2016 02:00:00 AM,48,-122,0,0,0
17883,58thStGreenway22ndAve,02/13/2016 03:00:00 AM,48,-122,0,0,0
17884,58thStGreenway22ndAve,02/13/2016 04:00:00 AM,48,-122,0,0,0
17885,58thStGreenway22ndAve,02/13/2016 05:00:00 AM,48,-122,1,0,1
17886,58thStGreenway22ndAve,02/13/2016 06:00:00 AM,48,-122,0,1,1
17887,58thStGreenway22ndAve,02/13/2016 07:00:00 AM,48,-122,0,0,0
17888,58thStGreenway22ndAve,02/13/2016 08:00:00 AM,48,-122,0,2,2
17889,58thStGreenway22ndAve,02/13/2016 09:00:00 AM,48,-122,0,3,3
17890,58thStGreenway22ndAve,02/13/2016 10:00:00 AM,48,-122,3,3,6
17891,58thStGreenway22ndAve,02/13/2016 11:00:00 AM,48,-122,4,3,7
17892,58thStGreenway22ndAve,02/13/2016 12:00:00 PM,48,-122,4,2,6
17893,58thStGreenway22ndAve,02/13/2016 01:00:00 PM,48,-122,6,1,7
17894,58thStGreenway22ndAve,02/13/2016 02:00:00 PM,48,-122,3,0,3
17895,58thStGreenway22ndAve,02/13/2016 03:00:00 PM,48,-122,1,1,2
17896,58thStGreenway22ndAve,02/13/2016 04:00:00 PM,48,-122,1,1,2
17897,58thStGreenway22ndAve,02/13/2016 05:00:00 PM,48,-122,2,1,3
17898,58thStGreenway22ndAve,02/13/2016 06:00:00 PM,48,-122,2,4,6
17899,58thStGreenway22ndAve,02/13/2016 07:00:00 PM,48,-122,1,0,1
17900,58thStGreenway22ndAve,02/13/2016 08:00:00 PM,48,-122,2,1,3
17901,58thStGreenway22ndAve,02/13/2016 09:00:00 PM,48,-122,0,1,1
17902,58thStGreenway22ndAve,02/13/2016 10:00:00 PM,48,-122,0,0,0
17903,58thStGreenway22ndAve,02/13/2016 11:00:00 PM,48,-122,2,0,2
17904,58thStGreenway22ndAve,02/14/2016 12:00:00 AM,48,-122,1,0,1
17905,58thStGreenway22ndAve,02/14/2016 01:00:00 AM,48,-122,0,0,0
17906,58thStGreenway22ndAve,02/14/2016 02:00:00 AM,48,-122,0,0,0
17907,58thStGreenway22ndAve,02/14/2016 03:00:00 AM,48,-122,0,0,0
17908,58thStGreenway22ndAve,02/14/2016 04:00:00 AM,48,-122,0,0,0
17909,58thStGreenway22ndAve,02/14/2016 05:00:00 AM,48,-122,0,0,0
17910,58thStGreenway22ndAve,02/14/2016 06:00:00 AM,48,-122,0,0,0
17911,58thStGreenway22ndAve,02/14/2016 07:00:00 AM,48,-122,1,1,2
17912,58thStGreenway22ndAve,02/14/2016 08:00:00 AM,48,-122,0,1,1
17913,58thStGreenway22ndAve,02/14/2016 09:00:00 AM,48,-122,1,3,4
17914,58thStGreenway22ndAve,02/14/2016 10:00:00 AM,48,-122,5,1,6
17915,58thStGreenway22ndAve,02/14/2016 11:00:00 AM,48,-122,0,6,6
17916,58thStGreenway22ndAve,02/14/2016 12:00:00 PM,48,-122,2,4,6
17917,58thStGreenway22ndAve,02/14/2016 01:00:00 PM,48,-122,1,3,4
17918,58thStGreenway22ndAve,02/14/2016 02:00:00 PM,48,-122,2,2,4
17919,58thStGreenway22ndAve,02/14/2016 03:00:00 PM,48,-122,2,5,7
17920,58thStGreenway22ndAve,02/14/2016 04:00:00 PM,48,-122,0,2,2
17921,58thStGreenway22ndAve,02/14/2016 05:00:00 PM,48,-122,1,0,1
17922,58thStGreenway22ndAve,02/14/2016 06:00:00 PM,48,-122,1,1,2
17923,58thStGreenway22ndAve,02/14/2016 07:00:00 PM,48,-122,0,1,1
17924,58thStGreenway22ndAve,02/14/2016 08:00:00 PM,48,-122,1,2,3
17925,58thStGreenway22ndAve,02/14/2016 09:00:00 PM,48,-122,0,0,0
17926,58thStGreenway22ndAve,02/14/2016 10:00:00 PM,48,-122,0,0,0
17927,58thStGreenway22ndAve,02/14/2016 11:00:00 PM,48,-122,1,0,1
17928,58thStGreenway22ndAve,02/15/2016 12:00:00 AM,48,-122,0,0,0
17929,58thStGreenway22ndAve,02/15/2016 01:00:00 AM,48,-122,0,0,0
17930,58thStGreenway22ndAve,02/15/2016 02:00:00 AM,48,-122,0,0,0
17931,58thStGreenway22ndAve,02/15/2016 03:00:00 AM,48,-122,0,0,0
17932,58thStGreenway22ndAve,02/15/2016 04:00:00 AM,48,-122,0,0,0
17933,58thStGreenway22ndAve,02/15/2016 05:00:00 AM,48,-122,0,0,0
17934,58thStGreenway22ndAve,02/15/2016 06:00:00 AM,48,-122,0,1,1
17935,58thStGreenway22ndAve,02/15/2016 07:00:00 AM,48,-122,2,0,2
17936,58thStGreenway22ndAve,02/15/2016 08:00:00 AM,48,-122,1,2,3
17937,58thStGreenway22ndAve,02/15/2016 09:00:00 AM,48,-122,3,6,9
17938,58thStGreenway22ndAve,02/15/2016 10:00:00 AM,48,-122,3,0,3
17939,58thStGreenway22ndAve,02/15/2016 11:00:00 AM,48,-122,0,5,5
17940,58thStGreenway22ndAve,02/15/2016 12:00:00 PM,48,-122,2,1,3
17941,58thStGreenway22ndAve,02/15/2016 01:00:00 PM,48,-122,2,1,3
17942,58thStGreenway22ndAve,02/15/2016 02:00:00 PM,48,-122,1,0,1
17943,58thStGreenway22ndAve,02/15/2016 03:00:00 PM,48,-122,0,2,2
17944,58thStGreenway22ndAve,02/15/2016 04:00:00 PM,48,-122,4,0,4
17945,58thStGreenway22ndAve,02/15/2016 05:00:00 PM,48,-122,4,1,5
17946,58thStGreenway22ndAve,02/15/2016 06:00:00 PM,48,-122,1,3,4
17947,58thStGreenway22ndAve,02/15/2016 07:00:00 PM,48,-122,1,2,3
17948,58thStGreenway22ndAve,02/15/2016 08:00:00 PM,48,-122,1,0,1
17949,58thStGreenway22ndAve,02/15/2016 09:00:00 PM,48,-122,0,0,0
17950,58thStGreenway22ndAve,02/15/2016 10:00:00 PM,48,-122,2,2,4
17951,58thStGreenway22ndAve,02/15/2016 11:00:00 PM,48,-122,0,0,0
17952,58thStGreenway22ndAve,02/16/2016 12:00:00 AM,48,-122,0,0,0
17953,58thStGreenway22ndAve,02/16/2016 01:00:00 AM,48,-122,0,0,0
17954,58thStGreenway22ndAve,02/16/2016 02:00:00 AM,48,-122,0,0,0
17955,58thStGreenway22ndAve,02/16/2016 03:00:00 AM,48,-122,0,0,0
17956,58thStGreenway22ndAve,02/16/2016 04:00:00 AM,48,-122,0,0,0
17957,58thStGreenway22ndAve,02/16/2016 05:00:00 AM,48,-122,0,0,0
17958,58thStGreenway22ndAve,02/16/2016 06:00:00 AM,48,-122,1,3,4
17959,58thStGreenway22ndAve,02/16/2016 07:00:00 AM,48,-122,3,1,4
17960,58thStGreenway22ndAve,02/16/2016 08:00:00 AM,48,-122,4,5,9
17961,58thStGreenway22ndAve,02/16/2016 09:00:00 AM,48,-122,3,3,6
17962,58thStGreenway22ndAve,02/16/2016 10:00:00 AM,48,-122,6,3,9
17963,58thStGreenway22ndAve,02/16/2016 11:00:00 AM,48,-122,1,1,2
17964,58thStGreenway22ndAve,02/16/2016 12:00:00 PM,48,-122,1,3,4
17965,58thStGreenway22ndAve,02/16/2016 01:00:00 PM,48,-122,4,3,7
17966,58thStGreenway22ndAve,02/16/2016 02:00:00 PM,48,-122,1,1,2
17967,58thStGreenway22ndAve,02/16/2016 03:00:00 PM,48,-122,4,1,5
17968,58thStGreenway22ndAve,02/16/2016 04:00:00 PM,48,-122,4,2,6
17969,58thStGreenway22ndAve,02/16/2016 05:00:00 PM,48,-122,7,9,16
17970,58thStGreenway22ndAve,02/16/2016 06:00:00 PM,48,-122,5,3,8
17971,58thStGreenway22ndAve,02/16/2016 07:00:00 PM,48,-122,4,7,11
17972,58thStGreenway22ndAve,02/16/2016 08:00:00 PM,48,-122,3,0,3
17973,58thStGreenway22ndAve,02/16/2016 09:00:00 PM,48,-122,0,0,0
17974,58thStGreenway22ndAve,02/16/2016 10:00:00 PM,48,-122,1,1,2
17975,58thStGreenway22ndAve,02/16/2016 11:00:00 PM,48,-122,0,0,0
17976,58thStGreenway22ndAve,02/17/2016 12:00:00 AM,48,-122,0,0,0
17977,58thStGreenway22ndAve,02/17/2016 01:00:00 AM,48,-122,0,0,0
17978,58thStGreenway22ndAve,02/17/2016 02:00:00 AM,48,-122,0,0,0
17979,58thStGreenway22ndAve,02/17/2016 03:00:00 AM,48,-122,0,0,0
17980,58thStGreenway22ndAve,02/17/2016 04:00:00 AM,48,-122,0,0,0
17981,58thStGreenway22ndAve,02/17/2016 05:00:00 AM,48,-122,0,0,0
17982,58thStGreenway22ndAve,02/17/2016 06:00:00 AM,48,-122,0,1,1
17983,58thStGreenway22ndAve,02/17/2016 07:00:00 AM,48,-122,3,1,4
17984,58thStGreenway22ndAve,02/17/2016 08:00:00 AM,48,-122,5,7,12
17985,58thStGreenway22ndAve,02/17/2016 09:00:00 AM,48,-122,8,6,14
17986,58thStGreenway22ndAve,02/17/2016 10:00:00 AM,48,-122,1,2,3
17987,58thStGreenway22ndAve,02/17/2016 11:00:00 AM,48,-122,0,3,3
17988,58thStGreenway22ndAve,02/17/2016 12:00:00 PM,48,-122,3,2,5
17989,58thStGreenway22ndAve,02/17/2016 01:00:00 PM,48,-122,2,6,8
17990,58thStGreenway22ndAve,02/17/2016 02:00:00 PM,48,-122,1,0,1
17991,58thStGreenway22ndAve,02/17/2016 03:00:00 PM,48,-122,2,2,4
17992,58thStGreenway22ndAve,02/17/2016 04:00:00 PM,48,-122,7,0,7
17993,58thStGreenway22ndAve,02/17/2016 05:00:00 PM,48,-122,5,3,8
17994,58thStGreenway22ndAve,02/17/2016 06:00:00 PM,48,-122,3,2,5
17995,58thStGreenway22ndAve,02/17/2016 07:00:00 PM,48,-122,2,3,5
17996,58thStGreenway22ndAve,02/17/2016 08:00:00 PM,48,-122,1,1,2
17997,58thStGreenway22ndAve,02/17/2016 09:00:00 PM,48,-122,0,0,0
17998,58thStGreenway22ndAve,02/17/2016 10:00:00 PM,48,-122,0,0,0
17999,58thStGreenway22ndAve,02/17/2016 11:00:00 PM,48,-122,0,1,1
18000,58thStGreenway22ndAve,02/18/2016 12:00:00 AM,48,-122,0,0,0
18001,58thStGreenway22ndAve,02/18/2016 01:00:00 AM,48,-122,0,0,0
18002,58thStGreenway22ndAve,02/18/2016 02:00:00 AM,48,-122,0,0,0
18003,58thStGreenway22ndAve,02/18/2016 03:00:00 AM,48,-122,0,0,0
18004,58thStGreenway22ndAve,02/18/2016 04:00:00 AM,48,-122,0,0,0
18005,58thStGreenway22ndAve,02/18/2016 05:00:00 AM,48,-122,0,0,0
18006,58thStGreenway22ndAve,02/18/2016 06:00:00 AM,48,-122,1,2,3
18007,58thStGreenway22ndAve,02/18/2016 07:00:00 AM,48,-122,6,0,6
18008,58thStGreenway22ndAve,02/18/2016 08:00:00 AM,48,-122,3,2,5
18009,58thStGreenway22ndAve,02/18/2016 09:00:00 AM,48,-122,4,3,7
18010,58thStGreenway22ndAve,02/18/2016 10:00:00 AM,48,-122,2,6,8
18011,58thStGreenway22ndAve,02/18/2016 11:00:00 AM,48,-122,0,0,0
18012,58thStGreenway22ndAve,02/18/2016 12:00:00 PM,48,-122,5,1,6
18013,58thStGreenway22ndAve,02/18/2016 01:00:00 PM,48,-122,2,4,6
18014,58thStGreenway22ndAve,02/18/2016 02:00:00 PM,48,-122,5,3,8
18015,58thStGreenway22ndAve,02/18/2016 03:00:00 PM,48,-122,2,2,4
18016,58thStGreenway22ndAve,02/18/2016 04:00:00 PM,48,-122,5,4,9
18017,58thStGreenway22ndAve,02/18/2016 05:00:00 PM,48,-122,3,6,9
18018,58thStGreenway22ndAve,02/18/2016 06:00:00 PM,48,-122,3,5,8
18019,58thStGreenway22ndAve,02/18/2016 07:00:00 PM,48,-122,2,4,6
18020,58thStGreenway22ndAve,02/18/2016 08:00:00 PM,48,-122,1,3,4
18021,58thStGreenway22ndAve,02/18/2016 09:00:00 PM,48,-122,3,0,3
18022,58thStGreenway22ndAve,02/18/2016 10:00:00 PM,48,-122,0,0,0
18023,58thStGreenway22ndAve,02/18/2016 11:00:00 PM,48,-122,0,0,0
18024,58thStGreenway22ndAve,02/19/2016 12:00:00 AM,48,-122,0,0,0
18025,58thStGreenway22ndAve,02/19/2016 01:00:00 AM,48,-122,0,0,0
18026,58thStGreenway22ndAve,02/19/2016 02:00:00 AM,48,-122,0,0,0
18027,58thStGreenway22ndAve,02/19/2016 03:00:00 AM,48,-122,0,0,0
18028,58thStGreenway22ndAve,02/19/2016 04:00:00 AM,48,-122,0,0,0
18029,58thStGreenway22ndAve,02/19/2016 05:00:00 AM,48,-122,0,0,0
18030,58thStGreenway22ndAve,02/19/2016 06:00:00 AM,48,-122,1,1,2
18031,58thStGreenway22ndAve,02/19/2016 07:00:00 AM,48,-122,2,1,3
18032,58thStGreenway22ndAve,02/19/2016 08:00:00 AM,48,-122,1,3,4
18033,58thStGreenway22ndAve,02/19/2016 09:00:00 AM,48,-122,1,1,2
18034,58thStGreenway22ndAve,02/19/2016 10:00:00 AM,48,-122,0,3,3
18035,58thStGreenway22ndAve,02/19/2016 11:00:00 AM,48,-122,0,2,2
18036,58thStGreenway22ndAve,02/19/2016 12:00:00 PM,48,-122,4,1,5
18037,58thStGreenway22ndAve,02/19/2016 01:00:00 PM,48,-122,0,1,1
18038,58thStGreenway22ndAve,02/19/2016 02:00:00 PM,48,-122,2,1,3
18039,58thStGreenway22ndAve,02/19/2016 03:00:00 PM,48,-122,1,1,2
18040,58thStGreenway22ndAve,02/19/2016 04:00:00 PM,48,-122,1,0,1
18041,58thStGreenway22ndAve,02/19/2016 05:00:00 PM,48,-122,3,1,4
18042,58thStGreenway22ndAve,02/19/2016 06:00:00 PM,48,-122,0,1,1
18043,58thStGreenway22ndAve,02/19/2016 07:00:00 PM,48,-122,2,4,6
18044,58thStGreenway22ndAve,02/19/2016 08:00:00 PM,48,-122,0,1,1
18045,58thStGreenway22ndAve,02/19/2016 09:00:00 PM,48,-122,3,0,3
18046,58thStGreenway22ndAve,02/19/2016 10:00:00 PM,48,-122,1,0,1
18047,58thStGreenway22ndAve,02/19/2016 11:00:00 PM,48,-122,0,0,0
18048,58thStGreenway22ndAve,02/20/2016 12:00:00 AM,48,-122,0,0,0
18049,58thStGreenway22ndAve,02/20/2016 01:00:00 AM,48,-122,0,0,0
18050,58thStGreenway22ndAve,02/20/2016 02:00:00 AM,48,-122,0,0,0
18051,58thStGreenway22ndAve,02/20/2016 03:00:00 AM,48,-122,0,0,0
18052,58thStGreenway22ndAve,02/20/2016 04:00:00 AM,48,-122,0,0,0
18053,58thStGreenway22ndAve,02/20/2016 05:00:00 AM,48,-122,0,0,0
18054,58thStGreenway22ndAve,02/20/2016 06:00:00 AM,48,-122,0,1,1
18055,58thStGreenway22ndAve,02/20/2016 07:00:00 AM,48,-122,1,0,1
18056,58thStGreenway22ndAve,02/20/2016 08:00:00 AM,48,-122,0,1,1
18057,58thStGreenway22ndAve,02/20/2016 09:00:00 AM,48,-122,4,3,7
18058,58thStGreenway22ndAve,02/20/2016 10:00:00 AM,48,-122,10,2,12
18059,58thStGreenway22ndAve,02/20/2016 11:00:00 AM,48,-122,1,12,13
18060,58thStGreenway22ndAve,02/20/2016 12:00:00 PM,48,-122,10,7,17
18061,58thStGreenway22ndAve,02/20/2016 01:00:00 PM,48,-122,5,5,10
18062,58thStGreenway22ndAve,02/20/2016 02:00:00 PM,48,-122,8,2,10
18063,58thStGreenway22ndAve,02/20/2016 03:00:00 PM,48,-122,7,3,10
18064,58thStGreenway22ndAve,02/20/2016 04:00:00 PM,48,-122,3,4,7
18065,58thStGreenway22ndAve,02/20/2016 05:00:00 PM,48,-122,3,3,6
18066,58thStGreenway22ndAve,02/20/2016 06:00:00 PM,48,-122,5,3,8
18067,58thStGreenway22ndAve,02/20/2016 07:00:00 PM,48,-122,3,1,4
18068,58thStGreenway22ndAve,02/20/2016 08:00:00 PM,48,-122,5,3,8
18069,58thStGreenway22ndAve,02/20/2016 09:00:00 PM,48,-122,0,0,0
18070,58thStGreenway22ndAve,02/20/2016 10:00:00 PM,48,-122,0,1,1
18071,58thStGreenway22ndAve,02/20/2016 11:00:00 PM,48,-122,0,1,1
18072,58thStGreenway22ndAve,02/21/2016 12:00:00 AM,48,-122,0,2,2
18073,58thStGreenway22ndAve,02/21/2016 01:00:00 AM,48,-122,0,0,0
18074,58thStGreenway22ndAve,02/21/2016 02:00:00 AM,48,-122,0,0,0
18075,58thStGreenway22ndAve,02/21/2016 03:00:00 AM,48,-122,0,0,0
18076,58thStGreenway22ndAve,02/21/2016 04:00:00 AM,48,-122,0,0,0
18077,58thStGreenway22ndAve,02/21/2016 05:00:00 AM,48,-122,0,0,0
18078,58thStGreenway22ndAve,02/21/2016 06:00:00 AM,48,-122,0,2,2
18079,58thStGreenway22ndAve,02/21/2016 07:00:00 AM,48,-122,0,0,0
18080,58thStGreenway22ndAve,02/21/2016 08:00:00 AM,48,-122,1,4,5
18081,58thStGreenway22ndAve,02/21/2016 09:00:00 AM,48,-122,2,2,4
18082,58thStGreenway22ndAve,02/21/2016 10:00:00 AM,48,-122,1,3,4
18083,58thStGreenway22ndAve,02/21/2016 11:00:00 AM,48,-122,2,5,7
18084,58thStGreenway22ndAve,02/21/2016 12:00:00 PM,48,-122,5,0,5
18085,58thStGreenway22ndAve,02/21/2016 01:00:00 PM,48,-122,0,2,2
18086,58thStGreenway22ndAve,02/21/2016 02:00:00 PM,48,-122,5,7,12
18087,58thStGreenway22ndAve,02/21/2016 03:00:00 PM,48,-122,2,3,5
18088,58thStGreenway22ndAve,02/21/2016 04:00:00 PM,48,-122,1,2,3
18089,58thStGreenway22ndAve,02/21/2016 05:00:00 PM,48,-122,6,2,8
18090,58thStGreenway22ndAve,02/21/2016 06:00:00 PM,48,-122,1,1,2
18091,58thStGreenway22ndAve,02/21/2016 07:00:00 PM,48,-122,1,3,4
18092,58thStGreenway22ndAve,02/21/2016 08:00:00 PM,48,-122,0,3,3
18093,58thStGreenway22ndAve,02/21/2016 09:00:00 PM,48,-122,3,0,3
18094,58thStGreenway22ndAve,02/21/2016 10:00:00 PM,48,-122,0,0,0
18095,58thStGreenway22ndAve,02/21/2016 11:00:00 PM,48,-122,1,2,3
18096,58thStGreenway22ndAve,02/22/2016 12:00:00 AM,48,-122,0,0,0
18097,58thStGreenway22ndAve,02/22/2016 01:00:00 AM,48,-122,0,0,0
18098,58thStGreenway22ndAve,02/22/2016 02:00:00 AM,48,-122,0,0,0
18099,58thStGreenway22ndAve,02/22/2016 03:00:00 AM,48,-122,0,0,0
18100,58thStGreenway22ndAve,02/22/2016 04:00:00 AM,48,-122,0,0,0
18101,58thStGreenway22ndAve,02/22/2016 05:00:00 AM,48,-122,0,1,1
18102,58thStGreenway22ndAve,02/22/2016 06:00:00 AM,48,-122,0,2,2
18103,58thStGreenway22ndAve,02/22/2016 07:00:00 AM,48,-122,8,3,11
18104,58thStGreenway22ndAve,02/22/2016 08:00:00 AM,48,-122,0,7,7
18105,58thStGreenway22ndAve,02/22/2016 09:00:00 AM,48,-122,7,6,13
18106,58thStGreenway22ndAve,02/22/2016 10:00:00 AM,48,-122,4,2,6
18107,58thStGreenway22ndAve,02/22/2016 11:00:00 AM,48,-122,0,1,1
18108,58thStGreenway22ndAve,02/22/2016 12:00:00 PM,48,-122,3,1,4
18109,58thStGreenway22ndAve,02/22/2016 01:00:00 PM,48,-122,1,5,6
18110,58thStGreenway22ndAve,02/22/2016 02:00:00 PM,48,-122,4,2,6
18111,58thStGreenway22ndAve,02/22/2016 03:00:00 PM,48,-122,3,6,9
18112,58thStGreenway22ndAve,02/22/2016 04:00:00 PM,48,-122,6,4,10
18113,58thStGreenway22ndAve,02/22/2016 05:00:00 PM,48,-122,3,4,7
18114,58thStGreenway22ndAve,02/22/2016 06:00:00 PM,48,-122,2,4,6
18115,58thStGreenway22ndAve,02/22/2016 07:00:00 PM,48,-122,1,0,1
18116,58thStGreenway22ndAve,02/22/2016 08:00:00 PM,48,-122,1,1,2
18117,58thStGreenway22ndAve,02/22/2016 09:00:00 PM,48,-122,1,0,1
18118,58thStGreenway22ndAve,02/22/2016 10:00:00 PM,48,-122,1,0,1
18119,58thStGreenway22ndAve,02/22/2016 11:00:00 PM,48,-122,2,0,2
18120,58thStGreenway22ndAve,02/23/2016 12:00:00 AM,48,-122,0,0,0
18121,58thStGreenway22ndAve,02/23/2016 01:00:00 AM,48,-122,0,0,0
18122,58thStGreenway22ndAve,02/23/2016 02:00:00 AM,48,-122,0,0,0
18123,58thStGreenway22ndAve,02/23/2016 03:00:00 AM,48,-122,0,0,0
18124,58thStGreenway22ndAve,02/23/2016 04:00:00 AM,48,-122,0,0,0
18125,58thStGreenway22ndAve,02/23/2016 05:00:00 AM,48,-122,0,1,1
18126,58thStGreenway22ndAve,02/23/2016 06:00:00 AM,48,-122,0,2,2
18127,58thStGreenway22ndAve,02/23/2016 07:00:00 AM,48,-122,3,2,5
18128,58thStGreenway22ndAve,02/23/2016 08:00:00 AM,48,-122,7,6,13
18129,58thStGreenway22ndAve,02/23/2016 09:00:00 AM,48,-122,3,2,5
18130,58thStGreenway22ndAve,02/23/2016 10:00:00 AM,48,-122,1,5,6
18131,58thStGreenway22ndAve,02/23/2016 11:00:00 AM,48,-122,3,4,7
18132,58thStGreenway22ndAve,02/23/2016 12:00:00 PM,48,-122,3,3,6
18133,58thStGreenway22ndAve,02/23/2016 01:00:00 PM,48,-122,2,3,5
18134,58thStGreenway22ndAve,02/23/2016 02:00:00 PM,48,-122,4,1,5
18135,58thStGreenway22ndAve,02/23/2016 03:00:00 PM,48,-122,3,1,4
18136,58thStGreenway22ndAve,02/23/2016 04:00:00 PM,48,-122,6,5,11
18137,58thStGreenway22ndAve,02/23/2016 05:00:00 PM,48,-122,4,3,7
18138,58thStGreenway22ndAve,02/23/2016 06:00:00 PM,48,-122,3,7,10
18139,58thStGreenway22ndAve,02/23/2016 07:00:00 PM,48,-122,3,8,11
18140,58thStGreenway22ndAve,02/23/2016 08:00:00 PM,48,-122,1,1,2
18141,58thStGreenway22ndAve,02/23/2016 09:00:00 PM,48,-122,2,0,2
18142,58thStGreenway22ndAve,02/23/2016 10:00:00 PM,48,-122,1,0,1
18143,58thStGreenway22ndAve,02/23/2016 11:00:00 PM,48,-122,0,0,0
18144,58thStGreenway22ndAve,02/24/2016 12:00:00 AM,48,-122,0,0,0
18145,58thStGreenway22ndAve,02/24/2016 01:00:00 AM,48,-122,0,0,0
18146,58thStGreenway22ndAve,02/24/2016 02:00:00 AM,48,-122,0,0,0
18147,58thStGreenway22ndAve,02/24/2016 03:00:00 AM,48,-122,0,0,0
18148,58thStGreenway22ndAve,02/24/2016 04:00:00 AM,48,-122,0,0,0
18149,58thStGreenway22ndAve,02/24/2016 05:00:00 AM,48,-122,0,1,1
18150,58thStGreenway22ndAve,02/24/2016 06:00:00 AM,48,-122,0,2,2
18151,58thStGreenway22ndAve,02/24/2016 07:00:00 AM,48,-122,6,4,10
18152,58thStGreenway22ndAve,02/24/2016 08:00:00 AM,48,-122,6,4,10
18153,58thStGreenway22ndAve,02/24/2016 09:00:00 AM,48,-122,4,4,8
18154,58thStGreenway22ndAve,02/24/2016 10:00:00 AM,48,-122,0,2,2
18155,58thStGreenway22ndAve,02/24/2016 11:00:00 AM,48,-122,2,3,5
18156,58thStGreenway22ndAve,02/24/2016 12:00:00 PM,48,-122,4,8,12
18157,58thStGreenway22ndAve,02/24/2016 01:00:00 PM,48,-122,4,3,7
18158,58thStGreenway22ndAve,02/24/2016 02:00:00 PM,48,-122,3,2,5
18159,58thStGreenway22ndAve,02/24/2016 03:00:00 PM,48,-122,2,4,6
18160,58thStGreenway22ndAve,02/24/2016 04:00:00 PM,48,-122,5,8,13
18161,58thStGreenway22ndAve,02/24/2016 05:00:00 PM,48,-122,5,4,9
18162,58thStGreenway22ndAve,02/24/2016 06:00:00 PM,48,-122,5,4,9
18163,58thStGreenway22ndAve,02/24/2016 07:00:00 PM,48,-122,2,1,3
18164,58thStGreenway22ndAve,02/24/2016 08:00:00 PM,48,-122,1,0,1
18165,58thStGreenway22ndAve,02/24/2016 09:00:00 PM,48,-122,0,0,0
18166,58thStGreenway22ndAve,02/24/2016 10:00:00 PM,48,-122,2,0,2
18167,58thStGreenway22ndAve,02/24/2016 11:00:00 PM,48,-122,0,0,0
18168,58thStGreenway22ndAve,02/25/2016 12:00:00 AM,48,-122,0,0,0
18169,58thStGreenway22ndAve,02/25/2016 01:00:00 AM,48,-122,0,0,0
18170,58thStGreenway22ndAve,02/25/2016 02:00:00 AM,48,-122,2,0,2
18171,58thStGreenway22ndAve,02/25/2016 03:00:00 AM,48,-122,0,0,0
18172,58thStGreenway22ndAve,02/25/2016 04:00:00 AM,48,-122,0,2,2
18173,58thStGreenway22ndAve,02/25/2016 05:00:00 AM,48,-122,0,1,1
18174,58thStGreenway22ndAve,02/25/2016 06:00:00 AM,48,-122,2,2,4
18175,58thStGreenway22ndAve,02/25/2016 07:00:00 AM,48,-122,1,3,4
18176,58thStGreenway22ndAve,02/25/2016 08:00:00 AM,48,-122,3,2,5
18177,58thStGreenway22ndAve,02/25/2016 09:00:00 AM,48,-122,5,1,6
18178,58thStGreenway22ndAve,02/25/2016 10:00:00 AM,48,-122,1,3,4
18179,58thStGreenway22ndAve,02/25/2016 11:00:00 AM,48,-122,4,3,7
18180,58thStGreenway22ndAve,02/25/2016 12:00:00 PM,48,-122,2,6,8
18181,58thStGreenway22ndAve,02/25/2016 01:00:00 PM,48,-122,2,5,7
18182,58thStGreenway22ndAve,02/25/2016 02:00:00 PM,48,-122,8,5,13
18183,58thStGreenway22ndAve,02/25/2016 03:00:00 PM,48,-122,3,7,10
18184,58thStGreenway22ndAve,02/25/2016 04:00:00 PM,48,-122,10,6,16
18185,58thStGreenway22ndAve,02/25/2016 05:00:00 PM,48,-122,7,12,19
18186,58thStGreenway22ndAve,02/25/2016 06:00:00 PM,48,-122,5,8,13
18187,58thStGreenway22ndAve,02/25/2016 07:00:00 PM,48,-122,9,4,13
18188,58thStGreenway22ndAve,02/25/2016 08:00:00 PM,48,-122,0,2,2
18189,58thStGreenway22ndAve,02/25/2016 09:00:00 PM,48,-122,4,2,6
18190,58thStGreenway22ndAve,02/25/2016 10:00:00 PM,48,-122,2,0,2
18191,58thStGreenway22ndAve,02/25/2016 11:00:00 PM,48,-122,0,0,0
18192,58thStGreenway22ndAve,02/26/2016 12:00:00 AM,48,-122,0,0,0
18193,58thStGreenway22ndAve,02/26/2016 01:00:00 AM,48,-122,0,0,0
18194,58thStGreenway22ndAve,02/26/2016 02:00:00 AM,48,-122,0,0,0
18195,58thStGreenway22ndAve,02/26/2016 03:00:00 AM,48,-122,0,0,0
18196,58thStGreenway22ndAve,02/26/2016 04:00:00 AM,48,-122,0,0,0
18197,58thStGreenway22ndAve,02/26/2016 05:00:00 AM,48,-122,0,1,1
18198,58thStGreenway22ndAve,02/26/2016 06:00:00 AM,48,-122,0,3,3
18199,58thStGreenway22ndAve,02/26/2016 07:00:00 AM,48,-122,1,2,3
18200,58thStGreenway22ndAve,02/26/2016 08:00:00 AM,48,-122,3,3,6
18201,58thStGreenway22ndAve,02/26/2016 09:00:00 AM,48,-122,5,3,8
18202,58thStGreenway22ndAve,02/26/2016 10:00:00 AM,48,-122,4,1,5
18203,58thStGreenway22ndAve,02/26/2016 11:00:00 AM,48,-122,4,5,9
18204,58thStGreenway22ndAve,02/26/2016 12:00:00 PM,48,-122,3,4,7
18205,58thStGreenway22ndAve,02/26/2016 01:00:00 PM,48,-122,7,6,13
18206,58thStGreenway22ndAve,02/26/2016 02:00:00 PM,48,-122,1,0,1
18207,58thStGreenway22ndAve,02/26/2016 03:00:00 PM,48,-122,4,2,6
18208,58thStGreenway22ndAve,02/26/2016 04:00:00 PM,48,-122,1,4,5
18209,58thStGreenway22ndAve,02/26/2016 05:00:00 PM,48,-122,0,3,3
18210,58thStGreenway22ndAve,02/26/2016 06:00:00 PM,48,-122,1,0,1
18211,58thStGreenway22ndAve,02/26/2016 07:00:00 PM,48,-122,0,0,0
18212,58thStGreenway22ndAve,02/26/2016 08:00:00 PM,48,-122,0,0,0
18213,58thStGreenway22ndAve,02/26/2016 09:00:00 PM,48,-122,1,0,1
18214,58thStGreenway22ndAve,02/26/2016 10:00:00 PM,48,-122,1,0,1
18215,58thStGreenway22ndAve,02/26/2016 11:00:00 PM,48,-122,0,0,0
18216,58thStGreenway22ndAve,02/27/2016 12:00:00 AM,48,-122,0,0,0
18217,58thStGreenway22ndAve,02/27/2016 01:00:00 AM,48,-122,0,0,0
18218,58thStGreenway22ndAve,02/27/2016 02:00:00 AM,48,-122,0,0,0
18219,58thStGreenway22ndAve,02/27/2016 03:00:00 AM,48,-122,0,0,0
18220,58thStGreenway22ndAve,02/27/2016 04:00:00 AM,48,-122,0,0,0
18221,58thStGreenway22ndAve,02/27/2016 05:00:00 AM,48,-122,0,0,0
18222,58thStGreenway22ndAve,02/27/2016 06:00:00 AM,48,-122,0,0,0
18223,58thStGreenway22ndAve,02/27/2016 07:00:00 AM,48,-122,0,0,0
18224,58thStGreenway22ndAve,02/27/2016 08:00:00 AM,48,-122,1,1,2
18225,58thStGreenway22ndAve,02/27/2016 09:00:00 AM,48,-122,0,4,4
18226,58thStGreenway22ndAve,02/27/2016 10:00:00 AM,48,-122,1,8,9
18227,58thStGreenway22ndAve,02/27/2016 11:00:00 AM,48,-122,3,37,40
18228,58thStGreenway22ndAve,02/27/2016 12:00:00 PM,48,-122,6,3,9
18229,58thStGreenway22ndAve,02/27/2016 01:00:00 PM,48,-122,8,7,15
18230,58thStGreenway22ndAve,02/27/2016 02:00:00 PM,48,-122,6,6,12
18231,58thStGreenway22ndAve,02/27/2016 03:00:00 PM,48,-122,9,9,18
18232,58thStGreenway22ndAve,02/27/2016 04:00:00 PM,48,-122,0,7,7
18233,58thStGreenway22ndAve,02/27/2016 05:00:00 PM,48,-122,11,4,15
18234,58thStGreenway22ndAve,02/27/2016 06:00:00 PM,48,-122,5,1,6
18235,58thStGreenway22ndAve,02/27/2016 07:00:00 PM,48,-122,3,2,5
18236,58thStGreenway22ndAve,02/27/2016 08:00:00 PM,48,-122,1,0,1
18237,58thStGreenway22ndAve,02/27/2016 09:00:00 PM,48,-122,0,0,0
18238,58thStGreenway22ndAve,02/27/2016 10:00:00 PM,48,-122,0,0,0
18239,58thStGreenway22ndAve,02/27/2016 11:00:00 PM,48,-122,0,0,0
18240,58thStGreenway22ndAve,02/28/2016 12:00:00 AM,48,-122,0,0,0
18241,58thStGreenway22ndAve,02/28/2016 01:00:00 AM,48,-122,1,0,1
18242,58thStGreenway22ndAve,02/28/2016 02:00:00 AM,48,-122,2,0,2
18243,58thStGreenway22ndAve,02/28/2016 03:00:00 AM,48,-122,0,0,0
18244,58thStGreenway22ndAve,02/28/2016 04:00:00 AM,48,-122,0,0,0
18245,58thStGreenway22ndAve,02/28/2016 05:00:00 AM,48,-122,0,0,0
18246,58thStGreenway22ndAve,02/28/2016 06:00:00 AM,48,-122,0,0,0
18247,58thStGreenway22ndAve,02/28/2016 07:00:00 AM,48,-122,0,1,1
18248,58thStGreenway22ndAve,02/28/2016 08:00:00 AM,48,-122,0,3,3
18249,58thStGreenway22ndAve,02/28/2016 09:00:00 AM,48,-122,0,0,0
18250,58thStGreenway22ndAve,02/28/2016 10:00:00 AM,48,-122,2,0,2
18251,58thStGreenway22ndAve,02/28/2016 11:00:00 AM,48,-122,5,3,8
18252,58thStGreenway22ndAve,02/28/2016 12:00:00 PM,48,-122,2,3,5
18253,58thStGreenway22ndAve,02/28/2016 01:00:00 PM,48,-122,1,1,2
18254,58thStGreenway22ndAve,02/28/2016 02:00:00 PM,48,-122,1,1,2
18255,58thStGreenway22ndAve,02/28/2016 03:00:00 PM,48,-122,3,3,6
18256,58thStGreenway22ndAve,02/28/2016 04:00:00 PM,48,-122,0,2,2
18257,58thStGreenway22ndAve,02/28/2016 05:00:00 PM,48,-122,2,3,5
18258,58thStGreenway22ndAve,02/28/2016 06:00:00 PM,48,-122,5,1,6
18259,58thStGreenway22ndAve,02/28/2016 07:00:00 PM,48,-122,3,0,3
18260,58thStGreenway22ndAve,02/28/2016 08:00:00 PM,48,-122,1,0,1
18261,58thStGreenway22ndAve,02/28/2016 09:00:00 PM,48,-122,0,0,0
18262,58thStGreenway22ndAve,02/28/2016 10:00:00 PM,48,-122,0,0,0
18263,58thStGreenway22ndAve,02/28/2016 11:00:00 PM,48,-122,0,0,0
18264,58thStGreenway22ndAve,02/29/2016 12:00:00 AM,48,-122,0,0,0
18265,58thStGreenway22ndAve,02/29/2016 01:00:00 AM,48,-122,0,0,0
18266,58thStGreenway22ndAve,02/29/2016 02:00:00 AM,48,-122,0,0,0
18267,58thStGreenway22ndAve,02/29/2016 03:00:00 AM,48,-122,0,0,0
18268,58thStGreenway22ndAve,02/29/2016 04:00:00 AM,48,-122,0,0,0
18269,58thStGreenway22ndAve,02/29/2016 05:00:00 AM,48,-122,0,2,2
18270,58thStGreenway22ndAve,02/29/2016 06:00:00 AM,48,-122,0,0,0
18271,58thStGreenway22ndAve,02/29/2016 07:00:00 AM,48,-122,2,2,4
18272,58thStGreenway22ndAve,02/29/2016 08:00:00 AM,48,-122,6,3,9
18273,58thStGreenway22ndAve,02/29/2016 09:00:00 AM,48,-122,6,2,8
18274,58thStGreenway22ndAve,02/29/2016 10:00:00 AM,48,-122,3,4,7
18275,58thStGreenway22ndAve,02/29/2016 11:00:00 AM,48,-122,2,2,4
18276,58thStGreenway22ndAve,02/29/2016 12:00:00 PM,48,-122,4,10,14
18277,58thStGreenway22ndAve,02/29/2016 01:00:00 PM,48,-122,3,6,9
18278,58thStGreenway22ndAve,02/29/2016 02:00:00 PM,48,-122,10,3,13
18279,58thStGreenway22ndAve,02/29/2016 03:00:00 PM,48,-122,8,3,11
18280,58thStGreenway22ndAve,02/29/2016 04:00:00 PM,48,-122,13,2,15
18281,58thStGreenway22ndAve,02/29/2016 05:00:00 PM,48,-122,5,4,9
18282,58thStGreenway22ndAve,02/29/2016 06:00:00 PM,48,-122,6,8,14
18283,58thStGreenway22ndAve,02/29/2016 07:00:00 PM,48,-122,3,1,4
18284,58thStGreenway22ndAve,02/29/2016 08:00:00 PM,48,-122,4,1,5
18285,58thStGreenway22ndAve,02/29/2016 09:00:00 PM,48,-122,0,2,2
18286,58thStGreenway22ndAve,02/29/2016 10:00:00 PM,48,-122,1,0,1
18287,58thStGreenway22ndAve,02/29/2016 11:00:00 PM,48,-122,0,0,0
18288,58thStGreenway22ndAve,03/01/2016 12:00:00 AM,48,-122,0,0,0
18289,58thStGreenway22ndAve,03/01/2016 01:00:00 AM,48,-122,0,1,1
18290,58thStGreenway22ndAve,03/01/2016 02:00:00 AM,48,-122,1,1,2
18291,58thStGreenway22ndAve,03/01/2016 03:00:00 AM,48,-122,0,0,0
18292,58thStGreenway22ndAve,03/01/2016 04:00:00 AM,48,-122,0,0,0
18293,58thStGreenway22ndAve,03/01/2016 05:00:00 AM,48,-122,0,1,1
18294,58thStGreenway22ndAve,03/01/2016 06:00:00 AM,48,-122,0,1,1
18295,58thStGreenway22ndAve,03/01/2016 07:00:00 AM,48,-122,4,0,4
18296,58thStGreenway22ndAve,03/01/2016 08:00:00 AM,48,-122,3,1,4
18297,58thStGreenway22ndAve,03/01/2016 09:00:00 AM,48,-122,5,3,8
18298,58thStGreenway22ndAve,03/01/2016 10:00:00 AM,48,-122,0,5,5
18299,58thStGreenway22ndAve,03/01/2016 11:00:00 AM,48,-122,2,1,3
18300,58thStGreenway22ndAve,03/01/2016 12:00:00 PM,48,-122,0,4,4
18301,58thStGreenway22ndAve,03/01/2016 01:00:00 PM,48,-122,1,1,2
18302,58thStGreenway22ndAve,03/01/2016 02:00:00 PM,48,-122,1,0,1
18303,58thStGreenway22ndAve,03/01/2016 03:00:00 PM,48,-122,3,0,3
18304,58thStGreenway22ndAve,03/01/2016 04:00:00 PM,48,-122,3,1,4
18305,58thStGreenway22ndAve,03/01/2016 05:00:00 PM,48,-122,3,3,6
18306,58thStGreenway22ndAve,03/01/2016 06:00:00 PM,48,-122,3,0,3
18307,58thStGreenway22ndAve,03/01/2016 07:00:00 PM,48,-122,2,2,4
18308,58thStGreenway22ndAve,03/01/2016 08:00:00 PM,48,-122,2,2,4
18309,58thStGreenway22ndAve,03/01/2016 09:00:00 PM,48,-122,1,0,1
18310,58thStGreenway22ndAve,03/01/2016 10:00:00 PM,48,-122,2,2,4
18311,58thStGreenway22ndAve,03/01/2016 11:00:00 PM,48,-122,0,0,0
18312,58thStGreenway22ndAve,03/02/2016 12:00:00 AM,48,-122,0,0,0
18313,58thStGreenway22ndAve,03/02/2016 01:00:00 AM,48,-122,0,0,0
18314,58thStGreenway22ndAve,03/02/2016 02:00:00 AM,48,-122,0,0,0
18315,58thStGreenway22ndAve,03/02/2016 03:00:00 AM,48,-122,0,0,0
18316,58thStGreenway22ndAve,03/02/2016 04:00:00 AM,48,-122,0,0,0
18317,58thStGreenway22ndAve,03/02/2016 05:00:00 AM,48,-122,0,1,1
18318,58thStGreenway22ndAve,03/02/2016 06:00:00 AM,48,-122,0,3,3
18319,58thStGreenway22ndAve,03/02/2016 07:00:00 AM,48,-122,4,2,6
18320,58thStGreenway22ndAve,03/02/2016 08:00:00 AM,48,-122,3,5,8
18321,58thStGreenway22ndAve,03/02/2016 09:00:00 AM,48,-122,7,5,12
18322,58thStGreenway22ndAve,03/02/2016 10:00:00 AM,48,-122,2,2,4
18323,58thStGreenway22ndAve,03/02/2016 11:00:00 AM,48,-122,0,6,6
18324,58thStGreenway22ndAve,03/02/2016 12:00:00 PM,48,-122,5,6,11
18325,58thStGreenway22ndAve,03/02/2016 01:00:00 PM,48,-122,2,4,6
18326,58thStGreenway22ndAve,03/02/2016 02:00:00 PM,48,-122,1,5,6
18327,58thStGreenway22ndAve,03/02/2016 03:00:00 PM,48,-122,4,1,5
18328,58thStGreenway22ndAve,03/02/2016 04:00:00 PM,48,-122,8,5,13
18329,58thStGreenway22ndAve,03/02/2016 05:00:00 PM,48,-122,3,7,10
18330,58thStGreenway22ndAve,03/02/2016 06:00:00 PM,48,-122,2,2,4
18331,58thStGreenway22ndAve,03/02/2016 07:00:00 PM,48,-122,1,2,3
18332,58thStGreenway22ndAve,03/02/2016 08:00:00 PM,48,-122,0,3,3
18333,58thStGreenway22ndAve,03/02/2016 09:00:00 PM,48,-122,0,1,1
18334,58thStGreenway22ndAve,03/02/2016 10:00:00 PM,48,-122,0,0,0
18335,58thStGreenway22ndAve,03/02/2016 11:00:00 PM,48,-122,0,0,0
18336,58thStGreenway22ndAve,03/03/2016 12:00:00 AM,48,-122,0,0,0
18337,58thStGreenway22ndAve,03/03/2016 01:00:00 AM,48,-122,0,0,0
18338,58thStGreenway22ndAve,03/03/2016 02:00:00 AM,48,-122,0,0,0
18339,58thStGreenway22ndAve,03/03/2016 03:00:00 AM,48,-122,0,0,0
18340,58thStGreenway22ndAve,03/03/2016 04:00:00 AM,48,-122,0,0,0
18341,58thStGreenway22ndAve,03/03/2016 05:00:00 AM,48,-122,0,1,1
18342,58thStGreenway22ndAve,03/03/2016 06:00:00 AM,48,-122,0,3,3
18343,58thStGreenway22ndAve,03/03/2016 07:00:00 AM,48,-122,5,3,8
18344,58thStGreenway22ndAve,03/03/2016 08:00:00 AM,48,-122,4,3,7
18345,58thStGreenway22ndAve,03/03/2016 09:00:00 AM,48,-122,3,5,8
18346,58thStGreenway22ndAve,03/03/2016 10:00:00 AM,48,-122,0,3,3
18347,58thStGreenway22ndAve,03/03/2016 11:00:00 AM,48,-122,0,1,1
18348,58thStGreenway22ndAve,03/03/2016 12:00:00 PM,48,-122,1,1,2
18349,58thStGreenway22ndAve,03/03/2016 01:00:00 PM,48,-122,1,3,4
18350,58thStGreenway22ndAve,03/03/2016 02:00:00 PM,48,-122,0,0,0
18351,58thStGreenway22ndAve,03/03/2016 03:00:00 PM,48,-122,2,0,2
18352,58thStGreenway22ndAve,03/03/2016 04:00:00 PM,48,-122,9,1,10
18353,58thStGreenway22ndAve,03/03/2016 05:00:00 PM,48,-122,2,11,13
18354,58thStGreenway22ndAve,03/03/2016 06:00:00 PM,48,-122,2,3,5
18355,58thStGreenway22ndAve,03/03/2016 07:00:00 PM,48,-122,0,0,0
18356,58thStGreenway22ndAve,03/03/2016 08:00:00 PM,48,-122,1,3,4
18357,58thStGreenway22ndAve,03/03/2016 09:00:00 PM,48,-122,1,0,1
18358,58thStGreenway22ndAve,03/03/2016 10:00:00 PM,48,-122,0,1,1
18359,58thStGreenway22ndAve,03/03/2016 11:00:00 PM,48,-122,1,1,2
18360,58thStGreenway22ndAve,03/04/2016 12:00:00 AM,48,-122,3,0,3
18361,58thStGreenway22ndAve,03/04/2016 01:00:00 AM,48,-122,0,0,0
18362,58thStGreenway22ndAve,03/04/2016 02:00:00 AM,48,-122,0,0,0
18363,58thStGreenway22ndAve,03/04/2016 03:00:00 AM,48,-122,0,0,0
18364,58thStGreenway22ndAve,03/04/2016 04:00:00 AM,48,-122,0,0,0
18365,58thStGreenway22ndAve,03/04/2016 05:00:00 AM,48,-122,0,0,0
18366,58thStGreenway22ndAve,03/04/2016 06:00:00 AM,48,-122,3,1,4
18367,58thStGreenway22ndAve,03/04/2016 07:00:00 AM,48,-122,4,5,9
18368,58thStGreenway22ndAve,03/04/2016 08:00:00 AM,48,-122,2,4,6
18369,58thStGreenway22ndAve,03/04/2016 09:00:00 AM,48,-122,3,2,5
18370,58thStGreenway22ndAve,03/04/2016 10:00:00 AM,48,-122,1,3,4
18371,58thStGreenway22ndAve,03/04/2016 11:00:00 AM,48,-122,0,0,0
18372,58thStGreenway22ndAve,03/04/2016 12:00:00 PM,48,-122,4,5,9
18373,58thStGreenway22ndAve,03/04/2016 01:00:00 PM,48,-122,4,7,11
18374,58thStGreenway22ndAve,03/04/2016 02:00:00 PM,48,-122,3,2,5
18375,58thStGreenway22ndAve,03/04/2016 03:00:00 PM,48,-122,5,3,8
18376,58thStGreenway22ndAve,03/04/2016 04:00:00 PM,48,-122,1,2,3
18377,58thStGreenway22ndAve,03/04/2016 05:00:00 PM,48,-122,0,4,4
18378,58thStGreenway22ndAve,03/04/2016 06:00:00 PM,48,-122,0,4,4
18379,58thStGreenway22ndAve,03/04/2016 07:00:00 PM,48,-122,2,0,2
18380,58thStGreenway22ndAve,03/04/2016 08:00:00 PM,48,-122,3,3,6
18381,58thStGreenway22ndAve,03/04/2016 09:00:00 PM,48,-122,4,1,5
18382,58thStGreenway22ndAve,03/04/2016 10:00:00 PM,48,-122,1,0,1
18383,58thStGreenway22ndAve,03/04/2016 11:00:00 PM,48,-122,0,0,0
18384,58thStGreenway22ndAve,03/05/2016 12:00:00 AM,48,-122,0,1,1
18385,58thStGreenway22ndAve,03/05/2016 01:00:00 AM,48,-122,0,0,0
18386,58thStGreenway22ndAve,03/05/2016 02:00:00 AM,48,-122,0,1,1
18387,58thStGreenway22ndAve,03/05/2016 03:00:00 AM,48,-122,0,0,0
18388,58thStGreenway22ndAve,03/05/2016 04:00:00 AM,48,-122,1,0,1
18389,58thStGreenway22ndAve,03/05/2016 05:00:00 AM,48,-122,0,0,0
18390,58thStGreenway22ndAve,03/05/2016 06:00:00 AM,48,-122,0,0,0
18391,58thStGreenway22ndAve,03/05/2016 07:00:00 AM,48,-122,0,0,0
18392,58thStGreenway22ndAve,03/05/2016 08:00:00 AM,48,-122,0,0,0
18393,58thStGreenway22ndAve,03/05/2016 09:00:00 AM,48,-122,4,3,7
18394,58thStGreenway22ndAve,03/05/2016 10:00:00 AM,48,-122,2,10,12
18395,58thStGreenway22ndAve,03/05/2016 11:00:00 AM,48,-122,8,7,15
18396,58thStGreenway22ndAve,03/05/2016 12:00:00 PM,48,-122,2,6,8
18397,58thStGreenway22ndAve,03/05/2016 01:00:00 PM,48,-122,6,1,7
18398,58thStGreenway22ndAve,03/05/2016 02:00:00 PM,48,-122,6,7,13
18399,58thStGreenway22ndAve,03/05/2016 03:00:00 PM,48,-122,7,7,14
18400,58thStGreenway22ndAve,03/05/2016 04:00:00 PM,48,-122,5,7,12
18401,58thStGreenway22ndAve,03/05/2016 05:00:00 PM,48,-122,7,3,10
18402,58thStGreenway22ndAve,03/05/2016 06:00:00 PM,48,-122,0,1,1
18403,58thStGreenway22ndAve,03/05/2016 07:00:00 PM,48,-122,1,3,4
18404,58thStGreenway22ndAve,03/05/2016 08:00:00 PM,48,-122,0,0,0
18405,58thStGreenway22ndAve,03/05/2016 09:00:00 PM,48,-122,0,2,2
18406,58thStGreenway22ndAve,03/05/2016 10:00:00 PM,48,-122,1,1,2
18407,58thStGreenway22ndAve,03/05/2016 11:00:00 PM,48,-122,0,0,0
18408,58thStGreenway22ndAve,03/06/2016 12:00:00 AM,48,-122,0,1,1
18409,58thStGreenway22ndAve,03/06/2016 01:00:00 AM,48,-122,2,1,3
18410,58thStGreenway22ndAve,03/06/2016 02:00:00 AM,48,-122,0,0,0
18411,58thStGreenway22ndAve,03/06/2016 03:00:00 AM,48,-122,0,0,0
18412,58thStGreenway22ndAve,03/06/2016 04:00:00 AM,48,-122,0,0,0
18413,58thStGreenway22ndAve,03/06/2016 05:00:00 AM,48,-122,0,0,0
18414,58thStGreenway22ndAve,03/06/2016 06:00:00 AM,48,-122,0,1,1
18415,58thStGreenway22ndAve,03/06/2016 07:00:00 AM,48,-122,0,0,0
18416,58thStGreenway22ndAve,03/06/2016 08:00:00 AM,48,-122,0,0,0
18417,58thStGreenway22ndAve,03/06/2016 09:00:00 AM,48,-122,2,1,3
18418,58thStGreenway22ndAve,03/06/2016 10:00:00 AM,48,-122,3,3,6
18419,58thStGreenway22ndAve,03/06/2016 11:00:00 AM,48,-122,3,3,6
18420,58thStGreenway22ndAve,03/06/2016 12:00:00 PM,48,-122,3,1,4
18421,58thStGreenway22ndAve,03/06/2016 01:00:00 PM,48,-122,2,5,7
18422,58thStGreenway22ndAve,03/06/2016 02:00:00 PM,48,-122,3,3,6
18423,58thStGreenway22ndAve,03/06/2016 03:00:00 PM,48,-122,4,2,6
18424,58thStGreenway22ndAve,03/06/2016 04:00:00 PM,48,-122,3,3,6
18425,58thStGreenway22ndAve,03/06/2016 05:00:00 PM,48,-122,1,1,2
18426,58thStGreenway22ndAve,03/06/2016 06:00:00 PM,48,-122,1,2,3
18427,58thStGreenway22ndAve,03/06/2016 07:00:00 PM,48,-122,5,1,6
18428,58thStGreenway22ndAve,03/06/2016 08:00:00 PM,48,-122,1,0,1
18429,58thStGreenway22ndAve,03/06/2016 09:00:00 PM,48,-122,0,0,0
18430,58thStGreenway22ndAve,03/06/2016 10:00:00 PM,48,-122,3,1,4
18431,58thStGreenway22ndAve,03/06/2016 11:00:00 PM,48,-122,0,0,0
18432,58thStGreenway22ndAve,03/07/2016 12:00:00 AM,48,-122,0,0,0
18433,58thStGreenway22ndAve,03/07/2016 01:00:00 AM,48,-122,0,0,0
18434,58thStGreenway22ndAve,03/07/2016 02:00:00 AM,48,-122,0,0,0
18435,58thStGreenway22ndAve,03/07/2016 03:00:00 AM,48,-122,0,0,0
18436,58thStGreenway22ndAve,03/07/2016 04:00:00 AM,48,-122,0,0,0
18437,58thStGreenway22ndAve,03/07/2016 05:00:00 AM,48,-122,2,1,3
18438,58thStGreenway22ndAve,03/07/2016 06:00:00 AM,48,-122,0,2,2
18439,58thStGreenway22ndAve,03/07/2016 07:00:00 AM,48,-122,1,0,1
18440,58thStGreenway22ndAve,03/07/2016 08:00:00 AM,48,-122,5,4,9
18441,58thStGreenway22ndAve,03/07/2016 09:00:00 AM,48,-122,4,3,7
18442,58thStGreenway22ndAve,03/07/2016 10:00:00 AM,48,-122,0,0,0
18443,58thStGreenway22ndAve,03/07/2016 11:00:00 AM,48,-122,0,3,3
18444,58thStGreenway22ndAve,03/07/2016 12:00:00 PM,48,-122,3,1,4
18445,58thStGreenway22ndAve,03/07/2016 01:00:00 PM,48,-122,1,3,4
18446,58thStGreenway22ndAve,03/07/2016 02:00:00 PM,48,-122,3,2,5
18447,58thStGreenway22ndAve,03/07/2016 03:00:00 PM,48,-122,3,1,4
18448,58thStGreenway22ndAve,03/07/2016 04:00:00 PM,48,-122,2,4,6
18449,58thStGreenway22ndAve,03/07/2016 05:00:00 PM,48,-122,7,7,14
18450,58thStGreenway22ndAve,03/07/2016 06:00:00 PM,48,-122,4,4,8
18451,58thStGreenway22ndAve,03/07/2016 07:00:00 PM,48,-122,1,0,1
18452,58thStGreenway22ndAve,03/07/2016 08:00:00 PM,48,-122,0,1,1
18453,58thStGreenway22ndAve,03/07/2016 09:00:00 PM,48,-122,2,0,2
18454,58thStGreenway22ndAve,03/07/2016 10:00:00 PM,48,-122,0,0,0
18455,58thStGreenway22ndAve,03/07/2016 11:00:00 PM,48,-122,2,1,3
18456,58thStGreenway22ndAve,03/08/2016 12:00:00 AM,48,-122,0,0,0
18457,58thStGreenway22ndAve,03/08/2016 01:00:00 AM,48,-122,0,0,0
18458,58thStGreenway22ndAve,03/08/2016 02:00:00 AM,48,-122,0,0,0
18459,58thStGreenway22ndAve,03/08/2016 03:00:00 AM,48,-122,0,0,0
18460,58thStGreenway22ndAve,03/08/2016 04:00:00 AM,48,-122,0,0,0
18461,58thStGreenway22ndAve,03/08/2016 05:00:00 AM,48,-122,0,2,2
18462,58thStGreenway22ndAve,03/08/2016 06:00:00 AM,48,-122,0,3,3
18463,58thStGreenway22ndAve,03/08/2016 07:00:00 AM,48,-122,8,1,9
18464,58thStGreenway22ndAve,03/08/2016 08:00:00 AM,48,-122,5,7,12
18465,58thStGreenway22ndAve,03/08/2016 09:00:00 AM,48,-122,4,1,5
18466,58thStGreenway22ndAve,03/08/2016 10:00:00 AM,48,-122,1,6,7
18467,58thStGreenway22ndAve,03/08/2016 11:00:00 AM,48,-122,3,1,4
18468,58thStGreenway22ndAve,03/08/2016 12:00:00 PM,48,-122,1,3,4
18469,58thStGreenway22ndAve,03/08/2016 01:00:00 PM,48,-122,3,2,5
18470,58thStGreenway22ndAve,03/08/2016 02:00:00 PM,48,-122,11,1,12
18471,58thStGreenway22ndAve,03/08/2016 03:00:00 PM,48,-122,1,2,3
18472,58thStGreenway22ndAve,03/08/2016 04:00:00 PM,48,-122,2,2,4
18473,58thStGreenway22ndAve,03/08/2016 05:00:00 PM,48,-122,10,8,18
18474,58thStGreenway22ndAve,03/08/2016 06:00:00 PM,48,-122,5,1,6
18475,58thStGreenway22ndAve,03/08/2016 07:00:00 PM,48,-122,2,6,8
18476,58thStGreenway22ndAve,03/08/2016 08:00:00 PM,48,-122,1,0,1
18477,58thStGreenway22ndAve,03/08/2016 09:00:00 PM,48,-122,3,1,4
18478,58thStGreenway22ndAve,03/08/2016 10:00:00 PM,48,-122,1,1,2
18479,58thStGreenway22ndAve,03/08/2016 11:00:00 PM,48,-122,0,0,0
18480,58thStGreenway22ndAve,03/09/2016 12:00:00 AM,48,-122,0,0,0
18481,58thStGreenway22ndAve,03/09/2016 01:00:00 AM,48,-122,0,0,0
18482,58thStGreenway22ndAve,03/09/2016 02:00:00 AM,48,-122,0,0,0
18483,58thStGreenway22ndAve,03/09/2016 03:00:00 AM,48,-122,0,0,0
18484,58thStGreenway22ndAve,03/09/2016 04:00:00 AM,48,-122,0,0,0
18485,58thStGreenway22ndAve,03/09/2016 05:00:00 AM,48,-122,0,1,1
18486,58thStGreenway22ndAve,03/09/2016 06:00:00 AM,48,-122,2,3,5
18487,58thStGreenway22ndAve,03/09/2016 07:00:00 AM,48,-122,3,6,9
18488,58thStGreenway22ndAve,03/09/2016 08:00:00 AM,48,-122,2,6,8
18489,58thStGreenway22ndAve,03/09/2016 09:00:00 AM,48,-122,3,2,5
18490,58thStGreenway22ndAve,03/09/2016 10:00:00 AM,48,-122,0,2,2
18491,58thStGreenway22ndAve,03/09/2016 11:00:00 AM,48,-122,2,1,3
18492,58thStGreenway22ndAve,03/09/2016 12:00:00 PM,48,-122,6,2,8
18493,58thStGreenway22ndAve,03/09/2016 01:00:00 PM,48,-122,0,0,0
18494,58thStGreenway22ndAve,03/09/2016 02:00:00 PM,48,-122,0,0,0
18495,58thStGreenway22ndAve,03/09/2016 03:00:00 PM,48,-122,2,0,2
18496,58thStGreenway22ndAve,03/09/2016 04:00:00 PM,48,-122,2,2,4
18497,58thStGreenway22ndAve,03/09/2016 05:00:00 PM,48,-122,2,2,4
18498,58thStGreenway22ndAve,03/09/2016 06:00:00 PM,48,-122,2,2,4
18499,58thStGreenway22ndAve,03/09/2016 07:00:00 PM,48,-122,1,1,2
18500,58thStGreenway22ndAve,03/09/2016 08:00:00 PM,48,-122,0,0,0
18501,58thStGreenway22ndAve,03/09/2016 09:00:00 PM,48,-122,1,0,1
18502,58thStGreenway22ndAve,03/09/2016 10:00:00 PM,48,-122,0,0,0
18503,58thStGreenway22ndAve,03/09/2016 11:00:00 PM,48,-122,0,1,1
18504,58thStGreenway22ndAve,03/10/2016 12:00:00 AM,48,-122,1,0,1
18505,58thStGreenway22ndAve,03/10/2016 01:00:00 AM,48,-122,0,0,0
18506,58thStGreenway22ndAve,03/10/2016 02:00:00 AM,48,-122,0,0,0
18507,58thStGreenway22ndAve,03/10/2016 03:00:00 AM,48,-122,0,0,0
18508,58thStGreenway22ndAve,03/10/2016 04:00:00 AM,48,-122,0,0,0
18509,58thStGreenway22ndAve,03/10/2016 05:00:00 AM,48,-122,0,1,1
18510,58thStGreenway22ndAve,03/10/2016 06:00:00 AM,48,-122,0,0,0
18511,58thStGreenway22ndAve,03/10/2016 07:00:00 AM,48,-122,3,3,6
18512,58thStGreenway22ndAve,03/10/2016 08:00:00 AM,48,-122,3,1,4
18513,58thStGreenway22ndAve,03/10/2016 09:00:00 AM,48,-122,2,1,3
18514,58thStGreenway22ndAve,03/10/2016 10:00:00 AM,48,-122,0,2,2
18515,58thStGreenway22ndAve,03/10/2016 11:00:00 AM,48,-122,1,5,6
18516,58thStGreenway22ndAve,03/10/2016 12:00:00 PM,48,-122,4,0,4
18517,58thStGreenway22ndAve,03/10/2016 01:00:00 PM,48,-122,0,3,3
18518,58thStGreenway22ndAve,03/10/2016 02:00:00 PM,48,-122,2,1,3
18519,58thStGreenway22ndAve,03/10/2016 03:00:00 PM,48,-122,0,0,0
18520,58thStGreenway22ndAve,03/10/2016 04:00:00 PM,48,-122,5,0,5
18521,58thStGreenway22ndAve,03/10/2016 05:00:00 PM,48,-122,4,5,9
18522,58thStGreenway22ndAve,03/10/2016 06:00:00 PM,48,-122,7,5,12
18523,58thStGreenway22ndAve,03/10/2016 07:00:00 PM,48,-122,3,2,5
18524,58thStGreenway22ndAve,03/10/2016 08:00:00 PM,48,-122,0,1,1
18525,58thStGreenway22ndAve,03/10/2016 09:00:00 PM,48,-122,1,0,1
18526,58thStGreenway22ndAve,03/10/2016 10:00:00 PM,48,-122,2,0,2
18527,58thStGreenway22ndAve,03/10/2016 11:00:00 PM,48,-122,1,0,1
18528,58thStGreenway22ndAve,03/11/2016 12:00:00 AM,48,-122,0,0,0
18529,58thStGreenway22ndAve,03/11/2016 01:00:00 AM,48,-122,0,0,0
18530,58thStGreenway22ndAve,03/11/2016 02:00:00 AM,48,-122,0,0,0
18531,58thStGreenway22ndAve,03/11/2016 03:00:00 AM,48,-122,0,0,0
18532,58thStGreenway22ndAve,03/11/2016 04:00:00 AM,48,-122,0,0,0
18533,58thStGreenway22ndAve,03/11/2016 05:00:00 AM,48,-122,0,0,0
18534,58thStGreenway22ndAve,03/11/2016 06:00:00 AM,48,-122,0,3,3
18535,58thStGreenway22ndAve,03/11/2016 07:00:00 AM,48,-122,5,2,7
18536,58thStGreenway22ndAve,03/11/2016 08:00:00 AM,48,-122,5,5,10
18537,58thStGreenway22ndAve,03/11/2016 09:00:00 AM,48,-122,4,2,6
18538,58thStGreenway22ndAve,03/11/2016 10:00:00 AM,48,-122,3,2,5
18539,58thStGreenway22ndAve,03/11/2016 11:00:00 AM,48,-122,0,7,7
18540,58thStGreenway22ndAve,03/11/2016 12:00:00 PM,48,-122,4,2,6
18541,58thStGreenway22ndAve,03/11/2016 01:00:00 PM,48,-122,0,3,3
18542,58thStGreenway22ndAve,03/11/2016 02:00:00 PM,48,-122,6,0,6
18543,58thStGreenway22ndAve,03/11/2016 03:00:00 PM,48,-122,2,1,3
18544,58thStGreenway22ndAve,03/11/2016 04:00:00 PM,48,-122,3,4,7
18545,58thStGreenway22ndAve,03/11/2016 05:00:00 PM,48,-122,2,3,5
18546,58thStGreenway22ndAve,03/11/2016 06:00:00 PM,48,-122,4,3,7
18547,58thStGreenway22ndAve,03/11/2016 07:00:00 PM,48,-122,3,2,5
18548,58thStGreenway22ndAve,03/11/2016 08:00:00 PM,48,-122,0,2,2
18549,58thStGreenway22ndAve,03/11/2016 09:00:00 PM,48,-122,1,0,1
18550,58thStGreenway22ndAve,03/11/2016 10:00:00 PM,48,-122,0,1,1
18551,58thStGreenway22ndAve,03/11/2016 11:00:00 PM,48,-122,2,0,2
18552,58thStGreenway22ndAve,03/12/2016 12:00:00 AM,48,-122,0,0,0
18553,58thStGreenway22ndAve,03/12/2016 01:00:00 AM,48,-122,0,0,0
18554,58thStGreenway22ndAve,03/12/2016 02:00:00 AM,48,-122,0,0,0
18555,58thStGreenway22ndAve,03/12/2016 03:00:00 AM,48,-122,0,0,0
18556,58thStGreenway22ndAve,03/12/2016 04:00:00 AM,48,-122,0,0,0
18557,58thStGreenway22ndAve,03/12/2016 05:00:00 AM,48,-122,0,0,0
18558,58thStGreenway22ndAve,03/12/2016 06:00:00 AM,48,-122,0,2,2
18559,58thStGreenway22ndAve,03/12/2016 07:00:00 AM,48,-122,1,0,1
18560,58thStGreenway22ndAve,03/12/2016 08:00:00 AM,48,-122,1,0,1
18561,58thStGreenway22ndAve,03/12/2016 09:00:00 AM,48,-122,4,8,12
18562,58thStGreenway22ndAve,03/12/2016 10:00:00 AM,48,-122,4,0,4
18563,58thStGreenway22ndAve,03/12/2016 11:00:00 AM,48,-122,4,2,6
18564,58thStGreenway22ndAve,03/12/2016 12:00:00 PM,48,-122,2,3,5
18565,58thStGreenway22ndAve,03/12/2016 01:00:00 PM,48,-122,5,2,7
18566,58thStGreenway22ndAve,03/12/2016 02:00:00 PM,48,-122,1,2,3
18567,58thStGreenway22ndAve,03/12/2016 03:00:00 PM,48,-122,4,3,7
18568,58thStGreenway22ndAve,03/12/2016 04:00:00 PM,48,-122,5,0,5
18569,58thStGreenway22ndAve,03/12/2016 05:00:00 PM,48,-122,2,2,4
18570,58thStGreenway22ndAve,03/12/2016 06:00:00 PM,48,-122,2,0,2
18571,58thStGreenway22ndAve,03/12/2016 07:00:00 PM,48,-122,3,3,6
18572,58thStGreenway22ndAve,03/12/2016 08:00:00 PM,48,-122,0,0,0
18573,58thStGreenway22ndAve,03/12/2016 09:00:00 PM,48,-122,0,0,0
18574,58thStGreenway22ndAve,03/12/2016 10:00:00 PM,48,-122,0,0,0
18575,58thStGreenway22ndAve,03/12/2016 11:00:00 PM,48,-122,0,0,0
18576,58thStGreenway22ndAve,03/13/2016 12:00:00 AM,48,-122,0,0,0
18577,58thStGreenway22ndAve,03/13/2016 01:00:00 AM,48,-122,0,0,0
18578,58thStGreenway22ndAve,03/13/2016 03:00:00 AM,48,-122,,,
18579,58thStGreenway22ndAve,03/13/2016 03:00:00 AM,48,-122,0,0,0
18580,58thStGreenway22ndAve,03/13/2016 04:00:00 AM,48,-122,0,0,0
18581,58thStGreenway22ndAve,03/13/2016 05:00:00 AM,48,-122,0,0,0
18582,58thStGreenway22ndAve,03/13/2016 06:00:00 AM,48,-122,0,1,1
18583,58thStGreenway22ndAve,03/13/2016 07:00:00 AM,48,-122,0,2,2
18584,58thStGreenway22ndAve,03/13/2016 08:00:00 AM,48,-122,0,0,0
18585,58thStGreenway22ndAve,03/13/2016 09:00:00 AM,48,-122,0,1,1
18586,58thStGreenway22ndAve,03/13/2016 10:00:00 AM,48,-122,0,0,0
18587,58thStGreenway22ndAve,03/13/2016 11:00:00 AM,48,-122,0,2,2
18588,58thStGreenway22ndAve,03/13/2016 12:00:00 PM,48,-122,1,1,2
18589,58thStGreenway22ndAve,03/13/2016 01:00:00 PM,48,-122,2,3,5
18590,58thStGreenway22ndAve,03/13/2016 02:00:00 PM,48,-122,1,2,3
18591,58thStGreenway22ndAve,03/13/2016 03:00:00 PM,48,-122,0,1,1
18592,58thStGreenway22ndAve,03/13/2016 04:00:00 PM,48,-122,0,0,0
18593,58thStGreenway22ndAve,03/13/2016 05:00:00 PM,48,-122,2,0,2
18594,58thStGreenway22ndAve,03/13/2016 06:00:00 PM,48,-122,1,0,1
18595,58thStGreenway22ndAve,03/13/2016 07:00:00 PM,48,-122,2,1,3
18596,58thStGreenway22ndAve,03/13/2016 08:00:00 PM,48,-122,0,0,0
18597,58thStGreenway22ndAve,03/13/2016 09:00:00 PM,48,-122,2,0,2
18598,58thStGreenway22ndAve,03/13/2016 10:00:00 PM,48,-122,0,0,0
18599,58thStGreenway22ndAve,03/13/2016 11:00:00 PM,48,-122,0,0,0
18600,58thStGreenway22ndAve,03/14/2016 12:00:00 AM,48,-122,0,0,0
18601,58thStGreenway22ndAve,03/14/2016 01:00:00 AM,48,-122,0,0,0
18602,58thStGreenway22ndAve,03/14/2016 02:00:00 AM,48,-122,0,1,1
18603,58thStGreenway22ndAve,03/14/2016 03:00:00 AM,48,-122,0,0,0
18604,58thStGreenway22ndAve,03/14/2016 04:00:00 AM,48,-122,0,0,0
18605,58thStGreenway22ndAve,03/14/2016 05:00:00 AM,48,-122,0,1,1
18606,58thStGreenway22ndAve,03/14/2016 06:00:00 AM,48,-122,1,1,2
18607,58thStGreenway22ndAve,03/14/2016 07:00:00 AM,48,-122,2,2,4
18608,58thStGreenway22ndAve,03/14/2016 08:00:00 AM,48,-122,2,3,5
18609,58thStGreenway22ndAve,03/14/2016 09:00:00 AM,48,-122,3,2,5
18610,58thStGreenway22ndAve,03/14/2016 10:00:00 AM,48,-122,4,5,9
18611,58thStGreenway22ndAve,03/14/2016 11:00:00 AM,48,-122,1,2,3
18612,58thStGreenway22ndAve,03/14/2016 12:00:00 PM,48,-122,2,2,4
18613,58thStGreenway22ndAve,03/14/2016 01:00:00 PM,48,-122,2,3,5
18614,58thStGreenway22ndAve,03/14/2016 02:00:00 PM,48,-122,2,1,3
18615,58thStGreenway22ndAve,03/14/2016 03:00:00 PM,48,-122,5,5,10
18616,58thStGreenway22ndAve,03/14/2016 04:00:00 PM,48,-122,1,1,2
18617,58thStGreenway22ndAve,03/14/2016 05:00:00 PM,48,-122,3,9,12
18618,58thStGreenway22ndAve,03/14/2016 06:00:00 PM,48,-122,3,5,8
18619,58thStGreenway22ndAve,03/14/2016 07:00:00 PM,48,-122,4,8,12
18620,58thStGreenway22ndAve,03/14/2016 08:00:00 PM,48,-122,0,1,1
18621,58thStGreenway22ndAve,03/14/2016 09:00:00 PM,48,-122,1,0,1
18622,58thStGreenway22ndAve,03/14/2016 10:00:00 PM,48,-122,0,0,0
18623,58thStGreenway22ndAve,03/14/2016 11:00:00 PM,48,-122,0,0,0
18624,58thStGreenway22ndAve,03/15/2016 12:00:00 AM,48,-122,1,0,1
18625,58thStGreenway22ndAve,03/15/2016 01:00:00 AM,48,-122,0,0,0
18626,58thStGreenway22ndAve,03/15/2016 02:00:00 AM,48,-122,0,0,0
18627,58thStGreenway22ndAve,03/15/2016 03:00:00 AM,48,-122,0,0,0
18628,58thStGreenway22ndAve,03/15/2016 04:00:00 AM,48,-122,0,0,0
18629,58thStGreenway22ndAve,03/15/2016 05:00:00 AM,48,-122,0,1,1
18630,58thStGreenway22ndAve,03/15/2016 06:00:00 AM,48,-122,0,2,2
18631,58thStGreenway22ndAve,03/15/2016 07:00:00 AM,48,-122,4,3,7
18632,58thStGreenway22ndAve,03/15/2016 08:00:00 AM,48,-122,1,4,5
18633,58thStGreenway22ndAve,03/15/2016 09:00:00 AM,48,-122,4,0,4
18634,58thStGreenway22ndAve,03/15/2016 10:00:00 AM,48,-122,0,8,8
18635,58thStGreenway22ndAve,03/15/2016 11:00:00 AM,48,-122,9,1,10
18636,58thStGreenway22ndAve,03/15/2016 12:00:00 PM,48,-122,1,0,1
18637,58thStGreenway22ndAve,03/15/2016 01:00:00 PM,48,-122,4,5,9
18638,58thStGreenway22ndAve,03/15/2016 02:00:00 PM,48,-122,6,4,10
18639,58thStGreenway22ndAve,03/15/2016 03:00:00 PM,48,-122,3,1,4
18640,58thStGreenway22ndAve,03/15/2016 04:00:00 PM,48,-122,2,4,6
18641,58thStGreenway22ndAve,03/15/2016 05:00:00 PM,48,-122,7,7,14
18642,58thStGreenway22ndAve,03/15/2016 06:00:00 PM,48,-122,4,5,9
18643,58thStGreenway22ndAve,03/15/2016 07:00:00 PM,48,-122,4,3,7
18644,58thStGreenway22ndAve,03/15/2016 08:00:00 PM,48,-122,1,4,5
18645,58thStGreenway22ndAve,03/15/2016 09:00:00 PM,48,-122,3,3,6
18646,58thStGreenway22ndAve,03/15/2016 10:00:00 PM,48,-122,1,1,2
18647,58thStGreenway22ndAve,03/15/2016 11:00:00 PM,48,-122,0,0,0
18648,58thStGreenway22ndAve,03/16/2016 12:00:00 AM,48,-122,0,0,0
18649,58thStGreenway22ndAve,03/16/2016 01:00:00 AM,48,-122,0,0,0
18650,58thStGreenway22ndAve,03/16/2016 02:00:00 AM,48,-122,0,0,0
18651,58thStGreenway22ndAve,03/16/2016 03:00:00 AM,48,-122,0,0,0
18652,58thStGreenway22ndAve,03/16/2016 04:00:00 AM,48,-122,0,0,0
18653,58thStGreenway22ndAve,03/16/2016 05:00:00 AM,48,-122,2,1,3
18654,58thStGreenway22ndAve,03/16/2016 06:00:00 AM,48,-122,3,1,4
18655,58thStGreenway22ndAve,03/16/2016 07:00:00 AM,48,-122,3,4,7
18656,58thStGreenway22ndAve,03/16/2016 08:00:00 AM,48,-122,6,4,10
18657,58thStGreenway22ndAve,03/16/2016 09:00:00 AM,48,-122,7,2,9
18658,58thStGreenway22ndAve,03/16/2016 10:00:00 AM,48,-122,2,4,6
18659,58thStGreenway22ndAve,03/16/2016 11:00:00 AM,48,-122,1,2,3
18660,58thStGreenway22ndAve,03/16/2016 12:00:00 PM,48,-122,3,5,8
18661,58thStGreenway22ndAve,03/16/2016 01:00:00 PM,48,-122,1,1,2
18662,58thStGreenway22ndAve,03/16/2016 02:00:00 PM,48,-122,5,1,6
18663,58thStGreenway22ndAve,03/16/2016 03:00:00 PM,48,-122,4,3,7
18664,58thStGreenway22ndAve,03/16/2016 04:00:00 PM,48,-122,4,3,7
18665,58thStGreenway22ndAve,03/16/2016 05:00:00 PM,48,-122,5,8,13
18666,58thStGreenway22ndAve,03/16/2016 06:00:00 PM,48,-122,8,24,32
18667,58thStGreenway22ndAve,03/16/2016 07:00:00 PM,48,-122,10,7,17
18668,58thStGreenway22ndAve,03/16/2016 08:00:00 PM,48,-122,4,2,6
18669,58thStGreenway22ndAve,03/16/2016 09:00:00 PM,48,-122,1,0,1
18670,58thStGreenway22ndAve,03/16/2016 10:00:00 PM,48,-122,2,1,3
18671,58thStGreenway22ndAve,03/16/2016 11:00:00 PM,48,-122,0,0,0
18672,58thStGreenway22ndAve,03/17/2016 12:00:00 AM,48,-122,0,0,0
18673,58thStGreenway22ndAve,03/17/2016 01:00:00 AM,48,-122,0,2,2
18674,58thStGreenway22ndAve,03/17/2016 02:00:00 AM,48,-122,0,0,0
18675,58thStGreenway22ndAve,03/17/2016 03:00:00 AM,48,-122,0,0,0
18676,58thStGreenway22ndAve,03/17/2016 04:00:00 AM,48,-122,0,0,0
18677,58thStGreenway22ndAve,03/17/2016 05:00:00 AM,48,-122,0,1,1
18678,58thStGreenway22ndAve,03/17/2016 06:00:00 AM,48,-122,0,0,0
18679,58thStGreenway22ndAve,03/17/2016 07:00:00 AM,48,-122,3,3,6
18680,58thStGreenway22ndAve,03/17/2016 08:00:00 AM,48,-122,3,4,7
18681,58thStGreenway22ndAve,03/17/2016 09:00:00 AM,48,-122,3,1,4
18682,58thStGreenway22ndAve,03/17/2016 10:00:00 AM,48,-122,4,10,14
18683,58thStGreenway22ndAve,03/17/2016 11:00:00 AM,48,-122,3,2,5
18684,58thStGreenway22ndAve,03/17/2016 12:00:00 PM,48,-122,2,4,6
18685,58thStGreenway22ndAve,03/17/2016 01:00:00 PM,48,-122,2,2,4
18686,58thStGreenway22ndAve,03/17/2016 02:00:00 PM,48,-122,0,3,3
18687,58thStGreenway22ndAve,03/17/2016 03:00:00 PM,48,-122,5,4,9
18688,58thStGreenway22ndAve,03/17/2016 04:00:00 PM,48,-122,4,1,5
18689,58thStGreenway22ndAve,03/17/2016 05:00:00 PM,48,-122,8,5,13
18690,58thStGreenway22ndAve,03/17/2016 06:00:00 PM,48,-122,6,5,11
18691,58thStGreenway22ndAve,03/17/2016 07:00:00 PM,48,-122,4,1,5
18692,58thStGreenway22ndAve,03/17/2016 08:00:00 PM,48,-122,2,2,4
18693,58thStGreenway22ndAve,03/17/2016 09:00:00 PM,48,-122,0,0,0
18694,58thStGreenway22ndAve,03/17/2016 10:00:00 PM,48,-122,1,1,2
18695,58thStGreenway22ndAve,03/17/2016 11:00:00 PM,48,-122,0,1,1
18696,58thStGreenway22ndAve,03/18/2016 12:00:00 AM,48,-122,0,0,0
18697,58thStGreenway22ndAve,03/18/2016 01:00:00 AM,48,-122,0,0,0
18698,58thStGreenway22ndAve,03/18/2016 02:00:00 AM,48,-122,0,0,0
18699,58thStGreenway22ndAve,03/18/2016 03:00:00 AM,48,-122,0,0,0
18700,58thStGreenway22ndAve,03/18/2016 04:00:00 AM,48,-122,0,0,0
18701,58thStGreenway22ndAve,03/18/2016 05:00:00 AM,48,-122,0,0,0
18702,58thStGreenway22ndAve,03/18/2016 06:00:00 AM,48,-122,1,1,2
18703,58thStGreenway22ndAve,03/18/2016 07:00:00 AM,48,-122,2,1,3
18704,58thStGreenway22ndAve,03/18/2016 08:00:00 AM,48,-122,5,3,8
18705,58thStGreenway22ndAve,03/18/2016 09:00:00 AM,48,-122,5,5,10
18706,58thStGreenway22ndAve,03/18/2016 10:00:00 AM,48,-122,3,5,8
18707,58thStGreenway22ndAve,03/18/2016 11:00:00 AM,48,-122,3,2,5
18708,58thStGreenway22ndAve,03/18/2016 12:00:00 PM,48,-122,2,7,9
18709,58thStGreenway22ndAve,03/18/2016 01:00:00 PM,48,-122,4,4,8
18710,58thStGreenway22ndAve,03/18/2016 02:00:00 PM,48,-122,2,2,4
18711,58thStGreenway22ndAve,03/18/2016 03:00:00 PM,48,-122,4,6,10
18712,58thStGreenway22ndAve,03/18/2016 04:00:00 PM,48,-122,5,6,11
18713,58thStGreenway22ndAve,03/18/2016 05:00:00 PM,48,-122,3,4,7
18714,58thStGreenway22ndAve,03/18/2016 06:00:00 PM,48,-122,5,9,14
18715,58thStGreenway22ndAve,03/18/2016 07:00:00 PM,48,-122,8,5,13
18716,58thStGreenway22ndAve,03/18/2016 08:00:00 PM,48,-122,3,1,4
18717,58thStGreenway22ndAve,03/18/2016 09:00:00 PM,48,-122,1,3,4
18718,58thStGreenway22ndAve,03/18/2016 10:00:00 PM,48,-122,2,0,2
18719,58thStGreenway22ndAve,03/18/2016 11:00:00 PM,48,-122,2,1,3
18720,58thStGreenway22ndAve,03/19/2016 12:00:00 AM,48,-122,1,2,3
18721,58thStGreenway22ndAve,03/19/2016 01:00:00 AM,48,-122,1,0,1
18722,58thStGreenway22ndAve,03/19/2016 02:00:00 AM,48,-122,0,0,0
18723,58thStGreenway22ndAve,03/19/2016 03:00:00 AM,48,-122,0,0,0
18724,58thStGreenway22ndAve,03/19/2016 04:00:00 AM,48,-122,0,0,0
18725,58thStGreenway22ndAve,03/19/2016 05:00:00 AM,48,-122,0,0,0
18726,58thStGreenway22ndAve,03/19/2016 06:00:00 AM,48,-122,0,0,0
18727,58thStGreenway22ndAve,03/19/2016 07:00:00 AM,48,-122,0,1,1
18728,58thStGreenway22ndAve,03/19/2016 08:00:00 AM,48,-122,0,1,1
18729,58thStGreenway22ndAve,03/19/2016 09:00:00 AM,48,-122,2,2,4
18730,58thStGreenway22ndAve,03/19/2016 10:00:00 AM,48,-122,0,4,4
18731,58thStGreenway22ndAve,03/19/2016 11:00:00 AM,48,-122,4,4,8
18732,58thStGreenway22ndAve,03/19/2016 12:00:00 PM,48,-122,5,7,12
18733,58thStGreenway22ndAve,03/19/2016 01:00:00 PM,48,-122,4,2,6
18734,58thStGreenway22ndAve,03/19/2016 02:00:00 PM,48,-122,3,6,9
18735,58thStGreenway22ndAve,03/19/2016 03:00:00 PM,48,-122,6,4,10
18736,58thStGreenway22ndAve,03/19/2016 04:00:00 PM,48,-122,3,5,8
18737,58thStGreenway22ndAve,03/19/2016 05:00:00 PM,48,-122,2,2,4
18738,58thStGreenway22ndAve,03/19/2016 06:00:00 PM,48,-122,4,5,9
18739,58thStGreenway22ndAve,03/19/2016 07:00:00 PM,48,-122,0,0,0
18740,58thStGreenway22ndAve,03/19/2016 08:00:00 PM,48,-122,0,0,0
18741,58thStGreenway22ndAve,03/19/2016 09:00:00 PM,48,-122,0,0,0
18742,58thStGreenway22ndAve,03/19/2016 10:00:00 PM,48,-122,0,0,0
18743,58thStGreenway22ndAve,03/19/2016 11:00:00 PM,48,-122,2,0,2
18744,58thStGreenway22ndAve,03/20/2016 12:00:00 AM,48,-122,0,0,0
18745,58thStGreenway22ndAve,03/20/2016 01:00:00 AM,48,-122,2,0,2
18746,58thStGreenway22ndAve,03/20/2016 02:00:00 AM,48,-122,1,1,2
18747,58thStGreenway22ndAve,03/20/2016 03:00:00 AM,48,-122,0,0,0
18748,58thStGreenway22ndAve,03/20/2016 04:00:00 AM,48,-122,0,1,1
18749,58thStGreenway22ndAve,03/20/2016 05:00:00 AM,48,-122,1,0,1
18750,58thStGreenway22ndAve,03/20/2016 06:00:00 AM,48,-122,0,1,1
18751,58thStGreenway22ndAve,03/20/2016 07:00:00 AM,48,-122,0,0,0
18752,58thStGreenway22ndAve,03/20/2016 08:00:00 AM,48,-122,0,2,2
18753,58thStGreenway22ndAve,03/20/2016 09:00:00 AM,48,-122,1,1,2
18754,58thStGreenway22ndAve,03/20/2016 10:00:00 AM,48,-122,3,1,4
18755,58thStGreenway22ndAve,03/20/2016 11:00:00 AM,48,-122,2,3,5
18756,58thStGreenway22ndAve,03/20/2016 12:00:00 PM,48,-122,5,1,6
18757,58thStGreenway22ndAve,03/20/2016 01:00:00 PM,48,-122,2,2,4
18758,58thStGreenway22ndAve,03/20/2016 02:00:00 PM,48,-122,3,0,3
18759,58thStGreenway22ndAve,03/20/2016 03:00:00 PM,48,-122,2,3,5
18760,58thStGreenway22ndAve,03/20/2016 04:00:00 PM,48,-122,0,0,0
18761,58thStGreenway22ndAve,03/20/2016 05:00:00 PM,48,-122,3,2,5
18762,58thStGreenway22ndAve,03/20/2016 06:00:00 PM,48,-122,3,1,4
18763,58thStGreenway22ndAve,03/20/2016 07:00:00 PM,48,-122,1,1,2
18764,58thStGreenway22ndAve,03/20/2016 08:00:00 PM,48,-122,2,1,3
18765,58thStGreenway22ndAve,03/20/2016 09:00:00 PM,48,-122,0,1,1
18766,58thStGreenway22ndAve,03/20/2016 10:00:00 PM,48,-122,0,0,0
18767,58thStGreenway22ndAve,03/20/2016 11:00:00 PM,48,-122,0,0,0
18768,58thStGreenway22ndAve,03/21/2016 12:00:00 AM,48,-122,1,0,1
18769,58thStGreenway22ndAve,03/21/2016 01:00:00 AM,48,-122,0,0,0
18770,58thStGreenway22ndAve,03/21/2016 02:00:00 AM,48,-122,0,0,0
18771,58thStGreenway22ndAve,03/21/2016 03:00:00 AM,48,-122,0,0,0
18772,58thStGreenway22ndAve,03/21/2016 04:00:00 AM,48,-122,0,0,0
18773,58thStGreenway22ndAve,03/21/2016 05:00:00 AM,48,-122,0,1,1
18774,58thStGreenway22ndAve,03/21/2016 06:00:00 AM,48,-122,0,2,2
18775,58thStGreenway22ndAve,03/21/2016 07:00:00 AM,48,-122,2,0,2
18776,58thStGreenway22ndAve,03/21/2016 08:00:00 AM,48,-122,0,5,5
18777,58thStGreenway22ndAve,03/21/2016 09:00:00 AM,48,-122,4,3,7
18778,58thStGreenway22ndAve,03/21/2016 10:00:00 AM,48,-122,3,0,3
18779,58thStGreenway22ndAve,03/21/2016 11:00:00 AM,48,-122,0,3,3
18780,58thStGreenway22ndAve,03/21/2016 12:00:00 PM,48,-122,1,2,3
18781,58thStGreenway22ndAve,03/21/2016 01:00:00 PM,48,-122,1,0,1
18782,58thStGreenway22ndAve,03/21/2016 02:00:00 PM,48,-122,1,0,1
18783,58thStGreenway22ndAve,03/21/2016 03:00:00 PM,48,-122,2,1,3
18784,58thStGreenway22ndAve,03/21/2016 04:00:00 PM,48,-122,3,1,4
18785,58thStGreenway22ndAve,03/21/2016 05:00:00 PM,48,-122,3,6,9
18786,58thStGreenway22ndAve,03/21/2016 06:00:00 PM,48,-122,3,4,7
18787,58thStGreenway22ndAve,03/21/2016 07:00:00 PM,48,-122,1,3,4
18788,58thStGreenway22ndAve,03/21/2016 08:00:00 PM,48,-122,0,1,1
18789,58thStGreenway22ndAve,03/21/2016 09:00:00 PM,48,-122,0,4,4
18790,58thStGreenway22ndAve,03/21/2016 10:00:00 PM,48,-122,0,0,0
18791,58thStGreenway22ndAve,03/21/2016 11:00:00 PM,48,-122,0,0,0
18792,58thStGreenway22ndAve,03/22/2016 12:00:00 AM,48,-122,0,0,0
18793,58thStGreenway22ndAve,03/22/2016 01:00:00 AM,48,-122,1,0,1
18794,58thStGreenway22ndAve,03/22/2016 02:00:00 AM,48,-122,1,0,1
18795,58thStGreenway22ndAve,03/22/2016 03:00:00 AM,48,-122,0,0,0
18796,58thStGreenway22ndAve,03/22/2016 04:00:00 AM,48,-122,0,0,0
18797,58thStGreenway22ndAve,03/22/2016 05:00:00 AM,48,-122,0,1,1
18798,58thStGreenway22ndAve,03/22/2016 06:00:00 AM,48,-122,0,1,1
18799,58thStGreenway22ndAve,03/22/2016 07:00:00 AM,48,-122,3,1,4
18800,58thStGreenway22ndAve,03/22/2016 08:00:00 AM,48,-122,4,3,7
18801,58thStGreenway22ndAve,03/22/2016 09:00:00 AM,48,-122,3,1,4
18802,58thStGreenway22ndAve,03/22/2016 10:00:00 AM,48,-122,1,5,6
18803,58thStGreenway22ndAve,03/22/2016 11:00:00 AM,48,-122,4,5,9
18804,58thStGreenway22ndAve,03/22/2016 12:00:00 PM,48,-122,9,5,14
18805,58thStGreenway22ndAve,03/22/2016 01:00:00 PM,48,-122,5,5,10
18806,58thStGreenway22ndAve,03/22/2016 02:00:00 PM,48,-122,4,6,10
18807,58thStGreenway22ndAve,03/22/2016 03:00:00 PM,48,-122,5,2,7
18808,58thStGreenway22ndAve,03/22/2016 04:00:00 PM,48,-122,12,2,14
18809,58thStGreenway22ndAve,03/22/2016 05:00:00 PM,48,-122,9,6,15
18810,58thStGreenway22ndAve,03/22/2016 06:00:00 PM,48,-122,7,2,9
18811,58thStGreenway22ndAve,03/22/2016 07:00:00 PM,48,-122,1,2,3
18812,58thStGreenway22ndAve,03/22/2016 08:00:00 PM,48,-122,2,2,4
18813,58thStGreenway22ndAve,03/22/2016 09:00:00 PM,48,-122,2,0,2
18814,58thStGreenway22ndAve,03/22/2016 10:00:00 PM,48,-122,1,2,3
18815,58thStGreenway22ndAve,03/22/2016 11:00:00 PM,48,-122,1,2,3
18816,58thStGreenway22ndAve,03/23/2016 12:00:00 AM,48,-122,0,0,0
18817,58thStGreenway22ndAve,03/23/2016 01:00:00 AM,48,-122,0,0,0
18818,58thStGreenway22ndAve,03/23/2016 02:00:00 AM,48,-122,0,0,0
18819,58thStGreenway22ndAve,03/23/2016 03:00:00 AM,48,-122,0,0,0
18820,58thStGreenway22ndAve,03/23/2016 04:00:00 AM,48,-122,0,0,0
18821,58thStGreenway22ndAve,03/23/2016 05:00:00 AM,48,-122,0,1,1
18822,58thStGreenway22ndAve,03/23/2016 06:00:00 AM,48,-122,1,1,2
18823,58thStGreenway22ndAve,03/23/2016 07:00:00 AM,48,-122,3,2,5
18824,58thStGreenway22ndAve,03/23/2016 08:00:00 AM,48,-122,6,5,11
18825,58thStGreenway22ndAve,03/23/2016 09:00:00 AM,48,-122,1,5,6
18826,58thStGreenway22ndAve,03/23/2016 10:00:00 AM,48,-122,3,2,5
18827,58thStGreenway22ndAve,03/23/2016 11:00:00 AM,48,-122,1,1,2
18828,58thStGreenway22ndAve,03/23/2016 12:00:00 PM,48,-122,1,2,3
18829,58thStGreenway22ndAve,03/23/2016 01:00:00 PM,48,-122,2,4,6
18830,58thStGreenway22ndAve,03/23/2016 02:00:00 PM,48,-122,0,0,0
18831,58thStGreenway22ndAve,03/23/2016 03:00:00 PM,48,-122,3,0,3
18832,58thStGreenway22ndAve,03/23/2016 04:00:00 PM,48,-122,2,1,3
18833,58thStGreenway22ndAve,03/23/2016 05:00:00 PM,48,-122,4,3,7
18834,58thStGreenway22ndAve,03/23/2016 06:00:00 PM,48,-122,5,3,8
18835,58thStGreenway22ndAve,03/23/2016 07:00:00 PM,48,-122,2,3,5
18836,58thStGreenway22ndAve,03/23/2016 08:00:00 PM,48,-122,2,2,4
18837,58thStGreenway22ndAve,03/23/2016 09:00:00 PM,48,-122,1,1,2
18838,58thStGreenway22ndAve,03/23/2016 10:00:00 PM,48,-122,2,0,2
18839,58thStGreenway22ndAve,03/23/2016 11:00:00 PM,48,-122,1,0,1
18840,58thStGreenway22ndAve,03/24/2016 12:00:00 AM,48,-122,0,0,0
18841,58thStGreenway22ndAve,03/24/2016 01:00:00 AM,48,-122,0,1,1
18842,58thStGreenway22ndAve,03/24/2016 02:00:00 AM,48,-122,0,1,1
18843,58thStGreenway22ndAve,03/24/2016 03:00:00 AM,48,-122,0,0,0
18844,58thStGreenway22ndAve,03/24/2016 04:00:00 AM,48,-122,0,0,0
18845,58thStGreenway22ndAve,03/24/2016 05:00:00 AM,48,-122,0,1,1
18846,58thStGreenway22ndAve,03/24/2016 06:00:00 AM,48,-122,0,1,1
18847,58thStGreenway22ndAve,03/24/2016 07:00:00 AM,48,-122,4,3,7
18848,58thStGreenway22ndAve,03/24/2016 08:00:00 AM,48,-122,5,3,8
18849,58thStGreenway22ndAve,03/24/2016 09:00:00 AM,48,-122,4,0,4
18850,58thStGreenway22ndAve,03/24/2016 10:00:00 AM,48,-122,1,3,4
18851,58thStGreenway22ndAve,03/24/2016 11:00:00 AM,48,-122,2,3,5
18852,58thStGreenway22ndAve,03/24/2016 12:00:00 PM,48,-122,4,0,4
18853,58thStGreenway22ndAve,03/24/2016 01:00:00 PM,48,-122,5,4,9
18854,58thStGreenway22ndAve,03/24/2016 02:00:00 PM,48,-122,2,4,6
18855,58thStGreenway22ndAve,03/24/2016 03:00:00 PM,48,-122,3,1,4
18856,58thStGreenway22ndAve,03/24/2016 04:00:00 PM,48,-122,3,2,5
18857,58thStGreenway22ndAve,03/24/2016 05:00:00 PM,48,-122,3,6,9
18858,58thStGreenway22ndAve,03/24/2016 06:00:00 PM,48,-122,5,4,9
18859,58thStGreenway22ndAve,03/24/2016 07:00:00 PM,48,-122,3,3,6
18860,58thStGreenway22ndAve,03/24/2016 08:00:00 PM,48,-122,1,3,4
18861,58thStGreenway22ndAve,03/24/2016 09:00:00 PM,48,-122,2,1,3
18862,58thStGreenway22ndAve,03/24/2016 10:00:00 PM,48,-122,0,1,1
18863,58thStGreenway22ndAve,03/24/2016 11:00:00 PM,48,-122,0,0,0
18864,58thStGreenway22ndAve,03/25/2016 12:00:00 AM,48,-122,0,1,1
18865,58thStGreenway22ndAve,03/25/2016 01:00:00 AM,48,-122,0,1,1
18866,58thStGreenway22ndAve,03/25/2016 02:00:00 AM,48,-122,0,1,1
18867,58thStGreenway22ndAve,03/25/2016 03:00:00 AM,48,-122,0,0,0
18868,58thStGreenway22ndAve,03/25/2016 04:00:00 AM,48,-122,0,0,0
18869,58thStGreenway22ndAve,03/25/2016 05:00:00 AM,48,-122,0,0,0
18870,58thStGreenway22ndAve,03/25/2016 06:00:00 AM,48,-122,0,1,1
18871,58thStGreenway22ndAve,03/25/2016 07:00:00 AM,48,-122,5,3,8
18872,58thStGreenway22ndAve,03/25/2016 08:00:00 AM,48,-122,5,3,8
18873,58thStGreenway22ndAve,03/25/2016 09:00:00 AM,48,-122,1,2,3
18874,58thStGreenway22ndAve,03/25/2016 10:00:00 AM,48,-122,1,2,3
18875,58thStGreenway22ndAve,03/25/2016 11:00:00 AM,48,-122,5,3,8
18876,58thStGreenway22ndAve,03/25/2016 12:00:00 PM,48,-122,6,3,9
18877,58thStGreenway22ndAve,03/25/2016 01:00:00 PM,48,-122,5,5,10
18878,58thStGreenway22ndAve,03/25/2016 02:00:00 PM,48,-122,6,5,11
18879,58thStGreenway22ndAve,03/25/2016 03:00:00 PM,48,-122,8,6,14
18880,58thStGreenway22ndAve,03/25/2016 04:00:00 PM,48,-122,5,7,12
18881,58thStGreenway22ndAve,03/25/2016 05:00:00 PM,48,-122,7,11,18
18882,58thStGreenway22ndAve,03/25/2016 06:00:00 PM,48,-122,6,6,12
18883,58thStGreenway22ndAve,03/25/2016 07:00:00 PM,48,-122,3,3,6
18884,58thStGreenway22ndAve,03/25/2016 08:00:00 PM,48,-122,4,0,4
18885,58thStGreenway22ndAve,03/25/2016 09:00:00 PM,48,-122,1,3,4
18886,58thStGreenway22ndAve,03/25/2016 10:00:00 PM,48,-122,2,0,2
18887,58thStGreenway22ndAve,03/25/2016 11:00:00 PM,48,-122,0,0,0
18888,58thStGreenway22ndAve,03/26/2016 12:00:00 AM,48,-122,0,0,0
18889,58thStGreenway22ndAve,03/26/2016 01:00:00 AM,48,-122,0,0,0
18890,58thStGreenway22ndAve,03/26/2016 02:00:00 AM,48,-122,0,1,1
18891,58thStGreenway22ndAve,03/26/2016 03:00:00 AM,48,-122,0,0,0
18892,58thStGreenway22ndAve,03/26/2016 04:00:00 AM,48,-122,0,0,0
18893,58thStGreenway22ndAve,03/26/2016 05:00:00 AM,48,-122,0,0,0
18894,58thStGreenway22ndAve,03/26/2016 06:00:00 AM,48,-122,0,1,1
18895,58thStGreenway22ndAve,03/26/2016 07:00:00 AM,48,-122,1,2,3
18896,58thStGreenway22ndAve,03/26/2016 08:00:00 AM,48,-122,1,3,4
18897,58thStGreenway22ndAve,03/26/2016 09:00:00 AM,48,-122,3,5,8
18898,58thStGreenway22ndAve,03/26/2016 10:00:00 AM,48,-122,2,43,45
18899,58thStGreenway22ndAve,03/26/2016 11:00:00 AM,48,-122,8,3,11
18900,58thStGreenway22ndAve,03/26/2016 12:00:00 PM,48,-122,4,11,15
18901,58thStGreenway22ndAve,03/26/2016 01:00:00 PM,48,-122,13,8,21
18902,58thStGreenway22ndAve,03/26/2016 02:00:00 PM,48,-122,6,11,17
18903,58thStGreenway22ndAve,03/26/2016 03:00:00 PM,48,-122,9,12,21
18904,58thStGreenway22ndAve,03/26/2016 04:00:00 PM,48,-122,5,13,18
18905,58thStGreenway22ndAve,03/26/2016 05:00:00 PM,48,-122,12,2,14
18906,58thStGreenway22ndAve,03/26/2016 06:00:00 PM,48,-122,2,2,4
18907,58thStGreenway22ndAve,03/26/2016 07:00:00 PM,48,-122,3,0,3
18908,58thStGreenway22ndAve,03/26/2016 08:00:00 PM,48,-122,1,3,4
18909,58thStGreenway22ndAve,03/26/2016 09:00:00 PM,48,-122,2,2,4
18910,58thStGreenway22ndAve,03/26/2016 10:00:00 PM,48,-122,0,0,0
18911,58thStGreenway22ndAve,03/26/2016 11:00:00 PM,48,-122,0,0,0
18912,58thStGreenway22ndAve,03/27/2016 12:00:00 AM,48,-122,1,0,1
18913,58thStGreenway22ndAve,03/27/2016 01:00:00 AM,48,-122,0,0,0
18914,58thStGreenway22ndAve,03/27/2016 02:00:00 AM,48,-122,0,0,0
18915,58thStGreenway22ndAve,03/27/2016 03:00:00 AM,48,-122,0,0,0
18916,58thStGreenway22ndAve,03/27/2016 04:00:00 AM,48,-122,2,0,2
18917,58thStGreenway22ndAve,03/27/2016 05:00:00 AM,48,-122,0,0,0
18918,58thStGreenway22ndAve,03/27/2016 06:00:00 AM,48,-122,0,1,1
18919,58thStGreenway22ndAve,03/27/2016 07:00:00 AM,48,-122,0,0,0
18920,58thStGreenway22ndAve,03/27/2016 08:00:00 AM,48,-122,0,1,1
18921,58thStGreenway22ndAve,03/27/2016 09:00:00 AM,48,-122,4,0,4
18922,58thStGreenway22ndAve,03/27/2016 10:00:00 AM,48,-122,1,0,1
18923,58thStGreenway22ndAve,03/27/2016 11:00:00 AM,48,-122,0,2,2
18924,58thStGreenway22ndAve,03/27/2016 12:00:00 PM,48,-122,0,2,2
18925,58thStGreenway22ndAve,03/27/2016 01:00:00 PM,48,-122,2,4,6
18926,58thStGreenway22ndAve,03/27/2016 02:00:00 PM,48,-122,3,1,4
18927,58thStGreenway22ndAve,03/27/2016 03:00:00 PM,48,-122,4,5,9
18928,58thStGreenway22ndAve,03/27/2016 04:00:00 PM,48,-122,4,2,6
18929,58thStGreenway22ndAve,03/27/2016 05:00:00 PM,48,-122,0,1,1
18930,58thStGreenway22ndAve,03/27/2016 06:00:00 PM,48,-122,2,1,3
18931,58thStGreenway22ndAve,03/27/2016 07:00:00 PM,48,-122,0,0,0
18932,58thStGreenway22ndAve,03/27/2016 08:00:00 PM,48,-122,1,0,1
18933,58thStGreenway22ndAve,03/27/2016 09:00:00 PM,48,-122,0,1,1
18934,58thStGreenway22ndAve,03/27/2016 10:00:00 PM,48,-122,0,1,1
18935,58thStGreenway22ndAve,03/27/2016 11:00:00 PM,48,-122,1,1,2
18936,58thStGreenway22ndAve,03/28/2016 12:00:00 AM,48,-122,0,0,0
18937,58thStGreenway22ndAve,03/28/2016 01:00:00 AM,48,-122,0,0,0
18938,58thStGreenway22ndAve,03/28/2016 02:00:00 AM,48,-122,0,0,0
18939,58thStGreenway22ndAve,03/28/2016 03:00:00 AM,48,-122,0,0,0
18940,58thStGreenway22ndAve,03/28/2016 04:00:00 AM,48,-122,1,0,1
18941,58thStGreenway22ndAve,03/28/2016 05:00:00 AM,48,-122,0,2,2
18942,58thStGreenway22ndAve,03/28/2016 06:00:00 AM,48,-122,2,1,3
18943,58thStGreenway22ndAve,03/28/2016 07:00:00 AM,48,-122,2,2,4
18944,58thStGreenway22ndAve,03/28/2016 08:00:00 AM,48,-122,4,4,8
18945,58thStGreenway22ndAve,03/28/2016 09:00:00 AM,48,-122,5,9,14
18946,58thStGreenway22ndAve,03/28/2016 10:00:00 AM,48,-122,4,3,7
18947,58thStGreenway22ndAve,03/28/2016 11:00:00 AM,48,-122,0,2,2
18948,58thStGreenway22ndAve,03/28/2016 12:00:00 PM,48,-122,3,3,6
18949,58thStGreenway22ndAve,03/28/2016 01:00:00 PM,48,-122,6,1,7
18950,58thStGreenway22ndAve,03/28/2016 02:00:00 PM,48,-122,4,2,6
18951,58thStGreenway22ndAve,03/28/2016 03:00:00 PM,48,-122,4,1,5
18952,58thStGreenway22ndAve,03/28/2016 04:00:00 PM,48,-122,4,7,11
18953,58thStGreenway22ndAve,03/28/2016 05:00:00 PM,48,-122,7,8,15
18954,58thStGreenway22ndAve,03/28/2016 06:00:00 PM,48,-122,9,9,18
18955,58thStGreenway22ndAve,03/28/2016 07:00:00 PM,48,-122,3,5,8
18956,58thStGreenway22ndAve,03/28/2016 08:00:00 PM,48,-122,6,3,9
18957,58thStGreenway22ndAve,03/28/2016 09:00:00 PM,48,-122,1,1,2
18958,58thStGreenway22ndAve,03/28/2016 10:00:00 PM,48,-122,2,0,2
18959,58thStGreenway22ndAve,03/28/2016 11:00:00 PM,48,-122,1,0,1
18960,58thStGreenway22ndAve,03/29/2016 12:00:00 AM,48,-122,0,0,0
18961,58thStGreenway22ndAve,03/29/2016 01:00:00 AM,48,-122,0,0,0
18962,58thStGreenway22ndAve,03/29/2016 02:00:00 AM,48,-122,0,1,1
18963,58thStGreenway22ndAve,03/29/2016 03:00:00 AM,48,-122,0,0,0
18964,58thStGreenway22ndAve,03/29/2016 04:00:00 AM,48,-122,1,0,1
18965,58thStGreenway22ndAve,03/29/2016 05:00:00 AM,48,-122,0,1,1
18966,58thStGreenway22ndAve,03/29/2016 06:00:00 AM,48,-122,0,1,1
18967,58thStGreenway22ndAve,03/29/2016 07:00:00 AM,48,-122,2,5,7
18968,58thStGreenway22ndAve,03/29/2016 08:00:00 AM,48,-122,4,6,10
18969,58thStGreenway22ndAve,03/29/2016 09:00:00 AM,48,-122,8,7,15
18970,58thStGreenway22ndAve,03/29/2016 10:00:00 AM,48,-122,5,5,10
18971,58thStGreenway22ndAve,03/29/2016 11:00:00 AM,48,-122,4,4,8
18972,58thStGreenway22ndAve,03/29/2016 12:00:00 PM,48,-122,4,6,10
18973,58thStGreenway22ndAve,03/29/2016 01:00:00 PM,48,-122,5,2,7
18974,58thStGreenway22ndAve,03/29/2016 02:00:00 PM,48,-122,10,5,15
18975,58thStGreenway22ndAve,03/29/2016 03:00:00 PM,48,-122,3,6,9
18976,58thStGreenway22ndAve,03/29/2016 04:00:00 PM,48,-122,7,7,14
18977,58thStGreenway22ndAve,03/29/2016 05:00:00 PM,48,-122,9,10,19
18978,58thStGreenway22ndAve,03/29/2016 06:00:00 PM,48,-122,5,4,9
18979,58thStGreenway22ndAve,03/29/2016 07:00:00 PM,48,-122,7,4,11
18980,58thStGreenway22ndAve,03/29/2016 08:00:00 PM,48,-122,1,4,5
18981,58thStGreenway22ndAve,03/29/2016 09:00:00 PM,48,-122,4,1,5
18982,58thStGreenway22ndAve,03/29/2016 10:00:00 PM,48,-122,3,1,4
18983,58thStGreenway22ndAve,03/29/2016 11:00:00 PM,48,-122,2,0,2
18984,58thStGreenway22ndAve,03/30/2016 12:00:00 AM,48,-122,2,0,2
18985,58thStGreenway22ndAve,03/30/2016 01:00:00 AM,48,-122,0,2,2
18986,58thStGreenway22ndAve,03/30/2016 02:00:00 AM,48,-122,0,0,0
18987,58thStGreenway22ndAve,03/30/2016 03:00:00 AM,48,-122,0,0,0
18988,58thStGreenway22ndAve,03/30/2016 04:00:00 AM,48,-122,0,0,0
18989,58thStGreenway22ndAve,03/30/2016 05:00:00 AM,48,-122,0,2,2
18990,58thStGreenway22ndAve,03/30/2016 06:00:00 AM,48,-122,0,2,2
18991,58thStGreenway22ndAve,03/30/2016 07:00:00 AM,48,-122,4,5,9
18992,58thStGreenway22ndAve,03/30/2016 08:00:00 AM,48,-122,2,5,7
18993,58thStGreenway22ndAve,03/30/2016 09:00:00 AM,48,-122,7,7,14
18994,58thStGreenway22ndAve,03/30/2016 10:00:00 AM,48,-122,4,0,4
18995,58thStGreenway22ndAve,03/30/2016 11:00:00 AM,48,-122,4,3,7
18996,58thStGreenway22ndAve,03/30/2016 12:00:00 PM,48,-122,2,10,12
18997,58thStGreenway22ndAve,03/30/2016 01:00:00 PM,48,-122,6,3,9
18998,58thStGreenway22ndAve,03/30/2016 02:00:00 PM,48,-122,8,10,18
18999,58thStGreenway22ndAve,03/30/2016 03:00:00 PM,48,-122,4,1,5
19000,58thStGreenway22ndAve,03/30/2016 04:00:00 PM,48,-122,11,7,18
19001,58thStGreenway22ndAve,03/30/2016 05:00:00 PM,48,-122,16,11,27
19002,58thStGreenway22ndAve,03/30/2016 06:00:00 PM,48,-122,7,12,19
19003,58thStGreenway22ndAve,03/30/2016 07:00:00 PM,48,-122,7,8,15
19004,58thStGreenway22ndAve,03/30/2016 08:00:00 PM,48,-122,10,2,12
19005,58thStGreenway22ndAve,03/30/2016 09:00:00 PM,48,-122,3,1,4
19006,58thStGreenway22ndAve,03/30/2016 10:00:00 PM,48,-122,5,0,5
19007,58thStGreenway22ndAve,03/30/2016 11:00:00 PM,48,-122,0,1,1
19008,58thStGreenway22ndAve,03/31/2016 12:00:00 AM,48,-122,0,3,3
19009,58thStGreenway22ndAve,03/31/2016 01:00:00 AM,48,-122,0,0,0
19010,58thStGreenway22ndAve,03/31/2016 02:00:00 AM,48,-122,0,0,0
19011,58thStGreenway22ndAve,03/31/2016 03:00:00 AM,48,-122,0,0,0
19012,58thStGreenway22ndAve,03/31/2016 04:00:00 AM,48,-122,0,0,0
19013,58thStGreenway22ndAve,03/31/2016 05:00:00 AM,48,-122,0,1,1
19014,58thStGreenway22ndAve,03/31/2016 06:00:00 AM,48,-122,0,0,0
19015,58thStGreenway22ndAve,03/31/2016 07:00:00 AM,48,-122,4,3,7
19016,58thStGreenway22ndAve,03/31/2016 08:00:00 AM,48,-122,5,4,9
19017,58thStGreenway22ndAve,03/31/2016 09:00:00 AM,48,-122,5,4,9
19018,58thStGreenway22ndAve,03/31/2016 10:00:00 AM,48,-122,3,4,7
19019,58thStGreenway22ndAve,03/31/2016 11:00:00 AM,48,-122,6,5,11
19020,58thStGreenway22ndAve,03/31/2016 12:00:00 PM,48,-122,5,4,9
19021,58thStGreenway22ndAve,03/31/2016 01:00:00 PM,48,-122,4,6,10
19022,58thStGreenway22ndAve,03/31/2016 02:00:00 PM,48,-122,7,5,12
19023,58thStGreenway22ndAve,03/31/2016 03:00:00 PM,48,-122,10,7,17
19024,58thStGreenway22ndAve,03/31/2016 04:00:00 PM,48,-122,17,10,27
19025,58thStGreenway22ndAve,03/31/2016 05:00:00 PM,48,-122,15,8,23
19026,58thStGreenway22ndAve,03/31/2016 06:00:00 PM,48,-122,6,9,15
19027,58thStGreenway22ndAve,03/31/2016 07:00:00 PM,48,-122,5,6,11
19028,58thStGreenway22ndAve,03/31/2016 08:00:00 PM,48,-122,4,2,6
19029,58thStGreenway22ndAve,03/31/2016 09:00:00 PM,48,-122,1,3,4
19030,58thStGreenway22ndAve,03/31/2016 10:00:00 PM,48,-122,2,0,2
19031,58thStGreenway22ndAve,03/31/2016 11:00:00 PM,48,-122,0,1,1
19032,58thStGreenway22ndAve,04/01/2016 12:00:00 AM,48,-122,0,0,0
19033,58thStGreenway22ndAve,04/01/2016 01:00:00 AM,48,-122,0,0,0
19034,58thStGreenway22ndAve,04/01/2016 02:00:00 AM,48,-122,0,0,0
19035,58thStGreenway22ndAve,04/01/2016 03:00:00 AM,48,-122,1,0,1
19036,58thStGreenway22ndAve,04/01/2016 04:00:00 AM,48,-122,0,0,0
19037,58thStGreenway22ndAve,04/01/2016 05:00:00 AM,48,-122,0,0,0
19038,58thStGreenway22ndAve,04/01/2016 06:00:00 AM,48,-122,0,1,1
19039,58thStGreenway22ndAve,04/01/2016 07:00:00 AM,48,-122,2,4,6
19040,58thStGreenway22ndAve,04/01/2016 08:00:00 AM,48,-122,4,10,14
19041,58thStGreenway22ndAve,04/01/2016 09:00:00 AM,48,-122,6,3,9
19042,58thStGreenway22ndAve,04/01/2016 10:00:00 AM,48,-122,2,7,9
19043,58thStGreenway22ndAve,04/01/2016 11:00:00 AM,48,-122,2,4,6
19044,58thStGreenway22ndAve,04/01/2016 12:00:00 PM,48,-122,4,9,13
19045,58thStGreenway22ndAve,04/01/2016 01:00:00 PM,48,-122,9,5,14
19046,58thStGreenway22ndAve,04/01/2016 02:00:00 PM,48,-122,8,3,11
19047,58thStGreenway22ndAve,04/01/2016 03:00:00 PM,48,-122,11,8,19
19048,58thStGreenway22ndAve,04/01/2016 04:00:00 PM,48,-122,13,3,16
19049,58thStGreenway22ndAve,04/01/2016 05:00:00 PM,48,-122,10,7,17
19050,58thStGreenway22ndAve,04/01/2016 06:00:00 PM,48,-122,13,8,21
19051,58thStGreenway22ndAve,04/01/2016 07:00:00 PM,48,-122,7,11,18
19052,58thStGreenway22ndAve,04/01/2016 08:00:00 PM,48,-122,2,2,4
19053,58thStGreenway22ndAve,04/01/2016 09:00:00 PM,48,-122,6,2,8
19054,58thStGreenway22ndAve,04/01/2016 10:00:00 PM,48,-122,2,0,2
19055,58thStGreenway22ndAve,04/01/2016 11:00:00 PM,48,-122,2,1,3
19056,58thStGreenway22ndAve,04/02/2016 12:00:00 AM,48,-122,0,0,0
19057,58thStGreenway22ndAve,04/02/2016 01:00:00 AM,48,-122,0,0,0
19058,58thStGreenway22ndAve,04/02/2016 02:00:00 AM,48,-122,1,1,2
19059,58thStGreenway22ndAve,04/02/2016 03:00:00 AM,48,-122,0,0,0
19060,58thStGreenway22ndAve,04/02/2016 04:00:00 AM,48,-122,0,0,0
19061,58thStGreenway22ndAve,04/02/2016 05:00:00 AM,48,-122,0,0,0
19062,58thStGreenway22ndAve,04/02/2016 06:00:00 AM,48,-122,0,1,1
19063,58thStGreenway22ndAve,04/02/2016 07:00:00 AM,48,-122,0,1,1
19064,58thStGreenway22ndAve,04/02/2016 08:00:00 AM,48,-122,1,1,2
19065,58thStGreenway22ndAve,04/02/2016 09:00:00 AM,48,-122,5,5,10
19066,58thStGreenway22ndAve,04/02/2016 10:00:00 AM,48,-122,4,11,15
19067,58thStGreenway22ndAve,04/02/2016 11:00:00 AM,48,-122,8,3,11
19068,58thStGreenway22ndAve,04/02/2016 12:00:00 PM,48,-122,7,8,15
19069,58thStGreenway22ndAve,04/02/2016 01:00:00 PM,48,-122,24,10,34
19070,58thStGreenway22ndAve,04/02/2016 02:00:00 PM,48,-122,5,9,14
19071,58thStGreenway22ndAve,04/02/2016 03:00:00 PM,48,-122,13,10,23
19072,58thStGreenway22ndAve,04/02/2016 04:00:00 PM,48,-122,7,5,12
19073,58thStGreenway22ndAve,04/02/2016 05:00:00 PM,48,-122,18,5,23
19074,58thStGreenway22ndAve,04/02/2016 06:00:00 PM,48,-122,3,9,12
19075,58thStGreenway22ndAve,04/02/2016 07:00:00 PM,48,-122,1,6,7
19076,58thStGreenway22ndAve,04/02/2016 08:00:00 PM,48,-122,8,3,11
19077,58thStGreenway22ndAve,04/02/2016 09:00:00 PM,48,-122,3,1,4
19078,58thStGreenway22ndAve,04/02/2016 10:00:00 PM,48,-122,3,0,3
19079,58thStGreenway22ndAve,04/02/2016 11:00:00 PM,48,-122,2,1,3
19080,58thStGreenway22ndAve,04/03/2016 12:00:00 AM,48,-122,0,0,0
19081,58thStGreenway22ndAve,04/03/2016 01:00:00 AM,48,-122,0,0,0
19082,58thStGreenway22ndAve,04/03/2016 02:00:00 AM,48,-122,0,1,1
19083,58thStGreenway22ndAve,04/03/2016 03:00:00 AM,48,-122,0,0,0
19084,58thStGreenway22ndAve,04/03/2016 04:00:00 AM,48,-122,0,0,0
19085,58thStGreenway22ndAve,04/03/2016 05:00:00 AM,48,-122,3,0,3
19086,58thStGreenway22ndAve,04/03/2016 06:00:00 AM,48,-122,7,0,7
19087,58thStGreenway22ndAve,04/03/2016 07:00:00 AM,48,-122,0,2,2
19088,58thStGreenway22ndAve,04/03/2016 08:00:00 AM,48,-122,0,1,1
19089,58thStGreenway22ndAve,04/03/2016 09:00:00 AM,48,-122,3,8,11
19090,58thStGreenway22ndAve,04/03/2016 10:00:00 AM,48,-122,5,2,7
19091,58thStGreenway22ndAve,04/03/2016 11:00:00 AM,48,-122,5,7,12
19092,58thStGreenway22ndAve,04/03/2016 12:00:00 PM,48,-122,11,8,19
19093,58thStGreenway22ndAve,04/03/2016 01:00:00 PM,48,-122,9,17,26
19094,58thStGreenway22ndAve,04/03/2016 02:00:00 PM,48,-122,8,12,20
19095,58thStGreenway22ndAve,04/03/2016 03:00:00 PM,48,-122,14,8,22
19096,58thStGreenway22ndAve,04/03/2016 04:00:00 PM,48,-122,4,8,12
19097,58thStGreenway22ndAve,04/03/2016 05:00:00 PM,48,-122,8,10,18
19098,58thStGreenway22ndAve,04/03/2016 06:00:00 PM,48,-122,4,2,6
19099,58thStGreenway22ndAve,04/03/2016 07:00:00 PM,48,-122,0,2,2
19100,58thStGreenway22ndAve,04/03/2016 08:00:00 PM,48,-122,0,2,2
19101,58thStGreenway22ndAve,04/03/2016 09:00:00 PM,48,-122,1,0,1
19102,58thStGreenway22ndAve,04/03/2016 10:00:00 PM,48,-122,1,0,1
19103,58thStGreenway22ndAve,04/03/2016 11:00:00 PM,48,-122,0,0,0
19104,58thStGreenway22ndAve,04/04/2016 12:00:00 AM,48,-122,0,0,0
19105,58thStGreenway22ndAve,04/04/2016 01:00:00 AM,48,-122,0,0,0
19106,58thStGreenway22ndAve,04/04/2016 02:00:00 AM,48,-122,0,0,0
19107,58thStGreenway22ndAve,04/04/2016 03:00:00 AM,48,-122,0,0,0
19108,58thStGreenway22ndAve,04/04/2016 04:00:00 AM,48,-122,0,1,1
19109,58thStGreenway22ndAve,04/04/2016 05:00:00 AM,48,-122,0,0,0
19110,58thStGreenway22ndAve,04/04/2016 06:00:00 AM,48,-122,1,0,1
19111,58thStGreenway22ndAve,04/04/2016 07:00:00 AM,48,-122,5,4,9
19112,58thStGreenway22ndAve,04/04/2016 08:00:00 AM,48,-122,3,6,9
19113,58thStGreenway22ndAve,04/04/2016 09:00:00 AM,48,-122,7,5,12
19114,58thStGreenway22ndAve,04/04/2016 10:00:00 AM,48,-122,2,7,9
19115,58thStGreenway22ndAve,04/04/2016 11:00:00 AM,48,-122,1,4,5
19116,58thStGreenway22ndAve,04/04/2016 12:00:00 PM,48,-122,6,0,6
19117,58thStGreenway22ndAve,04/04/2016 01:00:00 PM,48,-122,5,1,6
19118,58thStGreenway22ndAve,04/04/2016 02:00:00 PM,48,-122,4,1,5
19119,58thStGreenway22ndAve,04/04/2016 03:00:00 PM,48,-122,3,1,4
19120,58thStGreenway22ndAve,04/04/2016 04:00:00 PM,48,-122,8,6,14
19121,58thStGreenway22ndAve,04/04/2016 05:00:00 PM,48,-122,7,13,20
19122,58thStGreenway22ndAve,04/04/2016 06:00:00 PM,48,-122,7,10,17
19123,58thStGreenway22ndAve,04/04/2016 07:00:00 PM,48,-122,3,1,4
19124,58thStGreenway22ndAve,04/04/2016 08:00:00 PM,48,-122,2,0,2
19125,58thStGreenway22ndAve,04/04/2016 09:00:00 PM,48,-122,2,3,5
19126,58thStGreenway22ndAve,04/04/2016 10:00:00 PM,48,-122,0,0,0
19127,58thStGreenway22ndAve,04/04/2016 11:00:00 PM,48,-122,0,0,0
19128,58thStGreenway22ndAve,04/05/2016 12:00:00 AM,48,-122,0,0,0
19129,58thStGreenway22ndAve,04/05/2016 01:00:00 AM,48,-122,1,0,1
19130,58thStGreenway22ndAve,04/05/2016 02:00:00 AM,48,-122,1,0,1
19131,58thStGreenway22ndAve,04/05/2016 03:00:00 AM,48,-122,0,2,2
19132,58thStGreenway22ndAve,04/05/2016 04:00:00 AM,48,-122,0,0,0
19133,58thStGreenway22ndAve,04/05/2016 05:00:00 AM,48,-122,0,1,1
19134,58thStGreenway22ndAve,04/05/2016 06:00:00 AM,48,-122,0,2,2
19135,58thStGreenway22ndAve,04/05/2016 07:00:00 AM,48,-122,6,3,9
19136,58thStGreenway22ndAve,04/05/2016 08:00:00 AM,48,-122,1,6,7
19137,58thStGreenway22ndAve,04/05/2016 09:00:00 AM,48,-122,4,6,10
19138,58thStGreenway22ndAve,04/05/2016 10:00:00 AM,48,-122,5,3,8
19139,58thStGreenway22ndAve,04/05/2016 11:00:00 AM,48,-122,3,0,3
19140,58thStGreenway22ndAve,04/05/2016 12:00:00 PM,48,-122,3,3,6
19141,58thStGreenway22ndAve,04/05/2016 01:00:00 PM,48,-122,0,1,1
19142,58thStGreenway22ndAve,04/05/2016 02:00:00 PM,48,-122,4,2,6
19143,58thStGreenway22ndAve,04/05/2016 03:00:00 PM,48,-122,6,9,15
19144,58thStGreenway22ndAve,04/05/2016 04:00:00 PM,48,-122,5,7,12
19145,58thStGreenway22ndAve,04/05/2016 05:00:00 PM,48,-122,4,15,19
19146,58thStGreenway22ndAve,04/05/2016 06:00:00 PM,48,-122,10,9,19
19147,58thStGreenway22ndAve,04/05/2016 07:00:00 PM,48,-122,5,5,10
19148,58thStGreenway22ndAve,04/05/2016 08:00:00 PM,48,-122,2,1,3
19149,58thStGreenway22ndAve,04/05/2016 09:00:00 PM,48,-122,1,3,4
19150,58thStGreenway22ndAve,04/05/2016 10:00:00 PM,48,-122,2,1,3
19151,58thStGreenway22ndAve,04/05/2016 11:00:00 PM,48,-122,3,1,4
19152,58thStGreenway22ndAve,04/06/2016 12:00:00 AM,48,-122,0,0,0
19153,58thStGreenway22ndAve,04/06/2016 01:00:00 AM,48,-122,0,1,1
19154,58thStGreenway22ndAve,04/06/2016 02:00:00 AM,48,-122,0,1,1
19155,58thStGreenway22ndAve,04/06/2016 03:00:00 AM,48,-122,0,0,0
19156,58thStGreenway22ndAve,04/06/2016 04:00:00 AM,48,-122,0,0,0
19157,58thStGreenway22ndAve,04/06/2016 05:00:00 AM,48,-122,0,1,1
19158,58thStGreenway22ndAve,04/06/2016 06:00:00 AM,48,-122,0,0,0
19159,58thStGreenway22ndAve,04/06/2016 07:00:00 AM,48,-122,5,6,11
19160,58thStGreenway22ndAve,04/06/2016 08:00:00 AM,48,-122,3,7,10
19161,58thStGreenway22ndAve,04/06/2016 09:00:00 AM,48,-122,3,4,7
19162,58thStGreenway22ndAve,04/06/2016 10:00:00 AM,48,-122,4,5,9
19163,58thStGreenway22ndAve,04/06/2016 11:00:00 AM,48,-122,1,4,5
19164,58thStGreenway22ndAve,04/06/2016 12:00:00 PM,48,-122,1,2,3
19165,58thStGreenway22ndAve,04/06/2016 01:00:00 PM,48,-122,7,5,12
19166,58thStGreenway22ndAve,04/06/2016 02:00:00 PM,48,-122,4,8,12
19167,58thStGreenway22ndAve,04/06/2016 03:00:00 PM,48,-122,2,6,8
19168,58thStGreenway22ndAve,04/06/2016 04:00:00 PM,48,-122,6,7,13
19169,58thStGreenway22ndAve,04/06/2016 05:00:00 PM,48,-122,11,9,20
19170,58thStGreenway22ndAve,04/06/2016 06:00:00 PM,48,-122,14,25,39
19171,58thStGreenway22ndAve,04/06/2016 07:00:00 PM,48,-122,6,7,13
19172,58thStGreenway22ndAve,04/06/2016 08:00:00 PM,48,-122,5,0,5
19173,58thStGreenway22ndAve,04/06/2016 09:00:00 PM,48,-122,2,1,3
19174,58thStGreenway22ndAve,04/06/2016 10:00:00 PM,48,-122,0,1,1
19175,58thStGreenway22ndAve,04/06/2016 11:00:00 PM,48,-122,1,1,2
19176,58thStGreenway22ndAve,04/07/2016 12:00:00 AM,48,-122,0,0,0
19177,58thStGreenway22ndAve,04/07/2016 01:00:00 AM,48,-122,0,0,0
19178,58thStGreenway22ndAve,04/07/2016 02:00:00 AM,48,-122,0,0,0
19179,58thStGreenway22ndAve,04/07/2016 03:00:00 AM,48,-122,0,0,0
19180,58thStGreenway22ndAve,04/07/2016 04:00:00 AM,48,-122,0,0,0
19181,58thStGreenway22ndAve,04/07/2016 05:00:00 AM,48,-122,0,1,1
19182,58thStGreenway22ndAve,04/07/2016 06:00:00 AM,48,-122,0,0,0
19183,58thStGreenway22ndAve,04/07/2016 07:00:00 AM,48,-122,5,1,6
19184,58thStGreenway22ndAve,04/07/2016 08:00:00 AM,48,-122,2,6,8
19185,58thStGreenway22ndAve,04/07/2016 09:00:00 AM,48,-122,5,2,7
19186,58thStGreenway22ndAve,04/07/2016 10:00:00 AM,48,-122,8,5,13
19187,58thStGreenway22ndAve,04/07/2016 11:00:00 AM,48,-122,7,5,12
19188,58thStGreenway22ndAve,04/07/2016 12:00:00 PM,48,-122,3,8,11
19189,58thStGreenway22ndAve,04/07/2016 01:00:00 PM,48,-122,7,8,15
19190,58thStGreenway22ndAve,04/07/2016 02:00:00 PM,48,-122,7,9,16
19191,58thStGreenway22ndAve,04/07/2016 03:00:00 PM,48,-122,4,3,7
19192,58thStGreenway22ndAve,04/07/2016 04:00:00 PM,48,-122,7,6,13
19193,58thStGreenway22ndAve,04/07/2016 05:00:00 PM,48,-122,19,5,24
19194,58thStGreenway22ndAve,04/07/2016 06:00:00 PM,48,-122,7,5,12
19195,58thStGreenway22ndAve,04/07/2016 07:00:00 PM,48,-122,13,8,21
19196,58thStGreenway22ndAve,04/07/2016 08:00:00 PM,48,-122,2,3,5
19197,58thStGreenway22ndAve,04/07/2016 09:00:00 PM,48,-122,9,2,11
19198,58thStGreenway22ndAve,04/07/2016 10:00:00 PM,48,-122,1,2,3
19199,58thStGreenway22ndAve,04/07/2016 11:00:00 PM,48,-122,1,1,2
19200,58thStGreenway22ndAve,04/08/2016 12:00:00 AM,48,-122,0,0,0
19201,58thStGreenway22ndAve,04/08/2016 01:00:00 AM,48,-122,0,0,0
19202,58thStGreenway22ndAve,04/08/2016 02:00:00 AM,48,-122,0,1,1
19203,58thStGreenway22ndAve,04/08/2016 03:00:00 AM,48,-122,0,0,0
19204,58thStGreenway22ndAve,04/08/2016 04:00:00 AM,48,-122,0,0,0
19205,58thStGreenway22ndAve,04/08/2016 05:00:00 AM,48,-122,0,1,1
19206,58thStGreenway22ndAve,04/08/2016 06:00:00 AM,48,-122,0,3,3
19207,58thStGreenway22ndAve,04/08/2016 07:00:00 AM,48,-122,3,6,9
19208,58thStGreenway22ndAve,04/08/2016 08:00:00 AM,48,-122,3,5,8
19209,58thStGreenway22ndAve,04/08/2016 09:00:00 AM,48,-122,3,2,5
19210,58thStGreenway22ndAve,04/08/2016 10:00:00 AM,48,-122,4,7,11
19211,58thStGreenway22ndAve,04/08/2016 11:00:00 AM,48,-122,4,7,11
19212,58thStGreenway22ndAve,04/08/2016 12:00:00 PM,48,-122,0,5,5
19213,58thStGreenway22ndAve,04/08/2016 01:00:00 PM,48,-122,11,3,14
19214,58thStGreenway22ndAve,04/08/2016 02:00:00 PM,48,-122,14,11,25
19215,58thStGreenway22ndAve,04/08/2016 03:00:00 PM,48,-122,15,6,21
19216,58thStGreenway22ndAve,04/08/2016 04:00:00 PM,48,-122,3,4,7
19217,58thStGreenway22ndAve,04/08/2016 05:00:00 PM,48,-122,5,13,18
19218,58thStGreenway22ndAve,04/08/2016 06:00:00 PM,48,-122,7,12,19
19219,58thStGreenway22ndAve,04/08/2016 07:00:00 PM,48,-122,13,1,14
19220,58thStGreenway22ndAve,04/08/2016 08:00:00 PM,48,-122,5,0,5
19221,58thStGreenway22ndAve,04/08/2016 09:00:00 PM,48,-122,3,2,5
19222,58thStGreenway22ndAve,04/08/2016 10:00:00 PM,48,-122,1,4,5
19223,58thStGreenway22ndAve,04/08/2016 11:00:00 PM,48,-122,1,1,2
19224,58thStGreenway22ndAve,04/09/2016 12:00:00 AM,48,-122,1,0,1
19225,58thStGreenway22ndAve,04/09/2016 01:00:00 AM,48,-122,0,1,1
19226,58thStGreenway22ndAve,04/09/2016 02:00:00 AM,48,-122,0,0,0
19227,58thStGreenway22ndAve,04/09/2016 03:00:00 AM,48,-122,0,1,1
19228,58thStGreenway22ndAve,04/09/2016 04:00:00 AM,48,-122,0,0,0
19229,58thStGreenway22ndAve,04/09/2016 05:00:00 AM,48,-122,0,0,0
19230,58thStGreenway22ndAve,04/09/2016 06:00:00 AM,48,-122,0,2,2
19231,58thStGreenway22ndAve,04/09/2016 07:00:00 AM,48,-122,1,2,3
19232,58thStGreenway22ndAve,04/09/2016 08:00:00 AM,48,-122,4,1,5
19233,58thStGreenway22ndAve,04/09/2016 09:00:00 AM,48,-122,5,6,11
19234,58thStGreenway22ndAve,04/09/2016 10:00:00 AM,48,-122,2,4,6
19235,58thStGreenway22ndAve,04/09/2016 11:00:00 AM,48,-122,6,4,10
19236,58thStGreenway22ndAve,04/09/2016 12:00:00 PM,48,-122,0,13,13
19237,58thStGreenway22ndAve,04/09/2016 01:00:00 PM,48,-122,14,8,22
19238,58thStGreenway22ndAve,04/09/2016 02:00:00 PM,48,-122,8,15,23
19239,58thStGreenway22ndAve,04/09/2016 03:00:00 PM,48,-122,5,6,11
19240,58thStGreenway22ndAve,04/09/2016 04:00:00 PM,48,-122,18,8,26
19241,58thStGreenway22ndAve,04/09/2016 05:00:00 PM,48,-122,5,4,9
19242,58thStGreenway22ndAve,04/09/2016 06:00:00 PM,48,-122,6,11,17
19243,58thStGreenway22ndAve,04/09/2016 07:00:00 PM,48,-122,1,3,4
19244,58thStGreenway22ndAve,04/09/2016 08:00:00 PM,48,-122,0,2,2
19245,58thStGreenway22ndAve,04/09/2016 09:00:00 PM,48,-122,2,3,5
19246,58thStGreenway22ndAve,04/09/2016 10:00:00 PM,48,-122,2,0,2
19247,58thStGreenway22ndAve,04/09/2016 11:00:00 PM,48,-122,2,0,2
19248,58thStGreenway22ndAve,04/10/2016 12:00:00 AM,48,-122,0,0,0
19249,58thStGreenway22ndAve,04/10/2016 01:00:00 AM,48,-122,0,0,0
19250,58thStGreenway22ndAve,04/10/2016 02:00:00 AM,48,-122,3,0,3
19251,58thStGreenway22ndAve,04/10/2016 03:00:00 AM,48,-122,0,0,0
19252,58thStGreenway22ndAve,04/10/2016 04:00:00 AM,48,-122,0,0,0
19253,58thStGreenway22ndAve,04/10/2016 05:00:00 AM,48,-122,0,0,0
19254,58thStGreenway22ndAve,04/10/2016 06:00:00 AM,48,-122,0,0,0
19255,58thStGreenway22ndAve,04/10/2016 07:00:00 AM,48,-122,0,1,1
19256,58thStGreenway22ndAve,04/10/2016 08:00:00 AM,48,-122,0,2,2
19257,58thStGreenway22ndAve,04/10/2016 09:00:00 AM,48,-122,4,2,6
19258,58thStGreenway22ndAve,04/10/2016 10:00:00 AM,48,-122,5,5,10
19259,58thStGreenway22ndAve,04/10/2016 11:00:00 AM,48,-122,3,6,9
19260,58thStGreenway22ndAve,04/10/2016 12:00:00 PM,48,-122,14,4,18
19261,58thStGreenway22ndAve,04/10/2016 01:00:00 PM,48,-122,8,10,18
19262,58thStGreenway22ndAve,04/10/2016 02:00:00 PM,48,-122,12,14,26
19263,58thStGreenway22ndAve,04/10/2016 03:00:00 PM,48,-122,6,10,16
19264,58thStGreenway22ndAve,04/10/2016 04:00:00 PM,48,-122,4,6,10
19265,58thStGreenway22ndAve,04/10/2016 05:00:00 PM,48,-122,11,7,18
19266,58thStGreenway22ndAve,04/10/2016 06:00:00 PM,48,-122,4,3,7
19267,58thStGreenway22ndAve,04/10/2016 07:00:00 PM,48,-122,5,2,7
19268,58thStGreenway22ndAve,04/10/2016 08:00:00 PM,48,-122,1,1,2
19269,58thStGreenway22ndAve,04/10/2016 09:00:00 PM,48,-122,0,0,0
19270,58thStGreenway22ndAve,04/10/2016 10:00:00 PM,48,-122,0,0,0
19271,58thStGreenway22ndAve,04/10/2016 11:00:00 PM,48,-122,0,0,0
19272,58thStGreenway22ndAve,04/11/2016 12:00:00 AM,48,-122,0,0,0
19273,58thStGreenway22ndAve,04/11/2016 01:00:00 AM,48,-122,0,0,0
19274,58thStGreenway22ndAve,04/11/2016 02:00:00 AM,48,-122,0,0,0
19275,58thStGreenway22ndAve,04/11/2016 03:00:00 AM,48,-122,0,0,0
19276,58thStGreenway22ndAve,04/11/2016 04:00:00 AM,48,-122,0,0,0
19277,58thStGreenway22ndAve,04/11/2016 05:00:00 AM,48,-122,0,1,1
19278,58thStGreenway22ndAve,04/11/2016 06:00:00 AM,48,-122,1,2,3
19279,58thStGreenway22ndAve,04/11/2016 07:00:00 AM,48,-122,4,8,12
19280,58thStGreenway22ndAve,04/11/2016 08:00:00 AM,48,-122,1,6,7
19281,58thStGreenway22ndAve,04/11/2016 09:00:00 AM,48,-122,6,6,12
19282,58thStGreenway22ndAve,04/11/2016 10:00:00 AM,48,-122,3,1,4
19283,58thStGreenway22ndAve,04/11/2016 11:00:00 AM,48,-122,1,1,2
19284,58thStGreenway22ndAve,04/11/2016 12:00:00 PM,48,-122,4,3,7
19285,58thStGreenway22ndAve,04/11/2016 01:00:00 PM,48,-122,11,3,14
19286,58thStGreenway22ndAve,04/11/2016 02:00:00 PM,48,-122,3,2,5
19287,58thStGreenway22ndAve,04/11/2016 03:00:00 PM,48,-122,6,1,7
19288,58thStGreenway22ndAve,04/11/2016 04:00:00 PM,48,-122,8,4,12
19289,58thStGreenway22ndAve,04/11/2016 05:00:00 PM,48,-122,5,7,12
19290,58thStGreenway22ndAve,04/11/2016 06:00:00 PM,48,-122,6,6,12
19291,58thStGreenway22ndAve,04/11/2016 07:00:00 PM,48,-122,2,2,4
19292,58thStGreenway22ndAve,04/11/2016 08:00:00 PM,48,-122,5,3,8
19293,58thStGreenway22ndAve,04/11/2016 09:00:00 PM,48,-122,2,0,2
19294,58thStGreenway22ndAve,04/11/2016 10:00:00 PM,48,-122,3,0,3
19295,58thStGreenway22ndAve,04/11/2016 11:00:00 PM,48,-122,0,0,0
19296,58thStGreenway22ndAve,04/12/2016 12:00:00 AM,48,-122,0,0,0
19297,58thStGreenway22ndAve,04/12/2016 01:00:00 AM,48,-122,0,0,0
19298,58thStGreenway22ndAve,04/12/2016 02:00:00 AM,48,-122,0,0,0
19299,58thStGreenway22ndAve,04/12/2016 03:00:00 AM,48,-122,0,0,0
19300,58thStGreenway22ndAve,04/12/2016 04:00:00 AM,48,-122,0,0,0
19301,58thStGreenway22ndAve,04/12/2016 05:00:00 AM,48,-122,0,1,1
19302,58thStGreenway22ndAve,04/12/2016 06:00:00 AM,48,-122,1,1,2
19303,58thStGreenway22ndAve,04/12/2016 07:00:00 AM,48,-122,6,2,8
19304,58thStGreenway22ndAve,04/12/2016 08:00:00 AM,48,-122,2,4,6
19305,58thStGreenway22ndAve,04/12/2016 09:00:00 AM,48,-122,1,5,6
19306,58thStGreenway22ndAve,04/12/2016 10:00:00 AM,48,-122,1,7,8
19307,58thStGreenway22ndAve,04/12/2016 11:00:00 AM,48,-122,5,1,6
19308,58thStGreenway22ndAve,04/12/2016 12:00:00 PM,48,-122,7,2,9
19309,58thStGreenway22ndAve,04/12/2016 01:00:00 PM,48,-122,3,2,5
19310,58thStGreenway22ndAve,04/12/2016 02:00:00 PM,48,-122,2,2,4
19311,58thStGreenway22ndAve,04/12/2016 03:00:00 PM,48,-122,0,0,0
19312,58thStGreenway22ndAve,04/12/2016 04:00:00 PM,48,-122,3,2,5
19313,58thStGreenway22ndAve,04/12/2016 05:00:00 PM,48,-122,3,3,6
19314,58thStGreenway22ndAve,04/12/2016 06:00:00 PM,48,-122,2,3,5
19315,58thStGreenway22ndAve,04/12/2016 07:00:00 PM,48,-122,6,5,11
19316,58thStGreenway22ndAve,04/12/2016 08:00:00 PM,48,-122,2,3,5
19317,58thStGreenway22ndAve,04/12/2016 09:00:00 PM,48,-122,1,0,1
19318,58thStGreenway22ndAve,04/12/2016 10:00:00 PM,48,-122,1,1,2
19319,58thStGreenway22ndAve,04/12/2016 11:00:00 PM,48,-122,1,0,1
19320,58thStGreenway22ndAve,04/13/2016 12:00:00 AM,48,-122,0,0,0
19321,58thStGreenway22ndAve,04/13/2016 01:00:00 AM,48,-122,0,0,0
19322,58thStGreenway22ndAve,04/13/2016 02:00:00 AM,48,-122,0,1,1
19323,58thStGreenway22ndAve,04/13/2016 03:00:00 AM,48,-122,0,0,0
19324,58thStGreenway22ndAve,04/13/2016 04:00:00 AM,48,-122,0,0,0
19325,58thStGreenway22ndAve,04/13/2016 05:00:00 AM,48,-122,0,2,2
19326,58thStGreenway22ndAve,04/13/2016 06:00:00 AM,48,-122,0,2,2
19327,58thStGreenway22ndAve,04/13/2016 07:00:00 AM,48,-122,10,4,14
19328,58thStGreenway22ndAve,04/13/2016 08:00:00 AM,48,-122,7,3,10
19329,58thStGreenway22ndAve,04/13/2016 09:00:00 AM,48,-122,7,6,13
19330,58thStGreenway22ndAve,04/13/2016 10:00:00 AM,48,-122,1,9,10
19331,58thStGreenway22ndAve,04/13/2016 11:00:00 AM,48,-122,0,5,5
19332,58thStGreenway22ndAve,04/13/2016 12:00:00 PM,48,-122,1,5,6
19333,58thStGreenway22ndAve,04/13/2016 01:00:00 PM,48,-122,0,2,2
19334,58thStGreenway22ndAve,04/13/2016 02:00:00 PM,48,-122,8,2,10
19335,58thStGreenway22ndAve,04/13/2016 03:00:00 PM,48,-122,2,2,4
19336,58thStGreenway22ndAve,04/13/2016 04:00:00 PM,48,-122,8,4,12
19337,58thStGreenway22ndAve,04/13/2016 05:00:00 PM,48,-122,5,5,10
19338,58thStGreenway22ndAve,04/13/2016 06:00:00 PM,48,-122,6,9,15
19339,58thStGreenway22ndAve,04/13/2016 07:00:00 PM,48,-122,0,8,8
19340,58thStGreenway22ndAve,04/13/2016 08:00:00 PM,48,-122,3,2,5
19341,58thStGreenway22ndAve,04/13/2016 09:00:00 PM,48,-122,2,0,2
19342,58thStGreenway22ndAve,04/13/2016 10:00:00 PM,48,-122,0,0,0
19343,58thStGreenway22ndAve,04/13/2016 11:00:00 PM,48,-122,0,0,0
19344,58thStGreenway22ndAve,04/14/2016 12:00:00 AM,48,-122,0,0,0
19345,58thStGreenway22ndAve,04/14/2016 01:00:00 AM,48,-122,0,0,0
19346,58thStGreenway22ndAve,04/14/2016 02:00:00 AM,48,-122,0,0,0
19347,58thStGreenway22ndAve,04/14/2016 03:00:00 AM,48,-122,0,0,0
19348,58thStGreenway22ndAve,04/14/2016 04:00:00 AM,48,-122,0,0,0
19349,58thStGreenway22ndAve,04/14/2016 05:00:00 AM,48,-122,1,1,2
19350,58thStGreenway22ndAve,04/14/2016 06:00:00 AM,48,-122,0,0,0
19351,58thStGreenway22ndAve,04/14/2016 07:00:00 AM,48,-122,2,2,4
19352,58thStGreenway22ndAve,04/14/2016 08:00:00 AM,48,-122,3,4,7
19353,58thStGreenway22ndAve,04/14/2016 09:00:00 AM,48,-122,2,2,4
19354,58thStGreenway22ndAve,04/14/2016 10:00:00 AM,48,-122,3,3,6
19355,58thStGreenway22ndAve,04/14/2016 11:00:00 AM,48,-122,3,3,6
19356,58thStGreenway22ndAve,04/14/2016 12:00:00 PM,48,-122,9,5,14
19357,58thStGreenway22ndAve,04/14/2016 01:00:00 PM,48,-122,5,9,14
19358,58thStGreenway22ndAve,04/14/2016 02:00:00 PM,48,-122,7,2,9
19359,58thStGreenway22ndAve,04/14/2016 03:00:00 PM,48,-122,5,5,10
19360,58thStGreenway22ndAve,04/14/2016 04:00:00 PM,48,-122,7,9,16
19361,58thStGreenway22ndAve,04/14/2016 05:00:00 PM,48,-122,9,8,17
19362,58thStGreenway22ndAve,04/14/2016 06:00:00 PM,48,-122,10,7,17
19363,58thStGreenway22ndAve,04/14/2016 07:00:00 PM,48,-122,10,4,14
19364,58thStGreenway22ndAve,04/14/2016 08:00:00 PM,48,-122,3,4,7
19365,58thStGreenway22ndAve,04/14/2016 09:00:00 PM,48,-122,2,1,3
19366,58thStGreenway22ndAve,04/14/2016 10:00:00 PM,48,-122,0,0,0
19367,58thStGreenway22ndAve,04/14/2016 11:00:00 PM,48,-122,1,0,1
19368,58thStGreenway22ndAve,04/15/2016 12:00:00 AM,48,-122,0,0,0
19369,58thStGreenway22ndAve,04/15/2016 01:00:00 AM,48,-122,0,0,0
19370,58thStGreenway22ndAve,04/15/2016 02:00:00 AM,48,-122,0,0,0
19371,58thStGreenway22ndAve,04/15/2016 03:00:00 AM,48,-122,0,0,0
19372,58thStGreenway22ndAve,04/15/2016 04:00:00 AM,48,-122,0,0,0
19373,58thStGreenway22ndAve,04/15/2016 05:00:00 AM,48,-122,0,0,0
19374,58thStGreenway22ndAve,04/15/2016 06:00:00 AM,48,-122,0,3,3
19375,58thStGreenway22ndAve,04/15/2016 07:00:00 AM,48,-122,3,3,6
19376,58thStGreenway22ndAve,04/15/2016 08:00:00 AM,48,-122,2,3,5
19377,58thStGreenway22ndAve,04/15/2016 09:00:00 AM,48,-122,5,4,9
19378,58thStGreenway22ndAve,04/15/2016 10:00:00 AM,48,-122,5,4,9
19379,58thStGreenway22ndAve,04/15/2016 11:00:00 AM,48,-122,1,3,4
19380,58thStGreenway22ndAve,04/15/2016 12:00:00 PM,48,-122,7,4,11
19381,58thStGreenway22ndAve,04/15/2016 01:00:00 PM,48,-122,2,2,4
19382,58thStGreenway22ndAve,04/15/2016 02:00:00 PM,48,-122,8,2,10
19383,58thStGreenway22ndAve,04/15/2016 03:00:00 PM,48,-122,2,7,9
19384,58thStGreenway22ndAve,04/15/2016 04:00:00 PM,48,-122,7,4,11
19385,58thStGreenway22ndAve,04/15/2016 05:00:00 PM,48,-122,5,4,9
19386,58thStGreenway22ndAve,04/15/2016 06:00:00 PM,48,-122,10,5,15
19387,58thStGreenway22ndAve,04/15/2016 07:00:00 PM,48,-122,6,5,11
19388,58thStGreenway22ndAve,04/15/2016 08:00:00 PM,48,-122,3,4,7
19389,58thStGreenway22ndAve,04/15/2016 09:00:00 PM,48,-122,2,0,2
19390,58thStGreenway22ndAve,04/15/2016 10:00:00 PM,48,-122,0,2,2
19391,58thStGreenway22ndAve,04/15/2016 11:00:00 PM,48,-122,0,0,0
19392,58thStGreenway22ndAve,04/16/2016 12:00:00 AM,48,-122,2,0,2
19393,58thStGreenway22ndAve,04/16/2016 01:00:00 AM,48,-122,1,0,1
19394,58thStGreenway22ndAve,04/16/2016 02:00:00 AM,48,-122,1,0,1
19395,58thStGreenway22ndAve,04/16/2016 03:00:00 AM,48,-122,0,0,0
19396,58thStGreenway22ndAve,04/16/2016 04:00:00 AM,48,-122,0,0,0
19397,58thStGreenway22ndAve,04/16/2016 05:00:00 AM,48,-122,0,0,0
19398,58thStGreenway22ndAve,04/16/2016 06:00:00 AM,48,-122,0,0,0
19399,58thStGreenway22ndAve,04/16/2016 07:00:00 AM,48,-122,0,1,1
19400,58thStGreenway22ndAve,04/16/2016 08:00:00 AM,48,-122,1,2,3
19401,58thStGreenway22ndAve,04/16/2016 09:00:00 AM,48,-122,3,2,5
19402,58thStGreenway22ndAve,04/16/2016 10:00:00 AM,48,-122,2,6,8
19403,58thStGreenway22ndAve,04/16/2016 11:00:00 AM,48,-122,12,5,17
19404,58thStGreenway22ndAve,04/16/2016 12:00:00 PM,48,-122,7,11,18
19405,58thStGreenway22ndAve,04/16/2016 01:00:00 PM,48,-122,6,9,15
19406,58thStGreenway22ndAve,04/16/2016 02:00:00 PM,48,-122,8,6,14
19407,58thStGreenway22ndAve,04/16/2016 03:00:00 PM,48,-122,4,10,14
19408,58thStGreenway22ndAve,04/16/2016 04:00:00 PM,48,-122,9,7,16
19409,58thStGreenway22ndAve,04/16/2016 05:00:00 PM,48,-122,8,8,16
19410,58thStGreenway22ndAve,04/16/2016 06:00:00 PM,48,-122,5,8,13
19411,58thStGreenway22ndAve,04/16/2016 07:00:00 PM,48,-122,11,0,11
19412,58thStGreenway22ndAve,04/16/2016 08:00:00 PM,48,-122,10,0,10
19413,58thStGreenway22ndAve,04/16/2016 09:00:00 PM,48,-122,0,2,2
19414,58thStGreenway22ndAve,04/16/2016 10:00:00 PM,48,-122,0,0,0
19415,58thStGreenway22ndAve,04/16/2016 11:00:00 PM,48,-122,0,1,1
19416,58thStGreenway22ndAve,04/17/2016 12:00:00 AM,48,-122,0,1,1
19417,58thStGreenway22ndAve,04/17/2016 01:00:00 AM,48,-122,1,1,2
19418,58thStGreenway22ndAve,04/17/2016 02:00:00 AM,48,-122,0,0,0
19419,58thStGreenway22ndAve,04/17/2016 03:00:00 AM,48,-122,0,0,0
19420,58thStGreenway22ndAve,04/17/2016 04:00:00 AM,48,-122,0,0,0
19421,58thStGreenway22ndAve,04/17/2016 05:00:00 AM,48,-122,0,0,0
19422,58thStGreenway22ndAve,04/17/2016 06:00:00 AM,48,-122,0,1,1
19423,58thStGreenway22ndAve,04/17/2016 07:00:00 AM,48,-122,0,3,3
19424,58thStGreenway22ndAve,04/17/2016 08:00:00 AM,48,-122,2,5,7
19425,58thStGreenway22ndAve,04/17/2016 09:00:00 AM,48,-122,3,11,14
19426,58thStGreenway22ndAve,04/17/2016 10:00:00 AM,48,-122,15,6,21
19427,58thStGreenway22ndAve,04/17/2016 11:00:00 AM,48,-122,13,12,25
19428,58thStGreenway22ndAve,04/17/2016 12:00:00 PM,48,-122,13,13,26
19429,58thStGreenway22ndAve,04/17/2016 01:00:00 PM,48,-122,8,13,21
19430,58thStGreenway22ndAve,04/17/2016 02:00:00 PM,48,-122,14,16,30
19431,58thStGreenway22ndAve,04/17/2016 03:00:00 PM,48,-122,10,23,33
19432,58thStGreenway22ndAve,04/17/2016 04:00:00 PM,48,-122,7,14,21
19433,58thStGreenway22ndAve,04/17/2016 05:00:00 PM,48,-122,4,6,10
19434,58thStGreenway22ndAve,04/17/2016 06:00:00 PM,48,-122,5,13,18
19435,58thStGreenway22ndAve,04/17/2016 07:00:00 PM,48,-122,10,3,13
19436,58thStGreenway22ndAve,04/17/2016 08:00:00 PM,48,-122,2,3,5
19437,58thStGreenway22ndAve,04/17/2016 09:00:00 PM,48,-122,3,1,4
19438,58thStGreenway22ndAve,04/17/2016 10:00:00 PM,48,-122,1,0,1
19439,58thStGreenway22ndAve,04/17/2016 11:00:00 PM,48,-122,0,0,0
19440,58thStGreenway22ndAve,04/18/2016 12:00:00 AM,48,-122,0,0,0
19441,58thStGreenway22ndAve,04/18/2016 01:00:00 AM,48,-122,0,0,0
19442,58thStGreenway22ndAve,04/18/2016 02:00:00 AM,48,-122,0,0,0
19443,58thStGreenway22ndAve,04/18/2016 03:00:00 AM,48,-122,0,0,0
19444,58thStGreenway22ndAve,04/18/2016 04:00:00 AM,48,-122,0,0,0
19445,58thStGreenway22ndAve,04/18/2016 05:00:00 AM,48,-122,2,1,3
19446,58thStGreenway22ndAve,04/18/2016 06:00:00 AM,48,-122,4,3,7
19447,58thStGreenway22ndAve,04/18/2016 07:00:00 AM,48,-122,6,9,15
19448,58thStGreenway22ndAve,04/18/2016 08:00:00 AM,48,-122,3,7,10
19449,58thStGreenway22ndAve,04/18/2016 09:00:00 AM,48,-122,5,7,12
19450,58thStGreenway22ndAve,04/18/2016 10:00:00 AM,48,-122,4,5,9
19451,58thStGreenway22ndAve,04/18/2016 11:00:00 AM,48,-122,2,2,4
19452,58thStGreenway22ndAve,04/18/2016 12:00:00 PM,48,-122,9,9,18
19453,58thStGreenway22ndAve,04/18/2016 01:00:00 PM,48,-122,10,13,23
19454,58thStGreenway22ndAve,04/18/2016 02:00:00 PM,48,-122,7,12,19
19455,58thStGreenway22ndAve,04/18/2016 03:00:00 PM,48,-122,16,9,25
19456,58thStGreenway22ndAve,04/18/2016 04:00:00 PM,48,-122,9,5,14
19457,58thStGreenway22ndAve,04/18/2016 05:00:00 PM,48,-122,14,13,27
19458,58thStGreenway22ndAve,04/18/2016 06:00:00 PM,48,-122,16,14,30
19459,58thStGreenway22ndAve,04/18/2016 07:00:00 PM,48,-122,8,9,17
19460,58thStGreenway22ndAve,04/18/2016 08:00:00 PM,48,-122,10,3,13
19461,58thStGreenway22ndAve,04/18/2016 09:00:00 PM,48,-122,7,2,9
19462,58thStGreenway22ndAve,04/18/2016 10:00:00 PM,48,-122,2,1,3
19463,58thStGreenway22ndAve,04/18/2016 11:00:00 PM,48,-122,0,0,0
19464,58thStGreenway22ndAve,04/19/2016 12:00:00 AM,48,-122,0,0,0
19465,58thStGreenway22ndAve,04/19/2016 01:00:00 AM,48,-122,0,1,1
19466,58thStGreenway22ndAve,04/19/2016 02:00:00 AM,48,-122,0,1,1
19467,58thStGreenway22ndAve,04/19/2016 03:00:00 AM,48,-122,1,0,1
19468,58thStGreenway22ndAve,04/19/2016 04:00:00 AM,48,-122,0,0,0
19469,58thStGreenway22ndAve,04/19/2016 05:00:00 AM,48,-122,0,2,2
19470,58thStGreenway22ndAve,04/19/2016 06:00:00 AM,48,-122,2,0,2
19471,58thStGreenway22ndAve,04/19/2016 07:00:00 AM,48,-122,7,10,17
19472,58thStGreenway22ndAve,04/19/2016 08:00:00 AM,48,-122,2,7,9
19473,58thStGreenway22ndAve,04/19/2016 09:00:00 AM,48,-122,6,12,18
19474,58thStGreenway22ndAve,04/19/2016 10:00:00 AM,48,-122,7,3,10
19475,58thStGreenway22ndAve,04/19/2016 11:00:00 AM,48,-122,3,6,9
19476,58thStGreenway22ndAve,04/19/2016 12:00:00 PM,48,-122,5,9,14
19477,58thStGreenway22ndAve,04/19/2016 01:00:00 PM,48,-122,4,10,14
19478,58thStGreenway22ndAve,04/19/2016 02:00:00 PM,48,-122,9,8,17
19479,58thStGreenway22ndAve,04/19/2016 03:00:00 PM,48,-122,7,7,14
19480,58thStGreenway22ndAve,04/19/2016 04:00:00 PM,48,-122,8,7,15
19481,58thStGreenway22ndAve,04/19/2016 05:00:00 PM,48,-122,13,7,20
19482,58thStGreenway22ndAve,04/19/2016 06:00:00 PM,48,-122,12,11,23
19483,58thStGreenway22ndAve,04/19/2016 07:00:00 PM,48,-122,6,13,19
19484,58thStGreenway22ndAve,04/19/2016 08:00:00 PM,48,-122,3,0,3
19485,58thStGreenway22ndAve,04/19/2016 09:00:00 PM,48,-122,8,2,10
19486,58thStGreenway22ndAve,04/19/2016 10:00:00 PM,48,-122,0,0,0
19487,58thStGreenway22ndAve,04/19/2016 11:00:00 PM,48,-122,0,0,0
19488,58thStGreenway22ndAve,04/20/2016 12:00:00 AM,48,-122,0,1,1
19489,58thStGreenway22ndAve,04/20/2016 01:00:00 AM,48,-122,0,0,0
19490,58thStGreenway22ndAve,04/20/2016 02:00:00 AM,48,-122,0,0,0
19491,58thStGreenway22ndAve,04/20/2016 03:00:00 AM,48,-122,0,0,0
19492,58thStGreenway22ndAve,04/20/2016 04:00:00 AM,48,-122,0,0,0
19493,58thStGreenway22ndAve,04/20/2016 05:00:00 AM,48,-122,0,1,1
19494,58thStGreenway22ndAve,04/20/2016 06:00:00 AM,48,-122,0,1,1
19495,58thStGreenway22ndAve,04/20/2016 07:00:00 AM,48,-122,3,6,9
19496,58thStGreenway22ndAve,04/20/2016 08:00:00 AM,48,-122,8,6,14
19497,58thStGreenway22ndAve,04/20/2016 09:00:00 AM,48,-122,5,8,13
19498,58thStGreenway22ndAve,04/20/2016 10:00:00 AM,48,-122,4,3,7
19499,58thStGreenway22ndAve,04/20/2016 11:00:00 AM,48,-122,3,3,6
19500,58thStGreenway22ndAve,04/20/2016 12:00:00 PM,48,-122,8,10,18
19501,58thStGreenway22ndAve,04/20/2016 01:00:00 PM,48,-122,4,2,6
19502,58thStGreenway22ndAve,04/20/2016 02:00:00 PM,48,-122,6,4,10
19503,58thStGreenway22ndAve,04/20/2016 03:00:00 PM,48,-122,11,7,18
19504,58thStGreenway22ndAve,04/20/2016 04:00:00 PM,48,-122,6,4,10
19505,58thStGreenway22ndAve,04/20/2016 05:00:00 PM,48,-122,24,9,33
19506,58thStGreenway22ndAve,04/20/2016 06:00:00 PM,48,-122,10,15,25
19507,58thStGreenway22ndAve,04/20/2016 07:00:00 PM,48,-122,7,2,9
19508,58thStGreenway22ndAve,04/20/2016 08:00:00 PM,48,-122,7,6,13
19509,58thStGreenway22ndAve,04/20/2016 09:00:00 PM,48,-122,3,6,9
19510,58thStGreenway22ndAve,04/20/2016 10:00:00 PM,48,-122,1,0,1
19511,58thStGreenway22ndAve,04/20/2016 11:00:00 PM,48,-122,0,0,0
19512,58thStGreenway22ndAve,04/21/2016 12:00:00 AM,48,-122,1,0,1
19513,58thStGreenway22ndAve,04/21/2016 01:00:00 AM,48,-122,0,0,0
19514,58thStGreenway22ndAve,04/21/2016 02:00:00 AM,48,-122,0,0,0
19515,58thStGreenway22ndAve,04/21/2016 03:00:00 AM,48,-122,0,0,0
19516,58thStGreenway22ndAve,04/21/2016 04:00:00 AM,48,-122,1,0,1
19517,58thStGreenway22ndAve,04/21/2016 05:00:00 AM,48,-122,0,1,1
19518,58thStGreenway22ndAve,04/21/2016 06:00:00 AM,48,-122,1,1,2
19519,58thStGreenway22ndAve,04/21/2016 07:00:00 AM,48,-122,5,9,14
19520,58thStGreenway22ndAve,04/21/2016 08:00:00 AM,48,-122,10,1,11
19521,58thStGreenway22ndAve,04/21/2016 09:00:00 AM,48,-122,5,4,9
19522,58thStGreenway22ndAve,04/21/2016 10:00:00 AM,48,-122,2,8,10
19523,58thStGreenway22ndAve,04/21/2016 11:00:00 AM,48,-122,5,4,9
19524,58thStGreenway22ndAve,04/21/2016 12:00:00 PM,48,-122,7,1,8
19525,58thStGreenway22ndAve,04/21/2016 01:00:00 PM,48,-122,1,6,7
19526,58thStGreenway22ndAve,04/21/2016 02:00:00 PM,48,-122,5,11,16
19527,58thStGreenway22ndAve,04/21/2016 03:00:00 PM,48,-122,5,3,8
19528,58thStGreenway22ndAve,04/21/2016 04:00:00 PM,48,-122,12,11,23
19529,58thStGreenway22ndAve,04/21/2016 05:00:00 PM,48,-122,15,12,27
19530,58thStGreenway22ndAve,04/21/2016 06:00:00 PM,48,-122,5,9,14
19531,58thStGreenway22ndAve,04/21/2016 07:00:00 PM,48,-122,10,4,14
19532,58thStGreenway22ndAve,04/21/2016 08:00:00 PM,48,-122,3,6,9
19533,58thStGreenway22ndAve,04/21/2016 09:00:00 PM,48,-122,4,5,9
19534,58thStGreenway22ndAve,04/21/2016 10:00:00 PM,48,-122,3,3,6
19535,58thStGreenway22ndAve,04/21/2016 11:00:00 PM,48,-122,1,0,1
19536,58thStGreenway22ndAve,04/22/2016 12:00:00 AM,48,-122,0,0,0
19537,58thStGreenway22ndAve,04/22/2016 01:00:00 AM,48,-122,0,0,0
19538,58thStGreenway22ndAve,04/22/2016 02:00:00 AM,48,-122,0,1,1
19539,58thStGreenway22ndAve,04/22/2016 03:00:00 AM,48,-122,0,0,0
19540,58thStGreenway22ndAve,04/22/2016 04:00:00 AM,48,-122,0,0,0
19541,58thStGreenway22ndAve,04/22/2016 05:00:00 AM,48,-122,0,0,0
19542,58thStGreenway22ndAve,04/22/2016 06:00:00 AM,48,-122,1,0,1
19543,58thStGreenway22ndAve,04/22/2016 07:00:00 AM,48,-122,3,7,10
19544,58thStGreenway22ndAve,04/22/2016 08:00:00 AM,48,-122,3,6,9
19545,58thStGreenway22ndAve,04/22/2016 09:00:00 AM,48,-122,4,6,10
19546,58thStGreenway22ndAve,04/22/2016 10:00:00 AM,48,-122,4,3,7
19547,58thStGreenway22ndAve,04/22/2016 11:00:00 AM,48,-122,2,3,5
19548,58thStGreenway22ndAve,04/22/2016 12:00:00 PM,48,-122,2,0,2
19549,58thStGreenway22ndAve,04/22/2016 01:00:00 PM,48,-122,5,3,8
19550,58thStGreenway22ndAve,04/22/2016 02:00:00 PM,48,-122,1,2,3
19551,58thStGreenway22ndAve,04/22/2016 03:00:00 PM,48,-122,0,0,0
19552,58thStGreenway22ndAve,04/22/2016 04:00:00 PM,48,-122,5,5,10
19553,58thStGreenway22ndAve,04/22/2016 05:00:00 PM,48,-122,5,7,12
19554,58thStGreenway22ndAve,04/22/2016 06:00:00 PM,48,-122,1,2,3
19555,58thStGreenway22ndAve,04/22/2016 07:00:00 PM,48,-122,1,1,2
19556,58thStGreenway22ndAve,04/22/2016 08:00:00 PM,48,-122,1,0,1
19557,58thStGreenway22ndAve,04/22/2016 09:00:00 PM,48,-122,0,2,2
19558,58thStGreenway22ndAve,04/22/2016 10:00:00 PM,48,-122,0,1,1
19559,58thStGreenway22ndAve,04/22/2016 11:00:00 PM,48,-122,1,1,2
19560,58thStGreenway22ndAve,04/23/2016 12:00:00 AM,48,-122,0,0,0
19561,58thStGreenway22ndAve,04/23/2016 01:00:00 AM,48,-122,0,0,0
19562,58thStGreenway22ndAve,04/23/2016 02:00:00 AM,48,-122,0,0,0
19563,58thStGreenway22ndAve,04/23/2016 03:00:00 AM,48,-122,0,0,0
19564,58thStGreenway22ndAve,04/23/2016 04:00:00 AM,48,-122,0,0,0
19565,58thStGreenway22ndAve,04/23/2016 05:00:00 AM,48,-122,1,0,1
19566,58thStGreenway22ndAve,04/23/2016 06:00:00 AM,48,-122,0,1,1
19567,58thStGreenway22ndAve,04/23/2016 07:00:00 AM,48,-122,1,3,4
19568,58thStGreenway22ndAve,04/23/2016 08:00:00 AM,48,-122,4,2,6
19569,58thStGreenway22ndAve,04/23/2016 09:00:00 AM,48,-122,5,1,6
19570,58thStGreenway22ndAve,04/23/2016 10:00:00 AM,48,-122,1,6,7
19571,58thStGreenway22ndAve,04/23/2016 11:00:00 AM,48,-122,5,11,16
19572,58thStGreenway22ndAve,04/23/2016 12:00:00 PM,48,-122,4,6,10
19573,58thStGreenway22ndAve,04/23/2016 01:00:00 PM,48,-122,12,5,17
19574,58thStGreenway22ndAve,04/23/2016 02:00:00 PM,48,-122,3,17,20
19575,58thStGreenway22ndAve,04/23/2016 03:00:00 PM,48,-122,3,8,11
19576,58thStGreenway22ndAve,04/23/2016 04:00:00 PM,48,-122,8,8,16
19577,58thStGreenway22ndAve,04/23/2016 05:00:00 PM,48,-122,9,8,17
19578,58thStGreenway22ndAve,04/23/2016 06:00:00 PM,48,-122,6,7,13
19579,58thStGreenway22ndAve,04/23/2016 07:00:00 PM,48,-122,3,1,4
19580,58thStGreenway22ndAve,04/23/2016 08:00:00 PM,48,-122,2,0,2
19581,58thStGreenway22ndAve,04/23/2016 09:00:00 PM,48,-122,0,2,2
19582,58thStGreenway22ndAve,04/23/2016 10:00:00 PM,48,-122,2,2,4
19583,58thStGreenway22ndAve,04/23/2016 11:00:00 PM,48,-122,1,0,1
19584,58thStGreenway22ndAve,04/24/2016 12:00:00 AM,48,-122,1,2,3
19585,58thStGreenway22ndAve,04/24/2016 01:00:00 AM,48,-122,0,0,0
19586,58thStGreenway22ndAve,04/24/2016 02:00:00 AM,48,-122,0,0,0
19587,58thStGreenway22ndAve,04/24/2016 03:00:00 AM,48,-122,0,0,0
19588,58thStGreenway22ndAve,04/24/2016 04:00:00 AM,48,-122,0,0,0
19589,58thStGreenway22ndAve,04/24/2016 05:00:00 AM,48,-122,0,0,0
19590,58thStGreenway22ndAve,04/24/2016 06:00:00 AM,48,-122,0,1,1
19591,58thStGreenway22ndAve,04/24/2016 07:00:00 AM,48,-122,1,1,2
19592,58thStGreenway22ndAve,04/24/2016 08:00:00 AM,48,-122,0,3,3
19593,58thStGreenway22ndAve,04/24/2016 09:00:00 AM,48,-122,4,0,4
19594,58thStGreenway22ndAve,04/24/2016 10:00:00 AM,48,-122,1,0,1
19595,58thStGreenway22ndAve,04/24/2016 11:00:00 AM,48,-122,1,0,1
19596,58thStGreenway22ndAve,04/24/2016 12:00:00 PM,48,-122,4,1,5
19597,58thStGreenway22ndAve,04/24/2016 01:00:00 PM,48,-122,4,1,5
19598,58thStGreenway22ndAve,04/24/2016 02:00:00 PM,48,-122,3,3,6
19599,58thStGreenway22ndAve,04/24/2016 03:00:00 PM,48,-122,5,6,11
19600,58thStGreenway22ndAve,04/24/2016 04:00:00 PM,48,-122,5,2,7
19601,58thStGreenway22ndAve,04/24/2016 05:00:00 PM,48,-122,2,3,5
19602,58thStGreenway22ndAve,04/24/2016 06:00:00 PM,48,-122,1,3,4
19603,58thStGreenway22ndAve,04/24/2016 07:00:00 PM,48,-122,0,1,1
19604,58thStGreenway22ndAve,04/24/2016 08:00:00 PM,48,-122,2,2,4
19605,58thStGreenway22ndAve,04/24/2016 09:00:00 PM,48,-122,1,0,1
19606,58thStGreenway22ndAve,04/24/2016 10:00:00 PM,48,-122,1,1,2
19607,58thStGreenway22ndAve,04/24/2016 11:00:00 PM,48,-122,0,0,0
19608,58thStGreenway22ndAve,04/25/2016 12:00:00 AM,48,-122,0,0,0
19609,58thStGreenway22ndAve,04/25/2016 01:00:00 AM,48,-122,0,0,0
19610,58thStGreenway22ndAve,04/25/2016 02:00:00 AM,48,-122,0,0,0
19611,58thStGreenway22ndAve,04/25/2016 03:00:00 AM,48,-122,0,0,0
19612,58thStGreenway22ndAve,04/25/2016 04:00:00 AM,48,-122,1,0,1
19613,58thStGreenway22ndAve,04/25/2016 05:00:00 AM,48,-122,1,2,3
19614,58thStGreenway22ndAve,04/25/2016 06:00:00 AM,48,-122,1,1,2
19615,58thStGreenway22ndAve,04/25/2016 07:00:00 AM,48,-122,2,7,9
19616,58thStGreenway22ndAve,04/25/2016 08:00:00 AM,48,-122,5,5,10
19617,58thStGreenway22ndAve,04/25/2016 09:00:00 AM,48,-122,2,0,2
19618,58thStGreenway22ndAve,04/25/2016 10:00:00 AM,48,-122,2,3,5
19619,58thStGreenway22ndAve,04/25/2016 11:00:00 AM,48,-122,2,3,5
19620,58thStGreenway22ndAve,04/25/2016 12:00:00 PM,48,-122,4,3,7
19621,58thStGreenway22ndAve,04/25/2016 01:00:00 PM,48,-122,4,2,6
19622,58thStGreenway22ndAve,04/25/2016 02:00:00 PM,48,-122,5,6,11
19623,58thStGreenway22ndAve,04/25/2016 03:00:00 PM,48,-122,6,5,11
19624,58thStGreenway22ndAve,04/25/2016 04:00:00 PM,48,-122,5,2,7
19625,58thStGreenway22ndAve,04/25/2016 05:00:00 PM,48,-122,16,2,18
19626,58thStGreenway22ndAve,04/25/2016 06:00:00 PM,48,-122,10,10,20
19627,58thStGreenway22ndAve,04/25/2016 07:00:00 PM,48,-122,5,2,7
19628,58thStGreenway22ndAve,04/25/2016 08:00:00 PM,48,-122,6,5,11
19629,58thStGreenway22ndAve,04/25/2016 09:00:00 PM,48,-122,0,1,1
19630,58thStGreenway22ndAve,04/25/2016 10:00:00 PM,48,-122,0,1,1
19631,58thStGreenway22ndAve,04/25/2016 11:00:00 PM,48,-122,1,0,1
19632,58thStGreenway22ndAve,04/26/2016 12:00:00 AM,48,-122,0,0,0
19633,58thStGreenway22ndAve,04/26/2016 01:00:00 AM,48,-122,0,1,1
19634,58thStGreenway22ndAve,04/26/2016 02:00:00 AM,48,-122,0,0,0
19635,58thStGreenway22ndAve,04/26/2016 03:00:00 AM,48,-122,0,0,0
19636,58thStGreenway22ndAve,04/26/2016 04:00:00 AM,48,-122,0,0,0
19637,58thStGreenway22ndAve,04/26/2016 05:00:00 AM,48,-122,1,2,3
19638,58thStGreenway22ndAve,04/26/2016 06:00:00 AM,48,-122,1,1,2
19639,58thStGreenway22ndAve,04/26/2016 07:00:00 AM,48,-122,4,1,5
19640,58thStGreenway22ndAve,04/26/2016 08:00:00 AM,48,-122,3,12,15
19641,58thStGreenway22ndAve,04/26/2016 09:00:00 AM,48,-122,4,6,10
19642,58thStGreenway22ndAve,04/26/2016 10:00:00 AM,48,-122,4,1,5
19643,58thStGreenway22ndAve,04/26/2016 11:00:00 AM,48,-122,0,1,1
19644,58thStGreenway22ndAve,04/26/2016 12:00:00 PM,48,-122,2,2,4
19645,58thStGreenway22ndAve,04/26/2016 01:00:00 PM,48,-122,3,1,4
19646,58thStGreenway22ndAve,04/26/2016 02:00:00 PM,48,-122,6,2,8
19647,58thStGreenway22ndAve,04/26/2016 03:00:00 PM,48,-122,4,5,9
19648,58thStGreenway22ndAve,04/26/2016 04:00:00 PM,48,-122,4,5,9
19649,58thStGreenway22ndAve,04/26/2016 05:00:00 PM,48,-122,12,8,20
19650,58thStGreenway22ndAve,04/26/2016 06:00:00 PM,48,-122,4,7,11
19651,58thStGreenway22ndAve,04/26/2016 07:00:00 PM,48,-122,7,4,11
19652,58thStGreenway22ndAve,04/26/2016 08:00:00 PM,48,-122,4,1,5
19653,58thStGreenway22ndAve,04/26/2016 09:00:00 PM,48,-122,5,4,9
19654,58thStGreenway22ndAve,04/26/2016 10:00:00 PM,48,-122,0,1,1
19655,58thStGreenway22ndAve,04/26/2016 11:00:00 PM,48,-122,1,0,1
19656,58thStGreenway22ndAve,04/27/2016 12:00:00 AM,48,-122,1,2,3
19657,58thStGreenway22ndAve,04/27/2016 01:00:00 AM,48,-122,0,0,0
19658,58thStGreenway22ndAve,04/27/2016 02:00:00 AM,48,-122,0,0,0
19659,58thStGreenway22ndAve,04/27/2016 03:00:00 AM,48,-122,0,0,0
19660,58thStGreenway22ndAve,04/27/2016 04:00:00 AM,48,-122,0,0,0
19661,58thStGreenway22ndAve,04/27/2016 05:00:00 AM,48,-122,0,3,3
19662,58thStGreenway22ndAve,04/27/2016 06:00:00 AM,48,-122,3,0,3
19663,58thStGreenway22ndAve,04/27/2016 07:00:00 AM,48,-122,6,4,10
19664,58thStGreenway22ndAve,04/27/2016 08:00:00 AM,48,-122,3,7,10
19665,58thStGreenway22ndAve,04/27/2016 09:00:00 AM,48,-122,5,4,9
19666,58thStGreenway22ndAve,04/27/2016 10:00:00 AM,48,-122,1,5,6
19667,58thStGreenway22ndAve,04/27/2016 11:00:00 AM,48,-122,2,7,9
19668,58thStGreenway22ndAve,04/27/2016 12:00:00 PM,48,-122,7,6,13
19669,58thStGreenway22ndAve,04/27/2016 01:00:00 PM,48,-122,5,1,6
19670,58thStGreenway22ndAve,04/27/2016 02:00:00 PM,48,-122,5,3,8
19671,58thStGreenway22ndAve,04/27/2016 03:00:00 PM,48,-122,4,4,8
19672,58thStGreenway22ndAve,04/27/2016 04:00:00 PM,48,-122,8,5,13
19673,58thStGreenway22ndAve,04/27/2016 05:00:00 PM,48,-122,12,8,20
19674,58thStGreenway22ndAve,04/27/2016 06:00:00 PM,48,-122,12,11,23
19675,58thStGreenway22ndAve,04/27/2016 07:00:00 PM,48,-122,10,4,14
19676,58thStGreenway22ndAve,04/27/2016 08:00:00 PM,48,-122,5,5,10
19677,58thStGreenway22ndAve,04/27/2016 09:00:00 PM,48,-122,1,1,2
19678,58thStGreenway22ndAve,04/27/2016 10:00:00 PM,48,-122,0,0,0
19679,58thStGreenway22ndAve,04/27/2016 11:00:00 PM,48,-122,0,0,0
19680,58thStGreenway22ndAve,04/28/2016 12:00:00 AM,48,-122,0,0,0
19681,58thStGreenway22ndAve,04/28/2016 01:00:00 AM,48,-122,0,1,1
19682,58thStGreenway22ndAve,04/28/2016 02:00:00 AM,48,-122,0,0,0
19683,58thStGreenway22ndAve,04/28/2016 03:00:00 AM,48,-122,0,0,0
19684,58thStGreenway22ndAve,04/28/2016 04:00:00 AM,48,-122,0,0,0
19685,58thStGreenway22ndAve,04/28/2016 05:00:00 AM,48,-122,0,2,2
19686,58thStGreenway22ndAve,04/28/2016 06:00:00 AM,48,-122,1,2,3
19687,58thStGreenway22ndAve,04/28/2016 07:00:00 AM,48,-122,6,5,11
19688,58thStGreenway22ndAve,04/28/2016 08:00:00 AM,48,-122,6,6,12
19689,58thStGreenway22ndAve,04/28/2016 09:00:00 AM,48,-122,3,4,7
19690,58thStGreenway22ndAve,04/28/2016 10:00:00 AM,48,-122,5,1,6
19691,58thStGreenway22ndAve,04/28/2016 11:00:00 AM,48,-122,6,1,7
19692,58thStGreenway22ndAve,04/28/2016 12:00:00 PM,48,-122,6,1,7
19693,58thStGreenway22ndAve,04/28/2016 01:00:00 PM,48,-122,5,4,9
19694,58thStGreenway22ndAve,04/28/2016 02:00:00 PM,48,-122,2,5,7
19695,58thStGreenway22ndAve,04/28/2016 03:00:00 PM,48,-122,4,7,11
19696,58thStGreenway22ndAve,04/28/2016 04:00:00 PM,48,-122,5,6,11
19697,58thStGreenway22ndAve,04/28/2016 05:00:00 PM,48,-122,15,1,16
19698,58thStGreenway22ndAve,04/28/2016 06:00:00 PM,48,-122,9,7,16
19699,58thStGreenway22ndAve,04/28/2016 07:00:00 PM,48,-122,5,2,7
19700,58thStGreenway22ndAve,04/28/2016 08:00:00 PM,48,-122,0,4,4
19701,58thStGreenway22ndAve,04/28/2016 09:00:00 PM,48,-122,6,3,9
19702,58thStGreenway22ndAve,04/28/2016 10:00:00 PM,48,-122,2,0,2
19703,58thStGreenway22ndAve,04/28/2016 11:00:00 PM,48,-122,0,0,0
19704,58thStGreenway22ndAve,04/29/2016 12:00:00 AM,48,-122,1,0,1
19705,58thStGreenway22ndAve,04/29/2016 01:00:00 AM,48,-122,0,0,0
19706,58thStGreenway22ndAve,04/29/2016 02:00:00 AM,48,-122,4,0,4
19707,58thStGreenway22ndAve,04/29/2016 03:00:00 AM,48,-122,0,0,0
19708,58thStGreenway22ndAve,04/29/2016 04:00:00 AM,48,-122,0,0,0
19709,58thStGreenway22ndAve,04/29/2016 05:00:00 AM,48,-122,0,2,2
19710,58thStGreenway22ndAve,04/29/2016 06:00:00 AM,48,-122,0,1,1
19711,58thStGreenway22ndAve,04/29/2016 07:00:00 AM,48,-122,3,3,6
19712,58thStGreenway22ndAve,04/29/2016 08:00:00 AM,48,-122,3,4,7
19713,58thStGreenway22ndAve,04/29/2016 09:00:00 AM,48,-122,3,3,6
19714,58thStGreenway22ndAve,04/29/2016 10:00:00 AM,48,-122,3,2,5
19715,58thStGreenway22ndAve,04/29/2016 11:00:00 AM,48,-122,5,2,7
19716,58thStGreenway22ndAve,04/29/2016 12:00:00 PM,48,-122,0,2,2
19717,58thStGreenway22ndAve,04/29/2016 01:00:00 PM,48,-122,1,4,5
19718,58thStGreenway22ndAve,04/29/2016 02:00:00 PM,48,-122,4,3,7
19719,58thStGreenway22ndAve,04/29/2016 03:00:00 PM,48,-122,5,5,10
19720,58thStGreenway22ndAve,04/29/2016 04:00:00 PM,48,-122,4,3,7
19721,58thStGreenway22ndAve,04/29/2016 05:00:00 PM,48,-122,9,6,15
19722,58thStGreenway22ndAve,04/29/2016 06:00:00 PM,48,-122,9,6,15
19723,58thStGreenway22ndAve,04/29/2016 07:00:00 PM,48,-122,2,2,4
19724,58thStGreenway22ndAve,04/29/2016 08:00:00 PM,48,-122,4,3,7
19725,58thStGreenway22ndAve,04/29/2016 09:00:00 PM,48,-122,2,3,5
19726,58thStGreenway22ndAve,04/29/2016 10:00:00 PM,48,-122,1,1,2
19727,58thStGreenway22ndAve,04/29/2016 11:00:00 PM,48,-122,1,3,4
19728,58thStGreenway22ndAve,04/30/2016 12:00:00 AM,48,-122,1,0,1
19729,58thStGreenway22ndAve,04/30/2016 01:00:00 AM,48,-122,0,0,0
19730,58thStGreenway22ndAve,04/30/2016 02:00:00 AM,48,-122,0,0,0
19731,58thStGreenway22ndAve,04/30/2016 03:00:00 AM,48,-122,0,1,1
19732,58thStGreenway22ndAve,04/30/2016 04:00:00 AM,48,-122,0,0,0
19733,58thStGreenway22ndAve,04/30/2016 05:00:00 AM,48,-122,0,1,1
19734,58thStGreenway22ndAve,04/30/2016 06:00:00 AM,48,-122,0,1,1
19735,58thStGreenway22ndAve,04/30/2016 07:00:00 AM,48,-122,0,1,1
19736,58thStGreenway22ndAve,04/30/2016 08:00:00 AM,48,-122,1,0,1
19737,58thStGreenway22ndAve,04/30/2016 09:00:00 AM,48,-122,7,4,11
19738,58thStGreenway22ndAve,04/30/2016 10:00:00 AM,48,-122,11,7,18
19739,58thStGreenway22ndAve,04/30/2016 11:00:00 AM,48,-122,4,3,7
19740,58thStGreenway22ndAve,04/30/2016 12:00:00 PM,48,-122,9,6,15
19741,58thStGreenway22ndAve,04/30/2016 01:00:00 PM,48,-122,13,9,22
19742,58thStGreenway22ndAve,04/30/2016 02:00:00 PM,48,-122,6,14,20
19743,58thStGreenway22ndAve,04/30/2016 03:00:00 PM,48,-122,8,16,24
19744,58thStGreenway22ndAve,04/30/2016 04:00:00 PM,48,-122,16,15,31
19745,58thStGreenway22ndAve,04/30/2016 05:00:00 PM,48,-122,10,8,18
19746,58thStGreenway22ndAve,04/30/2016 06:00:00 PM,48,-122,5,5,10
19747,58thStGreenway22ndAve,04/30/2016 07:00:00 PM,48,-122,5,4,9
19748,58thStGreenway22ndAve,04/30/2016 08:00:00 PM,48,-122,11,0,11
19749,58thStGreenway22ndAve,04/30/2016 09:00:00 PM,48,-122,2,0,2
19750,58thStGreenway22ndAve,04/30/2016 10:00:00 PM,48,-122,1,1,2
19751,58thStGreenway22ndAve,04/30/2016 11:00:00 PM,48,-122,0,1,1
19752,58thStGreenway22ndAve,05/01/2016 12:00:00 AM,48,-122,2,0,2
19753,58thStGreenway22ndAve,05/01/2016 01:00:00 AM,48,-122,0,0,0
19754,58thStGreenway22ndAve,05/01/2016 02:00:00 AM,48,-122,0,1,1
19755,58thStGreenway22ndAve,05/01/2016 03:00:00 AM,48,-122,0,0,0
19756,58thStGreenway22ndAve,05/01/2016 04:00:00 AM,48,-122,1,0,1
19757,58thStGreenway22ndAve,05/01/2016 05:00:00 AM,48,-122,0,0,0
19758,58thStGreenway22ndAve,05/01/2016 06:00:00 AM,48,-122,0,0,0
19759,58thStGreenway22ndAve,05/01/2016 07:00:00 AM,48,-122,0,1,1
19760,58thStGreenway22ndAve,05/01/2016 08:00:00 AM,48,-122,1,0,1
19761,58thStGreenway22ndAve,05/01/2016 09:00:00 AM,48,-122,5,12,17
19762,58thStGreenway22ndAve,05/01/2016 10:00:00 AM,48,-122,11,5,16
19763,58thStGreenway22ndAve,05/01/2016 11:00:00 AM,48,-122,14,14,28
19764,58thStGreenway22ndAve,05/01/2016 12:00:00 PM,48,-122,17,9,26
19765,58thStGreenway22ndAve,05/01/2016 01:00:00 PM,48,-122,8,16,24
19766,58thStGreenway22ndAve,05/01/2016 02:00:00 PM,48,-122,9,20,29
19767,58thStGreenway22ndAve,05/01/2016 03:00:00 PM,48,-122,8,13,21
19768,58thStGreenway22ndAve,05/01/2016 04:00:00 PM,48,-122,16,10,26
19769,58thStGreenway22ndAve,05/01/2016 05:00:00 PM,48,-122,12,4,16
19770,58thStGreenway22ndAve,05/01/2016 06:00:00 PM,48,-122,9,4,13
19771,58thStGreenway22ndAve,05/01/2016 07:00:00 PM,48,-122,5,1,6
19772,58thStGreenway22ndAve,05/01/2016 08:00:00 PM,48,-122,7,6,13
19773,58thStGreenway22ndAve,05/01/2016 09:00:00 PM,48,-122,0,1,1
19774,58thStGreenway22ndAve,05/01/2016 10:00:00 PM,48,-122,1,0,1
19775,58thStGreenway22ndAve,05/01/2016 11:00:00 PM,48,-122,0,0,0
19776,58thStGreenway22ndAve,05/02/2016 12:00:00 AM,48,-122,0,0,0
19777,58thStGreenway22ndAve,05/02/2016 01:00:00 AM,48,-122,0,0,0
19778,58thStGreenway22ndAve,05/02/2016 02:00:00 AM,48,-122,0,1,1
19779,58thStGreenway22ndAve,05/02/2016 03:00:00 AM,48,-122,1,0,1
19780,58thStGreenway22ndAve,05/02/2016 04:00:00 AM,48,-122,0,0,0
19781,58thStGreenway22ndAve,05/02/2016 05:00:00 AM,48,-122,1,1,2
19782,58thStGreenway22ndAve,05/02/2016 06:00:00 AM,48,-122,2,4,6
19783,58thStGreenway22ndAve,05/02/2016 07:00:00 AM,48,-122,8,9,17
19784,58thStGreenway22ndAve,05/02/2016 08:00:00 AM,48,-122,11,10,21
19785,58thStGreenway22ndAve,05/02/2016 09:00:00 AM,48,-122,6,10,16
19786,58thStGreenway22ndAve,05/02/2016 10:00:00 AM,48,-122,7,5,12
19787,58thStGreenway22ndAve,05/02/2016 11:00:00 AM,48,-122,4,2,6
19788,58thStGreenway22ndAve,05/02/2016 12:00:00 PM,48,-122,8,7,15
19789,58thStGreenway22ndAve,05/02/2016 01:00:00 PM,48,-122,5,5,10
19790,58thStGreenway22ndAve,05/02/2016 02:00:00 PM,48,-122,8,11,19
19791,58thStGreenway22ndAve,05/02/2016 03:00:00 PM,48,-122,7,11,18
19792,58thStGreenway22ndAve,05/02/2016 04:00:00 PM,48,-122,7,11,18
19793,58thStGreenway22ndAve,05/02/2016 05:00:00 PM,48,-122,15,12,27
19794,58thStGreenway22ndAve,05/02/2016 06:00:00 PM,48,-122,12,9,21
19795,58thStGreenway22ndAve,05/02/2016 07:00:00 PM,48,-122,9,7,16
19796,58thStGreenway22ndAve,05/02/2016 08:00:00 PM,48,-122,10,7,17
19797,58thStGreenway22ndAve,05/02/2016 09:00:00 PM,48,-122,6,2,8
19798,58thStGreenway22ndAve,05/02/2016 10:00:00 PM,48,-122,1,0,1
19799,58thStGreenway22ndAve,05/02/2016 11:00:00 PM,48,-122,0,1,1
19800,58thStGreenway22ndAve,05/03/2016 12:00:00 AM,48,-122,1,0,1
19801,58thStGreenway22ndAve,05/03/2016 01:00:00 AM,48,-122,1,0,1
19802,58thStGreenway22ndAve,05/03/2016 02:00:00 AM,48,-122,0,0,0
19803,58thStGreenway22ndAve,05/03/2016 03:00:00 AM,48,-122,0,0,0
19804,58thStGreenway22ndAve,05/03/2016 04:00:00 AM,48,-122,0,0,0
19805,58thStGreenway22ndAve,05/03/2016 05:00:00 AM,48,-122,2,2,4
19806,58thStGreenway22ndAve,05/03/2016 06:00:00 AM,48,-122,1,1,2
19807,58thStGreenway22ndAve,05/03/2016 07:00:00 AM,48,-122,4,5,9
19808,58thStGreenway22ndAve,05/03/2016 08:00:00 AM,48,-122,6,12,18
19809,58thStGreenway22ndAve,05/03/2016 09:00:00 AM,48,-122,6,7,13
19810,58thStGreenway22ndAve,05/03/2016 10:00:00 AM,48,-122,9,5,14
19811,58thStGreenway22ndAve,05/03/2016 11:00:00 AM,48,-122,4,6,10
19812,58thStGreenway22ndAve,05/03/2016 12:00:00 PM,48,-122,1,9,10
19813,58thStGreenway22ndAve,05/03/2016 01:00:00 PM,48,-122,4,1,5
19814,58thStGreenway22ndAve,05/03/2016 02:00:00 PM,48,-122,12,3,15
19815,58thStGreenway22ndAve,05/03/2016 03:00:00 PM,48,-122,8,5,13
19816,58thStGreenway22ndAve,05/03/2016 04:00:00 PM,48,-122,9,10,19
19817,58thStGreenway22ndAve,05/03/2016 05:00:00 PM,48,-122,11,11,22
19818,58thStGreenway22ndAve,05/03/2016 06:00:00 PM,48,-122,8,7,15
19819,58thStGreenway22ndAve,05/03/2016 07:00:00 PM,48,-122,8,4,12
19820,58thStGreenway22ndAve,05/03/2016 08:00:00 PM,48,-122,5,1,6
19821,58thStGreenway22ndAve,05/03/2016 09:00:00 PM,48,-122,4,3,7
19822,58thStGreenway22ndAve,05/03/2016 10:00:00 PM,48,-122,0,0,0
19823,58thStGreenway22ndAve,05/03/2016 11:00:00 PM,48,-122,0,2,2
19824,58thStGreenway22ndAve,05/04/2016 12:00:00 AM,48,-122,3,0,3
19825,58thStGreenway22ndAve,05/04/2016 01:00:00 AM,48,-122,0,0,0
19826,58thStGreenway22ndAve,05/04/2016 02:00:00 AM,48,-122,0,0,0
19827,58thStGreenway22ndAve,05/04/2016 03:00:00 AM,48,-122,0,1,1
19828,58thStGreenway22ndAve,05/04/2016 04:00:00 AM,48,-122,0,0,0
19829,58thStGreenway22ndAve,05/04/2016 05:00:00 AM,48,-122,1,1,2
19830,58thStGreenway22ndAve,05/04/2016 06:00:00 AM,48,-122,0,0,0
19831,58thStGreenway22ndAve,05/04/2016 07:00:00 AM,48,-122,4,7,11
19832,58thStGreenway22ndAve,05/04/2016 08:00:00 AM,48,-122,11,9,20
19833,58thStGreenway22ndAve,05/04/2016 09:00:00 AM,48,-122,7,6,13
19834,58thStGreenway22ndAve,05/04/2016 10:00:00 AM,48,-122,2,3,5
19835,58thStGreenway22ndAve,05/04/2016 11:00:00 AM,48,-122,1,5,6
19836,58thStGreenway22ndAve,05/04/2016 12:00:00 PM,48,-122,2,1,3
19837,58thStGreenway22ndAve,05/04/2016 01:00:00 PM,48,-122,6,1,7
19838,58thStGreenway22ndAve,05/04/2016 02:00:00 PM,48,-122,1,4,5
19839,58thStGreenway22ndAve,05/04/2016 03:00:00 PM,48,-122,5,3,8
19840,58thStGreenway22ndAve,05/04/2016 04:00:00 PM,48,-122,6,6,12
19841,58thStGreenway22ndAve,05/04/2016 05:00:00 PM,48,-122,12,6,18
19842,58thStGreenway22ndAve,05/04/2016 06:00:00 PM,48,-122,7,8,15
19843,58thStGreenway22ndAve,05/04/2016 07:00:00 PM,48,-122,4,2,6
19844,58thStGreenway22ndAve,05/04/2016 08:00:00 PM,48,-122,4,3,7
19845,58thStGreenway22ndAve,05/04/2016 09:00:00 PM,48,-122,5,1,6
19846,58thStGreenway22ndAve,05/04/2016 10:00:00 PM,48,-122,1,0,1
19847,58thStGreenway22ndAve,05/04/2016 11:00:00 PM,48,-122,0,0,0
19848,58thStGreenway22ndAve,05/05/2016 12:00:00 AM,48,-122,0,0,0
19849,58thStGreenway22ndAve,05/05/2016 01:00:00 AM,48,-122,0,0,0
19850,58thStGreenway22ndAve,05/05/2016 02:00:00 AM,48,-122,0,0,0
19851,58thStGreenway22ndAve,05/05/2016 03:00:00 AM,48,-122,0,0,0
19852,58thStGreenway22ndAve,05/05/2016 04:00:00 AM,48,-122,0,0,0
19853,58thStGreenway22ndAve,05/05/2016 05:00:00 AM,48,-122,1,1,2
19854,58thStGreenway22ndAve,05/05/2016 06:00:00 AM,48,-122,4,1,5
19855,58thStGreenway22ndAve,05/05/2016 07:00:00 AM,48,-122,4,6,10
19856,58thStGreenway22ndAve,05/05/2016 08:00:00 AM,48,-122,9,11,20
19857,58thStGreenway22ndAve,05/05/2016 09:00:00 AM,48,-122,7,3,10
19858,58thStGreenway22ndAve,05/05/2016 10:00:00 AM,48,-122,7,10,17
19859,58thStGreenway22ndAve,05/05/2016 11:00:00 AM,48,-122,0,2,2
19860,58thStGreenway22ndAve,05/05/2016 12:00:00 PM,48,-122,5,1,6
19861,58thStGreenway22ndAve,05/05/2016 01:00:00 PM,48,-122,5,7,12
19862,58thStGreenway22ndAve,05/05/2016 02:00:00 PM,48,-122,8,3,11
19863,58thStGreenway22ndAve,05/05/2016 03:00:00 PM,48,-122,1,0,1
19864,58thStGreenway22ndAve,05/05/2016 04:00:00 PM,48,-122,10,7,17
19865,58thStGreenway22ndAve,05/05/2016 05:00:00 PM,48,-122,13,7,20
19866,58thStGreenway22ndAve,05/05/2016 06:00:00 PM,48,-122,16,10,26
19867,58thStGreenway22ndAve,05/05/2016 07:00:00 PM,48,-122,5,8,13
19868,58thStGreenway22ndAve,05/05/2016 08:00:00 PM,48,-122,11,6,17
19869,58thStGreenway22ndAve,05/05/2016 09:00:00 PM,48,-122,1,0,1
19870,58thStGreenway22ndAve,05/05/2016 10:00:00 PM,48,-122,0,1,1
19871,58thStGreenway22ndAve,05/05/2016 11:00:00 PM,48,-122,0,0,0
19872,58thStGreenway22ndAve,05/06/2016 12:00:00 AM,48,-122,2,0,2
19873,58thStGreenway22ndAve,05/06/2016 01:00:00 AM,48,-122,0,0,0
19874,58thStGreenway22ndAve,05/06/2016 02:00:00 AM,48,-122,0,0,0
19875,58thStGreenway22ndAve,05/06/2016 03:00:00 AM,48,-122,0,2,2
19876,58thStGreenway22ndAve,05/06/2016 04:00:00 AM,48,-122,0,0,0
19877,58thStGreenway22ndAve,05/06/2016 05:00:00 AM,48,-122,0,1,1
19878,58thStGreenway22ndAve,05/06/2016 06:00:00 AM,48,-122,0,2,2
19879,58thStGreenway22ndAve,05/06/2016 07:00:00 AM,48,-122,4,6,10
19880,58thStGreenway22ndAve,05/06/2016 08:00:00 AM,48,-122,6,9,15
19881,58thStGreenway22ndAve,05/06/2016 09:00:00 AM,48,-122,5,6,11
19882,58thStGreenway22ndAve,05/06/2016 10:00:00 AM,48,-122,5,2,7
19883,58thStGreenway22ndAve,05/06/2016 11:00:00 AM,48,-122,3,2,5
19884,58thStGreenway22ndAve,05/06/2016 12:00:00 PM,48,-122,3,3,6
19885,58thStGreenway22ndAve,05/06/2016 01:00:00 PM,48,-122,6,7,13
19886,58thStGreenway22ndAve,05/06/2016 02:00:00 PM,48,-122,10,11,21
19887,58thStGreenway22ndAve,05/06/2016 03:00:00 PM,48,-122,8,10,18
19888,58thStGreenway22ndAve,05/06/2016 04:00:00 PM,48,-122,8,6,14
19889,58thStGreenway22ndAve,05/06/2016 05:00:00 PM,48,-122,11,19,30
19890,58thStGreenway22ndAve,05/06/2016 06:00:00 PM,48,-122,6,9,15
19891,58thStGreenway22ndAve,05/06/2016 07:00:00 PM,48,-122,7,8,15
19892,58thStGreenway22ndAve,05/06/2016 08:00:00 PM,48,-122,9,5,14
19893,58thStGreenway22ndAve,05/06/2016 09:00:00 PM,48,-122,4,3,7
19894,58thStGreenway22ndAve,05/06/2016 10:00:00 PM,48,-122,4,0,4
19895,58thStGreenway22ndAve,05/06/2016 11:00:00 PM,48,-122,0,0,0
19896,58thStGreenway22ndAve,05/07/2016 12:00:00 AM,48,-122,1,0,1
19897,58thStGreenway22ndAve,05/07/2016 01:00:00 AM,48,-122,0,2,2
19898,58thStGreenway22ndAve,05/07/2016 02:00:00 AM,48,-122,0,1,1
19899,58thStGreenway22ndAve,05/07/2016 03:00:00 AM,48,-122,0,0,0
19900,58thStGreenway22ndAve,05/07/2016 04:00:00 AM,48,-122,1,0,1
19901,58thStGreenway22ndAve,05/07/2016 05:00:00 AM,48,-122,0,0,0
19902,58thStGreenway22ndAve,05/07/2016 06:00:00 AM,48,-122,0,2,2
19903,58thStGreenway22ndAve,05/07/2016 07:00:00 AM,48,-122,3,2,5
19904,58thStGreenway22ndAve,05/07/2016 08:00:00 AM,48,-122,2,5,7
19905,58thStGreenway22ndAve,05/07/2016 09:00:00 AM,48,-122,14,0,14
19906,58thStGreenway22ndAve,05/07/2016 10:00:00 AM,48,-122,5,11,16
19907,58thStGreenway22ndAve,05/07/2016 11:00:00 AM,48,-122,9,20,29
19908,58thStGreenway22ndAve,05/07/2016 12:00:00 PM,48,-122,6,7,13
19909,58thStGreenway22ndAve,05/07/2016 01:00:00 PM,48,-122,13,5,18
19910,58thStGreenway22ndAve,05/07/2016 02:00:00 PM,48,-122,17,17,34
19911,58thStGreenway22ndAve,05/07/2016 03:00:00 PM,48,-122,7,9,16
19912,58thStGreenway22ndAve,05/07/2016 04:00:00 PM,48,-122,17,18,35
19913,58thStGreenway22ndAve,05/07/2016 05:00:00 PM,48,-122,9,4,13
19914,58thStGreenway22ndAve,05/07/2016 06:00:00 PM,48,-122,3,12,15
19915,58thStGreenway22ndAve,05/07/2016 07:00:00 PM,48,-122,14,5,19
19916,58thStGreenway22ndAve,05/07/2016 08:00:00 PM,48,-122,7,2,9
19917,58thStGreenway22ndAve,05/07/2016 09:00:00 PM,48,-122,2,5,7
19918,58thStGreenway22ndAve,05/07/2016 10:00:00 PM,48,-122,1,2,3
19919,58thStGreenway22ndAve,05/07/2016 11:00:00 PM,48,-122,0,1,1
19920,58thStGreenway22ndAve,05/08/2016 12:00:00 AM,48,-122,0,0,0
19921,58thStGreenway22ndAve,05/08/2016 01:00:00 AM,48,-122,0,3,3
19922,58thStGreenway22ndAve,05/08/2016 02:00:00 AM,48,-122,0,0,0
19923,58thStGreenway22ndAve,05/08/2016 03:00:00 AM,48,-122,0,0,0
19924,58thStGreenway22ndAve,05/08/2016 04:00:00 AM,48,-122,0,0,0
19925,58thStGreenway22ndAve,05/08/2016 05:00:00 AM,48,-122,0,0,0
19926,58thStGreenway22ndAve,05/08/2016 06:00:00 AM,48,-122,0,1,1
19927,58thStGreenway22ndAve,05/08/2016 07:00:00 AM,48,-122,1,0,1
19928,58thStGreenway22ndAve,05/08/2016 08:00:00 AM,48,-122,2,3,5
19929,58thStGreenway22ndAve,05/08/2016 09:00:00 AM,48,-122,4,0,4
19930,58thStGreenway22ndAve,05/08/2016 10:00:00 AM,48,-122,1,6,7
19931,58thStGreenway22ndAve,05/08/2016 11:00:00 AM,48,-122,7,9,16
19932,58thStGreenway22ndAve,05/08/2016 12:00:00 PM,48,-122,7,9,16
19933,58thStGreenway22ndAve,05/08/2016 01:00:00 PM,48,-122,5,4,9
19934,58thStGreenway22ndAve,05/08/2016 02:00:00 PM,48,-122,1,7,8
19935,58thStGreenway22ndAve,05/08/2016 03:00:00 PM,48,-122,2,8,10
19936,58thStGreenway22ndAve,05/08/2016 04:00:00 PM,48,-122,6,3,9
19937,58thStGreenway22ndAve,05/08/2016 05:00:00 PM,48,-122,2,2,4
19938,58thStGreenway22ndAve,05/08/2016 06:00:00 PM,48,-122,4,3,7
19939,58thStGreenway22ndAve,05/08/2016 07:00:00 PM,48,-122,3,1,4
19940,58thStGreenway22ndAve,05/08/2016 08:00:00 PM,48,-122,0,1,1
19941,58thStGreenway22ndAve,05/08/2016 09:00:00 PM,48,-122,6,0,6
19942,58thStGreenway22ndAve,05/08/2016 10:00:00 PM,48,-122,1,0,1
19943,58thStGreenway22ndAve,05/08/2016 11:00:00 PM,48,-122,0,0,0
19944,58thStGreenway22ndAve,05/09/2016 12:00:00 AM,48,-122,0,0,0
19945,58thStGreenway22ndAve,05/09/2016 01:00:00 AM,48,-122,0,0,0
19946,58thStGreenway22ndAve,05/09/2016 02:00:00 AM,48,-122,0,1,1
19947,58thStGreenway22ndAve,05/09/2016 03:00:00 AM,48,-122,0,0,0
19948,58thStGreenway22ndAve,05/09/2016 04:00:00 AM,48,-122,0,0,0
19949,58thStGreenway22ndAve,05/09/2016 05:00:00 AM,48,-122,0,1,1
19950,58thStGreenway22ndAve,05/09/2016 06:00:00 AM,48,-122,3,0,3
19951,58thStGreenway22ndAve,05/09/2016 07:00:00 AM,48,-122,7,4,11
19952,58thStGreenway22ndAve,05/09/2016 08:00:00 AM,48,-122,7,12,19
19953,58thStGreenway22ndAve,05/09/2016 09:00:00 AM,48,-122,3,3,6
19954,58thStGreenway22ndAve,05/09/2016 10:00:00 AM,48,-122,4,6,10
19955,58thStGreenway22ndAve,05/09/2016 11:00:00 AM,48,-122,5,2,7
19956,58thStGreenway22ndAve,05/09/2016 12:00:00 PM,48,-122,3,5,8
19957,58thStGreenway22ndAve,05/09/2016 01:00:00 PM,48,-122,3,7,10
19958,58thStGreenway22ndAve,05/09/2016 02:00:00 PM,48,-122,8,6,14
19959,58thStGreenway22ndAve,05/09/2016 03:00:00 PM,48,-122,4,6,10
19960,58thStGreenway22ndAve,05/09/2016 04:00:00 PM,48,-122,9,4,13
19961,58thStGreenway22ndAve,05/09/2016 05:00:00 PM,48,-122,11,11,22
19962,58thStGreenway22ndAve,05/09/2016 06:00:00 PM,48,-122,7,13,20
19963,58thStGreenway22ndAve,05/09/2016 07:00:00 PM,48,-122,5,9,14
19964,58thStGreenway22ndAve,05/09/2016 08:00:00 PM,48,-122,7,1,8
19965,58thStGreenway22ndAve,05/09/2016 09:00:00 PM,48,-122,1,1,2
19966,58thStGreenway22ndAve,05/09/2016 10:00:00 PM,48,-122,1,0,1
19967,58thStGreenway22ndAve,05/09/2016 11:00:00 PM,48,-122,1,1,2
19968,58thStGreenway22ndAve,05/10/2016 12:00:00 AM,48,-122,0,0,0
19969,58thStGreenway22ndAve,05/10/2016 01:00:00 AM,48,-122,0,0,0
19970,58thStGreenway22ndAve,05/10/2016 02:00:00 AM,48,-122,0,0,0
19971,58thStGreenway22ndAve,05/10/2016 03:00:00 AM,48,-122,0,0,0
19972,58thStGreenway22ndAve,05/10/2016 04:00:00 AM,48,-122,0,0,0
19973,58thStGreenway22ndAve,05/10/2016 05:00:00 AM,48,-122,0,2,2
19974,58thStGreenway22ndAve,05/10/2016 06:00:00 AM,48,-122,2,3,5
19975,58thStGreenway22ndAve,05/10/2016 07:00:00 AM,48,-122,8,4,12
19976,58thStGreenway22ndAve,05/10/2016 08:00:00 AM,48,-122,12,12,24
19977,58thStGreenway22ndAve,05/10/2016 09:00:00 AM,48,-122,4,6,10
19978,58thStGreenway22ndAve,05/10/2016 10:00:00 AM,48,-122,4,6,10
19979,58thStGreenway22ndAve,05/10/2016 11:00:00 AM,48,-122,5,6,11
19980,58thStGreenway22ndAve,05/10/2016 12:00:00 PM,48,-122,8,0,8
19981,58thStGreenway22ndAve,05/10/2016 01:00:00 PM,48,-122,4,2,6
19982,58thStGreenway22ndAve,05/10/2016 02:00:00 PM,48,-122,13,5,18
19983,58thStGreenway22ndAve,05/10/2016 03:00:00 PM,48,-122,10,14,24
19984,58thStGreenway22ndAve,05/10/2016 04:00:00 PM,48,-122,7,8,15
19985,58thStGreenway22ndAve,05/10/2016 05:00:00 PM,48,-122,9,8,17
19986,58thStGreenway22ndAve,05/10/2016 06:00:00 PM,48,-122,15,5,20
19987,58thStGreenway22ndAve,05/10/2016 07:00:00 PM,48,-122,2,12,14
19988,58thStGreenway22ndAve,05/10/2016 08:00:00 PM,48,-122,5,4,9
19989,58thStGreenway22ndAve,05/10/2016 09:00:00 PM,48,-122,2,0,2
19990,58thStGreenway22ndAve,05/10/2016 10:00:00 PM,48,-122,2,1,3
19991,58thStGreenway22ndAve,05/10/2016 11:00:00 PM,48,-122,1,0,1
19992,58thStGreenway22ndAve,05/11/2016 12:00:00 AM,48,-122,0,1,1
19993,58thStGreenway22ndAve,05/11/2016 01:00:00 AM,48,-122,1,0,1
19994,58thStGreenway22ndAve,05/11/2016 02:00:00 AM,48,-122,0,0,0
19995,58thStGreenway22ndAve,05/11/2016 03:00:00 AM,48,-122,0,0,0
19996,58thStGreenway22ndAve,05/11/2016 04:00:00 AM,48,-122,0,0,0
19997,58thStGreenway22ndAve,05/11/2016 05:00:00 AM,48,-122,0,1,1
19998,58thStGreenway22ndAve,05/11/2016 06:00:00 AM,48,-122,0,2,2
19999,58thStGreenway22ndAve,05/11/2016 07:00:00 AM,48,-122,7,7,14
20000,58thStGreenway22ndAve,05/11/2016 08:00:00 AM,48,-122,12,13,25
20001,58thStGreenway22ndAve,05/11/2016 09:00:00 AM,48,-122,6,7,13
20002,58thStGreenway22ndAve,05/11/2016 10:00:00 AM,48,-122,2,3,5
20003,58thStGreenway22ndAve,05/11/2016 11:00:00 AM,48,-122,5,7,12
20004,58thStGreenway22ndAve,05/11/2016 12:00:00 PM,48,-122,6,1,7
20005,58thStGreenway22ndAve,05/11/2016 01:00:00 PM,48,-122,5,4,9
20006,58thStGreenway22ndAve,05/11/2016 02:00:00 PM,48,-122,1,10,11
20007,58thStGreenway22ndAve,05/11/2016 03:00:00 PM,48,-122,6,6,12
20008,58thStGreenway22ndAve,05/11/2016 04:00:00 PM,48,-122,5,3,8
20009,58thStGreenway22ndAve,05/11/2016 05:00:00 PM,48,-122,12,20,32
20010,58thStGreenway22ndAve,05/11/2016 06:00:00 PM,48,-122,14,17,31
20011,58thStGreenway22ndAve,05/11/2016 07:00:00 PM,48,-122,11,13,24
20012,58thStGreenway22ndAve,05/11/2016 08:00:00 PM,48,-122,7,2,9
20013,58thStGreenway22ndAve,05/11/2016 09:00:00 PM,48,-122,4,0,4
20014,58thStGreenway22ndAve,05/11/2016 10:00:00 PM,48,-122,1,0,1
20015,58thStGreenway22ndAve,05/11/2016 11:00:00 PM,48,-122,0,1,1
20016,58thStGreenway22ndAve,05/12/2016 12:00:00 AM,48,-122,0,0,0
20017,58thStGreenway22ndAve,05/12/2016 01:00:00 AM,48,-122,2,1,3
20018,58thStGreenway22ndAve,05/12/2016 02:00:00 AM,48,-122,0,0,0
20019,58thStGreenway22ndAve,05/12/2016 03:00:00 AM,48,-122,0,0,0
20020,58thStGreenway22ndAve,05/12/2016 04:00:00 AM,48,-122,1,0,1
20021,58thStGreenway22ndAve,05/12/2016 05:00:00 AM,48,-122,0,1,1
20022,58thStGreenway22ndAve,05/12/2016 06:00:00 AM,48,-122,1,2,3
20023,58thStGreenway22ndAve,05/12/2016 07:00:00 AM,48,-122,6,6,12
20024,58thStGreenway22ndAve,05/12/2016 08:00:00 AM,48,-122,6,7,13
20025,58thStGreenway22ndAve,05/12/2016 09:00:00 AM,48,-122,5,7,12
20026,58thStGreenway22ndAve,05/12/2016 10:00:00 AM,48,-122,3,5,8
20027,58thStGreenway22ndAve,05/12/2016 11:00:00 AM,48,-122,3,5,8
20028,58thStGreenway22ndAve,05/12/2016 12:00:00 PM,48,-122,4,3,7
20029,58thStGreenway22ndAve,05/12/2016 01:00:00 PM,48,-122,1,2,3
20030,58thStGreenway22ndAve,05/12/2016 02:00:00 PM,48,-122,9,5,14
20031,58thStGreenway22ndAve,05/12/2016 03:00:00 PM,48,-122,9,5,14
20032,58thStGreenway22ndAve,05/12/2016 04:00:00 PM,48,-122,6,4,10
20033,58thStGreenway22ndAve,05/12/2016 05:00:00 PM,48,-122,17,16,33
20034,58thStGreenway22ndAve,05/12/2016 06:00:00 PM,48,-122,15,7,22
20035,58thStGreenway22ndAve,05/12/2016 07:00:00 PM,48,-122,8,5,13
20036,58thStGreenway22ndAve,05/12/2016 08:00:00 PM,48,-122,3,3,6
20037,58thStGreenway22ndAve,05/12/2016 09:00:00 PM,48,-122,7,4,11
20038,58thStGreenway22ndAve,05/12/2016 10:00:00 PM,48,-122,3,2,5
20039,58thStGreenway22ndAve,05/12/2016 11:00:00 PM,48,-122,0,2,2
20040,58thStGreenway22ndAve,05/13/2016 12:00:00 AM,48,-122,0,0,0
20041,58thStGreenway22ndAve,05/13/2016 01:00:00 AM,48,-122,0,0,0
20042,58thStGreenway22ndAve,05/13/2016 02:00:00 AM,48,-122,1,0,1
20043,58thStGreenway22ndAve,05/13/2016 03:00:00 AM,48,-122,0,0,0
20044,58thStGreenway22ndAve,05/13/2016 04:00:00 AM,48,-122,0,0,0
20045,58thStGreenway22ndAve,05/13/2016 05:00:00 AM,48,-122,0,0,0
20046,58thStGreenway22ndAve,05/13/2016 06:00:00 AM,48,-122,0,2,2
20047,58thStGreenway22ndAve,05/13/2016 07:00:00 AM,48,-122,5,6,11
20048,58thStGreenway22ndAve,05/13/2016 08:00:00 AM,48,-122,11,13,24
20049,58thStGreenway22ndAve,05/13/2016 09:00:00 AM,48,-122,8,7,15
20050,58thStGreenway22ndAve,05/13/2016 10:00:00 AM,48,-122,4,4,8
20051,58thStGreenway22ndAve,05/13/2016 11:00:00 AM,48,-122,3,5,8
20052,58thStGreenway22ndAve,05/13/2016 12:00:00 PM,48,-122,7,9,16
20053,58thStGreenway22ndAve,05/13/2016 01:00:00 PM,48,-122,10,4,14
20054,58thStGreenway22ndAve,05/13/2016 02:00:00 PM,48,-122,3,7,10
20055,58thStGreenway22ndAve,05/13/2016 03:00:00 PM,48,-122,4,3,7
20056,58thStGreenway22ndAve,05/13/2016 04:00:00 PM,48,-122,9,10,19
20057,58thStGreenway22ndAve,05/13/2016 05:00:00 PM,48,-122,14,10,24
20058,58thStGreenway22ndAve,05/13/2016 06:00:00 PM,48,-122,8,12,20
20059,58thStGreenway22ndAve,05/13/2016 07:00:00 PM,48,-122,0,5,5
20060,58thStGreenway22ndAve,05/13/2016 08:00:00 PM,48,-122,6,3,9
20061,58thStGreenway22ndAve,05/13/2016 09:00:00 PM,48,-122,5,0,5
20062,58thStGreenway22ndAve,05/13/2016 10:00:00 PM,48,-122,4,3,7
20063,58thStGreenway22ndAve,05/13/2016 11:00:00 PM,48,-122,0,3,3
20064,58thStGreenway22ndAve,05/14/2016 12:00:00 AM,48,-122,0,0,0
20065,58thStGreenway22ndAve,05/14/2016 01:00:00 AM,48,-122,3,1,4
20066,58thStGreenway22ndAve,05/14/2016 02:00:00 AM,48,-122,0,0,0
20067,58thStGreenway22ndAve,05/14/2016 03:00:00 AM,48,-122,2,1,3
20068,58thStGreenway22ndAve,05/14/2016 04:00:00 AM,48,-122,0,0,0
20069,58thStGreenway22ndAve,05/14/2016 05:00:00 AM,48,-122,0,0,0
20070,58thStGreenway22ndAve,05/14/2016 06:00:00 AM,48,-122,0,1,1
20071,58thStGreenway22ndAve,05/14/2016 07:00:00 AM,48,-122,1,0,1
20072,58thStGreenway22ndAve,05/14/2016 08:00:00 AM,48,-122,2,3,5
20073,58thStGreenway22ndAve,05/14/2016 09:00:00 AM,48,-122,11,6,17
20074,58thStGreenway22ndAve,05/14/2016 10:00:00 AM,48,-122,4,2,6
20075,58thStGreenway22ndAve,05/14/2016 11:00:00 AM,48,-122,5,3,8
20076,58thStGreenway22ndAve,05/14/2016 12:00:00 PM,48,-122,10,7,17
20077,58thStGreenway22ndAve,05/14/2016 01:00:00 PM,48,-122,1,1,2
20078,58thStGreenway22ndAve,05/14/2016 02:00:00 PM,48,-122,3,3,6
20079,58thStGreenway22ndAve,05/14/2016 03:00:00 PM,48,-122,2,0,2
20080,58thStGreenway22ndAve,05/14/2016 04:00:00 PM,48,-122,6,4,10
20081,58thStGreenway22ndAve,05/14/2016 05:00:00 PM,48,-122,5,2,7
20082,58thStGreenway22ndAve,05/14/2016 06:00:00 PM,48,-122,1,3,4
20083,58thStGreenway22ndAve,05/14/2016 07:00:00 PM,48,-122,0,1,1
20084,58thStGreenway22ndAve,05/14/2016 08:00:00 PM,48,-122,5,1,6
20085,58thStGreenway22ndAve,05/14/2016 09:00:00 PM,48,-122,0,0,0
20086,58thStGreenway22ndAve,05/14/2016 10:00:00 PM,48,-122,0,1,1
20087,58thStGreenway22ndAve,05/14/2016 11:00:00 PM,48,-122,0,0,0
20088,58thStGreenway22ndAve,05/15/2016 12:00:00 AM,48,-122,0,0,0
20089,58thStGreenway22ndAve,05/15/2016 01:00:00 AM,48,-122,0,0,0
20090,58thStGreenway22ndAve,05/15/2016 02:00:00 AM,48,-122,0,0,0
20091,58thStGreenway22ndAve,05/15/2016 03:00:00 AM,48,-122,2,2,4
20092,58thStGreenway22ndAve,05/15/2016 04:00:00 AM,48,-122,0,0,0
20093,58thStGreenway22ndAve,05/15/2016 05:00:00 AM,48,-122,0,0,0
20094,58thStGreenway22ndAve,05/15/2016 06:00:00 AM,48,-122,0,2,2
20095,58thStGreenway22ndAve,05/15/2016 07:00:00 AM,48,-122,2,1,3
20096,58thStGreenway22ndAve,05/15/2016 08:00:00 AM,48,-122,1,2,3
20097,58thStGreenway22ndAve,05/15/2016 09:00:00 AM,48,-122,2,2,4
20098,58thStGreenway22ndAve,05/15/2016 10:00:00 AM,48,-122,5,1,6
20099,58thStGreenway22ndAve,05/15/2016 11:00:00 AM,48,-122,0,3,3
20100,58thStGreenway22ndAve,05/15/2016 12:00:00 PM,48,-122,3,1,4
20101,58thStGreenway22ndAve,05/15/2016 01:00:00 PM,48,-122,8,8,16
20102,58thStGreenway22ndAve,05/15/2016 02:00:00 PM,48,-122,4,6,10
20103,58thStGreenway22ndAve,05/15/2016 03:00:00 PM,48,-122,2,6,8
20104,58thStGreenway22ndAve,05/15/2016 04:00:00 PM,48,-122,8,3,11
20105,58thStGreenway22ndAve,05/15/2016 05:00:00 PM,48,-122,3,1,4
20106,58thStGreenway22ndAve,05/15/2016 06:00:00 PM,48,-122,2,1,3
20107,58thStGreenway22ndAve,05/15/2016 07:00:00 PM,48,-122,1,2,3
20108,58thStGreenway22ndAve,05/15/2016 08:00:00 PM,48,-122,4,1,5
20109,58thStGreenway22ndAve,05/15/2016 09:00:00 PM,48,-122,1,0,1
20110,58thStGreenway22ndAve,05/15/2016 10:00:00 PM,48,-122,0,0,0
20111,58thStGreenway22ndAve,05/15/2016 11:00:00 PM,48,-122,0,0,0
20112,58thStGreenway22ndAve,05/16/2016 12:00:00 AM,48,-122,1,0,1
20113,58thStGreenway22ndAve,05/16/2016 01:00:00 AM,48,-122,0,1,1
20114,58thStGreenway22ndAve,05/16/2016 02:00:00 AM,48,-122,0,0,0
20115,58thStGreenway22ndAve,05/16/2016 03:00:00 AM,48,-122,0,0,0
20116,58thStGreenway22ndAve,05/16/2016 04:00:00 AM,48,-122,0,0,0
20117,58thStGreenway22ndAve,05/16/2016 05:00:00 AM,48,-122,0,1,1
20118,58thStGreenway22ndAve,05/16/2016 06:00:00 AM,48,-122,0,1,1
20119,58thStGreenway22ndAve,05/16/2016 07:00:00 AM,48,-122,3,6,9
20120,58thStGreenway22ndAve,05/16/2016 08:00:00 AM,48,-122,6,6,12
20121,58thStGreenway22ndAve,05/16/2016 09:00:00 AM,48,-122,6,5,11
20122,58thStGreenway22ndAve,05/16/2016 10:00:00 AM,48,-122,2,4,6
20123,58thStGreenway22ndAve,05/16/2016 11:00:00 AM,48,-122,3,5,8
20124,58thStGreenway22ndAve,05/16/2016 12:00:00 PM,48,-122,6,6,12
20125,58thStGreenway22ndAve,05/16/2016 01:00:00 PM,48,-122,2,3,5
20126,58thStGreenway22ndAve,05/16/2016 02:00:00 PM,48,-122,5,6,11
20127,58thStGreenway22ndAve,05/16/2016 03:00:00 PM,48,-122,2,2,4
20128,58thStGreenway22ndAve,05/16/2016 04:00:00 PM,48,-122,8,2,10
20129,58thStGreenway22ndAve,05/16/2016 05:00:00 PM,48,-122,9,8,17
20130,58thStGreenway22ndAve,05/16/2016 06:00:00 PM,48,-122,8,7,15
20131,58thStGreenway22ndAve,05/16/2016 07:00:00 PM,48,-122,6,9,15
20132,58thStGreenway22ndAve,05/16/2016 08:00:00 PM,48,-122,5,1,6
20133,58thStGreenway22ndAve,05/16/2016 09:00:00 PM,48,-122,2,0,2
20134,58thStGreenway22ndAve,05/16/2016 10:00:00 PM,48,-122,0,3,3
20135,58thStGreenway22ndAve,05/16/2016 11:00:00 PM,48,-122,0,1,1
20136,58thStGreenway22ndAve,05/17/2016 12:00:00 AM,48,-122,0,0,0
20137,58thStGreenway22ndAve,05/17/2016 01:00:00 AM,48,-122,0,0,0
20138,58thStGreenway22ndAve,05/17/2016 02:00:00 AM,48,-122,0,0,0
20139,58thStGreenway22ndAve,05/17/2016 03:00:00 AM,48,-122,0,0,0
20140,58thStGreenway22ndAve,05/17/2016 04:00:00 AM,48,-122,0,0,0
20141,58thStGreenway22ndAve,05/17/2016 05:00:00 AM,48,-122,1,1,2
20142,58thStGreenway22ndAve,05/17/2016 06:00:00 AM,48,-122,1,2,3
20143,58thStGreenway22ndAve,05/17/2016 07:00:00 AM,48,-122,6,3,9
20144,58thStGreenway22ndAve,05/17/2016 08:00:00 AM,48,-122,7,13,20
20145,58thStGreenway22ndAve,05/17/2016 09:00:00 AM,48,-122,3,5,8
20146,58thStGreenway22ndAve,05/17/2016 10:00:00 AM,48,-122,6,13,19
20147,58thStGreenway22ndAve,05/17/2016 11:00:00 AM,48,-122,4,5,9
20148,58thStGreenway22ndAve,05/17/2016 12:00:00 PM,48,-122,8,6,14
20149,58thStGreenway22ndAve,05/17/2016 01:00:00 PM,48,-122,4,4,8
20150,58thStGreenway22ndAve,05/17/2016 02:00:00 PM,48,-122,2,4,6
20151,58thStGreenway22ndAve,05/17/2016 03:00:00 PM,48,-122,8,8,16
20152,58thStGreenway22ndAve,05/17/2016 04:00:00 PM,48,-122,10,5,15
20153,58thStGreenway22ndAve,05/17/2016 05:00:00 PM,48,-122,6,31,37
20154,58thStGreenway22ndAve,05/17/2016 06:00:00 PM,48,-122,8,14,22
20155,58thStGreenway22ndAve,05/17/2016 07:00:00 PM,48,-122,21,9,30
20156,58thStGreenway22ndAve,05/17/2016 08:00:00 PM,48,-122,8,5,13
20157,58thStGreenway22ndAve,05/17/2016 09:00:00 PM,48,-122,1,3,4
20158,58thStGreenway22ndAve,05/17/2016 10:00:00 PM,48,-122,3,0,3
20159,58thStGreenway22ndAve,05/17/2016 11:00:00 PM,48,-122,2,0,2
20160,58thStGreenway22ndAve,05/18/2016 12:00:00 AM,48,-122,0,0,0
20161,58thStGreenway22ndAve,05/18/2016 01:00:00 AM,48,-122,0,0,0
20162,58thStGreenway22ndAve,05/18/2016 02:00:00 AM,48,-122,0,0,0
20163,58thStGreenway22ndAve,05/18/2016 03:00:00 AM,48,-122,2,0,2
20164,58thStGreenway22ndAve,05/18/2016 04:00:00 AM,48,-122,0,0,0
20165,58thStGreenway22ndAve,05/18/2016 05:00:00 AM,48,-122,2,1,3
20166,58thStGreenway22ndAve,05/18/2016 06:00:00 AM,48,-122,1,1,2
20167,58thStGreenway22ndAve,05/18/2016 07:00:00 AM,48,-122,7,8,15
20168,58thStGreenway22ndAve,05/18/2016 08:00:00 AM,48,-122,4,7,11
20169,58thStGreenway22ndAve,05/18/2016 09:00:00 AM,48,-122,8,7,15
20170,58thStGreenway22ndAve,05/18/2016 10:00:00 AM,48,-122,8,4,12
20171,58thStGreenway22ndAve,05/18/2016 11:00:00 AM,48,-122,2,3,5
20172,58thStGreenway22ndAve,05/18/2016 12:00:00 PM,48,-122,4,5,9
20173,58thStGreenway22ndAve,05/18/2016 01:00:00 PM,48,-122,5,4,9
20174,58thStGreenway22ndAve,05/18/2016 02:00:00 PM,48,-122,4,2,6
20175,58thStGreenway22ndAve,05/18/2016 03:00:00 PM,48,-122,5,6,11
20176,58thStGreenway22ndAve,05/18/2016 04:00:00 PM,48,-122,3,3,6
20177,58thStGreenway22ndAve,05/18/2016 05:00:00 PM,48,-122,6,3,9
20178,58thStGreenway22ndAve,05/18/2016 06:00:00 PM,48,-122,12,8,20
20179,58thStGreenway22ndAve,05/18/2016 07:00:00 PM,48,-122,11,6,17
20180,58thStGreenway22ndAve,05/18/2016 08:00:00 PM,48,-122,3,4,7
20181,58thStGreenway22ndAve,05/18/2016 09:00:00 PM,48,-122,6,1,7
20182,58thStGreenway22ndAve,05/18/2016 10:00:00 PM,48,-122,1,0,1
20183,58thStGreenway22ndAve,05/18/2016 11:00:00 PM,48,-122,0,0,0
20184,58thStGreenway22ndAve,05/19/2016 12:00:00 AM,48,-122,0,0,0
20185,58thStGreenway22ndAve,05/19/2016 01:00:00 AM,48,-122,0,0,0
20186,58thStGreenway22ndAve,05/19/2016 02:00:00 AM,48,-122,0,0,0
20187,58thStGreenway22ndAve,05/19/2016 03:00:00 AM,48,-122,0,0,0
20188,58thStGreenway22ndAve,05/19/2016 04:00:00 AM,48,-122,0,0,0
20189,58thStGreenway22ndAve,05/19/2016 05:00:00 AM,48,-122,0,1,1
20190,58thStGreenway22ndAve,05/19/2016 06:00:00 AM,48,-122,0,2,2
20191,58thStGreenway22ndAve,05/19/2016 07:00:00 AM,48,-122,5,5,10
20192,58thStGreenway22ndAve,05/19/2016 08:00:00 AM,48,-122,5,8,13
20193,58thStGreenway22ndAve,05/19/2016 09:00:00 AM,48,-122,4,4,8
20194,58thStGreenway22ndAve,05/19/2016 10:00:00 AM,48,-122,3,4,7
20195,58thStGreenway22ndAve,05/19/2016 11:00:00 AM,48,-122,4,7,11
20196,58thStGreenway22ndAve,05/19/2016 12:00:00 PM,48,-122,2,3,5
20197,58thStGreenway22ndAve,05/19/2016 01:00:00 PM,48,-122,3,6,9
20198,58thStGreenway22ndAve,05/19/2016 02:00:00 PM,48,-122,3,1,4
20199,58thStGreenway22ndAve,05/19/2016 03:00:00 PM,48,-122,4,3,7
20200,58thStGreenway22ndAve,05/19/2016 04:00:00 PM,48,-122,8,3,11
20201,58thStGreenway22ndAve,05/19/2016 05:00:00 PM,48,-122,6,3,9
20202,58thStGreenway22ndAve,05/19/2016 06:00:00 PM,48,-122,7,7,14
20203,58thStGreenway22ndAve,05/19/2016 07:00:00 PM,48,-122,5,7,12
20204,58thStGreenway22ndAve,05/19/2016 08:00:00 PM,48,-122,1,2,3
20205,58thStGreenway22ndAve,05/19/2016 09:00:00 PM,48,-122,5,0,5
20206,58thStGreenway22ndAve,05/19/2016 10:00:00 PM,48,-122,3,2,5
20207,58thStGreenway22ndAve,05/19/2016 11:00:00 PM,48,-122,0,0,0
20208,58thStGreenway22ndAve,05/20/2016 12:00:00 AM,48,-122,0,0,0
20209,58thStGreenway22ndAve,05/20/2016 01:00:00 AM,48,-122,0,0,0
20210,58thStGreenway22ndAve,05/20/2016 02:00:00 AM,48,-122,1,0,1
20211,58thStGreenway22ndAve,05/20/2016 03:00:00 AM,48,-122,0,0,0
20212,58thStGreenway22ndAve,05/20/2016 04:00:00 AM,48,-122,0,0,0
20213,58thStGreenway22ndAve,05/20/2016 05:00:00 AM,48,-122,1,0,1
20214,58thStGreenway22ndAve,05/20/2016 06:00:00 AM,48,-122,2,2,4
20215,58thStGreenway22ndAve,05/20/2016 07:00:00 AM,48,-122,8,10,18
20216,58thStGreenway22ndAve,05/20/2016 08:00:00 AM,48,-122,16,4,20
20217,58thStGreenway22ndAve,05/20/2016 09:00:00 AM,48,-122,4,5,9
20218,58thStGreenway22ndAve,05/20/2016 10:00:00 AM,48,-122,5,8,13
20219,58thStGreenway22ndAve,05/20/2016 11:00:00 AM,48,-122,7,7,14
20220,58thStGreenway22ndAve,05/20/2016 12:00:00 PM,48,-122,8,2,10
20221,58thStGreenway22ndAve,05/20/2016 01:00:00 PM,48,-122,1,4,5
20222,58thStGreenway22ndAve,05/20/2016 02:00:00 PM,48,-122,4,4,8
20223,58thStGreenway22ndAve,05/20/2016 03:00:00 PM,48,-122,3,8,11
20224,58thStGreenway22ndAve,05/20/2016 04:00:00 PM,48,-122,14,8,22
20225,58thStGreenway22ndAve,05/20/2016 05:00:00 PM,48,-122,11,6,17
20226,58thStGreenway22ndAve,05/20/2016 06:00:00 PM,48,-122,9,6,15
20227,58thStGreenway22ndAve,05/20/2016 07:00:00 PM,48,-122,4,4,8
20228,58thStGreenway22ndAve,05/20/2016 08:00:00 PM,48,-122,8,3,11
20229,58thStGreenway22ndAve,05/20/2016 09:00:00 PM,48,-122,0,1,1
20230,58thStGreenway22ndAve,05/20/2016 10:00:00 PM,48,-122,2,2,4
20231,58thStGreenway22ndAve,05/20/2016 11:00:00 PM,48,-122,2,0,2
20232,58thStGreenway22ndAve,05/21/2016 12:00:00 AM,48,-122,0,0,0
20233,58thStGreenway22ndAve,05/21/2016 01:00:00 AM,48,-122,0,1,1
20234,58thStGreenway22ndAve,05/21/2016 02:00:00 AM,48,-122,0,1,1
20235,58thStGreenway22ndAve,05/21/2016 03:00:00 AM,48,-122,0,0,0
20236,58thStGreenway22ndAve,05/21/2016 04:00:00 AM,48,-122,0,0,0
20237,58thStGreenway22ndAve,05/21/2016 05:00:00 AM,48,-122,0,0,0
20238,58thStGreenway22ndAve,05/21/2016 06:00:00 AM,48,-122,0,1,1
20239,58thStGreenway22ndAve,05/21/2016 07:00:00 AM,48,-122,0,0,0
20240,58thStGreenway22ndAve,05/21/2016 08:00:00 AM,48,-122,2,0,2
20241,58thStGreenway22ndAve,05/21/2016 09:00:00 AM,48,-122,3,2,5
20242,58thStGreenway22ndAve,05/21/2016 10:00:00 AM,48,-122,1,2,3
20243,58thStGreenway22ndAve,05/21/2016 11:00:00 AM,48,-122,1,1,2
20244,58thStGreenway22ndAve,05/21/2016 12:00:00 PM,48,-122,1,1,2
20245,58thStGreenway22ndAve,05/21/2016 01:00:00 PM,48,-122,3,0,3
20246,58thStGreenway22ndAve,05/21/2016 02:00:00 PM,48,-122,3,5,8
20247,58thStGreenway22ndAve,05/21/2016 03:00:00 PM,48,-122,2,7,9
20248,58thStGreenway22ndAve,05/21/2016 04:00:00 PM,48,-122,5,3,8
20249,58thStGreenway22ndAve,05/21/2016 05:00:00 PM,48,-122,11,6,17
20250,58thStGreenway22ndAve,05/21/2016 06:00:00 PM,48,-122,2,2,4
20251,58thStGreenway22ndAve,05/21/2016 07:00:00 PM,48,-122,0,2,2
20252,58thStGreenway22ndAve,05/21/2016 08:00:00 PM,48,-122,2,3,5
20253,58thStGreenway22ndAve,05/21/2016 09:00:00 PM,48,-122,1,0,1
20254,58thStGreenway22ndAve,05/21/2016 10:00:00 PM,48,-122,4,1,5
20255,58thStGreenway22ndAve,05/21/2016 11:00:00 PM,48,-122,1,2,3
20256,58thStGreenway22ndAve,05/22/2016 12:00:00 AM,48,-122,3,0,3
20257,58thStGreenway22ndAve,05/22/2016 01:00:00 AM,48,-122,1,0,1
20258,58thStGreenway22ndAve,05/22/2016 02:00:00 AM,48,-122,1,0,1
20259,58thStGreenway22ndAve,05/22/2016 03:00:00 AM,48,-122,0,0,0
20260,58thStGreenway22ndAve,05/22/2016 04:00:00 AM,48,-122,0,0,0
20261,58thStGreenway22ndAve,05/22/2016 05:00:00 AM,48,-122,0,1,1
20262,58thStGreenway22ndAve,05/22/2016 06:00:00 AM,48,-122,0,0,0
20263,58thStGreenway22ndAve,05/22/2016 07:00:00 AM,48,-122,0,1,1
20264,58thStGreenway22ndAve,05/22/2016 08:00:00 AM,48,-122,2,1,3
20265,58thStGreenway22ndAve,05/22/2016 09:00:00 AM,48,-122,2,6,8
20266,58thStGreenway22ndAve,05/22/2016 10:00:00 AM,48,-122,6,6,12
20267,58thStGreenway22ndAve,05/22/2016 11:00:00 AM,48,-122,6,16,22
20268,58thStGreenway22ndAve,05/22/2016 12:00:00 PM,48,-122,9,17,26
20269,58thStGreenway22ndAve,05/22/2016 01:00:00 PM,48,-122,17,5,22
20270,58thStGreenway22ndAve,05/22/2016 02:00:00 PM,48,-122,20,13,33
20271,58thStGreenway22ndAve,05/22/2016 03:00:00 PM,48,-122,7,9,16
20272,58thStGreenway22ndAve,05/22/2016 04:00:00 PM,48,-122,11,8,19
20273,58thStGreenway22ndAve,05/22/2016 05:00:00 PM,48,-122,8,4,12
20274,58thStGreenway22ndAve,05/22/2016 06:00:00 PM,48,-122,2,1,3
20275,58thStGreenway22ndAve,05/22/2016 07:00:00 PM,48,-122,1,1,2
20276,58thStGreenway22ndAve,05/22/2016 08:00:00 PM,48,-122,0,0,0
20277,58thStGreenway22ndAve,05/22/2016 09:00:00 PM,48,-122,1,1,2
20278,58thStGreenway22ndAve,05/22/2016 10:00:00 PM,48,-122,0,1,1
20279,58thStGreenway22ndAve,05/22/2016 11:00:00 PM,48,-122,0,1,1
20280,58thStGreenway22ndAve,05/23/2016 12:00:00 AM,48,-122,0,0,0
20281,58thStGreenway22ndAve,05/23/2016 01:00:00 AM,48,-122,0,0,0
20282,58thStGreenway22ndAve,05/23/2016 02:00:00 AM,48,-122,1,1,2
20283,58thStGreenway22ndAve,05/23/2016 03:00:00 AM,48,-122,2,0,2
20284,58thStGreenway22ndAve,05/23/2016 04:00:00 AM,48,-122,0,0,0
20285,58thStGreenway22ndAve,05/23/2016 05:00:00 AM,48,-122,0,1,1
20286,58thStGreenway22ndAve,05/23/2016 06:00:00 AM,48,-122,0,0,0
20287,58thStGreenway22ndAve,05/23/2016 07:00:00 AM,48,-122,2,6,8
20288,58thStGreenway22ndAve,05/23/2016 08:00:00 AM,48,-122,11,10,21
20289,58thStGreenway22ndAve,05/23/2016 09:00:00 AM,48,-122,5,7,12
20290,58thStGreenway22ndAve,05/23/2016 10:00:00 AM,48,-122,2,6,8
20291,58thStGreenway22ndAve,05/23/2016 11:00:00 AM,48,-122,2,9,11
20292,58thStGreenway22ndAve,05/23/2016 12:00:00 PM,48,-122,4,3,7
20293,58thStGreenway22ndAve,05/23/2016 01:00:00 PM,48,-122,5,5,10
20294,58thStGreenway22ndAve,05/23/2016 02:00:00 PM,48,-122,2,3,5
20295,58thStGreenway22ndAve,05/23/2016 03:00:00 PM,48,-122,4,7,11
20296,58thStGreenway22ndAve,05/23/2016 04:00:00 PM,48,-122,10,4,14
20297,58thStGreenway22ndAve,05/23/2016 05:00:00 PM,48,-122,9,7,16
20298,58thStGreenway22ndAve,05/23/2016 06:00:00 PM,48,-122,8,11,19
20299,58thStGreenway22ndAve,05/23/2016 07:00:00 PM,48,-122,9,6,15
20300,58thStGreenway22ndAve,05/23/2016 08:00:00 PM,48,-122,5,3,8
20301,58thStGreenway22ndAve,05/23/2016 09:00:00 PM,48,-122,0,0,0
20302,58thStGreenway22ndAve,05/23/2016 10:00:00 PM,48,-122,1,1,2
20303,58thStGreenway22ndAve,05/23/2016 11:00:00 PM,48,-122,0,0,0
20304,58thStGreenway22ndAve,05/24/2016 12:00:00 AM,48,-122,0,0,0
20305,58thStGreenway22ndAve,05/24/2016 01:00:00 AM,48,-122,0,0,0
20306,58thStGreenway22ndAve,05/24/2016 02:00:00 AM,48,-122,0,0,0
20307,58thStGreenway22ndAve,05/24/2016 03:00:00 AM,48,-122,0,0,0
20308,58thStGreenway22ndAve,05/24/2016 04:00:00 AM,48,-122,0,0,0
20309,58thStGreenway22ndAve,05/24/2016 05:00:00 AM,48,-122,1,1,2
20310,58thStGreenway22ndAve,05/24/2016 06:00:00 AM,48,-122,0,1,1
20311,58thStGreenway22ndAve,05/24/2016 07:00:00 AM,48,-122,8,7,15
20312,58thStGreenway22ndAve,05/24/2016 08:00:00 AM,48,-122,10,9,19
20313,58thStGreenway22ndAve,05/24/2016 09:00:00 AM,48,-122,6,7,13
20314,58thStGreenway22ndAve,05/24/2016 10:00:00 AM,48,-122,1,6,7
20315,58thStGreenway22ndAve,05/24/2016 11:00:00 AM,48,-122,3,0,3
20316,58thStGreenway22ndAve,05/24/2016 12:00:00 PM,48,-122,2,6,8
20317,58thStGreenway22ndAve,05/24/2016 01:00:00 PM,48,-122,8,4,12
20318,58thStGreenway22ndAve,05/24/2016 02:00:00 PM,48,-122,2,2,4
20319,58thStGreenway22ndAve,05/24/2016 03:00:00 PM,48,-122,4,6,10
20320,58thStGreenway22ndAve,05/24/2016 04:00:00 PM,48,-122,7,4,11
20321,58thStGreenway22ndAve,05/24/2016 05:00:00 PM,48,-122,12,11,23
20322,58thStGreenway22ndAve,05/24/2016 06:00:00 PM,48,-122,8,11,19
20323,58thStGreenway22ndAve,05/24/2016 07:00:00 PM,48,-122,5,13,18
20324,58thStGreenway22ndAve,05/24/2016 08:00:00 PM,48,-122,4,5,9
20325,58thStGreenway22ndAve,05/24/2016 09:00:00 PM,48,-122,4,1,5
20326,58thStGreenway22ndAve,05/24/2016 10:00:00 PM,48,-122,2,1,3
20327,58thStGreenway22ndAve,05/24/2016 11:00:00 PM,48,-122,0,0,0
20328,58thStGreenway22ndAve,05/25/2016 12:00:00 AM,48,-122,0,0,0
20329,58thStGreenway22ndAve,05/25/2016 01:00:00 AM,48,-122,0,0,0
20330,58thStGreenway22ndAve,05/25/2016 02:00:00 AM,48,-122,1,0,1
20331,58thStGreenway22ndAve,05/25/2016 03:00:00 AM,48,-122,0,0,0
20332,58thStGreenway22ndAve,05/25/2016 04:00:00 AM,48,-122,0,0,0
20333,58thStGreenway22ndAve,05/25/2016 05:00:00 AM,48,-122,0,0,0
20334,58thStGreenway22ndAve,05/25/2016 06:00:00 AM,48,-122,0,3,3
20335,58thStGreenway22ndAve,05/25/2016 07:00:00 AM,48,-122,3,6,9
20336,58thStGreenway22ndAve,05/25/2016 08:00:00 AM,48,-122,12,4,16
20337,58thStGreenway22ndAve,05/25/2016 09:00:00 AM,48,-122,7,5,12
20338,58thStGreenway22ndAve,05/25/2016 10:00:00 AM,48,-122,2,5,7
20339,58thStGreenway22ndAve,05/25/2016 11:00:00 AM,48,-122,2,5,7
20340,58thStGreenway22ndAve,05/25/2016 12:00:00 PM,48,-122,1,3,4
20341,58thStGreenway22ndAve,05/25/2016 01:00:00 PM,48,-122,3,1,4
20342,58thStGreenway22ndAve,05/25/2016 02:00:00 PM,48,-122,3,3,6
20343,58thStGreenway22ndAve,05/25/2016 03:00:00 PM,48,-122,2,0,2
20344,58thStGreenway22ndAve,05/25/2016 04:00:00 PM,48,-122,15,4,19
20345,58thStGreenway22ndAve,05/25/2016 05:00:00 PM,48,-122,8,4,12
20346,58thStGreenway22ndAve,05/25/2016 06:00:00 PM,48,-122,15,7,22
20347,58thStGreenway22ndAve,05/25/2016 07:00:00 PM,48,-122,5,4,9
20348,58thStGreenway22ndAve,05/25/2016 08:00:00 PM,48,-122,3,3,6
20349,58thStGreenway22ndAve,05/25/2016 09:00:00 PM,48,-122,1,3,4
20350,58thStGreenway22ndAve,05/25/2016 10:00:00 PM,48,-122,1,1,2
20351,58thStGreenway22ndAve,05/25/2016 11:00:00 PM,48,-122,0,0,0
20352,58thStGreenway22ndAve,05/26/2016 12:00:00 AM,48,-122,1,0,1
20353,58thStGreenway22ndAve,05/26/2016 01:00:00 AM,48,-122,0,0,0
20354,58thStGreenway22ndAve,05/26/2016 02:00:00 AM,48,-122,0,0,0
20355,58thStGreenway22ndAve,05/26/2016 03:00:00 AM,48,-122,0,0,0
20356,58thStGreenway22ndAve,05/26/2016 04:00:00 AM,48,-122,0,0,0
20357,58thStGreenway22ndAve,05/26/2016 05:00:00 AM,48,-122,0,2,2
20358,58thStGreenway22ndAve,05/26/2016 06:00:00 AM,48,-122,0,2,2
20359,58thStGreenway22ndAve,05/26/2016 07:00:00 AM,48,-122,5,5,10
20360,58thStGreenway22ndAve,05/26/2016 08:00:00 AM,48,-122,6,8,14
20361,58thStGreenway22ndAve,05/26/2016 09:00:00 AM,48,-122,5,9,14
20362,58thStGreenway22ndAve,05/26/2016 10:00:00 AM,48,-122,5,4,9
20363,58thStGreenway22ndAve,05/26/2016 11:00:00 AM,48,-122,4,2,6
20364,58thStGreenway22ndAve,05/26/2016 12:00:00 PM,48,-122,1,3,4
20365,58thStGreenway22ndAve,05/26/2016 01:00:00 PM,48,-122,4,8,12
20366,58thStGreenway22ndAve,05/26/2016 02:00:00 PM,48,-122,2,3,5
20367,58thStGreenway22ndAve,05/26/2016 03:00:00 PM,48,-122,2,5,7
20368,58thStGreenway22ndAve,05/26/2016 04:00:00 PM,48,-122,1,4,5
20369,58thStGreenway22ndAve,05/26/2016 05:00:00 PM,48,-122,8,6,14
20370,58thStGreenway22ndAve,05/26/2016 06:00:00 PM,48,-122,8,8,16
20371,58thStGreenway22ndAve,05/26/2016 07:00:00 PM,48,-122,13,3,16
20372,58thStGreenway22ndAve,05/26/2016 08:00:00 PM,48,-122,4,1,5
20373,58thStGreenway22ndAve,05/26/2016 09:00:00 PM,48,-122,5,1,6
20374,58thStGreenway22ndAve,05/26/2016 10:00:00 PM,48,-122,1,3,4
20375,58thStGreenway22ndAve,05/26/2016 11:00:00 PM,48,-122,1,0,1
20376,58thStGreenway22ndAve,05/27/2016 12:00:00 AM,48,-122,0,0,0
20377,58thStGreenway22ndAve,05/27/2016 01:00:00 AM,48,-122,0,0,0
20378,58thStGreenway22ndAve,05/27/2016 02:00:00 AM,48,-122,0,0,0
20379,58thStGreenway22ndAve,05/27/2016 03:00:00 AM,48,-122,0,0,0
20380,58thStGreenway22ndAve,05/27/2016 04:00:00 AM,48,-122,0,0,0
20381,58thStGreenway22ndAve,05/27/2016 05:00:00 AM,48,-122,0,0,0
20382,58thStGreenway22ndAve,05/27/2016 06:00:00 AM,48,-122,0,2,2
20383,58thStGreenway22ndAve,05/27/2016 07:00:00 AM,48,-122,4,3,7
20384,58thStGreenway22ndAve,05/27/2016 08:00:00 AM,48,-122,9,5,14
20385,58thStGreenway22ndAve,05/27/2016 09:00:00 AM,48,-122,4,0,4
20386,58thStGreenway22ndAve,05/27/2016 10:00:00 AM,48,-122,3,7,10
20387,58thStGreenway22ndAve,05/27/2016 11:00:00 AM,48,-122,5,3,8
20388,58thStGreenway22ndAve,05/27/2016 12:00:00 PM,48,-122,4,0,4
20389,58thStGreenway22ndAve,05/27/2016 01:00:00 PM,48,-122,6,6,12
20390,58thStGreenway22ndAve,05/27/2016 02:00:00 PM,48,-122,8,1,9
20391,58thStGreenway22ndAve,05/27/2016 03:00:00 PM,48,-122,5,1,6
20392,58thStGreenway22ndAve,05/27/2016 04:00:00 PM,48,-122,9,8,17
20393,58thStGreenway22ndAve,05/27/2016 05:00:00 PM,48,-122,14,2,16
20394,58thStGreenway22ndAve,05/27/2016 06:00:00 PM,48,-122,1,3,4
20395,58thStGreenway22ndAve,05/27/2016 07:00:00 PM,48,-122,1,7,8
20396,58thStGreenway22ndAve,05/27/2016 08:00:00 PM,48,-122,3,1,4
20397,58thStGreenway22ndAve,05/27/2016 09:00:00 PM,48,-122,0,0,0
20398,58thStGreenway22ndAve,05/27/2016 10:00:00 PM,48,-122,0,1,1
20399,58thStGreenway22ndAve,05/27/2016 11:00:00 PM,48,-122,0,1,1
20400,58thStGreenway22ndAve,05/28/2016 12:00:00 AM,48,-122,0,0,0
20401,58thStGreenway22ndAve,05/28/2016 01:00:00 AM,48,-122,0,0,0
20402,58thStGreenway22ndAve,05/28/2016 02:00:00 AM,48,-122,0,0,0
20403,58thStGreenway22ndAve,05/28/2016 03:00:00 AM,48,-122,0,0,0
20404,58thStGreenway22ndAve,05/28/2016 04:00:00 AM,48,-122,0,0,0
20405,58thStGreenway22ndAve,05/28/2016 05:00:00 AM,48,-122,0,0,0
20406,58thStGreenway22ndAve,05/28/2016 06:00:00 AM,48,-122,0,1,1
20407,58thStGreenway22ndAve,05/28/2016 07:00:00 AM,48,-122,1,1,2
20408,58thStGreenway22ndAve,05/28/2016 08:00:00 AM,48,-122,0,2,2
20409,58thStGreenway22ndAve,05/28/2016 09:00:00 AM,48,-122,3,2,5
20410,58thStGreenway22ndAve,05/28/2016 10:00:00 AM,48,-122,1,6,7
20411,58thStGreenway22ndAve,05/28/2016 11:00:00 AM,48,-122,3,7,10
20412,58thStGreenway22ndAve,05/28/2016 12:00:00 PM,48,-122,6,4,10
20413,58thStGreenway22ndAve,05/28/2016 01:00:00 PM,48,-122,3,0,3
20414,58thStGreenway22ndAve,05/28/2016 02:00:00 PM,48,-122,2,3,5
20415,58thStGreenway22ndAve,05/28/2016 03:00:00 PM,48,-122,3,1,4
20416,58thStGreenway22ndAve,05/28/2016 04:00:00 PM,48,-122,6,5,11
20417,58thStGreenway22ndAve,05/28/2016 05:00:00 PM,48,-122,1,2,3
20418,58thStGreenway22ndAve,05/28/2016 06:00:00 PM,48,-122,4,4,8
20419,58thStGreenway22ndAve,05/28/2016 07:00:00 PM,48,-122,7,3,10
20420,58thStGreenway22ndAve,05/28/2016 08:00:00 PM,48,-122,1,0,1
20421,58thStGreenway22ndAve,05/28/2016 09:00:00 PM,48,-122,0,0,0
20422,58thStGreenway22ndAve,05/28/2016 10:00:00 PM,48,-122,0,2,2
20423,58thStGreenway22ndAve,05/28/2016 11:00:00 PM,48,-122,0,0,0
20424,58thStGreenway22ndAve,05/29/2016 12:00:00 AM,48,-122,0,0,0
20425,58thStGreenway22ndAve,05/29/2016 01:00:00 AM,48,-122,0,1,1
20426,58thStGreenway22ndAve,05/29/2016 02:00:00 AM,48,-122,0,2,2
20427,58thStGreenway22ndAve,05/29/2016 03:00:00 AM,48,-122,0,0,0
20428,58thStGreenway22ndAve,05/29/2016 04:00:00 AM,48,-122,0,0,0
20429,58thStGreenway22ndAve,05/29/2016 05:00:00 AM,48,-122,0,0,0
20430,58thStGreenway22ndAve,05/29/2016 06:00:00 AM,48,-122,0,1,1
20431,58thStGreenway22ndAve,05/29/2016 07:00:00 AM,48,-122,1,2,3
20432,58thStGreenway22ndAve,05/29/2016 08:00:00 AM,48,-122,0,1,1
20433,58thStGreenway22ndAve,05/29/2016 09:00:00 AM,48,-122,2,0,2
20434,58thStGreenway22ndAve,05/29/2016 10:00:00 AM,48,-122,0,0,0
20435,58thStGreenway22ndAve,05/29/2016 11:00:00 AM,48,-122,0,5,5
20436,58thStGreenway22ndAve,05/29/2016 12:00:00 PM,48,-122,0,4,4
20437,58thStGreenway22ndAve,05/29/2016 01:00:00 PM,48,-122,8,5,13
20438,58thStGreenway22ndAve,05/29/2016 02:00:00 PM,48,-122,3,3,6
20439,58thStGreenway22ndAve,05/29/2016 03:00:00 PM,48,-122,4,5,9
20440,58thStGreenway22ndAve,05/29/2016 04:00:00 PM,48,-122,2,1,3
20441,58thStGreenway22ndAve,05/29/2016 05:00:00 PM,48,-122,2,5,7
20442,58thStGreenway22ndAve,05/29/2016 06:00:00 PM,48,-122,3,7,10
20443,58thStGreenway22ndAve,05/29/2016 07:00:00 PM,48,-122,1,3,4
20444,58thStGreenway22ndAve,05/29/2016 08:00:00 PM,48,-122,0,2,2
20445,58thStGreenway22ndAve,05/29/2016 09:00:00 PM,48,-122,3,0,3
20446,58thStGreenway22ndAve,05/29/2016 10:00:00 PM,48,-122,0,2,2
20447,58thStGreenway22ndAve,05/29/2016 11:00:00 PM,48,-122,3,1,4
20448,58thStGreenway22ndAve,05/30/2016 12:00:00 AM,48,-122,2,0,2
20449,58thStGreenway22ndAve,05/30/2016 01:00:00 AM,48,-122,0,0,0
20450,58thStGreenway22ndAve,05/30/2016 02:00:00 AM,48,-122,0,0,0
20451,58thStGreenway22ndAve,05/30/2016 03:00:00 AM,48,-122,0,0,0
20452,58thStGreenway22ndAve,05/30/2016 04:00:00 AM,48,-122,1,0,1
20453,58thStGreenway22ndAve,05/30/2016 05:00:00 AM,48,-122,0,0,0
20454,58thStGreenway22ndAve,05/30/2016 06:00:00 AM,48,-122,0,0,0
20455,58thStGreenway22ndAve,05/30/2016 07:00:00 AM,48,-122,1,0,1
20456,58thStGreenway22ndAve,05/30/2016 08:00:00 AM,48,-122,1,2,3
20457,58thStGreenway22ndAve,05/30/2016 09:00:00 AM,48,-122,2,8,10
20458,58thStGreenway22ndAve,05/30/2016 10:00:00 AM,48,-122,9,10,19
20459,58thStGreenway22ndAve,05/30/2016 11:00:00 AM,48,-122,10,23,33
20460,58thStGreenway22ndAve,05/30/2016 12:00:00 PM,48,-122,12,14,26
20461,58thStGreenway22ndAve,05/30/2016 01:00:00 PM,48,-122,15,5,20
20462,58thStGreenway22ndAve,05/30/2016 02:00:00 PM,48,-122,14,23,37
20463,58thStGreenway22ndAve,05/30/2016 03:00:00 PM,48,-122,9,7,16
20464,58thStGreenway22ndAve,05/30/2016 04:00:00 PM,48,-122,12,8,20
20465,58thStGreenway22ndAve,05/30/2016 05:00:00 PM,48,-122,11,6,17
20466,58thStGreenway22ndAve,05/30/2016 06:00:00 PM,48,-122,13,3,16
20467,58thStGreenway22ndAve,05/30/2016 07:00:00 PM,48,-122,7,6,13
20468,58thStGreenway22ndAve,05/30/2016 08:00:00 PM,48,-122,1,2,3
20469,58thStGreenway22ndAve,05/30/2016 09:00:00 PM,48,-122,1,1,2
20470,58thStGreenway22ndAve,05/30/2016 10:00:00 PM,48,-122,1,5,6
20471,58thStGreenway22ndAve,05/30/2016 11:00:00 PM,48,-122,0,0,0
20472,58thStGreenway22ndAve,05/31/2016 12:00:00 AM,48,-122,0,0,0
20473,58thStGreenway22ndAve,05/31/2016 01:00:00 AM,48,-122,0,1,1
20474,58thStGreenway22ndAve,05/31/2016 02:00:00 AM,48,-122,0,0,0
20475,58thStGreenway22ndAve,05/31/2016 03:00:00 AM,48,-122,0,0,0
20476,58thStGreenway22ndAve,05/31/2016 04:00:00 AM,48,-122,0,0,0
20477,58thStGreenway22ndAve,05/31/2016 05:00:00 AM,48,-122,0,1,1
20478,58thStGreenway22ndAve,05/31/2016 06:00:00 AM,48,-122,1,2,3
20479,58thStGreenway22ndAve,05/31/2016 07:00:00 AM,48,-122,5,2,7
20480,58thStGreenway22ndAve,05/31/2016 08:00:00 AM,48,-122,4,13,17
20481,58thStGreenway22ndAve,05/31/2016 09:00:00 AM,48,-122,6,3,9
20482,58thStGreenway22ndAve,05/31/2016 10:00:00 AM,48,-122,5,4,9
20483,58thStGreenway22ndAve,05/31/2016 11:00:00 AM,48,-122,3,9,12
20484,58thStGreenway22ndAve,05/31/2016 12:00:00 PM,48,-122,6,7,13
20485,58thStGreenway22ndAve,05/31/2016 01:00:00 PM,48,-122,3,4,7
20486,58thStGreenway22ndAve,05/31/2016 02:00:00 PM,48,-122,5,6,11
20487,58thStGreenway22ndAve,05/31/2016 03:00:00 PM,48,-122,4,4,8
20488,58thStGreenway22ndAve,05/31/2016 04:00:00 PM,48,-122,6,4,10
20489,58thStGreenway22ndAve,05/31/2016 05:00:00 PM,48,-122,10,13,23
20490,58thStGreenway22ndAve,05/31/2016 06:00:00 PM,48,-122,9,6,15
20491,58thStGreenway22ndAve,05/31/2016 07:00:00 PM,48,-122,5,13,18
20492,58thStGreenway22ndAve,05/31/2016 08:00:00 PM,48,-122,7,1,8
20493,58thStGreenway22ndAve,05/31/2016 09:00:00 PM,48,-122,4,2,6
20494,58thStGreenway22ndAve,05/31/2016 10:00:00 PM,48,-122,3,0,3
20495,58thStGreenway22ndAve,05/31/2016 11:00:00 PM,48,-122,1,1,2
20496,58thStGreenway22ndAve,06/01/2016 12:00:00 AM,48,-122,0,1,1
20497,58thStGreenway22ndAve,06/01/2016 01:00:00 AM,48,-122,0,0,0
20498,58thStGreenway22ndAve,06/01/2016 02:00:00 AM,48,-122,0,0,0
20499,58thStGreenway22ndAve,06/01/2016 03:00:00 AM,48,-122,1,0,1
20500,58thStGreenway22ndAve,06/01/2016 04:00:00 AM,48,-122,0,0,0
20501,58thStGreenway22ndAve,06/01/2016 05:00:00 AM,48,-122,0,1,1
20502,58thStGreenway22ndAve,06/01/2016 06:00:00 AM,48,-122,0,3,3
20503,58thStGreenway22ndAve,06/01/2016 07:00:00 AM,48,-122,11,8,19
20504,58thStGreenway22ndAve,06/01/2016 08:00:00 AM,48,-122,8,8,16
20505,58thStGreenway22ndAve,06/01/2016 09:00:00 AM,48,-122,6,5,11
20506,58thStGreenway22ndAve,06/01/2016 10:00:00 AM,48,-122,5,3,8
20507,58thStGreenway22ndAve,06/01/2016 11:00:00 AM,48,-122,2,4,6
20508,58thStGreenway22ndAve,06/01/2016 12:00:00 PM,48,-122,7,8,15
20509,58thStGreenway22ndAve,06/01/2016 01:00:00 PM,48,-122,0,4,4
20510,58thStGreenway22ndAve,06/01/2016 02:00:00 PM,48,-122,0,2,2
20511,58thStGreenway22ndAve,06/01/2016 03:00:00 PM,48,-122,1,6,7
20512,58thStGreenway22ndAve,06/01/2016 04:00:00 PM,48,-122,6,10,16
20513,58thStGreenway22ndAve,06/01/2016 05:00:00 PM,48,-122,10,8,18
20514,58thStGreenway22ndAve,06/01/2016 06:00:00 PM,48,-122,12,9,21
20515,58thStGreenway22ndAve,06/01/2016 07:00:00 PM,48,-122,11,8,19
20516,58thStGreenway22ndAve,06/01/2016 08:00:00 PM,48,-122,2,4,6
20517,58thStGreenway22ndAve,06/01/2016 09:00:00 PM,48,-122,3,5,8
20518,58thStGreenway22ndAve,06/01/2016 10:00:00 PM,48,-122,5,0,5
20519,58thStGreenway22ndAve,06/01/2016 11:00:00 PM,48,-122,1,0,1
20520,58thStGreenway22ndAve,06/02/2016 12:00:00 AM,48,-122,0,0,0
20521,58thStGreenway22ndAve,06/02/2016 01:00:00 AM,48,-122,1,0,1
20522,58thStGreenway22ndAve,06/02/2016 02:00:00 AM,48,-122,0,0,0
20523,58thStGreenway22ndAve,06/02/2016 03:00:00 AM,48,-122,0,0,0
20524,58thStGreenway22ndAve,06/02/2016 04:00:00 AM,48,-122,0,0,0
20525,58thStGreenway22ndAve,06/02/2016 05:00:00 AM,48,-122,0,1,1
20526,58thStGreenway22ndAve,06/02/2016 06:00:00 AM,48,-122,2,2,4
20527,58thStGreenway22ndAve,06/02/2016 07:00:00 AM,48,-122,5,1,6
20528,58thStGreenway22ndAve,06/02/2016 08:00:00 AM,48,-122,4,9,13
20529,58thStGreenway22ndAve,06/02/2016 09:00:00 AM,48,-122,6,7,13
20530,58thStGreenway22ndAve,06/02/2016 10:00:00 AM,48,-122,4,1,5
20531,58thStGreenway22ndAve,06/02/2016 11:00:00 AM,48,-122,4,2,6
20532,58thStGreenway22ndAve,06/02/2016 12:00:00 PM,48,-122,6,2,8
20533,58thStGreenway22ndAve,06/02/2016 01:00:00 PM,48,-122,1,4,5
20534,58thStGreenway22ndAve,06/02/2016 02:00:00 PM,48,-122,6,2,8
20535,58thStGreenway22ndAve,06/02/2016 03:00:00 PM,48,-122,4,5,9
20536,58thStGreenway22ndAve,06/02/2016 04:00:00 PM,48,-122,8,5,13
20537,58thStGreenway22ndAve,06/02/2016 05:00:00 PM,48,-122,12,7,19
20538,58thStGreenway22ndAve,06/02/2016 06:00:00 PM,48,-122,8,3,11
20539,58thStGreenway22ndAve,06/02/2016 07:00:00 PM,48,-122,3,7,10
20540,58thStGreenway22ndAve,06/02/2016 08:00:00 PM,48,-122,1,3,4
20541,58thStGreenway22ndAve,06/02/2016 09:00:00 PM,48,-122,3,1,4
20542,58thStGreenway22ndAve,06/02/2016 10:00:00 PM,48,-122,0,2,2
20543,58thStGreenway22ndAve,06/02/2016 11:00:00 PM,48,-122,1,1,2
20544,58thStGreenway22ndAve,06/03/2016 12:00:00 AM,48,-122,1,1,2
20545,58thStGreenway22ndAve,06/03/2016 01:00:00 AM,48,-122,0,0,0
20546,58thStGreenway22ndAve,06/03/2016 02:00:00 AM,48,-122,0,0,0
20547,58thStGreenway22ndAve,06/03/2016 03:00:00 AM,48,-122,0,0,0
20548,58thStGreenway22ndAve,06/03/2016 04:00:00 AM,48,-122,0,0,0
20549,58thStGreenway22ndAve,06/03/2016 05:00:00 AM,48,-122,0,0,0
20550,58thStGreenway22ndAve,06/03/2016 06:00:00 AM,48,-122,1,0,1
20551,58thStGreenway22ndAve,06/03/2016 07:00:00 AM,48,-122,6,6,12
20552,58thStGreenway22ndAve,06/03/2016 08:00:00 AM,48,-122,8,10,18
20553,58thStGreenway22ndAve,06/03/2016 09:00:00 AM,48,-122,7,8,15
20554,58thStGreenway22ndAve,06/03/2016 10:00:00 AM,48,-122,7,8,15
20555,58thStGreenway22ndAve,06/03/2016 11:00:00 AM,48,-122,3,4,7
20556,58thStGreenway22ndAve,06/03/2016 12:00:00 PM,48,-122,6,4,10
20557,58thStGreenway22ndAve,06/03/2016 01:00:00 PM,48,-122,5,10,15
20558,58thStGreenway22ndAve,06/03/2016 02:00:00 PM,48,-122,5,6,11
20559,58thStGreenway22ndAve,06/03/2016 03:00:00 PM,48,-122,9,12,21
20560,58thStGreenway22ndAve,06/03/2016 04:00:00 PM,48,-122,14,8,22
20561,58thStGreenway22ndAve,06/03/2016 05:00:00 PM,48,-122,13,8,21
20562,58thStGreenway22ndAve,06/03/2016 06:00:00 PM,48,-122,2,12,14
20563,58thStGreenway22ndAve,06/03/2016 07:00:00 PM,48,-122,4,13,17
20564,58thStGreenway22ndAve,06/03/2016 08:00:00 PM,48,-122,8,8,16
20565,58thStGreenway22ndAve,06/03/2016 09:00:00 PM,48,-122,4,1,5
20566,58thStGreenway22ndAve,06/03/2016 10:00:00 PM,48,-122,1,0,1
20567,58thStGreenway22ndAve,06/03/2016 11:00:00 PM,48,-122,2,0,2
20568,58thStGreenway22ndAve,06/04/2016 12:00:00 AM,48,-122,1,0,1
20569,58thStGreenway22ndAve,06/04/2016 01:00:00 AM,48,-122,0,0,0
20570,58thStGreenway22ndAve,06/04/2016 02:00:00 AM,48,-122,0,0,0
20571,58thStGreenway22ndAve,06/04/2016 03:00:00 AM,48,-122,0,0,0
20572,58thStGreenway22ndAve,06/04/2016 04:00:00 AM,48,-122,0,0,0
20573,58thStGreenway22ndAve,06/04/2016 05:00:00 AM,48,-122,2,2,4
20574,58thStGreenway22ndAve,06/04/2016 06:00:00 AM,48,-122,1,1,2
20575,58thStGreenway22ndAve,06/04/2016 07:00:00 AM,48,-122,2,5,7
20576,58thStGreenway22ndAve,06/04/2016 08:00:00 AM,48,-122,6,3,9
20577,58thStGreenway22ndAve,06/04/2016 09:00:00 AM,48,-122,10,4,14
20578,58thStGreenway22ndAve,06/04/2016 10:00:00 AM,48,-122,10,14,24
20579,58thStGreenway22ndAve,06/04/2016 11:00:00 AM,48,-122,14,8,22
20580,58thStGreenway22ndAve,06/04/2016 12:00:00 PM,48,-122,13,15,28
20581,58thStGreenway22ndAve,06/04/2016 01:00:00 PM,48,-122,5,7,12
20582,58thStGreenway22ndAve,06/04/2016 02:00:00 PM,48,-122,11,15,26
20583,58thStGreenway22ndAve,06/04/2016 03:00:00 PM,48,-122,9,13,22
20584,58thStGreenway22ndAve,06/04/2016 04:00:00 PM,48,-122,7,5,12
20585,58thStGreenway22ndAve,06/04/2016 05:00:00 PM,48,-122,13,3,16
20586,58thStGreenway22ndAve,06/04/2016 06:00:00 PM,48,-122,5,6,11
20587,58thStGreenway22ndAve,06/04/2016 07:00:00 PM,48,-122,8,0,8
20588,58thStGreenway22ndAve,06/04/2016 08:00:00 PM,48,-122,7,7,14
20589,58thStGreenway22ndAve,06/04/2016 09:00:00 PM,48,-122,10,3,13
20590,58thStGreenway22ndAve,06/04/2016 10:00:00 PM,48,-122,0,1,1
20591,58thStGreenway22ndAve,06/04/2016 11:00:00 PM,48,-122,1,1,2
20592,58thStGreenway22ndAve,06/05/2016 12:00:00 AM,48,-122,3,0,3
20593,58thStGreenway22ndAve,06/05/2016 01:00:00 AM,48,-122,0,0,0
20594,58thStGreenway22ndAve,06/05/2016 02:00:00 AM,48,-122,0,0,0
20595,58thStGreenway22ndAve,06/05/2016 03:00:00 AM,48,-122,0,1,1
20596,58thStGreenway22ndAve,06/05/2016 04:00:00 AM,48,-122,0,0,0
20597,58thStGreenway22ndAve,06/05/2016 05:00:00 AM,48,-122,0,1,1
20598,58thStGreenway22ndAve,06/05/2016 06:00:00 AM,48,-122,0,1,1
20599,58thStGreenway22ndAve,06/05/2016 07:00:00 AM,48,-122,1,2,3
20600,58thStGreenway22ndAve,06/05/2016 08:00:00 AM,48,-122,2,3,5
20601,58thStGreenway22ndAve,06/05/2016 09:00:00 AM,48,-122,5,6,11
20602,58thStGreenway22ndAve,06/05/2016 10:00:00 AM,48,-122,4,13,17
20603,58thStGreenway22ndAve,06/05/2016 11:00:00 AM,48,-122,9,9,18
20604,58thStGreenway22ndAve,06/05/2016 12:00:00 PM,48,-122,12,8,20
20605,58thStGreenway22ndAve,06/05/2016 01:00:00 PM,48,-122,14,18,32
20606,58thStGreenway22ndAve,06/05/2016 02:00:00 PM,48,-122,10,14,24
20607,58thStGreenway22ndAve,06/05/2016 03:00:00 PM,48,-122,19,11,30
20608,58thStGreenway22ndAve,06/05/2016 04:00:00 PM,48,-122,12,6,18
20609,58thStGreenway22ndAve,06/05/2016 05:00:00 PM,48,-122,5,7,12
20610,58thStGreenway22ndAve,06/05/2016 06:00:00 PM,48,-122,6,5,11
20611,58thStGreenway22ndAve,06/05/2016 07:00:00 PM,48,-122,2,10,12
20612,58thStGreenway22ndAve,06/05/2016 08:00:00 PM,48,-122,2,2,4
20613,58thStGreenway22ndAve,06/05/2016 09:00:00 PM,48,-122,2,3,5
20614,58thStGreenway22ndAve,06/05/2016 10:00:00 PM,48,-122,3,0,3
20615,58thStGreenway22ndAve,06/05/2016 11:00:00 PM,48,-122,0,0,0
20616,58thStGreenway22ndAve,06/06/2016 12:00:00 AM,48,-122,1,0,1
20617,58thStGreenway22ndAve,06/06/2016 01:00:00 AM,48,-122,0,0,0
20618,58thStGreenway22ndAve,06/06/2016 02:00:00 AM,48,-122,0,0,0
20619,58thStGreenway22ndAve,06/06/2016 03:00:00 AM,48,-122,0,3,3
20620,58thStGreenway22ndAve,06/06/2016 04:00:00 AM,48,-122,1,0,1
20621,58thStGreenway22ndAve,06/06/2016 05:00:00 AM,48,-122,0,0,0
20622,58thStGreenway22ndAve,06/06/2016 06:00:00 AM,48,-122,0,1,1
20623,58thStGreenway22ndAve,06/06/2016 07:00:00 AM,48,-122,1,5,6
20624,58thStGreenway22ndAve,06/06/2016 08:00:00 AM,48,-122,12,14,26
20625,58thStGreenway22ndAve,06/06/2016 09:00:00 AM,48,-122,6,5,11
20626,58thStGreenway22ndAve,06/06/2016 10:00:00 AM,48,-122,4,6,10
20627,58thStGreenway22ndAve,06/06/2016 11:00:00 AM,48,-122,2,7,9
20628,58thStGreenway22ndAve,06/06/2016 12:00:00 PM,48,-122,5,3,8
20629,58thStGreenway22ndAve,06/06/2016 01:00:00 PM,48,-122,6,4,10
20630,58thStGreenway22ndAve,06/06/2016 02:00:00 PM,48,-122,5,11,16
20631,58thStGreenway22ndAve,06/06/2016 03:00:00 PM,48,-122,2,11,13
20632,58thStGreenway22ndAve,06/06/2016 04:00:00 PM,48,-122,8,8,16
20633,58thStGreenway22ndAve,06/06/2016 05:00:00 PM,48,-122,20,5,25
20634,58thStGreenway22ndAve,06/06/2016 06:00:00 PM,48,-122,16,14,30
20635,58thStGreenway22ndAve,06/06/2016 07:00:00 PM,48,-122,12,14,26
20636,58thStGreenway22ndAve,06/06/2016 08:00:00 PM,48,-122,5,1,6
20637,58thStGreenway22ndAve,06/06/2016 09:00:00 PM,48,-122,9,1,10
20638,58thStGreenway22ndAve,06/06/2016 10:00:00 PM,48,-122,4,1,5
20639,58thStGreenway22ndAve,06/06/2016 11:00:00 PM,48,-122,0,0,0
20640,58thStGreenway22ndAve,06/07/2016 12:00:00 AM,48,-122,0,0,0
20641,58thStGreenway22ndAve,06/07/2016 01:00:00 AM,48,-122,0,0,0
20642,58thStGreenway22ndAve,06/07/2016 02:00:00 AM,48,-122,1,0,1
20643,58thStGreenway22ndAve,06/07/2016 03:00:00 AM,48,-122,0,0,0
20644,58thStGreenway22ndAve,06/07/2016 04:00:00 AM,48,-122,0,0,0
20645,58thStGreenway22ndAve,06/07/2016 05:00:00 AM,48,-122,0,0,0
20646,58thStGreenway22ndAve,06/07/2016 06:00:00 AM,48,-122,1,2,3
20647,58thStGreenway22ndAve,06/07/2016 07:00:00 AM,48,-122,5,3,8
20648,58thStGreenway22ndAve,06/07/2016 08:00:00 AM,48,-122,7,9,16
20649,58thStGreenway22ndAve,06/07/2016 09:00:00 AM,48,-122,4,7,11
20650,58thStGreenway22ndAve,06/07/2016 10:00:00 AM,48,-122,7,8,15
20651,58thStGreenway22ndAve,06/07/2016 11:00:00 AM,48,-122,1,3,4
20652,58thStGreenway22ndAve,06/07/2016 12:00:00 PM,48,-122,8,6,14
20653,58thStGreenway22ndAve,06/07/2016 01:00:00 PM,48,-122,1,6,7
20654,58thStGreenway22ndAve,06/07/2016 02:00:00 PM,48,-122,0,5,5
20655,58thStGreenway22ndAve,06/07/2016 03:00:00 PM,48,-122,5,2,7
20656,58thStGreenway22ndAve,06/07/2016 04:00:00 PM,48,-122,8,5,13
20657,58thStGreenway22ndAve,06/07/2016 05:00:00 PM,48,-122,12,12,24
20658,58thStGreenway22ndAve,06/07/2016 06:00:00 PM,48,-122,9,16,25
20659,58thStGreenway22ndAve,06/07/2016 07:00:00 PM,48,-122,16,1,17
20660,58thStGreenway22ndAve,06/07/2016 08:00:00 PM,48,-122,9,5,14
20661,58thStGreenway22ndAve,06/07/2016 09:00:00 PM,48,-122,0,2,2
20662,58thStGreenway22ndAve,06/07/2016 10:00:00 PM,48,-122,0,0,0
20663,58thStGreenway22ndAve,06/07/2016 11:00:00 PM,48,-122,0,0,0
20664,58thStGreenway22ndAve,06/08/2016 12:00:00 AM,48,-122,4,0,4
20665,58thStGreenway22ndAve,06/08/2016 01:00:00 AM,48,-122,0,0,0
20666,58thStGreenway22ndAve,06/08/2016 02:00:00 AM,48,-122,0,1,1
20667,58thStGreenway22ndAve,06/08/2016 03:00:00 AM,48,-122,0,0,0
20668,58thStGreenway22ndAve,06/08/2016 04:00:00 AM,48,-122,0,0,0
20669,58thStGreenway22ndAve,06/08/2016 05:00:00 AM,48,-122,0,0,0
20670,58thStGreenway22ndAve,06/08/2016 06:00:00 AM,48,-122,3,2,5
20671,58thStGreenway22ndAve,06/08/2016 07:00:00 AM,48,-122,3,4,7
20672,58thStGreenway22ndAve,06/08/2016 08:00:00 AM,48,-122,8,8,16
20673,58thStGreenway22ndAve,06/08/2016 09:00:00 AM,48,-122,7,5,12
20674,58thStGreenway22ndAve,06/08/2016 10:00:00 AM,48,-122,2,3,5
20675,58thStGreenway22ndAve,06/08/2016 11:00:00 AM,48,-122,3,0,3
20676,58thStGreenway22ndAve,06/08/2016 12:00:00 PM,48,-122,2,5,7
20677,58thStGreenway22ndAve,06/08/2016 01:00:00 PM,48,-122,0,4,4
20678,58thStGreenway22ndAve,06/08/2016 02:00:00 PM,48,-122,4,1,5
20679,58thStGreenway22ndAve,06/08/2016 03:00:00 PM,48,-122,3,3,6
20680,58thStGreenway22ndAve,06/08/2016 04:00:00 PM,48,-122,4,6,10
20681,58thStGreenway22ndAve,06/08/2016 05:00:00 PM,48,-122,10,6,16
20682,58thStGreenway22ndAve,06/08/2016 06:00:00 PM,48,-122,11,6,17
20683,58thStGreenway22ndAve,06/08/2016 07:00:00 PM,48,-122,6,6,12
20684,58thStGreenway22ndAve,06/08/2016 08:00:00 PM,48,-122,7,4,11
20685,58thStGreenway22ndAve,06/08/2016 09:00:00 PM,48,-122,2,5,7
20686,58thStGreenway22ndAve,06/08/2016 10:00:00 PM,48,-122,2,2,4
20687,58thStGreenway22ndAve,06/08/2016 11:00:00 PM,48,-122,9,5,14
20688,58thStGreenway22ndAve,06/09/2016 12:00:00 AM,48,-122,1,0,1
20689,58thStGreenway22ndAve,06/09/2016 01:00:00 AM,48,-122,0,1,1
20690,58thStGreenway22ndAve,06/09/2016 02:00:00 AM,48,-122,0,3,3
20691,58thStGreenway22ndAve,06/09/2016 03:00:00 AM,48,-122,0,0,0
20692,58thStGreenway22ndAve,06/09/2016 04:00:00 AM,48,-122,0,0,0
20693,58thStGreenway22ndAve,06/09/2016 05:00:00 AM,48,-122,0,1,1
20694,58thStGreenway22ndAve,06/09/2016 06:00:00 AM,48,-122,1,2,3
20695,58thStGreenway22ndAve,06/09/2016 07:00:00 AM,48,-122,6,1,7
20696,58thStGreenway22ndAve,06/09/2016 08:00:00 AM,48,-122,6,7,13
20697,58thStGreenway22ndAve,06/09/2016 09:00:00 AM,48,-122,4,3,7
20698,58thStGreenway22ndAve,06/09/2016 10:00:00 AM,48,-122,5,9,14
20699,58thStGreenway22ndAve,06/09/2016 11:00:00 AM,48,-122,2,8,10
20700,58thStGreenway22ndAve,06/09/2016 12:00:00 PM,48,-122,6,0,6
20701,58thStGreenway22ndAve,06/09/2016 01:00:00 PM,48,-122,2,2,4
20702,58thStGreenway22ndAve,06/09/2016 02:00:00 PM,48,-122,1,1,2
20703,58thStGreenway22ndAve,06/09/2016 03:00:00 PM,48,-122,1,1,2
20704,58thStGreenway22ndAve,06/09/2016 04:00:00 PM,48,-122,7,4,11
20705,58thStGreenway22ndAve,06/09/2016 05:00:00 PM,48,-122,3,2,5
20706,58thStGreenway22ndAve,06/09/2016 06:00:00 PM,48,-122,11,9,20
20707,58thStGreenway22ndAve,06/09/2016 07:00:00 PM,48,-122,5,7,12
20708,58thStGreenway22ndAve,06/09/2016 08:00:00 PM,48,-122,5,3,8
20709,58thStGreenway22ndAve,06/09/2016 09:00:00 PM,48,-122,2,1,3
20710,58thStGreenway22ndAve,06/09/2016 10:00:00 PM,48,-122,1,2,3
20711,58thStGreenway22ndAve,06/09/2016 11:00:00 PM,48,-122,1,0,1
20712,58thStGreenway22ndAve,06/10/2016 12:00:00 AM,48,-122,0,0,0
20713,58thStGreenway22ndAve,06/10/2016 01:00:00 AM,48,-122,0,0,0
20714,58thStGreenway22ndAve,06/10/2016 02:00:00 AM,48,-122,0,1,1
20715,58thStGreenway22ndAve,06/10/2016 03:00:00 AM,48,-122,0,0,0
20716,58thStGreenway22ndAve,06/10/2016 04:00:00 AM,48,-122,0,0,0
20717,58thStGreenway22ndAve,06/10/2016 05:00:00 AM,48,-122,0,2,2
20718,58thStGreenway22ndAve,06/10/2016 06:00:00 AM,48,-122,2,0,2
20719,58thStGreenway22ndAve,06/10/2016 07:00:00 AM,48,-122,4,4,8
20720,58thStGreenway22ndAve,06/10/2016 08:00:00 AM,48,-122,4,6,10
20721,58thStGreenway22ndAve,06/10/2016 09:00:00 AM,48,-122,5,3,8
20722,58thStGreenway22ndAve,06/10/2016 10:00:00 AM,48,-122,5,4,9
20723,58thStGreenway22ndAve,06/10/2016 11:00:00 AM,48,-122,1,3,4
20724,58thStGreenway22ndAve,06/10/2016 12:00:00 PM,48,-122,3,8,11
20725,58thStGreenway22ndAve,06/10/2016 01:00:00 PM,48,-122,9,10,19
20726,58thStGreenway22ndAve,06/10/2016 02:00:00 PM,48,-122,7,3,10
20727,58thStGreenway22ndAve,06/10/2016 03:00:00 PM,48,-122,1,2,3
20728,58thStGreenway22ndAve,06/10/2016 04:00:00 PM,48,-122,4,6,10
20729,58thStGreenway22ndAve,06/10/2016 05:00:00 PM,48,-122,6,5,11
20730,58thStGreenway22ndAve,06/10/2016 06:00:00 PM,48,-122,1,1,2
20731,58thStGreenway22ndAve,06/10/2016 07:00:00 PM,48,-122,5,1,6
20732,58thStGreenway22ndAve,06/10/2016 08:00:00 PM,48,-122,3,2,5
20733,58thStGreenway22ndAve,06/10/2016 09:00:00 PM,48,-122,2,2,4
20734,58thStGreenway22ndAve,06/10/2016 10:00:00 PM,48,-122,0,0,0
20735,58thStGreenway22ndAve,06/10/2016 11:00:00 PM,48,-122,4,2,6
20736,58thStGreenway22ndAve,06/11/2016 12:00:00 AM,48,-122,1,0,1
20737,58thStGreenway22ndAve,06/11/2016 01:00:00 AM,48,-122,0,0,0
20738,58thStGreenway22ndAve,06/11/2016 02:00:00 AM,48,-122,0,0,0
20739,58thStGreenway22ndAve,06/11/2016 03:00:00 AM,48,-122,2,0,2
20740,58thStGreenway22ndAve,06/11/2016 04:00:00 AM,48,-122,0,0,0
20741,58thStGreenway22ndAve,06/11/2016 05:00:00 AM,48,-122,1,0,1
20742,58thStGreenway22ndAve,06/11/2016 06:00:00 AM,48,-122,0,0,0
20743,58thStGreenway22ndAve,06/11/2016 07:00:00 AM,48,-122,4,3,7
20744,58thStGreenway22ndAve,06/11/2016 08:00:00 AM,48,-122,1,1,2
20745,58thStGreenway22ndAve,06/11/2016 09:00:00 AM,48,-122,3,1,4
20746,58thStGreenway22ndAve,06/11/2016 10:00:00 AM,48,-122,2,5,7
20747,58thStGreenway22ndAve,06/11/2016 11:00:00 AM,48,-122,12,13,25
20748,58thStGreenway22ndAve,06/11/2016 12:00:00 PM,48,-122,6,10,16
20749,58thStGreenway22ndAve,06/11/2016 01:00:00 PM,48,-122,9,4,13
20750,58thStGreenway22ndAve,06/11/2016 02:00:00 PM,48,-122,7,2,9
20751,58thStGreenway22ndAve,06/11/2016 03:00:00 PM,48,-122,5,8,13
20752,58thStGreenway22ndAve,06/11/2016 04:00:00 PM,48,-122,8,2,10
20753,58thStGreenway22ndAve,06/11/2016 05:00:00 PM,48,-122,9,5,14
20754,58thStGreenway22ndAve,06/11/2016 06:00:00 PM,48,-122,5,4,9
20755,58thStGreenway22ndAve,06/11/2016 07:00:00 PM,48,-122,0,3,3
20756,58thStGreenway22ndAve,06/11/2016 08:00:00 PM,48,-122,5,3,8
20757,58thStGreenway22ndAve,06/11/2016 09:00:00 PM,48,-122,3,2,5
20758,58thStGreenway22ndAve,06/11/2016 10:00:00 PM,48,-122,1,0,1
20759,58thStGreenway22ndAve,06/11/2016 11:00:00 PM,48,-122,0,0,0
20760,58thStGreenway22ndAve,06/12/2016 12:00:00 AM,48,-122,0,0,0
20761,58thStGreenway22ndAve,06/12/2016 01:00:00 AM,48,-122,0,0,0
20762,58thStGreenway22ndAve,06/12/2016 02:00:00 AM,48,-122,0,0,0
20763,58thStGreenway22ndAve,06/12/2016 03:00:00 AM,48,-122,0,0,0
20764,58thStGreenway22ndAve,06/12/2016 04:00:00 AM,48,-122,0,0,0
20765,58thStGreenway22ndAve,06/12/2016 05:00:00 AM,48,-122,0,0,0
20766,58thStGreenway22ndAve,06/12/2016 06:00:00 AM,48,-122,0,0,0
20767,58thStGreenway22ndAve,06/12/2016 07:00:00 AM,48,-122,0,0,0
20768,58thStGreenway22ndAve,06/12/2016 08:00:00 AM,48,-122,2,4,6
20769,58thStGreenway22ndAve,06/12/2016 09:00:00 AM,48,-122,4,7,11
20770,58thStGreenway22ndAve,06/12/2016 10:00:00 AM,48,-122,12,5,17
20771,58thStGreenway22ndAve,06/12/2016 11:00:00 AM,48,-122,9,12,21
20772,58thStGreenway22ndAve,06/12/2016 12:00:00 PM,48,-122,3,4,7
20773,58thStGreenway22ndAve,06/12/2016 01:00:00 PM,48,-122,7,13,20
20774,58thStGreenway22ndAve,06/12/2016 02:00:00 PM,48,-122,10,11,21
20775,58thStGreenway22ndAve,06/12/2016 03:00:00 PM,48,-122,10,12,22
20776,58thStGreenway22ndAve,06/12/2016 04:00:00 PM,48,-122,12,9,21
20777,58thStGreenway22ndAve,06/12/2016 05:00:00 PM,48,-122,5,11,16
20778,58thStGreenway22ndAve,06/12/2016 06:00:00 PM,48,-122,13,10,23
20779,58thStGreenway22ndAve,06/12/2016 07:00:00 PM,48,-122,7,9,16
20780,58thStGreenway22ndAve,06/12/2016 08:00:00 PM,48,-122,2,5,7
20781,58thStGreenway22ndAve,06/12/2016 09:00:00 PM,48,-122,5,2,7
20782,58thStGreenway22ndAve,06/12/2016 10:00:00 PM,48,-122,3,1,4
20783,58thStGreenway22ndAve,06/12/2016 11:00:00 PM,48,-122,1,2,3
20784,58thStGreenway22ndAve,06/13/2016 12:00:00 AM,48,-122,0,0,0
20785,58thStGreenway22ndAve,06/13/2016 01:00:00 AM,48,-122,0,1,1
20786,58thStGreenway22ndAve,06/13/2016 02:00:00 AM,48,-122,0,0,0
20787,58thStGreenway22ndAve,06/13/2016 03:00:00 AM,48,-122,1,0,1
20788,58thStGreenway22ndAve,06/13/2016 04:00:00 AM,48,-122,0,0,0
20789,58thStGreenway22ndAve,06/13/2016 05:00:00 AM,48,-122,1,1,2
20790,58thStGreenway22ndAve,06/13/2016 06:00:00 AM,48,-122,0,0,0
20791,58thStGreenway22ndAve,06/13/2016 07:00:00 AM,48,-122,3,3,6
20792,58thStGreenway22ndAve,06/13/2016 08:00:00 AM,48,-122,4,10,14
20793,58thStGreenway22ndAve,06/13/2016 09:00:00 AM,48,-122,5,14,19
20794,58thStGreenway22ndAve,06/13/2016 10:00:00 AM,48,-122,0,2,2
20795,58thStGreenway22ndAve,06/13/2016 11:00:00 AM,48,-122,1,1,2
20796,58thStGreenway22ndAve,06/13/2016 12:00:00 PM,48,-122,0,4,4
20797,58thStGreenway22ndAve,06/13/2016 01:00:00 PM,48,-122,0,4,4
20798,58thStGreenway22ndAve,06/13/2016 02:00:00 PM,48,-122,13,4,17
20799,58thStGreenway22ndAve,06/13/2016 03:00:00 PM,48,-122,5,6,11
20800,58thStGreenway22ndAve,06/13/2016 04:00:00 PM,48,-122,4,7,11
20801,58thStGreenway22ndAve,06/13/2016 05:00:00 PM,48,-122,7,2,9
20802,58thStGreenway22ndAve,06/13/2016 06:00:00 PM,48,-122,9,8,17
20803,58thStGreenway22ndAve,06/13/2016 07:00:00 PM,48,-122,2,2,4
20804,58thStGreenway22ndAve,06/13/2016 08:00:00 PM,48,-122,1,2,3
20805,58thStGreenway22ndAve,06/13/2016 09:00:00 PM,48,-122,5,0,5
20806,58thStGreenway22ndAve,06/13/2016 10:00:00 PM,48,-122,2,1,3
20807,58thStGreenway22ndAve,06/13/2016 11:00:00 PM,48,-122,1,2,3
20808,58thStGreenway22ndAve,06/14/2016 12:00:00 AM,48,-122,0,0,0
20809,58thStGreenway22ndAve,06/14/2016 01:00:00 AM,48,-122,0,0,0
20810,58thStGreenway22ndAve,06/14/2016 02:00:00 AM,48,-122,0,0,0
20811,58thStGreenway22ndAve,06/14/2016 03:00:00 AM,48,-122,0,0,0
20812,58thStGreenway22ndAve,06/14/2016 04:00:00 AM,48,-122,1,2,3
20813,58thStGreenway22ndAve,06/14/2016 05:00:00 AM,48,-122,0,1,1
20814,58thStGreenway22ndAve,06/14/2016 06:00:00 AM,48,-122,3,1,4
20815,58thStGreenway22ndAve,06/14/2016 07:00:00 AM,48,-122,4,1,5
20816,58thStGreenway22ndAve,06/14/2016 08:00:00 AM,48,-122,3,5,8
20817,58thStGreenway22ndAve,06/14/2016 09:00:00 AM,48,-122,5,5,10
20818,58thStGreenway22ndAve,06/14/2016 10:00:00 AM,48,-122,0,8,8
20819,58thStGreenway22ndAve,06/14/2016 11:00:00 AM,48,-122,2,6,8
20820,58thStGreenway22ndAve,06/14/2016 12:00:00 PM,48,-122,4,5,9
20821,58thStGreenway22ndAve,06/14/2016 01:00:00 PM,48,-122,5,6,11
20822,58thStGreenway22ndAve,06/14/2016 02:00:00 PM,48,-122,4,5,9
20823,58thStGreenway22ndAve,06/14/2016 03:00:00 PM,48,-122,8,2,10
20824,58thStGreenway22ndAve,06/14/2016 04:00:00 PM,48,-122,7,1,8
20825,58thStGreenway22ndAve,06/14/2016 05:00:00 PM,48,-122,4,11,15
20826,58thStGreenway22ndAve,06/14/2016 06:00:00 PM,48,-122,10,11,21
20827,58thStGreenway22ndAve,06/14/2016 07:00:00 PM,48,-122,10,5,15
20828,58thStGreenway22ndAve,06/14/2016 08:00:00 PM,48,-122,0,1,1
20829,58thStGreenway22ndAve,06/14/2016 09:00:00 PM,48,-122,3,3,6
20830,58thStGreenway22ndAve,06/14/2016 10:00:00 PM,48,-122,0,0,0
20831,58thStGreenway22ndAve,06/14/2016 11:00:00 PM,48,-122,1,0,1
20832,58thStGreenway22ndAve,06/15/2016 12:00:00 AM,48,-122,0,0,0
20833,58thStGreenway22ndAve,06/15/2016 01:00:00 AM,48,-122,0,0,0
20834,58thStGreenway22ndAve,06/15/2016 02:00:00 AM,48,-122,0,0,0
20835,58thStGreenway22ndAve,06/15/2016 03:00:00 AM,48,-122,0,0,0
20836,58thStGreenway22ndAve,06/15/2016 04:00:00 AM,48,-122,0,0,0
20837,58thStGreenway22ndAve,06/15/2016 05:00:00 AM,48,-122,0,4,4
20838,58thStGreenway22ndAve,06/15/2016 06:00:00 AM,48,-122,0,0,0
20839,58thStGreenway22ndAve,06/15/2016 07:00:00 AM,48,-122,11,3,14
20840,58thStGreenway22ndAve,06/15/2016 08:00:00 AM,48,-122,5,4,9
20841,58thStGreenway22ndAve,06/15/2016 09:00:00 AM,48,-122,4,13,17
20842,58thStGreenway22ndAve,06/15/2016 10:00:00 AM,48,-122,3,2,5
20843,58thStGreenway22ndAve,06/15/2016 11:00:00 AM,48,-122,4,7,11
20844,58thStGreenway22ndAve,06/15/2016 12:00:00 PM,48,-122,6,8,14
20845,58thStGreenway22ndAve,06/15/2016 01:00:00 PM,48,-122,5,7,12
20846,58thStGreenway22ndAve,06/15/2016 02:00:00 PM,48,-122,2,2,4
20847,58thStGreenway22ndAve,06/15/2016 03:00:00 PM,48,-122,8,7,15
20848,58thStGreenway22ndAve,06/15/2016 04:00:00 PM,48,-122,7,4,11
20849,58thStGreenway22ndAve,06/15/2016 05:00:00 PM,48,-122,16,9,25
20850,58thStGreenway22ndAve,06/15/2016 06:00:00 PM,48,-122,15,12,27
20851,58thStGreenway22ndAve,06/15/2016 07:00:00 PM,48,-122,6,8,14
20852,58thStGreenway22ndAve,06/15/2016 08:00:00 PM,48,-122,7,5,12
20853,58thStGreenway22ndAve,06/15/2016 09:00:00 PM,48,-122,6,4,10
20854,58thStGreenway22ndAve,06/15/2016 10:00:00 PM,48,-122,7,0,7
20855,58thStGreenway22ndAve,06/15/2016 11:00:00 PM,48,-122,1,0,1
20856,58thStGreenway22ndAve,06/16/2016 12:00:00 AM,48,-122,0,1,1
20857,58thStGreenway22ndAve,06/16/2016 01:00:00 AM,48,-122,0,0,0
20858,58thStGreenway22ndAve,06/16/2016 02:00:00 AM,48,-122,0,0,0
20859,58thStGreenway22ndAve,06/16/2016 03:00:00 AM,48,-122,0,0,0
20860,58thStGreenway22ndAve,06/16/2016 04:00:00 AM,48,-122,0,0,0
20861,58thStGreenway22ndAve,06/16/2016 05:00:00 AM,48,-122,0,1,1
20862,58thStGreenway22ndAve,06/16/2016 06:00:00 AM,48,-122,0,1,1
20863,58thStGreenway22ndAve,06/16/2016 07:00:00 AM,48,-122,10,2,12
20864,58thStGreenway22ndAve,06/16/2016 08:00:00 AM,48,-122,4,6,10
20865,58thStGreenway22ndAve,06/16/2016 09:00:00 AM,48,-122,7,7,14
20866,58thStGreenway22ndAve,06/16/2016 10:00:00 AM,48,-122,0,6,6
20867,58thStGreenway22ndAve,06/16/2016 11:00:00 AM,48,-122,4,4,8
20868,58thStGreenway22ndAve,06/16/2016 12:00:00 PM,48,-122,2,3,5
20869,58thStGreenway22ndAve,06/16/2016 01:00:00 PM,48,-122,4,11,15
20870,58thStGreenway22ndAve,06/16/2016 02:00:00 PM,48,-122,7,3,10
20871,58thStGreenway22ndAve,06/16/2016 03:00:00 PM,48,-122,3,7,10
20872,58thStGreenway22ndAve,06/16/2016 04:00:00 PM,48,-122,7,6,13
20873,58thStGreenway22ndAve,06/16/2016 05:00:00 PM,48,-122,5,4,9
20874,58thStGreenway22ndAve,06/16/2016 06:00:00 PM,48,-122,13,6,19
20875,58thStGreenway22ndAve,06/16/2016 07:00:00 PM,48,-122,10,5,15
20876,58thStGreenway22ndAve,06/16/2016 08:00:00 PM,48,-122,9,2,11
20877,58thStGreenway22ndAve,06/16/2016 09:00:00 PM,48,-122,3,2,5
20878,58thStGreenway22ndAve,06/16/2016 10:00:00 PM,48,-122,1,2,3
20879,58thStGreenway22ndAve,06/16/2016 11:00:00 PM,48,-122,1,0,1
20880,58thStGreenway22ndAve,06/17/2016 12:00:00 AM,48,-122,0,0,0
20881,58thStGreenway22ndAve,06/17/2016 01:00:00 AM,48,-122,0,0,0
20882,58thStGreenway22ndAve,06/17/2016 02:00:00 AM,48,-122,0,2,2
20883,58thStGreenway22ndAve,06/17/2016 03:00:00 AM,48,-122,0,0,0
20884,58thStGreenway22ndAve,06/17/2016 04:00:00 AM,48,-122,1,0,1
20885,58thStGreenway22ndAve,06/17/2016 05:00:00 AM,48,-122,0,0,0
20886,58thStGreenway22ndAve,06/17/2016 06:00:00 AM,48,-122,0,2,2
20887,58thStGreenway22ndAve,06/17/2016 07:00:00 AM,48,-122,3,1,4
20888,58thStGreenway22ndAve,06/17/2016 08:00:00 AM,48,-122,5,10,15
20889,58thStGreenway22ndAve,06/17/2016 09:00:00 AM,48,-122,6,6,12
20890,58thStGreenway22ndAve,06/17/2016 10:00:00 AM,48,-122,3,3,6
20891,58thStGreenway22ndAve,06/17/2016 11:00:00 AM,48,-122,4,2,6
20892,58thStGreenway22ndAve,06/17/2016 12:00:00 PM,48,-122,7,7,14
20893,58thStGreenway22ndAve,06/17/2016 01:00:00 PM,48,-122,5,6,11
20894,58thStGreenway22ndAve,06/17/2016 02:00:00 PM,48,-122,5,4,9
20895,58thStGreenway22ndAve,06/17/2016 03:00:00 PM,48,-122,3,0,3
20896,58thStGreenway22ndAve,06/17/2016 04:00:00 PM,48,-122,7,3,10
20897,58thStGreenway22ndAve,06/17/2016 05:00:00 PM,48,-122,3,9,12
20898,58thStGreenway22ndAve,06/17/2016 06:00:00 PM,48,-122,5,3,8
20899,58thStGreenway22ndAve,06/17/2016 07:00:00 PM,48,-122,2,3,5
20900,58thStGreenway22ndAve,06/17/2016 08:00:00 PM,48,-122,7,2,9
20901,58thStGreenway22ndAve,06/17/2016 09:00:00 PM,48,-122,0,1,1
20902,58thStGreenway22ndAve,06/17/2016 10:00:00 PM,48,-122,1,3,4
20903,58thStGreenway22ndAve,06/17/2016 11:00:00 PM,48,-122,1,1,2
20904,58thStGreenway22ndAve,06/18/2016 12:00:00 AM,48,-122,0,0,0
20905,58thStGreenway22ndAve,06/18/2016 01:00:00 AM,48,-122,0,0,0
20906,58thStGreenway22ndAve,06/18/2016 02:00:00 AM,48,-122,0,0,0
20907,58thStGreenway22ndAve,06/18/2016 03:00:00 AM,48,-122,0,0,0
20908,58thStGreenway22ndAve,06/18/2016 04:00:00 AM,48,-122,0,0,0
20909,58thStGreenway22ndAve,06/18/2016 05:00:00 AM,48,-122,0,0,0
20910,58thStGreenway22ndAve,06/18/2016 06:00:00 AM,48,-122,2,0,2
20911,58thStGreenway22ndAve,06/18/2016 07:00:00 AM,48,-122,0,0,0
20912,58thStGreenway22ndAve,06/18/2016 08:00:00 AM,48,-122,1,3,4
20913,58thStGreenway22ndAve,06/18/2016 09:00:00 AM,48,-122,4,3,7
20914,58thStGreenway22ndAve,06/18/2016 10:00:00 AM,48,-122,4,5,9
20915,58thStGreenway22ndAve,06/18/2016 11:00:00 AM,48,-122,1,2,3
20916,58thStGreenway22ndAve,06/18/2016 12:00:00 PM,48,-122,9,3,12
20917,58thStGreenway22ndAve,06/18/2016 01:00:00 PM,48,-122,2,8,10
20918,58thStGreenway22ndAve,06/18/2016 02:00:00 PM,48,-122,19,4,23
20919,58thStGreenway22ndAve,06/18/2016 03:00:00 PM,48,-122,4,2,6
20920,58thStGreenway22ndAve,06/18/2016 04:00:00 PM,48,-122,5,2,7
20921,58thStGreenway22ndAve,06/18/2016 05:00:00 PM,48,-122,6,6,12
20922,58thStGreenway22ndAve,06/18/2016 06:00:00 PM,48,-122,1,0,1
20923,58thStGreenway22ndAve,06/18/2016 07:00:00 PM,48,-122,0,0,0
20924,58thStGreenway22ndAve,06/18/2016 08:00:00 PM,48,-122,1,3,4
20925,58thStGreenway22ndAve,06/18/2016 09:00:00 PM,48,-122,3,0,3
20926,58thStGreenway22ndAve,06/18/2016 10:00:00 PM,48,-122,0,1,1
20927,58thStGreenway22ndAve,06/18/2016 11:00:00 PM,48,-122,0,0,0
20928,58thStGreenway22ndAve,06/19/2016 12:00:00 AM,48,-122,1,0,1
20929,58thStGreenway22ndAve,06/19/2016 01:00:00 AM,48,-122,0,0,0
20930,58thStGreenway22ndAve,06/19/2016 02:00:00 AM,48,-122,0,0,0
20931,58thStGreenway22ndAve,06/19/2016 03:00:00 AM,48,-122,0,0,0
20932,58thStGreenway22ndAve,06/19/2016 04:00:00 AM,48,-122,0,0,0
20933,58thStGreenway22ndAve,06/19/2016 05:00:00 AM,48,-122,0,0,0
20934,58thStGreenway22ndAve,06/19/2016 06:00:00 AM,48,-122,0,1,1
20935,58thStGreenway22ndAve,06/19/2016 07:00:00 AM,48,-122,2,2,4
20936,58thStGreenway22ndAve,06/19/2016 08:00:00 AM,48,-122,2,0,2
20937,58thStGreenway22ndAve,06/19/2016 09:00:00 AM,48,-122,3,1,4
20938,58thStGreenway22ndAve,06/19/2016 10:00:00 AM,48,-122,2,13,15
20939,58thStGreenway22ndAve,06/19/2016 11:00:00 AM,48,-122,5,3,8
20940,58thStGreenway22ndAve,06/19/2016 12:00:00 PM,48,-122,3,6,9
20941,58thStGreenway22ndAve,06/19/2016 01:00:00 PM,48,-122,8,10,18
20942,58thStGreenway22ndAve,06/19/2016 02:00:00 PM,48,-122,11,11,22
20943,58thStGreenway22ndAve,06/19/2016 03:00:00 PM,48,-122,4,6,10
20944,58thStGreenway22ndAve,06/19/2016 04:00:00 PM,48,-122,14,10,24
20945,58thStGreenway22ndAve,06/19/2016 05:00:00 PM,48,-122,16,12,28
20946,58thStGreenway22ndAve,06/19/2016 06:00:00 PM,48,-122,7,1,8
20947,58thStGreenway22ndAve,06/19/2016 07:00:00 PM,48,-122,3,0,3
20948,58thStGreenway22ndAve,06/19/2016 08:00:00 PM,48,-122,1,3,4
20949,58thStGreenway22ndAve,06/19/2016 09:00:00 PM,48,-122,2,0,2
20950,58thStGreenway22ndAve,06/19/2016 10:00:00 PM,48,-122,0,0,0
20951,58thStGreenway22ndAve,06/19/2016 11:00:00 PM,48,-122,0,0,0
20952,58thStGreenway22ndAve,06/20/2016 12:00:00 AM,48,-122,1,0,1
20953,58thStGreenway22ndAve,06/20/2016 01:00:00 AM,48,-122,0,0,0
20954,58thStGreenway22ndAve,06/20/2016 02:00:00 AM,48,-122,0,0,0
20955,58thStGreenway22ndAve,06/20/2016 03:00:00 AM,48,-122,0,0,0
20956,58thStGreenway22ndAve,06/20/2016 04:00:00 AM,48,-122,0,0,0
20957,58thStGreenway22ndAve,06/20/2016 05:00:00 AM,48,-122,1,0,1
20958,58thStGreenway22ndAve,06/20/2016 06:00:00 AM,48,-122,1,3,4
20959,58thStGreenway22ndAve,06/20/2016 07:00:00 AM,48,-122,6,4,10
20960,58thStGreenway22ndAve,06/20/2016 08:00:00 AM,48,-122,4,9,13
20961,58thStGreenway22ndAve,06/20/2016 09:00:00 AM,48,-122,6,4,10
20962,58thStGreenway22ndAve,06/20/2016 10:00:00 AM,48,-122,1,8,9
20963,58thStGreenway22ndAve,06/20/2016 11:00:00 AM,48,-122,0,5,5
20964,58thStGreenway22ndAve,06/20/2016 12:00:00 PM,48,-122,4,7,11
20965,58thStGreenway22ndAve,06/20/2016 01:00:00 PM,48,-122,6,4,10
20966,58thStGreenway22ndAve,06/20/2016 02:00:00 PM,48,-122,3,1,4
20967,58thStGreenway22ndAve,06/20/2016 03:00:00 PM,48,-122,5,6,11
20968,58thStGreenway22ndAve,06/20/2016 04:00:00 PM,48,-122,3,6,9
20969,58thStGreenway22ndAve,06/20/2016 05:00:00 PM,48,-122,10,4,14
20970,58thStGreenway22ndAve,06/20/2016 06:00:00 PM,48,-122,9,9,18
20971,58thStGreenway22ndAve,06/20/2016 07:00:00 PM,48,-122,6,9,15
20972,58thStGreenway22ndAve,06/20/2016 08:00:00 PM,48,-122,5,6,11
20973,58thStGreenway22ndAve,06/20/2016 09:00:00 PM,48,-122,2,5,7
20974,58thStGreenway22ndAve,06/20/2016 10:00:00 PM,48,-122,2,3,5
20975,58thStGreenway22ndAve,06/20/2016 11:00:00 PM,48,-122,0,0,0
20976,58thStGreenway22ndAve,06/21/2016 12:00:00 AM,48,-122,0,0,0
20977,58thStGreenway22ndAve,06/21/2016 01:00:00 AM,48,-122,0,0,0
20978,58thStGreenway22ndAve,06/21/2016 02:00:00 AM,48,-122,0,0,0
20979,58thStGreenway22ndAve,06/21/2016 03:00:00 AM,48,-122,0,0,0
20980,58thStGreenway22ndAve,06/21/2016 04:00:00 AM,48,-122,0,0,0
20981,58thStGreenway22ndAve,06/21/2016 05:00:00 AM,48,-122,0,1,1
20982,58thStGreenway22ndAve,06/21/2016 06:00:00 AM,48,-122,1,1,2
20983,58thStGreenway22ndAve,06/21/2016 07:00:00 AM,48,-122,6,4,10
20984,58thStGreenway22ndAve,06/21/2016 08:00:00 AM,48,-122,10,5,15
20985,58thStGreenway22ndAve,06/21/2016 09:00:00 AM,48,-122,2,7,9
20986,58thStGreenway22ndAve,06/21/2016 10:00:00 AM,48,-122,3,8,11
20987,58thStGreenway22ndAve,06/21/2016 11:00:00 AM,48,-122,4,4,8
20988,58thStGreenway22ndAve,06/21/2016 12:00:00 PM,48,-122,6,6,12
20989,58thStGreenway22ndAve,06/21/2016 01:00:00 PM,48,-122,4,7,11
20990,58thStGreenway22ndAve,06/21/2016 02:00:00 PM,48,-122,6,2,8
20991,58thStGreenway22ndAve,06/21/2016 03:00:00 PM,48,-122,5,6,11
20992,58thStGreenway22ndAve,06/21/2016 04:00:00 PM,48,-122,5,9,14
20993,58thStGreenway22ndAve,06/21/2016 05:00:00 PM,48,-122,7,7,14
20994,58thStGreenway22ndAve,06/21/2016 06:00:00 PM,48,-122,16,17,33
20995,58thStGreenway22ndAve,06/21/2016 07:00:00 PM,48,-122,3,16,19
20996,58thStGreenway22ndAve,06/21/2016 08:00:00 PM,48,-122,10,6,16
20997,58thStGreenway22ndAve,06/21/2016 09:00:00 PM,48,-122,3,4,7
20998,58thStGreenway22ndAve,06/21/2016 10:00:00 PM,48,-122,2,4,6
20999,58thStGreenway22ndAve,06/21/2016 11:00:00 PM,48,-122,1,0,1
21000,58thStGreenway22ndAve,06/22/2016 12:00:00 AM,48,-122,0,0,0
21001,58thStGreenway22ndAve,06/22/2016 01:00:00 AM,48,-122,0,0,0
21002,58thStGreenway22ndAve,06/22/2016 02:00:00 AM,48,-122,0,0,0
21003,58thStGreenway22ndAve,06/22/2016 03:00:00 AM,48,-122,0,0,0
21004,58thStGreenway22ndAve,06/22/2016 04:00:00 AM,48,-122,0,0,0
21005,58thStGreenway22ndAve,06/22/2016 05:00:00 AM,48,-122,0,1,1
21006,58thStGreenway22ndAve,06/22/2016 06:00:00 AM,48,-122,1,3,4
21007,58thStGreenway22ndAve,06/22/2016 07:00:00 AM,48,-122,6,2,8
21008,58thStGreenway22ndAve,06/22/2016 08:00:00 AM,48,-122,11,5,16
21009,58thStGreenway22ndAve,06/22/2016 09:00:00 AM,48,-122,1,7,8
21010,58thStGreenway22ndAve,06/22/2016 10:00:00 AM,48,-122,6,16,22
21011,58thStGreenway22ndAve,06/22/2016 11:00:00 AM,48,-122,4,4,8
21012,58thStGreenway22ndAve,06/22/2016 12:00:00 PM,48,-122,2,6,8
21013,58thStGreenway22ndAve,06/22/2016 01:00:00 PM,48,-122,4,3,7
21014,58thStGreenway22ndAve,06/22/2016 02:00:00 PM,48,-122,4,4,8
21015,58thStGreenway22ndAve,06/22/2016 03:00:00 PM,48,-122,8,1,9
21016,58thStGreenway22ndAve,06/22/2016 04:00:00 PM,48,-122,5,6,11
21017,58thStGreenway22ndAve,06/22/2016 05:00:00 PM,48,-122,7,8,15
21018,58thStGreenway22ndAve,06/22/2016 06:00:00 PM,48,-122,11,16,27
21019,58thStGreenway22ndAve,06/22/2016 07:00:00 PM,48,-122,9,6,15
21020,58thStGreenway22ndAve,06/22/2016 08:00:00 PM,48,-122,3,3,6
21021,58thStGreenway22ndAve,06/22/2016 09:00:00 PM,48,-122,3,0,3
21022,58thStGreenway22ndAve,06/22/2016 10:00:00 PM,48,-122,1,0,1
21023,58thStGreenway22ndAve,06/22/2016 11:00:00 PM,48,-122,2,0,2
21024,58thStGreenway22ndAve,06/23/2016 12:00:00 AM,48,-122,0,0,0
21025,58thStGreenway22ndAve,06/23/2016 01:00:00 AM,48,-122,0,0,0
21026,58thStGreenway22ndAve,06/23/2016 02:00:00 AM,48,-122,1,0,1
21027,58thStGreenway22ndAve,06/23/2016 03:00:00 AM,48,-122,0,1,1
21028,58thStGreenway22ndAve,06/23/2016 04:00:00 AM,48,-122,0,0,0
21029,58thStGreenway22ndAve,06/23/2016 05:00:00 AM,48,-122,2,2,4
21030,58thStGreenway22ndAve,06/23/2016 06:00:00 AM,48,-122,1,0,1
21031,58thStGreenway22ndAve,06/23/2016 07:00:00 AM,48,-122,7,2,9
21032,58thStGreenway22ndAve,06/23/2016 08:00:00 AM,48,-122,4,4,8
21033,58thStGreenway22ndAve,06/23/2016 09:00:00 AM,48,-122,6,5,11
21034,58thStGreenway22ndAve,06/23/2016 10:00:00 AM,48,-122,3,3,6
21035,58thStGreenway22ndAve,06/23/2016 11:00:00 AM,48,-122,1,7,8
21036,58thStGreenway22ndAve,06/23/2016 12:00:00 PM,48,-122,2,9,11
21037,58thStGreenway22ndAve,06/23/2016 01:00:00 PM,48,-122,2,5,7
21038,58thStGreenway22ndAve,06/23/2016 02:00:00 PM,48,-122,4,4,8
21039,58thStGreenway22ndAve,06/23/2016 03:00:00 PM,48,-122,6,0,6
21040,58thStGreenway22ndAve,06/23/2016 04:00:00 PM,48,-122,5,3,8
21041,58thStGreenway22ndAve,06/23/2016 05:00:00 PM,48,-122,4,3,7
21042,58thStGreenway22ndAve,06/23/2016 06:00:00 PM,48,-122,3,3,6
21043,58thStGreenway22ndAve,06/23/2016 07:00:00 PM,48,-122,2,4,6
21044,58thStGreenway22ndAve,06/23/2016 08:00:00 PM,48,-122,3,1,4
21045,58thStGreenway22ndAve,06/23/2016 09:00:00 PM,48,-122,4,0,4
21046,58thStGreenway22ndAve,06/23/2016 10:00:00 PM,48,-122,1,1,2
21047,58thStGreenway22ndAve,06/23/2016 11:00:00 PM,48,-122,0,0,0
21048,58thStGreenway22ndAve,06/24/2016 12:00:00 AM,48,-122,0,0,0
21049,58thStGreenway22ndAve,06/24/2016 01:00:00 AM,48,-122,0,0,0
21050,58thStGreenway22ndAve,06/24/2016 02:00:00 AM,48,-122,0,0,0
21051,58thStGreenway22ndAve,06/24/2016 03:00:00 AM,48,-122,0,0,0
21052,58thStGreenway22ndAve,06/24/2016 04:00:00 AM,48,-122,0,0,0
21053,58thStGreenway22ndAve,06/24/2016 05:00:00 AM,48,-122,0,1,1
21054,58thStGreenway22ndAve,06/24/2016 06:00:00 AM,48,-122,0,2,2
21055,58thStGreenway22ndAve,06/24/2016 07:00:00 AM,48,-122,2,2,4
21056,58thStGreenway22ndAve,06/24/2016 08:00:00 AM,48,-122,5,4,9
21057,58thStGreenway22ndAve,06/24/2016 09:00:00 AM,48,-122,3,4,7
21058,58thStGreenway22ndAve,06/24/2016 10:00:00 AM,48,-122,3,4,7
21059,58thStGreenway22ndAve,06/24/2016 11:00:00 AM,48,-122,2,4,6
21060,58thStGreenway22ndAve,06/24/2016 12:00:00 PM,48,-122,8,12,20
21061,58thStGreenway22ndAve,06/24/2016 01:00:00 PM,48,-122,2,4,6
21062,58thStGreenway22ndAve,06/24/2016 02:00:00 PM,48,-122,3,6,9
21063,58thStGreenway22ndAve,06/24/2016 03:00:00 PM,48,-122,8,9,17
21064,58thStGreenway22ndAve,06/24/2016 04:00:00 PM,48,-122,1,5,6
21065,58thStGreenway22ndAve,06/24/2016 05:00:00 PM,48,-122,3,6,9
21066,58thStGreenway22ndAve,06/24/2016 06:00:00 PM,48,-122,9,4,13
21067,58thStGreenway22ndAve,06/24/2016 07:00:00 PM,48,-122,3,4,7
21068,58thStGreenway22ndAve,06/24/2016 08:00:00 PM,48,-122,2,1,3
21069,58thStGreenway22ndAve,06/24/2016 09:00:00 PM,48,-122,4,0,4
21070,58thStGreenway22ndAve,06/24/2016 10:00:00 PM,48,-122,0,2,2
21071,58thStGreenway22ndAve,06/24/2016 11:00:00 PM,48,-122,2,2,4
21072,58thStGreenway22ndAve,06/25/2016 12:00:00 AM,48,-122,2,1,3
21073,58thStGreenway22ndAve,06/25/2016 01:00:00 AM,48,-122,1,1,2
21074,58thStGreenway22ndAve,06/25/2016 02:00:00 AM,48,-122,1,1,2
21075,58thStGreenway22ndAve,06/25/2016 03:00:00 AM,48,-122,0,0,0
21076,58thStGreenway22ndAve,06/25/2016 04:00:00 AM,48,-122,0,0,0
21077,58thStGreenway22ndAve,06/25/2016 05:00:00 AM,48,-122,1,0,1
21078,58thStGreenway22ndAve,06/25/2016 06:00:00 AM,48,-122,0,0,0
21079,58thStGreenway22ndAve,06/25/2016 07:00:00 AM,48,-122,1,1,2
21080,58thStGreenway22ndAve,06/25/2016 08:00:00 AM,48,-122,6,5,11
21081,58thStGreenway22ndAve,06/25/2016 09:00:00 AM,48,-122,5,6,11
21082,58thStGreenway22ndAve,06/25/2016 10:00:00 AM,48,-122,6,6,12
21083,58thStGreenway22ndAve,06/25/2016 11:00:00 AM,48,-122,8,10,18
21084,58thStGreenway22ndAve,06/25/2016 12:00:00 PM,48,-122,7,13,20
21085,58thStGreenway22ndAve,06/25/2016 01:00:00 PM,48,-122,8,4,12
21086,58thStGreenway22ndAve,06/25/2016 02:00:00 PM,48,-122,2,12,14
21087,58thStGreenway22ndAve,06/25/2016 03:00:00 PM,48,-122,5,7,12
21088,58thStGreenway22ndAve,06/25/2016 04:00:00 PM,48,-122,11,3,14
21089,58thStGreenway22ndAve,06/25/2016 05:00:00 PM,48,-122,7,7,14
21090,58thStGreenway22ndAve,06/25/2016 06:00:00 PM,48,-122,15,7,22
21091,58thStGreenway22ndAve,06/25/2016 07:00:00 PM,48,-122,2,0,2
21092,58thStGreenway22ndAve,06/25/2016 08:00:00 PM,48,-122,6,0,6
21093,58thStGreenway22ndAve,06/25/2016 09:00:00 PM,48,-122,2,3,5
21094,58thStGreenway22ndAve,06/25/2016 10:00:00 PM,48,-122,0,3,3
21095,58thStGreenway22ndAve,06/25/2016 11:00:00 PM,48,-122,4,0,4
21096,58thStGreenway22ndAve,06/26/2016 12:00:00 AM,48,-122,1,1,2
21097,58thStGreenway22ndAve,06/26/2016 01:00:00 AM,48,-122,0,0,0
21098,58thStGreenway22ndAve,06/26/2016 02:00:00 AM,48,-122,0,0,0
21099,58thStGreenway22ndAve,06/26/2016 03:00:00 AM,48,-122,0,0,0
21100,58thStGreenway22ndAve,06/26/2016 04:00:00 AM,48,-122,0,0,0
21101,58thStGreenway22ndAve,06/26/2016 05:00:00 AM,48,-122,0,0,0
21102,58thStGreenway22ndAve,06/26/2016 06:00:00 AM,48,-122,1,0,1
21103,58thStGreenway22ndAve,06/26/2016 07:00:00 AM,48,-122,0,0,0
21104,58thStGreenway22ndAve,06/26/2016 08:00:00 AM,48,-122,2,3,5
21105,58thStGreenway22ndAve,06/26/2016 09:00:00 AM,48,-122,5,13,18
21106,58thStGreenway22ndAve,06/26/2016 10:00:00 AM,48,-122,8,7,15
21107,58thStGreenway22ndAve,06/26/2016 11:00:00 AM,48,-122,13,10,23
21108,58thStGreenway22ndAve,06/26/2016 12:00:00 PM,48,-122,9,19,28
21109,58thStGreenway22ndAve,06/26/2016 01:00:00 PM,48,-122,8,24,32
21110,58thStGreenway22ndAve,06/26/2016 02:00:00 PM,48,-122,11,13,24
21111,58thStGreenway22ndAve,06/26/2016 03:00:00 PM,48,-122,20,10,30
21112,58thStGreenway22ndAve,06/26/2016 04:00:00 PM,48,-122,24,7,31
21113,58thStGreenway22ndAve,06/26/2016 05:00:00 PM,48,-122,14,5,19
21114,58thStGreenway22ndAve,06/26/2016 06:00:00 PM,48,-122,12,4,16
21115,58thStGreenway22ndAve,06/26/2016 07:00:00 PM,48,-122,5,2,7
21116,58thStGreenway22ndAve,06/26/2016 08:00:00 PM,48,-122,4,1,5
21117,58thStGreenway22ndAve,06/26/2016 09:00:00 PM,48,-122,3,5,8
21118,58thStGreenway22ndAve,06/26/2016 10:00:00 PM,48,-122,0,1,1
21119,58thStGreenway22ndAve,06/26/2016 11:00:00 PM,48,-122,0,0,0
21120,58thStGreenway22ndAve,06/27/2016 12:00:00 AM,48,-122,2,0,2
21121,58thStGreenway22ndAve,06/27/2016 01:00:00 AM,48,-122,0,0,0
21122,58thStGreenway22ndAve,06/27/2016 02:00:00 AM,48,-122,0,0,0
21123,58thStGreenway22ndAve,06/27/2016 03:00:00 AM,48,-122,0,0,0
21124,58thStGreenway22ndAve,06/27/2016 04:00:00 AM,48,-122,1,0,1
21125,58thStGreenway22ndAve,06/27/2016 05:00:00 AM,48,-122,0,1,1
21126,58thStGreenway22ndAve,06/27/2016 06:00:00 AM,48,-122,1,2,3
21127,58thStGreenway22ndAve,06/27/2016 07:00:00 AM,48,-122,5,8,13
21128,58thStGreenway22ndAve,06/27/2016 08:00:00 AM,48,-122,7,9,16
21129,58thStGreenway22ndAve,06/27/2016 09:00:00 AM,48,-122,5,3,8
21130,58thStGreenway22ndAve,06/27/2016 10:00:00 AM,48,-122,2,6,8
21131,58thStGreenway22ndAve,06/27/2016 11:00:00 AM,48,-122,1,5,6
21132,58thStGreenway22ndAve,06/27/2016 12:00:00 PM,48,-122,2,4,6
21133,58thStGreenway22ndAve,06/27/2016 01:00:00 PM,48,-122,7,4,11
21134,58thStGreenway22ndAve,06/27/2016 02:00:00 PM,48,-122,1,1,2
21135,58thStGreenway22ndAve,06/27/2016 03:00:00 PM,48,-122,4,5,9
21136,58thStGreenway22ndAve,06/27/2016 04:00:00 PM,48,-122,9,12,21
21137,58thStGreenway22ndAve,06/27/2016 05:00:00 PM,48,-122,8,15,23
21138,58thStGreenway22ndAve,06/27/2016 06:00:00 PM,48,-122,21,8,29
21139,58thStGreenway22ndAve,06/27/2016 07:00:00 PM,48,-122,9,4,13
21140,58thStGreenway22ndAve,06/27/2016 08:00:00 PM,48,-122,10,15,25
21141,58thStGreenway22ndAve,06/27/2016 09:00:00 PM,48,-122,8,4,12
21142,58thStGreenway22ndAve,06/27/2016 10:00:00 PM,48,-122,5,2,7
21143,58thStGreenway22ndAve,06/27/2016 11:00:00 PM,48,-122,3,2,5
21144,58thStGreenway22ndAve,06/28/2016 12:00:00 AM,48,-122,0,1,1
21145,58thStGreenway22ndAve,06/28/2016 01:00:00 AM,48,-122,0,0,0
21146,58thStGreenway22ndAve,06/28/2016 02:00:00 AM,48,-122,0,0,0
21147,58thStGreenway22ndAve,06/28/2016 03:00:00 AM,48,-122,0,0,0
21148,58thStGreenway22ndAve,06/28/2016 04:00:00 AM,48,-122,0,1,1
21149,58thStGreenway22ndAve,06/28/2016 05:00:00 AM,48,-122,0,0,0
21150,58thStGreenway22ndAve,06/28/2016 06:00:00 AM,48,-122,0,2,2
21151,58thStGreenway22ndAve,06/28/2016 07:00:00 AM,48,-122,5,2,7
21152,58thStGreenway22ndAve,06/28/2016 08:00:00 AM,48,-122,3,13,16
21153,58thStGreenway22ndAve,06/28/2016 09:00:00 AM,48,-122,6,2,8
21154,58thStGreenway22ndAve,06/28/2016 10:00:00 AM,48,-122,5,7,12
21155,58thStGreenway22ndAve,06/28/2016 11:00:00 AM,48,-122,2,3,5
21156,58thStGreenway22ndAve,06/28/2016 12:00:00 PM,48,-122,6,8,14
21157,58thStGreenway22ndAve,06/28/2016 01:00:00 PM,48,-122,5,3,8
21158,58thStGreenway22ndAve,06/28/2016 02:00:00 PM,48,-122,6,9,15
21159,58thStGreenway22ndAve,06/28/2016 03:00:00 PM,48,-122,10,8,18
21160,58thStGreenway22ndAve,06/28/2016 04:00:00 PM,48,-122,9,4,13
21161,58thStGreenway22ndAve,06/28/2016 05:00:00 PM,48,-122,9,6,15
21162,58thStGreenway22ndAve,06/28/2016 06:00:00 PM,48,-122,16,11,27
21163,58thStGreenway22ndAve,06/28/2016 07:00:00 PM,48,-122,11,16,27
21164,58thStGreenway22ndAve,06/28/2016 08:00:00 PM,48,-122,9,6,15
21165,58thStGreenway22ndAve,06/28/2016 09:00:00 PM,48,-122,10,4,14
21166,58thStGreenway22ndAve,06/28/2016 10:00:00 PM,48,-122,7,1,8
21167,58thStGreenway22ndAve,06/28/2016 11:00:00 PM,48,-122,1,0,1
21168,58thStGreenway22ndAve,06/29/2016 12:00:00 AM,48,-122,0,1,1
21169,58thStGreenway22ndAve,06/29/2016 01:00:00 AM,48,-122,0,2,2
21170,58thStGreenway22ndAve,06/29/2016 02:00:00 AM,48,-122,0,0,0
21171,58thStGreenway22ndAve,06/29/2016 03:00:00 AM,48,-122,0,0,0
21172,58thStGreenway22ndAve,06/29/2016 04:00:00 AM,48,-122,0,0,0
21173,58thStGreenway22ndAve,06/29/2016 05:00:00 AM,48,-122,2,0,2
21174,58thStGreenway22ndAve,06/29/2016 06:00:00 AM,48,-122,1,1,2
21175,58thStGreenway22ndAve,06/29/2016 07:00:00 AM,48,-122,4,4,8
21176,58thStGreenway22ndAve,06/29/2016 08:00:00 AM,48,-122,2,9,11
21177,58thStGreenway22ndAve,06/29/2016 09:00:00 AM,48,-122,3,10,13
21178,58thStGreenway22ndAve,06/29/2016 10:00:00 AM,48,-122,4,8,12
21179,58thStGreenway22ndAve,06/29/2016 11:00:00 AM,48,-122,6,4,10
21180,58thStGreenway22ndAve,06/29/2016 12:00:00 PM,48,-122,3,4,7
21181,58thStGreenway22ndAve,06/29/2016 01:00:00 PM,48,-122,8,8,16
21182,58thStGreenway22ndAve,06/29/2016 02:00:00 PM,48,-122,2,2,4
21183,58thStGreenway22ndAve,06/29/2016 03:00:00 PM,48,-122,5,3,8
21184,58thStGreenway22ndAve,06/29/2016 04:00:00 PM,48,-122,8,12,20
21185,58thStGreenway22ndAve,06/29/2016 05:00:00 PM,48,-122,14,16,30
21186,58thStGreenway22ndAve,06/29/2016 06:00:00 PM,48,-122,13,18,31
21187,58thStGreenway22ndAve,06/29/2016 07:00:00 PM,48,-122,12,10,22
21188,58thStGreenway22ndAve,06/29/2016 08:00:00 PM,48,-122,8,2,10
21189,58thStGreenway22ndAve,06/29/2016 09:00:00 PM,48,-122,7,4,11
21190,58thStGreenway22ndAve,06/29/2016 10:00:00 PM,48,-122,4,1,5
21191,58thStGreenway22ndAve,06/29/2016 11:00:00 PM,48,-122,0,0,0
21192,58thStGreenway22ndAve,06/30/2016 12:00:00 AM,48,-122,0,0,0
21193,58thStGreenway22ndAve,06/30/2016 01:00:00 AM,48,-122,0,0,0
21194,58thStGreenway22ndAve,06/30/2016 02:00:00 AM,48,-122,0,0,0
21195,58thStGreenway22ndAve,06/30/2016 03:00:00 AM,48,-122,0,0,0
21196,58thStGreenway22ndAve,06/30/2016 04:00:00 AM,48,-122,0,0,0
21197,58thStGreenway22ndAve,06/30/2016 05:00:00 AM,48,-122,0,1,1
21198,58thStGreenway22ndAve,06/30/2016 06:00:00 AM,48,-122,1,0,1
21199,58thStGreenway22ndAve,06/30/2016 07:00:00 AM,48,-122,9,5,14
21200,58thStGreenway22ndAve,06/30/2016 08:00:00 AM,48,-122,3,7,10
21201,58thStGreenway22ndAve,06/30/2016 09:00:00 AM,48,-122,5,3,8
21202,58thStGreenway22ndAve,06/30/2016 10:00:00 AM,48,-122,4,3,7
21203,58thStGreenway22ndAve,06/30/2016 11:00:00 AM,48,-122,0,2,2
21204,58thStGreenway22ndAve,06/30/2016 12:00:00 PM,48,-122,2,6,8
21205,58thStGreenway22ndAve,06/30/2016 01:00:00 PM,48,-122,2,3,5
21206,58thStGreenway22ndAve,06/30/2016 02:00:00 PM,48,-122,3,2,5
21207,58thStGreenway22ndAve,06/30/2016 03:00:00 PM,48,-122,4,1,5
21208,58thStGreenway22ndAve,06/30/2016 04:00:00 PM,48,-122,2,9,11
21209,58thStGreenway22ndAve,06/30/2016 05:00:00 PM,48,-122,18,10,28
21210,58thStGreenway22ndAve,06/30/2016 06:00:00 PM,48,-122,12,5,17
21211,58thStGreenway22ndAve,06/30/2016 07:00:00 PM,48,-122,5,8,13
21212,58thStGreenway22ndAve,06/30/2016 08:00:00 PM,48,-122,5,6,11
21213,58thStGreenway22ndAve,06/30/2016 09:00:00 PM,48,-122,3,6,9
21214,58thStGreenway22ndAve,06/30/2016 10:00:00 PM,48,-122,6,3,9
21215,58thStGreenway22ndAve,06/30/2016 11:00:00 PM,48,-122,2,1,3
21216,58thStGreenway22ndAve,07/01/2016 12:00:00 AM,48,-122,0,1,1
21217,58thStGreenway22ndAve,07/01/2016 01:00:00 AM,48,-122,0,0,0
21218,58thStGreenway22ndAve,07/01/2016 02:00:00 AM,48,-122,0,0,0
21219,58thStGreenway22ndAve,07/01/2016 03:00:00 AM,48,-122,1,1,2
21220,58thStGreenway22ndAve,07/01/2016 04:00:00 AM,48,-122,0,0,0
21221,58thStGreenway22ndAve,07/01/2016 05:00:00 AM,48,-122,0,1,1
21222,58thStGreenway22ndAve,07/01/2016 06:00:00 AM,48,-122,0,2,2
21223,58thStGreenway22ndAve,07/01/2016 07:00:00 AM,48,-122,6,3,9
21224,58thStGreenway22ndAve,07/01/2016 08:00:00 AM,48,-122,1,6,7
21225,58thStGreenway22ndAve,07/01/2016 09:00:00 AM,48,-122,3,2,5
21226,58thStGreenway22ndAve,07/01/2016 10:00:00 AM,48,-122,1,3,4
21227,58thStGreenway22ndAve,07/01/2016 11:00:00 AM,48,-122,4,15,19
21228,58thStGreenway22ndAve,07/01/2016 12:00:00 PM,48,-122,5,6,11
21229,58thStGreenway22ndAve,07/01/2016 01:00:00 PM,48,-122,8,9,17
21230,58thStGreenway22ndAve,07/01/2016 02:00:00 PM,48,-122,4,8,12
21231,58thStGreenway22ndAve,07/01/2016 03:00:00 PM,48,-122,5,4,9
21232,58thStGreenway22ndAve,07/01/2016 04:00:00 PM,48,-122,7,6,13
21233,58thStGreenway22ndAve,07/01/2016 05:00:00 PM,48,-122,16,8,24
21234,58thStGreenway22ndAve,07/01/2016 06:00:00 PM,48,-122,10,10,20
21235,58thStGreenway22ndAve,07/01/2016 07:00:00 PM,48,-122,6,9,15
21236,58thStGreenway22ndAve,07/01/2016 08:00:00 PM,48,-122,2,10,12
21237,58thStGreenway22ndAve,07/01/2016 09:00:00 PM,48,-122,4,1,5
21238,58thStGreenway22ndAve,07/01/2016 10:00:00 PM,48,-122,3,3,6
21239,58thStGreenway22ndAve,07/01/2016 11:00:00 PM,48,-122,2,3,5
21240,58thStGreenway22ndAve,07/02/2016 12:00:00 AM,48,-122,2,0,2
21241,58thStGreenway22ndAve,07/02/2016 01:00:00 AM,48,-122,0,1,1
21242,58thStGreenway22ndAve,07/02/2016 02:00:00 AM,48,-122,0,2,2
21243,58thStGreenway22ndAve,07/02/2016 03:00:00 AM,48,-122,0,0,0
21244,58thStGreenway22ndAve,07/02/2016 04:00:00 AM,48,-122,0,2,2
21245,58thStGreenway22ndAve,07/02/2016 05:00:00 AM,48,-122,3,0,3
21246,58thStGreenway22ndAve,07/02/2016 06:00:00 AM,48,-122,0,1,1
21247,58thStGreenway22ndAve,07/02/2016 07:00:00 AM,48,-122,0,0,0
21248,58thStGreenway22ndAve,07/02/2016 08:00:00 AM,48,-122,1,4,5
21249,58thStGreenway22ndAve,07/02/2016 09:00:00 AM,48,-122,6,2,8
21250,58thStGreenway22ndAve,07/02/2016 10:00:00 AM,48,-122,10,6,16
21251,58thStGreenway22ndAve,07/02/2016 11:00:00 AM,48,-122,3,7,10
21252,58thStGreenway22ndAve,07/02/2016 12:00:00 PM,48,-122,7,11,18
21253,58thStGreenway22ndAve,07/02/2016 01:00:00 PM,48,-122,9,13,22
21254,58thStGreenway22ndAve,07/02/2016 02:00:00 PM,48,-122,6,9,15
21255,58thStGreenway22ndAve,07/02/2016 03:00:00 PM,48,-122,5,11,16
21256,58thStGreenway22ndAve,07/02/2016 04:00:00 PM,48,-122,7,11,18
21257,58thStGreenway22ndAve,07/02/2016 05:00:00 PM,48,-122,6,12,18
21258,58thStGreenway22ndAve,07/02/2016 06:00:00 PM,48,-122,5,4,9
21259,58thStGreenway22ndAve,07/02/2016 07:00:00 PM,48,-122,8,2,10
21260,58thStGreenway22ndAve,07/02/2016 08:00:00 PM,48,-122,0,0,0
21261,58thStGreenway22ndAve,07/02/2016 09:00:00 PM,48,-122,2,2,4
21262,58thStGreenway22ndAve,07/02/2016 10:00:00 PM,48,-122,0,0,0
21263,58thStGreenway22ndAve,07/02/2016 11:00:00 PM,48,-122,2,1,3
21264,58thStGreenway22ndAve,07/03/2016 12:00:00 AM,48,-122,1,0,1
21265,58thStGreenway22ndAve,07/03/2016 01:00:00 AM,48,-122,0,0,0
21266,58thStGreenway22ndAve,07/03/2016 02:00:00 AM,48,-122,2,0,2
21267,58thStGreenway22ndAve,07/03/2016 03:00:00 AM,48,-122,1,0,1
21268,58thStGreenway22ndAve,07/03/2016 04:00:00 AM,48,-122,0,0,0
21269,58thStGreenway22ndAve,07/03/2016 05:00:00 AM,48,-122,0,0,0
21270,58thStGreenway22ndAve,07/03/2016 06:00:00 AM,48,-122,0,1,1
21271,58thStGreenway22ndAve,07/03/2016 07:00:00 AM,48,-122,2,0,2
21272,58thStGreenway22ndAve,07/03/2016 08:00:00 AM,48,-122,4,3,7
21273,58thStGreenway22ndAve,07/03/2016 09:00:00 AM,48,-122,5,4,9
21274,58thStGreenway22ndAve,07/03/2016 10:00:00 AM,48,-122,6,4,10
21275,58thStGreenway22ndAve,07/03/2016 11:00:00 AM,48,-122,21,9,30
21276,58thStGreenway22ndAve,07/03/2016 12:00:00 PM,48,-122,12,9,21
21277,58thStGreenway22ndAve,07/03/2016 01:00:00 PM,48,-122,10,10,20
21278,58thStGreenway22ndAve,07/03/2016 02:00:00 PM,48,-122,6,13,19
21279,58thStGreenway22ndAve,07/03/2016 03:00:00 PM,48,-122,5,13,18
21280,58thStGreenway22ndAve,07/03/2016 04:00:00 PM,48,-122,10,10,20
21281,58thStGreenway22ndAve,07/03/2016 05:00:00 PM,48,-122,6,9,15
21282,58thStGreenway22ndAve,07/03/2016 06:00:00 PM,48,-122,7,10,17
21283,58thStGreenway22ndAve,07/03/2016 07:00:00 PM,48,-122,5,8,13
21284,58thStGreenway22ndAve,07/03/2016 08:00:00 PM,48,-122,9,0,9
21285,58thStGreenway22ndAve,07/03/2016 09:00:00 PM,48,-122,4,0,4
21286,58thStGreenway22ndAve,07/03/2016 10:00:00 PM,48,-122,4,0,4
21287,58thStGreenway22ndAve,07/03/2016 11:00:00 PM,48,-122,0,0,0
21288,58thStGreenway22ndAve,07/04/2016 12:00:00 AM,48,-122,3,1,4
21289,58thStGreenway22ndAve,07/04/2016 01:00:00 AM,48,-122,2,0,2
21290,58thStGreenway22ndAve,07/04/2016 02:00:00 AM,48,-122,0,1,1
21291,58thStGreenway22ndAve,07/04/2016 03:00:00 AM,48,-122,0,0,0
21292,58thStGreenway22ndAve,07/04/2016 04:00:00 AM,48,-122,0,0,0
21293,58thStGreenway22ndAve,07/04/2016 05:00:00 AM,48,-122,0,0,0
21294,58thStGreenway22ndAve,07/04/2016 06:00:00 AM,48,-122,0,0,0
21295,58thStGreenway22ndAve,07/04/2016 07:00:00 AM,48,-122,1,2,3
21296,58thStGreenway22ndAve,07/04/2016 08:00:00 AM,48,-122,1,0,1
21297,58thStGreenway22ndAve,07/04/2016 09:00:00 AM,48,-122,1,5,6
21298,58thStGreenway22ndAve,07/04/2016 10:00:00 AM,48,-122,1,4,5
21299,58thStGreenway22ndAve,07/04/2016 11:00:00 AM,48,-122,9,10,19
21300,58thStGreenway22ndAve,07/04/2016 12:00:00 PM,48,-122,5,10,15
21301,58thStGreenway22ndAve,07/04/2016 01:00:00 PM,48,-122,8,9,17
21302,58thStGreenway22ndAve,07/04/2016 02:00:00 PM,48,-122,9,11,20
21303,58thStGreenway22ndAve,07/04/2016 03:00:00 PM,48,-122,10,0,10
21304,58thStGreenway22ndAve,07/04/2016 04:00:00 PM,48,-122,12,10,22
21305,58thStGreenway22ndAve,07/04/2016 05:00:00 PM,48,-122,4,7,11
21306,58thStGreenway22ndAve,07/04/2016 06:00:00 PM,48,-122,2,1,3
21307,58thStGreenway22ndAve,07/04/2016 07:00:00 PM,48,-122,7,2,9
21308,58thStGreenway22ndAve,07/04/2016 08:00:00 PM,48,-122,9,1,10
21309,58thStGreenway22ndAve,07/04/2016 09:00:00 PM,48,-122,0,1,1
21310,58thStGreenway22ndAve,07/04/2016 10:00:00 PM,48,-122,0,2,2
21311,58thStGreenway22ndAve,07/04/2016 11:00:00 PM,48,-122,2,1,3
21312,58thStGreenway22ndAve,07/05/2016 12:00:00 AM,48,-122,0,0,0
21313,58thStGreenway22ndAve,07/05/2016 01:00:00 AM,48,-122,0,0,0
21314,58thStGreenway22ndAve,07/05/2016 02:00:00 AM,48,-122,0,0,0
21315,58thStGreenway22ndAve,07/05/2016 03:00:00 AM,48,-122,0,0,0
21316,58thStGreenway22ndAve,07/05/2016 04:00:00 AM,48,-122,0,0,0
21317,58thStGreenway22ndAve,07/05/2016 05:00:00 AM,48,-122,0,2,2
21318,58thStGreenway22ndAve,07/05/2016 06:00:00 AM,48,-122,2,1,3
21319,58thStGreenway22ndAve,07/05/2016 07:00:00 AM,48,-122,3,2,5
21320,58thStGreenway22ndAve,07/05/2016 08:00:00 AM,48,-122,10,5,15
21321,58thStGreenway22ndAve,07/05/2016 09:00:00 AM,48,-122,4,5,9
21322,58thStGreenway22ndAve,07/05/2016 10:00:00 AM,48,-122,3,7,10
21323,58thStGreenway22ndAve,07/05/2016 11:00:00 AM,48,-122,3,4,7
21324,58thStGreenway22ndAve,07/05/2016 12:00:00 PM,48,-122,0,7,7
21325,58thStGreenway22ndAve,07/05/2016 01:00:00 PM,48,-122,4,0,4
21326,58thStGreenway22ndAve,07/05/2016 02:00:00 PM,48,-122,6,6,12
21327,58thStGreenway22ndAve,07/05/2016 03:00:00 PM,48,-122,9,7,16
21328,58thStGreenway22ndAve,07/05/2016 04:00:00 PM,48,-122,11,7,18
21329,58thStGreenway22ndAve,07/05/2016 05:00:00 PM,48,-122,2,10,12
21330,58thStGreenway22ndAve,07/05/2016 06:00:00 PM,48,-122,8,8,16
21331,58thStGreenway22ndAve,07/05/2016 07:00:00 PM,48,-122,11,9,20
21332,58thStGreenway22ndAve,07/05/2016 08:00:00 PM,48,-122,1,2,3
21333,58thStGreenway22ndAve,07/05/2016 09:00:00 PM,48,-122,3,1,4
21334,58thStGreenway22ndAve,07/05/2016 10:00:00 PM,48,-122,3,1,4
21335,58thStGreenway22ndAve,07/05/2016 11:00:00 PM,48,-122,0,1,1
21336,58thStGreenway22ndAve,07/06/2016 12:00:00 AM,48,-122,0,1,1
21337,58thStGreenway22ndAve,07/06/2016 01:00:00 AM,48,-122,1,0,1
21338,58thStGreenway22ndAve,07/06/2016 02:00:00 AM,48,-122,1,0,1
21339,58thStGreenway22ndAve,07/06/2016 03:00:00 AM,48,-122,0,0,0
21340,58thStGreenway22ndAve,07/06/2016 04:00:00 AM,48,-122,0,0,0
21341,58thStGreenway22ndAve,07/06/2016 05:00:00 AM,48,-122,0,1,1
21342,58thStGreenway22ndAve,07/06/2016 06:00:00 AM,48,-122,1,1,2
21343,58thStGreenway22ndAve,07/06/2016 07:00:00 AM,48,-122,9,3,12
21344,58thStGreenway22ndAve,07/06/2016 08:00:00 AM,48,-122,2,9,11
21345,58thStGreenway22ndAve,07/06/2016 09:00:00 AM,48,-122,9,9,18
21346,58thStGreenway22ndAve,07/06/2016 10:00:00 AM,48,-122,8,12,20
21347,58thStGreenway22ndAve,07/06/2016 11:00:00 AM,48,-122,6,4,10
21348,58thStGreenway22ndAve,07/06/2016 12:00:00 PM,48,-122,7,4,11
21349,58thStGreenway22ndAve,07/06/2016 01:00:00 PM,48,-122,5,4,9
21350,58thStGreenway22ndAve,07/06/2016 02:00:00 PM,48,-122,7,9,16
21351,58thStGreenway22ndAve,07/06/2016 03:00:00 PM,48,-122,4,10,14
21352,58thStGreenway22ndAve,07/06/2016 04:00:00 PM,48,-122,10,8,18
21353,58thStGreenway22ndAve,07/06/2016 05:00:00 PM,48,-122,15,11,26
21354,58thStGreenway22ndAve,07/06/2016 06:00:00 PM,48,-122,19,11,30
21355,58thStGreenway22ndAve,07/06/2016 07:00:00 PM,48,-122,12,11,23
21356,58thStGreenway22ndAve,07/06/2016 08:00:00 PM,48,-122,7,8,15
21357,58thStGreenway22ndAve,07/06/2016 09:00:00 PM,48,-122,0,4,4
21358,58thStGreenway22ndAve,07/06/2016 10:00:00 PM,48,-122,4,0,4
21359,58thStGreenway22ndAve,07/06/2016 11:00:00 PM,48,-122,1,0,1
21360,58thStGreenway22ndAve,07/07/2016 12:00:00 AM,48,-122,1,0,1
21361,58thStGreenway22ndAve,07/07/2016 01:00:00 AM,48,-122,0,0,0
21362,58thStGreenway22ndAve,07/07/2016 02:00:00 AM,48,-122,0,0,0
21363,58thStGreenway22ndAve,07/07/2016 03:00:00 AM,48,-122,0,0,0
21364,58thStGreenway22ndAve,07/07/2016 04:00:00 AM,48,-122,0,0,0
21365,58thStGreenway22ndAve,07/07/2016 05:00:00 AM,48,-122,0,0,0
21366,58thStGreenway22ndAve,07/07/2016 06:00:00 AM,48,-122,0,3,3
21367,58thStGreenway22ndAve,07/07/2016 07:00:00 AM,48,-122,2,4,6
21368,58thStGreenway22ndAve,07/07/2016 08:00:00 AM,48,-122,3,7,10
21369,58thStGreenway22ndAve,07/07/2016 09:00:00 AM,48,-122,2,3,5
21370,58thStGreenway22ndAve,07/07/2016 10:00:00 AM,48,-122,3,4,7
21371,58thStGreenway22ndAve,07/07/2016 11:00:00 AM,48,-122,5,6,11
21372,58thStGreenway22ndAve,07/07/2016 12:00:00 PM,48,-122,3,2,5
21373,58thStGreenway22ndAve,07/07/2016 01:00:00 PM,48,-122,2,2,4
21374,58thStGreenway22ndAve,07/07/2016 02:00:00 PM,48,-122,1,1,2
21375,58thStGreenway22ndAve,07/07/2016 03:00:00 PM,48,-122,7,2,9
21376,58thStGreenway22ndAve,07/07/2016 04:00:00 PM,48,-122,8,3,11
21377,58thStGreenway22ndAve,07/07/2016 05:00:00 PM,48,-122,7,6,13
21378,58thStGreenway22ndAve,07/07/2016 06:00:00 PM,48,-122,2,5,7
21379,58thStGreenway22ndAve,07/07/2016 07:00:00 PM,48,-122,1,6,7
21380,58thStGreenway22ndAve,07/07/2016 08:00:00 PM,48,-122,4,0,4
21381,58thStGreenway22ndAve,07/07/2016 09:00:00 PM,48,-122,1,3,4
21382,58thStGreenway22ndAve,07/07/2016 10:00:00 PM,48,-122,3,0,3
21383,58thStGreenway22ndAve,07/07/2016 11:00:00 PM,48,-122,1,0,1
21384,58thStGreenway22ndAve,07/08/2016 12:00:00 AM,48,-122,0,0,0
21385,58thStGreenway22ndAve,07/08/2016 01:00:00 AM,48,-122,0,0,0
21386,58thStGreenway22ndAve,07/08/2016 02:00:00 AM,48,-122,0,0,0
21387,58thStGreenway22ndAve,07/08/2016 03:00:00 AM,48,-122,0,0,0
21388,58thStGreenway22ndAve,07/08/2016 04:00:00 AM,48,-122,0,0,0
21389,58thStGreenway22ndAve,07/08/2016 05:00:00 AM,48,-122,0,0,0
21390,58thStGreenway22ndAve,07/08/2016 06:00:00 AM,48,-122,2,1,3
21391,58thStGreenway22ndAve,07/08/2016 07:00:00 AM,48,-122,5,2,7
21392,58thStGreenway22ndAve,07/08/2016 08:00:00 AM,48,-122,10,3,13
21393,58thStGreenway22ndAve,07/08/2016 09:00:00 AM,48,-122,3,4,7
21394,58thStGreenway22ndAve,07/08/2016 10:00:00 AM,48,-122,2,3,5
21395,58thStGreenway22ndAve,07/08/2016 11:00:00 AM,48,-122,4,3,7
21396,58thStGreenway22ndAve,07/08/2016 12:00:00 PM,48,-122,5,7,12
21397,58thStGreenway22ndAve,07/08/2016 01:00:00 PM,48,-122,5,5,10
21398,58thStGreenway22ndAve,07/08/2016 02:00:00 PM,48,-122,4,11,15
21399,58thStGreenway22ndAve,07/08/2016 03:00:00 PM,48,-122,14,5,19
21400,58thStGreenway22ndAve,07/08/2016 04:00:00 PM,48,-122,10,9,19
21401,58thStGreenway22ndAve,07/08/2016 05:00:00 PM,48,-122,8,9,17
21402,58thStGreenway22ndAve,07/08/2016 06:00:00 PM,48,-122,4,7,11
21403,58thStGreenway22ndAve,07/08/2016 07:00:00 PM,48,-122,8,4,12
21404,58thStGreenway22ndAve,07/08/2016 08:00:00 PM,48,-122,7,5,12
21405,58thStGreenway22ndAve,07/08/2016 09:00:00 PM,48,-122,5,0,5
21406,58thStGreenway22ndAve,07/08/2016 10:00:00 PM,48,-122,0,4,4
21407,58thStGreenway22ndAve,07/08/2016 11:00:00 PM,48,-122,0,0,0
21408,58thStGreenway22ndAve,07/09/2016 12:00:00 AM,48,-122,2,0,2
21409,58thStGreenway22ndAve,07/09/2016 01:00:00 AM,48,-122,0,0,0
21410,58thStGreenway22ndAve,07/09/2016 02:00:00 AM,48,-122,0,0,0
21411,58thStGreenway22ndAve,07/09/2016 03:00:00 AM,48,-122,0,0,0
21412,58thStGreenway22ndAve,07/09/2016 04:00:00 AM,48,-122,0,1,1
21413,58thStGreenway22ndAve,07/09/2016 05:00:00 AM,48,-122,0,2,2
21414,58thStGreenway22ndAve,07/09/2016 06:00:00 AM,48,-122,0,0,0
21415,58thStGreenway22ndAve,07/09/2016 07:00:00 AM,48,-122,1,1,2
21416,58thStGreenway22ndAve,07/09/2016 08:00:00 AM,48,-122,4,4,8
21417,58thStGreenway22ndAve,07/09/2016 09:00:00 AM,48,-122,6,5,11
21418,58thStGreenway22ndAve,07/09/2016 10:00:00 AM,48,-122,7,9,16
21419,58thStGreenway22ndAve,07/09/2016 11:00:00 AM,48,-122,6,7,13
21420,58thStGreenway22ndAve,07/09/2016 12:00:00 PM,48,-122,17,20,37
21421,58thStGreenway22ndAve,07/09/2016 01:00:00 PM,48,-122,12,14,26
21422,58thStGreenway22ndAve,07/09/2016 02:00:00 PM,48,-122,9,16,25
21423,58thStGreenway22ndAve,07/09/2016 03:00:00 PM,48,-122,15,13,28
21424,58thStGreenway22ndAve,07/09/2016 04:00:00 PM,48,-122,19,21,40
21425,58thStGreenway22ndAve,07/09/2016 05:00:00 PM,48,-122,12,8,20
21426,58thStGreenway22ndAve,07/09/2016 06:00:00 PM,48,-122,15,13,28
21427,58thStGreenway22ndAve,07/09/2016 07:00:00 PM,48,-122,10,4,14
21428,58thStGreenway22ndAve,07/09/2016 08:00:00 PM,48,-122,9,10,19
21429,58thStGreenway22ndAve,07/09/2016 09:00:00 PM,48,-122,5,0,5
21430,58thStGreenway22ndAve,07/09/2016 10:00:00 PM,48,-122,9,3,12
21431,58thStGreenway22ndAve,07/09/2016 11:00:00 PM,48,-122,1,1,2
21432,58thStGreenway22ndAve,07/10/2016 12:00:00 AM,48,-122,2,1,3
21433,58thStGreenway22ndAve,07/10/2016 01:00:00 AM,48,-122,3,0,3
21434,58thStGreenway22ndAve,07/10/2016 02:00:00 AM,48,-122,1,1,2
21435,58thStGreenway22ndAve,07/10/2016 03:00:00 AM,48,-122,0,0,0
21436,58thStGreenway22ndAve,07/10/2016 04:00:00 AM,48,-122,0,0,0
21437,58thStGreenway22ndAve,07/10/2016 05:00:00 AM,48,-122,2,2,4
21438,58thStGreenway22ndAve,07/10/2016 06:00:00 AM,48,-122,1,1,2
21439,58thStGreenway22ndAve,07/10/2016 07:00:00 AM,48,-122,1,0,1
21440,58thStGreenway22ndAve,07/10/2016 08:00:00 AM,48,-122,2,0,2
21441,58thStGreenway22ndAve,07/10/2016 09:00:00 AM,48,-122,3,2,5
21442,58thStGreenway22ndAve,07/10/2016 10:00:00 AM,48,-122,11,18,29
21443,58thStGreenway22ndAve,07/10/2016 11:00:00 AM,48,-122,16,14,30
21444,58thStGreenway22ndAve,07/10/2016 12:00:00 PM,48,-122,13,9,22
21445,58thStGreenway22ndAve,07/10/2016 01:00:00 PM,48,-122,17,20,37
21446,58thStGreenway22ndAve,07/10/2016 02:00:00 PM,48,-122,20,21,41
21447,58thStGreenway22ndAve,07/10/2016 03:00:00 PM,48,-122,19,14,33
21448,58thStGreenway22ndAve,07/10/2016 04:00:00 PM,48,-122,9,16,25
21449,58thStGreenway22ndAve,07/10/2016 05:00:00 PM,48,-122,21,11,32
21450,58thStGreenway22ndAve,07/10/2016 06:00:00 PM,48,-122,6,6,12
21451,58thStGreenway22ndAve,07/10/2016 07:00:00 PM,48,-122,11,13,24
21452,58thStGreenway22ndAve,07/10/2016 08:00:00 PM,48,-122,8,5,13
21453,58thStGreenway22ndAve,07/10/2016 09:00:00 PM,48,-122,8,3,11
21454,58thStGreenway22ndAve,07/10/2016 10:00:00 PM,48,-122,3,2,5
21455,58thStGreenway22ndAve,07/10/2016 11:00:00 PM,48,-122,1,0,1
21456,58thStGreenway22ndAve,07/11/2016 12:00:00 AM,48,-122,0,0,0
21457,58thStGreenway22ndAve,07/11/2016 01:00:00 AM,48,-122,0,0,0
21458,58thStGreenway22ndAve,07/11/2016 02:00:00 AM,48,-122,0,0,0
21459,58thStGreenway22ndAve,07/11/2016 03:00:00 AM,48,-122,0,0,0
21460,58thStGreenway22ndAve,07/11/2016 04:00:00 AM,48,-122,0,0,0
21461,58thStGreenway22ndAve,07/11/2016 05:00:00 AM,48,-122,0,1,1
21462,58thStGreenway22ndAve,07/11/2016 06:00:00 AM,48,-122,3,1,4
21463,58thStGreenway22ndAve,07/11/2016 07:00:00 AM,48,-122,3,8,11
21464,58thStGreenway22ndAve,07/11/2016 08:00:00 AM,48,-122,6,5,11
21465,58thStGreenway22ndAve,07/11/2016 09:00:00 AM,48,-122,5,7,12
21466,58thStGreenway22ndAve,07/11/2016 10:00:00 AM,48,-122,2,3,5
21467,58thStGreenway22ndAve,07/11/2016 11:00:00 AM,48,-122,5,5,10
21468,58thStGreenway22ndAve,07/11/2016 12:00:00 PM,48,-122,3,6,9
21469,58thStGreenway22ndAve,07/11/2016 01:00:00 PM,48,-122,5,4,9
21470,58thStGreenway22ndAve,07/11/2016 02:00:00 PM,48,-122,5,3,8
21471,58thStGreenway22ndAve,07/11/2016 03:00:00 PM,48,-122,6,2,8
21472,58thStGreenway22ndAve,07/11/2016 04:00:00 PM,48,-122,9,7,16
21473,58thStGreenway22ndAve,07/11/2016 05:00:00 PM,48,-122,10,14,24
21474,58thStGreenway22ndAve,07/11/2016 06:00:00 PM,48,-122,16,8,24
21475,58thStGreenway22ndAve,07/11/2016 07:00:00 PM,48,-122,7,4,11
21476,58thStGreenway22ndAve,07/11/2016 08:00:00 PM,48,-122,10,4,14
21477,58thStGreenway22ndAve,07/11/2016 09:00:00 PM,48,-122,6,4,10
21478,58thStGreenway22ndAve,07/11/2016 10:00:00 PM,48,-122,2,0,2
21479,58thStGreenway22ndAve,07/11/2016 11:00:00 PM,48,-122,1,0,1
21480,58thStGreenway22ndAve,07/12/2016 12:00:00 AM,48,-122,0,0,0
21481,58thStGreenway22ndAve,07/12/2016 01:00:00 AM,48,-122,0,0,0
21482,58thStGreenway22ndAve,07/12/2016 02:00:00 AM,48,-122,0,0,0
21483,58thStGreenway22ndAve,07/12/2016 03:00:00 AM,48,-122,0,0,0
21484,58thStGreenway22ndAve,07/12/2016 04:00:00 AM,48,-122,0,1,1
21485,58thStGreenway22ndAve,07/12/2016 05:00:00 AM,48,-122,0,0,0
21486,58thStGreenway22ndAve,07/12/2016 06:00:00 AM,48,-122,1,1,2
21487,58thStGreenway22ndAve,07/12/2016 07:00:00 AM,48,-122,4,1,5
21488,58thStGreenway22ndAve,07/12/2016 08:00:00 AM,48,-122,6,8,14
21489,58thStGreenway22ndAve,07/12/2016 09:00:00 AM,48,-122,6,4,10
21490,58thStGreenway22ndAve,07/12/2016 10:00:00 AM,48,-122,2,6,8
21491,58thStGreenway22ndAve,07/12/2016 11:00:00 AM,48,-122,7,14,21
21492,58thStGreenway22ndAve,07/12/2016 12:00:00 PM,48,-122,9,5,14
21493,58thStGreenway22ndAve,07/12/2016 01:00:00 PM,48,-122,7,10,17
21494,58thStGreenway22ndAve,07/12/2016 02:00:00 PM,48,-122,6,7,13
21495,58thStGreenway22ndAve,07/12/2016 03:00:00 PM,48,-122,8,5,13
21496,58thStGreenway22ndAve,07/12/2016 04:00:00 PM,48,-122,16,0,16
21497,58thStGreenway22ndAve,07/12/2016 05:00:00 PM,48,-122,6,6,12
21498,58thStGreenway22ndAve,07/12/2016 06:00:00 PM,48,-122,10,9,19
21499,58thStGreenway22ndAve,07/12/2016 07:00:00 PM,48,-122,3,10,13
21500,58thStGreenway22ndAve,07/12/2016 08:00:00 PM,48,-122,6,4,10
21501,58thStGreenway22ndAve,07/12/2016 09:00:00 PM,48,-122,11,1,12
21502,58thStGreenway22ndAve,07/12/2016 10:00:00 PM,48,-122,0,1,1
21503,58thStGreenway22ndAve,07/12/2016 11:00:00 PM,48,-122,2,0,2
21504,58thStGreenway22ndAve,07/13/2016 12:00:00 AM,48,-122,1,0,1
21505,58thStGreenway22ndAve,07/13/2016 01:00:00 AM,48,-122,0,0,0
21506,58thStGreenway22ndAve,07/13/2016 02:00:00 AM,48,-122,0,0,0
21507,58thStGreenway22ndAve,07/13/2016 03:00:00 AM,48,-122,0,0,0
21508,58thStGreenway22ndAve,07/13/2016 04:00:00 AM,48,-122,1,1,2
21509,58thStGreenway22ndAve,07/13/2016 05:00:00 AM,48,-122,0,1,1
21510,58thStGreenway22ndAve,07/13/2016 06:00:00 AM,48,-122,4,1,5
21511,58thStGreenway22ndAve,07/13/2016 07:00:00 AM,48,-122,6,2,8
21512,58thStGreenway22ndAve,07/13/2016 08:00:00 AM,48,-122,5,11,16
21513,58thStGreenway22ndAve,07/13/2016 09:00:00 AM,48,-122,4,5,9
21514,58thStGreenway22ndAve,07/13/2016 10:00:00 AM,48,-122,4,12,16
21515,58thStGreenway22ndAve,07/13/2016 11:00:00 AM,48,-122,8,13,21
21516,58thStGreenway22ndAve,07/13/2016 12:00:00 PM,48,-122,7,7,14
21517,58thStGreenway22ndAve,07/13/2016 01:00:00 PM,48,-122,9,5,14
21518,58thStGreenway22ndAve,07/13/2016 02:00:00 PM,48,-122,6,3,9
21519,58thStGreenway22ndAve,07/13/2016 03:00:00 PM,48,-122,13,7,20
21520,58thStGreenway22ndAve,07/13/2016 04:00:00 PM,48,-122,9,8,17
21521,58thStGreenway22ndAve,07/13/2016 05:00:00 PM,48,-122,14,13,27
21522,58thStGreenway22ndAve,07/13/2016 06:00:00 PM,48,-122,9,17,26
21523,58thStGreenway22ndAve,07/13/2016 07:00:00 PM,48,-122,4,5,9
21524,58thStGreenway22ndAve,07/13/2016 08:00:00 PM,48,-122,9,5,14
21525,58thStGreenway22ndAve,07/13/2016 09:00:00 PM,48,-122,2,2,4
21526,58thStGreenway22ndAve,07/13/2016 10:00:00 PM,48,-122,3,0,3
21527,58thStGreenway22ndAve,07/13/2016 11:00:00 PM,48,-122,1,0,1
21528,58thStGreenway22ndAve,07/14/2016 12:00:00 AM,48,-122,0,3,3
21529,58thStGreenway22ndAve,07/14/2016 01:00:00 AM,48,-122,0,0,0
21530,58thStGreenway22ndAve,07/14/2016 02:00:00 AM,48,-122,0,0,0
21531,58thStGreenway22ndAve,07/14/2016 03:00:00 AM,48,-122,0,0,0
21532,58thStGreenway22ndAve,07/14/2016 04:00:00 AM,48,-122,0,1,1
21533,58thStGreenway22ndAve,07/14/2016 05:00:00 AM,48,-122,0,0,0
21534,58thStGreenway22ndAve,07/14/2016 06:00:00 AM,48,-122,2,3,5
21535,58thStGreenway22ndAve,07/14/2016 07:00:00 AM,48,-122,4,2,6
21536,58thStGreenway22ndAve,07/14/2016 08:00:00 AM,48,-122,9,6,15
21537,58thStGreenway22ndAve,07/14/2016 09:00:00 AM,48,-122,6,2,8
21538,58thStGreenway22ndAve,07/14/2016 10:00:00 AM,48,-122,6,6,12
21539,58thStGreenway22ndAve,07/14/2016 11:00:00 AM,48,-122,8,5,13
21540,58thStGreenway22ndAve,07/14/2016 12:00:00 PM,48,-122,5,12,17
21541,58thStGreenway22ndAve,07/14/2016 01:00:00 PM,48,-122,3,8,11
21542,58thStGreenway22ndAve,07/14/2016 02:00:00 PM,48,-122,2,4,6
21543,58thStGreenway22ndAve,07/14/2016 03:00:00 PM,48,-122,5,6,11
21544,58thStGreenway22ndAve,07/14/2016 04:00:00 PM,48,-122,10,10,20
21545,58thStGreenway22ndAve,07/14/2016 05:00:00 PM,48,-122,9,4,13
21546,58thStGreenway22ndAve,07/14/2016 06:00:00 PM,48,-122,13,14,27
21547,58thStGreenway22ndAve,07/14/2016 07:00:00 PM,48,-122,17,9,26
21548,58thStGreenway22ndAve,07/14/2016 08:00:00 PM,48,-122,9,1,10
21549,58thStGreenway22ndAve,07/14/2016 09:00:00 PM,48,-122,9,5,14
21550,58thStGreenway22ndAve,07/14/2016 10:00:00 PM,48,-122,7,2,9
21551,58thStGreenway22ndAve,07/14/2016 11:00:00 PM,48,-122,0,1,1
21552,58thStGreenway22ndAve,07/15/2016 12:00:00 AM,48,-122,0,1,1
21553,58thStGreenway22ndAve,07/15/2016 01:00:00 AM,48,-122,0,0,0
21554,58thStGreenway22ndAve,07/15/2016 02:00:00 AM,48,-122,1,0,1
21555,58thStGreenway22ndAve,07/15/2016 03:00:00 AM,48,-122,0,0,0
21556,58thStGreenway22ndAve,07/15/2016 04:00:00 AM,48,-122,0,0,0
21557,58thStGreenway22ndAve,07/15/2016 05:00:00 AM,48,-122,0,1,1
21558,58thStGreenway22ndAve,07/15/2016 06:00:00 AM,48,-122,3,2,5
21559,58thStGreenway22ndAve,07/15/2016 07:00:00 AM,48,-122,4,1,5
21560,58thStGreenway22ndAve,07/15/2016 08:00:00 AM,48,-122,5,7,12
21561,58thStGreenway22ndAve,07/15/2016 09:00:00 AM,48,-122,5,5,10
21562,58thStGreenway22ndAve,07/15/2016 10:00:00 AM,48,-122,5,4,9
21563,58thStGreenway22ndAve,07/15/2016 11:00:00 AM,48,-122,5,6,11
21564,58thStGreenway22ndAve,07/15/2016 12:00:00 PM,48,-122,1,5,6
21565,58thStGreenway22ndAve,07/15/2016 01:00:00 PM,48,-122,8,2,10
21566,58thStGreenway22ndAve,07/15/2016 02:00:00 PM,48,-122,8,4,12
21567,58thStGreenway22ndAve,07/15/2016 03:00:00 PM,48,-122,16,9,25
21568,58thStGreenway22ndAve,07/15/2016 04:00:00 PM,48,-122,5,13,18
21569,58thStGreenway22ndAve,07/15/2016 05:00:00 PM,48,-122,9,11,20
21570,58thStGreenway22ndAve,07/15/2016 06:00:00 PM,48,-122,8,5,13
21571,58thStGreenway22ndAve,07/15/2016 07:00:00 PM,48,-122,3,3,6
21572,58thStGreenway22ndAve,07/15/2016 08:00:00 PM,48,-122,6,1,7
21573,58thStGreenway22ndAve,07/15/2016 09:00:00 PM,48,-122,7,2,9
21574,58thStGreenway22ndAve,07/15/2016 10:00:00 PM,48,-122,0,1,1
21575,58thStGreenway22ndAve,07/15/2016 11:00:00 PM,48,-122,3,2,5
21576,58thStGreenway22ndAve,07/16/2016 12:00:00 AM,48,-122,0,2,2
21577,58thStGreenway22ndAve,07/16/2016 01:00:00 AM,48,-122,1,1,2
21578,58thStGreenway22ndAve,07/16/2016 02:00:00 AM,48,-122,1,0,1
21579,58thStGreenway22ndAve,07/16/2016 03:00:00 AM,48,-122,0,0,0
21580,58thStGreenway22ndAve,07/16/2016 04:00:00 AM,48,-122,1,0,1
21581,58thStGreenway22ndAve,07/16/2016 05:00:00 AM,48,-122,0,0,0
21582,58thStGreenway22ndAve,07/16/2016 06:00:00 AM,48,-122,0,0,0
21583,58thStGreenway22ndAve,07/16/2016 07:00:00 AM,48,-122,3,1,4
21584,58thStGreenway22ndAve,07/16/2016 08:00:00 AM,48,-122,0,4,4
21585,58thStGreenway22ndAve,07/16/2016 09:00:00 AM,48,-122,3,4,7
21586,58thStGreenway22ndAve,07/16/2016 10:00:00 AM,48,-122,2,5,7
21587,58thStGreenway22ndAve,07/16/2016 11:00:00 AM,48,-122,7,8,15
21588,58thStGreenway22ndAve,07/16/2016 12:00:00 PM,48,-122,5,8,13
21589,58thStGreenway22ndAve,07/16/2016 01:00:00 PM,48,-122,6,15,21
21590,58thStGreenway22ndAve,07/16/2016 02:00:00 PM,48,-122,6,3,9
21591,58thStGreenway22ndAve,07/16/2016 03:00:00 PM,48,-122,0,0,0
21592,58thStGreenway22ndAve,07/16/2016 04:00:00 PM,48,-122,0,0,0
21593,58thStGreenway22ndAve,07/16/2016 05:00:00 PM,48,-122,0,0,0
21594,58thStGreenway22ndAve,07/16/2016 06:00:00 PM,48,-122,0,0,0
21595,58thStGreenway22ndAve,07/16/2016 07:00:00 PM,48,-122,0,0,0
21596,58thStGreenway22ndAve,07/16/2016 08:00:00 PM,48,-122,0,0,0
21597,58thStGreenway22ndAve,07/16/2016 09:00:00 PM,48,-122,0,0,0
21598,58thStGreenway22ndAve,07/16/2016 10:00:00 PM,48,-122,0,0,0
21599,58thStGreenway22ndAve,07/16/2016 11:00:00 PM,48,-122,0,0,0
21600,58thStGreenway22ndAve,07/17/2016 12:00:00 AM,48,-122,0,0,0
21601,58thStGreenway22ndAve,07/17/2016 01:00:00 AM,48,-122,0,0,0
21602,58thStGreenway22ndAve,07/17/2016 02:00:00 AM,48,-122,0,0,0
21603,58thStGreenway22ndAve,07/17/2016 03:00:00 AM,48,-122,0,0,0
21604,58thStGreenway22ndAve,07/17/2016 04:00:00 AM,48,-122,0,0,0
21605,58thStGreenway22ndAve,07/17/2016 05:00:00 AM,48,-122,0,0,0
21606,58thStGreenway22ndAve,07/17/2016 06:00:00 AM,48,-122,0,0,0
21607,58thStGreenway22ndAve,07/17/2016 07:00:00 AM,48,-122,0,0,0
21608,58thStGreenway22ndAve,07/17/2016 08:00:00 AM,48,-122,0,0,0
21609,58thStGreenway22ndAve,07/17/2016 09:00:00 AM,48,-122,0,0,0
21610,58thStGreenway22ndAve,07/17/2016 10:00:00 AM,48,-122,0,0,0
21611,58thStGreenway22ndAve,07/17/2016 11:00:00 AM,48,-122,0,0,0
21612,58thStGreenway22ndAve,07/17/2016 12:00:00 PM,48,-122,0,0,0
21613,58thStGreenway22ndAve,07/17/2016 01:00:00 PM,48,-122,0,0,0
21614,58thStGreenway22ndAve,07/17/2016 02:00:00 PM,48,-122,0,0,0
21615,58thStGreenway22ndAve,07/17/2016 03:00:00 PM,48,-122,0,0,0
21616,58thStGreenway22ndAve,07/17/2016 04:00:00 PM,48,-122,0,0,0
21617,58thStGreenway22ndAve,07/17/2016 05:00:00 PM,48,-122,0,0,0
21618,58thStGreenway22ndAve,07/17/2016 06:00:00 PM,48,-122,0,0,0
21619,58thStGreenway22ndAve,07/17/2016 07:00:00 PM,48,-122,0,0,0
21620,58thStGreenway22ndAve,07/17/2016 08:00:00 PM,48,-122,0,0,0
21621,58thStGreenway22ndAve,07/17/2016 09:00:00 PM,48,-122,0,0,0
21622,58thStGreenway22ndAve,07/17/2016 10:00:00 PM,48,-122,0,0,0
21623,58thStGreenway22ndAve,07/17/2016 11:00:00 PM,48,-122,0,0,0
21624,58thStGreenway22ndAve,07/18/2016 12:00:00 AM,48,-122,0,0,0
21625,58thStGreenway22ndAve,07/18/2016 01:00:00 AM,48,-122,0,0,0
21626,58thStGreenway22ndAve,07/18/2016 02:00:00 AM,48,-122,0,0,0
21627,58thStGreenway22ndAve,07/18/2016 03:00:00 AM,48,-122,0,0,0
21628,58thStGreenway22ndAve,07/18/2016 04:00:00 AM,48,-122,0,0,0
21629,58thStGreenway22ndAve,07/18/2016 05:00:00 AM,48,-122,0,0,0
21630,58thStGreenway22ndAve,07/18/2016 06:00:00 AM,48,-122,0,0,0
21631,58thStGreenway22ndAve,07/18/2016 07:00:00 AM,48,-122,0,0,0
21632,58thStGreenway22ndAve,07/18/2016 08:00:00 AM,48,-122,0,0,0
21633,58thStGreenway22ndAve,07/18/2016 09:00:00 AM,48,-122,0,0,0
21634,58thStGreenway22ndAve,07/18/2016 10:00:00 AM,48,-122,0,0,0
21635,58thStGreenway22ndAve,07/18/2016 11:00:00 AM,48,-122,0,0,0
21636,58thStGreenway22ndAve,07/18/2016 12:00:00 PM,48,-122,0,0,0
21637,58thStGreenway22ndAve,07/18/2016 01:00:00 PM,48,-122,0,0,0
21638,58thStGreenway22ndAve,07/18/2016 02:00:00 PM,48,-122,0,0,0
21639,58thStGreenway22ndAve,07/18/2016 03:00:00 PM,48,-122,0,0,0
21640,58thStGreenway22ndAve,07/18/2016 04:00:00 PM,48,-122,0,0,0
21641,58thStGreenway22ndAve,07/18/2016 05:00:00 PM,48,-122,0,0,0
21642,58thStGreenway22ndAve,07/18/2016 06:00:00 PM,48,-122,0,0,0
21643,58thStGreenway22ndAve,07/18/2016 07:00:00 PM,48,-122,0,0,0
21644,58thStGreenway22ndAve,07/18/2016 08:00:00 PM,48,-122,0,0,0
21645,58thStGreenway22ndAve,07/18/2016 09:00:00 PM,48,-122,0,0,0
21646,58thStGreenway22ndAve,07/18/2016 10:00:00 PM,48,-122,0,0,0
21647,58thStGreenway22ndAve,07/18/2016 11:00:00 PM,48,-122,0,0,0
21648,58thStGreenway22ndAve,07/19/2016 12:00:00 AM,48,-122,0,0,0
21649,58thStGreenway22ndAve,07/19/2016 01:00:00 AM,48,-122,0,0,0
21650,58thStGreenway22ndAve,07/19/2016 02:00:00 AM,48,-122,0,0,0
21651,58thStGreenway22ndAve,07/19/2016 03:00:00 AM,48,-122,0,0,0
21652,58thStGreenway22ndAve,07/19/2016 04:00:00 AM,48,-122,0,0,0
21653,58thStGreenway22ndAve,07/19/2016 05:00:00 AM,48,-122,0,0,0
21654,58thStGreenway22ndAve,07/19/2016 06:00:00 AM,48,-122,0,0,0
21655,58thStGreenway22ndAve,07/19/2016 07:00:00 AM,48,-122,0,0,0
21656,58thStGreenway22ndAve,07/19/2016 08:00:00 AM,48,-122,0,0,0
21657,58thStGreenway22ndAve,07/19/2016 09:00:00 AM,48,-122,0,0,0
21658,58thStGreenway22ndAve,07/19/2016 10:00:00 AM,48,-122,0,0,0
21659,58thStGreenway22ndAve,07/19/2016 11:00:00 AM,48,-122,0,0,0
21660,58thStGreenway22ndAve,07/19/2016 12:00:00 PM,48,-122,0,0,0
21661,58thStGreenway22ndAve,07/19/2016 01:00:00 PM,48,-122,0,0,0
21662,58thStGreenway22ndAve,07/19/2016 02:00:00 PM,48,-122,0,0,0
21663,58thStGreenway22ndAve,07/19/2016 03:00:00 PM,48,-122,0,0,0
21664,58thStGreenway22ndAve,07/19/2016 04:00:00 PM,48,-122,0,0,0
21665,58thStGreenway22ndAve,07/19/2016 05:00:00 PM,48,-122,0,0,0
21666,58thStGreenway22ndAve,07/19/2016 06:00:00 PM,48,-122,0,0,0
21667,58thStGreenway22ndAve,07/19/2016 07:00:00 PM,48,-122,0,0,0
21668,58thStGreenway22ndAve,07/19/2016 08:00:00 PM,48,-122,0,0,0
21669,58thStGreenway22ndAve,07/19/2016 09:00:00 PM,48,-122,0,0,0
21670,58thStGreenway22ndAve,07/19/2016 10:00:00 PM,48,-122,0,0,0
21671,58thStGreenway22ndAve,07/19/2016 11:00:00 PM,48,-122,0,0,0
21672,58thStGreenway22ndAve,07/20/2016 12:00:00 AM,48,-122,0,0,0
21673,58thStGreenway22ndAve,07/20/2016 01:00:00 AM,48,-122,0,0,0
21674,58thStGreenway22ndAve,07/20/2016 02:00:00 AM,48,-122,0,0,0
21675,58thStGreenway22ndAve,07/20/2016 03:00:00 AM,48,-122,0,0,0
21676,58thStGreenway22ndAve,07/20/2016 04:00:00 AM,48,-122,0,0,0
21677,58thStGreenway22ndAve,07/20/2016 05:00:00 AM,48,-122,0,0,0
21678,58thStGreenway22ndAve,07/20/2016 06:00:00 AM,48,-122,0,0,0
21679,58thStGreenway22ndAve,07/20/2016 07:00:00 AM,48,-122,0,0,0
21680,58thStGreenway22ndAve,07/20/2016 08:00:00 AM,48,-122,0,0,0
21681,58thStGreenway22ndAve,07/20/2016 09:00:00 AM,48,-122,0,0,0
21682,58thStGreenway22ndAve,07/20/2016 10:00:00 AM,48,-122,0,0,0
21683,58thStGreenway22ndAve,07/20/2016 11:00:00 AM,48,-122,0,0,0
21684,58thStGreenway22ndAve,07/20/2016 12:00:00 PM,48,-122,0,0,0
21685,58thStGreenway22ndAve,07/20/2016 01:00:00 PM,48,-122,0,0,0
21686,58thStGreenway22ndAve,07/20/2016 02:00:00 PM,48,-122,0,0,0
21687,58thStGreenway22ndAve,07/20/2016 03:00:00 PM,48,-122,0,0,0
21688,58thStGreenway22ndAve,07/20/2016 04:00:00 PM,48,-122,0,0,0
21689,58thStGreenway22ndAve,07/20/2016 05:00:00 PM,48,-122,1,0,1
21690,58thStGreenway22ndAve,07/20/2016 06:00:00 PM,48,-122,0,0,0
21691,58thStGreenway22ndAve,07/20/2016 07:00:00 PM,48,-122,0,0,0
21692,58thStGreenway22ndAve,07/20/2016 08:00:00 PM,48,-122,0,0,0
21693,58thStGreenway22ndAve,07/20/2016 09:00:00 PM,48,-122,0,0,0
21694,58thStGreenway22ndAve,07/20/2016 10:00:00 PM,48,-122,0,0,0
21695,58thStGreenway22ndAve,07/20/2016 11:00:00 PM,48,-122,0,0,0
21696,58thStGreenway22ndAve,07/21/2016 12:00:00 AM,48,-122,0,0,0
21697,58thStGreenway22ndAve,07/21/2016 01:00:00 AM,48,-122,0,0,0
21698,58thStGreenway22ndAve,07/21/2016 02:00:00 AM,48,-122,0,0,0
21699,58thStGreenway22ndAve,07/21/2016 03:00:00 AM,48,-122,0,0,0
21700,58thStGreenway22ndAve,07/21/2016 04:00:00 AM,48,-122,0,0,0
21701,58thStGreenway22ndAve,07/21/2016 05:00:00 AM,48,-122,0,0,0
21702,58thStGreenway22ndAve,07/21/2016 06:00:00 AM,48,-122,0,0,0
21703,58thStGreenway22ndAve,07/21/2016 07:00:00 AM,48,-122,0,0,0
21704,58thStGreenway22ndAve,07/21/2016 08:00:00 AM,48,-122,0,0,0
21705,58thStGreenway22ndAve,07/21/2016 09:00:00 AM,48,-122,0,0,0
21706,58thStGreenway22ndAve,07/21/2016 10:00:00 AM,48,-122,0,0,0
21707,58thStGreenway22ndAve,07/21/2016 11:00:00 AM,48,-122,0,0,0
21708,58thStGreenway22ndAve,07/21/2016 12:00:00 PM,48,-122,0,0,0
21709,58thStGreenway22ndAve,07/21/2016 01:00:00 PM,48,-122,0,0,0
21710,58thStGreenway22ndAve,07/21/2016 02:00:00 PM,48,-122,0,0,0
21711,58thStGreenway22ndAve,07/21/2016 03:00:00 PM,48,-122,0,0,0
21712,58thStGreenway22ndAve,07/21/2016 04:00:00 PM,48,-122,0,0,0
21713,58thStGreenway22ndAve,07/21/2016 05:00:00 PM,48,-122,0,0,0
21714,58thStGreenway22ndAve,07/21/2016 06:00:00 PM,48,-122,0,0,0
21715,58thStGreenway22ndAve,07/21/2016 07:00:00 PM,48,-122,0,0,0
21716,58thStGreenway22ndAve,07/21/2016 08:00:00 PM,48,-122,0,0,0
21717,58thStGreenway22ndAve,07/21/2016 09:00:00 PM,48,-122,0,0,0
21718,58thStGreenway22ndAve,07/21/2016 10:00:00 PM,48,-122,0,0,0
21719,58thStGreenway22ndAve,07/21/2016 11:00:00 PM,48,-122,0,0,0
21720,58thStGreenway22ndAve,07/22/2016 12:00:00 AM,48,-122,0,0,0
21721,58thStGreenway22ndAve,07/22/2016 01:00:00 AM,48,-122,0,0,0
21722,58thStGreenway22ndAve,07/22/2016 02:00:00 AM,48,-122,0,0,0
21723,58thStGreenway22ndAve,07/22/2016 03:00:00 AM,48,-122,0,0,0
21724,58thStGreenway22ndAve,07/22/2016 04:00:00 AM,48,-122,0,0,0
21725,58thStGreenway22ndAve,07/22/2016 05:00:00 AM,48,-122,0,0,0
21726,58thStGreenway22ndAve,07/22/2016 06:00:00 AM,48,-122,0,0,0
21727,58thStGreenway22ndAve,07/22/2016 07:00:00 AM,48,-122,0,0,0
21728,58thStGreenway22ndAve,07/22/2016 08:00:00 AM,48,-122,0,0,0
21729,58thStGreenway22ndAve,07/22/2016 09:00:00 AM,48,-122,0,0,0
21730,58thStGreenway22ndAve,07/22/2016 10:00:00 AM,48,-122,0,0,0
21731,58thStGreenway22ndAve,07/22/2016 11:00:00 AM,48,-122,0,0,0
21732,58thStGreenway22ndAve,07/22/2016 12:00:00 PM,48,-122,0,0,0
21733,58thStGreenway22ndAve,07/22/2016 01:00:00 PM,48,-122,0,0,0
21734,58thStGreenway22ndAve,07/22/2016 02:00:00 PM,48,-122,0,0,0
21735,58thStGreenway22ndAve,07/22/2016 03:00:00 PM,48,-122,0,0,0
21736,58thStGreenway22ndAve,07/22/2016 04:00:00 PM,48,-122,0,0,0
21737,58thStGreenway22ndAve,07/22/2016 05:00:00 PM,48,-122,0,0,0
21738,58thStGreenway22ndAve,07/22/2016 06:00:00 PM,48,-122,0,0,0
21739,58thStGreenway22ndAve,07/22/2016 07:00:00 PM,48,-122,0,0,0
21740,58thStGreenway22ndAve,07/22/2016 08:00:00 PM,48,-122,0,0,0
21741,58thStGreenway22ndAve,07/22/2016 09:00:00 PM,48,-122,0,0,0
21742,58thStGreenway22ndAve,07/22/2016 10:00:00 PM,48,-122,0,0,0
21743,58thStGreenway22ndAve,07/22/2016 11:00:00 PM,48,-122,0,0,0
21744,58thStGreenway22ndAve,07/23/2016 12:00:00 AM,48,-122,0,0,0
21745,58thStGreenway22ndAve,07/23/2016 01:00:00 AM,48,-122,0,0,0
21746,58thStGreenway22ndAve,07/23/2016 02:00:00 AM,48,-122,0,0,0
21747,58thStGreenway22ndAve,07/23/2016 03:00:00 AM,48,-122,0,0,0
21748,58thStGreenway22ndAve,07/23/2016 04:00:00 AM,48,-122,0,0,0
21749,58thStGreenway22ndAve,07/23/2016 05:00:00 AM,48,-122,0,0,0
21750,58thStGreenway22ndAve,07/23/2016 06:00:00 AM,48,-122,0,0,0
21751,58thStGreenway22ndAve,07/23/2016 07:00:00 AM,48,-122,0,0,0
21752,58thStGreenway22ndAve,07/23/2016 08:00:00 AM,48,-122,0,0,0
21753,58thStGreenway22ndAve,07/23/2016 09:00:00 AM,48,-122,0,0,0
21754,58thStGreenway22ndAve,07/23/2016 10:00:00 AM,48,-122,0,0,0
21755,58thStGreenway22ndAve,07/23/2016 11:00:00 AM,48,-122,0,0,0
21756,58thStGreenway22ndAve,07/23/2016 12:00:00 PM,48,-122,0,0,0
21757,58thStGreenway22ndAve,07/23/2016 01:00:00 PM,48,-122,0,0,0
21758,58thStGreenway22ndAve,07/23/2016 02:00:00 PM,48,-122,0,0,0
21759,58thStGreenway22ndAve,07/23/2016 03:00:00 PM,48,-122,0,0,0
21760,58thStGreenway22ndAve,07/23/2016 04:00:00 PM,48,-122,0,0,0
21761,58thStGreenway22ndAve,07/23/2016 05:00:00 PM,48,-122,0,0,0
21762,58thStGreenway22ndAve,07/23/2016 06:00:00 PM,48,-122,0,0,0
21763,58thStGreenway22ndAve,07/23/2016 07:00:00 PM,48,-122,0,0,0
21764,58thStGreenway22ndAve,07/23/2016 08:00:00 PM,48,-122,0,0,0
21765,58thStGreenway22ndAve,07/23/2016 09:00:00 PM,48,-122,0,0,0
21766,58thStGreenway22ndAve,07/23/2016 10:00:00 PM,48,-122,0,0,0
21767,58thStGreenway22ndAve,07/23/2016 11:00:00 PM,48,-122,0,0,0
21768,58thStGreenway22ndAve,07/24/2016 12:00:00 AM,48,-122,0,0,0
21769,58thStGreenway22ndAve,07/24/2016 01:00:00 AM,48,-122,0,0,0
21770,58thStGreenway22ndAve,07/24/2016 02:00:00 AM,48,-122,0,0,0
21771,58thStGreenway22ndAve,07/24/2016 03:00:00 AM,48,-122,0,0,0
21772,58thStGreenway22ndAve,07/24/2016 04:00:00 AM,48,-122,0,0,0
21773,58thStGreenway22ndAve,07/24/2016 05:00:00 AM,48,-122,0,0,0
21774,58thStGreenway22ndAve,07/24/2016 06:00:00 AM,48,-122,0,0,0
21775,58thStGreenway22ndAve,07/24/2016 07:00:00 AM,48,-122,0,0,0
21776,58thStGreenway22ndAve,07/24/2016 08:00:00 AM,48,-122,0,0,0
21777,58thStGreenway22ndAve,07/24/2016 09:00:00 AM,48,-122,0,0,0
21778,58thStGreenway22ndAve,07/24/2016 10:00:00 AM,48,-122,0,0,0
21779,58thStGreenway22ndAve,07/24/2016 11:00:00 AM,48,-122,0,0,0
21780,58thStGreenway22ndAve,07/24/2016 12:00:00 PM,48,-122,0,0,0
21781,58thStGreenway22ndAve,07/24/2016 01:00:00 PM,48,-122,0,0,0
21782,58thStGreenway22ndAve,07/24/2016 02:00:00 PM,48,-122,0,0,0
21783,58thStGreenway22ndAve,07/24/2016 03:00:00 PM,48,-122,0,0,0
21784,58thStGreenway22ndAve,07/24/2016 04:00:00 PM,48,-122,0,0,0
21785,58thStGreenway22ndAve,07/24/2016 05:00:00 PM,48,-122,0,0,0
21786,58thStGreenway22ndAve,07/24/2016 06:00:00 PM,48,-122,0,0,0
21787,58thStGreenway22ndAve,07/24/2016 07:00:00 PM,48,-122,0,0,0
21788,58thStGreenway22ndAve,07/24/2016 08:00:00 PM,48,-122,0,0,0
21789,58thStGreenway22ndAve,07/24/2016 09:00:00 PM,48,-122,0,0,0
21790,58thStGreenway22ndAve,07/24/2016 10:00:00 PM,48,-122,0,0,0
21791,58thStGreenway22ndAve,07/24/2016 11:00:00 PM,48,-122,0,0,0
21792,58thStGreenway22ndAve,07/25/2016 12:00:00 AM,48,-122,0,0,0
21793,58thStGreenway22ndAve,07/25/2016 01:00:00 AM,48,-122,0,0,0
21794,58thStGreenway22ndAve,07/25/2016 02:00:00 AM,48,-122,0,0,0
21795,58thStGreenway22ndAve,07/25/2016 03:00:00 AM,48,-122,0,0,0
21796,58thStGreenway22ndAve,07/25/2016 04:00:00 AM,48,-122,0,0,0
21797,58thStGreenway22ndAve,07/25/2016 05:00:00 AM,48,-122,0,0,0
21798,58thStGreenway22ndAve,07/25/2016 06:00:00 AM,48,-122,0,0,0
21799,58thStGreenway22ndAve,07/25/2016 07:00:00 AM,48,-122,0,0,0
21800,58thStGreenway22ndAve,07/25/2016 08:00:00 AM,48,-122,0,0,0
21801,58thStGreenway22ndAve,07/25/2016 09:00:00 AM,48,-122,0,0,0
21802,58thStGreenway22ndAve,07/25/2016 10:00:00 AM,48,-122,0,0,0
21803,58thStGreenway22ndAve,07/25/2016 11:00:00 AM,48,-122,0,0,0
21804,58thStGreenway22ndAve,07/25/2016 12:00:00 PM,48,-122,0,0,0
21805,58thStGreenway22ndAve,07/25/2016 01:00:00 PM,48,-122,0,0,0
21806,58thStGreenway22ndAve,07/25/2016 02:00:00 PM,48,-122,0,0,0
21807,58thStGreenway22ndAve,07/25/2016 03:00:00 PM,48,-122,0,0,0
21808,58thStGreenway22ndAve,07/25/2016 04:00:00 PM,48,-122,0,0,0
21809,58thStGreenway22ndAve,07/25/2016 05:00:00 PM,48,-122,0,0,0
21810,58thStGreenway22ndAve,07/25/2016 06:00:00 PM,48,-122,0,0,0
21811,58thStGreenway22ndAve,07/25/2016 07:00:00 PM,48,-122,0,0,0
21812,58thStGreenway22ndAve,07/25/2016 08:00:00 PM,48,-122,0,0,0
21813,58thStGreenway22ndAve,07/25/2016 09:00:00 PM,48,-122,0,0,0
21814,58thStGreenway22ndAve,07/25/2016 10:00:00 PM,48,-122,0,0,0
21815,58thStGreenway22ndAve,07/25/2016 11:00:00 PM,48,-122,0,0,0
21816,58thStGreenway22ndAve,07/26/2016 12:00:00 AM,48,-122,0,0,0
21817,58thStGreenway22ndAve,07/26/2016 01:00:00 AM,48,-122,0,0,0
21818,58thStGreenway22ndAve,07/26/2016 02:00:00 AM,48,-122,0,0,0
21819,58thStGreenway22ndAve,07/26/2016 03:00:00 AM,48,-122,0,0,0
21820,58thStGreenway22ndAve,07/26/2016 04:00:00 AM,48,-122,0,0,0
21821,58thStGreenway22ndAve,07/26/2016 05:00:00 AM,48,-122,0,0,0
21822,58thStGreenway22ndAve,07/26/2016 06:00:00 AM,48,-122,0,0,0
21823,58thStGreenway22ndAve,07/26/2016 07:00:00 AM,48,-122,0,0,0
21824,58thStGreenway22ndAve,07/26/2016 08:00:00 AM,48,-122,0,0,0
21825,58thStGreenway22ndAve,07/26/2016 09:00:00 AM,48,-122,0,0,0
21826,58thStGreenway22ndAve,07/26/2016 10:00:00 AM,48,-122,0,0,0
21827,58thStGreenway22ndAve,07/26/2016 11:00:00 AM,48,-122,0,0,0
21828,58thStGreenway22ndAve,07/26/2016 12:00:00 PM,48,-122,0,0,0
21829,58thStGreenway22ndAve,07/26/2016 01:00:00 PM,48,-122,0,0,0
21830,58thStGreenway22ndAve,07/26/2016 02:00:00 PM,48,-122,0,0,0
21831,58thStGreenway22ndAve,07/26/2016 03:00:00 PM,48,-122,0,0,0
21832,58thStGreenway22ndAve,07/26/2016 04:00:00 PM,48,-122,0,0,0
21833,58thStGreenway22ndAve,07/26/2016 05:00:00 PM,48,-122,0,0,0
21834,58thStGreenway22ndAve,07/26/2016 06:00:00 PM,48,-122,0,0,0
21835,58thStGreenway22ndAve,07/26/2016 07:00:00 PM,48,-122,0,0,0
21836,58thStGreenway22ndAve,07/26/2016 08:00:00 PM,48,-122,0,0,0
21837,58thStGreenway22ndAve,07/26/2016 09:00:00 PM,48,-122,0,0,0
21838,58thStGreenway22ndAve,07/26/2016 10:00:00 PM,48,-122,0,0,0
21839,58thStGreenway22ndAve,07/26/2016 11:00:00 PM,48,-122,0,0,0
21840,58thStGreenway22ndAve,07/27/2016 12:00:00 AM,48,-122,0,0,0
21841,58thStGreenway22ndAve,07/27/2016 01:00:00 AM,48,-122,0,0,0
21842,58thStGreenway22ndAve,07/27/2016 02:00:00 AM,48,-122,0,0,0
21843,58thStGreenway22ndAve,07/27/2016 03:00:00 AM,48,-122,0,0,0
21844,58thStGreenway22ndAve,07/27/2016 04:00:00 AM,48,-122,0,0,0
21845,58thStGreenway22ndAve,07/27/2016 05:00:00 AM,48,-122,0,0,0
21846,58thStGreenway22ndAve,07/27/2016 06:00:00 AM,48,-122,0,0,0
21847,58thStGreenway22ndAve,07/27/2016 07:00:00 AM,48,-122,0,0,0
21848,58thStGreenway22ndAve,07/27/2016 08:00:00 AM,48,-122,0,0,0
21849,58thStGreenway22ndAve,07/27/2016 09:00:00 AM,48,-122,0,0,0
21850,58thStGreenway22ndAve,07/27/2016 10:00:00 AM,48,-122,0,0,0
21851,58thStGreenway22ndAve,07/27/2016 11:00:00 AM,48,-122,0,0,0
21852,58thStGreenway22ndAve,07/27/2016 12:00:00 PM,48,-122,0,0,0
21853,58thStGreenway22ndAve,07/27/2016 01:00:00 PM,48,-122,0,0,0
21854,58thStGreenway22ndAve,07/27/2016 02:00:00 PM,48,-122,0,0,0
21855,58thStGreenway22ndAve,07/27/2016 03:00:00 PM,48,-122,0,0,0
21856,58thStGreenway22ndAve,07/27/2016 04:00:00 PM,48,-122,0,0,0
21857,58thStGreenway22ndAve,07/27/2016 05:00:00 PM,48,-122,0,0,0
21858,58thStGreenway22ndAve,07/27/2016 06:00:00 PM,48,-122,0,0,0
21859,58thStGreenway22ndAve,07/27/2016 07:00:00 PM,48,-122,0,0,0
21860,58thStGreenway22ndAve,07/27/2016 08:00:00 PM,48,-122,0,0,0
21861,58thStGreenway22ndAve,07/27/2016 09:00:00 PM,48,-122,0,0,0
21862,58thStGreenway22ndAve,07/27/2016 10:00:00 PM,48,-122,0,0,0
21863,58thStGreenway22ndAve,07/27/2016 11:00:00 PM,48,-122,0,0,0
21864,58thStGreenway22ndAve,07/28/2016 12:00:00 AM,48,-122,0,0,0
21865,58thStGreenway22ndAve,07/28/2016 01:00:00 AM,48,-122,0,0,0
21866,58thStGreenway22ndAve,07/28/2016 02:00:00 AM,48,-122,0,0,0
21867,58thStGreenway22ndAve,07/28/2016 03:00:00 AM,48,-122,0,0,0
21868,58thStGreenway22ndAve,07/28/2016 04:00:00 AM,48,-122,0,0,0
21869,58thStGreenway22ndAve,07/28/2016 05:00:00 AM,48,-122,0,0,0
21870,58thStGreenway22ndAve,07/28/2016 06:00:00 AM,48,-122,0,0,0
21871,58thStGreenway22ndAve,07/28/2016 07:00:00 AM,48,-122,0,0,0
21872,58thStGreenway22ndAve,07/28/2016 08:00:00 AM,48,-122,0,0,0
21873,58thStGreenway22ndAve,07/28/2016 09:00:00 AM,48,-122,0,0,0
21874,58thStGreenway22ndAve,07/28/2016 10:00:00 AM,48,-122,0,0,0
21875,58thStGreenway22ndAve,07/28/2016 11:00:00 AM,48,-122,0,0,0
21876,58thStGreenway22ndAve,07/28/2016 12:00:00 PM,48,-122,0,0,0
21877,58thStGreenway22ndAve,07/28/2016 01:00:00 PM,48,-122,0,0,0
21878,58thStGreenway22ndAve,07/28/2016 02:00:00 PM,48,-122,1,0,1
21879,58thStGreenway22ndAve,07/28/2016 03:00:00 PM,48,-122,0,0,0
21880,58thStGreenway22ndAve,07/28/2016 04:00:00 PM,48,-122,0,0,0
21881,58thStGreenway22ndAve,07/28/2016 05:00:00 PM,48,-122,0,0,0
21882,58thStGreenway22ndAve,07/28/2016 06:00:00 PM,48,-122,0,0,0
21883,58thStGreenway22ndAve,07/28/2016 07:00:00 PM,48,-122,0,0,0
21884,58thStGreenway22ndAve,07/28/2016 08:00:00 PM,48,-122,0,0,0
21885,58thStGreenway22ndAve,07/28/2016 09:00:00 PM,48,-122,0,0,0
21886,58thStGreenway22ndAve,07/28/2016 10:00:00 PM,48,-122,0,0,0
21887,58thStGreenway22ndAve,07/28/2016 11:00:00 PM,48,-122,0,0,0
21888,58thStGreenway22ndAve,07/29/2016 12:00:00 AM,48,-122,0,0,0
21889,58thStGreenway22ndAve,07/29/2016 01:00:00 AM,48,-122,0,0,0
21890,58thStGreenway22ndAve,07/29/2016 02:00:00 AM,48,-122,0,0,0
21891,58thStGreenway22ndAve,07/29/2016 03:00:00 AM,48,-122,0,0,0
21892,58thStGreenway22ndAve,07/29/2016 04:00:00 AM,48,-122,0,0,0
21893,58thStGreenway22ndAve,07/29/2016 05:00:00 AM,48,-122,0,0,0
21894,58thStGreenway22ndAve,07/29/2016 06:00:00 AM,48,-122,0,0,0
21895,58thStGreenway22ndAve,07/29/2016 07:00:00 AM,48,-122,0,0,0
21896,58thStGreenway22ndAve,07/29/2016 08:00:00 AM,48,-122,0,0,0
21897,58thStGreenway22ndAve,07/29/2016 09:00:00 AM,48,-122,0,0,0
21898,58thStGreenway22ndAve,07/29/2016 10:00:00 AM,48,-122,0,0,0
21899,58thStGreenway22ndAve,07/29/2016 11:00:00 AM,48,-122,0,0,0
21900,58thStGreenway22ndAve,07/29/2016 12:00:00 PM,48,-122,0,0,0
21901,58thStGreenway22ndAve,07/29/2016 01:00:00 PM,48,-122,0,0,0
21902,58thStGreenway22ndAve,07/29/2016 02:00:00 PM,48,-122,0,0,0
21903,58thStGreenway22ndAve,07/29/2016 03:00:00 PM,48,-122,0,0,0
21904,58thStGreenway22ndAve,07/29/2016 04:00:00 PM,48,-122,0,0,0
21905,58thStGreenway22ndAve,07/29/2016 05:00:00 PM,48,-122,0,0,0
21906,58thStGreenway22ndAve,07/29/2016 06:00:00 PM,48,-122,0,0,0
21907,58thStGreenway22ndAve,07/29/2016 07:00:00 PM,48,-122,0,0,0
21908,58thStGreenway22ndAve,07/29/2016 08:00:00 PM,48,-122,0,0,0
21909,58thStGreenway22ndAve,07/29/2016 09:00:00 PM,48,-122,0,0,0
21910,58thStGreenway22ndAve,07/29/2016 10:00:00 PM,48,-122,0,0,0
21911,58thStGreenway22ndAve,07/29/2016 11:00:00 PM,48,-122,0,0,0
21912,58thStGreenway22ndAve,07/30/2016 12:00:00 AM,48,-122,0,0,0
21913,58thStGreenway22ndAve,07/30/2016 01:00:00 AM,48,-122,0,0,0
21914,58thStGreenway22ndAve,07/30/2016 02:00:00 AM,48,-122,0,0,0
21915,58thStGreenway22ndAve,07/30/2016 03:00:00 AM,48,-122,0,0,0
21916,58thStGreenway22ndAve,07/30/2016 04:00:00 AM,48,-122,0,0,0
21917,58thStGreenway22ndAve,07/30/2016 05:00:00 AM,48,-122,0,0,0
21918,58thStGreenway22ndAve,07/30/2016 06:00:00 AM,48,-122,0,0,0
21919,58thStGreenway22ndAve,07/30/2016 07:00:00 AM,48,-122,0,0,0
21920,58thStGreenway22ndAve,07/30/2016 08:00:00 AM,48,-122,0,0,0
21921,58thStGreenway22ndAve,07/30/2016 09:00:00 AM,48,-122,0,0,0
21922,58thStGreenway22ndAve,07/30/2016 10:00:00 AM,48,-122,0,0,0
21923,58thStGreenway22ndAve,07/30/2016 11:00:00 AM,48,-122,0,0,0
21924,58thStGreenway22ndAve,07/30/2016 12:00:00 PM,48,-122,0,0,0
21925,58thStGreenway22ndAve,07/30/2016 01:00:00 PM,48,-122,0,0,0
21926,58thStGreenway22ndAve,07/30/2016 02:00:00 PM,48,-122,0,0,0
21927,58thStGreenway22ndAve,07/30/2016 03:00:00 PM,48,-122,0,0,0
21928,58thStGreenway22ndAve,07/30/2016 04:00:00 PM,48,-122,0,0,0
21929,58thStGreenway22ndAve,07/30/2016 05:00:00 PM,48,-122,0,0,0
21930,58thStGreenway22ndAve,07/30/2016 06:00:00 PM,48,-122,0,0,0
21931,58thStGreenway22ndAve,07/30/2016 07:00:00 PM,48,-122,0,0,0
21932,58thStGreenway22ndAve,07/30/2016 08:00:00 PM,48,-122,0,0,0
21933,58thStGreenway22ndAve,07/30/2016 09:00:00 PM,48,-122,0,0,0
21934,58thStGreenway22ndAve,07/30/2016 10:00:00 PM,48,-122,0,0,0
21935,58thStGreenway22ndAve,07/30/2016 11:00:00 PM,48,-122,0,0,0
21936,58thStGreenway22ndAve,07/31/2016 12:00:00 AM,48,-122,0,0,0
21937,58thStGreenway22ndAve,07/31/2016 01:00:00 AM,48,-122,0,0,0
21938,58thStGreenway22ndAve,07/31/2016 02:00:00 AM,48,-122,0,0,0
21939,58thStGreenway22ndAve,07/31/2016 03:00:00 AM,48,-122,0,0,0
21940,58thStGreenway22ndAve,07/31/2016 04:00:00 AM,48,-122,0,0,0
21941,58thStGreenway22ndAve,07/31/2016 05:00:00 AM,48,-122,0,0,0
21942,58thStGreenway22ndAve,07/31/2016 06:00:00 AM,48,-122,0,0,0
21943,58thStGreenway22ndAve,07/31/2016 07:00:00 AM,48,-122,0,0,0
21944,58thStGreenway22ndAve,07/31/2016 08:00:00 AM,48,-122,0,0,0
21945,58thStGreenway22ndAve,07/31/2016 09:00:00 AM,48,-122,0,0,0
21946,58thStGreenway22ndAve,07/31/2016 10:00:00 AM,48,-122,0,0,0
21947,58thStGreenway22ndAve,07/31/2016 11:00:00 AM,48,-122,0,0,0
21948,58thStGreenway22ndAve,07/31/2016 12:00:00 PM,48,-122,0,0,0
21949,58thStGreenway22ndAve,07/31/2016 01:00:00 PM,48,-122,0,0,0
21950,58thStGreenway22ndAve,07/31/2016 02:00:00 PM,48,-122,0,0,0
21951,58thStGreenway22ndAve,07/31/2016 03:00:00 PM,48,-122,0,0,0
21952,58thStGreenway22ndAve,07/31/2016 04:00:00 PM,48,-122,0,0,0
21953,58thStGreenway22ndAve,07/31/2016 05:00:00 PM,48,-122,0,0,0
21954,58thStGreenway22ndAve,07/31/2016 06:00:00 PM,48,-122,0,0,0
21955,58thStGreenway22ndAve,07/31/2016 07:00:00 PM,48,-122,0,0,0
21956,58thStGreenway22ndAve,07/31/2016 08:00:00 PM,48,-122,0,0,0
21957,58thStGreenway22ndAve,07/31/2016 09:00:00 PM,48,-122,0,0,0
21958,58thStGreenway22ndAve,07/31/2016 10:00:00 PM,48,-122,0,0,0
21959,58thStGreenway22ndAve,07/31/2016 11:00:00 PM,48,-122,0,0,0
21960,58thStGreenway22ndAve,09/01/2016 12:00:00 AM,48,-122,0,0,0
21961,58thStGreenway22ndAve,09/01/2016 01:00:00 AM,48,-122,0,0,0
21962,58thStGreenway22ndAve,09/01/2016 02:00:00 AM,48,-122,0,0,0
21963,58thStGreenway22ndAve,09/01/2016 03:00:00 AM,48,-122,0,0,0
21964,58thStGreenway22ndAve,09/01/2016 04:00:00 AM,48,-122,0,0,0
21965,58thStGreenway22ndAve,09/01/2016 05:00:00 AM,48,-122,0,0,0
21966,58thStGreenway22ndAve,09/01/2016 06:00:00 AM,48,-122,0,0,0
21967,58thStGreenway22ndAve,09/01/2016 07:00:00 AM,48,-122,0,0,0
21968,58thStGreenway22ndAve,09/01/2016 08:00:00 AM,48,-122,0,0,0
21969,58thStGreenway22ndAve,09/01/2016 09:00:00 AM,48,-122,0,0,0
21970,58thStGreenway22ndAve,09/01/2016 10:00:00 AM,48,-122,0,0,0
21971,58thStGreenway22ndAve,09/01/2016 11:00:00 AM,48,-122,0,0,0
21972,58thStGreenway22ndAve,09/01/2016 12:00:00 PM,48,-122,0,0,0
21973,58thStGreenway22ndAve,09/01/2016 01:00:00 PM,48,-122,0,0,0
21974,58thStGreenway22ndAve,09/01/2016 02:00:00 PM,48,-122,0,0,0
21975,58thStGreenway22ndAve,09/01/2016 03:00:00 PM,48,-122,0,0,0
21976,58thStGreenway22ndAve,09/01/2016 04:00:00 PM,48,-122,0,0,0
21977,58thStGreenway22ndAve,09/01/2016 05:00:00 PM,48,-122,0,0,0
21978,58thStGreenway22ndAve,09/01/2016 06:00:00 PM,48,-122,0,0,0
21979,58thStGreenway22ndAve,09/01/2016 07:00:00 PM,48,-122,0,0,0
21980,58thStGreenway22ndAve,09/01/2016 08:00:00 PM,48,-122,0,0,0
21981,58thStGreenway22ndAve,09/01/2016 09:00:00 PM,48,-122,0,0,0
21982,58thStGreenway22ndAve,09/01/2016 10:00:00 PM,48,-122,0,0,0
21983,58thStGreenway22ndAve,09/01/2016 11:00:00 PM,48,-122,0,0,0
21984,58thStGreenway22ndAve,09/02/2016 12:00:00 AM,48,-122,0,0,0
21985,58thStGreenway22ndAve,09/02/2016 01:00:00 AM,48,-122,0,0,0
21986,58thStGreenway22ndAve,09/02/2016 02:00:00 AM,48,-122,0,0,0
21987,58thStGreenway22ndAve,09/02/2016 03:00:00 AM,48,-122,0,0,0
21988,58thStGreenway22ndAve,09/02/2016 04:00:00 AM,48,-122,0,0,0
21989,58thStGreenway22ndAve,09/02/2016 05:00:00 AM,48,-122,0,0,0
21990,58thStGreenway22ndAve,09/02/2016 06:00:00 AM,48,-122,0,0,0
21991,58thStGreenway22ndAve,09/02/2016 07:00:00 AM,48,-122,0,0,0
21992,58thStGreenway22ndAve,09/02/2016 08:00:00 AM,48,-122,0,0,0
21993,58thStGreenway22ndAve,09/02/2016 09:00:00 AM,48,-122,0,0,0
21994,58thStGreenway22ndAve,09/02/2016 10:00:00 AM,48,-122,,,
21995,58thStGreenway22ndAve,09/02/2016 11:00:00 AM,48,-122,0,0,0
21996,58thStGreenway22ndAve,09/02/2016 12:00:00 PM,48,-122,0,0,0
21997,58thStGreenway22ndAve,09/02/2016 01:00:00 PM,48,-122,0,0,0
21998,58thStGreenway22ndAve,09/02/2016 02:00:00 PM,48,-122,0,0,0
21999,58thStGreenway22ndAve,09/02/2016 03:00:00 PM,48,-122,0,0,0
22000,58thStGreenway22ndAve,09/02/2016 04:00:00 PM,48,-122,0,0,0
22001,58thStGreenway22ndAve,09/02/2016 05:00:00 PM,48,-122,0,0,0
22002,58thStGreenway22ndAve,09/02/2016 06:00:00 PM,48,-122,0,0,0
22003,58thStGreenway22ndAve,09/02/2016 07:00:00 PM,48,-122,0,0,0
22004,58thStGreenway22ndAve,09/02/2016 08:00:00 PM,48,-122,0,0,0
22005,58thStGreenway22ndAve,09/02/2016 09:00:00 PM,48,-122,0,0,0
22006,58thStGreenway22ndAve,09/02/2016 10:00:00 PM,48,-122,0,0,0
22007,58thStGreenway22ndAve,09/02/2016 11:00:00 PM,48,-122,0,0,0
22008,58thStGreenway22ndAve,09/03/2016 12:00:00 AM,48,-122,0,0,0
22009,58thStGreenway22ndAve,09/03/2016 01:00:00 AM,48,-122,0,0,0
22010,58thStGreenway22ndAve,09/03/2016 02:00:00 AM,48,-122,0,0,0
22011,58thStGreenway22ndAve,09/03/2016 03:00:00 AM,48,-122,0,0,0
22012,58thStGreenway22ndAve,09/03/2016 04:00:00 AM,48,-122,0,0,0
22013,58thStGreenway22ndAve,09/03/2016 05:00:00 AM,48,-122,0,0,0
22014,58thStGreenway22ndAve,09/03/2016 06:00:00 AM,48,-122,0,0,0
22015,58thStGreenway22ndAve,09/03/2016 07:00:00 AM,48,-122,0,0,0
22016,58thStGreenway22ndAve,09/03/2016 08:00:00 AM,48,-122,0,0,0
22017,58thStGreenway22ndAve,09/03/2016 09:00:00 AM,48,-122,0,0,0
22018,58thStGreenway22ndAve,09/03/2016 10:00:00 AM,48,-122,0,0,0
22019,58thStGreenway22ndAve,09/03/2016 11:00:00 AM,48,-122,0,0,0
22020,58thStGreenway22ndAve,09/03/2016 12:00:00 PM,48,-122,0,0,0
22021,58thStGreenway22ndAve,09/03/2016 01:00:00 PM,48,-122,0,0,0
22022,58thStGreenway22ndAve,09/03/2016 02:00:00 PM,48,-122,0,0,0
22023,58thStGreenway22ndAve,09/03/2016 03:00:00 PM,48,-122,0,0,0
22024,58thStGreenway22ndAve,09/03/2016 04:00:00 PM,48,-122,0,0,0
22025,58thStGreenway22ndAve,09/03/2016 05:00:00 PM,48,-122,0,0,0
22026,58thStGreenway22ndAve,09/03/2016 06:00:00 PM,48,-122,0,0,0
22027,58thStGreenway22ndAve,09/03/2016 07:00:00 PM,48,-122,0,0,0
22028,58thStGreenway22ndAve,09/03/2016 08:00:00 PM,48,-122,0,0,0
22029,58thStGreenway22ndAve,09/03/2016 09:00:00 PM,48,-122,0,0,0
22030,58thStGreenway22ndAve,09/03/2016 10:00:00 PM,48,-122,0,0,0
22031,58thStGreenway22ndAve,09/03/2016 11:00:00 PM,48,-122,0,0,0
22032,58thStGreenway22ndAve,09/04/2016 12:00:00 AM,48,-122,0,0,0
22033,58thStGreenway22ndAve,09/04/2016 01:00:00 AM,48,-122,0,0,0
22034,58thStGreenway22ndAve,09/04/2016 02:00:00 AM,48,-122,0,0,0
22035,58thStGreenway22ndAve,09/04/2016 03:00:00 AM,48,-122,0,0,0
22036,58thStGreenway22ndAve,09/04/2016 04:00:00 AM,48,-122,0,0,0
22037,58thStGreenway22ndAve,09/04/2016 05:00:00 AM,48,-122,0,0,0
22038,58thStGreenway22ndAve,09/04/2016 06:00:00 AM,48,-122,0,0,0
22039,58thStGreenway22ndAve,09/04/2016 07:00:00 AM,48,-122,0,0,0
22040,58thStGreenway22ndAve,09/04/2016 08:00:00 AM,48,-122,0,0,0
22041,58thStGreenway22ndAve,09/04/2016 09:00:00 AM,48,-122,0,0,0
22042,58thStGreenway22ndAve,09/04/2016 10:00:00 AM,48,-122,0,0,0
22043,58thStGreenway22ndAve,09/04/2016 11:00:00 AM,48,-122,0,0,0
22044,58thStGreenway22ndAve,09/04/2016 12:00:00 PM,48,-122,0,0,0
22045,58thStGreenway22ndAve,09/04/2016 01:00:00 PM,48,-122,0,0,0
22046,58thStGreenway22ndAve,09/04/2016 02:00:00 PM,48,-122,0,0,0
22047,58thStGreenway22ndAve,09/04/2016 03:00:00 PM,48,-122,0,0,0
22048,58thStGreenway22ndAve,09/04/2016 04:00:00 PM,48,-122,0,0,0
22049,58thStGreenway22ndAve,09/04/2016 05:00:00 PM,48,-122,0,0,0
22050,58thStGreenway22ndAve,09/04/2016 06:00:00 PM,48,-122,0,0,0
22051,58thStGreenway22ndAve,09/04/2016 07:00:00 PM,48,-122,0,0,0
22052,58thStGreenway22ndAve,09/04/2016 08:00:00 PM,48,-122,0,0,0
22053,58thStGreenway22ndAve,09/04/2016 09:00:00 PM,48,-122,0,0,0
22054,58thStGreenway22ndAve,09/04/2016 10:00:00 PM,48,-122,0,0,0
22055,58thStGreenway22ndAve,09/04/2016 11:00:00 PM,48,-122,0,0,0
22056,58thStGreenway22ndAve,09/05/2016 12:00:00 AM,48,-122,0,0,0
22057,58thStGreenway22ndAve,09/05/2016 01:00:00 AM,48,-122,0,0,0
22058,58thStGreenway22ndAve,09/05/2016 02:00:00 AM,48,-122,0,0,0
22059,58thStGreenway22ndAve,09/05/2016 03:00:00 AM,48,-122,0,0,0
22060,58thStGreenway22ndAve,09/05/2016 04:00:00 AM,48,-122,0,0,0
22061,58thStGreenway22ndAve,09/05/2016 05:00:00 AM,48,-122,0,0,0
22062,58thStGreenway22ndAve,09/05/2016 06:00:00 AM,48,-122,0,0,0
22063,58thStGreenway22ndAve,09/05/2016 07:00:00 AM,48,-122,0,0,0
22064,58thStGreenway22ndAve,09/05/2016 08:00:00 AM,48,-122,0,0,0
22065,58thStGreenway22ndAve,09/05/2016 09:00:00 AM,48,-122,0,0,0
22066,58thStGreenway22ndAve,09/05/2016 10:00:00 AM,48,-122,0,0,0
22067,58thStGreenway22ndAve,09/05/2016 11:00:00 AM,48,-122,0,0,0
22068,58thStGreenway22ndAve,09/05/2016 12:00:00 PM,48,-122,0,0,0
22069,58thStGreenway22ndAve,09/05/2016 01:00:00 PM,48,-122,0,0,0
22070,58thStGreenway22ndAve,09/05/2016 02:00:00 PM,48,-122,0,0,0
22071,58thStGreenway22ndAve,09/05/2016 03:00:00 PM,48,-122,0,0,0
22072,58thStGreenway22ndAve,09/05/2016 04:00:00 PM,48,-122,0,0,0
22073,58thStGreenway22ndAve,09/05/2016 05:00:00 PM,48,-122,0,0,0
22074,58thStGreenway22ndAve,09/05/2016 06:00:00 PM,48,-122,0,0,0
22075,58thStGreenway22ndAve,09/05/2016 07:00:00 PM,48,-122,0,0,0
22076,58thStGreenway22ndAve,09/05/2016 08:00:00 PM,48,-122,0,0,0
22077,58thStGreenway22ndAve,09/05/2016 09:00:00 PM,48,-122,0,0,0
22078,58thStGreenway22ndAve,09/05/2016 10:00:00 PM,48,-122,0,0,0
22079,58thStGreenway22ndAve,09/05/2016 11:00:00 PM,48,-122,0,0,0
22080,58thStGreenway22ndAve,09/06/2016 12:00:00 AM,48,-122,0,0,0
22081,58thStGreenway22ndAve,09/06/2016 01:00:00 AM,48,-122,0,0,0
22082,58thStGreenway22ndAve,09/06/2016 02:00:00 AM,48,-122,0,0,0
22083,58thStGreenway22ndAve,09/06/2016 03:00:00 AM,48,-122,0,0,0
22084,58thStGreenway22ndAve,09/06/2016 04:00:00 AM,48,-122,0,0,0
22085,58thStGreenway22ndAve,09/06/2016 05:00:00 AM,48,-122,0,0,0
22086,58thStGreenway22ndAve,09/06/2016 06:00:00 AM,48,-122,0,0,0
22087,58thStGreenway22ndAve,09/06/2016 07:00:00 AM,48,-122,0,0,0
22088,58thStGreenway22ndAve,09/06/2016 08:00:00 AM,48,-122,0,0,0
22089,58thStGreenway22ndAve,09/06/2016 09:00:00 AM,48,-122,0,0,0
22090,58thStGreenway22ndAve,09/06/2016 10:00:00 AM,48,-122,0,0,0
22091,58thStGreenway22ndAve,09/06/2016 11:00:00 AM,48,-122,0,0,0
22092,58thStGreenway22ndAve,09/06/2016 12:00:00 PM,48,-122,0,0,0
22093,58thStGreenway22ndAve,09/06/2016 01:00:00 PM,48,-122,0,0,0
22094,58thStGreenway22ndAve,09/06/2016 02:00:00 PM,48,-122,0,0,0
22095,58thStGreenway22ndAve,09/06/2016 03:00:00 PM,48,-122,0,0,0
22096,58thStGreenway22ndAve,09/06/2016 04:00:00 PM,48,-122,0,0,0
22097,58thStGreenway22ndAve,09/06/2016 05:00:00 PM,48,-122,0,0,0
22098,58thStGreenway22ndAve,09/06/2016 06:00:00 PM,48,-122,0,0,0
22099,58thStGreenway22ndAve,09/06/2016 07:00:00 PM,48,-122,0,0,0
22100,58thStGreenway22ndAve,09/06/2016 08:00:00 PM,48,-122,0,0,0
22101,58thStGreenway22ndAve,09/06/2016 09:00:00 PM,48,-122,0,0,0
22102,58thStGreenway22ndAve,09/06/2016 10:00:00 PM,48,-122,0,0,0
22103,58thStGreenway22ndAve,09/06/2016 11:00:00 PM,48,-122,0,0,0
22104,58thStGreenway22ndAve,09/07/2016 12:00:00 AM,48,-122,0,0,0
22105,58thStGreenway22ndAve,09/07/2016 01:00:00 AM,48,-122,0,0,0
22106,58thStGreenway22ndAve,09/07/2016 02:00:00 AM,48,-122,0,0,0
22107,58thStGreenway22ndAve,09/07/2016 03:00:00 AM,48,-122,0,0,0
22108,58thStGreenway22ndAve,09/07/2016 04:00:00 AM,48,-122,0,0,0
22109,58thStGreenway22ndAve,09/07/2016 05:00:00 AM,48,-122,0,0,0
22110,58thStGreenway22ndAve,09/07/2016 06:00:00 AM,48,-122,0,0,0
22111,58thStGreenway22ndAve,09/07/2016 07:00:00 AM,48,-122,0,0,0
22112,58thStGreenway22ndAve,09/07/2016 08:00:00 AM,48,-122,0,0,0
22113,58thStGreenway22ndAve,09/07/2016 09:00:00 AM,48,-122,0,0,0
22114,58thStGreenway22ndAve,09/07/2016 10:00:00 AM,48,-122,0,0,0
22115,58thStGreenway22ndAve,09/07/2016 11:00:00 AM,48,-122,0,0,0
22116,58thStGreenway22ndAve,09/07/2016 12:00:00 PM,48,-122,0,0,0
22117,58thStGreenway22ndAve,09/07/2016 01:00:00 PM,48,-122,0,0,0
22118,58thStGreenway22ndAve,09/07/2016 02:00:00 PM,48,-122,0,0,0
22119,58thStGreenway22ndAve,09/07/2016 03:00:00 PM,48,-122,0,0,0
22120,58thStGreenway22ndAve,09/07/2016 04:00:00 PM,48,-122,0,0,0
22121,58thStGreenway22ndAve,09/07/2016 05:00:00 PM,48,-122,0,0,0
22122,58thStGreenway22ndAve,09/07/2016 06:00:00 PM,48,-122,0,0,0
22123,58thStGreenway22ndAve,09/07/2016 07:00:00 PM,48,-122,0,0,0
22124,58thStGreenway22ndAve,09/07/2016 08:00:00 PM,48,-122,0,0,0
22125,58thStGreenway22ndAve,09/07/2016 09:00:00 PM,48,-122,0,0,0
22126,58thStGreenway22ndAve,09/07/2016 10:00:00 PM,48,-122,0,0,0
22127,58thStGreenway22ndAve,09/07/2016 11:00:00 PM,48,-122,0,0,0
22128,58thStGreenway22ndAve,09/08/2016 12:00:00 AM,48,-122,0,0,0
22129,58thStGreenway22ndAve,09/08/2016 01:00:00 AM,48,-122,0,0,0
22130,58thStGreenway22ndAve,09/08/2016 02:00:00 AM,48,-122,0,0,0
22131,58thStGreenway22ndAve,09/08/2016 03:00:00 AM,48,-122,0,0,0
22132,58thStGreenway22ndAve,09/08/2016 04:00:00 AM,48,-122,0,0,0
22133,58thStGreenway22ndAve,09/08/2016 05:00:00 AM,48,-122,0,0,0
22134,58thStGreenway22ndAve,09/08/2016 06:00:00 AM,48,-122,0,0,0
22135,58thStGreenway22ndAve,09/08/2016 07:00:00 AM,48,-122,0,0,0
22136,58thStGreenway22ndAve,09/08/2016 08:00:00 AM,48,-122,0,0,0
22137,58thStGreenway22ndAve,09/08/2016 09:00:00 AM,48,-122,0,0,0
22138,58thStGreenway22ndAve,09/08/2016 10:00:00 AM,48,-122,0,0,0
22139,58thStGreenway22ndAve,09/08/2016 11:00:00 AM,48,-122,0,0,0
22140,58thStGreenway22ndAve,09/08/2016 12:00:00 PM,48,-122,0,0,0
22141,58thStGreenway22ndAve,09/08/2016 01:00:00 PM,48,-122,0,0,0
22142,58thStGreenway22ndAve,09/08/2016 02:00:00 PM,48,-122,0,0,0
22143,58thStGreenway22ndAve,09/08/2016 03:00:00 PM,48,-122,0,0,0
22144,58thStGreenway22ndAve,09/08/2016 04:00:00 PM,48,-122,0,0,0
22145,58thStGreenway22ndAve,09/08/2016 05:00:00 PM,48,-122,0,0,0
22146,58thStGreenway22ndAve,09/08/2016 06:00:00 PM,48,-122,0,0,0
22147,58thStGreenway22ndAve,09/08/2016 07:00:00 PM,48,-122,0,0,0
22148,58thStGreenway22ndAve,09/08/2016 08:00:00 PM,48,-122,0,0,0
22149,58thStGreenway22ndAve,09/08/2016 09:00:00 PM,48,-122,0,0,0
22150,58thStGreenway22ndAve,09/08/2016 10:00:00 PM,48,-122,0,0,0
22151,58thStGreenway22ndAve,09/08/2016 11:00:00 PM,48,-122,0,0,0
22152,58thStGreenway22ndAve,09/09/2016 12:00:00 AM,48,-122,0,0,0
22153,58thStGreenway22ndAve,09/09/2016 01:00:00 AM,48,-122,0,0,0
22154,58thStGreenway22ndAve,09/09/2016 02:00:00 AM,48,-122,0,0,0
22155,58thStGreenway22ndAve,09/09/2016 03:00:00 AM,48,-122,0,0,0
22156,58thStGreenway22ndAve,09/09/2016 04:00:00 AM,48,-122,0,0,0
22157,58thStGreenway22ndAve,09/09/2016 05:00:00 AM,48,-122,0,0,0
22158,58thStGreenway22ndAve,09/09/2016 06:00:00 AM,48,-122,0,0,0
22159,58thStGreenway22ndAve,09/09/2016 07:00:00 AM,48,-122,0,0,0
22160,58thStGreenway22ndAve,09/09/2016 08:00:00 AM,48,-122,0,0,0
22161,58thStGreenway22ndAve,09/09/2016 09:00:00 AM,48,-122,0,0,0
22162,58thStGreenway22ndAve,09/09/2016 10:00:00 AM,48,-122,0,0,0
22163,58thStGreenway22ndAve,09/09/2016 11:00:00 AM,48,-122,17,8,25
22164,58thStGreenway22ndAve,09/09/2016 12:00:00 PM,48,-122,12,7,19
22165,58thStGreenway22ndAve,09/09/2016 01:00:00 PM,48,-122,32,5,37
22166,58thStGreenway22ndAve,09/09/2016 02:00:00 PM,48,-122,17,8,25
22167,58thStGreenway22ndAve,09/09/2016 03:00:00 PM,48,-122,13,4,17
22168,58thStGreenway22ndAve,09/09/2016 04:00:00 PM,48,-122,35,6,41
22169,58thStGreenway22ndAve,09/09/2016 05:00:00 PM,48,-122,12,9,21
22170,58thStGreenway22ndAve,09/09/2016 06:00:00 PM,48,-122,22,7,29
22171,58thStGreenway22ndAve,09/09/2016 07:00:00 PM,48,-122,21,4,25
22172,58thStGreenway22ndAve,09/09/2016 08:00:00 PM,48,-122,11,3,14
22173,58thStGreenway22ndAve,09/09/2016 09:00:00 PM,48,-122,11,3,14
22174,58thStGreenway22ndAve,09/09/2016 10:00:00 PM,48,-122,5,2,7
22175,58thStGreenway22ndAve,09/09/2016 11:00:00 PM,48,-122,3,3,6
22176,58thStGreenway22ndAve,09/10/2016 12:00:00 AM,48,-122,4,0,4
22177,58thStGreenway22ndAve,09/10/2016 01:00:00 AM,48,-122,7,1,8
22178,58thStGreenway22ndAve,09/10/2016 02:00:00 AM,48,-122,2,1,3
22179,58thStGreenway22ndAve,09/10/2016 03:00:00 AM,48,-122,0,0,0
22180,58thStGreenway22ndAve,09/10/2016 04:00:00 AM,48,-122,1,0,1
22181,58thStGreenway22ndAve,09/10/2016 05:00:00 AM,48,-122,0,0,0
22182,58thStGreenway22ndAve,09/10/2016 06:00:00 AM,48,-122,0,0,0
22183,58thStGreenway22ndAve,09/10/2016 07:00:00 AM,48,-122,2,0,2
22184,58thStGreenway22ndAve,09/10/2016 08:00:00 AM,48,-122,12,5,17
22185,58thStGreenway22ndAve,09/10/2016 09:00:00 AM,48,-122,15,6,21
22186,58thStGreenway22ndAve,09/10/2016 10:00:00 AM,48,-122,21,5,26
22187,58thStGreenway22ndAve,09/10/2016 11:00:00 AM,48,-122,38,11,49
22188,58thStGreenway22ndAve,09/10/2016 12:00:00 PM,48,-122,26,8,34
22189,58thStGreenway22ndAve,09/10/2016 01:00:00 PM,48,-122,33,11,44
22190,58thStGreenway22ndAve,09/10/2016 02:00:00 PM,48,-122,23,9,32
22191,58thStGreenway22ndAve,09/10/2016 03:00:00 PM,48,-122,27,12,39
22192,58thStGreenway22ndAve,09/10/2016 04:00:00 PM,48,-122,32,3,35
22193,58thStGreenway22ndAve,09/10/2016 05:00:00 PM,48,-122,26,12,38
22194,58thStGreenway22ndAve,09/10/2016 06:00:00 PM,48,-122,16,5,21
22195,58thStGreenway22ndAve,09/10/2016 07:00:00 PM,48,-122,34,5,39
22196,58thStGreenway22ndAve,09/10/2016 08:00:00 PM,48,-122,6,1,7
22197,58thStGreenway22ndAve,09/10/2016 09:00:00 PM,48,-122,7,1,8
22198,58thStGreenway22ndAve,09/10/2016 10:00:00 PM,48,-122,11,1,12
22199,58thStGreenway22ndAve,09/10/2016 11:00:00 PM,48,-122,7,4,11
22200,58thStGreenway22ndAve,09/11/2016 12:00:00 AM,48,-122,6,1,7
22201,58thStGreenway22ndAve,09/11/2016 01:00:00 AM,48,-122,2,0,2
22202,58thStGreenway22ndAve,09/11/2016 02:00:00 AM,48,-122,0,0,0
22203,58thStGreenway22ndAve,09/11/2016 03:00:00 AM,48,-122,0,0,0
22204,58thStGreenway22ndAve,09/11/2016 04:00:00 AM,48,-122,0,0,0
22205,58thStGreenway22ndAve,09/11/2016 05:00:00 AM,48,-122,2,0,2
22206,58thStGreenway22ndAve,09/11/2016 06:00:00 AM,48,-122,1,1,2
22207,58thStGreenway22ndAve,09/11/2016 07:00:00 AM,48,-122,2,2,4
22208,58thStGreenway22ndAve,09/11/2016 08:00:00 AM,48,-122,9,1,10
22209,58thStGreenway22ndAve,09/11/2016 09:00:00 AM,48,-122,10,8,18
22210,58thStGreenway22ndAve,09/11/2016 10:00:00 AM,48,-122,27,10,37
22211,58thStGreenway22ndAve,09/11/2016 11:00:00 AM,48,-122,44,9,53
22212,58thStGreenway22ndAve,09/11/2016 12:00:00 PM,48,-122,35,14,49
22213,58thStGreenway22ndAve,09/11/2016 01:00:00 PM,48,-122,44,27,71
22214,58thStGreenway22ndAve,09/11/2016 02:00:00 PM,48,-122,40,17,57
22215,58thStGreenway22ndAve,09/11/2016 03:00:00 PM,48,-122,15,4,19
22216,58thStGreenway22ndAve,09/11/2016 04:00:00 PM,48,-122,21,8,29
22217,58thStGreenway22ndAve,09/11/2016 05:00:00 PM,48,-122,25,3,28
22218,58thStGreenway22ndAve,09/11/2016 06:00:00 PM,48,-122,17,6,23
22219,58thStGreenway22ndAve,09/11/2016 07:00:00 PM,48,-122,10,5,15
22220,58thStGreenway22ndAve,09/11/2016 08:00:00 PM,48,-122,12,4,16
22221,58thStGreenway22ndAve,09/11/2016 09:00:00 PM,48,-122,5,0,5
22222,58thStGreenway22ndAve,09/11/2016 10:00:00 PM,48,-122,2,0,2
22223,58thStGreenway22ndAve,09/11/2016 11:00:00 PM,48,-122,3,2,5
22224,58thStGreenway22ndAve,09/12/2016 12:00:00 AM,48,-122,4,1,5
22225,58thStGreenway22ndAve,09/12/2016 01:00:00 AM,48,-122,2,0,2
22226,58thStGreenway22ndAve,09/12/2016 02:00:00 AM,48,-122,0,0,0
22227,58thStGreenway22ndAve,09/12/2016 03:00:00 AM,48,-122,0,0,0
22228,58thStGreenway22ndAve,09/12/2016 04:00:00 AM,48,-122,0,0,0
22229,58thStGreenway22ndAve,09/12/2016 05:00:00 AM,48,-122,0,1,1
22230,58thStGreenway22ndAve,09/12/2016 06:00:00 AM,48,-122,12,3,15
22231,58thStGreenway22ndAve,09/12/2016 07:00:00 AM,48,-122,26,5,31
22232,58thStGreenway22ndAve,09/12/2016 08:00:00 AM,48,-122,20,6,26
22233,58thStGreenway22ndAve,09/12/2016 09:00:00 AM,48,-122,21,5,26
22234,58thStGreenway22ndAve,09/12/2016 10:00:00 AM,48,-122,11,5,16
22235,58thStGreenway22ndAve,09/12/2016 11:00:00 AM,48,-122,36,5,41
22236,58thStGreenway22ndAve,09/12/2016 12:00:00 PM,48,-122,30,6,36
22237,58thStGreenway22ndAve,09/12/2016 01:00:00 PM,48,-122,33,11,44
22238,58thStGreenway22ndAve,09/12/2016 02:00:00 PM,48,-122,26,4,30
22239,58thStGreenway22ndAve,09/12/2016 03:00:00 PM,48,-122,24,4,28
22240,58thStGreenway22ndAve,09/12/2016 04:00:00 PM,48,-122,33,14,47
22241,58thStGreenway22ndAve,09/12/2016 05:00:00 PM,48,-122,40,9,49
22242,58thStGreenway22ndAve,09/12/2016 06:00:00 PM,48,-122,31,13,44
22243,58thStGreenway22ndAve,09/12/2016 07:00:00 PM,48,-122,29,2,31
22244,58thStGreenway22ndAve,09/12/2016 08:00:00 PM,48,-122,19,4,23
22245,58thStGreenway22ndAve,09/12/2016 09:00:00 PM,48,-122,9,1,10
22246,58thStGreenway22ndAve,09/12/2016 10:00:00 PM,48,-122,8,3,11
22247,58thStGreenway22ndAve,09/12/2016 11:00:00 PM,48,-122,2,1,3
22248,58thStGreenway22ndAve,09/13/2016 12:00:00 AM,48,-122,0,0,0
22249,58thStGreenway22ndAve,09/13/2016 01:00:00 AM,48,-122,0,0,0
22250,58thStGreenway22ndAve,09/13/2016 02:00:00 AM,48,-122,2,0,2
22251,58thStGreenway22ndAve,09/13/2016 03:00:00 AM,48,-122,0,0,0
22252,58thStGreenway22ndAve,09/13/2016 04:00:00 AM,48,-122,0,2,2
22253,58thStGreenway22ndAve,09/13/2016 05:00:00 AM,48,-122,0,2,2
22254,58thStGreenway22ndAve,09/13/2016 06:00:00 AM,48,-122,1,1,2
22255,58thStGreenway22ndAve,09/13/2016 07:00:00 AM,48,-122,22,3,25
22256,58thStGreenway22ndAve,09/13/2016 08:00:00 AM,48,-122,24,13,37
22257,58thStGreenway22ndAve,09/13/2016 09:00:00 AM,48,-122,13,10,23
22258,58thStGreenway22ndAve,09/13/2016 10:00:00 AM,48,-122,17,7,24
22259,58thStGreenway22ndAve,09/13/2016 11:00:00 AM,48,-122,17,15,32
22260,58thStGreenway22ndAve,09/13/2016 12:00:00 PM,48,-122,13,13,26
22261,58thStGreenway22ndAve,09/13/2016 01:00:00 PM,48,-122,40,12,52
22262,58thStGreenway22ndAve,09/13/2016 02:00:00 PM,48,-122,31,9,40
22263,58thStGreenway22ndAve,09/13/2016 03:00:00 PM,48,-122,27,9,36
22264,58thStGreenway22ndAve,09/13/2016 04:00:00 PM,48,-122,20,7,27
22265,58thStGreenway22ndAve,09/13/2016 05:00:00 PM,48,-122,41,13,54
22266,58thStGreenway22ndAve,09/13/2016 06:00:00 PM,48,-122,14,6,20
22267,58thStGreenway22ndAve,09/13/2016 07:00:00 PM,48,-122,13,13,26
22268,58thStGreenway22ndAve,09/13/2016 08:00:00 PM,48,-122,18,4,22
22269,58thStGreenway22ndAve,09/13/2016 09:00:00 PM,48,-122,18,1,19
22270,58thStGreenway22ndAve,09/13/2016 10:00:00 PM,48,-122,2,1,3
22271,58thStGreenway22ndAve,09/13/2016 11:00:00 PM,48,-122,2,1,3
22272,58thStGreenway22ndAve,09/14/2016 12:00:00 AM,48,-122,1,0,1
22273,58thStGreenway22ndAve,09/14/2016 01:00:00 AM,48,-122,0,0,0
22274,58thStGreenway22ndAve,09/14/2016 02:00:00 AM,48,-122,4,0,4
22275,58thStGreenway22ndAve,09/14/2016 03:00:00 AM,48,-122,0,0,0
22276,58thStGreenway22ndAve,09/14/2016 04:00:00 AM,48,-122,0,2,2
22277,58thStGreenway22ndAve,09/14/2016 05:00:00 AM,48,-122,2,3,5
22278,58thStGreenway22ndAve,09/14/2016 06:00:00 AM,48,-122,10,1,11
22279,58thStGreenway22ndAve,09/14/2016 07:00:00 AM,48,-122,22,6,28
22280,58thStGreenway22ndAve,09/14/2016 08:00:00 AM,48,-122,19,9,28
22281,58thStGreenway22ndAve,09/14/2016 09:00:00 AM,48,-122,9,8,17
22282,58thStGreenway22ndAve,09/14/2016 10:00:00 AM,48,-122,9,7,16
22283,58thStGreenway22ndAve,09/14/2016 11:00:00 AM,48,-122,22,9,31
22284,58thStGreenway22ndAve,09/14/2016 12:00:00 PM,48,-122,32,6,38
22285,58thStGreenway22ndAve,09/14/2016 01:00:00 PM,48,-122,20,8,28
22286,58thStGreenway22ndAve,09/14/2016 02:00:00 PM,48,-122,21,8,29
22287,58thStGreenway22ndAve,09/14/2016 03:00:00 PM,48,-122,32,7,39
22288,58thStGreenway22ndAve,09/14/2016 04:00:00 PM,48,-122,12,14,26
22289,58thStGreenway22ndAve,09/14/2016 05:00:00 PM,48,-122,26,7,33
22290,58thStGreenway22ndAve,09/14/2016 06:00:00 PM,48,-122,29,16,45
22291,58thStGreenway22ndAve,09/14/2016 07:00:00 PM,48,-122,19,10,29
22292,58thStGreenway22ndAve,09/14/2016 08:00:00 PM,48,-122,8,8,16
22293,58thStGreenway22ndAve,09/14/2016 09:00:00 PM,48,-122,6,4,10
22294,58thStGreenway22ndAve,09/14/2016 10:00:00 PM,48,-122,3,0,3
22295,58thStGreenway22ndAve,09/14/2016 11:00:00 PM,48,-122,3,2,5
22296,58thStGreenway22ndAve,09/15/2016 12:00:00 AM,48,-122,0,2,2
22297,58thStGreenway22ndAve,09/15/2016 01:00:00 AM,48,-122,0,1,1
22298,58thStGreenway22ndAve,09/15/2016 02:00:00 AM,48,-122,0,0,0
22299,58thStGreenway22ndAve,09/15/2016 03:00:00 AM,48,-122,0,0,0
22300,58thStGreenway22ndAve,09/15/2016 04:00:00 AM,48,-122,0,1,1
22301,58thStGreenway22ndAve,09/15/2016 05:00:00 AM,48,-122,0,2,2
22302,58thStGreenway22ndAve,09/15/2016 06:00:00 AM,48,-122,8,3,11
22303,58thStGreenway22ndAve,09/15/2016 07:00:00 AM,48,-122,26,2,28
22304,58thStGreenway22ndAve,09/15/2016 08:00:00 AM,48,-122,26,8,34
22305,58thStGreenway22ndAve,09/15/2016 09:00:00 AM,48,-122,34,5,39
22306,58thStGreenway22ndAve,09/15/2016 10:00:00 AM,48,-122,30,7,37
22307,58thStGreenway22ndAve,09/15/2016 11:00:00 AM,48,-122,10,7,17
22308,58thStGreenway22ndAve,09/15/2016 12:00:00 PM,48,-122,1,1,2
22309,58thStGreenway22ndAve,09/15/2016 01:00:00 PM,48,-122,4,3,7
22310,58thStGreenway22ndAve,09/15/2016 02:00:00 PM,48,-122,4,4,8
22311,58thStGreenway22ndAve,09/15/2016 03:00:00 PM,48,-122,4,6,10
22312,58thStGreenway22ndAve,09/15/2016 04:00:00 PM,48,-122,5,7,12
22313,58thStGreenway22ndAve,09/15/2016 05:00:00 PM,48,-122,12,10,22
22314,58thStGreenway22ndAve,09/15/2016 06:00:00 PM,48,-122,9,11,20
22315,58thStGreenway22ndAve,09/15/2016 07:00:00 PM,48,-122,6,5,11
22316,58thStGreenway22ndAve,09/15/2016 08:00:00 PM,48,-122,3,3,6
22317,58thStGreenway22ndAve,09/15/2016 09:00:00 PM,48,-122,1,4,5
22318,58thStGreenway22ndAve,09/15/2016 10:00:00 PM,48,-122,1,0,1
22319,58thStGreenway22ndAve,09/15/2016 11:00:00 PM,48,-122,1,1,2
22320,58thStGreenway22ndAve,09/16/2016 12:00:00 AM,48,-122,0,0,0
22321,58thStGreenway22ndAve,09/16/2016 01:00:00 AM,48,-122,0,0,0
22322,58thStGreenway22ndAve,09/16/2016 02:00:00 AM,48,-122,0,0,0
22323,58thStGreenway22ndAve,09/16/2016 03:00:00 AM,48,-122,0,0,0
22324,58thStGreenway22ndAve,09/16/2016 04:00:00 AM,48,-122,0,0,0
22325,58thStGreenway22ndAve,09/16/2016 05:00:00 AM,48,-122,1,1,2
22326,58thStGreenway22ndAve,09/16/2016 06:00:00 AM,48,-122,1,2,3
22327,58thStGreenway22ndAve,09/16/2016 07:00:00 AM,48,-122,5,6,11
22328,58thStGreenway22ndAve,09/16/2016 08:00:00 AM,48,-122,8,5,13
22329,58thStGreenway22ndAve,09/16/2016 09:00:00 AM,48,-122,6,4,10
22330,58thStGreenway22ndAve,09/16/2016 10:00:00 AM,48,-122,1,17,18
22331,58thStGreenway22ndAve,09/16/2016 11:00:00 AM,48,-122,1,2,3
22332,58thStGreenway22ndAve,09/16/2016 12:00:00 PM,48,-122,2,3,5
22333,58thStGreenway22ndAve,09/16/2016 01:00:00 PM,48,-122,5,4,9
22334,58thStGreenway22ndAve,09/16/2016 02:00:00 PM,48,-122,15,5,20
22335,58thStGreenway22ndAve,09/16/2016 03:00:00 PM,48,-122,7,6,13
22336,58thStGreenway22ndAve,09/16/2016 04:00:00 PM,48,-122,6,6,12
22337,58thStGreenway22ndAve,09/16/2016 05:00:00 PM,48,-122,6,7,13
22338,58thStGreenway22ndAve,09/16/2016 06:00:00 PM,48,-122,4,3,7
22339,58thStGreenway22ndAve,09/16/2016 07:00:00 PM,48,-122,3,7,10
22340,58thStGreenway22ndAve,09/16/2016 08:00:00 PM,48,-122,2,2,4
22341,58thStGreenway22ndAve,09/16/2016 09:00:00 PM,48,-122,0,2,2
22342,58thStGreenway22ndAve,09/16/2016 10:00:00 PM,48,-122,0,3,3
22343,58thStGreenway22ndAve,09/16/2016 11:00:00 PM,48,-122,0,1,1
22344,58thStGreenway22ndAve,09/17/2016 12:00:00 AM,48,-122,0,1,1
22345,58thStGreenway22ndAve,09/17/2016 01:00:00 AM,48,-122,0,1,1
22346,58thStGreenway22ndAve,09/17/2016 02:00:00 AM,48,-122,0,1,1
22347,58thStGreenway22ndAve,09/17/2016 03:00:00 AM,48,-122,1,0,1
22348,58thStGreenway22ndAve,09/17/2016 04:00:00 AM,48,-122,0,0,0
22349,58thStGreenway22ndAve,09/17/2016 05:00:00 AM,48,-122,0,0,0
22350,58thStGreenway22ndAve,09/17/2016 06:00:00 AM,48,-122,0,1,1
22351,58thStGreenway22ndAve,09/17/2016 07:00:00 AM,48,-122,0,3,3
22352,58thStGreenway22ndAve,09/17/2016 08:00:00 AM,48,-122,1,3,4
22353,58thStGreenway22ndAve,09/17/2016 09:00:00 AM,48,-122,1,3,4
22354,58thStGreenway22ndAve,09/17/2016 10:00:00 AM,48,-122,1,9,10
22355,58thStGreenway22ndAve,09/17/2016 11:00:00 AM,48,-122,5,3,8
22356,58thStGreenway22ndAve,09/17/2016 12:00:00 PM,48,-122,5,4,9
22357,58thStGreenway22ndAve,09/17/2016 01:00:00 PM,48,-122,3,7,10
22358,58thStGreenway22ndAve,09/17/2016 02:00:00 PM,48,-122,4,7,11
22359,58thStGreenway22ndAve,09/17/2016 03:00:00 PM,48,-122,2,7,9
22360,58thStGreenway22ndAve,09/17/2016 04:00:00 PM,48,-122,5,5,10
22361,58thStGreenway22ndAve,09/17/2016 05:00:00 PM,48,-122,4,6,10
22362,58thStGreenway22ndAve,09/17/2016 06:00:00 PM,48,-122,2,4,6
22363,58thStGreenway22ndAve,09/17/2016 07:00:00 PM,48,-122,5,2,7
22364,58thStGreenway22ndAve,09/17/2016 08:00:00 PM,48,-122,0,2,2
22365,58thStGreenway22ndAve,09/17/2016 09:00:00 PM,48,-122,1,3,4
22366,58thStGreenway22ndAve,09/17/2016 10:00:00 PM,48,-122,0,1,1
22367,58thStGreenway22ndAve,09/17/2016 11:00:00 PM,48,-122,1,0,1
22368,58thStGreenway22ndAve,09/18/2016 12:00:00 AM,48,-122,2,0,2
22369,58thStGreenway22ndAve,09/18/2016 01:00:00 AM,48,-122,0,1,1
22370,58thStGreenway22ndAve,09/18/2016 02:00:00 AM,48,-122,1,0,1
22371,58thStGreenway22ndAve,09/18/2016 03:00:00 AM,48,-122,0,0,0
22372,58thStGreenway22ndAve,09/18/2016 04:00:00 AM,48,-122,0,1,1
22373,58thStGreenway22ndAve,09/18/2016 05:00:00 AM,48,-122,0,0,0
22374,58thStGreenway22ndAve,09/18/2016 06:00:00 AM,48,-122,1,1,2
22375,58thStGreenway22ndAve,09/18/2016 07:00:00 AM,48,-122,0,3,3
22376,58thStGreenway22ndAve,09/18/2016 08:00:00 AM,48,-122,3,1,4
22377,58thStGreenway22ndAve,09/18/2016 09:00:00 AM,48,-122,2,6,8
22378,58thStGreenway22ndAve,09/18/2016 10:00:00 AM,48,-122,3,19,22
22379,58thStGreenway22ndAve,09/18/2016 11:00:00 AM,48,-122,6,6,12
22380,58thStGreenway22ndAve,09/18/2016 12:00:00 PM,48,-122,9,9,18
22381,58thStGreenway22ndAve,09/18/2016 01:00:00 PM,48,-122,7,12,19
22382,58thStGreenway22ndAve,09/18/2016 02:00:00 PM,48,-122,8,11,19
22383,58thStGreenway22ndAve,09/18/2016 03:00:00 PM,48,-122,10,14,24
22384,58thStGreenway22ndAve,09/18/2016 04:00:00 PM,48,-122,13,10,23
22385,58thStGreenway22ndAve,09/18/2016 05:00:00 PM,48,-122,6,7,13
22386,58thStGreenway22ndAve,09/18/2016 06:00:00 PM,48,-122,3,5,8
22387,58thStGreenway22ndAve,09/18/2016 07:00:00 PM,48,-122,3,3,6
22388,58thStGreenway22ndAve,09/18/2016 08:00:00 PM,48,-122,0,3,3
22389,58thStGreenway22ndAve,09/18/2016 09:00:00 PM,48,-122,2,3,5
22390,58thStGreenway22ndAve,09/18/2016 10:00:00 PM,48,-122,0,1,1
22391,58thStGreenway22ndAve,09/18/2016 11:00:00 PM,48,-122,1,0,1
22392,58thStGreenway22ndAve,09/19/2016 12:00:00 AM,48,-122,0,0,0
22393,58thStGreenway22ndAve,09/19/2016 01:00:00 AM,48,-122,0,0,0
22394,58thStGreenway22ndAve,09/19/2016 02:00:00 AM,48,-122,0,1,1
22395,58thStGreenway22ndAve,09/19/2016 03:00:00 AM,48,-122,0,0,0
22396,58thStGreenway22ndAve,09/19/2016 04:00:00 AM,48,-122,0,0,0
22397,58thStGreenway22ndAve,09/19/2016 05:00:00 AM,48,-122,0,3,3
22398,58thStGreenway22ndAve,09/19/2016 06:00:00 AM,48,-122,0,0,0
22399,58thStGreenway22ndAve,09/19/2016 07:00:00 AM,48,-122,4,7,11
22400,58thStGreenway22ndAve,09/19/2016 08:00:00 AM,48,-122,5,6,11
22401,58thStGreenway22ndAve,09/19/2016 09:00:00 AM,48,-122,5,3,8
22402,58thStGreenway22ndAve,09/19/2016 10:00:00 AM,48,-122,2,3,5
22403,58thStGreenway22ndAve,09/19/2016 11:00:00 AM,48,-122,5,3,8
22404,58thStGreenway22ndAve,09/19/2016 12:00:00 PM,48,-122,4,6,10
22405,58thStGreenway22ndAve,09/19/2016 01:00:00 PM,48,-122,3,7,10
22406,58thStGreenway22ndAve,09/19/2016 02:00:00 PM,48,-122,2,6,8
22407,58thStGreenway22ndAve,09/19/2016 03:00:00 PM,48,-122,2,4,6
22408,58thStGreenway22ndAve,09/19/2016 04:00:00 PM,48,-122,7,3,10
22409,58thStGreenway22ndAve,09/19/2016 05:00:00 PM,48,-122,4,10,14
22410,58thStGreenway22ndAve,09/19/2016 06:00:00 PM,48,-122,8,11,19
22411,58thStGreenway22ndAve,09/19/2016 07:00:00 PM,48,-122,4,7,11
22412,58thStGreenway22ndAve,09/19/2016 08:00:00 PM,48,-122,4,2,6
22413,58thStGreenway22ndAve,09/19/2016 09:00:00 PM,48,-122,1,0,1
22414,58thStGreenway22ndAve,09/19/2016 10:00:00 PM,48,-122,0,0,0
22415,58thStGreenway22ndAve,09/19/2016 11:00:00 PM,48,-122,1,0,1
22416,58thStGreenway22ndAve,09/20/2016 12:00:00 AM,48,-122,1,0,1
22417,58thStGreenway22ndAve,09/20/2016 01:00:00 AM,48,-122,0,0,0
22418,58thStGreenway22ndAve,09/20/2016 02:00:00 AM,48,-122,0,0,0
22419,58thStGreenway22ndAve,09/20/2016 03:00:00 AM,48,-122,0,0,0
22420,58thStGreenway22ndAve,09/20/2016 04:00:00 AM,48,-122,0,0,0
22421,58thStGreenway22ndAve,09/20/2016 05:00:00 AM,48,-122,0,1,1
22422,58thStGreenway22ndAve,09/20/2016 06:00:00 AM,48,-122,1,1,2
22423,58thStGreenway22ndAve,09/20/2016 07:00:00 AM,48,-122,5,7,12
22424,58thStGreenway22ndAve,09/20/2016 08:00:00 AM,48,-122,7,8,15
22425,58thStGreenway22ndAve,09/20/2016 09:00:00 AM,48,-122,3,9,12
22426,58thStGreenway22ndAve,09/20/2016 10:00:00 AM,48,-122,0,2,2
22427,58thStGreenway22ndAve,09/20/2016 11:00:00 AM,48,-122,3,7,10
22428,58thStGreenway22ndAve,09/20/2016 12:00:00 PM,48,-122,3,2,5
22429,58thStGreenway22ndAve,09/20/2016 01:00:00 PM,48,-122,3,3,6
22430,58thStGreenway22ndAve,09/20/2016 02:00:00 PM,48,-122,5,4,9
22431,58thStGreenway22ndAve,09/20/2016 03:00:00 PM,48,-122,4,6,10
22432,58thStGreenway22ndAve,09/20/2016 04:00:00 PM,48,-122,8,4,12
22433,58thStGreenway22ndAve,09/20/2016 05:00:00 PM,48,-122,15,7,22
22434,58thStGreenway22ndAve,09/20/2016 06:00:00 PM,48,-122,6,18,24
22435,58thStGreenway22ndAve,09/20/2016 07:00:00 PM,48,-122,7,5,12
22436,58thStGreenway22ndAve,09/20/2016 08:00:00 PM,48,-122,1,2,3
22437,58thStGreenway22ndAve,09/20/2016 09:00:00 PM,48,-122,1,1,2
22438,58thStGreenway22ndAve,09/20/2016 10:00:00 PM,48,-122,1,0,1
22439,58thStGreenway22ndAve,09/20/2016 11:00:00 PM,48,-122,1,1,2
22440,58thStGreenway22ndAve,09/21/2016 12:00:00 AM,48,-122,0,0,0
22441,58thStGreenway22ndAve,09/21/2016 01:00:00 AM,48,-122,0,0,0
22442,58thStGreenway22ndAve,09/21/2016 02:00:00 AM,48,-122,0,0,0
22443,58thStGreenway22ndAve,09/21/2016 03:00:00 AM,48,-122,0,0,0
22444,58thStGreenway22ndAve,09/21/2016 04:00:00 AM,48,-122,1,0,1
22445,58thStGreenway22ndAve,09/21/2016 05:00:00 AM,48,-122,1,2,3
22446,58thStGreenway22ndAve,09/21/2016 06:00:00 AM,48,-122,0,2,2
22447,58thStGreenway22ndAve,09/21/2016 07:00:00 AM,48,-122,7,6,13
22448,58thStGreenway22ndAve,09/21/2016 08:00:00 AM,48,-122,4,8,12
22449,58thStGreenway22ndAve,09/21/2016 09:00:00 AM,48,-122,4,4,8
22450,58thStGreenway22ndAve,09/21/2016 10:00:00 AM,48,-122,3,4,7
22451,58thStGreenway22ndAve,09/21/2016 11:00:00 AM,48,-122,1,6,7
22452,58thStGreenway22ndAve,09/21/2016 12:00:00 PM,48,-122,2,5,7
22453,58thStGreenway22ndAve,09/21/2016 01:00:00 PM,48,-122,5,6,11
22454,58thStGreenway22ndAve,09/21/2016 02:00:00 PM,48,-122,2,2,4
22455,58thStGreenway22ndAve,09/21/2016 03:00:00 PM,48,-122,5,6,11
22456,58thStGreenway22ndAve,09/21/2016 04:00:00 PM,48,-122,7,3,10
22457,58thStGreenway22ndAve,09/21/2016 05:00:00 PM,48,-122,4,9,13
22458,58thStGreenway22ndAve,09/21/2016 06:00:00 PM,48,-122,7,6,13
22459,58thStGreenway22ndAve,09/21/2016 07:00:00 PM,48,-122,2,6,8
22460,58thStGreenway22ndAve,09/21/2016 08:00:00 PM,48,-122,0,3,3
22461,58thStGreenway22ndAve,09/21/2016 09:00:00 PM,48,-122,2,4,6
22462,58thStGreenway22ndAve,09/21/2016 10:00:00 PM,48,-122,3,2,5
22463,58thStGreenway22ndAve,09/21/2016 11:00:00 PM,48,-122,0,2,2
22464,58thStGreenway22ndAve,09/22/2016 12:00:00 AM,48,-122,0,0,0
22465,58thStGreenway22ndAve,09/22/2016 01:00:00 AM,48,-122,0,0,0
22466,58thStGreenway22ndAve,09/22/2016 02:00:00 AM,48,-122,0,0,0
22467,58thStGreenway22ndAve,09/22/2016 03:00:00 AM,48,-122,0,0,0
22468,58thStGreenway22ndAve,09/22/2016 04:00:00 AM,48,-122,0,0,0
22469,58thStGreenway22ndAve,09/22/2016 05:00:00 AM,48,-122,0,2,2
22470,58thStGreenway22ndAve,09/22/2016 06:00:00 AM,48,-122,2,1,3
22471,58thStGreenway22ndAve,09/22/2016 07:00:00 AM,48,-122,3,3,6
22472,58thStGreenway22ndAve,09/22/2016 08:00:00 AM,48,-122,6,4,10
22473,58thStGreenway22ndAve,09/22/2016 09:00:00 AM,48,-122,5,8,13
22474,58thStGreenway22ndAve,09/22/2016 10:00:00 AM,48,-122,2,5,7
22475,58thStGreenway22ndAve,09/22/2016 11:00:00 AM,48,-122,3,4,7
22476,58thStGreenway22ndAve,09/22/2016 12:00:00 PM,48,-122,7,8,15
22477,58thStGreenway22ndAve,09/22/2016 01:00:00 PM,48,-122,4,3,7
22478,58thStGreenway22ndAve,09/22/2016 02:00:00 PM,48,-122,3,5,8
22479,58thStGreenway22ndAve,09/22/2016 03:00:00 PM,48,-122,2,4,6
22480,58thStGreenway22ndAve,09/22/2016 04:00:00 PM,48,-122,5,10,15
22481,58thStGreenway22ndAve,09/22/2016 05:00:00 PM,48,-122,17,8,25
22482,58thStGreenway22ndAve,09/22/2016 06:00:00 PM,48,-122,4,11,15
22483,58thStGreenway22ndAve,09/22/2016 07:00:00 PM,48,-122,4,5,9
22484,58thStGreenway22ndAve,09/22/2016 08:00:00 PM,48,-122,4,0,4
22485,58thStGreenway22ndAve,09/22/2016 09:00:00 PM,48,-122,1,1,2
22486,58thStGreenway22ndAve,09/22/2016 10:00:00 PM,48,-122,0,2,2
22487,58thStGreenway22ndAve,09/22/2016 11:00:00 PM,48,-122,0,1,1
22488,58thStGreenway22ndAve,09/23/2016 12:00:00 AM,48,-122,0,1,1
22489,58thStGreenway22ndAve,09/23/2016 01:00:00 AM,48,-122,0,0,0
22490,58thStGreenway22ndAve,09/23/2016 02:00:00 AM,48,-122,0,0,0
22491,58thStGreenway22ndAve,09/23/2016 03:00:00 AM,48,-122,0,2,2
22492,58thStGreenway22ndAve,09/23/2016 04:00:00 AM,48,-122,0,1,1
22493,58thStGreenway22ndAve,09/23/2016 05:00:00 AM,48,-122,0,1,1
22494,58thStGreenway22ndAve,09/23/2016 06:00:00 AM,48,-122,0,2,2
22495,58thStGreenway22ndAve,09/23/2016 07:00:00 AM,48,-122,3,6,9
22496,58thStGreenway22ndAve,09/23/2016 08:00:00 AM,48,-122,4,5,9
22497,58thStGreenway22ndAve,09/23/2016 09:00:00 AM,48,-122,1,6,7
22498,58thStGreenway22ndAve,09/23/2016 10:00:00 AM,48,-122,2,7,9
22499,58thStGreenway22ndAve,09/23/2016 11:00:00 AM,48,-122,1,10,11
22500,58thStGreenway22ndAve,09/23/2016 12:00:00 PM,48,-122,3,2,5
22501,58thStGreenway22ndAve,09/23/2016 01:00:00 PM,48,-122,3,4,7
22502,58thStGreenway22ndAve,09/23/2016 02:00:00 PM,48,-122,3,3,6
22503,58thStGreenway22ndAve,09/23/2016 03:00:00 PM,48,-122,2,1,3
22504,58thStGreenway22ndAve,09/23/2016 04:00:00 PM,48,-122,4,4,8
22505,58thStGreenway22ndAve,09/23/2016 05:00:00 PM,48,-122,3,11,14
22506,58thStGreenway22ndAve,09/23/2016 06:00:00 PM,48,-122,0,8,8
22507,58thStGreenway22ndAve,09/23/2016 07:00:00 PM,48,-122,1,10,11
22508,58thStGreenway22ndAve,09/23/2016 08:00:00 PM,48,-122,3,0,3
22509,58thStGreenway22ndAve,09/23/2016 09:00:00 PM,48,-122,1,1,2
22510,58thStGreenway22ndAve,09/23/2016 10:00:00 PM,48,-122,0,3,3
22511,58thStGreenway22ndAve,09/23/2016 11:00:00 PM,48,-122,0,0,0
22512,58thStGreenway22ndAve,09/24/2016 12:00:00 AM,48,-122,1,1,2
22513,58thStGreenway22ndAve,09/24/2016 01:00:00 AM,48,-122,1,1,2
22514,58thStGreenway22ndAve,09/24/2016 02:00:00 AM,48,-122,1,0,1
22515,58thStGreenway22ndAve,09/24/2016 03:00:00 AM,48,-122,0,1,1
22516,58thStGreenway22ndAve,09/24/2016 04:00:00 AM,48,-122,0,0,0
22517,58thStGreenway22ndAve,09/24/2016 05:00:00 AM,48,-122,0,1,1
22518,58thStGreenway22ndAve,09/24/2016 06:00:00 AM,48,-122,1,0,1
22519,58thStGreenway22ndAve,09/24/2016 07:00:00 AM,48,-122,0,1,1
22520,58thStGreenway22ndAve,09/24/2016 08:00:00 AM,48,-122,2,4,6
22521,58thStGreenway22ndAve,09/24/2016 09:00:00 AM,48,-122,4,2,6
22522,58thStGreenway22ndAve,09/24/2016 10:00:00 AM,48,-122,1,8,9
22523,58thStGreenway22ndAve,09/24/2016 11:00:00 AM,48,-122,5,5,10
22524,58thStGreenway22ndAve,09/24/2016 12:00:00 PM,48,-122,12,4,16
22525,58thStGreenway22ndAve,09/24/2016 01:00:00 PM,48,-122,3,8,11
22526,58thStGreenway22ndAve,09/24/2016 02:00:00 PM,48,-122,5,9,14
22527,58thStGreenway22ndAve,09/24/2016 03:00:00 PM,48,-122,3,6,9
22528,58thStGreenway22ndAve,09/24/2016 04:00:00 PM,48,-122,9,13,22
22529,58thStGreenway22ndAve,09/24/2016 05:00:00 PM,48,-122,7,3,10
22530,58thStGreenway22ndAve,09/24/2016 06:00:00 PM,48,-122,5,12,17
22531,58thStGreenway22ndAve,09/24/2016 07:00:00 PM,48,-122,6,3,9
22532,58thStGreenway22ndAve,09/24/2016 08:00:00 PM,48,-122,1,2,3
22533,58thStGreenway22ndAve,09/24/2016 09:00:00 PM,48,-122,3,3,6
22534,58thStGreenway22ndAve,09/24/2016 10:00:00 PM,48,-122,1,2,3
22535,58thStGreenway22ndAve,09/24/2016 11:00:00 PM,48,-122,0,1,1
22536,58thStGreenway22ndAve,09/25/2016 12:00:00 AM,48,-122,0,0,0
22537,58thStGreenway22ndAve,09/25/2016 01:00:00 AM,48,-122,0,0,0
22538,58thStGreenway22ndAve,09/25/2016 02:00:00 AM,48,-122,0,0,0
22539,58thStGreenway22ndAve,09/25/2016 03:00:00 AM,48,-122,0,1,1
22540,58thStGreenway22ndAve,09/25/2016 04:00:00 AM,48,-122,0,0,0
22541,58thStGreenway22ndAve,09/25/2016 05:00:00 AM,48,-122,0,0,0
22542,58thStGreenway22ndAve,09/25/2016 06:00:00 AM,48,-122,1,0,1
22543,58thStGreenway22ndAve,09/25/2016 07:00:00 AM,48,-122,1,2,3
22544,58thStGreenway22ndAve,09/25/2016 08:00:00 AM,48,-122,0,2,2
22545,58thStGreenway22ndAve,09/25/2016 09:00:00 AM,48,-122,6,4,10
22546,58thStGreenway22ndAve,09/25/2016 10:00:00 AM,48,-122,2,5,7
22547,58thStGreenway22ndAve,09/25/2016 11:00:00 AM,48,-122,8,9,17
22548,58thStGreenway22ndAve,09/25/2016 12:00:00 PM,48,-122,4,6,10
22549,58thStGreenway22ndAve,09/25/2016 01:00:00 PM,48,-122,9,13,22
22550,58thStGreenway22ndAve,09/25/2016 02:00:00 PM,48,-122,4,9,13
22551,58thStGreenway22ndAve,09/25/2016 03:00:00 PM,48,-122,7,7,14
22552,58thStGreenway22ndAve,09/25/2016 04:00:00 PM,48,-122,6,10,16
22553,58thStGreenway22ndAve,09/25/2016 05:00:00 PM,48,-122,3,6,9
22554,58thStGreenway22ndAve,09/25/2016 06:00:00 PM,48,-122,8,2,10
22555,58thStGreenway22ndAve,09/25/2016 07:00:00 PM,48,-122,2,8,10
22556,58thStGreenway22ndAve,09/25/2016 08:00:00 PM,48,-122,4,2,6
22557,58thStGreenway22ndAve,09/25/2016 09:00:00 PM,48,-122,1,0,1
22558,58thStGreenway22ndAve,09/25/2016 10:00:00 PM,48,-122,2,1,3
22559,58thStGreenway22ndAve,09/25/2016 11:00:00 PM,48,-122,1,1,2
22560,58thStGreenway22ndAve,09/26/2016 12:00:00 AM,48,-122,0,0,0
22561,58thStGreenway22ndAve,09/26/2016 01:00:00 AM,48,-122,0,0,0
22562,58thStGreenway22ndAve,09/26/2016 02:00:00 AM,48,-122,0,0,0
22563,58thStGreenway22ndAve,09/26/2016 03:00:00 AM,48,-122,0,0,0
22564,58thStGreenway22ndAve,09/26/2016 04:00:00 AM,48,-122,0,0,0
22565,58thStGreenway22ndAve,09/26/2016 05:00:00 AM,48,-122,0,1,1
22566,58thStGreenway22ndAve,09/26/2016 06:00:00 AM,48,-122,2,3,5
22567,58thStGreenway22ndAve,09/26/2016 07:00:00 AM,48,-122,3,3,6
22568,58thStGreenway22ndAve,09/26/2016 08:00:00 AM,48,-122,5,8,13
22569,58thStGreenway22ndAve,09/26/2016 09:00:00 AM,48,-122,4,9,13
22570,58thStGreenway22ndAve,09/26/2016 10:00:00 AM,48,-122,6,6,12
22571,58thStGreenway22ndAve,09/26/2016 11:00:00 AM,48,-122,4,6,10
22572,58thStGreenway22ndAve,09/26/2016 12:00:00 PM,48,-122,0,8,8
22573,58thStGreenway22ndAve,09/26/2016 01:00:00 PM,48,-122,6,10,16
22574,58thStGreenway22ndAve,09/26/2016 02:00:00 PM,48,-122,9,5,14
22575,58thStGreenway22ndAve,09/26/2016 03:00:00 PM,48,-122,8,10,18
22576,58thStGreenway22ndAve,09/26/2016 04:00:00 PM,48,-122,7,5,12
22577,58thStGreenway22ndAve,09/26/2016 05:00:00 PM,48,-122,16,8,24
22578,58thStGreenway22ndAve,09/26/2016 06:00:00 PM,48,-122,9,13,22
22579,58thStGreenway22ndAve,09/26/2016 07:00:00 PM,48,-122,4,0,4
22580,58thStGreenway22ndAve,09/26/2016 08:00:00 PM,48,-122,5,6,11
22581,58thStGreenway22ndAve,09/26/2016 09:00:00 PM,48,-122,0,4,4
22582,58thStGreenway22ndAve,09/26/2016 10:00:00 PM,48,-122,1,1,2
22583,58thStGreenway22ndAve,09/26/2016 11:00:00 PM,48,-122,0,1,1
22584,58thStGreenway22ndAve,09/27/2016 12:00:00 AM,48,-122,1,1,2
22585,58thStGreenway22ndAve,09/27/2016 01:00:00 AM,48,-122,0,0,0
22586,58thStGreenway22ndAve,09/27/2016 02:00:00 AM,48,-122,0,0,0
22587,58thStGreenway22ndAve,09/27/2016 03:00:00 AM,48,-122,0,0,0
22588,58thStGreenway22ndAve,09/27/2016 04:00:00 AM,48,-122,0,0,0
22589,58thStGreenway22ndAve,09/27/2016 05:00:00 AM,48,-122,1,3,4
22590,58thStGreenway22ndAve,09/27/2016 06:00:00 AM,48,-122,2,0,2
22591,58thStGreenway22ndAve,09/27/2016 07:00:00 AM,48,-122,3,2,5
22592,58thStGreenway22ndAve,09/27/2016 08:00:00 AM,48,-122,5,6,11
22593,58thStGreenway22ndAve,09/27/2016 09:00:00 AM,48,-122,2,5,7
22594,58thStGreenway22ndAve,09/27/2016 10:00:00 AM,48,-122,2,10,12
22595,58thStGreenway22ndAve,09/27/2016 11:00:00 AM,48,-122,5,2,7
22596,58thStGreenway22ndAve,09/27/2016 12:00:00 PM,48,-122,3,5,8
22597,58thStGreenway22ndAve,09/27/2016 01:00:00 PM,48,-122,3,9,12
22598,58thStGreenway22ndAve,09/27/2016 02:00:00 PM,48,-122,4,2,6
22599,58thStGreenway22ndAve,09/27/2016 03:00:00 PM,48,-122,6,5,11
22600,58thStGreenway22ndAve,09/27/2016 04:00:00 PM,48,-122,6,9,15
22601,58thStGreenway22ndAve,09/27/2016 05:00:00 PM,48,-122,12,12,24
22602,58thStGreenway22ndAve,09/27/2016 06:00:00 PM,48,-122,7,6,13
22603,58thStGreenway22ndAve,09/27/2016 07:00:00 PM,48,-122,5,1,6
22604,58thStGreenway22ndAve,09/27/2016 08:00:00 PM,48,-122,2,6,8
22605,58thStGreenway22ndAve,09/27/2016 09:00:00 PM,48,-122,3,2,5
22606,58thStGreenway22ndAve,09/27/2016 10:00:00 PM,48,-122,2,1,3
22607,58thStGreenway22ndAve,09/27/2016 11:00:00 PM,48,-122,0,0,0
22608,58thStGreenway22ndAve,09/28/2016 12:00:00 AM,48,-122,0,0,0
22609,58thStGreenway22ndAve,09/28/2016 01:00:00 AM,48,-122,1,0,1
22610,58thStGreenway22ndAve,09/28/2016 02:00:00 AM,48,-122,0,0,0
22611,58thStGreenway22ndAve,09/28/2016 03:00:00 AM,48,-122,0,0,0
22612,58thStGreenway22ndAve,09/28/2016 04:00:00 AM,48,-122,0,0,0
22613,58thStGreenway22ndAve,09/28/2016 05:00:00 AM,48,-122,0,1,1
22614,58thStGreenway22ndAve,09/28/2016 06:00:00 AM,48,-122,1,1,2
22615,58thStGreenway22ndAve,09/28/2016 07:00:00 AM,48,-122,3,2,5
22616,58thStGreenway22ndAve,09/28/2016 08:00:00 AM,48,-122,4,6,10
22617,58thStGreenway22ndAve,09/28/2016 09:00:00 AM,48,-122,5,5,10
22618,58thStGreenway22ndAve,09/28/2016 10:00:00 AM,48,-122,1,7,8
22619,58thStGreenway22ndAve,09/28/2016 11:00:00 AM,48,-122,2,4,6
22620,58thStGreenway22ndAve,09/28/2016 12:00:00 PM,48,-122,1,4,5
22621,58thStGreenway22ndAve,09/28/2016 01:00:00 PM,48,-122,6,5,11
22622,58thStGreenway22ndAve,09/28/2016 02:00:00 PM,48,-122,2,9,11
22623,58thStGreenway22ndAve,09/28/2016 03:00:00 PM,48,-122,4,4,8
22624,58thStGreenway22ndAve,09/28/2016 04:00:00 PM,48,-122,7,6,13
22625,58thStGreenway22ndAve,09/28/2016 05:00:00 PM,48,-122,16,6,22
22626,58thStGreenway22ndAve,09/28/2016 06:00:00 PM,48,-122,8,12,20
22627,58thStGreenway22ndAve,09/28/2016 07:00:00 PM,48,-122,3,5,8
22628,58thStGreenway22ndAve,09/28/2016 08:00:00 PM,48,-122,7,4,11
22629,58thStGreenway22ndAve,09/28/2016 09:00:00 PM,48,-122,2,3,5
22630,58thStGreenway22ndAve,09/28/2016 10:00:00 PM,48,-122,0,0,0
22631,58thStGreenway22ndAve,09/28/2016 11:00:00 PM,48,-122,1,0,1
22632,58thStGreenway22ndAve,09/29/2016 12:00:00 AM,48,-122,0,0,0
22633,58thStGreenway22ndAve,09/29/2016 01:00:00 AM,48,-122,0,0,0
22634,58thStGreenway22ndAve,09/29/2016 02:00:00 AM,48,-122,0,1,1
22635,58thStGreenway22ndAve,09/29/2016 03:00:00 AM,48,-122,0,0,0
22636,58thStGreenway22ndAve,09/29/2016 04:00:00 AM,48,-122,0,0,0
22637,58thStGreenway22ndAve,09/29/2016 05:00:00 AM,48,-122,0,1,1
22638,58thStGreenway22ndAve,09/29/2016 06:00:00 AM,48,-122,2,1,3
22639,58thStGreenway22ndAve,09/29/2016 07:00:00 AM,48,-122,3,0,3
22640,58thStGreenway22ndAve,09/29/2016 08:00:00 AM,48,-122,7,9,16
22641,58thStGreenway22ndAve,09/29/2016 09:00:00 AM,48,-122,8,8,16
22642,58thStGreenway22ndAve,09/29/2016 10:00:00 AM,48,-122,2,3,5
22643,58thStGreenway22ndAve,09/29/2016 11:00:00 AM,48,-122,12,7,19
22644,58thStGreenway22ndAve,09/29/2016 12:00:00 PM,48,-122,1,2,3
22645,58thStGreenway22ndAve,09/29/2016 01:00:00 PM,48,-122,3,7,10
22646,58thStGreenway22ndAve,09/29/2016 02:00:00 PM,48,-122,7,5,12
22647,58thStGreenway22ndAve,09/29/2016 03:00:00 PM,48,-122,3,5,8
22648,58thStGreenway22ndAve,09/29/2016 04:00:00 PM,48,-122,4,5,9
22649,58thStGreenway22ndAve,09/29/2016 05:00:00 PM,48,-122,6,1,7
22650,58thStGreenway22ndAve,09/29/2016 06:00:00 PM,48,-122,7,6,13
22651,58thStGreenway22ndAve,09/29/2016 07:00:00 PM,48,-122,3,8,11
22652,58thStGreenway22ndAve,09/29/2016 08:00:00 PM,48,-122,2,0,2
22653,58thStGreenway22ndAve,09/29/2016 09:00:00 PM,48,-122,1,1,2
22654,58thStGreenway22ndAve,09/29/2016 10:00:00 PM,48,-122,1,1,2
22655,58thStGreenway22ndAve,09/29/2016 11:00:00 PM,48,-122,1,1,2
22656,58thStGreenway22ndAve,09/30/2016 12:00:00 AM,48,-122,0,0,0
22657,58thStGreenway22ndAve,09/30/2016 01:00:00 AM,48,-122,0,0,0
22658,58thStGreenway22ndAve,09/30/2016 02:00:00 AM,48,-122,0,0,0
22659,58thStGreenway22ndAve,09/30/2016 03:00:00 AM,48,-122,1,0,1
22660,58thStGreenway22ndAve,09/30/2016 04:00:00 AM,48,-122,0,0,0
22661,58thStGreenway22ndAve,09/30/2016 05:00:00 AM,48,-122,1,0,1
22662,58thStGreenway22ndAve,09/30/2016 06:00:00 AM,48,-122,4,1,5
22663,58thStGreenway22ndAve,09/30/2016 07:00:00 AM,48,-122,5,1,6
22664,58thStGreenway22ndAve,09/30/2016 08:00:00 AM,48,-122,5,10,15
22665,58thStGreenway22ndAve,09/30/2016 09:00:00 AM,48,-122,5,6,11
22666,58thStGreenway22ndAve,09/30/2016 10:00:00 AM,48,-122,1,4,5
22667,58thStGreenway22ndAve,09/30/2016 11:00:00 AM,48,-122,0,13,13
22668,58thStGreenway22ndAve,09/30/2016 12:00:00 PM,48,-122,4,10,14
22669,58thStGreenway22ndAve,09/30/2016 01:00:00 PM,48,-122,9,6,15
22670,58thStGreenway22ndAve,09/30/2016 02:00:00 PM,48,-122,5,4,9
22671,58thStGreenway22ndAve,09/30/2016 03:00:00 PM,48,-122,2,6,8
22672,58thStGreenway22ndAve,09/30/2016 04:00:00 PM,48,-122,5,6,11
22673,58thStGreenway22ndAve,09/30/2016 05:00:00 PM,48,-122,8,8,16
22674,58thStGreenway22ndAve,09/30/2016 06:00:00 PM,48,-122,8,9,17
22675,58thStGreenway22ndAve,09/30/2016 07:00:00 PM,48,-122,2,5,7
22676,58thStGreenway22ndAve,09/30/2016 08:00:00 PM,48,-122,2,5,7
22677,58thStGreenway22ndAve,09/30/2016 09:00:00 PM,48,-122,1,7,8
22678,58thStGreenway22ndAve,09/30/2016 10:00:00 PM,48,-122,0,3,3
22679,58thStGreenway22ndAve,09/30/2016 11:00:00 PM,48,-122,2,1,3
22680,58thStGreenway22ndAve,10/01/2016 12:00:00 AM,48,-122,1,2,3
22681,58thStGreenway22ndAve,10/01/2016 01:00:00 AM,48,-122,1,0,1
22682,58thStGreenway22ndAve,10/01/2016 02:00:00 AM,48,-122,0,0,0
22683,58thStGreenway22ndAve,10/01/2016 03:00:00 AM,48,-122,0,0,0
22684,58thStGreenway22ndAve,10/01/2016 04:00:00 AM,48,-122,1,0,1
22685,58thStGreenway22ndAve,10/01/2016 05:00:00 AM,48,-122,0,0,0
22686,58thStGreenway22ndAve,10/01/2016 06:00:00 AM,48,-122,0,1,1
22687,58thStGreenway22ndAve,10/01/2016 07:00:00 AM,48,-122,0,1,1
22688,58thStGreenway22ndAve,10/01/2016 08:00:00 AM,48,-122,1,3,4
22689,58thStGreenway22ndAve,10/01/2016 09:00:00 AM,48,-122,4,4,8
22690,58thStGreenway22ndAve,10/01/2016 10:00:00 AM,48,-122,7,5,12
22691,58thStGreenway22ndAve,10/01/2016 11:00:00 AM,48,-122,6,15,21
22692,58thStGreenway22ndAve,10/01/2016 12:00:00 PM,48,-122,4,11,15
22693,58thStGreenway22ndAve,10/01/2016 01:00:00 PM,48,-122,1,5,6
22694,58thStGreenway22ndAve,10/01/2016 02:00:00 PM,48,-122,2,3,5
22695,58thStGreenway22ndAve,10/01/2016 03:00:00 PM,48,-122,5,10,15
22696,58thStGreenway22ndAve,10/01/2016 04:00:00 PM,48,-122,4,6,10
22697,58thStGreenway22ndAve,10/01/2016 05:00:00 PM,48,-122,6,8,14
22698,58thStGreenway22ndAve,10/01/2016 06:00:00 PM,48,-122,2,0,2
22699,58thStGreenway22ndAve,10/01/2016 07:00:00 PM,48,-122,0,3,3
22700,58thStGreenway22ndAve,10/01/2016 08:00:00 PM,48,-122,2,3,5
22701,58thStGreenway22ndAve,10/01/2016 09:00:00 PM,48,-122,1,1,2
22702,58thStGreenway22ndAve,10/01/2016 10:00:00 PM,48,-122,2,3,5
22703,58thStGreenway22ndAve,10/01/2016 11:00:00 PM,48,-122,0,0,0
22704,58thStGreenway22ndAve,10/02/2016 12:00:00 AM,48,-122,1,0,1
22705,58thStGreenway22ndAve,10/02/2016 01:00:00 AM,48,-122,1,1,2
22706,58thStGreenway22ndAve,10/02/2016 02:00:00 AM,48,-122,0,0,0
22707,58thStGreenway22ndAve,10/02/2016 03:00:00 AM,48,-122,0,0,0
22708,58thStGreenway22ndAve,10/02/2016 04:00:00 AM,48,-122,0,1,1
22709,58thStGreenway22ndAve,10/02/2016 05:00:00 AM,48,-122,0,0,0
22710,58thStGreenway22ndAve,10/02/2016 06:00:00 AM,48,-122,0,1,1
22711,58thStGreenway22ndAve,10/02/2016 07:00:00 AM,48,-122,0,1,1
22712,58thStGreenway22ndAve,10/02/2016 08:00:00 AM,48,-122,2,1,3
22713,58thStGreenway22ndAve,10/02/2016 09:00:00 AM,48,-122,5,3,8
22714,58thStGreenway22ndAve,10/02/2016 10:00:00 AM,48,-122,2,3,5
22715,58thStGreenway22ndAve,10/02/2016 11:00:00 AM,48,-122,7,6,13
22716,58thStGreenway22ndAve,10/02/2016 12:00:00 PM,48,-122,9,2,11
22717,58thStGreenway22ndAve,10/02/2016 01:00:00 PM,48,-122,11,10,21
22718,58thStGreenway22ndAve,10/02/2016 02:00:00 PM,48,-122,5,7,12
22719,58thStGreenway22ndAve,10/02/2016 03:00:00 PM,48,-122,7,8,15
22720,58thStGreenway22ndAve,10/02/2016 04:00:00 PM,48,-122,7,6,13
22721,58thStGreenway22ndAve,10/02/2016 05:00:00 PM,48,-122,4,4,8
22722,58thStGreenway22ndAve,10/02/2016 06:00:00 PM,48,-122,5,2,7
22723,58thStGreenway22ndAve,10/02/2016 07:00:00 PM,48,-122,6,3,9
22724,58thStGreenway22ndAve,10/02/2016 08:00:00 PM,48,-122,3,0,3
22725,58thStGreenway22ndAve,10/02/2016 09:00:00 PM,48,-122,2,2,4
22726,58thStGreenway22ndAve,10/02/2016 10:00:00 PM,48,-122,0,2,2
22727,58thStGreenway22ndAve,10/02/2016 11:00:00 PM,48,-122,0,0,0
22728,58thStGreenway22ndAve,10/03/2016 12:00:00 AM,48,-122,0,0,0
22729,58thStGreenway22ndAve,10/03/2016 01:00:00 AM,48,-122,0,0,0
22730,58thStGreenway22ndAve,10/03/2016 02:00:00 AM,48,-122,0,1,1
22731,58thStGreenway22ndAve,10/03/2016 03:00:00 AM,48,-122,0,0,0
22732,58thStGreenway22ndAve,10/03/2016 04:00:00 AM,48,-122,0,0,0
22733,58thStGreenway22ndAve,10/03/2016 05:00:00 AM,48,-122,0,1,1
22734,58thStGreenway22ndAve,10/03/2016 06:00:00 AM,48,-122,2,2,4
22735,58thStGreenway22ndAve,10/03/2016 07:00:00 AM,48,-122,6,6,12
22736,58thStGreenway22ndAve,10/03/2016 08:00:00 AM,48,-122,6,6,12
22737,58thStGreenway22ndAve,10/03/2016 09:00:00 AM,48,-122,5,6,11
22738,58thStGreenway22ndAve,10/03/2016 10:00:00 AM,48,-122,2,4,6
22739,58thStGreenway22ndAve,10/03/2016 11:00:00 AM,48,-122,5,4,9
22740,58thStGreenway22ndAve,10/03/2016 12:00:00 PM,48,-122,3,9,12
22741,58thStGreenway22ndAve,10/03/2016 01:00:00 PM,48,-122,6,8,14
22742,58thStGreenway22ndAve,10/03/2016 02:00:00 PM,48,-122,3,7,10
22743,58thStGreenway22ndAve,10/03/2016 03:00:00 PM,48,-122,3,8,11
22744,58thStGreenway22ndAve,10/03/2016 04:00:00 PM,48,-122,12,5,17
22745,58thStGreenway22ndAve,10/03/2016 05:00:00 PM,48,-122,5,14,19
22746,58thStGreenway22ndAve,10/03/2016 06:00:00 PM,48,-122,9,8,17
22747,58thStGreenway22ndAve,10/03/2016 07:00:00 PM,48,-122,2,4,6
22748,58thStGreenway22ndAve,10/03/2016 08:00:00 PM,48,-122,1,1,2
22749,58thStGreenway22ndAve,10/03/2016 09:00:00 PM,48,-122,0,0,0
22750,58thStGreenway22ndAve,10/03/2016 10:00:00 PM,48,-122,0,2,2
22751,58thStGreenway22ndAve,10/03/2016 11:00:00 PM,48,-122,1,1,2
22752,58thStGreenway22ndAve,10/04/2016 12:00:00 AM,48,-122,0,1,1
22753,58thStGreenway22ndAve,10/04/2016 01:00:00 AM,48,-122,0,0,0
22754,58thStGreenway22ndAve,10/04/2016 02:00:00 AM,48,-122,0,0,0
22755,58thStGreenway22ndAve,10/04/2016 03:00:00 AM,48,-122,0,0,0
22756,58thStGreenway22ndAve,10/04/2016 04:00:00 AM,48,-122,0,0,0
22757,58thStGreenway22ndAve,10/04/2016 05:00:00 AM,48,-122,0,1,1
22758,58thStGreenway22ndAve,10/04/2016 06:00:00 AM,48,-122,0,1,1
22759,58thStGreenway22ndAve,10/04/2016 07:00:00 AM,48,-122,4,2,6
22760,58thStGreenway22ndAve,10/04/2016 08:00:00 AM,48,-122,10,8,18
22761,58thStGreenway22ndAve,10/04/2016 09:00:00 AM,48,-122,2,8,10
22762,58thStGreenway22ndAve,10/04/2016 10:00:00 AM,48,-122,2,9,11
22763,58thStGreenway22ndAve,10/04/2016 11:00:00 AM,48,-122,6,8,14
22764,58thStGreenway22ndAve,10/04/2016 12:00:00 PM,48,-122,5,6,11
22765,58thStGreenway22ndAve,10/04/2016 01:00:00 PM,48,-122,2,2,4
22766,58thStGreenway22ndAve,10/04/2016 02:00:00 PM,48,-122,1,0,1
22767,58thStGreenway22ndAve,10/04/2016 03:00:00 PM,48,-122,3,5,8
22768,58thStGreenway22ndAve,10/04/2016 04:00:00 PM,48,-122,1,5,6
22769,58thStGreenway22ndAve,10/04/2016 05:00:00 PM,48,-122,2,13,15
22770,58thStGreenway22ndAve,10/04/2016 06:00:00 PM,48,-122,8,8,16
22771,58thStGreenway22ndAve,10/04/2016 07:00:00 PM,48,-122,3,1,4
22772,58thStGreenway22ndAve,10/04/2016 08:00:00 PM,48,-122,3,3,6
22773,58thStGreenway22ndAve,10/04/2016 09:00:00 PM,48,-122,3,2,5
22774,58thStGreenway22ndAve,10/04/2016 10:00:00 PM,48,-122,0,2,2
22775,58thStGreenway22ndAve,10/04/2016 11:00:00 PM,48,-122,0,2,2
22776,58thStGreenway22ndAve,10/05/2016 12:00:00 AM,48,-122,0,0,0
22777,58thStGreenway22ndAve,10/05/2016 01:00:00 AM,48,-122,0,0,0
22778,58thStGreenway22ndAve,10/05/2016 02:00:00 AM,48,-122,0,0,0
22779,58thStGreenway22ndAve,10/05/2016 03:00:00 AM,48,-122,1,1,2
22780,58thStGreenway22ndAve,10/05/2016 04:00:00 AM,48,-122,1,1,2
22781,58thStGreenway22ndAve,10/05/2016 05:00:00 AM,48,-122,0,1,1
22782,58thStGreenway22ndAve,10/05/2016 06:00:00 AM,48,-122,2,2,4
22783,58thStGreenway22ndAve,10/05/2016 07:00:00 AM,48,-122,5,4,9
22784,58thStGreenway22ndAve,10/05/2016 08:00:00 AM,48,-122,5,13,18
22785,58thStGreenway22ndAve,10/05/2016 09:00:00 AM,48,-122,3,5,8
22786,58thStGreenway22ndAve,10/05/2016 10:00:00 AM,48,-122,3,6,9
22787,58thStGreenway22ndAve,10/05/2016 11:00:00 AM,48,-122,2,11,13
22788,58thStGreenway22ndAve,10/05/2016 12:00:00 PM,48,-122,2,8,10
22789,58thStGreenway22ndAve,10/05/2016 01:00:00 PM,48,-122,5,5,10
22790,58thStGreenway22ndAve,10/05/2016 02:00:00 PM,48,-122,3,2,5
22791,58thStGreenway22ndAve,10/05/2016 03:00:00 PM,48,-122,4,10,14
22792,58thStGreenway22ndAve,10/05/2016 04:00:00 PM,48,-122,4,4,8
22793,58thStGreenway22ndAve,10/05/2016 05:00:00 PM,48,-122,7,5,12
22794,58thStGreenway22ndAve,10/05/2016 06:00:00 PM,48,-122,6,15,21
22795,58thStGreenway22ndAve,10/05/2016 07:00:00 PM,48,-122,4,10,14
22796,58thStGreenway22ndAve,10/05/2016 08:00:00 PM,48,-122,1,3,4
22797,58thStGreenway22ndAve,10/05/2016 09:00:00 PM,48,-122,2,0,2
22798,58thStGreenway22ndAve,10/05/2016 10:00:00 PM,48,-122,1,0,1
22799,58thStGreenway22ndAve,10/05/2016 11:00:00 PM,48,-122,0,0,0
22800,58thStGreenway22ndAve,10/06/2016 12:00:00 AM,48,-122,0,0,0
22801,58thStGreenway22ndAve,10/06/2016 01:00:00 AM,48,-122,0,0,0
22802,58thStGreenway22ndAve,10/06/2016 02:00:00 AM,48,-122,0,0,0
22803,58thStGreenway22ndAve,10/06/2016 03:00:00 AM,48,-122,0,0,0
22804,58thStGreenway22ndAve,10/06/2016 04:00:00 AM,48,-122,0,0,0
22805,58thStGreenway22ndAve,10/06/2016 05:00:00 AM,48,-122,0,1,1
22806,58thStGreenway22ndAve,10/06/2016 06:00:00 AM,48,-122,1,3,4
22807,58thStGreenway22ndAve,10/06/2016 07:00:00 AM,48,-122,4,4,8
22808,58thStGreenway22ndAve,10/06/2016 08:00:00 AM,48,-122,2,10,12
22809,58thStGreenway22ndAve,10/06/2016 09:00:00 AM,48,-122,7,11,18
22810,58thStGreenway22ndAve,10/06/2016 10:00:00 AM,48,-122,3,12,15
22811,58thStGreenway22ndAve,10/06/2016 11:00:00 AM,48,-122,3,6,9
22812,58thStGreenway22ndAve,10/06/2016 12:00:00 PM,48,-122,3,10,13
22813,58thStGreenway22ndAve,10/06/2016 01:00:00 PM,48,-122,4,5,9
22814,58thStGreenway22ndAve,10/06/2016 02:00:00 PM,48,-122,8,9,17
22815,58thStGreenway22ndAve,10/06/2016 03:00:00 PM,48,-122,4,11,15
22816,58thStGreenway22ndAve,10/06/2016 04:00:00 PM,48,-122,5,3,8
22817,58thStGreenway22ndAve,10/06/2016 05:00:00 PM,48,-122,8,16,24
22818,58thStGreenway22ndAve,10/06/2016 06:00:00 PM,48,-122,0,8,8
22819,58thStGreenway22ndAve,10/06/2016 07:00:00 PM,48,-122,2,2,4
22820,58thStGreenway22ndAve,10/06/2016 08:00:00 PM,48,-122,1,3,4
22821,58thStGreenway22ndAve,10/06/2016 09:00:00 PM,48,-122,3,2,5
22822,58thStGreenway22ndAve,10/06/2016 10:00:00 PM,48,-122,0,2,2
22823,58thStGreenway22ndAve,10/06/2016 11:00:00 PM,48,-122,0,1,1
22824,58thStGreenway22ndAve,10/07/2016 12:00:00 AM,48,-122,2,1,3
22825,58thStGreenway22ndAve,10/07/2016 01:00:00 AM,48,-122,0,1,1
22826,58thStGreenway22ndAve,10/07/2016 02:00:00 AM,48,-122,0,0,0
22827,58thStGreenway22ndAve,10/07/2016 03:00:00 AM,48,-122,0,0,0
22828,58thStGreenway22ndAve,10/07/2016 04:00:00 AM,48,-122,0,0,0
22829,58thStGreenway22ndAve,10/07/2016 05:00:00 AM,48,-122,0,1,1
22830,58thStGreenway22ndAve,10/07/2016 06:00:00 AM,48,-122,1,1,2
22831,58thStGreenway22ndAve,10/07/2016 07:00:00 AM,48,-122,3,0,3
22832,58thStGreenway22ndAve,10/07/2016 08:00:00 AM,48,-122,3,6,9
22833,58thStGreenway22ndAve,10/07/2016 09:00:00 AM,48,-122,1,6,7
22834,58thStGreenway22ndAve,10/07/2016 10:00:00 AM,48,-122,2,5,7
22835,58thStGreenway22ndAve,10/07/2016 11:00:00 AM,48,-122,2,6,8
22836,58thStGreenway22ndAve,10/07/2016 12:00:00 PM,48,-122,2,8,10
22837,58thStGreenway22ndAve,10/07/2016 01:00:00 PM,48,-122,6,5,11
22838,58thStGreenway22ndAve,10/07/2016 02:00:00 PM,48,-122,2,4,6
22839,58thStGreenway22ndAve,10/07/2016 03:00:00 PM,48,-122,5,6,11
22840,58thStGreenway22ndAve,10/07/2016 04:00:00 PM,48,-122,4,8,12
22841,58thStGreenway22ndAve,10/07/2016 05:00:00 PM,48,-122,5,7,12
22842,58thStGreenway22ndAve,10/07/2016 06:00:00 PM,48,-122,8,10,18
22843,58thStGreenway22ndAve,10/07/2016 07:00:00 PM,48,-122,1,1,2
22844,58thStGreenway22ndAve,10/07/2016 08:00:00 PM,48,-122,1,1,2
22845,58thStGreenway22ndAve,10/07/2016 09:00:00 PM,48,-122,3,7,10
22846,58thStGreenway22ndAve,10/07/2016 10:00:00 PM,48,-122,0,1,1
22847,58thStGreenway22ndAve,10/07/2016 11:00:00 PM,48,-122,3,0,3
22848,58thStGreenway22ndAve,10/08/2016 12:00:00 AM,48,-122,0,1,1
22849,58thStGreenway22ndAve,10/08/2016 01:00:00 AM,48,-122,0,0,0
22850,58thStGreenway22ndAve,10/08/2016 02:00:00 AM,48,-122,0,0,0
22851,58thStGreenway22ndAve,10/08/2016 03:00:00 AM,48,-122,0,0,0
22852,58thStGreenway22ndAve,10/08/2016 04:00:00 AM,48,-122,0,0,0
22853,58thStGreenway22ndAve,10/08/2016 05:00:00 AM,48,-122,0,0,0
22854,58thStGreenway22ndAve,10/08/2016 06:00:00 AM,48,-122,0,0,0
22855,58thStGreenway22ndAve,10/08/2016 07:00:00 AM,48,-122,0,2,2
22856,58thStGreenway22ndAve,10/08/2016 08:00:00 AM,48,-122,2,1,3
22857,58thStGreenway22ndAve,10/08/2016 09:00:00 AM,48,-122,1,7,8
22858,58thStGreenway22ndAve,10/08/2016 10:00:00 AM,48,-122,1,3,4
22859,58thStGreenway22ndAve,10/08/2016 11:00:00 AM,48,-122,5,11,16
22860,58thStGreenway22ndAve,10/08/2016 12:00:00 PM,48,-122,1,5,6
22861,58thStGreenway22ndAve,10/08/2016 01:00:00 PM,48,-122,6,7,13
22862,58thStGreenway22ndAve,10/08/2016 02:00:00 PM,48,-122,1,3,4
22863,58thStGreenway22ndAve,10/08/2016 03:00:00 PM,48,-122,2,5,7
22864,58thStGreenway22ndAve,10/08/2016 04:00:00 PM,48,-122,3,5,8
22865,58thStGreenway22ndAve,10/08/2016 05:00:00 PM,48,-122,1,1,2
22866,58thStGreenway22ndAve,10/08/2016 06:00:00 PM,48,-122,0,6,6
22867,58thStGreenway22ndAve,10/08/2016 07:00:00 PM,48,-122,3,2,5
22868,58thStGreenway22ndAve,10/08/2016 08:00:00 PM,48,-122,2,1,3
22869,58thStGreenway22ndAve,10/08/2016 09:00:00 PM,48,-122,1,2,3
22870,58thStGreenway22ndAve,10/08/2016 10:00:00 PM,48,-122,1,0,1
22871,58thStGreenway22ndAve,10/08/2016 11:00:00 PM,48,-122,0,0,0
22872,58thStGreenway22ndAve,10/09/2016 12:00:00 AM,48,-122,0,1,1
22873,58thStGreenway22ndAve,10/09/2016 01:00:00 AM,48,-122,0,1,1
22874,58thStGreenway22ndAve,10/09/2016 02:00:00 AM,48,-122,0,0,0
22875,58thStGreenway22ndAve,10/09/2016 03:00:00 AM,48,-122,0,1,1
22876,58thStGreenway22ndAve,10/09/2016 04:00:00 AM,48,-122,0,0,0
22877,58thStGreenway22ndAve,10/09/2016 05:00:00 AM,48,-122,0,0,0
22878,58thStGreenway22ndAve,10/09/2016 06:00:00 AM,48,-122,0,0,0
22879,58thStGreenway22ndAve,10/09/2016 07:00:00 AM,48,-122,1,0,1
22880,58thStGreenway22ndAve,10/09/2016 08:00:00 AM,48,-122,1,1,2
22881,58thStGreenway22ndAve,10/09/2016 09:00:00 AM,48,-122,2,2,4
22882,58thStGreenway22ndAve,10/09/2016 10:00:00 AM,48,-122,3,10,13
22883,58thStGreenway22ndAve,10/09/2016 11:00:00 AM,48,-122,1,3,4
22884,58thStGreenway22ndAve,10/09/2016 12:00:00 PM,48,-122,8,8,16
22885,58thStGreenway22ndAve,10/09/2016 01:00:00 PM,48,-122,6,10,16
22886,58thStGreenway22ndAve,10/09/2016 02:00:00 PM,48,-122,8,4,12
22887,58thStGreenway22ndAve,10/09/2016 03:00:00 PM,48,-122,6,4,10
22888,58thStGreenway22ndAve,10/09/2016 04:00:00 PM,48,-122,5,5,10
22889,58thStGreenway22ndAve,10/09/2016 05:00:00 PM,48,-122,4,8,12
22890,58thStGreenway22ndAve,10/09/2016 06:00:00 PM,48,-122,1,5,6
22891,58thStGreenway22ndAve,10/09/2016 07:00:00 PM,48,-122,4,0,4
22892,58thStGreenway22ndAve,10/09/2016 08:00:00 PM,48,-122,0,3,3
22893,58thStGreenway22ndAve,10/09/2016 09:00:00 PM,48,-122,1,0,1
22894,58thStGreenway22ndAve,10/09/2016 10:00:00 PM,48,-122,1,0,1
22895,58thStGreenway22ndAve,10/09/2016 11:00:00 PM,48,-122,1,0,1
22896,58thStGreenway22ndAve,10/10/2016 12:00:00 AM,48,-122,0,1,1
22897,58thStGreenway22ndAve,10/10/2016 01:00:00 AM,48,-122,0,1,1
22898,58thStGreenway22ndAve,10/10/2016 02:00:00 AM,48,-122,0,1,1
22899,58thStGreenway22ndAve,10/10/2016 03:00:00 AM,48,-122,0,0,0
22900,58thStGreenway22ndAve,10/10/2016 04:00:00 AM,48,-122,1,0,1
22901,58thStGreenway22ndAve,10/10/2016 05:00:00 AM,48,-122,0,3,3
22902,58thStGreenway22ndAve,10/10/2016 06:00:00 AM,48,-122,1,1,2
22903,58thStGreenway22ndAve,10/10/2016 07:00:00 AM,48,-122,2,3,5
22904,58thStGreenway22ndAve,10/10/2016 08:00:00 AM,48,-122,4,8,12
22905,58thStGreenway22ndAve,10/10/2016 09:00:00 AM,48,-122,6,3,9
22906,58thStGreenway22ndAve,10/10/2016 10:00:00 AM,48,-122,3,6,9
22907,58thStGreenway22ndAve,10/10/2016 11:00:00 AM,48,-122,3,4,7
22908,58thStGreenway22ndAve,10/10/2016 12:00:00 PM,48,-122,5,2,7
22909,58thStGreenway22ndAve,10/10/2016 01:00:00 PM,48,-122,6,7,13
22910,58thStGreenway22ndAve,10/10/2016 02:00:00 PM,48,-122,6,3,9
22911,58thStGreenway22ndAve,10/10/2016 03:00:00 PM,48,-122,2,6,8
22912,58thStGreenway22ndAve,10/10/2016 04:00:00 PM,48,-122,6,9,15
22913,58thStGreenway22ndAve,10/10/2016 05:00:00 PM,48,-122,8,8,16
22914,58thStGreenway22ndAve,10/10/2016 06:00:00 PM,48,-122,5,2,7
22915,58thStGreenway22ndAve,10/10/2016 07:00:00 PM,48,-122,5,4,9
22916,58thStGreenway22ndAve,10/10/2016 08:00:00 PM,48,-122,3,3,6
22917,58thStGreenway22ndAve,10/10/2016 09:00:00 PM,48,-122,3,3,6
22918,58thStGreenway22ndAve,10/10/2016 10:00:00 PM,48,-122,0,0,0
22919,58thStGreenway22ndAve,10/10/2016 11:00:00 PM,48,-122,0,0,0
22920,58thStGreenway22ndAve,10/11/2016 12:00:00 AM,48,-122,0,0,0
22921,58thStGreenway22ndAve,10/11/2016 01:00:00 AM,48,-122,0,0,0
22922,58thStGreenway22ndAve,10/11/2016 02:00:00 AM,48,-122,0,0,0
22923,58thStGreenway22ndAve,10/11/2016 03:00:00 AM,48,-122,0,0,0
22924,58thStGreenway22ndAve,10/11/2016 04:00:00 AM,48,-122,0,0,0
22925,58thStGreenway22ndAve,10/11/2016 05:00:00 AM,48,-122,0,2,2
22926,58thStGreenway22ndAve,10/11/2016 06:00:00 AM,48,-122,2,0,2
22927,58thStGreenway22ndAve,10/11/2016 07:00:00 AM,48,-122,5,4,9
22928,58thStGreenway22ndAve,10/11/2016 08:00:00 AM,48,-122,7,6,13
22929,58thStGreenway22ndAve,10/11/2016 09:00:00 AM,48,-122,5,7,12
22930,58thStGreenway22ndAve,10/11/2016 10:00:00 AM,48,-122,2,6,8
22931,58thStGreenway22ndAve,10/11/2016 11:00:00 AM,48,-122,9,2,11
22932,58thStGreenway22ndAve,10/11/2016 12:00:00 PM,48,-122,4,10,14
22933,58thStGreenway22ndAve,10/11/2016 01:00:00 PM,48,-122,4,7,11
22934,58thStGreenway22ndAve,10/11/2016 02:00:00 PM,48,-122,8,7,15
22935,58thStGreenway22ndAve,10/11/2016 03:00:00 PM,48,-122,5,2,7
22936,58thStGreenway22ndAve,10/11/2016 04:00:00 PM,48,-122,3,8,11
22937,58thStGreenway22ndAve,10/11/2016 05:00:00 PM,48,-122,12,10,22
22938,58thStGreenway22ndAve,10/11/2016 06:00:00 PM,48,-122,7,11,18
22939,58thStGreenway22ndAve,10/11/2016 07:00:00 PM,48,-122,5,7,12
22940,58thStGreenway22ndAve,10/11/2016 08:00:00 PM,48,-122,0,5,5
22941,58thStGreenway22ndAve,10/11/2016 09:00:00 PM,48,-122,3,0,3
22942,58thStGreenway22ndAve,10/11/2016 10:00:00 PM,48,-122,1,1,2
22943,58thStGreenway22ndAve,10/11/2016 11:00:00 PM,48,-122,0,1,1
22944,58thStGreenway22ndAve,10/12/2016 12:00:00 AM,48,-122,0,0,0
22945,58thStGreenway22ndAve,10/12/2016 01:00:00 AM,48,-122,0,0,0
22946,58thStGreenway22ndAve,10/12/2016 02:00:00 AM,48,-122,0,0,0
22947,58thStGreenway22ndAve,10/12/2016 03:00:00 AM,48,-122,0,0,0
22948,58thStGreenway22ndAve,10/12/2016 04:00:00 AM,48,-122,0,0,0
22949,58thStGreenway22ndAve,10/12/2016 05:00:00 AM,48,-122,2,0,2
22950,58thStGreenway22ndAve,10/12/2016 06:00:00 AM,48,-122,2,3,5
22951,58thStGreenway22ndAve,10/12/2016 07:00:00 AM,48,-122,5,1,6
22952,58thStGreenway22ndAve,10/12/2016 08:00:00 AM,48,-122,4,7,11
22953,58thStGreenway22ndAve,10/12/2016 09:00:00 AM,48,-122,7,8,15
22954,58thStGreenway22ndAve,10/12/2016 10:00:00 AM,48,-122,5,5,10
22955,58thStGreenway22ndAve,10/12/2016 11:00:00 AM,48,-122,1,3,4
22956,58thStGreenway22ndAve,10/12/2016 12:00:00 PM,48,-122,5,8,13
22957,58thStGreenway22ndAve,10/12/2016 01:00:00 PM,48,-122,4,6,10
22958,58thStGreenway22ndAve,10/12/2016 02:00:00 PM,48,-122,2,6,8
22959,58thStGreenway22ndAve,10/12/2016 03:00:00 PM,48,-122,5,5,10
22960,58thStGreenway22ndAve,10/12/2016 04:00:00 PM,48,-122,12,8,20
22961,58thStGreenway22ndAve,10/12/2016 05:00:00 PM,48,-122,5,6,11
22962,58thStGreenway22ndAve,10/12/2016 06:00:00 PM,48,-122,9,7,16
22963,58thStGreenway22ndAve,10/12/2016 07:00:00 PM,48,-122,4,3,7
22964,58thStGreenway22ndAve,10/12/2016 08:00:00 PM,48,-122,2,5,7
22965,58thStGreenway22ndAve,10/12/2016 09:00:00 PM,48,-122,2,1,3
22966,58thStGreenway22ndAve,10/12/2016 10:00:00 PM,48,-122,0,2,2
22967,58thStGreenway22ndAve,10/12/2016 11:00:00 PM,48,-122,0,0,0
22968,58thStGreenway22ndAve,10/13/2016 12:00:00 AM,48,-122,0,0,0
22969,58thStGreenway22ndAve,10/13/2016 01:00:00 AM,48,-122,0,0,0
22970,58thStGreenway22ndAve,10/13/2016 02:00:00 AM,48,-122,0,0,0
22971,58thStGreenway22ndAve,10/13/2016 03:00:00 AM,48,-122,0,0,0
22972,58thStGreenway22ndAve,10/13/2016 04:00:00 AM,48,-122,0,0,0
22973,58thStGreenway22ndAve,10/13/2016 05:00:00 AM,48,-122,1,1,2
22974,58thStGreenway22ndAve,10/13/2016 06:00:00 AM,48,-122,1,0,1
22975,58thStGreenway22ndAve,10/13/2016 07:00:00 AM,48,-122,3,4,7
22976,58thStGreenway22ndAve,10/13/2016 08:00:00 AM,48,-122,2,2,4
22977,58thStGreenway22ndAve,10/13/2016 09:00:00 AM,48,-122,1,1,2
22978,58thStGreenway22ndAve,10/13/2016 10:00:00 AM,48,-122,0,1,1
22979,58thStGreenway22ndAve,10/13/2016 11:00:00 AM,48,-122,0,5,5
22980,58thStGreenway22ndAve,10/13/2016 12:00:00 PM,48,-122,0,3,3
22981,58thStGreenway22ndAve,10/13/2016 01:00:00 PM,48,-122,1,7,8
22982,58thStGreenway22ndAve,10/13/2016 02:00:00 PM,48,-122,3,5,8
22983,58thStGreenway22ndAve,10/13/2016 03:00:00 PM,48,-122,3,7,10
22984,58thStGreenway22ndAve,10/13/2016 04:00:00 PM,48,-122,2,2,4
22985,58thStGreenway22ndAve,10/13/2016 05:00:00 PM,48,-122,4,4,8
22986,58thStGreenway22ndAve,10/13/2016 06:00:00 PM,48,-122,7,7,14
22987,58thStGreenway22ndAve,10/13/2016 07:00:00 PM,48,-122,0,3,3
22988,58thStGreenway22ndAve,10/13/2016 08:00:00 PM,48,-122,1,3,4
22989,58thStGreenway22ndAve,10/13/2016 09:00:00 PM,48,-122,0,0,0
22990,58thStGreenway22ndAve,10/13/2016 10:00:00 PM,48,-122,0,1,1
22991,58thStGreenway22ndAve,10/13/2016 11:00:00 PM,48,-122,1,0,1
22992,58thStGreenway22ndAve,10/14/2016 12:00:00 AM,48,-122,0,0,0
22993,58thStGreenway22ndAve,10/14/2016 01:00:00 AM,48,-122,0,0,0
22994,58thStGreenway22ndAve,10/14/2016 02:00:00 AM,48,-122,0,0,0
22995,58thStGreenway22ndAve,10/14/2016 03:00:00 AM,48,-122,0,0,0
22996,58thStGreenway22ndAve,10/14/2016 04:00:00 AM,48,-122,0,0,0
22997,58thStGreenway22ndAve,10/14/2016 05:00:00 AM,48,-122,0,1,1
22998,58thStGreenway22ndAve,10/14/2016 06:00:00 AM,48,-122,0,0,0
22999,58thStGreenway22ndAve,10/14/2016 07:00:00 AM,48,-122,1,1,2
23000,58thStGreenway22ndAve,10/14/2016 08:00:00 AM,48,-122,4,3,7
23001,58thStGreenway22ndAve,10/14/2016 09:00:00 AM,48,-122,1,2,3
23002,58thStGreenway22ndAve,10/14/2016 10:00:00 AM,48,-122,0,1,1
23003,58thStGreenway22ndAve,10/14/2016 11:00:00 AM,48,-122,3,5,8
23004,58thStGreenway22ndAve,10/14/2016 12:00:00 PM,48,-122,1,6,7
23005,58thStGreenway22ndAve,10/14/2016 01:00:00 PM,48,-122,3,2,5
23006,58thStGreenway22ndAve,10/14/2016 02:00:00 PM,48,-122,4,2,6
23007,58thStGreenway22ndAve,10/14/2016 03:00:00 PM,48,-122,2,2,4
23008,58thStGreenway22ndAve,10/14/2016 04:00:00 PM,48,-122,1,5,6
23009,58thStGreenway22ndAve,10/14/2016 05:00:00 PM,48,-122,0,11,11
23010,58thStGreenway22ndAve,10/14/2016 06:00:00 PM,48,-122,3,4,7
23011,58thStGreenway22ndAve,10/14/2016 07:00:00 PM,48,-122,1,3,4
23012,58thStGreenway22ndAve,10/14/2016 08:00:00 PM,48,-122,1,2,3
23013,58thStGreenway22ndAve,10/14/2016 09:00:00 PM,48,-122,1,3,4
23014,58thStGreenway22ndAve,10/14/2016 10:00:00 PM,48,-122,1,1,2
23015,58thStGreenway22ndAve,10/14/2016 11:00:00 PM,48,-122,3,2,5
23016,58thStGreenway22ndAve,10/15/2016 12:00:00 AM,48,-122,1,1,2
23017,58thStGreenway22ndAve,10/15/2016 01:00:00 AM,48,-122,0,0,0
23018,58thStGreenway22ndAve,10/15/2016 02:00:00 AM,48,-122,0,1,1
23019,58thStGreenway22ndAve,10/15/2016 03:00:00 AM,48,-122,0,0,0
23020,58thStGreenway22ndAve,10/15/2016 04:00:00 AM,48,-122,0,0,0
23021,58thStGreenway22ndAve,10/15/2016 05:00:00 AM,48,-122,0,0,0
23022,58thStGreenway22ndAve,10/15/2016 06:00:00 AM,48,-122,0,1,1
23023,58thStGreenway22ndAve,10/15/2016 07:00:00 AM,48,-122,0,2,2
23024,58thStGreenway22ndAve,10/15/2016 08:00:00 AM,48,-122,2,0,2
23025,58thStGreenway22ndAve,10/15/2016 09:00:00 AM,48,-122,2,6,8
23026,58thStGreenway22ndAve,10/15/2016 10:00:00 AM,48,-122,0,6,6
23027,58thStGreenway22ndAve,10/15/2016 11:00:00 AM,48,-122,3,6,9
23028,58thStGreenway22ndAve,10/15/2016 12:00:00 PM,48,-122,2,5,7
23029,58thStGreenway22ndAve,10/15/2016 01:00:00 PM,48,-122,1,2,3
23030,58thStGreenway22ndAve,10/15/2016 02:00:00 PM,48,-122,1,6,7
23031,58thStGreenway22ndAve,10/15/2016 03:00:00 PM,48,-122,4,9,13
23032,58thStGreenway22ndAve,10/15/2016 04:00:00 PM,48,-122,1,1,2
23033,58thStGreenway22ndAve,10/15/2016 05:00:00 PM,48,-122,0,4,4
23034,58thStGreenway22ndAve,10/15/2016 06:00:00 PM,48,-122,2,0,2
23035,58thStGreenway22ndAve,10/15/2016 07:00:00 PM,48,-122,1,1,2
23036,58thStGreenway22ndAve,10/15/2016 08:00:00 PM,48,-122,2,1,3
23037,58thStGreenway22ndAve,10/15/2016 09:00:00 PM,48,-122,0,0,0
23038,58thStGreenway22ndAve,10/15/2016 10:00:00 PM,48,-122,1,0,1
23039,58thStGreenway22ndAve,10/15/2016 11:00:00 PM,48,-122,0,0,0
23040,58thStGreenway22ndAve,10/16/2016 12:00:00 AM,48,-122,0,0,0
23041,58thStGreenway22ndAve,10/16/2016 01:00:00 AM,48,-122,0,0,0
23042,58thStGreenway22ndAve,10/16/2016 02:00:00 AM,48,-122,0,1,1
23043,58thStGreenway22ndAve,10/16/2016 03:00:00 AM,48,-122,0,0,0
23044,58thStGreenway22ndAve,10/16/2016 04:00:00 AM,48,-122,0,0,0
23045,58thStGreenway22ndAve,10/16/2016 05:00:00 AM,48,-122,0,0,0
23046,58thStGreenway22ndAve,10/16/2016 06:00:00 AM,48,-122,0,1,1
23047,58thStGreenway22ndAve,10/16/2016 07:00:00 AM,48,-122,0,1,1
23048,58thStGreenway22ndAve,10/16/2016 08:00:00 AM,48,-122,1,1,2
23049,58thStGreenway22ndAve,10/16/2016 09:00:00 AM,48,-122,1,4,5
23050,58thStGreenway22ndAve,10/16/2016 10:00:00 AM,48,-122,3,2,5
23051,58thStGreenway22ndAve,10/16/2016 11:00:00 AM,48,-122,4,5,9
23052,58thStGreenway22ndAve,10/16/2016 12:00:00 PM,48,-122,1,7,8
23053,58thStGreenway22ndAve,10/16/2016 01:00:00 PM,48,-122,1,8,9
23054,58thStGreenway22ndAve,10/16/2016 02:00:00 PM,48,-122,4,4,8
23055,58thStGreenway22ndAve,10/16/2016 03:00:00 PM,48,-122,5,4,9
23056,58thStGreenway22ndAve,10/16/2016 04:00:00 PM,48,-122,0,4,4
23057,58thStGreenway22ndAve,10/16/2016 05:00:00 PM,48,-122,7,1,8
23058,58thStGreenway22ndAve,10/16/2016 06:00:00 PM,48,-122,1,0,1
23059,58thStGreenway22ndAve,10/16/2016 07:00:00 PM,48,-122,1,2,3
23060,58thStGreenway22ndAve,10/16/2016 08:00:00 PM,48,-122,0,2,2
23061,58thStGreenway22ndAve,10/16/2016 09:00:00 PM,48,-122,0,1,1
23062,58thStGreenway22ndAve,10/16/2016 10:00:00 PM,48,-122,1,3,4
23063,58thStGreenway22ndAve,10/16/2016 11:00:00 PM,48,-122,0,0,0
23064,58thStGreenway22ndAve,10/17/2016 12:00:00 AM,48,-122,0,0,0
23065,58thStGreenway22ndAve,10/17/2016 01:00:00 AM,48,-122,0,0,0
23066,58thStGreenway22ndAve,10/17/2016 02:00:00 AM,48,-122,0,0,0
23067,58thStGreenway22ndAve,10/17/2016 03:00:00 AM,48,-122,0,0,0
23068,58thStGreenway22ndAve,10/17/2016 04:00:00 AM,48,-122,0,0,0
23069,58thStGreenway22ndAve,10/17/2016 05:00:00 AM,48,-122,0,1,1
23070,58thStGreenway22ndAve,10/17/2016 06:00:00 AM,48,-122,3,1,4
23071,58thStGreenway22ndAve,10/17/2016 07:00:00 AM,48,-122,2,6,8
23072,58thStGreenway22ndAve,10/17/2016 08:00:00 AM,48,-122,3,6,9
23073,58thStGreenway22ndAve,10/17/2016 09:00:00 AM,48,-122,2,6,8
23074,58thStGreenway22ndAve,10/17/2016 10:00:00 AM,48,-122,5,6,11
23075,58thStGreenway22ndAve,10/17/2016 11:00:00 AM,48,-122,0,8,8
23076,58thStGreenway22ndAve,10/17/2016 12:00:00 PM,48,-122,1,4,5
23077,58thStGreenway22ndAve,10/17/2016 01:00:00 PM,48,-122,1,3,4
23078,58thStGreenway22ndAve,10/17/2016 02:00:00 PM,48,-122,3,8,11
23079,58thStGreenway22ndAve,10/17/2016 03:00:00 PM,48,-122,3,6,9
23080,58thStGreenway22ndAve,10/17/2016 04:00:00 PM,48,-122,2,5,7
23081,58thStGreenway22ndAve,10/17/2016 05:00:00 PM,48,-122,6,7,13
23082,58thStGreenway22ndAve,10/17/2016 06:00:00 PM,48,-122,6,7,13
23083,58thStGreenway22ndAve,10/17/2016 07:00:00 PM,48,-122,3,7,10
23084,58thStGreenway22ndAve,10/17/2016 08:00:00 PM,48,-122,4,4,8
23085,58thStGreenway22ndAve,10/17/2016 09:00:00 PM,48,-122,1,0,1
23086,58thStGreenway22ndAve,10/17/2016 10:00:00 PM,48,-122,1,0,1
23087,58thStGreenway22ndAve,10/17/2016 11:00:00 PM,48,-122,0,1,1
23088,58thStGreenway22ndAve,10/18/2016 12:00:00 AM,48,-122,0,0,0
23089,58thStGreenway22ndAve,10/18/2016 01:00:00 AM,48,-122,0,0,0
23090,58thStGreenway22ndAve,10/18/2016 02:00:00 AM,48,-122,0,0,0
23091,58thStGreenway22ndAve,10/18/2016 03:00:00 AM,48,-122,0,0,0
23092,58thStGreenway22ndAve,10/18/2016 04:00:00 AM,48,-122,0,0,0
23093,58thStGreenway22ndAve,10/18/2016 05:00:00 AM,48,-122,0,1,1
23094,58thStGreenway22ndAve,10/18/2016 06:00:00 AM,48,-122,0,0,0
23095,58thStGreenway22ndAve,10/18/2016 07:00:00 AM,48,-122,2,5,7
23096,58thStGreenway22ndAve,10/18/2016 08:00:00 AM,48,-122,3,4,7
23097,58thStGreenway22ndAve,10/18/2016 09:00:00 AM,48,-122,6,3,9
23098,58thStGreenway22ndAve,10/18/2016 10:00:00 AM,48,-122,2,7,9
23099,58thStGreenway22ndAve,10/18/2016 11:00:00 AM,48,-122,2,5,7
23100,58thStGreenway22ndAve,10/18/2016 12:00:00 PM,48,-122,1,1,2
23101,58thStGreenway22ndAve,10/18/2016 01:00:00 PM,48,-122,7,6,13
23102,58thStGreenway22ndAve,10/18/2016 02:00:00 PM,48,-122,4,8,12
23103,58thStGreenway22ndAve,10/18/2016 03:00:00 PM,48,-122,0,6,6
23104,58thStGreenway22ndAve,10/18/2016 04:00:00 PM,48,-122,6,6,12
23105,58thStGreenway22ndAve,10/18/2016 05:00:00 PM,48,-122,10,11,21
23106,58thStGreenway22ndAve,10/18/2016 06:00:00 PM,48,-122,9,6,15
23107,58thStGreenway22ndAve,10/18/2016 07:00:00 PM,48,-122,4,1,5
23108,58thStGreenway22ndAve,10/18/2016 08:00:00 PM,48,-122,4,3,7
23109,58thStGreenway22ndAve,10/18/2016 09:00:00 PM,48,-122,1,2,3
23110,58thStGreenway22ndAve,10/18/2016 10:00:00 PM,48,-122,0,0,0
23111,58thStGreenway22ndAve,10/18/2016 11:00:00 PM,48,-122,0,0,0
23112,58thStGreenway22ndAve,10/19/2016 12:00:00 AM,48,-122,0,0,0
23113,58thStGreenway22ndAve,10/19/2016 01:00:00 AM,48,-122,0,0,0
23114,58thStGreenway22ndAve,10/19/2016 02:00:00 AM,48,-122,0,1,1
23115,58thStGreenway22ndAve,10/19/2016 03:00:00 AM,48,-122,0,0,0
23116,58thStGreenway22ndAve,10/19/2016 04:00:00 AM,48,-122,0,0,0
23117,58thStGreenway22ndAve,10/19/2016 05:00:00 AM,48,-122,0,1,1
23118,58thStGreenway22ndAve,10/19/2016 06:00:00 AM,48,-122,1,2,3
23119,58thStGreenway22ndAve,10/19/2016 07:00:00 AM,48,-122,6,2,8
23120,58thStGreenway22ndAve,10/19/2016 08:00:00 AM,48,-122,2,7,9
23121,58thStGreenway22ndAve,10/19/2016 09:00:00 AM,48,-122,1,6,7
23122,58thStGreenway22ndAve,10/19/2016 10:00:00 AM,48,-122,4,7,11
23123,58thStGreenway22ndAve,10/19/2016 11:00:00 AM,48,-122,3,4,7
23124,58thStGreenway22ndAve,10/19/2016 12:00:00 PM,48,-122,2,9,11
23125,58thStGreenway22ndAve,10/19/2016 01:00:00 PM,48,-122,2,7,9
23126,58thStGreenway22ndAve,10/19/2016 02:00:00 PM,48,-122,5,3,8
23127,58thStGreenway22ndAve,10/19/2016 03:00:00 PM,48,-122,4,5,9
23128,58thStGreenway22ndAve,10/19/2016 04:00:00 PM,48,-122,6,3,9
23129,58thStGreenway22ndAve,10/19/2016 05:00:00 PM,48,-122,6,11,17
23130,58thStGreenway22ndAve,10/19/2016 06:00:00 PM,48,-122,3,5,8
23131,58thStGreenway22ndAve,10/19/2016 07:00:00 PM,48,-122,1,6,7
23132,58thStGreenway22ndAve,10/19/2016 08:00:00 PM,48,-122,3,3,6
23133,58thStGreenway22ndAve,10/19/2016 09:00:00 PM,48,-122,3,3,6
23134,58thStGreenway22ndAve,10/19/2016 10:00:00 PM,48,-122,3,0,3
23135,58thStGreenway22ndAve,10/19/2016 11:00:00 PM,48,-122,0,0,0
23136,58thStGreenway22ndAve,10/20/2016 12:00:00 AM,48,-122,0,0,0
23137,58thStGreenway22ndAve,10/20/2016 01:00:00 AM,48,-122,0,1,1
23138,58thStGreenway22ndAve,10/20/2016 02:00:00 AM,48,-122,0,0,0
23139,58thStGreenway22ndAve,10/20/2016 03:00:00 AM,48,-122,0,0,0
23140,58thStGreenway22ndAve,10/20/2016 04:00:00 AM,48,-122,0,0,0
23141,58thStGreenway22ndAve,10/20/2016 05:00:00 AM,48,-122,0,2,2
23142,58thStGreenway22ndAve,10/20/2016 06:00:00 AM,48,-122,0,1,1
23143,58thStGreenway22ndAve,10/20/2016 07:00:00 AM,48,-122,4,2,6
23144,58thStGreenway22ndAve,10/20/2016 08:00:00 AM,48,-122,4,4,8
23145,58thStGreenway22ndAve,10/20/2016 09:00:00 AM,48,-122,3,4,7
23146,58thStGreenway22ndAve,10/20/2016 10:00:00 AM,48,-122,0,4,4
23147,58thStGreenway22ndAve,10/20/2016 11:00:00 AM,48,-122,1,6,7
23148,58thStGreenway22ndAve,10/20/2016 12:00:00 PM,48,-122,1,4,5
23149,58thStGreenway22ndAve,10/20/2016 01:00:00 PM,48,-122,2,8,10
23150,58thStGreenway22ndAve,10/20/2016 02:00:00 PM,48,-122,3,5,8
23151,58thStGreenway22ndAve,10/20/2016 03:00:00 PM,48,-122,2,2,4
23152,58thStGreenway22ndAve,10/20/2016 04:00:00 PM,48,-122,3,4,7
23153,58thStGreenway22ndAve,10/20/2016 05:00:00 PM,48,-122,7,9,16
23154,58thStGreenway22ndAve,10/20/2016 06:00:00 PM,48,-122,5,4,9
23155,58thStGreenway22ndAve,10/20/2016 07:00:00 PM,48,-122,3,3,6
23156,58thStGreenway22ndAve,10/20/2016 08:00:00 PM,48,-122,3,4,7
23157,58thStGreenway22ndAve,10/20/2016 09:00:00 PM,48,-122,2,2,4
23158,58thStGreenway22ndAve,10/20/2016 10:00:00 PM,48,-122,1,0,1
23159,58thStGreenway22ndAve,10/20/2016 11:00:00 PM,48,-122,1,0,1
23160,58thStGreenway22ndAve,10/21/2016 12:00:00 AM,48,-122,0,1,1
23161,58thStGreenway22ndAve,10/21/2016 01:00:00 AM,48,-122,0,0,0
23162,58thStGreenway22ndAve,10/21/2016 02:00:00 AM,48,-122,0,0,0
23163,58thStGreenway22ndAve,10/21/2016 03:00:00 AM,48,-122,0,0,0
23164,58thStGreenway22ndAve,10/21/2016 04:00:00 AM,48,-122,0,0,0
23165,58thStGreenway22ndAve,10/21/2016 05:00:00 AM,48,-122,0,0,0
23166,58thStGreenway22ndAve,10/21/2016 06:00:00 AM,48,-122,2,0,2
23167,58thStGreenway22ndAve,10/21/2016 07:00:00 AM,48,-122,1,1,2
23168,58thStGreenway22ndAve,10/21/2016 08:00:00 AM,48,-122,2,8,10
23169,58thStGreenway22ndAve,10/21/2016 09:00:00 AM,48,-122,1,9,10
23170,58thStGreenway22ndAve,10/21/2016 10:00:00 AM,48,-122,2,2,4
23171,58thStGreenway22ndAve,10/21/2016 11:00:00 AM,48,-122,4,8,12
23172,58thStGreenway22ndAve,10/21/2016 12:00:00 PM,48,-122,2,6,8
23173,58thStGreenway22ndAve,10/21/2016 01:00:00 PM,48,-122,5,6,11
23174,58thStGreenway22ndAve,10/21/2016 02:00:00 PM,48,-122,7,7,14
23175,58thStGreenway22ndAve,10/21/2016 03:00:00 PM,48,-122,7,8,15
23176,58thStGreenway22ndAve,10/21/2016 04:00:00 PM,48,-122,7,4,11
23177,58thStGreenway22ndAve,10/21/2016 05:00:00 PM,48,-122,7,2,9
23178,58thStGreenway22ndAve,10/21/2016 06:00:00 PM,48,-122,4,6,10
23179,58thStGreenway22ndAve,10/21/2016 07:00:00 PM,48,-122,5,4,9
23180,58thStGreenway22ndAve,10/21/2016 08:00:00 PM,48,-122,2,1,3
23181,58thStGreenway22ndAve,10/21/2016 09:00:00 PM,48,-122,4,2,6
23182,58thStGreenway22ndAve,10/21/2016 10:00:00 PM,48,-122,0,0,0
23183,58thStGreenway22ndAve,10/21/2016 11:00:00 PM,48,-122,1,0,1
23184,58thStGreenway22ndAve,10/22/2016 12:00:00 AM,48,-122,0,0,0
23185,58thStGreenway22ndAve,10/22/2016 01:00:00 AM,48,-122,0,0,0
23186,58thStGreenway22ndAve,10/22/2016 02:00:00 AM,48,-122,1,0,1
23187,58thStGreenway22ndAve,10/22/2016 03:00:00 AM,48,-122,0,0,0
23188,58thStGreenway22ndAve,10/22/2016 04:00:00 AM,48,-122,0,0,0
23189,58thStGreenway22ndAve,10/22/2016 05:00:00 AM,48,-122,0,0,0
23190,58thStGreenway22ndAve,10/22/2016 06:00:00 AM,48,-122,0,1,1
23191,58thStGreenway22ndAve,10/22/2016 07:00:00 AM,48,-122,0,1,1
23192,58thStGreenway22ndAve,10/22/2016 08:00:00 AM,48,-122,1,2,3
23193,58thStGreenway22ndAve,10/22/2016 09:00:00 AM,48,-122,2,5,7
23194,58thStGreenway22ndAve,10/22/2016 10:00:00 AM,48,-122,6,9,15
23195,58thStGreenway22ndAve,10/22/2016 11:00:00 AM,48,-122,5,4,9
23196,58thStGreenway22ndAve,10/22/2016 12:00:00 PM,48,-122,2,5,7
23197,58thStGreenway22ndAve,10/22/2016 01:00:00 PM,48,-122,5,6,11
23198,58thStGreenway22ndAve,10/22/2016 02:00:00 PM,48,-122,7,3,10
23199,58thStGreenway22ndAve,10/22/2016 03:00:00 PM,48,-122,7,9,16
23200,58thStGreenway22ndAve,10/22/2016 04:00:00 PM,48,-122,8,9,17
23201,58thStGreenway22ndAve,10/22/2016 05:00:00 PM,48,-122,3,5,8
23202,58thStGreenway22ndAve,10/22/2016 06:00:00 PM,48,-122,4,2,6
23203,58thStGreenway22ndAve,10/22/2016 07:00:00 PM,48,-122,2,2,4
23204,58thStGreenway22ndAve,10/22/2016 08:00:00 PM,48,-122,0,2,2
23205,58thStGreenway22ndAve,10/22/2016 09:00:00 PM,48,-122,0,3,3
23206,58thStGreenway22ndAve,10/22/2016 10:00:00 PM,48,-122,0,1,1
23207,58thStGreenway22ndAve,10/22/2016 11:00:00 PM,48,-122,0,2,2
23208,58thStGreenway22ndAve,10/23/2016 12:00:00 AM,48,-122,3,0,3
23209,58thStGreenway22ndAve,10/23/2016 01:00:00 AM,48,-122,0,0,0
23210,58thStGreenway22ndAve,10/23/2016 02:00:00 AM,48,-122,0,0,0
23211,58thStGreenway22ndAve,10/23/2016 03:00:00 AM,48,-122,0,0,0
23212,58thStGreenway22ndAve,10/23/2016 04:00:00 AM,48,-122,0,0,0
23213,58thStGreenway22ndAve,10/23/2016 05:00:00 AM,48,-122,0,0,0
23214,58thStGreenway22ndAve,10/23/2016 06:00:00 AM,48,-122,0,2,2
23215,58thStGreenway22ndAve,10/23/2016 07:00:00 AM,48,-122,0,0,0
23216,58thStGreenway22ndAve,10/23/2016 08:00:00 AM,48,-122,2,1,3
23217,58thStGreenway22ndAve,10/23/2016 09:00:00 AM,48,-122,5,2,7
23218,58thStGreenway22ndAve,10/23/2016 10:00:00 AM,48,-122,2,4,6
23219,58thStGreenway22ndAve,10/23/2016 11:00:00 AM,48,-122,1,8,9
23220,58thStGreenway22ndAve,10/23/2016 12:00:00 PM,48,-122,3,12,15
23221,58thStGreenway22ndAve,10/23/2016 01:00:00 PM,48,-122,9,8,17
23222,58thStGreenway22ndAve,10/23/2016 02:00:00 PM,48,-122,11,7,18
23223,58thStGreenway22ndAve,10/23/2016 03:00:00 PM,48,-122,6,7,13
23224,58thStGreenway22ndAve,10/23/2016 04:00:00 PM,48,-122,5,3,8
23225,58thStGreenway22ndAve,10/23/2016 05:00:00 PM,48,-122,3,1,4
23226,58thStGreenway22ndAve,10/23/2016 06:00:00 PM,48,-122,3,1,4
23227,58thStGreenway22ndAve,10/23/2016 07:00:00 PM,48,-122,1,1,2
23228,58thStGreenway22ndAve,10/23/2016 08:00:00 PM,48,-122,0,0,0
23229,58thStGreenway22ndAve,10/23/2016 09:00:00 PM,48,-122,3,1,4
23230,58thStGreenway22ndAve,10/23/2016 10:00:00 PM,48,-122,1,1,2
23231,58thStGreenway22ndAve,10/23/2016 11:00:00 PM,48,-122,0,0,0
23232,58thStGreenway22ndAve,10/24/2016 12:00:00 AM,48,-122,0,0,0
23233,58thStGreenway22ndAve,10/24/2016 01:00:00 AM,48,-122,0,0,0
23234,58thStGreenway22ndAve,10/24/2016 02:00:00 AM,48,-122,0,0,0
23235,58thStGreenway22ndAve,10/24/2016 03:00:00 AM,48,-122,0,0,0
23236,58thStGreenway22ndAve,10/24/2016 04:00:00 AM,48,-122,0,0,0
23237,58thStGreenway22ndAve,10/24/2016 05:00:00 AM,48,-122,1,1,2
23238,58thStGreenway22ndAve,10/24/2016 06:00:00 AM,48,-122,0,3,3
23239,58thStGreenway22ndAve,10/24/2016 07:00:00 AM,48,-122,4,5,9
23240,58thStGreenway22ndAve,10/24/2016 08:00:00 AM,48,-122,3,4,7
23241,58thStGreenway22ndAve,10/24/2016 09:00:00 AM,48,-122,4,9,13
23242,58thStGreenway22ndAve,10/24/2016 10:00:00 AM,48,-122,5,2,7
23243,58thStGreenway22ndAve,10/24/2016 11:00:00 AM,48,-122,4,2,6
23244,58thStGreenway22ndAve,10/24/2016 12:00:00 PM,48,-122,0,6,6
23245,58thStGreenway22ndAve,10/24/2016 01:00:00 PM,48,-122,5,7,12
23246,58thStGreenway22ndAve,10/24/2016 02:00:00 PM,48,-122,4,7,11
23247,58thStGreenway22ndAve,10/24/2016 03:00:00 PM,48,-122,6,9,15
23248,58thStGreenway22ndAve,10/24/2016 04:00:00 PM,48,-122,4,6,10
23249,58thStGreenway22ndAve,10/24/2016 05:00:00 PM,48,-122,6,7,13
23250,58thStGreenway22ndAve,10/24/2016 06:00:00 PM,48,-122,1,7,8
23251,58thStGreenway22ndAve,10/24/2016 07:00:00 PM,48,-122,2,4,6
23252,58thStGreenway22ndAve,10/24/2016 08:00:00 PM,48,-122,3,1,4
23253,58thStGreenway22ndAve,10/24/2016 09:00:00 PM,48,-122,2,3,5
23254,58thStGreenway22ndAve,10/24/2016 10:00:00 PM,48,-122,1,1,2
23255,58thStGreenway22ndAve,10/24/2016 11:00:00 PM,48,-122,0,0,0
23256,58thStGreenway22ndAve,10/25/2016 12:00:00 AM,48,-122,1,0,1
23257,58thStGreenway22ndAve,10/25/2016 01:00:00 AM,48,-122,0,0,0
23258,58thStGreenway22ndAve,10/25/2016 02:00:00 AM,48,-122,0,0,0
23259,58thStGreenway22ndAve,10/25/2016 03:00:00 AM,48,-122,0,0,0
23260,58thStGreenway22ndAve,10/25/2016 04:00:00 AM,48,-122,0,0,0
23261,58thStGreenway22ndAve,10/25/2016 05:00:00 AM,48,-122,0,1,1
23262,58thStGreenway22ndAve,10/25/2016 06:00:00 AM,48,-122,0,0,0
23263,58thStGreenway22ndAve,10/25/2016 07:00:00 AM,48,-122,7,4,11
23264,58thStGreenway22ndAve,10/25/2016 08:00:00 AM,48,-122,3,7,10
23265,58thStGreenway22ndAve,10/25/2016 09:00:00 AM,48,-122,1,5,6
23266,58thStGreenway22ndAve,10/25/2016 10:00:00 AM,48,-122,1,6,7
23267,58thStGreenway22ndAve,10/25/2016 11:00:00 AM,48,-122,1,1,2
23268,58thStGreenway22ndAve,10/25/2016 12:00:00 PM,48,-122,7,6,13
23269,58thStGreenway22ndAve,10/25/2016 01:00:00 PM,48,-122,3,5,8
23270,58thStGreenway22ndAve,10/25/2016 02:00:00 PM,48,-122,3,6,9
23271,58thStGreenway22ndAve,10/25/2016 03:00:00 PM,48,-122,2,5,7
23272,58thStGreenway22ndAve,10/25/2016 04:00:00 PM,48,-122,4,4,8
23273,58thStGreenway22ndAve,10/25/2016 05:00:00 PM,48,-122,6,15,21
23274,58thStGreenway22ndAve,10/25/2016 06:00:00 PM,48,-122,1,0,1
23275,58thStGreenway22ndAve,10/25/2016 07:00:00 PM,48,-122,0,0,0
23276,58thStGreenway22ndAve,10/25/2016 08:00:00 PM,48,-122,0,0,0
23277,58thStGreenway22ndAve,10/25/2016 09:00:00 PM,48,-122,0,0,0
23278,58thStGreenway22ndAve,10/25/2016 10:00:00 PM,48,-122,0,0,0
23279,58thStGreenway22ndAve,10/25/2016 11:00:00 PM,48,-122,0,0,0
23280,58thStGreenway22ndAve,10/26/2016 12:00:00 AM,48,-122,0,0,0
23281,58thStGreenway22ndAve,10/26/2016 01:00:00 AM,48,-122,0,0,0
23282,58thStGreenway22ndAve,10/26/2016 02:00:00 AM,48,-122,0,0,0
23283,58thStGreenway22ndAve,10/26/2016 03:00:00 AM,48,-122,0,0,0
23284,58thStGreenway22ndAve,10/26/2016 04:00:00 AM,48,-122,0,0,0
23285,58thStGreenway22ndAve,10/26/2016 05:00:00 AM,48,-122,0,0,0
23286,58thStGreenway22ndAve,10/26/2016 06:00:00 AM,48,-122,0,0,0
23287,58thStGreenway22ndAve,10/26/2016 07:00:00 AM,48,-122,4,2,6
23288,58thStGreenway22ndAve,10/26/2016 08:00:00 AM,48,-122,3,5,8
23289,58thStGreenway22ndAve,10/26/2016 09:00:00 AM,48,-122,1,6,7
23290,58thStGreenway22ndAve,10/26/2016 10:00:00 AM,48,-122,0,4,4
23291,58thStGreenway22ndAve,10/26/2016 11:00:00 AM,48,-122,1,2,3
23292,58thStGreenway22ndAve,10/26/2016 12:00:00 PM,48,-122,3,2,5
23293,58thStGreenway22ndAve,10/26/2016 01:00:00 PM,48,-122,0,4,4
23294,58thStGreenway22ndAve,10/26/2016 02:00:00 PM,48,-122,1,5,6
23295,58thStGreenway22ndAve,10/26/2016 03:00:00 PM,48,-122,4,3,7
23296,58thStGreenway22ndAve,10/26/2016 04:00:00 PM,48,-122,3,5,8
23297,58thStGreenway22ndAve,10/26/2016 05:00:00 PM,48,-122,3,7,10
23298,58thStGreenway22ndAve,10/26/2016 06:00:00 PM,48,-122,2,3,5
23299,58thStGreenway22ndAve,10/26/2016 07:00:00 PM,48,-122,4,9,13
23300,58thStGreenway22ndAve,10/26/2016 08:00:00 PM,48,-122,0,1,1
23301,58thStGreenway22ndAve,10/26/2016 09:00:00 PM,48,-122,0,1,1
23302,58thStGreenway22ndAve,10/26/2016 10:00:00 PM,48,-122,0,2,2
23303,58thStGreenway22ndAve,10/26/2016 11:00:00 PM,48,-122,2,1,3
23304,58thStGreenway22ndAve,10/27/2016 12:00:00 AM,48,-122,0,0,0
23305,58thStGreenway22ndAve,10/27/2016 01:00:00 AM,48,-122,0,0,0
23306,58thStGreenway22ndAve,10/27/2016 02:00:00 AM,48,-122,0,0,0
23307,58thStGreenway22ndAve,10/27/2016 03:00:00 AM,48,-122,0,2,2
23308,58thStGreenway22ndAve,10/27/2016 04:00:00 AM,48,-122,0,0,0
23309,58thStGreenway22ndAve,10/27/2016 05:00:00 AM,48,-122,0,1,1
23310,58thStGreenway22ndAve,10/27/2016 06:00:00 AM,48,-122,0,0,0
23311,58thStGreenway22ndAve,10/27/2016 07:00:00 AM,48,-122,2,3,5
23312,58thStGreenway22ndAve,10/27/2016 08:00:00 AM,48,-122,1,4,5
23313,58thStGreenway22ndAve,10/27/2016 09:00:00 AM,48,-122,5,6,11
23314,58thStGreenway22ndAve,10/27/2016 10:00:00 AM,48,-122,1,4,5
23315,58thStGreenway22ndAve,10/27/2016 11:00:00 AM,48,-122,2,3,5
23316,58thStGreenway22ndAve,10/27/2016 12:00:00 PM,48,-122,3,1,4
23317,58thStGreenway22ndAve,10/27/2016 01:00:00 PM,48,-122,3,7,10
23318,58thStGreenway22ndAve,10/27/2016 02:00:00 PM,48,-122,2,0,2
23319,58thStGreenway22ndAve,10/27/2016 03:00:00 PM,48,-122,4,7,11
23320,58thStGreenway22ndAve,10/27/2016 04:00:00 PM,48,-122,2,8,10
23321,58thStGreenway22ndAve,10/27/2016 05:00:00 PM,48,-122,7,9,16
23322,58thStGreenway22ndAve,10/27/2016 06:00:00 PM,48,-122,6,8,14
23323,58thStGreenway22ndAve,10/27/2016 07:00:00 PM,48,-122,5,2,7
23324,58thStGreenway22ndAve,10/27/2016 08:00:00 PM,48,-122,1,1,2
23325,58thStGreenway22ndAve,10/27/2016 09:00:00 PM,48,-122,1,3,4
23326,58thStGreenway22ndAve,10/27/2016 10:00:00 PM,48,-122,1,1,2
23327,58thStGreenway22ndAve,10/27/2016 11:00:00 PM,48,-122,0,1,1
23328,58thStGreenway22ndAve,10/28/2016 12:00:00 AM,48,-122,1,0,1
23329,58thStGreenway22ndAve,10/28/2016 01:00:00 AM,48,-122,0,0,0
23330,58thStGreenway22ndAve,10/28/2016 02:00:00 AM,48,-122,0,1,1
23331,58thStGreenway22ndAve,10/28/2016 03:00:00 AM,48,-122,0,0,0
23332,58thStGreenway22ndAve,10/28/2016 04:00:00 AM,48,-122,0,0,0
23333,58thStGreenway22ndAve,10/28/2016 05:00:00 AM,48,-122,0,0,0
23334,58thStGreenway22ndAve,10/28/2016 06:00:00 AM,48,-122,3,0,3
23335,58thStGreenway22ndAve,10/28/2016 07:00:00 AM,48,-122,4,1,5
23336,58thStGreenway22ndAve,10/28/2016 08:00:00 AM,48,-122,2,6,8
23337,58thStGreenway22ndAve,10/28/2016 09:00:00 AM,48,-122,1,4,5
23338,58thStGreenway22ndAve,10/28/2016 10:00:00 AM,48,-122,5,4,9
23339,58thStGreenway22ndAve,10/28/2016 11:00:00 AM,48,-122,1,6,7
23340,58thStGreenway22ndAve,10/28/2016 12:00:00 PM,48,-122,0,3,3
23341,58thStGreenway22ndAve,10/28/2016 01:00:00 PM,48,-122,4,7,11
23342,58thStGreenway22ndAve,10/28/2016 02:00:00 PM,48,-122,3,4,7
23343,58thStGreenway22ndAve,10/28/2016 03:00:00 PM,48,-122,5,7,12
23344,58thStGreenway22ndAve,10/28/2016 04:00:00 PM,48,-122,12,9,21
23345,58thStGreenway22ndAve,10/28/2016 05:00:00 PM,48,-122,1,1,2
23346,58thStGreenway22ndAve,10/28/2016 06:00:00 PM,48,-122,0,0,0
23347,58thStGreenway22ndAve,10/28/2016 07:00:00 PM,48,-122,0,0,0
23348,58thStGreenway22ndAve,10/28/2016 08:00:00 PM,48,-122,0,0,0
23349,58thStGreenway22ndAve,10/28/2016 09:00:00 PM,48,-122,0,0,0
23350,58thStGreenway22ndAve,10/28/2016 10:00:00 PM,48,-122,0,0,0
23351,58thStGreenway22ndAve,10/28/2016 11:00:00 PM,48,-122,0,0,0
23352,58thStGreenway22ndAve,10/29/2016 12:00:00 AM,48,-122,0,0,0
23353,58thStGreenway22ndAve,10/29/2016 01:00:00 AM,48,-122,0,0,0
23354,58thStGreenway22ndAve,10/29/2016 02:00:00 AM,48,-122,0,0,0
23355,58thStGreenway22ndAve,10/29/2016 03:00:00 AM,48,-122,0,0,0
23356,58thStGreenway22ndAve,10/29/2016 04:00:00 AM,48,-122,0,0,0
23357,58thStGreenway22ndAve,10/29/2016 05:00:00 AM,48,-122,0,0,0
23358,58thStGreenway22ndAve,10/29/2016 06:00:00 AM,48,-122,0,0,0
23359,58thStGreenway22ndAve,10/29/2016 07:00:00 AM,48,-122,1,1,2
23360,58thStGreenway22ndAve,10/29/2016 08:00:00 AM,48,-122,0,0,0
23361,58thStGreenway22ndAve,10/29/2016 09:00:00 AM,48,-122,2,1,3
23362,58thStGreenway22ndAve,10/29/2016 10:00:00 AM,48,-122,2,7,9
23363,58thStGreenway22ndAve,10/29/2016 11:00:00 AM,48,-122,0,4,4
23364,58thStGreenway22ndAve,10/29/2016 12:00:00 PM,48,-122,2,4,6
23365,58thStGreenway22ndAve,10/29/2016 01:00:00 PM,48,-122,2,4,6
23366,58thStGreenway22ndAve,10/29/2016 02:00:00 PM,48,-122,4,3,7
23367,58thStGreenway22ndAve,10/29/2016 03:00:00 PM,48,-122,4,8,12
23368,58thStGreenway22ndAve,10/29/2016 04:00:00 PM,48,-122,2,3,5
23369,58thStGreenway22ndAve,10/29/2016 05:00:00 PM,48,-122,3,6,9
23370,58thStGreenway22ndAve,10/29/2016 06:00:00 PM,48,-122,2,6,8
23371,58thStGreenway22ndAve,10/29/2016 07:00:00 PM,48,-122,2,3,5
23372,58thStGreenway22ndAve,10/29/2016 08:00:00 PM,48,-122,4,5,9
23373,58thStGreenway22ndAve,10/29/2016 09:00:00 PM,48,-122,2,4,6
23374,58thStGreenway22ndAve,10/29/2016 10:00:00 PM,48,-122,2,3,5
23375,58thStGreenway22ndAve,10/29/2016 11:00:00 PM,48,-122,2,0,2
23376,58thStGreenway22ndAve,10/30/2016 12:00:00 AM,48,-122,0,1,1
23377,58thStGreenway22ndAve,10/30/2016 01:00:00 AM,48,-122,0,2,2
23378,58thStGreenway22ndAve,10/30/2016 02:00:00 AM,48,-122,1,0,1
23379,58thStGreenway22ndAve,10/30/2016 03:00:00 AM,48,-122,0,0,0
23380,58thStGreenway22ndAve,10/30/2016 04:00:00 AM,48,-122,0,0,0
23381,58thStGreenway22ndAve,10/30/2016 05:00:00 AM,48,-122,0,0,0
23382,58thStGreenway22ndAve,10/30/2016 06:00:00 AM,48,-122,0,0,0
23383,58thStGreenway22ndAve,10/30/2016 07:00:00 AM,48,-122,0,1,1
23384,58thStGreenway22ndAve,10/30/2016 08:00:00 AM,48,-122,0,0,0
23385,58thStGreenway22ndAve,10/30/2016 09:00:00 AM,48,-122,0,1,1
23386,58thStGreenway22ndAve,10/30/2016 10:00:00 AM,48,-122,2,12,14
23387,58thStGreenway22ndAve,10/30/2016 11:00:00 AM,48,-122,4,1,5
23388,58thStGreenway22ndAve,10/30/2016 12:00:00 PM,48,-122,4,8,12
23389,58thStGreenway22ndAve,10/30/2016 01:00:00 PM,48,-122,2,4,6
23390,58thStGreenway22ndAve,10/30/2016 02:00:00 PM,48,-122,1,4,5
23391,58thStGreenway22ndAve,10/30/2016 03:00:00 PM,48,-122,3,7,10
23392,58thStGreenway22ndAve,10/30/2016 04:00:00 PM,48,-122,3,5,8
23393,58thStGreenway22ndAve,10/30/2016 05:00:00 PM,48,-122,1,2,3
23394,58thStGreenway22ndAve,10/30/2016 06:00:00 PM,48,-122,2,2,4
23395,58thStGreenway22ndAve,10/30/2016 07:00:00 PM,48,-122,2,1,3
23396,58thStGreenway22ndAve,10/30/2016 08:00:00 PM,48,-122,2,1,3
23397,58thStGreenway22ndAve,10/30/2016 09:00:00 PM,48,-122,1,0,1
23398,58thStGreenway22ndAve,10/30/2016 10:00:00 PM,48,-122,0,2,2
23399,58thStGreenway22ndAve,10/30/2016 11:00:00 PM,48,-122,0,0,0
23400,58thStGreenway22ndAve,10/31/2016 12:00:00 AM,48,-122,0,1,1
23401,58thStGreenway22ndAve,10/31/2016 01:00:00 AM,48,-122,0,0,0
23402,58thStGreenway22ndAve,10/31/2016 02:00:00 AM,48,-122,0,0,0
23403,58thStGreenway22ndAve,10/31/2016 03:00:00 AM,48,-122,0,0,0
23404,58thStGreenway22ndAve,10/31/2016 04:00:00 AM,48,-122,0,0,0
23405,58thStGreenway22ndAve,10/31/2016 05:00:00 AM,48,-122,0,1,1
23406,58thStGreenway22ndAve,10/31/2016 06:00:00 AM,48,-122,2,0,2
23407,58thStGreenway22ndAve,10/31/2016 07:00:00 AM,48,-122,5,3,8
23408,58thStGreenway22ndAve,10/31/2016 08:00:00 AM,48,-122,3,1,4
23409,58thStGreenway22ndAve,10/31/2016 09:00:00 AM,48,-122,1,1,2
23410,58thStGreenway22ndAve,10/31/2016 10:00:00 AM,48,-122,0,0,0
23411,58thStGreenway22ndAve,10/31/2016 11:00:00 AM,48,-122,2,7,9
23412,58thStGreenway22ndAve,10/31/2016 12:00:00 PM,48,-122,1,6,7
23413,58thStGreenway22ndAve,10/31/2016 01:00:00 PM,48,-122,3,6,9
23414,58thStGreenway22ndAve,10/31/2016 02:00:00 PM,48,-122,4,5,9
23415,58thStGreenway22ndAve,10/31/2016 03:00:00 PM,48,-122,3,2,5
23416,58thStGreenway22ndAve,10/31/2016 04:00:00 PM,48,-122,3,9,12
23417,58thStGreenway22ndAve,10/31/2016 05:00:00 PM,48,-122,2,6,8
23418,58thStGreenway22ndAve,10/31/2016 06:00:00 PM,48,-122,1,4,5
23419,58thStGreenway22ndAve,10/31/2016 07:00:00 PM,48,-122,3,1,4
23420,58thStGreenway22ndAve,10/31/2016 08:00:00 PM,48,-122,1,2,3
23421,58thStGreenway22ndAve,10/31/2016 09:00:00 PM,48,-122,1,2,3
23422,58thStGreenway22ndAve,10/31/2016 10:00:00 PM,48,-122,1,0,1
23423,58thStGreenway22ndAve,10/31/2016 11:00:00 PM,48,-122,2,1,3
23424,58thStGreenway22ndAve,11/01/2016 12:00:00 AM,48,-122,0,0,0
23425,58thStGreenway22ndAve,11/01/2016 01:00:00 AM,48,-122,0,0,0
23426,58thStGreenway22ndAve,11/01/2016 02:00:00 AM,48,-122,0,0,0
23427,58thStGreenway22ndAve,11/01/2016 03:00:00 AM,48,-122,0,1,1
23428,58thStGreenway22ndAve,11/01/2016 04:00:00 AM,48,-122,0,0,0
23429,58thStGreenway22ndAve,11/01/2016 05:00:00 AM,48,-122,0,1,1
23430,58thStGreenway22ndAve,11/01/2016 06:00:00 AM,48,-122,0,0,0
23431,58thStGreenway22ndAve,11/01/2016 07:00:00 AM,48,-122,3,2,5
23432,58thStGreenway22ndAve,11/01/2016 08:00:00 AM,48,-122,4,1,5
23433,58thStGreenway22ndAve,11/01/2016 09:00:00 AM,48,-122,3,8,11
23434,58thStGreenway22ndAve,11/01/2016 10:00:00 AM,48,-122,2,1,3
23435,58thStGreenway22ndAve,11/01/2016 11:00:00 AM,48,-122,2,2,4
23436,58thStGreenway22ndAve,11/01/2016 12:00:00 PM,48,-122,2,5,7
23437,58thStGreenway22ndAve,11/01/2016 01:00:00 PM,48,-122,4,5,9
23438,58thStGreenway22ndAve,11/01/2016 02:00:00 PM,48,-122,3,7,10
23439,58thStGreenway22ndAve,11/01/2016 03:00:00 PM,48,-122,1,9,10
23440,58thStGreenway22ndAve,11/01/2016 04:00:00 PM,48,-122,2,6,8
23441,58thStGreenway22ndAve,11/01/2016 05:00:00 PM,48,-122,8,6,14
23442,58thStGreenway22ndAve,11/01/2016 06:00:00 PM,48,-122,2,2,4
23443,58thStGreenway22ndAve,11/01/2016 07:00:00 PM,48,-122,1,7,8
23444,58thStGreenway22ndAve,11/01/2016 08:00:00 PM,48,-122,0,1,1
23445,58thStGreenway22ndAve,11/01/2016 09:00:00 PM,48,-122,3,0,3
23446,58thStGreenway22ndAve,11/01/2016 10:00:00 PM,48,-122,1,0,1
23447,58thStGreenway22ndAve,11/01/2016 11:00:00 PM,48,-122,0,1,1
23448,58thStGreenway22ndAve,11/02/2016 12:00:00 AM,48,-122,0,0,0
23449,58thStGreenway22ndAve,11/02/2016 01:00:00 AM,48,-122,0,0,0
23450,58thStGreenway22ndAve,11/02/2016 02:00:00 AM,48,-122,0,0,0
23451,58thStGreenway22ndAve,11/02/2016 03:00:00 AM,48,-122,1,0,1
23452,58thStGreenway22ndAve,11/02/2016 04:00:00 AM,48,-122,0,0,0
23453,58thStGreenway22ndAve,11/02/2016 05:00:00 AM,48,-122,1,2,3
23454,58thStGreenway22ndAve,11/02/2016 06:00:00 AM,48,-122,3,1,4
23455,58thStGreenway22ndAve,11/02/2016 07:00:00 AM,48,-122,2,4,6
23456,58thStGreenway22ndAve,11/02/2016 08:00:00 AM,48,-122,5,3,8
23457,58thStGreenway22ndAve,11/02/2016 09:00:00 AM,48,-122,5,5,10
23458,58thStGreenway22ndAve,11/02/2016 10:00:00 AM,48,-122,0,3,3
23459,58thStGreenway22ndAve,11/02/2016 11:00:00 AM,48,-122,4,5,9
23460,58thStGreenway22ndAve,11/02/2016 12:00:00 PM,48,-122,1,3,4
23461,58thStGreenway22ndAve,11/02/2016 01:00:00 PM,48,-122,4,4,8
23462,58thStGreenway22ndAve,11/02/2016 02:00:00 PM,48,-122,2,2,4
23463,58thStGreenway22ndAve,11/02/2016 03:00:00 PM,48,-122,6,4,10
23464,58thStGreenway22ndAve,11/02/2016 04:00:00 PM,48,-122,5,14,19
23465,58thStGreenway22ndAve,11/02/2016 05:00:00 PM,48,-122,6,12,18
23466,58thStGreenway22ndAve,11/02/2016 06:00:00 PM,48,-122,3,7,10
23467,58thStGreenway22ndAve,11/02/2016 07:00:00 PM,48,-122,2,10,12
23468,58thStGreenway22ndAve,11/02/2016 08:00:00 PM,48,-122,4,3,7
23469,58thStGreenway22ndAve,11/02/2016 09:00:00 PM,48,-122,2,1,3
23470,58thStGreenway22ndAve,11/02/2016 10:00:00 PM,48,-122,1,1,2
23471,58thStGreenway22ndAve,11/02/2016 11:00:00 PM,48,-122,0,0,0
23472,58thStGreenway22ndAve,11/03/2016 12:00:00 AM,48,-122,0,1,1
23473,58thStGreenway22ndAve,11/03/2016 01:00:00 AM,48,-122,0,1,1
23474,58thStGreenway22ndAve,11/03/2016 02:00:00 AM,48,-122,0,0,0
23475,58thStGreenway22ndAve,11/03/2016 03:00:00 AM,48,-122,0,1,1
23476,58thStGreenway22ndAve,11/03/2016 04:00:00 AM,48,-122,0,0,0
23477,58thStGreenway22ndAve,11/03/2016 05:00:00 AM,48,-122,0,1,1
23478,58thStGreenway22ndAve,11/03/2016 06:00:00 AM,48,-122,1,1,2
23479,58thStGreenway22ndAve,11/03/2016 07:00:00 AM,48,-122,3,2,5
23480,58thStGreenway22ndAve,11/03/2016 08:00:00 AM,48,-122,3,5,8
23481,58thStGreenway22ndAve,11/03/2016 09:00:00 AM,48,-122,2,2,4
23482,58thStGreenway22ndAve,11/03/2016 10:00:00 AM,48,-122,4,4,8
23483,58thStGreenway22ndAve,11/03/2016 11:00:00 AM,48,-122,2,10,12
23484,58thStGreenway22ndAve,11/03/2016 12:00:00 PM,48,-122,2,5,7
23485,58thStGreenway22ndAve,11/03/2016 01:00:00 PM,48,-122,4,5,9
23486,58thStGreenway22ndAve,11/03/2016 02:00:00 PM,48,-122,6,11,17
23487,58thStGreenway22ndAve,11/03/2016 03:00:00 PM,48,-122,7,11,18
23488,58thStGreenway22ndAve,11/03/2016 04:00:00 PM,48,-122,5,12,17
23489,58thStGreenway22ndAve,11/03/2016 05:00:00 PM,48,-122,14,7,21
23490,58thStGreenway22ndAve,11/03/2016 06:00:00 PM,48,-122,8,7,15
23491,58thStGreenway22ndAve,11/03/2016 07:00:00 PM,48,-122,3,4,7
23492,58thStGreenway22ndAve,11/03/2016 08:00:00 PM,48,-122,0,1,1
23493,58thStGreenway22ndAve,11/03/2016 09:00:00 PM,48,-122,2,1,3
23494,58thStGreenway22ndAve,11/03/2016 10:00:00 PM,48,-122,0,0,0
23495,58thStGreenway22ndAve,11/03/2016 11:00:00 PM,48,-122,0,1,1
23496,58thStGreenway22ndAve,11/04/2016 12:00:00 AM,48,-122,0,0,0
23497,58thStGreenway22ndAve,11/04/2016 01:00:00 AM,48,-122,0,0,0
23498,58thStGreenway22ndAve,11/04/2016 02:00:00 AM,48,-122,0,0,0
23499,58thStGreenway22ndAve,11/04/2016 03:00:00 AM,48,-122,0,0,0
23500,58thStGreenway22ndAve,11/04/2016 04:00:00 AM,48,-122,0,0,0
23501,58thStGreenway22ndAve,11/04/2016 05:00:00 AM,48,-122,0,1,1
23502,58thStGreenway22ndAve,11/04/2016 06:00:00 AM,48,-122,3,1,4
23503,58thStGreenway22ndAve,11/04/2016 07:00:00 AM,48,-122,4,2,6
23504,58thStGreenway22ndAve,11/04/2016 08:00:00 AM,48,-122,4,12,16
23505,58thStGreenway22ndAve,11/04/2016 09:00:00 AM,48,-122,4,5,9
23506,58thStGreenway22ndAve,11/04/2016 10:00:00 AM,48,-122,3,6,9
23507,58thStGreenway22ndAve,11/04/2016 11:00:00 AM,48,-122,0,10,10
23508,58thStGreenway22ndAve,11/04/2016 12:00:00 PM,48,-122,4,11,15
23509,58thStGreenway22ndAve,11/04/2016 01:00:00 PM,48,-122,5,6,11
23510,58thStGreenway22ndAve,11/04/2016 02:00:00 PM,48,-122,4,3,7
23511,58thStGreenway22ndAve,11/04/2016 03:00:00 PM,48,-122,2,11,13
23512,58thStGreenway22ndAve,11/04/2016 04:00:00 PM,48,-122,9,8,17
23513,58thStGreenway22ndAve,11/04/2016 05:00:00 PM,48,-122,5,10,15
23514,58thStGreenway22ndAve,11/04/2016 06:00:00 PM,48,-122,6,12,18
23515,58thStGreenway22ndAve,11/04/2016 07:00:00 PM,48,-122,4,8,12
23516,58thStGreenway22ndAve,11/04/2016 08:00:00 PM,48,-122,2,1,3
23517,58thStGreenway22ndAve,11/04/2016 09:00:00 PM,48,-122,2,3,5
23518,58thStGreenway22ndAve,11/04/2016 10:00:00 PM,48,-122,0,0,0
23519,58thStGreenway22ndAve,11/04/2016 11:00:00 PM,48,-122,2,0,2
23520,58thStGreenway22ndAve,11/05/2016 12:00:00 AM,48,-122,0,2,2
23521,58thStGreenway22ndAve,11/05/2016 01:00:00 AM,48,-122,2,0,2
23522,58thStGreenway22ndAve,11/05/2016 02:00:00 AM,48,-122,1,0,1
23523,58thStGreenway22ndAve,11/05/2016 03:00:00 AM,48,-122,0,1,1
23524,58thStGreenway22ndAve,11/05/2016 04:00:00 AM,48,-122,0,0,0
23525,58thStGreenway22ndAve,11/05/2016 05:00:00 AM,48,-122,0,0,0
23526,58thStGreenway22ndAve,11/05/2016 06:00:00 AM,48,-122,0,3,3
23527,58thStGreenway22ndAve,11/05/2016 07:00:00 AM,48,-122,1,0,1
23528,58thStGreenway22ndAve,11/05/2016 08:00:00 AM,48,-122,0,3,3
23529,58thStGreenway22ndAve,11/05/2016 09:00:00 AM,48,-122,2,2,4
23530,58thStGreenway22ndAve,11/05/2016 10:00:00 AM,48,-122,2,4,6
23531,58thStGreenway22ndAve,11/05/2016 11:00:00 AM,48,-122,2,7,9
23532,58thStGreenway22ndAve,11/05/2016 12:00:00 PM,48,-122,1,5,6
23533,58thStGreenway22ndAve,11/05/2016 01:00:00 PM,48,-122,7,9,16
23534,58thStGreenway22ndAve,11/05/2016 02:00:00 PM,48,-122,3,7,10
23535,58thStGreenway22ndAve,11/05/2016 03:00:00 PM,48,-122,2,4,6
23536,58thStGreenway22ndAve,11/05/2016 04:00:00 PM,48,-122,3,5,8
23537,58thStGreenway22ndAve,11/05/2016 05:00:00 PM,48,-122,2,8,10
23538,58thStGreenway22ndAve,11/05/2016 06:00:00 PM,48,-122,1,6,7
23539,58thStGreenway22ndAve,11/05/2016 07:00:00 PM,48,-122,1,3,4
23540,58thStGreenway22ndAve,11/05/2016 08:00:00 PM,48,-122,2,1,3
23541,58thStGreenway22ndAve,11/05/2016 09:00:00 PM,48,-122,1,0,1
23542,58thStGreenway22ndAve,11/05/2016 10:00:00 PM,48,-122,0,0,0
23543,58thStGreenway22ndAve,11/05/2016 11:00:00 PM,48,-122,1,0,1
23544,58thStGreenway22ndAve,11/06/2016 12:00:00 AM,48,-122,0,0,0
23545,58thStGreenway22ndAve,11/06/2016 01:00:00 AM,48,-122,0,1,1
23546,58thStGreenway22ndAve,11/06/2016 02:00:00 AM,48,-122,0,0,0
23547,58thStGreenway22ndAve,11/06/2016 03:00:00 AM,48,-122,1,0,1
23548,58thStGreenway22ndAve,11/06/2016 04:00:00 AM,48,-122,0,0,0
23549,58thStGreenway22ndAve,11/06/2016 05:00:00 AM,48,-122,0,0,0
23550,58thStGreenway22ndAve,11/06/2016 06:00:00 AM,48,-122,0,1,1
23551,58thStGreenway22ndAve,11/06/2016 07:00:00 AM,48,-122,0,1,1
23552,58thStGreenway22ndAve,11/06/2016 08:00:00 AM,48,-122,2,5,7
23553,58thStGreenway22ndAve,11/06/2016 09:00:00 AM,48,-122,4,4,8
23554,58thStGreenway22ndAve,11/06/2016 10:00:00 AM,48,-122,0,8,8
23555,58thStGreenway22ndAve,11/06/2016 11:00:00 AM,48,-122,9,12,21
23556,58thStGreenway22ndAve,11/06/2016 12:00:00 PM,48,-122,1,17,18
23557,58thStGreenway22ndAve,11/06/2016 01:00:00 PM,48,-122,4,12,16
23558,58thStGreenway22ndAve,11/06/2016 02:00:00 PM,48,-122,7,5,12
23559,58thStGreenway22ndAve,11/06/2016 03:00:00 PM,48,-122,9,13,22
23560,58thStGreenway22ndAve,11/06/2016 04:00:00 PM,48,-122,6,7,13
23561,58thStGreenway22ndAve,11/06/2016 05:00:00 PM,48,-122,2,4,6
23562,58thStGreenway22ndAve,11/06/2016 06:00:00 PM,48,-122,3,0,3
23563,58thStGreenway22ndAve,11/06/2016 07:00:00 PM,48,-122,0,0,0
23564,58thStGreenway22ndAve,11/06/2016 08:00:00 PM,48,-122,0,0,0
23565,58thStGreenway22ndAve,11/06/2016 09:00:00 PM,48,-122,0,0,0
23566,58thStGreenway22ndAve,11/06/2016 10:00:00 PM,48,-122,0,0,0
23567,58thStGreenway22ndAve,11/06/2016 11:00:00 PM,48,-122,0,0,0
23568,58thStGreenway22ndAve,11/07/2016 12:00:00 AM,48,-122,0,0,0
23569,58thStGreenway22ndAve,11/07/2016 01:00:00 AM,48,-122,0,0,0
23570,58thStGreenway22ndAve,11/07/2016 02:00:00 AM,48,-122,0,0,0
23571,58thStGreenway22ndAve,11/07/2016 03:00:00 AM,48,-122,0,0,0
23572,58thStGreenway22ndAve,11/07/2016 04:00:00 AM,48,-122,0,0,0
23573,58thStGreenway22ndAve,11/07/2016 05:00:00 AM,48,-122,0,0,0
23574,58thStGreenway22ndAve,11/07/2016 06:00:00 AM,48,-122,0,2,2
23575,58thStGreenway22ndAve,11/07/2016 07:00:00 AM,48,-122,4,3,7
23576,58thStGreenway22ndAve,11/07/2016 08:00:00 AM,48,-122,5,7,12
23577,58thStGreenway22ndAve,11/07/2016 09:00:00 AM,48,-122,3,5,8
23578,58thStGreenway22ndAve,11/07/2016 10:00:00 AM,48,-122,2,4,6
23579,58thStGreenway22ndAve,11/07/2016 11:00:00 AM,48,-122,3,3,6
23580,58thStGreenway22ndAve,11/07/2016 12:00:00 PM,48,-122,4,10,14
23581,58thStGreenway22ndAve,11/07/2016 01:00:00 PM,48,-122,2,8,10
23582,58thStGreenway22ndAve,11/07/2016 02:00:00 PM,48,-122,7,2,9
23583,58thStGreenway22ndAve,11/07/2016 03:00:00 PM,48,-122,2,5,7
23584,58thStGreenway22ndAve,11/07/2016 04:00:00 PM,48,-122,8,7,15
23585,58thStGreenway22ndAve,11/07/2016 05:00:00 PM,48,-122,6,2,8
23586,58thStGreenway22ndAve,11/07/2016 06:00:00 PM,48,-122,0,0,0
23587,58thStGreenway22ndAve,11/07/2016 07:00:00 PM,48,-122,0,0,0
23588,58thStGreenway22ndAve,11/07/2016 08:00:00 PM,48,-122,0,0,0
23589,58thStGreenway22ndAve,11/07/2016 09:00:00 PM,48,-122,0,0,0
23590,58thStGreenway22ndAve,11/07/2016 10:00:00 PM,48,-122,0,0,0
23591,58thStGreenway22ndAve,11/07/2016 11:00:00 PM,48,-122,0,0,0
23592,58thStGreenway22ndAve,11/08/2016 12:00:00 AM,48,-122,0,1,1
23593,58thStGreenway22ndAve,11/08/2016 01:00:00 AM,48,-122,0,0,0
23594,58thStGreenway22ndAve,11/08/2016 02:00:00 AM,48,-122,0,1,1
23595,58thStGreenway22ndAve,11/08/2016 03:00:00 AM,48,-122,0,0,0
23596,58thStGreenway22ndAve,11/08/2016 04:00:00 AM,48,-122,0,0,0
23597,58thStGreenway22ndAve,11/08/2016 05:00:00 AM,48,-122,0,2,2
23598,58thStGreenway22ndAve,11/08/2016 06:00:00 AM,48,-122,1,1,2
23599,58thStGreenway22ndAve,11/08/2016 07:00:00 AM,48,-122,2,4,6
23600,58thStGreenway22ndAve,11/08/2016 08:00:00 AM,48,-122,5,10,15
23601,58thStGreenway22ndAve,11/08/2016 09:00:00 AM,48,-122,2,5,7
23602,58thStGreenway22ndAve,11/08/2016 10:00:00 AM,48,-122,9,14,23
23603,58thStGreenway22ndAve,11/08/2016 11:00:00 AM,48,-122,2,3,5
23604,58thStGreenway22ndAve,11/08/2016 12:00:00 PM,48,-122,8,14,22
23605,58thStGreenway22ndAve,11/08/2016 01:00:00 PM,48,-122,3,7,10
23606,58thStGreenway22ndAve,11/08/2016 02:00:00 PM,48,-122,7,5,12
23607,58thStGreenway22ndAve,11/08/2016 03:00:00 PM,48,-122,7,13,20
23608,58thStGreenway22ndAve,11/08/2016 04:00:00 PM,48,-122,9,15,24
23609,58thStGreenway22ndAve,11/08/2016 05:00:00 PM,48,-122,8,7,15
23610,58thStGreenway22ndAve,11/08/2016 06:00:00 PM,48,-122,6,1,7
23611,58thStGreenway22ndAve,11/08/2016 07:00:00 PM,48,-122,9,10,19
23612,58thStGreenway22ndAve,11/08/2016 08:00:00 PM,48,-122,0,1,1
23613,58thStGreenway22ndAve,11/08/2016 09:00:00 PM,48,-122,2,1,3
23614,58thStGreenway22ndAve,11/08/2016 10:00:00 PM,48,-122,1,3,4
23615,58thStGreenway22ndAve,11/08/2016 11:00:00 PM,48,-122,2,1,3
23616,58thStGreenway22ndAve,11/09/2016 12:00:00 AM,48,-122,1,1,2
23617,58thStGreenway22ndAve,11/09/2016 01:00:00 AM,48,-122,0,0,0
23618,58thStGreenway22ndAve,11/09/2016 02:00:00 AM,48,-122,0,2,2
23619,58thStGreenway22ndAve,11/09/2016 03:00:00 AM,48,-122,0,0,0
23620,58thStGreenway22ndAve,11/09/2016 04:00:00 AM,48,-122,0,0,0
23621,58thStGreenway22ndAve,11/09/2016 05:00:00 AM,48,-122,2,1,3
23622,58thStGreenway22ndAve,11/09/2016 06:00:00 AM,48,-122,1,1,2
23623,58thStGreenway22ndAve,11/09/2016 07:00:00 AM,48,-122,4,0,4
23624,58thStGreenway22ndAve,11/09/2016 08:00:00 AM,48,-122,6,6,12
23625,58thStGreenway22ndAve,11/09/2016 09:00:00 AM,48,-122,2,5,7
23626,58thStGreenway22ndAve,11/09/2016 10:00:00 AM,48,-122,1,3,4
23627,58thStGreenway22ndAve,11/09/2016 11:00:00 AM,48,-122,5,3,8
23628,58thStGreenway22ndAve,11/09/2016 12:00:00 PM,48,-122,2,2,4
23629,58thStGreenway22ndAve,11/09/2016 01:00:00 PM,48,-122,2,10,12
23630,58thStGreenway22ndAve,11/09/2016 02:00:00 PM,48,-122,1,4,5
23631,58thStGreenway22ndAve,11/09/2016 03:00:00 PM,48,-122,1,4,5
23632,58thStGreenway22ndAve,11/09/2016 04:00:00 PM,48,-122,1,4,5
23633,58thStGreenway22ndAve,11/09/2016 05:00:00 PM,48,-122,6,5,11
23634,58thStGreenway22ndAve,11/09/2016 06:00:00 PM,48,-122,2,7,9
23635,58thStGreenway22ndAve,11/09/2016 07:00:00 PM,48,-122,3,6,9
23636,58thStGreenway22ndAve,11/09/2016 08:00:00 PM,48,-122,1,1,2
23637,58thStGreenway22ndAve,11/09/2016 09:00:00 PM,48,-122,3,1,4
23638,58thStGreenway22ndAve,11/09/2016 10:00:00 PM,48,-122,2,0,2
23639,58thStGreenway22ndAve,11/09/2016 11:00:00 PM,48,-122,1,0,1
23640,58thStGreenway22ndAve,11/10/2016 12:00:00 AM,48,-122,1,0,1
23641,58thStGreenway22ndAve,11/10/2016 01:00:00 AM,48,-122,0,1,1
23642,58thStGreenway22ndAve,11/10/2016 02:00:00 AM,48,-122,0,0,0
23643,58thStGreenway22ndAve,11/10/2016 03:00:00 AM,48,-122,0,0,0
23644,58thStGreenway22ndAve,11/10/2016 04:00:00 AM,48,-122,0,0,0
23645,58thStGreenway22ndAve,11/10/2016 05:00:00 AM,48,-122,0,1,1
23646,58thStGreenway22ndAve,11/10/2016 06:00:00 AM,48,-122,1,0,1
23647,58thStGreenway22ndAve,11/10/2016 07:00:00 AM,48,-122,7,3,10
23648,58thStGreenway22ndAve,11/10/2016 08:00:00 AM,48,-122,5,8,13
23649,58thStGreenway22ndAve,11/10/2016 09:00:00 AM,48,-122,3,4,7
23650,58thStGreenway22ndAve,11/10/2016 10:00:00 AM,48,-122,3,4,7
23651,58thStGreenway22ndAve,11/10/2016 11:00:00 AM,48,-122,1,2,3
23652,58thStGreenway22ndAve,11/10/2016 12:00:00 PM,48,-122,4,4,8
23653,58thStGreenway22ndAve,11/10/2016 01:00:00 PM,48,-122,3,8,11
23654,58thStGreenway22ndAve,11/10/2016 02:00:00 PM,48,-122,8,7,15
23655,58thStGreenway22ndAve,11/10/2016 03:00:00 PM,48,-122,5,6,11
23656,58thStGreenway22ndAve,11/10/2016 04:00:00 PM,48,-122,5,0,5
23657,58thStGreenway22ndAve,11/10/2016 05:00:00 PM,48,-122,13,5,18
23658,58thStGreenway22ndAve,11/10/2016 06:00:00 PM,48,-122,6,12,18
23659,58thStGreenway22ndAve,11/10/2016 07:00:00 PM,48,-122,4,3,7
23660,58thStGreenway22ndAve,11/10/2016 08:00:00 PM,48,-122,2,1,3
23661,58thStGreenway22ndAve,11/10/2016 09:00:00 PM,48,-122,3,4,7
23662,58thStGreenway22ndAve,11/10/2016 10:00:00 PM,48,-122,7,1,8
23663,58thStGreenway22ndAve,11/10/2016 11:00:00 PM,48,-122,4,1,5
23664,58thStGreenway22ndAve,11/11/2016 12:00:00 AM,48,-122,1,0,1
23665,58thStGreenway22ndAve,11/11/2016 01:00:00 AM,48,-122,0,0,0
23666,58thStGreenway22ndAve,11/11/2016 02:00:00 AM,48,-122,0,1,1
23667,58thStGreenway22ndAve,11/11/2016 03:00:00 AM,48,-122,0,0,0
23668,58thStGreenway22ndAve,11/11/2016 04:00:00 AM,48,-122,0,0,0
23669,58thStGreenway22ndAve,11/11/2016 05:00:00 AM,48,-122,2,0,2
23670,58thStGreenway22ndAve,11/11/2016 06:00:00 AM,48,-122,0,0,0
23671,58thStGreenway22ndAve,11/11/2016 07:00:00 AM,48,-122,5,2,7
23672,58thStGreenway22ndAve,11/11/2016 08:00:00 AM,48,-122,3,7,10
23673,58thStGreenway22ndAve,11/11/2016 09:00:00 AM,48,-122,1,4,5
23674,58thStGreenway22ndAve,11/11/2016 10:00:00 AM,48,-122,0,2,2
23675,58thStGreenway22ndAve,11/11/2016 11:00:00 AM,48,-122,3,7,10
23676,58thStGreenway22ndAve,11/11/2016 12:00:00 PM,48,-122,3,7,10
23677,58thStGreenway22ndAve,11/11/2016 01:00:00 PM,48,-122,3,2,5
23678,58thStGreenway22ndAve,11/11/2016 02:00:00 PM,48,-122,7,7,14
23679,58thStGreenway22ndAve,11/11/2016 03:00:00 PM,48,-122,6,3,9
23680,58thStGreenway22ndAve,11/11/2016 04:00:00 PM,48,-122,7,5,12
23681,58thStGreenway22ndAve,11/11/2016 05:00:00 PM,48,-122,4,1,5
23682,58thStGreenway22ndAve,11/11/2016 06:00:00 PM,48,-122,7,4,11
23683,58thStGreenway22ndAve,11/11/2016 07:00:00 PM,48,-122,6,5,11
23684,58thStGreenway22ndAve,11/11/2016 08:00:00 PM,48,-122,3,1,4
23685,58thStGreenway22ndAve,11/11/2016 09:00:00 PM,48,-122,1,0,1
23686,58thStGreenway22ndAve,11/11/2016 10:00:00 PM,48,-122,0,3,3
23687,58thStGreenway22ndAve,11/11/2016 11:00:00 PM,48,-122,1,0,1
23688,58thStGreenway22ndAve,11/12/2016 12:00:00 AM,48,-122,2,0,2
23689,58thStGreenway22ndAve,11/12/2016 01:00:00 AM,48,-122,0,2,2
23690,58thStGreenway22ndAve,11/12/2016 02:00:00 AM,48,-122,1,0,1
23691,58thStGreenway22ndAve,11/12/2016 03:00:00 AM,48,-122,2,0,2
23692,58thStGreenway22ndAve,11/12/2016 04:00:00 AM,48,-122,0,0,0
23693,58thStGreenway22ndAve,11/12/2016 05:00:00 AM,48,-122,0,0,0
23694,58thStGreenway22ndAve,11/12/2016 06:00:00 AM,48,-122,0,1,1
23695,58thStGreenway22ndAve,11/12/2016 07:00:00 AM,48,-122,0,0,0
23696,58thStGreenway22ndAve,11/12/2016 08:00:00 AM,48,-122,4,2,6
23697,58thStGreenway22ndAve,11/12/2016 09:00:00 AM,48,-122,0,4,4
23698,58thStGreenway22ndAve,11/12/2016 10:00:00 AM,48,-122,1,3,4
23699,58thStGreenway22ndAve,11/12/2016 11:00:00 AM,48,-122,4,9,13
23700,58thStGreenway22ndAve,11/12/2016 12:00:00 PM,48,-122,1,3,4
23701,58thStGreenway22ndAve,11/12/2016 01:00:00 PM,48,-122,3,4,7
23702,58thStGreenway22ndAve,11/12/2016 02:00:00 PM,48,-122,5,9,14
23703,58thStGreenway22ndAve,11/12/2016 03:00:00 PM,48,-122,2,10,12
23704,58thStGreenway22ndAve,11/12/2016 04:00:00 PM,48,-122,7,6,13
23705,58thStGreenway22ndAve,11/12/2016 05:00:00 PM,48,-122,1,3,4
23706,58thStGreenway22ndAve,11/12/2016 06:00:00 PM,48,-122,2,5,7
23707,58thStGreenway22ndAve,11/12/2016 07:00:00 PM,48,-122,1,5,6
23708,58thStGreenway22ndAve,11/12/2016 08:00:00 PM,48,-122,1,3,4
23709,58thStGreenway22ndAve,11/12/2016 09:00:00 PM,48,-122,1,0,1
23710,58thStGreenway22ndAve,11/12/2016 10:00:00 PM,48,-122,0,0,0
23711,58thStGreenway22ndAve,11/12/2016 11:00:00 PM,48,-122,1,0,1
23712,58thStGreenway22ndAve,11/13/2016 12:00:00 AM,48,-122,0,1,1
23713,58thStGreenway22ndAve,11/13/2016 01:00:00 AM,48,-122,0,0,0
23714,58thStGreenway22ndAve,11/13/2016 02:00:00 AM,48,-122,0,0,0
23715,58thStGreenway22ndAve,11/13/2016 03:00:00 AM,48,-122,0,0,0
23716,58thStGreenway22ndAve,11/13/2016 04:00:00 AM,48,-122,0,0,0
23717,58thStGreenway22ndAve,11/13/2016 05:00:00 AM,48,-122,2,0,2
23718,58thStGreenway22ndAve,11/13/2016 06:00:00 AM,48,-122,0,0,0
23719,58thStGreenway22ndAve,11/13/2016 07:00:00 AM,48,-122,1,0,1
23720,58thStGreenway22ndAve,11/13/2016 08:00:00 AM,48,-122,2,1,3
23721,58thStGreenway22ndAve,11/13/2016 09:00:00 AM,48,-122,1,1,2
23722,58thStGreenway22ndAve,11/13/2016 10:00:00 AM,48,-122,2,9,11
23723,58thStGreenway22ndAve,11/13/2016 11:00:00 AM,48,-122,3,8,11
23724,58thStGreenway22ndAve,11/13/2016 12:00:00 PM,48,-122,1,2,3
23725,58thStGreenway22ndAve,11/13/2016 01:00:00 PM,48,-122,3,5,8
23726,58thStGreenway22ndAve,11/13/2016 02:00:00 PM,48,-122,5,8,13
23727,58thStGreenway22ndAve,11/13/2016 03:00:00 PM,48,-122,2,4,6
23728,58thStGreenway22ndAve,11/13/2016 04:00:00 PM,48,-122,2,3,5
23729,58thStGreenway22ndAve,11/13/2016 05:00:00 PM,48,-122,0,2,2
23730,58thStGreenway22ndAve,11/13/2016 06:00:00 PM,48,-122,4,3,7
23731,58thStGreenway22ndAve,11/13/2016 07:00:00 PM,48,-122,1,3,4
23732,58thStGreenway22ndAve,11/13/2016 08:00:00 PM,48,-122,1,1,2
23733,58thStGreenway22ndAve,11/13/2016 09:00:00 PM,48,-122,1,2,3
23734,58thStGreenway22ndAve,11/13/2016 10:00:00 PM,48,-122,0,0,0
23735,58thStGreenway22ndAve,11/13/2016 11:00:00 PM,48,-122,0,0,0
23736,58thStGreenway22ndAve,11/14/2016 12:00:00 AM,48,-122,0,0,0
23737,58thStGreenway22ndAve,11/14/2016 01:00:00 AM,48,-122,0,1,1
23738,58thStGreenway22ndAve,11/14/2016 02:00:00 AM,48,-122,0,0,0
23739,58thStGreenway22ndAve,11/14/2016 03:00:00 AM,48,-122,0,0,0
23740,58thStGreenway22ndAve,11/14/2016 04:00:00 AM,48,-122,0,0,0
23741,58thStGreenway22ndAve,11/14/2016 05:00:00 AM,48,-122,0,4,4
23742,58thStGreenway22ndAve,11/14/2016 06:00:00 AM,48,-122,2,0,2
23743,58thStGreenway22ndAve,11/14/2016 07:00:00 AM,48,-122,4,8,12
23744,58thStGreenway22ndAve,11/14/2016 08:00:00 AM,48,-122,5,2,7
23745,58thStGreenway22ndAve,11/14/2016 09:00:00 AM,48,-122,7,3,10
23746,58thStGreenway22ndAve,11/14/2016 10:00:00 AM,48,-122,2,4,6
23747,58thStGreenway22ndAve,11/14/2016 11:00:00 AM,48,-122,2,6,8
23748,58thStGreenway22ndAve,11/14/2016 12:00:00 PM,48,-122,1,5,6
23749,58thStGreenway22ndAve,11/14/2016 01:00:00 PM,48,-122,5,6,11
23750,58thStGreenway22ndAve,11/14/2016 02:00:00 PM,48,-122,3,6,9
23751,58thStGreenway22ndAve,11/14/2016 03:00:00 PM,48,-122,1,10,11
23752,58thStGreenway22ndAve,11/14/2016 04:00:00 PM,48,-122,6,1,7
23753,58thStGreenway22ndAve,11/14/2016 05:00:00 PM,48,-122,2,14,16
23754,58thStGreenway22ndAve,11/14/2016 06:00:00 PM,48,-122,3,13,16
23755,58thStGreenway22ndAve,11/14/2016 07:00:00 PM,48,-122,7,3,10
23756,58thStGreenway22ndAve,11/14/2016 08:00:00 PM,48,-122,3,0,3
23757,58thStGreenway22ndAve,11/14/2016 09:00:00 PM,48,-122,1,0,1
23758,58thStGreenway22ndAve,11/14/2016 10:00:00 PM,48,-122,0,0,0
23759,58thStGreenway22ndAve,11/14/2016 11:00:00 PM,48,-122,0,0,0
23760,58thStGreenway22ndAve,11/15/2016 12:00:00 AM,48,-122,0,0,0
23761,58thStGreenway22ndAve,11/15/2016 01:00:00 AM,48,-122,0,1,1
23762,58thStGreenway22ndAve,11/15/2016 02:00:00 AM,48,-122,0,0,0
23763,58thStGreenway22ndAve,11/15/2016 03:00:00 AM,48,-122,0,0,0
23764,58thStGreenway22ndAve,11/15/2016 04:00:00 AM,48,-122,0,0,0
23765,58thStGreenway22ndAve,11/15/2016 05:00:00 AM,48,-122,0,1,1
23766,58thStGreenway22ndAve,11/15/2016 06:00:00 AM,48,-122,0,3,3
23767,58thStGreenway22ndAve,11/15/2016 07:00:00 AM,48,-122,5,1,6
23768,58thStGreenway22ndAve,11/15/2016 08:00:00 AM,48,-122,3,3,6
23769,58thStGreenway22ndAve,11/15/2016 09:00:00 AM,48,-122,4,6,10
23770,58thStGreenway22ndAve,11/15/2016 10:00:00 AM,48,-122,2,9,11
23771,58thStGreenway22ndAve,11/15/2016 11:00:00 AM,48,-122,2,4,6
23772,58thStGreenway22ndAve,11/15/2016 12:00:00 PM,48,-122,4,4,8
23773,58thStGreenway22ndAve,11/15/2016 01:00:00 PM,48,-122,2,5,7
23774,58thStGreenway22ndAve,11/15/2016 02:00:00 PM,48,-122,3,7,10
23775,58thStGreenway22ndAve,11/15/2016 03:00:00 PM,48,-122,3,3,6
23776,58thStGreenway22ndAve,11/15/2016 04:00:00 PM,48,-122,3,4,7
23777,58thStGreenway22ndAve,11/15/2016 05:00:00 PM,48,-122,6,6,12
23778,58thStGreenway22ndAve,11/15/2016 06:00:00 PM,48,-122,4,12,16
23779,58thStGreenway22ndAve,11/15/2016 07:00:00 PM,48,-122,7,4,11
23780,58thStGreenway22ndAve,11/15/2016 08:00:00 PM,48,-122,1,2,3
23781,58thStGreenway22ndAve,11/15/2016 09:00:00 PM,48,-122,1,0,1
23782,58thStGreenway22ndAve,11/15/2016 10:00:00 PM,48,-122,0,0,0
23783,58thStGreenway22ndAve,11/15/2016 11:00:00 PM,48,-122,0,0,0
23784,58thStGreenway22ndAve,11/16/2016 12:00:00 AM,48,-122,0,1,1
23785,58thStGreenway22ndAve,11/16/2016 01:00:00 AM,48,-122,0,0,0
23786,58thStGreenway22ndAve,11/16/2016 02:00:00 AM,48,-122,0,0,0
23787,58thStGreenway22ndAve,11/16/2016 03:00:00 AM,48,-122,0,0,0
23788,58thStGreenway22ndAve,11/16/2016 04:00:00 AM,48,-122,0,0,0
23789,58thStGreenway22ndAve,11/16/2016 05:00:00 AM,48,-122,1,1,2
23790,58thStGreenway22ndAve,11/16/2016 06:00:00 AM,48,-122,3,0,3
23791,58thStGreenway22ndAve,11/16/2016 07:00:00 AM,48,-122,5,4,9
23792,58thStGreenway22ndAve,11/16/2016 08:00:00 AM,48,-122,3,3,6
23793,58thStGreenway22ndAve,11/16/2016 09:00:00 AM,48,-122,2,5,7
23794,58thStGreenway22ndAve,11/16/2016 10:00:00 AM,48,-122,1,4,5
23795,58thStGreenway22ndAve,11/16/2016 11:00:00 AM,48,-122,2,6,8
23796,58thStGreenway22ndAve,11/16/2016 12:00:00 PM,48,-122,2,5,7
23797,58thStGreenway22ndAve,11/16/2016 01:00:00 PM,48,-122,2,8,10
23798,58thStGreenway22ndAve,11/16/2016 02:00:00 PM,48,-122,4,1,5
23799,58thStGreenway22ndAve,11/16/2016 03:00:00 PM,48,-122,3,5,8
23800,58thStGreenway22ndAve,11/16/2016 04:00:00 PM,48,-122,1,2,3
23801,58thStGreenway22ndAve,11/16/2016 05:00:00 PM,48,-122,11,4,15
23802,58thStGreenway22ndAve,11/16/2016 06:00:00 PM,48,-122,3,4,7
23803,58thStGreenway22ndAve,11/16/2016 07:00:00 PM,48,-122,8,2,10
23804,58thStGreenway22ndAve,11/16/2016 08:00:00 PM,48,-122,1,0,1
23805,58thStGreenway22ndAve,11/16/2016 09:00:00 PM,48,-122,3,5,8
23806,58thStGreenway22ndAve,11/16/2016 10:00:00 PM,48,-122,2,1,3
23807,58thStGreenway22ndAve,11/16/2016 11:00:00 PM,48,-122,2,1,3
23808,58thStGreenway22ndAve,11/17/2016 12:00:00 AM,48,-122,0,1,1
23809,58thStGreenway22ndAve,11/17/2016 01:00:00 AM,48,-122,0,0,0
23810,58thStGreenway22ndAve,11/17/2016 02:00:00 AM,48,-122,0,0,0
23811,58thStGreenway22ndAve,11/17/2016 03:00:00 AM,48,-122,1,0,1
23812,58thStGreenway22ndAve,11/17/2016 04:00:00 AM,48,-122,0,0,0
23813,58thStGreenway22ndAve,11/17/2016 05:00:00 AM,48,-122,0,1,1
23814,58thStGreenway22ndAve,11/17/2016 06:00:00 AM,48,-122,1,0,1
23815,58thStGreenway22ndAve,11/17/2016 07:00:00 AM,48,-122,3,2,5
23816,58thStGreenway22ndAve,11/17/2016 08:00:00 AM,48,-122,5,2,7
23817,58thStGreenway22ndAve,11/17/2016 09:00:00 AM,48,-122,4,6,10
23818,58thStGreenway22ndAve,11/17/2016 10:00:00 AM,48,-122,1,5,6
23819,58thStGreenway22ndAve,11/17/2016 11:00:00 AM,48,-122,3,3,6
23820,58thStGreenway22ndAve,11/17/2016 12:00:00 PM,48,-122,5,4,9
23821,58thStGreenway22ndAve,11/17/2016 01:00:00 PM,48,-122,4,7,11
23822,58thStGreenway22ndAve,11/17/2016 02:00:00 PM,48,-122,5,6,11
23823,58thStGreenway22ndAve,11/17/2016 03:00:00 PM,48,-122,4,10,14
23824,58thStGreenway22ndAve,11/17/2016 04:00:00 PM,48,-122,6,9,15
23825,58thStGreenway22ndAve,11/17/2016 05:00:00 PM,48,-122,7,4,11
23826,58thStGreenway22ndAve,11/17/2016 06:00:00 PM,48,-122,8,8,16
23827,58thStGreenway22ndAve,11/17/2016 07:00:00 PM,48,-122,5,2,7
23828,58thStGreenway22ndAve,11/17/2016 08:00:00 PM,48,-122,2,3,5
23829,58thStGreenway22ndAve,11/17/2016 09:00:00 PM,48,-122,3,2,5
23830,58thStGreenway22ndAve,11/17/2016 10:00:00 PM,48,-122,3,0,3
23831,58thStGreenway22ndAve,11/17/2016 11:00:00 PM,48,-122,1,2,3
23832,58thStGreenway22ndAve,11/18/2016 12:00:00 AM,48,-122,0,0,0
23833,58thStGreenway22ndAve,11/18/2016 01:00:00 AM,48,-122,0,1,1
23834,58thStGreenway22ndAve,11/18/2016 02:00:00 AM,48,-122,0,0,0
23835,58thStGreenway22ndAve,11/18/2016 03:00:00 AM,48,-122,1,0,1
23836,58thStGreenway22ndAve,11/18/2016 04:00:00 AM,48,-122,0,0,0
23837,58thStGreenway22ndAve,11/18/2016 05:00:00 AM,48,-122,0,0,0
23838,58thStGreenway22ndAve,11/18/2016 06:00:00 AM,48,-122,1,2,3
23839,58thStGreenway22ndAve,11/18/2016 07:00:00 AM,48,-122,1,2,3
23840,58thStGreenway22ndAve,11/18/2016 08:00:00 AM,48,-122,2,2,4
23841,58thStGreenway22ndAve,11/18/2016 09:00:00 AM,48,-122,2,2,4
23842,58thStGreenway22ndAve,11/18/2016 10:00:00 AM,48,-122,6,2,8
23843,58thStGreenway22ndAve,11/18/2016 11:00:00 AM,48,-122,6,1,7
23844,58thStGreenway22ndAve,11/18/2016 12:00:00 PM,48,-122,2,3,5
23845,58thStGreenway22ndAve,11/18/2016 01:00:00 PM,48,-122,2,8,10
23846,58thStGreenway22ndAve,11/18/2016 02:00:00 PM,48,-122,5,9,14
23847,58thStGreenway22ndAve,11/18/2016 03:00:00 PM,48,-122,2,1,3
23848,58thStGreenway22ndAve,11/18/2016 04:00:00 PM,48,-122,6,5,11
23849,58thStGreenway22ndAve,11/18/2016 05:00:00 PM,48,-122,1,1,2
23850,58thStGreenway22ndAve,11/18/2016 06:00:00 PM,48,-122,2,6,8
23851,58thStGreenway22ndAve,11/18/2016 07:00:00 PM,48,-122,2,6,8
23852,58thStGreenway22ndAve,11/18/2016 08:00:00 PM,48,-122,0,0,0
23853,58thStGreenway22ndAve,11/18/2016 09:00:00 PM,48,-122,3,4,7
23854,58thStGreenway22ndAve,11/18/2016 10:00:00 PM,48,-122,2,0,2
23855,58thStGreenway22ndAve,11/18/2016 11:00:00 PM,48,-122,0,2,2
23856,58thStGreenway22ndAve,11/19/2016 12:00:00 AM,48,-122,0,0,0
23857,58thStGreenway22ndAve,11/19/2016 01:00:00 AM,48,-122,0,1,1
23858,58thStGreenway22ndAve,11/19/2016 02:00:00 AM,48,-122,1,0,1
23859,58thStGreenway22ndAve,11/19/2016 03:00:00 AM,48,-122,0,0,0
23860,58thStGreenway22ndAve,11/19/2016 04:00:00 AM,48,-122,0,0,0
23861,58thStGreenway22ndAve,11/19/2016 05:00:00 AM,48,-122,0,0,0
23862,58thStGreenway22ndAve,11/19/2016 06:00:00 AM,48,-122,0,1,1
23863,58thStGreenway22ndAve,11/19/2016 07:00:00 AM,48,-122,0,1,1
23864,58thStGreenway22ndAve,11/19/2016 08:00:00 AM,48,-122,1,2,3
23865,58thStGreenway22ndAve,11/19/2016 09:00:00 AM,48,-122,1,1,2
23866,58thStGreenway22ndAve,11/19/2016 10:00:00 AM,48,-122,1,6,7
23867,58thStGreenway22ndAve,11/19/2016 11:00:00 AM,48,-122,0,3,3
23868,58thStGreenway22ndAve,11/19/2016 12:00:00 PM,48,-122,3,2,5
23869,58thStGreenway22ndAve,11/19/2016 01:00:00 PM,48,-122,3,6,9
23870,58thStGreenway22ndAve,11/19/2016 02:00:00 PM,48,-122,6,6,12
23871,58thStGreenway22ndAve,11/19/2016 03:00:00 PM,48,-122,4,6,10
23872,58thStGreenway22ndAve,11/19/2016 04:00:00 PM,48,-122,3,2,5
23873,58thStGreenway22ndAve,11/19/2016 05:00:00 PM,48,-122,1,3,4
23874,58thStGreenway22ndAve,11/19/2016 06:00:00 PM,48,-122,7,3,10
23875,58thStGreenway22ndAve,11/19/2016 07:00:00 PM,48,-122,3,0,3
23876,58thStGreenway22ndAve,11/19/2016 08:00:00 PM,48,-122,3,0,3
23877,58thStGreenway22ndAve,11/19/2016 09:00:00 PM,48,-122,1,3,4
23878,58thStGreenway22ndAve,11/19/2016 10:00:00 PM,48,-122,0,2,2
23879,58thStGreenway22ndAve,11/19/2016 11:00:00 PM,48,-122,1,0,1
23880,58thStGreenway22ndAve,11/20/2016 12:00:00 AM,48,-122,2,0,2
23881,58thStGreenway22ndAve,11/20/2016 01:00:00 AM,48,-122,0,0,0
23882,58thStGreenway22ndAve,11/20/2016 02:00:00 AM,48,-122,0,0,0
23883,58thStGreenway22ndAve,11/20/2016 03:00:00 AM,48,-122,0,0,0
23884,58thStGreenway22ndAve,11/20/2016 04:00:00 AM,48,-122,0,0,0
23885,58thStGreenway22ndAve,11/20/2016 05:00:00 AM,48,-122,0,0,0
23886,58thStGreenway22ndAve,11/20/2016 06:00:00 AM,48,-122,0,0,0
23887,58thStGreenway22ndAve,11/20/2016 07:00:00 AM,48,-122,1,0,1
23888,58thStGreenway22ndAve,11/20/2016 08:00:00 AM,48,-122,1,2,3
23889,58thStGreenway22ndAve,11/20/2016 09:00:00 AM,48,-122,2,3,5
23890,58thStGreenway22ndAve,11/20/2016 10:00:00 AM,48,-122,2,3,5
23891,58thStGreenway22ndAve,11/20/2016 11:00:00 AM,48,-122,4,8,12
23892,58thStGreenway22ndAve,11/20/2016 12:00:00 PM,48,-122,3,6,9
23893,58thStGreenway22ndAve,11/20/2016 01:00:00 PM,48,-122,1,4,5
23894,58thStGreenway22ndAve,11/20/2016 02:00:00 PM,48,-122,3,6,9
23895,58thStGreenway22ndAve,11/20/2016 03:00:00 PM,48,-122,2,2,4
23896,58thStGreenway22ndAve,11/20/2016 04:00:00 PM,48,-122,2,3,5
23897,58thStGreenway22ndAve,11/20/2016 05:00:00 PM,48,-122,2,4,6
23898,58thStGreenway22ndAve,11/20/2016 06:00:00 PM,48,-122,3,3,6
23899,58thStGreenway22ndAve,11/20/2016 07:00:00 PM,48,-122,0,1,1
23900,58thStGreenway22ndAve,11/20/2016 08:00:00 PM,48,-122,1,3,4
23901,58thStGreenway22ndAve,11/20/2016 09:00:00 PM,48,-122,0,1,1
23902,58thStGreenway22ndAve,11/20/2016 10:00:00 PM,48,-122,0,0,0
23903,58thStGreenway22ndAve,11/20/2016 11:00:00 PM,48,-122,0,0,0
23904,58thStGreenway22ndAve,11/21/2016 12:00:00 AM,48,-122,1,1,2
23905,58thStGreenway22ndAve,11/21/2016 01:00:00 AM,48,-122,0,0,0
23906,58thStGreenway22ndAve,11/21/2016 02:00:00 AM,48,-122,0,0,0
23907,58thStGreenway22ndAve,11/21/2016 03:00:00 AM,48,-122,0,0,0
23908,58thStGreenway22ndAve,11/21/2016 04:00:00 AM,48,-122,0,0,0
23909,58thStGreenway22ndAve,11/21/2016 05:00:00 AM,48,-122,0,1,1
23910,58thStGreenway22ndAve,11/21/2016 06:00:00 AM,48,-122,0,1,1
23911,58thStGreenway22ndAve,11/21/2016 07:00:00 AM,48,-122,2,3,5
23912,58thStGreenway22ndAve,11/21/2016 08:00:00 AM,48,-122,6,3,9
23913,58thStGreenway22ndAve,11/21/2016 09:00:00 AM,48,-122,2,7,9
23914,58thStGreenway22ndAve,11/21/2016 10:00:00 AM,48,-122,4,4,8
23915,58thStGreenway22ndAve,11/21/2016 11:00:00 AM,48,-122,2,3,5
23916,58thStGreenway22ndAve,11/21/2016 12:00:00 PM,48,-122,2,6,8
23917,58thStGreenway22ndAve,11/21/2016 01:00:00 PM,48,-122,4,5,9
23918,58thStGreenway22ndAve,11/21/2016 02:00:00 PM,48,-122,7,4,11
23919,58thStGreenway22ndAve,11/21/2016 03:00:00 PM,48,-122,7,8,15
23920,58thStGreenway22ndAve,11/21/2016 04:00:00 PM,48,-122,4,5,9
23921,58thStGreenway22ndAve,11/21/2016 05:00:00 PM,48,-122,6,4,10
23922,58thStGreenway22ndAve,11/21/2016 06:00:00 PM,48,-122,6,6,12
23923,58thStGreenway22ndAve,11/21/2016 07:00:00 PM,48,-122,2,3,5
23924,58thStGreenway22ndAve,11/21/2016 08:00:00 PM,48,-122,2,5,7
23925,58thStGreenway22ndAve,11/21/2016 09:00:00 PM,48,-122,1,0,1
23926,58thStGreenway22ndAve,11/21/2016 10:00:00 PM,48,-122,2,1,3
23927,58thStGreenway22ndAve,11/21/2016 11:00:00 PM,48,-122,1,0,1
23928,58thStGreenway22ndAve,11/22/2016 12:00:00 AM,48,-122,0,0,0
23929,58thStGreenway22ndAve,11/22/2016 01:00:00 AM,48,-122,0,0,0
23930,58thStGreenway22ndAve,11/22/2016 02:00:00 AM,48,-122,0,0,0
23931,58thStGreenway22ndAve,11/22/2016 03:00:00 AM,48,-122,0,0,0
23932,58thStGreenway22ndAve,11/22/2016 04:00:00 AM,48,-122,0,0,0
23933,58thStGreenway22ndAve,11/22/2016 05:00:00 AM,48,-122,0,1,1
23934,58thStGreenway22ndAve,11/22/2016 06:00:00 AM,48,-122,0,1,1
23935,58thStGreenway22ndAve,11/22/2016 07:00:00 AM,48,-122,4,3,7
23936,58thStGreenway22ndAve,11/22/2016 08:00:00 AM,48,-122,3,1,4
23937,58thStGreenway22ndAve,11/22/2016 09:00:00 AM,48,-122,3,4,7
23938,58thStGreenway22ndAve,11/22/2016 10:00:00 AM,48,-122,2,11,13
23939,58thStGreenway22ndAve,11/22/2016 11:00:00 AM,48,-122,4,7,11
23940,58thStGreenway22ndAve,11/22/2016 12:00:00 PM,48,-122,1,11,12
23941,58thStGreenway22ndAve,11/22/2016 01:00:00 PM,48,-122,5,4,9
23942,58thStGreenway22ndAve,11/22/2016 02:00:00 PM,48,-122,3,1,4
23943,58thStGreenway22ndAve,11/22/2016 03:00:00 PM,48,-122,5,7,12
23944,58thStGreenway22ndAve,11/22/2016 04:00:00 PM,48,-122,1,7,8
23945,58thStGreenway22ndAve,11/22/2016 05:00:00 PM,48,-122,3,5,8
23946,58thStGreenway22ndAve,11/22/2016 06:00:00 PM,48,-122,4,8,12
23947,58thStGreenway22ndAve,11/22/2016 07:00:00 PM,48,-122,1,2,3
23948,58thStGreenway22ndAve,11/22/2016 08:00:00 PM,48,-122,1,2,3
23949,58thStGreenway22ndAve,11/22/2016 09:00:00 PM,48,-122,2,2,4
23950,58thStGreenway22ndAve,11/22/2016 10:00:00 PM,48,-122,0,1,1
23951,58thStGreenway22ndAve,11/22/2016 11:00:00 PM,48,-122,0,1,1
23952,58thStGreenway22ndAve,11/23/2016 12:00:00 AM,48,-122,0,0,0
23953,58thStGreenway22ndAve,11/23/2016 01:00:00 AM,48,-122,0,0,0
23954,58thStGreenway22ndAve,11/23/2016 02:00:00 AM,48,-122,0,0,0
23955,58thStGreenway22ndAve,11/23/2016 03:00:00 AM,48,-122,1,0,1
23956,58thStGreenway22ndAve,11/23/2016 04:00:00 AM,48,-122,0,1,1
23957,58thStGreenway22ndAve,11/23/2016 05:00:00 AM,48,-122,0,1,1
23958,58thStGreenway22ndAve,11/23/2016 06:00:00 AM,48,-122,1,4,5
23959,58thStGreenway22ndAve,11/23/2016 07:00:00 AM,48,-122,6,2,8
23960,58thStGreenway22ndAve,11/23/2016 08:00:00 AM,48,-122,5,2,7
23961,58thStGreenway22ndAve,11/23/2016 09:00:00 AM,48,-122,5,3,8
23962,58thStGreenway22ndAve,11/23/2016 10:00:00 AM,48,-122,0,9,9
23963,58thStGreenway22ndAve,11/23/2016 11:00:00 AM,48,-122,2,11,13
23964,58thStGreenway22ndAve,11/23/2016 12:00:00 PM,48,-122,4,5,9
23965,58thStGreenway22ndAve,11/23/2016 01:00:00 PM,48,-122,4,1,5
23966,58thStGreenway22ndAve,11/23/2016 02:00:00 PM,48,-122,2,5,7
23967,58thStGreenway22ndAve,11/23/2016 03:00:00 PM,48,-122,3,4,7
23968,58thStGreenway22ndAve,11/23/2016 04:00:00 PM,48,-122,2,5,7
23969,58thStGreenway22ndAve,11/23/2016 05:00:00 PM,48,-122,6,3,9
23970,58thStGreenway22ndAve,11/23/2016 06:00:00 PM,48,-122,0,8,8
23971,58thStGreenway22ndAve,11/23/2016 07:00:00 PM,48,-122,0,3,3
23972,58thStGreenway22ndAve,11/23/2016 08:00:00 PM,48,-122,1,5,6
23973,58thStGreenway22ndAve,11/23/2016 09:00:00 PM,48,-122,0,0,0
23974,58thStGreenway22ndAve,11/23/2016 10:00:00 PM,48,-122,0,0,0
23975,58thStGreenway22ndAve,11/23/2016 11:00:00 PM,48,-122,2,0,2
23976,58thStGreenway22ndAve,11/24/2016 12:00:00 AM,48,-122,0,0,0
23977,58thStGreenway22ndAve,11/24/2016 01:00:00 AM,48,-122,0,0,0
23978,58thStGreenway22ndAve,11/24/2016 02:00:00 AM,48,-122,0,0,0
23979,58thStGreenway22ndAve,11/24/2016 03:00:00 AM,48,-122,0,0,0
23980,58thStGreenway22ndAve,11/24/2016 04:00:00 AM,48,-122,0,0,0
23981,58thStGreenway22ndAve,11/24/2016 05:00:00 AM,48,-122,0,0,0
23982,58thStGreenway22ndAve,11/24/2016 06:00:00 AM,48,-122,0,0,0
23983,58thStGreenway22ndAve,11/24/2016 07:00:00 AM,48,-122,1,0,1
23984,58thStGreenway22ndAve,11/24/2016 08:00:00 AM,48,-122,0,0,0
23985,58thStGreenway22ndAve,11/24/2016 09:00:00 AM,48,-122,0,1,1
23986,58thStGreenway22ndAve,11/24/2016 10:00:00 AM,48,-122,2,1,3
23987,58thStGreenway22ndAve,11/24/2016 11:00:00 AM,48,-122,1,0,1
23988,58thStGreenway22ndAve,11/24/2016 12:00:00 PM,48,-122,1,0,1
23989,58thStGreenway22ndAve,11/24/2016 01:00:00 PM,48,-122,0,1,1
23990,58thStGreenway22ndAve,11/24/2016 02:00:00 PM,48,-122,0,0,0
23991,58thStGreenway22ndAve,11/24/2016 03:00:00 PM,48,-122,0,0,0
23992,58thStGreenway22ndAve,11/24/2016 04:00:00 PM,48,-122,3,0,3
23993,58thStGreenway22ndAve,11/24/2016 05:00:00 PM,48,-122,0,0,0
23994,58thStGreenway22ndAve,11/24/2016 06:00:00 PM,48,-122,0,0,0
23995,58thStGreenway22ndAve,11/24/2016 07:00:00 PM,48,-122,0,2,2
23996,58thStGreenway22ndAve,11/24/2016 08:00:00 PM,48,-122,0,1,1
23997,58thStGreenway22ndAve,11/24/2016 09:00:00 PM,48,-122,0,0,0
23998,58thStGreenway22ndAve,11/24/2016 10:00:00 PM,48,-122,0,0,0
23999,58thStGreenway22ndAve,11/24/2016 11:00:00 PM,48,-122,1,1,2
24000,58thStGreenway22ndAve,11/25/2016 12:00:00 AM,48,-122,0,0,0
24001,58thStGreenway22ndAve,11/25/2016 01:00:00 AM,48,-122,0,0,0
24002,58thStGreenway22ndAve,11/25/2016 02:00:00 AM,48,-122,0,0,0
24003,58thStGreenway22ndAve,11/25/2016 03:00:00 AM,48,-122,0,0,0
24004,58thStGreenway22ndAve,11/25/2016 04:00:00 AM,48,-122,1,0,1
24005,58thStGreenway22ndAve,11/25/2016 05:00:00 AM,48,-122,0,1,1
24006,58thStGreenway22ndAve,11/25/2016 06:00:00 AM,48,-122,0,0,0
24007,58thStGreenway22ndAve,11/25/2016 07:00:00 AM,48,-122,0,3,3
24008,58thStGreenway22ndAve,11/25/2016 08:00:00 AM,48,-122,2,1,3
24009,58thStGreenway22ndAve,11/25/2016 09:00:00 AM,48,-122,1,2,3
24010,58thStGreenway22ndAve,11/25/2016 10:00:00 AM,48,-122,1,5,6
24011,58thStGreenway22ndAve,11/25/2016 11:00:00 AM,48,-122,3,4,7
24012,58thStGreenway22ndAve,11/25/2016 12:00:00 PM,48,-122,5,8,13
24013,58thStGreenway22ndAve,11/25/2016 01:00:00 PM,48,-122,0,5,5
24014,58thStGreenway22ndAve,11/25/2016 02:00:00 PM,48,-122,8,3,11
24015,58thStGreenway22ndAve,11/25/2016 03:00:00 PM,48,-122,7,6,13
24016,58thStGreenway22ndAve,11/25/2016 04:00:00 PM,48,-122,4,4,8
24017,58thStGreenway22ndAve,11/25/2016 05:00:00 PM,48,-122,1,3,4
24018,58thStGreenway22ndAve,11/25/2016 06:00:00 PM,48,-122,1,2,3
24019,58thStGreenway22ndAve,11/25/2016 07:00:00 PM,48,-122,2,1,3
24020,58thStGreenway22ndAve,11/25/2016 08:00:00 PM,48,-122,0,3,3
24021,58thStGreenway22ndAve,11/25/2016 09:00:00 PM,48,-122,0,2,2
24022,58thStGreenway22ndAve,11/25/2016 10:00:00 PM,48,-122,0,0,0
24023,58thStGreenway22ndAve,11/25/2016 11:00:00 PM,48,-122,0,0,0
24024,58thStGreenway22ndAve,11/26/2016 12:00:00 AM,48,-122,0,1,1
24025,58thStGreenway22ndAve,11/26/2016 01:00:00 AM,48,-122,2,0,2
24026,58thStGreenway22ndAve,11/26/2016 02:00:00 AM,48,-122,0,0,0
24027,58thStGreenway22ndAve,11/26/2016 03:00:00 AM,48,-122,0,0,0
24028,58thStGreenway22ndAve,11/26/2016 04:00:00 AM,48,-122,0,0,0
24029,58thStGreenway22ndAve,11/26/2016 05:00:00 AM,48,-122,0,0,0
24030,58thStGreenway22ndAve,11/26/2016 06:00:00 AM,48,-122,0,0,0
24031,58thStGreenway22ndAve,11/26/2016 07:00:00 AM,48,-122,0,0,0
24032,58thStGreenway22ndAve,11/26/2016 08:00:00 AM,48,-122,1,1,2
24033,58thStGreenway22ndAve,11/26/2016 09:00:00 AM,48,-122,0,0,0
24034,58thStGreenway22ndAve,11/26/2016 10:00:00 AM,48,-122,4,5,9
24035,58thStGreenway22ndAve,11/26/2016 11:00:00 AM,48,-122,1,2,3
24036,58thStGreenway22ndAve,11/26/2016 12:00:00 PM,48,-122,1,4,5
24037,58thStGreenway22ndAve,11/26/2016 01:00:00 PM,48,-122,2,5,7
24038,58thStGreenway22ndAve,11/26/2016 02:00:00 PM,48,-122,1,1,2
24039,58thStGreenway22ndAve,11/26/2016 03:00:00 PM,48,-122,3,3,6
24040,58thStGreenway22ndAve,11/26/2016 04:00:00 PM,48,-122,1,6,7
24041,58thStGreenway22ndAve,11/26/2016 05:00:00 PM,48,-122,2,2,4
24042,58thStGreenway22ndAve,11/26/2016 06:00:00 PM,48,-122,4,3,7
24043,58thStGreenway22ndAve,11/26/2016 07:00:00 PM,48,-122,2,3,5
24044,58thStGreenway22ndAve,11/26/2016 08:00:00 PM,48,-122,4,0,4
24045,58thStGreenway22ndAve,11/26/2016 09:00:00 PM,48,-122,0,2,2
24046,58thStGreenway22ndAve,11/26/2016 10:00:00 PM,48,-122,0,0,0
24047,58thStGreenway22ndAve,11/26/2016 11:00:00 PM,48,-122,0,1,1
24048,58thStGreenway22ndAve,11/27/2016 12:00:00 AM,48,-122,0,0,0
24049,58thStGreenway22ndAve,11/27/2016 01:00:00 AM,48,-122,0,0,0
24050,58thStGreenway22ndAve,11/27/2016 02:00:00 AM,48,-122,0,0,0
24051,58thStGreenway22ndAve,11/27/2016 03:00:00 AM,48,-122,0,0,0
24052,58thStGreenway22ndAve,11/27/2016 04:00:00 AM,48,-122,1,0,1
24053,58thStGreenway22ndAve,11/27/2016 05:00:00 AM,48,-122,0,0,0
24054,58thStGreenway22ndAve,11/27/2016 06:00:00 AM,48,-122,0,2,2
24055,58thStGreenway22ndAve,11/27/2016 07:00:00 AM,48,-122,0,4,4
24056,58thStGreenway22ndAve,11/27/2016 08:00:00 AM,48,-122,1,0,1
24057,58thStGreenway22ndAve,11/27/2016 09:00:00 AM,48,-122,4,2,6
24058,58thStGreenway22ndAve,11/27/2016 10:00:00 AM,48,-122,0,3,3
24059,58thStGreenway22ndAve,11/27/2016 11:00:00 AM,48,-122,5,4,9
24060,58thStGreenway22ndAve,11/27/2016 12:00:00 PM,48,-122,7,10,17
24061,58thStGreenway22ndAve,11/27/2016 01:00:00 PM,48,-122,7,4,11
24062,58thStGreenway22ndAve,11/27/2016 02:00:00 PM,48,-122,4,2,6
24063,58thStGreenway22ndAve,11/27/2016 03:00:00 PM,48,-122,5,1,6
24064,58thStGreenway22ndAve,11/27/2016 04:00:00 PM,48,-122,0,1,1
24065,58thStGreenway22ndAve,11/27/2016 05:00:00 PM,48,-122,1,3,4
24066,58thStGreenway22ndAve,11/27/2016 06:00:00 PM,48,-122,0,0,0
24067,58thStGreenway22ndAve,11/27/2016 07:00:00 PM,48,-122,1,2,3
24068,58thStGreenway22ndAve,11/27/2016 08:00:00 PM,48,-122,1,1,2
24069,58thStGreenway22ndAve,11/27/2016 09:00:00 PM,48,-122,1,1,2
24070,58thStGreenway22ndAve,11/27/2016 10:00:00 PM,48,-122,0,1,1
24071,58thStGreenway22ndAve,11/27/2016 11:00:00 PM,48,-122,3,1,4
24072,58thStGreenway22ndAve,11/28/2016 12:00:00 AM,48,-122,0,1,1
24073,58thStGreenway22ndAve,11/28/2016 01:00:00 AM,48,-122,0,0,0
24074,58thStGreenway22ndAve,11/28/2016 02:00:00 AM,48,-122,0,0,0
24075,58thStGreenway22ndAve,11/28/2016 03:00:00 AM,48,-122,1,0,1
24076,58thStGreenway22ndAve,11/28/2016 04:00:00 AM,48,-122,0,0,0
24077,58thStGreenway22ndAve,11/28/2016 05:00:00 AM,48,-122,0,1,1
24078,58thStGreenway22ndAve,11/28/2016 06:00:00 AM,48,-122,1,0,1
24079,58thStGreenway22ndAve,11/28/2016 07:00:00 AM,48,-122,10,3,13
24080,58thStGreenway22ndAve,11/28/2016 08:00:00 AM,48,-122,3,3,6
24081,58thStGreenway22ndAve,11/28/2016 09:00:00 AM,48,-122,5,10,15
24082,58thStGreenway22ndAve,11/28/2016 10:00:00 AM,48,-122,8,4,12
24083,58thStGreenway22ndAve,11/28/2016 11:00:00 AM,48,-122,2,5,7
24084,58thStGreenway22ndAve,11/28/2016 12:00:00 PM,48,-122,4,4,8
24085,58thStGreenway22ndAve,11/28/2016 01:00:00 PM,48,-122,1,11,12
24086,58thStGreenway22ndAve,11/28/2016 02:00:00 PM,48,-122,2,4,6
24087,58thStGreenway22ndAve,11/28/2016 03:00:00 PM,48,-122,4,6,10
24088,58thStGreenway22ndAve,11/28/2016 04:00:00 PM,48,-122,7,6,13
24089,58thStGreenway22ndAve,11/28/2016 05:00:00 PM,48,-122,6,6,12
24090,58thStGreenway22ndAve,11/28/2016 06:00:00 PM,48,-122,3,4,7
24091,58thStGreenway22ndAve,11/28/2016 07:00:00 PM,48,-122,2,4,6
24092,58thStGreenway22ndAve,11/28/2016 08:00:00 PM,48,-122,2,1,3
24093,58thStGreenway22ndAve,11/28/2016 09:00:00 PM,48,-122,2,0,2
24094,58thStGreenway22ndAve,11/28/2016 10:00:00 PM,48,-122,0,0,0
24095,58thStGreenway22ndAve,11/28/2016 11:00:00 PM,48,-122,0,0,0
24096,58thStGreenway22ndAve,11/29/2016 12:00:00 AM,48,-122,0,0,0
24097,58thStGreenway22ndAve,11/29/2016 01:00:00 AM,48,-122,1,0,1
24098,58thStGreenway22ndAve,11/29/2016 02:00:00 AM,48,-122,0,0,0
24099,58thStGreenway22ndAve,11/29/2016 03:00:00 AM,48,-122,0,0,0
24100,58thStGreenway22ndAve,11/29/2016 04:00:00 AM,48,-122,0,0,0
24101,58thStGreenway22ndAve,11/29/2016 05:00:00 AM,48,-122,2,1,3
24102,58thStGreenway22ndAve,11/29/2016 06:00:00 AM,48,-122,2,1,3
24103,58thStGreenway22ndAve,11/29/2016 07:00:00 AM,48,-122,3,7,10
24104,58thStGreenway22ndAve,11/29/2016 08:00:00 AM,48,-122,4,3,7
24105,58thStGreenway22ndAve,11/29/2016 09:00:00 AM,48,-122,2,7,9
24106,58thStGreenway22ndAve,11/29/2016 10:00:00 AM,48,-122,1,4,5
24107,58thStGreenway22ndAve,11/29/2016 11:00:00 AM,48,-122,3,1,4
24108,58thStGreenway22ndAve,11/29/2016 12:00:00 PM,48,-122,3,0,3
24109,58thStGreenway22ndAve,11/29/2016 01:00:00 PM,48,-122,6,5,11
24110,58thStGreenway22ndAve,11/29/2016 02:00:00 PM,48,-122,0,7,7
24111,58thStGreenway22ndAve,11/29/2016 03:00:00 PM,48,-122,6,4,10
24112,58thStGreenway22ndAve,11/29/2016 04:00:00 PM,48,-122,1,1,2
24113,58thStGreenway22ndAve,11/29/2016 05:00:00 PM,48,-122,7,7,14
24114,58thStGreenway22ndAve,11/29/2016 06:00:00 PM,48,-122,3,5,8
24115,58thStGreenway22ndAve,11/29/2016 07:00:00 PM,48,-122,0,4,4
24116,58thStGreenway22ndAve,11/29/2016 08:00:00 PM,48,-122,4,1,5
24117,58thStGreenway22ndAve,11/29/2016 09:00:00 PM,48,-122,2,1,3
24118,58thStGreenway22ndAve,11/29/2016 10:00:00 PM,48,-122,1,0,1
24119,58thStGreenway22ndAve,11/29/2016 11:00:00 PM,48,-122,0,1,1
24120,58thStGreenway22ndAve,11/30/2016 12:00:00 AM,48,-122,1,0,1
24121,58thStGreenway22ndAve,11/30/2016 01:00:00 AM,48,-122,0,0,0
24122,58thStGreenway22ndAve,11/30/2016 02:00:00 AM,48,-122,0,0,0
24123,58thStGreenway22ndAve,11/30/2016 03:00:00 AM,48,-122,1,0,1
24124,58thStGreenway22ndAve,11/30/2016 04:00:00 AM,48,-122,0,0,0
24125,58thStGreenway22ndAve,11/30/2016 05:00:00 AM,48,-122,0,2,2
24126,58thStGreenway22ndAve,11/30/2016 06:00:00 AM,48,-122,5,1,6
24127,58thStGreenway22ndAve,11/30/2016 07:00:00 AM,48,-122,6,1,7
24128,58thStGreenway22ndAve,11/30/2016 08:00:00 AM,48,-122,2,3,5
24129,58thStGreenway22ndAve,11/30/2016 09:00:00 AM,48,-122,1,2,3
24130,58thStGreenway22ndAve,11/30/2016 10:00:00 AM,48,-122,4,2,6
24131,58thStGreenway22ndAve,11/30/2016 11:00:00 AM,48,-122,4,5,9
24132,58thStGreenway22ndAve,11/30/2016 12:00:00 PM,48,-122,4,2,6
24133,58thStGreenway22ndAve,11/30/2016 01:00:00 PM,48,-122,1,2,3
24134,58thStGreenway22ndAve,11/30/2016 02:00:00 PM,48,-122,0,10,10
24135,58thStGreenway22ndAve,11/30/2016 03:00:00 PM,48,-122,1,2,3
24136,58thStGreenway22ndAve,11/30/2016 04:00:00 PM,48,-122,5,2,7
24137,58thStGreenway22ndAve,11/30/2016 05:00:00 PM,48,-122,6,3,9
24138,58thStGreenway22ndAve,11/30/2016 06:00:00 PM,48,-122,7,3,10
24139,58thStGreenway22ndAve,11/30/2016 07:00:00 PM,48,-122,4,3,7
24140,58thStGreenway22ndAve,11/30/2016 08:00:00 PM,48,-122,2,3,5
24141,58thStGreenway22ndAve,11/30/2016 09:00:00 PM,48,-122,2,0,2
24142,58thStGreenway22ndAve,11/30/2016 10:00:00 PM,48,-122,0,0,0
24143,58thStGreenway22ndAve,11/30/2016 11:00:00 PM,48,-122,0,1,1
24144,58thStGreenway22ndAve,12/01/2016 12:00:00 AM,48,-122,0,1,1
24145,58thStGreenway22ndAve,12/01/2016 01:00:00 AM,48,-122,0,0,0
24146,58thStGreenway22ndAve,12/01/2016 02:00:00 AM,48,-122,1,0,1
24147,58thStGreenway22ndAve,12/01/2016 03:00:00 AM,48,-122,0,1,1
24148,58thStGreenway22ndAve,12/01/2016 04:00:00 AM,48,-122,0,0,0
24149,58thStGreenway22ndAve,12/01/2016 05:00:00 AM,48,-122,0,1,1
24150,58thStGreenway22ndAve,12/01/2016 06:00:00 AM,48,-122,0,1,1
24151,58thStGreenway22ndAve,12/01/2016 07:00:00 AM,48,-122,3,1,4
24152,58thStGreenway22ndAve,12/01/2016 08:00:00 AM,48,-122,2,2,4
24153,58thStGreenway22ndAve,12/01/2016 09:00:00 AM,48,-122,4,3,7
24154,58thStGreenway22ndAve,12/01/2016 10:00:00 AM,48,-122,0,5,5
24155,58thStGreenway22ndAve,12/01/2016 11:00:00 AM,48,-122,3,6,9
24156,58thStGreenway22ndAve,12/01/2016 12:00:00 PM,48,-122,2,3,5
24157,58thStGreenway22ndAve,12/01/2016 01:00:00 PM,48,-122,4,6,10
24158,58thStGreenway22ndAve,12/01/2016 02:00:00 PM,48,-122,5,4,9
24159,58thStGreenway22ndAve,12/01/2016 03:00:00 PM,48,-122,4,4,8
24160,58thStGreenway22ndAve,12/01/2016 04:00:00 PM,48,-122,4,5,9
24161,58thStGreenway22ndAve,12/01/2016 05:00:00 PM,48,-122,4,3,7
24162,58thStGreenway22ndAve,12/01/2016 06:00:00 PM,48,-122,3,1,4
24163,58thStGreenway22ndAve,12/01/2016 07:00:00 PM,48,-122,3,2,5
24164,58thStGreenway22ndAve,12/01/2016 08:00:00 PM,48,-122,2,1,3
24165,58thStGreenway22ndAve,12/01/2016 09:00:00 PM,48,-122,3,2,5
24166,58thStGreenway22ndAve,12/01/2016 10:00:00 PM,48,-122,0,0,0
24167,58thStGreenway22ndAve,12/01/2016 11:00:00 PM,48,-122,0,0,0
24168,58thStGreenway22ndAve,12/02/2016 12:00:00 AM,48,-122,0,0,0
24169,58thStGreenway22ndAve,12/02/2016 01:00:00 AM,48,-122,0,0,0
24170,58thStGreenway22ndAve,12/02/2016 02:00:00 AM,48,-122,0,0,0
24171,58thStGreenway22ndAve,12/02/2016 03:00:00 AM,48,-122,0,0,0
24172,58thStGreenway22ndAve,12/02/2016 04:00:00 AM,48,-122,0,0,0
24173,58thStGreenway22ndAve,12/02/2016 05:00:00 AM,48,-122,0,1,1
24174,58thStGreenway22ndAve,12/02/2016 06:00:00 AM,48,-122,1,0,1
24175,58thStGreenway22ndAve,12/02/2016 07:00:00 AM,48,-122,4,2,6
24176,58thStGreenway22ndAve,12/02/2016 08:00:00 AM,48,-122,6,4,10
24177,58thStGreenway22ndAve,12/02/2016 09:00:00 AM,48,-122,2,3,5
24178,58thStGreenway22ndAve,12/02/2016 10:00:00 AM,48,-122,0,4,4
24179,58thStGreenway22ndAve,12/02/2016 11:00:00 AM,48,-122,0,2,2
24180,58thStGreenway22ndAve,12/02/2016 12:00:00 PM,48,-122,1,5,6
24181,58thStGreenway22ndAve,12/02/2016 01:00:00 PM,48,-122,3,4,7
24182,58thStGreenway22ndAve,12/02/2016 02:00:00 PM,48,-122,1,3,4
24183,58thStGreenway22ndAve,12/02/2016 03:00:00 PM,48,-122,1,1,2
24184,58thStGreenway22ndAve,12/02/2016 04:00:00 PM,48,-122,4,0,4
24185,58thStGreenway22ndAve,12/02/2016 05:00:00 PM,48,-122,0,1,1
24186,58thStGreenway22ndAve,12/02/2016 06:00:00 PM,48,-122,0,0,0
24187,58thStGreenway22ndAve,12/02/2016 07:00:00 PM,48,-122,0,0,0
24188,58thStGreenway22ndAve,12/02/2016 08:00:00 PM,48,-122,0,0,0
24189,58thStGreenway22ndAve,12/02/2016 09:00:00 PM,48,-122,0,0,0
24190,58thStGreenway22ndAve,12/02/2016 10:00:00 PM,48,-122,0,0,0
24191,58thStGreenway22ndAve,12/02/2016 11:00:00 PM,48,-122,0,0,0
24192,58thStGreenway22ndAve,12/03/2016 12:00:00 AM,48,-122,0,0,0
24193,58thStGreenway22ndAve,12/03/2016 01:00:00 AM,48,-122,0,0,0
24194,58thStGreenway22ndAve,12/03/2016 02:00:00 AM,48,-122,0,0,0
24195,58thStGreenway22ndAve,12/03/2016 03:00:00 AM,48,-122,0,0,0
24196,58thStGreenway22ndAve,12/03/2016 04:00:00 AM,48,-122,0,0,0
24197,58thStGreenway22ndAve,12/03/2016 05:00:00 AM,48,-122,0,0,0
24198,58thStGreenway22ndAve,12/03/2016 06:00:00 AM,48,-122,0,0,0
24199,58thStGreenway22ndAve,12/03/2016 07:00:00 AM,48,-122,0,0,0
24200,58thStGreenway22ndAve,12/03/2016 08:00:00 AM,48,-122,0,0,0
24201,58thStGreenway22ndAve,12/03/2016 09:00:00 AM,48,-122,0,0,0
24202,58thStGreenway22ndAve,12/03/2016 10:00:00 AM,48,-122,0,0,0
24203,58thStGreenway22ndAve,12/03/2016 11:00:00 AM,48,-122,2,1,3
24204,58thStGreenway22ndAve,12/03/2016 12:00:00 PM,48,-122,3,4,7
24205,58thStGreenway22ndAve,12/03/2016 01:00:00 PM,48,-122,6,6,12
24206,58thStGreenway22ndAve,12/03/2016 02:00:00 PM,48,-122,6,4,10
24207,58thStGreenway22ndAve,12/03/2016 03:00:00 PM,48,-122,3,6,9
24208,58thStGreenway22ndAve,12/03/2016 04:00:00 PM,48,-122,8,3,11
24209,58thStGreenway22ndAve,12/03/2016 05:00:00 PM,48,-122,5,2,7
24210,58thStGreenway22ndAve,12/03/2016 06:00:00 PM,48,-122,2,2,4
24211,58thStGreenway22ndAve,12/03/2016 07:00:00 PM,48,-122,3,3,6
24212,58thStGreenway22ndAve,12/03/2016 08:00:00 PM,48,-122,1,0,1
24213,58thStGreenway22ndAve,12/03/2016 09:00:00 PM,48,-122,0,1,1
24214,58thStGreenway22ndAve,12/03/2016 10:00:00 PM,48,-122,1,1,2
24215,58thStGreenway22ndAve,12/03/2016 11:00:00 PM,48,-122,0,0,0
24216,58thStGreenway22ndAve,12/04/2016 12:00:00 AM,48,-122,1,0,1
24217,58thStGreenway22ndAve,12/04/2016 01:00:00 AM,48,-122,0,0,0
24218,58thStGreenway22ndAve,12/04/2016 02:00:00 AM,48,-122,0,0,0
24219,58thStGreenway22ndAve,12/04/2016 03:00:00 AM,48,-122,0,0,0
24220,58thStGreenway22ndAve,12/04/2016 04:00:00 AM,48,-122,0,0,0
24221,58thStGreenway22ndAve,12/04/2016 05:00:00 AM,48,-122,0,0,0
24222,58thStGreenway22ndAve,12/04/2016 06:00:00 AM,48,-122,0,1,1
24223,58thStGreenway22ndAve,12/04/2016 07:00:00 AM,48,-122,0,1,1
24224,58thStGreenway22ndAve,12/04/2016 08:00:00 AM,48,-122,0,4,4
24225,58thStGreenway22ndAve,12/04/2016 09:00:00 AM,48,-122,2,0,2
24226,58thStGreenway22ndAve,12/04/2016 10:00:00 AM,48,-122,3,4,7
24227,58thStGreenway22ndAve,12/04/2016 11:00:00 AM,48,-122,3,1,4
24228,58thStGreenway22ndAve,12/04/2016 12:00:00 PM,48,-122,13,6,19
24229,58thStGreenway22ndAve,12/04/2016 01:00:00 PM,48,-122,9,7,16
24230,58thStGreenway22ndAve,12/04/2016 02:00:00 PM,48,-122,8,4,12
24231,58thStGreenway22ndAve,12/04/2016 03:00:00 PM,48,-122,4,3,7
24232,58thStGreenway22ndAve,12/04/2016 04:00:00 PM,48,-122,5,6,11
24233,58thStGreenway22ndAve,12/04/2016 05:00:00 PM,48,-122,2,2,4
24234,58thStGreenway22ndAve,12/04/2016 06:00:00 PM,48,-122,1,1,2
24235,58thStGreenway22ndAve,12/04/2016 07:00:00 PM,48,-122,4,1,5
24236,58thStGreenway22ndAve,12/04/2016 08:00:00 PM,48,-122,0,0,0
24237,58thStGreenway22ndAve,12/04/2016 09:00:00 PM,48,-122,1,1,2
24238,58thStGreenway22ndAve,12/04/2016 10:00:00 PM,48,-122,1,0,1
24239,58thStGreenway22ndAve,12/04/2016 11:00:00 PM,48,-122,1,0,1
24240,58thStGreenway22ndAve,12/05/2016 12:00:00 AM,48,-122,0,0,0
24241,58thStGreenway22ndAve,12/05/2016 01:00:00 AM,48,-122,0,0,0
24242,58thStGreenway22ndAve,12/05/2016 02:00:00 AM,48,-122,0,0,0
24243,58thStGreenway22ndAve,12/05/2016 03:00:00 AM,48,-122,0,0,0
24244,58thStGreenway22ndAve,12/05/2016 04:00:00 AM,48,-122,0,0,0
24245,58thStGreenway22ndAve,12/05/2016 05:00:00 AM,48,-122,0,1,1
24246,58thStGreenway22ndAve,12/05/2016 06:00:00 AM,48,-122,2,1,3
24247,58thStGreenway22ndAve,12/05/2016 07:00:00 AM,48,-122,4,3,7
24248,58thStGreenway22ndAve,12/05/2016 08:00:00 AM,48,-122,2,4,6
24249,58thStGreenway22ndAve,12/05/2016 09:00:00 AM,48,-122,1,3,4
24250,58thStGreenway22ndAve,12/05/2016 10:00:00 AM,48,-122,0,1,1
24251,58thStGreenway22ndAve,12/05/2016 11:00:00 AM,48,-122,3,6,9
24252,58thStGreenway22ndAve,12/05/2016 12:00:00 PM,48,-122,0,4,4
24253,58thStGreenway22ndAve,12/05/2016 01:00:00 PM,48,-122,2,5,7
24254,58thStGreenway22ndAve,12/05/2016 02:00:00 PM,48,-122,3,2,5
24255,58thStGreenway22ndAve,12/05/2016 03:00:00 PM,48,-122,2,6,8
24256,58thStGreenway22ndAve,12/05/2016 04:00:00 PM,48,-122,2,3,5
24257,58thStGreenway22ndAve,12/05/2016 05:00:00 PM,48,-122,4,4,8
24258,58thStGreenway22ndAve,12/05/2016 06:00:00 PM,48,-122,3,6,9
24259,58thStGreenway22ndAve,12/05/2016 07:00:00 PM,48,-122,1,2,3
24260,58thStGreenway22ndAve,12/05/2016 08:00:00 PM,48,-122,0,1,1
24261,58thStGreenway22ndAve,12/05/2016 09:00:00 PM,48,-122,1,1,2
24262,58thStGreenway22ndAve,12/05/2016 10:00:00 PM,48,-122,0,0,0
24263,58thStGreenway22ndAve,12/05/2016 11:00:00 PM,48,-122,1,1,2
24264,58thStGreenway22ndAve,12/06/2016 12:00:00 AM,48,-122,0,0,0
24265,58thStGreenway22ndAve,12/06/2016 01:00:00 AM,48,-122,0,0,0
24266,58thStGreenway22ndAve,12/06/2016 02:00:00 AM,48,-122,0,0,0
24267,58thStGreenway22ndAve,12/06/2016 03:00:00 AM,48,-122,0,0,0
24268,58thStGreenway22ndAve,12/06/2016 04:00:00 AM,48,-122,0,0,0
24269,58thStGreenway22ndAve,12/06/2016 05:00:00 AM,48,-122,0,1,1
24270,58thStGreenway22ndAve,12/06/2016 06:00:00 AM,48,-122,1,0,1
24271,58thStGreenway22ndAve,12/06/2016 07:00:00 AM,48,-122,1,1,2
24272,58thStGreenway22ndAve,12/06/2016 08:00:00 AM,48,-122,2,0,2
24273,58thStGreenway22ndAve,12/06/2016 09:00:00 AM,48,-122,2,2,4
24274,58thStGreenway22ndAve,12/06/2016 10:00:00 AM,48,-122,2,1,3
24275,58thStGreenway22ndAve,12/06/2016 11:00:00 AM,48,-122,3,1,4
24276,58thStGreenway22ndAve,12/06/2016 12:00:00 PM,48,-122,4,4,8
24277,58thStGreenway22ndAve,12/06/2016 01:00:00 PM,48,-122,1,3,4
24278,58thStGreenway22ndAve,12/06/2016 02:00:00 PM,48,-122,3,4,7
24279,58thStGreenway22ndAve,12/06/2016 03:00:00 PM,48,-122,4,4,8
24280,58thStGreenway22ndAve,12/06/2016 04:00:00 PM,48,-122,6,2,8
24281,58thStGreenway22ndAve,12/06/2016 05:00:00 PM,48,-122,7,5,12
24282,58thStGreenway22ndAve,12/06/2016 06:00:00 PM,48,-122,5,5,10
24283,58thStGreenway22ndAve,12/06/2016 07:00:00 PM,48,-122,4,4,8
24284,58thStGreenway22ndAve,12/06/2016 08:00:00 PM,48,-122,2,1,3
24285,58thStGreenway22ndAve,12/06/2016 09:00:00 PM,48,-122,3,1,4
24286,58thStGreenway22ndAve,12/06/2016 10:00:00 PM,48,-122,1,2,3
24287,58thStGreenway22ndAve,12/06/2016 11:00:00 PM,48,-122,0,0,0
24288,58thStGreenway22ndAve,12/07/2016 12:00:00 AM,48,-122,0,0,0
24289,58thStGreenway22ndAve,12/07/2016 01:00:00 AM,48,-122,0,0,0
24290,58thStGreenway22ndAve,12/07/2016 02:00:00 AM,48,-122,0,0,0
24291,58thStGreenway22ndAve,12/07/2016 03:00:00 AM,48,-122,0,0,0
24292,58thStGreenway22ndAve,12/07/2016 04:00:00 AM,48,-122,0,0,0
24293,58thStGreenway22ndAve,12/07/2016 05:00:00 AM,48,-122,0,1,1
24294,58thStGreenway22ndAve,12/07/2016 06:00:00 AM,48,-122,0,0,0
24295,58thStGreenway22ndAve,12/07/2016 07:00:00 AM,48,-122,1,0,1
24296,58thStGreenway22ndAve,12/07/2016 08:00:00 AM,48,-122,2,5,7
24297,58thStGreenway22ndAve,12/07/2016 09:00:00 AM,48,-122,1,0,1
24298,58thStGreenway22ndAve,12/07/2016 10:00:00 AM,48,-122,1,2,3
24299,58thStGreenway22ndAve,12/07/2016 11:00:00 AM,48,-122,1,1,2
24300,58thStGreenway22ndAve,12/07/2016 12:00:00 PM,48,-122,4,2,6
24301,58thStGreenway22ndAve,12/07/2016 01:00:00 PM,48,-122,2,1,3
24302,58thStGreenway22ndAve,12/07/2016 02:00:00 PM,48,-122,3,2,5
24303,58thStGreenway22ndAve,12/07/2016 03:00:00 PM,48,-122,4,2,6
24304,58thStGreenway22ndAve,12/07/2016 04:00:00 PM,48,-122,6,1,7
24305,58thStGreenway22ndAve,12/07/2016 05:00:00 PM,48,-122,4,3,7
24306,58thStGreenway22ndAve,12/07/2016 06:00:00 PM,48,-122,4,1,5
24307,58thStGreenway22ndAve,12/07/2016 07:00:00 PM,48,-122,1,1,2
24308,58thStGreenway22ndAve,12/07/2016 08:00:00 PM,48,-122,0,1,1
24309,58thStGreenway22ndAve,12/07/2016 09:00:00 PM,48,-122,2,0,2
24310,58thStGreenway22ndAve,12/07/2016 10:00:00 PM,48,-122,0,0,0
24311,58thStGreenway22ndAve,12/07/2016 11:00:00 PM,48,-122,0,0,0
24312,58thStGreenway22ndAve,12/08/2016 12:00:00 AM,48,-122,1,2,3
24313,58thStGreenway22ndAve,12/08/2016 01:00:00 AM,48,-122,0,0,0
24314,58thStGreenway22ndAve,12/08/2016 02:00:00 AM,48,-122,0,0,0
24315,58thStGreenway22ndAve,12/08/2016 03:00:00 AM,48,-122,0,0,0
24316,58thStGreenway22ndAve,12/08/2016 04:00:00 AM,48,-122,0,0,0
24317,58thStGreenway22ndAve,12/08/2016 05:00:00 AM,48,-122,0,1,1
24318,58thStGreenway22ndAve,12/08/2016 06:00:00 AM,48,-122,0,1,1
24319,58thStGreenway22ndAve,12/08/2016 07:00:00 AM,48,-122,2,3,5
24320,58thStGreenway22ndAve,12/08/2016 08:00:00 AM,48,-122,4,2,6
24321,58thStGreenway22ndAve,12/08/2016 09:00:00 AM,48,-122,3,4,7
24322,58thStGreenway22ndAve,12/08/2016 10:00:00 AM,48,-122,1,4,5
24323,58thStGreenway22ndAve,12/08/2016 11:00:00 AM,48,-122,5,2,7
24324,58thStGreenway22ndAve,12/08/2016 12:00:00 PM,48,-122,3,4,7
24325,58thStGreenway22ndAve,12/08/2016 01:00:00 PM,48,-122,2,1,3
24326,58thStGreenway22ndAve,12/08/2016 02:00:00 PM,48,-122,5,5,10
24327,58thStGreenway22ndAve,12/08/2016 03:00:00 PM,48,-122,2,3,5
24328,58thStGreenway22ndAve,12/08/2016 04:00:00 PM,48,-122,3,5,8
24329,58thStGreenway22ndAve,12/08/2016 05:00:00 PM,48,-122,6,2,8
24330,58thStGreenway22ndAve,12/08/2016 06:00:00 PM,48,-122,3,0,3
24331,58thStGreenway22ndAve,12/08/2016 07:00:00 PM,48,-122,2,1,3
24332,58thStGreenway22ndAve,12/08/2016 08:00:00 PM,48,-122,2,1,3
24333,58thStGreenway22ndAve,12/08/2016 09:00:00 PM,48,-122,2,0,2
24334,58thStGreenway22ndAve,12/08/2016 10:00:00 PM,48,-122,0,0,0
24335,58thStGreenway22ndAve,12/08/2016 11:00:00 PM,48,-122,0,0,0
24336,58thStGreenway22ndAve,12/09/2016 12:00:00 AM,48,-122,0,0,0
24337,58thStGreenway22ndAve,12/09/2016 01:00:00 AM,48,-122,1,0,1
24338,58thStGreenway22ndAve,12/09/2016 02:00:00 AM,48,-122,0,0,0
24339,58thStGreenway22ndAve,12/09/2016 03:00:00 AM,48,-122,0,1,1
24340,58thStGreenway22ndAve,12/09/2016 04:00:00 AM,48,-122,0,0,0
24341,58thStGreenway22ndAve,12/09/2016 05:00:00 AM,48,-122,0,0,0
24342,58thStGreenway22ndAve,12/09/2016 06:00:00 AM,48,-122,0,2,2
24343,58thStGreenway22ndAve,12/09/2016 07:00:00 AM,48,-122,0,3,3
24344,58thStGreenway22ndAve,12/09/2016 08:00:00 AM,48,-122,4,1,5
24345,58thStGreenway22ndAve,12/09/2016 09:00:00 AM,48,-122,1,2,3
24346,58thStGreenway22ndAve,12/09/2016 10:00:00 AM,48,-122,1,2,3
24347,58thStGreenway22ndAve,12/09/2016 11:00:00 AM,48,-122,0,4,4
24348,58thStGreenway22ndAve,12/09/2016 12:00:00 PM,48,-122,2,1,3
24349,58thStGreenway22ndAve,12/09/2016 01:00:00 PM,48,-122,2,8,10
24350,58thStGreenway22ndAve,12/09/2016 02:00:00 PM,48,-122,1,3,4
24351,58thStGreenway22ndAve,12/09/2016 03:00:00 PM,48,-122,1,3,4
24352,58thStGreenway22ndAve,12/09/2016 04:00:00 PM,48,-122,0,7,7
24353,58thStGreenway22ndAve,12/09/2016 05:00:00 PM,48,-122,2,2,4
24354,58thStGreenway22ndAve,12/09/2016 06:00:00 PM,48,-122,2,0,2
24355,58thStGreenway22ndAve,12/09/2016 07:00:00 PM,48,-122,5,0,5
24356,58thStGreenway22ndAve,12/09/2016 08:00:00 PM,48,-122,1,0,1
24357,58thStGreenway22ndAve,12/09/2016 09:00:00 PM,48,-122,1,0,1
24358,58thStGreenway22ndAve,12/09/2016 10:00:00 PM,48,-122,0,0,0
24359,58thStGreenway22ndAve,12/09/2016 11:00:00 PM,48,-122,0,0,0
24360,58thStGreenway22ndAve,12/10/2016 12:00:00 AM,48,-122,0,0,0
24361,58thStGreenway22ndAve,12/10/2016 01:00:00 AM,48,-122,0,0,0
24362,58thStGreenway22ndAve,12/10/2016 02:00:00 AM,48,-122,0,0,0
24363,58thStGreenway22ndAve,12/10/2016 03:00:00 AM,48,-122,0,0,0
24364,58thStGreenway22ndAve,12/10/2016 04:00:00 AM,48,-122,0,0,0
24365,58thStGreenway22ndAve,12/10/2016 05:00:00 AM,48,-122,0,0,0
24366,58thStGreenway22ndAve,12/10/2016 06:00:00 AM,48,-122,0,1,1
24367,58thStGreenway22ndAve,12/10/2016 07:00:00 AM,48,-122,0,0,0
24368,58thStGreenway22ndAve,12/10/2016 08:00:00 AM,48,-122,0,0,0
24369,58thStGreenway22ndAve,12/10/2016 09:00:00 AM,48,-122,2,1,3
24370,58thStGreenway22ndAve,12/10/2016 10:00:00 AM,48,-122,2,3,5
24371,58thStGreenway22ndAve,12/10/2016 11:00:00 AM,48,-122,2,7,9
24372,58thStGreenway22ndAve,12/10/2016 12:00:00 PM,48,-122,2,1,3
24373,58thStGreenway22ndAve,12/10/2016 01:00:00 PM,48,-122,2,1,3
24374,58thStGreenway22ndAve,12/10/2016 02:00:00 PM,48,-122,0,1,1
24375,58thStGreenway22ndAve,12/10/2016 03:00:00 PM,48,-122,2,3,5
24376,58thStGreenway22ndAve,12/10/2016 04:00:00 PM,48,-122,1,3,4
24377,58thStGreenway22ndAve,12/10/2016 05:00:00 PM,48,-122,1,3,4
24378,58thStGreenway22ndAve,12/10/2016 06:00:00 PM,48,-122,2,3,5
24379,58thStGreenway22ndAve,12/10/2016 07:00:00 PM,48,-122,3,0,3
24380,58thStGreenway22ndAve,12/10/2016 08:00:00 PM,48,-122,0,1,1
24381,58thStGreenway22ndAve,12/10/2016 09:00:00 PM,48,-122,2,1,3
24382,58thStGreenway22ndAve,12/10/2016 10:00:00 PM,48,-122,1,1,2
24383,58thStGreenway22ndAve,12/10/2016 11:00:00 PM,48,-122,3,1,4
24384,58thStGreenway22ndAve,12/11/2016 12:00:00 AM,48,-122,1,0,1
24385,58thStGreenway22ndAve,12/11/2016 01:00:00 AM,48,-122,1,1,2
24386,58thStGreenway22ndAve,12/11/2016 02:00:00 AM,48,-122,0,0,0
24387,58thStGreenway22ndAve,12/11/2016 03:00:00 AM,48,-122,0,0,0
24388,58thStGreenway22ndAve,12/11/2016 04:00:00 AM,48,-122,0,0,0
24389,58thStGreenway22ndAve,12/11/2016 05:00:00 AM,48,-122,0,0,0
24390,58thStGreenway22ndAve,12/11/2016 06:00:00 AM,48,-122,0,1,1
24391,58thStGreenway22ndAve,12/11/2016 07:00:00 AM,48,-122,0,0,0
24392,58thStGreenway22ndAve,12/11/2016 08:00:00 AM,48,-122,1,1,2
24393,58thStGreenway22ndAve,12/11/2016 09:00:00 AM,48,-122,0,1,1
24394,58thStGreenway22ndAve,12/11/2016 10:00:00 AM,48,-122,2,1,3
24395,58thStGreenway22ndAve,12/11/2016 11:00:00 AM,48,-122,4,6,10
24396,58thStGreenway22ndAve,12/11/2016 12:00:00 PM,48,-122,4,3,7
24397,58thStGreenway22ndAve,12/11/2016 01:00:00 PM,48,-122,5,7,12
24398,58thStGreenway22ndAve,12/11/2016 02:00:00 PM,48,-122,2,3,5
24399,58thStGreenway22ndAve,12/11/2016 03:00:00 PM,48,-122,0,1,1
24400,58thStGreenway22ndAve,12/11/2016 04:00:00 PM,48,-122,2,3,5
24401,58thStGreenway22ndAve,12/11/2016 05:00:00 PM,48,-122,1,3,4
24402,58thStGreenway22ndAve,12/11/2016 06:00:00 PM,48,-122,1,0,1
24403,58thStGreenway22ndAve,12/11/2016 07:00:00 PM,48,-122,1,0,1
24404,58thStGreenway22ndAve,12/11/2016 08:00:00 PM,48,-122,0,0,0
24405,58thStGreenway22ndAve,12/11/2016 09:00:00 PM,48,-122,0,0,0
24406,58thStGreenway22ndAve,12/11/2016 10:00:00 PM,48,-122,0,1,1
24407,58thStGreenway22ndAve,12/11/2016 11:00:00 PM,48,-122,0,0,0
24408,58thStGreenway22ndAve,12/12/2016 12:00:00 AM,48,-122,1,0,1
24409,58thStGreenway22ndAve,12/12/2016 01:00:00 AM,48,-122,0,0,0
24410,58thStGreenway22ndAve,12/12/2016 02:00:00 AM,48,-122,0,0,0
24411,58thStGreenway22ndAve,12/12/2016 03:00:00 AM,48,-122,0,0,0
24412,58thStGreenway22ndAve,12/12/2016 04:00:00 AM,48,-122,0,0,0
24413,58thStGreenway22ndAve,12/12/2016 05:00:00 AM,48,-122,0,1,1
24414,58thStGreenway22ndAve,12/12/2016 06:00:00 AM,48,-122,1,2,3
24415,58thStGreenway22ndAve,12/12/2016 07:00:00 AM,48,-122,2,7,9
24416,58thStGreenway22ndAve,12/12/2016 08:00:00 AM,48,-122,5,7,12
24417,58thStGreenway22ndAve,12/12/2016 09:00:00 AM,48,-122,2,5,7
24418,58thStGreenway22ndAve,12/12/2016 10:00:00 AM,48,-122,0,3,3
24419,58thStGreenway22ndAve,12/12/2016 11:00:00 AM,48,-122,1,2,3
24420,58thStGreenway22ndAve,12/12/2016 12:00:00 PM,48,-122,3,7,10
24421,58thStGreenway22ndAve,12/12/2016 01:00:00 PM,48,-122,1,7,8
24422,58thStGreenway22ndAve,12/12/2016 02:00:00 PM,48,-122,4,7,11
24423,58thStGreenway22ndAve,12/12/2016 03:00:00 PM,48,-122,1,3,4
24424,58thStGreenway22ndAve,12/12/2016 04:00:00 PM,48,-122,5,3,8
24425,58thStGreenway22ndAve,12/12/2016 05:00:00 PM,48,-122,5,3,8
24426,58thStGreenway22ndAve,12/12/2016 06:00:00 PM,48,-122,3,2,5
24427,58thStGreenway22ndAve,12/12/2016 07:00:00 PM,48,-122,3,0,3
24428,58thStGreenway22ndAve,12/12/2016 08:00:00 PM,48,-122,0,0,0
24429,58thStGreenway22ndAve,12/12/2016 09:00:00 PM,48,-122,0,0,0
24430,58thStGreenway22ndAve,12/12/2016 10:00:00 PM,48,-122,1,0,1
24431,58thStGreenway22ndAve,12/12/2016 11:00:00 PM,48,-122,0,1,1
24432,58thStGreenway22ndAve,12/13/2016 12:00:00 AM,48,-122,0,0,0
24433,58thStGreenway22ndAve,12/13/2016 01:00:00 AM,48,-122,0,0,0
24434,58thStGreenway22ndAve,12/13/2016 02:00:00 AM,48,-122,0,0,0
24435,58thStGreenway22ndAve,12/13/2016 03:00:00 AM,48,-122,0,0,0
24436,58thStGreenway22ndAve,12/13/2016 04:00:00 AM,48,-122,0,0,0
24437,58thStGreenway22ndAve,12/13/2016 05:00:00 AM,48,-122,0,0,0
24438,58thStGreenway22ndAve,12/13/2016 06:00:00 AM,48,-122,1,0,1
24439,58thStGreenway22ndAve,12/13/2016 07:00:00 AM,48,-122,6,0,6
24440,58thStGreenway22ndAve,12/13/2016 08:00:00 AM,48,-122,3,0,3
24441,58thStGreenway22ndAve,12/13/2016 09:00:00 AM,48,-122,3,1,4
24442,58thStGreenway22ndAve,12/13/2016 10:00:00 AM,48,-122,2,6,8
24443,58thStGreenway22ndAve,12/13/2016 11:00:00 AM,48,-122,4,5,9
24444,58thStGreenway22ndAve,12/13/2016 12:00:00 PM,48,-122,1,5,6
24445,58thStGreenway22ndAve,12/13/2016 01:00:00 PM,48,-122,4,5,9
24446,58thStGreenway22ndAve,12/13/2016 02:00:00 PM,48,-122,2,3,5
24447,58thStGreenway22ndAve,12/13/2016 03:00:00 PM,48,-122,4,4,8
24448,58thStGreenway22ndAve,12/13/2016 04:00:00 PM,48,-122,8,7,15
24449,58thStGreenway22ndAve,12/13/2016 05:00:00 PM,48,-122,5,10,15
24450,58thStGreenway22ndAve,12/13/2016 06:00:00 PM,48,-122,5,4,9
24451,58thStGreenway22ndAve,12/13/2016 07:00:00 PM,48,-122,7,2,9
24452,58thStGreenway22ndAve,12/13/2016 08:00:00 PM,48,-122,2,1,3
24453,58thStGreenway22ndAve,12/13/2016 09:00:00 PM,48,-122,0,1,1
24454,58thStGreenway22ndAve,12/13/2016 10:00:00 PM,48,-122,0,1,1
24455,58thStGreenway22ndAve,12/13/2016 11:00:00 PM,48,-122,0,0,0
24456,58thStGreenway22ndAve,12/14/2016 12:00:00 AM,48,-122,0,0,0
24457,58thStGreenway22ndAve,12/14/2016 01:00:00 AM,48,-122,0,0,0
24458,58thStGreenway22ndAve,12/14/2016 02:00:00 AM,48,-122,0,0,0
24459,58thStGreenway22ndAve,12/14/2016 03:00:00 AM,48,-122,0,0,0
24460,58thStGreenway22ndAve,12/14/2016 04:00:00 AM,48,-122,0,0,0
24461,58thStGreenway22ndAve,12/14/2016 05:00:00 AM,48,-122,0,1,1
24462,58thStGreenway22ndAve,12/14/2016 06:00:00 AM,48,-122,2,0,2
24463,58thStGreenway22ndAve,12/14/2016 07:00:00 AM,48,-122,4,1,5
24464,58thStGreenway22ndAve,12/14/2016 08:00:00 AM,48,-122,1,0,1
24465,58thStGreenway22ndAve,12/14/2016 09:00:00 AM,48,-122,5,2,7
24466,58thStGreenway22ndAve,12/14/2016 10:00:00 AM,48,-122,1,4,5
24467,58thStGreenway22ndAve,12/14/2016 11:00:00 AM,48,-122,0,2,2
24468,58thStGreenway22ndAve,12/14/2016 12:00:00 PM,48,-122,2,4,6
24469,58thStGreenway22ndAve,12/14/2016 01:00:00 PM,48,-122,2,2,4
24470,58thStGreenway22ndAve,12/14/2016 02:00:00 PM,48,-122,3,4,7
24471,58thStGreenway22ndAve,12/14/2016 03:00:00 PM,48,-122,3,1,4
24472,58thStGreenway22ndAve,12/14/2016 04:00:00 PM,48,-122,3,5,8
24473,58thStGreenway22ndAve,12/14/2016 05:00:00 PM,48,-122,2,1,3
24474,58thStGreenway22ndAve,12/14/2016 06:00:00 PM,48,-122,2,3,5
24475,58thStGreenway22ndAve,12/14/2016 07:00:00 PM,48,-122,1,1,2
24476,58thStGreenway22ndAve,12/14/2016 08:00:00 PM,48,-122,4,2,6
24477,58thStGreenway22ndAve,12/14/2016 09:00:00 PM,48,-122,0,3,3
24478,58thStGreenway22ndAve,12/14/2016 10:00:00 PM,48,-122,1,1,2
24479,58thStGreenway22ndAve,12/14/2016 11:00:00 PM,48,-122,1,1,2
24480,58thStGreenway22ndAve,12/15/2016 12:00:00 AM,48,-122,0,0,0
24481,58thStGreenway22ndAve,12/15/2016 01:00:00 AM,48,-122,0,0,0
24482,58thStGreenway22ndAve,12/15/2016 02:00:00 AM,48,-122,0,0,0
24483,58thStGreenway22ndAve,12/15/2016 03:00:00 AM,48,-122,0,0,0
24484,58thStGreenway22ndAve,12/15/2016 04:00:00 AM,48,-122,0,0,0
24485,58thStGreenway22ndAve,12/15/2016 05:00:00 AM,48,-122,0,0,0
24486,58thStGreenway22ndAve,12/15/2016 06:00:00 AM,48,-122,0,2,2
24487,58thStGreenway22ndAve,12/15/2016 07:00:00 AM,48,-122,4,2,6
24488,58thStGreenway22ndAve,12/15/2016 08:00:00 AM,48,-122,2,4,6
24489,58thStGreenway22ndAve,12/15/2016 09:00:00 AM,48,-122,3,5,8
24490,58thStGreenway22ndAve,12/15/2016 10:00:00 AM,48,-122,1,3,4
24491,58thStGreenway22ndAve,12/15/2016 11:00:00 AM,48,-122,4,6,10
24492,58thStGreenway22ndAve,12/15/2016 12:00:00 PM,48,-122,0,2,2
24493,58thStGreenway22ndAve,12/15/2016 01:00:00 PM,48,-122,2,4,6
24494,58thStGreenway22ndAve,12/15/2016 02:00:00 PM,48,-122,2,0,2
24495,58thStGreenway22ndAve,12/15/2016 03:00:00 PM,48,-122,4,3,7
24496,58thStGreenway22ndAve,12/15/2016 04:00:00 PM,48,-122,5,3,8
24497,58thStGreenway22ndAve,12/15/2016 05:00:00 PM,48,-122,4,3,7
24498,58thStGreenway22ndAve,12/15/2016 06:00:00 PM,48,-122,3,3,6
24499,58thStGreenway22ndAve,12/15/2016 07:00:00 PM,48,-122,5,1,6
24500,58thStGreenway22ndAve,12/15/2016 08:00:00 PM,48,-122,0,0,0
24501,58thStGreenway22ndAve,12/15/2016 09:00:00 PM,48,-122,1,1,2
24502,58thStGreenway22ndAve,12/15/2016 10:00:00 PM,48,-122,2,0,2
24503,58thStGreenway22ndAve,12/15/2016 11:00:00 PM,48,-122,0,0,0
24504,58thStGreenway22ndAve,12/16/2016 12:00:00 AM,48,-122,0,0,0
24505,58thStGreenway22ndAve,12/16/2016 01:00:00 AM,48,-122,0,0,0
24506,58thStGreenway22ndAve,12/16/2016 02:00:00 AM,48,-122,0,0,0
24507,58thStGreenway22ndAve,12/16/2016 03:00:00 AM,48,-122,0,0,0
24508,58thStGreenway22ndAve,12/16/2016 04:00:00 AM,48,-122,0,0,0
24509,58thStGreenway22ndAve,12/16/2016 05:00:00 AM,48,-122,0,0,0
24510,58thStGreenway22ndAve,12/16/2016 06:00:00 AM,48,-122,0,0,0
24511,58thStGreenway22ndAve,12/16/2016 07:00:00 AM,48,-122,4,1,5
24512,58thStGreenway22ndAve,12/16/2016 08:00:00 AM,48,-122,4,2,6
24513,58thStGreenway22ndAve,12/16/2016 09:00:00 AM,48,-122,0,2,2
24514,58thStGreenway22ndAve,12/16/2016 10:00:00 AM,48,-122,3,3,6
24515,58thStGreenway22ndAve,12/16/2016 11:00:00 AM,48,-122,1,2,3
24516,58thStGreenway22ndAve,12/16/2016 12:00:00 PM,48,-122,1,8,9
24517,58thStGreenway22ndAve,12/16/2016 01:00:00 PM,48,-122,2,4,6
24518,58thStGreenway22ndAve,12/16/2016 02:00:00 PM,48,-122,5,2,7
24519,58thStGreenway22ndAve,12/16/2016 03:00:00 PM,48,-122,2,7,9
24520,58thStGreenway22ndAve,12/16/2016 04:00:00 PM,48,-122,2,6,8
24521,58thStGreenway22ndAve,12/16/2016 05:00:00 PM,48,-122,3,5,8
24522,58thStGreenway22ndAve,12/16/2016 06:00:00 PM,48,-122,1,3,4
24523,58thStGreenway22ndAve,12/16/2016 07:00:00 PM,48,-122,6,2,8
24524,58thStGreenway22ndAve,12/16/2016 08:00:00 PM,48,-122,1,4,5
24525,58thStGreenway22ndAve,12/16/2016 09:00:00 PM,48,-122,0,1,1
24526,58thStGreenway22ndAve,12/16/2016 10:00:00 PM,48,-122,3,2,5
24527,58thStGreenway22ndAve,12/16/2016 11:00:00 PM,48,-122,2,0,2
24528,58thStGreenway22ndAve,12/17/2016 12:00:00 AM,48,-122,1,2,3
24529,58thStGreenway22ndAve,12/17/2016 01:00:00 AM,48,-122,0,1,1
24530,58thStGreenway22ndAve,12/17/2016 02:00:00 AM,48,-122,1,0,1
24531,58thStGreenway22ndAve,12/17/2016 03:00:00 AM,48,-122,0,0,0
24532,58thStGreenway22ndAve,12/17/2016 04:00:00 AM,48,-122,0,0,0
24533,58thStGreenway22ndAve,12/17/2016 05:00:00 AM,48,-122,0,0,0
24534,58thStGreenway22ndAve,12/17/2016 06:00:00 AM,48,-122,0,0,0
24535,58thStGreenway22ndAve,12/17/2016 07:00:00 AM,48,-122,1,0,1
24536,58thStGreenway22ndAve,12/17/2016 08:00:00 AM,48,-122,1,1,2
24537,58thStGreenway22ndAve,12/17/2016 09:00:00 AM,48,-122,2,2,4
24538,58thStGreenway22ndAve,12/17/2016 10:00:00 AM,48,-122,1,1,2
24539,58thStGreenway22ndAve,12/17/2016 11:00:00 AM,48,-122,3,3,6
24540,58thStGreenway22ndAve,12/17/2016 12:00:00 PM,48,-122,3,3,6
24541,58thStGreenway22ndAve,12/17/2016 01:00:00 PM,48,-122,4,6,10
24542,58thStGreenway22ndAve,12/17/2016 02:00:00 PM,48,-122,1,6,7
24543,58thStGreenway22ndAve,12/17/2016 03:00:00 PM,48,-122,1,2,3
24544,58thStGreenway22ndAve,12/17/2016 04:00:00 PM,48,-122,3,1,4
24545,58thStGreenway22ndAve,12/17/2016 05:00:00 PM,48,-122,3,1,4
24546,58thStGreenway22ndAve,12/17/2016 06:00:00 PM,48,-122,3,2,5
24547,58thStGreenway22ndAve,12/17/2016 07:00:00 PM,48,-122,3,4,7
24548,58thStGreenway22ndAve,12/17/2016 08:00:00 PM,48,-122,1,0,1
24549,58thStGreenway22ndAve,12/17/2016 09:00:00 PM,48,-122,0,0,0
24550,58thStGreenway22ndAve,12/17/2016 10:00:00 PM,48,-122,0,0,0
24551,58thStGreenway22ndAve,12/17/2016 11:00:00 PM,48,-122,1,0,1
24552,58thStGreenway22ndAve,12/18/2016 12:00:00 AM,48,-122,1,0,1
24553,58thStGreenway22ndAve,12/18/2016 01:00:00 AM,48,-122,0,0,0
24554,58thStGreenway22ndAve,12/18/2016 02:00:00 AM,48,-122,0,0,0
24555,58thStGreenway22ndAve,12/18/2016 03:00:00 AM,48,-122,0,0,0
24556,58thStGreenway22ndAve,12/18/2016 04:00:00 AM,48,-122,0,0,0
24557,58thStGreenway22ndAve,12/18/2016 05:00:00 AM,48,-122,0,0,0
24558,58thStGreenway22ndAve,12/18/2016 06:00:00 AM,48,-122,0,2,2
24559,58thStGreenway22ndAve,12/18/2016 07:00:00 AM,48,-122,0,0,0
24560,58thStGreenway22ndAve,12/18/2016 08:00:00 AM,48,-122,1,0,1
24561,58thStGreenway22ndAve,12/18/2016 09:00:00 AM,48,-122,3,3,6
24562,58thStGreenway22ndAve,12/18/2016 10:00:00 AM,48,-122,2,4,6
24563,58thStGreenway22ndAve,12/18/2016 11:00:00 AM,48,-122,1,5,6
24564,58thStGreenway22ndAve,12/18/2016 12:00:00 PM,48,-122,3,12,15
24565,58thStGreenway22ndAve,12/18/2016 01:00:00 PM,48,-122,9,3,12
24566,58thStGreenway22ndAve,12/18/2016 02:00:00 PM,48,-122,6,9,15
24567,58thStGreenway22ndAve,12/18/2016 03:00:00 PM,48,-122,2,8,10
24568,58thStGreenway22ndAve,12/18/2016 04:00:00 PM,48,-122,4,7,11
24569,58thStGreenway22ndAve,12/18/2016 05:00:00 PM,48,-122,2,1,3
24570,58thStGreenway22ndAve,12/18/2016 06:00:00 PM,48,-122,2,0,2
24571,58thStGreenway22ndAve,12/18/2016 07:00:00 PM,48,-122,2,2,4
24572,58thStGreenway22ndAve,12/18/2016 08:00:00 PM,48,-122,0,2,2
24573,58thStGreenway22ndAve,12/18/2016 09:00:00 PM,48,-122,0,2,2
24574,58thStGreenway22ndAve,12/18/2016 10:00:00 PM,48,-122,0,0,0
24575,58thStGreenway22ndAve,12/18/2016 11:00:00 PM,48,-122,1,1,2
24576,58thStGreenway22ndAve,12/19/2016 12:00:00 AM,48,-122,0,0,0
24577,58thStGreenway22ndAve,12/19/2016 01:00:00 AM,48,-122,0,0,0
24578,58thStGreenway22ndAve,12/19/2016 02:00:00 AM,48,-122,0,0,0
24579,58thStGreenway22ndAve,12/19/2016 03:00:00 AM,48,-122,0,0,0
24580,58thStGreenway22ndAve,12/19/2016 04:00:00 AM,48,-122,1,0,1
24581,58thStGreenway22ndAve,12/19/2016 05:00:00 AM,48,-122,0,1,1
24582,58thStGreenway22ndAve,12/19/2016 06:00:00 AM,48,-122,1,0,1
24583,58thStGreenway22ndAve,12/19/2016 07:00:00 AM,48,-122,5,2,7
24584,58thStGreenway22ndAve,12/19/2016 08:00:00 AM,48,-122,2,2,4
24585,58thStGreenway22ndAve,12/19/2016 09:00:00 AM,48,-122,4,4,8
24586,58thStGreenway22ndAve,12/19/2016 10:00:00 AM,48,-122,1,0,1
24587,58thStGreenway22ndAve,12/19/2016 11:00:00 AM,48,-122,0,7,7
24588,58thStGreenway22ndAve,12/19/2016 12:00:00 PM,48,-122,1,2,3
24589,58thStGreenway22ndAve,12/19/2016 01:00:00 PM,48,-122,0,4,4
24590,58thStGreenway22ndAve,12/19/2016 02:00:00 PM,48,-122,2,6,8
24591,58thStGreenway22ndAve,12/19/2016 03:00:00 PM,48,-122,3,3,6
24592,58thStGreenway22ndAve,12/19/2016 04:00:00 PM,48,-122,2,6,8
24593,58thStGreenway22ndAve,12/19/2016 05:00:00 PM,48,-122,2,8,10
24594,58thStGreenway22ndAve,12/19/2016 06:00:00 PM,48,-122,1,2,3
24595,58thStGreenway22ndAve,12/19/2016 07:00:00 PM,48,-122,2,6,8
24596,58thStGreenway22ndAve,12/19/2016 08:00:00 PM,48,-122,3,0,3
24597,58thStGreenway22ndAve,12/19/2016 09:00:00 PM,48,-122,2,1,3
24598,58thStGreenway22ndAve,12/19/2016 10:00:00 PM,48,-122,1,1,2
24599,58thStGreenway22ndAve,12/19/2016 11:00:00 PM,48,-122,0,0,0
24600,58thStGreenway22ndAve,12/20/2016 12:00:00 AM,48,-122,0,0,0
24601,58thStGreenway22ndAve,12/20/2016 01:00:00 AM,48,-122,0,0,0
24602,58thStGreenway22ndAve,12/20/2016 02:00:00 AM,48,-122,0,0,0
24603,58thStGreenway22ndAve,12/20/2016 03:00:00 AM,48,-122,0,0,0
24604,58thStGreenway22ndAve,12/20/2016 04:00:00 AM,48,-122,0,0,0
24605,58thStGreenway22ndAve,12/20/2016 05:00:00 AM,48,-122,0,0,0
24606,58thStGreenway22ndAve,12/20/2016 06:00:00 AM,48,-122,0,1,1
24607,58thStGreenway22ndAve,12/20/2016 07:00:00 AM,48,-122,3,0,3
24608,58thStGreenway22ndAve,12/20/2016 08:00:00 AM,48,-122,6,5,11
24609,58thStGreenway22ndAve,12/20/2016 09:00:00 AM,48,-122,4,0,4
24610,58thStGreenway22ndAve,12/20/2016 10:00:00 AM,48,-122,0,1,1
24611,58thStGreenway22ndAve,12/20/2016 11:00:00 AM,48,-122,4,5,9
24612,58thStGreenway22ndAve,12/20/2016 12:00:00 PM,48,-122,3,5,8
24613,58thStGreenway22ndAve,12/20/2016 01:00:00 PM,48,-122,5,4,9
24614,58thStGreenway22ndAve,12/20/2016 02:00:00 PM,48,-122,1,2,3
24615,58thStGreenway22ndAve,12/20/2016 03:00:00 PM,48,-122,5,6,11
24616,58thStGreenway22ndAve,12/20/2016 04:00:00 PM,48,-122,2,5,7
24617,58thStGreenway22ndAve,12/20/2016 05:00:00 PM,48,-122,7,2,9
24618,58thStGreenway22ndAve,12/20/2016 06:00:00 PM,48,-122,7,3,10
24619,58thStGreenway22ndAve,12/20/2016 07:00:00 PM,48,-122,3,1,4
24620,58thStGreenway22ndAve,12/20/2016 08:00:00 PM,48,-122,2,0,2
24621,58thStGreenway22ndAve,12/20/2016 09:00:00 PM,48,-122,1,0,1
24622,58thStGreenway22ndAve,12/20/2016 10:00:00 PM,48,-122,0,1,1
24623,58thStGreenway22ndAve,12/20/2016 11:00:00 PM,48,-122,3,0,3
24624,58thStGreenway22ndAve,12/21/2016 12:00:00 AM,48,-122,0,1,1
24625,58thStGreenway22ndAve,12/21/2016 01:00:00 AM,48,-122,0,0,0
24626,58thStGreenway22ndAve,12/21/2016 02:00:00 AM,48,-122,0,0,0
24627,58thStGreenway22ndAve,12/21/2016 03:00:00 AM,48,-122,0,0,0
24628,58thStGreenway22ndAve,12/21/2016 04:00:00 AM,48,-122,0,0,0
24629,58thStGreenway22ndAve,12/21/2016 05:00:00 AM,48,-122,0,0,0
24630,58thStGreenway22ndAve,12/21/2016 06:00:00 AM,48,-122,1,2,3
24631,58thStGreenway22ndAve,12/21/2016 07:00:00 AM,48,-122,3,1,4
24632,58thStGreenway22ndAve,12/21/2016 08:00:00 AM,48,-122,2,5,7
24633,58thStGreenway22ndAve,12/21/2016 09:00:00 AM,48,-122,1,3,4
24634,58thStGreenway22ndAve,12/21/2016 10:00:00 AM,48,-122,2,3,5
24635,58thStGreenway22ndAve,12/21/2016 11:00:00 AM,48,-122,1,7,8
24636,58thStGreenway22ndAve,12/21/2016 12:00:00 PM,48,-122,2,8,10
24637,58thStGreenway22ndAve,12/21/2016 01:00:00 PM,48,-122,1,3,4
24638,58thStGreenway22ndAve,12/21/2016 02:00:00 PM,48,-122,4,0,4
24639,58thStGreenway22ndAve,12/21/2016 03:00:00 PM,48,-122,2,3,5
24640,58thStGreenway22ndAve,12/21/2016 04:00:00 PM,48,-122,1,1,2
24641,58thStGreenway22ndAve,12/21/2016 05:00:00 PM,48,-122,3,8,11
24642,58thStGreenway22ndAve,12/21/2016 06:00:00 PM,48,-122,1,3,4
24643,58thStGreenway22ndAve,12/21/2016 07:00:00 PM,48,-122,6,1,7
24644,58thStGreenway22ndAve,12/21/2016 08:00:00 PM,48,-122,1,0,1
24645,58thStGreenway22ndAve,12/21/2016 09:00:00 PM,48,-122,0,0,0
24646,58thStGreenway22ndAve,12/21/2016 10:00:00 PM,48,-122,0,1,1
24647,58thStGreenway22ndAve,12/21/2016 11:00:00 PM,48,-122,1,0,1
24648,58thStGreenway22ndAve,12/22/2016 12:00:00 AM,48,-122,0,0,0
24649,58thStGreenway22ndAve,12/22/2016 01:00:00 AM,48,-122,0,0,0
24650,58thStGreenway22ndAve,12/22/2016 02:00:00 AM,48,-122,0,0,0
24651,58thStGreenway22ndAve,12/22/2016 03:00:00 AM,48,-122,0,0,0
24652,58thStGreenway22ndAve,12/22/2016 04:00:00 AM,48,-122,0,0,0
24653,58thStGreenway22ndAve,12/22/2016 05:00:00 AM,48,-122,0,1,1
24654,58thStGreenway22ndAve,12/22/2016 06:00:00 AM,48,-122,0,0,0
24655,58thStGreenway22ndAve,12/22/2016 07:00:00 AM,48,-122,7,0,7
24656,58thStGreenway22ndAve,12/22/2016 08:00:00 AM,48,-122,2,0,2
24657,58thStGreenway22ndAve,12/22/2016 09:00:00 AM,48,-122,3,2,5
24658,58thStGreenway22ndAve,12/22/2016 10:00:00 AM,48,-122,2,1,3
24659,58thStGreenway22ndAve,12/22/2016 11:00:00 AM,48,-122,5,5,10
24660,58thStGreenway22ndAve,12/22/2016 12:00:00 PM,48,-122,3,0,3
24661,58thStGreenway22ndAve,12/22/2016 01:00:00 PM,48,-122,1,12,13
24662,58thStGreenway22ndAve,12/22/2016 02:00:00 PM,48,-122,2,4,6
24663,58thStGreenway22ndAve,12/22/2016 03:00:00 PM,48,-122,2,2,4
24664,58thStGreenway22ndAve,12/22/2016 04:00:00 PM,48,-122,1,0,1
24665,58thStGreenway22ndAve,12/22/2016 05:00:00 PM,48,-122,3,6,9
24666,58thStGreenway22ndAve,12/22/2016 06:00:00 PM,48,-122,3,3,6
24667,58thStGreenway22ndAve,12/22/2016 07:00:00 PM,48,-122,0,4,4
24668,58thStGreenway22ndAve,12/22/2016 08:00:00 PM,48,-122,3,4,7
24669,58thStGreenway22ndAve,12/22/2016 09:00:00 PM,48,-122,0,0,0
24670,58thStGreenway22ndAve,12/22/2016 10:00:00 PM,48,-122,1,0,1
24671,58thStGreenway22ndAve,12/22/2016 11:00:00 PM,48,-122,1,0,1
24672,58thStGreenway22ndAve,12/23/2016 12:00:00 AM,48,-122,1,0,1
24673,58thStGreenway22ndAve,12/23/2016 01:00:00 AM,48,-122,0,1,1
24674,58thStGreenway22ndAve,12/23/2016 02:00:00 AM,48,-122,0,0,0
24675,58thStGreenway22ndAve,12/23/2016 03:00:00 AM,48,-122,0,0,0
24676,58thStGreenway22ndAve,12/23/2016 04:00:00 AM,48,-122,0,0,0
24677,58thStGreenway22ndAve,12/23/2016 05:00:00 AM,48,-122,0,0,0
24678,58thStGreenway22ndAve,12/23/2016 06:00:00 AM,48,-122,0,0,0
24679,58thStGreenway22ndAve,12/23/2016 07:00:00 AM,48,-122,2,0,2
24680,58thStGreenway22ndAve,12/23/2016 08:00:00 AM,48,-122,2,3,5
24681,58thStGreenway22ndAve,12/23/2016 09:00:00 AM,48,-122,3,2,5
24682,58thStGreenway22ndAve,12/23/2016 10:00:00 AM,48,-122,2,2,4
24683,58thStGreenway22ndAve,12/23/2016 11:00:00 AM,48,-122,2,1,3
24684,58thStGreenway22ndAve,12/23/2016 12:00:00 PM,48,-122,1,2,3
24685,58thStGreenway22ndAve,12/23/2016 01:00:00 PM,48,-122,3,1,4
24686,58thStGreenway22ndAve,12/23/2016 02:00:00 PM,48,-122,2,2,4
24687,58thStGreenway22ndAve,12/23/2016 03:00:00 PM,48,-122,1,4,5
24688,58thStGreenway22ndAve,12/23/2016 04:00:00 PM,48,-122,1,1,2
24689,58thStGreenway22ndAve,12/23/2016 05:00:00 PM,48,-122,0,6,6
24690,58thStGreenway22ndAve,12/23/2016 06:00:00 PM,48,-122,1,2,3
24691,58thStGreenway22ndAve,12/23/2016 07:00:00 PM,48,-122,0,1,1
24692,58thStGreenway22ndAve,12/23/2016 08:00:00 PM,48,-122,0,0,0
24693,58thStGreenway22ndAve,12/23/2016 09:00:00 PM,48,-122,1,0,1
24694,58thStGreenway22ndAve,12/23/2016 10:00:00 PM,48,-122,0,0,0
24695,58thStGreenway22ndAve,12/23/2016 11:00:00 PM,48,-122,1,0,1
24696,58thStGreenway22ndAve,12/24/2016 12:00:00 AM,48,-122,0,0,0
24697,58thStGreenway22ndAve,12/24/2016 01:00:00 AM,48,-122,0,0,0
24698,58thStGreenway22ndAve,12/24/2016 02:00:00 AM,48,-122,0,0,0
24699,58thStGreenway22ndAve,12/24/2016 03:00:00 AM,48,-122,0,0,0
24700,58thStGreenway22ndAve,12/24/2016 04:00:00 AM,48,-122,0,0,0
24701,58thStGreenway22ndAve,12/24/2016 05:00:00 AM,48,-122,0,0,0
24702,58thStGreenway22ndAve,12/24/2016 06:00:00 AM,48,-122,0,0,0
24703,58thStGreenway22ndAve,12/24/2016 07:00:00 AM,48,-122,0,0,0
24704,58thStGreenway22ndAve,12/24/2016 08:00:00 AM,48,-122,0,0,0
24705,58thStGreenway22ndAve,12/24/2016 09:00:00 AM,48,-122,1,0,1
24706,58thStGreenway22ndAve,12/24/2016 10:00:00 AM,48,-122,1,1,2
24707,58thStGreenway22ndAve,12/24/2016 11:00:00 AM,48,-122,1,1,2
24708,58thStGreenway22ndAve,12/24/2016 12:00:00 PM,48,-122,3,0,3
24709,58thStGreenway22ndAve,12/24/2016 01:00:00 PM,48,-122,2,2,4
24710,58thStGreenway22ndAve,12/24/2016 02:00:00 PM,48,-122,3,0,3
24711,58thStGreenway22ndAve,12/24/2016 03:00:00 PM,48,-122,2,3,5
24712,58thStGreenway22ndAve,12/24/2016 04:00:00 PM,48,-122,1,1,2
24713,58thStGreenway22ndAve,12/24/2016 05:00:00 PM,48,-122,0,0,0
24714,58thStGreenway22ndAve,12/24/2016 06:00:00 PM,48,-122,1,0,1
24715,58thStGreenway22ndAve,12/24/2016 07:00:00 PM,48,-122,1,0,1
24716,58thStGreenway22ndAve,12/24/2016 08:00:00 PM,48,-122,1,2,3
24717,58thStGreenway22ndAve,12/24/2016 09:00:00 PM,48,-122,2,0,2
24718,58thStGreenway22ndAve,12/24/2016 10:00:00 PM,48,-122,0,0,0
24719,58thStGreenway22ndAve,12/24/2016 11:00:00 PM,48,-122,0,0,0
24720,58thStGreenway22ndAve,12/25/2016 12:00:00 AM,48,-122,0,0,0
24721,58thStGreenway22ndAve,12/25/2016 01:00:00 AM,48,-122,0,0,0
24722,58thStGreenway22ndAve,12/25/2016 02:00:00 AM,48,-122,0,0,0
24723,58thStGreenway22ndAve,12/25/2016 03:00:00 AM,48,-122,0,0,0
24724,58thStGreenway22ndAve,12/25/2016 04:00:00 AM,48,-122,0,0,0
24725,58thStGreenway22ndAve,12/25/2016 05:00:00 AM,48,-122,0,0,0
24726,58thStGreenway22ndAve,12/25/2016 06:00:00 AM,48,-122,0,0,0
24727,58thStGreenway22ndAve,12/25/2016 07:00:00 AM,48,-122,0,0,0
24728,58thStGreenway22ndAve,12/25/2016 08:00:00 AM,48,-122,1,0,1
24729,58thStGreenway22ndAve,12/25/2016 09:00:00 AM,48,-122,0,0,0
24730,58thStGreenway22ndAve,12/25/2016 10:00:00 AM,48,-122,0,0,0
24731,58thStGreenway22ndAve,12/25/2016 11:00:00 AM,48,-122,3,0,3
24732,58thStGreenway22ndAve,12/25/2016 12:00:00 PM,48,-122,0,0,0
24733,58thStGreenway22ndAve,12/25/2016 01:00:00 PM,48,-122,3,0,3
24734,58thStGreenway22ndAve,12/25/2016 02:00:00 PM,48,-122,1,0,1
24735,58thStGreenway22ndAve,12/25/2016 03:00:00 PM,48,-122,1,0,1
24736,58thStGreenway22ndAve,12/25/2016 04:00:00 PM,48,-122,1,0,1
24737,58thStGreenway22ndAve,12/25/2016 05:00:00 PM,48,-122,0,0,0
24738,58thStGreenway22ndAve,12/25/2016 06:00:00 PM,48,-122,0,0,0
24739,58thStGreenway22ndAve,12/25/2016 07:00:00 PM,48,-122,1,0,1
24740,58thStGreenway22ndAve,12/25/2016 08:00:00 PM,48,-122,0,0,0
24741,58thStGreenway22ndAve,12/25/2016 09:00:00 PM,48,-122,0,0,0
24742,58thStGreenway22ndAve,12/25/2016 10:00:00 PM,48,-122,0,0,0
24743,58thStGreenway22ndAve,12/25/2016 11:00:00 PM,48,-122,0,0,0
24744,58thStGreenway22ndAve,12/26/2016 12:00:00 AM,48,-122,0,0,0
24745,58thStGreenway22ndAve,12/26/2016 01:00:00 AM,48,-122,1,0,1
24746,58thStGreenway22ndAve,12/26/2016 02:00:00 AM,48,-122,0,0,0
24747,58thStGreenway22ndAve,12/26/2016 03:00:00 AM,48,-122,0,0,0
24748,58thStGreenway22ndAve,12/26/2016 04:00:00 AM,48,-122,0,0,0
24749,58thStGreenway22ndAve,12/26/2016 05:00:00 AM,48,-122,0,0,0
24750,58thStGreenway22ndAve,12/26/2016 06:00:00 AM,48,-122,1,0,1
24751,58thStGreenway22ndAve,12/26/2016 07:00:00 AM,48,-122,0,0,0
24752,58thStGreenway22ndAve,12/26/2016 08:00:00 AM,48,-122,0,0,0
24753,58thStGreenway22ndAve,12/26/2016 09:00:00 AM,48,-122,3,1,4
24754,58thStGreenway22ndAve,12/26/2016 10:00:00 AM,48,-122,0,0,0
24755,58thStGreenway22ndAve,12/26/2016 11:00:00 AM,48,-122,4,0,4
24756,58thStGreenway22ndAve,12/26/2016 12:00:00 PM,48,-122,1,0,1
24757,58thStGreenway22ndAve,12/26/2016 01:00:00 PM,48,-122,5,0,5
24758,58thStGreenway22ndAve,12/26/2016 02:00:00 PM,48,-122,1,1,2
24759,58thStGreenway22ndAve,12/26/2016 03:00:00 PM,48,-122,3,2,5
24760,58thStGreenway22ndAve,12/26/2016 04:00:00 PM,48,-122,2,0,2
24761,58thStGreenway22ndAve,12/26/2016 05:00:00 PM,48,-122,0,0,0
24762,58thStGreenway22ndAve,12/26/2016 06:00:00 PM,48,-122,2,0,2
24763,58thStGreenway22ndAve,12/26/2016 07:00:00 PM,48,-122,1,0,1
24764,58thStGreenway22ndAve,12/26/2016 08:00:00 PM,48,-122,0,0,0
24765,58thStGreenway22ndAve,12/26/2016 09:00:00 PM,48,-122,0,0,0
24766,58thStGreenway22ndAve,12/26/2016 10:00:00 PM,48,-122,0,0,0
24767,58thStGreenway22ndAve,12/26/2016 11:00:00 PM,48,-122,0,0,0
24768,58thStGreenway22ndAve,12/27/2016 12:00:00 AM,48,-122,0,0,0
24769,58thStGreenway22ndAve,12/27/2016 01:00:00 AM,48,-122,0,0,0
24770,58thStGreenway22ndAve,12/27/2016 02:00:00 AM,48,-122,1,0,1
24771,58thStGreenway22ndAve,12/27/2016 03:00:00 AM,48,-122,0,0,0
24772,58thStGreenway22ndAve,12/27/2016 04:00:00 AM,48,-122,0,0,0
24773,58thStGreenway22ndAve,12/27/2016 05:00:00 AM,48,-122,0,0,0
24774,58thStGreenway22ndAve,12/27/2016 06:00:00 AM,48,-122,0,0,0
24775,58thStGreenway22ndAve,12/27/2016 07:00:00 AM,48,-122,1,1,2
24776,58thStGreenway22ndAve,12/27/2016 08:00:00 AM,48,-122,2,0,2
24777,58thStGreenway22ndAve,12/27/2016 09:00:00 AM,48,-122,2,1,3
24778,58thStGreenway22ndAve,12/27/2016 10:00:00 AM,48,-122,0,1,1
24779,58thStGreenway22ndAve,12/27/2016 11:00:00 AM,48,-122,1,2,3
24780,58thStGreenway22ndAve,12/27/2016 12:00:00 PM,48,-122,1,2,3
24781,58thStGreenway22ndAve,12/27/2016 01:00:00 PM,48,-122,4,0,4
24782,58thStGreenway22ndAve,12/27/2016 02:00:00 PM,48,-122,1,1,2
24783,58thStGreenway22ndAve,12/27/2016 03:00:00 PM,48,-122,1,0,1
24784,58thStGreenway22ndAve,12/27/2016 04:00:00 PM,48,-122,1,0,1
24785,58thStGreenway22ndAve,12/27/2016 05:00:00 PM,48,-122,4,1,5
24786,58thStGreenway22ndAve,12/27/2016 06:00:00 PM,48,-122,2,0,2
24787,58thStGreenway22ndAve,12/27/2016 07:00:00 PM,48,-122,3,1,4
24788,58thStGreenway22ndAve,12/27/2016 08:00:00 PM,48,-122,1,0,1
24789,58thStGreenway22ndAve,12/27/2016 09:00:00 PM,48,-122,1,0,1
24790,58thStGreenway22ndAve,12/27/2016 10:00:00 PM,48,-122,0,0,0
24791,58thStGreenway22ndAve,12/27/2016 11:00:00 PM,48,-122,0,0,0
24792,58thStGreenway22ndAve,12/28/2016 12:00:00 AM,48,-122,0,0,0
24793,58thStGreenway22ndAve,12/28/2016 01:00:00 AM,48,-122,0,0,0
24794,58thStGreenway22ndAve,12/28/2016 02:00:00 AM,48,-122,0,0,0
24795,58thStGreenway22ndAve,12/28/2016 03:00:00 AM,48,-122,0,0,0
24796,58thStGreenway22ndAve,12/28/2016 04:00:00 AM,48,-122,0,0,0
24797,58thStGreenway22ndAve,12/28/2016 05:00:00 AM,48,-122,0,0,0
24798,58thStGreenway22ndAve,12/28/2016 06:00:00 AM,48,-122,0,1,1
24799,58thStGreenway22ndAve,12/28/2016 07:00:00 AM,48,-122,5,1,6
24800,58thStGreenway22ndAve,12/28/2016 08:00:00 AM,48,-122,2,0,2
24801,58thStGreenway22ndAve,12/28/2016 09:00:00 AM,48,-122,2,3,5
24802,58thStGreenway22ndAve,12/28/2016 10:00:00 AM,48,-122,2,1,3
24803,58thStGreenway22ndAve,12/28/2016 11:00:00 AM,48,-122,1,5,6
24804,58thStGreenway22ndAve,12/28/2016 12:00:00 PM,48,-122,3,1,4
24805,58thStGreenway22ndAve,12/28/2016 01:00:00 PM,48,-122,6,1,7
24806,58thStGreenway22ndAve,12/28/2016 02:00:00 PM,48,-122,5,3,8
24807,58thStGreenway22ndAve,12/28/2016 03:00:00 PM,48,-122,6,0,6
24808,58thStGreenway22ndAve,12/28/2016 04:00:00 PM,48,-122,2,1,3
24809,58thStGreenway22ndAve,12/28/2016 05:00:00 PM,48,-122,2,1,3
24810,58thStGreenway22ndAve,12/28/2016 06:00:00 PM,48,-122,3,0,3
24811,58thStGreenway22ndAve,12/28/2016 07:00:00 PM,48,-122,2,0,2
24812,58thStGreenway22ndAve,12/28/2016 08:00:00 PM,48,-122,1,0,1
24813,58thStGreenway22ndAve,12/28/2016 09:00:00 PM,48,-122,1,0,1
24814,58thStGreenway22ndAve,12/28/2016 10:00:00 PM,48,-122,0,0,0
24815,58thStGreenway22ndAve,12/28/2016 11:00:00 PM,48,-122,1,0,1
24816,58thStGreenway22ndAve,12/29/2016 12:00:00 AM,48,-122,0,0,0
24817,58thStGreenway22ndAve,12/29/2016 01:00:00 AM,48,-122,0,0,0
24818,58thStGreenway22ndAve,12/29/2016 02:00:00 AM,48,-122,0,0,0
24819,58thStGreenway22ndAve,12/29/2016 03:00:00 AM,48,-122,0,0,0
24820,58thStGreenway22ndAve,12/29/2016 04:00:00 AM,48,-122,0,0,0
24821,58thStGreenway22ndAve,12/29/2016 05:00:00 AM,48,-122,0,0,0
24822,58thStGreenway22ndAve,12/29/2016 06:00:00 AM,48,-122,1,0,1
24823,58thStGreenway22ndAve,12/29/2016 07:00:00 AM,48,-122,2,1,3
24824,58thStGreenway22ndAve,12/29/2016 08:00:00 AM,48,-122,5,1,6
24825,58thStGreenway22ndAve,12/29/2016 09:00:00 AM,48,-122,2,0,2
24826,58thStGreenway22ndAve,12/29/2016 10:00:00 AM,48,-122,3,0,3
24827,58thStGreenway22ndAve,12/29/2016 11:00:00 AM,48,-122,3,0,3
24828,58thStGreenway22ndAve,12/29/2016 12:00:00 PM,48,-122,4,1,5
24829,58thStGreenway22ndAve,12/29/2016 01:00:00 PM,48,-122,2,1,3
24830,58thStGreenway22ndAve,12/29/2016 02:00:00 PM,48,-122,1,0,1
24831,58thStGreenway22ndAve,12/29/2016 03:00:00 PM,48,-122,5,0,5
24832,58thStGreenway22ndAve,12/29/2016 04:00:00 PM,48,-122,3,1,4
24833,58thStGreenway22ndAve,12/29/2016 05:00:00 PM,48,-122,1,0,1
24834,58thStGreenway22ndAve,12/29/2016 06:00:00 PM,48,-122,5,1,6
24835,58thStGreenway22ndAve,12/29/2016 07:00:00 PM,48,-122,4,0,4
24836,58thStGreenway22ndAve,12/29/2016 08:00:00 PM,48,-122,2,1,3
24837,58thStGreenway22ndAve,12/29/2016 09:00:00 PM,48,-122,1,0,1
24838,58thStGreenway22ndAve,12/29/2016 10:00:00 PM,48,-122,2,0,2
24839,58thStGreenway22ndAve,12/29/2016 11:00:00 PM,48,-122,0,0,0
24840,58thStGreenway22ndAve,12/30/2016 12:00:00 AM,48,-122,0,0,0
24841,58thStGreenway22ndAve,12/30/2016 01:00:00 AM,48,-122,0,0,0
24842,58thStGreenway22ndAve,12/30/2016 02:00:00 AM,48,-122,0,0,0
24843,58thStGreenway22ndAve,12/30/2016 03:00:00 AM,48,-122,0,0,0
24844,58thStGreenway22ndAve,12/30/2016 04:00:00 AM,48,-122,0,0,0
24845,58thStGreenway22ndAve,12/30/2016 05:00:00 AM,48,-122,0,0,0
24846,58thStGreenway22ndAve,12/30/2016 06:00:00 AM,48,-122,2,0,2
24847,58thStGreenway22ndAve,12/30/2016 07:00:00 AM,48,-122,4,0,4
24848,58thStGreenway22ndAve,12/30/2016 08:00:00 AM,48,-122,0,0,0
24849,58thStGreenway22ndAve,12/30/2016 09:00:00 AM,48,-122,7,0,7
24850,58thStGreenway22ndAve,12/30/2016 10:00:00 AM,48,-122,3,1,4
24851,58thStGreenway22ndAve,12/30/2016 11:00:00 AM,48,-122,6,1,7
24852,58thStGreenway22ndAve,12/30/2016 12:00:00 PM,48,-122,6,0,6
24853,58thStGreenway22ndAve,12/30/2016 01:00:00 PM,48,-122,6,1,7
24854,58thStGreenway22ndAve,12/30/2016 02:00:00 PM,48,-122,3,0,3
24855,58thStGreenway22ndAve,12/30/2016 03:00:00 PM,48,-122,2,3,5
24856,58thStGreenway22ndAve,12/30/2016 04:00:00 PM,48,-122,5,2,7
24857,58thStGreenway22ndAve,12/30/2016 05:00:00 PM,48,-122,3,1,4
24858,58thStGreenway22ndAve,12/30/2016 06:00:00 PM,48,-122,0,0,0
24859,58thStGreenway22ndAve,12/30/2016 07:00:00 PM,48,-122,1,1,2
24860,58thStGreenway22ndAve,12/30/2016 08:00:00 PM,48,-122,2,1,3
24861,58thStGreenway22ndAve,12/30/2016 09:00:00 PM,48,-122,4,0,4
24862,58thStGreenway22ndAve,12/30/2016 10:00:00 PM,48,-122,0,1,1
24863,58thStGreenway22ndAve,12/30/2016 11:00:00 PM,48,-122,1,0,1
24864,58thStGreenway22ndAve,12/31/2016 12:00:00 AM,48,-122,1,1,2
24865,58thStGreenway22ndAve,12/31/2016 01:00:00 AM,48,-122,0,0,0
24866,58thStGreenway22ndAve,12/31/2016 02:00:00 AM,48,-122,0,0,0
24867,58thStGreenway22ndAve,12/31/2016 03:00:00 AM,48,-122,0,0,0
24868,58thStGreenway22ndAve,12/31/2016 04:00:00 AM,48,-122,0,0,0
24869,58thStGreenway22ndAve,12/31/2016 05:00:00 AM,48,-122,0,0,0
24870,58thStGreenway22ndAve,12/31/2016 06:00:00 AM,48,-122,0,0,0
24871,58thStGreenway22ndAve,12/31/2016 07:00:00 AM,48,-122,1,0,1
24872,58thStGreenway22ndAve,12/31/2016 08:00:00 AM,48,-122,1,1,2
24873,58thStGreenway22ndAve,12/31/2016 09:00:00 AM,48,-122,0,1,1
24874,58thStGreenway22ndAve,12/31/2016 10:00:00 AM,48,-122,5,0,5
24875,58thStGreenway22ndAve,12/31/2016 11:00:00 AM,48,-122,2,2,4
24876,58thStGreenway22ndAve,12/31/2016 12:00:00 PM,48,-122,3,1,4
24877,58thStGreenway22ndAve,12/31/2016 01:00:00 PM,48,-122,5,2,7
24878,58thStGreenway22ndAve,12/31/2016 02:00:00 PM,48,-122,1,2,3
24879,58thStGreenway22ndAve,12/31/2016 03:00:00 PM,48,-122,2,1,3
24880,58thStGreenway22ndAve,12/31/2016 04:00:00 PM,48,-122,2,1,3
24881,58thStGreenway22ndAve,12/31/2016 05:00:00 PM,48,-122,3,0,3
24882,58thStGreenway22ndAve,12/31/2016 06:00:00 PM,48,-122,0,1,1
24883,58thStGreenway22ndAve,12/31/2016 07:00:00 PM,48,-122,1,0,1
24884,58thStGreenway22ndAve,12/31/2016 08:00:00 PM,48,-122,1,1,2
24885,58thStGreenway22ndAve,12/31/2016 09:00:00 PM,48,-122,0,0,0
24886,58thStGreenway22ndAve,12/31/2016 10:00:00 PM,48,-122,0,0,0
24887,58thStGreenway22ndAve,12/31/2016 11:00:00 PM,48,-122,1,1,2
24888,58thStGreenway22ndAve,01/01/2017 12:00:00 AM,48,-122,0,0,0
24889,58thStGreenway22ndAve,01/01/2017 01:00:00 AM,48,-122,1,1,2
24890,58thStGreenway22ndAve,01/01/2017 02:00:00 AM,48,-122,0,0,0
24891,58thStGreenway22ndAve,01/01/2017 03:00:00 AM,48,-122,0,0,0
24892,58thStGreenway22ndAve,01/01/2017 04:00:00 AM,48,-122,0,0,0
24893,58thStGreenway22ndAve,01/01/2017 05:00:00 AM,48,-122,0,0,0
24894,58thStGreenway22ndAve,01/01/2017 06:00:00 AM,48,-122,0,0,0
24895,58thStGreenway22ndAve,01/01/2017 07:00:00 AM,48,-122,1,0,1
24896,58thStGreenway22ndAve,01/01/2017 08:00:00 AM,48,-122,0,0,0
24897,58thStGreenway22ndAve,01/01/2017 09:00:00 AM,48,-122,3,0,3
24898,58thStGreenway22ndAve,01/01/2017 10:00:00 AM,48,-122,1,0,1
24899,58thStGreenway22ndAve,01/01/2017 11:00:00 AM,48,-122,1,0,1
24900,58thStGreenway22ndAve,01/01/2017 12:00:00 PM,48,-122,3,1,4
24901,58thStGreenway22ndAve,01/01/2017 01:00:00 PM,48,-122,2,0,2
24902,58thStGreenway22ndAve,01/01/2017 02:00:00 PM,48,-122,0,0,0
24903,58thStGreenway22ndAve,01/01/2017 03:00:00 PM,48,-122,1,3,4
24904,58thStGreenway22ndAve,01/01/2017 04:00:00 PM,48,-122,0,4,4
24905,58thStGreenway22ndAve,01/01/2017 05:00:00 PM,48,-122,0,1,1
24906,58thStGreenway22ndAve,01/01/2017 06:00:00 PM,48,-122,1,6,7
24907,58thStGreenway22ndAve,01/01/2017 07:00:00 PM,48,-122,0,0,0
24908,58thStGreenway22ndAve,01/01/2017 08:00:00 PM,48,-122,0,4,4
24909,58thStGreenway22ndAve,01/01/2017 09:00:00 PM,48,-122,1,5,6
24910,58thStGreenway22ndAve,01/01/2017 10:00:00 PM,48,-122,0,2,2
24911,58thStGreenway22ndAve,01/01/2017 11:00:00 PM,48,-122,0,1,1
24912,58thStGreenway22ndAve,01/02/2017 12:00:00 AM,48,-122,0,3,3
24913,58thStGreenway22ndAve,01/02/2017 01:00:00 AM,48,-122,1,1,2
24914,58thStGreenway22ndAve,01/02/2017 02:00:00 AM,48,-122,0,0,0
24915,58thStGreenway22ndAve,01/02/2017 03:00:00 AM,48,-122,0,1,1
24916,58thStGreenway22ndAve,01/02/2017 04:00:00 AM,48,-122,0,1,1
24917,58thStGreenway22ndAve,01/02/2017 05:00:00 AM,48,-122,0,0,0
24918,58thStGreenway22ndAve,01/02/2017 06:00:00 AM,48,-122,0,0,0
24919,58thStGreenway22ndAve,01/02/2017 07:00:00 AM,48,-122,1,3,4
24920,58thStGreenway22ndAve,01/02/2017 08:00:00 AM,48,-122,0,1,1
24921,58thStGreenway22ndAve,01/02/2017 09:00:00 AM,48,-122,1,2,3
24922,58thStGreenway22ndAve,01/02/2017 10:00:00 AM,48,-122,0,0,0
24923,58thStGreenway22ndAve,01/02/2017 11:00:00 AM,48,-122,5,1,6
24924,58thStGreenway22ndAve,01/02/2017 12:00:00 PM,48,-122,8,1,9
24925,58thStGreenway22ndAve,01/02/2017 01:00:00 PM,48,-122,1,1,2
24926,58thStGreenway22ndAve,01/02/2017 02:00:00 PM,48,-122,4,3,7
24927,58thStGreenway22ndAve,01/02/2017 03:00:00 PM,48,-122,6,2,8
24928,58thStGreenway22ndAve,01/02/2017 04:00:00 PM,48,-122,3,2,5
24929,58thStGreenway22ndAve,01/02/2017 05:00:00 PM,48,-122,4,4,8
24930,58thStGreenway22ndAve,01/02/2017 06:00:00 PM,48,-122,2,1,3
24931,58thStGreenway22ndAve,01/02/2017 07:00:00 PM,48,-122,1,0,1
24932,58thStGreenway22ndAve,01/02/2017 08:00:00 PM,48,-122,1,2,3
24933,58thStGreenway22ndAve,01/02/2017 09:00:00 PM,48,-122,1,5,6
24934,58thStGreenway22ndAve,01/02/2017 10:00:00 PM,48,-122,1,2,3
24935,58thStGreenway22ndAve,01/02/2017 11:00:00 PM,48,-122,1,1,2
24936,58thStGreenway22ndAve,01/03/2017 12:00:00 AM,48,-122,0,2,2
24937,58thStGreenway22ndAve,01/03/2017 01:00:00 AM,48,-122,0,0,0
24938,58thStGreenway22ndAve,01/03/2017 02:00:00 AM,48,-122,0,0,0
24939,58thStGreenway22ndAve,01/03/2017 03:00:00 AM,48,-122,1,0,1
24940,58thStGreenway22ndAve,01/03/2017 04:00:00 AM,48,-122,0,0,0
24941,58thStGreenway22ndAve,01/03/2017 05:00:00 AM,48,-122,0,0,0
24942,58thStGreenway22ndAve,01/03/2017 06:00:00 AM,48,-122,0,2,2
24943,58thStGreenway22ndAve,01/03/2017 07:00:00 AM,48,-122,1,1,2
24944,58thStGreenway22ndAve,01/03/2017 08:00:00 AM,48,-122,0,0,0
24945,58thStGreenway22ndAve,01/03/2017 09:00:00 AM,48,-122,3,1,4
24946,58thStGreenway22ndAve,01/03/2017 10:00:00 AM,48,-122,,,
24947,58thStGreenway22ndAve,01/03/2017 11:00:00 AM,48,-122,3,0,3
24948,58thStGreenway22ndAve,01/03/2017 12:00:00 PM,48,-122,0,0,0
24949,58thStGreenway22ndAve,01/03/2017 01:00:00 PM,48,-122,2,3,5
24950,58thStGreenway22ndAve,01/03/2017 02:00:00 PM,48,-122,2,9,11
24951,58thStGreenway22ndAve,01/03/2017 03:00:00 PM,48,-122,2,3,5
24952,58thStGreenway22ndAve,01/03/2017 04:00:00 PM,48,-122,1,5,6
24953,58thStGreenway22ndAve,01/03/2017 05:00:00 PM,48,-122,4,1,5
24954,58thStGreenway22ndAve,01/03/2017 06:00:00 PM,48,-122,2,0,2
24955,58thStGreenway22ndAve,01/03/2017 07:00:00 PM,48,-122,2,0,2
24956,58thStGreenway22ndAve,01/03/2017 08:00:00 PM,48,-122,1,0,1
24957,58thStGreenway22ndAve,01/03/2017 09:00:00 PM,48,-122,1,1,2
24958,58thStGreenway22ndAve,01/03/2017 10:00:00 PM,48,-122,0,1,1
24959,58thStGreenway22ndAve,01/03/2017 11:00:00 PM,48,-122,0,0,0
24960,58thStGreenway22ndAve,01/04/2017 12:00:00 AM,48,-122,0,0,0
24961,58thStGreenway22ndAve,01/04/2017 01:00:00 AM,48,-122,0,0,0
24962,58thStGreenway22ndAve,01/04/2017 02:00:00 AM,48,-122,0,0,0
24963,58thStGreenway22ndAve,01/04/2017 03:00:00 AM,48,-122,0,0,0
24964,58thStGreenway22ndAve,01/04/2017 04:00:00 AM,48,-122,0,0,0
24965,58thStGreenway22ndAve,01/04/2017 05:00:00 AM,48,-122,0,0,0
24966,58thStGreenway22ndAve,01/04/2017 06:00:00 AM,48,-122,0,0,0
24967,58thStGreenway22ndAve,01/04/2017 07:00:00 AM,48,-122,0,0,0
24968,58thStGreenway22ndAve,01/04/2017 08:00:00 AM,48,-122,0,0,0
24969,58thStGreenway22ndAve,01/04/2017 09:00:00 AM,48,-122,0,0,0
24970,58thStGreenway22ndAve,01/04/2017 10:00:00 AM,48,-122,0,0,0
24971,58thStGreenway22ndAve,01/04/2017 11:00:00 AM,48,-122,2,2,4
24972,58thStGreenway22ndAve,01/04/2017 12:00:00 PM,48,-122,0,0,0
24973,58thStGreenway22ndAve,01/04/2017 01:00:00 PM,48,-122,3,1,4
24974,58thStGreenway22ndAve,01/04/2017 02:00:00 PM,48,-122,1,3,4
24975,58thStGreenway22ndAve,01/04/2017 03:00:00 PM,48,-122,1,5,6
24976,58thStGreenway22ndAve,01/04/2017 04:00:00 PM,48,-122,5,0,5
24977,58thStGreenway22ndAve,01/04/2017 05:00:00 PM,48,-122,9,0,9
24978,58thStGreenway22ndAve,01/04/2017 06:00:00 PM,48,-122,1,0,1
24979,58thStGreenway22ndAve,01/04/2017 07:00:00 PM,48,-122,0,0,0
24980,58thStGreenway22ndAve,01/04/2017 08:00:00 PM,48,-122,0,0,0
24981,58thStGreenway22ndAve,01/04/2017 09:00:00 PM,48,-122,0,0,0
24982,58thStGreenway22ndAve,01/04/2017 10:00:00 PM,48,-122,0,0,0
24983,58thStGreenway22ndAve,01/04/2017 11:00:00 PM,48,-122,0,0,0
24984,58thStGreenway22ndAve,01/05/2017 12:00:00 AM,48,-122,0,0,0
24985,58thStGreenway22ndAve,01/05/2017 01:00:00 AM,48,-122,0,0,0
24986,58thStGreenway22ndAve,01/05/2017 02:00:00 AM,48,-122,0,0,0
24987,58thStGreenway22ndAve,01/05/2017 03:00:00 AM,48,-122,0,0,0
24988,58thStGreenway22ndAve,01/05/2017 04:00:00 AM,48,-122,0,0,0
24989,58thStGreenway22ndAve,01/05/2017 05:00:00 AM,48,-122,0,0,0
24990,58thStGreenway22ndAve,01/05/2017 06:00:00 AM,48,-122,0,0,0
24991,58thStGreenway22ndAve,01/05/2017 07:00:00 AM,48,-122,0,0,0
24992,58thStGreenway22ndAve,01/05/2017 08:00:00 AM,48,-122,0,0,0
24993,58thStGreenway22ndAve,01/05/2017 09:00:00 AM,48,-122,0,0,0
24994,58thStGreenway22ndAve,01/05/2017 10:00:00 AM,48,-122,0,0,0
24995,58thStGreenway22ndAve,01/05/2017 11:00:00 AM,48,-122,0,0,0
24996,58thStGreenway22ndAve,01/05/2017 12:00:00 PM,48,-122,1,1,2
24997,58thStGreenway22ndAve,01/05/2017 01:00:00 PM,48,-122,2,0,2
24998,58thStGreenway22ndAve,01/05/2017 02:00:00 PM,48,-122,0,0,0
24999,58thStGreenway22ndAve,01/05/2017 03:00:00 PM,48,-122,0,0,0
25000,58thStGreenway22ndAve,01/05/2017 04:00:00 PM,48,-122,1,0,1
25001,58thStGreenway22ndAve,01/05/2017 05:00:00 PM,48,-122,0,0,0
25002,58thStGreenway22ndAve,01/05/2017 06:00:00 PM,48,-122,2,0,2
25003,58thStGreenway22ndAve,01/05/2017 07:00:00 PM,48,-122,0,0,0
25004,58thStGreenway22ndAve,01/05/2017 08:00:00 PM,48,-122,1,0,1
25005,58thStGreenway22ndAve,01/05/2017 09:00:00 PM,48,-122,3,0,3
25006,58thStGreenway22ndAve,01/05/2017 10:00:00 PM,48,-122,1,0,1
25007,58thStGreenway22ndAve,01/05/2017 11:00:00 PM,48,-122,0,0,0
25008,58thStGreenway22ndAve,01/06/2017 12:00:00 AM,48,-122,0,0,0
25009,58thStGreenway22ndAve,01/06/2017 01:00:00 AM,48,-122,0,0,0
25010,58thStGreenway22ndAve,01/06/2017 02:00:00 AM,48,-122,0,0,0
25011,58thStGreenway22ndAve,01/06/2017 03:00:00 AM,48,-122,0,0,0
25012,58thStGreenway22ndAve,01/06/2017 04:00:00 AM,48,-122,0,0,0
25013,58thStGreenway22ndAve,01/06/2017 05:00:00 AM,48,-122,0,0,0
25014,58thStGreenway22ndAve,01/06/2017 06:00:00 AM,48,-122,0,0,0
25015,58thStGreenway22ndAve,01/06/2017 07:00:00 AM,48,-122,0,0,0
25016,58thStGreenway22ndAve,01/06/2017 08:00:00 AM,48,-122,0,0,0
25017,58thStGreenway22ndAve,01/06/2017 09:00:00 AM,48,-122,0,0,0
25018,58thStGreenway22ndAve,01/06/2017 10:00:00 AM,48,-122,3,0,3
25019,58thStGreenway22ndAve,01/06/2017 11:00:00 AM,48,-122,0,0,0
25020,58thStGreenway22ndAve,01/06/2017 12:00:00 PM,48,-122,0,0,0
25021,58thStGreenway22ndAve,01/06/2017 01:00:00 PM,48,-122,0,0,0
25022,58thStGreenway22ndAve,01/06/2017 02:00:00 PM,48,-122,0,0,0
25023,58thStGreenway22ndAve,01/06/2017 03:00:00 PM,48,-122,3,0,3
25024,58thStGreenway22ndAve,01/06/2017 04:00:00 PM,48,-122,0,0,0
25025,58thStGreenway22ndAve,01/06/2017 05:00:00 PM,48,-122,0,0,0
25026,58thStGreenway22ndAve,01/06/2017 06:00:00 PM,48,-122,0,0,0
25027,58thStGreenway22ndAve,01/06/2017 07:00:00 PM,48,-122,0,0,0
25028,58thStGreenway22ndAve,01/06/2017 08:00:00 PM,48,-122,1,0,1
25029,58thStGreenway22ndAve,01/06/2017 09:00:00 PM,48,-122,0,0,0
25030,58thStGreenway22ndAve,01/06/2017 10:00:00 PM,48,-122,0,0,0
25031,58thStGreenway22ndAve,01/06/2017 11:00:00 PM,48,-122,0,0,0
25032,58thStGreenway22ndAve,01/07/2017 12:00:00 AM,48,-122,0,0,0
25033,58thStGreenway22ndAve,01/07/2017 01:00:00 AM,48,-122,0,0,0
25034,58thStGreenway22ndAve,01/07/2017 02:00:00 AM,48,-122,0,0,0
25035,58thStGreenway22ndAve,01/07/2017 03:00:00 AM,48,-122,0,0,0
25036,58thStGreenway22ndAve,01/07/2017 04:00:00 AM,48,-122,0,0,0
25037,58thStGreenway22ndAve,01/07/2017 05:00:00 AM,48,-122,0,0,0
25038,58thStGreenway22ndAve,01/07/2017 06:00:00 AM,48,-122,0,0,0
25039,58thStGreenway22ndAve,01/07/2017 07:00:00 AM,48,-122,0,0,0
25040,58thStGreenway22ndAve,01/07/2017 08:00:00 AM,48,-122,0,0,0
25041,58thStGreenway22ndAve,01/07/2017 09:00:00 AM,48,-122,0,1,1
25042,58thStGreenway22ndAve,01/07/2017 10:00:00 AM,48,-122,4,3,7
25043,58thStGreenway22ndAve,01/07/2017 11:00:00 AM,48,-122,4,4,8
25044,58thStGreenway22ndAve,01/07/2017 12:00:00 PM,48,-122,1,3,4
25045,58thStGreenway22ndAve,01/07/2017 01:00:00 PM,48,-122,1,3,4
25046,58thStGreenway22ndAve,01/07/2017 02:00:00 PM,48,-122,3,2,5
25047,58thStGreenway22ndAve,01/07/2017 03:00:00 PM,48,-122,4,3,7
25048,58thStGreenway22ndAve,01/07/2017 04:00:00 PM,48,-122,2,2,4
25049,58thStGreenway22ndAve,01/07/2017 05:00:00 PM,48,-122,2,3,5
25050,58thStGreenway22ndAve,01/07/2017 06:00:00 PM,48,-122,3,1,4
25051,58thStGreenway22ndAve,01/07/2017 07:00:00 PM,48,-122,1,0,1
25052,58thStGreenway22ndAve,01/07/2017 08:00:00 PM,48,-122,1,1,2
25053,58thStGreenway22ndAve,01/07/2017 09:00:00 PM,48,-122,0,1,1
25054,58thStGreenway22ndAve,01/07/2017 10:00:00 PM,48,-122,0,1,1
25055,58thStGreenway22ndAve,01/07/2017 11:00:00 PM,48,-122,1,0,1
25056,58thStGreenway22ndAve,01/08/2017 12:00:00 AM,48,-122,0,0,0
25057,58thStGreenway22ndAve,01/08/2017 01:00:00 AM,48,-122,0,0,0
25058,58thStGreenway22ndAve,01/08/2017 02:00:00 AM,48,-122,0,0,0
25059,58thStGreenway22ndAve,01/08/2017 03:00:00 AM,48,-122,0,2,2
25060,58thStGreenway22ndAve,01/08/2017 04:00:00 AM,48,-122,0,0,0
25061,58thStGreenway22ndAve,01/08/2017 05:00:00 AM,48,-122,0,0,0
25062,58thStGreenway22ndAve,01/08/2017 06:00:00 AM,48,-122,0,0,0
25063,58thStGreenway22ndAve,01/08/2017 07:00:00 AM,48,-122,0,0,0
25064,58thStGreenway22ndAve,01/08/2017 08:00:00 AM,48,-122,0,0,0
25065,58thStGreenway22ndAve,01/08/2017 09:00:00 AM,48,-122,1,0,1
25066,58thStGreenway22ndAve,01/08/2017 10:00:00 AM,48,-122,3,0,3
25067,58thStGreenway22ndAve,01/08/2017 11:00:00 AM,48,-122,2,0,2
25068,58thStGreenway22ndAve,01/08/2017 12:00:00 PM,48,-122,2,1,3
25069,58thStGreenway22ndAve,01/08/2017 01:00:00 PM,48,-122,3,0,3
25070,58thStGreenway22ndAve,01/08/2017 02:00:00 PM,48,-122,5,1,6
25071,58thStGreenway22ndAve,01/08/2017 03:00:00 PM,48,-122,1,2,3
25072,58thStGreenway22ndAve,01/08/2017 04:00:00 PM,48,-122,2,0,2
25073,58thStGreenway22ndAve,01/08/2017 05:00:00 PM,48,-122,2,1,3
25074,58thStGreenway22ndAve,01/08/2017 06:00:00 PM,48,-122,2,5,7
25075,58thStGreenway22ndAve,01/08/2017 07:00:00 PM,48,-122,0,2,2
25076,58thStGreenway22ndAve,01/08/2017 08:00:00 PM,48,-122,2,1,3
25077,58thStGreenway22ndAve,01/08/2017 09:00:00 PM,48,-122,0,0,0
25078,58thStGreenway22ndAve,01/08/2017 10:00:00 PM,48,-122,0,1,1
25079,58thStGreenway22ndAve,01/08/2017 11:00:00 PM,48,-122,0,2,2
25080,58thStGreenway22ndAve,01/09/2017 12:00:00 AM,48,-122,0,0,0
25081,58thStGreenway22ndAve,01/09/2017 01:00:00 AM,48,-122,0,0,0
25082,58thStGreenway22ndAve,01/09/2017 02:00:00 AM,48,-122,0,0,0
25083,58thStGreenway22ndAve,01/09/2017 03:00:00 AM,48,-122,0,0,0
25084,58thStGreenway22ndAve,01/09/2017 04:00:00 AM,48,-122,0,0,0
25085,58thStGreenway22ndAve,01/09/2017 05:00:00 AM,48,-122,0,1,1
25086,58thStGreenway22ndAve,01/09/2017 06:00:00 AM,48,-122,0,1,1
25087,58thStGreenway22ndAve,01/09/2017 07:00:00 AM,48,-122,3,0,3
25088,58thStGreenway22ndAve,01/09/2017 08:00:00 AM,48,-122,1,3,4
25089,58thStGreenway22ndAve,01/09/2017 09:00:00 AM,48,-122,0,0,0
25090,58thStGreenway22ndAve,01/09/2017 10:00:00 AM,48,-122,1,2,3
25091,58thStGreenway22ndAve,01/09/2017 11:00:00 AM,48,-122,3,3,6
25092,58thStGreenway22ndAve,01/09/2017 12:00:00 PM,48,-122,2,0,2
25093,58thStGreenway22ndAve,01/09/2017 01:00:00 PM,48,-122,1,2,3
25094,58thStGreenway22ndAve,01/09/2017 02:00:00 PM,48,-122,3,3,6
25095,58thStGreenway22ndAve,01/09/2017 03:00:00 PM,48,-122,1,2,3
25096,58thStGreenway22ndAve,01/09/2017 04:00:00 PM,48,-122,2,2,4
25097,58thStGreenway22ndAve,01/09/2017 05:00:00 PM,48,-122,5,3,8
25098,58thStGreenway22ndAve,01/09/2017 06:00:00 PM,48,-122,0,2,2
25099,58thStGreenway22ndAve,01/09/2017 07:00:00 PM,48,-122,0,3,3
25100,58thStGreenway22ndAve,01/09/2017 08:00:00 PM,48,-122,2,3,5
25101,58thStGreenway22ndAve,01/09/2017 09:00:00 PM,48,-122,0,3,3
25102,58thStGreenway22ndAve,01/09/2017 10:00:00 PM,48,-122,0,3,3
25103,58thStGreenway22ndAve,01/09/2017 11:00:00 PM,48,-122,1,0,1
25104,58thStGreenway22ndAve,01/10/2017 12:00:00 AM,48,-122,0,1,1
25105,58thStGreenway22ndAve,01/10/2017 01:00:00 AM,48,-122,1,0,1
25106,58thStGreenway22ndAve,01/10/2017 02:00:00 AM,48,-122,0,0,0
25107,58thStGreenway22ndAve,01/10/2017 03:00:00 AM,48,-122,0,0,0
25108,58thStGreenway22ndAve,01/10/2017 04:00:00 AM,48,-122,0,0,0
25109,58thStGreenway22ndAve,01/10/2017 05:00:00 AM,48,-122,0,2,2
25110,58thStGreenway22ndAve,01/10/2017 06:00:00 AM,48,-122,0,1,1
25111,58thStGreenway22ndAve,01/10/2017 07:00:00 AM,48,-122,0,1,1
25112,58thStGreenway22ndAve,01/10/2017 08:00:00 AM,48,-122,1,0,1
25113,58thStGreenway22ndAve,01/10/2017 09:00:00 AM,48,-122,1,2,3
25114,58thStGreenway22ndAve,01/10/2017 10:00:00 AM,48,-122,3,0,3
25115,58thStGreenway22ndAve,01/10/2017 11:00:00 AM,48,-122,2,3,5
25116,58thStGreenway22ndAve,01/10/2017 12:00:00 PM,48,-122,2,11,13
25117,58thStGreenway22ndAve,01/10/2017 01:00:00 PM,48,-122,2,9,11
25118,58thStGreenway22ndAve,01/10/2017 02:00:00 PM,48,-122,2,6,8
25119,58thStGreenway22ndAve,01/10/2017 03:00:00 PM,48,-122,0,11,11
25120,58thStGreenway22ndAve,01/10/2017 04:00:00 PM,48,-122,4,13,17
25121,58thStGreenway22ndAve,01/10/2017 05:00:00 PM,48,-122,6,19,25
25122,58thStGreenway22ndAve,01/10/2017 06:00:00 PM,48,-122,1,12,13
25123,58thStGreenway22ndAve,01/10/2017 07:00:00 PM,48,-122,2,7,9
25124,58thStGreenway22ndAve,01/10/2017 08:00:00 PM,48,-122,0,4,4
25125,58thStGreenway22ndAve,01/10/2017 09:00:00 PM,48,-122,0,9,9
25126,58thStGreenway22ndAve,01/10/2017 10:00:00 PM,48,-122,0,7,7
25127,58thStGreenway22ndAve,01/10/2017 11:00:00 PM,48,-122,1,0,1
25128,58thStGreenway22ndAve,01/11/2017 12:00:00 AM,48,-122,0,3,3
25129,58thStGreenway22ndAve,01/11/2017 01:00:00 AM,48,-122,0,1,1
25130,58thStGreenway22ndAve,01/11/2017 02:00:00 AM,48,-122,0,1,1
25131,58thStGreenway22ndAve,01/11/2017 03:00:00 AM,48,-122,0,0,0
25132,58thStGreenway22ndAve,01/11/2017 04:00:00 AM,48,-122,0,0,0
25133,58thStGreenway22ndAve,01/11/2017 05:00:00 AM,48,-122,0,4,4
25134,58thStGreenway22ndAve,01/11/2017 06:00:00 AM,48,-122,2,1,3
25135,58thStGreenway22ndAve,01/11/2017 07:00:00 AM,48,-122,0,4,4
25136,58thStGreenway22ndAve,01/11/2017 08:00:00 AM,48,-122,5,3,8
25137,58thStGreenway22ndAve,01/11/2017 09:00:00 AM,48,-122,1,2,3
25138,58thStGreenway22ndAve,01/11/2017 10:00:00 AM,48,-122,4,1,5
25139,58thStGreenway22ndAve,01/11/2017 11:00:00 AM,48,-122,3,1,4
25140,58thStGreenway22ndAve,01/11/2017 12:00:00 PM,48,-122,7,6,13
25141,58thStGreenway22ndAve,01/11/2017 01:00:00 PM,48,-122,3,9,12
25142,58thStGreenway22ndAve,01/11/2017 02:00:00 PM,48,-122,8,4,12
25143,58thStGreenway22ndAve,01/11/2017 03:00:00 PM,48,-122,8,2,10
25144,58thStGreenway22ndAve,01/11/2017 04:00:00 PM,48,-122,8,6,14
25145,58thStGreenway22ndAve,01/11/2017 05:00:00 PM,48,-122,3,5,8
25146,58thStGreenway22ndAve,01/11/2017 06:00:00 PM,48,-122,2,2,4
25147,58thStGreenway22ndAve,01/11/2017 07:00:00 PM,48,-122,1,4,5
25148,58thStGreenway22ndAve,01/11/2017 08:00:00 PM,48,-122,1,3,4
25149,58thStGreenway22ndAve,01/11/2017 09:00:00 PM,48,-122,1,5,6
25150,58thStGreenway22ndAve,01/11/2017 10:00:00 PM,48,-122,0,0,0
25151,58thStGreenway22ndAve,01/11/2017 11:00:00 PM,48,-122,1,1,2
25152,58thStGreenway22ndAve,01/12/2017 12:00:00 AM,48,-122,0,1,1
25153,58thStGreenway22ndAve,01/12/2017 01:00:00 AM,48,-122,0,0,0
25154,58thStGreenway22ndAve,01/12/2017 02:00:00 AM,48,-122,0,0,0
25155,58thStGreenway22ndAve,01/12/2017 03:00:00 AM,48,-122,0,0,0
25156,58thStGreenway22ndAve,01/12/2017 04:00:00 AM,48,-122,0,0,0
25157,58thStGreenway22ndAve,01/12/2017 05:00:00 AM,48,-122,0,1,1
25158,58thStGreenway22ndAve,01/12/2017 06:00:00 AM,48,-122,1,1,2
25159,58thStGreenway22ndAve,01/12/2017 07:00:00 AM,48,-122,1,0,1
25160,58thStGreenway22ndAve,01/12/2017 08:00:00 AM,48,-122,3,0,3
25161,58thStGreenway22ndAve,01/12/2017 09:00:00 AM,48,-122,1,1,2
25162,58thStGreenway22ndAve,01/12/2017 10:00:00 AM,48,-122,1,3,4
25163,58thStGreenway22ndAve,01/12/2017 11:00:00 AM,48,-122,1,1,2
25164,58thStGreenway22ndAve,01/12/2017 12:00:00 PM,48,-122,2,1,3
25165,58thStGreenway22ndAve,01/12/2017 01:00:00 PM,48,-122,4,10,14
25166,58thStGreenway22ndAve,01/12/2017 02:00:00 PM,48,-122,3,1,4
25167,58thStGreenway22ndAve,01/12/2017 03:00:00 PM,48,-122,1,0,1
25168,58thStGreenway22ndAve,01/12/2017 04:00:00 PM,48,-122,1,0,1
25169,58thStGreenway22ndAve,01/12/2017 05:00:00 PM,48,-122,3,1,4
25170,58thStGreenway22ndAve,01/12/2017 06:00:00 PM,48,-122,5,2,7
25171,58thStGreenway22ndAve,01/12/2017 07:00:00 PM,48,-122,4,4,8
25172,58thStGreenway22ndAve,01/12/2017 08:00:00 PM,48,-122,0,1,1
25173,58thStGreenway22ndAve,01/12/2017 09:00:00 PM,48,-122,0,0,0
25174,58thStGreenway22ndAve,01/12/2017 10:00:00 PM,48,-122,1,2,3
25175,58thStGreenway22ndAve,01/12/2017 11:00:00 PM,48,-122,1,0,1
25176,58thStGreenway22ndAve,01/13/2017 12:00:00 AM,48,-122,0,0,0
25177,58thStGreenway22ndAve,01/13/2017 01:00:00 AM,48,-122,1,0,1
25178,58thStGreenway22ndAve,01/13/2017 02:00:00 AM,48,-122,0,0,0
25179,58thStGreenway22ndAve,01/13/2017 03:00:00 AM,48,-122,0,0,0
25180,58thStGreenway22ndAve,01/13/2017 04:00:00 AM,48,-122,1,0,1
25181,58thStGreenway22ndAve,01/13/2017 05:00:00 AM,48,-122,0,0,0
25182,58thStGreenway22ndAve,01/13/2017 06:00:00 AM,48,-122,0,0,0
25183,58thStGreenway22ndAve,01/13/2017 07:00:00 AM,48,-122,0,3,3
25184,58thStGreenway22ndAve,01/13/2017 08:00:00 AM,48,-122,2,0,2
25185,58thStGreenway22ndAve,01/13/2017 09:00:00 AM,48,-122,3,0,3
25186,58thStGreenway22ndAve,01/13/2017 10:00:00 AM,48,-122,2,1,3
25187,58thStGreenway22ndAve,01/13/2017 11:00:00 AM,48,-122,3,0,3
25188,58thStGreenway22ndAve,01/13/2017 12:00:00 PM,48,-122,2,1,3
25189,58thStGreenway22ndAve,01/13/2017 01:00:00 PM,48,-122,3,2,5
25190,58thStGreenway22ndAve,01/13/2017 02:00:00 PM,48,-122,2,0,2
25191,58thStGreenway22ndAve,01/13/2017 03:00:00 PM,48,-122,2,1,3
25192,58thStGreenway22ndAve,01/13/2017 04:00:00 PM,48,-122,1,0,1
25193,58thStGreenway22ndAve,01/13/2017 05:00:00 PM,48,-122,2,0,2
25194,58thStGreenway22ndAve,01/13/2017 06:00:00 PM,48,-122,2,2,4
25195,58thStGreenway22ndAve,01/13/2017 07:00:00 PM,48,-122,3,2,5
25196,58thStGreenway22ndAve,01/13/2017 08:00:00 PM,48,-122,0,1,1
25197,58thStGreenway22ndAve,01/13/2017 09:00:00 PM,48,-122,0,0,0
25198,58thStGreenway22ndAve,01/13/2017 10:00:00 PM,48,-122,0,1,1
25199,58thStGreenway22ndAve,01/13/2017 11:00:00 PM,48,-122,2,0,2
25200,58thStGreenway22ndAve,01/14/2017 12:00:00 AM,48,-122,0,0,0
25201,58thStGreenway22ndAve,01/14/2017 01:00:00 AM,48,-122,0,0,0
25202,58thStGreenway22ndAve,01/14/2017 02:00:00 AM,48,-122,0,1,1
25203,58thStGreenway22ndAve,01/14/2017 03:00:00 AM,48,-122,0,0,0
25204,58thStGreenway22ndAve,01/14/2017 04:00:00 AM,48,-122,0,0,0
25205,58thStGreenway22ndAve,01/14/2017 05:00:00 AM,48,-122,0,0,0
25206,58thStGreenway22ndAve,01/14/2017 06:00:00 AM,48,-122,1,0,1
25207,58thStGreenway22ndAve,01/14/2017 07:00:00 AM,48,-122,1,1,2
25208,58thStGreenway22ndAve,01/14/2017 08:00:00 AM,48,-122,1,0,1
25209,58thStGreenway22ndAve,01/14/2017 09:00:00 AM,48,-122,3,1,4
25210,58thStGreenway22ndAve,01/14/2017 10:00:00 AM,48,-122,5,2,7
25211,58thStGreenway22ndAve,01/14/2017 11:00:00 AM,48,-122,3,2,5
25212,58thStGreenway22ndAve,01/14/2017 12:00:00 PM,48,-122,1,1,2
25213,58thStGreenway22ndAve,01/14/2017 01:00:00 PM,48,-122,4,3,7
25214,58thStGreenway22ndAve,01/14/2017 02:00:00 PM,48,-122,0,0,0
25215,58thStGreenway22ndAve,01/14/2017 03:00:00 PM,48,-122,2,0,2
25216,58thStGreenway22ndAve,01/14/2017 04:00:00 PM,48,-122,5,2,7
25217,58thStGreenway22ndAve,01/14/2017 05:00:00 PM,48,-122,5,0,5
25218,58thStGreenway22ndAve,01/14/2017 06:00:00 PM,48,-122,1,0,1
25219,58thStGreenway22ndAve,01/14/2017 07:00:00 PM,48,-122,0,1,1
25220,58thStGreenway22ndAve,01/14/2017 08:00:00 PM,48,-122,2,0,2
25221,58thStGreenway22ndAve,01/14/2017 09:00:00 PM,48,-122,0,0,0
25222,58thStGreenway22ndAve,01/14/2017 10:00:00 PM,48,-122,0,0,0
25223,58thStGreenway22ndAve,01/14/2017 11:00:00 PM,48,-122,1,1,2
25224,58thStGreenway22ndAve,01/15/2017 12:00:00 AM,48,-122,1,0,1
25225,58thStGreenway22ndAve,01/15/2017 01:00:00 AM,48,-122,0,2,2
25226,58thStGreenway22ndAve,01/15/2017 02:00:00 AM,48,-122,0,1,1
25227,58thStGreenway22ndAve,01/15/2017 03:00:00 AM,48,-122,0,0,0
25228,58thStGreenway22ndAve,01/15/2017 04:00:00 AM,48,-122,0,0,0
25229,58thStGreenway22ndAve,01/15/2017 05:00:00 AM,48,-122,0,0,0
25230,58thStGreenway22ndAve,01/15/2017 06:00:00 AM,48,-122,0,0,0
25231,58thStGreenway22ndAve,01/15/2017 07:00:00 AM,48,-122,0,1,1
25232,58thStGreenway22ndAve,01/15/2017 08:00:00 AM,48,-122,0,0,0
25233,58thStGreenway22ndAve,01/15/2017 09:00:00 AM,48,-122,1,0,1
25234,58thStGreenway22ndAve,01/15/2017 10:00:00 AM,48,-122,5,0,5
25235,58thStGreenway22ndAve,01/15/2017 11:00:00 AM,48,-122,4,3,7
25236,58thStGreenway22ndAve,01/15/2017 12:00:00 PM,48,-122,5,1,6
25237,58thStGreenway22ndAve,01/15/2017 01:00:00 PM,48,-122,10,2,12
25238,58thStGreenway22ndAve,01/15/2017 02:00:00 PM,48,-122,11,4,15
25239,58thStGreenway22ndAve,01/15/2017 03:00:00 PM,48,-122,4,4,8
25240,58thStGreenway22ndAve,01/15/2017 04:00:00 PM,48,-122,5,0,5
25241,58thStGreenway22ndAve,01/15/2017 05:00:00 PM,48,-122,3,1,4
25242,58thStGreenway22ndAve,01/15/2017 06:00:00 PM,48,-122,8,0,8
25243,58thStGreenway22ndAve,01/15/2017 07:00:00 PM,48,-122,1,0,1
25244,58thStGreenway22ndAve,01/15/2017 08:00:00 PM,48,-122,1,1,2
25245,58thStGreenway22ndAve,01/15/2017 09:00:00 PM,48,-122,0,0,0
25246,58thStGreenway22ndAve,01/15/2017 10:00:00 PM,48,-122,0,0,0
25247,58thStGreenway22ndAve,01/15/2017 11:00:00 PM,48,-122,0,0,0
25248,58thStGreenway22ndAve,01/16/2017 12:00:00 AM,48,-122,0,0,0
25249,58thStGreenway22ndAve,01/16/2017 01:00:00 AM,48,-122,0,0,0
25250,58thStGreenway22ndAve,01/16/2017 02:00:00 AM,48,-122,0,0,0
25251,58thStGreenway22ndAve,01/16/2017 03:00:00 AM,48,-122,0,0,0
25252,58thStGreenway22ndAve,01/16/2017 04:00:00 AM,48,-122,0,0,0
25253,58thStGreenway22ndAve,01/16/2017 05:00:00 AM,48,-122,0,0,0
25254,58thStGreenway22ndAve,01/16/2017 06:00:00 AM,48,-122,4,0,4
25255,58thStGreenway22ndAve,01/16/2017 07:00:00 AM,48,-122,4,2,6
25256,58thStGreenway22ndAve,01/16/2017 08:00:00 AM,48,-122,1,1,2
25257,58thStGreenway22ndAve,01/16/2017 09:00:00 AM,48,-122,6,0,6
25258,58thStGreenway22ndAve,01/16/2017 10:00:00 AM,48,-122,1,1,2
25259,58thStGreenway22ndAve,01/16/2017 11:00:00 AM,48,-122,1,1,2
25260,58thStGreenway22ndAve,01/16/2017 12:00:00 PM,48,-122,3,1,4
25261,58thStGreenway22ndAve,01/16/2017 01:00:00 PM,48,-122,6,3,9
25262,58thStGreenway22ndAve,01/16/2017 02:00:00 PM,48,-122,3,1,4
25263,58thStGreenway22ndAve,01/16/2017 03:00:00 PM,48,-122,1,1,2
25264,58thStGreenway22ndAve,01/16/2017 04:00:00 PM,48,-122,0,2,2
25265,58thStGreenway22ndAve,01/16/2017 05:00:00 PM,48,-122,6,1,7
25266,58thStGreenway22ndAve,01/16/2017 06:00:00 PM,48,-122,0,0,0
25267,58thStGreenway22ndAve,01/16/2017 07:00:00 PM,48,-122,2,0,2
25268,58thStGreenway22ndAve,01/16/2017 08:00:00 PM,48,-122,2,0,2
25269,58thStGreenway22ndAve,01/16/2017 09:00:00 PM,48,-122,0,1,1
25270,58thStGreenway22ndAve,01/16/2017 10:00:00 PM,48,-122,0,0,0
25271,58thStGreenway22ndAve,01/16/2017 11:00:00 PM,48,-122,0,0,0
25272,58thStGreenway22ndAve,01/17/2017 12:00:00 AM,48,-122,0,0,0
25273,58thStGreenway22ndAve,01/17/2017 01:00:00 AM,48,-122,0,0,0
25274,58thStGreenway22ndAve,01/17/2017 02:00:00 AM,48,-122,0,0,0
25275,58thStGreenway22ndAve,01/17/2017 03:00:00 AM,48,-122,0,0,0
25276,58thStGreenway22ndAve,01/17/2017 04:00:00 AM,48,-122,0,0,0
25277,58thStGreenway22ndAve,01/17/2017 05:00:00 AM,48,-122,0,0,0
25278,58thStGreenway22ndAve,01/17/2017 06:00:00 AM,48,-122,1,0,1
25279,58thStGreenway22ndAve,01/17/2017 07:00:00 AM,48,-122,8,0,8
25280,58thStGreenway22ndAve,01/17/2017 08:00:00 AM,48,-122,5,0,5
25281,58thStGreenway22ndAve,01/17/2017 09:00:00 AM,48,-122,6,0,6
25282,58thStGreenway22ndAve,01/17/2017 10:00:00 AM,48,-122,0,2,2
25283,58thStGreenway22ndAve,01/17/2017 11:00:00 AM,48,-122,4,1,5
25284,58thStGreenway22ndAve,01/17/2017 12:00:00 PM,48,-122,1,4,5
25285,58thStGreenway22ndAve,01/17/2017 01:00:00 PM,48,-122,0,2,2
25286,58thStGreenway22ndAve,01/17/2017 02:00:00 PM,48,-122,2,3,5
25287,58thStGreenway22ndAve,01/17/2017 03:00:00 PM,48,-122,0,0,0
25288,58thStGreenway22ndAve,01/17/2017 04:00:00 PM,48,-122,2,3,5
25289,58thStGreenway22ndAve,01/17/2017 05:00:00 PM,48,-122,2,0,2
25290,58thStGreenway22ndAve,01/17/2017 06:00:00 PM,48,-122,0,6,6
25291,58thStGreenway22ndAve,01/17/2017 07:00:00 PM,48,-122,0,4,4
25292,58thStGreenway22ndAve,01/17/2017 08:00:00 PM,48,-122,0,3,3
25293,58thStGreenway22ndAve,01/17/2017 09:00:00 PM,48,-122,1,2,3
25294,58thStGreenway22ndAve,01/17/2017 10:00:00 PM,48,-122,0,1,1
25295,58thStGreenway22ndAve,01/17/2017 11:00:00 PM,48,-122,0,2,2
25296,58thStGreenway22ndAve,01/18/2017 12:00:00 AM,48,-122,0,1,1
25297,58thStGreenway22ndAve,01/18/2017 01:00:00 AM,48,-122,0,0,0
25298,58thStGreenway22ndAve,01/18/2017 02:00:00 AM,48,-122,0,2,2
25299,58thStGreenway22ndAve,01/18/2017 03:00:00 AM,48,-122,0,0,0
25300,58thStGreenway22ndAve,01/18/2017 04:00:00 AM,48,-122,0,0,0
25301,58thStGreenway22ndAve,01/18/2017 05:00:00 AM,48,-122,1,3,4
25302,58thStGreenway22ndAve,01/18/2017 06:00:00 AM,48,-122,1,1,2
25303,58thStGreenway22ndAve,01/18/2017 07:00:00 AM,48,-122,1,0,1
25304,58thStGreenway22ndAve,01/18/2017 08:00:00 AM,48,-122,1,2,3
25305,58thStGreenway22ndAve,01/18/2017 09:00:00 AM,48,-122,2,5,7
25306,58thStGreenway22ndAve,01/18/2017 10:00:00 AM,48,-122,0,1,1
25307,58thStGreenway22ndAve,01/18/2017 11:00:00 AM,48,-122,0,1,1
25308,58thStGreenway22ndAve,01/18/2017 12:00:00 PM,48,-122,0,1,1
25309,58thStGreenway22ndAve,01/18/2017 01:00:00 PM,48,-122,0,0,0
25310,58thStGreenway22ndAve,01/18/2017 02:00:00 PM,48,-122,1,3,4
25311,58thStGreenway22ndAve,01/18/2017 03:00:00 PM,48,-122,3,2,5
25312,58thStGreenway22ndAve,01/18/2017 04:00:00 PM,48,-122,0,1,1
25313,58thStGreenway22ndAve,01/18/2017 05:00:00 PM,48,-122,2,0,2
25314,58thStGreenway22ndAve,01/18/2017 06:00:00 PM,48,-122,1,1,2
25315,58thStGreenway22ndAve,01/18/2017 07:00:00 PM,48,-122,1,1,2
25316,58thStGreenway22ndAve,01/18/2017 08:00:00 PM,48,-122,0,0,0
25317,58thStGreenway22ndAve,01/18/2017 09:00:00 PM,48,-122,1,1,2
25318,58thStGreenway22ndAve,01/18/2017 10:00:00 PM,48,-122,0,1,1
25319,58thStGreenway22ndAve,01/18/2017 11:00:00 PM,48,-122,0,0,0
25320,58thStGreenway22ndAve,01/19/2017 12:00:00 AM,48,-122,0,0,0
25321,58thStGreenway22ndAve,01/19/2017 01:00:00 AM,48,-122,0,0,0
25322,58thStGreenway22ndAve,01/19/2017 02:00:00 AM,48,-122,0,0,0
25323,58thStGreenway22ndAve,01/19/2017 03:00:00 AM,48,-122,0,0,0
25324,58thStGreenway22ndAve,01/19/2017 04:00:00 AM,48,-122,0,1,1
25325,58thStGreenway22ndAve,01/19/2017 05:00:00 AM,48,-122,0,0,0
25326,58thStGreenway22ndAve,01/19/2017 06:00:00 AM,48,-122,1,1,2
25327,58thStGreenway22ndAve,01/19/2017 07:00:00 AM,48,-122,1,0,1
25328,58thStGreenway22ndAve,01/19/2017 08:00:00 AM,48,-122,0,2,2
25329,58thStGreenway22ndAve,01/19/2017 09:00:00 AM,48,-122,1,0,1
25330,58thStGreenway22ndAve,01/19/2017 10:00:00 AM,48,-122,2,1,3
25331,58thStGreenway22ndAve,01/19/2017 11:00:00 AM,48,-122,0,0,0
25332,58thStGreenway22ndAve,01/19/2017 12:00:00 PM,48,-122,4,0,4
25333,58thStGreenway22ndAve,01/19/2017 01:00:00 PM,48,-122,1,2,3
25334,58thStGreenway22ndAve,01/19/2017 02:00:00 PM,48,-122,1,5,6
25335,58thStGreenway22ndAve,01/19/2017 03:00:00 PM,48,-122,1,1,2
25336,58thStGreenway22ndAve,01/19/2017 04:00:00 PM,48,-122,2,2,4
25337,58thStGreenway22ndAve,01/19/2017 05:00:00 PM,48,-122,1,0,1
25338,58thStGreenway22ndAve,01/19/2017 06:00:00 PM,48,-122,1,3,4
25339,58thStGreenway22ndAve,01/19/2017 07:00:00 PM,48,-122,0,2,2
25340,58thStGreenway22ndAve,01/19/2017 08:00:00 PM,48,-122,0,1,1
25341,58thStGreenway22ndAve,01/19/2017 09:00:00 PM,48,-122,0,2,2
25342,58thStGreenway22ndAve,01/19/2017 10:00:00 PM,48,-122,1,1,2
25343,58thStGreenway22ndAve,01/19/2017 11:00:00 PM,48,-122,0,2,2
25344,58thStGreenway22ndAve,01/20/2017 12:00:00 AM,48,-122,0,0,0
25345,58thStGreenway22ndAve,01/20/2017 01:00:00 AM,48,-122,1,0,1
25346,58thStGreenway22ndAve,01/20/2017 02:00:00 AM,48,-122,0,0,0
25347,58thStGreenway22ndAve,01/20/2017 03:00:00 AM,48,-122,0,0,0
25348,58thStGreenway22ndAve,01/20/2017 04:00:00 AM,48,-122,0,0,0
25349,58thStGreenway22ndAve,01/20/2017 05:00:00 AM,48,-122,0,0,0
25350,58thStGreenway22ndAve,01/20/2017 06:00:00 AM,48,-122,0,1,1
25351,58thStGreenway22ndAve,01/20/2017 07:00:00 AM,48,-122,2,1,3
25352,58thStGreenway22ndAve,01/20/2017 08:00:00 AM,48,-122,0,2,2
25353,58thStGreenway22ndAve,01/20/2017 09:00:00 AM,48,-122,1,3,4
25354,58thStGreenway22ndAve,01/20/2017 10:00:00 AM,48,-122,1,2,3
25355,58thStGreenway22ndAve,01/20/2017 11:00:00 AM,48,-122,1,4,5
25356,58thStGreenway22ndAve,01/20/2017 12:00:00 PM,48,-122,0,2,2
25357,58thStGreenway22ndAve,01/20/2017 01:00:00 PM,48,-122,1,1,2
25358,58thStGreenway22ndAve,01/20/2017 02:00:00 PM,48,-122,1,8,9
25359,58thStGreenway22ndAve,01/20/2017 03:00:00 PM,48,-122,4,4,8
25360,58thStGreenway22ndAve,01/20/2017 04:00:00 PM,48,-122,1,4,5
25361,58thStGreenway22ndAve,01/20/2017 05:00:00 PM,48,-122,0,3,3
25362,58thStGreenway22ndAve,01/20/2017 06:00:00 PM,48,-122,2,0,2
25363,58thStGreenway22ndAve,01/20/2017 07:00:00 PM,48,-122,1,7,8
25364,58thStGreenway22ndAve,01/20/2017 08:00:00 PM,48,-122,1,4,5
25365,58thStGreenway22ndAve,01/20/2017 09:00:00 PM,48,-122,0,3,3
25366,58thStGreenway22ndAve,01/20/2017 10:00:00 PM,48,-122,1,0,1
25367,58thStGreenway22ndAve,01/20/2017 11:00:00 PM,48,-122,0,4,4
25368,58thStGreenway22ndAve,01/21/2017 12:00:00 AM,48,-122,0,2,2
25369,58thStGreenway22ndAve,01/21/2017 01:00:00 AM,48,-122,0,1,1
25370,58thStGreenway22ndAve,01/21/2017 02:00:00 AM,48,-122,0,1,1
25371,58thStGreenway22ndAve,01/21/2017 03:00:00 AM,48,-122,0,0,0
25372,58thStGreenway22ndAve,01/21/2017 04:00:00 AM,48,-122,0,0,0
25373,58thStGreenway22ndAve,01/21/2017 05:00:00 AM,48,-122,0,0,0
25374,58thStGreenway22ndAve,01/21/2017 06:00:00 AM,48,-122,0,0,0
25375,58thStGreenway22ndAve,01/21/2017 07:00:00 AM,48,-122,0,2,2
25376,58thStGreenway22ndAve,01/21/2017 08:00:00 AM,48,-122,0,3,3
25377,58thStGreenway22ndAve,01/21/2017 09:00:00 AM,48,-122,1,2,3
25378,58thStGreenway22ndAve,01/21/2017 10:00:00 AM,48,-122,0,2,2
25379,58thStGreenway22ndAve,01/21/2017 11:00:00 AM,48,-122,1,2,3
25380,58thStGreenway22ndAve,01/21/2017 12:00:00 PM,48,-122,1,2,3
25381,58thStGreenway22ndAve,01/21/2017 01:00:00 PM,48,-122,1,1,2
25382,58thStGreenway22ndAve,01/21/2017 02:00:00 PM,48,-122,0,7,7
25383,58thStGreenway22ndAve,01/21/2017 03:00:00 PM,48,-122,0,5,5
25384,58thStGreenway22ndAve,01/21/2017 04:00:00 PM,48,-122,4,6,10
25385,58thStGreenway22ndAve,01/21/2017 05:00:00 PM,48,-122,0,3,3
25386,58thStGreenway22ndAve,01/21/2017 06:00:00 PM,48,-122,0,6,6
25387,58thStGreenway22ndAve,01/21/2017 07:00:00 PM,48,-122,0,4,4
25388,58thStGreenway22ndAve,01/21/2017 08:00:00 PM,48,-122,0,2,2
25389,58thStGreenway22ndAve,01/21/2017 09:00:00 PM,48,-122,0,2,2
25390,58thStGreenway22ndAve,01/21/2017 10:00:00 PM,48,-122,2,0,2
25391,58thStGreenway22ndAve,01/21/2017 11:00:00 PM,48,-122,0,2,2
25392,58thStGreenway22ndAve,01/22/2017 12:00:00 AM,48,-122,0,2,2
25393,58thStGreenway22ndAve,01/22/2017 01:00:00 AM,48,-122,0,0,0
25394,58thStGreenway22ndAve,01/22/2017 02:00:00 AM,48,-122,0,1,1
25395,58thStGreenway22ndAve,01/22/2017 03:00:00 AM,48,-122,0,2,2
25396,58thStGreenway22ndAve,01/22/2017 04:00:00 AM,48,-122,0,1,1
25397,58thStGreenway22ndAve,01/22/2017 05:00:00 AM,48,-122,0,0,0
25398,58thStGreenway22ndAve,01/22/2017 06:00:00 AM,48,-122,0,0,0
25399,58thStGreenway22ndAve,01/22/2017 07:00:00 AM,48,-122,0,0,0
25400,58thStGreenway22ndAve,01/22/2017 08:00:00 AM,48,-122,1,1,2
25401,58thStGreenway22ndAve,01/22/2017 09:00:00 AM,48,-122,0,0,0
25402,58thStGreenway22ndAve,01/22/2017 10:00:00 AM,48,-122,0,0,0
25403,58thStGreenway22ndAve,01/22/2017 11:00:00 AM,48,-122,2,2,4
25404,58thStGreenway22ndAve,01/22/2017 12:00:00 PM,48,-122,0,0,0
25405,58thStGreenway22ndAve,01/22/2017 01:00:00 PM,48,-122,1,6,7
25406,58thStGreenway22ndAve,01/22/2017 02:00:00 PM,48,-122,2,2,4
25407,58thStGreenway22ndAve,01/22/2017 03:00:00 PM,48,-122,2,3,5
25408,58thStGreenway22ndAve,01/22/2017 04:00:00 PM,48,-122,0,3,3
25409,58thStGreenway22ndAve,01/22/2017 05:00:00 PM,48,-122,3,2,5
25410,58thStGreenway22ndAve,01/22/2017 06:00:00 PM,48,-122,0,2,2
25411,58thStGreenway22ndAve,01/22/2017 07:00:00 PM,48,-122,0,4,4
25412,58thStGreenway22ndAve,01/22/2017 08:00:00 PM,48,-122,0,5,5
25413,58thStGreenway22ndAve,01/22/2017 09:00:00 PM,48,-122,0,0,0
25414,58thStGreenway22ndAve,01/22/2017 10:00:00 PM,48,-122,1,1,2
25415,58thStGreenway22ndAve,01/22/2017 11:00:00 PM,48,-122,0,1,1
25416,58thStGreenway22ndAve,01/23/2017 12:00:00 AM,48,-122,0,0,0
25417,58thStGreenway22ndAve,01/23/2017 01:00:00 AM,48,-122,0,0,0
25418,58thStGreenway22ndAve,01/23/2017 02:00:00 AM,48,-122,0,0,0
25419,58thStGreenway22ndAve,01/23/2017 03:00:00 AM,48,-122,0,0,0
25420,58thStGreenway22ndAve,01/23/2017 04:00:00 AM,48,-122,0,0,0
25421,58thStGreenway22ndAve,01/23/2017 05:00:00 AM,48,-122,0,1,1
25422,58thStGreenway22ndAve,01/23/2017 06:00:00 AM,48,-122,0,0,0
25423,58thStGreenway22ndAve,01/23/2017 07:00:00 AM,48,-122,1,0,1
25424,58thStGreenway22ndAve,01/23/2017 08:00:00 AM,48,-122,1,0,1
25425,58thStGreenway22ndAve,01/23/2017 09:00:00 AM,48,-122,1,1,2
25426,58thStGreenway22ndAve,01/23/2017 10:00:00 AM,48,-122,1,2,3
25427,58thStGreenway22ndAve,01/23/2017 11:00:00 AM,48,-122,1,2,3
25428,58thStGreenway22ndAve,01/23/2017 12:00:00 PM,48,-122,0,3,3
25429,58thStGreenway22ndAve,01/23/2017 01:00:00 PM,48,-122,1,1,2
25430,58thStGreenway22ndAve,01/23/2017 02:00:00 PM,48,-122,3,1,4
25431,58thStGreenway22ndAve,01/23/2017 03:00:00 PM,48,-122,2,3,5
25432,58thStGreenway22ndAve,01/23/2017 04:00:00 PM,48,-122,3,6,9
25433,58thStGreenway22ndAve,01/23/2017 05:00:00 PM,48,-122,3,11,14
25434,58thStGreenway22ndAve,01/23/2017 06:00:00 PM,48,-122,0,2,2
25435,58thStGreenway22ndAve,01/23/2017 07:00:00 PM,48,-122,0,5,5
25436,58thStGreenway22ndAve,01/23/2017 08:00:00 PM,48,-122,0,2,2
25437,58thStGreenway22ndAve,01/23/2017 09:00:00 PM,48,-122,1,2,3
25438,58thStGreenway22ndAve,01/23/2017 10:00:00 PM,48,-122,0,1,1
25439,58thStGreenway22ndAve,01/23/2017 11:00:00 PM,48,-122,0,2,2
25440,58thStGreenway22ndAve,01/24/2017 12:00:00 AM,48,-122,0,0,0
25441,58thStGreenway22ndAve,01/24/2017 01:00:00 AM,48,-122,0,1,1
25442,58thStGreenway22ndAve,01/24/2017 02:00:00 AM,48,-122,0,0,0
25443,58thStGreenway22ndAve,01/24/2017 03:00:00 AM,48,-122,0,0,0
25444,58thStGreenway22ndAve,01/24/2017 04:00:00 AM,48,-122,0,1,1
25445,58thStGreenway22ndAve,01/24/2017 05:00:00 AM,48,-122,0,1,1
25446,58thStGreenway22ndAve,01/24/2017 06:00:00 AM,48,-122,0,0,0
25447,58thStGreenway22ndAve,01/24/2017 07:00:00 AM,48,-122,2,3,5
25448,58thStGreenway22ndAve,01/24/2017 08:00:00 AM,48,-122,0,0,0
25449,58thStGreenway22ndAve,01/24/2017 09:00:00 AM,48,-122,0,2,2
25450,58thStGreenway22ndAve,01/24/2017 10:00:00 AM,48,-122,1,0,1
25451,58thStGreenway22ndAve,01/24/2017 11:00:00 AM,48,-122,2,6,8
25452,58thStGreenway22ndAve,01/24/2017 12:00:00 PM,48,-122,1,6,7
25453,58thStGreenway22ndAve,01/24/2017 01:00:00 PM,48,-122,0,6,6
25454,58thStGreenway22ndAve,01/24/2017 02:00:00 PM,48,-122,3,2,5
25455,58thStGreenway22ndAve,01/24/2017 03:00:00 PM,48,-122,0,2,2
25456,58thStGreenway22ndAve,01/24/2017 04:00:00 PM,48,-122,1,5,6
25457,58thStGreenway22ndAve,01/24/2017 05:00:00 PM,48,-122,0,2,2
25458,58thStGreenway22ndAve,01/24/2017 06:00:00 PM,48,-122,2,2,4
25459,58thStGreenway22ndAve,01/24/2017 07:00:00 PM,48,-122,1,2,3
25460,58thStGreenway22ndAve,01/24/2017 08:00:00 PM,48,-122,1,1,2
25461,58thStGreenway22ndAve,01/24/2017 09:00:00 PM,48,-122,1,0,1
25462,58thStGreenway22ndAve,01/24/2017 10:00:00 PM,48,-122,1,0,1
25463,58thStGreenway22ndAve,01/24/2017 11:00:00 PM,48,-122,0,0,0
25464,58thStGreenway22ndAve,01/25/2017 12:00:00 AM,48,-122,0,0,0
25465,58thStGreenway22ndAve,01/25/2017 01:00:00 AM,48,-122,0,0,0
25466,58thStGreenway22ndAve,01/25/2017 02:00:00 AM,48,-122,0,0,0
25467,58thStGreenway22ndAve,01/25/2017 03:00:00 AM,48,-122,0,0,0
25468,58thStGreenway22ndAve,01/25/2017 04:00:00 AM,48,-122,0,0,0
25469,58thStGreenway22ndAve,01/25/2017 05:00:00 AM,48,-122,2,0,2
25470,58thStGreenway22ndAve,01/25/2017 06:00:00 AM,48,-122,1,0,1
25471,58thStGreenway22ndAve,01/25/2017 07:00:00 AM,48,-122,2,0,2
25472,58thStGreenway22ndAve,01/25/2017 08:00:00 AM,48,-122,3,0,3
25473,58thStGreenway22ndAve,01/25/2017 09:00:00 AM,48,-122,2,0,2
25474,58thStGreenway22ndAve,01/25/2017 10:00:00 AM,48,-122,0,1,1
25475,58thStGreenway22ndAve,01/25/2017 11:00:00 AM,48,-122,1,1,2
25476,58thStGreenway22ndAve,01/25/2017 12:00:00 PM,48,-122,1,1,2
25477,58thStGreenway22ndAve,01/25/2017 01:00:00 PM,48,-122,0,0,0
25478,58thStGreenway22ndAve,01/25/2017 02:00:00 PM,48,-122,4,0,4
25479,58thStGreenway22ndAve,01/25/2017 03:00:00 PM,48,-122,0,0,0
25480,58thStGreenway22ndAve,01/25/2017 04:00:00 PM,48,-122,4,0,4
25481,58thStGreenway22ndAve,01/25/2017 05:00:00 PM,48,-122,2,0,2
25482,58thStGreenway22ndAve,01/25/2017 06:00:00 PM,48,-122,2,0,2
25483,58thStGreenway22ndAve,01/25/2017 07:00:00 PM,48,-122,6,0,6
25484,58thStGreenway22ndAve,01/25/2017 08:00:00 PM,48,-122,3,0,3
25485,58thStGreenway22ndAve,01/25/2017 09:00:00 PM,48,-122,2,1,3
25486,58thStGreenway22ndAve,01/25/2017 10:00:00 PM,48,-122,1,0,1
25487,58thStGreenway22ndAve,01/25/2017 11:00:00 PM,48,-122,0,0,0
25488,58thStGreenway22ndAve,01/26/2017 12:00:00 AM,48,-122,0,0,0
25489,58thStGreenway22ndAve,01/26/2017 01:00:00 AM,48,-122,0,0,0
25490,58thStGreenway22ndAve,01/26/2017 02:00:00 AM,48,-122,0,0,0
25491,58thStGreenway22ndAve,01/26/2017 03:00:00 AM,48,-122,1,0,1
25492,58thStGreenway22ndAve,01/26/2017 04:00:00 AM,48,-122,0,0,0
25493,58thStGreenway22ndAve,01/26/2017 05:00:00 AM,48,-122,0,0,0
25494,58thStGreenway22ndAve,01/26/2017 06:00:00 AM,48,-122,0,0,0
25495,58thStGreenway22ndAve,01/26/2017 07:00:00 AM,48,-122,1,0,1
25496,58thStGreenway22ndAve,01/26/2017 08:00:00 AM,48,-122,3,0,3
25497,58thStGreenway22ndAve,01/26/2017 09:00:00 AM,48,-122,0,0,0
25498,58thStGreenway22ndAve,01/26/2017 10:00:00 AM,48,-122,3,0,3
25499,58thStGreenway22ndAve,01/26/2017 11:00:00 AM,48,-122,2,0,2
25500,58thStGreenway22ndAve,01/26/2017 12:00:00 PM,48,-122,2,0,2
25501,58thStGreenway22ndAve,01/26/2017 01:00:00 PM,48,-122,1,1,2
25502,58thStGreenway22ndAve,01/26/2017 02:00:00 PM,48,-122,2,0,2
25503,58thStGreenway22ndAve,01/26/2017 03:00:00 PM,48,-122,3,0,3
25504,58thStGreenway22ndAve,01/26/2017 04:00:00 PM,48,-122,0,0,0
25505,58thStGreenway22ndAve,01/26/2017 05:00:00 PM,48,-122,4,0,4
25506,58thStGreenway22ndAve,01/26/2017 06:00:00 PM,48,-122,0,0,0
25507,58thStGreenway22ndAve,01/26/2017 07:00:00 PM,48,-122,4,0,4
25508,58thStGreenway22ndAve,01/26/2017 08:00:00 PM,48,-122,0,0,0
25509,58thStGreenway22ndAve,01/26/2017 09:00:00 PM,48,-122,0,0,0
25510,58thStGreenway22ndAve,01/26/2017 10:00:00 PM,48,-122,0,0,0
25511,58thStGreenway22ndAve,01/26/2017 11:00:00 PM,48,-122,0,0,0
25512,58thStGreenway22ndAve,01/27/2017 12:00:00 AM,48,-122,0,0,0
25513,58thStGreenway22ndAve,01/27/2017 01:00:00 AM,48,-122,0,0,0
25514,58thStGreenway22ndAve,01/27/2017 02:00:00 AM,48,-122,0,0,0
25515,58thStGreenway22ndAve,01/27/2017 03:00:00 AM,48,-122,0,0,0
25516,58thStGreenway22ndAve,01/27/2017 04:00:00 AM,48,-122,1,0,1
25517,58thStGreenway22ndAve,01/27/2017 05:00:00 AM,48,-122,0,0,0
25518,58thStGreenway22ndAve,01/27/2017 06:00:00 AM,48,-122,1,0,1
25519,58thStGreenway22ndAve,01/27/2017 07:00:00 AM,48,-122,0,0,0
25520,58thStGreenway22ndAve,01/27/2017 08:00:00 AM,48,-122,1,0,1
25521,58thStGreenway22ndAve,01/27/2017 09:00:00 AM,48,-122,2,0,2
25522,58thStGreenway22ndAve,01/27/2017 10:00:00 AM,48,-122,1,0,1
25523,58thStGreenway22ndAve,01/27/2017 11:00:00 AM,48,-122,0,0,0
25524,58thStGreenway22ndAve,01/27/2017 12:00:00 PM,48,-122,1,0,1
25525,58thStGreenway22ndAve,01/27/2017 01:00:00 PM,48,-122,1,0,1
25526,58thStGreenway22ndAve,01/27/2017 02:00:00 PM,48,-122,0,0,0
25527,58thStGreenway22ndAve,01/27/2017 03:00:00 PM,48,-122,0,0,0
25528,58thStGreenway22ndAve,01/27/2017 04:00:00 PM,48,-122,2,0,2
25529,58thStGreenway22ndAve,01/27/2017 05:00:00 PM,48,-122,1,0,1
25530,58thStGreenway22ndAve,01/27/2017 06:00:00 PM,48,-122,1,0,1
25531,58thStGreenway22ndAve,01/27/2017 07:00:00 PM,48,-122,3,0,3
25532,58thStGreenway22ndAve,01/27/2017 08:00:00 PM,48,-122,5,0,5
25533,58thStGreenway22ndAve,01/27/2017 09:00:00 PM,48,-122,0,0,0
25534,58thStGreenway22ndAve,01/27/2017 10:00:00 PM,48,-122,1,0,1
25535,58thStGreenway22ndAve,01/27/2017 11:00:00 PM,48,-122,0,0,0
25536,58thStGreenway22ndAve,01/28/2017 12:00:00 AM,48,-122,0,0,0
25537,58thStGreenway22ndAve,01/28/2017 01:00:00 AM,48,-122,0,0,0
25538,58thStGreenway22ndAve,01/28/2017 02:00:00 AM,48,-122,0,1,1
25539,58thStGreenway22ndAve,01/28/2017 03:00:00 AM,48,-122,0,0,0
25540,58thStGreenway22ndAve,01/28/2017 04:00:00 AM,48,-122,0,0,0
25541,58thStGreenway22ndAve,01/28/2017 05:00:00 AM,48,-122,0,0,0
25542,58thStGreenway22ndAve,01/28/2017 06:00:00 AM,48,-122,0,0,0
25543,58thStGreenway22ndAve,01/28/2017 07:00:00 AM,48,-122,0,0,0
25544,58thStGreenway22ndAve,01/28/2017 08:00:00 AM,48,-122,0,0,0
25545,58thStGreenway22ndAve,01/28/2017 09:00:00 AM,48,-122,0,0,0
25546,58thStGreenway22ndAve,01/28/2017 10:00:00 AM,48,-122,2,1,3
25547,58thStGreenway22ndAve,01/28/2017 11:00:00 AM,48,-122,1,0,1
25548,58thStGreenway22ndAve,01/28/2017 12:00:00 PM,48,-122,0,0,0
25549,58thStGreenway22ndAve,01/28/2017 01:00:00 PM,48,-122,0,0,0
25550,58thStGreenway22ndAve,01/28/2017 02:00:00 PM,48,-122,1,0,1
25551,58thStGreenway22ndAve,01/28/2017 03:00:00 PM,48,-122,2,0,2
25552,58thStGreenway22ndAve,01/28/2017 04:00:00 PM,48,-122,1,0,1
25553,58thStGreenway22ndAve,01/28/2017 05:00:00 PM,48,-122,3,0,3
25554,58thStGreenway22ndAve,01/28/2017 06:00:00 PM,48,-122,1,0,1
25555,58thStGreenway22ndAve,01/28/2017 07:00:00 PM,48,-122,0,0,0
25556,58thStGreenway22ndAve,01/28/2017 08:00:00 PM,48,-122,0,0,0
25557,58thStGreenway22ndAve,01/28/2017 09:00:00 PM,48,-122,0,0,0
25558,58thStGreenway22ndAve,01/28/2017 10:00:00 PM,48,-122,1,0,1
25559,58thStGreenway22ndAve,01/28/2017 11:00:00 PM,48,-122,0,0,0
25560,58thStGreenway22ndAve,01/29/2017 12:00:00 AM,48,-122,0,0,0
25561,58thStGreenway22ndAve,01/29/2017 01:00:00 AM,48,-122,0,0,0
25562,58thStGreenway22ndAve,01/29/2017 02:00:00 AM,48,-122,0,0,0
25563,58thStGreenway22ndAve,01/29/2017 03:00:00 AM,48,-122,0,0,0
25564,58thStGreenway22ndAve,01/29/2017 04:00:00 AM,48,-122,0,0,0
25565,58thStGreenway22ndAve,01/29/2017 05:00:00 AM,48,-122,0,0,0
25566,58thStGreenway22ndAve,01/29/2017 06:00:00 AM,48,-122,0,0,0
25567,58thStGreenway22ndAve,01/29/2017 07:00:00 AM,48,-122,0,0,0
25568,58thStGreenway22ndAve,01/29/2017 08:00:00 AM,48,-122,0,0,0
25569,58thStGreenway22ndAve,01/29/2017 09:00:00 AM,48,-122,1,0,1
25570,58thStGreenway22ndAve,01/29/2017 10:00:00 AM,48,-122,2,0,2
25571,58thStGreenway22ndAve,01/29/2017 11:00:00 AM,48,-122,2,0,2
25572,58thStGreenway22ndAve,01/29/2017 12:00:00 PM,48,-122,2,0,2
25573,58thStGreenway22ndAve,01/29/2017 01:00:00 PM,48,-122,3,0,3
25574,58thStGreenway22ndAve,01/29/2017 02:00:00 PM,48,-122,1,0,1
25575,58thStGreenway22ndAve,01/29/2017 03:00:00 PM,48,-122,2,0,2
25576,58thStGreenway22ndAve,01/29/2017 04:00:00 PM,48,-122,0,1,1
25577,58thStGreenway22ndAve,01/29/2017 05:00:00 PM,48,-122,1,0,1
25578,58thStGreenway22ndAve,01/29/2017 06:00:00 PM,48,-122,0,0,0
25579,58thStGreenway22ndAve,01/29/2017 07:00:00 PM,48,-122,0,0,0
25580,58thStGreenway22ndAve,01/29/2017 08:00:00 PM,48,-122,0,0,0
25581,58thStGreenway22ndAve,01/29/2017 09:00:00 PM,48,-122,0,0,0
25582,58thStGreenway22ndAve,01/29/2017 10:00:00 PM,48,-122,0,0,0
25583,58thStGreenway22ndAve,01/29/2017 11:00:00 PM,48,-122,0,0,0
25584,58thStGreenway22ndAve,01/30/2017 12:00:00 AM,48,-122,0,0,0
25585,58thStGreenway22ndAve,01/30/2017 01:00:00 AM,48,-122,0,0,0
25586,58thStGreenway22ndAve,01/30/2017 02:00:00 AM,48,-122,0,0,0
25587,58thStGreenway22ndAve,01/30/2017 03:00:00 AM,48,-122,0,0,0
25588,58thStGreenway22ndAve,01/30/2017 04:00:00 AM,48,-122,0,0,0
25589,58thStGreenway22ndAve,01/30/2017 05:00:00 AM,48,-122,0,0,0
25590,58thStGreenway22ndAve,01/30/2017 06:00:00 AM,48,-122,0,0,0
25591,58thStGreenway22ndAve,01/30/2017 07:00:00 AM,48,-122,0,0,0
25592,58thStGreenway22ndAve,01/30/2017 08:00:00 AM,48,-122,0,0,0
25593,58thStGreenway22ndAve,01/30/2017 09:00:00 AM,48,-122,5,0,5
25594,58thStGreenway22ndAve,01/30/2017 10:00:00 AM,48,-122,0,1,1
25595,58thStGreenway22ndAve,01/30/2017 11:00:00 AM,48,-122,1,1,2
25596,58thStGreenway22ndAve,01/30/2017 12:00:00 PM,48,-122,1,0,1
25597,58thStGreenway22ndAve,01/30/2017 01:00:00 PM,48,-122,1,0,1
25598,58thStGreenway22ndAve,01/30/2017 02:00:00 PM,48,-122,2,0,2
25599,58thStGreenway22ndAve,01/30/2017 03:00:00 PM,48,-122,3,0,3
25600,58thStGreenway22ndAve,01/30/2017 04:00:00 PM,48,-122,2,0,2
25601,58thStGreenway22ndAve,01/30/2017 05:00:00 PM,48,-122,1,0,1
25602,58thStGreenway22ndAve,01/30/2017 06:00:00 PM,48,-122,3,0,3
25603,58thStGreenway22ndAve,01/30/2017 07:00:00 PM,48,-122,2,0,2
25604,58thStGreenway22ndAve,01/30/2017 08:00:00 PM,48,-122,0,0,0
25605,58thStGreenway22ndAve,01/30/2017 09:00:00 PM,48,-122,0,0,0
25606,58thStGreenway22ndAve,01/30/2017 10:00:00 PM,48,-122,0,0,0
25607,58thStGreenway22ndAve,01/30/2017 11:00:00 PM,48,-122,0,0,0
25608,58thStGreenway22ndAve,01/31/2017 12:00:00 AM,48,-122,0,0,0
25609,58thStGreenway22ndAve,01/31/2017 01:00:00 AM,48,-122,0,0,0
25610,58thStGreenway22ndAve,01/31/2017 02:00:00 AM,48,-122,0,0,0
25611,58thStGreenway22ndAve,01/31/2017 03:00:00 AM,48,-122,0,0,0
25612,58thStGreenway22ndAve,01/31/2017 04:00:00 AM,48,-122,0,0,0
25613,58thStGreenway22ndAve,01/31/2017 05:00:00 AM,48,-122,1,0,1
25614,58thStGreenway22ndAve,01/31/2017 06:00:00 AM,48,-122,0,0,0
25615,58thStGreenway22ndAve,01/31/2017 07:00:00 AM,48,-122,2,0,2
25616,58thStGreenway22ndAve,01/31/2017 08:00:00 AM,48,-122,0,0,0
25617,58thStGreenway22ndAve,01/31/2017 09:00:00 AM,48,-122,0,1,1
25618,58thStGreenway22ndAve,01/31/2017 10:00:00 AM,48,-122,2,0,2
25619,58thStGreenway22ndAve,01/31/2017 11:00:00 AM,48,-122,2,2,4
25620,58thStGreenway22ndAve,01/31/2017 12:00:00 PM,48,-122,0,0,0
25621,58thStGreenway22ndAve,01/31/2017 01:00:00 PM,48,-122,1,0,1
25622,58thStGreenway22ndAve,01/31/2017 02:00:00 PM,48,-122,2,0,2
25623,58thStGreenway22ndAve,01/31/2017 03:00:00 PM,48,-122,2,0,2
25624,58thStGreenway22ndAve,01/31/2017 04:00:00 PM,48,-122,0,0,0
25625,58thStGreenway22ndAve,01/31/2017 05:00:00 PM,48,-122,1,0,1
25626,58thStGreenway22ndAve,01/31/2017 06:00:00 PM,48,-122,0,0,0
25627,58thStGreenway22ndAve,01/31/2017 07:00:00 PM,48,-122,0,0,0
25628,58thStGreenway22ndAve,01/31/2017 08:00:00 PM,48,-122,0,0,0
25629,58thStGreenway22ndAve,01/31/2017 09:00:00 PM,48,-122,0,0,0
25630,58thStGreenway22ndAve,01/31/2017 10:00:00 PM,48,-122,0,0,0
25631,58thStGreenway22ndAve,01/31/2017 11:00:00 PM,48,-122,0,0,0
25632,58thStGreenway22ndAve,02/01/2017 12:00:00 AM,48,-122,0,0,0
25633,58thStGreenway22ndAve,02/01/2017 01:00:00 AM,48,-122,0,0,0
25634,58thStGreenway22ndAve,02/01/2017 02:00:00 AM,48,-122,0,0,0
25635,58thStGreenway22ndAve,02/01/2017 03:00:00 AM,48,-122,0,0,0
25636,58thStGreenway22ndAve,02/01/2017 04:00:00 AM,48,-122,0,0,0
25637,58thStGreenway22ndAve,02/01/2017 05:00:00 AM,48,-122,0,0,0
25638,58thStGreenway22ndAve,02/01/2017 06:00:00 AM,48,-122,1,0,1
25639,58thStGreenway22ndAve,02/01/2017 07:00:00 AM,48,-122,0,0,0
25640,58thStGreenway22ndAve,02/01/2017 08:00:00 AM,48,-122,1,0,1
25641,58thStGreenway22ndAve,02/01/2017 09:00:00 AM,48,-122,1,0,1
25642,58thStGreenway22ndAve,02/01/2017 10:00:00 AM,48,-122,0,0,0
25643,58thStGreenway22ndAve,02/01/2017 11:00:00 AM,48,-122,0,1,1
25644,58thStGreenway22ndAve,02/01/2017 12:00:00 PM,48,-122,0,0,0
25645,58thStGreenway22ndAve,02/01/2017 01:00:00 PM,48,-122,0,0,0
25646,58thStGreenway22ndAve,02/01/2017 02:00:00 PM,48,-122,1,0,1
25647,58thStGreenway22ndAve,02/01/2017 03:00:00 PM,48,-122,0,0,0
25648,58thStGreenway22ndAve,02/01/2017 04:00:00 PM,48,-122,1,0,1
25649,58thStGreenway22ndAve,02/01/2017 05:00:00 PM,48,-122,1,0,1
25650,58thStGreenway22ndAve,02/01/2017 06:00:00 PM,48,-122,0,0,0
25651,58thStGreenway22ndAve,02/01/2017 07:00:00 PM,48,-122,0,0,0
25652,58thStGreenway22ndAve,02/01/2017 08:00:00 PM,48,-122,0,0,0
25653,58thStGreenway22ndAve,02/01/2017 09:00:00 PM,48,-122,0,0,0
25654,58thStGreenway22ndAve,02/01/2017 10:00:00 PM,48,-122,0,0,0
25655,58thStGreenway22ndAve,02/01/2017 11:00:00 PM,48,-122,0,0,0
25656,58thStGreenway22ndAve,02/02/2017 12:00:00 AM,48,-122,0,0,0
25657,58thStGreenway22ndAve,02/02/2017 01:00:00 AM,48,-122,0,0,0
25658,58thStGreenway22ndAve,02/02/2017 02:00:00 AM,48,-122,0,0,0
25659,58thStGreenway22ndAve,02/02/2017 03:00:00 AM,48,-122,0,0,0
25660,58thStGreenway22ndAve,02/02/2017 04:00:00 AM,48,-122,0,0,0
25661,58thStGreenway22ndAve,02/02/2017 05:00:00 AM,48,-122,0,0,0
25662,58thStGreenway22ndAve,02/02/2017 06:00:00 AM,48,-122,0,0,0
25663,58thStGreenway22ndAve,02/02/2017 07:00:00 AM,48,-122,0,0,0
25664,58thStGreenway22ndAve,02/02/2017 08:00:00 AM,48,-122,1,0,1
25665,58thStGreenway22ndAve,02/02/2017 09:00:00 AM,48,-122,0,0,0
25666,58thStGreenway22ndAve,02/02/2017 10:00:00 AM,48,-122,0,0,0
25667,58thStGreenway22ndAve,02/02/2017 11:00:00 AM,48,-122,0,0,0
25668,58thStGreenway22ndAve,02/02/2017 12:00:00 PM,48,-122,0,0,0
25669,58thStGreenway22ndAve,02/02/2017 01:00:00 PM,48,-122,0,0,0
25670,58thStGreenway22ndAve,02/02/2017 02:00:00 PM,48,-122,0,0,0
25671,58thStGreenway22ndAve,02/02/2017 03:00:00 PM,48,-122,0,0,0
25672,58thStGreenway22ndAve,02/02/2017 04:00:00 PM,48,-122,0,0,0
25673,58thStGreenway22ndAve,02/02/2017 05:00:00 PM,48,-122,1,0,1
25674,58thStGreenway22ndAve,02/02/2017 06:00:00 PM,48,-122,0,0,0
25675,58thStGreenway22ndAve,02/02/2017 07:00:00 PM,48,-122,0,0,0
25676,58thStGreenway22ndAve,02/02/2017 08:00:00 PM,48,-122,0,0,0
25677,58thStGreenway22ndAve,02/02/2017 09:00:00 PM,48,-122,0,0,0
25678,58thStGreenway22ndAve,02/02/2017 10:00:00 PM,48,-122,0,0,0
25679,58thStGreenway22ndAve,02/02/2017 11:00:00 PM,48,-122,0,0,0
25680,58thStGreenway22ndAve,02/03/2017 12:00:00 AM,48,-122,0,0,0
25681,58thStGreenway22ndAve,02/03/2017 01:00:00 AM,48,-122,0,0,0
25682,58thStGreenway22ndAve,02/03/2017 02:00:00 AM,48,-122,0,0,0
25683,58thStGreenway22ndAve,02/03/2017 03:00:00 AM,48,-122,0,0,0
25684,58thStGreenway22ndAve,02/03/2017 04:00:00 AM,48,-122,0,0,0
25685,58thStGreenway22ndAve,02/03/2017 05:00:00 AM,48,-122,0,0,0
25686,58thStGreenway22ndAve,02/03/2017 06:00:00 AM,48,-122,0,0,0
25687,58thStGreenway22ndAve,02/03/2017 07:00:00 AM,48,-122,0,0,0
25688,58thStGreenway22ndAve,02/03/2017 08:00:00 AM,48,-122,1,0,1
25689,58thStGreenway22ndAve,02/03/2017 09:00:00 AM,48,-122,1,0,1
25690,58thStGreenway22ndAve,02/03/2017 10:00:00 AM,48,-122,0,0,0
25691,58thStGreenway22ndAve,02/03/2017 11:00:00 AM,48,-122,2,0,2
25692,58thStGreenway22ndAve,02/03/2017 12:00:00 PM,48,-122,1,0,1
25693,58thStGreenway22ndAve,02/03/2017 01:00:00 PM,48,-122,0,0,0
25694,58thStGreenway22ndAve,02/03/2017 02:00:00 PM,48,-122,0,0,0
25695,58thStGreenway22ndAve,02/03/2017 03:00:00 PM,48,-122,0,0,0
25696,58thStGreenway22ndAve,02/03/2017 04:00:00 PM,48,-122,1,0,1
25697,58thStGreenway22ndAve,02/03/2017 05:00:00 PM,48,-122,2,0,2
25698,58thStGreenway22ndAve,02/03/2017 06:00:00 PM,48,-122,1,0,1
25699,58thStGreenway22ndAve,02/03/2017 07:00:00 PM,48,-122,0,0,0
25700,58thStGreenway22ndAve,02/03/2017 08:00:00 PM,48,-122,1,0,1
25701,58thStGreenway22ndAve,02/03/2017 09:00:00 PM,48,-122,0,0,0
25702,58thStGreenway22ndAve,02/03/2017 10:00:00 PM,48,-122,0,0,0
25703,58thStGreenway22ndAve,02/03/2017 11:00:00 PM,48,-122,0,0,0
25704,58thStGreenway22ndAve,02/04/2017 12:00:00 AM,48,-122,0,0,0
25705,58thStGreenway22ndAve,02/04/2017 01:00:00 AM,48,-122,0,0,0
25706,58thStGreenway22ndAve,02/04/2017 02:00:00 AM,48,-122,0,0,0
25707,58thStGreenway22ndAve,02/04/2017 03:00:00 AM,48,-122,0,0,0
25708,58thStGreenway22ndAve,02/04/2017 04:00:00 AM,48,-122,0,0,0
25709,58thStGreenway22ndAve,02/04/2017 05:00:00 AM,48,-122,1,0,1
25710,58thStGreenway22ndAve,02/04/2017 06:00:00 AM,48,-122,0,0,0
25711,58thStGreenway22ndAve,02/04/2017 07:00:00 AM,48,-122,0,0,0
25712,58thStGreenway22ndAve,02/04/2017 08:00:00 AM,48,-122,0,0,0
25713,58thStGreenway22ndAve,02/04/2017 09:00:00 AM,48,-122,2,0,2
25714,58thStGreenway22ndAve,02/04/2017 10:00:00 AM,48,-122,1,0,1
25715,58thStGreenway22ndAve,02/04/2017 11:00:00 AM,48,-122,0,0,0
25716,58thStGreenway22ndAve,02/04/2017 12:00:00 PM,48,-122,1,0,1
25717,58thStGreenway22ndAve,02/04/2017 01:00:00 PM,48,-122,1,0,1
25718,58thStGreenway22ndAve,02/04/2017 02:00:00 PM,48,-122,1,0,1
25719,58thStGreenway22ndAve,02/04/2017 03:00:00 PM,48,-122,0,0,0
25720,58thStGreenway22ndAve,02/04/2017 04:00:00 PM,48,-122,2,0,2
25721,58thStGreenway22ndAve,02/04/2017 05:00:00 PM,48,-122,0,0,0
25722,58thStGreenway22ndAve,02/04/2017 06:00:00 PM,48,-122,0,0,0
25723,58thStGreenway22ndAve,02/04/2017 07:00:00 PM,48,-122,0,0,0
25724,58thStGreenway22ndAve,02/04/2017 08:00:00 PM,48,-122,1,0,1
25725,58thStGreenway22ndAve,02/04/2017 09:00:00 PM,48,-122,1,0,1
25726,58thStGreenway22ndAve,02/04/2017 10:00:00 PM,48,-122,0,0,0
25727,58thStGreenway22ndAve,02/04/2017 11:00:00 PM,48,-122,1,0,1
25728,58thStGreenway22ndAve,02/05/2017 12:00:00 AM,48,-122,0,0,0
25729,58thStGreenway22ndAve,02/05/2017 01:00:00 AM,48,-122,0,0,0
25730,58thStGreenway22ndAve,02/05/2017 02:00:00 AM,48,-122,1,0,1
25731,58thStGreenway22ndAve,02/05/2017 03:00:00 AM,48,-122,0,0,0
25732,58thStGreenway22ndAve,02/05/2017 04:00:00 AM,48,-122,0,0,0
25733,58thStGreenway22ndAve,02/05/2017 05:00:00 AM,48,-122,0,0,0
25734,58thStGreenway22ndAve,02/05/2017 06:00:00 AM,48,-122,0,0,0
25735,58thStGreenway22ndAve,02/05/2017 07:00:00 AM,48,-122,0,0,0
25736,58thStGreenway22ndAve,02/05/2017 08:00:00 AM,48,-122,0,0,0
25737,58thStGreenway22ndAve,02/05/2017 09:00:00 AM,48,-122,0,0,0
25738,58thStGreenway22ndAve,02/05/2017 10:00:00 AM,48,-122,0,0,0
25739,58thStGreenway22ndAve,02/05/2017 11:00:00 AM,48,-122,1,0,1
25740,58thStGreenway22ndAve,02/05/2017 12:00:00 PM,48,-122,2,0,2
25741,58thStGreenway22ndAve,02/05/2017 01:00:00 PM,48,-122,0,0,0
25742,58thStGreenway22ndAve,02/05/2017 02:00:00 PM,48,-122,1,0,1
25743,58thStGreenway22ndAve,02/05/2017 03:00:00 PM,48,-122,4,0,4
25744,58thStGreenway22ndAve,02/05/2017 04:00:00 PM,48,-122,0,0,0
25745,58thStGreenway22ndAve,02/05/2017 05:00:00 PM,48,-122,0,0,0
25746,58thStGreenway22ndAve,02/05/2017 06:00:00 PM,48,-122,0,0,0
25747,58thStGreenway22ndAve,02/05/2017 07:00:00 PM,48,-122,0,0,0
25748,58thStGreenway22ndAve,02/05/2017 08:00:00 PM,48,-122,0,0,0
25749,58thStGreenway22ndAve,02/05/2017 09:00:00 PM,48,-122,0,0,0
25750,58thStGreenway22ndAve,02/05/2017 10:00:00 PM,48,-122,0,0,0
25751,58thStGreenway22ndAve,02/05/2017 11:00:00 PM,48,-122,0,0,0
25752,58thStGreenway22ndAve,02/06/2017 12:00:00 AM,48,-122,0,0,0
25753,58thStGreenway22ndAve,02/06/2017 01:00:00 AM,48,-122,0,0,0
25754,58thStGreenway22ndAve,02/06/2017 02:00:00 AM,48,-122,0,0,0
25755,58thStGreenway22ndAve,02/06/2017 03:00:00 AM,48,-122,0,0,0
25756,58thStGreenway22ndAve,02/06/2017 04:00:00 AM,48,-122,0,0,0
25757,58thStGreenway22ndAve,02/06/2017 05:00:00 AM,48,-122,0,0,0
25758,58thStGreenway22ndAve,02/06/2017 06:00:00 AM,48,-122,1,0,1
25759,58thStGreenway22ndAve,02/06/2017 07:00:00 AM,48,-122,0,0,0
25760,58thStGreenway22ndAve,02/06/2017 08:00:00 AM,48,-122,1,0,1
25761,58thStGreenway22ndAve,02/06/2017 09:00:00 AM,48,-122,1,0,1
25762,58thStGreenway22ndAve,02/06/2017 10:00:00 AM,48,-122,2,0,2
25763,58thStGreenway22ndAve,02/06/2017 11:00:00 AM,48,-122,1,2,3
25764,58thStGreenway22ndAve,02/06/2017 12:00:00 PM,48,-122,1,0,1
25765,58thStGreenway22ndAve,02/06/2017 01:00:00 PM,48,-122,0,0,0
25766,58thStGreenway22ndAve,02/06/2017 02:00:00 PM,48,-122,0,0,0
25767,58thStGreenway22ndAve,02/06/2017 03:00:00 PM,48,-122,1,0,1
25768,58thStGreenway22ndAve,02/06/2017 04:00:00 PM,48,-122,2,0,2
25769,58thStGreenway22ndAve,02/06/2017 05:00:00 PM,48,-122,1,0,1
25770,58thStGreenway22ndAve,02/06/2017 06:00:00 PM,48,-122,0,0,0
25771,58thStGreenway22ndAve,02/06/2017 07:00:00 PM,48,-122,0,0,0
25772,58thStGreenway22ndAve,02/06/2017 08:00:00 PM,48,-122,1,0,1
25773,58thStGreenway22ndAve,02/06/2017 09:00:00 PM,48,-122,1,0,1
25774,58thStGreenway22ndAve,02/06/2017 10:00:00 PM,48,-122,0,0,0
25775,58thStGreenway22ndAve,02/06/2017 11:00:00 PM,48,-122,0,0,0
25776,58thStGreenway22ndAve,02/07/2017 12:00:00 AM,48,-122,0,0,0
25777,58thStGreenway22ndAve,02/07/2017 01:00:00 AM,48,-122,0,0,0
25778,58thStGreenway22ndAve,02/07/2017 02:00:00 AM,48,-122,0,0,0
25779,58thStGreenway22ndAve,02/07/2017 03:00:00 AM,48,-122,0,0,0
25780,58thStGreenway22ndAve,02/07/2017 04:00:00 AM,48,-122,0,0,0
25781,58thStGreenway22ndAve,02/07/2017 05:00:00 AM,48,-122,0,0,0
25782,58thStGreenway22ndAve,02/07/2017 06:00:00 AM,48,-122,0,0,0
25783,58thStGreenway22ndAve,02/07/2017 07:00:00 AM,48,-122,0,0,0
25784,58thStGreenway22ndAve,02/07/2017 08:00:00 AM,48,-122,0,0,0
25785,58thStGreenway22ndAve,02/07/2017 09:00:00 AM,48,-122,0,1,1
25786,58thStGreenway22ndAve,02/07/2017 10:00:00 AM,48,-122,1,1,2
25787,58thStGreenway22ndAve,02/07/2017 11:00:00 AM,48,-122,0,0,0
25788,58thStGreenway22ndAve,02/07/2017 12:00:00 PM,48,-122,0,0,0
25789,58thStGreenway22ndAve,02/07/2017 01:00:00 PM,48,-122,1,0,1
25790,58thStGreenway22ndAve,02/07/2017 02:00:00 PM,48,-122,0,0,0
25791,58thStGreenway22ndAve,02/07/2017 03:00:00 PM,48,-122,0,0,0
25792,58thStGreenway22ndAve,02/07/2017 04:00:00 PM,48,-122,3,0,3
25793,58thStGreenway22ndAve,02/07/2017 05:00:00 PM,48,-122,1,0,1
25794,58thStGreenway22ndAve,02/07/2017 06:00:00 PM,48,-122,1,0,1
25795,58thStGreenway22ndAve,02/07/2017 07:00:00 PM,48,-122,0,0,0
25796,58thStGreenway22ndAve,02/07/2017 08:00:00 PM,48,-122,0,0,0
25797,58thStGreenway22ndAve,02/07/2017 09:00:00 PM,48,-122,0,0,0
25798,58thStGreenway22ndAve,02/07/2017 10:00:00 PM,48,-122,0,0,0
25799,58thStGreenway22ndAve,02/07/2017 11:00:00 PM,48,-122,0,0,0
25800,58thStGreenway22ndAve,02/08/2017 12:00:00 AM,48,-122,0,0,0
25801,58thStGreenway22ndAve,02/08/2017 01:00:00 AM,48,-122,0,0,0
25802,58thStGreenway22ndAve,02/08/2017 02:00:00 AM,48,-122,0,0,0
25803,58thStGreenway22ndAve,02/08/2017 03:00:00 AM,48,-122,0,0,0
25804,58thStGreenway22ndAve,02/08/2017 04:00:00 AM,48,-122,0,0,0
25805,58thStGreenway22ndAve,02/08/2017 05:00:00 AM,48,-122,0,0,0
25806,58thStGreenway22ndAve,02/08/2017 06:00:00 AM,48,-122,0,0,0
25807,58thStGreenway22ndAve,02/08/2017 07:00:00 AM,48,-122,1,0,1
25808,58thStGreenway22ndAve,02/08/2017 08:00:00 AM,48,-122,0,1,1
25809,58thStGreenway22ndAve,02/08/2017 09:00:00 AM,48,-122,0,0,0
25810,58thStGreenway22ndAve,02/08/2017 10:00:00 AM,48,-122,0,0,0
25811,58thStGreenway22ndAve,02/08/2017 11:00:00 AM,48,-122,0,0,0
25812,58thStGreenway22ndAve,02/08/2017 12:00:00 PM,48,-122,1,1,2
25813,58thStGreenway22ndAve,02/08/2017 01:00:00 PM,48,-122,0,0,0
25814,58thStGreenway22ndAve,02/08/2017 02:00:00 PM,48,-122,0,0,0
25815,58thStGreenway22ndAve,02/08/2017 03:00:00 PM,48,-122,0,0,0
25816,58thStGreenway22ndAve,02/08/2017 04:00:00 PM,48,-122,0,0,0
25817,58thStGreenway22ndAve,02/08/2017 05:00:00 PM,48,-122,0,0,0
25818,58thStGreenway22ndAve,02/08/2017 06:00:00 PM,48,-122,1,0,1
25819,58thStGreenway22ndAve,02/08/2017 07:00:00 PM,48,-122,0,0,0
25820,58thStGreenway22ndAve,02/08/2017 08:00:00 PM,48,-122,0,0,0
25821,58thStGreenway22ndAve,02/08/2017 09:00:00 PM,48,-122,0,0,0
25822,58thStGreenway22ndAve,02/08/2017 10:00:00 PM,48,-122,0,0,0
25823,58thStGreenway22ndAve,02/08/2017 11:00:00 PM,48,-122,0,0,0
25824,58thStGreenway22ndAve,02/09/2017 12:00:00 AM,48,-122,0,0,0
25825,58thStGreenway22ndAve,02/09/2017 01:00:00 AM,48,-122,0,0,0
25826,58thStGreenway22ndAve,02/09/2017 02:00:00 AM,48,-122,0,0,0
25827,58thStGreenway22ndAve,02/09/2017 03:00:00 AM,48,-122,0,0,0
25828,58thStGreenway22ndAve,02/09/2017 04:00:00 AM,48,-122,0,0,0
25829,58thStGreenway22ndAve,02/09/2017 05:00:00 AM,48,-122,0,0,0
25830,58thStGreenway22ndAve,02/09/2017 06:00:00 AM,48,-122,0,0,0
25831,58thStGreenway22ndAve,02/09/2017 07:00:00 AM,48,-122,0,0,0
25832,58thStGreenway22ndAve,02/09/2017 08:00:00 AM,48,-122,0,0,0
25833,58thStGreenway22ndAve,02/09/2017 09:00:00 AM,48,-122,1,0,1
25834,58thStGreenway22ndAve,02/09/2017 10:00:00 AM,48,-122,1,0,1
25835,58thStGreenway22ndAve,02/09/2017 11:00:00 AM,48,-122,0,1,1
25836,58thStGreenway22ndAve,02/09/2017 12:00:00 PM,48,-122,0,0,0
25837,58thStGreenway22ndAve,02/09/2017 01:00:00 PM,48,-122,2,0,2
25838,58thStGreenway22ndAve,02/09/2017 02:00:00 PM,48,-122,0,1,1
25839,58thStGreenway22ndAve,02/09/2017 03:00:00 PM,48,-122,1,0,1
25840,58thStGreenway22ndAve,02/09/2017 04:00:00 PM,48,-122,0,0,0
25841,58thStGreenway22ndAve,02/09/2017 05:00:00 PM,48,-122,1,0,1
25842,58thStGreenway22ndAve,02/09/2017 06:00:00 PM,48,-122,2,0,2
25843,58thStGreenway22ndAve,02/09/2017 07:00:00 PM,48,-122,0,0,0
25844,58thStGreenway22ndAve,02/09/2017 08:00:00 PM,48,-122,0,0,0
25845,58thStGreenway22ndAve,02/09/2017 09:00:00 PM,48,-122,0,0,0
25846,58thStGreenway22ndAve,02/09/2017 10:00:00 PM,48,-122,0,0,0
25847,58thStGreenway22ndAve,02/09/2017 11:00:00 PM,48,-122,0,0,0
25848,58thStGreenway22ndAve,02/10/2017 12:00:00 AM,48,-122,0,0,0
25849,58thStGreenway22ndAve,02/10/2017 01:00:00 AM,48,-122,0,0,0
25850,58thStGreenway22ndAve,02/10/2017 02:00:00 AM,48,-122,0,0,0
25851,58thStGreenway22ndAve,02/10/2017 03:00:00 AM,48,-122,0,0,0
25852,58thStGreenway22ndAve,02/10/2017 04:00:00 AM,48,-122,0,0,0
25853,58thStGreenway22ndAve,02/10/2017 05:00:00 AM,48,-122,0,0,0
25854,58thStGreenway22ndAve,02/10/2017 06:00:00 AM,48,-122,0,0,0
25855,58thStGreenway22ndAve,02/10/2017 07:00:00 AM,48,-122,0,0,0
25856,58thStGreenway22ndAve,02/10/2017 08:00:00 AM,48,-122,1,0,1
25857,58thStGreenway22ndAve,02/10/2017 09:00:00 AM,48,-122,1,0,1
25858,58thStGreenway22ndAve,02/10/2017 10:00:00 AM,48,-122,0,0,0
25859,58thStGreenway22ndAve,02/10/2017 11:00:00 AM,48,-122,2,0,2
25860,58thStGreenway22ndAve,02/10/2017 12:00:00 PM,48,-122,1,0,1
25861,58thStGreenway22ndAve,02/10/2017 01:00:00 PM,48,-122,0,0,0
25862,58thStGreenway22ndAve,02/10/2017 02:00:00 PM,48,-122,0,0,0
25863,58thStGreenway22ndAve,02/10/2017 03:00:00 PM,48,-122,0,0,0
25864,58thStGreenway22ndAve,02/10/2017 04:00:00 PM,48,-122,1,0,1
25865,58thStGreenway22ndAve,02/10/2017 05:00:00 PM,48,-122,0,1,1
25866,58thStGreenway22ndAve,02/10/2017 06:00:00 PM,48,-122,0,0,0
25867,58thStGreenway22ndAve,02/10/2017 07:00:00 PM,48,-122,0,2,2
25868,58thStGreenway22ndAve,02/10/2017 08:00:00 PM,48,-122,0,0,0
25869,58thStGreenway22ndAve,02/10/2017 09:00:00 PM,48,-122,0,0,0
25870,58thStGreenway22ndAve,02/10/2017 10:00:00 PM,48,-122,0,3,3
25871,58thStGreenway22ndAve,02/10/2017 11:00:00 PM,48,-122,0,3,3
25872,58thStGreenway22ndAve,02/11/2017 12:00:00 AM,48,-122,1,0,1
25873,58thStGreenway22ndAve,02/11/2017 01:00:00 AM,48,-122,0,1,1
25874,58thStGreenway22ndAve,02/11/2017 02:00:00 AM,48,-122,0,4,4
25875,58thStGreenway22ndAve,02/11/2017 03:00:00 AM,48,-122,0,0,0
25876,58thStGreenway22ndAve,02/11/2017 04:00:00 AM,48,-122,0,0,0
25877,58thStGreenway22ndAve,02/11/2017 05:00:00 AM,48,-122,0,0,0
25878,58thStGreenway22ndAve,02/11/2017 06:00:00 AM,48,-122,0,2,2
25879,58thStGreenway22ndAve,02/11/2017 07:00:00 AM,48,-122,1,2,3
25880,58thStGreenway22ndAve,02/11/2017 08:00:00 AM,48,-122,1,5,6
25881,58thStGreenway22ndAve,02/11/2017 09:00:00 AM,48,-122,0,2,2
25882,58thStGreenway22ndAve,02/11/2017 10:00:00 AM,48,-122,0,0,0
25883,58thStGreenway22ndAve,02/11/2017 11:00:00 AM,48,-122,1,0,1
25884,58thStGreenway22ndAve,02/11/2017 12:00:00 PM,48,-122,2,3,5
25885,58thStGreenway22ndAve,02/11/2017 01:00:00 PM,48,-122,1,1,2
25886,58thStGreenway22ndAve,02/11/2017 02:00:00 PM,48,-122,0,4,4
25887,58thStGreenway22ndAve,02/11/2017 03:00:00 PM,48,-122,2,4,6
25888,58thStGreenway22ndAve,02/11/2017 04:00:00 PM,48,-122,3,2,5
25889,58thStGreenway22ndAve,02/11/2017 05:00:00 PM,48,-122,1,9,10
25890,58thStGreenway22ndAve,02/11/2017 06:00:00 PM,48,-122,0,3,3
25891,58thStGreenway22ndAve,02/11/2017 07:00:00 PM,48,-122,0,2,2
25892,58thStGreenway22ndAve,02/11/2017 08:00:00 PM,48,-122,0,3,3
25893,58thStGreenway22ndAve,02/11/2017 09:00:00 PM,48,-122,0,3,3
25894,58thStGreenway22ndAve,02/11/2017 10:00:00 PM,48,-122,0,3,3
25895,58thStGreenway22ndAve,02/11/2017 11:00:00 PM,48,-122,0,3,3
25896,58thStGreenway22ndAve,02/12/2017 12:00:00 AM,48,-122,1,3,4
25897,58thStGreenway22ndAve,02/12/2017 01:00:00 AM,48,-122,0,6,6
25898,58thStGreenway22ndAve,02/12/2017 02:00:00 AM,48,-122,0,0,0
25899,58thStGreenway22ndAve,02/12/2017 03:00:00 AM,48,-122,0,0,0
25900,58thStGreenway22ndAve,02/12/2017 04:00:00 AM,48,-122,0,0,0
25901,58thStGreenway22ndAve,02/12/2017 05:00:00 AM,48,-122,0,0,0
25902,58thStGreenway22ndAve,02/12/2017 06:00:00 AM,48,-122,0,0,0
25903,58thStGreenway22ndAve,02/12/2017 07:00:00 AM,48,-122,0,1,1
25904,58thStGreenway22ndAve,02/12/2017 08:00:00 AM,48,-122,0,1,1
25905,58thStGreenway22ndAve,02/12/2017 09:00:00 AM,48,-122,0,3,3
25906,58thStGreenway22ndAve,02/12/2017 10:00:00 AM,48,-122,2,2,4
25907,58thStGreenway22ndAve,02/12/2017 11:00:00 AM,48,-122,0,5,5
25908,58thStGreenway22ndAve,02/12/2017 12:00:00 PM,48,-122,3,5,8
25909,58thStGreenway22ndAve,02/12/2017 01:00:00 PM,48,-122,2,6,8
25910,58thStGreenway22ndAve,02/12/2017 02:00:00 PM,48,-122,6,5,11
25911,58thStGreenway22ndAve,02/12/2017 03:00:00 PM,48,-122,4,6,10
25912,58thStGreenway22ndAve,02/12/2017 04:00:00 PM,48,-122,1,2,3
25913,58thStGreenway22ndAve,02/12/2017 05:00:00 PM,48,-122,3,3,6
25914,58thStGreenway22ndAve,02/12/2017 06:00:00 PM,48,-122,1,1,2
25915,58thStGreenway22ndAve,02/12/2017 07:00:00 PM,48,-122,0,2,2
25916,58thStGreenway22ndAve,02/12/2017 08:00:00 PM,48,-122,0,2,2
25917,58thStGreenway22ndAve,02/12/2017 09:00:00 PM,48,-122,1,3,4
25918,58thStGreenway22ndAve,02/12/2017 10:00:00 PM,48,-122,0,0,0
25919,58thStGreenway22ndAve,02/12/2017 11:00:00 PM,48,-122,0,2,2
25920,58thStGreenway22ndAve,02/13/2017 12:00:00 AM,48,-122,0,0,0
25921,58thStGreenway22ndAve,02/13/2017 01:00:00 AM,48,-122,0,0,0
25922,58thStGreenway22ndAve,02/13/2017 02:00:00 AM,48,-122,0,1,1
25923,58thStGreenway22ndAve,02/13/2017 03:00:00 AM,48,-122,0,0,0
25924,58thStGreenway22ndAve,02/13/2017 04:00:00 AM,48,-122,0,0,0
25925,58thStGreenway22ndAve,02/13/2017 05:00:00 AM,48,-122,0,0,0
25926,58thStGreenway22ndAve,02/13/2017 06:00:00 AM,48,-122,1,1,2
25927,58thStGreenway22ndAve,02/13/2017 07:00:00 AM,48,-122,2,1,3
25928,58thStGreenway22ndAve,02/13/2017 08:00:00 AM,48,-122,2,0,2
25929,58thStGreenway22ndAve,02/13/2017 09:00:00 AM,48,-122,1,2,3
25930,58thStGreenway22ndAve,02/13/2017 10:00:00 AM,48,-122,0,3,3
25931,58thStGreenway22ndAve,02/13/2017 11:00:00 AM,48,-122,1,4,5
25932,58thStGreenway22ndAve,02/13/2017 12:00:00 PM,48,-122,0,1,1
25933,58thStGreenway22ndAve,02/13/2017 01:00:00 PM,48,-122,0,3,3
25934,58thStGreenway22ndAve,02/13/2017 02:00:00 PM,48,-122,5,1,6
25935,58thStGreenway22ndAve,02/13/2017 03:00:00 PM,48,-122,1,5,6
25936,58thStGreenway22ndAve,02/13/2017 04:00:00 PM,48,-122,0,5,5
25937,58thStGreenway22ndAve,02/13/2017 05:00:00 PM,48,-122,1,0,1
25938,58thStGreenway22ndAve,02/13/2017 06:00:00 PM,48,-122,1,1,2
25939,58thStGreenway22ndAve,02/13/2017 07:00:00 PM,48,-122,0,3,3
25940,58thStGreenway22ndAve,02/13/2017 08:00:00 PM,48,-122,0,1,1
25941,58thStGreenway22ndAve,02/13/2017 09:00:00 PM,48,-122,0,1,1
25942,58thStGreenway22ndAve,02/13/2017 10:00:00 PM,48,-122,0,2,2
25943,58thStGreenway22ndAve,02/13/2017 11:00:00 PM,48,-122,0,0,0
25944,58thStGreenway22ndAve,02/14/2017 12:00:00 AM,48,-122,0,0,0
25945,58thStGreenway22ndAve,02/14/2017 01:00:00 AM,48,-122,0,0,0
25946,58thStGreenway22ndAve,02/14/2017 02:00:00 AM,48,-122,0,0,0
25947,58thStGreenway22ndAve,02/14/2017 03:00:00 AM,48,-122,0,0,0
25948,58thStGreenway22ndAve,02/14/2017 04:00:00 AM,48,-122,0,0,0
25949,58thStGreenway22ndAve,02/14/2017 05:00:00 AM,48,-122,0,1,1
25950,58thStGreenway22ndAve,02/14/2017 06:00:00 AM,48,-122,1,0,1
25951,58thStGreenway22ndAve,02/14/2017 07:00:00 AM,48,-122,3,0,3
25952,58thStGreenway22ndAve,02/14/2017 08:00:00 AM,48,-122,1,2,3
25953,58thStGreenway22ndAve,02/14/2017 09:00:00 AM,48,-122,2,1,3
25954,58thStGreenway22ndAve,02/14/2017 10:00:00 AM,48,-122,0,0,0
25955,58thStGreenway22ndAve,02/14/2017 11:00:00 AM,48,-122,0,3,3
25956,58thStGreenway22ndAve,02/14/2017 12:00:00 PM,48,-122,1,1,2
25957,58thStGreenway22ndAve,02/14/2017 01:00:00 PM,48,-122,1,1,2
25958,58thStGreenway22ndAve,02/14/2017 02:00:00 PM,48,-122,2,1,3
25959,58thStGreenway22ndAve,02/14/2017 03:00:00 PM,48,-122,1,3,4
25960,58thStGreenway22ndAve,02/14/2017 04:00:00 PM,48,-122,3,2,5
25961,58thStGreenway22ndAve,02/14/2017 05:00:00 PM,48,-122,4,1,5
25962,58thStGreenway22ndAve,02/14/2017 06:00:00 PM,48,-122,1,1,2
25963,58thStGreenway22ndAve,02/14/2017 07:00:00 PM,48,-122,1,2,3
25964,58thStGreenway22ndAve,02/14/2017 08:00:00 PM,48,-122,1,0,1
25965,58thStGreenway22ndAve,02/14/2017 09:00:00 PM,48,-122,0,3,3
25966,58thStGreenway22ndAve,02/14/2017 10:00:00 PM,48,-122,0,3,3
25967,58thStGreenway22ndAve,02/14/2017 11:00:00 PM,48,-122,0,0,0
25968,58thStGreenway22ndAve,02/15/2017 12:00:00 AM,48,-122,0,0,0
25969,58thStGreenway22ndAve,02/15/2017 01:00:00 AM,48,-122,0,0,0
25970,58thStGreenway22ndAve,02/15/2017 02:00:00 AM,48,-122,0,1,1
25971,58thStGreenway22ndAve,02/15/2017 03:00:00 AM,48,-122,0,0,0
25972,58thStGreenway22ndAve,02/15/2017 04:00:00 AM,48,-122,0,1,1
25973,58thStGreenway22ndAve,02/15/2017 05:00:00 AM,48,-122,0,1,1
25974,58thStGreenway22ndAve,02/15/2017 06:00:00 AM,48,-122,0,1,1
25975,58thStGreenway22ndAve,02/15/2017 07:00:00 AM,48,-122,1,2,3
25976,58thStGreenway22ndAve,02/15/2017 08:00:00 AM,48,-122,0,2,2
25977,58thStGreenway22ndAve,02/15/2017 09:00:00 AM,48,-122,1,2,3
25978,58thStGreenway22ndAve,02/15/2017 10:00:00 AM,48,-122,0,3,3
25979,58thStGreenway22ndAve,02/15/2017 11:00:00 AM,48,-122,2,3,5
25980,58thStGreenway22ndAve,02/15/2017 12:00:00 PM,48,-122,0,2,2
25981,58thStGreenway22ndAve,02/15/2017 01:00:00 PM,48,-122,1,4,5
25982,58thStGreenway22ndAve,02/15/2017 02:00:00 PM,48,-122,1,1,2
25983,58thStGreenway22ndAve,02/15/2017 03:00:00 PM,48,-122,0,2,2
25984,58thStGreenway22ndAve,02/15/2017 04:00:00 PM,48,-122,0,3,3
25985,58thStGreenway22ndAve,02/15/2017 05:00:00 PM,48,-122,1,3,4
25986,58thStGreenway22ndAve,02/15/2017 06:00:00 PM,48,-122,0,5,5
25987,58thStGreenway22ndAve,02/15/2017 07:00:00 PM,48,-122,0,3,3
25988,58thStGreenway22ndAve,02/15/2017 08:00:00 PM,48,-122,0,4,4
25989,58thStGreenway22ndAve,02/15/2017 09:00:00 PM,48,-122,0,1,1
25990,58thStGreenway22ndAve,02/15/2017 10:00:00 PM,48,-122,0,1,1
25991,58thStGreenway22ndAve,02/15/2017 11:00:00 PM,48,-122,0,0,0
25992,58thStGreenway22ndAve,02/16/2017 12:00:00 AM,48,-122,0,1,1
25993,58thStGreenway22ndAve,02/16/2017 01:00:00 AM,48,-122,0,0,0
25994,58thStGreenway22ndAve,02/16/2017 02:00:00 AM,48,-122,0,0,0
25995,58thStGreenway22ndAve,02/16/2017 03:00:00 AM,48,-122,0,0,0
25996,58thStGreenway22ndAve,02/16/2017 04:00:00 AM,48,-122,0,0,0
25997,58thStGreenway22ndAve,02/16/2017 05:00:00 AM,48,-122,0,2,2
25998,58thStGreenway22ndAve,02/16/2017 06:00:00 AM,48,-122,0,1,1
25999,58thStGreenway22ndAve,02/16/2017 07:00:00 AM,48,-122,1,2,3
26000,58thStGreenway22ndAve,02/16/2017 08:00:00 AM,48,-122,1,2,3
26001,58thStGreenway22ndAve,02/16/2017 09:00:00 AM,48,-122,0,1,1
26002,58thStGreenway22ndAve,02/16/2017 10:00:00 AM,48,-122,1,2,3
26003,58thStGreenway22ndAve,02/16/2017 11:00:00 AM,48,-122,0,1,1
26004,58thStGreenway22ndAve,02/16/2017 12:00:00 PM,48,-122,1,1,2
26005,58thStGreenway22ndAve,02/16/2017 01:00:00 PM,48,-122,0,2,2
26006,58thStGreenway22ndAve,02/16/2017 02:00:00 PM,48,-122,2,3,5
26007,58thStGreenway22ndAve,02/16/2017 03:00:00 PM,48,-122,1,2,3
26008,58thStGreenway22ndAve,02/16/2017 04:00:00 PM,48,-122,0,2,2
26009,58thStGreenway22ndAve,02/16/2017 05:00:00 PM,48,-122,2,2,4
26010,58thStGreenway22ndAve,02/16/2017 06:00:00 PM,48,-122,1,6,7
26011,58thStGreenway22ndAve,02/16/2017 07:00:00 PM,48,-122,0,0,0
26012,58thStGreenway22ndAve,02/16/2017 08:00:00 PM,48,-122,0,4,4
26013,58thStGreenway22ndAve,02/16/2017 09:00:00 PM,48,-122,0,3,3
26014,58thStGreenway22ndAve,02/16/2017 10:00:00 PM,48,-122,0,0,0
26015,58thStGreenway22ndAve,02/16/2017 11:00:00 PM,48,-122,1,0,1
26016,58thStGreenway22ndAve,02/17/2017 12:00:00 AM,48,-122,0,0,0
26017,58thStGreenway22ndAve,02/17/2017 01:00:00 AM,48,-122,0,0,0
26018,58thStGreenway22ndAve,02/17/2017 02:00:00 AM,48,-122,0,0,0
26019,58thStGreenway22ndAve,02/17/2017 03:00:00 AM,48,-122,0,0,0
26020,58thStGreenway22ndAve,02/17/2017 04:00:00 AM,48,-122,0,1,1
26021,58thStGreenway22ndAve,02/17/2017 05:00:00 AM,48,-122,1,2,3
26022,58thStGreenway22ndAve,02/17/2017 06:00:00 AM,48,-122,1,1,2
26023,58thStGreenway22ndAve,02/17/2017 07:00:00 AM,48,-122,1,2,3
26024,58thStGreenway22ndAve,02/17/2017 08:00:00 AM,48,-122,0,1,1
26025,58thStGreenway22ndAve,02/17/2017 09:00:00 AM,48,-122,1,7,8
26026,58thStGreenway22ndAve,02/17/2017 10:00:00 AM,48,-122,1,6,7
26027,58thStGreenway22ndAve,02/17/2017 11:00:00 AM,48,-122,0,5,5
26028,58thStGreenway22ndAve,02/17/2017 12:00:00 PM,48,-122,1,2,3
26029,58thStGreenway22ndAve,02/17/2017 01:00:00 PM,48,-122,1,6,7
26030,58thStGreenway22ndAve,02/17/2017 02:00:00 PM,48,-122,3,6,9
26031,58thStGreenway22ndAve,02/17/2017 03:00:00 PM,48,-122,2,2,4
26032,58thStGreenway22ndAve,02/17/2017 04:00:00 PM,48,-122,0,5,5
26033,58thStGreenway22ndAve,02/17/2017 05:00:00 PM,48,-122,3,5,8
26034,58thStGreenway22ndAve,02/17/2017 06:00:00 PM,48,-122,2,3,5
26035,58thStGreenway22ndAve,02/17/2017 07:00:00 PM,48,-122,1,2,3
26036,58thStGreenway22ndAve,02/17/2017 08:00:00 PM,48,-122,0,2,2
26037,58thStGreenway22ndAve,02/17/2017 09:00:00 PM,48,-122,1,0,1
26038,58thStGreenway22ndAve,02/17/2017 10:00:00 PM,48,-122,0,1,1
26039,58thStGreenway22ndAve,02/17/2017 11:00:00 PM,48,-122,0,0,0
26040,58thStGreenway22ndAve,02/18/2017 12:00:00 AM,48,-122,1,2,3
26041,58thStGreenway22ndAve,02/18/2017 01:00:00 AM,48,-122,0,0,0
26042,58thStGreenway22ndAve,02/18/2017 02:00:00 AM,48,-122,0,2,2
26043,58thStGreenway22ndAve,02/18/2017 03:00:00 AM,48,-122,0,0,0
26044,58thStGreenway22ndAve,02/18/2017 04:00:00 AM,48,-122,0,0,0
26045,58thStGreenway22ndAve,02/18/2017 05:00:00 AM,48,-122,1,1,2
26046,58thStGreenway22ndAve,02/18/2017 06:00:00 AM,48,-122,0,1,1
26047,58thStGreenway22ndAve,02/18/2017 07:00:00 AM,48,-122,0,0,0
26048,58thStGreenway22ndAve,02/18/2017 08:00:00 AM,48,-122,0,1,1
26049,58thStGreenway22ndAve,02/18/2017 09:00:00 AM,48,-122,0,5,5
26050,58thStGreenway22ndAve,02/18/2017 10:00:00 AM,48,-122,1,0,1
26051,58thStGreenway22ndAve,02/18/2017 11:00:00 AM,48,-122,1,3,4
26052,58thStGreenway22ndAve,02/18/2017 12:00:00 PM,48,-122,1,2,3
26053,58thStGreenway22ndAve,02/18/2017 01:00:00 PM,48,-122,0,1,1
26054,58thStGreenway22ndAve,02/18/2017 02:00:00 PM,48,-122,2,0,2
26055,58thStGreenway22ndAve,02/18/2017 03:00:00 PM,48,-122,1,1,2
26056,58thStGreenway22ndAve,02/18/2017 04:00:00 PM,48,-122,1,2,3
26057,58thStGreenway22ndAve,02/18/2017 05:00:00 PM,48,-122,2,1,3
26058,58thStGreenway22ndAve,02/18/2017 06:00:00 PM,48,-122,2,2,4
26059,58thStGreenway22ndAve,02/18/2017 07:00:00 PM,48,-122,1,0,1
26060,58thStGreenway22ndAve,02/18/2017 08:00:00 PM,48,-122,0,1,1
26061,58thStGreenway22ndAve,02/18/2017 09:00:00 PM,48,-122,0,0,0
26062,58thStGreenway22ndAve,02/18/2017 10:00:00 PM,48,-122,0,0,0
26063,58thStGreenway22ndAve,02/18/2017 11:00:00 PM,48,-122,0,2,2
26064,58thStGreenway22ndAve,02/19/2017 12:00:00 AM,48,-122,0,2,2
26065,58thStGreenway22ndAve,02/19/2017 01:00:00 AM,48,-122,0,2,2
26066,58thStGreenway22ndAve,02/19/2017 02:00:00 AM,48,-122,0,0,0
26067,58thStGreenway22ndAve,02/19/2017 03:00:00 AM,48,-122,0,0,0
26068,58thStGreenway22ndAve,02/19/2017 04:00:00 AM,48,-122,0,0,0
26069,58thStGreenway22ndAve,02/19/2017 05:00:00 AM,48,-122,0,0,0
26070,58thStGreenway22ndAve,02/19/2017 06:00:00 AM,48,-122,0,0,0
26071,58thStGreenway22ndAve,02/19/2017 07:00:00 AM,48,-122,0,1,1
26072,58thStGreenway22ndAve,02/19/2017 08:00:00 AM,48,-122,0,0,0
26073,58thStGreenway22ndAve,02/19/2017 09:00:00 AM,48,-122,1,0,1
26074,58thStGreenway22ndAve,02/19/2017 10:00:00 AM,48,-122,1,2,3
26075,58thStGreenway22ndAve,02/19/2017 11:00:00 AM,48,-122,1,3,4
26076,58thStGreenway22ndAve,02/19/2017 12:00:00 PM,48,-122,3,2,5
26077,58thStGreenway22ndAve,02/19/2017 01:00:00 PM,48,-122,5,2,7
26078,58thStGreenway22ndAve,02/19/2017 02:00:00 PM,48,-122,0,0,0
26079,58thStGreenway22ndAve,02/19/2017 03:00:00 PM,48,-122,1,1,2
26080,58thStGreenway22ndAve,02/19/2017 04:00:00 PM,48,-122,0,1,1
26081,58thStGreenway22ndAve,02/19/2017 05:00:00 PM,48,-122,0,0,0
26082,58thStGreenway22ndAve,02/19/2017 06:00:00 PM,48,-122,1,2,3
26083,58thStGreenway22ndAve,02/19/2017 07:00:00 PM,48,-122,2,1,3
26084,58thStGreenway22ndAve,02/19/2017 08:00:00 PM,48,-122,0,3,3
26085,58thStGreenway22ndAve,02/19/2017 09:00:00 PM,48,-122,0,0,0
26086,58thStGreenway22ndAve,02/19/2017 10:00:00 PM,48,-122,0,1,1
26087,58thStGreenway22ndAve,02/19/2017 11:00:00 PM,48,-122,1,0,1
26088,58thStGreenway22ndAve,02/20/2017 12:00:00 AM,48,-122,0,0,0
26089,58thStGreenway22ndAve,02/20/2017 01:00:00 AM,48,-122,0,1,1
26090,58thStGreenway22ndAve,02/20/2017 02:00:00 AM,48,-122,0,1,1
26091,58thStGreenway22ndAve,02/20/2017 03:00:00 AM,48,-122,0,1,1
26092,58thStGreenway22ndAve,02/20/2017 04:00:00 AM,48,-122,0,1,1
26093,58thStGreenway22ndAve,02/20/2017 05:00:00 AM,48,-122,0,1,1
26094,58thStGreenway22ndAve,02/20/2017 06:00:00 AM,48,-122,0,0,0
26095,58thStGreenway22ndAve,02/20/2017 07:00:00 AM,48,-122,1,0,1
26096,58thStGreenway22ndAve,02/20/2017 08:00:00 AM,48,-122,0,0,0
26097,58thStGreenway22ndAve,02/20/2017 09:00:00 AM,48,-122,0,3,3
26098,58thStGreenway22ndAve,02/20/2017 10:00:00 AM,48,-122,0,0,0
26099,58thStGreenway22ndAve,02/20/2017 11:00:00 AM,48,-122,0,3,3
26100,58thStGreenway22ndAve,02/20/2017 12:00:00 PM,48,-122,0,3,3
26101,58thStGreenway22ndAve,02/20/2017 01:00:00 PM,48,-122,1,2,3
26102,58thStGreenway22ndAve,02/20/2017 02:00:00 PM,48,-122,2,3,5
26103,58thStGreenway22ndAve,02/20/2017 03:00:00 PM,48,-122,0,0,0
26104,58thStGreenway22ndAve,02/20/2017 04:00:00 PM,48,-122,0,0,0
26105,58thStGreenway22ndAve,02/20/2017 05:00:00 PM,48,-122,2,1,3
26106,58thStGreenway22ndAve,02/20/2017 06:00:00 PM,48,-122,2,0,2
26107,58thStGreenway22ndAve,02/20/2017 07:00:00 PM,48,-122,6,3,9
26108,58thStGreenway22ndAve,02/20/2017 08:00:00 PM,48,-122,0,1,1
26109,58thStGreenway22ndAve,02/20/2017 09:00:00 PM,48,-122,2,0,2
26110,58thStGreenway22ndAve,02/20/2017 10:00:00 PM,48,-122,0,0,0
26111,58thStGreenway22ndAve,02/20/2017 11:00:00 PM,48,-122,0,0,0
26112,58thStGreenway22ndAve,02/21/2017 12:00:00 AM,48,-122,0,0,0
26113,58thStGreenway22ndAve,02/21/2017 01:00:00 AM,48,-122,0,1,1
26114,58thStGreenway22ndAve,02/21/2017 02:00:00 AM,48,-122,0,0,0
26115,58thStGreenway22ndAve,02/21/2017 03:00:00 AM,48,-122,0,0,0
26116,58thStGreenway22ndAve,02/21/2017 04:00:00 AM,48,-122,0,0,0
26117,58thStGreenway22ndAve,02/21/2017 05:00:00 AM,48,-122,0,1,1
26118,58thStGreenway22ndAve,02/21/2017 06:00:00 AM,48,-122,1,1,2
26119,58thStGreenway22ndAve,02/21/2017 07:00:00 AM,48,-122,2,0,2
26120,58thStGreenway22ndAve,02/21/2017 08:00:00 AM,48,-122,0,0,0
26121,58thStGreenway22ndAve,02/21/2017 09:00:00 AM,48,-122,2,0,2
26122,58thStGreenway22ndAve,02/21/2017 10:00:00 AM,48,-122,0,1,1
26123,58thStGreenway22ndAve,02/21/2017 11:00:00 AM,48,-122,0,3,3
26124,58thStGreenway22ndAve,02/21/2017 12:00:00 PM,48,-122,2,3,5
26125,58thStGreenway22ndAve,02/21/2017 01:00:00 PM,48,-122,3,1,4
26126,58thStGreenway22ndAve,02/21/2017 02:00:00 PM,48,-122,5,0,5
26127,58thStGreenway22ndAve,02/21/2017 03:00:00 PM,48,-122,0,0,0
26128,58thStGreenway22ndAve,02/21/2017 04:00:00 PM,48,-122,0,0,0
26129,58thStGreenway22ndAve,02/21/2017 05:00:00 PM,48,-122,0,0,0
26130,58thStGreenway22ndAve,02/21/2017 06:00:00 PM,48,-122,0,0,0
26131,58thStGreenway22ndAve,02/21/2017 07:00:00 PM,48,-122,2,0,2
26132,58thStGreenway22ndAve,02/21/2017 08:00:00 PM,48,-122,3,0,3
26133,58thStGreenway22ndAve,02/21/2017 09:00:00 PM,48,-122,0,0,0
26134,58thStGreenway22ndAve,02/21/2017 10:00:00 PM,48,-122,0,0,0
26135,58thStGreenway22ndAve,02/21/2017 11:00:00 PM,48,-122,0,0,0
26136,58thStGreenway22ndAve,02/22/2017 12:00:00 AM,48,-122,0,0,0
26137,58thStGreenway22ndAve,02/22/2017 01:00:00 AM,48,-122,0,0,0
26138,58thStGreenway22ndAve,02/22/2017 02:00:00 AM,48,-122,0,0,0
26139,58thStGreenway22ndAve,02/22/2017 03:00:00 AM,48,-122,0,0,0
26140,58thStGreenway22ndAve,02/22/2017 04:00:00 AM,48,-122,0,0,0
26141,58thStGreenway22ndAve,02/22/2017 05:00:00 AM,48,-122,0,0,0
26142,58thStGreenway22ndAve,02/22/2017 06:00:00 AM,48,-122,0,0,0
26143,58thStGreenway22ndAve,02/22/2017 07:00:00 AM,48,-122,0,0,0
26144,58thStGreenway22ndAve,02/22/2017 08:00:00 AM,48,-122,0,0,0
26145,58thStGreenway22ndAve,02/22/2017 09:00:00 AM,48,-122,0,0,0
26146,58thStGreenway22ndAve,02/22/2017 10:00:00 AM,48,-122,3,0,3
26147,58thStGreenway22ndAve,02/22/2017 11:00:00 AM,48,-122,0,0,0
26148,58thStGreenway22ndAve,02/22/2017 12:00:00 PM,48,-122,0,0,0
26149,58thStGreenway22ndAve,02/22/2017 01:00:00 PM,48,-122,0,0,0
26150,58thStGreenway22ndAve,02/22/2017 02:00:00 PM,48,-122,3,0,3
26151,58thStGreenway22ndAve,02/22/2017 03:00:00 PM,48,-122,3,0,3
26152,58thStGreenway22ndAve,02/22/2017 04:00:00 PM,48,-122,1,0,1
26153,58thStGreenway22ndAve,02/22/2017 05:00:00 PM,48,-122,2,0,2
26154,58thStGreenway22ndAve,02/22/2017 06:00:00 PM,48,-122,1,0,1
26155,58thStGreenway22ndAve,02/22/2017 07:00:00 PM,48,-122,4,0,4
26156,58thStGreenway22ndAve,02/22/2017 08:00:00 PM,48,-122,1,0,1
26157,58thStGreenway22ndAve,02/22/2017 09:00:00 PM,48,-122,0,0,0
26158,58thStGreenway22ndAve,02/22/2017 10:00:00 PM,48,-122,0,0,0
26159,58thStGreenway22ndAve,02/22/2017 11:00:00 PM,48,-122,0,0,0
26160,58thStGreenway22ndAve,02/23/2017 12:00:00 AM,48,-122,0,0,0
26161,58thStGreenway22ndAve,02/23/2017 01:00:00 AM,48,-122,0,0,0
26162,58thStGreenway22ndAve,02/23/2017 02:00:00 AM,48,-122,0,0,0
26163,58thStGreenway22ndAve,02/23/2017 03:00:00 AM,48,-122,0,0,0
26164,58thStGreenway22ndAve,02/23/2017 04:00:00 AM,48,-122,0,0,0
26165,58thStGreenway22ndAve,02/23/2017 05:00:00 AM,48,-122,0,0,0
26166,58thStGreenway22ndAve,02/23/2017 06:00:00 AM,48,-122,2,0,2
26167,58thStGreenway22ndAve,02/23/2017 07:00:00 AM,48,-122,0,0,0
26168,58thStGreenway22ndAve,02/23/2017 08:00:00 AM,48,-122,0,0,0
26169,58thStGreenway22ndAve,02/23/2017 09:00:00 AM,48,-122,1,0,1
26170,58thStGreenway22ndAve,02/23/2017 10:00:00 AM,48,-122,0,0,0
26171,58thStGreenway22ndAve,02/23/2017 11:00:00 AM,48,-122,0,0,0
26172,58thStGreenway22ndAve,02/23/2017 12:00:00 PM,48,-122,2,0,2
26173,58thStGreenway22ndAve,02/23/2017 01:00:00 PM,48,-122,4,0,4
26174,58thStGreenway22ndAve,02/23/2017 02:00:00 PM,48,-122,1,0,1
26175,58thStGreenway22ndAve,02/23/2017 03:00:00 PM,48,-122,0,0,0
26176,58thStGreenway22ndAve,02/23/2017 04:00:00 PM,48,-122,0,0,0
26177,58thStGreenway22ndAve,02/23/2017 05:00:00 PM,48,-122,0,0,0
26178,58thStGreenway22ndAve,02/23/2017 06:00:00 PM,48,-122,0,0,0
26179,58thStGreenway22ndAve,02/23/2017 07:00:00 PM,48,-122,0,0,0
26180,58thStGreenway22ndAve,02/23/2017 08:00:00 PM,48,-122,0,0,0
26181,58thStGreenway22ndAve,02/23/2017 09:00:00 PM,48,-122,0,0,0
26182,58thStGreenway22ndAve,02/23/2017 10:00:00 PM,48,-122,0,0,0
26183,58thStGreenway22ndAve,02/23/2017 11:00:00 PM,48,-122,0,0,0
26184,58thStGreenway22ndAve,02/24/2017 12:00:00 AM,48,-122,0,0,0
26185,58thStGreenway22ndAve,02/24/2017 01:00:00 AM,48,-122,0,0,0
26186,58thStGreenway22ndAve,02/24/2017 02:00:00 AM,48,-122,0,0,0
26187,58thStGreenway22ndAve,02/24/2017 03:00:00 AM,48,-122,0,0,0
26188,58thStGreenway22ndAve,02/24/2017 04:00:00 AM,48,-122,0,0,0
26189,58thStGreenway22ndAve,02/24/2017 05:00:00 AM,48,-122,0,0,0
26190,58thStGreenway22ndAve,02/24/2017 06:00:00 AM,48,-122,0,0,0
26191,58thStGreenway22ndAve,02/24/2017 07:00:00 AM,48,-122,0,0,0
26192,58thStGreenway22ndAve,02/24/2017 08:00:00 AM,48,-122,0,0,0
26193,58thStGreenway22ndAve,02/24/2017 09:00:00 AM,48,-122,0,0,0
26194,58thStGreenway22ndAve,02/24/2017 10:00:00 AM,48,-122,0,0,0
26195,58thStGreenway22ndAve,02/24/2017 11:00:00 AM,48,-122,0,0,0
26196,58thStGreenway22ndAve,02/24/2017 12:00:00 PM,48,-122,1,0,1
26197,58thStGreenway22ndAve,02/24/2017 01:00:00 PM,48,-122,0,0,0
26198,58thStGreenway22ndAve,02/24/2017 02:00:00 PM,48,-122,1,0,1
26199,58thStGreenway22ndAve,02/24/2017 03:00:00 PM,48,-122,1,0,1
26200,58thStGreenway22ndAve,02/24/2017 04:00:00 PM,48,-122,0,3,3
26201,58thStGreenway22ndAve,02/24/2017 05:00:00 PM,48,-122,2,0,2
26202,58thStGreenway22ndAve,02/24/2017 06:00:00 PM,48,-122,1,0,1
26203,58thStGreenway22ndAve,02/24/2017 07:00:00 PM,48,-122,0,0,0
26204,58thStGreenway22ndAve,02/24/2017 08:00:00 PM,48,-122,0,0,0
26205,58thStGreenway22ndAve,02/24/2017 09:00:00 PM,48,-122,0,0,0
26206,58thStGreenway22ndAve,02/24/2017 10:00:00 PM,48,-122,0,0,0
26207,58thStGreenway22ndAve,02/24/2017 11:00:00 PM,48,-122,0,0,0
26208,58thStGreenway22ndAve,02/25/2017 12:00:00 AM,48,-122,0,0,0
26209,58thStGreenway22ndAve,02/25/2017 01:00:00 AM,48,-122,0,0,0
26210,58thStGreenway22ndAve,02/25/2017 02:00:00 AM,48,-122,0,0,0
26211,58thStGreenway22ndAve,02/25/2017 03:00:00 AM,48,-122,0,0,0
26212,58thStGreenway22ndAve,02/25/2017 04:00:00 AM,48,-122,0,0,0
26213,58thStGreenway22ndAve,02/25/2017 05:00:00 AM,48,-122,0,0,0
26214,58thStGreenway22ndAve,02/25/2017 06:00:00 AM,48,-122,0,0,0
26215,58thStGreenway22ndAve,02/25/2017 07:00:00 AM,48,-122,0,0,0
26216,58thStGreenway22ndAve,02/25/2017 08:00:00 AM,48,-122,0,0,0
26217,58thStGreenway22ndAve,02/25/2017 09:00:00 AM,48,-122,0,0,0
26218,58thStGreenway22ndAve,02/25/2017 10:00:00 AM,48,-122,2,0,2
26219,58thStGreenway22ndAve,02/25/2017 11:00:00 AM,48,-122,1,0,1
26220,58thStGreenway22ndAve,02/25/2017 12:00:00 PM,48,-122,0,0,0
26221,58thStGreenway22ndAve,02/25/2017 01:00:00 PM,48,-122,1,0,1
26222,58thStGreenway22ndAve,02/25/2017 02:00:00 PM,48,-122,1,0,1
26223,58thStGreenway22ndAve,02/25/2017 03:00:00 PM,48,-122,1,0,1
26224,58thStGreenway22ndAve,02/25/2017 04:00:00 PM,48,-122,1,0,1
26225,58thStGreenway22ndAve,02/25/2017 05:00:00 PM,48,-122,1,0,1
26226,58thStGreenway22ndAve,02/25/2017 06:00:00 PM,48,-122,0,0,0
26227,58thStGreenway22ndAve,02/25/2017 07:00:00 PM,48,-122,0,0,0
26228,58thStGreenway22ndAve,02/25/2017 08:00:00 PM,48,-122,1,0,1
26229,58thStGreenway22ndAve,02/25/2017 09:00:00 PM,48,-122,0,0,0
26230,58thStGreenway22ndAve,02/25/2017 10:00:00 PM,48,-122,0,0,0
26231,58thStGreenway22ndAve,02/25/2017 11:00:00 PM,48,-122,0,0,0
26232,58thStGreenway22ndAve,02/26/2017 12:00:00 AM,48,-122,0,0,0
26233,58thStGreenway22ndAve,02/26/2017 01:00:00 AM,48,-122,0,0,0
26234,58thStGreenway22ndAve,02/26/2017 02:00:00 AM,48,-122,0,0,0
26235,58thStGreenway22ndAve,02/26/2017 03:00:00 AM,48,-122,0,0,0
26236,58thStGreenway22ndAve,02/26/2017 04:00:00 AM,48,-122,0,0,0
26237,58thStGreenway22ndAve,02/26/2017 05:00:00 AM,48,-122,0,1,1
26238,58thStGreenway22ndAve,02/26/2017 06:00:00 AM,48,-122,0,0,0
26239,58thStGreenway22ndAve,02/26/2017 07:00:00 AM,48,-122,0,0,0
26240,58thStGreenway22ndAve,02/26/2017 08:00:00 AM,48,-122,0,0,0
26241,58thStGreenway22ndAve,02/26/2017 09:00:00 AM,48,-122,0,0,0
26242,58thStGreenway22ndAve,02/26/2017 10:00:00 AM,48,-122,2,0,2
26243,58thStGreenway22ndAve,02/26/2017 11:00:00 AM,48,-122,1,0,1
26244,58thStGreenway22ndAve,02/26/2017 12:00:00 PM,48,-122,1,0,1
26245,58thStGreenway22ndAve,02/26/2017 01:00:00 PM,48,-122,2,0,2
26246,58thStGreenway22ndAve,02/26/2017 02:00:00 PM,48,-122,1,0,1
26247,58thStGreenway22ndAve,02/26/2017 03:00:00 PM,48,-122,1,0,1
26248,58thStGreenway22ndAve,02/26/2017 04:00:00 PM,48,-122,1,0,1
26249,58thStGreenway22ndAve,02/26/2017 05:00:00 PM,48,-122,1,0,1
26250,58thStGreenway22ndAve,02/26/2017 06:00:00 PM,48,-122,1,0,1
26251,58thStGreenway22ndAve,02/26/2017 07:00:00 PM,48,-122,0,0,0
26252,58thStGreenway22ndAve,02/26/2017 08:00:00 PM,48,-122,0,0,0
26253,58thStGreenway22ndAve,02/26/2017 09:00:00 PM,48,-122,0,0,0
26254,58thStGreenway22ndAve,02/26/2017 10:00:00 PM,48,-122,0,0,0
26255,58thStGreenway22ndAve,02/26/2017 11:00:00 PM,48,-122,0,0,0
26256,58thStGreenway22ndAve,02/27/2017 12:00:00 AM,48,-122,0,0,0
26257,58thStGreenway22ndAve,02/27/2017 01:00:00 AM,48,-122,0,0,0
26258,58thStGreenway22ndAve,02/27/2017 02:00:00 AM,48,-122,0,0,0
26259,58thStGreenway22ndAve,02/27/2017 03:00:00 AM,48,-122,0,0,0
26260,58thStGreenway22ndAve,02/27/2017 04:00:00 AM,48,-122,0,0,0
26261,58thStGreenway22ndAve,02/27/2017 05:00:00 AM,48,-122,0,0,0
26262,58thStGreenway22ndAve,02/27/2017 06:00:00 AM,48,-122,0,0,0
26263,58thStGreenway22ndAve,02/27/2017 07:00:00 AM,48,-122,0,0,0
26264,58thStGreenway22ndAve,02/27/2017 08:00:00 AM,48,-122,0,0,0
26265,58thStGreenway22ndAve,02/27/2017 09:00:00 AM,48,-122,0,0,0
26266,58thStGreenway22ndAve,02/27/2017 10:00:00 AM,48,-122,0,0,0
26267,58thStGreenway22ndAve,02/27/2017 11:00:00 AM,48,-122,0,0,0
26268,58thStGreenway22ndAve,02/27/2017 12:00:00 PM,48,-122,1,0,1
26269,58thStGreenway22ndAve,02/27/2017 01:00:00 PM,48,-122,0,0,0
26270,58thStGreenway22ndAve,02/27/2017 02:00:00 PM,48,-122,0,0,0
26271,58thStGreenway22ndAve,02/27/2017 03:00:00 PM,48,-122,0,0,0
26272,58thStGreenway22ndAve,02/27/2017 04:00:00 PM,48,-122,1,0,1
26273,58thStGreenway22ndAve,02/27/2017 05:00:00 PM,48,-122,0,0,0
26274,58thStGreenway22ndAve,02/27/2017 06:00:00 PM,48,-122,1,0,1
26275,58thStGreenway22ndAve,02/27/2017 07:00:00 PM,48,-122,1,0,1
26276,58thStGreenway22ndAve,02/27/2017 08:00:00 PM,48,-122,0,0,0
26277,58thStGreenway22ndAve,02/27/2017 09:00:00 PM,48,-122,0,0,0
26278,58thStGreenway22ndAve,02/27/2017 10:00:00 PM,48,-122,0,0,0
26279,58thStGreenway22ndAve,02/27/2017 11:00:00 PM,48,-122,0,0,0
26280,58thStGreenway22ndAve,02/28/2017 12:00:00 AM,48,-122,0,0,0
26281,58thStGreenway22ndAve,02/28/2017 01:00:00 AM,48,-122,0,0,0
26282,58thStGreenway22ndAve,02/28/2017 02:00:00 AM,48,-122,0,0,0
26283,58thStGreenway22ndAve,02/28/2017 03:00:00 AM,48,-122,0,0,0
26284,58thStGreenway22ndAve,02/28/2017 04:00:00 AM,48,-122,0,0,0
26285,58thStGreenway22ndAve,02/28/2017 05:00:00 AM,48,-122,0,0,0
26286,58thStGreenway22ndAve,02/28/2017 06:00:00 AM,48,-122,0,0,0
26287,58thStGreenway22ndAve,02/28/2017 07:00:00 AM,48,-122,0,0,0
26288,58thStGreenway22ndAve,02/28/2017 08:00:00 AM,48,-122,0,0,0
26289,58thStGreenway22ndAve,02/28/2017 09:00:00 AM,48,-122,1,0,1
26290,58thStGreenway22ndAve,02/28/2017 10:00:00 AM,48,-122,0,0,0
26291,58thStGreenway22ndAve,02/28/2017 11:00:00 AM,48,-122,1,1,2
26292,58thStGreenway22ndAve,02/28/2017 12:00:00 PM,48,-122,0,0,0
26293,58thStGreenway22ndAve,02/28/2017 01:00:00 PM,48,-122,0,0,0
26294,58thStGreenway22ndAve,02/28/2017 02:00:00 PM,48,-122,2,1,3
26295,58thStGreenway22ndAve,02/28/2017 03:00:00 PM,48,-122,1,0,1
26296,58thStGreenway22ndAve,02/28/2017 04:00:00 PM,48,-122,2,0,2
26297,58thStGreenway22ndAve,02/28/2017 05:00:00 PM,48,-122,2,0,2
26298,58thStGreenway22ndAve,02/28/2017 06:00:00 PM,48,-122,3,0,3
26299,58thStGreenway22ndAve,02/28/2017 07:00:00 PM,48,-122,0,1,1
26300,58thStGreenway22ndAve,02/28/2017 08:00:00 PM,48,-122,2,1,3
26301,58thStGreenway22ndAve,02/28/2017 09:00:00 PM,48,-122,0,0,0
26302,58thStGreenway22ndAve,02/28/2017 10:00:00 PM,48,-122,0,0,0
26303,58thStGreenway22ndAve,02/28/2017 11:00:00 PM,48,-122,0,0,0
26304,58thStGreenway22ndAve,03/01/2017 12:00:00 AM,48,-122,0,0,0
26305,58thStGreenway22ndAve,03/01/2017 01:00:00 AM,48,-122,0,0,0
26306,58thStGreenway22ndAve,03/01/2017 02:00:00 AM,48,-122,0,0,0
26307,58thStGreenway22ndAve,03/01/2017 03:00:00 AM,48,-122,0,0,0
26308,58thStGreenway22ndAve,03/01/2017 04:00:00 AM,48,-122,0,0,0
26309,58thStGreenway22ndAve,03/01/2017 05:00:00 AM,48,-122,0,0,0
26310,58thStGreenway22ndAve,03/01/2017 06:00:00 AM,48,-122,0,0,0
26311,58thStGreenway22ndAve,03/01/2017 07:00:00 AM,48,-122,0,0,0
26312,58thStGreenway22ndAve,03/01/2017 08:00:00 AM,48,-122,1,0,1
26313,58thStGreenway22ndAve,03/01/2017 09:00:00 AM,48,-122,2,0,2
26314,58thStGreenway22ndAve,03/01/2017 10:00:00 AM,48,-122,1,0,1
26315,58thStGreenway22ndAve,03/01/2017 11:00:00 AM,48,-122,0,0,0
26316,58thStGreenway22ndAve,03/01/2017 12:00:00 PM,48,-122,1,0,1
26317,58thStGreenway22ndAve,03/01/2017 01:00:00 PM,48,-122,1,0,1
26318,58thStGreenway22ndAve,03/01/2017 02:00:00 PM,48,-122,1,0,1
26319,58thStGreenway22ndAve,03/01/2017 03:00:00 PM,48,-122,1,0,1
26320,58thStGreenway22ndAve,03/01/2017 04:00:00 PM,48,-122,1,0,1
26321,58thStGreenway22ndAve,03/01/2017 05:00:00 PM,48,-122,0,0,0
26322,58thStGreenway22ndAve,03/01/2017 06:00:00 PM,48,-122,2,0,2
26323,58thStGreenway22ndAve,03/01/2017 07:00:00 PM,48,-122,0,0,0
26324,58thStGreenway22ndAve,03/01/2017 08:00:00 PM,48,-122,1,0,1
26325,58thStGreenway22ndAve,03/01/2017 09:00:00 PM,48,-122,0,0,0
26326,58thStGreenway22ndAve,03/01/2017 10:00:00 PM,48,-122,0,0,0
26327,58thStGreenway22ndAve,03/01/2017 11:00:00 PM,48,-122,0,0,0
26328,58thStGreenway22ndAve,03/02/2017 12:00:00 AM,48,-122,0,0,0
26329,58thStGreenway22ndAve,03/02/2017 01:00:00 AM,48,-122,1,0,1
26330,58thStGreenway22ndAve,03/02/2017 02:00:00 AM,48,-122,0,0,0
26331,58thStGreenway22ndAve,03/02/2017 03:00:00 AM,48,-122,0,0,0
26332,58thStGreenway22ndAve,03/02/2017 04:00:00 AM,48,-122,0,0,0
26333,58thStGreenway22ndAve,03/02/2017 05:00:00 AM,48,-122,1,0,1
26334,58thStGreenway22ndAve,03/02/2017 06:00:00 AM,48,-122,0,0,0
26335,58thStGreenway22ndAve,03/02/2017 07:00:00 AM,48,-122,1,0,1
26336,58thStGreenway22ndAve,03/02/2017 08:00:00 AM,48,-122,1,0,1
26337,58thStGreenway22ndAve,03/02/2017 09:00:00 AM,48,-122,1,0,1
26338,58thStGreenway22ndAve,03/02/2017 10:00:00 AM,48,-122,1,0,1
26339,58thStGreenway22ndAve,03/02/2017 11:00:00 AM,48,-122,1,0,1
26340,58thStGreenway22ndAve,03/02/2017 12:00:00 PM,48,-122,1,1,2
26341,58thStGreenway22ndAve,03/02/2017 01:00:00 PM,48,-122,2,0,2
26342,58thStGreenway22ndAve,03/02/2017 02:00:00 PM,48,-122,1,0,1
26343,58thStGreenway22ndAve,03/02/2017 03:00:00 PM,48,-122,0,0,0
26344,58thStGreenway22ndAve,03/02/2017 04:00:00 PM,48,-122,2,0,2
26345,58thStGreenway22ndAve,03/02/2017 05:00:00 PM,48,-122,2,0,2
26346,58thStGreenway22ndAve,03/02/2017 06:00:00 PM,48,-122,1,0,1
26347,58thStGreenway22ndAve,03/02/2017 07:00:00 PM,48,-122,0,0,0
26348,58thStGreenway22ndAve,03/02/2017 08:00:00 PM,48,-122,0,0,0
26349,58thStGreenway22ndAve,03/02/2017 09:00:00 PM,48,-122,0,0,0
26350,58thStGreenway22ndAve,03/02/2017 10:00:00 PM,48,-122,0,0,0
26351,58thStGreenway22ndAve,03/02/2017 11:00:00 PM,48,-122,0,0,0
26352,58thStGreenway22ndAve,03/03/2017 12:00:00 AM,48,-122,0,0,0
26353,58thStGreenway22ndAve,03/03/2017 01:00:00 AM,48,-122,0,0,0
26354,58thStGreenway22ndAve,03/03/2017 02:00:00 AM,48,-122,0,0,0
26355,58thStGreenway22ndAve,03/03/2017 03:00:00 AM,48,-122,0,0,0
26356,58thStGreenway22ndAve,03/03/2017 04:00:00 AM,48,-122,0,0,0
26357,58thStGreenway22ndAve,03/03/2017 05:00:00 AM,48,-122,0,0,0
26358,58thStGreenway22ndAve,03/03/2017 06:00:00 AM,48,-122,0,0,0
26359,58thStGreenway22ndAve,03/03/2017 07:00:00 AM,48,-122,1,0,1
26360,58thStGreenway22ndAve,03/03/2017 08:00:00 AM,48,-122,1,1,2
26361,58thStGreenway22ndAve,03/03/2017 09:00:00 AM,48,-122,0,0,0
26362,58thStGreenway22ndAve,03/03/2017 10:00:00 AM,48,-122,0,0,0
26363,58thStGreenway22ndAve,03/03/2017 11:00:00 AM,48,-122,0,0,0
26364,58thStGreenway22ndAve,03/03/2017 12:00:00 PM,48,-122,1,1,2
26365,58thStGreenway22ndAve,03/03/2017 01:00:00 PM,48,-122,2,0,2
26366,58thStGreenway22ndAve,03/03/2017 02:00:00 PM,48,-122,1,0,1
26367,58thStGreenway22ndAve,03/03/2017 03:00:00 PM,48,-122,1,0,1
26368,58thStGreenway22ndAve,03/03/2017 04:00:00 PM,48,-122,0,0,0
26369,58thStGreenway22ndAve,03/03/2017 05:00:00 PM,48,-122,3,0,3
26370,58thStGreenway22ndAve,03/03/2017 06:00:00 PM,48,-122,1,1,2
26371,58thStGreenway22ndAve,03/03/2017 07:00:00 PM,48,-122,0,0,0
26372,58thStGreenway22ndAve,03/03/2017 08:00:00 PM,48,-122,1,0,1
26373,58thStGreenway22ndAve,03/03/2017 09:00:00 PM,48,-122,1,0,1
26374,58thStGreenway22ndAve,03/03/2017 10:00:00 PM,48,-122,1,0,1
26375,58thStGreenway22ndAve,03/03/2017 11:00:00 PM,48,-122,0,0,0
26376,58thStGreenway22ndAve,03/04/2017 12:00:00 AM,48,-122,0,0,0
26377,58thStGreenway22ndAve,03/04/2017 01:00:00 AM,48,-122,0,0,0
26378,58thStGreenway22ndAve,03/04/2017 02:00:00 AM,48,-122,0,0,0
26379,58thStGreenway22ndAve,03/04/2017 03:00:00 AM,48,-122,0,0,0
26380,58thStGreenway22ndAve,03/04/2017 04:00:00 AM,48,-122,0,0,0
26381,58thStGreenway22ndAve,03/04/2017 05:00:00 AM,48,-122,0,0,0
26382,58thStGreenway22ndAve,03/04/2017 06:00:00 AM,48,-122,0,0,0
26383,58thStGreenway22ndAve,03/04/2017 07:00:00 AM,48,-122,0,0,0
26384,58thStGreenway22ndAve,03/04/2017 08:00:00 AM,48,-122,0,0,0
26385,58thStGreenway22ndAve,03/04/2017 09:00:00 AM,48,-122,2,0,2
26386,58thStGreenway22ndAve,03/04/2017 10:00:00 AM,48,-122,0,0,0
26387,58thStGreenway22ndAve,03/04/2017 11:00:00 AM,48,-122,5,0,5
26388,58thStGreenway22ndAve,03/04/2017 12:00:00 PM,48,-122,1,0,1
26389,58thStGreenway22ndAve,03/04/2017 01:00:00 PM,48,-122,1,0,1
26390,58thStGreenway22ndAve,03/04/2017 02:00:00 PM,48,-122,5,0,5
26391,58thStGreenway22ndAve,03/04/2017 03:00:00 PM,48,-122,1,0,1
26392,58thStGreenway22ndAve,03/04/2017 04:00:00 PM,48,-122,2,0,2
26393,58thStGreenway22ndAve,03/04/2017 05:00:00 PM,48,-122,1,0,1
26394,58thStGreenway22ndAve,03/04/2017 06:00:00 PM,48,-122,1,0,1
26395,58thStGreenway22ndAve,03/04/2017 07:00:00 PM,48,-122,3,1,4
26396,58thStGreenway22ndAve,03/04/2017 08:00:00 PM,48,-122,0,2,2
26397,58thStGreenway22ndAve,03/04/2017 09:00:00 PM,48,-122,2,0,2
26398,58thStGreenway22ndAve,03/04/2017 10:00:00 PM,48,-122,0,0,0
26399,58thStGreenway22ndAve,03/04/2017 11:00:00 PM,48,-122,0,0,0
26400,58thStGreenway22ndAve,03/05/2017 12:00:00 AM,48,-122,0,0,0
26401,58thStGreenway22ndAve,03/05/2017 01:00:00 AM,48,-122,0,0,0
26402,58thStGreenway22ndAve,03/05/2017 02:00:00 AM,48,-122,1,0,1
26403,58thStGreenway22ndAve,03/05/2017 03:00:00 AM,48,-122,0,0,0
26404,58thStGreenway22ndAve,03/05/2017 04:00:00 AM,48,-122,0,0,0
26405,58thStGreenway22ndAve,03/05/2017 05:00:00 AM,48,-122,0,0,0
26406,58thStGreenway22ndAve,03/05/2017 06:00:00 AM,48,-122,0,0,0
26407,58thStGreenway22ndAve,03/05/2017 07:00:00 AM,48,-122,1,0,1
26408,58thStGreenway22ndAve,03/05/2017 08:00:00 AM,48,-122,0,0,0
26409,58thStGreenway22ndAve,03/05/2017 09:00:00 AM,48,-122,1,0,1
26410,58thStGreenway22ndAve,03/05/2017 10:00:00 AM,48,-122,2,0,2
26411,58thStGreenway22ndAve,03/05/2017 11:00:00 AM,48,-122,2,0,2
26412,58thStGreenway22ndAve,03/05/2017 12:00:00 PM,48,-122,2,0,2
26413,58thStGreenway22ndAve,03/05/2017 01:00:00 PM,48,-122,2,0,2
26414,58thStGreenway22ndAve,03/05/2017 02:00:00 PM,48,-122,4,0,4
26415,58thStGreenway22ndAve,03/05/2017 03:00:00 PM,48,-122,1,0,1
26416,58thStGreenway22ndAve,03/05/2017 04:00:00 PM,48,-122,0,0,0
26417,58thStGreenway22ndAve,03/05/2017 05:00:00 PM,48,-122,1,0,1
26418,58thStGreenway22ndAve,03/05/2017 06:00:00 PM,48,-122,2,0,2
26419,58thStGreenway22ndAve,03/05/2017 07:00:00 PM,48,-122,3,0,3
26420,58thStGreenway22ndAve,03/05/2017 08:00:00 PM,48,-122,0,0,0
26421,58thStGreenway22ndAve,03/05/2017 09:00:00 PM,48,-122,1,0,1
26422,58thStGreenway22ndAve,03/05/2017 10:00:00 PM,48,-122,0,0,0
26423,58thStGreenway22ndAve,03/05/2017 11:00:00 PM,48,-122,1,0,1
26424,58thStGreenway22ndAve,03/06/2017 12:00:00 AM,48,-122,0,0,0
26425,58thStGreenway22ndAve,03/06/2017 01:00:00 AM,48,-122,0,0,0
26426,58thStGreenway22ndAve,03/06/2017 02:00:00 AM,48,-122,0,0,0
26427,58thStGreenway22ndAve,03/06/2017 03:00:00 AM,48,-122,0,0,0
26428,58thStGreenway22ndAve,03/06/2017 04:00:00 AM,48,-122,0,0,0
26429,58thStGreenway22ndAve,03/06/2017 05:00:00 AM,48,-122,0,0,0
26430,58thStGreenway22ndAve,03/06/2017 06:00:00 AM,48,-122,1,0,1
26431,58thStGreenway22ndAve,03/06/2017 07:00:00 AM,48,-122,2,1,3
26432,58thStGreenway22ndAve,03/06/2017 08:00:00 AM,48,-122,3,0,3
26433,58thStGreenway22ndAve,03/06/2017 09:00:00 AM,48,-122,0,1,1
26434,58thStGreenway22ndAve,03/06/2017 10:00:00 AM,48,-122,0,0,0
26435,58thStGreenway22ndAve,03/06/2017 11:00:00 AM,48,-122,2,0,2
26436,58thStGreenway22ndAve,03/06/2017 12:00:00 PM,48,-122,1,0,1
26437,58thStGreenway22ndAve,03/06/2017 01:00:00 PM,48,-122,4,0,4
26438,58thStGreenway22ndAve,03/06/2017 02:00:00 PM,48,-122,8,1,9
26439,58thStGreenway22ndAve,03/06/2017 03:00:00 PM,48,-122,5,2,7
26440,58thStGreenway22ndAve,03/06/2017 04:00:00 PM,48,-122,3,7,10
26441,58thStGreenway22ndAve,03/06/2017 05:00:00 PM,48,-122,1,0,1
26442,58thStGreenway22ndAve,03/06/2017 06:00:00 PM,48,-122,2,0,2
26443,58thStGreenway22ndAve,03/06/2017 07:00:00 PM,48,-122,2,0,2
26444,58thStGreenway22ndAve,03/06/2017 08:00:00 PM,48,-122,0,0,0
26445,58thStGreenway22ndAve,03/06/2017 09:00:00 PM,48,-122,0,0,0
26446,58thStGreenway22ndAve,03/06/2017 10:00:00 PM,48,-122,1,0,1
26447,58thStGreenway22ndAve,03/06/2017 11:00:00 PM,48,-122,0,0,0
26448,58thStGreenway22ndAve,03/07/2017 12:00:00 AM,48,-122,0,0,0
26449,58thStGreenway22ndAve,03/07/2017 01:00:00 AM,48,-122,0,0,0
26450,58thStGreenway22ndAve,03/07/2017 02:00:00 AM,48,-122,0,0,0
26451,58thStGreenway22ndAve,03/07/2017 03:00:00 AM,48,-122,0,0,0
26452,58thStGreenway22ndAve,03/07/2017 04:00:00 AM,48,-122,0,0,0
26453,58thStGreenway22ndAve,03/07/2017 05:00:00 AM,48,-122,0,0,0
26454,58thStGreenway22ndAve,03/07/2017 06:00:00 AM,48,-122,0,0,0
26455,58thStGreenway22ndAve,03/07/2017 07:00:00 AM,48,-122,0,1,1
26456,58thStGreenway22ndAve,03/07/2017 08:00:00 AM,48,-122,1,0,1
26457,58thStGreenway22ndAve,03/07/2017 09:00:00 AM,48,-122,2,1,3
26458,58thStGreenway22ndAve,03/07/2017 10:00:00 AM,48,-122,1,0,1
26459,58thStGreenway22ndAve,03/07/2017 11:00:00 AM,48,-122,1,1,2
26460,58thStGreenway22ndAve,03/07/2017 12:00:00 PM,48,-122,0,4,4
26461,58thStGreenway22ndAve,03/07/2017 01:00:00 PM,48,-122,2,0,2
26462,58thStGreenway22ndAve,03/07/2017 02:00:00 PM,48,-122,1,0,1
26463,58thStGreenway22ndAve,03/07/2017 03:00:00 PM,48,-122,0,2,2
26464,58thStGreenway22ndAve,03/07/2017 04:00:00 PM,48,-122,0,2,2
26465,58thStGreenway22ndAve,03/07/2017 05:00:00 PM,48,-122,5,3,8
26466,58thStGreenway22ndAve,03/07/2017 06:00:00 PM,48,-122,1,2,3
26467,58thStGreenway22ndAve,03/07/2017 07:00:00 PM,48,-122,0,5,5
26468,58thStGreenway22ndAve,03/07/2017 08:00:00 PM,48,-122,2,0,2
26469,58thStGreenway22ndAve,03/07/2017 09:00:00 PM,48,-122,1,5,6
26470,58thStGreenway22ndAve,03/07/2017 10:00:00 PM,48,-122,1,7,8
26471,58thStGreenway22ndAve,03/07/2017 11:00:00 PM,48,-122,0,0,0
26472,58thStGreenway22ndAve,03/08/2017 12:00:00 AM,48,-122,0,1,1
26473,58thStGreenway22ndAve,03/08/2017 01:00:00 AM,48,-122,0,0,0
26474,58thStGreenway22ndAve,03/08/2017 02:00:00 AM,48,-122,0,2,2
26475,58thStGreenway22ndAve,03/08/2017 03:00:00 AM,48,-122,0,0,0
26476,58thStGreenway22ndAve,03/08/2017 04:00:00 AM,48,-122,0,1,1
26477,58thStGreenway22ndAve,03/08/2017 05:00:00 AM,48,-122,0,2,2
26478,58thStGreenway22ndAve,03/08/2017 06:00:00 AM,48,-122,0,2,2
26479,58thStGreenway22ndAve,03/08/2017 07:00:00 AM,48,-122,0,1,1
26480,58thStGreenway22ndAve,03/08/2017 08:00:00 AM,48,-122,1,3,4
26481,58thStGreenway22ndAve,03/08/2017 09:00:00 AM,48,-122,0,8,8
26482,58thStGreenway22ndAve,03/08/2017 10:00:00 AM,48,-122,1,4,5
26483,58thStGreenway22ndAve,03/08/2017 11:00:00 AM,48,-122,1,4,5
26484,58thStGreenway22ndAve,03/08/2017 12:00:00 PM,48,-122,3,7,10
26485,58thStGreenway22ndAve,03/08/2017 01:00:00 PM,48,-122,1,1,2
26486,58thStGreenway22ndAve,03/08/2017 02:00:00 PM,48,-122,1,2,3
26487,58thStGreenway22ndAve,03/08/2017 03:00:00 PM,48,-122,0,5,5
26488,58thStGreenway22ndAve,03/08/2017 04:00:00 PM,48,-122,2,10,12
26489,58thStGreenway22ndAve,03/08/2017 05:00:00 PM,48,-122,3,9,12
26490,58thStGreenway22ndAve,03/08/2017 06:00:00 PM,48,-122,3,6,9
26491,58thStGreenway22ndAve,03/08/2017 07:00:00 PM,48,-122,3,8,11
26492,58thStGreenway22ndAve,03/08/2017 08:00:00 PM,48,-122,0,1,1
26493,58thStGreenway22ndAve,03/08/2017 09:00:00 PM,48,-122,0,4,4
26494,58thStGreenway22ndAve,03/08/2017 10:00:00 PM,48,-122,0,4,4
26495,58thStGreenway22ndAve,03/08/2017 11:00:00 PM,48,-122,1,1,2
26496,58thStGreenway22ndAve,03/09/2017 12:00:00 AM,48,-122,0,0,0
26497,58thStGreenway22ndAve,03/09/2017 01:00:00 AM,48,-122,0,0,0
26498,58thStGreenway22ndAve,03/09/2017 02:00:00 AM,48,-122,0,0,0
26499,58thStGreenway22ndAve,03/09/2017 03:00:00 AM,48,-122,0,0,0
26500,58thStGreenway22ndAve,03/09/2017 04:00:00 AM,48,-122,0,0,0
26501,58thStGreenway22ndAve,03/09/2017 05:00:00 AM,48,-122,0,0,0
26502,58thStGreenway22ndAve,03/09/2017 06:00:00 AM,48,-122,0,1,1
26503,58thStGreenway22ndAve,03/09/2017 07:00:00 AM,48,-122,1,2,3
26504,58thStGreenway22ndAve,03/09/2017 08:00:00 AM,48,-122,5,0,5
26505,58thStGreenway22ndAve,03/09/2017 09:00:00 AM,48,-122,1,0,1
26506,58thStGreenway22ndAve,03/09/2017 10:00:00 AM,48,-122,0,0,0
26507,58thStGreenway22ndAve,03/09/2017 11:00:00 AM,48,-122,2,1,3
26508,58thStGreenway22ndAve,03/09/2017 12:00:00 PM,48,-122,1,1,2
26509,58thStGreenway22ndAve,03/09/2017 01:00:00 PM,48,-122,1,0,1
26510,58thStGreenway22ndAve,03/09/2017 02:00:00 PM,48,-122,3,2,5
26511,58thStGreenway22ndAve,03/09/2017 03:00:00 PM,48,-122,0,5,5
26512,58thStGreenway22ndAve,03/09/2017 04:00:00 PM,48,-122,0,3,3
26513,58thStGreenway22ndAve,03/09/2017 05:00:00 PM,48,-122,0,5,5
26514,58thStGreenway22ndAve,03/09/2017 06:00:00 PM,48,-122,0,2,2
26515,58thStGreenway22ndAve,03/09/2017 07:00:00 PM,48,-122,0,5,5
26516,58thStGreenway22ndAve,03/09/2017 08:00:00 PM,48,-122,1,2,3
26517,58thStGreenway22ndAve,03/09/2017 09:00:00 PM,48,-122,1,2,3
26518,58thStGreenway22ndAve,03/09/2017 10:00:00 PM,48,-122,0,3,3
26519,58thStGreenway22ndAve,03/09/2017 11:00:00 PM,48,-122,1,1,2
26520,58thStGreenway22ndAve,03/10/2017 12:00:00 AM,48,-122,0,1,1
26521,58thStGreenway22ndAve,03/10/2017 01:00:00 AM,48,-122,0,0,0
26522,58thStGreenway22ndAve,03/10/2017 02:00:00 AM,48,-122,0,0,0
26523,58thStGreenway22ndAve,03/10/2017 03:00:00 AM,48,-122,0,1,1
26524,58thStGreenway22ndAve,03/10/2017 04:00:00 AM,48,-122,0,0,0
26525,58thStGreenway22ndAve,03/10/2017 05:00:00 AM,48,-122,0,1,1
26526,58thStGreenway22ndAve,03/10/2017 06:00:00 AM,48,-122,0,2,2
26527,58thStGreenway22ndAve,03/10/2017 07:00:00 AM,48,-122,1,2,3
26528,58thStGreenway22ndAve,03/10/2017 08:00:00 AM,48,-122,0,4,4
26529,58thStGreenway22ndAve,03/10/2017 09:00:00 AM,48,-122,1,5,6
26530,58thStGreenway22ndAve,03/10/2017 10:00:00 AM,48,-122,0,0,0
26531,58thStGreenway22ndAve,03/10/2017 11:00:00 AM,48,-122,3,3,6
26532,58thStGreenway22ndAve,03/10/2017 12:00:00 PM,48,-122,0,9,9
26533,58thStGreenway22ndAve,03/10/2017 01:00:00 PM,48,-122,4,6,10
26534,58thStGreenway22ndAve,03/10/2017 02:00:00 PM,48,-122,1,4,5
26535,58thStGreenway22ndAve,03/10/2017 03:00:00 PM,48,-122,3,3,6
26536,58thStGreenway22ndAve,03/10/2017 04:00:00 PM,48,-122,0,5,5
26537,58thStGreenway22ndAve,03/10/2017 05:00:00 PM,48,-122,1,4,5
26538,58thStGreenway22ndAve,03/10/2017 06:00:00 PM,48,-122,3,2,5
26539,58thStGreenway22ndAve,03/10/2017 07:00:00 PM,48,-122,0,6,6
26540,58thStGreenway22ndAve,03/10/2017 08:00:00 PM,48,-122,2,4,6
26541,58thStGreenway22ndAve,03/10/2017 09:00:00 PM,48,-122,0,3,3
26542,58thStGreenway22ndAve,03/10/2017 10:00:00 PM,48,-122,2,4,6
26543,58thStGreenway22ndAve,03/10/2017 11:00:00 PM,48,-122,0,4,4
26544,58thStGreenway22ndAve,03/11/2017 12:00:00 AM,48,-122,0,1,1
26545,58thStGreenway22ndAve,03/11/2017 01:00:00 AM,48,-122,0,1,1
26546,58thStGreenway22ndAve,03/11/2017 02:00:00 AM,48,-122,0,0,0
26547,58thStGreenway22ndAve,03/11/2017 03:00:00 AM,48,-122,0,0,0
26548,58thStGreenway22ndAve,03/11/2017 04:00:00 AM,48,-122,0,0,0
26549,58thStGreenway22ndAve,03/11/2017 05:00:00 AM,48,-122,0,0,0
26550,58thStGreenway22ndAve,03/11/2017 06:00:00 AM,48,-122,0,2,2
26551,58thStGreenway22ndAve,03/11/2017 07:00:00 AM,48,-122,2,0,2
26552,58thStGreenway22ndAve,03/11/2017 08:00:00 AM,48,-122,0,2,2
26553,58thStGreenway22ndAve,03/11/2017 09:00:00 AM,48,-122,2,3,5
26554,58thStGreenway22ndAve,03/11/2017 10:00:00 AM,48,-122,1,2,3
26555,58thStGreenway22ndAve,03/11/2017 11:00:00 AM,48,-122,1,10,11
26556,58thStGreenway22ndAve,03/11/2017 12:00:00 PM,48,-122,0,8,8
26557,58thStGreenway22ndAve,03/11/2017 01:00:00 PM,48,-122,4,2,6
26558,58thStGreenway22ndAve,03/11/2017 02:00:00 PM,48,-122,2,1,3
26559,58thStGreenway22ndAve,03/11/2017 03:00:00 PM,48,-122,3,0,3
26560,58thStGreenway22ndAve,03/11/2017 04:00:00 PM,48,-122,1,0,1
26561,58thStGreenway22ndAve,03/11/2017 05:00:00 PM,48,-122,1,1,2
26562,58thStGreenway22ndAve,03/11/2017 06:00:00 PM,48,-122,6,2,8
26563,58thStGreenway22ndAve,03/11/2017 07:00:00 PM,48,-122,0,5,5
26564,58thStGreenway22ndAve,03/11/2017 08:00:00 PM,48,-122,2,5,7
26565,58thStGreenway22ndAve,03/11/2017 09:00:00 PM,48,-122,1,1,2
26566,58thStGreenway22ndAve,03/11/2017 10:00:00 PM,48,-122,3,0,3
26567,58thStGreenway22ndAve,03/11/2017 11:00:00 PM,48,-122,0,0,0
26568,58thStGreenway22ndAve,03/12/2017 12:00:00 AM,48,-122,0,0,0
26569,58thStGreenway22ndAve,03/12/2017 01:00:00 AM,48,-122,0,0,0
26570,58thStGreenway22ndAve,03/12/2017 02:00:00 AM,48,-122,0,0,0
26571,58thStGreenway22ndAve,03/12/2017 03:00:00 AM,48,-122,0,0,0
26572,58thStGreenway22ndAve,03/12/2017 04:00:00 AM,48,-122,0,0,0
26573,58thStGreenway22ndAve,03/12/2017 05:00:00 AM,48,-122,0,0,0
26574,58thStGreenway22ndAve,03/12/2017 06:00:00 AM,48,-122,0,0,0
26575,58thStGreenway22ndAve,03/12/2017 07:00:00 AM,48,-122,0,0,0
26576,58thStGreenway22ndAve,03/12/2017 08:00:00 AM,48,-122,1,0,1
26577,58thStGreenway22ndAve,03/12/2017 09:00:00 AM,48,-122,0,0,0
26578,58thStGreenway22ndAve,03/12/2017 10:00:00 AM,48,-122,2,0,2
26579,58thStGreenway22ndAve,03/12/2017 11:00:00 AM,48,-122,0,0,0
26580,58thStGreenway22ndAve,03/12/2017 12:00:00 PM,48,-122,0,0,0
26581,58thStGreenway22ndAve,03/12/2017 01:00:00 PM,48,-122,3,0,3
26582,58thStGreenway22ndAve,03/12/2017 02:00:00 PM,48,-122,2,0,2
26583,58thStGreenway22ndAve,03/12/2017 03:00:00 PM,48,-122,1,0,1
26584,58thStGreenway22ndAve,03/12/2017 04:00:00 PM,48,-122,4,0,4
26585,58thStGreenway22ndAve,03/12/2017 05:00:00 PM,48,-122,1,1,2
26586,58thStGreenway22ndAve,03/12/2017 06:00:00 PM,48,-122,5,0,5
26587,58thStGreenway22ndAve,03/12/2017 07:00:00 PM,48,-122,0,1,1
26588,58thStGreenway22ndAve,03/12/2017 08:00:00 PM,48,-122,2,0,2
26589,58thStGreenway22ndAve,03/12/2017 09:00:00 PM,48,-122,0,0,0
26590,58thStGreenway22ndAve,03/12/2017 10:00:00 PM,48,-122,1,0,1
26591,58thStGreenway22ndAve,03/12/2017 11:00:00 PM,48,-122,0,0,0
26592,58thStGreenway22ndAve,03/13/2017 12:00:00 AM,48,-122,1,0,1
26593,58thStGreenway22ndAve,03/13/2017 01:00:00 AM,48,-122,0,0,0
26594,58thStGreenway22ndAve,03/13/2017 02:00:00 AM,48,-122,0,0,0
26595,58thStGreenway22ndAve,03/13/2017 03:00:00 AM,48,-122,0,0,0
26596,58thStGreenway22ndAve,03/13/2017 04:00:00 AM,48,-122,0,0,0
26597,58thStGreenway22ndAve,03/13/2017 05:00:00 AM,48,-122,0,1,1
26598,58thStGreenway22ndAve,03/13/2017 06:00:00 AM,48,-122,2,2,4
26599,58thStGreenway22ndAve,03/13/2017 07:00:00 AM,48,-122,1,2,3
26600,58thStGreenway22ndAve,03/13/2017 08:00:00 AM,48,-122,3,2,5
26601,58thStGreenway22ndAve,03/13/2017 09:00:00 AM,48,-122,1,1,2
26602,58thStGreenway22ndAve,03/13/2017 10:00:00 AM,48,-122,6,1,7
26603,58thStGreenway22ndAve,03/13/2017 11:00:00 AM,48,-122,1,0,1
26604,58thStGreenway22ndAve,03/13/2017 12:00:00 PM,48,-122,0,0,0
26605,58thStGreenway22ndAve,03/13/2017 01:00:00 PM,48,-122,2,0,2
26606,58thStGreenway22ndAve,03/13/2017 02:00:00 PM,48,-122,2,3,5
26607,58thStGreenway22ndAve,03/13/2017 03:00:00 PM,48,-122,1,8,9
26608,58thStGreenway22ndAve,03/13/2017 04:00:00 PM,48,-122,1,2,3
26609,58thStGreenway22ndAve,03/13/2017 05:00:00 PM,48,-122,2,5,7
26610,58thStGreenway22ndAve,03/13/2017 06:00:00 PM,48,-122,0,10,10
26611,58thStGreenway22ndAve,03/13/2017 07:00:00 PM,48,-122,0,4,4
26612,58thStGreenway22ndAve,03/13/2017 08:00:00 PM,48,-122,0,3,3
26613,58thStGreenway22ndAve,03/13/2017 09:00:00 PM,48,-122,1,5,6
26614,58thStGreenway22ndAve,03/13/2017 10:00:00 PM,48,-122,0,1,1
26615,58thStGreenway22ndAve,03/13/2017 11:00:00 PM,48,-122,0,1,1
26616,58thStGreenway22ndAve,03/14/2017 12:00:00 AM,48,-122,0,0,0
26617,58thStGreenway22ndAve,03/14/2017 01:00:00 AM,48,-122,0,2,2
26618,58thStGreenway22ndAve,03/14/2017 02:00:00 AM,48,-122,0,0,0
26619,58thStGreenway22ndAve,03/14/2017 03:00:00 AM,48,-122,0,0,0
26620,58thStGreenway22ndAve,03/14/2017 04:00:00 AM,48,-122,0,1,1
26621,58thStGreenway22ndAve,03/14/2017 05:00:00 AM,48,-122,0,0,0
26622,58thStGreenway22ndAve,03/14/2017 06:00:00 AM,48,-122,0,1,1
26623,58thStGreenway22ndAve,03/14/2017 07:00:00 AM,48,-122,1,1,2
26624,58thStGreenway22ndAve,03/14/2017 08:00:00 AM,48,-122,3,2,5
26625,58thStGreenway22ndAve,03/14/2017 09:00:00 AM,48,-122,1,3,4
26626,58thStGreenway22ndAve,03/14/2017 10:00:00 AM,48,-122,0,1,1
26627,58thStGreenway22ndAve,03/14/2017 11:00:00 AM,48,-122,0,6,6
26628,58thStGreenway22ndAve,03/14/2017 12:00:00 PM,48,-122,1,3,4
26629,58thStGreenway22ndAve,03/14/2017 01:00:00 PM,48,-122,0,7,7
26630,58thStGreenway22ndAve,03/14/2017 02:00:00 PM,48,-122,0,6,6
26631,58thStGreenway22ndAve,03/14/2017 03:00:00 PM,48,-122,1,8,9
26632,58thStGreenway22ndAve,03/14/2017 04:00:00 PM,48,-122,2,2,4
26633,58thStGreenway22ndAve,03/14/2017 05:00:00 PM,48,-122,2,2,4
26634,58thStGreenway22ndAve,03/14/2017 06:00:00 PM,48,-122,1,2,3
26635,58thStGreenway22ndAve,03/14/2017 07:00:00 PM,48,-122,1,3,4
26636,58thStGreenway22ndAve,03/14/2017 08:00:00 PM,48,-122,0,5,5
26637,58thStGreenway22ndAve,03/14/2017 09:00:00 PM,48,-122,1,1,2
26638,58thStGreenway22ndAve,03/14/2017 10:00:00 PM,48,-122,1,0,1
26639,58thStGreenway22ndAve,03/14/2017 11:00:00 PM,48,-122,0,2,2
26640,58thStGreenway22ndAve,03/15/2017 12:00:00 AM,48,-122,0,1,1
26641,58thStGreenway22ndAve,03/15/2017 01:00:00 AM,48,-122,0,1,1
26642,58thStGreenway22ndAve,03/15/2017 02:00:00 AM,48,-122,0,0,0
26643,58thStGreenway22ndAve,03/15/2017 03:00:00 AM,48,-122,0,0,0
26644,58thStGreenway22ndAve,03/15/2017 04:00:00 AM,48,-122,0,0,0
26645,58thStGreenway22ndAve,03/15/2017 05:00:00 AM,48,-122,0,1,1
26646,58thStGreenway22ndAve,03/15/2017 06:00:00 AM,48,-122,0,0,0
26647,58thStGreenway22ndAve,03/15/2017 07:00:00 AM,48,-122,0,1,1
26648,58thStGreenway22ndAve,03/15/2017 08:00:00 AM,48,-122,0,1,1
26649,58thStGreenway22ndAve,03/15/2017 09:00:00 AM,48,-122,2,1,3
26650,58thStGreenway22ndAve,03/15/2017 10:00:00 AM,48,-122,0,4,4
26651,58thStGreenway22ndAve,03/15/2017 11:00:00 AM,48,-122,0,7,7
26652,58thStGreenway22ndAve,03/15/2017 12:00:00 PM,48,-122,2,0,2
26653,58thStGreenway22ndAve,03/15/2017 01:00:00 PM,48,-122,1,6,7
26654,58thStGreenway22ndAve,03/15/2017 02:00:00 PM,48,-122,1,4,5
26655,58thStGreenway22ndAve,03/15/2017 03:00:00 PM,48,-122,0,3,3
26656,58thStGreenway22ndAve,03/15/2017 04:00:00 PM,48,-122,1,4,5
26657,58thStGreenway22ndAve,03/15/2017 05:00:00 PM,48,-122,1,6,7
26658,58thStGreenway22ndAve,03/15/2017 06:00:00 PM,48,-122,1,6,7
26659,58thStGreenway22ndAve,03/15/2017 07:00:00 PM,48,-122,2,3,5
26660,58thStGreenway22ndAve,03/15/2017 08:00:00 PM,48,-122,0,3,3
26661,58thStGreenway22ndAve,03/15/2017 09:00:00 PM,48,-122,0,4,4
26662,58thStGreenway22ndAve,03/15/2017 10:00:00 PM,48,-122,0,0,0
26663,58thStGreenway22ndAve,03/15/2017 11:00:00 PM,48,-122,0,0,0
26664,58thStGreenway22ndAve,03/16/2017 12:00:00 AM,48,-122,0,0,0
26665,58thStGreenway22ndAve,03/16/2017 01:00:00 AM,48,-122,0,0,0
26666,58thStGreenway22ndAve,03/16/2017 02:00:00 AM,48,-122,0,0,0
26667,58thStGreenway22ndAve,03/16/2017 03:00:00 AM,48,-122,0,1,1
26668,58thStGreenway22ndAve,03/16/2017 04:00:00 AM,48,-122,0,1,1
26669,58thStGreenway22ndAve,03/16/2017 05:00:00 AM,48,-122,0,0,0
26670,58thStGreenway22ndAve,03/16/2017 06:00:00 AM,48,-122,0,0,0
26671,58thStGreenway22ndAve,03/16/2017 07:00:00 AM,48,-122,1,8,9
26672,58thStGreenway22ndAve,03/16/2017 08:00:00 AM,48,-122,1,6,7
26673,58thStGreenway22ndAve,03/16/2017 09:00:00 AM,48,-122,3,1,4
26674,58thStGreenway22ndAve,03/16/2017 10:00:00 AM,48,-122,2,6,8
26675,58thStGreenway22ndAve,03/16/2017 11:00:00 AM,48,-122,2,3,5
26676,58thStGreenway22ndAve,03/16/2017 12:00:00 PM,48,-122,1,4,5
26677,58thStGreenway22ndAve,03/16/2017 01:00:00 PM,48,-122,0,2,2
26678,58thStGreenway22ndAve,03/16/2017 02:00:00 PM,48,-122,3,5,8
26679,58thStGreenway22ndAve,03/16/2017 03:00:00 PM,48,-122,1,5,6
26680,58thStGreenway22ndAve,03/16/2017 04:00:00 PM,48,-122,1,1,2
26681,58thStGreenway22ndAve,03/16/2017 05:00:00 PM,48,-122,1,4,5
26682,58thStGreenway22ndAve,03/16/2017 06:00:00 PM,48,-122,1,4,5
26683,58thStGreenway22ndAve,03/16/2017 07:00:00 PM,48,-122,3,3,6
26684,58thStGreenway22ndAve,03/16/2017 08:00:00 PM,48,-122,1,5,6
26685,58thStGreenway22ndAve,03/16/2017 09:00:00 PM,48,-122,2,1,3
26686,58thStGreenway22ndAve,03/16/2017 10:00:00 PM,48,-122,0,2,2
26687,58thStGreenway22ndAve,03/16/2017 11:00:00 PM,48,-122,1,2,3
26688,58thStGreenway22ndAve,03/17/2017 12:00:00 AM,48,-122,1,1,2
26689,58thStGreenway22ndAve,03/17/2017 01:00:00 AM,48,-122,0,0,0
26690,58thStGreenway22ndAve,03/17/2017 02:00:00 AM,48,-122,0,0,0
26691,58thStGreenway22ndAve,03/17/2017 03:00:00 AM,48,-122,0,0,0
26692,58thStGreenway22ndAve,03/17/2017 04:00:00 AM,48,-122,0,1,1
26693,58thStGreenway22ndAve,03/17/2017 05:00:00 AM,48,-122,0,2,2
26694,58thStGreenway22ndAve,03/17/2017 06:00:00 AM,48,-122,0,1,1
26695,58thStGreenway22ndAve,03/17/2017 07:00:00 AM,48,-122,3,1,4
26696,58thStGreenway22ndAve,03/17/2017 08:00:00 AM,48,-122,1,2,3
26697,58thStGreenway22ndAve,03/17/2017 09:00:00 AM,48,-122,2,1,3
26698,58thStGreenway22ndAve,03/17/2017 10:00:00 AM,48,-122,0,0,0
26699,58thStGreenway22ndAve,03/17/2017 11:00:00 AM,48,-122,2,1,3
26700,58thStGreenway22ndAve,03/17/2017 12:00:00 PM,48,-122,1,3,4
26701,58thStGreenway22ndAve,03/17/2017 01:00:00 PM,48,-122,0,5,5
26702,58thStGreenway22ndAve,03/17/2017 02:00:00 PM,48,-122,0,4,4
26703,58thStGreenway22ndAve,03/17/2017 03:00:00 PM,48,-122,2,3,5
26704,58thStGreenway22ndAve,03/17/2017 04:00:00 PM,48,-122,1,2,3
26705,58thStGreenway22ndAve,03/17/2017 05:00:00 PM,48,-122,0,2,2
26706,58thStGreenway22ndAve,03/17/2017 06:00:00 PM,48,-122,1,4,5
26707,58thStGreenway22ndAve,03/17/2017 07:00:00 PM,48,-122,1,2,3
26708,58thStGreenway22ndAve,03/17/2017 08:00:00 PM,48,-122,0,1,1
26709,58thStGreenway22ndAve,03/17/2017 09:00:00 PM,48,-122,0,0,0
26710,58thStGreenway22ndAve,03/17/2017 10:00:00 PM,48,-122,0,1,1
26711,58thStGreenway22ndAve,03/17/2017 11:00:00 PM,48,-122,0,1,1
26712,58thStGreenway22ndAve,03/18/2017 12:00:00 AM,48,-122,0,1,1
26713,58thStGreenway22ndAve,03/18/2017 01:00:00 AM,48,-122,0,0,0
26714,58thStGreenway22ndAve,03/18/2017 02:00:00 AM,48,-122,1,1,2
26715,58thStGreenway22ndAve,03/18/2017 03:00:00 AM,48,-122,0,0,0
26716,58thStGreenway22ndAve,03/18/2017 04:00:00 AM,48,-122,0,1,1
26717,58thStGreenway22ndAve,03/18/2017 05:00:00 AM,48,-122,0,2,2
26718,58thStGreenway22ndAve,03/18/2017 06:00:00 AM,48,-122,0,1,1
26719,58thStGreenway22ndAve,03/18/2017 07:00:00 AM,48,-122,0,0,0
26720,58thStGreenway22ndAve,03/18/2017 08:00:00 AM,48,-122,1,1,2
26721,58thStGreenway22ndAve,03/18/2017 09:00:00 AM,48,-122,0,2,2
26722,58thStGreenway22ndAve,03/18/2017 10:00:00 AM,48,-122,0,2,2
26723,58thStGreenway22ndAve,03/18/2017 11:00:00 AM,48,-122,0,1,1
26724,58thStGreenway22ndAve,03/18/2017 12:00:00 PM,48,-122,1,1,2
26725,58thStGreenway22ndAve,03/18/2017 01:00:00 PM,48,-122,2,0,2
26726,58thStGreenway22ndAve,03/18/2017 02:00:00 PM,48,-122,1,0,1
26727,58thStGreenway22ndAve,03/18/2017 03:00:00 PM,48,-122,1,4,5
26728,58thStGreenway22ndAve,03/18/2017 04:00:00 PM,48,-122,4,2,6
26729,58thStGreenway22ndAve,03/18/2017 05:00:00 PM,48,-122,2,1,3
26730,58thStGreenway22ndAve,03/18/2017 06:00:00 PM,48,-122,2,1,3
26731,58thStGreenway22ndAve,03/18/2017 07:00:00 PM,48,-122,2,1,3
26732,58thStGreenway22ndAve,03/18/2017 08:00:00 PM,48,-122,2,1,3
26733,58thStGreenway22ndAve,03/18/2017 09:00:00 PM,48,-122,2,1,3
26734,58thStGreenway22ndAve,03/18/2017 10:00:00 PM,48,-122,1,2,3
26735,58thStGreenway22ndAve,03/18/2017 11:00:00 PM,48,-122,1,2,3
26736,58thStGreenway22ndAve,03/19/2017 12:00:00 AM,48,-122,0,2,2
26737,58thStGreenway22ndAve,03/19/2017 01:00:00 AM,48,-122,0,0,0
26738,58thStGreenway22ndAve,03/19/2017 02:00:00 AM,48,-122,0,0,0
26739,58thStGreenway22ndAve,03/19/2017 03:00:00 AM,48,-122,1,0,1
26740,58thStGreenway22ndAve,03/19/2017 04:00:00 AM,48,-122,0,1,1
26741,58thStGreenway22ndAve,03/19/2017 05:00:00 AM,48,-122,0,1,1
26742,58thStGreenway22ndAve,03/19/2017 06:00:00 AM,48,-122,0,0,0
26743,58thStGreenway22ndAve,03/19/2017 07:00:00 AM,48,-122,0,1,1
26744,58thStGreenway22ndAve,03/19/2017 08:00:00 AM,48,-122,1,2,3
26745,58thStGreenway22ndAve,03/19/2017 09:00:00 AM,48,-122,2,0,2
26746,58thStGreenway22ndAve,03/19/2017 10:00:00 AM,48,-122,2,1,3
26747,58thStGreenway22ndAve,03/19/2017 11:00:00 AM,48,-122,9,0,9
26748,58thStGreenway22ndAve,03/19/2017 12:00:00 PM,48,-122,5,2,7
26749,58thStGreenway22ndAve,03/19/2017 01:00:00 PM,48,-122,5,1,6
26750,58thStGreenway22ndAve,03/19/2017 02:00:00 PM,48,-122,5,1,6
26751,58thStGreenway22ndAve,03/19/2017 03:00:00 PM,48,-122,5,0,5
26752,58thStGreenway22ndAve,03/19/2017 04:00:00 PM,48,-122,10,0,10
26753,58thStGreenway22ndAve,03/19/2017 05:00:00 PM,48,-122,3,0,3
26754,58thStGreenway22ndAve,03/19/2017 06:00:00 PM,48,-122,4,0,4
26755,58thStGreenway22ndAve,03/19/2017 07:00:00 PM,48,-122,1,0,1
26756,58thStGreenway22ndAve,03/19/2017 08:00:00 PM,48,-122,0,0,0
26757,58thStGreenway22ndAve,03/19/2017 09:00:00 PM,48,-122,1,0,1
26758,58thStGreenway22ndAve,03/19/2017 10:00:00 PM,48,-122,1,0,1
26759,58thStGreenway22ndAve,03/19/2017 11:00:00 PM,48,-122,0,0,0
26760,58thStGreenway22ndAve,03/20/2017 12:00:00 AM,48,-122,0,0,0
26761,58thStGreenway22ndAve,03/20/2017 01:00:00 AM,48,-122,0,0,0
26762,58thStGreenway22ndAve,03/20/2017 02:00:00 AM,48,-122,0,0,0
26763,58thStGreenway22ndAve,03/20/2017 03:00:00 AM,48,-122,0,0,0
26764,58thStGreenway22ndAve,03/20/2017 04:00:00 AM,48,-122,0,0,0
26765,58thStGreenway22ndAve,03/20/2017 05:00:00 AM,48,-122,0,0,0
26766,58thStGreenway22ndAve,03/20/2017 06:00:00 AM,48,-122,0,0,0
26767,58thStGreenway22ndAve,03/20/2017 07:00:00 AM,48,-122,1,0,1
26768,58thStGreenway22ndAve,03/20/2017 08:00:00 AM,48,-122,0,0,0
26769,58thStGreenway22ndAve,03/20/2017 09:00:00 AM,48,-122,2,1,3
26770,58thStGreenway22ndAve,03/20/2017 10:00:00 AM,48,-122,2,1,3
26771,58thStGreenway22ndAve,03/20/2017 11:00:00 AM,48,-122,3,0,3
26772,58thStGreenway22ndAve,03/20/2017 12:00:00 PM,48,-122,3,1,4
26773,58thStGreenway22ndAve,03/20/2017 01:00:00 PM,48,-122,6,0,6
26774,58thStGreenway22ndAve,03/20/2017 02:00:00 PM,48,-122,2,1,3
26775,58thStGreenway22ndAve,03/20/2017 03:00:00 PM,48,-122,0,0,0
26776,58thStGreenway22ndAve,03/20/2017 04:00:00 PM,48,-122,1,0,1
26777,58thStGreenway22ndAve,03/20/2017 05:00:00 PM,48,-122,5,0,5
26778,58thStGreenway22ndAve,03/20/2017 06:00:00 PM,48,-122,4,0,4
26779,58thStGreenway22ndAve,03/20/2017 07:00:00 PM,48,-122,3,0,3
26780,58thStGreenway22ndAve,03/20/2017 08:00:00 PM,48,-122,3,1,4
26781,58thStGreenway22ndAve,03/20/2017 09:00:00 PM,48,-122,1,1,2
26782,58thStGreenway22ndAve,03/20/2017 10:00:00 PM,48,-122,1,0,1
26783,58thStGreenway22ndAve,03/20/2017 11:00:00 PM,48,-122,0,0,0
26784,58thStGreenway22ndAve,03/21/2017 12:00:00 AM,48,-122,0,0,0
26785,58thStGreenway22ndAve,03/21/2017 01:00:00 AM,48,-122,0,0,0
26786,58thStGreenway22ndAve,03/21/2017 02:00:00 AM,48,-122,0,0,0
26787,58thStGreenway22ndAve,03/21/2017 03:00:00 AM,48,-122,0,0,0
26788,58thStGreenway22ndAve,03/21/2017 04:00:00 AM,48,-122,0,0,0
26789,58thStGreenway22ndAve,03/21/2017 05:00:00 AM,48,-122,0,0,0
26790,58thStGreenway22ndAve,03/21/2017 06:00:00 AM,48,-122,0,0,0
26791,58thStGreenway22ndAve,03/21/2017 07:00:00 AM,48,-122,0,0,0
26792,58thStGreenway22ndAve,03/21/2017 08:00:00 AM,48,-122,0,1,1
26793,58thStGreenway22ndAve,03/21/2017 09:00:00 AM,48,-122,0,1,1
26794,58thStGreenway22ndAve,03/21/2017 10:00:00 AM,48,-122,4,1,5
26795,58thStGreenway22ndAve,03/21/2017 11:00:00 AM,48,-122,1,3,4
26796,58thStGreenway22ndAve,03/21/2017 12:00:00 PM,48,-122,3,2,5
26797,58thStGreenway22ndAve,03/21/2017 01:00:00 PM,48,-122,6,0,6
26798,58thStGreenway22ndAve,03/21/2017 02:00:00 PM,48,-122,3,3,6
26799,58thStGreenway22ndAve,03/21/2017 03:00:00 PM,48,-122,3,5,8
26800,58thStGreenway22ndAve,03/21/2017 04:00:00 PM,48,-122,1,3,4
26801,58thStGreenway22ndAve,03/21/2017 05:00:00 PM,48,-122,1,1,2
26802,58thStGreenway22ndAve,03/21/2017 06:00:00 PM,48,-122,0,2,2
26803,58thStGreenway22ndAve,03/21/2017 07:00:00 PM,48,-122,2,0,2
26804,58thStGreenway22ndAve,03/21/2017 08:00:00 PM,48,-122,2,1,3
26805,58thStGreenway22ndAve,03/21/2017 09:00:00 PM,48,-122,0,0,0
26806,58thStGreenway22ndAve,03/21/2017 10:00:00 PM,48,-122,1,1,2
26807,58thStGreenway22ndAve,03/21/2017 11:00:00 PM,48,-122,1,0,1
26808,58thStGreenway22ndAve,03/22/2017 12:00:00 AM,48,-122,0,0,0
26809,58thStGreenway22ndAve,03/22/2017 01:00:00 AM,48,-122,0,0,0
26810,58thStGreenway22ndAve,03/22/2017 02:00:00 AM,48,-122,0,1,1
26811,58thStGreenway22ndAve,03/22/2017 03:00:00 AM,48,-122,0,0,0
26812,58thStGreenway22ndAve,03/22/2017 04:00:00 AM,48,-122,0,0,0
26813,58thStGreenway22ndAve,03/22/2017 05:00:00 AM,48,-122,0,0,0
26814,58thStGreenway22ndAve,03/22/2017 06:00:00 AM,48,-122,0,1,1
26815,58thStGreenway22ndAve,03/22/2017 07:00:00 AM,48,-122,4,0,4
26816,58thStGreenway22ndAve,03/22/2017 08:00:00 AM,48,-122,2,2,4
26817,58thStGreenway22ndAve,03/22/2017 09:00:00 AM,48,-122,3,5,8
26818,58thStGreenway22ndAve,03/22/2017 10:00:00 AM,48,-122,1,1,2
26819,58thStGreenway22ndAve,03/22/2017 11:00:00 AM,48,-122,0,0,0
26820,58thStGreenway22ndAve,03/22/2017 12:00:00 PM,48,-122,0,0,0
26821,58thStGreenway22ndAve,03/22/2017 01:00:00 PM,48,-122,1,0,1
26822,58thStGreenway22ndAve,03/22/2017 02:00:00 PM,48,-122,3,0,3
26823,58thStGreenway22ndAve,03/22/2017 03:00:00 PM,48,-122,1,0,1
26824,58thStGreenway22ndAve,03/22/2017 04:00:00 PM,48,-122,0,2,2
26825,58thStGreenway22ndAve,03/22/2017 05:00:00 PM,48,-122,7,6,13
26826,58thStGreenway22ndAve,03/22/2017 06:00:00 PM,48,-122,9,7,16
26827,58thStGreenway22ndAve,03/22/2017 07:00:00 PM,48,-122,3,2,5
26828,58thStGreenway22ndAve,03/22/2017 08:00:00 PM,48,-122,1,2,3
26829,58thStGreenway22ndAve,03/22/2017 09:00:00 PM,48,-122,0,2,2
26830,58thStGreenway22ndAve,03/22/2017 10:00:00 PM,48,-122,0,0,0
26831,58thStGreenway22ndAve,03/22/2017 11:00:00 PM,48,-122,0,1,1
26832,58thStGreenway22ndAve,03/23/2017 12:00:00 AM,48,-122,0,0,0
26833,58thStGreenway22ndAve,03/23/2017 01:00:00 AM,48,-122,0,0,0
26834,58thStGreenway22ndAve,03/23/2017 02:00:00 AM,48,-122,0,0,0
26835,58thStGreenway22ndAve,03/23/2017 03:00:00 AM,48,-122,0,0,0
26836,58thStGreenway22ndAve,03/23/2017 04:00:00 AM,48,-122,0,2,2
26837,58thStGreenway22ndAve,03/23/2017 05:00:00 AM,48,-122,0,3,3
26838,58thStGreenway22ndAve,03/23/2017 06:00:00 AM,48,-122,1,1,2
26839,58thStGreenway22ndAve,03/23/2017 07:00:00 AM,48,-122,2,1,3
26840,58thStGreenway22ndAve,03/23/2017 08:00:00 AM,48,-122,4,2,6
26841,58thStGreenway22ndAve,03/23/2017 09:00:00 AM,48,-122,3,2,5
26842,58thStGreenway22ndAve,03/23/2017 10:00:00 AM,48,-122,3,0,3
26843,58thStGreenway22ndAve,03/23/2017 11:00:00 AM,48,-122,4,0,4
26844,58thStGreenway22ndAve,03/23/2017 12:00:00 PM,48,-122,4,0,4
26845,58thStGreenway22ndAve,03/23/2017 01:00:00 PM,48,-122,1,1,2
26846,58thStGreenway22ndAve,03/23/2017 02:00:00 PM,48,-122,0,1,1
26847,58thStGreenway22ndAve,03/23/2017 03:00:00 PM,48,-122,1,0,1
26848,58thStGreenway22ndAve,03/23/2017 04:00:00 PM,48,-122,1,2,3
26849,58thStGreenway22ndAve,03/23/2017 05:00:00 PM,48,-122,6,3,9
26850,58thStGreenway22ndAve,03/23/2017 06:00:00 PM,48,-122,4,1,5
26851,58thStGreenway22ndAve,03/23/2017 07:00:00 PM,48,-122,3,2,5
26852,58thStGreenway22ndAve,03/23/2017 08:00:00 PM,48,-122,2,0,2
26853,58thStGreenway22ndAve,03/23/2017 09:00:00 PM,48,-122,0,0,0
26854,58thStGreenway22ndAve,03/23/2017 10:00:00 PM,48,-122,1,0,1
26855,58thStGreenway22ndAve,03/23/2017 11:00:00 PM,48,-122,1,2,3
26856,58thStGreenway22ndAve,03/24/2017 12:00:00 AM,48,-122,0,1,1
26857,58thStGreenway22ndAve,03/24/2017 01:00:00 AM,48,-122,0,0,0
26858,58thStGreenway22ndAve,03/24/2017 02:00:00 AM,48,-122,0,0,0
26859,58thStGreenway22ndAve,03/24/2017 03:00:00 AM,48,-122,0,0,0
26860,58thStGreenway22ndAve,03/24/2017 04:00:00 AM,48,-122,0,1,1
26861,58thStGreenway22ndAve,03/24/2017 05:00:00 AM,48,-122,0,0,0
26862,58thStGreenway22ndAve,03/24/2017 06:00:00 AM,48,-122,1,1,2
26863,58thStGreenway22ndAve,03/24/2017 07:00:00 AM,48,-122,1,0,1
26864,58thStGreenway22ndAve,03/24/2017 08:00:00 AM,48,-122,4,1,5
26865,58thStGreenway22ndAve,03/24/2017 09:00:00 AM,48,-122,1,0,1
26866,58thStGreenway22ndAve,03/24/2017 10:00:00 AM,48,-122,1,2,3
26867,58thStGreenway22ndAve,03/24/2017 11:00:00 AM,48,-122,3,8,11
26868,58thStGreenway22ndAve,03/24/2017 12:00:00 PM,48,-122,3,7,10
26869,58thStGreenway22ndAve,03/24/2017 01:00:00 PM,48,-122,2,6,8
26870,58thStGreenway22ndAve,03/24/2017 02:00:00 PM,48,-122,0,7,7
26871,58thStGreenway22ndAve,03/24/2017 03:00:00 PM,48,-122,3,4,7
26872,58thStGreenway22ndAve,03/24/2017 04:00:00 PM,48,-122,1,3,4
26873,58thStGreenway22ndAve,03/24/2017 05:00:00 PM,48,-122,4,0,4
26874,58thStGreenway22ndAve,03/24/2017 06:00:00 PM,48,-122,1,0,1
26875,58thStGreenway22ndAve,03/24/2017 07:00:00 PM,48,-122,0,0,0
26876,58thStGreenway22ndAve,03/24/2017 08:00:00 PM,48,-122,0,0,0
26877,58thStGreenway22ndAve,03/24/2017 09:00:00 PM,48,-122,1,0,1
26878,58thStGreenway22ndAve,03/24/2017 10:00:00 PM,48,-122,0,0,0
26879,58thStGreenway22ndAve,03/24/2017 11:00:00 PM,48,-122,0,1,1
26880,58thStGreenway22ndAve,03/25/2017 12:00:00 AM,48,-122,0,0,0
26881,58thStGreenway22ndAve,03/25/2017 01:00:00 AM,48,-122,0,0,0
26882,58thStGreenway22ndAve,03/25/2017 02:00:00 AM,48,-122,0,0,0
26883,58thStGreenway22ndAve,03/25/2017 03:00:00 AM,48,-122,0,0,0
26884,58thStGreenway22ndAve,03/25/2017 04:00:00 AM,48,-122,0,0,0
26885,58thStGreenway22ndAve,03/25/2017 05:00:00 AM,48,-122,0,0,0
26886,58thStGreenway22ndAve,03/25/2017 06:00:00 AM,48,-122,0,0,0
26887,58thStGreenway22ndAve,03/25/2017 07:00:00 AM,48,-122,0,0,0
26888,58thStGreenway22ndAve,03/25/2017 08:00:00 AM,48,-122,0,0,0
26889,58thStGreenway22ndAve,03/25/2017 09:00:00 AM,48,-122,0,0,0
26890,58thStGreenway22ndAve,03/25/2017 10:00:00 AM,48,-122,2,0,2
26891,58thStGreenway22ndAve,03/25/2017 11:00:00 AM,48,-122,0,2,2
26892,58thStGreenway22ndAve,03/25/2017 12:00:00 PM,48,-122,1,0,1
26893,58thStGreenway22ndAve,03/25/2017 01:00:00 PM,48,-122,4,0,4
26894,58thStGreenway22ndAve,03/25/2017 02:00:00 PM,48,-122,2,0,2
26895,58thStGreenway22ndAve,03/25/2017 03:00:00 PM,48,-122,0,0,0
26896,58thStGreenway22ndAve,03/25/2017 04:00:00 PM,48,-122,2,1,3
26897,58thStGreenway22ndAve,03/25/2017 05:00:00 PM,48,-122,3,1,4
26898,58thStGreenway22ndAve,03/25/2017 06:00:00 PM,48,-122,3,2,5
26899,58thStGreenway22ndAve,03/25/2017 07:00:00 PM,48,-122,2,7,9
26900,58thStGreenway22ndAve,03/25/2017 08:00:00 PM,48,-122,1,1,2
26901,58thStGreenway22ndAve,03/25/2017 09:00:00 PM,48,-122,1,1,2
26902,58thStGreenway22ndAve,03/25/2017 10:00:00 PM,48,-122,0,4,4
26903,58thStGreenway22ndAve,03/25/2017 11:00:00 PM,48,-122,1,3,4
26904,58thStGreenway22ndAve,03/26/2017 12:00:00 AM,48,-122,0,2,2
26905,58thStGreenway22ndAve,03/26/2017 01:00:00 AM,48,-122,0,1,1
26906,58thStGreenway22ndAve,03/26/2017 02:00:00 AM,48,-122,1,2,3
26907,58thStGreenway22ndAve,03/26/2017 03:00:00 AM,48,-122,1,0,1
26908,58thStGreenway22ndAve,03/26/2017 04:00:00 AM,48,-122,0,0,0
26909,58thStGreenway22ndAve,03/26/2017 05:00:00 AM,48,-122,0,1,1
26910,58thStGreenway22ndAve,03/26/2017 06:00:00 AM,48,-122,0,0,0
26911,58thStGreenway22ndAve,03/26/2017 07:00:00 AM,48,-122,0,1,1
26912,58thStGreenway22ndAve,03/26/2017 08:00:00 AM,48,-122,1,4,5
26913,58thStGreenway22ndAve,03/26/2017 09:00:00 AM,48,-122,1,8,9
26914,58thStGreenway22ndAve,03/26/2017 10:00:00 AM,48,-122,1,5,6
26915,58thStGreenway22ndAve,03/26/2017 11:00:00 AM,48,-122,2,5,7
26916,58thStGreenway22ndAve,03/26/2017 12:00:00 PM,48,-122,2,4,6
26917,58thStGreenway22ndAve,03/26/2017 01:00:00 PM,48,-122,8,7,15
26918,58thStGreenway22ndAve,03/26/2017 02:00:00 PM,48,-122,4,1,5
26919,58thStGreenway22ndAve,03/26/2017 03:00:00 PM,48,-122,1,1,2
26920,58thStGreenway22ndAve,03/26/2017 04:00:00 PM,48,-122,1,6,7
26921,58thStGreenway22ndAve,03/26/2017 05:00:00 PM,48,-122,1,2,3
26922,58thStGreenway22ndAve,03/26/2017 06:00:00 PM,48,-122,1,1,2
26923,58thStGreenway22ndAve,03/26/2017 07:00:00 PM,48,-122,0,6,6
26924,58thStGreenway22ndAve,03/26/2017 08:00:00 PM,48,-122,0,1,1
26925,58thStGreenway22ndAve,03/26/2017 09:00:00 PM,48,-122,0,1,1
26926,58thStGreenway22ndAve,03/26/2017 10:00:00 PM,48,-122,0,0,0
26927,58thStGreenway22ndAve,03/26/2017 11:00:00 PM,48,-122,0,1,1
26928,58thStGreenway22ndAve,03/27/2017 12:00:00 AM,48,-122,0,0,0
26929,58thStGreenway22ndAve,03/27/2017 01:00:00 AM,48,-122,0,0,0
26930,58thStGreenway22ndAve,03/27/2017 02:00:00 AM,48,-122,0,0,0
26931,58thStGreenway22ndAve,03/27/2017 03:00:00 AM,48,-122,0,0,0
26932,58thStGreenway22ndAve,03/27/2017 04:00:00 AM,48,-122,0,0,0
26933,58thStGreenway22ndAve,03/27/2017 05:00:00 AM,48,-122,0,1,1
26934,58thStGreenway22ndAve,03/27/2017 06:00:00 AM,48,-122,0,0,0
26935,58thStGreenway22ndAve,03/27/2017 07:00:00 AM,48,-122,0,2,2
26936,58thStGreenway22ndAve,03/27/2017 08:00:00 AM,48,-122,0,2,2
26937,58thStGreenway22ndAve,03/27/2017 09:00:00 AM,48,-122,1,3,4
26938,58thStGreenway22ndAve,03/27/2017 10:00:00 AM,48,-122,1,6,7
26939,58thStGreenway22ndAve,03/27/2017 11:00:00 AM,48,-122,1,1,2
26940,58thStGreenway22ndAve,03/27/2017 12:00:00 PM,48,-122,2,1,3
26941,58thStGreenway22ndAve,03/27/2017 01:00:00 PM,48,-122,2,0,2
26942,58thStGreenway22ndAve,03/27/2017 02:00:00 PM,48,-122,0,0,0
26943,58thStGreenway22ndAve,03/27/2017 03:00:00 PM,48,-122,1,0,1
26944,58thStGreenway22ndAve,03/27/2017 04:00:00 PM,48,-122,3,0,3
26945,58thStGreenway22ndAve,03/27/2017 05:00:00 PM,48,-122,1,0,1
26946,58thStGreenway22ndAve,03/27/2017 06:00:00 PM,48,-122,3,2,5
26947,58thStGreenway22ndAve,03/27/2017 07:00:00 PM,48,-122,1,2,3
26948,58thStGreenway22ndAve,03/27/2017 08:00:00 PM,48,-122,1,0,1
26949,58thStGreenway22ndAve,03/27/2017 09:00:00 PM,48,-122,1,0,1
26950,58thStGreenway22ndAve,03/27/2017 10:00:00 PM,48,-122,1,2,3
26951,58thStGreenway22ndAve,03/27/2017 11:00:00 PM,48,-122,0,0,0
26952,58thStGreenway22ndAve,03/28/2017 12:00:00 AM,48,-122,0,0,0
26953,58thStGreenway22ndAve,03/28/2017 01:00:00 AM,48,-122,0,0,0
26954,58thStGreenway22ndAve,03/28/2017 02:00:00 AM,48,-122,0,0,0
26955,58thStGreenway22ndAve,03/28/2017 03:00:00 AM,48,-122,0,0,0
26956,58thStGreenway22ndAve,03/28/2017 04:00:00 AM,48,-122,0,0,0
26957,58thStGreenway22ndAve,03/28/2017 05:00:00 AM,48,-122,0,0,0
26958,58thStGreenway22ndAve,03/28/2017 06:00:00 AM,48,-122,0,0,0
26959,58thStGreenway22ndAve,03/28/2017 07:00:00 AM,48,-122,3,0,3
26960,58thStGreenway22ndAve,03/28/2017 08:00:00 AM,48,-122,7,1,8
26961,58thStGreenway22ndAve,03/28/2017 09:00:00 AM,48,-122,1,1,2
26962,58thStGreenway22ndAve,03/28/2017 10:00:00 AM,48,-122,0,3,3
26963,58thStGreenway22ndAve,03/28/2017 11:00:00 AM,48,-122,0,1,1
26964,58thStGreenway22ndAve,03/28/2017 12:00:00 PM,48,-122,2,0,2
26965,58thStGreenway22ndAve,03/28/2017 01:00:00 PM,48,-122,2,5,7
26966,58thStGreenway22ndAve,03/28/2017 02:00:00 PM,48,-122,0,0,0
26967,58thStGreenway22ndAve,03/28/2017 03:00:00 PM,48,-122,3,4,7
26968,58thStGreenway22ndAve,03/28/2017 04:00:00 PM,48,-122,1,3,4
26969,58thStGreenway22ndAve,03/28/2017 05:00:00 PM,48,-122,0,0,0
26970,58thStGreenway22ndAve,03/28/2017 06:00:00 PM,48,-122,7,0,7
26971,58thStGreenway22ndAve,03/28/2017 07:00:00 PM,48,-122,2,1,3
26972,58thStGreenway22ndAve,03/28/2017 08:00:00 PM,48,-122,2,1,3
26973,58thStGreenway22ndAve,03/28/2017 09:00:00 PM,48,-122,1,0,1
26974,58thStGreenway22ndAve,03/28/2017 10:00:00 PM,48,-122,1,0,1
26975,58thStGreenway22ndAve,03/28/2017 11:00:00 PM,48,-122,0,0,0
26976,58thStGreenway22ndAve,03/29/2017 12:00:00 AM,48,-122,0,0,0
26977,58thStGreenway22ndAve,03/29/2017 01:00:00 AM,48,-122,0,0,0
26978,58thStGreenway22ndAve,03/29/2017 02:00:00 AM,48,-122,0,0,0
26979,58thStGreenway22ndAve,03/29/2017 03:00:00 AM,48,-122,0,1,1
26980,58thStGreenway22ndAve,03/29/2017 04:00:00 AM,48,-122,0,1,1
26981,58thStGreenway22ndAve,03/29/2017 05:00:00 AM,48,-122,0,0,0
26982,58thStGreenway22ndAve,03/29/2017 06:00:00 AM,48,-122,1,2,3
26983,58thStGreenway22ndAve,03/29/2017 07:00:00 AM,48,-122,1,0,1
26984,58thStGreenway22ndAve,03/29/2017 08:00:00 AM,48,-122,2,0,2
26985,58thStGreenway22ndAve,03/29/2017 09:00:00 AM,48,-122,0,0,0
26986,58thStGreenway22ndAve,03/29/2017 10:00:00 AM,48,-122,0,0,0
26987,58thStGreenway22ndAve,03/29/2017 11:00:00 AM,48,-122,0,1,1
26988,58thStGreenway22ndAve,03/29/2017 12:00:00 PM,48,-122,0,5,5
26989,58thStGreenway22ndAve,03/29/2017 01:00:00 PM,48,-122,1,0,1
26990,58thStGreenway22ndAve,03/29/2017 02:00:00 PM,48,-122,1,0,1
26991,58thStGreenway22ndAve,03/29/2017 03:00:00 PM,48,-122,0,0,0
26992,58thStGreenway22ndAve,03/29/2017 04:00:00 PM,48,-122,0,0,0
26993,58thStGreenway22ndAve,03/29/2017 05:00:00 PM,48,-122,1,0,1
26994,58thStGreenway22ndAve,03/29/2017 06:00:00 PM,48,-122,0,0,0
26995,58thStGreenway22ndAve,03/29/2017 07:00:00 PM,48,-122,1,0,1
26996,58thStGreenway22ndAve,03/29/2017 08:00:00 PM,48,-122,0,0,0
26997,58thStGreenway22ndAve,03/29/2017 09:00:00 PM,48,-122,0,0,0
26998,58thStGreenway22ndAve,03/29/2017 10:00:00 PM,48,-122,0,0,0
26999,58thStGreenway22ndAve,03/29/2017 11:00:00 PM,48,-122,0,0,0
27000,58thStGreenway22ndAve,03/30/2017 12:00:00 AM,48,-122,0,0,0
27001,58thStGreenway22ndAve,03/30/2017 01:00:00 AM,48,-122,0,0,0
27002,58thStGreenway22ndAve,03/30/2017 02:00:00 AM,48,-122,0,0,0
27003,58thStGreenway22ndAve,03/30/2017 03:00:00 AM,48,-122,0,0,0
27004,58thStGreenway22ndAve,03/30/2017 04:00:00 AM,48,-122,0,0,0
27005,58thStGreenway22ndAve,03/30/2017 05:00:00 AM,48,-122,0,0,0
27006,58thStGreenway22ndAve,03/30/2017 06:00:00 AM,48,-122,0,0,0
27007,58thStGreenway22ndAve,03/30/2017 07:00:00 AM,48,-122,2,0,2
27008,58thStGreenway22ndAve,03/30/2017 08:00:00 AM,48,-122,2,1,3
27009,58thStGreenway22ndAve,03/30/2017 09:00:00 AM,48,-122,3,1,4
27010,58thStGreenway22ndAve,03/30/2017 10:00:00 AM,48,-122,1,1,2
27011,58thStGreenway22ndAve,03/30/2017 11:00:00 AM,48,-122,2,0,2
27012,58thStGreenway22ndAve,03/30/2017 12:00:00 PM,48,-122,2,1,3
27013,58thStGreenway22ndAve,03/30/2017 01:00:00 PM,48,-122,0,1,1
27014,58thStGreenway22ndAve,03/30/2017 02:00:00 PM,48,-122,0,1,1
27015,58thStGreenway22ndAve,03/30/2017 03:00:00 PM,48,-122,2,0,2
27016,58thStGreenway22ndAve,03/30/2017 04:00:00 PM,48,-122,1,0,1
27017,58thStGreenway22ndAve,03/30/2017 05:00:00 PM,48,-122,1,1,2
27018,58thStGreenway22ndAve,03/30/2017 06:00:00 PM,48,-122,5,2,7
27019,58thStGreenway22ndAve,03/30/2017 07:00:00 PM,48,-122,6,1,7
27020,58thStGreenway22ndAve,03/30/2017 08:00:00 PM,48,-122,2,1,3
27021,58thStGreenway22ndAve,03/30/2017 09:00:00 PM,48,-122,3,0,3
27022,58thStGreenway22ndAve,03/30/2017 10:00:00 PM,48,-122,2,2,4
27023,58thStGreenway22ndAve,03/30/2017 11:00:00 PM,48,-122,1,0,1
27024,58thStGreenway22ndAve,03/31/2017 12:00:00 AM,48,-122,0,0,0
27025,58thStGreenway22ndAve,03/31/2017 01:00:00 AM,48,-122,0,0,0
27026,58thStGreenway22ndAve,03/31/2017 02:00:00 AM,48,-122,0,0,0
27027,58thStGreenway22ndAve,03/31/2017 03:00:00 AM,48,-122,0,1,1
27028,58thStGreenway22ndAve,03/31/2017 04:00:00 AM,48,-122,0,0,0
27029,58thStGreenway22ndAve,03/31/2017 05:00:00 AM,48,-122,0,0,0
27030,58thStGreenway22ndAve,03/31/2017 06:00:00 AM,48,-122,0,0,0
27031,58thStGreenway22ndAve,03/31/2017 07:00:00 AM,48,-122,1,0,1
27032,58thStGreenway22ndAve,03/31/2017 08:00:00 AM,48,-122,1,3,4
27033,58thStGreenway22ndAve,03/31/2017 09:00:00 AM,48,-122,3,1,4
27034,58thStGreenway22ndAve,03/31/2017 10:00:00 AM,48,-122,1,2,3
27035,58thStGreenway22ndAve,03/31/2017 11:00:00 AM,48,-122,0,4,4
27036,58thStGreenway22ndAve,03/31/2017 12:00:00 PM,48,-122,1,3,4
27037,58thStGreenway22ndAve,03/31/2017 01:00:00 PM,48,-122,1,3,4
27038,58thStGreenway22ndAve,03/31/2017 02:00:00 PM,48,-122,3,4,7
27039,58thStGreenway22ndAve,03/31/2017 03:00:00 PM,48,-122,6,1,7
27040,58thStGreenway22ndAve,03/31/2017 04:00:00 PM,48,-122,2,1,3
27041,58thStGreenway22ndAve,03/31/2017 05:00:00 PM,48,-122,10,3,13
27042,58thStGreenway22ndAve,03/31/2017 06:00:00 PM,48,-122,4,1,5
27043,58thStGreenway22ndAve,03/31/2017 07:00:00 PM,48,-122,7,0,7
27044,58thStGreenway22ndAve,03/31/2017 08:00:00 PM,48,-122,6,3,9
27045,58thStGreenway22ndAve,03/31/2017 09:00:00 PM,48,-122,1,0,1
27046,58thStGreenway22ndAve,03/31/2017 10:00:00 PM,48,-122,1,2,3
27047,58thStGreenway22ndAve,03/31/2017 11:00:00 PM,48,-122,1,0,1
27048,58thStGreenway22ndAve,04/01/2017 12:00:00 AM,48,-122,2,1,3
27049,58thStGreenway22ndAve,04/01/2017 01:00:00 AM,48,-122,0,0,0
27050,58thStGreenway22ndAve,04/01/2017 02:00:00 AM,48,-122,1,0,1
27051,58thStGreenway22ndAve,04/01/2017 03:00:00 AM,48,-122,0,0,0
27052,58thStGreenway22ndAve,04/01/2017 04:00:00 AM,48,-122,0,0,0
27053,58thStGreenway22ndAve,04/01/2017 05:00:00 AM,48,-122,0,0,0
27054,58thStGreenway22ndAve,04/01/2017 06:00:00 AM,48,-122,0,0,0
27055,58thStGreenway22ndAve,04/01/2017 07:00:00 AM,48,-122,0,1,1
27056,58thStGreenway22ndAve,04/01/2017 08:00:00 AM,48,-122,4,0,4
27057,58thStGreenway22ndAve,04/01/2017 09:00:00 AM,48,-122,1,4,5
27058,58thStGreenway22ndAve,04/01/2017 10:00:00 AM,48,-122,3,2,5
27059,58thStGreenway22ndAve,04/01/2017 11:00:00 AM,48,-122,6,0,6
27060,58thStGreenway22ndAve,04/01/2017 12:00:00 PM,48,-122,6,0,6
27061,58thStGreenway22ndAve,04/01/2017 01:00:00 PM,48,-122,5,1,6
27062,58thStGreenway22ndAve,04/01/2017 02:00:00 PM,48,-122,3,2,5
27063,58thStGreenway22ndAve,04/01/2017 03:00:00 PM,48,-122,3,0,3
27064,58thStGreenway22ndAve,04/01/2017 04:00:00 PM,48,-122,5,0,5
27065,58thStGreenway22ndAve,04/01/2017 05:00:00 PM,48,-122,5,0,5
27066,58thStGreenway22ndAve,04/01/2017 06:00:00 PM,48,-122,6,0,6
27067,58thStGreenway22ndAve,04/01/2017 07:00:00 PM,48,-122,1,0,1
27068,58thStGreenway22ndAve,04/01/2017 08:00:00 PM,48,-122,2,1,3
27069,58thStGreenway22ndAve,04/01/2017 09:00:00 PM,48,-122,0,0,0
27070,58thStGreenway22ndAve,04/01/2017 10:00:00 PM,48,-122,0,0,0
27071,58thStGreenway22ndAve,04/01/2017 11:00:00 PM,48,-122,0,0,0
27072,58thStGreenway22ndAve,04/02/2017 12:00:00 AM,48,-122,0,0,0
27073,58thStGreenway22ndAve,04/02/2017 01:00:00 AM,48,-122,0,0,0
27074,58thStGreenway22ndAve,04/02/2017 02:00:00 AM,48,-122,0,0,0
27075,58thStGreenway22ndAve,04/02/2017 03:00:00 AM,48,-122,1,0,1
27076,58thStGreenway22ndAve,04/02/2017 04:00:00 AM,48,-122,0,0,0
27077,58thStGreenway22ndAve,04/02/2017 05:00:00 AM,48,-122,0,0,0
27078,58thStGreenway22ndAve,04/02/2017 06:00:00 AM,48,-122,0,0,0
27079,58thStGreenway22ndAve,04/02/2017 07:00:00 AM,48,-122,0,0,0
27080,58thStGreenway22ndAve,04/02/2017 08:00:00 AM,48,-122,0,0,0
27081,58thStGreenway22ndAve,04/02/2017 09:00:00 AM,48,-122,5,0,5
27082,58thStGreenway22ndAve,04/02/2017 10:00:00 AM,48,-122,4,0,4
27083,58thStGreenway22ndAve,04/02/2017 11:00:00 AM,48,-122,4,0,4
27084,58thStGreenway22ndAve,04/02/2017 12:00:00 PM,48,-122,9,0,9
27085,58thStGreenway22ndAve,04/02/2017 01:00:00 PM,48,-122,7,0,7
27086,58thStGreenway22ndAve,04/02/2017 02:00:00 PM,48,-122,4,0,4
27087,58thStGreenway22ndAve,04/02/2017 03:00:00 PM,48,-122,3,1,4
27088,58thStGreenway22ndAve,04/02/2017 04:00:00 PM,48,-122,3,0,3
27089,58thStGreenway22ndAve,04/02/2017 05:00:00 PM,48,-122,5,0,5
27090,58thStGreenway22ndAve,04/02/2017 06:00:00 PM,48,-122,3,1,4
27091,58thStGreenway22ndAve,04/02/2017 07:00:00 PM,48,-122,3,0,3
27092,58thStGreenway22ndAve,04/02/2017 08:00:00 PM,48,-122,0,0,0
27093,58thStGreenway22ndAve,04/02/2017 09:00:00 PM,48,-122,1,1,2
27094,58thStGreenway22ndAve,04/02/2017 10:00:00 PM,48,-122,1,0,1
27095,58thStGreenway22ndAve,04/02/2017 11:00:00 PM,48,-122,0,0,0
27096,58thStGreenway22ndAve,04/03/2017 12:00:00 AM,48,-122,0,0,0
27097,58thStGreenway22ndAve,04/03/2017 01:00:00 AM,48,-122,0,0,0
27098,58thStGreenway22ndAve,04/03/2017 02:00:00 AM,48,-122,0,0,0
27099,58thStGreenway22ndAve,04/03/2017 03:00:00 AM,48,-122,1,0,1
27100,58thStGreenway22ndAve,04/03/2017 04:00:00 AM,48,-122,0,0,0
27101,58thStGreenway22ndAve,04/03/2017 05:00:00 AM,48,-122,1,0,1
27102,58thStGreenway22ndAve,04/03/2017 06:00:00 AM,48,-122,0,1,1
27103,58thStGreenway22ndAve,04/03/2017 07:00:00 AM,48,-122,1,1,2
27104,58thStGreenway22ndAve,04/03/2017 08:00:00 AM,48,-122,0,0,0
27105,58thStGreenway22ndAve,04/03/2017 09:00:00 AM,48,-122,1,1,2
27106,58thStGreenway22ndAve,04/03/2017 10:00:00 AM,48,-122,3,0,3
27107,58thStGreenway22ndAve,04/03/2017 11:00:00 AM,48,-122,2,0,2
27108,58thStGreenway22ndAve,04/03/2017 12:00:00 PM,48,-122,6,1,7
27109,58thStGreenway22ndAve,04/03/2017 01:00:00 PM,48,-122,2,0,2
27110,58thStGreenway22ndAve,04/03/2017 02:00:00 PM,48,-122,1,0,1
27111,58thStGreenway22ndAve,04/03/2017 03:00:00 PM,48,-122,2,0,2
27112,58thStGreenway22ndAve,04/03/2017 04:00:00 PM,48,-122,3,0,3
27113,58thStGreenway22ndAve,04/03/2017 05:00:00 PM,48,-122,5,0,5
27114,58thStGreenway22ndAve,04/03/2017 06:00:00 PM,48,-122,5,1,6
27115,58thStGreenway22ndAve,04/03/2017 07:00:00 PM,48,-122,5,0,5
27116,58thStGreenway22ndAve,04/03/2017 08:00:00 PM,48,-122,0,0,0
27117,58thStGreenway22ndAve,04/03/2017 09:00:00 PM,48,-122,0,1,1
27118,58thStGreenway22ndAve,04/03/2017 10:00:00 PM,48,-122,0,0,0
27119,58thStGreenway22ndAve,04/03/2017 11:00:00 PM,48,-122,0,0,0
27120,58thStGreenway22ndAve,04/04/2017 12:00:00 AM,48,-122,0,1,1
27121,58thStGreenway22ndAve,04/04/2017 01:00:00 AM,48,-122,2,0,2
27122,58thStGreenway22ndAve,04/04/2017 02:00:00 AM,48,-122,0,0,0
27123,58thStGreenway22ndAve,04/04/2017 03:00:00 AM,48,-122,0,1,1
27124,58thStGreenway22ndAve,04/04/2017 04:00:00 AM,48,-122,0,0,0
27125,58thStGreenway22ndAve,04/04/2017 05:00:00 AM,48,-122,0,1,1
27126,58thStGreenway22ndAve,04/04/2017 06:00:00 AM,48,-122,1,0,1
27127,58thStGreenway22ndAve,04/04/2017 07:00:00 AM,48,-122,1,0,1
27128,58thStGreenway22ndAve,04/04/2017 08:00:00 AM,48,-122,5,0,5
27129,58thStGreenway22ndAve,04/04/2017 09:00:00 AM,48,-122,2,0,2
27130,58thStGreenway22ndAve,04/04/2017 10:00:00 AM,48,-122,3,0,3
27131,58thStGreenway22ndAve,04/04/2017 11:00:00 AM,48,-122,3,0,3
27132,58thStGreenway22ndAve,04/04/2017 12:00:00 PM,48,-122,1,0,1
27133,58thStGreenway22ndAve,04/04/2017 01:00:00 PM,48,-122,9,1,10
27134,58thStGreenway22ndAve,04/04/2017 02:00:00 PM,48,-122,0,0,0
27135,58thStGreenway22ndAve,04/04/2017 03:00:00 PM,48,-122,1,1,2
27136,58thStGreenway22ndAve,04/04/2017 04:00:00 PM,48,-122,1,1,2
27137,58thStGreenway22ndAve,04/04/2017 05:00:00 PM,48,-122,6,0,6
27138,58thStGreenway22ndAve,04/04/2017 06:00:00 PM,48,-122,3,2,5
27139,58thStGreenway22ndAve,04/04/2017 07:00:00 PM,48,-122,4,0,4
27140,58thStGreenway22ndAve,04/04/2017 08:00:00 PM,48,-122,3,0,3
27141,58thStGreenway22ndAve,04/04/2017 09:00:00 PM,48,-122,1,0,1
27142,58thStGreenway22ndAve,04/04/2017 10:00:00 PM,48,-122,0,0,0
27143,58thStGreenway22ndAve,04/04/2017 11:00:00 PM,48,-122,0,0,0
27144,58thStGreenway22ndAve,04/05/2017 12:00:00 AM,48,-122,0,0,0
27145,58thStGreenway22ndAve,04/05/2017 01:00:00 AM,48,-122,0,0,0
27146,58thStGreenway22ndAve,04/05/2017 02:00:00 AM,48,-122,0,0,0
27147,58thStGreenway22ndAve,04/05/2017 03:00:00 AM,48,-122,0,0,0
27148,58thStGreenway22ndAve,04/05/2017 04:00:00 AM,48,-122,0,0,0
27149,58thStGreenway22ndAve,04/05/2017 05:00:00 AM,48,-122,0,0,0
27150,58thStGreenway22ndAve,04/05/2017 06:00:00 AM,48,-122,1,0,1
27151,58thStGreenway22ndAve,04/05/2017 07:00:00 AM,48,-122,2,0,2
27152,58thStGreenway22ndAve,04/05/2017 08:00:00 AM,48,-122,2,1,3
27153,58thStGreenway22ndAve,04/05/2017 09:00:00 AM,48,-122,0,2,2
27154,58thStGreenway22ndAve,04/05/2017 10:00:00 AM,48,-122,0,4,4
27155,58thStGreenway22ndAve,04/05/2017 11:00:00 AM,48,-122,1,4,5
27156,58thStGreenway22ndAve,04/05/2017 12:00:00 PM,48,-122,4,4,8
27157,58thStGreenway22ndAve,04/05/2017 01:00:00 PM,48,-122,2,3,5
27158,58thStGreenway22ndAve,04/05/2017 02:00:00 PM,48,-122,1,5,6
27159,58thStGreenway22ndAve,04/05/2017 03:00:00 PM,48,-122,1,2,3
27160,58thStGreenway22ndAve,04/05/2017 04:00:00 PM,48,-122,3,3,6
27161,58thStGreenway22ndAve,04/05/2017 05:00:00 PM,48,-122,3,3,6
27162,58thStGreenway22ndAve,04/05/2017 06:00:00 PM,48,-122,1,7,8
27163,58thStGreenway22ndAve,04/05/2017 07:00:00 PM,48,-122,1,1,2
27164,58thStGreenway22ndAve,04/05/2017 08:00:00 PM,48,-122,0,1,1
27165,58thStGreenway22ndAve,04/05/2017 09:00:00 PM,48,-122,2,1,3
27166,58thStGreenway22ndAve,04/05/2017 10:00:00 PM,48,-122,0,1,1
27167,58thStGreenway22ndAve,04/05/2017 11:00:00 PM,48,-122,0,2,2
27168,58thStGreenway22ndAve,04/06/2017 12:00:00 AM,48,-122,0,1,1
27169,58thStGreenway22ndAve,04/06/2017 01:00:00 AM,48,-122,0,0,0
27170,58thStGreenway22ndAve,04/06/2017 02:00:00 AM,48,-122,0,0,0
27171,58thStGreenway22ndAve,04/06/2017 03:00:00 AM,48,-122,0,0,0
27172,58thStGreenway22ndAve,04/06/2017 04:00:00 AM,48,-122,0,1,1
27173,58thStGreenway22ndAve,04/06/2017 05:00:00 AM,48,-122,0,0,0
27174,58thStGreenway22ndAve,04/06/2017 06:00:00 AM,48,-122,0,0,0
27175,58thStGreenway22ndAve,04/06/2017 07:00:00 AM,48,-122,2,2,4
27176,58thStGreenway22ndAve,04/06/2017 08:00:00 AM,48,-122,1,5,6
27177,58thStGreenway22ndAve,04/06/2017 09:00:00 AM,48,-122,0,2,2
27178,58thStGreenway22ndAve,04/06/2017 10:00:00 AM,48,-122,0,3,3
27179,58thStGreenway22ndAve,04/06/2017 11:00:00 AM,48,-122,0,5,5
27180,58thStGreenway22ndAve,04/06/2017 12:00:00 PM,48,-122,2,6,8
27181,58thStGreenway22ndAve,04/06/2017 01:00:00 PM,48,-122,1,5,6
27182,58thStGreenway22ndAve,04/06/2017 02:00:00 PM,48,-122,0,5,5
27183,58thStGreenway22ndAve,04/06/2017 03:00:00 PM,48,-122,0,5,5
27184,58thStGreenway22ndAve,04/06/2017 04:00:00 PM,48,-122,0,3,3
27185,58thStGreenway22ndAve,04/06/2017 05:00:00 PM,48,-122,3,9,12
27186,58thStGreenway22ndAve,04/06/2017 06:00:00 PM,48,-122,3,4,7
27187,58thStGreenway22ndAve,04/06/2017 07:00:00 PM,48,-122,5,2,7
27188,58thStGreenway22ndAve,04/06/2017 08:00:00 PM,48,-122,0,4,4
27189,58thStGreenway22ndAve,04/06/2017 09:00:00 PM,48,-122,1,8,9
27190,58thStGreenway22ndAve,04/06/2017 10:00:00 PM,48,-122,0,8,8
27191,58thStGreenway22ndAve,04/06/2017 11:00:00 PM,48,-122,0,4,4
27192,58thStGreenway22ndAve,04/07/2017 12:00:00 AM,48,-122,0,2,2
27193,58thStGreenway22ndAve,04/07/2017 01:00:00 AM,48,-122,0,0,0
27194,58thStGreenway22ndAve,04/07/2017 02:00:00 AM,48,-122,0,1,1
27195,58thStGreenway22ndAve,04/07/2017 03:00:00 AM,48,-122,1,0,1
27196,58thStGreenway22ndAve,04/07/2017 04:00:00 AM,48,-122,0,0,0
27197,58thStGreenway22ndAve,04/07/2017 05:00:00 AM,48,-122,0,0,0
27198,58thStGreenway22ndAve,04/07/2017 06:00:00 AM,48,-122,0,0,0
27199,58thStGreenway22ndAve,04/07/2017 07:00:00 AM,48,-122,0,1,1
27200,58thStGreenway22ndAve,04/07/2017 08:00:00 AM,48,-122,1,4,5
27201,58thStGreenway22ndAve,04/07/2017 09:00:00 AM,48,-122,1,4,5
27202,58thStGreenway22ndAve,04/07/2017 10:00:00 AM,48,-122,3,3,6
27203,58thStGreenway22ndAve,04/07/2017 11:00:00 AM,48,-122,1,3,4
27204,58thStGreenway22ndAve,04/07/2017 12:00:00 PM,48,-122,0,10,10
27205,58thStGreenway22ndAve,04/07/2017 01:00:00 PM,48,-122,0,0,0
27206,58thStGreenway22ndAve,04/07/2017 02:00:00 PM,48,-122,0,1,1
27207,58thStGreenway22ndAve,04/07/2017 03:00:00 PM,48,-122,4,0,4
27208,58thStGreenway22ndAve,04/07/2017 04:00:00 PM,48,-122,1,2,3
27209,58thStGreenway22ndAve,04/07/2017 05:00:00 PM,48,-122,2,4,6
27210,58thStGreenway22ndAve,04/07/2017 06:00:00 PM,48,-122,1,2,3
27211,58thStGreenway22ndAve,04/07/2017 07:00:00 PM,48,-122,0,4,4
27212,58thStGreenway22ndAve,04/07/2017 08:00:00 PM,48,-122,1,3,4
27213,58thStGreenway22ndAve,04/07/2017 09:00:00 PM,48,-122,1,0,1
27214,58thStGreenway22ndAve,04/07/2017 10:00:00 PM,48,-122,0,1,1
27215,58thStGreenway22ndAve,04/07/2017 11:00:00 PM,48,-122,0,2,2
27216,58thStGreenway22ndAve,04/08/2017 12:00:00 AM,48,-122,0,0,0
27217,58thStGreenway22ndAve,04/08/2017 01:00:00 AM,48,-122,0,0,0
27218,58thStGreenway22ndAve,04/08/2017 02:00:00 AM,48,-122,0,0,0
27219,58thStGreenway22ndAve,04/08/2017 03:00:00 AM,48,-122,0,0,0
27220,58thStGreenway22ndAve,04/08/2017 04:00:00 AM,48,-122,0,0,0
27221,58thStGreenway22ndAve,04/08/2017 05:00:00 AM,48,-122,0,1,1
27222,58thStGreenway22ndAve,04/08/2017 06:00:00 AM,48,-122,0,0,0
27223,58thStGreenway22ndAve,04/08/2017 07:00:00 AM,48,-122,0,0,0
27224,58thStGreenway22ndAve,04/08/2017 08:00:00 AM,48,-122,0,0,0
27225,58thStGreenway22ndAve,04/08/2017 09:00:00 AM,48,-122,5,1,6
27226,58thStGreenway22ndAve,04/08/2017 10:00:00 AM,48,-122,5,0,5
27227,58thStGreenway22ndAve,04/08/2017 11:00:00 AM,48,-122,4,0,4
27228,58thStGreenway22ndAve,04/08/2017 12:00:00 PM,48,-122,6,1,7
27229,58thStGreenway22ndAve,04/08/2017 01:00:00 PM,48,-122,5,0,5
27230,58thStGreenway22ndAve,04/08/2017 02:00:00 PM,48,-122,3,1,4
27231,58thStGreenway22ndAve,04/08/2017 03:00:00 PM,48,-122,1,1,2
27232,58thStGreenway22ndAve,04/08/2017 04:00:00 PM,48,-122,3,2,5
27233,58thStGreenway22ndAve,04/08/2017 05:00:00 PM,48,-122,4,6,10
27234,58thStGreenway22ndAve,04/08/2017 06:00:00 PM,48,-122,6,1,7
27235,58thStGreenway22ndAve,04/08/2017 07:00:00 PM,48,-122,1,1,2
27236,58thStGreenway22ndAve,04/08/2017 08:00:00 PM,48,-122,1,0,1
27237,58thStGreenway22ndAve,04/08/2017 09:00:00 PM,48,-122,0,1,1
27238,58thStGreenway22ndAve,04/08/2017 10:00:00 PM,48,-122,0,0,0
27239,58thStGreenway22ndAve,04/08/2017 11:00:00 PM,48,-122,0,1,1
27240,58thStGreenway22ndAve,04/09/2017 12:00:00 AM,48,-122,1,0,1
27241,58thStGreenway22ndAve,04/09/2017 01:00:00 AM,48,-122,0,0,0
27242,58thStGreenway22ndAve,04/09/2017 02:00:00 AM,48,-122,0,0,0
27243,58thStGreenway22ndAve,04/09/2017 03:00:00 AM,48,-122,0,0,0
27244,58thStGreenway22ndAve,04/09/2017 04:00:00 AM,48,-122,0,0,0
27245,58thStGreenway22ndAve,04/09/2017 05:00:00 AM,48,-122,0,0,0
27246,58thStGreenway22ndAve,04/09/2017 06:00:00 AM,48,-122,0,2,2
27247,58thStGreenway22ndAve,04/09/2017 07:00:00 AM,48,-122,0,0,0
27248,58thStGreenway22ndAve,04/09/2017 08:00:00 AM,48,-122,1,0,1
27249,58thStGreenway22ndAve,04/09/2017 09:00:00 AM,48,-122,2,1,3
27250,58thStGreenway22ndAve,04/09/2017 10:00:00 AM,48,-122,6,1,7
27251,58thStGreenway22ndAve,04/09/2017 11:00:00 AM,48,-122,4,6,10
27252,58thStGreenway22ndAve,04/09/2017 12:00:00 PM,48,-122,4,4,8
27253,58thStGreenway22ndAve,04/09/2017 01:00:00 PM,48,-122,2,2,4
27254,58thStGreenway22ndAve,04/09/2017 02:00:00 PM,48,-122,4,1,5
27255,58thStGreenway22ndAve,04/09/2017 03:00:00 PM,48,-122,0,3,3
27256,58thStGreenway22ndAve,04/09/2017 04:00:00 PM,48,-122,8,2,10
27257,58thStGreenway22ndAve,04/09/2017 05:00:00 PM,48,-122,9,2,11
27258,58thStGreenway22ndAve,04/09/2017 06:00:00 PM,48,-122,4,1,5
27259,58thStGreenway22ndAve,04/09/2017 07:00:00 PM,48,-122,3,0,3
27260,58thStGreenway22ndAve,04/09/2017 08:00:00 PM,48,-122,1,1,2
27261,58thStGreenway22ndAve,04/09/2017 09:00:00 PM,48,-122,2,0,2
27262,58thStGreenway22ndAve,04/09/2017 10:00:00 PM,48,-122,1,0,1
27263,58thStGreenway22ndAve,04/09/2017 11:00:00 PM,48,-122,0,0,0
27264,58thStGreenway22ndAve,04/10/2017 12:00:00 AM,48,-122,0,0,0
27265,58thStGreenway22ndAve,04/10/2017 01:00:00 AM,48,-122,0,0,0
27266,58thStGreenway22ndAve,04/10/2017 02:00:00 AM,48,-122,0,0,0
27267,58thStGreenway22ndAve,04/10/2017 03:00:00 AM,48,-122,0,0,0
27268,58thStGreenway22ndAve,04/10/2017 04:00:00 AM,48,-122,0,0,0
27269,58thStGreenway22ndAve,04/10/2017 05:00:00 AM,48,-122,0,0,0
27270,58thStGreenway22ndAve,04/10/2017 06:00:00 AM,48,-122,0,0,0
27271,58thStGreenway22ndAve,04/10/2017 07:00:00 AM,48,-122,3,0,3
27272,58thStGreenway22ndAve,04/10/2017 08:00:00 AM,48,-122,2,0,2
27273,58thStGreenway22ndAve,04/10/2017 09:00:00 AM,48,-122,5,1,6
27274,58thStGreenway22ndAve,04/10/2017 10:00:00 AM,48,-122,1,0,1
27275,58thStGreenway22ndAve,04/10/2017 11:00:00 AM,48,-122,2,1,3
27276,58thStGreenway22ndAve,04/10/2017 12:00:00 PM,48,-122,1,0,1
27277,58thStGreenway22ndAve,04/10/2017 01:00:00 PM,48,-122,0,0,0
27278,58thStGreenway22ndAve,04/10/2017 02:00:00 PM,48,-122,4,3,7
27279,58thStGreenway22ndAve,04/10/2017 03:00:00 PM,48,-122,0,3,3
27280,58thStGreenway22ndAve,04/10/2017 04:00:00 PM,48,-122,1,0,1
27281,58thStGreenway22ndAve,04/10/2017 05:00:00 PM,48,-122,0,1,1
27282,58thStGreenway22ndAve,04/10/2017 06:00:00 PM,48,-122,0,1,1
27283,58thStGreenway22ndAve,04/10/2017 07:00:00 PM,48,-122,4,1,5
27284,58thStGreenway22ndAve,04/10/2017 08:00:00 PM,48,-122,4,1,5
27285,58thStGreenway22ndAve,04/10/2017 09:00:00 PM,48,-122,0,0,0
27286,58thStGreenway22ndAve,04/10/2017 10:00:00 PM,48,-122,3,0,3
27287,58thStGreenway22ndAve,04/10/2017 11:00:00 PM,48,-122,0,0,0
27288,58thStGreenway22ndAve,04/11/2017 12:00:00 AM,48,-122,1,0,1
27289,58thStGreenway22ndAve,04/11/2017 01:00:00 AM,48,-122,0,0,0
27290,58thStGreenway22ndAve,04/11/2017 02:00:00 AM,48,-122,0,0,0
27291,58thStGreenway22ndAve,04/11/2017 03:00:00 AM,48,-122,0,0,0
27292,58thStGreenway22ndAve,04/11/2017 04:00:00 AM,48,-122,0,0,0
27293,58thStGreenway22ndAve,04/11/2017 05:00:00 AM,48,-122,1,0,1
27294,58thStGreenway22ndAve,04/11/2017 06:00:00 AM,48,-122,0,0,0
27295,58thStGreenway22ndAve,04/11/2017 07:00:00 AM,48,-122,2,0,2
27296,58thStGreenway22ndAve,04/11/2017 08:00:00 AM,48,-122,1,1,2
27297,58thStGreenway22ndAve,04/11/2017 09:00:00 AM,48,-122,7,2,9
27298,58thStGreenway22ndAve,04/11/2017 10:00:00 AM,48,-122,2,0,2
27299,58thStGreenway22ndAve,04/11/2017 11:00:00 AM,48,-122,5,0,5
27300,58thStGreenway22ndAve,04/11/2017 12:00:00 PM,48,-122,1,0,1
27301,58thStGreenway22ndAve,04/11/2017 01:00:00 PM,48,-122,2,2,4
27302,58thStGreenway22ndAve,04/11/2017 02:00:00 PM,48,-122,4,0,4
27303,58thStGreenway22ndAve,04/11/2017 03:00:00 PM,48,-122,0,1,1
27304,58thStGreenway22ndAve,04/11/2017 04:00:00 PM,48,-122,1,2,3
27305,58thStGreenway22ndAve,04/11/2017 05:00:00 PM,48,-122,1,1,2
27306,58thStGreenway22ndAve,04/11/2017 06:00:00 PM,48,-122,2,1,3
27307,58thStGreenway22ndAve,04/11/2017 07:00:00 PM,48,-122,0,0,0
27308,58thStGreenway22ndAve,04/11/2017 08:00:00 PM,48,-122,1,0,1
27309,58thStGreenway22ndAve,04/11/2017 09:00:00 PM,48,-122,1,1,2
27310,58thStGreenway22ndAve,04/11/2017 10:00:00 PM,48,-122,1,1,2
27311,58thStGreenway22ndAve,04/11/2017 11:00:00 PM,48,-122,1,0,1
27312,58thStGreenway22ndAve,04/12/2017 12:00:00 AM,48,-122,0,0,0
27313,58thStGreenway22ndAve,04/12/2017 01:00:00 AM,48,-122,0,0,0
27314,58thStGreenway22ndAve,04/12/2017 02:00:00 AM,48,-122,0,0,0
27315,58thStGreenway22ndAve,04/12/2017 03:00:00 AM,48,-122,0,0,0
27316,58thStGreenway22ndAve,04/12/2017 04:00:00 AM,48,-122,0,0,0
27317,58thStGreenway22ndAve,04/12/2017 05:00:00 AM,48,-122,1,0,1
27318,58thStGreenway22ndAve,04/12/2017 06:00:00 AM,48,-122,0,2,2
27319,58thStGreenway22ndAve,04/12/2017 07:00:00 AM,48,-122,2,0,2
27320,58thStGreenway22ndAve,04/12/2017 08:00:00 AM,48,-122,1,1,2
27321,58thStGreenway22ndAve,04/12/2017 09:00:00 AM,48,-122,2,1,3
27322,58thStGreenway22ndAve,04/12/2017 10:00:00 AM,48,-122,1,3,4
27323,58thStGreenway22ndAve,04/12/2017 11:00:00 AM,48,-122,3,2,5
27324,58thStGreenway22ndAve,04/12/2017 12:00:00 PM,48,-122,3,0,3
27325,58thStGreenway22ndAve,04/12/2017 01:00:00 PM,48,-122,0,1,1
27326,58thStGreenway22ndAve,04/12/2017 02:00:00 PM,48,-122,1,0,1
27327,58thStGreenway22ndAve,04/12/2017 03:00:00 PM,48,-122,3,2,5
27328,58thStGreenway22ndAve,04/12/2017 04:00:00 PM,48,-122,3,0,3
27329,58thStGreenway22ndAve,04/12/2017 05:00:00 PM,48,-122,6,4,10
27330,58thStGreenway22ndAve,04/12/2017 06:00:00 PM,48,-122,3,4,7
27331,58thStGreenway22ndAve,04/12/2017 07:00:00 PM,48,-122,0,3,3
27332,58thStGreenway22ndAve,04/12/2017 08:00:00 PM,48,-122,1,0,1
27333,58thStGreenway22ndAve,04/12/2017 09:00:00 PM,48,-122,0,0,0
27334,58thStGreenway22ndAve,04/12/2017 10:00:00 PM,48,-122,0,1,1
27335,58thStGreenway22ndAve,04/12/2017 11:00:00 PM,48,-122,0,0,0
27336,58thStGreenway22ndAve,04/13/2017 12:00:00 AM,48,-122,0,0,0
27337,58thStGreenway22ndAve,04/13/2017 01:00:00 AM,48,-122,0,0,0
27338,58thStGreenway22ndAve,04/13/2017 02:00:00 AM,48,-122,0,1,1
27339,58thStGreenway22ndAve,04/13/2017 03:00:00 AM,48,-122,0,0,0
27340,58thStGreenway22ndAve,04/13/2017 04:00:00 AM,48,-122,0,0,0
27341,58thStGreenway22ndAve,04/13/2017 05:00:00 AM,48,-122,0,0,0
27342,58thStGreenway22ndAve,04/13/2017 06:00:00 AM,48,-122,0,0,0
27343,58thStGreenway22ndAve,04/13/2017 07:00:00 AM,48,-122,4,5,9
27344,58thStGreenway22ndAve,04/13/2017 08:00:00 AM,48,-122,0,4,4
27345,58thStGreenway22ndAve,04/13/2017 09:00:00 AM,48,-122,0,3,3
27346,58thStGreenway22ndAve,04/13/2017 10:00:00 AM,48,-122,0,6,6
27347,58thStGreenway22ndAve,04/13/2017 11:00:00 AM,48,-122,3,2,5
27348,58thStGreenway22ndAve,04/13/2017 12:00:00 PM,48,-122,4,0,4
27349,58thStGreenway22ndAve,04/13/2017 01:00:00 PM,48,-122,3,4,7
27350,58thStGreenway22ndAve,04/13/2017 02:00:00 PM,48,-122,2,12,14
27351,58thStGreenway22ndAve,04/13/2017 03:00:00 PM,48,-122,1,4,5
27352,58thStGreenway22ndAve,04/13/2017 04:00:00 PM,48,-122,0,10,10
27353,58thStGreenway22ndAve,04/13/2017 05:00:00 PM,48,-122,0,15,15
27354,58thStGreenway22ndAve,04/13/2017 06:00:00 PM,48,-122,0,14,14
27355,58thStGreenway22ndAve,04/13/2017 07:00:00 PM,48,-122,5,7,12
27356,58thStGreenway22ndAve,04/13/2017 08:00:00 PM,48,-122,1,9,10
27357,58thStGreenway22ndAve,04/13/2017 09:00:00 PM,48,-122,5,7,12
27358,58thStGreenway22ndAve,04/13/2017 10:00:00 PM,48,-122,0,9,9
27359,58thStGreenway22ndAve,04/13/2017 11:00:00 PM,48,-122,0,3,3
27360,58thStGreenway22ndAve,04/14/2017 12:00:00 AM,48,-122,0,1,1
27361,58thStGreenway22ndAve,04/14/2017 01:00:00 AM,48,-122,0,1,1
27362,58thStGreenway22ndAve,04/14/2017 02:00:00 AM,48,-122,0,0,0
27363,58thStGreenway22ndAve,04/14/2017 03:00:00 AM,48,-122,0,0,0
27364,58thStGreenway22ndAve,04/14/2017 04:00:00 AM,48,-122,0,0,0
27365,58thStGreenway22ndAve,04/14/2017 05:00:00 AM,48,-122,0,0,0
27366,58thStGreenway22ndAve,04/14/2017 06:00:00 AM,48,-122,0,3,3
27367,58thStGreenway22ndAve,04/14/2017 07:00:00 AM,48,-122,1,2,3
27368,58thStGreenway22ndAve,04/14/2017 08:00:00 AM,48,-122,1,5,6
27369,58thStGreenway22ndAve,04/14/2017 09:00:00 AM,48,-122,0,6,6
27370,58thStGreenway22ndAve,04/14/2017 10:00:00 AM,48,-122,2,5,7
27371,58thStGreenway22ndAve,04/14/2017 11:00:00 AM,48,-122,2,4,6
27372,58thStGreenway22ndAve,04/14/2017 12:00:00 PM,48,-122,0,3,3
27373,58thStGreenway22ndAve,04/14/2017 01:00:00 PM,48,-122,1,1,2
27374,58thStGreenway22ndAve,04/14/2017 02:00:00 PM,48,-122,0,5,5
27375,58thStGreenway22ndAve,04/14/2017 03:00:00 PM,48,-122,1,7,8
27376,58thStGreenway22ndAve,04/14/2017 04:00:00 PM,48,-122,5,7,12
27377,58thStGreenway22ndAve,04/14/2017 05:00:00 PM,48,-122,2,10,12
27378,58thStGreenway22ndAve,04/14/2017 06:00:00 PM,48,-122,1,9,10
27379,58thStGreenway22ndAve,04/14/2017 07:00:00 PM,48,-122,0,3,3
27380,58thStGreenway22ndAve,04/14/2017 08:00:00 PM,48,-122,1,8,9
27381,58thStGreenway22ndAve,04/14/2017 09:00:00 PM,48,-122,0,1,1
27382,58thStGreenway22ndAve,04/14/2017 10:00:00 PM,48,-122,1,2,3
27383,58thStGreenway22ndAve,04/14/2017 11:00:00 PM,48,-122,1,2,3
27384,58thStGreenway22ndAve,04/15/2017 12:00:00 AM,48,-122,1,1,2
27385,58thStGreenway22ndAve,04/15/2017 01:00:00 AM,48,-122,3,1,4
27386,58thStGreenway22ndAve,04/15/2017 02:00:00 AM,48,-122,0,0,0
27387,58thStGreenway22ndAve,04/15/2017 03:00:00 AM,48,-122,0,1,1
27388,58thStGreenway22ndAve,04/15/2017 04:00:00 AM,48,-122,0,0,0
27389,58thStGreenway22ndAve,04/15/2017 05:00:00 AM,48,-122,0,0,0
27390,58thStGreenway22ndAve,04/15/2017 06:00:00 AM,48,-122,1,0,1
27391,58thStGreenway22ndAve,04/15/2017 07:00:00 AM,48,-122,2,0,2
27392,58thStGreenway22ndAve,04/15/2017 08:00:00 AM,48,-122,3,1,4
27393,58thStGreenway22ndAve,04/15/2017 09:00:00 AM,48,-122,4,6,10
27394,58thStGreenway22ndAve,04/15/2017 10:00:00 AM,48,-122,0,1,1
27395,58thStGreenway22ndAve,04/15/2017 11:00:00 AM,48,-122,5,1,6
27396,58thStGreenway22ndAve,04/15/2017 12:00:00 PM,48,-122,0,5,5
27397,58thStGreenway22ndAve,04/15/2017 01:00:00 PM,48,-122,2,3,5
27398,58thStGreenway22ndAve,04/15/2017 02:00:00 PM,48,-122,4,5,9
27399,58thStGreenway22ndAve,04/15/2017 03:00:00 PM,48,-122,0,3,3
27400,58thStGreenway22ndAve,04/15/2017 04:00:00 PM,48,-122,0,1,1
27401,58thStGreenway22ndAve,04/15/2017 05:00:00 PM,48,-122,1,5,6
27402,58thStGreenway22ndAve,04/15/2017 06:00:00 PM,48,-122,2,4,6
27403,58thStGreenway22ndAve,04/15/2017 07:00:00 PM,48,-122,1,8,9
27404,58thStGreenway22ndAve,04/15/2017 08:00:00 PM,48,-122,1,0,1
27405,58thStGreenway22ndAve,04/15/2017 09:00:00 PM,48,-122,0,0,0
27406,58thStGreenway22ndAve,04/15/2017 10:00:00 PM,48,-122,0,0,0
27407,58thStGreenway22ndAve,04/15/2017 11:00:00 PM,48,-122,0,0,0
27408,58thStGreenway22ndAve,04/16/2017 12:00:00 AM,48,-122,0,0,0
27409,58thStGreenway22ndAve,04/16/2017 01:00:00 AM,48,-122,0,0,0
27410,58thStGreenway22ndAve,04/16/2017 02:00:00 AM,48,-122,0,0,0
27411,58thStGreenway22ndAve,04/16/2017 03:00:00 AM,48,-122,0,0,0
27412,58thStGreenway22ndAve,04/16/2017 04:00:00 AM,48,-122,0,0,0
27413,58thStGreenway22ndAve,04/16/2017 05:00:00 AM,48,-122,0,0,0
27414,58thStGreenway22ndAve,04/16/2017 06:00:00 AM,48,-122,0,0,0
27415,58thStGreenway22ndAve,04/16/2017 07:00:00 AM,48,-122,0,0,0
27416,58thStGreenway22ndAve,04/16/2017 08:00:00 AM,48,-122,0,0,0
27417,58thStGreenway22ndAve,04/16/2017 09:00:00 AM,48,-122,0,0,0
27418,58thStGreenway22ndAve,04/16/2017 10:00:00 AM,48,-122,1,0,1
27419,58thStGreenway22ndAve,04/16/2017 11:00:00 AM,48,-122,2,5,7
27420,58thStGreenway22ndAve,04/16/2017 12:00:00 PM,48,-122,3,2,5
27421,58thStGreenway22ndAve,04/16/2017 01:00:00 PM,48,-122,2,2,4
27422,58thStGreenway22ndAve,04/16/2017 02:00:00 PM,48,-122,2,4,6
27423,58thStGreenway22ndAve,04/16/2017 03:00:00 PM,48,-122,4,1,5
27424,58thStGreenway22ndAve,04/16/2017 04:00:00 PM,48,-122,2,1,3
27425,58thStGreenway22ndAve,04/16/2017 05:00:00 PM,48,-122,1,2,3
27426,58thStGreenway22ndAve,04/16/2017 06:00:00 PM,48,-122,0,2,2
27427,58thStGreenway22ndAve,04/16/2017 07:00:00 PM,48,-122,0,2,2
27428,58thStGreenway22ndAve,04/16/2017 08:00:00 PM,48,-122,3,2,5
27429,58thStGreenway22ndAve,04/16/2017 09:00:00 PM,48,-122,0,2,2
27430,58thStGreenway22ndAve,04/16/2017 10:00:00 PM,48,-122,0,0,0
27431,58thStGreenway22ndAve,04/16/2017 11:00:00 PM,48,-122,0,0,0
27432,58thStGreenway22ndAve,04/17/2017 12:00:00 AM,48,-122,0,0,0
27433,58thStGreenway22ndAve,04/17/2017 01:00:00 AM,48,-122,0,0,0
27434,58thStGreenway22ndAve,04/17/2017 02:00:00 AM,48,-122,0,0,0
27435,58thStGreenway22ndAve,04/17/2017 03:00:00 AM,48,-122,0,0,0
27436,58thStGreenway22ndAve,04/17/2017 04:00:00 AM,48,-122,0,0,0
27437,58thStGreenway22ndAve,04/17/2017 05:00:00 AM,48,-122,0,0,0
27438,58thStGreenway22ndAve,04/17/2017 06:00:00 AM,48,-122,0,0,0
27439,58thStGreenway22ndAve,04/17/2017 07:00:00 AM,48,-122,1,0,1
27440,58thStGreenway22ndAve,04/17/2017 08:00:00 AM,48,-122,0,3,3
27441,58thStGreenway22ndAve,04/17/2017 09:00:00 AM,48,-122,3,0,3
27442,58thStGreenway22ndAve,04/17/2017 10:00:00 AM,48,-122,0,2,2
27443,58thStGreenway22ndAve,04/17/2017 11:00:00 AM,48,-122,1,2,3
27444,58thStGreenway22ndAve,04/17/2017 12:00:00 PM,48,-122,2,1,3
27445,58thStGreenway22ndAve,04/17/2017 01:00:00 PM,48,-122,3,2,5
27446,58thStGreenway22ndAve,04/17/2017 02:00:00 PM,48,-122,2,0,2
27447,58thStGreenway22ndAve,04/17/2017 03:00:00 PM,48,-122,1,4,5
27448,58thStGreenway22ndAve,04/17/2017 04:00:00 PM,48,-122,5,1,6
27449,58thStGreenway22ndAve,04/17/2017 05:00:00 PM,48,-122,3,4,7
27450,58thStGreenway22ndAve,04/17/2017 06:00:00 PM,48,-122,1,6,7
27451,58thStGreenway22ndAve,04/17/2017 07:00:00 PM,48,-122,1,3,4
27452,58thStGreenway22ndAve,04/17/2017 08:00:00 PM,48,-122,0,2,2
27453,58thStGreenway22ndAve,04/17/2017 09:00:00 PM,48,-122,0,4,4
27454,58thStGreenway22ndAve,04/17/2017 10:00:00 PM,48,-122,0,2,2
27455,58thStGreenway22ndAve,04/17/2017 11:00:00 PM,48,-122,0,2,2
27456,58thStGreenway22ndAve,04/18/2017 12:00:00 AM,48,-122,0,0,0
27457,58thStGreenway22ndAve,04/18/2017 01:00:00 AM,48,-122,0,1,1
27458,58thStGreenway22ndAve,04/18/2017 02:00:00 AM,48,-122,0,1,1
27459,58thStGreenway22ndAve,04/18/2017 03:00:00 AM,48,-122,0,0,0
27460,58thStGreenway22ndAve,04/18/2017 04:00:00 AM,48,-122,0,2,2
27461,58thStGreenway22ndAve,04/18/2017 05:00:00 AM,48,-122,0,1,1
27462,58thStGreenway22ndAve,04/18/2017 06:00:00 AM,48,-122,0,2,2
27463,58thStGreenway22ndAve,04/18/2017 07:00:00 AM,48,-122,0,1,1
27464,58thStGreenway22ndAve,04/18/2017 08:00:00 AM,48,-122,2,2,4
27465,58thStGreenway22ndAve,04/18/2017 09:00:00 AM,48,-122,2,4,6
27466,58thStGreenway22ndAve,04/18/2017 10:00:00 AM,48,-122,0,1,1
27467,58thStGreenway22ndAve,04/18/2017 11:00:00 AM,48,-122,1,0,1
27468,58thStGreenway22ndAve,04/18/2017 12:00:00 PM,48,-122,1,3,4
27469,58thStGreenway22ndAve,04/18/2017 01:00:00 PM,48,-122,1,0,1
27470,58thStGreenway22ndAve,04/18/2017 02:00:00 PM,48,-122,1,1,2
27471,58thStGreenway22ndAve,04/18/2017 03:00:00 PM,48,-122,2,2,4
27472,58thStGreenway22ndAve,04/18/2017 04:00:00 PM,48,-122,0,0,0
27473,58thStGreenway22ndAve,04/18/2017 05:00:00 PM,48,-122,2,1,3
27474,58thStGreenway22ndAve,04/18/2017 06:00:00 PM,48,-122,0,0,0
27475,58thStGreenway22ndAve,04/18/2017 07:00:00 PM,48,-122,0,0,0
27476,58thStGreenway22ndAve,04/18/2017 08:00:00 PM,48,-122,2,0,2
27477,58thStGreenway22ndAve,04/18/2017 09:00:00 PM,48,-122,0,1,1
27478,58thStGreenway22ndAve,04/18/2017 10:00:00 PM,48,-122,0,1,1
27479,58thStGreenway22ndAve,04/18/2017 11:00:00 PM,48,-122,0,0,0
27480,58thStGreenway22ndAve,04/19/2017 12:00:00 AM,48,-122,0,0,0
27481,58thStGreenway22ndAve,04/19/2017 01:00:00 AM,48,-122,0,0,0
27482,58thStGreenway22ndAve,04/19/2017 02:00:00 AM,48,-122,0,0,0
27483,58thStGreenway22ndAve,04/19/2017 03:00:00 AM,48,-122,0,0,0
27484,58thStGreenway22ndAve,04/19/2017 04:00:00 AM,48,-122,0,1,1
27485,58thStGreenway22ndAve,04/19/2017 05:00:00 AM,48,-122,0,3,3
27486,58thStGreenway22ndAve,04/19/2017 06:00:00 AM,48,-122,0,4,4
27487,58thStGreenway22ndAve,04/19/2017 07:00:00 AM,48,-122,6,2,8
27488,58thStGreenway22ndAve,04/19/2017 08:00:00 AM,48,-122,2,8,10
27489,58thStGreenway22ndAve,04/19/2017 09:00:00 AM,48,-122,2,3,5
27490,58thStGreenway22ndAve,04/19/2017 10:00:00 AM,48,-122,1,1,2
27491,58thStGreenway22ndAve,04/19/2017 11:00:00 AM,48,-122,0,6,6
27492,58thStGreenway22ndAve,04/19/2017 12:00:00 PM,48,-122,1,1,2
27493,58thStGreenway22ndAve,04/19/2017 01:00:00 PM,48,-122,1,2,3
27494,58thStGreenway22ndAve,04/19/2017 02:00:00 PM,48,-122,1,0,1
27495,58thStGreenway22ndAve,04/19/2017 03:00:00 PM,48,-122,3,2,5
27496,58thStGreenway22ndAve,04/19/2017 04:00:00 PM,48,-122,3,6,9
27497,58thStGreenway22ndAve,04/19/2017 05:00:00 PM,48,-122,4,10,14
27498,58thStGreenway22ndAve,04/19/2017 06:00:00 PM,48,-122,2,2,4
27499,58thStGreenway22ndAve,04/19/2017 07:00:00 PM,48,-122,2,10,12
27500,58thStGreenway22ndAve,04/19/2017 08:00:00 PM,48,-122,0,5,5
27501,58thStGreenway22ndAve,04/19/2017 09:00:00 PM,48,-122,1,2,3
27502,58thStGreenway22ndAve,04/19/2017 10:00:00 PM,48,-122,0,3,3
27503,58thStGreenway22ndAve,04/19/2017 11:00:00 PM,48,-122,0,2,2
27504,58thStGreenway22ndAve,04/20/2017 12:00:00 AM,48,-122,0,1,1
27505,58thStGreenway22ndAve,04/20/2017 01:00:00 AM,48,-122,0,0,0
27506,58thStGreenway22ndAve,04/20/2017 02:00:00 AM,48,-122,0,0,0
27507,58thStGreenway22ndAve,04/20/2017 03:00:00 AM,48,-122,0,0,0
27508,58thStGreenway22ndAve,04/20/2017 04:00:00 AM,48,-122,0,1,1
27509,58thStGreenway22ndAve,04/20/2017 05:00:00 AM,48,-122,1,0,1
27510,58thStGreenway22ndAve,04/20/2017 06:00:00 AM,48,-122,1,4,5
27511,58thStGreenway22ndAve,04/20/2017 07:00:00 AM,48,-122,2,2,4
27512,58thStGreenway22ndAve,04/20/2017 08:00:00 AM,48,-122,2,1,3
27513,58thStGreenway22ndAve,04/20/2017 09:00:00 AM,48,-122,2,6,8
27514,58thStGreenway22ndAve,04/20/2017 10:00:00 AM,48,-122,0,4,4
27515,58thStGreenway22ndAve,04/20/2017 11:00:00 AM,48,-122,0,0,0
27516,58thStGreenway22ndAve,04/20/2017 12:00:00 PM,48,-122,3,2,5
27517,58thStGreenway22ndAve,04/20/2017 01:00:00 PM,48,-122,0,3,3
27518,58thStGreenway22ndAve,04/20/2017 02:00:00 PM,48,-122,0,0,0
27519,58thStGreenway22ndAve,04/20/2017 03:00:00 PM,48,-122,1,3,4
27520,58thStGreenway22ndAve,04/20/2017 04:00:00 PM,48,-122,3,7,10
27521,58thStGreenway22ndAve,04/20/2017 05:00:00 PM,48,-122,5,12,17
27522,58thStGreenway22ndAve,04/20/2017 06:00:00 PM,48,-122,5,9,14
27523,58thStGreenway22ndAve,04/20/2017 07:00:00 PM,48,-122,0,1,1
27524,58thStGreenway22ndAve,04/20/2017 08:00:00 PM,48,-122,2,5,7
27525,58thStGreenway22ndAve,04/20/2017 09:00:00 PM,48,-122,0,3,3
27526,58thStGreenway22ndAve,04/20/2017 10:00:00 PM,48,-122,0,0,0
27527,58thStGreenway22ndAve,04/20/2017 11:00:00 PM,48,-122,0,1,1
27528,58thStGreenway22ndAve,04/21/2017 12:00:00 AM,48,-122,0,3,3
27529,58thStGreenway22ndAve,04/21/2017 01:00:00 AM,48,-122,0,1,1
27530,58thStGreenway22ndAve,04/21/2017 02:00:00 AM,48,-122,0,1,1
27531,58thStGreenway22ndAve,04/21/2017 03:00:00 AM,48,-122,0,0,0
27532,58thStGreenway22ndAve,04/21/2017 04:00:00 AM,48,-122,0,0,0
27533,58thStGreenway22ndAve,04/21/2017 05:00:00 AM,48,-122,0,1,1
27534,58thStGreenway22ndAve,04/21/2017 06:00:00 AM,48,-122,2,3,5
27535,58thStGreenway22ndAve,04/21/2017 07:00:00 AM,48,-122,2,4,6
27536,58thStGreenway22ndAve,04/21/2017 08:00:00 AM,48,-122,0,3,3
27537,58thStGreenway22ndAve,04/21/2017 09:00:00 AM,48,-122,0,5,5
27538,58thStGreenway22ndAve,04/21/2017 10:00:00 AM,48,-122,0,4,4
27539,58thStGreenway22ndAve,04/21/2017 11:00:00 AM,48,-122,1,2,3
27540,58thStGreenway22ndAve,04/21/2017 12:00:00 PM,48,-122,0,0,0
27541,58thStGreenway22ndAve,04/21/2017 01:00:00 PM,48,-122,0,0,0
27542,58thStGreenway22ndAve,04/21/2017 02:00:00 PM,48,-122,0,0,0
27543,58thStGreenway22ndAve,04/21/2017 03:00:00 PM,48,-122,0,0,0
27544,58thStGreenway22ndAve,04/21/2017 04:00:00 PM,48,-122,0,0,0
27545,58thStGreenway22ndAve,04/21/2017 05:00:00 PM,48,-122,0,0,0
27546,58thStGreenway22ndAve,04/21/2017 06:00:00 PM,48,-122,0,0,0
27547,58thStGreenway22ndAve,04/21/2017 07:00:00 PM,48,-122,0,0,0
27548,58thStGreenway22ndAve,04/21/2017 08:00:00 PM,48,-122,0,0,0
27549,58thStGreenway22ndAve,04/21/2017 09:00:00 PM,48,-122,0,0,0
27550,58thStGreenway22ndAve,04/21/2017 10:00:00 PM,48,-122,0,0,0
27551,58thStGreenway22ndAve,04/21/2017 11:00:00 PM,48,-122,0,0,0
27552,58thStGreenway22ndAve,04/22/2017 12:00:00 AM,48,-122,0,0,0
27553,58thStGreenway22ndAve,04/22/2017 01:00:00 AM,48,-122,0,0,0
27554,58thStGreenway22ndAve,04/22/2017 02:00:00 AM,48,-122,0,0,0
27555,58thStGreenway22ndAve,04/22/2017 03:00:00 AM,48,-122,0,0,0
27556,58thStGreenway22ndAve,04/22/2017 04:00:00 AM,48,-122,0,0,0
27557,58thStGreenway22ndAve,04/22/2017 05:00:00 AM,48,-122,0,0,0
27558,58thStGreenway22ndAve,04/22/2017 06:00:00 AM,48,-122,0,0,0
27559,58thStGreenway22ndAve,04/22/2017 07:00:00 AM,48,-122,0,0,0
27560,58thStGreenway22ndAve,04/22/2017 08:00:00 AM,48,-122,0,0,0
27561,58thStGreenway22ndAve,04/22/2017 09:00:00 AM,48,-122,0,0,0
27562,58thStGreenway22ndAve,04/22/2017 10:00:00 AM,48,-122,0,0,0
27563,58thStGreenway22ndAve,04/22/2017 11:00:00 AM,48,-122,0,0,0
27564,58thStGreenway22ndAve,04/22/2017 12:00:00 PM,48,-122,0,0,0
27565,58thStGreenway22ndAve,04/22/2017 01:00:00 PM,48,-122,0,0,0
27566,58thStGreenway22ndAve,04/22/2017 02:00:00 PM,48,-122,0,0,0
27567,58thStGreenway22ndAve,04/22/2017 03:00:00 PM,48,-122,0,0,0
27568,58thStGreenway22ndAve,04/22/2017 04:00:00 PM,48,-122,0,0,0
27569,58thStGreenway22ndAve,04/22/2017 05:00:00 PM,48,-122,0,0,0
27570,58thStGreenway22ndAve,04/22/2017 06:00:00 PM,48,-122,0,0,0
27571,58thStGreenway22ndAve,04/22/2017 07:00:00 PM,48,-122,0,0,0
27572,58thStGreenway22ndAve,04/22/2017 08:00:00 PM,48,-122,0,0,0
27573,58thStGreenway22ndAve,04/22/2017 09:00:00 PM,48,-122,0,0,0
27574,58thStGreenway22ndAve,04/22/2017 10:00:00 PM,48,-122,0,0,0
27575,58thStGreenway22ndAve,04/22/2017 11:00:00 PM,48,-122,0,0,0
27576,58thStGreenway22ndAve,04/23/2017 12:00:00 AM,48,-122,0,0,0
27577,58thStGreenway22ndAve,04/23/2017 01:00:00 AM,48,-122,0,0,0
27578,58thStGreenway22ndAve,04/23/2017 02:00:00 AM,48,-122,0,0,0
27579,58thStGreenway22ndAve,04/23/2017 03:00:00 AM,48,-122,0,0,0
27580,58thStGreenway22ndAve,04/23/2017 04:00:00 AM,48,-122,0,0,0
27581,58thStGreenway22ndAve,04/23/2017 05:00:00 AM,48,-122,0,0,0
27582,58thStGreenway22ndAve,04/23/2017 06:00:00 AM,48,-122,0,0,0
27583,58thStGreenway22ndAve,04/23/2017 07:00:00 AM,48,-122,0,0,0
27584,58thStGreenway22ndAve,04/23/2017 08:00:00 AM,48,-122,0,0,0
27585,58thStGreenway22ndAve,04/23/2017 09:00:00 AM,48,-122,0,0,0
27586,58thStGreenway22ndAve,04/23/2017 10:00:00 AM,48,-122,0,0,0
27587,58thStGreenway22ndAve,04/23/2017 11:00:00 AM,48,-122,0,0,0
27588,58thStGreenway22ndAve,04/23/2017 12:00:00 PM,48,-122,0,0,0
27589,58thStGreenway22ndAve,04/23/2017 01:00:00 PM,48,-122,0,0,0
27590,58thStGreenway22ndAve,04/23/2017 02:00:00 PM,48,-122,0,0,0
27591,58thStGreenway22ndAve,04/23/2017 03:00:00 PM,48,-122,0,0,0
27592,58thStGreenway22ndAve,04/23/2017 04:00:00 PM,48,-122,0,0,0
27593,58thStGreenway22ndAve,04/23/2017 05:00:00 PM,48,-122,0,0,0
27594,58thStGreenway22ndAve,04/23/2017 06:00:00 PM,48,-122,0,0,0
27595,58thStGreenway22ndAve,04/23/2017 07:00:00 PM,48,-122,0,0,0
27596,58thStGreenway22ndAve,04/23/2017 08:00:00 PM,48,-122,0,0,0
27597,58thStGreenway22ndAve,04/23/2017 09:00:00 PM,48,-122,0,0,0
27598,58thStGreenway22ndAve,04/23/2017 10:00:00 PM,48,-122,0,0,0
27599,58thStGreenway22ndAve,04/23/2017 11:00:00 PM,48,-122,0,0,0
27600,58thStGreenway22ndAve,04/24/2017 12:00:00 AM,48,-122,0,0,0
27601,58thStGreenway22ndAve,04/24/2017 01:00:00 AM,48,-122,0,0,0
27602,58thStGreenway22ndAve,04/24/2017 02:00:00 AM,48,-122,0,0,0
27603,58thStGreenway22ndAve,04/24/2017 03:00:00 AM,48,-122,0,0,0
27604,58thStGreenway22ndAve,04/24/2017 04:00:00 AM,48,-122,0,0,0
27605,58thStGreenway22ndAve,04/24/2017 05:00:00 AM,48,-122,0,0,0
27606,58thStGreenway22ndAve,04/24/2017 06:00:00 AM,48,-122,0,0,0
27607,58thStGreenway22ndAve,04/24/2017 07:00:00 AM,48,-122,0,0,0
27608,58thStGreenway22ndAve,04/24/2017 08:00:00 AM,48,-122,0,0,0
27609,58thStGreenway22ndAve,04/24/2017 09:00:00 AM,48,-122,0,0,0
27610,58thStGreenway22ndAve,04/24/2017 10:00:00 AM,48,-122,0,0,0
27611,58thStGreenway22ndAve,04/24/2017 11:00:00 AM,48,-122,0,0,0
27612,58thStGreenway22ndAve,04/24/2017 12:00:00 PM,48,-122,0,0,0
27613,58thStGreenway22ndAve,04/24/2017 01:00:00 PM,48,-122,0,0,0
27614,58thStGreenway22ndAve,04/24/2017 02:00:00 PM,48,-122,0,0,0
27615,58thStGreenway22ndAve,04/24/2017 03:00:00 PM,48,-122,0,0,0
27616,58thStGreenway22ndAve,04/24/2017 04:00:00 PM,48,-122,0,0,0
27617,58thStGreenway22ndAve,04/24/2017 05:00:00 PM,48,-122,0,0,0
27618,58thStGreenway22ndAve,04/24/2017 06:00:00 PM,48,-122,0,0,0
27619,58thStGreenway22ndAve,04/24/2017 07:00:00 PM,48,-122,0,0,0
27620,58thStGreenway22ndAve,04/24/2017 08:00:00 PM,48,-122,0,0,0
27621,58thStGreenway22ndAve,04/24/2017 09:00:00 PM,48,-122,0,0,0
27622,58thStGreenway22ndAve,04/24/2017 10:00:00 PM,48,-122,0,0,0
27623,58thStGreenway22ndAve,04/24/2017 11:00:00 PM,48,-122,0,0,0
27624,58thStGreenway22ndAve,04/25/2017 12:00:00 AM,48,-122,0,0,0
27625,58thStGreenway22ndAve,04/25/2017 01:00:00 AM,48,-122,0,0,0
27626,58thStGreenway22ndAve,04/25/2017 02:00:00 AM,48,-122,0,0,0
27627,58thStGreenway22ndAve,04/25/2017 03:00:00 AM,48,-122,0,0,0
27628,58thStGreenway22ndAve,04/25/2017 04:00:00 AM,48,-122,0,0,0
27629,58thStGreenway22ndAve,04/25/2017 05:00:00 AM,48,-122,0,0,0
27630,58thStGreenway22ndAve,04/25/2017 06:00:00 AM,48,-122,0,0,0
27631,58thStGreenway22ndAve,04/25/2017 07:00:00 AM,48,-122,0,0,0
27632,58thStGreenway22ndAve,04/25/2017 08:00:00 AM,48,-122,0,0,0
27633,58thStGreenway22ndAve,04/25/2017 09:00:00 AM,48,-122,0,0,0
27634,58thStGreenway22ndAve,04/25/2017 10:00:00 AM,48,-122,0,0,0
27635,58thStGreenway22ndAve,04/25/2017 11:00:00 AM,48,-122,0,0,0
27636,58thStGreenway22ndAve,04/25/2017 12:00:00 PM,48,-122,3,1,4
27637,58thStGreenway22ndAve,04/25/2017 01:00:00 PM,48,-122,6,1,7
27638,58thStGreenway22ndAve,04/25/2017 02:00:00 PM,48,-122,5,4,9
27639,58thStGreenway22ndAve,04/25/2017 03:00:00 PM,48,-122,3,4,7
27640,58thStGreenway22ndAve,04/25/2017 04:00:00 PM,48,-122,1,6,7
27641,58thStGreenway22ndAve,04/25/2017 05:00:00 PM,48,-122,7,7,14
27642,58thStGreenway22ndAve,04/25/2017 06:00:00 PM,48,-122,8,1,9
27643,58thStGreenway22ndAve,04/25/2017 07:00:00 PM,48,-122,3,2,5
27644,58thStGreenway22ndAve,04/25/2017 08:00:00 PM,48,-122,4,4,8
27645,58thStGreenway22ndAve,04/25/2017 09:00:00 PM,48,-122,2,2,4
27646,58thStGreenway22ndAve,04/25/2017 10:00:00 PM,48,-122,0,0,0
27647,58thStGreenway22ndAve,04/25/2017 11:00:00 PM,48,-122,0,2,2
27648,58thStGreenway22ndAve,04/26/2017 12:00:00 AM,48,-122,0,0,0
27649,58thStGreenway22ndAve,04/26/2017 01:00:00 AM,48,-122,0,1,1
27650,58thStGreenway22ndAve,04/26/2017 02:00:00 AM,48,-122,1,0,1
27651,58thStGreenway22ndAve,04/26/2017 03:00:00 AM,48,-122,1,0,1
27652,58thStGreenway22ndAve,04/26/2017 04:00:00 AM,48,-122,0,0,0
27653,58thStGreenway22ndAve,04/26/2017 05:00:00 AM,48,-122,1,0,1
27654,58thStGreenway22ndAve,04/26/2017 06:00:00 AM,48,-122,2,1,3
27655,58thStGreenway22ndAve,04/26/2017 07:00:00 AM,48,-122,4,7,11
27656,58thStGreenway22ndAve,04/26/2017 08:00:00 AM,48,-122,3,1,4
27657,58thStGreenway22ndAve,04/26/2017 09:00:00 AM,48,-122,2,4,6
27658,58thStGreenway22ndAve,04/26/2017 10:00:00 AM,48,-122,4,1,5
27659,58thStGreenway22ndAve,04/26/2017 11:00:00 AM,48,-122,5,3,8
27660,58thStGreenway22ndAve,04/26/2017 12:00:00 PM,48,-122,1,1,2
27661,58thStGreenway22ndAve,04/26/2017 01:00:00 PM,48,-122,1,2,3
27662,58thStGreenway22ndAve,04/26/2017 02:00:00 PM,48,-122,1,3,4
27663,58thStGreenway22ndAve,04/26/2017 03:00:00 PM,48,-122,0,5,5
27664,58thStGreenway22ndAve,04/26/2017 04:00:00 PM,48,-122,2,4,6
27665,58thStGreenway22ndAve,04/26/2017 05:00:00 PM,48,-122,9,6,15
27666,58thStGreenway22ndAve,04/26/2017 06:00:00 PM,48,-122,8,2,10
27667,58thStGreenway22ndAve,04/26/2017 07:00:00 PM,48,-122,2,4,6
27668,58thStGreenway22ndAve,04/26/2017 08:00:00 PM,48,-122,3,2,5
27669,58thStGreenway22ndAve,04/26/2017 09:00:00 PM,48,-122,0,3,3
27670,58thStGreenway22ndAve,04/26/2017 10:00:00 PM,48,-122,2,1,3
27671,58thStGreenway22ndAve,04/26/2017 11:00:00 PM,48,-122,0,0,0
27672,58thStGreenway22ndAve,04/27/2017 12:00:00 AM,48,-122,0,0,0
27673,58thStGreenway22ndAve,04/27/2017 01:00:00 AM,48,-122,0,0,0
27674,58thStGreenway22ndAve,04/27/2017 02:00:00 AM,48,-122,0,0,0
27675,58thStGreenway22ndAve,04/27/2017 03:00:00 AM,48,-122,0,0,0
27676,58thStGreenway22ndAve,04/27/2017 04:00:00 AM,48,-122,0,0,0
27677,58thStGreenway22ndAve,04/27/2017 05:00:00 AM,48,-122,0,0,0
27678,58thStGreenway22ndAve,04/27/2017 06:00:00 AM,48,-122,1,3,4
27679,58thStGreenway22ndAve,04/27/2017 07:00:00 AM,48,-122,0,3,3
27680,58thStGreenway22ndAve,04/27/2017 08:00:00 AM,48,-122,3,4,7
27681,58thStGreenway22ndAve,04/27/2017 09:00:00 AM,48,-122,1,2,3
27682,58thStGreenway22ndAve,04/27/2017 10:00:00 AM,48,-122,7,3,10
27683,58thStGreenway22ndAve,04/27/2017 11:00:00 AM,48,-122,5,5,10
27684,58thStGreenway22ndAve,04/27/2017 12:00:00 PM,48,-122,5,5,10
27685,58thStGreenway22ndAve,04/27/2017 01:00:00 PM,48,-122,2,7,9
27686,58thStGreenway22ndAve,04/27/2017 02:00:00 PM,48,-122,6,2,8
27687,58thStGreenway22ndAve,04/27/2017 03:00:00 PM,48,-122,7,3,10
27688,58thStGreenway22ndAve,04/27/2017 04:00:00 PM,48,-122,8,3,11
27689,58thStGreenway22ndAve,04/27/2017 05:00:00 PM,48,-122,4,5,9
27690,58thStGreenway22ndAve,04/27/2017 06:00:00 PM,48,-122,11,3,14
27691,58thStGreenway22ndAve,04/27/2017 07:00:00 PM,48,-122,3,2,5
27692,58thStGreenway22ndAve,04/27/2017 08:00:00 PM,48,-122,1,0,1
27693,58thStGreenway22ndAve,04/27/2017 09:00:00 PM,48,-122,1,1,2
27694,58thStGreenway22ndAve,04/27/2017 10:00:00 PM,48,-122,0,0,0
27695,58thStGreenway22ndAve,04/27/2017 11:00:00 PM,48,-122,1,2,3
27696,58thStGreenway22ndAve,04/28/2017 12:00:00 AM,48,-122,1,0,1
27697,58thStGreenway22ndAve,04/28/2017 01:00:00 AM,48,-122,0,0,0
27698,58thStGreenway22ndAve,04/28/2017 02:00:00 AM,48,-122,1,0,1
27699,58thStGreenway22ndAve,04/28/2017 03:00:00 AM,48,-122,0,0,0
27700,58thStGreenway22ndAve,04/28/2017 04:00:00 AM,48,-122,0,0,0
27701,58thStGreenway22ndAve,04/28/2017 05:00:00 AM,48,-122,0,0,0
27702,58thStGreenway22ndAve,04/28/2017 06:00:00 AM,48,-122,1,2,3
27703,58thStGreenway22ndAve,04/28/2017 07:00:00 AM,48,-122,1,4,5
27704,58thStGreenway22ndAve,04/28/2017 08:00:00 AM,48,-122,6,3,9
27705,58thStGreenway22ndAve,04/28/2017 09:00:00 AM,48,-122,2,1,3
27706,58thStGreenway22ndAve,04/28/2017 10:00:00 AM,48,-122,0,2,2
27707,58thStGreenway22ndAve,04/28/2017 11:00:00 AM,48,-122,2,5,7
27708,58thStGreenway22ndAve,04/28/2017 12:00:00 PM,48,-122,5,6,11
27709,58thStGreenway22ndAve,04/28/2017 01:00:00 PM,48,-122,3,1,4
27710,58thStGreenway22ndAve,04/28/2017 02:00:00 PM,48,-122,0,0,0
27711,58thStGreenway22ndAve,04/28/2017 03:00:00 PM,48,-122,0,0,0
27712,58thStGreenway22ndAve,04/28/2017 04:00:00 PM,48,-122,0,0,0
27713,58thStGreenway22ndAve,04/28/2017 05:00:00 PM,48,-122,0,0,0
27714,58thStGreenway22ndAve,04/28/2017 06:00:00 PM,48,-122,0,0,0
27715,58thStGreenway22ndAve,04/28/2017 07:00:00 PM,48,-122,0,0,0
27716,58thStGreenway22ndAve,04/28/2017 08:00:00 PM,48,-122,0,0,0
27717,58thStGreenway22ndAve,04/28/2017 09:00:00 PM,48,-122,0,0,0
27718,58thStGreenway22ndAve,04/28/2017 10:00:00 PM,48,-122,0,0,0
27719,58thStGreenway22ndAve,04/28/2017 11:00:00 PM,48,-122,0,1,1
27720,58thStGreenway22ndAve,04/29/2017 12:00:00 AM,48,-122,0,0,0
27721,58thStGreenway22ndAve,04/29/2017 01:00:00 AM,48,-122,0,0,0
27722,58thStGreenway22ndAve,04/29/2017 02:00:00 AM,48,-122,0,0,0
27723,58thStGreenway22ndAve,04/29/2017 03:00:00 AM,48,-122,0,0,0
27724,58thStGreenway22ndAve,04/29/2017 04:00:00 AM,48,-122,0,0,0
27725,58thStGreenway22ndAve,04/29/2017 05:00:00 AM,48,-122,0,0,0
27726,58thStGreenway22ndAve,04/29/2017 06:00:00 AM,48,-122,0,0,0
27727,58thStGreenway22ndAve,04/29/2017 07:00:00 AM,48,-122,0,0,0
27728,58thStGreenway22ndAve,04/29/2017 08:00:00 AM,48,-122,0,0,0
27729,58thStGreenway22ndAve,04/29/2017 09:00:00 AM,48,-122,0,0,0
27730,58thStGreenway22ndAve,04/29/2017 10:00:00 AM,48,-122,0,0,0
27731,58thStGreenway22ndAve,04/29/2017 11:00:00 AM,48,-122,0,0,0
27732,58thStGreenway22ndAve,04/29/2017 12:00:00 PM,48,-122,0,0,0
27733,58thStGreenway22ndAve,04/29/2017 01:00:00 PM,48,-122,0,0,0
27734,58thStGreenway22ndAve,04/29/2017 02:00:00 PM,48,-122,0,0,0
27735,58thStGreenway22ndAve,04/29/2017 03:00:00 PM,48,-122,0,0,0
27736,58thStGreenway22ndAve,04/29/2017 04:00:00 PM,48,-122,0,0,0
27737,58thStGreenway22ndAve,04/29/2017 05:00:00 PM,48,-122,0,0,0
27738,58thStGreenway22ndAve,04/29/2017 06:00:00 PM,48,-122,0,0,0
27739,58thStGreenway22ndAve,04/29/2017 07:00:00 PM,48,-122,0,0,0
27740,58thStGreenway22ndAve,04/29/2017 08:00:00 PM,48,-122,0,0,0
27741,58thStGreenway22ndAve,04/29/2017 09:00:00 PM,48,-122,0,0,0
27742,58thStGreenway22ndAve,04/29/2017 10:00:00 PM,48,-122,0,0,0
27743,58thStGreenway22ndAve,04/29/2017 11:00:00 PM,48,-122,0,0,0
27744,58thStGreenway22ndAve,04/30/2017 12:00:00 AM,48,-122,0,0,0
27745,58thStGreenway22ndAve,04/30/2017 01:00:00 AM,48,-122,0,0,0
27746,58thStGreenway22ndAve,04/30/2017 02:00:00 AM,48,-122,0,0,0
27747,58thStGreenway22ndAve,04/30/2017 03:00:00 AM,48,-122,0,0,0
27748,58thStGreenway22ndAve,04/30/2017 04:00:00 AM,48,-122,0,0,0
27749,58thStGreenway22ndAve,04/30/2017 05:00:00 AM,48,-122,0,0,0
27750,58thStGreenway22ndAve,04/30/2017 06:00:00 AM,48,-122,0,0,0
27751,58thStGreenway22ndAve,04/30/2017 07:00:00 AM,48,-122,0,0,0
27752,58thStGreenway22ndAve,04/30/2017 08:00:00 AM,48,-122,0,0,0
27753,58thStGreenway22ndAve,04/30/2017 09:00:00 AM,48,-122,0,0,0
27754,58thStGreenway22ndAve,04/30/2017 10:00:00 AM,48,-122,0,0,0
27755,58thStGreenway22ndAve,04/30/2017 11:00:00 AM,48,-122,0,0,0
27756,58thStGreenway22ndAve,04/30/2017 12:00:00 PM,48,-122,0,0,0
27757,58thStGreenway22ndAve,04/30/2017 01:00:00 PM,48,-122,0,0,0
27758,58thStGreenway22ndAve,04/30/2017 02:00:00 PM,48,-122,0,0,0
27759,58thStGreenway22ndAve,04/30/2017 03:00:00 PM,48,-122,0,0,0
27760,58thStGreenway22ndAve,04/30/2017 04:00:00 PM,48,-122,0,0,0
27761,58thStGreenway22ndAve,04/30/2017 05:00:00 PM,48,-122,0,0,0
27762,58thStGreenway22ndAve,04/30/2017 06:00:00 PM,48,-122,0,0,0
27763,58thStGreenway22ndAve,04/30/2017 07:00:00 PM,48,-122,0,0,0
27764,58thStGreenway22ndAve,04/30/2017 08:00:00 PM,48,-122,0,0,0
27765,58thStGreenway22ndAve,04/30/2017 09:00:00 PM,48,-122,0,0,0
27766,58thStGreenway22ndAve,04/30/2017 10:00:00 PM,48,-122,0,0,0
27767,58thStGreenway22ndAve,04/30/2017 11:00:00 PM,48,-122,0,0,0
27768,58thStGreenway22ndAve,05/01/2017 12:00:00 AM,48,-122,0,0,0
27769,58thStGreenway22ndAve,05/01/2017 01:00:00 AM,48,-122,0,0,0
27770,58thStGreenway22ndAve,05/01/2017 02:00:00 AM,48,-122,0,0,0
27771,58thStGreenway22ndAve,05/01/2017 03:00:00 AM,48,-122,0,0,0
27772,58thStGreenway22ndAve,05/01/2017 04:00:00 AM,48,-122,0,0,0
27773,58thStGreenway22ndAve,05/01/2017 05:00:00 AM,48,-122,0,0,0
27774,58thStGreenway22ndAve,05/01/2017 06:00:00 AM,48,-122,0,0,0
27775,58thStGreenway22ndAve,05/01/2017 07:00:00 AM,48,-122,0,0,0
27776,58thStGreenway22ndAve,05/01/2017 08:00:00 AM,48,-122,0,0,0
27777,58thStGreenway22ndAve,05/01/2017 09:00:00 AM,48,-122,0,0,0
27778,58thStGreenway22ndAve,05/01/2017 10:00:00 AM,48,-122,0,1,1
27779,58thStGreenway22ndAve,05/01/2017 11:00:00 AM,48,-122,0,0,0
27780,58thStGreenway22ndAve,05/01/2017 12:00:00 PM,48,-122,0,0,0
27781,58thStGreenway22ndAve,05/01/2017 01:00:00 PM,48,-122,0,0,0
27782,58thStGreenway22ndAve,05/01/2017 02:00:00 PM,48,-122,0,0,0
27783,58thStGreenway22ndAve,05/01/2017 03:00:00 PM,48,-122,0,0,0
27784,58thStGreenway22ndAve,05/01/2017 04:00:00 PM,48,-122,0,0,0
27785,58thStGreenway22ndAve,05/01/2017 05:00:00 PM,48,-122,0,0,0
27786,58thStGreenway22ndAve,05/01/2017 06:00:00 PM,48,-122,0,0,0
27787,58thStGreenway22ndAve,05/01/2017 07:00:00 PM,48,-122,0,0,0
27788,58thStGreenway22ndAve,05/01/2017 08:00:00 PM,48,-122,0,0,0
27789,58thStGreenway22ndAve,05/01/2017 09:00:00 PM,48,-122,0,0,0
27790,58thStGreenway22ndAve,05/01/2017 10:00:00 PM,48,-122,0,0,0
27791,58thStGreenway22ndAve,05/01/2017 11:00:00 PM,48,-122,0,0,0
27792,58thStGreenway22ndAve,05/02/2017 12:00:00 AM,48,-122,0,0,0
27793,58thStGreenway22ndAve,05/02/2017 01:00:00 AM,48,-122,0,0,0
27794,58thStGreenway22ndAve,05/02/2017 02:00:00 AM,48,-122,0,0,0
27795,58thStGreenway22ndAve,05/02/2017 03:00:00 AM,48,-122,0,0,0
27796,58thStGreenway22ndAve,05/02/2017 04:00:00 AM,48,-122,0,0,0
27797,58thStGreenway22ndAve,05/02/2017 05:00:00 AM,48,-122,0,0,0
27798,58thStGreenway22ndAve,05/02/2017 06:00:00 AM,48,-122,0,0,0
27799,58thStGreenway22ndAve,05/02/2017 07:00:00 AM,48,-122,0,0,0
27800,58thStGreenway22ndAve,05/02/2017 08:00:00 AM,48,-122,0,0,0
27801,58thStGreenway22ndAve,05/02/2017 09:00:00 AM,48,-122,0,0,0
27802,58thStGreenway22ndAve,05/02/2017 10:00:00 AM,48,-122,0,0,0
27803,58thStGreenway22ndAve,05/02/2017 11:00:00 AM,48,-122,0,0,0
27804,58thStGreenway22ndAve,05/02/2017 12:00:00 PM,48,-122,0,0,0
27805,58thStGreenway22ndAve,05/02/2017 01:00:00 PM,48,-122,0,0,0
27806,58thStGreenway22ndAve,05/02/2017 02:00:00 PM,48,-122,0,0,0
27807,58thStGreenway22ndAve,05/02/2017 03:00:00 PM,48,-122,0,0,0
27808,58thStGreenway22ndAve,05/02/2017 04:00:00 PM,48,-122,0,0,0
27809,58thStGreenway22ndAve,05/02/2017 05:00:00 PM,48,-122,0,0,0
27810,58thStGreenway22ndAve,05/02/2017 06:00:00 PM,48,-122,0,0,0
27811,58thStGreenway22ndAve,05/02/2017 07:00:00 PM,48,-122,0,0,0
27812,58thStGreenway22ndAve,05/02/2017 08:00:00 PM,48,-122,0,0,0
27813,58thStGreenway22ndAve,05/02/2017 09:00:00 PM,48,-122,0,0,0
27814,58thStGreenway22ndAve,05/02/2017 10:00:00 PM,48,-122,0,0,0
27815,58thStGreenway22ndAve,05/02/2017 11:00:00 PM,48,-122,0,0,0
27816,58thStGreenway22ndAve,05/03/2017 12:00:00 AM,48,-122,0,0,0
27817,58thStGreenway22ndAve,05/03/2017 01:00:00 AM,48,-122,0,0,0
27818,58thStGreenway22ndAve,05/03/2017 02:00:00 AM,48,-122,0,0,0
27819,58thStGreenway22ndAve,05/03/2017 03:00:00 AM,48,-122,0,0,0
27820,58thStGreenway22ndAve,05/03/2017 04:00:00 AM,48,-122,0,0,0
27821,58thStGreenway22ndAve,05/03/2017 05:00:00 AM,48,-122,0,0,0
27822,58thStGreenway22ndAve,05/03/2017 06:00:00 AM,48,-122,0,0,0
27823,58thStGreenway22ndAve,05/03/2017 07:00:00 AM,48,-122,0,0,0
27824,58thStGreenway22ndAve,05/03/2017 08:00:00 AM,48,-122,0,0,0
27825,58thStGreenway22ndAve,05/03/2017 09:00:00 AM,48,-122,0,0,0
27826,58thStGreenway22ndAve,05/03/2017 10:00:00 AM,48,-122,0,0,0
27827,58thStGreenway22ndAve,05/03/2017 11:00:00 AM,48,-122,0,0,0
27828,58thStGreenway22ndAve,05/03/2017 12:00:00 PM,48,-122,0,0,0
27829,58thStGreenway22ndAve,05/03/2017 01:00:00 PM,48,-122,1,3,4
27830,58thStGreenway22ndAve,05/03/2017 02:00:00 PM,48,-122,7,4,11
27831,58thStGreenway22ndAve,05/03/2017 03:00:00 PM,48,-122,8,5,13
27832,58thStGreenway22ndAve,05/03/2017 04:00:00 PM,48,-122,11,3,14
27833,58thStGreenway22ndAve,05/03/2017 05:00:00 PM,48,-122,14,11,25
27834,58thStGreenway22ndAve,05/03/2017 06:00:00 PM,48,-122,13,7,20
27835,58thStGreenway22ndAve,05/03/2017 07:00:00 PM,48,-122,16,15,31
27836,58thStGreenway22ndAve,05/03/2017 08:00:00 PM,48,-122,4,3,7
27837,58thStGreenway22ndAve,05/03/2017 09:00:00 PM,48,-122,4,5,9
27838,58thStGreenway22ndAve,05/03/2017 10:00:00 PM,48,-122,0,6,6
27839,58thStGreenway22ndAve,05/03/2017 11:00:00 PM,48,-122,1,1,2
27840,58thStGreenway22ndAve,05/04/2017 12:00:00 AM,48,-122,0,0,0
27841,58thStGreenway22ndAve,05/04/2017 01:00:00 AM,48,-122,0,0,0
27842,58thStGreenway22ndAve,05/04/2017 02:00:00 AM,48,-122,0,1,1
27843,58thStGreenway22ndAve,05/04/2017 03:00:00 AM,48,-122,0,0,0
27844,58thStGreenway22ndAve,05/04/2017 04:00:00 AM,48,-122,0,0,0
27845,58thStGreenway22ndAve,05/04/2017 05:00:00 AM,48,-122,0,1,1
27846,58thStGreenway22ndAve,05/04/2017 06:00:00 AM,48,-122,1,3,4
27847,58thStGreenway22ndAve,05/04/2017 07:00:00 AM,48,-122,2,6,8
27848,58thStGreenway22ndAve,05/04/2017 08:00:00 AM,48,-122,6,4,10
27849,58thStGreenway22ndAve,05/04/2017 09:00:00 AM,48,-122,10,4,14
27850,58thStGreenway22ndAve,05/04/2017 10:00:00 AM,48,-122,4,6,10
27851,58thStGreenway22ndAve,05/04/2017 11:00:00 AM,48,-122,5,7,12
27852,58thStGreenway22ndAve,05/04/2017 12:00:00 PM,48,-122,7,11,18
27853,58thStGreenway22ndAve,05/04/2017 01:00:00 PM,48,-122,7,10,17
27854,58thStGreenway22ndAve,05/04/2017 02:00:00 PM,48,-122,6,8,14
27855,58thStGreenway22ndAve,05/04/2017 03:00:00 PM,48,-122,5,17,22
27856,58thStGreenway22ndAve,05/04/2017 04:00:00 PM,48,-122,3,11,14
27857,58thStGreenway22ndAve,05/04/2017 05:00:00 PM,48,-122,3,8,11
27858,58thStGreenway22ndAve,05/04/2017 06:00:00 PM,48,-122,2,1,3
27859,58thStGreenway22ndAve,05/04/2017 07:00:00 PM,48,-122,4,7,11
27860,58thStGreenway22ndAve,05/04/2017 08:00:00 PM,48,-122,2,8,10
27861,58thStGreenway22ndAve,05/04/2017 09:00:00 PM,48,-122,1,2,3
27862,58thStGreenway22ndAve,05/04/2017 10:00:00 PM,48,-122,1,1,2
27863,58thStGreenway22ndAve,05/04/2017 11:00:00 PM,48,-122,0,1,1
27864,58thStGreenway22ndAve,05/05/2017 12:00:00 AM,48,-122,0,0,0
27865,58thStGreenway22ndAve,05/05/2017 01:00:00 AM,48,-122,0,0,0
27866,58thStGreenway22ndAve,05/05/2017 02:00:00 AM,48,-122,0,1,1
27867,58thStGreenway22ndAve,05/05/2017 03:00:00 AM,48,-122,0,0,0
27868,58thStGreenway22ndAve,05/05/2017 04:00:00 AM,48,-122,0,0,0
27869,58thStGreenway22ndAve,05/05/2017 05:00:00 AM,48,-122,0,2,2
27870,58thStGreenway22ndAve,05/05/2017 06:00:00 AM,48,-122,0,4,4
27871,58thStGreenway22ndAve,05/05/2017 07:00:00 AM,48,-122,3,7,10
27872,58thStGreenway22ndAve,05/05/2017 08:00:00 AM,48,-122,3,6,9
27873,58thStGreenway22ndAve,05/05/2017 09:00:00 AM,48,-122,,,
27874,58thStGreenway22ndAve,05/05/2017 10:00:00 AM,48,-122,2,1,3
27875,58thStGreenway22ndAve,05/05/2017 11:00:00 AM,48,-122,3,6,9
27876,58thStGreenway22ndAve,05/05/2017 12:00:00 PM,48,-122,5,3,8
27877,58thStGreenway22ndAve,05/05/2017 01:00:00 PM,48,-122,2,5,7
27878,58thStGreenway22ndAve,05/05/2017 02:00:00 PM,48,-122,3,0,3
27879,58thStGreenway22ndAve,05/05/2017 03:00:00 PM,48,-122,3,5,8
27880,58thStGreenway22ndAve,05/05/2017 04:00:00 PM,48,-122,10,6,16
27881,58thStGreenway22ndAve,05/05/2017 05:00:00 PM,48,-122,6,8,14
27882,58thStGreenway22ndAve,05/05/2017 06:00:00 PM,48,-122,7,5,12
27883,58thStGreenway22ndAve,05/05/2017 07:00:00 PM,48,-122,7,2,9
27884,58thStGreenway22ndAve,05/05/2017 08:00:00 PM,48,-122,4,0,4
27885,58thStGreenway22ndAve,05/05/2017 09:00:00 PM,48,-122,5,0,5
27886,58thStGreenway22ndAve,05/05/2017 10:00:00 PM,48,-122,0,1,1
27887,58thStGreenway22ndAve,05/05/2017 11:00:00 PM,48,-122,0,0,0
27888,58thStGreenway22ndAve,05/06/2017 12:00:00 AM,48,-122,0,0,0
27889,58thStGreenway22ndAve,05/06/2017 01:00:00 AM,48,-122,0,0,0
27890,58thStGreenway22ndAve,05/06/2017 02:00:00 AM,48,-122,0,0,0
27891,58thStGreenway22ndAve,05/06/2017 03:00:00 AM,48,-122,0,0,0
27892,58thStGreenway22ndAve,05/06/2017 04:00:00 AM,48,-122,0,0,0
27893,58thStGreenway22ndAve,05/06/2017 05:00:00 AM,48,-122,0,1,1
27894,58thStGreenway22ndAve,05/06/2017 06:00:00 AM,48,-122,1,1,2
27895,58thStGreenway22ndAve,05/06/2017 07:00:00 AM,48,-122,5,3,8
27896,58thStGreenway22ndAve,05/06/2017 08:00:00 AM,48,-122,2,1,3
27897,58thStGreenway22ndAve,05/06/2017 09:00:00 AM,48,-122,7,4,11
27898,58thStGreenway22ndAve,05/06/2017 10:00:00 AM,48,-122,6,6,12
27899,58thStGreenway22ndAve,05/06/2017 11:00:00 AM,48,-122,5,9,14
27900,58thStGreenway22ndAve,05/06/2017 12:00:00 PM,48,-122,6,15,21
27901,58thStGreenway22ndAve,05/06/2017 01:00:00 PM,48,-122,4,7,11
27902,58thStGreenway22ndAve,05/06/2017 02:00:00 PM,48,-122,9,10,19
27903,58thStGreenway22ndAve,05/06/2017 03:00:00 PM,48,-122,10,12,22
27904,58thStGreenway22ndAve,05/06/2017 04:00:00 PM,48,-122,7,6,13
27905,58thStGreenway22ndAve,05/06/2017 05:00:00 PM,48,-122,11,13,24
27906,58thStGreenway22ndAve,05/06/2017 06:00:00 PM,48,-122,2,4,6
27907,58thStGreenway22ndAve,05/06/2017 07:00:00 PM,48,-122,7,2,9
27908,58thStGreenway22ndAve,05/06/2017 08:00:00 PM,48,-122,1,0,1
27909,58thStGreenway22ndAve,05/06/2017 09:00:00 PM,48,-122,2,0,2
27910,58thStGreenway22ndAve,05/06/2017 10:00:00 PM,48,-122,0,0,0
27911,58thStGreenway22ndAve,05/06/2017 11:00:00 PM,48,-122,2,1,3
27912,58thStGreenway22ndAve,05/07/2017 12:00:00 AM,48,-122,0,1,1
27913,58thStGreenway22ndAve,05/07/2017 01:00:00 AM,48,-122,0,0,0
27914,58thStGreenway22ndAve,05/07/2017 02:00:00 AM,48,-122,0,0,0
27915,58thStGreenway22ndAve,05/07/2017 03:00:00 AM,48,-122,0,0,0
27916,58thStGreenway22ndAve,05/07/2017 04:00:00 AM,48,-122,0,0,0
27917,58thStGreenway22ndAve,05/07/2017 05:00:00 AM,48,-122,0,0,0
27918,58thStGreenway22ndAve,05/07/2017 06:00:00 AM,48,-122,1,0,1
27919,58thStGreenway22ndAve,05/07/2017 07:00:00 AM,48,-122,0,3,3
27920,58thStGreenway22ndAve,05/07/2017 08:00:00 AM,48,-122,3,3,6
27921,58thStGreenway22ndAve,05/07/2017 09:00:00 AM,48,-122,4,2,6
27922,58thStGreenway22ndAve,05/07/2017 10:00:00 AM,48,-122,5,16,21
27923,58thStGreenway22ndAve,05/07/2017 11:00:00 AM,48,-122,15,13,28
27924,58thStGreenway22ndAve,05/07/2017 12:00:00 PM,48,-122,3,11,14
27925,58thStGreenway22ndAve,05/07/2017 01:00:00 PM,48,-122,16,10,26
27926,58thStGreenway22ndAve,05/07/2017 02:00:00 PM,48,-122,9,8,17
27927,58thStGreenway22ndAve,05/07/2017 03:00:00 PM,48,-122,16,6,22
27928,58thStGreenway22ndAve,05/07/2017 04:00:00 PM,48,-122,10,8,18
27929,58thStGreenway22ndAve,05/07/2017 05:00:00 PM,48,-122,5,5,10
27930,58thStGreenway22ndAve,05/07/2017 06:00:00 PM,48,-122,6,5,11
27931,58thStGreenway22ndAve,05/07/2017 07:00:00 PM,48,-122,2,7,9
27932,58thStGreenway22ndAve,05/07/2017 08:00:00 PM,48,-122,3,7,10
27933,58thStGreenway22ndAve,05/07/2017 09:00:00 PM,48,-122,2,0,2
27934,58thStGreenway22ndAve,05/07/2017 10:00:00 PM,48,-122,0,0,0
27935,58thStGreenway22ndAve,05/07/2017 11:00:00 PM,48,-122,0,0,0
27936,58thStGreenway22ndAve,05/08/2017 12:00:00 AM,48,-122,0,0,0
27937,58thStGreenway22ndAve,05/08/2017 01:00:00 AM,48,-122,0,0,0
27938,58thStGreenway22ndAve,05/08/2017 02:00:00 AM,48,-122,0,0,0
27939,58thStGreenway22ndAve,05/08/2017 03:00:00 AM,48,-122,0,0,0
27940,58thStGreenway22ndAve,05/08/2017 04:00:00 AM,48,-122,1,0,1
27941,58thStGreenway22ndAve,05/08/2017 05:00:00 AM,48,-122,1,1,2
27942,58thStGreenway22ndAve,05/08/2017 06:00:00 AM,48,-122,2,2,4
27943,58thStGreenway22ndAve,05/08/2017 07:00:00 AM,48,-122,6,7,13
27944,58thStGreenway22ndAve,05/08/2017 08:00:00 AM,48,-122,5,3,8
27945,58thStGreenway22ndAve,05/08/2017 09:00:00 AM,48,-122,4,4,8
27946,58thStGreenway22ndAve,05/08/2017 10:00:00 AM,48,-122,7,2,9
27947,58thStGreenway22ndAve,05/08/2017 11:00:00 AM,48,-122,3,4,7
27948,58thStGreenway22ndAve,05/08/2017 12:00:00 PM,48,-122,2,5,7
27949,58thStGreenway22ndAve,05/08/2017 01:00:00 PM,48,-122,7,1,8
27950,58thStGreenway22ndAve,05/08/2017 02:00:00 PM,48,-122,5,5,10
27951,58thStGreenway22ndAve,05/08/2017 03:00:00 PM,48,-122,6,5,11
27952,58thStGreenway22ndAve,05/08/2017 04:00:00 PM,48,-122,11,8,19
27953,58thStGreenway22ndAve,05/08/2017 05:00:00 PM,48,-122,5,12,17
27954,58thStGreenway22ndAve,05/08/2017 06:00:00 PM,48,-122,10,5,15
27955,58thStGreenway22ndAve,05/08/2017 07:00:00 PM,48,-122,7,4,11
27956,58thStGreenway22ndAve,05/08/2017 08:00:00 PM,48,-122,2,7,9
27957,58thStGreenway22ndAve,05/08/2017 09:00:00 PM,48,-122,0,2,2
27958,58thStGreenway22ndAve,05/08/2017 10:00:00 PM,48,-122,0,1,1
27959,58thStGreenway22ndAve,05/08/2017 11:00:00 PM,48,-122,0,0,0
27960,58thStGreenway22ndAve,05/09/2017 12:00:00 AM,48,-122,0,0,0
27961,58thStGreenway22ndAve,05/09/2017 01:00:00 AM,48,-122,1,0,1
27962,58thStGreenway22ndAve,05/09/2017 02:00:00 AM,48,-122,1,1,2
27963,58thStGreenway22ndAve,05/09/2017 03:00:00 AM,48,-122,0,0,0
27964,58thStGreenway22ndAve,05/09/2017 04:00:00 AM,48,-122,0,1,1
27965,58thStGreenway22ndAve,05/09/2017 05:00:00 AM,48,-122,0,1,1
27966,58thStGreenway22ndAve,05/09/2017 06:00:00 AM,48,-122,2,2,4
27967,58thStGreenway22ndAve,05/09/2017 07:00:00 AM,48,-122,5,5,10
27968,58thStGreenway22ndAve,05/09/2017 08:00:00 AM,48,-122,5,9,14
27969,58thStGreenway22ndAve,05/09/2017 09:00:00 AM,48,-122,6,2,8
27970,58thStGreenway22ndAve,05/09/2017 10:00:00 AM,48,-122,5,2,7
27971,58thStGreenway22ndAve,05/09/2017 11:00:00 AM,48,-122,6,3,9
27972,58thStGreenway22ndAve,05/09/2017 12:00:00 PM,48,-122,3,2,5
27973,58thStGreenway22ndAve,05/09/2017 01:00:00 PM,48,-122,4,3,7
27974,58thStGreenway22ndAve,05/09/2017 02:00:00 PM,48,-122,8,7,15
27975,58thStGreenway22ndAve,05/09/2017 03:00:00 PM,48,-122,8,5,13
27976,58thStGreenway22ndAve,05/09/2017 04:00:00 PM,48,-122,12,12,24
27977,58thStGreenway22ndAve,05/09/2017 05:00:00 PM,48,-122,10,8,18
27978,58thStGreenway22ndAve,05/09/2017 06:00:00 PM,48,-122,9,7,16
27979,58thStGreenway22ndAve,05/09/2017 07:00:00 PM,48,-122,7,14,21
27980,58thStGreenway22ndAve,05/09/2017 08:00:00 PM,48,-122,2,8,10
27981,58thStGreenway22ndAve,05/09/2017 09:00:00 PM,48,-122,0,2,2
27982,58thStGreenway22ndAve,05/09/2017 10:00:00 PM,48,-122,2,3,5
27983,58thStGreenway22ndAve,05/09/2017 11:00:00 PM,48,-122,0,2,2
27984,58thStGreenway22ndAve,05/10/2017 12:00:00 AM,48,-122,2,1,3
27985,58thStGreenway22ndAve,05/10/2017 01:00:00 AM,48,-122,0,0,0
27986,58thStGreenway22ndAve,05/10/2017 02:00:00 AM,48,-122,0,0,0
27987,58thStGreenway22ndAve,05/10/2017 03:00:00 AM,48,-122,1,0,1
27988,58thStGreenway22ndAve,05/10/2017 04:00:00 AM,48,-122,1,0,1
27989,58thStGreenway22ndAve,05/10/2017 05:00:00 AM,48,-122,1,0,1
27990,58thStGreenway22ndAve,05/10/2017 06:00:00 AM,48,-122,2,1,3
27991,58thStGreenway22ndAve,05/10/2017 07:00:00 AM,48,-122,5,10,15
27992,58thStGreenway22ndAve,05/10/2017 08:00:00 AM,48,-122,8,7,15
27993,58thStGreenway22ndAve,05/10/2017 09:00:00 AM,48,-122,6,4,10
27994,58thStGreenway22ndAve,05/10/2017 10:00:00 AM,48,-122,7,2,9
27995,58thStGreenway22ndAve,05/10/2017 11:00:00 AM,48,-122,6,4,10
27996,58thStGreenway22ndAve,05/10/2017 12:00:00 PM,48,-122,4,2,6
27997,58thStGreenway22ndAve,05/10/2017 01:00:00 PM,48,-122,6,4,10
27998,58thStGreenway22ndAve,05/10/2017 02:00:00 PM,48,-122,8,5,13
27999,58thStGreenway22ndAve,05/10/2017 03:00:00 PM,48,-122,4,9,13
28000,58thStGreenway22ndAve,05/10/2017 04:00:00 PM,48,-122,13,9,22
28001,58thStGreenway22ndAve,05/10/2017 05:00:00 PM,48,-122,12,6,18
28002,58thStGreenway22ndAve,05/10/2017 06:00:00 PM,48,-122,9,6,15
28003,58thStGreenway22ndAve,05/10/2017 07:00:00 PM,48,-122,4,3,7
28004,58thStGreenway22ndAve,05/10/2017 08:00:00 PM,48,-122,4,3,7
28005,58thStGreenway22ndAve,05/10/2017 09:00:00 PM,48,-122,3,0,3
28006,58thStGreenway22ndAve,05/10/2017 10:00:00 PM,48,-122,0,1,1
28007,58thStGreenway22ndAve,05/10/2017 11:00:00 PM,48,-122,0,0,0
28008,58thStGreenway22ndAve,05/11/2017 12:00:00 AM,48,-122,0,0,0
28009,58thStGreenway22ndAve,05/11/2017 01:00:00 AM,48,-122,0,0,0
28010,58thStGreenway22ndAve,05/11/2017 02:00:00 AM,48,-122,0,0,0
28011,58thStGreenway22ndAve,05/11/2017 03:00:00 AM,48,-122,0,0,0
28012,58thStGreenway22ndAve,05/11/2017 04:00:00 AM,48,-122,0,1,1
28013,58thStGreenway22ndAve,05/11/2017 05:00:00 AM,48,-122,0,0,0
28014,58thStGreenway22ndAve,05/11/2017 06:00:00 AM,48,-122,1,2,3
28015,58thStGreenway22ndAve,05/11/2017 07:00:00 AM,48,-122,1,2,3
28016,58thStGreenway22ndAve,05/11/2017 08:00:00 AM,48,-122,5,3,8
28017,58thStGreenway22ndAve,05/11/2017 09:00:00 AM,48,-122,1,1,2
28018,58thStGreenway22ndAve,05/11/2017 10:00:00 AM,48,-122,2,3,5
28019,58thStGreenway22ndAve,05/11/2017 11:00:00 AM,48,-122,1,2,3
28020,58thStGreenway22ndAve,05/11/2017 12:00:00 PM,48,-122,0,4,4
28021,58thStGreenway22ndAve,05/11/2017 01:00:00 PM,48,-122,2,1,3
28022,58thStGreenway22ndAve,05/11/2017 02:00:00 PM,48,-122,1,5,6
28023,58thStGreenway22ndAve,05/11/2017 03:00:00 PM,48,-122,3,3,6
28024,58thStGreenway22ndAve,05/11/2017 04:00:00 PM,48,-122,6,4,10
28025,58thStGreenway22ndAve,05/11/2017 05:00:00 PM,48,-122,5,6,11
28026,58thStGreenway22ndAve,05/11/2017 06:00:00 PM,48,-122,10,7,17
28027,58thStGreenway22ndAve,05/11/2017 07:00:00 PM,48,-122,2,3,5
28028,58thStGreenway22ndAve,05/11/2017 08:00:00 PM,48,-122,1,0,1
28029,58thStGreenway22ndAve,05/11/2017 09:00:00 PM,48,-122,1,1,2
28030,58thStGreenway22ndAve,05/11/2017 10:00:00 PM,48,-122,0,0,0
28031,58thStGreenway22ndAve,05/11/2017 11:00:00 PM,48,-122,0,0,0
28032,58thStGreenway22ndAve,05/12/2017 12:00:00 AM,48,-122,0,0,0
28033,58thStGreenway22ndAve,05/12/2017 01:00:00 AM,48,-122,1,0,1
28034,58thStGreenway22ndAve,05/12/2017 02:00:00 AM,48,-122,0,1,1
28035,58thStGreenway22ndAve,05/12/2017 03:00:00 AM,48,-122,0,0,0
28036,58thStGreenway22ndAve,05/12/2017 04:00:00 AM,48,-122,0,0,0
28037,58thStGreenway22ndAve,05/12/2017 05:00:00 AM,48,-122,0,1,1
28038,58thStGreenway22ndAve,05/12/2017 06:00:00 AM,48,-122,3,1,4
28039,58thStGreenway22ndAve,05/12/2017 07:00:00 AM,48,-122,3,3,6
28040,58thStGreenway22ndAve,05/12/2017 08:00:00 AM,48,-122,7,4,11
28041,58thStGreenway22ndAve,05/12/2017 09:00:00 AM,48,-122,0,0,0
28042,58thStGreenway22ndAve,05/12/2017 10:00:00 AM,48,-122,0,0,0
28043,58thStGreenway22ndAve,05/12/2017 11:00:00 AM,48,-122,0,0,0
28044,58thStGreenway22ndAve,05/12/2017 12:00:00 PM,48,-122,0,0,0
28045,58thStGreenway22ndAve,05/12/2017 01:00:00 PM,48,-122,0,0,0
28046,58thStGreenway22ndAve,05/12/2017 02:00:00 PM,48,-122,0,0,0
28047,58thStGreenway22ndAve,05/12/2017 03:00:00 PM,48,-122,1,0,1
28048,58thStGreenway22ndAve,05/12/2017 04:00:00 PM,48,-122,0,0,0
28049,58thStGreenway22ndAve,05/12/2017 05:00:00 PM,48,-122,0,0,0
28050,58thStGreenway22ndAve,05/12/2017 06:00:00 PM,48,-122,0,0,0
28051,58thStGreenway22ndAve,05/12/2017 07:00:00 PM,48,-122,0,0,0
28052,58thStGreenway22ndAve,05/12/2017 08:00:00 PM,48,-122,0,0,0
28053,58thStGreenway22ndAve,05/12/2017 09:00:00 PM,48,-122,0,0,0
28054,58thStGreenway22ndAve,05/12/2017 10:00:00 PM,48,-122,0,0,0
28055,58thStGreenway22ndAve,05/12/2017 11:00:00 PM,48,-122,0,0,0
28056,58thStGreenway22ndAve,05/13/2017 12:00:00 AM,48,-122,0,0,0
28057,58thStGreenway22ndAve,05/13/2017 01:00:00 AM,48,-122,0,0,0
28058,58thStGreenway22ndAve,05/13/2017 02:00:00 AM,48,-122,0,0,0
28059,58thStGreenway22ndAve,05/13/2017 03:00:00 AM,48,-122,0,0,0
28060,58thStGreenway22ndAve,05/13/2017 04:00:00 AM,48,-122,0,0,0
28061,58thStGreenway22ndAve,05/13/2017 05:00:00 AM,48,-122,0,0,0
28062,58thStGreenway22ndAve,05/13/2017 06:00:00 AM,48,-122,0,0,0
28063,58thStGreenway22ndAve,05/13/2017 07:00:00 AM,48,-122,0,0,0
28064,58thStGreenway22ndAve,05/13/2017 08:00:00 AM,48,-122,0,0,0
28065,58thStGreenway22ndAve,05/13/2017 09:00:00 AM,48,-122,0,0,0
28066,58thStGreenway22ndAve,05/13/2017 10:00:00 AM,48,-122,0,0,0
28067,58thStGreenway22ndAve,05/13/2017 11:00:00 AM,48,-122,0,0,0
28068,58thStGreenway22ndAve,05/13/2017 12:00:00 PM,48,-122,0,0,0
28069,58thStGreenway22ndAve,05/13/2017 01:00:00 PM,48,-122,0,0,0
28070,58thStGreenway22ndAve,05/13/2017 02:00:00 PM,48,-122,0,0,0
28071,58thStGreenway22ndAve,05/13/2017 03:00:00 PM,48,-122,0,1,1
28072,58thStGreenway22ndAve,05/13/2017 04:00:00 PM,48,-122,0,1,1
28073,58thStGreenway22ndAve,05/13/2017 05:00:00 PM,48,-122,0,0,0
28074,58thStGreenway22ndAve,05/13/2017 06:00:00 PM,48,-122,0,0,0
28075,58thStGreenway22ndAve,05/13/2017 07:00:00 PM,48,-122,0,0,0
28076,58thStGreenway22ndAve,05/13/2017 08:00:00 PM,48,-122,0,0,0
28077,58thStGreenway22ndAve,05/13/2017 09:00:00 PM,48,-122,0,0,0
28078,58thStGreenway22ndAve,05/13/2017 10:00:00 PM,48,-122,1,0,1
28079,58thStGreenway22ndAve,05/13/2017 11:00:00 PM,48,-122,0,0,0
28080,58thStGreenway22ndAve,05/14/2017 12:00:00 AM,48,-122,0,0,0
28081,58thStGreenway22ndAve,05/14/2017 01:00:00 AM,48,-122,0,0,0
28082,58thStGreenway22ndAve,05/14/2017 02:00:00 AM,48,-122,0,0,0
28083,58thStGreenway22ndAve,05/14/2017 03:00:00 AM,48,-122,0,0,0
28084,58thStGreenway22ndAve,05/14/2017 04:00:00 AM,48,-122,0,0,0
28085,58thStGreenway22ndAve,05/14/2017 05:00:00 AM,48,-122,0,0,0
28086,58thStGreenway22ndAve,05/14/2017 06:00:00 AM,48,-122,0,0,0
28087,58thStGreenway22ndAve,05/14/2017 07:00:00 AM,48,-122,0,0,0
28088,58thStGreenway22ndAve,05/14/2017 08:00:00 AM,48,-122,0,0,0
28089,58thStGreenway22ndAve,05/14/2017 09:00:00 AM,48,-122,0,0,0
28090,58thStGreenway22ndAve,05/14/2017 10:00:00 AM,48,-122,0,0,0
28091,58thStGreenway22ndAve,05/14/2017 11:00:00 AM,48,-122,0,0,0
28092,58thStGreenway22ndAve,05/14/2017 12:00:00 PM,48,-122,0,0,0
28093,58thStGreenway22ndAve,05/14/2017 01:00:00 PM,48,-122,0,0,0
28094,58thStGreenway22ndAve,05/14/2017 02:00:00 PM,48,-122,0,0,0
28095,58thStGreenway22ndAve,05/14/2017 03:00:00 PM,48,-122,0,0,0
28096,58thStGreenway22ndAve,05/14/2017 04:00:00 PM,48,-122,0,0,0
28097,58thStGreenway22ndAve,05/14/2017 05:00:00 PM,48,-122,0,0,0
28098,58thStGreenway22ndAve,05/14/2017 06:00:00 PM,48,-122,0,1,1
28099,58thStGreenway22ndAve,05/14/2017 07:00:00 PM,48,-122,0,0,0
28100,58thStGreenway22ndAve,05/14/2017 08:00:00 PM,48,-122,0,0,0
28101,58thStGreenway22ndAve,05/14/2017 09:00:00 PM,48,-122,0,0,0
28102,58thStGreenway22ndAve,05/14/2017 10:00:00 PM,48,-122,0,0,0
28103,58thStGreenway22ndAve,05/14/2017 11:00:00 PM,48,-122,0,0,0
28104,58thStGreenway22ndAve,05/15/2017 12:00:00 AM,48,-122,0,0,0
28105,58thStGreenway22ndAve,05/15/2017 01:00:00 AM,48,-122,0,0,0
28106,58thStGreenway22ndAve,05/15/2017 02:00:00 AM,48,-122,0,0,0
28107,58thStGreenway22ndAve,05/15/2017 03:00:00 AM,48,-122,0,0,0
28108,58thStGreenway22ndAve,05/15/2017 04:00:00 AM,48,-122,0,0,0
28109,58thStGreenway22ndAve,05/15/2017 05:00:00 AM,48,-122,0,0,0
28110,58thStGreenway22ndAve,05/15/2017 06:00:00 AM,48,-122,1,0,1
28111,58thStGreenway22ndAve,05/15/2017 07:00:00 AM,48,-122,0,0,0
28112,58thStGreenway22ndAve,05/15/2017 08:00:00 AM,48,-122,0,0,0
28113,58thStGreenway22ndAve,05/15/2017 09:00:00 AM,48,-122,0,0,0
28114,58thStGreenway22ndAve,05/15/2017 10:00:00 AM,48,-122,0,0,0
28115,58thStGreenway22ndAve,05/15/2017 11:00:00 AM,48,-122,0,0,0
28116,58thStGreenway22ndAve,05/15/2017 12:00:00 PM,48,-122,0,0,0
28117,58thStGreenway22ndAve,05/15/2017 01:00:00 PM,48,-122,0,0,0
28118,58thStGreenway22ndAve,05/15/2017 02:00:00 PM,48,-122,0,0,0
28119,58thStGreenway22ndAve,05/15/2017 03:00:00 PM,48,-122,0,0,0
28120,58thStGreenway22ndAve,05/15/2017 04:00:00 PM,48,-122,0,0,0
28121,58thStGreenway22ndAve,05/15/2017 05:00:00 PM,48,-122,0,0,0
28122,58thStGreenway22ndAve,05/15/2017 06:00:00 PM,48,-122,0,0,0
28123,58thStGreenway22ndAve,05/15/2017 07:00:00 PM,48,-122,0,0,0
28124,58thStGreenway22ndAve,05/15/2017 08:00:00 PM,48,-122,0,0,0
28125,58thStGreenway22ndAve,05/15/2017 09:00:00 PM,48,-122,0,0,0
28126,58thStGreenway22ndAve,05/15/2017 10:00:00 PM,48,-122,0,0,0
28127,58thStGreenway22ndAve,05/15/2017 11:00:00 PM,48,-122,0,0,0
28128,58thStGreenway22ndAve,05/16/2017 12:00:00 AM,48,-122,0,0,0
28129,58thStGreenway22ndAve,05/16/2017 01:00:00 AM,48,-122,0,0,0
28130,58thStGreenway22ndAve,05/16/2017 02:00:00 AM,48,-122,0,0,0
28131,58thStGreenway22ndAve,05/16/2017 03:00:00 AM,48,-122,0,0,0
28132,58thStGreenway22ndAve,05/16/2017 04:00:00 AM,48,-122,0,0,0
28133,58thStGreenway22ndAve,05/16/2017 05:00:00 AM,48,-122,0,0,0
28134,58thStGreenway22ndAve,05/16/2017 06:00:00 AM,48,-122,0,0,0
28135,58thStGreenway22ndAve,05/16/2017 07:00:00 AM,48,-122,0,0,0
28136,58thStGreenway22ndAve,05/16/2017 08:00:00 AM,48,-122,0,0,0
28137,58thStGreenway22ndAve,05/16/2017 09:00:00 AM,48,-122,0,0,0
28138,58thStGreenway22ndAve,05/16/2017 10:00:00 AM,48,-122,0,0,0
28139,58thStGreenway22ndAve,05/16/2017 11:00:00 AM,48,-122,0,0,0
28140,58thStGreenway22ndAve,05/16/2017 12:00:00 PM,48,-122,0,0,0
28141,58thStGreenway22ndAve,05/16/2017 01:00:00 PM,48,-122,0,0,0
28142,58thStGreenway22ndAve,05/16/2017 02:00:00 PM,48,-122,0,0,0
28143,58thStGreenway22ndAve,05/16/2017 03:00:00 PM,48,-122,0,0,0
28144,58thStGreenway22ndAve,05/16/2017 04:00:00 PM,48,-122,0,0,0
28145,58thStGreenway22ndAve,05/16/2017 05:00:00 PM,48,-122,0,0,0
28146,58thStGreenway22ndAve,05/16/2017 06:00:00 PM,48,-122,0,0,0
28147,58thStGreenway22ndAve,05/16/2017 07:00:00 PM,48,-122,0,0,0
28148,58thStGreenway22ndAve,05/16/2017 08:00:00 PM,48,-122,0,0,0
28149,58thStGreenway22ndAve,05/16/2017 09:00:00 PM,48,-122,0,0,0
28150,58thStGreenway22ndAve,05/16/2017 10:00:00 PM,48,-122,0,0,0
28151,58thStGreenway22ndAve,05/16/2017 11:00:00 PM,48,-122,0,0,0
28152,58thStGreenway22ndAve,05/17/2017 12:00:00 AM,48,-122,0,0,0
28153,58thStGreenway22ndAve,05/17/2017 01:00:00 AM,48,-122,0,0,0
28154,58thStGreenway22ndAve,05/17/2017 02:00:00 AM,48,-122,0,0,0
28155,58thStGreenway22ndAve,05/17/2017 03:00:00 AM,48,-122,0,0,0
28156,58thStGreenway22ndAve,05/17/2017 04:00:00 AM,48,-122,0,0,0
28157,58thStGreenway22ndAve,05/17/2017 05:00:00 AM,48,-122,0,0,0
28158,58thStGreenway22ndAve,05/17/2017 06:00:00 AM,48,-122,0,0,0
28159,58thStGreenway22ndAve,05/17/2017 07:00:00 AM,48,-122,0,0,0
28160,58thStGreenway22ndAve,05/17/2017 08:00:00 AM,48,-122,0,0,0
28161,58thStGreenway22ndAve,05/17/2017 09:00:00 AM,48,-122,0,0,0
28162,58thStGreenway22ndAve,05/17/2017 10:00:00 AM,48,-122,0,0,0
28163,58thStGreenway22ndAve,05/17/2017 11:00:00 AM,48,-122,0,0,0
28164,58thStGreenway22ndAve,05/17/2017 12:00:00 PM,48,-122,0,0,0
28165,58thStGreenway22ndAve,05/17/2017 01:00:00 PM,48,-122,0,0,0
28166,58thStGreenway22ndAve,05/17/2017 02:00:00 PM,48,-122,0,0,0
28167,58thStGreenway22ndAve,05/17/2017 03:00:00 PM,48,-122,0,0,0
28168,58thStGreenway22ndAve,05/17/2017 04:00:00 PM,48,-122,0,0,0
28169,58thStGreenway22ndAve,05/17/2017 05:00:00 PM,48,-122,0,0,0
28170,58thStGreenway22ndAve,05/17/2017 06:00:00 PM,48,-122,0,0,0
28171,58thStGreenway22ndAve,05/17/2017 07:00:00 PM,48,-122,0,0,0
28172,58thStGreenway22ndAve,05/17/2017 08:00:00 PM,48,-122,0,0,0
28173,58thStGreenway22ndAve,05/17/2017 09:00:00 PM,48,-122,0,0,0
28174,58thStGreenway22ndAve,05/17/2017 10:00:00 PM,48,-122,0,0,0
28175,58thStGreenway22ndAve,05/17/2017 11:00:00 PM,48,-122,0,0,0
28176,58thStGreenway22ndAve,05/18/2017 12:00:00 AM,48,-122,0,0,0
28177,58thStGreenway22ndAve,05/18/2017 01:00:00 AM,48,-122,0,0,0
28178,58thStGreenway22ndAve,05/18/2017 02:00:00 AM,48,-122,0,0,0
28179,58thStGreenway22ndAve,05/18/2017 03:00:00 AM,48,-122,0,0,0
28180,58thStGreenway22ndAve,05/18/2017 04:00:00 AM,48,-122,0,0,0
28181,58thStGreenway22ndAve,05/18/2017 05:00:00 AM,48,-122,0,0,0
28182,58thStGreenway22ndAve,05/18/2017 06:00:00 AM,48,-122,0,0,0
28183,58thStGreenway22ndAve,05/18/2017 07:00:00 AM,48,-122,0,0,0
28184,58thStGreenway22ndAve,05/18/2017 08:00:00 AM,48,-122,0,0,0
28185,58thStGreenway22ndAve,05/18/2017 09:00:00 AM,48,-122,0,0,0
28186,58thStGreenway22ndAve,05/18/2017 10:00:00 AM,48,-122,0,0,0
28187,58thStGreenway22ndAve,05/18/2017 11:00:00 AM,48,-122,0,0,0
28188,58thStGreenway22ndAve,05/18/2017 12:00:00 PM,48,-122,0,0,0
28189,58thStGreenway22ndAve,05/18/2017 01:00:00 PM,48,-122,0,0,0
28190,58thStGreenway22ndAve,05/18/2017 02:00:00 PM,48,-122,0,0,0
28191,58thStGreenway22ndAve,05/18/2017 03:00:00 PM,48,-122,0,0,0
28192,58thStGreenway22ndAve,05/18/2017 04:00:00 PM,48,-122,0,0,0
28193,58thStGreenway22ndAve,05/18/2017 05:00:00 PM,48,-122,0,0,0
28194,58thStGreenway22ndAve,05/18/2017 06:00:00 PM,48,-122,0,0,0
28195,58thStGreenway22ndAve,05/18/2017 07:00:00 PM,48,-122,0,0,0
28196,58thStGreenway22ndAve,05/18/2017 08:00:00 PM,48,-122,0,0,0
28197,58thStGreenway22ndAve,05/18/2017 09:00:00 PM,48,-122,0,0,0
28198,58thStGreenway22ndAve,05/18/2017 10:00:00 PM,48,-122,0,0,0
28199,58thStGreenway22ndAve,05/18/2017 11:00:00 PM,48,-122,0,0,0
28200,58thStGreenway22ndAve,05/19/2017 12:00:00 AM,48,-122,0,0,0
28201,58thStGreenway22ndAve,05/19/2017 01:00:00 AM,48,-122,0,0,0
28202,58thStGreenway22ndAve,05/19/2017 02:00:00 AM,48,-122,0,0,0
28203,58thStGreenway22ndAve,05/19/2017 03:00:00 AM,48,-122,0,0,0
28204,58thStGreenway22ndAve,05/19/2017 04:00:00 AM,48,-122,0,0,0
28205,58thStGreenway22ndAve,05/19/2017 05:00:00 AM,48,-122,0,0,0
28206,58thStGreenway22ndAve,05/19/2017 06:00:00 AM,48,-122,0,0,0
28207,58thStGreenway22ndAve,05/19/2017 07:00:00 AM,48,-122,0,0,0
28208,58thStGreenway22ndAve,05/19/2017 08:00:00 AM,48,-122,0,0,0
28209,58thStGreenway22ndAve,05/19/2017 09:00:00 AM,48,-122,0,0,0
28210,58thStGreenway22ndAve,05/19/2017 10:00:00 AM,48,-122,0,0,0
28211,58thStGreenway22ndAve,05/19/2017 11:00:00 AM,48,-122,0,0,0
28212,58thStGreenway22ndAve,05/19/2017 12:00:00 PM,48,-122,0,0,0
28213,58thStGreenway22ndAve,05/19/2017 01:00:00 PM,48,-122,0,0,0
28214,58thStGreenway22ndAve,05/19/2017 02:00:00 PM,48,-122,0,0,0
28215,58thStGreenway22ndAve,05/19/2017 03:00:00 PM,48,-122,0,0,0
28216,58thStGreenway22ndAve,05/19/2017 04:00:00 PM,48,-122,0,0,0
28217,58thStGreenway22ndAve,05/19/2017 05:00:00 PM,48,-122,0,0,0
28218,58thStGreenway22ndAve,05/19/2017 06:00:00 PM,48,-122,0,0,0
28219,58thStGreenway22ndAve,05/19/2017 07:00:00 PM,48,-122,0,0,0
28220,58thStGreenway22ndAve,05/19/2017 08:00:00 PM,48,-122,0,0,0
28221,58thStGreenway22ndAve,05/19/2017 09:00:00 PM,48,-122,0,0,0
28222,58thStGreenway22ndAve,05/19/2017 10:00:00 PM,48,-122,0,0,0
28223,58thStGreenway22ndAve,05/19/2017 11:00:00 PM,48,-122,0,0,0
28224,58thStGreenway22ndAve,05/20/2017 12:00:00 AM,48,-122,0,0,0
28225,58thStGreenway22ndAve,05/20/2017 01:00:00 AM,48,-122,0,0,0
28226,58thStGreenway22ndAve,05/20/2017 02:00:00 AM,48,-122,0,0,0
28227,58thStGreenway22ndAve,05/20/2017 03:00:00 AM,48,-122,0,0,0
28228,58thStGreenway22ndAve,05/20/2017 04:00:00 AM,48,-122,0,0,0
28229,58thStGreenway22ndAve,05/20/2017 05:00:00 AM,48,-122,0,0,0
28230,58thStGreenway22ndAve,05/20/2017 06:00:00 AM,48,-122,0,0,0
28231,58thStGreenway22ndAve,05/20/2017 07:00:00 AM,48,-122,0,0,0
28232,58thStGreenway22ndAve,05/20/2017 08:00:00 AM,48,-122,0,0,0
28233,58thStGreenway22ndAve,05/20/2017 09:00:00 AM,48,-122,0,0,0
28234,58thStGreenway22ndAve,05/20/2017 10:00:00 AM,48,-122,0,0,0
28235,58thStGreenway22ndAve,05/20/2017 11:00:00 AM,48,-122,0,0,0
28236,58thStGreenway22ndAve,05/20/2017 12:00:00 PM,48,-122,0,0,0
28237,58thStGreenway22ndAve,05/20/2017 01:00:00 PM,48,-122,0,0,0
28238,58thStGreenway22ndAve,05/20/2017 02:00:00 PM,48,-122,0,0,0
28239,58thStGreenway22ndAve,05/20/2017 03:00:00 PM,48,-122,0,0,0
28240,58thStGreenway22ndAve,05/20/2017 04:00:00 PM,48,-122,0,0,0
28241,58thStGreenway22ndAve,05/20/2017 05:00:00 PM,48,-122,0,0,0
28242,58thStGreenway22ndAve,05/20/2017 06:00:00 PM,48,-122,0,0,0
28243,58thStGreenway22ndAve,05/20/2017 07:00:00 PM,48,-122,0,0,0
28244,58thStGreenway22ndAve,05/20/2017 08:00:00 PM,48,-122,0,0,0
28245,58thStGreenway22ndAve,05/20/2017 09:00:00 PM,48,-122,0,0,0
28246,58thStGreenway22ndAve,05/20/2017 10:00:00 PM,48,-122,0,0,0
28247,58thStGreenway22ndAve,05/20/2017 11:00:00 PM,48,-122,0,0,0
28248,58thStGreenway22ndAve,05/21/2017 12:00:00 AM,48,-122,0,0,0
28249,58thStGreenway22ndAve,05/21/2017 01:00:00 AM,48,-122,0,0,0
28250,58thStGreenway22ndAve,05/21/2017 02:00:00 AM,48,-122,0,0,0
28251,58thStGreenway22ndAve,05/21/2017 03:00:00 AM,48,-122,0,0,0
28252,58thStGreenway22ndAve,05/21/2017 04:00:00 AM,48,-122,0,0,0
28253,58thStGreenway22ndAve,05/21/2017 05:00:00 AM,48,-122,0,0,0
28254,58thStGreenway22ndAve,05/21/2017 06:00:00 AM,48,-122,0,0,0
28255,58thStGreenway22ndAve,05/21/2017 07:00:00 AM,48,-122,0,0,0
28256,58thStGreenway22ndAve,05/21/2017 08:00:00 AM,48,-122,0,0,0
28257,58thStGreenway22ndAve,05/21/2017 09:00:00 AM,48,-122,0,0,0
28258,58thStGreenway22ndAve,05/21/2017 10:00:00 AM,48,-122,0,0,0
28259,58thStGreenway22ndAve,05/21/2017 11:00:00 AM,48,-122,0,0,0
28260,58thStGreenway22ndAve,05/21/2017 12:00:00 PM,48,-122,0,0,0
28261,58thStGreenway22ndAve,05/21/2017 01:00:00 PM,48,-122,0,0,0
28262,58thStGreenway22ndAve,05/21/2017 02:00:00 PM,48,-122,0,0,0
28263,58thStGreenway22ndAve,05/21/2017 03:00:00 PM,48,-122,0,0,0
28264,58thStGreenway22ndAve,05/21/2017 04:00:00 PM,48,-122,0,0,0
28265,58thStGreenway22ndAve,05/21/2017 05:00:00 PM,48,-122,0,0,0
28266,58thStGreenway22ndAve,05/21/2017 06:00:00 PM,48,-122,0,0,0
28267,58thStGreenway22ndAve,05/21/2017 07:00:00 PM,48,-122,0,0,0
28268,58thStGreenway22ndAve,05/21/2017 08:00:00 PM,48,-122,0,0,0
28269,58thStGreenway22ndAve,05/21/2017 09:00:00 PM,48,-122,0,0,0
28270,58thStGreenway22ndAve,05/21/2017 10:00:00 PM,48,-122,0,0,0
28271,58thStGreenway22ndAve,05/21/2017 11:00:00 PM,48,-122,0,0,0
28272,58thStGreenway22ndAve,05/22/2017 12:00:00 AM,48,-122,0,0,0
28273,58thStGreenway22ndAve,05/22/2017 01:00:00 AM,48,-122,0,0,0
28274,58thStGreenway22ndAve,05/22/2017 02:00:00 AM,48,-122,0,0,0
28275,58thStGreenway22ndAve,05/22/2017 03:00:00 AM,48,-122,0,0,0
28276,58thStGreenway22ndAve,05/22/2017 04:00:00 AM,48,-122,0,0,0
28277,58thStGreenway22ndAve,05/22/2017 05:00:00 AM,48,-122,0,0,0
28278,58thStGreenway22ndAve,05/22/2017 06:00:00 AM,48,-122,0,0,0
28279,58thStGreenway22ndAve,05/22/2017 07:00:00 AM,48,-122,0,0,0
28280,58thStGreenway22ndAve,05/22/2017 08:00:00 AM,48,-122,0,0,0
28281,58thStGreenway22ndAve,05/22/2017 09:00:00 AM,48,-122,0,0,0
28282,58thStGreenway22ndAve,05/22/2017 10:00:00 AM,48,-122,0,0,0
28283,58thStGreenway22ndAve,05/22/2017 11:00:00 AM,48,-122,0,0,0
28284,58thStGreenway22ndAve,05/22/2017 12:00:00 PM,48,-122,0,0,0
28285,58thStGreenway22ndAve,05/22/2017 01:00:00 PM,48,-122,0,0,0
28286,58thStGreenway22ndAve,05/22/2017 02:00:00 PM,48,-122,0,0,0
28287,58thStGreenway22ndAve,05/22/2017 03:00:00 PM,48,-122,0,0,0
28288,58thStGreenway22ndAve,05/22/2017 04:00:00 PM,48,-122,0,0,0
28289,58thStGreenway22ndAve,05/22/2017 05:00:00 PM,48,-122,0,0,0
28290,58thStGreenway22ndAve,05/22/2017 06:00:00 PM,48,-122,0,0,0
28291,58thStGreenway22ndAve,05/22/2017 07:00:00 PM,48,-122,0,0,0
28292,58thStGreenway22ndAve,05/22/2017 08:00:00 PM,48,-122,0,0,0
28293,58thStGreenway22ndAve,05/22/2017 09:00:00 PM,48,-122,0,0,0
28294,58thStGreenway22ndAve,05/22/2017 10:00:00 PM,48,-122,0,0,0
28295,58thStGreenway22ndAve,05/22/2017 11:00:00 PM,48,-122,0,0,0
28296,58thStGreenway22ndAve,05/23/2017 12:00:00 AM,48,-122,0,0,0
28297,58thStGreenway22ndAve,05/23/2017 01:00:00 AM,48,-122,0,0,0
28298,58thStGreenway22ndAve,05/23/2017 02:00:00 AM,48,-122,0,0,0
28299,58thStGreenway22ndAve,05/23/2017 03:00:00 AM,48,-122,0,0,0
28300,58thStGreenway22ndAve,05/23/2017 04:00:00 AM,48,-122,0,0,0
28301,58thStGreenway22ndAve,05/23/2017 05:00:00 AM,48,-122,0,0,0
28302,58thStGreenway22ndAve,05/23/2017 06:00:00 AM,48,-122,0,0,0
28303,58thStGreenway22ndAve,05/23/2017 07:00:00 AM,48,-122,0,0,0
28304,58thStGreenway22ndAve,05/23/2017 08:00:00 AM,48,-122,0,0,0
28305,58thStGreenway22ndAve,05/23/2017 09:00:00 AM,48,-122,0,0,0
28306,58thStGreenway22ndAve,05/23/2017 10:00:00 AM,48,-122,0,0,0
28307,58thStGreenway22ndAve,05/23/2017 11:00:00 AM,48,-122,0,0,0
28308,58thStGreenway22ndAve,05/23/2017 12:00:00 PM,48,-122,0,0,0
28309,58thStGreenway22ndAve,05/23/2017 01:00:00 PM,48,-122,0,0,0
28310,58thStGreenway22ndAve,05/23/2017 02:00:00 PM,48,-122,0,0,0
28311,58thStGreenway22ndAve,05/23/2017 03:00:00 PM,48,-122,0,0,0
28312,58thStGreenway22ndAve,05/23/2017 04:00:00 PM,48,-122,0,0,0
28313,58thStGreenway22ndAve,05/23/2017 05:00:00 PM,48,-122,0,0,0
28314,58thStGreenway22ndAve,05/23/2017 06:00:00 PM,48,-122,0,0,0
28315,58thStGreenway22ndAve,05/23/2017 07:00:00 PM,48,-122,0,0,0
28316,58thStGreenway22ndAve,05/23/2017 08:00:00 PM,48,-122,0,0,0
28317,58thStGreenway22ndAve,05/23/2017 09:00:00 PM,48,-122,0,0,0
28318,58thStGreenway22ndAve,05/23/2017 10:00:00 PM,48,-122,0,0,0
28319,58thStGreenway22ndAve,05/23/2017 11:00:00 PM,48,-122,0,0,0
28320,58thStGreenway22ndAve,05/24/2017 12:00:00 AM,48,-122,0,0,0
28321,58thStGreenway22ndAve,05/24/2017 01:00:00 AM,48,-122,0,0,0
28322,58thStGreenway22ndAve,05/24/2017 02:00:00 AM,48,-122,0,0,0
28323,58thStGreenway22ndAve,05/24/2017 03:00:00 AM,48,-122,0,0,0
28324,58thStGreenway22ndAve,05/24/2017 04:00:00 AM,48,-122,0,0,0
28325,58thStGreenway22ndAve,05/24/2017 05:00:00 AM,48,-122,0,0,0
28326,58thStGreenway22ndAve,05/24/2017 06:00:00 AM,48,-122,0,0,0
28327,58thStGreenway22ndAve,05/24/2017 07:00:00 AM,48,-122,0,0,0
28328,58thStGreenway22ndAve,05/24/2017 08:00:00 AM,48,-122,0,0,0
28329,58thStGreenway22ndAve,05/24/2017 09:00:00 AM,48,-122,0,0,0
28330,58thStGreenway22ndAve,05/24/2017 10:00:00 AM,48,-122,0,0,0
28331,58thStGreenway22ndAve,05/24/2017 11:00:00 AM,48,-122,0,0,0
28332,58thStGreenway22ndAve,05/24/2017 12:00:00 PM,48,-122,0,0,0
28333,58thStGreenway22ndAve,05/24/2017 01:00:00 PM,48,-122,0,0,0
28334,58thStGreenway22ndAve,05/24/2017 02:00:00 PM,48,-122,0,0,0
28335,58thStGreenway22ndAve,05/24/2017 03:00:00 PM,48,-122,0,0,0
28336,58thStGreenway22ndAve,05/24/2017 04:00:00 PM,48,-122,0,0,0
28337,58thStGreenway22ndAve,05/24/2017 05:00:00 PM,48,-122,1,0,1
28338,58thStGreenway22ndAve,05/24/2017 06:00:00 PM,48,-122,0,0,0
28339,58thStGreenway22ndAve,05/24/2017 07:00:00 PM,48,-122,0,0,0
28340,58thStGreenway22ndAve,05/24/2017 08:00:00 PM,48,-122,0,0,0
28341,58thStGreenway22ndAve,05/24/2017 09:00:00 PM,48,-122,0,0,0
28342,58thStGreenway22ndAve,05/24/2017 10:00:00 PM,48,-122,0,0,0
28343,58thStGreenway22ndAve,05/24/2017 11:00:00 PM,48,-122,0,0,0
28344,58thStGreenway22ndAve,05/25/2017 12:00:00 AM,48,-122,0,0,0
28345,58thStGreenway22ndAve,05/25/2017 01:00:00 AM,48,-122,0,0,0
28346,58thStGreenway22ndAve,05/25/2017 02:00:00 AM,48,-122,0,0,0
28347,58thStGreenway22ndAve,05/25/2017 03:00:00 AM,48,-122,0,0,0
28348,58thStGreenway22ndAve,05/25/2017 04:00:00 AM,48,-122,0,0,0
28349,58thStGreenway22ndAve,05/25/2017 05:00:00 AM,48,-122,0,0,0
28350,58thStGreenway22ndAve,05/25/2017 06:00:00 AM,48,-122,0,0,0
28351,58thStGreenway22ndAve,05/25/2017 07:00:00 AM,48,-122,0,0,0
28352,58thStGreenway22ndAve,05/25/2017 08:00:00 AM,48,-122,0,0,0
28353,58thStGreenway22ndAve,05/25/2017 09:00:00 AM,48,-122,0,0,0
28354,58thStGreenway22ndAve,05/25/2017 10:00:00 AM,48,-122,0,0,0
28355,58thStGreenway22ndAve,05/25/2017 11:00:00 AM,48,-122,0,0,0
28356,58thStGreenway22ndAve,05/25/2017 12:00:00 PM,48,-122,0,0,0
28357,58thStGreenway22ndAve,05/25/2017 01:00:00 PM,48,-122,0,0,0
28358,58thStGreenway22ndAve,05/25/2017 02:00:00 PM,48,-122,0,0,0
28359,58thStGreenway22ndAve,05/25/2017 03:00:00 PM,48,-122,0,0,0
28360,58thStGreenway22ndAve,05/25/2017 04:00:00 PM,48,-122,0,0,0
28361,58thStGreenway22ndAve,05/25/2017 05:00:00 PM,48,-122,0,0,0
28362,58thStGreenway22ndAve,05/25/2017 06:00:00 PM,48,-122,0,0,0
28363,58thStGreenway22ndAve,05/25/2017 07:00:00 PM,48,-122,0,0,0
28364,58thStGreenway22ndAve,05/25/2017 08:00:00 PM,48,-122,0,0,0
28365,58thStGreenway22ndAve,05/25/2017 09:00:00 PM,48,-122,0,0,0
28366,58thStGreenway22ndAve,05/25/2017 10:00:00 PM,48,-122,0,0,0
28367,58thStGreenway22ndAve,05/25/2017 11:00:00 PM,48,-122,0,0,0
28368,58thStGreenway22ndAve,05/26/2017 12:00:00 AM,48,-122,0,0,0
28369,58thStGreenway22ndAve,05/26/2017 01:00:00 AM,48,-122,0,0,0
28370,58thStGreenway22ndAve,05/26/2017 02:00:00 AM,48,-122,0,0,0
28371,58thStGreenway22ndAve,05/26/2017 03:00:00 AM,48,-122,0,0,0
28372,58thStGreenway22ndAve,05/26/2017 04:00:00 AM,48,-122,0,0,0
28373,58thStGreenway22ndAve,05/26/2017 05:00:00 AM,48,-122,0,0,0
28374,58thStGreenway22ndAve,05/26/2017 06:00:00 AM,48,-122,0,0,0
28375,58thStGreenway22ndAve,05/26/2017 07:00:00 AM,48,-122,0,0,0
28376,58thStGreenway22ndAve,05/26/2017 08:00:00 AM,48,-122,0,0,0
28377,58thStGreenway22ndAve,05/26/2017 09:00:00 AM,48,-122,0,0,0
28378,58thStGreenway22ndAve,05/26/2017 10:00:00 AM,48,-122,0,0,0
28379,58thStGreenway22ndAve,05/26/2017 11:00:00 AM,48,-122,0,0,0
28380,58thStGreenway22ndAve,05/26/2017 12:00:00 PM,48,-122,1,1,2
28381,58thStGreenway22ndAve,05/26/2017 01:00:00 PM,48,-122,0,0,0
28382,58thStGreenway22ndAve,05/26/2017 02:00:00 PM,48,-122,0,0,0
28383,58thStGreenway22ndAve,05/26/2017 03:00:00 PM,48,-122,0,0,0
28384,58thStGreenway22ndAve,05/26/2017 04:00:00 PM,48,-122,0,0,0
28385,58thStGreenway22ndAve,05/26/2017 05:00:00 PM,48,-122,0,0,0
28386,58thStGreenway22ndAve,05/26/2017 06:00:00 PM,48,-122,0,0,0
28387,58thStGreenway22ndAve,05/26/2017 07:00:00 PM,48,-122,0,0,0
28388,58thStGreenway22ndAve,05/26/2017 08:00:00 PM,48,-122,0,0,0
28389,58thStGreenway22ndAve,05/26/2017 09:00:00 PM,48,-122,0,0,0
28390,58thStGreenway22ndAve,05/26/2017 10:00:00 PM,48,-122,0,0,0
28391,58thStGreenway22ndAve,05/26/2017 11:00:00 PM,48,-122,0,0,0
28392,58thStGreenway22ndAve,05/27/2017 12:00:00 AM,48,-122,0,0,0
28393,58thStGreenway22ndAve,05/27/2017 01:00:00 AM,48,-122,0,0,0
28394,58thStGreenway22ndAve,05/27/2017 02:00:00 AM,48,-122,0,0,0
28395,58thStGreenway22ndAve,05/27/2017 03:00:00 AM,48,-122,0,0,0
28396,58thStGreenway22ndAve,05/27/2017 04:00:00 AM,48,-122,0,0,0
28397,58thStGreenway22ndAve,05/27/2017 05:00:00 AM,48,-122,0,0,0
28398,58thStGreenway22ndAve,05/27/2017 06:00:00 AM,48,-122,0,0,0
28399,58thStGreenway22ndAve,05/27/2017 07:00:00 AM,48,-122,0,0,0
28400,58thStGreenway22ndAve,05/27/2017 08:00:00 AM,48,-122,0,0,0
28401,58thStGreenway22ndAve,05/27/2017 09:00:00 AM,48,-122,0,0,0
28402,58thStGreenway22ndAve,05/27/2017 10:00:00 AM,48,-122,0,0,0
28403,58thStGreenway22ndAve,05/27/2017 11:00:00 AM,48,-122,0,0,0
28404,58thStGreenway22ndAve,05/27/2017 12:00:00 PM,48,-122,0,0,0
28405,58thStGreenway22ndAve,05/27/2017 01:00:00 PM,48,-122,0,0,0
28406,58thStGreenway22ndAve,05/27/2017 02:00:00 PM,48,-122,0,0,0
28407,58thStGreenway22ndAve,05/27/2017 03:00:00 PM,48,-122,0,0,0
28408,58thStGreenway22ndAve,05/27/2017 04:00:00 PM,48,-122,0,0,0
28409,58thStGreenway22ndAve,05/27/2017 05:00:00 PM,48,-122,0,0,0
28410,58thStGreenway22ndAve,05/27/2017 06:00:00 PM,48,-122,0,0,0
28411,58thStGreenway22ndAve,05/27/2017 07:00:00 PM,48,-122,0,0,0
28412,58thStGreenway22ndAve,05/27/2017 08:00:00 PM,48,-122,0,0,0
28413,58thStGreenway22ndAve,05/27/2017 09:00:00 PM,48,-122,0,0,0
28414,58thStGreenway22ndAve,05/27/2017 10:00:00 PM,48,-122,0,0,0
28415,58thStGreenway22ndAve,05/27/2017 11:00:00 PM,48,-122,0,0,0
28416,58thStGreenway22ndAve,05/28/2017 12:00:00 AM,48,-122,0,0,0
28417,58thStGreenway22ndAve,05/28/2017 01:00:00 AM,48,-122,0,0,0
28418,58thStGreenway22ndAve,05/28/2017 02:00:00 AM,48,-122,0,0,0
28419,58thStGreenway22ndAve,05/28/2017 03:00:00 AM,48,-122,0,0,0
28420,58thStGreenway22ndAve,05/28/2017 04:00:00 AM,48,-122,0,0,0
28421,58thStGreenway22ndAve,05/28/2017 05:00:00 AM,48,-122,0,0,0
28422,58thStGreenway22ndAve,05/28/2017 06:00:00 AM,48,-122,0,0,0
28423,58thStGreenway22ndAve,05/28/2017 07:00:00 AM,48,-122,0,0,0
28424,58thStGreenway22ndAve,05/28/2017 08:00:00 AM,48,-122,0,0,0
28425,58thStGreenway22ndAve,05/28/2017 09:00:00 AM,48,-122,0,0,0
28426,58thStGreenway22ndAve,05/28/2017 10:00:00 AM,48,-122,0,0,0
28427,58thStGreenway22ndAve,05/28/2017 11:00:00 AM,48,-122,0,0,0
28428,58thStGreenway22ndAve,05/28/2017 12:00:00 PM,48,-122,0,0,0
28429,58thStGreenway22ndAve,05/28/2017 01:00:00 PM,48,-122,0,0,0
28430,58thStGreenway22ndAve,05/28/2017 02:00:00 PM,48,-122,0,0,0
28431,58thStGreenway22ndAve,05/28/2017 03:00:00 PM,48,-122,0,0,0
28432,58thStGreenway22ndAve,05/28/2017 04:00:00 PM,48,-122,0,0,0
28433,58thStGreenway22ndAve,05/28/2017 05:00:00 PM,48,-122,0,0,0
28434,58thStGreenway22ndAve,05/28/2017 06:00:00 PM,48,-122,0,0,0
28435,58thStGreenway22ndAve,05/28/2017 07:00:00 PM,48,-122,0,0,0
28436,58thStGreenway22ndAve,05/28/2017 08:00:00 PM,48,-122,0,0,0
28437,58thStGreenway22ndAve,05/28/2017 09:00:00 PM,48,-122,0,0,0
28438,58thStGreenway22ndAve,05/28/2017 10:00:00 PM,48,-122,0,0,0
28439,58thStGreenway22ndAve,05/28/2017 11:00:00 PM,48,-122,0,0,0
28440,58thStGreenway22ndAve,05/29/2017 12:00:00 AM,48,-122,0,0,0
28441,58thStGreenway22ndAve,05/29/2017 01:00:00 AM,48,-122,0,0,0
28442,58thStGreenway22ndAve,05/29/2017 02:00:00 AM,48,-122,0,0,0
28443,58thStGreenway22ndAve,05/29/2017 03:00:00 AM,48,-122,0,0,0
28444,58thStGreenway22ndAve,05/29/2017 04:00:00 AM,48,-122,0,0,0
28445,58thStGreenway22ndAve,05/29/2017 05:00:00 AM,48,-122,0,0,0
28446,58thStGreenway22ndAve,05/29/2017 06:00:00 AM,48,-122,0,0,0
28447,58thStGreenway22ndAve,05/29/2017 07:00:00 AM,48,-122,0,0,0
28448,58thStGreenway22ndAve,05/29/2017 08:00:00 AM,48,-122,0,0,0
28449,58thStGreenway22ndAve,05/29/2017 09:00:00 AM,48,-122,0,0,0
28450,58thStGreenway22ndAve,05/29/2017 10:00:00 AM,48,-122,0,0,0
28451,58thStGreenway22ndAve,05/29/2017 11:00:00 AM,48,-122,0,0,0
28452,58thStGreenway22ndAve,05/29/2017 12:00:00 PM,48,-122,0,0,0
28453,58thStGreenway22ndAve,05/29/2017 01:00:00 PM,48,-122,0,0,0
28454,58thStGreenway22ndAve,05/29/2017 02:00:00 PM,48,-122,0,0,0
28455,58thStGreenway22ndAve,05/29/2017 03:00:00 PM,48,-122,0,0,0
28456,58thStGreenway22ndAve,05/29/2017 04:00:00 PM,48,-122,0,0,0
28457,58thStGreenway22ndAve,05/29/2017 05:00:00 PM,48,-122,0,0,0
28458,58thStGreenway22ndAve,05/29/2017 06:00:00 PM,48,-122,0,0,0
28459,58thStGreenway22ndAve,05/29/2017 07:00:00 PM,48,-122,0,0,0
28460,58thStGreenway22ndAve,05/29/2017 08:00:00 PM,48,-122,0,0,0
28461,58thStGreenway22ndAve,05/29/2017 09:00:00 PM,48,-122,0,0,0
28462,58thStGreenway22ndAve,05/29/2017 10:00:00 PM,48,-122,0,0,0
28463,58thStGreenway22ndAve,05/29/2017 11:00:00 PM,48,-122,0,0,0
28464,58thStGreenway22ndAve,05/30/2017 12:00:00 AM,48,-122,0,0,0
28465,58thStGreenway22ndAve,05/30/2017 01:00:00 AM,48,-122,0,0,0
28466,58thStGreenway22ndAve,05/30/2017 02:00:00 AM,48,-122,0,0,0
28467,58thStGreenway22ndAve,05/30/2017 03:00:00 AM,48,-122,0,0,0
28468,58thStGreenway22ndAve,05/30/2017 04:00:00 AM,48,-122,0,0,0
28469,58thStGreenway22ndAve,05/30/2017 05:00:00 AM,48,-122,0,0,0
28470,58thStGreenway22ndAve,05/30/2017 06:00:00 AM,48,-122,0,0,0
28471,58thStGreenway22ndAve,05/30/2017 07:00:00 AM,48,-122,0,0,0
28472,58thStGreenway22ndAve,05/30/2017 08:00:00 AM,48,-122,0,0,0
28473,58thStGreenway22ndAve,05/30/2017 09:00:00 AM,48,-122,0,0,0
28474,58thStGreenway22ndAve,05/30/2017 10:00:00 AM,48,-122,0,0,0
28475,58thStGreenway22ndAve,05/30/2017 11:00:00 AM,48,-122,0,0,0
28476,58thStGreenway22ndAve,05/30/2017 12:00:00 PM,48,-122,0,0,0
28477,58thStGreenway22ndAve,05/30/2017 01:00:00 PM,48,-122,0,0,0
28478,58thStGreenway22ndAve,05/30/2017 02:00:00 PM,48,-122,0,0,0
28479,58thStGreenway22ndAve,05/30/2017 03:00:00 PM,48,-122,0,0,0
28480,58thStGreenway22ndAve,05/30/2017 04:00:00 PM,48,-122,0,0,0
28481,58thStGreenway22ndAve,05/30/2017 05:00:00 PM,48,-122,0,0,0
28482,58thStGreenway22ndAve,05/30/2017 06:00:00 PM,48,-122,0,0,0
28483,58thStGreenway22ndAve,05/30/2017 07:00:00 PM,48,-122,0,0,0
28484,58thStGreenway22ndAve,05/30/2017 08:00:00 PM,48,-122,0,0,0
28485,58thStGreenway22ndAve,05/30/2017 09:00:00 PM,48,-122,0,0,0
28486,58thStGreenway22ndAve,05/30/2017 10:00:00 PM,48,-122,0,0,0
28487,58thStGreenway22ndAve,05/30/2017 11:00:00 PM,48,-122,0,0,0
28488,58thStGreenway22ndAve,05/31/2017 12:00:00 AM,48,-122,0,0,0
28489,58thStGreenway22ndAve,05/31/2017 01:00:00 AM,48,-122,0,0,0
28490,58thStGreenway22ndAve,05/31/2017 02:00:00 AM,48,-122,0,0,0
28491,58thStGreenway22ndAve,05/31/2017 03:00:00 AM,48,-122,0,0,0
28492,58thStGreenway22ndAve,05/31/2017 04:00:00 AM,48,-122,0,0,0
28493,58thStGreenway22ndAve,05/31/2017 05:00:00 AM,48,-122,0,0,0
28494,58thStGreenway22ndAve,05/31/2017 06:00:00 AM,48,-122,0,0,0
28495,58thStGreenway22ndAve,05/31/2017 07:00:00 AM,48,-122,0,0,0
28496,58thStGreenway22ndAve,05/31/2017 08:00:00 AM,48,-122,0,0,0
28497,58thStGreenway22ndAve,05/31/2017 09:00:00 AM,48,-122,0,0,0
28498,58thStGreenway22ndAve,05/31/2017 10:00:00 AM,48,-122,0,0,0
28499,58thStGreenway22ndAve,05/31/2017 11:00:00 AM,48,-122,0,0,0
28500,58thStGreenway22ndAve,05/31/2017 12:00:00 PM,48,-122,0,0,0
28501,58thStGreenway22ndAve,05/31/2017 01:00:00 PM,48,-122,0,0,0
28502,58thStGreenway22ndAve,05/31/2017 02:00:00 PM,48,-122,0,0,0
28503,58thStGreenway22ndAve,05/31/2017 03:00:00 PM,48,-122,0,0,0
28504,58thStGreenway22ndAve,05/31/2017 04:00:00 PM,48,-122,0,0,0
28505,58thStGreenway22ndAve,05/31/2017 05:00:00 PM,48,-122,0,0,0
28506,58thStGreenway22ndAve,05/31/2017 06:00:00 PM,48,-122,0,0,0
28507,58thStGreenway22ndAve,05/31/2017 07:00:00 PM,48,-122,0,0,0
28508,58thStGreenway22ndAve,05/31/2017 08:00:00 PM,48,-122,0,0,0
28509,58thStGreenway22ndAve,05/31/2017 09:00:00 PM,48,-122,0,0,0
28510,58thStGreenway22ndAve,05/31/2017 10:00:00 PM,48,-122,0,0,0
28511,58thStGreenway22ndAve,05/31/2017 11:00:00 PM,48,-122,0,0,0
28512,58thStGreenway22ndAve,06/01/2017 12:00:00 AM,48,-122,0,0,0
28513,58thStGreenway22ndAve,06/01/2017 01:00:00 AM,48,-122,0,0,0
28514,58thStGreenway22ndAve,06/01/2017 02:00:00 AM,48,-122,0,0,0
28515,58thStGreenway22ndAve,06/01/2017 03:00:00 AM,48,-122,0,0,0
28516,58thStGreenway22ndAve,06/01/2017 04:00:00 AM,48,-122,0,0,0
28517,58thStGreenway22ndAve,06/01/2017 05:00:00 AM,48,-122,0,0,0
28518,58thStGreenway22ndAve,06/01/2017 06:00:00 AM,48,-122,0,0,0
28519,58thStGreenway22ndAve,06/01/2017 07:00:00 AM,48,-122,0,0,0
28520,58thStGreenway22ndAve,06/01/2017 08:00:00 AM,48,-122,0,0,0
28521,58thStGreenway22ndAve,06/01/2017 09:00:00 AM,48,-122,0,0,0
28522,58thStGreenway22ndAve,06/01/2017 10:00:00 AM,48,-122,0,0,0
28523,58thStGreenway22ndAve,06/01/2017 11:00:00 AM,48,-122,0,0,0
28524,58thStGreenway22ndAve,06/01/2017 12:00:00 PM,48,-122,0,0,0
28525,58thStGreenway22ndAve,06/01/2017 01:00:00 PM,48,-122,0,0,0
28526,58thStGreenway22ndAve,06/01/2017 02:00:00 PM,48,-122,0,0,0
28527,58thStGreenway22ndAve,06/01/2017 03:00:00 PM,48,-122,0,0,0
28528,58thStGreenway22ndAve,06/01/2017 04:00:00 PM,48,-122,0,0,0
28529,58thStGreenway22ndAve,06/01/2017 05:00:00 PM,48,-122,0,0,0
28530,58thStGreenway22ndAve,06/01/2017 06:00:00 PM,48,-122,0,0,0
28531,58thStGreenway22ndAve,06/01/2017 07:00:00 PM,48,-122,0,0,0
28532,58thStGreenway22ndAve,06/01/2017 08:00:00 PM,48,-122,0,0,0
28533,58thStGreenway22ndAve,06/01/2017 09:00:00 PM,48,-122,0,0,0
28534,58thStGreenway22ndAve,06/01/2017 10:00:00 PM,48,-122,0,0,0
28535,58thStGreenway22ndAve,06/01/2017 11:00:00 PM,48,-122,0,0,0
28536,58thStGreenway22ndAve,06/02/2017 12:00:00 AM,48,-122,0,0,0
28537,58thStGreenway22ndAve,06/02/2017 01:00:00 AM,48,-122,0,0,0
28538,58thStGreenway22ndAve,06/02/2017 02:00:00 AM,48,-122,0,0,0
28539,58thStGreenway22ndAve,06/02/2017 03:00:00 AM,48,-122,0,0,0
28540,58thStGreenway22ndAve,06/02/2017 04:00:00 AM,48,-122,0,0,0
28541,58thStGreenway22ndAve,06/02/2017 05:00:00 AM,48,-122,0,0,0
28542,58thStGreenway22ndAve,06/02/2017 06:00:00 AM,48,-122,0,0,0
28543,58thStGreenway22ndAve,06/02/2017 07:00:00 AM,48,-122,0,0,0
28544,58thStGreenway22ndAve,06/02/2017 08:00:00 AM,48,-122,0,0,0
28545,58thStGreenway22ndAve,06/02/2017 09:00:00 AM,48,-122,0,0,0
28546,58thStGreenway22ndAve,06/02/2017 10:00:00 AM,48,-122,0,0,0
28547,58thStGreenway22ndAve,06/02/2017 11:00:00 AM,48,-122,0,0,0
28548,58thStGreenway22ndAve,06/02/2017 12:00:00 PM,48,-122,0,0,0
28549,58thStGreenway22ndAve,06/02/2017 01:00:00 PM,48,-122,1,2,3
28550,58thStGreenway22ndAve,06/02/2017 02:00:00 PM,48,-122,1,9,10
28551,58thStGreenway22ndAve,06/02/2017 03:00:00 PM,48,-122,11,4,15
28552,58thStGreenway22ndAve,06/02/2017 04:00:00 PM,48,-122,9,9,18
28553,58thStGreenway22ndAve,06/02/2017 05:00:00 PM,48,-122,11,10,21
28554,58thStGreenway22ndAve,06/02/2017 06:00:00 PM,48,-122,8,3,11
28555,58thStGreenway22ndAve,06/02/2017 07:00:00 PM,48,-122,9,1,10
28556,58thStGreenway22ndAve,06/02/2017 08:00:00 PM,48,-122,2,1,3
28557,58thStGreenway22ndAve,06/02/2017 09:00:00 PM,48,-122,2,2,4
28558,58thStGreenway22ndAve,06/02/2017 10:00:00 PM,48,-122,0,1,1
28559,58thStGreenway22ndAve,06/02/2017 11:00:00 PM,48,-122,1,3,4
28560,58thStGreenway22ndAve,06/03/2017 12:00:00 AM,48,-122,0,0,0
28561,58thStGreenway22ndAve,06/03/2017 01:00:00 AM,48,-122,1,1,2
28562,58thStGreenway22ndAve,06/03/2017 02:00:00 AM,48,-122,0,0,0
28563,58thStGreenway22ndAve,06/03/2017 03:00:00 AM,48,-122,0,0,0
28564,58thStGreenway22ndAve,06/03/2017 04:00:00 AM,48,-122,0,0,0
28565,58thStGreenway22ndAve,06/03/2017 05:00:00 AM,48,-122,0,0,0
28566,58thStGreenway22ndAve,06/03/2017 06:00:00 AM,48,-122,2,1,3
28567,58thStGreenway22ndAve,06/03/2017 07:00:00 AM,48,-122,3,3,6
28568,58thStGreenway22ndAve,06/03/2017 08:00:00 AM,48,-122,1,1,2
28569,58thStGreenway22ndAve,06/03/2017 09:00:00 AM,48,-122,7,8,15
28570,58thStGreenway22ndAve,06/03/2017 10:00:00 AM,48,-122,4,8,12
28571,58thStGreenway22ndAve,06/03/2017 11:00:00 AM,48,-122,5,10,15
28572,58thStGreenway22ndAve,06/03/2017 12:00:00 PM,48,-122,6,4,10
28573,58thStGreenway22ndAve,06/03/2017 01:00:00 PM,48,-122,8,5,13
28574,58thStGreenway22ndAve,06/03/2017 02:00:00 PM,48,-122,8,7,15
28575,58thStGreenway22ndAve,06/03/2017 03:00:00 PM,48,-122,13,9,22
28576,58thStGreenway22ndAve,06/03/2017 04:00:00 PM,48,-122,2,6,8
28577,58thStGreenway22ndAve,06/03/2017 05:00:00 PM,48,-122,9,0,9
28578,58thStGreenway22ndAve,06/03/2017 06:00:00 PM,48,-122,4,4,8
28579,58thStGreenway22ndAve,06/03/2017 07:00:00 PM,48,-122,4,2,6
28580,58thStGreenway22ndAve,06/03/2017 08:00:00 PM,48,-122,2,1,3
28581,58thStGreenway22ndAve,06/03/2017 09:00:00 PM,48,-122,2,3,5
28582,58thStGreenway22ndAve,06/03/2017 10:00:00 PM,48,-122,0,0,0
28583,58thStGreenway22ndAve,06/03/2017 11:00:00 PM,48,-122,0,0,0
28584,58thStGreenway22ndAve,06/04/2017 12:00:00 AM,48,-122,0,0,0
28585,58thStGreenway22ndAve,06/04/2017 01:00:00 AM,48,-122,0,0,0
28586,58thStGreenway22ndAve,06/04/2017 02:00:00 AM,48,-122,0,0,0
28587,58thStGreenway22ndAve,06/04/2017 03:00:00 AM,48,-122,0,0,0
28588,58thStGreenway22ndAve,06/04/2017 04:00:00 AM,48,-122,0,0,0
28589,58thStGreenway22ndAve,06/04/2017 05:00:00 AM,48,-122,1,0,1
28590,58thStGreenway22ndAve,06/04/2017 06:00:00 AM,48,-122,2,0,2
28591,58thStGreenway22ndAve,06/04/2017 07:00:00 AM,48,-122,0,1,1
28592,58thStGreenway22ndAve,06/04/2017 08:00:00 AM,48,-122,6,2,8
28593,58thStGreenway22ndAve,06/04/2017 09:00:00 AM,48,-122,8,3,11
28594,58thStGreenway22ndAve,06/04/2017 10:00:00 AM,48,-122,14,6,20
28595,58thStGreenway22ndAve,06/04/2017 11:00:00 AM,48,-122,9,6,15
28596,58thStGreenway22ndAve,06/04/2017 12:00:00 PM,48,-122,10,5,15
28597,58thStGreenway22ndAve,06/04/2017 01:00:00 PM,48,-122,11,7,18
28598,58thStGreenway22ndAve,06/04/2017 02:00:00 PM,48,-122,13,6,19
28599,58thStGreenway22ndAve,06/04/2017 03:00:00 PM,48,-122,12,11,23
28600,58thStGreenway22ndAve,06/04/2017 04:00:00 PM,48,-122,6,7,13
28601,58thStGreenway22ndAve,06/04/2017 05:00:00 PM,48,-122,5,8,13
28602,58thStGreenway22ndAve,06/04/2017 06:00:00 PM,48,-122,5,3,8
28603,58thStGreenway22ndAve,06/04/2017 07:00:00 PM,48,-122,2,0,2
28604,58thStGreenway22ndAve,06/04/2017 08:00:00 PM,48,-122,1,2,3
28605,58thStGreenway22ndAve,06/04/2017 09:00:00 PM,48,-122,0,0,0
28606,58thStGreenway22ndAve,06/04/2017 10:00:00 PM,48,-122,0,0,0
28607,58thStGreenway22ndAve,06/04/2017 11:00:00 PM,48,-122,0,0,0
28608,58thStGreenway22ndAve,06/05/2017 12:00:00 AM,48,-122,1,0,1
28609,58thStGreenway22ndAve,06/05/2017 01:00:00 AM,48,-122,1,0,1
28610,58thStGreenway22ndAve,06/05/2017 02:00:00 AM,48,-122,0,0,0
28611,58thStGreenway22ndAve,06/05/2017 03:00:00 AM,48,-122,0,0,0
28612,58thStGreenway22ndAve,06/05/2017 04:00:00 AM,48,-122,0,1,1
28613,58thStGreenway22ndAve,06/05/2017 05:00:00 AM,48,-122,2,1,3
28614,58thStGreenway22ndAve,06/05/2017 06:00:00 AM,48,-122,5,4,9
28615,58thStGreenway22ndAve,06/05/2017 07:00:00 AM,48,-122,4,1,5
28616,58thStGreenway22ndAve,06/05/2017 08:00:00 AM,48,-122,3,5,8
28617,58thStGreenway22ndAve,06/05/2017 09:00:00 AM,48,-122,2,1,3
28618,58thStGreenway22ndAve,06/05/2017 10:00:00 AM,48,-122,3,4,7
28619,58thStGreenway22ndAve,06/05/2017 11:00:00 AM,48,-122,3,1,4
28620,58thStGreenway22ndAve,06/05/2017 12:00:00 PM,48,-122,6,3,9
28621,58thStGreenway22ndAve,06/05/2017 01:00:00 PM,48,-122,7,6,13
28622,58thStGreenway22ndAve,06/05/2017 02:00:00 PM,48,-122,7,4,11
28623,58thStGreenway22ndAve,06/05/2017 03:00:00 PM,48,-122,6,9,15
28624,58thStGreenway22ndAve,06/05/2017 04:00:00 PM,48,-122,8,10,18
28625,58thStGreenway22ndAve,06/05/2017 05:00:00 PM,48,-122,15,6,21
28626,58thStGreenway22ndAve,06/05/2017 06:00:00 PM,48,-122,11,4,15
28627,58thStGreenway22ndAve,06/05/2017 07:00:00 PM,48,-122,2,4,6
28628,58thStGreenway22ndAve,06/05/2017 08:00:00 PM,48,-122,0,5,5
28629,58thStGreenway22ndAve,06/05/2017 09:00:00 PM,48,-122,0,2,2
28630,58thStGreenway22ndAve,06/05/2017 10:00:00 PM,48,-122,0,1,1
28631,58thStGreenway22ndAve,06/05/2017 11:00:00 PM,48,-122,0,0,0
28632,58thStGreenway22ndAve,06/06/2017 12:00:00 AM,48,-122,0,2,2
28633,58thStGreenway22ndAve,06/06/2017 01:00:00 AM,48,-122,0,0,0
28634,58thStGreenway22ndAve,06/06/2017 02:00:00 AM,48,-122,0,0,0
28635,58thStGreenway22ndAve,06/06/2017 03:00:00 AM,48,-122,0,0,0
28636,58thStGreenway22ndAve,06/06/2017 04:00:00 AM,48,-122,0,0,0
28637,58thStGreenway22ndAve,06/06/2017 05:00:00 AM,48,-122,1,1,2
28638,58thStGreenway22ndAve,06/06/2017 06:00:00 AM,48,-122,4,4,8
28639,58thStGreenway22ndAve,06/06/2017 07:00:00 AM,48,-122,7,3,10
28640,58thStGreenway22ndAve,06/06/2017 08:00:00 AM,48,-122,5,4,9
28641,58thStGreenway22ndAve,06/06/2017 09:00:00 AM,48,-122,8,2,10
28642,58thStGreenway22ndAve,06/06/2017 10:00:00 AM,48,-122,1,5,6
28643,58thStGreenway22ndAve,06/06/2017 11:00:00 AM,48,-122,8,0,8
28644,58thStGreenway22ndAve,06/06/2017 12:00:00 PM,48,-122,1,7,8
28645,58thStGreenway22ndAve,06/06/2017 01:00:00 PM,48,-122,5,5,10
28646,58thStGreenway22ndAve,06/06/2017 02:00:00 PM,48,-122,4,7,11
28647,58thStGreenway22ndAve,06/06/2017 03:00:00 PM,48,-122,3,9,12
28648,58thStGreenway22ndAve,06/06/2017 04:00:00 PM,48,-122,10,14,24
28649,58thStGreenway22ndAve,06/06/2017 05:00:00 PM,48,-122,12,10,22
28650,58thStGreenway22ndAve,06/06/2017 06:00:00 PM,48,-122,5,6,11
28651,58thStGreenway22ndAve,06/06/2017 07:00:00 PM,48,-122,6,11,17
28652,58thStGreenway22ndAve,06/06/2017 08:00:00 PM,48,-122,3,3,6
28653,58thStGreenway22ndAve,06/06/2017 09:00:00 PM,48,-122,0,3,3
28654,58thStGreenway22ndAve,06/06/2017 10:00:00 PM,48,-122,0,0,0
28655,58thStGreenway22ndAve,06/06/2017 11:00:00 PM,48,-122,0,2,2
28656,58thStGreenway22ndAve,06/07/2017 12:00:00 AM,48,-122,0,1,1
28657,58thStGreenway22ndAve,06/07/2017 01:00:00 AM,48,-122,0,0,0
28658,58thStGreenway22ndAve,06/07/2017 02:00:00 AM,48,-122,0,0,0
28659,58thStGreenway22ndAve,06/07/2017 03:00:00 AM,48,-122,0,0,0
28660,58thStGreenway22ndAve,06/07/2017 04:00:00 AM,48,-122,1,0,1
28661,58thStGreenway22ndAve,06/07/2017 05:00:00 AM,48,-122,3,1,4
28662,58thStGreenway22ndAve,06/07/2017 06:00:00 AM,48,-122,4,6,10
28663,58thStGreenway22ndAve,06/07/2017 07:00:00 AM,48,-122,6,5,11
28664,58thStGreenway22ndAve,06/07/2017 08:00:00 AM,48,-122,5,5,10
28665,58thStGreenway22ndAve,06/07/2017 09:00:00 AM,48,-122,4,3,7
28666,58thStGreenway22ndAve,06/07/2017 10:00:00 AM,48,-122,9,5,14
28667,58thStGreenway22ndAve,06/07/2017 11:00:00 AM,48,-122,6,3,9
28668,58thStGreenway22ndAve,06/07/2017 12:00:00 PM,48,-122,6,5,11
28669,58thStGreenway22ndAve,06/07/2017 01:00:00 PM,48,-122,10,4,14
28670,58thStGreenway22ndAve,06/07/2017 02:00:00 PM,48,-122,8,4,12
28671,58thStGreenway22ndAve,06/07/2017 03:00:00 PM,48,-122,13,9,22
28672,58thStGreenway22ndAve,06/07/2017 04:00:00 PM,48,-122,5,10,15
28673,58thStGreenway22ndAve,06/07/2017 05:00:00 PM,48,-122,10,6,16
28674,58thStGreenway22ndAve,06/07/2017 06:00:00 PM,48,-122,10,23,33
28675,58thStGreenway22ndAve,06/07/2017 07:00:00 PM,48,-122,3,3,6
28676,58thStGreenway22ndAve,06/07/2017 08:00:00 PM,48,-122,2,3,5
28677,58thStGreenway22ndAve,06/07/2017 09:00:00 PM,48,-122,1,4,5
28678,58thStGreenway22ndAve,06/07/2017 10:00:00 PM,48,-122,0,0,0
28679,58thStGreenway22ndAve,06/07/2017 11:00:00 PM,48,-122,0,1,1
28680,58thStGreenway22ndAve,06/08/2017 12:00:00 AM,48,-122,0,0,0
28681,58thStGreenway22ndAve,06/08/2017 01:00:00 AM,48,-122,0,0,0
28682,58thStGreenway22ndAve,06/08/2017 02:00:00 AM,48,-122,0,0,0
28683,58thStGreenway22ndAve,06/08/2017 03:00:00 AM,48,-122,0,0,0
28684,58thStGreenway22ndAve,06/08/2017 04:00:00 AM,48,-122,0,0,0
28685,58thStGreenway22ndAve,06/08/2017 05:00:00 AM,48,-122,1,1,2
28686,58thStGreenway22ndAve,06/08/2017 06:00:00 AM,48,-122,1,2,3
28687,58thStGreenway22ndAve,06/08/2017 07:00:00 AM,48,-122,1,1,2
28688,58thStGreenway22ndAve,06/08/2017 08:00:00 AM,48,-122,6,0,6
28689,58thStGreenway22ndAve,06/08/2017 09:00:00 AM,48,-122,2,1,3
28690,58thStGreenway22ndAve,06/08/2017 10:00:00 AM,48,-122,5,0,5
28691,58thStGreenway22ndAve,06/08/2017 11:00:00 AM,48,-122,5,2,7
28692,58thStGreenway22ndAve,06/08/2017 12:00:00 PM,48,-122,4,4,8
28693,58thStGreenway22ndAve,06/08/2017 01:00:00 PM,48,-122,5,3,8
28694,58thStGreenway22ndAve,06/08/2017 02:00:00 PM,48,-122,5,1,6
28695,58thStGreenway22ndAve,06/08/2017 03:00:00 PM,48,-122,2,5,7
28696,58thStGreenway22ndAve,06/08/2017 04:00:00 PM,48,-122,10,6,16
28697,58thStGreenway22ndAve,06/08/2017 05:00:00 PM,48,-122,18,7,25
28698,58thStGreenway22ndAve,06/08/2017 06:00:00 PM,48,-122,8,1,9
28699,58thStGreenway22ndAve,06/08/2017 07:00:00 PM,48,-122,4,0,4
28700,58thStGreenway22ndAve,06/08/2017 08:00:00 PM,48,-122,3,1,4
28701,58thStGreenway22ndAve,06/08/2017 09:00:00 PM,48,-122,1,1,2
28702,58thStGreenway22ndAve,06/08/2017 10:00:00 PM,48,-122,0,1,1
28703,58thStGreenway22ndAve,06/08/2017 11:00:00 PM,48,-122,0,0,0
28704,58thStGreenway22ndAve,06/09/2017 12:00:00 AM,48,-122,0,0,0
28705,58thStGreenway22ndAve,06/09/2017 01:00:00 AM,48,-122,0,0,0
28706,58thStGreenway22ndAve,06/09/2017 02:00:00 AM,48,-122,0,0,0
28707,58thStGreenway22ndAve,06/09/2017 03:00:00 AM,48,-122,2,0,2
28708,58thStGreenway22ndAve,06/09/2017 04:00:00 AM,48,-122,1,0,1
28709,58thStGreenway22ndAve,06/09/2017 05:00:00 AM,48,-122,4,1,5
28710,58thStGreenway22ndAve,06/09/2017 06:00:00 AM,48,-122,3,5,8
28711,58thStGreenway22ndAve,06/09/2017 07:00:00 AM,48,-122,2,6,8
28712,58thStGreenway22ndAve,06/09/2017 08:00:00 AM,48,-122,3,1,4
28713,58thStGreenway22ndAve,06/09/2017 09:00:00 AM,48,-122,6,0,6
28714,58thStGreenway22ndAve,06/09/2017 10:00:00 AM,48,-122,4,3,7
28715,58thStGreenway22ndAve,06/09/2017 11:00:00 AM,48,-122,7,4,11
28716,58thStGreenway22ndAve,06/09/2017 12:00:00 PM,48,-122,5,4,9
28717,58thStGreenway22ndAve,06/09/2017 01:00:00 PM,48,-122,5,5,10
28718,58thStGreenway22ndAve,06/09/2017 02:00:00 PM,48,-122,3,3,6
28719,58thStGreenway22ndAve,06/09/2017 03:00:00 PM,48,-122,12,7,19
28720,58thStGreenway22ndAve,06/09/2017 04:00:00 PM,48,-122,12,9,21
28721,58thStGreenway22ndAve,06/09/2017 05:00:00 PM,48,-122,8,6,14
28722,58thStGreenway22ndAve,06/09/2017 06:00:00 PM,48,-122,6,4,10
28723,58thStGreenway22ndAve,06/09/2017 07:00:00 PM,48,-122,7,5,12
28724,58thStGreenway22ndAve,06/09/2017 08:00:00 PM,48,-122,4,0,4
28725,58thStGreenway22ndAve,06/09/2017 09:00:00 PM,48,-122,0,0,0
28726,58thStGreenway22ndAve,06/09/2017 10:00:00 PM,48,-122,2,2,4
28727,58thStGreenway22ndAve,06/09/2017 11:00:00 PM,48,-122,0,0,0
28728,58thStGreenway22ndAve,06/10/2017 12:00:00 AM,48,-122,0,0,0
28729,58thStGreenway22ndAve,06/10/2017 01:00:00 AM,48,-122,0,0,0
28730,58thStGreenway22ndAve,06/10/2017 02:00:00 AM,48,-122,0,0,0
28731,58thStGreenway22ndAve,06/10/2017 03:00:00 AM,48,-122,1,1,2
28732,58thStGreenway22ndAve,06/10/2017 04:00:00 AM,48,-122,0,0,0
28733,58thStGreenway22ndAve,06/10/2017 05:00:00 AM,48,-122,0,0,0
28734,58thStGreenway22ndAve,06/10/2017 06:00:00 AM,48,-122,3,1,4
28735,58thStGreenway22ndAve,06/10/2017 07:00:00 AM,48,-122,8,2,10
28736,58thStGreenway22ndAve,06/10/2017 08:00:00 AM,48,-122,8,5,13
28737,58thStGreenway22ndAve,06/10/2017 09:00:00 AM,48,-122,16,3,19
28738,58thStGreenway22ndAve,06/10/2017 10:00:00 AM,48,-122,9,10,19
28739,58thStGreenway22ndAve,06/10/2017 11:00:00 AM,48,-122,9,8,17
28740,58thStGreenway22ndAve,06/10/2017 12:00:00 PM,48,-122,17,6,23
28741,58thStGreenway22ndAve,06/10/2017 01:00:00 PM,48,-122,8,12,20
28742,58thStGreenway22ndAve,06/10/2017 02:00:00 PM,48,-122,19,5,24
28743,58thStGreenway22ndAve,06/10/2017 03:00:00 PM,48,-122,7,7,14
28744,58thStGreenway22ndAve,06/10/2017 04:00:00 PM,48,-122,17,1,18
28745,58thStGreenway22ndAve,06/10/2017 05:00:00 PM,48,-122,12,4,16
28746,58thStGreenway22ndAve,06/10/2017 06:00:00 PM,48,-122,7,7,14
28747,58thStGreenway22ndAve,06/10/2017 07:00:00 PM,48,-122,7,7,14
28748,58thStGreenway22ndAve,06/10/2017 08:00:00 PM,48,-122,3,1,4
28749,58thStGreenway22ndAve,06/10/2017 09:00:00 PM,48,-122,6,5,11
28750,58thStGreenway22ndAve,06/10/2017 10:00:00 PM,48,-122,0,1,1
28751,58thStGreenway22ndAve,06/10/2017 11:00:00 PM,48,-122,0,0,0
28752,58thStGreenway22ndAve,06/11/2017 12:00:00 AM,48,-122,0,0,0
28753,58thStGreenway22ndAve,06/11/2017 01:00:00 AM,48,-122,0,0,0
28754,58thStGreenway22ndAve,06/11/2017 02:00:00 AM,48,-122,1,0,1
28755,58thStGreenway22ndAve,06/11/2017 03:00:00 AM,48,-122,0,0,0
28756,58thStGreenway22ndAve,06/11/2017 04:00:00 AM,48,-122,1,0,1
28757,58thStGreenway22ndAve,06/11/2017 05:00:00 AM,48,-122,0,0,0
28758,58thStGreenway22ndAve,06/11/2017 06:00:00 AM,48,-122,3,0,3
28759,58thStGreenway22ndAve,06/11/2017 07:00:00 AM,48,-122,1,1,2
28760,58thStGreenway22ndAve,06/11/2017 08:00:00 AM,48,-122,4,5,9
28761,58thStGreenway22ndAve,06/11/2017 09:00:00 AM,48,-122,13,4,17
28762,58thStGreenway22ndAve,06/11/2017 10:00:00 AM,48,-122,15,5,20
28763,58thStGreenway22ndAve,06/11/2017 11:00:00 AM,48,-122,17,8,25
28764,58thStGreenway22ndAve,06/11/2017 12:00:00 PM,48,-122,25,9,34
28765,58thStGreenway22ndAve,06/11/2017 01:00:00 PM,48,-122,12,11,23
28766,58thStGreenway22ndAve,06/11/2017 02:00:00 PM,48,-122,11,8,19
28767,58thStGreenway22ndAve,06/11/2017 03:00:00 PM,48,-122,15,7,22
28768,58thStGreenway22ndAve,06/11/2017 04:00:00 PM,48,-122,8,13,21
28769,58thStGreenway22ndAve,06/11/2017 05:00:00 PM,48,-122,8,6,14
28770,58thStGreenway22ndAve,06/11/2017 06:00:00 PM,48,-122,4,6,10
28771,58thStGreenway22ndAve,06/11/2017 07:00:00 PM,48,-122,4,1,5
28772,58thStGreenway22ndAve,06/11/2017 08:00:00 PM,48,-122,6,2,8
28773,58thStGreenway22ndAve,06/11/2017 09:00:00 PM,48,-122,1,0,1
28774,58thStGreenway22ndAve,06/11/2017 10:00:00 PM,48,-122,2,0,2
28775,58thStGreenway22ndAve,06/11/2017 11:00:00 PM,48,-122,0,1,1
28776,58thStGreenway22ndAve,06/12/2017 12:00:00 AM,48,-122,0,0,0
28777,58thStGreenway22ndAve,06/12/2017 01:00:00 AM,48,-122,0,0,0
28778,58thStGreenway22ndAve,06/12/2017 02:00:00 AM,48,-122,0,0,0
28779,58thStGreenway22ndAve,06/12/2017 03:00:00 AM,48,-122,0,1,1
28780,58thStGreenway22ndAve,06/12/2017 04:00:00 AM,48,-122,1,0,1
28781,58thStGreenway22ndAve,06/12/2017 05:00:00 AM,48,-122,3,2,5
28782,58thStGreenway22ndAve,06/12/2017 06:00:00 AM,48,-122,4,4,8
28783,58thStGreenway22ndAve,06/12/2017 07:00:00 AM,48,-122,4,1,5
28784,58thStGreenway22ndAve,06/12/2017 08:00:00 AM,48,-122,12,2,14
28785,58thStGreenway22ndAve,06/12/2017 09:00:00 AM,48,-122,4,2,6
28786,58thStGreenway22ndAve,06/12/2017 10:00:00 AM,48,-122,4,1,5
28787,58thStGreenway22ndAve,06/12/2017 11:00:00 AM,48,-122,4,0,4
28788,58thStGreenway22ndAve,06/12/2017 12:00:00 PM,48,-122,8,1,9
28789,58thStGreenway22ndAve,06/12/2017 01:00:00 PM,48,-122,7,9,16
28790,58thStGreenway22ndAve,06/12/2017 02:00:00 PM,48,-122,5,5,10
28791,58thStGreenway22ndAve,06/12/2017 03:00:00 PM,48,-122,5,3,8
28792,58thStGreenway22ndAve,06/12/2017 04:00:00 PM,48,-122,8,9,17
28793,58thStGreenway22ndAve,06/12/2017 05:00:00 PM,48,-122,10,5,15
28794,58thStGreenway22ndAve,06/12/2017 06:00:00 PM,48,-122,5,5,10
28795,58thStGreenway22ndAve,06/12/2017 07:00:00 PM,48,-122,2,1,3
28796,58thStGreenway22ndAve,06/12/2017 08:00:00 PM,48,-122,1,1,2
28797,58thStGreenway22ndAve,06/12/2017 09:00:00 PM,48,-122,0,1,1
28798,58thStGreenway22ndAve,06/12/2017 10:00:00 PM,48,-122,0,1,1
28799,58thStGreenway22ndAve,06/12/2017 11:00:00 PM,48,-122,1,1,2
28800,58thStGreenway22ndAve,06/13/2017 12:00:00 AM,48,-122,0,0,0
28801,58thStGreenway22ndAve,06/13/2017 01:00:00 AM,48,-122,0,0,0
28802,58thStGreenway22ndAve,06/13/2017 02:00:00 AM,48,-122,0,1,1
28803,58thStGreenway22ndAve,06/13/2017 03:00:00 AM,48,-122,1,0,1
28804,58thStGreenway22ndAve,06/13/2017 04:00:00 AM,48,-122,1,0,1
28805,58thStGreenway22ndAve,06/13/2017 05:00:00 AM,48,-122,2,3,5
28806,58thStGreenway22ndAve,06/13/2017 06:00:00 AM,48,-122,4,7,11
28807,58thStGreenway22ndAve,06/13/2017 07:00:00 AM,48,-122,3,2,5
28808,58thStGreenway22ndAve,06/13/2017 08:00:00 AM,48,-122,7,1,8
28809,58thStGreenway22ndAve,06/13/2017 09:00:00 AM,48,-122,3,2,5
28810,58thStGreenway22ndAve,06/13/2017 10:00:00 AM,48,-122,5,2,7
28811,58thStGreenway22ndAve,06/13/2017 11:00:00 AM,48,-122,4,2,6
28812,58thStGreenway22ndAve,06/13/2017 12:00:00 PM,48,-122,3,2,5
28813,58thStGreenway22ndAve,06/13/2017 01:00:00 PM,48,-122,2,4,6
28814,58thStGreenway22ndAve,06/13/2017 02:00:00 PM,48,-122,3,5,8
28815,58thStGreenway22ndAve,06/13/2017 03:00:00 PM,48,-122,9,4,13
28816,58thStGreenway22ndAve,06/13/2017 04:00:00 PM,48,-122,8,10,18
28817,58thStGreenway22ndAve,06/13/2017 05:00:00 PM,48,-122,9,5,14
28818,58thStGreenway22ndAve,06/13/2017 06:00:00 PM,48,-122,7,6,13
28819,58thStGreenway22ndAve,06/13/2017 07:00:00 PM,48,-122,4,3,7
28820,58thStGreenway22ndAve,06/13/2017 08:00:00 PM,48,-122,2,2,4
28821,58thStGreenway22ndAve,06/13/2017 09:00:00 PM,48,-122,0,0,0
28822,58thStGreenway22ndAve,06/13/2017 10:00:00 PM,48,-122,0,0,0
28823,58thStGreenway22ndAve,06/13/2017 11:00:00 PM,48,-122,0,1,1
28824,58thStGreenway22ndAve,06/14/2017 12:00:00 AM,48,-122,0,1,1
28825,58thStGreenway22ndAve,06/14/2017 01:00:00 AM,48,-122,0,1,1
28826,58thStGreenway22ndAve,06/14/2017 02:00:00 AM,48,-122,0,0,0
28827,58thStGreenway22ndAve,06/14/2017 03:00:00 AM,48,-122,0,0,0
28828,58thStGreenway22ndAve,06/14/2017 04:00:00 AM,48,-122,1,0,1
28829,58thStGreenway22ndAve,06/14/2017 05:00:00 AM,48,-122,1,0,1
28830,58thStGreenway22ndAve,06/14/2017 06:00:00 AM,48,-122,2,3,5
28831,58thStGreenway22ndAve,06/14/2017 07:00:00 AM,48,-122,7,2,9
28832,58thStGreenway22ndAve,06/14/2017 08:00:00 AM,48,-122,6,3,9
28833,58thStGreenway22ndAve,06/14/2017 09:00:00 AM,48,-122,2,0,2
28834,58thStGreenway22ndAve,06/14/2017 10:00:00 AM,48,-122,6,3,9
28835,58thStGreenway22ndAve,06/14/2017 11:00:00 AM,48,-122,4,1,5
28836,58thStGreenway22ndAve,06/14/2017 12:00:00 PM,48,-122,4,6,10
28837,58thStGreenway22ndAve,06/14/2017 01:00:00 PM,48,-122,1,2,3
28838,58thStGreenway22ndAve,06/14/2017 02:00:00 PM,48,-122,3,4,7
28839,58thStGreenway22ndAve,06/14/2017 03:00:00 PM,48,-122,4,4,8
28840,58thStGreenway22ndAve,06/14/2017 04:00:00 PM,48,-122,9,7,16
28841,58thStGreenway22ndAve,06/14/2017 05:00:00 PM,48,-122,12,6,18
28842,58thStGreenway22ndAve,06/14/2017 06:00:00 PM,48,-122,4,6,10
28843,58thStGreenway22ndAve,06/14/2017 07:00:00 PM,48,-122,6,3,9
28844,58thStGreenway22ndAve,06/14/2017 08:00:00 PM,48,-122,1,0,1
28845,58thStGreenway22ndAve,06/14/2017 09:00:00 PM,48,-122,1,3,4
28846,58thStGreenway22ndAve,06/14/2017 10:00:00 PM,48,-122,0,1,1
28847,58thStGreenway22ndAve,06/14/2017 11:00:00 PM,48,-122,0,1,1
28848,58thStGreenway22ndAve,06/15/2017 12:00:00 AM,48,-122,1,0,1
28849,58thStGreenway22ndAve,06/15/2017 01:00:00 AM,48,-122,0,1,1
28850,58thStGreenway22ndAve,06/15/2017 02:00:00 AM,48,-122,0,0,0
28851,58thStGreenway22ndAve,06/15/2017 03:00:00 AM,48,-122,0,0,0
28852,58thStGreenway22ndAve,06/15/2017 04:00:00 AM,48,-122,1,0,1
28853,58thStGreenway22ndAve,06/15/2017 05:00:00 AM,48,-122,2,1,3
28854,58thStGreenway22ndAve,06/15/2017 06:00:00 AM,48,-122,3,4,7
28855,58thStGreenway22ndAve,06/15/2017 07:00:00 AM,48,-122,4,4,8
28856,58thStGreenway22ndAve,06/15/2017 08:00:00 AM,48,-122,2,0,2
28857,58thStGreenway22ndAve,06/15/2017 09:00:00 AM,48,-122,5,0,5
28858,58thStGreenway22ndAve,06/15/2017 10:00:00 AM,48,-122,5,1,6
28859,58thStGreenway22ndAve,06/15/2017 11:00:00 AM,48,-122,6,1,7
28860,58thStGreenway22ndAve,06/15/2017 12:00:00 PM,48,-122,5,0,5
28861,58thStGreenway22ndAve,06/15/2017 01:00:00 PM,48,-122,5,2,7
28862,58thStGreenway22ndAve,06/15/2017 02:00:00 PM,48,-122,2,2,4
28863,58thStGreenway22ndAve,06/15/2017 03:00:00 PM,48,-122,10,1,11
28864,58thStGreenway22ndAve,06/15/2017 04:00:00 PM,48,-122,5,3,8
28865,58thStGreenway22ndAve,06/15/2017 05:00:00 PM,48,-122,5,2,7
28866,58thStGreenway22ndAve,06/15/2017 06:00:00 PM,48,-122,1,4,5
28867,58thStGreenway22ndAve,06/15/2017 07:00:00 PM,48,-122,3,1,4
28868,58thStGreenway22ndAve,06/15/2017 08:00:00 PM,48,-122,0,2,2
28869,58thStGreenway22ndAve,06/15/2017 09:00:00 PM,48,-122,0,0,0
28870,58thStGreenway22ndAve,06/15/2017 10:00:00 PM,48,-122,0,0,0
28871,58thStGreenway22ndAve,06/15/2017 11:00:00 PM,48,-122,1,0,1
28872,58thStGreenway22ndAve,06/16/2017 12:00:00 AM,48,-122,0,0,0
28873,58thStGreenway22ndAve,06/16/2017 01:00:00 AM,48,-122,0,0,0
28874,58thStGreenway22ndAve,06/16/2017 02:00:00 AM,48,-122,0,0,0
28875,58thStGreenway22ndAve,06/16/2017 03:00:00 AM,48,-122,1,0,1
28876,58thStGreenway22ndAve,06/16/2017 04:00:00 AM,48,-122,0,0,0
28877,58thStGreenway22ndAve,06/16/2017 05:00:00 AM,48,-122,2,2,4
28878,58thStGreenway22ndAve,06/16/2017 06:00:00 AM,48,-122,3,1,4
28879,58thStGreenway22ndAve,06/16/2017 07:00:00 AM,48,-122,4,3,7
28880,58thStGreenway22ndAve,06/16/2017 08:00:00 AM,48,-122,7,2,9
28881,58thStGreenway22ndAve,06/16/2017 09:00:00 AM,48,-122,7,4,11
28882,58thStGreenway22ndAve,06/16/2017 10:00:00 AM,48,-122,8,2,10
28883,58thStGreenway22ndAve,06/16/2017 11:00:00 AM,48,-122,3,1,4
28884,58thStGreenway22ndAve,06/16/2017 12:00:00 PM,48,-122,4,0,4
28885,58thStGreenway22ndAve,06/16/2017 01:00:00 PM,48,-122,3,3,6
28886,58thStGreenway22ndAve,06/16/2017 02:00:00 PM,48,-122,6,6,12
28887,58thStGreenway22ndAve,06/16/2017 03:00:00 PM,48,-122,13,7,20
28888,58thStGreenway22ndAve,06/16/2017 04:00:00 PM,48,-122,17,7,24
28889,58thStGreenway22ndAve,06/16/2017 05:00:00 PM,48,-122,10,3,13
28890,58thStGreenway22ndAve,06/16/2017 06:00:00 PM,48,-122,7,2,9
28891,58thStGreenway22ndAve,06/16/2017 07:00:00 PM,48,-122,4,4,8
28892,58thStGreenway22ndAve,06/16/2017 08:00:00 PM,48,-122,2,2,4
28893,58thStGreenway22ndAve,06/16/2017 09:00:00 PM,48,-122,1,1,2
28894,58thStGreenway22ndAve,06/16/2017 10:00:00 PM,48,-122,1,1,2
28895,58thStGreenway22ndAve,06/16/2017 11:00:00 PM,48,-122,1,1,2
28896,58thStGreenway22ndAve,06/17/2017 12:00:00 AM,48,-122,0,0,0
28897,58thStGreenway22ndAve,06/17/2017 01:00:00 AM,48,-122,0,0,0
28898,58thStGreenway22ndAve,06/17/2017 02:00:00 AM,48,-122,0,0,0
28899,58thStGreenway22ndAve,06/17/2017 03:00:00 AM,48,-122,1,1,2
28900,58thStGreenway22ndAve,06/17/2017 04:00:00 AM,48,-122,0,0,0
28901,58thStGreenway22ndAve,06/17/2017 05:00:00 AM,48,-122,0,1,1
28902,58thStGreenway22ndAve,06/17/2017 06:00:00 AM,48,-122,3,0,3
28903,58thStGreenway22ndAve,06/17/2017 07:00:00 AM,48,-122,6,1,7
28904,58thStGreenway22ndAve,06/17/2017 08:00:00 AM,48,-122,5,4,9
28905,58thStGreenway22ndAve,06/17/2017 09:00:00 AM,48,-122,10,7,17
28906,58thStGreenway22ndAve,06/17/2017 10:00:00 AM,48,-122,10,15,25
28907,58thStGreenway22ndAve,06/17/2017 11:00:00 AM,48,-122,9,4,13
28908,58thStGreenway22ndAve,06/17/2017 12:00:00 PM,48,-122,11,12,23
28909,58thStGreenway22ndAve,06/17/2017 01:00:00 PM,48,-122,4,8,12
28910,58thStGreenway22ndAve,06/17/2017 02:00:00 PM,48,-122,16,12,28
28911,58thStGreenway22ndAve,06/17/2017 03:00:00 PM,48,-122,8,2,10
28912,58thStGreenway22ndAve,06/17/2017 04:00:00 PM,48,-122,4,7,11
28913,58thStGreenway22ndAve,06/17/2017 05:00:00 PM,48,-122,2,2,4
28914,58thStGreenway22ndAve,06/17/2017 06:00:00 PM,48,-122,2,2,4
28915,58thStGreenway22ndAve,06/17/2017 07:00:00 PM,48,-122,1,0,1
28916,58thStGreenway22ndAve,06/17/2017 08:00:00 PM,48,-122,1,1,2
28917,58thStGreenway22ndAve,06/17/2017 09:00:00 PM,48,-122,1,1,2
28918,58thStGreenway22ndAve,06/17/2017 10:00:00 PM,48,-122,0,0,0
28919,58thStGreenway22ndAve,06/17/2017 11:00:00 PM,48,-122,1,1,2
28920,58thStGreenway22ndAve,06/18/2017 12:00:00 AM,48,-122,1,1,2
28921,58thStGreenway22ndAve,06/18/2017 01:00:00 AM,48,-122,0,0,0
28922,58thStGreenway22ndAve,06/18/2017 02:00:00 AM,48,-122,0,0,0
28923,58thStGreenway22ndAve,06/18/2017 03:00:00 AM,48,-122,1,2,3
28924,58thStGreenway22ndAve,06/18/2017 04:00:00 AM,48,-122,0,0,0
28925,58thStGreenway22ndAve,06/18/2017 05:00:00 AM,48,-122,0,0,0
28926,58thStGreenway22ndAve,06/18/2017 06:00:00 AM,48,-122,0,2,2
28927,58thStGreenway22ndAve,06/18/2017 07:00:00 AM,48,-122,2,0,2
28928,58thStGreenway22ndAve,06/18/2017 08:00:00 AM,48,-122,4,4,8
28929,58thStGreenway22ndAve,06/18/2017 09:00:00 AM,48,-122,2,4,6
28930,58thStGreenway22ndAve,06/18/2017 10:00:00 AM,48,-122,10,5,15
28931,58thStGreenway22ndAve,06/18/2017 11:00:00 AM,48,-122,7,3,10
28932,58thStGreenway22ndAve,06/18/2017 12:00:00 PM,48,-122,14,4,18
28933,58thStGreenway22ndAve,06/18/2017 01:00:00 PM,48,-122,12,8,20
28934,58thStGreenway22ndAve,06/18/2017 02:00:00 PM,48,-122,9,11,20
28935,58thStGreenway22ndAve,06/18/2017 03:00:00 PM,48,-122,8,8,16
28936,58thStGreenway22ndAve,06/18/2017 04:00:00 PM,48,-122,9,8,17
28937,58thStGreenway22ndAve,06/18/2017 05:00:00 PM,48,-122,2,3,5
28938,58thStGreenway22ndAve,06/18/2017 06:00:00 PM,48,-122,7,0,7
28939,58thStGreenway22ndAve,06/18/2017 07:00:00 PM,48,-122,2,3,5
28940,58thStGreenway22ndAve,06/18/2017 08:00:00 PM,48,-122,0,0,0
28941,58thStGreenway22ndAve,06/18/2017 09:00:00 PM,48,-122,4,0,4
28942,58thStGreenway22ndAve,06/18/2017 10:00:00 PM,48,-122,1,0,1
28943,58thStGreenway22ndAve,06/18/2017 11:00:00 PM,48,-122,0,0,0
28944,58thStGreenway22ndAve,06/19/2017 12:00:00 AM,48,-122,0,1,1
28945,58thStGreenway22ndAve,06/19/2017 01:00:00 AM,48,-122,0,0,0
28946,58thStGreenway22ndAve,06/19/2017 02:00:00 AM,48,-122,0,0,0
28947,58thStGreenway22ndAve,06/19/2017 03:00:00 AM,48,-122,0,0,0
28948,58thStGreenway22ndAve,06/19/2017 04:00:00 AM,48,-122,2,1,3
28949,58thStGreenway22ndAve,06/19/2017 05:00:00 AM,48,-122,4,1,5
28950,58thStGreenway22ndAve,06/19/2017 06:00:00 AM,48,-122,4,5,9
28951,58thStGreenway22ndAve,06/19/2017 07:00:00 AM,48,-122,6,3,9
28952,58thStGreenway22ndAve,06/19/2017 08:00:00 AM,48,-122,5,4,9
28953,58thStGreenway22ndAve,06/19/2017 09:00:00 AM,48,-122,7,2,9
28954,58thStGreenway22ndAve,06/19/2017 10:00:00 AM,48,-122,1,3,4
28955,58thStGreenway22ndAve,06/19/2017 11:00:00 AM,48,-122,4,1,5
28956,58thStGreenway22ndAve,06/19/2017 12:00:00 PM,48,-122,11,3,14
28957,58thStGreenway22ndAve,06/19/2017 01:00:00 PM,48,-122,7,3,10
28958,58thStGreenway22ndAve,06/19/2017 02:00:00 PM,48,-122,9,2,11
28959,58thStGreenway22ndAve,06/19/2017 03:00:00 PM,48,-122,10,7,17
28960,58thStGreenway22ndAve,06/19/2017 04:00:00 PM,48,-122,14,11,25
28961,58thStGreenway22ndAve,06/19/2017 05:00:00 PM,48,-122,10,10,20
28962,58thStGreenway22ndAve,06/19/2017 06:00:00 PM,48,-122,14,3,17
28963,58thStGreenway22ndAve,06/19/2017 07:00:00 PM,48,-122,3,4,7
28964,58thStGreenway22ndAve,06/19/2017 08:00:00 PM,48,-122,1,9,10
28965,58thStGreenway22ndAve,06/19/2017 09:00:00 PM,48,-122,0,2,2
28966,58thStGreenway22ndAve,06/19/2017 10:00:00 PM,48,-122,0,2,2
28967,58thStGreenway22ndAve,06/19/2017 11:00:00 PM,48,-122,3,0,3
28968,58thStGreenway22ndAve,06/20/2017 12:00:00 AM,48,-122,0,0,0
28969,58thStGreenway22ndAve,06/20/2017 01:00:00 AM,48,-122,0,0,0
28970,58thStGreenway22ndAve,06/20/2017 02:00:00 AM,48,-122,0,1,1
28971,58thStGreenway22ndAve,06/20/2017 03:00:00 AM,48,-122,0,0,0
28972,58thStGreenway22ndAve,06/20/2017 04:00:00 AM,48,-122,0,0,0
28973,58thStGreenway22ndAve,06/20/2017 05:00:00 AM,48,-122,3,1,4
28974,58thStGreenway22ndAve,06/20/2017 06:00:00 AM,48,-122,1,4,5
28975,58thStGreenway22ndAve,06/20/2017 07:00:00 AM,48,-122,6,2,8
28976,58thStGreenway22ndAve,06/20/2017 08:00:00 AM,48,-122,6,2,8
28977,58thStGreenway22ndAve,06/20/2017 09:00:00 AM,48,-122,5,1,6
28978,58thStGreenway22ndAve,06/20/2017 10:00:00 AM,48,-122,8,1,9
28979,58thStGreenway22ndAve,06/20/2017 11:00:00 AM,48,-122,0,2,2
28980,58thStGreenway22ndAve,06/20/2017 12:00:00 PM,48,-122,4,7,11
28981,58thStGreenway22ndAve,06/20/2017 01:00:00 PM,48,-122,5,4,9
28982,58thStGreenway22ndAve,06/20/2017 02:00:00 PM,48,-122,2,4,6
28983,58thStGreenway22ndAve,06/20/2017 03:00:00 PM,48,-122,6,5,11
28984,58thStGreenway22ndAve,06/20/2017 04:00:00 PM,48,-122,10,6,16
28985,58thStGreenway22ndAve,06/20/2017 05:00:00 PM,48,-122,9,6,15
28986,58thStGreenway22ndAve,06/20/2017 06:00:00 PM,48,-122,13,3,16
28987,58thStGreenway22ndAve,06/20/2017 07:00:00 PM,48,-122,2,1,3
28988,58thStGreenway22ndAve,06/20/2017 08:00:00 PM,48,-122,3,3,6
28989,58thStGreenway22ndAve,06/20/2017 09:00:00 PM,48,-122,1,1,2
28990,58thStGreenway22ndAve,06/20/2017 10:00:00 PM,48,-122,1,1,2
28991,58thStGreenway22ndAve,06/20/2017 11:00:00 PM,48,-122,0,0,0
28992,58thStGreenway22ndAve,06/21/2017 12:00:00 AM,48,-122,0,0,0
28993,58thStGreenway22ndAve,06/21/2017 01:00:00 AM,48,-122,0,0,0
28994,58thStGreenway22ndAve,06/21/2017 02:00:00 AM,48,-122,0,0,0
28995,58thStGreenway22ndAve,06/21/2017 03:00:00 AM,48,-122,0,0,0
28996,58thStGreenway22ndAve,06/21/2017 04:00:00 AM,48,-122,0,0,0
28997,58thStGreenway22ndAve,06/21/2017 05:00:00 AM,48,-122,2,0,2
28998,58thStGreenway22ndAve,06/21/2017 06:00:00 AM,48,-122,4,5,9
28999,58thStGreenway22ndAve,06/21/2017 07:00:00 AM,48,-122,5,3,8
29000,58thStGreenway22ndAve,06/21/2017 08:00:00 AM,48,-122,5,0,5
29001,58thStGreenway22ndAve,06/21/2017 09:00:00 AM,48,-122,7,3,10
29002,58thStGreenway22ndAve,06/21/2017 10:00:00 AM,48,-122,7,3,10
29003,58thStGreenway22ndAve,06/21/2017 11:00:00 AM,48,-122,10,4,14
29004,58thStGreenway22ndAve,06/21/2017 12:00:00 PM,48,-122,5,8,13
29005,58thStGreenway22ndAve,06/21/2017 01:00:00 PM,48,-122,9,5,14
29006,58thStGreenway22ndAve,06/21/2017 02:00:00 PM,48,-122,9,8,17
29007,58thStGreenway22ndAve,06/21/2017 03:00:00 PM,48,-122,14,8,22
29008,58thStGreenway22ndAve,06/21/2017 04:00:00 PM,48,-122,11,5,16
29009,58thStGreenway22ndAve,06/21/2017 05:00:00 PM,48,-122,11,6,17
29010,58thStGreenway22ndAve,06/21/2017 06:00:00 PM,48,-122,12,7,19
29011,58thStGreenway22ndAve,06/21/2017 07:00:00 PM,48,-122,8,4,12
29012,58thStGreenway22ndAve,06/21/2017 08:00:00 PM,48,-122,7,3,10
29013,58thStGreenway22ndAve,06/21/2017 09:00:00 PM,48,-122,1,4,5
29014,58thStGreenway22ndAve,06/21/2017 10:00:00 PM,48,-122,0,0,0
29015,58thStGreenway22ndAve,06/21/2017 11:00:00 PM,48,-122,1,0,1
29016,58thStGreenway22ndAve,06/22/2017 12:00:00 AM,48,-122,1,0,1
29017,58thStGreenway22ndAve,06/22/2017 01:00:00 AM,48,-122,0,0,0
29018,58thStGreenway22ndAve,06/22/2017 02:00:00 AM,48,-122,0,0,0
29019,58thStGreenway22ndAve,06/22/2017 03:00:00 AM,48,-122,0,0,0
29020,58thStGreenway22ndAve,06/22/2017 04:00:00 AM,48,-122,0,1,1
29021,58thStGreenway22ndAve,06/22/2017 05:00:00 AM,48,-122,0,2,2
29022,58thStGreenway22ndAve,06/22/2017 06:00:00 AM,48,-122,2,3,5
29023,58thStGreenway22ndAve,06/22/2017 07:00:00 AM,48,-122,3,6,9
29024,58thStGreenway22ndAve,06/22/2017 08:00:00 AM,48,-122,9,1,10
29025,58thStGreenway22ndAve,06/22/2017 09:00:00 AM,48,-122,7,3,10
29026,58thStGreenway22ndAve,06/22/2017 10:00:00 AM,48,-122,4,1,5
29027,58thStGreenway22ndAve,06/22/2017 11:00:00 AM,48,-122,7,1,8
29028,58thStGreenway22ndAve,06/22/2017 12:00:00 PM,48,-122,7,4,11
29029,58thStGreenway22ndAve,06/22/2017 01:00:00 PM,48,-122,6,5,11
29030,58thStGreenway22ndAve,06/22/2017 02:00:00 PM,48,-122,7,2,9
29031,58thStGreenway22ndAve,06/22/2017 03:00:00 PM,48,-122,7,6,13
29032,58thStGreenway22ndAve,06/22/2017 04:00:00 PM,48,-122,7,9,16
29033,58thStGreenway22ndAve,06/22/2017 05:00:00 PM,48,-122,6,8,14
29034,58thStGreenway22ndAve,06/22/2017 06:00:00 PM,48,-122,6,3,9
29035,58thStGreenway22ndAve,06/22/2017 07:00:00 PM,48,-122,5,1,6
29036,58thStGreenway22ndAve,06/22/2017 08:00:00 PM,48,-122,2,5,7
29037,58thStGreenway22ndAve,06/22/2017 09:00:00 PM,48,-122,2,0,2
29038,58thStGreenway22ndAve,06/22/2017 10:00:00 PM,48,-122,2,1,3
29039,58thStGreenway22ndAve,06/22/2017 11:00:00 PM,48,-122,0,0,0
29040,58thStGreenway22ndAve,06/23/2017 12:00:00 AM,48,-122,0,0,0
29041,58thStGreenway22ndAve,06/23/2017 01:00:00 AM,48,-122,0,0,0
29042,58thStGreenway22ndAve,06/23/2017 02:00:00 AM,48,-122,0,1,1
29043,58thStGreenway22ndAve,06/23/2017 03:00:00 AM,48,-122,1,0,1
29044,58thStGreenway22ndAve,06/23/2017 04:00:00 AM,48,-122,0,0,0
29045,58thStGreenway22ndAve,06/23/2017 05:00:00 AM,48,-122,2,2,4
29046,58thStGreenway22ndAve,06/23/2017 06:00:00 AM,48,-122,5,1,6
29047,58thStGreenway22ndAve,06/23/2017 07:00:00 AM,48,-122,5,8,13
29048,58thStGreenway22ndAve,06/23/2017 08:00:00 AM,48,-122,6,2,8
29049,58thStGreenway22ndAve,06/23/2017 09:00:00 AM,48,-122,8,0,8
29050,58thStGreenway22ndAve,06/23/2017 10:00:00 AM,48,-122,5,4,9
29051,58thStGreenway22ndAve,06/23/2017 11:00:00 AM,48,-122,5,2,7
29052,58thStGreenway22ndAve,06/23/2017 12:00:00 PM,48,-122,3,6,9
29053,58thStGreenway22ndAve,06/23/2017 01:00:00 PM,48,-122,8,11,19
29054,58thStGreenway22ndAve,06/23/2017 02:00:00 PM,48,-122,6,10,16
29055,58thStGreenway22ndAve,06/23/2017 03:00:00 PM,48,-122,10,8,18
29056,58thStGreenway22ndAve,06/23/2017 04:00:00 PM,48,-122,7,5,12
29057,58thStGreenway22ndAve,06/23/2017 05:00:00 PM,48,-122,11,2,13
29058,58thStGreenway22ndAve,06/23/2017 06:00:00 PM,48,-122,6,5,11
29059,58thStGreenway22ndAve,06/23/2017 07:00:00 PM,48,-122,8,4,12
29060,58thStGreenway22ndAve,06/23/2017 08:00:00 PM,48,-122,5,6,11
29061,58thStGreenway22ndAve,06/23/2017 09:00:00 PM,48,-122,2,2,4
29062,58thStGreenway22ndAve,06/23/2017 10:00:00 PM,48,-122,0,5,5
29063,58thStGreenway22ndAve,06/23/2017 11:00:00 PM,48,-122,0,1,1
29064,58thStGreenway22ndAve,06/24/2017 12:00:00 AM,48,-122,1,0,1
29065,58thStGreenway22ndAve,06/24/2017 01:00:00 AM,48,-122,0,0,0
29066,58thStGreenway22ndAve,06/24/2017 02:00:00 AM,48,-122,0,1,1
29067,58thStGreenway22ndAve,06/24/2017 03:00:00 AM,48,-122,0,0,0
29068,58thStGreenway22ndAve,06/24/2017 04:00:00 AM,48,-122,0,0,0
29069,58thStGreenway22ndAve,06/24/2017 05:00:00 AM,48,-122,0,0,0
29070,58thStGreenway22ndAve,06/24/2017 06:00:00 AM,48,-122,1,0,1
29071,58thStGreenway22ndAve,06/24/2017 07:00:00 AM,48,-122,4,2,6
29072,58thStGreenway22ndAve,06/24/2017 08:00:00 AM,48,-122,12,6,18
29073,58thStGreenway22ndAve,06/24/2017 09:00:00 AM,48,-122,8,5,13
29074,58thStGreenway22ndAve,06/24/2017 10:00:00 AM,48,-122,11,12,23
29075,58thStGreenway22ndAve,06/24/2017 11:00:00 AM,48,-122,7,4,11
29076,58thStGreenway22ndAve,06/24/2017 12:00:00 PM,48,-122,13,7,20
29077,58thStGreenway22ndAve,06/24/2017 01:00:00 PM,48,-122,12,10,22
29078,58thStGreenway22ndAve,06/24/2017 02:00:00 PM,48,-122,14,3,17
29079,58thStGreenway22ndAve,06/24/2017 03:00:00 PM,48,-122,4,3,7
29080,58thStGreenway22ndAve,06/24/2017 04:00:00 PM,48,-122,4,4,8
29081,58thStGreenway22ndAve,06/24/2017 05:00:00 PM,48,-122,5,9,14
29082,58thStGreenway22ndAve,06/24/2017 06:00:00 PM,48,-122,6,4,10
29083,58thStGreenway22ndAve,06/24/2017 07:00:00 PM,48,-122,4,3,7
29084,58thStGreenway22ndAve,06/24/2017 08:00:00 PM,48,-122,2,4,6
29085,58thStGreenway22ndAve,06/24/2017 09:00:00 PM,48,-122,4,5,9
29086,58thStGreenway22ndAve,06/24/2017 10:00:00 PM,48,-122,0,1,1
29087,58thStGreenway22ndAve,06/24/2017 11:00:00 PM,48,-122,1,0,1
29088,58thStGreenway22ndAve,06/25/2017 12:00:00 AM,48,-122,0,0,0
29089,58thStGreenway22ndAve,06/25/2017 01:00:00 AM,48,-122,0,0,0
29090,58thStGreenway22ndAve,06/25/2017 02:00:00 AM,48,-122,0,0,0
29091,58thStGreenway22ndAve,06/25/2017 03:00:00 AM,48,-122,0,1,1
29092,58thStGreenway22ndAve,06/25/2017 04:00:00 AM,48,-122,0,0,0
29093,58thStGreenway22ndAve,06/25/2017 05:00:00 AM,48,-122,2,0,2
29094,58thStGreenway22ndAve,06/25/2017 06:00:00 AM,48,-122,1,1,2
29095,58thStGreenway22ndAve,06/25/2017 07:00:00 AM,48,-122,2,6,8
29096,58thStGreenway22ndAve,06/25/2017 08:00:00 AM,48,-122,6,4,10
29097,58thStGreenway22ndAve,06/25/2017 09:00:00 AM,48,-122,7,4,11
29098,58thStGreenway22ndAve,06/25/2017 10:00:00 AM,48,-122,10,10,20
29099,58thStGreenway22ndAve,06/25/2017 11:00:00 AM,48,-122,7,3,10
29100,58thStGreenway22ndAve,06/25/2017 12:00:00 PM,48,-122,3,8,11
29101,58thStGreenway22ndAve,06/25/2017 01:00:00 PM,48,-122,12,8,20
29102,58thStGreenway22ndAve,06/25/2017 02:00:00 PM,48,-122,6,9,15
29103,58thStGreenway22ndAve,06/25/2017 03:00:00 PM,48,-122,7,10,17
29104,58thStGreenway22ndAve,06/25/2017 04:00:00 PM,48,-122,6,2,8
29105,58thStGreenway22ndAve,06/25/2017 05:00:00 PM,48,-122,1,5,6
29106,58thStGreenway22ndAve,06/25/2017 06:00:00 PM,48,-122,1,3,4
29107,58thStGreenway22ndAve,06/25/2017 07:00:00 PM,48,-122,5,1,6
29108,58thStGreenway22ndAve,06/25/2017 08:00:00 PM,48,-122,1,7,8
29109,58thStGreenway22ndAve,06/25/2017 09:00:00 PM,48,-122,0,0,0
29110,58thStGreenway22ndAve,06/25/2017 10:00:00 PM,48,-122,0,1,1
29111,58thStGreenway22ndAve,06/25/2017 11:00:00 PM,48,-122,0,0,0
29112,58thStGreenway22ndAve,06/26/2017 12:00:00 AM,48,-122,1,0,1
29113,58thStGreenway22ndAve,06/26/2017 01:00:00 AM,48,-122,0,0,0
29114,58thStGreenway22ndAve,06/26/2017 02:00:00 AM,48,-122,0,1,1
29115,58thStGreenway22ndAve,06/26/2017 03:00:00 AM,48,-122,1,1,2
29116,58thStGreenway22ndAve,06/26/2017 04:00:00 AM,48,-122,0,0,0
29117,58thStGreenway22ndAve,06/26/2017 05:00:00 AM,48,-122,1,2,3
29118,58thStGreenway22ndAve,06/26/2017 06:00:00 AM,48,-122,5,6,11
29119,58thStGreenway22ndAve,06/26/2017 07:00:00 AM,48,-122,2,2,4
29120,58thStGreenway22ndAve,06/26/2017 08:00:00 AM,48,-122,11,4,15
29121,58thStGreenway22ndAve,06/26/2017 09:00:00 AM,48,-122,4,7,11
29122,58thStGreenway22ndAve,06/26/2017 10:00:00 AM,48,-122,4,0,4
29123,58thStGreenway22ndAve,06/26/2017 11:00:00 AM,48,-122,4,6,10
29124,58thStGreenway22ndAve,06/26/2017 12:00:00 PM,48,-122,4,6,10
29125,58thStGreenway22ndAve,06/26/2017 01:00:00 PM,48,-122,5,3,8
29126,58thStGreenway22ndAve,06/26/2017 02:00:00 PM,48,-122,5,3,8
29127,58thStGreenway22ndAve,06/26/2017 03:00:00 PM,48,-122,10,9,19
29128,58thStGreenway22ndAve,06/26/2017 04:00:00 PM,48,-122,12,4,16
29129,58thStGreenway22ndAve,06/26/2017 05:00:00 PM,48,-122,11,7,18
29130,58thStGreenway22ndAve,06/26/2017 06:00:00 PM,48,-122,5,2,7
29131,58thStGreenway22ndAve,06/26/2017 07:00:00 PM,48,-122,1,6,7
29132,58thStGreenway22ndAve,06/26/2017 08:00:00 PM,48,-122,1,3,4
29133,58thStGreenway22ndAve,06/26/2017 09:00:00 PM,48,-122,1,3,4
29134,58thStGreenway22ndAve,06/26/2017 10:00:00 PM,48,-122,0,1,1
29135,58thStGreenway22ndAve,06/26/2017 11:00:00 PM,48,-122,1,0,1
29136,58thStGreenway22ndAve,06/27/2017 12:00:00 AM,48,-122,0,0,0
29137,58thStGreenway22ndAve,06/27/2017 01:00:00 AM,48,-122,0,0,0
29138,58thStGreenway22ndAve,06/27/2017 02:00:00 AM,48,-122,0,0,0
29139,58thStGreenway22ndAve,06/27/2017 03:00:00 AM,48,-122,0,0,0
29140,58thStGreenway22ndAve,06/27/2017 04:00:00 AM,48,-122,0,1,1
29141,58thStGreenway22ndAve,06/27/2017 05:00:00 AM,48,-122,0,1,1
29142,58thStGreenway22ndAve,06/27/2017 06:00:00 AM,48,-122,2,7,9
29143,58thStGreenway22ndAve,06/27/2017 07:00:00 AM,48,-122,6,2,8
29144,58thStGreenway22ndAve,06/27/2017 08:00:00 AM,48,-122,4,5,9
29145,58thStGreenway22ndAve,06/27/2017 09:00:00 AM,48,-122,8,2,10
29146,58thStGreenway22ndAve,06/27/2017 10:00:00 AM,48,-122,4,3,7
29147,58thStGreenway22ndAve,06/27/2017 11:00:00 AM,48,-122,6,2,8
29148,58thStGreenway22ndAve,06/27/2017 12:00:00 PM,48,-122,5,3,8
29149,58thStGreenway22ndAve,06/27/2017 01:00:00 PM,48,-122,2,7,9
29150,58thStGreenway22ndAve,06/27/2017 02:00:00 PM,48,-122,5,8,13
29151,58thStGreenway22ndAve,06/27/2017 03:00:00 PM,48,-122,8,8,16
29152,58thStGreenway22ndAve,06/27/2017 04:00:00 PM,48,-122,9,8,17
29153,58thStGreenway22ndAve,06/27/2017 05:00:00 PM,48,-122,9,3,12
29154,58thStGreenway22ndAve,06/27/2017 06:00:00 PM,48,-122,10,10,20
29155,58thStGreenway22ndAve,06/27/2017 07:00:00 PM,48,-122,4,5,9
29156,58thStGreenway22ndAve,06/27/2017 08:00:00 PM,48,-122,3,8,11
29157,58thStGreenway22ndAve,06/27/2017 09:00:00 PM,48,-122,2,4,6
29158,58thStGreenway22ndAve,06/27/2017 10:00:00 PM,48,-122,0,1,1
29159,58thStGreenway22ndAve,06/27/2017 11:00:00 PM,48,-122,1,0,1
29160,58thStGreenway22ndAve,06/28/2017 12:00:00 AM,48,-122,0,0,0
29161,58thStGreenway22ndAve,06/28/2017 01:00:00 AM,48,-122,0,0,0
29162,58thStGreenway22ndAve,06/28/2017 02:00:00 AM,48,-122,1,0,1
29163,58thStGreenway22ndAve,06/28/2017 03:00:00 AM,48,-122,0,0,0
29164,58thStGreenway22ndAve,06/28/2017 04:00:00 AM,48,-122,0,0,0
29165,58thStGreenway22ndAve,06/28/2017 05:00:00 AM,48,-122,0,1,1
29166,58thStGreenway22ndAve,06/28/2017 06:00:00 AM,48,-122,7,5,12
29167,58thStGreenway22ndAve,06/28/2017 07:00:00 AM,48,-122,1,3,4
29168,58thStGreenway22ndAve,06/28/2017 08:00:00 AM,48,-122,3,6,9
29169,58thStGreenway22ndAve,06/28/2017 09:00:00 AM,48,-122,2,3,5
29170,58thStGreenway22ndAve,06/28/2017 10:00:00 AM,48,-122,2,2,4
29171,58thStGreenway22ndAve,06/28/2017 11:00:00 AM,48,-122,4,1,5
29172,58thStGreenway22ndAve,06/28/2017 12:00:00 PM,48,-122,0,2,2
29173,58thStGreenway22ndAve,06/28/2017 01:00:00 PM,48,-122,7,2,9
29174,58thStGreenway22ndAve,06/28/2017 02:00:00 PM,48,-122,6,7,13
29175,58thStGreenway22ndAve,06/28/2017 03:00:00 PM,48,-122,6,2,8
29176,58thStGreenway22ndAve,06/28/2017 04:00:00 PM,48,-122,10,6,16
29177,58thStGreenway22ndAve,06/28/2017 05:00:00 PM,48,-122,10,8,18
29178,58thStGreenway22ndAve,06/28/2017 06:00:00 PM,48,-122,3,4,7
29179,58thStGreenway22ndAve,06/28/2017 07:00:00 PM,48,-122,4,3,7
29180,58thStGreenway22ndAve,06/28/2017 08:00:00 PM,48,-122,5,5,10
29181,58thStGreenway22ndAve,06/28/2017 09:00:00 PM,48,-122,0,4,4
29182,58thStGreenway22ndAve,06/28/2017 10:00:00 PM,48,-122,0,0,0
29183,58thStGreenway22ndAve,06/28/2017 11:00:00 PM,48,-122,0,0,0
29184,58thStGreenway22ndAve,06/29/2017 12:00:00 AM,48,-122,0,0,0
29185,58thStGreenway22ndAve,06/29/2017 01:00:00 AM,48,-122,0,0,0
29186,58thStGreenway22ndAve,06/29/2017 02:00:00 AM,48,-122,1,0,1
29187,58thStGreenway22ndAve,06/29/2017 03:00:00 AM,48,-122,0,0,0
29188,58thStGreenway22ndAve,06/29/2017 04:00:00 AM,48,-122,2,1,3
29189,58thStGreenway22ndAve,06/29/2017 05:00:00 AM,48,-122,2,2,4
29190,58thStGreenway22ndAve,06/29/2017 06:00:00 AM,48,-122,1,5,6
29191,58thStGreenway22ndAve,06/29/2017 07:00:00 AM,48,-122,8,4,12
29192,58thStGreenway22ndAve,06/29/2017 08:00:00 AM,48,-122,15,0,15
29193,58thStGreenway22ndAve,06/29/2017 09:00:00 AM,48,-122,8,5,13
29194,58thStGreenway22ndAve,06/29/2017 10:00:00 AM,48,-122,8,5,13
29195,58thStGreenway22ndAve,06/29/2017 11:00:00 AM,48,-122,9,3,12
29196,58thStGreenway22ndAve,06/29/2017 12:00:00 PM,48,-122,9,5,14
29197,58thStGreenway22ndAve,06/29/2017 01:00:00 PM,48,-122,9,3,12
29198,58thStGreenway22ndAve,06/29/2017 02:00:00 PM,48,-122,6,4,10
29199,58thStGreenway22ndAve,06/29/2017 03:00:00 PM,48,-122,7,5,12
29200,58thStGreenway22ndAve,06/29/2017 04:00:00 PM,48,-122,11,8,19
29201,58thStGreenway22ndAve,06/29/2017 05:00:00 PM,48,-122,11,14,25
29202,58thStGreenway22ndAve,06/29/2017 06:00:00 PM,48,-122,11,8,19
29203,58thStGreenway22ndAve,06/29/2017 07:00:00 PM,48,-122,4,6,10
29204,58thStGreenway22ndAve,06/29/2017 08:00:00 PM,48,-122,2,6,8
29205,58thStGreenway22ndAve,06/29/2017 09:00:00 PM,48,-122,2,3,5
29206,58thStGreenway22ndAve,06/29/2017 10:00:00 PM,48,-122,2,0,2
29207,58thStGreenway22ndAve,06/29/2017 11:00:00 PM,48,-122,1,0,1
29208,58thStGreenway22ndAve,06/30/2017 12:00:00 AM,48,-122,0,0,0
29209,58thStGreenway22ndAve,06/30/2017 01:00:00 AM,48,-122,1,0,1
29210,58thStGreenway22ndAve,06/30/2017 02:00:00 AM,48,-122,0,0,0
29211,58thStGreenway22ndAve,06/30/2017 03:00:00 AM,48,-122,0,0,0
29212,58thStGreenway22ndAve,06/30/2017 04:00:00 AM,48,-122,1,0,1
29213,58thStGreenway22ndAve,06/30/2017 05:00:00 AM,48,-122,1,3,4
29214,58thStGreenway22ndAve,06/30/2017 06:00:00 AM,48,-122,5,3,8
29215,58thStGreenway22ndAve,06/30/2017 07:00:00 AM,48,-122,6,6,12
29216,58thStGreenway22ndAve,06/30/2017 08:00:00 AM,48,-122,2,3,5
29217,58thStGreenway22ndAve,06/30/2017 09:00:00 AM,48,-122,5,2,7
29218,58thStGreenway22ndAve,06/30/2017 10:00:00 AM,48,-122,10,3,13
29219,58thStGreenway22ndAve,06/30/2017 11:00:00 AM,48,-122,13,5,18
29220,58thStGreenway22ndAve,06/30/2017 12:00:00 PM,48,-122,2,2,4
29221,58thStGreenway22ndAve,06/30/2017 01:00:00 PM,48,-122,4,2,6
29222,58thStGreenway22ndAve,06/30/2017 02:00:00 PM,48,-122,6,5,11
29223,58thStGreenway22ndAve,06/30/2017 03:00:00 PM,48,-122,9,7,16
29224,58thStGreenway22ndAve,06/30/2017 04:00:00 PM,48,-122,3,11,14
29225,58thStGreenway22ndAve,06/30/2017 05:00:00 PM,48,-122,4,9,13
29226,58thStGreenway22ndAve,06/30/2017 06:00:00 PM,48,-122,9,3,12
29227,58thStGreenway22ndAve,06/30/2017 07:00:00 PM,48,-122,7,5,12
29228,58thStGreenway22ndAve,06/30/2017 08:00:00 PM,48,-122,5,3,8
29229,58thStGreenway22ndAve,06/30/2017 09:00:00 PM,48,-122,2,1,3
29230,58thStGreenway22ndAve,06/30/2017 10:00:00 PM,48,-122,2,4,6
29231,58thStGreenway22ndAve,06/30/2017 11:00:00 PM,48,-122,0,2,2
29232,58thStGreenway22ndAve,07/01/2017 12:00:00 AM,48,-122,1,0,1
29233,58thStGreenway22ndAve,07/01/2017 01:00:00 AM,48,-122,0,0,0
29234,58thStGreenway22ndAve,07/01/2017 02:00:00 AM,48,-122,0,0,0
29235,58thStGreenway22ndAve,07/01/2017 03:00:00 AM,48,-122,0,0,0
29236,58thStGreenway22ndAve,07/01/2017 04:00:00 AM,48,-122,0,1,1
29237,58thStGreenway22ndAve,07/01/2017 05:00:00 AM,48,-122,0,0,0
29238,58thStGreenway22ndAve,07/01/2017 06:00:00 AM,48,-122,4,1,5
29239,58thStGreenway22ndAve,07/01/2017 07:00:00 AM,48,-122,2,3,5
29240,58thStGreenway22ndAve,07/01/2017 08:00:00 AM,48,-122,3,4,7
29241,58thStGreenway22ndAve,07/01/2017 09:00:00 AM,48,-122,9,3,12
29242,58thStGreenway22ndAve,07/01/2017 10:00:00 AM,48,-122,9,5,14
29243,58thStGreenway22ndAve,07/01/2017 11:00:00 AM,48,-122,11,7,18
29244,58thStGreenway22ndAve,07/01/2017 12:00:00 PM,48,-122,9,5,14
29245,58thStGreenway22ndAve,07/01/2017 01:00:00 PM,48,-122,10,5,15
29246,58thStGreenway22ndAve,07/01/2017 02:00:00 PM,48,-122,6,10,16
29247,58thStGreenway22ndAve,07/01/2017 03:00:00 PM,48,-122,10,7,17
29248,58thStGreenway22ndAve,07/01/2017 04:00:00 PM,48,-122,9,6,15
29249,58thStGreenway22ndAve,07/01/2017 05:00:00 PM,48,-122,4,11,15
29250,58thStGreenway22ndAve,07/01/2017 06:00:00 PM,48,-122,3,3,6
29251,58thStGreenway22ndAve,07/01/2017 07:00:00 PM,48,-122,2,13,15
29252,58thStGreenway22ndAve,07/01/2017 08:00:00 PM,48,-122,4,2,6
29253,58thStGreenway22ndAve,07/01/2017 09:00:00 PM,48,-122,0,1,1
29254,58thStGreenway22ndAve,07/01/2017 10:00:00 PM,48,-122,2,1,3
29255,58thStGreenway22ndAve,07/01/2017 11:00:00 PM,48,-122,0,0,0
29256,58thStGreenway22ndAve,07/02/2017 12:00:00 AM,48,-122,2,0,2
29257,58thStGreenway22ndAve,07/02/2017 01:00:00 AM,48,-122,0,0,0
29258,58thStGreenway22ndAve,07/02/2017 02:00:00 AM,48,-122,0,0,0
29259,58thStGreenway22ndAve,07/02/2017 03:00:00 AM,48,-122,0,0,0
29260,58thStGreenway22ndAve,07/02/2017 04:00:00 AM,48,-122,0,0,0
29261,58thStGreenway22ndAve,07/02/2017 05:00:00 AM,48,-122,0,0,0
29262,58thStGreenway22ndAve,07/02/2017 06:00:00 AM,48,-122,0,1,1
29263,58thStGreenway22ndAve,07/02/2017 07:00:00 AM,48,-122,2,3,5
29264,58thStGreenway22ndAve,07/02/2017 08:00:00 AM,48,-122,3,5,8
29265,58thStGreenway22ndAve,07/02/2017 09:00:00 AM,48,-122,7,6,13
29266,58thStGreenway22ndAve,07/02/2017 10:00:00 AM,48,-122,9,3,12
29267,58thStGreenway22ndAve,07/02/2017 11:00:00 AM,48,-122,11,4,15
29268,58thStGreenway22ndAve,07/02/2017 12:00:00 PM,48,-122,12,9,21
29269,58thStGreenway22ndAve,07/02/2017 01:00:00 PM,48,-122,7,13,20
29270,58thStGreenway22ndAve,07/02/2017 02:00:00 PM,48,-122,13,16,29
29271,58thStGreenway22ndAve,07/02/2017 03:00:00 PM,48,-122,5,5,10
29272,58thStGreenway22ndAve,07/02/2017 04:00:00 PM,48,-122,5,11,16
29273,58thStGreenway22ndAve,07/02/2017 05:00:00 PM,48,-122,7,6,13
29274,58thStGreenway22ndAve,07/02/2017 06:00:00 PM,48,-122,4,4,8
29275,58thStGreenway22ndAve,07/02/2017 07:00:00 PM,48,-122,5,7,12
29276,58thStGreenway22ndAve,07/02/2017 08:00:00 PM,48,-122,3,2,5
29277,58thStGreenway22ndAve,07/02/2017 09:00:00 PM,48,-122,3,3,6
29278,58thStGreenway22ndAve,07/02/2017 10:00:00 PM,48,-122,1,0,1
29279,58thStGreenway22ndAve,07/02/2017 11:00:00 PM,48,-122,1,1,2
29280,58thStGreenway22ndAve,07/03/2017 12:00:00 AM,48,-122,1,0,1
29281,58thStGreenway22ndAve,07/03/2017 01:00:00 AM,48,-122,0,0,0
29282,58thStGreenway22ndAve,07/03/2017 02:00:00 AM,48,-122,0,0,0
29283,58thStGreenway22ndAve,07/03/2017 03:00:00 AM,48,-122,0,0,0
29284,58thStGreenway22ndAve,07/03/2017 04:00:00 AM,48,-122,1,0,1
29285,58thStGreenway22ndAve,07/03/2017 05:00:00 AM,48,-122,0,0,0
29286,58thStGreenway22ndAve,07/03/2017 06:00:00 AM,48,-122,4,2,6
29287,58thStGreenway22ndAve,07/03/2017 07:00:00 AM,48,-122,4,2,6
29288,58thStGreenway22ndAve,07/03/2017 08:00:00 AM,48,-122,4,5,9
29289,58thStGreenway22ndAve,07/03/2017 09:00:00 AM,48,-122,10,4,14
29290,58thStGreenway22ndAve,07/03/2017 10:00:00 AM,48,-122,0,0,0
29291,58thStGreenway22ndAve,07/03/2017 11:00:00 AM,48,-122,14,5,19
29292,58thStGreenway22ndAve,07/03/2017 12:00:00 PM,48,-122,7,2,9
29293,58thStGreenway22ndAve,07/03/2017 01:00:00 PM,48,-122,9,8,17
29294,58thStGreenway22ndAve,07/03/2017 02:00:00 PM,48,-122,5,7,12
29295,58thStGreenway22ndAve,07/03/2017 03:00:00 PM,48,-122,10,12,22
29296,58thStGreenway22ndAve,07/03/2017 04:00:00 PM,48,-122,13,6,19
29297,58thStGreenway22ndAve,07/03/2017 05:00:00 PM,48,-122,11,19,30
29298,58thStGreenway22ndAve,07/03/2017 06:00:00 PM,48,-122,2,8,10
29299,58thStGreenway22ndAve,07/03/2017 07:00:00 PM,48,-122,5,6,11
29300,58thStGreenway22ndAve,07/03/2017 08:00:00 PM,48,-122,3,4,7
29301,58thStGreenway22ndAve,07/03/2017 09:00:00 PM,48,-122,5,4,9
29302,58thStGreenway22ndAve,07/03/2017 10:00:00 PM,48,-122,1,5,6
29303,58thStGreenway22ndAve,07/03/2017 11:00:00 PM,48,-122,2,3,5
29304,58thStGreenway22ndAve,07/04/2017 12:00:00 AM,48,-122,0,0,0
29305,58thStGreenway22ndAve,07/04/2017 01:00:00 AM,48,-122,1,0,1
29306,58thStGreenway22ndAve,07/04/2017 02:00:00 AM,48,-122,0,0,0
29307,58thStGreenway22ndAve,07/04/2017 03:00:00 AM,48,-122,0,1,1
29308,58thStGreenway22ndAve,07/04/2017 04:00:00 AM,48,-122,0,0,0
29309,58thStGreenway22ndAve,07/04/2017 05:00:00 AM,48,-122,0,0,0
29310,58thStGreenway22ndAve,07/04/2017 06:00:00 AM,48,-122,0,0,0
29311,58thStGreenway22ndAve,07/04/2017 07:00:00 AM,48,-122,1,3,4
29312,58thStGreenway22ndAve,07/04/2017 08:00:00 AM,48,-122,5,8,13
29313,58thStGreenway22ndAve,07/04/2017 09:00:00 AM,48,-122,9,3,12
29314,58thStGreenway22ndAve,07/04/2017 10:00:00 AM,48,-122,11,7,18
29315,58thStGreenway22ndAve,07/04/2017 11:00:00 AM,48,-122,13,21,34
29316,58thStGreenway22ndAve,07/04/2017 12:00:00 PM,48,-122,7,11,18
29317,58thStGreenway22ndAve,07/04/2017 01:00:00 PM,48,-122,7,10,17
29318,58thStGreenway22ndAve,07/04/2017 02:00:00 PM,48,-122,5,5,10
29319,58thStGreenway22ndAve,07/04/2017 03:00:00 PM,48,-122,6,9,15
29320,58thStGreenway22ndAve,07/04/2017 04:00:00 PM,48,-122,8,10,18
29321,58thStGreenway22ndAve,07/04/2017 05:00:00 PM,48,-122,6,8,14
29322,58thStGreenway22ndAve,07/04/2017 06:00:00 PM,48,-122,2,4,6
29323,58thStGreenway22ndAve,07/04/2017 07:00:00 PM,48,-122,4,4,8
29324,58thStGreenway22ndAve,07/04/2017 08:00:00 PM,48,-122,3,5,8
29325,58thStGreenway22ndAve,07/04/2017 09:00:00 PM,48,-122,2,2,4
29326,58thStGreenway22ndAve,07/04/2017 10:00:00 PM,48,-122,0,3,3
29327,58thStGreenway22ndAve,07/04/2017 11:00:00 PM,48,-122,7,2,9
29328,58thStGreenway22ndAve,07/05/2017 12:00:00 AM,48,-122,4,0,4
29329,58thStGreenway22ndAve,07/05/2017 01:00:00 AM,48,-122,0,1,1
29330,58thStGreenway22ndAve,07/05/2017 02:00:00 AM,48,-122,0,0,0
29331,58thStGreenway22ndAve,07/05/2017 03:00:00 AM,48,-122,0,1,1
29332,58thStGreenway22ndAve,07/05/2017 04:00:00 AM,48,-122,0,1,1
29333,58thStGreenway22ndAve,07/05/2017 05:00:00 AM,48,-122,0,0,0
29334,58thStGreenway22ndAve,07/05/2017 06:00:00 AM,48,-122,1,0,1
29335,58thStGreenway22ndAve,07/05/2017 07:00:00 AM,48,-122,4,5,9
29336,58thStGreenway22ndAve,07/05/2017 08:00:00 AM,48,-122,5,3,8
29337,58thStGreenway22ndAve,07/05/2017 09:00:00 AM,48,-122,6,5,11
29338,58thStGreenway22ndAve,07/05/2017 10:00:00 AM,48,-122,7,3,10
29339,58thStGreenway22ndAve,07/05/2017 11:00:00 AM,48,-122,0,6,6
29340,58thStGreenway22ndAve,07/05/2017 12:00:00 PM,48,-122,8,2,10
29341,58thStGreenway22ndAve,07/05/2017 01:00:00 PM,48,-122,2,5,7
29342,58thStGreenway22ndAve,07/05/2017 02:00:00 PM,48,-122,4,2,6
29343,58thStGreenway22ndAve,07/05/2017 03:00:00 PM,48,-122,2,4,6
29344,58thStGreenway22ndAve,07/05/2017 04:00:00 PM,48,-122,4,9,13
29345,58thStGreenway22ndAve,07/05/2017 05:00:00 PM,48,-122,9,11,20
29346,58thStGreenway22ndAve,07/05/2017 06:00:00 PM,48,-122,6,9,15
29347,58thStGreenway22ndAve,07/05/2017 07:00:00 PM,48,-122,7,2,9
29348,58thStGreenway22ndAve,07/05/2017 08:00:00 PM,48,-122,7,7,14
29349,58thStGreenway22ndAve,07/05/2017 09:00:00 PM,48,-122,1,1,2
29350,58thStGreenway22ndAve,07/05/2017 10:00:00 PM,48,-122,1,1,2
29351,58thStGreenway22ndAve,07/05/2017 11:00:00 PM,48,-122,0,1,1
29352,58thStGreenway22ndAve,07/06/2017 12:00:00 AM,48,-122,0,0,0
29353,58thStGreenway22ndAve,07/06/2017 01:00:00 AM,48,-122,0,0,0
29354,58thStGreenway22ndAve,07/06/2017 02:00:00 AM,48,-122,0,0,0
29355,58thStGreenway22ndAve,07/06/2017 03:00:00 AM,48,-122,0,0,0
29356,58thStGreenway22ndAve,07/06/2017 04:00:00 AM,48,-122,0,0,0
29357,58thStGreenway22ndAve,07/06/2017 05:00:00 AM,48,-122,0,0,0
29358,58thStGreenway22ndAve,07/06/2017 06:00:00 AM,48,-122,1,2,3
29359,58thStGreenway22ndAve,07/06/2017 07:00:00 AM,48,-122,4,4,8
29360,58thStGreenway22ndAve,07/06/2017 08:00:00 AM,48,-122,6,7,13
29361,58thStGreenway22ndAve,07/06/2017 09:00:00 AM,48,-122,5,1,6
29362,58thStGreenway22ndAve,07/06/2017 10:00:00 AM,48,-122,12,8,20
29363,58thStGreenway22ndAve,07/06/2017 11:00:00 AM,48,-122,7,3,10
29364,58thStGreenway22ndAve,07/06/2017 12:00:00 PM,48,-122,7,6,13
29365,58thStGreenway22ndAve,07/06/2017 01:00:00 PM,48,-122,1,7,8
29366,58thStGreenway22ndAve,07/06/2017 02:00:00 PM,48,-122,2,4,6
29367,58thStGreenway22ndAve,07/06/2017 03:00:00 PM,48,-122,2,7,9
29368,58thStGreenway22ndAve,07/06/2017 04:00:00 PM,48,-122,6,7,13
29369,58thStGreenway22ndAve,07/06/2017 05:00:00 PM,48,-122,2,8,10
29370,58thStGreenway22ndAve,07/06/2017 06:00:00 PM,48,-122,10,7,17
29371,58thStGreenway22ndAve,07/06/2017 07:00:00 PM,48,-122,2,7,9
29372,58thStGreenway22ndAve,07/06/2017 08:00:00 PM,48,-122,2,2,4
29373,58thStGreenway22ndAve,07/06/2017 09:00:00 PM,48,-122,2,4,6
29374,58thStGreenway22ndAve,07/06/2017 10:00:00 PM,48,-122,2,3,5
29375,58thStGreenway22ndAve,07/06/2017 11:00:00 PM,48,-122,0,0,0
29376,58thStGreenway22ndAve,07/07/2017 12:00:00 AM,48,-122,0,0,0
29377,58thStGreenway22ndAve,07/07/2017 01:00:00 AM,48,-122,0,0,0
29378,58thStGreenway22ndAve,07/07/2017 02:00:00 AM,48,-122,0,0,0
29379,58thStGreenway22ndAve,07/07/2017 03:00:00 AM,48,-122,0,1,1
29380,58thStGreenway22ndAve,07/07/2017 04:00:00 AM,48,-122,2,0,2
29381,58thStGreenway22ndAve,07/07/2017 05:00:00 AM,48,-122,1,0,1
29382,58thStGreenway22ndAve,07/07/2017 06:00:00 AM,48,-122,0,1,1
29383,58thStGreenway22ndAve,07/07/2017 07:00:00 AM,48,-122,1,4,5
29384,58thStGreenway22ndAve,07/07/2017 08:00:00 AM,48,-122,5,6,11
29385,58thStGreenway22ndAve,07/07/2017 09:00:00 AM,48,-122,6,4,10
29386,58thStGreenway22ndAve,07/07/2017 10:00:00 AM,48,-122,1,2,3
29387,58thStGreenway22ndAve,07/07/2017 11:00:00 AM,48,-122,3,2,5
29388,58thStGreenway22ndAve,07/07/2017 12:00:00 PM,48,-122,4,2,6
29389,58thStGreenway22ndAve,07/07/2017 01:00:00 PM,48,-122,2,6,8
29390,58thStGreenway22ndAve,07/07/2017 02:00:00 PM,48,-122,4,4,8
29391,58thStGreenway22ndAve,07/07/2017 03:00:00 PM,48,-122,5,7,12
29392,58thStGreenway22ndAve,07/07/2017 04:00:00 PM,48,-122,6,2,8
29393,58thStGreenway22ndAve,07/07/2017 05:00:00 PM,48,-122,10,16,26
29394,58thStGreenway22ndAve,07/07/2017 06:00:00 PM,48,-122,14,4,18
29395,58thStGreenway22ndAve,07/07/2017 07:00:00 PM,48,-122,5,4,9
29396,58thStGreenway22ndAve,07/07/2017 08:00:00 PM,48,-122,7,8,15
29397,58thStGreenway22ndAve,07/07/2017 09:00:00 PM,48,-122,1,6,7
29398,58thStGreenway22ndAve,07/07/2017 10:00:00 PM,48,-122,5,1,6
29399,58thStGreenway22ndAve,07/07/2017 11:00:00 PM,48,-122,9,1,10
29400,58thStGreenway22ndAve,07/08/2017 12:00:00 AM,48,-122,7,3,10
29401,58thStGreenway22ndAve,07/08/2017 01:00:00 AM,48,-122,0,1,1
29402,58thStGreenway22ndAve,07/08/2017 02:00:00 AM,48,-122,0,0,0
29403,58thStGreenway22ndAve,07/08/2017 03:00:00 AM,48,-122,0,0,0
29404,58thStGreenway22ndAve,07/08/2017 04:00:00 AM,48,-122,0,0,0
29405,58thStGreenway22ndAve,07/08/2017 05:00:00 AM,48,-122,0,0,0
29406,58thStGreenway22ndAve,07/08/2017 06:00:00 AM,48,-122,1,1,2
29407,58thStGreenway22ndAve,07/08/2017 07:00:00 AM,48,-122,4,1,5
29408,58thStGreenway22ndAve,07/08/2017 08:00:00 AM,48,-122,9,2,11
29409,58thStGreenway22ndAve,07/08/2017 09:00:00 AM,48,-122,10,9,19
29410,58thStGreenway22ndAve,07/08/2017 10:00:00 AM,48,-122,20,15,35
29411,58thStGreenway22ndAve,07/08/2017 11:00:00 AM,48,-122,18,6,24
29412,58thStGreenway22ndAve,07/08/2017 12:00:00 PM,48,-122,19,8,27
29413,58thStGreenway22ndAve,07/08/2017 01:00:00 PM,48,-122,19,13,32
29414,58thStGreenway22ndAve,07/08/2017 02:00:00 PM,48,-122,10,4,14
29415,58thStGreenway22ndAve,07/08/2017 03:00:00 PM,48,-122,19,22,41
29416,58thStGreenway22ndAve,07/08/2017 04:00:00 PM,48,-122,10,9,19
29417,58thStGreenway22ndAve,07/08/2017 05:00:00 PM,48,-122,23,10,33
29418,58thStGreenway22ndAve,07/08/2017 06:00:00 PM,48,-122,11,9,20
29419,58thStGreenway22ndAve,07/08/2017 07:00:00 PM,48,-122,6,10,16
29420,58thStGreenway22ndAve,07/08/2017 08:00:00 PM,48,-122,7,6,13
29421,58thStGreenway22ndAve,07/08/2017 09:00:00 PM,48,-122,3,2,5
29422,58thStGreenway22ndAve,07/08/2017 10:00:00 PM,48,-122,2,2,4
29423,58thStGreenway22ndAve,07/08/2017 11:00:00 PM,48,-122,0,1,1
29424,58thStGreenway22ndAve,07/09/2017 12:00:00 AM,48,-122,1,2,3
29425,58thStGreenway22ndAve,07/09/2017 01:00:00 AM,48,-122,0,1,1
29426,58thStGreenway22ndAve,07/09/2017 02:00:00 AM,48,-122,1,0,1
29427,58thStGreenway22ndAve,07/09/2017 03:00:00 AM,48,-122,1,1,2
29428,58thStGreenway22ndAve,07/09/2017 04:00:00 AM,48,-122,1,0,1
29429,58thStGreenway22ndAve,07/09/2017 05:00:00 AM,48,-122,0,0,0
29430,58thStGreenway22ndAve,07/09/2017 06:00:00 AM,48,-122,0,0,0
29431,58thStGreenway22ndAve,07/09/2017 07:00:00 AM,48,-122,2,2,4
29432,58thStGreenway22ndAve,07/09/2017 08:00:00 AM,48,-122,3,2,5
29433,58thStGreenway22ndAve,07/09/2017 09:00:00 AM,48,-122,13,4,17
29434,58thStGreenway22ndAve,07/09/2017 10:00:00 AM,48,-122,20,11,31
29435,58thStGreenway22ndAve,07/09/2017 11:00:00 AM,48,-122,14,15,29
29436,58thStGreenway22ndAve,07/09/2017 12:00:00 PM,48,-122,10,9,19
29437,58thStGreenway22ndAve,07/09/2017 01:00:00 PM,48,-122,18,7,25
29438,58thStGreenway22ndAve,07/09/2017 02:00:00 PM,48,-122,23,14,37
29439,58thStGreenway22ndAve,07/09/2017 03:00:00 PM,48,-122,17,9,26
29440,58thStGreenway22ndAve,07/09/2017 04:00:00 PM,48,-122,8,11,19
29441,58thStGreenway22ndAve,07/09/2017 05:00:00 PM,48,-122,10,10,20
29442,58thStGreenway22ndAve,07/09/2017 06:00:00 PM,48,-122,10,10,20
29443,58thStGreenway22ndAve,07/09/2017 07:00:00 PM,48,-122,9,8,17
29444,58thStGreenway22ndAve,07/09/2017 08:00:00 PM,48,-122,8,1,9
29445,58thStGreenway22ndAve,07/09/2017 09:00:00 PM,48,-122,6,2,8
29446,58thStGreenway22ndAve,07/09/2017 10:00:00 PM,48,-122,3,0,3
29447,58thStGreenway22ndAve,07/09/2017 11:00:00 PM,48,-122,3,0,3
29448,58thStGreenway22ndAve,07/10/2017 12:00:00 AM,48,-122,1,1,2
29449,58thStGreenway22ndAve,07/10/2017 01:00:00 AM,48,-122,0,0,0
29450,58thStGreenway22ndAve,07/10/2017 02:00:00 AM,48,-122,0,0,0
29451,58thStGreenway22ndAve,07/10/2017 03:00:00 AM,48,-122,0,0,0
29452,58thStGreenway22ndAve,07/10/2017 04:00:00 AM,48,-122,1,0,1
29453,58thStGreenway22ndAve,07/10/2017 05:00:00 AM,48,-122,1,0,1
29454,58thStGreenway22ndAve,07/10/2017 06:00:00 AM,48,-122,2,2,4
29455,58thStGreenway22ndAve,07/10/2017 07:00:00 AM,48,-122,3,6,9
29456,58thStGreenway22ndAve,07/10/2017 08:00:00 AM,48,-122,8,7,15
29457,58thStGreenway22ndAve,07/10/2017 09:00:00 AM,48,-122,5,4,9
29458,58thStGreenway22ndAve,07/10/2017 10:00:00 AM,48,-122,12,2,14
29459,58thStGreenway22ndAve,07/10/2017 11:00:00 AM,48,-122,7,1,8
29460,58thStGreenway22ndAve,07/10/2017 12:00:00 PM,48,-122,8,4,12
29461,58thStGreenway22ndAve,07/10/2017 01:00:00 PM,48,-122,1,4,5
29462,58thStGreenway22ndAve,07/10/2017 02:00:00 PM,48,-122,2,7,9
29463,58thStGreenway22ndAve,07/10/2017 03:00:00 PM,48,-122,4,2,6
29464,58thStGreenway22ndAve,07/10/2017 04:00:00 PM,48,-122,6,5,11
29465,58thStGreenway22ndAve,07/10/2017 05:00:00 PM,48,-122,8,11,19
29466,58thStGreenway22ndAve,07/10/2017 06:00:00 PM,48,-122,9,10,19
29467,58thStGreenway22ndAve,07/10/2017 07:00:00 PM,48,-122,9,4,13
29468,58thStGreenway22ndAve,07/10/2017 08:00:00 PM,48,-122,5,6,11
29469,58thStGreenway22ndAve,07/10/2017 09:00:00 PM,48,-122,3,5,8
29470,58thStGreenway22ndAve,07/10/2017 10:00:00 PM,48,-122,1,0,1
29471,58thStGreenway22ndAve,07/10/2017 11:00:00 PM,48,-122,0,0,0
29472,58thStGreenway22ndAve,07/11/2017 12:00:00 AM,48,-122,0,0,0
29473,58thStGreenway22ndAve,07/11/2017 01:00:00 AM,48,-122,0,0,0
29474,58thStGreenway22ndAve,07/11/2017 02:00:00 AM,48,-122,0,0,0
29475,58thStGreenway22ndAve,07/11/2017 03:00:00 AM,48,-122,0,0,0
29476,58thStGreenway22ndAve,07/11/2017 04:00:00 AM,48,-122,0,0,0
29477,58thStGreenway22ndAve,07/11/2017 05:00:00 AM,48,-122,1,0,1
29478,58thStGreenway22ndAve,07/11/2017 06:00:00 AM,48,-122,5,1,6
29479,58thStGreenway22ndAve,07/11/2017 07:00:00 AM,48,-122,5,5,10
29480,58thStGreenway22ndAve,07/11/2017 08:00:00 AM,48,-122,7,5,12
29481,58thStGreenway22ndAve,07/11/2017 09:00:00 AM,48,-122,3,3,6
29482,58thStGreenway22ndAve,07/11/2017 10:00:00 AM,48,-122,6,2,8
29483,58thStGreenway22ndAve,07/11/2017 11:00:00 AM,48,-122,5,4,9
29484,58thStGreenway22ndAve,07/11/2017 12:00:00 PM,48,-122,10,5,15
29485,58thStGreenway22ndAve,07/11/2017 01:00:00 PM,48,-122,12,8,20
29486,58thStGreenway22ndAve,07/11/2017 02:00:00 PM,48,-122,6,3,9
29487,58thStGreenway22ndAve,07/11/2017 03:00:00 PM,48,-122,5,8,13
29488,58thStGreenway22ndAve,07/11/2017 04:00:00 PM,48,-122,7,11,18
29489,58thStGreenway22ndAve,07/11/2017 05:00:00 PM,48,-122,5,15,20
29490,58thStGreenway22ndAve,07/11/2017 06:00:00 PM,48,-122,17,9,26
29491,58thStGreenway22ndAve,07/11/2017 07:00:00 PM,48,-122,5,4,9
29492,58thStGreenway22ndAve,07/11/2017 08:00:00 PM,48,-122,6,4,10
29493,58thStGreenway22ndAve,07/11/2017 09:00:00 PM,48,-122,3,4,7
29494,58thStGreenway22ndAve,07/11/2017 10:00:00 PM,48,-122,0,2,2
29495,58thStGreenway22ndAve,07/11/2017 11:00:00 PM,48,-122,0,0,0
29496,58thStGreenway22ndAve,07/12/2017 12:00:00 AM,48,-122,0,0,0
29497,58thStGreenway22ndAve,07/12/2017 01:00:00 AM,48,-122,0,0,0
29498,58thStGreenway22ndAve,07/12/2017 02:00:00 AM,48,-122,0,0,0
29499,58thStGreenway22ndAve,07/12/2017 03:00:00 AM,48,-122,0,2,2
29500,58thStGreenway22ndAve,07/12/2017 04:00:00 AM,48,-122,0,0,0
29501,58thStGreenway22ndAve,07/12/2017 05:00:00 AM,48,-122,0,0,0
29502,58thStGreenway22ndAve,07/12/2017 06:00:00 AM,48,-122,9,5,14
29503,58thStGreenway22ndAve,07/12/2017 07:00:00 AM,48,-122,7,7,14
29504,58thStGreenway22ndAve,07/12/2017 08:00:00 AM,48,-122,7,2,9
29505,58thStGreenway22ndAve,07/12/2017 09:00:00 AM,48,-122,6,5,11
29506,58thStGreenway22ndAve,07/12/2017 10:00:00 AM,48,-122,4,2,6
29507,58thStGreenway22ndAve,07/12/2017 11:00:00 AM,48,-122,4,5,9
29508,58thStGreenway22ndAve,07/12/2017 12:00:00 PM,48,-122,6,2,8
29509,58thStGreenway22ndAve,07/12/2017 01:00:00 PM,48,-122,5,1,6
29510,58thStGreenway22ndAve,07/12/2017 02:00:00 PM,48,-122,6,6,12
29511,58thStGreenway22ndAve,07/12/2017 03:00:00 PM,48,-122,3,3,6
29512,58thStGreenway22ndAve,07/12/2017 04:00:00 PM,48,-122,11,10,21
29513,58thStGreenway22ndAve,07/12/2017 05:00:00 PM,48,-122,11,12,23
29514,58thStGreenway22ndAve,07/12/2017 06:00:00 PM,48,-122,15,7,22
29515,58thStGreenway22ndAve,07/12/2017 07:00:00 PM,48,-122,11,7,18
29516,58thStGreenway22ndAve,07/12/2017 08:00:00 PM,48,-122,6,8,14
29517,58thStGreenway22ndAve,07/12/2017 09:00:00 PM,48,-122,4,2,6
29518,58thStGreenway22ndAve,07/12/2017 10:00:00 PM,48,-122,3,0,3
29519,58thStGreenway22ndAve,07/12/2017 11:00:00 PM,48,-122,0,2,2
29520,58thStGreenway22ndAve,07/13/2017 12:00:00 AM,48,-122,0,0,0
29521,58thStGreenway22ndAve,07/13/2017 01:00:00 AM,48,-122,0,0,0
29522,58thStGreenway22ndAve,07/13/2017 02:00:00 AM,48,-122,0,0,0
29523,58thStGreenway22ndAve,07/13/2017 03:00:00 AM,48,-122,0,0,0
29524,58thStGreenway22ndAve,07/13/2017 04:00:00 AM,48,-122,1,0,1
29525,58thStGreenway22ndAve,07/13/2017 05:00:00 AM,48,-122,0,0,0
29526,58thStGreenway22ndAve,07/13/2017 06:00:00 AM,48,-122,2,2,4
29527,58thStGreenway22ndAve,07/13/2017 07:00:00 AM,48,-122,3,4,7
29528,58thStGreenway22ndAve,07/13/2017 08:00:00 AM,48,-122,4,5,9
29529,58thStGreenway22ndAve,07/13/2017 09:00:00 AM,48,-122,5,7,12
29530,58thStGreenway22ndAve,07/13/2017 10:00:00 AM,48,-122,7,2,9
29531,58thStGreenway22ndAve,07/13/2017 11:00:00 AM,48,-122,6,4,10
29532,58thStGreenway22ndAve,07/13/2017 12:00:00 PM,48,-122,9,1,10
29533,58thStGreenway22ndAve,07/13/2017 01:00:00 PM,48,-122,4,5,9
29534,58thStGreenway22ndAve,07/13/2017 02:00:00 PM,48,-122,2,2,4
29535,58thStGreenway22ndAve,07/13/2017 03:00:00 PM,48,-122,5,3,8
29536,58thStGreenway22ndAve,07/13/2017 04:00:00 PM,48,-122,9,7,16
29537,58thStGreenway22ndAve,07/13/2017 05:00:00 PM,48,-122,11,16,27
29538,58thStGreenway22ndAve,07/13/2017 06:00:00 PM,48,-122,7,13,20
29539,58thStGreenway22ndAve,07/13/2017 07:00:00 PM,48,-122,12,7,19
29540,58thStGreenway22ndAve,07/13/2017 08:00:00 PM,48,-122,10,4,14
29541,58thStGreenway22ndAve,07/13/2017 09:00:00 PM,48,-122,2,4,6
29542,58thStGreenway22ndAve,07/13/2017 10:00:00 PM,48,-122,4,1,5
29543,58thStGreenway22ndAve,07/13/2017 11:00:00 PM,48,-122,0,0,0
29544,58thStGreenway22ndAve,07/14/2017 12:00:00 AM,48,-122,0,0,0
29545,58thStGreenway22ndAve,07/14/2017 01:00:00 AM,48,-122,0,1,1
29546,58thStGreenway22ndAve,07/14/2017 02:00:00 AM,48,-122,0,0,0
29547,58thStGreenway22ndAve,07/14/2017 03:00:00 AM,48,-122,1,0,1
29548,58thStGreenway22ndAve,07/14/2017 04:00:00 AM,48,-122,0,0,0
29549,58thStGreenway22ndAve,07/14/2017 05:00:00 AM,48,-122,0,0,0
29550,58thStGreenway22ndAve,07/14/2017 06:00:00 AM,48,-122,2,1,3
29551,58thStGreenway22ndAve,07/14/2017 07:00:00 AM,48,-122,4,7,11
29552,58thStGreenway22ndAve,07/14/2017 08:00:00 AM,48,-122,5,4,9
29553,58thStGreenway22ndAve,07/14/2017 09:00:00 AM,48,-122,3,7,10
29554,58thStGreenway22ndAve,07/14/2017 10:00:00 AM,48,-122,7,4,11
29555,58thStGreenway22ndAve,07/14/2017 11:00:00 AM,48,-122,6,3,9
29556,58thStGreenway22ndAve,07/14/2017 12:00:00 PM,48,-122,3,5,8
29557,58thStGreenway22ndAve,07/14/2017 01:00:00 PM,48,-122,3,2,5
29558,58thStGreenway22ndAve,07/14/2017 02:00:00 PM,48,-122,1,7,8
29559,58thStGreenway22ndAve,07/14/2017 03:00:00 PM,48,-122,2,5,7
29560,58thStGreenway22ndAve,07/14/2017 04:00:00 PM,48,-122,6,7,13
29561,58thStGreenway22ndAve,07/14/2017 05:00:00 PM,48,-122,14,6,20
29562,58thStGreenway22ndAve,07/14/2017 06:00:00 PM,48,-122,4,4,8
29563,58thStGreenway22ndAve,07/14/2017 07:00:00 PM,48,-122,4,7,11
29564,58thStGreenway22ndAve,07/14/2017 08:00:00 PM,48,-122,3,6,9
29565,58thStGreenway22ndAve,07/14/2017 09:00:00 PM,48,-122,3,4,7
29566,58thStGreenway22ndAve,07/14/2017 10:00:00 PM,48,-122,1,0,1
29567,58thStGreenway22ndAve,07/14/2017 11:00:00 PM,48,-122,1,0,1
29568,58thStGreenway22ndAve,07/15/2017 12:00:00 AM,48,-122,2,1,3
29569,58thStGreenway22ndAve,07/15/2017 01:00:00 AM,48,-122,0,0,0
29570,58thStGreenway22ndAve,07/15/2017 02:00:00 AM,48,-122,1,0,1
29571,58thStGreenway22ndAve,07/15/2017 03:00:00 AM,48,-122,1,0,1
29572,58thStGreenway22ndAve,07/15/2017 04:00:00 AM,48,-122,0,1,1
29573,58thStGreenway22ndAve,07/15/2017 05:00:00 AM,48,-122,1,0,1
29574,58thStGreenway22ndAve,07/15/2017 06:00:00 AM,48,-122,1,0,1
29575,58thStGreenway22ndAve,07/15/2017 07:00:00 AM,48,-122,2,1,3
29576,58thStGreenway22ndAve,07/15/2017 08:00:00 AM,48,-122,1,3,4
29577,58thStGreenway22ndAve,07/15/2017 09:00:00 AM,48,-122,6,2,8
29578,58thStGreenway22ndAve,07/15/2017 10:00:00 AM,48,-122,10,5,15
29579,58thStGreenway22ndAve,07/15/2017 11:00:00 AM,48,-122,6,9,15
29580,58thStGreenway22ndAve,07/15/2017 12:00:00 PM,48,-122,9,10,19
29581,58thStGreenway22ndAve,07/15/2017 01:00:00 PM,48,-122,1,9,10
29582,58thStGreenway22ndAve,07/15/2017 02:00:00 PM,48,-122,9,20,29
29583,58thStGreenway22ndAve,07/15/2017 03:00:00 PM,48,-122,4,2,6
29584,58thStGreenway22ndAve,07/15/2017 04:00:00 PM,48,-122,5,6,11
29585,58thStGreenway22ndAve,07/15/2017 05:00:00 PM,48,-122,7,2,9
29586,58thStGreenway22ndAve,07/15/2017 06:00:00 PM,48,-122,4,4,8
29587,58thStGreenway22ndAve,07/15/2017 07:00:00 PM,48,-122,1,3,4
29588,58thStGreenway22ndAve,07/15/2017 08:00:00 PM,48,-122,6,7,13
29589,58thStGreenway22ndAve,07/15/2017 09:00:00 PM,48,-122,3,0,3
29590,58thStGreenway22ndAve,07/15/2017 10:00:00 PM,48,-122,1,1,2
29591,58thStGreenway22ndAve,07/15/2017 11:00:00 PM,48,-122,1,0,1
29592,58thStGreenway22ndAve,07/16/2017 12:00:00 AM,48,-122,0,0,0
29593,58thStGreenway22ndAve,07/16/2017 01:00:00 AM,48,-122,0,0,0
29594,58thStGreenway22ndAve,07/16/2017 02:00:00 AM,48,-122,0,0,0
29595,58thStGreenway22ndAve,07/16/2017 03:00:00 AM,48,-122,0,0,0
29596,58thStGreenway22ndAve,07/16/2017 04:00:00 AM,48,-122,0,0,0
29597,58thStGreenway22ndAve,07/16/2017 05:00:00 AM,48,-122,0,0,0
29598,58thStGreenway22ndAve,07/16/2017 06:00:00 AM,48,-122,3,1,4
29599,58thStGreenway22ndAve,07/16/2017 07:00:00 AM,48,-122,2,2,4
29600,58thStGreenway22ndAve,07/16/2017 08:00:00 AM,48,-122,6,0,6
29601,58thStGreenway22ndAve,07/16/2017 09:00:00 AM,48,-122,5,5,10
29602,58thStGreenway22ndAve,07/16/2017 10:00:00 AM,48,-122,3,4,7
29603,58thStGreenway22ndAve,07/16/2017 11:00:00 AM,48,-122,5,5,10
29604,58thStGreenway22ndAve,07/16/2017 12:00:00 PM,48,-122,4,7,11
29605,58thStGreenway22ndAve,07/16/2017 01:00:00 PM,48,-122,7,9,16
29606,58thStGreenway22ndAve,07/16/2017 02:00:00 PM,48,-122,10,7,17
29607,58thStGreenway22ndAve,07/16/2017 03:00:00 PM,48,-122,12,9,21
29608,58thStGreenway22ndAve,07/16/2017 04:00:00 PM,48,-122,10,6,16
29609,58thStGreenway22ndAve,07/16/2017 05:00:00 PM,48,-122,6,8,14
29610,58thStGreenway22ndAve,07/16/2017 06:00:00 PM,48,-122,4,7,11
29611,58thStGreenway22ndAve,07/16/2017 07:00:00 PM,48,-122,4,3,7
29612,58thStGreenway22ndAve,07/16/2017 08:00:00 PM,48,-122,9,4,13
29613,58thStGreenway22ndAve,07/16/2017 09:00:00 PM,48,-122,1,3,4
29614,58thStGreenway22ndAve,07/16/2017 10:00:00 PM,48,-122,2,3,5
29615,58thStGreenway22ndAve,07/16/2017 11:00:00 PM,48,-122,1,0,1
29616,58thStGreenway22ndAve,07/17/2017 12:00:00 AM,48,-122,2,0,2
29617,58thStGreenway22ndAve,07/17/2017 01:00:00 AM,48,-122,0,0,0
29618,58thStGreenway22ndAve,07/17/2017 02:00:00 AM,48,-122,0,0,0
29619,58thStGreenway22ndAve,07/17/2017 03:00:00 AM,48,-122,0,1,1
29620,58thStGreenway22ndAve,07/17/2017 04:00:00 AM,48,-122,0,0,0
29621,58thStGreenway22ndAve,07/17/2017 05:00:00 AM,48,-122,0,0,0
29622,58thStGreenway22ndAve,07/17/2017 06:00:00 AM,48,-122,3,1,4
29623,58thStGreenway22ndAve,07/17/2017 07:00:00 AM,48,-122,7,9,16
29624,58thStGreenway22ndAve,07/17/2017 08:00:00 AM,48,-122,6,2,8
29625,58thStGreenway22ndAve,07/17/2017 09:00:00 AM,48,-122,8,1,9
29626,58thStGreenway22ndAve,07/17/2017 10:00:00 AM,48,-122,4,3,7
29627,58thStGreenway22ndAve,07/17/2017 11:00:00 AM,48,-122,10,1,11
29628,58thStGreenway22ndAve,07/17/2017 12:00:00 PM,48,-122,10,3,13
29629,58thStGreenway22ndAve,07/17/2017 01:00:00 PM,48,-122,2,8,10
29630,58thStGreenway22ndAve,07/17/2017 02:00:00 PM,48,-122,3,10,13
29631,58thStGreenway22ndAve,07/17/2017 03:00:00 PM,48,-122,5,6,11
29632,58thStGreenway22ndAve,07/17/2017 04:00:00 PM,48,-122,12,10,22
29633,58thStGreenway22ndAve,07/17/2017 05:00:00 PM,48,-122,9,8,17
29634,58thStGreenway22ndAve,07/17/2017 06:00:00 PM,48,-122,17,7,24
29635,58thStGreenway22ndAve,07/17/2017 07:00:00 PM,48,-122,6,6,12
29636,58thStGreenway22ndAve,07/17/2017 08:00:00 PM,48,-122,4,8,12
29637,58thStGreenway22ndAve,07/17/2017 09:00:00 PM,48,-122,0,3,3
29638,58thStGreenway22ndAve,07/17/2017 10:00:00 PM,48,-122,1,1,2
29639,58thStGreenway22ndAve,07/17/2017 11:00:00 PM,48,-122,1,0,1
29640,58thStGreenway22ndAve,07/18/2017 12:00:00 AM,48,-122,0,0,0
29641,58thStGreenway22ndAve,07/18/2017 01:00:00 AM,48,-122,0,0,0
29642,58thStGreenway22ndAve,07/18/2017 02:00:00 AM,48,-122,1,1,2
29643,58thStGreenway22ndAve,07/18/2017 03:00:00 AM,48,-122,0,1,1
29644,58thStGreenway22ndAve,07/18/2017 04:00:00 AM,48,-122,0,0,0
29645,58thStGreenway22ndAve,07/18/2017 05:00:00 AM,48,-122,1,2,3
29646,58thStGreenway22ndAve,07/18/2017 06:00:00 AM,48,-122,4,2,6
29647,58thStGreenway22ndAve,07/18/2017 07:00:00 AM,48,-122,4,7,11
29648,58thStGreenway22ndAve,07/18/2017 08:00:00 AM,48,-122,8,4,12
29649,58thStGreenway22ndAve,07/18/2017 09:00:00 AM,48,-122,5,7,12
29650,58thStGreenway22ndAve,07/18/2017 10:00:00 AM,48,-122,6,8,14
29651,58thStGreenway22ndAve,07/18/2017 11:00:00 AM,48,-122,7,6,13
29652,58thStGreenway22ndAve,07/18/2017 12:00:00 PM,48,-122,4,3,7
29653,58thStGreenway22ndAve,07/18/2017 01:00:00 PM,48,-122,6,10,16
29654,58thStGreenway22ndAve,07/18/2017 02:00:00 PM,48,-122,6,1,7
29655,58thStGreenway22ndAve,07/18/2017 03:00:00 PM,48,-122,5,4,9
29656,58thStGreenway22ndAve,07/18/2017 04:00:00 PM,48,-122,4,7,11
29657,58thStGreenway22ndAve,07/18/2017 05:00:00 PM,48,-122,10,9,19
29658,58thStGreenway22ndAve,07/18/2017 06:00:00 PM,48,-122,12,7,19
29659,58thStGreenway22ndAve,07/18/2017 07:00:00 PM,48,-122,14,5,19
29660,58thStGreenway22ndAve,07/18/2017 08:00:00 PM,48,-122,7,5,12
29661,58thStGreenway22ndAve,07/18/2017 09:00:00 PM,48,-122,4,6,10
29662,58thStGreenway22ndAve,07/18/2017 10:00:00 PM,48,-122,3,2,5
29663,58thStGreenway22ndAve,07/18/2017 11:00:00 PM,48,-122,2,2,4
29664,58thStGreenway22ndAve,07/19/2017 12:00:00 AM,48,-122,0,0,0
29665,58thStGreenway22ndAve,07/19/2017 01:00:00 AM,48,-122,1,1,2
29666,58thStGreenway22ndAve,07/19/2017 02:00:00 AM,48,-122,1,1,2
29667,58thStGreenway22ndAve,07/19/2017 03:00:00 AM,48,-122,0,0,0
29668,58thStGreenway22ndAve,07/19/2017 04:00:00 AM,48,-122,0,0,0
29669,58thStGreenway22ndAve,07/19/2017 05:00:00 AM,48,-122,1,1,2
29670,58thStGreenway22ndAve,07/19/2017 06:00:00 AM,48,-122,1,1,2
29671,58thStGreenway22ndAve,07/19/2017 07:00:00 AM,48,-122,5,9,14
29672,58thStGreenway22ndAve,07/19/2017 08:00:00 AM,48,-122,7,5,12
29673,58thStGreenway22ndAve,07/19/2017 09:00:00 AM,48,-122,11,3,14
29674,58thStGreenway22ndAve,07/19/2017 10:00:00 AM,48,-122,5,7,12
29675,58thStGreenway22ndAve,07/19/2017 11:00:00 AM,48,-122,8,4,12
29676,58thStGreenway22ndAve,07/19/2017 12:00:00 PM,48,-122,9,3,12
29677,58thStGreenway22ndAve,07/19/2017 01:00:00 PM,48,-122,5,12,17
29678,58thStGreenway22ndAve,07/19/2017 02:00:00 PM,48,-122,9,5,14
29679,58thStGreenway22ndAve,07/19/2017 03:00:00 PM,48,-122,4,7,11
29680,58thStGreenway22ndAve,07/19/2017 04:00:00 PM,48,-122,11,11,22
29681,58thStGreenway22ndAve,07/19/2017 05:00:00 PM,48,-122,8,7,15
29682,58thStGreenway22ndAve,07/19/2017 06:00:00 PM,48,-122,15,4,19
29683,58thStGreenway22ndAve,07/19/2017 07:00:00 PM,48,-122,9,4,13
29684,58thStGreenway22ndAve,07/19/2017 08:00:00 PM,48,-122,3,8,11
29685,58thStGreenway22ndAve,07/19/2017 09:00:00 PM,48,-122,1,0,1
29686,58thStGreenway22ndAve,07/19/2017 10:00:00 PM,48,-122,3,1,4
29687,58thStGreenway22ndAve,07/19/2017 11:00:00 PM,48,-122,2,0,2
29688,58thStGreenway22ndAve,07/20/2017 12:00:00 AM,48,-122,1,0,1
29689,58thStGreenway22ndAve,07/20/2017 01:00:00 AM,48,-122,1,0,1
29690,58thStGreenway22ndAve,07/20/2017 02:00:00 AM,48,-122,0,0,0
29691,58thStGreenway22ndAve,07/20/2017 03:00:00 AM,48,-122,0,0,0
29692,58thStGreenway22ndAve,07/20/2017 04:00:00 AM,48,-122,0,0,0
29693,58thStGreenway22ndAve,07/20/2017 05:00:00 AM,48,-122,0,1,1
29694,58thStGreenway22ndAve,07/20/2017 06:00:00 AM,48,-122,2,1,3
29695,58thStGreenway22ndAve,07/20/2017 07:00:00 AM,48,-122,3,6,9
29696,58thStGreenway22ndAve,07/20/2017 08:00:00 AM,48,-122,5,3,8
29697,58thStGreenway22ndAve,07/20/2017 09:00:00 AM,48,-122,6,2,8
29698,58thStGreenway22ndAve,07/20/2017 10:00:00 AM,48,-122,10,0,10
29699,58thStGreenway22ndAve,07/20/2017 11:00:00 AM,48,-122,2,5,7
29700,58thStGreenway22ndAve,07/20/2017 12:00:00 PM,48,-122,3,3,6
29701,58thStGreenway22ndAve,07/20/2017 01:00:00 PM,48,-122,2,6,8
29702,58thStGreenway22ndAve,07/20/2017 02:00:00 PM,48,-122,5,2,7
29703,58thStGreenway22ndAve,07/20/2017 03:00:00 PM,48,-122,4,6,10
29704,58thStGreenway22ndAve,07/20/2017 04:00:00 PM,48,-122,4,2,6
29705,58thStGreenway22ndAve,07/20/2017 05:00:00 PM,48,-122,7,4,11
29706,58thStGreenway22ndAve,07/20/2017 06:00:00 PM,48,-122,9,6,15
29707,58thStGreenway22ndAve,07/20/2017 07:00:00 PM,48,-122,4,5,9
29708,58thStGreenway22ndAve,07/20/2017 08:00:00 PM,48,-122,7,4,11
29709,58thStGreenway22ndAve,07/20/2017 09:00:00 PM,48,-122,1,3,4
29710,58thStGreenway22ndAve,07/20/2017 10:00:00 PM,48,-122,3,0,3
29711,58thStGreenway22ndAve,07/20/2017 11:00:00 PM,48,-122,1,2,3
29712,58thStGreenway22ndAve,07/21/2017 12:00:00 AM,48,-122,2,1,3
29713,58thStGreenway22ndAve,07/21/2017 01:00:00 AM,48,-122,0,0,0
29714,58thStGreenway22ndAve,07/21/2017 02:00:00 AM,48,-122,0,0,0
29715,58thStGreenway22ndAve,07/21/2017 03:00:00 AM,48,-122,1,1,2
29716,58thStGreenway22ndAve,07/21/2017 04:00:00 AM,48,-122,0,1,1
29717,58thStGreenway22ndAve,07/21/2017 05:00:00 AM,48,-122,0,0,0
29718,58thStGreenway22ndAve,07/21/2017 06:00:00 AM,48,-122,2,1,3
29719,58thStGreenway22ndAve,07/21/2017 07:00:00 AM,48,-122,4,7,11
29720,58thStGreenway22ndAve,07/21/2017 08:00:00 AM,48,-122,6,6,12
29721,58thStGreenway22ndAve,07/21/2017 09:00:00 AM,48,-122,8,2,10
29722,58thStGreenway22ndAve,07/21/2017 10:00:00 AM,48,-122,3,3,6
29723,58thStGreenway22ndAve,07/21/2017 11:00:00 AM,48,-122,7,4,11
29724,58thStGreenway22ndAve,07/21/2017 12:00:00 PM,48,-122,6,5,11
29725,58thStGreenway22ndAve,07/21/2017 01:00:00 PM,48,-122,2,6,8
29726,58thStGreenway22ndAve,07/21/2017 02:00:00 PM,48,-122,6,4,10
29727,58thStGreenway22ndAve,07/21/2017 03:00:00 PM,48,-122,10,7,17
29728,58thStGreenway22ndAve,07/21/2017 04:00:00 PM,48,-122,3,7,10
29729,58thStGreenway22ndAve,07/21/2017 05:00:00 PM,48,-122,9,7,16
29730,58thStGreenway22ndAve,07/21/2017 06:00:00 PM,48,-122,9,7,16
29731,58thStGreenway22ndAve,07/21/2017 07:00:00 PM,48,-122,5,6,11
29732,58thStGreenway22ndAve,07/21/2017 08:00:00 PM,48,-122,5,2,7
29733,58thStGreenway22ndAve,07/21/2017 09:00:00 PM,48,-122,1,4,5
29734,58thStGreenway22ndAve,07/21/2017 10:00:00 PM,48,-122,2,1,3
29735,58thStGreenway22ndAve,07/21/2017 11:00:00 PM,48,-122,0,2,2
29736,58thStGreenway22ndAve,07/22/2017 12:00:00 AM,48,-122,2,3,5
29737,58thStGreenway22ndAve,07/22/2017 01:00:00 AM,48,-122,2,0,2
29738,58thStGreenway22ndAve,07/22/2017 02:00:00 AM,48,-122,0,0,0
29739,58thStGreenway22ndAve,07/22/2017 03:00:00 AM,48,-122,0,0,0
29740,58thStGreenway22ndAve,07/22/2017 04:00:00 AM,48,-122,0,0,0
29741,58thStGreenway22ndAve,07/22/2017 05:00:00 AM,48,-122,1,0,1
29742,58thStGreenway22ndAve,07/22/2017 06:00:00 AM,48,-122,1,0,1
29743,58thStGreenway22ndAve,07/22/2017 07:00:00 AM,48,-122,1,1,2
29744,58thStGreenway22ndAve,07/22/2017 08:00:00 AM,48,-122,6,4,10
29745,58thStGreenway22ndAve,07/22/2017 09:00:00 AM,48,-122,6,5,11
29746,58thStGreenway22ndAve,07/22/2017 10:00:00 AM,48,-122,10,4,14
29747,58thStGreenway22ndAve,07/22/2017 11:00:00 AM,48,-122,8,9,17
29748,58thStGreenway22ndAve,07/22/2017 12:00:00 PM,48,-122,10,6,16
29749,58thStGreenway22ndAve,07/22/2017 01:00:00 PM,48,-122,4,7,11
29750,58thStGreenway22ndAve,07/22/2017 02:00:00 PM,48,-122,10,4,14
29751,58thStGreenway22ndAve,07/22/2017 03:00:00 PM,48,-122,9,5,14
29752,58thStGreenway22ndAve,07/22/2017 04:00:00 PM,48,-122,6,6,12
29753,58thStGreenway22ndAve,07/22/2017 05:00:00 PM,48,-122,8,7,15
29754,58thStGreenway22ndAve,07/22/2017 06:00:00 PM,48,-122,6,11,17
29755,58thStGreenway22ndAve,07/22/2017 07:00:00 PM,48,-122,2,7,9
29756,58thStGreenway22ndAve,07/22/2017 08:00:00 PM,48,-122,2,3,5
29757,58thStGreenway22ndAve,07/22/2017 09:00:00 PM,48,-122,4,3,7
29758,58thStGreenway22ndAve,07/22/2017 10:00:00 PM,48,-122,2,0,2
29759,58thStGreenway22ndAve,07/22/2017 11:00:00 PM,48,-122,1,4,5
29760,58thStGreenway22ndAve,07/23/2017 12:00:00 AM,48,-122,1,1,2
29761,58thStGreenway22ndAve,07/23/2017 01:00:00 AM,48,-122,0,1,1
29762,58thStGreenway22ndAve,07/23/2017 02:00:00 AM,48,-122,0,2,2
29763,58thStGreenway22ndAve,07/23/2017 03:00:00 AM,48,-122,0,0,0
29764,58thStGreenway22ndAve,07/23/2017 04:00:00 AM,48,-122,0,0,0
29765,58thStGreenway22ndAve,07/23/2017 05:00:00 AM,48,-122,0,0,0
29766,58thStGreenway22ndAve,07/23/2017 06:00:00 AM,48,-122,1,0,1
29767,58thStGreenway22ndAve,07/23/2017 07:00:00 AM,48,-122,0,1,1
29768,58thStGreenway22ndAve,07/23/2017 08:00:00 AM,48,-122,1,1,2
29769,58thStGreenway22ndAve,07/23/2017 09:00:00 AM,48,-122,4,1,5
29770,58thStGreenway22ndAve,07/23/2017 10:00:00 AM,48,-122,6,4,10
29771,58thStGreenway22ndAve,07/23/2017 11:00:00 AM,48,-122,5,4,9
29772,58thStGreenway22ndAve,07/23/2017 12:00:00 PM,48,-122,11,15,26
29773,58thStGreenway22ndAve,07/23/2017 01:00:00 PM,48,-122,7,11,18
29774,58thStGreenway22ndAve,07/23/2017 02:00:00 PM,48,-122,9,7,16
29775,58thStGreenway22ndAve,07/23/2017 03:00:00 PM,48,-122,7,10,17
29776,58thStGreenway22ndAve,07/23/2017 04:00:00 PM,48,-122,7,5,12
29777,58thStGreenway22ndAve,07/23/2017 05:00:00 PM,48,-122,5,3,8
29778,58thStGreenway22ndAve,07/23/2017 06:00:00 PM,48,-122,2,2,4
29779,58thStGreenway22ndAve,07/23/2017 07:00:00 PM,48,-122,6,2,8
29780,58thStGreenway22ndAve,07/23/2017 08:00:00 PM,48,-122,2,2,4
29781,58thStGreenway22ndAve,07/23/2017 09:00:00 PM,48,-122,2,0,2
29782,58thStGreenway22ndAve,07/23/2017 10:00:00 PM,48,-122,2,1,3
29783,58thStGreenway22ndAve,07/23/2017 11:00:00 PM,48,-122,2,2,4
29784,58thStGreenway22ndAve,07/24/2017 12:00:00 AM,48,-122,1,0,1
29785,58thStGreenway22ndAve,07/24/2017 01:00:00 AM,48,-122,0,0,0
29786,58thStGreenway22ndAve,07/24/2017 02:00:00 AM,48,-122,0,0,0
29787,58thStGreenway22ndAve,07/24/2017 03:00:00 AM,48,-122,0,1,1
29788,58thStGreenway22ndAve,07/24/2017 04:00:00 AM,48,-122,0,1,1
29789,58thStGreenway22ndAve,07/24/2017 05:00:00 AM,48,-122,1,0,1
29790,58thStGreenway22ndAve,07/24/2017 06:00:00 AM,48,-122,4,2,6
29791,58thStGreenway22ndAve,07/24/2017 07:00:00 AM,48,-122,5,6,11
29792,58thStGreenway22ndAve,07/24/2017 08:00:00 AM,48,-122,8,10,18
29793,58thStGreenway22ndAve,07/24/2017 09:00:00 AM,48,-122,5,2,7
29794,58thStGreenway22ndAve,07/24/2017 10:00:00 AM,48,-122,8,5,13
29795,58thStGreenway22ndAve,07/24/2017 11:00:00 AM,48,-122,7,1,8
29796,58thStGreenway22ndAve,07/24/2017 12:00:00 PM,48,-122,5,3,8
29797,58thStGreenway22ndAve,07/24/2017 01:00:00 PM,48,-122,8,5,13
29798,58thStGreenway22ndAve,07/24/2017 02:00:00 PM,48,-122,5,6,11
29799,58thStGreenway22ndAve,07/24/2017 03:00:00 PM,48,-122,8,6,14
29800,58thStGreenway22ndAve,07/24/2017 04:00:00 PM,48,-122,6,8,14
29801,58thStGreenway22ndAve,07/24/2017 05:00:00 PM,48,-122,14,12,26
29802,58thStGreenway22ndAve,07/24/2017 06:00:00 PM,48,-122,11,7,18
29803,58thStGreenway22ndAve,07/24/2017 07:00:00 PM,48,-122,12,6,18
29804,58thStGreenway22ndAve,07/24/2017 08:00:00 PM,48,-122,4,11,15
29805,58thStGreenway22ndAve,07/24/2017 09:00:00 PM,48,-122,2,4,6
29806,58thStGreenway22ndAve,07/24/2017 10:00:00 PM,48,-122,2,2,4
29807,58thStGreenway22ndAve,07/24/2017 11:00:00 PM,48,-122,0,1,1
29808,58thStGreenway22ndAve,07/25/2017 12:00:00 AM,48,-122,1,2,3
29809,58thStGreenway22ndAve,07/25/2017 01:00:00 AM,48,-122,1,0,1
29810,58thStGreenway22ndAve,07/25/2017 02:00:00 AM,48,-122,0,0,0
29811,58thStGreenway22ndAve,07/25/2017 03:00:00 AM,48,-122,0,0,0
29812,58thStGreenway22ndAve,07/25/2017 04:00:00 AM,48,-122,1,0,1
29813,58thStGreenway22ndAve,07/25/2017 05:00:00 AM,48,-122,0,1,1
29814,58thStGreenway22ndAve,07/25/2017 06:00:00 AM,48,-122,3,2,5
29815,58thStGreenway22ndAve,07/25/2017 07:00:00 AM,48,-122,3,4,7
29816,58thStGreenway22ndAve,07/25/2017 08:00:00 AM,48,-122,3,6,9
29817,58thStGreenway22ndAve,07/25/2017 09:00:00 AM,48,-122,4,6,10
29818,58thStGreenway22ndAve,07/25/2017 10:00:00 AM,48,-122,5,2,7
29819,58thStGreenway22ndAve,07/25/2017 11:00:00 AM,48,-122,7,5,12
29820,58thStGreenway22ndAve,07/25/2017 12:00:00 PM,48,-122,10,5,15
29821,58thStGreenway22ndAve,07/25/2017 01:00:00 PM,48,-122,3,8,11
29822,58thStGreenway22ndAve,07/25/2017 02:00:00 PM,48,-122,3,3,6
29823,58thStGreenway22ndAve,07/25/2017 03:00:00 PM,48,-122,9,8,17
29824,58thStGreenway22ndAve,07/25/2017 04:00:00 PM,48,-122,16,10,26
29825,58thStGreenway22ndAve,07/25/2017 05:00:00 PM,48,-122,8,11,19
29826,58thStGreenway22ndAve,07/25/2017 06:00:00 PM,48,-122,11,5,16
29827,58thStGreenway22ndAve,07/25/2017 07:00:00 PM,48,-122,6,7,13
29828,58thStGreenway22ndAve,07/25/2017 08:00:00 PM,48,-122,4,2,6
29829,58thStGreenway22ndAve,07/25/2017 09:00:00 PM,48,-122,3,3,6
29830,58thStGreenway22ndAve,07/25/2017 10:00:00 PM,48,-122,0,0,0
29831,58thStGreenway22ndAve,07/25/2017 11:00:00 PM,48,-122,2,2,4
29832,58thStGreenway22ndAve,07/26/2017 12:00:00 AM,48,-122,1,0,1
29833,58thStGreenway22ndAve,07/26/2017 01:00:00 AM,48,-122,0,1,1
29834,58thStGreenway22ndAve,07/26/2017 02:00:00 AM,48,-122,0,0,0
29835,58thStGreenway22ndAve,07/26/2017 03:00:00 AM,48,-122,0,0,0
29836,58thStGreenway22ndAve,07/26/2017 04:00:00 AM,48,-122,0,1,1
29837,58thStGreenway22ndAve,07/26/2017 05:00:00 AM,48,-122,0,1,1
29838,58thStGreenway22ndAve,07/26/2017 06:00:00 AM,48,-122,1,1,2
29839,58thStGreenway22ndAve,07/26/2017 07:00:00 AM,48,-122,3,5,8
29840,58thStGreenway22ndAve,07/26/2017 08:00:00 AM,48,-122,7,6,13
29841,58thStGreenway22ndAve,07/26/2017 09:00:00 AM,48,-122,7,3,10
29842,58thStGreenway22ndAve,07/26/2017 10:00:00 AM,48,-122,5,2,7
29843,58thStGreenway22ndAve,07/26/2017 11:00:00 AM,48,-122,13,6,19
29844,58thStGreenway22ndAve,07/26/2017 12:00:00 PM,48,-122,3,7,10
29845,58thStGreenway22ndAve,07/26/2017 01:00:00 PM,48,-122,9,6,15
29846,58thStGreenway22ndAve,07/26/2017 02:00:00 PM,48,-122,4,7,11
29847,58thStGreenway22ndAve,07/26/2017 03:00:00 PM,48,-122,6,7,13
29848,58thStGreenway22ndAve,07/26/2017 04:00:00 PM,48,-122,4,10,14
29849,58thStGreenway22ndAve,07/26/2017 05:00:00 PM,48,-122,11,8,19
29850,58thStGreenway22ndAve,07/26/2017 06:00:00 PM,48,-122,19,6,25
29851,58thStGreenway22ndAve,07/26/2017 07:00:00 PM,48,-122,6,9,15
29852,58thStGreenway22ndAve,07/26/2017 08:00:00 PM,48,-122,7,7,14
29853,58thStGreenway22ndAve,07/26/2017 09:00:00 PM,48,-122,3,3,6
29854,58thStGreenway22ndAve,07/26/2017 10:00:00 PM,48,-122,0,2,2
29855,58thStGreenway22ndAve,07/26/2017 11:00:00 PM,48,-122,1,0,1
29856,58thStGreenway22ndAve,07/27/2017 12:00:00 AM,48,-122,1,0,1
29857,58thStGreenway22ndAve,07/27/2017 01:00:00 AM,48,-122,0,0,0
29858,58thStGreenway22ndAve,07/27/2017 02:00:00 AM,48,-122,0,0,0
29859,58thStGreenway22ndAve,07/27/2017 03:00:00 AM,48,-122,0,0,0
29860,58thStGreenway22ndAve,07/27/2017 04:00:00 AM,48,-122,1,0,1
29861,58thStGreenway22ndAve,07/27/2017 05:00:00 AM,48,-122,1,0,1
29862,58thStGreenway22ndAve,07/27/2017 06:00:00 AM,48,-122,4,3,7
29863,58thStGreenway22ndAve,07/27/2017 07:00:00 AM,48,-122,2,3,5
29864,58thStGreenway22ndAve,07/27/2017 08:00:00 AM,48,-122,4,8,12
29865,58thStGreenway22ndAve,07/27/2017 09:00:00 AM,48,-122,7,1,8
29866,58thStGreenway22ndAve,07/27/2017 10:00:00 AM,48,-122,0,2,2
29867,58thStGreenway22ndAve,07/27/2017 11:00:00 AM,48,-122,9,4,13
29868,58thStGreenway22ndAve,07/27/2017 12:00:00 PM,48,-122,2,6,8
29869,58thStGreenway22ndAve,07/27/2017 01:00:00 PM,48,-122,5,4,9
29870,58thStGreenway22ndAve,07/27/2017 02:00:00 PM,48,-122,3,9,12
29871,58thStGreenway22ndAve,07/27/2017 03:00:00 PM,48,-122,2,2,4
29872,58thStGreenway22ndAve,07/27/2017 04:00:00 PM,48,-122,6,6,12
29873,58thStGreenway22ndAve,07/27/2017 05:00:00 PM,48,-122,9,11,20
29874,58thStGreenway22ndAve,07/27/2017 06:00:00 PM,48,-122,10,8,18
29875,58thStGreenway22ndAve,07/27/2017 07:00:00 PM,48,-122,8,10,18
29876,58thStGreenway22ndAve,07/27/2017 08:00:00 PM,48,-122,6,3,9
29877,58thStGreenway22ndAve,07/27/2017 09:00:00 PM,48,-122,5,1,6
29878,58thStGreenway22ndAve,07/27/2017 10:00:00 PM,48,-122,2,1,3
29879,58thStGreenway22ndAve,07/27/2017 11:00:00 PM,48,-122,1,0,1
29880,58thStGreenway22ndAve,07/28/2017 12:00:00 AM,48,-122,0,2,2
29881,58thStGreenway22ndAve,07/28/2017 01:00:00 AM,48,-122,0,0,0
29882,58thStGreenway22ndAve,07/28/2017 02:00:00 AM,48,-122,0,0,0
29883,58thStGreenway22ndAve,07/28/2017 03:00:00 AM,48,-122,0,1,1
29884,58thStGreenway22ndAve,07/28/2017 04:00:00 AM,48,-122,1,2,3
29885,58thStGreenway22ndAve,07/28/2017 05:00:00 AM,48,-122,1,1,2
29886,58thStGreenway22ndAve,07/28/2017 06:00:00 AM,48,-122,0,0,0
29887,58thStGreenway22ndAve,07/28/2017 07:00:00 AM,48,-122,2,6,8
29888,58thStGreenway22ndAve,07/28/2017 08:00:00 AM,48,-122,5,9,14
29889,58thStGreenway22ndAve,07/28/2017 09:00:00 AM,48,-122,1,4,5
29890,58thStGreenway22ndAve,07/28/2017 10:00:00 AM,48,-122,8,2,10
29891,58thStGreenway22ndAve,07/28/2017 11:00:00 AM,48,-122,10,6,16
29892,58thStGreenway22ndAve,07/28/2017 12:00:00 PM,48,-122,11,4,15
29893,58thStGreenway22ndAve,07/28/2017 01:00:00 PM,48,-122,7,7,14
29894,58thStGreenway22ndAve,07/28/2017 02:00:00 PM,48,-122,6,6,12
29895,58thStGreenway22ndAve,07/28/2017 03:00:00 PM,48,-122,9,5,14
29896,58thStGreenway22ndAve,07/28/2017 04:00:00 PM,48,-122,8,4,12
29897,58thStGreenway22ndAve,07/28/2017 05:00:00 PM,48,-122,3,16,19
29898,58thStGreenway22ndAve,07/28/2017 06:00:00 PM,48,-122,12,4,16
29899,58thStGreenway22ndAve,07/28/2017 07:00:00 PM,48,-122,3,6,9
29900,58thStGreenway22ndAve,07/28/2017 08:00:00 PM,48,-122,4,2,6
29901,58thStGreenway22ndAve,07/28/2017 09:00:00 PM,48,-122,5,6,11
29902,58thStGreenway22ndAve,07/28/2017 10:00:00 PM,48,-122,4,2,6
29903,58thStGreenway22ndAve,07/28/2017 11:00:00 PM,48,-122,0,1,1
29904,58thStGreenway22ndAve,07/29/2017 12:00:00 AM,48,-122,2,0,2
29905,58thStGreenway22ndAve,07/29/2017 01:00:00 AM,48,-122,0,0,0
29906,58thStGreenway22ndAve,07/29/2017 02:00:00 AM,48,-122,0,0,0
29907,58thStGreenway22ndAve,07/29/2017 03:00:00 AM,48,-122,1,1,2
29908,58thStGreenway22ndAve,07/29/2017 04:00:00 AM,48,-122,0,0,0
29909,58thStGreenway22ndAve,07/29/2017 05:00:00 AM,48,-122,0,1,1
29910,58thStGreenway22ndAve,07/29/2017 06:00:00 AM,48,-122,1,2,3
29911,58thStGreenway22ndAve,07/29/2017 07:00:00 AM,48,-122,1,0,1
29912,58thStGreenway22ndAve,07/29/2017 08:00:00 AM,48,-122,2,5,7
29913,58thStGreenway22ndAve,07/29/2017 09:00:00 AM,48,-122,6,6,12
29914,58thStGreenway22ndAve,07/29/2017 10:00:00 AM,48,-122,6,4,10
29915,58thStGreenway22ndAve,07/29/2017 11:00:00 AM,48,-122,14,9,23
29916,58thStGreenway22ndAve,07/29/2017 12:00:00 PM,48,-122,5,3,8
29917,58thStGreenway22ndAve,07/29/2017 01:00:00 PM,48,-122,8,7,15
29918,58thStGreenway22ndAve,07/29/2017 02:00:00 PM,48,-122,8,5,13
29919,58thStGreenway22ndAve,07/29/2017 03:00:00 PM,48,-122,10,6,16
29920,58thStGreenway22ndAve,07/29/2017 04:00:00 PM,48,-122,8,6,14
29921,58thStGreenway22ndAve,07/29/2017 05:00:00 PM,48,-122,5,6,11
29922,58thStGreenway22ndAve,07/29/2017 06:00:00 PM,48,-122,4,3,7
29923,58thStGreenway22ndAve,07/29/2017 07:00:00 PM,48,-122,0,7,7
29924,58thStGreenway22ndAve,07/29/2017 08:00:00 PM,48,-122,1,1,2
29925,58thStGreenway22ndAve,07/29/2017 09:00:00 PM,48,-122,2,2,4
29926,58thStGreenway22ndAve,07/29/2017 10:00:00 PM,48,-122,5,4,9
29927,58thStGreenway22ndAve,07/29/2017 11:00:00 PM,48,-122,1,1,2
29928,58thStGreenway22ndAve,07/30/2017 12:00:00 AM,48,-122,2,0,2
29929,58thStGreenway22ndAve,07/30/2017 01:00:00 AM,48,-122,0,0,0
29930,58thStGreenway22ndAve,07/30/2017 02:00:00 AM,48,-122,0,1,1
29931,58thStGreenway22ndAve,07/30/2017 03:00:00 AM,48,-122,0,0,0
29932,58thStGreenway22ndAve,07/30/2017 04:00:00 AM,48,-122,0,0,0
29933,58thStGreenway22ndAve,07/30/2017 05:00:00 AM,48,-122,0,0,0
29934,58thStGreenway22ndAve,07/30/2017 06:00:00 AM,48,-122,0,1,1
29935,58thStGreenway22ndAve,07/30/2017 07:00:00 AM,48,-122,0,1,1
29936,58thStGreenway22ndAve,07/30/2017 08:00:00 AM,48,-122,2,5,7
29937,58thStGreenway22ndAve,07/30/2017 09:00:00 AM,48,-122,1,0,1
29938,58thStGreenway22ndAve,07/30/2017 10:00:00 AM,48,-122,8,7,15
29939,58thStGreenway22ndAve,07/30/2017 11:00:00 AM,48,-122,22,5,27
29940,58thStGreenway22ndAve,07/30/2017 12:00:00 PM,48,-122,16,12,28
29941,58thStGreenway22ndAve,07/30/2017 01:00:00 PM,48,-122,17,13,30
29942,58thStGreenway22ndAve,07/30/2017 02:00:00 PM,48,-122,14,11,25
29943,58thStGreenway22ndAve,07/30/2017 03:00:00 PM,48,-122,13,12,25
29944,58thStGreenway22ndAve,07/30/2017 04:00:00 PM,48,-122,8,9,17
29945,58thStGreenway22ndAve,07/30/2017 05:00:00 PM,48,-122,8,8,16
29946,58thStGreenway22ndAve,07/30/2017 06:00:00 PM,48,-122,9,4,13
29947,58thStGreenway22ndAve,07/30/2017 07:00:00 PM,48,-122,6,5,11
29948,58thStGreenway22ndAve,07/30/2017 08:00:00 PM,48,-122,6,3,9
29949,58thStGreenway22ndAve,07/30/2017 09:00:00 PM,48,-122,2,3,5
29950,58thStGreenway22ndAve,07/30/2017 10:00:00 PM,48,-122,4,3,7
29951,58thStGreenway22ndAve,07/30/2017 11:00:00 PM,48,-122,1,0,1
29952,58thStGreenway22ndAve,07/31/2017 12:00:00 AM,48,-122,0,1,1
29953,58thStGreenway22ndAve,07/31/2017 01:00:00 AM,48,-122,0,0,0
29954,58thStGreenway22ndAve,07/31/2017 02:00:00 AM,48,-122,0,0,0
29955,58thStGreenway22ndAve,07/31/2017 03:00:00 AM,48,-122,0,1,1
29956,58thStGreenway22ndAve,07/31/2017 04:00:00 AM,48,-122,0,1,1
29957,58thStGreenway22ndAve,07/31/2017 05:00:00 AM,48,-122,0,1,1
29958,58thStGreenway22ndAve,07/31/2017 06:00:00 AM,48,-122,3,2,5
29959,58thStGreenway22ndAve,07/31/2017 07:00:00 AM,48,-122,5,9,14
29960,58thStGreenway22ndAve,07/31/2017 08:00:00 AM,48,-122,8,8,16
29961,58thStGreenway22ndAve,07/31/2017 09:00:00 AM,48,-122,14,7,21
29962,58thStGreenway22ndAve,07/31/2017 10:00:00 AM,48,-122,7,7,14
29963,58thStGreenway22ndAve,07/31/2017 11:00:00 AM,48,-122,1,4,5
29964,58thStGreenway22ndAve,07/31/2017 12:00:00 PM,48,-122,7,3,10
29965,58thStGreenway22ndAve,07/31/2017 01:00:00 PM,48,-122,10,4,14
29966,58thStGreenway22ndAve,07/31/2017 02:00:00 PM,48,-122,8,3,11
29967,58thStGreenway22ndAve,07/31/2017 03:00:00 PM,48,-122,11,10,21
29968,58thStGreenway22ndAve,07/31/2017 04:00:00 PM,48,-122,7,10,17
29969,58thStGreenway22ndAve,07/31/2017 05:00:00 PM,48,-122,13,11,24
29970,58thStGreenway22ndAve,07/31/2017 06:00:00 PM,48,-122,16,11,27
29971,58thStGreenway22ndAve,07/31/2017 07:00:00 PM,48,-122,17,7,24
29972,58thStGreenway22ndAve,07/31/2017 08:00:00 PM,48,-122,7,9,16
29973,58thStGreenway22ndAve,07/31/2017 09:00:00 PM,48,-122,3,7,10
29974,58thStGreenway22ndAve,07/31/2017 10:00:00 PM,48,-122,5,3,8
29975,58thStGreenway22ndAve,07/31/2017 11:00:00 PM,48,-122,1,2,3
29976,58thStGreenway22ndAve,08/01/2017 12:00:00 AM,48,-122,0,0,0
29977,58thStGreenway22ndAve,08/01/2017 01:00:00 AM,48,-122,0,0,0
29978,58thStGreenway22ndAve,08/01/2017 02:00:00 AM,48,-122,0,0,0
29979,58thStGreenway22ndAve,08/01/2017 03:00:00 AM,48,-122,0,0,0
29980,58thStGreenway22ndAve,08/01/2017 04:00:00 AM,48,-122,0,0,0
29981,58thStGreenway22ndAve,08/01/2017 05:00:00 AM,48,-122,0,1,1
29982,58thStGreenway22ndAve,08/01/2017 06:00:00 AM,48,-122,2,0,2
29983,58thStGreenway22ndAve,08/01/2017 07:00:00 AM,48,-122,10,11,21
29984,58thStGreenway22ndAve,08/01/2017 08:00:00 AM,48,-122,11,9,20
29985,58thStGreenway22ndAve,08/01/2017 09:00:00 AM,48,-122,9,4,13
29986,58thStGreenway22ndAve,08/01/2017 10:00:00 AM,48,-122,9,6,15
29987,58thStGreenway22ndAve,08/01/2017 11:00:00 AM,48,-122,9,4,13
29988,58thStGreenway22ndAve,08/01/2017 12:00:00 PM,48,-122,12,6,18
29989,58thStGreenway22ndAve,08/01/2017 01:00:00 PM,48,-122,7,5,12
29990,58thStGreenway22ndAve,08/01/2017 02:00:00 PM,48,-122,6,8,14
29991,58thStGreenway22ndAve,08/01/2017 03:00:00 PM,48,-122,14,7,21
29992,58thStGreenway22ndAve,08/01/2017 04:00:00 PM,48,-122,16,4,20
29993,58thStGreenway22ndAve,08/01/2017 05:00:00 PM,48,-122,17,10,27
29994,58thStGreenway22ndAve,08/01/2017 06:00:00 PM,48,-122,25,15,40
29995,58thStGreenway22ndAve,08/01/2017 07:00:00 PM,48,-122,18,14,32
29996,58thStGreenway22ndAve,08/01/2017 08:00:00 PM,48,-122,5,12,17
29997,58thStGreenway22ndAve,08/01/2017 09:00:00 PM,48,-122,2,9,11
29998,58thStGreenway22ndAve,08/01/2017 10:00:00 PM,48,-122,3,3,6
29999,58thStGreenway22ndAve,08/01/2017 11:00:00 PM,48,-122,0,0,0
30000,58thStGreenway22ndAve,08/02/2017 12:00:00 AM,48,-122,0,0,0
30001,58thStGreenway22ndAve,08/02/2017 01:00:00 AM,48,-122,0,1,1
30002,58thStGreenway22ndAve,08/02/2017 02:00:00 AM,48,-122,0,0,0
30003,58thStGreenway22ndAve,08/02/2017 03:00:00 AM,48,-122,0,1,1
30004,58thStGreenway22ndAve,08/02/2017 04:00:00 AM,48,-122,0,0,0
30005,58thStGreenway22ndAve,08/02/2017 05:00:00 AM,48,-122,1,0,1
30006,58thStGreenway22ndAve,08/02/2017 06:00:00 AM,48,-122,3,1,4
30007,58thStGreenway22ndAve,08/02/2017 07:00:00 AM,48,-122,4,10,14
30008,58thStGreenway22ndAve,08/02/2017 08:00:00 AM,48,-122,8,6,14
30009,58thStGreenway22ndAve,08/02/2017 09:00:00 AM,48,-122,4,4,8
30010,58thStGreenway22ndAve,08/02/2017 10:00:00 AM,48,-122,12,4,16
30011,58thStGreenway22ndAve,08/02/2017 11:00:00 AM,48,-122,2,2,4
30012,58thStGreenway22ndAve,08/02/2017 12:00:00 PM,48,-122,6,5,11
30013,58thStGreenway22ndAve,08/02/2017 01:00:00 PM,48,-122,4,4,8
30014,58thStGreenway22ndAve,08/02/2017 02:00:00 PM,48,-122,4,5,9
30015,58thStGreenway22ndAve,08/02/2017 03:00:00 PM,48,-122,6,4,10
30016,58thStGreenway22ndAve,08/02/2017 04:00:00 PM,48,-122,6,5,11
30017,58thStGreenway22ndAve,08/02/2017 05:00:00 PM,48,-122,10,7,17
30018,58thStGreenway22ndAve,08/02/2017 06:00:00 PM,48,-122,16,14,30
30019,58thStGreenway22ndAve,08/02/2017 07:00:00 PM,48,-122,3,10,13
30020,58thStGreenway22ndAve,08/02/2017 08:00:00 PM,48,-122,5,7,12
30021,58thStGreenway22ndAve,08/02/2017 09:00:00 PM,48,-122,2,5,7
30022,58thStGreenway22ndAve,08/02/2017 10:00:00 PM,48,-122,4,1,5
30023,58thStGreenway22ndAve,08/02/2017 11:00:00 PM,48,-122,2,5,7
30024,58thStGreenway22ndAve,08/03/2017 12:00:00 AM,48,-122,0,1,1
30025,58thStGreenway22ndAve,08/03/2017 01:00:00 AM,48,-122,1,1,2
30026,58thStGreenway22ndAve,08/03/2017 02:00:00 AM,48,-122,0,0,0
30027,58thStGreenway22ndAve,08/03/2017 03:00:00 AM,48,-122,0,0,0
30028,58thStGreenway22ndAve,08/03/2017 04:00:00 AM,48,-122,0,0,0
30029,58thStGreenway22ndAve,08/03/2017 05:00:00 AM,48,-122,1,2,3
30030,58thStGreenway22ndAve,08/03/2017 06:00:00 AM,48,-122,2,1,3
30031,58thStGreenway22ndAve,08/03/2017 07:00:00 AM,48,-122,2,4,6
30032,58thStGreenway22ndAve,08/03/2017 08:00:00 AM,48,-122,3,4,7
30033,58thStGreenway22ndAve,08/03/2017 09:00:00 AM,48,-122,6,4,10
30034,58thStGreenway22ndAve,08/03/2017 10:00:00 AM,48,-122,5,3,8
30035,58thStGreenway22ndAve,08/03/2017 11:00:00 AM,48,-122,4,5,9
30036,58thStGreenway22ndAve,08/03/2017 12:00:00 PM,48,-122,8,4,12
30037,58thStGreenway22ndAve,08/03/2017 01:00:00 PM,48,-122,8,5,13
30038,58thStGreenway22ndAve,08/03/2017 02:00:00 PM,48,-122,4,0,4
30039,58thStGreenway22ndAve,08/03/2017 03:00:00 PM,48,-122,6,2,8
30040,58thStGreenway22ndAve,08/03/2017 04:00:00 PM,48,-122,8,5,13
30041,58thStGreenway22ndAve,08/03/2017 05:00:00 PM,48,-122,9,5,14
30042,58thStGreenway22ndAve,08/03/2017 06:00:00 PM,48,-122,13,5,18
30043,58thStGreenway22ndAve,08/03/2017 07:00:00 PM,48,-122,7,7,14
30044,58thStGreenway22ndAve,08/03/2017 08:00:00 PM,48,-122,2,6,8
30045,58thStGreenway22ndAve,08/03/2017 09:00:00 PM,48,-122,3,3,6
30046,58thStGreenway22ndAve,08/03/2017 10:00:00 PM,48,-122,1,1,2
30047,58thStGreenway22ndAve,08/03/2017 11:00:00 PM,48,-122,1,1,2
30048,58thStGreenway22ndAve,08/04/2017 12:00:00 AM,48,-122,0,0,0
30049,58thStGreenway22ndAve,08/04/2017 01:00:00 AM,48,-122,1,0,1
30050,58thStGreenway22ndAve,08/04/2017 02:00:00 AM,48,-122,0,0,0
30051,58thStGreenway22ndAve,08/04/2017 03:00:00 AM,48,-122,0,0,0
30052,58thStGreenway22ndAve,08/04/2017 04:00:00 AM,48,-122,1,0,1
30053,58thStGreenway22ndAve,08/04/2017 05:00:00 AM,48,-122,1,0,1
30054,58thStGreenway22ndAve,08/04/2017 06:00:00 AM,48,-122,4,0,4
30055,58thStGreenway22ndAve,08/04/2017 07:00:00 AM,48,-122,4,2,6
30056,58thStGreenway22ndAve,08/04/2017 08:00:00 AM,48,-122,2,7,9
30057,58thStGreenway22ndAve,08/04/2017 09:00:00 AM,48,-122,3,5,8
30058,58thStGreenway22ndAve,08/04/2017 10:00:00 AM,48,-122,8,2,10
30059,58thStGreenway22ndAve,08/04/2017 11:00:00 AM,48,-122,6,5,11
30060,58thStGreenway22ndAve,08/04/2017 12:00:00 PM,48,-122,5,1,6
30061,58thStGreenway22ndAve,08/04/2017 01:00:00 PM,48,-122,6,1,7
30062,58thStGreenway22ndAve,08/04/2017 02:00:00 PM,48,-122,5,3,8
30063,58thStGreenway22ndAve,08/04/2017 03:00:00 PM,48,-122,7,8,15
30064,58thStGreenway22ndAve,08/04/2017 04:00:00 PM,48,-122,9,11,20
30065,58thStGreenway22ndAve,08/04/2017 05:00:00 PM,48,-122,8,9,17
30066,58thStGreenway22ndAve,08/04/2017 06:00:00 PM,48,-122,8,5,13
30067,58thStGreenway22ndAve,08/04/2017 07:00:00 PM,48,-122,7,3,10
30068,58thStGreenway22ndAve,08/04/2017 08:00:00 PM,48,-122,2,3,5
30069,58thStGreenway22ndAve,08/04/2017 09:00:00 PM,48,-122,2,0,2
30070,58thStGreenway22ndAve,08/04/2017 10:00:00 PM,48,-122,2,3,5
30071,58thStGreenway22ndAve,08/04/2017 11:00:00 PM,48,-122,0,3,3
30072,58thStGreenway22ndAve,08/05/2017 12:00:00 AM,48,-122,0,1,1
30073,58thStGreenway22ndAve,08/05/2017 01:00:00 AM,48,-122,0,0,0
30074,58thStGreenway22ndAve,08/05/2017 02:00:00 AM,48,-122,1,0,1
30075,58thStGreenway22ndAve,08/05/2017 03:00:00 AM,48,-122,0,0,0
30076,58thStGreenway22ndAve,08/05/2017 04:00:00 AM,48,-122,0,0,0
30077,58thStGreenway22ndAve,08/05/2017 05:00:00 AM,48,-122,0,0,0
30078,58thStGreenway22ndAve,08/05/2017 06:00:00 AM,48,-122,0,0,0
30079,58thStGreenway22ndAve,08/05/2017 07:00:00 AM,48,-122,2,1,3
30080,58thStGreenway22ndAve,08/05/2017 08:00:00 AM,48,-122,7,3,10
30081,58thStGreenway22ndAve,08/05/2017 09:00:00 AM,48,-122,5,7,12
30082,58thStGreenway22ndAve,08/05/2017 10:00:00 AM,48,-122,7,7,14
30083,58thStGreenway22ndAve,08/05/2017 11:00:00 AM,48,-122,4,4,8
30084,58thStGreenway22ndAve,08/05/2017 12:00:00 PM,48,-122,5,2,7
30085,58thStGreenway22ndAve,08/05/2017 01:00:00 PM,48,-122,12,6,18
30086,58thStGreenway22ndAve,08/05/2017 02:00:00 PM,48,-122,16,8,24
30087,58thStGreenway22ndAve,08/05/2017 03:00:00 PM,48,-122,6,5,11
30088,58thStGreenway22ndAve,08/05/2017 04:00:00 PM,48,-122,13,8,21
30089,58thStGreenway22ndAve,08/05/2017 05:00:00 PM,48,-122,8,4,12
30090,58thStGreenway22ndAve,08/05/2017 06:00:00 PM,48,-122,4,3,7
30091,58thStGreenway22ndAve,08/05/2017 07:00:00 PM,48,-122,2,11,13
30092,58thStGreenway22ndAve,08/05/2017 08:00:00 PM,48,-122,3,2,5
30093,58thStGreenway22ndAve,08/05/2017 09:00:00 PM,48,-122,1,3,4
30094,58thStGreenway22ndAve,08/05/2017 10:00:00 PM,48,-122,2,1,3
30095,58thStGreenway22ndAve,08/05/2017 11:00:00 PM,48,-122,1,2,3
30096,58thStGreenway22ndAve,08/06/2017 12:00:00 AM,48,-122,0,0,0
30097,58thStGreenway22ndAve,08/06/2017 01:00:00 AM,48,-122,1,1,2
30098,58thStGreenway22ndAve,08/06/2017 02:00:00 AM,48,-122,0,0,0
30099,58thStGreenway22ndAve,08/06/2017 03:00:00 AM,48,-122,0,0,0
30100,58thStGreenway22ndAve,08/06/2017 04:00:00 AM,48,-122,0,0,0
30101,58thStGreenway22ndAve,08/06/2017 05:00:00 AM,48,-122,0,0,0
30102,58thStGreenway22ndAve,08/06/2017 06:00:00 AM,48,-122,0,0,0
30103,58thStGreenway22ndAve,08/06/2017 07:00:00 AM,48,-122,2,0,2
30104,58thStGreenway22ndAve,08/06/2017 08:00:00 AM,48,-122,3,2,5
30105,58thStGreenway22ndAve,08/06/2017 09:00:00 AM,48,-122,6,6,12
30106,58thStGreenway22ndAve,08/06/2017 10:00:00 AM,48,-122,15,7,22
30107,58thStGreenway22ndAve,08/06/2017 11:00:00 AM,48,-122,14,9,23
30108,58thStGreenway22ndAve,08/06/2017 12:00:00 PM,48,-122,16,10,26
30109,58thStGreenway22ndAve,08/06/2017 01:00:00 PM,48,-122,12,5,17
30110,58thStGreenway22ndAve,08/06/2017 02:00:00 PM,48,-122,7,10,17
30111,58thStGreenway22ndAve,08/06/2017 03:00:00 PM,48,-122,8,11,19
30112,58thStGreenway22ndAve,08/06/2017 04:00:00 PM,48,-122,5,7,12
30113,58thStGreenway22ndAve,08/06/2017 05:00:00 PM,48,-122,5,3,8
30114,58thStGreenway22ndAve,08/06/2017 06:00:00 PM,48,-122,6,4,10
30115,58thStGreenway22ndAve,08/06/2017 07:00:00 PM,48,-122,3,2,5
30116,58thStGreenway22ndAve,08/06/2017 08:00:00 PM,48,-122,3,4,7
30117,58thStGreenway22ndAve,08/06/2017 09:00:00 PM,48,-122,1,3,4
30118,58thStGreenway22ndAve,08/06/2017 10:00:00 PM,48,-122,2,1,3
30119,58thStGreenway22ndAve,08/06/2017 11:00:00 PM,48,-122,0,0,0
30120,58thStGreenway22ndAve,08/07/2017 12:00:00 AM,48,-122,1,1,2
30121,58thStGreenway22ndAve,08/07/2017 01:00:00 AM,48,-122,0,0,0
30122,58thStGreenway22ndAve,08/07/2017 02:00:00 AM,48,-122,0,0,0
30123,58thStGreenway22ndAve,08/07/2017 03:00:00 AM,48,-122,0,1,1
30124,58thStGreenway22ndAve,08/07/2017 04:00:00 AM,48,-122,0,0,0
30125,58thStGreenway22ndAve,08/07/2017 05:00:00 AM,48,-122,0,1,1
30126,58thStGreenway22ndAve,08/07/2017 06:00:00 AM,48,-122,6,3,9
30127,58thStGreenway22ndAve,08/07/2017 07:00:00 AM,48,-122,7,11,18
30128,58thStGreenway22ndAve,08/07/2017 08:00:00 AM,48,-122,6,9,15
30129,58thStGreenway22ndAve,08/07/2017 09:00:00 AM,48,-122,4,9,13
30130,58thStGreenway22ndAve,08/07/2017 10:00:00 AM,48,-122,2,4,6
30131,58thStGreenway22ndAve,08/07/2017 11:00:00 AM,48,-122,8,3,11
30132,58thStGreenway22ndAve,08/07/2017 12:00:00 PM,48,-122,6,4,10
30133,58thStGreenway22ndAve,08/07/2017 01:00:00 PM,48,-122,8,3,11
30134,58thStGreenway22ndAve,08/07/2017 02:00:00 PM,48,-122,3,2,5
30135,58thStGreenway22ndAve,08/07/2017 03:00:00 PM,48,-122,5,7,12
30136,58thStGreenway22ndAve,08/07/2017 04:00:00 PM,48,-122,8,2,10
30137,58thStGreenway22ndAve,08/07/2017 05:00:00 PM,48,-122,12,12,24
30138,58thStGreenway22ndAve,08/07/2017 06:00:00 PM,48,-122,9,16,25
30139,58thStGreenway22ndAve,08/07/2017 07:00:00 PM,48,-122,4,3,7
30140,58thStGreenway22ndAve,08/07/2017 08:00:00 PM,48,-122,7,6,13
30141,58thStGreenway22ndAve,08/07/2017 09:00:00 PM,48,-122,2,3,5
30142,58thStGreenway22ndAve,08/07/2017 10:00:00 PM,48,-122,1,1,2
30143,58thStGreenway22ndAve,08/07/2017 11:00:00 PM,48,-122,1,0,1
30144,58thStGreenway22ndAve,08/08/2017 12:00:00 AM,48,-122,0,1,1
30145,58thStGreenway22ndAve,08/08/2017 01:00:00 AM,48,-122,0,0,0
30146,58thStGreenway22ndAve,08/08/2017 02:00:00 AM,48,-122,0,0,0
30147,58thStGreenway22ndAve,08/08/2017 03:00:00 AM,48,-122,0,0,0
30148,58thStGreenway22ndAve,08/08/2017 04:00:00 AM,48,-122,0,0,0
30149,58thStGreenway22ndAve,08/08/2017 05:00:00 AM,48,-122,0,2,2
30150,58thStGreenway22ndAve,08/08/2017 06:00:00 AM,48,-122,0,4,4
30151,58thStGreenway22ndAve,08/08/2017 07:00:00 AM,48,-122,7,5,12
30152,58thStGreenway22ndAve,08/08/2017 08:00:00 AM,48,-122,6,5,11
30153,58thStGreenway22ndAve,08/08/2017 09:00:00 AM,48,-122,4,7,11
30154,58thStGreenway22ndAve,08/08/2017 10:00:00 AM,48,-122,9,5,14
30155,58thStGreenway22ndAve,08/08/2017 11:00:00 AM,48,-122,7,6,13
30156,58thStGreenway22ndAve,08/08/2017 12:00:00 PM,48,-122,1,6,7
30157,58thStGreenway22ndAve,08/08/2017 01:00:00 PM,48,-122,5,4,9
30158,58thStGreenway22ndAve,08/08/2017 02:00:00 PM,48,-122,7,4,11
30159,58thStGreenway22ndAve,08/08/2017 03:00:00 PM,48,-122,5,9,14
30160,58thStGreenway22ndAve,08/08/2017 04:00:00 PM,48,-122,8,7,15
30161,58thStGreenway22ndAve,08/08/2017 05:00:00 PM,48,-122,11,10,21
30162,58thStGreenway22ndAve,08/08/2017 06:00:00 PM,48,-122,6,11,17
30163,58thStGreenway22ndAve,08/08/2017 07:00:00 PM,48,-122,16,2,18
30164,58thStGreenway22ndAve,08/08/2017 08:00:00 PM,48,-122,5,8,13
30165,58thStGreenway22ndAve,08/08/2017 09:00:00 PM,48,-122,1,5,6
30166,58thStGreenway22ndAve,08/08/2017 10:00:00 PM,48,-122,0,2,2
30167,58thStGreenway22ndAve,08/08/2017 11:00:00 PM,48,-122,0,1,1
30168,58thStGreenway22ndAve,08/09/2017 12:00:00 AM,48,-122,0,0,0
30169,58thStGreenway22ndAve,08/09/2017 01:00:00 AM,48,-122,0,0,0
30170,58thStGreenway22ndAve,08/09/2017 02:00:00 AM,48,-122,0,1,1
30171,58thStGreenway22ndAve,08/09/2017 03:00:00 AM,48,-122,1,0,1
30172,58thStGreenway22ndAve,08/09/2017 04:00:00 AM,48,-122,1,0,1
30173,58thStGreenway22ndAve,08/09/2017 05:00:00 AM,48,-122,1,0,1
30174,58thStGreenway22ndAve,08/09/2017 06:00:00 AM,48,-122,1,0,1
30175,58thStGreenway22ndAve,08/09/2017 07:00:00 AM,48,-122,7,4,11
30176,58thStGreenway22ndAve,08/09/2017 08:00:00 AM,48,-122,10,8,18
30177,58thStGreenway22ndAve,08/09/2017 09:00:00 AM,48,-122,8,9,17
30178,58thStGreenway22ndAve,08/09/2017 10:00:00 AM,48,-122,3,9,12
30179,58thStGreenway22ndAve,08/09/2017 11:00:00 AM,48,-122,6,5,11
30180,58thStGreenway22ndAve,08/09/2017 12:00:00 PM,48,-122,4,6,10
30181,58thStGreenway22ndAve,08/09/2017 01:00:00 PM,48,-122,7,2,9
30182,58thStGreenway22ndAve,08/09/2017 02:00:00 PM,48,-122,1,8,9
30183,58thStGreenway22ndAve,08/09/2017 03:00:00 PM,48,-122,5,9,14
30184,58thStGreenway22ndAve,08/09/2017 04:00:00 PM,48,-122,8,8,16
30185,58thStGreenway22ndAve,08/09/2017 05:00:00 PM,48,-122,7,11,18
30186,58thStGreenway22ndAve,08/09/2017 06:00:00 PM,48,-122,13,3,16
30187,58thStGreenway22ndAve,08/09/2017 07:00:00 PM,48,-122,3,4,7
30188,58thStGreenway22ndAve,08/09/2017 08:00:00 PM,48,-122,4,2,6
30189,58thStGreenway22ndAve,08/09/2017 09:00:00 PM,48,-122,4,6,10
30190,58thStGreenway22ndAve,08/09/2017 10:00:00 PM,48,-122,3,3,6
30191,58thStGreenway22ndAve,08/09/2017 11:00:00 PM,48,-122,0,1,1
30192,58thStGreenway22ndAve,08/10/2017 12:00:00 AM,48,-122,0,0,0
30193,58thStGreenway22ndAve,08/10/2017 01:00:00 AM,48,-122,0,0,0
30194,58thStGreenway22ndAve,08/10/2017 02:00:00 AM,48,-122,0,0,0
30195,58thStGreenway22ndAve,08/10/2017 03:00:00 AM,48,-122,0,1,1
30196,58thStGreenway22ndAve,08/10/2017 04:00:00 AM,48,-122,0,0,0
30197,58thStGreenway22ndAve,08/10/2017 05:00:00 AM,48,-122,0,0,0
30198,58thStGreenway22ndAve,08/10/2017 06:00:00 AM,48,-122,2,4,6
30199,58thStGreenway22ndAve,08/10/2017 07:00:00 AM,48,-122,4,6,10
30200,58thStGreenway22ndAve,08/10/2017 08:00:00 AM,48,-122,6,4,10
30201,58thStGreenway22ndAve,08/10/2017 09:00:00 AM,48,-122,9,6,15
30202,58thStGreenway22ndAve,08/10/2017 10:00:00 AM,48,-122,4,8,12
30203,58thStGreenway22ndAve,08/10/2017 11:00:00 AM,48,-122,2,5,7
30204,58thStGreenway22ndAve,08/10/2017 12:00:00 PM,48,-122,2,5,7
30205,58thStGreenway22ndAve,08/10/2017 01:00:00 PM,48,-122,6,8,14
30206,58thStGreenway22ndAve,08/10/2017 02:00:00 PM,48,-122,3,5,8
30207,58thStGreenway22ndAve,08/10/2017 03:00:00 PM,48,-122,7,11,18
30208,58thStGreenway22ndAve,08/10/2017 04:00:00 PM,48,-122,14,8,22
30209,58thStGreenway22ndAve,08/10/2017 05:00:00 PM,48,-122,7,10,17
30210,58thStGreenway22ndAve,08/10/2017 06:00:00 PM,48,-122,17,11,28
30211,58thStGreenway22ndAve,08/10/2017 07:00:00 PM,48,-122,10,10,20
30212,58thStGreenway22ndAve,08/10/2017 08:00:00 PM,48,-122,5,6,11
30213,58thStGreenway22ndAve,08/10/2017 09:00:00 PM,48,-122,4,4,8
30214,58thStGreenway22ndAve,08/10/2017 10:00:00 PM,48,-122,3,0,3
30215,58thStGreenway22ndAve,08/10/2017 11:00:00 PM,48,-122,1,1,2
30216,58thStGreenway22ndAve,08/11/2017 12:00:00 AM,48,-122,1,1,2
30217,58thStGreenway22ndAve,08/11/2017 01:00:00 AM,48,-122,0,0,0
30218,58thStGreenway22ndAve,08/11/2017 02:00:00 AM,48,-122,0,0,0
30219,58thStGreenway22ndAve,08/11/2017 03:00:00 AM,48,-122,2,2,4
30220,58thStGreenway22ndAve,08/11/2017 04:00:00 AM,48,-122,1,0,1
30221,58thStGreenway22ndAve,08/11/2017 05:00:00 AM,48,-122,2,0,2
30222,58thStGreenway22ndAve,08/11/2017 06:00:00 AM,48,-122,1,3,4
30223,58thStGreenway22ndAve,08/11/2017 07:00:00 AM,48,-122,3,5,8
30224,58thStGreenway22ndAve,08/11/2017 08:00:00 AM,48,-122,5,4,9
30225,58thStGreenway22ndAve,08/11/2017 09:00:00 AM,48,-122,5,5,10
30226,58thStGreenway22ndAve,08/11/2017 10:00:00 AM,48,-122,9,4,13
30227,58thStGreenway22ndAve,08/11/2017 11:00:00 AM,48,-122,7,5,12
30228,58thStGreenway22ndAve,08/11/2017 12:00:00 PM,48,-122,7,3,10
30229,58thStGreenway22ndAve,08/11/2017 01:00:00 PM,48,-122,10,6,16
30230,58thStGreenway22ndAve,08/11/2017 02:00:00 PM,48,-122,4,6,10
30231,58thStGreenway22ndAve,08/11/2017 03:00:00 PM,48,-122,6,6,12
30232,58thStGreenway22ndAve,08/11/2017 04:00:00 PM,48,-122,12,7,19
30233,58thStGreenway22ndAve,08/11/2017 05:00:00 PM,48,-122,9,7,16
30234,58thStGreenway22ndAve,08/11/2017 06:00:00 PM,48,-122,7,6,13
30235,58thStGreenway22ndAve,08/11/2017 07:00:00 PM,48,-122,8,8,16
30236,58thStGreenway22ndAve,08/11/2017 08:00:00 PM,48,-122,7,7,14
30237,58thStGreenway22ndAve,08/11/2017 09:00:00 PM,48,-122,4,2,6
30238,58thStGreenway22ndAve,08/11/2017 10:00:00 PM,48,-122,3,1,4
30239,58thStGreenway22ndAve,08/11/2017 11:00:00 PM,48,-122,2,0,2
30240,58thStGreenway22ndAve,08/12/2017 12:00:00 AM,48,-122,1,2,3
30241,58thStGreenway22ndAve,08/12/2017 01:00:00 AM,48,-122,1,2,3
30242,58thStGreenway22ndAve,08/12/2017 02:00:00 AM,48,-122,0,0,0
30243,58thStGreenway22ndAve,08/12/2017 03:00:00 AM,48,-122,0,0,0
30244,58thStGreenway22ndAve,08/12/2017 04:00:00 AM,48,-122,0,0,0
30245,58thStGreenway22ndAve,08/12/2017 05:00:00 AM,48,-122,0,0,0
30246,58thStGreenway22ndAve,08/12/2017 06:00:00 AM,48,-122,0,0,0
30247,58thStGreenway22ndAve,08/12/2017 07:00:00 AM,48,-122,3,0,3
30248,58thStGreenway22ndAve,08/12/2017 08:00:00 AM,48,-122,5,0,5
30249,58thStGreenway22ndAve,08/12/2017 09:00:00 AM,48,-122,6,3,9
30250,58thStGreenway22ndAve,08/12/2017 10:00:00 AM,48,-122,14,8,22
30251,58thStGreenway22ndAve,08/12/2017 11:00:00 AM,48,-122,5,11,16
30252,58thStGreenway22ndAve,08/12/2017 12:00:00 PM,48,-122,9,7,16
30253,58thStGreenway22ndAve,08/12/2017 01:00:00 PM,48,-122,4,3,7
30254,58thStGreenway22ndAve,08/12/2017 02:00:00 PM,48,-122,15,6,21
30255,58thStGreenway22ndAve,08/12/2017 03:00:00 PM,48,-122,17,12,29
30256,58thStGreenway22ndAve,08/12/2017 04:00:00 PM,48,-122,9,5,14
30257,58thStGreenway22ndAve,08/12/2017 05:00:00 PM,48,-122,9,4,13
30258,58thStGreenway22ndAve,08/12/2017 06:00:00 PM,48,-122,7,14,21
30259,58thStGreenway22ndAve,08/12/2017 07:00:00 PM,48,-122,7,6,13
30260,58thStGreenway22ndAve,08/12/2017 08:00:00 PM,48,-122,4,5,9
30261,58thStGreenway22ndAve,08/12/2017 09:00:00 PM,48,-122,2,1,3
30262,58thStGreenway22ndAve,08/12/2017 10:00:00 PM,48,-122,2,5,7
30263,58thStGreenway22ndAve,08/12/2017 11:00:00 PM,48,-122,1,1,2
30264,58thStGreenway22ndAve,08/13/2017 12:00:00 AM,48,-122,0,2,2
30265,58thStGreenway22ndAve,08/13/2017 01:00:00 AM,48,-122,0,0,0
30266,58thStGreenway22ndAve,08/13/2017 02:00:00 AM,48,-122,0,0,0
30267,58thStGreenway22ndAve,08/13/2017 03:00:00 AM,48,-122,0,0,0
30268,58thStGreenway22ndAve,08/13/2017 04:00:00 AM,48,-122,0,0,0
30269,58thStGreenway22ndAve,08/13/2017 05:00:00 AM,48,-122,0,0,0
30270,58thStGreenway22ndAve,08/13/2017 06:00:00 AM,48,-122,0,0,0
30271,58thStGreenway22ndAve,08/13/2017 07:00:00 AM,48,-122,0,1,1
30272,58thStGreenway22ndAve,08/13/2017 08:00:00 AM,48,-122,2,3,5
30273,58thStGreenway22ndAve,08/13/2017 09:00:00 AM,48,-122,5,2,7
30274,58thStGreenway22ndAve,08/13/2017 10:00:00 AM,48,-122,5,5,10
30275,58thStGreenway22ndAve,08/13/2017 11:00:00 AM,48,-122,9,7,16
30276,58thStGreenway22ndAve,08/13/2017 12:00:00 PM,48,-122,8,20,28
30277,58thStGreenway22ndAve,08/13/2017 01:00:00 PM,48,-122,12,5,17
30278,58thStGreenway22ndAve,08/13/2017 02:00:00 PM,48,-122,7,15,22
30279,58thStGreenway22ndAve,08/13/2017 03:00:00 PM,48,-122,3,4,7
30280,58thStGreenway22ndAve,08/13/2017 04:00:00 PM,48,-122,11,3,14
30281,58thStGreenway22ndAve,08/13/2017 05:00:00 PM,48,-122,10,11,21
30282,58thStGreenway22ndAve,08/13/2017 06:00:00 PM,48,-122,3,1,4
30283,58thStGreenway22ndAve,08/13/2017 07:00:00 PM,48,-122,3,3,6
30284,58thStGreenway22ndAve,08/13/2017 08:00:00 PM,48,-122,1,2,3
30285,58thStGreenway22ndAve,08/13/2017 09:00:00 PM,48,-122,2,0,2
30286,58thStGreenway22ndAve,08/13/2017 10:00:00 PM,48,-122,0,0,0
30287,58thStGreenway22ndAve,08/13/2017 11:00:00 PM,48,-122,0,0,0
30288,58thStGreenway22ndAve,08/14/2017 12:00:00 AM,48,-122,1,0,1
30289,58thStGreenway22ndAve,08/14/2017 01:00:00 AM,48,-122,0,0,0
30290,58thStGreenway22ndAve,08/14/2017 02:00:00 AM,48,-122,0,1,1
30291,58thStGreenway22ndAve,08/14/2017 03:00:00 AM,48,-122,1,0,1
30292,58thStGreenway22ndAve,08/14/2017 04:00:00 AM,48,-122,0,1,1
30293,58thStGreenway22ndAve,08/14/2017 05:00:00 AM,48,-122,0,1,1
30294,58thStGreenway22ndAve,08/14/2017 06:00:00 AM,48,-122,2,0,2
30295,58thStGreenway22ndAve,08/14/2017 07:00:00 AM,48,-122,4,5,9
30296,58thStGreenway22ndAve,08/14/2017 08:00:00 AM,48,-122,2,2,4
30297,58thStGreenway22ndAve,08/14/2017 09:00:00 AM,48,-122,3,4,7
30298,58thStGreenway22ndAve,08/14/2017 10:00:00 AM,48,-122,7,4,11
30299,58thStGreenway22ndAve,08/14/2017 11:00:00 AM,48,-122,7,5,12
30300,58thStGreenway22ndAve,08/14/2017 12:00:00 PM,48,-122,12,4,16
30301,58thStGreenway22ndAve,08/14/2017 01:00:00 PM,48,-122,7,6,13
30302,58thStGreenway22ndAve,08/14/2017 02:00:00 PM,48,-122,8,1,9
30303,58thStGreenway22ndAve,08/14/2017 03:00:00 PM,48,-122,9,8,17
30304,58thStGreenway22ndAve,08/14/2017 04:00:00 PM,48,-122,6,4,10
30305,58thStGreenway22ndAve,08/14/2017 05:00:00 PM,48,-122,10,3,13
30306,58thStGreenway22ndAve,08/14/2017 06:00:00 PM,48,-122,6,7,13
30307,58thStGreenway22ndAve,08/14/2017 07:00:00 PM,48,-122,5,2,7
30308,58thStGreenway22ndAve,08/14/2017 08:00:00 PM,48,-122,6,6,12
30309,58thStGreenway22ndAve,08/14/2017 09:00:00 PM,48,-122,3,6,9
30310,58thStGreenway22ndAve,08/14/2017 10:00:00 PM,48,-122,0,0,0
30311,58thStGreenway22ndAve,08/14/2017 11:00:00 PM,48,-122,1,1,2
30312,58thStGreenway22ndAve,08/15/2017 12:00:00 AM,48,-122,0,0,0
30313,58thStGreenway22ndAve,08/15/2017 01:00:00 AM,48,-122,2,0,2
30314,58thStGreenway22ndAve,08/15/2017 02:00:00 AM,48,-122,0,0,0
30315,58thStGreenway22ndAve,08/15/2017 03:00:00 AM,48,-122,0,0,0
30316,58thStGreenway22ndAve,08/15/2017 04:00:00 AM,48,-122,0,0,0
30317,58thStGreenway22ndAve,08/15/2017 05:00:00 AM,48,-122,0,0,0
30318,58thStGreenway22ndAve,08/15/2017 06:00:00 AM,48,-122,1,3,4
30319,58thStGreenway22ndAve,08/15/2017 07:00:00 AM,48,-122,3,9,12
30320,58thStGreenway22ndAve,08/15/2017 08:00:00 AM,48,-122,6,8,14
30321,58thStGreenway22ndAve,08/15/2017 09:00:00 AM,48,-122,1,1,2
30322,58thStGreenway22ndAve,08/15/2017 10:00:00 AM,48,-122,2,5,7
30323,58thStGreenway22ndAve,08/15/2017 11:00:00 AM,48,-122,7,3,10
30324,58thStGreenway22ndAve,08/15/2017 12:00:00 PM,48,-122,9,7,16
30325,58thStGreenway22ndAve,08/15/2017 01:00:00 PM,48,-122,5,8,13
30326,58thStGreenway22ndAve,08/15/2017 02:00:00 PM,48,-122,8,8,16
30327,58thStGreenway22ndAve,08/15/2017 03:00:00 PM,48,-122,10,4,14
30328,58thStGreenway22ndAve,08/15/2017 04:00:00 PM,48,-122,10,5,15
30329,58thStGreenway22ndAve,08/15/2017 05:00:00 PM,48,-122,10,8,18
30330,58thStGreenway22ndAve,08/15/2017 06:00:00 PM,48,-122,23,13,36
30331,58thStGreenway22ndAve,08/15/2017 07:00:00 PM,48,-122,20,10,30
30332,58thStGreenway22ndAve,08/15/2017 08:00:00 PM,48,-122,4,7,11
30333,58thStGreenway22ndAve,08/15/2017 09:00:00 PM,48,-122,1,3,4
30334,58thStGreenway22ndAve,08/15/2017 10:00:00 PM,48,-122,3,3,6
30335,58thStGreenway22ndAve,08/15/2017 11:00:00 PM,48,-122,1,0,1
30336,58thStGreenway22ndAve,08/16/2017 12:00:00 AM,48,-122,0,0,0
30337,58thStGreenway22ndAve,08/16/2017 01:00:00 AM,48,-122,0,1,1
30338,58thStGreenway22ndAve,08/16/2017 02:00:00 AM,48,-122,0,0,0
30339,58thStGreenway22ndAve,08/16/2017 03:00:00 AM,48,-122,0,1,1
30340,58thStGreenway22ndAve,08/16/2017 04:00:00 AM,48,-122,0,0,0
30341,58thStGreenway22ndAve,08/16/2017 05:00:00 AM,48,-122,0,0,0
30342,58thStGreenway22ndAve,08/16/2017 06:00:00 AM,48,-122,1,1,2
30343,58thStGreenway22ndAve,08/16/2017 07:00:00 AM,48,-122,8,4,12
30344,58thStGreenway22ndAve,08/16/2017 08:00:00 AM,48,-122,7,8,15
30345,58thStGreenway22ndAve,08/16/2017 09:00:00 AM,48,-122,6,5,11
30346,58thStGreenway22ndAve,08/16/2017 10:00:00 AM,48,-122,3,6,9
30347,58thStGreenway22ndAve,08/16/2017 11:00:00 AM,48,-122,9,3,12
30348,58thStGreenway22ndAve,08/16/2017 12:00:00 PM,48,-122,5,5,10
30349,58thStGreenway22ndAve,08/16/2017 01:00:00 PM,48,-122,8,6,14
30350,58thStGreenway22ndAve,08/16/2017 02:00:00 PM,48,-122,5,2,7
30351,58thStGreenway22ndAve,08/16/2017 03:00:00 PM,48,-122,7,6,13
30352,58thStGreenway22ndAve,08/16/2017 04:00:00 PM,48,-122,10,7,17
30353,58thStGreenway22ndAve,08/16/2017 05:00:00 PM,48,-122,5,16,21
30354,58thStGreenway22ndAve,08/16/2017 06:00:00 PM,48,-122,9,15,24
30355,58thStGreenway22ndAve,08/16/2017 07:00:00 PM,48,-122,16,12,28
30356,58thStGreenway22ndAve,08/16/2017 08:00:00 PM,48,-122,7,11,18
30357,58thStGreenway22ndAve,08/16/2017 09:00:00 PM,48,-122,1,2,3
30358,58thStGreenway22ndAve,08/16/2017 10:00:00 PM,48,-122,0,4,4
30359,58thStGreenway22ndAve,08/16/2017 11:00:00 PM,48,-122,3,0,3
30360,58thStGreenway22ndAve,08/17/2017 12:00:00 AM,48,-122,1,1,2
30361,58thStGreenway22ndAve,08/17/2017 01:00:00 AM,48,-122,0,0,0
30362,58thStGreenway22ndAve,08/17/2017 02:00:00 AM,48,-122,0,0,0
30363,58thStGreenway22ndAve,08/17/2017 03:00:00 AM,48,-122,0,0,0
30364,58thStGreenway22ndAve,08/17/2017 04:00:00 AM,48,-122,1,0,1
30365,58thStGreenway22ndAve,08/17/2017 05:00:00 AM,48,-122,0,0,0
30366,58thStGreenway22ndAve,08/17/2017 06:00:00 AM,48,-122,3,3,6
30367,58thStGreenway22ndAve,08/17/2017 07:00:00 AM,48,-122,3,5,8
30368,58thStGreenway22ndAve,08/17/2017 08:00:00 AM,48,-122,4,7,11
30369,58thStGreenway22ndAve,08/17/2017 09:00:00 AM,48,-122,3,4,7
30370,58thStGreenway22ndAve,08/17/2017 10:00:00 AM,48,-122,6,4,10
30371,58thStGreenway22ndAve,08/17/2017 11:00:00 AM,48,-122,6,2,8
30372,58thStGreenway22ndAve,08/17/2017 12:00:00 PM,48,-122,3,3,6
30373,58thStGreenway22ndAve,08/17/2017 01:00:00 PM,48,-122,8,9,17
30374,58thStGreenway22ndAve,08/17/2017 02:00:00 PM,48,-122,7,6,13
30375,58thStGreenway22ndAve,08/17/2017 03:00:00 PM,48,-122,6,3,9
30376,58thStGreenway22ndAve,08/17/2017 04:00:00 PM,48,-122,10,8,18
30377,58thStGreenway22ndAve,08/17/2017 05:00:00 PM,48,-122,6,8,14
30378,58thStGreenway22ndAve,08/17/2017 06:00:00 PM,48,-122,13,10,23
30379,58thStGreenway22ndAve,08/17/2017 07:00:00 PM,48,-122,6,9,15
30380,58thStGreenway22ndAve,08/17/2017 08:00:00 PM,48,-122,4,4,8
30381,58thStGreenway22ndAve,08/17/2017 09:00:00 PM,48,-122,0,0,0
30382,58thStGreenway22ndAve,08/17/2017 10:00:00 PM,48,-122,1,2,3
30383,58thStGreenway22ndAve,08/17/2017 11:00:00 PM,48,-122,1,0,1
30384,58thStGreenway22ndAve,08/18/2017 12:00:00 AM,48,-122,0,0,0
30385,58thStGreenway22ndAve,08/18/2017 01:00:00 AM,48,-122,0,0,0
30386,58thStGreenway22ndAve,08/18/2017 02:00:00 AM,48,-122,0,0,0
30387,58thStGreenway22ndAve,08/18/2017 03:00:00 AM,48,-122,0,0,0
30388,58thStGreenway22ndAve,08/18/2017 04:00:00 AM,48,-122,0,2,2
30389,58thStGreenway22ndAve,08/18/2017 05:00:00 AM,48,-122,0,0,0
30390,58thStGreenway22ndAve,08/18/2017 06:00:00 AM,48,-122,3,2,5
30391,58thStGreenway22ndAve,08/18/2017 07:00:00 AM,48,-122,1,6,7
30392,58thStGreenway22ndAve,08/18/2017 08:00:00 AM,48,-122,6,5,11
30393,58thStGreenway22ndAve,08/18/2017 09:00:00 AM,48,-122,10,3,13
30394,58thStGreenway22ndAve,08/18/2017 10:00:00 AM,48,-122,2,0,2
30395,58thStGreenway22ndAve,08/18/2017 11:00:00 AM,48,-122,10,5,15
30396,58thStGreenway22ndAve,08/18/2017 12:00:00 PM,48,-122,3,6,9
30397,58thStGreenway22ndAve,08/18/2017 01:00:00 PM,48,-122,4,6,10
30398,58thStGreenway22ndAve,08/18/2017 02:00:00 PM,48,-122,5,6,11
30399,58thStGreenway22ndAve,08/18/2017 03:00:00 PM,48,-122,4,8,12
30400,58thStGreenway22ndAve,08/18/2017 04:00:00 PM,48,-122,10,7,17
30401,58thStGreenway22ndAve,08/18/2017 05:00:00 PM,48,-122,17,1,18
30402,58thStGreenway22ndAve,08/18/2017 06:00:00 PM,48,-122,9,8,17
30403,58thStGreenway22ndAve,08/18/2017 07:00:00 PM,48,-122,4,4,8
30404,58thStGreenway22ndAve,08/18/2017 08:00:00 PM,48,-122,2,4,6
30405,58thStGreenway22ndAve,08/18/2017 09:00:00 PM,48,-122,3,3,6
30406,58thStGreenway22ndAve,08/18/2017 10:00:00 PM,48,-122,2,0,2
30407,58thStGreenway22ndAve,08/18/2017 11:00:00 PM,48,-122,1,1,2
30408,58thStGreenway22ndAve,08/19/2017 12:00:00 AM,48,-122,0,1,1
30409,58thStGreenway22ndAve,08/19/2017 01:00:00 AM,48,-122,0,0,0
30410,58thStGreenway22ndAve,08/19/2017 02:00:00 AM,48,-122,0,0,0
30411,58thStGreenway22ndAve,08/19/2017 03:00:00 AM,48,-122,0,0,0
30412,58thStGreenway22ndAve,08/19/2017 04:00:00 AM,48,-122,0,0,0
30413,58thStGreenway22ndAve,08/19/2017 05:00:00 AM,48,-122,0,0,0
30414,58thStGreenway22ndAve,08/19/2017 06:00:00 AM,48,-122,3,0,3
30415,58thStGreenway22ndAve,08/19/2017 07:00:00 AM,48,-122,2,2,4
30416,58thStGreenway22ndAve,08/19/2017 08:00:00 AM,48,-122,4,0,4
30417,58thStGreenway22ndAve,08/19/2017 09:00:00 AM,48,-122,7,5,12
30418,58thStGreenway22ndAve,08/19/2017 10:00:00 AM,48,-122,9,4,13
30419,58thStGreenway22ndAve,08/19/2017 11:00:00 AM,48,-122,8,8,16
30420,58thStGreenway22ndAve,08/19/2017 12:00:00 PM,48,-122,13,8,21
30421,58thStGreenway22ndAve,08/19/2017 01:00:00 PM,48,-122,0,0,0
30422,58thStGreenway22ndAve,08/19/2017 02:00:00 PM,48,-122,0,0,0
30423,58thStGreenway22ndAve,08/19/2017 03:00:00 PM,48,-122,0,0,0
30424,58thStGreenway22ndAve,08/19/2017 04:00:00 PM,48,-122,0,0,0
30425,58thStGreenway22ndAve,08/19/2017 05:00:00 PM,48,-122,0,0,0
30426,58thStGreenway22ndAve,08/19/2017 06:00:00 PM,48,-122,5,4,9
30427,58thStGreenway22ndAve,08/19/2017 07:00:00 PM,48,-122,8,3,11
30428,58thStGreenway22ndAve,08/19/2017 08:00:00 PM,48,-122,6,4,10
30429,58thStGreenway22ndAve,08/19/2017 09:00:00 PM,48,-122,2,1,3
30430,58thStGreenway22ndAve,08/19/2017 10:00:00 PM,48,-122,0,1,1
30431,58thStGreenway22ndAve,08/19/2017 11:00:00 PM,48,-122,0,0,0
30432,58thStGreenway22ndAve,08/20/2017 12:00:00 AM,48,-122,2,0,2
30433,58thStGreenway22ndAve,08/20/2017 01:00:00 AM,48,-122,0,2,2
30434,58thStGreenway22ndAve,08/20/2017 02:00:00 AM,48,-122,0,0,0
30435,58thStGreenway22ndAve,08/20/2017 03:00:00 AM,48,-122,1,0,1
30436,58thStGreenway22ndAve,08/20/2017 04:00:00 AM,48,-122,0,0,0
30437,58thStGreenway22ndAve,08/20/2017 05:00:00 AM,48,-122,0,0,0
30438,58thStGreenway22ndAve,08/20/2017 06:00:00 AM,48,-122,1,0,1
30439,58thStGreenway22ndAve,08/20/2017 07:00:00 AM,48,-122,3,1,4
30440,58thStGreenway22ndAve,08/20/2017 08:00:00 AM,48,-122,0,1,1
30441,58thStGreenway22ndAve,08/20/2017 09:00:00 AM,48,-122,2,3,5
30442,58thStGreenway22ndAve,08/20/2017 10:00:00 AM,48,-122,7,4,11
30443,58thStGreenway22ndAve,08/20/2017 11:00:00 AM,48,-122,7,8,15
30444,58thStGreenway22ndAve,08/20/2017 12:00:00 PM,48,-122,6,8,14
30445,58thStGreenway22ndAve,08/20/2017 01:00:00 PM,48,-122,11,6,17
30446,58thStGreenway22ndAve,08/20/2017 02:00:00 PM,48,-122,14,6,20
30447,58thStGreenway22ndAve,08/20/2017 03:00:00 PM,48,-122,9,11,20
30448,58thStGreenway22ndAve,08/20/2017 04:00:00 PM,48,-122,13,7,20
30449,58thStGreenway22ndAve,08/20/2017 05:00:00 PM,48,-122,9,11,20
30450,58thStGreenway22ndAve,08/20/2017 06:00:00 PM,48,-122,2,6,8
30451,58thStGreenway22ndAve,08/20/2017 07:00:00 PM,48,-122,2,2,4
30452,58thStGreenway22ndAve,08/20/2017 08:00:00 PM,48,-122,0,1,1
30453,58thStGreenway22ndAve,08/20/2017 09:00:00 PM,48,-122,5,0,5
30454,58thStGreenway22ndAve,08/20/2017 10:00:00 PM,48,-122,2,2,4
30455,58thStGreenway22ndAve,08/20/2017 11:00:00 PM,48,-122,1,2,3
30456,58thStGreenway22ndAve,08/21/2017 12:00:00 AM,48,-122,0,0,0
30457,58thStGreenway22ndAve,08/21/2017 01:00:00 AM,48,-122,0,0,0
30458,58thStGreenway22ndAve,08/21/2017 02:00:00 AM,48,-122,0,0,0
30459,58thStGreenway22ndAve,08/21/2017 03:00:00 AM,48,-122,0,0,0
30460,58thStGreenway22ndAve,08/21/2017 04:00:00 AM,48,-122,0,0,0
30461,58thStGreenway22ndAve,08/21/2017 05:00:00 AM,48,-122,0,0,0
30462,58thStGreenway22ndAve,08/21/2017 06:00:00 AM,48,-122,1,5,6
30463,58thStGreenway22ndAve,08/21/2017 07:00:00 AM,48,-122,6,3,9
30464,58thStGreenway22ndAve,08/21/2017 08:00:00 AM,48,-122,4,7,11
30465,58thStGreenway22ndAve,08/21/2017 09:00:00 AM,48,-122,5,4,9
30466,58thStGreenway22ndAve,08/21/2017 10:00:00 AM,48,-122,5,1,6
30467,58thStGreenway22ndAve,08/21/2017 11:00:00 AM,48,-122,5,3,8
30468,58thStGreenway22ndAve,08/21/2017 12:00:00 PM,48,-122,10,7,17
30469,58thStGreenway22ndAve,08/21/2017 01:00:00 PM,48,-122,6,3,9
30470,58thStGreenway22ndAve,08/21/2017 02:00:00 PM,48,-122,7,6,13
30471,58thStGreenway22ndAve,08/21/2017 03:00:00 PM,48,-122,5,3,8
30472,58thStGreenway22ndAve,08/21/2017 04:00:00 PM,48,-122,9,5,14
30473,58thStGreenway22ndAve,08/21/2017 05:00:00 PM,48,-122,14,7,21
30474,58thStGreenway22ndAve,08/21/2017 06:00:00 PM,48,-122,14,6,20
30475,58thStGreenway22ndAve,08/21/2017 07:00:00 PM,48,-122,5,9,14
30476,58thStGreenway22ndAve,08/21/2017 08:00:00 PM,48,-122,3,2,5
30477,58thStGreenway22ndAve,08/21/2017 09:00:00 PM,48,-122,2,4,6
30478,58thStGreenway22ndAve,08/21/2017 10:00:00 PM,48,-122,1,3,4
30479,58thStGreenway22ndAve,08/21/2017 11:00:00 PM,48,-122,0,1,1
30480,58thStGreenway22ndAve,08/22/2017 12:00:00 AM,48,-122,1,1,2
30481,58thStGreenway22ndAve,08/22/2017 01:00:00 AM,48,-122,0,0,0
30482,58thStGreenway22ndAve,08/22/2017 02:00:00 AM,48,-122,0,1,1
30483,58thStGreenway22ndAve,08/22/2017 03:00:00 AM,48,-122,0,0,0
30484,58thStGreenway22ndAve,08/22/2017 04:00:00 AM,48,-122,0,0,0
30485,58thStGreenway22ndAve,08/22/2017 05:00:00 AM,48,-122,1,0,1
30486,58thStGreenway22ndAve,08/22/2017 06:00:00 AM,48,-122,1,3,4
30487,58thStGreenway22ndAve,08/22/2017 07:00:00 AM,48,-122,3,5,8
30488,58thStGreenway22ndAve,08/22/2017 08:00:00 AM,48,-122,1,7,8
30489,58thStGreenway22ndAve,08/22/2017 09:00:00 AM,48,-122,3,2,5
30490,58thStGreenway22ndAve,08/22/2017 10:00:00 AM,48,-122,7,4,11
30491,58thStGreenway22ndAve,08/22/2017 11:00:00 AM,48,-122,4,4,8
30492,58thStGreenway22ndAve,08/22/2017 12:00:00 PM,48,-122,4,2,6
30493,58thStGreenway22ndAve,08/22/2017 01:00:00 PM,48,-122,5,3,8
30494,58thStGreenway22ndAve,08/22/2017 02:00:00 PM,48,-122,11,6,17
30495,58thStGreenway22ndAve,08/22/2017 03:00:00 PM,48,-122,9,7,16
30496,58thStGreenway22ndAve,08/22/2017 04:00:00 PM,48,-122,18,14,32
30497,58thStGreenway22ndAve,08/22/2017 05:00:00 PM,48,-122,5,7,12
30498,58thStGreenway22ndAve,08/22/2017 06:00:00 PM,48,-122,15,6,21
30499,58thStGreenway22ndAve,08/22/2017 07:00:00 PM,48,-122,12,6,18
30500,58thStGreenway22ndAve,08/22/2017 08:00:00 PM,48,-122,5,10,15
30501,58thStGreenway22ndAve,08/22/2017 09:00:00 PM,48,-122,1,3,4
30502,58thStGreenway22ndAve,08/22/2017 10:00:00 PM,48,-122,0,1,1
30503,58thStGreenway22ndAve,08/22/2017 11:00:00 PM,48,-122,0,0,0
30504,58thStGreenway22ndAve,08/23/2017 12:00:00 AM,48,-122,1,1,2
30505,58thStGreenway22ndAve,08/23/2017 01:00:00 AM,48,-122,0,0,0
30506,58thStGreenway22ndAve,08/23/2017 02:00:00 AM,48,-122,0,0,0
30507,58thStGreenway22ndAve,08/23/2017 03:00:00 AM,48,-122,0,0,0
30508,58thStGreenway22ndAve,08/23/2017 04:00:00 AM,48,-122,0,0,0
30509,58thStGreenway22ndAve,08/23/2017 05:00:00 AM,48,-122,0,0,0
30510,58thStGreenway22ndAve,08/23/2017 06:00:00 AM,48,-122,0,2,2
30511,58thStGreenway22ndAve,08/23/2017 07:00:00 AM,48,-122,1,9,10
30512,58thStGreenway22ndAve,08/23/2017 08:00:00 AM,48,-122,3,8,11
30513,58thStGreenway22ndAve,08/23/2017 09:00:00 AM,48,-122,11,7,18
30514,58thStGreenway22ndAve,08/23/2017 10:00:00 AM,48,-122,6,6,12
30515,58thStGreenway22ndAve,08/23/2017 11:00:00 AM,48,-122,2,6,8
30516,58thStGreenway22ndAve,08/23/2017 12:00:00 PM,48,-122,10,1,11
30517,58thStGreenway22ndAve,08/23/2017 01:00:00 PM,48,-122,3,2,5
30518,58thStGreenway22ndAve,08/23/2017 02:00:00 PM,48,-122,6,5,11
30519,58thStGreenway22ndAve,08/23/2017 03:00:00 PM,48,-122,4,6,10
30520,58thStGreenway22ndAve,08/23/2017 04:00:00 PM,48,-122,7,4,11
30521,58thStGreenway22ndAve,08/23/2017 05:00:00 PM,48,-122,17,8,25
30522,58thStGreenway22ndAve,08/23/2017 06:00:00 PM,48,-122,12,8,20
30523,58thStGreenway22ndAve,08/23/2017 07:00:00 PM,48,-122,9,9,18
30524,58thStGreenway22ndAve,08/23/2017 08:00:00 PM,48,-122,2,8,10
30525,58thStGreenway22ndAve,08/23/2017 09:00:00 PM,48,-122,3,2,5
30526,58thStGreenway22ndAve,08/23/2017 10:00:00 PM,48,-122,0,0,0
30527,58thStGreenway22ndAve,08/23/2017 11:00:00 PM,48,-122,0,3,3
30528,58thStGreenway22ndAve,08/24/2017 12:00:00 AM,48,-122,1,0,1
30529,58thStGreenway22ndAve,08/24/2017 01:00:00 AM,48,-122,0,1,1
30530,58thStGreenway22ndAve,08/24/2017 02:00:00 AM,48,-122,0,1,1
30531,58thStGreenway22ndAve,08/24/2017 03:00:00 AM,48,-122,0,0,0
30532,58thStGreenway22ndAve,08/24/2017 04:00:00 AM,48,-122,0,0,0
30533,58thStGreenway22ndAve,08/24/2017 05:00:00 AM,48,-122,1,1,2
30534,58thStGreenway22ndAve,08/24/2017 06:00:00 AM,48,-122,2,4,6
30535,58thStGreenway22ndAve,08/24/2017 07:00:00 AM,48,-122,9,9,18
30536,58thStGreenway22ndAve,08/24/2017 08:00:00 AM,48,-122,4,7,11
30537,58thStGreenway22ndAve,08/24/2017 09:00:00 AM,48,-122,7,7,14
30538,58thStGreenway22ndAve,08/24/2017 10:00:00 AM,48,-122,1,2,3
30539,58thStGreenway22ndAve,08/24/2017 11:00:00 AM,48,-122,7,2,9
30540,58thStGreenway22ndAve,08/24/2017 12:00:00 PM,48,-122,7,6,13
30541,58thStGreenway22ndAve,08/24/2017 01:00:00 PM,48,-122,6,6,12
30542,58thStGreenway22ndAve,08/24/2017 02:00:00 PM,48,-122,4,6,10
30543,58thStGreenway22ndAve,08/24/2017 03:00:00 PM,48,-122,7,3,10
30544,58thStGreenway22ndAve,08/24/2017 04:00:00 PM,48,-122,13,7,20
30545,58thStGreenway22ndAve,08/24/2017 05:00:00 PM,48,-122,10,10,20
30546,58thStGreenway22ndAve,08/24/2017 06:00:00 PM,48,-122,10,14,24
30547,58thStGreenway22ndAve,08/24/2017 07:00:00 PM,48,-122,3,6,9
30548,58thStGreenway22ndAve,08/24/2017 08:00:00 PM,48,-122,2,6,8
30549,58thStGreenway22ndAve,08/24/2017 09:00:00 PM,48,-122,0,5,5
30550,58thStGreenway22ndAve,08/24/2017 10:00:00 PM,48,-122,1,0,1
30551,58thStGreenway22ndAve,08/24/2017 11:00:00 PM,48,-122,0,0,0
30552,58thStGreenway22ndAve,08/25/2017 12:00:00 AM,48,-122,1,0,1
30553,58thStGreenway22ndAve,08/25/2017 01:00:00 AM,48,-122,1,0,1
30554,58thStGreenway22ndAve,08/25/2017 02:00:00 AM,48,-122,0,0,0
30555,58thStGreenway22ndAve,08/25/2017 03:00:00 AM,48,-122,0,0,0
30556,58thStGreenway22ndAve,08/25/2017 04:00:00 AM,48,-122,1,1,2
30557,58thStGreenway22ndAve,08/25/2017 05:00:00 AM,48,-122,0,0,0
30558,58thStGreenway22ndAve,08/25/2017 06:00:00 AM,48,-122,1,2,3
30559,58thStGreenway22ndAve,08/25/2017 07:00:00 AM,48,-122,3,8,11
30560,58thStGreenway22ndAve,08/25/2017 08:00:00 AM,48,-122,3,7,10
30561,58thStGreenway22ndAve,08/25/2017 09:00:00 AM,48,-122,2,3,5
30562,58thStGreenway22ndAve,08/25/2017 10:00:00 AM,48,-122,8,9,17
30563,58thStGreenway22ndAve,08/25/2017 11:00:00 AM,48,-122,1,5,6
30564,58thStGreenway22ndAve,08/25/2017 12:00:00 PM,48,-122,12,8,20
30565,58thStGreenway22ndAve,08/25/2017 01:00:00 PM,48,-122,4,3,7
30566,58thStGreenway22ndAve,08/25/2017 02:00:00 PM,48,-122,5,10,15
30567,58thStGreenway22ndAve,08/25/2017 03:00:00 PM,48,-122,8,11,19
30568,58thStGreenway22ndAve,08/25/2017 04:00:00 PM,48,-122,3,5,8
30569,58thStGreenway22ndAve,08/25/2017 05:00:00 PM,48,-122,9,15,24
30570,58thStGreenway22ndAve,08/25/2017 06:00:00 PM,48,-122,7,7,14
30571,58thStGreenway22ndAve,08/25/2017 07:00:00 PM,48,-122,3,10,13
30572,58thStGreenway22ndAve,08/25/2017 08:00:00 PM,48,-122,6,4,10
30573,58thStGreenway22ndAve,08/25/2017 09:00:00 PM,48,-122,2,2,4
30574,58thStGreenway22ndAve,08/25/2017 10:00:00 PM,48,-122,2,1,3
30575,58thStGreenway22ndAve,08/25/2017 11:00:00 PM,48,-122,1,1,2
30576,58thStGreenway22ndAve,08/26/2017 12:00:00 AM,48,-122,0,2,2
30577,58thStGreenway22ndAve,08/26/2017 01:00:00 AM,48,-122,0,1,1
30578,58thStGreenway22ndAve,08/26/2017 02:00:00 AM,48,-122,1,0,1
30579,58thStGreenway22ndAve,08/26/2017 03:00:00 AM,48,-122,0,0,0
30580,58thStGreenway22ndAve,08/26/2017 04:00:00 AM,48,-122,0,0,0
30581,58thStGreenway22ndAve,08/26/2017 05:00:00 AM,48,-122,0,0,0
30582,58thStGreenway22ndAve,08/26/2017 06:00:00 AM,48,-122,0,0,0
30583,58thStGreenway22ndAve,08/26/2017 07:00:00 AM,48,-122,1,0,1
30584,58thStGreenway22ndAve,08/26/2017 08:00:00 AM,48,-122,2,4,6
30585,58thStGreenway22ndAve,08/26/2017 09:00:00 AM,48,-122,9,14,23
30586,58thStGreenway22ndAve,08/26/2017 10:00:00 AM,48,-122,4,7,11
30587,58thStGreenway22ndAve,08/26/2017 11:00:00 AM,48,-122,8,9,17
30588,58thStGreenway22ndAve,08/26/2017 12:00:00 PM,48,-122,9,16,25
30589,58thStGreenway22ndAve,08/26/2017 01:00:00 PM,48,-122,15,5,20
30590,58thStGreenway22ndAve,08/26/2017 02:00:00 PM,48,-122,12,8,20
30591,58thStGreenway22ndAve,08/26/2017 03:00:00 PM,48,-122,16,7,23
30592,58thStGreenway22ndAve,08/26/2017 04:00:00 PM,48,-122,15,14,29
30593,58thStGreenway22ndAve,08/26/2017 05:00:00 PM,48,-122,11,7,18
30594,58thStGreenway22ndAve,08/26/2017 06:00:00 PM,48,-122,4,6,10
30595,58thStGreenway22ndAve,08/26/2017 07:00:00 PM,48,-122,2,4,6
30596,58thStGreenway22ndAve,08/26/2017 08:00:00 PM,48,-122,3,7,10
30597,58thStGreenway22ndAve,08/26/2017 09:00:00 PM,48,-122,1,2,3
30598,58thStGreenway22ndAve,08/26/2017 10:00:00 PM,48,-122,3,4,7
30599,58thStGreenway22ndAve,08/26/2017 11:00:00 PM,48,-122,1,1,2
30600,58thStGreenway22ndAve,08/27/2017 12:00:00 AM,48,-122,1,0,1
30601,58thStGreenway22ndAve,08/27/2017 01:00:00 AM,48,-122,1,1,2
30602,58thStGreenway22ndAve,08/27/2017 02:00:00 AM,48,-122,0,1,1
30603,58thStGreenway22ndAve,08/27/2017 03:00:00 AM,48,-122,0,0,0
30604,58thStGreenway22ndAve,08/27/2017 04:00:00 AM,48,-122,0,0,0
30605,58thStGreenway22ndAve,08/27/2017 05:00:00 AM,48,-122,0,0,0
30606,58thStGreenway22ndAve,08/27/2017 06:00:00 AM,48,-122,1,0,1
30607,58thStGreenway22ndAve,08/27/2017 07:00:00 AM,48,-122,1,2,3
30608,58thStGreenway22ndAve,08/27/2017 08:00:00 AM,48,-122,5,1,6
30609,58thStGreenway22ndAve,08/27/2017 09:00:00 AM,48,-122,8,6,14
30610,58thStGreenway22ndAve,08/27/2017 10:00:00 AM,48,-122,11,5,16
30611,58thStGreenway22ndAve,08/27/2017 11:00:00 AM,48,-122,7,17,24
30612,58thStGreenway22ndAve,08/27/2017 12:00:00 PM,48,-122,15,9,24
30613,58thStGreenway22ndAve,08/27/2017 01:00:00 PM,48,-122,15,6,21
30614,58thStGreenway22ndAve,08/27/2017 02:00:00 PM,48,-122,15,10,25
30615,58thStGreenway22ndAve,08/27/2017 03:00:00 PM,48,-122,6,7,13
30616,58thStGreenway22ndAve,08/27/2017 04:00:00 PM,48,-122,12,7,19
30617,58thStGreenway22ndAve,08/27/2017 05:00:00 PM,48,-122,3,4,7
30618,58thStGreenway22ndAve,08/27/2017 06:00:00 PM,48,-122,2,7,9
30619,58thStGreenway22ndAve,08/27/2017 07:00:00 PM,48,-122,7,2,9
30620,58thStGreenway22ndAve,08/27/2017 08:00:00 PM,48,-122,2,4,6
30621,58thStGreenway22ndAve,08/27/2017 09:00:00 PM,48,-122,1,2,3
30622,58thStGreenway22ndAve,08/27/2017 10:00:00 PM,48,-122,1,4,5
30623,58thStGreenway22ndAve,08/27/2017 11:00:00 PM,48,-122,1,0,1
30624,58thStGreenway22ndAve,08/28/2017 12:00:00 AM,48,-122,0,0,0
30625,58thStGreenway22ndAve,08/28/2017 01:00:00 AM,48,-122,0,0,0
30626,58thStGreenway22ndAve,08/28/2017 02:00:00 AM,48,-122,0,0,0
30627,58thStGreenway22ndAve,08/28/2017 03:00:00 AM,48,-122,0,0,0
30628,58thStGreenway22ndAve,08/28/2017 04:00:00 AM,48,-122,0,0,0
30629,58thStGreenway22ndAve,08/28/2017 05:00:00 AM,48,-122,0,0,0
30630,58thStGreenway22ndAve,08/28/2017 06:00:00 AM,48,-122,3,0,3
30631,58thStGreenway22ndAve,08/28/2017 07:00:00 AM,48,-122,6,12,18
30632,58thStGreenway22ndAve,08/28/2017 08:00:00 AM,48,-122,7,5,12
30633,58thStGreenway22ndAve,08/28/2017 09:00:00 AM,48,-122,7,3,10
30634,58thStGreenway22ndAve,08/28/2017 10:00:00 AM,48,-122,3,5,8
30635,58thStGreenway22ndAve,08/28/2017 11:00:00 AM,48,-122,11,2,13
30636,58thStGreenway22ndAve,08/28/2017 12:00:00 PM,48,-122,8,3,11
30637,58thStGreenway22ndAve,08/28/2017 01:00:00 PM,48,-122,5,1,6
30638,58thStGreenway22ndAve,08/28/2017 02:00:00 PM,48,-122,7,6,13
30639,58thStGreenway22ndAve,08/28/2017 03:00:00 PM,48,-122,6,4,10
30640,58thStGreenway22ndAve,08/28/2017 04:00:00 PM,48,-122,7,7,14
30641,58thStGreenway22ndAve,08/28/2017 05:00:00 PM,48,-122,4,10,14
30642,58thStGreenway22ndAve,08/28/2017 06:00:00 PM,48,-122,15,12,27
30643,58thStGreenway22ndAve,08/28/2017 07:00:00 PM,48,-122,8,3,11
30644,58thStGreenway22ndAve,08/28/2017 08:00:00 PM,48,-122,3,6,9
30645,58thStGreenway22ndAve,08/28/2017 09:00:00 PM,48,-122,4,0,4
30646,58thStGreenway22ndAve,08/28/2017 10:00:00 PM,48,-122,0,1,1
30647,58thStGreenway22ndAve,08/28/2017 11:00:00 PM,48,-122,1,1,2
30648,58thStGreenway22ndAve,08/29/2017 12:00:00 AM,48,-122,2,2,4
30649,58thStGreenway22ndAve,08/29/2017 01:00:00 AM,48,-122,0,0,0
30650,58thStGreenway22ndAve,08/29/2017 02:00:00 AM,48,-122,0,0,0
30651,58thStGreenway22ndAve,08/29/2017 03:00:00 AM,48,-122,0,0,0
30652,58thStGreenway22ndAve,08/29/2017 04:00:00 AM,48,-122,0,0,0
30653,58thStGreenway22ndAve,08/29/2017 05:00:00 AM,48,-122,1,1,2
30654,58thStGreenway22ndAve,08/29/2017 06:00:00 AM,48,-122,0,3,3
30655,58thStGreenway22ndAve,08/29/2017 07:00:00 AM,48,-122,2,4,6
30656,58thStGreenway22ndAve,08/29/2017 08:00:00 AM,48,-122,6,8,14
30657,58thStGreenway22ndAve,08/29/2017 09:00:00 AM,48,-122,4,6,10
30658,58thStGreenway22ndAve,08/29/2017 10:00:00 AM,48,-122,4,3,7
30659,58thStGreenway22ndAve,08/29/2017 11:00:00 AM,48,-122,6,5,11
30660,58thStGreenway22ndAve,08/29/2017 12:00:00 PM,48,-122,3,4,7
30661,58thStGreenway22ndAve,08/29/2017 01:00:00 PM,48,-122,6,6,12
30662,58thStGreenway22ndAve,08/29/2017 02:00:00 PM,48,-122,7,2,9
30663,58thStGreenway22ndAve,08/29/2017 03:00:00 PM,48,-122,4,6,10
30664,58thStGreenway22ndAve,08/29/2017 04:00:00 PM,48,-122,6,11,17
30665,58thStGreenway22ndAve,08/29/2017 05:00:00 PM,48,-122,12,9,21
30666,58thStGreenway22ndAve,08/29/2017 06:00:00 PM,48,-122,24,10,34
30667,58thStGreenway22ndAve,08/29/2017 07:00:00 PM,48,-122,9,11,20
30668,58thStGreenway22ndAve,08/29/2017 08:00:00 PM,48,-122,7,11,18
30669,58thStGreenway22ndAve,08/29/2017 09:00:00 PM,48,-122,3,5,8
30670,58thStGreenway22ndAve,08/29/2017 10:00:00 PM,48,-122,4,1,5
30671,58thStGreenway22ndAve,08/29/2017 11:00:00 PM,48,-122,0,3,3
30672,58thStGreenway22ndAve,08/30/2017 12:00:00 AM,48,-122,0,0,0
30673,58thStGreenway22ndAve,08/30/2017 01:00:00 AM,48,-122,0,1,1
30674,58thStGreenway22ndAve,08/30/2017 02:00:00 AM,48,-122,0,0,0
30675,58thStGreenway22ndAve,08/30/2017 03:00:00 AM,48,-122,0,0,0
30676,58thStGreenway22ndAve,08/30/2017 04:00:00 AM,48,-122,0,0,0
30677,58thStGreenway22ndAve,08/30/2017 05:00:00 AM,48,-122,0,0,0
30678,58thStGreenway22ndAve,08/30/2017 06:00:00 AM,48,-122,1,2,3
30679,58thStGreenway22ndAve,08/30/2017 07:00:00 AM,48,-122,4,4,8
30680,58thStGreenway22ndAve,08/30/2017 08:00:00 AM,48,-122,3,4,7
30681,58thStGreenway22ndAve,08/30/2017 09:00:00 AM,48,-122,6,4,10
30682,58thStGreenway22ndAve,08/30/2017 10:00:00 AM,48,-122,8,5,13
30683,58thStGreenway22ndAve,08/30/2017 11:00:00 AM,48,-122,6,4,10
30684,58thStGreenway22ndAve,08/30/2017 12:00:00 PM,48,-122,9,4,13
30685,58thStGreenway22ndAve,08/30/2017 01:00:00 PM,48,-122,3,6,9
30686,58thStGreenway22ndAve,08/30/2017 02:00:00 PM,48,-122,6,3,9
30687,58thStGreenway22ndAve,08/30/2017 03:00:00 PM,48,-122,1,1,2
30688,58thStGreenway22ndAve,08/30/2017 04:00:00 PM,48,-122,3,6,9
30689,58thStGreenway22ndAve,08/30/2017 05:00:00 PM,48,-122,6,9,15
30690,58thStGreenway22ndAve,08/30/2017 06:00:00 PM,48,-122,14,10,24
30691,58thStGreenway22ndAve,08/30/2017 07:00:00 PM,48,-122,12,6,18
30692,58thStGreenway22ndAve,08/30/2017 08:00:00 PM,48,-122,7,8,15
30693,58thStGreenway22ndAve,08/30/2017 09:00:00 PM,48,-122,2,3,5
30694,58thStGreenway22ndAve,08/30/2017 10:00:00 PM,48,-122,0,2,2
30695,58thStGreenway22ndAve,08/30/2017 11:00:00 PM,48,-122,1,3,4
30696,58thStGreenway22ndAve,08/31/2017 12:00:00 AM,48,-122,0,0,0
30697,58thStGreenway22ndAve,08/31/2017 01:00:00 AM,48,-122,0,0,0
30698,58thStGreenway22ndAve,08/31/2017 02:00:00 AM,48,-122,0,0,0
30699,58thStGreenway22ndAve,08/31/2017 03:00:00 AM,48,-122,1,0,1
30700,58thStGreenway22ndAve,08/31/2017 04:00:00 AM,48,-122,0,0,0
30701,58thStGreenway22ndAve,08/31/2017 05:00:00 AM,48,-122,0,0,0
30702,58thStGreenway22ndAve,08/31/2017 06:00:00 AM,48,-122,0,6,6
30703,58thStGreenway22ndAve,08/31/2017 07:00:00 AM,48,-122,3,4,7
30704,58thStGreenway22ndAve,08/31/2017 08:00:00 AM,48,-122,3,2,5
30705,58thStGreenway22ndAve,08/31/2017 09:00:00 AM,48,-122,5,7,12
30706,58thStGreenway22ndAve,08/31/2017 10:00:00 AM,48,-122,3,4,7
30707,58thStGreenway22ndAve,08/31/2017 11:00:00 AM,48,-122,0,0,0
30708,58thStGreenway22ndAve,08/31/2017 12:00:00 PM,48,-122,5,5,10
30709,58thStGreenway22ndAve,08/31/2017 01:00:00 PM,48,-122,3,1,4
30710,58thStGreenway22ndAve,08/31/2017 02:00:00 PM,48,-122,6,8,14
30711,58thStGreenway22ndAve,08/31/2017 03:00:00 PM,48,-122,8,3,11
30712,58thStGreenway22ndAve,08/31/2017 04:00:00 PM,48,-122,9,6,15
30713,58thStGreenway22ndAve,08/31/2017 05:00:00 PM,48,-122,7,9,16
30714,58thStGreenway22ndAve,08/31/2017 06:00:00 PM,48,-122,10,4,14
30715,58thStGreenway22ndAve,08/31/2017 07:00:00 PM,48,-122,2,4,6
30716,58thStGreenway22ndAve,08/31/2017 08:00:00 PM,48,-122,5,4,9
30717,58thStGreenway22ndAve,08/31/2017 09:00:00 PM,48,-122,1,9,10
30718,58thStGreenway22ndAve,08/31/2017 10:00:00 PM,48,-122,3,3,6
30719,58thStGreenway22ndAve,08/31/2017 11:00:00 PM,48,-122,2,2,4
30720,58thStGreenway22ndAve,09/01/2017 12:00:00 AM,48,-122,0,0,0
30721,58thStGreenway22ndAve,09/01/2017 01:00:00 AM,48,-122,0,0,0
30722,58thStGreenway22ndAve,09/01/2017 02:00:00 AM,48,-122,0,2,2
30723,58thStGreenway22ndAve,09/01/2017 03:00:00 AM,48,-122,0,0,0
30724,58thStGreenway22ndAve,09/01/2017 04:00:00 AM,48,-122,1,0,1
30725,58thStGreenway22ndAve,09/01/2017 05:00:00 AM,48,-122,0,0,0
30726,58thStGreenway22ndAve,09/01/2017 06:00:00 AM,48,-122,0,0,0
30727,58thStGreenway22ndAve,09/01/2017 07:00:00 AM,48,-122,2,5,7
30728,58thStGreenway22ndAve,09/01/2017 08:00:00 AM,48,-122,5,3,8
30729,58thStGreenway22ndAve,09/01/2017 09:00:00 AM,48,-122,7,7,14
30730,58thStGreenway22ndAve,09/01/2017 10:00:00 AM,48,-122,3,10,13
30731,58thStGreenway22ndAve,09/01/2017 11:00:00 AM,48,-122,2,4,6
30732,58thStGreenway22ndAve,09/01/2017 12:00:00 PM,48,-122,2,5,7
30733,58thStGreenway22ndAve,09/01/2017 01:00:00 PM,48,-122,14,1,15
30734,58thStGreenway22ndAve,09/01/2017 02:00:00 PM,48,-122,6,5,11
30735,58thStGreenway22ndAve,09/01/2017 03:00:00 PM,48,-122,4,8,12
30736,58thStGreenway22ndAve,09/01/2017 04:00:00 PM,48,-122,5,7,12
30737,58thStGreenway22ndAve,09/01/2017 05:00:00 PM,48,-122,8,5,13
30738,58thStGreenway22ndAve,09/01/2017 06:00:00 PM,48,-122,8,11,19
30739,58thStGreenway22ndAve,09/01/2017 07:00:00 PM,48,-122,14,11,25
30740,58thStGreenway22ndAve,09/01/2017 08:00:00 PM,48,-122,2,5,7
30741,58thStGreenway22ndAve,09/01/2017 09:00:00 PM,48,-122,4,3,7
30742,58thStGreenway22ndAve,09/01/2017 10:00:00 PM,48,-122,1,1,2
30743,58thStGreenway22ndAve,09/01/2017 11:00:00 PM,48,-122,1,3,4
30744,58thStGreenway22ndAve,09/02/2017 12:00:00 AM,48,-122,0,0,0
30745,58thStGreenway22ndAve,09/02/2017 01:00:00 AM,48,-122,0,1,1
30746,58thStGreenway22ndAve,09/02/2017 02:00:00 AM,48,-122,0,0,0
30747,58thStGreenway22ndAve,09/02/2017 03:00:00 AM,48,-122,0,1,1
30748,58thStGreenway22ndAve,09/02/2017 04:00:00 AM,48,-122,0,1,1
30749,58thStGreenway22ndAve,09/02/2017 05:00:00 AM,48,-122,0,1,1
30750,58thStGreenway22ndAve,09/02/2017 06:00:00 AM,48,-122,1,1,2
30751,58thStGreenway22ndAve,09/02/2017 07:00:00 AM,48,-122,0,1,1
30752,58thStGreenway22ndAve,09/02/2017 08:00:00 AM,48,-122,1,1,2
30753,58thStGreenway22ndAve,09/02/2017 09:00:00 AM,48,-122,6,5,11
30754,58thStGreenway22ndAve,09/02/2017 10:00:00 AM,48,-122,8,7,15
30755,58thStGreenway22ndAve,09/02/2017 11:00:00 AM,48,-122,9,8,17
30756,58thStGreenway22ndAve,09/02/2017 12:00:00 PM,48,-122,4,12,16
30757,58thStGreenway22ndAve,09/02/2017 01:00:00 PM,48,-122,14,5,19
30758,58thStGreenway22ndAve,09/02/2017 02:00:00 PM,48,-122,6,7,13
30759,58thStGreenway22ndAve,09/02/2017 03:00:00 PM,48,-122,7,7,14
30760,58thStGreenway22ndAve,09/02/2017 04:00:00 PM,48,-122,13,10,23
30761,58thStGreenway22ndAve,09/02/2017 05:00:00 PM,48,-122,6,6,12
30762,58thStGreenway22ndAve,09/02/2017 06:00:00 PM,48,-122,13,8,21
30763,58thStGreenway22ndAve,09/02/2017 07:00:00 PM,48,-122,4,5,9
30764,58thStGreenway22ndAve,09/02/2017 08:00:00 PM,48,-122,0,9,9
30765,58thStGreenway22ndAve,09/02/2017 09:00:00 PM,48,-122,2,2,4
30766,58thStGreenway22ndAve,09/02/2017 10:00:00 PM,48,-122,0,1,1
30767,58thStGreenway22ndAve,09/02/2017 11:00:00 PM,48,-122,2,3,5
30768,58thStGreenway22ndAve,09/03/2017 12:00:00 AM,48,-122,1,2,3
30769,58thStGreenway22ndAve,09/03/2017 01:00:00 AM,48,-122,0,1,1
30770,58thStGreenway22ndAve,09/03/2017 02:00:00 AM,48,-122,0,0,0
30771,58thStGreenway22ndAve,09/03/2017 03:00:00 AM,48,-122,0,2,2
30772,58thStGreenway22ndAve,09/03/2017 04:00:00 AM,48,-122,0,0,0
30773,58thStGreenway22ndAve,09/03/2017 05:00:00 AM,48,-122,0,0,0
30774,58thStGreenway22ndAve,09/03/2017 06:00:00 AM,48,-122,0,1,1
30775,58thStGreenway22ndAve,09/03/2017 07:00:00 AM,48,-122,2,0,2
30776,58thStGreenway22ndAve,09/03/2017 08:00:00 AM,48,-122,0,2,2
30777,58thStGreenway22ndAve,09/03/2017 09:00:00 AM,48,-122,0,5,5
30778,58thStGreenway22ndAve,09/03/2017 10:00:00 AM,48,-122,1,3,4
30779,58thStGreenway22ndAve,09/03/2017 11:00:00 AM,48,-122,6,14,20
30780,58thStGreenway22ndAve,09/03/2017 12:00:00 PM,48,-122,7,15,22
30781,58thStGreenway22ndAve,09/03/2017 01:00:00 PM,48,-122,11,11,22
30782,58thStGreenway22ndAve,09/03/2017 02:00:00 PM,48,-122,8,10,18
30783,58thStGreenway22ndAve,09/03/2017 03:00:00 PM,48,-122,4,4,8
30784,58thStGreenway22ndAve,09/03/2017 04:00:00 PM,48,-122,3,8,11
30785,58thStGreenway22ndAve,09/03/2017 05:00:00 PM,48,-122,8,6,14
30786,58thStGreenway22ndAve,09/03/2017 06:00:00 PM,48,-122,5,5,10
30787,58thStGreenway22ndAve,09/03/2017 07:00:00 PM,48,-122,7,6,13
30788,58thStGreenway22ndAve,09/03/2017 08:00:00 PM,48,-122,1,8,9
30789,58thStGreenway22ndAve,09/03/2017 09:00:00 PM,48,-122,0,5,5
30790,58thStGreenway22ndAve,09/03/2017 10:00:00 PM,48,-122,2,1,3
30791,58thStGreenway22ndAve,09/03/2017 11:00:00 PM,48,-122,4,0,4
30792,58thStGreenway22ndAve,09/04/2017 12:00:00 AM,48,-122,1,0,1
30793,58thStGreenway22ndAve,09/04/2017 01:00:00 AM,48,-122,0,1,1
30794,58thStGreenway22ndAve,09/04/2017 02:00:00 AM,48,-122,1,0,1
30795,58thStGreenway22ndAve,09/04/2017 03:00:00 AM,48,-122,0,0,0
30796,58thStGreenway22ndAve,09/04/2017 04:00:00 AM,48,-122,0,0,0
30797,58thStGreenway22ndAve,09/04/2017 05:00:00 AM,48,-122,0,0,0
30798,58thStGreenway22ndAve,09/04/2017 06:00:00 AM,48,-122,2,1,3
30799,58thStGreenway22ndAve,09/04/2017 07:00:00 AM,48,-122,4,2,6
30800,58thStGreenway22ndAve,09/04/2017 08:00:00 AM,48,-122,2,2,4
30801,58thStGreenway22ndAve,09/04/2017 09:00:00 AM,48,-122,6,2,8
30802,58thStGreenway22ndAve,09/04/2017 10:00:00 AM,48,-122,7,7,14
30803,58thStGreenway22ndAve,09/04/2017 11:00:00 AM,48,-122,5,6,11
30804,58thStGreenway22ndAve,09/04/2017 12:00:00 PM,48,-122,2,9,11
30805,58thStGreenway22ndAve,09/04/2017 01:00:00 PM,48,-122,3,5,8
30806,58thStGreenway22ndAve,09/04/2017 02:00:00 PM,48,-122,0,2,2
30807,58thStGreenway22ndAve,09/04/2017 03:00:00 PM,48,-122,11,13,24
30808,58thStGreenway22ndAve,09/04/2017 04:00:00 PM,48,-122,7,10,17
30809,58thStGreenway22ndAve,09/04/2017 05:00:00 PM,48,-122,10,9,19
30810,58thStGreenway22ndAve,09/04/2017 06:00:00 PM,48,-122,2,8,10
30811,58thStGreenway22ndAve,09/04/2017 07:00:00 PM,48,-122,2,8,10
30812,58thStGreenway22ndAve,09/04/2017 08:00:00 PM,48,-122,1,4,5
30813,58thStGreenway22ndAve,09/04/2017 09:00:00 PM,48,-122,3,2,5
30814,58thStGreenway22ndAve,09/04/2017 10:00:00 PM,48,-122,1,1,2
30815,58thStGreenway22ndAve,09/04/2017 11:00:00 PM,48,-122,0,1,1
30816,58thStGreenway22ndAve,09/05/2017 12:00:00 AM,48,-122,0,0,0
30817,58thStGreenway22ndAve,09/05/2017 01:00:00 AM,48,-122,0,0,0
30818,58thStGreenway22ndAve,09/05/2017 02:00:00 AM,48,-122,0,0,0
30819,58thStGreenway22ndAve,09/05/2017 03:00:00 AM,48,-122,0,0,0
30820,58thStGreenway22ndAve,09/05/2017 04:00:00 AM,48,-122,1,0,1
30821,58thStGreenway22ndAve,09/05/2017 05:00:00 AM,48,-122,0,0,0
30822,58thStGreenway22ndAve,09/05/2017 06:00:00 AM,48,-122,0,2,2
30823,58thStGreenway22ndAve,09/05/2017 07:00:00 AM,48,-122,3,7,10
30824,58thStGreenway22ndAve,09/05/2017 08:00:00 AM,48,-122,1,2,3
30825,58thStGreenway22ndAve,09/05/2017 09:00:00 AM,48,-122,0,3,3
30826,58thStGreenway22ndAve,09/05/2017 10:00:00 AM,48,-122,3,4,7
30827,58thStGreenway22ndAve,09/05/2017 11:00:00 AM,48,-122,5,4,9
30828,58thStGreenway22ndAve,09/05/2017 12:00:00 PM,48,-122,3,6,9
30829,58thStGreenway22ndAve,09/05/2017 01:00:00 PM,48,-122,4,4,8
30830,58thStGreenway22ndAve,09/05/2017 02:00:00 PM,48,-122,3,6,9
30831,58thStGreenway22ndAve,09/05/2017 03:00:00 PM,48,-122,2,3,5
30832,58thStGreenway22ndAve,09/05/2017 04:00:00 PM,48,-122,3,7,10
30833,58thStGreenway22ndAve,09/05/2017 05:00:00 PM,48,-122,14,4,18
30834,58thStGreenway22ndAve,09/05/2017 06:00:00 PM,48,-122,9,7,16
30835,58thStGreenway22ndAve,09/05/2017 07:00:00 PM,48,-122,13,4,17
30836,58thStGreenway22ndAve,09/05/2017 08:00:00 PM,48,-122,4,4,8
30837,58thStGreenway22ndAve,09/05/2017 09:00:00 PM,48,-122,3,5,8
30838,58thStGreenway22ndAve,09/05/2017 10:00:00 PM,48,-122,0,2,2
30839,58thStGreenway22ndAve,09/05/2017 11:00:00 PM,48,-122,0,0,0
30840,58thStGreenway22ndAve,09/06/2017 12:00:00 AM,48,-122,2,0,2
30841,58thStGreenway22ndAve,09/06/2017 01:00:00 AM,48,-122,0,0,0
30842,58thStGreenway22ndAve,09/06/2017 02:00:00 AM,48,-122,0,0,0
30843,58thStGreenway22ndAve,09/06/2017 03:00:00 AM,48,-122,0,0,0
30844,58thStGreenway22ndAve,09/06/2017 04:00:00 AM,48,-122,1,0,1
30845,58thStGreenway22ndAve,09/06/2017 05:00:00 AM,48,-122,0,1,1
30846,58thStGreenway22ndAve,09/06/2017 06:00:00 AM,48,-122,5,0,5
30847,58thStGreenway22ndAve,09/06/2017 07:00:00 AM,48,-122,1,7,8
30848,58thStGreenway22ndAve,09/06/2017 08:00:00 AM,48,-122,9,6,15
30849,58thStGreenway22ndAve,09/06/2017 09:00:00 AM,48,-122,1,5,6
30850,58thStGreenway22ndAve,09/06/2017 10:00:00 AM,48,-122,3,7,10
30851,58thStGreenway22ndAve,09/06/2017 11:00:00 AM,48,-122,5,3,8
30852,58thStGreenway22ndAve,09/06/2017 12:00:00 PM,48,-122,3,1,4
30853,58thStGreenway22ndAve,09/06/2017 01:00:00 PM,48,-122,9,3,12
30854,58thStGreenway22ndAve,09/06/2017 02:00:00 PM,48,-122,4,7,11
30855,58thStGreenway22ndAve,09/06/2017 03:00:00 PM,48,-122,5,4,9
30856,58thStGreenway22ndAve,09/06/2017 04:00:00 PM,48,-122,4,3,7
30857,58thStGreenway22ndAve,09/06/2017 05:00:00 PM,48,-122,6,13,19
30858,58thStGreenway22ndAve,09/06/2017 06:00:00 PM,48,-122,11,9,20
30859,58thStGreenway22ndAve,09/06/2017 07:00:00 PM,48,-122,6,5,11
30860,58thStGreenway22ndAve,09/06/2017 08:00:00 PM,48,-122,4,4,8
30861,58thStGreenway22ndAve,09/06/2017 09:00:00 PM,48,-122,1,2,3
30862,58thStGreenway22ndAve,09/06/2017 10:00:00 PM,48,-122,0,0,0
30863,58thStGreenway22ndAve,09/06/2017 11:00:00 PM,48,-122,0,1,1
30864,58thStGreenway22ndAve,09/07/2017 12:00:00 AM,48,-122,1,0,1
30865,58thStGreenway22ndAve,09/07/2017 01:00:00 AM,48,-122,1,1,2
30866,58thStGreenway22ndAve,09/07/2017 02:00:00 AM,48,-122,0,0,0
30867,58thStGreenway22ndAve,09/07/2017 03:00:00 AM,48,-122,0,0,0
30868,58thStGreenway22ndAve,09/07/2017 04:00:00 AM,48,-122,0,0,0
30869,58thStGreenway22ndAve,09/07/2017 05:00:00 AM,48,-122,0,0,0
30870,58thStGreenway22ndAve,09/07/2017 06:00:00 AM,48,-122,0,2,2
30871,58thStGreenway22ndAve,09/07/2017 07:00:00 AM,48,-122,1,2,3
30872,58thStGreenway22ndAve,09/07/2017 08:00:00 AM,48,-122,0,4,4
30873,58thStGreenway22ndAve,09/07/2017 09:00:00 AM,48,-122,2,6,8
30874,58thStGreenway22ndAve,09/07/2017 10:00:00 AM,48,-122,3,1,4
30875,58thStGreenway22ndAve,09/07/2017 11:00:00 AM,48,-122,2,5,7
30876,58thStGreenway22ndAve,09/07/2017 12:00:00 PM,48,-122,3,1,4
30877,58thStGreenway22ndAve,09/07/2017 01:00:00 PM,48,-122,7,6,13
30878,58thStGreenway22ndAve,09/07/2017 02:00:00 PM,48,-122,4,3,7
30879,58thStGreenway22ndAve,09/07/2017 03:00:00 PM,48,-122,6,3,9
30880,58thStGreenway22ndAve,09/07/2017 04:00:00 PM,48,-122,5,5,10
30881,58thStGreenway22ndAve,09/07/2017 05:00:00 PM,48,-122,5,7,12
30882,58thStGreenway22ndAve,09/07/2017 06:00:00 PM,48,-122,10,6,16
30883,58thStGreenway22ndAve,09/07/2017 07:00:00 PM,48,-122,8,5,13
30884,58thStGreenway22ndAve,09/07/2017 08:00:00 PM,48,-122,5,3,8
30885,58thStGreenway22ndAve,09/07/2017 09:00:00 PM,48,-122,3,0,3
30886,58thStGreenway22ndAve,09/07/2017 10:00:00 PM,48,-122,1,2,3
30887,58thStGreenway22ndAve,09/07/2017 11:00:00 PM,48,-122,0,1,1
30888,58thStGreenway22ndAve,09/08/2017 12:00:00 AM,48,-122,0,0,0
30889,58thStGreenway22ndAve,09/08/2017 01:00:00 AM,48,-122,0,0,0
30890,58thStGreenway22ndAve,09/08/2017 02:00:00 AM,48,-122,0,0,0
30891,58thStGreenway22ndAve,09/08/2017 03:00:00 AM,48,-122,0,0,0
30892,58thStGreenway22ndAve,09/08/2017 04:00:00 AM,48,-122,0,1,1
30893,58thStGreenway22ndAve,09/08/2017 05:00:00 AM,48,-122,0,0,0
30894,58thStGreenway22ndAve,09/08/2017 06:00:00 AM,48,-122,4,1,5
30895,58thStGreenway22ndAve,09/08/2017 07:00:00 AM,48,-122,4,6,10
30896,58thStGreenway22ndAve,09/08/2017 08:00:00 AM,48,-122,2,7,9
30897,58thStGreenway22ndAve,09/08/2017 09:00:00 AM,48,-122,9,4,13
30898,58thStGreenway22ndAve,09/08/2017 10:00:00 AM,48,-122,3,5,8
30899,58thStGreenway22ndAve,09/08/2017 11:00:00 AM,48,-122,3,7,10
30900,58thStGreenway22ndAve,09/08/2017 12:00:00 PM,48,-122,8,4,12
30901,58thStGreenway22ndAve,09/08/2017 01:00:00 PM,48,-122,8,4,12
30902,58thStGreenway22ndAve,09/08/2017 02:00:00 PM,48,-122,7,2,9
30903,58thStGreenway22ndAve,09/08/2017 03:00:00 PM,48,-122,2,10,12
30904,58thStGreenway22ndAve,09/08/2017 04:00:00 PM,48,-122,4,6,10
30905,58thStGreenway22ndAve,09/08/2017 05:00:00 PM,48,-122,12,11,23
30906,58thStGreenway22ndAve,09/08/2017 06:00:00 PM,48,-122,11,7,18
30907,58thStGreenway22ndAve,09/08/2017 07:00:00 PM,48,-122,6,9,15
30908,58thStGreenway22ndAve,09/08/2017 08:00:00 PM,48,-122,6,5,11
30909,58thStGreenway22ndAve,09/08/2017 09:00:00 PM,48,-122,1,2,3
30910,58thStGreenway22ndAve,09/08/2017 10:00:00 PM,48,-122,2,2,4
30911,58thStGreenway22ndAve,09/08/2017 11:00:00 PM,48,-122,0,2,2
30912,58thStGreenway22ndAve,09/09/2017 12:00:00 AM,48,-122,0,0,0
30913,58thStGreenway22ndAve,09/09/2017 01:00:00 AM,48,-122,0,0,0
30914,58thStGreenway22ndAve,09/09/2017 02:00:00 AM,48,-122,0,1,1
30915,58thStGreenway22ndAve,09/09/2017 03:00:00 AM,48,-122,0,0,0
30916,58thStGreenway22ndAve,09/09/2017 04:00:00 AM,48,-122,0,0,0
30917,58thStGreenway22ndAve,09/09/2017 05:00:00 AM,48,-122,0,0,0
30918,58thStGreenway22ndAve,09/09/2017 06:00:00 AM,48,-122,0,1,1
30919,58thStGreenway22ndAve,09/09/2017 07:00:00 AM,48,-122,0,2,2
30920,58thStGreenway22ndAve,09/09/2017 08:00:00 AM,48,-122,3,1,4
30921,58thStGreenway22ndAve,09/09/2017 09:00:00 AM,48,-122,5,3,8
30922,58thStGreenway22ndAve,09/09/2017 10:00:00 AM,48,-122,5,2,7
30923,58thStGreenway22ndAve,09/09/2017 11:00:00 AM,48,-122,9,11,20
30924,58thStGreenway22ndAve,09/09/2017 12:00:00 PM,48,-122,8,8,16
30925,58thStGreenway22ndAve,09/09/2017 01:00:00 PM,48,-122,3,7,10
30926,58thStGreenway22ndAve,09/09/2017 02:00:00 PM,48,-122,5,6,11
30927,58thStGreenway22ndAve,09/09/2017 03:00:00 PM,48,-122,2,7,9
30928,58thStGreenway22ndAve,09/09/2017 04:00:00 PM,48,-122,4,14,18
30929,58thStGreenway22ndAve,09/09/2017 05:00:00 PM,48,-122,2,2,4
30930,58thStGreenway22ndAve,09/09/2017 06:00:00 PM,48,-122,1,2,3
30931,58thStGreenway22ndAve,09/09/2017 07:00:00 PM,48,-122,0,6,6
30932,58thStGreenway22ndAve,09/09/2017 08:00:00 PM,48,-122,0,7,7
30933,58thStGreenway22ndAve,09/09/2017 09:00:00 PM,48,-122,1,2,3
30934,58thStGreenway22ndAve,09/09/2017 10:00:00 PM,48,-122,1,1,2
30935,58thStGreenway22ndAve,09/09/2017 11:00:00 PM,48,-122,1,4,5
30936,58thStGreenway22ndAve,09/10/2017 12:00:00 AM,48,-122,1,3,4
30937,58thStGreenway22ndAve,09/10/2017 01:00:00 AM,48,-122,0,0,0
30938,58thStGreenway22ndAve,09/10/2017 02:00:00 AM,48,-122,0,0,0
30939,58thStGreenway22ndAve,09/10/2017 03:00:00 AM,48,-122,0,0,0
30940,58thStGreenway22ndAve,09/10/2017 04:00:00 AM,48,-122,0,0,0
30941,58thStGreenway22ndAve,09/10/2017 05:00:00 AM,48,-122,0,0,0
30942,58thStGreenway22ndAve,09/10/2017 06:00:00 AM,48,-122,0,0,0
30943,58thStGreenway22ndAve,09/10/2017 07:00:00 AM,48,-122,1,0,1
30944,58thStGreenway22ndAve,09/10/2017 08:00:00 AM,48,-122,2,0,2
30945,58thStGreenway22ndAve,09/10/2017 09:00:00 AM,48,-122,4,2,6
30946,58thStGreenway22ndAve,09/10/2017 10:00:00 AM,48,-122,1,7,8
30947,58thStGreenway22ndAve,09/10/2017 11:00:00 AM,48,-122,0,4,4
30948,58thStGreenway22ndAve,09/10/2017 12:00:00 PM,48,-122,5,5,10
30949,58thStGreenway22ndAve,09/10/2017 01:00:00 PM,48,-122,3,6,9
30950,58thStGreenway22ndAve,09/10/2017 02:00:00 PM,48,-122,3,8,11
30951,58thStGreenway22ndAve,09/10/2017 03:00:00 PM,48,-122,4,13,17
30952,58thStGreenway22ndAve,09/10/2017 04:00:00 PM,48,-122,4,3,7
30953,58thStGreenway22ndAve,09/10/2017 05:00:00 PM,48,-122,11,3,14
30954,58thStGreenway22ndAve,09/10/2017 06:00:00 PM,48,-122,5,9,14
30955,58thStGreenway22ndAve,09/10/2017 07:00:00 PM,48,-122,5,6,11
30956,58thStGreenway22ndAve,09/10/2017 08:00:00 PM,48,-122,5,5,10
30957,58thStGreenway22ndAve,09/10/2017 09:00:00 PM,48,-122,0,0,0
30958,58thStGreenway22ndAve,09/10/2017 10:00:00 PM,48,-122,0,0,0
30959,58thStGreenway22ndAve,09/10/2017 11:00:00 PM,48,-122,1,2,3
30960,58thStGreenway22ndAve,09/11/2017 12:00:00 AM,48,-122,0,0,0
30961,58thStGreenway22ndAve,09/11/2017 01:00:00 AM,48,-122,1,0,1
30962,58thStGreenway22ndAve,09/11/2017 02:00:00 AM,48,-122,0,0,0
30963,58thStGreenway22ndAve,09/11/2017 03:00:00 AM,48,-122,0,0,0
30964,58thStGreenway22ndAve,09/11/2017 04:00:00 AM,48,-122,0,0,0
30965,58thStGreenway22ndAve,09/11/2017 05:00:00 AM,48,-122,0,0,0
30966,58thStGreenway22ndAve,09/11/2017 06:00:00 AM,48,-122,2,1,3
30967,58thStGreenway22ndAve,09/11/2017 07:00:00 AM,48,-122,5,6,11
30968,58thStGreenway22ndAve,09/11/2017 08:00:00 AM,48,-122,5,11,16
30969,58thStGreenway22ndAve,09/11/2017 09:00:00 AM,48,-122,1,3,4
30970,58thStGreenway22ndAve,09/11/2017 10:00:00 AM,48,-122,0,6,6
30971,58thStGreenway22ndAve,09/11/2017 11:00:00 AM,48,-122,2,5,7
30972,58thStGreenway22ndAve,09/11/2017 12:00:00 PM,48,-122,5,7,12
30973,58thStGreenway22ndAve,09/11/2017 01:00:00 PM,48,-122,4,5,9
30974,58thStGreenway22ndAve,09/11/2017 02:00:00 PM,48,-122,4,7,11
30975,58thStGreenway22ndAve,09/11/2017 03:00:00 PM,48,-122,12,9,21
30976,58thStGreenway22ndAve,09/11/2017 04:00:00 PM,48,-122,7,6,13
30977,58thStGreenway22ndAve,09/11/2017 05:00:00 PM,48,-122,2,7,9
30978,58thStGreenway22ndAve,09/11/2017 06:00:00 PM,48,-122,13,4,17
30979,58thStGreenway22ndAve,09/11/2017 07:00:00 PM,48,-122,9,3,12
30980,58thStGreenway22ndAve,09/11/2017 08:00:00 PM,48,-122,3,10,13
30981,58thStGreenway22ndAve,09/11/2017 09:00:00 PM,48,-122,1,2,3
30982,58thStGreenway22ndAve,09/11/2017 10:00:00 PM,48,-122,2,2,4
30983,58thStGreenway22ndAve,09/11/2017 11:00:00 PM,48,-122,0,0,0
30984,58thStGreenway22ndAve,09/12/2017 12:00:00 AM,48,-122,0,0,0
30985,58thStGreenway22ndAve,09/12/2017 01:00:00 AM,48,-122,0,0,0
30986,58thStGreenway22ndAve,09/12/2017 02:00:00 AM,48,-122,1,0,1
30987,58thStGreenway22ndAve,09/12/2017 03:00:00 AM,48,-122,1,0,1
30988,58thStGreenway22ndAve,09/12/2017 04:00:00 AM,48,-122,0,1,1
30989,58thStGreenway22ndAve,09/12/2017 05:00:00 AM,48,-122,0,1,1
30990,58thStGreenway22ndAve,09/12/2017 06:00:00 AM,48,-122,0,2,2
30991,58thStGreenway22ndAve,09/12/2017 07:00:00 AM,48,-122,4,11,15
30992,58thStGreenway22ndAve,09/12/2017 08:00:00 AM,48,-122,11,6,17
30993,58thStGreenway22ndAve,09/12/2017 09:00:00 AM,48,-122,4,5,9
30994,58thStGreenway22ndAve,09/12/2017 10:00:00 AM,48,-122,2,3,5
30995,58thStGreenway22ndAve,09/12/2017 11:00:00 AM,48,-122,8,8,16
30996,58thStGreenway22ndAve,09/12/2017 12:00:00 PM,48,-122,9,6,15
30997,58thStGreenway22ndAve,09/12/2017 01:00:00 PM,48,-122,5,4,9
30998,58thStGreenway22ndAve,09/12/2017 02:00:00 PM,48,-122,7,2,9
30999,58thStGreenway22ndAve,09/12/2017 03:00:00 PM,48,-122,14,9,23
31000,58thStGreenway22ndAve,09/12/2017 04:00:00 PM,48,-122,11,8,19
31001,58thStGreenway22ndAve,09/12/2017 05:00:00 PM,48,-122,16,9,25
31002,58thStGreenway22ndAve,09/12/2017 06:00:00 PM,48,-122,12,15,27
31003,58thStGreenway22ndAve,09/12/2017 07:00:00 PM,48,-122,12,4,16
31004,58thStGreenway22ndAve,09/12/2017 08:00:00 PM,48,-122,5,5,10
31005,58thStGreenway22ndAve,09/12/2017 09:00:00 PM,48,-122,2,3,5
31006,58thStGreenway22ndAve,09/12/2017 10:00:00 PM,48,-122,0,3,3
31007,58thStGreenway22ndAve,09/12/2017 11:00:00 PM,48,-122,1,2,3
31008,58thStGreenway22ndAve,09/13/2017 12:00:00 AM,48,-122,0,0,0
31009,58thStGreenway22ndAve,09/13/2017 01:00:00 AM,48,-122,0,0,0
31010,58thStGreenway22ndAve,09/13/2017 02:00:00 AM,48,-122,0,0,0
31011,58thStGreenway22ndAve,09/13/2017 03:00:00 AM,48,-122,0,0,0
31012,58thStGreenway22ndAve,09/13/2017 04:00:00 AM,48,-122,0,1,1
31013,58thStGreenway22ndAve,09/13/2017 05:00:00 AM,48,-122,0,0,0
31014,58thStGreenway22ndAve,09/13/2017 06:00:00 AM,48,-122,0,1,1
31015,58thStGreenway22ndAve,09/13/2017 07:00:00 AM,48,-122,2,7,9
31016,58thStGreenway22ndAve,09/13/2017 08:00:00 AM,48,-122,7,17,24
31017,58thStGreenway22ndAve,09/13/2017 09:00:00 AM,48,-122,5,11,16
31018,58thStGreenway22ndAve,09/13/2017 10:00:00 AM,48,-122,4,4,8
31019,58thStGreenway22ndAve,09/13/2017 11:00:00 AM,48,-122,8,3,11
31020,58thStGreenway22ndAve,09/13/2017 12:00:00 PM,48,-122,2,4,6
31021,58thStGreenway22ndAve,09/13/2017 01:00:00 PM,48,-122,6,4,10
31022,58thStGreenway22ndAve,09/13/2017 02:00:00 PM,48,-122,4,2,6
31023,58thStGreenway22ndAve,09/13/2017 03:00:00 PM,48,-122,6,5,11
31024,58thStGreenway22ndAve,09/13/2017 04:00:00 PM,48,-122,4,5,9
31025,58thStGreenway22ndAve,09/13/2017 05:00:00 PM,48,-122,14,7,21
31026,58thStGreenway22ndAve,09/13/2017 06:00:00 PM,48,-122,13,13,26
31027,58thStGreenway22ndAve,09/13/2017 07:00:00 PM,48,-122,3,8,11
31028,58thStGreenway22ndAve,09/13/2017 08:00:00 PM,48,-122,2,2,4
31029,58thStGreenway22ndAve,09/13/2017 09:00:00 PM,48,-122,0,0,0
31030,58thStGreenway22ndAve,09/13/2017 10:00:00 PM,48,-122,1,1,2
31031,58thStGreenway22ndAve,09/13/2017 11:00:00 PM,48,-122,0,0,0
31032,58thStGreenway22ndAve,09/14/2017 12:00:00 AM,48,-122,2,0,2
31033,58thStGreenway22ndAve,09/14/2017 01:00:00 AM,48,-122,1,0,1
31034,58thStGreenway22ndAve,09/14/2017 02:00:00 AM,48,-122,0,0,0
31035,58thStGreenway22ndAve,09/14/2017 03:00:00 AM,48,-122,0,0,0
31036,58thStGreenway22ndAve,09/14/2017 04:00:00 AM,48,-122,0,0,0
31037,58thStGreenway22ndAve,09/14/2017 05:00:00 AM,48,-122,0,2,2
31038,58thStGreenway22ndAve,09/14/2017 06:00:00 AM,48,-122,0,5,5
31039,58thStGreenway22ndAve,09/14/2017 07:00:00 AM,48,-122,1,4,5
31040,58thStGreenway22ndAve,09/14/2017 08:00:00 AM,48,-122,1,7,8
31041,58thStGreenway22ndAve,09/14/2017 09:00:00 AM,48,-122,5,2,7
31042,58thStGreenway22ndAve,09/14/2017 10:00:00 AM,48,-122,6,3,9
31043,58thStGreenway22ndAve,09/14/2017 11:00:00 AM,48,-122,5,2,7
31044,58thStGreenway22ndAve,09/14/2017 12:00:00 PM,48,-122,6,3,9
31045,58thStGreenway22ndAve,09/14/2017 01:00:00 PM,48,-122,3,4,7
31046,58thStGreenway22ndAve,09/14/2017 02:00:00 PM,48,-122,2,11,13
31047,58thStGreenway22ndAve,09/14/2017 03:00:00 PM,48,-122,7,6,13
31048,58thStGreenway22ndAve,09/14/2017 04:00:00 PM,48,-122,9,11,20
31049,58thStGreenway22ndAve,09/14/2017 05:00:00 PM,48,-122,9,8,17
31050,58thStGreenway22ndAve,09/14/2017 06:00:00 PM,48,-122,15,8,23
31051,58thStGreenway22ndAve,09/14/2017 07:00:00 PM,48,-122,5,6,11
31052,58thStGreenway22ndAve,09/14/2017 08:00:00 PM,48,-122,3,5,8
31053,58thStGreenway22ndAve,09/14/2017 09:00:00 PM,48,-122,7,3,10
31054,58thStGreenway22ndAve,09/14/2017 10:00:00 PM,48,-122,0,0,0
31055,58thStGreenway22ndAve,09/14/2017 11:00:00 PM,48,-122,0,0,0
31056,58thStGreenway22ndAve,09/15/2017 12:00:00 AM,48,-122,0,0,0
31057,58thStGreenway22ndAve,09/15/2017 01:00:00 AM,48,-122,0,0,0
31058,58thStGreenway22ndAve,09/15/2017 02:00:00 AM,48,-122,0,2,2
31059,58thStGreenway22ndAve,09/15/2017 03:00:00 AM,48,-122,0,1,1
31060,58thStGreenway22ndAve,09/15/2017 04:00:00 AM,48,-122,0,0,0
31061,58thStGreenway22ndAve,09/15/2017 05:00:00 AM,48,-122,0,1,1
31062,58thStGreenway22ndAve,09/15/2017 06:00:00 AM,48,-122,2,3,5
31063,58thStGreenway22ndAve,09/15/2017 07:00:00 AM,48,-122,2,5,7
31064,58thStGreenway22ndAve,09/15/2017 08:00:00 AM,48,-122,5,6,11
31065,58thStGreenway22ndAve,09/15/2017 09:00:00 AM,48,-122,7,5,12
31066,58thStGreenway22ndAve,09/15/2017 10:00:00 AM,48,-122,11,11,22
31067,58thStGreenway22ndAve,09/15/2017 11:00:00 AM,48,-122,1,1,2
31068,58thStGreenway22ndAve,09/15/2017 12:00:00 PM,48,-122,1,1,2
31069,58thStGreenway22ndAve,09/15/2017 01:00:00 PM,48,-122,1,4,5
31070,58thStGreenway22ndAve,09/15/2017 02:00:00 PM,48,-122,2,9,11
31071,58thStGreenway22ndAve,09/15/2017 03:00:00 PM,48,-122,10,8,18
31072,58thStGreenway22ndAve,09/15/2017 04:00:00 PM,48,-122,8,9,17
31073,58thStGreenway22ndAve,09/15/2017 05:00:00 PM,48,-122,9,9,18
31074,58thStGreenway22ndAve,09/15/2017 06:00:00 PM,48,-122,13,10,23
31075,58thStGreenway22ndAve,09/15/2017 07:00:00 PM,48,-122,9,14,23
31076,58thStGreenway22ndAve,09/15/2017 08:00:00 PM,48,-122,5,5,10
31077,58thStGreenway22ndAve,09/15/2017 09:00:00 PM,48,-122,1,2,3
31078,58thStGreenway22ndAve,09/15/2017 10:00:00 PM,48,-122,0,6,6
31079,58thStGreenway22ndAve,09/15/2017 11:00:00 PM,48,-122,1,4,5
31080,58thStGreenway22ndAve,09/16/2017 12:00:00 AM,48,-122,0,5,5
31081,58thStGreenway22ndAve,09/16/2017 01:00:00 AM,48,-122,0,2,2
31082,58thStGreenway22ndAve,09/16/2017 02:00:00 AM,48,-122,0,0,0
31083,58thStGreenway22ndAve,09/16/2017 03:00:00 AM,48,-122,0,0,0
31084,58thStGreenway22ndAve,09/16/2017 04:00:00 AM,48,-122,0,1,1
31085,58thStGreenway22ndAve,09/16/2017 05:00:00 AM,48,-122,0,0,0
31086,58thStGreenway22ndAve,09/16/2017 06:00:00 AM,48,-122,0,0,0
31087,58thStGreenway22ndAve,09/16/2017 07:00:00 AM,48,-122,0,2,2
31088,58thStGreenway22ndAve,09/16/2017 08:00:00 AM,48,-122,4,3,7
31089,58thStGreenway22ndAve,09/16/2017 09:00:00 AM,48,-122,9,7,16
31090,58thStGreenway22ndAve,09/16/2017 10:00:00 AM,48,-122,1,8,9
31091,58thStGreenway22ndAve,09/16/2017 11:00:00 AM,48,-122,0,11,11
31092,58thStGreenway22ndAve,09/16/2017 12:00:00 PM,48,-122,1,7,8
31093,58thStGreenway22ndAve,09/16/2017 01:00:00 PM,48,-122,0,5,5
31094,58thStGreenway22ndAve,09/16/2017 02:00:00 PM,48,-122,3,8,11
31095,58thStGreenway22ndAve,09/16/2017 03:00:00 PM,48,-122,1,3,4
31096,58thStGreenway22ndAve,09/16/2017 04:00:00 PM,48,-122,1,5,6
31097,58thStGreenway22ndAve,09/16/2017 05:00:00 PM,48,-122,8,9,17
31098,58thStGreenway22ndAve,09/16/2017 06:00:00 PM,48,-122,3,4,7
31099,58thStGreenway22ndAve,09/16/2017 07:00:00 PM,48,-122,2,8,10
31100,58thStGreenway22ndAve,09/16/2017 08:00:00 PM,48,-122,2,0,2
31101,58thStGreenway22ndAve,09/16/2017 09:00:00 PM,48,-122,0,7,7
31102,58thStGreenway22ndAve,09/16/2017 10:00:00 PM,48,-122,0,2,2
31103,58thStGreenway22ndAve,09/16/2017 11:00:00 PM,48,-122,1,0,1
31104,58thStGreenway22ndAve,09/17/2017 12:00:00 AM,48,-122,0,1,1
31105,58thStGreenway22ndAve,09/17/2017 01:00:00 AM,48,-122,1,0,1
31106,58thStGreenway22ndAve,09/17/2017 02:00:00 AM,48,-122,0,0,0
31107,58thStGreenway22ndAve,09/17/2017 03:00:00 AM,48,-122,0,1,1
31108,58thStGreenway22ndAve,09/17/2017 04:00:00 AM,48,-122,1,0,1
31109,58thStGreenway22ndAve,09/17/2017 05:00:00 AM,48,-122,1,1,2
31110,58thStGreenway22ndAve,09/17/2017 06:00:00 AM,48,-122,0,1,1
31111,58thStGreenway22ndAve,09/17/2017 07:00:00 AM,48,-122,0,1,1
31112,58thStGreenway22ndAve,09/17/2017 08:00:00 AM,48,-122,1,3,4
31113,58thStGreenway22ndAve,09/17/2017 09:00:00 AM,48,-122,5,4,9
31114,58thStGreenway22ndAve,09/17/2017 10:00:00 AM,48,-122,2,5,7
31115,58thStGreenway22ndAve,09/17/2017 11:00:00 AM,48,-122,1,4,5
31116,58thStGreenway22ndAve,09/17/2017 12:00:00 PM,48,-122,4,11,15
31117,58thStGreenway22ndAve,09/17/2017 01:00:00 PM,48,-122,2,4,6
31118,58thStGreenway22ndAve,09/17/2017 02:00:00 PM,48,-122,0,1,1
31119,58thStGreenway22ndAve,09/17/2017 03:00:00 PM,48,-122,0,3,3
31120,58thStGreenway22ndAve,09/17/2017 04:00:00 PM,48,-122,0,2,2
31121,58thStGreenway22ndAve,09/17/2017 05:00:00 PM,48,-122,2,7,9
31122,58thStGreenway22ndAve,09/17/2017 06:00:00 PM,48,-122,2,3,5
31123,58thStGreenway22ndAve,09/17/2017 07:00:00 PM,48,-122,0,1,1
31124,58thStGreenway22ndAve,09/17/2017 08:00:00 PM,48,-122,0,1,1
31125,58thStGreenway22ndAve,09/17/2017 09:00:00 PM,48,-122,0,1,1
31126,58thStGreenway22ndAve,09/17/2017 10:00:00 PM,48,-122,0,1,1
31127,58thStGreenway22ndAve,09/17/2017 11:00:00 PM,48,-122,1,2,3
31128,58thStGreenway22ndAve,09/18/2017 12:00:00 AM,48,-122,0,0,0
31129,58thStGreenway22ndAve,09/18/2017 01:00:00 AM,48,-122,0,0,0
31130,58thStGreenway22ndAve,09/18/2017 02:00:00 AM,48,-122,0,0,0
31131,58thStGreenway22ndAve,09/18/2017 03:00:00 AM,48,-122,0,0,0
31132,58thStGreenway22ndAve,09/18/2017 04:00:00 AM,48,-122,0,0,0
31133,58thStGreenway22ndAve,09/18/2017 05:00:00 AM,48,-122,1,1,2
31134,58thStGreenway22ndAve,09/18/2017 06:00:00 AM,48,-122,0,2,2
31135,58thStGreenway22ndAve,09/18/2017 07:00:00 AM,48,-122,0,3,3
31136,58thStGreenway22ndAve,09/18/2017 08:00:00 AM,48,-122,1,3,4
31137,58thStGreenway22ndAve,09/18/2017 09:00:00 AM,48,-122,0,4,4
31138,58thStGreenway22ndAve,09/18/2017 10:00:00 AM,48,-122,0,2,2
31139,58thStGreenway22ndAve,09/18/2017 11:00:00 AM,48,-122,2,6,8
31140,58thStGreenway22ndAve,09/18/2017 12:00:00 PM,48,-122,2,0,2
31141,58thStGreenway22ndAve,09/18/2017 01:00:00 PM,48,-122,0,7,7
31142,58thStGreenway22ndAve,09/18/2017 02:00:00 PM,48,-122,3,9,12
31143,58thStGreenway22ndAve,09/18/2017 03:00:00 PM,48,-122,3,3,6
31144,58thStGreenway22ndAve,09/18/2017 04:00:00 PM,48,-122,1,7,8
31145,58thStGreenway22ndAve,09/18/2017 05:00:00 PM,48,-122,6,4,10
31146,58thStGreenway22ndAve,09/18/2017 06:00:00 PM,48,-122,3,7,10
31147,58thStGreenway22ndAve,09/18/2017 07:00:00 PM,48,-122,5,1,6
31148,58thStGreenway22ndAve,09/18/2017 08:00:00 PM,48,-122,1,1,2
31149,58thStGreenway22ndAve,09/18/2017 09:00:00 PM,48,-122,1,1,2
31150,58thStGreenway22ndAve,09/18/2017 10:00:00 PM,48,-122,0,2,2
31151,58thStGreenway22ndAve,09/18/2017 11:00:00 PM,48,-122,0,1,1
31152,58thStGreenway22ndAve,09/19/2017 12:00:00 AM,48,-122,0,1,1
31153,58thStGreenway22ndAve,09/19/2017 01:00:00 AM,48,-122,0,0,0
31154,58thStGreenway22ndAve,09/19/2017 02:00:00 AM,48,-122,0,0,0
31155,58thStGreenway22ndAve,09/19/2017 03:00:00 AM,48,-122,0,0,0
31156,58thStGreenway22ndAve,09/19/2017 04:00:00 AM,48,-122,0,0,0
31157,58thStGreenway22ndAve,09/19/2017 05:00:00 AM,48,-122,0,0,0
31158,58thStGreenway22ndAve,09/19/2017 06:00:00 AM,48,-122,0,2,2
31159,58thStGreenway22ndAve,09/19/2017 07:00:00 AM,48,-122,0,1,1
31160,58thStGreenway22ndAve,09/19/2017 08:00:00 AM,48,-122,0,7,7
31161,58thStGreenway22ndAve,09/19/2017 09:00:00 AM,48,-122,3,3,6
31162,58thStGreenway22ndAve,09/19/2017 10:00:00 AM,48,-122,3,1,4
31163,58thStGreenway22ndAve,09/19/2017 11:00:00 AM,48,-122,2,1,3
31164,58thStGreenway22ndAve,09/19/2017 12:00:00 PM,48,-122,4,1,5
31165,58thStGreenway22ndAve,09/19/2017 01:00:00 PM,48,-122,1,2,3
31166,58thStGreenway22ndAve,09/19/2017 02:00:00 PM,48,-122,3,3,6
31167,58thStGreenway22ndAve,09/19/2017 03:00:00 PM,48,-122,4,4,8
31168,58thStGreenway22ndAve,09/19/2017 04:00:00 PM,48,-122,1,1,2
31169,58thStGreenway22ndAve,09/19/2017 05:00:00 PM,48,-122,1,2,3
31170,58thStGreenway22ndAve,09/19/2017 06:00:00 PM,48,-122,2,7,9
31171,58thStGreenway22ndAve,09/19/2017 07:00:00 PM,48,-122,2,11,13
31172,58thStGreenway22ndAve,09/19/2017 08:00:00 PM,48,-122,0,7,7
31173,58thStGreenway22ndAve,09/19/2017 09:00:00 PM,48,-122,0,2,2
31174,58thStGreenway22ndAve,09/19/2017 10:00:00 PM,48,-122,0,1,1
31175,58thStGreenway22ndAve,09/19/2017 11:00:00 PM,48,-122,0,0,0
31176,58thStGreenway22ndAve,09/20/2017 12:00:00 AM,48,-122,0,0,0
31177,58thStGreenway22ndAve,09/20/2017 01:00:00 AM,48,-122,0,0,0
31178,58thStGreenway22ndAve,09/20/2017 02:00:00 AM,48,-122,0,2,2
31179,58thStGreenway22ndAve,09/20/2017 03:00:00 AM,48,-122,0,0,0
31180,58thStGreenway22ndAve,09/20/2017 04:00:00 AM,48,-122,0,0,0
31181,58thStGreenway22ndAve,09/20/2017 05:00:00 AM,48,-122,0,0,0
31182,58thStGreenway22ndAve,09/20/2017 06:00:00 AM,48,-122,0,2,2
31183,58thStGreenway22ndAve,09/20/2017 07:00:00 AM,48,-122,2,5,7
31184,58thStGreenway22ndAve,09/20/2017 08:00:00 AM,48,-122,0,9,9
31185,58thStGreenway22ndAve,09/20/2017 09:00:00 AM,48,-122,0,3,3
31186,58thStGreenway22ndAve,09/20/2017 10:00:00 AM,48,-122,3,5,8
31187,58thStGreenway22ndAve,09/20/2017 11:00:00 AM,48,-122,1,5,6
31188,58thStGreenway22ndAve,09/20/2017 12:00:00 PM,48,-122,1,8,9
31189,58thStGreenway22ndAve,09/20/2017 01:00:00 PM,48,-122,1,8,9
31190,58thStGreenway22ndAve,09/20/2017 02:00:00 PM,48,-122,2,3,5
31191,58thStGreenway22ndAve,09/20/2017 03:00:00 PM,48,-122,5,5,10
31192,58thStGreenway22ndAve,09/20/2017 04:00:00 PM,48,-122,9,5,14
31193,58thStGreenway22ndAve,09/20/2017 05:00:00 PM,48,-122,12,7,19
31194,58thStGreenway22ndAve,09/20/2017 06:00:00 PM,48,-122,10,19,29
31195,58thStGreenway22ndAve,09/20/2017 07:00:00 PM,48,-122,6,14,20
31196,58thStGreenway22ndAve,09/20/2017 08:00:00 PM,48,-122,4,8,12
31197,58thStGreenway22ndAve,09/20/2017 09:00:00 PM,48,-122,0,1,1
31198,58thStGreenway22ndAve,09/20/2017 10:00:00 PM,48,-122,0,0,0
31199,58thStGreenway22ndAve,09/20/2017 11:00:00 PM,48,-122,0,1,1
31200,58thStGreenway22ndAve,09/21/2017 12:00:00 AM,48,-122,1,0,1
31201,58thStGreenway22ndAve,09/21/2017 01:00:00 AM,48,-122,0,0,0
31202,58thStGreenway22ndAve,09/21/2017 02:00:00 AM,48,-122,0,0,0
31203,58thStGreenway22ndAve,09/21/2017 03:00:00 AM,48,-122,0,0,0
31204,58thStGreenway22ndAve,09/21/2017 04:00:00 AM,48,-122,0,0,0
31205,58thStGreenway22ndAve,09/21/2017 05:00:00 AM,48,-122,1,0,1
31206,58thStGreenway22ndAve,09/21/2017 06:00:00 AM,48,-122,1,5,6
31207,58thStGreenway22ndAve,09/21/2017 07:00:00 AM,48,-122,1,7,8
31208,58thStGreenway22ndAve,09/21/2017 08:00:00 AM,48,-122,4,4,8
31209,58thStGreenway22ndAve,09/21/2017 09:00:00 AM,48,-122,5,5,10
31210,58thStGreenway22ndAve,09/21/2017 10:00:00 AM,48,-122,1,2,3
31211,58thStGreenway22ndAve,09/21/2017 11:00:00 AM,48,-122,4,4,8
31212,58thStGreenway22ndAve,09/21/2017 12:00:00 PM,48,-122,1,3,4
31213,58thStGreenway22ndAve,09/21/2017 01:00:00 PM,48,-122,0,2,2
31214,58thStGreenway22ndAve,09/21/2017 02:00:00 PM,48,-122,1,5,6
31215,58thStGreenway22ndAve,09/21/2017 03:00:00 PM,48,-122,6,6,12
31216,58thStGreenway22ndAve,09/21/2017 04:00:00 PM,48,-122,5,3,8
31217,58thStGreenway22ndAve,09/21/2017 05:00:00 PM,48,-122,10,13,23
31218,58thStGreenway22ndAve,09/21/2017 06:00:00 PM,48,-122,9,6,15
31219,58thStGreenway22ndAve,09/21/2017 07:00:00 PM,48,-122,3,7,10
31220,58thStGreenway22ndAve,09/21/2017 08:00:00 PM,48,-122,5,3,8
31221,58thStGreenway22ndAve,09/21/2017 09:00:00 PM,48,-122,1,1,2
31222,58thStGreenway22ndAve,09/21/2017 10:00:00 PM,48,-122,1,0,1
31223,58thStGreenway22ndAve,09/21/2017 11:00:00 PM,48,-122,2,1,3
31224,58thStGreenway22ndAve,09/22/2017 12:00:00 AM,48,-122,1,2,3
31225,58thStGreenway22ndAve,09/22/2017 01:00:00 AM,48,-122,0,0,0
31226,58thStGreenway22ndAve,09/22/2017 02:00:00 AM,48,-122,0,0,0
31227,58thStGreenway22ndAve,09/22/2017 03:00:00 AM,48,-122,0,1,1
31228,58thStGreenway22ndAve,09/22/2017 04:00:00 AM,48,-122,1,0,1
31229,58thStGreenway22ndAve,09/22/2017 05:00:00 AM,48,-122,0,1,1
31230,58thStGreenway22ndAve,09/22/2017 06:00:00 AM,48,-122,2,1,3
31231,58thStGreenway22ndAve,09/22/2017 07:00:00 AM,48,-122,2,4,6
31232,58thStGreenway22ndAve,09/22/2017 08:00:00 AM,48,-122,5,6,11
31233,58thStGreenway22ndAve,09/22/2017 09:00:00 AM,48,-122,5,3,8
31234,58thStGreenway22ndAve,09/22/2017 10:00:00 AM,48,-122,7,5,12
31235,58thStGreenway22ndAve,09/22/2017 11:00:00 AM,48,-122,8,6,14
31236,58thStGreenway22ndAve,09/22/2017 12:00:00 PM,48,-122,7,5,12
31237,58thStGreenway22ndAve,09/22/2017 01:00:00 PM,48,-122,12,5,17
31238,58thStGreenway22ndAve,09/22/2017 02:00:00 PM,48,-122,11,6,17
31239,58thStGreenway22ndAve,09/22/2017 03:00:00 PM,48,-122,3,8,11
31240,58thStGreenway22ndAve,09/22/2017 04:00:00 PM,48,-122,4,4,8
31241,58thStGreenway22ndAve,09/22/2017 05:00:00 PM,48,-122,13,7,20
31242,58thStGreenway22ndAve,09/22/2017 06:00:00 PM,48,-122,12,2,14
31243,58thStGreenway22ndAve,09/22/2017 07:00:00 PM,48,-122,5,3,8
31244,58thStGreenway22ndAve,09/22/2017 08:00:00 PM,48,-122,1,3,4
31245,58thStGreenway22ndAve,09/22/2017 09:00:00 PM,48,-122,1,2,3
31246,58thStGreenway22ndAve,09/22/2017 10:00:00 PM,48,-122,0,1,1
31247,58thStGreenway22ndAve,09/22/2017 11:00:00 PM,48,-122,0,1,1
31248,58thStGreenway22ndAve,09/23/2017 12:00:00 AM,48,-122,1,0,1
31249,58thStGreenway22ndAve,09/23/2017 01:00:00 AM,48,-122,3,2,5
31250,58thStGreenway22ndAve,09/23/2017 02:00:00 AM,48,-122,0,1,1
31251,58thStGreenway22ndAve,09/23/2017 03:00:00 AM,48,-122,0,0,0
31252,58thStGreenway22ndAve,09/23/2017 04:00:00 AM,48,-122,0,1,1
31253,58thStGreenway22ndAve,09/23/2017 05:00:00 AM,48,-122,0,0,0
31254,58thStGreenway22ndAve,09/23/2017 06:00:00 AM,48,-122,0,1,1
31255,58thStGreenway22ndAve,09/23/2017 07:00:00 AM,48,-122,2,0,2
31256,58thStGreenway22ndAve,09/23/2017 08:00:00 AM,48,-122,3,6,9
31257,58thStGreenway22ndAve,09/23/2017 09:00:00 AM,48,-122,5,2,7
31258,58thStGreenway22ndAve,09/23/2017 10:00:00 AM,48,-122,7,2,9
31259,58thStGreenway22ndAve,09/23/2017 11:00:00 AM,48,-122,12,7,19
31260,58thStGreenway22ndAve,09/23/2017 12:00:00 PM,48,-122,11,7,18
31261,58thStGreenway22ndAve,09/23/2017 01:00:00 PM,48,-122,10,7,17
31262,58thStGreenway22ndAve,09/23/2017 02:00:00 PM,48,-122,6,2,8
31263,58thStGreenway22ndAve,09/23/2017 03:00:00 PM,48,-122,4,8,12
31264,58thStGreenway22ndAve,09/23/2017 04:00:00 PM,48,-122,6,6,12
31265,58thStGreenway22ndAve,09/23/2017 05:00:00 PM,48,-122,12,8,20
31266,58thStGreenway22ndAve,09/23/2017 06:00:00 PM,48,-122,9,3,12
31267,58thStGreenway22ndAve,09/23/2017 07:00:00 PM,48,-122,1,2,3
31268,58thStGreenway22ndAve,09/23/2017 08:00:00 PM,48,-122,3,4,7
31269,58thStGreenway22ndAve,09/23/2017 09:00:00 PM,48,-122,1,2,3
31270,58thStGreenway22ndAve,09/23/2017 10:00:00 PM,48,-122,0,0,0
31271,58thStGreenway22ndAve,09/23/2017 11:00:00 PM,48,-122,2,0,2
31272,58thStGreenway22ndAve,09/24/2017 12:00:00 AM,48,-122,0,1,1
31273,58thStGreenway22ndAve,09/24/2017 01:00:00 AM,48,-122,2,0,2
31274,58thStGreenway22ndAve,09/24/2017 02:00:00 AM,48,-122,1,0,1
31275,58thStGreenway22ndAve,09/24/2017 03:00:00 AM,48,-122,0,0,0
31276,58thStGreenway22ndAve,09/24/2017 04:00:00 AM,48,-122,0,0,0
31277,58thStGreenway22ndAve,09/24/2017 05:00:00 AM,48,-122,0,2,2
31278,58thStGreenway22ndAve,09/24/2017 06:00:00 AM,48,-122,0,0,0
31279,58thStGreenway22ndAve,09/24/2017 07:00:00 AM,48,-122,3,1,4
31280,58thStGreenway22ndAve,09/24/2017 08:00:00 AM,48,-122,4,3,7
31281,58thStGreenway22ndAve,09/24/2017 09:00:00 AM,48,-122,7,6,13
31282,58thStGreenway22ndAve,09/24/2017 10:00:00 AM,48,-122,8,2,10
31283,58thStGreenway22ndAve,09/24/2017 11:00:00 AM,48,-122,4,2,6
31284,58thStGreenway22ndAve,09/24/2017 12:00:00 PM,48,-122,0,0,0
31285,58thStGreenway22ndAve,09/24/2017 01:00:00 PM,48,-122,0,0,0
31286,58thStGreenway22ndAve,09/24/2017 02:00:00 PM,48,-122,0,0,0
31287,58thStGreenway22ndAve,09/24/2017 03:00:00 PM,48,-122,0,0,0
31288,58thStGreenway22ndAve,09/24/2017 04:00:00 PM,48,-122,0,0,0
31289,58thStGreenway22ndAve,09/24/2017 05:00:00 PM,48,-122,0,0,0
31290,58thStGreenway22ndAve,09/24/2017 06:00:00 PM,48,-122,0,0,0
31291,58thStGreenway22ndAve,09/24/2017 07:00:00 PM,48,-122,0,0,0
31292,58thStGreenway22ndAve,09/24/2017 08:00:00 PM,48,-122,0,0,0
31293,58thStGreenway22ndAve,09/24/2017 09:00:00 PM,48,-122,0,0,0
31294,58thStGreenway22ndAve,09/24/2017 10:00:00 PM,48,-122,0,0,0
31295,58thStGreenway22ndAve,09/24/2017 11:00:00 PM,48,-122,0,0,0
31296,58thStGreenway22ndAve,09/25/2017 12:00:00 AM,48,-122,0,0,0
31297,58thStGreenway22ndAve,09/25/2017 01:00:00 AM,48,-122,0,0,0
31298,58thStGreenway22ndAve,09/25/2017 02:00:00 AM,48,-122,0,0,0
31299,58thStGreenway22ndAve,09/25/2017 03:00:00 AM,48,-122,0,0,0
31300,58thStGreenway22ndAve,09/25/2017 04:00:00 AM,48,-122,0,0,0
31301,58thStGreenway22ndAve,09/25/2017 05:00:00 AM,48,-122,0,0,0
31302,58thStGreenway22ndAve,09/25/2017 06:00:00 AM,48,-122,0,0,0
31303,58thStGreenway22ndAve,09/25/2017 07:00:00 AM,48,-122,2,2,4
31304,58thStGreenway22ndAve,09/25/2017 08:00:00 AM,48,-122,5,5,10
31305,58thStGreenway22ndAve,09/25/2017 09:00:00 AM,48,-122,7,2,9
31306,58thStGreenway22ndAve,09/25/2017 10:00:00 AM,48,-122,4,4,8
31307,58thStGreenway22ndAve,09/25/2017 11:00:00 AM,48,-122,1,4,5
31308,58thStGreenway22ndAve,09/25/2017 12:00:00 PM,48,-122,2,3,5
31309,58thStGreenway22ndAve,09/25/2017 01:00:00 PM,48,-122,10,3,13
31310,58thStGreenway22ndAve,09/25/2017 02:00:00 PM,48,-122,8,4,12
31311,58thStGreenway22ndAve,09/25/2017 03:00:00 PM,48,-122,8,2,10
31312,58thStGreenway22ndAve,09/25/2017 04:00:00 PM,48,-122,8,10,18
31313,58thStGreenway22ndAve,09/25/2017 05:00:00 PM,48,-122,7,8,15
31314,58thStGreenway22ndAve,09/25/2017 06:00:00 PM,48,-122,6,7,13
31315,58thStGreenway22ndAve,09/25/2017 07:00:00 PM,48,-122,2,5,7
31316,58thStGreenway22ndAve,09/25/2017 08:00:00 PM,48,-122,2,1,3
31317,58thStGreenway22ndAve,09/25/2017 09:00:00 PM,48,-122,1,0,1
31318,58thStGreenway22ndAve,09/25/2017 10:00:00 PM,48,-122,0,2,2
31319,58thStGreenway22ndAve,09/25/2017 11:00:00 PM,48,-122,0,0,0
31320,58thStGreenway22ndAve,09/26/2017 12:00:00 AM,48,-122,0,1,1
31321,58thStGreenway22ndAve,09/26/2017 01:00:00 AM,48,-122,0,0,0
31322,58thStGreenway22ndAve,09/26/2017 02:00:00 AM,48,-122,0,0,0
31323,58thStGreenway22ndAve,09/26/2017 03:00:00 AM,48,-122,0,0,0
31324,58thStGreenway22ndAve,09/26/2017 04:00:00 AM,48,-122,0,0,0
31325,58thStGreenway22ndAve,09/26/2017 05:00:00 AM,48,-122,0,0,0
31326,58thStGreenway22ndAve,09/26/2017 06:00:00 AM,48,-122,0,1,1
31327,58thStGreenway22ndAve,09/26/2017 07:00:00 AM,48,-122,4,5,9
31328,58thStGreenway22ndAve,09/26/2017 08:00:00 AM,48,-122,9,8,17
31329,58thStGreenway22ndAve,09/26/2017 09:00:00 AM,48,-122,6,3,9
31330,58thStGreenway22ndAve,09/26/2017 10:00:00 AM,48,-122,7,3,10
31331,58thStGreenway22ndAve,09/26/2017 11:00:00 AM,48,-122,2,3,5
31332,58thStGreenway22ndAve,09/26/2017 12:00:00 PM,48,-122,10,3,13
31333,58thStGreenway22ndAve,09/26/2017 01:00:00 PM,48,-122,5,6,11
31334,58thStGreenway22ndAve,09/26/2017 02:00:00 PM,48,-122,3,5,8
31335,58thStGreenway22ndAve,09/26/2017 03:00:00 PM,48,-122,9,5,14
31336,58thStGreenway22ndAve,09/26/2017 04:00:00 PM,48,-122,3,6,9
31337,58thStGreenway22ndAve,09/26/2017 05:00:00 PM,48,-122,10,8,18
31338,58thStGreenway22ndAve,09/26/2017 06:00:00 PM,48,-122,11,9,20
31339,58thStGreenway22ndAve,09/26/2017 07:00:00 PM,48,-122,8,5,13
31340,58thStGreenway22ndAve,09/26/2017 08:00:00 PM,48,-122,3,3,6
31341,58thStGreenway22ndAve,09/26/2017 09:00:00 PM,48,-122,2,4,6
31342,58thStGreenway22ndAve,09/26/2017 10:00:00 PM,48,-122,2,1,3
31343,58thStGreenway22ndAve,09/26/2017 11:00:00 PM,48,-122,2,0,2
31344,58thStGreenway22ndAve,09/27/2017 12:00:00 AM,48,-122,1,0,1
31345,58thStGreenway22ndAve,09/27/2017 01:00:00 AM,48,-122,0,0,0
31346,58thStGreenway22ndAve,09/27/2017 02:00:00 AM,48,-122,0,0,0
31347,58thStGreenway22ndAve,09/27/2017 03:00:00 AM,48,-122,1,0,1
31348,58thStGreenway22ndAve,09/27/2017 04:00:00 AM,48,-122,0,0,0
31349,58thStGreenway22ndAve,09/27/2017 05:00:00 AM,48,-122,1,0,1
31350,58thStGreenway22ndAve,09/27/2017 06:00:00 AM,48,-122,2,2,4
31351,58thStGreenway22ndAve,09/27/2017 07:00:00 AM,48,-122,4,6,10
31352,58thStGreenway22ndAve,09/27/2017 08:00:00 AM,48,-122,7,8,15
31353,58thStGreenway22ndAve,09/27/2017 09:00:00 AM,48,-122,8,4,12
31354,58thStGreenway22ndAve,09/27/2017 10:00:00 AM,48,-122,4,3,7
31355,58thStGreenway22ndAve,09/27/2017 11:00:00 AM,48,-122,8,1,9
31356,58thStGreenway22ndAve,09/27/2017 12:00:00 PM,48,-122,6,6,12
31357,58thStGreenway22ndAve,09/27/2017 01:00:00 PM,48,-122,0,8,8
31358,58thStGreenway22ndAve,09/27/2017 02:00:00 PM,48,-122,5,2,7
31359,58thStGreenway22ndAve,09/27/2017 03:00:00 PM,48,-122,5,8,13
31360,58thStGreenway22ndAve,09/27/2017 04:00:00 PM,48,-122,7,5,12
31361,58thStGreenway22ndAve,09/27/2017 05:00:00 PM,48,-122,13,8,21
31362,58thStGreenway22ndAve,09/27/2017 06:00:00 PM,48,-122,15,11,26
31363,58thStGreenway22ndAve,09/27/2017 07:00:00 PM,48,-122,6,6,12
31364,58thStGreenway22ndAve,09/27/2017 08:00:00 PM,48,-122,2,4,6
31365,58thStGreenway22ndAve,09/27/2017 09:00:00 PM,48,-122,1,1,2
31366,58thStGreenway22ndAve,09/27/2017 10:00:00 PM,48,-122,1,4,5
31367,58thStGreenway22ndAve,09/27/2017 11:00:00 PM,48,-122,2,1,3
31368,58thStGreenway22ndAve,09/28/2017 12:00:00 AM,48,-122,0,0,0
31369,58thStGreenway22ndAve,09/28/2017 01:00:00 AM,48,-122,0,0,0
31370,58thStGreenway22ndAve,09/28/2017 02:00:00 AM,48,-122,1,0,1
31371,58thStGreenway22ndAve,09/28/2017 03:00:00 AM,48,-122,1,0,1
31372,58thStGreenway22ndAve,09/28/2017 04:00:00 AM,48,-122,0,0,0
31373,58thStGreenway22ndAve,09/28/2017 05:00:00 AM,48,-122,0,0,0
31374,58thStGreenway22ndAve,09/28/2017 06:00:00 AM,48,-122,0,2,2
31375,58thStGreenway22ndAve,09/28/2017 07:00:00 AM,48,-122,3,3,6
31376,58thStGreenway22ndAve,09/28/2017 08:00:00 AM,48,-122,3,6,9
31377,58thStGreenway22ndAve,09/28/2017 09:00:00 AM,48,-122,8,3,11
31378,58thStGreenway22ndAve,09/28/2017 10:00:00 AM,48,-122,4,10,14
31379,58thStGreenway22ndAve,09/28/2017 11:00:00 AM,48,-122,10,0,10
31380,58thStGreenway22ndAve,09/28/2017 12:00:00 PM,48,-122,4,3,7
31381,58thStGreenway22ndAve,09/28/2017 01:00:00 PM,48,-122,10,3,13
31382,58thStGreenway22ndAve,09/28/2017 02:00:00 PM,48,-122,6,8,14
31383,58thStGreenway22ndAve,09/28/2017 03:00:00 PM,48,-122,3,5,8
31384,58thStGreenway22ndAve,09/28/2017 04:00:00 PM,48,-122,6,9,15
31385,58thStGreenway22ndAve,09/28/2017 05:00:00 PM,48,-122,16,10,26
31386,58thStGreenway22ndAve,09/28/2017 06:00:00 PM,48,-122,25,8,33
31387,58thStGreenway22ndAve,09/28/2017 07:00:00 PM,48,-122,7,12,19
31388,58thStGreenway22ndAve,09/28/2017 08:00:00 PM,48,-122,4,6,10
31389,58thStGreenway22ndAve,09/28/2017 09:00:00 PM,48,-122,3,5,8
31390,58thStGreenway22ndAve,09/28/2017 10:00:00 PM,48,-122,5,2,7
31391,58thStGreenway22ndAve,09/28/2017 11:00:00 PM,48,-122,0,1,1
31392,58thStGreenway22ndAve,09/29/2017 12:00:00 AM,48,-122,1,0,1
31393,58thStGreenway22ndAve,09/29/2017 01:00:00 AM,48,-122,0,0,0
31394,58thStGreenway22ndAve,09/29/2017 02:00:00 AM,48,-122,0,1,1
31395,58thStGreenway22ndAve,09/29/2017 03:00:00 AM,48,-122,0,0,0
31396,58thStGreenway22ndAve,09/29/2017 04:00:00 AM,48,-122,2,0,2
31397,58thStGreenway22ndAve,09/29/2017 05:00:00 AM,48,-122,1,1,2
31398,58thStGreenway22ndAve,09/29/2017 06:00:00 AM,48,-122,0,1,1
31399,58thStGreenway22ndAve,09/29/2017 07:00:00 AM,48,-122,2,4,6
31400,58thStGreenway22ndAve,09/29/2017 08:00:00 AM,48,-122,2,3,5
31401,58thStGreenway22ndAve,09/29/2017 09:00:00 AM,48,-122,3,0,3
31402,58thStGreenway22ndAve,09/29/2017 10:00:00 AM,48,-122,5,4,9
31403,58thStGreenway22ndAve,09/29/2017 11:00:00 AM,48,-122,4,4,8
31404,58thStGreenway22ndAve,09/29/2017 12:00:00 PM,48,-122,2,1,3
31405,58thStGreenway22ndAve,09/29/2017 01:00:00 PM,48,-122,4,3,7
31406,58thStGreenway22ndAve,09/29/2017 02:00:00 PM,48,-122,6,3,9
31407,58thStGreenway22ndAve,09/29/2017 03:00:00 PM,48,-122,6,1,7
31408,58thStGreenway22ndAve,09/29/2017 04:00:00 PM,48,-122,9,5,14
31409,58thStGreenway22ndAve,09/29/2017 05:00:00 PM,48,-122,10,4,14
31410,58thStGreenway22ndAve,09/29/2017 06:00:00 PM,48,-122,8,3,11
31411,58thStGreenway22ndAve,09/29/2017 07:00:00 PM,48,-122,4,5,9
31412,58thStGreenway22ndAve,09/29/2017 08:00:00 PM,48,-122,8,2,10
31413,58thStGreenway22ndAve,09/29/2017 09:00:00 PM,48,-122,5,4,9
31414,58thStGreenway22ndAve,09/29/2017 10:00:00 PM,48,-122,0,1,1
31415,58thStGreenway22ndAve,09/29/2017 11:00:00 PM,48,-122,1,1,2
31416,58thStGreenway22ndAve,09/30/2017 12:00:00 AM,48,-122,0,1,1
31417,58thStGreenway22ndAve,09/30/2017 01:00:00 AM,48,-122,0,0,0
31418,58thStGreenway22ndAve,09/30/2017 02:00:00 AM,48,-122,1,1,2
31419,58thStGreenway22ndAve,09/30/2017 03:00:00 AM,48,-122,0,0,0
31420,58thStGreenway22ndAve,09/30/2017 04:00:00 AM,48,-122,0,1,1
31421,58thStGreenway22ndAve,09/30/2017 05:00:00 AM,48,-122,0,0,0
31422,58thStGreenway22ndAve,09/30/2017 06:00:00 AM,48,-122,0,0,0
31423,58thStGreenway22ndAve,09/30/2017 07:00:00 AM,48,-122,1,1,2
31424,58thStGreenway22ndAve,09/30/2017 08:00:00 AM,48,-122,3,2,5
31425,58thStGreenway22ndAve,09/30/2017 09:00:00 AM,48,-122,7,6,13
31426,58thStGreenway22ndAve,09/30/2017 10:00:00 AM,48,-122,11,1,12
31427,58thStGreenway22ndAve,09/30/2017 11:00:00 AM,48,-122,7,11,18
31428,58thStGreenway22ndAve,09/30/2017 12:00:00 PM,48,-122,9,1,10
31429,58thStGreenway22ndAve,09/30/2017 01:00:00 PM,48,-122,8,4,12
31430,58thStGreenway22ndAve,09/30/2017 02:00:00 PM,48,-122,8,3,11
31431,58thStGreenway22ndAve,09/30/2017 03:00:00 PM,48,-122,9,2,11
31432,58thStGreenway22ndAve,09/30/2017 04:00:00 PM,48,-122,6,5,11
31433,58thStGreenway22ndAve,09/30/2017 05:00:00 PM,48,-122,5,3,8
31434,58thStGreenway22ndAve,09/30/2017 06:00:00 PM,48,-122,11,3,14
31435,58thStGreenway22ndAve,09/30/2017 07:00:00 PM,48,-122,3,2,5
31436,58thStGreenway22ndAve,09/30/2017 08:00:00 PM,48,-122,4,2,6
31437,58thStGreenway22ndAve,09/30/2017 09:00:00 PM,48,-122,1,1,2
31438,58thStGreenway22ndAve,09/30/2017 10:00:00 PM,48,-122,1,2,3
31439,58thStGreenway22ndAve,09/30/2017 11:00:00 PM,48,-122,1,0,1
31440,58thStGreenway22ndAve,10/01/2017 12:00:00 AM,48,-122,0,2,2
31441,58thStGreenway22ndAve,10/01/2017 01:00:00 AM,48,-122,0,0,0
31442,58thStGreenway22ndAve,10/01/2017 02:00:00 AM,48,-122,1,2,3
31443,58thStGreenway22ndAve,10/01/2017 03:00:00 AM,48,-122,1,0,1
31444,58thStGreenway22ndAve,10/01/2017 04:00:00 AM,48,-122,1,0,1
31445,58thStGreenway22ndAve,10/01/2017 05:00:00 AM,48,-122,0,0,0
31446,58thStGreenway22ndAve,10/01/2017 06:00:00 AM,48,-122,1,0,1
31447,58thStGreenway22ndAve,10/01/2017 07:00:00 AM,48,-122,2,0,2
31448,58thStGreenway22ndAve,10/01/2017 08:00:00 AM,48,-122,2,1,3
31449,58thStGreenway22ndAve,10/01/2017 09:00:00 AM,48,-122,7,0,7
31450,58thStGreenway22ndAve,10/01/2017 10:00:00 AM,48,-122,4,2,6
31451,58thStGreenway22ndAve,10/01/2017 11:00:00 AM,48,-122,9,6,15
31452,58thStGreenway22ndAve,10/01/2017 12:00:00 PM,48,-122,12,9,21
31453,58thStGreenway22ndAve,10/01/2017 01:00:00 PM,48,-122,9,9,18
31454,58thStGreenway22ndAve,10/01/2017 02:00:00 PM,48,-122,9,6,15
31455,58thStGreenway22ndAve,10/01/2017 03:00:00 PM,48,-122,10,5,15
31456,58thStGreenway22ndAve,10/01/2017 04:00:00 PM,48,-122,8,10,18
31457,58thStGreenway22ndAve,10/01/2017 05:00:00 PM,48,-122,15,9,24
31458,58thStGreenway22ndAve,10/01/2017 06:00:00 PM,48,-122,7,2,9
31459,58thStGreenway22ndAve,10/01/2017 07:00:00 PM,48,-122,2,1,3
31460,58thStGreenway22ndAve,10/01/2017 08:00:00 PM,48,-122,4,3,7
31461,58thStGreenway22ndAve,10/01/2017 09:00:00 PM,48,-122,1,0,1
31462,58thStGreenway22ndAve,10/01/2017 10:00:00 PM,48,-122,1,2,3
31463,58thStGreenway22ndAve,10/01/2017 11:00:00 PM,48,-122,0,1,1
31464,58thStGreenway22ndAve,10/02/2017 12:00:00 AM,48,-122,0,0,0
31465,58thStGreenway22ndAve,10/02/2017 01:00:00 AM,48,-122,0,0,0
31466,58thStGreenway22ndAve,10/02/2017 02:00:00 AM,48,-122,0,0,0
31467,58thStGreenway22ndAve,10/02/2017 03:00:00 AM,48,-122,0,0,0
31468,58thStGreenway22ndAve,10/02/2017 04:00:00 AM,48,-122,0,0,0
31469,58thStGreenway22ndAve,10/02/2017 05:00:00 AM,48,-122,0,2,2
31470,58thStGreenway22ndAve,10/02/2017 06:00:00 AM,48,-122,3,0,3
31471,58thStGreenway22ndAve,10/02/2017 07:00:00 AM,48,-122,6,3,9
31472,58thStGreenway22ndAve,10/02/2017 08:00:00 AM,48,-122,4,6,10
31473,58thStGreenway22ndAve,10/02/2017 09:00:00 AM,48,-122,7,1,8
31474,58thStGreenway22ndAve,10/02/2017 10:00:00 AM,48,-122,2,3,5
31475,58thStGreenway22ndAve,10/02/2017 11:00:00 AM,48,-122,5,1,6
31476,58thStGreenway22ndAve,10/02/2017 12:00:00 PM,48,-122,6,2,8
31477,58thStGreenway22ndAve,10/02/2017 01:00:00 PM,48,-122,4,1,5
31478,58thStGreenway22ndAve,10/02/2017 02:00:00 PM,48,-122,8,1,9
31479,58thStGreenway22ndAve,10/02/2017 03:00:00 PM,48,-122,6,3,9
31480,58thStGreenway22ndAve,10/02/2017 04:00:00 PM,48,-122,10,3,13
31481,58thStGreenway22ndAve,10/02/2017 05:00:00 PM,48,-122,13,5,18
31482,58thStGreenway22ndAve,10/02/2017 06:00:00 PM,48,-122,10,10,20
31483,58thStGreenway22ndAve,10/02/2017 07:00:00 PM,48,-122,9,4,13
31484,58thStGreenway22ndAve,10/02/2017 08:00:00 PM,48,-122,2,3,5
31485,58thStGreenway22ndAve,10/02/2017 09:00:00 PM,48,-122,4,3,7
31486,58thStGreenway22ndAve,10/02/2017 10:00:00 PM,48,-122,2,1,3
31487,58thStGreenway22ndAve,10/02/2017 11:00:00 PM,48,-122,0,2,2
31488,58thStGreenway22ndAve,10/03/2017 12:00:00 AM,48,-122,0,0,0
31489,58thStGreenway22ndAve,10/03/2017 01:00:00 AM,48,-122,0,0,0
31490,58thStGreenway22ndAve,10/03/2017 02:00:00 AM,48,-122,0,0,0
31491,58thStGreenway22ndAve,10/03/2017 03:00:00 AM,48,-122,0,0,0
31492,58thStGreenway22ndAve,10/03/2017 04:00:00 AM,48,-122,0,0,0
31493,58thStGreenway22ndAve,10/03/2017 05:00:00 AM,48,-122,0,0,0
31494,58thStGreenway22ndAve,10/03/2017 06:00:00 AM,48,-122,1,2,3
31495,58thStGreenway22ndAve,10/03/2017 07:00:00 AM,48,-122,6,8,14
31496,58thStGreenway22ndAve,10/03/2017 08:00:00 AM,48,-122,3,12,15
31497,58thStGreenway22ndAve,10/03/2017 09:00:00 AM,48,-122,3,3,6
31498,58thStGreenway22ndAve,10/03/2017 10:00:00 AM,48,-122,2,2,4
31499,58thStGreenway22ndAve,10/03/2017 11:00:00 AM,48,-122,5,2,7
31500,58thStGreenway22ndAve,10/03/2017 12:00:00 PM,48,-122,5,5,10
31501,58thStGreenway22ndAve,10/03/2017 01:00:00 PM,48,-122,8,2,10
31502,58thStGreenway22ndAve,10/03/2017 02:00:00 PM,48,-122,8,0,8
31503,58thStGreenway22ndAve,10/03/2017 03:00:00 PM,48,-122,8,6,14
31504,58thStGreenway22ndAve,10/03/2017 04:00:00 PM,48,-122,9,6,15
31505,58thStGreenway22ndAve,10/03/2017 05:00:00 PM,48,-122,12,11,23
31506,58thStGreenway22ndAve,10/03/2017 06:00:00 PM,48,-122,18,7,25
31507,58thStGreenway22ndAve,10/03/2017 07:00:00 PM,48,-122,2,2,4
31508,58thStGreenway22ndAve,10/03/2017 08:00:00 PM,48,-122,0,0,0
31509,58thStGreenway22ndAve,10/03/2017 09:00:00 PM,48,-122,0,0,0
31510,58thStGreenway22ndAve,10/03/2017 10:00:00 PM,48,-122,0,0,0
31511,58thStGreenway22ndAve,10/03/2017 11:00:00 PM,48,-122,0,0,0
31512,58thStGreenway22ndAve,10/04/2017 12:00:00 AM,48,-122,0,0,0
31513,58thStGreenway22ndAve,10/04/2017 01:00:00 AM,48,-122,0,0,0
31514,58thStGreenway22ndAve,10/04/2017 02:00:00 AM,48,-122,0,0,0
31515,58thStGreenway22ndAve,10/04/2017 03:00:00 AM,48,-122,0,0,0
31516,58thStGreenway22ndAve,10/04/2017 04:00:00 AM,48,-122,0,0,0
31517,58thStGreenway22ndAve,10/04/2017 05:00:00 AM,48,-122,0,0,0
31518,58thStGreenway22ndAve,10/04/2017 06:00:00 AM,48,-122,0,0,0
31519,58thStGreenway22ndAve,10/04/2017 07:00:00 AM,48,-122,3,3,6
31520,58thStGreenway22ndAve,10/04/2017 08:00:00 AM,48,-122,3,4,7
31521,58thStGreenway22ndAve,10/04/2017 09:00:00 AM,48,-122,5,1,6
31522,58thStGreenway22ndAve,10/04/2017 10:00:00 AM,48,-122,4,5,9
31523,58thStGreenway22ndAve,10/04/2017 11:00:00 AM,48,-122,8,2,10
31524,58thStGreenway22ndAve,10/04/2017 12:00:00 PM,48,-122,7,3,10
31525,58thStGreenway22ndAve,10/04/2017 01:00:00 PM,48,-122,5,3,8
31526,58thStGreenway22ndAve,10/04/2017 02:00:00 PM,48,-122,6,1,7
31527,58thStGreenway22ndAve,10/04/2017 03:00:00 PM,48,-122,3,6,9
31528,58thStGreenway22ndAve,10/04/2017 04:00:00 PM,48,-122,10,5,15
31529,58thStGreenway22ndAve,10/04/2017 05:00:00 PM,48,-122,15,4,19
31530,58thStGreenway22ndAve,10/04/2017 06:00:00 PM,48,-122,16,9,25
31531,58thStGreenway22ndAve,10/04/2017 07:00:00 PM,48,-122,4,13,17
31532,58thStGreenway22ndAve,10/04/2017 08:00:00 PM,48,-122,5,3,8
31533,58thStGreenway22ndAve,10/04/2017 09:00:00 PM,48,-122,2,2,4
31534,58thStGreenway22ndAve,10/04/2017 10:00:00 PM,48,-122,1,3,4
31535,58thStGreenway22ndAve,10/04/2017 11:00:00 PM,48,-122,0,0,0
31536,58thStGreenway22ndAve,10/05/2017 12:00:00 AM,48,-122,0,0,0
31537,58thStGreenway22ndAve,10/05/2017 01:00:00 AM,48,-122,0,1,1
31538,58thStGreenway22ndAve,10/05/2017 02:00:00 AM,48,-122,0,0,0
31539,58thStGreenway22ndAve,10/05/2017 03:00:00 AM,48,-122,0,0,0
31540,58thStGreenway22ndAve,10/05/2017 04:00:00 AM,48,-122,0,0,0
31541,58thStGreenway22ndAve,10/05/2017 05:00:00 AM,48,-122,0,1,1
31542,58thStGreenway22ndAve,10/05/2017 06:00:00 AM,48,-122,1,2,3
31543,58thStGreenway22ndAve,10/05/2017 07:00:00 AM,48,-122,4,7,11
31544,58thStGreenway22ndAve,10/05/2017 08:00:00 AM,48,-122,4,5,9
31545,58thStGreenway22ndAve,10/05/2017 09:00:00 AM,48,-122,4,1,5
31546,58thStGreenway22ndAve,10/05/2017 10:00:00 AM,48,-122,3,3,6
31547,58thStGreenway22ndAve,10/05/2017 11:00:00 AM,48,-122,6,5,11
31548,58thStGreenway22ndAve,10/05/2017 12:00:00 PM,48,-122,9,2,11
31549,58thStGreenway22ndAve,10/05/2017 01:00:00 PM,48,-122,3,0,3
31550,58thStGreenway22ndAve,10/05/2017 02:00:00 PM,48,-122,4,7,11
31551,58thStGreenway22ndAve,10/05/2017 03:00:00 PM,48,-122,9,6,15
31552,58thStGreenway22ndAve,10/05/2017 04:00:00 PM,48,-122,9,3,12
31553,58thStGreenway22ndAve,10/05/2017 05:00:00 PM,48,-122,11,5,16
31554,58thStGreenway22ndAve,10/05/2017 06:00:00 PM,48,-122,9,9,18
31555,58thStGreenway22ndAve,10/05/2017 07:00:00 PM,48,-122,4,8,12
31556,58thStGreenway22ndAve,10/05/2017 08:00:00 PM,48,-122,1,4,5
31557,58thStGreenway22ndAve,10/05/2017 09:00:00 PM,48,-122,1,0,1
31558,58thStGreenway22ndAve,10/05/2017 10:00:00 PM,48,-122,1,1,2
31559,58thStGreenway22ndAve,10/05/2017 11:00:00 PM,48,-122,0,0,0
31560,58thStGreenway22ndAve,10/06/2017 12:00:00 AM,48,-122,0,0,0
31561,58thStGreenway22ndAve,10/06/2017 01:00:00 AM,48,-122,1,1,2
31562,58thStGreenway22ndAve,10/06/2017 02:00:00 AM,48,-122,0,0,0
31563,58thStGreenway22ndAve,10/06/2017 03:00:00 AM,48,-122,0,0,0
31564,58thStGreenway22ndAve,10/06/2017 04:00:00 AM,48,-122,0,0,0
31565,58thStGreenway22ndAve,10/06/2017 05:00:00 AM,48,-122,0,0,0
31566,58thStGreenway22ndAve,10/06/2017 06:00:00 AM,48,-122,1,3,4
31567,58thStGreenway22ndAve,10/06/2017 07:00:00 AM,48,-122,3,3,6
31568,58thStGreenway22ndAve,10/06/2017 08:00:00 AM,48,-122,3,6,9
31569,58thStGreenway22ndAve,10/06/2017 09:00:00 AM,48,-122,7,1,8
31570,58thStGreenway22ndAve,10/06/2017 10:00:00 AM,48,-122,3,4,7
31571,58thStGreenway22ndAve,10/06/2017 11:00:00 AM,48,-122,6,4,10
31572,58thStGreenway22ndAve,10/06/2017 12:00:00 PM,48,-122,10,3,13
31573,58thStGreenway22ndAve,10/06/2017 01:00:00 PM,48,-122,1,4,5
31574,58thStGreenway22ndAve,10/06/2017 02:00:00 PM,48,-122,7,4,11
31575,58thStGreenway22ndAve,10/06/2017 03:00:00 PM,48,-122,6,4,10
31576,58thStGreenway22ndAve,10/06/2017 04:00:00 PM,48,-122,7,10,17
31577,58thStGreenway22ndAve,10/06/2017 05:00:00 PM,48,-122,5,9,14
31578,58thStGreenway22ndAve,10/06/2017 06:00:00 PM,48,-122,8,9,17
31579,58thStGreenway22ndAve,10/06/2017 07:00:00 PM,48,-122,3,1,4
31580,58thStGreenway22ndAve,10/06/2017 08:00:00 PM,48,-122,1,4,5
31581,58thStGreenway22ndAve,10/06/2017 09:00:00 PM,48,-122,2,2,4
31582,58thStGreenway22ndAve,10/06/2017 10:00:00 PM,48,-122,1,2,3
31583,58thStGreenway22ndAve,10/06/2017 11:00:00 PM,48,-122,1,0,1
31584,58thStGreenway22ndAve,10/07/2017 12:00:00 AM,48,-122,0,0,0
31585,58thStGreenway22ndAve,10/07/2017 01:00:00 AM,48,-122,1,0,1
31586,58thStGreenway22ndAve,10/07/2017 02:00:00 AM,48,-122,0,0,0
31587,58thStGreenway22ndAve,10/07/2017 03:00:00 AM,48,-122,0,0,0
31588,58thStGreenway22ndAve,10/07/2017 04:00:00 AM,48,-122,0,0,0
31589,58thStGreenway22ndAve,10/07/2017 05:00:00 AM,48,-122,0,0,0
31590,58thStGreenway22ndAve,10/07/2017 06:00:00 AM,48,-122,1,0,1
31591,58thStGreenway22ndAve,10/07/2017 07:00:00 AM,48,-122,0,0,0
31592,58thStGreenway22ndAve,10/07/2017 08:00:00 AM,48,-122,2,1,3
31593,58thStGreenway22ndAve,10/07/2017 09:00:00 AM,48,-122,5,6,11
31594,58thStGreenway22ndAve,10/07/2017 10:00:00 AM,48,-122,10,4,14
31595,58thStGreenway22ndAve,10/07/2017 11:00:00 AM,48,-122,3,7,10
31596,58thStGreenway22ndAve,10/07/2017 12:00:00 PM,48,-122,9,5,14
31597,58thStGreenway22ndAve,10/07/2017 01:00:00 PM,48,-122,6,1,7
31598,58thStGreenway22ndAve,10/07/2017 02:00:00 PM,48,-122,6,1,7
31599,58thStGreenway22ndAve,10/07/2017 03:00:00 PM,48,-122,5,4,9
31600,58thStGreenway22ndAve,10/07/2017 04:00:00 PM,48,-122,7,6,13
31601,58thStGreenway22ndAve,10/07/2017 05:00:00 PM,48,-122,5,5,10
31602,58thStGreenway22ndAve,10/07/2017 06:00:00 PM,48,-122,7,3,10
31603,58thStGreenway22ndAve,10/07/2017 07:00:00 PM,48,-122,6,1,7
31604,58thStGreenway22ndAve,10/07/2017 08:00:00 PM,48,-122,0,2,2
31605,58thStGreenway22ndAve,10/07/2017 09:00:00 PM,48,-122,2,2,4
31606,58thStGreenway22ndAve,10/07/2017 10:00:00 PM,48,-122,0,1,1
31607,58thStGreenway22ndAve,10/07/2017 11:00:00 PM,48,-122,2,1,3
31608,58thStGreenway22ndAve,10/08/2017 12:00:00 AM,48,-122,0,0,0
31609,58thStGreenway22ndAve,10/08/2017 01:00:00 AM,48,-122,0,2,2
31610,58thStGreenway22ndAve,10/08/2017 02:00:00 AM,48,-122,1,0,1
31611,58thStGreenway22ndAve,10/08/2017 03:00:00 AM,48,-122,0,1,1
31612,58thStGreenway22ndAve,10/08/2017 04:00:00 AM,48,-122,1,1,2
31613,58thStGreenway22ndAve,10/08/2017 05:00:00 AM,48,-122,0,1,1
31614,58thStGreenway22ndAve,10/08/2017 06:00:00 AM,48,-122,0,0,0
31615,58thStGreenway22ndAve,10/08/2017 07:00:00 AM,48,-122,0,0,0
31616,58thStGreenway22ndAve,10/08/2017 08:00:00 AM,48,-122,1,0,1
31617,58thStGreenway22ndAve,10/08/2017 09:00:00 AM,48,-122,4,3,7
31618,58thStGreenway22ndAve,10/08/2017 10:00:00 AM,48,-122,9,4,13
31619,58thStGreenway22ndAve,10/08/2017 11:00:00 AM,48,-122,9,5,14
31620,58thStGreenway22ndAve,10/08/2017 12:00:00 PM,48,-122,16,3,19
31621,58thStGreenway22ndAve,10/08/2017 01:00:00 PM,48,-122,8,4,12
31622,58thStGreenway22ndAve,10/08/2017 02:00:00 PM,48,-122,6,6,12
31623,58thStGreenway22ndAve,10/08/2017 03:00:00 PM,48,-122,4,4,8
31624,58thStGreenway22ndAve,10/08/2017 04:00:00 PM,48,-122,9,4,13
31625,58thStGreenway22ndAve,10/08/2017 05:00:00 PM,48,-122,3,2,5
31626,58thStGreenway22ndAve,10/08/2017 06:00:00 PM,48,-122,3,7,10
31627,58thStGreenway22ndAve,10/08/2017 07:00:00 PM,48,-122,0,3,3
31628,58thStGreenway22ndAve,10/08/2017 08:00:00 PM,48,-122,0,1,1
31629,58thStGreenway22ndAve,10/08/2017 09:00:00 PM,48,-122,0,2,2
31630,58thStGreenway22ndAve,10/08/2017 10:00:00 PM,48,-122,0,1,1
31631,58thStGreenway22ndAve,10/08/2017 11:00:00 PM,48,-122,1,0,1
31632,58thStGreenway22ndAve,10/09/2017 12:00:00 AM,48,-122,0,0,0
31633,58thStGreenway22ndAve,10/09/2017 01:00:00 AM,48,-122,0,0,0
31634,58thStGreenway22ndAve,10/09/2017 02:00:00 AM,48,-122,0,0,0
31635,58thStGreenway22ndAve,10/09/2017 03:00:00 AM,48,-122,0,0,0
31636,58thStGreenway22ndAve,10/09/2017 04:00:00 AM,48,-122,0,0,0
31637,58thStGreenway22ndAve,10/09/2017 05:00:00 AM,48,-122,0,0,0
31638,58thStGreenway22ndAve,10/09/2017 06:00:00 AM,48,-122,0,1,1
31639,58thStGreenway22ndAve,10/09/2017 07:00:00 AM,48,-122,6,2,8
31640,58thStGreenway22ndAve,10/09/2017 08:00:00 AM,48,-122,6,7,13
31641,58thStGreenway22ndAve,10/09/2017 09:00:00 AM,48,-122,6,2,8
31642,58thStGreenway22ndAve,10/09/2017 10:00:00 AM,48,-122,3,3,6
31643,58thStGreenway22ndAve,10/09/2017 11:00:00 AM,48,-122,9,3,12
31644,58thStGreenway22ndAve,10/09/2017 12:00:00 PM,48,-122,8,7,15
31645,58thStGreenway22ndAve,10/09/2017 01:00:00 PM,48,-122,5,7,12
31646,58thStGreenway22ndAve,10/09/2017 02:00:00 PM,48,-122,3,1,4
31647,58thStGreenway22ndAve,10/09/2017 03:00:00 PM,48,-122,7,4,11
31648,58thStGreenway22ndAve,10/09/2017 04:00:00 PM,48,-122,6,2,8
31649,58thStGreenway22ndAve,10/09/2017 05:00:00 PM,48,-122,13,7,20
31650,58thStGreenway22ndAve,10/09/2017 06:00:00 PM,48,-122,5,5,10
31651,58thStGreenway22ndAve,10/09/2017 07:00:00 PM,48,-122,2,3,5
31652,58thStGreenway22ndAve,10/09/2017 08:00:00 PM,48,-122,4,5,9
31653,58thStGreenway22ndAve,10/09/2017 09:00:00 PM,48,-122,2,2,4
31654,58thStGreenway22ndAve,10/09/2017 10:00:00 PM,48,-122,2,2,4
31655,58thStGreenway22ndAve,10/09/2017 11:00:00 PM,48,-122,1,0,1
31656,58thStGreenway22ndAve,10/10/2017 12:00:00 AM,48,-122,0,0,0
31657,58thStGreenway22ndAve,10/10/2017 01:00:00 AM,48,-122,1,0,1
31658,58thStGreenway22ndAve,10/10/2017 02:00:00 AM,48,-122,0,0,0
31659,58thStGreenway22ndAve,10/10/2017 03:00:00 AM,48,-122,0,0,0
31660,58thStGreenway22ndAve,10/10/2017 04:00:00 AM,48,-122,0,0,0
31661,58thStGreenway22ndAve,10/10/2017 05:00:00 AM,48,-122,0,1,1
31662,58thStGreenway22ndAve,10/10/2017 06:00:00 AM,48,-122,1,0,1
31663,58thStGreenway22ndAve,10/10/2017 07:00:00 AM,48,-122,8,5,13
31664,58thStGreenway22ndAve,10/10/2017 08:00:00 AM,48,-122,5,5,10
31665,58thStGreenway22ndAve,10/10/2017 09:00:00 AM,48,-122,3,7,10
31666,58thStGreenway22ndAve,10/10/2017 10:00:00 AM,48,-122,9,2,11
31667,58thStGreenway22ndAve,10/10/2017 11:00:00 AM,48,-122,3,2,5
31668,58thStGreenway22ndAve,10/10/2017 12:00:00 PM,48,-122,6,2,8
31669,58thStGreenway22ndAve,10/10/2017 01:00:00 PM,48,-122,3,7,10
31670,58thStGreenway22ndAve,10/10/2017 02:00:00 PM,48,-122,5,2,7
31671,58thStGreenway22ndAve,10/10/2017 03:00:00 PM,48,-122,3,3,6
31672,58thStGreenway22ndAve,10/10/2017 04:00:00 PM,48,-122,4,2,6
31673,58thStGreenway22ndAve,10/10/2017 05:00:00 PM,48,-122,13,8,21
31674,58thStGreenway22ndAve,10/10/2017 06:00:00 PM,48,-122,10,6,16
31675,58thStGreenway22ndAve,10/10/2017 07:00:00 PM,48,-122,2,4,6
31676,58thStGreenway22ndAve,10/10/2017 08:00:00 PM,48,-122,3,5,8
31677,58thStGreenway22ndAve,10/10/2017 09:00:00 PM,48,-122,3,2,5
31678,58thStGreenway22ndAve,10/10/2017 10:00:00 PM,48,-122,2,0,2
31679,58thStGreenway22ndAve,10/10/2017 11:00:00 PM,48,-122,0,0,0
31680,58thStGreenway22ndAve,10/11/2017 12:00:00 AM,48,-122,0,0,0
31681,58thStGreenway22ndAve,10/11/2017 01:00:00 AM,48,-122,0,0,0
31682,58thStGreenway22ndAve,10/11/2017 02:00:00 AM,48,-122,0,0,0
31683,58thStGreenway22ndAve,10/11/2017 03:00:00 AM,48,-122,0,0,0
31684,58thStGreenway22ndAve,10/11/2017 04:00:00 AM,48,-122,0,0,0
31685,58thStGreenway22ndAve,10/11/2017 05:00:00 AM,48,-122,0,0,0
31686,58thStGreenway22ndAve,10/11/2017 06:00:00 AM,48,-122,2,2,4
31687,58thStGreenway22ndAve,10/11/2017 07:00:00 AM,48,-122,1,3,4
31688,58thStGreenway22ndAve,10/11/2017 08:00:00 AM,48,-122,4,3,7
31689,58thStGreenway22ndAve,10/11/2017 09:00:00 AM,48,-122,8,9,17
31690,58thStGreenway22ndAve,10/11/2017 10:00:00 AM,48,-122,8,1,9
31691,58thStGreenway22ndAve,10/11/2017 11:00:00 AM,48,-122,5,3,8
31692,58thStGreenway22ndAve,10/11/2017 12:00:00 PM,48,-122,4,2,6
31693,58thStGreenway22ndAve,10/11/2017 01:00:00 PM,48,-122,8,1,9
31694,58thStGreenway22ndAve,10/11/2017 02:00:00 PM,48,-122,8,2,10
31695,58thStGreenway22ndAve,10/11/2017 03:00:00 PM,48,-122,5,4,9
31696,58thStGreenway22ndAve,10/11/2017 04:00:00 PM,48,-122,5,2,7
31697,58thStGreenway22ndAve,10/11/2017 05:00:00 PM,48,-122,14,4,18
31698,58thStGreenway22ndAve,10/11/2017 06:00:00 PM,48,-122,8,5,13
31699,58thStGreenway22ndAve,10/11/2017 07:00:00 PM,48,-122,5,5,10
31700,58thStGreenway22ndAve,10/11/2017 08:00:00 PM,48,-122,5,1,6
31701,58thStGreenway22ndAve,10/11/2017 09:00:00 PM,48,-122,1,0,1
31702,58thStGreenway22ndAve,10/11/2017 10:00:00 PM,48,-122,2,0,2
31703,58thStGreenway22ndAve,10/11/2017 11:00:00 PM,48,-122,0,0,0
31704,58thStGreenway22ndAve,10/12/2017 12:00:00 AM,48,-122,0,1,1
31705,58thStGreenway22ndAve,10/12/2017 01:00:00 AM,48,-122,1,0,1
31706,58thStGreenway22ndAve,10/12/2017 02:00:00 AM,48,-122,0,0,0
31707,58thStGreenway22ndAve,10/12/2017 03:00:00 AM,48,-122,0,0,0
31708,58thStGreenway22ndAve,10/12/2017 04:00:00 AM,48,-122,0,0,0
31709,58thStGreenway22ndAve,10/12/2017 05:00:00 AM,48,-122,0,0,0
31710,58thStGreenway22ndAve,10/12/2017 06:00:00 AM,48,-122,1,3,4
31711,58thStGreenway22ndAve,10/12/2017 07:00:00 AM,48,-122,2,6,8
31712,58thStGreenway22ndAve,10/12/2017 08:00:00 AM,48,-122,4,4,8
31713,58thStGreenway22ndAve,10/12/2017 09:00:00 AM,48,-122,1,2,3
31714,58thStGreenway22ndAve,10/12/2017 10:00:00 AM,48,-122,6,0,6
31715,58thStGreenway22ndAve,10/12/2017 11:00:00 AM,48,-122,4,2,6
31716,58thStGreenway22ndAve,10/12/2017 12:00:00 PM,48,-122,1,3,4
31717,58thStGreenway22ndAve,10/12/2017 01:00:00 PM,48,-122,2,1,3
31718,58thStGreenway22ndAve,10/12/2017 02:00:00 PM,48,-122,2,2,4
31719,58thStGreenway22ndAve,10/12/2017 03:00:00 PM,48,-122,4,2,6
31720,58thStGreenway22ndAve,10/12/2017 04:00:00 PM,48,-122,3,9,12
31721,58thStGreenway22ndAve,10/12/2017 05:00:00 PM,48,-122,8,2,10
31722,58thStGreenway22ndAve,10/12/2017 06:00:00 PM,48,-122,11,7,18
31723,58thStGreenway22ndAve,10/12/2017 07:00:00 PM,48,-122,2,6,8
31724,58thStGreenway22ndAve,10/12/2017 08:00:00 PM,48,-122,5,4,9
31725,58thStGreenway22ndAve,10/12/2017 09:00:00 PM,48,-122,1,3,4
31726,58thStGreenway22ndAve,10/12/2017 10:00:00 PM,48,-122,1,0,1
31727,58thStGreenway22ndAve,10/12/2017 11:00:00 PM,48,-122,3,1,4
31728,58thStGreenway22ndAve,10/13/2017 12:00:00 AM,48,-122,0,0,0
31729,58thStGreenway22ndAve,10/13/2017 01:00:00 AM,48,-122,0,0,0
31730,58thStGreenway22ndAve,10/13/2017 02:00:00 AM,48,-122,0,0,0
31731,58thStGreenway22ndAve,10/13/2017 03:00:00 AM,48,-122,0,0,0
31732,58thStGreenway22ndAve,10/13/2017 04:00:00 AM,48,-122,0,0,0
31733,58thStGreenway22ndAve,10/13/2017 05:00:00 AM,48,-122,0,1,1
31734,58thStGreenway22ndAve,10/13/2017 06:00:00 AM,48,-122,1,1,2
31735,58thStGreenway22ndAve,10/13/2017 07:00:00 AM,48,-122,1,3,4
31736,58thStGreenway22ndAve,10/13/2017 08:00:00 AM,48,-122,4,2,6
31737,58thStGreenway22ndAve,10/13/2017 09:00:00 AM,48,-122,4,7,11
31738,58thStGreenway22ndAve,10/13/2017 10:00:00 AM,48,-122,3,3,6
31739,58thStGreenway22ndAve,10/13/2017 11:00:00 AM,48,-122,6,5,11
31740,58thStGreenway22ndAve,10/13/2017 12:00:00 PM,48,-122,3,3,6
31741,58thStGreenway22ndAve,10/13/2017 01:00:00 PM,48,-122,1,2,3
31742,58thStGreenway22ndAve,10/13/2017 02:00:00 PM,48,-122,7,4,11
31743,58thStGreenway22ndAve,10/13/2017 03:00:00 PM,48,-122,8,1,9
31744,58thStGreenway22ndAve,10/13/2017 04:00:00 PM,48,-122,10,4,14
31745,58thStGreenway22ndAve,10/13/2017 05:00:00 PM,48,-122,12,4,16
31746,58thStGreenway22ndAve,10/13/2017 06:00:00 PM,48,-122,7,7,14
31747,58thStGreenway22ndAve,10/13/2017 07:00:00 PM,48,-122,2,6,8
31748,58thStGreenway22ndAve,10/13/2017 08:00:00 PM,48,-122,3,1,4
31749,58thStGreenway22ndAve,10/13/2017 09:00:00 PM,48,-122,0,1,1
31750,58thStGreenway22ndAve,10/13/2017 10:00:00 PM,48,-122,0,2,2
31751,58thStGreenway22ndAve,10/13/2017 11:00:00 PM,48,-122,1,1,2
31752,58thStGreenway22ndAve,10/14/2017 12:00:00 AM,48,-122,0,0,0
31753,58thStGreenway22ndAve,10/14/2017 01:00:00 AM,48,-122,0,0,0
31754,58thStGreenway22ndAve,10/14/2017 02:00:00 AM,48,-122,3,1,4
31755,58thStGreenway22ndAve,10/14/2017 03:00:00 AM,48,-122,0,0,0
31756,58thStGreenway22ndAve,10/14/2017 04:00:00 AM,48,-122,0,0,0
31757,58thStGreenway22ndAve,10/14/2017 05:00:00 AM,48,-122,0,0,0
31758,58thStGreenway22ndAve,10/14/2017 06:00:00 AM,48,-122,1,0,1
31759,58thStGreenway22ndAve,10/14/2017 07:00:00 AM,48,-122,2,1,3
31760,58thStGreenway22ndAve,10/14/2017 08:00:00 AM,48,-122,0,2,2
31761,58thStGreenway22ndAve,10/14/2017 09:00:00 AM,48,-122,10,1,11
31762,58thStGreenway22ndAve,10/14/2017 10:00:00 AM,48,-122,6,2,8
31763,58thStGreenway22ndAve,10/14/2017 11:00:00 AM,48,-122,6,10,16
31764,58thStGreenway22ndAve,10/14/2017 12:00:00 PM,48,-122,7,11,18
31765,58thStGreenway22ndAve,10/14/2017 01:00:00 PM,48,-122,13,2,15
31766,58thStGreenway22ndAve,10/14/2017 02:00:00 PM,48,-122,5,7,12
31767,58thStGreenway22ndAve,10/14/2017 03:00:00 PM,48,-122,3,5,8
31768,58thStGreenway22ndAve,10/14/2017 04:00:00 PM,48,-122,8,6,14
31769,58thStGreenway22ndAve,10/14/2017 05:00:00 PM,48,-122,3,3,6
31770,58thStGreenway22ndAve,10/14/2017 06:00:00 PM,48,-122,4,7,11
31771,58thStGreenway22ndAve,10/14/2017 07:00:00 PM,48,-122,4,2,6
31772,58thStGreenway22ndAve,10/14/2017 08:00:00 PM,48,-122,1,2,3
31773,58thStGreenway22ndAve,10/14/2017 09:00:00 PM,48,-122,0,1,1
31774,58thStGreenway22ndAve,10/14/2017 10:00:00 PM,48,-122,2,1,3
31775,58thStGreenway22ndAve,10/14/2017 11:00:00 PM,48,-122,1,0,1
31776,58thStGreenway22ndAve,10/15/2017 12:00:00 AM,48,-122,0,0,0
31777,58thStGreenway22ndAve,10/15/2017 01:00:00 AM,48,-122,1,0,1
31778,58thStGreenway22ndAve,10/15/2017 02:00:00 AM,48,-122,0,0,0
31779,58thStGreenway22ndAve,10/15/2017 03:00:00 AM,48,-122,0,0,0
31780,58thStGreenway22ndAve,10/15/2017 04:00:00 AM,48,-122,0,0,0
31781,58thStGreenway22ndAve,10/15/2017 05:00:00 AM,48,-122,0,0,0
31782,58thStGreenway22ndAve,10/15/2017 06:00:00 AM,48,-122,0,0,0
31783,58thStGreenway22ndAve,10/15/2017 07:00:00 AM,48,-122,1,1,2
31784,58thStGreenway22ndAve,10/15/2017 08:00:00 AM,48,-122,5,3,8
31785,58thStGreenway22ndAve,10/15/2017 09:00:00 AM,48,-122,3,3,6
31786,58thStGreenway22ndAve,10/15/2017 10:00:00 AM,48,-122,7,0,7
31787,58thStGreenway22ndAve,10/15/2017 11:00:00 AM,48,-122,7,10,17
31788,58thStGreenway22ndAve,10/15/2017 12:00:00 PM,48,-122,11,1,12
31789,58thStGreenway22ndAve,10/15/2017 01:00:00 PM,48,-122,10,9,19
31790,58thStGreenway22ndAve,10/15/2017 02:00:00 PM,48,-122,14,8,22
31791,58thStGreenway22ndAve,10/15/2017 03:00:00 PM,48,-122,16,12,28
31792,58thStGreenway22ndAve,10/15/2017 04:00:00 PM,48,-122,8,8,16
31793,58thStGreenway22ndAve,10/15/2017 05:00:00 PM,48,-122,5,8,13
31794,58thStGreenway22ndAve,10/15/2017 06:00:00 PM,48,-122,2,3,5
31795,58thStGreenway22ndAve,10/15/2017 07:00:00 PM,48,-122,3,2,5
31796,58thStGreenway22ndAve,10/15/2017 08:00:00 PM,48,-122,2,4,6
31797,58thStGreenway22ndAve,10/15/2017 09:00:00 PM,48,-122,2,2,4
31798,58thStGreenway22ndAve,10/15/2017 10:00:00 PM,48,-122,0,0,0
31799,58thStGreenway22ndAve,10/15/2017 11:00:00 PM,48,-122,0,1,1
31800,58thStGreenway22ndAve,10/16/2017 12:00:00 AM,48,-122,0,1,1
31801,58thStGreenway22ndAve,10/16/2017 01:00:00 AM,48,-122,0,0,0
31802,58thStGreenway22ndAve,10/16/2017 02:00:00 AM,48,-122,0,0,0
31803,58thStGreenway22ndAve,10/16/2017 03:00:00 AM,48,-122,0,0,0
31804,58thStGreenway22ndAve,10/16/2017 04:00:00 AM,48,-122,0,0,0
31805,58thStGreenway22ndAve,10/16/2017 05:00:00 AM,48,-122,0,1,1
31806,58thStGreenway22ndAve,10/16/2017 06:00:00 AM,48,-122,2,1,3
31807,58thStGreenway22ndAve,10/16/2017 07:00:00 AM,48,-122,3,4,7
31808,58thStGreenway22ndAve,10/16/2017 08:00:00 AM,48,-122,6,9,15
31809,58thStGreenway22ndAve,10/16/2017 09:00:00 AM,48,-122,3,2,5
31810,58thStGreenway22ndAve,10/16/2017 10:00:00 AM,48,-122,5,6,11
31811,58thStGreenway22ndAve,10/16/2017 11:00:00 AM,48,-122,2,1,3
31812,58thStGreenway22ndAve,10/16/2017 12:00:00 PM,48,-122,2,4,6
31813,58thStGreenway22ndAve,10/16/2017 01:00:00 PM,48,-122,9,4,13
31814,58thStGreenway22ndAve,10/16/2017 02:00:00 PM,48,-122,5,1,6
31815,58thStGreenway22ndAve,10/16/2017 03:00:00 PM,48,-122,5,6,11
31816,58thStGreenway22ndAve,10/16/2017 04:00:00 PM,48,-122,5,3,8
31817,58thStGreenway22ndAve,10/16/2017 05:00:00 PM,48,-122,7,8,15
31818,58thStGreenway22ndAve,10/16/2017 06:00:00 PM,48,-122,7,5,12
31819,58thStGreenway22ndAve,10/16/2017 07:00:00 PM,48,-122,2,4,6
31820,58thStGreenway22ndAve,10/16/2017 08:00:00 PM,48,-122,0,0,0
31821,58thStGreenway22ndAve,10/16/2017 09:00:00 PM,48,-122,0,1,1
31822,58thStGreenway22ndAve,10/16/2017 10:00:00 PM,48,-122,1,1,2
31823,58thStGreenway22ndAve,10/16/2017 11:00:00 PM,48,-122,0,1,1
31824,58thStGreenway22ndAve,10/17/2017 12:00:00 AM,48,-122,0,0,0
31825,58thStGreenway22ndAve,10/17/2017 01:00:00 AM,48,-122,0,0,0
31826,58thStGreenway22ndAve,10/17/2017 02:00:00 AM,48,-122,2,0,2
31827,58thStGreenway22ndAve,10/17/2017 03:00:00 AM,48,-122,0,0,0
31828,58thStGreenway22ndAve,10/17/2017 04:00:00 AM,48,-122,0,0,0
31829,58thStGreenway22ndAve,10/17/2017 05:00:00 AM,48,-122,1,1,2
31830,58thStGreenway22ndAve,10/17/2017 06:00:00 AM,48,-122,0,0,0
31831,58thStGreenway22ndAve,10/17/2017 07:00:00 AM,48,-122,1,3,4
31832,58thStGreenway22ndAve,10/17/2017 08:00:00 AM,48,-122,3,1,4
31833,58thStGreenway22ndAve,10/17/2017 09:00:00 AM,48,-122,2,6,8
31834,58thStGreenway22ndAve,10/17/2017 10:00:00 AM,48,-122,3,2,5
31835,58thStGreenway22ndAve,10/17/2017 11:00:00 AM,48,-122,5,2,7
31836,58thStGreenway22ndAve,10/17/2017 12:00:00 PM,48,-122,7,1,8
31837,58thStGreenway22ndAve,10/17/2017 01:00:00 PM,48,-122,6,5,11
31838,58thStGreenway22ndAve,10/17/2017 02:00:00 PM,48,-122,4,5,9
31839,58thStGreenway22ndAve,10/17/2017 03:00:00 PM,48,-122,4,3,7
31840,58thStGreenway22ndAve,10/17/2017 04:00:00 PM,48,-122,7,4,11
31841,58thStGreenway22ndAve,10/17/2017 05:00:00 PM,48,-122,6,5,11
31842,58thStGreenway22ndAve,10/17/2017 06:00:00 PM,48,-122,9,6,15
31843,58thStGreenway22ndAve,10/17/2017 07:00:00 PM,48,-122,2,7,9
31844,58thStGreenway22ndAve,10/17/2017 08:00:00 PM,48,-122,0,2,2
31845,58thStGreenway22ndAve,10/17/2017 09:00:00 PM,48,-122,1,2,3
31846,58thStGreenway22ndAve,10/17/2017 10:00:00 PM,48,-122,1,0,1
31847,58thStGreenway22ndAve,10/17/2017 11:00:00 PM,48,-122,1,0,1
31848,58thStGreenway22ndAve,10/18/2017 12:00:00 AM,48,-122,0,0,0
31849,58thStGreenway22ndAve,10/18/2017 01:00:00 AM,48,-122,0,1,1
31850,58thStGreenway22ndAve,10/18/2017 02:00:00 AM,48,-122,0,0,0
31851,58thStGreenway22ndAve,10/18/2017 03:00:00 AM,48,-122,0,0,0
31852,58thStGreenway22ndAve,10/18/2017 04:00:00 AM,48,-122,1,0,1
31853,58thStGreenway22ndAve,10/18/2017 05:00:00 AM,48,-122,0,0,0
31854,58thStGreenway22ndAve,10/18/2017 06:00:00 AM,48,-122,2,0,2
31855,58thStGreenway22ndAve,10/18/2017 07:00:00 AM,48,-122,1,4,5
31856,58thStGreenway22ndAve,10/18/2017 08:00:00 AM,48,-122,2,5,7
31857,58thStGreenway22ndAve,10/18/2017 09:00:00 AM,48,-122,4,6,10
31858,58thStGreenway22ndAve,10/18/2017 10:00:00 AM,48,-122,7,2,9
31859,58thStGreenway22ndAve,10/18/2017 11:00:00 AM,48,-122,3,1,4
31860,58thStGreenway22ndAve,10/18/2017 12:00:00 PM,48,-122,2,2,4
31861,58thStGreenway22ndAve,10/18/2017 01:00:00 PM,48,-122,3,3,6
31862,58thStGreenway22ndAve,10/18/2017 02:00:00 PM,48,-122,3,2,5
31863,58thStGreenway22ndAve,10/18/2017 03:00:00 PM,48,-122,3,3,6
31864,58thStGreenway22ndAve,10/18/2017 04:00:00 PM,48,-122,1,2,3
31865,58thStGreenway22ndAve,10/18/2017 05:00:00 PM,48,-122,3,3,6
31866,58thStGreenway22ndAve,10/18/2017 06:00:00 PM,48,-122,5,2,7
31867,58thStGreenway22ndAve,10/18/2017 07:00:00 PM,48,-122,8,2,10
31868,58thStGreenway22ndAve,10/18/2017 08:00:00 PM,48,-122,2,0,2
31869,58thStGreenway22ndAve,10/18/2017 09:00:00 PM,48,-122,3,2,5
31870,58thStGreenway22ndAve,10/18/2017 10:00:00 PM,48,-122,1,0,1
31871,58thStGreenway22ndAve,10/18/2017 11:00:00 PM,48,-122,0,0,0
31872,58thStGreenway22ndAve,10/19/2017 12:00:00 AM,48,-122,0,0,0
31873,58thStGreenway22ndAve,10/19/2017 01:00:00 AM,48,-122,0,0,0
31874,58thStGreenway22ndAve,10/19/2017 02:00:00 AM,48,-122,0,0,0
31875,58thStGreenway22ndAve,10/19/2017 03:00:00 AM,48,-122,0,0,0
31876,58thStGreenway22ndAve,10/19/2017 04:00:00 AM,48,-122,0,0,0
31877,58thStGreenway22ndAve,10/19/2017 05:00:00 AM,48,-122,1,0,1
31878,58thStGreenway22ndAve,10/19/2017 06:00:00 AM,48,-122,1,1,2
31879,58thStGreenway22ndAve,10/19/2017 07:00:00 AM,48,-122,1,1,2
31880,58thStGreenway22ndAve,10/19/2017 08:00:00 AM,48,-122,4,3,7
31881,58thStGreenway22ndAve,10/19/2017 09:00:00 AM,48,-122,3,0,3
31882,58thStGreenway22ndAve,10/19/2017 10:00:00 AM,48,-122,8,1,9
31883,58thStGreenway22ndAve,10/19/2017 11:00:00 AM,48,-122,3,0,3
31884,58thStGreenway22ndAve,10/19/2017 12:00:00 PM,48,-122,1,1,2
31885,58thStGreenway22ndAve,10/19/2017 01:00:00 PM,48,-122,5,1,6
31886,58thStGreenway22ndAve,10/19/2017 02:00:00 PM,48,-122,6,4,10
31887,58thStGreenway22ndAve,10/19/2017 03:00:00 PM,48,-122,5,2,7
31888,58thStGreenway22ndAve,10/19/2017 04:00:00 PM,48,-122,3,0,3
31889,58thStGreenway22ndAve,10/19/2017 05:00:00 PM,48,-122,8,1,9
31890,58thStGreenway22ndAve,10/19/2017 06:00:00 PM,48,-122,2,4,6
31891,58thStGreenway22ndAve,10/19/2017 07:00:00 PM,48,-122,4,3,7
31892,58thStGreenway22ndAve,10/19/2017 08:00:00 PM,48,-122,2,2,4
31893,58thStGreenway22ndAve,10/19/2017 09:00:00 PM,48,-122,2,1,3
31894,58thStGreenway22ndAve,10/19/2017 10:00:00 PM,48,-122,2,0,2
31895,58thStGreenway22ndAve,10/19/2017 11:00:00 PM,48,-122,1,0,1
31896,58thStGreenway22ndAve,10/20/2017 12:00:00 AM,48,-122,2,0,2
31897,58thStGreenway22ndAve,10/20/2017 01:00:00 AM,48,-122,0,1,1
31898,58thStGreenway22ndAve,10/20/2017 02:00:00 AM,48,-122,0,0,0
31899,58thStGreenway22ndAve,10/20/2017 03:00:00 AM,48,-122,0,0,0
31900,58thStGreenway22ndAve,10/20/2017 04:00:00 AM,48,-122,0,0,0
31901,58thStGreenway22ndAve,10/20/2017 05:00:00 AM,48,-122,0,0,0
31902,58thStGreenway22ndAve,10/20/2017 06:00:00 AM,48,-122,4,0,4
31903,58thStGreenway22ndAve,10/20/2017 07:00:00 AM,48,-122,2,3,5
31904,58thStGreenway22ndAve,10/20/2017 08:00:00 AM,48,-122,4,5,9
31905,58thStGreenway22ndAve,10/20/2017 09:00:00 AM,48,-122,6,2,8
31906,58thStGreenway22ndAve,10/20/2017 10:00:00 AM,48,-122,8,4,12
31907,58thStGreenway22ndAve,10/20/2017 11:00:00 AM,48,-122,7,1,8
31908,58thStGreenway22ndAve,10/20/2017 12:00:00 PM,48,-122,11,4,15
31909,58thStGreenway22ndAve,10/20/2017 01:00:00 PM,48,-122,6,2,8
31910,58thStGreenway22ndAve,10/20/2017 02:00:00 PM,48,-122,2,1,3
31911,58thStGreenway22ndAve,10/20/2017 03:00:00 PM,48,-122,3,3,6
31912,58thStGreenway22ndAve,10/20/2017 04:00:00 PM,48,-122,12,2,14
31913,58thStGreenway22ndAve,10/20/2017 05:00:00 PM,48,-122,5,7,12
31914,58thStGreenway22ndAve,10/20/2017 06:00:00 PM,48,-122,3,5,8
31915,58thStGreenway22ndAve,10/20/2017 07:00:00 PM,48,-122,4,2,6
31916,58thStGreenway22ndAve,10/20/2017 08:00:00 PM,48,-122,2,5,7
31917,58thStGreenway22ndAve,10/20/2017 09:00:00 PM,48,-122,3,3,6
31918,58thStGreenway22ndAve,10/20/2017 10:00:00 PM,48,-122,2,1,3
31919,58thStGreenway22ndAve,10/20/2017 11:00:00 PM,48,-122,0,0,0
31920,58thStGreenway22ndAve,10/21/2017 12:00:00 AM,48,-122,0,1,1
31921,58thStGreenway22ndAve,10/21/2017 01:00:00 AM,48,-122,1,2,3
31922,58thStGreenway22ndAve,10/21/2017 02:00:00 AM,48,-122,0,0,0
31923,58thStGreenway22ndAve,10/21/2017 03:00:00 AM,48,-122,1,1,2
31924,58thStGreenway22ndAve,10/21/2017 04:00:00 AM,48,-122,0,0,0
31925,58thStGreenway22ndAve,10/21/2017 05:00:00 AM,48,-122,0,0,0
31926,58thStGreenway22ndAve,10/21/2017 06:00:00 AM,48,-122,1,0,1
31927,58thStGreenway22ndAve,10/21/2017 07:00:00 AM,48,-122,0,0,0
31928,58thStGreenway22ndAve,10/21/2017 08:00:00 AM,48,-122,2,1,3
31929,58thStGreenway22ndAve,10/21/2017 09:00:00 AM,48,-122,5,8,13
31930,58thStGreenway22ndAve,10/21/2017 10:00:00 AM,48,-122,10,1,11
31931,58thStGreenway22ndAve,10/21/2017 11:00:00 AM,48,-122,0,2,2
31932,58thStGreenway22ndAve,10/21/2017 12:00:00 PM,48,-122,6,5,11
31933,58thStGreenway22ndAve,10/21/2017 01:00:00 PM,48,-122,10,4,14
31934,58thStGreenway22ndAve,10/21/2017 02:00:00 PM,48,-122,3,3,6
31935,58thStGreenway22ndAve,10/21/2017 03:00:00 PM,48,-122,2,0,2
31936,58thStGreenway22ndAve,10/21/2017 04:00:00 PM,48,-122,3,1,4
31937,58thStGreenway22ndAve,10/21/2017 05:00:00 PM,48,-122,1,1,2
31938,58thStGreenway22ndAve,10/21/2017 06:00:00 PM,48,-122,4,0,4
31939,58thStGreenway22ndAve,10/21/2017 07:00:00 PM,48,-122,4,0,4
31940,58thStGreenway22ndAve,10/21/2017 08:00:00 PM,48,-122,2,2,4
31941,58thStGreenway22ndAve,10/21/2017 09:00:00 PM,48,-122,0,1,1
31942,58thStGreenway22ndAve,10/21/2017 10:00:00 PM,48,-122,0,0,0
31943,58thStGreenway22ndAve,10/21/2017 11:00:00 PM,48,-122,0,0,0
31944,58thStGreenway22ndAve,10/22/2017 12:00:00 AM,48,-122,0,0,0
31945,58thStGreenway22ndAve,10/22/2017 01:00:00 AM,48,-122,0,0,0
31946,58thStGreenway22ndAve,10/22/2017 02:00:00 AM,48,-122,1,1,2
31947,58thStGreenway22ndAve,10/22/2017 03:00:00 AM,48,-122,0,0,0
31948,58thStGreenway22ndAve,10/22/2017 04:00:00 AM,48,-122,0,0,0
31949,58thStGreenway22ndAve,10/22/2017 05:00:00 AM,48,-122,0,0,0
31950,58thStGreenway22ndAve,10/22/2017 06:00:00 AM,48,-122,0,0,0
31951,58thStGreenway22ndAve,10/22/2017 07:00:00 AM,48,-122,0,0,0
31952,58thStGreenway22ndAve,10/22/2017 08:00:00 AM,48,-122,1,1,2
31953,58thStGreenway22ndAve,10/22/2017 09:00:00 AM,48,-122,2,1,3
31954,58thStGreenway22ndAve,10/22/2017 10:00:00 AM,48,-122,5,4,9
31955,58thStGreenway22ndAve,10/22/2017 11:00:00 AM,48,-122,7,10,17
31956,58thStGreenway22ndAve,10/22/2017 12:00:00 PM,48,-122,7,10,17
31957,58thStGreenway22ndAve,10/22/2017 01:00:00 PM,48,-122,10,7,17
31958,58thStGreenway22ndAve,10/22/2017 02:00:00 PM,48,-122,3,4,7
31959,58thStGreenway22ndAve,10/22/2017 03:00:00 PM,48,-122,7,3,10
31960,58thStGreenway22ndAve,10/22/2017 04:00:00 PM,48,-122,2,9,11
31961,58thStGreenway22ndAve,10/22/2017 05:00:00 PM,48,-122,4,7,11
31962,58thStGreenway22ndAve,10/22/2017 06:00:00 PM,48,-122,1,4,5
31963,58thStGreenway22ndAve,10/22/2017 07:00:00 PM,48,-122,4,1,5
31964,58thStGreenway22ndAve,10/22/2017 08:00:00 PM,48,-122,0,1,1
31965,58thStGreenway22ndAve,10/22/2017 09:00:00 PM,48,-122,0,3,3
31966,58thStGreenway22ndAve,10/22/2017 10:00:00 PM,48,-122,0,0,0
31967,58thStGreenway22ndAve,10/22/2017 11:00:00 PM,48,-122,1,0,1
31968,58thStGreenway22ndAve,10/23/2017 12:00:00 AM,48,-122,0,1,1
31969,58thStGreenway22ndAve,10/23/2017 01:00:00 AM,48,-122,0,0,0
31970,58thStGreenway22ndAve,10/23/2017 02:00:00 AM,48,-122,0,0,0
31971,58thStGreenway22ndAve,10/23/2017 03:00:00 AM,48,-122,0,0,0
31972,58thStGreenway22ndAve,10/23/2017 04:00:00 AM,48,-122,0,0,0
31973,58thStGreenway22ndAve,10/23/2017 05:00:00 AM,48,-122,0,0,0
31974,58thStGreenway22ndAve,10/23/2017 06:00:00 AM,48,-122,2,4,6
31975,58thStGreenway22ndAve,10/23/2017 07:00:00 AM,48,-122,3,5,8
31976,58thStGreenway22ndAve,10/23/2017 08:00:00 AM,48,-122,6,5,11
31977,58thStGreenway22ndAve,10/23/2017 09:00:00 AM,48,-122,10,5,15
31978,58thStGreenway22ndAve,10/23/2017 10:00:00 AM,48,-122,2,4,6
31979,58thStGreenway22ndAve,10/23/2017 11:00:00 AM,48,-122,3,2,5
31980,58thStGreenway22ndAve,10/23/2017 12:00:00 PM,48,-122,4,3,7
31981,58thStGreenway22ndAve,10/23/2017 01:00:00 PM,48,-122,9,9,18
31982,58thStGreenway22ndAve,10/23/2017 02:00:00 PM,48,-122,4,5,9
31983,58thStGreenway22ndAve,10/23/2017 03:00:00 PM,48,-122,9,10,19
31984,58thStGreenway22ndAve,10/23/2017 04:00:00 PM,48,-122,12,15,27
31985,58thStGreenway22ndAve,10/23/2017 05:00:00 PM,48,-122,8,12,20
31986,58thStGreenway22ndAve,10/23/2017 06:00:00 PM,48,-122,9,6,15
31987,58thStGreenway22ndAve,10/23/2017 07:00:00 PM,48,-122,2,2,4
31988,58thStGreenway22ndAve,10/23/2017 08:00:00 PM,48,-122,2,4,6
31989,58thStGreenway22ndAve,10/23/2017 09:00:00 PM,48,-122,1,0,1
31990,58thStGreenway22ndAve,10/23/2017 10:00:00 PM,48,-122,0,2,2
31991,58thStGreenway22ndAve,10/23/2017 11:00:00 PM,48,-122,0,0,0
31992,58thStGreenway22ndAve,10/24/2017 12:00:00 AM,48,-122,1,0,1
31993,58thStGreenway22ndAve,10/24/2017 01:00:00 AM,48,-122,0,0,0
31994,58thStGreenway22ndAve,10/24/2017 02:00:00 AM,48,-122,1,0,1
31995,58thStGreenway22ndAve,10/24/2017 03:00:00 AM,48,-122,0,0,0
31996,58thStGreenway22ndAve,10/24/2017 04:00:00 AM,48,-122,0,0,0
31997,58thStGreenway22ndAve,10/24/2017 05:00:00 AM,48,-122,0,0,0
31998,58thStGreenway22ndAve,10/24/2017 06:00:00 AM,48,-122,1,1,2
31999,58thStGreenway22ndAve,10/24/2017 07:00:00 AM,48,-122,6,5,11
32000,58thStGreenway22ndAve,10/24/2017 08:00:00 AM,48,-122,7,6,13
32001,58thStGreenway22ndAve,10/24/2017 09:00:00 AM,48,-122,4,4,8
32002,58thStGreenway22ndAve,10/24/2017 10:00:00 AM,48,-122,8,1,9
32003,58thStGreenway22ndAve,10/24/2017 11:00:00 AM,48,-122,3,2,5
32004,58thStGreenway22ndAve,10/24/2017 12:00:00 PM,48,-122,5,8,13
32005,58thStGreenway22ndAve,10/24/2017 01:00:00 PM,48,-122,4,5,9
32006,58thStGreenway22ndAve,10/24/2017 02:00:00 PM,48,-122,7,6,13
32007,58thStGreenway22ndAve,10/24/2017 03:00:00 PM,48,-122,5,5,10
32008,58thStGreenway22ndAve,10/24/2017 04:00:00 PM,48,-122,4,3,7
32009,58thStGreenway22ndAve,10/24/2017 05:00:00 PM,48,-122,12,10,22
32010,58thStGreenway22ndAve,10/24/2017 06:00:00 PM,48,-122,7,7,14
32011,58thStGreenway22ndAve,10/24/2017 07:00:00 PM,48,-122,6,6,12
32012,58thStGreenway22ndAve,10/24/2017 08:00:00 PM,48,-122,2,4,6
32013,58thStGreenway22ndAve,10/24/2017 09:00:00 PM,48,-122,2,2,4
32014,58thStGreenway22ndAve,10/24/2017 10:00:00 PM,48,-122,0,0,0
32015,58thStGreenway22ndAve,10/24/2017 11:00:00 PM,48,-122,2,1,3
32016,58thStGreenway22ndAve,10/25/2017 12:00:00 AM,48,-122,0,0,0
32017,58thStGreenway22ndAve,10/25/2017 01:00:00 AM,48,-122,0,0,0
32018,58thStGreenway22ndAve,10/25/2017 02:00:00 AM,48,-122,0,0,0
32019,58thStGreenway22ndAve,10/25/2017 03:00:00 AM,48,-122,0,0,0
32020,58thStGreenway22ndAve,10/25/2017 04:00:00 AM,48,-122,0,0,0
32021,58thStGreenway22ndAve,10/25/2017 05:00:00 AM,48,-122,0,0,0
32022,58thStGreenway22ndAve,10/25/2017 06:00:00 AM,48,-122,1,0,1
32023,58thStGreenway22ndAve,10/25/2017 07:00:00 AM,48,-122,2,4,6
32024,58thStGreenway22ndAve,10/25/2017 08:00:00 AM,48,-122,4,4,8
32025,58thStGreenway22ndAve,10/25/2017 09:00:00 AM,48,-122,2,2,4
32026,58thStGreenway22ndAve,10/25/2017 10:00:00 AM,48,-122,6,1,7
32027,58thStGreenway22ndAve,10/25/2017 11:00:00 AM,48,-122,12,7,19
32028,58thStGreenway22ndAve,10/25/2017 12:00:00 PM,48,-122,9,0,9
32029,58thStGreenway22ndAve,10/25/2017 01:00:00 PM,48,-122,8,2,10
32030,58thStGreenway22ndAve,10/25/2017 02:00:00 PM,48,-122,3,1,4
32031,58thStGreenway22ndAve,10/25/2017 03:00:00 PM,48,-122,5,6,11
32032,58thStGreenway22ndAve,10/25/2017 04:00:00 PM,48,-122,5,4,9
32033,58thStGreenway22ndAve,10/25/2017 05:00:00 PM,48,-122,8,7,15
32034,58thStGreenway22ndAve,10/25/2017 06:00:00 PM,48,-122,8,11,19
32035,58thStGreenway22ndAve,10/25/2017 07:00:00 PM,48,-122,4,3,7
32036,58thStGreenway22ndAve,10/25/2017 08:00:00 PM,48,-122,2,5,7
32037,58thStGreenway22ndAve,10/25/2017 09:00:00 PM,48,-122,3,3,6
32038,58thStGreenway22ndAve,10/25/2017 10:00:00 PM,48,-122,2,2,4
32039,58thStGreenway22ndAve,10/25/2017 11:00:00 PM,48,-122,2,1,3
32040,58thStGreenway22ndAve,10/26/2017 12:00:00 AM,48,-122,0,1,1
32041,58thStGreenway22ndAve,10/26/2017 01:00:00 AM,48,-122,0,1,1
32042,58thStGreenway22ndAve,10/26/2017 02:00:00 AM,48,-122,0,0,0
32043,58thStGreenway22ndAve,10/26/2017 03:00:00 AM,48,-122,0,0,0
32044,58thStGreenway22ndAve,10/26/2017 04:00:00 AM,48,-122,0,0,0
32045,58thStGreenway22ndAve,10/26/2017 05:00:00 AM,48,-122,0,0,0
32046,58thStGreenway22ndAve,10/26/2017 06:00:00 AM,48,-122,2,4,6
32047,58thStGreenway22ndAve,10/26/2017 07:00:00 AM,48,-122,1,2,3
32048,58thStGreenway22ndAve,10/26/2017 08:00:00 AM,48,-122,5,2,7
32049,58thStGreenway22ndAve,10/26/2017 09:00:00 AM,48,-122,5,4,9
32050,58thStGreenway22ndAve,10/26/2017 10:00:00 AM,48,-122,1,1,2
32051,58thStGreenway22ndAve,10/26/2017 11:00:00 AM,48,-122,11,2,13
32052,58thStGreenway22ndAve,10/26/2017 12:00:00 PM,48,-122,0,1,1
32053,58thStGreenway22ndAve,10/26/2017 01:00:00 PM,48,-122,4,8,12
32054,58thStGreenway22ndAve,10/26/2017 02:00:00 PM,48,-122,7,2,9
32055,58thStGreenway22ndAve,10/26/2017 03:00:00 PM,48,-122,11,4,15
32056,58thStGreenway22ndAve,10/26/2017 04:00:00 PM,48,-122,11,14,25
32057,58thStGreenway22ndAve,10/26/2017 05:00:00 PM,48,-122,15,10,25
32058,58thStGreenway22ndAve,10/26/2017 06:00:00 PM,48,-122,14,9,23
32059,58thStGreenway22ndAve,10/26/2017 07:00:00 PM,48,-122,5,5,10
32060,58thStGreenway22ndAve,10/26/2017 08:00:00 PM,48,-122,2,2,4
32061,58thStGreenway22ndAve,10/26/2017 09:00:00 PM,48,-122,1,0,1
32062,58thStGreenway22ndAve,10/26/2017 10:00:00 PM,48,-122,0,3,3
32063,58thStGreenway22ndAve,10/26/2017 11:00:00 PM,48,-122,1,0,1
32064,58thStGreenway22ndAve,10/27/2017 12:00:00 AM,48,-122,0,0,0
32065,58thStGreenway22ndAve,10/27/2017 01:00:00 AM,48,-122,1,0,1
32066,58thStGreenway22ndAve,10/27/2017 02:00:00 AM,48,-122,0,0,0
32067,58thStGreenway22ndAve,10/27/2017 03:00:00 AM,48,-122,0,0,0
32068,58thStGreenway22ndAve,10/27/2017 04:00:00 AM,48,-122,0,0,0
32069,58thStGreenway22ndAve,10/27/2017 05:00:00 AM,48,-122,0,1,1
32070,58thStGreenway22ndAve,10/27/2017 06:00:00 AM,48,-122,3,1,4
32071,58thStGreenway22ndAve,10/27/2017 07:00:00 AM,48,-122,0,8,8
32072,58thStGreenway22ndAve,10/27/2017 08:00:00 AM,48,-122,4,3,7
32073,58thStGreenway22ndAve,10/27/2017 09:00:00 AM,48,-122,6,2,8
32074,58thStGreenway22ndAve,10/27/2017 10:00:00 AM,48,-122,9,4,13
32075,58thStGreenway22ndAve,10/27/2017 11:00:00 AM,48,-122,5,2,7
32076,58thStGreenway22ndAve,10/27/2017 12:00:00 PM,48,-122,5,0,5
32077,58thStGreenway22ndAve,10/27/2017 01:00:00 PM,48,-122,3,0,3
32078,58thStGreenway22ndAve,10/27/2017 02:00:00 PM,48,-122,5,3,8
32079,58thStGreenway22ndAve,10/27/2017 03:00:00 PM,48,-122,13,8,21
32080,58thStGreenway22ndAve,10/27/2017 04:00:00 PM,48,-122,6,8,14
32081,58thStGreenway22ndAve,10/27/2017 05:00:00 PM,48,-122,3,6,9
32082,58thStGreenway22ndAve,10/27/2017 06:00:00 PM,48,-122,10,2,12
32083,58thStGreenway22ndAve,10/27/2017 07:00:00 PM,48,-122,5,3,8
32084,58thStGreenway22ndAve,10/27/2017 08:00:00 PM,48,-122,6,1,7
32085,58thStGreenway22ndAve,10/27/2017 09:00:00 PM,48,-122,3,2,5
32086,58thStGreenway22ndAve,10/27/2017 10:00:00 PM,48,-122,0,0,0
32087,58thStGreenway22ndAve,10/27/2017 11:00:00 PM,48,-122,1,1,2
32088,58thStGreenway22ndAve,10/28/2017 12:00:00 AM,48,-122,0,0,0
32089,58thStGreenway22ndAve,10/28/2017 01:00:00 AM,48,-122,2,1,3
32090,58thStGreenway22ndAve,10/28/2017 02:00:00 AM,48,-122,0,0,0
32091,58thStGreenway22ndAve,10/28/2017 03:00:00 AM,48,-122,0,0,0
32092,58thStGreenway22ndAve,10/28/2017 04:00:00 AM,48,-122,0,0,0
32093,58thStGreenway22ndAve,10/28/2017 05:00:00 AM,48,-122,0,0,0
32094,58thStGreenway22ndAve,10/28/2017 06:00:00 AM,48,-122,0,0,0
32095,58thStGreenway22ndAve,10/28/2017 07:00:00 AM,48,-122,1,2,3
32096,58thStGreenway22ndAve,10/28/2017 08:00:00 AM,48,-122,0,2,2
32097,58thStGreenway22ndAve,10/28/2017 09:00:00 AM,48,-122,3,5,8
32098,58thStGreenway22ndAve,10/28/2017 10:00:00 AM,48,-122,5,3,8
32099,58thStGreenway22ndAve,10/28/2017 11:00:00 AM,48,-122,8,3,11
32100,58thStGreenway22ndAve,10/28/2017 12:00:00 PM,48,-122,6,12,18
32101,58thStGreenway22ndAve,10/28/2017 01:00:00 PM,48,-122,9,3,12
32102,58thStGreenway22ndAve,10/28/2017 02:00:00 PM,48,-122,10,5,15
32103,58thStGreenway22ndAve,10/28/2017 03:00:00 PM,48,-122,7,10,17
32104,58thStGreenway22ndAve,10/28/2017 04:00:00 PM,48,-122,6,3,9
32105,58thStGreenway22ndAve,10/28/2017 05:00:00 PM,48,-122,6,5,11
32106,58thStGreenway22ndAve,10/28/2017 06:00:00 PM,48,-122,3,6,9
32107,58thStGreenway22ndAve,10/28/2017 07:00:00 PM,48,-122,3,0,3
32108,58thStGreenway22ndAve,10/28/2017 08:00:00 PM,48,-122,1,5,6
32109,58thStGreenway22ndAve,10/28/2017 09:00:00 PM,48,-122,1,2,3
32110,58thStGreenway22ndAve,10/28/2017 10:00:00 PM,48,-122,0,1,1
32111,58thStGreenway22ndAve,10/28/2017 11:00:00 PM,48,-122,0,0,0
32112,58thStGreenway22ndAve,10/29/2017 12:00:00 AM,48,-122,0,1,1
32113,58thStGreenway22ndAve,10/29/2017 01:00:00 AM,48,-122,3,1,4
32114,58thStGreenway22ndAve,10/29/2017 02:00:00 AM,48,-122,0,0,0
32115,58thStGreenway22ndAve,10/29/2017 03:00:00 AM,48,-122,0,0,0
32116,58thStGreenway22ndAve,10/29/2017 04:00:00 AM,48,-122,0,0,0
32117,58thStGreenway22ndAve,10/29/2017 05:00:00 AM,48,-122,0,0,0
32118,58thStGreenway22ndAve,10/29/2017 06:00:00 AM,48,-122,0,0,0
32119,58thStGreenway22ndAve,10/29/2017 07:00:00 AM,48,-122,1,1,2
32120,58thStGreenway22ndAve,10/29/2017 08:00:00 AM,48,-122,1,2,3
32121,58thStGreenway22ndAve,10/29/2017 09:00:00 AM,48,-122,2,6,8
32122,58thStGreenway22ndAve,10/29/2017 10:00:00 AM,48,-122,7,1,8
32123,58thStGreenway22ndAve,10/29/2017 11:00:00 AM,48,-122,8,6,14
32124,58thStGreenway22ndAve,10/29/2017 12:00:00 PM,48,-122,5,10,15
32125,58thStGreenway22ndAve,10/29/2017 01:00:00 PM,48,-122,10,5,15
32126,58thStGreenway22ndAve,10/29/2017 02:00:00 PM,48,-122,13,11,24
32127,58thStGreenway22ndAve,10/29/2017 03:00:00 PM,48,-122,6,12,18
32128,58thStGreenway22ndAve,10/29/2017 04:00:00 PM,48,-122,10,10,20
32129,58thStGreenway22ndAve,10/29/2017 05:00:00 PM,48,-122,9,1,10
32130,58thStGreenway22ndAve,10/29/2017 06:00:00 PM,48,-122,2,1,3
32131,58thStGreenway22ndAve,10/29/2017 07:00:00 PM,48,-122,1,0,1
32132,58thStGreenway22ndAve,10/29/2017 08:00:00 PM,48,-122,1,1,2
32133,58thStGreenway22ndAve,10/29/2017 09:00:00 PM,48,-122,1,1,2
32134,58thStGreenway22ndAve,10/29/2017 10:00:00 PM,48,-122,0,1,1
32135,58thStGreenway22ndAve,10/29/2017 11:00:00 PM,48,-122,1,2,3
32136,58thStGreenway22ndAve,10/30/2017 12:00:00 AM,48,-122,0,0,0
32137,58thStGreenway22ndAve,10/30/2017 01:00:00 AM,48,-122,0,0,0
32138,58thStGreenway22ndAve,10/30/2017 02:00:00 AM,48,-122,0,0,0
32139,58thStGreenway22ndAve,10/30/2017 03:00:00 AM,48,-122,0,0,0
32140,58thStGreenway22ndAve,10/30/2017 04:00:00 AM,48,-122,0,0,0
32141,58thStGreenway22ndAve,10/30/2017 05:00:00 AM,48,-122,0,1,1
32142,58thStGreenway22ndAve,10/30/2017 06:00:00 AM,48,-122,0,2,2
32143,58thStGreenway22ndAve,10/30/2017 07:00:00 AM,48,-122,5,3,8
32144,58thStGreenway22ndAve,10/30/2017 08:00:00 AM,48,-122,3,6,9
32145,58thStGreenway22ndAve,10/30/2017 09:00:00 AM,48,-122,5,3,8
32146,58thStGreenway22ndAve,10/30/2017 10:00:00 AM,48,-122,3,4,7
32147,58thStGreenway22ndAve,10/30/2017 11:00:00 AM,48,-122,6,1,7
32148,58thStGreenway22ndAve,10/30/2017 12:00:00 PM,48,-122,7,2,9
32149,58thStGreenway22ndAve,10/30/2017 01:00:00 PM,48,-122,7,3,10
32150,58thStGreenway22ndAve,10/30/2017 02:00:00 PM,48,-122,6,0,6
32151,58thStGreenway22ndAve,10/30/2017 03:00:00 PM,48,-122,8,2,10
32152,58thStGreenway22ndAve,10/30/2017 04:00:00 PM,48,-122,7,4,11
32153,58thStGreenway22ndAve,10/30/2017 05:00:00 PM,48,-122,13,7,20
32154,58thStGreenway22ndAve,10/30/2017 06:00:00 PM,48,-122,14,9,23
32155,58thStGreenway22ndAve,10/30/2017 07:00:00 PM,48,-122,2,2,4
32156,58thStGreenway22ndAve,10/30/2017 08:00:00 PM,48,-122,1,1,2
32157,58thStGreenway22ndAve,10/30/2017 09:00:00 PM,48,-122,0,2,2
32158,58thStGreenway22ndAve,10/30/2017 10:00:00 PM,48,-122,0,0,0
32159,58thStGreenway22ndAve,10/30/2017 11:00:00 PM,48,-122,0,0,0
32160,58thStGreenway22ndAve,10/31/2017 12:00:00 AM,48,-122,0,0,0
32161,58thStGreenway22ndAve,10/31/2017 01:00:00 AM,48,-122,0,0,0
32162,58thStGreenway22ndAve,10/31/2017 02:00:00 AM,48,-122,0,0,0
32163,58thStGreenway22ndAve,10/31/2017 03:00:00 AM,48,-122,0,0,0
32164,58thStGreenway22ndAve,10/31/2017 04:00:00 AM,48,-122,0,0,0
32165,58thStGreenway22ndAve,10/31/2017 05:00:00 AM,48,-122,1,0,1
32166,58thStGreenway22ndAve,10/31/2017 06:00:00 AM,48,-122,0,1,1
32167,58thStGreenway22ndAve,10/31/2017 07:00:00 AM,48,-122,3,6,9
32168,58thStGreenway22ndAve,10/31/2017 08:00:00 AM,48,-122,5,0,5
32169,58thStGreenway22ndAve,10/31/2017 09:00:00 AM,48,-122,3,4,7
32170,58thStGreenway22ndAve,10/31/2017 10:00:00 AM,48,-122,2,5,7
32171,58thStGreenway22ndAve,10/31/2017 11:00:00 AM,48,-122,6,2,8
32172,58thStGreenway22ndAve,10/31/2017 12:00:00 PM,48,-122,1,4,5
32173,58thStGreenway22ndAve,10/31/2017 01:00:00 PM,48,-122,6,8,14
32174,58thStGreenway22ndAve,10/31/2017 02:00:00 PM,48,-122,3,4,7
32175,58thStGreenway22ndAve,10/31/2017 03:00:00 PM,48,-122,6,2,8
32176,58thStGreenway22ndAve,10/31/2017 04:00:00 PM,48,-122,4,4,8
32177,58thStGreenway22ndAve,10/31/2017 05:00:00 PM,48,-122,4,10,14
32178,58thStGreenway22ndAve,10/31/2017 06:00:00 PM,48,-122,4,3,7
32179,58thStGreenway22ndAve,10/31/2017 07:00:00 PM,48,-122,3,2,5
32180,58thStGreenway22ndAve,10/31/2017 08:00:00 PM,48,-122,2,3,5
32181,58thStGreenway22ndAve,10/31/2017 09:00:00 PM,48,-122,0,2,2
32182,58thStGreenway22ndAve,10/31/2017 10:00:00 PM,48,-122,1,2,3
32183,58thStGreenway22ndAve,10/31/2017 11:00:00 PM,48,-122,1,0,1
32184,58thStGreenway22ndAve,11/01/2017 12:00:00 AM,48,-122,0,1,1
32185,58thStGreenway22ndAve,11/01/2017 01:00:00 AM,48,-122,0,0,0
32186,58thStGreenway22ndAve,11/01/2017 02:00:00 AM,48,-122,0,0,0
32187,58thStGreenway22ndAve,11/01/2017 03:00:00 AM,48,-122,0,0,0
32188,58thStGreenway22ndAve,11/01/2017 04:00:00 AM,48,-122,1,1,2
32189,58thStGreenway22ndAve,11/01/2017 05:00:00 AM,48,-122,1,0,1
32190,58thStGreenway22ndAve,11/01/2017 06:00:00 AM,48,-122,2,0,2
32191,58thStGreenway22ndAve,11/01/2017 07:00:00 AM,48,-122,1,1,2
32192,58thStGreenway22ndAve,11/01/2017 08:00:00 AM,48,-122,3,1,4
32193,58thStGreenway22ndAve,11/01/2017 09:00:00 AM,48,-122,3,2,5
32194,58thStGreenway22ndAve,11/01/2017 10:00:00 AM,48,-122,4,1,5
32195,58thStGreenway22ndAve,11/01/2017 11:00:00 AM,48,-122,5,1,6
32196,58thStGreenway22ndAve,11/01/2017 12:00:00 PM,48,-122,4,2,6
32197,58thStGreenway22ndAve,11/01/2017 01:00:00 PM,48,-122,7,2,9
32198,58thStGreenway22ndAve,11/01/2017 02:00:00 PM,48,-122,6,6,12
32199,58thStGreenway22ndAve,11/01/2017 03:00:00 PM,48,-122,5,5,10
32200,58thStGreenway22ndAve,11/01/2017 04:00:00 PM,48,-122,7,1,8
32201,58thStGreenway22ndAve,11/01/2017 05:00:00 PM,48,-122,5,6,11
32202,58thStGreenway22ndAve,11/01/2017 06:00:00 PM,48,-122,4,9,13
32203,58thStGreenway22ndAve,11/01/2017 07:00:00 PM,48,-122,1,3,4
32204,58thStGreenway22ndAve,11/01/2017 08:00:00 PM,48,-122,1,2,3
32205,58thStGreenway22ndAve,11/01/2017 09:00:00 PM,48,-122,0,0,0
32206,58thStGreenway22ndAve,11/01/2017 10:00:00 PM,48,-122,0,1,1
32207,58thStGreenway22ndAve,11/01/2017 11:00:00 PM,48,-122,2,0,2
32208,58thStGreenway22ndAve,11/02/2017 12:00:00 AM,48,-122,0,0,0
32209,58thStGreenway22ndAve,11/02/2017 01:00:00 AM,48,-122,1,0,1
32210,58thStGreenway22ndAve,11/02/2017 02:00:00 AM,48,-122,0,0,0
32211,58thStGreenway22ndAve,11/02/2017 03:00:00 AM,48,-122,0,0,0
32212,58thStGreenway22ndAve,11/02/2017 04:00:00 AM,48,-122,0,0,0
32213,58thStGreenway22ndAve,11/02/2017 05:00:00 AM,48,-122,0,0,0
32214,58thStGreenway22ndAve,11/02/2017 06:00:00 AM,48,-122,1,0,1
32215,58thStGreenway22ndAve,11/02/2017 07:00:00 AM,48,-122,0,1,1
32216,58thStGreenway22ndAve,11/02/2017 08:00:00 AM,48,-122,2,2,4
32217,58thStGreenway22ndAve,11/02/2017 09:00:00 AM,48,-122,8,0,8
32218,58thStGreenway22ndAve,11/02/2017 10:00:00 AM,48,-122,6,6,12
32219,58thStGreenway22ndAve,11/02/2017 11:00:00 AM,48,-122,3,2,5
32220,58thStGreenway22ndAve,11/02/2017 12:00:00 PM,48,-122,2,5,7
32221,58thStGreenway22ndAve,11/02/2017 01:00:00 PM,48,-122,4,3,7
32222,58thStGreenway22ndAve,11/02/2017 02:00:00 PM,48,-122,1,5,6
32223,58thStGreenway22ndAve,11/02/2017 03:00:00 PM,48,-122,5,2,7
32224,58thStGreenway22ndAve,11/02/2017 04:00:00 PM,48,-122,4,4,8
32225,58thStGreenway22ndAve,11/02/2017 05:00:00 PM,48,-122,7,4,11
32226,58thStGreenway22ndAve,11/02/2017 06:00:00 PM,48,-122,3,11,14
32227,58thStGreenway22ndAve,11/02/2017 07:00:00 PM,48,-122,2,6,8
32228,58thStGreenway22ndAve,11/02/2017 08:00:00 PM,48,-122,4,2,6
32229,58thStGreenway22ndAve,11/02/2017 09:00:00 PM,48,-122,0,1,1
32230,58thStGreenway22ndAve,11/02/2017 10:00:00 PM,48,-122,0,1,1
32231,58thStGreenway22ndAve,11/02/2017 11:00:00 PM,48,-122,2,2,4
32232,58thStGreenway22ndAve,11/03/2017 12:00:00 AM,48,-122,3,1,4
32233,58thStGreenway22ndAve,11/03/2017 01:00:00 AM,48,-122,0,0,0
32234,58thStGreenway22ndAve,11/03/2017 02:00:00 AM,48,-122,0,0,0
32235,58thStGreenway22ndAve,11/03/2017 03:00:00 AM,48,-122,1,0,1
32236,58thStGreenway22ndAve,11/03/2017 04:00:00 AM,48,-122,1,1,2
32237,58thStGreenway22ndAve,11/03/2017 05:00:00 AM,48,-122,0,0,0
32238,58thStGreenway22ndAve,11/03/2017 06:00:00 AM,48,-122,0,1,1
32239,58thStGreenway22ndAve,11/03/2017 07:00:00 AM,48,-122,1,3,4
32240,58thStGreenway22ndAve,11/03/2017 08:00:00 AM,48,-122,5,3,8
32241,58thStGreenway22ndAve,11/03/2017 09:00:00 AM,48,-122,10,3,13
32242,58thStGreenway22ndAve,11/03/2017 10:00:00 AM,48,-122,4,0,4
32243,58thStGreenway22ndAve,11/03/2017 11:00:00 AM,48,-122,7,1,8
32244,58thStGreenway22ndAve,11/03/2017 12:00:00 PM,48,-122,3,2,5
32245,58thStGreenway22ndAve,11/03/2017 01:00:00 PM,48,-122,7,2,9
32246,58thStGreenway22ndAve,11/03/2017 02:00:00 PM,48,-122,5,2,7
32247,58thStGreenway22ndAve,11/03/2017 03:00:00 PM,48,-122,4,4,8
32248,58thStGreenway22ndAve,11/03/2017 04:00:00 PM,48,-122,7,5,12
32249,58thStGreenway22ndAve,11/03/2017 05:00:00 PM,48,-122,8,1,9
32250,58thStGreenway22ndAve,11/03/2017 06:00:00 PM,48,-122,5,4,9
32251,58thStGreenway22ndAve,11/03/2017 07:00:00 PM,48,-122,7,1,8
32252,58thStGreenway22ndAve,11/03/2017 08:00:00 PM,48,-122,4,4,8
32253,58thStGreenway22ndAve,11/03/2017 09:00:00 PM,48,-122,0,1,1
32254,58thStGreenway22ndAve,11/03/2017 10:00:00 PM,48,-122,1,1,2
32255,58thStGreenway22ndAve,11/03/2017 11:00:00 PM,48,-122,0,0,0
32256,58thStGreenway22ndAve,11/04/2017 12:00:00 AM,48,-122,1,1,2
32257,58thStGreenway22ndAve,11/04/2017 01:00:00 AM,48,-122,1,0,1
32258,58thStGreenway22ndAve,11/04/2017 02:00:00 AM,48,-122,0,0,0
32259,58thStGreenway22ndAve,11/04/2017 03:00:00 AM,48,-122,0,0,0
32260,58thStGreenway22ndAve,11/04/2017 04:00:00 AM,48,-122,0,0,0
32261,58thStGreenway22ndAve,11/04/2017 05:00:00 AM,48,-122,1,0,1
32262,58thStGreenway22ndAve,11/04/2017 06:00:00 AM,48,-122,1,0,1
32263,58thStGreenway22ndAve,11/04/2017 07:00:00 AM,48,-122,2,0,2
32264,58thStGreenway22ndAve,11/04/2017 08:00:00 AM,48,-122,1,1,2
32265,58thStGreenway22ndAve,11/04/2017 09:00:00 AM,48,-122,4,2,6
32266,58thStGreenway22ndAve,11/04/2017 10:00:00 AM,48,-122,4,1,5
32267,58thStGreenway22ndAve,11/04/2017 11:00:00 AM,48,-122,7,2,9
32268,58thStGreenway22ndAve,11/04/2017 12:00:00 PM,48,-122,8,4,12
32269,58thStGreenway22ndAve,11/04/2017 01:00:00 PM,48,-122,6,4,10
32270,58thStGreenway22ndAve,11/04/2017 02:00:00 PM,48,-122,9,3,12
32271,58thStGreenway22ndAve,11/04/2017 03:00:00 PM,48,-122,2,2,4
32272,58thStGreenway22ndAve,11/04/2017 04:00:00 PM,48,-122,1,4,5
32273,58thStGreenway22ndAve,11/04/2017 05:00:00 PM,48,-122,3,0,3
32274,58thStGreenway22ndAve,11/04/2017 06:00:00 PM,48,-122,5,1,6
32275,58thStGreenway22ndAve,11/04/2017 07:00:00 PM,48,-122,1,1,2
32276,58thStGreenway22ndAve,11/04/2017 08:00:00 PM,48,-122,1,1,2
32277,58thStGreenway22ndAve,11/04/2017 09:00:00 PM,48,-122,0,0,0
32278,58thStGreenway22ndAve,11/04/2017 10:00:00 PM,48,-122,2,0,2
32279,58thStGreenway22ndAve,11/04/2017 11:00:00 PM,48,-122,0,0,0
32280,58thStGreenway22ndAve,11/05/2017 12:00:00 AM,48,-122,0,0,0
32281,58thStGreenway22ndAve,11/05/2017 01:00:00 AM,48,-122,0,1,1
32282,58thStGreenway22ndAve,11/05/2017 02:00:00 AM,48,-122,0,1,1
32283,58thStGreenway22ndAve,11/05/2017 03:00:00 AM,48,-122,0,0,0
32284,58thStGreenway22ndAve,11/05/2017 04:00:00 AM,48,-122,0,0,0
32285,58thStGreenway22ndAve,11/05/2017 05:00:00 AM,48,-122,0,0,0
32286,58thStGreenway22ndAve,11/05/2017 06:00:00 AM,48,-122,0,0,0
32287,58thStGreenway22ndAve,11/05/2017 07:00:00 AM,48,-122,0,0,0
32288,58thStGreenway22ndAve,11/05/2017 08:00:00 AM,48,-122,1,0,1
32289,58thStGreenway22ndAve,11/05/2017 09:00:00 AM,48,-122,0,0,0
32290,58thStGreenway22ndAve,11/05/2017 10:00:00 AM,48,-122,0,1,1
32291,58thStGreenway22ndAve,11/05/2017 11:00:00 AM,48,-122,0,0,0
32292,58thStGreenway22ndAve,11/05/2017 12:00:00 PM,48,-122,0,0,0
32293,58thStGreenway22ndAve,11/05/2017 01:00:00 PM,48,-122,0,0,0
32294,58thStGreenway22ndAve,11/05/2017 02:00:00 PM,48,-122,0,0,0
32295,58thStGreenway22ndAve,11/05/2017 03:00:00 PM,48,-122,2,1,3
32296,58thStGreenway22ndAve,11/05/2017 04:00:00 PM,48,-122,5,1,6
32297,58thStGreenway22ndAve,11/05/2017 05:00:00 PM,48,-122,3,2,5
32298,58thStGreenway22ndAve,11/05/2017 06:00:00 PM,48,-122,2,0,2
32299,58thStGreenway22ndAve,11/05/2017 07:00:00 PM,48,-122,0,1,1
32300,58thStGreenway22ndAve,11/05/2017 08:00:00 PM,48,-122,1,0,1
32301,58thStGreenway22ndAve,11/05/2017 09:00:00 PM,48,-122,0,0,0
32302,58thStGreenway22ndAve,11/05/2017 10:00:00 PM,48,-122,0,0,0
32303,58thStGreenway22ndAve,11/05/2017 11:00:00 PM,48,-122,0,0,0
32304,58thStGreenway22ndAve,11/06/2017 12:00:00 AM,48,-122,0,0,0
32305,58thStGreenway22ndAve,11/06/2017 01:00:00 AM,48,-122,0,0,0
32306,58thStGreenway22ndAve,11/06/2017 02:00:00 AM,48,-122,0,0,0
32307,58thStGreenway22ndAve,11/06/2017 03:00:00 AM,48,-122,0,0,0
32308,58thStGreenway22ndAve,11/06/2017 04:00:00 AM,48,-122,0,0,0
32309,58thStGreenway22ndAve,11/06/2017 05:00:00 AM,48,-122,1,1,2
32310,58thStGreenway22ndAve,11/06/2017 06:00:00 AM,48,-122,4,1,5
32311,58thStGreenway22ndAve,11/06/2017 07:00:00 AM,48,-122,1,3,4
32312,58thStGreenway22ndAve,11/06/2017 08:00:00 AM,48,-122,4,1,5
32313,58thStGreenway22ndAve,11/06/2017 09:00:00 AM,48,-122,3,0,3
32314,58thStGreenway22ndAve,11/06/2017 10:00:00 AM,48,-122,3,3,6
32315,58thStGreenway22ndAve,11/06/2017 11:00:00 AM,48,-122,4,0,4
32316,58thStGreenway22ndAve,11/06/2017 12:00:00 PM,48,-122,2,1,3
32317,58thStGreenway22ndAve,11/06/2017 01:00:00 PM,48,-122,6,0,6
32318,58thStGreenway22ndAve,11/06/2017 02:00:00 PM,48,-122,6,2,8
32319,58thStGreenway22ndAve,11/06/2017 03:00:00 PM,48,-122,2,3,5
32320,58thStGreenway22ndAve,11/06/2017 04:00:00 PM,48,-122,1,4,5
32321,58thStGreenway22ndAve,11/06/2017 05:00:00 PM,48,-122,4,5,9
32322,58thStGreenway22ndAve,11/06/2017 06:00:00 PM,48,-122,6,3,9
32323,58thStGreenway22ndAve,11/06/2017 07:00:00 PM,48,-122,4,4,8
32324,58thStGreenway22ndAve,11/06/2017 08:00:00 PM,48,-122,4,6,10
32325,58thStGreenway22ndAve,11/06/2017 09:00:00 PM,48,-122,0,0,0
32326,58thStGreenway22ndAve,11/06/2017 10:00:00 PM,48,-122,2,2,4
32327,58thStGreenway22ndAve,11/06/2017 11:00:00 PM,48,-122,0,1,1
32328,58thStGreenway22ndAve,11/07/2017 12:00:00 AM,48,-122,0,2,2
32329,58thStGreenway22ndAve,11/07/2017 01:00:00 AM,48,-122,0,0,0
32330,58thStGreenway22ndAve,11/07/2017 02:00:00 AM,48,-122,0,0,0
32331,58thStGreenway22ndAve,11/07/2017 03:00:00 AM,48,-122,0,1,1
32332,58thStGreenway22ndAve,11/07/2017 04:00:00 AM,48,-122,0,0,0
32333,58thStGreenway22ndAve,11/07/2017 05:00:00 AM,48,-122,0,1,1
32334,58thStGreenway22ndAve,11/07/2017 06:00:00 AM,48,-122,0,3,3
32335,58thStGreenway22ndAve,11/07/2017 07:00:00 AM,48,-122,6,3,9
32336,58thStGreenway22ndAve,11/07/2017 08:00:00 AM,48,-122,12,3,15
32337,58thStGreenway22ndAve,11/07/2017 09:00:00 AM,48,-122,12,4,16
32338,58thStGreenway22ndAve,11/07/2017 10:00:00 AM,48,-122,5,1,6
32339,58thStGreenway22ndAve,11/07/2017 11:00:00 AM,48,-122,13,2,15
32340,58thStGreenway22ndAve,11/07/2017 12:00:00 PM,48,-122,5,5,10
32341,58thStGreenway22ndAve,11/07/2017 01:00:00 PM,48,-122,5,1,6
32342,58thStGreenway22ndAve,11/07/2017 02:00:00 PM,48,-122,8,3,11
32343,58thStGreenway22ndAve,11/07/2017 03:00:00 PM,48,-122,7,1,8
32344,58thStGreenway22ndAve,11/07/2017 04:00:00 PM,48,-122,9,4,13
32345,58thStGreenway22ndAve,11/07/2017 05:00:00 PM,48,-122,25,3,28
32346,58thStGreenway22ndAve,11/07/2017 06:00:00 PM,48,-122,16,8,24
32347,58thStGreenway22ndAve,11/07/2017 07:00:00 PM,48,-122,19,6,25
32348,58thStGreenway22ndAve,11/07/2017 08:00:00 PM,48,-122,2,3,5
32349,58thStGreenway22ndAve,11/07/2017 09:00:00 PM,48,-122,0,3,3
32350,58thStGreenway22ndAve,11/07/2017 10:00:00 PM,48,-122,0,1,1
32351,58thStGreenway22ndAve,11/07/2017 11:00:00 PM,48,-122,0,0,0
32352,58thStGreenway22ndAve,11/08/2017 12:00:00 AM,48,-122,0,0,0
32353,58thStGreenway22ndAve,11/08/2017 01:00:00 AM,48,-122,3,0,3
32354,58thStGreenway22ndAve,11/08/2017 02:00:00 AM,48,-122,0,0,0
32355,58thStGreenway22ndAve,11/08/2017 03:00:00 AM,48,-122,0,0,0
32356,58thStGreenway22ndAve,11/08/2017 04:00:00 AM,48,-122,0,0,0
32357,58thStGreenway22ndAve,11/08/2017 05:00:00 AM,48,-122,1,2,3
32358,58thStGreenway22ndAve,11/08/2017 06:00:00 AM,48,-122,1,1,2
32359,58thStGreenway22ndAve,11/08/2017 07:00:00 AM,48,-122,2,5,7
32360,58thStGreenway22ndAve,11/08/2017 08:00:00 AM,48,-122,0,0,0
32361,58thStGreenway22ndAve,11/08/2017 09:00:00 AM,48,-122,5,2,7
32362,58thStGreenway22ndAve,11/08/2017 10:00:00 AM,48,-122,7,1,8
32363,58thStGreenway22ndAve,11/08/2017 11:00:00 AM,48,-122,3,5,8
32364,58thStGreenway22ndAve,11/08/2017 12:00:00 PM,48,-122,3,1,4
32365,58thStGreenway22ndAve,11/08/2017 01:00:00 PM,48,-122,6,2,8
32366,58thStGreenway22ndAve,11/08/2017 02:00:00 PM,48,-122,3,1,4
32367,58thStGreenway22ndAve,11/08/2017 03:00:00 PM,48,-122,4,2,6
32368,58thStGreenway22ndAve,11/08/2017 04:00:00 PM,48,-122,2,4,6
32369,58thStGreenway22ndAve,11/08/2017 05:00:00 PM,48,-122,3,2,5
32370,58thStGreenway22ndAve,11/08/2017 06:00:00 PM,48,-122,2,2,4
32371,58thStGreenway22ndAve,11/08/2017 07:00:00 PM,48,-122,5,3,8
32372,58thStGreenway22ndAve,11/08/2017 08:00:00 PM,48,-122,2,2,4
32373,58thStGreenway22ndAve,11/08/2017 09:00:00 PM,48,-122,2,0,2
32374,58thStGreenway22ndAve,11/08/2017 10:00:00 PM,48,-122,0,0,0
32375,58thStGreenway22ndAve,11/08/2017 11:00:00 PM,48,-122,0,1,1
32376,58thStGreenway22ndAve,11/09/2017 12:00:00 AM,48,-122,0,0,0
32377,58thStGreenway22ndAve,11/09/2017 01:00:00 AM,48,-122,0,0,0
32378,58thStGreenway22ndAve,11/09/2017 02:00:00 AM,48,-122,1,0,1
32379,58thStGreenway22ndAve,11/09/2017 03:00:00 AM,48,-122,0,0,0
32380,58thStGreenway22ndAve,11/09/2017 04:00:00 AM,48,-122,0,0,0
32381,58thStGreenway22ndAve,11/09/2017 05:00:00 AM,48,-122,0,0,0
32382,58thStGreenway22ndAve,11/09/2017 06:00:00 AM,48,-122,2,0,2
32383,58thStGreenway22ndAve,11/09/2017 07:00:00 AM,48,-122,2,3,5
32384,58thStGreenway22ndAve,11/09/2017 08:00:00 AM,48,-122,4,2,6
32385,58thStGreenway22ndAve,11/09/2017 09:00:00 AM,48,-122,6,1,7
32386,58thStGreenway22ndAve,11/09/2017 10:00:00 AM,48,-122,1,1,2
32387,58thStGreenway22ndAve,11/09/2017 11:00:00 AM,48,-122,5,2,7
32388,58thStGreenway22ndAve,11/09/2017 12:00:00 PM,48,-122,4,1,5
32389,58thStGreenway22ndAve,11/09/2017 01:00:00 PM,48,-122,2,3,5
32390,58thStGreenway22ndAve,11/09/2017 02:00:00 PM,48,-122,1,1,2
32391,58thStGreenway22ndAve,11/09/2017 03:00:00 PM,48,-122,4,3,7
32392,58thStGreenway22ndAve,11/09/2017 04:00:00 PM,48,-122,4,6,10
32393,58thStGreenway22ndAve,11/09/2017 05:00:00 PM,48,-122,5,5,10
32394,58thStGreenway22ndAve,11/09/2017 06:00:00 PM,48,-122,7,2,9
32395,58thStGreenway22ndAve,11/09/2017 07:00:00 PM,48,-122,3,2,5
32396,58thStGreenway22ndAve,11/09/2017 08:00:00 PM,48,-122,7,2,9
32397,58thStGreenway22ndAve,11/09/2017 09:00:00 PM,48,-122,0,1,1
32398,58thStGreenway22ndAve,11/09/2017 10:00:00 PM,48,-122,0,0,0
32399,58thStGreenway22ndAve,11/09/2017 11:00:00 PM,48,-122,0,0,0
32400,58thStGreenway22ndAve,11/10/2017 12:00:00 AM,48,-122,0,0,0
32401,58thStGreenway22ndAve,11/10/2017 01:00:00 AM,48,-122,0,0,0
32402,58thStGreenway22ndAve,11/10/2017 02:00:00 AM,48,-122,0,0,0
32403,58thStGreenway22ndAve,11/10/2017 03:00:00 AM,48,-122,0,0,0
32404,58thStGreenway22ndAve,11/10/2017 04:00:00 AM,48,-122,0,0,0
32405,58thStGreenway22ndAve,11/10/2017 05:00:00 AM,48,-122,0,0,0
32406,58thStGreenway22ndAve,11/10/2017 06:00:00 AM,48,-122,2,1,3
32407,58thStGreenway22ndAve,11/10/2017 07:00:00 AM,48,-122,4,2,6
32408,58thStGreenway22ndAve,11/10/2017 08:00:00 AM,48,-122,4,0,4
32409,58thStGreenway22ndAve,11/10/2017 09:00:00 AM,48,-122,6,1,7
32410,58thStGreenway22ndAve,11/10/2017 10:00:00 AM,48,-122,6,1,7
32411,58thStGreenway22ndAve,11/10/2017 11:00:00 AM,48,-122,7,3,10
32412,58thStGreenway22ndAve,11/10/2017 12:00:00 PM,48,-122,8,2,10
32413,58thStGreenway22ndAve,11/10/2017 01:00:00 PM,48,-122,13,5,18
32414,58thStGreenway22ndAve,11/10/2017 02:00:00 PM,48,-122,5,7,12
32415,58thStGreenway22ndAve,11/10/2017 03:00:00 PM,48,-122,6,1,7
32416,58thStGreenway22ndAve,11/10/2017 04:00:00 PM,48,-122,6,3,9
32417,58thStGreenway22ndAve,11/10/2017 05:00:00 PM,48,-122,2,3,5
32418,58thStGreenway22ndAve,11/10/2017 06:00:00 PM,48,-122,2,3,5
32419,58thStGreenway22ndAve,11/10/2017 07:00:00 PM,48,-122,5,2,7
32420,58thStGreenway22ndAve,11/10/2017 08:00:00 PM,48,-122,4,1,5
32421,58thStGreenway22ndAve,11/10/2017 09:00:00 PM,48,-122,0,1,1
32422,58thStGreenway22ndAve,11/10/2017 10:00:00 PM,48,-122,0,0,0
32423,58thStGreenway22ndAve,11/10/2017 11:00:00 PM,48,-122,4,0,4
32424,58thStGreenway22ndAve,11/11/2017 12:00:00 AM,48,-122,1,0,1
32425,58thStGreenway22ndAve,11/11/2017 01:00:00 AM,48,-122,0,0,0
32426,58thStGreenway22ndAve,11/11/2017 02:00:00 AM,48,-122,0,0,0
32427,58thStGreenway22ndAve,11/11/2017 03:00:00 AM,48,-122,0,0,0
32428,58thStGreenway22ndAve,11/11/2017 04:00:00 AM,48,-122,0,0,0
32429,58thStGreenway22ndAve,11/11/2017 05:00:00 AM,48,-122,0,0,0
32430,58thStGreenway22ndAve,11/11/2017 06:00:00 AM,48,-122,0,0,0
32431,58thStGreenway22ndAve,11/11/2017 07:00:00 AM,48,-122,3,1,4
32432,58thStGreenway22ndAve,11/11/2017 08:00:00 AM,48,-122,1,1,2
32433,58thStGreenway22ndAve,11/11/2017 09:00:00 AM,48,-122,4,0,4
32434,58thStGreenway22ndAve,11/11/2017 10:00:00 AM,48,-122,4,1,5
32435,58thStGreenway22ndAve,11/11/2017 11:00:00 AM,48,-122,1,2,3
32436,58thStGreenway22ndAve,11/11/2017 12:00:00 PM,48,-122,4,4,8
32437,58thStGreenway22ndAve,11/11/2017 01:00:00 PM,48,-122,6,2,8
32438,58thStGreenway22ndAve,11/11/2017 02:00:00 PM,48,-122,2,1,3
32439,58thStGreenway22ndAve,11/11/2017 03:00:00 PM,48,-122,4,6,10
32440,58thStGreenway22ndAve,11/11/2017 04:00:00 PM,48,-122,8,1,9
32441,58thStGreenway22ndAve,11/11/2017 05:00:00 PM,48,-122,2,3,5
32442,58thStGreenway22ndAve,11/11/2017 06:00:00 PM,48,-122,2,5,7
32443,58thStGreenway22ndAve,11/11/2017 07:00:00 PM,48,-122,2,1,3
32444,58thStGreenway22ndAve,11/11/2017 08:00:00 PM,48,-122,2,1,3
32445,58thStGreenway22ndAve,11/11/2017 09:00:00 PM,48,-122,4,0,4
32446,58thStGreenway22ndAve,11/11/2017 10:00:00 PM,48,-122,0,0,0
32447,58thStGreenway22ndAve,11/11/2017 11:00:00 PM,48,-122,0,1,1
32448,58thStGreenway22ndAve,11/12/2017 12:00:00 AM,48,-122,0,0,0
32449,58thStGreenway22ndAve,11/12/2017 01:00:00 AM,48,-122,0,0,0
32450,58thStGreenway22ndAve,11/12/2017 02:00:00 AM,48,-122,0,0,0
32451,58thStGreenway22ndAve,11/12/2017 03:00:00 AM,48,-122,0,0,0
32452,58thStGreenway22ndAve,11/12/2017 04:00:00 AM,48,-122,0,0,0
32453,58thStGreenway22ndAve,11/12/2017 05:00:00 AM,48,-122,0,0,0
32454,58thStGreenway22ndAve,11/12/2017 06:00:00 AM,48,-122,1,0,1
32455,58thStGreenway22ndAve,11/12/2017 07:00:00 AM,48,-122,0,0,0
32456,58thStGreenway22ndAve,11/12/2017 08:00:00 AM,48,-122,1,0,1
32457,58thStGreenway22ndAve,11/12/2017 09:00:00 AM,48,-122,3,1,4
32458,58thStGreenway22ndAve,11/12/2017 10:00:00 AM,48,-122,1,4,5
32459,58thStGreenway22ndAve,11/12/2017 11:00:00 AM,48,-122,6,4,10
32460,58thStGreenway22ndAve,11/12/2017 12:00:00 PM,48,-122,5,4,9
32461,58thStGreenway22ndAve,11/12/2017 01:00:00 PM,48,-122,5,12,17
32462,58thStGreenway22ndAve,11/12/2017 02:00:00 PM,48,-122,8,1,9
32463,58thStGreenway22ndAve,11/12/2017 03:00:00 PM,48,-122,1,2,3
32464,58thStGreenway22ndAve,11/12/2017 04:00:00 PM,48,-122,4,2,6
32465,58thStGreenway22ndAve,11/12/2017 05:00:00 PM,48,-122,2,2,4
32466,58thStGreenway22ndAve,11/12/2017 06:00:00 PM,48,-122,3,0,3
32467,58thStGreenway22ndAve,11/12/2017 07:00:00 PM,48,-122,0,0,0
32468,58thStGreenway22ndAve,11/12/2017 08:00:00 PM,48,-122,0,0,0
32469,58thStGreenway22ndAve,11/12/2017 09:00:00 PM,48,-122,1,0,1
32470,58thStGreenway22ndAve,11/12/2017 10:00:00 PM,48,-122,0,0,0
32471,58thStGreenway22ndAve,11/12/2017 11:00:00 PM,48,-122,0,0,0
32472,58thStGreenway22ndAve,11/13/2017 12:00:00 AM,48,-122,0,0,0
32473,58thStGreenway22ndAve,11/13/2017 01:00:00 AM,48,-122,0,0,0
32474,58thStGreenway22ndAve,11/13/2017 02:00:00 AM,48,-122,0,0,0
32475,58thStGreenway22ndAve,11/13/2017 03:00:00 AM,48,-122,0,0,0
32476,58thStGreenway22ndAve,11/13/2017 04:00:00 AM,48,-122,0,0,0
32477,58thStGreenway22ndAve,11/13/2017 05:00:00 AM,48,-122,0,0,0
32478,58thStGreenway22ndAve,11/13/2017 06:00:00 AM,48,-122,3,0,3
32479,58thStGreenway22ndAve,11/13/2017 07:00:00 AM,48,-122,4,5,9
32480,58thStGreenway22ndAve,11/13/2017 08:00:00 AM,48,-122,3,0,3
32481,58thStGreenway22ndAve,11/13/2017 09:00:00 AM,48,-122,3,1,4
32482,58thStGreenway22ndAve,11/13/2017 10:00:00 AM,48,-122,3,6,9
32483,58thStGreenway22ndAve,11/13/2017 11:00:00 AM,48,-122,0,5,5
32484,58thStGreenway22ndAve,11/13/2017 12:00:00 PM,48,-122,4,4,8
32485,58thStGreenway22ndAve,11/13/2017 01:00:00 PM,48,-122,0,1,1
32486,58thStGreenway22ndAve,11/13/2017 02:00:00 PM,48,-122,3,2,5
32487,58thStGreenway22ndAve,11/13/2017 03:00:00 PM,48,-122,6,5,11
32488,58thStGreenway22ndAve,11/13/2017 04:00:00 PM,48,-122,1,4,5
32489,58thStGreenway22ndAve,11/13/2017 05:00:00 PM,48,-122,5,3,8
32490,58thStGreenway22ndAve,11/13/2017 06:00:00 PM,48,-122,5,2,7
32491,58thStGreenway22ndAve,11/13/2017 07:00:00 PM,48,-122,4,2,6
32492,58thStGreenway22ndAve,11/13/2017 08:00:00 PM,48,-122,2,2,4
32493,58thStGreenway22ndAve,11/13/2017 09:00:00 PM,48,-122,3,0,3
32494,58thStGreenway22ndAve,11/13/2017 10:00:00 PM,48,-122,0,0,0
32495,58thStGreenway22ndAve,11/13/2017 11:00:00 PM,48,-122,0,0,0
32496,58thStGreenway22ndAve,11/14/2017 12:00:00 AM,48,-122,0,0,0
32497,58thStGreenway22ndAve,11/14/2017 01:00:00 AM,48,-122,0,1,1
32498,58thStGreenway22ndAve,11/14/2017 02:00:00 AM,48,-122,0,0,0
32499,58thStGreenway22ndAve,11/14/2017 03:00:00 AM,48,-122,0,0,0
32500,58thStGreenway22ndAve,11/14/2017 04:00:00 AM,48,-122,1,2,3
32501,58thStGreenway22ndAve,11/14/2017 05:00:00 AM,48,-122,0,0,0
32502,58thStGreenway22ndAve,11/14/2017 06:00:00 AM,48,-122,1,0,1
32503,58thStGreenway22ndAve,11/14/2017 07:00:00 AM,48,-122,3,3,6
32504,58thStGreenway22ndAve,11/14/2017 08:00:00 AM,48,-122,4,0,4
32505,58thStGreenway22ndAve,11/14/2017 09:00:00 AM,48,-122,2,2,4
32506,58thStGreenway22ndAve,11/14/2017 10:00:00 AM,48,-122,7,2,9
32507,58thStGreenway22ndAve,11/14/2017 11:00:00 AM,48,-122,2,2,4
32508,58thStGreenway22ndAve,11/14/2017 12:00:00 PM,48,-122,3,5,8
32509,58thStGreenway22ndAve,11/14/2017 01:00:00 PM,48,-122,4,1,5
32510,58thStGreenway22ndAve,11/14/2017 02:00:00 PM,48,-122,4,2,6
32511,58thStGreenway22ndAve,11/14/2017 03:00:00 PM,48,-122,1,3,4
32512,58thStGreenway22ndAve,11/14/2017 04:00:00 PM,48,-122,6,3,9
32513,58thStGreenway22ndAve,11/14/2017 05:00:00 PM,48,-122,2,9,11
32514,58thStGreenway22ndAve,11/14/2017 06:00:00 PM,48,-122,8,3,11
32515,58thStGreenway22ndAve,11/14/2017 07:00:00 PM,48,-122,5,3,8
32516,58thStGreenway22ndAve,11/14/2017 08:00:00 PM,48,-122,0,5,5
32517,58thStGreenway22ndAve,11/14/2017 09:00:00 PM,48,-122,0,0,0
32518,58thStGreenway22ndAve,11/14/2017 10:00:00 PM,48,-122,0,1,1
32519,58thStGreenway22ndAve,11/14/2017 11:00:00 PM,48,-122,0,0,0
32520,58thStGreenway22ndAve,11/15/2017 12:00:00 AM,48,-122,0,0,0
32521,58thStGreenway22ndAve,11/15/2017 01:00:00 AM,48,-122,0,0,0
32522,58thStGreenway22ndAve,11/15/2017 02:00:00 AM,48,-122,0,0,0
32523,58thStGreenway22ndAve,11/15/2017 03:00:00 AM,48,-122,0,0,0
32524,58thStGreenway22ndAve,11/15/2017 04:00:00 AM,48,-122,0,0,0
32525,58thStGreenway22ndAve,11/15/2017 05:00:00 AM,48,-122,0,0,0
32526,58thStGreenway22ndAve,11/15/2017 06:00:00 AM,48,-122,1,0,1
32527,58thStGreenway22ndAve,11/15/2017 07:00:00 AM,48,-122,1,1,2
32528,58thStGreenway22ndAve,11/15/2017 08:00:00 AM,48,-122,3,2,5
32529,58thStGreenway22ndAve,11/15/2017 09:00:00 AM,48,-122,4,0,4
32530,58thStGreenway22ndAve,11/15/2017 10:00:00 AM,48,-122,2,2,4
32531,58thStGreenway22ndAve,11/15/2017 11:00:00 AM,48,-122,4,0,4
32532,58thStGreenway22ndAve,11/15/2017 12:00:00 PM,48,-122,5,1,6
32533,58thStGreenway22ndAve,11/15/2017 01:00:00 PM,48,-122,3,2,5
32534,58thStGreenway22ndAve,11/15/2017 02:00:00 PM,48,-122,2,3,5
32535,58thStGreenway22ndAve,11/15/2017 03:00:00 PM,48,-122,0,3,3
32536,58thStGreenway22ndAve,11/15/2017 04:00:00 PM,48,-122,4,3,7
32537,58thStGreenway22ndAve,11/15/2017 05:00:00 PM,48,-122,7,9,16
32538,58thStGreenway22ndAve,11/15/2017 06:00:00 PM,48,-122,3,9,12
32539,58thStGreenway22ndAve,11/15/2017 07:00:00 PM,48,-122,4,3,7
32540,58thStGreenway22ndAve,11/15/2017 08:00:00 PM,48,-122,1,1,2
32541,58thStGreenway22ndAve,11/15/2017 09:00:00 PM,48,-122,0,0,0
32542,58thStGreenway22ndAve,11/15/2017 10:00:00 PM,48,-122,0,0,0
32543,58thStGreenway22ndAve,11/15/2017 11:00:00 PM,48,-122,1,2,3
32544,58thStGreenway22ndAve,11/16/2017 12:00:00 AM,48,-122,1,1,2
32545,58thStGreenway22ndAve,11/16/2017 01:00:00 AM,48,-122,0,0,0
32546,58thStGreenway22ndAve,11/16/2017 02:00:00 AM,48,-122,0,0,0
32547,58thStGreenway22ndAve,11/16/2017 03:00:00 AM,48,-122,0,0,0
32548,58thStGreenway22ndAve,11/16/2017 04:00:00 AM,48,-122,0,0,0
32549,58thStGreenway22ndAve,11/16/2017 05:00:00 AM,48,-122,1,0,1
32550,58thStGreenway22ndAve,11/16/2017 06:00:00 AM,48,-122,0,1,1
32551,58thStGreenway22ndAve,11/16/2017 07:00:00 AM,48,-122,3,5,8
32552,58thStGreenway22ndAve,11/16/2017 08:00:00 AM,48,-122,1,4,5
32553,58thStGreenway22ndAve,11/16/2017 09:00:00 AM,48,-122,2,1,3
32554,58thStGreenway22ndAve,11/16/2017 10:00:00 AM,48,-122,5,2,7
32555,58thStGreenway22ndAve,11/16/2017 11:00:00 AM,48,-122,4,7,11
32556,58thStGreenway22ndAve,11/16/2017 12:00:00 PM,48,-122,4,2,6
32557,58thStGreenway22ndAve,11/16/2017 01:00:00 PM,48,-122,2,2,4
32558,58thStGreenway22ndAve,11/16/2017 02:00:00 PM,48,-122,4,3,7
32559,58thStGreenway22ndAve,11/16/2017 03:00:00 PM,48,-122,3,0,3
32560,58thStGreenway22ndAve,11/16/2017 04:00:00 PM,48,-122,3,3,6
32561,58thStGreenway22ndAve,11/16/2017 05:00:00 PM,48,-122,12,4,16
32562,58thStGreenway22ndAve,11/16/2017 06:00:00 PM,48,-122,3,4,7
32563,58thStGreenway22ndAve,11/16/2017 07:00:00 PM,48,-122,2,2,4
32564,58thStGreenway22ndAve,11/16/2017 08:00:00 PM,48,-122,0,1,1
32565,58thStGreenway22ndAve,11/16/2017 09:00:00 PM,48,-122,0,1,1
32566,58thStGreenway22ndAve,11/16/2017 10:00:00 PM,48,-122,0,1,1
32567,58thStGreenway22ndAve,11/16/2017 11:00:00 PM,48,-122,0,0,0
32568,58thStGreenway22ndAve,11/17/2017 12:00:00 AM,48,-122,0,1,1
32569,58thStGreenway22ndAve,11/17/2017 01:00:00 AM,48,-122,0,1,1
32570,58thStGreenway22ndAve,11/17/2017 02:00:00 AM,48,-122,0,0,0
32571,58thStGreenway22ndAve,11/17/2017 03:00:00 AM,48,-122,0,0,0
32572,58thStGreenway22ndAve,11/17/2017 04:00:00 AM,48,-122,0,0,0
32573,58thStGreenway22ndAve,11/17/2017 05:00:00 AM,48,-122,1,1,2
32574,58thStGreenway22ndAve,11/17/2017 06:00:00 AM,48,-122,1,3,4
32575,58thStGreenway22ndAve,11/17/2017 07:00:00 AM,48,-122,5,1,6
32576,58thStGreenway22ndAve,11/17/2017 08:00:00 AM,48,-122,2,8,10
32577,58thStGreenway22ndAve,11/17/2017 09:00:00 AM,48,-122,8,1,9
32578,58thStGreenway22ndAve,11/17/2017 10:00:00 AM,48,-122,8,6,14
32579,58thStGreenway22ndAve,11/17/2017 11:00:00 AM,48,-122,2,2,4
32580,58thStGreenway22ndAve,11/17/2017 12:00:00 PM,48,-122,14,2,16
32581,58thStGreenway22ndAve,11/17/2017 01:00:00 PM,48,-122,9,5,14
32582,58thStGreenway22ndAve,11/17/2017 02:00:00 PM,48,-122,6,6,12
32583,58thStGreenway22ndAve,11/17/2017 03:00:00 PM,48,-122,2,4,6
32584,58thStGreenway22ndAve,11/17/2017 04:00:00 PM,48,-122,6,6,12
32585,58thStGreenway22ndAve,11/17/2017 05:00:00 PM,48,-122,7,4,11
32586,58thStGreenway22ndAve,11/17/2017 06:00:00 PM,48,-122,6,3,9
32587,58thStGreenway22ndAve,11/17/2017 07:00:00 PM,48,-122,0,1,1
32588,58thStGreenway22ndAve,11/17/2017 08:00:00 PM,48,-122,3,4,7
32589,58thStGreenway22ndAve,11/17/2017 09:00:00 PM,48,-122,1,0,1
32590,58thStGreenway22ndAve,11/17/2017 10:00:00 PM,48,-122,0,1,1
32591,58thStGreenway22ndAve,11/17/2017 11:00:00 PM,48,-122,2,0,2
32592,58thStGreenway22ndAve,11/18/2017 12:00:00 AM,48,-122,0,0,0
32593,58thStGreenway22ndAve,11/18/2017 01:00:00 AM,48,-122,0,1,1
32594,58thStGreenway22ndAve,11/18/2017 02:00:00 AM,48,-122,0,0,0
32595,58thStGreenway22ndAve,11/18/2017 03:00:00 AM,48,-122,0,0,0
32596,58thStGreenway22ndAve,11/18/2017 04:00:00 AM,48,-122,0,0,0
32597,58thStGreenway22ndAve,11/18/2017 05:00:00 AM,48,-122,0,0,0
32598,58thStGreenway22ndAve,11/18/2017 06:00:00 AM,48,-122,0,0,0
32599,58thStGreenway22ndAve,11/18/2017 07:00:00 AM,48,-122,1,1,2
32600,58thStGreenway22ndAve,11/18/2017 08:00:00 AM,48,-122,2,1,3
32601,58thStGreenway22ndAve,11/18/2017 09:00:00 AM,48,-122,3,0,3
32602,58thStGreenway22ndAve,11/18/2017 10:00:00 AM,48,-122,5,2,7
32603,58thStGreenway22ndAve,11/18/2017 11:00:00 AM,48,-122,6,5,11
32604,58thStGreenway22ndAve,11/18/2017 12:00:00 PM,48,-122,7,12,19
32605,58thStGreenway22ndAve,11/18/2017 01:00:00 PM,48,-122,6,6,12
32606,58thStGreenway22ndAve,11/18/2017 02:00:00 PM,48,-122,6,5,11
32607,58thStGreenway22ndAve,11/18/2017 03:00:00 PM,48,-122,2,8,10
32608,58thStGreenway22ndAve,11/18/2017 04:00:00 PM,48,-122,4,4,8
32609,58thStGreenway22ndAve,11/18/2017 05:00:00 PM,48,-122,6,7,13
32610,58thStGreenway22ndAve,11/18/2017 06:00:00 PM,48,-122,2,4,6
32611,58thStGreenway22ndAve,11/18/2017 07:00:00 PM,48,-122,6,1,7
32612,58thStGreenway22ndAve,11/18/2017 08:00:00 PM,48,-122,2,1,3
32613,58thStGreenway22ndAve,11/18/2017 09:00:00 PM,48,-122,1,1,2
32614,58thStGreenway22ndAve,11/18/2017 10:00:00 PM,48,-122,2,2,4
32615,58thStGreenway22ndAve,11/18/2017 11:00:00 PM,48,-122,1,1,2
32616,58thStGreenway22ndAve,11/19/2017 12:00:00 AM,48,-122,0,2,2
32617,58thStGreenway22ndAve,11/19/2017 01:00:00 AM,48,-122,0,0,0
32618,58thStGreenway22ndAve,11/19/2017 02:00:00 AM,48,-122,0,0,0
32619,58thStGreenway22ndAve,11/19/2017 03:00:00 AM,48,-122,0,0,0
32620,58thStGreenway22ndAve,11/19/2017 04:00:00 AM,48,-122,0,0,0
32621,58thStGreenway22ndAve,11/19/2017 05:00:00 AM,48,-122,0,0,0
32622,58thStGreenway22ndAve,11/19/2017 06:00:00 AM,48,-122,0,0,0
32623,58thStGreenway22ndAve,11/19/2017 07:00:00 AM,48,-122,2,0,2
32624,58thStGreenway22ndAve,11/19/2017 08:00:00 AM,48,-122,0,3,3
32625,58thStGreenway22ndAve,11/19/2017 09:00:00 AM,48,-122,6,2,8
32626,58thStGreenway22ndAve,11/19/2017 10:00:00 AM,48,-122,6,1,7
32627,58thStGreenway22ndAve,11/19/2017 11:00:00 AM,48,-122,5,4,9
32628,58thStGreenway22ndAve,11/19/2017 12:00:00 PM,48,-122,4,6,10
32629,58thStGreenway22ndAve,11/19/2017 01:00:00 PM,48,-122,16,2,18
32630,58thStGreenway22ndAve,11/19/2017 02:00:00 PM,48,-122,3,4,7
32631,58thStGreenway22ndAve,11/19/2017 03:00:00 PM,48,-122,2,0,2
32632,58thStGreenway22ndAve,11/19/2017 04:00:00 PM,48,-122,2,0,2
32633,58thStGreenway22ndAve,11/19/2017 05:00:00 PM,48,-122,1,0,1
32634,58thStGreenway22ndAve,11/19/2017 06:00:00 PM,48,-122,4,0,4
32635,58thStGreenway22ndAve,11/19/2017 07:00:00 PM,48,-122,0,2,2
32636,58thStGreenway22ndAve,11/19/2017 08:00:00 PM,48,-122,1,3,4
32637,58thStGreenway22ndAve,11/19/2017 09:00:00 PM,48,-122,2,0,2
32638,58thStGreenway22ndAve,11/19/2017 10:00:00 PM,48,-122,0,0,0
32639,58thStGreenway22ndAve,11/19/2017 11:00:00 PM,48,-122,0,0,0
32640,58thStGreenway22ndAve,11/20/2017 12:00:00 AM,48,-122,2,0,2
32641,58thStGreenway22ndAve,11/20/2017 01:00:00 AM,48,-122,0,0,0
32642,58thStGreenway22ndAve,11/20/2017 02:00:00 AM,48,-122,0,0,0
32643,58thStGreenway22ndAve,11/20/2017 03:00:00 AM,48,-122,0,0,0
32644,58thStGreenway22ndAve,11/20/2017 04:00:00 AM,48,-122,0,0,0
32645,58thStGreenway22ndAve,11/20/2017 05:00:00 AM,48,-122,0,0,0
32646,58thStGreenway22ndAve,11/20/2017 06:00:00 AM,48,-122,1,0,1
32647,58thStGreenway22ndAve,11/20/2017 07:00:00 AM,48,-122,1,2,3
32648,58thStGreenway22ndAve,11/20/2017 08:00:00 AM,48,-122,1,0,1
32649,58thStGreenway22ndAve,11/20/2017 09:00:00 AM,48,-122,3,2,5
32650,58thStGreenway22ndAve,11/20/2017 10:00:00 AM,48,-122,0,2,2
32651,58thStGreenway22ndAve,11/20/2017 11:00:00 AM,48,-122,2,0,2
32652,58thStGreenway22ndAve,11/20/2017 12:00:00 PM,48,-122,2,2,4
32653,58thStGreenway22ndAve,11/20/2017 01:00:00 PM,48,-122,6,3,9
32654,58thStGreenway22ndAve,11/20/2017 02:00:00 PM,48,-122,1,1,2
32655,58thStGreenway22ndAve,11/20/2017 03:00:00 PM,48,-122,3,1,4
32656,58thStGreenway22ndAve,11/20/2017 04:00:00 PM,48,-122,2,0,2
32657,58thStGreenway22ndAve,11/20/2017 05:00:00 PM,48,-122,4,2,6
32658,58thStGreenway22ndAve,11/20/2017 06:00:00 PM,48,-122,3,3,6
32659,58thStGreenway22ndAve,11/20/2017 07:00:00 PM,48,-122,3,1,4
32660,58thStGreenway22ndAve,11/20/2017 08:00:00 PM,48,-122,1,2,3
32661,58thStGreenway22ndAve,11/20/2017 09:00:00 PM,48,-122,2,5,7
32662,58thStGreenway22ndAve,11/20/2017 10:00:00 PM,48,-122,1,0,1
32663,58thStGreenway22ndAve,11/20/2017 11:00:00 PM,48,-122,0,0,0
32664,58thStGreenway22ndAve,11/21/2017 12:00:00 AM,48,-122,1,1,2
32665,58thStGreenway22ndAve,11/21/2017 01:00:00 AM,48,-122,0,0,0
32666,58thStGreenway22ndAve,11/21/2017 02:00:00 AM,48,-122,0,0,0
32667,58thStGreenway22ndAve,11/21/2017 03:00:00 AM,48,-122,0,0,0
32668,58thStGreenway22ndAve,11/21/2017 04:00:00 AM,48,-122,0,0,0
32669,58thStGreenway22ndAve,11/21/2017 05:00:00 AM,48,-122,0,2,2
32670,58thStGreenway22ndAve,11/21/2017 06:00:00 AM,48,-122,2,0,2
32671,58thStGreenway22ndAve,11/21/2017 07:00:00 AM,48,-122,1,1,2
32672,58thStGreenway22ndAve,11/21/2017 08:00:00 AM,48,-122,0,1,1
32673,58thStGreenway22ndAve,11/21/2017 09:00:00 AM,48,-122,2,2,4
32674,58thStGreenway22ndAve,11/21/2017 10:00:00 AM,48,-122,1,1,2
32675,58thStGreenway22ndAve,11/21/2017 11:00:00 AM,48,-122,2,1,3
32676,58thStGreenway22ndAve,11/21/2017 12:00:00 PM,48,-122,0,1,1
32677,58thStGreenway22ndAve,11/21/2017 01:00:00 PM,48,-122,2,1,3
32678,58thStGreenway22ndAve,11/21/2017 02:00:00 PM,48,-122,2,1,3
32679,58thStGreenway22ndAve,11/21/2017 03:00:00 PM,48,-122,3,2,5
32680,58thStGreenway22ndAve,11/21/2017 04:00:00 PM,48,-122,5,2,7
32681,58thStGreenway22ndAve,11/21/2017 05:00:00 PM,48,-122,5,4,9
32682,58thStGreenway22ndAve,11/21/2017 06:00:00 PM,48,-122,13,2,15
32683,58thStGreenway22ndAve,11/21/2017 07:00:00 PM,48,-122,2,2,4
32684,58thStGreenway22ndAve,11/21/2017 08:00:00 PM,48,-122,3,2,5
32685,58thStGreenway22ndAve,11/21/2017 09:00:00 PM,48,-122,0,4,4
32686,58thStGreenway22ndAve,11/21/2017 10:00:00 PM,48,-122,0,2,2
32687,58thStGreenway22ndAve,11/21/2017 11:00:00 PM,48,-122,0,0,0
32688,58thStGreenway22ndAve,11/22/2017 12:00:00 AM,48,-122,0,0,0
32689,58thStGreenway22ndAve,11/22/2017 01:00:00 AM,48,-122,0,0,0
32690,58thStGreenway22ndAve,11/22/2017 02:00:00 AM,48,-122,0,0,0
32691,58thStGreenway22ndAve,11/22/2017 03:00:00 AM,48,-122,0,0,0
32692,58thStGreenway22ndAve,11/22/2017 04:00:00 AM,48,-122,0,0,0
32693,58thStGreenway22ndAve,11/22/2017 05:00:00 AM,48,-122,0,0,0
32694,58thStGreenway22ndAve,11/22/2017 06:00:00 AM,48,-122,1,1,2
32695,58thStGreenway22ndAve,11/22/2017 07:00:00 AM,48,-122,2,2,4
32696,58thStGreenway22ndAve,11/22/2017 08:00:00 AM,48,-122,3,1,4
32697,58thStGreenway22ndAve,11/22/2017 09:00:00 AM,48,-122,3,3,6
32698,58thStGreenway22ndAve,11/22/2017 10:00:00 AM,48,-122,9,3,12
32699,58thStGreenway22ndAve,11/22/2017 11:00:00 AM,48,-122,1,0,1
32700,58thStGreenway22ndAve,11/22/2017 12:00:00 PM,48,-122,4,1,5
32701,58thStGreenway22ndAve,11/22/2017 01:00:00 PM,48,-122,0,2,2
32702,58thStGreenway22ndAve,11/22/2017 02:00:00 PM,48,-122,2,4,6
32703,58thStGreenway22ndAve,11/22/2017 03:00:00 PM,48,-122,8,0,8
32704,58thStGreenway22ndAve,11/22/2017 04:00:00 PM,48,-122,7,6,13
32705,58thStGreenway22ndAve,11/22/2017 05:00:00 PM,48,-122,4,5,9
32706,58thStGreenway22ndAve,11/22/2017 06:00:00 PM,48,-122,5,3,8
32707,58thStGreenway22ndAve,11/22/2017 07:00:00 PM,48,-122,2,1,3
32708,58thStGreenway22ndAve,11/22/2017 08:00:00 PM,48,-122,0,0,0
32709,58thStGreenway22ndAve,11/22/2017 09:00:00 PM,48,-122,4,0,4
32710,58thStGreenway22ndAve,11/22/2017 10:00:00 PM,48,-122,2,0,2
32711,58thStGreenway22ndAve,11/22/2017 11:00:00 PM,48,-122,0,1,1
32712,58thStGreenway22ndAve,11/23/2017 12:00:00 AM,48,-122,0,0,0
32713,58thStGreenway22ndAve,11/23/2017 01:00:00 AM,48,-122,0,0,0
32714,58thStGreenway22ndAve,11/23/2017 02:00:00 AM,48,-122,0,0,0
32715,58thStGreenway22ndAve,11/23/2017 03:00:00 AM,48,-122,0,1,1
32716,58thStGreenway22ndAve,11/23/2017 04:00:00 AM,48,-122,0,0,0
32717,58thStGreenway22ndAve,11/23/2017 05:00:00 AM,48,-122,0,0,0
32718,58thStGreenway22ndAve,11/23/2017 06:00:00 AM,48,-122,0,0,0
32719,58thStGreenway22ndAve,11/23/2017 07:00:00 AM,48,-122,1,0,1
32720,58thStGreenway22ndAve,11/23/2017 08:00:00 AM,48,-122,3,0,3
32721,58thStGreenway22ndAve,11/23/2017 09:00:00 AM,48,-122,0,0,0
32722,58thStGreenway22ndAve,11/23/2017 10:00:00 AM,48,-122,1,0,1
32723,58thStGreenway22ndAve,11/23/2017 11:00:00 AM,48,-122,0,1,1
32724,58thStGreenway22ndAve,11/23/2017 12:00:00 PM,48,-122,2,0,2
32725,58thStGreenway22ndAve,11/23/2017 01:00:00 PM,48,-122,1,1,2
32726,58thStGreenway22ndAve,11/23/2017 02:00:00 PM,48,-122,1,1,2
32727,58thStGreenway22ndAve,11/23/2017 03:00:00 PM,48,-122,0,1,1
32728,58thStGreenway22ndAve,11/23/2017 04:00:00 PM,48,-122,0,2,2
32729,58thStGreenway22ndAve,11/23/2017 05:00:00 PM,48,-122,0,0,0
32730,58thStGreenway22ndAve,11/23/2017 06:00:00 PM,48,-122,0,1,1
32731,58thStGreenway22ndAve,11/23/2017 07:00:00 PM,48,-122,0,2,2
32732,58thStGreenway22ndAve,11/23/2017 08:00:00 PM,48,-122,1,0,1
32733,58thStGreenway22ndAve,11/23/2017 09:00:00 PM,48,-122,0,0,0
32734,58thStGreenway22ndAve,11/23/2017 10:00:00 PM,48,-122,2,2,4
32735,58thStGreenway22ndAve,11/23/2017 11:00:00 PM,48,-122,0,0,0
32736,58thStGreenway22ndAve,11/24/2017 12:00:00 AM,48,-122,0,0,0
32737,58thStGreenway22ndAve,11/24/2017 01:00:00 AM,48,-122,0,0,0
32738,58thStGreenway22ndAve,11/24/2017 02:00:00 AM,48,-122,0,0,0
32739,58thStGreenway22ndAve,11/24/2017 03:00:00 AM,48,-122,0,0,0
32740,58thStGreenway22ndAve,11/24/2017 04:00:00 AM,48,-122,0,0,0
32741,58thStGreenway22ndAve,11/24/2017 05:00:00 AM,48,-122,1,0,1
32742,58thStGreenway22ndAve,11/24/2017 06:00:00 AM,48,-122,0,0,0
32743,58thStGreenway22ndAve,11/24/2017 07:00:00 AM,48,-122,0,1,1
32744,58thStGreenway22ndAve,11/24/2017 08:00:00 AM,48,-122,4,0,4
32745,58thStGreenway22ndAve,11/24/2017 09:00:00 AM,48,-122,1,0,1
32746,58thStGreenway22ndAve,11/24/2017 10:00:00 AM,48,-122,5,6,11
32747,58thStGreenway22ndAve,11/24/2017 11:00:00 AM,48,-122,8,0,8
32748,58thStGreenway22ndAve,11/24/2017 12:00:00 PM,48,-122,12,5,17
32749,58thStGreenway22ndAve,11/24/2017 01:00:00 PM,48,-122,5,3,8
32750,58thStGreenway22ndAve,11/24/2017 02:00:00 PM,48,-122,6,3,9
32751,58thStGreenway22ndAve,11/24/2017 03:00:00 PM,48,-122,3,3,6
32752,58thStGreenway22ndAve,11/24/2017 04:00:00 PM,48,-122,4,2,6
32753,58thStGreenway22ndAve,11/24/2017 05:00:00 PM,48,-122,1,4,5
32754,58thStGreenway22ndAve,11/24/2017 06:00:00 PM,48,-122,1,2,3
32755,58thStGreenway22ndAve,11/24/2017 07:00:00 PM,48,-122,2,1,3
32756,58thStGreenway22ndAve,11/24/2017 08:00:00 PM,48,-122,1,3,4
32757,58thStGreenway22ndAve,11/24/2017 09:00:00 PM,48,-122,0,1,1
32758,58thStGreenway22ndAve,11/24/2017 10:00:00 PM,48,-122,0,0,0
32759,58thStGreenway22ndAve,11/24/2017 11:00:00 PM,48,-122,1,0,1
32760,58thStGreenway22ndAve,11/25/2017 12:00:00 AM,48,-122,0,0,0
32761,58thStGreenway22ndAve,11/25/2017 01:00:00 AM,48,-122,0,0,0
32762,58thStGreenway22ndAve,11/25/2017 02:00:00 AM,48,-122,1,1,2
32763,58thStGreenway22ndAve,11/25/2017 03:00:00 AM,48,-122,0,0,0
32764,58thStGreenway22ndAve,11/25/2017 04:00:00 AM,48,-122,0,0,0
32765,58thStGreenway22ndAve,11/25/2017 05:00:00 AM,48,-122,0,0,0
32766,58thStGreenway22ndAve,11/25/2017 06:00:00 AM,48,-122,0,0,0
32767,58thStGreenway22ndAve,11/25/2017 07:00:00 AM,48,-122,1,1,2
32768,58thStGreenway22ndAve,11/25/2017 08:00:00 AM,48,-122,1,0,1
32769,58thStGreenway22ndAve,11/25/2017 09:00:00 AM,48,-122,2,2,4
32770,58thStGreenway22ndAve,11/25/2017 10:00:00 AM,48,-122,8,3,11
32771,58thStGreenway22ndAve,11/25/2017 11:00:00 AM,48,-122,4,5,9
32772,58thStGreenway22ndAve,11/25/2017 12:00:00 PM,48,-122,6,4,10
32773,58thStGreenway22ndAve,11/25/2017 01:00:00 PM,48,-122,4,2,6
32774,58thStGreenway22ndAve,11/25/2017 02:00:00 PM,48,-122,2,4,6
32775,58thStGreenway22ndAve,11/25/2017 03:00:00 PM,48,-122,4,1,5
32776,58thStGreenway22ndAve,11/25/2017 04:00:00 PM,48,-122,3,6,9
32777,58thStGreenway22ndAve,11/25/2017 05:00:00 PM,48,-122,5,0,5
32778,58thStGreenway22ndAve,11/25/2017 06:00:00 PM,48,-122,4,1,5
32779,58thStGreenway22ndAve,11/25/2017 07:00:00 PM,48,-122,2,3,5
32780,58thStGreenway22ndAve,11/25/2017 08:00:00 PM,48,-122,0,2,2
32781,58thStGreenway22ndAve,11/25/2017 09:00:00 PM,48,-122,0,1,1
32782,58thStGreenway22ndAve,11/25/2017 10:00:00 PM,48,-122,0,1,1
32783,58thStGreenway22ndAve,11/25/2017 11:00:00 PM,48,-122,0,0,0
32784,58thStGreenway22ndAve,11/26/2017 12:00:00 AM,48,-122,0,0,0
32785,58thStGreenway22ndAve,11/26/2017 01:00:00 AM,48,-122,0,0,0
32786,58thStGreenway22ndAve,11/26/2017 02:00:00 AM,48,-122,0,0,0
32787,58thStGreenway22ndAve,11/26/2017 03:00:00 AM,48,-122,0,0,0
32788,58thStGreenway22ndAve,11/26/2017 04:00:00 AM,48,-122,0,0,0
32789,58thStGreenway22ndAve,11/26/2017 05:00:00 AM,48,-122,0,1,1
32790,58thStGreenway22ndAve,11/26/2017 06:00:00 AM,48,-122,0,0,0
32791,58thStGreenway22ndAve,11/26/2017 07:00:00 AM,48,-122,0,1,1
32792,58thStGreenway22ndAve,11/26/2017 08:00:00 AM,48,-122,0,0,0
32793,58thStGreenway22ndAve,11/26/2017 09:00:00 AM,48,-122,0,1,1
32794,58thStGreenway22ndAve,11/26/2017 10:00:00 AM,48,-122,3,1,4
32795,58thStGreenway22ndAve,11/26/2017 11:00:00 AM,48,-122,4,2,6
32796,58thStGreenway22ndAve,11/26/2017 12:00:00 PM,48,-122,2,2,4
32797,58thStGreenway22ndAve,11/26/2017 01:00:00 PM,48,-122,4,2,6
32798,58thStGreenway22ndAve,11/26/2017 02:00:00 PM,48,-122,1,2,3
32799,58thStGreenway22ndAve,11/26/2017 03:00:00 PM,48,-122,2,1,3
32800,58thStGreenway22ndAve,11/26/2017 04:00:00 PM,48,-122,2,3,5
32801,58thStGreenway22ndAve,11/26/2017 05:00:00 PM,48,-122,3,0,3
32802,58thStGreenway22ndAve,11/26/2017 06:00:00 PM,48,-122,0,2,2
32803,58thStGreenway22ndAve,11/26/2017 07:00:00 PM,48,-122,1,1,2
32804,58thStGreenway22ndAve,11/26/2017 08:00:00 PM,48,-122,1,4,5
32805,58thStGreenway22ndAve,11/26/2017 09:00:00 PM,48,-122,0,0,0
32806,58thStGreenway22ndAve,11/26/2017 10:00:00 PM,48,-122,0,1,1
32807,58thStGreenway22ndAve,11/26/2017 11:00:00 PM,48,-122,0,0,0
32808,58thStGreenway22ndAve,11/27/2017 12:00:00 AM,48,-122,0,0,0
32809,58thStGreenway22ndAve,11/27/2017 01:00:00 AM,48,-122,0,0,0
32810,58thStGreenway22ndAve,11/27/2017 02:00:00 AM,48,-122,0,0,0
32811,58thStGreenway22ndAve,11/27/2017 03:00:00 AM,48,-122,0,0,0
32812,58thStGreenway22ndAve,11/27/2017 04:00:00 AM,48,-122,1,0,1
32813,58thStGreenway22ndAve,11/27/2017 05:00:00 AM,48,-122,0,0,0
32814,58thStGreenway22ndAve,11/27/2017 06:00:00 AM,48,-122,2,0,2
32815,58thStGreenway22ndAve,11/27/2017 07:00:00 AM,48,-122,4,4,8
32816,58thStGreenway22ndAve,11/27/2017 08:00:00 AM,48,-122,4,1,5
32817,58thStGreenway22ndAve,11/27/2017 09:00:00 AM,48,-122,6,5,11
32818,58thStGreenway22ndAve,11/27/2017 10:00:00 AM,48,-122,4,2,6
32819,58thStGreenway22ndAve,11/27/2017 11:00:00 AM,48,-122,3,3,6
32820,58thStGreenway22ndAve,11/27/2017 12:00:00 PM,48,-122,0,2,2
32821,58thStGreenway22ndAve,11/27/2017 01:00:00 PM,48,-122,6,0,6
32822,58thStGreenway22ndAve,11/27/2017 02:00:00 PM,48,-122,5,2,7
32823,58thStGreenway22ndAve,11/27/2017 03:00:00 PM,48,-122,2,1,3
32824,58thStGreenway22ndAve,11/27/2017 04:00:00 PM,48,-122,5,6,11
32825,58thStGreenway22ndAve,11/27/2017 05:00:00 PM,48,-122,6,4,10
32826,58thStGreenway22ndAve,11/27/2017 06:00:00 PM,48,-122,5,5,10
32827,58thStGreenway22ndAve,11/27/2017 07:00:00 PM,48,-122,5,4,9
32828,58thStGreenway22ndAve,11/27/2017 08:00:00 PM,48,-122,0,2,2
32829,58thStGreenway22ndAve,11/27/2017 09:00:00 PM,48,-122,0,0,0
32830,58thStGreenway22ndAve,11/27/2017 10:00:00 PM,48,-122,1,0,1
32831,58thStGreenway22ndAve,11/27/2017 11:00:00 PM,48,-122,0,0,0
32832,58thStGreenway22ndAve,11/28/2017 12:00:00 AM,48,-122,0,0,0
32833,58thStGreenway22ndAve,11/28/2017 01:00:00 AM,48,-122,0,0,0
32834,58thStGreenway22ndAve,11/28/2017 02:00:00 AM,48,-122,0,0,0
32835,58thStGreenway22ndAve,11/28/2017 03:00:00 AM,48,-122,0,0,0
32836,58thStGreenway22ndAve,11/28/2017 04:00:00 AM,48,-122,0,0,0
32837,58thStGreenway22ndAve,11/28/2017 05:00:00 AM,48,-122,0,0,0
32838,58thStGreenway22ndAve,11/28/2017 06:00:00 AM,48,-122,0,2,2
32839,58thStGreenway22ndAve,11/28/2017 07:00:00 AM,48,-122,1,3,4
32840,58thStGreenway22ndAve,11/28/2017 08:00:00 AM,48,-122,3,1,4
32841,58thStGreenway22ndAve,11/28/2017 09:00:00 AM,48,-122,0,1,1
32842,58thStGreenway22ndAve,11/28/2017 10:00:00 AM,48,-122,1,1,2
32843,58thStGreenway22ndAve,11/28/2017 11:00:00 AM,48,-122,1,0,1
32844,58thStGreenway22ndAve,11/28/2017 12:00:00 PM,48,-122,2,3,5
32845,58thStGreenway22ndAve,11/28/2017 01:00:00 PM,48,-122,2,2,4
32846,58thStGreenway22ndAve,11/28/2017 02:00:00 PM,48,-122,0,2,2
32847,58thStGreenway22ndAve,11/28/2017 03:00:00 PM,48,-122,0,0,0
32848,58thStGreenway22ndAve,11/28/2017 04:00:00 PM,48,-122,5,0,5
32849,58thStGreenway22ndAve,11/28/2017 05:00:00 PM,48,-122,7,8,15
32850,58thStGreenway22ndAve,11/28/2017 06:00:00 PM,48,-122,4,2,6
32851,58thStGreenway22ndAve,11/28/2017 07:00:00 PM,48,-122,1,2,3
32852,58thStGreenway22ndAve,11/28/2017 08:00:00 PM,48,-122,2,2,4
32853,58thStGreenway22ndAve,11/28/2017 09:00:00 PM,48,-122,1,2,3
32854,58thStGreenway22ndAve,11/28/2017 10:00:00 PM,48,-122,0,0,0
32855,58thStGreenway22ndAve,11/28/2017 11:00:00 PM,48,-122,0,2,2
32856,58thStGreenway22ndAve,11/29/2017 12:00:00 AM,48,-122,0,0,0
32857,58thStGreenway22ndAve,11/29/2017 01:00:00 AM,48,-122,1,0,1
32858,58thStGreenway22ndAve,11/29/2017 02:00:00 AM,48,-122,0,3,3
32859,58thStGreenway22ndAve,11/29/2017 03:00:00 AM,48,-122,0,0,0
32860,58thStGreenway22ndAve,11/29/2017 04:00:00 AM,48,-122,0,0,0
32861,58thStGreenway22ndAve,11/29/2017 05:00:00 AM,48,-122,0,0,0
32862,58thStGreenway22ndAve,11/29/2017 06:00:00 AM,48,-122,1,2,3
32863,58thStGreenway22ndAve,11/29/2017 07:00:00 AM,48,-122,2,4,6
32864,58thStGreenway22ndAve,11/29/2017 08:00:00 AM,48,-122,5,0,5
32865,58thStGreenway22ndAve,11/29/2017 09:00:00 AM,48,-122,4,1,5
32866,58thStGreenway22ndAve,11/29/2017 10:00:00 AM,48,-122,2,3,5
32867,58thStGreenway22ndAve,11/29/2017 11:00:00 AM,48,-122,2,5,7
32868,58thStGreenway22ndAve,11/29/2017 12:00:00 PM,48,-122,5,1,6
32869,58thStGreenway22ndAve,11/29/2017 01:00:00 PM,48,-122,2,0,2
32870,58thStGreenway22ndAve,11/29/2017 02:00:00 PM,48,-122,4,1,5
32871,58thStGreenway22ndAve,11/29/2017 03:00:00 PM,48,-122,3,3,6
32872,58thStGreenway22ndAve,11/29/2017 04:00:00 PM,48,-122,3,1,4
32873,58thStGreenway22ndAve,11/29/2017 05:00:00 PM,48,-122,4,4,8
32874,58thStGreenway22ndAve,11/29/2017 06:00:00 PM,48,-122,1,2,3
32875,58thStGreenway22ndAve,11/29/2017 07:00:00 PM,48,-122,9,5,14
32876,58thStGreenway22ndAve,11/29/2017 08:00:00 PM,48,-122,1,3,4
32877,58thStGreenway22ndAve,11/29/2017 09:00:00 PM,48,-122,0,2,2
32878,58thStGreenway22ndAve,11/29/2017 10:00:00 PM,48,-122,0,0,0
32879,58thStGreenway22ndAve,11/29/2017 11:00:00 PM,48,-122,0,1,1
32880,58thStGreenway22ndAve,11/30/2017 12:00:00 AM,48,-122,0,0,0
32881,58thStGreenway22ndAve,11/30/2017 01:00:00 AM,48,-122,1,0,1
32882,58thStGreenway22ndAve,11/30/2017 02:00:00 AM,48,-122,0,0,0
32883,58thStGreenway22ndAve,11/30/2017 03:00:00 AM,48,-122,0,0,0
32884,58thStGreenway22ndAve,11/30/2017 04:00:00 AM,48,-122,0,0,0
32885,58thStGreenway22ndAve,11/30/2017 05:00:00 AM,48,-122,0,0,0
32886,58thStGreenway22ndAve,11/30/2017 06:00:00 AM,48,-122,0,0,0
32887,58thStGreenway22ndAve,11/30/2017 07:00:00 AM,48,-122,3,6,9
32888,58thStGreenway22ndAve,11/30/2017 08:00:00 AM,48,-122,3,2,5
32889,58thStGreenway22ndAve,11/30/2017 09:00:00 AM,48,-122,3,0,3
32890,58thStGreenway22ndAve,11/30/2017 10:00:00 AM,48,-122,2,2,4
32891,58thStGreenway22ndAve,11/30/2017 11:00:00 AM,48,-122,2,2,4
32892,58thStGreenway22ndAve,11/30/2017 12:00:00 PM,48,-122,3,2,5
32893,58thStGreenway22ndAve,11/30/2017 01:00:00 PM,48,-122,1,3,4
32894,58thStGreenway22ndAve,11/30/2017 02:00:00 PM,48,-122,1,3,4
32895,58thStGreenway22ndAve,11/30/2017 03:00:00 PM,48,-122,3,4,7
32896,58thStGreenway22ndAve,11/30/2017 04:00:00 PM,48,-122,4,3,7
32897,58thStGreenway22ndAve,11/30/2017 05:00:00 PM,48,-122,2,5,7
32898,58thStGreenway22ndAve,11/30/2017 06:00:00 PM,48,-122,1,2,3
32899,58thStGreenway22ndAve,11/30/2017 07:00:00 PM,48,-122,2,3,5
32900,58thStGreenway22ndAve,11/30/2017 08:00:00 PM,48,-122,0,0,0
32901,58thStGreenway22ndAve,11/30/2017 09:00:00 PM,48,-122,0,0,0
32902,58thStGreenway22ndAve,11/30/2017 10:00:00 PM,48,-122,0,0,0
32903,58thStGreenway22ndAve,11/30/2017 11:00:00 PM,48,-122,0,0,0
32904,58thStGreenway22ndAve,12/01/2017 12:00:00 AM,48,-122,0,0,0
32905,58thStGreenway22ndAve,12/01/2017 01:00:00 AM,48,-122,0,0,0
32906,58thStGreenway22ndAve,12/01/2017 02:00:00 AM,48,-122,0,0,0
32907,58thStGreenway22ndAve,12/01/2017 03:00:00 AM,48,-122,0,0,0
32908,58thStGreenway22ndAve,12/01/2017 04:00:00 AM,48,-122,0,0,0
32909,58thStGreenway22ndAve,12/01/2017 05:00:00 AM,48,-122,0,1,1
32910,58thStGreenway22ndAve,12/01/2017 06:00:00 AM,48,-122,1,2,3
32911,58thStGreenway22ndAve,12/01/2017 07:00:00 AM,48,-122,7,2,9
32912,58thStGreenway22ndAve,12/01/2017 08:00:00 AM,48,-122,4,4,8
32913,58thStGreenway22ndAve,12/01/2017 09:00:00 AM,48,-122,9,1,10
32914,58thStGreenway22ndAve,12/01/2017 10:00:00 AM,48,-122,4,2,6
32915,58thStGreenway22ndAve,12/01/2017 11:00:00 AM,48,-122,1,4,5
32916,58thStGreenway22ndAve,12/01/2017 12:00:00 PM,48,-122,3,1,4
32917,58thStGreenway22ndAve,12/01/2017 01:00:00 PM,48,-122,2,1,3
32918,58thStGreenway22ndAve,12/01/2017 02:00:00 PM,48,-122,2,1,3
32919,58thStGreenway22ndAve,12/01/2017 03:00:00 PM,48,-122,2,3,5
32920,58thStGreenway22ndAve,12/01/2017 04:00:00 PM,48,-122,4,7,11
32921,58thStGreenway22ndAve,12/01/2017 05:00:00 PM,48,-122,4,0,4
32922,58thStGreenway22ndAve,12/01/2017 06:00:00 PM,48,-122,0,4,4
32923,58thStGreenway22ndAve,12/01/2017 07:00:00 PM,48,-122,4,0,4
32924,58thStGreenway22ndAve,12/01/2017 08:00:00 PM,48,-122,4,1,5
32925,58thStGreenway22ndAve,12/01/2017 09:00:00 PM,48,-122,3,0,3
32926,58thStGreenway22ndAve,12/01/2017 10:00:00 PM,48,-122,0,0,0
32927,58thStGreenway22ndAve,12/01/2017 11:00:00 PM,48,-122,2,0,2
32928,58thStGreenway22ndAve,12/02/2017 12:00:00 AM,48,-122,0,0,0
32929,58thStGreenway22ndAve,12/02/2017 01:00:00 AM,48,-122,0,0,0
32930,58thStGreenway22ndAve,12/02/2017 02:00:00 AM,48,-122,0,0,0
32931,58thStGreenway22ndAve,12/02/2017 03:00:00 AM,48,-122,0,1,1
32932,58thStGreenway22ndAve,12/02/2017 04:00:00 AM,48,-122,0,0,0
32933,58thStGreenway22ndAve,12/02/2017 05:00:00 AM,48,-122,0,0,0
32934,58thStGreenway22ndAve,12/02/2017 06:00:00 AM,48,-122,0,0,0
32935,58thStGreenway22ndAve,12/02/2017 07:00:00 AM,48,-122,1,1,2
32936,58thStGreenway22ndAve,12/02/2017 08:00:00 AM,48,-122,1,1,2
32937,58thStGreenway22ndAve,12/02/2017 09:00:00 AM,48,-122,4,5,9
32938,58thStGreenway22ndAve,12/02/2017 10:00:00 AM,48,-122,2,2,4
32939,58thStGreenway22ndAve,12/02/2017 11:00:00 AM,48,-122,1,3,4
32940,58thStGreenway22ndAve,12/02/2017 12:00:00 PM,48,-122,5,3,8
32941,58thStGreenway22ndAve,12/02/2017 01:00:00 PM,48,-122,2,5,7
32942,58thStGreenway22ndAve,12/02/2017 02:00:00 PM,48,-122,0,5,5
32943,58thStGreenway22ndAve,12/02/2017 03:00:00 PM,48,-122,0,13,13
32944,58thStGreenway22ndAve,12/02/2017 04:00:00 PM,48,-122,1,8,9
32945,58thStGreenway22ndAve,12/02/2017 05:00:00 PM,48,-122,1,11,12
32946,58thStGreenway22ndAve,12/02/2017 06:00:00 PM,48,-122,0,1,1
32947,58thStGreenway22ndAve,12/02/2017 07:00:00 PM,48,-122,1,2,3
32948,58thStGreenway22ndAve,12/02/2017 08:00:00 PM,48,-122,4,1,5
32949,58thStGreenway22ndAve,12/02/2017 09:00:00 PM,48,-122,0,4,4
32950,58thStGreenway22ndAve,12/02/2017 10:00:00 PM,48,-122,0,2,2
32951,58thStGreenway22ndAve,12/02/2017 11:00:00 PM,48,-122,0,2,2
32952,58thStGreenway22ndAve,12/03/2017 12:00:00 AM,48,-122,1,0,1
32953,58thStGreenway22ndAve,12/03/2017 01:00:00 AM,48,-122,0,1,1
32954,58thStGreenway22ndAve,12/03/2017 02:00:00 AM,48,-122,1,2,3
32955,58thStGreenway22ndAve,12/03/2017 03:00:00 AM,48,-122,0,0,0
32956,58thStGreenway22ndAve,12/03/2017 04:00:00 AM,48,-122,0,0,0
32957,58thStGreenway22ndAve,12/03/2017 05:00:00 AM,48,-122,0,0,0
32958,58thStGreenway22ndAve,12/03/2017 06:00:00 AM,48,-122,0,1,1
32959,58thStGreenway22ndAve,12/03/2017 07:00:00 AM,48,-122,0,1,1
32960,58thStGreenway22ndAve,12/03/2017 08:00:00 AM,48,-122,1,2,3
32961,58thStGreenway22ndAve,12/03/2017 09:00:00 AM,48,-122,0,6,6
32962,58thStGreenway22ndAve,12/03/2017 10:00:00 AM,48,-122,2,13,15
32963,58thStGreenway22ndAve,12/03/2017 11:00:00 AM,48,-122,4,20,24
32964,58thStGreenway22ndAve,12/03/2017 12:00:00 PM,48,-122,1,20,21
32965,58thStGreenway22ndAve,12/03/2017 01:00:00 PM,48,-122,7,29,36
32966,58thStGreenway22ndAve,12/03/2017 02:00:00 PM,48,-122,0,18,18
32967,58thStGreenway22ndAve,12/03/2017 03:00:00 PM,48,-122,2,22,24
32968,58thStGreenway22ndAve,12/03/2017 04:00:00 PM,48,-122,1,16,17
32969,58thStGreenway22ndAve,12/03/2017 05:00:00 PM,48,-122,1,17,18
32970,58thStGreenway22ndAve,12/03/2017 06:00:00 PM,48,-122,0,18,18
32971,58thStGreenway22ndAve,12/03/2017 07:00:00 PM,48,-122,1,9,10
32972,58thStGreenway22ndAve,12/03/2017 08:00:00 PM,48,-122,0,4,4
32973,58thStGreenway22ndAve,12/03/2017 09:00:00 PM,48,-122,0,10,10
32974,58thStGreenway22ndAve,12/03/2017 10:00:00 PM,48,-122,0,2,2
32975,58thStGreenway22ndAve,12/03/2017 11:00:00 PM,48,-122,0,8,8
32976,58thStGreenway22ndAve,12/04/2017 12:00:00 AM,48,-122,0,0,0
32977,58thStGreenway22ndAve,12/04/2017 01:00:00 AM,48,-122,0,3,3
32978,58thStGreenway22ndAve,12/04/2017 02:00:00 AM,48,-122,0,0,0
32979,58thStGreenway22ndAve,12/04/2017 03:00:00 AM,48,-122,0,1,1
32980,58thStGreenway22ndAve,12/04/2017 04:00:00 AM,48,-122,0,2,2
32981,58thStGreenway22ndAve,12/04/2017 05:00:00 AM,48,-122,0,3,3
32982,58thStGreenway22ndAve,12/04/2017 06:00:00 AM,48,-122,0,8,8
32983,58thStGreenway22ndAve,12/04/2017 07:00:00 AM,48,-122,0,4,4
32984,58thStGreenway22ndAve,12/04/2017 08:00:00 AM,48,-122,0,20,20
32985,58thStGreenway22ndAve,12/04/2017 09:00:00 AM,48,-122,2,21,23
32986,58thStGreenway22ndAve,12/04/2017 10:00:00 AM,48,-122,2,17,19
32987,58thStGreenway22ndAve,12/04/2017 11:00:00 AM,48,-122,0,22,22
32988,58thStGreenway22ndAve,12/04/2017 12:00:00 PM,48,-122,1,18,19
32989,58thStGreenway22ndAve,12/04/2017 01:00:00 PM,48,-122,2,25,27
32990,58thStGreenway22ndAve,12/04/2017 02:00:00 PM,48,-122,1,17,18
32991,58thStGreenway22ndAve,12/04/2017 03:00:00 PM,48,-122,6,27,33
32992,58thStGreenway22ndAve,12/04/2017 04:00:00 PM,48,-122,1,28,29
32993,58thStGreenway22ndAve,12/04/2017 05:00:00 PM,48,-122,1,18,19
32994,58thStGreenway22ndAve,12/04/2017 06:00:00 PM,48,-122,0,24,24
32995,58thStGreenway22ndAve,12/04/2017 07:00:00 PM,48,-122,1,10,11
32996,58thStGreenway22ndAve,12/04/2017 08:00:00 PM,48,-122,1,11,12
32997,58thStGreenway22ndAve,12/04/2017 09:00:00 PM,48,-122,0,13,13
32998,58thStGreenway22ndAve,12/04/2017 10:00:00 PM,48,-122,1,4,5
32999,58thStGreenway22ndAve,12/04/2017 11:00:00 PM,48,-122,0,5,5
33000,58thStGreenway22ndAve,12/05/2017 12:00:00 AM,48,-122,0,2,2
33001,58thStGreenway22ndAve,12/05/2017 01:00:00 AM,48,-122,0,4,4
33002,58thStGreenway22ndAve,12/05/2017 02:00:00 AM,48,-122,0,1,1
33003,58thStGreenway22ndAve,12/05/2017 03:00:00 AM,48,-122,0,1,1
33004,58thStGreenway22ndAve,12/05/2017 04:00:00 AM,48,-122,0,3,3
33005,58thStGreenway22ndAve,12/05/2017 05:00:00 AM,48,-122,0,3,3
33006,58thStGreenway22ndAve,12/05/2017 06:00:00 AM,48,-122,0,6,6
33007,58thStGreenway22ndAve,12/05/2017 07:00:00 AM,48,-122,1,12,13
33008,58thStGreenway22ndAve,12/05/2017 08:00:00 AM,48,-122,2,15,17
33009,58thStGreenway22ndAve,12/05/2017 09:00:00 AM,48,-122,1,16,17
33010,58thStGreenway22ndAve,12/05/2017 10:00:00 AM,48,-122,1,14,15
33011,58thStGreenway22ndAve,12/05/2017 11:00:00 AM,48,-122,1,17,18
33012,58thStGreenway22ndAve,12/05/2017 12:00:00 PM,48,-122,3,21,24
33013,58thStGreenway22ndAve,12/05/2017 01:00:00 PM,48,-122,1,31,32
33014,58thStGreenway22ndAve,12/05/2017 02:00:00 PM,48,-122,0,25,25
33015,58thStGreenway22ndAve,12/05/2017 03:00:00 PM,48,-122,3,30,33
33016,58thStGreenway22ndAve,12/05/2017 04:00:00 PM,48,-122,0,7,7
33017,58thStGreenway22ndAve,12/05/2017 05:00:00 PM,48,-122,1,13,14
33018,58thStGreenway22ndAve,12/05/2017 06:00:00 PM,48,-122,0,9,9
33019,58thStGreenway22ndAve,12/05/2017 07:00:00 PM,48,-122,0,10,10
33020,58thStGreenway22ndAve,12/05/2017 08:00:00 PM,48,-122,0,18,18
33021,58thStGreenway22ndAve,12/05/2017 09:00:00 PM,48,-122,0,10,10
33022,58thStGreenway22ndAve,12/05/2017 10:00:00 PM,48,-122,0,6,6
33023,58thStGreenway22ndAve,12/05/2017 11:00:00 PM,48,-122,0,5,5
33024,58thStGreenway22ndAve,12/06/2017 12:00:00 AM,48,-122,0,2,2
33025,58thStGreenway22ndAve,12/06/2017 01:00:00 AM,48,-122,0,0,0
33026,58thStGreenway22ndAve,12/06/2017 02:00:00 AM,48,-122,0,0,0
33027,58thStGreenway22ndAve,12/06/2017 03:00:00 AM,48,-122,0,1,1
33028,58thStGreenway22ndAve,12/06/2017 04:00:00 AM,48,-122,0,2,2
33029,58thStGreenway22ndAve,12/06/2017 05:00:00 AM,48,-122,0,3,3
33030,58thStGreenway22ndAve,12/06/2017 06:00:00 AM,48,-122,2,2,4
33031,58thStGreenway22ndAve,12/06/2017 07:00:00 AM,48,-122,1,9,10
33032,58thStGreenway22ndAve,12/06/2017 08:00:00 AM,48,-122,0,10,10
33033,58thStGreenway22ndAve,12/06/2017 09:00:00 AM,48,-122,0,6,6
33034,58thStGreenway22ndAve,12/06/2017 10:00:00 AM,48,-122,1,17,18
33035,58thStGreenway22ndAve,12/06/2017 11:00:00 AM,48,-122,0,14,14
33036,58thStGreenway22ndAve,12/06/2017 12:00:00 PM,48,-122,0,15,15
33037,58thStGreenway22ndAve,12/06/2017 01:00:00 PM,48,-122,0,21,21
33038,58thStGreenway22ndAve,12/06/2017 02:00:00 PM,48,-122,1,11,12
33039,58thStGreenway22ndAve,12/06/2017 03:00:00 PM,48,-122,3,10,13
33040,58thStGreenway22ndAve,12/06/2017 04:00:00 PM,48,-122,0,12,12
33041,58thStGreenway22ndAve,12/06/2017 05:00:00 PM,48,-122,3,7,10
33042,58thStGreenway22ndAve,12/06/2017 06:00:00 PM,48,-122,5,1,6
33043,58thStGreenway22ndAve,12/06/2017 07:00:00 PM,48,-122,0,5,5
33044,58thStGreenway22ndAve,12/06/2017 08:00:00 PM,48,-122,0,4,4
33045,58thStGreenway22ndAve,12/06/2017 09:00:00 PM,48,-122,0,4,4
33046,58thStGreenway22ndAve,12/06/2017 10:00:00 PM,48,-122,4,1,5
33047,58thStGreenway22ndAve,12/06/2017 11:00:00 PM,48,-122,0,2,2
33048,58thStGreenway22ndAve,12/07/2017 12:00:00 AM,48,-122,0,0,0
33049,58thStGreenway22ndAve,12/07/2017 01:00:00 AM,48,-122,0,1,1
33050,58thStGreenway22ndAve,12/07/2017 02:00:00 AM,48,-122,0,0,0
33051,58thStGreenway22ndAve,12/07/2017 03:00:00 AM,48,-122,0,0,0
33052,58thStGreenway22ndAve,12/07/2017 04:00:00 AM,48,-122,0,1,1
33053,58thStGreenway22ndAve,12/07/2017 05:00:00 AM,48,-122,0,3,3
33054,58thStGreenway22ndAve,12/07/2017 06:00:00 AM,48,-122,0,5,5
33055,58thStGreenway22ndAve,12/07/2017 07:00:00 AM,48,-122,0,6,6
33056,58thStGreenway22ndAve,12/07/2017 08:00:00 AM,48,-122,5,9,14
33057,58thStGreenway22ndAve,12/07/2017 09:00:00 AM,48,-122,1,6,7
33058,58thStGreenway22ndAve,12/07/2017 10:00:00 AM,48,-122,3,2,5
33059,58thStGreenway22ndAve,12/07/2017 11:00:00 AM,48,-122,6,4,10
33060,58thStGreenway22ndAve,12/07/2017 12:00:00 PM,48,-122,2,9,11
33061,58thStGreenway22ndAve,12/07/2017 01:00:00 PM,48,-122,3,5,8
33062,58thStGreenway22ndAve,12/07/2017 02:00:00 PM,48,-122,5,5,10
33063,58thStGreenway22ndAve,12/07/2017 03:00:00 PM,48,-122,0,2,2
33064,58thStGreenway22ndAve,12/07/2017 04:00:00 PM,48,-122,1,4,5
33065,58thStGreenway22ndAve,12/07/2017 05:00:00 PM,48,-122,1,15,16
33066,58thStGreenway22ndAve,12/07/2017 06:00:00 PM,48,-122,0,12,12
33067,58thStGreenway22ndAve,12/07/2017 07:00:00 PM,48,-122,0,11,11
33068,58thStGreenway22ndAve,12/07/2017 08:00:00 PM,48,-122,0,10,10
33069,58thStGreenway22ndAve,12/07/2017 09:00:00 PM,48,-122,0,5,5
33070,58thStGreenway22ndAve,12/07/2017 10:00:00 PM,48,-122,0,6,6
33071,58thStGreenway22ndAve,12/07/2017 11:00:00 PM,48,-122,0,3,3
33072,58thStGreenway22ndAve,12/08/2017 12:00:00 AM,48,-122,0,1,1
33073,58thStGreenway22ndAve,12/08/2017 01:00:00 AM,48,-122,0,0,0
33074,58thStGreenway22ndAve,12/08/2017 02:00:00 AM,48,-122,0,0,0
33075,58thStGreenway22ndAve,12/08/2017 03:00:00 AM,48,-122,0,1,1
33076,58thStGreenway22ndAve,12/08/2017 04:00:00 AM,48,-122,0,0,0
33077,58thStGreenway22ndAve,12/08/2017 05:00:00 AM,48,-122,0,2,2
33078,58thStGreenway22ndAve,12/08/2017 06:00:00 AM,48,-122,0,3,3
33079,58thStGreenway22ndAve,12/08/2017 07:00:00 AM,48,-122,1,4,5
33080,58thStGreenway22ndAve,12/08/2017 08:00:00 AM,48,-122,0,0,0
33081,58thStGreenway22ndAve,12/08/2017 09:00:00 AM,48,-122,0,0,0
33082,58thStGreenway22ndAve,12/08/2017 10:00:00 AM,48,-122,0,1,1
33083,58thStGreenway22ndAve,12/08/2017 11:00:00 AM,48,-122,1,7,8
33084,58thStGreenway22ndAve,12/08/2017 12:00:00 PM,48,-122,1,7,8
33085,58thStGreenway22ndAve,12/08/2017 01:00:00 PM,48,-122,1,10,11
33086,58thStGreenway22ndAve,12/08/2017 02:00:00 PM,48,-122,6,17,23
33087,58thStGreenway22ndAve,12/08/2017 03:00:00 PM,48,-122,1,24,25
33088,58thStGreenway22ndAve,12/08/2017 04:00:00 PM,48,-122,1,20,21
33089,58thStGreenway22ndAve,12/08/2017 05:00:00 PM,48,-122,0,15,15
33090,58thStGreenway22ndAve,12/08/2017 06:00:00 PM,48,-122,1,6,7
33091,58thStGreenway22ndAve,12/08/2017 07:00:00 PM,48,-122,1,10,11
33092,58thStGreenway22ndAve,12/08/2017 08:00:00 PM,48,-122,0,22,22
33093,58thStGreenway22ndAve,12/08/2017 09:00:00 PM,48,-122,1,6,7
33094,58thStGreenway22ndAve,12/08/2017 10:00:00 PM,48,-122,0,9,9
33095,58thStGreenway22ndAve,12/08/2017 11:00:00 PM,48,-122,0,2,2
33096,58thStGreenway22ndAve,12/09/2017 12:00:00 AM,48,-122,4,2,6
33097,58thStGreenway22ndAve,12/09/2017 01:00:00 AM,48,-122,0,1,1
33098,58thStGreenway22ndAve,12/09/2017 02:00:00 AM,48,-122,0,1,1
33099,58thStGreenway22ndAve,12/09/2017 03:00:00 AM,48,-122,0,0,0
33100,58thStGreenway22ndAve,12/09/2017 04:00:00 AM,48,-122,0,1,1
33101,58thStGreenway22ndAve,12/09/2017 05:00:00 AM,48,-122,0,0,0
33102,58thStGreenway22ndAve,12/09/2017 06:00:00 AM,48,-122,0,0,0
33103,58thStGreenway22ndAve,12/09/2017 07:00:00 AM,48,-122,0,1,1
33104,58thStGreenway22ndAve,12/09/2017 08:00:00 AM,48,-122,0,4,4
33105,58thStGreenway22ndAve,12/09/2017 09:00:00 AM,48,-122,2,9,11
33106,58thStGreenway22ndAve,12/09/2017 10:00:00 AM,48,-122,1,9,10
33107,58thStGreenway22ndAve,12/09/2017 11:00:00 AM,48,-122,2,20,22
33108,58thStGreenway22ndAve,12/09/2017 12:00:00 PM,48,-122,1,20,21
33109,58thStGreenway22ndAve,12/09/2017 01:00:00 PM,48,-122,4,15,19
33110,58thStGreenway22ndAve,12/09/2017 02:00:00 PM,48,-122,1,17,18
33111,58thStGreenway22ndAve,12/09/2017 03:00:00 PM,48,-122,2,9,11
33112,58thStGreenway22ndAve,12/09/2017 04:00:00 PM,48,-122,2,13,15
33113,58thStGreenway22ndAve,12/09/2017 05:00:00 PM,48,-122,0,7,7
33114,58thStGreenway22ndAve,12/09/2017 06:00:00 PM,48,-122,0,7,7
33115,58thStGreenway22ndAve,12/09/2017 07:00:00 PM,48,-122,1,2,3
33116,58thStGreenway22ndAve,12/09/2017 08:00:00 PM,48,-122,1,1,2
33117,58thStGreenway22ndAve,12/09/2017 09:00:00 PM,48,-122,0,3,3
33118,58thStGreenway22ndAve,12/09/2017 10:00:00 PM,48,-122,2,2,4
33119,58thStGreenway22ndAve,12/09/2017 11:00:00 PM,48,-122,0,1,1
33120,58thStGreenway22ndAve,12/10/2017 12:00:00 AM,48,-122,0,0,0
33121,58thStGreenway22ndAve,12/10/2017 01:00:00 AM,48,-122,1,0,1
33122,58thStGreenway22ndAve,12/10/2017 02:00:00 AM,48,-122,0,0,0
33123,58thStGreenway22ndAve,12/10/2017 03:00:00 AM,48,-122,0,0,0
33124,58thStGreenway22ndAve,12/10/2017 04:00:00 AM,48,-122,0,0,0
33125,58thStGreenway22ndAve,12/10/2017 05:00:00 AM,48,-122,0,0,0
33126,58thStGreenway22ndAve,12/10/2017 06:00:00 AM,48,-122,0,0,0
33127,58thStGreenway22ndAve,12/10/2017 07:00:00 AM,48,-122,0,0,0
33128,58thStGreenway22ndAve,12/10/2017 08:00:00 AM,48,-122,0,1,1
33129,58thStGreenway22ndAve,12/10/2017 09:00:00 AM,48,-122,0,1,1
33130,58thStGreenway22ndAve,12/10/2017 10:00:00 AM,48,-122,1,3,4
33131,58thStGreenway22ndAve,12/10/2017 11:00:00 AM,48,-122,5,0,5
33132,58thStGreenway22ndAve,12/10/2017 12:00:00 PM,48,-122,5,3,8
33133,58thStGreenway22ndAve,12/10/2017 01:00:00 PM,48,-122,8,5,13
33134,58thStGreenway22ndAve,12/10/2017 02:00:00 PM,48,-122,1,4,5
33135,58thStGreenway22ndAve,12/10/2017 03:00:00 PM,48,-122,3,2,5
33136,58thStGreenway22ndAve,12/10/2017 04:00:00 PM,48,-122,5,2,7
33137,58thStGreenway22ndAve,12/10/2017 05:00:00 PM,48,-122,0,5,5
33138,58thStGreenway22ndAve,12/10/2017 06:00:00 PM,48,-122,3,3,6
33139,58thStGreenway22ndAve,12/10/2017 07:00:00 PM,48,-122,2,0,2
33140,58thStGreenway22ndAve,12/10/2017 08:00:00 PM,48,-122,0,2,2
33141,58thStGreenway22ndAve,12/10/2017 09:00:00 PM,48,-122,0,0,0
33142,58thStGreenway22ndAve,12/10/2017 10:00:00 PM,48,-122,0,1,1
33143,58thStGreenway22ndAve,12/10/2017 11:00:00 PM,48,-122,0,0,0
33144,58thStGreenway22ndAve,12/11/2017 12:00:00 AM,48,-122,0,1,1
33145,58thStGreenway22ndAve,12/11/2017 01:00:00 AM,48,-122,0,0,0
33146,58thStGreenway22ndAve,12/11/2017 02:00:00 AM,48,-122,0,0,0
33147,58thStGreenway22ndAve,12/11/2017 03:00:00 AM,48,-122,0,0,0
33148,58thStGreenway22ndAve,12/11/2017 04:00:00 AM,48,-122,0,0,0
33149,58thStGreenway22ndAve,12/11/2017 05:00:00 AM,48,-122,0,0,0
33150,58thStGreenway22ndAve,12/11/2017 06:00:00 AM,48,-122,1,0,1
33151,58thStGreenway22ndAve,12/11/2017 07:00:00 AM,48,-122,0,2,2
33152,58thStGreenway22ndAve,12/11/2017 08:00:00 AM,48,-122,1,3,4
33153,58thStGreenway22ndAve,12/11/2017 09:00:00 AM,48,-122,5,0,5
33154,58thStGreenway22ndAve,12/11/2017 10:00:00 AM,48,-122,1,2,3
33155,58thStGreenway22ndAve,12/11/2017 11:00:00 AM,48,-122,6,1,7
33156,58thStGreenway22ndAve,12/11/2017 12:00:00 PM,48,-122,7,2,9
33157,58thStGreenway22ndAve,12/11/2017 01:00:00 PM,48,-122,0,2,2
33158,58thStGreenway22ndAve,12/11/2017 02:00:00 PM,48,-122,2,3,5
33159,58thStGreenway22ndAve,12/11/2017 03:00:00 PM,48,-122,0,0,0
33160,58thStGreenway22ndAve,12/11/2017 04:00:00 PM,48,-122,4,1,5
33161,58thStGreenway22ndAve,12/11/2017 05:00:00 PM,48,-122,3,7,10
33162,58thStGreenway22ndAve,12/11/2017 06:00:00 PM,48,-122,2,7,9
33163,58thStGreenway22ndAve,12/11/2017 07:00:00 PM,48,-122,0,6,6
33164,58thStGreenway22ndAve,12/11/2017 08:00:00 PM,48,-122,0,6,6
33165,58thStGreenway22ndAve,12/11/2017 09:00:00 PM,48,-122,1,6,7
33166,58thStGreenway22ndAve,12/11/2017 10:00:00 PM,48,-122,0,2,2
33167,58thStGreenway22ndAve,12/11/2017 11:00:00 PM,48,-122,0,0,0
33168,58thStGreenway22ndAve,12/12/2017 12:00:00 AM,48,-122,0,1,1
33169,58thStGreenway22ndAve,12/12/2017 01:00:00 AM,48,-122,0,0,0
33170,58thStGreenway22ndAve,12/12/2017 02:00:00 AM,48,-122,0,0,0
33171,58thStGreenway22ndAve,12/12/2017 03:00:00 AM,48,-122,0,2,2
33172,58thStGreenway22ndAve,12/12/2017 04:00:00 AM,48,-122,0,0,0
33173,58thStGreenway22ndAve,12/12/2017 05:00:00 AM,48,-122,0,0,0
33174,58thStGreenway22ndAve,12/12/2017 06:00:00 AM,48,-122,0,0,0
33175,58thStGreenway22ndAve,12/12/2017 07:00:00 AM,48,-122,0,2,2
33176,58thStGreenway22ndAve,12/12/2017 08:00:00 AM,48,-122,1,0,1
33177,58thStGreenway22ndAve,12/12/2017 09:00:00 AM,48,-122,1,3,4
33178,58thStGreenway22ndAve,12/12/2017 10:00:00 AM,48,-122,0,4,4
33179,58thStGreenway22ndAve,12/12/2017 11:00:00 AM,48,-122,2,3,5
33180,58thStGreenway22ndAve,12/12/2017 12:00:00 PM,48,-122,4,1,5
33181,58thStGreenway22ndAve,12/12/2017 01:00:00 PM,48,-122,3,1,4
33182,58thStGreenway22ndAve,12/12/2017 02:00:00 PM,48,-122,3,1,4
33183,58thStGreenway22ndAve,12/12/2017 03:00:00 PM,48,-122,2,10,12
33184,58thStGreenway22ndAve,12/12/2017 04:00:00 PM,48,-122,1,3,4
33185,58thStGreenway22ndAve,12/12/2017 05:00:00 PM,48,-122,2,6,8
33186,58thStGreenway22ndAve,12/12/2017 06:00:00 PM,48,-122,2,6,8
33187,58thStGreenway22ndAve,12/12/2017 07:00:00 PM,48,-122,1,8,9
33188,58thStGreenway22ndAve,12/12/2017 08:00:00 PM,48,-122,0,6,6
33189,58thStGreenway22ndAve,12/12/2017 09:00:00 PM,48,-122,1,1,2
33190,58thStGreenway22ndAve,12/12/2017 10:00:00 PM,48,-122,0,2,2
33191,58thStGreenway22ndAve,12/12/2017 11:00:00 PM,48,-122,0,6,6
33192,58thStGreenway22ndAve,12/13/2017 12:00:00 AM,48,-122,0,2,2
33193,58thStGreenway22ndAve,12/13/2017 01:00:00 AM,48,-122,0,0,0
33194,58thStGreenway22ndAve,12/13/2017 02:00:00 AM,48,-122,0,0,0
33195,58thStGreenway22ndAve,12/13/2017 03:00:00 AM,48,-122,0,0,0
33196,58thStGreenway22ndAve,12/13/2017 04:00:00 AM,48,-122,0,3,3
33197,58thStGreenway22ndAve,12/13/2017 05:00:00 AM,48,-122,0,1,1
33198,58thStGreenway22ndAve,12/13/2017 06:00:00 AM,48,-122,0,0,0
33199,58thStGreenway22ndAve,12/13/2017 07:00:00 AM,48,-122,0,3,3
33200,58thStGreenway22ndAve,12/13/2017 08:00:00 AM,48,-122,1,1,2
33201,58thStGreenway22ndAve,12/13/2017 09:00:00 AM,48,-122,1,6,7
33202,58thStGreenway22ndAve,12/13/2017 10:00:00 AM,48,-122,1,3,4
33203,58thStGreenway22ndAve,12/13/2017 11:00:00 AM,48,-122,2,5,7
33204,58thStGreenway22ndAve,12/13/2017 12:00:00 PM,48,-122,1,2,3
33205,58thStGreenway22ndAve,12/13/2017 01:00:00 PM,48,-122,0,2,2
33206,58thStGreenway22ndAve,12/13/2017 02:00:00 PM,48,-122,3,5,8
33207,58thStGreenway22ndAve,12/13/2017 03:00:00 PM,48,-122,0,4,4
33208,58thStGreenway22ndAve,12/13/2017 04:00:00 PM,48,-122,0,10,10
33209,58thStGreenway22ndAve,12/13/2017 05:00:00 PM,48,-122,1,6,7
33210,58thStGreenway22ndAve,12/13/2017 06:00:00 PM,48,-122,0,10,10
33211,58thStGreenway22ndAve,12/13/2017 07:00:00 PM,48,-122,0,6,6
33212,58thStGreenway22ndAve,12/13/2017 08:00:00 PM,48,-122,0,5,5
33213,58thStGreenway22ndAve,12/13/2017 09:00:00 PM,48,-122,0,2,2
33214,58thStGreenway22ndAve,12/13/2017 10:00:00 PM,48,-122,0,3,3
33215,58thStGreenway22ndAve,12/13/2017 11:00:00 PM,48,-122,0,1,1
33216,58thStGreenway22ndAve,12/14/2017 12:00:00 AM,48,-122,0,0,0
33217,58thStGreenway22ndAve,12/14/2017 01:00:00 AM,48,-122,0,0,0
33218,58thStGreenway22ndAve,12/14/2017 02:00:00 AM,48,-122,0,0,0
33219,58thStGreenway22ndAve,12/14/2017 03:00:00 AM,48,-122,0,0,0
33220,58thStGreenway22ndAve,12/14/2017 04:00:00 AM,48,-122,0,0,0
33221,58thStGreenway22ndAve,12/14/2017 05:00:00 AM,48,-122,0,0,0
33222,58thStGreenway22ndAve,12/14/2017 06:00:00 AM,48,-122,1,0,1
33223,58thStGreenway22ndAve,12/14/2017 07:00:00 AM,48,-122,0,1,1
33224,58thStGreenway22ndAve,12/14/2017 08:00:00 AM,48,-122,2,0,2
33225,58thStGreenway22ndAve,12/14/2017 09:00:00 AM,48,-122,3,4,7
33226,58thStGreenway22ndAve,12/14/2017 10:00:00 AM,48,-122,1,4,5
33227,58thStGreenway22ndAve,12/14/2017 11:00:00 AM,48,-122,0,8,8
33228,58thStGreenway22ndAve,12/14/2017 12:00:00 PM,48,-122,0,2,2
33229,58thStGreenway22ndAve,12/14/2017 01:00:00 PM,48,-122,1,4,5
33230,58thStGreenway22ndAve,12/14/2017 02:00:00 PM,48,-122,0,7,7
33231,58thStGreenway22ndAve,12/14/2017 03:00:00 PM,48,-122,0,4,4
33232,58thStGreenway22ndAve,12/14/2017 04:00:00 PM,48,-122,4,7,11
33233,58thStGreenway22ndAve,12/14/2017 05:00:00 PM,48,-122,4,8,12
33234,58thStGreenway22ndAve,12/14/2017 06:00:00 PM,48,-122,1,9,10
33235,58thStGreenway22ndAve,12/14/2017 07:00:00 PM,48,-122,0,6,6
33236,58thStGreenway22ndAve,12/14/2017 08:00:00 PM,48,-122,1,5,6
33237,58thStGreenway22ndAve,12/14/2017 09:00:00 PM,48,-122,0,3,3
33238,58thStGreenway22ndAve,12/14/2017 10:00:00 PM,48,-122,0,0,0
33239,58thStGreenway22ndAve,12/14/2017 11:00:00 PM,48,-122,0,0,0
33240,58thStGreenway22ndAve,12/15/2017 12:00:00 AM,48,-122,0,2,2
33241,58thStGreenway22ndAve,12/15/2017 01:00:00 AM,48,-122,0,0,0
33242,58thStGreenway22ndAve,12/15/2017 02:00:00 AM,48,-122,0,0,0
33243,58thStGreenway22ndAve,12/15/2017 03:00:00 AM,48,-122,0,0,0
33244,58thStGreenway22ndAve,12/15/2017 04:00:00 AM,48,-122,0,0,0
33245,58thStGreenway22ndAve,12/15/2017 05:00:00 AM,48,-122,0,1,1
33246,58thStGreenway22ndAve,12/15/2017 06:00:00 AM,48,-122,1,1,2
33247,58thStGreenway22ndAve,12/15/2017 07:00:00 AM,48,-122,3,0,3
33248,58thStGreenway22ndAve,12/15/2017 08:00:00 AM,48,-122,0,2,2
33249,58thStGreenway22ndAve,12/15/2017 09:00:00 AM,48,-122,1,3,4
33250,58thStGreenway22ndAve,12/15/2017 10:00:00 AM,48,-122,1,2,3
33251,58thStGreenway22ndAve,12/15/2017 11:00:00 AM,48,-122,3,1,4
33252,58thStGreenway22ndAve,12/15/2017 12:00:00 PM,48,-122,0,3,3
33253,58thStGreenway22ndAve,12/15/2017 01:00:00 PM,48,-122,1,3,4
33254,58thStGreenway22ndAve,12/15/2017 02:00:00 PM,48,-122,5,3,8
33255,58thStGreenway22ndAve,12/15/2017 03:00:00 PM,48,-122,1,4,5
33256,58thStGreenway22ndAve,12/15/2017 04:00:00 PM,48,-122,1,3,4
33257,58thStGreenway22ndAve,12/15/2017 05:00:00 PM,48,-122,0,4,4
33258,58thStGreenway22ndAve,12/15/2017 06:00:00 PM,48,-122,5,1,6
33259,58thStGreenway22ndAve,12/15/2017 07:00:00 PM,48,-122,1,0,1
33260,58thStGreenway22ndAve,12/15/2017 08:00:00 PM,48,-122,0,1,1
33261,58thStGreenway22ndAve,12/15/2017 09:00:00 PM,48,-122,0,2,2
33262,58thStGreenway22ndAve,12/15/2017 10:00:00 PM,48,-122,1,1,2
33263,58thStGreenway22ndAve,12/15/2017 11:00:00 PM,48,-122,0,2,2
33264,58thStGreenway22ndAve,12/16/2017 12:00:00 AM,48,-122,1,1,2
33265,58thStGreenway22ndAve,12/16/2017 01:00:00 AM,48,-122,0,0,0
33266,58thStGreenway22ndAve,12/16/2017 02:00:00 AM,48,-122,1,0,1
33267,58thStGreenway22ndAve,12/16/2017 03:00:00 AM,48,-122,0,0,0
33268,58thStGreenway22ndAve,12/16/2017 04:00:00 AM,48,-122,0,0,0
33269,58thStGreenway22ndAve,12/16/2017 05:00:00 AM,48,-122,0,1,1
33270,58thStGreenway22ndAve,12/16/2017 06:00:00 AM,48,-122,1,0,1
33271,58thStGreenway22ndAve,12/16/2017 07:00:00 AM,48,-122,0,0,0
33272,58thStGreenway22ndAve,12/16/2017 08:00:00 AM,48,-122,1,4,5
33273,58thStGreenway22ndAve,12/16/2017 09:00:00 AM,48,-122,0,1,1
33274,58thStGreenway22ndAve,12/16/2017 10:00:00 AM,48,-122,2,0,2
33275,58thStGreenway22ndAve,12/16/2017 11:00:00 AM,48,-122,1,4,5
33276,58thStGreenway22ndAve,12/16/2017 12:00:00 PM,48,-122,6,0,6
33277,58thStGreenway22ndAve,12/16/2017 01:00:00 PM,48,-122,2,0,2
33278,58thStGreenway22ndAve,12/16/2017 02:00:00 PM,48,-122,6,1,7
33279,58thStGreenway22ndAve,12/16/2017 03:00:00 PM,48,-122,1,0,1
33280,58thStGreenway22ndAve,12/16/2017 04:00:00 PM,48,-122,1,2,3
33281,58thStGreenway22ndAve,12/16/2017 05:00:00 PM,48,-122,1,7,8
33282,58thStGreenway22ndAve,12/16/2017 06:00:00 PM,48,-122,1,0,1
33283,58thStGreenway22ndAve,12/16/2017 07:00:00 PM,48,-122,0,1,1
33284,58thStGreenway22ndAve,12/16/2017 08:00:00 PM,48,-122,0,0,0
33285,58thStGreenway22ndAve,12/16/2017 09:00:00 PM,48,-122,2,0,2
33286,58thStGreenway22ndAve,12/16/2017 10:00:00 PM,48,-122,0,1,1
33287,58thStGreenway22ndAve,12/16/2017 11:00:00 PM,48,-122,0,1,1
33288,58thStGreenway22ndAve,12/17/2017 12:00:00 AM,48,-122,0,0,0
33289,58thStGreenway22ndAve,12/17/2017 01:00:00 AM,48,-122,0,0,0
33290,58thStGreenway22ndAve,12/17/2017 02:00:00 AM,48,-122,0,0,0
33291,58thStGreenway22ndAve,12/17/2017 03:00:00 AM,48,-122,0,0,0
33292,58thStGreenway22ndAve,12/17/2017 04:00:00 AM,48,-122,0,0,0
33293,58thStGreenway22ndAve,12/17/2017 05:00:00 AM,48,-122,0,0,0
33294,58thStGreenway22ndAve,12/17/2017 06:00:00 AM,48,-122,0,0,0
33295,58thStGreenway22ndAve,12/17/2017 07:00:00 AM,48,-122,0,0,0
33296,58thStGreenway22ndAve,12/17/2017 08:00:00 AM,48,-122,0,2,2
33297,58thStGreenway22ndAve,12/17/2017 09:00:00 AM,48,-122,0,0,0
33298,58thStGreenway22ndAve,12/17/2017 10:00:00 AM,48,-122,0,0,0
33299,58thStGreenway22ndAve,12/17/2017 11:00:00 AM,48,-122,2,2,4
33300,58thStGreenway22ndAve,12/17/2017 12:00:00 PM,48,-122,5,3,8
33301,58thStGreenway22ndAve,12/17/2017 01:00:00 PM,48,-122,1,4,5
33302,58thStGreenway22ndAve,12/17/2017 02:00:00 PM,48,-122,0,3,3
33303,58thStGreenway22ndAve,12/17/2017 03:00:00 PM,48,-122,3,1,4
33304,58thStGreenway22ndAve,12/17/2017 04:00:00 PM,48,-122,0,2,2
33305,58thStGreenway22ndAve,12/17/2017 05:00:00 PM,48,-122,0,1,1
33306,58thStGreenway22ndAve,12/17/2017 06:00:00 PM,48,-122,0,0,0
33307,58thStGreenway22ndAve,12/17/2017 07:00:00 PM,48,-122,0,0,0
33308,58thStGreenway22ndAve,12/17/2017 08:00:00 PM,48,-122,0,1,1
33309,58thStGreenway22ndAve,12/17/2017 09:00:00 PM,48,-122,1,0,1
33310,58thStGreenway22ndAve,12/17/2017 10:00:00 PM,48,-122,0,0,0
33311,58thStGreenway22ndAve,12/17/2017 11:00:00 PM,48,-122,0,0,0
33312,58thStGreenway22ndAve,12/18/2017 12:00:00 AM,48,-122,0,1,1
33313,58thStGreenway22ndAve,12/18/2017 01:00:00 AM,48,-122,0,0,0
33314,58thStGreenway22ndAve,12/18/2017 02:00:00 AM,48,-122,0,0,0
33315,58thStGreenway22ndAve,12/18/2017 03:00:00 AM,48,-122,0,0,0
33316,58thStGreenway22ndAve,12/18/2017 04:00:00 AM,48,-122,0,1,1
33317,58thStGreenway22ndAve,12/18/2017 05:00:00 AM,48,-122,0,0,0
33318,58thStGreenway22ndAve,12/18/2017 06:00:00 AM,48,-122,1,0,1
33319,58thStGreenway22ndAve,12/18/2017 07:00:00 AM,48,-122,2,1,3
33320,58thStGreenway22ndAve,12/18/2017 08:00:00 AM,48,-122,0,6,6
33321,58thStGreenway22ndAve,12/18/2017 09:00:00 AM,48,-122,0,2,2
33322,58thStGreenway22ndAve,12/18/2017 10:00:00 AM,48,-122,0,0,0
33323,58thStGreenway22ndAve,12/18/2017 11:00:00 AM,48,-122,1,0,1
33324,58thStGreenway22ndAve,12/18/2017 12:00:00 PM,48,-122,1,2,3
33325,58thStGreenway22ndAve,12/18/2017 01:00:00 PM,48,-122,2,0,2
33326,58thStGreenway22ndAve,12/18/2017 02:00:00 PM,48,-122,0,1,1
33327,58thStGreenway22ndAve,12/18/2017 03:00:00 PM,48,-122,2,0,2
33328,58thStGreenway22ndAve,12/18/2017 04:00:00 PM,48,-122,1,0,1
33329,58thStGreenway22ndAve,12/18/2017 05:00:00 PM,48,-122,2,0,2
33330,58thStGreenway22ndAve,12/18/2017 06:00:00 PM,48,-122,4,2,6
33331,58thStGreenway22ndAve,12/18/2017 07:00:00 PM,48,-122,0,1,1
33332,58thStGreenway22ndAve,12/18/2017 08:00:00 PM,48,-122,1,0,1
33333,58thStGreenway22ndAve,12/18/2017 09:00:00 PM,48,-122,2,0,2
33334,58thStGreenway22ndAve,12/18/2017 10:00:00 PM,48,-122,0,0,0
33335,58thStGreenway22ndAve,12/18/2017 11:00:00 PM,48,-122,0,1,1
33336,58thStGreenway22ndAve,12/19/2017 12:00:00 AM,48,-122,0,0,0
33337,58thStGreenway22ndAve,12/19/2017 01:00:00 AM,48,-122,0,0,0
33338,58thStGreenway22ndAve,12/19/2017 02:00:00 AM,48,-122,1,0,1
33339,58thStGreenway22ndAve,12/19/2017 03:00:00 AM,48,-122,0,0,0
33340,58thStGreenway22ndAve,12/19/2017 04:00:00 AM,48,-122,0,0,0
33341,58thStGreenway22ndAve,12/19/2017 05:00:00 AM,48,-122,0,0,0
33342,58thStGreenway22ndAve,12/19/2017 06:00:00 AM,48,-122,1,4,5
33343,58thStGreenway22ndAve,12/19/2017 07:00:00 AM,48,-122,0,7,7
33344,58thStGreenway22ndAve,12/19/2017 08:00:00 AM,48,-122,2,9,11
33345,58thStGreenway22ndAve,12/19/2017 09:00:00 AM,48,-122,3,12,15
33346,58thStGreenway22ndAve,12/19/2017 10:00:00 AM,48,-122,0,7,7
33347,58thStGreenway22ndAve,12/19/2017 11:00:00 AM,48,-122,1,10,11
33348,58thStGreenway22ndAve,12/19/2017 12:00:00 PM,48,-122,1,9,10
33349,58thStGreenway22ndAve,12/19/2017 01:00:00 PM,48,-122,0,9,9
33350,58thStGreenway22ndAve,12/19/2017 02:00:00 PM,48,-122,7,8,15
33351,58thStGreenway22ndAve,12/19/2017 03:00:00 PM,48,-122,1,14,15
33352,58thStGreenway22ndAve,12/19/2017 04:00:00 PM,48,-122,4,10,14
33353,58thStGreenway22ndAve,12/19/2017 05:00:00 PM,48,-122,0,13,13
33354,58thStGreenway22ndAve,12/19/2017 06:00:00 PM,48,-122,3,6,9
33355,58thStGreenway22ndAve,12/19/2017 07:00:00 PM,48,-122,2,4,6
33356,58thStGreenway22ndAve,12/19/2017 08:00:00 PM,48,-122,0,5,5
33357,58thStGreenway22ndAve,12/19/2017 09:00:00 PM,48,-122,0,2,2
33358,58thStGreenway22ndAve,12/19/2017 10:00:00 PM,48,-122,0,4,4
33359,58thStGreenway22ndAve,12/19/2017 11:00:00 PM,48,-122,0,0,0
33360,58thStGreenway22ndAve,12/20/2017 12:00:00 AM,48,-122,0,0,0
33361,58thStGreenway22ndAve,12/20/2017 01:00:00 AM,48,-122,0,0,0
33362,58thStGreenway22ndAve,12/20/2017 02:00:00 AM,48,-122,0,0,0
33363,58thStGreenway22ndAve,12/20/2017 03:00:00 AM,48,-122,0,0,0
33364,58thStGreenway22ndAve,12/20/2017 04:00:00 AM,48,-122,0,0,0
33365,58thStGreenway22ndAve,12/20/2017 05:00:00 AM,48,-122,0,0,0
33366,58thStGreenway22ndAve,12/20/2017 06:00:00 AM,48,-122,0,0,0
33367,58thStGreenway22ndAve,12/20/2017 07:00:00 AM,48,-122,0,0,0
33368,58thStGreenway22ndAve,12/20/2017 08:00:00 AM,48,-122,0,0,0
33369,58thStGreenway22ndAve,12/20/2017 09:00:00 AM,48,-122,0,0,0
33370,58thStGreenway22ndAve,12/20/2017 10:00:00 AM,48,-122,0,1,1
33371,58thStGreenway22ndAve,12/20/2017 11:00:00 AM,48,-122,4,5,9
33372,58thStGreenway22ndAve,12/20/2017 12:00:00 PM,48,-122,2,14,16
33373,58thStGreenway22ndAve,12/20/2017 01:00:00 PM,48,-122,1,11,12
33374,58thStGreenway22ndAve,12/20/2017 02:00:00 PM,48,-122,0,6,6
33375,58thStGreenway22ndAve,12/20/2017 03:00:00 PM,48,-122,1,7,8
33376,58thStGreenway22ndAve,12/20/2017 04:00:00 PM,48,-122,1,12,13
33377,58thStGreenway22ndAve,12/20/2017 05:00:00 PM,48,-122,0,7,7
33378,58thStGreenway22ndAve,12/20/2017 06:00:00 PM,48,-122,2,9,11
33379,58thStGreenway22ndAve,12/20/2017 07:00:00 PM,48,-122,0,12,12
33380,58thStGreenway22ndAve,12/20/2017 08:00:00 PM,48,-122,0,6,6
33381,58thStGreenway22ndAve,12/20/2017 09:00:00 PM,48,-122,0,5,5
33382,58thStGreenway22ndAve,12/20/2017 10:00:00 PM,48,-122,0,4,4
33383,58thStGreenway22ndAve,12/20/2017 11:00:00 PM,48,-122,0,2,2
33384,58thStGreenway22ndAve,12/21/2017 12:00:00 AM,48,-122,0,0,0
33385,58thStGreenway22ndAve,12/21/2017 01:00:00 AM,48,-122,0,0,0
33386,58thStGreenway22ndAve,12/21/2017 02:00:00 AM,48,-122,0,1,1
33387,58thStGreenway22ndAve,12/21/2017 03:00:00 AM,48,-122,0,0,0
33388,58thStGreenway22ndAve,12/21/2017 04:00:00 AM,48,-122,0,1,1
33389,58thStGreenway22ndAve,12/21/2017 05:00:00 AM,48,-122,0,3,3
33390,58thStGreenway22ndAve,12/21/2017 06:00:00 AM,48,-122,0,0,0
33391,58thStGreenway22ndAve,12/21/2017 07:00:00 AM,48,-122,0,0,0
33392,58thStGreenway22ndAve,12/21/2017 08:00:00 AM,48,-122,0,0,0
33393,58thStGreenway22ndAve,12/21/2017 09:00:00 AM,48,-122,1,6,7
33394,58thStGreenway22ndAve,12/21/2017 10:00:00 AM,48,-122,0,17,17
33395,58thStGreenway22ndAve,12/21/2017 11:00:00 AM,48,-122,1,9,10
33396,58thStGreenway22ndAve,12/21/2017 12:00:00 PM,48,-122,2,9,11
33397,58thStGreenway22ndAve,12/21/2017 01:00:00 PM,48,-122,3,8,11
33398,58thStGreenway22ndAve,12/21/2017 02:00:00 PM,48,-122,1,4,5
33399,58thStGreenway22ndAve,12/21/2017 03:00:00 PM,48,-122,3,9,12
33400,58thStGreenway22ndAve,12/21/2017 04:00:00 PM,48,-122,3,6,9
33401,58thStGreenway22ndAve,12/21/2017 05:00:00 PM,48,-122,0,8,8
33402,58thStGreenway22ndAve,12/21/2017 06:00:00 PM,48,-122,3,5,8
33403,58thStGreenway22ndAve,12/21/2017 07:00:00 PM,48,-122,0,5,5
33404,58thStGreenway22ndAve,12/21/2017 08:00:00 PM,48,-122,0,4,4
33405,58thStGreenway22ndAve,12/21/2017 09:00:00 PM,48,-122,1,3,4
33406,58thStGreenway22ndAve,12/21/2017 10:00:00 PM,48,-122,0,3,3
33407,58thStGreenway22ndAve,12/21/2017 11:00:00 PM,48,-122,0,1,1
33408,58thStGreenway22ndAve,12/22/2017 12:00:00 AM,48,-122,0,2,2
33409,58thStGreenway22ndAve,12/22/2017 01:00:00 AM,48,-122,0,1,1
33410,58thStGreenway22ndAve,12/22/2017 02:00:00 AM,48,-122,0,0,0
33411,58thStGreenway22ndAve,12/22/2017 03:00:00 AM,48,-122,0,0,0
33412,58thStGreenway22ndAve,12/22/2017 04:00:00 AM,48,-122,0,0,0
33413,58thStGreenway22ndAve,12/22/2017 05:00:00 AM,48,-122,0,2,2
33414,58thStGreenway22ndAve,12/22/2017 06:00:00 AM,48,-122,0,0,0
33415,58thStGreenway22ndAve,12/22/2017 07:00:00 AM,48,-122,3,5,8
33416,58thStGreenway22ndAve,12/22/2017 08:00:00 AM,48,-122,0,3,3
33417,58thStGreenway22ndAve,12/22/2017 09:00:00 AM,48,-122,1,4,5
33418,58thStGreenway22ndAve,12/22/2017 10:00:00 AM,48,-122,3,9,12
33419,58thStGreenway22ndAve,12/22/2017 11:00:00 AM,48,-122,2,8,10
33420,58thStGreenway22ndAve,12/22/2017 12:00:00 PM,48,-122,0,10,10
33421,58thStGreenway22ndAve,12/22/2017 01:00:00 PM,48,-122,5,7,12
33422,58thStGreenway22ndAve,12/22/2017 02:00:00 PM,48,-122,2,9,11
33423,58thStGreenway22ndAve,12/22/2017 03:00:00 PM,48,-122,1,15,16
33424,58thStGreenway22ndAve,12/22/2017 04:00:00 PM,48,-122,6,6,12
33425,58thStGreenway22ndAve,12/22/2017 05:00:00 PM,48,-122,3,5,8
33426,58thStGreenway22ndAve,12/22/2017 06:00:00 PM,48,-122,7,4,11
33427,58thStGreenway22ndAve,12/22/2017 07:00:00 PM,48,-122,3,7,10
33428,58thStGreenway22ndAve,12/22/2017 08:00:00 PM,48,-122,0,3,3
33429,58thStGreenway22ndAve,12/22/2017 09:00:00 PM,48,-122,1,2,3
33430,58thStGreenway22ndAve,12/22/2017 10:00:00 PM,48,-122,0,2,2
33431,58thStGreenway22ndAve,12/22/2017 11:00:00 PM,48,-122,0,2,2
33432,58thStGreenway22ndAve,12/23/2017 12:00:00 AM,48,-122,0,0,0
33433,58thStGreenway22ndAve,12/23/2017 01:00:00 AM,48,-122,0,1,1
33434,58thStGreenway22ndAve,12/23/2017 02:00:00 AM,48,-122,0,0,0
33435,58thStGreenway22ndAve,12/23/2017 03:00:00 AM,48,-122,0,2,2
33436,58thStGreenway22ndAve,12/23/2017 04:00:00 AM,48,-122,0,0,0
33437,58thStGreenway22ndAve,12/23/2017 05:00:00 AM,48,-122,1,0,1
33438,58thStGreenway22ndAve,12/23/2017 06:00:00 AM,48,-122,0,0,0
33439,58thStGreenway22ndAve,12/23/2017 07:00:00 AM,48,-122,0,5,5
33440,58thStGreenway22ndAve,12/23/2017 08:00:00 AM,48,-122,0,4,4
33441,58thStGreenway22ndAve,12/23/2017 09:00:00 AM,48,-122,3,6,9
33442,58thStGreenway22ndAve,12/23/2017 10:00:00 AM,48,-122,1,9,10
33443,58thStGreenway22ndAve,12/23/2017 11:00:00 AM,48,-122,5,15,20
33444,58thStGreenway22ndAve,12/23/2017 12:00:00 PM,48,-122,3,8,11
33445,58thStGreenway22ndAve,12/23/2017 01:00:00 PM,48,-122,10,11,21
33446,58thStGreenway22ndAve,12/23/2017 02:00:00 PM,48,-122,3,8,11
33447,58thStGreenway22ndAve,12/23/2017 03:00:00 PM,48,-122,1,4,5
33448,58thStGreenway22ndAve,12/23/2017 04:00:00 PM,48,-122,0,2,2
33449,58thStGreenway22ndAve,12/23/2017 05:00:00 PM,48,-122,0,1,1
33450,58thStGreenway22ndAve,12/23/2017 06:00:00 PM,48,-122,0,9,9
33451,58thStGreenway22ndAve,12/23/2017 07:00:00 PM,48,-122,0,4,4
33452,58thStGreenway22ndAve,12/23/2017 08:00:00 PM,48,-122,2,2,4
33453,58thStGreenway22ndAve,12/23/2017 09:00:00 PM,48,-122,1,9,10
33454,58thStGreenway22ndAve,12/23/2017 10:00:00 PM,48,-122,0,0,0
33455,58thStGreenway22ndAve,12/23/2017 11:00:00 PM,48,-122,0,0,0
33456,58thStGreenway22ndAve,12/24/2017 12:00:00 AM,48,-122,0,0,0
33457,58thStGreenway22ndAve,12/24/2017 01:00:00 AM,48,-122,0,0,0
33458,58thStGreenway22ndAve,12/24/2017 02:00:00 AM,48,-122,0,0,0
33459,58thStGreenway22ndAve,12/24/2017 03:00:00 AM,48,-122,0,0,0
33460,58thStGreenway22ndAve,12/24/2017 04:00:00 AM,48,-122,0,0,0
33461,58thStGreenway22ndAve,12/24/2017 05:00:00 AM,48,-122,0,0,0
33462,58thStGreenway22ndAve,12/24/2017 06:00:00 AM,48,-122,0,0,0
33463,58thStGreenway22ndAve,12/24/2017 07:00:00 AM,48,-122,0,0,0
33464,58thStGreenway22ndAve,12/24/2017 08:00:00 AM,48,-122,0,0,0
33465,58thStGreenway22ndAve,12/24/2017 09:00:00 AM,48,-122,0,0,0
33466,58thStGreenway22ndAve,12/24/2017 10:00:00 AM,48,-122,1,5,6
33467,58thStGreenway22ndAve,12/24/2017 11:00:00 AM,48,-122,0,12,12
33468,58thStGreenway22ndAve,12/24/2017 12:00:00 PM,48,-122,0,4,4
33469,58thStGreenway22ndAve,12/24/2017 01:00:00 PM,48,-122,0,6,6
33470,58thStGreenway22ndAve,12/24/2017 02:00:00 PM,48,-122,0,1,1
33471,58thStGreenway22ndAve,12/24/2017 03:00:00 PM,48,-122,2,7,9
33472,58thStGreenway22ndAve,12/24/2017 04:00:00 PM,48,-122,0,0,0
33473,58thStGreenway22ndAve,12/24/2017 05:00:00 PM,48,-122,0,0,0
33474,58thStGreenway22ndAve,12/24/2017 06:00:00 PM,48,-122,0,1,1
33475,58thStGreenway22ndAve,12/24/2017 07:00:00 PM,48,-122,0,0,0
33476,58thStGreenway22ndAve,12/24/2017 08:00:00 PM,48,-122,0,0,0
33477,58thStGreenway22ndAve,12/24/2017 09:00:00 PM,48,-122,0,1,1
33478,58thStGreenway22ndAve,12/24/2017 10:00:00 PM,48,-122,0,1,1
33479,58thStGreenway22ndAve,12/24/2017 11:00:00 PM,48,-122,0,1,1
33480,58thStGreenway22ndAve,12/25/2017 12:00:00 AM,48,-122,0,0,0
33481,58thStGreenway22ndAve,12/25/2017 01:00:00 AM,48,-122,0,1,1
33482,58thStGreenway22ndAve,12/25/2017 02:00:00 AM,48,-122,0,0,0
33483,58thStGreenway22ndAve,12/25/2017 03:00:00 AM,48,-122,0,0,0
33484,58thStGreenway22ndAve,12/25/2017 04:00:00 AM,48,-122,0,0,0
33485,58thStGreenway22ndAve,12/25/2017 05:00:00 AM,48,-122,0,1,1
33486,58thStGreenway22ndAve,12/25/2017 06:00:00 AM,48,-122,0,0,0
33487,58thStGreenway22ndAve,12/25/2017 07:00:00 AM,48,-122,0,1,1
33488,58thStGreenway22ndAve,12/25/2017 08:00:00 AM,48,-122,0,0,0
33489,58thStGreenway22ndAve,12/25/2017 09:00:00 AM,48,-122,0,0,0
33490,58thStGreenway22ndAve,12/25/2017 10:00:00 AM,48,-122,1,0,1
33491,58thStGreenway22ndAve,12/25/2017 11:00:00 AM,48,-122,0,2,2
33492,58thStGreenway22ndAve,12/25/2017 12:00:00 PM,48,-122,0,1,1
33493,58thStGreenway22ndAve,12/25/2017 01:00:00 PM,48,-122,1,0,1
33494,58thStGreenway22ndAve,12/25/2017 02:00:00 PM,48,-122,0,1,1
33495,58thStGreenway22ndAve,12/25/2017 03:00:00 PM,48,-122,0,2,2
33496,58thStGreenway22ndAve,12/25/2017 04:00:00 PM,48,-122,0,2,2
33497,58thStGreenway22ndAve,12/25/2017 05:00:00 PM,48,-122,3,0,3
33498,58thStGreenway22ndAve,12/25/2017 06:00:00 PM,48,-122,0,1,1
33499,58thStGreenway22ndAve,12/25/2017 07:00:00 PM,48,-122,0,1,1
33500,58thStGreenway22ndAve,12/25/2017 08:00:00 PM,48,-122,0,3,3
33501,58thStGreenway22ndAve,12/25/2017 09:00:00 PM,48,-122,0,2,2
33502,58thStGreenway22ndAve,12/25/2017 10:00:00 PM,48,-122,0,1,1
33503,58thStGreenway22ndAve,12/25/2017 11:00:00 PM,48,-122,0,0,0
33504,58thStGreenway22ndAve,12/26/2017 12:00:00 AM,48,-122,0,0,0
33505,58thStGreenway22ndAve,12/26/2017 01:00:00 AM,48,-122,0,0,0
33506,58thStGreenway22ndAve,12/26/2017 02:00:00 AM,48,-122,0,0,0
33507,58thStGreenway22ndAve,12/26/2017 03:00:00 AM,48,-122,0,1,1
33508,58thStGreenway22ndAve,12/26/2017 04:00:00 AM,48,-122,0,2,2
33509,58thStGreenway22ndAve,12/26/2017 05:00:00 AM,48,-122,0,0,0
33510,58thStGreenway22ndAve,12/26/2017 06:00:00 AM,48,-122,0,1,1
33511,58thStGreenway22ndAve,12/26/2017 07:00:00 AM,48,-122,1,2,3
33512,58thStGreenway22ndAve,12/26/2017 08:00:00 AM,48,-122,0,5,5
33513,58thStGreenway22ndAve,12/26/2017 09:00:00 AM,48,-122,0,3,3
33514,58thStGreenway22ndAve,12/26/2017 10:00:00 AM,48,-122,0,5,5
33515,58thStGreenway22ndAve,12/26/2017 11:00:00 AM,48,-122,1,5,6
33516,58thStGreenway22ndAve,12/26/2017 12:00:00 PM,48,-122,0,5,5
33517,58thStGreenway22ndAve,12/26/2017 01:00:00 PM,48,-122,1,7,8
33518,58thStGreenway22ndAve,12/26/2017 02:00:00 PM,48,-122,1,11,12
33519,58thStGreenway22ndAve,12/26/2017 03:00:00 PM,48,-122,1,8,9
33520,58thStGreenway22ndAve,12/26/2017 04:00:00 PM,48,-122,0,8,8
33521,58thStGreenway22ndAve,12/26/2017 05:00:00 PM,48,-122,0,6,6
33522,58thStGreenway22ndAve,12/26/2017 06:00:00 PM,48,-122,1,6,7
33523,58thStGreenway22ndAve,12/26/2017 07:00:00 PM,48,-122,0,3,3
33524,58thStGreenway22ndAve,12/26/2017 08:00:00 PM,48,-122,0,4,4
33525,58thStGreenway22ndAve,12/26/2017 09:00:00 PM,48,-122,0,0,0
33526,58thStGreenway22ndAve,12/26/2017 10:00:00 PM,48,-122,0,1,1
33527,58thStGreenway22ndAve,12/26/2017 11:00:00 PM,48,-122,0,4,4
33528,58thStGreenway22ndAve,12/27/2017 12:00:00 AM,48,-122,0,0,0
33529,58thStGreenway22ndAve,12/27/2017 01:00:00 AM,48,-122,0,0,0
33530,58thStGreenway22ndAve,12/27/2017 02:00:00 AM,48,-122,0,0,0
33531,58thStGreenway22ndAve,12/27/2017 03:00:00 AM,48,-122,0,0,0
33532,58thStGreenway22ndAve,12/27/2017 04:00:00 AM,48,-122,0,1,1
33533,58thStGreenway22ndAve,12/27/2017 05:00:00 AM,48,-122,0,0,0
33534,58thStGreenway22ndAve,12/27/2017 06:00:00 AM,48,-122,0,2,2
33535,58thStGreenway22ndAve,12/27/2017 07:00:00 AM,48,-122,0,4,4
33536,58thStGreenway22ndAve,12/27/2017 08:00:00 AM,48,-122,1,1,2
33537,58thStGreenway22ndAve,12/27/2017 09:00:00 AM,48,-122,1,0,1
33538,58thStGreenway22ndAve,12/27/2017 10:00:00 AM,48,-122,1,0,1
33539,58thStGreenway22ndAve,12/27/2017 11:00:00 AM,48,-122,3,0,3
33540,58thStGreenway22ndAve,12/27/2017 12:00:00 PM,48,-122,1,1,2
33541,58thStGreenway22ndAve,12/27/2017 01:00:00 PM,48,-122,3,5,8
33542,58thStGreenway22ndAve,12/27/2017 02:00:00 PM,48,-122,1,3,4
33543,58thStGreenway22ndAve,12/27/2017 03:00:00 PM,48,-122,2,0,2
33544,58thStGreenway22ndAve,12/27/2017 04:00:00 PM,48,-122,2,0,2
33545,58thStGreenway22ndAve,12/27/2017 05:00:00 PM,48,-122,3,1,4
33546,58thStGreenway22ndAve,12/27/2017 06:00:00 PM,48,-122,2,2,4
33547,58thStGreenway22ndAve,12/27/2017 07:00:00 PM,48,-122,1,0,1
33548,58thStGreenway22ndAve,12/27/2017 08:00:00 PM,48,-122,0,2,2
33549,58thStGreenway22ndAve,12/27/2017 09:00:00 PM,48,-122,0,1,1
33550,58thStGreenway22ndAve,12/27/2017 10:00:00 PM,48,-122,0,0,0
33551,58thStGreenway22ndAve,12/27/2017 11:00:00 PM,48,-122,0,0,0
33552,58thStGreenway22ndAve,12/28/2017 12:00:00 AM,48,-122,0,1,1
33553,58thStGreenway22ndAve,12/28/2017 01:00:00 AM,48,-122,0,0,0
33554,58thStGreenway22ndAve,12/28/2017 02:00:00 AM,48,-122,0,0,0
33555,58thStGreenway22ndAve,12/28/2017 03:00:00 AM,48,-122,0,1,1
33556,58thStGreenway22ndAve,12/28/2017 04:00:00 AM,48,-122,0,0,0
33557,58thStGreenway22ndAve,12/28/2017 05:00:00 AM,48,-122,0,0,0
33558,58thStGreenway22ndAve,12/28/2017 06:00:00 AM,48,-122,0,0,0
33559,58thStGreenway22ndAve,12/28/2017 07:00:00 AM,48,-122,1,2,3
33560,58thStGreenway22ndAve,12/28/2017 08:00:00 AM,48,-122,0,2,2
33561,58thStGreenway22ndAve,12/28/2017 09:00:00 AM,48,-122,1,1,2
33562,58thStGreenway22ndAve,12/28/2017 10:00:00 AM,48,-122,3,0,3
33563,58thStGreenway22ndAve,12/28/2017 11:00:00 AM,48,-122,2,1,3
33564,58thStGreenway22ndAve,12/28/2017 12:00:00 PM,48,-122,2,0,2
33565,58thStGreenway22ndAve,12/28/2017 01:00:00 PM,48,-122,6,1,7
33566,58thStGreenway22ndAve,12/28/2017 02:00:00 PM,48,-122,3,2,5
33567,58thStGreenway22ndAve,12/28/2017 03:00:00 PM,48,-122,5,0,5
33568,58thStGreenway22ndAve,12/28/2017 04:00:00 PM,48,-122,1,1,2
33569,58thStGreenway22ndAve,12/28/2017 05:00:00 PM,48,-122,2,1,3
33570,58thStGreenway22ndAve,12/28/2017 06:00:00 PM,48,-122,0,2,2
33571,58thStGreenway22ndAve,12/28/2017 07:00:00 PM,48,-122,0,2,2
33572,58thStGreenway22ndAve,12/28/2017 08:00:00 PM,48,-122,1,1,2
33573,58thStGreenway22ndAve,12/28/2017 09:00:00 PM,48,-122,0,0,0
33574,58thStGreenway22ndAve,12/28/2017 10:00:00 PM,48,-122,0,0,0
33575,58thStGreenway22ndAve,12/28/2017 11:00:00 PM,48,-122,0,0,0
33576,58thStGreenway22ndAve,12/29/2017 12:00:00 AM,48,-122,0,0,0
33577,58thStGreenway22ndAve,12/29/2017 01:00:00 AM,48,-122,0,0,0
33578,58thStGreenway22ndAve,12/29/2017 02:00:00 AM,48,-122,0,0,0
33579,58thStGreenway22ndAve,12/29/2017 03:00:00 AM,48,-122,0,0,0
33580,58thStGreenway22ndAve,12/29/2017 04:00:00 AM,48,-122,1,1,2
33581,58thStGreenway22ndAve,12/29/2017 05:00:00 AM,48,-122,0,0,0
33582,58thStGreenway22ndAve,12/29/2017 06:00:00 AM,48,-122,0,1,1
33583,58thStGreenway22ndAve,12/29/2017 07:00:00 AM,48,-122,0,0,0
33584,58thStGreenway22ndAve,12/29/2017 08:00:00 AM,48,-122,0,0,0
33585,58thStGreenway22ndAve,12/29/2017 09:00:00 AM,48,-122,0,1,1
33586,58thStGreenway22ndAve,12/29/2017 10:00:00 AM,48,-122,3,2,5
33587,58thStGreenway22ndAve,12/29/2017 11:00:00 AM,48,-122,2,1,3
33588,58thStGreenway22ndAve,12/29/2017 12:00:00 PM,48,-122,1,1,2
33589,58thStGreenway22ndAve,12/29/2017 01:00:00 PM,48,-122,0,3,3
33590,58thStGreenway22ndAve,12/29/2017 02:00:00 PM,48,-122,0,4,4
33591,58thStGreenway22ndAve,12/29/2017 03:00:00 PM,48,-122,4,11,15
33592,58thStGreenway22ndAve,12/29/2017 04:00:00 PM,48,-122,2,16,18
33593,58thStGreenway22ndAve,12/29/2017 05:00:00 PM,48,-122,0,12,12
33594,58thStGreenway22ndAve,12/29/2017 06:00:00 PM,48,-122,2,4,6
33595,58thStGreenway22ndAve,12/29/2017 07:00:00 PM,48,-122,0,7,7
33596,58thStGreenway22ndAve,12/29/2017 08:00:00 PM,48,-122,1,3,4
33597,58thStGreenway22ndAve,12/29/2017 09:00:00 PM,48,-122,0,10,10
33598,58thStGreenway22ndAve,12/29/2017 10:00:00 PM,48,-122,0,2,2
33599,58thStGreenway22ndAve,12/29/2017 11:00:00 PM,48,-122,0,5,5
33600,58thStGreenway22ndAve,12/30/2017 12:00:00 AM,48,-122,0,1,1
33601,58thStGreenway22ndAve,12/30/2017 01:00:00 AM,48,-122,0,0,0
33602,58thStGreenway22ndAve,12/30/2017 02:00:00 AM,48,-122,0,0,0
33603,58thStGreenway22ndAve,12/30/2017 03:00:00 AM,48,-122,0,2,2
33604,58thStGreenway22ndAve,12/30/2017 04:00:00 AM,48,-122,0,1,1
33605,58thStGreenway22ndAve,12/30/2017 05:00:00 AM,48,-122,0,1,1
33606,58thStGreenway22ndAve,12/30/2017 06:00:00 AM,48,-122,0,1,1
33607,58thStGreenway22ndAve,12/30/2017 07:00:00 AM,48,-122,0,3,3
33608,58thStGreenway22ndAve,12/30/2017 08:00:00 AM,48,-122,0,5,5
33609,58thStGreenway22ndAve,12/30/2017 09:00:00 AM,48,-122,0,9,9
33610,58thStGreenway22ndAve,12/30/2017 10:00:00 AM,48,-122,1,15,16
33611,58thStGreenway22ndAve,12/30/2017 11:00:00 AM,48,-122,2,24,26
33612,58thStGreenway22ndAve,12/30/2017 12:00:00 PM,48,-122,0,23,23
33613,58thStGreenway22ndAve,12/30/2017 01:00:00 PM,48,-122,0,26,26
33614,58thStGreenway22ndAve,12/30/2017 02:00:00 PM,48,-122,1,28,29
33615,58thStGreenway22ndAve,12/30/2017 03:00:00 PM,48,-122,0,23,23
33616,58thStGreenway22ndAve,12/30/2017 04:00:00 PM,48,-122,0,18,18
33617,58thStGreenway22ndAve,12/30/2017 05:00:00 PM,48,-122,1,17,18
33618,58thStGreenway22ndAve,12/30/2017 06:00:00 PM,48,-122,0,12,12
33619,58thStGreenway22ndAve,12/30/2017 07:00:00 PM,48,-122,0,10,10
33620,58thStGreenway22ndAve,12/30/2017 08:00:00 PM,48,-122,2,5,7
33621,58thStGreenway22ndAve,12/30/2017 09:00:00 PM,48,-122,0,1,1
33622,58thStGreenway22ndAve,12/30/2017 10:00:00 PM,48,-122,0,3,3
33623,58thStGreenway22ndAve,12/30/2017 11:00:00 PM,48,-122,0,3,3
33624,58thStGreenway22ndAve,12/31/2017 12:00:00 AM,48,-122,0,0,0
33625,58thStGreenway22ndAve,12/31/2017 01:00:00 AM,48,-122,0,2,2
33626,58thStGreenway22ndAve,12/31/2017 02:00:00 AM,48,-122,0,1,1
33627,58thStGreenway22ndAve,12/31/2017 03:00:00 AM,48,-122,0,1,1
33628,58thStGreenway22ndAve,12/31/2017 04:00:00 AM,48,-122,0,0,0
33629,58thStGreenway22ndAve,12/31/2017 05:00:00 AM,48,-122,0,1,1
33630,58thStGreenway22ndAve,12/31/2017 06:00:00 AM,48,-122,0,1,1
33631,58thStGreenway22ndAve,12/31/2017 07:00:00 AM,48,-122,0,2,2
33632,58thStGreenway22ndAve,12/31/2017 08:00:00 AM,48,-122,0,4,4
33633,58thStGreenway22ndAve,12/31/2017 09:00:00 AM,48,-122,0,8,8
33634,58thStGreenway22ndAve,12/31/2017 10:00:00 AM,48,-122,0,15,15
33635,58thStGreenway22ndAve,12/31/2017 11:00:00 AM,48,-122,1,19,20
33636,58thStGreenway22ndAve,12/31/2017 12:00:00 PM,48,-122,0,18,18
33637,58thStGreenway22ndAve,12/31/2017 01:00:00 PM,48,-122,2,16,18
33638,58thStGreenway22ndAve,12/31/2017 02:00:00 PM,48,-122,2,3,5
33639,58thStGreenway22ndAve,12/31/2017 03:00:00 PM,48,-122,1,7,8
33640,58thStGreenway22ndAve,12/31/2017 04:00:00 PM,48,-122,0,7,7
33641,58thStGreenway22ndAve,12/31/2017 05:00:00 PM,48,-122,2,3,5
33642,58thStGreenway22ndAve,12/31/2017 06:00:00 PM,48,-122,1,5,6
33643,58thStGreenway22ndAve,12/31/2017 07:00:00 PM,48,-122,0,10,10
33644,58thStGreenway22ndAve,12/31/2017 08:00:00 PM,48,-122,2,3,5
33645,58thStGreenway22ndAve,12/31/2017 09:00:00 PM,48,-122,0,11,11
33646,58thStGreenway22ndAve,12/31/2017 10:00:00 PM,48,-122,0,2,2
33647,58thStGreenway22ndAve,12/31/2017 11:00:00 PM,48,-122,0,3,3
