,Name,Date,Latitude,Longitude,NB,SB,TotalCount
0,ElliotBayTrailMyrtlePark,01/01/2014 12:00:00 AM,48,-122,1,3,4
1,ElliotBayTrailMyrtlePark,01/01/2014 01:00:00 AM,48,-122,1,1,2
2,ElliotBayTrailMyrtlePark,01/01/2014 02:00:00 AM,48,-122,3,1,4
3,ElliotBayTrailMyrtlePark,01/01/2014 03:00:00 AM,48,-122,1,1,2
4,ElliotBayTrailMyrtlePark,01/01/2014 04:00:00 AM,48,-122,0,0,0
5,ElliotBayTrailMyrtlePark,01/01/2014 05:00:00 AM,48,-122,1,1,2
6,ElliotBayTrailMyrtlePark,01/01/2014 06:00:00 AM,48,-122,0,0,0
7,ElliotBayTrailMyrtlePark,01/01/2014 07:00:00 AM,48,-122,4,5,9
8,ElliotBayTrailMyrtlePark,01/01/2014 08:00:00 AM,48,-122,2,4,6
9,ElliotBayTrailMyrtlePark,01/01/2014 09:00:00 AM,48,-122,3,7,10
10,ElliotBayTrailMyrtlePark,01/01/2014 10:00:00 AM,48,-122,21,13,34
11,ElliotBayTrailMyrtlePark,01/01/2014 11:00:00 AM,48,-122,28,14,42
12,ElliotBayTrailMyrtlePark,01/01/2014 12:00:00 PM,48,-122,25,26,51
13,ElliotBayTrailMyrtlePark,01/01/2014 01:00:00 PM,48,-122,41,33,74
14,ElliotBayTrailMyrtlePark,01/01/2014 02:00:00 PM,48,-122,42,45,87
15,ElliotBayTrailMyrtlePark,01/01/2014 03:00:00 PM,48,-122,29,25,54
16,ElliotBayTrailMyrtlePark,01/01/2014 04:00:00 PM,48,-122,17,25,42
17,ElliotBayTrailMyrtlePark,01/01/2014 05:00:00 PM,48,-122,5,7,12
18,ElliotBayTrailMyrtlePark,01/01/2014 06:00:00 PM,48,-122,4,2,6
19,ElliotBayTrailMyrtlePark,01/01/2014 07:00:00 PM,48,-122,1,2,3
20,ElliotBayTrailMyrtlePark,01/01/2014 08:00:00 PM,48,-122,1,2,3
21,ElliotBayTrailMyrtlePark,01/01/2014 09:00:00 PM,48,-122,1,0,1
22,ElliotBayTrailMyrtlePark,01/01/2014 10:00:00 PM,48,-122,0,0,0
23,ElliotBayTrailMyrtlePark,01/01/2014 11:00:00 PM,48,-122,1,1,2
24,ElliotBayTrailMyrtlePark,01/02/2014 12:00:00 AM,48,-122,1,1,2
25,ElliotBayTrailMyrtlePark,01/02/2014 01:00:00 AM,48,-122,0,0,0
26,ElliotBayTrailMyrtlePark,01/02/2014 02:00:00 AM,48,-122,0,0,0
27,ElliotBayTrailMyrtlePark,01/02/2014 03:00:00 AM,48,-122,1,1,2
28,ElliotBayTrailMyrtlePark,01/02/2014 04:00:00 AM,48,-122,2,1,3
29,ElliotBayTrailMyrtlePark,01/02/2014 05:00:00 AM,48,-122,9,10,19
30,ElliotBayTrailMyrtlePark,01/02/2014 06:00:00 AM,48,-122,8,14,22
31,ElliotBayTrailMyrtlePark,01/02/2014 07:00:00 AM,48,-122,19,49,68
32,ElliotBayTrailMyrtlePark,01/02/2014 08:00:00 AM,48,-122,19,64,83
33,ElliotBayTrailMyrtlePark,01/02/2014 09:00:00 AM,48,-122,12,31,43
34,ElliotBayTrailMyrtlePark,01/02/2014 10:00:00 AM,48,-122,4,11,15
35,ElliotBayTrailMyrtlePark,01/02/2014 11:00:00 AM,48,-122,11,9,20
36,ElliotBayTrailMyrtlePark,01/02/2014 12:00:00 PM,48,-122,6,10,16
37,ElliotBayTrailMyrtlePark,01/02/2014 01:00:00 PM,48,-122,18,12,30
38,ElliotBayTrailMyrtlePark,01/02/2014 02:00:00 PM,48,-122,18,14,32
39,ElliotBayTrailMyrtlePark,01/02/2014 03:00:00 PM,48,-122,37,25,62
40,ElliotBayTrailMyrtlePark,01/02/2014 04:00:00 PM,48,-122,82,20,102
41,ElliotBayTrailMyrtlePark,01/02/2014 05:00:00 PM,48,-122,36,8,44
42,ElliotBayTrailMyrtlePark,01/02/2014 06:00:00 PM,48,-122,11,4,15
43,ElliotBayTrailMyrtlePark,01/02/2014 07:00:00 PM,48,-122,3,0,3
44,ElliotBayTrailMyrtlePark,01/02/2014 08:00:00 PM,48,-122,2,0,2
45,ElliotBayTrailMyrtlePark,01/02/2014 09:00:00 PM,48,-122,1,0,1
46,ElliotBayTrailMyrtlePark,01/02/2014 10:00:00 PM,48,-122,2,0,2
47,ElliotBayTrailMyrtlePark,01/02/2014 11:00:00 PM,48,-122,3,0,3
48,ElliotBayTrailMyrtlePark,01/03/2014 12:00:00 AM,48,-122,0,0,0
49,ElliotBayTrailMyrtlePark,01/03/2014 01:00:00 AM,48,-122,0,0,0
50,ElliotBayTrailMyrtlePark,01/03/2014 02:00:00 AM,48,-122,0,0,0
51,ElliotBayTrailMyrtlePark,01/03/2014 03:00:00 AM,48,-122,1,1,2
52,ElliotBayTrailMyrtlePark,01/03/2014 04:00:00 AM,48,-122,10,11,21
53,ElliotBayTrailMyrtlePark,01/03/2014 05:00:00 AM,48,-122,13,10,23
54,ElliotBayTrailMyrtlePark,01/03/2014 06:00:00 AM,48,-122,21,55,76
55,ElliotBayTrailMyrtlePark,01/03/2014 07:00:00 AM,48,-122,23,63,86
56,ElliotBayTrailMyrtlePark,01/03/2014 08:00:00 AM,48,-122,5,41,46
57,ElliotBayTrailMyrtlePark,01/03/2014 09:00:00 AM,48,-122,4,13,17
58,ElliotBayTrailMyrtlePark,01/03/2014 10:00:00 AM,48,-122,9,11,20
59,ElliotBayTrailMyrtlePark,01/03/2014 11:00:00 AM,48,-122,20,21,41
60,ElliotBayTrailMyrtlePark,01/03/2014 12:00:00 PM,48,-122,26,18,44
61,ElliotBayTrailMyrtlePark,01/03/2014 01:00:00 PM,48,-122,41,27,68
62,ElliotBayTrailMyrtlePark,01/03/2014 02:00:00 PM,48,-122,36,33,69
63,ElliotBayTrailMyrtlePark,01/03/2014 03:00:00 PM,48,-122,58,28,86
64,ElliotBayTrailMyrtlePark,01/03/2014 04:00:00 PM,48,-122,83,23,106
65,ElliotBayTrailMyrtlePark,01/03/2014 05:00:00 PM,48,-122,30,9,39
66,ElliotBayTrailMyrtlePark,01/03/2014 06:00:00 PM,48,-122,6,2,8
67,ElliotBayTrailMyrtlePark,01/03/2014 07:00:00 PM,48,-122,2,1,3
68,ElliotBayTrailMyrtlePark,01/03/2014 08:00:00 PM,48,-122,6,2,8
69,ElliotBayTrailMyrtlePark,01/03/2014 09:00:00 PM,48,-122,1,3,4
70,ElliotBayTrailMyrtlePark,01/03/2014 10:00:00 PM,48,-122,0,0,0
71,ElliotBayTrailMyrtlePark,01/03/2014 11:00:00 PM,48,-122,2,3,5
72,ElliotBayTrailMyrtlePark,01/04/2014 12:00:00 AM,48,-122,1,0,1
73,ElliotBayTrailMyrtlePark,01/04/2014 01:00:00 AM,48,-122,1,0,1
74,ElliotBayTrailMyrtlePark,01/04/2014 02:00:00 AM,48,-122,0,0,0
75,ElliotBayTrailMyrtlePark,01/04/2014 03:00:00 AM,48,-122,0,0,0
76,ElliotBayTrailMyrtlePark,01/04/2014 04:00:00 AM,48,-122,2,0,2
77,ElliotBayTrailMyrtlePark,01/04/2014 05:00:00 AM,48,-122,0,4,4
78,ElliotBayTrailMyrtlePark,01/04/2014 06:00:00 AM,48,-122,4,4,8
79,ElliotBayTrailMyrtlePark,01/04/2014 07:00:00 AM,48,-122,5,19,24
80,ElliotBayTrailMyrtlePark,01/04/2014 08:00:00 AM,48,-122,16,13,29
81,ElliotBayTrailMyrtlePark,01/04/2014 09:00:00 AM,48,-122,20,26,46
82,ElliotBayTrailMyrtlePark,01/04/2014 10:00:00 AM,48,-122,24,35,59
83,ElliotBayTrailMyrtlePark,01/04/2014 11:00:00 AM,48,-122,55,35,90
84,ElliotBayTrailMyrtlePark,01/04/2014 12:00:00 PM,48,-122,49,33,82
85,ElliotBayTrailMyrtlePark,01/04/2014 01:00:00 PM,48,-122,66,47,113
86,ElliotBayTrailMyrtlePark,01/04/2014 02:00:00 PM,48,-122,57,62,119
87,ElliotBayTrailMyrtlePark,01/04/2014 03:00:00 PM,48,-122,22,16,38
88,ElliotBayTrailMyrtlePark,01/04/2014 04:00:00 PM,48,-122,15,6,21
89,ElliotBayTrailMyrtlePark,01/04/2014 05:00:00 PM,48,-122,9,2,11
90,ElliotBayTrailMyrtlePark,01/04/2014 06:00:00 PM,48,-122,6,0,6
91,ElliotBayTrailMyrtlePark,01/04/2014 07:00:00 PM,48,-122,3,2,5
92,ElliotBayTrailMyrtlePark,01/04/2014 08:00:00 PM,48,-122,2,0,2
93,ElliotBayTrailMyrtlePark,01/04/2014 09:00:00 PM,48,-122,2,0,2
94,ElliotBayTrailMyrtlePark,01/04/2014 10:00:00 PM,48,-122,2,0,2
95,ElliotBayTrailMyrtlePark,01/04/2014 11:00:00 PM,48,-122,0,0,0
96,ElliotBayTrailMyrtlePark,01/05/2014 12:00:00 AM,48,-122,0,0,0
97,ElliotBayTrailMyrtlePark,01/05/2014 01:00:00 AM,48,-122,0,1,1
98,ElliotBayTrailMyrtlePark,01/05/2014 02:00:00 AM,48,-122,0,0,0
99,ElliotBayTrailMyrtlePark,01/05/2014 03:00:00 AM,48,-122,0,0,0
100,ElliotBayTrailMyrtlePark,01/05/2014 04:00:00 AM,48,-122,0,0,0
101,ElliotBayTrailMyrtlePark,01/05/2014 05:00:00 AM,48,-122,0,5,5
102,ElliotBayTrailMyrtlePark,01/05/2014 06:00:00 AM,48,-122,1,3,4
103,ElliotBayTrailMyrtlePark,01/05/2014 07:00:00 AM,48,-122,2,6,8
104,ElliotBayTrailMyrtlePark,01/05/2014 08:00:00 AM,48,-122,7,14,21
105,ElliotBayTrailMyrtlePark,01/05/2014 09:00:00 AM,48,-122,12,15,27
106,ElliotBayTrailMyrtlePark,01/05/2014 10:00:00 AM,48,-122,24,38,62
107,ElliotBayTrailMyrtlePark,01/05/2014 11:00:00 AM,48,-122,37,38,75
108,ElliotBayTrailMyrtlePark,01/05/2014 12:00:00 PM,48,-122,54,36,90
109,ElliotBayTrailMyrtlePark,01/05/2014 01:00:00 PM,48,-122,34,42,76
110,ElliotBayTrailMyrtlePark,01/05/2014 02:00:00 PM,48,-122,48,37,85
111,ElliotBayTrailMyrtlePark,01/05/2014 03:00:00 PM,48,-122,23,13,36
112,ElliotBayTrailMyrtlePark,01/05/2014 04:00:00 PM,48,-122,15,9,24
113,ElliotBayTrailMyrtlePark,01/05/2014 05:00:00 PM,48,-122,2,4,6
114,ElliotBayTrailMyrtlePark,01/05/2014 06:00:00 PM,48,-122,1,2,3
115,ElliotBayTrailMyrtlePark,01/05/2014 07:00:00 PM,48,-122,5,0,5
116,ElliotBayTrailMyrtlePark,01/05/2014 08:00:00 PM,48,-122,1,3,4
117,ElliotBayTrailMyrtlePark,01/05/2014 09:00:00 PM,48,-122,3,1,4
118,ElliotBayTrailMyrtlePark,01/05/2014 10:00:00 PM,48,-122,1,0,1
119,ElliotBayTrailMyrtlePark,01/05/2014 11:00:00 PM,48,-122,0,1,1
120,ElliotBayTrailMyrtlePark,01/06/2014 12:00:00 AM,48,-122,0,0,0
121,ElliotBayTrailMyrtlePark,01/06/2014 01:00:00 AM,48,-122,0,0,0
122,ElliotBayTrailMyrtlePark,01/06/2014 02:00:00 AM,48,-122,0,0,0
123,ElliotBayTrailMyrtlePark,01/06/2014 03:00:00 AM,48,-122,0,1,1
124,ElliotBayTrailMyrtlePark,01/06/2014 04:00:00 AM,48,-122,9,11,20
125,ElliotBayTrailMyrtlePark,01/06/2014 05:00:00 AM,48,-122,18,22,40
126,ElliotBayTrailMyrtlePark,01/06/2014 06:00:00 AM,48,-122,32,57,89
127,ElliotBayTrailMyrtlePark,01/06/2014 07:00:00 AM,48,-122,21,87,108
128,ElliotBayTrailMyrtlePark,01/06/2014 08:00:00 AM,48,-122,4,40,44
129,ElliotBayTrailMyrtlePark,01/06/2014 09:00:00 AM,48,-122,9,11,20
130,ElliotBayTrailMyrtlePark,01/06/2014 10:00:00 AM,48,-122,9,8,17
131,ElliotBayTrailMyrtlePark,01/06/2014 11:00:00 AM,48,-122,12,13,25
132,ElliotBayTrailMyrtlePark,01/06/2014 12:00:00 PM,48,-122,10,11,21
133,ElliotBayTrailMyrtlePark,01/06/2014 01:00:00 PM,48,-122,9,11,20
134,ElliotBayTrailMyrtlePark,01/06/2014 02:00:00 PM,48,-122,26,20,46
135,ElliotBayTrailMyrtlePark,01/06/2014 03:00:00 PM,48,-122,48,23,71
136,ElliotBayTrailMyrtlePark,01/06/2014 04:00:00 PM,48,-122,93,34,127
137,ElliotBayTrailMyrtlePark,01/06/2014 05:00:00 PM,48,-122,58,15,73
138,ElliotBayTrailMyrtlePark,01/06/2014 06:00:00 PM,48,-122,14,3,17
139,ElliotBayTrailMyrtlePark,01/06/2014 07:00:00 PM,48,-122,7,2,9
140,ElliotBayTrailMyrtlePark,01/06/2014 08:00:00 PM,48,-122,2,2,4
141,ElliotBayTrailMyrtlePark,01/06/2014 09:00:00 PM,48,-122,0,1,1
142,ElliotBayTrailMyrtlePark,01/06/2014 10:00:00 PM,48,-122,2,0,2
143,ElliotBayTrailMyrtlePark,01/06/2014 11:00:00 PM,48,-122,0,0,0
144,ElliotBayTrailMyrtlePark,01/07/2014 12:00:00 AM,48,-122,0,0,0
145,ElliotBayTrailMyrtlePark,01/07/2014 01:00:00 AM,48,-122,0,0,0
146,ElliotBayTrailMyrtlePark,01/07/2014 02:00:00 AM,48,-122,0,0,0
147,ElliotBayTrailMyrtlePark,01/07/2014 03:00:00 AM,48,-122,1,1,2
148,ElliotBayTrailMyrtlePark,01/07/2014 04:00:00 AM,48,-122,8,6,14
149,ElliotBayTrailMyrtlePark,01/07/2014 05:00:00 AM,48,-122,19,22,41
150,ElliotBayTrailMyrtlePark,01/07/2014 06:00:00 AM,48,-122,29,46,75
151,ElliotBayTrailMyrtlePark,01/07/2014 07:00:00 AM,48,-122,22,77,99
152,ElliotBayTrailMyrtlePark,01/07/2014 08:00:00 AM,48,-122,4,37,41
153,ElliotBayTrailMyrtlePark,01/07/2014 09:00:00 AM,48,-122,10,13,23
154,ElliotBayTrailMyrtlePark,01/07/2014 10:00:00 AM,48,-122,3,9,12
155,ElliotBayTrailMyrtlePark,01/07/2014 11:00:00 AM,48,-122,4,6,10
156,ElliotBayTrailMyrtlePark,01/07/2014 12:00:00 PM,48,-122,3,8,11
157,ElliotBayTrailMyrtlePark,01/07/2014 01:00:00 PM,48,-122,3,7,10
158,ElliotBayTrailMyrtlePark,01/07/2014 02:00:00 PM,48,-122,18,9,27
159,ElliotBayTrailMyrtlePark,01/07/2014 03:00:00 PM,48,-122,38,27,65
160,ElliotBayTrailMyrtlePark,01/07/2014 04:00:00 PM,48,-122,91,32,123
161,ElliotBayTrailMyrtlePark,01/07/2014 05:00:00 PM,48,-122,62,15,77
162,ElliotBayTrailMyrtlePark,01/07/2014 06:00:00 PM,48,-122,10,3,13
163,ElliotBayTrailMyrtlePark,01/07/2014 07:00:00 PM,48,-122,1,0,1
164,ElliotBayTrailMyrtlePark,01/07/2014 08:00:00 PM,48,-122,2,0,2
165,ElliotBayTrailMyrtlePark,01/07/2014 09:00:00 PM,48,-122,3,1,4
166,ElliotBayTrailMyrtlePark,01/07/2014 10:00:00 PM,48,-122,1,0,1
167,ElliotBayTrailMyrtlePark,01/07/2014 11:00:00 PM,48,-122,0,1,1
168,ElliotBayTrailMyrtlePark,01/08/2014 12:00:00 AM,48,-122,2,0,2
169,ElliotBayTrailMyrtlePark,01/08/2014 01:00:00 AM,48,-122,0,0,0
170,ElliotBayTrailMyrtlePark,01/08/2014 02:00:00 AM,48,-122,0,0,0
171,ElliotBayTrailMyrtlePark,01/08/2014 03:00:00 AM,48,-122,0,1,1
172,ElliotBayTrailMyrtlePark,01/08/2014 04:00:00 AM,48,-122,11,8,19
173,ElliotBayTrailMyrtlePark,01/08/2014 05:00:00 AM,48,-122,10,24,34
174,ElliotBayTrailMyrtlePark,01/08/2014 06:00:00 AM,48,-122,37,42,79
175,ElliotBayTrailMyrtlePark,01/08/2014 07:00:00 AM,48,-122,31,73,104
176,ElliotBayTrailMyrtlePark,01/08/2014 08:00:00 AM,48,-122,9,44,53
177,ElliotBayTrailMyrtlePark,01/08/2014 09:00:00 AM,48,-122,5,11,16
178,ElliotBayTrailMyrtlePark,01/08/2014 10:00:00 AM,48,-122,7,10,17
179,ElliotBayTrailMyrtlePark,01/08/2014 11:00:00 AM,48,-122,7,7,14
180,ElliotBayTrailMyrtlePark,01/08/2014 12:00:00 PM,48,-122,4,11,15
181,ElliotBayTrailMyrtlePark,01/08/2014 01:00:00 PM,48,-122,6,8,14
182,ElliotBayTrailMyrtlePark,01/08/2014 02:00:00 PM,48,-122,16,20,36
183,ElliotBayTrailMyrtlePark,01/08/2014 03:00:00 PM,48,-122,42,22,64
184,ElliotBayTrailMyrtlePark,01/08/2014 04:00:00 PM,48,-122,92,27,119
185,ElliotBayTrailMyrtlePark,01/08/2014 05:00:00 PM,48,-122,52,10,62
186,ElliotBayTrailMyrtlePark,01/08/2014 06:00:00 PM,48,-122,16,3,19
187,ElliotBayTrailMyrtlePark,01/08/2014 07:00:00 PM,48,-122,6,1,7
188,ElliotBayTrailMyrtlePark,01/08/2014 08:00:00 PM,48,-122,4,2,6
189,ElliotBayTrailMyrtlePark,01/08/2014 09:00:00 PM,48,-122,2,0,2
190,ElliotBayTrailMyrtlePark,01/08/2014 10:00:00 PM,48,-122,0,0,0
191,ElliotBayTrailMyrtlePark,01/08/2014 11:00:00 PM,48,-122,1,0,1
192,ElliotBayTrailMyrtlePark,01/09/2014 12:00:00 AM,48,-122,1,0,1
193,ElliotBayTrailMyrtlePark,01/09/2014 01:00:00 AM,48,-122,1,2,3
194,ElliotBayTrailMyrtlePark,01/09/2014 02:00:00 AM,48,-122,0,0,0
195,ElliotBayTrailMyrtlePark,01/09/2014 03:00:00 AM,48,-122,0,1,1
196,ElliotBayTrailMyrtlePark,01/09/2014 04:00:00 AM,48,-122,10,10,20
197,ElliotBayTrailMyrtlePark,01/09/2014 05:00:00 AM,48,-122,9,15,24
198,ElliotBayTrailMyrtlePark,01/09/2014 06:00:00 AM,48,-122,41,48,89
199,ElliotBayTrailMyrtlePark,01/09/2014 07:00:00 AM,48,-122,24,86,110
200,ElliotBayTrailMyrtlePark,01/09/2014 08:00:00 AM,48,-122,10,31,41
201,ElliotBayTrailMyrtlePark,01/09/2014 09:00:00 AM,48,-122,5,11,16
202,ElliotBayTrailMyrtlePark,01/09/2014 10:00:00 AM,48,-122,6,13,19
203,ElliotBayTrailMyrtlePark,01/09/2014 11:00:00 AM,48,-122,5,8,13
204,ElliotBayTrailMyrtlePark,01/09/2014 12:00:00 PM,48,-122,9,8,17
205,ElliotBayTrailMyrtlePark,01/09/2014 01:00:00 PM,48,-122,4,13,17
206,ElliotBayTrailMyrtlePark,01/09/2014 02:00:00 PM,48,-122,10,10,20
207,ElliotBayTrailMyrtlePark,01/09/2014 03:00:00 PM,48,-122,43,25,68
208,ElliotBayTrailMyrtlePark,01/09/2014 04:00:00 PM,48,-122,88,17,105
209,ElliotBayTrailMyrtlePark,01/09/2014 05:00:00 PM,48,-122,53,18,71
210,ElliotBayTrailMyrtlePark,01/09/2014 06:00:00 PM,48,-122,23,3,26
211,ElliotBayTrailMyrtlePark,01/09/2014 07:00:00 PM,48,-122,5,0,5
212,ElliotBayTrailMyrtlePark,01/09/2014 08:00:00 PM,48,-122,5,0,5
213,ElliotBayTrailMyrtlePark,01/09/2014 09:00:00 PM,48,-122,2,1,3
214,ElliotBayTrailMyrtlePark,01/09/2014 10:00:00 PM,48,-122,2,0,2
215,ElliotBayTrailMyrtlePark,01/09/2014 11:00:00 PM,48,-122,1,0,1
216,ElliotBayTrailMyrtlePark,01/10/2014 12:00:00 AM,48,-122,0,0,0
217,ElliotBayTrailMyrtlePark,01/10/2014 01:00:00 AM,48,-122,0,0,0
218,ElliotBayTrailMyrtlePark,01/10/2014 02:00:00 AM,48,-122,0,0,0
219,ElliotBayTrailMyrtlePark,01/10/2014 03:00:00 AM,48,-122,0,1,1
220,ElliotBayTrailMyrtlePark,01/10/2014 04:00:00 AM,48,-122,13,5,18
221,ElliotBayTrailMyrtlePark,01/10/2014 05:00:00 AM,48,-122,7,15,22
222,ElliotBayTrailMyrtlePark,01/10/2014 06:00:00 AM,48,-122,29,34,63
223,ElliotBayTrailMyrtlePark,01/10/2014 07:00:00 AM,48,-122,19,58,77
224,ElliotBayTrailMyrtlePark,01/10/2014 08:00:00 AM,48,-122,6,32,38
225,ElliotBayTrailMyrtlePark,01/10/2014 09:00:00 AM,48,-122,8,4,12
226,ElliotBayTrailMyrtlePark,01/10/2014 10:00:00 AM,48,-122,4,6,10
227,ElliotBayTrailMyrtlePark,01/10/2014 11:00:00 AM,48,-122,4,7,11
228,ElliotBayTrailMyrtlePark,01/10/2014 12:00:00 PM,48,-122,7,5,12
229,ElliotBayTrailMyrtlePark,01/10/2014 01:00:00 PM,48,-122,9,6,15
230,ElliotBayTrailMyrtlePark,01/10/2014 02:00:00 PM,48,-122,31,13,44
231,ElliotBayTrailMyrtlePark,01/10/2014 03:00:00 PM,48,-122,42,30,72
232,ElliotBayTrailMyrtlePark,01/10/2014 04:00:00 PM,48,-122,74,23,97
233,ElliotBayTrailMyrtlePark,01/10/2014 05:00:00 PM,48,-122,33,5,38
234,ElliotBayTrailMyrtlePark,01/10/2014 06:00:00 PM,48,-122,6,2,8
235,ElliotBayTrailMyrtlePark,01/10/2014 07:00:00 PM,48,-122,3,0,3
236,ElliotBayTrailMyrtlePark,01/10/2014 08:00:00 PM,48,-122,4,0,4
237,ElliotBayTrailMyrtlePark,01/10/2014 09:00:00 PM,48,-122,1,0,1
238,ElliotBayTrailMyrtlePark,01/10/2014 10:00:00 PM,48,-122,0,0,0
239,ElliotBayTrailMyrtlePark,01/10/2014 11:00:00 PM,48,-122,1,0,1
240,ElliotBayTrailMyrtlePark,01/11/2014 12:00:00 AM,48,-122,0,0,0
241,ElliotBayTrailMyrtlePark,01/11/2014 01:00:00 AM,48,-122,0,0,0
242,ElliotBayTrailMyrtlePark,01/11/2014 02:00:00 AM,48,-122,0,0,0
243,ElliotBayTrailMyrtlePark,01/11/2014 03:00:00 AM,48,-122,0,0,0
244,ElliotBayTrailMyrtlePark,01/11/2014 04:00:00 AM,48,-122,1,0,1
245,ElliotBayTrailMyrtlePark,01/11/2014 05:00:00 AM,48,-122,1,2,3
246,ElliotBayTrailMyrtlePark,01/11/2014 06:00:00 AM,48,-122,4,3,7
247,ElliotBayTrailMyrtlePark,01/11/2014 07:00:00 AM,48,-122,4,2,6
248,ElliotBayTrailMyrtlePark,01/11/2014 08:00:00 AM,48,-122,2,12,14
249,ElliotBayTrailMyrtlePark,01/11/2014 09:00:00 AM,48,-122,5,8,13
250,ElliotBayTrailMyrtlePark,01/11/2014 10:00:00 AM,48,-122,2,7,9
251,ElliotBayTrailMyrtlePark,01/11/2014 11:00:00 AM,48,-122,7,1,8
252,ElliotBayTrailMyrtlePark,01/11/2014 12:00:00 PM,48,-122,2,2,4
253,ElliotBayTrailMyrtlePark,01/11/2014 01:00:00 PM,48,-122,3,1,4
254,ElliotBayTrailMyrtlePark,01/11/2014 02:00:00 PM,48,-122,6,2,8
255,ElliotBayTrailMyrtlePark,01/11/2014 03:00:00 PM,48,-122,2,1,3
256,ElliotBayTrailMyrtlePark,01/11/2014 04:00:00 PM,48,-122,5,1,6
257,ElliotBayTrailMyrtlePark,01/11/2014 05:00:00 PM,48,-122,3,0,3
258,ElliotBayTrailMyrtlePark,01/11/2014 06:00:00 PM,48,-122,2,0,2
259,ElliotBayTrailMyrtlePark,01/11/2014 07:00:00 PM,48,-122,1,1,2
260,ElliotBayTrailMyrtlePark,01/11/2014 08:00:00 PM,48,-122,2,0,2
261,ElliotBayTrailMyrtlePark,01/11/2014 09:00:00 PM,48,-122,1,4,5
262,ElliotBayTrailMyrtlePark,01/11/2014 10:00:00 PM,48,-122,1,1,2
263,ElliotBayTrailMyrtlePark,01/11/2014 11:00:00 PM,48,-122,1,0,1
264,ElliotBayTrailMyrtlePark,01/12/2014 12:00:00 AM,48,-122,0,0,0
265,ElliotBayTrailMyrtlePark,01/12/2014 01:00:00 AM,48,-122,0,0,0
266,ElliotBayTrailMyrtlePark,01/12/2014 02:00:00 AM,48,-122,0,0,0
267,ElliotBayTrailMyrtlePark,01/12/2014 03:00:00 AM,48,-122,0,0,0
268,ElliotBayTrailMyrtlePark,01/12/2014 04:00:00 AM,48,-122,1,0,1
269,ElliotBayTrailMyrtlePark,01/12/2014 05:00:00 AM,48,-122,1,5,6
270,ElliotBayTrailMyrtlePark,01/12/2014 06:00:00 AM,48,-122,2,4,6
271,ElliotBayTrailMyrtlePark,01/12/2014 07:00:00 AM,48,-122,4,3,7
272,ElliotBayTrailMyrtlePark,01/12/2014 08:00:00 AM,48,-122,4,7,11
273,ElliotBayTrailMyrtlePark,01/12/2014 09:00:00 AM,48,-122,11,8,19
274,ElliotBayTrailMyrtlePark,01/12/2014 10:00:00 AM,48,-122,3,12,15
275,ElliotBayTrailMyrtlePark,01/12/2014 11:00:00 AM,48,-122,8,11,19
276,ElliotBayTrailMyrtlePark,01/12/2014 12:00:00 PM,48,-122,12,9,21
277,ElliotBayTrailMyrtlePark,01/12/2014 01:00:00 PM,48,-122,10,6,16
278,ElliotBayTrailMyrtlePark,01/12/2014 02:00:00 PM,48,-122,17,12,29
279,ElliotBayTrailMyrtlePark,01/12/2014 03:00:00 PM,48,-122,11,8,19
280,ElliotBayTrailMyrtlePark,01/12/2014 04:00:00 PM,48,-122,2,3,5
281,ElliotBayTrailMyrtlePark,01/12/2014 05:00:00 PM,48,-122,1,2,3
282,ElliotBayTrailMyrtlePark,01/12/2014 06:00:00 PM,48,-122,4,1,5
283,ElliotBayTrailMyrtlePark,01/12/2014 07:00:00 PM,48,-122,1,0,1
284,ElliotBayTrailMyrtlePark,01/12/2014 08:00:00 PM,48,-122,2,0,2
285,ElliotBayTrailMyrtlePark,01/12/2014 09:00:00 PM,48,-122,2,3,5
286,ElliotBayTrailMyrtlePark,01/12/2014 10:00:00 PM,48,-122,3,1,4
287,ElliotBayTrailMyrtlePark,01/12/2014 11:00:00 PM,48,-122,1,0,1
288,ElliotBayTrailMyrtlePark,01/13/2014 12:00:00 AM,48,-122,0,1,1
289,ElliotBayTrailMyrtlePark,01/13/2014 01:00:00 AM,48,-122,2,1,3
290,ElliotBayTrailMyrtlePark,01/13/2014 02:00:00 AM,48,-122,0,0,0
291,ElliotBayTrailMyrtlePark,01/13/2014 03:00:00 AM,48,-122,1,1,2
292,ElliotBayTrailMyrtlePark,01/13/2014 04:00:00 AM,48,-122,16,7,23
293,ElliotBayTrailMyrtlePark,01/13/2014 05:00:00 AM,48,-122,13,20,33
294,ElliotBayTrailMyrtlePark,01/13/2014 06:00:00 AM,48,-122,31,44,75
295,ElliotBayTrailMyrtlePark,01/13/2014 07:00:00 AM,48,-122,17,77,94
296,ElliotBayTrailMyrtlePark,01/13/2014 08:00:00 AM,48,-122,4,48,52
297,ElliotBayTrailMyrtlePark,01/13/2014 09:00:00 AM,48,-122,7,9,16
298,ElliotBayTrailMyrtlePark,01/13/2014 10:00:00 AM,48,-122,6,7,13
299,ElliotBayTrailMyrtlePark,01/13/2014 11:00:00 AM,48,-122,12,8,20
300,ElliotBayTrailMyrtlePark,01/13/2014 12:00:00 PM,48,-122,17,6,23
301,ElliotBayTrailMyrtlePark,01/13/2014 01:00:00 PM,48,-122,14,8,22
302,ElliotBayTrailMyrtlePark,01/13/2014 02:00:00 PM,48,-122,20,16,36
303,ElliotBayTrailMyrtlePark,01/13/2014 03:00:00 PM,48,-122,38,25,63
304,ElliotBayTrailMyrtlePark,01/13/2014 04:00:00 PM,48,-122,111,35,146
305,ElliotBayTrailMyrtlePark,01/13/2014 05:00:00 PM,48,-122,63,21,84
306,ElliotBayTrailMyrtlePark,01/13/2014 06:00:00 PM,48,-122,16,6,22
307,ElliotBayTrailMyrtlePark,01/13/2014 07:00:00 PM,48,-122,2,0,2
308,ElliotBayTrailMyrtlePark,01/13/2014 08:00:00 PM,48,-122,3,2,5
309,ElliotBayTrailMyrtlePark,01/13/2014 09:00:00 PM,48,-122,4,1,5
310,ElliotBayTrailMyrtlePark,01/13/2014 10:00:00 PM,48,-122,1,2,3
311,ElliotBayTrailMyrtlePark,01/13/2014 11:00:00 PM,48,-122,2,1,3
312,ElliotBayTrailMyrtlePark,01/14/2014 12:00:00 AM,48,-122,0,0,0
313,ElliotBayTrailMyrtlePark,01/14/2014 01:00:00 AM,48,-122,1,1,2
314,ElliotBayTrailMyrtlePark,01/14/2014 02:00:00 AM,48,-122,0,1,1
315,ElliotBayTrailMyrtlePark,01/14/2014 03:00:00 AM,48,-122,0,1,1
316,ElliotBayTrailMyrtlePark,01/14/2014 04:00:00 AM,48,-122,17,10,27
317,ElliotBayTrailMyrtlePark,01/14/2014 05:00:00 AM,48,-122,14,27,41
318,ElliotBayTrailMyrtlePark,01/14/2014 06:00:00 AM,48,-122,38,84,122
319,ElliotBayTrailMyrtlePark,01/14/2014 07:00:00 AM,48,-122,32,94,126
320,ElliotBayTrailMyrtlePark,01/14/2014 08:00:00 AM,48,-122,10,50,60
321,ElliotBayTrailMyrtlePark,01/14/2014 09:00:00 AM,48,-122,17,13,30
322,ElliotBayTrailMyrtlePark,01/14/2014 10:00:00 AM,48,-122,9,10,19
323,ElliotBayTrailMyrtlePark,01/14/2014 11:00:00 AM,48,-122,14,10,24
324,ElliotBayTrailMyrtlePark,01/14/2014 12:00:00 PM,48,-122,15,12,27
325,ElliotBayTrailMyrtlePark,01/14/2014 01:00:00 PM,48,-122,16,15,31
326,ElliotBayTrailMyrtlePark,01/14/2014 02:00:00 PM,48,-122,23,21,44
327,ElliotBayTrailMyrtlePark,01/14/2014 03:00:00 PM,48,-122,67,40,107
328,ElliotBayTrailMyrtlePark,01/14/2014 04:00:00 PM,48,-122,129,45,174
329,ElliotBayTrailMyrtlePark,01/14/2014 05:00:00 PM,48,-122,65,20,85
330,ElliotBayTrailMyrtlePark,01/14/2014 06:00:00 PM,48,-122,23,7,30
331,ElliotBayTrailMyrtlePark,01/14/2014 07:00:00 PM,48,-122,7,1,8
332,ElliotBayTrailMyrtlePark,01/14/2014 08:00:00 PM,48,-122,2,3,5
333,ElliotBayTrailMyrtlePark,01/14/2014 09:00:00 PM,48,-122,3,1,4
334,ElliotBayTrailMyrtlePark,01/14/2014 10:00:00 PM,48,-122,1,1,2
335,ElliotBayTrailMyrtlePark,01/14/2014 11:00:00 PM,48,-122,1,1,2
336,ElliotBayTrailMyrtlePark,01/15/2014 12:00:00 AM,48,-122,0,2,2
337,ElliotBayTrailMyrtlePark,01/15/2014 01:00:00 AM,48,-122,1,1,2
338,ElliotBayTrailMyrtlePark,01/15/2014 02:00:00 AM,48,-122,1,1,2
339,ElliotBayTrailMyrtlePark,01/15/2014 03:00:00 AM,48,-122,0,1,1
340,ElliotBayTrailMyrtlePark,01/15/2014 04:00:00 AM,48,-122,8,9,17
341,ElliotBayTrailMyrtlePark,01/15/2014 05:00:00 AM,48,-122,25,28,53
342,ElliotBayTrailMyrtlePark,01/15/2014 06:00:00 AM,48,-122,43,64,107
343,ElliotBayTrailMyrtlePark,01/15/2014 07:00:00 AM,48,-122,24,94,118
344,ElliotBayTrailMyrtlePark,01/15/2014 08:00:00 AM,48,-122,12,48,60
345,ElliotBayTrailMyrtlePark,01/15/2014 09:00:00 AM,48,-122,15,15,30
346,ElliotBayTrailMyrtlePark,01/15/2014 10:00:00 AM,48,-122,10,12,22
347,ElliotBayTrailMyrtlePark,01/15/2014 11:00:00 AM,48,-122,14,14,28
348,ElliotBayTrailMyrtlePark,01/15/2014 12:00:00 PM,48,-122,14,20,34
349,ElliotBayTrailMyrtlePark,01/15/2014 01:00:00 PM,48,-122,18,21,39
350,ElliotBayTrailMyrtlePark,01/15/2014 02:00:00 PM,48,-122,27,25,52
351,ElliotBayTrailMyrtlePark,01/15/2014 03:00:00 PM,48,-122,67,47,114
352,ElliotBayTrailMyrtlePark,01/15/2014 04:00:00 PM,48,-122,129,40,169
353,ElliotBayTrailMyrtlePark,01/15/2014 05:00:00 PM,48,-122,64,20,84
354,ElliotBayTrailMyrtlePark,01/15/2014 06:00:00 PM,48,-122,23,5,28
355,ElliotBayTrailMyrtlePark,01/15/2014 07:00:00 PM,48,-122,2,4,6
356,ElliotBayTrailMyrtlePark,01/15/2014 08:00:00 PM,48,-122,6,1,7
357,ElliotBayTrailMyrtlePark,01/15/2014 09:00:00 PM,48,-122,5,1,6
358,ElliotBayTrailMyrtlePark,01/15/2014 10:00:00 PM,48,-122,2,0,2
359,ElliotBayTrailMyrtlePark,01/15/2014 11:00:00 PM,48,-122,3,1,4
360,ElliotBayTrailMyrtlePark,01/16/2014 12:00:00 AM,48,-122,2,0,2
361,ElliotBayTrailMyrtlePark,01/16/2014 01:00:00 AM,48,-122,1,1,2
362,ElliotBayTrailMyrtlePark,01/16/2014 02:00:00 AM,48,-122,1,1,2
363,ElliotBayTrailMyrtlePark,01/16/2014 03:00:00 AM,48,-122,0,0,0
364,ElliotBayTrailMyrtlePark,01/16/2014 04:00:00 AM,48,-122,7,6,13
365,ElliotBayTrailMyrtlePark,01/16/2014 05:00:00 AM,48,-122,20,24,44
366,ElliotBayTrailMyrtlePark,01/16/2014 06:00:00 AM,48,-122,37,59,96
367,ElliotBayTrailMyrtlePark,01/16/2014 07:00:00 AM,48,-122,25,109,134
368,ElliotBayTrailMyrtlePark,01/16/2014 08:00:00 AM,48,-122,15,46,61
369,ElliotBayTrailMyrtlePark,01/16/2014 09:00:00 AM,48,-122,10,19,29
370,ElliotBayTrailMyrtlePark,01/16/2014 10:00:00 AM,48,-122,15,6,21
371,ElliotBayTrailMyrtlePark,01/16/2014 11:00:00 AM,48,-122,10,10,20
372,ElliotBayTrailMyrtlePark,01/16/2014 12:00:00 PM,48,-122,11,17,28
373,ElliotBayTrailMyrtlePark,01/16/2014 01:00:00 PM,48,-122,15,14,29
374,ElliotBayTrailMyrtlePark,01/16/2014 02:00:00 PM,48,-122,23,23,46
375,ElliotBayTrailMyrtlePark,01/16/2014 03:00:00 PM,48,-122,61,39,100
376,ElliotBayTrailMyrtlePark,01/16/2014 04:00:00 PM,48,-122,112,28,140
377,ElliotBayTrailMyrtlePark,01/16/2014 05:00:00 PM,48,-122,58,23,81
378,ElliotBayTrailMyrtlePark,01/16/2014 06:00:00 PM,48,-122,16,4,20
379,ElliotBayTrailMyrtlePark,01/16/2014 07:00:00 PM,48,-122,3,1,4
380,ElliotBayTrailMyrtlePark,01/16/2014 08:00:00 PM,48,-122,9,0,9
381,ElliotBayTrailMyrtlePark,01/16/2014 09:00:00 PM,48,-122,1,2,3
382,ElliotBayTrailMyrtlePark,01/16/2014 10:00:00 PM,48,-122,3,0,3
383,ElliotBayTrailMyrtlePark,01/16/2014 11:00:00 PM,48,-122,0,0,0
384,ElliotBayTrailMyrtlePark,01/17/2014 12:00:00 AM,48,-122,1,0,1
385,ElliotBayTrailMyrtlePark,01/17/2014 01:00:00 AM,48,-122,0,0,0
386,ElliotBayTrailMyrtlePark,01/17/2014 02:00:00 AM,48,-122,0,0,0
387,ElliotBayTrailMyrtlePark,01/17/2014 03:00:00 AM,48,-122,0,0,0
388,ElliotBayTrailMyrtlePark,01/17/2014 04:00:00 AM,48,-122,7,6,13
389,ElliotBayTrailMyrtlePark,01/17/2014 05:00:00 AM,48,-122,14,19,33
390,ElliotBayTrailMyrtlePark,01/17/2014 06:00:00 AM,48,-122,23,60,83
391,ElliotBayTrailMyrtlePark,01/17/2014 07:00:00 AM,48,-122,20,77,97
392,ElliotBayTrailMyrtlePark,01/17/2014 08:00:00 AM,48,-122,12,33,45
393,ElliotBayTrailMyrtlePark,01/17/2014 09:00:00 AM,48,-122,14,13,27
394,ElliotBayTrailMyrtlePark,01/17/2014 10:00:00 AM,48,-122,8,12,20
395,ElliotBayTrailMyrtlePark,01/17/2014 11:00:00 AM,48,-122,10,8,18
396,ElliotBayTrailMyrtlePark,01/17/2014 12:00:00 PM,48,-122,29,11,40
397,ElliotBayTrailMyrtlePark,01/17/2014 01:00:00 PM,48,-122,17,14,31
398,ElliotBayTrailMyrtlePark,01/17/2014 02:00:00 PM,48,-122,28,24,52
399,ElliotBayTrailMyrtlePark,01/17/2014 03:00:00 PM,48,-122,63,28,91
400,ElliotBayTrailMyrtlePark,01/17/2014 04:00:00 PM,48,-122,89,37,126
401,ElliotBayTrailMyrtlePark,01/17/2014 05:00:00 PM,48,-122,30,11,41
402,ElliotBayTrailMyrtlePark,01/17/2014 06:00:00 PM,48,-122,9,1,10
403,ElliotBayTrailMyrtlePark,01/17/2014 07:00:00 PM,48,-122,4,0,4
404,ElliotBayTrailMyrtlePark,01/17/2014 08:00:00 PM,48,-122,3,0,3
405,ElliotBayTrailMyrtlePark,01/17/2014 09:00:00 PM,48,-122,9,0,9
406,ElliotBayTrailMyrtlePark,01/17/2014 10:00:00 PM,48,-122,3,0,3
407,ElliotBayTrailMyrtlePark,01/17/2014 11:00:00 PM,48,-122,3,0,3
408,ElliotBayTrailMyrtlePark,01/18/2014 12:00:00 AM,48,-122,1,4,5
409,ElliotBayTrailMyrtlePark,01/18/2014 01:00:00 AM,48,-122,2,0,2
410,ElliotBayTrailMyrtlePark,01/18/2014 02:00:00 AM,48,-122,0,1,1
411,ElliotBayTrailMyrtlePark,01/18/2014 03:00:00 AM,48,-122,0,0,0
412,ElliotBayTrailMyrtlePark,01/18/2014 04:00:00 AM,48,-122,0,0,0
413,ElliotBayTrailMyrtlePark,01/18/2014 05:00:00 AM,48,-122,1,4,5
414,ElliotBayTrailMyrtlePark,01/18/2014 06:00:00 AM,48,-122,8,4,12
415,ElliotBayTrailMyrtlePark,01/18/2014 07:00:00 AM,48,-122,7,6,13
416,ElliotBayTrailMyrtlePark,01/18/2014 08:00:00 AM,48,-122,10,11,21
417,ElliotBayTrailMyrtlePark,01/18/2014 09:00:00 AM,48,-122,10,17,27
418,ElliotBayTrailMyrtlePark,01/18/2014 10:00:00 AM,48,-122,17,18,35
419,ElliotBayTrailMyrtlePark,01/18/2014 11:00:00 AM,48,-122,29,29,58
420,ElliotBayTrailMyrtlePark,01/18/2014 12:00:00 PM,48,-122,31,31,62
421,ElliotBayTrailMyrtlePark,01/18/2014 01:00:00 PM,48,-122,24,40,64
422,ElliotBayTrailMyrtlePark,01/18/2014 02:00:00 PM,48,-122,35,23,58
423,ElliotBayTrailMyrtlePark,01/18/2014 03:00:00 PM,48,-122,24,24,48
424,ElliotBayTrailMyrtlePark,01/18/2014 04:00:00 PM,48,-122,10,11,21
425,ElliotBayTrailMyrtlePark,01/18/2014 05:00:00 PM,48,-122,11,4,15
426,ElliotBayTrailMyrtlePark,01/18/2014 06:00:00 PM,48,-122,3,1,4
427,ElliotBayTrailMyrtlePark,01/18/2014 07:00:00 PM,48,-122,1,1,2
428,ElliotBayTrailMyrtlePark,01/18/2014 08:00:00 PM,48,-122,3,0,3
429,ElliotBayTrailMyrtlePark,01/18/2014 09:00:00 PM,48,-122,1,0,1
430,ElliotBayTrailMyrtlePark,01/18/2014 10:00:00 PM,48,-122,0,2,2
431,ElliotBayTrailMyrtlePark,01/18/2014 11:00:00 PM,48,-122,2,0,2
432,ElliotBayTrailMyrtlePark,01/19/2014 12:00:00 AM,48,-122,0,0,0
433,ElliotBayTrailMyrtlePark,01/19/2014 01:00:00 AM,48,-122,0,0,0
434,ElliotBayTrailMyrtlePark,01/19/2014 02:00:00 AM,48,-122,0,0,0
435,ElliotBayTrailMyrtlePark,01/19/2014 03:00:00 AM,48,-122,0,0,0
436,ElliotBayTrailMyrtlePark,01/19/2014 04:00:00 AM,48,-122,0,1,1
437,ElliotBayTrailMyrtlePark,01/19/2014 05:00:00 AM,48,-122,1,3,4
438,ElliotBayTrailMyrtlePark,01/19/2014 06:00:00 AM,48,-122,3,2,5
439,ElliotBayTrailMyrtlePark,01/19/2014 07:00:00 AM,48,-122,5,4,9
440,ElliotBayTrailMyrtlePark,01/19/2014 08:00:00 AM,48,-122,12,18,30
441,ElliotBayTrailMyrtlePark,01/19/2014 09:00:00 AM,48,-122,19,11,30
442,ElliotBayTrailMyrtlePark,01/19/2014 10:00:00 AM,48,-122,27,24,51
443,ElliotBayTrailMyrtlePark,01/19/2014 11:00:00 AM,48,-122,17,17,34
444,ElliotBayTrailMyrtlePark,01/19/2014 12:00:00 PM,48,-122,14,17,31
445,ElliotBayTrailMyrtlePark,01/19/2014 01:00:00 PM,48,-122,22,20,42
446,ElliotBayTrailMyrtlePark,01/19/2014 02:00:00 PM,48,-122,8,15,23
447,ElliotBayTrailMyrtlePark,01/19/2014 03:00:00 PM,48,-122,8,7,15
448,ElliotBayTrailMyrtlePark,01/19/2014 04:00:00 PM,48,-122,7,3,10
449,ElliotBayTrailMyrtlePark,01/19/2014 05:00:00 PM,48,-122,2,2,4
450,ElliotBayTrailMyrtlePark,01/19/2014 06:00:00 PM,48,-122,7,4,11
451,ElliotBayTrailMyrtlePark,01/19/2014 07:00:00 PM,48,-122,10,3,13
452,ElliotBayTrailMyrtlePark,01/19/2014 08:00:00 PM,48,-122,7,1,8
453,ElliotBayTrailMyrtlePark,01/19/2014 09:00:00 PM,48,-122,3,5,8
454,ElliotBayTrailMyrtlePark,01/19/2014 10:00:00 PM,48,-122,5,1,6
455,ElliotBayTrailMyrtlePark,01/19/2014 11:00:00 PM,48,-122,1,0,1
456,ElliotBayTrailMyrtlePark,01/20/2014 12:00:00 AM,48,-122,2,0,2
457,ElliotBayTrailMyrtlePark,01/20/2014 01:00:00 AM,48,-122,1,0,1
458,ElliotBayTrailMyrtlePark,01/20/2014 02:00:00 AM,48,-122,1,0,1
459,ElliotBayTrailMyrtlePark,01/20/2014 03:00:00 AM,48,-122,1,1,2
460,ElliotBayTrailMyrtlePark,01/20/2014 04:00:00 AM,48,-122,2,4,6
461,ElliotBayTrailMyrtlePark,01/20/2014 05:00:00 AM,48,-122,9,15,24
462,ElliotBayTrailMyrtlePark,01/20/2014 06:00:00 AM,48,-122,19,30,49
463,ElliotBayTrailMyrtlePark,01/20/2014 07:00:00 AM,48,-122,16,45,61
464,ElliotBayTrailMyrtlePark,01/20/2014 08:00:00 AM,48,-122,10,38,48
465,ElliotBayTrailMyrtlePark,01/20/2014 09:00:00 AM,48,-122,8,15,23
466,ElliotBayTrailMyrtlePark,01/20/2014 10:00:00 AM,48,-122,17,17,34
467,ElliotBayTrailMyrtlePark,01/20/2014 11:00:00 AM,48,-122,20,8,28
468,ElliotBayTrailMyrtlePark,01/20/2014 12:00:00 PM,48,-122,28,30,58
469,ElliotBayTrailMyrtlePark,01/20/2014 01:00:00 PM,48,-122,35,18,53
470,ElliotBayTrailMyrtlePark,01/20/2014 02:00:00 PM,48,-122,41,33,74
471,ElliotBayTrailMyrtlePark,01/20/2014 03:00:00 PM,48,-122,41,35,76
472,ElliotBayTrailMyrtlePark,01/20/2014 04:00:00 PM,48,-122,69,24,93
473,ElliotBayTrailMyrtlePark,01/20/2014 05:00:00 PM,48,-122,31,8,39
474,ElliotBayTrailMyrtlePark,01/20/2014 06:00:00 PM,48,-122,10,6,16
475,ElliotBayTrailMyrtlePark,01/20/2014 07:00:00 PM,48,-122,2,0,2
476,ElliotBayTrailMyrtlePark,01/20/2014 08:00:00 PM,48,-122,1,0,1
477,ElliotBayTrailMyrtlePark,01/20/2014 09:00:00 PM,48,-122,0,0,0
478,ElliotBayTrailMyrtlePark,01/20/2014 10:00:00 PM,48,-122,1,1,2
479,ElliotBayTrailMyrtlePark,01/20/2014 11:00:00 PM,48,-122,1,1,2
480,ElliotBayTrailMyrtlePark,01/21/2014 12:00:00 AM,48,-122,0,0,0
481,ElliotBayTrailMyrtlePark,01/21/2014 01:00:00 AM,48,-122,1,1,2
482,ElliotBayTrailMyrtlePark,01/21/2014 02:00:00 AM,48,-122,2,0,2
483,ElliotBayTrailMyrtlePark,01/21/2014 03:00:00 AM,48,-122,0,0,0
484,ElliotBayTrailMyrtlePark,01/21/2014 04:00:00 AM,48,-122,6,11,17
485,ElliotBayTrailMyrtlePark,01/21/2014 05:00:00 AM,48,-122,17,33,50
486,ElliotBayTrailMyrtlePark,01/21/2014 06:00:00 AM,48,-122,39,69,108
487,ElliotBayTrailMyrtlePark,01/21/2014 07:00:00 AM,48,-122,24,94,118
488,ElliotBayTrailMyrtlePark,01/21/2014 08:00:00 AM,48,-122,10,43,53
489,ElliotBayTrailMyrtlePark,01/21/2014 09:00:00 AM,48,-122,15,17,32
490,ElliotBayTrailMyrtlePark,01/21/2014 10:00:00 AM,48,-122,9,17,26
491,ElliotBayTrailMyrtlePark,01/21/2014 11:00:00 AM,48,-122,5,2,7
492,ElliotBayTrailMyrtlePark,01/21/2014 12:00:00 PM,48,-122,9,10,19
493,ElliotBayTrailMyrtlePark,01/21/2014 01:00:00 PM,48,-122,14,21,35
494,ElliotBayTrailMyrtlePark,01/21/2014 02:00:00 PM,48,-122,31,27,58
495,ElliotBayTrailMyrtlePark,01/21/2014 03:00:00 PM,48,-122,75,37,112
496,ElliotBayTrailMyrtlePark,01/21/2014 04:00:00 PM,48,-122,130,47,177
497,ElliotBayTrailMyrtlePark,01/21/2014 05:00:00 PM,48,-122,63,12,75
498,ElliotBayTrailMyrtlePark,01/21/2014 06:00:00 PM,48,-122,19,9,28
499,ElliotBayTrailMyrtlePark,01/21/2014 07:00:00 PM,48,-122,4,1,5
500,ElliotBayTrailMyrtlePark,01/21/2014 08:00:00 PM,48,-122,4,2,6
501,ElliotBayTrailMyrtlePark,01/21/2014 09:00:00 PM,48,-122,4,1,5
502,ElliotBayTrailMyrtlePark,01/21/2014 10:00:00 PM,48,-122,4,3,7
503,ElliotBayTrailMyrtlePark,01/21/2014 11:00:00 PM,48,-122,2,0,2
504,ElliotBayTrailMyrtlePark,01/22/2014 12:00:00 AM,48,-122,0,0,0
505,ElliotBayTrailMyrtlePark,01/22/2014 01:00:00 AM,48,-122,1,1,2
506,ElliotBayTrailMyrtlePark,01/22/2014 02:00:00 AM,48,-122,2,1,3
507,ElliotBayTrailMyrtlePark,01/22/2014 03:00:00 AM,48,-122,0,0,0
508,ElliotBayTrailMyrtlePark,01/22/2014 04:00:00 AM,48,-122,10,8,18
509,ElliotBayTrailMyrtlePark,01/22/2014 05:00:00 AM,48,-122,14,25,39
510,ElliotBayTrailMyrtlePark,01/22/2014 06:00:00 AM,48,-122,44,79,123
511,ElliotBayTrailMyrtlePark,01/22/2014 07:00:00 AM,48,-122,21,79,100
512,ElliotBayTrailMyrtlePark,01/22/2014 08:00:00 AM,48,-122,14,43,57
513,ElliotBayTrailMyrtlePark,01/22/2014 09:00:00 AM,48,-122,10,15,25
514,ElliotBayTrailMyrtlePark,01/22/2014 10:00:00 AM,48,-122,14,7,21
515,ElliotBayTrailMyrtlePark,01/22/2014 11:00:00 AM,48,-122,16,12,28
516,ElliotBayTrailMyrtlePark,01/22/2014 12:00:00 PM,48,-122,9,18,27
517,ElliotBayTrailMyrtlePark,01/22/2014 01:00:00 PM,48,-122,3,9,12
518,ElliotBayTrailMyrtlePark,01/22/2014 02:00:00 PM,48,-122,27,21,48
519,ElliotBayTrailMyrtlePark,01/22/2014 03:00:00 PM,48,-122,57,31,88
520,ElliotBayTrailMyrtlePark,01/22/2014 04:00:00 PM,48,-122,117,32,149
521,ElliotBayTrailMyrtlePark,01/22/2014 05:00:00 PM,48,-122,76,20,96
522,ElliotBayTrailMyrtlePark,01/22/2014 06:00:00 PM,48,-122,20,5,25
523,ElliotBayTrailMyrtlePark,01/22/2014 07:00:00 PM,48,-122,8,3,11
524,ElliotBayTrailMyrtlePark,01/22/2014 08:00:00 PM,48,-122,5,0,5
525,ElliotBayTrailMyrtlePark,01/22/2014 09:00:00 PM,48,-122,0,3,3
526,ElliotBayTrailMyrtlePark,01/22/2014 10:00:00 PM,48,-122,2,1,3
527,ElliotBayTrailMyrtlePark,01/22/2014 11:00:00 PM,48,-122,2,1,3
528,ElliotBayTrailMyrtlePark,01/23/2014 12:00:00 AM,48,-122,1,0,1
529,ElliotBayTrailMyrtlePark,01/23/2014 01:00:00 AM,48,-122,1,1,2
530,ElliotBayTrailMyrtlePark,01/23/2014 02:00:00 AM,48,-122,1,1,2
531,ElliotBayTrailMyrtlePark,01/23/2014 03:00:00 AM,48,-122,0,1,1
532,ElliotBayTrailMyrtlePark,01/23/2014 04:00:00 AM,48,-122,10,10,20
533,ElliotBayTrailMyrtlePark,01/23/2014 05:00:00 AM,48,-122,14,16,30
534,ElliotBayTrailMyrtlePark,01/23/2014 06:00:00 AM,48,-122,28,65,93
535,ElliotBayTrailMyrtlePark,01/23/2014 07:00:00 AM,48,-122,30,75,105
536,ElliotBayTrailMyrtlePark,01/23/2014 08:00:00 AM,48,-122,8,44,52
537,ElliotBayTrailMyrtlePark,01/23/2014 09:00:00 AM,48,-122,8,13,21
538,ElliotBayTrailMyrtlePark,01/23/2014 10:00:00 AM,48,-122,5,7,12
539,ElliotBayTrailMyrtlePark,01/23/2014 11:00:00 AM,48,-122,15,15,30
540,ElliotBayTrailMyrtlePark,01/23/2014 12:00:00 PM,48,-122,20,13,33
541,ElliotBayTrailMyrtlePark,01/23/2014 01:00:00 PM,48,-122,23,25,48
542,ElliotBayTrailMyrtlePark,01/23/2014 02:00:00 PM,48,-122,32,32,64
543,ElliotBayTrailMyrtlePark,01/23/2014 03:00:00 PM,48,-122,74,41,115
544,ElliotBayTrailMyrtlePark,01/23/2014 04:00:00 PM,48,-122,110,35,145
545,ElliotBayTrailMyrtlePark,01/23/2014 05:00:00 PM,48,-122,63,21,84
546,ElliotBayTrailMyrtlePark,01/23/2014 06:00:00 PM,48,-122,23,7,30
547,ElliotBayTrailMyrtlePark,01/23/2014 07:00:00 PM,48,-122,8,5,13
548,ElliotBayTrailMyrtlePark,01/23/2014 08:00:00 PM,48,-122,1,1,2
549,ElliotBayTrailMyrtlePark,01/23/2014 09:00:00 PM,48,-122,5,0,5
550,ElliotBayTrailMyrtlePark,01/23/2014 10:00:00 PM,48,-122,2,0,2
551,ElliotBayTrailMyrtlePark,01/23/2014 11:00:00 PM,48,-122,0,1,1
552,ElliotBayTrailMyrtlePark,01/24/2014 12:00:00 AM,48,-122,0,0,0
553,ElliotBayTrailMyrtlePark,01/24/2014 01:00:00 AM,48,-122,1,0,1
554,ElliotBayTrailMyrtlePark,01/24/2014 02:00:00 AM,48,-122,0,0,0
555,ElliotBayTrailMyrtlePark,01/24/2014 03:00:00 AM,48,-122,0,0,0
556,ElliotBayTrailMyrtlePark,01/24/2014 04:00:00 AM,48,-122,12,10,22
557,ElliotBayTrailMyrtlePark,01/24/2014 05:00:00 AM,48,-122,8,14,22
558,ElliotBayTrailMyrtlePark,01/24/2014 06:00:00 AM,48,-122,30,55,85
559,ElliotBayTrailMyrtlePark,01/24/2014 07:00:00 AM,48,-122,21,65,86
560,ElliotBayTrailMyrtlePark,01/24/2014 08:00:00 AM,48,-122,8,36,44
561,ElliotBayTrailMyrtlePark,01/24/2014 09:00:00 AM,48,-122,9,14,23
562,ElliotBayTrailMyrtlePark,01/24/2014 10:00:00 AM,48,-122,11,17,28
563,ElliotBayTrailMyrtlePark,01/24/2014 11:00:00 AM,48,-122,17,19,36
564,ElliotBayTrailMyrtlePark,01/24/2014 12:00:00 PM,48,-122,19,21,40
565,ElliotBayTrailMyrtlePark,01/24/2014 01:00:00 PM,48,-122,34,30,64
566,ElliotBayTrailMyrtlePark,01/24/2014 02:00:00 PM,48,-122,46,42,88
567,ElliotBayTrailMyrtlePark,01/24/2014 03:00:00 PM,48,-122,72,38,110
568,ElliotBayTrailMyrtlePark,01/24/2014 04:00:00 PM,48,-122,114,37,151
569,ElliotBayTrailMyrtlePark,01/24/2014 05:00:00 PM,48,-122,43,17,60
570,ElliotBayTrailMyrtlePark,01/24/2014 06:00:00 PM,48,-122,11,4,15
571,ElliotBayTrailMyrtlePark,01/24/2014 07:00:00 PM,48,-122,3,1,4
572,ElliotBayTrailMyrtlePark,01/24/2014 08:00:00 PM,48,-122,2,0,2
573,ElliotBayTrailMyrtlePark,01/24/2014 09:00:00 PM,48,-122,5,0,5
574,ElliotBayTrailMyrtlePark,01/24/2014 10:00:00 PM,48,-122,1,0,1
575,ElliotBayTrailMyrtlePark,01/24/2014 11:00:00 PM,48,-122,0,0,0
576,ElliotBayTrailMyrtlePark,01/25/2014 12:00:00 AM,48,-122,0,1,1
577,ElliotBayTrailMyrtlePark,01/25/2014 01:00:00 AM,48,-122,0,0,0
578,ElliotBayTrailMyrtlePark,01/25/2014 02:00:00 AM,48,-122,0,0,0
579,ElliotBayTrailMyrtlePark,01/25/2014 03:00:00 AM,48,-122,1,1,2
580,ElliotBayTrailMyrtlePark,01/25/2014 04:00:00 AM,48,-122,0,0,0
581,ElliotBayTrailMyrtlePark,01/25/2014 05:00:00 AM,48,-122,2,1,3
582,ElliotBayTrailMyrtlePark,01/25/2014 06:00:00 AM,48,-122,7,4,11
583,ElliotBayTrailMyrtlePark,01/25/2014 07:00:00 AM,48,-122,6,19,25
584,ElliotBayTrailMyrtlePark,01/25/2014 08:00:00 AM,48,-122,9,13,22
585,ElliotBayTrailMyrtlePark,01/25/2014 09:00:00 AM,48,-122,7,16,23
586,ElliotBayTrailMyrtlePark,01/25/2014 10:00:00 AM,48,-122,24,28,52
587,ElliotBayTrailMyrtlePark,01/25/2014 11:00:00 AM,48,-122,39,33,72
588,ElliotBayTrailMyrtlePark,01/25/2014 12:00:00 PM,48,-122,43,45,88
589,ElliotBayTrailMyrtlePark,01/25/2014 01:00:00 PM,48,-122,64,62,126
590,ElliotBayTrailMyrtlePark,01/25/2014 02:00:00 PM,48,-122,71,57,128
591,ElliotBayTrailMyrtlePark,01/25/2014 03:00:00 PM,48,-122,75,51,126
592,ElliotBayTrailMyrtlePark,01/25/2014 04:00:00 PM,48,-122,23,26,49
593,ElliotBayTrailMyrtlePark,01/25/2014 05:00:00 PM,48,-122,9,15,24
594,ElliotBayTrailMyrtlePark,01/25/2014 06:00:00 PM,48,-122,6,5,11
595,ElliotBayTrailMyrtlePark,01/25/2014 07:00:00 PM,48,-122,2,0,2
596,ElliotBayTrailMyrtlePark,01/25/2014 08:00:00 PM,48,-122,4,0,4
597,ElliotBayTrailMyrtlePark,01/25/2014 09:00:00 PM,48,-122,3,3,6
598,ElliotBayTrailMyrtlePark,01/25/2014 10:00:00 PM,48,-122,0,0,0
599,ElliotBayTrailMyrtlePark,01/25/2014 11:00:00 PM,48,-122,0,1,1
600,ElliotBayTrailMyrtlePark,01/26/2014 12:00:00 AM,48,-122,1,0,1
601,ElliotBayTrailMyrtlePark,01/26/2014 01:00:00 AM,48,-122,1,0,1
602,ElliotBayTrailMyrtlePark,01/26/2014 02:00:00 AM,48,-122,0,0,0
603,ElliotBayTrailMyrtlePark,01/26/2014 03:00:00 AM,48,-122,0,0,0
604,ElliotBayTrailMyrtlePark,01/26/2014 04:00:00 AM,48,-122,1,1,2
605,ElliotBayTrailMyrtlePark,01/26/2014 05:00:00 AM,48,-122,2,2,4
606,ElliotBayTrailMyrtlePark,01/26/2014 06:00:00 AM,48,-122,5,2,7
607,ElliotBayTrailMyrtlePark,01/26/2014 07:00:00 AM,48,-122,8,7,15
608,ElliotBayTrailMyrtlePark,01/26/2014 08:00:00 AM,48,-122,8,9,17
609,ElliotBayTrailMyrtlePark,01/26/2014 09:00:00 AM,48,-122,21,28,49
610,ElliotBayTrailMyrtlePark,01/26/2014 10:00:00 AM,48,-122,19,37,56
611,ElliotBayTrailMyrtlePark,01/26/2014 11:00:00 AM,48,-122,33,23,56
612,ElliotBayTrailMyrtlePark,01/26/2014 12:00:00 PM,48,-122,38,35,73
613,ElliotBayTrailMyrtlePark,01/26/2014 01:00:00 PM,48,-122,46,45,91
614,ElliotBayTrailMyrtlePark,01/26/2014 02:00:00 PM,48,-122,47,43,90
615,ElliotBayTrailMyrtlePark,01/26/2014 03:00:00 PM,48,-122,39,35,74
616,ElliotBayTrailMyrtlePark,01/26/2014 04:00:00 PM,48,-122,19,17,36
617,ElliotBayTrailMyrtlePark,01/26/2014 05:00:00 PM,48,-122,3,2,5
618,ElliotBayTrailMyrtlePark,01/26/2014 06:00:00 PM,48,-122,3,1,4
619,ElliotBayTrailMyrtlePark,01/26/2014 07:00:00 PM,48,-122,1,1,2
620,ElliotBayTrailMyrtlePark,01/26/2014 08:00:00 PM,48,-122,1,0,1
621,ElliotBayTrailMyrtlePark,01/26/2014 09:00:00 PM,48,-122,1,1,2
622,ElliotBayTrailMyrtlePark,01/26/2014 10:00:00 PM,48,-122,1,1,2
623,ElliotBayTrailMyrtlePark,01/26/2014 11:00:00 PM,48,-122,0,0,0
624,ElliotBayTrailMyrtlePark,01/27/2014 12:00:00 AM,48,-122,1,1,2
625,ElliotBayTrailMyrtlePark,01/27/2014 01:00:00 AM,48,-122,1,1,2
626,ElliotBayTrailMyrtlePark,01/27/2014 02:00:00 AM,48,-122,1,0,1
627,ElliotBayTrailMyrtlePark,01/27/2014 03:00:00 AM,48,-122,1,3,4
628,ElliotBayTrailMyrtlePark,01/27/2014 04:00:00 AM,48,-122,12,10,22
629,ElliotBayTrailMyrtlePark,01/27/2014 05:00:00 AM,48,-122,12,19,31
630,ElliotBayTrailMyrtlePark,01/27/2014 06:00:00 AM,48,-122,37,65,102
631,ElliotBayTrailMyrtlePark,01/27/2014 07:00:00 AM,48,-122,24,80,104
632,ElliotBayTrailMyrtlePark,01/27/2014 08:00:00 AM,48,-122,14,59,73
633,ElliotBayTrailMyrtlePark,01/27/2014 09:00:00 AM,48,-122,6,13,19
634,ElliotBayTrailMyrtlePark,01/27/2014 10:00:00 AM,48,-122,13,16,29
635,ElliotBayTrailMyrtlePark,01/27/2014 11:00:00 AM,48,-122,9,10,19
636,ElliotBayTrailMyrtlePark,01/27/2014 12:00:00 PM,48,-122,16,11,27
637,ElliotBayTrailMyrtlePark,01/27/2014 01:00:00 PM,48,-122,11,8,19
638,ElliotBayTrailMyrtlePark,01/27/2014 02:00:00 PM,48,-122,24,23,47
639,ElliotBayTrailMyrtlePark,01/27/2014 03:00:00 PM,48,-122,50,34,84
640,ElliotBayTrailMyrtlePark,01/27/2014 04:00:00 PM,48,-122,115,36,151
641,ElliotBayTrailMyrtlePark,01/27/2014 05:00:00 PM,48,-122,65,13,78
642,ElliotBayTrailMyrtlePark,01/27/2014 06:00:00 PM,48,-122,19,6,25
643,ElliotBayTrailMyrtlePark,01/27/2014 07:00:00 PM,48,-122,3,3,6
644,ElliotBayTrailMyrtlePark,01/27/2014 08:00:00 PM,48,-122,4,1,5
645,ElliotBayTrailMyrtlePark,01/27/2014 09:00:00 PM,48,-122,0,1,1
646,ElliotBayTrailMyrtlePark,01/27/2014 10:00:00 PM,48,-122,3,2,5
647,ElliotBayTrailMyrtlePark,01/27/2014 11:00:00 PM,48,-122,1,1,2
648,ElliotBayTrailMyrtlePark,01/28/2014 12:00:00 AM,48,-122,0,0,0
649,ElliotBayTrailMyrtlePark,01/28/2014 01:00:00 AM,48,-122,1,1,2
650,ElliotBayTrailMyrtlePark,01/28/2014 02:00:00 AM,48,-122,1,1,2
651,ElliotBayTrailMyrtlePark,01/28/2014 03:00:00 AM,48,-122,2,0,2
652,ElliotBayTrailMyrtlePark,01/28/2014 04:00:00 AM,48,-122,16,10,26
653,ElliotBayTrailMyrtlePark,01/28/2014 05:00:00 AM,48,-122,9,29,38
654,ElliotBayTrailMyrtlePark,01/28/2014 06:00:00 AM,48,-122,33,66,99
655,ElliotBayTrailMyrtlePark,01/28/2014 07:00:00 AM,48,-122,24,84,108
656,ElliotBayTrailMyrtlePark,01/28/2014 08:00:00 AM,48,-122,7,49,56
657,ElliotBayTrailMyrtlePark,01/28/2014 09:00:00 AM,48,-122,4,6,10
658,ElliotBayTrailMyrtlePark,01/28/2014 10:00:00 AM,48,-122,15,8,23
659,ElliotBayTrailMyrtlePark,01/28/2014 11:00:00 AM,48,-122,14,6,20
660,ElliotBayTrailMyrtlePark,01/28/2014 12:00:00 PM,48,-122,8,8,16
661,ElliotBayTrailMyrtlePark,01/28/2014 01:00:00 PM,48,-122,8,20,28
662,ElliotBayTrailMyrtlePark,01/28/2014 02:00:00 PM,48,-122,23,12,35
663,ElliotBayTrailMyrtlePark,01/28/2014 03:00:00 PM,48,-122,41,32,73
664,ElliotBayTrailMyrtlePark,01/28/2014 04:00:00 PM,48,-122,122,36,158
665,ElliotBayTrailMyrtlePark,01/28/2014 05:00:00 PM,48,-122,62,20,82
666,ElliotBayTrailMyrtlePark,01/28/2014 06:00:00 PM,48,-122,13,5,18
667,ElliotBayTrailMyrtlePark,01/28/2014 07:00:00 PM,48,-122,5,0,5
668,ElliotBayTrailMyrtlePark,01/28/2014 08:00:00 PM,48,-122,6,1,7
669,ElliotBayTrailMyrtlePark,01/28/2014 09:00:00 PM,48,-122,1,0,1
670,ElliotBayTrailMyrtlePark,01/28/2014 10:00:00 PM,48,-122,1,0,1
671,ElliotBayTrailMyrtlePark,01/28/2014 11:00:00 PM,48,-122,1,0,1
672,ElliotBayTrailMyrtlePark,01/29/2014 12:00:00 AM,48,-122,0,0,0
673,ElliotBayTrailMyrtlePark,01/29/2014 01:00:00 AM,48,-122,0,0,0
674,ElliotBayTrailMyrtlePark,01/29/2014 02:00:00 AM,48,-122,0,0,0
675,ElliotBayTrailMyrtlePark,01/29/2014 03:00:00 AM,48,-122,0,0,0
676,ElliotBayTrailMyrtlePark,01/29/2014 04:00:00 AM,48,-122,6,12,18
677,ElliotBayTrailMyrtlePark,01/29/2014 05:00:00 AM,48,-122,17,18,35
678,ElliotBayTrailMyrtlePark,01/29/2014 06:00:00 AM,48,-122,26,61,87
679,ElliotBayTrailMyrtlePark,01/29/2014 07:00:00 AM,48,-122,24,62,86
680,ElliotBayTrailMyrtlePark,01/29/2014 08:00:00 AM,48,-122,9,20,29
681,ElliotBayTrailMyrtlePark,01/29/2014 09:00:00 AM,48,-122,3,9,12
682,ElliotBayTrailMyrtlePark,01/29/2014 10:00:00 AM,48,-122,4,4,8
683,ElliotBayTrailMyrtlePark,01/29/2014 11:00:00 AM,48,-122,9,4,13
684,ElliotBayTrailMyrtlePark,01/29/2014 12:00:00 PM,48,-122,6,5,11
685,ElliotBayTrailMyrtlePark,01/29/2014 01:00:00 PM,48,-122,4,8,12
686,ElliotBayTrailMyrtlePark,01/29/2014 02:00:00 PM,48,-122,10,19,29
687,ElliotBayTrailMyrtlePark,01/29/2014 03:00:00 PM,48,-122,45,18,63
688,ElliotBayTrailMyrtlePark,01/29/2014 04:00:00 PM,48,-122,76,29,105
689,ElliotBayTrailMyrtlePark,01/29/2014 05:00:00 PM,48,-122,60,10,70
690,ElliotBayTrailMyrtlePark,01/29/2014 06:00:00 PM,48,-122,20,1,21
691,ElliotBayTrailMyrtlePark,01/29/2014 07:00:00 PM,48,-122,6,2,8
692,ElliotBayTrailMyrtlePark,01/29/2014 08:00:00 PM,48,-122,2,0,2
693,ElliotBayTrailMyrtlePark,01/29/2014 09:00:00 PM,48,-122,1,1,2
694,ElliotBayTrailMyrtlePark,01/29/2014 10:00:00 PM,48,-122,2,0,2
695,ElliotBayTrailMyrtlePark,01/29/2014 11:00:00 PM,48,-122,1,0,1
696,ElliotBayTrailMyrtlePark,01/30/2014 12:00:00 AM,48,-122,0,0,0
697,ElliotBayTrailMyrtlePark,01/30/2014 01:00:00 AM,48,-122,1,1,2
698,ElliotBayTrailMyrtlePark,01/30/2014 02:00:00 AM,48,-122,1,1,2
699,ElliotBayTrailMyrtlePark,01/30/2014 03:00:00 AM,48,-122,1,0,1
700,ElliotBayTrailMyrtlePark,01/30/2014 04:00:00 AM,48,-122,11,7,18
701,ElliotBayTrailMyrtlePark,01/30/2014 05:00:00 AM,48,-122,14,17,31
702,ElliotBayTrailMyrtlePark,01/30/2014 06:00:00 AM,48,-122,35,64,99
703,ElliotBayTrailMyrtlePark,01/30/2014 07:00:00 AM,48,-122,30,74,104
704,ElliotBayTrailMyrtlePark,01/30/2014 08:00:00 AM,48,-122,8,45,53
705,ElliotBayTrailMyrtlePark,01/30/2014 09:00:00 AM,48,-122,7,10,17
706,ElliotBayTrailMyrtlePark,01/30/2014 10:00:00 AM,48,-122,6,9,15
707,ElliotBayTrailMyrtlePark,01/30/2014 11:00:00 AM,48,-122,7,5,12
708,ElliotBayTrailMyrtlePark,01/30/2014 12:00:00 PM,48,-122,10,9,19
709,ElliotBayTrailMyrtlePark,01/30/2014 01:00:00 PM,48,-122,16,14,30
710,ElliotBayTrailMyrtlePark,01/30/2014 02:00:00 PM,48,-122,21,14,35
711,ElliotBayTrailMyrtlePark,01/30/2014 03:00:00 PM,48,-122,43,30,73
712,ElliotBayTrailMyrtlePark,01/30/2014 04:00:00 PM,48,-122,94,32,126
713,ElliotBayTrailMyrtlePark,01/30/2014 05:00:00 PM,48,-122,47,7,54
714,ElliotBayTrailMyrtlePark,01/30/2014 06:00:00 PM,48,-122,21,10,31
715,ElliotBayTrailMyrtlePark,01/30/2014 07:00:00 PM,48,-122,13,1,14
716,ElliotBayTrailMyrtlePark,01/30/2014 08:00:00 PM,48,-122,4,0,4
717,ElliotBayTrailMyrtlePark,01/30/2014 09:00:00 PM,48,-122,3,1,4
718,ElliotBayTrailMyrtlePark,01/30/2014 10:00:00 PM,48,-122,3,0,3
719,ElliotBayTrailMyrtlePark,01/30/2014 11:00:00 PM,48,-122,1,0,1
720,ElliotBayTrailMyrtlePark,01/31/2014 12:00:00 AM,48,-122,0,0,0
721,ElliotBayTrailMyrtlePark,01/31/2014 01:00:00 AM,48,-122,0,0,0
722,ElliotBayTrailMyrtlePark,01/31/2014 02:00:00 AM,48,-122,0,0,0
723,ElliotBayTrailMyrtlePark,01/31/2014 03:00:00 AM,48,-122,0,0,0
724,ElliotBayTrailMyrtlePark,01/31/2014 04:00:00 AM,48,-122,15,6,21
725,ElliotBayTrailMyrtlePark,01/31/2014 05:00:00 AM,48,-122,6,16,22
726,ElliotBayTrailMyrtlePark,01/31/2014 06:00:00 AM,48,-122,28,51,79
727,ElliotBayTrailMyrtlePark,01/31/2014 07:00:00 AM,48,-122,23,76,99
728,ElliotBayTrailMyrtlePark,01/31/2014 08:00:00 AM,48,-122,6,29,35
729,ElliotBayTrailMyrtlePark,01/31/2014 09:00:00 AM,48,-122,7,10,17
730,ElliotBayTrailMyrtlePark,01/31/2014 10:00:00 AM,48,-122,5,11,16
731,ElliotBayTrailMyrtlePark,01/31/2014 11:00:00 AM,48,-122,9,5,14
732,ElliotBayTrailMyrtlePark,01/31/2014 12:00:00 PM,48,-122,8,8,16
733,ElliotBayTrailMyrtlePark,01/31/2014 01:00:00 PM,48,-122,9,11,20
734,ElliotBayTrailMyrtlePark,01/31/2014 02:00:00 PM,48,-122,24,20,44
735,ElliotBayTrailMyrtlePark,01/31/2014 03:00:00 PM,48,-122,49,22,71
736,ElliotBayTrailMyrtlePark,01/31/2014 04:00:00 PM,48,-122,73,27,100
737,ElliotBayTrailMyrtlePark,01/31/2014 05:00:00 PM,48,-122,46,10,56
738,ElliotBayTrailMyrtlePark,01/31/2014 06:00:00 PM,48,-122,9,5,14
739,ElliotBayTrailMyrtlePark,01/31/2014 07:00:00 PM,48,-122,2,1,3
740,ElliotBayTrailMyrtlePark,01/31/2014 08:00:00 PM,48,-122,5,0,5
741,ElliotBayTrailMyrtlePark,01/31/2014 09:00:00 PM,48,-122,2,1,3
742,ElliotBayTrailMyrtlePark,01/31/2014 10:00:00 PM,48,-122,5,2,7
743,ElliotBayTrailMyrtlePark,01/31/2014 11:00:00 PM,48,-122,2,1,3
744,ElliotBayTrailMyrtlePark,02/01/2014 12:00:00 AM,48,-122,0,0,0
745,ElliotBayTrailMyrtlePark,02/01/2014 01:00:00 AM,48,-122,0,0,0
746,ElliotBayTrailMyrtlePark,02/01/2014 02:00:00 AM,48,-122,0,0,0
747,ElliotBayTrailMyrtlePark,02/01/2014 03:00:00 AM,48,-122,0,0,0
748,ElliotBayTrailMyrtlePark,02/01/2014 04:00:00 AM,48,-122,0,1,1
749,ElliotBayTrailMyrtlePark,02/01/2014 05:00:00 AM,48,-122,1,4,5
750,ElliotBayTrailMyrtlePark,02/01/2014 06:00:00 AM,48,-122,4,2,6
751,ElliotBayTrailMyrtlePark,02/01/2014 07:00:00 AM,48,-122,15,15,30
752,ElliotBayTrailMyrtlePark,02/01/2014 08:00:00 AM,48,-122,11,14,25
753,ElliotBayTrailMyrtlePark,02/01/2014 09:00:00 AM,48,-122,12,35,47
754,ElliotBayTrailMyrtlePark,02/01/2014 10:00:00 AM,48,-122,13,23,36
755,ElliotBayTrailMyrtlePark,02/01/2014 11:00:00 AM,48,-122,34,29,63
756,ElliotBayTrailMyrtlePark,02/01/2014 12:00:00 PM,48,-122,19,15,34
757,ElliotBayTrailMyrtlePark,02/01/2014 01:00:00 PM,48,-122,32,37,69
758,ElliotBayTrailMyrtlePark,02/01/2014 02:00:00 PM,48,-122,38,28,66
759,ElliotBayTrailMyrtlePark,02/01/2014 03:00:00 PM,48,-122,39,25,64
760,ElliotBayTrailMyrtlePark,02/01/2014 04:00:00 PM,48,-122,16,12,28
761,ElliotBayTrailMyrtlePark,02/01/2014 05:00:00 PM,48,-122,13,3,16
762,ElliotBayTrailMyrtlePark,02/01/2014 06:00:00 PM,48,-122,2,2,4
763,ElliotBayTrailMyrtlePark,02/01/2014 07:00:00 PM,48,-122,4,0,4
764,ElliotBayTrailMyrtlePark,02/01/2014 08:00:00 PM,48,-122,2,1,3
765,ElliotBayTrailMyrtlePark,02/01/2014 09:00:00 PM,48,-122,5,0,5
766,ElliotBayTrailMyrtlePark,02/01/2014 10:00:00 PM,48,-122,1,0,1
767,ElliotBayTrailMyrtlePark,02/01/2014 11:00:00 PM,48,-122,1,0,1
768,ElliotBayTrailMyrtlePark,02/02/2014 12:00:00 AM,48,-122,0,0,0
769,ElliotBayTrailMyrtlePark,02/02/2014 01:00:00 AM,48,-122,0,0,0
770,ElliotBayTrailMyrtlePark,02/02/2014 02:00:00 AM,48,-122,0,0,0
771,ElliotBayTrailMyrtlePark,02/02/2014 03:00:00 AM,48,-122,0,0,0
772,ElliotBayTrailMyrtlePark,02/02/2014 04:00:00 AM,48,-122,1,1,2
773,ElliotBayTrailMyrtlePark,02/02/2014 05:00:00 AM,48,-122,2,1,3
774,ElliotBayTrailMyrtlePark,02/02/2014 06:00:00 AM,48,-122,4,6,10
775,ElliotBayTrailMyrtlePark,02/02/2014 07:00:00 AM,48,-122,5,2,7
776,ElliotBayTrailMyrtlePark,02/02/2014 08:00:00 AM,48,-122,9,14,23
777,ElliotBayTrailMyrtlePark,02/02/2014 09:00:00 AM,48,-122,28,17,45
778,ElliotBayTrailMyrtlePark,02/02/2014 10:00:00 AM,48,-122,33,39,72
779,ElliotBayTrailMyrtlePark,02/02/2014 11:00:00 AM,48,-122,38,35,73
780,ElliotBayTrailMyrtlePark,02/02/2014 12:00:00 PM,48,-122,26,21,47
781,ElliotBayTrailMyrtlePark,02/02/2014 01:00:00 PM,48,-122,33,24,57
782,ElliotBayTrailMyrtlePark,02/02/2014 02:00:00 PM,48,-122,11,23,34
783,ElliotBayTrailMyrtlePark,02/02/2014 03:00:00 PM,48,-122,9,6,15
784,ElliotBayTrailMyrtlePark,02/02/2014 04:00:00 PM,48,-122,3,4,7
785,ElliotBayTrailMyrtlePark,02/02/2014 05:00:00 PM,48,-122,0,4,4
786,ElliotBayTrailMyrtlePark,02/02/2014 06:00:00 PM,48,-122,5,7,12
787,ElliotBayTrailMyrtlePark,02/02/2014 07:00:00 PM,48,-122,1,1,2
788,ElliotBayTrailMyrtlePark,02/02/2014 08:00:00 PM,48,-122,3,0,3
789,ElliotBayTrailMyrtlePark,02/02/2014 09:00:00 PM,48,-122,6,2,8
790,ElliotBayTrailMyrtlePark,02/02/2014 10:00:00 PM,48,-122,4,1,5
791,ElliotBayTrailMyrtlePark,02/02/2014 11:00:00 PM,48,-122,2,0,2
792,ElliotBayTrailMyrtlePark,02/03/2014 12:00:00 AM,48,-122,0,0,0
793,ElliotBayTrailMyrtlePark,02/03/2014 01:00:00 AM,48,-122,1,2,3
794,ElliotBayTrailMyrtlePark,02/03/2014 02:00:00 AM,48,-122,0,0,0
795,ElliotBayTrailMyrtlePark,02/03/2014 03:00:00 AM,48,-122,0,0,0
796,ElliotBayTrailMyrtlePark,02/03/2014 04:00:00 AM,48,-122,6,7,13
797,ElliotBayTrailMyrtlePark,02/03/2014 05:00:00 AM,48,-122,11,17,28
798,ElliotBayTrailMyrtlePark,02/03/2014 06:00:00 AM,48,-122,36,51,87
799,ElliotBayTrailMyrtlePark,02/03/2014 07:00:00 AM,48,-122,25,71,96
800,ElliotBayTrailMyrtlePark,02/03/2014 08:00:00 AM,48,-122,9,35,44
801,ElliotBayTrailMyrtlePark,02/03/2014 09:00:00 AM,48,-122,5,7,12
802,ElliotBayTrailMyrtlePark,02/03/2014 10:00:00 AM,48,-122,5,8,13
803,ElliotBayTrailMyrtlePark,02/03/2014 11:00:00 AM,48,-122,8,12,20
804,ElliotBayTrailMyrtlePark,02/03/2014 12:00:00 PM,48,-122,7,12,19
805,ElliotBayTrailMyrtlePark,02/03/2014 01:00:00 PM,48,-122,0,0,0
806,ElliotBayTrailMyrtlePark,02/03/2014 02:00:00 PM,48,-122,13,15,28
807,ElliotBayTrailMyrtlePark,02/03/2014 03:00:00 PM,48,-122,24,16,40
808,ElliotBayTrailMyrtlePark,02/03/2014 04:00:00 PM,48,-122,38,28,66
809,ElliotBayTrailMyrtlePark,02/03/2014 05:00:00 PM,48,-122,94,29,123
810,ElliotBayTrailMyrtlePark,02/03/2014 06:00:00 PM,48,-122,49,10,59
811,ElliotBayTrailMyrtlePark,02/03/2014 07:00:00 PM,48,-122,21,2,23
812,ElliotBayTrailMyrtlePark,02/03/2014 08:00:00 PM,48,-122,0,2,2
813,ElliotBayTrailMyrtlePark,02/03/2014 09:00:00 PM,48,-122,2,1,3
814,ElliotBayTrailMyrtlePark,02/03/2014 10:00:00 PM,48,-122,0,1,1
815,ElliotBayTrailMyrtlePark,02/03/2014 11:00:00 PM,48,-122,2,1,3
816,ElliotBayTrailMyrtlePark,02/04/2014 12:00:00 AM,48,-122,1,3,4
817,ElliotBayTrailMyrtlePark,02/04/2014 01:00:00 AM,48,-122,0,0,0
818,ElliotBayTrailMyrtlePark,02/04/2014 02:00:00 AM,48,-122,1,1,2
819,ElliotBayTrailMyrtlePark,02/04/2014 03:00:00 AM,48,-122,1,1,2
820,ElliotBayTrailMyrtlePark,02/04/2014 04:00:00 AM,48,-122,0,1,1
821,ElliotBayTrailMyrtlePark,02/04/2014 05:00:00 AM,48,-122,5,11,16
822,ElliotBayTrailMyrtlePark,02/04/2014 06:00:00 AM,48,-122,23,15,38
823,ElliotBayTrailMyrtlePark,02/04/2014 07:00:00 AM,48,-122,32,65,97
824,ElliotBayTrailMyrtlePark,02/04/2014 08:00:00 AM,48,-122,18,78,96
825,ElliotBayTrailMyrtlePark,02/04/2014 09:00:00 AM,48,-122,11,38,49
826,ElliotBayTrailMyrtlePark,02/04/2014 10:00:00 AM,48,-122,6,10,16
827,ElliotBayTrailMyrtlePark,02/04/2014 11:00:00 AM,48,-122,8,5,13
828,ElliotBayTrailMyrtlePark,02/04/2014 12:00:00 PM,48,-122,2,2,4
829,ElliotBayTrailMyrtlePark,02/04/2014 01:00:00 PM,48,-122,4,18,22
830,ElliotBayTrailMyrtlePark,02/04/2014 02:00:00 PM,48,-122,13,13,26
831,ElliotBayTrailMyrtlePark,02/04/2014 03:00:00 PM,48,-122,21,13,34
832,ElliotBayTrailMyrtlePark,02/04/2014 04:00:00 PM,48,-122,32,24,56
833,ElliotBayTrailMyrtlePark,02/04/2014 05:00:00 PM,48,-122,99,31,130
834,ElliotBayTrailMyrtlePark,02/04/2014 06:00:00 PM,48,-122,51,16,67
835,ElliotBayTrailMyrtlePark,02/04/2014 07:00:00 PM,48,-122,14,4,18
836,ElliotBayTrailMyrtlePark,02/04/2014 08:00:00 PM,48,-122,4,0,4
837,ElliotBayTrailMyrtlePark,02/04/2014 09:00:00 PM,48,-122,3,1,4
838,ElliotBayTrailMyrtlePark,02/04/2014 10:00:00 PM,48,-122,0,0,0
839,ElliotBayTrailMyrtlePark,02/04/2014 11:00:00 PM,48,-122,1,1,2
840,ElliotBayTrailMyrtlePark,02/05/2014 12:00:00 AM,48,-122,1,1,2
841,ElliotBayTrailMyrtlePark,02/05/2014 01:00:00 AM,48,-122,1,0,1
842,ElliotBayTrailMyrtlePark,02/05/2014 02:00:00 AM,48,-122,1,1,2
843,ElliotBayTrailMyrtlePark,02/05/2014 03:00:00 AM,48,-122,0,1,1
844,ElliotBayTrailMyrtlePark,02/05/2014 04:00:00 AM,48,-122,0,0,0
845,ElliotBayTrailMyrtlePark,02/05/2014 05:00:00 AM,48,-122,9,8,17
846,ElliotBayTrailMyrtlePark,02/05/2014 06:00:00 AM,48,-122,13,17,30
847,ElliotBayTrailMyrtlePark,02/05/2014 07:00:00 AM,48,-122,22,53,75
848,ElliotBayTrailMyrtlePark,02/05/2014 08:00:00 AM,48,-122,27,78,105
849,ElliotBayTrailMyrtlePark,02/05/2014 09:00:00 AM,48,-122,10,65,75
850,ElliotBayTrailMyrtlePark,02/05/2014 10:00:00 AM,48,-122,7,91,98
851,ElliotBayTrailMyrtlePark,02/05/2014 11:00:00 AM,48,-122,12,56,68
852,ElliotBayTrailMyrtlePark,02/05/2014 12:00:00 PM,48,-122,31,20,51
853,ElliotBayTrailMyrtlePark,02/05/2014 01:00:00 PM,48,-122,44,13,57
854,ElliotBayTrailMyrtlePark,02/05/2014 02:00:00 PM,48,-122,56,11,67
855,ElliotBayTrailMyrtlePark,02/05/2014 03:00:00 PM,48,-122,52,21,73
856,ElliotBayTrailMyrtlePark,02/05/2014 04:00:00 PM,48,-122,72,44,116
857,ElliotBayTrailMyrtlePark,02/05/2014 05:00:00 PM,48,-122,88,22,110
858,ElliotBayTrailMyrtlePark,02/05/2014 06:00:00 PM,48,-122,53,10,63
859,ElliotBayTrailMyrtlePark,02/05/2014 07:00:00 PM,48,-122,21,6,27
860,ElliotBayTrailMyrtlePark,02/05/2014 08:00:00 PM,48,-122,7,0,7
861,ElliotBayTrailMyrtlePark,02/05/2014 09:00:00 PM,48,-122,3,0,3
862,ElliotBayTrailMyrtlePark,02/05/2014 10:00:00 PM,48,-122,2,0,2
863,ElliotBayTrailMyrtlePark,02/05/2014 11:00:00 PM,48,-122,2,2,4
864,ElliotBayTrailMyrtlePark,02/06/2014 12:00:00 AM,48,-122,2,1,3
865,ElliotBayTrailMyrtlePark,02/06/2014 01:00:00 AM,48,-122,0,0,0
866,ElliotBayTrailMyrtlePark,02/06/2014 02:00:00 AM,48,-122,1,1,2
867,ElliotBayTrailMyrtlePark,02/06/2014 03:00:00 AM,48,-122,0,0,0
868,ElliotBayTrailMyrtlePark,02/06/2014 04:00:00 AM,48,-122,0,0,0
869,ElliotBayTrailMyrtlePark,02/06/2014 05:00:00 AM,48,-122,9,9,18
870,ElliotBayTrailMyrtlePark,02/06/2014 06:00:00 AM,48,-122,14,13,27
871,ElliotBayTrailMyrtlePark,02/06/2014 07:00:00 AM,48,-122,25,42,67
872,ElliotBayTrailMyrtlePark,02/06/2014 08:00:00 AM,48,-122,18,63,81
873,ElliotBayTrailMyrtlePark,02/06/2014 09:00:00 AM,48,-122,6,24,30
874,ElliotBayTrailMyrtlePark,02/06/2014 10:00:00 AM,48,-122,3,14,17
875,ElliotBayTrailMyrtlePark,02/06/2014 11:00:00 AM,48,-122,4,5,9
876,ElliotBayTrailMyrtlePark,02/06/2014 12:00:00 PM,48,-122,9,6,15
877,ElliotBayTrailMyrtlePark,02/06/2014 01:00:00 PM,48,-122,4,6,10
878,ElliotBayTrailMyrtlePark,02/06/2014 02:00:00 PM,48,-122,4,6,10
879,ElliotBayTrailMyrtlePark,02/06/2014 03:00:00 PM,48,-122,6,9,15
880,ElliotBayTrailMyrtlePark,02/06/2014 04:00:00 PM,48,-122,26,23,49
881,ElliotBayTrailMyrtlePark,02/06/2014 05:00:00 PM,48,-122,73,17,90
882,ElliotBayTrailMyrtlePark,02/06/2014 06:00:00 PM,48,-122,39,7,46
883,ElliotBayTrailMyrtlePark,02/06/2014 07:00:00 PM,48,-122,23,3,26
884,ElliotBayTrailMyrtlePark,02/06/2014 08:00:00 PM,48,-122,4,1,5
885,ElliotBayTrailMyrtlePark,02/06/2014 09:00:00 PM,48,-122,3,0,3
886,ElliotBayTrailMyrtlePark,02/06/2014 10:00:00 PM,48,-122,2,3,5
887,ElliotBayTrailMyrtlePark,02/06/2014 11:00:00 PM,48,-122,1,0,1
888,ElliotBayTrailMyrtlePark,02/07/2014 12:00:00 AM,48,-122,0,0,0
889,ElliotBayTrailMyrtlePark,02/07/2014 01:00:00 AM,48,-122,1,0,1
890,ElliotBayTrailMyrtlePark,02/07/2014 02:00:00 AM,48,-122,0,0,0
891,ElliotBayTrailMyrtlePark,02/07/2014 03:00:00 AM,48,-122,1,0,1
892,ElliotBayTrailMyrtlePark,02/07/2014 04:00:00 AM,48,-122,0,0,0
893,ElliotBayTrailMyrtlePark,02/07/2014 05:00:00 AM,48,-122,11,5,16
894,ElliotBayTrailMyrtlePark,02/07/2014 06:00:00 AM,48,-122,10,10,20
895,ElliotBayTrailMyrtlePark,02/07/2014 07:00:00 AM,48,-122,19,33,52
896,ElliotBayTrailMyrtlePark,02/07/2014 08:00:00 AM,48,-122,14,56,70
897,ElliotBayTrailMyrtlePark,02/07/2014 09:00:00 AM,48,-122,1,28,29
898,ElliotBayTrailMyrtlePark,02/07/2014 10:00:00 AM,48,-122,3,16,19
899,ElliotBayTrailMyrtlePark,02/07/2014 11:00:00 AM,48,-122,11,6,17
900,ElliotBayTrailMyrtlePark,02/07/2014 12:00:00 PM,48,-122,2,8,10
901,ElliotBayTrailMyrtlePark,02/07/2014 01:00:00 PM,48,-122,7,11,18
902,ElliotBayTrailMyrtlePark,02/07/2014 02:00:00 PM,48,-122,16,19,35
903,ElliotBayTrailMyrtlePark,02/07/2014 03:00:00 PM,48,-122,19,11,30
904,ElliotBayTrailMyrtlePark,02/07/2014 04:00:00 PM,48,-122,37,22,59
905,ElliotBayTrailMyrtlePark,02/07/2014 05:00:00 PM,48,-122,71,33,104
906,ElliotBayTrailMyrtlePark,02/07/2014 06:00:00 PM,48,-122,30,6,36
907,ElliotBayTrailMyrtlePark,02/07/2014 07:00:00 PM,48,-122,10,4,14
908,ElliotBayTrailMyrtlePark,02/07/2014 08:00:00 PM,48,-122,3,3,6
909,ElliotBayTrailMyrtlePark,02/07/2014 09:00:00 PM,48,-122,5,0,5
910,ElliotBayTrailMyrtlePark,02/07/2014 10:00:00 PM,48,-122,3,2,5
911,ElliotBayTrailMyrtlePark,02/07/2014 11:00:00 PM,48,-122,2,1,3
912,ElliotBayTrailMyrtlePark,02/08/2014 12:00:00 AM,48,-122,2,1,3
913,ElliotBayTrailMyrtlePark,02/08/2014 01:00:00 AM,48,-122,2,0,2
914,ElliotBayTrailMyrtlePark,02/08/2014 02:00:00 AM,48,-122,0,1,1
915,ElliotBayTrailMyrtlePark,02/08/2014 03:00:00 AM,48,-122,0,0,0
916,ElliotBayTrailMyrtlePark,02/08/2014 04:00:00 AM,48,-122,0,0,0
917,ElliotBayTrailMyrtlePark,02/08/2014 05:00:00 AM,48,-122,0,0,0
918,ElliotBayTrailMyrtlePark,02/08/2014 06:00:00 AM,48,-122,3,0,3
919,ElliotBayTrailMyrtlePark,02/08/2014 07:00:00 AM,48,-122,8,2,10
920,ElliotBayTrailMyrtlePark,02/08/2014 08:00:00 AM,48,-122,5,7,12
921,ElliotBayTrailMyrtlePark,02/08/2014 09:00:00 AM,48,-122,4,7,11
922,ElliotBayTrailMyrtlePark,02/08/2014 10:00:00 AM,48,-122,7,24,31
923,ElliotBayTrailMyrtlePark,02/08/2014 11:00:00 AM,48,-122,24,14,38
924,ElliotBayTrailMyrtlePark,02/08/2014 12:00:00 PM,48,-122,21,17,38
925,ElliotBayTrailMyrtlePark,02/08/2014 01:00:00 PM,48,-122,12,21,33
926,ElliotBayTrailMyrtlePark,02/08/2014 02:00:00 PM,48,-122,24,23,47
927,ElliotBayTrailMyrtlePark,02/08/2014 03:00:00 PM,48,-122,22,13,35
928,ElliotBayTrailMyrtlePark,02/08/2014 04:00:00 PM,48,-122,13,11,24
929,ElliotBayTrailMyrtlePark,02/08/2014 05:00:00 PM,48,-122,8,7,15
930,ElliotBayTrailMyrtlePark,02/08/2014 06:00:00 PM,48,-122,5,5,10
931,ElliotBayTrailMyrtlePark,02/08/2014 07:00:00 PM,48,-122,1,2,3
932,ElliotBayTrailMyrtlePark,02/08/2014 08:00:00 PM,48,-122,0,0,0
933,ElliotBayTrailMyrtlePark,02/08/2014 09:00:00 PM,48,-122,1,1,2
934,ElliotBayTrailMyrtlePark,02/08/2014 10:00:00 PM,48,-122,2,2,4
935,ElliotBayTrailMyrtlePark,02/08/2014 11:00:00 PM,48,-122,1,0,1
936,ElliotBayTrailMyrtlePark,02/09/2014 12:00:00 AM,48,-122,0,1,1
937,ElliotBayTrailMyrtlePark,02/09/2014 01:00:00 AM,48,-122,0,1,1
938,ElliotBayTrailMyrtlePark,02/09/2014 02:00:00 AM,48,-122,0,0,0
939,ElliotBayTrailMyrtlePark,02/09/2014 03:00:00 AM,48,-122,0,0,0
940,ElliotBayTrailMyrtlePark,02/09/2014 04:00:00 AM,48,-122,1,0,1
941,ElliotBayTrailMyrtlePark,02/09/2014 05:00:00 AM,48,-122,0,0,0
942,ElliotBayTrailMyrtlePark,02/09/2014 06:00:00 AM,48,-122,1,0,1
943,ElliotBayTrailMyrtlePark,02/09/2014 07:00:00 AM,48,-122,1,1,2
944,ElliotBayTrailMyrtlePark,02/09/2014 08:00:00 AM,48,-122,1,1,2
945,ElliotBayTrailMyrtlePark,02/09/2014 09:00:00 AM,48,-122,0,0,0
946,ElliotBayTrailMyrtlePark,02/09/2014 10:00:00 AM,48,-122,0,1,1
947,ElliotBayTrailMyrtlePark,02/09/2014 11:00:00 AM,48,-122,1,3,4
948,ElliotBayTrailMyrtlePark,02/09/2014 12:00:00 PM,48,-122,3,1,4
949,ElliotBayTrailMyrtlePark,02/09/2014 01:00:00 PM,48,-122,2,1,3
950,ElliotBayTrailMyrtlePark,02/09/2014 02:00:00 PM,48,-122,0,1,1
951,ElliotBayTrailMyrtlePark,02/09/2014 03:00:00 PM,48,-122,3,1,4
952,ElliotBayTrailMyrtlePark,02/09/2014 04:00:00 PM,48,-122,6,2,8
953,ElliotBayTrailMyrtlePark,02/09/2014 05:00:00 PM,48,-122,1,2,3
954,ElliotBayTrailMyrtlePark,02/09/2014 06:00:00 PM,48,-122,0,0,0
955,ElliotBayTrailMyrtlePark,02/09/2014 07:00:00 PM,48,-122,2,0,2
956,ElliotBayTrailMyrtlePark,02/09/2014 08:00:00 PM,48,-122,0,0,0
957,ElliotBayTrailMyrtlePark,02/09/2014 09:00:00 PM,48,-122,0,0,0
958,ElliotBayTrailMyrtlePark,02/09/2014 10:00:00 PM,48,-122,1,1,2
959,ElliotBayTrailMyrtlePark,02/09/2014 11:00:00 PM,48,-122,3,1,4
960,ElliotBayTrailMyrtlePark,02/10/2014 12:00:00 AM,48,-122,0,1,1
961,ElliotBayTrailMyrtlePark,02/10/2014 01:00:00 AM,48,-122,1,0,1
962,ElliotBayTrailMyrtlePark,02/10/2014 02:00:00 AM,48,-122,2,1,3
963,ElliotBayTrailMyrtlePark,02/10/2014 03:00:00 AM,48,-122,1,0,1
964,ElliotBayTrailMyrtlePark,02/10/2014 04:00:00 AM,48,-122,1,1,2
965,ElliotBayTrailMyrtlePark,02/10/2014 05:00:00 AM,48,-122,7,7,14
966,ElliotBayTrailMyrtlePark,02/10/2014 06:00:00 AM,48,-122,7,8,15
967,ElliotBayTrailMyrtlePark,02/10/2014 07:00:00 AM,48,-122,16,28,44
968,ElliotBayTrailMyrtlePark,02/10/2014 08:00:00 AM,48,-122,7,40,47
969,ElliotBayTrailMyrtlePark,02/10/2014 09:00:00 AM,48,-122,4,26,30
970,ElliotBayTrailMyrtlePark,02/10/2014 10:00:00 AM,48,-122,2,8,10
971,ElliotBayTrailMyrtlePark,02/10/2014 11:00:00 AM,48,-122,3,2,5
972,ElliotBayTrailMyrtlePark,02/10/2014 12:00:00 PM,48,-122,8,4,12
973,ElliotBayTrailMyrtlePark,02/10/2014 01:00:00 PM,48,-122,1,7,8
974,ElliotBayTrailMyrtlePark,02/10/2014 02:00:00 PM,48,-122,8,5,13
975,ElliotBayTrailMyrtlePark,02/10/2014 03:00:00 PM,48,-122,6,8,14
976,ElliotBayTrailMyrtlePark,02/10/2014 04:00:00 PM,48,-122,18,19,37
977,ElliotBayTrailMyrtlePark,02/10/2014 05:00:00 PM,48,-122,52,16,68
978,ElliotBayTrailMyrtlePark,02/10/2014 06:00:00 PM,48,-122,39,8,47
979,ElliotBayTrailMyrtlePark,02/10/2014 07:00:00 PM,48,-122,13,2,15
980,ElliotBayTrailMyrtlePark,02/10/2014 08:00:00 PM,48,-122,2,0,2
981,ElliotBayTrailMyrtlePark,02/10/2014 09:00:00 PM,48,-122,1,0,1
982,ElliotBayTrailMyrtlePark,02/10/2014 10:00:00 PM,48,-122,0,0,0
983,ElliotBayTrailMyrtlePark,02/10/2014 11:00:00 PM,48,-122,2,2,4
984,ElliotBayTrailMyrtlePark,02/11/2014 12:00:00 AM,48,-122,2,2,4
985,ElliotBayTrailMyrtlePark,02/11/2014 01:00:00 AM,48,-122,0,0,0
986,ElliotBayTrailMyrtlePark,02/11/2014 02:00:00 AM,48,-122,1,1,2
987,ElliotBayTrailMyrtlePark,02/11/2014 03:00:00 AM,48,-122,1,1,2
988,ElliotBayTrailMyrtlePark,02/11/2014 04:00:00 AM,48,-122,0,0,0
989,ElliotBayTrailMyrtlePark,02/11/2014 05:00:00 AM,48,-122,13,10,23
990,ElliotBayTrailMyrtlePark,02/11/2014 06:00:00 AM,48,-122,8,21,29
991,ElliotBayTrailMyrtlePark,02/11/2014 07:00:00 AM,48,-122,34,70,104
992,ElliotBayTrailMyrtlePark,02/11/2014 08:00:00 AM,48,-122,24,80,104
993,ElliotBayTrailMyrtlePark,02/11/2014 09:00:00 AM,48,-122,7,33,40
994,ElliotBayTrailMyrtlePark,02/11/2014 10:00:00 AM,48,-122,5,7,12
995,ElliotBayTrailMyrtlePark,02/11/2014 11:00:00 AM,48,-122,9,7,16
996,ElliotBayTrailMyrtlePark,02/11/2014 12:00:00 PM,48,-122,7,9,16
997,ElliotBayTrailMyrtlePark,02/11/2014 01:00:00 PM,48,-122,4,9,13
998,ElliotBayTrailMyrtlePark,02/11/2014 02:00:00 PM,48,-122,9,15,24
999,ElliotBayTrailMyrtlePark,02/11/2014 03:00:00 PM,48,-122,21,12,33
1000,ElliotBayTrailMyrtlePark,02/11/2014 04:00:00 PM,48,-122,37,20,57
1001,ElliotBayTrailMyrtlePark,02/11/2014 05:00:00 PM,48,-122,85,30,115
1002,ElliotBayTrailMyrtlePark,02/11/2014 06:00:00 PM,48,-122,51,6,57
1003,ElliotBayTrailMyrtlePark,02/11/2014 07:00:00 PM,48,-122,19,6,25
1004,ElliotBayTrailMyrtlePark,02/11/2014 08:00:00 PM,48,-122,3,1,4
1005,ElliotBayTrailMyrtlePark,02/11/2014 09:00:00 PM,48,-122,1,1,2
1006,ElliotBayTrailMyrtlePark,02/11/2014 10:00:00 PM,48,-122,1,0,1
1007,ElliotBayTrailMyrtlePark,02/11/2014 11:00:00 PM,48,-122,1,0,1
1008,ElliotBayTrailMyrtlePark,02/12/2014 12:00:00 AM,48,-122,2,0,2
1009,ElliotBayTrailMyrtlePark,02/12/2014 01:00:00 AM,48,-122,1,0,1
1010,ElliotBayTrailMyrtlePark,02/12/2014 02:00:00 AM,48,-122,2,1,3
1011,ElliotBayTrailMyrtlePark,02/12/2014 03:00:00 AM,48,-122,1,1,2
1012,ElliotBayTrailMyrtlePark,02/12/2014 04:00:00 AM,48,-122,0,0,0
1013,ElliotBayTrailMyrtlePark,02/12/2014 05:00:00 AM,48,-122,7,7,14
1014,ElliotBayTrailMyrtlePark,02/12/2014 06:00:00 AM,48,-122,25,15,40
1015,ElliotBayTrailMyrtlePark,02/12/2014 07:00:00 AM,48,-122,19,38,57
1016,ElliotBayTrailMyrtlePark,02/12/2014 08:00:00 AM,48,-122,26,60,86
1017,ElliotBayTrailMyrtlePark,02/12/2014 09:00:00 AM,48,-122,8,35,43
1018,ElliotBayTrailMyrtlePark,02/12/2014 10:00:00 AM,48,-122,5,14,19
1019,ElliotBayTrailMyrtlePark,02/12/2014 11:00:00 AM,48,-122,11,9,20
1020,ElliotBayTrailMyrtlePark,02/12/2014 12:00:00 PM,48,-122,17,11,28
1021,ElliotBayTrailMyrtlePark,02/12/2014 01:00:00 PM,48,-122,11,15,26
1022,ElliotBayTrailMyrtlePark,02/12/2014 02:00:00 PM,48,-122,9,15,24
1023,ElliotBayTrailMyrtlePark,02/12/2014 03:00:00 PM,48,-122,27,17,44
1024,ElliotBayTrailMyrtlePark,02/12/2014 04:00:00 PM,48,-122,51,33,84
1025,ElliotBayTrailMyrtlePark,02/12/2014 05:00:00 PM,48,-122,80,42,122
1026,ElliotBayTrailMyrtlePark,02/12/2014 06:00:00 PM,48,-122,56,16,72
1027,ElliotBayTrailMyrtlePark,02/12/2014 07:00:00 PM,48,-122,25,9,34
1028,ElliotBayTrailMyrtlePark,02/12/2014 08:00:00 PM,48,-122,8,3,11
1029,ElliotBayTrailMyrtlePark,02/12/2014 09:00:00 PM,48,-122,2,1,3
1030,ElliotBayTrailMyrtlePark,02/12/2014 10:00:00 PM,48,-122,0,0,0
1031,ElliotBayTrailMyrtlePark,02/12/2014 11:00:00 PM,48,-122,1,0,1
1032,ElliotBayTrailMyrtlePark,02/13/2014 12:00:00 AM,48,-122,0,1,1
1033,ElliotBayTrailMyrtlePark,02/13/2014 01:00:00 AM,48,-122,1,0,1
1034,ElliotBayTrailMyrtlePark,02/13/2014 02:00:00 AM,48,-122,1,1,2
1035,ElliotBayTrailMyrtlePark,02/13/2014 03:00:00 AM,48,-122,1,1,2
1036,ElliotBayTrailMyrtlePark,02/13/2014 04:00:00 AM,48,-122,0,0,0
1037,ElliotBayTrailMyrtlePark,02/13/2014 05:00:00 AM,48,-122,14,7,21
1038,ElliotBayTrailMyrtlePark,02/13/2014 06:00:00 AM,48,-122,14,17,31
1039,ElliotBayTrailMyrtlePark,02/13/2014 07:00:00 AM,48,-122,21,52,73
1040,ElliotBayTrailMyrtlePark,02/13/2014 08:00:00 AM,48,-122,28,89,117
1041,ElliotBayTrailMyrtlePark,02/13/2014 09:00:00 AM,48,-122,13,45,58
1042,ElliotBayTrailMyrtlePark,02/13/2014 10:00:00 AM,48,-122,7,14,21
1043,ElliotBayTrailMyrtlePark,02/13/2014 11:00:00 AM,48,-122,15,4,19
1044,ElliotBayTrailMyrtlePark,02/13/2014 12:00:00 PM,48,-122,13,8,21
1045,ElliotBayTrailMyrtlePark,02/13/2014 01:00:00 PM,48,-122,6,12,18
1046,ElliotBayTrailMyrtlePark,02/13/2014 02:00:00 PM,48,-122,26,22,48
1047,ElliotBayTrailMyrtlePark,02/13/2014 03:00:00 PM,48,-122,27,27,54
1048,ElliotBayTrailMyrtlePark,02/13/2014 04:00:00 PM,48,-122,46,37,83
1049,ElliotBayTrailMyrtlePark,02/13/2014 05:00:00 PM,48,-122,113,39,152
1050,ElliotBayTrailMyrtlePark,02/13/2014 06:00:00 PM,48,-122,55,15,70
1051,ElliotBayTrailMyrtlePark,02/13/2014 07:00:00 PM,48,-122,23,5,28
1052,ElliotBayTrailMyrtlePark,02/13/2014 08:00:00 PM,48,-122,4,1,5
1053,ElliotBayTrailMyrtlePark,02/13/2014 09:00:00 PM,48,-122,3,3,6
1054,ElliotBayTrailMyrtlePark,02/13/2014 10:00:00 PM,48,-122,2,2,4
1055,ElliotBayTrailMyrtlePark,02/13/2014 11:00:00 PM,48,-122,1,0,1
1056,ElliotBayTrailMyrtlePark,02/14/2014 12:00:00 AM,48,-122,1,0,1
1057,ElliotBayTrailMyrtlePark,02/14/2014 01:00:00 AM,48,-122,0,1,1
1058,ElliotBayTrailMyrtlePark,02/14/2014 02:00:00 AM,48,-122,1,0,1
1059,ElliotBayTrailMyrtlePark,02/14/2014 03:00:00 AM,48,-122,0,0,0
1060,ElliotBayTrailMyrtlePark,02/14/2014 04:00:00 AM,48,-122,0,0,0
1061,ElliotBayTrailMyrtlePark,02/14/2014 05:00:00 AM,48,-122,9,9,18
1062,ElliotBayTrailMyrtlePark,02/14/2014 06:00:00 AM,48,-122,17,13,30
1063,ElliotBayTrailMyrtlePark,02/14/2014 07:00:00 AM,48,-122,15,40,55
1064,ElliotBayTrailMyrtlePark,02/14/2014 08:00:00 AM,48,-122,14,55,69
1065,ElliotBayTrailMyrtlePark,02/14/2014 09:00:00 AM,48,-122,6,23,29
1066,ElliotBayTrailMyrtlePark,02/14/2014 10:00:00 AM,48,-122,3,10,13
1067,ElliotBayTrailMyrtlePark,02/14/2014 11:00:00 AM,48,-122,4,1,5
1068,ElliotBayTrailMyrtlePark,02/14/2014 12:00:00 PM,48,-122,5,3,8
1069,ElliotBayTrailMyrtlePark,02/14/2014 01:00:00 PM,48,-122,5,1,6
1070,ElliotBayTrailMyrtlePark,02/14/2014 02:00:00 PM,48,-122,16,9,25
1071,ElliotBayTrailMyrtlePark,02/14/2014 03:00:00 PM,48,-122,19,15,34
1072,ElliotBayTrailMyrtlePark,02/14/2014 04:00:00 PM,48,-122,48,17,65
1073,ElliotBayTrailMyrtlePark,02/14/2014 05:00:00 PM,48,-122,73,25,98
1074,ElliotBayTrailMyrtlePark,02/14/2014 06:00:00 PM,48,-122,34,11,45
1075,ElliotBayTrailMyrtlePark,02/14/2014 07:00:00 PM,48,-122,7,0,7
1076,ElliotBayTrailMyrtlePark,02/14/2014 08:00:00 PM,48,-122,0,0,0
1077,ElliotBayTrailMyrtlePark,02/14/2014 09:00:00 PM,48,-122,5,5,10
1078,ElliotBayTrailMyrtlePark,02/14/2014 10:00:00 PM,48,-122,1,0,1
1079,ElliotBayTrailMyrtlePark,02/14/2014 11:00:00 PM,48,-122,0,2,2
1080,ElliotBayTrailMyrtlePark,02/15/2014 12:00:00 AM,48,-122,5,0,5
1081,ElliotBayTrailMyrtlePark,02/15/2014 01:00:00 AM,48,-122,0,1,1
1082,ElliotBayTrailMyrtlePark,02/15/2014 02:00:00 AM,48,-122,0,0,0
1083,ElliotBayTrailMyrtlePark,02/15/2014 03:00:00 AM,48,-122,0,0,0
1084,ElliotBayTrailMyrtlePark,02/15/2014 04:00:00 AM,48,-122,1,0,1
1085,ElliotBayTrailMyrtlePark,02/15/2014 05:00:00 AM,48,-122,0,1,1
1086,ElliotBayTrailMyrtlePark,02/15/2014 06:00:00 AM,48,-122,1,1,2
1087,ElliotBayTrailMyrtlePark,02/15/2014 07:00:00 AM,48,-122,6,6,12
1088,ElliotBayTrailMyrtlePark,02/15/2014 08:00:00 AM,48,-122,10,6,16
1089,ElliotBayTrailMyrtlePark,02/15/2014 09:00:00 AM,48,-122,9,11,20
1090,ElliotBayTrailMyrtlePark,02/15/2014 10:00:00 AM,48,-122,12,17,29
1091,ElliotBayTrailMyrtlePark,02/15/2014 11:00:00 AM,48,-122,15,13,28
1092,ElliotBayTrailMyrtlePark,02/15/2014 12:00:00 PM,48,-122,9,29,38
1093,ElliotBayTrailMyrtlePark,02/15/2014 01:00:00 PM,48,-122,7,6,13
1094,ElliotBayTrailMyrtlePark,02/15/2014 02:00:00 PM,48,-122,2,5,7
1095,ElliotBayTrailMyrtlePark,02/15/2014 03:00:00 PM,48,-122,4,2,6
1096,ElliotBayTrailMyrtlePark,02/15/2014 04:00:00 PM,48,-122,2,1,3
1097,ElliotBayTrailMyrtlePark,02/15/2014 05:00:00 PM,48,-122,8,2,10
1098,ElliotBayTrailMyrtlePark,02/15/2014 06:00:00 PM,48,-122,6,2,8
1099,ElliotBayTrailMyrtlePark,02/15/2014 07:00:00 PM,48,-122,0,0,0
1100,ElliotBayTrailMyrtlePark,02/15/2014 08:00:00 PM,48,-122,0,0,0
1101,ElliotBayTrailMyrtlePark,02/15/2014 09:00:00 PM,48,-122,0,0,0
1102,ElliotBayTrailMyrtlePark,02/15/2014 10:00:00 PM,48,-122,2,0,2
1103,ElliotBayTrailMyrtlePark,02/15/2014 11:00:00 PM,48,-122,0,0,0
1104,ElliotBayTrailMyrtlePark,02/16/2014 12:00:00 AM,48,-122,1,1,2
1105,ElliotBayTrailMyrtlePark,02/16/2014 01:00:00 AM,48,-122,3,0,3
1106,ElliotBayTrailMyrtlePark,02/16/2014 02:00:00 AM,48,-122,0,0,0
1107,ElliotBayTrailMyrtlePark,02/16/2014 03:00:00 AM,48,-122,1,1,2
1108,ElliotBayTrailMyrtlePark,02/16/2014 04:00:00 AM,48,-122,1,2,3
1109,ElliotBayTrailMyrtlePark,02/16/2014 05:00:00 AM,48,-122,1,0,1
1110,ElliotBayTrailMyrtlePark,02/16/2014 06:00:00 AM,48,-122,2,4,6
1111,ElliotBayTrailMyrtlePark,02/16/2014 07:00:00 AM,48,-122,2,3,5
1112,ElliotBayTrailMyrtlePark,02/16/2014 08:00:00 AM,48,-122,5,4,9
1113,ElliotBayTrailMyrtlePark,02/16/2014 09:00:00 AM,48,-122,12,9,21
1114,ElliotBayTrailMyrtlePark,02/16/2014 10:00:00 AM,48,-122,8,19,27
1115,ElliotBayTrailMyrtlePark,02/16/2014 11:00:00 AM,48,-122,9,10,19
1116,ElliotBayTrailMyrtlePark,02/16/2014 12:00:00 PM,48,-122,7,4,11
1117,ElliotBayTrailMyrtlePark,02/16/2014 01:00:00 PM,48,-122,4,6,10
1118,ElliotBayTrailMyrtlePark,02/16/2014 02:00:00 PM,48,-122,7,10,17
1119,ElliotBayTrailMyrtlePark,02/16/2014 03:00:00 PM,48,-122,6,3,9
1120,ElliotBayTrailMyrtlePark,02/16/2014 04:00:00 PM,48,-122,0,5,5
1121,ElliotBayTrailMyrtlePark,02/16/2014 05:00:00 PM,48,-122,2,1,3
1122,ElliotBayTrailMyrtlePark,02/16/2014 06:00:00 PM,48,-122,2,1,3
1123,ElliotBayTrailMyrtlePark,02/16/2014 07:00:00 PM,48,-122,2,1,3
1124,ElliotBayTrailMyrtlePark,02/16/2014 08:00:00 PM,48,-122,1,0,1
1125,ElliotBayTrailMyrtlePark,02/16/2014 09:00:00 PM,48,-122,1,0,1
1126,ElliotBayTrailMyrtlePark,02/16/2014 10:00:00 PM,48,-122,3,0,3
1127,ElliotBayTrailMyrtlePark,02/16/2014 11:00:00 PM,48,-122,1,1,2
1128,ElliotBayTrailMyrtlePark,02/17/2014 12:00:00 AM,48,-122,0,0,0
1129,ElliotBayTrailMyrtlePark,02/17/2014 01:00:00 AM,48,-122,1,1,2
1130,ElliotBayTrailMyrtlePark,02/17/2014 02:00:00 AM,48,-122,2,1,3
1131,ElliotBayTrailMyrtlePark,02/17/2014 03:00:00 AM,48,-122,0,0,0
1132,ElliotBayTrailMyrtlePark,02/17/2014 04:00:00 AM,48,-122,0,2,2
1133,ElliotBayTrailMyrtlePark,02/17/2014 05:00:00 AM,48,-122,7,2,9
1134,ElliotBayTrailMyrtlePark,02/17/2014 06:00:00 AM,48,-122,5,5,10
1135,ElliotBayTrailMyrtlePark,02/17/2014 07:00:00 AM,48,-122,11,17,28
1136,ElliotBayTrailMyrtlePark,02/17/2014 08:00:00 AM,48,-122,4,18,22
1137,ElliotBayTrailMyrtlePark,02/17/2014 09:00:00 AM,48,-122,2,14,16
1138,ElliotBayTrailMyrtlePark,02/17/2014 10:00:00 AM,48,-122,7,11,18
1139,ElliotBayTrailMyrtlePark,02/17/2014 11:00:00 AM,48,-122,9,15,24
1140,ElliotBayTrailMyrtlePark,02/17/2014 12:00:00 PM,48,-122,9,3,12
1141,ElliotBayTrailMyrtlePark,02/17/2014 01:00:00 PM,48,-122,5,11,16
1142,ElliotBayTrailMyrtlePark,02/17/2014 02:00:00 PM,48,-122,13,12,25
1143,ElliotBayTrailMyrtlePark,02/17/2014 03:00:00 PM,48,-122,19,17,36
1144,ElliotBayTrailMyrtlePark,02/17/2014 04:00:00 PM,48,-122,19,23,42
1145,ElliotBayTrailMyrtlePark,02/17/2014 05:00:00 PM,48,-122,21,10,31
1146,ElliotBayTrailMyrtlePark,02/17/2014 06:00:00 PM,48,-122,24,4,28
1147,ElliotBayTrailMyrtlePark,02/17/2014 07:00:00 PM,48,-122,6,3,9
1148,ElliotBayTrailMyrtlePark,02/17/2014 08:00:00 PM,48,-122,4,0,4
1149,ElliotBayTrailMyrtlePark,02/17/2014 09:00:00 PM,48,-122,0,0,0
1150,ElliotBayTrailMyrtlePark,02/17/2014 10:00:00 PM,48,-122,1,0,1
1151,ElliotBayTrailMyrtlePark,02/17/2014 11:00:00 PM,48,-122,0,0,0
1152,ElliotBayTrailMyrtlePark,02/18/2014 12:00:00 AM,48,-122,3,2,5
1153,ElliotBayTrailMyrtlePark,02/18/2014 01:00:00 AM,48,-122,1,0,1
1154,ElliotBayTrailMyrtlePark,02/18/2014 02:00:00 AM,48,-122,1,2,3
1155,ElliotBayTrailMyrtlePark,02/18/2014 03:00:00 AM,48,-122,1,1,2
1156,ElliotBayTrailMyrtlePark,02/18/2014 04:00:00 AM,48,-122,0,0,0
1157,ElliotBayTrailMyrtlePark,02/18/2014 05:00:00 AM,48,-122,9,7,16
1158,ElliotBayTrailMyrtlePark,02/18/2014 06:00:00 AM,48,-122,12,12,24
1159,ElliotBayTrailMyrtlePark,02/18/2014 07:00:00 AM,48,-122,27,46,73
1160,ElliotBayTrailMyrtlePark,02/18/2014 08:00:00 AM,48,-122,17,49,66
1161,ElliotBayTrailMyrtlePark,02/18/2014 09:00:00 AM,48,-122,7,25,32
1162,ElliotBayTrailMyrtlePark,02/18/2014 10:00:00 AM,48,-122,3,1,4
1163,ElliotBayTrailMyrtlePark,02/18/2014 11:00:00 AM,48,-122,0,2,2
1164,ElliotBayTrailMyrtlePark,02/18/2014 12:00:00 PM,48,-122,3,1,4
1165,ElliotBayTrailMyrtlePark,02/18/2014 01:00:00 PM,48,-122,1,4,5
1166,ElliotBayTrailMyrtlePark,02/18/2014 02:00:00 PM,48,-122,5,7,12
1167,ElliotBayTrailMyrtlePark,02/18/2014 03:00:00 PM,48,-122,15,10,25
1168,ElliotBayTrailMyrtlePark,02/18/2014 04:00:00 PM,48,-122,30,20,50
1169,ElliotBayTrailMyrtlePark,02/18/2014 05:00:00 PM,48,-122,69,26,95
1170,ElliotBayTrailMyrtlePark,02/18/2014 06:00:00 PM,48,-122,30,12,42
1171,ElliotBayTrailMyrtlePark,02/18/2014 07:00:00 PM,48,-122,13,3,16
1172,ElliotBayTrailMyrtlePark,02/18/2014 08:00:00 PM,48,-122,4,1,5
1173,ElliotBayTrailMyrtlePark,02/18/2014 09:00:00 PM,48,-122,2,0,2
1174,ElliotBayTrailMyrtlePark,02/18/2014 10:00:00 PM,48,-122,2,0,2
1175,ElliotBayTrailMyrtlePark,02/18/2014 11:00:00 PM,48,-122,1,1,2
1176,ElliotBayTrailMyrtlePark,02/19/2014 12:00:00 AM,48,-122,2,2,4
1177,ElliotBayTrailMyrtlePark,02/19/2014 01:00:00 AM,48,-122,0,0,0
1178,ElliotBayTrailMyrtlePark,02/19/2014 02:00:00 AM,48,-122,2,1,3
1179,ElliotBayTrailMyrtlePark,02/19/2014 03:00:00 AM,48,-122,0,0,0
1180,ElliotBayTrailMyrtlePark,02/19/2014 04:00:00 AM,48,-122,0,0,0
1181,ElliotBayTrailMyrtlePark,02/19/2014 05:00:00 AM,48,-122,10,7,17
1182,ElliotBayTrailMyrtlePark,02/19/2014 06:00:00 AM,48,-122,13,18,31
1183,ElliotBayTrailMyrtlePark,02/19/2014 07:00:00 AM,48,-122,34,64,98
1184,ElliotBayTrailMyrtlePark,02/19/2014 08:00:00 AM,48,-122,30,63,93
1185,ElliotBayTrailMyrtlePark,02/19/2014 09:00:00 AM,48,-122,8,40,48
1186,ElliotBayTrailMyrtlePark,02/19/2014 10:00:00 AM,48,-122,8,17,25
1187,ElliotBayTrailMyrtlePark,02/19/2014 11:00:00 AM,48,-122,12,3,15
1188,ElliotBayTrailMyrtlePark,02/19/2014 12:00:00 PM,48,-122,13,17,30
1189,ElliotBayTrailMyrtlePark,02/19/2014 01:00:00 PM,48,-122,10,4,14
1190,ElliotBayTrailMyrtlePark,02/19/2014 02:00:00 PM,48,-122,12,16,28
1191,ElliotBayTrailMyrtlePark,02/19/2014 03:00:00 PM,48,-122,25,19,44
1192,ElliotBayTrailMyrtlePark,02/19/2014 04:00:00 PM,48,-122,57,36,93
1193,ElliotBayTrailMyrtlePark,02/19/2014 05:00:00 PM,48,-122,103,35,138
1194,ElliotBayTrailMyrtlePark,02/19/2014 06:00:00 PM,48,-122,53,11,64
1195,ElliotBayTrailMyrtlePark,02/19/2014 07:00:00 PM,48,-122,19,4,23
1196,ElliotBayTrailMyrtlePark,02/19/2014 08:00:00 PM,48,-122,5,0,5
1197,ElliotBayTrailMyrtlePark,02/19/2014 09:00:00 PM,48,-122,0,0,0
1198,ElliotBayTrailMyrtlePark,02/19/2014 10:00:00 PM,48,-122,1,1,2
1199,ElliotBayTrailMyrtlePark,02/19/2014 11:00:00 PM,48,-122,1,1,2
1200,ElliotBayTrailMyrtlePark,02/20/2014 12:00:00 AM,48,-122,2,2,4
1201,ElliotBayTrailMyrtlePark,02/20/2014 01:00:00 AM,48,-122,3,0,3
1202,ElliotBayTrailMyrtlePark,02/20/2014 02:00:00 AM,48,-122,1,0,1
1203,ElliotBayTrailMyrtlePark,02/20/2014 03:00:00 AM,48,-122,1,1,2
1204,ElliotBayTrailMyrtlePark,02/20/2014 04:00:00 AM,48,-122,0,0,0
1205,ElliotBayTrailMyrtlePark,02/20/2014 05:00:00 AM,48,-122,8,8,16
1206,ElliotBayTrailMyrtlePark,02/20/2014 06:00:00 AM,48,-122,18,16,34
1207,ElliotBayTrailMyrtlePark,02/20/2014 07:00:00 AM,48,-122,22,51,73
1208,ElliotBayTrailMyrtlePark,02/20/2014 08:00:00 AM,48,-122,19,73,92
1209,ElliotBayTrailMyrtlePark,02/20/2014 09:00:00 AM,48,-122,11,32,43
1210,ElliotBayTrailMyrtlePark,02/20/2014 10:00:00 AM,48,-122,7,14,21
1211,ElliotBayTrailMyrtlePark,02/20/2014 11:00:00 AM,48,-122,7,5,12
1212,ElliotBayTrailMyrtlePark,02/20/2014 12:00:00 PM,48,-122,7,4,11
1213,ElliotBayTrailMyrtlePark,02/20/2014 01:00:00 PM,48,-122,5,5,10
1214,ElliotBayTrailMyrtlePark,02/20/2014 02:00:00 PM,48,-122,26,26,52
1215,ElliotBayTrailMyrtlePark,02/20/2014 03:00:00 PM,48,-122,33,19,52
1216,ElliotBayTrailMyrtlePark,02/20/2014 04:00:00 PM,48,-122,50,34,84
1217,ElliotBayTrailMyrtlePark,02/20/2014 05:00:00 PM,48,-122,88,30,118
1218,ElliotBayTrailMyrtlePark,02/20/2014 06:00:00 PM,48,-122,53,13,66
1219,ElliotBayTrailMyrtlePark,02/20/2014 07:00:00 PM,48,-122,21,6,27
1220,ElliotBayTrailMyrtlePark,02/20/2014 08:00:00 PM,48,-122,4,0,4
1221,ElliotBayTrailMyrtlePark,02/20/2014 09:00:00 PM,48,-122,1,1,2
1222,ElliotBayTrailMyrtlePark,02/20/2014 10:00:00 PM,48,-122,5,0,5
1223,ElliotBayTrailMyrtlePark,02/20/2014 11:00:00 PM,48,-122,4,0,4
1224,ElliotBayTrailMyrtlePark,02/21/2014 12:00:00 AM,48,-122,1,0,1
1225,ElliotBayTrailMyrtlePark,02/21/2014 01:00:00 AM,48,-122,2,1,3
1226,ElliotBayTrailMyrtlePark,02/21/2014 02:00:00 AM,48,-122,0,0,0
1227,ElliotBayTrailMyrtlePark,02/21/2014 03:00:00 AM,48,-122,0,0,0
1228,ElliotBayTrailMyrtlePark,02/21/2014 04:00:00 AM,48,-122,0,0,0
1229,ElliotBayTrailMyrtlePark,02/21/2014 05:00:00 AM,48,-122,6,10,16
1230,ElliotBayTrailMyrtlePark,02/21/2014 06:00:00 AM,48,-122,10,19,29
1231,ElliotBayTrailMyrtlePark,02/21/2014 07:00:00 AM,48,-122,25,45,70
1232,ElliotBayTrailMyrtlePark,02/21/2014 08:00:00 AM,48,-122,17,78,95
1233,ElliotBayTrailMyrtlePark,02/21/2014 09:00:00 AM,48,-122,11,21,32
1234,ElliotBayTrailMyrtlePark,02/21/2014 10:00:00 AM,48,-122,3,12,15
1235,ElliotBayTrailMyrtlePark,02/21/2014 11:00:00 AM,48,-122,13,4,17
1236,ElliotBayTrailMyrtlePark,02/21/2014 12:00:00 PM,48,-122,5,6,11
1237,ElliotBayTrailMyrtlePark,02/21/2014 01:00:00 PM,48,-122,17,4,21
1238,ElliotBayTrailMyrtlePark,02/21/2014 02:00:00 PM,48,-122,11,8,19
1239,ElliotBayTrailMyrtlePark,02/21/2014 03:00:00 PM,48,-122,11,11,22
1240,ElliotBayTrailMyrtlePark,02/21/2014 04:00:00 PM,48,-122,41,23,64
1241,ElliotBayTrailMyrtlePark,02/21/2014 05:00:00 PM,48,-122,77,27,104
1242,ElliotBayTrailMyrtlePark,02/21/2014 06:00:00 PM,48,-122,43,12,55
1243,ElliotBayTrailMyrtlePark,02/21/2014 07:00:00 PM,48,-122,11,2,13
1244,ElliotBayTrailMyrtlePark,02/21/2014 08:00:00 PM,48,-122,1,4,5
1245,ElliotBayTrailMyrtlePark,02/21/2014 09:00:00 PM,48,-122,2,1,3
1246,ElliotBayTrailMyrtlePark,02/21/2014 10:00:00 PM,48,-122,3,0,3
1247,ElliotBayTrailMyrtlePark,02/21/2014 11:00:00 PM,48,-122,4,1,5
1248,ElliotBayTrailMyrtlePark,02/22/2014 12:00:00 AM,48,-122,1,0,1
1249,ElliotBayTrailMyrtlePark,02/22/2014 01:00:00 AM,48,-122,0,0,0
1250,ElliotBayTrailMyrtlePark,02/22/2014 02:00:00 AM,48,-122,0,0,0
1251,ElliotBayTrailMyrtlePark,02/22/2014 03:00:00 AM,48,-122,0,0,0
1252,ElliotBayTrailMyrtlePark,02/22/2014 04:00:00 AM,48,-122,0,0,0
1253,ElliotBayTrailMyrtlePark,02/22/2014 05:00:00 AM,48,-122,0,0,0
1254,ElliotBayTrailMyrtlePark,02/22/2014 06:00:00 AM,48,-122,2,4,6
1255,ElliotBayTrailMyrtlePark,02/22/2014 07:00:00 AM,48,-122,4,4,8
1256,ElliotBayTrailMyrtlePark,02/22/2014 08:00:00 AM,48,-122,4,6,10
1257,ElliotBayTrailMyrtlePark,02/22/2014 09:00:00 AM,48,-122,4,2,6
1258,ElliotBayTrailMyrtlePark,02/22/2014 10:00:00 AM,48,-122,7,8,15
1259,ElliotBayTrailMyrtlePark,02/22/2014 11:00:00 AM,48,-122,10,4,14
1260,ElliotBayTrailMyrtlePark,02/22/2014 12:00:00 PM,48,-122,7,10,17
1261,ElliotBayTrailMyrtlePark,02/22/2014 01:00:00 PM,48,-122,5,11,16
1262,ElliotBayTrailMyrtlePark,02/22/2014 02:00:00 PM,48,-122,6,3,9
1263,ElliotBayTrailMyrtlePark,02/22/2014 03:00:00 PM,48,-122,15,16,31
1264,ElliotBayTrailMyrtlePark,02/22/2014 04:00:00 PM,48,-122,14,10,24
1265,ElliotBayTrailMyrtlePark,02/22/2014 05:00:00 PM,48,-122,4,6,10
1266,ElliotBayTrailMyrtlePark,02/22/2014 06:00:00 PM,48,-122,4,1,5
1267,ElliotBayTrailMyrtlePark,02/22/2014 07:00:00 PM,48,-122,3,0,3
1268,ElliotBayTrailMyrtlePark,02/22/2014 08:00:00 PM,48,-122,1,0,1
1269,ElliotBayTrailMyrtlePark,02/22/2014 09:00:00 PM,48,-122,3,0,3
1270,ElliotBayTrailMyrtlePark,02/22/2014 10:00:00 PM,48,-122,2,0,2
1271,ElliotBayTrailMyrtlePark,02/22/2014 11:00:00 PM,48,-122,0,0,0
1272,ElliotBayTrailMyrtlePark,02/23/2014 12:00:00 AM,48,-122,0,2,2
1273,ElliotBayTrailMyrtlePark,02/23/2014 01:00:00 AM,48,-122,0,0,0
1274,ElliotBayTrailMyrtlePark,02/23/2014 02:00:00 AM,48,-122,1,0,1
1275,ElliotBayTrailMyrtlePark,02/23/2014 03:00:00 AM,48,-122,0,0,0
1276,ElliotBayTrailMyrtlePark,02/23/2014 04:00:00 AM,48,-122,0,0,0
1277,ElliotBayTrailMyrtlePark,02/23/2014 05:00:00 AM,48,-122,0,1,1
1278,ElliotBayTrailMyrtlePark,02/23/2014 06:00:00 AM,48,-122,0,10,10
1279,ElliotBayTrailMyrtlePark,02/23/2014 07:00:00 AM,48,-122,3,49,52
1280,ElliotBayTrailMyrtlePark,02/23/2014 08:00:00 AM,48,-122,1,57,58
1281,ElliotBayTrailMyrtlePark,02/23/2014 09:00:00 AM,48,-122,7,30,37
1282,ElliotBayTrailMyrtlePark,02/23/2014 10:00:00 AM,48,-122,17,20,37
1283,ElliotBayTrailMyrtlePark,02/23/2014 11:00:00 AM,48,-122,6,16,22
1284,ElliotBayTrailMyrtlePark,02/23/2014 12:00:00 PM,48,-122,37,18,55
1285,ElliotBayTrailMyrtlePark,02/23/2014 01:00:00 PM,48,-122,72,9,81
1286,ElliotBayTrailMyrtlePark,02/23/2014 02:00:00 PM,48,-122,12,5,17
1287,ElliotBayTrailMyrtlePark,02/23/2014 03:00:00 PM,48,-122,53,5,58
1288,ElliotBayTrailMyrtlePark,02/23/2014 04:00:00 PM,48,-122,17,4,21
1289,ElliotBayTrailMyrtlePark,02/23/2014 05:00:00 PM,48,-122,9,5,14
1290,ElliotBayTrailMyrtlePark,02/23/2014 06:00:00 PM,48,-122,6,1,7
1291,ElliotBayTrailMyrtlePark,02/23/2014 07:00:00 PM,48,-122,2,2,4
1292,ElliotBayTrailMyrtlePark,02/23/2014 08:00:00 PM,48,-122,2,1,3
1293,ElliotBayTrailMyrtlePark,02/23/2014 09:00:00 PM,48,-122,2,0,2
1294,ElliotBayTrailMyrtlePark,02/23/2014 10:00:00 PM,48,-122,1,0,1
1295,ElliotBayTrailMyrtlePark,02/23/2014 11:00:00 PM,48,-122,1,1,2
1296,ElliotBayTrailMyrtlePark,02/24/2014 12:00:00 AM,48,-122,0,0,0
1297,ElliotBayTrailMyrtlePark,02/24/2014 01:00:00 AM,48,-122,0,0,0
1298,ElliotBayTrailMyrtlePark,02/24/2014 02:00:00 AM,48,-122,1,1,2
1299,ElliotBayTrailMyrtlePark,02/24/2014 03:00:00 AM,48,-122,0,0,0
1300,ElliotBayTrailMyrtlePark,02/24/2014 04:00:00 AM,48,-122,1,1,2
1301,ElliotBayTrailMyrtlePark,02/24/2014 05:00:00 AM,48,-122,8,8,16
1302,ElliotBayTrailMyrtlePark,02/24/2014 06:00:00 AM,48,-122,12,15,27
1303,ElliotBayTrailMyrtlePark,02/24/2014 07:00:00 AM,48,-122,25,51,76
1304,ElliotBayTrailMyrtlePark,02/24/2014 08:00:00 AM,48,-122,23,51,74
1305,ElliotBayTrailMyrtlePark,02/24/2014 09:00:00 AM,48,-122,7,21,28
1306,ElliotBayTrailMyrtlePark,02/24/2014 10:00:00 AM,48,-122,1,7,8
1307,ElliotBayTrailMyrtlePark,02/24/2014 11:00:00 AM,48,-122,0,3,3
1308,ElliotBayTrailMyrtlePark,02/24/2014 12:00:00 PM,48,-122,3,3,6
1309,ElliotBayTrailMyrtlePark,02/24/2014 01:00:00 PM,48,-122,7,5,12
1310,ElliotBayTrailMyrtlePark,02/24/2014 02:00:00 PM,48,-122,4,7,11
1311,ElliotBayTrailMyrtlePark,02/24/2014 03:00:00 PM,48,-122,15,10,25
1312,ElliotBayTrailMyrtlePark,02/24/2014 04:00:00 PM,48,-122,25,14,39
1313,ElliotBayTrailMyrtlePark,02/24/2014 05:00:00 PM,48,-122,69,37,106
1314,ElliotBayTrailMyrtlePark,02/24/2014 06:00:00 PM,48,-122,37,10,47
1315,ElliotBayTrailMyrtlePark,02/24/2014 07:00:00 PM,48,-122,10,2,12
1316,ElliotBayTrailMyrtlePark,02/24/2014 08:00:00 PM,48,-122,4,1,5
1317,ElliotBayTrailMyrtlePark,02/24/2014 09:00:00 PM,48,-122,2,0,2
1318,ElliotBayTrailMyrtlePark,02/24/2014 10:00:00 PM,48,-122,1,0,1
1319,ElliotBayTrailMyrtlePark,02/24/2014 11:00:00 PM,48,-122,2,1,3
1320,ElliotBayTrailMyrtlePark,02/25/2014 12:00:00 AM,48,-122,1,1,2
1321,ElliotBayTrailMyrtlePark,02/25/2014 01:00:00 AM,48,-122,0,0,0
1322,ElliotBayTrailMyrtlePark,02/25/2014 02:00:00 AM,48,-122,1,1,2
1323,ElliotBayTrailMyrtlePark,02/25/2014 03:00:00 AM,48,-122,1,1,2
1324,ElliotBayTrailMyrtlePark,02/25/2014 04:00:00 AM,48,-122,0,1,1
1325,ElliotBayTrailMyrtlePark,02/25/2014 05:00:00 AM,48,-122,9,10,19
1326,ElliotBayTrailMyrtlePark,02/25/2014 06:00:00 AM,48,-122,14,24,38
1327,ElliotBayTrailMyrtlePark,02/25/2014 07:00:00 AM,48,-122,34,84,118
1328,ElliotBayTrailMyrtlePark,02/25/2014 08:00:00 AM,48,-122,25,94,119
1329,ElliotBayTrailMyrtlePark,02/25/2014 09:00:00 AM,48,-122,7,38,45
1330,ElliotBayTrailMyrtlePark,02/25/2014 10:00:00 AM,48,-122,11,12,23
1331,ElliotBayTrailMyrtlePark,02/25/2014 11:00:00 AM,48,-122,9,3,12
1332,ElliotBayTrailMyrtlePark,02/25/2014 12:00:00 PM,48,-122,12,13,25
1333,ElliotBayTrailMyrtlePark,02/25/2014 01:00:00 PM,48,-122,17,22,39
1334,ElliotBayTrailMyrtlePark,02/25/2014 02:00:00 PM,48,-122,24,23,47
1335,ElliotBayTrailMyrtlePark,02/25/2014 03:00:00 PM,48,-122,31,24,55
1336,ElliotBayTrailMyrtlePark,02/25/2014 04:00:00 PM,48,-122,75,50,125
1337,ElliotBayTrailMyrtlePark,02/25/2014 05:00:00 PM,48,-122,135,48,183
1338,ElliotBayTrailMyrtlePark,02/25/2014 06:00:00 PM,48,-122,70,15,85
1339,ElliotBayTrailMyrtlePark,02/25/2014 07:00:00 PM,48,-122,21,7,28
1340,ElliotBayTrailMyrtlePark,02/25/2014 08:00:00 PM,48,-122,3,4,7
1341,ElliotBayTrailMyrtlePark,02/25/2014 09:00:00 PM,48,-122,3,1,4
1342,ElliotBayTrailMyrtlePark,02/25/2014 10:00:00 PM,48,-122,1,3,4
1343,ElliotBayTrailMyrtlePark,02/25/2014 11:00:00 PM,48,-122,5,1,6
1344,ElliotBayTrailMyrtlePark,02/26/2014 12:00:00 AM,48,-122,2,1,3
1345,ElliotBayTrailMyrtlePark,02/26/2014 01:00:00 AM,48,-122,0,1,1
1346,ElliotBayTrailMyrtlePark,02/26/2014 02:00:00 AM,48,-122,1,1,2
1347,ElliotBayTrailMyrtlePark,02/26/2014 03:00:00 AM,48,-122,1,1,2
1348,ElliotBayTrailMyrtlePark,02/26/2014 04:00:00 AM,48,-122,0,0,0
1349,ElliotBayTrailMyrtlePark,02/26/2014 05:00:00 AM,48,-122,10,16,26
1350,ElliotBayTrailMyrtlePark,02/26/2014 06:00:00 AM,48,-122,16,28,44
1351,ElliotBayTrailMyrtlePark,02/26/2014 07:00:00 AM,48,-122,34,86,120
1352,ElliotBayTrailMyrtlePark,02/26/2014 08:00:00 AM,48,-122,35,92,127
1353,ElliotBayTrailMyrtlePark,02/26/2014 09:00:00 AM,48,-122,18,42,60
1354,ElliotBayTrailMyrtlePark,02/26/2014 10:00:00 AM,48,-122,6,19,25
1355,ElliotBayTrailMyrtlePark,02/26/2014 11:00:00 AM,48,-122,21,13,34
1356,ElliotBayTrailMyrtlePark,02/26/2014 12:00:00 PM,48,-122,15,19,34
1357,ElliotBayTrailMyrtlePark,02/26/2014 01:00:00 PM,48,-122,20,15,35
1358,ElliotBayTrailMyrtlePark,02/26/2014 02:00:00 PM,48,-122,26,37,63
1359,ElliotBayTrailMyrtlePark,02/26/2014 03:00:00 PM,48,-122,43,27,70
1360,ElliotBayTrailMyrtlePark,02/26/2014 04:00:00 PM,48,-122,89,50,139
1361,ElliotBayTrailMyrtlePark,02/26/2014 05:00:00 PM,48,-122,134,57,191
1362,ElliotBayTrailMyrtlePark,02/26/2014 06:00:00 PM,48,-122,55,43,98
1363,ElliotBayTrailMyrtlePark,02/26/2014 07:00:00 PM,48,-122,27,10,37
1364,ElliotBayTrailMyrtlePark,02/26/2014 08:00:00 PM,48,-122,8,1,9
1365,ElliotBayTrailMyrtlePark,02/26/2014 09:00:00 PM,48,-122,5,3,8
1366,ElliotBayTrailMyrtlePark,02/26/2014 10:00:00 PM,48,-122,0,1,1
1367,ElliotBayTrailMyrtlePark,02/26/2014 11:00:00 PM,48,-122,5,1,6
1368,ElliotBayTrailMyrtlePark,02/27/2014 12:00:00 AM,48,-122,3,1,4
1369,ElliotBayTrailMyrtlePark,02/27/2014 01:00:00 AM,48,-122,0,0,0
1370,ElliotBayTrailMyrtlePark,02/27/2014 02:00:00 AM,48,-122,2,1,3
1371,ElliotBayTrailMyrtlePark,02/27/2014 03:00:00 AM,48,-122,1,1,2
1372,ElliotBayTrailMyrtlePark,02/27/2014 04:00:00 AM,48,-122,0,0,0
1373,ElliotBayTrailMyrtlePark,02/27/2014 05:00:00 AM,48,-122,9,14,23
1374,ElliotBayTrailMyrtlePark,02/27/2014 06:00:00 AM,48,-122,15,13,28
1375,ElliotBayTrailMyrtlePark,02/27/2014 07:00:00 AM,48,-122,39,78,117
1376,ElliotBayTrailMyrtlePark,02/27/2014 08:00:00 AM,48,-122,32,93,125
1377,ElliotBayTrailMyrtlePark,02/27/2014 09:00:00 AM,48,-122,13,44,57
1378,ElliotBayTrailMyrtlePark,02/27/2014 10:00:00 AM,48,-122,11,15,26
1379,ElliotBayTrailMyrtlePark,02/27/2014 11:00:00 AM,48,-122,19,10,29
1380,ElliotBayTrailMyrtlePark,02/27/2014 12:00:00 PM,48,-122,9,10,19
1381,ElliotBayTrailMyrtlePark,02/27/2014 01:00:00 PM,48,-122,9,17,26
1382,ElliotBayTrailMyrtlePark,02/27/2014 02:00:00 PM,48,-122,25,22,47
1383,ElliotBayTrailMyrtlePark,02/27/2014 03:00:00 PM,48,-122,27,17,44
1384,ElliotBayTrailMyrtlePark,02/27/2014 04:00:00 PM,48,-122,68,40,108
1385,ElliotBayTrailMyrtlePark,02/27/2014 05:00:00 PM,48,-122,119,41,160
1386,ElliotBayTrailMyrtlePark,02/27/2014 06:00:00 PM,48,-122,72,19,91
1387,ElliotBayTrailMyrtlePark,02/27/2014 07:00:00 PM,48,-122,21,6,27
1388,ElliotBayTrailMyrtlePark,02/27/2014 08:00:00 PM,48,-122,7,0,7
1389,ElliotBayTrailMyrtlePark,02/27/2014 09:00:00 PM,48,-122,2,3,5
1390,ElliotBayTrailMyrtlePark,02/27/2014 10:00:00 PM,48,-122,3,3,6
1391,ElliotBayTrailMyrtlePark,02/27/2014 11:00:00 PM,48,-122,3,2,5
1392,ElliotBayTrailMyrtlePark,02/28/2014 12:00:00 AM,48,-122,1,2,3
1393,ElliotBayTrailMyrtlePark,02/28/2014 01:00:00 AM,48,-122,0,0,0
1394,ElliotBayTrailMyrtlePark,02/28/2014 02:00:00 AM,48,-122,1,0,1
1395,ElliotBayTrailMyrtlePark,02/28/2014 03:00:00 AM,48,-122,0,0,0
1396,ElliotBayTrailMyrtlePark,02/28/2014 04:00:00 AM,48,-122,0,0,0
1397,ElliotBayTrailMyrtlePark,02/28/2014 05:00:00 AM,48,-122,8,13,21
1398,ElliotBayTrailMyrtlePark,02/28/2014 06:00:00 AM,48,-122,18,12,30
1399,ElliotBayTrailMyrtlePark,02/28/2014 07:00:00 AM,48,-122,27,75,102
1400,ElliotBayTrailMyrtlePark,02/28/2014 08:00:00 AM,48,-122,29,88,117
1401,ElliotBayTrailMyrtlePark,02/28/2014 09:00:00 AM,48,-122,19,40,59
1402,ElliotBayTrailMyrtlePark,02/28/2014 10:00:00 AM,48,-122,10,18,28
1403,ElliotBayTrailMyrtlePark,02/28/2014 11:00:00 AM,48,-122,14,16,30
1404,ElliotBayTrailMyrtlePark,02/28/2014 12:00:00 PM,48,-122,16,23,39
1405,ElliotBayTrailMyrtlePark,02/28/2014 01:00:00 PM,48,-122,24,17,41
1406,ElliotBayTrailMyrtlePark,02/28/2014 02:00:00 PM,48,-122,37,27,64
1407,ElliotBayTrailMyrtlePark,02/28/2014 03:00:00 PM,48,-122,36,30,66
1408,ElliotBayTrailMyrtlePark,02/28/2014 04:00:00 PM,48,-122,83,37,120
1409,ElliotBayTrailMyrtlePark,02/28/2014 05:00:00 PM,48,-122,114,67,181
1410,ElliotBayTrailMyrtlePark,02/28/2014 06:00:00 PM,48,-122,63,13,76
1411,ElliotBayTrailMyrtlePark,02/28/2014 07:00:00 PM,48,-122,14,7,21
1412,ElliotBayTrailMyrtlePark,02/28/2014 08:00:00 PM,48,-122,5,1,6
1413,ElliotBayTrailMyrtlePark,02/28/2014 09:00:00 PM,48,-122,3,3,6
1414,ElliotBayTrailMyrtlePark,02/28/2014 10:00:00 PM,48,-122,1,0,1
1415,ElliotBayTrailMyrtlePark,02/28/2014 11:00:00 PM,48,-122,3,1,4
1416,ElliotBayTrailMyrtlePark,03/01/2014 12:00:00 AM,48,-122,4,0,4
1417,ElliotBayTrailMyrtlePark,03/01/2014 01:00:00 AM,48,-122,0,1,1
1418,ElliotBayTrailMyrtlePark,03/01/2014 02:00:00 AM,48,-122,0,0,0
1419,ElliotBayTrailMyrtlePark,03/01/2014 03:00:00 AM,48,-122,1,0,1
1420,ElliotBayTrailMyrtlePark,03/01/2014 04:00:00 AM,48,-122,0,0,0
1421,ElliotBayTrailMyrtlePark,03/01/2014 05:00:00 AM,48,-122,0,0,0
1422,ElliotBayTrailMyrtlePark,03/01/2014 06:00:00 AM,48,-122,2,4,6
1423,ElliotBayTrailMyrtlePark,03/01/2014 07:00:00 AM,48,-122,13,5,18
1424,ElliotBayTrailMyrtlePark,03/01/2014 08:00:00 AM,48,-122,38,10,48
1425,ElliotBayTrailMyrtlePark,03/01/2014 09:00:00 AM,48,-122,45,14,59
1426,ElliotBayTrailMyrtlePark,03/01/2014 10:00:00 AM,48,-122,37,21,58
1427,ElliotBayTrailMyrtlePark,03/01/2014 11:00:00 AM,48,-122,59,30,89
1428,ElliotBayTrailMyrtlePark,03/01/2014 12:00:00 PM,48,-122,51,33,84
1429,ElliotBayTrailMyrtlePark,03/01/2014 01:00:00 PM,48,-122,45,30,75
1430,ElliotBayTrailMyrtlePark,03/01/2014 02:00:00 PM,48,-122,25,46,71
1431,ElliotBayTrailMyrtlePark,03/01/2014 03:00:00 PM,48,-122,13,29,42
1432,ElliotBayTrailMyrtlePark,03/01/2014 04:00:00 PM,48,-122,7,28,35
1433,ElliotBayTrailMyrtlePark,03/01/2014 05:00:00 PM,48,-122,3,23,26
1434,ElliotBayTrailMyrtlePark,03/01/2014 06:00:00 PM,48,-122,3,21,24
1435,ElliotBayTrailMyrtlePark,03/01/2014 07:00:00 PM,48,-122,0,2,2
1436,ElliotBayTrailMyrtlePark,03/01/2014 08:00:00 PM,48,-122,1,0,1
1437,ElliotBayTrailMyrtlePark,03/01/2014 09:00:00 PM,48,-122,3,1,4
1438,ElliotBayTrailMyrtlePark,03/01/2014 10:00:00 PM,48,-122,2,2,4
1439,ElliotBayTrailMyrtlePark,03/01/2014 11:00:00 PM,48,-122,0,0,0
1440,ElliotBayTrailMyrtlePark,03/02/2014 12:00:00 AM,48,-122,2,2,4
1441,ElliotBayTrailMyrtlePark,03/02/2014 01:00:00 AM,48,-122,1,0,1
1442,ElliotBayTrailMyrtlePark,03/02/2014 02:00:00 AM,48,-122,0,0,0
1443,ElliotBayTrailMyrtlePark,03/02/2014 03:00:00 AM,48,-122,0,0,0
1444,ElliotBayTrailMyrtlePark,03/02/2014 04:00:00 AM,48,-122,0,0,0
1445,ElliotBayTrailMyrtlePark,03/02/2014 05:00:00 AM,48,-122,0,0,0
1446,ElliotBayTrailMyrtlePark,03/02/2014 06:00:00 AM,48,-122,1,2,3
1447,ElliotBayTrailMyrtlePark,03/02/2014 07:00:00 AM,48,-122,1,1,2
1448,ElliotBayTrailMyrtlePark,03/02/2014 08:00:00 AM,48,-122,7,2,9
1449,ElliotBayTrailMyrtlePark,03/02/2014 09:00:00 AM,48,-122,25,3,28
1450,ElliotBayTrailMyrtlePark,03/02/2014 10:00:00 AM,48,-122,22,7,29
1451,ElliotBayTrailMyrtlePark,03/02/2014 11:00:00 AM,48,-122,17,5,22
1452,ElliotBayTrailMyrtlePark,03/02/2014 12:00:00 PM,48,-122,15,14,29
1453,ElliotBayTrailMyrtlePark,03/02/2014 01:00:00 PM,48,-122,3,14,17
1454,ElliotBayTrailMyrtlePark,03/02/2014 02:00:00 PM,48,-122,6,23,29
1455,ElliotBayTrailMyrtlePark,03/02/2014 03:00:00 PM,48,-122,4,13,17
1456,ElliotBayTrailMyrtlePark,03/02/2014 04:00:00 PM,48,-122,6,12,18
1457,ElliotBayTrailMyrtlePark,03/02/2014 05:00:00 PM,48,-122,4,9,13
1458,ElliotBayTrailMyrtlePark,03/02/2014 06:00:00 PM,48,-122,1,1,2
1459,ElliotBayTrailMyrtlePark,03/02/2014 07:00:00 PM,48,-122,2,0,2
1460,ElliotBayTrailMyrtlePark,03/02/2014 08:00:00 PM,48,-122,2,1,3
1461,ElliotBayTrailMyrtlePark,03/02/2014 09:00:00 PM,48,-122,1,0,1
1462,ElliotBayTrailMyrtlePark,03/02/2014 10:00:00 PM,48,-122,0,0,0
1463,ElliotBayTrailMyrtlePark,03/02/2014 11:00:00 PM,48,-122,0,0,0
1464,ElliotBayTrailMyrtlePark,03/03/2014 12:00:00 AM,48,-122,0,0,0
1465,ElliotBayTrailMyrtlePark,03/03/2014 01:00:00 AM,48,-122,0,0,0
1466,ElliotBayTrailMyrtlePark,03/03/2014 02:00:00 AM,48,-122,0,0,0
1467,ElliotBayTrailMyrtlePark,03/03/2014 03:00:00 AM,48,-122,0,0,0
1468,ElliotBayTrailMyrtlePark,03/03/2014 04:00:00 AM,48,-122,0,0,0
1469,ElliotBayTrailMyrtlePark,03/03/2014 05:00:00 AM,48,-122,6,5,11
1470,ElliotBayTrailMyrtlePark,03/03/2014 06:00:00 AM,48,-122,15,20,35
1471,ElliotBayTrailMyrtlePark,03/03/2014 07:00:00 AM,48,-122,34,44,78
1472,ElliotBayTrailMyrtlePark,03/03/2014 08:00:00 AM,48,-122,20,55,75
1473,ElliotBayTrailMyrtlePark,03/03/2014 09:00:00 AM,48,-122,3,24,27
1474,ElliotBayTrailMyrtlePark,03/03/2014 10:00:00 AM,48,-122,6,5,11
1475,ElliotBayTrailMyrtlePark,03/03/2014 11:00:00 AM,48,-122,2,7,9
1476,ElliotBayTrailMyrtlePark,03/03/2014 12:00:00 PM,48,-122,6,4,10
1477,ElliotBayTrailMyrtlePark,03/03/2014 01:00:00 PM,48,-122,10,7,17
1478,ElliotBayTrailMyrtlePark,03/03/2014 02:00:00 PM,48,-122,14,5,19
1479,ElliotBayTrailMyrtlePark,03/03/2014 03:00:00 PM,48,-122,21,25,46
1480,ElliotBayTrailMyrtlePark,03/03/2014 04:00:00 PM,48,-122,46,29,75
1481,ElliotBayTrailMyrtlePark,03/03/2014 05:00:00 PM,48,-122,76,37,113
1482,ElliotBayTrailMyrtlePark,03/03/2014 06:00:00 PM,48,-122,47,20,67
1483,ElliotBayTrailMyrtlePark,03/03/2014 07:00:00 PM,48,-122,9,3,12
1484,ElliotBayTrailMyrtlePark,03/03/2014 08:00:00 PM,48,-122,3,0,3
1485,ElliotBayTrailMyrtlePark,03/03/2014 09:00:00 PM,48,-122,3,0,3
1486,ElliotBayTrailMyrtlePark,03/03/2014 10:00:00 PM,48,-122,0,0,0
1487,ElliotBayTrailMyrtlePark,03/03/2014 11:00:00 PM,48,-122,0,0,0
1488,ElliotBayTrailMyrtlePark,03/04/2014 12:00:00 AM,48,-122,2,0,2
1489,ElliotBayTrailMyrtlePark,03/04/2014 01:00:00 AM,48,-122,0,0,0
1490,ElliotBayTrailMyrtlePark,03/04/2014 02:00:00 AM,48,-122,0,0,0
1491,ElliotBayTrailMyrtlePark,03/04/2014 03:00:00 AM,48,-122,0,0,0
1492,ElliotBayTrailMyrtlePark,03/04/2014 04:00:00 AM,48,-122,0,0,0
1493,ElliotBayTrailMyrtlePark,03/04/2014 05:00:00 AM,48,-122,6,12,18
1494,ElliotBayTrailMyrtlePark,03/04/2014 06:00:00 AM,48,-122,19,13,32
1495,ElliotBayTrailMyrtlePark,03/04/2014 07:00:00 AM,48,-122,39,80,119
1496,ElliotBayTrailMyrtlePark,03/04/2014 08:00:00 AM,48,-122,23,90,113
1497,ElliotBayTrailMyrtlePark,03/04/2014 09:00:00 AM,48,-122,7,32,39
1498,ElliotBayTrailMyrtlePark,03/04/2014 10:00:00 AM,48,-122,9,9,18
1499,ElliotBayTrailMyrtlePark,03/04/2014 11:00:00 AM,48,-122,5,7,12
1500,ElliotBayTrailMyrtlePark,03/04/2014 12:00:00 PM,48,-122,3,2,5
1501,ElliotBayTrailMyrtlePark,03/04/2014 01:00:00 PM,48,-122,4,8,12
1502,ElliotBayTrailMyrtlePark,03/04/2014 02:00:00 PM,48,-122,10,10,20
1503,ElliotBayTrailMyrtlePark,03/04/2014 03:00:00 PM,48,-122,11,17,28
1504,ElliotBayTrailMyrtlePark,03/04/2014 04:00:00 PM,48,-122,42,26,68
1505,ElliotBayTrailMyrtlePark,03/04/2014 05:00:00 PM,48,-122,96,34,130
1506,ElliotBayTrailMyrtlePark,03/04/2014 06:00:00 PM,48,-122,48,14,62
1507,ElliotBayTrailMyrtlePark,03/04/2014 07:00:00 PM,48,-122,16,5,21
1508,ElliotBayTrailMyrtlePark,03/04/2014 08:00:00 PM,48,-122,7,0,7
1509,ElliotBayTrailMyrtlePark,03/04/2014 09:00:00 PM,48,-122,2,2,4
1510,ElliotBayTrailMyrtlePark,03/04/2014 10:00:00 PM,48,-122,1,0,1
1511,ElliotBayTrailMyrtlePark,03/04/2014 11:00:00 PM,48,-122,2,1,3
1512,ElliotBayTrailMyrtlePark,03/05/2014 12:00:00 AM,48,-122,1,0,1
1513,ElliotBayTrailMyrtlePark,03/05/2014 01:00:00 AM,48,-122,0,0,0
1514,ElliotBayTrailMyrtlePark,03/05/2014 02:00:00 AM,48,-122,0,0,0
1515,ElliotBayTrailMyrtlePark,03/05/2014 03:00:00 AM,48,-122,1,0,1
1516,ElliotBayTrailMyrtlePark,03/05/2014 04:00:00 AM,48,-122,0,0,0
1517,ElliotBayTrailMyrtlePark,03/05/2014 05:00:00 AM,48,-122,5,6,11
1518,ElliotBayTrailMyrtlePark,03/05/2014 06:00:00 AM,48,-122,14,11,25
1519,ElliotBayTrailMyrtlePark,03/05/2014 07:00:00 AM,48,-122,34,47,81
1520,ElliotBayTrailMyrtlePark,03/05/2014 08:00:00 AM,48,-122,23,80,103
1521,ElliotBayTrailMyrtlePark,03/05/2014 09:00:00 AM,48,-122,11,34,45
1522,ElliotBayTrailMyrtlePark,03/05/2014 10:00:00 AM,48,-122,4,11,15
1523,ElliotBayTrailMyrtlePark,03/05/2014 11:00:00 AM,48,-122,5,7,12
1524,ElliotBayTrailMyrtlePark,03/05/2014 12:00:00 PM,48,-122,10,10,20
1525,ElliotBayTrailMyrtlePark,03/05/2014 01:00:00 PM,48,-122,16,18,34
1526,ElliotBayTrailMyrtlePark,03/05/2014 02:00:00 PM,48,-122,17,14,31
1527,ElliotBayTrailMyrtlePark,03/05/2014 03:00:00 PM,48,-122,8,16,24
1528,ElliotBayTrailMyrtlePark,03/05/2014 04:00:00 PM,48,-122,31,28,59
1529,ElliotBayTrailMyrtlePark,03/05/2014 05:00:00 PM,48,-122,84,23,107
1530,ElliotBayTrailMyrtlePark,03/05/2014 06:00:00 PM,48,-122,52,7,59
1531,ElliotBayTrailMyrtlePark,03/05/2014 07:00:00 PM,48,-122,16,4,20
1532,ElliotBayTrailMyrtlePark,03/05/2014 08:00:00 PM,48,-122,4,0,4
1533,ElliotBayTrailMyrtlePark,03/05/2014 09:00:00 PM,48,-122,3,1,4
1534,ElliotBayTrailMyrtlePark,03/05/2014 10:00:00 PM,48,-122,0,0,0
1535,ElliotBayTrailMyrtlePark,03/05/2014 11:00:00 PM,48,-122,2,1,3
1536,ElliotBayTrailMyrtlePark,03/06/2014 12:00:00 AM,48,-122,0,0,0
1537,ElliotBayTrailMyrtlePark,03/06/2014 01:00:00 AM,48,-122,0,0,0
1538,ElliotBayTrailMyrtlePark,03/06/2014 02:00:00 AM,48,-122,0,0,0
1539,ElliotBayTrailMyrtlePark,03/06/2014 03:00:00 AM,48,-122,0,0,0
1540,ElliotBayTrailMyrtlePark,03/06/2014 04:00:00 AM,48,-122,0,0,0
1541,ElliotBayTrailMyrtlePark,03/06/2014 05:00:00 AM,48,-122,9,10,19
1542,ElliotBayTrailMyrtlePark,03/06/2014 06:00:00 AM,48,-122,14,14,28
1543,ElliotBayTrailMyrtlePark,03/06/2014 07:00:00 AM,48,-122,26,36,62
1544,ElliotBayTrailMyrtlePark,03/06/2014 08:00:00 AM,48,-122,19,49,68
1545,ElliotBayTrailMyrtlePark,03/06/2014 09:00:00 AM,48,-122,4,31,35
1546,ElliotBayTrailMyrtlePark,03/06/2014 10:00:00 AM,48,-122,7,8,15
1547,ElliotBayTrailMyrtlePark,03/06/2014 11:00:00 AM,48,-122,6,5,11
1548,ElliotBayTrailMyrtlePark,03/06/2014 12:00:00 PM,48,-122,7,3,10
1549,ElliotBayTrailMyrtlePark,03/06/2014 01:00:00 PM,48,-122,8,6,14
1550,ElliotBayTrailMyrtlePark,03/06/2014 02:00:00 PM,48,-122,13,9,22
1551,ElliotBayTrailMyrtlePark,03/06/2014 03:00:00 PM,48,-122,14,8,22
1552,ElliotBayTrailMyrtlePark,03/06/2014 04:00:00 PM,48,-122,24,22,46
1553,ElliotBayTrailMyrtlePark,03/06/2014 05:00:00 PM,48,-122,72,37,109
1554,ElliotBayTrailMyrtlePark,03/06/2014 06:00:00 PM,48,-122,41,11,52
1555,ElliotBayTrailMyrtlePark,03/06/2014 07:00:00 PM,48,-122,14,6,20
1556,ElliotBayTrailMyrtlePark,03/06/2014 08:00:00 PM,48,-122,4,0,4
1557,ElliotBayTrailMyrtlePark,03/06/2014 09:00:00 PM,48,-122,6,1,7
1558,ElliotBayTrailMyrtlePark,03/06/2014 10:00:00 PM,48,-122,4,2,6
1559,ElliotBayTrailMyrtlePark,03/06/2014 11:00:00 PM,48,-122,0,6,6
1560,ElliotBayTrailMyrtlePark,03/07/2014 12:00:00 AM,48,-122,1,2,3
1561,ElliotBayTrailMyrtlePark,03/07/2014 01:00:00 AM,48,-122,1,3,4
1562,ElliotBayTrailMyrtlePark,03/07/2014 02:00:00 AM,48,-122,0,0,0
1563,ElliotBayTrailMyrtlePark,03/07/2014 03:00:00 AM,48,-122,0,0,0
1564,ElliotBayTrailMyrtlePark,03/07/2014 04:00:00 AM,48,-122,0,0,0
1565,ElliotBayTrailMyrtlePark,03/07/2014 05:00:00 AM,48,-122,10,9,19
1566,ElliotBayTrailMyrtlePark,03/07/2014 06:00:00 AM,48,-122,21,13,34
1567,ElliotBayTrailMyrtlePark,03/07/2014 07:00:00 AM,48,-122,31,66,97
1568,ElliotBayTrailMyrtlePark,03/07/2014 08:00:00 AM,48,-122,23,75,98
1569,ElliotBayTrailMyrtlePark,03/07/2014 09:00:00 AM,48,-122,13,39,52
1570,ElliotBayTrailMyrtlePark,03/07/2014 10:00:00 AM,48,-122,15,17,32
1571,ElliotBayTrailMyrtlePark,03/07/2014 11:00:00 AM,48,-122,19,11,30
1572,ElliotBayTrailMyrtlePark,03/07/2014 12:00:00 PM,48,-122,31,21,52
1573,ElliotBayTrailMyrtlePark,03/07/2014 01:00:00 PM,48,-122,21,31,52
1574,ElliotBayTrailMyrtlePark,03/07/2014 02:00:00 PM,48,-122,28,23,51
1575,ElliotBayTrailMyrtlePark,03/07/2014 03:00:00 PM,48,-122,42,25,67
1576,ElliotBayTrailMyrtlePark,03/07/2014 04:00:00 PM,48,-122,69,41,110
1577,ElliotBayTrailMyrtlePark,03/07/2014 05:00:00 PM,48,-122,111,63,174
1578,ElliotBayTrailMyrtlePark,03/07/2014 06:00:00 PM,48,-122,49,30,79
1579,ElliotBayTrailMyrtlePark,03/07/2014 07:00:00 PM,48,-122,17,8,25
1580,ElliotBayTrailMyrtlePark,03/07/2014 08:00:00 PM,48,-122,5,0,5
1581,ElliotBayTrailMyrtlePark,03/07/2014 09:00:00 PM,48,-122,7,1,8
1582,ElliotBayTrailMyrtlePark,03/07/2014 10:00:00 PM,48,-122,3,0,3
1583,ElliotBayTrailMyrtlePark,03/07/2014 11:00:00 PM,48,-122,2,1,3
1584,ElliotBayTrailMyrtlePark,03/08/2014 12:00:00 AM,48,-122,1,0,1
1585,ElliotBayTrailMyrtlePark,03/08/2014 01:00:00 AM,48,-122,0,0,0
1586,ElliotBayTrailMyrtlePark,03/08/2014 02:00:00 AM,48,-122,0,0,0
1587,ElliotBayTrailMyrtlePark,03/08/2014 03:00:00 AM,48,-122,1,0,1
1588,ElliotBayTrailMyrtlePark,03/08/2014 04:00:00 AM,48,-122,0,0,0
1589,ElliotBayTrailMyrtlePark,03/08/2014 05:00:00 AM,48,-122,0,2,2
1590,ElliotBayTrailMyrtlePark,03/08/2014 06:00:00 AM,48,-122,2,4,6
1591,ElliotBayTrailMyrtlePark,03/08/2014 07:00:00 AM,48,-122,7,4,11
1592,ElliotBayTrailMyrtlePark,03/08/2014 08:00:00 AM,48,-122,15,18,33
1593,ElliotBayTrailMyrtlePark,03/08/2014 09:00:00 AM,48,-122,13,14,27
1594,ElliotBayTrailMyrtlePark,03/08/2014 10:00:00 AM,48,-122,19,26,45
1595,ElliotBayTrailMyrtlePark,03/08/2014 11:00:00 AM,48,-122,19,26,45
1596,ElliotBayTrailMyrtlePark,03/08/2014 12:00:00 PM,48,-122,9,5,14
1597,ElliotBayTrailMyrtlePark,03/08/2014 01:00:00 PM,48,-122,10,6,16
1598,ElliotBayTrailMyrtlePark,03/08/2014 02:00:00 PM,48,-122,8,4,12
1599,ElliotBayTrailMyrtlePark,03/08/2014 03:00:00 PM,48,-122,5,1,6
1600,ElliotBayTrailMyrtlePark,03/08/2014 04:00:00 PM,48,-122,7,2,9
1601,ElliotBayTrailMyrtlePark,03/08/2014 05:00:00 PM,48,-122,5,1,6
1602,ElliotBayTrailMyrtlePark,03/08/2014 06:00:00 PM,48,-122,3,5,8
1603,ElliotBayTrailMyrtlePark,03/08/2014 07:00:00 PM,48,-122,1,1,2
1604,ElliotBayTrailMyrtlePark,03/08/2014 08:00:00 PM,48,-122,2,0,2
1605,ElliotBayTrailMyrtlePark,03/08/2014 09:00:00 PM,48,-122,1,0,1
1606,ElliotBayTrailMyrtlePark,03/08/2014 10:00:00 PM,48,-122,1,0,1
1607,ElliotBayTrailMyrtlePark,03/08/2014 11:00:00 PM,48,-122,0,0,0
1608,ElliotBayTrailMyrtlePark,03/09/2014 12:00:00 AM,48,-122,0,0,0
1609,ElliotBayTrailMyrtlePark,03/09/2014 01:00:00 AM,48,-122,0,2,2
1610,ElliotBayTrailMyrtlePark,03/09/2014 02:00:00 AM,48,-122,0,0,0
1611,ElliotBayTrailMyrtlePark,03/09/2014 03:00:00 AM,48,-122,0,0,0
1612,ElliotBayTrailMyrtlePark,03/09/2014 04:00:00 AM,48,-122,0,0,0
1613,ElliotBayTrailMyrtlePark,03/09/2014 05:00:00 AM,48,-122,0,0,0
1614,ElliotBayTrailMyrtlePark,03/09/2014 06:00:00 AM,48,-122,1,3,4
1615,ElliotBayTrailMyrtlePark,03/09/2014 07:00:00 AM,48,-122,0,1,1
1616,ElliotBayTrailMyrtlePark,03/09/2014 08:00:00 AM,48,-122,3,3,6
1617,ElliotBayTrailMyrtlePark,03/09/2014 09:00:00 AM,48,-122,9,6,15
1618,ElliotBayTrailMyrtlePark,03/09/2014 10:00:00 AM,48,-122,15,17,32
1619,ElliotBayTrailMyrtlePark,03/09/2014 11:00:00 AM,48,-122,19,25,44
1620,ElliotBayTrailMyrtlePark,03/09/2014 12:00:00 PM,48,-122,18,19,37
1621,ElliotBayTrailMyrtlePark,03/09/2014 01:00:00 PM,48,-122,28,25,53
1622,ElliotBayTrailMyrtlePark,03/09/2014 02:00:00 PM,48,-122,57,42,99
1623,ElliotBayTrailMyrtlePark,03/09/2014 03:00:00 PM,48,-122,34,57,91
1624,ElliotBayTrailMyrtlePark,03/09/2014 04:00:00 PM,48,-122,34,31,65
1625,ElliotBayTrailMyrtlePark,03/09/2014 05:00:00 PM,48,-122,28,24,52
1626,ElliotBayTrailMyrtlePark,03/09/2014 06:00:00 PM,48,-122,9,9,18
1627,ElliotBayTrailMyrtlePark,03/09/2014 07:00:00 PM,48,-122,4,6,10
1628,ElliotBayTrailMyrtlePark,03/09/2014 08:00:00 PM,48,-122,2,3,5
1629,ElliotBayTrailMyrtlePark,03/09/2014 09:00:00 PM,48,-122,1,0,1
1630,ElliotBayTrailMyrtlePark,03/09/2014 10:00:00 PM,48,-122,1,1,2
1631,ElliotBayTrailMyrtlePark,03/09/2014 11:00:00 PM,48,-122,1,1,2
1632,ElliotBayTrailMyrtlePark,03/10/2014 12:00:00 AM,48,-122,0,0,0
1633,ElliotBayTrailMyrtlePark,03/10/2014 01:00:00 AM,48,-122,1,1,2
1634,ElliotBayTrailMyrtlePark,03/10/2014 02:00:00 AM,48,-122,0,0,0
1635,ElliotBayTrailMyrtlePark,03/10/2014 03:00:00 AM,48,-122,0,0,0
1636,ElliotBayTrailMyrtlePark,03/10/2014 04:00:00 AM,48,-122,0,0,0
1637,ElliotBayTrailMyrtlePark,03/10/2014 05:00:00 AM,48,-122,8,8,16
1638,ElliotBayTrailMyrtlePark,03/10/2014 06:00:00 AM,48,-122,16,24,40
1639,ElliotBayTrailMyrtlePark,03/10/2014 07:00:00 AM,48,-122,22,43,65
1640,ElliotBayTrailMyrtlePark,03/10/2014 08:00:00 AM,48,-122,19,84,103
1641,ElliotBayTrailMyrtlePark,03/10/2014 09:00:00 AM,48,-122,9,39,48
1642,ElliotBayTrailMyrtlePark,03/10/2014 10:00:00 AM,48,-122,5,19,24
1643,ElliotBayTrailMyrtlePark,03/10/2014 11:00:00 AM,48,-122,7,4,11
1644,ElliotBayTrailMyrtlePark,03/10/2014 12:00:00 PM,48,-122,7,4,11
1645,ElliotBayTrailMyrtlePark,03/10/2014 01:00:00 PM,48,-122,8,7,15
1646,ElliotBayTrailMyrtlePark,03/10/2014 02:00:00 PM,48,-122,6,8,14
1647,ElliotBayTrailMyrtlePark,03/10/2014 03:00:00 PM,48,-122,16,15,31
1648,ElliotBayTrailMyrtlePark,03/10/2014 04:00:00 PM,48,-122,48,24,72
1649,ElliotBayTrailMyrtlePark,03/10/2014 05:00:00 PM,48,-122,89,35,124
1650,ElliotBayTrailMyrtlePark,03/10/2014 06:00:00 PM,48,-122,62,21,83
1651,ElliotBayTrailMyrtlePark,03/10/2014 07:00:00 PM,48,-122,20,12,32
1652,ElliotBayTrailMyrtlePark,03/10/2014 08:00:00 PM,48,-122,9,0,9
1653,ElliotBayTrailMyrtlePark,03/10/2014 09:00:00 PM,48,-122,1,1,2
1654,ElliotBayTrailMyrtlePark,03/10/2014 10:00:00 PM,48,-122,3,0,3
1655,ElliotBayTrailMyrtlePark,03/10/2014 11:00:00 PM,48,-122,2,1,3
1656,ElliotBayTrailMyrtlePark,03/11/2014 12:00:00 AM,48,-122,2,1,3
1657,ElliotBayTrailMyrtlePark,03/11/2014 01:00:00 AM,48,-122,0,0,0
1658,ElliotBayTrailMyrtlePark,03/11/2014 02:00:00 AM,48,-122,1,1,2
1659,ElliotBayTrailMyrtlePark,03/11/2014 03:00:00 AM,48,-122,1,1,2
1660,ElliotBayTrailMyrtlePark,03/11/2014 04:00:00 AM,48,-122,0,0,0
1661,ElliotBayTrailMyrtlePark,03/11/2014 05:00:00 AM,48,-122,13,18,31
1662,ElliotBayTrailMyrtlePark,03/11/2014 06:00:00 AM,48,-122,16,16,32
1663,ElliotBayTrailMyrtlePark,03/11/2014 07:00:00 AM,48,-122,31,74,105
1664,ElliotBayTrailMyrtlePark,03/11/2014 08:00:00 AM,48,-122,32,121,153
1665,ElliotBayTrailMyrtlePark,03/11/2014 09:00:00 AM,48,-122,14,55,69
1666,ElliotBayTrailMyrtlePark,03/11/2014 10:00:00 AM,48,-122,13,34,47
1667,ElliotBayTrailMyrtlePark,03/11/2014 11:00:00 AM,48,-122,14,10,24
1668,ElliotBayTrailMyrtlePark,03/11/2014 12:00:00 PM,48,-122,10,16,26
1669,ElliotBayTrailMyrtlePark,03/11/2014 01:00:00 PM,48,-122,27,21,48
1670,ElliotBayTrailMyrtlePark,03/11/2014 02:00:00 PM,48,-122,26,20,46
1671,ElliotBayTrailMyrtlePark,03/11/2014 03:00:00 PM,48,-122,45,40,85
1672,ElliotBayTrailMyrtlePark,03/11/2014 04:00:00 PM,48,-122,74,53,127
1673,ElliotBayTrailMyrtlePark,03/11/2014 05:00:00 PM,48,-122,192,100,292
1674,ElliotBayTrailMyrtlePark,03/11/2014 06:00:00 PM,48,-122,107,63,170
1675,ElliotBayTrailMyrtlePark,03/11/2014 07:00:00 PM,48,-122,42,23,65
1676,ElliotBayTrailMyrtlePark,03/11/2014 08:00:00 PM,48,-122,6,6,12
1677,ElliotBayTrailMyrtlePark,03/11/2014 09:00:00 PM,48,-122,3,3,6
1678,ElliotBayTrailMyrtlePark,03/11/2014 10:00:00 PM,48,-122,3,2,5
1679,ElliotBayTrailMyrtlePark,03/11/2014 11:00:00 PM,48,-122,3,2,5
1680,ElliotBayTrailMyrtlePark,03/12/2014 12:00:00 AM,48,-122,2,1,3
1681,ElliotBayTrailMyrtlePark,03/12/2014 01:00:00 AM,48,-122,2,0,2
1682,ElliotBayTrailMyrtlePark,03/12/2014 02:00:00 AM,48,-122,1,0,1
1683,ElliotBayTrailMyrtlePark,03/12/2014 03:00:00 AM,48,-122,1,2,3
1684,ElliotBayTrailMyrtlePark,03/12/2014 04:00:00 AM,48,-122,0,0,0
1685,ElliotBayTrailMyrtlePark,03/12/2014 05:00:00 AM,48,-122,5,10,15
1686,ElliotBayTrailMyrtlePark,03/12/2014 06:00:00 AM,48,-122,19,31,50
1687,ElliotBayTrailMyrtlePark,03/12/2014 07:00:00 AM,48,-122,47,80,127
1688,ElliotBayTrailMyrtlePark,03/12/2014 08:00:00 AM,48,-122,49,143,192
1689,ElliotBayTrailMyrtlePark,03/12/2014 09:00:00 AM,48,-122,15,50,65
1690,ElliotBayTrailMyrtlePark,03/12/2014 10:00:00 AM,48,-122,17,23,40
1691,ElliotBayTrailMyrtlePark,03/12/2014 11:00:00 AM,48,-122,20,19,39
1692,ElliotBayTrailMyrtlePark,03/12/2014 12:00:00 PM,48,-122,25,20,45
1693,ElliotBayTrailMyrtlePark,03/12/2014 01:00:00 PM,48,-122,25,37,62
1694,ElliotBayTrailMyrtlePark,03/12/2014 02:00:00 PM,48,-122,38,18,56
1695,ElliotBayTrailMyrtlePark,03/12/2014 03:00:00 PM,48,-122,44,44,88
1696,ElliotBayTrailMyrtlePark,03/12/2014 04:00:00 PM,48,-122,114,77,191
1697,ElliotBayTrailMyrtlePark,03/12/2014 05:00:00 PM,48,-122,194,89,283
1698,ElliotBayTrailMyrtlePark,03/12/2014 06:00:00 PM,48,-122,127,67,194
1699,ElliotBayTrailMyrtlePark,03/12/2014 07:00:00 PM,48,-122,46,35,81
1700,ElliotBayTrailMyrtlePark,03/12/2014 08:00:00 PM,48,-122,12,4,16
1701,ElliotBayTrailMyrtlePark,03/12/2014 09:00:00 PM,48,-122,3,2,5
1702,ElliotBayTrailMyrtlePark,03/12/2014 10:00:00 PM,48,-122,1,3,4
1703,ElliotBayTrailMyrtlePark,03/12/2014 11:00:00 PM,48,-122,4,1,5
1704,ElliotBayTrailMyrtlePark,03/13/2014 12:00:00 AM,48,-122,2,0,2
1705,ElliotBayTrailMyrtlePark,03/13/2014 01:00:00 AM,48,-122,0,1,1
1706,ElliotBayTrailMyrtlePark,03/13/2014 02:00:00 AM,48,-122,0,0,0
1707,ElliotBayTrailMyrtlePark,03/13/2014 03:00:00 AM,48,-122,1,0,1
1708,ElliotBayTrailMyrtlePark,03/13/2014 04:00:00 AM,48,-122,0,1,1
1709,ElliotBayTrailMyrtlePark,03/13/2014 05:00:00 AM,48,-122,6,12,18
1710,ElliotBayTrailMyrtlePark,03/13/2014 06:00:00 AM,48,-122,21,31,52
1711,ElliotBayTrailMyrtlePark,03/13/2014 07:00:00 AM,48,-122,33,66,99
1712,ElliotBayTrailMyrtlePark,03/13/2014 08:00:00 AM,48,-122,27,108,135
1713,ElliotBayTrailMyrtlePark,03/13/2014 09:00:00 AM,48,-122,10,61,71
1714,ElliotBayTrailMyrtlePark,03/13/2014 10:00:00 AM,48,-122,13,13,26
1715,ElliotBayTrailMyrtlePark,03/13/2014 11:00:00 AM,48,-122,19,15,34
1716,ElliotBayTrailMyrtlePark,03/13/2014 12:00:00 PM,48,-122,10,15,25
1717,ElliotBayTrailMyrtlePark,03/13/2014 01:00:00 PM,48,-122,24,17,41
1718,ElliotBayTrailMyrtlePark,03/13/2014 02:00:00 PM,48,-122,25,25,50
1719,ElliotBayTrailMyrtlePark,03/13/2014 03:00:00 PM,48,-122,31,26,57
1720,ElliotBayTrailMyrtlePark,03/13/2014 04:00:00 PM,48,-122,65,47,112
1721,ElliotBayTrailMyrtlePark,03/13/2014 05:00:00 PM,48,-122,166,60,226
1722,ElliotBayTrailMyrtlePark,03/13/2014 06:00:00 PM,48,-122,93,33,126
1723,ElliotBayTrailMyrtlePark,03/13/2014 07:00:00 PM,48,-122,37,10,47
1724,ElliotBayTrailMyrtlePark,03/13/2014 08:00:00 PM,48,-122,16,1,17
1725,ElliotBayTrailMyrtlePark,03/13/2014 09:00:00 PM,48,-122,5,1,6
1726,ElliotBayTrailMyrtlePark,03/13/2014 10:00:00 PM,48,-122,3,1,4
1727,ElliotBayTrailMyrtlePark,03/13/2014 11:00:00 PM,48,-122,2,0,2
1728,ElliotBayTrailMyrtlePark,03/14/2014 12:00:00 AM,48,-122,6,0,6
1729,ElliotBayTrailMyrtlePark,03/14/2014 01:00:00 AM,48,-122,2,2,4
1730,ElliotBayTrailMyrtlePark,03/14/2014 02:00:00 AM,48,-122,0,0,0
1731,ElliotBayTrailMyrtlePark,03/14/2014 03:00:00 AM,48,-122,1,0,1
1732,ElliotBayTrailMyrtlePark,03/14/2014 04:00:00 AM,48,-122,0,0,0
1733,ElliotBayTrailMyrtlePark,03/14/2014 05:00:00 AM,48,-122,7,14,21
1734,ElliotBayTrailMyrtlePark,03/14/2014 06:00:00 AM,48,-122,14,17,31
1735,ElliotBayTrailMyrtlePark,03/14/2014 07:00:00 AM,48,-122,27,42,69
1736,ElliotBayTrailMyrtlePark,03/14/2014 08:00:00 AM,48,-122,22,60,82
1737,ElliotBayTrailMyrtlePark,03/14/2014 09:00:00 AM,48,-122,4,18,22
1738,ElliotBayTrailMyrtlePark,03/14/2014 10:00:00 AM,48,-122,9,14,23
1739,ElliotBayTrailMyrtlePark,03/14/2014 11:00:00 AM,48,-122,9,9,18
1740,ElliotBayTrailMyrtlePark,03/14/2014 12:00:00 PM,48,-122,14,11,25
1741,ElliotBayTrailMyrtlePark,03/14/2014 01:00:00 PM,48,-122,14,10,24
1742,ElliotBayTrailMyrtlePark,03/14/2014 02:00:00 PM,48,-122,14,18,32
1743,ElliotBayTrailMyrtlePark,03/14/2014 03:00:00 PM,48,-122,26,25,51
1744,ElliotBayTrailMyrtlePark,03/14/2014 04:00:00 PM,48,-122,51,32,83
1745,ElliotBayTrailMyrtlePark,03/14/2014 05:00:00 PM,48,-122,107,41,148
1746,ElliotBayTrailMyrtlePark,03/14/2014 06:00:00 PM,48,-122,66,24,90
1747,ElliotBayTrailMyrtlePark,03/14/2014 07:00:00 PM,48,-122,22,21,43
1748,ElliotBayTrailMyrtlePark,03/14/2014 08:00:00 PM,48,-122,7,7,14
1749,ElliotBayTrailMyrtlePark,03/14/2014 09:00:00 PM,48,-122,3,0,3
1750,ElliotBayTrailMyrtlePark,03/14/2014 10:00:00 PM,48,-122,2,0,2
1751,ElliotBayTrailMyrtlePark,03/14/2014 11:00:00 PM,48,-122,1,1,2
1752,ElliotBayTrailMyrtlePark,03/15/2014 12:00:00 AM,48,-122,3,0,3
1753,ElliotBayTrailMyrtlePark,03/15/2014 01:00:00 AM,48,-122,0,5,5
1754,ElliotBayTrailMyrtlePark,03/15/2014 02:00:00 AM,48,-122,1,0,1
1755,ElliotBayTrailMyrtlePark,03/15/2014 03:00:00 AM,48,-122,3,1,4
1756,ElliotBayTrailMyrtlePark,03/15/2014 04:00:00 AM,48,-122,0,2,2
1757,ElliotBayTrailMyrtlePark,03/15/2014 05:00:00 AM,48,-122,1,0,1
1758,ElliotBayTrailMyrtlePark,03/15/2014 06:00:00 AM,48,-122,0,8,8
1759,ElliotBayTrailMyrtlePark,03/15/2014 07:00:00 AM,48,-122,4,9,13
1760,ElliotBayTrailMyrtlePark,03/15/2014 08:00:00 AM,48,-122,12,7,19
1761,ElliotBayTrailMyrtlePark,03/15/2014 09:00:00 AM,48,-122,8,14,22
1762,ElliotBayTrailMyrtlePark,03/15/2014 10:00:00 AM,48,-122,12,20,32
1763,ElliotBayTrailMyrtlePark,03/15/2014 11:00:00 AM,48,-122,25,25,50
1764,ElliotBayTrailMyrtlePark,03/15/2014 12:00:00 PM,48,-122,20,44,64
1765,ElliotBayTrailMyrtlePark,03/15/2014 01:00:00 PM,48,-122,32,21,53
1766,ElliotBayTrailMyrtlePark,03/15/2014 02:00:00 PM,48,-122,19,23,42
1767,ElliotBayTrailMyrtlePark,03/15/2014 03:00:00 PM,48,-122,34,30,64
1768,ElliotBayTrailMyrtlePark,03/15/2014 04:00:00 PM,48,-122,30,22,52
1769,ElliotBayTrailMyrtlePark,03/15/2014 05:00:00 PM,48,-122,23,13,36
1770,ElliotBayTrailMyrtlePark,03/15/2014 06:00:00 PM,48,-122,10,10,20
1771,ElliotBayTrailMyrtlePark,03/15/2014 07:00:00 PM,48,-122,7,2,9
1772,ElliotBayTrailMyrtlePark,03/15/2014 08:00:00 PM,48,-122,3,1,4
1773,ElliotBayTrailMyrtlePark,03/15/2014 09:00:00 PM,48,-122,2,0,2
1774,ElliotBayTrailMyrtlePark,03/15/2014 10:00:00 PM,48,-122,2,0,2
1775,ElliotBayTrailMyrtlePark,03/15/2014 11:00:00 PM,48,-122,2,1,3
1776,ElliotBayTrailMyrtlePark,03/16/2014 12:00:00 AM,48,-122,1,1,2
1777,ElliotBayTrailMyrtlePark,03/16/2014 01:00:00 AM,48,-122,0,1,1
1778,ElliotBayTrailMyrtlePark,03/16/2014 02:00:00 AM,48,-122,1,1,2
1779,ElliotBayTrailMyrtlePark,03/16/2014 03:00:00 AM,48,-122,0,1,1
1780,ElliotBayTrailMyrtlePark,03/16/2014 04:00:00 AM,48,-122,0,0,0
1781,ElliotBayTrailMyrtlePark,03/16/2014 05:00:00 AM,48,-122,1,1,2
1782,ElliotBayTrailMyrtlePark,03/16/2014 06:00:00 AM,48,-122,1,5,6
1783,ElliotBayTrailMyrtlePark,03/16/2014 07:00:00 AM,48,-122,2,1,3
1784,ElliotBayTrailMyrtlePark,03/16/2014 08:00:00 AM,48,-122,1,0,1
1785,ElliotBayTrailMyrtlePark,03/16/2014 09:00:00 AM,48,-122,2,2,4
1786,ElliotBayTrailMyrtlePark,03/16/2014 10:00:00 AM,48,-122,3,2,5
1787,ElliotBayTrailMyrtlePark,03/16/2014 11:00:00 AM,48,-122,3,7,10
1788,ElliotBayTrailMyrtlePark,03/16/2014 12:00:00 PM,48,-122,4,6,10
1789,ElliotBayTrailMyrtlePark,03/16/2014 01:00:00 PM,48,-122,3,5,8
1790,ElliotBayTrailMyrtlePark,03/16/2014 02:00:00 PM,48,-122,4,4,8
1791,ElliotBayTrailMyrtlePark,03/16/2014 03:00:00 PM,48,-122,4,5,9
1792,ElliotBayTrailMyrtlePark,03/16/2014 04:00:00 PM,48,-122,2,2,4
1793,ElliotBayTrailMyrtlePark,03/16/2014 05:00:00 PM,48,-122,6,5,11
1794,ElliotBayTrailMyrtlePark,03/16/2014 06:00:00 PM,48,-122,5,0,5
1795,ElliotBayTrailMyrtlePark,03/16/2014 07:00:00 PM,48,-122,1,1,2
1796,ElliotBayTrailMyrtlePark,03/16/2014 08:00:00 PM,48,-122,3,1,4
1797,ElliotBayTrailMyrtlePark,03/16/2014 09:00:00 PM,48,-122,0,0,0
1798,ElliotBayTrailMyrtlePark,03/16/2014 10:00:00 PM,48,-122,0,0,0
1799,ElliotBayTrailMyrtlePark,03/16/2014 11:00:00 PM,48,-122,2,1,3
1800,ElliotBayTrailMyrtlePark,03/17/2014 12:00:00 AM,48,-122,0,0,0
1801,ElliotBayTrailMyrtlePark,03/17/2014 01:00:00 AM,48,-122,2,2,4
1802,ElliotBayTrailMyrtlePark,03/17/2014 02:00:00 AM,48,-122,1,2,3
1803,ElliotBayTrailMyrtlePark,03/17/2014 03:00:00 AM,48,-122,0,0,0
1804,ElliotBayTrailMyrtlePark,03/17/2014 04:00:00 AM,48,-122,1,2,3
1805,ElliotBayTrailMyrtlePark,03/17/2014 05:00:00 AM,48,-122,9,8,17
1806,ElliotBayTrailMyrtlePark,03/17/2014 06:00:00 AM,48,-122,20,22,42
1807,ElliotBayTrailMyrtlePark,03/17/2014 07:00:00 AM,48,-122,27,63,90
1808,ElliotBayTrailMyrtlePark,03/17/2014 08:00:00 AM,48,-122,32,100,132
1809,ElliotBayTrailMyrtlePark,03/17/2014 09:00:00 AM,48,-122,9,43,52
1810,ElliotBayTrailMyrtlePark,03/17/2014 10:00:00 AM,48,-122,9,24,33
1811,ElliotBayTrailMyrtlePark,03/17/2014 11:00:00 AM,48,-122,24,13,37
1812,ElliotBayTrailMyrtlePark,03/17/2014 12:00:00 PM,48,-122,10,23,33
1813,ElliotBayTrailMyrtlePark,03/17/2014 01:00:00 PM,48,-122,11,12,23
1814,ElliotBayTrailMyrtlePark,03/17/2014 02:00:00 PM,48,-122,20,18,38
1815,ElliotBayTrailMyrtlePark,03/17/2014 03:00:00 PM,48,-122,17,27,44
1816,ElliotBayTrailMyrtlePark,03/17/2014 04:00:00 PM,48,-122,44,34,78
1817,ElliotBayTrailMyrtlePark,03/17/2014 05:00:00 PM,48,-122,137,50,187
1818,ElliotBayTrailMyrtlePark,03/17/2014 06:00:00 PM,48,-122,90,36,126
1819,ElliotBayTrailMyrtlePark,03/17/2014 07:00:00 PM,48,-122,27,10,37
1820,ElliotBayTrailMyrtlePark,03/17/2014 08:00:00 PM,48,-122,6,5,11
1821,ElliotBayTrailMyrtlePark,03/17/2014 09:00:00 PM,48,-122,3,0,3
1822,ElliotBayTrailMyrtlePark,03/17/2014 10:00:00 PM,48,-122,5,2,7
1823,ElliotBayTrailMyrtlePark,03/17/2014 11:00:00 PM,48,-122,2,0,2
1824,ElliotBayTrailMyrtlePark,03/18/2014 12:00:00 AM,48,-122,3,1,4
1825,ElliotBayTrailMyrtlePark,03/18/2014 01:00:00 AM,48,-122,0,1,1
1826,ElliotBayTrailMyrtlePark,03/18/2014 02:00:00 AM,48,-122,3,2,5
1827,ElliotBayTrailMyrtlePark,03/18/2014 03:00:00 AM,48,-122,1,1,2
1828,ElliotBayTrailMyrtlePark,03/18/2014 04:00:00 AM,48,-122,0,0,0
1829,ElliotBayTrailMyrtlePark,03/18/2014 05:00:00 AM,48,-122,5,12,17
1830,ElliotBayTrailMyrtlePark,03/18/2014 06:00:00 AM,48,-122,17,24,41
1831,ElliotBayTrailMyrtlePark,03/18/2014 07:00:00 AM,48,-122,44,85,129
1832,ElliotBayTrailMyrtlePark,03/18/2014 08:00:00 AM,48,-122,33,117,150
1833,ElliotBayTrailMyrtlePark,03/18/2014 09:00:00 AM,48,-122,11,47,58
1834,ElliotBayTrailMyrtlePark,03/18/2014 10:00:00 AM,48,-122,7,30,37
1835,ElliotBayTrailMyrtlePark,03/18/2014 11:00:00 AM,48,-122,16,14,30
1836,ElliotBayTrailMyrtlePark,03/18/2014 12:00:00 PM,48,-122,7,8,15
1837,ElliotBayTrailMyrtlePark,03/18/2014 01:00:00 PM,48,-122,9,15,24
1838,ElliotBayTrailMyrtlePark,03/18/2014 02:00:00 PM,48,-122,12,19,31
1839,ElliotBayTrailMyrtlePark,03/18/2014 03:00:00 PM,48,-122,25,18,43
1840,ElliotBayTrailMyrtlePark,03/18/2014 04:00:00 PM,48,-122,61,27,88
1841,ElliotBayTrailMyrtlePark,03/18/2014 05:00:00 PM,48,-122,151,42,193
1842,ElliotBayTrailMyrtlePark,03/18/2014 06:00:00 PM,48,-122,85,29,114
1843,ElliotBayTrailMyrtlePark,03/18/2014 07:00:00 PM,48,-122,31,14,45
1844,ElliotBayTrailMyrtlePark,03/18/2014 08:00:00 PM,48,-122,9,5,14
1845,ElliotBayTrailMyrtlePark,03/18/2014 09:00:00 PM,48,-122,10,2,12
1846,ElliotBayTrailMyrtlePark,03/18/2014 10:00:00 PM,48,-122,0,3,3
1847,ElliotBayTrailMyrtlePark,03/18/2014 11:00:00 PM,48,-122,4,3,7
1848,ElliotBayTrailMyrtlePark,03/19/2014 12:00:00 AM,48,-122,1,2,3
1849,ElliotBayTrailMyrtlePark,03/19/2014 01:00:00 AM,48,-122,2,3,5
1850,ElliotBayTrailMyrtlePark,03/19/2014 02:00:00 AM,48,-122,1,1,2
1851,ElliotBayTrailMyrtlePark,03/19/2014 03:00:00 AM,48,-122,1,0,1
1852,ElliotBayTrailMyrtlePark,03/19/2014 04:00:00 AM,48,-122,0,0,0
1853,ElliotBayTrailMyrtlePark,03/19/2014 05:00:00 AM,48,-122,6,10,16
1854,ElliotBayTrailMyrtlePark,03/19/2014 06:00:00 AM,48,-122,16,25,41
1855,ElliotBayTrailMyrtlePark,03/19/2014 07:00:00 AM,48,-122,28,57,85
1856,ElliotBayTrailMyrtlePark,03/19/2014 08:00:00 AM,48,-122,32,68,100
1857,ElliotBayTrailMyrtlePark,03/19/2014 09:00:00 AM,48,-122,17,40,57
1858,ElliotBayTrailMyrtlePark,03/19/2014 10:00:00 AM,48,-122,6,12,18
1859,ElliotBayTrailMyrtlePark,03/19/2014 11:00:00 AM,48,-122,4,4,8
1860,ElliotBayTrailMyrtlePark,03/19/2014 12:00:00 PM,48,-122,3,7,10
1861,ElliotBayTrailMyrtlePark,03/19/2014 01:00:00 PM,48,-122,4,6,10
1862,ElliotBayTrailMyrtlePark,03/19/2014 02:00:00 PM,48,-122,11,13,24
1863,ElliotBayTrailMyrtlePark,03/19/2014 03:00:00 PM,48,-122,16,15,31
1864,ElliotBayTrailMyrtlePark,03/19/2014 04:00:00 PM,48,-122,47,36,83
1865,ElliotBayTrailMyrtlePark,03/19/2014 05:00:00 PM,48,-122,109,26,135
1866,ElliotBayTrailMyrtlePark,03/19/2014 06:00:00 PM,48,-122,66,18,84
1867,ElliotBayTrailMyrtlePark,03/19/2014 07:00:00 PM,48,-122,23,15,38
1868,ElliotBayTrailMyrtlePark,03/19/2014 08:00:00 PM,48,-122,3,4,7
1869,ElliotBayTrailMyrtlePark,03/19/2014 09:00:00 PM,48,-122,2,0,2
1870,ElliotBayTrailMyrtlePark,03/19/2014 10:00:00 PM,48,-122,0,1,1
1871,ElliotBayTrailMyrtlePark,03/19/2014 11:00:00 PM,48,-122,5,2,7
1872,ElliotBayTrailMyrtlePark,03/20/2014 12:00:00 AM,48,-122,0,0,0
1873,ElliotBayTrailMyrtlePark,03/20/2014 01:00:00 AM,48,-122,0,0,0
1874,ElliotBayTrailMyrtlePark,03/20/2014 02:00:00 AM,48,-122,3,1,4
1875,ElliotBayTrailMyrtlePark,03/20/2014 03:00:00 AM,48,-122,1,1,2
1876,ElliotBayTrailMyrtlePark,03/20/2014 04:00:00 AM,48,-122,0,0,0
1877,ElliotBayTrailMyrtlePark,03/20/2014 05:00:00 AM,48,-122,6,11,17
1878,ElliotBayTrailMyrtlePark,03/20/2014 06:00:00 AM,48,-122,13,23,36
1879,ElliotBayTrailMyrtlePark,03/20/2014 07:00:00 AM,48,-122,33,63,96
1880,ElliotBayTrailMyrtlePark,03/20/2014 08:00:00 AM,48,-122,36,109,145
1881,ElliotBayTrailMyrtlePark,03/20/2014 09:00:00 AM,48,-122,11,55,66
1882,ElliotBayTrailMyrtlePark,03/20/2014 10:00:00 AM,48,-122,5,16,21
1883,ElliotBayTrailMyrtlePark,03/20/2014 11:00:00 AM,48,-122,9,5,14
1884,ElliotBayTrailMyrtlePark,03/20/2014 12:00:00 PM,48,-122,12,10,22
1885,ElliotBayTrailMyrtlePark,03/20/2014 01:00:00 PM,48,-122,15,13,28
1886,ElliotBayTrailMyrtlePark,03/20/2014 02:00:00 PM,48,-122,26,24,50
1887,ElliotBayTrailMyrtlePark,03/20/2014 03:00:00 PM,48,-122,36,40,76
1888,ElliotBayTrailMyrtlePark,03/20/2014 04:00:00 PM,48,-122,50,53,103
1889,ElliotBayTrailMyrtlePark,03/20/2014 05:00:00 PM,48,-122,148,45,193
1890,ElliotBayTrailMyrtlePark,03/20/2014 06:00:00 PM,48,-122,79,28,107
1891,ElliotBayTrailMyrtlePark,03/20/2014 07:00:00 PM,48,-122,32,19,51
1892,ElliotBayTrailMyrtlePark,03/20/2014 08:00:00 PM,48,-122,17,6,23
1893,ElliotBayTrailMyrtlePark,03/20/2014 09:00:00 PM,48,-122,1,1,2
1894,ElliotBayTrailMyrtlePark,03/20/2014 10:00:00 PM,48,-122,1,2,3
1895,ElliotBayTrailMyrtlePark,03/20/2014 11:00:00 PM,48,-122,0,0,0
1896,ElliotBayTrailMyrtlePark,03/21/2014 12:00:00 AM,48,-122,5,0,5
1897,ElliotBayTrailMyrtlePark,03/21/2014 01:00:00 AM,48,-122,0,0,0
1898,ElliotBayTrailMyrtlePark,03/21/2014 02:00:00 AM,48,-122,0,0,0
1899,ElliotBayTrailMyrtlePark,03/21/2014 03:00:00 AM,48,-122,0,1,1
1900,ElliotBayTrailMyrtlePark,03/21/2014 04:00:00 AM,48,-122,0,0,0
1901,ElliotBayTrailMyrtlePark,03/21/2014 05:00:00 AM,48,-122,8,14,22
1902,ElliotBayTrailMyrtlePark,03/21/2014 06:00:00 AM,48,-122,14,23,37
1903,ElliotBayTrailMyrtlePark,03/21/2014 07:00:00 AM,48,-122,33,66,99
1904,ElliotBayTrailMyrtlePark,03/21/2014 08:00:00 AM,48,-122,34,87,121
1905,ElliotBayTrailMyrtlePark,03/21/2014 09:00:00 AM,48,-122,11,51,62
1906,ElliotBayTrailMyrtlePark,03/21/2014 10:00:00 AM,48,-122,12,16,28
1907,ElliotBayTrailMyrtlePark,03/21/2014 11:00:00 AM,48,-122,12,15,27
1908,ElliotBayTrailMyrtlePark,03/21/2014 12:00:00 PM,48,-122,27,13,40
1909,ElliotBayTrailMyrtlePark,03/21/2014 01:00:00 PM,48,-122,24,24,48
1910,ElliotBayTrailMyrtlePark,03/21/2014 02:00:00 PM,48,-122,23,22,45
1911,ElliotBayTrailMyrtlePark,03/21/2014 03:00:00 PM,48,-122,26,26,52
1912,ElliotBayTrailMyrtlePark,03/21/2014 04:00:00 PM,48,-122,73,49,122
1913,ElliotBayTrailMyrtlePark,03/21/2014 05:00:00 PM,48,-122,130,52,182
1914,ElliotBayTrailMyrtlePark,03/21/2014 06:00:00 PM,48,-122,88,37,125
1915,ElliotBayTrailMyrtlePark,03/21/2014 07:00:00 PM,48,-122,28,18,46
1916,ElliotBayTrailMyrtlePark,03/21/2014 08:00:00 PM,48,-122,7,6,13
1917,ElliotBayTrailMyrtlePark,03/21/2014 09:00:00 PM,48,-122,3,0,3
1918,ElliotBayTrailMyrtlePark,03/21/2014 10:00:00 PM,48,-122,3,1,4
1919,ElliotBayTrailMyrtlePark,03/21/2014 11:00:00 PM,48,-122,3,0,3
1920,ElliotBayTrailMyrtlePark,03/22/2014 12:00:00 AM,48,-122,2,0,2
1921,ElliotBayTrailMyrtlePark,03/22/2014 01:00:00 AM,48,-122,4,0,4
1922,ElliotBayTrailMyrtlePark,03/22/2014 02:00:00 AM,48,-122,0,0,0
1923,ElliotBayTrailMyrtlePark,03/22/2014 03:00:00 AM,48,-122,0,0,0
1924,ElliotBayTrailMyrtlePark,03/22/2014 04:00:00 AM,48,-122,0,0,0
1925,ElliotBayTrailMyrtlePark,03/22/2014 05:00:00 AM,48,-122,2,3,5
1926,ElliotBayTrailMyrtlePark,03/22/2014 06:00:00 AM,48,-122,0,4,4
1927,ElliotBayTrailMyrtlePark,03/22/2014 07:00:00 AM,48,-122,10,7,17
1928,ElliotBayTrailMyrtlePark,03/22/2014 08:00:00 AM,48,-122,8,16,24
1929,ElliotBayTrailMyrtlePark,03/22/2014 09:00:00 AM,48,-122,13,14,27
1930,ElliotBayTrailMyrtlePark,03/22/2014 10:00:00 AM,48,-122,33,33,66
1931,ElliotBayTrailMyrtlePark,03/22/2014 11:00:00 AM,48,-122,39,34,73
1932,ElliotBayTrailMyrtlePark,03/22/2014 12:00:00 PM,48,-122,21,29,50
1933,ElliotBayTrailMyrtlePark,03/22/2014 01:00:00 PM,48,-122,23,26,49
1934,ElliotBayTrailMyrtlePark,03/22/2014 02:00:00 PM,48,-122,44,27,71
1935,ElliotBayTrailMyrtlePark,03/22/2014 03:00:00 PM,48,-122,32,37,69
1936,ElliotBayTrailMyrtlePark,03/22/2014 04:00:00 PM,48,-122,31,34,65
1937,ElliotBayTrailMyrtlePark,03/22/2014 05:00:00 PM,48,-122,33,27,60
1938,ElliotBayTrailMyrtlePark,03/22/2014 06:00:00 PM,48,-122,17,17,34
1939,ElliotBayTrailMyrtlePark,03/22/2014 07:00:00 PM,48,-122,7,7,14
1940,ElliotBayTrailMyrtlePark,03/22/2014 08:00:00 PM,48,-122,13,5,18
1941,ElliotBayTrailMyrtlePark,03/22/2014 09:00:00 PM,48,-122,5,2,7
1942,ElliotBayTrailMyrtlePark,03/22/2014 10:00:00 PM,48,-122,7,8,15
1943,ElliotBayTrailMyrtlePark,03/22/2014 11:00:00 PM,48,-122,2,0,2
1944,ElliotBayTrailMyrtlePark,03/23/2014 12:00:00 AM,48,-122,0,1,1
1945,ElliotBayTrailMyrtlePark,03/23/2014 01:00:00 AM,48,-122,2,0,2
1946,ElliotBayTrailMyrtlePark,03/23/2014 02:00:00 AM,48,-122,2,0,2
1947,ElliotBayTrailMyrtlePark,03/23/2014 03:00:00 AM,48,-122,0,0,0
1948,ElliotBayTrailMyrtlePark,03/23/2014 04:00:00 AM,48,-122,0,0,0
1949,ElliotBayTrailMyrtlePark,03/23/2014 05:00:00 AM,48,-122,0,0,0
1950,ElliotBayTrailMyrtlePark,03/23/2014 06:00:00 AM,48,-122,0,3,3
1951,ElliotBayTrailMyrtlePark,03/23/2014 07:00:00 AM,48,-122,3,3,6
1952,ElliotBayTrailMyrtlePark,03/23/2014 08:00:00 AM,48,-122,4,7,11
1953,ElliotBayTrailMyrtlePark,03/23/2014 09:00:00 AM,48,-122,17,21,38
1954,ElliotBayTrailMyrtlePark,03/23/2014 10:00:00 AM,48,-122,17,45,62
1955,ElliotBayTrailMyrtlePark,03/23/2014 11:00:00 AM,48,-122,52,46,98
1956,ElliotBayTrailMyrtlePark,03/23/2014 12:00:00 PM,48,-122,55,47,102
1957,ElliotBayTrailMyrtlePark,03/23/2014 01:00:00 PM,48,-122,70,78,148
1958,ElliotBayTrailMyrtlePark,03/23/2014 02:00:00 PM,48,-122,76,70,146
1959,ElliotBayTrailMyrtlePark,03/23/2014 03:00:00 PM,48,-122,66,54,120
1960,ElliotBayTrailMyrtlePark,03/23/2014 04:00:00 PM,48,-122,64,73,137
1961,ElliotBayTrailMyrtlePark,03/23/2014 05:00:00 PM,48,-122,50,38,88
1962,ElliotBayTrailMyrtlePark,03/23/2014 06:00:00 PM,48,-122,25,20,45
1963,ElliotBayTrailMyrtlePark,03/23/2014 07:00:00 PM,48,-122,24,18,42
1964,ElliotBayTrailMyrtlePark,03/23/2014 08:00:00 PM,48,-122,4,6,10
1965,ElliotBayTrailMyrtlePark,03/23/2014 09:00:00 PM,48,-122,2,0,2
1966,ElliotBayTrailMyrtlePark,03/23/2014 10:00:00 PM,48,-122,3,1,4
1967,ElliotBayTrailMyrtlePark,03/23/2014 11:00:00 PM,48,-122,1,1,2
1968,ElliotBayTrailMyrtlePark,03/24/2014 12:00:00 AM,48,-122,4,0,4
1969,ElliotBayTrailMyrtlePark,03/24/2014 01:00:00 AM,48,-122,1,0,1
1970,ElliotBayTrailMyrtlePark,03/24/2014 02:00:00 AM,48,-122,1,1,2
1971,ElliotBayTrailMyrtlePark,03/24/2014 03:00:00 AM,48,-122,0,0,0
1972,ElliotBayTrailMyrtlePark,03/24/2014 04:00:00 AM,48,-122,1,1,2
1973,ElliotBayTrailMyrtlePark,03/24/2014 05:00:00 AM,48,-122,6,11,17
1974,ElliotBayTrailMyrtlePark,03/24/2014 06:00:00 AM,48,-122,15,27,42
1975,ElliotBayTrailMyrtlePark,03/24/2014 07:00:00 AM,48,-122,43,84,127
1976,ElliotBayTrailMyrtlePark,03/24/2014 08:00:00 AM,48,-122,28,114,142
1977,ElliotBayTrailMyrtlePark,03/24/2014 09:00:00 AM,48,-122,18,56,74
1978,ElliotBayTrailMyrtlePark,03/24/2014 10:00:00 AM,48,-122,14,24,38
1979,ElliotBayTrailMyrtlePark,03/24/2014 11:00:00 AM,48,-122,12,18,30
1980,ElliotBayTrailMyrtlePark,03/24/2014 12:00:00 PM,48,-122,14,29,43
1981,ElliotBayTrailMyrtlePark,03/24/2014 01:00:00 PM,48,-122,30,28,58
1982,ElliotBayTrailMyrtlePark,03/24/2014 02:00:00 PM,48,-122,27,34,61
1983,ElliotBayTrailMyrtlePark,03/24/2014 03:00:00 PM,48,-122,53,36,89
1984,ElliotBayTrailMyrtlePark,03/24/2014 04:00:00 PM,48,-122,103,74,177
1985,ElliotBayTrailMyrtlePark,03/24/2014 05:00:00 PM,48,-122,177,80,257
1986,ElliotBayTrailMyrtlePark,03/24/2014 06:00:00 PM,48,-122,124,49,173
1987,ElliotBayTrailMyrtlePark,03/24/2014 07:00:00 PM,48,-122,34,28,62
1988,ElliotBayTrailMyrtlePark,03/24/2014 08:00:00 PM,48,-122,14,17,31
1989,ElliotBayTrailMyrtlePark,03/24/2014 09:00:00 PM,48,-122,3,1,4
1990,ElliotBayTrailMyrtlePark,03/24/2014 10:00:00 PM,48,-122,2,3,5
1991,ElliotBayTrailMyrtlePark,03/24/2014 11:00:00 PM,48,-122,4,2,6
1992,ElliotBayTrailMyrtlePark,03/25/2014 12:00:00 AM,48,-122,0,0,0
1993,ElliotBayTrailMyrtlePark,03/25/2014 01:00:00 AM,48,-122,3,0,3
1994,ElliotBayTrailMyrtlePark,03/25/2014 02:00:00 AM,48,-122,2,1,3
1995,ElliotBayTrailMyrtlePark,03/25/2014 03:00:00 AM,48,-122,1,1,2
1996,ElliotBayTrailMyrtlePark,03/25/2014 04:00:00 AM,48,-122,0,0,0
1997,ElliotBayTrailMyrtlePark,03/25/2014 05:00:00 AM,48,-122,10,11,21
1998,ElliotBayTrailMyrtlePark,03/25/2014 06:00:00 AM,48,-122,9,28,37
1999,ElliotBayTrailMyrtlePark,03/25/2014 07:00:00 AM,48,-122,37,67,104
2000,ElliotBayTrailMyrtlePark,03/25/2014 08:00:00 AM,48,-122,27,81,108
2001,ElliotBayTrailMyrtlePark,03/25/2014 09:00:00 AM,48,-122,13,42,55
2002,ElliotBayTrailMyrtlePark,03/25/2014 10:00:00 AM,48,-122,2,5,7
2003,ElliotBayTrailMyrtlePark,03/25/2014 11:00:00 AM,48,-122,8,8,16
2004,ElliotBayTrailMyrtlePark,03/25/2014 12:00:00 PM,48,-122,5,8,13
2005,ElliotBayTrailMyrtlePark,03/25/2014 01:00:00 PM,48,-122,2,7,9
2006,ElliotBayTrailMyrtlePark,03/25/2014 02:00:00 PM,48,-122,9,8,17
2007,ElliotBayTrailMyrtlePark,03/25/2014 03:00:00 PM,48,-122,15,21,36
2008,ElliotBayTrailMyrtlePark,03/25/2014 04:00:00 PM,48,-122,38,24,62
2009,ElliotBayTrailMyrtlePark,03/25/2014 05:00:00 PM,48,-122,110,36,146
2010,ElliotBayTrailMyrtlePark,03/25/2014 06:00:00 PM,48,-122,61,11,72
2011,ElliotBayTrailMyrtlePark,03/25/2014 07:00:00 PM,48,-122,29,13,42
2012,ElliotBayTrailMyrtlePark,03/25/2014 08:00:00 PM,48,-122,1,1,2
2013,ElliotBayTrailMyrtlePark,03/25/2014 09:00:00 PM,48,-122,5,0,5
2014,ElliotBayTrailMyrtlePark,03/25/2014 10:00:00 PM,48,-122,2,0,2
2015,ElliotBayTrailMyrtlePark,03/25/2014 11:00:00 PM,48,-122,1,2,3
2016,ElliotBayTrailMyrtlePark,03/26/2014 12:00:00 AM,48,-122,1,1,2
2017,ElliotBayTrailMyrtlePark,03/26/2014 01:00:00 AM,48,-122,3,0,3
2018,ElliotBayTrailMyrtlePark,03/26/2014 02:00:00 AM,48,-122,1,0,1
2019,ElliotBayTrailMyrtlePark,03/26/2014 03:00:00 AM,48,-122,1,1,2
2020,ElliotBayTrailMyrtlePark,03/26/2014 04:00:00 AM,48,-122,0,1,1
2021,ElliotBayTrailMyrtlePark,03/26/2014 05:00:00 AM,48,-122,10,7,17
2022,ElliotBayTrailMyrtlePark,03/26/2014 06:00:00 AM,48,-122,24,22,46
2023,ElliotBayTrailMyrtlePark,03/26/2014 07:00:00 AM,48,-122,44,63,107
2024,ElliotBayTrailMyrtlePark,03/26/2014 08:00:00 AM,48,-122,31,91,122
2025,ElliotBayTrailMyrtlePark,03/26/2014 09:00:00 AM,48,-122,13,43,56
2026,ElliotBayTrailMyrtlePark,03/26/2014 10:00:00 AM,48,-122,10,12,22
2027,ElliotBayTrailMyrtlePark,03/26/2014 11:00:00 AM,48,-122,3,8,11
2028,ElliotBayTrailMyrtlePark,03/26/2014 12:00:00 PM,48,-122,7,5,12
2029,ElliotBayTrailMyrtlePark,03/26/2014 01:00:00 PM,48,-122,6,7,13
2030,ElliotBayTrailMyrtlePark,03/26/2014 02:00:00 PM,48,-122,13,13,26
2031,ElliotBayTrailMyrtlePark,03/26/2014 03:00:00 PM,48,-122,14,14,28
2032,ElliotBayTrailMyrtlePark,03/26/2014 04:00:00 PM,48,-122,45,29,74
2033,ElliotBayTrailMyrtlePark,03/26/2014 05:00:00 PM,48,-122,107,34,141
2034,ElliotBayTrailMyrtlePark,03/26/2014 06:00:00 PM,48,-122,58,11,69
2035,ElliotBayTrailMyrtlePark,03/26/2014 07:00:00 PM,48,-122,23,11,34
2036,ElliotBayTrailMyrtlePark,03/26/2014 08:00:00 PM,48,-122,4,2,6
2037,ElliotBayTrailMyrtlePark,03/26/2014 09:00:00 PM,48,-122,1,1,2
2038,ElliotBayTrailMyrtlePark,03/26/2014 10:00:00 PM,48,-122,7,1,8
2039,ElliotBayTrailMyrtlePark,03/26/2014 11:00:00 PM,48,-122,2,1,3
2040,ElliotBayTrailMyrtlePark,03/27/2014 12:00:00 AM,48,-122,0,1,1
2041,ElliotBayTrailMyrtlePark,03/27/2014 01:00:00 AM,48,-122,0,0,0
2042,ElliotBayTrailMyrtlePark,03/27/2014 02:00:00 AM,48,-122,4,1,5
2043,ElliotBayTrailMyrtlePark,03/27/2014 03:00:00 AM,48,-122,1,2,3
2044,ElliotBayTrailMyrtlePark,03/27/2014 04:00:00 AM,48,-122,0,0,0
2045,ElliotBayTrailMyrtlePark,03/27/2014 05:00:00 AM,48,-122,10,17,27
2046,ElliotBayTrailMyrtlePark,03/27/2014 06:00:00 AM,48,-122,11,28,39
2047,ElliotBayTrailMyrtlePark,03/27/2014 07:00:00 AM,48,-122,38,57,95
2048,ElliotBayTrailMyrtlePark,03/27/2014 08:00:00 AM,48,-122,20,74,94
2049,ElliotBayTrailMyrtlePark,03/27/2014 09:00:00 AM,48,-122,9,42,51
2050,ElliotBayTrailMyrtlePark,03/27/2014 10:00:00 AM,48,-122,6,14,20
2051,ElliotBayTrailMyrtlePark,03/27/2014 11:00:00 AM,48,-122,8,8,16
2052,ElliotBayTrailMyrtlePark,03/27/2014 12:00:00 PM,48,-122,8,8,16
2053,ElliotBayTrailMyrtlePark,03/27/2014 01:00:00 PM,48,-122,20,11,31
2054,ElliotBayTrailMyrtlePark,03/27/2014 02:00:00 PM,48,-122,18,28,46
2055,ElliotBayTrailMyrtlePark,03/27/2014 03:00:00 PM,48,-122,17,24,41
2056,ElliotBayTrailMyrtlePark,03/27/2014 04:00:00 PM,48,-122,47,35,82
2057,ElliotBayTrailMyrtlePark,03/27/2014 05:00:00 PM,48,-122,114,57,171
2058,ElliotBayTrailMyrtlePark,03/27/2014 06:00:00 PM,48,-122,75,26,101
2059,ElliotBayTrailMyrtlePark,03/27/2014 07:00:00 PM,48,-122,29,18,47
2060,ElliotBayTrailMyrtlePark,03/27/2014 08:00:00 PM,48,-122,13,4,17
2061,ElliotBayTrailMyrtlePark,03/27/2014 09:00:00 PM,48,-122,7,0,7
2062,ElliotBayTrailMyrtlePark,03/27/2014 10:00:00 PM,48,-122,3,0,3
2063,ElliotBayTrailMyrtlePark,03/27/2014 11:00:00 PM,48,-122,3,0,3
2064,ElliotBayTrailMyrtlePark,03/28/2014 12:00:00 AM,48,-122,2,0,2
2065,ElliotBayTrailMyrtlePark,03/28/2014 01:00:00 AM,48,-122,3,0,3
2066,ElliotBayTrailMyrtlePark,03/28/2014 02:00:00 AM,48,-122,0,0,0
2067,ElliotBayTrailMyrtlePark,03/28/2014 03:00:00 AM,48,-122,0,0,0
2068,ElliotBayTrailMyrtlePark,03/28/2014 04:00:00 AM,48,-122,0,0,0
2069,ElliotBayTrailMyrtlePark,03/28/2014 05:00:00 AM,48,-122,8,16,24
2070,ElliotBayTrailMyrtlePark,03/28/2014 06:00:00 AM,48,-122,6,17,23
2071,ElliotBayTrailMyrtlePark,03/28/2014 07:00:00 AM,48,-122,20,44,64
2072,ElliotBayTrailMyrtlePark,03/28/2014 08:00:00 AM,48,-122,21,51,72
2073,ElliotBayTrailMyrtlePark,03/28/2014 09:00:00 AM,48,-122,6,27,33
2074,ElliotBayTrailMyrtlePark,03/28/2014 10:00:00 AM,48,-122,3,10,13
2075,ElliotBayTrailMyrtlePark,03/28/2014 11:00:00 AM,48,-122,3,1,4
2076,ElliotBayTrailMyrtlePark,03/28/2014 12:00:00 PM,48,-122,4,8,12
2077,ElliotBayTrailMyrtlePark,03/28/2014 01:00:00 PM,48,-122,2,4,6
2078,ElliotBayTrailMyrtlePark,03/28/2014 02:00:00 PM,48,-122,6,4,10
2079,ElliotBayTrailMyrtlePark,03/28/2014 03:00:00 PM,48,-122,12,12,24
2080,ElliotBayTrailMyrtlePark,03/28/2014 04:00:00 PM,48,-122,29,18,47
2081,ElliotBayTrailMyrtlePark,03/28/2014 05:00:00 PM,48,-122,80,26,106
2082,ElliotBayTrailMyrtlePark,03/28/2014 06:00:00 PM,48,-122,47,8,55
2083,ElliotBayTrailMyrtlePark,03/28/2014 07:00:00 PM,48,-122,19,11,30
2084,ElliotBayTrailMyrtlePark,03/28/2014 08:00:00 PM,48,-122,9,4,13
2085,ElliotBayTrailMyrtlePark,03/28/2014 09:00:00 PM,48,-122,2,5,7
2086,ElliotBayTrailMyrtlePark,03/28/2014 10:00:00 PM,48,-122,3,0,3
2087,ElliotBayTrailMyrtlePark,03/28/2014 11:00:00 PM,48,-122,0,0,0
2088,ElliotBayTrailMyrtlePark,03/29/2014 12:00:00 AM,48,-122,3,0,3
2089,ElliotBayTrailMyrtlePark,03/29/2014 01:00:00 AM,48,-122,1,0,1
2090,ElliotBayTrailMyrtlePark,03/29/2014 02:00:00 AM,48,-122,1,1,2
2091,ElliotBayTrailMyrtlePark,03/29/2014 03:00:00 AM,48,-122,0,0,0
2092,ElliotBayTrailMyrtlePark,03/29/2014 04:00:00 AM,48,-122,0,0,0
2093,ElliotBayTrailMyrtlePark,03/29/2014 05:00:00 AM,48,-122,0,0,0
2094,ElliotBayTrailMyrtlePark,03/29/2014 06:00:00 AM,48,-122,2,3,5
2095,ElliotBayTrailMyrtlePark,03/29/2014 07:00:00 AM,48,-122,3,2,5
2096,ElliotBayTrailMyrtlePark,03/29/2014 08:00:00 AM,48,-122,4,4,8
2097,ElliotBayTrailMyrtlePark,03/29/2014 09:00:00 AM,48,-122,2,3,5
2098,ElliotBayTrailMyrtlePark,03/29/2014 10:00:00 AM,48,-122,5,5,10
2099,ElliotBayTrailMyrtlePark,03/29/2014 11:00:00 AM,48,-122,12,12,24
2100,ElliotBayTrailMyrtlePark,03/29/2014 12:00:00 PM,48,-122,5,2,7
2101,ElliotBayTrailMyrtlePark,03/29/2014 01:00:00 PM,48,-122,6,13,19
2102,ElliotBayTrailMyrtlePark,03/29/2014 02:00:00 PM,48,-122,8,7,15
2103,ElliotBayTrailMyrtlePark,03/29/2014 03:00:00 PM,48,-122,11,6,17
2104,ElliotBayTrailMyrtlePark,03/29/2014 04:00:00 PM,48,-122,7,8,15
2105,ElliotBayTrailMyrtlePark,03/29/2014 05:00:00 PM,48,-122,8,6,14
2106,ElliotBayTrailMyrtlePark,03/29/2014 06:00:00 PM,48,-122,3,5,8
2107,ElliotBayTrailMyrtlePark,03/29/2014 07:00:00 PM,48,-122,4,1,5
2108,ElliotBayTrailMyrtlePark,03/29/2014 08:00:00 PM,48,-122,2,0,2
2109,ElliotBayTrailMyrtlePark,03/29/2014 09:00:00 PM,48,-122,1,0,1
2110,ElliotBayTrailMyrtlePark,03/29/2014 10:00:00 PM,48,-122,0,0,0
2111,ElliotBayTrailMyrtlePark,03/29/2014 11:00:00 PM,48,-122,4,2,6
2112,ElliotBayTrailMyrtlePark,03/30/2014 12:00:00 AM,48,-122,2,0,2
2113,ElliotBayTrailMyrtlePark,03/30/2014 01:00:00 AM,48,-122,0,0,0
2114,ElliotBayTrailMyrtlePark,03/30/2014 02:00:00 AM,48,-122,0,0,0
2115,ElliotBayTrailMyrtlePark,03/30/2014 03:00:00 AM,48,-122,0,0,0
2116,ElliotBayTrailMyrtlePark,03/30/2014 04:00:00 AM,48,-122,0,0,0
2117,ElliotBayTrailMyrtlePark,03/30/2014 05:00:00 AM,48,-122,0,0,0
2118,ElliotBayTrailMyrtlePark,03/30/2014 06:00:00 AM,48,-122,0,3,3
2119,ElliotBayTrailMyrtlePark,03/30/2014 07:00:00 AM,48,-122,4,2,6
2120,ElliotBayTrailMyrtlePark,03/30/2014 08:00:00 AM,48,-122,8,9,17
2121,ElliotBayTrailMyrtlePark,03/30/2014 09:00:00 AM,48,-122,10,15,25
2122,ElliotBayTrailMyrtlePark,03/30/2014 10:00:00 AM,48,-122,23,9,32
2123,ElliotBayTrailMyrtlePark,03/30/2014 11:00:00 AM,48,-122,19,27,46
2124,ElliotBayTrailMyrtlePark,03/30/2014 12:00:00 PM,48,-122,30,28,58
2125,ElliotBayTrailMyrtlePark,03/30/2014 01:00:00 PM,48,-122,28,26,54
2126,ElliotBayTrailMyrtlePark,03/30/2014 02:00:00 PM,48,-122,43,40,83
2127,ElliotBayTrailMyrtlePark,03/30/2014 03:00:00 PM,48,-122,46,44,90
2128,ElliotBayTrailMyrtlePark,03/30/2014 04:00:00 PM,48,-122,45,29,74
2129,ElliotBayTrailMyrtlePark,03/30/2014 05:00:00 PM,48,-122,24,25,49
2130,ElliotBayTrailMyrtlePark,03/30/2014 06:00:00 PM,48,-122,12,5,17
2131,ElliotBayTrailMyrtlePark,03/30/2014 07:00:00 PM,48,-122,17,11,28
2132,ElliotBayTrailMyrtlePark,03/30/2014 08:00:00 PM,48,-122,10,4,14
2133,ElliotBayTrailMyrtlePark,03/30/2014 09:00:00 PM,48,-122,3,1,4
2134,ElliotBayTrailMyrtlePark,03/30/2014 10:00:00 PM,48,-122,1,2,3
2135,ElliotBayTrailMyrtlePark,03/30/2014 11:00:00 PM,48,-122,1,2,3
2136,ElliotBayTrailMyrtlePark,03/31/2014 12:00:00 AM,48,-122,0,0,0
2137,ElliotBayTrailMyrtlePark,03/31/2014 01:00:00 AM,48,-122,1,0,1
2138,ElliotBayTrailMyrtlePark,03/31/2014 02:00:00 AM,48,-122,1,2,3
2139,ElliotBayTrailMyrtlePark,03/31/2014 03:00:00 AM,48,-122,0,0,0
2140,ElliotBayTrailMyrtlePark,03/31/2014 04:00:00 AM,48,-122,2,1,3
2141,ElliotBayTrailMyrtlePark,03/31/2014 05:00:00 AM,48,-122,9,9,18
2142,ElliotBayTrailMyrtlePark,03/31/2014 06:00:00 AM,48,-122,24,27,51
2143,ElliotBayTrailMyrtlePark,03/31/2014 07:00:00 AM,48,-122,33,88,121
2144,ElliotBayTrailMyrtlePark,03/31/2014 08:00:00 AM,48,-122,21,109,130
2145,ElliotBayTrailMyrtlePark,03/31/2014 09:00:00 AM,48,-122,16,52,68
2146,ElliotBayTrailMyrtlePark,03/31/2014 10:00:00 AM,48,-122,16,22,38
2147,ElliotBayTrailMyrtlePark,03/31/2014 11:00:00 AM,48,-122,17,15,32
2148,ElliotBayTrailMyrtlePark,03/31/2014 12:00:00 PM,48,-122,17,13,30
2149,ElliotBayTrailMyrtlePark,03/31/2014 01:00:00 PM,48,-122,29,26,55
2150,ElliotBayTrailMyrtlePark,03/31/2014 02:00:00 PM,48,-122,13,26,39
2151,ElliotBayTrailMyrtlePark,03/31/2014 03:00:00 PM,48,-122,36,35,71
2152,ElliotBayTrailMyrtlePark,03/31/2014 04:00:00 PM,48,-122,73,43,116
2153,ElliotBayTrailMyrtlePark,03/31/2014 05:00:00 PM,48,-122,165,64,229
2154,ElliotBayTrailMyrtlePark,03/31/2014 06:00:00 PM,48,-122,113,47,160
2155,ElliotBayTrailMyrtlePark,03/31/2014 07:00:00 PM,48,-122,34,17,51
2156,ElliotBayTrailMyrtlePark,03/31/2014 08:00:00 PM,48,-122,8,8,16
2157,ElliotBayTrailMyrtlePark,03/31/2014 09:00:00 PM,48,-122,5,1,6
2158,ElliotBayTrailMyrtlePark,03/31/2014 10:00:00 PM,48,-122,2,2,4
2159,ElliotBayTrailMyrtlePark,03/31/2014 11:00:00 PM,48,-122,2,0,2
2160,ElliotBayTrailMyrtlePark,04/01/2014 12:00:00 AM,48,-122,1,1,2
2161,ElliotBayTrailMyrtlePark,04/01/2014 01:00:00 AM,48,-122,3,1,4
2162,ElliotBayTrailMyrtlePark,04/01/2014 02:00:00 AM,48,-122,3,1,4
2163,ElliotBayTrailMyrtlePark,04/01/2014 03:00:00 AM,48,-122,0,0,0
2164,ElliotBayTrailMyrtlePark,04/01/2014 04:00:00 AM,48,-122,0,2,2
2165,ElliotBayTrailMyrtlePark,04/01/2014 05:00:00 AM,48,-122,7,16,23
2166,ElliotBayTrailMyrtlePark,04/01/2014 06:00:00 AM,48,-122,15,19,34
2167,ElliotBayTrailMyrtlePark,04/01/2014 07:00:00 AM,48,-122,27,137,164
2168,ElliotBayTrailMyrtlePark,04/01/2014 08:00:00 AM,48,-122,26,133,159
2169,ElliotBayTrailMyrtlePark,04/01/2014 09:00:00 AM,48,-122,21,46,67
2170,ElliotBayTrailMyrtlePark,04/01/2014 10:00:00 AM,48,-122,7,20,27
2171,ElliotBayTrailMyrtlePark,04/01/2014 11:00:00 AM,48,-122,10,12,22
2172,ElliotBayTrailMyrtlePark,04/01/2014 12:00:00 PM,48,-122,13,16,29
2173,ElliotBayTrailMyrtlePark,04/01/2014 01:00:00 PM,48,-122,21,21,42
2174,ElliotBayTrailMyrtlePark,04/01/2014 02:00:00 PM,48,-122,46,35,81
2175,ElliotBayTrailMyrtlePark,04/01/2014 03:00:00 PM,48,-122,121,35,156
2176,ElliotBayTrailMyrtlePark,04/01/2014 04:00:00 PM,48,-122,200,70,270
2177,ElliotBayTrailMyrtlePark,04/01/2014 05:00:00 PM,48,-122,143,73,216
2178,ElliotBayTrailMyrtlePark,04/01/2014 06:00:00 PM,48,-122,55,34,89
2179,ElliotBayTrailMyrtlePark,04/01/2014 07:00:00 PM,48,-122,21,7,28
2180,ElliotBayTrailMyrtlePark,04/01/2014 08:00:00 PM,48,-122,8,5,13
2181,ElliotBayTrailMyrtlePark,04/01/2014 09:00:00 PM,48,-122,8,2,10
2182,ElliotBayTrailMyrtlePark,04/01/2014 10:00:00 PM,48,-122,8,2,10
2183,ElliotBayTrailMyrtlePark,04/01/2014 11:00:00 PM,48,-122,3,0,3
2184,ElliotBayTrailMyrtlePark,04/02/2014 12:00:00 AM,48,-122,1,1,2
2185,ElliotBayTrailMyrtlePark,04/02/2014 01:00:00 AM,48,-122,1,1,2
2186,ElliotBayTrailMyrtlePark,04/02/2014 02:00:00 AM,48,-122,0,0,0
2187,ElliotBayTrailMyrtlePark,04/02/2014 03:00:00 AM,48,-122,0,0,0
2188,ElliotBayTrailMyrtlePark,04/02/2014 04:00:00 AM,48,-122,9,13,22
2189,ElliotBayTrailMyrtlePark,04/02/2014 05:00:00 AM,48,-122,13,28,41
2190,ElliotBayTrailMyrtlePark,04/02/2014 06:00:00 AM,48,-122,37,88,125
2191,ElliotBayTrailMyrtlePark,04/02/2014 07:00:00 AM,48,-122,35,117,152
2192,ElliotBayTrailMyrtlePark,04/02/2014 08:00:00 AM,48,-122,8,62,70
2193,ElliotBayTrailMyrtlePark,04/02/2014 09:00:00 AM,48,-122,14,23,37
2194,ElliotBayTrailMyrtlePark,04/02/2014 10:00:00 AM,48,-122,8,11,19
2195,ElliotBayTrailMyrtlePark,04/02/2014 11:00:00 AM,48,-122,9,15,24
2196,ElliotBayTrailMyrtlePark,04/02/2014 12:00:00 PM,48,-122,16,14,30
2197,ElliotBayTrailMyrtlePark,04/02/2014 01:00:00 PM,48,-122,25,25,50
2198,ElliotBayTrailMyrtlePark,04/02/2014 02:00:00 PM,48,-122,36,33,69
2199,ElliotBayTrailMyrtlePark,04/02/2014 03:00:00 PM,48,-122,92,43,135
2200,ElliotBayTrailMyrtlePark,04/02/2014 04:00:00 PM,48,-122,187,69,256
2201,ElliotBayTrailMyrtlePark,04/02/2014 05:00:00 PM,48,-122,112,58,170
2202,ElliotBayTrailMyrtlePark,04/02/2014 06:00:00 PM,48,-122,45,23,68
2203,ElliotBayTrailMyrtlePark,04/02/2014 07:00:00 PM,48,-122,20,15,35
2204,ElliotBayTrailMyrtlePark,04/02/2014 08:00:00 PM,48,-122,6,2,8
2205,ElliotBayTrailMyrtlePark,04/02/2014 09:00:00 PM,48,-122,10,1,11
2206,ElliotBayTrailMyrtlePark,04/02/2014 10:00:00 PM,48,-122,3,3,6
2207,ElliotBayTrailMyrtlePark,04/02/2014 11:00:00 PM,48,-122,1,0,1
2208,ElliotBayTrailMyrtlePark,04/03/2014 12:00:00 AM,48,-122,1,1,2
2209,ElliotBayTrailMyrtlePark,04/03/2014 01:00:00 AM,48,-122,2,0,2
2210,ElliotBayTrailMyrtlePark,04/03/2014 02:00:00 AM,48,-122,0,0,0
2211,ElliotBayTrailMyrtlePark,04/03/2014 03:00:00 AM,48,-122,1,1,2
2212,ElliotBayTrailMyrtlePark,04/03/2014 04:00:00 AM,48,-122,9,13,22
2213,ElliotBayTrailMyrtlePark,04/03/2014 05:00:00 AM,48,-122,9,23,32
2214,ElliotBayTrailMyrtlePark,04/03/2014 06:00:00 AM,48,-122,42,79,121
2215,ElliotBayTrailMyrtlePark,04/03/2014 07:00:00 AM,48,-122,19,96,115
2216,ElliotBayTrailMyrtlePark,04/03/2014 08:00:00 AM,48,-122,18,68,86
2217,ElliotBayTrailMyrtlePark,04/03/2014 09:00:00 AM,48,-122,24,17,41
2218,ElliotBayTrailMyrtlePark,04/03/2014 10:00:00 AM,48,-122,14,11,25
2219,ElliotBayTrailMyrtlePark,04/03/2014 11:00:00 AM,48,-122,8,9,17
2220,ElliotBayTrailMyrtlePark,04/03/2014 12:00:00 PM,48,-122,12,17,29
2221,ElliotBayTrailMyrtlePark,04/03/2014 01:00:00 PM,48,-122,14,10,24
2222,ElliotBayTrailMyrtlePark,04/03/2014 02:00:00 PM,48,-122,16,11,27
2223,ElliotBayTrailMyrtlePark,04/03/2014 03:00:00 PM,48,-122,38,28,66
2224,ElliotBayTrailMyrtlePark,04/03/2014 04:00:00 PM,48,-122,115,28,143
2225,ElliotBayTrailMyrtlePark,04/03/2014 05:00:00 PM,48,-122,65,14,79
2226,ElliotBayTrailMyrtlePark,04/03/2014 06:00:00 PM,48,-122,25,2,27
2227,ElliotBayTrailMyrtlePark,04/03/2014 07:00:00 PM,48,-122,8,1,9
2228,ElliotBayTrailMyrtlePark,04/03/2014 08:00:00 PM,48,-122,4,2,6
2229,ElliotBayTrailMyrtlePark,04/03/2014 09:00:00 PM,48,-122,5,1,6
2230,ElliotBayTrailMyrtlePark,04/03/2014 10:00:00 PM,48,-122,0,0,0
2231,ElliotBayTrailMyrtlePark,04/03/2014 11:00:00 PM,48,-122,0,1,1
2232,ElliotBayTrailMyrtlePark,04/04/2014 12:00:00 AM,48,-122,0,0,0
2233,ElliotBayTrailMyrtlePark,04/04/2014 01:00:00 AM,48,-122,3,1,4
2234,ElliotBayTrailMyrtlePark,04/04/2014 02:00:00 AM,48,-122,0,0,0
2235,ElliotBayTrailMyrtlePark,04/04/2014 03:00:00 AM,48,-122,0,0,0
2236,ElliotBayTrailMyrtlePark,04/04/2014 04:00:00 AM,48,-122,9,11,20
2237,ElliotBayTrailMyrtlePark,04/04/2014 05:00:00 AM,48,-122,9,16,25
2238,ElliotBayTrailMyrtlePark,04/04/2014 06:00:00 AM,48,-122,18,62,80
2239,ElliotBayTrailMyrtlePark,04/04/2014 07:00:00 AM,48,-122,20,92,112
2240,ElliotBayTrailMyrtlePark,04/04/2014 08:00:00 AM,48,-122,12,39,51
2241,ElliotBayTrailMyrtlePark,04/04/2014 09:00:00 AM,48,-122,9,20,29
2242,ElliotBayTrailMyrtlePark,04/04/2014 10:00:00 AM,48,-122,4,11,15
2243,ElliotBayTrailMyrtlePark,04/04/2014 11:00:00 AM,48,-122,13,12,25
2244,ElliotBayTrailMyrtlePark,04/04/2014 12:00:00 PM,48,-122,17,13,30
2245,ElliotBayTrailMyrtlePark,04/04/2014 01:00:00 PM,48,-122,25,19,44
2246,ElliotBayTrailMyrtlePark,04/04/2014 02:00:00 PM,48,-122,44,27,71
2247,ElliotBayTrailMyrtlePark,04/04/2014 03:00:00 PM,48,-122,66,30,96
2248,ElliotBayTrailMyrtlePark,04/04/2014 04:00:00 PM,48,-122,120,48,168
2249,ElliotBayTrailMyrtlePark,04/04/2014 05:00:00 PM,48,-122,75,26,101
2250,ElliotBayTrailMyrtlePark,04/04/2014 06:00:00 PM,48,-122,23,20,43
2251,ElliotBayTrailMyrtlePark,04/04/2014 07:00:00 PM,48,-122,6,9,15
2252,ElliotBayTrailMyrtlePark,04/04/2014 08:00:00 PM,48,-122,2,4,6
2253,ElliotBayTrailMyrtlePark,04/04/2014 09:00:00 PM,48,-122,7,0,7
2254,ElliotBayTrailMyrtlePark,04/04/2014 10:00:00 PM,48,-122,3,0,3
2255,ElliotBayTrailMyrtlePark,04/04/2014 11:00:00 PM,48,-122,1,1,2
2256,ElliotBayTrailMyrtlePark,04/05/2014 12:00:00 AM,48,-122,2,2,4
2257,ElliotBayTrailMyrtlePark,04/05/2014 01:00:00 AM,48,-122,0,5,5
2258,ElliotBayTrailMyrtlePark,04/05/2014 02:00:00 AM,48,-122,1,0,1
2259,ElliotBayTrailMyrtlePark,04/05/2014 03:00:00 AM,48,-122,0,0,0
2260,ElliotBayTrailMyrtlePark,04/05/2014 04:00:00 AM,48,-122,1,0,1
2261,ElliotBayTrailMyrtlePark,04/05/2014 05:00:00 AM,48,-122,2,6,8
2262,ElliotBayTrailMyrtlePark,04/05/2014 06:00:00 AM,48,-122,6,11,17
2263,ElliotBayTrailMyrtlePark,04/05/2014 07:00:00 AM,48,-122,9,11,20
2264,ElliotBayTrailMyrtlePark,04/05/2014 08:00:00 AM,48,-122,27,16,43
2265,ElliotBayTrailMyrtlePark,04/05/2014 09:00:00 AM,48,-122,19,24,43
2266,ElliotBayTrailMyrtlePark,04/05/2014 10:00:00 AM,48,-122,12,21,33
2267,ElliotBayTrailMyrtlePark,04/05/2014 11:00:00 AM,48,-122,23,17,40
2268,ElliotBayTrailMyrtlePark,04/05/2014 12:00:00 PM,48,-122,8,16,24
2269,ElliotBayTrailMyrtlePark,04/05/2014 01:00:00 PM,48,-122,12,3,15
2270,ElliotBayTrailMyrtlePark,04/05/2014 02:00:00 PM,48,-122,4,1,5
2271,ElliotBayTrailMyrtlePark,04/05/2014 03:00:00 PM,48,-122,12,7,19
2272,ElliotBayTrailMyrtlePark,04/05/2014 04:00:00 PM,48,-122,5,4,9
2273,ElliotBayTrailMyrtlePark,04/05/2014 05:00:00 PM,48,-122,8,3,11
2274,ElliotBayTrailMyrtlePark,04/05/2014 06:00:00 PM,48,-122,7,5,12
2275,ElliotBayTrailMyrtlePark,04/05/2014 07:00:00 PM,48,-122,1,4,5
2276,ElliotBayTrailMyrtlePark,04/05/2014 08:00:00 PM,48,-122,1,0,1
2277,ElliotBayTrailMyrtlePark,04/05/2014 09:00:00 PM,48,-122,2,1,3
2278,ElliotBayTrailMyrtlePark,04/05/2014 10:00:00 PM,48,-122,2,1,3
2279,ElliotBayTrailMyrtlePark,04/05/2014 11:00:00 PM,48,-122,0,0,0
2280,ElliotBayTrailMyrtlePark,04/06/2014 12:00:00 AM,48,-122,1,1,2
2281,ElliotBayTrailMyrtlePark,04/06/2014 01:00:00 AM,48,-122,2,0,2
2282,ElliotBayTrailMyrtlePark,04/06/2014 02:00:00 AM,48,-122,0,0,0
2283,ElliotBayTrailMyrtlePark,04/06/2014 03:00:00 AM,48,-122,1,2,3
2284,ElliotBayTrailMyrtlePark,04/06/2014 04:00:00 AM,48,-122,2,3,5
2285,ElliotBayTrailMyrtlePark,04/06/2014 05:00:00 AM,48,-122,1,3,4
2286,ElliotBayTrailMyrtlePark,04/06/2014 06:00:00 AM,48,-122,5,2,7
2287,ElliotBayTrailMyrtlePark,04/06/2014 07:00:00 AM,48,-122,8,13,21
2288,ElliotBayTrailMyrtlePark,04/06/2014 08:00:00 AM,48,-122,11,15,26
2289,ElliotBayTrailMyrtlePark,04/06/2014 09:00:00 AM,48,-122,18,11,29
2290,ElliotBayTrailMyrtlePark,04/06/2014 10:00:00 AM,48,-122,36,29,65
2291,ElliotBayTrailMyrtlePark,04/06/2014 11:00:00 AM,48,-122,41,28,69
2292,ElliotBayTrailMyrtlePark,04/06/2014 12:00:00 PM,48,-122,43,48,91
2293,ElliotBayTrailMyrtlePark,04/06/2014 01:00:00 PM,48,-122,65,39,104
2294,ElliotBayTrailMyrtlePark,04/06/2014 02:00:00 PM,48,-122,37,36,73
2295,ElliotBayTrailMyrtlePark,04/06/2014 03:00:00 PM,48,-122,41,26,67
2296,ElliotBayTrailMyrtlePark,04/06/2014 04:00:00 PM,48,-122,26,26,52
2297,ElliotBayTrailMyrtlePark,04/06/2014 05:00:00 PM,48,-122,28,8,36
2298,ElliotBayTrailMyrtlePark,04/06/2014 06:00:00 PM,48,-122,7,24,31
2299,ElliotBayTrailMyrtlePark,04/06/2014 07:00:00 PM,48,-122,7,2,9
2300,ElliotBayTrailMyrtlePark,04/06/2014 08:00:00 PM,48,-122,3,0,3
2301,ElliotBayTrailMyrtlePark,04/06/2014 09:00:00 PM,48,-122,2,2,4
2302,ElliotBayTrailMyrtlePark,04/06/2014 10:00:00 PM,48,-122,3,0,3
2303,ElliotBayTrailMyrtlePark,04/06/2014 11:00:00 PM,48,-122,1,0,1
2304,ElliotBayTrailMyrtlePark,04/07/2014 12:00:00 AM,48,-122,1,1,2
2305,ElliotBayTrailMyrtlePark,04/07/2014 01:00:00 AM,48,-122,0,1,1
2306,ElliotBayTrailMyrtlePark,04/07/2014 02:00:00 AM,48,-122,1,1,2
2307,ElliotBayTrailMyrtlePark,04/07/2014 03:00:00 AM,48,-122,1,0,1
2308,ElliotBayTrailMyrtlePark,04/07/2014 04:00:00 AM,48,-122,16,18,34
2309,ElliotBayTrailMyrtlePark,04/07/2014 05:00:00 AM,48,-122,12,27,39
2310,ElliotBayTrailMyrtlePark,04/07/2014 06:00:00 AM,48,-122,41,111,152
2311,ElliotBayTrailMyrtlePark,04/07/2014 07:00:00 AM,48,-122,38,139,177
2312,ElliotBayTrailMyrtlePark,04/07/2014 08:00:00 AM,48,-122,15,64,79
2313,ElliotBayTrailMyrtlePark,04/07/2014 09:00:00 AM,48,-122,12,27,39
2314,ElliotBayTrailMyrtlePark,04/07/2014 10:00:00 AM,48,-122,24,26,50
2315,ElliotBayTrailMyrtlePark,04/07/2014 11:00:00 AM,48,-122,26,34,60
2316,ElliotBayTrailMyrtlePark,04/07/2014 12:00:00 PM,48,-122,34,21,55
2317,ElliotBayTrailMyrtlePark,04/07/2014 01:00:00 PM,48,-122,41,52,93
2318,ElliotBayTrailMyrtlePark,04/07/2014 02:00:00 PM,48,-122,67,64,131
2319,ElliotBayTrailMyrtlePark,04/07/2014 03:00:00 PM,48,-122,127,82,209
2320,ElliotBayTrailMyrtlePark,04/07/2014 04:00:00 PM,48,-122,262,113,375
2321,ElliotBayTrailMyrtlePark,04/07/2014 05:00:00 PM,48,-122,149,86,235
2322,ElliotBayTrailMyrtlePark,04/07/2014 06:00:00 PM,48,-122,57,61,118
2323,ElliotBayTrailMyrtlePark,04/07/2014 07:00:00 PM,48,-122,17,25,42
2324,ElliotBayTrailMyrtlePark,04/07/2014 08:00:00 PM,48,-122,12,2,14
2325,ElliotBayTrailMyrtlePark,04/07/2014 09:00:00 PM,48,-122,3,3,6
2326,ElliotBayTrailMyrtlePark,04/07/2014 10:00:00 PM,48,-122,2,2,4
2327,ElliotBayTrailMyrtlePark,04/07/2014 11:00:00 PM,48,-122,3,1,4
2328,ElliotBayTrailMyrtlePark,04/08/2014 12:00:00 AM,48,-122,0,2,2
2329,ElliotBayTrailMyrtlePark,04/08/2014 01:00:00 AM,48,-122,1,0,1
2330,ElliotBayTrailMyrtlePark,04/08/2014 02:00:00 AM,48,-122,0,0,0
2331,ElliotBayTrailMyrtlePark,04/08/2014 03:00:00 AM,48,-122,2,1,3
2332,ElliotBayTrailMyrtlePark,04/08/2014 04:00:00 AM,48,-122,8,14,22
2333,ElliotBayTrailMyrtlePark,04/08/2014 05:00:00 AM,48,-122,18,23,41
2334,ElliotBayTrailMyrtlePark,04/08/2014 06:00:00 AM,48,-122,52,94,146
2335,ElliotBayTrailMyrtlePark,04/08/2014 07:00:00 AM,48,-122,34,111,145
2336,ElliotBayTrailMyrtlePark,04/08/2014 08:00:00 AM,48,-122,6,57,63
2337,ElliotBayTrailMyrtlePark,04/08/2014 09:00:00 AM,48,-122,7,19,26
2338,ElliotBayTrailMyrtlePark,04/08/2014 10:00:00 AM,48,-122,8,9,17
2339,ElliotBayTrailMyrtlePark,04/08/2014 11:00:00 AM,48,-122,12,13,25
2340,ElliotBayTrailMyrtlePark,04/08/2014 12:00:00 PM,48,-122,13,10,23
2341,ElliotBayTrailMyrtlePark,04/08/2014 01:00:00 PM,48,-122,22,21,43
2342,ElliotBayTrailMyrtlePark,04/08/2014 02:00:00 PM,48,-122,20,12,32
2343,ElliotBayTrailMyrtlePark,04/08/2014 03:00:00 PM,48,-122,49,25,74
2344,ElliotBayTrailMyrtlePark,04/08/2014 04:00:00 PM,48,-122,107,33,140
2345,ElliotBayTrailMyrtlePark,04/08/2014 05:00:00 PM,48,-122,55,19,74
2346,ElliotBayTrailMyrtlePark,04/08/2014 06:00:00 PM,48,-122,19,8,27
2347,ElliotBayTrailMyrtlePark,04/08/2014 07:00:00 PM,48,-122,9,0,9
2348,ElliotBayTrailMyrtlePark,04/08/2014 08:00:00 PM,48,-122,4,1,5
2349,ElliotBayTrailMyrtlePark,04/08/2014 09:00:00 PM,48,-122,7,1,8
2350,ElliotBayTrailMyrtlePark,04/08/2014 10:00:00 PM,48,-122,1,0,1
2351,ElliotBayTrailMyrtlePark,04/08/2014 11:00:00 PM,48,-122,3,0,3
2352,ElliotBayTrailMyrtlePark,04/09/2014 12:00:00 AM,48,-122,2,1,3
2353,ElliotBayTrailMyrtlePark,04/09/2014 01:00:00 AM,48,-122,2,1,3
2354,ElliotBayTrailMyrtlePark,04/09/2014 02:00:00 AM,48,-122,1,0,1
2355,ElliotBayTrailMyrtlePark,04/09/2014 03:00:00 AM,48,-122,0,0,0
2356,ElliotBayTrailMyrtlePark,04/09/2014 04:00:00 AM,48,-122,6,12,18
2357,ElliotBayTrailMyrtlePark,04/09/2014 05:00:00 AM,48,-122,18,36,54
2358,ElliotBayTrailMyrtlePark,04/09/2014 06:00:00 AM,48,-122,39,89,128
2359,ElliotBayTrailMyrtlePark,04/09/2014 07:00:00 AM,48,-122,32,111,143
2360,ElliotBayTrailMyrtlePark,04/09/2014 08:00:00 AM,48,-122,18,53,71
2361,ElliotBayTrailMyrtlePark,04/09/2014 09:00:00 AM,48,-122,12,30,42
2362,ElliotBayTrailMyrtlePark,04/09/2014 10:00:00 AM,48,-122,16,23,39
2363,ElliotBayTrailMyrtlePark,04/09/2014 11:00:00 AM,48,-122,17,23,40
2364,ElliotBayTrailMyrtlePark,04/09/2014 12:00:00 PM,48,-122,16,22,38
2365,ElliotBayTrailMyrtlePark,04/09/2014 01:00:00 PM,48,-122,27,18,45
2366,ElliotBayTrailMyrtlePark,04/09/2014 02:00:00 PM,48,-122,42,28,70
2367,ElliotBayTrailMyrtlePark,04/09/2014 03:00:00 PM,48,-122,92,50,142
2368,ElliotBayTrailMyrtlePark,04/09/2014 04:00:00 PM,48,-122,175,73,248
2369,ElliotBayTrailMyrtlePark,04/09/2014 05:00:00 PM,48,-122,109,59,168
2370,ElliotBayTrailMyrtlePark,04/09/2014 06:00:00 PM,48,-122,53,22,75
2371,ElliotBayTrailMyrtlePark,04/09/2014 07:00:00 PM,48,-122,20,9,29
2372,ElliotBayTrailMyrtlePark,04/09/2014 08:00:00 PM,48,-122,8,2,10
2373,ElliotBayTrailMyrtlePark,04/09/2014 09:00:00 PM,48,-122,6,1,7
2374,ElliotBayTrailMyrtlePark,04/09/2014 10:00:00 PM,48,-122,4,0,4
2375,ElliotBayTrailMyrtlePark,04/09/2014 11:00:00 PM,48,-122,1,0,1
2376,ElliotBayTrailMyrtlePark,04/10/2014 12:00:00 AM,48,-122,1,1,2
2377,ElliotBayTrailMyrtlePark,04/10/2014 01:00:00 AM,48,-122,1,0,1
2378,ElliotBayTrailMyrtlePark,04/10/2014 02:00:00 AM,48,-122,0,0,0
2379,ElliotBayTrailMyrtlePark,04/10/2014 03:00:00 AM,48,-122,1,0,1
2380,ElliotBayTrailMyrtlePark,04/10/2014 04:00:00 AM,48,-122,10,15,25
2381,ElliotBayTrailMyrtlePark,04/10/2014 05:00:00 AM,48,-122,16,33,49
2382,ElliotBayTrailMyrtlePark,04/10/2014 06:00:00 AM,48,-122,42,96,138
2383,ElliotBayTrailMyrtlePark,04/10/2014 07:00:00 AM,48,-122,36,108,144
2384,ElliotBayTrailMyrtlePark,04/10/2014 08:00:00 AM,48,-122,18,55,73
2385,ElliotBayTrailMyrtlePark,04/10/2014 09:00:00 AM,48,-122,15,19,34
2386,ElliotBayTrailMyrtlePark,04/10/2014 10:00:00 AM,48,-122,14,13,27
2387,ElliotBayTrailMyrtlePark,04/10/2014 11:00:00 AM,48,-122,14,24,38
2388,ElliotBayTrailMyrtlePark,04/10/2014 12:00:00 PM,48,-122,23,32,55
2389,ElliotBayTrailMyrtlePark,04/10/2014 01:00:00 PM,48,-122,22,20,42
2390,ElliotBayTrailMyrtlePark,04/10/2014 02:00:00 PM,48,-122,29,28,57
2391,ElliotBayTrailMyrtlePark,04/10/2014 03:00:00 PM,48,-122,93,48,141
2392,ElliotBayTrailMyrtlePark,04/10/2014 04:00:00 PM,48,-122,170,64,234
2393,ElliotBayTrailMyrtlePark,04/10/2014 05:00:00 PM,48,-122,103,58,161
2394,ElliotBayTrailMyrtlePark,04/10/2014 06:00:00 PM,48,-122,61,34,95
2395,ElliotBayTrailMyrtlePark,04/10/2014 07:00:00 PM,48,-122,10,9,19
2396,ElliotBayTrailMyrtlePark,04/10/2014 08:00:00 PM,48,-122,5,0,5
2397,ElliotBayTrailMyrtlePark,04/10/2014 09:00:00 PM,48,-122,2,3,5
2398,ElliotBayTrailMyrtlePark,04/10/2014 10:00:00 PM,48,-122,2,0,2
2399,ElliotBayTrailMyrtlePark,04/10/2014 11:00:00 PM,48,-122,4,2,6
2400,ElliotBayTrailMyrtlePark,04/11/2014 12:00:00 AM,48,-122,1,0,1
2401,ElliotBayTrailMyrtlePark,04/11/2014 01:00:00 AM,48,-122,4,0,4
2402,ElliotBayTrailMyrtlePark,04/11/2014 02:00:00 AM,48,-122,0,0,0
2403,ElliotBayTrailMyrtlePark,04/11/2014 03:00:00 AM,48,-122,1,0,1
2404,ElliotBayTrailMyrtlePark,04/11/2014 04:00:00 AM,48,-122,9,17,26
2405,ElliotBayTrailMyrtlePark,04/11/2014 05:00:00 AM,48,-122,13,26,39
2406,ElliotBayTrailMyrtlePark,04/11/2014 06:00:00 AM,48,-122,35,83,118
2407,ElliotBayTrailMyrtlePark,04/11/2014 07:00:00 AM,48,-122,38,96,134
2408,ElliotBayTrailMyrtlePark,04/11/2014 08:00:00 AM,48,-122,18,50,68
2409,ElliotBayTrailMyrtlePark,04/11/2014 09:00:00 AM,48,-122,24,18,42
2410,ElliotBayTrailMyrtlePark,04/11/2014 10:00:00 AM,48,-122,28,19,47
2411,ElliotBayTrailMyrtlePark,04/11/2014 11:00:00 AM,48,-122,18,28,46
2412,ElliotBayTrailMyrtlePark,04/11/2014 12:00:00 PM,48,-122,42,23,65
2413,ElliotBayTrailMyrtlePark,04/11/2014 01:00:00 PM,48,-122,41,25,66
2414,ElliotBayTrailMyrtlePark,04/11/2014 02:00:00 PM,48,-122,38,40,78
2415,ElliotBayTrailMyrtlePark,04/11/2014 03:00:00 PM,48,-122,104,62,166
2416,ElliotBayTrailMyrtlePark,04/11/2014 04:00:00 PM,48,-122,134,70,204
2417,ElliotBayTrailMyrtlePark,04/11/2014 05:00:00 PM,48,-122,94,37,131
2418,ElliotBayTrailMyrtlePark,04/11/2014 06:00:00 PM,48,-122,39,34,73
2419,ElliotBayTrailMyrtlePark,04/11/2014 07:00:00 PM,48,-122,10,10,20
2420,ElliotBayTrailMyrtlePark,04/11/2014 08:00:00 PM,48,-122,6,0,6
2421,ElliotBayTrailMyrtlePark,04/11/2014 09:00:00 PM,48,-122,13,2,15
2422,ElliotBayTrailMyrtlePark,04/11/2014 10:00:00 PM,48,-122,2,2,4
2423,ElliotBayTrailMyrtlePark,04/11/2014 11:00:00 PM,48,-122,2,4,6
2424,ElliotBayTrailMyrtlePark,04/12/2014 12:00:00 AM,48,-122,1,3,4
2425,ElliotBayTrailMyrtlePark,04/12/2014 01:00:00 AM,48,-122,0,0,0
2426,ElliotBayTrailMyrtlePark,04/12/2014 02:00:00 AM,48,-122,2,0,2
2427,ElliotBayTrailMyrtlePark,04/12/2014 03:00:00 AM,48,-122,1,0,1
2428,ElliotBayTrailMyrtlePark,04/12/2014 04:00:00 AM,48,-122,1,3,4
2429,ElliotBayTrailMyrtlePark,04/12/2014 05:00:00 AM,48,-122,3,8,11
2430,ElliotBayTrailMyrtlePark,04/12/2014 06:00:00 AM,48,-122,6,13,19
2431,ElliotBayTrailMyrtlePark,04/12/2014 07:00:00 AM,48,-122,9,22,31
2432,ElliotBayTrailMyrtlePark,04/12/2014 08:00:00 AM,48,-122,16,13,29
2433,ElliotBayTrailMyrtlePark,04/12/2014 09:00:00 AM,48,-122,29,28,57
2434,ElliotBayTrailMyrtlePark,04/12/2014 10:00:00 AM,48,-122,28,42,70
2435,ElliotBayTrailMyrtlePark,04/12/2014 11:00:00 AM,48,-122,52,44,96
2436,ElliotBayTrailMyrtlePark,04/12/2014 12:00:00 PM,48,-122,43,50,93
2437,ElliotBayTrailMyrtlePark,04/12/2014 01:00:00 PM,48,-122,62,77,139
2438,ElliotBayTrailMyrtlePark,04/12/2014 02:00:00 PM,48,-122,58,54,112
2439,ElliotBayTrailMyrtlePark,04/12/2014 03:00:00 PM,48,-122,56,49,105
2440,ElliotBayTrailMyrtlePark,04/12/2014 04:00:00 PM,48,-122,37,51,88
2441,ElliotBayTrailMyrtlePark,04/12/2014 05:00:00 PM,48,-122,29,36,65
2442,ElliotBayTrailMyrtlePark,04/12/2014 06:00:00 PM,48,-122,27,26,53
2443,ElliotBayTrailMyrtlePark,04/12/2014 07:00:00 PM,48,-122,15,8,23
2444,ElliotBayTrailMyrtlePark,04/12/2014 08:00:00 PM,48,-122,9,4,13
2445,ElliotBayTrailMyrtlePark,04/12/2014 09:00:00 PM,48,-122,7,0,7
2446,ElliotBayTrailMyrtlePark,04/12/2014 10:00:00 PM,48,-122,4,1,5
2447,ElliotBayTrailMyrtlePark,04/12/2014 11:00:00 PM,48,-122,3,1,4
2448,ElliotBayTrailMyrtlePark,04/13/2014 12:00:00 AM,48,-122,1,0,1
2449,ElliotBayTrailMyrtlePark,04/13/2014 01:00:00 AM,48,-122,4,0,4
2450,ElliotBayTrailMyrtlePark,04/13/2014 02:00:00 AM,48,-122,3,0,3
2451,ElliotBayTrailMyrtlePark,04/13/2014 03:00:00 AM,48,-122,1,0,1
2452,ElliotBayTrailMyrtlePark,04/13/2014 04:00:00 AM,48,-122,1,2,3
2453,ElliotBayTrailMyrtlePark,04/13/2014 05:00:00 AM,48,-122,1,6,7
2454,ElliotBayTrailMyrtlePark,04/13/2014 06:00:00 AM,48,-122,3,4,7
2455,ElliotBayTrailMyrtlePark,04/13/2014 07:00:00 AM,48,-122,14,15,29
2456,ElliotBayTrailMyrtlePark,04/13/2014 08:00:00 AM,48,-122,32,18,50
2457,ElliotBayTrailMyrtlePark,04/13/2014 09:00:00 AM,48,-122,89,82,171
2458,ElliotBayTrailMyrtlePark,04/13/2014 10:00:00 AM,48,-122,63,57,120
2459,ElliotBayTrailMyrtlePark,04/13/2014 11:00:00 AM,48,-122,93,76,169
2460,ElliotBayTrailMyrtlePark,04/13/2014 12:00:00 PM,48,-122,108,89,197
2461,ElliotBayTrailMyrtlePark,04/13/2014 01:00:00 PM,48,-122,111,100,211
2462,ElliotBayTrailMyrtlePark,04/13/2014 02:00:00 PM,48,-122,110,121,231
2463,ElliotBayTrailMyrtlePark,04/13/2014 03:00:00 PM,48,-122,92,98,190
2464,ElliotBayTrailMyrtlePark,04/13/2014 04:00:00 PM,48,-122,68,71,139
2465,ElliotBayTrailMyrtlePark,04/13/2014 05:00:00 PM,48,-122,41,63,104
2466,ElliotBayTrailMyrtlePark,04/13/2014 06:00:00 PM,48,-122,29,29,58
2467,ElliotBayTrailMyrtlePark,04/13/2014 07:00:00 PM,48,-122,17,12,29
2468,ElliotBayTrailMyrtlePark,04/13/2014 08:00:00 PM,48,-122,3,3,6
2469,ElliotBayTrailMyrtlePark,04/13/2014 09:00:00 PM,48,-122,6,2,8
2470,ElliotBayTrailMyrtlePark,04/13/2014 10:00:00 PM,48,-122,4,1,5
2471,ElliotBayTrailMyrtlePark,04/13/2014 11:00:00 PM,48,-122,2,1,3
2472,ElliotBayTrailMyrtlePark,04/14/2014 12:00:00 AM,48,-122,1,0,1
2473,ElliotBayTrailMyrtlePark,04/14/2014 01:00:00 AM,48,-122,0,1,1
2474,ElliotBayTrailMyrtlePark,04/14/2014 02:00:00 AM,48,-122,1,1,2
2475,ElliotBayTrailMyrtlePark,04/14/2014 03:00:00 AM,48,-122,1,0,1
2476,ElliotBayTrailMyrtlePark,04/14/2014 04:00:00 AM,48,-122,10,12,22
2477,ElliotBayTrailMyrtlePark,04/14/2014 05:00:00 AM,48,-122,20,33,53
2478,ElliotBayTrailMyrtlePark,04/14/2014 06:00:00 AM,48,-122,44,103,147
2479,ElliotBayTrailMyrtlePark,04/14/2014 07:00:00 AM,48,-122,42,139,181
2480,ElliotBayTrailMyrtlePark,04/14/2014 08:00:00 AM,48,-122,16,59,75
2481,ElliotBayTrailMyrtlePark,04/14/2014 09:00:00 AM,48,-122,20,25,45
2482,ElliotBayTrailMyrtlePark,04/14/2014 10:00:00 AM,48,-122,22,27,49
2483,ElliotBayTrailMyrtlePark,04/14/2014 11:00:00 AM,48,-122,21,21,42
2484,ElliotBayTrailMyrtlePark,04/14/2014 12:00:00 PM,48,-122,30,40,70
2485,ElliotBayTrailMyrtlePark,04/14/2014 01:00:00 PM,48,-122,24,24,48
2486,ElliotBayTrailMyrtlePark,04/14/2014 02:00:00 PM,48,-122,54,40,94
2487,ElliotBayTrailMyrtlePark,04/14/2014 03:00:00 PM,48,-122,89,61,150
2488,ElliotBayTrailMyrtlePark,04/14/2014 04:00:00 PM,48,-122,227,72,299
2489,ElliotBayTrailMyrtlePark,04/14/2014 05:00:00 PM,48,-122,110,51,161
2490,ElliotBayTrailMyrtlePark,04/14/2014 06:00:00 PM,48,-122,59,30,89
2491,ElliotBayTrailMyrtlePark,04/14/2014 07:00:00 PM,48,-122,16,9,25
2492,ElliotBayTrailMyrtlePark,04/14/2014 08:00:00 PM,48,-122,4,2,6
2493,ElliotBayTrailMyrtlePark,04/14/2014 09:00:00 PM,48,-122,1,1,2
2494,ElliotBayTrailMyrtlePark,04/14/2014 10:00:00 PM,48,-122,0,0,0
2495,ElliotBayTrailMyrtlePark,04/14/2014 11:00:00 PM,48,-122,2,1,3
2496,ElliotBayTrailMyrtlePark,04/15/2014 12:00:00 AM,48,-122,2,1,3
2497,ElliotBayTrailMyrtlePark,04/15/2014 01:00:00 AM,48,-122,3,1,4
2498,ElliotBayTrailMyrtlePark,04/15/2014 02:00:00 AM,48,-122,2,1,3
2499,ElliotBayTrailMyrtlePark,04/15/2014 03:00:00 AM,48,-122,0,1,1
2500,ElliotBayTrailMyrtlePark,04/15/2014 04:00:00 AM,48,-122,8,13,21
2501,ElliotBayTrailMyrtlePark,04/15/2014 05:00:00 AM,48,-122,9,22,31
2502,ElliotBayTrailMyrtlePark,04/15/2014 06:00:00 AM,48,-122,53,92,145
2503,ElliotBayTrailMyrtlePark,04/15/2014 07:00:00 AM,48,-122,32,95,127
2504,ElliotBayTrailMyrtlePark,04/15/2014 08:00:00 AM,48,-122,9,49,58
2505,ElliotBayTrailMyrtlePark,04/15/2014 09:00:00 AM,48,-122,15,31,46
2506,ElliotBayTrailMyrtlePark,04/15/2014 10:00:00 AM,48,-122,16,23,39
2507,ElliotBayTrailMyrtlePark,04/15/2014 11:00:00 AM,48,-122,18,16,34
2508,ElliotBayTrailMyrtlePark,04/15/2014 12:00:00 PM,48,-122,16,14,30
2509,ElliotBayTrailMyrtlePark,04/15/2014 01:00:00 PM,48,-122,34,20,54
2510,ElliotBayTrailMyrtlePark,04/15/2014 02:00:00 PM,48,-122,22,27,49
2511,ElliotBayTrailMyrtlePark,04/15/2014 03:00:00 PM,48,-122,60,45,105
2512,ElliotBayTrailMyrtlePark,04/15/2014 04:00:00 PM,48,-122,148,55,203
2513,ElliotBayTrailMyrtlePark,04/15/2014 05:00:00 PM,48,-122,81,29,110
2514,ElliotBayTrailMyrtlePark,04/15/2014 06:00:00 PM,48,-122,42,19,61
2515,ElliotBayTrailMyrtlePark,04/15/2014 07:00:00 PM,48,-122,7,7,14
2516,ElliotBayTrailMyrtlePark,04/15/2014 08:00:00 PM,48,-122,5,1,6
2517,ElliotBayTrailMyrtlePark,04/15/2014 09:00:00 PM,48,-122,2,0,2
2518,ElliotBayTrailMyrtlePark,04/15/2014 10:00:00 PM,48,-122,1,0,1
2519,ElliotBayTrailMyrtlePark,04/15/2014 11:00:00 PM,48,-122,0,0,0
2520,ElliotBayTrailMyrtlePark,04/16/2014 12:00:00 AM,48,-122,1,0,1
2521,ElliotBayTrailMyrtlePark,04/16/2014 01:00:00 AM,48,-122,0,0,0
2522,ElliotBayTrailMyrtlePark,04/16/2014 02:00:00 AM,48,-122,0,0,0
2523,ElliotBayTrailMyrtlePark,04/16/2014 03:00:00 AM,48,-122,0,0,0
2524,ElliotBayTrailMyrtlePark,04/16/2014 04:00:00 AM,48,-122,5,12,17
2525,ElliotBayTrailMyrtlePark,04/16/2014 05:00:00 AM,48,-122,14,23,37
2526,ElliotBayTrailMyrtlePark,04/16/2014 06:00:00 AM,48,-122,29,61,90
2527,ElliotBayTrailMyrtlePark,04/16/2014 07:00:00 AM,48,-122,16,65,81
2528,ElliotBayTrailMyrtlePark,04/16/2014 08:00:00 AM,48,-122,10,32,42
2529,ElliotBayTrailMyrtlePark,04/16/2014 09:00:00 AM,48,-122,6,13,19
2530,ElliotBayTrailMyrtlePark,04/16/2014 10:00:00 AM,48,-122,5,8,13
2531,ElliotBayTrailMyrtlePark,04/16/2014 11:00:00 AM,48,-122,3,3,6
2532,ElliotBayTrailMyrtlePark,04/16/2014 12:00:00 PM,48,-122,5,9,14
2533,ElliotBayTrailMyrtlePark,04/16/2014 01:00:00 PM,48,-122,7,3,10
2534,ElliotBayTrailMyrtlePark,04/16/2014 02:00:00 PM,48,-122,24,11,35
2535,ElliotBayTrailMyrtlePark,04/16/2014 03:00:00 PM,48,-122,37,24,61
2536,ElliotBayTrailMyrtlePark,04/16/2014 04:00:00 PM,48,-122,93,26,119
2537,ElliotBayTrailMyrtlePark,04/16/2014 05:00:00 PM,48,-122,52,14,66
2538,ElliotBayTrailMyrtlePark,04/16/2014 06:00:00 PM,48,-122,25,6,31
2539,ElliotBayTrailMyrtlePark,04/16/2014 07:00:00 PM,48,-122,8,4,12
2540,ElliotBayTrailMyrtlePark,04/16/2014 08:00:00 PM,48,-122,4,0,4
2541,ElliotBayTrailMyrtlePark,04/16/2014 09:00:00 PM,48,-122,0,0,0
2542,ElliotBayTrailMyrtlePark,04/16/2014 10:00:00 PM,48,-122,0,0,0
2543,ElliotBayTrailMyrtlePark,04/16/2014 11:00:00 PM,48,-122,3,0,3
2544,ElliotBayTrailMyrtlePark,04/17/2014 12:00:00 AM,48,-122,1,0,1
2545,ElliotBayTrailMyrtlePark,04/17/2014 01:00:00 AM,48,-122,0,0,0
2546,ElliotBayTrailMyrtlePark,04/17/2014 02:00:00 AM,48,-122,0,0,0
2547,ElliotBayTrailMyrtlePark,04/17/2014 03:00:00 AM,48,-122,0,0,0
2548,ElliotBayTrailMyrtlePark,04/17/2014 04:00:00 AM,48,-122,6,10,16
2549,ElliotBayTrailMyrtlePark,04/17/2014 05:00:00 AM,48,-122,9,17,26
2550,ElliotBayTrailMyrtlePark,04/17/2014 06:00:00 AM,48,-122,32,54,86
2551,ElliotBayTrailMyrtlePark,04/17/2014 07:00:00 AM,48,-122,17,46,63
2552,ElliotBayTrailMyrtlePark,04/17/2014 08:00:00 AM,48,-122,11,25,36
2553,ElliotBayTrailMyrtlePark,04/17/2014 09:00:00 AM,48,-122,7,6,13
2554,ElliotBayTrailMyrtlePark,04/17/2014 10:00:00 AM,48,-122,4,6,10
2555,ElliotBayTrailMyrtlePark,04/17/2014 11:00:00 AM,48,-122,2,4,6
2556,ElliotBayTrailMyrtlePark,04/17/2014 12:00:00 PM,48,-122,6,1,7
2557,ElliotBayTrailMyrtlePark,04/17/2014 01:00:00 PM,48,-122,6,8,14
2558,ElliotBayTrailMyrtlePark,04/17/2014 02:00:00 PM,48,-122,9,7,16
2559,ElliotBayTrailMyrtlePark,04/17/2014 03:00:00 PM,48,-122,17,22,39
2560,ElliotBayTrailMyrtlePark,04/17/2014 04:00:00 PM,48,-122,67,28,95
2561,ElliotBayTrailMyrtlePark,04/17/2014 05:00:00 PM,48,-122,48,8,56
2562,ElliotBayTrailMyrtlePark,04/17/2014 06:00:00 PM,48,-122,14,4,18
2563,ElliotBayTrailMyrtlePark,04/17/2014 07:00:00 PM,48,-122,5,3,8
2564,ElliotBayTrailMyrtlePark,04/17/2014 08:00:00 PM,48,-122,1,0,1
2565,ElliotBayTrailMyrtlePark,04/17/2014 09:00:00 PM,48,-122,3,2,5
2566,ElliotBayTrailMyrtlePark,04/17/2014 10:00:00 PM,48,-122,3,0,3
2567,ElliotBayTrailMyrtlePark,04/17/2014 11:00:00 PM,48,-122,0,0,0
2568,ElliotBayTrailMyrtlePark,04/18/2014 12:00:00 AM,48,-122,0,0,0
2569,ElliotBayTrailMyrtlePark,04/18/2014 01:00:00 AM,48,-122,0,0,0
2570,ElliotBayTrailMyrtlePark,04/18/2014 02:00:00 AM,48,-122,0,0,0
2571,ElliotBayTrailMyrtlePark,04/18/2014 03:00:00 AM,48,-122,1,0,1
2572,ElliotBayTrailMyrtlePark,04/18/2014 04:00:00 AM,48,-122,8,11,19
2573,ElliotBayTrailMyrtlePark,04/18/2014 05:00:00 AM,48,-122,14,16,30
2574,ElliotBayTrailMyrtlePark,04/18/2014 06:00:00 AM,48,-122,38,62,100
2575,ElliotBayTrailMyrtlePark,04/18/2014 07:00:00 AM,48,-122,30,87,117
2576,ElliotBayTrailMyrtlePark,04/18/2014 08:00:00 AM,48,-122,21,48,69
2577,ElliotBayTrailMyrtlePark,04/18/2014 09:00:00 AM,48,-122,13,15,28
2578,ElliotBayTrailMyrtlePark,04/18/2014 10:00:00 AM,48,-122,16,17,33
2579,ElliotBayTrailMyrtlePark,04/18/2014 11:00:00 AM,48,-122,29,23,52
2580,ElliotBayTrailMyrtlePark,04/18/2014 12:00:00 PM,48,-122,27,21,48
2581,ElliotBayTrailMyrtlePark,04/18/2014 01:00:00 PM,48,-122,31,35,66
2582,ElliotBayTrailMyrtlePark,04/18/2014 02:00:00 PM,48,-122,41,28,69
2583,ElliotBayTrailMyrtlePark,04/18/2014 03:00:00 PM,48,-122,67,56,123
2584,ElliotBayTrailMyrtlePark,04/18/2014 04:00:00 PM,48,-122,123,57,180
2585,ElliotBayTrailMyrtlePark,04/18/2014 05:00:00 PM,48,-122,79,37,116
2586,ElliotBayTrailMyrtlePark,04/18/2014 06:00:00 PM,48,-122,26,21,47
2587,ElliotBayTrailMyrtlePark,04/18/2014 07:00:00 PM,48,-122,14,17,31
2588,ElliotBayTrailMyrtlePark,04/18/2014 08:00:00 PM,48,-122,3,1,4
2589,ElliotBayTrailMyrtlePark,04/18/2014 09:00:00 PM,48,-122,2,1,3
2590,ElliotBayTrailMyrtlePark,04/18/2014 10:00:00 PM,48,-122,4,0,4
2591,ElliotBayTrailMyrtlePark,04/18/2014 11:00:00 PM,48,-122,3,1,4
2592,ElliotBayTrailMyrtlePark,04/19/2014 12:00:00 AM,48,-122,1,0,1
2593,ElliotBayTrailMyrtlePark,04/19/2014 01:00:00 AM,48,-122,2,0,2
2594,ElliotBayTrailMyrtlePark,04/19/2014 02:00:00 AM,48,-122,2,0,2
2595,ElliotBayTrailMyrtlePark,04/19/2014 03:00:00 AM,48,-122,0,0,0
2596,ElliotBayTrailMyrtlePark,04/19/2014 04:00:00 AM,48,-122,1,0,1
2597,ElliotBayTrailMyrtlePark,04/19/2014 05:00:00 AM,48,-122,1,4,5
2598,ElliotBayTrailMyrtlePark,04/19/2014 06:00:00 AM,48,-122,8,11,19
2599,ElliotBayTrailMyrtlePark,04/19/2014 07:00:00 AM,48,-122,22,9,31
2600,ElliotBayTrailMyrtlePark,04/19/2014 08:00:00 AM,48,-122,13,38,51
2601,ElliotBayTrailMyrtlePark,04/19/2014 09:00:00 AM,48,-122,27,35,62
2602,ElliotBayTrailMyrtlePark,04/19/2014 10:00:00 AM,48,-122,15,9,24
2603,ElliotBayTrailMyrtlePark,04/19/2014 11:00:00 AM,48,-122,20,8,28
2604,ElliotBayTrailMyrtlePark,04/19/2014 12:00:00 PM,48,-122,8,6,14
2605,ElliotBayTrailMyrtlePark,04/19/2014 01:00:00 PM,48,-122,5,5,10
2606,ElliotBayTrailMyrtlePark,04/19/2014 02:00:00 PM,48,-122,6,3,9
2607,ElliotBayTrailMyrtlePark,04/19/2014 03:00:00 PM,48,-122,8,5,13
2608,ElliotBayTrailMyrtlePark,04/19/2014 04:00:00 PM,48,-122,9,2,11
2609,ElliotBayTrailMyrtlePark,04/19/2014 05:00:00 PM,48,-122,6,8,14
2610,ElliotBayTrailMyrtlePark,04/19/2014 06:00:00 PM,48,-122,2,2,4
2611,ElliotBayTrailMyrtlePark,04/19/2014 07:00:00 PM,48,-122,4,2,6
2612,ElliotBayTrailMyrtlePark,04/19/2014 08:00:00 PM,48,-122,3,0,3
2613,ElliotBayTrailMyrtlePark,04/19/2014 09:00:00 PM,48,-122,0,2,2
2614,ElliotBayTrailMyrtlePark,04/19/2014 10:00:00 PM,48,-122,3,3,6
2615,ElliotBayTrailMyrtlePark,04/19/2014 11:00:00 PM,48,-122,1,0,1
2616,ElliotBayTrailMyrtlePark,04/20/2014 12:00:00 AM,48,-122,1,2,3
2617,ElliotBayTrailMyrtlePark,04/20/2014 01:00:00 AM,48,-122,3,2,5
2618,ElliotBayTrailMyrtlePark,04/20/2014 02:00:00 AM,48,-122,3,0,3
2619,ElliotBayTrailMyrtlePark,04/20/2014 03:00:00 AM,48,-122,0,0,0
2620,ElliotBayTrailMyrtlePark,04/20/2014 04:00:00 AM,48,-122,3,5,8
2621,ElliotBayTrailMyrtlePark,04/20/2014 05:00:00 AM,48,-122,3,4,7
2622,ElliotBayTrailMyrtlePark,04/20/2014 06:00:00 AM,48,-122,6,6,12
2623,ElliotBayTrailMyrtlePark,04/20/2014 07:00:00 AM,48,-122,33,0,33
2624,ElliotBayTrailMyrtlePark,04/20/2014 08:00:00 AM,48,-122,42,0,42
2625,ElliotBayTrailMyrtlePark,04/20/2014 09:00:00 AM,48,-122,49,0,49
2626,ElliotBayTrailMyrtlePark,04/20/2014 10:00:00 AM,48,-122,83,0,83
2627,ElliotBayTrailMyrtlePark,04/20/2014 11:00:00 AM,48,-122,112,0,112
2628,ElliotBayTrailMyrtlePark,04/20/2014 12:00:00 PM,48,-122,107,0,107
2629,ElliotBayTrailMyrtlePark,04/20/2014 01:00:00 PM,48,-122,116,0,116
2630,ElliotBayTrailMyrtlePark,04/20/2014 02:00:00 PM,48,-122,119,0,119
2631,ElliotBayTrailMyrtlePark,04/20/2014 03:00:00 PM,48,-122,90,0,90
2632,ElliotBayTrailMyrtlePark,04/20/2014 04:00:00 PM,48,-122,84,0,84
2633,ElliotBayTrailMyrtlePark,04/20/2014 05:00:00 PM,48,-122,63,0,63
2634,ElliotBayTrailMyrtlePark,04/20/2014 06:00:00 PM,48,-122,28,0,28
2635,ElliotBayTrailMyrtlePark,04/20/2014 07:00:00 PM,48,-122,10,0,10
2636,ElliotBayTrailMyrtlePark,04/20/2014 08:00:00 PM,48,-122,2,0,2
2637,ElliotBayTrailMyrtlePark,04/20/2014 09:00:00 PM,48,-122,5,0,5
2638,ElliotBayTrailMyrtlePark,04/20/2014 10:00:00 PM,48,-122,3,0,3
2639,ElliotBayTrailMyrtlePark,04/20/2014 11:00:00 PM,48,-122,3,0,3
2640,ElliotBayTrailMyrtlePark,04/21/2014 12:00:00 AM,48,-122,0,0,0
2641,ElliotBayTrailMyrtlePark,04/21/2014 01:00:00 AM,48,-122,1,0,1
2642,ElliotBayTrailMyrtlePark,04/21/2014 02:00:00 AM,48,-122,1,0,1
2643,ElliotBayTrailMyrtlePark,04/21/2014 03:00:00 AM,48,-122,0,0,0
2644,ElliotBayTrailMyrtlePark,04/21/2014 04:00:00 AM,48,-122,19,0,19
2645,ElliotBayTrailMyrtlePark,04/21/2014 05:00:00 AM,48,-122,40,0,40
2646,ElliotBayTrailMyrtlePark,04/21/2014 06:00:00 AM,48,-122,128,0,128
2647,ElliotBayTrailMyrtlePark,04/21/2014 07:00:00 AM,48,-122,148,0,148
2648,ElliotBayTrailMyrtlePark,04/21/2014 08:00:00 AM,48,-122,77,0,77
2649,ElliotBayTrailMyrtlePark,04/21/2014 09:00:00 AM,48,-122,41,0,41
2650,ElliotBayTrailMyrtlePark,04/21/2014 10:00:00 AM,48,-122,24,0,24
2651,ElliotBayTrailMyrtlePark,04/21/2014 11:00:00 AM,48,-122,23,0,23
2652,ElliotBayTrailMyrtlePark,04/21/2014 12:00:00 PM,48,-122,49,0,49
2653,ElliotBayTrailMyrtlePark,04/21/2014 01:00:00 PM,48,-122,53,2,55
2654,ElliotBayTrailMyrtlePark,04/21/2014 02:00:00 PM,48,-122,69,0,69
2655,ElliotBayTrailMyrtlePark,04/21/2014 03:00:00 PM,48,-122,159,0,159
2656,ElliotBayTrailMyrtlePark,04/21/2014 04:00:00 PM,48,-122,201,0,201
2657,ElliotBayTrailMyrtlePark,04/21/2014 05:00:00 PM,48,-122,125,0,125
2658,ElliotBayTrailMyrtlePark,04/21/2014 06:00:00 PM,48,-122,41,0,41
2659,ElliotBayTrailMyrtlePark,04/21/2014 07:00:00 PM,48,-122,11,0,11
2660,ElliotBayTrailMyrtlePark,04/21/2014 08:00:00 PM,48,-122,3,0,3
2661,ElliotBayTrailMyrtlePark,04/21/2014 09:00:00 PM,48,-122,3,0,3
2662,ElliotBayTrailMyrtlePark,04/21/2014 10:00:00 PM,48,-122,1,0,1
2663,ElliotBayTrailMyrtlePark,04/21/2014 11:00:00 PM,48,-122,3,0,3
2664,ElliotBayTrailMyrtlePark,04/22/2014 12:00:00 AM,48,-122,0,0,0
2665,ElliotBayTrailMyrtlePark,04/22/2014 01:00:00 AM,48,-122,1,0,1
2666,ElliotBayTrailMyrtlePark,04/22/2014 02:00:00 AM,48,-122,0,0,0
2667,ElliotBayTrailMyrtlePark,04/22/2014 03:00:00 AM,48,-122,0,0,0
2668,ElliotBayTrailMyrtlePark,04/22/2014 04:00:00 AM,48,-122,18,0,18
2669,ElliotBayTrailMyrtlePark,04/22/2014 05:00:00 AM,48,-122,25,0,25
2670,ElliotBayTrailMyrtlePark,04/22/2014 06:00:00 AM,48,-122,80,0,80
2671,ElliotBayTrailMyrtlePark,04/22/2014 07:00:00 AM,48,-122,74,0,74
2672,ElliotBayTrailMyrtlePark,04/22/2014 08:00:00 AM,48,-122,45,0,45
2673,ElliotBayTrailMyrtlePark,04/22/2014 09:00:00 AM,48,-122,21,0,21
2674,ElliotBayTrailMyrtlePark,04/22/2014 10:00:00 AM,48,-122,20,0,20
2675,ElliotBayTrailMyrtlePark,04/22/2014 11:00:00 AM,48,-122,9,0,9
2676,ElliotBayTrailMyrtlePark,04/22/2014 12:00:00 PM,48,-122,38,0,38
2677,ElliotBayTrailMyrtlePark,04/22/2014 01:00:00 PM,48,-122,77,0,77
2678,ElliotBayTrailMyrtlePark,04/22/2014 02:00:00 PM,48,-122,41,0,41
2679,ElliotBayTrailMyrtlePark,04/22/2014 03:00:00 PM,48,-122,130,0,130
2680,ElliotBayTrailMyrtlePark,04/22/2014 04:00:00 PM,48,-122,147,0,147
2681,ElliotBayTrailMyrtlePark,04/22/2014 05:00:00 PM,48,-122,105,0,105
2682,ElliotBayTrailMyrtlePark,04/22/2014 06:00:00 PM,48,-122,41,0,41
2683,ElliotBayTrailMyrtlePark,04/22/2014 07:00:00 PM,48,-122,8,0,8
2684,ElliotBayTrailMyrtlePark,04/22/2014 08:00:00 PM,48,-122,2,0,2
2685,ElliotBayTrailMyrtlePark,04/22/2014 09:00:00 PM,48,-122,3,0,3
2686,ElliotBayTrailMyrtlePark,04/22/2014 10:00:00 PM,48,-122,2,0,2
2687,ElliotBayTrailMyrtlePark,04/22/2014 11:00:00 PM,48,-122,1,0,1
2688,ElliotBayTrailMyrtlePark,04/23/2014 12:00:00 AM,48,-122,1,0,1
2689,ElliotBayTrailMyrtlePark,04/23/2014 01:00:00 AM,48,-122,1,0,1
2690,ElliotBayTrailMyrtlePark,04/23/2014 02:00:00 AM,48,-122,0,0,0
2691,ElliotBayTrailMyrtlePark,04/23/2014 03:00:00 AM,48,-122,0,0,0
2692,ElliotBayTrailMyrtlePark,04/23/2014 04:00:00 AM,48,-122,15,0,15
2693,ElliotBayTrailMyrtlePark,04/23/2014 05:00:00 AM,48,-122,38,0,38
2694,ElliotBayTrailMyrtlePark,04/23/2014 06:00:00 AM,48,-122,123,0,123
2695,ElliotBayTrailMyrtlePark,04/23/2014 07:00:00 AM,48,-122,108,0,108
2696,ElliotBayTrailMyrtlePark,04/23/2014 08:00:00 AM,48,-122,49,0,49
2697,ElliotBayTrailMyrtlePark,04/23/2014 09:00:00 AM,48,-122,37,0,37
2698,ElliotBayTrailMyrtlePark,04/23/2014 10:00:00 AM,48,-122,35,0,35
2699,ElliotBayTrailMyrtlePark,04/23/2014 11:00:00 AM,48,-122,19,0,19
2700,ElliotBayTrailMyrtlePark,04/23/2014 12:00:00 PM,48,-122,27,0,27
2701,ElliotBayTrailMyrtlePark,04/23/2014 01:00:00 PM,48,-122,40,0,40
2702,ElliotBayTrailMyrtlePark,04/23/2014 02:00:00 PM,48,-122,29,0,29
2703,ElliotBayTrailMyrtlePark,04/23/2014 03:00:00 PM,48,-122,87,0,87
2704,ElliotBayTrailMyrtlePark,04/23/2014 04:00:00 PM,48,-122,151,0,151
2705,ElliotBayTrailMyrtlePark,04/23/2014 05:00:00 PM,48,-122,91,0,91
2706,ElliotBayTrailMyrtlePark,04/23/2014 06:00:00 PM,48,-122,42,0,42
2707,ElliotBayTrailMyrtlePark,04/23/2014 07:00:00 PM,48,-122,10,0,10
2708,ElliotBayTrailMyrtlePark,04/23/2014 08:00:00 PM,48,-122,4,0,4
2709,ElliotBayTrailMyrtlePark,04/23/2014 09:00:00 PM,48,-122,4,0,4
2710,ElliotBayTrailMyrtlePark,04/23/2014 10:00:00 PM,48,-122,2,0,2
2711,ElliotBayTrailMyrtlePark,04/23/2014 11:00:00 PM,48,-122,1,0,1
2712,ElliotBayTrailMyrtlePark,04/24/2014 12:00:00 AM,48,-122,1,0,1
2713,ElliotBayTrailMyrtlePark,04/24/2014 01:00:00 AM,48,-122,0,0,0
2714,ElliotBayTrailMyrtlePark,04/24/2014 02:00:00 AM,48,-122,0,0,0
2715,ElliotBayTrailMyrtlePark,04/24/2014 03:00:00 AM,48,-122,1,0,1
2716,ElliotBayTrailMyrtlePark,04/24/2014 04:00:00 AM,48,-122,17,0,17
2717,ElliotBayTrailMyrtlePark,04/24/2014 05:00:00 AM,48,-122,31,0,31
2718,ElliotBayTrailMyrtlePark,04/24/2014 06:00:00 AM,48,-122,68,0,68
2719,ElliotBayTrailMyrtlePark,04/24/2014 07:00:00 AM,48,-122,100,0,100
2720,ElliotBayTrailMyrtlePark,04/24/2014 08:00:00 AM,48,-122,53,0,53
2721,ElliotBayTrailMyrtlePark,04/24/2014 09:00:00 AM,48,-122,32,0,32
2722,ElliotBayTrailMyrtlePark,04/24/2014 10:00:00 AM,48,-122,13,0,13
2723,ElliotBayTrailMyrtlePark,04/24/2014 11:00:00 AM,48,-122,4,0,4
2724,ElliotBayTrailMyrtlePark,04/24/2014 12:00:00 PM,48,-122,13,0,13
2725,ElliotBayTrailMyrtlePark,04/24/2014 01:00:00 PM,48,-122,22,0,22
2726,ElliotBayTrailMyrtlePark,04/24/2014 02:00:00 PM,48,-122,33,0,33
2727,ElliotBayTrailMyrtlePark,04/24/2014 03:00:00 PM,48,-122,64,0,64
2728,ElliotBayTrailMyrtlePark,04/24/2014 04:00:00 PM,48,-122,140,0,140
2729,ElliotBayTrailMyrtlePark,04/24/2014 05:00:00 PM,48,-122,106,1,107
2730,ElliotBayTrailMyrtlePark,04/24/2014 06:00:00 PM,48,-122,42,11,53
2731,ElliotBayTrailMyrtlePark,04/24/2014 07:00:00 PM,48,-122,23,1,24
2732,ElliotBayTrailMyrtlePark,04/24/2014 08:00:00 PM,48,-122,7,0,7
2733,ElliotBayTrailMyrtlePark,04/24/2014 09:00:00 PM,48,-122,3,0,3
2734,ElliotBayTrailMyrtlePark,04/24/2014 10:00:00 PM,48,-122,4,0,4
2735,ElliotBayTrailMyrtlePark,04/24/2014 11:00:00 PM,48,-122,1,0,1
2736,ElliotBayTrailMyrtlePark,04/25/2014 12:00:00 AM,48,-122,3,0,3
2737,ElliotBayTrailMyrtlePark,04/25/2014 01:00:00 AM,48,-122,0,0,0
2738,ElliotBayTrailMyrtlePark,04/25/2014 02:00:00 AM,48,-122,0,0,0
2739,ElliotBayTrailMyrtlePark,04/25/2014 03:00:00 AM,48,-122,0,0,0
2740,ElliotBayTrailMyrtlePark,04/25/2014 04:00:00 AM,48,-122,16,0,16
2741,ElliotBayTrailMyrtlePark,04/25/2014 05:00:00 AM,48,-122,41,0,41
2742,ElliotBayTrailMyrtlePark,04/25/2014 06:00:00 AM,48,-122,111,0,111
2743,ElliotBayTrailMyrtlePark,04/25/2014 07:00:00 AM,48,-122,121,0,121
2744,ElliotBayTrailMyrtlePark,04/25/2014 08:00:00 AM,48,-122,61,0,61
2745,ElliotBayTrailMyrtlePark,04/25/2014 09:00:00 AM,48,-122,45,0,45
2746,ElliotBayTrailMyrtlePark,04/25/2014 10:00:00 AM,48,-122,35,0,35
2747,ElliotBayTrailMyrtlePark,04/25/2014 11:00:00 AM,48,-122,28,13,41
2748,ElliotBayTrailMyrtlePark,04/25/2014 12:00:00 PM,48,-122,21,17,38
2749,ElliotBayTrailMyrtlePark,04/25/2014 01:00:00 PM,48,-122,39,36,75
2750,ElliotBayTrailMyrtlePark,04/25/2014 02:00:00 PM,48,-122,23,53,76
2751,ElliotBayTrailMyrtlePark,04/25/2014 03:00:00 PM,48,-122,39,91,130
2752,ElliotBayTrailMyrtlePark,04/25/2014 04:00:00 PM,48,-122,74,138,212
2753,ElliotBayTrailMyrtlePark,04/25/2014 05:00:00 PM,48,-122,44,92,136
2754,ElliotBayTrailMyrtlePark,04/25/2014 06:00:00 PM,48,-122,25,31,56
2755,ElliotBayTrailMyrtlePark,04/25/2014 07:00:00 PM,48,-122,17,28,45
2756,ElliotBayTrailMyrtlePark,04/25/2014 08:00:00 PM,48,-122,11,1,12
2757,ElliotBayTrailMyrtlePark,04/25/2014 09:00:00 PM,48,-122,6,4,10
2758,ElliotBayTrailMyrtlePark,04/25/2014 10:00:00 PM,48,-122,1,1,2
2759,ElliotBayTrailMyrtlePark,04/25/2014 11:00:00 PM,48,-122,0,1,1
2760,ElliotBayTrailMyrtlePark,04/26/2014 12:00:00 AM,48,-122,1,0,1
2761,ElliotBayTrailMyrtlePark,04/26/2014 01:00:00 AM,48,-122,0,0,0
2762,ElliotBayTrailMyrtlePark,04/26/2014 02:00:00 AM,48,-122,0,0,0
2763,ElliotBayTrailMyrtlePark,04/26/2014 03:00:00 AM,48,-122,2,0,2
2764,ElliotBayTrailMyrtlePark,04/26/2014 04:00:00 AM,48,-122,1,2,3
2765,ElliotBayTrailMyrtlePark,04/26/2014 05:00:00 AM,48,-122,7,1,8
2766,ElliotBayTrailMyrtlePark,04/26/2014 06:00:00 AM,48,-122,4,6,10
2767,ElliotBayTrailMyrtlePark,04/26/2014 07:00:00 AM,48,-122,15,14,29
2768,ElliotBayTrailMyrtlePark,04/26/2014 08:00:00 AM,48,-122,23,40,63
2769,ElliotBayTrailMyrtlePark,04/26/2014 09:00:00 AM,48,-122,23,41,64
2770,ElliotBayTrailMyrtlePark,04/26/2014 10:00:00 AM,48,-122,22,88,110
2771,ElliotBayTrailMyrtlePark,04/26/2014 11:00:00 AM,48,-122,36,86,122
2772,ElliotBayTrailMyrtlePark,04/26/2014 12:00:00 PM,48,-122,21,70,91
2773,ElliotBayTrailMyrtlePark,04/26/2014 01:00:00 PM,48,-122,42,43,85
2774,ElliotBayTrailMyrtlePark,04/26/2014 02:00:00 PM,48,-122,57,65,122
2775,ElliotBayTrailMyrtlePark,04/26/2014 03:00:00 PM,48,-122,46,60,106
2776,ElliotBayTrailMyrtlePark,04/26/2014 04:00:00 PM,48,-122,22,50,72
2777,ElliotBayTrailMyrtlePark,04/26/2014 05:00:00 PM,48,-122,14,27,41
2778,ElliotBayTrailMyrtlePark,04/26/2014 06:00:00 PM,48,-122,6,9,15
2779,ElliotBayTrailMyrtlePark,04/26/2014 07:00:00 PM,48,-122,5,1,6
2780,ElliotBayTrailMyrtlePark,04/26/2014 08:00:00 PM,48,-122,3,0,3
2781,ElliotBayTrailMyrtlePark,04/26/2014 09:00:00 PM,48,-122,1,0,1
2782,ElliotBayTrailMyrtlePark,04/26/2014 10:00:00 PM,48,-122,3,0,3
2783,ElliotBayTrailMyrtlePark,04/26/2014 11:00:00 PM,48,-122,0,0,0
2784,ElliotBayTrailMyrtlePark,04/27/2014 12:00:00 AM,48,-122,1,0,1
2785,ElliotBayTrailMyrtlePark,04/27/2014 01:00:00 AM,48,-122,1,0,1
2786,ElliotBayTrailMyrtlePark,04/27/2014 02:00:00 AM,48,-122,0,0,0
2787,ElliotBayTrailMyrtlePark,04/27/2014 03:00:00 AM,48,-122,0,0,0
2788,ElliotBayTrailMyrtlePark,04/27/2014 04:00:00 AM,48,-122,0,0,0
2789,ElliotBayTrailMyrtlePark,04/27/2014 05:00:00 AM,48,-122,6,0,6
2790,ElliotBayTrailMyrtlePark,04/27/2014 06:00:00 AM,48,-122,5,0,5
2791,ElliotBayTrailMyrtlePark,04/27/2014 07:00:00 AM,48,-122,10,0,10
2792,ElliotBayTrailMyrtlePark,04/27/2014 08:00:00 AM,48,-122,27,0,27
2793,ElliotBayTrailMyrtlePark,04/27/2014 09:00:00 AM,48,-122,38,0,38
2794,ElliotBayTrailMyrtlePark,04/27/2014 10:00:00 AM,48,-122,27,12,39
2795,ElliotBayTrailMyrtlePark,04/27/2014 11:00:00 AM,48,-122,26,22,48
2796,ElliotBayTrailMyrtlePark,04/27/2014 12:00:00 PM,48,-122,14,34,48
2797,ElliotBayTrailMyrtlePark,04/27/2014 01:00:00 PM,48,-122,22,22,44
2798,ElliotBayTrailMyrtlePark,04/27/2014 02:00:00 PM,48,-122,26,22,48
2799,ElliotBayTrailMyrtlePark,04/27/2014 03:00:00 PM,48,-122,12,23,35
2800,ElliotBayTrailMyrtlePark,04/27/2014 04:00:00 PM,48,-122,8,25,33
2801,ElliotBayTrailMyrtlePark,04/27/2014 05:00:00 PM,48,-122,9,17,26
2802,ElliotBayTrailMyrtlePark,04/27/2014 06:00:00 PM,48,-122,7,9,16
2803,ElliotBayTrailMyrtlePark,04/27/2014 07:00:00 PM,48,-122,2,15,17
2804,ElliotBayTrailMyrtlePark,04/27/2014 08:00:00 PM,48,-122,2,3,5
2805,ElliotBayTrailMyrtlePark,04/27/2014 09:00:00 PM,48,-122,1,4,5
2806,ElliotBayTrailMyrtlePark,04/27/2014 10:00:00 PM,48,-122,1,1,2
2807,ElliotBayTrailMyrtlePark,04/27/2014 11:00:00 PM,48,-122,2,0,2
2808,ElliotBayTrailMyrtlePark,04/28/2014 12:00:00 AM,48,-122,1,0,1
2809,ElliotBayTrailMyrtlePark,04/28/2014 01:00:00 AM,48,-122,1,1,2
2810,ElliotBayTrailMyrtlePark,04/28/2014 02:00:00 AM,48,-122,0,0,0
2811,ElliotBayTrailMyrtlePark,04/28/2014 03:00:00 AM,48,-122,0,2,2
2812,ElliotBayTrailMyrtlePark,04/28/2014 04:00:00 AM,48,-122,11,12,23
2813,ElliotBayTrailMyrtlePark,04/28/2014 05:00:00 AM,48,-122,36,16,52
2814,ElliotBayTrailMyrtlePark,04/28/2014 06:00:00 AM,48,-122,132,10,142
2815,ElliotBayTrailMyrtlePark,04/28/2014 07:00:00 AM,48,-122,79,66,145
2816,ElliotBayTrailMyrtlePark,04/28/2014 08:00:00 AM,48,-122,19,53,72
2817,ElliotBayTrailMyrtlePark,04/28/2014 09:00:00 AM,48,-122,12,32,44
2818,ElliotBayTrailMyrtlePark,04/28/2014 10:00:00 AM,48,-122,16,25,41
2819,ElliotBayTrailMyrtlePark,04/28/2014 11:00:00 AM,48,-122,12,24,36
2820,ElliotBayTrailMyrtlePark,04/28/2014 12:00:00 PM,48,-122,9,19,28
2821,ElliotBayTrailMyrtlePark,04/28/2014 01:00:00 PM,48,-122,16,30,46
2822,ElliotBayTrailMyrtlePark,04/28/2014 02:00:00 PM,48,-122,36,50,86
2823,ElliotBayTrailMyrtlePark,04/28/2014 03:00:00 PM,48,-122,78,74,152
2824,ElliotBayTrailMyrtlePark,04/28/2014 04:00:00 PM,48,-122,164,121,285
2825,ElliotBayTrailMyrtlePark,04/28/2014 05:00:00 PM,48,-122,105,86,191
2826,ElliotBayTrailMyrtlePark,04/28/2014 06:00:00 PM,48,-122,30,65,95
2827,ElliotBayTrailMyrtlePark,04/28/2014 07:00:00 PM,48,-122,10,27,37
2828,ElliotBayTrailMyrtlePark,04/28/2014 08:00:00 PM,48,-122,8,0,8
2829,ElliotBayTrailMyrtlePark,04/28/2014 09:00:00 PM,48,-122,2,4,6
2830,ElliotBayTrailMyrtlePark,04/28/2014 10:00:00 PM,48,-122,3,1,4
2831,ElliotBayTrailMyrtlePark,04/28/2014 11:00:00 PM,48,-122,2,4,6
2832,ElliotBayTrailMyrtlePark,04/29/2014 12:00:00 AM,48,-122,0,1,1
2833,ElliotBayTrailMyrtlePark,04/29/2014 01:00:00 AM,48,-122,1,0,1
2834,ElliotBayTrailMyrtlePark,04/29/2014 02:00:00 AM,48,-122,1,1,2
2835,ElliotBayTrailMyrtlePark,04/29/2014 03:00:00 AM,48,-122,0,1,1
2836,ElliotBayTrailMyrtlePark,04/29/2014 04:00:00 AM,48,-122,17,9,26
2837,ElliotBayTrailMyrtlePark,04/29/2014 05:00:00 AM,48,-122,29,36,65
2838,ElliotBayTrailMyrtlePark,04/29/2014 06:00:00 AM,48,-122,125,61,186
2839,ElliotBayTrailMyrtlePark,04/29/2014 07:00:00 AM,48,-122,133,48,181
2840,ElliotBayTrailMyrtlePark,04/29/2014 08:00:00 AM,48,-122,51,36,87
2841,ElliotBayTrailMyrtlePark,04/29/2014 09:00:00 AM,48,-122,15,34,49
2842,ElliotBayTrailMyrtlePark,04/29/2014 10:00:00 AM,48,-122,7,14,21
2843,ElliotBayTrailMyrtlePark,04/29/2014 11:00:00 AM,48,-122,17,29,46
2844,ElliotBayTrailMyrtlePark,04/29/2014 12:00:00 PM,48,-122,29,34,63
2845,ElliotBayTrailMyrtlePark,04/29/2014 01:00:00 PM,48,-122,33,39,72
2846,ElliotBayTrailMyrtlePark,04/29/2014 02:00:00 PM,48,-122,49,64,113
2847,ElliotBayTrailMyrtlePark,04/29/2014 03:00:00 PM,48,-122,105,85,190
2848,ElliotBayTrailMyrtlePark,04/29/2014 04:00:00 PM,48,-122,232,101,333
2849,ElliotBayTrailMyrtlePark,04/29/2014 05:00:00 PM,48,-122,170,91,261
2850,ElliotBayTrailMyrtlePark,04/29/2014 06:00:00 PM,48,-122,71,68,139
2851,ElliotBayTrailMyrtlePark,04/29/2014 07:00:00 PM,48,-122,31,38,69
2852,ElliotBayTrailMyrtlePark,04/29/2014 08:00:00 PM,48,-122,11,6,17
2853,ElliotBayTrailMyrtlePark,04/29/2014 09:00:00 PM,48,-122,2,4,6
2854,ElliotBayTrailMyrtlePark,04/29/2014 10:00:00 PM,48,-122,2,3,5
2855,ElliotBayTrailMyrtlePark,04/29/2014 11:00:00 PM,48,-122,2,1,3
2856,ElliotBayTrailMyrtlePark,04/30/2014 12:00:00 AM,48,-122,0,0,0
2857,ElliotBayTrailMyrtlePark,04/30/2014 01:00:00 AM,48,-122,0,0,0
2858,ElliotBayTrailMyrtlePark,04/30/2014 02:00:00 AM,48,-122,1,2,3
2859,ElliotBayTrailMyrtlePark,04/30/2014 03:00:00 AM,48,-122,2,0,2
2860,ElliotBayTrailMyrtlePark,04/30/2014 04:00:00 AM,48,-122,3,15,18
2861,ElliotBayTrailMyrtlePark,04/30/2014 05:00:00 AM,48,-122,10,76,86
2862,ElliotBayTrailMyrtlePark,04/30/2014 06:00:00 AM,48,-122,23,157,180
2863,ElliotBayTrailMyrtlePark,04/30/2014 07:00:00 AM,48,-122,53,157,210
2864,ElliotBayTrailMyrtlePark,04/30/2014 08:00:00 AM,48,-122,13,74,87
2865,ElliotBayTrailMyrtlePark,04/30/2014 09:00:00 AM,48,-122,18,46,64
2866,ElliotBayTrailMyrtlePark,04/30/2014 10:00:00 AM,48,-122,15,41,56
2867,ElliotBayTrailMyrtlePark,04/30/2014 11:00:00 AM,48,-122,24,42,66
2868,ElliotBayTrailMyrtlePark,04/30/2014 12:00:00 PM,48,-122,35,31,66
2869,ElliotBayTrailMyrtlePark,04/30/2014 01:00:00 PM,48,-122,50,42,92
2870,ElliotBayTrailMyrtlePark,04/30/2014 02:00:00 PM,48,-122,49,54,103
2871,ElliotBayTrailMyrtlePark,04/30/2014 03:00:00 PM,48,-122,143,80,223
2872,ElliotBayTrailMyrtlePark,04/30/2014 04:00:00 PM,48,-122,262,100,362
2873,ElliotBayTrailMyrtlePark,04/30/2014 05:00:00 PM,48,-122,173,89,262
2874,ElliotBayTrailMyrtlePark,04/30/2014 06:00:00 PM,48,-122,74,71,145
2875,ElliotBayTrailMyrtlePark,04/30/2014 07:00:00 PM,48,-122,47,50,97
2876,ElliotBayTrailMyrtlePark,04/30/2014 08:00:00 PM,48,-122,7,8,15
2877,ElliotBayTrailMyrtlePark,04/30/2014 09:00:00 PM,48,-122,3,0,3
2878,ElliotBayTrailMyrtlePark,04/30/2014 10:00:00 PM,48,-122,2,3,5
2879,ElliotBayTrailMyrtlePark,04/30/2014 11:00:00 PM,48,-122,2,0,2
2880,ElliotBayTrailMyrtlePark,05/01/2014 12:00:00 AM,48,-122,0,0,0
2881,ElliotBayTrailMyrtlePark,05/01/2014 01:00:00 AM,48,-122,2,1,3
2882,ElliotBayTrailMyrtlePark,05/01/2014 02:00:00 AM,48,-122,1,1,2
2883,ElliotBayTrailMyrtlePark,05/01/2014 03:00:00 AM,48,-122,0,0,0
2884,ElliotBayTrailMyrtlePark,05/01/2014 04:00:00 AM,48,-122,5,20,25
2885,ElliotBayTrailMyrtlePark,05/01/2014 05:00:00 AM,48,-122,7,79,86
2886,ElliotBayTrailMyrtlePark,05/01/2014 06:00:00 AM,48,-122,37,207,244
2887,ElliotBayTrailMyrtlePark,05/01/2014 07:00:00 AM,48,-122,26,201,227
2888,ElliotBayTrailMyrtlePark,05/01/2014 08:00:00 AM,48,-122,6,94,100
2889,ElliotBayTrailMyrtlePark,05/01/2014 09:00:00 AM,48,-122,22,38,60
2890,ElliotBayTrailMyrtlePark,05/01/2014 10:00:00 AM,48,-122,33,31,64
2891,ElliotBayTrailMyrtlePark,05/01/2014 11:00:00 AM,48,-122,35,53,88
2892,ElliotBayTrailMyrtlePark,05/01/2014 12:00:00 PM,48,-122,,,
2893,ElliotBayTrailMyrtlePark,05/01/2014 01:00:00 PM,48,-122,49,34,83
2894,ElliotBayTrailMyrtlePark,05/01/2014 02:00:00 PM,48,-122,73,30,103
2895,ElliotBayTrailMyrtlePark,05/01/2014 03:00:00 PM,48,-122,100,64,164
2896,ElliotBayTrailMyrtlePark,05/01/2014 04:00:00 PM,48,-122,190,95,285
2897,ElliotBayTrailMyrtlePark,05/01/2014 05:00:00 PM,48,-122,292,116,408
2898,ElliotBayTrailMyrtlePark,05/01/2014 06:00:00 PM,48,-122,183,83,266
2899,ElliotBayTrailMyrtlePark,05/01/2014 07:00:00 PM,48,-122,109,63,172
2900,ElliotBayTrailMyrtlePark,05/01/2014 08:00:00 PM,48,-122,47,38,85
2901,ElliotBayTrailMyrtlePark,05/01/2014 09:00:00 PM,48,-122,11,17,28
2902,ElliotBayTrailMyrtlePark,05/01/2014 10:00:00 PM,48,-122,11,1,12
2903,ElliotBayTrailMyrtlePark,05/01/2014 11:00:00 PM,48,-122,6,4,10
2904,ElliotBayTrailMyrtlePark,05/02/2014 12:00:00 AM,48,-122,4,2,6
2905,ElliotBayTrailMyrtlePark,05/02/2014 01:00:00 AM,48,-122,1,0,1
2906,ElliotBayTrailMyrtlePark,05/02/2014 02:00:00 AM,48,-122,0,2,2
2907,ElliotBayTrailMyrtlePark,05/02/2014 03:00:00 AM,48,-122,1,0,1
2908,ElliotBayTrailMyrtlePark,05/02/2014 04:00:00 AM,48,-122,1,0,1
2909,ElliotBayTrailMyrtlePark,05/02/2014 05:00:00 AM,48,-122,6,19,25
2910,ElliotBayTrailMyrtlePark,05/02/2014 06:00:00 AM,48,-122,14,45,59
2911,ElliotBayTrailMyrtlePark,05/02/2014 07:00:00 AM,48,-122,51,141,192
2912,ElliotBayTrailMyrtlePark,05/02/2014 08:00:00 AM,48,-122,37,173,210
2913,ElliotBayTrailMyrtlePark,05/02/2014 09:00:00 AM,48,-122,23,81,104
2914,ElliotBayTrailMyrtlePark,05/02/2014 10:00:00 AM,48,-122,28,37,65
2915,ElliotBayTrailMyrtlePark,05/02/2014 11:00:00 AM,48,-122,24,28,52
2916,ElliotBayTrailMyrtlePark,05/02/2014 12:00:00 PM,48,-122,30,27,57
2917,ElliotBayTrailMyrtlePark,05/02/2014 01:00:00 PM,48,-122,36,38,74
2918,ElliotBayTrailMyrtlePark,05/02/2014 02:00:00 PM,48,-122,46,28,74
2919,ElliotBayTrailMyrtlePark,05/02/2014 03:00:00 PM,48,-122,85,51,136
2920,ElliotBayTrailMyrtlePark,05/02/2014 04:00:00 PM,48,-122,136,57,193
2921,ElliotBayTrailMyrtlePark,05/02/2014 05:00:00 PM,48,-122,181,51,232
2922,ElliotBayTrailMyrtlePark,05/02/2014 06:00:00 PM,48,-122,111,34,145
2923,ElliotBayTrailMyrtlePark,05/02/2014 07:00:00 PM,48,-122,41,16,57
2924,ElliotBayTrailMyrtlePark,05/02/2014 08:00:00 PM,48,-122,13,4,17
2925,ElliotBayTrailMyrtlePark,05/02/2014 09:00:00 PM,48,-122,11,0,11
2926,ElliotBayTrailMyrtlePark,05/02/2014 10:00:00 PM,48,-122,6,3,9
2927,ElliotBayTrailMyrtlePark,05/02/2014 11:00:00 PM,48,-122,4,1,5
2928,ElliotBayTrailMyrtlePark,05/03/2014 12:00:00 AM,48,-122,3,11,14
2929,ElliotBayTrailMyrtlePark,05/03/2014 01:00:00 AM,48,-122,1,0,1
2930,ElliotBayTrailMyrtlePark,05/03/2014 02:00:00 AM,48,-122,1,0,1
2931,ElliotBayTrailMyrtlePark,05/03/2014 03:00:00 AM,48,-122,2,0,2
2932,ElliotBayTrailMyrtlePark,05/03/2014 04:00:00 AM,48,-122,1,1,2
2933,ElliotBayTrailMyrtlePark,05/03/2014 05:00:00 AM,48,-122,1,0,1
2934,ElliotBayTrailMyrtlePark,05/03/2014 06:00:00 AM,48,-122,10,6,16
2935,ElliotBayTrailMyrtlePark,05/03/2014 07:00:00 AM,48,-122,13,15,28
2936,ElliotBayTrailMyrtlePark,05/03/2014 08:00:00 AM,48,-122,8,19,27
2937,ElliotBayTrailMyrtlePark,05/03/2014 09:00:00 AM,48,-122,21,51,72
2938,ElliotBayTrailMyrtlePark,05/03/2014 10:00:00 AM,48,-122,36,32,68
2939,ElliotBayTrailMyrtlePark,05/03/2014 11:00:00 AM,48,-122,39,19,58
2940,ElliotBayTrailMyrtlePark,05/03/2014 12:00:00 PM,48,-122,20,17,37
2941,ElliotBayTrailMyrtlePark,05/03/2014 01:00:00 PM,48,-122,24,27,51
2942,ElliotBayTrailMyrtlePark,05/03/2014 02:00:00 PM,48,-122,16,15,31
2943,ElliotBayTrailMyrtlePark,05/03/2014 03:00:00 PM,48,-122,14,13,27
2944,ElliotBayTrailMyrtlePark,05/03/2014 04:00:00 PM,48,-122,38,3,41
2945,ElliotBayTrailMyrtlePark,05/03/2014 05:00:00 PM,48,-122,13,2,15
2946,ElliotBayTrailMyrtlePark,05/03/2014 06:00:00 PM,48,-122,2,13,15
2947,ElliotBayTrailMyrtlePark,05/03/2014 07:00:00 PM,48,-122,2,2,4
2948,ElliotBayTrailMyrtlePark,05/03/2014 08:00:00 PM,48,-122,2,1,3
2949,ElliotBayTrailMyrtlePark,05/03/2014 09:00:00 PM,48,-122,9,0,9
2950,ElliotBayTrailMyrtlePark,05/03/2014 10:00:00 PM,48,-122,1,1,2
2951,ElliotBayTrailMyrtlePark,05/03/2014 11:00:00 PM,48,-122,2,0,2
2952,ElliotBayTrailMyrtlePark,05/04/2014 12:00:00 AM,48,-122,1,0,1
2953,ElliotBayTrailMyrtlePark,05/04/2014 01:00:00 AM,48,-122,0,0,0
2954,ElliotBayTrailMyrtlePark,05/04/2014 02:00:00 AM,48,-122,0,0,0
2955,ElliotBayTrailMyrtlePark,05/04/2014 03:00:00 AM,48,-122,1,0,1
2956,ElliotBayTrailMyrtlePark,05/04/2014 04:00:00 AM,48,-122,0,0,0
2957,ElliotBayTrailMyrtlePark,05/04/2014 05:00:00 AM,48,-122,1,0,1
2958,ElliotBayTrailMyrtlePark,05/04/2014 06:00:00 AM,48,-122,2,2,4
2959,ElliotBayTrailMyrtlePark,05/04/2014 07:00:00 AM,48,-122,2,3,5
2960,ElliotBayTrailMyrtlePark,05/04/2014 08:00:00 AM,48,-122,2,7,9
2961,ElliotBayTrailMyrtlePark,05/04/2014 09:00:00 AM,48,-122,13,13,26
2962,ElliotBayTrailMyrtlePark,05/04/2014 10:00:00 AM,48,-122,15,9,24
2963,ElliotBayTrailMyrtlePark,05/04/2014 11:00:00 AM,48,-122,7,2,9
2964,ElliotBayTrailMyrtlePark,05/04/2014 12:00:00 PM,48,-122,14,4,18
2965,ElliotBayTrailMyrtlePark,05/04/2014 01:00:00 PM,48,-122,12,9,21
2966,ElliotBayTrailMyrtlePark,05/04/2014 02:00:00 PM,48,-122,8,6,14
2967,ElliotBayTrailMyrtlePark,05/04/2014 03:00:00 PM,48,-122,15,8,23
2968,ElliotBayTrailMyrtlePark,05/04/2014 04:00:00 PM,48,-122,7,7,14
2969,ElliotBayTrailMyrtlePark,05/04/2014 05:00:00 PM,48,-122,6,8,14
2970,ElliotBayTrailMyrtlePark,05/04/2014 06:00:00 PM,48,-122,9,3,12
2971,ElliotBayTrailMyrtlePark,05/04/2014 07:00:00 PM,48,-122,7,6,13
2972,ElliotBayTrailMyrtlePark,05/04/2014 08:00:00 PM,48,-122,3,2,5
2973,ElliotBayTrailMyrtlePark,05/04/2014 09:00:00 PM,48,-122,2,0,2
2974,ElliotBayTrailMyrtlePark,05/04/2014 10:00:00 PM,48,-122,2,1,3
2975,ElliotBayTrailMyrtlePark,05/04/2014 11:00:00 PM,48,-122,2,2,4
2976,ElliotBayTrailMyrtlePark,05/05/2014 12:00:00 AM,48,-122,1,0,1
2977,ElliotBayTrailMyrtlePark,05/05/2014 01:00:00 AM,48,-122,1,1,2
2978,ElliotBayTrailMyrtlePark,05/05/2014 02:00:00 AM,48,-122,1,1,2
2979,ElliotBayTrailMyrtlePark,05/05/2014 03:00:00 AM,48,-122,0,0,0
2980,ElliotBayTrailMyrtlePark,05/05/2014 04:00:00 AM,48,-122,0,0,0
2981,ElliotBayTrailMyrtlePark,05/05/2014 05:00:00 AM,48,-122,6,15,21
2982,ElliotBayTrailMyrtlePark,05/05/2014 06:00:00 AM,48,-122,14,26,40
2983,ElliotBayTrailMyrtlePark,05/05/2014 07:00:00 AM,48,-122,40,95,135
2984,ElliotBayTrailMyrtlePark,05/05/2014 08:00:00 AM,48,-122,20,125,145
2985,ElliotBayTrailMyrtlePark,05/05/2014 09:00:00 AM,48,-122,5,59,64
2986,ElliotBayTrailMyrtlePark,05/05/2014 10:00:00 AM,48,-122,6,17,23
2987,ElliotBayTrailMyrtlePark,05/05/2014 11:00:00 AM,48,-122,8,12,20
2988,ElliotBayTrailMyrtlePark,05/05/2014 12:00:00 PM,48,-122,6,1,7
2989,ElliotBayTrailMyrtlePark,05/05/2014 01:00:00 PM,48,-122,13,9,22
2990,ElliotBayTrailMyrtlePark,05/05/2014 02:00:00 PM,48,-122,10,13,23
2991,ElliotBayTrailMyrtlePark,05/05/2014 03:00:00 PM,48,-122,28,14,42
2992,ElliotBayTrailMyrtlePark,05/05/2014 04:00:00 PM,48,-122,62,30,92
2993,ElliotBayTrailMyrtlePark,05/05/2014 05:00:00 PM,48,-122,168,40,208
2994,ElliotBayTrailMyrtlePark,05/05/2014 06:00:00 PM,48,-122,99,39,138
2995,ElliotBayTrailMyrtlePark,05/05/2014 07:00:00 PM,48,-122,50,30,80
2996,ElliotBayTrailMyrtlePark,05/05/2014 08:00:00 PM,48,-122,27,15,42
2997,ElliotBayTrailMyrtlePark,05/05/2014 09:00:00 PM,48,-122,5,4,9
2998,ElliotBayTrailMyrtlePark,05/05/2014 10:00:00 PM,48,-122,2,2,4
2999,ElliotBayTrailMyrtlePark,05/05/2014 11:00:00 PM,48,-122,2,1,3
3000,ElliotBayTrailMyrtlePark,05/06/2014 12:00:00 AM,48,-122,3,1,4
3001,ElliotBayTrailMyrtlePark,05/06/2014 01:00:00 AM,48,-122,0,0,0
3002,ElliotBayTrailMyrtlePark,05/06/2014 02:00:00 AM,48,-122,0,0,0
3003,ElliotBayTrailMyrtlePark,05/06/2014 03:00:00 AM,48,-122,1,1,2
3004,ElliotBayTrailMyrtlePark,05/06/2014 04:00:00 AM,48,-122,0,0,0
3005,ElliotBayTrailMyrtlePark,05/06/2014 05:00:00 AM,48,-122,10,20,30
3006,ElliotBayTrailMyrtlePark,05/06/2014 06:00:00 AM,48,-122,24,49,73
3007,ElliotBayTrailMyrtlePark,05/06/2014 07:00:00 AM,48,-122,51,165,216
3008,ElliotBayTrailMyrtlePark,05/06/2014 08:00:00 AM,48,-122,24,151,175
3009,ElliotBayTrailMyrtlePark,05/06/2014 09:00:00 AM,48,-122,24,74,98
3010,ElliotBayTrailMyrtlePark,05/06/2014 10:00:00 AM,48,-122,18,30,48
3011,ElliotBayTrailMyrtlePark,05/06/2014 11:00:00 AM,48,-122,13,22,35
3012,ElliotBayTrailMyrtlePark,05/06/2014 12:00:00 PM,48,-122,18,18,36
3013,ElliotBayTrailMyrtlePark,05/06/2014 01:00:00 PM,48,-122,23,13,36
3014,ElliotBayTrailMyrtlePark,05/06/2014 02:00:00 PM,48,-122,35,24,59
3015,ElliotBayTrailMyrtlePark,05/06/2014 03:00:00 PM,48,-122,37,48,85
3016,ElliotBayTrailMyrtlePark,05/06/2014 04:00:00 PM,48,-122,125,41,166
3017,ElliotBayTrailMyrtlePark,05/06/2014 05:00:00 PM,48,-122,246,89,335
3018,ElliotBayTrailMyrtlePark,05/06/2014 06:00:00 PM,48,-122,144,58,202
3019,ElliotBayTrailMyrtlePark,05/06/2014 07:00:00 PM,48,-122,66,34,100
3020,ElliotBayTrailMyrtlePark,05/06/2014 08:00:00 PM,48,-122,39,21,60
3021,ElliotBayTrailMyrtlePark,05/06/2014 09:00:00 PM,48,-122,8,3,11
3022,ElliotBayTrailMyrtlePark,05/06/2014 10:00:00 PM,48,-122,6,2,8
3023,ElliotBayTrailMyrtlePark,05/06/2014 11:00:00 PM,48,-122,4,1,5
3024,ElliotBayTrailMyrtlePark,05/07/2014 12:00:00 AM,48,-122,0,1,1
3025,ElliotBayTrailMyrtlePark,05/07/2014 01:00:00 AM,48,-122,1,0,1
3026,ElliotBayTrailMyrtlePark,05/07/2014 02:00:00 AM,48,-122,1,0,1
3027,ElliotBayTrailMyrtlePark,05/07/2014 03:00:00 AM,48,-122,0,0,0
3028,ElliotBayTrailMyrtlePark,05/07/2014 04:00:00 AM,48,-122,0,0,0
3029,ElliotBayTrailMyrtlePark,05/07/2014 05:00:00 AM,48,-122,9,17,26
3030,ElliotBayTrailMyrtlePark,05/07/2014 06:00:00 AM,48,-122,29,58,87
3031,ElliotBayTrailMyrtlePark,05/07/2014 07:00:00 AM,48,-122,50,176,226
3032,ElliotBayTrailMyrtlePark,05/07/2014 08:00:00 AM,48,-122,38,210,248
3033,ElliotBayTrailMyrtlePark,05/07/2014 09:00:00 AM,48,-122,27,89,116
3034,ElliotBayTrailMyrtlePark,05/07/2014 10:00:00 AM,48,-122,21,45,66
3035,ElliotBayTrailMyrtlePark,05/07/2014 11:00:00 AM,48,-122,26,39,65
3036,ElliotBayTrailMyrtlePark,05/07/2014 12:00:00 PM,48,-122,20,24,44
3037,ElliotBayTrailMyrtlePark,05/07/2014 01:00:00 PM,48,-122,30,34,64
3038,ElliotBayTrailMyrtlePark,05/07/2014 02:00:00 PM,48,-122,44,37,81
3039,ElliotBayTrailMyrtlePark,05/07/2014 03:00:00 PM,48,-122,64,38,102
3040,ElliotBayTrailMyrtlePark,05/07/2014 04:00:00 PM,48,-122,112,72,184
3041,ElliotBayTrailMyrtlePark,05/07/2014 05:00:00 PM,48,-122,296,109,405
3042,ElliotBayTrailMyrtlePark,05/07/2014 06:00:00 PM,48,-122,154,87,241
3043,ElliotBayTrailMyrtlePark,05/07/2014 07:00:00 PM,48,-122,116,56,172
3044,ElliotBayTrailMyrtlePark,05/07/2014 08:00:00 PM,48,-122,64,39,103
3045,ElliotBayTrailMyrtlePark,05/07/2014 09:00:00 PM,48,-122,56,9,65
3046,ElliotBayTrailMyrtlePark,05/07/2014 10:00:00 PM,48,-122,8,4,12
3047,ElliotBayTrailMyrtlePark,05/07/2014 11:00:00 PM,48,-122,9,2,11
3048,ElliotBayTrailMyrtlePark,05/08/2014 12:00:00 AM,48,-122,1,5,6
3049,ElliotBayTrailMyrtlePark,05/08/2014 01:00:00 AM,48,-122,1,0,1
3050,ElliotBayTrailMyrtlePark,05/08/2014 02:00:00 AM,48,-122,2,1,3
3051,ElliotBayTrailMyrtlePark,05/08/2014 03:00:00 AM,48,-122,1,1,2
3052,ElliotBayTrailMyrtlePark,05/08/2014 04:00:00 AM,48,-122,0,0,0
3053,ElliotBayTrailMyrtlePark,05/08/2014 05:00:00 AM,48,-122,14,17,31
3054,ElliotBayTrailMyrtlePark,05/08/2014 06:00:00 AM,48,-122,25,35,60
3055,ElliotBayTrailMyrtlePark,05/08/2014 07:00:00 AM,48,-122,41,129,170
3056,ElliotBayTrailMyrtlePark,05/08/2014 08:00:00 AM,48,-122,41,126,167
3057,ElliotBayTrailMyrtlePark,05/08/2014 09:00:00 AM,48,-122,23,71,94
3058,ElliotBayTrailMyrtlePark,05/08/2014 10:00:00 AM,48,-122,7,26,33
3059,ElliotBayTrailMyrtlePark,05/08/2014 11:00:00 AM,48,-122,9,12,21
3060,ElliotBayTrailMyrtlePark,05/08/2014 12:00:00 PM,48,-122,6,6,12
3061,ElliotBayTrailMyrtlePark,05/08/2014 01:00:00 PM,48,-122,15,1,16
3062,ElliotBayTrailMyrtlePark,05/08/2014 02:00:00 PM,48,-122,10,5,15
3063,ElliotBayTrailMyrtlePark,05/08/2014 03:00:00 PM,48,-122,21,22,43
3064,ElliotBayTrailMyrtlePark,05/08/2014 04:00:00 PM,48,-122,43,24,67
3065,ElliotBayTrailMyrtlePark,05/08/2014 05:00:00 PM,48,-122,158,37,195
3066,ElliotBayTrailMyrtlePark,05/08/2014 06:00:00 PM,48,-122,90,16,106
3067,ElliotBayTrailMyrtlePark,05/08/2014 07:00:00 PM,48,-122,41,2,43
3068,ElliotBayTrailMyrtlePark,05/08/2014 08:00:00 PM,48,-122,15,3,18
3069,ElliotBayTrailMyrtlePark,05/08/2014 09:00:00 PM,48,-122,3,2,5
3070,ElliotBayTrailMyrtlePark,05/08/2014 10:00:00 PM,48,-122,2,2,4
3071,ElliotBayTrailMyrtlePark,05/08/2014 11:00:00 PM,48,-122,4,0,4
3072,ElliotBayTrailMyrtlePark,05/09/2014 12:00:00 AM,48,-122,4,1,5
3073,ElliotBayTrailMyrtlePark,05/09/2014 01:00:00 AM,48,-122,0,0,0
3074,ElliotBayTrailMyrtlePark,05/09/2014 02:00:00 AM,48,-122,0,0,0
3075,ElliotBayTrailMyrtlePark,05/09/2014 03:00:00 AM,48,-122,1,0,1
3076,ElliotBayTrailMyrtlePark,05/09/2014 04:00:00 AM,48,-122,0,0,0
3077,ElliotBayTrailMyrtlePark,05/09/2014 05:00:00 AM,48,-122,7,13,20
3078,ElliotBayTrailMyrtlePark,05/09/2014 06:00:00 AM,48,-122,10,29,39
3079,ElliotBayTrailMyrtlePark,05/09/2014 07:00:00 AM,48,-122,28,100,128
3080,ElliotBayTrailMyrtlePark,05/09/2014 08:00:00 AM,48,-122,18,100,118
3081,ElliotBayTrailMyrtlePark,05/09/2014 09:00:00 AM,48,-122,14,51,65
3082,ElliotBayTrailMyrtlePark,05/09/2014 10:00:00 AM,48,-122,13,10,23
3083,ElliotBayTrailMyrtlePark,05/09/2014 11:00:00 AM,48,-122,8,20,28
3084,ElliotBayTrailMyrtlePark,05/09/2014 12:00:00 PM,48,-122,10,17,27
3085,ElliotBayTrailMyrtlePark,05/09/2014 01:00:00 PM,48,-122,9,4,13
3086,ElliotBayTrailMyrtlePark,05/09/2014 02:00:00 PM,48,-122,8,14,22
3087,ElliotBayTrailMyrtlePark,05/09/2014 03:00:00 PM,48,-122,35,24,59
3088,ElliotBayTrailMyrtlePark,05/09/2014 04:00:00 PM,48,-122,88,26,114
3089,ElliotBayTrailMyrtlePark,05/09/2014 05:00:00 PM,48,-122,134,24,158
3090,ElliotBayTrailMyrtlePark,05/09/2014 06:00:00 PM,48,-122,74,16,90
3091,ElliotBayTrailMyrtlePark,05/09/2014 07:00:00 PM,48,-122,21,12,33
3092,ElliotBayTrailMyrtlePark,05/09/2014 08:00:00 PM,48,-122,9,4,13
3093,ElliotBayTrailMyrtlePark,05/09/2014 09:00:00 PM,48,-122,2,4,6
3094,ElliotBayTrailMyrtlePark,05/09/2014 10:00:00 PM,48,-122,9,2,11
3095,ElliotBayTrailMyrtlePark,05/09/2014 11:00:00 PM,48,-122,3,0,3
3096,ElliotBayTrailMyrtlePark,05/10/2014 12:00:00 AM,48,-122,3,2,5
3097,ElliotBayTrailMyrtlePark,05/10/2014 01:00:00 AM,48,-122,0,3,3
3098,ElliotBayTrailMyrtlePark,05/10/2014 02:00:00 AM,48,-122,3,0,3
3099,ElliotBayTrailMyrtlePark,05/10/2014 03:00:00 AM,48,-122,0,0,0
3100,ElliotBayTrailMyrtlePark,05/10/2014 04:00:00 AM,48,-122,0,0,0
3101,ElliotBayTrailMyrtlePark,05/10/2014 05:00:00 AM,48,-122,0,4,4
3102,ElliotBayTrailMyrtlePark,05/10/2014 06:00:00 AM,48,-122,3,5,8
3103,ElliotBayTrailMyrtlePark,05/10/2014 07:00:00 AM,48,-122,12,8,20
3104,ElliotBayTrailMyrtlePark,05/10/2014 08:00:00 AM,48,-122,12,10,22
3105,ElliotBayTrailMyrtlePark,05/10/2014 09:00:00 AM,48,-122,19,35,54
3106,ElliotBayTrailMyrtlePark,05/10/2014 10:00:00 AM,48,-122,13,68,81
3107,ElliotBayTrailMyrtlePark,05/10/2014 11:00:00 AM,48,-122,51,76,127
3108,ElliotBayTrailMyrtlePark,05/10/2014 12:00:00 PM,48,-122,47,60,107
3109,ElliotBayTrailMyrtlePark,05/10/2014 01:00:00 PM,48,-122,55,50,105
3110,ElliotBayTrailMyrtlePark,05/10/2014 02:00:00 PM,48,-122,52,56,108
3111,ElliotBayTrailMyrtlePark,05/10/2014 03:00:00 PM,48,-122,47,29,76
3112,ElliotBayTrailMyrtlePark,05/10/2014 04:00:00 PM,48,-122,39,33,72
3113,ElliotBayTrailMyrtlePark,05/10/2014 05:00:00 PM,48,-122,77,30,107
3114,ElliotBayTrailMyrtlePark,05/10/2014 06:00:00 PM,48,-122,17,22,39
3115,ElliotBayTrailMyrtlePark,05/10/2014 07:00:00 PM,48,-122,12,20,32
3116,ElliotBayTrailMyrtlePark,05/10/2014 08:00:00 PM,48,-122,11,6,17
3117,ElliotBayTrailMyrtlePark,05/10/2014 09:00:00 PM,48,-122,9,0,9
3118,ElliotBayTrailMyrtlePark,05/10/2014 10:00:00 PM,48,-122,6,1,7
3119,ElliotBayTrailMyrtlePark,05/10/2014 11:00:00 PM,48,-122,1,0,1
3120,ElliotBayTrailMyrtlePark,05/11/2014 12:00:00 AM,48,-122,3,1,4
3121,ElliotBayTrailMyrtlePark,05/11/2014 01:00:00 AM,48,-122,8,1,9
3122,ElliotBayTrailMyrtlePark,05/11/2014 02:00:00 AM,48,-122,1,3,4
3123,ElliotBayTrailMyrtlePark,05/11/2014 03:00:00 AM,48,-122,1,0,1
3124,ElliotBayTrailMyrtlePark,05/11/2014 04:00:00 AM,48,-122,0,0,0
3125,ElliotBayTrailMyrtlePark,05/11/2014 05:00:00 AM,48,-122,1,0,1
3126,ElliotBayTrailMyrtlePark,05/11/2014 06:00:00 AM,48,-122,3,7,10
3127,ElliotBayTrailMyrtlePark,05/11/2014 07:00:00 AM,48,-122,8,9,17
3128,ElliotBayTrailMyrtlePark,05/11/2014 08:00:00 AM,48,-122,9,11,20
3129,ElliotBayTrailMyrtlePark,05/11/2014 09:00:00 AM,48,-122,23,24,47
3130,ElliotBayTrailMyrtlePark,05/11/2014 10:00:00 AM,48,-122,45,43,88
3131,ElliotBayTrailMyrtlePark,05/11/2014 11:00:00 AM,48,-122,55,40,95
3132,ElliotBayTrailMyrtlePark,05/11/2014 12:00:00 PM,48,-122,48,71,119
3133,ElliotBayTrailMyrtlePark,05/11/2014 01:00:00 PM,48,-122,61,64,125
3134,ElliotBayTrailMyrtlePark,05/11/2014 02:00:00 PM,48,-122,114,68,182
3135,ElliotBayTrailMyrtlePark,05/11/2014 03:00:00 PM,48,-122,100,77,177
3136,ElliotBayTrailMyrtlePark,05/11/2014 04:00:00 PM,48,-122,87,68,155
3137,ElliotBayTrailMyrtlePark,05/11/2014 05:00:00 PM,48,-122,53,53,106
3138,ElliotBayTrailMyrtlePark,05/11/2014 06:00:00 PM,48,-122,43,42,85
3139,ElliotBayTrailMyrtlePark,05/11/2014 07:00:00 PM,48,-122,16,31,47
3140,ElliotBayTrailMyrtlePark,05/11/2014 08:00:00 PM,48,-122,11,14,25
3141,ElliotBayTrailMyrtlePark,05/11/2014 09:00:00 PM,48,-122,4,3,7
3142,ElliotBayTrailMyrtlePark,05/11/2014 10:00:00 PM,48,-122,1,0,1
3143,ElliotBayTrailMyrtlePark,05/11/2014 11:00:00 PM,48,-122,3,1,4
3144,ElliotBayTrailMyrtlePark,05/12/2014 12:00:00 AM,48,-122,3,1,4
3145,ElliotBayTrailMyrtlePark,05/12/2014 01:00:00 AM,48,-122,0,1,1
3146,ElliotBayTrailMyrtlePark,05/12/2014 02:00:00 AM,48,-122,4,0,4
3147,ElliotBayTrailMyrtlePark,05/12/2014 03:00:00 AM,48,-122,0,0,0
3148,ElliotBayTrailMyrtlePark,05/12/2014 04:00:00 AM,48,-122,1,1,2
3149,ElliotBayTrailMyrtlePark,05/12/2014 05:00:00 AM,48,-122,10,28,38
3150,ElliotBayTrailMyrtlePark,05/12/2014 06:00:00 AM,48,-122,16,59,75
3151,ElliotBayTrailMyrtlePark,05/12/2014 07:00:00 AM,48,-122,60,144,204
3152,ElliotBayTrailMyrtlePark,05/12/2014 08:00:00 AM,48,-122,58,194,252
3153,ElliotBayTrailMyrtlePark,05/12/2014 09:00:00 AM,48,-122,24,80,104
3154,ElliotBayTrailMyrtlePark,05/12/2014 10:00:00 AM,48,-122,16,21,37
3155,ElliotBayTrailMyrtlePark,05/12/2014 11:00:00 AM,48,-122,20,26,46
3156,ElliotBayTrailMyrtlePark,05/12/2014 12:00:00 PM,48,-122,24,29,53
3157,ElliotBayTrailMyrtlePark,05/12/2014 01:00:00 PM,48,-122,22,30,52
3158,ElliotBayTrailMyrtlePark,05/12/2014 02:00:00 PM,48,-122,48,32,80
3159,ElliotBayTrailMyrtlePark,05/12/2014 03:00:00 PM,48,-122,48,29,77
3160,ElliotBayTrailMyrtlePark,05/12/2014 04:00:00 PM,48,-122,144,78,222
3161,ElliotBayTrailMyrtlePark,05/12/2014 05:00:00 PM,48,-122,337,90,427
3162,ElliotBayTrailMyrtlePark,05/12/2014 06:00:00 PM,48,-122,234,92,326
3163,ElliotBayTrailMyrtlePark,05/12/2014 07:00:00 PM,48,-122,81,59,140
3164,ElliotBayTrailMyrtlePark,05/12/2014 08:00:00 PM,48,-122,50,50,100
3165,ElliotBayTrailMyrtlePark,05/12/2014 09:00:00 PM,48,-122,13,18,31
3166,ElliotBayTrailMyrtlePark,05/12/2014 10:00:00 PM,48,-122,11,3,14
3167,ElliotBayTrailMyrtlePark,05/12/2014 11:00:00 PM,48,-122,5,1,6
3168,ElliotBayTrailMyrtlePark,05/13/2014 12:00:00 AM,48,-122,3,2,5
3169,ElliotBayTrailMyrtlePark,05/13/2014 01:00:00 AM,48,-122,1,0,1
3170,ElliotBayTrailMyrtlePark,05/13/2014 02:00:00 AM,48,-122,3,1,4
3171,ElliotBayTrailMyrtlePark,05/13/2014 03:00:00 AM,48,-122,1,0,1
3172,ElliotBayTrailMyrtlePark,05/13/2014 04:00:00 AM,48,-122,0,0,0
3173,ElliotBayTrailMyrtlePark,05/13/2014 05:00:00 AM,48,-122,9,26,35
3174,ElliotBayTrailMyrtlePark,05/13/2014 06:00:00 AM,48,-122,29,61,90
3175,ElliotBayTrailMyrtlePark,05/13/2014 07:00:00 AM,48,-122,74,177,251
3176,ElliotBayTrailMyrtlePark,05/13/2014 08:00:00 AM,48,-122,59,208,267
3177,ElliotBayTrailMyrtlePark,05/13/2014 09:00:00 AM,48,-122,27,99,126
3178,ElliotBayTrailMyrtlePark,05/13/2014 10:00:00 AM,48,-122,24,32,56
3179,ElliotBayTrailMyrtlePark,05/13/2014 11:00:00 AM,48,-122,29,25,54
3180,ElliotBayTrailMyrtlePark,05/13/2014 12:00:00 PM,48,-122,31,40,71
3181,ElliotBayTrailMyrtlePark,05/13/2014 01:00:00 PM,48,-122,39,50,89
3182,ElliotBayTrailMyrtlePark,05/13/2014 02:00:00 PM,48,-122,49,32,81
3183,ElliotBayTrailMyrtlePark,05/13/2014 03:00:00 PM,48,-122,75,46,121
3184,ElliotBayTrailMyrtlePark,05/13/2014 04:00:00 PM,48,-122,156,77,233
3185,ElliotBayTrailMyrtlePark,05/13/2014 05:00:00 PM,48,-122,348,112,460
3186,ElliotBayTrailMyrtlePark,05/13/2014 06:00:00 PM,48,-122,219,96,315
3187,ElliotBayTrailMyrtlePark,05/13/2014 07:00:00 PM,48,-122,98,67,165
3188,ElliotBayTrailMyrtlePark,05/13/2014 08:00:00 PM,48,-122,53,45,98
3189,ElliotBayTrailMyrtlePark,05/13/2014 09:00:00 PM,48,-122,17,15,32
3190,ElliotBayTrailMyrtlePark,05/13/2014 10:00:00 PM,48,-122,14,4,18
3191,ElliotBayTrailMyrtlePark,05/13/2014 11:00:00 PM,48,-122,3,1,4
3192,ElliotBayTrailMyrtlePark,05/14/2014 12:00:00 AM,48,-122,4,2,6
3193,ElliotBayTrailMyrtlePark,05/14/2014 01:00:00 AM,48,-122,0,0,0
3194,ElliotBayTrailMyrtlePark,05/14/2014 02:00:00 AM,48,-122,1,1,2
3195,ElliotBayTrailMyrtlePark,05/14/2014 03:00:00 AM,48,-122,2,0,2
3196,ElliotBayTrailMyrtlePark,05/14/2014 04:00:00 AM,48,-122,1,0,1
3197,ElliotBayTrailMyrtlePark,05/14/2014 05:00:00 AM,48,-122,10,27,37
3198,ElliotBayTrailMyrtlePark,05/14/2014 06:00:00 AM,48,-122,28,85,113
3199,ElliotBayTrailMyrtlePark,05/14/2014 07:00:00 AM,48,-122,73,183,256
3200,ElliotBayTrailMyrtlePark,05/14/2014 08:00:00 AM,48,-122,66,191,257
3201,ElliotBayTrailMyrtlePark,05/14/2014 09:00:00 AM,48,-122,35,93,128
3202,ElliotBayTrailMyrtlePark,05/14/2014 10:00:00 AM,48,-122,18,37,55
3203,ElliotBayTrailMyrtlePark,05/14/2014 11:00:00 AM,48,-122,25,25,50
3204,ElliotBayTrailMyrtlePark,05/14/2014 12:00:00 PM,48,-122,33,35,68
3205,ElliotBayTrailMyrtlePark,05/14/2014 01:00:00 PM,48,-122,38,36,74
3206,ElliotBayTrailMyrtlePark,05/14/2014 02:00:00 PM,48,-122,39,30,69
3207,ElliotBayTrailMyrtlePark,05/14/2014 03:00:00 PM,48,-122,76,60,136
3208,ElliotBayTrailMyrtlePark,05/14/2014 04:00:00 PM,48,-122,156,60,216
3209,ElliotBayTrailMyrtlePark,05/14/2014 05:00:00 PM,48,-122,340,75,415
3210,ElliotBayTrailMyrtlePark,05/14/2014 06:00:00 PM,48,-122,172,78,250
3211,ElliotBayTrailMyrtlePark,05/14/2014 07:00:00 PM,48,-122,93,86,179
3212,ElliotBayTrailMyrtlePark,05/14/2014 08:00:00 PM,48,-122,45,39,84
3213,ElliotBayTrailMyrtlePark,05/14/2014 09:00:00 PM,48,-122,4,5,9
3214,ElliotBayTrailMyrtlePark,05/14/2014 10:00:00 PM,48,-122,8,5,13
3215,ElliotBayTrailMyrtlePark,05/14/2014 11:00:00 PM,48,-122,3,3,6
3216,ElliotBayTrailMyrtlePark,05/15/2014 12:00:00 AM,48,-122,2,3,5
3217,ElliotBayTrailMyrtlePark,05/15/2014 01:00:00 AM,48,-122,3,0,3
3218,ElliotBayTrailMyrtlePark,05/15/2014 02:00:00 AM,48,-122,2,0,2
3219,ElliotBayTrailMyrtlePark,05/15/2014 03:00:00 AM,48,-122,3,2,5
3220,ElliotBayTrailMyrtlePark,05/15/2014 04:00:00 AM,48,-122,1,0,1
3221,ElliotBayTrailMyrtlePark,05/15/2014 05:00:00 AM,48,-122,12,28,40
3222,ElliotBayTrailMyrtlePark,05/15/2014 06:00:00 AM,48,-122,32,68,100
3223,ElliotBayTrailMyrtlePark,05/15/2014 07:00:00 AM,48,-122,60,175,235
3224,ElliotBayTrailMyrtlePark,05/15/2014 08:00:00 AM,48,-122,53,148,201
3225,ElliotBayTrailMyrtlePark,05/15/2014 09:00:00 AM,48,-122,35,95,130
3226,ElliotBayTrailMyrtlePark,05/15/2014 10:00:00 AM,48,-122,25,43,68
3227,ElliotBayTrailMyrtlePark,05/15/2014 11:00:00 AM,48,-122,23,26,49
3228,ElliotBayTrailMyrtlePark,05/15/2014 12:00:00 PM,48,-122,29,36,65
3229,ElliotBayTrailMyrtlePark,05/15/2014 01:00:00 PM,48,-122,36,33,69
3230,ElliotBayTrailMyrtlePark,05/15/2014 02:00:00 PM,48,-122,45,50,95
3231,ElliotBayTrailMyrtlePark,05/15/2014 03:00:00 PM,48,-122,73,49,122
3232,ElliotBayTrailMyrtlePark,05/15/2014 04:00:00 PM,48,-122,130,68,198
3233,ElliotBayTrailMyrtlePark,05/15/2014 05:00:00 PM,48,-122,294,79,373
3234,ElliotBayTrailMyrtlePark,05/15/2014 06:00:00 PM,48,-122,178,53,231
3235,ElliotBayTrailMyrtlePark,05/15/2014 07:00:00 PM,48,-122,77,45,122
3236,ElliotBayTrailMyrtlePark,05/15/2014 08:00:00 PM,48,-122,50,27,77
3237,ElliotBayTrailMyrtlePark,05/15/2014 09:00:00 PM,48,-122,9,7,16
3238,ElliotBayTrailMyrtlePark,05/15/2014 10:00:00 PM,48,-122,8,11,19
3239,ElliotBayTrailMyrtlePark,05/15/2014 11:00:00 PM,48,-122,5,0,5
3240,ElliotBayTrailMyrtlePark,05/16/2014 12:00:00 AM,48,-122,5,0,5
3241,ElliotBayTrailMyrtlePark,05/16/2014 01:00:00 AM,48,-122,1,0,1
3242,ElliotBayTrailMyrtlePark,05/16/2014 02:00:00 AM,48,-122,1,1,2
3243,ElliotBayTrailMyrtlePark,05/16/2014 03:00:00 AM,48,-122,0,1,1
3244,ElliotBayTrailMyrtlePark,05/16/2014 04:00:00 AM,48,-122,1,0,1
3245,ElliotBayTrailMyrtlePark,05/16/2014 05:00:00 AM,48,-122,15,24,39
3246,ElliotBayTrailMyrtlePark,05/16/2014 06:00:00 AM,48,-122,28,59,87
3247,ElliotBayTrailMyrtlePark,05/16/2014 07:00:00 AM,48,-122,83,176,259
3248,ElliotBayTrailMyrtlePark,05/16/2014 08:00:00 AM,48,-122,62,204,266
3249,ElliotBayTrailMyrtlePark,05/16/2014 09:00:00 AM,48,-122,34,97,131
3250,ElliotBayTrailMyrtlePark,05/16/2014 10:00:00 AM,48,-122,23,44,67
3251,ElliotBayTrailMyrtlePark,05/16/2014 11:00:00 AM,48,-122,16,18,34
3252,ElliotBayTrailMyrtlePark,05/16/2014 12:00:00 PM,48,-122,20,18,38
3253,ElliotBayTrailMyrtlePark,05/16/2014 01:00:00 PM,48,-122,30,23,53
3254,ElliotBayTrailMyrtlePark,05/16/2014 02:00:00 PM,48,-122,30,32,62
3255,ElliotBayTrailMyrtlePark,05/16/2014 03:00:00 PM,48,-122,67,45,112
3256,ElliotBayTrailMyrtlePark,05/16/2014 04:00:00 PM,48,-122,148,83,231
3257,ElliotBayTrailMyrtlePark,05/16/2014 05:00:00 PM,48,-122,230,73,303
3258,ElliotBayTrailMyrtlePark,05/16/2014 06:00:00 PM,48,-122,122,50,172
3259,ElliotBayTrailMyrtlePark,05/16/2014 07:00:00 PM,48,-122,49,29,78
3260,ElliotBayTrailMyrtlePark,05/16/2014 08:00:00 PM,48,-122,24,15,39
3261,ElliotBayTrailMyrtlePark,05/16/2014 09:00:00 PM,48,-122,6,1,7
3262,ElliotBayTrailMyrtlePark,05/16/2014 10:00:00 PM,48,-122,8,3,11
3263,ElliotBayTrailMyrtlePark,05/16/2014 11:00:00 PM,48,-122,7,2,9
3264,ElliotBayTrailMyrtlePark,05/17/2014 12:00:00 AM,48,-122,5,2,7
3265,ElliotBayTrailMyrtlePark,05/17/2014 01:00:00 AM,48,-122,5,0,5
3266,ElliotBayTrailMyrtlePark,05/17/2014 02:00:00 AM,48,-122,2,3,5
3267,ElliotBayTrailMyrtlePark,05/17/2014 03:00:00 AM,48,-122,1,0,1
3268,ElliotBayTrailMyrtlePark,05/17/2014 04:00:00 AM,48,-122,0,0,0
3269,ElliotBayTrailMyrtlePark,05/17/2014 05:00:00 AM,48,-122,1,1,2
3270,ElliotBayTrailMyrtlePark,05/17/2014 06:00:00 AM,48,-122,6,3,9
3271,ElliotBayTrailMyrtlePark,05/17/2014 07:00:00 AM,48,-122,15,17,32
3272,ElliotBayTrailMyrtlePark,05/17/2014 08:00:00 AM,48,-122,16,17,33
3273,ElliotBayTrailMyrtlePark,05/17/2014 09:00:00 AM,48,-122,19,30,49
3274,ElliotBayTrailMyrtlePark,05/17/2014 10:00:00 AM,48,-122,35,30,65
3275,ElliotBayTrailMyrtlePark,05/17/2014 11:00:00 AM,48,-122,54,41,95
3276,ElliotBayTrailMyrtlePark,05/17/2014 12:00:00 PM,48,-122,55,46,101
3277,ElliotBayTrailMyrtlePark,05/17/2014 01:00:00 PM,48,-122,46,59,105
3278,ElliotBayTrailMyrtlePark,05/17/2014 02:00:00 PM,48,-122,62,53,115
3279,ElliotBayTrailMyrtlePark,05/17/2014 03:00:00 PM,48,-122,40,56,96
3280,ElliotBayTrailMyrtlePark,05/17/2014 04:00:00 PM,48,-122,52,30,82
3281,ElliotBayTrailMyrtlePark,05/17/2014 05:00:00 PM,48,-122,26,44,70
3282,ElliotBayTrailMyrtlePark,05/17/2014 06:00:00 PM,48,-122,36,42,78
3283,ElliotBayTrailMyrtlePark,05/17/2014 07:00:00 PM,48,-122,25,24,49
3284,ElliotBayTrailMyrtlePark,05/17/2014 08:00:00 PM,48,-122,14,21,35
3285,ElliotBayTrailMyrtlePark,05/17/2014 09:00:00 PM,48,-122,42,6,48
3286,ElliotBayTrailMyrtlePark,05/17/2014 10:00:00 PM,48,-122,8,5,13
3287,ElliotBayTrailMyrtlePark,05/17/2014 11:00:00 PM,48,-122,3,3,6
3288,ElliotBayTrailMyrtlePark,05/18/2014 12:00:00 AM,48,-122,7,0,7
3289,ElliotBayTrailMyrtlePark,05/18/2014 01:00:00 AM,48,-122,0,0,0
3290,ElliotBayTrailMyrtlePark,05/18/2014 02:00:00 AM,48,-122,0,0,0
3291,ElliotBayTrailMyrtlePark,05/18/2014 03:00:00 AM,48,-122,0,0,0
3292,ElliotBayTrailMyrtlePark,05/18/2014 04:00:00 AM,48,-122,0,0,0
3293,ElliotBayTrailMyrtlePark,05/18/2014 05:00:00 AM,48,-122,2,0,2
3294,ElliotBayTrailMyrtlePark,05/18/2014 06:00:00 AM,48,-122,1,1,2
3295,ElliotBayTrailMyrtlePark,05/18/2014 07:00:00 AM,48,-122,5,14,19
3296,ElliotBayTrailMyrtlePark,05/18/2014 08:00:00 AM,48,-122,16,15,31
3297,ElliotBayTrailMyrtlePark,05/18/2014 09:00:00 AM,48,-122,35,27,62
3298,ElliotBayTrailMyrtlePark,05/18/2014 10:00:00 AM,48,-122,47,31,78
3299,ElliotBayTrailMyrtlePark,05/18/2014 11:00:00 AM,48,-122,43,51,94
3300,ElliotBayTrailMyrtlePark,05/18/2014 12:00:00 PM,48,-122,46,63,109
3301,ElliotBayTrailMyrtlePark,05/18/2014 01:00:00 PM,48,-122,72,71,143
3302,ElliotBayTrailMyrtlePark,05/18/2014 02:00:00 PM,48,-122,83,70,153
3303,ElliotBayTrailMyrtlePark,05/18/2014 03:00:00 PM,48,-122,58,41,99
3304,ElliotBayTrailMyrtlePark,05/18/2014 04:00:00 PM,48,-122,38,35,73
3305,ElliotBayTrailMyrtlePark,05/18/2014 05:00:00 PM,48,-122,29,32,61
3306,ElliotBayTrailMyrtlePark,05/18/2014 06:00:00 PM,48,-122,17,14,31
3307,ElliotBayTrailMyrtlePark,05/18/2014 07:00:00 PM,48,-122,9,5,14
3308,ElliotBayTrailMyrtlePark,05/18/2014 08:00:00 PM,48,-122,7,1,8
3309,ElliotBayTrailMyrtlePark,05/18/2014 09:00:00 PM,48,-122,2,2,4
3310,ElliotBayTrailMyrtlePark,05/18/2014 10:00:00 PM,48,-122,1,0,1
3311,ElliotBayTrailMyrtlePark,05/18/2014 11:00:00 PM,48,-122,2,0,2
3312,ElliotBayTrailMyrtlePark,05/19/2014 12:00:00 AM,48,-122,0,0,0
3313,ElliotBayTrailMyrtlePark,05/19/2014 01:00:00 AM,48,-122,0,0,0
3314,ElliotBayTrailMyrtlePark,05/19/2014 02:00:00 AM,48,-122,0,0,0
3315,ElliotBayTrailMyrtlePark,05/19/2014 03:00:00 AM,48,-122,0,0,0
3316,ElliotBayTrailMyrtlePark,05/19/2014 04:00:00 AM,48,-122,0,0,0
3317,ElliotBayTrailMyrtlePark,05/19/2014 05:00:00 AM,48,-122,10,17,27
3318,ElliotBayTrailMyrtlePark,05/19/2014 06:00:00 AM,48,-122,21,46,67
3319,ElliotBayTrailMyrtlePark,05/19/2014 07:00:00 AM,48,-122,53,132,185
3320,ElliotBayTrailMyrtlePark,05/19/2014 08:00:00 AM,48,-122,35,181,216
3321,ElliotBayTrailMyrtlePark,05/19/2014 09:00:00 AM,48,-122,26,89,115
3322,ElliotBayTrailMyrtlePark,05/19/2014 10:00:00 AM,48,-122,27,33,60
3323,ElliotBayTrailMyrtlePark,05/19/2014 11:00:00 AM,48,-122,23,25,48
3324,ElliotBayTrailMyrtlePark,05/19/2014 12:00:00 PM,48,-122,21,23,44
3325,ElliotBayTrailMyrtlePark,05/19/2014 01:00:00 PM,48,-122,28,25,53
3326,ElliotBayTrailMyrtlePark,05/19/2014 02:00:00 PM,48,-122,43,54,97
3327,ElliotBayTrailMyrtlePark,05/19/2014 03:00:00 PM,48,-122,49,44,93
3328,ElliotBayTrailMyrtlePark,05/19/2014 04:00:00 PM,48,-122,110,67,177
3329,ElliotBayTrailMyrtlePark,05/19/2014 05:00:00 PM,48,-122,260,86,346
3330,ElliotBayTrailMyrtlePark,05/19/2014 06:00:00 PM,48,-122,162,73,235
3331,ElliotBayTrailMyrtlePark,05/19/2014 07:00:00 PM,48,-122,79,49,128
3332,ElliotBayTrailMyrtlePark,05/19/2014 08:00:00 PM,48,-122,29,29,58
3333,ElliotBayTrailMyrtlePark,05/19/2014 09:00:00 PM,48,-122,7,5,12
3334,ElliotBayTrailMyrtlePark,05/19/2014 10:00:00 PM,48,-122,2,3,5
3335,ElliotBayTrailMyrtlePark,05/19/2014 11:00:00 PM,48,-122,7,4,11
3336,ElliotBayTrailMyrtlePark,05/20/2014 12:00:00 AM,48,-122,1,1,2
3337,ElliotBayTrailMyrtlePark,05/20/2014 01:00:00 AM,48,-122,2,0,2
3338,ElliotBayTrailMyrtlePark,05/20/2014 02:00:00 AM,48,-122,4,0,4
3339,ElliotBayTrailMyrtlePark,05/20/2014 03:00:00 AM,48,-122,1,0,1
3340,ElliotBayTrailMyrtlePark,05/20/2014 04:00:00 AM,48,-122,1,0,1
3341,ElliotBayTrailMyrtlePark,05/20/2014 05:00:00 AM,48,-122,15,22,37
3342,ElliotBayTrailMyrtlePark,05/20/2014 06:00:00 AM,48,-122,29,73,102
3343,ElliotBayTrailMyrtlePark,05/20/2014 07:00:00 AM,48,-122,56,180,236
3344,ElliotBayTrailMyrtlePark,05/20/2014 08:00:00 AM,48,-122,78,159,237
3345,ElliotBayTrailMyrtlePark,05/20/2014 09:00:00 AM,48,-122,34,98,132
3346,ElliotBayTrailMyrtlePark,05/20/2014 10:00:00 AM,48,-122,19,41,60
3347,ElliotBayTrailMyrtlePark,05/20/2014 11:00:00 AM,48,-122,26,17,43
3348,ElliotBayTrailMyrtlePark,05/20/2014 12:00:00 PM,48,-122,25,40,65
3349,ElliotBayTrailMyrtlePark,05/20/2014 01:00:00 PM,48,-122,23,31,54
3350,ElliotBayTrailMyrtlePark,05/20/2014 02:00:00 PM,48,-122,44,36,80
3351,ElliotBayTrailMyrtlePark,05/20/2014 03:00:00 PM,48,-122,71,44,115
3352,ElliotBayTrailMyrtlePark,05/20/2014 04:00:00 PM,48,-122,150,78,228
3353,ElliotBayTrailMyrtlePark,05/20/2014 05:00:00 PM,48,-122,359,80,439
3354,ElliotBayTrailMyrtlePark,05/20/2014 06:00:00 PM,48,-122,149,61,210
3355,ElliotBayTrailMyrtlePark,05/20/2014 07:00:00 PM,48,-122,77,42,119
3356,ElliotBayTrailMyrtlePark,05/20/2014 08:00:00 PM,48,-122,34,27,61
3357,ElliotBayTrailMyrtlePark,05/20/2014 09:00:00 PM,48,-122,10,6,16
3358,ElliotBayTrailMyrtlePark,05/20/2014 10:00:00 PM,48,-122,9,5,14
3359,ElliotBayTrailMyrtlePark,05/20/2014 11:00:00 PM,48,-122,2,1,3
3360,ElliotBayTrailMyrtlePark,05/21/2014 12:00:00 AM,48,-122,3,0,3
3361,ElliotBayTrailMyrtlePark,05/21/2014 01:00:00 AM,48,-122,2,0,2
3362,ElliotBayTrailMyrtlePark,05/21/2014 02:00:00 AM,48,-122,1,0,1
3363,ElliotBayTrailMyrtlePark,05/21/2014 03:00:00 AM,48,-122,1,1,2
3364,ElliotBayTrailMyrtlePark,05/21/2014 04:00:00 AM,48,-122,2,0,2
3365,ElliotBayTrailMyrtlePark,05/21/2014 05:00:00 AM,48,-122,13,28,41
3366,ElliotBayTrailMyrtlePark,05/21/2014 06:00:00 AM,48,-122,21,62,83
3367,ElliotBayTrailMyrtlePark,05/21/2014 07:00:00 AM,48,-122,49,142,191
3368,ElliotBayTrailMyrtlePark,05/21/2014 08:00:00 AM,48,-122,46,184,230
3369,ElliotBayTrailMyrtlePark,05/21/2014 09:00:00 AM,48,-122,31,86,117
3370,ElliotBayTrailMyrtlePark,05/21/2014 10:00:00 AM,48,-122,13,26,39
3371,ElliotBayTrailMyrtlePark,05/21/2014 11:00:00 AM,48,-122,20,25,45
3372,ElliotBayTrailMyrtlePark,05/21/2014 12:00:00 PM,48,-122,23,33,56
3373,ElliotBayTrailMyrtlePark,05/21/2014 01:00:00 PM,48,-122,26,21,47
3374,ElliotBayTrailMyrtlePark,05/21/2014 02:00:00 PM,48,-122,33,19,52
3375,ElliotBayTrailMyrtlePark,05/21/2014 03:00:00 PM,48,-122,58,45,103
3376,ElliotBayTrailMyrtlePark,05/21/2014 04:00:00 PM,48,-122,111,70,181
3377,ElliotBayTrailMyrtlePark,05/21/2014 05:00:00 PM,48,-122,287,91,378
3378,ElliotBayTrailMyrtlePark,05/21/2014 06:00:00 PM,48,-122,174,71,245
3379,ElliotBayTrailMyrtlePark,05/21/2014 07:00:00 PM,48,-122,83,57,140
3380,ElliotBayTrailMyrtlePark,05/21/2014 08:00:00 PM,48,-122,36,18,54
3381,ElliotBayTrailMyrtlePark,05/21/2014 09:00:00 PM,48,-122,8,3,11
3382,ElliotBayTrailMyrtlePark,05/21/2014 10:00:00 PM,48,-122,15,0,15
3383,ElliotBayTrailMyrtlePark,05/21/2014 11:00:00 PM,48,-122,8,3,11
3384,ElliotBayTrailMyrtlePark,05/22/2014 12:00:00 AM,48,-122,1,0,1
3385,ElliotBayTrailMyrtlePark,05/22/2014 01:00:00 AM,48,-122,0,0,0
3386,ElliotBayTrailMyrtlePark,05/22/2014 02:00:00 AM,48,-122,1,0,1
3387,ElliotBayTrailMyrtlePark,05/22/2014 03:00:00 AM,48,-122,1,0,1
3388,ElliotBayTrailMyrtlePark,05/22/2014 04:00:00 AM,48,-122,1,1,2
3389,ElliotBayTrailMyrtlePark,05/22/2014 05:00:00 AM,48,-122,11,19,30
3390,ElliotBayTrailMyrtlePark,05/22/2014 06:00:00 AM,48,-122,17,62,79
3391,ElliotBayTrailMyrtlePark,05/22/2014 07:00:00 AM,48,-122,55,154,209
3392,ElliotBayTrailMyrtlePark,05/22/2014 08:00:00 AM,48,-122,64,160,224
3393,ElliotBayTrailMyrtlePark,05/22/2014 09:00:00 AM,48,-122,46,86,132
3394,ElliotBayTrailMyrtlePark,05/22/2014 10:00:00 AM,48,-122,32,30,62
3395,ElliotBayTrailMyrtlePark,05/22/2014 11:00:00 AM,48,-122,31,25,56
3396,ElliotBayTrailMyrtlePark,05/22/2014 12:00:00 PM,48,-122,32,35,67
3397,ElliotBayTrailMyrtlePark,05/22/2014 01:00:00 PM,48,-122,44,45,89
3398,ElliotBayTrailMyrtlePark,05/22/2014 02:00:00 PM,48,-122,37,38,75
3399,ElliotBayTrailMyrtlePark,05/22/2014 03:00:00 PM,48,-122,50,39,89
3400,ElliotBayTrailMyrtlePark,05/22/2014 04:00:00 PM,48,-122,122,70,192
3401,ElliotBayTrailMyrtlePark,05/22/2014 05:00:00 PM,48,-122,249,77,326
3402,ElliotBayTrailMyrtlePark,05/22/2014 06:00:00 PM,48,-122,165,56,221
3403,ElliotBayTrailMyrtlePark,05/22/2014 07:00:00 PM,48,-122,62,25,87
3404,ElliotBayTrailMyrtlePark,05/22/2014 08:00:00 PM,48,-122,39,16,55
3405,ElliotBayTrailMyrtlePark,05/22/2014 09:00:00 PM,48,-122,13,18,31
3406,ElliotBayTrailMyrtlePark,05/22/2014 10:00:00 PM,48,-122,8,15,23
3407,ElliotBayTrailMyrtlePark,05/22/2014 11:00:00 PM,48,-122,2,2,4
3408,ElliotBayTrailMyrtlePark,05/23/2014 12:00:00 AM,48,-122,5,1,6
3409,ElliotBayTrailMyrtlePark,05/23/2014 01:00:00 AM,48,-122,3,0,3
3410,ElliotBayTrailMyrtlePark,05/23/2014 02:00:00 AM,48,-122,3,0,3
3411,ElliotBayTrailMyrtlePark,05/23/2014 03:00:00 AM,48,-122,0,1,1
3412,ElliotBayTrailMyrtlePark,05/23/2014 04:00:00 AM,48,-122,0,1,1
3413,ElliotBayTrailMyrtlePark,05/23/2014 05:00:00 AM,48,-122,10,13,23
3414,ElliotBayTrailMyrtlePark,05/23/2014 06:00:00 AM,48,-122,16,29,45
3415,ElliotBayTrailMyrtlePark,05/23/2014 07:00:00 AM,48,-122,39,80,119
3416,ElliotBayTrailMyrtlePark,05/23/2014 08:00:00 AM,48,-122,16,77,93
3417,ElliotBayTrailMyrtlePark,05/23/2014 09:00:00 AM,48,-122,7,27,34
3418,ElliotBayTrailMyrtlePark,05/23/2014 10:00:00 AM,48,-122,6,17,23
3419,ElliotBayTrailMyrtlePark,05/23/2014 11:00:00 AM,48,-122,5,7,12
3420,ElliotBayTrailMyrtlePark,05/23/2014 12:00:00 PM,48,-122,13,12,25
3421,ElliotBayTrailMyrtlePark,05/23/2014 01:00:00 PM,48,-122,17,7,24
3422,ElliotBayTrailMyrtlePark,05/23/2014 02:00:00 PM,48,-122,24,10,34
3423,ElliotBayTrailMyrtlePark,05/23/2014 03:00:00 PM,48,-122,41,30,71
3424,ElliotBayTrailMyrtlePark,05/23/2014 04:00:00 PM,48,-122,64,34,98
3425,ElliotBayTrailMyrtlePark,05/23/2014 05:00:00 PM,48,-122,74,40,114
3426,ElliotBayTrailMyrtlePark,05/23/2014 06:00:00 PM,48,-122,63,29,92
3427,ElliotBayTrailMyrtlePark,05/23/2014 07:00:00 PM,48,-122,32,16,48
3428,ElliotBayTrailMyrtlePark,05/23/2014 08:00:00 PM,48,-122,10,18,28
3429,ElliotBayTrailMyrtlePark,05/23/2014 09:00:00 PM,48,-122,10,5,15
3430,ElliotBayTrailMyrtlePark,05/23/2014 10:00:00 PM,48,-122,8,2,10
3431,ElliotBayTrailMyrtlePark,05/23/2014 11:00:00 PM,48,-122,5,1,6
3432,ElliotBayTrailMyrtlePark,05/24/2014 12:00:00 AM,48,-122,8,0,8
3433,ElliotBayTrailMyrtlePark,05/24/2014 01:00:00 AM,48,-122,3,0,3
3434,ElliotBayTrailMyrtlePark,05/24/2014 02:00:00 AM,48,-122,1,0,1
3435,ElliotBayTrailMyrtlePark,05/24/2014 03:00:00 AM,48,-122,1,0,1
3436,ElliotBayTrailMyrtlePark,05/24/2014 04:00:00 AM,48,-122,2,0,2
3437,ElliotBayTrailMyrtlePark,05/24/2014 05:00:00 AM,48,-122,1,2,3
3438,ElliotBayTrailMyrtlePark,05/24/2014 06:00:00 AM,48,-122,3,7,10
3439,ElliotBayTrailMyrtlePark,05/24/2014 07:00:00 AM,48,-122,10,13,23
3440,ElliotBayTrailMyrtlePark,05/24/2014 08:00:00 AM,48,-122,17,10,27
3441,ElliotBayTrailMyrtlePark,05/24/2014 09:00:00 AM,48,-122,21,25,46
3442,ElliotBayTrailMyrtlePark,05/24/2014 10:00:00 AM,48,-122,38,35,73
3443,ElliotBayTrailMyrtlePark,05/24/2014 11:00:00 AM,48,-122,71,47,118
3444,ElliotBayTrailMyrtlePark,05/24/2014 12:00:00 PM,48,-122,42,56,98
3445,ElliotBayTrailMyrtlePark,05/24/2014 01:00:00 PM,48,-122,54,45,99
3446,ElliotBayTrailMyrtlePark,05/24/2014 02:00:00 PM,48,-122,72,64,136
3447,ElliotBayTrailMyrtlePark,05/24/2014 03:00:00 PM,48,-122,98,54,152
3448,ElliotBayTrailMyrtlePark,05/24/2014 04:00:00 PM,48,-122,55,71,126
3449,ElliotBayTrailMyrtlePark,05/24/2014 05:00:00 PM,48,-122,47,55,102
3450,ElliotBayTrailMyrtlePark,05/24/2014 06:00:00 PM,48,-122,51,31,82
3451,ElliotBayTrailMyrtlePark,05/24/2014 07:00:00 PM,48,-122,29,25,54
3452,ElliotBayTrailMyrtlePark,05/24/2014 08:00:00 PM,48,-122,14,25,39
3453,ElliotBayTrailMyrtlePark,05/24/2014 09:00:00 PM,48,-122,6,1,7
3454,ElliotBayTrailMyrtlePark,05/24/2014 10:00:00 PM,48,-122,11,9,20
3455,ElliotBayTrailMyrtlePark,05/24/2014 11:00:00 PM,48,-122,2,3,5
3456,ElliotBayTrailMyrtlePark,05/25/2014 12:00:00 AM,48,-122,0,1,1
3457,ElliotBayTrailMyrtlePark,05/25/2014 01:00:00 AM,48,-122,0,0,0
3458,ElliotBayTrailMyrtlePark,05/25/2014 02:00:00 AM,48,-122,1,1,2
3459,ElliotBayTrailMyrtlePark,05/25/2014 03:00:00 AM,48,-122,4,0,4
3460,ElliotBayTrailMyrtlePark,05/25/2014 04:00:00 AM,48,-122,0,0,0
3461,ElliotBayTrailMyrtlePark,05/25/2014 05:00:00 AM,48,-122,3,1,4
3462,ElliotBayTrailMyrtlePark,05/25/2014 06:00:00 AM,48,-122,3,4,7
3463,ElliotBayTrailMyrtlePark,05/25/2014 07:00:00 AM,48,-122,5,9,14
3464,ElliotBayTrailMyrtlePark,05/25/2014 08:00:00 AM,48,-122,18,15,33
3465,ElliotBayTrailMyrtlePark,05/25/2014 09:00:00 AM,48,-122,20,28,48
3466,ElliotBayTrailMyrtlePark,05/25/2014 10:00:00 AM,48,-122,31,26,57
3467,ElliotBayTrailMyrtlePark,05/25/2014 11:00:00 AM,48,-122,40,32,72
3468,ElliotBayTrailMyrtlePark,05/25/2014 12:00:00 PM,48,-122,30,47,77
3469,ElliotBayTrailMyrtlePark,05/25/2014 01:00:00 PM,48,-122,48,32,80
3470,ElliotBayTrailMyrtlePark,05/25/2014 02:00:00 PM,48,-122,16,24,40
3471,ElliotBayTrailMyrtlePark,05/25/2014 03:00:00 PM,48,-122,28,8,36
3472,ElliotBayTrailMyrtlePark,05/25/2014 04:00:00 PM,48,-122,30,18,48
3473,ElliotBayTrailMyrtlePark,05/25/2014 05:00:00 PM,48,-122,29,8,37
3474,ElliotBayTrailMyrtlePark,05/25/2014 06:00:00 PM,48,-122,15,12,27
3475,ElliotBayTrailMyrtlePark,05/25/2014 07:00:00 PM,48,-122,6,3,9
3476,ElliotBayTrailMyrtlePark,05/25/2014 08:00:00 PM,48,-122,7,1,8
3477,ElliotBayTrailMyrtlePark,05/25/2014 09:00:00 PM,48,-122,1,1,2
3478,ElliotBayTrailMyrtlePark,05/25/2014 10:00:00 PM,48,-122,4,2,6
3479,ElliotBayTrailMyrtlePark,05/25/2014 11:00:00 PM,48,-122,2,1,3
3480,ElliotBayTrailMyrtlePark,05/26/2014 12:00:00 AM,48,-122,1,0,1
3481,ElliotBayTrailMyrtlePark,05/26/2014 01:00:00 AM,48,-122,1,0,1
3482,ElliotBayTrailMyrtlePark,05/26/2014 02:00:00 AM,48,-122,0,0,0
3483,ElliotBayTrailMyrtlePark,05/26/2014 03:00:00 AM,48,-122,0,0,0
3484,ElliotBayTrailMyrtlePark,05/26/2014 04:00:00 AM,48,-122,0,1,1
3485,ElliotBayTrailMyrtlePark,05/26/2014 05:00:00 AM,48,-122,0,0,0
3486,ElliotBayTrailMyrtlePark,05/26/2014 06:00:00 AM,48,-122,2,2,4
3487,ElliotBayTrailMyrtlePark,05/26/2014 07:00:00 AM,48,-122,5,6,11
3488,ElliotBayTrailMyrtlePark,05/26/2014 08:00:00 AM,48,-122,14,15,29
3489,ElliotBayTrailMyrtlePark,05/26/2014 09:00:00 AM,48,-122,21,13,34
3490,ElliotBayTrailMyrtlePark,05/26/2014 10:00:00 AM,48,-122,24,39,63
3491,ElliotBayTrailMyrtlePark,05/26/2014 11:00:00 AM,48,-122,61,63,124
3492,ElliotBayTrailMyrtlePark,05/26/2014 12:00:00 PM,48,-122,92,79,171
3493,ElliotBayTrailMyrtlePark,05/26/2014 01:00:00 PM,48,-122,77,90,167
3494,ElliotBayTrailMyrtlePark,05/26/2014 02:00:00 PM,48,-122,85,91,176
3495,ElliotBayTrailMyrtlePark,05/26/2014 03:00:00 PM,48,-122,77,66,143
3496,ElliotBayTrailMyrtlePark,05/26/2014 04:00:00 PM,48,-122,58,72,130
3497,ElliotBayTrailMyrtlePark,05/26/2014 05:00:00 PM,48,-122,69,49,118
3498,ElliotBayTrailMyrtlePark,05/26/2014 06:00:00 PM,48,-122,62,33,95
3499,ElliotBayTrailMyrtlePark,05/26/2014 07:00:00 PM,48,-122,41,39,80
3500,ElliotBayTrailMyrtlePark,05/26/2014 08:00:00 PM,48,-122,17,22,39
3501,ElliotBayTrailMyrtlePark,05/26/2014 09:00:00 PM,48,-122,8,2,10
3502,ElliotBayTrailMyrtlePark,05/26/2014 10:00:00 PM,48,-122,1,2,3
3503,ElliotBayTrailMyrtlePark,05/26/2014 11:00:00 PM,48,-122,1,2,3
3504,ElliotBayTrailMyrtlePark,05/27/2014 12:00:00 AM,48,-122,0,1,1
3505,ElliotBayTrailMyrtlePark,05/27/2014 01:00:00 AM,48,-122,3,0,3
3506,ElliotBayTrailMyrtlePark,05/27/2014 02:00:00 AM,48,-122,0,0,0
3507,ElliotBayTrailMyrtlePark,05/27/2014 03:00:00 AM,48,-122,0,1,1
3508,ElliotBayTrailMyrtlePark,05/27/2014 04:00:00 AM,48,-122,0,1,1
3509,ElliotBayTrailMyrtlePark,05/27/2014 05:00:00 AM,48,-122,13,20,33
3510,ElliotBayTrailMyrtlePark,05/27/2014 06:00:00 AM,48,-122,24,52,76
3511,ElliotBayTrailMyrtlePark,05/27/2014 07:00:00 AM,48,-122,57,153,210
3512,ElliotBayTrailMyrtlePark,05/27/2014 08:00:00 AM,48,-122,47,155,202
3513,ElliotBayTrailMyrtlePark,05/27/2014 09:00:00 AM,48,-122,17,74,91
3514,ElliotBayTrailMyrtlePark,05/27/2014 10:00:00 AM,48,-122,13,28,41
3515,ElliotBayTrailMyrtlePark,05/27/2014 11:00:00 AM,48,-122,13,19,32
3516,ElliotBayTrailMyrtlePark,05/27/2014 12:00:00 PM,48,-122,21,21,42
3517,ElliotBayTrailMyrtlePark,05/27/2014 01:00:00 PM,48,-122,32,36,68
3518,ElliotBayTrailMyrtlePark,05/27/2014 02:00:00 PM,48,-122,39,27,66
3519,ElliotBayTrailMyrtlePark,05/27/2014 03:00:00 PM,48,-122,51,42,93
3520,ElliotBayTrailMyrtlePark,05/27/2014 04:00:00 PM,48,-122,141,92,233
3521,ElliotBayTrailMyrtlePark,05/27/2014 05:00:00 PM,48,-122,291,87,378
3522,ElliotBayTrailMyrtlePark,05/27/2014 06:00:00 PM,48,-122,170,84,254
3523,ElliotBayTrailMyrtlePark,05/27/2014 07:00:00 PM,48,-122,73,62,135
3524,ElliotBayTrailMyrtlePark,05/27/2014 08:00:00 PM,48,-122,45,28,73
3525,ElliotBayTrailMyrtlePark,05/27/2014 09:00:00 PM,48,-122,8,2,10
3526,ElliotBayTrailMyrtlePark,05/27/2014 10:00:00 PM,48,-122,5,4,9
3527,ElliotBayTrailMyrtlePark,05/27/2014 11:00:00 PM,48,-122,3,0,3
3528,ElliotBayTrailMyrtlePark,05/28/2014 12:00:00 AM,48,-122,1,2,3
3529,ElliotBayTrailMyrtlePark,05/28/2014 01:00:00 AM,48,-122,3,2,5
3530,ElliotBayTrailMyrtlePark,05/28/2014 02:00:00 AM,48,-122,1,0,1
3531,ElliotBayTrailMyrtlePark,05/28/2014 03:00:00 AM,48,-122,0,0,0
3532,ElliotBayTrailMyrtlePark,05/28/2014 04:00:00 AM,48,-122,2,1,3
3533,ElliotBayTrailMyrtlePark,05/28/2014 05:00:00 AM,48,-122,10,14,24
3534,ElliotBayTrailMyrtlePark,05/28/2014 06:00:00 AM,48,-122,20,36,56
3535,ElliotBayTrailMyrtlePark,05/28/2014 07:00:00 AM,48,-122,56,141,197
3536,ElliotBayTrailMyrtlePark,05/28/2014 08:00:00 AM,48,-122,35,145,180
3537,ElliotBayTrailMyrtlePark,05/28/2014 09:00:00 AM,48,-122,18,77,95
3538,ElliotBayTrailMyrtlePark,05/28/2014 10:00:00 AM,48,-122,9,26,35
3539,ElliotBayTrailMyrtlePark,05/28/2014 11:00:00 AM,48,-122,14,34,48
3540,ElliotBayTrailMyrtlePark,05/28/2014 12:00:00 PM,48,-122,22,11,33
3541,ElliotBayTrailMyrtlePark,05/28/2014 01:00:00 PM,48,-122,19,19,38
3542,ElliotBayTrailMyrtlePark,05/28/2014 02:00:00 PM,48,-122,54,34,88
3543,ElliotBayTrailMyrtlePark,05/28/2014 03:00:00 PM,48,-122,28,31,59
3544,ElliotBayTrailMyrtlePark,05/28/2014 04:00:00 PM,48,-122,81,61,142
3545,ElliotBayTrailMyrtlePark,05/28/2014 05:00:00 PM,48,-122,187,53,240
3546,ElliotBayTrailMyrtlePark,05/28/2014 06:00:00 PM,48,-122,127,18,145
3547,ElliotBayTrailMyrtlePark,05/28/2014 07:00:00 PM,48,-122,42,19,61
3548,ElliotBayTrailMyrtlePark,05/28/2014 08:00:00 PM,48,-122,32,9,41
3549,ElliotBayTrailMyrtlePark,05/28/2014 09:00:00 PM,48,-122,4,2,6
3550,ElliotBayTrailMyrtlePark,05/28/2014 10:00:00 PM,48,-122,13,6,19
3551,ElliotBayTrailMyrtlePark,05/28/2014 11:00:00 PM,48,-122,5,1,6
3552,ElliotBayTrailMyrtlePark,05/29/2014 12:00:00 AM,48,-122,1,0,1
3553,ElliotBayTrailMyrtlePark,05/29/2014 01:00:00 AM,48,-122,0,1,1
3554,ElliotBayTrailMyrtlePark,05/29/2014 02:00:00 AM,48,-122,0,0,0
3555,ElliotBayTrailMyrtlePark,05/29/2014 03:00:00 AM,48,-122,2,0,2
3556,ElliotBayTrailMyrtlePark,05/29/2014 04:00:00 AM,48,-122,0,1,1
3557,ElliotBayTrailMyrtlePark,05/29/2014 05:00:00 AM,48,-122,15,19,34
3558,ElliotBayTrailMyrtlePark,05/29/2014 06:00:00 AM,48,-122,18,42,60
3559,ElliotBayTrailMyrtlePark,05/29/2014 07:00:00 AM,48,-122,54,152,206
3560,ElliotBayTrailMyrtlePark,05/29/2014 08:00:00 AM,48,-122,32,156,188
3561,ElliotBayTrailMyrtlePark,05/29/2014 09:00:00 AM,48,-122,20,88,108
3562,ElliotBayTrailMyrtlePark,05/29/2014 10:00:00 AM,48,-122,16,33,49
3563,ElliotBayTrailMyrtlePark,05/29/2014 11:00:00 AM,48,-122,14,28,42
3564,ElliotBayTrailMyrtlePark,05/29/2014 12:00:00 PM,48,-122,16,9,25
3565,ElliotBayTrailMyrtlePark,05/29/2014 01:00:00 PM,48,-122,17,15,32
3566,ElliotBayTrailMyrtlePark,05/29/2014 02:00:00 PM,48,-122,24,29,53
3567,ElliotBayTrailMyrtlePark,05/29/2014 03:00:00 PM,48,-122,44,32,76
3568,ElliotBayTrailMyrtlePark,05/29/2014 04:00:00 PM,48,-122,103,71,174
3569,ElliotBayTrailMyrtlePark,05/29/2014 05:00:00 PM,48,-122,282,55,337
3570,ElliotBayTrailMyrtlePark,05/29/2014 06:00:00 PM,48,-122,156,48,204
3571,ElliotBayTrailMyrtlePark,05/29/2014 07:00:00 PM,48,-122,55,29,84
3572,ElliotBayTrailMyrtlePark,05/29/2014 08:00:00 PM,48,-122,26,17,43
3573,ElliotBayTrailMyrtlePark,05/29/2014 09:00:00 PM,48,-122,13,9,22
3574,ElliotBayTrailMyrtlePark,05/29/2014 10:00:00 PM,48,-122,6,11,17
3575,ElliotBayTrailMyrtlePark,05/29/2014 11:00:00 PM,48,-122,4,1,5
3576,ElliotBayTrailMyrtlePark,05/30/2014 12:00:00 AM,48,-122,5,1,6
3577,ElliotBayTrailMyrtlePark,05/30/2014 01:00:00 AM,48,-122,2,0,2
3578,ElliotBayTrailMyrtlePark,05/30/2014 02:00:00 AM,48,-122,1,0,1
3579,ElliotBayTrailMyrtlePark,05/30/2014 03:00:00 AM,48,-122,0,0,0
3580,ElliotBayTrailMyrtlePark,05/30/2014 04:00:00 AM,48,-122,0,0,0
3581,ElliotBayTrailMyrtlePark,05/30/2014 05:00:00 AM,48,-122,14,25,39
3582,ElliotBayTrailMyrtlePark,05/30/2014 06:00:00 AM,48,-122,28,48,76
3583,ElliotBayTrailMyrtlePark,05/30/2014 07:00:00 AM,48,-122,62,148,210
3584,ElliotBayTrailMyrtlePark,05/30/2014 08:00:00 AM,48,-122,53,180,233
3585,ElliotBayTrailMyrtlePark,05/30/2014 09:00:00 AM,48,-122,29,80,109
3586,ElliotBayTrailMyrtlePark,05/30/2014 10:00:00 AM,48,-122,38,33,71
3587,ElliotBayTrailMyrtlePark,05/30/2014 11:00:00 AM,48,-122,33,36,69
3588,ElliotBayTrailMyrtlePark,05/30/2014 12:00:00 PM,48,-122,30,37,67
3589,ElliotBayTrailMyrtlePark,05/30/2014 01:00:00 PM,48,-122,32,30,62
3590,ElliotBayTrailMyrtlePark,05/30/2014 02:00:00 PM,48,-122,33,38,71
3591,ElliotBayTrailMyrtlePark,05/30/2014 03:00:00 PM,48,-122,84,46,130
3592,ElliotBayTrailMyrtlePark,05/30/2014 04:00:00 PM,48,-122,154,79,233
3593,ElliotBayTrailMyrtlePark,05/30/2014 05:00:00 PM,48,-122,221,94,315
3594,ElliotBayTrailMyrtlePark,05/30/2014 06:00:00 PM,48,-122,147,47,194
3595,ElliotBayTrailMyrtlePark,05/30/2014 07:00:00 PM,48,-122,68,29,97
3596,ElliotBayTrailMyrtlePark,05/30/2014 08:00:00 PM,48,-122,28,25,53
3597,ElliotBayTrailMyrtlePark,05/30/2014 09:00:00 PM,48,-122,13,10,23
3598,ElliotBayTrailMyrtlePark,05/30/2014 10:00:00 PM,48,-122,12,4,16
3599,ElliotBayTrailMyrtlePark,05/30/2014 11:00:00 PM,48,-122,9,4,13
3600,ElliotBayTrailMyrtlePark,05/31/2014 12:00:00 AM,48,-122,7,0,7
3601,ElliotBayTrailMyrtlePark,05/31/2014 01:00:00 AM,48,-122,2,6,8
3602,ElliotBayTrailMyrtlePark,05/31/2014 02:00:00 AM,48,-122,2,0,2
3603,ElliotBayTrailMyrtlePark,05/31/2014 03:00:00 AM,48,-122,1,0,1
3604,ElliotBayTrailMyrtlePark,05/31/2014 04:00:00 AM,48,-122,0,1,1
3605,ElliotBayTrailMyrtlePark,05/31/2014 05:00:00 AM,48,-122,2,5,7
3606,ElliotBayTrailMyrtlePark,05/31/2014 06:00:00 AM,48,-122,3,5,8
3607,ElliotBayTrailMyrtlePark,05/31/2014 07:00:00 AM,48,-122,18,20,38
3608,ElliotBayTrailMyrtlePark,05/31/2014 08:00:00 AM,48,-122,35,30,65
3609,ElliotBayTrailMyrtlePark,05/31/2014 09:00:00 AM,48,-122,34,37,71
3610,ElliotBayTrailMyrtlePark,05/31/2014 10:00:00 AM,48,-122,56,51,107
3611,ElliotBayTrailMyrtlePark,05/31/2014 11:00:00 AM,48,-122,71,121,192
3612,ElliotBayTrailMyrtlePark,05/31/2014 12:00:00 PM,48,-122,69,129,198
3613,ElliotBayTrailMyrtlePark,05/31/2014 01:00:00 PM,48,-122,112,85,197
3614,ElliotBayTrailMyrtlePark,05/31/2014 02:00:00 PM,48,-122,82,81,163
3615,ElliotBayTrailMyrtlePark,05/31/2014 03:00:00 PM,48,-122,202,91,293
3616,ElliotBayTrailMyrtlePark,05/31/2014 04:00:00 PM,48,-122,79,84,163
3617,ElliotBayTrailMyrtlePark,05/31/2014 05:00:00 PM,48,-122,86,63,149
3618,ElliotBayTrailMyrtlePark,05/31/2014 06:00:00 PM,48,-122,54,36,90
3619,ElliotBayTrailMyrtlePark,05/31/2014 07:00:00 PM,48,-122,46,40,86
3620,ElliotBayTrailMyrtlePark,05/31/2014 08:00:00 PM,48,-122,30,17,47
3621,ElliotBayTrailMyrtlePark,05/31/2014 09:00:00 PM,48,-122,16,11,27
3622,ElliotBayTrailMyrtlePark,05/31/2014 10:00:00 PM,48,-122,6,4,10
3623,ElliotBayTrailMyrtlePark,05/31/2014 11:00:00 PM,48,-122,14,1,15
3624,ElliotBayTrailMyrtlePark,06/01/2014 12:00:00 AM,48,-122,7,2,9
3625,ElliotBayTrailMyrtlePark,06/01/2014 01:00:00 AM,48,-122,2,0,2
3626,ElliotBayTrailMyrtlePark,06/01/2014 02:00:00 AM,48,-122,6,3,9
3627,ElliotBayTrailMyrtlePark,06/01/2014 03:00:00 AM,48,-122,0,0,0
3628,ElliotBayTrailMyrtlePark,06/01/2014 04:00:00 AM,48,-122,0,0,0
3629,ElliotBayTrailMyrtlePark,06/01/2014 05:00:00 AM,48,-122,2,1,3
3630,ElliotBayTrailMyrtlePark,06/01/2014 06:00:00 AM,48,-122,6,8,14
3631,ElliotBayTrailMyrtlePark,06/01/2014 07:00:00 AM,48,-122,12,14,26
3632,ElliotBayTrailMyrtlePark,06/01/2014 08:00:00 AM,48,-122,11,21,32
3633,ElliotBayTrailMyrtlePark,06/01/2014 09:00:00 AM,48,-122,34,27,61
3634,ElliotBayTrailMyrtlePark,06/01/2014 10:00:00 AM,48,-122,31,64,95
3635,ElliotBayTrailMyrtlePark,06/01/2014 11:00:00 AM,48,-122,65,57,122
3636,ElliotBayTrailMyrtlePark,06/01/2014 12:00:00 PM,48,-122,56,70,126
3637,ElliotBayTrailMyrtlePark,06/01/2014 01:00:00 PM,48,-122,90,81,171
3638,ElliotBayTrailMyrtlePark,06/01/2014 02:00:00 PM,48,-122,123,73,196
3639,ElliotBayTrailMyrtlePark,06/01/2014 03:00:00 PM,48,-122,86,98,184
3640,ElliotBayTrailMyrtlePark,06/01/2014 04:00:00 PM,48,-122,97,79,176
3641,ElliotBayTrailMyrtlePark,06/01/2014 05:00:00 PM,48,-122,76,51,127
3642,ElliotBayTrailMyrtlePark,06/01/2014 06:00:00 PM,48,-122,63,61,124
3643,ElliotBayTrailMyrtlePark,06/01/2014 07:00:00 PM,48,-122,55,29,84
3644,ElliotBayTrailMyrtlePark,06/01/2014 08:00:00 PM,48,-122,32,27,59
3645,ElliotBayTrailMyrtlePark,06/01/2014 09:00:00 PM,48,-122,7,8,15
3646,ElliotBayTrailMyrtlePark,06/01/2014 10:00:00 PM,48,-122,8,10,18
3647,ElliotBayTrailMyrtlePark,06/01/2014 11:00:00 PM,48,-122,2,1,3
3648,ElliotBayTrailMyrtlePark,06/02/2014 12:00:00 AM,48,-122,6,1,7
3649,ElliotBayTrailMyrtlePark,06/02/2014 01:00:00 AM,48,-122,0,0,0
3650,ElliotBayTrailMyrtlePark,06/02/2014 02:00:00 AM,48,-122,1,0,1
3651,ElliotBayTrailMyrtlePark,06/02/2014 03:00:00 AM,48,-122,0,0,0
3652,ElliotBayTrailMyrtlePark,06/02/2014 04:00:00 AM,48,-122,0,1,1
3653,ElliotBayTrailMyrtlePark,06/02/2014 05:00:00 AM,48,-122,10,28,38
3654,ElliotBayTrailMyrtlePark,06/02/2014 06:00:00 AM,48,-122,28,55,83
3655,ElliotBayTrailMyrtlePark,06/02/2014 07:00:00 AM,48,-122,49,141,190
3656,ElliotBayTrailMyrtlePark,06/02/2014 08:00:00 AM,48,-122,44,168,212
3657,ElliotBayTrailMyrtlePark,06/02/2014 09:00:00 AM,48,-122,33,78,111
3658,ElliotBayTrailMyrtlePark,06/02/2014 10:00:00 AM,48,-122,19,31,50
3659,ElliotBayTrailMyrtlePark,06/02/2014 11:00:00 AM,48,-122,25,32,57
3660,ElliotBayTrailMyrtlePark,06/02/2014 12:00:00 PM,48,-122,25,28,53
3661,ElliotBayTrailMyrtlePark,06/02/2014 01:00:00 PM,48,-122,32,24,56
3662,ElliotBayTrailMyrtlePark,06/02/2014 02:00:00 PM,48,-122,24,25,49
3663,ElliotBayTrailMyrtlePark,06/02/2014 03:00:00 PM,48,-122,53,43,96
3664,ElliotBayTrailMyrtlePark,06/02/2014 04:00:00 PM,48,-122,118,52,170
3665,ElliotBayTrailMyrtlePark,06/02/2014 05:00:00 PM,48,-122,246,86,332
3666,ElliotBayTrailMyrtlePark,06/02/2014 06:00:00 PM,48,-122,166,70,236
3667,ElliotBayTrailMyrtlePark,06/02/2014 07:00:00 PM,48,-122,101,46,147
3668,ElliotBayTrailMyrtlePark,06/02/2014 08:00:00 PM,48,-122,47,45,92
3669,ElliotBayTrailMyrtlePark,06/02/2014 09:00:00 PM,48,-122,9,8,17
3670,ElliotBayTrailMyrtlePark,06/02/2014 10:00:00 PM,48,-122,5,2,7
3671,ElliotBayTrailMyrtlePark,06/02/2014 11:00:00 PM,48,-122,4,4,8
3672,ElliotBayTrailMyrtlePark,06/03/2014 12:00:00 AM,48,-122,2,0,2
3673,ElliotBayTrailMyrtlePark,06/03/2014 01:00:00 AM,48,-122,0,0,0
3674,ElliotBayTrailMyrtlePark,06/03/2014 02:00:00 AM,48,-122,1,0,1
3675,ElliotBayTrailMyrtlePark,06/03/2014 03:00:00 AM,48,-122,0,0,0
3676,ElliotBayTrailMyrtlePark,06/03/2014 04:00:00 AM,48,-122,0,1,1
3677,ElliotBayTrailMyrtlePark,06/03/2014 05:00:00 AM,48,-122,13,18,31
3678,ElliotBayTrailMyrtlePark,06/03/2014 06:00:00 AM,48,-122,14,54,68
3679,ElliotBayTrailMyrtlePark,06/03/2014 07:00:00 AM,48,-122,66,149,215
3680,ElliotBayTrailMyrtlePark,06/03/2014 08:00:00 AM,48,-122,36,168,204
3681,ElliotBayTrailMyrtlePark,06/03/2014 09:00:00 AM,48,-122,30,86,116
3682,ElliotBayTrailMyrtlePark,06/03/2014 10:00:00 AM,48,-122,19,36,55
3683,ElliotBayTrailMyrtlePark,06/03/2014 11:00:00 AM,48,-122,14,15,29
3684,ElliotBayTrailMyrtlePark,06/03/2014 12:00:00 PM,48,-122,17,23,40
3685,ElliotBayTrailMyrtlePark,06/03/2014 01:00:00 PM,48,-122,21,26,47
3686,ElliotBayTrailMyrtlePark,06/03/2014 02:00:00 PM,48,-122,31,25,56
3687,ElliotBayTrailMyrtlePark,06/03/2014 03:00:00 PM,48,-122,42,33,75
3688,ElliotBayTrailMyrtlePark,06/03/2014 04:00:00 PM,48,-122,110,50,160
3689,ElliotBayTrailMyrtlePark,06/03/2014 05:00:00 PM,48,-122,230,64,294
3690,ElliotBayTrailMyrtlePark,06/03/2014 06:00:00 PM,48,-122,143,46,189
3691,ElliotBayTrailMyrtlePark,06/03/2014 07:00:00 PM,48,-122,64,42,106
3692,ElliotBayTrailMyrtlePark,06/03/2014 08:00:00 PM,48,-122,25,13,38
3693,ElliotBayTrailMyrtlePark,06/03/2014 09:00:00 PM,48,-122,10,11,21
3694,ElliotBayTrailMyrtlePark,06/03/2014 10:00:00 PM,48,-122,8,1,9
3695,ElliotBayTrailMyrtlePark,06/03/2014 11:00:00 PM,48,-122,5,5,10
3696,ElliotBayTrailMyrtlePark,06/04/2014 12:00:00 AM,48,-122,0,0,0
3697,ElliotBayTrailMyrtlePark,06/04/2014 01:00:00 AM,48,-122,1,0,1
3698,ElliotBayTrailMyrtlePark,06/04/2014 02:00:00 AM,48,-122,1,0,1
3699,ElliotBayTrailMyrtlePark,06/04/2014 03:00:00 AM,48,-122,0,0,0
3700,ElliotBayTrailMyrtlePark,06/04/2014 04:00:00 AM,48,-122,0,1,1
3701,ElliotBayTrailMyrtlePark,06/04/2014 05:00:00 AM,48,-122,11,19,30
3702,ElliotBayTrailMyrtlePark,06/04/2014 06:00:00 AM,48,-122,30,42,72
3703,ElliotBayTrailMyrtlePark,06/04/2014 07:00:00 AM,48,-122,71,123,194
3704,ElliotBayTrailMyrtlePark,06/04/2014 08:00:00 AM,48,-122,43,160,203
3705,ElliotBayTrailMyrtlePark,06/04/2014 09:00:00 AM,48,-122,29,78,107
3706,ElliotBayTrailMyrtlePark,06/04/2014 10:00:00 AM,48,-122,24,26,50
3707,ElliotBayTrailMyrtlePark,06/04/2014 11:00:00 AM,48,-122,25,23,48
3708,ElliotBayTrailMyrtlePark,06/04/2014 12:00:00 PM,48,-122,12,32,44
3709,ElliotBayTrailMyrtlePark,06/04/2014 01:00:00 PM,48,-122,39,25,64
3710,ElliotBayTrailMyrtlePark,06/04/2014 02:00:00 PM,48,-122,43,37,80
3711,ElliotBayTrailMyrtlePark,06/04/2014 03:00:00 PM,48,-122,52,40,92
3712,ElliotBayTrailMyrtlePark,06/04/2014 04:00:00 PM,48,-122,116,70,186
3713,ElliotBayTrailMyrtlePark,06/04/2014 05:00:00 PM,48,-122,237,88,325
3714,ElliotBayTrailMyrtlePark,06/04/2014 06:00:00 PM,48,-122,156,71,227
3715,ElliotBayTrailMyrtlePark,06/04/2014 07:00:00 PM,48,-122,89,55,144
3716,ElliotBayTrailMyrtlePark,06/04/2014 08:00:00 PM,48,-122,31,21,52
3717,ElliotBayTrailMyrtlePark,06/04/2014 09:00:00 PM,48,-122,11,6,17
3718,ElliotBayTrailMyrtlePark,06/04/2014 10:00:00 PM,48,-122,8,4,12
3719,ElliotBayTrailMyrtlePark,06/04/2014 11:00:00 PM,48,-122,2,3,5
3720,ElliotBayTrailMyrtlePark,06/05/2014 12:00:00 AM,48,-122,4,1,5
3721,ElliotBayTrailMyrtlePark,06/05/2014 01:00:00 AM,48,-122,1,0,1
3722,ElliotBayTrailMyrtlePark,06/05/2014 02:00:00 AM,48,-122,1,0,1
3723,ElliotBayTrailMyrtlePark,06/05/2014 03:00:00 AM,48,-122,1,1,2
3724,ElliotBayTrailMyrtlePark,06/05/2014 04:00:00 AM,48,-122,0,1,1
3725,ElliotBayTrailMyrtlePark,06/05/2014 05:00:00 AM,48,-122,14,16,30
3726,ElliotBayTrailMyrtlePark,06/05/2014 06:00:00 AM,48,-122,21,51,72
3727,ElliotBayTrailMyrtlePark,06/05/2014 07:00:00 AM,48,-122,58,132,190
3728,ElliotBayTrailMyrtlePark,06/05/2014 08:00:00 AM,48,-122,52,155,207
3729,ElliotBayTrailMyrtlePark,06/05/2014 09:00:00 AM,48,-122,27,97,124
3730,ElliotBayTrailMyrtlePark,06/05/2014 10:00:00 AM,48,-122,26,30,56
3731,ElliotBayTrailMyrtlePark,06/05/2014 11:00:00 AM,48,-122,17,27,44
3732,ElliotBayTrailMyrtlePark,06/05/2014 12:00:00 PM,48,-122,28,22,50
3733,ElliotBayTrailMyrtlePark,06/05/2014 01:00:00 PM,48,-122,36,34,70
3734,ElliotBayTrailMyrtlePark,06/05/2014 02:00:00 PM,48,-122,34,33,67
3735,ElliotBayTrailMyrtlePark,06/05/2014 03:00:00 PM,48,-122,68,50,118
3736,ElliotBayTrailMyrtlePark,06/05/2014 04:00:00 PM,48,-122,106,59,165
3737,ElliotBayTrailMyrtlePark,06/05/2014 05:00:00 PM,48,-122,216,96,312
3738,ElliotBayTrailMyrtlePark,06/05/2014 06:00:00 PM,48,-122,150,71,221
3739,ElliotBayTrailMyrtlePark,06/05/2014 07:00:00 PM,48,-122,79,38,117
3740,ElliotBayTrailMyrtlePark,06/05/2014 08:00:00 PM,48,-122,57,41,98
3741,ElliotBayTrailMyrtlePark,06/05/2014 09:00:00 PM,48,-122,18,14,32
3742,ElliotBayTrailMyrtlePark,06/05/2014 10:00:00 PM,48,-122,17,11,28
3743,ElliotBayTrailMyrtlePark,06/05/2014 11:00:00 PM,48,-122,7,6,13
3744,ElliotBayTrailMyrtlePark,06/06/2014 12:00:00 AM,48,-122,6,12,18
3745,ElliotBayTrailMyrtlePark,06/06/2014 01:00:00 AM,48,-122,0,0,0
3746,ElliotBayTrailMyrtlePark,06/06/2014 02:00:00 AM,48,-122,3,0,3
3747,ElliotBayTrailMyrtlePark,06/06/2014 03:00:00 AM,48,-122,0,0,0
3748,ElliotBayTrailMyrtlePark,06/06/2014 04:00:00 AM,48,-122,1,0,1
3749,ElliotBayTrailMyrtlePark,06/06/2014 05:00:00 AM,48,-122,11,18,29
3750,ElliotBayTrailMyrtlePark,06/06/2014 06:00:00 AM,48,-122,26,47,73
3751,ElliotBayTrailMyrtlePark,06/06/2014 07:00:00 AM,48,-122,57,116,173
3752,ElliotBayTrailMyrtlePark,06/06/2014 08:00:00 AM,48,-122,55,124,179
3753,ElliotBayTrailMyrtlePark,06/06/2014 09:00:00 AM,48,-122,22,75,97
3754,ElliotBayTrailMyrtlePark,06/06/2014 10:00:00 AM,48,-122,21,36,57
3755,ElliotBayTrailMyrtlePark,06/06/2014 11:00:00 AM,48,-122,19,32,51
3756,ElliotBayTrailMyrtlePark,06/06/2014 12:00:00 PM,48,-122,30,22,52
3757,ElliotBayTrailMyrtlePark,06/06/2014 01:00:00 PM,48,-122,43,37,80
3758,ElliotBayTrailMyrtlePark,06/06/2014 02:00:00 PM,48,-122,55,40,95
3759,ElliotBayTrailMyrtlePark,06/06/2014 03:00:00 PM,48,-122,65,49,114
3760,ElliotBayTrailMyrtlePark,06/06/2014 04:00:00 PM,48,-122,130,70,200
3761,ElliotBayTrailMyrtlePark,06/06/2014 05:00:00 PM,48,-122,217,60,277
3762,ElliotBayTrailMyrtlePark,06/06/2014 06:00:00 PM,48,-122,100,44,144
3763,ElliotBayTrailMyrtlePark,06/06/2014 07:00:00 PM,48,-122,65,51,116
3764,ElliotBayTrailMyrtlePark,06/06/2014 08:00:00 PM,48,-122,30,25,55
3765,ElliotBayTrailMyrtlePark,06/06/2014 09:00:00 PM,48,-122,10,9,19
3766,ElliotBayTrailMyrtlePark,06/06/2014 10:00:00 PM,48,-122,11,5,16
3767,ElliotBayTrailMyrtlePark,06/06/2014 11:00:00 PM,48,-122,11,3,14
3768,ElliotBayTrailMyrtlePark,06/07/2014 12:00:00 AM,48,-122,13,1,14
3769,ElliotBayTrailMyrtlePark,06/07/2014 01:00:00 AM,48,-122,4,5,9
3770,ElliotBayTrailMyrtlePark,06/07/2014 02:00:00 AM,48,-122,1,4,5
3771,ElliotBayTrailMyrtlePark,06/07/2014 03:00:00 AM,48,-122,1,0,1
3772,ElliotBayTrailMyrtlePark,06/07/2014 04:00:00 AM,48,-122,0,0,0
3773,ElliotBayTrailMyrtlePark,06/07/2014 05:00:00 AM,48,-122,0,3,3
3774,ElliotBayTrailMyrtlePark,06/07/2014 06:00:00 AM,48,-122,5,7,12
3775,ElliotBayTrailMyrtlePark,06/07/2014 07:00:00 AM,48,-122,20,18,38
3776,ElliotBayTrailMyrtlePark,06/07/2014 08:00:00 AM,48,-122,17,21,38
3777,ElliotBayTrailMyrtlePark,06/07/2014 09:00:00 AM,48,-122,31,50,81
3778,ElliotBayTrailMyrtlePark,06/07/2014 10:00:00 AM,48,-122,67,58,125
3779,ElliotBayTrailMyrtlePark,06/07/2014 11:00:00 AM,48,-122,70,70,140
3780,ElliotBayTrailMyrtlePark,06/07/2014 12:00:00 PM,48,-122,59,72,131
3781,ElliotBayTrailMyrtlePark,06/07/2014 01:00:00 PM,48,-122,101,91,192
3782,ElliotBayTrailMyrtlePark,06/07/2014 02:00:00 PM,48,-122,106,91,197
3783,ElliotBayTrailMyrtlePark,06/07/2014 03:00:00 PM,48,-122,73,128,201
3784,ElliotBayTrailMyrtlePark,06/07/2014 04:00:00 PM,48,-122,103,85,188
3785,ElliotBayTrailMyrtlePark,06/07/2014 05:00:00 PM,48,-122,85,67,152
3786,ElliotBayTrailMyrtlePark,06/07/2014 06:00:00 PM,48,-122,65,54,119
3787,ElliotBayTrailMyrtlePark,06/07/2014 07:00:00 PM,48,-122,53,46,99
3788,ElliotBayTrailMyrtlePark,06/07/2014 08:00:00 PM,48,-122,28,30,58
3789,ElliotBayTrailMyrtlePark,06/07/2014 09:00:00 PM,48,-122,18,20,38
3790,ElliotBayTrailMyrtlePark,06/07/2014 10:00:00 PM,48,-122,6,6,12
3791,ElliotBayTrailMyrtlePark,06/07/2014 11:00:00 PM,48,-122,3,2,5
3792,ElliotBayTrailMyrtlePark,06/08/2014 12:00:00 AM,48,-122,1,4,5
3793,ElliotBayTrailMyrtlePark,06/08/2014 01:00:00 AM,48,-122,3,0,3
3794,ElliotBayTrailMyrtlePark,06/08/2014 02:00:00 AM,48,-122,4,0,4
3795,ElliotBayTrailMyrtlePark,06/08/2014 03:00:00 AM,48,-122,0,0,0
3796,ElliotBayTrailMyrtlePark,06/08/2014 04:00:00 AM,48,-122,0,0,0
3797,ElliotBayTrailMyrtlePark,06/08/2014 05:00:00 AM,48,-122,3,3,6
3798,ElliotBayTrailMyrtlePark,06/08/2014 06:00:00 AM,48,-122,6,10,16
3799,ElliotBayTrailMyrtlePark,06/08/2014 07:00:00 AM,48,-122,27,14,41
3800,ElliotBayTrailMyrtlePark,06/08/2014 08:00:00 AM,48,-122,176,42,218
3801,ElliotBayTrailMyrtlePark,06/08/2014 09:00:00 AM,48,-122,219,48,267
3802,ElliotBayTrailMyrtlePark,06/08/2014 10:00:00 AM,48,-122,97,55,152
3803,ElliotBayTrailMyrtlePark,06/08/2014 11:00:00 AM,48,-122,72,58,130
3804,ElliotBayTrailMyrtlePark,06/08/2014 12:00:00 PM,48,-122,70,79,149
3805,ElliotBayTrailMyrtlePark,06/08/2014 01:00:00 PM,48,-122,98,137,235
3806,ElliotBayTrailMyrtlePark,06/08/2014 02:00:00 PM,48,-122,104,185,289
3807,ElliotBayTrailMyrtlePark,06/08/2014 03:00:00 PM,48,-122,99,167,266
3808,ElliotBayTrailMyrtlePark,06/08/2014 04:00:00 PM,48,-122,100,131,231
3809,ElliotBayTrailMyrtlePark,06/08/2014 05:00:00 PM,48,-122,86,61,147
3810,ElliotBayTrailMyrtlePark,06/08/2014 06:00:00 PM,48,-122,46,39,85
3811,ElliotBayTrailMyrtlePark,06/08/2014 07:00:00 PM,48,-122,23,44,67
3812,ElliotBayTrailMyrtlePark,06/08/2014 08:00:00 PM,48,-122,30,20,50
3813,ElliotBayTrailMyrtlePark,06/08/2014 09:00:00 PM,48,-122,6,3,9
3814,ElliotBayTrailMyrtlePark,06/08/2014 10:00:00 PM,48,-122,8,6,14
3815,ElliotBayTrailMyrtlePark,06/08/2014 11:00:00 PM,48,-122,2,2,4
3816,ElliotBayTrailMyrtlePark,06/09/2014 12:00:00 AM,48,-122,2,2,4
3817,ElliotBayTrailMyrtlePark,06/09/2014 01:00:00 AM,48,-122,4,0,4
3818,ElliotBayTrailMyrtlePark,06/09/2014 02:00:00 AM,48,-122,0,1,1
3819,ElliotBayTrailMyrtlePark,06/09/2014 03:00:00 AM,48,-122,0,0,0
3820,ElliotBayTrailMyrtlePark,06/09/2014 04:00:00 AM,48,-122,0,1,1
3821,ElliotBayTrailMyrtlePark,06/09/2014 05:00:00 AM,48,-122,14,21,35
3822,ElliotBayTrailMyrtlePark,06/09/2014 06:00:00 AM,48,-122,12,28,40
3823,ElliotBayTrailMyrtlePark,06/09/2014 07:00:00 AM,48,-122,65,119,184
3824,ElliotBayTrailMyrtlePark,06/09/2014 08:00:00 AM,48,-122,33,164,197
3825,ElliotBayTrailMyrtlePark,06/09/2014 09:00:00 AM,48,-122,32,90,122
3826,ElliotBayTrailMyrtlePark,06/09/2014 10:00:00 AM,48,-122,20,28,48
3827,ElliotBayTrailMyrtlePark,06/09/2014 11:00:00 AM,48,-122,24,25,49
3828,ElliotBayTrailMyrtlePark,06/09/2014 12:00:00 PM,48,-122,30,24,54
3829,ElliotBayTrailMyrtlePark,06/09/2014 01:00:00 PM,48,-122,24,36,60
3830,ElliotBayTrailMyrtlePark,06/09/2014 02:00:00 PM,48,-122,24,27,51
3831,ElliotBayTrailMyrtlePark,06/09/2014 03:00:00 PM,48,-122,76,40,116
3832,ElliotBayTrailMyrtlePark,06/09/2014 04:00:00 PM,48,-122,89,51,140
3833,ElliotBayTrailMyrtlePark,06/09/2014 05:00:00 PM,48,-122,219,60,279
3834,ElliotBayTrailMyrtlePark,06/09/2014 06:00:00 PM,48,-122,142,39,181
3835,ElliotBayTrailMyrtlePark,06/09/2014 07:00:00 PM,48,-122,72,35,107
3836,ElliotBayTrailMyrtlePark,06/09/2014 08:00:00 PM,48,-122,28,27,55
3837,ElliotBayTrailMyrtlePark,06/09/2014 09:00:00 PM,48,-122,10,1,11
3838,ElliotBayTrailMyrtlePark,06/09/2014 10:00:00 PM,48,-122,4,8,12
3839,ElliotBayTrailMyrtlePark,06/09/2014 11:00:00 PM,48,-122,6,3,9
3840,ElliotBayTrailMyrtlePark,06/10/2014 12:00:00 AM,48,-122,1,1,2
3841,ElliotBayTrailMyrtlePark,06/10/2014 01:00:00 AM,48,-122,3,0,3
3842,ElliotBayTrailMyrtlePark,06/10/2014 02:00:00 AM,48,-122,1,0,1
3843,ElliotBayTrailMyrtlePark,06/10/2014 03:00:00 AM,48,-122,0,1,1
3844,ElliotBayTrailMyrtlePark,06/10/2014 04:00:00 AM,48,-122,1,0,1
3845,ElliotBayTrailMyrtlePark,06/10/2014 05:00:00 AM,48,-122,13,26,39
3846,ElliotBayTrailMyrtlePark,06/10/2014 06:00:00 AM,48,-122,19,43,62
3847,ElliotBayTrailMyrtlePark,06/10/2014 07:00:00 AM,48,-122,59,160,219
3848,ElliotBayTrailMyrtlePark,06/10/2014 08:00:00 AM,48,-122,33,155,188
3849,ElliotBayTrailMyrtlePark,06/10/2014 09:00:00 AM,48,-122,31,80,111
3850,ElliotBayTrailMyrtlePark,06/10/2014 10:00:00 AM,48,-122,10,27,37
3851,ElliotBayTrailMyrtlePark,06/10/2014 11:00:00 AM,48,-122,14,21,35
3852,ElliotBayTrailMyrtlePark,06/10/2014 12:00:00 PM,48,-122,29,18,47
3853,ElliotBayTrailMyrtlePark,06/10/2014 01:00:00 PM,48,-122,30,32,62
3854,ElliotBayTrailMyrtlePark,06/10/2014 02:00:00 PM,48,-122,25,37,62
3855,ElliotBayTrailMyrtlePark,06/10/2014 03:00:00 PM,48,-122,50,42,92
3856,ElliotBayTrailMyrtlePark,06/10/2014 04:00:00 PM,48,-122,107,58,165
3857,ElliotBayTrailMyrtlePark,06/10/2014 05:00:00 PM,48,-122,212,62,274
3858,ElliotBayTrailMyrtlePark,06/10/2014 06:00:00 PM,48,-122,171,58,229
3859,ElliotBayTrailMyrtlePark,06/10/2014 07:00:00 PM,48,-122,69,35,104
3860,ElliotBayTrailMyrtlePark,06/10/2014 08:00:00 PM,48,-122,24,25,49
3861,ElliotBayTrailMyrtlePark,06/10/2014 09:00:00 PM,48,-122,10,5,15
3862,ElliotBayTrailMyrtlePark,06/10/2014 10:00:00 PM,48,-122,11,3,14
3863,ElliotBayTrailMyrtlePark,06/10/2014 11:00:00 PM,48,-122,8,1,9
3864,ElliotBayTrailMyrtlePark,06/11/2014 12:00:00 AM,48,-122,2,1,3
3865,ElliotBayTrailMyrtlePark,06/11/2014 01:00:00 AM,48,-122,3,0,3
3866,ElliotBayTrailMyrtlePark,06/11/2014 02:00:00 AM,48,-122,1,0,1
3867,ElliotBayTrailMyrtlePark,06/11/2014 03:00:00 AM,48,-122,0,0,0
3868,ElliotBayTrailMyrtlePark,06/11/2014 04:00:00 AM,48,-122,0,2,2
3869,ElliotBayTrailMyrtlePark,06/11/2014 05:00:00 AM,48,-122,13,24,37
3870,ElliotBayTrailMyrtlePark,06/11/2014 06:00:00 AM,48,-122,27,79,106
3871,ElliotBayTrailMyrtlePark,06/11/2014 07:00:00 AM,48,-122,57,173,230
3872,ElliotBayTrailMyrtlePark,06/11/2014 08:00:00 AM,48,-122,89,129,218
3873,ElliotBayTrailMyrtlePark,06/11/2014 09:00:00 AM,48,-122,44,89,133
3874,ElliotBayTrailMyrtlePark,06/11/2014 10:00:00 AM,48,-122,19,39,58
3875,ElliotBayTrailMyrtlePark,06/11/2014 11:00:00 AM,48,-122,21,23,44
3876,ElliotBayTrailMyrtlePark,06/11/2014 12:00:00 PM,48,-122,43,39,82
3877,ElliotBayTrailMyrtlePark,06/11/2014 01:00:00 PM,48,-122,44,39,83
3878,ElliotBayTrailMyrtlePark,06/11/2014 02:00:00 PM,48,-122,51,51,102
3879,ElliotBayTrailMyrtlePark,06/11/2014 03:00:00 PM,48,-122,60,59,119
3880,ElliotBayTrailMyrtlePark,06/11/2014 04:00:00 PM,48,-122,137,82,219
3881,ElliotBayTrailMyrtlePark,06/11/2014 05:00:00 PM,48,-122,242,104,346
3882,ElliotBayTrailMyrtlePark,06/11/2014 06:00:00 PM,48,-122,192,62,254
3883,ElliotBayTrailMyrtlePark,06/11/2014 07:00:00 PM,48,-122,70,46,116
3884,ElliotBayTrailMyrtlePark,06/11/2014 08:00:00 PM,48,-122,33,20,53
3885,ElliotBayTrailMyrtlePark,06/11/2014 09:00:00 PM,48,-122,19,9,28
3886,ElliotBayTrailMyrtlePark,06/11/2014 10:00:00 PM,48,-122,8,7,15
3887,ElliotBayTrailMyrtlePark,06/11/2014 11:00:00 PM,48,-122,3,2,5
3888,ElliotBayTrailMyrtlePark,06/12/2014 12:00:00 AM,48,-122,5,3,8
3889,ElliotBayTrailMyrtlePark,06/12/2014 01:00:00 AM,48,-122,2,1,3
3890,ElliotBayTrailMyrtlePark,06/12/2014 02:00:00 AM,48,-122,3,0,3
3891,ElliotBayTrailMyrtlePark,06/12/2014 03:00:00 AM,48,-122,0,0,0
3892,ElliotBayTrailMyrtlePark,06/12/2014 04:00:00 AM,48,-122,1,1,2
3893,ElliotBayTrailMyrtlePark,06/12/2014 05:00:00 AM,48,-122,12,14,26
3894,ElliotBayTrailMyrtlePark,06/12/2014 06:00:00 AM,48,-122,18,47,65
3895,ElliotBayTrailMyrtlePark,06/12/2014 07:00:00 AM,48,-122,61,123,184
3896,ElliotBayTrailMyrtlePark,06/12/2014 08:00:00 AM,48,-122,50,139,189
3897,ElliotBayTrailMyrtlePark,06/12/2014 09:00:00 AM,48,-122,20,73,93
3898,ElliotBayTrailMyrtlePark,06/12/2014 10:00:00 AM,48,-122,15,27,42
3899,ElliotBayTrailMyrtlePark,06/12/2014 11:00:00 AM,48,-122,12,20,32
3900,ElliotBayTrailMyrtlePark,06/12/2014 12:00:00 PM,48,-122,21,19,40
3901,ElliotBayTrailMyrtlePark,06/12/2014 01:00:00 PM,48,-122,30,19,49
3902,ElliotBayTrailMyrtlePark,06/12/2014 02:00:00 PM,48,-122,31,25,56
3903,ElliotBayTrailMyrtlePark,06/12/2014 03:00:00 PM,48,-122,38,28,66
3904,ElliotBayTrailMyrtlePark,06/12/2014 04:00:00 PM,48,-122,92,51,143
3905,ElliotBayTrailMyrtlePark,06/12/2014 05:00:00 PM,48,-122,208,86,294
3906,ElliotBayTrailMyrtlePark,06/12/2014 06:00:00 PM,48,-122,122,46,168
3907,ElliotBayTrailMyrtlePark,06/12/2014 07:00:00 PM,48,-122,59,25,84
3908,ElliotBayTrailMyrtlePark,06/12/2014 08:00:00 PM,48,-122,14,21,35
3909,ElliotBayTrailMyrtlePark,06/12/2014 09:00:00 PM,48,-122,12,7,19
3910,ElliotBayTrailMyrtlePark,06/12/2014 10:00:00 PM,48,-122,17,3,20
3911,ElliotBayTrailMyrtlePark,06/12/2014 11:00:00 PM,48,-122,5,1,6
3912,ElliotBayTrailMyrtlePark,06/13/2014 12:00:00 AM,48,-122,1,1,2
3913,ElliotBayTrailMyrtlePark,06/13/2014 01:00:00 AM,48,-122,3,0,3
3914,ElliotBayTrailMyrtlePark,06/13/2014 02:00:00 AM,48,-122,2,0,2
3915,ElliotBayTrailMyrtlePark,06/13/2014 03:00:00 AM,48,-122,0,0,0
3916,ElliotBayTrailMyrtlePark,06/13/2014 04:00:00 AM,48,-122,0,0,0
3917,ElliotBayTrailMyrtlePark,06/13/2014 05:00:00 AM,48,-122,6,16,22
3918,ElliotBayTrailMyrtlePark,06/13/2014 06:00:00 AM,48,-122,13,23,36
3919,ElliotBayTrailMyrtlePark,06/13/2014 07:00:00 AM,48,-122,29,60,89
3920,ElliotBayTrailMyrtlePark,06/13/2014 08:00:00 AM,48,-122,19,75,94
3921,ElliotBayTrailMyrtlePark,06/13/2014 09:00:00 AM,48,-122,21,32,53
3922,ElliotBayTrailMyrtlePark,06/13/2014 10:00:00 AM,48,-122,5,12,17
3923,ElliotBayTrailMyrtlePark,06/13/2014 11:00:00 AM,48,-122,6,8,14
3924,ElliotBayTrailMyrtlePark,06/13/2014 12:00:00 PM,48,-122,13,16,29
3925,ElliotBayTrailMyrtlePark,06/13/2014 01:00:00 PM,48,-122,20,12,32
3926,ElliotBayTrailMyrtlePark,06/13/2014 02:00:00 PM,48,-122,17,13,30
3927,ElliotBayTrailMyrtlePark,06/13/2014 03:00:00 PM,48,-122,24,24,48
3928,ElliotBayTrailMyrtlePark,06/13/2014 04:00:00 PM,48,-122,59,40,99
3929,ElliotBayTrailMyrtlePark,06/13/2014 05:00:00 PM,48,-122,105,24,129
3930,ElliotBayTrailMyrtlePark,06/13/2014 06:00:00 PM,48,-122,63,27,90
3931,ElliotBayTrailMyrtlePark,06/13/2014 07:00:00 PM,48,-122,24,11,35
3932,ElliotBayTrailMyrtlePark,06/13/2014 08:00:00 PM,48,-122,14,5,19
3933,ElliotBayTrailMyrtlePark,06/13/2014 09:00:00 PM,48,-122,4,1,5
3934,ElliotBayTrailMyrtlePark,06/13/2014 10:00:00 PM,48,-122,6,4,10
3935,ElliotBayTrailMyrtlePark,06/13/2014 11:00:00 PM,48,-122,4,4,8
3936,ElliotBayTrailMyrtlePark,06/14/2014 12:00:00 AM,48,-122,5,0,5
3937,ElliotBayTrailMyrtlePark,06/14/2014 01:00:00 AM,48,-122,2,1,3
3938,ElliotBayTrailMyrtlePark,06/14/2014 02:00:00 AM,48,-122,0,0,0
3939,ElliotBayTrailMyrtlePark,06/14/2014 03:00:00 AM,48,-122,0,0,0
3940,ElliotBayTrailMyrtlePark,06/14/2014 04:00:00 AM,48,-122,1,1,2
3941,ElliotBayTrailMyrtlePark,06/14/2014 05:00:00 AM,48,-122,0,8,8
3942,ElliotBayTrailMyrtlePark,06/14/2014 06:00:00 AM,48,-122,4,9,13
3943,ElliotBayTrailMyrtlePark,06/14/2014 07:00:00 AM,48,-122,8,9,17
3944,ElliotBayTrailMyrtlePark,06/14/2014 08:00:00 AM,48,-122,12,12,24
3945,ElliotBayTrailMyrtlePark,06/14/2014 09:00:00 AM,48,-122,32,22,54
3946,ElliotBayTrailMyrtlePark,06/14/2014 10:00:00 AM,48,-122,15,30,45
3947,ElliotBayTrailMyrtlePark,06/14/2014 11:00:00 AM,48,-122,38,38,76
3948,ElliotBayTrailMyrtlePark,06/14/2014 12:00:00 PM,48,-122,32,25,57
3949,ElliotBayTrailMyrtlePark,06/14/2014 01:00:00 PM,48,-122,54,41,95
3950,ElliotBayTrailMyrtlePark,06/14/2014 02:00:00 PM,48,-122,45,32,77
3951,ElliotBayTrailMyrtlePark,06/14/2014 03:00:00 PM,48,-122,40,61,101
3952,ElliotBayTrailMyrtlePark,06/14/2014 04:00:00 PM,48,-122,102,49,151
3953,ElliotBayTrailMyrtlePark,06/14/2014 05:00:00 PM,48,-122,40,46,86
3954,ElliotBayTrailMyrtlePark,06/14/2014 06:00:00 PM,48,-122,23,28,51
3955,ElliotBayTrailMyrtlePark,06/14/2014 07:00:00 PM,48,-122,28,18,46
3956,ElliotBayTrailMyrtlePark,06/14/2014 08:00:00 PM,48,-122,13,10,23
3957,ElliotBayTrailMyrtlePark,06/14/2014 09:00:00 PM,48,-122,3,1,4
3958,ElliotBayTrailMyrtlePark,06/14/2014 10:00:00 PM,48,-122,7,0,7
3959,ElliotBayTrailMyrtlePark,06/14/2014 11:00:00 PM,48,-122,0,0,0
3960,ElliotBayTrailMyrtlePark,06/15/2014 12:00:00 AM,48,-122,1,1,2
3961,ElliotBayTrailMyrtlePark,06/15/2014 01:00:00 AM,48,-122,3,0,3
3962,ElliotBayTrailMyrtlePark,06/15/2014 02:00:00 AM,48,-122,1,0,1
3963,ElliotBayTrailMyrtlePark,06/15/2014 03:00:00 AM,48,-122,1,0,1
3964,ElliotBayTrailMyrtlePark,06/15/2014 04:00:00 AM,48,-122,0,0,0
3965,ElliotBayTrailMyrtlePark,06/15/2014 05:00:00 AM,48,-122,0,3,3
3966,ElliotBayTrailMyrtlePark,06/15/2014 06:00:00 AM,48,-122,2,5,7
3967,ElliotBayTrailMyrtlePark,06/15/2014 07:00:00 AM,48,-122,7,3,10
3968,ElliotBayTrailMyrtlePark,06/15/2014 08:00:00 AM,48,-122,7,12,19
3969,ElliotBayTrailMyrtlePark,06/15/2014 09:00:00 AM,48,-122,18,22,40
3970,ElliotBayTrailMyrtlePark,06/15/2014 10:00:00 AM,48,-122,28,32,60
3971,ElliotBayTrailMyrtlePark,06/15/2014 11:00:00 AM,48,-122,33,38,71
3972,ElliotBayTrailMyrtlePark,06/15/2014 12:00:00 PM,48,-122,40,52,92
3973,ElliotBayTrailMyrtlePark,06/15/2014 01:00:00 PM,48,-122,25,18,43
3974,ElliotBayTrailMyrtlePark,06/15/2014 02:00:00 PM,48,-122,38,30,68
3975,ElliotBayTrailMyrtlePark,06/15/2014 03:00:00 PM,48,-122,46,33,79
3976,ElliotBayTrailMyrtlePark,06/15/2014 04:00:00 PM,48,-122,41,24,65
3977,ElliotBayTrailMyrtlePark,06/15/2014 05:00:00 PM,48,-122,24,21,45
3978,ElliotBayTrailMyrtlePark,06/15/2014 06:00:00 PM,48,-122,15,13,28
3979,ElliotBayTrailMyrtlePark,06/15/2014 07:00:00 PM,48,-122,11,2,13
3980,ElliotBayTrailMyrtlePark,06/15/2014 08:00:00 PM,48,-122,9,3,12
3981,ElliotBayTrailMyrtlePark,06/15/2014 09:00:00 PM,48,-122,2,2,4
3982,ElliotBayTrailMyrtlePark,06/15/2014 10:00:00 PM,48,-122,0,1,1
3983,ElliotBayTrailMyrtlePark,06/15/2014 11:00:00 PM,48,-122,1,0,1
3984,ElliotBayTrailMyrtlePark,06/16/2014 12:00:00 AM,48,-122,0,0,0
3985,ElliotBayTrailMyrtlePark,06/16/2014 01:00:00 AM,48,-122,2,0,2
3986,ElliotBayTrailMyrtlePark,06/16/2014 02:00:00 AM,48,-122,1,0,1
3987,ElliotBayTrailMyrtlePark,06/16/2014 03:00:00 AM,48,-122,0,0,0
3988,ElliotBayTrailMyrtlePark,06/16/2014 04:00:00 AM,48,-122,0,1,1
3989,ElliotBayTrailMyrtlePark,06/16/2014 05:00:00 AM,48,-122,10,15,25
3990,ElliotBayTrailMyrtlePark,06/16/2014 06:00:00 AM,48,-122,18,21,39
3991,ElliotBayTrailMyrtlePark,06/16/2014 07:00:00 AM,48,-122,41,72,113
3992,ElliotBayTrailMyrtlePark,06/16/2014 08:00:00 AM,48,-122,32,127,159
3993,ElliotBayTrailMyrtlePark,06/16/2014 09:00:00 AM,48,-122,21,45,66
3994,ElliotBayTrailMyrtlePark,06/16/2014 10:00:00 AM,48,-122,8,20,28
3995,ElliotBayTrailMyrtlePark,06/16/2014 11:00:00 AM,48,-122,7,10,17
3996,ElliotBayTrailMyrtlePark,06/16/2014 12:00:00 PM,48,-122,9,13,22
3997,ElliotBayTrailMyrtlePark,06/16/2014 01:00:00 PM,48,-122,11,26,37
3998,ElliotBayTrailMyrtlePark,06/16/2014 02:00:00 PM,48,-122,28,15,43
3999,ElliotBayTrailMyrtlePark,06/16/2014 03:00:00 PM,48,-122,30,39,69
4000,ElliotBayTrailMyrtlePark,06/16/2014 04:00:00 PM,48,-122,62,45,107
4001,ElliotBayTrailMyrtlePark,06/16/2014 05:00:00 PM,48,-122,150,59,209
4002,ElliotBayTrailMyrtlePark,06/16/2014 06:00:00 PM,48,-122,117,48,165
4003,ElliotBayTrailMyrtlePark,06/16/2014 07:00:00 PM,48,-122,61,41,102
4004,ElliotBayTrailMyrtlePark,06/16/2014 08:00:00 PM,48,-122,29,40,69
4005,ElliotBayTrailMyrtlePark,06/16/2014 09:00:00 PM,48,-122,13,17,30
4006,ElliotBayTrailMyrtlePark,06/16/2014 10:00:00 PM,48,-122,8,1,9
4007,ElliotBayTrailMyrtlePark,06/16/2014 11:00:00 PM,48,-122,8,2,10
4008,ElliotBayTrailMyrtlePark,06/17/2014 12:00:00 AM,48,-122,1,1,2
4009,ElliotBayTrailMyrtlePark,06/17/2014 01:00:00 AM,48,-122,1,0,1
4010,ElliotBayTrailMyrtlePark,06/17/2014 02:00:00 AM,48,-122,1,0,1
4011,ElliotBayTrailMyrtlePark,06/17/2014 03:00:00 AM,48,-122,0,0,0
4012,ElliotBayTrailMyrtlePark,06/17/2014 04:00:00 AM,48,-122,0,0,0
4013,ElliotBayTrailMyrtlePark,06/17/2014 05:00:00 AM,48,-122,13,15,28
4014,ElliotBayTrailMyrtlePark,06/17/2014 06:00:00 AM,48,-122,15,41,56
4015,ElliotBayTrailMyrtlePark,06/17/2014 07:00:00 AM,48,-122,52,118,170
4016,ElliotBayTrailMyrtlePark,06/17/2014 08:00:00 AM,48,-122,24,157,181
4017,ElliotBayTrailMyrtlePark,06/17/2014 09:00:00 AM,48,-122,24,145,169
4018,ElliotBayTrailMyrtlePark,06/17/2014 10:00:00 AM,48,-122,12,26,38
4019,ElliotBayTrailMyrtlePark,06/17/2014 11:00:00 AM,48,-122,18,23,41
4020,ElliotBayTrailMyrtlePark,06/17/2014 12:00:00 PM,48,-122,16,13,29
4021,ElliotBayTrailMyrtlePark,06/17/2014 01:00:00 PM,48,-122,21,31,52
4022,ElliotBayTrailMyrtlePark,06/17/2014 02:00:00 PM,48,-122,100,21,121
4023,ElliotBayTrailMyrtlePark,06/17/2014 03:00:00 PM,48,-122,51,34,85
4024,ElliotBayTrailMyrtlePark,06/17/2014 04:00:00 PM,48,-122,90,45,135
4025,ElliotBayTrailMyrtlePark,06/17/2014 05:00:00 PM,48,-122,197,70,267
4026,ElliotBayTrailMyrtlePark,06/17/2014 06:00:00 PM,48,-122,131,38,169
4027,ElliotBayTrailMyrtlePark,06/17/2014 07:00:00 PM,48,-122,75,63,138
4028,ElliotBayTrailMyrtlePark,06/17/2014 08:00:00 PM,48,-122,47,29,76
4029,ElliotBayTrailMyrtlePark,06/17/2014 09:00:00 PM,48,-122,10,16,26
4030,ElliotBayTrailMyrtlePark,06/17/2014 10:00:00 PM,48,-122,7,5,12
4031,ElliotBayTrailMyrtlePark,06/17/2014 11:00:00 PM,48,-122,2,0,2
4032,ElliotBayTrailMyrtlePark,06/18/2014 12:00:00 AM,48,-122,3,0,3
4033,ElliotBayTrailMyrtlePark,06/18/2014 01:00:00 AM,48,-122,3,0,3
4034,ElliotBayTrailMyrtlePark,06/18/2014 02:00:00 AM,48,-122,1,0,1
4035,ElliotBayTrailMyrtlePark,06/18/2014 03:00:00 AM,48,-122,0,0,0
4036,ElliotBayTrailMyrtlePark,06/18/2014 04:00:00 AM,48,-122,0,1,1
4037,ElliotBayTrailMyrtlePark,06/18/2014 05:00:00 AM,48,-122,16,29,45
4038,ElliotBayTrailMyrtlePark,06/18/2014 06:00:00 AM,48,-122,27,37,64
4039,ElliotBayTrailMyrtlePark,06/18/2014 07:00:00 AM,48,-122,61,125,186
4040,ElliotBayTrailMyrtlePark,06/18/2014 08:00:00 AM,48,-122,30,172,202
4041,ElliotBayTrailMyrtlePark,06/18/2014 09:00:00 AM,48,-122,27,84,111
4042,ElliotBayTrailMyrtlePark,06/18/2014 10:00:00 AM,48,-122,19,36,55
4043,ElliotBayTrailMyrtlePark,06/18/2014 11:00:00 AM,48,-122,24,20,44
4044,ElliotBayTrailMyrtlePark,06/18/2014 12:00:00 PM,48,-122,21,15,36
4045,ElliotBayTrailMyrtlePark,06/18/2014 01:00:00 PM,48,-122,21,24,45
4046,ElliotBayTrailMyrtlePark,06/18/2014 02:00:00 PM,48,-122,37,32,69
4047,ElliotBayTrailMyrtlePark,06/18/2014 03:00:00 PM,48,-122,39,33,72
4048,ElliotBayTrailMyrtlePark,06/18/2014 04:00:00 PM,48,-122,115,60,175
4049,ElliotBayTrailMyrtlePark,06/18/2014 05:00:00 PM,48,-122,224,77,301
4050,ElliotBayTrailMyrtlePark,06/18/2014 06:00:00 PM,48,-122,158,57,215
4051,ElliotBayTrailMyrtlePark,06/18/2014 07:00:00 PM,48,-122,93,46,139
4052,ElliotBayTrailMyrtlePark,06/18/2014 08:00:00 PM,48,-122,42,43,85
4053,ElliotBayTrailMyrtlePark,06/18/2014 09:00:00 PM,48,-122,7,8,15
4054,ElliotBayTrailMyrtlePark,06/18/2014 10:00:00 PM,48,-122,9,6,15
4055,ElliotBayTrailMyrtlePark,06/18/2014 11:00:00 PM,48,-122,2,0,2
4056,ElliotBayTrailMyrtlePark,06/19/2014 12:00:00 AM,48,-122,5,2,7
4057,ElliotBayTrailMyrtlePark,06/19/2014 01:00:00 AM,48,-122,3,0,3
4058,ElliotBayTrailMyrtlePark,06/19/2014 02:00:00 AM,48,-122,1,0,1
4059,ElliotBayTrailMyrtlePark,06/19/2014 03:00:00 AM,48,-122,0,0,0
4060,ElliotBayTrailMyrtlePark,06/19/2014 04:00:00 AM,48,-122,0,1,1
4061,ElliotBayTrailMyrtlePark,06/19/2014 05:00:00 AM,48,-122,16,21,37
4062,ElliotBayTrailMyrtlePark,06/19/2014 06:00:00 AM,48,-122,17,52,69
4063,ElliotBayTrailMyrtlePark,06/19/2014 07:00:00 AM,48,-122,46,110,156
4064,ElliotBayTrailMyrtlePark,06/19/2014 08:00:00 AM,48,-122,44,170,214
4065,ElliotBayTrailMyrtlePark,06/19/2014 09:00:00 AM,48,-122,28,82,110
4066,ElliotBayTrailMyrtlePark,06/19/2014 10:00:00 AM,48,-122,14,36,50
4067,ElliotBayTrailMyrtlePark,06/19/2014 11:00:00 AM,48,-122,24,21,45
4068,ElliotBayTrailMyrtlePark,06/19/2014 12:00:00 PM,48,-122,26,32,58
4069,ElliotBayTrailMyrtlePark,06/19/2014 01:00:00 PM,48,-122,25,41,66
4070,ElliotBayTrailMyrtlePark,06/19/2014 02:00:00 PM,48,-122,37,38,75
4071,ElliotBayTrailMyrtlePark,06/19/2014 03:00:00 PM,48,-122,72,50,122
4072,ElliotBayTrailMyrtlePark,06/19/2014 04:00:00 PM,48,-122,100,59,159
4073,ElliotBayTrailMyrtlePark,06/19/2014 05:00:00 PM,48,-122,248,86,334
4074,ElliotBayTrailMyrtlePark,06/19/2014 06:00:00 PM,48,-122,165,51,216
4075,ElliotBayTrailMyrtlePark,06/19/2014 07:00:00 PM,48,-122,70,46,116
4076,ElliotBayTrailMyrtlePark,06/19/2014 08:00:00 PM,48,-122,33,25,58
4077,ElliotBayTrailMyrtlePark,06/19/2014 09:00:00 PM,48,-122,6,1,7
4078,ElliotBayTrailMyrtlePark,06/19/2014 10:00:00 PM,48,-122,7,2,9
4079,ElliotBayTrailMyrtlePark,06/19/2014 11:00:00 PM,48,-122,4,1,5
4080,ElliotBayTrailMyrtlePark,06/20/2014 12:00:00 AM,48,-122,5,1,6
4081,ElliotBayTrailMyrtlePark,06/20/2014 01:00:00 AM,48,-122,0,0,0
4082,ElliotBayTrailMyrtlePark,06/20/2014 02:00:00 AM,48,-122,4,0,4
4083,ElliotBayTrailMyrtlePark,06/20/2014 03:00:00 AM,48,-122,0,0,0
4084,ElliotBayTrailMyrtlePark,06/20/2014 04:00:00 AM,48,-122,0,2,2
4085,ElliotBayTrailMyrtlePark,06/20/2014 05:00:00 AM,48,-122,12,19,31
4086,ElliotBayTrailMyrtlePark,06/20/2014 06:00:00 AM,48,-122,15,35,50
4087,ElliotBayTrailMyrtlePark,06/20/2014 07:00:00 AM,48,-122,46,105,151
4088,ElliotBayTrailMyrtlePark,06/20/2014 08:00:00 AM,48,-122,32,139,171
4089,ElliotBayTrailMyrtlePark,06/20/2014 09:00:00 AM,48,-122,19,61,80
4090,ElliotBayTrailMyrtlePark,06/20/2014 10:00:00 AM,48,-122,13,28,41
4091,ElliotBayTrailMyrtlePark,06/20/2014 11:00:00 AM,48,-122,15,29,44
4092,ElliotBayTrailMyrtlePark,06/20/2014 12:00:00 PM,48,-122,20,18,38
4093,ElliotBayTrailMyrtlePark,06/20/2014 01:00:00 PM,48,-122,29,31,60
4094,ElliotBayTrailMyrtlePark,06/20/2014 02:00:00 PM,48,-122,37,34,71
4095,ElliotBayTrailMyrtlePark,06/20/2014 03:00:00 PM,48,-122,70,52,122
4096,ElliotBayTrailMyrtlePark,06/20/2014 04:00:00 PM,48,-122,87,55,142
4097,ElliotBayTrailMyrtlePark,06/20/2014 05:00:00 PM,48,-122,164,53,217
4098,ElliotBayTrailMyrtlePark,06/20/2014 06:00:00 PM,48,-122,139,32,171
4099,ElliotBayTrailMyrtlePark,06/20/2014 07:00:00 PM,48,-122,51,32,83
4100,ElliotBayTrailMyrtlePark,06/20/2014 08:00:00 PM,48,-122,33,32,65
4101,ElliotBayTrailMyrtlePark,06/20/2014 09:00:00 PM,48,-122,13,17,30
4102,ElliotBayTrailMyrtlePark,06/20/2014 10:00:00 PM,48,-122,7,8,15
4103,ElliotBayTrailMyrtlePark,06/20/2014 11:00:00 PM,48,-122,9,7,16
4104,ElliotBayTrailMyrtlePark,06/21/2014 12:00:00 AM,48,-122,8,1,9
4105,ElliotBayTrailMyrtlePark,06/21/2014 01:00:00 AM,48,-122,5,0,5
4106,ElliotBayTrailMyrtlePark,06/21/2014 02:00:00 AM,48,-122,0,0,0
4107,ElliotBayTrailMyrtlePark,06/21/2014 03:00:00 AM,48,-122,1,0,1
4108,ElliotBayTrailMyrtlePark,06/21/2014 04:00:00 AM,48,-122,0,0,0
4109,ElliotBayTrailMyrtlePark,06/21/2014 05:00:00 AM,48,-122,2,5,7
4110,ElliotBayTrailMyrtlePark,06/21/2014 06:00:00 AM,48,-122,7,16,23
4111,ElliotBayTrailMyrtlePark,06/21/2014 07:00:00 AM,48,-122,16,38,54
4112,ElliotBayTrailMyrtlePark,06/21/2014 08:00:00 AM,48,-122,25,40,65
4113,ElliotBayTrailMyrtlePark,06/21/2014 09:00:00 AM,48,-122,50,44,94
4114,ElliotBayTrailMyrtlePark,06/21/2014 10:00:00 AM,48,-122,75,64,139
4115,ElliotBayTrailMyrtlePark,06/21/2014 11:00:00 AM,48,-122,115,64,179
4116,ElliotBayTrailMyrtlePark,06/21/2014 12:00:00 PM,48,-122,114,66,180
4117,ElliotBayTrailMyrtlePark,06/21/2014 01:00:00 PM,48,-122,96,46,142
4118,ElliotBayTrailMyrtlePark,06/21/2014 02:00:00 PM,48,-122,122,55,177
4119,ElliotBayTrailMyrtlePark,06/21/2014 03:00:00 PM,48,-122,88,61,149
4120,ElliotBayTrailMyrtlePark,06/21/2014 04:00:00 PM,48,-122,79,57,136
4121,ElliotBayTrailMyrtlePark,06/21/2014 05:00:00 PM,48,-122,68,64,132
4122,ElliotBayTrailMyrtlePark,06/21/2014 06:00:00 PM,48,-122,60,85,145
4123,ElliotBayTrailMyrtlePark,06/21/2014 07:00:00 PM,48,-122,43,65,108
4124,ElliotBayTrailMyrtlePark,06/21/2014 08:00:00 PM,48,-122,20,39,59
4125,ElliotBayTrailMyrtlePark,06/21/2014 09:00:00 PM,48,-122,8,9,17
4126,ElliotBayTrailMyrtlePark,06/21/2014 10:00:00 PM,48,-122,4,8,12
4127,ElliotBayTrailMyrtlePark,06/21/2014 11:00:00 PM,48,-122,5,6,11
4128,ElliotBayTrailMyrtlePark,06/22/2014 12:00:00 AM,48,-122,5,2,7
4129,ElliotBayTrailMyrtlePark,06/22/2014 01:00:00 AM,48,-122,0,2,2
4130,ElliotBayTrailMyrtlePark,06/22/2014 02:00:00 AM,48,-122,2,0,2
4131,ElliotBayTrailMyrtlePark,06/22/2014 03:00:00 AM,48,-122,0,0,0
4132,ElliotBayTrailMyrtlePark,06/22/2014 04:00:00 AM,48,-122,1,3,4
4133,ElliotBayTrailMyrtlePark,06/22/2014 05:00:00 AM,48,-122,3,1,4
4134,ElliotBayTrailMyrtlePark,06/22/2014 06:00:00 AM,48,-122,5,8,13
4135,ElliotBayTrailMyrtlePark,06/22/2014 07:00:00 AM,48,-122,7,11,18
4136,ElliotBayTrailMyrtlePark,06/22/2014 08:00:00 AM,48,-122,28,37,65
4137,ElliotBayTrailMyrtlePark,06/22/2014 09:00:00 AM,48,-122,51,54,105
4138,ElliotBayTrailMyrtlePark,06/22/2014 10:00:00 AM,48,-122,49,38,87
4139,ElliotBayTrailMyrtlePark,06/22/2014 11:00:00 AM,48,-122,59,42,101
4140,ElliotBayTrailMyrtlePark,06/22/2014 12:00:00 PM,48,-122,109,92,201
4141,ElliotBayTrailMyrtlePark,06/22/2014 01:00:00 PM,48,-122,96,73,169
4142,ElliotBayTrailMyrtlePark,06/22/2014 02:00:00 PM,48,-122,101,69,170
4143,ElliotBayTrailMyrtlePark,06/22/2014 03:00:00 PM,48,-122,59,56,115
4144,ElliotBayTrailMyrtlePark,06/22/2014 04:00:00 PM,48,-122,69,53,122
4145,ElliotBayTrailMyrtlePark,06/22/2014 05:00:00 PM,48,-122,87,58,145
4146,ElliotBayTrailMyrtlePark,06/22/2014 06:00:00 PM,48,-122,74,73,147
4147,ElliotBayTrailMyrtlePark,06/22/2014 07:00:00 PM,48,-122,59,31,90
4148,ElliotBayTrailMyrtlePark,06/22/2014 08:00:00 PM,48,-122,29,30,59
4149,ElliotBayTrailMyrtlePark,06/22/2014 09:00:00 PM,48,-122,15,9,24
4150,ElliotBayTrailMyrtlePark,06/22/2014 10:00:00 PM,48,-122,4,12,16
4151,ElliotBayTrailMyrtlePark,06/22/2014 11:00:00 PM,48,-122,5,3,8
4152,ElliotBayTrailMyrtlePark,06/23/2014 12:00:00 AM,48,-122,1,2,3
4153,ElliotBayTrailMyrtlePark,06/23/2014 01:00:00 AM,48,-122,2,0,2
4154,ElliotBayTrailMyrtlePark,06/23/2014 02:00:00 AM,48,-122,0,0,0
4155,ElliotBayTrailMyrtlePark,06/23/2014 03:00:00 AM,48,-122,1,0,1
4156,ElliotBayTrailMyrtlePark,06/23/2014 04:00:00 AM,48,-122,0,2,2
4157,ElliotBayTrailMyrtlePark,06/23/2014 05:00:00 AM,48,-122,9,23,32
4158,ElliotBayTrailMyrtlePark,06/23/2014 06:00:00 AM,48,-122,29,48,77
4159,ElliotBayTrailMyrtlePark,06/23/2014 07:00:00 AM,48,-122,54,144,198
4160,ElliotBayTrailMyrtlePark,06/23/2014 08:00:00 AM,48,-122,89,134,223
4161,ElliotBayTrailMyrtlePark,06/23/2014 09:00:00 AM,48,-122,38,57,95
4162,ElliotBayTrailMyrtlePark,06/23/2014 10:00:00 AM,48,-122,27,40,67
4163,ElliotBayTrailMyrtlePark,06/23/2014 11:00:00 AM,48,-122,29,30,59
4164,ElliotBayTrailMyrtlePark,06/23/2014 12:00:00 PM,48,-122,52,35,87
4165,ElliotBayTrailMyrtlePark,06/23/2014 01:00:00 PM,48,-122,24,46,70
4166,ElliotBayTrailMyrtlePark,06/23/2014 02:00:00 PM,48,-122,42,47,89
4167,ElliotBayTrailMyrtlePark,06/23/2014 03:00:00 PM,48,-122,57,33,90
4168,ElliotBayTrailMyrtlePark,06/23/2014 04:00:00 PM,48,-122,103,60,163
4169,ElliotBayTrailMyrtlePark,06/23/2014 05:00:00 PM,48,-122,233,71,304
4170,ElliotBayTrailMyrtlePark,06/23/2014 06:00:00 PM,48,-122,178,54,232
4171,ElliotBayTrailMyrtlePark,06/23/2014 07:00:00 PM,48,-122,52,42,94
4172,ElliotBayTrailMyrtlePark,06/23/2014 08:00:00 PM,48,-122,22,18,40
4173,ElliotBayTrailMyrtlePark,06/23/2014 09:00:00 PM,48,-122,10,5,15
4174,ElliotBayTrailMyrtlePark,06/23/2014 10:00:00 PM,48,-122,12,3,15
4175,ElliotBayTrailMyrtlePark,06/23/2014 11:00:00 PM,48,-122,6,2,8
4176,ElliotBayTrailMyrtlePark,06/24/2014 12:00:00 AM,48,-122,2,0,2
4177,ElliotBayTrailMyrtlePark,06/24/2014 01:00:00 AM,48,-122,1,0,1
4178,ElliotBayTrailMyrtlePark,06/24/2014 02:00:00 AM,48,-122,4,0,4
4179,ElliotBayTrailMyrtlePark,06/24/2014 03:00:00 AM,48,-122,0,0,0
4180,ElliotBayTrailMyrtlePark,06/24/2014 04:00:00 AM,48,-122,0,1,1
4181,ElliotBayTrailMyrtlePark,06/24/2014 05:00:00 AM,48,-122,14,23,37
4182,ElliotBayTrailMyrtlePark,06/24/2014 06:00:00 AM,48,-122,22,42,64
4183,ElliotBayTrailMyrtlePark,06/24/2014 07:00:00 AM,48,-122,54,115,169
4184,ElliotBayTrailMyrtlePark,06/24/2014 08:00:00 AM,48,-122,40,156,196
4185,ElliotBayTrailMyrtlePark,06/24/2014 09:00:00 AM,48,-122,21,70,91
4186,ElliotBayTrailMyrtlePark,06/24/2014 10:00:00 AM,48,-122,18,31,49
4187,ElliotBayTrailMyrtlePark,06/24/2014 11:00:00 AM,48,-122,14,23,37
4188,ElliotBayTrailMyrtlePark,06/24/2014 12:00:00 PM,48,-122,30,24,54
4189,ElliotBayTrailMyrtlePark,06/24/2014 01:00:00 PM,48,-122,23,19,42
4190,ElliotBayTrailMyrtlePark,06/24/2014 02:00:00 PM,48,-122,53,31,84
4191,ElliotBayTrailMyrtlePark,06/24/2014 03:00:00 PM,48,-122,36,49,85
4192,ElliotBayTrailMyrtlePark,06/24/2014 04:00:00 PM,48,-122,124,67,191
4193,ElliotBayTrailMyrtlePark,06/24/2014 05:00:00 PM,48,-122,210,78,288
4194,ElliotBayTrailMyrtlePark,06/24/2014 06:00:00 PM,48,-122,191,89,280
4195,ElliotBayTrailMyrtlePark,06/24/2014 07:00:00 PM,48,-122,79,50,129
4196,ElliotBayTrailMyrtlePark,06/24/2014 08:00:00 PM,48,-122,50,35,85
4197,ElliotBayTrailMyrtlePark,06/24/2014 09:00:00 PM,48,-122,13,7,20
4198,ElliotBayTrailMyrtlePark,06/24/2014 10:00:00 PM,48,-122,21,3,24
4199,ElliotBayTrailMyrtlePark,06/24/2014 11:00:00 PM,48,-122,4,2,6
4200,ElliotBayTrailMyrtlePark,06/25/2014 12:00:00 AM,48,-122,2,2,4
4201,ElliotBayTrailMyrtlePark,06/25/2014 01:00:00 AM,48,-122,2,2,4
4202,ElliotBayTrailMyrtlePark,06/25/2014 02:00:00 AM,48,-122,1,0,1
4203,ElliotBayTrailMyrtlePark,06/25/2014 03:00:00 AM,48,-122,1,0,1
4204,ElliotBayTrailMyrtlePark,06/25/2014 04:00:00 AM,48,-122,0,1,1
4205,ElliotBayTrailMyrtlePark,06/25/2014 05:00:00 AM,48,-122,14,28,42
4206,ElliotBayTrailMyrtlePark,06/25/2014 06:00:00 AM,48,-122,29,59,88
4207,ElliotBayTrailMyrtlePark,06/25/2014 07:00:00 AM,48,-122,52,130,182
4208,ElliotBayTrailMyrtlePark,06/25/2014 08:00:00 AM,48,-122,50,168,218
4209,ElliotBayTrailMyrtlePark,06/25/2014 09:00:00 AM,48,-122,19,77,96
4210,ElliotBayTrailMyrtlePark,06/25/2014 10:00:00 AM,48,-122,23,37,60
4211,ElliotBayTrailMyrtlePark,06/25/2014 11:00:00 AM,48,-122,15,24,39
4212,ElliotBayTrailMyrtlePark,06/25/2014 12:00:00 PM,48,-122,38,32,70
4213,ElliotBayTrailMyrtlePark,06/25/2014 01:00:00 PM,48,-122,25,31,56
4214,ElliotBayTrailMyrtlePark,06/25/2014 02:00:00 PM,48,-122,47,39,86
4215,ElliotBayTrailMyrtlePark,06/25/2014 03:00:00 PM,48,-122,62,32,94
4216,ElliotBayTrailMyrtlePark,06/25/2014 04:00:00 PM,48,-122,101,69,170
4217,ElliotBayTrailMyrtlePark,06/25/2014 05:00:00 PM,48,-122,226,88,314
4218,ElliotBayTrailMyrtlePark,06/25/2014 06:00:00 PM,48,-122,158,58,216
4219,ElliotBayTrailMyrtlePark,06/25/2014 07:00:00 PM,48,-122,56,54,110
4220,ElliotBayTrailMyrtlePark,06/25/2014 08:00:00 PM,48,-122,49,32,81
4221,ElliotBayTrailMyrtlePark,06/25/2014 09:00:00 PM,48,-122,15,10,25
4222,ElliotBayTrailMyrtlePark,06/25/2014 10:00:00 PM,48,-122,17,8,25
4223,ElliotBayTrailMyrtlePark,06/25/2014 11:00:00 PM,48,-122,15,2,17
4224,ElliotBayTrailMyrtlePark,06/26/2014 12:00:00 AM,48,-122,3,0,3
4225,ElliotBayTrailMyrtlePark,06/26/2014 01:00:00 AM,48,-122,1,0,1
4226,ElliotBayTrailMyrtlePark,06/26/2014 02:00:00 AM,48,-122,4,0,4
4227,ElliotBayTrailMyrtlePark,06/26/2014 03:00:00 AM,48,-122,0,1,1
4228,ElliotBayTrailMyrtlePark,06/26/2014 04:00:00 AM,48,-122,0,0,0
4229,ElliotBayTrailMyrtlePark,06/26/2014 05:00:00 AM,48,-122,11,19,30
4230,ElliotBayTrailMyrtlePark,06/26/2014 06:00:00 AM,48,-122,17,51,68
4231,ElliotBayTrailMyrtlePark,06/26/2014 07:00:00 AM,48,-122,50,119,169
4232,ElliotBayTrailMyrtlePark,06/26/2014 08:00:00 AM,48,-122,42,141,183
4233,ElliotBayTrailMyrtlePark,06/26/2014 09:00:00 AM,48,-122,30,72,102
4234,ElliotBayTrailMyrtlePark,06/26/2014 10:00:00 AM,48,-122,13,21,34
4235,ElliotBayTrailMyrtlePark,06/26/2014 11:00:00 AM,48,-122,31,36,67
4236,ElliotBayTrailMyrtlePark,06/26/2014 12:00:00 PM,48,-122,19,14,33
4237,ElliotBayTrailMyrtlePark,06/26/2014 01:00:00 PM,48,-122,23,25,48
4238,ElliotBayTrailMyrtlePark,06/26/2014 02:00:00 PM,48,-122,31,30,61
4239,ElliotBayTrailMyrtlePark,06/26/2014 03:00:00 PM,48,-122,42,35,77
4240,ElliotBayTrailMyrtlePark,06/26/2014 04:00:00 PM,48,-122,93,64,157
4241,ElliotBayTrailMyrtlePark,06/26/2014 05:00:00 PM,48,-122,180,53,233
4242,ElliotBayTrailMyrtlePark,06/26/2014 06:00:00 PM,48,-122,129,49,178
4243,ElliotBayTrailMyrtlePark,06/26/2014 07:00:00 PM,48,-122,41,23,64
4244,ElliotBayTrailMyrtlePark,06/26/2014 08:00:00 PM,48,-122,38,10,48
4245,ElliotBayTrailMyrtlePark,06/26/2014 09:00:00 PM,48,-122,10,4,14
4246,ElliotBayTrailMyrtlePark,06/26/2014 10:00:00 PM,48,-122,3,3,6
4247,ElliotBayTrailMyrtlePark,06/26/2014 11:00:00 PM,48,-122,2,0,2
4248,ElliotBayTrailMyrtlePark,06/27/2014 12:00:00 AM,48,-122,3,2,5
4249,ElliotBayTrailMyrtlePark,06/27/2014 01:00:00 AM,48,-122,1,1,2
4250,ElliotBayTrailMyrtlePark,06/27/2014 02:00:00 AM,48,-122,1,0,1
4251,ElliotBayTrailMyrtlePark,06/27/2014 03:00:00 AM,48,-122,1,1,2
4252,ElliotBayTrailMyrtlePark,06/27/2014 04:00:00 AM,48,-122,2,1,3
4253,ElliotBayTrailMyrtlePark,06/27/2014 05:00:00 AM,48,-122,7,22,29
4254,ElliotBayTrailMyrtlePark,06/27/2014 06:00:00 AM,48,-122,14,21,35
4255,ElliotBayTrailMyrtlePark,06/27/2014 07:00:00 AM,48,-122,35,95,130
4256,ElliotBayTrailMyrtlePark,06/27/2014 08:00:00 AM,48,-122,29,104,133
4257,ElliotBayTrailMyrtlePark,06/27/2014 09:00:00 AM,48,-122,13,57,70
4258,ElliotBayTrailMyrtlePark,06/27/2014 10:00:00 AM,48,-122,17,21,38
4259,ElliotBayTrailMyrtlePark,06/27/2014 11:00:00 AM,48,-122,15,15,30
4260,ElliotBayTrailMyrtlePark,06/27/2014 12:00:00 PM,48,-122,16,11,27
4261,ElliotBayTrailMyrtlePark,06/27/2014 01:00:00 PM,48,-122,23,16,39
4262,ElliotBayTrailMyrtlePark,06/27/2014 02:00:00 PM,48,-122,25,29,54
4263,ElliotBayTrailMyrtlePark,06/27/2014 03:00:00 PM,48,-122,43,32,75
4264,ElliotBayTrailMyrtlePark,06/27/2014 04:00:00 PM,48,-122,77,49,126
4265,ElliotBayTrailMyrtlePark,06/27/2014 05:00:00 PM,48,-122,134,40,174
4266,ElliotBayTrailMyrtlePark,06/27/2014 06:00:00 PM,48,-122,89,24,113
4267,ElliotBayTrailMyrtlePark,06/27/2014 07:00:00 PM,48,-122,25,22,47
4268,ElliotBayTrailMyrtlePark,06/27/2014 08:00:00 PM,48,-122,19,15,34
4269,ElliotBayTrailMyrtlePark,06/27/2014 09:00:00 PM,48,-122,11,2,13
4270,ElliotBayTrailMyrtlePark,06/27/2014 10:00:00 PM,48,-122,8,5,13
4271,ElliotBayTrailMyrtlePark,06/27/2014 11:00:00 PM,48,-122,7,1,8
4272,ElliotBayTrailMyrtlePark,06/28/2014 12:00:00 AM,48,-122,2,2,4
4273,ElliotBayTrailMyrtlePark,06/28/2014 01:00:00 AM,48,-122,2,2,4
4274,ElliotBayTrailMyrtlePark,06/28/2014 02:00:00 AM,48,-122,1,0,1
4275,ElliotBayTrailMyrtlePark,06/28/2014 03:00:00 AM,48,-122,2,0,2
4276,ElliotBayTrailMyrtlePark,06/28/2014 04:00:00 AM,48,-122,0,0,0
4277,ElliotBayTrailMyrtlePark,06/28/2014 05:00:00 AM,48,-122,2,1,3
4278,ElliotBayTrailMyrtlePark,06/28/2014 06:00:00 AM,48,-122,6,11,17
4279,ElliotBayTrailMyrtlePark,06/28/2014 07:00:00 AM,48,-122,13,12,25
4280,ElliotBayTrailMyrtlePark,06/28/2014 08:00:00 AM,48,-122,23,24,47
4281,ElliotBayTrailMyrtlePark,06/28/2014 09:00:00 AM,48,-122,28,28,56
4282,ElliotBayTrailMyrtlePark,06/28/2014 10:00:00 AM,48,-122,25,25,50
4283,ElliotBayTrailMyrtlePark,06/28/2014 11:00:00 AM,48,-122,40,34,74
4284,ElliotBayTrailMyrtlePark,06/28/2014 12:00:00 PM,48,-122,45,33,78
4285,ElliotBayTrailMyrtlePark,06/28/2014 01:00:00 PM,48,-122,40,49,89
4286,ElliotBayTrailMyrtlePark,06/28/2014 02:00:00 PM,48,-122,31,22,53
4287,ElliotBayTrailMyrtlePark,06/28/2014 03:00:00 PM,48,-122,46,50,96
4288,ElliotBayTrailMyrtlePark,06/28/2014 04:00:00 PM,48,-122,46,31,77
4289,ElliotBayTrailMyrtlePark,06/28/2014 05:00:00 PM,48,-122,29,32,61
4290,ElliotBayTrailMyrtlePark,06/28/2014 06:00:00 PM,48,-122,34,34,68
4291,ElliotBayTrailMyrtlePark,06/28/2014 07:00:00 PM,48,-122,27,26,53
4292,ElliotBayTrailMyrtlePark,06/28/2014 08:00:00 PM,48,-122,14,14,28
4293,ElliotBayTrailMyrtlePark,06/28/2014 09:00:00 PM,48,-122,5,9,14
4294,ElliotBayTrailMyrtlePark,06/28/2014 10:00:00 PM,48,-122,13,2,15
4295,ElliotBayTrailMyrtlePark,06/28/2014 11:00:00 PM,48,-122,7,1,8
4296,ElliotBayTrailMyrtlePark,06/29/2014 12:00:00 AM,48,-122,2,2,4
4297,ElliotBayTrailMyrtlePark,06/29/2014 01:00:00 AM,48,-122,0,0,0
4298,ElliotBayTrailMyrtlePark,06/29/2014 02:00:00 AM,48,-122,0,0,0
4299,ElliotBayTrailMyrtlePark,06/29/2014 03:00:00 AM,48,-122,3,0,3
4300,ElliotBayTrailMyrtlePark,06/29/2014 04:00:00 AM,48,-122,0,1,1
4301,ElliotBayTrailMyrtlePark,06/29/2014 05:00:00 AM,48,-122,3,10,13
4302,ElliotBayTrailMyrtlePark,06/29/2014 06:00:00 AM,48,-122,12,7,19
4303,ElliotBayTrailMyrtlePark,06/29/2014 07:00:00 AM,48,-122,8,20,28
4304,ElliotBayTrailMyrtlePark,06/29/2014 08:00:00 AM,48,-122,10,11,21
4305,ElliotBayTrailMyrtlePark,06/29/2014 09:00:00 AM,48,-122,26,36,62
4306,ElliotBayTrailMyrtlePark,06/29/2014 10:00:00 AM,48,-122,36,50,86
4307,ElliotBayTrailMyrtlePark,06/29/2014 11:00:00 AM,48,-122,44,54,98
4308,ElliotBayTrailMyrtlePark,06/29/2014 12:00:00 PM,48,-122,52,59,111
4309,ElliotBayTrailMyrtlePark,06/29/2014 01:00:00 PM,48,-122,49,50,99
4310,ElliotBayTrailMyrtlePark,06/29/2014 02:00:00 PM,48,-122,88,66,154
4311,ElliotBayTrailMyrtlePark,06/29/2014 03:00:00 PM,48,-122,89,68,157
4312,ElliotBayTrailMyrtlePark,06/29/2014 04:00:00 PM,48,-122,83,42,125
4313,ElliotBayTrailMyrtlePark,06/29/2014 05:00:00 PM,48,-122,40,36,76
4314,ElliotBayTrailMyrtlePark,06/29/2014 06:00:00 PM,48,-122,33,35,68
4315,ElliotBayTrailMyrtlePark,06/29/2014 07:00:00 PM,48,-122,35,27,62
4316,ElliotBayTrailMyrtlePark,06/29/2014 08:00:00 PM,48,-122,32,19,51
4317,ElliotBayTrailMyrtlePark,06/29/2014 09:00:00 PM,48,-122,20,13,33
4318,ElliotBayTrailMyrtlePark,06/29/2014 10:00:00 PM,48,-122,4,6,10
4319,ElliotBayTrailMyrtlePark,06/29/2014 11:00:00 PM,48,-122,3,0,3
4320,ElliotBayTrailMyrtlePark,06/30/2014 12:00:00 AM,48,-122,5,0,5
4321,ElliotBayTrailMyrtlePark,06/30/2014 01:00:00 AM,48,-122,0,1,1
4322,ElliotBayTrailMyrtlePark,06/30/2014 02:00:00 AM,48,-122,1,0,1
4323,ElliotBayTrailMyrtlePark,06/30/2014 03:00:00 AM,48,-122,1,0,1
4324,ElliotBayTrailMyrtlePark,06/30/2014 04:00:00 AM,48,-122,0,2,2
4325,ElliotBayTrailMyrtlePark,06/30/2014 05:00:00 AM,48,-122,7,17,24
4326,ElliotBayTrailMyrtlePark,06/30/2014 06:00:00 AM,48,-122,29,45,74
4327,ElliotBayTrailMyrtlePark,06/30/2014 07:00:00 AM,48,-122,53,134,187
4328,ElliotBayTrailMyrtlePark,06/30/2014 08:00:00 AM,48,-122,66,168,234
4329,ElliotBayTrailMyrtlePark,06/30/2014 09:00:00 AM,48,-122,47,69,116
4330,ElliotBayTrailMyrtlePark,06/30/2014 10:00:00 AM,48,-122,16,39,55
4331,ElliotBayTrailMyrtlePark,06/30/2014 11:00:00 AM,48,-122,37,31,68
4332,ElliotBayTrailMyrtlePark,06/30/2014 12:00:00 PM,48,-122,33,26,59
4333,ElliotBayTrailMyrtlePark,06/30/2014 01:00:00 PM,48,-122,39,44,83
4334,ElliotBayTrailMyrtlePark,06/30/2014 02:00:00 PM,48,-122,28,54,82
4335,ElliotBayTrailMyrtlePark,06/30/2014 03:00:00 PM,48,-122,56,42,98
4336,ElliotBayTrailMyrtlePark,06/30/2014 04:00:00 PM,48,-122,125,63,188
4337,ElliotBayTrailMyrtlePark,06/30/2014 05:00:00 PM,48,-122,242,79,321
4338,ElliotBayTrailMyrtlePark,06/30/2014 06:00:00 PM,48,-122,200,78,278
4339,ElliotBayTrailMyrtlePark,06/30/2014 07:00:00 PM,48,-122,98,61,159
4340,ElliotBayTrailMyrtlePark,06/30/2014 08:00:00 PM,48,-122,66,44,110
4341,ElliotBayTrailMyrtlePark,06/30/2014 09:00:00 PM,48,-122,14,13,27
4342,ElliotBayTrailMyrtlePark,06/30/2014 10:00:00 PM,48,-122,11,13,24
4343,ElliotBayTrailMyrtlePark,06/30/2014 11:00:00 PM,48,-122,10,5,15
4344,ElliotBayTrailMyrtlePark,07/01/2014 12:00:00 AM,48,-122,6,3,9
4345,ElliotBayTrailMyrtlePark,07/01/2014 01:00:00 AM,48,-122,1,0,1
4346,ElliotBayTrailMyrtlePark,07/01/2014 02:00:00 AM,48,-122,5,0,5
4347,ElliotBayTrailMyrtlePark,07/01/2014 03:00:00 AM,48,-122,0,0,0
4348,ElliotBayTrailMyrtlePark,07/01/2014 04:00:00 AM,48,-122,0,0,0
4349,ElliotBayTrailMyrtlePark,07/01/2014 05:00:00 AM,48,-122,12,24,36
4350,ElliotBayTrailMyrtlePark,07/01/2014 06:00:00 AM,48,-122,34,79,113
4351,ElliotBayTrailMyrtlePark,07/01/2014 07:00:00 AM,48,-122,54,170,224
4352,ElliotBayTrailMyrtlePark,07/01/2014 08:00:00 AM,48,-122,112,115,227
4353,ElliotBayTrailMyrtlePark,07/01/2014 09:00:00 AM,48,-122,48,62,110
4354,ElliotBayTrailMyrtlePark,07/01/2014 10:00:00 AM,48,-122,23,45,68
4355,ElliotBayTrailMyrtlePark,07/01/2014 11:00:00 AM,48,-122,43,38,81
4356,ElliotBayTrailMyrtlePark,07/01/2014 12:00:00 PM,48,-122,26,24,50
4357,ElliotBayTrailMyrtlePark,07/01/2014 01:00:00 PM,48,-122,27,34,61
4358,ElliotBayTrailMyrtlePark,07/01/2014 02:00:00 PM,48,-122,35,27,62
4359,ElliotBayTrailMyrtlePark,07/01/2014 03:00:00 PM,48,-122,64,40,104
4360,ElliotBayTrailMyrtlePark,07/01/2014 04:00:00 PM,48,-122,165,78,243
4361,ElliotBayTrailMyrtlePark,07/01/2014 05:00:00 PM,48,-122,287,65,352
4362,ElliotBayTrailMyrtlePark,07/01/2014 06:00:00 PM,48,-122,197,67,264
4363,ElliotBayTrailMyrtlePark,07/01/2014 07:00:00 PM,48,-122,96,63,159
4364,ElliotBayTrailMyrtlePark,07/01/2014 08:00:00 PM,48,-122,54,44,98
4365,ElliotBayTrailMyrtlePark,07/01/2014 09:00:00 PM,48,-122,20,15,35
4366,ElliotBayTrailMyrtlePark,07/01/2014 10:00:00 PM,48,-122,10,7,17
4367,ElliotBayTrailMyrtlePark,07/01/2014 11:00:00 PM,48,-122,8,1,9
4368,ElliotBayTrailMyrtlePark,07/02/2014 12:00:00 AM,48,-122,10,0,10
4369,ElliotBayTrailMyrtlePark,07/02/2014 01:00:00 AM,48,-122,2,1,3
4370,ElliotBayTrailMyrtlePark,07/02/2014 02:00:00 AM,48,-122,2,0,2
4371,ElliotBayTrailMyrtlePark,07/02/2014 03:00:00 AM,48,-122,0,0,0
4372,ElliotBayTrailMyrtlePark,07/02/2014 04:00:00 AM,48,-122,0,0,0
4373,ElliotBayTrailMyrtlePark,07/02/2014 05:00:00 AM,48,-122,14,27,41
4374,ElliotBayTrailMyrtlePark,07/02/2014 06:00:00 AM,48,-122,16,48,64
4375,ElliotBayTrailMyrtlePark,07/02/2014 07:00:00 AM,48,-122,49,140,189
4376,ElliotBayTrailMyrtlePark,07/02/2014 08:00:00 AM,48,-122,37,148,185
4377,ElliotBayTrailMyrtlePark,07/02/2014 09:00:00 AM,48,-122,28,97,125
4378,ElliotBayTrailMyrtlePark,07/02/2014 10:00:00 AM,48,-122,20,30,50
4379,ElliotBayTrailMyrtlePark,07/02/2014 11:00:00 AM,48,-122,19,28,47
4380,ElliotBayTrailMyrtlePark,07/02/2014 12:00:00 PM,48,-122,27,27,54
4381,ElliotBayTrailMyrtlePark,07/02/2014 01:00:00 PM,48,-122,39,31,70
4382,ElliotBayTrailMyrtlePark,07/02/2014 02:00:00 PM,48,-122,31,26,57
4383,ElliotBayTrailMyrtlePark,07/02/2014 03:00:00 PM,48,-122,75,58,133
4384,ElliotBayTrailMyrtlePark,07/02/2014 04:00:00 PM,48,-122,125,60,185
4385,ElliotBayTrailMyrtlePark,07/02/2014 05:00:00 PM,48,-122,251,92,343
4386,ElliotBayTrailMyrtlePark,07/02/2014 06:00:00 PM,48,-122,172,61,233
4387,ElliotBayTrailMyrtlePark,07/02/2014 07:00:00 PM,48,-122,80,43,123
4388,ElliotBayTrailMyrtlePark,07/02/2014 08:00:00 PM,48,-122,55,40,95
4389,ElliotBayTrailMyrtlePark,07/02/2014 09:00:00 PM,48,-122,16,12,28
4390,ElliotBayTrailMyrtlePark,07/02/2014 10:00:00 PM,48,-122,8,6,14
4391,ElliotBayTrailMyrtlePark,07/02/2014 11:00:00 PM,48,-122,4,2,6
4392,ElliotBayTrailMyrtlePark,07/03/2014 12:00:00 AM,48,-122,1,5,6
4393,ElliotBayTrailMyrtlePark,07/03/2014 01:00:00 AM,48,-122,0,0,0
4394,ElliotBayTrailMyrtlePark,07/03/2014 02:00:00 AM,48,-122,3,0,3
4395,ElliotBayTrailMyrtlePark,07/03/2014 03:00:00 AM,48,-122,0,0,0
4396,ElliotBayTrailMyrtlePark,07/03/2014 04:00:00 AM,48,-122,2,0,2
4397,ElliotBayTrailMyrtlePark,07/03/2014 05:00:00 AM,48,-122,14,17,31
4398,ElliotBayTrailMyrtlePark,07/03/2014 06:00:00 AM,48,-122,20,50,70
4399,ElliotBayTrailMyrtlePark,07/03/2014 07:00:00 AM,48,-122,38,115,153
4400,ElliotBayTrailMyrtlePark,07/03/2014 08:00:00 AM,48,-122,39,114,153
4401,ElliotBayTrailMyrtlePark,07/03/2014 09:00:00 AM,48,-122,20,63,83
4402,ElliotBayTrailMyrtlePark,07/03/2014 10:00:00 AM,48,-122,16,29,45
4403,ElliotBayTrailMyrtlePark,07/03/2014 11:00:00 AM,48,-122,18,29,47
4404,ElliotBayTrailMyrtlePark,07/03/2014 12:00:00 PM,48,-122,24,28,52
4405,ElliotBayTrailMyrtlePark,07/03/2014 01:00:00 PM,48,-122,40,28,68
4406,ElliotBayTrailMyrtlePark,07/03/2014 02:00:00 PM,48,-122,71,42,113
4407,ElliotBayTrailMyrtlePark,07/03/2014 03:00:00 PM,48,-122,92,37,129
4408,ElliotBayTrailMyrtlePark,07/03/2014 04:00:00 PM,48,-122,124,67,191
4409,ElliotBayTrailMyrtlePark,07/03/2014 05:00:00 PM,48,-122,144,50,194
4410,ElliotBayTrailMyrtlePark,07/03/2014 06:00:00 PM,48,-122,81,42,123
4411,ElliotBayTrailMyrtlePark,07/03/2014 07:00:00 PM,48,-122,68,39,107
4412,ElliotBayTrailMyrtlePark,07/03/2014 08:00:00 PM,48,-122,22,28,50
4413,ElliotBayTrailMyrtlePark,07/03/2014 09:00:00 PM,48,-122,15,5,20
4414,ElliotBayTrailMyrtlePark,07/03/2014 10:00:00 PM,48,-122,15,4,19
4415,ElliotBayTrailMyrtlePark,07/03/2014 11:00:00 PM,48,-122,4,7,11
4416,ElliotBayTrailMyrtlePark,07/04/2014 12:00:00 AM,48,-122,4,1,5
4417,ElliotBayTrailMyrtlePark,07/04/2014 01:00:00 AM,48,-122,1,0,1
4418,ElliotBayTrailMyrtlePark,07/04/2014 02:00:00 AM,48,-122,1,0,1
4419,ElliotBayTrailMyrtlePark,07/04/2014 03:00:00 AM,48,-122,1,1,2
4420,ElliotBayTrailMyrtlePark,07/04/2014 04:00:00 AM,48,-122,1,0,1
4421,ElliotBayTrailMyrtlePark,07/04/2014 05:00:00 AM,48,-122,3,4,7
4422,ElliotBayTrailMyrtlePark,07/04/2014 06:00:00 AM,48,-122,15,7,22
4423,ElliotBayTrailMyrtlePark,07/04/2014 07:00:00 AM,48,-122,16,19,35
4424,ElliotBayTrailMyrtlePark,07/04/2014 08:00:00 AM,48,-122,18,31,49
4425,ElliotBayTrailMyrtlePark,07/04/2014 09:00:00 AM,48,-122,32,45,77
4426,ElliotBayTrailMyrtlePark,07/04/2014 10:00:00 AM,48,-122,60,86,146
4427,ElliotBayTrailMyrtlePark,07/04/2014 11:00:00 AM,48,-122,48,62,110
4428,ElliotBayTrailMyrtlePark,07/04/2014 12:00:00 PM,48,-122,90,68,158
4429,ElliotBayTrailMyrtlePark,07/04/2014 01:00:00 PM,48,-122,70,61,131
4430,ElliotBayTrailMyrtlePark,07/04/2014 02:00:00 PM,48,-122,61,49,110
4431,ElliotBayTrailMyrtlePark,07/04/2014 03:00:00 PM,48,-122,89,63,152
4432,ElliotBayTrailMyrtlePark,07/04/2014 04:00:00 PM,48,-122,66,53,119
4433,ElliotBayTrailMyrtlePark,07/04/2014 05:00:00 PM,48,-122,54,58,112
4434,ElliotBayTrailMyrtlePark,07/04/2014 06:00:00 PM,48,-122,32,13,45
4435,ElliotBayTrailMyrtlePark,07/04/2014 07:00:00 PM,48,-122,16,10,26
4436,ElliotBayTrailMyrtlePark,07/04/2014 08:00:00 PM,48,-122,15,4,19
4437,ElliotBayTrailMyrtlePark,07/04/2014 09:00:00 PM,48,-122,7,5,12
4438,ElliotBayTrailMyrtlePark,07/04/2014 10:00:00 PM,48,-122,5,2,7
4439,ElliotBayTrailMyrtlePark,07/04/2014 11:00:00 PM,48,-122,7,6,13
4440,ElliotBayTrailMyrtlePark,07/05/2014 12:00:00 AM,48,-122,2,1,3
4441,ElliotBayTrailMyrtlePark,07/05/2014 01:00:00 AM,48,-122,4,0,4
4442,ElliotBayTrailMyrtlePark,07/05/2014 02:00:00 AM,48,-122,2,0,2
4443,ElliotBayTrailMyrtlePark,07/05/2014 03:00:00 AM,48,-122,2,0,2
4444,ElliotBayTrailMyrtlePark,07/05/2014 04:00:00 AM,48,-122,1,0,1
4445,ElliotBayTrailMyrtlePark,07/05/2014 05:00:00 AM,48,-122,4,4,8
4446,ElliotBayTrailMyrtlePark,07/05/2014 06:00:00 AM,48,-122,2,4,6
4447,ElliotBayTrailMyrtlePark,07/05/2014 07:00:00 AM,48,-122,5,10,15
4448,ElliotBayTrailMyrtlePark,07/05/2014 08:00:00 AM,48,-122,27,13,40
4449,ElliotBayTrailMyrtlePark,07/05/2014 09:00:00 AM,48,-122,17,27,44
4450,ElliotBayTrailMyrtlePark,07/05/2014 10:00:00 AM,48,-122,41,33,74
4451,ElliotBayTrailMyrtlePark,07/05/2014 11:00:00 AM,48,-122,47,63,110
4452,ElliotBayTrailMyrtlePark,07/05/2014 12:00:00 PM,48,-122,73,73,146
4453,ElliotBayTrailMyrtlePark,07/05/2014 01:00:00 PM,48,-122,47,40,87
4454,ElliotBayTrailMyrtlePark,07/05/2014 02:00:00 PM,48,-122,38,34,72
4455,ElliotBayTrailMyrtlePark,07/05/2014 03:00:00 PM,48,-122,31,34,65
4456,ElliotBayTrailMyrtlePark,07/05/2014 04:00:00 PM,48,-122,59,48,107
4457,ElliotBayTrailMyrtlePark,07/05/2014 05:00:00 PM,48,-122,35,36,71
4458,ElliotBayTrailMyrtlePark,07/05/2014 06:00:00 PM,48,-122,43,30,73
4459,ElliotBayTrailMyrtlePark,07/05/2014 07:00:00 PM,48,-122,37,17,54
4460,ElliotBayTrailMyrtlePark,07/05/2014 08:00:00 PM,48,-122,18,17,35
4461,ElliotBayTrailMyrtlePark,07/05/2014 09:00:00 PM,48,-122,7,2,9
4462,ElliotBayTrailMyrtlePark,07/05/2014 10:00:00 PM,48,-122,9,4,13
4463,ElliotBayTrailMyrtlePark,07/05/2014 11:00:00 PM,48,-122,9,0,9
4464,ElliotBayTrailMyrtlePark,07/06/2014 12:00:00 AM,48,-122,5,3,8
4465,ElliotBayTrailMyrtlePark,07/06/2014 01:00:00 AM,48,-122,3,0,3
4466,ElliotBayTrailMyrtlePark,07/06/2014 02:00:00 AM,48,-122,4,0,4
4467,ElliotBayTrailMyrtlePark,07/06/2014 03:00:00 AM,48,-122,1,1,2
4468,ElliotBayTrailMyrtlePark,07/06/2014 04:00:00 AM,48,-122,0,1,1
4469,ElliotBayTrailMyrtlePark,07/06/2014 05:00:00 AM,48,-122,1,2,3
4470,ElliotBayTrailMyrtlePark,07/06/2014 06:00:00 AM,48,-122,2,10,12
4471,ElliotBayTrailMyrtlePark,07/06/2014 07:00:00 AM,48,-122,10,9,19
4472,ElliotBayTrailMyrtlePark,07/06/2014 08:00:00 AM,48,-122,22,33,55
4473,ElliotBayTrailMyrtlePark,07/06/2014 09:00:00 AM,48,-122,36,46,82
4474,ElliotBayTrailMyrtlePark,07/06/2014 10:00:00 AM,48,-122,54,42,96
4475,ElliotBayTrailMyrtlePark,07/06/2014 11:00:00 AM,48,-122,67,98,165
4476,ElliotBayTrailMyrtlePark,07/06/2014 12:00:00 PM,48,-122,108,72,180
4477,ElliotBayTrailMyrtlePark,07/06/2014 01:00:00 PM,48,-122,99,89,188
4478,ElliotBayTrailMyrtlePark,07/06/2014 02:00:00 PM,48,-122,119,80,199
4479,ElliotBayTrailMyrtlePark,07/06/2014 03:00:00 PM,48,-122,99,85,184
4480,ElliotBayTrailMyrtlePark,07/06/2014 04:00:00 PM,48,-122,100,64,164
4481,ElliotBayTrailMyrtlePark,07/06/2014 05:00:00 PM,48,-122,79,68,147
4482,ElliotBayTrailMyrtlePark,07/06/2014 06:00:00 PM,48,-122,75,53,128
4483,ElliotBayTrailMyrtlePark,07/06/2014 07:00:00 PM,48,-122,43,58,101
4484,ElliotBayTrailMyrtlePark,07/06/2014 08:00:00 PM,48,-122,32,34,66
4485,ElliotBayTrailMyrtlePark,07/06/2014 09:00:00 PM,48,-122,16,18,34
4486,ElliotBayTrailMyrtlePark,07/06/2014 10:00:00 PM,48,-122,3,4,7
4487,ElliotBayTrailMyrtlePark,07/06/2014 11:00:00 PM,48,-122,2,1,3
4488,ElliotBayTrailMyrtlePark,07/07/2014 12:00:00 AM,48,-122,3,2,5
4489,ElliotBayTrailMyrtlePark,07/07/2014 01:00:00 AM,48,-122,2,0,2
4490,ElliotBayTrailMyrtlePark,07/07/2014 02:00:00 AM,48,-122,1,1,2
4491,ElliotBayTrailMyrtlePark,07/07/2014 03:00:00 AM,48,-122,0,0,0
4492,ElliotBayTrailMyrtlePark,07/07/2014 04:00:00 AM,48,-122,0,1,1
4493,ElliotBayTrailMyrtlePark,07/07/2014 05:00:00 AM,48,-122,10,18,28
4494,ElliotBayTrailMyrtlePark,07/07/2014 06:00:00 AM,48,-122,17,42,59
4495,ElliotBayTrailMyrtlePark,07/07/2014 07:00:00 AM,48,-122,55,128,183
4496,ElliotBayTrailMyrtlePark,07/07/2014 08:00:00 AM,48,-122,32,135,167
4497,ElliotBayTrailMyrtlePark,07/07/2014 09:00:00 AM,48,-122,29,84,113
4498,ElliotBayTrailMyrtlePark,07/07/2014 10:00:00 AM,48,-122,16,50,66
4499,ElliotBayTrailMyrtlePark,07/07/2014 11:00:00 AM,48,-122,26,28,54
4500,ElliotBayTrailMyrtlePark,07/07/2014 12:00:00 PM,48,-122,22,23,45
4501,ElliotBayTrailMyrtlePark,07/07/2014 01:00:00 PM,48,-122,30,22,52
4502,ElliotBayTrailMyrtlePark,07/07/2014 02:00:00 PM,48,-122,36,30,66
4503,ElliotBayTrailMyrtlePark,07/07/2014 03:00:00 PM,48,-122,51,44,95
4504,ElliotBayTrailMyrtlePark,07/07/2014 04:00:00 PM,48,-122,116,63,179
4505,ElliotBayTrailMyrtlePark,07/07/2014 05:00:00 PM,48,-122,235,68,303
4506,ElliotBayTrailMyrtlePark,07/07/2014 06:00:00 PM,48,-122,159,75,234
4507,ElliotBayTrailMyrtlePark,07/07/2014 07:00:00 PM,48,-122,68,43,111
4508,ElliotBayTrailMyrtlePark,07/07/2014 08:00:00 PM,48,-122,53,43,96
4509,ElliotBayTrailMyrtlePark,07/07/2014 09:00:00 PM,48,-122,15,12,27
4510,ElliotBayTrailMyrtlePark,07/07/2014 10:00:00 PM,48,-122,19,10,29
4511,ElliotBayTrailMyrtlePark,07/07/2014 11:00:00 PM,48,-122,11,3,14
4512,ElliotBayTrailMyrtlePark,07/08/2014 12:00:00 AM,48,-122,2,1,3
4513,ElliotBayTrailMyrtlePark,07/08/2014 01:00:00 AM,48,-122,3,0,3
4514,ElliotBayTrailMyrtlePark,07/08/2014 02:00:00 AM,48,-122,3,3,6
4515,ElliotBayTrailMyrtlePark,07/08/2014 03:00:00 AM,48,-122,0,0,0
4516,ElliotBayTrailMyrtlePark,07/08/2014 04:00:00 AM,48,-122,1,2,3
4517,ElliotBayTrailMyrtlePark,07/08/2014 05:00:00 AM,48,-122,10,21,31
4518,ElliotBayTrailMyrtlePark,07/08/2014 06:00:00 AM,48,-122,27,51,78
4519,ElliotBayTrailMyrtlePark,07/08/2014 07:00:00 AM,48,-122,66,166,232
4520,ElliotBayTrailMyrtlePark,07/08/2014 08:00:00 AM,48,-122,111,145,256
4521,ElliotBayTrailMyrtlePark,07/08/2014 09:00:00 AM,48,-122,46,85,131
4522,ElliotBayTrailMyrtlePark,07/08/2014 10:00:00 AM,48,-122,28,41,69
4523,ElliotBayTrailMyrtlePark,07/08/2014 11:00:00 AM,48,-122,54,50,104
4524,ElliotBayTrailMyrtlePark,07/08/2014 12:00:00 PM,48,-122,43,48,91
4525,ElliotBayTrailMyrtlePark,07/08/2014 01:00:00 PM,48,-122,41,32,73
4526,ElliotBayTrailMyrtlePark,07/08/2014 02:00:00 PM,48,-122,33,29,62
4527,ElliotBayTrailMyrtlePark,07/08/2014 03:00:00 PM,48,-122,90,38,128
4528,ElliotBayTrailMyrtlePark,07/08/2014 04:00:00 PM,48,-122,137,74,211
4529,ElliotBayTrailMyrtlePark,07/08/2014 05:00:00 PM,48,-122,293,108,401
4530,ElliotBayTrailMyrtlePark,07/08/2014 06:00:00 PM,48,-122,176,75,251
4531,ElliotBayTrailMyrtlePark,07/08/2014 07:00:00 PM,48,-122,114,61,175
4532,ElliotBayTrailMyrtlePark,07/08/2014 08:00:00 PM,48,-122,74,76,150
4533,ElliotBayTrailMyrtlePark,07/08/2014 09:00:00 PM,48,-122,21,22,43
4534,ElliotBayTrailMyrtlePark,07/08/2014 10:00:00 PM,48,-122,22,9,31
4535,ElliotBayTrailMyrtlePark,07/08/2014 11:00:00 PM,48,-122,11,3,14
4536,ElliotBayTrailMyrtlePark,07/09/2014 12:00:00 AM,48,-122,5,3,8
4537,ElliotBayTrailMyrtlePark,07/09/2014 01:00:00 AM,48,-122,3,5,8
4538,ElliotBayTrailMyrtlePark,07/09/2014 02:00:00 AM,48,-122,4,0,4
4539,ElliotBayTrailMyrtlePark,07/09/2014 03:00:00 AM,48,-122,1,1,2
4540,ElliotBayTrailMyrtlePark,07/09/2014 04:00:00 AM,48,-122,0,0,0
4541,ElliotBayTrailMyrtlePark,07/09/2014 05:00:00 AM,48,-122,4,21,25
4542,ElliotBayTrailMyrtlePark,07/09/2014 06:00:00 AM,48,-122,25,57,82
4543,ElliotBayTrailMyrtlePark,07/09/2014 07:00:00 AM,48,-122,57,141,198
4544,ElliotBayTrailMyrtlePark,07/09/2014 08:00:00 AM,48,-122,119,120,239
4545,ElliotBayTrailMyrtlePark,07/09/2014 09:00:00 AM,48,-122,42,85,127
4546,ElliotBayTrailMyrtlePark,07/09/2014 10:00:00 AM,48,-122,38,40,78
4547,ElliotBayTrailMyrtlePark,07/09/2014 11:00:00 AM,48,-122,33,37,70
4548,ElliotBayTrailMyrtlePark,07/09/2014 12:00:00 PM,48,-122,28,39,67
4549,ElliotBayTrailMyrtlePark,07/09/2014 01:00:00 PM,48,-122,37,35,72
4550,ElliotBayTrailMyrtlePark,07/09/2014 02:00:00 PM,48,-122,31,48,79
4551,ElliotBayTrailMyrtlePark,07/09/2014 03:00:00 PM,48,-122,44,41,85
4552,ElliotBayTrailMyrtlePark,07/09/2014 04:00:00 PM,48,-122,123,59,182
4553,ElliotBayTrailMyrtlePark,07/09/2014 05:00:00 PM,48,-122,280,99,379
4554,ElliotBayTrailMyrtlePark,07/09/2014 06:00:00 PM,48,-122,169,87,256
4555,ElliotBayTrailMyrtlePark,07/09/2014 07:00:00 PM,48,-122,106,63,169
4556,ElliotBayTrailMyrtlePark,07/09/2014 08:00:00 PM,48,-122,44,44,88
4557,ElliotBayTrailMyrtlePark,07/09/2014 09:00:00 PM,48,-122,33,17,50
4558,ElliotBayTrailMyrtlePark,07/09/2014 10:00:00 PM,48,-122,23,13,36
4559,ElliotBayTrailMyrtlePark,07/09/2014 11:00:00 PM,48,-122,4,6,10
4560,ElliotBayTrailMyrtlePark,07/10/2014 12:00:00 AM,48,-122,4,2,6
4561,ElliotBayTrailMyrtlePark,07/10/2014 01:00:00 AM,48,-122,1,0,1
4562,ElliotBayTrailMyrtlePark,07/10/2014 02:00:00 AM,48,-122,2,0,2
4563,ElliotBayTrailMyrtlePark,07/10/2014 03:00:00 AM,48,-122,2,0,2
4564,ElliotBayTrailMyrtlePark,07/10/2014 04:00:00 AM,48,-122,1,2,3
4565,ElliotBayTrailMyrtlePark,07/10/2014 05:00:00 AM,48,-122,9,23,32
4566,ElliotBayTrailMyrtlePark,07/10/2014 06:00:00 AM,48,-122,31,48,79
4567,ElliotBayTrailMyrtlePark,07/10/2014 07:00:00 AM,48,-122,57,137,194
4568,ElliotBayTrailMyrtlePark,07/10/2014 08:00:00 AM,48,-122,54,163,217
4569,ElliotBayTrailMyrtlePark,07/10/2014 09:00:00 AM,48,-122,29,77,106
4570,ElliotBayTrailMyrtlePark,07/10/2014 10:00:00 AM,48,-122,32,45,77
4571,ElliotBayTrailMyrtlePark,07/10/2014 11:00:00 AM,48,-122,35,37,72
4572,ElliotBayTrailMyrtlePark,07/10/2014 12:00:00 PM,48,-122,25,33,58
4573,ElliotBayTrailMyrtlePark,07/10/2014 01:00:00 PM,48,-122,29,16,45
4574,ElliotBayTrailMyrtlePark,07/10/2014 02:00:00 PM,48,-122,54,50,104
4575,ElliotBayTrailMyrtlePark,07/10/2014 03:00:00 PM,48,-122,58,49,107
4576,ElliotBayTrailMyrtlePark,07/10/2014 04:00:00 PM,48,-122,124,67,191
4577,ElliotBayTrailMyrtlePark,07/10/2014 05:00:00 PM,48,-122,225,87,312
4578,ElliotBayTrailMyrtlePark,07/10/2014 06:00:00 PM,48,-122,148,80,228
4579,ElliotBayTrailMyrtlePark,07/10/2014 07:00:00 PM,48,-122,90,54,144
4580,ElliotBayTrailMyrtlePark,07/10/2014 08:00:00 PM,48,-122,60,38,98
4581,ElliotBayTrailMyrtlePark,07/10/2014 09:00:00 PM,48,-122,24,14,38
4582,ElliotBayTrailMyrtlePark,07/10/2014 10:00:00 PM,48,-122,19,2,21
4583,ElliotBayTrailMyrtlePark,07/10/2014 11:00:00 PM,48,-122,14,5,19
4584,ElliotBayTrailMyrtlePark,07/11/2014 12:00:00 AM,48,-122,3,5,8
4585,ElliotBayTrailMyrtlePark,07/11/2014 01:00:00 AM,48,-122,3,10,13
4586,ElliotBayTrailMyrtlePark,07/11/2014 02:00:00 AM,48,-122,4,4,8
4587,ElliotBayTrailMyrtlePark,07/11/2014 03:00:00 AM,48,-122,3,1,4
4588,ElliotBayTrailMyrtlePark,07/11/2014 04:00:00 AM,48,-122,1,1,2
4589,ElliotBayTrailMyrtlePark,07/11/2014 05:00:00 AM,48,-122,10,18,28
4590,ElliotBayTrailMyrtlePark,07/11/2014 06:00:00 AM,48,-122,23,50,73
4591,ElliotBayTrailMyrtlePark,07/11/2014 07:00:00 AM,48,-122,54,111,165
4592,ElliotBayTrailMyrtlePark,07/11/2014 08:00:00 AM,48,-122,100,123,223
4593,ElliotBayTrailMyrtlePark,07/11/2014 09:00:00 AM,48,-122,54,65,119
4594,ElliotBayTrailMyrtlePark,07/11/2014 10:00:00 AM,48,-122,27,46,73
4595,ElliotBayTrailMyrtlePark,07/11/2014 11:00:00 AM,48,-122,30,18,48
4596,ElliotBayTrailMyrtlePark,07/11/2014 12:00:00 PM,48,-122,27,31,58
4597,ElliotBayTrailMyrtlePark,07/11/2014 01:00:00 PM,48,-122,38,29,67
4598,ElliotBayTrailMyrtlePark,07/11/2014 02:00:00 PM,48,-122,49,33,82
4599,ElliotBayTrailMyrtlePark,07/11/2014 03:00:00 PM,48,-122,54,55,109
4600,ElliotBayTrailMyrtlePark,07/11/2014 04:00:00 PM,48,-122,123,54,177
4601,ElliotBayTrailMyrtlePark,07/11/2014 05:00:00 PM,48,-122,207,78,285
4602,ElliotBayTrailMyrtlePark,07/11/2014 06:00:00 PM,48,-122,122,62,184
4603,ElliotBayTrailMyrtlePark,07/11/2014 07:00:00 PM,48,-122,47,33,80
4604,ElliotBayTrailMyrtlePark,07/11/2014 08:00:00 PM,48,-122,37,17,54
4605,ElliotBayTrailMyrtlePark,07/11/2014 09:00:00 PM,48,-122,20,24,44
4606,ElliotBayTrailMyrtlePark,07/11/2014 10:00:00 PM,48,-122,37,11,48
4607,ElliotBayTrailMyrtlePark,07/11/2014 11:00:00 PM,48,-122,17,4,21
4608,ElliotBayTrailMyrtlePark,07/12/2014 12:00:00 AM,48,-122,13,1,14
4609,ElliotBayTrailMyrtlePark,07/12/2014 01:00:00 AM,48,-122,3,0,3
4610,ElliotBayTrailMyrtlePark,07/12/2014 02:00:00 AM,48,-122,2,2,4
4611,ElliotBayTrailMyrtlePark,07/12/2014 03:00:00 AM,48,-122,5,0,5
4612,ElliotBayTrailMyrtlePark,07/12/2014 04:00:00 AM,48,-122,0,0,0
4613,ElliotBayTrailMyrtlePark,07/12/2014 05:00:00 AM,48,-122,6,4,10
4614,ElliotBayTrailMyrtlePark,07/12/2014 06:00:00 AM,48,-122,7,6,13
4615,ElliotBayTrailMyrtlePark,07/12/2014 07:00:00 AM,48,-122,24,24,48
4616,ElliotBayTrailMyrtlePark,07/12/2014 08:00:00 AM,48,-122,40,46,86
4617,ElliotBayTrailMyrtlePark,07/12/2014 09:00:00 AM,48,-122,43,30,73
4618,ElliotBayTrailMyrtlePark,07/12/2014 10:00:00 AM,48,-122,70,70,140
4619,ElliotBayTrailMyrtlePark,07/12/2014 11:00:00 AM,48,-122,71,72,143
4620,ElliotBayTrailMyrtlePark,07/12/2014 12:00:00 PM,48,-122,100,63,163
4621,ElliotBayTrailMyrtlePark,07/12/2014 01:00:00 PM,48,-122,66,65,131
4622,ElliotBayTrailMyrtlePark,07/12/2014 02:00:00 PM,48,-122,65,39,104
4623,ElliotBayTrailMyrtlePark,07/12/2014 03:00:00 PM,48,-122,53,43,96
4624,ElliotBayTrailMyrtlePark,07/12/2014 04:00:00 PM,48,-122,51,63,114
4625,ElliotBayTrailMyrtlePark,07/12/2014 05:00:00 PM,48,-122,57,46,103
4626,ElliotBayTrailMyrtlePark,07/12/2014 06:00:00 PM,48,-122,44,54,98
4627,ElliotBayTrailMyrtlePark,07/12/2014 07:00:00 PM,48,-122,26,20,46
4628,ElliotBayTrailMyrtlePark,07/12/2014 08:00:00 PM,48,-122,39,25,64
4629,ElliotBayTrailMyrtlePark,07/12/2014 09:00:00 PM,48,-122,12,9,21
4630,ElliotBayTrailMyrtlePark,07/12/2014 10:00:00 PM,48,-122,27,11,38
4631,ElliotBayTrailMyrtlePark,07/12/2014 11:00:00 PM,48,-122,3,0,3
4632,ElliotBayTrailMyrtlePark,07/13/2014 12:00:00 AM,48,-122,10,3,13
4633,ElliotBayTrailMyrtlePark,07/13/2014 01:00:00 AM,48,-122,8,0,8
4634,ElliotBayTrailMyrtlePark,07/13/2014 02:00:00 AM,48,-122,1,2,3
4635,ElliotBayTrailMyrtlePark,07/13/2014 03:00:00 AM,48,-122,1,0,1
4636,ElliotBayTrailMyrtlePark,07/13/2014 04:00:00 AM,48,-122,1,0,1
4637,ElliotBayTrailMyrtlePark,07/13/2014 05:00:00 AM,48,-122,2,3,5
4638,ElliotBayTrailMyrtlePark,07/13/2014 06:00:00 AM,48,-122,5,6,11
4639,ElliotBayTrailMyrtlePark,07/13/2014 07:00:00 AM,48,-122,23,23,46
4640,ElliotBayTrailMyrtlePark,07/13/2014 08:00:00 AM,48,-122,32,24,56
4641,ElliotBayTrailMyrtlePark,07/13/2014 09:00:00 AM,48,-122,44,41,85
4642,ElliotBayTrailMyrtlePark,07/13/2014 10:00:00 AM,48,-122,57,51,108
4643,ElliotBayTrailMyrtlePark,07/13/2014 11:00:00 AM,48,-122,58,62,120
4644,ElliotBayTrailMyrtlePark,07/13/2014 12:00:00 PM,48,-122,67,44,111
4645,ElliotBayTrailMyrtlePark,07/13/2014 01:00:00 PM,48,-122,55,37,92
4646,ElliotBayTrailMyrtlePark,07/13/2014 02:00:00 PM,48,-122,35,39,74
4647,ElliotBayTrailMyrtlePark,07/13/2014 03:00:00 PM,48,-122,50,41,91
4648,ElliotBayTrailMyrtlePark,07/13/2014 04:00:00 PM,48,-122,60,67,127
4649,ElliotBayTrailMyrtlePark,07/13/2014 05:00:00 PM,48,-122,53,73,126
4650,ElliotBayTrailMyrtlePark,07/13/2014 06:00:00 PM,48,-122,36,48,84
4651,ElliotBayTrailMyrtlePark,07/13/2014 07:00:00 PM,48,-122,36,35,71
4652,ElliotBayTrailMyrtlePark,07/13/2014 08:00:00 PM,48,-122,28,21,49
4653,ElliotBayTrailMyrtlePark,07/13/2014 09:00:00 PM,48,-122,40,9,49
4654,ElliotBayTrailMyrtlePark,07/13/2014 10:00:00 PM,48,-122,48,4,52
4655,ElliotBayTrailMyrtlePark,07/13/2014 11:00:00 PM,48,-122,7,2,9
4656,ElliotBayTrailMyrtlePark,07/14/2014 12:00:00 AM,48,-122,2,0,2
4657,ElliotBayTrailMyrtlePark,07/14/2014 01:00:00 AM,48,-122,2,1,3
4658,ElliotBayTrailMyrtlePark,07/14/2014 02:00:00 AM,48,-122,1,0,1
4659,ElliotBayTrailMyrtlePark,07/14/2014 03:00:00 AM,48,-122,3,0,3
4660,ElliotBayTrailMyrtlePark,07/14/2014 04:00:00 AM,48,-122,1,3,4
4661,ElliotBayTrailMyrtlePark,07/14/2014 05:00:00 AM,48,-122,12,15,27
4662,ElliotBayTrailMyrtlePark,07/14/2014 06:00:00 AM,48,-122,23,50,73
4663,ElliotBayTrailMyrtlePark,07/14/2014 07:00:00 AM,48,-122,57,123,180
4664,ElliotBayTrailMyrtlePark,07/14/2014 08:00:00 AM,48,-122,76,126,202
4665,ElliotBayTrailMyrtlePark,07/14/2014 09:00:00 AM,48,-122,39,70,109
4666,ElliotBayTrailMyrtlePark,07/14/2014 10:00:00 AM,48,-122,28,35,63
4667,ElliotBayTrailMyrtlePark,07/14/2014 11:00:00 AM,48,-122,32,33,65
4668,ElliotBayTrailMyrtlePark,07/14/2014 12:00:00 PM,48,-122,33,23,56
4669,ElliotBayTrailMyrtlePark,07/14/2014 01:00:00 PM,48,-122,19,31,50
4670,ElliotBayTrailMyrtlePark,07/14/2014 02:00:00 PM,48,-122,37,34,71
4671,ElliotBayTrailMyrtlePark,07/14/2014 03:00:00 PM,48,-122,48,47,95
4672,ElliotBayTrailMyrtlePark,07/14/2014 04:00:00 PM,48,-122,90,53,143
4673,ElliotBayTrailMyrtlePark,07/14/2014 05:00:00 PM,48,-122,262,70,332
4674,ElliotBayTrailMyrtlePark,07/14/2014 06:00:00 PM,48,-122,151,68,219
4675,ElliotBayTrailMyrtlePark,07/14/2014 07:00:00 PM,48,-122,90,34,124
4676,ElliotBayTrailMyrtlePark,07/14/2014 08:00:00 PM,48,-122,42,44,86
4677,ElliotBayTrailMyrtlePark,07/14/2014 09:00:00 PM,48,-122,20,10,30
4678,ElliotBayTrailMyrtlePark,07/14/2014 10:00:00 PM,48,-122,11,9,20
4679,ElliotBayTrailMyrtlePark,07/14/2014 11:00:00 PM,48,-122,3,7,10
4680,ElliotBayTrailMyrtlePark,07/15/2014 12:00:00 AM,48,-122,3,0,3
4681,ElliotBayTrailMyrtlePark,07/15/2014 01:00:00 AM,48,-122,2,2,4
4682,ElliotBayTrailMyrtlePark,07/15/2014 02:00:00 AM,48,-122,1,1,2
4683,ElliotBayTrailMyrtlePark,07/15/2014 03:00:00 AM,48,-122,2,0,2
4684,ElliotBayTrailMyrtlePark,07/15/2014 04:00:00 AM,48,-122,0,2,2
4685,ElliotBayTrailMyrtlePark,07/15/2014 05:00:00 AM,48,-122,12,19,31
4686,ElliotBayTrailMyrtlePark,07/15/2014 06:00:00 AM,48,-122,34,47,81
4687,ElliotBayTrailMyrtlePark,07/15/2014 07:00:00 AM,48,-122,79,148,227
4688,ElliotBayTrailMyrtlePark,07/15/2014 08:00:00 AM,48,-122,50,174,224
4689,ElliotBayTrailMyrtlePark,07/15/2014 09:00:00 AM,48,-122,32,89,121
4690,ElliotBayTrailMyrtlePark,07/15/2014 10:00:00 AM,48,-122,15,31,46
4691,ElliotBayTrailMyrtlePark,07/15/2014 11:00:00 AM,48,-122,26,27,53
4692,ElliotBayTrailMyrtlePark,07/15/2014 12:00:00 PM,48,-122,29,44,73
4693,ElliotBayTrailMyrtlePark,07/15/2014 01:00:00 PM,48,-122,24,31,55
4694,ElliotBayTrailMyrtlePark,07/15/2014 02:00:00 PM,48,-122,30,22,52
4695,ElliotBayTrailMyrtlePark,07/15/2014 03:00:00 PM,48,-122,59,40,99
4696,ElliotBayTrailMyrtlePark,07/15/2014 04:00:00 PM,48,-122,107,78,185
4697,ElliotBayTrailMyrtlePark,07/15/2014 05:00:00 PM,48,-122,252,81,333
4698,ElliotBayTrailMyrtlePark,07/15/2014 06:00:00 PM,48,-122,193,62,255
4699,ElliotBayTrailMyrtlePark,07/15/2014 07:00:00 PM,48,-122,111,56,167
4700,ElliotBayTrailMyrtlePark,07/15/2014 08:00:00 PM,48,-122,39,52,91
4701,ElliotBayTrailMyrtlePark,07/15/2014 09:00:00 PM,48,-122,15,28,43
4702,ElliotBayTrailMyrtlePark,07/15/2014 10:00:00 PM,48,-122,16,3,19
4703,ElliotBayTrailMyrtlePark,07/15/2014 11:00:00 PM,48,-122,15,7,22
4704,ElliotBayTrailMyrtlePark,07/16/2014 12:00:00 AM,48,-122,2,0,2
4705,ElliotBayTrailMyrtlePark,07/16/2014 01:00:00 AM,48,-122,0,1,1
4706,ElliotBayTrailMyrtlePark,07/16/2014 02:00:00 AM,48,-122,0,7,7
4707,ElliotBayTrailMyrtlePark,07/16/2014 03:00:00 AM,48,-122,1,0,1
4708,ElliotBayTrailMyrtlePark,07/16/2014 04:00:00 AM,48,-122,0,1,1
4709,ElliotBayTrailMyrtlePark,07/16/2014 05:00:00 AM,48,-122,11,22,33
4710,ElliotBayTrailMyrtlePark,07/16/2014 06:00:00 AM,48,-122,26,67,93
4711,ElliotBayTrailMyrtlePark,07/16/2014 07:00:00 AM,48,-122,68,154,222
4712,ElliotBayTrailMyrtlePark,07/16/2014 08:00:00 AM,48,-122,109,126,235
4713,ElliotBayTrailMyrtlePark,07/16/2014 09:00:00 AM,48,-122,53,70,123
4714,ElliotBayTrailMyrtlePark,07/16/2014 10:00:00 AM,48,-122,27,45,72
4715,ElliotBayTrailMyrtlePark,07/16/2014 11:00:00 AM,48,-122,34,37,71
4716,ElliotBayTrailMyrtlePark,07/16/2014 12:00:00 PM,48,-122,34,36,70
4717,ElliotBayTrailMyrtlePark,07/16/2014 01:00:00 PM,48,-122,40,32,72
4718,ElliotBayTrailMyrtlePark,07/16/2014 02:00:00 PM,48,-122,38,34,72
4719,ElliotBayTrailMyrtlePark,07/16/2014 03:00:00 PM,48,-122,63,51,114
4720,ElliotBayTrailMyrtlePark,07/16/2014 04:00:00 PM,48,-122,111,90,201
4721,ElliotBayTrailMyrtlePark,07/16/2014 05:00:00 PM,48,-122,245,87,332
4722,ElliotBayTrailMyrtlePark,07/16/2014 06:00:00 PM,48,-122,176,92,268
4723,ElliotBayTrailMyrtlePark,07/16/2014 07:00:00 PM,48,-122,92,53,145
4724,ElliotBayTrailMyrtlePark,07/16/2014 08:00:00 PM,48,-122,63,49,112
4725,ElliotBayTrailMyrtlePark,07/16/2014 09:00:00 PM,48,-122,21,16,37
4726,ElliotBayTrailMyrtlePark,07/16/2014 10:00:00 PM,48,-122,14,9,23
4727,ElliotBayTrailMyrtlePark,07/16/2014 11:00:00 PM,48,-122,13,1,14
4728,ElliotBayTrailMyrtlePark,07/17/2014 12:00:00 AM,48,-122,6,2,8
4729,ElliotBayTrailMyrtlePark,07/17/2014 01:00:00 AM,48,-122,0,1,1
4730,ElliotBayTrailMyrtlePark,07/17/2014 02:00:00 AM,48,-122,2,0,2
4731,ElliotBayTrailMyrtlePark,07/17/2014 03:00:00 AM,48,-122,0,0,0
4732,ElliotBayTrailMyrtlePark,07/17/2014 04:00:00 AM,48,-122,1,1,2
4733,ElliotBayTrailMyrtlePark,07/17/2014 05:00:00 AM,48,-122,13,16,29
4734,ElliotBayTrailMyrtlePark,07/17/2014 06:00:00 AM,48,-122,24,52,76
4735,ElliotBayTrailMyrtlePark,07/17/2014 07:00:00 AM,48,-122,60,113,173
4736,ElliotBayTrailMyrtlePark,07/17/2014 08:00:00 AM,48,-122,45,134,179
4737,ElliotBayTrailMyrtlePark,07/17/2014 09:00:00 AM,48,-122,20,95,115
4738,ElliotBayTrailMyrtlePark,07/17/2014 10:00:00 AM,48,-122,25,33,58
4739,ElliotBayTrailMyrtlePark,07/17/2014 11:00:00 AM,48,-122,17,25,42
4740,ElliotBayTrailMyrtlePark,07/17/2014 12:00:00 PM,48,-122,16,29,45
4741,ElliotBayTrailMyrtlePark,07/17/2014 01:00:00 PM,48,-122,22,24,46
4742,ElliotBayTrailMyrtlePark,07/17/2014 02:00:00 PM,48,-122,20,31,51
4743,ElliotBayTrailMyrtlePark,07/17/2014 03:00:00 PM,48,-122,49,35,84
4744,ElliotBayTrailMyrtlePark,07/17/2014 04:00:00 PM,48,-122,129,68,197
4745,ElliotBayTrailMyrtlePark,07/17/2014 05:00:00 PM,48,-122,221,84,305
4746,ElliotBayTrailMyrtlePark,07/17/2014 06:00:00 PM,48,-122,151,65,216
4747,ElliotBayTrailMyrtlePark,07/17/2014 07:00:00 PM,48,-122,84,57,141
4748,ElliotBayTrailMyrtlePark,07/17/2014 08:00:00 PM,48,-122,62,48,110
4749,ElliotBayTrailMyrtlePark,07/17/2014 09:00:00 PM,48,-122,10,22,32
4750,ElliotBayTrailMyrtlePark,07/17/2014 10:00:00 PM,48,-122,10,37,47
4751,ElliotBayTrailMyrtlePark,07/17/2014 11:00:00 PM,48,-122,7,3,10
4752,ElliotBayTrailMyrtlePark,07/18/2014 12:00:00 AM,48,-122,0,1,1
4753,ElliotBayTrailMyrtlePark,07/18/2014 01:00:00 AM,48,-122,1,0,1
4754,ElliotBayTrailMyrtlePark,07/18/2014 02:00:00 AM,48,-122,3,0,3
4755,ElliotBayTrailMyrtlePark,07/18/2014 03:00:00 AM,48,-122,1,2,3
4756,ElliotBayTrailMyrtlePark,07/18/2014 04:00:00 AM,48,-122,0,2,2
4757,ElliotBayTrailMyrtlePark,07/18/2014 05:00:00 AM,48,-122,12,18,30
4758,ElliotBayTrailMyrtlePark,07/18/2014 06:00:00 AM,48,-122,24,39,63
4759,ElliotBayTrailMyrtlePark,07/18/2014 07:00:00 AM,48,-122,50,112,162
4760,ElliotBayTrailMyrtlePark,07/18/2014 08:00:00 AM,48,-122,41,138,179
4761,ElliotBayTrailMyrtlePark,07/18/2014 09:00:00 AM,48,-122,34,62,96
4762,ElliotBayTrailMyrtlePark,07/18/2014 10:00:00 AM,48,-122,20,32,52
4763,ElliotBayTrailMyrtlePark,07/18/2014 11:00:00 AM,48,-122,28,18,46
4764,ElliotBayTrailMyrtlePark,07/18/2014 12:00:00 PM,48,-122,30,27,57
4765,ElliotBayTrailMyrtlePark,07/18/2014 01:00:00 PM,48,-122,35,46,81
4766,ElliotBayTrailMyrtlePark,07/18/2014 02:00:00 PM,48,-122,47,62,109
4767,ElliotBayTrailMyrtlePark,07/18/2014 03:00:00 PM,48,-122,67,55,122
4768,ElliotBayTrailMyrtlePark,07/18/2014 04:00:00 PM,48,-122,130,59,189
4769,ElliotBayTrailMyrtlePark,07/18/2014 05:00:00 PM,48,-122,184,74,258
4770,ElliotBayTrailMyrtlePark,07/18/2014 06:00:00 PM,48,-122,127,42,169
4771,ElliotBayTrailMyrtlePark,07/18/2014 07:00:00 PM,48,-122,59,26,85
4772,ElliotBayTrailMyrtlePark,07/18/2014 08:00:00 PM,48,-122,37,32,69
4773,ElliotBayTrailMyrtlePark,07/18/2014 09:00:00 PM,48,-122,5,9,14
4774,ElliotBayTrailMyrtlePark,07/18/2014 10:00:00 PM,48,-122,10,13,23
4775,ElliotBayTrailMyrtlePark,07/18/2014 11:00:00 PM,48,-122,5,1,6
4776,ElliotBayTrailMyrtlePark,07/19/2014 12:00:00 AM,48,-122,8,2,10
4777,ElliotBayTrailMyrtlePark,07/19/2014 01:00:00 AM,48,-122,0,0,0
4778,ElliotBayTrailMyrtlePark,07/19/2014 02:00:00 AM,48,-122,3,0,3
4779,ElliotBayTrailMyrtlePark,07/19/2014 03:00:00 AM,48,-122,1,2,3
4780,ElliotBayTrailMyrtlePark,07/19/2014 04:00:00 AM,48,-122,1,0,1
4781,ElliotBayTrailMyrtlePark,07/19/2014 05:00:00 AM,48,-122,8,5,13
4782,ElliotBayTrailMyrtlePark,07/19/2014 06:00:00 AM,48,-122,4,13,17
4783,ElliotBayTrailMyrtlePark,07/19/2014 07:00:00 AM,48,-122,9,11,20
4784,ElliotBayTrailMyrtlePark,07/19/2014 08:00:00 AM,48,-122,27,14,41
4785,ElliotBayTrailMyrtlePark,07/19/2014 09:00:00 AM,48,-122,31,29,60
4786,ElliotBayTrailMyrtlePark,07/19/2014 10:00:00 AM,48,-122,20,56,76
4787,ElliotBayTrailMyrtlePark,07/19/2014 11:00:00 AM,48,-122,35,67,102
4788,ElliotBayTrailMyrtlePark,07/19/2014 12:00:00 PM,48,-122,38,72,110
4789,ElliotBayTrailMyrtlePark,07/19/2014 01:00:00 PM,48,-122,48,52,100
4790,ElliotBayTrailMyrtlePark,07/19/2014 02:00:00 PM,48,-122,72,38,110
4791,ElliotBayTrailMyrtlePark,07/19/2014 03:00:00 PM,48,-122,155,66,221
4792,ElliotBayTrailMyrtlePark,07/19/2014 04:00:00 PM,48,-122,94,46,140
4793,ElliotBayTrailMyrtlePark,07/19/2014 05:00:00 PM,48,-122,43,32,75
4794,ElliotBayTrailMyrtlePark,07/19/2014 06:00:00 PM,48,-122,42,29,71
4795,ElliotBayTrailMyrtlePark,07/19/2014 07:00:00 PM,48,-122,34,30,64
4796,ElliotBayTrailMyrtlePark,07/19/2014 08:00:00 PM,48,-122,17,13,30
4797,ElliotBayTrailMyrtlePark,07/19/2014 09:00:00 PM,48,-122,3,6,9
4798,ElliotBayTrailMyrtlePark,07/19/2014 10:00:00 PM,48,-122,8,5,13
4799,ElliotBayTrailMyrtlePark,07/19/2014 11:00:00 PM,48,-122,3,1,4
4800,ElliotBayTrailMyrtlePark,07/20/2014 12:00:00 AM,48,-122,2,2,4
4801,ElliotBayTrailMyrtlePark,07/20/2014 01:00:00 AM,48,-122,2,0,2
4802,ElliotBayTrailMyrtlePark,07/20/2014 02:00:00 AM,48,-122,0,0,0
4803,ElliotBayTrailMyrtlePark,07/20/2014 03:00:00 AM,48,-122,0,0,0
4804,ElliotBayTrailMyrtlePark,07/20/2014 04:00:00 AM,48,-122,0,1,1
4805,ElliotBayTrailMyrtlePark,07/20/2014 05:00:00 AM,48,-122,1,2,3
4806,ElliotBayTrailMyrtlePark,07/20/2014 06:00:00 AM,48,-122,3,5,8
4807,ElliotBayTrailMyrtlePark,07/20/2014 07:00:00 AM,48,-122,6,7,13
4808,ElliotBayTrailMyrtlePark,07/20/2014 08:00:00 AM,48,-122,10,11,21
4809,ElliotBayTrailMyrtlePark,07/20/2014 09:00:00 AM,48,-122,30,22,52
4810,ElliotBayTrailMyrtlePark,07/20/2014 10:00:00 AM,48,-122,22,38,60
4811,ElliotBayTrailMyrtlePark,07/20/2014 11:00:00 AM,48,-122,39,34,73
4812,ElliotBayTrailMyrtlePark,07/20/2014 12:00:00 PM,48,-122,45,48,93
4813,ElliotBayTrailMyrtlePark,07/20/2014 01:00:00 PM,48,-122,57,38,95
4814,ElliotBayTrailMyrtlePark,07/20/2014 02:00:00 PM,48,-122,63,33,96
4815,ElliotBayTrailMyrtlePark,07/20/2014 03:00:00 PM,48,-122,68,59,127
4816,ElliotBayTrailMyrtlePark,07/20/2014 04:00:00 PM,48,-122,37,46,83
4817,ElliotBayTrailMyrtlePark,07/20/2014 05:00:00 PM,48,-122,33,23,56
4818,ElliotBayTrailMyrtlePark,07/20/2014 06:00:00 PM,48,-122,36,26,62
4819,ElliotBayTrailMyrtlePark,07/20/2014 07:00:00 PM,48,-122,23,9,32
4820,ElliotBayTrailMyrtlePark,07/20/2014 08:00:00 PM,48,-122,12,8,20
4821,ElliotBayTrailMyrtlePark,07/20/2014 09:00:00 PM,48,-122,2,1,3
4822,ElliotBayTrailMyrtlePark,07/20/2014 10:00:00 PM,48,-122,3,2,5
4823,ElliotBayTrailMyrtlePark,07/20/2014 11:00:00 PM,48,-122,1,0,1
4824,ElliotBayTrailMyrtlePark,07/21/2014 12:00:00 AM,48,-122,0,0,0
4825,ElliotBayTrailMyrtlePark,07/21/2014 01:00:00 AM,48,-122,0,2,2
4826,ElliotBayTrailMyrtlePark,07/21/2014 02:00:00 AM,48,-122,2,0,2
4827,ElliotBayTrailMyrtlePark,07/21/2014 03:00:00 AM,48,-122,2,2,4
4828,ElliotBayTrailMyrtlePark,07/21/2014 04:00:00 AM,48,-122,0,3,3
4829,ElliotBayTrailMyrtlePark,07/21/2014 05:00:00 AM,48,-122,13,20,33
4830,ElliotBayTrailMyrtlePark,07/21/2014 06:00:00 AM,48,-122,24,35,59
4831,ElliotBayTrailMyrtlePark,07/21/2014 07:00:00 AM,48,-122,55,103,158
4832,ElliotBayTrailMyrtlePark,07/21/2014 08:00:00 AM,48,-122,59,158,217
4833,ElliotBayTrailMyrtlePark,07/21/2014 09:00:00 AM,48,-122,36,73,109
4834,ElliotBayTrailMyrtlePark,07/21/2014 10:00:00 AM,48,-122,17,29,46
4835,ElliotBayTrailMyrtlePark,07/21/2014 11:00:00 AM,48,-122,29,27,56
4836,ElliotBayTrailMyrtlePark,07/21/2014 12:00:00 PM,48,-122,21,25,46
4837,ElliotBayTrailMyrtlePark,07/21/2014 01:00:00 PM,48,-122,32,23,55
4838,ElliotBayTrailMyrtlePark,07/21/2014 02:00:00 PM,48,-122,32,32,64
4839,ElliotBayTrailMyrtlePark,07/21/2014 03:00:00 PM,48,-122,53,35,88
4840,ElliotBayTrailMyrtlePark,07/21/2014 04:00:00 PM,48,-122,105,81,186
4841,ElliotBayTrailMyrtlePark,07/21/2014 05:00:00 PM,48,-122,242,94,336
4842,ElliotBayTrailMyrtlePark,07/21/2014 06:00:00 PM,48,-122,154,83,237
4843,ElliotBayTrailMyrtlePark,07/21/2014 07:00:00 PM,48,-122,80,68,148
4844,ElliotBayTrailMyrtlePark,07/21/2014 08:00:00 PM,48,-122,55,39,94
4845,ElliotBayTrailMyrtlePark,07/21/2014 09:00:00 PM,48,-122,15,4,19
4846,ElliotBayTrailMyrtlePark,07/21/2014 10:00:00 PM,48,-122,17,7,24
4847,ElliotBayTrailMyrtlePark,07/21/2014 11:00:00 PM,48,-122,4,2,6
4848,ElliotBayTrailMyrtlePark,07/22/2014 12:00:00 AM,48,-122,4,3,7
4849,ElliotBayTrailMyrtlePark,07/22/2014 01:00:00 AM,48,-122,0,1,1
4850,ElliotBayTrailMyrtlePark,07/22/2014 02:00:00 AM,48,-122,3,0,3
4851,ElliotBayTrailMyrtlePark,07/22/2014 03:00:00 AM,48,-122,1,0,1
4852,ElliotBayTrailMyrtlePark,07/22/2014 04:00:00 AM,48,-122,0,2,2
4853,ElliotBayTrailMyrtlePark,07/22/2014 05:00:00 AM,48,-122,21,24,45
4854,ElliotBayTrailMyrtlePark,07/22/2014 06:00:00 AM,48,-122,31,54,85
4855,ElliotBayTrailMyrtlePark,07/22/2014 07:00:00 AM,48,-122,58,159,217
4856,ElliotBayTrailMyrtlePark,07/22/2014 08:00:00 AM,48,-122,46,167,213
4857,ElliotBayTrailMyrtlePark,07/22/2014 09:00:00 AM,48,-122,39,75,114
4858,ElliotBayTrailMyrtlePark,07/22/2014 10:00:00 AM,48,-122,19,26,45
4859,ElliotBayTrailMyrtlePark,07/22/2014 11:00:00 AM,48,-122,15,17,32
4860,ElliotBayTrailMyrtlePark,07/22/2014 12:00:00 PM,48,-122,26,33,59
4861,ElliotBayTrailMyrtlePark,07/22/2014 01:00:00 PM,48,-122,27,35,62
4862,ElliotBayTrailMyrtlePark,07/22/2014 02:00:00 PM,48,-122,34,31,65
4863,ElliotBayTrailMyrtlePark,07/22/2014 03:00:00 PM,48,-122,47,35,82
4864,ElliotBayTrailMyrtlePark,07/22/2014 04:00:00 PM,48,-122,104,63,167
4865,ElliotBayTrailMyrtlePark,07/22/2014 05:00:00 PM,48,-122,228,85,313
4866,ElliotBayTrailMyrtlePark,07/22/2014 06:00:00 PM,48,-122,173,64,237
4867,ElliotBayTrailMyrtlePark,07/22/2014 07:00:00 PM,48,-122,85,63,148
4868,ElliotBayTrailMyrtlePark,07/22/2014 08:00:00 PM,48,-122,44,23,67
4869,ElliotBayTrailMyrtlePark,07/22/2014 09:00:00 PM,48,-122,12,13,25
4870,ElliotBayTrailMyrtlePark,07/22/2014 10:00:00 PM,48,-122,15,3,18
4871,ElliotBayTrailMyrtlePark,07/22/2014 11:00:00 PM,48,-122,2,2,4
4872,ElliotBayTrailMyrtlePark,07/23/2014 12:00:00 AM,48,-122,2,1,3
4873,ElliotBayTrailMyrtlePark,07/23/2014 01:00:00 AM,48,-122,0,0,0
4874,ElliotBayTrailMyrtlePark,07/23/2014 02:00:00 AM,48,-122,1,0,1
4875,ElliotBayTrailMyrtlePark,07/23/2014 03:00:00 AM,48,-122,2,1,3
4876,ElliotBayTrailMyrtlePark,07/23/2014 04:00:00 AM,48,-122,0,2,2
4877,ElliotBayTrailMyrtlePark,07/23/2014 05:00:00 AM,48,-122,13,21,34
4878,ElliotBayTrailMyrtlePark,07/23/2014 06:00:00 AM,48,-122,17,32,49
4879,ElliotBayTrailMyrtlePark,07/23/2014 07:00:00 AM,48,-122,33,45,78
4880,ElliotBayTrailMyrtlePark,07/23/2014 08:00:00 AM,48,-122,15,75,90
4881,ElliotBayTrailMyrtlePark,07/23/2014 09:00:00 AM,48,-122,7,46,53
4882,ElliotBayTrailMyrtlePark,07/23/2014 10:00:00 AM,48,-122,6,11,17
4883,ElliotBayTrailMyrtlePark,07/23/2014 11:00:00 AM,48,-122,4,5,9
4884,ElliotBayTrailMyrtlePark,07/23/2014 12:00:00 PM,48,-122,8,3,11
4885,ElliotBayTrailMyrtlePark,07/23/2014 01:00:00 PM,48,-122,8,5,13
4886,ElliotBayTrailMyrtlePark,07/23/2014 02:00:00 PM,48,-122,7,8,15
4887,ElliotBayTrailMyrtlePark,07/23/2014 03:00:00 PM,48,-122,13,8,21
4888,ElliotBayTrailMyrtlePark,07/23/2014 04:00:00 PM,48,-122,40,22,62
4889,ElliotBayTrailMyrtlePark,07/23/2014 05:00:00 PM,48,-122,94,20,114
4890,ElliotBayTrailMyrtlePark,07/23/2014 06:00:00 PM,48,-122,70,17,87
4891,ElliotBayTrailMyrtlePark,07/23/2014 07:00:00 PM,48,-122,34,18,52
4892,ElliotBayTrailMyrtlePark,07/23/2014 08:00:00 PM,48,-122,11,11,22
4893,ElliotBayTrailMyrtlePark,07/23/2014 09:00:00 PM,48,-122,8,8,16
4894,ElliotBayTrailMyrtlePark,07/23/2014 10:00:00 PM,48,-122,4,2,6
4895,ElliotBayTrailMyrtlePark,07/23/2014 11:00:00 PM,48,-122,5,0,5
4896,ElliotBayTrailMyrtlePark,07/24/2014 12:00:00 AM,48,-122,2,0,2
4897,ElliotBayTrailMyrtlePark,07/24/2014 01:00:00 AM,48,-122,1,0,1
4898,ElliotBayTrailMyrtlePark,07/24/2014 02:00:00 AM,48,-122,1,0,1
4899,ElliotBayTrailMyrtlePark,07/24/2014 03:00:00 AM,48,-122,2,0,2
4900,ElliotBayTrailMyrtlePark,07/24/2014 04:00:00 AM,48,-122,0,1,1
4901,ElliotBayTrailMyrtlePark,07/24/2014 05:00:00 AM,48,-122,11,20,31
4902,ElliotBayTrailMyrtlePark,07/24/2014 06:00:00 AM,48,-122,25,22,47
4903,ElliotBayTrailMyrtlePark,07/24/2014 07:00:00 AM,48,-122,39,58,97
4904,ElliotBayTrailMyrtlePark,07/24/2014 08:00:00 AM,48,-122,29,96,125
4905,ElliotBayTrailMyrtlePark,07/24/2014 09:00:00 AM,48,-122,23,61,84
4906,ElliotBayTrailMyrtlePark,07/24/2014 10:00:00 AM,48,-122,17,22,39
4907,ElliotBayTrailMyrtlePark,07/24/2014 11:00:00 AM,48,-122,24,20,44
4908,ElliotBayTrailMyrtlePark,07/24/2014 12:00:00 PM,48,-122,14,18,32
4909,ElliotBayTrailMyrtlePark,07/24/2014 01:00:00 PM,48,-122,17,30,47
4910,ElliotBayTrailMyrtlePark,07/24/2014 02:00:00 PM,48,-122,11,23,34
4911,ElliotBayTrailMyrtlePark,07/24/2014 03:00:00 PM,48,-122,28,21,49
4912,ElliotBayTrailMyrtlePark,07/24/2014 04:00:00 PM,48,-122,52,42,94
4913,ElliotBayTrailMyrtlePark,07/24/2014 05:00:00 PM,48,-122,135,52,187
4914,ElliotBayTrailMyrtlePark,07/24/2014 06:00:00 PM,48,-122,105,32,137
4915,ElliotBayTrailMyrtlePark,07/24/2014 07:00:00 PM,48,-122,49,15,64
4916,ElliotBayTrailMyrtlePark,07/24/2014 08:00:00 PM,48,-122,26,13,39
4917,ElliotBayTrailMyrtlePark,07/24/2014 09:00:00 PM,48,-122,8,5,13
4918,ElliotBayTrailMyrtlePark,07/24/2014 10:00:00 PM,48,-122,8,3,11
4919,ElliotBayTrailMyrtlePark,07/24/2014 11:00:00 PM,48,-122,10,5,15
4920,ElliotBayTrailMyrtlePark,07/25/2014 12:00:00 AM,48,-122,3,2,5
4921,ElliotBayTrailMyrtlePark,07/25/2014 01:00:00 AM,48,-122,0,0,0
4922,ElliotBayTrailMyrtlePark,07/25/2014 02:00:00 AM,48,-122,5,0,5
4923,ElliotBayTrailMyrtlePark,07/25/2014 03:00:00 AM,48,-122,5,2,7
4924,ElliotBayTrailMyrtlePark,07/25/2014 04:00:00 AM,48,-122,3,2,5
4925,ElliotBayTrailMyrtlePark,07/25/2014 05:00:00 AM,48,-122,12,17,29
4926,ElliotBayTrailMyrtlePark,07/25/2014 06:00:00 AM,48,-122,24,38,62
4927,ElliotBayTrailMyrtlePark,07/25/2014 07:00:00 AM,48,-122,46,94,140
4928,ElliotBayTrailMyrtlePark,07/25/2014 08:00:00 AM,48,-122,39,113,152
4929,ElliotBayTrailMyrtlePark,07/25/2014 09:00:00 AM,48,-122,21,77,98
4930,ElliotBayTrailMyrtlePark,07/25/2014 10:00:00 AM,48,-122,22,44,66
4931,ElliotBayTrailMyrtlePark,07/25/2014 11:00:00 AM,48,-122,36,31,67
4932,ElliotBayTrailMyrtlePark,07/25/2014 12:00:00 PM,48,-122,31,23,54
4933,ElliotBayTrailMyrtlePark,07/25/2014 01:00:00 PM,48,-122,48,64,112
4934,ElliotBayTrailMyrtlePark,07/25/2014 02:00:00 PM,48,-122,51,56,107
4935,ElliotBayTrailMyrtlePark,07/25/2014 03:00:00 PM,48,-122,55,44,99
4936,ElliotBayTrailMyrtlePark,07/25/2014 04:00:00 PM,48,-122,141,64,205
4937,ElliotBayTrailMyrtlePark,07/25/2014 05:00:00 PM,48,-122,183,73,256
4938,ElliotBayTrailMyrtlePark,07/25/2014 06:00:00 PM,48,-122,120,78,198
4939,ElliotBayTrailMyrtlePark,07/25/2014 07:00:00 PM,48,-122,49,34,83
4940,ElliotBayTrailMyrtlePark,07/25/2014 08:00:00 PM,48,-122,41,30,71
4941,ElliotBayTrailMyrtlePark,07/25/2014 09:00:00 PM,48,-122,9,11,20
4942,ElliotBayTrailMyrtlePark,07/25/2014 10:00:00 PM,48,-122,10,5,15
4943,ElliotBayTrailMyrtlePark,07/25/2014 11:00:00 PM,48,-122,15,2,17
4944,ElliotBayTrailMyrtlePark,07/26/2014 12:00:00 AM,48,-122,6,2,8
4945,ElliotBayTrailMyrtlePark,07/26/2014 01:00:00 AM,48,-122,3,0,3
4946,ElliotBayTrailMyrtlePark,07/26/2014 02:00:00 AM,48,-122,1,0,1
4947,ElliotBayTrailMyrtlePark,07/26/2014 03:00:00 AM,48,-122,2,0,2
4948,ElliotBayTrailMyrtlePark,07/26/2014 04:00:00 AM,48,-122,4,1,5
4949,ElliotBayTrailMyrtlePark,07/26/2014 05:00:00 AM,48,-122,0,4,4
4950,ElliotBayTrailMyrtlePark,07/26/2014 06:00:00 AM,48,-122,8,12,20
4951,ElliotBayTrailMyrtlePark,07/26/2014 07:00:00 AM,48,-122,13,15,28
4952,ElliotBayTrailMyrtlePark,07/26/2014 08:00:00 AM,48,-122,28,23,51
4953,ElliotBayTrailMyrtlePark,07/26/2014 09:00:00 AM,48,-122,31,36,67
4954,ElliotBayTrailMyrtlePark,07/26/2014 10:00:00 AM,48,-122,55,48,103
4955,ElliotBayTrailMyrtlePark,07/26/2014 11:00:00 AM,48,-122,62,75,137
4956,ElliotBayTrailMyrtlePark,07/26/2014 12:00:00 PM,48,-122,73,82,155
4957,ElliotBayTrailMyrtlePark,07/26/2014 01:00:00 PM,48,-122,82,87,169
4958,ElliotBayTrailMyrtlePark,07/26/2014 02:00:00 PM,48,-122,90,78,168
4959,ElliotBayTrailMyrtlePark,07/26/2014 03:00:00 PM,48,-122,98,85,183
4960,ElliotBayTrailMyrtlePark,07/26/2014 04:00:00 PM,48,-122,105,66,171
4961,ElliotBayTrailMyrtlePark,07/26/2014 05:00:00 PM,48,-122,68,75,143
4962,ElliotBayTrailMyrtlePark,07/26/2014 06:00:00 PM,48,-122,58,62,120
4963,ElliotBayTrailMyrtlePark,07/26/2014 07:00:00 PM,48,-122,39,28,67
4964,ElliotBayTrailMyrtlePark,07/26/2014 08:00:00 PM,48,-122,43,30,73
4965,ElliotBayTrailMyrtlePark,07/26/2014 09:00:00 PM,48,-122,15,9,24
4966,ElliotBayTrailMyrtlePark,07/26/2014 10:00:00 PM,48,-122,15,7,22
4967,ElliotBayTrailMyrtlePark,07/26/2014 11:00:00 PM,48,-122,8,0,8
4968,ElliotBayTrailMyrtlePark,07/27/2014 12:00:00 AM,48,-122,3,2,5
4969,ElliotBayTrailMyrtlePark,07/27/2014 01:00:00 AM,48,-122,2,0,2
4970,ElliotBayTrailMyrtlePark,07/27/2014 02:00:00 AM,48,-122,4,1,5
4971,ElliotBayTrailMyrtlePark,07/27/2014 03:00:00 AM,48,-122,1,0,1
4972,ElliotBayTrailMyrtlePark,07/27/2014 04:00:00 AM,48,-122,1,1,2
4973,ElliotBayTrailMyrtlePark,07/27/2014 05:00:00 AM,48,-122,1,3,4
4974,ElliotBayTrailMyrtlePark,07/27/2014 06:00:00 AM,48,-122,4,1,5
4975,ElliotBayTrailMyrtlePark,07/27/2014 07:00:00 AM,48,-122,13,16,29
4976,ElliotBayTrailMyrtlePark,07/27/2014 08:00:00 AM,48,-122,31,20,51
4977,ElliotBayTrailMyrtlePark,07/27/2014 09:00:00 AM,48,-122,37,42,79
4978,ElliotBayTrailMyrtlePark,07/27/2014 10:00:00 AM,48,-122,41,53,94
4979,ElliotBayTrailMyrtlePark,07/27/2014 11:00:00 AM,48,-122,77,67,144
4980,ElliotBayTrailMyrtlePark,07/27/2014 12:00:00 PM,48,-122,96,91,187
4981,ElliotBayTrailMyrtlePark,07/27/2014 01:00:00 PM,48,-122,92,92,184
4982,ElliotBayTrailMyrtlePark,07/27/2014 02:00:00 PM,48,-122,83,73,156
4983,ElliotBayTrailMyrtlePark,07/27/2014 03:00:00 PM,48,-122,101,84,185
4984,ElliotBayTrailMyrtlePark,07/27/2014 04:00:00 PM,48,-122,75,57,132
4985,ElliotBayTrailMyrtlePark,07/27/2014 05:00:00 PM,48,-122,76,67,143
4986,ElliotBayTrailMyrtlePark,07/27/2014 06:00:00 PM,48,-122,67,48,115
4987,ElliotBayTrailMyrtlePark,07/27/2014 07:00:00 PM,48,-122,47,38,85
4988,ElliotBayTrailMyrtlePark,07/27/2014 08:00:00 PM,48,-122,27,40,67
4989,ElliotBayTrailMyrtlePark,07/27/2014 09:00:00 PM,48,-122,17,11,28
4990,ElliotBayTrailMyrtlePark,07/27/2014 10:00:00 PM,48,-122,15,4,19
4991,ElliotBayTrailMyrtlePark,07/27/2014 11:00:00 PM,48,-122,5,5,10
4992,ElliotBayTrailMyrtlePark,07/28/2014 12:00:00 AM,48,-122,2,1,3
4993,ElliotBayTrailMyrtlePark,07/28/2014 01:00:00 AM,48,-122,1,0,1
4994,ElliotBayTrailMyrtlePark,07/28/2014 02:00:00 AM,48,-122,3,1,4
4995,ElliotBayTrailMyrtlePark,07/28/2014 03:00:00 AM,48,-122,1,0,1
4996,ElliotBayTrailMyrtlePark,07/28/2014 04:00:00 AM,48,-122,0,0,0
4997,ElliotBayTrailMyrtlePark,07/28/2014 05:00:00 AM,48,-122,14,22,36
4998,ElliotBayTrailMyrtlePark,07/28/2014 06:00:00 AM,48,-122,28,47,75
4999,ElliotBayTrailMyrtlePark,07/28/2014 07:00:00 AM,48,-122,62,131,193
5000,ElliotBayTrailMyrtlePark,07/28/2014 08:00:00 AM,48,-122,90,137,227
5001,ElliotBayTrailMyrtlePark,07/28/2014 09:00:00 AM,48,-122,50,88,138
5002,ElliotBayTrailMyrtlePark,07/28/2014 10:00:00 AM,48,-122,39,36,75
5003,ElliotBayTrailMyrtlePark,07/28/2014 11:00:00 AM,48,-122,27,40,67
5004,ElliotBayTrailMyrtlePark,07/28/2014 12:00:00 PM,48,-122,34,32,66
5005,ElliotBayTrailMyrtlePark,07/28/2014 01:00:00 PM,48,-122,32,28,60
5006,ElliotBayTrailMyrtlePark,07/28/2014 02:00:00 PM,48,-122,34,40,74
5007,ElliotBayTrailMyrtlePark,07/28/2014 03:00:00 PM,48,-122,61,46,107
5008,ElliotBayTrailMyrtlePark,07/28/2014 04:00:00 PM,48,-122,125,63,188
5009,ElliotBayTrailMyrtlePark,07/28/2014 05:00:00 PM,48,-122,248,107,355
5010,ElliotBayTrailMyrtlePark,07/28/2014 06:00:00 PM,48,-122,160,87,247
5011,ElliotBayTrailMyrtlePark,07/28/2014 07:00:00 PM,48,-122,62,38,100
5012,ElliotBayTrailMyrtlePark,07/28/2014 08:00:00 PM,48,-122,41,27,68
5013,ElliotBayTrailMyrtlePark,07/28/2014 09:00:00 PM,48,-122,60,21,81
5014,ElliotBayTrailMyrtlePark,07/28/2014 10:00:00 PM,48,-122,22,4,26
5015,ElliotBayTrailMyrtlePark,07/28/2014 11:00:00 PM,48,-122,8,1,9
5016,ElliotBayTrailMyrtlePark,07/29/2014 12:00:00 AM,48,-122,2,2,4
5017,ElliotBayTrailMyrtlePark,07/29/2014 01:00:00 AM,48,-122,1,0,1
5018,ElliotBayTrailMyrtlePark,07/29/2014 02:00:00 AM,48,-122,1,0,1
5019,ElliotBayTrailMyrtlePark,07/29/2014 03:00:00 AM,48,-122,1,0,1
5020,ElliotBayTrailMyrtlePark,07/29/2014 04:00:00 AM,48,-122,1,0,1
5021,ElliotBayTrailMyrtlePark,07/29/2014 05:00:00 AM,48,-122,10,24,34
5022,ElliotBayTrailMyrtlePark,07/29/2014 06:00:00 AM,48,-122,29,49,78
5023,ElliotBayTrailMyrtlePark,07/29/2014 07:00:00 AM,48,-122,60,152,212
5024,ElliotBayTrailMyrtlePark,07/29/2014 08:00:00 AM,48,-122,91,153,244
5025,ElliotBayTrailMyrtlePark,07/29/2014 09:00:00 AM,48,-122,59,50,109
5026,ElliotBayTrailMyrtlePark,07/29/2014 10:00:00 AM,48,-122,28,55,83
5027,ElliotBayTrailMyrtlePark,07/29/2014 11:00:00 AM,48,-122,28,43,71
5028,ElliotBayTrailMyrtlePark,07/29/2014 12:00:00 PM,48,-122,45,45,90
5029,ElliotBayTrailMyrtlePark,07/29/2014 01:00:00 PM,48,-122,40,40,80
5030,ElliotBayTrailMyrtlePark,07/29/2014 02:00:00 PM,48,-122,46,42,88
5031,ElliotBayTrailMyrtlePark,07/29/2014 03:00:00 PM,48,-122,67,47,114
5032,ElliotBayTrailMyrtlePark,07/29/2014 04:00:00 PM,48,-122,135,80,215
5033,ElliotBayTrailMyrtlePark,07/29/2014 05:00:00 PM,48,-122,287,89,376
5034,ElliotBayTrailMyrtlePark,07/29/2014 06:00:00 PM,48,-122,180,74,254
5035,ElliotBayTrailMyrtlePark,07/29/2014 07:00:00 PM,48,-122,83,43,126
5036,ElliotBayTrailMyrtlePark,07/29/2014 08:00:00 PM,48,-122,61,46,107
5037,ElliotBayTrailMyrtlePark,07/29/2014 09:00:00 PM,48,-122,20,8,28
5038,ElliotBayTrailMyrtlePark,07/29/2014 10:00:00 PM,48,-122,9,8,17
5039,ElliotBayTrailMyrtlePark,07/29/2014 11:00:00 PM,48,-122,10,2,12
5040,ElliotBayTrailMyrtlePark,07/30/2014 12:00:00 AM,48,-122,1,3,4
5041,ElliotBayTrailMyrtlePark,07/30/2014 01:00:00 AM,48,-122,1,3,4
5042,ElliotBayTrailMyrtlePark,07/30/2014 02:00:00 AM,48,-122,1,0,1
5043,ElliotBayTrailMyrtlePark,07/30/2014 03:00:00 AM,48,-122,1,0,1
5044,ElliotBayTrailMyrtlePark,07/30/2014 04:00:00 AM,48,-122,0,1,1
5045,ElliotBayTrailMyrtlePark,07/30/2014 05:00:00 AM,48,-122,5,23,28
5046,ElliotBayTrailMyrtlePark,07/30/2014 06:00:00 AM,48,-122,33,54,87
5047,ElliotBayTrailMyrtlePark,07/30/2014 07:00:00 AM,48,-122,53,161,214
5048,ElliotBayTrailMyrtlePark,07/30/2014 08:00:00 AM,48,-122,86,145,231
5049,ElliotBayTrailMyrtlePark,07/30/2014 09:00:00 AM,48,-122,45,88,133
5050,ElliotBayTrailMyrtlePark,07/30/2014 10:00:00 AM,48,-122,30,43,73
5051,ElliotBayTrailMyrtlePark,07/30/2014 11:00:00 AM,48,-122,27,36,63
5052,ElliotBayTrailMyrtlePark,07/30/2014 12:00:00 PM,48,-122,30,43,73
5053,ElliotBayTrailMyrtlePark,07/30/2014 01:00:00 PM,48,-122,41,35,76
5054,ElliotBayTrailMyrtlePark,07/30/2014 02:00:00 PM,48,-122,38,38,76
5055,ElliotBayTrailMyrtlePark,07/30/2014 03:00:00 PM,48,-122,59,59,118
5056,ElliotBayTrailMyrtlePark,07/30/2014 04:00:00 PM,48,-122,139,67,206
5057,ElliotBayTrailMyrtlePark,07/30/2014 05:00:00 PM,48,-122,257,92,349
5058,ElliotBayTrailMyrtlePark,07/30/2014 06:00:00 PM,48,-122,183,73,256
5059,ElliotBayTrailMyrtlePark,07/30/2014 07:00:00 PM,48,-122,97,66,163
5060,ElliotBayTrailMyrtlePark,07/30/2014 08:00:00 PM,48,-122,57,48,105
5061,ElliotBayTrailMyrtlePark,07/30/2014 09:00:00 PM,48,-122,10,21,31
5062,ElliotBayTrailMyrtlePark,07/30/2014 10:00:00 PM,48,-122,7,11,18
5063,ElliotBayTrailMyrtlePark,07/30/2014 11:00:00 PM,48,-122,6,1,7
5064,ElliotBayTrailMyrtlePark,07/31/2014 12:00:00 AM,48,-122,5,1,6
5065,ElliotBayTrailMyrtlePark,07/31/2014 01:00:00 AM,48,-122,1,2,3
5066,ElliotBayTrailMyrtlePark,07/31/2014 02:00:00 AM,48,-122,2,0,2
5067,ElliotBayTrailMyrtlePark,07/31/2014 03:00:00 AM,48,-122,1,0,1
5068,ElliotBayTrailMyrtlePark,07/31/2014 04:00:00 AM,48,-122,2,1,3
5069,ElliotBayTrailMyrtlePark,07/31/2014 05:00:00 AM,48,-122,9,18,27
5070,ElliotBayTrailMyrtlePark,07/31/2014 06:00:00 AM,48,-122,37,48,85
5071,ElliotBayTrailMyrtlePark,07/31/2014 07:00:00 AM,48,-122,44,142,186
5072,ElliotBayTrailMyrtlePark,07/31/2014 08:00:00 AM,48,-122,72,124,196
5073,ElliotBayTrailMyrtlePark,07/31/2014 09:00:00 AM,48,-122,51,60,111
5074,ElliotBayTrailMyrtlePark,07/31/2014 10:00:00 AM,48,-122,35,37,72
5075,ElliotBayTrailMyrtlePark,07/31/2014 11:00:00 AM,48,-122,18,35,53
5076,ElliotBayTrailMyrtlePark,07/31/2014 12:00:00 PM,48,-122,30,37,67
5077,ElliotBayTrailMyrtlePark,07/31/2014 01:00:00 PM,48,-122,25,28,53
5078,ElliotBayTrailMyrtlePark,07/31/2014 02:00:00 PM,48,-122,53,47,100
5079,ElliotBayTrailMyrtlePark,07/31/2014 03:00:00 PM,48,-122,57,57,114
5080,ElliotBayTrailMyrtlePark,07/31/2014 04:00:00 PM,48,-122,105,64,169
5081,ElliotBayTrailMyrtlePark,07/31/2014 05:00:00 PM,48,-122,231,82,313
5082,ElliotBayTrailMyrtlePark,07/31/2014 06:00:00 PM,48,-122,168,72,240
5083,ElliotBayTrailMyrtlePark,07/31/2014 07:00:00 PM,48,-122,82,52,134
5084,ElliotBayTrailMyrtlePark,07/31/2014 08:00:00 PM,48,-122,58,46,104
5085,ElliotBayTrailMyrtlePark,07/31/2014 09:00:00 PM,48,-122,10,10,20
5086,ElliotBayTrailMyrtlePark,07/31/2014 10:00:00 PM,48,-122,25,4,29
5087,ElliotBayTrailMyrtlePark,07/31/2014 11:00:00 PM,48,-122,6,1,7
5088,ElliotBayTrailMyrtlePark,08/01/2014 12:00:00 AM,48,-122,6,0,6
5089,ElliotBayTrailMyrtlePark,08/01/2014 01:00:00 AM,48,-122,3,0,3
5090,ElliotBayTrailMyrtlePark,08/01/2014 02:00:00 AM,48,-122,1,0,1
5091,ElliotBayTrailMyrtlePark,08/01/2014 03:00:00 AM,48,-122,1,1,2
5092,ElliotBayTrailMyrtlePark,08/01/2014 04:00:00 AM,48,-122,1,1,2
5093,ElliotBayTrailMyrtlePark,08/01/2014 05:00:00 AM,48,-122,6,14,20
5094,ElliotBayTrailMyrtlePark,08/01/2014 06:00:00 AM,48,-122,27,49,76
5095,ElliotBayTrailMyrtlePark,08/01/2014 07:00:00 AM,48,-122,56,105,161
5096,ElliotBayTrailMyrtlePark,08/01/2014 08:00:00 AM,48,-122,70,121,191
5097,ElliotBayTrailMyrtlePark,08/01/2014 09:00:00 AM,48,-122,60,56,116
5098,ElliotBayTrailMyrtlePark,08/01/2014 10:00:00 AM,48,-122,21,38,59
5099,ElliotBayTrailMyrtlePark,08/01/2014 11:00:00 AM,48,-122,25,39,64
5100,ElliotBayTrailMyrtlePark,08/01/2014 12:00:00 PM,48,-122,26,43,69
5101,ElliotBayTrailMyrtlePark,08/01/2014 01:00:00 PM,48,-122,41,26,67
5102,ElliotBayTrailMyrtlePark,08/01/2014 02:00:00 PM,48,-122,36,48,84
5103,ElliotBayTrailMyrtlePark,08/01/2014 03:00:00 PM,48,-122,58,39,97
5104,ElliotBayTrailMyrtlePark,08/01/2014 04:00:00 PM,48,-122,100,53,153
5105,ElliotBayTrailMyrtlePark,08/01/2014 05:00:00 PM,48,-122,177,74,251
5106,ElliotBayTrailMyrtlePark,08/01/2014 06:00:00 PM,48,-122,117,57,174
5107,ElliotBayTrailMyrtlePark,08/01/2014 07:00:00 PM,48,-122,49,39,88
5108,ElliotBayTrailMyrtlePark,08/01/2014 08:00:00 PM,48,-122,39,26,65
5109,ElliotBayTrailMyrtlePark,08/01/2014 09:00:00 PM,48,-122,11,9,20
5110,ElliotBayTrailMyrtlePark,08/01/2014 10:00:00 PM,48,-122,12,18,30
5111,ElliotBayTrailMyrtlePark,08/01/2014 11:00:00 PM,48,-122,14,3,17
5112,ElliotBayTrailMyrtlePark,08/02/2014 12:00:00 AM,48,-122,14,1,15
5113,ElliotBayTrailMyrtlePark,08/02/2014 01:00:00 AM,48,-122,18,2,20
5114,ElliotBayTrailMyrtlePark,08/02/2014 02:00:00 AM,48,-122,10,0,10
5115,ElliotBayTrailMyrtlePark,08/02/2014 03:00:00 AM,48,-122,7,1,8
5116,ElliotBayTrailMyrtlePark,08/02/2014 04:00:00 AM,48,-122,1,0,1
5117,ElliotBayTrailMyrtlePark,08/02/2014 05:00:00 AM,48,-122,1,4,5
5118,ElliotBayTrailMyrtlePark,08/02/2014 06:00:00 AM,48,-122,4,9,13
5119,ElliotBayTrailMyrtlePark,08/02/2014 07:00:00 AM,48,-122,16,24,40
5120,ElliotBayTrailMyrtlePark,08/02/2014 08:00:00 AM,48,-122,23,27,50
5121,ElliotBayTrailMyrtlePark,08/02/2014 09:00:00 AM,48,-122,38,36,74
5122,ElliotBayTrailMyrtlePark,08/02/2014 10:00:00 AM,48,-122,31,56,87
5123,ElliotBayTrailMyrtlePark,08/02/2014 11:00:00 AM,48,-122,56,44,100
5124,ElliotBayTrailMyrtlePark,08/02/2014 12:00:00 PM,48,-122,64,59,123
5125,ElliotBayTrailMyrtlePark,08/02/2014 01:00:00 PM,48,-122,33,47,80
5126,ElliotBayTrailMyrtlePark,08/02/2014 02:00:00 PM,48,-122,82,49,131
5127,ElliotBayTrailMyrtlePark,08/02/2014 03:00:00 PM,48,-122,57,59,116
5128,ElliotBayTrailMyrtlePark,08/02/2014 04:00:00 PM,48,-122,64,65,129
5129,ElliotBayTrailMyrtlePark,08/02/2014 05:00:00 PM,48,-122,66,64,130
5130,ElliotBayTrailMyrtlePark,08/02/2014 06:00:00 PM,48,-122,63,31,94
5131,ElliotBayTrailMyrtlePark,08/02/2014 07:00:00 PM,48,-122,36,36,72
5132,ElliotBayTrailMyrtlePark,08/02/2014 08:00:00 PM,48,-122,41,21,62
5133,ElliotBayTrailMyrtlePark,08/02/2014 09:00:00 PM,48,-122,6,10,16
5134,ElliotBayTrailMyrtlePark,08/02/2014 10:00:00 PM,48,-122,9,2,11
5135,ElliotBayTrailMyrtlePark,08/02/2014 11:00:00 PM,48,-122,7,6,13
5136,ElliotBayTrailMyrtlePark,08/03/2014 12:00:00 AM,48,-122,3,0,3
5137,ElliotBayTrailMyrtlePark,08/03/2014 01:00:00 AM,48,-122,1,1,2
5138,ElliotBayTrailMyrtlePark,08/03/2014 02:00:00 AM,48,-122,2,1,3
5139,ElliotBayTrailMyrtlePark,08/03/2014 03:00:00 AM,48,-122,1,0,1
5140,ElliotBayTrailMyrtlePark,08/03/2014 04:00:00 AM,48,-122,0,0,0
5141,ElliotBayTrailMyrtlePark,08/03/2014 05:00:00 AM,48,-122,0,3,3
5142,ElliotBayTrailMyrtlePark,08/03/2014 06:00:00 AM,48,-122,6,5,11
5143,ElliotBayTrailMyrtlePark,08/03/2014 07:00:00 AM,48,-122,8,16,24
5144,ElliotBayTrailMyrtlePark,08/03/2014 08:00:00 AM,48,-122,33,17,50
5145,ElliotBayTrailMyrtlePark,08/03/2014 09:00:00 AM,48,-122,50,38,88
5146,ElliotBayTrailMyrtlePark,08/03/2014 10:00:00 AM,48,-122,66,62,128
5147,ElliotBayTrailMyrtlePark,08/03/2014 11:00:00 AM,48,-122,68,114,182
5148,ElliotBayTrailMyrtlePark,08/03/2014 12:00:00 PM,48,-122,64,68,132
5149,ElliotBayTrailMyrtlePark,08/03/2014 01:00:00 PM,48,-122,101,44,145
5150,ElliotBayTrailMyrtlePark,08/03/2014 02:00:00 PM,48,-122,86,83,169
5151,ElliotBayTrailMyrtlePark,08/03/2014 03:00:00 PM,48,-122,106,76,182
5152,ElliotBayTrailMyrtlePark,08/03/2014 04:00:00 PM,48,-122,91,57,148
5153,ElliotBayTrailMyrtlePark,08/03/2014 05:00:00 PM,48,-122,77,58,135
5154,ElliotBayTrailMyrtlePark,08/03/2014 06:00:00 PM,48,-122,39,33,72
5155,ElliotBayTrailMyrtlePark,08/03/2014 07:00:00 PM,48,-122,53,42,95
5156,ElliotBayTrailMyrtlePark,08/03/2014 08:00:00 PM,48,-122,42,33,75
5157,ElliotBayTrailMyrtlePark,08/03/2014 09:00:00 PM,48,-122,18,33,51
5158,ElliotBayTrailMyrtlePark,08/03/2014 10:00:00 PM,48,-122,7,6,13
5159,ElliotBayTrailMyrtlePark,08/03/2014 11:00:00 PM,48,-122,3,1,4
5160,ElliotBayTrailMyrtlePark,08/04/2014 12:00:00 AM,48,-122,1,3,4
5161,ElliotBayTrailMyrtlePark,08/04/2014 01:00:00 AM,48,-122,0,0,0
5162,ElliotBayTrailMyrtlePark,08/04/2014 02:00:00 AM,48,-122,1,1,2
5163,ElliotBayTrailMyrtlePark,08/04/2014 03:00:00 AM,48,-122,2,0,2
5164,ElliotBayTrailMyrtlePark,08/04/2014 04:00:00 AM,48,-122,1,2,3
5165,ElliotBayTrailMyrtlePark,08/04/2014 05:00:00 AM,48,-122,9,22,31
5166,ElliotBayTrailMyrtlePark,08/04/2014 06:00:00 AM,48,-122,30,39,69
5167,ElliotBayTrailMyrtlePark,08/04/2014 07:00:00 AM,48,-122,69,125,194
5168,ElliotBayTrailMyrtlePark,08/04/2014 08:00:00 AM,48,-122,64,164,228
5169,ElliotBayTrailMyrtlePark,08/04/2014 09:00:00 AM,48,-122,59,63,122
5170,ElliotBayTrailMyrtlePark,08/04/2014 10:00:00 AM,48,-122,26,48,74
5171,ElliotBayTrailMyrtlePark,08/04/2014 11:00:00 AM,48,-122,30,38,68
5172,ElliotBayTrailMyrtlePark,08/04/2014 12:00:00 PM,48,-122,35,29,64
5173,ElliotBayTrailMyrtlePark,08/04/2014 01:00:00 PM,48,-122,27,42,69
5174,ElliotBayTrailMyrtlePark,08/04/2014 02:00:00 PM,48,-122,30,31,61
5175,ElliotBayTrailMyrtlePark,08/04/2014 03:00:00 PM,48,-122,60,43,103
5176,ElliotBayTrailMyrtlePark,08/04/2014 04:00:00 PM,48,-122,89,112,201
5177,ElliotBayTrailMyrtlePark,08/04/2014 05:00:00 PM,48,-122,247,78,325
5178,ElliotBayTrailMyrtlePark,08/04/2014 06:00:00 PM,48,-122,183,77,260
5179,ElliotBayTrailMyrtlePark,08/04/2014 07:00:00 PM,48,-122,77,42,119
5180,ElliotBayTrailMyrtlePark,08/04/2014 08:00:00 PM,48,-122,44,28,72
5181,ElliotBayTrailMyrtlePark,08/04/2014 09:00:00 PM,48,-122,15,11,26
5182,ElliotBayTrailMyrtlePark,08/04/2014 10:00:00 PM,48,-122,8,8,16
5183,ElliotBayTrailMyrtlePark,08/04/2014 11:00:00 PM,48,-122,3,2,5
5184,ElliotBayTrailMyrtlePark,08/05/2014 12:00:00 AM,48,-122,3,1,4
5185,ElliotBayTrailMyrtlePark,08/05/2014 01:00:00 AM,48,-122,5,0,5
5186,ElliotBayTrailMyrtlePark,08/05/2014 02:00:00 AM,48,-122,0,0,0
5187,ElliotBayTrailMyrtlePark,08/05/2014 03:00:00 AM,48,-122,2,1,3
5188,ElliotBayTrailMyrtlePark,08/05/2014 04:00:00 AM,48,-122,0,1,1
5189,ElliotBayTrailMyrtlePark,08/05/2014 05:00:00 AM,48,-122,6,19,25
5190,ElliotBayTrailMyrtlePark,08/05/2014 06:00:00 AM,48,-122,24,51,75
5191,ElliotBayTrailMyrtlePark,08/05/2014 07:00:00 AM,48,-122,56,135,191
5192,ElliotBayTrailMyrtlePark,08/05/2014 08:00:00 AM,48,-122,56,144,200
5193,ElliotBayTrailMyrtlePark,08/05/2014 09:00:00 AM,48,-122,36,78,114
5194,ElliotBayTrailMyrtlePark,08/05/2014 10:00:00 AM,48,-122,28,31,59
5195,ElliotBayTrailMyrtlePark,08/05/2014 11:00:00 AM,48,-122,21,26,47
5196,ElliotBayTrailMyrtlePark,08/05/2014 12:00:00 PM,48,-122,38,32,70
5197,ElliotBayTrailMyrtlePark,08/05/2014 01:00:00 PM,48,-122,19,38,57
5198,ElliotBayTrailMyrtlePark,08/05/2014 02:00:00 PM,48,-122,32,46,78
5199,ElliotBayTrailMyrtlePark,08/05/2014 03:00:00 PM,48,-122,60,34,94
5200,ElliotBayTrailMyrtlePark,08/05/2014 04:00:00 PM,48,-122,126,73,199
5201,ElliotBayTrailMyrtlePark,08/05/2014 05:00:00 PM,48,-122,250,71,321
5202,ElliotBayTrailMyrtlePark,08/05/2014 06:00:00 PM,48,-122,147,81,228
5203,ElliotBayTrailMyrtlePark,08/05/2014 07:00:00 PM,48,-122,63,46,109
5204,ElliotBayTrailMyrtlePark,08/05/2014 08:00:00 PM,48,-122,49,29,78
5205,ElliotBayTrailMyrtlePark,08/05/2014 09:00:00 PM,48,-122,5,12,17
5206,ElliotBayTrailMyrtlePark,08/05/2014 10:00:00 PM,48,-122,21,1,22
5207,ElliotBayTrailMyrtlePark,08/05/2014 11:00:00 PM,48,-122,10,1,11
5208,ElliotBayTrailMyrtlePark,08/06/2014 12:00:00 AM,48,-122,1,3,4
5209,ElliotBayTrailMyrtlePark,08/06/2014 01:00:00 AM,48,-122,1,0,1
5210,ElliotBayTrailMyrtlePark,08/06/2014 02:00:00 AM,48,-122,0,0,0
5211,ElliotBayTrailMyrtlePark,08/06/2014 03:00:00 AM,48,-122,0,0,0
5212,ElliotBayTrailMyrtlePark,08/06/2014 04:00:00 AM,48,-122,1,1,2
5213,ElliotBayTrailMyrtlePark,08/06/2014 05:00:00 AM,48,-122,8,21,29
5214,ElliotBayTrailMyrtlePark,08/06/2014 06:00:00 AM,48,-122,22,34,56
5215,ElliotBayTrailMyrtlePark,08/06/2014 07:00:00 AM,48,-122,42,110,152
5216,ElliotBayTrailMyrtlePark,08/06/2014 08:00:00 AM,48,-122,50,166,216
5217,ElliotBayTrailMyrtlePark,08/06/2014 09:00:00 AM,48,-122,37,98,135
5218,ElliotBayTrailMyrtlePark,08/06/2014 10:00:00 AM,48,-122,28,40,68
5219,ElliotBayTrailMyrtlePark,08/06/2014 11:00:00 AM,48,-122,33,39,72
5220,ElliotBayTrailMyrtlePark,08/06/2014 12:00:00 PM,48,-122,40,33,73
5221,ElliotBayTrailMyrtlePark,08/06/2014 01:00:00 PM,48,-122,40,32,72
5222,ElliotBayTrailMyrtlePark,08/06/2014 02:00:00 PM,48,-122,35,36,71
5223,ElliotBayTrailMyrtlePark,08/06/2014 03:00:00 PM,48,-122,50,53,103
5224,ElliotBayTrailMyrtlePark,08/06/2014 04:00:00 PM,48,-122,115,57,172
5225,ElliotBayTrailMyrtlePark,08/06/2014 05:00:00 PM,48,-122,222,86,308
5226,ElliotBayTrailMyrtlePark,08/06/2014 06:00:00 PM,48,-122,152,50,202
5227,ElliotBayTrailMyrtlePark,08/06/2014 07:00:00 PM,48,-122,78,42,120
5228,ElliotBayTrailMyrtlePark,08/06/2014 08:00:00 PM,48,-122,55,39,94
5229,ElliotBayTrailMyrtlePark,08/06/2014 09:00:00 PM,48,-122,9,17,26
5230,ElliotBayTrailMyrtlePark,08/06/2014 10:00:00 PM,48,-122,8,2,10
5231,ElliotBayTrailMyrtlePark,08/06/2014 11:00:00 PM,48,-122,1,3,4
5232,ElliotBayTrailMyrtlePark,08/07/2014 12:00:00 AM,48,-122,4,1,5
5233,ElliotBayTrailMyrtlePark,08/07/2014 01:00:00 AM,48,-122,1,0,1
5234,ElliotBayTrailMyrtlePark,08/07/2014 02:00:00 AM,48,-122,2,0,2
5235,ElliotBayTrailMyrtlePark,08/07/2014 03:00:00 AM,48,-122,1,0,1
5236,ElliotBayTrailMyrtlePark,08/07/2014 04:00:00 AM,48,-122,2,2,4
5237,ElliotBayTrailMyrtlePark,08/07/2014 05:00:00 AM,48,-122,8,18,26
5238,ElliotBayTrailMyrtlePark,08/07/2014 06:00:00 AM,48,-122,25,53,78
5239,ElliotBayTrailMyrtlePark,08/07/2014 07:00:00 AM,48,-122,56,113,169
5240,ElliotBayTrailMyrtlePark,08/07/2014 08:00:00 AM,48,-122,63,160,223
5241,ElliotBayTrailMyrtlePark,08/07/2014 09:00:00 AM,48,-122,33,88,121
5242,ElliotBayTrailMyrtlePark,08/07/2014 10:00:00 AM,48,-122,32,36,68
5243,ElliotBayTrailMyrtlePark,08/07/2014 11:00:00 AM,48,-122,26,21,47
5244,ElliotBayTrailMyrtlePark,08/07/2014 12:00:00 PM,48,-122,35,52,87
5245,ElliotBayTrailMyrtlePark,08/07/2014 01:00:00 PM,48,-122,35,29,64
5246,ElliotBayTrailMyrtlePark,08/07/2014 02:00:00 PM,48,-122,52,42,94
5247,ElliotBayTrailMyrtlePark,08/07/2014 03:00:00 PM,48,-122,50,41,91
5248,ElliotBayTrailMyrtlePark,08/07/2014 04:00:00 PM,48,-122,105,67,172
5249,ElliotBayTrailMyrtlePark,08/07/2014 05:00:00 PM,48,-122,266,96,362
5250,ElliotBayTrailMyrtlePark,08/07/2014 06:00:00 PM,48,-122,160,67,227
5251,ElliotBayTrailMyrtlePark,08/07/2014 07:00:00 PM,48,-122,84,54,138
5252,ElliotBayTrailMyrtlePark,08/07/2014 08:00:00 PM,48,-122,61,33,94
5253,ElliotBayTrailMyrtlePark,08/07/2014 09:00:00 PM,48,-122,13,5,18
5254,ElliotBayTrailMyrtlePark,08/07/2014 10:00:00 PM,48,-122,17,1,18
5255,ElliotBayTrailMyrtlePark,08/07/2014 11:00:00 PM,48,-122,6,2,8
5256,ElliotBayTrailMyrtlePark,08/08/2014 12:00:00 AM,48,-122,5,4,9
5257,ElliotBayTrailMyrtlePark,08/08/2014 01:00:00 AM,48,-122,4,3,7
5258,ElliotBayTrailMyrtlePark,08/08/2014 02:00:00 AM,48,-122,1,1,2
5259,ElliotBayTrailMyrtlePark,08/08/2014 03:00:00 AM,48,-122,2,0,2
5260,ElliotBayTrailMyrtlePark,08/08/2014 04:00:00 AM,48,-122,0,2,2
5261,ElliotBayTrailMyrtlePark,08/08/2014 05:00:00 AM,48,-122,6,19,25
5262,ElliotBayTrailMyrtlePark,08/08/2014 06:00:00 AM,48,-122,26,41,67
5263,ElliotBayTrailMyrtlePark,08/08/2014 07:00:00 AM,48,-122,48,103,151
5264,ElliotBayTrailMyrtlePark,08/08/2014 08:00:00 AM,48,-122,46,137,183
5265,ElliotBayTrailMyrtlePark,08/08/2014 09:00:00 AM,48,-122,34,79,113
5266,ElliotBayTrailMyrtlePark,08/08/2014 10:00:00 AM,48,-122,23,29,52
5267,ElliotBayTrailMyrtlePark,08/08/2014 11:00:00 AM,48,-122,29,33,62
5268,ElliotBayTrailMyrtlePark,08/08/2014 12:00:00 PM,48,-122,27,45,72
5269,ElliotBayTrailMyrtlePark,08/08/2014 01:00:00 PM,48,-122,35,27,62
5270,ElliotBayTrailMyrtlePark,08/08/2014 02:00:00 PM,48,-122,63,45,108
5271,ElliotBayTrailMyrtlePark,08/08/2014 03:00:00 PM,48,-122,63,48,111
5272,ElliotBayTrailMyrtlePark,08/08/2014 04:00:00 PM,48,-122,106,63,169
5273,ElliotBayTrailMyrtlePark,08/08/2014 05:00:00 PM,48,-122,165,61,226
5274,ElliotBayTrailMyrtlePark,08/08/2014 06:00:00 PM,48,-122,123,57,180
5275,ElliotBayTrailMyrtlePark,08/08/2014 07:00:00 PM,48,-122,57,39,96
5276,ElliotBayTrailMyrtlePark,08/08/2014 08:00:00 PM,48,-122,35,33,68
5277,ElliotBayTrailMyrtlePark,08/08/2014 09:00:00 PM,48,-122,10,4,14
5278,ElliotBayTrailMyrtlePark,08/08/2014 10:00:00 PM,48,-122,17,5,22
5279,ElliotBayTrailMyrtlePark,08/08/2014 11:00:00 PM,48,-122,6,2,8
5280,ElliotBayTrailMyrtlePark,08/09/2014 12:00:00 AM,48,-122,6,0,6
5281,ElliotBayTrailMyrtlePark,08/09/2014 01:00:00 AM,48,-122,5,0,5
5282,ElliotBayTrailMyrtlePark,08/09/2014 02:00:00 AM,48,-122,1,3,4
5283,ElliotBayTrailMyrtlePark,08/09/2014 03:00:00 AM,48,-122,2,0,2
5284,ElliotBayTrailMyrtlePark,08/09/2014 04:00:00 AM,48,-122,1,0,1
5285,ElliotBayTrailMyrtlePark,08/09/2014 05:00:00 AM,48,-122,2,5,7
5286,ElliotBayTrailMyrtlePark,08/09/2014 06:00:00 AM,48,-122,5,11,16
5287,ElliotBayTrailMyrtlePark,08/09/2014 07:00:00 AM,48,-122,12,14,26
5288,ElliotBayTrailMyrtlePark,08/09/2014 08:00:00 AM,48,-122,27,25,52
5289,ElliotBayTrailMyrtlePark,08/09/2014 09:00:00 AM,48,-122,24,39,63
5290,ElliotBayTrailMyrtlePark,08/09/2014 10:00:00 AM,48,-122,50,66,116
5291,ElliotBayTrailMyrtlePark,08/09/2014 11:00:00 AM,48,-122,75,63,138
5292,ElliotBayTrailMyrtlePark,08/09/2014 12:00:00 PM,48,-122,72,74,146
5293,ElliotBayTrailMyrtlePark,08/09/2014 01:00:00 PM,48,-122,46,82,128
5294,ElliotBayTrailMyrtlePark,08/09/2014 02:00:00 PM,48,-122,79,76,155
5295,ElliotBayTrailMyrtlePark,08/09/2014 03:00:00 PM,48,-122,83,76,159
5296,ElliotBayTrailMyrtlePark,08/09/2014 04:00:00 PM,48,-122,89,60,149
5297,ElliotBayTrailMyrtlePark,08/09/2014 05:00:00 PM,48,-122,68,42,110
5298,ElliotBayTrailMyrtlePark,08/09/2014 06:00:00 PM,48,-122,56,40,96
5299,ElliotBayTrailMyrtlePark,08/09/2014 07:00:00 PM,48,-122,33,27,60
5300,ElliotBayTrailMyrtlePark,08/09/2014 08:00:00 PM,48,-122,34,26,60
5301,ElliotBayTrailMyrtlePark,08/09/2014 09:00:00 PM,48,-122,10,8,18
5302,ElliotBayTrailMyrtlePark,08/09/2014 10:00:00 PM,48,-122,10,3,13
5303,ElliotBayTrailMyrtlePark,08/09/2014 11:00:00 PM,48,-122,4,4,8
5304,ElliotBayTrailMyrtlePark,08/10/2014 12:00:00 AM,48,-122,3,3,6
5305,ElliotBayTrailMyrtlePark,08/10/2014 01:00:00 AM,48,-122,3,0,3
5306,ElliotBayTrailMyrtlePark,08/10/2014 02:00:00 AM,48,-122,0,0,0
5307,ElliotBayTrailMyrtlePark,08/10/2014 03:00:00 AM,48,-122,1,0,1
5308,ElliotBayTrailMyrtlePark,08/10/2014 04:00:00 AM,48,-122,0,1,1
5309,ElliotBayTrailMyrtlePark,08/10/2014 05:00:00 AM,48,-122,2,3,5
5310,ElliotBayTrailMyrtlePark,08/10/2014 06:00:00 AM,48,-122,5,5,10
5311,ElliotBayTrailMyrtlePark,08/10/2014 07:00:00 AM,48,-122,13,17,30
5312,ElliotBayTrailMyrtlePark,08/10/2014 08:00:00 AM,48,-122,19,21,40
5313,ElliotBayTrailMyrtlePark,08/10/2014 09:00:00 AM,48,-122,39,34,73
5314,ElliotBayTrailMyrtlePark,08/10/2014 10:00:00 AM,48,-122,51,56,107
5315,ElliotBayTrailMyrtlePark,08/10/2014 11:00:00 AM,48,-122,66,72,138
5316,ElliotBayTrailMyrtlePark,08/10/2014 12:00:00 PM,48,-122,51,73,124
5317,ElliotBayTrailMyrtlePark,08/10/2014 01:00:00 PM,48,-122,79,57,136
5318,ElliotBayTrailMyrtlePark,08/10/2014 02:00:00 PM,48,-122,90,76,166
5319,ElliotBayTrailMyrtlePark,08/10/2014 03:00:00 PM,48,-122,82,77,159
5320,ElliotBayTrailMyrtlePark,08/10/2014 04:00:00 PM,48,-122,67,55,122
5321,ElliotBayTrailMyrtlePark,08/10/2014 05:00:00 PM,48,-122,72,66,138
5322,ElliotBayTrailMyrtlePark,08/10/2014 06:00:00 PM,48,-122,39,54,93
5323,ElliotBayTrailMyrtlePark,08/10/2014 07:00:00 PM,48,-122,29,44,73
5324,ElliotBayTrailMyrtlePark,08/10/2014 08:00:00 PM,48,-122,27,26,53
5325,ElliotBayTrailMyrtlePark,08/10/2014 09:00:00 PM,48,-122,29,9,38
5326,ElliotBayTrailMyrtlePark,08/10/2014 10:00:00 PM,48,-122,81,2,83
5327,ElliotBayTrailMyrtlePark,08/10/2014 11:00:00 PM,48,-122,2,1,3
5328,ElliotBayTrailMyrtlePark,08/11/2014 12:00:00 AM,48,-122,7,3,10
5329,ElliotBayTrailMyrtlePark,08/11/2014 01:00:00 AM,48,-122,2,0,2
5330,ElliotBayTrailMyrtlePark,08/11/2014 02:00:00 AM,48,-122,0,1,1
5331,ElliotBayTrailMyrtlePark,08/11/2014 03:00:00 AM,48,-122,1,0,1
5332,ElliotBayTrailMyrtlePark,08/11/2014 04:00:00 AM,48,-122,1,4,5
5333,ElliotBayTrailMyrtlePark,08/11/2014 05:00:00 AM,48,-122,4,18,22
5334,ElliotBayTrailMyrtlePark,08/11/2014 06:00:00 AM,48,-122,26,43,69
5335,ElliotBayTrailMyrtlePark,08/11/2014 07:00:00 AM,48,-122,56,112,168
5336,ElliotBayTrailMyrtlePark,08/11/2014 08:00:00 AM,48,-122,60,154,214
5337,ElliotBayTrailMyrtlePark,08/11/2014 09:00:00 AM,48,-122,30,87,117
5338,ElliotBayTrailMyrtlePark,08/11/2014 10:00:00 AM,48,-122,19,49,68
5339,ElliotBayTrailMyrtlePark,08/11/2014 11:00:00 AM,48,-122,46,35,81
5340,ElliotBayTrailMyrtlePark,08/11/2014 12:00:00 PM,48,-122,33,29,62
5341,ElliotBayTrailMyrtlePark,08/11/2014 01:00:00 PM,48,-122,29,25,54
5342,ElliotBayTrailMyrtlePark,08/11/2014 02:00:00 PM,48,-122,35,39,74
5343,ElliotBayTrailMyrtlePark,08/11/2014 03:00:00 PM,48,-122,38,45,83
5344,ElliotBayTrailMyrtlePark,08/11/2014 04:00:00 PM,48,-122,88,52,140
5345,ElliotBayTrailMyrtlePark,08/11/2014 05:00:00 PM,48,-122,236,72,308
5346,ElliotBayTrailMyrtlePark,08/11/2014 06:00:00 PM,48,-122,155,65,220
5347,ElliotBayTrailMyrtlePark,08/11/2014 07:00:00 PM,48,-122,81,27,108
5348,ElliotBayTrailMyrtlePark,08/11/2014 08:00:00 PM,48,-122,31,26,57
5349,ElliotBayTrailMyrtlePark,08/11/2014 09:00:00 PM,48,-122,9,6,15
5350,ElliotBayTrailMyrtlePark,08/11/2014 10:00:00 PM,48,-122,18,1,19
5351,ElliotBayTrailMyrtlePark,08/11/2014 11:00:00 PM,48,-122,8,0,8
5352,ElliotBayTrailMyrtlePark,08/12/2014 12:00:00 AM,48,-122,5,1,6
5353,ElliotBayTrailMyrtlePark,08/12/2014 01:00:00 AM,48,-122,3,1,4
5354,ElliotBayTrailMyrtlePark,08/12/2014 02:00:00 AM,48,-122,3,2,5
5355,ElliotBayTrailMyrtlePark,08/12/2014 03:00:00 AM,48,-122,1,0,1
5356,ElliotBayTrailMyrtlePark,08/12/2014 04:00:00 AM,48,-122,0,0,0
5357,ElliotBayTrailMyrtlePark,08/12/2014 05:00:00 AM,48,-122,8,23,31
5358,ElliotBayTrailMyrtlePark,08/12/2014 06:00:00 AM,48,-122,30,48,78
5359,ElliotBayTrailMyrtlePark,08/12/2014 07:00:00 AM,48,-122,54,103,157
5360,ElliotBayTrailMyrtlePark,08/12/2014 08:00:00 AM,48,-122,40,150,190
5361,ElliotBayTrailMyrtlePark,08/12/2014 09:00:00 AM,48,-122,11,59,70
5362,ElliotBayTrailMyrtlePark,08/12/2014 10:00:00 AM,48,-122,15,37,52
5363,ElliotBayTrailMyrtlePark,08/12/2014 11:00:00 AM,48,-122,12,26,38
5364,ElliotBayTrailMyrtlePark,08/12/2014 12:00:00 PM,48,-122,17,18,35
5365,ElliotBayTrailMyrtlePark,08/12/2014 01:00:00 PM,48,-122,22,28,50
5366,ElliotBayTrailMyrtlePark,08/12/2014 02:00:00 PM,48,-122,19,27,46
5367,ElliotBayTrailMyrtlePark,08/12/2014 03:00:00 PM,48,-122,31,30,61
5368,ElliotBayTrailMyrtlePark,08/12/2014 04:00:00 PM,48,-122,114,66,180
5369,ElliotBayTrailMyrtlePark,08/12/2014 05:00:00 PM,48,-122,183,57,240
5370,ElliotBayTrailMyrtlePark,08/12/2014 06:00:00 PM,48,-122,117,48,165
5371,ElliotBayTrailMyrtlePark,08/12/2014 07:00:00 PM,48,-122,62,47,109
5372,ElliotBayTrailMyrtlePark,08/12/2014 08:00:00 PM,48,-122,31,16,47
5373,ElliotBayTrailMyrtlePark,08/12/2014 09:00:00 PM,48,-122,3,1,4
5374,ElliotBayTrailMyrtlePark,08/12/2014 10:00:00 PM,48,-122,12,0,12
5375,ElliotBayTrailMyrtlePark,08/12/2014 11:00:00 PM,48,-122,0,0,0
5376,ElliotBayTrailMyrtlePark,08/13/2014 12:00:00 AM,48,-122,3,3,6
5377,ElliotBayTrailMyrtlePark,08/13/2014 01:00:00 AM,48,-122,0,0,0
5378,ElliotBayTrailMyrtlePark,08/13/2014 02:00:00 AM,48,-122,1,0,1
5379,ElliotBayTrailMyrtlePark,08/13/2014 03:00:00 AM,48,-122,0,0,0
5380,ElliotBayTrailMyrtlePark,08/13/2014 04:00:00 AM,48,-122,0,0,0
5381,ElliotBayTrailMyrtlePark,08/13/2014 05:00:00 AM,48,-122,5,18,23
5382,ElliotBayTrailMyrtlePark,08/13/2014 06:00:00 AM,48,-122,19,24,43
5383,ElliotBayTrailMyrtlePark,08/13/2014 07:00:00 AM,48,-122,26,65,91
5384,ElliotBayTrailMyrtlePark,08/13/2014 08:00:00 AM,48,-122,40,109,149
5385,ElliotBayTrailMyrtlePark,08/13/2014 09:00:00 AM,48,-122,26,54,80
5386,ElliotBayTrailMyrtlePark,08/13/2014 10:00:00 AM,48,-122,10,27,37
5387,ElliotBayTrailMyrtlePark,08/13/2014 11:00:00 AM,48,-122,12,24,36
5388,ElliotBayTrailMyrtlePark,08/13/2014 12:00:00 PM,48,-122,11,18,29
5389,ElliotBayTrailMyrtlePark,08/13/2014 01:00:00 PM,48,-122,17,19,36
5390,ElliotBayTrailMyrtlePark,08/13/2014 02:00:00 PM,48,-122,20,14,34
5391,ElliotBayTrailMyrtlePark,08/13/2014 03:00:00 PM,48,-122,31,24,55
5392,ElliotBayTrailMyrtlePark,08/13/2014 04:00:00 PM,48,-122,53,51,104
5393,ElliotBayTrailMyrtlePark,08/13/2014 05:00:00 PM,48,-122,133,42,175
5394,ElliotBayTrailMyrtlePark,08/13/2014 06:00:00 PM,48,-122,124,47,171
5395,ElliotBayTrailMyrtlePark,08/13/2014 07:00:00 PM,48,-122,66,38,104
5396,ElliotBayTrailMyrtlePark,08/13/2014 08:00:00 PM,48,-122,30,19,49
5397,ElliotBayTrailMyrtlePark,08/13/2014 09:00:00 PM,48,-122,12,10,22
5398,ElliotBayTrailMyrtlePark,08/13/2014 10:00:00 PM,48,-122,4,2,6
5399,ElliotBayTrailMyrtlePark,08/13/2014 11:00:00 PM,48,-122,8,2,10
5400,ElliotBayTrailMyrtlePark,08/14/2014 12:00:00 AM,48,-122,3,3,6
5401,ElliotBayTrailMyrtlePark,08/14/2014 01:00:00 AM,48,-122,2,2,4
5402,ElliotBayTrailMyrtlePark,08/14/2014 02:00:00 AM,48,-122,6,0,6
5403,ElliotBayTrailMyrtlePark,08/14/2014 03:00:00 AM,48,-122,5,5,10
5404,ElliotBayTrailMyrtlePark,08/14/2014 04:00:00 AM,48,-122,1,1,2
5405,ElliotBayTrailMyrtlePark,08/14/2014 05:00:00 AM,48,-122,10,11,21
5406,ElliotBayTrailMyrtlePark,08/14/2014 06:00:00 AM,48,-122,23,33,56
5407,ElliotBayTrailMyrtlePark,08/14/2014 07:00:00 AM,48,-122,45,93,138
5408,ElliotBayTrailMyrtlePark,08/14/2014 08:00:00 AM,48,-122,44,129,173
5409,ElliotBayTrailMyrtlePark,08/14/2014 09:00:00 AM,48,-122,29,75,104
5410,ElliotBayTrailMyrtlePark,08/14/2014 10:00:00 AM,48,-122,21,36,57
5411,ElliotBayTrailMyrtlePark,08/14/2014 11:00:00 AM,48,-122,17,32,49
5412,ElliotBayTrailMyrtlePark,08/14/2014 12:00:00 PM,48,-122,28,30,58
5413,ElliotBayTrailMyrtlePark,08/14/2014 01:00:00 PM,48,-122,26,32,58
5414,ElliotBayTrailMyrtlePark,08/14/2014 02:00:00 PM,48,-122,39,40,79
5415,ElliotBayTrailMyrtlePark,08/14/2014 03:00:00 PM,48,-122,25,46,71
5416,ElliotBayTrailMyrtlePark,08/14/2014 04:00:00 PM,48,-122,69,47,116
5417,ElliotBayTrailMyrtlePark,08/14/2014 05:00:00 PM,48,-122,146,70,216
5418,ElliotBayTrailMyrtlePark,08/14/2014 06:00:00 PM,48,-122,113,49,162
5419,ElliotBayTrailMyrtlePark,08/14/2014 07:00:00 PM,48,-122,51,38,89
5420,ElliotBayTrailMyrtlePark,08/14/2014 08:00:00 PM,48,-122,30,19,49
5421,ElliotBayTrailMyrtlePark,08/14/2014 09:00:00 PM,48,-122,4,8,12
5422,ElliotBayTrailMyrtlePark,08/14/2014 10:00:00 PM,48,-122,9,9,18
5423,ElliotBayTrailMyrtlePark,08/14/2014 11:00:00 PM,48,-122,8,7,15
5424,ElliotBayTrailMyrtlePark,08/15/2014 12:00:00 AM,48,-122,4,4,8
5425,ElliotBayTrailMyrtlePark,08/15/2014 01:00:00 AM,48,-122,0,2,2
5426,ElliotBayTrailMyrtlePark,08/15/2014 02:00:00 AM,48,-122,4,5,9
5427,ElliotBayTrailMyrtlePark,08/15/2014 03:00:00 AM,48,-122,1,0,1
5428,ElliotBayTrailMyrtlePark,08/15/2014 04:00:00 AM,48,-122,0,0,0
5429,ElliotBayTrailMyrtlePark,08/15/2014 05:00:00 AM,48,-122,4,14,18
5430,ElliotBayTrailMyrtlePark,08/15/2014 06:00:00 AM,48,-122,3,25,28
5431,ElliotBayTrailMyrtlePark,08/15/2014 07:00:00 AM,48,-122,35,70,105
5432,ElliotBayTrailMyrtlePark,08/15/2014 08:00:00 AM,48,-122,29,87,116
5433,ElliotBayTrailMyrtlePark,08/15/2014 09:00:00 AM,48,-122,19,53,72
5434,ElliotBayTrailMyrtlePark,08/15/2014 10:00:00 AM,48,-122,12,36,48
5435,ElliotBayTrailMyrtlePark,08/15/2014 11:00:00 AM,48,-122,20,26,46
5436,ElliotBayTrailMyrtlePark,08/15/2014 12:00:00 PM,48,-122,23,14,37
5437,ElliotBayTrailMyrtlePark,08/15/2014 01:00:00 PM,48,-122,28,15,43
5438,ElliotBayTrailMyrtlePark,08/15/2014 02:00:00 PM,48,-122,31,14,45
5439,ElliotBayTrailMyrtlePark,08/15/2014 03:00:00 PM,48,-122,11,12,23
5440,ElliotBayTrailMyrtlePark,08/15/2014 04:00:00 PM,48,-122,23,26,49
5441,ElliotBayTrailMyrtlePark,08/15/2014 05:00:00 PM,48,-122,18,20,38
5442,ElliotBayTrailMyrtlePark,08/15/2014 06:00:00 PM,48,-122,21,23,44
5443,ElliotBayTrailMyrtlePark,08/15/2014 07:00:00 PM,48,-122,6,14,20
5444,ElliotBayTrailMyrtlePark,08/15/2014 08:00:00 PM,48,-122,10,45,55
5445,ElliotBayTrailMyrtlePark,08/15/2014 09:00:00 PM,48,-122,3,13,16
5446,ElliotBayTrailMyrtlePark,08/15/2014 10:00:00 PM,48,-122,4,9,13
5447,ElliotBayTrailMyrtlePark,08/15/2014 11:00:00 PM,48,-122,4,5,9
5448,ElliotBayTrailMyrtlePark,08/16/2014 12:00:00 AM,48,-122,1,3,4
5449,ElliotBayTrailMyrtlePark,08/16/2014 01:00:00 AM,48,-122,6,5,11
5450,ElliotBayTrailMyrtlePark,08/16/2014 02:00:00 AM,48,-122,4,2,6
5451,ElliotBayTrailMyrtlePark,08/16/2014 03:00:00 AM,48,-122,3,10,13
5452,ElliotBayTrailMyrtlePark,08/16/2014 04:00:00 AM,48,-122,0,0,0
5453,ElliotBayTrailMyrtlePark,08/16/2014 05:00:00 AM,48,-122,4,4,8
5454,ElliotBayTrailMyrtlePark,08/16/2014 06:00:00 AM,48,-122,3,5,8
5455,ElliotBayTrailMyrtlePark,08/16/2014 07:00:00 AM,48,-122,9,10,19
5456,ElliotBayTrailMyrtlePark,08/16/2014 08:00:00 AM,48,-122,10,30,40
5457,ElliotBayTrailMyrtlePark,08/16/2014 09:00:00 AM,48,-122,25,25,50
5458,ElliotBayTrailMyrtlePark,08/16/2014 10:00:00 AM,48,-122,17,14,31
5459,ElliotBayTrailMyrtlePark,08/16/2014 11:00:00 AM,48,-122,31,14,45
5460,ElliotBayTrailMyrtlePark,08/16/2014 12:00:00 PM,48,-122,31,18,49
5461,ElliotBayTrailMyrtlePark,08/16/2014 01:00:00 PM,48,-122,31,20,51
5462,ElliotBayTrailMyrtlePark,08/16/2014 02:00:00 PM,48,-122,20,26,46
5463,ElliotBayTrailMyrtlePark,08/16/2014 03:00:00 PM,48,-122,22,21,43
5464,ElliotBayTrailMyrtlePark,08/16/2014 04:00:00 PM,48,-122,14,17,31
5465,ElliotBayTrailMyrtlePark,08/16/2014 05:00:00 PM,48,-122,10,13,23
5466,ElliotBayTrailMyrtlePark,08/16/2014 06:00:00 PM,48,-122,6,15,21
5467,ElliotBayTrailMyrtlePark,08/16/2014 07:00:00 PM,48,-122,16,20,36
5468,ElliotBayTrailMyrtlePark,08/16/2014 08:00:00 PM,48,-122,13,27,40
5469,ElliotBayTrailMyrtlePark,08/16/2014 09:00:00 PM,48,-122,8,7,15
5470,ElliotBayTrailMyrtlePark,08/16/2014 10:00:00 PM,48,-122,4,30,34
5471,ElliotBayTrailMyrtlePark,08/16/2014 11:00:00 PM,48,-122,4,4,8
5472,ElliotBayTrailMyrtlePark,08/17/2014 12:00:00 AM,48,-122,7,7,14
5473,ElliotBayTrailMyrtlePark,08/17/2014 01:00:00 AM,48,-122,1,0,1
5474,ElliotBayTrailMyrtlePark,08/17/2014 02:00:00 AM,48,-122,2,3,5
5475,ElliotBayTrailMyrtlePark,08/17/2014 03:00:00 AM,48,-122,4,5,9
5476,ElliotBayTrailMyrtlePark,08/17/2014 04:00:00 AM,48,-122,2,6,8
5477,ElliotBayTrailMyrtlePark,08/17/2014 05:00:00 AM,48,-122,3,2,5
5478,ElliotBayTrailMyrtlePark,08/17/2014 06:00:00 AM,48,-122,6,8,14
5479,ElliotBayTrailMyrtlePark,08/17/2014 07:00:00 AM,48,-122,4,5,9
5480,ElliotBayTrailMyrtlePark,08/17/2014 08:00:00 AM,48,-122,18,22,40
5481,ElliotBayTrailMyrtlePark,08/17/2014 09:00:00 AM,48,-122,21,23,44
5482,ElliotBayTrailMyrtlePark,08/17/2014 10:00:00 AM,48,-122,32,15,47
5483,ElliotBayTrailMyrtlePark,08/17/2014 11:00:00 AM,48,-122,32,11,43
5484,ElliotBayTrailMyrtlePark,08/17/2014 12:00:00 PM,48,-122,20,32,52
5485,ElliotBayTrailMyrtlePark,08/17/2014 01:00:00 PM,48,-122,35,18,53
5486,ElliotBayTrailMyrtlePark,08/17/2014 02:00:00 PM,48,-122,20,20,40
5487,ElliotBayTrailMyrtlePark,08/17/2014 03:00:00 PM,48,-122,15,12,27
5488,ElliotBayTrailMyrtlePark,08/17/2014 04:00:00 PM,48,-122,23,25,48
5489,ElliotBayTrailMyrtlePark,08/17/2014 05:00:00 PM,48,-122,17,13,30
5490,ElliotBayTrailMyrtlePark,08/17/2014 06:00:00 PM,48,-122,28,15,43
5491,ElliotBayTrailMyrtlePark,08/17/2014 07:00:00 PM,48,-122,12,12,24
5492,ElliotBayTrailMyrtlePark,08/17/2014 08:00:00 PM,48,-122,15,41,56
5493,ElliotBayTrailMyrtlePark,08/17/2014 09:00:00 PM,48,-122,9,12,21
5494,ElliotBayTrailMyrtlePark,08/17/2014 10:00:00 PM,48,-122,13,40,53
5495,ElliotBayTrailMyrtlePark,08/17/2014 11:00:00 PM,48,-122,5,30,35
5496,ElliotBayTrailMyrtlePark,08/18/2014 12:00:00 AM,48,-122,3,4,7
5497,ElliotBayTrailMyrtlePark,08/18/2014 01:00:00 AM,48,-122,4,6,10
5498,ElliotBayTrailMyrtlePark,08/18/2014 02:00:00 AM,48,-122,2,9,11
5499,ElliotBayTrailMyrtlePark,08/18/2014 03:00:00 AM,48,-122,2,7,9
5500,ElliotBayTrailMyrtlePark,08/18/2014 04:00:00 AM,48,-122,1,18,19
5501,ElliotBayTrailMyrtlePark,08/18/2014 05:00:00 AM,48,-122,8,19,27
5502,ElliotBayTrailMyrtlePark,08/18/2014 06:00:00 AM,48,-122,22,23,45
5503,ElliotBayTrailMyrtlePark,08/18/2014 07:00:00 AM,48,-122,47,102,149
5504,ElliotBayTrailMyrtlePark,08/18/2014 08:00:00 AM,48,-122,60,146,206
5505,ElliotBayTrailMyrtlePark,08/18/2014 09:00:00 AM,48,-122,23,78,101
5506,ElliotBayTrailMyrtlePark,08/18/2014 10:00:00 AM,48,-122,14,30,44
5507,ElliotBayTrailMyrtlePark,08/18/2014 11:00:00 AM,48,-122,35,42,77
5508,ElliotBayTrailMyrtlePark,08/18/2014 12:00:00 PM,48,-122,42,28,70
5509,ElliotBayTrailMyrtlePark,08/18/2014 01:00:00 PM,48,-122,23,38,61
5510,ElliotBayTrailMyrtlePark,08/18/2014 02:00:00 PM,48,-122,39,39,78
5511,ElliotBayTrailMyrtlePark,08/18/2014 03:00:00 PM,48,-122,46,51,97
5512,ElliotBayTrailMyrtlePark,08/18/2014 04:00:00 PM,48,-122,95,66,161
5513,ElliotBayTrailMyrtlePark,08/18/2014 05:00:00 PM,48,-122,237,76,313
5514,ElliotBayTrailMyrtlePark,08/18/2014 06:00:00 PM,48,-122,122,67,189
5515,ElliotBayTrailMyrtlePark,08/18/2014 07:00:00 PM,48,-122,78,49,127
5516,ElliotBayTrailMyrtlePark,08/18/2014 08:00:00 PM,48,-122,35,35,70
5517,ElliotBayTrailMyrtlePark,08/18/2014 09:00:00 PM,48,-122,11,9,20
5518,ElliotBayTrailMyrtlePark,08/18/2014 10:00:00 PM,48,-122,0,4,4
5519,ElliotBayTrailMyrtlePark,08/18/2014 11:00:00 PM,48,-122,4,0,4
5520,ElliotBayTrailMyrtlePark,08/19/2014 12:00:00 AM,48,-122,2,0,2
5521,ElliotBayTrailMyrtlePark,08/19/2014 01:00:00 AM,48,-122,3,0,3
5522,ElliotBayTrailMyrtlePark,08/19/2014 02:00:00 AM,48,-122,0,0,0
5523,ElliotBayTrailMyrtlePark,08/19/2014 03:00:00 AM,48,-122,0,0,0
5524,ElliotBayTrailMyrtlePark,08/19/2014 04:00:00 AM,48,-122,0,0,0
5525,ElliotBayTrailMyrtlePark,08/19/2014 05:00:00 AM,48,-122,11,18,29
5526,ElliotBayTrailMyrtlePark,08/19/2014 06:00:00 AM,48,-122,32,45,77
5527,ElliotBayTrailMyrtlePark,08/19/2014 07:00:00 AM,48,-122,58,137,195
5528,ElliotBayTrailMyrtlePark,08/19/2014 08:00:00 AM,48,-122,54,153,207
5529,ElliotBayTrailMyrtlePark,08/19/2014 09:00:00 AM,48,-122,34,87,121
5530,ElliotBayTrailMyrtlePark,08/19/2014 10:00:00 AM,48,-122,20,25,45
5531,ElliotBayTrailMyrtlePark,08/19/2014 11:00:00 AM,48,-122,31,32,63
5532,ElliotBayTrailMyrtlePark,08/19/2014 12:00:00 PM,48,-122,32,32,64
5533,ElliotBayTrailMyrtlePark,08/19/2014 01:00:00 PM,48,-122,42,37,79
5534,ElliotBayTrailMyrtlePark,08/19/2014 02:00:00 PM,48,-122,31,42,73
5535,ElliotBayTrailMyrtlePark,08/19/2014 03:00:00 PM,48,-122,46,41,87
5536,ElliotBayTrailMyrtlePark,08/19/2014 04:00:00 PM,48,-122,109,69,178
5537,ElliotBayTrailMyrtlePark,08/19/2014 05:00:00 PM,48,-122,239,83,322
5538,ElliotBayTrailMyrtlePark,08/19/2014 06:00:00 PM,48,-122,174,49,223
5539,ElliotBayTrailMyrtlePark,08/19/2014 07:00:00 PM,48,-122,68,31,99
5540,ElliotBayTrailMyrtlePark,08/19/2014 08:00:00 PM,48,-122,33,32,65
5541,ElliotBayTrailMyrtlePark,08/19/2014 09:00:00 PM,48,-122,5,6,11
5542,ElliotBayTrailMyrtlePark,08/19/2014 10:00:00 PM,48,-122,9,4,13
5543,ElliotBayTrailMyrtlePark,08/19/2014 11:00:00 PM,48,-122,1,1,2
5544,ElliotBayTrailMyrtlePark,08/20/2014 12:00:00 AM,48,-122,2,0,2
5545,ElliotBayTrailMyrtlePark,08/20/2014 01:00:00 AM,48,-122,1,0,1
5546,ElliotBayTrailMyrtlePark,08/20/2014 02:00:00 AM,48,-122,1,0,1
5547,ElliotBayTrailMyrtlePark,08/20/2014 03:00:00 AM,48,-122,0,0,0
5548,ElliotBayTrailMyrtlePark,08/20/2014 04:00:00 AM,48,-122,0,0,0
5549,ElliotBayTrailMyrtlePark,08/20/2014 05:00:00 AM,48,-122,6,15,21
5550,ElliotBayTrailMyrtlePark,08/20/2014 06:00:00 AM,48,-122,28,40,68
5551,ElliotBayTrailMyrtlePark,08/20/2014 07:00:00 AM,48,-122,48,105,153
5552,ElliotBayTrailMyrtlePark,08/20/2014 08:00:00 AM,48,-122,36,164,200
5553,ElliotBayTrailMyrtlePark,08/20/2014 09:00:00 AM,48,-122,26,52,78
5554,ElliotBayTrailMyrtlePark,08/20/2014 10:00:00 AM,48,-122,14,28,42
5555,ElliotBayTrailMyrtlePark,08/20/2014 11:00:00 AM,48,-122,21,25,46
5556,ElliotBayTrailMyrtlePark,08/20/2014 12:00:00 PM,48,-122,21,23,44
5557,ElliotBayTrailMyrtlePark,08/20/2014 01:00:00 PM,48,-122,19,30,49
5558,ElliotBayTrailMyrtlePark,08/20/2014 02:00:00 PM,48,-122,23,22,45
5559,ElliotBayTrailMyrtlePark,08/20/2014 03:00:00 PM,48,-122,33,52,85
5560,ElliotBayTrailMyrtlePark,08/20/2014 04:00:00 PM,48,-122,90,47,137
5561,ElliotBayTrailMyrtlePark,08/20/2014 05:00:00 PM,48,-122,206,86,292
5562,ElliotBayTrailMyrtlePark,08/20/2014 06:00:00 PM,48,-122,142,75,217
5563,ElliotBayTrailMyrtlePark,08/20/2014 07:00:00 PM,48,-122,75,45,120
5564,ElliotBayTrailMyrtlePark,08/20/2014 08:00:00 PM,48,-122,34,29,63
5565,ElliotBayTrailMyrtlePark,08/20/2014 09:00:00 PM,48,-122,63,8,71
5566,ElliotBayTrailMyrtlePark,08/20/2014 10:00:00 PM,48,-122,14,6,20
5567,ElliotBayTrailMyrtlePark,08/20/2014 11:00:00 PM,48,-122,1,0,1
5568,ElliotBayTrailMyrtlePark,08/21/2014 12:00:00 AM,48,-122,5,0,5
5569,ElliotBayTrailMyrtlePark,08/21/2014 01:00:00 AM,48,-122,4,0,4
5570,ElliotBayTrailMyrtlePark,08/21/2014 02:00:00 AM,48,-122,1,5,6
5571,ElliotBayTrailMyrtlePark,08/21/2014 03:00:00 AM,48,-122,1,0,1
5572,ElliotBayTrailMyrtlePark,08/21/2014 04:00:00 AM,48,-122,2,2,4
5573,ElliotBayTrailMyrtlePark,08/21/2014 05:00:00 AM,48,-122,8,17,25
5574,ElliotBayTrailMyrtlePark,08/21/2014 06:00:00 AM,48,-122,26,30,56
5575,ElliotBayTrailMyrtlePark,08/21/2014 07:00:00 AM,48,-122,42,123,165
5576,ElliotBayTrailMyrtlePark,08/21/2014 08:00:00 AM,48,-122,43,137,180
5577,ElliotBayTrailMyrtlePark,08/21/2014 09:00:00 AM,48,-122,30,78,108
5578,ElliotBayTrailMyrtlePark,08/21/2014 10:00:00 AM,48,-122,29,32,61
5579,ElliotBayTrailMyrtlePark,08/21/2014 11:00:00 AM,48,-122,15,26,41
5580,ElliotBayTrailMyrtlePark,08/21/2014 12:00:00 PM,48,-122,33,26,59
5581,ElliotBayTrailMyrtlePark,08/21/2014 01:00:00 PM,48,-122,31,27,58
5582,ElliotBayTrailMyrtlePark,08/21/2014 02:00:00 PM,48,-122,21,32,53
5583,ElliotBayTrailMyrtlePark,08/21/2014 03:00:00 PM,48,-122,31,48,79
5584,ElliotBayTrailMyrtlePark,08/21/2014 04:00:00 PM,48,-122,96,52,148
5585,ElliotBayTrailMyrtlePark,08/21/2014 05:00:00 PM,48,-122,198,74,272
5586,ElliotBayTrailMyrtlePark,08/21/2014 06:00:00 PM,48,-122,136,64,200
5587,ElliotBayTrailMyrtlePark,08/21/2014 07:00:00 PM,48,-122,77,47,124
5588,ElliotBayTrailMyrtlePark,08/21/2014 08:00:00 PM,48,-122,27,24,51
5589,ElliotBayTrailMyrtlePark,08/21/2014 09:00:00 PM,48,-122,8,2,10
5590,ElliotBayTrailMyrtlePark,08/21/2014 10:00:00 PM,48,-122,5,5,10
5591,ElliotBayTrailMyrtlePark,08/21/2014 11:00:00 PM,48,-122,4,1,5
5592,ElliotBayTrailMyrtlePark,08/22/2014 12:00:00 AM,48,-122,3,0,3
5593,ElliotBayTrailMyrtlePark,08/22/2014 01:00:00 AM,48,-122,2,0,2
5594,ElliotBayTrailMyrtlePark,08/22/2014 02:00:00 AM,48,-122,2,0,2
5595,ElliotBayTrailMyrtlePark,08/22/2014 03:00:00 AM,48,-122,0,0,0
5596,ElliotBayTrailMyrtlePark,08/22/2014 04:00:00 AM,48,-122,0,0,0
5597,ElliotBayTrailMyrtlePark,08/22/2014 05:00:00 AM,48,-122,7,17,24
5598,ElliotBayTrailMyrtlePark,08/22/2014 06:00:00 AM,48,-122,19,30,49
5599,ElliotBayTrailMyrtlePark,08/22/2014 07:00:00 AM,48,-122,47,117,164
5600,ElliotBayTrailMyrtlePark,08/22/2014 08:00:00 AM,48,-122,35,145,180
5601,ElliotBayTrailMyrtlePark,08/22/2014 09:00:00 AM,48,-122,29,68,97
5602,ElliotBayTrailMyrtlePark,08/22/2014 10:00:00 AM,48,-122,17,30,47
5603,ElliotBayTrailMyrtlePark,08/22/2014 11:00:00 AM,48,-122,26,30,56
5604,ElliotBayTrailMyrtlePark,08/22/2014 12:00:00 PM,48,-122,22,34,56
5605,ElliotBayTrailMyrtlePark,08/22/2014 01:00:00 PM,48,-122,31,44,75
5606,ElliotBayTrailMyrtlePark,08/22/2014 02:00:00 PM,48,-122,43,38,81
5607,ElliotBayTrailMyrtlePark,08/22/2014 03:00:00 PM,48,-122,64,42,106
5608,ElliotBayTrailMyrtlePark,08/22/2014 04:00:00 PM,48,-122,118,70,188
5609,ElliotBayTrailMyrtlePark,08/22/2014 05:00:00 PM,48,-122,206,54,260
5610,ElliotBayTrailMyrtlePark,08/22/2014 06:00:00 PM,48,-122,114,37,151
5611,ElliotBayTrailMyrtlePark,08/22/2014 07:00:00 PM,48,-122,46,28,74
5612,ElliotBayTrailMyrtlePark,08/22/2014 08:00:00 PM,48,-122,26,20,46
5613,ElliotBayTrailMyrtlePark,08/22/2014 09:00:00 PM,48,-122,12,4,16
5614,ElliotBayTrailMyrtlePark,08/22/2014 10:00:00 PM,48,-122,26,7,33
5615,ElliotBayTrailMyrtlePark,08/22/2014 11:00:00 PM,48,-122,10,0,10
5616,ElliotBayTrailMyrtlePark,08/23/2014 12:00:00 AM,48,-122,9,0,9
5617,ElliotBayTrailMyrtlePark,08/23/2014 01:00:00 AM,48,-122,0,0,0
5618,ElliotBayTrailMyrtlePark,08/23/2014 02:00:00 AM,48,-122,7,0,7
5619,ElliotBayTrailMyrtlePark,08/23/2014 03:00:00 AM,48,-122,1,4,5
5620,ElliotBayTrailMyrtlePark,08/23/2014 04:00:00 AM,48,-122,1,1,2
5621,ElliotBayTrailMyrtlePark,08/23/2014 05:00:00 AM,48,-122,2,4,6
5622,ElliotBayTrailMyrtlePark,08/23/2014 06:00:00 AM,48,-122,7,10,17
5623,ElliotBayTrailMyrtlePark,08/23/2014 07:00:00 AM,48,-122,11,9,20
5624,ElliotBayTrailMyrtlePark,08/23/2014 08:00:00 AM,48,-122,37,34,71
5625,ElliotBayTrailMyrtlePark,08/23/2014 09:00:00 AM,48,-122,39,30,69
5626,ElliotBayTrailMyrtlePark,08/23/2014 10:00:00 AM,48,-122,27,88,115
5627,ElliotBayTrailMyrtlePark,08/23/2014 11:00:00 AM,48,-122,54,53,107
5628,ElliotBayTrailMyrtlePark,08/23/2014 12:00:00 PM,48,-122,73,60,133
5629,ElliotBayTrailMyrtlePark,08/23/2014 01:00:00 PM,48,-122,69,62,131
5630,ElliotBayTrailMyrtlePark,08/23/2014 02:00:00 PM,48,-122,62,62,124
5631,ElliotBayTrailMyrtlePark,08/23/2014 03:00:00 PM,48,-122,85,42,127
5632,ElliotBayTrailMyrtlePark,08/23/2014 04:00:00 PM,48,-122,71,55,126
5633,ElliotBayTrailMyrtlePark,08/23/2014 05:00:00 PM,48,-122,69,63,132
5634,ElliotBayTrailMyrtlePark,08/23/2014 06:00:00 PM,48,-122,54,54,108
5635,ElliotBayTrailMyrtlePark,08/23/2014 07:00:00 PM,48,-122,49,30,79
5636,ElliotBayTrailMyrtlePark,08/23/2014 08:00:00 PM,48,-122,18,26,44
5637,ElliotBayTrailMyrtlePark,08/23/2014 09:00:00 PM,48,-122,11,4,15
5638,ElliotBayTrailMyrtlePark,08/23/2014 10:00:00 PM,48,-122,8,4,12
5639,ElliotBayTrailMyrtlePark,08/23/2014 11:00:00 PM,48,-122,5,5,10
5640,ElliotBayTrailMyrtlePark,08/24/2014 12:00:00 AM,48,-122,6,0,6
5641,ElliotBayTrailMyrtlePark,08/24/2014 01:00:00 AM,48,-122,2,0,2
5642,ElliotBayTrailMyrtlePark,08/24/2014 02:00:00 AM,48,-122,2,0,2
5643,ElliotBayTrailMyrtlePark,08/24/2014 03:00:00 AM,48,-122,1,0,1
5644,ElliotBayTrailMyrtlePark,08/24/2014 04:00:00 AM,48,-122,1,0,1
5645,ElliotBayTrailMyrtlePark,08/24/2014 05:00:00 AM,48,-122,2,4,6
5646,ElliotBayTrailMyrtlePark,08/24/2014 06:00:00 AM,48,-122,3,6,9
5647,ElliotBayTrailMyrtlePark,08/24/2014 07:00:00 AM,48,-122,7,11,18
5648,ElliotBayTrailMyrtlePark,08/24/2014 08:00:00 AM,48,-122,13,15,28
5649,ElliotBayTrailMyrtlePark,08/24/2014 09:00:00 AM,48,-122,64,44,108
5650,ElliotBayTrailMyrtlePark,08/24/2014 10:00:00 AM,48,-122,50,57,107
5651,ElliotBayTrailMyrtlePark,08/24/2014 11:00:00 AM,48,-122,58,72,130
5652,ElliotBayTrailMyrtlePark,08/24/2014 12:00:00 PM,48,-122,79,64,143
5653,ElliotBayTrailMyrtlePark,08/24/2014 01:00:00 PM,48,-122,83,89,172
5654,ElliotBayTrailMyrtlePark,08/24/2014 02:00:00 PM,48,-122,88,71,159
5655,ElliotBayTrailMyrtlePark,08/24/2014 03:00:00 PM,48,-122,127,56,183
5656,ElliotBayTrailMyrtlePark,08/24/2014 04:00:00 PM,48,-122,93,69,162
5657,ElliotBayTrailMyrtlePark,08/24/2014 05:00:00 PM,48,-122,78,68,146
5658,ElliotBayTrailMyrtlePark,08/24/2014 06:00:00 PM,48,-122,50,34,84
5659,ElliotBayTrailMyrtlePark,08/24/2014 07:00:00 PM,48,-122,51,36,87
5660,ElliotBayTrailMyrtlePark,08/24/2014 08:00:00 PM,48,-122,20,14,34
5661,ElliotBayTrailMyrtlePark,08/24/2014 09:00:00 PM,48,-122,10,9,19
5662,ElliotBayTrailMyrtlePark,08/24/2014 10:00:00 PM,48,-122,6,5,11
5663,ElliotBayTrailMyrtlePark,08/24/2014 11:00:00 PM,48,-122,2,0,2
5664,ElliotBayTrailMyrtlePark,08/25/2014 12:00:00 AM,48,-122,3,0,3
5665,ElliotBayTrailMyrtlePark,08/25/2014 01:00:00 AM,48,-122,3,2,5
5666,ElliotBayTrailMyrtlePark,08/25/2014 02:00:00 AM,48,-122,3,0,3
5667,ElliotBayTrailMyrtlePark,08/25/2014 03:00:00 AM,48,-122,1,0,1
5668,ElliotBayTrailMyrtlePark,08/25/2014 04:00:00 AM,48,-122,0,0,0
5669,ElliotBayTrailMyrtlePark,08/25/2014 05:00:00 AM,48,-122,7,14,21
5670,ElliotBayTrailMyrtlePark,08/25/2014 06:00:00 AM,48,-122,39,49,88
5671,ElliotBayTrailMyrtlePark,08/25/2014 07:00:00 AM,48,-122,69,126,195
5672,ElliotBayTrailMyrtlePark,08/25/2014 08:00:00 AM,48,-122,50,213,263
5673,ElliotBayTrailMyrtlePark,08/25/2014 09:00:00 AM,48,-122,43,101,144
5674,ElliotBayTrailMyrtlePark,08/25/2014 10:00:00 AM,48,-122,25,29,54
5675,ElliotBayTrailMyrtlePark,08/25/2014 11:00:00 AM,48,-122,23,26,49
5676,ElliotBayTrailMyrtlePark,08/25/2014 12:00:00 PM,48,-122,24,35,59
5677,ElliotBayTrailMyrtlePark,08/25/2014 01:00:00 PM,48,-122,39,40,79
5678,ElliotBayTrailMyrtlePark,08/25/2014 02:00:00 PM,48,-122,37,48,85
5679,ElliotBayTrailMyrtlePark,08/25/2014 03:00:00 PM,48,-122,45,47,92
5680,ElliotBayTrailMyrtlePark,08/25/2014 04:00:00 PM,48,-122,122,77,199
5681,ElliotBayTrailMyrtlePark,08/25/2014 05:00:00 PM,48,-122,276,86,362
5682,ElliotBayTrailMyrtlePark,08/25/2014 06:00:00 PM,48,-122,177,75,252
5683,ElliotBayTrailMyrtlePark,08/25/2014 07:00:00 PM,48,-122,69,46,115
5684,ElliotBayTrailMyrtlePark,08/25/2014 08:00:00 PM,48,-122,25,23,48
5685,ElliotBayTrailMyrtlePark,08/25/2014 09:00:00 PM,48,-122,12,3,15
5686,ElliotBayTrailMyrtlePark,08/25/2014 10:00:00 PM,48,-122,17,2,19
5687,ElliotBayTrailMyrtlePark,08/25/2014 11:00:00 PM,48,-122,9,2,11
5688,ElliotBayTrailMyrtlePark,08/26/2014 12:00:00 AM,48,-122,5,1,6
5689,ElliotBayTrailMyrtlePark,08/26/2014 01:00:00 AM,48,-122,0,0,0
5690,ElliotBayTrailMyrtlePark,08/26/2014 02:00:00 AM,48,-122,4,2,6
5691,ElliotBayTrailMyrtlePark,08/26/2014 03:00:00 AM,48,-122,0,0,0
5692,ElliotBayTrailMyrtlePark,08/26/2014 04:00:00 AM,48,-122,0,0,0
5693,ElliotBayTrailMyrtlePark,08/26/2014 05:00:00 AM,48,-122,10,21,31
5694,ElliotBayTrailMyrtlePark,08/26/2014 06:00:00 AM,48,-122,30,47,77
5695,ElliotBayTrailMyrtlePark,08/26/2014 07:00:00 AM,48,-122,80,173,253
5696,ElliotBayTrailMyrtlePark,08/26/2014 08:00:00 AM,48,-122,53,204,257
5697,ElliotBayTrailMyrtlePark,08/26/2014 09:00:00 AM,48,-122,35,96,131
5698,ElliotBayTrailMyrtlePark,08/26/2014 10:00:00 AM,48,-122,24,49,73
5699,ElliotBayTrailMyrtlePark,08/26/2014 11:00:00 AM,48,-122,20,18,38
5700,ElliotBayTrailMyrtlePark,08/26/2014 12:00:00 PM,48,-122,33,42,75
5701,ElliotBayTrailMyrtlePark,08/26/2014 01:00:00 PM,48,-122,28,35,63
5702,ElliotBayTrailMyrtlePark,08/26/2014 02:00:00 PM,48,-122,47,33,80
5703,ElliotBayTrailMyrtlePark,08/26/2014 03:00:00 PM,48,-122,59,53,112
5704,ElliotBayTrailMyrtlePark,08/26/2014 04:00:00 PM,48,-122,146,69,215
5705,ElliotBayTrailMyrtlePark,08/26/2014 05:00:00 PM,48,-122,320,96,416
5706,ElliotBayTrailMyrtlePark,08/26/2014 06:00:00 PM,48,-122,170,64,234
5707,ElliotBayTrailMyrtlePark,08/26/2014 07:00:00 PM,48,-122,77,33,110
5708,ElliotBayTrailMyrtlePark,08/26/2014 08:00:00 PM,48,-122,36,32,68
5709,ElliotBayTrailMyrtlePark,08/26/2014 09:00:00 PM,48,-122,14,2,16
5710,ElliotBayTrailMyrtlePark,08/26/2014 10:00:00 PM,48,-122,14,4,18
5711,ElliotBayTrailMyrtlePark,08/26/2014 11:00:00 PM,48,-122,5,3,8
5712,ElliotBayTrailMyrtlePark,08/27/2014 12:00:00 AM,48,-122,1,0,1
5713,ElliotBayTrailMyrtlePark,08/27/2014 01:00:00 AM,48,-122,0,0,0
5714,ElliotBayTrailMyrtlePark,08/27/2014 02:00:00 AM,48,-122,1,0,1
5715,ElliotBayTrailMyrtlePark,08/27/2014 03:00:00 AM,48,-122,1,0,1
5716,ElliotBayTrailMyrtlePark,08/27/2014 04:00:00 AM,48,-122,0,0,0
5717,ElliotBayTrailMyrtlePark,08/27/2014 05:00:00 AM,48,-122,3,16,19
5718,ElliotBayTrailMyrtlePark,08/27/2014 06:00:00 AM,48,-122,33,44,77
5719,ElliotBayTrailMyrtlePark,08/27/2014 07:00:00 AM,48,-122,61,140,201
5720,ElliotBayTrailMyrtlePark,08/27/2014 08:00:00 AM,48,-122,59,196,255
5721,ElliotBayTrailMyrtlePark,08/27/2014 09:00:00 AM,48,-122,29,92,121
5722,ElliotBayTrailMyrtlePark,08/27/2014 10:00:00 AM,48,-122,23,37,60
5723,ElliotBayTrailMyrtlePark,08/27/2014 11:00:00 AM,48,-122,30,34,64
5724,ElliotBayTrailMyrtlePark,08/27/2014 12:00:00 PM,48,-122,20,38,58
5725,ElliotBayTrailMyrtlePark,08/27/2014 01:00:00 PM,48,-122,45,40,85
5726,ElliotBayTrailMyrtlePark,08/27/2014 02:00:00 PM,48,-122,36,54,90
5727,ElliotBayTrailMyrtlePark,08/27/2014 03:00:00 PM,48,-122,66,29,95
5728,ElliotBayTrailMyrtlePark,08/27/2014 04:00:00 PM,48,-122,125,56,181
5729,ElliotBayTrailMyrtlePark,08/27/2014 05:00:00 PM,48,-122,258,87,345
5730,ElliotBayTrailMyrtlePark,08/27/2014 06:00:00 PM,48,-122,167,74,241
5731,ElliotBayTrailMyrtlePark,08/27/2014 07:00:00 PM,48,-122,84,45,129
5732,ElliotBayTrailMyrtlePark,08/27/2014 08:00:00 PM,48,-122,24,26,50
5733,ElliotBayTrailMyrtlePark,08/27/2014 09:00:00 PM,48,-122,13,8,21
5734,ElliotBayTrailMyrtlePark,08/27/2014 10:00:00 PM,48,-122,10,4,14
5735,ElliotBayTrailMyrtlePark,08/27/2014 11:00:00 PM,48,-122,1,1,2
5736,ElliotBayTrailMyrtlePark,08/28/2014 12:00:00 AM,48,-122,3,3,6
5737,ElliotBayTrailMyrtlePark,08/28/2014 01:00:00 AM,48,-122,1,1,2
5738,ElliotBayTrailMyrtlePark,08/28/2014 02:00:00 AM,48,-122,1,0,1
5739,ElliotBayTrailMyrtlePark,08/28/2014 03:00:00 AM,48,-122,2,0,2
5740,ElliotBayTrailMyrtlePark,08/28/2014 04:00:00 AM,48,-122,2,3,5
5741,ElliotBayTrailMyrtlePark,08/28/2014 05:00:00 AM,48,-122,6,17,23
5742,ElliotBayTrailMyrtlePark,08/28/2014 06:00:00 AM,48,-122,30,48,78
5743,ElliotBayTrailMyrtlePark,08/28/2014 07:00:00 AM,48,-122,56,136,192
5744,ElliotBayTrailMyrtlePark,08/28/2014 08:00:00 AM,48,-122,51,131,182
5745,ElliotBayTrailMyrtlePark,08/28/2014 09:00:00 AM,48,-122,39,84,123
5746,ElliotBayTrailMyrtlePark,08/28/2014 10:00:00 AM,48,-122,18,25,43
5747,ElliotBayTrailMyrtlePark,08/28/2014 11:00:00 AM,48,-122,19,33,52
5748,ElliotBayTrailMyrtlePark,08/28/2014 12:00:00 PM,48,-122,22,21,43
5749,ElliotBayTrailMyrtlePark,08/28/2014 01:00:00 PM,48,-122,22,20,42
5750,ElliotBayTrailMyrtlePark,08/28/2014 02:00:00 PM,48,-122,27,22,49
5751,ElliotBayTrailMyrtlePark,08/28/2014 03:00:00 PM,48,-122,53,41,94
5752,ElliotBayTrailMyrtlePark,08/28/2014 04:00:00 PM,48,-122,103,53,156
5753,ElliotBayTrailMyrtlePark,08/28/2014 05:00:00 PM,48,-122,190,87,277
5754,ElliotBayTrailMyrtlePark,08/28/2014 06:00:00 PM,48,-122,156,55,211
5755,ElliotBayTrailMyrtlePark,08/28/2014 07:00:00 PM,48,-122,69,32,101
5756,ElliotBayTrailMyrtlePark,08/28/2014 08:00:00 PM,48,-122,36,28,64
5757,ElliotBayTrailMyrtlePark,08/28/2014 09:00:00 PM,48,-122,13,3,16
5758,ElliotBayTrailMyrtlePark,08/28/2014 10:00:00 PM,48,-122,7,6,13
5759,ElliotBayTrailMyrtlePark,08/28/2014 11:00:00 PM,48,-122,1,0,1
5760,ElliotBayTrailMyrtlePark,08/29/2014 12:00:00 AM,48,-122,6,1,7
5761,ElliotBayTrailMyrtlePark,08/29/2014 01:00:00 AM,48,-122,2,0,2
5762,ElliotBayTrailMyrtlePark,08/29/2014 02:00:00 AM,48,-122,5,1,6
5763,ElliotBayTrailMyrtlePark,08/29/2014 03:00:00 AM,48,-122,2,2,4
5764,ElliotBayTrailMyrtlePark,08/29/2014 04:00:00 AM,48,-122,0,0,0
5765,ElliotBayTrailMyrtlePark,08/29/2014 05:00:00 AM,48,-122,3,16,19
5766,ElliotBayTrailMyrtlePark,08/29/2014 06:00:00 AM,48,-122,31,29,60
5767,ElliotBayTrailMyrtlePark,08/29/2014 07:00:00 AM,48,-122,38,89,127
5768,ElliotBayTrailMyrtlePark,08/29/2014 08:00:00 AM,48,-122,32,108,140
5769,ElliotBayTrailMyrtlePark,08/29/2014 09:00:00 AM,48,-122,32,69,101
5770,ElliotBayTrailMyrtlePark,08/29/2014 10:00:00 AM,48,-122,16,36,52
5771,ElliotBayTrailMyrtlePark,08/29/2014 11:00:00 AM,48,-122,15,23,38
5772,ElliotBayTrailMyrtlePark,08/29/2014 12:00:00 PM,48,-122,27,14,41
5773,ElliotBayTrailMyrtlePark,08/29/2014 01:00:00 PM,48,-122,21,15,36
5774,ElliotBayTrailMyrtlePark,08/29/2014 02:00:00 PM,48,-122,23,38,61
5775,ElliotBayTrailMyrtlePark,08/29/2014 03:00:00 PM,48,-122,47,44,91
5776,ElliotBayTrailMyrtlePark,08/29/2014 04:00:00 PM,48,-122,113,46,159
5777,ElliotBayTrailMyrtlePark,08/29/2014 05:00:00 PM,48,-122,138,47,185
5778,ElliotBayTrailMyrtlePark,08/29/2014 06:00:00 PM,48,-122,83,46,129
5779,ElliotBayTrailMyrtlePark,08/29/2014 07:00:00 PM,48,-122,28,23,51
5780,ElliotBayTrailMyrtlePark,08/29/2014 08:00:00 PM,48,-122,17,6,23
5781,ElliotBayTrailMyrtlePark,08/29/2014 09:00:00 PM,48,-122,5,2,7
5782,ElliotBayTrailMyrtlePark,08/29/2014 10:00:00 PM,48,-122,12,1,13
5783,ElliotBayTrailMyrtlePark,08/29/2014 11:00:00 PM,48,-122,8,6,14
5784,ElliotBayTrailMyrtlePark,08/30/2014 12:00:00 AM,48,-122,10,2,12
5785,ElliotBayTrailMyrtlePark,08/30/2014 01:00:00 AM,48,-122,7,0,7
5786,ElliotBayTrailMyrtlePark,08/30/2014 02:00:00 AM,48,-122,0,0,0
5787,ElliotBayTrailMyrtlePark,08/30/2014 03:00:00 AM,48,-122,0,0,0
5788,ElliotBayTrailMyrtlePark,08/30/2014 04:00:00 AM,48,-122,0,1,1
5789,ElliotBayTrailMyrtlePark,08/30/2014 05:00:00 AM,48,-122,2,2,4
5790,ElliotBayTrailMyrtlePark,08/30/2014 06:00:00 AM,48,-122,3,6,9
5791,ElliotBayTrailMyrtlePark,08/30/2014 07:00:00 AM,48,-122,6,5,11
5792,ElliotBayTrailMyrtlePark,08/30/2014 08:00:00 AM,48,-122,11,8,19
5793,ElliotBayTrailMyrtlePark,08/30/2014 09:00:00 AM,48,-122,12,8,20
5794,ElliotBayTrailMyrtlePark,08/30/2014 10:00:00 AM,48,-122,12,25,37
5795,ElliotBayTrailMyrtlePark,08/30/2014 11:00:00 AM,48,-122,8,8,16
5796,ElliotBayTrailMyrtlePark,08/30/2014 12:00:00 PM,48,-122,12,18,30
5797,ElliotBayTrailMyrtlePark,08/30/2014 01:00:00 PM,48,-122,12,8,20
5798,ElliotBayTrailMyrtlePark,08/30/2014 02:00:00 PM,48,-122,6,14,20
5799,ElliotBayTrailMyrtlePark,08/30/2014 03:00:00 PM,48,-122,27,11,38
5800,ElliotBayTrailMyrtlePark,08/30/2014 04:00:00 PM,48,-122,20,22,42
5801,ElliotBayTrailMyrtlePark,08/30/2014 05:00:00 PM,48,-122,11,15,26
5802,ElliotBayTrailMyrtlePark,08/30/2014 06:00:00 PM,48,-122,12,21,33
5803,ElliotBayTrailMyrtlePark,08/30/2014 07:00:00 PM,48,-122,9,4,13
5804,ElliotBayTrailMyrtlePark,08/30/2014 08:00:00 PM,48,-122,11,9,20
5805,ElliotBayTrailMyrtlePark,08/30/2014 09:00:00 PM,48,-122,7,4,11
5806,ElliotBayTrailMyrtlePark,08/30/2014 10:00:00 PM,48,-122,0,0,0
5807,ElliotBayTrailMyrtlePark,08/30/2014 11:00:00 PM,48,-122,3,0,3
5808,ElliotBayTrailMyrtlePark,08/31/2014 12:00:00 AM,48,-122,1,0,1
5809,ElliotBayTrailMyrtlePark,08/31/2014 01:00:00 AM,48,-122,0,0,0
5810,ElliotBayTrailMyrtlePark,08/31/2014 02:00:00 AM,48,-122,1,0,1
5811,ElliotBayTrailMyrtlePark,08/31/2014 03:00:00 AM,48,-122,0,0,0
5812,ElliotBayTrailMyrtlePark,08/31/2014 04:00:00 AM,48,-122,0,0,0
5813,ElliotBayTrailMyrtlePark,08/31/2014 05:00:00 AM,48,-122,0,2,2
5814,ElliotBayTrailMyrtlePark,08/31/2014 06:00:00 AM,48,-122,2,2,4
5815,ElliotBayTrailMyrtlePark,08/31/2014 07:00:00 AM,48,-122,4,6,10
5816,ElliotBayTrailMyrtlePark,08/31/2014 08:00:00 AM,48,-122,4,6,10
5817,ElliotBayTrailMyrtlePark,08/31/2014 09:00:00 AM,48,-122,13,13,26
5818,ElliotBayTrailMyrtlePark,08/31/2014 10:00:00 AM,48,-122,27,29,56
5819,ElliotBayTrailMyrtlePark,08/31/2014 11:00:00 AM,48,-122,46,38,84
5820,ElliotBayTrailMyrtlePark,08/31/2014 12:00:00 PM,48,-122,53,47,100
5821,ElliotBayTrailMyrtlePark,08/31/2014 01:00:00 PM,48,-122,55,63,118
5822,ElliotBayTrailMyrtlePark,08/31/2014 02:00:00 PM,48,-122,49,38,87
5823,ElliotBayTrailMyrtlePark,08/31/2014 03:00:00 PM,48,-122,64,58,122
5824,ElliotBayTrailMyrtlePark,08/31/2014 04:00:00 PM,48,-122,58,37,95
5825,ElliotBayTrailMyrtlePark,08/31/2014 05:00:00 PM,48,-122,39,33,72
5826,ElliotBayTrailMyrtlePark,08/31/2014 06:00:00 PM,48,-122,37,27,64
5827,ElliotBayTrailMyrtlePark,08/31/2014 07:00:00 PM,48,-122,22,22,44
5828,ElliotBayTrailMyrtlePark,08/31/2014 08:00:00 PM,48,-122,17,23,40
5829,ElliotBayTrailMyrtlePark,08/31/2014 09:00:00 PM,48,-122,5,5,10
5830,ElliotBayTrailMyrtlePark,08/31/2014 10:00:00 PM,48,-122,5,8,13
5831,ElliotBayTrailMyrtlePark,08/31/2014 11:00:00 PM,48,-122,5,1,6
5832,ElliotBayTrailMyrtlePark,09/01/2014 12:00:00 AM,48,-122,2,1,3
5833,ElliotBayTrailMyrtlePark,09/01/2014 01:00:00 AM,48,-122,5,0,5
5834,ElliotBayTrailMyrtlePark,09/01/2014 02:00:00 AM,48,-122,3,1,4
5835,ElliotBayTrailMyrtlePark,09/01/2014 03:00:00 AM,48,-122,1,0,1
5836,ElliotBayTrailMyrtlePark,09/01/2014 04:00:00 AM,48,-122,0,0,0
5837,ElliotBayTrailMyrtlePark,09/01/2014 05:00:00 AM,48,-122,0,2,2
5838,ElliotBayTrailMyrtlePark,09/01/2014 06:00:00 AM,48,-122,8,6,14
5839,ElliotBayTrailMyrtlePark,09/01/2014 07:00:00 AM,48,-122,8,7,15
5840,ElliotBayTrailMyrtlePark,09/01/2014 08:00:00 AM,48,-122,18,18,36
5841,ElliotBayTrailMyrtlePark,09/01/2014 09:00:00 AM,48,-122,34,89,123
5842,ElliotBayTrailMyrtlePark,09/01/2014 10:00:00 AM,48,-122,43,55,98
5843,ElliotBayTrailMyrtlePark,09/01/2014 11:00:00 AM,48,-122,66,61,127
5844,ElliotBayTrailMyrtlePark,09/01/2014 12:00:00 PM,48,-122,74,61,135
5845,ElliotBayTrailMyrtlePark,09/01/2014 01:00:00 PM,48,-122,97,89,186
5846,ElliotBayTrailMyrtlePark,09/01/2014 02:00:00 PM,48,-122,74,79,153
5847,ElliotBayTrailMyrtlePark,09/01/2014 03:00:00 PM,48,-122,112,82,194
5848,ElliotBayTrailMyrtlePark,09/01/2014 04:00:00 PM,48,-122,101,99,200
5849,ElliotBayTrailMyrtlePark,09/01/2014 05:00:00 PM,48,-122,82,51,133
5850,ElliotBayTrailMyrtlePark,09/01/2014 06:00:00 PM,48,-122,60,71,131
5851,ElliotBayTrailMyrtlePark,09/01/2014 07:00:00 PM,48,-122,31,39,70
5852,ElliotBayTrailMyrtlePark,09/01/2014 08:00:00 PM,48,-122,14,24,38
5853,ElliotBayTrailMyrtlePark,09/01/2014 09:00:00 PM,48,-122,8,2,10
5854,ElliotBayTrailMyrtlePark,09/01/2014 10:00:00 PM,48,-122,5,2,7
5855,ElliotBayTrailMyrtlePark,09/01/2014 11:00:00 PM,48,-122,3,1,4
5856,ElliotBayTrailMyrtlePark,09/02/2014 12:00:00 AM,48,-122,3,0,3
5857,ElliotBayTrailMyrtlePark,09/02/2014 01:00:00 AM,48,-122,1,0,1
5858,ElliotBayTrailMyrtlePark,09/02/2014 02:00:00 AM,48,-122,0,0,0
5859,ElliotBayTrailMyrtlePark,09/02/2014 03:00:00 AM,48,-122,2,1,3
5860,ElliotBayTrailMyrtlePark,09/02/2014 04:00:00 AM,48,-122,0,0,0
5861,ElliotBayTrailMyrtlePark,09/02/2014 05:00:00 AM,48,-122,5,12,17
5862,ElliotBayTrailMyrtlePark,09/02/2014 06:00:00 AM,48,-122,25,32,57
5863,ElliotBayTrailMyrtlePark,09/02/2014 07:00:00 AM,48,-122,58,100,158
5864,ElliotBayTrailMyrtlePark,09/02/2014 08:00:00 AM,48,-122,42,148,190
5865,ElliotBayTrailMyrtlePark,09/02/2014 09:00:00 AM,48,-122,26,79,105
5866,ElliotBayTrailMyrtlePark,09/02/2014 10:00:00 AM,48,-122,20,33,53
5867,ElliotBayTrailMyrtlePark,09/02/2014 11:00:00 AM,48,-122,21,34,55
5868,ElliotBayTrailMyrtlePark,09/02/2014 12:00:00 PM,48,-122,28,29,57
5869,ElliotBayTrailMyrtlePark,09/02/2014 01:00:00 PM,48,-122,18,20,38
5870,ElliotBayTrailMyrtlePark,09/02/2014 02:00:00 PM,48,-122,19,21,40
5871,ElliotBayTrailMyrtlePark,09/02/2014 03:00:00 PM,48,-122,28,27,55
5872,ElliotBayTrailMyrtlePark,09/02/2014 04:00:00 PM,48,-122,65,43,108
5873,ElliotBayTrailMyrtlePark,09/02/2014 05:00:00 PM,48,-122,190,47,237
5874,ElliotBayTrailMyrtlePark,09/02/2014 06:00:00 PM,48,-122,110,41,151
5875,ElliotBayTrailMyrtlePark,09/02/2014 07:00:00 PM,48,-122,30,24,54
5876,ElliotBayTrailMyrtlePark,09/02/2014 08:00:00 PM,48,-122,10,3,13
5877,ElliotBayTrailMyrtlePark,09/02/2014 09:00:00 PM,48,-122,5,0,5
5878,ElliotBayTrailMyrtlePark,09/02/2014 10:00:00 PM,48,-122,6,1,7
5879,ElliotBayTrailMyrtlePark,09/02/2014 11:00:00 PM,48,-122,3,1,4
5880,ElliotBayTrailMyrtlePark,09/03/2014 12:00:00 AM,48,-122,4,1,5
5881,ElliotBayTrailMyrtlePark,09/03/2014 01:00:00 AM,48,-122,1,0,1
5882,ElliotBayTrailMyrtlePark,09/03/2014 02:00:00 AM,48,-122,1,1,2
5883,ElliotBayTrailMyrtlePark,09/03/2014 03:00:00 AM,48,-122,0,0,0
5884,ElliotBayTrailMyrtlePark,09/03/2014 04:00:00 AM,48,-122,0,0,0
5885,ElliotBayTrailMyrtlePark,09/03/2014 05:00:00 AM,48,-122,7,13,20
5886,ElliotBayTrailMyrtlePark,09/03/2014 06:00:00 AM,48,-122,24,41,65
5887,ElliotBayTrailMyrtlePark,09/03/2014 07:00:00 AM,48,-122,44,110,154
5888,ElliotBayTrailMyrtlePark,09/03/2014 08:00:00 AM,48,-122,34,151,185
5889,ElliotBayTrailMyrtlePark,09/03/2014 09:00:00 AM,48,-122,24,90,114
5890,ElliotBayTrailMyrtlePark,09/03/2014 10:00:00 AM,48,-122,15,32,47
5891,ElliotBayTrailMyrtlePark,09/03/2014 11:00:00 AM,48,-122,15,29,44
5892,ElliotBayTrailMyrtlePark,09/03/2014 12:00:00 PM,48,-122,34,27,61
5893,ElliotBayTrailMyrtlePark,09/03/2014 01:00:00 PM,48,-122,19,21,40
5894,ElliotBayTrailMyrtlePark,09/03/2014 02:00:00 PM,48,-122,34,21,55
5895,ElliotBayTrailMyrtlePark,09/03/2014 03:00:00 PM,48,-122,39,54,93
5896,ElliotBayTrailMyrtlePark,09/03/2014 04:00:00 PM,48,-122,97,63,160
5897,ElliotBayTrailMyrtlePark,09/03/2014 05:00:00 PM,48,-122,220,77,297
5898,ElliotBayTrailMyrtlePark,09/03/2014 06:00:00 PM,48,-122,178,56,234
5899,ElliotBayTrailMyrtlePark,09/03/2014 07:00:00 PM,48,-122,68,51,119
5900,ElliotBayTrailMyrtlePark,09/03/2014 08:00:00 PM,48,-122,36,24,60
5901,ElliotBayTrailMyrtlePark,09/03/2014 09:00:00 PM,48,-122,6,10,16
5902,ElliotBayTrailMyrtlePark,09/03/2014 10:00:00 PM,48,-122,5,1,6
5903,ElliotBayTrailMyrtlePark,09/03/2014 11:00:00 PM,48,-122,7,1,8
5904,ElliotBayTrailMyrtlePark,09/04/2014 12:00:00 AM,48,-122,4,0,4
5905,ElliotBayTrailMyrtlePark,09/04/2014 01:00:00 AM,48,-122,1,1,2
5906,ElliotBayTrailMyrtlePark,09/04/2014 02:00:00 AM,48,-122,6,0,6
5907,ElliotBayTrailMyrtlePark,09/04/2014 03:00:00 AM,48,-122,1,0,1
5908,ElliotBayTrailMyrtlePark,09/04/2014 04:00:00 AM,48,-122,0,1,1
5909,ElliotBayTrailMyrtlePark,09/04/2014 05:00:00 AM,48,-122,7,14,21
5910,ElliotBayTrailMyrtlePark,09/04/2014 06:00:00 AM,48,-122,39,57,96
5911,ElliotBayTrailMyrtlePark,09/04/2014 07:00:00 AM,48,-122,51,158,209
5912,ElliotBayTrailMyrtlePark,09/04/2014 08:00:00 AM,48,-122,47,211,258
5913,ElliotBayTrailMyrtlePark,09/04/2014 09:00:00 AM,48,-122,49,100,149
5914,ElliotBayTrailMyrtlePark,09/04/2014 10:00:00 AM,48,-122,30,48,78
5915,ElliotBayTrailMyrtlePark,09/04/2014 11:00:00 AM,48,-122,24,30,54
5916,ElliotBayTrailMyrtlePark,09/04/2014 12:00:00 PM,48,-122,27,33,60
5917,ElliotBayTrailMyrtlePark,09/04/2014 01:00:00 PM,48,-122,44,54,98
5918,ElliotBayTrailMyrtlePark,09/04/2014 02:00:00 PM,48,-122,49,57,106
5919,ElliotBayTrailMyrtlePark,09/04/2014 03:00:00 PM,48,-122,78,75,153
5920,ElliotBayTrailMyrtlePark,09/04/2014 04:00:00 PM,48,-122,198,92,290
5921,ElliotBayTrailMyrtlePark,09/04/2014 05:00:00 PM,48,-122,270,75,345
5922,ElliotBayTrailMyrtlePark,09/04/2014 06:00:00 PM,48,-122,134,41,175
5923,ElliotBayTrailMyrtlePark,09/04/2014 07:00:00 PM,48,-122,87,37,124
5924,ElliotBayTrailMyrtlePark,09/04/2014 08:00:00 PM,48,-122,18,13,31
5925,ElliotBayTrailMyrtlePark,09/04/2014 09:00:00 PM,48,-122,33,11,44
5926,ElliotBayTrailMyrtlePark,09/04/2014 10:00:00 PM,48,-122,13,5,18
5927,ElliotBayTrailMyrtlePark,09/04/2014 11:00:00 PM,48,-122,4,5,9
5928,ElliotBayTrailMyrtlePark,09/05/2014 12:00:00 AM,48,-122,5,8,13
5929,ElliotBayTrailMyrtlePark,09/05/2014 01:00:00 AM,48,-122,1,12,13
5930,ElliotBayTrailMyrtlePark,09/05/2014 02:00:00 AM,48,-122,4,2,6
5931,ElliotBayTrailMyrtlePark,09/05/2014 03:00:00 AM,48,-122,1,0,1
5932,ElliotBayTrailMyrtlePark,09/05/2014 04:00:00 AM,48,-122,2,0,2
5933,ElliotBayTrailMyrtlePark,09/05/2014 05:00:00 AM,48,-122,7,17,24
5934,ElliotBayTrailMyrtlePark,09/05/2014 06:00:00 AM,48,-122,18,40,58
5935,ElliotBayTrailMyrtlePark,09/05/2014 07:00:00 AM,48,-122,55,105,160
5936,ElliotBayTrailMyrtlePark,09/05/2014 08:00:00 AM,48,-122,54,142,196
5937,ElliotBayTrailMyrtlePark,09/05/2014 09:00:00 AM,48,-122,33,97,130
5938,ElliotBayTrailMyrtlePark,09/05/2014 10:00:00 AM,48,-122,27,30,57
5939,ElliotBayTrailMyrtlePark,09/05/2014 11:00:00 AM,48,-122,28,32,60
5940,ElliotBayTrailMyrtlePark,09/05/2014 12:00:00 PM,48,-122,24,31,55
5941,ElliotBayTrailMyrtlePark,09/05/2014 01:00:00 PM,48,-122,39,34,73
5942,ElliotBayTrailMyrtlePark,09/05/2014 02:00:00 PM,48,-122,37,39,76
5943,ElliotBayTrailMyrtlePark,09/05/2014 03:00:00 PM,48,-122,63,43,106
5944,ElliotBayTrailMyrtlePark,09/05/2014 04:00:00 PM,48,-122,122,72,194
5945,ElliotBayTrailMyrtlePark,09/05/2014 05:00:00 PM,48,-122,195,86,281
5946,ElliotBayTrailMyrtlePark,09/05/2014 06:00:00 PM,48,-122,167,42,209
5947,ElliotBayTrailMyrtlePark,09/05/2014 07:00:00 PM,48,-122,52,30,82
5948,ElliotBayTrailMyrtlePark,09/05/2014 08:00:00 PM,48,-122,22,17,39
5949,ElliotBayTrailMyrtlePark,09/05/2014 09:00:00 PM,48,-122,8,5,13
5950,ElliotBayTrailMyrtlePark,09/05/2014 10:00:00 PM,48,-122,8,1,9
5951,ElliotBayTrailMyrtlePark,09/05/2014 11:00:00 PM,48,-122,4,4,8
5952,ElliotBayTrailMyrtlePark,09/06/2014 12:00:00 AM,48,-122,6,0,6
5953,ElliotBayTrailMyrtlePark,09/06/2014 01:00:00 AM,48,-122,2,2,4
5954,ElliotBayTrailMyrtlePark,09/06/2014 02:00:00 AM,48,-122,3,0,3
5955,ElliotBayTrailMyrtlePark,09/06/2014 03:00:00 AM,48,-122,0,1,1
5956,ElliotBayTrailMyrtlePark,09/06/2014 04:00:00 AM,48,-122,0,0,0
5957,ElliotBayTrailMyrtlePark,09/06/2014 05:00:00 AM,48,-122,1,3,4
5958,ElliotBayTrailMyrtlePark,09/06/2014 06:00:00 AM,48,-122,7,18,25
5959,ElliotBayTrailMyrtlePark,09/06/2014 07:00:00 AM,48,-122,10,11,21
5960,ElliotBayTrailMyrtlePark,09/06/2014 08:00:00 AM,48,-122,26,33,59
5961,ElliotBayTrailMyrtlePark,09/06/2014 09:00:00 AM,48,-122,18,33,51
5962,ElliotBayTrailMyrtlePark,09/06/2014 10:00:00 AM,48,-122,46,49,95
5963,ElliotBayTrailMyrtlePark,09/06/2014 11:00:00 AM,48,-122,84,46,130
5964,ElliotBayTrailMyrtlePark,09/06/2014 12:00:00 PM,48,-122,58,64,122
5965,ElliotBayTrailMyrtlePark,09/06/2014 01:00:00 PM,48,-122,45,66,111
5966,ElliotBayTrailMyrtlePark,09/06/2014 02:00:00 PM,48,-122,85,60,145
5967,ElliotBayTrailMyrtlePark,09/06/2014 03:00:00 PM,48,-122,71,54,125
5968,ElliotBayTrailMyrtlePark,09/06/2014 04:00:00 PM,48,-122,65,54,119
5969,ElliotBayTrailMyrtlePark,09/06/2014 05:00:00 PM,48,-122,72,49,121
5970,ElliotBayTrailMyrtlePark,09/06/2014 06:00:00 PM,48,-122,45,55,100
5971,ElliotBayTrailMyrtlePark,09/06/2014 07:00:00 PM,48,-122,25,33,58
5972,ElliotBayTrailMyrtlePark,09/06/2014 08:00:00 PM,48,-122,18,16,34
5973,ElliotBayTrailMyrtlePark,09/06/2014 09:00:00 PM,48,-122,5,0,5
5974,ElliotBayTrailMyrtlePark,09/06/2014 10:00:00 PM,48,-122,9,9,18
5975,ElliotBayTrailMyrtlePark,09/06/2014 11:00:00 PM,48,-122,6,1,7
5976,ElliotBayTrailMyrtlePark,09/07/2014 12:00:00 AM,48,-122,3,3,6
5977,ElliotBayTrailMyrtlePark,09/07/2014 01:00:00 AM,48,-122,2,0,2
5978,ElliotBayTrailMyrtlePark,09/07/2014 02:00:00 AM,48,-122,1,0,1
5979,ElliotBayTrailMyrtlePark,09/07/2014 03:00:00 AM,48,-122,2,0,2
5980,ElliotBayTrailMyrtlePark,09/07/2014 04:00:00 AM,48,-122,1,0,1
5981,ElliotBayTrailMyrtlePark,09/07/2014 05:00:00 AM,48,-122,0,1,1
5982,ElliotBayTrailMyrtlePark,09/07/2014 06:00:00 AM,48,-122,5,3,8
5983,ElliotBayTrailMyrtlePark,09/07/2014 07:00:00 AM,48,-122,5,7,12
5984,ElliotBayTrailMyrtlePark,09/07/2014 08:00:00 AM,48,-122,11,18,29
5985,ElliotBayTrailMyrtlePark,09/07/2014 09:00:00 AM,48,-122,50,29,79
5986,ElliotBayTrailMyrtlePark,09/07/2014 10:00:00 AM,48,-122,44,49,93
5987,ElliotBayTrailMyrtlePark,09/07/2014 11:00:00 AM,48,-122,51,91,142
5988,ElliotBayTrailMyrtlePark,09/07/2014 12:00:00 PM,48,-122,72,61,133
5989,ElliotBayTrailMyrtlePark,09/07/2014 01:00:00 PM,48,-122,80,52,132
5990,ElliotBayTrailMyrtlePark,09/07/2014 02:00:00 PM,48,-122,73,99,172
5991,ElliotBayTrailMyrtlePark,09/07/2014 03:00:00 PM,48,-122,84,87,171
5992,ElliotBayTrailMyrtlePark,09/07/2014 04:00:00 PM,48,-122,73,62,135
5993,ElliotBayTrailMyrtlePark,09/07/2014 05:00:00 PM,48,-122,67,80,147
5994,ElliotBayTrailMyrtlePark,09/07/2014 06:00:00 PM,48,-122,63,51,114
5995,ElliotBayTrailMyrtlePark,09/07/2014 07:00:00 PM,48,-122,33,45,78
5996,ElliotBayTrailMyrtlePark,09/07/2014 08:00:00 PM,48,-122,16,21,37
5997,ElliotBayTrailMyrtlePark,09/07/2014 09:00:00 PM,48,-122,5,1,6
5998,ElliotBayTrailMyrtlePark,09/07/2014 10:00:00 PM,48,-122,8,4,12
5999,ElliotBayTrailMyrtlePark,09/07/2014 11:00:00 PM,48,-122,4,2,6
6000,ElliotBayTrailMyrtlePark,09/08/2014 12:00:00 AM,48,-122,4,2,6
6001,ElliotBayTrailMyrtlePark,09/08/2014 01:00:00 AM,48,-122,0,0,0
6002,ElliotBayTrailMyrtlePark,09/08/2014 02:00:00 AM,48,-122,1,0,1
6003,ElliotBayTrailMyrtlePark,09/08/2014 03:00:00 AM,48,-122,0,0,0
6004,ElliotBayTrailMyrtlePark,09/08/2014 04:00:00 AM,48,-122,0,0,0
6005,ElliotBayTrailMyrtlePark,09/08/2014 05:00:00 AM,48,-122,10,19,29
6006,ElliotBayTrailMyrtlePark,09/08/2014 06:00:00 AM,48,-122,19,36,55
6007,ElliotBayTrailMyrtlePark,09/08/2014 07:00:00 AM,48,-122,50,119,169
6008,ElliotBayTrailMyrtlePark,09/08/2014 08:00:00 AM,48,-122,33,151,184
6009,ElliotBayTrailMyrtlePark,09/08/2014 09:00:00 AM,48,-122,34,91,125
6010,ElliotBayTrailMyrtlePark,09/08/2014 10:00:00 AM,48,-122,14,26,40
6011,ElliotBayTrailMyrtlePark,09/08/2014 11:00:00 AM,48,-122,12,21,33
6012,ElliotBayTrailMyrtlePark,09/08/2014 12:00:00 PM,48,-122,13,10,23
6013,ElliotBayTrailMyrtlePark,09/08/2014 01:00:00 PM,48,-122,19,21,40
6014,ElliotBayTrailMyrtlePark,09/08/2014 02:00:00 PM,48,-122,18,21,39
6015,ElliotBayTrailMyrtlePark,09/08/2014 03:00:00 PM,48,-122,30,35,65
6016,ElliotBayTrailMyrtlePark,09/08/2014 04:00:00 PM,48,-122,69,55,124
6017,ElliotBayTrailMyrtlePark,09/08/2014 05:00:00 PM,48,-122,208,65,273
6018,ElliotBayTrailMyrtlePark,09/08/2014 06:00:00 PM,48,-122,136,64,200
6019,ElliotBayTrailMyrtlePark,09/08/2014 07:00:00 PM,48,-122,44,17,61
6020,ElliotBayTrailMyrtlePark,09/08/2014 08:00:00 PM,48,-122,7,8,15
6021,ElliotBayTrailMyrtlePark,09/08/2014 09:00:00 PM,48,-122,5,1,6
6022,ElliotBayTrailMyrtlePark,09/08/2014 10:00:00 PM,48,-122,5,4,9
6023,ElliotBayTrailMyrtlePark,09/08/2014 11:00:00 PM,48,-122,19,1,20
6024,ElliotBayTrailMyrtlePark,09/09/2014 12:00:00 AM,48,-122,0,1,1
6025,ElliotBayTrailMyrtlePark,09/09/2014 01:00:00 AM,48,-122,4,0,4
6026,ElliotBayTrailMyrtlePark,09/09/2014 02:00:00 AM,48,-122,1,0,1
6027,ElliotBayTrailMyrtlePark,09/09/2014 03:00:00 AM,48,-122,0,0,0
6028,ElliotBayTrailMyrtlePark,09/09/2014 04:00:00 AM,48,-122,0,1,1
6029,ElliotBayTrailMyrtlePark,09/09/2014 05:00:00 AM,48,-122,8,16,24
6030,ElliotBayTrailMyrtlePark,09/09/2014 06:00:00 AM,48,-122,21,39,60
6031,ElliotBayTrailMyrtlePark,09/09/2014 07:00:00 AM,48,-122,43,121,164
6032,ElliotBayTrailMyrtlePark,09/09/2014 08:00:00 AM,48,-122,38,153,191
6033,ElliotBayTrailMyrtlePark,09/09/2014 09:00:00 AM,48,-122,14,74,88
6034,ElliotBayTrailMyrtlePark,09/09/2014 10:00:00 AM,48,-122,12,34,46
6035,ElliotBayTrailMyrtlePark,09/09/2014 11:00:00 AM,48,-122,14,19,33
6036,ElliotBayTrailMyrtlePark,09/09/2014 12:00:00 PM,48,-122,19,21,40
6037,ElliotBayTrailMyrtlePark,09/09/2014 01:00:00 PM,48,-122,18,20,38
6038,ElliotBayTrailMyrtlePark,09/09/2014 02:00:00 PM,48,-122,48,29,77
6039,ElliotBayTrailMyrtlePark,09/09/2014 03:00:00 PM,48,-122,37,32,69
6040,ElliotBayTrailMyrtlePark,09/09/2014 04:00:00 PM,48,-122,99,40,139
6041,ElliotBayTrailMyrtlePark,09/09/2014 05:00:00 PM,48,-122,191,84,275
6042,ElliotBayTrailMyrtlePark,09/09/2014 06:00:00 PM,48,-122,154,53,207
6043,ElliotBayTrailMyrtlePark,09/09/2014 07:00:00 PM,48,-122,52,35,87
6044,ElliotBayTrailMyrtlePark,09/09/2014 08:00:00 PM,48,-122,18,12,30
6045,ElliotBayTrailMyrtlePark,09/09/2014 09:00:00 PM,48,-122,11,6,17
6046,ElliotBayTrailMyrtlePark,09/09/2014 10:00:00 PM,48,-122,20,4,24
6047,ElliotBayTrailMyrtlePark,09/09/2014 11:00:00 PM,48,-122,7,0,7
6048,ElliotBayTrailMyrtlePark,09/10/2014 12:00:00 AM,48,-122,2,2,4
6049,ElliotBayTrailMyrtlePark,09/10/2014 01:00:00 AM,48,-122,0,1,1
6050,ElliotBayTrailMyrtlePark,09/10/2014 02:00:00 AM,48,-122,3,0,3
6051,ElliotBayTrailMyrtlePark,09/10/2014 03:00:00 AM,48,-122,0,0,0
6052,ElliotBayTrailMyrtlePark,09/10/2014 04:00:00 AM,48,-122,0,0,0
6053,ElliotBayTrailMyrtlePark,09/10/2014 05:00:00 AM,48,-122,10,15,25
6054,ElliotBayTrailMyrtlePark,09/10/2014 06:00:00 AM,48,-122,21,41,62
6055,ElliotBayTrailMyrtlePark,09/10/2014 07:00:00 AM,48,-122,43,104,147
6056,ElliotBayTrailMyrtlePark,09/10/2014 08:00:00 AM,48,-122,47,155,202
6057,ElliotBayTrailMyrtlePark,09/10/2014 09:00:00 AM,48,-122,22,85,107
6058,ElliotBayTrailMyrtlePark,09/10/2014 10:00:00 AM,48,-122,14,21,35
6059,ElliotBayTrailMyrtlePark,09/10/2014 11:00:00 AM,48,-122,12,15,27
6060,ElliotBayTrailMyrtlePark,09/10/2014 12:00:00 PM,48,-122,9,21,30
6061,ElliotBayTrailMyrtlePark,09/10/2014 01:00:00 PM,48,-122,27,23,50
6062,ElliotBayTrailMyrtlePark,09/10/2014 02:00:00 PM,48,-122,32,36,68
6063,ElliotBayTrailMyrtlePark,09/10/2014 03:00:00 PM,48,-122,52,35,87
6064,ElliotBayTrailMyrtlePark,09/10/2014 04:00:00 PM,48,-122,83,52,135
6065,ElliotBayTrailMyrtlePark,09/10/2014 05:00:00 PM,48,-122,205,89,294
6066,ElliotBayTrailMyrtlePark,09/10/2014 06:00:00 PM,48,-122,157,56,213
6067,ElliotBayTrailMyrtlePark,09/10/2014 07:00:00 PM,48,-122,52,39,91
6068,ElliotBayTrailMyrtlePark,09/10/2014 08:00:00 PM,48,-122,32,10,42
6069,ElliotBayTrailMyrtlePark,09/10/2014 09:00:00 PM,48,-122,8,0,8
6070,ElliotBayTrailMyrtlePark,09/10/2014 10:00:00 PM,48,-122,5,2,7
6071,ElliotBayTrailMyrtlePark,09/10/2014 11:00:00 PM,48,-122,3,0,3
6072,ElliotBayTrailMyrtlePark,09/11/2014 12:00:00 AM,48,-122,2,0,2
6073,ElliotBayTrailMyrtlePark,09/11/2014 01:00:00 AM,48,-122,0,0,0
6074,ElliotBayTrailMyrtlePark,09/11/2014 02:00:00 AM,48,-122,2,0,2
6075,ElliotBayTrailMyrtlePark,09/11/2014 03:00:00 AM,48,-122,0,0,0
6076,ElliotBayTrailMyrtlePark,09/11/2014 04:00:00 AM,48,-122,0,1,1
6077,ElliotBayTrailMyrtlePark,09/11/2014 05:00:00 AM,48,-122,6,11,17
6078,ElliotBayTrailMyrtlePark,09/11/2014 06:00:00 AM,48,-122,19,35,54
6079,ElliotBayTrailMyrtlePark,09/11/2014 07:00:00 AM,48,-122,45,111,156
6080,ElliotBayTrailMyrtlePark,09/11/2014 08:00:00 AM,48,-122,50,163,213
6081,ElliotBayTrailMyrtlePark,09/11/2014 09:00:00 AM,48,-122,20,90,110
6082,ElliotBayTrailMyrtlePark,09/11/2014 10:00:00 AM,48,-122,23,32,55
6083,ElliotBayTrailMyrtlePark,09/11/2014 11:00:00 AM,48,-122,28,20,48
6084,ElliotBayTrailMyrtlePark,09/11/2014 12:00:00 PM,48,-122,27,40,67
6085,ElliotBayTrailMyrtlePark,09/11/2014 01:00:00 PM,48,-122,29,28,57
6086,ElliotBayTrailMyrtlePark,09/11/2014 02:00:00 PM,48,-122,32,40,72
6087,ElliotBayTrailMyrtlePark,09/11/2014 03:00:00 PM,48,-122,48,47,95
6088,ElliotBayTrailMyrtlePark,09/11/2014 04:00:00 PM,48,-122,104,75,179
6089,ElliotBayTrailMyrtlePark,09/11/2014 05:00:00 PM,48,-122,182,74,256
6090,ElliotBayTrailMyrtlePark,09/11/2014 06:00:00 PM,48,-122,162,56,218
6091,ElliotBayTrailMyrtlePark,09/11/2014 07:00:00 PM,48,-122,72,48,120
6092,ElliotBayTrailMyrtlePark,09/11/2014 08:00:00 PM,48,-122,26,19,45
6093,ElliotBayTrailMyrtlePark,09/11/2014 09:00:00 PM,48,-122,12,2,14
6094,ElliotBayTrailMyrtlePark,09/11/2014 10:00:00 PM,48,-122,6,5,11
6095,ElliotBayTrailMyrtlePark,09/11/2014 11:00:00 PM,48,-122,0,1,1
6096,ElliotBayTrailMyrtlePark,09/12/2014 12:00:00 AM,48,-122,5,0,5
6097,ElliotBayTrailMyrtlePark,09/12/2014 01:00:00 AM,48,-122,1,0,1
6098,ElliotBayTrailMyrtlePark,09/12/2014 02:00:00 AM,48,-122,2,0,2
6099,ElliotBayTrailMyrtlePark,09/12/2014 03:00:00 AM,48,-122,0,0,0
6100,ElliotBayTrailMyrtlePark,09/12/2014 04:00:00 AM,48,-122,1,0,1
6101,ElliotBayTrailMyrtlePark,09/12/2014 05:00:00 AM,48,-122,6,12,18
6102,ElliotBayTrailMyrtlePark,09/12/2014 06:00:00 AM,48,-122,13,27,40
6103,ElliotBayTrailMyrtlePark,09/12/2014 07:00:00 AM,48,-122,56,97,153
6104,ElliotBayTrailMyrtlePark,09/12/2014 08:00:00 AM,48,-122,41,156,197
6105,ElliotBayTrailMyrtlePark,09/12/2014 09:00:00 AM,48,-122,40,76,116
6106,ElliotBayTrailMyrtlePark,09/12/2014 10:00:00 AM,48,-122,15,31,46
6107,ElliotBayTrailMyrtlePark,09/12/2014 11:00:00 AM,48,-122,29,24,53
6108,ElliotBayTrailMyrtlePark,09/12/2014 12:00:00 PM,48,-122,33,25,58
6109,ElliotBayTrailMyrtlePark,09/12/2014 01:00:00 PM,48,-122,41,35,76
6110,ElliotBayTrailMyrtlePark,09/12/2014 02:00:00 PM,48,-122,55,50,105
6111,ElliotBayTrailMyrtlePark,09/12/2014 03:00:00 PM,48,-122,45,39,84
6112,ElliotBayTrailMyrtlePark,09/12/2014 04:00:00 PM,48,-122,114,79,193
6113,ElliotBayTrailMyrtlePark,09/12/2014 05:00:00 PM,48,-122,154,84,238
6114,ElliotBayTrailMyrtlePark,09/12/2014 06:00:00 PM,48,-122,121,71,192
6115,ElliotBayTrailMyrtlePark,09/12/2014 07:00:00 PM,48,-122,50,51,101
6116,ElliotBayTrailMyrtlePark,09/12/2014 08:00:00 PM,48,-122,11,17,28
6117,ElliotBayTrailMyrtlePark,09/12/2014 09:00:00 PM,48,-122,12,5,17
6118,ElliotBayTrailMyrtlePark,09/12/2014 10:00:00 PM,48,-122,73,5,78
6119,ElliotBayTrailMyrtlePark,09/12/2014 11:00:00 PM,48,-122,11,1,12
6120,ElliotBayTrailMyrtlePark,09/13/2014 12:00:00 AM,48,-122,15,2,17
6121,ElliotBayTrailMyrtlePark,09/13/2014 01:00:00 AM,48,-122,2,4,6
6122,ElliotBayTrailMyrtlePark,09/13/2014 02:00:00 AM,48,-122,2,0,2
6123,ElliotBayTrailMyrtlePark,09/13/2014 03:00:00 AM,48,-122,3,1,4
6124,ElliotBayTrailMyrtlePark,09/13/2014 04:00:00 AM,48,-122,1,0,1
6125,ElliotBayTrailMyrtlePark,09/13/2014 05:00:00 AM,48,-122,0,4,4
6126,ElliotBayTrailMyrtlePark,09/13/2014 06:00:00 AM,48,-122,7,11,18
6127,ElliotBayTrailMyrtlePark,09/13/2014 07:00:00 AM,48,-122,4,24,28
6128,ElliotBayTrailMyrtlePark,09/13/2014 08:00:00 AM,48,-122,7,18,25
6129,ElliotBayTrailMyrtlePark,09/13/2014 09:00:00 AM,48,-122,23,41,64
6130,ElliotBayTrailMyrtlePark,09/13/2014 10:00:00 AM,48,-122,43,48,91
6131,ElliotBayTrailMyrtlePark,09/13/2014 11:00:00 AM,48,-122,57,38,95
6132,ElliotBayTrailMyrtlePark,09/13/2014 12:00:00 PM,48,-122,61,51,112
6133,ElliotBayTrailMyrtlePark,09/13/2014 01:00:00 PM,48,-122,67,54,121
6134,ElliotBayTrailMyrtlePark,09/13/2014 02:00:00 PM,48,-122,52,59,111
6135,ElliotBayTrailMyrtlePark,09/13/2014 03:00:00 PM,48,-122,64,78,142
6136,ElliotBayTrailMyrtlePark,09/13/2014 04:00:00 PM,48,-122,75,68,143
6137,ElliotBayTrailMyrtlePark,09/13/2014 05:00:00 PM,48,-122,64,58,122
6138,ElliotBayTrailMyrtlePark,09/13/2014 06:00:00 PM,48,-122,69,51,120
6139,ElliotBayTrailMyrtlePark,09/13/2014 07:00:00 PM,48,-122,35,20,55
6140,ElliotBayTrailMyrtlePark,09/13/2014 08:00:00 PM,48,-122,17,17,34
6141,ElliotBayTrailMyrtlePark,09/13/2014 09:00:00 PM,48,-122,6,4,10
6142,ElliotBayTrailMyrtlePark,09/13/2014 10:00:00 PM,48,-122,14,0,14
6143,ElliotBayTrailMyrtlePark,09/13/2014 11:00:00 PM,48,-122,5,2,7
6144,ElliotBayTrailMyrtlePark,09/14/2014 12:00:00 AM,48,-122,7,0,7
6145,ElliotBayTrailMyrtlePark,09/14/2014 01:00:00 AM,48,-122,1,0,1
6146,ElliotBayTrailMyrtlePark,09/14/2014 02:00:00 AM,48,-122,3,1,4
6147,ElliotBayTrailMyrtlePark,09/14/2014 03:00:00 AM,48,-122,0,0,0
6148,ElliotBayTrailMyrtlePark,09/14/2014 04:00:00 AM,48,-122,0,0,0
6149,ElliotBayTrailMyrtlePark,09/14/2014 05:00:00 AM,48,-122,0,1,1
6150,ElliotBayTrailMyrtlePark,09/14/2014 06:00:00 AM,48,-122,3,3,6
6151,ElliotBayTrailMyrtlePark,09/14/2014 07:00:00 AM,48,-122,10,11,21
6152,ElliotBayTrailMyrtlePark,09/14/2014 08:00:00 AM,48,-122,13,21,34
6153,ElliotBayTrailMyrtlePark,09/14/2014 09:00:00 AM,48,-122,49,36,85
6154,ElliotBayTrailMyrtlePark,09/14/2014 10:00:00 AM,48,-122,35,64,99
6155,ElliotBayTrailMyrtlePark,09/14/2014 11:00:00 AM,48,-122,55,42,97
6156,ElliotBayTrailMyrtlePark,09/14/2014 12:00:00 PM,48,-122,51,77,128
6157,ElliotBayTrailMyrtlePark,09/14/2014 01:00:00 PM,48,-122,70,74,144
6158,ElliotBayTrailMyrtlePark,09/14/2014 02:00:00 PM,48,-122,78,63,141
6159,ElliotBayTrailMyrtlePark,09/14/2014 03:00:00 PM,48,-122,87,73,160
6160,ElliotBayTrailMyrtlePark,09/14/2014 04:00:00 PM,48,-122,103,67,170
6161,ElliotBayTrailMyrtlePark,09/14/2014 05:00:00 PM,48,-122,80,44,124
6162,ElliotBayTrailMyrtlePark,09/14/2014 06:00:00 PM,48,-122,54,44,98
6163,ElliotBayTrailMyrtlePark,09/14/2014 07:00:00 PM,48,-122,35,29,64
6164,ElliotBayTrailMyrtlePark,09/14/2014 08:00:00 PM,48,-122,20,13,33
6165,ElliotBayTrailMyrtlePark,09/14/2014 09:00:00 PM,48,-122,2,4,6
6166,ElliotBayTrailMyrtlePark,09/14/2014 10:00:00 PM,48,-122,14,6,20
6167,ElliotBayTrailMyrtlePark,09/14/2014 11:00:00 PM,48,-122,4,1,5
6168,ElliotBayTrailMyrtlePark,09/15/2014 12:00:00 AM,48,-122,0,0,0
6169,ElliotBayTrailMyrtlePark,09/15/2014 01:00:00 AM,48,-122,1,0,1
6170,ElliotBayTrailMyrtlePark,09/15/2014 02:00:00 AM,48,-122,2,0,2
6171,ElliotBayTrailMyrtlePark,09/15/2014 03:00:00 AM,48,-122,0,3,3
6172,ElliotBayTrailMyrtlePark,09/15/2014 04:00:00 AM,48,-122,0,0,0
6173,ElliotBayTrailMyrtlePark,09/15/2014 05:00:00 AM,48,-122,9,10,19
6174,ElliotBayTrailMyrtlePark,09/15/2014 06:00:00 AM,48,-122,22,40,62
6175,ElliotBayTrailMyrtlePark,09/15/2014 07:00:00 AM,48,-122,53,103,156
6176,ElliotBayTrailMyrtlePark,09/15/2014 08:00:00 AM,48,-122,53,172,225
6177,ElliotBayTrailMyrtlePark,09/15/2014 09:00:00 AM,48,-122,26,93,119
6178,ElliotBayTrailMyrtlePark,09/15/2014 10:00:00 AM,48,-122,13,30,43
6179,ElliotBayTrailMyrtlePark,09/15/2014 11:00:00 AM,48,-122,17,28,45
6180,ElliotBayTrailMyrtlePark,09/15/2014 12:00:00 PM,48,-122,22,28,50
6181,ElliotBayTrailMyrtlePark,09/15/2014 01:00:00 PM,48,-122,25,17,42
6182,ElliotBayTrailMyrtlePark,09/15/2014 02:00:00 PM,48,-122,29,34,63
6183,ElliotBayTrailMyrtlePark,09/15/2014 03:00:00 PM,48,-122,41,38,79
6184,ElliotBayTrailMyrtlePark,09/15/2014 04:00:00 PM,48,-122,96,61,157
6185,ElliotBayTrailMyrtlePark,09/15/2014 05:00:00 PM,48,-122,257,97,354
6186,ElliotBayTrailMyrtlePark,09/15/2014 06:00:00 PM,48,-122,170,77,247
6187,ElliotBayTrailMyrtlePark,09/15/2014 07:00:00 PM,48,-122,71,50,121
6188,ElliotBayTrailMyrtlePark,09/15/2014 08:00:00 PM,48,-122,17,17,34
6189,ElliotBayTrailMyrtlePark,09/15/2014 09:00:00 PM,48,-122,10,1,11
6190,ElliotBayTrailMyrtlePark,09/15/2014 10:00:00 PM,48,-122,3,6,9
6191,ElliotBayTrailMyrtlePark,09/15/2014 11:00:00 PM,48,-122,6,0,6
6192,ElliotBayTrailMyrtlePark,09/16/2014 12:00:00 AM,48,-122,3,1,4
6193,ElliotBayTrailMyrtlePark,09/16/2014 01:00:00 AM,48,-122,1,0,1
6194,ElliotBayTrailMyrtlePark,09/16/2014 02:00:00 AM,48,-122,2,0,2
6195,ElliotBayTrailMyrtlePark,09/16/2014 03:00:00 AM,48,-122,1,0,1
6196,ElliotBayTrailMyrtlePark,09/16/2014 04:00:00 AM,48,-122,0,2,2
6197,ElliotBayTrailMyrtlePark,09/16/2014 05:00:00 AM,48,-122,8,13,21
6198,ElliotBayTrailMyrtlePark,09/16/2014 06:00:00 AM,48,-122,19,35,54
6199,ElliotBayTrailMyrtlePark,09/16/2014 07:00:00 AM,48,-122,45,114,159
6200,ElliotBayTrailMyrtlePark,09/16/2014 08:00:00 AM,48,-122,51,191,242
6201,ElliotBayTrailMyrtlePark,09/16/2014 09:00:00 AM,48,-122,28,90,118
6202,ElliotBayTrailMyrtlePark,09/16/2014 10:00:00 AM,48,-122,13,30,43
6203,ElliotBayTrailMyrtlePark,09/16/2014 11:00:00 AM,48,-122,12,24,36
6204,ElliotBayTrailMyrtlePark,09/16/2014 12:00:00 PM,48,-122,24,24,48
6205,ElliotBayTrailMyrtlePark,09/16/2014 01:00:00 PM,48,-122,29,17,46
6206,ElliotBayTrailMyrtlePark,09/16/2014 02:00:00 PM,48,-122,29,37,66
6207,ElliotBayTrailMyrtlePark,09/16/2014 03:00:00 PM,48,-122,39,32,71
6208,ElliotBayTrailMyrtlePark,09/16/2014 04:00:00 PM,48,-122,108,65,173
6209,ElliotBayTrailMyrtlePark,09/16/2014 05:00:00 PM,48,-122,222,65,287
6210,ElliotBayTrailMyrtlePark,09/16/2014 06:00:00 PM,48,-122,143,59,202
6211,ElliotBayTrailMyrtlePark,09/16/2014 07:00:00 PM,48,-122,54,25,79
6212,ElliotBayTrailMyrtlePark,09/16/2014 08:00:00 PM,48,-122,16,7,23
6213,ElliotBayTrailMyrtlePark,09/16/2014 09:00:00 PM,48,-122,5,1,6
6214,ElliotBayTrailMyrtlePark,09/16/2014 10:00:00 PM,48,-122,6,4,10
6215,ElliotBayTrailMyrtlePark,09/16/2014 11:00:00 PM,48,-122,1,1,2
6216,ElliotBayTrailMyrtlePark,09/17/2014 12:00:00 AM,48,-122,2,1,3
6217,ElliotBayTrailMyrtlePark,09/17/2014 01:00:00 AM,48,-122,3,0,3
6218,ElliotBayTrailMyrtlePark,09/17/2014 02:00:00 AM,48,-122,1,0,1
6219,ElliotBayTrailMyrtlePark,09/17/2014 03:00:00 AM,48,-122,0,2,2
6220,ElliotBayTrailMyrtlePark,09/17/2014 04:00:00 AM,48,-122,0,0,0
6221,ElliotBayTrailMyrtlePark,09/17/2014 05:00:00 AM,48,-122,6,9,15
6222,ElliotBayTrailMyrtlePark,09/17/2014 06:00:00 AM,48,-122,22,38,60
6223,ElliotBayTrailMyrtlePark,09/17/2014 07:00:00 AM,48,-122,35,108,143
6224,ElliotBayTrailMyrtlePark,09/17/2014 08:00:00 AM,48,-122,49,155,204
6225,ElliotBayTrailMyrtlePark,09/17/2014 09:00:00 AM,48,-122,23,73,96
6226,ElliotBayTrailMyrtlePark,09/17/2014 10:00:00 AM,48,-122,11,26,37
6227,ElliotBayTrailMyrtlePark,09/17/2014 11:00:00 AM,48,-122,9,16,25
6228,ElliotBayTrailMyrtlePark,09/17/2014 12:00:00 PM,48,-122,23,17,40
6229,ElliotBayTrailMyrtlePark,09/17/2014 01:00:00 PM,48,-122,10,11,21
6230,ElliotBayTrailMyrtlePark,09/17/2014 02:00:00 PM,48,-122,23,20,43
6231,ElliotBayTrailMyrtlePark,09/17/2014 03:00:00 PM,48,-122,29,30,59
6232,ElliotBayTrailMyrtlePark,09/17/2014 04:00:00 PM,48,-122,83,47,130
6233,ElliotBayTrailMyrtlePark,09/17/2014 05:00:00 PM,48,-122,183,55,238
6234,ElliotBayTrailMyrtlePark,09/17/2014 06:00:00 PM,48,-122,147,51,198
6235,ElliotBayTrailMyrtlePark,09/17/2014 07:00:00 PM,48,-122,35,22,57
6236,ElliotBayTrailMyrtlePark,09/17/2014 08:00:00 PM,48,-122,20,8,28
6237,ElliotBayTrailMyrtlePark,09/17/2014 09:00:00 PM,48,-122,8,3,11
6238,ElliotBayTrailMyrtlePark,09/17/2014 10:00:00 PM,48,-122,7,3,10
6239,ElliotBayTrailMyrtlePark,09/17/2014 11:00:00 PM,48,-122,5,1,6
6240,ElliotBayTrailMyrtlePark,09/18/2014 12:00:00 AM,48,-122,4,1,5
6241,ElliotBayTrailMyrtlePark,09/18/2014 01:00:00 AM,48,-122,0,0,0
6242,ElliotBayTrailMyrtlePark,09/18/2014 02:00:00 AM,48,-122,2,0,2
6243,ElliotBayTrailMyrtlePark,09/18/2014 03:00:00 AM,48,-122,3,0,3
6244,ElliotBayTrailMyrtlePark,09/18/2014 04:00:00 AM,48,-122,2,2,4
6245,ElliotBayTrailMyrtlePark,09/18/2014 05:00:00 AM,48,-122,8,8,16
6246,ElliotBayTrailMyrtlePark,09/18/2014 06:00:00 AM,48,-122,18,28,46
6247,ElliotBayTrailMyrtlePark,09/18/2014 07:00:00 AM,48,-122,39,86,125
6248,ElliotBayTrailMyrtlePark,09/18/2014 08:00:00 AM,48,-122,38,101,139
6249,ElliotBayTrailMyrtlePark,09/18/2014 09:00:00 AM,48,-122,24,73,97
6250,ElliotBayTrailMyrtlePark,09/18/2014 10:00:00 AM,48,-122,7,19,26
6251,ElliotBayTrailMyrtlePark,09/18/2014 11:00:00 AM,48,-122,11,15,26
6252,ElliotBayTrailMyrtlePark,09/18/2014 12:00:00 PM,48,-122,10,13,23
6253,ElliotBayTrailMyrtlePark,09/18/2014 01:00:00 PM,48,-122,8,6,14
6254,ElliotBayTrailMyrtlePark,09/18/2014 02:00:00 PM,48,-122,18,15,33
6255,ElliotBayTrailMyrtlePark,09/18/2014 03:00:00 PM,48,-122,25,25,50
6256,ElliotBayTrailMyrtlePark,09/18/2014 04:00:00 PM,48,-122,52,44,96
6257,ElliotBayTrailMyrtlePark,09/18/2014 05:00:00 PM,48,-122,146,49,195
6258,ElliotBayTrailMyrtlePark,09/18/2014 06:00:00 PM,48,-122,107,44,151
6259,ElliotBayTrailMyrtlePark,09/18/2014 07:00:00 PM,48,-122,43,17,60
6260,ElliotBayTrailMyrtlePark,09/18/2014 08:00:00 PM,48,-122,9,6,15
6261,ElliotBayTrailMyrtlePark,09/18/2014 09:00:00 PM,48,-122,4,3,7
6262,ElliotBayTrailMyrtlePark,09/18/2014 10:00:00 PM,48,-122,5,1,6
6263,ElliotBayTrailMyrtlePark,09/18/2014 11:00:00 PM,48,-122,4,4,8
6264,ElliotBayTrailMyrtlePark,09/19/2014 12:00:00 AM,48,-122,2,0,2
6265,ElliotBayTrailMyrtlePark,09/19/2014 01:00:00 AM,48,-122,0,3,3
6266,ElliotBayTrailMyrtlePark,09/19/2014 02:00:00 AM,48,-122,1,0,1
6267,ElliotBayTrailMyrtlePark,09/19/2014 03:00:00 AM,48,-122,2,0,2
6268,ElliotBayTrailMyrtlePark,09/19/2014 04:00:00 AM,48,-122,0,1,1
6269,ElliotBayTrailMyrtlePark,09/19/2014 05:00:00 AM,48,-122,5,16,21
6270,ElliotBayTrailMyrtlePark,09/19/2014 06:00:00 AM,48,-122,19,29,48
6271,ElliotBayTrailMyrtlePark,09/19/2014 07:00:00 AM,48,-122,38,84,122
6272,ElliotBayTrailMyrtlePark,09/19/2014 08:00:00 AM,48,-122,41,133,174
6273,ElliotBayTrailMyrtlePark,09/19/2014 09:00:00 AM,48,-122,31,73,104
6274,ElliotBayTrailMyrtlePark,09/19/2014 10:00:00 AM,48,-122,15,29,44
6275,ElliotBayTrailMyrtlePark,09/19/2014 11:00:00 AM,48,-122,28,24,52
6276,ElliotBayTrailMyrtlePark,09/19/2014 12:00:00 PM,48,-122,21,25,46
6277,ElliotBayTrailMyrtlePark,09/19/2014 01:00:00 PM,48,-122,24,24,48
6278,ElliotBayTrailMyrtlePark,09/19/2014 02:00:00 PM,48,-122,39,35,74
6279,ElliotBayTrailMyrtlePark,09/19/2014 03:00:00 PM,48,-122,53,36,89
6280,ElliotBayTrailMyrtlePark,09/19/2014 04:00:00 PM,48,-122,76,55,131
6281,ElliotBayTrailMyrtlePark,09/19/2014 05:00:00 PM,48,-122,176,83,259
6282,ElliotBayTrailMyrtlePark,09/19/2014 06:00:00 PM,48,-122,124,43,167
6283,ElliotBayTrailMyrtlePark,09/19/2014 07:00:00 PM,48,-122,34,29,63
6284,ElliotBayTrailMyrtlePark,09/19/2014 08:00:00 PM,48,-122,25,10,35
6285,ElliotBayTrailMyrtlePark,09/19/2014 09:00:00 PM,48,-122,9,5,14
6286,ElliotBayTrailMyrtlePark,09/19/2014 10:00:00 PM,48,-122,8,3,11
6287,ElliotBayTrailMyrtlePark,09/19/2014 11:00:00 PM,48,-122,9,3,12
6288,ElliotBayTrailMyrtlePark,09/20/2014 12:00:00 AM,48,-122,7,0,7
6289,ElliotBayTrailMyrtlePark,09/20/2014 01:00:00 AM,48,-122,5,2,7
6290,ElliotBayTrailMyrtlePark,09/20/2014 02:00:00 AM,48,-122,1,1,2
6291,ElliotBayTrailMyrtlePark,09/20/2014 03:00:00 AM,48,-122,0,0,0
6292,ElliotBayTrailMyrtlePark,09/20/2014 04:00:00 AM,48,-122,4,1,5
6293,ElliotBayTrailMyrtlePark,09/20/2014 05:00:00 AM,48,-122,2,6,8
6294,ElliotBayTrailMyrtlePark,09/20/2014 06:00:00 AM,48,-122,8,8,16
6295,ElliotBayTrailMyrtlePark,09/20/2014 07:00:00 AM,48,-122,6,14,20
6296,ElliotBayTrailMyrtlePark,09/20/2014 08:00:00 AM,48,-122,13,16,29
6297,ElliotBayTrailMyrtlePark,09/20/2014 09:00:00 AM,48,-122,18,26,44
6298,ElliotBayTrailMyrtlePark,09/20/2014 10:00:00 AM,48,-122,17,38,55
6299,ElliotBayTrailMyrtlePark,09/20/2014 11:00:00 AM,48,-122,43,34,77
6300,ElliotBayTrailMyrtlePark,09/20/2014 12:00:00 PM,48,-122,52,49,101
6301,ElliotBayTrailMyrtlePark,09/20/2014 01:00:00 PM,48,-122,52,49,101
6302,ElliotBayTrailMyrtlePark,09/20/2014 02:00:00 PM,48,-122,56,44,100
6303,ElliotBayTrailMyrtlePark,09/20/2014 03:00:00 PM,48,-122,59,56,115
6304,ElliotBayTrailMyrtlePark,09/20/2014 04:00:00 PM,48,-122,58,60,118
6305,ElliotBayTrailMyrtlePark,09/20/2014 05:00:00 PM,48,-122,53,36,89
6306,ElliotBayTrailMyrtlePark,09/20/2014 06:00:00 PM,48,-122,25,25,50
6307,ElliotBayTrailMyrtlePark,09/20/2014 07:00:00 PM,48,-122,25,27,52
6308,ElliotBayTrailMyrtlePark,09/20/2014 08:00:00 PM,48,-122,12,8,20
6309,ElliotBayTrailMyrtlePark,09/20/2014 09:00:00 PM,48,-122,3,2,5
6310,ElliotBayTrailMyrtlePark,09/20/2014 10:00:00 PM,48,-122,6,3,9
6311,ElliotBayTrailMyrtlePark,09/20/2014 11:00:00 PM,48,-122,6,2,8
6312,ElliotBayTrailMyrtlePark,09/21/2014 12:00:00 AM,48,-122,5,3,8
6313,ElliotBayTrailMyrtlePark,09/21/2014 01:00:00 AM,48,-122,2,0,2
6314,ElliotBayTrailMyrtlePark,09/21/2014 02:00:00 AM,48,-122,1,0,1
6315,ElliotBayTrailMyrtlePark,09/21/2014 03:00:00 AM,48,-122,1,0,1
6316,ElliotBayTrailMyrtlePark,09/21/2014 04:00:00 AM,48,-122,2,1,3
6317,ElliotBayTrailMyrtlePark,09/21/2014 05:00:00 AM,48,-122,0,1,1
6318,ElliotBayTrailMyrtlePark,09/21/2014 06:00:00 AM,48,-122,3,2,5
6319,ElliotBayTrailMyrtlePark,09/21/2014 07:00:00 AM,48,-122,7,8,15
6320,ElliotBayTrailMyrtlePark,09/21/2014 08:00:00 AM,48,-122,11,11,22
6321,ElliotBayTrailMyrtlePark,09/21/2014 09:00:00 AM,48,-122,38,35,73
6322,ElliotBayTrailMyrtlePark,09/21/2014 10:00:00 AM,48,-122,42,51,93
6323,ElliotBayTrailMyrtlePark,09/21/2014 11:00:00 AM,48,-122,85,53,138
6324,ElliotBayTrailMyrtlePark,09/21/2014 12:00:00 PM,48,-122,52,98,150
6325,ElliotBayTrailMyrtlePark,09/21/2014 01:00:00 PM,48,-122,59,72,131
6326,ElliotBayTrailMyrtlePark,09/21/2014 02:00:00 PM,48,-122,71,71,142
6327,ElliotBayTrailMyrtlePark,09/21/2014 03:00:00 PM,48,-122,94,51,145
6328,ElliotBayTrailMyrtlePark,09/21/2014 04:00:00 PM,48,-122,43,62,105
6329,ElliotBayTrailMyrtlePark,09/21/2014 05:00:00 PM,48,-122,102,50,152
6330,ElliotBayTrailMyrtlePark,09/21/2014 06:00:00 PM,48,-122,58,48,106
6331,ElliotBayTrailMyrtlePark,09/21/2014 07:00:00 PM,48,-122,27,36,63
6332,ElliotBayTrailMyrtlePark,09/21/2014 08:00:00 PM,48,-122,12,16,28
6333,ElliotBayTrailMyrtlePark,09/21/2014 09:00:00 PM,48,-122,3,1,4
6334,ElliotBayTrailMyrtlePark,09/21/2014 10:00:00 PM,48,-122,8,8,16
6335,ElliotBayTrailMyrtlePark,09/21/2014 11:00:00 PM,48,-122,4,2,6
6336,ElliotBayTrailMyrtlePark,09/22/2014 12:00:00 AM,48,-122,3,1,4
6337,ElliotBayTrailMyrtlePark,09/22/2014 01:00:00 AM,48,-122,0,1,1
6338,ElliotBayTrailMyrtlePark,09/22/2014 02:00:00 AM,48,-122,1,1,2
6339,ElliotBayTrailMyrtlePark,09/22/2014 03:00:00 AM,48,-122,2,0,2
6340,ElliotBayTrailMyrtlePark,09/22/2014 04:00:00 AM,48,-122,0,1,1
6341,ElliotBayTrailMyrtlePark,09/22/2014 05:00:00 AM,48,-122,4,12,16
6342,ElliotBayTrailMyrtlePark,09/22/2014 06:00:00 AM,48,-122,23,37,60
6343,ElliotBayTrailMyrtlePark,09/22/2014 07:00:00 AM,48,-122,44,91,135
6344,ElliotBayTrailMyrtlePark,09/22/2014 08:00:00 AM,48,-122,30,140,170
6345,ElliotBayTrailMyrtlePark,09/22/2014 09:00:00 AM,48,-122,30,88,118
6346,ElliotBayTrailMyrtlePark,09/22/2014 10:00:00 AM,48,-122,16,20,36
6347,ElliotBayTrailMyrtlePark,09/22/2014 11:00:00 AM,48,-122,19,25,44
6348,ElliotBayTrailMyrtlePark,09/22/2014 12:00:00 PM,48,-122,8,12,20
6349,ElliotBayTrailMyrtlePark,09/22/2014 01:00:00 PM,48,-122,17,24,41
6350,ElliotBayTrailMyrtlePark,09/22/2014 02:00:00 PM,48,-122,25,22,47
6351,ElliotBayTrailMyrtlePark,09/22/2014 03:00:00 PM,48,-122,46,29,75
6352,ElliotBayTrailMyrtlePark,09/22/2014 04:00:00 PM,48,-122,92,54,146
6353,ElliotBayTrailMyrtlePark,09/22/2014 05:00:00 PM,48,-122,220,72,292
6354,ElliotBayTrailMyrtlePark,09/22/2014 06:00:00 PM,48,-122,128,65,193
6355,ElliotBayTrailMyrtlePark,09/22/2014 07:00:00 PM,48,-122,43,24,67
6356,ElliotBayTrailMyrtlePark,09/22/2014 08:00:00 PM,48,-122,12,10,22
6357,ElliotBayTrailMyrtlePark,09/22/2014 09:00:00 PM,48,-122,9,0,9
6358,ElliotBayTrailMyrtlePark,09/22/2014 10:00:00 PM,48,-122,3,5,8
6359,ElliotBayTrailMyrtlePark,09/22/2014 11:00:00 PM,48,-122,2,1,3
6360,ElliotBayTrailMyrtlePark,09/23/2014 12:00:00 AM,48,-122,4,0,4
6361,ElliotBayTrailMyrtlePark,09/23/2014 01:00:00 AM,48,-122,0,0,0
6362,ElliotBayTrailMyrtlePark,09/23/2014 02:00:00 AM,48,-122,2,0,2
6363,ElliotBayTrailMyrtlePark,09/23/2014 03:00:00 AM,48,-122,0,0,0
6364,ElliotBayTrailMyrtlePark,09/23/2014 04:00:00 AM,48,-122,2,0,2
6365,ElliotBayTrailMyrtlePark,09/23/2014 05:00:00 AM,48,-122,4,15,19
6366,ElliotBayTrailMyrtlePark,09/23/2014 06:00:00 AM,48,-122,21,39,60
6367,ElliotBayTrailMyrtlePark,09/23/2014 07:00:00 AM,48,-122,47,89,136
6368,ElliotBayTrailMyrtlePark,09/23/2014 08:00:00 AM,48,-122,37,145,182
6369,ElliotBayTrailMyrtlePark,09/23/2014 09:00:00 AM,48,-122,23,71,94
6370,ElliotBayTrailMyrtlePark,09/23/2014 10:00:00 AM,48,-122,11,21,32
6371,ElliotBayTrailMyrtlePark,09/23/2014 11:00:00 AM,48,-122,11,14,25
6372,ElliotBayTrailMyrtlePark,09/23/2014 12:00:00 PM,48,-122,6,16,22
6373,ElliotBayTrailMyrtlePark,09/23/2014 01:00:00 PM,48,-122,15,3,18
6374,ElliotBayTrailMyrtlePark,09/23/2014 02:00:00 PM,48,-122,9,6,15
6375,ElliotBayTrailMyrtlePark,09/23/2014 03:00:00 PM,48,-122,26,20,46
6376,ElliotBayTrailMyrtlePark,09/23/2014 04:00:00 PM,48,-122,59,33,92
6377,ElliotBayTrailMyrtlePark,09/23/2014 05:00:00 PM,48,-122,167,57,224
6378,ElliotBayTrailMyrtlePark,09/23/2014 06:00:00 PM,48,-122,98,19,117
6379,ElliotBayTrailMyrtlePark,09/23/2014 07:00:00 PM,48,-122,22,11,33
6380,ElliotBayTrailMyrtlePark,09/23/2014 08:00:00 PM,48,-122,5,3,8
6381,ElliotBayTrailMyrtlePark,09/23/2014 09:00:00 PM,48,-122,5,0,5
6382,ElliotBayTrailMyrtlePark,09/23/2014 10:00:00 PM,48,-122,4,1,5
6383,ElliotBayTrailMyrtlePark,09/23/2014 11:00:00 PM,48,-122,0,2,2
6384,ElliotBayTrailMyrtlePark,09/24/2014 12:00:00 AM,48,-122,1,2,3
6385,ElliotBayTrailMyrtlePark,09/24/2014 01:00:00 AM,48,-122,1,0,1
6386,ElliotBayTrailMyrtlePark,09/24/2014 02:00:00 AM,48,-122,1,0,1
6387,ElliotBayTrailMyrtlePark,09/24/2014 03:00:00 AM,48,-122,0,0,0
6388,ElliotBayTrailMyrtlePark,09/24/2014 04:00:00 AM,48,-122,0,0,0
6389,ElliotBayTrailMyrtlePark,09/24/2014 05:00:00 AM,48,-122,4,13,17
6390,ElliotBayTrailMyrtlePark,09/24/2014 06:00:00 AM,48,-122,17,15,32
6391,ElliotBayTrailMyrtlePark,09/24/2014 07:00:00 AM,48,-122,26,38,64
6392,ElliotBayTrailMyrtlePark,09/24/2014 08:00:00 AM,48,-122,33,70,103
6393,ElliotBayTrailMyrtlePark,09/24/2014 09:00:00 AM,48,-122,18,42,60
6394,ElliotBayTrailMyrtlePark,09/24/2014 10:00:00 AM,48,-122,8,15,23
6395,ElliotBayTrailMyrtlePark,09/24/2014 11:00:00 AM,48,-122,4,12,16
6396,ElliotBayTrailMyrtlePark,09/24/2014 12:00:00 PM,48,-122,2,5,7
6397,ElliotBayTrailMyrtlePark,09/24/2014 01:00:00 PM,48,-122,7,0,7
6398,ElliotBayTrailMyrtlePark,09/24/2014 02:00:00 PM,48,-122,9,11,20
6399,ElliotBayTrailMyrtlePark,09/24/2014 03:00:00 PM,48,-122,26,21,47
6400,ElliotBayTrailMyrtlePark,09/24/2014 04:00:00 PM,48,-122,38,36,74
6401,ElliotBayTrailMyrtlePark,09/24/2014 05:00:00 PM,48,-122,103,44,147
6402,ElliotBayTrailMyrtlePark,09/24/2014 06:00:00 PM,48,-122,70,52,122
6403,ElliotBayTrailMyrtlePark,09/24/2014 07:00:00 PM,48,-122,37,12,49
6404,ElliotBayTrailMyrtlePark,09/24/2014 08:00:00 PM,48,-122,11,2,13
6405,ElliotBayTrailMyrtlePark,09/24/2014 09:00:00 PM,48,-122,3,1,4
6406,ElliotBayTrailMyrtlePark,09/24/2014 10:00:00 PM,48,-122,5,0,5
6407,ElliotBayTrailMyrtlePark,09/24/2014 11:00:00 PM,48,-122,2,0,2
6408,ElliotBayTrailMyrtlePark,09/25/2014 12:00:00 AM,48,-122,1,1,2
6409,ElliotBayTrailMyrtlePark,09/25/2014 01:00:00 AM,48,-122,2,0,2
6410,ElliotBayTrailMyrtlePark,09/25/2014 02:00:00 AM,48,-122,1,1,2
6411,ElliotBayTrailMyrtlePark,09/25/2014 03:00:00 AM,48,-122,2,0,2
6412,ElliotBayTrailMyrtlePark,09/25/2014 04:00:00 AM,48,-122,0,0,0
6413,ElliotBayTrailMyrtlePark,09/25/2014 05:00:00 AM,48,-122,3,15,18
6414,ElliotBayTrailMyrtlePark,09/25/2014 06:00:00 AM,48,-122,16,23,39
6415,ElliotBayTrailMyrtlePark,09/25/2014 07:00:00 AM,48,-122,27,66,93
6416,ElliotBayTrailMyrtlePark,09/25/2014 08:00:00 AM,48,-122,38,104,142
6417,ElliotBayTrailMyrtlePark,09/25/2014 09:00:00 AM,48,-122,22,65,87
6418,ElliotBayTrailMyrtlePark,09/25/2014 10:00:00 AM,48,-122,6,16,22
6419,ElliotBayTrailMyrtlePark,09/25/2014 11:00:00 AM,48,-122,5,8,13
6420,ElliotBayTrailMyrtlePark,09/25/2014 12:00:00 PM,48,-122,7,10,17
6421,ElliotBayTrailMyrtlePark,09/25/2014 01:00:00 PM,48,-122,9,14,23
6422,ElliotBayTrailMyrtlePark,09/25/2014 02:00:00 PM,48,-122,31,29,60
6423,ElliotBayTrailMyrtlePark,09/25/2014 03:00:00 PM,48,-122,47,42,89
6424,ElliotBayTrailMyrtlePark,09/25/2014 04:00:00 PM,48,-122,77,49,126
6425,ElliotBayTrailMyrtlePark,09/25/2014 05:00:00 PM,48,-122,141,66,207
6426,ElliotBayTrailMyrtlePark,09/25/2014 06:00:00 PM,48,-122,103,32,135
6427,ElliotBayTrailMyrtlePark,09/25/2014 07:00:00 PM,48,-122,28,18,46
6428,ElliotBayTrailMyrtlePark,09/25/2014 08:00:00 PM,48,-122,21,2,23
6429,ElliotBayTrailMyrtlePark,09/25/2014 09:00:00 PM,48,-122,3,0,3
6430,ElliotBayTrailMyrtlePark,09/25/2014 10:00:00 PM,48,-122,4,1,5
6431,ElliotBayTrailMyrtlePark,09/25/2014 11:00:00 PM,48,-122,5,0,5
6432,ElliotBayTrailMyrtlePark,09/26/2014 12:00:00 AM,48,-122,4,1,5
6433,ElliotBayTrailMyrtlePark,09/26/2014 01:00:00 AM,48,-122,1,0,1
6434,ElliotBayTrailMyrtlePark,09/26/2014 02:00:00 AM,48,-122,1,0,1
6435,ElliotBayTrailMyrtlePark,09/26/2014 03:00:00 AM,48,-122,1,0,1
6436,ElliotBayTrailMyrtlePark,09/26/2014 04:00:00 AM,48,-122,0,1,1
6437,ElliotBayTrailMyrtlePark,09/26/2014 05:00:00 AM,48,-122,7,17,24
6438,ElliotBayTrailMyrtlePark,09/26/2014 06:00:00 AM,48,-122,10,20,30
6439,ElliotBayTrailMyrtlePark,09/26/2014 07:00:00 AM,48,-122,24,35,59
6440,ElliotBayTrailMyrtlePark,09/26/2014 08:00:00 AM,48,-122,19,75,94
6441,ElliotBayTrailMyrtlePark,09/26/2014 09:00:00 AM,48,-122,17,38,55
6442,ElliotBayTrailMyrtlePark,09/26/2014 10:00:00 AM,48,-122,5,12,17
6443,ElliotBayTrailMyrtlePark,09/26/2014 11:00:00 AM,48,-122,7,7,14
6444,ElliotBayTrailMyrtlePark,09/26/2014 12:00:00 PM,48,-122,10,11,21
6445,ElliotBayTrailMyrtlePark,09/26/2014 01:00:00 PM,48,-122,17,15,32
6446,ElliotBayTrailMyrtlePark,09/26/2014 02:00:00 PM,48,-122,26,22,48
6447,ElliotBayTrailMyrtlePark,09/26/2014 03:00:00 PM,48,-122,39,18,57
6448,ElliotBayTrailMyrtlePark,09/26/2014 04:00:00 PM,48,-122,64,43,107
6449,ElliotBayTrailMyrtlePark,09/26/2014 05:00:00 PM,48,-122,102,53,155
6450,ElliotBayTrailMyrtlePark,09/26/2014 06:00:00 PM,48,-122,65,30,95
6451,ElliotBayTrailMyrtlePark,09/26/2014 07:00:00 PM,48,-122,21,15,36
6452,ElliotBayTrailMyrtlePark,09/26/2014 08:00:00 PM,48,-122,11,1,12
6453,ElliotBayTrailMyrtlePark,09/26/2014 09:00:00 PM,48,-122,0,4,4
6454,ElliotBayTrailMyrtlePark,09/26/2014 10:00:00 PM,48,-122,7,1,8
6455,ElliotBayTrailMyrtlePark,09/26/2014 11:00:00 PM,48,-122,8,0,8
6456,ElliotBayTrailMyrtlePark,09/27/2014 12:00:00 AM,48,-122,3,1,4
6457,ElliotBayTrailMyrtlePark,09/27/2014 01:00:00 AM,48,-122,0,0,0
6458,ElliotBayTrailMyrtlePark,09/27/2014 02:00:00 AM,48,-122,0,0,0
6459,ElliotBayTrailMyrtlePark,09/27/2014 03:00:00 AM,48,-122,2,0,2
6460,ElliotBayTrailMyrtlePark,09/27/2014 04:00:00 AM,48,-122,0,0,0
6461,ElliotBayTrailMyrtlePark,09/27/2014 05:00:00 AM,48,-122,2,4,6
6462,ElliotBayTrailMyrtlePark,09/27/2014 06:00:00 AM,48,-122,3,10,13
6463,ElliotBayTrailMyrtlePark,09/27/2014 07:00:00 AM,48,-122,3,9,12
6464,ElliotBayTrailMyrtlePark,09/27/2014 08:00:00 AM,48,-122,17,28,45
6465,ElliotBayTrailMyrtlePark,09/27/2014 09:00:00 AM,48,-122,18,38,56
6466,ElliotBayTrailMyrtlePark,09/27/2014 10:00:00 AM,48,-122,33,58,91
6467,ElliotBayTrailMyrtlePark,09/27/2014 11:00:00 AM,48,-122,41,57,98
6468,ElliotBayTrailMyrtlePark,09/27/2014 12:00:00 PM,48,-122,64,101,165
6469,ElliotBayTrailMyrtlePark,09/27/2014 01:00:00 PM,48,-122,53,55,108
6470,ElliotBayTrailMyrtlePark,09/27/2014 02:00:00 PM,48,-122,55,57,112
6471,ElliotBayTrailMyrtlePark,09/27/2014 03:00:00 PM,48,-122,130,76,206
6472,ElliotBayTrailMyrtlePark,09/27/2014 04:00:00 PM,48,-122,65,62,127
6473,ElliotBayTrailMyrtlePark,09/27/2014 05:00:00 PM,48,-122,74,51,125
6474,ElliotBayTrailMyrtlePark,09/27/2014 06:00:00 PM,48,-122,50,31,81
6475,ElliotBayTrailMyrtlePark,09/27/2014 07:00:00 PM,48,-122,26,15,41
6476,ElliotBayTrailMyrtlePark,09/27/2014 08:00:00 PM,48,-122,8,4,12
6477,ElliotBayTrailMyrtlePark,09/27/2014 09:00:00 PM,48,-122,1,3,4
6478,ElliotBayTrailMyrtlePark,09/27/2014 10:00:00 PM,48,-122,7,1,8
6479,ElliotBayTrailMyrtlePark,09/27/2014 11:00:00 PM,48,-122,6,3,9
6480,ElliotBayTrailMyrtlePark,09/28/2014 12:00:00 AM,48,-122,5,0,5
6481,ElliotBayTrailMyrtlePark,09/28/2014 01:00:00 AM,48,-122,2,1,3
6482,ElliotBayTrailMyrtlePark,09/28/2014 02:00:00 AM,48,-122,1,0,1
6483,ElliotBayTrailMyrtlePark,09/28/2014 03:00:00 AM,48,-122,1,1,2
6484,ElliotBayTrailMyrtlePark,09/28/2014 04:00:00 AM,48,-122,2,1,3
6485,ElliotBayTrailMyrtlePark,09/28/2014 05:00:00 AM,48,-122,0,3,3
6486,ElliotBayTrailMyrtlePark,09/28/2014 06:00:00 AM,48,-122,0,1,1
6487,ElliotBayTrailMyrtlePark,09/28/2014 07:00:00 AM,48,-122,3,3,6
6488,ElliotBayTrailMyrtlePark,09/28/2014 08:00:00 AM,48,-122,14,13,27
6489,ElliotBayTrailMyrtlePark,09/28/2014 09:00:00 AM,48,-122,26,28,54
6490,ElliotBayTrailMyrtlePark,09/28/2014 10:00:00 AM,48,-122,35,36,71
6491,ElliotBayTrailMyrtlePark,09/28/2014 11:00:00 AM,48,-122,41,43,84
6492,ElliotBayTrailMyrtlePark,09/28/2014 12:00:00 PM,48,-122,31,56,87
6493,ElliotBayTrailMyrtlePark,09/28/2014 01:00:00 PM,48,-122,44,29,73
6494,ElliotBayTrailMyrtlePark,09/28/2014 02:00:00 PM,48,-122,49,25,74
6495,ElliotBayTrailMyrtlePark,09/28/2014 03:00:00 PM,48,-122,49,38,87
6496,ElliotBayTrailMyrtlePark,09/28/2014 04:00:00 PM,48,-122,90,70,160
6497,ElliotBayTrailMyrtlePark,09/28/2014 05:00:00 PM,48,-122,61,33,94
6498,ElliotBayTrailMyrtlePark,09/28/2014 06:00:00 PM,48,-122,40,46,86
6499,ElliotBayTrailMyrtlePark,09/28/2014 07:00:00 PM,48,-122,18,21,39
6500,ElliotBayTrailMyrtlePark,09/28/2014 08:00:00 PM,48,-122,9,2,11
6501,ElliotBayTrailMyrtlePark,09/28/2014 09:00:00 PM,48,-122,1,2,3
6502,ElliotBayTrailMyrtlePark,09/28/2014 10:00:00 PM,48,-122,2,3,5
6503,ElliotBayTrailMyrtlePark,09/28/2014 11:00:00 PM,48,-122,4,1,5
6504,ElliotBayTrailMyrtlePark,09/29/2014 12:00:00 AM,48,-122,1,1,2
6505,ElliotBayTrailMyrtlePark,09/29/2014 01:00:00 AM,48,-122,0,0,0
6506,ElliotBayTrailMyrtlePark,09/29/2014 02:00:00 AM,48,-122,2,0,2
6507,ElliotBayTrailMyrtlePark,09/29/2014 03:00:00 AM,48,-122,0,3,3
6508,ElliotBayTrailMyrtlePark,09/29/2014 04:00:00 AM,48,-122,0,0,0
6509,ElliotBayTrailMyrtlePark,09/29/2014 05:00:00 AM,48,-122,4,10,14
6510,ElliotBayTrailMyrtlePark,09/29/2014 06:00:00 AM,48,-122,16,27,43
6511,ElliotBayTrailMyrtlePark,09/29/2014 07:00:00 AM,48,-122,32,88,120
6512,ElliotBayTrailMyrtlePark,09/29/2014 08:00:00 AM,48,-122,27,113,140
6513,ElliotBayTrailMyrtlePark,09/29/2014 09:00:00 AM,48,-122,18,72,90
6514,ElliotBayTrailMyrtlePark,09/29/2014 10:00:00 AM,48,-122,9,16,25
6515,ElliotBayTrailMyrtlePark,09/29/2014 11:00:00 AM,48,-122,10,11,21
6516,ElliotBayTrailMyrtlePark,09/29/2014 12:00:00 PM,48,-122,7,5,12
6517,ElliotBayTrailMyrtlePark,09/29/2014 01:00:00 PM,48,-122,10,11,21
6518,ElliotBayTrailMyrtlePark,09/29/2014 02:00:00 PM,48,-122,11,14,25
6519,ElliotBayTrailMyrtlePark,09/29/2014 03:00:00 PM,48,-122,17,22,39
6520,ElliotBayTrailMyrtlePark,09/29/2014 04:00:00 PM,48,-122,47,29,76
6521,ElliotBayTrailMyrtlePark,09/29/2014 05:00:00 PM,48,-122,158,36,194
6522,ElliotBayTrailMyrtlePark,09/29/2014 06:00:00 PM,48,-122,97,17,114
6523,ElliotBayTrailMyrtlePark,09/29/2014 07:00:00 PM,48,-122,28,5,33
6524,ElliotBayTrailMyrtlePark,09/29/2014 08:00:00 PM,48,-122,9,3,12
6525,ElliotBayTrailMyrtlePark,09/29/2014 09:00:00 PM,48,-122,2,2,4
6526,ElliotBayTrailMyrtlePark,09/29/2014 10:00:00 PM,48,-122,4,0,4
6527,ElliotBayTrailMyrtlePark,09/29/2014 11:00:00 PM,48,-122,1,2,3
6528,ElliotBayTrailMyrtlePark,09/30/2014 12:00:00 AM,48,-122,4,1,5
6529,ElliotBayTrailMyrtlePark,09/30/2014 01:00:00 AM,48,-122,0,0,0
6530,ElliotBayTrailMyrtlePark,09/30/2014 02:00:00 AM,48,-122,1,0,1
6531,ElliotBayTrailMyrtlePark,09/30/2014 03:00:00 AM,48,-122,0,0,0
6532,ElliotBayTrailMyrtlePark,09/30/2014 04:00:00 AM,48,-122,0,0,0
6533,ElliotBayTrailMyrtlePark,09/30/2014 05:00:00 AM,48,-122,9,14,23
6534,ElliotBayTrailMyrtlePark,09/30/2014 06:00:00 AM,48,-122,20,25,45
6535,ElliotBayTrailMyrtlePark,09/30/2014 07:00:00 AM,48,-122,30,88,118
6536,ElliotBayTrailMyrtlePark,09/30/2014 08:00:00 AM,48,-122,35,133,168
6537,ElliotBayTrailMyrtlePark,09/30/2014 09:00:00 AM,48,-122,23,71,94
6538,ElliotBayTrailMyrtlePark,09/30/2014 10:00:00 AM,48,-122,15,20,35
6539,ElliotBayTrailMyrtlePark,09/30/2014 11:00:00 AM,48,-122,9,17,26
6540,ElliotBayTrailMyrtlePark,09/30/2014 12:00:00 PM,48,-122,18,23,41
6541,ElliotBayTrailMyrtlePark,09/30/2014 01:00:00 PM,48,-122,13,25,38
6542,ElliotBayTrailMyrtlePark,09/30/2014 02:00:00 PM,48,-122,36,25,61
6543,ElliotBayTrailMyrtlePark,09/30/2014 03:00:00 PM,48,-122,27,27,54
6544,ElliotBayTrailMyrtlePark,09/30/2014 04:00:00 PM,48,-122,77,38,115
6545,ElliotBayTrailMyrtlePark,09/30/2014 05:00:00 PM,48,-122,152,60,212
6546,ElliotBayTrailMyrtlePark,09/30/2014 06:00:00 PM,48,-122,153,51,204
6547,ElliotBayTrailMyrtlePark,09/30/2014 07:00:00 PM,48,-122,39,21,60
6548,ElliotBayTrailMyrtlePark,09/30/2014 08:00:00 PM,48,-122,10,6,16
6549,ElliotBayTrailMyrtlePark,09/30/2014 09:00:00 PM,48,-122,7,8,15
6550,ElliotBayTrailMyrtlePark,09/30/2014 10:00:00 PM,48,-122,7,3,10
6551,ElliotBayTrailMyrtlePark,09/30/2014 11:00:00 PM,48,-122,8,1,9
6552,ElliotBayTrailMyrtlePark,10/01/2014 12:00:00 AM,48,-122,2,1,3
6553,ElliotBayTrailMyrtlePark,10/01/2014 01:00:00 AM,48,-122,5,5,10
6554,ElliotBayTrailMyrtlePark,10/01/2014 02:00:00 AM,48,-122,2,0,2
6555,ElliotBayTrailMyrtlePark,10/01/2014 03:00:00 AM,48,-122,0,0,0
6556,ElliotBayTrailMyrtlePark,10/01/2014 04:00:00 AM,48,-122,0,0,0
6557,ElliotBayTrailMyrtlePark,10/01/2014 05:00:00 AM,48,-122,6,11,17
6558,ElliotBayTrailMyrtlePark,10/01/2014 06:00:00 AM,48,-122,13,32,45
6559,ElliotBayTrailMyrtlePark,10/01/2014 07:00:00 AM,48,-122,47,95,142
6560,ElliotBayTrailMyrtlePark,10/01/2014 08:00:00 AM,48,-122,45,154,199
6561,ElliotBayTrailMyrtlePark,10/01/2014 09:00:00 AM,48,-122,26,79,105
6562,ElliotBayTrailMyrtlePark,10/01/2014 10:00:00 AM,48,-122,16,24,40
6563,ElliotBayTrailMyrtlePark,10/01/2014 11:00:00 AM,48,-122,14,21,35
6564,ElliotBayTrailMyrtlePark,10/01/2014 12:00:00 PM,48,-122,12,16,28
6565,ElliotBayTrailMyrtlePark,10/01/2014 01:00:00 PM,48,-122,17,17,34
6566,ElliotBayTrailMyrtlePark,10/01/2014 02:00:00 PM,48,-122,25,28,53
6567,ElliotBayTrailMyrtlePark,10/01/2014 03:00:00 PM,48,-122,44,23,67
6568,ElliotBayTrailMyrtlePark,10/01/2014 04:00:00 PM,48,-122,94,56,150
6569,ElliotBayTrailMyrtlePark,10/01/2014 05:00:00 PM,48,-122,198,63,261
6570,ElliotBayTrailMyrtlePark,10/01/2014 06:00:00 PM,48,-122,148,49,197
6571,ElliotBayTrailMyrtlePark,10/01/2014 07:00:00 PM,48,-122,38,20,58
6572,ElliotBayTrailMyrtlePark,10/01/2014 08:00:00 PM,48,-122,16,4,20
6573,ElliotBayTrailMyrtlePark,10/01/2014 09:00:00 PM,48,-122,11,1,12
6574,ElliotBayTrailMyrtlePark,10/01/2014 10:00:00 PM,48,-122,2,6,8
6575,ElliotBayTrailMyrtlePark,10/01/2014 11:00:00 PM,48,-122,1,0,1
6576,ElliotBayTrailMyrtlePark,10/02/2014 12:00:00 AM,48,-122,5,1,6
6577,ElliotBayTrailMyrtlePark,10/02/2014 01:00:00 AM,48,-122,0,0,0
6578,ElliotBayTrailMyrtlePark,10/02/2014 02:00:00 AM,48,-122,1,0,1
6579,ElliotBayTrailMyrtlePark,10/02/2014 03:00:00 AM,48,-122,0,0,0
6580,ElliotBayTrailMyrtlePark,10/02/2014 04:00:00 AM,48,-122,1,0,1
6581,ElliotBayTrailMyrtlePark,10/02/2014 05:00:00 AM,48,-122,7,13,20
6582,ElliotBayTrailMyrtlePark,10/02/2014 06:00:00 AM,48,-122,21,30,51
6583,ElliotBayTrailMyrtlePark,10/02/2014 07:00:00 AM,48,-122,44,91,135
6584,ElliotBayTrailMyrtlePark,10/02/2014 08:00:00 AM,48,-122,24,154,178
6585,ElliotBayTrailMyrtlePark,10/02/2014 09:00:00 AM,48,-122,25,84,109
6586,ElliotBayTrailMyrtlePark,10/02/2014 10:00:00 AM,48,-122,16,30,46
6587,ElliotBayTrailMyrtlePark,10/02/2014 11:00:00 AM,48,-122,21,13,34
6588,ElliotBayTrailMyrtlePark,10/02/2014 12:00:00 PM,48,-122,31,20,51
6589,ElliotBayTrailMyrtlePark,10/02/2014 01:00:00 PM,48,-122,30,20,50
6590,ElliotBayTrailMyrtlePark,10/02/2014 02:00:00 PM,48,-122,26,28,54
6591,ElliotBayTrailMyrtlePark,10/02/2014 03:00:00 PM,48,-122,42,34,76
6592,ElliotBayTrailMyrtlePark,10/02/2014 04:00:00 PM,48,-122,101,46,147
6593,ElliotBayTrailMyrtlePark,10/02/2014 05:00:00 PM,48,-122,164,68,232
6594,ElliotBayTrailMyrtlePark,10/02/2014 06:00:00 PM,48,-122,119,48,167
6595,ElliotBayTrailMyrtlePark,10/02/2014 07:00:00 PM,48,-122,45,25,70
6596,ElliotBayTrailMyrtlePark,10/02/2014 08:00:00 PM,48,-122,17,3,20
6597,ElliotBayTrailMyrtlePark,10/02/2014 09:00:00 PM,48,-122,7,0,7
6598,ElliotBayTrailMyrtlePark,10/02/2014 10:00:00 PM,48,-122,3,1,4
6599,ElliotBayTrailMyrtlePark,10/02/2014 11:00:00 PM,48,-122,4,1,5
6600,ElliotBayTrailMyrtlePark,10/03/2014 12:00:00 AM,48,-122,3,0,3
6601,ElliotBayTrailMyrtlePark,10/03/2014 01:00:00 AM,48,-122,4,0,4
6602,ElliotBayTrailMyrtlePark,10/03/2014 02:00:00 AM,48,-122,4,0,4
6603,ElliotBayTrailMyrtlePark,10/03/2014 03:00:00 AM,48,-122,0,0,0
6604,ElliotBayTrailMyrtlePark,10/03/2014 04:00:00 AM,48,-122,0,1,1
6605,ElliotBayTrailMyrtlePark,10/03/2014 05:00:00 AM,48,-122,4,15,19
6606,ElliotBayTrailMyrtlePark,10/03/2014 06:00:00 AM,48,-122,17,26,43
6607,ElliotBayTrailMyrtlePark,10/03/2014 07:00:00 AM,48,-122,43,81,124
6608,ElliotBayTrailMyrtlePark,10/03/2014 08:00:00 AM,48,-122,43,127,170
6609,ElliotBayTrailMyrtlePark,10/03/2014 09:00:00 AM,48,-122,25,86,111
6610,ElliotBayTrailMyrtlePark,10/03/2014 10:00:00 AM,48,-122,16,28,44
6611,ElliotBayTrailMyrtlePark,10/03/2014 11:00:00 AM,48,-122,26,16,42
6612,ElliotBayTrailMyrtlePark,10/03/2014 12:00:00 PM,48,-122,32,29,61
6613,ElliotBayTrailMyrtlePark,10/03/2014 01:00:00 PM,48,-122,26,27,53
6614,ElliotBayTrailMyrtlePark,10/03/2014 02:00:00 PM,48,-122,33,36,69
6615,ElliotBayTrailMyrtlePark,10/03/2014 03:00:00 PM,48,-122,76,67,143
6616,ElliotBayTrailMyrtlePark,10/03/2014 04:00:00 PM,48,-122,100,57,157
6617,ElliotBayTrailMyrtlePark,10/03/2014 05:00:00 PM,48,-122,162,77,239
6618,ElliotBayTrailMyrtlePark,10/03/2014 06:00:00 PM,48,-122,99,46,145
6619,ElliotBayTrailMyrtlePark,10/03/2014 07:00:00 PM,48,-122,39,31,70
6620,ElliotBayTrailMyrtlePark,10/03/2014 08:00:00 PM,48,-122,14,16,30
6621,ElliotBayTrailMyrtlePark,10/03/2014 09:00:00 PM,48,-122,5,0,5
6622,ElliotBayTrailMyrtlePark,10/03/2014 10:00:00 PM,48,-122,13,6,19
6623,ElliotBayTrailMyrtlePark,10/03/2014 11:00:00 PM,48,-122,6,2,8
6624,ElliotBayTrailMyrtlePark,10/04/2014 12:00:00 AM,48,-122,10,4,14
6625,ElliotBayTrailMyrtlePark,10/04/2014 01:00:00 AM,48,-122,2,0,2
6626,ElliotBayTrailMyrtlePark,10/04/2014 02:00:00 AM,48,-122,2,1,3
6627,ElliotBayTrailMyrtlePark,10/04/2014 03:00:00 AM,48,-122,1,2,3
6628,ElliotBayTrailMyrtlePark,10/04/2014 04:00:00 AM,48,-122,2,0,2
6629,ElliotBayTrailMyrtlePark,10/04/2014 05:00:00 AM,48,-122,3,3,6
6630,ElliotBayTrailMyrtlePark,10/04/2014 06:00:00 AM,48,-122,4,11,15
6631,ElliotBayTrailMyrtlePark,10/04/2014 07:00:00 AM,48,-122,10,14,24
6632,ElliotBayTrailMyrtlePark,10/04/2014 08:00:00 AM,48,-122,10,22,32
6633,ElliotBayTrailMyrtlePark,10/04/2014 09:00:00 AM,48,-122,18,24,42
6634,ElliotBayTrailMyrtlePark,10/04/2014 10:00:00 AM,48,-122,21,24,45
6635,ElliotBayTrailMyrtlePark,10/04/2014 11:00:00 AM,48,-122,43,36,79
6636,ElliotBayTrailMyrtlePark,10/04/2014 12:00:00 PM,48,-122,51,52,103
6637,ElliotBayTrailMyrtlePark,10/04/2014 01:00:00 PM,48,-122,38,49,87
6638,ElliotBayTrailMyrtlePark,10/04/2014 02:00:00 PM,48,-122,52,32,84
6639,ElliotBayTrailMyrtlePark,10/04/2014 03:00:00 PM,48,-122,50,44,94
6640,ElliotBayTrailMyrtlePark,10/04/2014 04:00:00 PM,48,-122,52,36,88
6641,ElliotBayTrailMyrtlePark,10/04/2014 05:00:00 PM,48,-122,45,54,99
6642,ElliotBayTrailMyrtlePark,10/04/2014 06:00:00 PM,48,-122,28,39,67
6643,ElliotBayTrailMyrtlePark,10/04/2014 07:00:00 PM,48,-122,13,14,27
6644,ElliotBayTrailMyrtlePark,10/04/2014 08:00:00 PM,48,-122,17,11,28
6645,ElliotBayTrailMyrtlePark,10/04/2014 09:00:00 PM,48,-122,5,1,6
6646,ElliotBayTrailMyrtlePark,10/04/2014 10:00:00 PM,48,-122,9,4,13
6647,ElliotBayTrailMyrtlePark,10/04/2014 11:00:00 PM,48,-122,8,3,11
6648,ElliotBayTrailMyrtlePark,10/05/2014 12:00:00 AM,48,-122,2,1,3
6649,ElliotBayTrailMyrtlePark,10/05/2014 01:00:00 AM,48,-122,5,2,7
6650,ElliotBayTrailMyrtlePark,10/05/2014 02:00:00 AM,48,-122,1,1,2
6651,ElliotBayTrailMyrtlePark,10/05/2014 03:00:00 AM,48,-122,0,0,0
6652,ElliotBayTrailMyrtlePark,10/05/2014 04:00:00 AM,48,-122,0,1,1
6653,ElliotBayTrailMyrtlePark,10/05/2014 05:00:00 AM,48,-122,3,3,6
6654,ElliotBayTrailMyrtlePark,10/05/2014 06:00:00 AM,48,-122,0,6,6
6655,ElliotBayTrailMyrtlePark,10/05/2014 07:00:00 AM,48,-122,7,5,12
6656,ElliotBayTrailMyrtlePark,10/05/2014 08:00:00 AM,48,-122,9,10,19
6657,ElliotBayTrailMyrtlePark,10/05/2014 09:00:00 AM,48,-122,22,27,49
6658,ElliotBayTrailMyrtlePark,10/05/2014 10:00:00 AM,48,-122,28,20,48
6659,ElliotBayTrailMyrtlePark,10/05/2014 11:00:00 AM,48,-122,62,55,117
6660,ElliotBayTrailMyrtlePark,10/05/2014 12:00:00 PM,48,-122,57,47,104
6661,ElliotBayTrailMyrtlePark,10/05/2014 01:00:00 PM,48,-122,62,84,146
6662,ElliotBayTrailMyrtlePark,10/05/2014 02:00:00 PM,48,-122,85,58,143
6663,ElliotBayTrailMyrtlePark,10/05/2014 03:00:00 PM,48,-122,76,61,137
6664,ElliotBayTrailMyrtlePark,10/05/2014 04:00:00 PM,48,-122,79,95,174
6665,ElliotBayTrailMyrtlePark,10/05/2014 05:00:00 PM,48,-122,44,51,95
6666,ElliotBayTrailMyrtlePark,10/05/2014 06:00:00 PM,48,-122,27,33,60
6667,ElliotBayTrailMyrtlePark,10/05/2014 07:00:00 PM,48,-122,25,13,38
6668,ElliotBayTrailMyrtlePark,10/05/2014 08:00:00 PM,48,-122,12,11,23
6669,ElliotBayTrailMyrtlePark,10/05/2014 09:00:00 PM,48,-122,7,1,8
6670,ElliotBayTrailMyrtlePark,10/05/2014 10:00:00 PM,48,-122,0,1,1
6671,ElliotBayTrailMyrtlePark,10/05/2014 11:00:00 PM,48,-122,8,3,11
6672,ElliotBayTrailMyrtlePark,10/06/2014 12:00:00 AM,48,-122,5,2,7
6673,ElliotBayTrailMyrtlePark,10/06/2014 01:00:00 AM,48,-122,2,0,2
6674,ElliotBayTrailMyrtlePark,10/06/2014 02:00:00 AM,48,-122,3,0,3
6675,ElliotBayTrailMyrtlePark,10/06/2014 03:00:00 AM,48,-122,0,3,3
6676,ElliotBayTrailMyrtlePark,10/06/2014 04:00:00 AM,48,-122,0,0,0
6677,ElliotBayTrailMyrtlePark,10/06/2014 05:00:00 AM,48,-122,8,8,16
6678,ElliotBayTrailMyrtlePark,10/06/2014 06:00:00 AM,48,-122,19,35,54
6679,ElliotBayTrailMyrtlePark,10/06/2014 07:00:00 AM,48,-122,51,98,149
6680,ElliotBayTrailMyrtlePark,10/06/2014 08:00:00 AM,48,-122,31,144,175
6681,ElliotBayTrailMyrtlePark,10/06/2014 09:00:00 AM,48,-122,31,92,123
6682,ElliotBayTrailMyrtlePark,10/06/2014 10:00:00 AM,48,-122,12,28,40
6683,ElliotBayTrailMyrtlePark,10/06/2014 11:00:00 AM,48,-122,11,28,39
6684,ElliotBayTrailMyrtlePark,10/06/2014 12:00:00 PM,48,-122,28,29,57
6685,ElliotBayTrailMyrtlePark,10/06/2014 01:00:00 PM,48,-122,34,29,63
6686,ElliotBayTrailMyrtlePark,10/06/2014 02:00:00 PM,48,-122,30,35,65
6687,ElliotBayTrailMyrtlePark,10/06/2014 03:00:00 PM,48,-122,33,39,72
6688,ElliotBayTrailMyrtlePark,10/06/2014 04:00:00 PM,48,-122,118,51,169
6689,ElliotBayTrailMyrtlePark,10/06/2014 05:00:00 PM,48,-122,222,70,292
6690,ElliotBayTrailMyrtlePark,10/06/2014 06:00:00 PM,48,-122,113,42,155
6691,ElliotBayTrailMyrtlePark,10/06/2014 07:00:00 PM,48,-122,39,10,49
6692,ElliotBayTrailMyrtlePark,10/06/2014 08:00:00 PM,48,-122,11,10,21
6693,ElliotBayTrailMyrtlePark,10/06/2014 09:00:00 PM,48,-122,8,2,10
6694,ElliotBayTrailMyrtlePark,10/06/2014 10:00:00 PM,48,-122,7,3,10
6695,ElliotBayTrailMyrtlePark,10/06/2014 11:00:00 PM,48,-122,10,1,11
6696,ElliotBayTrailMyrtlePark,10/07/2014 12:00:00 AM,48,-122,4,1,5
6697,ElliotBayTrailMyrtlePark,10/07/2014 01:00:00 AM,48,-122,2,0,2
6698,ElliotBayTrailMyrtlePark,10/07/2014 02:00:00 AM,48,-122,4,1,5
6699,ElliotBayTrailMyrtlePark,10/07/2014 03:00:00 AM,48,-122,0,0,0
6700,ElliotBayTrailMyrtlePark,10/07/2014 04:00:00 AM,48,-122,0,0,0
6701,ElliotBayTrailMyrtlePark,10/07/2014 05:00:00 AM,48,-122,7,13,20
6702,ElliotBayTrailMyrtlePark,10/07/2014 06:00:00 AM,48,-122,22,43,65
6703,ElliotBayTrailMyrtlePark,10/07/2014 07:00:00 AM,48,-122,50,101,151
6704,ElliotBayTrailMyrtlePark,10/07/2014 08:00:00 AM,48,-122,36,167,203
6705,ElliotBayTrailMyrtlePark,10/07/2014 09:00:00 AM,48,-122,20,73,93
6706,ElliotBayTrailMyrtlePark,10/07/2014 10:00:00 AM,48,-122,21,25,46
6707,ElliotBayTrailMyrtlePark,10/07/2014 11:00:00 AM,48,-122,20,26,46
6708,ElliotBayTrailMyrtlePark,10/07/2014 12:00:00 PM,48,-122,19,13,32
6709,ElliotBayTrailMyrtlePark,10/07/2014 01:00:00 PM,48,-122,19,18,37
6710,ElliotBayTrailMyrtlePark,10/07/2014 02:00:00 PM,48,-122,24,17,41
6711,ElliotBayTrailMyrtlePark,10/07/2014 03:00:00 PM,48,-122,37,35,72
6712,ElliotBayTrailMyrtlePark,10/07/2014 04:00:00 PM,48,-122,86,62,148
6713,ElliotBayTrailMyrtlePark,10/07/2014 05:00:00 PM,48,-122,201,62,263
6714,ElliotBayTrailMyrtlePark,10/07/2014 06:00:00 PM,48,-122,135,55,190
6715,ElliotBayTrailMyrtlePark,10/07/2014 07:00:00 PM,48,-122,32,16,48
6716,ElliotBayTrailMyrtlePark,10/07/2014 08:00:00 PM,48,-122,8,8,16
6717,ElliotBayTrailMyrtlePark,10/07/2014 09:00:00 PM,48,-122,7,3,10
6718,ElliotBayTrailMyrtlePark,10/07/2014 10:00:00 PM,48,-122,3,1,4
6719,ElliotBayTrailMyrtlePark,10/07/2014 11:00:00 PM,48,-122,2,0,2
6720,ElliotBayTrailMyrtlePark,10/08/2014 12:00:00 AM,48,-122,4,0,4
6721,ElliotBayTrailMyrtlePark,10/08/2014 01:00:00 AM,48,-122,1,0,1
6722,ElliotBayTrailMyrtlePark,10/08/2014 02:00:00 AM,48,-122,4,1,5
6723,ElliotBayTrailMyrtlePark,10/08/2014 03:00:00 AM,48,-122,0,0,0
6724,ElliotBayTrailMyrtlePark,10/08/2014 04:00:00 AM,48,-122,0,0,0
6725,ElliotBayTrailMyrtlePark,10/08/2014 05:00:00 AM,48,-122,10,21,31
6726,ElliotBayTrailMyrtlePark,10/08/2014 06:00:00 AM,48,-122,21,32,53
6727,ElliotBayTrailMyrtlePark,10/08/2014 07:00:00 AM,48,-122,39,74,113
6728,ElliotBayTrailMyrtlePark,10/08/2014 08:00:00 AM,48,-122,41,139,180
6729,ElliotBayTrailMyrtlePark,10/08/2014 09:00:00 AM,48,-122,20,88,108
6730,ElliotBayTrailMyrtlePark,10/08/2014 10:00:00 AM,48,-122,13,23,36
6731,ElliotBayTrailMyrtlePark,10/08/2014 11:00:00 AM,48,-122,17,13,30
6732,ElliotBayTrailMyrtlePark,10/08/2014 12:00:00 PM,48,-122,12,12,24
6733,ElliotBayTrailMyrtlePark,10/08/2014 01:00:00 PM,48,-122,15,15,30
6734,ElliotBayTrailMyrtlePark,10/08/2014 02:00:00 PM,48,-122,29,32,61
6735,ElliotBayTrailMyrtlePark,10/08/2014 03:00:00 PM,48,-122,26,29,55
6736,ElliotBayTrailMyrtlePark,10/08/2014 04:00:00 PM,48,-122,73,48,121
6737,ElliotBayTrailMyrtlePark,10/08/2014 05:00:00 PM,48,-122,195,62,257
6738,ElliotBayTrailMyrtlePark,10/08/2014 06:00:00 PM,48,-122,138,64,202
6739,ElliotBayTrailMyrtlePark,10/08/2014 07:00:00 PM,48,-122,41,15,56
6740,ElliotBayTrailMyrtlePark,10/08/2014 08:00:00 PM,48,-122,10,3,13
6741,ElliotBayTrailMyrtlePark,10/08/2014 09:00:00 PM,48,-122,5,3,8
6742,ElliotBayTrailMyrtlePark,10/08/2014 10:00:00 PM,48,-122,4,6,10
6743,ElliotBayTrailMyrtlePark,10/08/2014 11:00:00 PM,48,-122,2,2,4
6744,ElliotBayTrailMyrtlePark,10/09/2014 12:00:00 AM,48,-122,5,1,6
6745,ElliotBayTrailMyrtlePark,10/09/2014 01:00:00 AM,48,-122,1,0,1
6746,ElliotBayTrailMyrtlePark,10/09/2014 02:00:00 AM,48,-122,1,0,1
6747,ElliotBayTrailMyrtlePark,10/09/2014 03:00:00 AM,48,-122,0,0,0
6748,ElliotBayTrailMyrtlePark,10/09/2014 04:00:00 AM,48,-122,0,0,0
6749,ElliotBayTrailMyrtlePark,10/09/2014 05:00:00 AM,48,-122,8,13,21
6750,ElliotBayTrailMyrtlePark,10/09/2014 06:00:00 AM,48,-122,20,31,51
6751,ElliotBayTrailMyrtlePark,10/09/2014 07:00:00 AM,48,-122,42,85,127
6752,ElliotBayTrailMyrtlePark,10/09/2014 08:00:00 AM,48,-122,36,140,176
6753,ElliotBayTrailMyrtlePark,10/09/2014 09:00:00 AM,48,-122,28,66,94
6754,ElliotBayTrailMyrtlePark,10/09/2014 10:00:00 AM,48,-122,25,28,53
6755,ElliotBayTrailMyrtlePark,10/09/2014 11:00:00 AM,48,-122,25,17,42
6756,ElliotBayTrailMyrtlePark,10/09/2014 12:00:00 PM,48,-122,14,17,31
6757,ElliotBayTrailMyrtlePark,10/09/2014 01:00:00 PM,48,-122,18,23,41
6758,ElliotBayTrailMyrtlePark,10/09/2014 02:00:00 PM,48,-122,25,26,51
6759,ElliotBayTrailMyrtlePark,10/09/2014 03:00:00 PM,48,-122,36,40,76
6760,ElliotBayTrailMyrtlePark,10/09/2014 04:00:00 PM,48,-122,75,53,128
6761,ElliotBayTrailMyrtlePark,10/09/2014 05:00:00 PM,48,-122,199,58,257
6762,ElliotBayTrailMyrtlePark,10/09/2014 06:00:00 PM,48,-122,167,55,222
6763,ElliotBayTrailMyrtlePark,10/09/2014 07:00:00 PM,48,-122,46,26,72
6764,ElliotBayTrailMyrtlePark,10/09/2014 08:00:00 PM,48,-122,15,11,26
6765,ElliotBayTrailMyrtlePark,10/09/2014 09:00:00 PM,48,-122,6,18,24
6766,ElliotBayTrailMyrtlePark,10/09/2014 10:00:00 PM,48,-122,8,2,10
6767,ElliotBayTrailMyrtlePark,10/09/2014 11:00:00 PM,48,-122,2,1,3
6768,ElliotBayTrailMyrtlePark,10/10/2014 12:00:00 AM,48,-122,1,0,1
6769,ElliotBayTrailMyrtlePark,10/10/2014 01:00:00 AM,48,-122,3,0,3
6770,ElliotBayTrailMyrtlePark,10/10/2014 02:00:00 AM,48,-122,1,0,1
6771,ElliotBayTrailMyrtlePark,10/10/2014 03:00:00 AM,48,-122,0,0,0
6772,ElliotBayTrailMyrtlePark,10/10/2014 04:00:00 AM,48,-122,1,0,1
6773,ElliotBayTrailMyrtlePark,10/10/2014 05:00:00 AM,48,-122,3,12,15
6774,ElliotBayTrailMyrtlePark,10/10/2014 06:00:00 AM,48,-122,12,21,33
6775,ElliotBayTrailMyrtlePark,10/10/2014 07:00:00 AM,48,-122,30,70,100
6776,ElliotBayTrailMyrtlePark,10/10/2014 08:00:00 AM,48,-122,39,107,146
6777,ElliotBayTrailMyrtlePark,10/10/2014 09:00:00 AM,48,-122,16,61,77
6778,ElliotBayTrailMyrtlePark,10/10/2014 10:00:00 AM,48,-122,9,23,32
6779,ElliotBayTrailMyrtlePark,10/10/2014 11:00:00 AM,48,-122,16,9,25
6780,ElliotBayTrailMyrtlePark,10/10/2014 12:00:00 PM,48,-122,13,12,25
6781,ElliotBayTrailMyrtlePark,10/10/2014 01:00:00 PM,48,-122,17,18,35
6782,ElliotBayTrailMyrtlePark,10/10/2014 02:00:00 PM,48,-122,24,30,54
6783,ElliotBayTrailMyrtlePark,10/10/2014 03:00:00 PM,48,-122,33,26,59
6784,ElliotBayTrailMyrtlePark,10/10/2014 04:00:00 PM,48,-122,94,42,136
6785,ElliotBayTrailMyrtlePark,10/10/2014 05:00:00 PM,48,-122,110,56,166
6786,ElliotBayTrailMyrtlePark,10/10/2014 06:00:00 PM,48,-122,71,53,124
6787,ElliotBayTrailMyrtlePark,10/10/2014 07:00:00 PM,48,-122,16,12,28
6788,ElliotBayTrailMyrtlePark,10/10/2014 08:00:00 PM,48,-122,15,1,16
6789,ElliotBayTrailMyrtlePark,10/10/2014 09:00:00 PM,48,-122,17,1,18
6790,ElliotBayTrailMyrtlePark,10/10/2014 10:00:00 PM,48,-122,28,2,30
6791,ElliotBayTrailMyrtlePark,10/10/2014 11:00:00 PM,48,-122,14,2,16
6792,ElliotBayTrailMyrtlePark,10/11/2014 12:00:00 AM,48,-122,5,3,8
6793,ElliotBayTrailMyrtlePark,10/11/2014 01:00:00 AM,48,-122,2,0,2
6794,ElliotBayTrailMyrtlePark,10/11/2014 02:00:00 AM,48,-122,0,3,3
6795,ElliotBayTrailMyrtlePark,10/11/2014 03:00:00 AM,48,-122,4,0,4
6796,ElliotBayTrailMyrtlePark,10/11/2014 04:00:00 AM,48,-122,1,0,1
6797,ElliotBayTrailMyrtlePark,10/11/2014 05:00:00 AM,48,-122,2,2,4
6798,ElliotBayTrailMyrtlePark,10/11/2014 06:00:00 AM,48,-122,3,4,7
6799,ElliotBayTrailMyrtlePark,10/11/2014 07:00:00 AM,48,-122,7,8,15
6800,ElliotBayTrailMyrtlePark,10/11/2014 08:00:00 AM,48,-122,20,13,33
6801,ElliotBayTrailMyrtlePark,10/11/2014 09:00:00 AM,48,-122,21,16,37
6802,ElliotBayTrailMyrtlePark,10/11/2014 10:00:00 AM,48,-122,22,25,47
6803,ElliotBayTrailMyrtlePark,10/11/2014 11:00:00 AM,48,-122,15,25,40
6804,ElliotBayTrailMyrtlePark,10/11/2014 12:00:00 PM,48,-122,18,28,46
6805,ElliotBayTrailMyrtlePark,10/11/2014 01:00:00 PM,48,-122,22,15,37
6806,ElliotBayTrailMyrtlePark,10/11/2014 02:00:00 PM,48,-122,12,16,28
6807,ElliotBayTrailMyrtlePark,10/11/2014 03:00:00 PM,48,-122,17,18,35
6808,ElliotBayTrailMyrtlePark,10/11/2014 04:00:00 PM,48,-122,33,34,67
6809,ElliotBayTrailMyrtlePark,10/11/2014 05:00:00 PM,48,-122,30,31,61
6810,ElliotBayTrailMyrtlePark,10/11/2014 06:00:00 PM,48,-122,14,4,18
6811,ElliotBayTrailMyrtlePark,10/11/2014 07:00:00 PM,48,-122,5,5,10
6812,ElliotBayTrailMyrtlePark,10/11/2014 08:00:00 PM,48,-122,2,2,4
6813,ElliotBayTrailMyrtlePark,10/11/2014 09:00:00 PM,48,-122,5,2,7
6814,ElliotBayTrailMyrtlePark,10/11/2014 10:00:00 PM,48,-122,4,3,7
6815,ElliotBayTrailMyrtlePark,10/11/2014 11:00:00 PM,48,-122,3,0,3
6816,ElliotBayTrailMyrtlePark,10/12/2014 12:00:00 AM,48,-122,3,1,4
6817,ElliotBayTrailMyrtlePark,10/12/2014 01:00:00 AM,48,-122,0,0,0
6818,ElliotBayTrailMyrtlePark,10/12/2014 02:00:00 AM,48,-122,0,2,2
6819,ElliotBayTrailMyrtlePark,10/12/2014 03:00:00 AM,48,-122,0,0,0
6820,ElliotBayTrailMyrtlePark,10/12/2014 04:00:00 AM,48,-122,2,1,3
6821,ElliotBayTrailMyrtlePark,10/12/2014 05:00:00 AM,48,-122,0,1,1
6822,ElliotBayTrailMyrtlePark,10/12/2014 06:00:00 AM,48,-122,0,2,2
6823,ElliotBayTrailMyrtlePark,10/12/2014 07:00:00 AM,48,-122,4,5,9
6824,ElliotBayTrailMyrtlePark,10/12/2014 08:00:00 AM,48,-122,9,14,23
6825,ElliotBayTrailMyrtlePark,10/12/2014 09:00:00 AM,48,-122,26,15,41
6826,ElliotBayTrailMyrtlePark,10/12/2014 10:00:00 AM,48,-122,26,32,58
6827,ElliotBayTrailMyrtlePark,10/12/2014 11:00:00 AM,48,-122,31,47,78
6828,ElliotBayTrailMyrtlePark,10/12/2014 12:00:00 PM,48,-122,25,38,63
6829,ElliotBayTrailMyrtlePark,10/12/2014 01:00:00 PM,48,-122,45,33,78
6830,ElliotBayTrailMyrtlePark,10/12/2014 02:00:00 PM,48,-122,48,30,78
6831,ElliotBayTrailMyrtlePark,10/12/2014 03:00:00 PM,48,-122,40,45,85
6832,ElliotBayTrailMyrtlePark,10/12/2014 04:00:00 PM,48,-122,41,19,60
6833,ElliotBayTrailMyrtlePark,10/12/2014 05:00:00 PM,48,-122,27,26,53
6834,ElliotBayTrailMyrtlePark,10/12/2014 06:00:00 PM,48,-122,19,9,28
6835,ElliotBayTrailMyrtlePark,10/12/2014 07:00:00 PM,48,-122,5,5,10
6836,ElliotBayTrailMyrtlePark,10/12/2014 08:00:00 PM,48,-122,1,0,1
6837,ElliotBayTrailMyrtlePark,10/12/2014 09:00:00 PM,48,-122,2,0,2
6838,ElliotBayTrailMyrtlePark,10/12/2014 10:00:00 PM,48,-122,4,2,6
6839,ElliotBayTrailMyrtlePark,10/12/2014 11:00:00 PM,48,-122,1,0,1
6840,ElliotBayTrailMyrtlePark,10/13/2014 12:00:00 AM,48,-122,3,1,4
6841,ElliotBayTrailMyrtlePark,10/13/2014 01:00:00 AM,48,-122,0,0,0
6842,ElliotBayTrailMyrtlePark,10/13/2014 02:00:00 AM,48,-122,0,0,0
6843,ElliotBayTrailMyrtlePark,10/13/2014 03:00:00 AM,48,-122,1,0,1
6844,ElliotBayTrailMyrtlePark,10/13/2014 04:00:00 AM,48,-122,2,0,2
6845,ElliotBayTrailMyrtlePark,10/13/2014 05:00:00 AM,48,-122,5,10,15
6846,ElliotBayTrailMyrtlePark,10/13/2014 06:00:00 AM,48,-122,17,27,44
6847,ElliotBayTrailMyrtlePark,10/13/2014 07:00:00 AM,48,-122,40,65,105
6848,ElliotBayTrailMyrtlePark,10/13/2014 08:00:00 AM,48,-122,29,115,144
6849,ElliotBayTrailMyrtlePark,10/13/2014 09:00:00 AM,48,-122,26,72,98
6850,ElliotBayTrailMyrtlePark,10/13/2014 10:00:00 AM,48,-122,15,30,45
6851,ElliotBayTrailMyrtlePark,10/13/2014 11:00:00 AM,48,-122,23,19,42
6852,ElliotBayTrailMyrtlePark,10/13/2014 12:00:00 PM,48,-122,25,25,50
6853,ElliotBayTrailMyrtlePark,10/13/2014 01:00:00 PM,48,-122,18,25,43
6854,ElliotBayTrailMyrtlePark,10/13/2014 02:00:00 PM,48,-122,25,24,49
6855,ElliotBayTrailMyrtlePark,10/13/2014 03:00:00 PM,48,-122,29,28,57
6856,ElliotBayTrailMyrtlePark,10/13/2014 04:00:00 PM,48,-122,84,35,119
6857,ElliotBayTrailMyrtlePark,10/13/2014 05:00:00 PM,48,-122,156,52,208
6858,ElliotBayTrailMyrtlePark,10/13/2014 06:00:00 PM,48,-122,90,40,130
6859,ElliotBayTrailMyrtlePark,10/13/2014 07:00:00 PM,48,-122,26,9,35
6860,ElliotBayTrailMyrtlePark,10/13/2014 08:00:00 PM,48,-122,9,2,11
6861,ElliotBayTrailMyrtlePark,10/13/2014 09:00:00 PM,48,-122,1,0,1
6862,ElliotBayTrailMyrtlePark,10/13/2014 10:00:00 PM,48,-122,1,3,4
6863,ElliotBayTrailMyrtlePark,10/13/2014 11:00:00 PM,48,-122,2,0,2
6864,ElliotBayTrailMyrtlePark,10/14/2014 12:00:00 AM,48,-122,2,1,3
6865,ElliotBayTrailMyrtlePark,10/14/2014 01:00:00 AM,48,-122,0,0,0
6866,ElliotBayTrailMyrtlePark,10/14/2014 02:00:00 AM,48,-122,1,0,1
6867,ElliotBayTrailMyrtlePark,10/14/2014 03:00:00 AM,48,-122,0,0,0
6868,ElliotBayTrailMyrtlePark,10/14/2014 04:00:00 AM,48,-122,0,1,1
6869,ElliotBayTrailMyrtlePark,10/14/2014 05:00:00 AM,48,-122,6,12,18
6870,ElliotBayTrailMyrtlePark,10/14/2014 06:00:00 AM,48,-122,22,28,50
6871,ElliotBayTrailMyrtlePark,10/14/2014 07:00:00 AM,48,-122,30,73,103
6872,ElliotBayTrailMyrtlePark,10/14/2014 08:00:00 AM,48,-122,34,112,146
6873,ElliotBayTrailMyrtlePark,10/14/2014 09:00:00 AM,48,-122,25,57,82
6874,ElliotBayTrailMyrtlePark,10/14/2014 10:00:00 AM,48,-122,8,23,31
6875,ElliotBayTrailMyrtlePark,10/14/2014 11:00:00 AM,48,-122,9,13,22
6876,ElliotBayTrailMyrtlePark,10/14/2014 12:00:00 PM,48,-122,13,12,25
6877,ElliotBayTrailMyrtlePark,10/14/2014 01:00:00 PM,48,-122,17,11,28
6878,ElliotBayTrailMyrtlePark,10/14/2014 02:00:00 PM,48,-122,14,23,37
6879,ElliotBayTrailMyrtlePark,10/14/2014 03:00:00 PM,48,-122,19,18,37
6880,ElliotBayTrailMyrtlePark,10/14/2014 04:00:00 PM,48,-122,64,29,93
6881,ElliotBayTrailMyrtlePark,10/14/2014 05:00:00 PM,48,-122,148,42,190
6882,ElliotBayTrailMyrtlePark,10/14/2014 06:00:00 PM,48,-122,118,38,156
6883,ElliotBayTrailMyrtlePark,10/14/2014 07:00:00 PM,48,-122,24,14,38
6884,ElliotBayTrailMyrtlePark,10/14/2014 08:00:00 PM,48,-122,8,9,17
6885,ElliotBayTrailMyrtlePark,10/14/2014 09:00:00 PM,48,-122,3,2,5
6886,ElliotBayTrailMyrtlePark,10/14/2014 10:00:00 PM,48,-122,2,5,7
6887,ElliotBayTrailMyrtlePark,10/14/2014 11:00:00 PM,48,-122,2,1,3
6888,ElliotBayTrailMyrtlePark,10/15/2014 12:00:00 AM,48,-122,1,2,3
6889,ElliotBayTrailMyrtlePark,10/15/2014 01:00:00 AM,48,-122,0,0,0
6890,ElliotBayTrailMyrtlePark,10/15/2014 02:00:00 AM,48,-122,2,0,2
6891,ElliotBayTrailMyrtlePark,10/15/2014 03:00:00 AM,48,-122,0,0,0
6892,ElliotBayTrailMyrtlePark,10/15/2014 04:00:00 AM,48,-122,0,0,0
6893,ElliotBayTrailMyrtlePark,10/15/2014 05:00:00 AM,48,-122,7,11,18
6894,ElliotBayTrailMyrtlePark,10/15/2014 06:00:00 AM,48,-122,16,28,44
6895,ElliotBayTrailMyrtlePark,10/15/2014 07:00:00 AM,48,-122,33,69,102
6896,ElliotBayTrailMyrtlePark,10/15/2014 08:00:00 AM,48,-122,21,90,111
6897,ElliotBayTrailMyrtlePark,10/15/2014 09:00:00 AM,48,-122,13,39,52
6898,ElliotBayTrailMyrtlePark,10/15/2014 10:00:00 AM,48,-122,8,21,29
6899,ElliotBayTrailMyrtlePark,10/15/2014 11:00:00 AM,48,-122,4,5,9
6900,ElliotBayTrailMyrtlePark,10/15/2014 12:00:00 PM,48,-122,4,4,8
6901,ElliotBayTrailMyrtlePark,10/15/2014 01:00:00 PM,48,-122,6,4,10
6902,ElliotBayTrailMyrtlePark,10/15/2014 02:00:00 PM,48,-122,9,15,24
6903,ElliotBayTrailMyrtlePark,10/15/2014 03:00:00 PM,48,-122,18,14,32
6904,ElliotBayTrailMyrtlePark,10/15/2014 04:00:00 PM,48,-122,57,39,96
6905,ElliotBayTrailMyrtlePark,10/15/2014 05:00:00 PM,48,-122,117,31,148
6906,ElliotBayTrailMyrtlePark,10/15/2014 06:00:00 PM,48,-122,86,38,124
6907,ElliotBayTrailMyrtlePark,10/15/2014 07:00:00 PM,48,-122,30,22,52
6908,ElliotBayTrailMyrtlePark,10/15/2014 08:00:00 PM,48,-122,7,7,14
6909,ElliotBayTrailMyrtlePark,10/15/2014 09:00:00 PM,48,-122,6,5,11
6910,ElliotBayTrailMyrtlePark,10/15/2014 10:00:00 PM,48,-122,7,1,8
6911,ElliotBayTrailMyrtlePark,10/15/2014 11:00:00 PM,48,-122,2,3,5
6912,ElliotBayTrailMyrtlePark,10/16/2014 12:00:00 AM,48,-122,2,1,3
6913,ElliotBayTrailMyrtlePark,10/16/2014 01:00:00 AM,48,-122,0,0,0
6914,ElliotBayTrailMyrtlePark,10/16/2014 02:00:00 AM,48,-122,3,0,3
6915,ElliotBayTrailMyrtlePark,10/16/2014 03:00:00 AM,48,-122,0,0,0
6916,ElliotBayTrailMyrtlePark,10/16/2014 04:00:00 AM,48,-122,1,0,1
6917,ElliotBayTrailMyrtlePark,10/16/2014 05:00:00 AM,48,-122,11,14,25
6918,ElliotBayTrailMyrtlePark,10/16/2014 06:00:00 AM,48,-122,17,29,46
6919,ElliotBayTrailMyrtlePark,10/16/2014 07:00:00 AM,48,-122,42,71,113
6920,ElliotBayTrailMyrtlePark,10/16/2014 08:00:00 AM,48,-122,36,138,174
6921,ElliotBayTrailMyrtlePark,10/16/2014 09:00:00 AM,48,-122,23,65,88
6922,ElliotBayTrailMyrtlePark,10/16/2014 10:00:00 AM,48,-122,8,22,30
6923,ElliotBayTrailMyrtlePark,10/16/2014 11:00:00 AM,48,-122,22,15,37
6924,ElliotBayTrailMyrtlePark,10/16/2014 12:00:00 PM,48,-122,14,24,38
6925,ElliotBayTrailMyrtlePark,10/16/2014 01:00:00 PM,48,-122,21,14,35
6926,ElliotBayTrailMyrtlePark,10/16/2014 02:00:00 PM,48,-122,26,24,50
6927,ElliotBayTrailMyrtlePark,10/16/2014 03:00:00 PM,48,-122,38,48,86
6928,ElliotBayTrailMyrtlePark,10/16/2014 04:00:00 PM,48,-122,91,61,152
6929,ElliotBayTrailMyrtlePark,10/16/2014 05:00:00 PM,48,-122,181,58,239
6930,ElliotBayTrailMyrtlePark,10/16/2014 06:00:00 PM,48,-122,101,36,137
6931,ElliotBayTrailMyrtlePark,10/16/2014 07:00:00 PM,48,-122,31,19,50
6932,ElliotBayTrailMyrtlePark,10/16/2014 08:00:00 PM,48,-122,17,3,20
6933,ElliotBayTrailMyrtlePark,10/16/2014 09:00:00 PM,48,-122,10,5,15
6934,ElliotBayTrailMyrtlePark,10/16/2014 10:00:00 PM,48,-122,5,1,6
6935,ElliotBayTrailMyrtlePark,10/16/2014 11:00:00 PM,48,-122,2,0,2
6936,ElliotBayTrailMyrtlePark,10/17/2014 12:00:00 AM,48,-122,1,2,3
6937,ElliotBayTrailMyrtlePark,10/17/2014 01:00:00 AM,48,-122,4,3,7
6938,ElliotBayTrailMyrtlePark,10/17/2014 02:00:00 AM,48,-122,3,0,3
6939,ElliotBayTrailMyrtlePark,10/17/2014 03:00:00 AM,48,-122,0,0,0
6940,ElliotBayTrailMyrtlePark,10/17/2014 04:00:00 AM,48,-122,0,0,0
6941,ElliotBayTrailMyrtlePark,10/17/2014 05:00:00 AM,48,-122,4,12,16
6942,ElliotBayTrailMyrtlePark,10/17/2014 06:00:00 AM,48,-122,20,19,39
6943,ElliotBayTrailMyrtlePark,10/17/2014 07:00:00 AM,48,-122,24,62,86
6944,ElliotBayTrailMyrtlePark,10/17/2014 08:00:00 AM,48,-122,21,84,105
6945,ElliotBayTrailMyrtlePark,10/17/2014 09:00:00 AM,48,-122,16,46,62
6946,ElliotBayTrailMyrtlePark,10/17/2014 10:00:00 AM,48,-122,9,16,25
6947,ElliotBayTrailMyrtlePark,10/17/2014 11:00:00 AM,48,-122,6,3,9
6948,ElliotBayTrailMyrtlePark,10/17/2014 12:00:00 PM,48,-122,2,5,7
6949,ElliotBayTrailMyrtlePark,10/17/2014 01:00:00 PM,48,-122,6,1,7
6950,ElliotBayTrailMyrtlePark,10/17/2014 02:00:00 PM,48,-122,12,15,27
6951,ElliotBayTrailMyrtlePark,10/17/2014 03:00:00 PM,48,-122,20,14,34
6952,ElliotBayTrailMyrtlePark,10/17/2014 04:00:00 PM,48,-122,52,28,80
6953,ElliotBayTrailMyrtlePark,10/17/2014 05:00:00 PM,48,-122,94,26,120
6954,ElliotBayTrailMyrtlePark,10/17/2014 06:00:00 PM,48,-122,57,7,64
6955,ElliotBayTrailMyrtlePark,10/17/2014 07:00:00 PM,48,-122,17,4,21
6956,ElliotBayTrailMyrtlePark,10/17/2014 08:00:00 PM,48,-122,7,2,9
6957,ElliotBayTrailMyrtlePark,10/17/2014 09:00:00 PM,48,-122,2,2,4
6958,ElliotBayTrailMyrtlePark,10/17/2014 10:00:00 PM,48,-122,4,3,7
6959,ElliotBayTrailMyrtlePark,10/17/2014 11:00:00 PM,48,-122,3,1,4
6960,ElliotBayTrailMyrtlePark,10/18/2014 12:00:00 AM,48,-122,1,1,2
6961,ElliotBayTrailMyrtlePark,10/18/2014 01:00:00 AM,48,-122,1,0,1
6962,ElliotBayTrailMyrtlePark,10/18/2014 02:00:00 AM,48,-122,1,0,1
6963,ElliotBayTrailMyrtlePark,10/18/2014 03:00:00 AM,48,-122,0,0,0
6964,ElliotBayTrailMyrtlePark,10/18/2014 04:00:00 AM,48,-122,3,0,3
6965,ElliotBayTrailMyrtlePark,10/18/2014 05:00:00 AM,48,-122,0,1,1
6966,ElliotBayTrailMyrtlePark,10/18/2014 06:00:00 AM,48,-122,2,7,9
6967,ElliotBayTrailMyrtlePark,10/18/2014 07:00:00 AM,48,-122,9,4,13
6968,ElliotBayTrailMyrtlePark,10/18/2014 08:00:00 AM,48,-122,9,15,24
6969,ElliotBayTrailMyrtlePark,10/18/2014 09:00:00 AM,48,-122,11,15,26
6970,ElliotBayTrailMyrtlePark,10/18/2014 10:00:00 AM,48,-122,12,10,22
6971,ElliotBayTrailMyrtlePark,10/18/2014 11:00:00 AM,48,-122,13,23,36
6972,ElliotBayTrailMyrtlePark,10/18/2014 12:00:00 PM,48,-122,14,9,23
6973,ElliotBayTrailMyrtlePark,10/18/2014 01:00:00 PM,48,-122,29,27,56
6974,ElliotBayTrailMyrtlePark,10/18/2014 02:00:00 PM,48,-122,22,28,50
6975,ElliotBayTrailMyrtlePark,10/18/2014 03:00:00 PM,48,-122,21,25,46
6976,ElliotBayTrailMyrtlePark,10/18/2014 04:00:00 PM,48,-122,39,18,57
6977,ElliotBayTrailMyrtlePark,10/18/2014 05:00:00 PM,48,-122,27,36,63
6978,ElliotBayTrailMyrtlePark,10/18/2014 06:00:00 PM,48,-122,29,20,49
6979,ElliotBayTrailMyrtlePark,10/18/2014 07:00:00 PM,48,-122,8,15,23
6980,ElliotBayTrailMyrtlePark,10/18/2014 08:00:00 PM,48,-122,12,6,18
6981,ElliotBayTrailMyrtlePark,10/18/2014 09:00:00 PM,48,-122,6,2,8
6982,ElliotBayTrailMyrtlePark,10/18/2014 10:00:00 PM,48,-122,5,1,6
6983,ElliotBayTrailMyrtlePark,10/18/2014 11:00:00 PM,48,-122,1,2,3
6984,ElliotBayTrailMyrtlePark,10/19/2014 12:00:00 AM,48,-122,3,0,3
6985,ElliotBayTrailMyrtlePark,10/19/2014 01:00:00 AM,48,-122,0,0,0
6986,ElliotBayTrailMyrtlePark,10/19/2014 02:00:00 AM,48,-122,3,3,6
6987,ElliotBayTrailMyrtlePark,10/19/2014 03:00:00 AM,48,-122,1,1,2
6988,ElliotBayTrailMyrtlePark,10/19/2014 04:00:00 AM,48,-122,0,2,2
6989,ElliotBayTrailMyrtlePark,10/19/2014 05:00:00 AM,48,-122,0,1,1
6990,ElliotBayTrailMyrtlePark,10/19/2014 06:00:00 AM,48,-122,3,0,3
6991,ElliotBayTrailMyrtlePark,10/19/2014 07:00:00 AM,48,-122,1,5,6
6992,ElliotBayTrailMyrtlePark,10/19/2014 08:00:00 AM,48,-122,21,12,33
6993,ElliotBayTrailMyrtlePark,10/19/2014 09:00:00 AM,48,-122,34,39,73
6994,ElliotBayTrailMyrtlePark,10/19/2014 10:00:00 AM,48,-122,34,32,66
6995,ElliotBayTrailMyrtlePark,10/19/2014 11:00:00 AM,48,-122,50,38,88
6996,ElliotBayTrailMyrtlePark,10/19/2014 12:00:00 PM,48,-122,75,46,121
6997,ElliotBayTrailMyrtlePark,10/19/2014 01:00:00 PM,48,-122,81,69,150
6998,ElliotBayTrailMyrtlePark,10/19/2014 02:00:00 PM,48,-122,107,95,202
6999,ElliotBayTrailMyrtlePark,10/19/2014 03:00:00 PM,48,-122,115,96,211
7000,ElliotBayTrailMyrtlePark,10/19/2014 04:00:00 PM,48,-122,79,83,162
7001,ElliotBayTrailMyrtlePark,10/19/2014 05:00:00 PM,48,-122,59,67,126
7002,ElliotBayTrailMyrtlePark,10/19/2014 06:00:00 PM,48,-122,25,38,63
7003,ElliotBayTrailMyrtlePark,10/19/2014 07:00:00 PM,48,-122,4,9,13
7004,ElliotBayTrailMyrtlePark,10/19/2014 08:00:00 PM,48,-122,5,5,10
7005,ElliotBayTrailMyrtlePark,10/19/2014 09:00:00 PM,48,-122,2,1,3
7006,ElliotBayTrailMyrtlePark,10/19/2014 10:00:00 PM,48,-122,5,4,9
7007,ElliotBayTrailMyrtlePark,10/19/2014 11:00:00 PM,48,-122,2,5,7
7008,ElliotBayTrailMyrtlePark,10/20/2014 12:00:00 AM,48,-122,5,2,7
7009,ElliotBayTrailMyrtlePark,10/20/2014 01:00:00 AM,48,-122,2,0,2
7010,ElliotBayTrailMyrtlePark,10/20/2014 02:00:00 AM,48,-122,0,0,0
7011,ElliotBayTrailMyrtlePark,10/20/2014 03:00:00 AM,48,-122,0,0,0
7012,ElliotBayTrailMyrtlePark,10/20/2014 04:00:00 AM,48,-122,0,1,1
7013,ElliotBayTrailMyrtlePark,10/20/2014 05:00:00 AM,48,-122,5,10,15
7014,ElliotBayTrailMyrtlePark,10/20/2014 06:00:00 AM,48,-122,19,27,46
7015,ElliotBayTrailMyrtlePark,10/20/2014 07:00:00 AM,48,-122,29,56,85
7016,ElliotBayTrailMyrtlePark,10/20/2014 08:00:00 AM,48,-122,22,113,135
7017,ElliotBayTrailMyrtlePark,10/20/2014 09:00:00 AM,48,-122,21,68,89
7018,ElliotBayTrailMyrtlePark,10/20/2014 10:00:00 AM,48,-122,12,22,34
7019,ElliotBayTrailMyrtlePark,10/20/2014 11:00:00 AM,48,-122,10,13,23
7020,ElliotBayTrailMyrtlePark,10/20/2014 12:00:00 PM,48,-122,15,23,38
7021,ElliotBayTrailMyrtlePark,10/20/2014 01:00:00 PM,48,-122,10,16,26
7022,ElliotBayTrailMyrtlePark,10/20/2014 02:00:00 PM,48,-122,12,17,29
7023,ElliotBayTrailMyrtlePark,10/20/2014 03:00:00 PM,48,-122,18,24,42
7024,ElliotBayTrailMyrtlePark,10/20/2014 04:00:00 PM,48,-122,48,42,90
7025,ElliotBayTrailMyrtlePark,10/20/2014 05:00:00 PM,48,-122,145,47,192
7026,ElliotBayTrailMyrtlePark,10/20/2014 06:00:00 PM,48,-122,95,40,135
7027,ElliotBayTrailMyrtlePark,10/20/2014 07:00:00 PM,48,-122,25,13,38
7028,ElliotBayTrailMyrtlePark,10/20/2014 08:00:00 PM,48,-122,11,3,14
7029,ElliotBayTrailMyrtlePark,10/20/2014 09:00:00 PM,48,-122,4,2,6
7030,ElliotBayTrailMyrtlePark,10/20/2014 10:00:00 PM,48,-122,2,2,4
7031,ElliotBayTrailMyrtlePark,10/20/2014 11:00:00 PM,48,-122,3,6,9
7032,ElliotBayTrailMyrtlePark,10/21/2014 12:00:00 AM,48,-122,1,3,4
7033,ElliotBayTrailMyrtlePark,10/21/2014 01:00:00 AM,48,-122,1,0,1
7034,ElliotBayTrailMyrtlePark,10/21/2014 02:00:00 AM,48,-122,0,0,0
7035,ElliotBayTrailMyrtlePark,10/21/2014 03:00:00 AM,48,-122,0,1,1
7036,ElliotBayTrailMyrtlePark,10/21/2014 04:00:00 AM,48,-122,0,1,1
7037,ElliotBayTrailMyrtlePark,10/21/2014 05:00:00 AM,48,-122,3,10,13
7038,ElliotBayTrailMyrtlePark,10/21/2014 06:00:00 AM,48,-122,20,35,55
7039,ElliotBayTrailMyrtlePark,10/21/2014 07:00:00 AM,48,-122,29,65,94
7040,ElliotBayTrailMyrtlePark,10/21/2014 08:00:00 AM,48,-122,33,117,150
7041,ElliotBayTrailMyrtlePark,10/21/2014 09:00:00 AM,48,-122,11,70,81
7042,ElliotBayTrailMyrtlePark,10/21/2014 10:00:00 AM,48,-122,12,20,32
7043,ElliotBayTrailMyrtlePark,10/21/2014 11:00:00 AM,48,-122,14,12,26
7044,ElliotBayTrailMyrtlePark,10/21/2014 12:00:00 PM,48,-122,17,16,33
7045,ElliotBayTrailMyrtlePark,10/21/2014 01:00:00 PM,48,-122,12,13,25
7046,ElliotBayTrailMyrtlePark,10/21/2014 02:00:00 PM,48,-122,17,12,29
7047,ElliotBayTrailMyrtlePark,10/21/2014 03:00:00 PM,48,-122,22,22,44
7048,ElliotBayTrailMyrtlePark,10/21/2014 04:00:00 PM,48,-122,65,31,96
7049,ElliotBayTrailMyrtlePark,10/21/2014 05:00:00 PM,48,-122,154,52,206
7050,ElliotBayTrailMyrtlePark,10/21/2014 06:00:00 PM,48,-122,84,36,120
7051,ElliotBayTrailMyrtlePark,10/21/2014 07:00:00 PM,48,-122,23,12,35
7052,ElliotBayTrailMyrtlePark,10/21/2014 08:00:00 PM,48,-122,12,3,15
7053,ElliotBayTrailMyrtlePark,10/21/2014 09:00:00 PM,48,-122,2,0,2
7054,ElliotBayTrailMyrtlePark,10/21/2014 10:00:00 PM,48,-122,7,0,7
7055,ElliotBayTrailMyrtlePark,10/21/2014 11:00:00 PM,48,-122,2,0,2
7056,ElliotBayTrailMyrtlePark,10/22/2014 12:00:00 AM,48,-122,0,0,0
7057,ElliotBayTrailMyrtlePark,10/22/2014 01:00:00 AM,48,-122,1,0,1
7058,ElliotBayTrailMyrtlePark,10/22/2014 02:00:00 AM,48,-122,0,0,0
7059,ElliotBayTrailMyrtlePark,10/22/2014 03:00:00 AM,48,-122,0,1,1
7060,ElliotBayTrailMyrtlePark,10/22/2014 04:00:00 AM,48,-122,0,0,0
7061,ElliotBayTrailMyrtlePark,10/22/2014 05:00:00 AM,48,-122,5,9,14
7062,ElliotBayTrailMyrtlePark,10/22/2014 06:00:00 AM,48,-122,16,14,30
7063,ElliotBayTrailMyrtlePark,10/22/2014 07:00:00 AM,48,-122,19,41,60
7064,ElliotBayTrailMyrtlePark,10/22/2014 08:00:00 AM,48,-122,36,89,125
7065,ElliotBayTrailMyrtlePark,10/22/2014 09:00:00 AM,48,-122,11,40,51
7066,ElliotBayTrailMyrtlePark,10/22/2014 10:00:00 AM,48,-122,6,17,23
7067,ElliotBayTrailMyrtlePark,10/22/2014 11:00:00 AM,48,-122,2,11,13
7068,ElliotBayTrailMyrtlePark,10/22/2014 12:00:00 PM,48,-122,2,6,8
7069,ElliotBayTrailMyrtlePark,10/22/2014 01:00:00 PM,48,-122,5,1,6
7070,ElliotBayTrailMyrtlePark,10/22/2014 02:00:00 PM,48,-122,11,10,21
7071,ElliotBayTrailMyrtlePark,10/22/2014 03:00:00 PM,48,-122,10,18,28
7072,ElliotBayTrailMyrtlePark,10/22/2014 04:00:00 PM,48,-122,24,23,47
7073,ElliotBayTrailMyrtlePark,10/22/2014 05:00:00 PM,48,-122,95,29,124
7074,ElliotBayTrailMyrtlePark,10/22/2014 06:00:00 PM,48,-122,58,16,74
7075,ElliotBayTrailMyrtlePark,10/22/2014 07:00:00 PM,48,-122,23,5,28
7076,ElliotBayTrailMyrtlePark,10/22/2014 08:00:00 PM,48,-122,3,2,5
7077,ElliotBayTrailMyrtlePark,10/22/2014 09:00:00 PM,48,-122,2,1,3
7078,ElliotBayTrailMyrtlePark,10/22/2014 10:00:00 PM,48,-122,5,0,5
7079,ElliotBayTrailMyrtlePark,10/22/2014 11:00:00 PM,48,-122,1,0,1
7080,ElliotBayTrailMyrtlePark,10/23/2014 12:00:00 AM,48,-122,2,1,3
7081,ElliotBayTrailMyrtlePark,10/23/2014 01:00:00 AM,48,-122,3,0,3
7082,ElliotBayTrailMyrtlePark,10/23/2014 02:00:00 AM,48,-122,1,0,1
7083,ElliotBayTrailMyrtlePark,10/23/2014 03:00:00 AM,48,-122,0,0,0
7084,ElliotBayTrailMyrtlePark,10/23/2014 04:00:00 AM,48,-122,0,0,0
7085,ElliotBayTrailMyrtlePark,10/23/2014 05:00:00 AM,48,-122,5,11,16
7086,ElliotBayTrailMyrtlePark,10/23/2014 06:00:00 AM,48,-122,7,17,24
7087,ElliotBayTrailMyrtlePark,10/23/2014 07:00:00 AM,48,-122,25,43,68
7088,ElliotBayTrailMyrtlePark,10/23/2014 08:00:00 AM,48,-122,23,87,110
7089,ElliotBayTrailMyrtlePark,10/23/2014 09:00:00 AM,48,-122,10,47,57
7090,ElliotBayTrailMyrtlePark,10/23/2014 10:00:00 AM,48,-122,3,11,14
7091,ElliotBayTrailMyrtlePark,10/23/2014 11:00:00 AM,48,-122,4,4,8
7092,ElliotBayTrailMyrtlePark,10/23/2014 12:00:00 PM,48,-122,18,11,29
7093,ElliotBayTrailMyrtlePark,10/23/2014 01:00:00 PM,48,-122,12,12,24
7094,ElliotBayTrailMyrtlePark,10/23/2014 02:00:00 PM,48,-122,7,15,22
7095,ElliotBayTrailMyrtlePark,10/23/2014 03:00:00 PM,48,-122,18,16,34
7096,ElliotBayTrailMyrtlePark,10/23/2014 04:00:00 PM,48,-122,44,18,62
7097,ElliotBayTrailMyrtlePark,10/23/2014 05:00:00 PM,48,-122,112,32,144
7098,ElliotBayTrailMyrtlePark,10/23/2014 06:00:00 PM,48,-122,62,26,88
7099,ElliotBayTrailMyrtlePark,10/23/2014 07:00:00 PM,48,-122,22,7,29
7100,ElliotBayTrailMyrtlePark,10/23/2014 08:00:00 PM,48,-122,4,7,11
7101,ElliotBayTrailMyrtlePark,10/23/2014 09:00:00 PM,48,-122,1,1,2
7102,ElliotBayTrailMyrtlePark,10/23/2014 10:00:00 PM,48,-122,3,2,5
7103,ElliotBayTrailMyrtlePark,10/23/2014 11:00:00 PM,48,-122,1,1,2
7104,ElliotBayTrailMyrtlePark,10/24/2014 12:00:00 AM,48,-122,1,3,4
7105,ElliotBayTrailMyrtlePark,10/24/2014 01:00:00 AM,48,-122,3,0,3
7106,ElliotBayTrailMyrtlePark,10/24/2014 02:00:00 AM,48,-122,2,0,2
7107,ElliotBayTrailMyrtlePark,10/24/2014 03:00:00 AM,48,-122,0,0,0
7108,ElliotBayTrailMyrtlePark,10/24/2014 04:00:00 AM,48,-122,0,0,0
7109,ElliotBayTrailMyrtlePark,10/24/2014 05:00:00 AM,48,-122,6,12,18
7110,ElliotBayTrailMyrtlePark,10/24/2014 06:00:00 AM,48,-122,13,26,39
7111,ElliotBayTrailMyrtlePark,10/24/2014 07:00:00 AM,48,-122,35,53,88
7112,ElliotBayTrailMyrtlePark,10/24/2014 08:00:00 AM,48,-122,32,101,133
7113,ElliotBayTrailMyrtlePark,10/24/2014 09:00:00 AM,48,-122,19,67,86
7114,ElliotBayTrailMyrtlePark,10/24/2014 10:00:00 AM,48,-122,15,18,33
7115,ElliotBayTrailMyrtlePark,10/24/2014 11:00:00 AM,48,-122,13,15,28
7116,ElliotBayTrailMyrtlePark,10/24/2014 12:00:00 PM,48,-122,20,12,32
7117,ElliotBayTrailMyrtlePark,10/24/2014 01:00:00 PM,48,-122,11,15,26
7118,ElliotBayTrailMyrtlePark,10/24/2014 02:00:00 PM,48,-122,15,20,35
7119,ElliotBayTrailMyrtlePark,10/24/2014 03:00:00 PM,48,-122,35,33,68
7120,ElliotBayTrailMyrtlePark,10/24/2014 04:00:00 PM,48,-122,84,36,120
7121,ElliotBayTrailMyrtlePark,10/24/2014 05:00:00 PM,48,-122,129,35,164
7122,ElliotBayTrailMyrtlePark,10/24/2014 06:00:00 PM,48,-122,60,14,74
7123,ElliotBayTrailMyrtlePark,10/24/2014 07:00:00 PM,48,-122,19,5,24
7124,ElliotBayTrailMyrtlePark,10/24/2014 08:00:00 PM,48,-122,6,5,11
7125,ElliotBayTrailMyrtlePark,10/24/2014 09:00:00 PM,48,-122,3,1,4
7126,ElliotBayTrailMyrtlePark,10/24/2014 10:00:00 PM,48,-122,6,0,6
7127,ElliotBayTrailMyrtlePark,10/24/2014 11:00:00 PM,48,-122,3,0,3
7128,ElliotBayTrailMyrtlePark,10/25/2014 12:00:00 AM,48,-122,1,3,4
7129,ElliotBayTrailMyrtlePark,10/25/2014 01:00:00 AM,48,-122,1,0,1
7130,ElliotBayTrailMyrtlePark,10/25/2014 02:00:00 AM,48,-122,1,0,1
7131,ElliotBayTrailMyrtlePark,10/25/2014 03:00:00 AM,48,-122,0,0,0
7132,ElliotBayTrailMyrtlePark,10/25/2014 04:00:00 AM,48,-122,0,0,0
7133,ElliotBayTrailMyrtlePark,10/25/2014 05:00:00 AM,48,-122,0,0,0
7134,ElliotBayTrailMyrtlePark,10/25/2014 06:00:00 AM,48,-122,1,2,3
7135,ElliotBayTrailMyrtlePark,10/25/2014 07:00:00 AM,48,-122,2,6,8
7136,ElliotBayTrailMyrtlePark,10/25/2014 08:00:00 AM,48,-122,8,8,16
7137,ElliotBayTrailMyrtlePark,10/25/2014 09:00:00 AM,48,-122,4,11,15
7138,ElliotBayTrailMyrtlePark,10/25/2014 10:00:00 AM,48,-122,11,12,23
7139,ElliotBayTrailMyrtlePark,10/25/2014 11:00:00 AM,48,-122,13,35,48
7140,ElliotBayTrailMyrtlePark,10/25/2014 12:00:00 PM,48,-122,15,21,36
7141,ElliotBayTrailMyrtlePark,10/25/2014 01:00:00 PM,48,-122,16,12,28
7142,ElliotBayTrailMyrtlePark,10/25/2014 02:00:00 PM,48,-122,21,7,28
7143,ElliotBayTrailMyrtlePark,10/25/2014 03:00:00 PM,48,-122,11,7,18
7144,ElliotBayTrailMyrtlePark,10/25/2014 04:00:00 PM,48,-122,13,7,20
7145,ElliotBayTrailMyrtlePark,10/25/2014 05:00:00 PM,48,-122,9,4,13
7146,ElliotBayTrailMyrtlePark,10/25/2014 06:00:00 PM,48,-122,7,1,8
7147,ElliotBayTrailMyrtlePark,10/25/2014 07:00:00 PM,48,-122,2,0,2
7148,ElliotBayTrailMyrtlePark,10/25/2014 08:00:00 PM,48,-122,2,2,4
7149,ElliotBayTrailMyrtlePark,10/25/2014 09:00:00 PM,48,-122,0,0,0
7150,ElliotBayTrailMyrtlePark,10/25/2014 10:00:00 PM,48,-122,0,0,0
7151,ElliotBayTrailMyrtlePark,10/25/2014 11:00:00 PM,48,-122,2,0,2
7152,ElliotBayTrailMyrtlePark,10/26/2014 12:00:00 AM,48,-122,3,0,3
7153,ElliotBayTrailMyrtlePark,10/26/2014 01:00:00 AM,48,-122,0,0,0
7154,ElliotBayTrailMyrtlePark,10/26/2014 02:00:00 AM,48,-122,1,0,1
7155,ElliotBayTrailMyrtlePark,10/26/2014 03:00:00 AM,48,-122,0,0,0
7156,ElliotBayTrailMyrtlePark,10/26/2014 04:00:00 AM,48,-122,0,0,0
7157,ElliotBayTrailMyrtlePark,10/26/2014 05:00:00 AM,48,-122,0,3,3
7158,ElliotBayTrailMyrtlePark,10/26/2014 06:00:00 AM,48,-122,1,0,1
7159,ElliotBayTrailMyrtlePark,10/26/2014 07:00:00 AM,48,-122,3,2,5
7160,ElliotBayTrailMyrtlePark,10/26/2014 08:00:00 AM,48,-122,3,12,15
7161,ElliotBayTrailMyrtlePark,10/26/2014 09:00:00 AM,48,-122,9,10,19
7162,ElliotBayTrailMyrtlePark,10/26/2014 10:00:00 AM,48,-122,9,25,34
7163,ElliotBayTrailMyrtlePark,10/26/2014 11:00:00 AM,48,-122,12,14,26
7164,ElliotBayTrailMyrtlePark,10/26/2014 12:00:00 PM,48,-122,21,6,27
7165,ElliotBayTrailMyrtlePark,10/26/2014 01:00:00 PM,48,-122,13,9,22
7166,ElliotBayTrailMyrtlePark,10/26/2014 02:00:00 PM,48,-122,12,7,19
7167,ElliotBayTrailMyrtlePark,10/26/2014 03:00:00 PM,48,-122,20,17,37
7168,ElliotBayTrailMyrtlePark,10/26/2014 04:00:00 PM,48,-122,18,22,40
7169,ElliotBayTrailMyrtlePark,10/26/2014 05:00:00 PM,48,-122,32,31,63
7170,ElliotBayTrailMyrtlePark,10/26/2014 06:00:00 PM,48,-122,14,12,26
7171,ElliotBayTrailMyrtlePark,10/26/2014 07:00:00 PM,48,-122,5,4,9
7172,ElliotBayTrailMyrtlePark,10/26/2014 08:00:00 PM,48,-122,3,5,8
7173,ElliotBayTrailMyrtlePark,10/26/2014 09:00:00 PM,48,-122,5,3,8
7174,ElliotBayTrailMyrtlePark,10/26/2014 10:00:00 PM,48,-122,4,2,6
7175,ElliotBayTrailMyrtlePark,10/26/2014 11:00:00 PM,48,-122,0,2,2
7176,ElliotBayTrailMyrtlePark,10/27/2014 12:00:00 AM,48,-122,1,0,1
7177,ElliotBayTrailMyrtlePark,10/27/2014 01:00:00 AM,48,-122,1,0,1
7178,ElliotBayTrailMyrtlePark,10/27/2014 02:00:00 AM,48,-122,1,0,1
7179,ElliotBayTrailMyrtlePark,10/27/2014 03:00:00 AM,48,-122,0,1,1
7180,ElliotBayTrailMyrtlePark,10/27/2014 04:00:00 AM,48,-122,0,1,1
7181,ElliotBayTrailMyrtlePark,10/27/2014 05:00:00 AM,48,-122,5,10,15
7182,ElliotBayTrailMyrtlePark,10/27/2014 06:00:00 AM,48,-122,19,24,43
7183,ElliotBayTrailMyrtlePark,10/27/2014 07:00:00 AM,48,-122,30,63,93
7184,ElliotBayTrailMyrtlePark,10/27/2014 08:00:00 AM,48,-122,44,125,169
7185,ElliotBayTrailMyrtlePark,10/27/2014 09:00:00 AM,48,-122,19,78,97
7186,ElliotBayTrailMyrtlePark,10/27/2014 10:00:00 AM,48,-122,14,21,35
7187,ElliotBayTrailMyrtlePark,10/27/2014 11:00:00 AM,48,-122,13,14,27
7188,ElliotBayTrailMyrtlePark,10/27/2014 12:00:00 PM,48,-122,15,18,33
7189,ElliotBayTrailMyrtlePark,10/27/2014 01:00:00 PM,48,-122,26,26,52
7190,ElliotBayTrailMyrtlePark,10/27/2014 02:00:00 PM,48,-122,23,25,48
7191,ElliotBayTrailMyrtlePark,10/27/2014 03:00:00 PM,48,-122,35,39,74
7192,ElliotBayTrailMyrtlePark,10/27/2014 04:00:00 PM,48,-122,65,45,110
7193,ElliotBayTrailMyrtlePark,10/27/2014 05:00:00 PM,48,-122,169,60,229
7194,ElliotBayTrailMyrtlePark,10/27/2014 06:00:00 PM,48,-122,102,24,126
7195,ElliotBayTrailMyrtlePark,10/27/2014 07:00:00 PM,48,-122,29,10,39
7196,ElliotBayTrailMyrtlePark,10/27/2014 08:00:00 PM,48,-122,15,0,15
7197,ElliotBayTrailMyrtlePark,10/27/2014 09:00:00 PM,48,-122,5,0,5
7198,ElliotBayTrailMyrtlePark,10/27/2014 10:00:00 PM,48,-122,2,4,6
7199,ElliotBayTrailMyrtlePark,10/27/2014 11:00:00 PM,48,-122,4,1,5
7200,ElliotBayTrailMyrtlePark,10/28/2014 12:00:00 AM,48,-122,1,0,1
7201,ElliotBayTrailMyrtlePark,10/28/2014 01:00:00 AM,48,-122,1,0,1
7202,ElliotBayTrailMyrtlePark,10/28/2014 02:00:00 AM,48,-122,0,0,0
7203,ElliotBayTrailMyrtlePark,10/28/2014 03:00:00 AM,48,-122,0,0,0
7204,ElliotBayTrailMyrtlePark,10/28/2014 04:00:00 AM,48,-122,0,0,0
7205,ElliotBayTrailMyrtlePark,10/28/2014 05:00:00 AM,48,-122,2,14,16
7206,ElliotBayTrailMyrtlePark,10/28/2014 06:00:00 AM,48,-122,9,27,36
7207,ElliotBayTrailMyrtlePark,10/28/2014 07:00:00 AM,48,-122,24,57,81
7208,ElliotBayTrailMyrtlePark,10/28/2014 08:00:00 AM,48,-122,24,90,114
7209,ElliotBayTrailMyrtlePark,10/28/2014 09:00:00 AM,48,-122,11,47,58
7210,ElliotBayTrailMyrtlePark,10/28/2014 10:00:00 AM,48,-122,8,9,17
7211,ElliotBayTrailMyrtlePark,10/28/2014 11:00:00 AM,48,-122,3,4,7
7212,ElliotBayTrailMyrtlePark,10/28/2014 12:00:00 PM,48,-122,1,6,7
7213,ElliotBayTrailMyrtlePark,10/28/2014 01:00:00 PM,48,-122,5,5,10
7214,ElliotBayTrailMyrtlePark,10/28/2014 02:00:00 PM,48,-122,5,15,20
7215,ElliotBayTrailMyrtlePark,10/28/2014 03:00:00 PM,48,-122,18,16,34
7216,ElliotBayTrailMyrtlePark,10/28/2014 04:00:00 PM,48,-122,45,22,67
7217,ElliotBayTrailMyrtlePark,10/28/2014 05:00:00 PM,48,-122,118,28,146
7218,ElliotBayTrailMyrtlePark,10/28/2014 06:00:00 PM,48,-122,86,19,105
7219,ElliotBayTrailMyrtlePark,10/28/2014 07:00:00 PM,48,-122,24,5,29
7220,ElliotBayTrailMyrtlePark,10/28/2014 08:00:00 PM,48,-122,5,1,6
7221,ElliotBayTrailMyrtlePark,10/28/2014 09:00:00 PM,48,-122,3,3,6
7222,ElliotBayTrailMyrtlePark,10/28/2014 10:00:00 PM,48,-122,4,1,5
7223,ElliotBayTrailMyrtlePark,10/28/2014 11:00:00 PM,48,-122,1,1,2
7224,ElliotBayTrailMyrtlePark,10/29/2014 12:00:00 AM,48,-122,2,0,2
7225,ElliotBayTrailMyrtlePark,10/29/2014 01:00:00 AM,48,-122,1,0,1
7226,ElliotBayTrailMyrtlePark,10/29/2014 02:00:00 AM,48,-122,1,0,1
7227,ElliotBayTrailMyrtlePark,10/29/2014 03:00:00 AM,48,-122,0,1,1
7228,ElliotBayTrailMyrtlePark,10/29/2014 04:00:00 AM,48,-122,0,1,1
7229,ElliotBayTrailMyrtlePark,10/29/2014 05:00:00 AM,48,-122,3,13,16
7230,ElliotBayTrailMyrtlePark,10/29/2014 06:00:00 AM,48,-122,14,31,45
7231,ElliotBayTrailMyrtlePark,10/29/2014 07:00:00 AM,48,-122,38,62,100
7232,ElliotBayTrailMyrtlePark,10/29/2014 08:00:00 AM,48,-122,28,108,136
7233,ElliotBayTrailMyrtlePark,10/29/2014 09:00:00 AM,48,-122,16,76,92
7234,ElliotBayTrailMyrtlePark,10/29/2014 10:00:00 AM,48,-122,13,24,37
7235,ElliotBayTrailMyrtlePark,10/29/2014 11:00:00 AM,48,-122,17,18,35
7236,ElliotBayTrailMyrtlePark,10/29/2014 12:00:00 PM,48,-122,10,15,25
7237,ElliotBayTrailMyrtlePark,10/29/2014 01:00:00 PM,48,-122,37,23,60
7238,ElliotBayTrailMyrtlePark,10/29/2014 02:00:00 PM,48,-122,28,33,61
7239,ElliotBayTrailMyrtlePark,10/29/2014 03:00:00 PM,48,-122,33,32,65
7240,ElliotBayTrailMyrtlePark,10/29/2014 04:00:00 PM,48,-122,81,57,138
7241,ElliotBayTrailMyrtlePark,10/29/2014 05:00:00 PM,48,-122,172,44,216
7242,ElliotBayTrailMyrtlePark,10/29/2014 06:00:00 PM,48,-122,97,45,142
7243,ElliotBayTrailMyrtlePark,10/29/2014 07:00:00 PM,48,-122,32,6,38
7244,ElliotBayTrailMyrtlePark,10/29/2014 08:00:00 PM,48,-122,12,6,18
7245,ElliotBayTrailMyrtlePark,10/29/2014 09:00:00 PM,48,-122,2,1,3
7246,ElliotBayTrailMyrtlePark,10/29/2014 10:00:00 PM,48,-122,2,3,5
7247,ElliotBayTrailMyrtlePark,10/29/2014 11:00:00 PM,48,-122,0,0,0
7248,ElliotBayTrailMyrtlePark,10/30/2014 12:00:00 AM,48,-122,2,1,3
7249,ElliotBayTrailMyrtlePark,10/30/2014 01:00:00 AM,48,-122,0,2,2
7250,ElliotBayTrailMyrtlePark,10/30/2014 02:00:00 AM,48,-122,2,0,2
7251,ElliotBayTrailMyrtlePark,10/30/2014 03:00:00 AM,48,-122,0,1,1
7252,ElliotBayTrailMyrtlePark,10/30/2014 04:00:00 AM,48,-122,0,1,1
7253,ElliotBayTrailMyrtlePark,10/30/2014 05:00:00 AM,48,-122,4,9,13
7254,ElliotBayTrailMyrtlePark,10/30/2014 06:00:00 AM,48,-122,16,25,41
7255,ElliotBayTrailMyrtlePark,10/30/2014 07:00:00 AM,48,-122,30,59,89
7256,ElliotBayTrailMyrtlePark,10/30/2014 08:00:00 AM,48,-122,26,108,134
7257,ElliotBayTrailMyrtlePark,10/30/2014 09:00:00 AM,48,-122,12,62,74
7258,ElliotBayTrailMyrtlePark,10/30/2014 10:00:00 AM,48,-122,7,12,19
7259,ElliotBayTrailMyrtlePark,10/30/2014 11:00:00 AM,48,-122,8,12,20
7260,ElliotBayTrailMyrtlePark,10/30/2014 12:00:00 PM,48,-122,0,7,7
7261,ElliotBayTrailMyrtlePark,10/30/2014 01:00:00 PM,48,-122,8,10,18
7262,ElliotBayTrailMyrtlePark,10/30/2014 02:00:00 PM,48,-122,4,9,13
7263,ElliotBayTrailMyrtlePark,10/30/2014 03:00:00 PM,48,-122,22,16,38
7264,ElliotBayTrailMyrtlePark,10/30/2014 04:00:00 PM,48,-122,40,24,64
7265,ElliotBayTrailMyrtlePark,10/30/2014 05:00:00 PM,48,-122,96,28,124
7266,ElliotBayTrailMyrtlePark,10/30/2014 06:00:00 PM,48,-122,74,17,91
7267,ElliotBayTrailMyrtlePark,10/30/2014 07:00:00 PM,48,-122,25,7,32
7268,ElliotBayTrailMyrtlePark,10/30/2014 08:00:00 PM,48,-122,6,2,8
7269,ElliotBayTrailMyrtlePark,10/30/2014 09:00:00 PM,48,-122,6,0,6
7270,ElliotBayTrailMyrtlePark,10/30/2014 10:00:00 PM,48,-122,2,0,2
7271,ElliotBayTrailMyrtlePark,10/30/2014 11:00:00 PM,48,-122,1,0,1
7272,ElliotBayTrailMyrtlePark,10/31/2014 12:00:00 AM,48,-122,0,0,0
7273,ElliotBayTrailMyrtlePark,10/31/2014 01:00:00 AM,48,-122,1,0,1
7274,ElliotBayTrailMyrtlePark,10/31/2014 02:00:00 AM,48,-122,0,0,0
7275,ElliotBayTrailMyrtlePark,10/31/2014 03:00:00 AM,48,-122,0,1,1
7276,ElliotBayTrailMyrtlePark,10/31/2014 04:00:00 AM,48,-122,0,0,0
7277,ElliotBayTrailMyrtlePark,10/31/2014 05:00:00 AM,48,-122,2,11,13
7278,ElliotBayTrailMyrtlePark,10/31/2014 06:00:00 AM,48,-122,10,10,20
7279,ElliotBayTrailMyrtlePark,10/31/2014 07:00:00 AM,48,-122,23,43,66
7280,ElliotBayTrailMyrtlePark,10/31/2014 08:00:00 AM,48,-122,23,63,86
7281,ElliotBayTrailMyrtlePark,10/31/2014 09:00:00 AM,48,-122,9,43,52
7282,ElliotBayTrailMyrtlePark,10/31/2014 10:00:00 AM,48,-122,5,8,13
7283,ElliotBayTrailMyrtlePark,10/31/2014 11:00:00 AM,48,-122,3,2,5
7284,ElliotBayTrailMyrtlePark,10/31/2014 12:00:00 PM,48,-122,5,11,16
7285,ElliotBayTrailMyrtlePark,10/31/2014 01:00:00 PM,48,-122,4,5,9
7286,ElliotBayTrailMyrtlePark,10/31/2014 02:00:00 PM,48,-122,13,21,34
7287,ElliotBayTrailMyrtlePark,10/31/2014 03:00:00 PM,48,-122,21,11,32
7288,ElliotBayTrailMyrtlePark,10/31/2014 04:00:00 PM,48,-122,60,30,90
7289,ElliotBayTrailMyrtlePark,10/31/2014 05:00:00 PM,48,-122,78,31,109
7290,ElliotBayTrailMyrtlePark,10/31/2014 06:00:00 PM,48,-122,37,11,48
7291,ElliotBayTrailMyrtlePark,10/31/2014 07:00:00 PM,48,-122,10,2,12
7292,ElliotBayTrailMyrtlePark,10/31/2014 08:00:00 PM,48,-122,0,2,2
7293,ElliotBayTrailMyrtlePark,10/31/2014 09:00:00 PM,48,-122,7,0,7
7294,ElliotBayTrailMyrtlePark,10/31/2014 10:00:00 PM,48,-122,5,3,8
7295,ElliotBayTrailMyrtlePark,10/31/2014 11:00:00 PM,48,-122,1,2,3
7296,ElliotBayTrailMyrtlePark,11/01/2014 12:00:00 AM,48,-122,2,3,5
7297,ElliotBayTrailMyrtlePark,11/01/2014 01:00:00 AM,48,-122,1,0,1
7298,ElliotBayTrailMyrtlePark,11/01/2014 02:00:00 AM,48,-122,0,0,0
7299,ElliotBayTrailMyrtlePark,11/01/2014 03:00:00 AM,48,-122,4,0,4
7300,ElliotBayTrailMyrtlePark,11/01/2014 04:00:00 AM,48,-122,0,0,0
7301,ElliotBayTrailMyrtlePark,11/01/2014 05:00:00 AM,48,-122,0,6,6
7302,ElliotBayTrailMyrtlePark,11/01/2014 06:00:00 AM,48,-122,1,4,5
7303,ElliotBayTrailMyrtlePark,11/01/2014 07:00:00 AM,48,-122,3,3,6
7304,ElliotBayTrailMyrtlePark,11/01/2014 08:00:00 AM,48,-122,5,9,14
7305,ElliotBayTrailMyrtlePark,11/01/2014 09:00:00 AM,48,-122,9,14,23
7306,ElliotBayTrailMyrtlePark,11/01/2014 10:00:00 AM,48,-122,21,36,57
7307,ElliotBayTrailMyrtlePark,11/01/2014 11:00:00 AM,48,-122,19,22,41
7308,ElliotBayTrailMyrtlePark,11/01/2014 12:00:00 PM,48,-122,24,13,37
7309,ElliotBayTrailMyrtlePark,11/01/2014 01:00:00 PM,48,-122,23,17,40
7310,ElliotBayTrailMyrtlePark,11/01/2014 02:00:00 PM,48,-122,35,28,63
7311,ElliotBayTrailMyrtlePark,11/01/2014 03:00:00 PM,48,-122,35,24,59
7312,ElliotBayTrailMyrtlePark,11/01/2014 04:00:00 PM,48,-122,34,31,65
7313,ElliotBayTrailMyrtlePark,11/01/2014 05:00:00 PM,48,-122,32,18,50
7314,ElliotBayTrailMyrtlePark,11/01/2014 06:00:00 PM,48,-122,14,20,34
7315,ElliotBayTrailMyrtlePark,11/01/2014 07:00:00 PM,48,-122,4,5,9
7316,ElliotBayTrailMyrtlePark,11/01/2014 08:00:00 PM,48,-122,8,4,12
7317,ElliotBayTrailMyrtlePark,11/01/2014 09:00:00 PM,48,-122,0,1,1
7318,ElliotBayTrailMyrtlePark,11/01/2014 10:00:00 PM,48,-122,2,0,2
7319,ElliotBayTrailMyrtlePark,11/01/2014 11:00:00 PM,48,-122,3,0,3
7320,ElliotBayTrailMyrtlePark,11/02/2014 12:00:00 AM,48,-122,1,1,2
7321,ElliotBayTrailMyrtlePark,11/02/2014 01:00:00 AM,48,-122,0,1,1
7322,ElliotBayTrailMyrtlePark,11/02/2014 02:00:00 AM,48,-122,0,0,0
7323,ElliotBayTrailMyrtlePark,11/02/2014 03:00:00 AM,48,-122,0,0,0
7324,ElliotBayTrailMyrtlePark,11/02/2014 04:00:00 AM,48,-122,0,0,0
7325,ElliotBayTrailMyrtlePark,11/02/2014 05:00:00 AM,48,-122,0,2,2
7326,ElliotBayTrailMyrtlePark,11/02/2014 06:00:00 AM,48,-122,2,2,4
7327,ElliotBayTrailMyrtlePark,11/02/2014 07:00:00 AM,48,-122,3,4,7
7328,ElliotBayTrailMyrtlePark,11/02/2014 08:00:00 AM,48,-122,11,11,22
7329,ElliotBayTrailMyrtlePark,11/02/2014 09:00:00 AM,48,-122,27,22,49
7330,ElliotBayTrailMyrtlePark,11/02/2014 10:00:00 AM,48,-122,27,31,58
7331,ElliotBayTrailMyrtlePark,11/02/2014 11:00:00 AM,48,-122,39,37,76
7332,ElliotBayTrailMyrtlePark,11/02/2014 12:00:00 PM,48,-122,41,59,100
7333,ElliotBayTrailMyrtlePark,11/02/2014 01:00:00 PM,48,-122,31,44,75
7334,ElliotBayTrailMyrtlePark,11/02/2014 02:00:00 PM,48,-122,9,10,19
7335,ElliotBayTrailMyrtlePark,11/02/2014 03:00:00 PM,48,-122,13,10,23
7336,ElliotBayTrailMyrtlePark,11/02/2014 04:00:00 PM,48,-122,9,4,13
7337,ElliotBayTrailMyrtlePark,11/02/2014 05:00:00 PM,48,-122,9,3,12
7338,ElliotBayTrailMyrtlePark,11/02/2014 06:00:00 PM,48,-122,9,1,10
7339,ElliotBayTrailMyrtlePark,11/02/2014 07:00:00 PM,48,-122,1,0,1
7340,ElliotBayTrailMyrtlePark,11/02/2014 08:00:00 PM,48,-122,1,1,2
7341,ElliotBayTrailMyrtlePark,11/02/2014 09:00:00 PM,48,-122,0,0,0
7342,ElliotBayTrailMyrtlePark,11/02/2014 10:00:00 PM,48,-122,0,0,0
7343,ElliotBayTrailMyrtlePark,11/02/2014 11:00:00 PM,48,-122,0,0,0
7344,ElliotBayTrailMyrtlePark,11/03/2014 12:00:00 AM,48,-122,1,0,1
7345,ElliotBayTrailMyrtlePark,11/03/2014 01:00:00 AM,48,-122,0,0,0
7346,ElliotBayTrailMyrtlePark,11/03/2014 02:00:00 AM,48,-122,1,0,1
7347,ElliotBayTrailMyrtlePark,11/03/2014 03:00:00 AM,48,-122,0,0,0
7348,ElliotBayTrailMyrtlePark,11/03/2014 04:00:00 AM,48,-122,0,1,1
7349,ElliotBayTrailMyrtlePark,11/03/2014 05:00:00 AM,48,-122,7,8,15
7350,ElliotBayTrailMyrtlePark,11/03/2014 06:00:00 AM,48,-122,16,23,39
7351,ElliotBayTrailMyrtlePark,11/03/2014 07:00:00 AM,48,-122,33,79,112
7352,ElliotBayTrailMyrtlePark,11/03/2014 08:00:00 AM,48,-122,25,94,119
7353,ElliotBayTrailMyrtlePark,11/03/2014 09:00:00 AM,48,-122,16,47,63
7354,ElliotBayTrailMyrtlePark,11/03/2014 10:00:00 AM,48,-122,7,19,26
7355,ElliotBayTrailMyrtlePark,11/03/2014 11:00:00 AM,48,-122,13,8,21
7356,ElliotBayTrailMyrtlePark,11/03/2014 12:00:00 PM,48,-122,10,6,16
7357,ElliotBayTrailMyrtlePark,11/03/2014 01:00:00 PM,48,-122,11,7,18
7358,ElliotBayTrailMyrtlePark,11/03/2014 02:00:00 PM,48,-122,8,10,18
7359,ElliotBayTrailMyrtlePark,11/03/2014 03:00:00 PM,48,-122,16,9,25
7360,ElliotBayTrailMyrtlePark,11/03/2014 04:00:00 PM,48,-122,59,29,88
7361,ElliotBayTrailMyrtlePark,11/03/2014 05:00:00 PM,48,-122,116,39,155
7362,ElliotBayTrailMyrtlePark,11/03/2014 06:00:00 PM,48,-122,77,14,91
7363,ElliotBayTrailMyrtlePark,11/03/2014 07:00:00 PM,48,-122,21,7,28
7364,ElliotBayTrailMyrtlePark,11/03/2014 08:00:00 PM,48,-122,6,1,7
7365,ElliotBayTrailMyrtlePark,11/03/2014 09:00:00 PM,48,-122,5,4,9
7366,ElliotBayTrailMyrtlePark,11/03/2014 10:00:00 PM,48,-122,2,2,4
7367,ElliotBayTrailMyrtlePark,11/03/2014 11:00:00 PM,48,-122,0,0,0
7368,ElliotBayTrailMyrtlePark,11/04/2014 12:00:00 AM,48,-122,4,1,5
7369,ElliotBayTrailMyrtlePark,11/04/2014 01:00:00 AM,48,-122,1,1,2
7370,ElliotBayTrailMyrtlePark,11/04/2014 02:00:00 AM,48,-122,0,0,0
7371,ElliotBayTrailMyrtlePark,11/04/2014 03:00:00 AM,48,-122,0,0,0
7372,ElliotBayTrailMyrtlePark,11/04/2014 04:00:00 AM,48,-122,0,0,0
7373,ElliotBayTrailMyrtlePark,11/04/2014 05:00:00 AM,48,-122,4,12,16
7374,ElliotBayTrailMyrtlePark,11/04/2014 06:00:00 AM,48,-122,13,18,31
7375,ElliotBayTrailMyrtlePark,11/04/2014 07:00:00 AM,48,-122,36,69,105
7376,ElliotBayTrailMyrtlePark,11/04/2014 08:00:00 AM,48,-122,33,105,138
7377,ElliotBayTrailMyrtlePark,11/04/2014 09:00:00 AM,48,-122,16,49,65
7378,ElliotBayTrailMyrtlePark,11/04/2014 10:00:00 AM,48,-122,11,19,30
7379,ElliotBayTrailMyrtlePark,11/04/2014 11:00:00 AM,48,-122,11,6,17
7380,ElliotBayTrailMyrtlePark,11/04/2014 12:00:00 PM,48,-122,15,14,29
7381,ElliotBayTrailMyrtlePark,11/04/2014 01:00:00 PM,48,-122,10,8,18
7382,ElliotBayTrailMyrtlePark,11/04/2014 02:00:00 PM,48,-122,13,18,31
7383,ElliotBayTrailMyrtlePark,11/04/2014 03:00:00 PM,48,-122,17,17,34
7384,ElliotBayTrailMyrtlePark,11/04/2014 04:00:00 PM,48,-122,55,33,88
7385,ElliotBayTrailMyrtlePark,11/04/2014 05:00:00 PM,48,-122,127,42,169
7386,ElliotBayTrailMyrtlePark,11/04/2014 06:00:00 PM,48,-122,82,21,103
7387,ElliotBayTrailMyrtlePark,11/04/2014 07:00:00 PM,48,-122,34,5,39
7388,ElliotBayTrailMyrtlePark,11/04/2014 08:00:00 PM,48,-122,4,2,6
7389,ElliotBayTrailMyrtlePark,11/04/2014 09:00:00 PM,48,-122,8,1,9
7390,ElliotBayTrailMyrtlePark,11/04/2014 10:00:00 PM,48,-122,3,2,5
7391,ElliotBayTrailMyrtlePark,11/04/2014 11:00:00 PM,48,-122,1,2,3
7392,ElliotBayTrailMyrtlePark,11/05/2014 12:00:00 AM,48,-122,4,1,5
7393,ElliotBayTrailMyrtlePark,11/05/2014 01:00:00 AM,48,-122,1,0,1
7394,ElliotBayTrailMyrtlePark,11/05/2014 02:00:00 AM,48,-122,1,0,1
7395,ElliotBayTrailMyrtlePark,11/05/2014 03:00:00 AM,48,-122,0,0,0
7396,ElliotBayTrailMyrtlePark,11/05/2014 04:00:00 AM,48,-122,0,0,0
7397,ElliotBayTrailMyrtlePark,11/05/2014 05:00:00 AM,48,-122,5,14,19
7398,ElliotBayTrailMyrtlePark,11/05/2014 06:00:00 AM,48,-122,22,27,49
7399,ElliotBayTrailMyrtlePark,11/05/2014 07:00:00 AM,48,-122,42,70,112
7400,ElliotBayTrailMyrtlePark,11/05/2014 08:00:00 AM,48,-122,27,117,144
7401,ElliotBayTrailMyrtlePark,11/05/2014 09:00:00 AM,48,-122,27,50,77
7402,ElliotBayTrailMyrtlePark,11/05/2014 10:00:00 AM,48,-122,16,23,39
7403,ElliotBayTrailMyrtlePark,11/05/2014 11:00:00 AM,48,-122,13,37,50
7404,ElliotBayTrailMyrtlePark,11/05/2014 12:00:00 PM,48,-122,17,12,29
7405,ElliotBayTrailMyrtlePark,11/05/2014 01:00:00 PM,48,-122,16,12,28
7406,ElliotBayTrailMyrtlePark,11/05/2014 02:00:00 PM,48,-122,13,10,23
7407,ElliotBayTrailMyrtlePark,11/05/2014 03:00:00 PM,48,-122,18,11,29
7408,ElliotBayTrailMyrtlePark,11/05/2014 04:00:00 PM,48,-122,54,42,96
7409,ElliotBayTrailMyrtlePark,11/05/2014 05:00:00 PM,48,-122,125,23,148
7410,ElliotBayTrailMyrtlePark,11/05/2014 06:00:00 PM,48,-122,81,9,90
7411,ElliotBayTrailMyrtlePark,11/05/2014 07:00:00 PM,48,-122,36,8,44
7412,ElliotBayTrailMyrtlePark,11/05/2014 08:00:00 PM,48,-122,3,2,5
7413,ElliotBayTrailMyrtlePark,11/05/2014 09:00:00 PM,48,-122,5,1,6
7414,ElliotBayTrailMyrtlePark,11/05/2014 10:00:00 PM,48,-122,0,1,1
7415,ElliotBayTrailMyrtlePark,11/05/2014 11:00:00 PM,48,-122,1,0,1
7416,ElliotBayTrailMyrtlePark,11/06/2014 12:00:00 AM,48,-122,0,1,1
7417,ElliotBayTrailMyrtlePark,11/06/2014 01:00:00 AM,48,-122,1,0,1
7418,ElliotBayTrailMyrtlePark,11/06/2014 02:00:00 AM,48,-122,2,0,2
7419,ElliotBayTrailMyrtlePark,11/06/2014 03:00:00 AM,48,-122,1,0,1
7420,ElliotBayTrailMyrtlePark,11/06/2014 04:00:00 AM,48,-122,0,0,0
7421,ElliotBayTrailMyrtlePark,11/06/2014 05:00:00 AM,48,-122,5,13,18
7422,ElliotBayTrailMyrtlePark,11/06/2014 06:00:00 AM,48,-122,11,19,30
7423,ElliotBayTrailMyrtlePark,11/06/2014 07:00:00 AM,48,-122,28,46,74
7424,ElliotBayTrailMyrtlePark,11/06/2014 08:00:00 AM,48,-122,34,65,99
7425,ElliotBayTrailMyrtlePark,11/06/2014 09:00:00 AM,48,-122,10,44,54
7426,ElliotBayTrailMyrtlePark,11/06/2014 10:00:00 AM,48,-122,7,11,18
7427,ElliotBayTrailMyrtlePark,11/06/2014 11:00:00 AM,48,-122,7,4,11
7428,ElliotBayTrailMyrtlePark,11/06/2014 12:00:00 PM,48,-122,8,11,19
7429,ElliotBayTrailMyrtlePark,11/06/2014 01:00:00 PM,48,-122,1,4,5
7430,ElliotBayTrailMyrtlePark,11/06/2014 02:00:00 PM,48,-122,18,11,29
7431,ElliotBayTrailMyrtlePark,11/06/2014 03:00:00 PM,48,-122,13,11,24
7432,ElliotBayTrailMyrtlePark,11/06/2014 04:00:00 PM,48,-122,41,33,74
7433,ElliotBayTrailMyrtlePark,11/06/2014 05:00:00 PM,48,-122,85,31,116
7434,ElliotBayTrailMyrtlePark,11/06/2014 06:00:00 PM,48,-122,76,13,89
7435,ElliotBayTrailMyrtlePark,11/06/2014 07:00:00 PM,48,-122,19,4,23
7436,ElliotBayTrailMyrtlePark,11/06/2014 08:00:00 PM,48,-122,6,1,7
7437,ElliotBayTrailMyrtlePark,11/06/2014 09:00:00 PM,48,-122,4,0,4
7438,ElliotBayTrailMyrtlePark,11/06/2014 10:00:00 PM,48,-122,2,0,2
7439,ElliotBayTrailMyrtlePark,11/06/2014 11:00:00 PM,48,-122,4,3,7
7440,ElliotBayTrailMyrtlePark,11/07/2014 12:00:00 AM,48,-122,4,1,5
7441,ElliotBayTrailMyrtlePark,11/07/2014 01:00:00 AM,48,-122,0,0,0
7442,ElliotBayTrailMyrtlePark,11/07/2014 02:00:00 AM,48,-122,2,0,2
7443,ElliotBayTrailMyrtlePark,11/07/2014 03:00:00 AM,48,-122,0,0,0
7444,ElliotBayTrailMyrtlePark,11/07/2014 04:00:00 AM,48,-122,0,0,0
7445,ElliotBayTrailMyrtlePark,11/07/2014 05:00:00 AM,48,-122,3,11,14
7446,ElliotBayTrailMyrtlePark,11/07/2014 06:00:00 AM,48,-122,15,22,37
7447,ElliotBayTrailMyrtlePark,11/07/2014 07:00:00 AM,48,-122,35,72,107
7448,ElliotBayTrailMyrtlePark,11/07/2014 08:00:00 AM,48,-122,31,125,156
7449,ElliotBayTrailMyrtlePark,11/07/2014 09:00:00 AM,48,-122,22,68,90
7450,ElliotBayTrailMyrtlePark,11/07/2014 10:00:00 AM,48,-122,20,29,49
7451,ElliotBayTrailMyrtlePark,11/07/2014 11:00:00 AM,48,-122,18,15,33
7452,ElliotBayTrailMyrtlePark,11/07/2014 12:00:00 PM,48,-122,24,17,41
7453,ElliotBayTrailMyrtlePark,11/07/2014 01:00:00 PM,48,-122,36,21,57
7454,ElliotBayTrailMyrtlePark,11/07/2014 02:00:00 PM,48,-122,23,26,49
7455,ElliotBayTrailMyrtlePark,11/07/2014 03:00:00 PM,48,-122,41,45,86
7456,ElliotBayTrailMyrtlePark,11/07/2014 04:00:00 PM,48,-122,98,65,163
7457,ElliotBayTrailMyrtlePark,11/07/2014 05:00:00 PM,48,-122,130,47,177
7458,ElliotBayTrailMyrtlePark,11/07/2014 06:00:00 PM,48,-122,61,18,79
7459,ElliotBayTrailMyrtlePark,11/07/2014 07:00:00 PM,48,-122,24,4,28
7460,ElliotBayTrailMyrtlePark,11/07/2014 08:00:00 PM,48,-122,11,2,13
7461,ElliotBayTrailMyrtlePark,11/07/2014 09:00:00 PM,48,-122,5,6,11
7462,ElliotBayTrailMyrtlePark,11/07/2014 10:00:00 PM,48,-122,0,3,3
7463,ElliotBayTrailMyrtlePark,11/07/2014 11:00:00 PM,48,-122,3,0,3
7464,ElliotBayTrailMyrtlePark,11/08/2014 12:00:00 AM,48,-122,7,1,8
7465,ElliotBayTrailMyrtlePark,11/08/2014 01:00:00 AM,48,-122,1,0,1
7466,ElliotBayTrailMyrtlePark,11/08/2014 02:00:00 AM,48,-122,1,0,1
7467,ElliotBayTrailMyrtlePark,11/08/2014 03:00:00 AM,48,-122,2,0,2
7468,ElliotBayTrailMyrtlePark,11/08/2014 04:00:00 AM,48,-122,1,0,1
7469,ElliotBayTrailMyrtlePark,11/08/2014 05:00:00 AM,48,-122,1,2,3
7470,ElliotBayTrailMyrtlePark,11/08/2014 06:00:00 AM,48,-122,2,3,5
7471,ElliotBayTrailMyrtlePark,11/08/2014 07:00:00 AM,48,-122,7,8,15
7472,ElliotBayTrailMyrtlePark,11/08/2014 08:00:00 AM,48,-122,16,9,25
7473,ElliotBayTrailMyrtlePark,11/08/2014 09:00:00 AM,48,-122,11,27,38
7474,ElliotBayTrailMyrtlePark,11/08/2014 10:00:00 AM,48,-122,27,27,54
7475,ElliotBayTrailMyrtlePark,11/08/2014 11:00:00 AM,48,-122,49,48,97
7476,ElliotBayTrailMyrtlePark,11/08/2014 12:00:00 PM,48,-122,59,73,132
7477,ElliotBayTrailMyrtlePark,11/08/2014 01:00:00 PM,48,-122,61,44,105
7478,ElliotBayTrailMyrtlePark,11/08/2014 02:00:00 PM,48,-122,62,49,111
7479,ElliotBayTrailMyrtlePark,11/08/2014 03:00:00 PM,48,-122,48,61,109
7480,ElliotBayTrailMyrtlePark,11/08/2014 04:00:00 PM,48,-122,27,29,56
7481,ElliotBayTrailMyrtlePark,11/08/2014 05:00:00 PM,48,-122,26,16,42
7482,ElliotBayTrailMyrtlePark,11/08/2014 06:00:00 PM,48,-122,6,7,13
7483,ElliotBayTrailMyrtlePark,11/08/2014 07:00:00 PM,48,-122,7,13,20
7484,ElliotBayTrailMyrtlePark,11/08/2014 08:00:00 PM,48,-122,2,0,2
7485,ElliotBayTrailMyrtlePark,11/08/2014 09:00:00 PM,48,-122,6,2,8
7486,ElliotBayTrailMyrtlePark,11/08/2014 10:00:00 PM,48,-122,7,0,7
7487,ElliotBayTrailMyrtlePark,11/08/2014 11:00:00 PM,48,-122,8,0,8
7488,ElliotBayTrailMyrtlePark,11/09/2014 12:00:00 AM,48,-122,3,2,5
7489,ElliotBayTrailMyrtlePark,11/09/2014 01:00:00 AM,48,-122,0,0,0
7490,ElliotBayTrailMyrtlePark,11/09/2014 02:00:00 AM,48,-122,1,2,3
7491,ElliotBayTrailMyrtlePark,11/09/2014 03:00:00 AM,48,-122,1,1,2
7492,ElliotBayTrailMyrtlePark,11/09/2014 04:00:00 AM,48,-122,0,0,0
7493,ElliotBayTrailMyrtlePark,11/09/2014 05:00:00 AM,48,-122,0,3,3
7494,ElliotBayTrailMyrtlePark,11/09/2014 06:00:00 AM,48,-122,1,3,4
7495,ElliotBayTrailMyrtlePark,11/09/2014 07:00:00 AM,48,-122,1,2,3
7496,ElliotBayTrailMyrtlePark,11/09/2014 08:00:00 AM,48,-122,2,1,3
7497,ElliotBayTrailMyrtlePark,11/09/2014 09:00:00 AM,48,-122,22,19,41
7498,ElliotBayTrailMyrtlePark,11/09/2014 10:00:00 AM,48,-122,12,9,21
7499,ElliotBayTrailMyrtlePark,11/09/2014 11:00:00 AM,48,-122,13,14,27
7500,ElliotBayTrailMyrtlePark,11/09/2014 12:00:00 PM,48,-122,23,25,48
7501,ElliotBayTrailMyrtlePark,11/09/2014 01:00:00 PM,48,-122,14,19,33
7502,ElliotBayTrailMyrtlePark,11/09/2014 02:00:00 PM,48,-122,16,19,35
7503,ElliotBayTrailMyrtlePark,11/09/2014 03:00:00 PM,48,-122,11,14,25
7504,ElliotBayTrailMyrtlePark,11/09/2014 04:00:00 PM,48,-122,10,3,13
7505,ElliotBayTrailMyrtlePark,11/09/2014 05:00:00 PM,48,-122,13,5,18
7506,ElliotBayTrailMyrtlePark,11/09/2014 06:00:00 PM,48,-122,5,1,6
7507,ElliotBayTrailMyrtlePark,11/09/2014 07:00:00 PM,48,-122,1,2,3
7508,ElliotBayTrailMyrtlePark,11/09/2014 08:00:00 PM,48,-122,4,2,6
7509,ElliotBayTrailMyrtlePark,11/09/2014 09:00:00 PM,48,-122,2,0,2
7510,ElliotBayTrailMyrtlePark,11/09/2014 10:00:00 PM,48,-122,1,1,2
7511,ElliotBayTrailMyrtlePark,11/09/2014 11:00:00 PM,48,-122,0,1,1
7512,ElliotBayTrailMyrtlePark,11/10/2014 12:00:00 AM,48,-122,1,1,2
7513,ElliotBayTrailMyrtlePark,11/10/2014 01:00:00 AM,48,-122,1,0,1
7514,ElliotBayTrailMyrtlePark,11/10/2014 02:00:00 AM,48,-122,1,0,1
7515,ElliotBayTrailMyrtlePark,11/10/2014 03:00:00 AM,48,-122,0,1,1
7516,ElliotBayTrailMyrtlePark,11/10/2014 04:00:00 AM,48,-122,0,0,0
7517,ElliotBayTrailMyrtlePark,11/10/2014 05:00:00 AM,48,-122,5,11,16
7518,ElliotBayTrailMyrtlePark,11/10/2014 06:00:00 AM,48,-122,14,26,40
7519,ElliotBayTrailMyrtlePark,11/10/2014 07:00:00 AM,48,-122,32,62,94
7520,ElliotBayTrailMyrtlePark,11/10/2014 08:00:00 AM,48,-122,33,127,160
7521,ElliotBayTrailMyrtlePark,11/10/2014 09:00:00 AM,48,-122,16,67,83
7522,ElliotBayTrailMyrtlePark,11/10/2014 10:00:00 AM,48,-122,31,30,61
7523,ElliotBayTrailMyrtlePark,11/10/2014 11:00:00 AM,48,-122,15,18,33
7524,ElliotBayTrailMyrtlePark,11/10/2014 12:00:00 PM,48,-122,17,24,41
7525,ElliotBayTrailMyrtlePark,11/10/2014 01:00:00 PM,48,-122,18,19,37
7526,ElliotBayTrailMyrtlePark,11/10/2014 02:00:00 PM,48,-122,38,25,63
7527,ElliotBayTrailMyrtlePark,11/10/2014 03:00:00 PM,48,-122,32,37,69
7528,ElliotBayTrailMyrtlePark,11/10/2014 04:00:00 PM,48,-122,82,46,128
7529,ElliotBayTrailMyrtlePark,11/10/2014 05:00:00 PM,48,-122,148,51,199
7530,ElliotBayTrailMyrtlePark,11/10/2014 06:00:00 PM,48,-122,71,24,95
7531,ElliotBayTrailMyrtlePark,11/10/2014 07:00:00 PM,48,-122,30,9,39
7532,ElliotBayTrailMyrtlePark,11/10/2014 08:00:00 PM,48,-122,11,3,14
7533,ElliotBayTrailMyrtlePark,11/10/2014 09:00:00 PM,48,-122,4,0,4
7534,ElliotBayTrailMyrtlePark,11/10/2014 10:00:00 PM,48,-122,32,3,35
7535,ElliotBayTrailMyrtlePark,11/10/2014 11:00:00 PM,48,-122,7,0,7
7536,ElliotBayTrailMyrtlePark,11/11/2014 12:00:00 AM,48,-122,5,2,7
7537,ElliotBayTrailMyrtlePark,11/11/2014 01:00:00 AM,48,-122,3,0,3
7538,ElliotBayTrailMyrtlePark,11/11/2014 02:00:00 AM,48,-122,3,0,3
7539,ElliotBayTrailMyrtlePark,11/11/2014 03:00:00 AM,48,-122,1,0,1
7540,ElliotBayTrailMyrtlePark,11/11/2014 04:00:00 AM,48,-122,0,0,0
7541,ElliotBayTrailMyrtlePark,11/11/2014 05:00:00 AM,48,-122,3,6,9
7542,ElliotBayTrailMyrtlePark,11/11/2014 06:00:00 AM,48,-122,11,18,29
7543,ElliotBayTrailMyrtlePark,11/11/2014 07:00:00 AM,48,-122,36,60,96
7544,ElliotBayTrailMyrtlePark,11/11/2014 08:00:00 AM,48,-122,26,101,127
7545,ElliotBayTrailMyrtlePark,11/11/2014 09:00:00 AM,48,-122,18,60,78
7546,ElliotBayTrailMyrtlePark,11/11/2014 10:00:00 AM,48,-122,16,26,42
7547,ElliotBayTrailMyrtlePark,11/11/2014 11:00:00 AM,48,-122,23,13,36
7548,ElliotBayTrailMyrtlePark,11/11/2014 12:00:00 PM,48,-122,23,25,48
7549,ElliotBayTrailMyrtlePark,11/11/2014 01:00:00 PM,48,-122,28,33,61
7550,ElliotBayTrailMyrtlePark,11/11/2014 02:00:00 PM,48,-122,19,13,32
7551,ElliotBayTrailMyrtlePark,11/11/2014 03:00:00 PM,48,-122,50,30,80
7552,ElliotBayTrailMyrtlePark,11/11/2014 04:00:00 PM,48,-122,63,35,98
7553,ElliotBayTrailMyrtlePark,11/11/2014 05:00:00 PM,48,-122,118,40,158
7554,ElliotBayTrailMyrtlePark,11/11/2014 06:00:00 PM,48,-122,79,16,95
7555,ElliotBayTrailMyrtlePark,11/11/2014 07:00:00 PM,48,-122,21,5,26
7556,ElliotBayTrailMyrtlePark,11/11/2014 08:00:00 PM,48,-122,5,5,10
7557,ElliotBayTrailMyrtlePark,11/11/2014 09:00:00 PM,48,-122,5,1,6
7558,ElliotBayTrailMyrtlePark,11/11/2014 10:00:00 PM,48,-122,2,0,2
7559,ElliotBayTrailMyrtlePark,11/11/2014 11:00:00 PM,48,-122,1,0,1
7560,ElliotBayTrailMyrtlePark,11/12/2014 12:00:00 AM,48,-122,2,0,2
7561,ElliotBayTrailMyrtlePark,11/12/2014 01:00:00 AM,48,-122,1,0,1
7562,ElliotBayTrailMyrtlePark,11/12/2014 02:00:00 AM,48,-122,1,0,1
7563,ElliotBayTrailMyrtlePark,11/12/2014 03:00:00 AM,48,-122,0,0,0
7564,ElliotBayTrailMyrtlePark,11/12/2014 04:00:00 AM,48,-122,0,1,1
7565,ElliotBayTrailMyrtlePark,11/12/2014 05:00:00 AM,48,-122,5,11,16
7566,ElliotBayTrailMyrtlePark,11/12/2014 06:00:00 AM,48,-122,16,28,44
7567,ElliotBayTrailMyrtlePark,11/12/2014 07:00:00 AM,48,-122,34,58,92
7568,ElliotBayTrailMyrtlePark,11/12/2014 08:00:00 AM,48,-122,25,112,137
7569,ElliotBayTrailMyrtlePark,11/12/2014 09:00:00 AM,48,-122,22,60,82
7570,ElliotBayTrailMyrtlePark,11/12/2014 10:00:00 AM,48,-122,6,23,29
7571,ElliotBayTrailMyrtlePark,11/12/2014 11:00:00 AM,48,-122,9,17,26
7572,ElliotBayTrailMyrtlePark,11/12/2014 12:00:00 PM,48,-122,10,10,20
7573,ElliotBayTrailMyrtlePark,11/12/2014 01:00:00 PM,48,-122,11,11,22
7574,ElliotBayTrailMyrtlePark,11/12/2014 02:00:00 PM,48,-122,20,18,38
7575,ElliotBayTrailMyrtlePark,11/12/2014 03:00:00 PM,48,-122,24,19,43
7576,ElliotBayTrailMyrtlePark,11/12/2014 04:00:00 PM,48,-122,71,30,101
7577,ElliotBayTrailMyrtlePark,11/12/2014 05:00:00 PM,48,-122,122,31,153
7578,ElliotBayTrailMyrtlePark,11/12/2014 06:00:00 PM,48,-122,79,19,98
7579,ElliotBayTrailMyrtlePark,11/12/2014 07:00:00 PM,48,-122,16,7,23
7580,ElliotBayTrailMyrtlePark,11/12/2014 08:00:00 PM,48,-122,10,2,12
7581,ElliotBayTrailMyrtlePark,11/12/2014 09:00:00 PM,48,-122,4,1,5
7582,ElliotBayTrailMyrtlePark,11/12/2014 10:00:00 PM,48,-122,5,2,7
7583,ElliotBayTrailMyrtlePark,11/12/2014 11:00:00 PM,48,-122,2,0,2
7584,ElliotBayTrailMyrtlePark,11/13/2014 12:00:00 AM,48,-122,3,1,4
7585,ElliotBayTrailMyrtlePark,11/13/2014 01:00:00 AM,48,-122,1,1,2
7586,ElliotBayTrailMyrtlePark,11/13/2014 02:00:00 AM,48,-122,1,0,1
7587,ElliotBayTrailMyrtlePark,11/13/2014 03:00:00 AM,48,-122,1,0,1
7588,ElliotBayTrailMyrtlePark,11/13/2014 04:00:00 AM,48,-122,0,0,0
7589,ElliotBayTrailMyrtlePark,11/13/2014 05:00:00 AM,48,-122,7,10,17
7590,ElliotBayTrailMyrtlePark,11/13/2014 06:00:00 AM,48,-122,7,23,30
7591,ElliotBayTrailMyrtlePark,11/13/2014 07:00:00 AM,48,-122,35,57,92
7592,ElliotBayTrailMyrtlePark,11/13/2014 08:00:00 AM,48,-122,31,98,129
7593,ElliotBayTrailMyrtlePark,11/13/2014 09:00:00 AM,48,-122,17,67,84
7594,ElliotBayTrailMyrtlePark,11/13/2014 10:00:00 AM,48,-122,12,20,32
7595,ElliotBayTrailMyrtlePark,11/13/2014 11:00:00 AM,48,-122,5,11,16
7596,ElliotBayTrailMyrtlePark,11/13/2014 12:00:00 PM,48,-122,12,8,20
7597,ElliotBayTrailMyrtlePark,11/13/2014 01:00:00 PM,48,-122,14,11,25
7598,ElliotBayTrailMyrtlePark,11/13/2014 02:00:00 PM,48,-122,22,24,46
7599,ElliotBayTrailMyrtlePark,11/13/2014 03:00:00 PM,48,-122,20,25,45
7600,ElliotBayTrailMyrtlePark,11/13/2014 04:00:00 PM,48,-122,48,25,73
7601,ElliotBayTrailMyrtlePark,11/13/2014 05:00:00 PM,48,-122,119,29,148
7602,ElliotBayTrailMyrtlePark,11/13/2014 06:00:00 PM,48,-122,61,11,72
7603,ElliotBayTrailMyrtlePark,11/13/2014 07:00:00 PM,48,-122,57,14,71
7604,ElliotBayTrailMyrtlePark,11/13/2014 08:00:00 PM,48,-122,6,3,9
7605,ElliotBayTrailMyrtlePark,11/13/2014 09:00:00 PM,48,-122,4,2,6
7606,ElliotBayTrailMyrtlePark,11/13/2014 10:00:00 PM,48,-122,3,1,4
7607,ElliotBayTrailMyrtlePark,11/13/2014 11:00:00 PM,48,-122,2,2,4
7608,ElliotBayTrailMyrtlePark,11/14/2014 12:00:00 AM,48,-122,1,2,3
7609,ElliotBayTrailMyrtlePark,11/14/2014 01:00:00 AM,48,-122,1,0,1
7610,ElliotBayTrailMyrtlePark,11/14/2014 02:00:00 AM,48,-122,3,1,4
7611,ElliotBayTrailMyrtlePark,11/14/2014 03:00:00 AM,48,-122,0,0,0
7612,ElliotBayTrailMyrtlePark,11/14/2014 04:00:00 AM,48,-122,0,0,0
7613,ElliotBayTrailMyrtlePark,11/14/2014 05:00:00 AM,48,-122,4,10,14
7614,ElliotBayTrailMyrtlePark,11/14/2014 06:00:00 AM,48,-122,13,21,34
7615,ElliotBayTrailMyrtlePark,11/14/2014 07:00:00 AM,48,-122,31,48,79
7616,ElliotBayTrailMyrtlePark,11/14/2014 08:00:00 AM,48,-122,24,93,117
7617,ElliotBayTrailMyrtlePark,11/14/2014 09:00:00 AM,48,-122,20,53,73
7618,ElliotBayTrailMyrtlePark,11/14/2014 10:00:00 AM,48,-122,6,23,29
7619,ElliotBayTrailMyrtlePark,11/14/2014 11:00:00 AM,48,-122,9,3,12
7620,ElliotBayTrailMyrtlePark,11/14/2014 12:00:00 PM,48,-122,15,8,23
7621,ElliotBayTrailMyrtlePark,11/14/2014 01:00:00 PM,48,-122,20,16,36
7622,ElliotBayTrailMyrtlePark,11/14/2014 02:00:00 PM,48,-122,11,18,29
7623,ElliotBayTrailMyrtlePark,11/14/2014 03:00:00 PM,48,-122,25,16,41
7624,ElliotBayTrailMyrtlePark,11/14/2014 04:00:00 PM,48,-122,65,39,104
7625,ElliotBayTrailMyrtlePark,11/14/2014 05:00:00 PM,48,-122,85,33,118
7626,ElliotBayTrailMyrtlePark,11/14/2014 06:00:00 PM,48,-122,46,8,54
7627,ElliotBayTrailMyrtlePark,11/14/2014 07:00:00 PM,48,-122,18,3,21
7628,ElliotBayTrailMyrtlePark,11/14/2014 08:00:00 PM,48,-122,6,2,8
7629,ElliotBayTrailMyrtlePark,11/14/2014 09:00:00 PM,48,-122,0,1,1
7630,ElliotBayTrailMyrtlePark,11/14/2014 10:00:00 PM,48,-122,2,1,3
7631,ElliotBayTrailMyrtlePark,11/14/2014 11:00:00 PM,48,-122,3,0,3
7632,ElliotBayTrailMyrtlePark,11/15/2014 12:00:00 AM,48,-122,3,1,4
7633,ElliotBayTrailMyrtlePark,11/15/2014 01:00:00 AM,48,-122,0,0,0
7634,ElliotBayTrailMyrtlePark,11/15/2014 02:00:00 AM,48,-122,0,0,0
7635,ElliotBayTrailMyrtlePark,11/15/2014 03:00:00 AM,48,-122,1,0,1
7636,ElliotBayTrailMyrtlePark,11/15/2014 04:00:00 AM,48,-122,0,2,2
7637,ElliotBayTrailMyrtlePark,11/15/2014 05:00:00 AM,48,-122,1,1,2
7638,ElliotBayTrailMyrtlePark,11/15/2014 06:00:00 AM,48,-122,2,2,4
7639,ElliotBayTrailMyrtlePark,11/15/2014 07:00:00 AM,48,-122,4,4,8
7640,ElliotBayTrailMyrtlePark,11/15/2014 08:00:00 AM,48,-122,5,12,17
7641,ElliotBayTrailMyrtlePark,11/15/2014 09:00:00 AM,48,-122,14,7,21
7642,ElliotBayTrailMyrtlePark,11/15/2014 10:00:00 AM,48,-122,7,15,22
7643,ElliotBayTrailMyrtlePark,11/15/2014 11:00:00 AM,48,-122,26,16,42
7644,ElliotBayTrailMyrtlePark,11/15/2014 12:00:00 PM,48,-122,28,17,45
7645,ElliotBayTrailMyrtlePark,11/15/2014 01:00:00 PM,48,-122,32,25,57
7646,ElliotBayTrailMyrtlePark,11/15/2014 02:00:00 PM,48,-122,36,34,70
7647,ElliotBayTrailMyrtlePark,11/15/2014 03:00:00 PM,48,-122,36,43,79
7648,ElliotBayTrailMyrtlePark,11/15/2014 04:00:00 PM,48,-122,39,33,72
7649,ElliotBayTrailMyrtlePark,11/15/2014 05:00:00 PM,48,-122,10,7,17
7650,ElliotBayTrailMyrtlePark,11/15/2014 06:00:00 PM,48,-122,6,2,8
7651,ElliotBayTrailMyrtlePark,11/15/2014 07:00:00 PM,48,-122,5,1,6
7652,ElliotBayTrailMyrtlePark,11/15/2014 08:00:00 PM,48,-122,0,2,2
7653,ElliotBayTrailMyrtlePark,11/15/2014 09:00:00 PM,48,-122,2,2,4
7654,ElliotBayTrailMyrtlePark,11/15/2014 10:00:00 PM,48,-122,5,2,7
7655,ElliotBayTrailMyrtlePark,11/15/2014 11:00:00 PM,48,-122,2,1,3
7656,ElliotBayTrailMyrtlePark,11/16/2014 12:00:00 AM,48,-122,3,0,3
7657,ElliotBayTrailMyrtlePark,11/16/2014 01:00:00 AM,48,-122,1,0,1
7658,ElliotBayTrailMyrtlePark,11/16/2014 02:00:00 AM,48,-122,1,0,1
7659,ElliotBayTrailMyrtlePark,11/16/2014 03:00:00 AM,48,-122,2,0,2
7660,ElliotBayTrailMyrtlePark,11/16/2014 04:00:00 AM,48,-122,0,0,0
7661,ElliotBayTrailMyrtlePark,11/16/2014 05:00:00 AM,48,-122,0,0,0
7662,ElliotBayTrailMyrtlePark,11/16/2014 06:00:00 AM,48,-122,1,2,3
7663,ElliotBayTrailMyrtlePark,11/16/2014 07:00:00 AM,48,-122,1,4,5
7664,ElliotBayTrailMyrtlePark,11/16/2014 08:00:00 AM,48,-122,5,2,7
7665,ElliotBayTrailMyrtlePark,11/16/2014 09:00:00 AM,48,-122,8,8,16
7666,ElliotBayTrailMyrtlePark,11/16/2014 10:00:00 AM,48,-122,13,10,23
7667,ElliotBayTrailMyrtlePark,11/16/2014 11:00:00 AM,48,-122,16,12,28
7668,ElliotBayTrailMyrtlePark,11/16/2014 12:00:00 PM,48,-122,21,13,34
7669,ElliotBayTrailMyrtlePark,11/16/2014 01:00:00 PM,48,-122,19,19,38
7670,ElliotBayTrailMyrtlePark,11/16/2014 02:00:00 PM,48,-122,40,49,89
7671,ElliotBayTrailMyrtlePark,11/16/2014 03:00:00 PM,48,-122,27,23,50
7672,ElliotBayTrailMyrtlePark,11/16/2014 04:00:00 PM,48,-122,29,27,56
7673,ElliotBayTrailMyrtlePark,11/16/2014 05:00:00 PM,48,-122,12,14,26
7674,ElliotBayTrailMyrtlePark,11/16/2014 06:00:00 PM,48,-122,7,2,9
7675,ElliotBayTrailMyrtlePark,11/16/2014 07:00:00 PM,48,-122,3,3,6
7676,ElliotBayTrailMyrtlePark,11/16/2014 08:00:00 PM,48,-122,1,2,3
7677,ElliotBayTrailMyrtlePark,11/16/2014 09:00:00 PM,48,-122,4,0,4
7678,ElliotBayTrailMyrtlePark,11/16/2014 10:00:00 PM,48,-122,1,2,3
7679,ElliotBayTrailMyrtlePark,11/16/2014 11:00:00 PM,48,-122,4,0,4
7680,ElliotBayTrailMyrtlePark,11/17/2014 12:00:00 AM,48,-122,1,0,1
7681,ElliotBayTrailMyrtlePark,11/17/2014 01:00:00 AM,48,-122,1,0,1
7682,ElliotBayTrailMyrtlePark,11/17/2014 02:00:00 AM,48,-122,1,0,1
7683,ElliotBayTrailMyrtlePark,11/17/2014 03:00:00 AM,48,-122,0,0,0
7684,ElliotBayTrailMyrtlePark,11/17/2014 04:00:00 AM,48,-122,0,2,2
7685,ElliotBayTrailMyrtlePark,11/17/2014 05:00:00 AM,48,-122,9,10,19
7686,ElliotBayTrailMyrtlePark,11/17/2014 06:00:00 AM,48,-122,18,25,43
7687,ElliotBayTrailMyrtlePark,11/17/2014 07:00:00 AM,48,-122,29,56,85
7688,ElliotBayTrailMyrtlePark,11/17/2014 08:00:00 AM,48,-122,30,112,142
7689,ElliotBayTrailMyrtlePark,11/17/2014 09:00:00 AM,48,-122,18,55,73
7690,ElliotBayTrailMyrtlePark,11/17/2014 10:00:00 AM,48,-122,20,22,42
7691,ElliotBayTrailMyrtlePark,11/17/2014 11:00:00 AM,48,-122,11,11,22
7692,ElliotBayTrailMyrtlePark,11/17/2014 12:00:00 PM,48,-122,12,17,29
7693,ElliotBayTrailMyrtlePark,11/17/2014 01:00:00 PM,48,-122,8,13,21
7694,ElliotBayTrailMyrtlePark,11/17/2014 02:00:00 PM,48,-122,18,21,39
7695,ElliotBayTrailMyrtlePark,11/17/2014 03:00:00 PM,48,-122,18,25,43
7696,ElliotBayTrailMyrtlePark,11/17/2014 04:00:00 PM,48,-122,52,35,87
7697,ElliotBayTrailMyrtlePark,11/17/2014 05:00:00 PM,48,-122,128,45,173
7698,ElliotBayTrailMyrtlePark,11/17/2014 06:00:00 PM,48,-122,71,12,83
7699,ElliotBayTrailMyrtlePark,11/17/2014 07:00:00 PM,48,-122,23,6,29
7700,ElliotBayTrailMyrtlePark,11/17/2014 08:00:00 PM,48,-122,2,2,4
7701,ElliotBayTrailMyrtlePark,11/17/2014 09:00:00 PM,48,-122,6,3,9
7702,ElliotBayTrailMyrtlePark,11/17/2014 10:00:00 PM,48,-122,4,3,7
7703,ElliotBayTrailMyrtlePark,11/17/2014 11:00:00 PM,48,-122,3,0,3
7704,ElliotBayTrailMyrtlePark,11/18/2014 12:00:00 AM,48,-122,3,7,10
7705,ElliotBayTrailMyrtlePark,11/18/2014 01:00:00 AM,48,-122,0,0,0
7706,ElliotBayTrailMyrtlePark,11/18/2014 02:00:00 AM,48,-122,2,0,2
7707,ElliotBayTrailMyrtlePark,11/18/2014 03:00:00 AM,48,-122,1,0,1
7708,ElliotBayTrailMyrtlePark,11/18/2014 04:00:00 AM,48,-122,0,0,0
7709,ElliotBayTrailMyrtlePark,11/18/2014 05:00:00 AM,48,-122,3,13,16
7710,ElliotBayTrailMyrtlePark,11/18/2014 06:00:00 AM,48,-122,16,27,43
7711,ElliotBayTrailMyrtlePark,11/18/2014 07:00:00 AM,48,-122,31,61,92
7712,ElliotBayTrailMyrtlePark,11/18/2014 08:00:00 AM,48,-122,39,126,165
7713,ElliotBayTrailMyrtlePark,11/18/2014 09:00:00 AM,48,-122,13,57,70
7714,ElliotBayTrailMyrtlePark,11/18/2014 10:00:00 AM,48,-122,11,12,23
7715,ElliotBayTrailMyrtlePark,11/18/2014 11:00:00 AM,48,-122,17,11,28
7716,ElliotBayTrailMyrtlePark,11/18/2014 12:00:00 PM,48,-122,10,14,24
7717,ElliotBayTrailMyrtlePark,11/18/2014 01:00:00 PM,48,-122,14,20,34
7718,ElliotBayTrailMyrtlePark,11/18/2014 02:00:00 PM,48,-122,13,20,33
7719,ElliotBayTrailMyrtlePark,11/18/2014 03:00:00 PM,48,-122,26,20,46
7720,ElliotBayTrailMyrtlePark,11/18/2014 04:00:00 PM,48,-122,56,37,93
7721,ElliotBayTrailMyrtlePark,11/18/2014 05:00:00 PM,48,-122,116,39,155
7722,ElliotBayTrailMyrtlePark,11/18/2014 06:00:00 PM,48,-122,91,18,109
7723,ElliotBayTrailMyrtlePark,11/18/2014 07:00:00 PM,48,-122,30,10,40
7724,ElliotBayTrailMyrtlePark,11/18/2014 08:00:00 PM,48,-122,7,2,9
7725,ElliotBayTrailMyrtlePark,11/18/2014 09:00:00 PM,48,-122,5,1,6
7726,ElliotBayTrailMyrtlePark,11/18/2014 10:00:00 PM,48,-122,3,1,4
7727,ElliotBayTrailMyrtlePark,11/18/2014 11:00:00 PM,48,-122,2,1,3
7728,ElliotBayTrailMyrtlePark,11/19/2014 12:00:00 AM,48,-122,1,1,2
7729,ElliotBayTrailMyrtlePark,11/19/2014 01:00:00 AM,48,-122,0,0,0
7730,ElliotBayTrailMyrtlePark,11/19/2014 02:00:00 AM,48,-122,1,0,1
7731,ElliotBayTrailMyrtlePark,11/19/2014 03:00:00 AM,48,-122,0,0,0
7732,ElliotBayTrailMyrtlePark,11/19/2014 04:00:00 AM,48,-122,0,0,0
7733,ElliotBayTrailMyrtlePark,11/19/2014 05:00:00 AM,48,-122,3,11,14
7734,ElliotBayTrailMyrtlePark,11/19/2014 06:00:00 AM,48,-122,16,26,42
7735,ElliotBayTrailMyrtlePark,11/19/2014 07:00:00 AM,48,-122,29,58,87
7736,ElliotBayTrailMyrtlePark,11/19/2014 08:00:00 AM,48,-122,31,91,122
7737,ElliotBayTrailMyrtlePark,11/19/2014 09:00:00 AM,48,-122,17,54,71
7738,ElliotBayTrailMyrtlePark,11/19/2014 10:00:00 AM,48,-122,14,21,35
7739,ElliotBayTrailMyrtlePark,11/19/2014 11:00:00 AM,48,-122,7,19,26
7740,ElliotBayTrailMyrtlePark,11/19/2014 12:00:00 PM,48,-122,21,16,37
7741,ElliotBayTrailMyrtlePark,11/19/2014 01:00:00 PM,48,-122,13,14,27
7742,ElliotBayTrailMyrtlePark,11/19/2014 02:00:00 PM,48,-122,12,19,31
7743,ElliotBayTrailMyrtlePark,11/19/2014 03:00:00 PM,48,-122,24,19,43
7744,ElliotBayTrailMyrtlePark,11/19/2014 04:00:00 PM,48,-122,48,31,79
7745,ElliotBayTrailMyrtlePark,11/19/2014 05:00:00 PM,48,-122,113,31,144
7746,ElliotBayTrailMyrtlePark,11/19/2014 06:00:00 PM,48,-122,80,21,101
7747,ElliotBayTrailMyrtlePark,11/19/2014 07:00:00 PM,48,-122,19,12,31
7748,ElliotBayTrailMyrtlePark,11/19/2014 08:00:00 PM,48,-122,9,2,11
7749,ElliotBayTrailMyrtlePark,11/19/2014 09:00:00 PM,48,-122,10,2,12
7750,ElliotBayTrailMyrtlePark,11/19/2014 10:00:00 PM,48,-122,2,2,4
7751,ElliotBayTrailMyrtlePark,11/19/2014 11:00:00 PM,48,-122,0,0,0
7752,ElliotBayTrailMyrtlePark,11/20/2014 12:00:00 AM,48,-122,1,0,1
7753,ElliotBayTrailMyrtlePark,11/20/2014 01:00:00 AM,48,-122,0,0,0
7754,ElliotBayTrailMyrtlePark,11/20/2014 02:00:00 AM,48,-122,0,0,0
7755,ElliotBayTrailMyrtlePark,11/20/2014 03:00:00 AM,48,-122,2,0,2
7756,ElliotBayTrailMyrtlePark,11/20/2014 04:00:00 AM,48,-122,0,0,0
7757,ElliotBayTrailMyrtlePark,11/20/2014 05:00:00 AM,48,-122,3,6,9
7758,ElliotBayTrailMyrtlePark,11/20/2014 06:00:00 AM,48,-122,16,25,41
7759,ElliotBayTrailMyrtlePark,11/20/2014 07:00:00 AM,48,-122,23,50,73
7760,ElliotBayTrailMyrtlePark,11/20/2014 08:00:00 AM,48,-122,33,105,138
7761,ElliotBayTrailMyrtlePark,11/20/2014 09:00:00 AM,48,-122,11,54,65
7762,ElliotBayTrailMyrtlePark,11/20/2014 10:00:00 AM,48,-122,8,12,20
7763,ElliotBayTrailMyrtlePark,11/20/2014 11:00:00 AM,48,-122,11,12,23
7764,ElliotBayTrailMyrtlePark,11/20/2014 12:00:00 PM,48,-122,6,12,18
7765,ElliotBayTrailMyrtlePark,11/20/2014 01:00:00 PM,48,-122,14,12,26
7766,ElliotBayTrailMyrtlePark,11/20/2014 02:00:00 PM,48,-122,16,21,37
7767,ElliotBayTrailMyrtlePark,11/20/2014 03:00:00 PM,48,-122,17,26,43
7768,ElliotBayTrailMyrtlePark,11/20/2014 04:00:00 PM,48,-122,43,37,80
7769,ElliotBayTrailMyrtlePark,11/20/2014 05:00:00 PM,48,-122,99,23,122
7770,ElliotBayTrailMyrtlePark,11/20/2014 06:00:00 PM,48,-122,70,11,81
7771,ElliotBayTrailMyrtlePark,11/20/2014 07:00:00 PM,48,-122,25,8,33
7772,ElliotBayTrailMyrtlePark,11/20/2014 08:00:00 PM,48,-122,3,5,8
7773,ElliotBayTrailMyrtlePark,11/20/2014 09:00:00 PM,48,-122,7,2,9
7774,ElliotBayTrailMyrtlePark,11/20/2014 10:00:00 PM,48,-122,4,1,5
7775,ElliotBayTrailMyrtlePark,11/20/2014 11:00:00 PM,48,-122,4,1,5
7776,ElliotBayTrailMyrtlePark,11/21/2014 12:00:00 AM,48,-122,1,0,1
7777,ElliotBayTrailMyrtlePark,11/21/2014 01:00:00 AM,48,-122,0,0,0
7778,ElliotBayTrailMyrtlePark,11/21/2014 02:00:00 AM,48,-122,2,1,3
7779,ElliotBayTrailMyrtlePark,11/21/2014 03:00:00 AM,48,-122,0,0,0
7780,ElliotBayTrailMyrtlePark,11/21/2014 04:00:00 AM,48,-122,0,1,1
7781,ElliotBayTrailMyrtlePark,11/21/2014 05:00:00 AM,48,-122,4,10,14
7782,ElliotBayTrailMyrtlePark,11/21/2014 06:00:00 AM,48,-122,12,18,30
7783,ElliotBayTrailMyrtlePark,11/21/2014 07:00:00 AM,48,-122,19,42,61
7784,ElliotBayTrailMyrtlePark,11/21/2014 08:00:00 AM,48,-122,24,79,103
7785,ElliotBayTrailMyrtlePark,11/21/2014 09:00:00 AM,48,-122,9,37,46
7786,ElliotBayTrailMyrtlePark,11/21/2014 10:00:00 AM,48,-122,2,9,11
7787,ElliotBayTrailMyrtlePark,11/21/2014 11:00:00 AM,48,-122,6,7,13
7788,ElliotBayTrailMyrtlePark,11/21/2014 12:00:00 PM,48,-122,8,3,11
7789,ElliotBayTrailMyrtlePark,11/21/2014 01:00:00 PM,48,-122,2,4,6
7790,ElliotBayTrailMyrtlePark,11/21/2014 02:00:00 PM,48,-122,10,10,20
7791,ElliotBayTrailMyrtlePark,11/21/2014 03:00:00 PM,48,-122,14,8,22
7792,ElliotBayTrailMyrtlePark,11/21/2014 04:00:00 PM,48,-122,35,28,63
7793,ElliotBayTrailMyrtlePark,11/21/2014 05:00:00 PM,48,-122,91,20,111
7794,ElliotBayTrailMyrtlePark,11/21/2014 06:00:00 PM,48,-122,42,9,51
7795,ElliotBayTrailMyrtlePark,11/21/2014 07:00:00 PM,48,-122,16,7,23
7796,ElliotBayTrailMyrtlePark,11/21/2014 08:00:00 PM,48,-122,4,3,7
7797,ElliotBayTrailMyrtlePark,11/21/2014 09:00:00 PM,48,-122,6,4,10
7798,ElliotBayTrailMyrtlePark,11/21/2014 10:00:00 PM,48,-122,1,0,1
7799,ElliotBayTrailMyrtlePark,11/21/2014 11:00:00 PM,48,-122,2,2,4
7800,ElliotBayTrailMyrtlePark,11/22/2014 12:00:00 AM,48,-122,4,1,5
7801,ElliotBayTrailMyrtlePark,11/22/2014 01:00:00 AM,48,-122,2,0,2
7802,ElliotBayTrailMyrtlePark,11/22/2014 02:00:00 AM,48,-122,0,0,0
7803,ElliotBayTrailMyrtlePark,11/22/2014 03:00:00 AM,48,-122,0,0,0
7804,ElliotBayTrailMyrtlePark,11/22/2014 04:00:00 AM,48,-122,0,0,0
7805,ElliotBayTrailMyrtlePark,11/22/2014 05:00:00 AM,48,-122,1,1,2
7806,ElliotBayTrailMyrtlePark,11/22/2014 06:00:00 AM,48,-122,0,5,5
7807,ElliotBayTrailMyrtlePark,11/22/2014 07:00:00 AM,48,-122,2,9,11
7808,ElliotBayTrailMyrtlePark,11/22/2014 08:00:00 AM,48,-122,6,7,13
7809,ElliotBayTrailMyrtlePark,11/22/2014 09:00:00 AM,48,-122,7,8,15
7810,ElliotBayTrailMyrtlePark,11/22/2014 10:00:00 AM,48,-122,12,10,22
7811,ElliotBayTrailMyrtlePark,11/22/2014 11:00:00 AM,48,-122,6,17,23
7812,ElliotBayTrailMyrtlePark,11/22/2014 12:00:00 PM,48,-122,10,20,30
7813,ElliotBayTrailMyrtlePark,11/22/2014 01:00:00 PM,48,-122,17,12,29
7814,ElliotBayTrailMyrtlePark,11/22/2014 02:00:00 PM,48,-122,21,28,49
7815,ElliotBayTrailMyrtlePark,11/22/2014 03:00:00 PM,48,-122,33,38,71
7816,ElliotBayTrailMyrtlePark,11/22/2014 04:00:00 PM,48,-122,28,20,48
7817,ElliotBayTrailMyrtlePark,11/22/2014 05:00:00 PM,48,-122,17,5,22
7818,ElliotBayTrailMyrtlePark,11/22/2014 06:00:00 PM,48,-122,8,7,15
7819,ElliotBayTrailMyrtlePark,11/22/2014 07:00:00 PM,48,-122,3,2,5
7820,ElliotBayTrailMyrtlePark,11/22/2014 08:00:00 PM,48,-122,5,1,6
7821,ElliotBayTrailMyrtlePark,11/22/2014 09:00:00 PM,48,-122,3,5,8
7822,ElliotBayTrailMyrtlePark,11/22/2014 10:00:00 PM,48,-122,6,0,6
7823,ElliotBayTrailMyrtlePark,11/22/2014 11:00:00 PM,48,-122,2,0,2
7824,ElliotBayTrailMyrtlePark,11/23/2014 12:00:00 AM,48,-122,3,0,3
7825,ElliotBayTrailMyrtlePark,11/23/2014 01:00:00 AM,48,-122,0,0,0
7826,ElliotBayTrailMyrtlePark,11/23/2014 02:00:00 AM,48,-122,0,0,0
7827,ElliotBayTrailMyrtlePark,11/23/2014 03:00:00 AM,48,-122,1,1,2
7828,ElliotBayTrailMyrtlePark,11/23/2014 04:00:00 AM,48,-122,0,0,0
7829,ElliotBayTrailMyrtlePark,11/23/2014 05:00:00 AM,48,-122,0,0,0
7830,ElliotBayTrailMyrtlePark,11/23/2014 06:00:00 AM,48,-122,0,3,3
7831,ElliotBayTrailMyrtlePark,11/23/2014 07:00:00 AM,48,-122,0,2,2
7832,ElliotBayTrailMyrtlePark,11/23/2014 08:00:00 AM,48,-122,1,2,3
7833,ElliotBayTrailMyrtlePark,11/23/2014 09:00:00 AM,48,-122,10,3,13
7834,ElliotBayTrailMyrtlePark,11/23/2014 10:00:00 AM,48,-122,2,9,11
7835,ElliotBayTrailMyrtlePark,11/23/2014 11:00:00 AM,48,-122,2,14,16
7836,ElliotBayTrailMyrtlePark,11/23/2014 12:00:00 PM,48,-122,13,11,24
7837,ElliotBayTrailMyrtlePark,11/23/2014 01:00:00 PM,48,-122,23,12,35
7838,ElliotBayTrailMyrtlePark,11/23/2014 02:00:00 PM,48,-122,28,39,67
7839,ElliotBayTrailMyrtlePark,11/23/2014 03:00:00 PM,48,-122,31,18,49
7840,ElliotBayTrailMyrtlePark,11/23/2014 04:00:00 PM,48,-122,22,31,53
7841,ElliotBayTrailMyrtlePark,11/23/2014 05:00:00 PM,48,-122,7,13,20
7842,ElliotBayTrailMyrtlePark,11/23/2014 06:00:00 PM,48,-122,8,4,12
7843,ElliotBayTrailMyrtlePark,11/23/2014 07:00:00 PM,48,-122,4,2,6
7844,ElliotBayTrailMyrtlePark,11/23/2014 08:00:00 PM,48,-122,4,1,5
7845,ElliotBayTrailMyrtlePark,11/23/2014 09:00:00 PM,48,-122,2,4,6
7846,ElliotBayTrailMyrtlePark,11/23/2014 10:00:00 PM,48,-122,1,2,3
7847,ElliotBayTrailMyrtlePark,11/23/2014 11:00:00 PM,48,-122,2,2,4
7848,ElliotBayTrailMyrtlePark,11/24/2014 12:00:00 AM,48,-122,0,0,0
7849,ElliotBayTrailMyrtlePark,11/24/2014 01:00:00 AM,48,-122,0,0,0
7850,ElliotBayTrailMyrtlePark,11/24/2014 02:00:00 AM,48,-122,1,0,1
7851,ElliotBayTrailMyrtlePark,11/24/2014 03:00:00 AM,48,-122,0,0,0
7852,ElliotBayTrailMyrtlePark,11/24/2014 04:00:00 AM,48,-122,0,1,1
7853,ElliotBayTrailMyrtlePark,11/24/2014 05:00:00 AM,48,-122,4,8,12
7854,ElliotBayTrailMyrtlePark,11/24/2014 06:00:00 AM,48,-122,16,18,34
7855,ElliotBayTrailMyrtlePark,11/24/2014 07:00:00 AM,48,-122,29,59,88
7856,ElliotBayTrailMyrtlePark,11/24/2014 08:00:00 AM,48,-122,23,102,125
7857,ElliotBayTrailMyrtlePark,11/24/2014 09:00:00 AM,48,-122,19,57,76
7858,ElliotBayTrailMyrtlePark,11/24/2014 10:00:00 AM,48,-122,13,22,35
7859,ElliotBayTrailMyrtlePark,11/24/2014 11:00:00 AM,48,-122,11,8,19
7860,ElliotBayTrailMyrtlePark,11/24/2014 12:00:00 PM,48,-122,5,8,13
7861,ElliotBayTrailMyrtlePark,11/24/2014 01:00:00 PM,48,-122,10,6,16
7862,ElliotBayTrailMyrtlePark,11/24/2014 02:00:00 PM,48,-122,9,14,23
7863,ElliotBayTrailMyrtlePark,11/24/2014 03:00:00 PM,48,-122,19,20,39
7864,ElliotBayTrailMyrtlePark,11/24/2014 04:00:00 PM,48,-122,44,21,65
7865,ElliotBayTrailMyrtlePark,11/24/2014 05:00:00 PM,48,-122,101,23,124
7866,ElliotBayTrailMyrtlePark,11/24/2014 06:00:00 PM,48,-122,76,14,90
7867,ElliotBayTrailMyrtlePark,11/24/2014 07:00:00 PM,48,-122,20,8,28
7868,ElliotBayTrailMyrtlePark,11/24/2014 08:00:00 PM,48,-122,4,2,6
7869,ElliotBayTrailMyrtlePark,11/24/2014 09:00:00 PM,48,-122,6,4,10
7870,ElliotBayTrailMyrtlePark,11/24/2014 10:00:00 PM,48,-122,2,2,4
7871,ElliotBayTrailMyrtlePark,11/24/2014 11:00:00 PM,48,-122,1,0,1
7872,ElliotBayTrailMyrtlePark,11/25/2014 12:00:00 AM,48,-122,2,1,3
7873,ElliotBayTrailMyrtlePark,11/25/2014 01:00:00 AM,48,-122,0,1,1
7874,ElliotBayTrailMyrtlePark,11/25/2014 02:00:00 AM,48,-122,1,0,1
7875,ElliotBayTrailMyrtlePark,11/25/2014 03:00:00 AM,48,-122,1,0,1
7876,ElliotBayTrailMyrtlePark,11/25/2014 04:00:00 AM,48,-122,0,1,1
7877,ElliotBayTrailMyrtlePark,11/25/2014 05:00:00 AM,48,-122,3,6,9
7878,ElliotBayTrailMyrtlePark,11/25/2014 06:00:00 AM,48,-122,12,16,28
7879,ElliotBayTrailMyrtlePark,11/25/2014 07:00:00 AM,48,-122,19,48,67
7880,ElliotBayTrailMyrtlePark,11/25/2014 08:00:00 AM,48,-122,27,73,100
7881,ElliotBayTrailMyrtlePark,11/25/2014 09:00:00 AM,48,-122,14,34,48
7882,ElliotBayTrailMyrtlePark,11/25/2014 10:00:00 AM,48,-122,3,14,17
7883,ElliotBayTrailMyrtlePark,11/25/2014 11:00:00 AM,48,-122,10,7,17
7884,ElliotBayTrailMyrtlePark,11/25/2014 12:00:00 PM,48,-122,6,7,13
7885,ElliotBayTrailMyrtlePark,11/25/2014 01:00:00 PM,48,-122,8,6,14
7886,ElliotBayTrailMyrtlePark,11/25/2014 02:00:00 PM,48,-122,7,10,17
7887,ElliotBayTrailMyrtlePark,11/25/2014 03:00:00 PM,48,-122,9,8,17
7888,ElliotBayTrailMyrtlePark,11/25/2014 04:00:00 PM,48,-122,37,22,59
7889,ElliotBayTrailMyrtlePark,11/25/2014 05:00:00 PM,48,-122,76,20,96
7890,ElliotBayTrailMyrtlePark,11/25/2014 06:00:00 PM,48,-122,56,11,67
7891,ElliotBayTrailMyrtlePark,11/25/2014 07:00:00 PM,48,-122,29,12,41
7892,ElliotBayTrailMyrtlePark,11/25/2014 08:00:00 PM,48,-122,8,0,8
7893,ElliotBayTrailMyrtlePark,11/25/2014 09:00:00 PM,48,-122,4,3,7
7894,ElliotBayTrailMyrtlePark,11/25/2014 10:00:00 PM,48,-122,1,0,1
7895,ElliotBayTrailMyrtlePark,11/25/2014 11:00:00 PM,48,-122,5,0,5
7896,ElliotBayTrailMyrtlePark,11/26/2014 12:00:00 AM,48,-122,0,1,1
7897,ElliotBayTrailMyrtlePark,11/26/2014 01:00:00 AM,48,-122,0,0,0
7898,ElliotBayTrailMyrtlePark,11/26/2014 02:00:00 AM,48,-122,2,0,2
7899,ElliotBayTrailMyrtlePark,11/26/2014 03:00:00 AM,48,-122,1,0,1
7900,ElliotBayTrailMyrtlePark,11/26/2014 04:00:00 AM,48,-122,0,0,0
7901,ElliotBayTrailMyrtlePark,11/26/2014 05:00:00 AM,48,-122,5,5,10
7902,ElliotBayTrailMyrtlePark,11/26/2014 06:00:00 AM,48,-122,9,15,24
7903,ElliotBayTrailMyrtlePark,11/26/2014 07:00:00 AM,48,-122,29,39,68
7904,ElliotBayTrailMyrtlePark,11/26/2014 08:00:00 AM,48,-122,27,53,80
7905,ElliotBayTrailMyrtlePark,11/26/2014 09:00:00 AM,48,-122,8,34,42
7906,ElliotBayTrailMyrtlePark,11/26/2014 10:00:00 AM,48,-122,16,30,46
7907,ElliotBayTrailMyrtlePark,11/26/2014 11:00:00 AM,48,-122,14,22,36
7908,ElliotBayTrailMyrtlePark,11/26/2014 12:00:00 PM,48,-122,17,10,27
7909,ElliotBayTrailMyrtlePark,11/26/2014 01:00:00 PM,48,-122,26,12,38
7910,ElliotBayTrailMyrtlePark,11/26/2014 02:00:00 PM,48,-122,32,33,65
7911,ElliotBayTrailMyrtlePark,11/26/2014 03:00:00 PM,48,-122,35,27,62
7912,ElliotBayTrailMyrtlePark,11/26/2014 04:00:00 PM,48,-122,54,38,92
7913,ElliotBayTrailMyrtlePark,11/26/2014 05:00:00 PM,48,-122,64,19,83
7914,ElliotBayTrailMyrtlePark,11/26/2014 06:00:00 PM,48,-122,29,10,39
7915,ElliotBayTrailMyrtlePark,11/26/2014 07:00:00 PM,48,-122,22,4,26
7916,ElliotBayTrailMyrtlePark,11/26/2014 08:00:00 PM,48,-122,5,3,8
7917,ElliotBayTrailMyrtlePark,11/26/2014 09:00:00 PM,48,-122,2,1,3
7918,ElliotBayTrailMyrtlePark,11/26/2014 10:00:00 PM,48,-122,0,2,2
7919,ElliotBayTrailMyrtlePark,11/26/2014 11:00:00 PM,48,-122,1,0,1
7920,ElliotBayTrailMyrtlePark,11/27/2014 12:00:00 AM,48,-122,2,1,3
7921,ElliotBayTrailMyrtlePark,11/27/2014 01:00:00 AM,48,-122,0,0,0
7922,ElliotBayTrailMyrtlePark,11/27/2014 02:00:00 AM,48,-122,1,0,1
7923,ElliotBayTrailMyrtlePark,11/27/2014 03:00:00 AM,48,-122,0,0,0
7924,ElliotBayTrailMyrtlePark,11/27/2014 04:00:00 AM,48,-122,0,0,0
7925,ElliotBayTrailMyrtlePark,11/27/2014 05:00:00 AM,48,-122,0,1,1
7926,ElliotBayTrailMyrtlePark,11/27/2014 06:00:00 AM,48,-122,1,2,3
7927,ElliotBayTrailMyrtlePark,11/27/2014 07:00:00 AM,48,-122,5,4,9
7928,ElliotBayTrailMyrtlePark,11/27/2014 08:00:00 AM,48,-122,4,7,11
7929,ElliotBayTrailMyrtlePark,11/27/2014 09:00:00 AM,48,-122,15,13,28
7930,ElliotBayTrailMyrtlePark,11/27/2014 10:00:00 AM,48,-122,14,7,21
7931,ElliotBayTrailMyrtlePark,11/27/2014 11:00:00 AM,48,-122,18,21,39
7932,ElliotBayTrailMyrtlePark,11/27/2014 12:00:00 PM,48,-122,19,10,29
7933,ElliotBayTrailMyrtlePark,11/27/2014 01:00:00 PM,48,-122,10,8,18
7934,ElliotBayTrailMyrtlePark,11/27/2014 02:00:00 PM,48,-122,11,5,16
7935,ElliotBayTrailMyrtlePark,11/27/2014 03:00:00 PM,48,-122,10,1,11
7936,ElliotBayTrailMyrtlePark,11/27/2014 04:00:00 PM,48,-122,3,8,11
7937,ElliotBayTrailMyrtlePark,11/27/2014 05:00:00 PM,48,-122,4,2,6
7938,ElliotBayTrailMyrtlePark,11/27/2014 06:00:00 PM,48,-122,4,2,6
7939,ElliotBayTrailMyrtlePark,11/27/2014 07:00:00 PM,48,-122,1,1,2
7940,ElliotBayTrailMyrtlePark,11/27/2014 08:00:00 PM,48,-122,0,2,2
7941,ElliotBayTrailMyrtlePark,11/27/2014 09:00:00 PM,48,-122,0,0,0
7942,ElliotBayTrailMyrtlePark,11/27/2014 10:00:00 PM,48,-122,5,1,6
7943,ElliotBayTrailMyrtlePark,11/27/2014 11:00:00 PM,48,-122,0,1,1
7944,ElliotBayTrailMyrtlePark,11/28/2014 12:00:00 AM,48,-122,0,0,0
7945,ElliotBayTrailMyrtlePark,11/28/2014 01:00:00 AM,48,-122,1,0,1
7946,ElliotBayTrailMyrtlePark,11/28/2014 02:00:00 AM,48,-122,0,0,0
7947,ElliotBayTrailMyrtlePark,11/28/2014 03:00:00 AM,48,-122,0,0,0
7948,ElliotBayTrailMyrtlePark,11/28/2014 04:00:00 AM,48,-122,0,0,0
7949,ElliotBayTrailMyrtlePark,11/28/2014 05:00:00 AM,48,-122,1,2,3
7950,ElliotBayTrailMyrtlePark,11/28/2014 06:00:00 AM,48,-122,4,5,9
7951,ElliotBayTrailMyrtlePark,11/28/2014 07:00:00 AM,48,-122,5,10,15
7952,ElliotBayTrailMyrtlePark,11/28/2014 08:00:00 AM,48,-122,3,2,5
7953,ElliotBayTrailMyrtlePark,11/28/2014 09:00:00 AM,48,-122,2,5,7
7954,ElliotBayTrailMyrtlePark,11/28/2014 10:00:00 AM,48,-122,2,3,5
7955,ElliotBayTrailMyrtlePark,11/28/2014 11:00:00 AM,48,-122,1,0,1
7956,ElliotBayTrailMyrtlePark,11/28/2014 12:00:00 PM,48,-122,1,2,3
7957,ElliotBayTrailMyrtlePark,11/28/2014 01:00:00 PM,48,-122,3,2,5
7958,ElliotBayTrailMyrtlePark,11/28/2014 02:00:00 PM,48,-122,3,5,8
7959,ElliotBayTrailMyrtlePark,11/28/2014 03:00:00 PM,48,-122,7,4,11
7960,ElliotBayTrailMyrtlePark,11/28/2014 04:00:00 PM,48,-122,3,9,12
7961,ElliotBayTrailMyrtlePark,11/28/2014 05:00:00 PM,48,-122,5,5,10
7962,ElliotBayTrailMyrtlePark,11/28/2014 06:00:00 PM,48,-122,4,1,5
7963,ElliotBayTrailMyrtlePark,11/28/2014 07:00:00 PM,48,-122,1,1,2
7964,ElliotBayTrailMyrtlePark,11/28/2014 08:00:00 PM,48,-122,0,0,0
7965,ElliotBayTrailMyrtlePark,11/28/2014 09:00:00 PM,48,-122,0,1,1
7966,ElliotBayTrailMyrtlePark,11/28/2014 10:00:00 PM,48,-122,0,1,1
7967,ElliotBayTrailMyrtlePark,11/28/2014 11:00:00 PM,48,-122,5,0,5
7968,ElliotBayTrailMyrtlePark,11/29/2014 12:00:00 AM,48,-122,3,2,5
7969,ElliotBayTrailMyrtlePark,11/29/2014 01:00:00 AM,48,-122,0,0,0
7970,ElliotBayTrailMyrtlePark,11/29/2014 02:00:00 AM,48,-122,0,0,0
7971,ElliotBayTrailMyrtlePark,11/29/2014 03:00:00 AM,48,-122,0,0,0
7972,ElliotBayTrailMyrtlePark,11/29/2014 04:00:00 AM,48,-122,0,0,0
7973,ElliotBayTrailMyrtlePark,11/29/2014 05:00:00 AM,48,-122,0,0,0
7974,ElliotBayTrailMyrtlePark,11/29/2014 06:00:00 AM,48,-122,3,2,5
7975,ElliotBayTrailMyrtlePark,11/29/2014 07:00:00 AM,48,-122,0,2,2
7976,ElliotBayTrailMyrtlePark,11/29/2014 08:00:00 AM,48,-122,5,0,5
7977,ElliotBayTrailMyrtlePark,11/29/2014 09:00:00 AM,48,-122,1,6,7
7978,ElliotBayTrailMyrtlePark,11/29/2014 10:00:00 AM,48,-122,3,0,3
7979,ElliotBayTrailMyrtlePark,11/29/2014 11:00:00 AM,48,-122,0,0,0
7980,ElliotBayTrailMyrtlePark,11/29/2014 12:00:00 PM,48,-122,5,1,6
7981,ElliotBayTrailMyrtlePark,11/29/2014 01:00:00 PM,48,-122,10,10,20
7982,ElliotBayTrailMyrtlePark,11/29/2014 02:00:00 PM,48,-122,5,2,7
7983,ElliotBayTrailMyrtlePark,11/29/2014 03:00:00 PM,48,-122,3,7,10
7984,ElliotBayTrailMyrtlePark,11/29/2014 04:00:00 PM,48,-122,1,5,6
7985,ElliotBayTrailMyrtlePark,11/29/2014 05:00:00 PM,48,-122,1,2,3
7986,ElliotBayTrailMyrtlePark,11/29/2014 06:00:00 PM,48,-122,2,1,3
7987,ElliotBayTrailMyrtlePark,11/29/2014 07:00:00 PM,48,-122,1,0,1
7988,ElliotBayTrailMyrtlePark,11/29/2014 08:00:00 PM,48,-122,0,0,0
7989,ElliotBayTrailMyrtlePark,11/29/2014 09:00:00 PM,48,-122,0,2,2
7990,ElliotBayTrailMyrtlePark,11/29/2014 10:00:00 PM,48,-122,0,0,0
7991,ElliotBayTrailMyrtlePark,11/29/2014 11:00:00 PM,48,-122,3,0,3
7992,ElliotBayTrailMyrtlePark,11/30/2014 12:00:00 AM,48,-122,0,0,0
7993,ElliotBayTrailMyrtlePark,11/30/2014 01:00:00 AM,48,-122,2,0,2
7994,ElliotBayTrailMyrtlePark,11/30/2014 02:00:00 AM,48,-122,0,0,0
7995,ElliotBayTrailMyrtlePark,11/30/2014 03:00:00 AM,48,-122,0,0,0
7996,ElliotBayTrailMyrtlePark,11/30/2014 04:00:00 AM,48,-122,0,1,1
7997,ElliotBayTrailMyrtlePark,11/30/2014 05:00:00 AM,48,-122,0,1,1
7998,ElliotBayTrailMyrtlePark,11/30/2014 06:00:00 AM,48,-122,0,0,0
7999,ElliotBayTrailMyrtlePark,11/30/2014 07:00:00 AM,48,-122,1,1,2
8000,ElliotBayTrailMyrtlePark,11/30/2014 08:00:00 AM,48,-122,1,3,4
8001,ElliotBayTrailMyrtlePark,11/30/2014 09:00:00 AM,48,-122,1,2,3
8002,ElliotBayTrailMyrtlePark,11/30/2014 10:00:00 AM,48,-122,6,3,9
8003,ElliotBayTrailMyrtlePark,11/30/2014 11:00:00 AM,48,-122,11,10,21
8004,ElliotBayTrailMyrtlePark,11/30/2014 12:00:00 PM,48,-122,18,14,32
8005,ElliotBayTrailMyrtlePark,11/30/2014 01:00:00 PM,48,-122,4,15,19
8006,ElliotBayTrailMyrtlePark,11/30/2014 02:00:00 PM,48,-122,16,5,21
8007,ElliotBayTrailMyrtlePark,11/30/2014 03:00:00 PM,48,-122,11,20,31
8008,ElliotBayTrailMyrtlePark,11/30/2014 04:00:00 PM,48,-122,13,17,30
8009,ElliotBayTrailMyrtlePark,11/30/2014 05:00:00 PM,48,-122,4,7,11
8010,ElliotBayTrailMyrtlePark,11/30/2014 06:00:00 PM,48,-122,5,3,8
8011,ElliotBayTrailMyrtlePark,11/30/2014 07:00:00 PM,48,-122,2,1,3
8012,ElliotBayTrailMyrtlePark,11/30/2014 08:00:00 PM,48,-122,3,0,3
8013,ElliotBayTrailMyrtlePark,11/30/2014 09:00:00 PM,48,-122,10,2,12
8014,ElliotBayTrailMyrtlePark,11/30/2014 10:00:00 PM,48,-122,1,0,1
8015,ElliotBayTrailMyrtlePark,11/30/2014 11:00:00 PM,48,-122,0,0,0
8016,ElliotBayTrailMyrtlePark,12/01/2014 12:00:00 AM,48,-122,1,0,1
8017,ElliotBayTrailMyrtlePark,12/01/2014 01:00:00 AM,48,-122,0,0,0
8018,ElliotBayTrailMyrtlePark,12/01/2014 02:00:00 AM,48,-122,0,0,0
8019,ElliotBayTrailMyrtlePark,12/01/2014 03:00:00 AM,48,-122,0,0,0
8020,ElliotBayTrailMyrtlePark,12/01/2014 04:00:00 AM,48,-122,0,1,1
8021,ElliotBayTrailMyrtlePark,12/01/2014 05:00:00 AM,48,-122,7,6,13
8022,ElliotBayTrailMyrtlePark,12/01/2014 06:00:00 AM,48,-122,7,11,18
8023,ElliotBayTrailMyrtlePark,12/01/2014 07:00:00 AM,48,-122,22,34,56
8024,ElliotBayTrailMyrtlePark,12/01/2014 08:00:00 AM,48,-122,21,58,79
8025,ElliotBayTrailMyrtlePark,12/01/2014 09:00:00 AM,48,-122,11,49,60
8026,ElliotBayTrailMyrtlePark,12/01/2014 10:00:00 AM,48,-122,8,15,23
8027,ElliotBayTrailMyrtlePark,12/01/2014 11:00:00 AM,48,-122,8,14,22
8028,ElliotBayTrailMyrtlePark,12/01/2014 12:00:00 PM,48,-122,10,8,18
8029,ElliotBayTrailMyrtlePark,12/01/2014 01:00:00 PM,48,-122,7,5,12
8030,ElliotBayTrailMyrtlePark,12/01/2014 02:00:00 PM,48,-122,5,18,23
8031,ElliotBayTrailMyrtlePark,12/01/2014 03:00:00 PM,48,-122,14,9,23
8032,ElliotBayTrailMyrtlePark,12/01/2014 04:00:00 PM,48,-122,30,22,52
8033,ElliotBayTrailMyrtlePark,12/01/2014 05:00:00 PM,48,-122,79,19,98
8034,ElliotBayTrailMyrtlePark,12/01/2014 06:00:00 PM,48,-122,53,12,65
8035,ElliotBayTrailMyrtlePark,12/01/2014 07:00:00 PM,48,-122,16,5,21
8036,ElliotBayTrailMyrtlePark,12/01/2014 08:00:00 PM,48,-122,5,4,9
8037,ElliotBayTrailMyrtlePark,12/01/2014 09:00:00 PM,48,-122,0,0,0
8038,ElliotBayTrailMyrtlePark,12/01/2014 10:00:00 PM,48,-122,0,1,1
8039,ElliotBayTrailMyrtlePark,12/01/2014 11:00:00 PM,48,-122,4,0,4
8040,ElliotBayTrailMyrtlePark,12/02/2014 12:00:00 AM,48,-122,1,0,1
8041,ElliotBayTrailMyrtlePark,12/02/2014 01:00:00 AM,48,-122,1,0,1
8042,ElliotBayTrailMyrtlePark,12/02/2014 02:00:00 AM,48,-122,0,0,0
8043,ElliotBayTrailMyrtlePark,12/02/2014 03:00:00 AM,48,-122,0,0,0
8044,ElliotBayTrailMyrtlePark,12/02/2014 04:00:00 AM,48,-122,0,0,0
8045,ElliotBayTrailMyrtlePark,12/02/2014 05:00:00 AM,48,-122,5,11,16
8046,ElliotBayTrailMyrtlePark,12/02/2014 06:00:00 AM,48,-122,13,12,25
8047,ElliotBayTrailMyrtlePark,12/02/2014 07:00:00 AM,48,-122,18,36,54
8048,ElliotBayTrailMyrtlePark,12/02/2014 08:00:00 AM,48,-122,25,73,98
8049,ElliotBayTrailMyrtlePark,12/02/2014 09:00:00 AM,48,-122,14,51,65
8050,ElliotBayTrailMyrtlePark,12/02/2014 10:00:00 AM,48,-122,8,9,17
8051,ElliotBayTrailMyrtlePark,12/02/2014 11:00:00 AM,48,-122,15,11,26
8052,ElliotBayTrailMyrtlePark,12/02/2014 12:00:00 PM,48,-122,8,11,19
8053,ElliotBayTrailMyrtlePark,12/02/2014 01:00:00 PM,48,-122,11,12,23
8054,ElliotBayTrailMyrtlePark,12/02/2014 02:00:00 PM,48,-122,10,15,25
8055,ElliotBayTrailMyrtlePark,12/02/2014 03:00:00 PM,48,-122,12,13,25
8056,ElliotBayTrailMyrtlePark,12/02/2014 04:00:00 PM,48,-122,33,19,52
8057,ElliotBayTrailMyrtlePark,12/02/2014 05:00:00 PM,48,-122,76,31,107
8058,ElliotBayTrailMyrtlePark,12/02/2014 06:00:00 PM,48,-122,72,6,78
8059,ElliotBayTrailMyrtlePark,12/02/2014 07:00:00 PM,48,-122,24,3,27
8060,ElliotBayTrailMyrtlePark,12/02/2014 08:00:00 PM,48,-122,9,1,10
8061,ElliotBayTrailMyrtlePark,12/02/2014 09:00:00 PM,48,-122,1,0,1
8062,ElliotBayTrailMyrtlePark,12/02/2014 10:00:00 PM,48,-122,3,3,6
8063,ElliotBayTrailMyrtlePark,12/02/2014 11:00:00 PM,48,-122,1,0,1
8064,ElliotBayTrailMyrtlePark,12/03/2014 12:00:00 AM,48,-122,1,0,1
8065,ElliotBayTrailMyrtlePark,12/03/2014 01:00:00 AM,48,-122,0,2,2
8066,ElliotBayTrailMyrtlePark,12/03/2014 02:00:00 AM,48,-122,4,0,4
8067,ElliotBayTrailMyrtlePark,12/03/2014 03:00:00 AM,48,-122,0,0,0
8068,ElliotBayTrailMyrtlePark,12/03/2014 04:00:00 AM,48,-122,0,0,0
8069,ElliotBayTrailMyrtlePark,12/03/2014 05:00:00 AM,48,-122,3,9,12
8070,ElliotBayTrailMyrtlePark,12/03/2014 06:00:00 AM,48,-122,13,18,31
8071,ElliotBayTrailMyrtlePark,12/03/2014 07:00:00 AM,48,-122,28,36,64
8072,ElliotBayTrailMyrtlePark,12/03/2014 08:00:00 AM,48,-122,25,100,125
8073,ElliotBayTrailMyrtlePark,12/03/2014 09:00:00 AM,48,-122,13,51,64
8074,ElliotBayTrailMyrtlePark,12/03/2014 10:00:00 AM,48,-122,8,23,31
8075,ElliotBayTrailMyrtlePark,12/03/2014 11:00:00 AM,48,-122,10,14,24
8076,ElliotBayTrailMyrtlePark,12/03/2014 12:00:00 PM,48,-122,12,15,27
8077,ElliotBayTrailMyrtlePark,12/03/2014 01:00:00 PM,48,-122,5,13,18
8078,ElliotBayTrailMyrtlePark,12/03/2014 02:00:00 PM,48,-122,17,17,34
8079,ElliotBayTrailMyrtlePark,12/03/2014 03:00:00 PM,48,-122,20,19,39
8080,ElliotBayTrailMyrtlePark,12/03/2014 04:00:00 PM,48,-122,47,21,68
8081,ElliotBayTrailMyrtlePark,12/03/2014 05:00:00 PM,48,-122,89,25,114
8082,ElliotBayTrailMyrtlePark,12/03/2014 06:00:00 PM,48,-122,78,10,88
8083,ElliotBayTrailMyrtlePark,12/03/2014 07:00:00 PM,48,-122,20,7,27
8084,ElliotBayTrailMyrtlePark,12/03/2014 08:00:00 PM,48,-122,6,6,12
8085,ElliotBayTrailMyrtlePark,12/03/2014 09:00:00 PM,48,-122,6,2,8
8086,ElliotBayTrailMyrtlePark,12/03/2014 10:00:00 PM,48,-122,2,0,2
8087,ElliotBayTrailMyrtlePark,12/03/2014 11:00:00 PM,48,-122,0,0,0
8088,ElliotBayTrailMyrtlePark,12/04/2014 12:00:00 AM,48,-122,0,1,1
8089,ElliotBayTrailMyrtlePark,12/04/2014 01:00:00 AM,48,-122,1,0,1
8090,ElliotBayTrailMyrtlePark,12/04/2014 02:00:00 AM,48,-122,1,0,1
8091,ElliotBayTrailMyrtlePark,12/04/2014 03:00:00 AM,48,-122,1,0,1
8092,ElliotBayTrailMyrtlePark,12/04/2014 04:00:00 AM,48,-122,1,0,1
8093,ElliotBayTrailMyrtlePark,12/04/2014 05:00:00 AM,48,-122,6,4,10
8094,ElliotBayTrailMyrtlePark,12/04/2014 06:00:00 AM,48,-122,11,21,32
8095,ElliotBayTrailMyrtlePark,12/04/2014 07:00:00 AM,48,-122,25,52,77
8096,ElliotBayTrailMyrtlePark,12/04/2014 08:00:00 AM,48,-122,33,71,104
8097,ElliotBayTrailMyrtlePark,12/04/2014 09:00:00 AM,48,-122,15,50,65
8098,ElliotBayTrailMyrtlePark,12/04/2014 10:00:00 AM,48,-122,5,13,18
8099,ElliotBayTrailMyrtlePark,12/04/2014 11:00:00 AM,48,-122,8,9,17
8100,ElliotBayTrailMyrtlePark,12/04/2014 12:00:00 PM,48,-122,14,3,17
8101,ElliotBayTrailMyrtlePark,12/04/2014 01:00:00 PM,48,-122,6,11,17
8102,ElliotBayTrailMyrtlePark,12/04/2014 02:00:00 PM,48,-122,5,8,13
8103,ElliotBayTrailMyrtlePark,12/04/2014 03:00:00 PM,48,-122,16,9,25
8104,ElliotBayTrailMyrtlePark,12/04/2014 04:00:00 PM,48,-122,37,24,61
8105,ElliotBayTrailMyrtlePark,12/04/2014 05:00:00 PM,48,-122,88,20,108
8106,ElliotBayTrailMyrtlePark,12/04/2014 06:00:00 PM,48,-122,61,18,79
8107,ElliotBayTrailMyrtlePark,12/04/2014 07:00:00 PM,48,-122,18,9,27
8108,ElliotBayTrailMyrtlePark,12/04/2014 08:00:00 PM,48,-122,4,2,6
8109,ElliotBayTrailMyrtlePark,12/04/2014 09:00:00 PM,48,-122,4,2,6
8110,ElliotBayTrailMyrtlePark,12/04/2014 10:00:00 PM,48,-122,2,0,2
8111,ElliotBayTrailMyrtlePark,12/04/2014 11:00:00 PM,48,-122,1,0,1
8112,ElliotBayTrailMyrtlePark,12/05/2014 12:00:00 AM,48,-122,3,1,4
8113,ElliotBayTrailMyrtlePark,12/05/2014 01:00:00 AM,48,-122,1,1,2
8114,ElliotBayTrailMyrtlePark,12/05/2014 02:00:00 AM,48,-122,1,0,1
8115,ElliotBayTrailMyrtlePark,12/05/2014 03:00:00 AM,48,-122,0,0,0
8116,ElliotBayTrailMyrtlePark,12/05/2014 04:00:00 AM,48,-122,1,0,1
8117,ElliotBayTrailMyrtlePark,12/05/2014 05:00:00 AM,48,-122,2,10,12
8118,ElliotBayTrailMyrtlePark,12/05/2014 06:00:00 AM,48,-122,10,17,27
8119,ElliotBayTrailMyrtlePark,12/05/2014 07:00:00 AM,48,-122,27,40,67
8120,ElliotBayTrailMyrtlePark,12/05/2014 08:00:00 AM,48,-122,21,62,83
8121,ElliotBayTrailMyrtlePark,12/05/2014 09:00:00 AM,48,-122,8,34,42
8122,ElliotBayTrailMyrtlePark,12/05/2014 10:00:00 AM,48,-122,5,10,15
8123,ElliotBayTrailMyrtlePark,12/05/2014 11:00:00 AM,48,-122,3,4,7
8124,ElliotBayTrailMyrtlePark,12/05/2014 12:00:00 PM,48,-122,6,7,13
8125,ElliotBayTrailMyrtlePark,12/05/2014 01:00:00 PM,48,-122,6,8,14
8126,ElliotBayTrailMyrtlePark,12/05/2014 02:00:00 PM,48,-122,10,12,22
8127,ElliotBayTrailMyrtlePark,12/05/2014 03:00:00 PM,48,-122,15,8,23
8128,ElliotBayTrailMyrtlePark,12/05/2014 04:00:00 PM,48,-122,31,30,61
8129,ElliotBayTrailMyrtlePark,12/05/2014 05:00:00 PM,48,-122,72,24,96
8130,ElliotBayTrailMyrtlePark,12/05/2014 06:00:00 PM,48,-122,40,9,49
8131,ElliotBayTrailMyrtlePark,12/05/2014 07:00:00 PM,48,-122,22,3,25
8132,ElliotBayTrailMyrtlePark,12/05/2014 08:00:00 PM,48,-122,3,3,6
8133,ElliotBayTrailMyrtlePark,12/05/2014 09:00:00 PM,48,-122,5,0,5
8134,ElliotBayTrailMyrtlePark,12/05/2014 10:00:00 PM,48,-122,3,1,4
8135,ElliotBayTrailMyrtlePark,12/05/2014 11:00:00 PM,48,-122,2,0,2
8136,ElliotBayTrailMyrtlePark,12/06/2014 12:00:00 AM,48,-122,2,1,3
8137,ElliotBayTrailMyrtlePark,12/06/2014 01:00:00 AM,48,-122,2,0,2
8138,ElliotBayTrailMyrtlePark,12/06/2014 02:00:00 AM,48,-122,0,0,0
8139,ElliotBayTrailMyrtlePark,12/06/2014 03:00:00 AM,48,-122,0,0,0
8140,ElliotBayTrailMyrtlePark,12/06/2014 04:00:00 AM,48,-122,0,0,0
8141,ElliotBayTrailMyrtlePark,12/06/2014 05:00:00 AM,48,-122,0,1,1
8142,ElliotBayTrailMyrtlePark,12/06/2014 06:00:00 AM,48,-122,0,4,4
8143,ElliotBayTrailMyrtlePark,12/06/2014 07:00:00 AM,48,-122,2,5,7
8144,ElliotBayTrailMyrtlePark,12/06/2014 08:00:00 AM,48,-122,2,6,8
8145,ElliotBayTrailMyrtlePark,12/06/2014 09:00:00 AM,48,-122,7,10,17
8146,ElliotBayTrailMyrtlePark,12/06/2014 10:00:00 AM,48,-122,5,7,12
8147,ElliotBayTrailMyrtlePark,12/06/2014 11:00:00 AM,48,-122,14,6,20
8148,ElliotBayTrailMyrtlePark,12/06/2014 12:00:00 PM,48,-122,11,12,23
8149,ElliotBayTrailMyrtlePark,12/06/2014 01:00:00 PM,48,-122,19,5,24
8150,ElliotBayTrailMyrtlePark,12/06/2014 02:00:00 PM,48,-122,19,21,40
8151,ElliotBayTrailMyrtlePark,12/06/2014 03:00:00 PM,48,-122,29,21,50
8152,ElliotBayTrailMyrtlePark,12/06/2014 04:00:00 PM,48,-122,15,20,35
8153,ElliotBayTrailMyrtlePark,12/06/2014 05:00:00 PM,48,-122,9,7,16
8154,ElliotBayTrailMyrtlePark,12/06/2014 06:00:00 PM,48,-122,8,5,13
8155,ElliotBayTrailMyrtlePark,12/06/2014 07:00:00 PM,48,-122,5,3,8
8156,ElliotBayTrailMyrtlePark,12/06/2014 08:00:00 PM,48,-122,1,0,1
8157,ElliotBayTrailMyrtlePark,12/06/2014 09:00:00 PM,48,-122,1,0,1
8158,ElliotBayTrailMyrtlePark,12/06/2014 10:00:00 PM,48,-122,4,0,4
8159,ElliotBayTrailMyrtlePark,12/06/2014 11:00:00 PM,48,-122,2,3,5
8160,ElliotBayTrailMyrtlePark,12/07/2014 12:00:00 AM,48,-122,3,1,4
8161,ElliotBayTrailMyrtlePark,12/07/2014 01:00:00 AM,48,-122,0,0,0
8162,ElliotBayTrailMyrtlePark,12/07/2014 02:00:00 AM,48,-122,0,0,0
8163,ElliotBayTrailMyrtlePark,12/07/2014 03:00:00 AM,48,-122,1,0,1
8164,ElliotBayTrailMyrtlePark,12/07/2014 04:00:00 AM,48,-122,0,0,0
8165,ElliotBayTrailMyrtlePark,12/07/2014 05:00:00 AM,48,-122,0,1,1
8166,ElliotBayTrailMyrtlePark,12/07/2014 06:00:00 AM,48,-122,0,0,0
8167,ElliotBayTrailMyrtlePark,12/07/2014 07:00:00 AM,48,-122,2,4,6
8168,ElliotBayTrailMyrtlePark,12/07/2014 08:00:00 AM,48,-122,1,5,6
8169,ElliotBayTrailMyrtlePark,12/07/2014 09:00:00 AM,48,-122,19,7,26
8170,ElliotBayTrailMyrtlePark,12/07/2014 10:00:00 AM,48,-122,16,22,38
8171,ElliotBayTrailMyrtlePark,12/07/2014 11:00:00 AM,48,-122,26,30,56
8172,ElliotBayTrailMyrtlePark,12/07/2014 12:00:00 PM,48,-122,34,35,69
8173,ElliotBayTrailMyrtlePark,12/07/2014 01:00:00 PM,48,-122,43,25,68
8174,ElliotBayTrailMyrtlePark,12/07/2014 02:00:00 PM,48,-122,33,36,69
8175,ElliotBayTrailMyrtlePark,12/07/2014 03:00:00 PM,48,-122,20,30,50
8176,ElliotBayTrailMyrtlePark,12/07/2014 04:00:00 PM,48,-122,24,25,49
8177,ElliotBayTrailMyrtlePark,12/07/2014 05:00:00 PM,48,-122,10,7,17
8178,ElliotBayTrailMyrtlePark,12/07/2014 06:00:00 PM,48,-122,7,3,10
8179,ElliotBayTrailMyrtlePark,12/07/2014 07:00:00 PM,48,-122,7,8,15
8180,ElliotBayTrailMyrtlePark,12/07/2014 08:00:00 PM,48,-122,3,4,7
8181,ElliotBayTrailMyrtlePark,12/07/2014 09:00:00 PM,48,-122,3,5,8
8182,ElliotBayTrailMyrtlePark,12/07/2014 10:00:00 PM,48,-122,2,1,3
8183,ElliotBayTrailMyrtlePark,12/07/2014 11:00:00 PM,48,-122,6,0,6
8184,ElliotBayTrailMyrtlePark,12/08/2014 12:00:00 AM,48,-122,0,1,1
8185,ElliotBayTrailMyrtlePark,12/08/2014 01:00:00 AM,48,-122,4,0,4
8186,ElliotBayTrailMyrtlePark,12/08/2014 02:00:00 AM,48,-122,1,0,1
8187,ElliotBayTrailMyrtlePark,12/08/2014 03:00:00 AM,48,-122,0,0,0
8188,ElliotBayTrailMyrtlePark,12/08/2014 04:00:00 AM,48,-122,0,0,0
8189,ElliotBayTrailMyrtlePark,12/08/2014 05:00:00 AM,48,-122,3,8,11
8190,ElliotBayTrailMyrtlePark,12/08/2014 06:00:00 AM,48,-122,15,20,35
8191,ElliotBayTrailMyrtlePark,12/08/2014 07:00:00 AM,48,-122,33,49,82
8192,ElliotBayTrailMyrtlePark,12/08/2014 08:00:00 AM,48,-122,19,115,134
8193,ElliotBayTrailMyrtlePark,12/08/2014 09:00:00 AM,48,-122,12,72,84
8194,ElliotBayTrailMyrtlePark,12/08/2014 10:00:00 AM,48,-122,13,24,37
8195,ElliotBayTrailMyrtlePark,12/08/2014 11:00:00 AM,48,-122,17,18,35
8196,ElliotBayTrailMyrtlePark,12/08/2014 12:00:00 PM,48,-122,16,23,39
8197,ElliotBayTrailMyrtlePark,12/08/2014 01:00:00 PM,48,-122,13,14,27
8198,ElliotBayTrailMyrtlePark,12/08/2014 02:00:00 PM,48,-122,12,18,30
8199,ElliotBayTrailMyrtlePark,12/08/2014 03:00:00 PM,48,-122,16,16,32
8200,ElliotBayTrailMyrtlePark,12/08/2014 04:00:00 PM,48,-122,44,25,69
8201,ElliotBayTrailMyrtlePark,12/08/2014 05:00:00 PM,48,-122,108,25,133
8202,ElliotBayTrailMyrtlePark,12/08/2014 06:00:00 PM,48,-122,84,9,93
8203,ElliotBayTrailMyrtlePark,12/08/2014 07:00:00 PM,48,-122,24,7,31
8204,ElliotBayTrailMyrtlePark,12/08/2014 08:00:00 PM,48,-122,4,2,6
8205,ElliotBayTrailMyrtlePark,12/08/2014 09:00:00 PM,48,-122,7,1,8
8206,ElliotBayTrailMyrtlePark,12/08/2014 10:00:00 PM,48,-122,1,0,1
8207,ElliotBayTrailMyrtlePark,12/08/2014 11:00:00 PM,48,-122,3,0,3
8208,ElliotBayTrailMyrtlePark,12/09/2014 12:00:00 AM,48,-122,1,0,1
8209,ElliotBayTrailMyrtlePark,12/09/2014 01:00:00 AM,48,-122,0,0,0
8210,ElliotBayTrailMyrtlePark,12/09/2014 02:00:00 AM,48,-122,1,0,1
8211,ElliotBayTrailMyrtlePark,12/09/2014 03:00:00 AM,48,-122,1,0,1
8212,ElliotBayTrailMyrtlePark,12/09/2014 04:00:00 AM,48,-122,0,0,0
8213,ElliotBayTrailMyrtlePark,12/09/2014 05:00:00 AM,48,-122,2,7,9
8214,ElliotBayTrailMyrtlePark,12/09/2014 06:00:00 AM,48,-122,11,14,25
8215,ElliotBayTrailMyrtlePark,12/09/2014 07:00:00 AM,48,-122,27,38,65
8216,ElliotBayTrailMyrtlePark,12/09/2014 08:00:00 AM,48,-122,22,82,104
8217,ElliotBayTrailMyrtlePark,12/09/2014 09:00:00 AM,48,-122,17,40,57
8218,ElliotBayTrailMyrtlePark,12/09/2014 10:00:00 AM,48,-122,7,18,25
8219,ElliotBayTrailMyrtlePark,12/09/2014 11:00:00 AM,48,-122,5,4,9
8220,ElliotBayTrailMyrtlePark,12/09/2014 12:00:00 PM,48,-122,4,3,7
8221,ElliotBayTrailMyrtlePark,12/09/2014 01:00:00 PM,48,-122,6,6,12
8222,ElliotBayTrailMyrtlePark,12/09/2014 02:00:00 PM,48,-122,11,20,31
8223,ElliotBayTrailMyrtlePark,12/09/2014 03:00:00 PM,48,-122,18,16,34
8224,ElliotBayTrailMyrtlePark,12/09/2014 04:00:00 PM,48,-122,43,22,65
8225,ElliotBayTrailMyrtlePark,12/09/2014 05:00:00 PM,48,-122,96,27,123
8226,ElliotBayTrailMyrtlePark,12/09/2014 06:00:00 PM,48,-122,59,10,69
8227,ElliotBayTrailMyrtlePark,12/09/2014 07:00:00 PM,48,-122,18,5,23
8228,ElliotBayTrailMyrtlePark,12/09/2014 08:00:00 PM,48,-122,6,1,7
8229,ElliotBayTrailMyrtlePark,12/09/2014 09:00:00 PM,48,-122,8,3,11
8230,ElliotBayTrailMyrtlePark,12/09/2014 10:00:00 PM,48,-122,5,0,5
8231,ElliotBayTrailMyrtlePark,12/09/2014 11:00:00 PM,48,-122,1,0,1
8232,ElliotBayTrailMyrtlePark,12/10/2014 12:00:00 AM,48,-122,1,0,1
8233,ElliotBayTrailMyrtlePark,12/10/2014 01:00:00 AM,48,-122,2,0,2
8234,ElliotBayTrailMyrtlePark,12/10/2014 02:00:00 AM,48,-122,2,0,2
8235,ElliotBayTrailMyrtlePark,12/10/2014 03:00:00 AM,48,-122,0,0,0
8236,ElliotBayTrailMyrtlePark,12/10/2014 04:00:00 AM,48,-122,0,0,0
8237,ElliotBayTrailMyrtlePark,12/10/2014 05:00:00 AM,48,-122,4,10,14
8238,ElliotBayTrailMyrtlePark,12/10/2014 06:00:00 AM,48,-122,13,24,37
8239,ElliotBayTrailMyrtlePark,12/10/2014 07:00:00 AM,48,-122,26,44,70
8240,ElliotBayTrailMyrtlePark,12/10/2014 08:00:00 AM,48,-122,26,73,99
8241,ElliotBayTrailMyrtlePark,12/10/2014 09:00:00 AM,48,-122,20,51,71
8242,ElliotBayTrailMyrtlePark,12/10/2014 10:00:00 AM,48,-122,10,15,25
8243,ElliotBayTrailMyrtlePark,12/10/2014 11:00:00 AM,48,-122,3,6,9
8244,ElliotBayTrailMyrtlePark,12/10/2014 12:00:00 PM,48,-122,5,4,9
8245,ElliotBayTrailMyrtlePark,12/10/2014 01:00:00 PM,48,-122,3,4,7
8246,ElliotBayTrailMyrtlePark,12/10/2014 02:00:00 PM,48,-122,6,9,15
8247,ElliotBayTrailMyrtlePark,12/10/2014 03:00:00 PM,48,-122,7,8,15
8248,ElliotBayTrailMyrtlePark,12/10/2014 04:00:00 PM,48,-122,32,15,47
8249,ElliotBayTrailMyrtlePark,12/10/2014 05:00:00 PM,48,-122,79,25,104
8250,ElliotBayTrailMyrtlePark,12/10/2014 06:00:00 PM,48,-122,63,10,73
8251,ElliotBayTrailMyrtlePark,12/10/2014 07:00:00 PM,48,-122,24,0,24
8252,ElliotBayTrailMyrtlePark,12/10/2014 08:00:00 PM,48,-122,9,0,9
8253,ElliotBayTrailMyrtlePark,12/10/2014 09:00:00 PM,48,-122,4,1,5
8254,ElliotBayTrailMyrtlePark,12/10/2014 10:00:00 PM,48,-122,0,1,1
8255,ElliotBayTrailMyrtlePark,12/10/2014 11:00:00 PM,48,-122,1,0,1
8256,ElliotBayTrailMyrtlePark,12/11/2014 12:00:00 AM,48,-122,0,0,0
8257,ElliotBayTrailMyrtlePark,12/11/2014 01:00:00 AM,48,-122,0,1,1
8258,ElliotBayTrailMyrtlePark,12/11/2014 02:00:00 AM,48,-122,1,0,1
8259,ElliotBayTrailMyrtlePark,12/11/2014 03:00:00 AM,48,-122,1,0,1
8260,ElliotBayTrailMyrtlePark,12/11/2014 04:00:00 AM,48,-122,0,0,0
8261,ElliotBayTrailMyrtlePark,12/11/2014 05:00:00 AM,48,-122,6,7,13
8262,ElliotBayTrailMyrtlePark,12/11/2014 06:00:00 AM,48,-122,6,13,19
8263,ElliotBayTrailMyrtlePark,12/11/2014 07:00:00 AM,48,-122,25,38,63
8264,ElliotBayTrailMyrtlePark,12/11/2014 08:00:00 AM,48,-122,33,80,113
8265,ElliotBayTrailMyrtlePark,12/11/2014 09:00:00 AM,48,-122,18,44,62
8266,ElliotBayTrailMyrtlePark,12/11/2014 10:00:00 AM,48,-122,9,9,18
8267,ElliotBayTrailMyrtlePark,12/11/2014 11:00:00 AM,48,-122,4,6,10
8268,ElliotBayTrailMyrtlePark,12/11/2014 12:00:00 PM,48,-122,6,3,9
8269,ElliotBayTrailMyrtlePark,12/11/2014 01:00:00 PM,48,-122,1,4,5
8270,ElliotBayTrailMyrtlePark,12/11/2014 02:00:00 PM,48,-122,7,9,16
8271,ElliotBayTrailMyrtlePark,12/11/2014 03:00:00 PM,48,-122,17,15,32
8272,ElliotBayTrailMyrtlePark,12/11/2014 04:00:00 PM,48,-122,41,28,69
8273,ElliotBayTrailMyrtlePark,12/11/2014 05:00:00 PM,48,-122,58,21,79
8274,ElliotBayTrailMyrtlePark,12/11/2014 06:00:00 PM,48,-122,51,10,61
8275,ElliotBayTrailMyrtlePark,12/11/2014 07:00:00 PM,48,-122,16,4,20
8276,ElliotBayTrailMyrtlePark,12/11/2014 08:00:00 PM,48,-122,11,1,12
8277,ElliotBayTrailMyrtlePark,12/11/2014 09:00:00 PM,48,-122,3,1,4
8278,ElliotBayTrailMyrtlePark,12/11/2014 10:00:00 PM,48,-122,1,19,20
8279,ElliotBayTrailMyrtlePark,12/11/2014 11:00:00 PM,48,-122,3,0,3
8280,ElliotBayTrailMyrtlePark,12/12/2014 12:00:00 AM,48,-122,0,0,0
8281,ElliotBayTrailMyrtlePark,12/12/2014 01:00:00 AM,48,-122,0,0,0
8282,ElliotBayTrailMyrtlePark,12/12/2014 02:00:00 AM,48,-122,1,0,1
8283,ElliotBayTrailMyrtlePark,12/12/2014 03:00:00 AM,48,-122,1,0,1
8284,ElliotBayTrailMyrtlePark,12/12/2014 04:00:00 AM,48,-122,0,0,0
8285,ElliotBayTrailMyrtlePark,12/12/2014 05:00:00 AM,48,-122,5,10,15
8286,ElliotBayTrailMyrtlePark,12/12/2014 06:00:00 AM,48,-122,14,9,23
8287,ElliotBayTrailMyrtlePark,12/12/2014 07:00:00 AM,48,-122,23,40,63
8288,ElliotBayTrailMyrtlePark,12/12/2014 08:00:00 AM,48,-122,22,83,105
8289,ElliotBayTrailMyrtlePark,12/12/2014 09:00:00 AM,48,-122,18,44,62
8290,ElliotBayTrailMyrtlePark,12/12/2014 10:00:00 AM,48,-122,8,22,30
8291,ElliotBayTrailMyrtlePark,12/12/2014 11:00:00 AM,48,-122,13,8,21
8292,ElliotBayTrailMyrtlePark,12/12/2014 12:00:00 PM,48,-122,9,15,24
8293,ElliotBayTrailMyrtlePark,12/12/2014 01:00:00 PM,48,-122,14,13,27
8294,ElliotBayTrailMyrtlePark,12/12/2014 02:00:00 PM,48,-122,13,13,26
8295,ElliotBayTrailMyrtlePark,12/12/2014 03:00:00 PM,48,-122,41,32,73
8296,ElliotBayTrailMyrtlePark,12/12/2014 04:00:00 PM,48,-122,44,30,74
8297,ElliotBayTrailMyrtlePark,12/12/2014 05:00:00 PM,48,-122,85,35,120
8298,ElliotBayTrailMyrtlePark,12/12/2014 06:00:00 PM,48,-122,64,11,75
8299,ElliotBayTrailMyrtlePark,12/12/2014 07:00:00 PM,48,-122,20,8,28
8300,ElliotBayTrailMyrtlePark,12/12/2014 08:00:00 PM,48,-122,5,1,6
8301,ElliotBayTrailMyrtlePark,12/12/2014 09:00:00 PM,48,-122,1,1,2
8302,ElliotBayTrailMyrtlePark,12/12/2014 10:00:00 PM,48,-122,3,1,4
8303,ElliotBayTrailMyrtlePark,12/12/2014 11:00:00 PM,48,-122,6,2,8
8304,ElliotBayTrailMyrtlePark,12/13/2014 12:00:00 AM,48,-122,2,3,5
8305,ElliotBayTrailMyrtlePark,12/13/2014 01:00:00 AM,48,-122,2,0,2
8306,ElliotBayTrailMyrtlePark,12/13/2014 02:00:00 AM,48,-122,1,0,1
8307,ElliotBayTrailMyrtlePark,12/13/2014 03:00:00 AM,48,-122,0,0,0
8308,ElliotBayTrailMyrtlePark,12/13/2014 04:00:00 AM,48,-122,0,1,1
8309,ElliotBayTrailMyrtlePark,12/13/2014 05:00:00 AM,48,-122,1,1,2
8310,ElliotBayTrailMyrtlePark,12/13/2014 06:00:00 AM,48,-122,1,4,5
8311,ElliotBayTrailMyrtlePark,12/13/2014 07:00:00 AM,48,-122,5,8,13
8312,ElliotBayTrailMyrtlePark,12/13/2014 08:00:00 AM,48,-122,7,7,14
8313,ElliotBayTrailMyrtlePark,12/13/2014 09:00:00 AM,48,-122,4,16,20
8314,ElliotBayTrailMyrtlePark,12/13/2014 10:00:00 AM,48,-122,17,19,36
8315,ElliotBayTrailMyrtlePark,12/13/2014 11:00:00 AM,48,-122,26,25,51
8316,ElliotBayTrailMyrtlePark,12/13/2014 12:00:00 PM,48,-122,31,30,61
8317,ElliotBayTrailMyrtlePark,12/13/2014 01:00:00 PM,48,-122,51,30,81
8318,ElliotBayTrailMyrtlePark,12/13/2014 02:00:00 PM,48,-122,45,39,84
8319,ElliotBayTrailMyrtlePark,12/13/2014 03:00:00 PM,48,-122,49,34,83
8320,ElliotBayTrailMyrtlePark,12/13/2014 04:00:00 PM,48,-122,38,30,68
8321,ElliotBayTrailMyrtlePark,12/13/2014 05:00:00 PM,48,-122,8,6,14
8322,ElliotBayTrailMyrtlePark,12/13/2014 06:00:00 PM,48,-122,9,12,21
8323,ElliotBayTrailMyrtlePark,12/13/2014 07:00:00 PM,48,-122,8,1,9
8324,ElliotBayTrailMyrtlePark,12/13/2014 08:00:00 PM,48,-122,2,1,3
8325,ElliotBayTrailMyrtlePark,12/13/2014 09:00:00 PM,48,-122,4,1,5
8326,ElliotBayTrailMyrtlePark,12/13/2014 10:00:00 PM,48,-122,6,3,9
8327,ElliotBayTrailMyrtlePark,12/13/2014 11:00:00 PM,48,-122,2,1,3
8328,ElliotBayTrailMyrtlePark,12/14/2014 12:00:00 AM,48,-122,3,1,4
8329,ElliotBayTrailMyrtlePark,12/14/2014 01:00:00 AM,48,-122,0,1,1
8330,ElliotBayTrailMyrtlePark,12/14/2014 02:00:00 AM,48,-122,0,0,0
8331,ElliotBayTrailMyrtlePark,12/14/2014 03:00:00 AM,48,-122,0,0,0
8332,ElliotBayTrailMyrtlePark,12/14/2014 04:00:00 AM,48,-122,0,0,0
8333,ElliotBayTrailMyrtlePark,12/14/2014 05:00:00 AM,48,-122,0,1,1
8334,ElliotBayTrailMyrtlePark,12/14/2014 06:00:00 AM,48,-122,1,0,1
8335,ElliotBayTrailMyrtlePark,12/14/2014 07:00:00 AM,48,-122,2,5,7
8336,ElliotBayTrailMyrtlePark,12/14/2014 08:00:00 AM,48,-122,3,1,4
8337,ElliotBayTrailMyrtlePark,12/14/2014 09:00:00 AM,48,-122,22,25,47
8338,ElliotBayTrailMyrtlePark,12/14/2014 10:00:00 AM,48,-122,22,28,50
8339,ElliotBayTrailMyrtlePark,12/14/2014 11:00:00 AM,48,-122,25,42,67
8340,ElliotBayTrailMyrtlePark,12/14/2014 12:00:00 PM,48,-122,38,48,86
8341,ElliotBayTrailMyrtlePark,12/14/2014 01:00:00 PM,48,-122,49,42,91
8342,ElliotBayTrailMyrtlePark,12/14/2014 02:00:00 PM,48,-122,50,63,113
8343,ElliotBayTrailMyrtlePark,12/14/2014 03:00:00 PM,48,-122,37,36,73
8344,ElliotBayTrailMyrtlePark,12/14/2014 04:00:00 PM,48,-122,33,25,58
8345,ElliotBayTrailMyrtlePark,12/14/2014 05:00:00 PM,48,-122,19,12,31
8346,ElliotBayTrailMyrtlePark,12/14/2014 06:00:00 PM,48,-122,15,3,18
8347,ElliotBayTrailMyrtlePark,12/14/2014 07:00:00 PM,48,-122,2,2,4
8348,ElliotBayTrailMyrtlePark,12/14/2014 08:00:00 PM,48,-122,4,4,8
8349,ElliotBayTrailMyrtlePark,12/14/2014 09:00:00 PM,48,-122,0,2,2
8350,ElliotBayTrailMyrtlePark,12/14/2014 10:00:00 PM,48,-122,2,2,4
8351,ElliotBayTrailMyrtlePark,12/14/2014 11:00:00 PM,48,-122,0,0,0
8352,ElliotBayTrailMyrtlePark,12/15/2014 12:00:00 AM,48,-122,3,2,5
8353,ElliotBayTrailMyrtlePark,12/15/2014 01:00:00 AM,48,-122,0,0,0
8354,ElliotBayTrailMyrtlePark,12/15/2014 02:00:00 AM,48,-122,2,0,2
8355,ElliotBayTrailMyrtlePark,12/15/2014 03:00:00 AM,48,-122,0,0,0
8356,ElliotBayTrailMyrtlePark,12/15/2014 04:00:00 AM,48,-122,0,0,0
8357,ElliotBayTrailMyrtlePark,12/15/2014 05:00:00 AM,48,-122,7,6,13
8358,ElliotBayTrailMyrtlePark,12/15/2014 06:00:00 AM,48,-122,10,22,32
8359,ElliotBayTrailMyrtlePark,12/15/2014 07:00:00 AM,48,-122,30,63,93
8360,ElliotBayTrailMyrtlePark,12/15/2014 08:00:00 AM,48,-122,24,101,125
8361,ElliotBayTrailMyrtlePark,12/15/2014 09:00:00 AM,48,-122,15,71,86
8362,ElliotBayTrailMyrtlePark,12/15/2014 10:00:00 AM,48,-122,12,13,25
8363,ElliotBayTrailMyrtlePark,12/15/2014 11:00:00 AM,48,-122,9,12,21
8364,ElliotBayTrailMyrtlePark,12/15/2014 12:00:00 PM,48,-122,2,11,13
8365,ElliotBayTrailMyrtlePark,12/15/2014 01:00:00 PM,48,-122,21,14,35
8366,ElliotBayTrailMyrtlePark,12/15/2014 02:00:00 PM,48,-122,13,28,41
8367,ElliotBayTrailMyrtlePark,12/15/2014 03:00:00 PM,48,-122,15,13,28
8368,ElliotBayTrailMyrtlePark,12/15/2014 04:00:00 PM,48,-122,47,36,83
8369,ElliotBayTrailMyrtlePark,12/15/2014 05:00:00 PM,48,-122,115,32,147
8370,ElliotBayTrailMyrtlePark,12/15/2014 06:00:00 PM,48,-122,82,15,97
8371,ElliotBayTrailMyrtlePark,12/15/2014 07:00:00 PM,48,-122,26,8,34
8372,ElliotBayTrailMyrtlePark,12/15/2014 08:00:00 PM,48,-122,6,1,7
8373,ElliotBayTrailMyrtlePark,12/15/2014 09:00:00 PM,48,-122,6,3,9
8374,ElliotBayTrailMyrtlePark,12/15/2014 10:00:00 PM,48,-122,2,2,4
8375,ElliotBayTrailMyrtlePark,12/15/2014 11:00:00 PM,48,-122,3,0,3
8376,ElliotBayTrailMyrtlePark,12/16/2014 12:00:00 AM,48,-122,0,0,0
8377,ElliotBayTrailMyrtlePark,12/16/2014 01:00:00 AM,48,-122,0,0,0
8378,ElliotBayTrailMyrtlePark,12/16/2014 02:00:00 AM,48,-122,1,0,1
8379,ElliotBayTrailMyrtlePark,12/16/2014 03:00:00 AM,48,-122,1,0,1
8380,ElliotBayTrailMyrtlePark,12/16/2014 04:00:00 AM,48,-122,0,0,0
8381,ElliotBayTrailMyrtlePark,12/16/2014 05:00:00 AM,48,-122,6,7,13
8382,ElliotBayTrailMyrtlePark,12/16/2014 06:00:00 AM,48,-122,14,26,40
8383,ElliotBayTrailMyrtlePark,12/16/2014 07:00:00 AM,48,-122,30,59,89
8384,ElliotBayTrailMyrtlePark,12/16/2014 08:00:00 AM,48,-122,36,113,149
8385,ElliotBayTrailMyrtlePark,12/16/2014 09:00:00 AM,48,-122,16,57,73
8386,ElliotBayTrailMyrtlePark,12/16/2014 10:00:00 AM,48,-122,4,14,18
8387,ElliotBayTrailMyrtlePark,12/16/2014 11:00:00 AM,48,-122,15,21,36
8388,ElliotBayTrailMyrtlePark,12/16/2014 12:00:00 PM,48,-122,8,13,21
8389,ElliotBayTrailMyrtlePark,12/16/2014 01:00:00 PM,48,-122,11,13,24
8390,ElliotBayTrailMyrtlePark,12/16/2014 02:00:00 PM,48,-122,11,11,22
8391,ElliotBayTrailMyrtlePark,12/16/2014 03:00:00 PM,48,-122,14,12,26
8392,ElliotBayTrailMyrtlePark,12/16/2014 04:00:00 PM,48,-122,39,33,72
8393,ElliotBayTrailMyrtlePark,12/16/2014 05:00:00 PM,48,-122,119,25,144
8394,ElliotBayTrailMyrtlePark,12/16/2014 06:00:00 PM,48,-122,86,20,106
8395,ElliotBayTrailMyrtlePark,12/16/2014 07:00:00 PM,48,-122,22,4,26
8396,ElliotBayTrailMyrtlePark,12/16/2014 08:00:00 PM,48,-122,5,3,8
8397,ElliotBayTrailMyrtlePark,12/16/2014 09:00:00 PM,48,-122,7,1,8
8398,ElliotBayTrailMyrtlePark,12/16/2014 10:00:00 PM,48,-122,2,1,3
8399,ElliotBayTrailMyrtlePark,12/16/2014 11:00:00 PM,48,-122,2,1,3
8400,ElliotBayTrailMyrtlePark,12/17/2014 12:00:00 AM,48,-122,0,1,1
8401,ElliotBayTrailMyrtlePark,12/17/2014 01:00:00 AM,48,-122,1,0,1
8402,ElliotBayTrailMyrtlePark,12/17/2014 02:00:00 AM,48,-122,2,0,2
8403,ElliotBayTrailMyrtlePark,12/17/2014 03:00:00 AM,48,-122,0,0,0
8404,ElliotBayTrailMyrtlePark,12/17/2014 04:00:00 AM,48,-122,0,0,0
8405,ElliotBayTrailMyrtlePark,12/17/2014 05:00:00 AM,48,-122,5,7,12
8406,ElliotBayTrailMyrtlePark,12/17/2014 06:00:00 AM,48,-122,12,17,29
8407,ElliotBayTrailMyrtlePark,12/17/2014 07:00:00 AM,48,-122,20,52,72
8408,ElliotBayTrailMyrtlePark,12/17/2014 08:00:00 AM,48,-122,28,91,119
8409,ElliotBayTrailMyrtlePark,12/17/2014 09:00:00 AM,48,-122,15,45,60
8410,ElliotBayTrailMyrtlePark,12/17/2014 10:00:00 AM,48,-122,4,19,23
8411,ElliotBayTrailMyrtlePark,12/17/2014 11:00:00 AM,48,-122,10,7,17
8412,ElliotBayTrailMyrtlePark,12/17/2014 12:00:00 PM,48,-122,9,11,20
8413,ElliotBayTrailMyrtlePark,12/17/2014 01:00:00 PM,48,-122,14,13,27
8414,ElliotBayTrailMyrtlePark,12/17/2014 02:00:00 PM,48,-122,19,20,39
8415,ElliotBayTrailMyrtlePark,12/17/2014 03:00:00 PM,48,-122,10,16,26
8416,ElliotBayTrailMyrtlePark,12/17/2014 04:00:00 PM,48,-122,39,22,61
8417,ElliotBayTrailMyrtlePark,12/17/2014 05:00:00 PM,48,-122,96,27,123
8418,ElliotBayTrailMyrtlePark,12/17/2014 06:00:00 PM,48,-122,59,18,77
8419,ElliotBayTrailMyrtlePark,12/17/2014 07:00:00 PM,48,-122,23,5,28
8420,ElliotBayTrailMyrtlePark,12/17/2014 08:00:00 PM,48,-122,3,7,10
8421,ElliotBayTrailMyrtlePark,12/17/2014 09:00:00 PM,48,-122,5,2,7
8422,ElliotBayTrailMyrtlePark,12/17/2014 10:00:00 PM,48,-122,0,0,0
8423,ElliotBayTrailMyrtlePark,12/17/2014 11:00:00 PM,48,-122,2,0,2
8424,ElliotBayTrailMyrtlePark,12/18/2014 12:00:00 AM,48,-122,1,1,2
8425,ElliotBayTrailMyrtlePark,12/18/2014 01:00:00 AM,48,-122,1,0,1
8426,ElliotBayTrailMyrtlePark,12/18/2014 02:00:00 AM,48,-122,1,0,1
8427,ElliotBayTrailMyrtlePark,12/18/2014 03:00:00 AM,48,-122,2,1,3
8428,ElliotBayTrailMyrtlePark,12/18/2014 04:00:00 AM,48,-122,0,1,1
8429,ElliotBayTrailMyrtlePark,12/18/2014 05:00:00 AM,48,-122,5,6,11
8430,ElliotBayTrailMyrtlePark,12/18/2014 06:00:00 AM,48,-122,16,16,32
8431,ElliotBayTrailMyrtlePark,12/18/2014 07:00:00 AM,48,-122,24,42,66
8432,ElliotBayTrailMyrtlePark,12/18/2014 08:00:00 AM,48,-122,23,87,110
8433,ElliotBayTrailMyrtlePark,12/18/2014 09:00:00 AM,48,-122,12,49,61
8434,ElliotBayTrailMyrtlePark,12/18/2014 10:00:00 AM,48,-122,14,17,31
8435,ElliotBayTrailMyrtlePark,12/18/2014 11:00:00 AM,48,-122,7,10,17
8436,ElliotBayTrailMyrtlePark,12/18/2014 12:00:00 PM,48,-122,13,11,24
8437,ElliotBayTrailMyrtlePark,12/18/2014 01:00:00 PM,48,-122,10,9,19
8438,ElliotBayTrailMyrtlePark,12/18/2014 02:00:00 PM,48,-122,9,16,25
8439,ElliotBayTrailMyrtlePark,12/18/2014 03:00:00 PM,48,-122,6,6,12
8440,ElliotBayTrailMyrtlePark,12/18/2014 04:00:00 PM,48,-122,24,22,46
8441,ElliotBayTrailMyrtlePark,12/18/2014 05:00:00 PM,48,-122,92,35,127
8442,ElliotBayTrailMyrtlePark,12/18/2014 06:00:00 PM,48,-122,58,9,67
8443,ElliotBayTrailMyrtlePark,12/18/2014 07:00:00 PM,48,-122,24,9,33
8444,ElliotBayTrailMyrtlePark,12/18/2014 08:00:00 PM,48,-122,6,1,7
8445,ElliotBayTrailMyrtlePark,12/18/2014 09:00:00 PM,48,-122,6,3,9
8446,ElliotBayTrailMyrtlePark,12/18/2014 10:00:00 PM,48,-122,4,0,4
8447,ElliotBayTrailMyrtlePark,12/18/2014 11:00:00 PM,48,-122,2,1,3
8448,ElliotBayTrailMyrtlePark,12/19/2014 12:00:00 AM,48,-122,0,0,0
8449,ElliotBayTrailMyrtlePark,12/19/2014 01:00:00 AM,48,-122,0,0,0
8450,ElliotBayTrailMyrtlePark,12/19/2014 02:00:00 AM,48,-122,1,0,1
8451,ElliotBayTrailMyrtlePark,12/19/2014 03:00:00 AM,48,-122,2,0,2
8452,ElliotBayTrailMyrtlePark,12/19/2014 04:00:00 AM,48,-122,0,0,0
8453,ElliotBayTrailMyrtlePark,12/19/2014 05:00:00 AM,48,-122,4,10,14
8454,ElliotBayTrailMyrtlePark,12/19/2014 06:00:00 AM,48,-122,12,11,23
8455,ElliotBayTrailMyrtlePark,12/19/2014 07:00:00 AM,48,-122,22,27,49
8456,ElliotBayTrailMyrtlePark,12/19/2014 08:00:00 AM,48,-122,17,68,85
8457,ElliotBayTrailMyrtlePark,12/19/2014 09:00:00 AM,48,-122,14,39,53
8458,ElliotBayTrailMyrtlePark,12/19/2014 10:00:00 AM,48,-122,8,12,20
8459,ElliotBayTrailMyrtlePark,12/19/2014 11:00:00 AM,48,-122,12,6,18
8460,ElliotBayTrailMyrtlePark,12/19/2014 12:00:00 PM,48,-122,11,9,20
8461,ElliotBayTrailMyrtlePark,12/19/2014 01:00:00 PM,48,-122,12,13,25
8462,ElliotBayTrailMyrtlePark,12/19/2014 02:00:00 PM,48,-122,15,22,37
8463,ElliotBayTrailMyrtlePark,12/19/2014 03:00:00 PM,48,-122,17,14,31
8464,ElliotBayTrailMyrtlePark,12/19/2014 04:00:00 PM,48,-122,38,23,61
8465,ElliotBayTrailMyrtlePark,12/19/2014 05:00:00 PM,48,-122,69,21,90
8466,ElliotBayTrailMyrtlePark,12/19/2014 06:00:00 PM,48,-122,40,10,50
8467,ElliotBayTrailMyrtlePark,12/19/2014 07:00:00 PM,48,-122,13,5,18
8468,ElliotBayTrailMyrtlePark,12/19/2014 08:00:00 PM,48,-122,8,0,8
8469,ElliotBayTrailMyrtlePark,12/19/2014 09:00:00 PM,48,-122,2,8,10
8470,ElliotBayTrailMyrtlePark,12/19/2014 10:00:00 PM,48,-122,5,1,6
8471,ElliotBayTrailMyrtlePark,12/19/2014 11:00:00 PM,48,-122,1,1,2
8472,ElliotBayTrailMyrtlePark,12/20/2014 12:00:00 AM,48,-122,2,2,4
8473,ElliotBayTrailMyrtlePark,12/20/2014 01:00:00 AM,48,-122,1,3,4
8474,ElliotBayTrailMyrtlePark,12/20/2014 02:00:00 AM,48,-122,0,0,0
8475,ElliotBayTrailMyrtlePark,12/20/2014 03:00:00 AM,48,-122,1,0,1
8476,ElliotBayTrailMyrtlePark,12/20/2014 04:00:00 AM,48,-122,0,0,0
8477,ElliotBayTrailMyrtlePark,12/20/2014 05:00:00 AM,48,-122,0,0,0
8478,ElliotBayTrailMyrtlePark,12/20/2014 06:00:00 AM,48,-122,1,3,4
8479,ElliotBayTrailMyrtlePark,12/20/2014 07:00:00 AM,48,-122,0,7,7
8480,ElliotBayTrailMyrtlePark,12/20/2014 08:00:00 AM,48,-122,4,1,5
8481,ElliotBayTrailMyrtlePark,12/20/2014 09:00:00 AM,48,-122,2,6,8
8482,ElliotBayTrailMyrtlePark,12/20/2014 10:00:00 AM,48,-122,4,5,9
8483,ElliotBayTrailMyrtlePark,12/20/2014 11:00:00 AM,48,-122,2,1,3
8484,ElliotBayTrailMyrtlePark,12/20/2014 12:00:00 PM,48,-122,9,1,10
8485,ElliotBayTrailMyrtlePark,12/20/2014 01:00:00 PM,48,-122,5,0,5
8486,ElliotBayTrailMyrtlePark,12/20/2014 02:00:00 PM,48,-122,1,4,5
8487,ElliotBayTrailMyrtlePark,12/20/2014 03:00:00 PM,48,-122,6,2,8
8488,ElliotBayTrailMyrtlePark,12/20/2014 04:00:00 PM,48,-122,3,7,10
8489,ElliotBayTrailMyrtlePark,12/20/2014 05:00:00 PM,48,-122,2,0,2
8490,ElliotBayTrailMyrtlePark,12/20/2014 06:00:00 PM,48,-122,3,3,6
8491,ElliotBayTrailMyrtlePark,12/20/2014 07:00:00 PM,48,-122,4,1,5
8492,ElliotBayTrailMyrtlePark,12/20/2014 08:00:00 PM,48,-122,0,0,0
8493,ElliotBayTrailMyrtlePark,12/20/2014 09:00:00 PM,48,-122,0,2,2
8494,ElliotBayTrailMyrtlePark,12/20/2014 10:00:00 PM,48,-122,0,0,0
8495,ElliotBayTrailMyrtlePark,12/20/2014 11:00:00 PM,48,-122,3,2,5
8496,ElliotBayTrailMyrtlePark,12/21/2014 12:00:00 AM,48,-122,3,0,3
8497,ElliotBayTrailMyrtlePark,12/21/2014 01:00:00 AM,48,-122,0,0,0
8498,ElliotBayTrailMyrtlePark,12/21/2014 02:00:00 AM,48,-122,4,0,4
8499,ElliotBayTrailMyrtlePark,12/21/2014 03:00:00 AM,48,-122,2,0,2
8500,ElliotBayTrailMyrtlePark,12/21/2014 04:00:00 AM,48,-122,0,0,0
8501,ElliotBayTrailMyrtlePark,12/21/2014 05:00:00 AM,48,-122,2,1,3
8502,ElliotBayTrailMyrtlePark,12/21/2014 06:00:00 AM,48,-122,1,3,4
8503,ElliotBayTrailMyrtlePark,12/21/2014 07:00:00 AM,48,-122,2,4,6
8504,ElliotBayTrailMyrtlePark,12/21/2014 08:00:00 AM,48,-122,4,4,8
8505,ElliotBayTrailMyrtlePark,12/21/2014 09:00:00 AM,48,-122,14,10,24
8506,ElliotBayTrailMyrtlePark,12/21/2014 10:00:00 AM,48,-122,11,8,19
8507,ElliotBayTrailMyrtlePark,12/21/2014 11:00:00 AM,48,-122,14,22,36
8508,ElliotBayTrailMyrtlePark,12/21/2014 12:00:00 PM,48,-122,19,20,39
8509,ElliotBayTrailMyrtlePark,12/21/2014 01:00:00 PM,48,-122,28,21,49
8510,ElliotBayTrailMyrtlePark,12/21/2014 02:00:00 PM,48,-122,21,24,45
8511,ElliotBayTrailMyrtlePark,12/21/2014 03:00:00 PM,48,-122,20,21,41
8512,ElliotBayTrailMyrtlePark,12/21/2014 04:00:00 PM,48,-122,9,14,23
8513,ElliotBayTrailMyrtlePark,12/21/2014 05:00:00 PM,48,-122,10,6,16
8514,ElliotBayTrailMyrtlePark,12/21/2014 06:00:00 PM,48,-122,5,4,9
8515,ElliotBayTrailMyrtlePark,12/21/2014 07:00:00 PM,48,-122,5,0,5
8516,ElliotBayTrailMyrtlePark,12/21/2014 08:00:00 PM,48,-122,1,0,1
8517,ElliotBayTrailMyrtlePark,12/21/2014 09:00:00 PM,48,-122,1,4,5
8518,ElliotBayTrailMyrtlePark,12/21/2014 10:00:00 PM,48,-122,2,0,2
8519,ElliotBayTrailMyrtlePark,12/21/2014 11:00:00 PM,48,-122,1,0,1
8520,ElliotBayTrailMyrtlePark,12/22/2014 12:00:00 AM,48,-122,0,0,0
8521,ElliotBayTrailMyrtlePark,12/22/2014 01:00:00 AM,48,-122,0,1,1
8522,ElliotBayTrailMyrtlePark,12/22/2014 02:00:00 AM,48,-122,1,0,1
8523,ElliotBayTrailMyrtlePark,12/22/2014 03:00:00 AM,48,-122,0,0,0
8524,ElliotBayTrailMyrtlePark,12/22/2014 04:00:00 AM,48,-122,1,0,1
8525,ElliotBayTrailMyrtlePark,12/22/2014 05:00:00 AM,48,-122,6,8,14
8526,ElliotBayTrailMyrtlePark,12/22/2014 06:00:00 AM,48,-122,13,15,28
8527,ElliotBayTrailMyrtlePark,12/22/2014 07:00:00 AM,48,-122,24,41,65
8528,ElliotBayTrailMyrtlePark,12/22/2014 08:00:00 AM,48,-122,24,73,97
8529,ElliotBayTrailMyrtlePark,12/22/2014 09:00:00 AM,48,-122,14,52,66
8530,ElliotBayTrailMyrtlePark,12/22/2014 10:00:00 AM,48,-122,4,20,24
8531,ElliotBayTrailMyrtlePark,12/22/2014 11:00:00 AM,48,-122,13,15,28
8532,ElliotBayTrailMyrtlePark,12/22/2014 12:00:00 PM,48,-122,16,13,29
8533,ElliotBayTrailMyrtlePark,12/22/2014 01:00:00 PM,48,-122,13,13,26
8534,ElliotBayTrailMyrtlePark,12/22/2014 02:00:00 PM,48,-122,17,32,49
8535,ElliotBayTrailMyrtlePark,12/22/2014 03:00:00 PM,48,-122,32,24,56
8536,ElliotBayTrailMyrtlePark,12/22/2014 04:00:00 PM,48,-122,46,29,75
8537,ElliotBayTrailMyrtlePark,12/22/2014 05:00:00 PM,48,-122,84,17,101
8538,ElliotBayTrailMyrtlePark,12/22/2014 06:00:00 PM,48,-122,50,13,63
8539,ElliotBayTrailMyrtlePark,12/22/2014 07:00:00 PM,48,-122,18,4,22
8540,ElliotBayTrailMyrtlePark,12/22/2014 08:00:00 PM,48,-122,1,1,2
8541,ElliotBayTrailMyrtlePark,12/22/2014 09:00:00 PM,48,-122,3,0,3
8542,ElliotBayTrailMyrtlePark,12/22/2014 10:00:00 PM,48,-122,6,1,7
8543,ElliotBayTrailMyrtlePark,12/22/2014 11:00:00 PM,48,-122,2,2,4
8544,ElliotBayTrailMyrtlePark,12/23/2014 12:00:00 AM,48,-122,0,1,1
8545,ElliotBayTrailMyrtlePark,12/23/2014 01:00:00 AM,48,-122,0,0,0
8546,ElliotBayTrailMyrtlePark,12/23/2014 02:00:00 AM,48,-122,2,0,2
8547,ElliotBayTrailMyrtlePark,12/23/2014 03:00:00 AM,48,-122,0,0,0
8548,ElliotBayTrailMyrtlePark,12/23/2014 04:00:00 AM,48,-122,0,0,0
8549,ElliotBayTrailMyrtlePark,12/23/2014 05:00:00 AM,48,-122,5,9,14
8550,ElliotBayTrailMyrtlePark,12/23/2014 06:00:00 AM,48,-122,4,5,9
8551,ElliotBayTrailMyrtlePark,12/23/2014 07:00:00 AM,48,-122,15,27,42
8552,ElliotBayTrailMyrtlePark,12/23/2014 08:00:00 AM,48,-122,25,57,82
8553,ElliotBayTrailMyrtlePark,12/23/2014 09:00:00 AM,48,-122,9,47,56
8554,ElliotBayTrailMyrtlePark,12/23/2014 10:00:00 AM,48,-122,14,19,33
8555,ElliotBayTrailMyrtlePark,12/23/2014 11:00:00 AM,48,-122,7,6,13
8556,ElliotBayTrailMyrtlePark,12/23/2014 12:00:00 PM,48,-122,12,11,23
8557,ElliotBayTrailMyrtlePark,12/23/2014 01:00:00 PM,48,-122,12,19,31
8558,ElliotBayTrailMyrtlePark,12/23/2014 02:00:00 PM,48,-122,10,17,27
8559,ElliotBayTrailMyrtlePark,12/23/2014 03:00:00 PM,48,-122,8,8,16
8560,ElliotBayTrailMyrtlePark,12/23/2014 04:00:00 PM,48,-122,25,19,44
8561,ElliotBayTrailMyrtlePark,12/23/2014 05:00:00 PM,48,-122,51,12,63
8562,ElliotBayTrailMyrtlePark,12/23/2014 06:00:00 PM,48,-122,25,6,31
8563,ElliotBayTrailMyrtlePark,12/23/2014 07:00:00 PM,48,-122,11,2,13
8564,ElliotBayTrailMyrtlePark,12/23/2014 08:00:00 PM,48,-122,4,3,7
8565,ElliotBayTrailMyrtlePark,12/23/2014 09:00:00 PM,48,-122,0,0,0
8566,ElliotBayTrailMyrtlePark,12/23/2014 10:00:00 PM,48,-122,1,0,1
8567,ElliotBayTrailMyrtlePark,12/23/2014 11:00:00 PM,48,-122,2,0,2
8568,ElliotBayTrailMyrtlePark,12/24/2014 12:00:00 AM,48,-122,1,0,1
8569,ElliotBayTrailMyrtlePark,12/24/2014 01:00:00 AM,48,-122,1,0,1
8570,ElliotBayTrailMyrtlePark,12/24/2014 02:00:00 AM,48,-122,2,0,2
8571,ElliotBayTrailMyrtlePark,12/24/2014 03:00:00 AM,48,-122,1,0,1
8572,ElliotBayTrailMyrtlePark,12/24/2014 04:00:00 AM,48,-122,0,1,1
8573,ElliotBayTrailMyrtlePark,12/24/2014 05:00:00 AM,48,-122,2,3,5
8574,ElliotBayTrailMyrtlePark,12/24/2014 06:00:00 AM,48,-122,2,6,8
8575,ElliotBayTrailMyrtlePark,12/24/2014 07:00:00 AM,48,-122,5,9,14
8576,ElliotBayTrailMyrtlePark,12/24/2014 08:00:00 AM,48,-122,8,19,27
8577,ElliotBayTrailMyrtlePark,12/24/2014 09:00:00 AM,48,-122,10,16,26
8578,ElliotBayTrailMyrtlePark,12/24/2014 10:00:00 AM,48,-122,7,7,14
8579,ElliotBayTrailMyrtlePark,12/24/2014 11:00:00 AM,48,-122,11,10,21
8580,ElliotBayTrailMyrtlePark,12/24/2014 12:00:00 PM,48,-122,15,9,24
8581,ElliotBayTrailMyrtlePark,12/24/2014 01:00:00 PM,48,-122,12,13,25
8582,ElliotBayTrailMyrtlePark,12/24/2014 02:00:00 PM,48,-122,27,15,42
8583,ElliotBayTrailMyrtlePark,12/24/2014 03:00:00 PM,48,-122,29,4,33
8584,ElliotBayTrailMyrtlePark,12/24/2014 04:00:00 PM,48,-122,19,8,27
8585,ElliotBayTrailMyrtlePark,12/24/2014 05:00:00 PM,48,-122,4,2,6
8586,ElliotBayTrailMyrtlePark,12/24/2014 06:00:00 PM,48,-122,4,3,7
8587,ElliotBayTrailMyrtlePark,12/24/2014 07:00:00 PM,48,-122,2,0,2
8588,ElliotBayTrailMyrtlePark,12/24/2014 08:00:00 PM,48,-122,0,0,0
8589,ElliotBayTrailMyrtlePark,12/24/2014 09:00:00 PM,48,-122,0,0,0
8590,ElliotBayTrailMyrtlePark,12/24/2014 10:00:00 PM,48,-122,1,1,2
8591,ElliotBayTrailMyrtlePark,12/24/2014 11:00:00 PM,48,-122,0,0,0
8592,ElliotBayTrailMyrtlePark,12/25/2014 12:00:00 AM,48,-122,0,0,0
8593,ElliotBayTrailMyrtlePark,12/25/2014 01:00:00 AM,48,-122,0,0,0
8594,ElliotBayTrailMyrtlePark,12/25/2014 02:00:00 AM,48,-122,1,0,1
8595,ElliotBayTrailMyrtlePark,12/25/2014 03:00:00 AM,48,-122,0,0,0
8596,ElliotBayTrailMyrtlePark,12/25/2014 04:00:00 AM,48,-122,1,0,1
8597,ElliotBayTrailMyrtlePark,12/25/2014 05:00:00 AM,48,-122,0,1,1
8598,ElliotBayTrailMyrtlePark,12/25/2014 06:00:00 AM,48,-122,0,1,1
8599,ElliotBayTrailMyrtlePark,12/25/2014 07:00:00 AM,48,-122,0,0,0
8600,ElliotBayTrailMyrtlePark,12/25/2014 08:00:00 AM,48,-122,2,1,3
8601,ElliotBayTrailMyrtlePark,12/25/2014 09:00:00 AM,48,-122,6,2,8
8602,ElliotBayTrailMyrtlePark,12/25/2014 10:00:00 AM,48,-122,10,20,30
8603,ElliotBayTrailMyrtlePark,12/25/2014 11:00:00 AM,48,-122,7,9,16
8604,ElliotBayTrailMyrtlePark,12/25/2014 12:00:00 PM,48,-122,25,10,35
8605,ElliotBayTrailMyrtlePark,12/25/2014 01:00:00 PM,48,-122,30,25,55
8606,ElliotBayTrailMyrtlePark,12/25/2014 02:00:00 PM,48,-122,33,22,55
8607,ElliotBayTrailMyrtlePark,12/25/2014 03:00:00 PM,48,-122,31,29,60
8608,ElliotBayTrailMyrtlePark,12/25/2014 04:00:00 PM,48,-122,12,13,25
8609,ElliotBayTrailMyrtlePark,12/25/2014 05:00:00 PM,48,-122,3,8,11
8610,ElliotBayTrailMyrtlePark,12/25/2014 06:00:00 PM,48,-122,3,3,6
8611,ElliotBayTrailMyrtlePark,12/25/2014 07:00:00 PM,48,-122,0,2,2
8612,ElliotBayTrailMyrtlePark,12/25/2014 08:00:00 PM,48,-122,1,1,2
8613,ElliotBayTrailMyrtlePark,12/25/2014 09:00:00 PM,48,-122,0,0,0
8614,ElliotBayTrailMyrtlePark,12/25/2014 10:00:00 PM,48,-122,0,0,0
8615,ElliotBayTrailMyrtlePark,12/25/2014 11:00:00 PM,48,-122,0,0,0
8616,ElliotBayTrailMyrtlePark,12/26/2014 12:00:00 AM,48,-122,0,3,3
8617,ElliotBayTrailMyrtlePark,12/26/2014 01:00:00 AM,48,-122,0,0,0
8618,ElliotBayTrailMyrtlePark,12/26/2014 02:00:00 AM,48,-122,2,5,7
8619,ElliotBayTrailMyrtlePark,12/26/2014 03:00:00 AM,48,-122,0,1,1
8620,ElliotBayTrailMyrtlePark,12/26/2014 04:00:00 AM,48,-122,0,0,0
8621,ElliotBayTrailMyrtlePark,12/26/2014 05:00:00 AM,48,-122,2,1,3
8622,ElliotBayTrailMyrtlePark,12/26/2014 06:00:00 AM,48,-122,1,2,3
8623,ElliotBayTrailMyrtlePark,12/26/2014 07:00:00 AM,48,-122,6,12,18
8624,ElliotBayTrailMyrtlePark,12/26/2014 08:00:00 AM,48,-122,7,19,26
8625,ElliotBayTrailMyrtlePark,12/26/2014 09:00:00 AM,48,-122,10,19,29
8626,ElliotBayTrailMyrtlePark,12/26/2014 10:00:00 AM,48,-122,8,27,35
8627,ElliotBayTrailMyrtlePark,12/26/2014 11:00:00 AM,48,-122,20,12,32
8628,ElliotBayTrailMyrtlePark,12/26/2014 12:00:00 PM,48,-122,20,13,33
8629,ElliotBayTrailMyrtlePark,12/26/2014 01:00:00 PM,48,-122,19,30,49
8630,ElliotBayTrailMyrtlePark,12/26/2014 02:00:00 PM,48,-122,43,37,80
8631,ElliotBayTrailMyrtlePark,12/26/2014 03:00:00 PM,48,-122,35,21,56
8632,ElliotBayTrailMyrtlePark,12/26/2014 04:00:00 PM,48,-122,11,14,25
8633,ElliotBayTrailMyrtlePark,12/26/2014 05:00:00 PM,48,-122,13,6,19
8634,ElliotBayTrailMyrtlePark,12/26/2014 06:00:00 PM,48,-122,10,4,14
8635,ElliotBayTrailMyrtlePark,12/26/2014 07:00:00 PM,48,-122,4,2,6
8636,ElliotBayTrailMyrtlePark,12/26/2014 08:00:00 PM,48,-122,0,0,0
8637,ElliotBayTrailMyrtlePark,12/26/2014 09:00:00 PM,48,-122,1,1,2
8638,ElliotBayTrailMyrtlePark,12/26/2014 10:00:00 PM,48,-122,1,0,1
8639,ElliotBayTrailMyrtlePark,12/26/2014 11:00:00 PM,48,-122,2,0,2
8640,ElliotBayTrailMyrtlePark,12/27/2014 12:00:00 AM,48,-122,1,0,1
8641,ElliotBayTrailMyrtlePark,12/27/2014 01:00:00 AM,48,-122,0,0,0
8642,ElliotBayTrailMyrtlePark,12/27/2014 02:00:00 AM,48,-122,0,0,0
8643,ElliotBayTrailMyrtlePark,12/27/2014 03:00:00 AM,48,-122,0,0,0
8644,ElliotBayTrailMyrtlePark,12/27/2014 04:00:00 AM,48,-122,2,0,2
8645,ElliotBayTrailMyrtlePark,12/27/2014 05:00:00 AM,48,-122,0,2,2
8646,ElliotBayTrailMyrtlePark,12/27/2014 06:00:00 AM,48,-122,0,4,4
8647,ElliotBayTrailMyrtlePark,12/27/2014 07:00:00 AM,48,-122,1,4,5
8648,ElliotBayTrailMyrtlePark,12/27/2014 08:00:00 AM,48,-122,2,1,3
8649,ElliotBayTrailMyrtlePark,12/27/2014 09:00:00 AM,48,-122,5,8,13
8650,ElliotBayTrailMyrtlePark,12/27/2014 10:00:00 AM,48,-122,10,5,15
8651,ElliotBayTrailMyrtlePark,12/27/2014 11:00:00 AM,48,-122,14,16,30
8652,ElliotBayTrailMyrtlePark,12/27/2014 12:00:00 PM,48,-122,11,9,20
8653,ElliotBayTrailMyrtlePark,12/27/2014 01:00:00 PM,48,-122,9,12,21
8654,ElliotBayTrailMyrtlePark,12/27/2014 02:00:00 PM,48,-122,22,4,26
8655,ElliotBayTrailMyrtlePark,12/27/2014 03:00:00 PM,48,-122,7,6,13
8656,ElliotBayTrailMyrtlePark,12/27/2014 04:00:00 PM,48,-122,3,1,4
8657,ElliotBayTrailMyrtlePark,12/27/2014 05:00:00 PM,48,-122,9,0,9
8658,ElliotBayTrailMyrtlePark,12/27/2014 06:00:00 PM,48,-122,3,5,8
8659,ElliotBayTrailMyrtlePark,12/27/2014 07:00:00 PM,48,-122,7,2,9
8660,ElliotBayTrailMyrtlePark,12/27/2014 08:00:00 PM,48,-122,1,0,1
8661,ElliotBayTrailMyrtlePark,12/27/2014 09:00:00 PM,48,-122,4,0,4
8662,ElliotBayTrailMyrtlePark,12/27/2014 10:00:00 PM,48,-122,3,1,4
8663,ElliotBayTrailMyrtlePark,12/27/2014 11:00:00 PM,48,-122,0,1,1
8664,ElliotBayTrailMyrtlePark,12/28/2014 12:00:00 AM,48,-122,0,0,0
8665,ElliotBayTrailMyrtlePark,12/28/2014 01:00:00 AM,48,-122,0,0,0
8666,ElliotBayTrailMyrtlePark,12/28/2014 02:00:00 AM,48,-122,0,0,0
8667,ElliotBayTrailMyrtlePark,12/28/2014 03:00:00 AM,48,-122,1,0,1
8668,ElliotBayTrailMyrtlePark,12/28/2014 04:00:00 AM,48,-122,0,0,0
8669,ElliotBayTrailMyrtlePark,12/28/2014 05:00:00 AM,48,-122,0,1,1
8670,ElliotBayTrailMyrtlePark,12/28/2014 06:00:00 AM,48,-122,0,0,0
8671,ElliotBayTrailMyrtlePark,12/28/2014 07:00:00 AM,48,-122,2,0,2
8672,ElliotBayTrailMyrtlePark,12/28/2014 08:00:00 AM,48,-122,2,3,5
8673,ElliotBayTrailMyrtlePark,12/28/2014 09:00:00 AM,48,-122,15,16,31
8674,ElliotBayTrailMyrtlePark,12/28/2014 10:00:00 AM,48,-122,8,18,26
8675,ElliotBayTrailMyrtlePark,12/28/2014 11:00:00 AM,48,-122,20,41,61
8676,ElliotBayTrailMyrtlePark,12/28/2014 12:00:00 PM,48,-122,16,17,33
8677,ElliotBayTrailMyrtlePark,12/28/2014 01:00:00 PM,48,-122,25,27,52
8678,ElliotBayTrailMyrtlePark,12/28/2014 02:00:00 PM,48,-122,18,16,34
8679,ElliotBayTrailMyrtlePark,12/28/2014 03:00:00 PM,48,-122,11,10,21
8680,ElliotBayTrailMyrtlePark,12/28/2014 04:00:00 PM,48,-122,17,10,27
8681,ElliotBayTrailMyrtlePark,12/28/2014 05:00:00 PM,48,-122,14,1,15
8682,ElliotBayTrailMyrtlePark,12/28/2014 06:00:00 PM,48,-122,4,2,6
8683,ElliotBayTrailMyrtlePark,12/28/2014 07:00:00 PM,48,-122,2,1,3
8684,ElliotBayTrailMyrtlePark,12/28/2014 08:00:00 PM,48,-122,3,1,4
8685,ElliotBayTrailMyrtlePark,12/28/2014 09:00:00 PM,48,-122,1,3,4
8686,ElliotBayTrailMyrtlePark,12/28/2014 10:00:00 PM,48,-122,4,2,6
8687,ElliotBayTrailMyrtlePark,12/28/2014 11:00:00 PM,48,-122,0,1,1
8688,ElliotBayTrailMyrtlePark,12/29/2014 12:00:00 AM,48,-122,1,0,1
8689,ElliotBayTrailMyrtlePark,12/29/2014 01:00:00 AM,48,-122,0,0,0
8690,ElliotBayTrailMyrtlePark,12/29/2014 02:00:00 AM,48,-122,1,0,1
8691,ElliotBayTrailMyrtlePark,12/29/2014 03:00:00 AM,48,-122,3,0,3
8692,ElliotBayTrailMyrtlePark,12/29/2014 04:00:00 AM,48,-122,0,0,0
8693,ElliotBayTrailMyrtlePark,12/29/2014 05:00:00 AM,48,-122,3,7,10
8694,ElliotBayTrailMyrtlePark,12/29/2014 06:00:00 AM,48,-122,8,13,21
8695,ElliotBayTrailMyrtlePark,12/29/2014 07:00:00 AM,48,-122,21,26,47
8696,ElliotBayTrailMyrtlePark,12/29/2014 08:00:00 AM,48,-122,13,63,76
8697,ElliotBayTrailMyrtlePark,12/29/2014 09:00:00 AM,48,-122,4,30,34
8698,ElliotBayTrailMyrtlePark,12/29/2014 10:00:00 AM,48,-122,19,20,39
8699,ElliotBayTrailMyrtlePark,12/29/2014 11:00:00 AM,48,-122,13,12,25
8700,ElliotBayTrailMyrtlePark,12/29/2014 12:00:00 PM,48,-122,13,16,29
8701,ElliotBayTrailMyrtlePark,12/29/2014 01:00:00 PM,48,-122,10,13,23
8702,ElliotBayTrailMyrtlePark,12/29/2014 02:00:00 PM,48,-122,28,22,50
8703,ElliotBayTrailMyrtlePark,12/29/2014 03:00:00 PM,48,-122,29,25,54
8704,ElliotBayTrailMyrtlePark,12/29/2014 04:00:00 PM,48,-122,37,24,61
8705,ElliotBayTrailMyrtlePark,12/29/2014 05:00:00 PM,48,-122,73,13,86
8706,ElliotBayTrailMyrtlePark,12/29/2014 06:00:00 PM,48,-122,38,8,46
8707,ElliotBayTrailMyrtlePark,12/29/2014 07:00:00 PM,48,-122,12,5,17
8708,ElliotBayTrailMyrtlePark,12/29/2014 08:00:00 PM,48,-122,5,4,9
8709,ElliotBayTrailMyrtlePark,12/29/2014 09:00:00 PM,48,-122,1,1,2
8710,ElliotBayTrailMyrtlePark,12/29/2014 10:00:00 PM,48,-122,3,0,3
8711,ElliotBayTrailMyrtlePark,12/29/2014 11:00:00 PM,48,-122,2,1,3
8712,ElliotBayTrailMyrtlePark,12/30/2014 12:00:00 AM,48,-122,1,0,1
8713,ElliotBayTrailMyrtlePark,12/30/2014 01:00:00 AM,48,-122,0,0,0
8714,ElliotBayTrailMyrtlePark,12/30/2014 02:00:00 AM,48,-122,1,0,1
8715,ElliotBayTrailMyrtlePark,12/30/2014 03:00:00 AM,48,-122,0,0,0
8716,ElliotBayTrailMyrtlePark,12/30/2014 04:00:00 AM,48,-122,2,0,2
8717,ElliotBayTrailMyrtlePark,12/30/2014 05:00:00 AM,48,-122,3,3,6
8718,ElliotBayTrailMyrtlePark,12/30/2014 06:00:00 AM,48,-122,8,12,20
8719,ElliotBayTrailMyrtlePark,12/30/2014 07:00:00 AM,48,-122,16,27,43
8720,ElliotBayTrailMyrtlePark,12/30/2014 08:00:00 AM,48,-122,17,56,73
8721,ElliotBayTrailMyrtlePark,12/30/2014 09:00:00 AM,48,-122,11,33,44
8722,ElliotBayTrailMyrtlePark,12/30/2014 10:00:00 AM,48,-122,6,11,17
8723,ElliotBayTrailMyrtlePark,12/30/2014 11:00:00 AM,48,-122,3,14,17
8724,ElliotBayTrailMyrtlePark,12/30/2014 12:00:00 PM,48,-122,14,12,26
8725,ElliotBayTrailMyrtlePark,12/30/2014 01:00:00 PM,48,-122,11,24,35
8726,ElliotBayTrailMyrtlePark,12/30/2014 02:00:00 PM,48,-122,16,17,33
8727,ElliotBayTrailMyrtlePark,12/30/2014 03:00:00 PM,48,-122,25,22,47
8728,ElliotBayTrailMyrtlePark,12/30/2014 04:00:00 PM,48,-122,40,20,60
8729,ElliotBayTrailMyrtlePark,12/30/2014 05:00:00 PM,48,-122,60,20,80
8730,ElliotBayTrailMyrtlePark,12/30/2014 06:00:00 PM,48,-122,43,11,54
8731,ElliotBayTrailMyrtlePark,12/30/2014 07:00:00 PM,48,-122,13,4,17
8732,ElliotBayTrailMyrtlePark,12/30/2014 08:00:00 PM,48,-122,1,1,2
8733,ElliotBayTrailMyrtlePark,12/30/2014 09:00:00 PM,48,-122,2,1,3
8734,ElliotBayTrailMyrtlePark,12/30/2014 10:00:00 PM,48,-122,3,2,5
8735,ElliotBayTrailMyrtlePark,12/30/2014 11:00:00 PM,48,-122,0,1,1
8736,ElliotBayTrailMyrtlePark,12/31/2014 12:00:00 AM,48,-122,0,0,0
8737,ElliotBayTrailMyrtlePark,12/31/2014 01:00:00 AM,48,-122,1,1,2
8738,ElliotBayTrailMyrtlePark,12/31/2014 02:00:00 AM,48,-122,1,0,1
8739,ElliotBayTrailMyrtlePark,12/31/2014 03:00:00 AM,48,-122,0,0,0
8740,ElliotBayTrailMyrtlePark,12/31/2014 04:00:00 AM,48,-122,0,0,0
8741,ElliotBayTrailMyrtlePark,12/31/2014 05:00:00 AM,48,-122,3,7,10
8742,ElliotBayTrailMyrtlePark,12/31/2014 06:00:00 AM,48,-122,9,8,17
8743,ElliotBayTrailMyrtlePark,12/31/2014 07:00:00 AM,48,-122,10,19,29
8744,ElliotBayTrailMyrtlePark,12/31/2014 08:00:00 AM,48,-122,11,38,49
8745,ElliotBayTrailMyrtlePark,12/31/2014 09:00:00 AM,48,-122,10,24,34
8746,ElliotBayTrailMyrtlePark,12/31/2014 10:00:00 AM,48,-122,9,13,22
8747,ElliotBayTrailMyrtlePark,12/31/2014 11:00:00 AM,48,-122,12,9,21
8748,ElliotBayTrailMyrtlePark,12/31/2014 12:00:00 PM,48,-122,13,7,20
8749,ElliotBayTrailMyrtlePark,12/31/2014 01:00:00 PM,48,-122,27,19,46
8750,ElliotBayTrailMyrtlePark,12/31/2014 02:00:00 PM,48,-122,35,28,63
8751,ElliotBayTrailMyrtlePark,12/31/2014 03:00:00 PM,48,-122,52,15,67
8752,ElliotBayTrailMyrtlePark,12/31/2014 04:00:00 PM,48,-122,49,32,81
8753,ElliotBayTrailMyrtlePark,12/31/2014 05:00:00 PM,48,-122,29,11,40
8754,ElliotBayTrailMyrtlePark,12/31/2014 06:00:00 PM,48,-122,10,4,14
8755,ElliotBayTrailMyrtlePark,12/31/2014 07:00:00 PM,48,-122,12,3,15
8756,ElliotBayTrailMyrtlePark,12/31/2014 08:00:00 PM,48,-122,0,3,3
8757,ElliotBayTrailMyrtlePark,12/31/2014 09:00:00 PM,48,-122,1,2,3
8758,ElliotBayTrailMyrtlePark,12/31/2014 10:00:00 PM,48,-122,0,1,1
8759,ElliotBayTrailMyrtlePark,12/31/2014 11:00:00 PM,48,-122,2,2,4
8760,ElliotBayTrailMyrtlePark,01/01/2015 12:00:00 AM,48,-122,0,0,0
8761,ElliotBayTrailMyrtlePark,01/01/2015 01:00:00 AM,48,-122,4,1,5
8762,ElliotBayTrailMyrtlePark,01/01/2015 02:00:00 AM,48,-122,1,0,1
8763,ElliotBayTrailMyrtlePark,01/01/2015 03:00:00 AM,48,-122,1,0,1
8764,ElliotBayTrailMyrtlePark,01/01/2015 04:00:00 AM,48,-122,1,2,3
8765,ElliotBayTrailMyrtlePark,01/01/2015 05:00:00 AM,48,-122,0,0,0
8766,ElliotBayTrailMyrtlePark,01/01/2015 06:00:00 AM,48,-122,2,1,3
8767,ElliotBayTrailMyrtlePark,01/01/2015 07:00:00 AM,48,-122,1,1,2
8768,ElliotBayTrailMyrtlePark,01/01/2015 08:00:00 AM,48,-122,6,5,11
8769,ElliotBayTrailMyrtlePark,01/01/2015 09:00:00 AM,48,-122,3,5,8
8770,ElliotBayTrailMyrtlePark,01/01/2015 10:00:00 AM,48,-122,7,5,12
8771,ElliotBayTrailMyrtlePark,01/01/2015 11:00:00 AM,48,-122,20,8,28
8772,ElliotBayTrailMyrtlePark,01/01/2015 12:00:00 PM,48,-122,29,16,45
8773,ElliotBayTrailMyrtlePark,01/01/2015 01:00:00 PM,48,-122,32,37,69
8774,ElliotBayTrailMyrtlePark,01/01/2015 02:00:00 PM,48,-122,39,42,81
8775,ElliotBayTrailMyrtlePark,01/01/2015 03:00:00 PM,48,-122,37,37,74
8776,ElliotBayTrailMyrtlePark,01/01/2015 04:00:00 PM,48,-122,28,19,47
8777,ElliotBayTrailMyrtlePark,01/01/2015 05:00:00 PM,48,-122,10,7,17
8778,ElliotBayTrailMyrtlePark,01/01/2015 06:00:00 PM,48,-122,2,6,8
8779,ElliotBayTrailMyrtlePark,01/01/2015 07:00:00 PM,48,-122,4,1,5
8780,ElliotBayTrailMyrtlePark,01/01/2015 08:00:00 PM,48,-122,0,2,2
8781,ElliotBayTrailMyrtlePark,01/01/2015 09:00:00 PM,48,-122,1,0,1
8782,ElliotBayTrailMyrtlePark,01/01/2015 10:00:00 PM,48,-122,0,0,0
8783,ElliotBayTrailMyrtlePark,01/01/2015 11:00:00 PM,48,-122,0,0,0
8784,ElliotBayTrailMyrtlePark,01/02/2015 12:00:00 AM,48,-122,1,0,1
8785,ElliotBayTrailMyrtlePark,01/02/2015 01:00:00 AM,48,-122,0,0,0
8786,ElliotBayTrailMyrtlePark,01/02/2015 02:00:00 AM,48,-122,1,0,1
8787,ElliotBayTrailMyrtlePark,01/02/2015 03:00:00 AM,48,-122,0,0,0
8788,ElliotBayTrailMyrtlePark,01/02/2015 04:00:00 AM,48,-122,0,0,0
8789,ElliotBayTrailMyrtlePark,01/02/2015 05:00:00 AM,48,-122,3,5,8
8790,ElliotBayTrailMyrtlePark,01/02/2015 06:00:00 AM,48,-122,5,6,11
8791,ElliotBayTrailMyrtlePark,01/02/2015 07:00:00 AM,48,-122,11,17,28
8792,ElliotBayTrailMyrtlePark,01/02/2015 08:00:00 AM,48,-122,11,39,50
8793,ElliotBayTrailMyrtlePark,01/02/2015 09:00:00 AM,48,-122,5,25,30
8794,ElliotBayTrailMyrtlePark,01/02/2015 10:00:00 AM,48,-122,9,14,23
8795,ElliotBayTrailMyrtlePark,01/02/2015 11:00:00 AM,48,-122,13,9,22
8796,ElliotBayTrailMyrtlePark,01/02/2015 12:00:00 PM,48,-122,4,5,9
8797,ElliotBayTrailMyrtlePark,01/02/2015 01:00:00 PM,48,-122,4,10,14
8798,ElliotBayTrailMyrtlePark,01/02/2015 02:00:00 PM,48,-122,13,15,28
8799,ElliotBayTrailMyrtlePark,01/02/2015 03:00:00 PM,48,-122,24,14,38
8800,ElliotBayTrailMyrtlePark,01/02/2015 04:00:00 PM,48,-122,24,8,32
8801,ElliotBayTrailMyrtlePark,01/02/2015 05:00:00 PM,48,-122,29,8,37
8802,ElliotBayTrailMyrtlePark,01/02/2015 06:00:00 PM,48,-122,13,1,14
8803,ElliotBayTrailMyrtlePark,01/02/2015 07:00:00 PM,48,-122,11,0,11
8804,ElliotBayTrailMyrtlePark,01/02/2015 08:00:00 PM,48,-122,0,0,0
8805,ElliotBayTrailMyrtlePark,01/02/2015 09:00:00 PM,48,-122,4,1,5
8806,ElliotBayTrailMyrtlePark,01/02/2015 10:00:00 PM,48,-122,4,0,4
8807,ElliotBayTrailMyrtlePark,01/02/2015 11:00:00 PM,48,-122,0,0,0
8808,ElliotBayTrailMyrtlePark,01/03/2015 12:00:00 AM,48,-122,3,1,4
8809,ElliotBayTrailMyrtlePark,01/03/2015 01:00:00 AM,48,-122,1,0,1
8810,ElliotBayTrailMyrtlePark,01/03/2015 02:00:00 AM,48,-122,2,0,2
8811,ElliotBayTrailMyrtlePark,01/03/2015 03:00:00 AM,48,-122,0,0,0
8812,ElliotBayTrailMyrtlePark,01/03/2015 04:00:00 AM,48,-122,2,0,2
8813,ElliotBayTrailMyrtlePark,01/03/2015 05:00:00 AM,48,-122,0,1,1
8814,ElliotBayTrailMyrtlePark,01/03/2015 06:00:00 AM,48,-122,1,3,4
8815,ElliotBayTrailMyrtlePark,01/03/2015 07:00:00 AM,48,-122,1,1,2
8816,ElliotBayTrailMyrtlePark,01/03/2015 08:00:00 AM,48,-122,4,6,10
8817,ElliotBayTrailMyrtlePark,01/03/2015 09:00:00 AM,48,-122,9,11,20
8818,ElliotBayTrailMyrtlePark,01/03/2015 10:00:00 AM,48,-122,11,13,24
8819,ElliotBayTrailMyrtlePark,01/03/2015 11:00:00 AM,48,-122,15,12,27
8820,ElliotBayTrailMyrtlePark,01/03/2015 12:00:00 PM,48,-122,14,16,30
8821,ElliotBayTrailMyrtlePark,01/03/2015 01:00:00 PM,48,-122,23,8,31
8822,ElliotBayTrailMyrtlePark,01/03/2015 02:00:00 PM,48,-122,22,11,33
8823,ElliotBayTrailMyrtlePark,01/03/2015 03:00:00 PM,48,-122,13,21,34
8824,ElliotBayTrailMyrtlePark,01/03/2015 04:00:00 PM,48,-122,13,22,35
8825,ElliotBayTrailMyrtlePark,01/03/2015 05:00:00 PM,48,-122,3,14,17
8826,ElliotBayTrailMyrtlePark,01/03/2015 06:00:00 PM,48,-122,1,2,3
8827,ElliotBayTrailMyrtlePark,01/03/2015 07:00:00 PM,48,-122,5,2,7
8828,ElliotBayTrailMyrtlePark,01/03/2015 08:00:00 PM,48,-122,0,2,2
8829,ElliotBayTrailMyrtlePark,01/03/2015 09:00:00 PM,48,-122,5,2,7
8830,ElliotBayTrailMyrtlePark,01/03/2015 10:00:00 PM,48,-122,1,0,1
8831,ElliotBayTrailMyrtlePark,01/03/2015 11:00:00 PM,48,-122,1,0,1
8832,ElliotBayTrailMyrtlePark,01/04/2015 12:00:00 AM,48,-122,1,1,2
8833,ElliotBayTrailMyrtlePark,01/04/2015 01:00:00 AM,48,-122,1,0,1
8834,ElliotBayTrailMyrtlePark,01/04/2015 02:00:00 AM,48,-122,1,1,2
8835,ElliotBayTrailMyrtlePark,01/04/2015 03:00:00 AM,48,-122,1,0,1
8836,ElliotBayTrailMyrtlePark,01/04/2015 04:00:00 AM,48,-122,0,1,1
8837,ElliotBayTrailMyrtlePark,01/04/2015 05:00:00 AM,48,-122,0,1,1
8838,ElliotBayTrailMyrtlePark,01/04/2015 06:00:00 AM,48,-122,0,1,1
8839,ElliotBayTrailMyrtlePark,01/04/2015 07:00:00 AM,48,-122,2,2,4
8840,ElliotBayTrailMyrtlePark,01/04/2015 08:00:00 AM,48,-122,1,0,1
8841,ElliotBayTrailMyrtlePark,01/04/2015 09:00:00 AM,48,-122,3,6,9
8842,ElliotBayTrailMyrtlePark,01/04/2015 10:00:00 AM,48,-122,2,6,8
8843,ElliotBayTrailMyrtlePark,01/04/2015 11:00:00 AM,48,-122,2,7,9
8844,ElliotBayTrailMyrtlePark,01/04/2015 12:00:00 PM,48,-122,8,1,9
8845,ElliotBayTrailMyrtlePark,01/04/2015 01:00:00 PM,48,-122,1,3,4
8846,ElliotBayTrailMyrtlePark,01/04/2015 02:00:00 PM,48,-122,8,4,12
8847,ElliotBayTrailMyrtlePark,01/04/2015 03:00:00 PM,48,-122,4,5,9
8848,ElliotBayTrailMyrtlePark,01/04/2015 04:00:00 PM,48,-122,4,3,7
8849,ElliotBayTrailMyrtlePark,01/04/2015 05:00:00 PM,48,-122,6,4,10
8850,ElliotBayTrailMyrtlePark,01/04/2015 06:00:00 PM,48,-122,5,2,7
8851,ElliotBayTrailMyrtlePark,01/04/2015 07:00:00 PM,48,-122,0,1,1
8852,ElliotBayTrailMyrtlePark,01/04/2015 08:00:00 PM,48,-122,1,0,1
8853,ElliotBayTrailMyrtlePark,01/04/2015 09:00:00 PM,48,-122,1,0,1
8854,ElliotBayTrailMyrtlePark,01/04/2015 10:00:00 PM,48,-122,1,1,2
8855,ElliotBayTrailMyrtlePark,01/04/2015 11:00:00 PM,48,-122,0,0,0
8856,ElliotBayTrailMyrtlePark,01/05/2015 12:00:00 AM,48,-122,0,1,1
8857,ElliotBayTrailMyrtlePark,01/05/2015 01:00:00 AM,48,-122,0,0,0
8858,ElliotBayTrailMyrtlePark,01/05/2015 02:00:00 AM,48,-122,0,0,0
8859,ElliotBayTrailMyrtlePark,01/05/2015 03:00:00 AM,48,-122,0,1,1
8860,ElliotBayTrailMyrtlePark,01/05/2015 04:00:00 AM,48,-122,0,0,0
8861,ElliotBayTrailMyrtlePark,01/05/2015 05:00:00 AM,48,-122,4,11,15
8862,ElliotBayTrailMyrtlePark,01/05/2015 06:00:00 AM,48,-122,15,16,31
8863,ElliotBayTrailMyrtlePark,01/05/2015 07:00:00 AM,48,-122,25,36,61
8864,ElliotBayTrailMyrtlePark,01/05/2015 08:00:00 AM,48,-122,26,83,109
8865,ElliotBayTrailMyrtlePark,01/05/2015 09:00:00 AM,48,-122,10,44,54
8866,ElliotBayTrailMyrtlePark,01/05/2015 10:00:00 AM,48,-122,8,12,20
8867,ElliotBayTrailMyrtlePark,01/05/2015 11:00:00 AM,48,-122,2,4,6
8868,ElliotBayTrailMyrtlePark,01/05/2015 12:00:00 PM,48,-122,2,2,4
8869,ElliotBayTrailMyrtlePark,01/05/2015 01:00:00 PM,48,-122,5,4,9
8870,ElliotBayTrailMyrtlePark,01/05/2015 02:00:00 PM,48,-122,6,12,18
8871,ElliotBayTrailMyrtlePark,01/05/2015 03:00:00 PM,48,-122,14,6,20
8872,ElliotBayTrailMyrtlePark,01/05/2015 04:00:00 PM,48,-122,35,24,59
8873,ElliotBayTrailMyrtlePark,01/05/2015 05:00:00 PM,48,-122,85,27,112
8874,ElliotBayTrailMyrtlePark,01/05/2015 06:00:00 PM,48,-122,55,14,69
8875,ElliotBayTrailMyrtlePark,01/05/2015 07:00:00 PM,48,-122,21,4,25
8876,ElliotBayTrailMyrtlePark,01/05/2015 08:00:00 PM,48,-122,4,1,5
8877,ElliotBayTrailMyrtlePark,01/05/2015 09:00:00 PM,48,-122,4,1,5
8878,ElliotBayTrailMyrtlePark,01/05/2015 10:00:00 PM,48,-122,1,0,1
8879,ElliotBayTrailMyrtlePark,01/05/2015 11:00:00 PM,48,-122,1,0,1
8880,ElliotBayTrailMyrtlePark,01/06/2015 12:00:00 AM,48,-122,3,2,5
8881,ElliotBayTrailMyrtlePark,01/06/2015 01:00:00 AM,48,-122,0,0,0
8882,ElliotBayTrailMyrtlePark,01/06/2015 02:00:00 AM,48,-122,2,0,2
8883,ElliotBayTrailMyrtlePark,01/06/2015 03:00:00 AM,48,-122,0,0,0
8884,ElliotBayTrailMyrtlePark,01/06/2015 04:00:00 AM,48,-122,0,0,0
8885,ElliotBayTrailMyrtlePark,01/06/2015 05:00:00 AM,48,-122,5,10,15
8886,ElliotBayTrailMyrtlePark,01/06/2015 06:00:00 AM,48,-122,13,9,22
8887,ElliotBayTrailMyrtlePark,01/06/2015 07:00:00 AM,48,-122,33,65,98
8888,ElliotBayTrailMyrtlePark,01/06/2015 08:00:00 AM,48,-122,38,119,157
8889,ElliotBayTrailMyrtlePark,01/06/2015 09:00:00 AM,48,-122,18,78,96
8890,ElliotBayTrailMyrtlePark,01/06/2015 10:00:00 AM,48,-122,9,16,25
8891,ElliotBayTrailMyrtlePark,01/06/2015 11:00:00 AM,48,-122,12,9,21
8892,ElliotBayTrailMyrtlePark,01/06/2015 12:00:00 PM,48,-122,6,7,13
8893,ElliotBayTrailMyrtlePark,01/06/2015 01:00:00 PM,48,-122,12,16,28
8894,ElliotBayTrailMyrtlePark,01/06/2015 02:00:00 PM,48,-122,12,25,37
8895,ElliotBayTrailMyrtlePark,01/06/2015 03:00:00 PM,48,-122,18,18,36
8896,ElliotBayTrailMyrtlePark,01/06/2015 04:00:00 PM,48,-122,54,37,91
8897,ElliotBayTrailMyrtlePark,01/06/2015 05:00:00 PM,48,-122,136,46,182
8898,ElliotBayTrailMyrtlePark,01/06/2015 06:00:00 PM,48,-122,87,23,110
8899,ElliotBayTrailMyrtlePark,01/06/2015 07:00:00 PM,48,-122,35,11,46
8900,ElliotBayTrailMyrtlePark,01/06/2015 08:00:00 PM,48,-122,4,2,6
8901,ElliotBayTrailMyrtlePark,01/06/2015 09:00:00 PM,48,-122,8,1,9
8902,ElliotBayTrailMyrtlePark,01/06/2015 10:00:00 PM,48,-122,2,0,2
8903,ElliotBayTrailMyrtlePark,01/06/2015 11:00:00 PM,48,-122,0,1,1
8904,ElliotBayTrailMyrtlePark,01/07/2015 12:00:00 AM,48,-122,3,2,5
8905,ElliotBayTrailMyrtlePark,01/07/2015 01:00:00 AM,48,-122,0,0,0
8906,ElliotBayTrailMyrtlePark,01/07/2015 02:00:00 AM,48,-122,1,0,1
8907,ElliotBayTrailMyrtlePark,01/07/2015 03:00:00 AM,48,-122,0,0,0
8908,ElliotBayTrailMyrtlePark,01/07/2015 04:00:00 AM,48,-122,2,1,3
8909,ElliotBayTrailMyrtlePark,01/07/2015 05:00:00 AM,48,-122,6,8,14
8910,ElliotBayTrailMyrtlePark,01/07/2015 06:00:00 AM,48,-122,17,22,39
8911,ElliotBayTrailMyrtlePark,01/07/2015 07:00:00 AM,48,-122,31,53,84
8912,ElliotBayTrailMyrtlePark,01/07/2015 08:00:00 AM,48,-122,40,110,150
8913,ElliotBayTrailMyrtlePark,01/07/2015 09:00:00 AM,48,-122,24,65,89
8914,ElliotBayTrailMyrtlePark,01/07/2015 10:00:00 AM,48,-122,2,24,26
8915,ElliotBayTrailMyrtlePark,01/07/2015 11:00:00 AM,48,-122,10,15,25
8916,ElliotBayTrailMyrtlePark,01/07/2015 12:00:00 PM,48,-122,10,10,20
8917,ElliotBayTrailMyrtlePark,01/07/2015 01:00:00 PM,48,-122,15,6,21
8918,ElliotBayTrailMyrtlePark,01/07/2015 02:00:00 PM,48,-122,18,24,42
8919,ElliotBayTrailMyrtlePark,01/07/2015 03:00:00 PM,48,-122,27,24,51
8920,ElliotBayTrailMyrtlePark,01/07/2015 04:00:00 PM,48,-122,56,41,97
8921,ElliotBayTrailMyrtlePark,01/07/2015 05:00:00 PM,48,-122,135,48,183
8922,ElliotBayTrailMyrtlePark,01/07/2015 06:00:00 PM,48,-122,81,18,99
8923,ElliotBayTrailMyrtlePark,01/07/2015 07:00:00 PM,48,-122,24,7,31
8924,ElliotBayTrailMyrtlePark,01/07/2015 08:00:00 PM,48,-122,8,7,15
8925,ElliotBayTrailMyrtlePark,01/07/2015 09:00:00 PM,48,-122,8,1,9
8926,ElliotBayTrailMyrtlePark,01/07/2015 10:00:00 PM,48,-122,2,2,4
8927,ElliotBayTrailMyrtlePark,01/07/2015 11:00:00 PM,48,-122,3,0,3
8928,ElliotBayTrailMyrtlePark,01/08/2015 12:00:00 AM,48,-122,1,0,1
8929,ElliotBayTrailMyrtlePark,01/08/2015 01:00:00 AM,48,-122,0,0,0
8930,ElliotBayTrailMyrtlePark,01/08/2015 02:00:00 AM,48,-122,2,0,2
8931,ElliotBayTrailMyrtlePark,01/08/2015 03:00:00 AM,48,-122,0,0,0
8932,ElliotBayTrailMyrtlePark,01/08/2015 04:00:00 AM,48,-122,0,0,0
8933,ElliotBayTrailMyrtlePark,01/08/2015 05:00:00 AM,48,-122,7,8,15
8934,ElliotBayTrailMyrtlePark,01/08/2015 06:00:00 AM,48,-122,17,20,37
8935,ElliotBayTrailMyrtlePark,01/08/2015 07:00:00 AM,48,-122,35,49,84
8936,ElliotBayTrailMyrtlePark,01/08/2015 08:00:00 AM,48,-122,32,119,151
8937,ElliotBayTrailMyrtlePark,01/08/2015 09:00:00 AM,48,-122,19,66,85
8938,ElliotBayTrailMyrtlePark,01/08/2015 10:00:00 AM,48,-122,10,25,35
8939,ElliotBayTrailMyrtlePark,01/08/2015 11:00:00 AM,48,-122,11,8,19
8940,ElliotBayTrailMyrtlePark,01/08/2015 12:00:00 PM,48,-122,18,20,38
8941,ElliotBayTrailMyrtlePark,01/08/2015 01:00:00 PM,48,-122,25,17,42
8942,ElliotBayTrailMyrtlePark,01/08/2015 02:00:00 PM,48,-122,20,41,61
8943,ElliotBayTrailMyrtlePark,01/08/2015 03:00:00 PM,48,-122,31,25,56
8944,ElliotBayTrailMyrtlePark,01/08/2015 04:00:00 PM,48,-122,59,49,108
8945,ElliotBayTrailMyrtlePark,01/08/2015 05:00:00 PM,48,-122,113,36,149
8946,ElliotBayTrailMyrtlePark,01/08/2015 06:00:00 PM,48,-122,77,22,99
8947,ElliotBayTrailMyrtlePark,01/08/2015 07:00:00 PM,48,-122,27,7,34
8948,ElliotBayTrailMyrtlePark,01/08/2015 08:00:00 PM,48,-122,9,2,11
8949,ElliotBayTrailMyrtlePark,01/08/2015 09:00:00 PM,48,-122,5,3,8
8950,ElliotBayTrailMyrtlePark,01/08/2015 10:00:00 PM,48,-122,7,2,9
8951,ElliotBayTrailMyrtlePark,01/08/2015 11:00:00 PM,48,-122,5,1,6
8952,ElliotBayTrailMyrtlePark,01/09/2015 12:00:00 AM,48,-122,0,0,0
8953,ElliotBayTrailMyrtlePark,01/09/2015 01:00:00 AM,48,-122,0,0,0
8954,ElliotBayTrailMyrtlePark,01/09/2015 02:00:00 AM,48,-122,1,0,1
8955,ElliotBayTrailMyrtlePark,01/09/2015 03:00:00 AM,48,-122,0,0,0
8956,ElliotBayTrailMyrtlePark,01/09/2015 04:00:00 AM,48,-122,0,0,0
8957,ElliotBayTrailMyrtlePark,01/09/2015 05:00:00 AM,48,-122,4,11,15
8958,ElliotBayTrailMyrtlePark,01/09/2015 06:00:00 AM,48,-122,15,15,30
8959,ElliotBayTrailMyrtlePark,01/09/2015 07:00:00 AM,48,-122,25,38,63
8960,ElliotBayTrailMyrtlePark,01/09/2015 08:00:00 AM,48,-122,31,79,110
8961,ElliotBayTrailMyrtlePark,01/09/2015 09:00:00 AM,48,-122,20,59,79
8962,ElliotBayTrailMyrtlePark,01/09/2015 10:00:00 AM,48,-122,10,17,27
8963,ElliotBayTrailMyrtlePark,01/09/2015 11:00:00 AM,48,-122,12,10,22
8964,ElliotBayTrailMyrtlePark,01/09/2015 12:00:00 PM,48,-122,11,6,17
8965,ElliotBayTrailMyrtlePark,01/09/2015 01:00:00 PM,48,-122,11,10,21
8966,ElliotBayTrailMyrtlePark,01/09/2015 02:00:00 PM,48,-122,17,24,41
8967,ElliotBayTrailMyrtlePark,01/09/2015 03:00:00 PM,48,-122,34,20,54
8968,ElliotBayTrailMyrtlePark,01/09/2015 04:00:00 PM,48,-122,54,40,94
8969,ElliotBayTrailMyrtlePark,01/09/2015 05:00:00 PM,48,-122,96,46,142
8970,ElliotBayTrailMyrtlePark,01/09/2015 06:00:00 PM,48,-122,62,9,71
8971,ElliotBayTrailMyrtlePark,01/09/2015 07:00:00 PM,48,-122,19,8,27
8972,ElliotBayTrailMyrtlePark,01/09/2015 08:00:00 PM,48,-122,7,0,7
8973,ElliotBayTrailMyrtlePark,01/09/2015 09:00:00 PM,48,-122,5,1,6
8974,ElliotBayTrailMyrtlePark,01/09/2015 10:00:00 PM,48,-122,3,3,6
8975,ElliotBayTrailMyrtlePark,01/09/2015 11:00:00 PM,48,-122,2,1,3
8976,ElliotBayTrailMyrtlePark,01/10/2015 12:00:00 AM,48,-122,1,0,1
8977,ElliotBayTrailMyrtlePark,01/10/2015 01:00:00 AM,48,-122,1,1,2
8978,ElliotBayTrailMyrtlePark,01/10/2015 02:00:00 AM,48,-122,2,0,2
8979,ElliotBayTrailMyrtlePark,01/10/2015 03:00:00 AM,48,-122,0,0,0
8980,ElliotBayTrailMyrtlePark,01/10/2015 04:00:00 AM,48,-122,1,0,1
8981,ElliotBayTrailMyrtlePark,01/10/2015 05:00:00 AM,48,-122,0,2,2
8982,ElliotBayTrailMyrtlePark,01/10/2015 06:00:00 AM,48,-122,3,2,5
8983,ElliotBayTrailMyrtlePark,01/10/2015 07:00:00 AM,48,-122,1,7,8
8984,ElliotBayTrailMyrtlePark,01/10/2015 08:00:00 AM,48,-122,6,5,11
8985,ElliotBayTrailMyrtlePark,01/10/2015 09:00:00 AM,48,-122,14,23,37
8986,ElliotBayTrailMyrtlePark,01/10/2015 10:00:00 AM,48,-122,16,10,26
8987,ElliotBayTrailMyrtlePark,01/10/2015 11:00:00 AM,48,-122,16,14,30
8988,ElliotBayTrailMyrtlePark,01/10/2015 12:00:00 PM,48,-122,13,6,19
8989,ElliotBayTrailMyrtlePark,01/10/2015 01:00:00 PM,48,-122,17,16,33
8990,ElliotBayTrailMyrtlePark,01/10/2015 02:00:00 PM,48,-122,10,12,22
8991,ElliotBayTrailMyrtlePark,01/10/2015 03:00:00 PM,48,-122,10,12,22
8992,ElliotBayTrailMyrtlePark,01/10/2015 04:00:00 PM,48,-122,15,7,22
8993,ElliotBayTrailMyrtlePark,01/10/2015 05:00:00 PM,48,-122,9,8,17
8994,ElliotBayTrailMyrtlePark,01/10/2015 06:00:00 PM,48,-122,8,2,10
8995,ElliotBayTrailMyrtlePark,01/10/2015 07:00:00 PM,48,-122,3,2,5
8996,ElliotBayTrailMyrtlePark,01/10/2015 08:00:00 PM,48,-122,4,7,11
8997,ElliotBayTrailMyrtlePark,01/10/2015 09:00:00 PM,48,-122,4,2,6
8998,ElliotBayTrailMyrtlePark,01/10/2015 10:00:00 PM,48,-122,1,4,5
8999,ElliotBayTrailMyrtlePark,01/10/2015 11:00:00 PM,48,-122,3,1,4
9000,ElliotBayTrailMyrtlePark,01/11/2015 12:00:00 AM,48,-122,0,0,0
9001,ElliotBayTrailMyrtlePark,01/11/2015 01:00:00 AM,48,-122,0,0,0
9002,ElliotBayTrailMyrtlePark,01/11/2015 02:00:00 AM,48,-122,0,0,0
9003,ElliotBayTrailMyrtlePark,01/11/2015 03:00:00 AM,48,-122,0,0,0
9004,ElliotBayTrailMyrtlePark,01/11/2015 04:00:00 AM,48,-122,0,0,0
9005,ElliotBayTrailMyrtlePark,01/11/2015 05:00:00 AM,48,-122,1,1,2
9006,ElliotBayTrailMyrtlePark,01/11/2015 06:00:00 AM,48,-122,1,2,3
9007,ElliotBayTrailMyrtlePark,01/11/2015 07:00:00 AM,48,-122,3,1,4
9008,ElliotBayTrailMyrtlePark,01/11/2015 08:00:00 AM,48,-122,3,7,10
9009,ElliotBayTrailMyrtlePark,01/11/2015 09:00:00 AM,48,-122,12,7,19
9010,ElliotBayTrailMyrtlePark,01/11/2015 10:00:00 AM,48,-122,13,12,25
9011,ElliotBayTrailMyrtlePark,01/11/2015 11:00:00 AM,48,-122,20,14,34
9012,ElliotBayTrailMyrtlePark,01/11/2015 12:00:00 PM,48,-122,17,17,34
9013,ElliotBayTrailMyrtlePark,01/11/2015 01:00:00 PM,48,-122,26,16,42
9014,ElliotBayTrailMyrtlePark,01/11/2015 02:00:00 PM,48,-122,37,23,60
9015,ElliotBayTrailMyrtlePark,01/11/2015 03:00:00 PM,48,-122,26,17,43
9016,ElliotBayTrailMyrtlePark,01/11/2015 04:00:00 PM,48,-122,16,18,34
9017,ElliotBayTrailMyrtlePark,01/11/2015 05:00:00 PM,48,-122,4,2,6
9018,ElliotBayTrailMyrtlePark,01/11/2015 06:00:00 PM,48,-122,10,3,13
9019,ElliotBayTrailMyrtlePark,01/11/2015 07:00:00 PM,48,-122,4,5,9
9020,ElliotBayTrailMyrtlePark,01/11/2015 08:00:00 PM,48,-122,1,0,1
9021,ElliotBayTrailMyrtlePark,01/11/2015 09:00:00 PM,48,-122,1,2,3
9022,ElliotBayTrailMyrtlePark,01/11/2015 10:00:00 PM,48,-122,2,1,3
9023,ElliotBayTrailMyrtlePark,01/11/2015 11:00:00 PM,48,-122,0,1,1
9024,ElliotBayTrailMyrtlePark,01/12/2015 12:00:00 AM,48,-122,0,0,0
9025,ElliotBayTrailMyrtlePark,01/12/2015 01:00:00 AM,48,-122,0,0,0
9026,ElliotBayTrailMyrtlePark,01/12/2015 02:00:00 AM,48,-122,1,0,1
9027,ElliotBayTrailMyrtlePark,01/12/2015 03:00:00 AM,48,-122,0,0,0
9028,ElliotBayTrailMyrtlePark,01/12/2015 04:00:00 AM,48,-122,0,0,0
9029,ElliotBayTrailMyrtlePark,01/12/2015 05:00:00 AM,48,-122,4,9,13
9030,ElliotBayTrailMyrtlePark,01/12/2015 06:00:00 AM,48,-122,13,25,38
9031,ElliotBayTrailMyrtlePark,01/12/2015 07:00:00 AM,48,-122,30,54,84
9032,ElliotBayTrailMyrtlePark,01/12/2015 08:00:00 AM,48,-122,23,95,118
9033,ElliotBayTrailMyrtlePark,01/12/2015 09:00:00 AM,48,-122,14,60,74
9034,ElliotBayTrailMyrtlePark,01/12/2015 10:00:00 AM,48,-122,9,15,24
9035,ElliotBayTrailMyrtlePark,01/12/2015 11:00:00 AM,48,-122,12,17,29
9036,ElliotBayTrailMyrtlePark,01/12/2015 12:00:00 PM,48,-122,14,18,32
9037,ElliotBayTrailMyrtlePark,01/12/2015 01:00:00 PM,48,-122,20,18,38
9038,ElliotBayTrailMyrtlePark,01/12/2015 02:00:00 PM,48,-122,17,28,45
9039,ElliotBayTrailMyrtlePark,01/12/2015 03:00:00 PM,48,-122,25,32,57
9040,ElliotBayTrailMyrtlePark,01/12/2015 04:00:00 PM,48,-122,66,39,105
9041,ElliotBayTrailMyrtlePark,01/12/2015 05:00:00 PM,48,-122,136,40,176
9042,ElliotBayTrailMyrtlePark,01/12/2015 06:00:00 PM,48,-122,87,18,105
9043,ElliotBayTrailMyrtlePark,01/12/2015 07:00:00 PM,48,-122,19,2,21
9044,ElliotBayTrailMyrtlePark,01/12/2015 08:00:00 PM,48,-122,9,0,9
9045,ElliotBayTrailMyrtlePark,01/12/2015 09:00:00 PM,48,-122,5,1,6
9046,ElliotBayTrailMyrtlePark,01/12/2015 10:00:00 PM,48,-122,2,2,4
9047,ElliotBayTrailMyrtlePark,01/12/2015 11:00:00 PM,48,-122,0,1,1
9048,ElliotBayTrailMyrtlePark,01/13/2015 12:00:00 AM,48,-122,1,3,4
9049,ElliotBayTrailMyrtlePark,01/13/2015 01:00:00 AM,48,-122,1,0,1
9050,ElliotBayTrailMyrtlePark,01/13/2015 02:00:00 AM,48,-122,1,0,1
9051,ElliotBayTrailMyrtlePark,01/13/2015 03:00:00 AM,48,-122,0,0,0
9052,ElliotBayTrailMyrtlePark,01/13/2015 04:00:00 AM,48,-122,0,0,0
9053,ElliotBayTrailMyrtlePark,01/13/2015 05:00:00 AM,48,-122,5,10,15
9054,ElliotBayTrailMyrtlePark,01/13/2015 06:00:00 AM,48,-122,13,18,31
9055,ElliotBayTrailMyrtlePark,01/13/2015 07:00:00 AM,48,-122,34,65,99
9056,ElliotBayTrailMyrtlePark,01/13/2015 08:00:00 AM,48,-122,33,114,147
9057,ElliotBayTrailMyrtlePark,01/13/2015 09:00:00 AM,48,-122,27,67,94
9058,ElliotBayTrailMyrtlePark,01/13/2015 10:00:00 AM,48,-122,13,16,29
9059,ElliotBayTrailMyrtlePark,01/13/2015 11:00:00 AM,48,-122,15,21,36
9060,ElliotBayTrailMyrtlePark,01/13/2015 12:00:00 PM,48,-122,14,17,31
9061,ElliotBayTrailMyrtlePark,01/13/2015 01:00:00 PM,48,-122,18,25,43
9062,ElliotBayTrailMyrtlePark,01/13/2015 02:00:00 PM,48,-122,22,26,48
9063,ElliotBayTrailMyrtlePark,01/13/2015 03:00:00 PM,48,-122,26,25,51
9064,ElliotBayTrailMyrtlePark,01/13/2015 04:00:00 PM,48,-122,56,36,92
9065,ElliotBayTrailMyrtlePark,01/13/2015 05:00:00 PM,48,-122,147,48,195
9066,ElliotBayTrailMyrtlePark,01/13/2015 06:00:00 PM,48,-122,101,27,128
9067,ElliotBayTrailMyrtlePark,01/13/2015 07:00:00 PM,48,-122,31,14,45
9068,ElliotBayTrailMyrtlePark,01/13/2015 08:00:00 PM,48,-122,1,4,5
9069,ElliotBayTrailMyrtlePark,01/13/2015 09:00:00 PM,48,-122,9,1,10
9070,ElliotBayTrailMyrtlePark,01/13/2015 10:00:00 PM,48,-122,4,1,5
9071,ElliotBayTrailMyrtlePark,01/13/2015 11:00:00 PM,48,-122,2,0,2
9072,ElliotBayTrailMyrtlePark,01/14/2015 12:00:00 AM,48,-122,1,2,3
9073,ElliotBayTrailMyrtlePark,01/14/2015 01:00:00 AM,48,-122,0,0,0
9074,ElliotBayTrailMyrtlePark,01/14/2015 02:00:00 AM,48,-122,1,0,1
9075,ElliotBayTrailMyrtlePark,01/14/2015 03:00:00 AM,48,-122,0,0,0
9076,ElliotBayTrailMyrtlePark,01/14/2015 04:00:00 AM,48,-122,0,0,0
9077,ElliotBayTrailMyrtlePark,01/14/2015 05:00:00 AM,48,-122,3,12,15
9078,ElliotBayTrailMyrtlePark,01/14/2015 06:00:00 AM,48,-122,13,24,37
9079,ElliotBayTrailMyrtlePark,01/14/2015 07:00:00 AM,48,-122,30,52,82
9080,ElliotBayTrailMyrtlePark,01/14/2015 08:00:00 AM,48,-122,34,110,144
9081,ElliotBayTrailMyrtlePark,01/14/2015 09:00:00 AM,48,-122,16,64,80
9082,ElliotBayTrailMyrtlePark,01/14/2015 10:00:00 AM,48,-122,18,21,39
9083,ElliotBayTrailMyrtlePark,01/14/2015 11:00:00 AM,48,-122,8,12,20
9084,ElliotBayTrailMyrtlePark,01/14/2015 12:00:00 PM,48,-122,13,14,27
9085,ElliotBayTrailMyrtlePark,01/14/2015 01:00:00 PM,48,-122,23,20,43
9086,ElliotBayTrailMyrtlePark,01/14/2015 02:00:00 PM,48,-122,24,28,52
9087,ElliotBayTrailMyrtlePark,01/14/2015 03:00:00 PM,48,-122,34,24,58
9088,ElliotBayTrailMyrtlePark,01/14/2015 04:00:00 PM,48,-122,69,45,114
9089,ElliotBayTrailMyrtlePark,01/14/2015 05:00:00 PM,48,-122,135,48,183
9090,ElliotBayTrailMyrtlePark,01/14/2015 06:00:00 PM,48,-122,76,20,96
9091,ElliotBayTrailMyrtlePark,01/14/2015 07:00:00 PM,48,-122,34,4,38
9092,ElliotBayTrailMyrtlePark,01/14/2015 08:00:00 PM,48,-122,6,2,8
9093,ElliotBayTrailMyrtlePark,01/14/2015 09:00:00 PM,48,-122,9,0,9
9094,ElliotBayTrailMyrtlePark,01/14/2015 10:00:00 PM,48,-122,5,5,10
9095,ElliotBayTrailMyrtlePark,01/14/2015 11:00:00 PM,48,-122,0,1,1
9096,ElliotBayTrailMyrtlePark,01/15/2015 12:00:00 AM,48,-122,1,1,2
9097,ElliotBayTrailMyrtlePark,01/15/2015 01:00:00 AM,48,-122,0,0,0
9098,ElliotBayTrailMyrtlePark,01/15/2015 02:00:00 AM,48,-122,1,0,1
9099,ElliotBayTrailMyrtlePark,01/15/2015 03:00:00 AM,48,-122,1,0,1
9100,ElliotBayTrailMyrtlePark,01/15/2015 04:00:00 AM,48,-122,0,0,0
9101,ElliotBayTrailMyrtlePark,01/15/2015 05:00:00 AM,48,-122,6,7,13
9102,ElliotBayTrailMyrtlePark,01/15/2015 06:00:00 AM,48,-122,15,20,35
9103,ElliotBayTrailMyrtlePark,01/15/2015 07:00:00 AM,48,-122,28,55,83
9104,ElliotBayTrailMyrtlePark,01/15/2015 08:00:00 AM,48,-122,23,87,110
9105,ElliotBayTrailMyrtlePark,01/15/2015 09:00:00 AM,48,-122,12,54,66
9106,ElliotBayTrailMyrtlePark,01/15/2015 10:00:00 AM,48,-122,11,15,26
9107,ElliotBayTrailMyrtlePark,01/15/2015 11:00:00 AM,48,-122,6,7,13
9108,ElliotBayTrailMyrtlePark,01/15/2015 12:00:00 PM,48,-122,11,8,19
9109,ElliotBayTrailMyrtlePark,01/15/2015 01:00:00 PM,48,-122,5,5,10
9110,ElliotBayTrailMyrtlePark,01/15/2015 02:00:00 PM,48,-122,9,9,18
9111,ElliotBayTrailMyrtlePark,01/15/2015 03:00:00 PM,48,-122,10,16,26
9112,ElliotBayTrailMyrtlePark,01/15/2015 04:00:00 PM,48,-122,44,24,68
9113,ElliotBayTrailMyrtlePark,01/15/2015 05:00:00 PM,48,-122,82,32,114
9114,ElliotBayTrailMyrtlePark,01/15/2015 06:00:00 PM,48,-122,59,8,67
9115,ElliotBayTrailMyrtlePark,01/15/2015 07:00:00 PM,48,-122,15,4,19
9116,ElliotBayTrailMyrtlePark,01/15/2015 08:00:00 PM,48,-122,1,1,2
9117,ElliotBayTrailMyrtlePark,01/15/2015 09:00:00 PM,48,-122,4,1,5
9118,ElliotBayTrailMyrtlePark,01/15/2015 10:00:00 PM,48,-122,3,2,5
9119,ElliotBayTrailMyrtlePark,01/15/2015 11:00:00 PM,48,-122,1,1,2
9120,ElliotBayTrailMyrtlePark,01/16/2015 12:00:00 AM,48,-122,2,1,3
9121,ElliotBayTrailMyrtlePark,01/16/2015 01:00:00 AM,48,-122,0,0,0
9122,ElliotBayTrailMyrtlePark,01/16/2015 02:00:00 AM,48,-122,1,0,1
9123,ElliotBayTrailMyrtlePark,01/16/2015 03:00:00 AM,48,-122,1,0,1
9124,ElliotBayTrailMyrtlePark,01/16/2015 04:00:00 AM,48,-122,0,0,0
9125,ElliotBayTrailMyrtlePark,01/16/2015 05:00:00 AM,48,-122,4,9,13
9126,ElliotBayTrailMyrtlePark,01/16/2015 06:00:00 AM,48,-122,10,11,21
9127,ElliotBayTrailMyrtlePark,01/16/2015 07:00:00 AM,48,-122,30,48,78
9128,ElliotBayTrailMyrtlePark,01/16/2015 08:00:00 AM,48,-122,21,93,114
9129,ElliotBayTrailMyrtlePark,01/16/2015 09:00:00 AM,48,-122,14,59,73
9130,ElliotBayTrailMyrtlePark,01/16/2015 10:00:00 AM,48,-122,10,8,18
9131,ElliotBayTrailMyrtlePark,01/16/2015 11:00:00 AM,48,-122,11,10,21
9132,ElliotBayTrailMyrtlePark,01/16/2015 12:00:00 PM,48,-122,11,15,26
9133,ElliotBayTrailMyrtlePark,01/16/2015 01:00:00 PM,48,-122,18,14,32
9134,ElliotBayTrailMyrtlePark,01/16/2015 02:00:00 PM,48,-122,27,18,45
9135,ElliotBayTrailMyrtlePark,01/16/2015 03:00:00 PM,48,-122,41,32,73
9136,ElliotBayTrailMyrtlePark,01/16/2015 04:00:00 PM,48,-122,86,44,130
9137,ElliotBayTrailMyrtlePark,01/16/2015 05:00:00 PM,48,-122,106,42,148
9138,ElliotBayTrailMyrtlePark,01/16/2015 06:00:00 PM,48,-122,48,18,66
9139,ElliotBayTrailMyrtlePark,01/16/2015 07:00:00 PM,48,-122,15,8,23
9140,ElliotBayTrailMyrtlePark,01/16/2015 08:00:00 PM,48,-122,5,1,6
9141,ElliotBayTrailMyrtlePark,01/16/2015 09:00:00 PM,48,-122,3,1,4
9142,ElliotBayTrailMyrtlePark,01/16/2015 10:00:00 PM,48,-122,1,1,2
9143,ElliotBayTrailMyrtlePark,01/16/2015 11:00:00 PM,48,-122,7,0,7
9144,ElliotBayTrailMyrtlePark,01/17/2015 12:00:00 AM,48,-122,2,0,2
9145,ElliotBayTrailMyrtlePark,01/17/2015 01:00:00 AM,48,-122,3,2,5
9146,ElliotBayTrailMyrtlePark,01/17/2015 02:00:00 AM,48,-122,1,0,1
9147,ElliotBayTrailMyrtlePark,01/17/2015 03:00:00 AM,48,-122,2,0,2
9148,ElliotBayTrailMyrtlePark,01/17/2015 04:00:00 AM,48,-122,0,0,0
9149,ElliotBayTrailMyrtlePark,01/17/2015 05:00:00 AM,48,-122,0,3,3
9150,ElliotBayTrailMyrtlePark,01/17/2015 06:00:00 AM,48,-122,2,2,4
9151,ElliotBayTrailMyrtlePark,01/17/2015 07:00:00 AM,48,-122,9,6,15
9152,ElliotBayTrailMyrtlePark,01/17/2015 08:00:00 AM,48,-122,5,10,15
9153,ElliotBayTrailMyrtlePark,01/17/2015 09:00:00 AM,48,-122,7,12,19
9154,ElliotBayTrailMyrtlePark,01/17/2015 10:00:00 AM,48,-122,5,12,17
9155,ElliotBayTrailMyrtlePark,01/17/2015 11:00:00 AM,48,-122,8,8,16
9156,ElliotBayTrailMyrtlePark,01/17/2015 12:00:00 PM,48,-122,7,9,16
9157,ElliotBayTrailMyrtlePark,01/17/2015 01:00:00 PM,48,-122,20,5,25
9158,ElliotBayTrailMyrtlePark,01/17/2015 02:00:00 PM,48,-122,8,12,20
9159,ElliotBayTrailMyrtlePark,01/17/2015 03:00:00 PM,48,-122,7,11,18
9160,ElliotBayTrailMyrtlePark,01/17/2015 04:00:00 PM,48,-122,4,1,5
9161,ElliotBayTrailMyrtlePark,01/17/2015 05:00:00 PM,48,-122,3,2,5
9162,ElliotBayTrailMyrtlePark,01/17/2015 06:00:00 PM,48,-122,4,1,5
9163,ElliotBayTrailMyrtlePark,01/17/2015 07:00:00 PM,48,-122,2,2,4
9164,ElliotBayTrailMyrtlePark,01/17/2015 08:00:00 PM,48,-122,1,4,5
9165,ElliotBayTrailMyrtlePark,01/17/2015 09:00:00 PM,48,-122,2,0,2
9166,ElliotBayTrailMyrtlePark,01/17/2015 10:00:00 PM,48,-122,0,2,2
9167,ElliotBayTrailMyrtlePark,01/17/2015 11:00:00 PM,48,-122,2,0,2
9168,ElliotBayTrailMyrtlePark,01/18/2015 12:00:00 AM,48,-122,1,0,1
9169,ElliotBayTrailMyrtlePark,01/18/2015 01:00:00 AM,48,-122,2,1,3
9170,ElliotBayTrailMyrtlePark,01/18/2015 02:00:00 AM,48,-122,0,0,0
9171,ElliotBayTrailMyrtlePark,01/18/2015 03:00:00 AM,48,-122,0,0,0
9172,ElliotBayTrailMyrtlePark,01/18/2015 04:00:00 AM,48,-122,0,0,0
9173,ElliotBayTrailMyrtlePark,01/18/2015 05:00:00 AM,48,-122,0,1,1
9174,ElliotBayTrailMyrtlePark,01/18/2015 06:00:00 AM,48,-122,0,1,1
9175,ElliotBayTrailMyrtlePark,01/18/2015 07:00:00 AM,48,-122,1,5,6
9176,ElliotBayTrailMyrtlePark,01/18/2015 08:00:00 AM,48,-122,4,5,9
9177,ElliotBayTrailMyrtlePark,01/18/2015 09:00:00 AM,48,-122,4,8,12
9178,ElliotBayTrailMyrtlePark,01/18/2015 10:00:00 AM,48,-122,13,7,20
9179,ElliotBayTrailMyrtlePark,01/18/2015 11:00:00 AM,48,-122,9,10,19
9180,ElliotBayTrailMyrtlePark,01/18/2015 12:00:00 PM,48,-122,5,7,12
9181,ElliotBayTrailMyrtlePark,01/18/2015 01:00:00 PM,48,-122,6,3,9
9182,ElliotBayTrailMyrtlePark,01/18/2015 02:00:00 PM,48,-122,3,12,15
9183,ElliotBayTrailMyrtlePark,01/18/2015 03:00:00 PM,48,-122,3,3,6
9184,ElliotBayTrailMyrtlePark,01/18/2015 04:00:00 PM,48,-122,12,11,23
9185,ElliotBayTrailMyrtlePark,01/18/2015 05:00:00 PM,48,-122,6,7,13
9186,ElliotBayTrailMyrtlePark,01/18/2015 06:00:00 PM,48,-122,6,6,12
9187,ElliotBayTrailMyrtlePark,01/18/2015 07:00:00 PM,48,-122,1,1,2
9188,ElliotBayTrailMyrtlePark,01/18/2015 08:00:00 PM,48,-122,6,0,6
9189,ElliotBayTrailMyrtlePark,01/18/2015 09:00:00 PM,48,-122,2,0,2
9190,ElliotBayTrailMyrtlePark,01/18/2015 10:00:00 PM,48,-122,1,2,3
9191,ElliotBayTrailMyrtlePark,01/18/2015 11:00:00 PM,48,-122,0,0,0
9192,ElliotBayTrailMyrtlePark,01/19/2015 12:00:00 AM,48,-122,0,0,0
9193,ElliotBayTrailMyrtlePark,01/19/2015 01:00:00 AM,48,-122,0,0,0
9194,ElliotBayTrailMyrtlePark,01/19/2015 02:00:00 AM,48,-122,1,0,1
9195,ElliotBayTrailMyrtlePark,01/19/2015 03:00:00 AM,48,-122,0,0,0
9196,ElliotBayTrailMyrtlePark,01/19/2015 04:00:00 AM,48,-122,0,1,1
9197,ElliotBayTrailMyrtlePark,01/19/2015 05:00:00 AM,48,-122,2,1,3
9198,ElliotBayTrailMyrtlePark,01/19/2015 06:00:00 AM,48,-122,8,15,23
9199,ElliotBayTrailMyrtlePark,01/19/2015 07:00:00 AM,48,-122,27,29,56
9200,ElliotBayTrailMyrtlePark,01/19/2015 08:00:00 AM,48,-122,23,61,84
9201,ElliotBayTrailMyrtlePark,01/19/2015 09:00:00 AM,48,-122,12,31,43
9202,ElliotBayTrailMyrtlePark,01/19/2015 10:00:00 AM,48,-122,15,22,37
9203,ElliotBayTrailMyrtlePark,01/19/2015 11:00:00 AM,48,-122,12,30,42
9204,ElliotBayTrailMyrtlePark,01/19/2015 12:00:00 PM,48,-122,18,13,31
9205,ElliotBayTrailMyrtlePark,01/19/2015 01:00:00 PM,48,-122,39,33,72
9206,ElliotBayTrailMyrtlePark,01/19/2015 02:00:00 PM,48,-122,43,33,76
9207,ElliotBayTrailMyrtlePark,01/19/2015 03:00:00 PM,48,-122,34,38,72
9208,ElliotBayTrailMyrtlePark,01/19/2015 04:00:00 PM,48,-122,46,27,73
9209,ElliotBayTrailMyrtlePark,01/19/2015 05:00:00 PM,48,-122,79,31,110
9210,ElliotBayTrailMyrtlePark,01/19/2015 06:00:00 PM,48,-122,35,17,52
9211,ElliotBayTrailMyrtlePark,01/19/2015 07:00:00 PM,48,-122,13,5,18
9212,ElliotBayTrailMyrtlePark,01/19/2015 08:00:00 PM,48,-122,5,2,7
9213,ElliotBayTrailMyrtlePark,01/19/2015 09:00:00 PM,48,-122,6,0,6
9214,ElliotBayTrailMyrtlePark,01/19/2015 10:00:00 PM,48,-122,7,0,7
9215,ElliotBayTrailMyrtlePark,01/19/2015 11:00:00 PM,48,-122,3,0,3
9216,ElliotBayTrailMyrtlePark,01/20/2015 12:00:00 AM,48,-122,0,2,2
9217,ElliotBayTrailMyrtlePark,01/20/2015 01:00:00 AM,48,-122,1,0,1
9218,ElliotBayTrailMyrtlePark,01/20/2015 02:00:00 AM,48,-122,1,0,1
9219,ElliotBayTrailMyrtlePark,01/20/2015 03:00:00 AM,48,-122,0,0,0
9220,ElliotBayTrailMyrtlePark,01/20/2015 04:00:00 AM,48,-122,0,0,0
9221,ElliotBayTrailMyrtlePark,01/20/2015 05:00:00 AM,48,-122,6,12,18
9222,ElliotBayTrailMyrtlePark,01/20/2015 06:00:00 AM,48,-122,10,26,36
9223,ElliotBayTrailMyrtlePark,01/20/2015 07:00:00 AM,48,-122,35,69,104
9224,ElliotBayTrailMyrtlePark,01/20/2015 08:00:00 AM,48,-122,42,107,149
9225,ElliotBayTrailMyrtlePark,01/20/2015 09:00:00 AM,48,-122,25,69,94
9226,ElliotBayTrailMyrtlePark,01/20/2015 10:00:00 AM,48,-122,4,17,21
9227,ElliotBayTrailMyrtlePark,01/20/2015 11:00:00 AM,48,-122,16,10,26
9228,ElliotBayTrailMyrtlePark,01/20/2015 12:00:00 PM,48,-122,23,15,38
9229,ElliotBayTrailMyrtlePark,01/20/2015 01:00:00 PM,48,-122,11,19,30
9230,ElliotBayTrailMyrtlePark,01/20/2015 02:00:00 PM,48,-122,28,40,68
9231,ElliotBayTrailMyrtlePark,01/20/2015 03:00:00 PM,48,-122,41,27,68
9232,ElliotBayTrailMyrtlePark,01/20/2015 04:00:00 PM,48,-122,62,53,115
9233,ElliotBayTrailMyrtlePark,01/20/2015 05:00:00 PM,48,-122,130,62,192
9234,ElliotBayTrailMyrtlePark,01/20/2015 06:00:00 PM,48,-122,91,18,109
9235,ElliotBayTrailMyrtlePark,01/20/2015 07:00:00 PM,48,-122,30,7,37
9236,ElliotBayTrailMyrtlePark,01/20/2015 08:00:00 PM,48,-122,12,3,15
9237,ElliotBayTrailMyrtlePark,01/20/2015 09:00:00 PM,48,-122,2,1,3
9238,ElliotBayTrailMyrtlePark,01/20/2015 10:00:00 PM,48,-122,5,3,8
9239,ElliotBayTrailMyrtlePark,01/20/2015 11:00:00 PM,48,-122,4,1,5
9240,ElliotBayTrailMyrtlePark,01/21/2015 12:00:00 AM,48,-122,0,1,1
9241,ElliotBayTrailMyrtlePark,01/21/2015 01:00:00 AM,48,-122,1,0,1
9242,ElliotBayTrailMyrtlePark,01/21/2015 02:00:00 AM,48,-122,3,0,3
9243,ElliotBayTrailMyrtlePark,01/21/2015 03:00:00 AM,48,-122,0,0,0
9244,ElliotBayTrailMyrtlePark,01/21/2015 04:00:00 AM,48,-122,2,0,2
9245,ElliotBayTrailMyrtlePark,01/21/2015 05:00:00 AM,48,-122,4,8,12
9246,ElliotBayTrailMyrtlePark,01/21/2015 06:00:00 AM,48,-122,15,27,42
9247,ElliotBayTrailMyrtlePark,01/21/2015 07:00:00 AM,48,-122,27,50,77
9248,ElliotBayTrailMyrtlePark,01/21/2015 08:00:00 AM,48,-122,43,105,148
9249,ElliotBayTrailMyrtlePark,01/21/2015 09:00:00 AM,48,-122,19,63,82
9250,ElliotBayTrailMyrtlePark,01/21/2015 10:00:00 AM,48,-122,13,18,31
9251,ElliotBayTrailMyrtlePark,01/21/2015 11:00:00 AM,48,-122,10,9,19
9252,ElliotBayTrailMyrtlePark,01/21/2015 12:00:00 PM,48,-122,12,7,19
9253,ElliotBayTrailMyrtlePark,01/21/2015 01:00:00 PM,48,-122,15,28,43
9254,ElliotBayTrailMyrtlePark,01/21/2015 02:00:00 PM,48,-122,19,19,38
9255,ElliotBayTrailMyrtlePark,01/21/2015 03:00:00 PM,48,-122,34,19,53
9256,ElliotBayTrailMyrtlePark,01/21/2015 04:00:00 PM,48,-122,59,40,99
9257,ElliotBayTrailMyrtlePark,01/21/2015 05:00:00 PM,48,-122,121,17,138
9258,ElliotBayTrailMyrtlePark,01/21/2015 06:00:00 PM,48,-122,71,19,90
9259,ElliotBayTrailMyrtlePark,01/21/2015 07:00:00 PM,48,-122,31,7,38
9260,ElliotBayTrailMyrtlePark,01/21/2015 08:00:00 PM,48,-122,8,2,10
9261,ElliotBayTrailMyrtlePark,01/21/2015 09:00:00 PM,48,-122,3,1,4
9262,ElliotBayTrailMyrtlePark,01/21/2015 10:00:00 PM,48,-122,4,3,7
9263,ElliotBayTrailMyrtlePark,01/21/2015 11:00:00 PM,48,-122,0,0,0
9264,ElliotBayTrailMyrtlePark,01/22/2015 12:00:00 AM,48,-122,1,2,3
9265,ElliotBayTrailMyrtlePark,01/22/2015 01:00:00 AM,48,-122,1,0,1
9266,ElliotBayTrailMyrtlePark,01/22/2015 02:00:00 AM,48,-122,3,0,3
9267,ElliotBayTrailMyrtlePark,01/22/2015 03:00:00 AM,48,-122,0,0,0
9268,ElliotBayTrailMyrtlePark,01/22/2015 04:00:00 AM,48,-122,0,0,0
9269,ElliotBayTrailMyrtlePark,01/22/2015 05:00:00 AM,48,-122,4,7,11
9270,ElliotBayTrailMyrtlePark,01/22/2015 06:00:00 AM,48,-122,13,18,31
9271,ElliotBayTrailMyrtlePark,01/22/2015 07:00:00 AM,48,-122,26,55,81
9272,ElliotBayTrailMyrtlePark,01/22/2015 08:00:00 AM,48,-122,28,93,121
9273,ElliotBayTrailMyrtlePark,01/22/2015 09:00:00 AM,48,-122,13,51,64
9274,ElliotBayTrailMyrtlePark,01/22/2015 10:00:00 AM,48,-122,11,11,22
9275,ElliotBayTrailMyrtlePark,01/22/2015 11:00:00 AM,48,-122,15,9,24
9276,ElliotBayTrailMyrtlePark,01/22/2015 12:00:00 PM,48,-122,7,9,16
9277,ElliotBayTrailMyrtlePark,01/22/2015 01:00:00 PM,48,-122,10,1,11
9278,ElliotBayTrailMyrtlePark,01/22/2015 02:00:00 PM,48,-122,13,21,34
9279,ElliotBayTrailMyrtlePark,01/22/2015 03:00:00 PM,48,-122,12,11,23
9280,ElliotBayTrailMyrtlePark,01/22/2015 04:00:00 PM,48,-122,41,36,77
9281,ElliotBayTrailMyrtlePark,01/22/2015 05:00:00 PM,48,-122,107,35,142
9282,ElliotBayTrailMyrtlePark,01/22/2015 06:00:00 PM,48,-122,64,20,84
9283,ElliotBayTrailMyrtlePark,01/22/2015 07:00:00 PM,48,-122,21,4,25
9284,ElliotBayTrailMyrtlePark,01/22/2015 08:00:00 PM,48,-122,5,3,8
9285,ElliotBayTrailMyrtlePark,01/22/2015 09:00:00 PM,48,-122,6,3,9
9286,ElliotBayTrailMyrtlePark,01/22/2015 10:00:00 PM,48,-122,4,1,5
9287,ElliotBayTrailMyrtlePark,01/22/2015 11:00:00 PM,48,-122,1,1,2
9288,ElliotBayTrailMyrtlePark,01/23/2015 12:00:00 AM,48,-122,0,0,0
9289,ElliotBayTrailMyrtlePark,01/23/2015 01:00:00 AM,48,-122,0,1,1
9290,ElliotBayTrailMyrtlePark,01/23/2015 02:00:00 AM,48,-122,1,0,1
9291,ElliotBayTrailMyrtlePark,01/23/2015 03:00:00 AM,48,-122,1,0,1
9292,ElliotBayTrailMyrtlePark,01/23/2015 04:00:00 AM,48,-122,0,0,0
9293,ElliotBayTrailMyrtlePark,01/23/2015 05:00:00 AM,48,-122,3,11,14
9294,ElliotBayTrailMyrtlePark,01/23/2015 06:00:00 AM,48,-122,10,17,27
9295,ElliotBayTrailMyrtlePark,01/23/2015 07:00:00 AM,48,-122,29,42,71
9296,ElliotBayTrailMyrtlePark,01/23/2015 08:00:00 AM,48,-122,17,71,88
9297,ElliotBayTrailMyrtlePark,01/23/2015 09:00:00 AM,48,-122,7,35,42
9298,ElliotBayTrailMyrtlePark,01/23/2015 10:00:00 AM,48,-122,5,8,13
9299,ElliotBayTrailMyrtlePark,01/23/2015 11:00:00 AM,48,-122,3,7,10
9300,ElliotBayTrailMyrtlePark,01/23/2015 12:00:00 PM,48,-122,5,3,8
9301,ElliotBayTrailMyrtlePark,01/23/2015 01:00:00 PM,48,-122,8,3,11
9302,ElliotBayTrailMyrtlePark,01/23/2015 02:00:00 PM,48,-122,8,6,14
9303,ElliotBayTrailMyrtlePark,01/23/2015 03:00:00 PM,48,-122,24,12,36
9304,ElliotBayTrailMyrtlePark,01/23/2015 04:00:00 PM,48,-122,38,24,62
9305,ElliotBayTrailMyrtlePark,01/23/2015 05:00:00 PM,48,-122,65,25,90
9306,ElliotBayTrailMyrtlePark,01/23/2015 06:00:00 PM,48,-122,45,12,57
9307,ElliotBayTrailMyrtlePark,01/23/2015 07:00:00 PM,48,-122,23,6,29
9308,ElliotBayTrailMyrtlePark,01/23/2015 08:00:00 PM,48,-122,2,0,2
9309,ElliotBayTrailMyrtlePark,01/23/2015 09:00:00 PM,48,-122,5,0,5
9310,ElliotBayTrailMyrtlePark,01/23/2015 10:00:00 PM,48,-122,4,2,6
9311,ElliotBayTrailMyrtlePark,01/23/2015 11:00:00 PM,48,-122,7,4,11
9312,ElliotBayTrailMyrtlePark,01/24/2015 12:00:00 AM,48,-122,0,0,0
9313,ElliotBayTrailMyrtlePark,01/24/2015 01:00:00 AM,48,-122,1,0,1
9314,ElliotBayTrailMyrtlePark,01/24/2015 02:00:00 AM,48,-122,0,3,3
9315,ElliotBayTrailMyrtlePark,01/24/2015 03:00:00 AM,48,-122,2,0,2
9316,ElliotBayTrailMyrtlePark,01/24/2015 04:00:00 AM,48,-122,0,0,0
9317,ElliotBayTrailMyrtlePark,01/24/2015 05:00:00 AM,48,-122,0,1,1
9318,ElliotBayTrailMyrtlePark,01/24/2015 06:00:00 AM,48,-122,0,2,2
9319,ElliotBayTrailMyrtlePark,01/24/2015 07:00:00 AM,48,-122,2,3,5
9320,ElliotBayTrailMyrtlePark,01/24/2015 08:00:00 AM,48,-122,3,7,10
9321,ElliotBayTrailMyrtlePark,01/24/2015 09:00:00 AM,48,-122,10,9,19
9322,ElliotBayTrailMyrtlePark,01/24/2015 10:00:00 AM,48,-122,19,10,29
9323,ElliotBayTrailMyrtlePark,01/24/2015 11:00:00 AM,48,-122,16,25,41
9324,ElliotBayTrailMyrtlePark,01/24/2015 12:00:00 PM,48,-122,18,31,49
9325,ElliotBayTrailMyrtlePark,01/24/2015 01:00:00 PM,48,-122,22,31,53
9326,ElliotBayTrailMyrtlePark,01/24/2015 02:00:00 PM,48,-122,30,28,58
9327,ElliotBayTrailMyrtlePark,01/24/2015 03:00:00 PM,48,-122,44,32,76
9328,ElliotBayTrailMyrtlePark,01/24/2015 04:00:00 PM,48,-122,49,24,73
9329,ElliotBayTrailMyrtlePark,01/24/2015 05:00:00 PM,48,-122,25,40,65
9330,ElliotBayTrailMyrtlePark,01/24/2015 06:00:00 PM,48,-122,9,7,16
9331,ElliotBayTrailMyrtlePark,01/24/2015 07:00:00 PM,48,-122,4,1,5
9332,ElliotBayTrailMyrtlePark,01/24/2015 08:00:00 PM,48,-122,2,0,2
9333,ElliotBayTrailMyrtlePark,01/24/2015 09:00:00 PM,48,-122,0,0,0
9334,ElliotBayTrailMyrtlePark,01/24/2015 10:00:00 PM,48,-122,0,2,2
9335,ElliotBayTrailMyrtlePark,01/24/2015 11:00:00 PM,48,-122,5,0,5
9336,ElliotBayTrailMyrtlePark,01/25/2015 12:00:00 AM,48,-122,0,0,0
9337,ElliotBayTrailMyrtlePark,01/25/2015 01:00:00 AM,48,-122,0,0,0
9338,ElliotBayTrailMyrtlePark,01/25/2015 02:00:00 AM,48,-122,1,0,1
9339,ElliotBayTrailMyrtlePark,01/25/2015 03:00:00 AM,48,-122,0,0,0
9340,ElliotBayTrailMyrtlePark,01/25/2015 04:00:00 AM,48,-122,0,0,0
9341,ElliotBayTrailMyrtlePark,01/25/2015 05:00:00 AM,48,-122,0,2,2
9342,ElliotBayTrailMyrtlePark,01/25/2015 06:00:00 AM,48,-122,0,2,2
9343,ElliotBayTrailMyrtlePark,01/25/2015 07:00:00 AM,48,-122,3,5,8
9344,ElliotBayTrailMyrtlePark,01/25/2015 08:00:00 AM,48,-122,8,7,15
9345,ElliotBayTrailMyrtlePark,01/25/2015 09:00:00 AM,48,-122,26,24,50
9346,ElliotBayTrailMyrtlePark,01/25/2015 10:00:00 AM,48,-122,29,27,56
9347,ElliotBayTrailMyrtlePark,01/25/2015 11:00:00 AM,48,-122,37,41,78
9348,ElliotBayTrailMyrtlePark,01/25/2015 12:00:00 PM,48,-122,69,71,140
9349,ElliotBayTrailMyrtlePark,01/25/2015 01:00:00 PM,48,-122,94,63,157
9350,ElliotBayTrailMyrtlePark,01/25/2015 02:00:00 PM,48,-122,109,109,218
9351,ElliotBayTrailMyrtlePark,01/25/2015 03:00:00 PM,48,-122,104,76,180
9352,ElliotBayTrailMyrtlePark,01/25/2015 04:00:00 PM,48,-122,97,69,166
9353,ElliotBayTrailMyrtlePark,01/25/2015 05:00:00 PM,48,-122,28,41,69
9354,ElliotBayTrailMyrtlePark,01/25/2015 06:00:00 PM,48,-122,10,7,17
9355,ElliotBayTrailMyrtlePark,01/25/2015 07:00:00 PM,48,-122,12,1,13
9356,ElliotBayTrailMyrtlePark,01/25/2015 08:00:00 PM,48,-122,6,4,10
9357,ElliotBayTrailMyrtlePark,01/25/2015 09:00:00 PM,48,-122,0,0,0
9358,ElliotBayTrailMyrtlePark,01/25/2015 10:00:00 PM,48,-122,3,2,5
9359,ElliotBayTrailMyrtlePark,01/25/2015 11:00:00 PM,48,-122,2,0,2
9360,ElliotBayTrailMyrtlePark,01/26/2015 12:00:00 AM,48,-122,0,0,0
9361,ElliotBayTrailMyrtlePark,01/26/2015 01:00:00 AM,48,-122,0,0,0
9362,ElliotBayTrailMyrtlePark,01/26/2015 02:00:00 AM,48,-122,1,0,1
9363,ElliotBayTrailMyrtlePark,01/26/2015 03:00:00 AM,48,-122,0,0,0
9364,ElliotBayTrailMyrtlePark,01/26/2015 04:00:00 AM,48,-122,1,0,1
9365,ElliotBayTrailMyrtlePark,01/26/2015 05:00:00 AM,48,-122,6,9,15
9366,ElliotBayTrailMyrtlePark,01/26/2015 06:00:00 AM,48,-122,12,24,36
9367,ElliotBayTrailMyrtlePark,01/26/2015 07:00:00 AM,48,-122,34,76,110
9368,ElliotBayTrailMyrtlePark,01/26/2015 08:00:00 AM,48,-122,42,129,171
9369,ElliotBayTrailMyrtlePark,01/26/2015 09:00:00 AM,48,-122,21,81,102
9370,ElliotBayTrailMyrtlePark,01/26/2015 10:00:00 AM,48,-122,14,26,40
9371,ElliotBayTrailMyrtlePark,01/26/2015 11:00:00 AM,48,-122,13,15,28
9372,ElliotBayTrailMyrtlePark,01/26/2015 12:00:00 PM,48,-122,22,24,46
9373,ElliotBayTrailMyrtlePark,01/26/2015 01:00:00 PM,48,-122,39,36,75
9374,ElliotBayTrailMyrtlePark,01/26/2015 02:00:00 PM,48,-122,28,32,60
9375,ElliotBayTrailMyrtlePark,01/26/2015 03:00:00 PM,48,-122,71,49,120
9376,ElliotBayTrailMyrtlePark,01/26/2015 04:00:00 PM,48,-122,88,81,169
9377,ElliotBayTrailMyrtlePark,01/26/2015 05:00:00 PM,48,-122,164,76,240
9378,ElliotBayTrailMyrtlePark,01/26/2015 06:00:00 PM,48,-122,97,24,121
9379,ElliotBayTrailMyrtlePark,01/26/2015 07:00:00 PM,48,-122,32,6,38
9380,ElliotBayTrailMyrtlePark,01/26/2015 08:00:00 PM,48,-122,4,2,6
9381,ElliotBayTrailMyrtlePark,01/26/2015 09:00:00 PM,48,-122,4,3,7
9382,ElliotBayTrailMyrtlePark,01/26/2015 10:00:00 PM,48,-122,3,2,5
9383,ElliotBayTrailMyrtlePark,01/26/2015 11:00:00 PM,48,-122,1,0,1
9384,ElliotBayTrailMyrtlePark,01/27/2015 12:00:00 AM,48,-122,4,0,4
9385,ElliotBayTrailMyrtlePark,01/27/2015 01:00:00 AM,48,-122,0,0,0
9386,ElliotBayTrailMyrtlePark,01/27/2015 02:00:00 AM,48,-122,5,0,5
9387,ElliotBayTrailMyrtlePark,01/27/2015 03:00:00 AM,48,-122,0,0,0
9388,ElliotBayTrailMyrtlePark,01/27/2015 04:00:00 AM,48,-122,1,0,1
9389,ElliotBayTrailMyrtlePark,01/27/2015 05:00:00 AM,48,-122,9,11,20
9390,ElliotBayTrailMyrtlePark,01/27/2015 06:00:00 AM,48,-122,18,27,45
9391,ElliotBayTrailMyrtlePark,01/27/2015 07:00:00 AM,48,-122,40,63,103
9392,ElliotBayTrailMyrtlePark,01/27/2015 08:00:00 AM,48,-122,30,119,149
9393,ElliotBayTrailMyrtlePark,01/27/2015 09:00:00 AM,48,-122,18,59,77
9394,ElliotBayTrailMyrtlePark,01/27/2015 10:00:00 AM,48,-122,5,21,26
9395,ElliotBayTrailMyrtlePark,01/27/2015 11:00:00 AM,48,-122,12,5,17
9396,ElliotBayTrailMyrtlePark,01/27/2015 12:00:00 PM,48,-122,5,4,9
9397,ElliotBayTrailMyrtlePark,01/27/2015 01:00:00 PM,48,-122,10,10,20
9398,ElliotBayTrailMyrtlePark,01/27/2015 02:00:00 PM,48,-122,8,21,29
9399,ElliotBayTrailMyrtlePark,01/27/2015 03:00:00 PM,48,-122,23,21,44
9400,ElliotBayTrailMyrtlePark,01/27/2015 04:00:00 PM,48,-122,52,28,80
9401,ElliotBayTrailMyrtlePark,01/27/2015 05:00:00 PM,48,-122,128,49,177
9402,ElliotBayTrailMyrtlePark,01/27/2015 06:00:00 PM,48,-122,76,12,88
9403,ElliotBayTrailMyrtlePark,01/27/2015 07:00:00 PM,48,-122,20,11,31
9404,ElliotBayTrailMyrtlePark,01/27/2015 08:00:00 PM,48,-122,3,2,5
9405,ElliotBayTrailMyrtlePark,01/27/2015 09:00:00 PM,48,-122,4,5,9
9406,ElliotBayTrailMyrtlePark,01/27/2015 10:00:00 PM,48,-122,3,3,6
9407,ElliotBayTrailMyrtlePark,01/27/2015 11:00:00 PM,48,-122,2,1,3
9408,ElliotBayTrailMyrtlePark,01/28/2015 12:00:00 AM,48,-122,1,0,1
9409,ElliotBayTrailMyrtlePark,01/28/2015 01:00:00 AM,48,-122,0,0,0
9410,ElliotBayTrailMyrtlePark,01/28/2015 02:00:00 AM,48,-122,2,0,2
9411,ElliotBayTrailMyrtlePark,01/28/2015 03:00:00 AM,48,-122,0,0,0
9412,ElliotBayTrailMyrtlePark,01/28/2015 04:00:00 AM,48,-122,2,0,2
9413,ElliotBayTrailMyrtlePark,01/28/2015 05:00:00 AM,48,-122,6,10,16
9414,ElliotBayTrailMyrtlePark,01/28/2015 06:00:00 AM,48,-122,20,29,49
9415,ElliotBayTrailMyrtlePark,01/28/2015 07:00:00 AM,48,-122,31,45,76
9416,ElliotBayTrailMyrtlePark,01/28/2015 08:00:00 AM,48,-122,31,110,141
9417,ElliotBayTrailMyrtlePark,01/28/2015 09:00:00 AM,48,-122,31,61,92
9418,ElliotBayTrailMyrtlePark,01/28/2015 10:00:00 AM,48,-122,11,21,32
9419,ElliotBayTrailMyrtlePark,01/28/2015 11:00:00 AM,48,-122,8,10,18
9420,ElliotBayTrailMyrtlePark,01/28/2015 12:00:00 PM,48,-122,18,17,35
9421,ElliotBayTrailMyrtlePark,01/28/2015 01:00:00 PM,48,-122,10,17,27
9422,ElliotBayTrailMyrtlePark,01/28/2015 02:00:00 PM,48,-122,22,19,41
9423,ElliotBayTrailMyrtlePark,01/28/2015 03:00:00 PM,48,-122,23,34,57
9424,ElliotBayTrailMyrtlePark,01/28/2015 04:00:00 PM,48,-122,71,44,115
9425,ElliotBayTrailMyrtlePark,01/28/2015 05:00:00 PM,48,-122,121,47,168
9426,ElliotBayTrailMyrtlePark,01/28/2015 06:00:00 PM,48,-122,71,24,95
9427,ElliotBayTrailMyrtlePark,01/28/2015 07:00:00 PM,48,-122,29,3,32
9428,ElliotBayTrailMyrtlePark,01/28/2015 08:00:00 PM,48,-122,10,7,17
9429,ElliotBayTrailMyrtlePark,01/28/2015 09:00:00 PM,48,-122,3,2,5
9430,ElliotBayTrailMyrtlePark,01/28/2015 10:00:00 PM,48,-122,5,1,6
9431,ElliotBayTrailMyrtlePark,01/28/2015 11:00:00 PM,48,-122,1,3,4
9432,ElliotBayTrailMyrtlePark,01/29/2015 12:00:00 AM,48,-122,0,1,1
9433,ElliotBayTrailMyrtlePark,01/29/2015 01:00:00 AM,48,-122,0,0,0
9434,ElliotBayTrailMyrtlePark,01/29/2015 02:00:00 AM,48,-122,1,0,1
9435,ElliotBayTrailMyrtlePark,01/29/2015 03:00:00 AM,48,-122,3,0,3
9436,ElliotBayTrailMyrtlePark,01/29/2015 04:00:00 AM,48,-122,0,1,1
9437,ElliotBayTrailMyrtlePark,01/29/2015 05:00:00 AM,48,-122,5,10,15
9438,ElliotBayTrailMyrtlePark,01/29/2015 06:00:00 AM,48,-122,17,14,31
9439,ElliotBayTrailMyrtlePark,01/29/2015 07:00:00 AM,48,-122,28,72,100
9440,ElliotBayTrailMyrtlePark,01/29/2015 08:00:00 AM,48,-122,38,108,146
9441,ElliotBayTrailMyrtlePark,01/29/2015 09:00:00 AM,48,-122,18,59,77
9442,ElliotBayTrailMyrtlePark,01/29/2015 10:00:00 AM,48,-122,8,22,30
9443,ElliotBayTrailMyrtlePark,01/29/2015 11:00:00 AM,48,-122,25,25,50
9444,ElliotBayTrailMyrtlePark,01/29/2015 12:00:00 PM,48,-122,17,16,33
9445,ElliotBayTrailMyrtlePark,01/29/2015 01:00:00 PM,48,-122,20,19,39
9446,ElliotBayTrailMyrtlePark,01/29/2015 02:00:00 PM,48,-122,33,40,73
9447,ElliotBayTrailMyrtlePark,01/29/2015 03:00:00 PM,48,-122,42,41,83
9448,ElliotBayTrailMyrtlePark,01/29/2015 04:00:00 PM,48,-122,69,54,123
9449,ElliotBayTrailMyrtlePark,01/29/2015 05:00:00 PM,48,-122,154,49,203
9450,ElliotBayTrailMyrtlePark,01/29/2015 06:00:00 PM,48,-122,81,27,108
9451,ElliotBayTrailMyrtlePark,01/29/2015 07:00:00 PM,48,-122,25,4,29
9452,ElliotBayTrailMyrtlePark,01/29/2015 08:00:00 PM,48,-122,9,1,10
9453,ElliotBayTrailMyrtlePark,01/29/2015 09:00:00 PM,48,-122,7,2,9
9454,ElliotBayTrailMyrtlePark,01/29/2015 10:00:00 PM,48,-122,3,3,6
9455,ElliotBayTrailMyrtlePark,01/29/2015 11:00:00 PM,48,-122,3,1,4
9456,ElliotBayTrailMyrtlePark,01/30/2015 12:00:00 AM,48,-122,1,1,2
9457,ElliotBayTrailMyrtlePark,01/30/2015 01:00:00 AM,48,-122,0,0,0
9458,ElliotBayTrailMyrtlePark,01/30/2015 02:00:00 AM,48,-122,3,0,3
9459,ElliotBayTrailMyrtlePark,01/30/2015 03:00:00 AM,48,-122,2,0,2
9460,ElliotBayTrailMyrtlePark,01/30/2015 04:00:00 AM,48,-122,0,0,0
9461,ElliotBayTrailMyrtlePark,01/30/2015 05:00:00 AM,48,-122,5,9,14
9462,ElliotBayTrailMyrtlePark,01/30/2015 06:00:00 AM,48,-122,12,17,29
9463,ElliotBayTrailMyrtlePark,01/30/2015 07:00:00 AM,48,-122,25,49,74
9464,ElliotBayTrailMyrtlePark,01/30/2015 08:00:00 AM,48,-122,34,110,144
9465,ElliotBayTrailMyrtlePark,01/30/2015 09:00:00 AM,48,-122,9,60,69
9466,ElliotBayTrailMyrtlePark,01/30/2015 10:00:00 AM,48,-122,11,15,26
9467,ElliotBayTrailMyrtlePark,01/30/2015 11:00:00 AM,48,-122,18,15,33
9468,ElliotBayTrailMyrtlePark,01/30/2015 12:00:00 PM,48,-122,6,19,25
9469,ElliotBayTrailMyrtlePark,01/30/2015 01:00:00 PM,48,-122,12,14,26
9470,ElliotBayTrailMyrtlePark,01/30/2015 02:00:00 PM,48,-122,31,23,54
9471,ElliotBayTrailMyrtlePark,01/30/2015 03:00:00 PM,48,-122,39,34,73
9472,ElliotBayTrailMyrtlePark,01/30/2015 04:00:00 PM,48,-122,57,41,98
9473,ElliotBayTrailMyrtlePark,01/30/2015 05:00:00 PM,48,-122,108,28,136
9474,ElliotBayTrailMyrtlePark,01/30/2015 06:00:00 PM,48,-122,79,16,95
9475,ElliotBayTrailMyrtlePark,01/30/2015 07:00:00 PM,48,-122,19,7,26
9476,ElliotBayTrailMyrtlePark,01/30/2015 08:00:00 PM,48,-122,6,3,9
9477,ElliotBayTrailMyrtlePark,01/30/2015 09:00:00 PM,48,-122,6,1,7
9478,ElliotBayTrailMyrtlePark,01/30/2015 10:00:00 PM,48,-122,2,2,4
9479,ElliotBayTrailMyrtlePark,01/30/2015 11:00:00 PM,48,-122,4,1,5
9480,ElliotBayTrailMyrtlePark,01/31/2015 12:00:00 AM,48,-122,5,0,5
9481,ElliotBayTrailMyrtlePark,01/31/2015 01:00:00 AM,48,-122,0,3,3
9482,ElliotBayTrailMyrtlePark,01/31/2015 02:00:00 AM,48,-122,4,0,4
9483,ElliotBayTrailMyrtlePark,01/31/2015 03:00:00 AM,48,-122,1,0,1
9484,ElliotBayTrailMyrtlePark,01/31/2015 04:00:00 AM,48,-122,2,0,2
9485,ElliotBayTrailMyrtlePark,01/31/2015 05:00:00 AM,48,-122,0,3,3
9486,ElliotBayTrailMyrtlePark,01/31/2015 06:00:00 AM,48,-122,2,4,6
9487,ElliotBayTrailMyrtlePark,01/31/2015 07:00:00 AM,48,-122,4,8,12
9488,ElliotBayTrailMyrtlePark,01/31/2015 08:00:00 AM,48,-122,5,12,17
9489,ElliotBayTrailMyrtlePark,01/31/2015 09:00:00 AM,48,-122,6,10,16
9490,ElliotBayTrailMyrtlePark,01/31/2015 10:00:00 AM,48,-122,30,23,53
9491,ElliotBayTrailMyrtlePark,01/31/2015 11:00:00 AM,48,-122,14,19,33
9492,ElliotBayTrailMyrtlePark,01/31/2015 12:00:00 PM,48,-122,33,27,60
9493,ElliotBayTrailMyrtlePark,01/31/2015 01:00:00 PM,48,-122,33,47,80
9494,ElliotBayTrailMyrtlePark,01/31/2015 02:00:00 PM,48,-122,39,40,79
9495,ElliotBayTrailMyrtlePark,01/31/2015 03:00:00 PM,48,-122,41,44,85
9496,ElliotBayTrailMyrtlePark,01/31/2015 04:00:00 PM,48,-122,32,34,66
9497,ElliotBayTrailMyrtlePark,01/31/2015 05:00:00 PM,48,-122,27,24,51
9498,ElliotBayTrailMyrtlePark,01/31/2015 06:00:00 PM,48,-122,10,4,14
9499,ElliotBayTrailMyrtlePark,01/31/2015 07:00:00 PM,48,-122,8,2,10
9500,ElliotBayTrailMyrtlePark,01/31/2015 08:00:00 PM,48,-122,2,1,3
9501,ElliotBayTrailMyrtlePark,01/31/2015 09:00:00 PM,48,-122,6,3,9
9502,ElliotBayTrailMyrtlePark,01/31/2015 10:00:00 PM,48,-122,2,1,3
9503,ElliotBayTrailMyrtlePark,01/31/2015 11:00:00 PM,48,-122,6,2,8
9504,ElliotBayTrailMyrtlePark,02/01/2015 12:00:00 AM,48,-122,3,0,3
9505,ElliotBayTrailMyrtlePark,02/01/2015 01:00:00 AM,48,-122,1,0,1
9506,ElliotBayTrailMyrtlePark,02/01/2015 02:00:00 AM,48,-122,0,0,0
9507,ElliotBayTrailMyrtlePark,02/01/2015 03:00:00 AM,48,-122,0,1,1
9508,ElliotBayTrailMyrtlePark,02/01/2015 04:00:00 AM,48,-122,0,1,1
9509,ElliotBayTrailMyrtlePark,02/01/2015 05:00:00 AM,48,-122,1,1,2
9510,ElliotBayTrailMyrtlePark,02/01/2015 06:00:00 AM,48,-122,0,3,3
9511,ElliotBayTrailMyrtlePark,02/01/2015 07:00:00 AM,48,-122,4,3,7
9512,ElliotBayTrailMyrtlePark,02/01/2015 08:00:00 AM,48,-122,4,5,9
9513,ElliotBayTrailMyrtlePark,02/01/2015 09:00:00 AM,48,-122,22,23,45
9514,ElliotBayTrailMyrtlePark,02/01/2015 10:00:00 AM,48,-122,12,15,27
9515,ElliotBayTrailMyrtlePark,02/01/2015 11:00:00 AM,48,-122,27,12,39
9516,ElliotBayTrailMyrtlePark,02/01/2015 12:00:00 PM,48,-122,6,11,17
9517,ElliotBayTrailMyrtlePark,02/01/2015 01:00:00 PM,48,-122,22,12,34
9518,ElliotBayTrailMyrtlePark,02/01/2015 02:00:00 PM,48,-122,15,11,26
9519,ElliotBayTrailMyrtlePark,02/01/2015 03:00:00 PM,48,-122,9,15,24
9520,ElliotBayTrailMyrtlePark,02/01/2015 04:00:00 PM,48,-122,3,5,8
9521,ElliotBayTrailMyrtlePark,02/01/2015 05:00:00 PM,48,-122,3,5,8
9522,ElliotBayTrailMyrtlePark,02/01/2015 06:00:00 PM,48,-122,1,2,3
9523,ElliotBayTrailMyrtlePark,02/01/2015 07:00:00 PM,48,-122,8,1,9
9524,ElliotBayTrailMyrtlePark,02/01/2015 08:00:00 PM,48,-122,8,3,11
9525,ElliotBayTrailMyrtlePark,02/01/2015 09:00:00 PM,48,-122,1,1,2
9526,ElliotBayTrailMyrtlePark,02/01/2015 10:00:00 PM,48,-122,1,4,5
9527,ElliotBayTrailMyrtlePark,02/01/2015 11:00:00 PM,48,-122,3,0,3
9528,ElliotBayTrailMyrtlePark,02/02/2015 12:00:00 AM,48,-122,1,1,2
9529,ElliotBayTrailMyrtlePark,02/02/2015 01:00:00 AM,48,-122,0,0,0
9530,ElliotBayTrailMyrtlePark,02/02/2015 02:00:00 AM,48,-122,0,0,0
9531,ElliotBayTrailMyrtlePark,02/02/2015 03:00:00 AM,48,-122,0,0,0
9532,ElliotBayTrailMyrtlePark,02/02/2015 04:00:00 AM,48,-122,0,2,2
9533,ElliotBayTrailMyrtlePark,02/02/2015 05:00:00 AM,48,-122,5,10,15
9534,ElliotBayTrailMyrtlePark,02/02/2015 06:00:00 AM,48,-122,16,17,33
9535,ElliotBayTrailMyrtlePark,02/02/2015 07:00:00 AM,48,-122,33,57,90
9536,ElliotBayTrailMyrtlePark,02/02/2015 08:00:00 AM,48,-122,30,75,105
9537,ElliotBayTrailMyrtlePark,02/02/2015 09:00:00 AM,48,-122,9,44,53
9538,ElliotBayTrailMyrtlePark,02/02/2015 10:00:00 AM,48,-122,4,8,12
9539,ElliotBayTrailMyrtlePark,02/02/2015 11:00:00 AM,48,-122,8,6,14
9540,ElliotBayTrailMyrtlePark,02/02/2015 12:00:00 PM,48,-122,5,7,12
9541,ElliotBayTrailMyrtlePark,02/02/2015 01:00:00 PM,48,-122,4,4,8
9542,ElliotBayTrailMyrtlePark,02/02/2015 02:00:00 PM,48,-122,11,11,22
9543,ElliotBayTrailMyrtlePark,02/02/2015 03:00:00 PM,48,-122,17,16,33
9544,ElliotBayTrailMyrtlePark,02/02/2015 04:00:00 PM,48,-122,43,26,69
9545,ElliotBayTrailMyrtlePark,02/02/2015 05:00:00 PM,48,-122,96,34,130
9546,ElliotBayTrailMyrtlePark,02/02/2015 06:00:00 PM,48,-122,63,14,77
9547,ElliotBayTrailMyrtlePark,02/02/2015 07:00:00 PM,48,-122,27,2,29
9548,ElliotBayTrailMyrtlePark,02/02/2015 08:00:00 PM,48,-122,6,3,9
9549,ElliotBayTrailMyrtlePark,02/02/2015 09:00:00 PM,48,-122,1,1,2
9550,ElliotBayTrailMyrtlePark,02/02/2015 10:00:00 PM,48,-122,5,2,7
9551,ElliotBayTrailMyrtlePark,02/02/2015 11:00:00 PM,48,-122,0,0,0
9552,ElliotBayTrailMyrtlePark,02/03/2015 12:00:00 AM,48,-122,1,0,1
9553,ElliotBayTrailMyrtlePark,02/03/2015 01:00:00 AM,48,-122,0,0,0
9554,ElliotBayTrailMyrtlePark,02/03/2015 02:00:00 AM,48,-122,1,0,1
9555,ElliotBayTrailMyrtlePark,02/03/2015 03:00:00 AM,48,-122,1,0,1
9556,ElliotBayTrailMyrtlePark,02/03/2015 04:00:00 AM,48,-122,0,0,0
9557,ElliotBayTrailMyrtlePark,02/03/2015 05:00:00 AM,48,-122,5,13,18
9558,ElliotBayTrailMyrtlePark,02/03/2015 06:00:00 AM,48,-122,17,22,39
9559,ElliotBayTrailMyrtlePark,02/03/2015 07:00:00 AM,48,-122,27,52,79
9560,ElliotBayTrailMyrtlePark,02/03/2015 08:00:00 AM,48,-122,36,105,141
9561,ElliotBayTrailMyrtlePark,02/03/2015 09:00:00 AM,48,-122,14,70,84
9562,ElliotBayTrailMyrtlePark,02/03/2015 10:00:00 AM,48,-122,15,15,30
9563,ElliotBayTrailMyrtlePark,02/03/2015 11:00:00 AM,48,-122,7,6,13
9564,ElliotBayTrailMyrtlePark,02/03/2015 12:00:00 PM,48,-122,11,11,22
9565,ElliotBayTrailMyrtlePark,02/03/2015 01:00:00 PM,48,-122,15,7,22
9566,ElliotBayTrailMyrtlePark,02/03/2015 02:00:00 PM,48,-122,8,12,20
9567,ElliotBayTrailMyrtlePark,02/03/2015 03:00:00 PM,48,-122,11,10,21
9568,ElliotBayTrailMyrtlePark,02/03/2015 04:00:00 PM,48,-122,49,27,76
9569,ElliotBayTrailMyrtlePark,02/03/2015 05:00:00 PM,48,-122,110,33,143
9570,ElliotBayTrailMyrtlePark,02/03/2015 06:00:00 PM,48,-122,87,17,104
9571,ElliotBayTrailMyrtlePark,02/03/2015 07:00:00 PM,48,-122,31,5,36
9572,ElliotBayTrailMyrtlePark,02/03/2015 08:00:00 PM,48,-122,7,2,9
9573,ElliotBayTrailMyrtlePark,02/03/2015 09:00:00 PM,48,-122,4,7,11
9574,ElliotBayTrailMyrtlePark,02/03/2015 10:00:00 PM,48,-122,1,6,7
9575,ElliotBayTrailMyrtlePark,02/03/2015 11:00:00 PM,48,-122,1,1,2
9576,ElliotBayTrailMyrtlePark,02/04/2015 12:00:00 AM,48,-122,1,1,2
9577,ElliotBayTrailMyrtlePark,02/04/2015 01:00:00 AM,48,-122,1,0,1
9578,ElliotBayTrailMyrtlePark,02/04/2015 02:00:00 AM,48,-122,0,0,0
9579,ElliotBayTrailMyrtlePark,02/04/2015 03:00:00 AM,48,-122,1,0,1
9580,ElliotBayTrailMyrtlePark,02/04/2015 04:00:00 AM,48,-122,2,0,2
9581,ElliotBayTrailMyrtlePark,02/04/2015 05:00:00 AM,48,-122,7,8,15
9582,ElliotBayTrailMyrtlePark,02/04/2015 06:00:00 AM,48,-122,10,23,33
9583,ElliotBayTrailMyrtlePark,02/04/2015 07:00:00 AM,48,-122,34,53,87
9584,ElliotBayTrailMyrtlePark,02/04/2015 08:00:00 AM,48,-122,19,103,122
9585,ElliotBayTrailMyrtlePark,02/04/2015 09:00:00 AM,48,-122,16,54,70
9586,ElliotBayTrailMyrtlePark,02/04/2015 10:00:00 AM,48,-122,10,20,30
9587,ElliotBayTrailMyrtlePark,02/04/2015 11:00:00 AM,48,-122,6,6,12
9588,ElliotBayTrailMyrtlePark,02/04/2015 12:00:00 PM,48,-122,14,3,17
9589,ElliotBayTrailMyrtlePark,02/04/2015 01:00:00 PM,48,-122,11,7,18
9590,ElliotBayTrailMyrtlePark,02/04/2015 02:00:00 PM,48,-122,12,16,28
9591,ElliotBayTrailMyrtlePark,02/04/2015 03:00:00 PM,48,-122,20,20,40
9592,ElliotBayTrailMyrtlePark,02/04/2015 04:00:00 PM,48,-122,48,25,73
9593,ElliotBayTrailMyrtlePark,02/04/2015 05:00:00 PM,48,-122,109,35,144
9594,ElliotBayTrailMyrtlePark,02/04/2015 06:00:00 PM,48,-122,71,11,82
9595,ElliotBayTrailMyrtlePark,02/04/2015 07:00:00 PM,48,-122,22,3,25
9596,ElliotBayTrailMyrtlePark,02/04/2015 08:00:00 PM,48,-122,7,0,7
9597,ElliotBayTrailMyrtlePark,02/04/2015 09:00:00 PM,48,-122,7,2,9
9598,ElliotBayTrailMyrtlePark,02/04/2015 10:00:00 PM,48,-122,2,2,4
9599,ElliotBayTrailMyrtlePark,02/04/2015 11:00:00 PM,48,-122,0,0,0
9600,ElliotBayTrailMyrtlePark,02/05/2015 12:00:00 AM,48,-122,0,0,0
9601,ElliotBayTrailMyrtlePark,02/05/2015 01:00:00 AM,48,-122,1,0,1
9602,ElliotBayTrailMyrtlePark,02/05/2015 02:00:00 AM,48,-122,2,0,2
9603,ElliotBayTrailMyrtlePark,02/05/2015 03:00:00 AM,48,-122,1,0,1
9604,ElliotBayTrailMyrtlePark,02/05/2015 04:00:00 AM,48,-122,0,0,0
9605,ElliotBayTrailMyrtlePark,02/05/2015 05:00:00 AM,48,-122,4,7,11
9606,ElliotBayTrailMyrtlePark,02/05/2015 06:00:00 AM,48,-122,11,13,24
9607,ElliotBayTrailMyrtlePark,02/05/2015 07:00:00 AM,48,-122,21,38,59
9608,ElliotBayTrailMyrtlePark,02/05/2015 08:00:00 AM,48,-122,26,70,96
9609,ElliotBayTrailMyrtlePark,02/05/2015 09:00:00 AM,48,-122,9,47,56
9610,ElliotBayTrailMyrtlePark,02/05/2015 10:00:00 AM,48,-122,2,13,15
9611,ElliotBayTrailMyrtlePark,02/05/2015 11:00:00 AM,48,-122,5,7,12
9612,ElliotBayTrailMyrtlePark,02/05/2015 12:00:00 PM,48,-122,4,8,12
9613,ElliotBayTrailMyrtlePark,02/05/2015 01:00:00 PM,48,-122,9,6,15
9614,ElliotBayTrailMyrtlePark,02/05/2015 02:00:00 PM,48,-122,12,10,22
9615,ElliotBayTrailMyrtlePark,02/05/2015 03:00:00 PM,48,-122,10,12,22
9616,ElliotBayTrailMyrtlePark,02/05/2015 04:00:00 PM,48,-122,30,32,62
9617,ElliotBayTrailMyrtlePark,02/05/2015 05:00:00 PM,48,-122,64,30,94
9618,ElliotBayTrailMyrtlePark,02/05/2015 06:00:00 PM,48,-122,50,7,57
9619,ElliotBayTrailMyrtlePark,02/05/2015 07:00:00 PM,48,-122,19,0,19
9620,ElliotBayTrailMyrtlePark,02/05/2015 08:00:00 PM,48,-122,11,4,15
9621,ElliotBayTrailMyrtlePark,02/05/2015 09:00:00 PM,48,-122,7,1,8
9622,ElliotBayTrailMyrtlePark,02/05/2015 10:00:00 PM,48,-122,1,7,8
9623,ElliotBayTrailMyrtlePark,02/05/2015 11:00:00 PM,48,-122,1,0,1
9624,ElliotBayTrailMyrtlePark,02/06/2015 12:00:00 AM,48,-122,1,0,1
9625,ElliotBayTrailMyrtlePark,02/06/2015 01:00:00 AM,48,-122,1,0,1
9626,ElliotBayTrailMyrtlePark,02/06/2015 02:00:00 AM,48,-122,1,0,1
9627,ElliotBayTrailMyrtlePark,02/06/2015 03:00:00 AM,48,-122,0,0,0
9628,ElliotBayTrailMyrtlePark,02/06/2015 04:00:00 AM,48,-122,0,0,0
9629,ElliotBayTrailMyrtlePark,02/06/2015 05:00:00 AM,48,-122,6,10,16
9630,ElliotBayTrailMyrtlePark,02/06/2015 06:00:00 AM,48,-122,6,17,23
9631,ElliotBayTrailMyrtlePark,02/06/2015 07:00:00 AM,48,-122,24,30,54
9632,ElliotBayTrailMyrtlePark,02/06/2015 08:00:00 AM,48,-122,26,60,86
9633,ElliotBayTrailMyrtlePark,02/06/2015 09:00:00 AM,48,-122,10,53,63
9634,ElliotBayTrailMyrtlePark,02/06/2015 10:00:00 AM,48,-122,3,5,8
9635,ElliotBayTrailMyrtlePark,02/06/2015 11:00:00 AM,48,-122,5,1,6
9636,ElliotBayTrailMyrtlePark,02/06/2015 12:00:00 PM,48,-122,2,4,6
9637,ElliotBayTrailMyrtlePark,02/06/2015 01:00:00 PM,48,-122,3,2,5
9638,ElliotBayTrailMyrtlePark,02/06/2015 02:00:00 PM,48,-122,7,6,13
9639,ElliotBayTrailMyrtlePark,02/06/2015 03:00:00 PM,48,-122,15,15,30
9640,ElliotBayTrailMyrtlePark,02/06/2015 04:00:00 PM,48,-122,39,26,65
9641,ElliotBayTrailMyrtlePark,02/06/2015 05:00:00 PM,48,-122,65,34,99
9642,ElliotBayTrailMyrtlePark,02/06/2015 06:00:00 PM,48,-122,36,10,46
9643,ElliotBayTrailMyrtlePark,02/06/2015 07:00:00 PM,48,-122,18,6,24
9644,ElliotBayTrailMyrtlePark,02/06/2015 08:00:00 PM,48,-122,3,1,4
9645,ElliotBayTrailMyrtlePark,02/06/2015 09:00:00 PM,48,-122,5,1,6
9646,ElliotBayTrailMyrtlePark,02/06/2015 10:00:00 PM,48,-122,3,0,3
9647,ElliotBayTrailMyrtlePark,02/06/2015 11:00:00 PM,48,-122,3,0,3
9648,ElliotBayTrailMyrtlePark,02/07/2015 12:00:00 AM,48,-122,2,1,3
9649,ElliotBayTrailMyrtlePark,02/07/2015 01:00:00 AM,48,-122,0,0,0
9650,ElliotBayTrailMyrtlePark,02/07/2015 02:00:00 AM,48,-122,1,0,1
9651,ElliotBayTrailMyrtlePark,02/07/2015 03:00:00 AM,48,-122,0,0,0
9652,ElliotBayTrailMyrtlePark,02/07/2015 04:00:00 AM,48,-122,0,0,0
9653,ElliotBayTrailMyrtlePark,02/07/2015 05:00:00 AM,48,-122,0,1,1
9654,ElliotBayTrailMyrtlePark,02/07/2015 06:00:00 AM,48,-122,1,1,2
9655,ElliotBayTrailMyrtlePark,02/07/2015 07:00:00 AM,48,-122,4,1,5
9656,ElliotBayTrailMyrtlePark,02/07/2015 08:00:00 AM,48,-122,7,4,11
9657,ElliotBayTrailMyrtlePark,02/07/2015 09:00:00 AM,48,-122,2,8,10
9658,ElliotBayTrailMyrtlePark,02/07/2015 10:00:00 AM,48,-122,2,3,5
9659,ElliotBayTrailMyrtlePark,02/07/2015 11:00:00 AM,48,-122,3,6,9
9660,ElliotBayTrailMyrtlePark,02/07/2015 12:00:00 PM,48,-122,10,5,15
9661,ElliotBayTrailMyrtlePark,02/07/2015 01:00:00 PM,48,-122,7,9,16
9662,ElliotBayTrailMyrtlePark,02/07/2015 02:00:00 PM,48,-122,16,15,31
9663,ElliotBayTrailMyrtlePark,02/07/2015 03:00:00 PM,48,-122,12,15,27
9664,ElliotBayTrailMyrtlePark,02/07/2015 04:00:00 PM,48,-122,9,9,18
9665,ElliotBayTrailMyrtlePark,02/07/2015 05:00:00 PM,48,-122,4,2,6
9666,ElliotBayTrailMyrtlePark,02/07/2015 06:00:00 PM,48,-122,3,2,5
9667,ElliotBayTrailMyrtlePark,02/07/2015 07:00:00 PM,48,-122,3,3,6
9668,ElliotBayTrailMyrtlePark,02/07/2015 08:00:00 PM,48,-122,1,1,2
9669,ElliotBayTrailMyrtlePark,02/07/2015 09:00:00 PM,48,-122,1,0,1
9670,ElliotBayTrailMyrtlePark,02/07/2015 10:00:00 PM,48,-122,0,0,0
9671,ElliotBayTrailMyrtlePark,02/07/2015 11:00:00 PM,48,-122,1,0,1
9672,ElliotBayTrailMyrtlePark,02/08/2015 12:00:00 AM,48,-122,0,1,1
9673,ElliotBayTrailMyrtlePark,02/08/2015 01:00:00 AM,48,-122,0,0,0
9674,ElliotBayTrailMyrtlePark,02/08/2015 02:00:00 AM,48,-122,0,0,0
9675,ElliotBayTrailMyrtlePark,02/08/2015 03:00:00 AM,48,-122,2,0,2
9676,ElliotBayTrailMyrtlePark,02/08/2015 04:00:00 AM,48,-122,0,0,0
9677,ElliotBayTrailMyrtlePark,02/08/2015 05:00:00 AM,48,-122,0,2,2
9678,ElliotBayTrailMyrtlePark,02/08/2015 06:00:00 AM,48,-122,0,2,2
9679,ElliotBayTrailMyrtlePark,02/08/2015 07:00:00 AM,48,-122,3,2,5
9680,ElliotBayTrailMyrtlePark,02/08/2015 08:00:00 AM,48,-122,5,5,10
9681,ElliotBayTrailMyrtlePark,02/08/2015 09:00:00 AM,48,-122,27,22,49
9682,ElliotBayTrailMyrtlePark,02/08/2015 10:00:00 AM,48,-122,37,45,82
9683,ElliotBayTrailMyrtlePark,02/08/2015 11:00:00 AM,48,-122,36,46,82
9684,ElliotBayTrailMyrtlePark,02/08/2015 12:00:00 PM,48,-122,43,35,78
9685,ElliotBayTrailMyrtlePark,02/08/2015 01:00:00 PM,48,-122,60,74,134
9686,ElliotBayTrailMyrtlePark,02/08/2015 02:00:00 PM,48,-122,72,71,143
9687,ElliotBayTrailMyrtlePark,02/08/2015 03:00:00 PM,48,-122,55,40,95
9688,ElliotBayTrailMyrtlePark,02/08/2015 04:00:00 PM,48,-122,32,36,68
9689,ElliotBayTrailMyrtlePark,02/08/2015 05:00:00 PM,48,-122,17,21,38
9690,ElliotBayTrailMyrtlePark,02/08/2015 06:00:00 PM,48,-122,3,14,17
9691,ElliotBayTrailMyrtlePark,02/08/2015 07:00:00 PM,48,-122,2,2,4
9692,ElliotBayTrailMyrtlePark,02/08/2015 08:00:00 PM,48,-122,3,1,4
9693,ElliotBayTrailMyrtlePark,02/08/2015 09:00:00 PM,48,-122,1,2,3
9694,ElliotBayTrailMyrtlePark,02/08/2015 10:00:00 PM,48,-122,0,0,0
9695,ElliotBayTrailMyrtlePark,02/08/2015 11:00:00 PM,48,-122,2,1,3
9696,ElliotBayTrailMyrtlePark,02/09/2015 12:00:00 AM,48,-122,0,0,0
9697,ElliotBayTrailMyrtlePark,02/09/2015 01:00:00 AM,48,-122,0,0,0
9698,ElliotBayTrailMyrtlePark,02/09/2015 02:00:00 AM,48,-122,1,0,1
9699,ElliotBayTrailMyrtlePark,02/09/2015 03:00:00 AM,48,-122,1,0,1
9700,ElliotBayTrailMyrtlePark,02/09/2015 04:00:00 AM,48,-122,0,0,0
9701,ElliotBayTrailMyrtlePark,02/09/2015 05:00:00 AM,48,-122,6,14,20
9702,ElliotBayTrailMyrtlePark,02/09/2015 06:00:00 AM,48,-122,12,25,37
9703,ElliotBayTrailMyrtlePark,02/09/2015 07:00:00 AM,48,-122,28,45,73
9704,ElliotBayTrailMyrtlePark,02/09/2015 08:00:00 AM,48,-122,33,101,134
9705,ElliotBayTrailMyrtlePark,02/09/2015 09:00:00 AM,48,-122,10,46,56
9706,ElliotBayTrailMyrtlePark,02/09/2015 10:00:00 AM,48,-122,4,13,17
9707,ElliotBayTrailMyrtlePark,02/09/2015 11:00:00 AM,48,-122,3,9,12
9708,ElliotBayTrailMyrtlePark,02/09/2015 12:00:00 PM,48,-122,6,12,18
9709,ElliotBayTrailMyrtlePark,02/09/2015 01:00:00 PM,48,-122,3,6,9
9710,ElliotBayTrailMyrtlePark,02/09/2015 02:00:00 PM,48,-122,6,11,17
9711,ElliotBayTrailMyrtlePark,02/09/2015 03:00:00 PM,48,-122,22,14,36
9712,ElliotBayTrailMyrtlePark,02/09/2015 04:00:00 PM,48,-122,55,23,78
9713,ElliotBayTrailMyrtlePark,02/09/2015 05:00:00 PM,48,-122,95,43,138
9714,ElliotBayTrailMyrtlePark,02/09/2015 06:00:00 PM,48,-122,74,14,88
9715,ElliotBayTrailMyrtlePark,02/09/2015 07:00:00 PM,48,-122,21,5,26
9716,ElliotBayTrailMyrtlePark,02/09/2015 08:00:00 PM,48,-122,6,3,9
9717,ElliotBayTrailMyrtlePark,02/09/2015 09:00:00 PM,48,-122,2,2,4
9718,ElliotBayTrailMyrtlePark,02/09/2015 10:00:00 PM,48,-122,4,0,4
9719,ElliotBayTrailMyrtlePark,02/09/2015 11:00:00 PM,48,-122,2,0,2
9720,ElliotBayTrailMyrtlePark,02/10/2015 12:00:00 AM,48,-122,1,0,1
9721,ElliotBayTrailMyrtlePark,02/10/2015 01:00:00 AM,48,-122,1,0,1
9722,ElliotBayTrailMyrtlePark,02/10/2015 02:00:00 AM,48,-122,0,2,2
9723,ElliotBayTrailMyrtlePark,02/10/2015 03:00:00 AM,48,-122,0,0,0
9724,ElliotBayTrailMyrtlePark,02/10/2015 04:00:00 AM,48,-122,0,0,0
9725,ElliotBayTrailMyrtlePark,02/10/2015 05:00:00 AM,48,-122,3,13,16
9726,ElliotBayTrailMyrtlePark,02/10/2015 06:00:00 AM,48,-122,14,15,29
9727,ElliotBayTrailMyrtlePark,02/10/2015 07:00:00 AM,48,-122,32,60,92
9728,ElliotBayTrailMyrtlePark,02/10/2015 08:00:00 AM,48,-122,33,102,135
9729,ElliotBayTrailMyrtlePark,02/10/2015 09:00:00 AM,48,-122,18,52,70
9730,ElliotBayTrailMyrtlePark,02/10/2015 10:00:00 AM,48,-122,15,28,43
9731,ElliotBayTrailMyrtlePark,02/10/2015 11:00:00 AM,48,-122,17,20,37
9732,ElliotBayTrailMyrtlePark,02/10/2015 12:00:00 PM,48,-122,9,15,24
9733,ElliotBayTrailMyrtlePark,02/10/2015 01:00:00 PM,48,-122,14,19,33
9734,ElliotBayTrailMyrtlePark,02/10/2015 02:00:00 PM,48,-122,25,24,49
9735,ElliotBayTrailMyrtlePark,02/10/2015 03:00:00 PM,48,-122,24,20,44
9736,ElliotBayTrailMyrtlePark,02/10/2015 04:00:00 PM,48,-122,63,48,111
9737,ElliotBayTrailMyrtlePark,02/10/2015 05:00:00 PM,48,-122,118,46,164
9738,ElliotBayTrailMyrtlePark,02/10/2015 06:00:00 PM,48,-122,89,25,114
9739,ElliotBayTrailMyrtlePark,02/10/2015 07:00:00 PM,48,-122,39,12,51
9740,ElliotBayTrailMyrtlePark,02/10/2015 08:00:00 PM,48,-122,7,4,11
9741,ElliotBayTrailMyrtlePark,02/10/2015 09:00:00 PM,48,-122,9,4,13
9742,ElliotBayTrailMyrtlePark,02/10/2015 10:00:00 PM,48,-122,3,5,8
9743,ElliotBayTrailMyrtlePark,02/10/2015 11:00:00 PM,48,-122,3,1,4
9744,ElliotBayTrailMyrtlePark,02/11/2015 12:00:00 AM,48,-122,0,0,0
9745,ElliotBayTrailMyrtlePark,02/11/2015 01:00:00 AM,48,-122,3,0,3
9746,ElliotBayTrailMyrtlePark,02/11/2015 02:00:00 AM,48,-122,1,0,1
9747,ElliotBayTrailMyrtlePark,02/11/2015 03:00:00 AM,48,-122,0,0,0
9748,ElliotBayTrailMyrtlePark,02/11/2015 04:00:00 AM,48,-122,2,1,3
9749,ElliotBayTrailMyrtlePark,02/11/2015 05:00:00 AM,48,-122,5,10,15
9750,ElliotBayTrailMyrtlePark,02/11/2015 06:00:00 AM,48,-122,17,18,35
9751,ElliotBayTrailMyrtlePark,02/11/2015 07:00:00 AM,48,-122,34,74,108
9752,ElliotBayTrailMyrtlePark,02/11/2015 08:00:00 AM,48,-122,37,122,159
9753,ElliotBayTrailMyrtlePark,02/11/2015 09:00:00 AM,48,-122,14,75,89
9754,ElliotBayTrailMyrtlePark,02/11/2015 10:00:00 AM,48,-122,9,25,34
9755,ElliotBayTrailMyrtlePark,02/11/2015 11:00:00 AM,48,-122,8,11,19
9756,ElliotBayTrailMyrtlePark,02/11/2015 12:00:00 PM,48,-122,22,16,38
9757,ElliotBayTrailMyrtlePark,02/11/2015 01:00:00 PM,48,-122,13,16,29
9758,ElliotBayTrailMyrtlePark,02/11/2015 02:00:00 PM,48,-122,16,18,34
9759,ElliotBayTrailMyrtlePark,02/11/2015 03:00:00 PM,48,-122,34,23,57
9760,ElliotBayTrailMyrtlePark,02/11/2015 04:00:00 PM,48,-122,55,38,93
9761,ElliotBayTrailMyrtlePark,02/11/2015 05:00:00 PM,48,-122,135,45,180
9762,ElliotBayTrailMyrtlePark,02/11/2015 06:00:00 PM,48,-122,96,21,117
9763,ElliotBayTrailMyrtlePark,02/11/2015 07:00:00 PM,48,-122,36,11,47
9764,ElliotBayTrailMyrtlePark,02/11/2015 08:00:00 PM,48,-122,6,4,10
9765,ElliotBayTrailMyrtlePark,02/11/2015 09:00:00 PM,48,-122,6,2,8
9766,ElliotBayTrailMyrtlePark,02/11/2015 10:00:00 PM,48,-122,3,2,5
9767,ElliotBayTrailMyrtlePark,02/11/2015 11:00:00 PM,48,-122,1,0,1
9768,ElliotBayTrailMyrtlePark,02/12/2015 12:00:00 AM,48,-122,0,0,0
9769,ElliotBayTrailMyrtlePark,02/12/2015 01:00:00 AM,48,-122,1,0,1
9770,ElliotBayTrailMyrtlePark,02/12/2015 02:00:00 AM,48,-122,2,0,2
9771,ElliotBayTrailMyrtlePark,02/12/2015 03:00:00 AM,48,-122,1,0,1
9772,ElliotBayTrailMyrtlePark,02/12/2015 04:00:00 AM,48,-122,0,0,0
9773,ElliotBayTrailMyrtlePark,02/12/2015 05:00:00 AM,48,-122,4,8,12
9774,ElliotBayTrailMyrtlePark,02/12/2015 06:00:00 AM,48,-122,11,24,35
9775,ElliotBayTrailMyrtlePark,02/12/2015 07:00:00 AM,48,-122,31,56,87
9776,ElliotBayTrailMyrtlePark,02/12/2015 08:00:00 AM,48,-122,39,116,155
9777,ElliotBayTrailMyrtlePark,02/12/2015 09:00:00 AM,48,-122,19,63,82
9778,ElliotBayTrailMyrtlePark,02/12/2015 10:00:00 AM,48,-122,11,18,29
9779,ElliotBayTrailMyrtlePark,02/12/2015 11:00:00 AM,48,-122,10,18,28
9780,ElliotBayTrailMyrtlePark,02/12/2015 12:00:00 PM,48,-122,18,12,30
9781,ElliotBayTrailMyrtlePark,02/12/2015 01:00:00 PM,48,-122,14,16,30
9782,ElliotBayTrailMyrtlePark,02/12/2015 02:00:00 PM,48,-122,28,31,59
9783,ElliotBayTrailMyrtlePark,02/12/2015 03:00:00 PM,48,-122,29,34,63
9784,ElliotBayTrailMyrtlePark,02/12/2015 04:00:00 PM,48,-122,78,35,113
9785,ElliotBayTrailMyrtlePark,02/12/2015 05:00:00 PM,48,-122,128,52,180
9786,ElliotBayTrailMyrtlePark,02/12/2015 06:00:00 PM,48,-122,84,27,111
9787,ElliotBayTrailMyrtlePark,02/12/2015 07:00:00 PM,48,-122,25,6,31
9788,ElliotBayTrailMyrtlePark,02/12/2015 08:00:00 PM,48,-122,15,0,15
9789,ElliotBayTrailMyrtlePark,02/12/2015 09:00:00 PM,48,-122,5,0,5
9790,ElliotBayTrailMyrtlePark,02/12/2015 10:00:00 PM,48,-122,3,5,8
9791,ElliotBayTrailMyrtlePark,02/12/2015 11:00:00 PM,48,-122,2,1,3
9792,ElliotBayTrailMyrtlePark,02/13/2015 12:00:00 AM,48,-122,1,0,1
9793,ElliotBayTrailMyrtlePark,02/13/2015 01:00:00 AM,48,-122,0,0,0
9794,ElliotBayTrailMyrtlePark,02/13/2015 02:00:00 AM,48,-122,2,0,2
9795,ElliotBayTrailMyrtlePark,02/13/2015 03:00:00 AM,48,-122,1,0,1
9796,ElliotBayTrailMyrtlePark,02/13/2015 04:00:00 AM,48,-122,0,2,2
9797,ElliotBayTrailMyrtlePark,02/13/2015 05:00:00 AM,48,-122,4,11,15
9798,ElliotBayTrailMyrtlePark,02/13/2015 06:00:00 AM,48,-122,15,12,27
9799,ElliotBayTrailMyrtlePark,02/13/2015 07:00:00 AM,48,-122,26,59,85
9800,ElliotBayTrailMyrtlePark,02/13/2015 08:00:00 AM,48,-122,35,113,148
9801,ElliotBayTrailMyrtlePark,02/13/2015 09:00:00 AM,48,-122,19,59,78
9802,ElliotBayTrailMyrtlePark,02/13/2015 10:00:00 AM,48,-122,10,24,34
9803,ElliotBayTrailMyrtlePark,02/13/2015 11:00:00 AM,48,-122,18,16,34
9804,ElliotBayTrailMyrtlePark,02/13/2015 12:00:00 PM,48,-122,22,22,44
9805,ElliotBayTrailMyrtlePark,02/13/2015 01:00:00 PM,48,-122,23,26,49
9806,ElliotBayTrailMyrtlePark,02/13/2015 02:00:00 PM,48,-122,32,29,61
9807,ElliotBayTrailMyrtlePark,02/13/2015 03:00:00 PM,48,-122,47,38,85
9808,ElliotBayTrailMyrtlePark,02/13/2015 04:00:00 PM,48,-122,73,32,105
9809,ElliotBayTrailMyrtlePark,02/13/2015 05:00:00 PM,48,-122,122,39,161
9810,ElliotBayTrailMyrtlePark,02/13/2015 06:00:00 PM,48,-122,71,21,92
9811,ElliotBayTrailMyrtlePark,02/13/2015 07:00:00 PM,48,-122,27,4,31
9812,ElliotBayTrailMyrtlePark,02/13/2015 08:00:00 PM,48,-122,9,5,14
9813,ElliotBayTrailMyrtlePark,02/13/2015 09:00:00 PM,48,-122,8,2,10
9814,ElliotBayTrailMyrtlePark,02/13/2015 10:00:00 PM,48,-122,1,6,7
9815,ElliotBayTrailMyrtlePark,02/13/2015 11:00:00 PM,48,-122,6,1,7
9816,ElliotBayTrailMyrtlePark,02/14/2015 12:00:00 AM,48,-122,3,0,3
9817,ElliotBayTrailMyrtlePark,02/14/2015 01:00:00 AM,48,-122,3,0,3
9818,ElliotBayTrailMyrtlePark,02/14/2015 02:00:00 AM,48,-122,2,0,2
9819,ElliotBayTrailMyrtlePark,02/14/2015 03:00:00 AM,48,-122,0,0,0
9820,ElliotBayTrailMyrtlePark,02/14/2015 04:00:00 AM,48,-122,0,0,0
9821,ElliotBayTrailMyrtlePark,02/14/2015 05:00:00 AM,48,-122,0,1,1
9822,ElliotBayTrailMyrtlePark,02/14/2015 06:00:00 AM,48,-122,1,3,4
9823,ElliotBayTrailMyrtlePark,02/14/2015 07:00:00 AM,48,-122,5,10,15
9824,ElliotBayTrailMyrtlePark,02/14/2015 08:00:00 AM,48,-122,11,10,21
9825,ElliotBayTrailMyrtlePark,02/14/2015 09:00:00 AM,48,-122,12,27,39
9826,ElliotBayTrailMyrtlePark,02/14/2015 10:00:00 AM,48,-122,17,27,44
9827,ElliotBayTrailMyrtlePark,02/14/2015 11:00:00 AM,48,-122,23,29,52
9828,ElliotBayTrailMyrtlePark,02/14/2015 12:00:00 PM,48,-122,32,38,70
9829,ElliotBayTrailMyrtlePark,02/14/2015 01:00:00 PM,48,-122,43,45,88
9830,ElliotBayTrailMyrtlePark,02/14/2015 02:00:00 PM,48,-122,46,51,97
9831,ElliotBayTrailMyrtlePark,02/14/2015 03:00:00 PM,48,-122,58,51,109
9832,ElliotBayTrailMyrtlePark,02/14/2015 04:00:00 PM,48,-122,59,43,102
9833,ElliotBayTrailMyrtlePark,02/14/2015 05:00:00 PM,48,-122,55,48,103
9834,ElliotBayTrailMyrtlePark,02/14/2015 06:00:00 PM,48,-122,11,19,30
9835,ElliotBayTrailMyrtlePark,02/14/2015 07:00:00 PM,48,-122,11,1,12
9836,ElliotBayTrailMyrtlePark,02/14/2015 08:00:00 PM,48,-122,2,0,2
9837,ElliotBayTrailMyrtlePark,02/14/2015 09:00:00 PM,48,-122,4,4,8
9838,ElliotBayTrailMyrtlePark,02/14/2015 10:00:00 PM,48,-122,0,5,5
9839,ElliotBayTrailMyrtlePark,02/14/2015 11:00:00 PM,48,-122,5,1,6
9840,ElliotBayTrailMyrtlePark,02/15/2015 12:00:00 AM,48,-122,4,2,6
9841,ElliotBayTrailMyrtlePark,02/15/2015 01:00:00 AM,48,-122,2,0,2
9842,ElliotBayTrailMyrtlePark,02/15/2015 02:00:00 AM,48,-122,0,0,0
9843,ElliotBayTrailMyrtlePark,02/15/2015 03:00:00 AM,48,-122,1,0,1
9844,ElliotBayTrailMyrtlePark,02/15/2015 04:00:00 AM,48,-122,0,0,0
9845,ElliotBayTrailMyrtlePark,02/15/2015 05:00:00 AM,48,-122,0,1,1
9846,ElliotBayTrailMyrtlePark,02/15/2015 06:00:00 AM,48,-122,0,3,3
9847,ElliotBayTrailMyrtlePark,02/15/2015 07:00:00 AM,48,-122,7,6,13
9848,ElliotBayTrailMyrtlePark,02/15/2015 08:00:00 AM,48,-122,8,9,17
9849,ElliotBayTrailMyrtlePark,02/15/2015 09:00:00 AM,48,-122,14,28,42
9850,ElliotBayTrailMyrtlePark,02/15/2015 10:00:00 AM,48,-122,40,22,62
9851,ElliotBayTrailMyrtlePark,02/15/2015 11:00:00 AM,48,-122,62,64,126
9852,ElliotBayTrailMyrtlePark,02/15/2015 12:00:00 PM,48,-122,65,69,134
9853,ElliotBayTrailMyrtlePark,02/15/2015 01:00:00 PM,48,-122,89,90,179
9854,ElliotBayTrailMyrtlePark,02/15/2015 02:00:00 PM,48,-122,90,81,171
9855,ElliotBayTrailMyrtlePark,02/15/2015 03:00:00 PM,48,-122,80,70,150
9856,ElliotBayTrailMyrtlePark,02/15/2015 04:00:00 PM,48,-122,64,62,126
9857,ElliotBayTrailMyrtlePark,02/15/2015 05:00:00 PM,48,-122,49,37,86
9858,ElliotBayTrailMyrtlePark,02/15/2015 06:00:00 PM,48,-122,10,10,20
9859,ElliotBayTrailMyrtlePark,02/15/2015 07:00:00 PM,48,-122,7,1,8
9860,ElliotBayTrailMyrtlePark,02/15/2015 08:00:00 PM,48,-122,0,2,2
9861,ElliotBayTrailMyrtlePark,02/15/2015 09:00:00 PM,48,-122,2,2,4
9862,ElliotBayTrailMyrtlePark,02/15/2015 10:00:00 PM,48,-122,3,0,3
9863,ElliotBayTrailMyrtlePark,02/15/2015 11:00:00 PM,48,-122,2,0,2
9864,ElliotBayTrailMyrtlePark,02/16/2015 12:00:00 AM,48,-122,0,0,0
9865,ElliotBayTrailMyrtlePark,02/16/2015 01:00:00 AM,48,-122,0,0,0
9866,ElliotBayTrailMyrtlePark,02/16/2015 02:00:00 AM,48,-122,1,0,1
9867,ElliotBayTrailMyrtlePark,02/16/2015 03:00:00 AM,48,-122,0,0,0
9868,ElliotBayTrailMyrtlePark,02/16/2015 04:00:00 AM,48,-122,0,0,0
9869,ElliotBayTrailMyrtlePark,02/16/2015 05:00:00 AM,48,-122,3,4,7
9870,ElliotBayTrailMyrtlePark,02/16/2015 06:00:00 AM,48,-122,4,9,13
9871,ElliotBayTrailMyrtlePark,02/16/2015 07:00:00 AM,48,-122,15,26,41
9872,ElliotBayTrailMyrtlePark,02/16/2015 08:00:00 AM,48,-122,18,53,71
9873,ElliotBayTrailMyrtlePark,02/16/2015 09:00:00 AM,48,-122,19,34,53
9874,ElliotBayTrailMyrtlePark,02/16/2015 10:00:00 AM,48,-122,19,31,50
9875,ElliotBayTrailMyrtlePark,02/16/2015 11:00:00 AM,48,-122,40,30,70
9876,ElliotBayTrailMyrtlePark,02/16/2015 12:00:00 PM,48,-122,40,48,88
9877,ElliotBayTrailMyrtlePark,02/16/2015 01:00:00 PM,48,-122,51,45,96
9878,ElliotBayTrailMyrtlePark,02/16/2015 02:00:00 PM,48,-122,49,53,102
9879,ElliotBayTrailMyrtlePark,02/16/2015 03:00:00 PM,48,-122,47,60,107
9880,ElliotBayTrailMyrtlePark,02/16/2015 04:00:00 PM,48,-122,61,44,105
9881,ElliotBayTrailMyrtlePark,02/16/2015 05:00:00 PM,48,-122,78,35,113
9882,ElliotBayTrailMyrtlePark,02/16/2015 06:00:00 PM,48,-122,66,29,95
9883,ElliotBayTrailMyrtlePark,02/16/2015 07:00:00 PM,48,-122,15,6,21
9884,ElliotBayTrailMyrtlePark,02/16/2015 08:00:00 PM,48,-122,3,0,3
9885,ElliotBayTrailMyrtlePark,02/16/2015 09:00:00 PM,48,-122,9,3,12
9886,ElliotBayTrailMyrtlePark,02/16/2015 10:00:00 PM,48,-122,3,2,5
9887,ElliotBayTrailMyrtlePark,02/16/2015 11:00:00 PM,48,-122,3,1,4
9888,ElliotBayTrailMyrtlePark,02/17/2015 12:00:00 AM,48,-122,3,0,3
9889,ElliotBayTrailMyrtlePark,02/17/2015 01:00:00 AM,48,-122,0,0,0
9890,ElliotBayTrailMyrtlePark,02/17/2015 02:00:00 AM,48,-122,1,0,1
9891,ElliotBayTrailMyrtlePark,02/17/2015 03:00:00 AM,48,-122,0,0,0
9892,ElliotBayTrailMyrtlePark,02/17/2015 04:00:00 AM,48,-122,0,1,1
9893,ElliotBayTrailMyrtlePark,02/17/2015 05:00:00 AM,48,-122,3,8,11
9894,ElliotBayTrailMyrtlePark,02/17/2015 06:00:00 AM,48,-122,17,33,50
9895,ElliotBayTrailMyrtlePark,02/17/2015 07:00:00 AM,48,-122,24,80,104
9896,ElliotBayTrailMyrtlePark,02/17/2015 08:00:00 AM,48,-122,42,127,169
9897,ElliotBayTrailMyrtlePark,02/17/2015 09:00:00 AM,48,-122,25,64,89
9898,ElliotBayTrailMyrtlePark,02/17/2015 10:00:00 AM,48,-122,13,22,35
9899,ElliotBayTrailMyrtlePark,02/17/2015 11:00:00 AM,48,-122,15,18,33
9900,ElliotBayTrailMyrtlePark,02/17/2015 12:00:00 PM,48,-122,27,22,49
9901,ElliotBayTrailMyrtlePark,02/17/2015 01:00:00 PM,48,-122,34,35,69
9902,ElliotBayTrailMyrtlePark,02/17/2015 02:00:00 PM,48,-122,39,42,81
9903,ElliotBayTrailMyrtlePark,02/17/2015 03:00:00 PM,48,-122,48,48,96
9904,ElliotBayTrailMyrtlePark,02/17/2015 04:00:00 PM,48,-122,104,51,155
9905,ElliotBayTrailMyrtlePark,02/17/2015 05:00:00 PM,48,-122,186,65,251
9906,ElliotBayTrailMyrtlePark,02/17/2015 06:00:00 PM,48,-122,93,36,129
9907,ElliotBayTrailMyrtlePark,02/17/2015 07:00:00 PM,48,-122,29,11,40
9908,ElliotBayTrailMyrtlePark,02/17/2015 08:00:00 PM,48,-122,14,3,17
9909,ElliotBayTrailMyrtlePark,02/17/2015 09:00:00 PM,48,-122,7,0,7
9910,ElliotBayTrailMyrtlePark,02/17/2015 10:00:00 PM,48,-122,6,4,10
9911,ElliotBayTrailMyrtlePark,02/17/2015 11:00:00 PM,48,-122,2,2,4
9912,ElliotBayTrailMyrtlePark,02/18/2015 12:00:00 AM,48,-122,0,0,0
9913,ElliotBayTrailMyrtlePark,02/18/2015 01:00:00 AM,48,-122,2,0,2
9914,ElliotBayTrailMyrtlePark,02/18/2015 02:00:00 AM,48,-122,0,0,0
9915,ElliotBayTrailMyrtlePark,02/18/2015 03:00:00 AM,48,-122,0,0,0
9916,ElliotBayTrailMyrtlePark,02/18/2015 04:00:00 AM,48,-122,3,1,4
9917,ElliotBayTrailMyrtlePark,02/18/2015 05:00:00 AM,48,-122,4,12,16
9918,ElliotBayTrailMyrtlePark,02/18/2015 06:00:00 AM,48,-122,22,28,50
9919,ElliotBayTrailMyrtlePark,02/18/2015 07:00:00 AM,48,-122,31,69,100
9920,ElliotBayTrailMyrtlePark,02/18/2015 08:00:00 AM,48,-122,37,119,156
9921,ElliotBayTrailMyrtlePark,02/18/2015 09:00:00 AM,48,-122,17,83,100
9922,ElliotBayTrailMyrtlePark,02/18/2015 10:00:00 AM,48,-122,16,11,27
9923,ElliotBayTrailMyrtlePark,02/18/2015 11:00:00 AM,48,-122,7,17,24
9924,ElliotBayTrailMyrtlePark,02/18/2015 12:00:00 PM,48,-122,13,10,23
9925,ElliotBayTrailMyrtlePark,02/18/2015 01:00:00 PM,48,-122,16,15,31
9926,ElliotBayTrailMyrtlePark,02/18/2015 02:00:00 PM,48,-122,18,17,35
9927,ElliotBayTrailMyrtlePark,02/18/2015 03:00:00 PM,48,-122,18,20,38
9928,ElliotBayTrailMyrtlePark,02/18/2015 04:00:00 PM,48,-122,72,35,107
9929,ElliotBayTrailMyrtlePark,02/18/2015 05:00:00 PM,48,-122,156,44,200
9930,ElliotBayTrailMyrtlePark,02/18/2015 06:00:00 PM,48,-122,64,28,92
9931,ElliotBayTrailMyrtlePark,02/18/2015 07:00:00 PM,48,-122,31,4,35
9932,ElliotBayTrailMyrtlePark,02/18/2015 08:00:00 PM,48,-122,8,3,11
9933,ElliotBayTrailMyrtlePark,02/18/2015 09:00:00 PM,48,-122,10,2,12
9934,ElliotBayTrailMyrtlePark,02/18/2015 10:00:00 PM,48,-122,2,4,6
9935,ElliotBayTrailMyrtlePark,02/18/2015 11:00:00 PM,48,-122,2,1,3
9936,ElliotBayTrailMyrtlePark,02/19/2015 12:00:00 AM,48,-122,1,1,2
9937,ElliotBayTrailMyrtlePark,02/19/2015 01:00:00 AM,48,-122,0,0,0
9938,ElliotBayTrailMyrtlePark,02/19/2015 02:00:00 AM,48,-122,2,0,2
9939,ElliotBayTrailMyrtlePark,02/19/2015 03:00:00 AM,48,-122,0,0,0
9940,ElliotBayTrailMyrtlePark,02/19/2015 04:00:00 AM,48,-122,0,0,0
9941,ElliotBayTrailMyrtlePark,02/19/2015 05:00:00 AM,48,-122,2,4,6
9942,ElliotBayTrailMyrtlePark,02/19/2015 06:00:00 AM,48,-122,13,27,40
9943,ElliotBayTrailMyrtlePark,02/19/2015 07:00:00 AM,48,-122,32,63,95
9944,ElliotBayTrailMyrtlePark,02/19/2015 08:00:00 AM,48,-122,38,127,165
9945,ElliotBayTrailMyrtlePark,02/19/2015 09:00:00 AM,48,-122,19,55,74
9946,ElliotBayTrailMyrtlePark,02/19/2015 10:00:00 AM,48,-122,8,11,19
9947,ElliotBayTrailMyrtlePark,02/19/2015 11:00:00 AM,48,-122,8,5,13
9948,ElliotBayTrailMyrtlePark,02/19/2015 12:00:00 PM,48,-122,7,7,14
9949,ElliotBayTrailMyrtlePark,02/19/2015 01:00:00 PM,48,-122,11,10,21
9950,ElliotBayTrailMyrtlePark,02/19/2015 02:00:00 PM,48,-122,8,10,18
9951,ElliotBayTrailMyrtlePark,02/19/2015 03:00:00 PM,48,-122,13,12,25
9952,ElliotBayTrailMyrtlePark,02/19/2015 04:00:00 PM,48,-122,52,25,77
9953,ElliotBayTrailMyrtlePark,02/19/2015 05:00:00 PM,48,-122,99,39,138
9954,ElliotBayTrailMyrtlePark,02/19/2015 06:00:00 PM,48,-122,81,11,92
9955,ElliotBayTrailMyrtlePark,02/19/2015 07:00:00 PM,48,-122,27,3,30
9956,ElliotBayTrailMyrtlePark,02/19/2015 08:00:00 PM,48,-122,13,1,14
9957,ElliotBayTrailMyrtlePark,02/19/2015 09:00:00 PM,48,-122,3,2,5
9958,ElliotBayTrailMyrtlePark,02/19/2015 10:00:00 PM,48,-122,1,4,5
9959,ElliotBayTrailMyrtlePark,02/19/2015 11:00:00 PM,48,-122,6,1,7
9960,ElliotBayTrailMyrtlePark,02/20/2015 12:00:00 AM,48,-122,1,4,5
9961,ElliotBayTrailMyrtlePark,02/20/2015 01:00:00 AM,48,-122,0,0,0
9962,ElliotBayTrailMyrtlePark,02/20/2015 02:00:00 AM,48,-122,2,0,2
9963,ElliotBayTrailMyrtlePark,02/20/2015 03:00:00 AM,48,-122,2,0,2
9964,ElliotBayTrailMyrtlePark,02/20/2015 04:00:00 AM,48,-122,0,1,1
9965,ElliotBayTrailMyrtlePark,02/20/2015 05:00:00 AM,48,-122,3,5,8
9966,ElliotBayTrailMyrtlePark,02/20/2015 06:00:00 AM,48,-122,7,16,23
9967,ElliotBayTrailMyrtlePark,02/20/2015 07:00:00 AM,48,-122,27,51,78
9968,ElliotBayTrailMyrtlePark,02/20/2015 08:00:00 AM,48,-122,25,101,126
9969,ElliotBayTrailMyrtlePark,02/20/2015 09:00:00 AM,48,-122,11,39,50
9970,ElliotBayTrailMyrtlePark,02/20/2015 10:00:00 AM,48,-122,9,18,27
9971,ElliotBayTrailMyrtlePark,02/20/2015 11:00:00 AM,48,-122,6,17,23
9972,ElliotBayTrailMyrtlePark,02/20/2015 12:00:00 PM,48,-122,15,12,27
9973,ElliotBayTrailMyrtlePark,02/20/2015 01:00:00 PM,48,-122,31,10,41
9974,ElliotBayTrailMyrtlePark,02/20/2015 02:00:00 PM,48,-122,23,19,42
9975,ElliotBayTrailMyrtlePark,02/20/2015 03:00:00 PM,48,-122,35,20,55
9976,ElliotBayTrailMyrtlePark,02/20/2015 04:00:00 PM,48,-122,47,26,73
9977,ElliotBayTrailMyrtlePark,02/20/2015 05:00:00 PM,48,-122,106,32,138
9978,ElliotBayTrailMyrtlePark,02/20/2015 06:00:00 PM,48,-122,60,22,82
9979,ElliotBayTrailMyrtlePark,02/20/2015 07:00:00 PM,48,-122,19,5,24
9980,ElliotBayTrailMyrtlePark,02/20/2015 08:00:00 PM,48,-122,8,1,9
9981,ElliotBayTrailMyrtlePark,02/20/2015 09:00:00 PM,48,-122,0,2,2
9982,ElliotBayTrailMyrtlePark,02/20/2015 10:00:00 PM,48,-122,4,2,6
9983,ElliotBayTrailMyrtlePark,02/20/2015 11:00:00 PM,48,-122,1,0,1
9984,ElliotBayTrailMyrtlePark,02/21/2015 12:00:00 AM,48,-122,3,0,3
9985,ElliotBayTrailMyrtlePark,02/21/2015 01:00:00 AM,48,-122,1,0,1
9986,ElliotBayTrailMyrtlePark,02/21/2015 02:00:00 AM,48,-122,0,1,1
9987,ElliotBayTrailMyrtlePark,02/21/2015 03:00:00 AM,48,-122,0,0,0
9988,ElliotBayTrailMyrtlePark,02/21/2015 04:00:00 AM,48,-122,2,0,2
9989,ElliotBayTrailMyrtlePark,02/21/2015 05:00:00 AM,48,-122,1,1,2
9990,ElliotBayTrailMyrtlePark,02/21/2015 06:00:00 AM,48,-122,1,3,4
9991,ElliotBayTrailMyrtlePark,02/21/2015 07:00:00 AM,48,-122,9,10,19
9992,ElliotBayTrailMyrtlePark,02/21/2015 08:00:00 AM,48,-122,10,21,31
9993,ElliotBayTrailMyrtlePark,02/21/2015 09:00:00 AM,48,-122,6,15,21
9994,ElliotBayTrailMyrtlePark,02/21/2015 10:00:00 AM,48,-122,24,26,50
9995,ElliotBayTrailMyrtlePark,02/21/2015 11:00:00 AM,48,-122,40,29,69
9996,ElliotBayTrailMyrtlePark,02/21/2015 12:00:00 PM,48,-122,28,53,81
9997,ElliotBayTrailMyrtlePark,02/21/2015 01:00:00 PM,48,-122,49,40,89
9998,ElliotBayTrailMyrtlePark,02/21/2015 02:00:00 PM,48,-122,41,62,103
9999,ElliotBayTrailMyrtlePark,02/21/2015 03:00:00 PM,48,-122,68,66,134
10000,ElliotBayTrailMyrtlePark,02/21/2015 04:00:00 PM,48,-122,69,55,124
10001,ElliotBayTrailMyrtlePark,02/21/2015 05:00:00 PM,48,-122,50,47,97
10002,ElliotBayTrailMyrtlePark,02/21/2015 06:00:00 PM,48,-122,23,29,52
10003,ElliotBayTrailMyrtlePark,02/21/2015 07:00:00 PM,48,-122,6,4,10
10004,ElliotBayTrailMyrtlePark,02/21/2015 08:00:00 PM,48,-122,5,2,7
10005,ElliotBayTrailMyrtlePark,02/21/2015 09:00:00 PM,48,-122,3,0,3
10006,ElliotBayTrailMyrtlePark,02/21/2015 10:00:00 PM,48,-122,1,0,1
10007,ElliotBayTrailMyrtlePark,02/21/2015 11:00:00 PM,48,-122,4,0,4
10008,ElliotBayTrailMyrtlePark,02/22/2015 12:00:00 AM,48,-122,0,0,0
10009,ElliotBayTrailMyrtlePark,02/22/2015 01:00:00 AM,48,-122,0,1,1
10010,ElliotBayTrailMyrtlePark,02/22/2015 02:00:00 AM,48,-122,2,0,2
10011,ElliotBayTrailMyrtlePark,02/22/2015 03:00:00 AM,48,-122,1,0,1
10012,ElliotBayTrailMyrtlePark,02/22/2015 04:00:00 AM,48,-122,0,0,0
10013,ElliotBayTrailMyrtlePark,02/22/2015 05:00:00 AM,48,-122,0,1,1
10014,ElliotBayTrailMyrtlePark,02/22/2015 06:00:00 AM,48,-122,0,7,7
10015,ElliotBayTrailMyrtlePark,02/22/2015 07:00:00 AM,48,-122,7,75,82
10016,ElliotBayTrailMyrtlePark,02/22/2015 08:00:00 AM,48,-122,14,85,99
10017,ElliotBayTrailMyrtlePark,02/22/2015 09:00:00 AM,48,-122,15,75,90
10018,ElliotBayTrailMyrtlePark,02/22/2015 10:00:00 AM,48,-122,43,31,74
10019,ElliotBayTrailMyrtlePark,02/22/2015 11:00:00 AM,48,-122,40,49,89
10020,ElliotBayTrailMyrtlePark,02/22/2015 12:00:00 PM,48,-122,83,39,122
10021,ElliotBayTrailMyrtlePark,02/22/2015 01:00:00 PM,48,-122,123,86,209
10022,ElliotBayTrailMyrtlePark,02/22/2015 02:00:00 PM,48,-122,107,41,148
10023,ElliotBayTrailMyrtlePark,02/22/2015 03:00:00 PM,48,-122,88,43,131
10024,ElliotBayTrailMyrtlePark,02/22/2015 04:00:00 PM,48,-122,106,39,145
10025,ElliotBayTrailMyrtlePark,02/22/2015 05:00:00 PM,48,-122,66,28,94
10026,ElliotBayTrailMyrtlePark,02/22/2015 06:00:00 PM,48,-122,24,12,36
10027,ElliotBayTrailMyrtlePark,02/22/2015 07:00:00 PM,48,-122,10,2,12
10028,ElliotBayTrailMyrtlePark,02/22/2015 08:00:00 PM,48,-122,1,1,2
10029,ElliotBayTrailMyrtlePark,02/22/2015 09:00:00 PM,48,-122,5,2,7
10030,ElliotBayTrailMyrtlePark,02/22/2015 10:00:00 PM,48,-122,2,0,2
10031,ElliotBayTrailMyrtlePark,02/22/2015 11:00:00 PM,48,-122,1,0,1
10032,ElliotBayTrailMyrtlePark,02/23/2015 12:00:00 AM,48,-122,0,0,0
10033,ElliotBayTrailMyrtlePark,02/23/2015 01:00:00 AM,48,-122,0,2,2
10034,ElliotBayTrailMyrtlePark,02/23/2015 02:00:00 AM,48,-122,1,0,1
10035,ElliotBayTrailMyrtlePark,02/23/2015 03:00:00 AM,48,-122,0,0,0
10036,ElliotBayTrailMyrtlePark,02/23/2015 04:00:00 AM,48,-122,0,0,0
10037,ElliotBayTrailMyrtlePark,02/23/2015 05:00:00 AM,48,-122,4,6,10
10038,ElliotBayTrailMyrtlePark,02/23/2015 06:00:00 AM,48,-122,19,24,43
10039,ElliotBayTrailMyrtlePark,02/23/2015 07:00:00 AM,48,-122,28,65,93
10040,ElliotBayTrailMyrtlePark,02/23/2015 08:00:00 AM,48,-122,35,129,164
10041,ElliotBayTrailMyrtlePark,02/23/2015 09:00:00 AM,48,-122,23,73,96
10042,ElliotBayTrailMyrtlePark,02/23/2015 10:00:00 AM,48,-122,8,20,28
10043,ElliotBayTrailMyrtlePark,02/23/2015 11:00:00 AM,48,-122,22,18,40
10044,ElliotBayTrailMyrtlePark,02/23/2015 12:00:00 PM,48,-122,23,19,42
10045,ElliotBayTrailMyrtlePark,02/23/2015 01:00:00 PM,48,-122,25,25,50
10046,ElliotBayTrailMyrtlePark,02/23/2015 02:00:00 PM,48,-122,26,39,65
10047,ElliotBayTrailMyrtlePark,02/23/2015 03:00:00 PM,48,-122,31,32,63
10048,ElliotBayTrailMyrtlePark,02/23/2015 04:00:00 PM,48,-122,82,66,148
10049,ElliotBayTrailMyrtlePark,02/23/2015 05:00:00 PM,48,-122,167,62,229
10050,ElliotBayTrailMyrtlePark,02/23/2015 06:00:00 PM,48,-122,84,39,123
10051,ElliotBayTrailMyrtlePark,02/23/2015 07:00:00 PM,48,-122,33,7,40
10052,ElliotBayTrailMyrtlePark,02/23/2015 08:00:00 PM,48,-122,5,3,8
10053,ElliotBayTrailMyrtlePark,02/23/2015 09:00:00 PM,48,-122,1,2,3
10054,ElliotBayTrailMyrtlePark,02/23/2015 10:00:00 PM,48,-122,2,1,3
10055,ElliotBayTrailMyrtlePark,02/23/2015 11:00:00 PM,48,-122,4,1,5
10056,ElliotBayTrailMyrtlePark,02/24/2015 12:00:00 AM,48,-122,0,0,0
10057,ElliotBayTrailMyrtlePark,02/24/2015 01:00:00 AM,48,-122,0,0,0
10058,ElliotBayTrailMyrtlePark,02/24/2015 02:00:00 AM,48,-122,1,0,1
10059,ElliotBayTrailMyrtlePark,02/24/2015 03:00:00 AM,48,-122,0,0,0
10060,ElliotBayTrailMyrtlePark,02/24/2015 04:00:00 AM,48,-122,0,1,1
10061,ElliotBayTrailMyrtlePark,02/24/2015 05:00:00 AM,48,-122,4,9,13
10062,ElliotBayTrailMyrtlePark,02/24/2015 06:00:00 AM,48,-122,14,25,39
10063,ElliotBayTrailMyrtlePark,02/24/2015 07:00:00 AM,48,-122,38,80,118
10064,ElliotBayTrailMyrtlePark,02/24/2015 08:00:00 AM,48,-122,41,132,173
10065,ElliotBayTrailMyrtlePark,02/24/2015 09:00:00 AM,48,-122,16,80,96
10066,ElliotBayTrailMyrtlePark,02/24/2015 10:00:00 AM,48,-122,11,22,33
10067,ElliotBayTrailMyrtlePark,02/24/2015 11:00:00 AM,48,-122,14,20,34
10068,ElliotBayTrailMyrtlePark,02/24/2015 12:00:00 PM,48,-122,14,20,34
10069,ElliotBayTrailMyrtlePark,02/24/2015 01:00:00 PM,48,-122,13,17,30
10070,ElliotBayTrailMyrtlePark,02/24/2015 02:00:00 PM,48,-122,33,23,56
10071,ElliotBayTrailMyrtlePark,02/24/2015 03:00:00 PM,48,-122,28,38,66
10072,ElliotBayTrailMyrtlePark,02/24/2015 04:00:00 PM,48,-122,73,44,117
10073,ElliotBayTrailMyrtlePark,02/24/2015 05:00:00 PM,48,-122,167,58,225
10074,ElliotBayTrailMyrtlePark,02/24/2015 06:00:00 PM,48,-122,89,37,126
10075,ElliotBayTrailMyrtlePark,02/24/2015 07:00:00 PM,48,-122,34,9,43
10076,ElliotBayTrailMyrtlePark,02/24/2015 08:00:00 PM,48,-122,8,2,10
10077,ElliotBayTrailMyrtlePark,02/24/2015 09:00:00 PM,48,-122,8,1,9
10078,ElliotBayTrailMyrtlePark,02/24/2015 10:00:00 PM,48,-122,7,2,9
10079,ElliotBayTrailMyrtlePark,02/24/2015 11:00:00 PM,48,-122,5,3,8
10080,ElliotBayTrailMyrtlePark,02/25/2015 12:00:00 AM,48,-122,1,0,1
10081,ElliotBayTrailMyrtlePark,02/25/2015 01:00:00 AM,48,-122,2,3,5
10082,ElliotBayTrailMyrtlePark,02/25/2015 02:00:00 AM,48,-122,2,0,2
10083,ElliotBayTrailMyrtlePark,02/25/2015 03:00:00 AM,48,-122,0,0,0
10084,ElliotBayTrailMyrtlePark,02/25/2015 04:00:00 AM,48,-122,2,0,2
10085,ElliotBayTrailMyrtlePark,02/25/2015 05:00:00 AM,48,-122,7,7,14
10086,ElliotBayTrailMyrtlePark,02/25/2015 06:00:00 AM,48,-122,19,27,46
10087,ElliotBayTrailMyrtlePark,02/25/2015 07:00:00 AM,48,-122,37,60,97
10088,ElliotBayTrailMyrtlePark,02/25/2015 08:00:00 AM,48,-122,35,108,143
10089,ElliotBayTrailMyrtlePark,02/25/2015 09:00:00 AM,48,-122,15,51,66
10090,ElliotBayTrailMyrtlePark,02/25/2015 10:00:00 AM,48,-122,6,19,25
10091,ElliotBayTrailMyrtlePark,02/25/2015 11:00:00 AM,48,-122,8,6,14
10092,ElliotBayTrailMyrtlePark,02/25/2015 12:00:00 PM,48,-122,11,10,21
10093,ElliotBayTrailMyrtlePark,02/25/2015 01:00:00 PM,48,-122,5,5,10
10094,ElliotBayTrailMyrtlePark,02/25/2015 02:00:00 PM,48,-122,10,10,20
10095,ElliotBayTrailMyrtlePark,02/25/2015 03:00:00 PM,48,-122,16,12,28
10096,ElliotBayTrailMyrtlePark,02/25/2015 04:00:00 PM,48,-122,49,28,77
10097,ElliotBayTrailMyrtlePark,02/25/2015 05:00:00 PM,48,-122,115,32,147
10098,ElliotBayTrailMyrtlePark,02/25/2015 06:00:00 PM,48,-122,67,16,83
10099,ElliotBayTrailMyrtlePark,02/25/2015 07:00:00 PM,48,-122,30,8,38
10100,ElliotBayTrailMyrtlePark,02/25/2015 08:00:00 PM,48,-122,16,2,18
10101,ElliotBayTrailMyrtlePark,02/25/2015 09:00:00 PM,48,-122,5,2,7
10102,ElliotBayTrailMyrtlePark,02/25/2015 10:00:00 PM,48,-122,6,3,9
10103,ElliotBayTrailMyrtlePark,02/25/2015 11:00:00 PM,48,-122,1,1,2
10104,ElliotBayTrailMyrtlePark,02/26/2015 12:00:00 AM,48,-122,0,1,1
10105,ElliotBayTrailMyrtlePark,02/26/2015 01:00:00 AM,48,-122,0,0,0
10106,ElliotBayTrailMyrtlePark,02/26/2015 02:00:00 AM,48,-122,2,0,2
10107,ElliotBayTrailMyrtlePark,02/26/2015 03:00:00 AM,48,-122,0,0,0
10108,ElliotBayTrailMyrtlePark,02/26/2015 04:00:00 AM,48,-122,0,0,0
10109,ElliotBayTrailMyrtlePark,02/26/2015 05:00:00 AM,48,-122,3,10,13
10110,ElliotBayTrailMyrtlePark,02/26/2015 06:00:00 AM,48,-122,14,19,33
10111,ElliotBayTrailMyrtlePark,02/26/2015 07:00:00 AM,48,-122,19,58,77
10112,ElliotBayTrailMyrtlePark,02/26/2015 08:00:00 AM,48,-122,25,90,115
10113,ElliotBayTrailMyrtlePark,02/26/2015 09:00:00 AM,48,-122,29,61,90
10114,ElliotBayTrailMyrtlePark,02/26/2015 10:00:00 AM,48,-122,5,10,15
10115,ElliotBayTrailMyrtlePark,02/26/2015 11:00:00 AM,48,-122,10,9,19
10116,ElliotBayTrailMyrtlePark,02/26/2015 12:00:00 PM,48,-122,3,9,12
10117,ElliotBayTrailMyrtlePark,02/26/2015 01:00:00 PM,48,-122,11,10,21
10118,ElliotBayTrailMyrtlePark,02/26/2015 02:00:00 PM,48,-122,13,14,27
10119,ElliotBayTrailMyrtlePark,02/26/2015 03:00:00 PM,48,-122,21,22,43
10120,ElliotBayTrailMyrtlePark,02/26/2015 04:00:00 PM,48,-122,43,27,70
10121,ElliotBayTrailMyrtlePark,02/26/2015 05:00:00 PM,48,-122,107,32,139
10122,ElliotBayTrailMyrtlePark,02/26/2015 06:00:00 PM,48,-122,65,20,85
10123,ElliotBayTrailMyrtlePark,02/26/2015 07:00:00 PM,48,-122,26,7,33
10124,ElliotBayTrailMyrtlePark,02/26/2015 08:00:00 PM,48,-122,7,5,12
10125,ElliotBayTrailMyrtlePark,02/26/2015 09:00:00 PM,48,-122,4,1,5
10126,ElliotBayTrailMyrtlePark,02/26/2015 10:00:00 PM,48,-122,6,4,10
10127,ElliotBayTrailMyrtlePark,02/26/2015 11:00:00 PM,48,-122,6,1,7
10128,ElliotBayTrailMyrtlePark,02/27/2015 12:00:00 AM,48,-122,0,0,0
10129,ElliotBayTrailMyrtlePark,02/27/2015 01:00:00 AM,48,-122,0,0,0
10130,ElliotBayTrailMyrtlePark,02/27/2015 02:00:00 AM,48,-122,1,0,1
10131,ElliotBayTrailMyrtlePark,02/27/2015 03:00:00 AM,48,-122,2,0,2
10132,ElliotBayTrailMyrtlePark,02/27/2015 04:00:00 AM,48,-122,0,0,0
10133,ElliotBayTrailMyrtlePark,02/27/2015 05:00:00 AM,48,-122,2,11,13
10134,ElliotBayTrailMyrtlePark,02/27/2015 06:00:00 AM,48,-122,10,15,25
10135,ElliotBayTrailMyrtlePark,02/27/2015 07:00:00 AM,48,-122,27,49,76
10136,ElliotBayTrailMyrtlePark,02/27/2015 08:00:00 AM,48,-122,28,82,110
10137,ElliotBayTrailMyrtlePark,02/27/2015 09:00:00 AM,48,-122,17,43,60
10138,ElliotBayTrailMyrtlePark,02/27/2015 10:00:00 AM,48,-122,2,14,16
10139,ElliotBayTrailMyrtlePark,02/27/2015 11:00:00 AM,48,-122,10,9,19
10140,ElliotBayTrailMyrtlePark,02/27/2015 12:00:00 PM,48,-122,2,7,9
10141,ElliotBayTrailMyrtlePark,02/27/2015 01:00:00 PM,48,-122,8,8,16
10142,ElliotBayTrailMyrtlePark,02/27/2015 02:00:00 PM,48,-122,13,13,26
10143,ElliotBayTrailMyrtlePark,02/27/2015 03:00:00 PM,48,-122,17,13,30
10144,ElliotBayTrailMyrtlePark,02/27/2015 04:00:00 PM,48,-122,45,19,64
10145,ElliotBayTrailMyrtlePark,02/27/2015 05:00:00 PM,48,-122,94,30,124
10146,ElliotBayTrailMyrtlePark,02/27/2015 06:00:00 PM,48,-122,42,13,55
10147,ElliotBayTrailMyrtlePark,02/27/2015 07:00:00 PM,48,-122,20,5,25
10148,ElliotBayTrailMyrtlePark,02/27/2015 08:00:00 PM,48,-122,3,1,4
10149,ElliotBayTrailMyrtlePark,02/27/2015 09:00:00 PM,48,-122,5,0,5
10150,ElliotBayTrailMyrtlePark,02/27/2015 10:00:00 PM,48,-122,5,0,5
10151,ElliotBayTrailMyrtlePark,02/27/2015 11:00:00 PM,48,-122,2,2,4
10152,ElliotBayTrailMyrtlePark,02/28/2015 12:00:00 AM,48,-122,4,1,5
10153,ElliotBayTrailMyrtlePark,02/28/2015 01:00:00 AM,48,-122,6,0,6
10154,ElliotBayTrailMyrtlePark,02/28/2015 02:00:00 AM,48,-122,1,0,1
10155,ElliotBayTrailMyrtlePark,02/28/2015 03:00:00 AM,48,-122,2,0,2
10156,ElliotBayTrailMyrtlePark,02/28/2015 04:00:00 AM,48,-122,1,0,1
10157,ElliotBayTrailMyrtlePark,02/28/2015 05:00:00 AM,48,-122,0,0,0
10158,ElliotBayTrailMyrtlePark,02/28/2015 06:00:00 AM,48,-122,1,2,3
10159,ElliotBayTrailMyrtlePark,02/28/2015 07:00:00 AM,48,-122,5,8,13
10160,ElliotBayTrailMyrtlePark,02/28/2015 08:00:00 AM,48,-122,6,17,23
10161,ElliotBayTrailMyrtlePark,02/28/2015 09:00:00 AM,48,-122,27,34,61
10162,ElliotBayTrailMyrtlePark,02/28/2015 10:00:00 AM,48,-122,21,39,60
10163,ElliotBayTrailMyrtlePark,02/28/2015 11:00:00 AM,48,-122,42,50,92
10164,ElliotBayTrailMyrtlePark,02/28/2015 12:00:00 PM,48,-122,85,65,150
10165,ElliotBayTrailMyrtlePark,02/28/2015 01:00:00 PM,48,-122,56,56,112
10166,ElliotBayTrailMyrtlePark,02/28/2015 02:00:00 PM,48,-122,76,83,159
10167,ElliotBayTrailMyrtlePark,02/28/2015 03:00:00 PM,48,-122,99,58,157
10168,ElliotBayTrailMyrtlePark,02/28/2015 04:00:00 PM,48,-122,63,61,124
10169,ElliotBayTrailMyrtlePark,02/28/2015 05:00:00 PM,48,-122,49,63,112
10170,ElliotBayTrailMyrtlePark,02/28/2015 06:00:00 PM,48,-122,26,24,50
10171,ElliotBayTrailMyrtlePark,02/28/2015 07:00:00 PM,48,-122,7,2,9
10172,ElliotBayTrailMyrtlePark,02/28/2015 08:00:00 PM,48,-122,1,1,2
10173,ElliotBayTrailMyrtlePark,02/28/2015 09:00:00 PM,48,-122,7,4,11
10174,ElliotBayTrailMyrtlePark,02/28/2015 10:00:00 PM,48,-122,5,7,12
10175,ElliotBayTrailMyrtlePark,02/28/2015 11:00:00 PM,48,-122,4,0,4
10176,ElliotBayTrailMyrtlePark,03/01/2015 12:00:00 AM,48,-122,7,1,8
10177,ElliotBayTrailMyrtlePark,03/01/2015 01:00:00 AM,48,-122,0,0,0
10178,ElliotBayTrailMyrtlePark,03/01/2015 02:00:00 AM,48,-122,0,0,0
10179,ElliotBayTrailMyrtlePark,03/01/2015 03:00:00 AM,48,-122,2,0,2
10180,ElliotBayTrailMyrtlePark,03/01/2015 04:00:00 AM,48,-122,0,0,0
10181,ElliotBayTrailMyrtlePark,03/01/2015 05:00:00 AM,48,-122,2,1,3
10182,ElliotBayTrailMyrtlePark,03/01/2015 06:00:00 AM,48,-122,0,2,2
10183,ElliotBayTrailMyrtlePark,03/01/2015 07:00:00 AM,48,-122,1,3,4
10184,ElliotBayTrailMyrtlePark,03/01/2015 08:00:00 AM,48,-122,10,18,28
10185,ElliotBayTrailMyrtlePark,03/01/2015 09:00:00 AM,48,-122,26,28,54
10186,ElliotBayTrailMyrtlePark,03/01/2015 10:00:00 AM,48,-122,41,52,93
10187,ElliotBayTrailMyrtlePark,03/01/2015 11:00:00 AM,48,-122,34,61,95
10188,ElliotBayTrailMyrtlePark,03/01/2015 12:00:00 PM,48,-122,0,0,0
10189,ElliotBayTrailMyrtlePark,03/01/2015 01:00:00 PM,48,-122,0,0,0
10190,ElliotBayTrailMyrtlePark,03/01/2015 02:00:00 PM,48,-122,0,0,0
10191,ElliotBayTrailMyrtlePark,03/01/2015 03:00:00 PM,48,-122,0,0,0
10192,ElliotBayTrailMyrtlePark,03/01/2015 04:00:00 PM,48,-122,0,0,0
10193,ElliotBayTrailMyrtlePark,03/01/2015 05:00:00 PM,48,-122,0,0,0
10194,ElliotBayTrailMyrtlePark,03/01/2015 06:00:00 PM,48,-122,0,0,0
10195,ElliotBayTrailMyrtlePark,03/01/2015 07:00:00 PM,48,-122,0,0,0
10196,ElliotBayTrailMyrtlePark,03/01/2015 08:00:00 PM,48,-122,0,0,0
10197,ElliotBayTrailMyrtlePark,03/01/2015 09:00:00 PM,48,-122,0,0,0
10198,ElliotBayTrailMyrtlePark,03/01/2015 10:00:00 PM,48,-122,0,0,0
10199,ElliotBayTrailMyrtlePark,03/01/2015 11:00:00 PM,48,-122,0,0,0
10200,ElliotBayTrailMyrtlePark,03/02/2015 12:00:00 AM,48,-122,0,0,0
10201,ElliotBayTrailMyrtlePark,03/02/2015 01:00:00 AM,48,-122,0,0,0
10202,ElliotBayTrailMyrtlePark,03/02/2015 02:00:00 AM,48,-122,0,0,0
10203,ElliotBayTrailMyrtlePark,03/02/2015 03:00:00 AM,48,-122,0,0,0
10204,ElliotBayTrailMyrtlePark,03/02/2015 04:00:00 AM,48,-122,0,0,0
10205,ElliotBayTrailMyrtlePark,03/02/2015 05:00:00 AM,48,-122,0,0,0
10206,ElliotBayTrailMyrtlePark,03/02/2015 06:00:00 AM,48,-122,0,0,0
10207,ElliotBayTrailMyrtlePark,03/02/2015 07:00:00 AM,48,-122,0,0,0
10208,ElliotBayTrailMyrtlePark,03/02/2015 08:00:00 AM,48,-122,0,0,0
10209,ElliotBayTrailMyrtlePark,03/02/2015 09:00:00 AM,48,-122,0,0,0
10210,ElliotBayTrailMyrtlePark,03/02/2015 10:00:00 AM,48,-122,0,0,0
10211,ElliotBayTrailMyrtlePark,03/02/2015 11:00:00 AM,48,-122,0,0,0
10212,ElliotBayTrailMyrtlePark,03/02/2015 12:00:00 PM,48,-122,0,0,0
10213,ElliotBayTrailMyrtlePark,03/02/2015 01:00:00 PM,48,-122,0,0,0
10214,ElliotBayTrailMyrtlePark,03/02/2015 02:00:00 PM,48,-122,0,0,0
10215,ElliotBayTrailMyrtlePark,03/02/2015 03:00:00 PM,48,-122,0,0,0
10216,ElliotBayTrailMyrtlePark,03/02/2015 04:00:00 PM,48,-122,0,0,0
10217,ElliotBayTrailMyrtlePark,03/02/2015 05:00:00 PM,48,-122,0,0,0
10218,ElliotBayTrailMyrtlePark,03/02/2015 06:00:00 PM,48,-122,0,0,0
10219,ElliotBayTrailMyrtlePark,03/02/2015 07:00:00 PM,48,-122,0,0,0
10220,ElliotBayTrailMyrtlePark,03/02/2015 08:00:00 PM,48,-122,0,0,0
10221,ElliotBayTrailMyrtlePark,03/02/2015 09:00:00 PM,48,-122,0,0,0
10222,ElliotBayTrailMyrtlePark,03/02/2015 10:00:00 PM,48,-122,0,0,0
10223,ElliotBayTrailMyrtlePark,03/02/2015 11:00:00 PM,48,-122,0,0,0
10224,ElliotBayTrailMyrtlePark,03/03/2015 12:00:00 AM,48,-122,0,0,0
10225,ElliotBayTrailMyrtlePark,03/03/2015 01:00:00 AM,48,-122,0,0,0
10226,ElliotBayTrailMyrtlePark,03/03/2015 02:00:00 AM,48,-122,0,0,0
10227,ElliotBayTrailMyrtlePark,03/03/2015 03:00:00 AM,48,-122,0,0,0
10228,ElliotBayTrailMyrtlePark,03/03/2015 04:00:00 AM,48,-122,0,0,0
10229,ElliotBayTrailMyrtlePark,03/03/2015 05:00:00 AM,48,-122,0,0,0
10230,ElliotBayTrailMyrtlePark,03/03/2015 06:00:00 AM,48,-122,0,0,0
10231,ElliotBayTrailMyrtlePark,03/03/2015 07:00:00 AM,48,-122,0,0,0
10232,ElliotBayTrailMyrtlePark,03/03/2015 08:00:00 AM,48,-122,0,0,0
10233,ElliotBayTrailMyrtlePark,03/03/2015 09:00:00 AM,48,-122,0,0,0
10234,ElliotBayTrailMyrtlePark,03/03/2015 10:00:00 AM,48,-122,0,0,0
10235,ElliotBayTrailMyrtlePark,03/03/2015 11:00:00 AM,48,-122,0,0,0
10236,ElliotBayTrailMyrtlePark,03/03/2015 12:00:00 PM,48,-122,0,0,0
10237,ElliotBayTrailMyrtlePark,03/03/2015 01:00:00 PM,48,-122,0,0,0
10238,ElliotBayTrailMyrtlePark,03/03/2015 02:00:00 PM,48,-122,0,0,0
10239,ElliotBayTrailMyrtlePark,03/03/2015 03:00:00 PM,48,-122,0,0,0
10240,ElliotBayTrailMyrtlePark,03/03/2015 04:00:00 PM,48,-122,0,0,0
10241,ElliotBayTrailMyrtlePark,03/03/2015 05:00:00 PM,48,-122,0,0,0
10242,ElliotBayTrailMyrtlePark,03/03/2015 06:00:00 PM,48,-122,0,0,0
10243,ElliotBayTrailMyrtlePark,03/03/2015 07:00:00 PM,48,-122,0,0,0
10244,ElliotBayTrailMyrtlePark,03/03/2015 08:00:00 PM,48,-122,0,0,0
10245,ElliotBayTrailMyrtlePark,03/03/2015 09:00:00 PM,48,-122,0,0,0
10246,ElliotBayTrailMyrtlePark,03/03/2015 10:00:00 PM,48,-122,0,0,0
10247,ElliotBayTrailMyrtlePark,03/03/2015 11:00:00 PM,48,-122,0,0,0
10248,ElliotBayTrailMyrtlePark,03/04/2015 12:00:00 AM,48,-122,0,0,0
10249,ElliotBayTrailMyrtlePark,03/04/2015 01:00:00 AM,48,-122,0,0,0
10250,ElliotBayTrailMyrtlePark,03/04/2015 02:00:00 AM,48,-122,0,0,0
10251,ElliotBayTrailMyrtlePark,03/04/2015 03:00:00 AM,48,-122,0,0,0
10252,ElliotBayTrailMyrtlePark,03/04/2015 04:00:00 AM,48,-122,0,0,0
10253,ElliotBayTrailMyrtlePark,03/04/2015 05:00:00 AM,48,-122,0,0,0
10254,ElliotBayTrailMyrtlePark,03/04/2015 06:00:00 AM,48,-122,0,0,0
10255,ElliotBayTrailMyrtlePark,03/04/2015 07:00:00 AM,48,-122,0,0,0
10256,ElliotBayTrailMyrtlePark,03/04/2015 08:00:00 AM,48,-122,0,0,0
10257,ElliotBayTrailMyrtlePark,03/04/2015 09:00:00 AM,48,-122,0,0,0
10258,ElliotBayTrailMyrtlePark,03/04/2015 10:00:00 AM,48,-122,0,0,0
10259,ElliotBayTrailMyrtlePark,03/04/2015 11:00:00 AM,48,-122,0,0,0
10260,ElliotBayTrailMyrtlePark,03/04/2015 12:00:00 PM,48,-122,0,0,0
10261,ElliotBayTrailMyrtlePark,03/04/2015 01:00:00 PM,48,-122,0,0,0
10262,ElliotBayTrailMyrtlePark,03/04/2015 02:00:00 PM,48,-122,0,0,0
10263,ElliotBayTrailMyrtlePark,03/04/2015 03:00:00 PM,48,-122,0,0,0
10264,ElliotBayTrailMyrtlePark,03/04/2015 04:00:00 PM,48,-122,0,0,0
10265,ElliotBayTrailMyrtlePark,03/04/2015 05:00:00 PM,48,-122,0,0,0
10266,ElliotBayTrailMyrtlePark,03/04/2015 06:00:00 PM,48,-122,0,0,0
10267,ElliotBayTrailMyrtlePark,03/04/2015 07:00:00 PM,48,-122,0,0,0
10268,ElliotBayTrailMyrtlePark,03/04/2015 08:00:00 PM,48,-122,0,0,0
10269,ElliotBayTrailMyrtlePark,03/04/2015 09:00:00 PM,48,-122,0,0,0
10270,ElliotBayTrailMyrtlePark,03/04/2015 10:00:00 PM,48,-122,0,0,0
10271,ElliotBayTrailMyrtlePark,03/04/2015 11:00:00 PM,48,-122,0,0,0
10272,ElliotBayTrailMyrtlePark,03/05/2015 12:00:00 AM,48,-122,0,0,0
10273,ElliotBayTrailMyrtlePark,03/05/2015 01:00:00 AM,48,-122,0,0,0
10274,ElliotBayTrailMyrtlePark,03/05/2015 02:00:00 AM,48,-122,0,0,0
10275,ElliotBayTrailMyrtlePark,03/05/2015 03:00:00 AM,48,-122,0,0,0
10276,ElliotBayTrailMyrtlePark,03/05/2015 04:00:00 AM,48,-122,0,0,0
10277,ElliotBayTrailMyrtlePark,03/05/2015 05:00:00 AM,48,-122,0,0,0
10278,ElliotBayTrailMyrtlePark,03/05/2015 06:00:00 AM,48,-122,0,0,0
10279,ElliotBayTrailMyrtlePark,03/05/2015 07:00:00 AM,48,-122,0,0,0
10280,ElliotBayTrailMyrtlePark,03/05/2015 08:00:00 AM,48,-122,0,0,0
10281,ElliotBayTrailMyrtlePark,03/05/2015 09:00:00 AM,48,-122,0,0,0
10282,ElliotBayTrailMyrtlePark,03/05/2015 10:00:00 AM,48,-122,0,0,0
10283,ElliotBayTrailMyrtlePark,03/05/2015 11:00:00 AM,48,-122,0,0,0
10284,ElliotBayTrailMyrtlePark,03/05/2015 12:00:00 PM,48,-122,0,0,0
10285,ElliotBayTrailMyrtlePark,03/05/2015 01:00:00 PM,48,-122,0,0,0
10286,ElliotBayTrailMyrtlePark,03/05/2015 02:00:00 PM,48,-122,0,0,0
10287,ElliotBayTrailMyrtlePark,03/05/2015 03:00:00 PM,48,-122,0,0,0
10288,ElliotBayTrailMyrtlePark,03/05/2015 04:00:00 PM,48,-122,0,0,0
10289,ElliotBayTrailMyrtlePark,03/05/2015 05:00:00 PM,48,-122,0,0,0
10290,ElliotBayTrailMyrtlePark,03/05/2015 06:00:00 PM,48,-122,0,0,0
10291,ElliotBayTrailMyrtlePark,03/05/2015 07:00:00 PM,48,-122,0,0,0
10292,ElliotBayTrailMyrtlePark,03/05/2015 08:00:00 PM,48,-122,0,0,0
10293,ElliotBayTrailMyrtlePark,03/05/2015 09:00:00 PM,48,-122,0,0,0
10294,ElliotBayTrailMyrtlePark,03/05/2015 10:00:00 PM,48,-122,0,0,0
10295,ElliotBayTrailMyrtlePark,03/05/2015 11:00:00 PM,48,-122,0,0,0
10296,ElliotBayTrailMyrtlePark,03/06/2015 12:00:00 AM,48,-122,0,0,0
10297,ElliotBayTrailMyrtlePark,03/06/2015 01:00:00 AM,48,-122,0,0,0
10298,ElliotBayTrailMyrtlePark,03/06/2015 02:00:00 AM,48,-122,0,0,0
10299,ElliotBayTrailMyrtlePark,03/06/2015 03:00:00 AM,48,-122,0,0,0
10300,ElliotBayTrailMyrtlePark,03/06/2015 04:00:00 AM,48,-122,0,0,0
10301,ElliotBayTrailMyrtlePark,03/06/2015 05:00:00 AM,48,-122,0,0,0
10302,ElliotBayTrailMyrtlePark,03/06/2015 06:00:00 AM,48,-122,0,0,0
10303,ElliotBayTrailMyrtlePark,03/06/2015 07:00:00 AM,48,-122,0,0,0
10304,ElliotBayTrailMyrtlePark,03/06/2015 08:00:00 AM,48,-122,0,0,0
10305,ElliotBayTrailMyrtlePark,03/06/2015 09:00:00 AM,48,-122,0,0,0
10306,ElliotBayTrailMyrtlePark,03/06/2015 10:00:00 AM,48,-122,0,0,0
10307,ElliotBayTrailMyrtlePark,03/06/2015 11:00:00 AM,48,-122,0,0,0
10308,ElliotBayTrailMyrtlePark,03/06/2015 12:00:00 PM,48,-122,0,0,0
10309,ElliotBayTrailMyrtlePark,03/06/2015 01:00:00 PM,48,-122,0,0,0
10310,ElliotBayTrailMyrtlePark,03/06/2015 02:00:00 PM,48,-122,0,0,0
10311,ElliotBayTrailMyrtlePark,03/06/2015 03:00:00 PM,48,-122,0,0,0
10312,ElliotBayTrailMyrtlePark,03/06/2015 04:00:00 PM,48,-122,0,0,0
10313,ElliotBayTrailMyrtlePark,03/06/2015 05:00:00 PM,48,-122,0,0,0
10314,ElliotBayTrailMyrtlePark,03/06/2015 06:00:00 PM,48,-122,0,0,0
10315,ElliotBayTrailMyrtlePark,03/06/2015 07:00:00 PM,48,-122,0,0,0
10316,ElliotBayTrailMyrtlePark,03/06/2015 08:00:00 PM,48,-122,0,0,0
10317,ElliotBayTrailMyrtlePark,03/06/2015 09:00:00 PM,48,-122,0,0,0
10318,ElliotBayTrailMyrtlePark,03/06/2015 10:00:00 PM,48,-122,0,0,0
10319,ElliotBayTrailMyrtlePark,03/06/2015 11:00:00 PM,48,-122,0,0,0
10320,ElliotBayTrailMyrtlePark,03/07/2015 12:00:00 AM,48,-122,0,0,0
10321,ElliotBayTrailMyrtlePark,03/07/2015 01:00:00 AM,48,-122,0,0,0
10322,ElliotBayTrailMyrtlePark,03/07/2015 02:00:00 AM,48,-122,0,0,0
10323,ElliotBayTrailMyrtlePark,03/07/2015 03:00:00 AM,48,-122,0,0,0
10324,ElliotBayTrailMyrtlePark,03/07/2015 04:00:00 AM,48,-122,0,0,0
10325,ElliotBayTrailMyrtlePark,03/07/2015 05:00:00 AM,48,-122,0,0,0
10326,ElliotBayTrailMyrtlePark,03/07/2015 06:00:00 AM,48,-122,0,0,0
10327,ElliotBayTrailMyrtlePark,03/07/2015 07:00:00 AM,48,-122,0,0,0
10328,ElliotBayTrailMyrtlePark,03/07/2015 08:00:00 AM,48,-122,0,0,0
10329,ElliotBayTrailMyrtlePark,03/07/2015 09:00:00 AM,48,-122,0,0,0
10330,ElliotBayTrailMyrtlePark,03/07/2015 10:00:00 AM,48,-122,0,0,0
10331,ElliotBayTrailMyrtlePark,03/07/2015 11:00:00 AM,48,-122,0,0,0
10332,ElliotBayTrailMyrtlePark,03/07/2015 12:00:00 PM,48,-122,0,0,0
10333,ElliotBayTrailMyrtlePark,03/07/2015 01:00:00 PM,48,-122,0,0,0
10334,ElliotBayTrailMyrtlePark,03/07/2015 02:00:00 PM,48,-122,0,0,0
10335,ElliotBayTrailMyrtlePark,03/07/2015 03:00:00 PM,48,-122,0,0,0
10336,ElliotBayTrailMyrtlePark,03/07/2015 04:00:00 PM,48,-122,0,0,0
10337,ElliotBayTrailMyrtlePark,03/07/2015 05:00:00 PM,48,-122,0,0,0
10338,ElliotBayTrailMyrtlePark,03/07/2015 06:00:00 PM,48,-122,0,0,0
10339,ElliotBayTrailMyrtlePark,03/07/2015 07:00:00 PM,48,-122,0,0,0
10340,ElliotBayTrailMyrtlePark,03/07/2015 08:00:00 PM,48,-122,0,0,0
10341,ElliotBayTrailMyrtlePark,03/07/2015 09:00:00 PM,48,-122,0,0,0
10342,ElliotBayTrailMyrtlePark,03/07/2015 10:00:00 PM,48,-122,0,0,0
10343,ElliotBayTrailMyrtlePark,03/07/2015 11:00:00 PM,48,-122,0,0,0
10344,ElliotBayTrailMyrtlePark,03/08/2015 12:00:00 AM,48,-122,0,0,0
10345,ElliotBayTrailMyrtlePark,03/08/2015 01:00:00 AM,48,-122,0,0,0
10346,ElliotBayTrailMyrtlePark,03/08/2015 02:00:00 AM,48,-122,,,
10347,ElliotBayTrailMyrtlePark,03/08/2015 03:00:00 AM,48,-122,0,0,0
10348,ElliotBayTrailMyrtlePark,03/08/2015 04:00:00 AM,48,-122,0,0,0
10349,ElliotBayTrailMyrtlePark,03/08/2015 05:00:00 AM,48,-122,0,0,0
10350,ElliotBayTrailMyrtlePark,03/08/2015 06:00:00 AM,48,-122,0,0,0
10351,ElliotBayTrailMyrtlePark,03/08/2015 07:00:00 AM,48,-122,0,0,0
10352,ElliotBayTrailMyrtlePark,03/08/2015 08:00:00 AM,48,-122,0,0,0
10353,ElliotBayTrailMyrtlePark,03/08/2015 09:00:00 AM,48,-122,0,0,0
10354,ElliotBayTrailMyrtlePark,03/08/2015 10:00:00 AM,48,-122,0,0,0
10355,ElliotBayTrailMyrtlePark,03/08/2015 11:00:00 AM,48,-122,0,0,0
10356,ElliotBayTrailMyrtlePark,03/08/2015 12:00:00 PM,48,-122,0,0,0
10357,ElliotBayTrailMyrtlePark,03/08/2015 01:00:00 PM,48,-122,0,0,0
10358,ElliotBayTrailMyrtlePark,03/08/2015 02:00:00 PM,48,-122,0,0,0
10359,ElliotBayTrailMyrtlePark,03/08/2015 03:00:00 PM,48,-122,0,0,0
10360,ElliotBayTrailMyrtlePark,03/08/2015 04:00:00 PM,48,-122,0,0,0
10361,ElliotBayTrailMyrtlePark,03/08/2015 05:00:00 PM,48,-122,0,0,0
10362,ElliotBayTrailMyrtlePark,03/08/2015 06:00:00 PM,48,-122,0,0,0
10363,ElliotBayTrailMyrtlePark,03/08/2015 07:00:00 PM,48,-122,0,0,0
10364,ElliotBayTrailMyrtlePark,03/08/2015 08:00:00 PM,48,-122,0,0,0
10365,ElliotBayTrailMyrtlePark,03/08/2015 09:00:00 PM,48,-122,0,0,0
10366,ElliotBayTrailMyrtlePark,03/08/2015 10:00:00 PM,48,-122,0,0,0
10367,ElliotBayTrailMyrtlePark,03/08/2015 11:00:00 PM,48,-122,0,0,0
10368,ElliotBayTrailMyrtlePark,03/09/2015 12:00:00 AM,48,-122,0,0,0
10369,ElliotBayTrailMyrtlePark,03/09/2015 01:00:00 AM,48,-122,0,0,0
10370,ElliotBayTrailMyrtlePark,03/09/2015 02:00:00 AM,48,-122,0,0,0
10371,ElliotBayTrailMyrtlePark,03/09/2015 03:00:00 AM,48,-122,0,0,0
10372,ElliotBayTrailMyrtlePark,03/09/2015 04:00:00 AM,48,-122,0,0,0
10373,ElliotBayTrailMyrtlePark,03/09/2015 05:00:00 AM,48,-122,0,0,0
10374,ElliotBayTrailMyrtlePark,03/09/2015 06:00:00 AM,48,-122,0,0,0
10375,ElliotBayTrailMyrtlePark,03/09/2015 07:00:00 AM,48,-122,0,0,0
10376,ElliotBayTrailMyrtlePark,03/09/2015 08:00:00 AM,48,-122,0,0,0
10377,ElliotBayTrailMyrtlePark,03/09/2015 09:00:00 AM,48,-122,0,0,0
10378,ElliotBayTrailMyrtlePark,03/09/2015 10:00:00 AM,48,-122,0,0,0
10379,ElliotBayTrailMyrtlePark,03/09/2015 11:00:00 AM,48,-122,0,0,0
10380,ElliotBayTrailMyrtlePark,03/09/2015 12:00:00 PM,48,-122,0,0,0
10381,ElliotBayTrailMyrtlePark,03/09/2015 01:00:00 PM,48,-122,0,0,0
10382,ElliotBayTrailMyrtlePark,03/09/2015 02:00:00 PM,48,-122,0,0,0
10383,ElliotBayTrailMyrtlePark,03/09/2015 03:00:00 PM,48,-122,0,0,0
10384,ElliotBayTrailMyrtlePark,03/09/2015 04:00:00 PM,48,-122,0,0,0
10385,ElliotBayTrailMyrtlePark,03/09/2015 05:00:00 PM,48,-122,0,0,0
10386,ElliotBayTrailMyrtlePark,03/09/2015 06:00:00 PM,48,-122,0,0,0
10387,ElliotBayTrailMyrtlePark,03/09/2015 07:00:00 PM,48,-122,0,0,0
10388,ElliotBayTrailMyrtlePark,03/09/2015 08:00:00 PM,48,-122,0,0,0
10389,ElliotBayTrailMyrtlePark,03/09/2015 09:00:00 PM,48,-122,0,0,0
10390,ElliotBayTrailMyrtlePark,03/09/2015 10:00:00 PM,48,-122,0,0,0
10391,ElliotBayTrailMyrtlePark,03/09/2015 11:00:00 PM,48,-122,0,0,0
10392,ElliotBayTrailMyrtlePark,03/10/2015 12:00:00 AM,48,-122,0,0,0
10393,ElliotBayTrailMyrtlePark,03/10/2015 01:00:00 AM,48,-122,0,0,0
10394,ElliotBayTrailMyrtlePark,03/10/2015 02:00:00 AM,48,-122,0,0,0
10395,ElliotBayTrailMyrtlePark,03/10/2015 03:00:00 AM,48,-122,0,0,0
10396,ElliotBayTrailMyrtlePark,03/10/2015 04:00:00 AM,48,-122,0,0,0
10397,ElliotBayTrailMyrtlePark,03/10/2015 05:00:00 AM,48,-122,0,0,0
10398,ElliotBayTrailMyrtlePark,03/10/2015 06:00:00 AM,48,-122,0,0,0
10399,ElliotBayTrailMyrtlePark,03/10/2015 07:00:00 AM,48,-122,0,0,0
10400,ElliotBayTrailMyrtlePark,03/10/2015 08:00:00 AM,48,-122,0,0,0
10401,ElliotBayTrailMyrtlePark,03/10/2015 09:00:00 AM,48,-122,0,0,0
10402,ElliotBayTrailMyrtlePark,03/10/2015 10:00:00 AM,48,-122,0,0,0
10403,ElliotBayTrailMyrtlePark,03/10/2015 11:00:00 AM,48,-122,0,0,0
10404,ElliotBayTrailMyrtlePark,03/10/2015 12:00:00 PM,48,-122,0,0,0
10405,ElliotBayTrailMyrtlePark,03/10/2015 01:00:00 PM,48,-122,0,0,0
10406,ElliotBayTrailMyrtlePark,03/10/2015 02:00:00 PM,48,-122,0,0,0
10407,ElliotBayTrailMyrtlePark,03/10/2015 03:00:00 PM,48,-122,0,0,0
10408,ElliotBayTrailMyrtlePark,03/10/2015 04:00:00 PM,48,-122,0,0,0
10409,ElliotBayTrailMyrtlePark,03/10/2015 05:00:00 PM,48,-122,0,0,0
10410,ElliotBayTrailMyrtlePark,03/10/2015 06:00:00 PM,48,-122,0,0,0
10411,ElliotBayTrailMyrtlePark,03/10/2015 07:00:00 PM,48,-122,0,0,0
10412,ElliotBayTrailMyrtlePark,03/10/2015 08:00:00 PM,48,-122,0,0,0
10413,ElliotBayTrailMyrtlePark,03/10/2015 09:00:00 PM,48,-122,0,0,0
10414,ElliotBayTrailMyrtlePark,03/10/2015 10:00:00 PM,48,-122,0,0,0
10415,ElliotBayTrailMyrtlePark,03/10/2015 11:00:00 PM,48,-122,0,0,0
10416,ElliotBayTrailMyrtlePark,03/11/2015 12:00:00 AM,48,-122,0,0,0
10417,ElliotBayTrailMyrtlePark,03/11/2015 01:00:00 AM,48,-122,0,0,0
10418,ElliotBayTrailMyrtlePark,03/11/2015 02:00:00 AM,48,-122,0,0,0
10419,ElliotBayTrailMyrtlePark,03/11/2015 03:00:00 AM,48,-122,0,0,0
10420,ElliotBayTrailMyrtlePark,03/11/2015 04:00:00 AM,48,-122,0,0,0
10421,ElliotBayTrailMyrtlePark,03/11/2015 05:00:00 AM,48,-122,0,0,0
10422,ElliotBayTrailMyrtlePark,03/11/2015 06:00:00 AM,48,-122,0,0,0
10423,ElliotBayTrailMyrtlePark,03/11/2015 07:00:00 AM,48,-122,0,0,0
10424,ElliotBayTrailMyrtlePark,03/11/2015 08:00:00 AM,48,-122,0,0,0
10425,ElliotBayTrailMyrtlePark,03/11/2015 09:00:00 AM,48,-122,0,0,0
10426,ElliotBayTrailMyrtlePark,03/11/2015 10:00:00 AM,48,-122,0,0,0
10427,ElliotBayTrailMyrtlePark,03/11/2015 11:00:00 AM,48,-122,0,0,0
10428,ElliotBayTrailMyrtlePark,03/11/2015 12:00:00 PM,48,-122,0,0,0
10429,ElliotBayTrailMyrtlePark,03/11/2015 01:00:00 PM,48,-122,0,0,0
10430,ElliotBayTrailMyrtlePark,03/11/2015 02:00:00 PM,48,-122,0,0,0
10431,ElliotBayTrailMyrtlePark,03/11/2015 03:00:00 PM,48,-122,0,0,0
10432,ElliotBayTrailMyrtlePark,03/11/2015 04:00:00 PM,48,-122,0,0,0
10433,ElliotBayTrailMyrtlePark,03/11/2015 05:00:00 PM,48,-122,0,0,0
10434,ElliotBayTrailMyrtlePark,03/11/2015 06:00:00 PM,48,-122,0,0,0
10435,ElliotBayTrailMyrtlePark,03/11/2015 07:00:00 PM,48,-122,0,0,0
10436,ElliotBayTrailMyrtlePark,03/11/2015 08:00:00 PM,48,-122,0,0,0
10437,ElliotBayTrailMyrtlePark,03/11/2015 09:00:00 PM,48,-122,0,0,0
10438,ElliotBayTrailMyrtlePark,03/11/2015 10:00:00 PM,48,-122,0,0,0
10439,ElliotBayTrailMyrtlePark,03/11/2015 11:00:00 PM,48,-122,0,0,0
10440,ElliotBayTrailMyrtlePark,03/12/2015 12:00:00 AM,48,-122,0,0,0
10441,ElliotBayTrailMyrtlePark,03/12/2015 01:00:00 AM,48,-122,0,0,0
10442,ElliotBayTrailMyrtlePark,03/12/2015 02:00:00 AM,48,-122,0,0,0
10443,ElliotBayTrailMyrtlePark,03/12/2015 03:00:00 AM,48,-122,0,0,0
10444,ElliotBayTrailMyrtlePark,03/12/2015 04:00:00 AM,48,-122,0,0,0
10445,ElliotBayTrailMyrtlePark,03/12/2015 05:00:00 AM,48,-122,0,0,0
10446,ElliotBayTrailMyrtlePark,03/12/2015 06:00:00 AM,48,-122,0,0,0
10447,ElliotBayTrailMyrtlePark,03/12/2015 07:00:00 AM,48,-122,0,0,0
10448,ElliotBayTrailMyrtlePark,03/12/2015 08:00:00 AM,48,-122,0,0,0
10449,ElliotBayTrailMyrtlePark,03/12/2015 09:00:00 AM,48,-122,0,0,0
10450,ElliotBayTrailMyrtlePark,03/12/2015 10:00:00 AM,48,-122,0,0,0
10451,ElliotBayTrailMyrtlePark,03/12/2015 11:00:00 AM,48,-122,0,0,0
10452,ElliotBayTrailMyrtlePark,03/12/2015 12:00:00 PM,48,-122,0,0,0
10453,ElliotBayTrailMyrtlePark,03/12/2015 01:00:00 PM,48,-122,0,0,0
10454,ElliotBayTrailMyrtlePark,03/12/2015 02:00:00 PM,48,-122,0,0,0
10455,ElliotBayTrailMyrtlePark,03/12/2015 03:00:00 PM,48,-122,0,0,0
10456,ElliotBayTrailMyrtlePark,03/12/2015 04:00:00 PM,48,-122,0,0,0
10457,ElliotBayTrailMyrtlePark,03/12/2015 05:00:00 PM,48,-122,0,0,0
10458,ElliotBayTrailMyrtlePark,03/12/2015 06:00:00 PM,48,-122,0,0,0
10459,ElliotBayTrailMyrtlePark,03/12/2015 07:00:00 PM,48,-122,0,0,0
10460,ElliotBayTrailMyrtlePark,03/12/2015 08:00:00 PM,48,-122,0,0,0
10461,ElliotBayTrailMyrtlePark,03/12/2015 09:00:00 PM,48,-122,0,0,0
10462,ElliotBayTrailMyrtlePark,03/12/2015 10:00:00 PM,48,-122,0,0,0
10463,ElliotBayTrailMyrtlePark,03/12/2015 11:00:00 PM,48,-122,0,0,0
10464,ElliotBayTrailMyrtlePark,03/13/2015 12:00:00 AM,48,-122,0,0,0
10465,ElliotBayTrailMyrtlePark,03/13/2015 01:00:00 AM,48,-122,0,0,0
10466,ElliotBayTrailMyrtlePark,03/13/2015 02:00:00 AM,48,-122,0,0,0
10467,ElliotBayTrailMyrtlePark,03/13/2015 03:00:00 AM,48,-122,0,0,0
10468,ElliotBayTrailMyrtlePark,03/13/2015 04:00:00 AM,48,-122,0,0,0
10469,ElliotBayTrailMyrtlePark,03/13/2015 05:00:00 AM,48,-122,0,0,0
10470,ElliotBayTrailMyrtlePark,03/13/2015 06:00:00 AM,48,-122,0,0,0
10471,ElliotBayTrailMyrtlePark,03/13/2015 07:00:00 AM,48,-122,0,0,0
10472,ElliotBayTrailMyrtlePark,03/13/2015 08:00:00 AM,48,-122,0,0,0
10473,ElliotBayTrailMyrtlePark,03/13/2015 09:00:00 AM,48,-122,0,0,0
10474,ElliotBayTrailMyrtlePark,03/13/2015 10:00:00 AM,48,-122,0,0,0
10475,ElliotBayTrailMyrtlePark,03/13/2015 11:00:00 AM,48,-122,0,0,0
10476,ElliotBayTrailMyrtlePark,03/13/2015 12:00:00 PM,48,-122,0,0,0
10477,ElliotBayTrailMyrtlePark,03/13/2015 01:00:00 PM,48,-122,0,0,0
10478,ElliotBayTrailMyrtlePark,03/13/2015 02:00:00 PM,48,-122,0,0,0
10479,ElliotBayTrailMyrtlePark,03/13/2015 03:00:00 PM,48,-122,0,0,0
10480,ElliotBayTrailMyrtlePark,03/13/2015 04:00:00 PM,48,-122,0,0,0
10481,ElliotBayTrailMyrtlePark,03/13/2015 05:00:00 PM,48,-122,0,0,0
10482,ElliotBayTrailMyrtlePark,03/13/2015 06:00:00 PM,48,-122,0,0,0
10483,ElliotBayTrailMyrtlePark,03/13/2015 07:00:00 PM,48,-122,0,0,0
10484,ElliotBayTrailMyrtlePark,03/13/2015 08:00:00 PM,48,-122,0,0,0
10485,ElliotBayTrailMyrtlePark,03/13/2015 09:00:00 PM,48,-122,0,0,0
10486,ElliotBayTrailMyrtlePark,03/13/2015 10:00:00 PM,48,-122,0,0,0
10487,ElliotBayTrailMyrtlePark,03/13/2015 11:00:00 PM,48,-122,0,0,0
10488,ElliotBayTrailMyrtlePark,03/14/2015 12:00:00 AM,48,-122,0,0,0
10489,ElliotBayTrailMyrtlePark,03/14/2015 01:00:00 AM,48,-122,0,0,0
10490,ElliotBayTrailMyrtlePark,03/14/2015 02:00:00 AM,48,-122,0,0,0
10491,ElliotBayTrailMyrtlePark,03/14/2015 03:00:00 AM,48,-122,0,0,0
10492,ElliotBayTrailMyrtlePark,03/14/2015 04:00:00 AM,48,-122,0,0,0
10493,ElliotBayTrailMyrtlePark,03/14/2015 05:00:00 AM,48,-122,0,0,0
10494,ElliotBayTrailMyrtlePark,03/14/2015 06:00:00 AM,48,-122,0,0,0
10495,ElliotBayTrailMyrtlePark,03/14/2015 07:00:00 AM,48,-122,0,0,0
10496,ElliotBayTrailMyrtlePark,03/14/2015 08:00:00 AM,48,-122,0,0,0
10497,ElliotBayTrailMyrtlePark,03/14/2015 09:00:00 AM,48,-122,0,0,0
10498,ElliotBayTrailMyrtlePark,03/14/2015 10:00:00 AM,48,-122,0,0,0
10499,ElliotBayTrailMyrtlePark,03/14/2015 11:00:00 AM,48,-122,0,0,0
10500,ElliotBayTrailMyrtlePark,03/14/2015 12:00:00 PM,48,-122,0,0,0
10501,ElliotBayTrailMyrtlePark,03/14/2015 01:00:00 PM,48,-122,0,0,0
10502,ElliotBayTrailMyrtlePark,03/14/2015 02:00:00 PM,48,-122,0,0,0
10503,ElliotBayTrailMyrtlePark,03/14/2015 03:00:00 PM,48,-122,0,0,0
10504,ElliotBayTrailMyrtlePark,03/14/2015 04:00:00 PM,48,-122,0,0,0
10505,ElliotBayTrailMyrtlePark,03/14/2015 05:00:00 PM,48,-122,0,0,0
10506,ElliotBayTrailMyrtlePark,03/14/2015 06:00:00 PM,48,-122,0,0,0
10507,ElliotBayTrailMyrtlePark,03/14/2015 07:00:00 PM,48,-122,0,0,0
10508,ElliotBayTrailMyrtlePark,03/14/2015 08:00:00 PM,48,-122,0,0,0
10509,ElliotBayTrailMyrtlePark,03/14/2015 09:00:00 PM,48,-122,0,0,0
10510,ElliotBayTrailMyrtlePark,03/14/2015 10:00:00 PM,48,-122,0,0,0
10511,ElliotBayTrailMyrtlePark,03/14/2015 11:00:00 PM,48,-122,0,0,0
10512,ElliotBayTrailMyrtlePark,03/15/2015 12:00:00 AM,48,-122,0,0,0
10513,ElliotBayTrailMyrtlePark,03/15/2015 01:00:00 AM,48,-122,0,0,0
10514,ElliotBayTrailMyrtlePark,03/15/2015 02:00:00 AM,48,-122,0,0,0
10515,ElliotBayTrailMyrtlePark,03/15/2015 03:00:00 AM,48,-122,0,0,0
10516,ElliotBayTrailMyrtlePark,03/15/2015 04:00:00 AM,48,-122,0,0,0
10517,ElliotBayTrailMyrtlePark,03/15/2015 05:00:00 AM,48,-122,0,0,0
10518,ElliotBayTrailMyrtlePark,03/15/2015 06:00:00 AM,48,-122,0,0,0
10519,ElliotBayTrailMyrtlePark,03/15/2015 07:00:00 AM,48,-122,0,0,0
10520,ElliotBayTrailMyrtlePark,03/15/2015 08:00:00 AM,48,-122,0,0,0
10521,ElliotBayTrailMyrtlePark,03/15/2015 09:00:00 AM,48,-122,0,0,0
10522,ElliotBayTrailMyrtlePark,03/15/2015 10:00:00 AM,48,-122,0,0,0
10523,ElliotBayTrailMyrtlePark,03/15/2015 11:00:00 AM,48,-122,0,0,0
10524,ElliotBayTrailMyrtlePark,03/15/2015 12:00:00 PM,48,-122,0,0,0
10525,ElliotBayTrailMyrtlePark,03/15/2015 01:00:00 PM,48,-122,0,0,0
10526,ElliotBayTrailMyrtlePark,03/15/2015 02:00:00 PM,48,-122,0,0,0
10527,ElliotBayTrailMyrtlePark,03/15/2015 03:00:00 PM,48,-122,0,0,0
10528,ElliotBayTrailMyrtlePark,03/15/2015 04:00:00 PM,48,-122,0,0,0
10529,ElliotBayTrailMyrtlePark,03/15/2015 05:00:00 PM,48,-122,0,0,0
10530,ElliotBayTrailMyrtlePark,03/15/2015 06:00:00 PM,48,-122,0,0,0
10531,ElliotBayTrailMyrtlePark,03/15/2015 07:00:00 PM,48,-122,0,0,0
10532,ElliotBayTrailMyrtlePark,03/15/2015 08:00:00 PM,48,-122,0,0,0
10533,ElliotBayTrailMyrtlePark,03/15/2015 09:00:00 PM,48,-122,0,0,0
10534,ElliotBayTrailMyrtlePark,03/15/2015 10:00:00 PM,48,-122,0,0,0
10535,ElliotBayTrailMyrtlePark,03/15/2015 11:00:00 PM,48,-122,0,0,0
10536,ElliotBayTrailMyrtlePark,03/16/2015 12:00:00 AM,48,-122,0,0,0
10537,ElliotBayTrailMyrtlePark,03/16/2015 01:00:00 AM,48,-122,0,0,0
10538,ElliotBayTrailMyrtlePark,03/16/2015 02:00:00 AM,48,-122,0,0,0
10539,ElliotBayTrailMyrtlePark,03/16/2015 03:00:00 AM,48,-122,0,0,0
10540,ElliotBayTrailMyrtlePark,03/16/2015 04:00:00 AM,48,-122,0,0,0
10541,ElliotBayTrailMyrtlePark,03/16/2015 05:00:00 AM,48,-122,0,0,0
10542,ElliotBayTrailMyrtlePark,03/16/2015 06:00:00 AM,48,-122,0,0,0
10543,ElliotBayTrailMyrtlePark,03/16/2015 07:00:00 AM,48,-122,0,0,0
10544,ElliotBayTrailMyrtlePark,03/16/2015 08:00:00 AM,48,-122,0,0,0
10545,ElliotBayTrailMyrtlePark,03/16/2015 09:00:00 AM,48,-122,0,0,0
10546,ElliotBayTrailMyrtlePark,03/16/2015 10:00:00 AM,48,-122,0,0,0
10547,ElliotBayTrailMyrtlePark,03/16/2015 11:00:00 AM,48,-122,0,0,0
10548,ElliotBayTrailMyrtlePark,03/16/2015 12:00:00 PM,48,-122,0,0,0
10549,ElliotBayTrailMyrtlePark,03/16/2015 01:00:00 PM,48,-122,0,0,0
10550,ElliotBayTrailMyrtlePark,03/16/2015 02:00:00 PM,48,-122,0,0,0
10551,ElliotBayTrailMyrtlePark,03/16/2015 03:00:00 PM,48,-122,0,0,0
10552,ElliotBayTrailMyrtlePark,03/16/2015 04:00:00 PM,48,-122,0,0,0
10553,ElliotBayTrailMyrtlePark,03/16/2015 05:00:00 PM,48,-122,0,0,0
10554,ElliotBayTrailMyrtlePark,03/16/2015 06:00:00 PM,48,-122,0,0,0
10555,ElliotBayTrailMyrtlePark,03/16/2015 07:00:00 PM,48,-122,0,0,0
10556,ElliotBayTrailMyrtlePark,03/16/2015 08:00:00 PM,48,-122,0,0,0
10557,ElliotBayTrailMyrtlePark,03/16/2015 09:00:00 PM,48,-122,0,0,0
10558,ElliotBayTrailMyrtlePark,03/16/2015 10:00:00 PM,48,-122,0,0,0
10559,ElliotBayTrailMyrtlePark,03/16/2015 11:00:00 PM,48,-122,0,0,0
10560,ElliotBayTrailMyrtlePark,03/17/2015 12:00:00 AM,48,-122,0,0,0
10561,ElliotBayTrailMyrtlePark,03/17/2015 01:00:00 AM,48,-122,0,0,0
10562,ElliotBayTrailMyrtlePark,03/17/2015 02:00:00 AM,48,-122,0,0,0
10563,ElliotBayTrailMyrtlePark,03/17/2015 03:00:00 AM,48,-122,0,0,0
10564,ElliotBayTrailMyrtlePark,03/17/2015 04:00:00 AM,48,-122,0,0,0
10565,ElliotBayTrailMyrtlePark,03/17/2015 05:00:00 AM,48,-122,0,0,0
10566,ElliotBayTrailMyrtlePark,03/17/2015 06:00:00 AM,48,-122,0,0,0
10567,ElliotBayTrailMyrtlePark,03/17/2015 07:00:00 AM,48,-122,0,0,0
10568,ElliotBayTrailMyrtlePark,03/17/2015 08:00:00 AM,48,-122,0,0,0
10569,ElliotBayTrailMyrtlePark,03/17/2015 09:00:00 AM,48,-122,0,0,0
10570,ElliotBayTrailMyrtlePark,03/17/2015 10:00:00 AM,48,-122,0,0,0
10571,ElliotBayTrailMyrtlePark,03/17/2015 11:00:00 AM,48,-122,0,0,0
10572,ElliotBayTrailMyrtlePark,03/17/2015 12:00:00 PM,48,-122,0,0,0
10573,ElliotBayTrailMyrtlePark,03/17/2015 01:00:00 PM,48,-122,0,0,0
10574,ElliotBayTrailMyrtlePark,03/17/2015 02:00:00 PM,48,-122,0,0,0
10575,ElliotBayTrailMyrtlePark,03/17/2015 03:00:00 PM,48,-122,0,0,0
10576,ElliotBayTrailMyrtlePark,03/17/2015 04:00:00 PM,48,-122,0,0,0
10577,ElliotBayTrailMyrtlePark,03/17/2015 05:00:00 PM,48,-122,0,0,0
10578,ElliotBayTrailMyrtlePark,03/17/2015 06:00:00 PM,48,-122,0,0,0
10579,ElliotBayTrailMyrtlePark,03/17/2015 07:00:00 PM,48,-122,0,0,0
10580,ElliotBayTrailMyrtlePark,03/17/2015 08:00:00 PM,48,-122,0,0,0
10581,ElliotBayTrailMyrtlePark,03/17/2015 09:00:00 PM,48,-122,0,0,0
10582,ElliotBayTrailMyrtlePark,03/17/2015 10:00:00 PM,48,-122,0,0,0
10583,ElliotBayTrailMyrtlePark,03/17/2015 11:00:00 PM,48,-122,0,0,0
10584,ElliotBayTrailMyrtlePark,03/18/2015 12:00:00 AM,48,-122,0,0,0
10585,ElliotBayTrailMyrtlePark,03/18/2015 01:00:00 AM,48,-122,0,0,0
10586,ElliotBayTrailMyrtlePark,03/18/2015 02:00:00 AM,48,-122,0,0,0
10587,ElliotBayTrailMyrtlePark,03/18/2015 03:00:00 AM,48,-122,0,0,0
10588,ElliotBayTrailMyrtlePark,03/18/2015 04:00:00 AM,48,-122,0,0,0
10589,ElliotBayTrailMyrtlePark,03/18/2015 05:00:00 AM,48,-122,0,0,0
10590,ElliotBayTrailMyrtlePark,03/18/2015 06:00:00 AM,48,-122,0,0,0
10591,ElliotBayTrailMyrtlePark,03/18/2015 07:00:00 AM,48,-122,0,0,0
10592,ElliotBayTrailMyrtlePark,03/18/2015 08:00:00 AM,48,-122,0,0,0
10593,ElliotBayTrailMyrtlePark,03/18/2015 09:00:00 AM,48,-122,0,0,0
10594,ElliotBayTrailMyrtlePark,03/18/2015 10:00:00 AM,48,-122,0,0,0
10595,ElliotBayTrailMyrtlePark,03/18/2015 11:00:00 AM,48,-122,0,0,0
10596,ElliotBayTrailMyrtlePark,03/18/2015 12:00:00 PM,48,-122,0,0,0
10597,ElliotBayTrailMyrtlePark,03/18/2015 01:00:00 PM,48,-122,0,0,0
10598,ElliotBayTrailMyrtlePark,03/18/2015 02:00:00 PM,48,-122,0,0,0
10599,ElliotBayTrailMyrtlePark,03/18/2015 03:00:00 PM,48,-122,0,0,0
10600,ElliotBayTrailMyrtlePark,03/18/2015 04:00:00 PM,48,-122,0,0,0
10601,ElliotBayTrailMyrtlePark,03/18/2015 05:00:00 PM,48,-122,0,0,0
10602,ElliotBayTrailMyrtlePark,03/18/2015 06:00:00 PM,48,-122,0,0,0
10603,ElliotBayTrailMyrtlePark,03/18/2015 07:00:00 PM,48,-122,0,0,0
10604,ElliotBayTrailMyrtlePark,03/18/2015 08:00:00 PM,48,-122,0,0,0
10605,ElliotBayTrailMyrtlePark,03/18/2015 09:00:00 PM,48,-122,0,0,0
10606,ElliotBayTrailMyrtlePark,03/18/2015 10:00:00 PM,48,-122,0,0,0
10607,ElliotBayTrailMyrtlePark,03/18/2015 11:00:00 PM,48,-122,0,0,0
10608,ElliotBayTrailMyrtlePark,03/19/2015 12:00:00 AM,48,-122,0,0,0
10609,ElliotBayTrailMyrtlePark,03/19/2015 01:00:00 AM,48,-122,0,0,0
10610,ElliotBayTrailMyrtlePark,03/19/2015 02:00:00 AM,48,-122,0,0,0
10611,ElliotBayTrailMyrtlePark,03/19/2015 03:00:00 AM,48,-122,0,0,0
10612,ElliotBayTrailMyrtlePark,03/19/2015 04:00:00 AM,48,-122,0,0,0
10613,ElliotBayTrailMyrtlePark,03/19/2015 05:00:00 AM,48,-122,0,0,0
10614,ElliotBayTrailMyrtlePark,03/19/2015 06:00:00 AM,48,-122,0,0,0
10615,ElliotBayTrailMyrtlePark,03/19/2015 07:00:00 AM,48,-122,0,0,0
10616,ElliotBayTrailMyrtlePark,03/19/2015 08:00:00 AM,48,-122,0,0,0
10617,ElliotBayTrailMyrtlePark,03/19/2015 09:00:00 AM,48,-122,0,0,0
10618,ElliotBayTrailMyrtlePark,03/19/2015 10:00:00 AM,48,-122,0,0,0
10619,ElliotBayTrailMyrtlePark,03/19/2015 11:00:00 AM,48,-122,0,0,0
10620,ElliotBayTrailMyrtlePark,03/19/2015 12:00:00 PM,48,-122,0,0,0
10621,ElliotBayTrailMyrtlePark,03/19/2015 01:00:00 PM,48,-122,0,0,0
10622,ElliotBayTrailMyrtlePark,03/19/2015 02:00:00 PM,48,-122,0,0,0
10623,ElliotBayTrailMyrtlePark,03/19/2015 03:00:00 PM,48,-122,0,0,0
10624,ElliotBayTrailMyrtlePark,03/19/2015 04:00:00 PM,48,-122,0,0,0
10625,ElliotBayTrailMyrtlePark,03/19/2015 05:00:00 PM,48,-122,0,0,0
10626,ElliotBayTrailMyrtlePark,03/19/2015 06:00:00 PM,48,-122,0,0,0
10627,ElliotBayTrailMyrtlePark,03/19/2015 07:00:00 PM,48,-122,0,0,0
10628,ElliotBayTrailMyrtlePark,03/19/2015 08:00:00 PM,48,-122,0,0,0
10629,ElliotBayTrailMyrtlePark,03/19/2015 09:00:00 PM,48,-122,0,0,0
10630,ElliotBayTrailMyrtlePark,03/19/2015 10:00:00 PM,48,-122,0,0,0
10631,ElliotBayTrailMyrtlePark,03/19/2015 11:00:00 PM,48,-122,0,0,0
10632,ElliotBayTrailMyrtlePark,03/20/2015 12:00:00 AM,48,-122,0,0,0
10633,ElliotBayTrailMyrtlePark,03/20/2015 01:00:00 AM,48,-122,0,0,0
10634,ElliotBayTrailMyrtlePark,03/20/2015 02:00:00 AM,48,-122,0,0,0
10635,ElliotBayTrailMyrtlePark,03/20/2015 03:00:00 AM,48,-122,0,0,0
10636,ElliotBayTrailMyrtlePark,03/20/2015 04:00:00 AM,48,-122,0,0,0
10637,ElliotBayTrailMyrtlePark,03/20/2015 05:00:00 AM,48,-122,0,0,0
10638,ElliotBayTrailMyrtlePark,03/20/2015 06:00:00 AM,48,-122,0,0,0
10639,ElliotBayTrailMyrtlePark,03/20/2015 07:00:00 AM,48,-122,0,0,0
10640,ElliotBayTrailMyrtlePark,03/20/2015 08:00:00 AM,48,-122,0,0,0
10641,ElliotBayTrailMyrtlePark,03/20/2015 09:00:00 AM,48,-122,0,0,0
10642,ElliotBayTrailMyrtlePark,03/20/2015 10:00:00 AM,48,-122,0,0,0
10643,ElliotBayTrailMyrtlePark,03/20/2015 11:00:00 AM,48,-122,0,0,0
10644,ElliotBayTrailMyrtlePark,03/20/2015 12:00:00 PM,48,-122,0,0,0
10645,ElliotBayTrailMyrtlePark,03/20/2015 01:00:00 PM,48,-122,0,0,0
10646,ElliotBayTrailMyrtlePark,03/20/2015 02:00:00 PM,48,-122,0,0,0
10647,ElliotBayTrailMyrtlePark,03/20/2015 03:00:00 PM,48,-122,0,0,0
10648,ElliotBayTrailMyrtlePark,03/20/2015 04:00:00 PM,48,-122,0,0,0
10649,ElliotBayTrailMyrtlePark,03/20/2015 05:00:00 PM,48,-122,0,0,0
10650,ElliotBayTrailMyrtlePark,03/20/2015 06:00:00 PM,48,-122,0,0,0
10651,ElliotBayTrailMyrtlePark,03/20/2015 07:00:00 PM,48,-122,0,0,0
10652,ElliotBayTrailMyrtlePark,03/20/2015 08:00:00 PM,48,-122,0,0,0
10653,ElliotBayTrailMyrtlePark,03/20/2015 09:00:00 PM,48,-122,0,0,0
10654,ElliotBayTrailMyrtlePark,03/20/2015 10:00:00 PM,48,-122,0,0,0
10655,ElliotBayTrailMyrtlePark,03/20/2015 11:00:00 PM,48,-122,0,0,0
10656,ElliotBayTrailMyrtlePark,03/21/2015 12:00:00 AM,48,-122,0,0,0
10657,ElliotBayTrailMyrtlePark,03/21/2015 01:00:00 AM,48,-122,0,0,0
10658,ElliotBayTrailMyrtlePark,03/21/2015 02:00:00 AM,48,-122,0,0,0
10659,ElliotBayTrailMyrtlePark,03/21/2015 03:00:00 AM,48,-122,0,0,0
10660,ElliotBayTrailMyrtlePark,03/21/2015 04:00:00 AM,48,-122,0,0,0
10661,ElliotBayTrailMyrtlePark,03/21/2015 05:00:00 AM,48,-122,0,0,0
10662,ElliotBayTrailMyrtlePark,03/21/2015 06:00:00 AM,48,-122,0,0,0
10663,ElliotBayTrailMyrtlePark,03/21/2015 07:00:00 AM,48,-122,0,0,0
10664,ElliotBayTrailMyrtlePark,03/21/2015 08:00:00 AM,48,-122,0,0,0
10665,ElliotBayTrailMyrtlePark,03/21/2015 09:00:00 AM,48,-122,0,0,0
10666,ElliotBayTrailMyrtlePark,03/21/2015 10:00:00 AM,48,-122,0,0,0
10667,ElliotBayTrailMyrtlePark,03/21/2015 11:00:00 AM,48,-122,0,0,0
10668,ElliotBayTrailMyrtlePark,03/21/2015 12:00:00 PM,48,-122,0,0,0
10669,ElliotBayTrailMyrtlePark,03/21/2015 01:00:00 PM,48,-122,0,0,0
10670,ElliotBayTrailMyrtlePark,03/21/2015 02:00:00 PM,48,-122,0,0,0
10671,ElliotBayTrailMyrtlePark,03/21/2015 03:00:00 PM,48,-122,0,0,0
10672,ElliotBayTrailMyrtlePark,03/21/2015 04:00:00 PM,48,-122,0,0,0
10673,ElliotBayTrailMyrtlePark,03/21/2015 05:00:00 PM,48,-122,0,0,0
10674,ElliotBayTrailMyrtlePark,03/21/2015 06:00:00 PM,48,-122,0,0,0
10675,ElliotBayTrailMyrtlePark,03/21/2015 07:00:00 PM,48,-122,0,0,0
10676,ElliotBayTrailMyrtlePark,03/21/2015 08:00:00 PM,48,-122,0,0,0
10677,ElliotBayTrailMyrtlePark,03/21/2015 09:00:00 PM,48,-122,0,0,0
10678,ElliotBayTrailMyrtlePark,03/21/2015 10:00:00 PM,48,-122,0,0,0
10679,ElliotBayTrailMyrtlePark,03/21/2015 11:00:00 PM,48,-122,0,0,0
10680,ElliotBayTrailMyrtlePark,03/22/2015 12:00:00 AM,48,-122,0,0,0
10681,ElliotBayTrailMyrtlePark,03/22/2015 01:00:00 AM,48,-122,0,0,0
10682,ElliotBayTrailMyrtlePark,03/22/2015 02:00:00 AM,48,-122,0,0,0
10683,ElliotBayTrailMyrtlePark,03/22/2015 03:00:00 AM,48,-122,0,0,0
10684,ElliotBayTrailMyrtlePark,03/22/2015 04:00:00 AM,48,-122,0,0,0
10685,ElliotBayTrailMyrtlePark,03/22/2015 05:00:00 AM,48,-122,0,0,0
10686,ElliotBayTrailMyrtlePark,03/22/2015 06:00:00 AM,48,-122,0,0,0
10687,ElliotBayTrailMyrtlePark,03/22/2015 07:00:00 AM,48,-122,0,0,0
10688,ElliotBayTrailMyrtlePark,03/22/2015 08:00:00 AM,48,-122,0,0,0
10689,ElliotBayTrailMyrtlePark,03/22/2015 09:00:00 AM,48,-122,0,0,0
10690,ElliotBayTrailMyrtlePark,03/22/2015 10:00:00 AM,48,-122,0,0,0
10691,ElliotBayTrailMyrtlePark,03/22/2015 11:00:00 AM,48,-122,0,0,0
10692,ElliotBayTrailMyrtlePark,03/22/2015 12:00:00 PM,48,-122,0,0,0
10693,ElliotBayTrailMyrtlePark,03/22/2015 01:00:00 PM,48,-122,0,0,0
10694,ElliotBayTrailMyrtlePark,03/22/2015 02:00:00 PM,48,-122,0,0,0
10695,ElliotBayTrailMyrtlePark,03/22/2015 03:00:00 PM,48,-122,0,0,0
10696,ElliotBayTrailMyrtlePark,03/22/2015 04:00:00 PM,48,-122,0,0,0
10697,ElliotBayTrailMyrtlePark,03/22/2015 05:00:00 PM,48,-122,0,0,0
10698,ElliotBayTrailMyrtlePark,03/22/2015 06:00:00 PM,48,-122,0,0,0
10699,ElliotBayTrailMyrtlePark,03/22/2015 07:00:00 PM,48,-122,0,0,0
10700,ElliotBayTrailMyrtlePark,03/22/2015 08:00:00 PM,48,-122,0,0,0
10701,ElliotBayTrailMyrtlePark,03/22/2015 09:00:00 PM,48,-122,0,0,0
10702,ElliotBayTrailMyrtlePark,03/22/2015 10:00:00 PM,48,-122,0,0,0
10703,ElliotBayTrailMyrtlePark,03/22/2015 11:00:00 PM,48,-122,0,0,0
10704,ElliotBayTrailMyrtlePark,03/23/2015 12:00:00 AM,48,-122,0,0,0
10705,ElliotBayTrailMyrtlePark,03/23/2015 01:00:00 AM,48,-122,0,0,0
10706,ElliotBayTrailMyrtlePark,03/23/2015 02:00:00 AM,48,-122,0,0,0
10707,ElliotBayTrailMyrtlePark,03/23/2015 03:00:00 AM,48,-122,0,0,0
10708,ElliotBayTrailMyrtlePark,03/23/2015 04:00:00 AM,48,-122,0,0,0
10709,ElliotBayTrailMyrtlePark,03/23/2015 05:00:00 AM,48,-122,0,0,0
10710,ElliotBayTrailMyrtlePark,03/23/2015 06:00:00 AM,48,-122,0,0,0
10711,ElliotBayTrailMyrtlePark,03/23/2015 07:00:00 AM,48,-122,0,0,0
10712,ElliotBayTrailMyrtlePark,03/23/2015 08:00:00 AM,48,-122,0,0,0
10713,ElliotBayTrailMyrtlePark,03/23/2015 09:00:00 AM,48,-122,0,0,0
10714,ElliotBayTrailMyrtlePark,03/23/2015 10:00:00 AM,48,-122,0,0,0
10715,ElliotBayTrailMyrtlePark,03/23/2015 11:00:00 AM,48,-122,0,0,0
10716,ElliotBayTrailMyrtlePark,03/23/2015 12:00:00 PM,48,-122,0,0,0
10717,ElliotBayTrailMyrtlePark,03/23/2015 01:00:00 PM,48,-122,0,0,0
10718,ElliotBayTrailMyrtlePark,03/23/2015 02:00:00 PM,48,-122,0,0,0
10719,ElliotBayTrailMyrtlePark,03/23/2015 03:00:00 PM,48,-122,0,0,0
10720,ElliotBayTrailMyrtlePark,03/23/2015 04:00:00 PM,48,-122,0,0,0
10721,ElliotBayTrailMyrtlePark,03/23/2015 05:00:00 PM,48,-122,0,0,0
10722,ElliotBayTrailMyrtlePark,03/23/2015 06:00:00 PM,48,-122,0,0,0
10723,ElliotBayTrailMyrtlePark,03/23/2015 07:00:00 PM,48,-122,0,0,0
10724,ElliotBayTrailMyrtlePark,03/23/2015 08:00:00 PM,48,-122,0,0,0
10725,ElliotBayTrailMyrtlePark,03/23/2015 09:00:00 PM,48,-122,0,0,0
10726,ElliotBayTrailMyrtlePark,03/23/2015 10:00:00 PM,48,-122,0,0,0
10727,ElliotBayTrailMyrtlePark,03/23/2015 11:00:00 PM,48,-122,0,0,0
10728,ElliotBayTrailMyrtlePark,03/24/2015 12:00:00 AM,48,-122,0,0,0
10729,ElliotBayTrailMyrtlePark,03/24/2015 01:00:00 AM,48,-122,0,0,0
10730,ElliotBayTrailMyrtlePark,03/24/2015 02:00:00 AM,48,-122,0,0,0
10731,ElliotBayTrailMyrtlePark,03/24/2015 03:00:00 AM,48,-122,0,0,0
10732,ElliotBayTrailMyrtlePark,03/24/2015 04:00:00 AM,48,-122,0,0,0
10733,ElliotBayTrailMyrtlePark,03/24/2015 05:00:00 AM,48,-122,0,0,0
10734,ElliotBayTrailMyrtlePark,03/24/2015 06:00:00 AM,48,-122,0,0,0
10735,ElliotBayTrailMyrtlePark,03/24/2015 07:00:00 AM,48,-122,0,0,0
10736,ElliotBayTrailMyrtlePark,03/24/2015 08:00:00 AM,48,-122,0,0,0
10737,ElliotBayTrailMyrtlePark,03/24/2015 09:00:00 AM,48,-122,0,0,0
10738,ElliotBayTrailMyrtlePark,03/24/2015 10:00:00 AM,48,-122,0,0,0
10739,ElliotBayTrailMyrtlePark,03/24/2015 11:00:00 AM,48,-122,0,0,0
10740,ElliotBayTrailMyrtlePark,03/24/2015 12:00:00 PM,48,-122,0,0,0
10741,ElliotBayTrailMyrtlePark,03/24/2015 01:00:00 PM,48,-122,0,0,0
10742,ElliotBayTrailMyrtlePark,03/24/2015 02:00:00 PM,48,-122,0,0,0
10743,ElliotBayTrailMyrtlePark,03/24/2015 03:00:00 PM,48,-122,0,0,0
10744,ElliotBayTrailMyrtlePark,03/24/2015 04:00:00 PM,48,-122,0,0,0
10745,ElliotBayTrailMyrtlePark,03/24/2015 05:00:00 PM,48,-122,0,0,0
10746,ElliotBayTrailMyrtlePark,03/24/2015 06:00:00 PM,48,-122,0,0,0
10747,ElliotBayTrailMyrtlePark,03/24/2015 07:00:00 PM,48,-122,0,0,0
10748,ElliotBayTrailMyrtlePark,03/24/2015 08:00:00 PM,48,-122,0,0,0
10749,ElliotBayTrailMyrtlePark,03/24/2015 09:00:00 PM,48,-122,0,0,0
10750,ElliotBayTrailMyrtlePark,03/24/2015 10:00:00 PM,48,-122,0,0,0
10751,ElliotBayTrailMyrtlePark,03/24/2015 11:00:00 PM,48,-122,0,0,0
10752,ElliotBayTrailMyrtlePark,03/25/2015 12:00:00 AM,48,-122,0,0,0
10753,ElliotBayTrailMyrtlePark,03/25/2015 01:00:00 AM,48,-122,0,0,0
10754,ElliotBayTrailMyrtlePark,03/25/2015 02:00:00 AM,48,-122,0,0,0
10755,ElliotBayTrailMyrtlePark,03/25/2015 03:00:00 AM,48,-122,0,0,0
10756,ElliotBayTrailMyrtlePark,03/25/2015 04:00:00 AM,48,-122,0,0,0
10757,ElliotBayTrailMyrtlePark,03/25/2015 05:00:00 AM,48,-122,0,0,0
10758,ElliotBayTrailMyrtlePark,03/25/2015 06:00:00 AM,48,-122,0,0,0
10759,ElliotBayTrailMyrtlePark,03/25/2015 07:00:00 AM,48,-122,0,0,0
10760,ElliotBayTrailMyrtlePark,03/25/2015 08:00:00 AM,48,-122,0,0,0
10761,ElliotBayTrailMyrtlePark,03/25/2015 09:00:00 AM,48,-122,0,0,0
10762,ElliotBayTrailMyrtlePark,03/25/2015 10:00:00 AM,48,-122,0,0,0
10763,ElliotBayTrailMyrtlePark,03/25/2015 11:00:00 AM,48,-122,0,0,0
10764,ElliotBayTrailMyrtlePark,03/25/2015 12:00:00 PM,48,-122,0,0,0
10765,ElliotBayTrailMyrtlePark,03/25/2015 01:00:00 PM,48,-122,0,0,0
10766,ElliotBayTrailMyrtlePark,03/25/2015 02:00:00 PM,48,-122,0,0,0
10767,ElliotBayTrailMyrtlePark,03/25/2015 03:00:00 PM,48,-122,0,0,0
10768,ElliotBayTrailMyrtlePark,03/25/2015 04:00:00 PM,48,-122,0,0,0
10769,ElliotBayTrailMyrtlePark,03/25/2015 05:00:00 PM,48,-122,0,0,0
10770,ElliotBayTrailMyrtlePark,03/25/2015 06:00:00 PM,48,-122,0,0,0
10771,ElliotBayTrailMyrtlePark,03/25/2015 07:00:00 PM,48,-122,0,0,0
10772,ElliotBayTrailMyrtlePark,03/25/2015 08:00:00 PM,48,-122,0,0,0
10773,ElliotBayTrailMyrtlePark,03/25/2015 09:00:00 PM,48,-122,0,0,0
10774,ElliotBayTrailMyrtlePark,03/25/2015 10:00:00 PM,48,-122,0,0,0
10775,ElliotBayTrailMyrtlePark,03/25/2015 11:00:00 PM,48,-122,0,0,0
10776,ElliotBayTrailMyrtlePark,03/26/2015 12:00:00 AM,48,-122,0,0,0
10777,ElliotBayTrailMyrtlePark,03/26/2015 01:00:00 AM,48,-122,0,0,0
10778,ElliotBayTrailMyrtlePark,03/26/2015 02:00:00 AM,48,-122,0,0,0
10779,ElliotBayTrailMyrtlePark,03/26/2015 03:00:00 AM,48,-122,0,0,0
10780,ElliotBayTrailMyrtlePark,03/26/2015 04:00:00 AM,48,-122,0,0,0
10781,ElliotBayTrailMyrtlePark,03/26/2015 05:00:00 AM,48,-122,0,0,0
10782,ElliotBayTrailMyrtlePark,03/26/2015 06:00:00 AM,48,-122,0,0,0
10783,ElliotBayTrailMyrtlePark,03/26/2015 07:00:00 AM,48,-122,0,0,0
10784,ElliotBayTrailMyrtlePark,03/26/2015 08:00:00 AM,48,-122,0,0,0
10785,ElliotBayTrailMyrtlePark,03/26/2015 09:00:00 AM,48,-122,0,0,0
10786,ElliotBayTrailMyrtlePark,03/26/2015 10:00:00 AM,48,-122,0,0,0
10787,ElliotBayTrailMyrtlePark,03/26/2015 11:00:00 AM,48,-122,0,0,0
10788,ElliotBayTrailMyrtlePark,03/26/2015 12:00:00 PM,48,-122,0,0,0
10789,ElliotBayTrailMyrtlePark,03/26/2015 01:00:00 PM,48,-122,0,0,0
10790,ElliotBayTrailMyrtlePark,03/26/2015 02:00:00 PM,48,-122,0,0,0
10791,ElliotBayTrailMyrtlePark,03/26/2015 03:00:00 PM,48,-122,0,0,0
10792,ElliotBayTrailMyrtlePark,03/26/2015 04:00:00 PM,48,-122,0,0,0
10793,ElliotBayTrailMyrtlePark,03/26/2015 05:00:00 PM,48,-122,0,0,0
10794,ElliotBayTrailMyrtlePark,03/26/2015 06:00:00 PM,48,-122,0,0,0
10795,ElliotBayTrailMyrtlePark,03/26/2015 07:00:00 PM,48,-122,0,0,0
10796,ElliotBayTrailMyrtlePark,03/26/2015 08:00:00 PM,48,-122,0,0,0
10797,ElliotBayTrailMyrtlePark,03/26/2015 09:00:00 PM,48,-122,0,0,0
10798,ElliotBayTrailMyrtlePark,03/26/2015 10:00:00 PM,48,-122,0,0,0
10799,ElliotBayTrailMyrtlePark,03/26/2015 11:00:00 PM,48,-122,0,0,0
10800,ElliotBayTrailMyrtlePark,03/27/2015 12:00:00 AM,48,-122,0,0,0
10801,ElliotBayTrailMyrtlePark,03/27/2015 01:00:00 AM,48,-122,0,0,0
10802,ElliotBayTrailMyrtlePark,03/27/2015 02:00:00 AM,48,-122,0,0,0
10803,ElliotBayTrailMyrtlePark,03/27/2015 03:00:00 AM,48,-122,0,0,0
10804,ElliotBayTrailMyrtlePark,03/27/2015 04:00:00 AM,48,-122,0,0,0
10805,ElliotBayTrailMyrtlePark,03/27/2015 05:00:00 AM,48,-122,0,0,0
10806,ElliotBayTrailMyrtlePark,03/27/2015 06:00:00 AM,48,-122,0,0,0
10807,ElliotBayTrailMyrtlePark,03/27/2015 07:00:00 AM,48,-122,0,0,0
10808,ElliotBayTrailMyrtlePark,03/27/2015 08:00:00 AM,48,-122,0,0,0
10809,ElliotBayTrailMyrtlePark,03/27/2015 09:00:00 AM,48,-122,0,0,0
10810,ElliotBayTrailMyrtlePark,03/27/2015 10:00:00 AM,48,-122,0,0,0
10811,ElliotBayTrailMyrtlePark,03/27/2015 11:00:00 AM,48,-122,0,0,0
10812,ElliotBayTrailMyrtlePark,03/27/2015 12:00:00 PM,48,-122,0,0,0
10813,ElliotBayTrailMyrtlePark,03/27/2015 01:00:00 PM,48,-122,0,0,0
10814,ElliotBayTrailMyrtlePark,03/27/2015 02:00:00 PM,48,-122,0,0,0
10815,ElliotBayTrailMyrtlePark,03/27/2015 03:00:00 PM,48,-122,0,0,0
10816,ElliotBayTrailMyrtlePark,03/27/2015 04:00:00 PM,48,-122,0,0,0
10817,ElliotBayTrailMyrtlePark,03/27/2015 05:00:00 PM,48,-122,0,0,0
10818,ElliotBayTrailMyrtlePark,03/27/2015 06:00:00 PM,48,-122,0,0,0
10819,ElliotBayTrailMyrtlePark,03/27/2015 07:00:00 PM,48,-122,0,0,0
10820,ElliotBayTrailMyrtlePark,03/27/2015 08:00:00 PM,48,-122,0,0,0
10821,ElliotBayTrailMyrtlePark,03/27/2015 09:00:00 PM,48,-122,0,0,0
10822,ElliotBayTrailMyrtlePark,03/27/2015 10:00:00 PM,48,-122,0,0,0
10823,ElliotBayTrailMyrtlePark,03/27/2015 11:00:00 PM,48,-122,0,0,0
10824,ElliotBayTrailMyrtlePark,03/28/2015 12:00:00 AM,48,-122,0,0,0
10825,ElliotBayTrailMyrtlePark,03/28/2015 01:00:00 AM,48,-122,0,0,0
10826,ElliotBayTrailMyrtlePark,03/28/2015 02:00:00 AM,48,-122,0,0,0
10827,ElliotBayTrailMyrtlePark,03/28/2015 03:00:00 AM,48,-122,0,0,0
10828,ElliotBayTrailMyrtlePark,03/28/2015 04:00:00 AM,48,-122,0,0,0
10829,ElliotBayTrailMyrtlePark,03/28/2015 05:00:00 AM,48,-122,0,0,0
10830,ElliotBayTrailMyrtlePark,03/28/2015 06:00:00 AM,48,-122,0,0,0
10831,ElliotBayTrailMyrtlePark,03/28/2015 07:00:00 AM,48,-122,0,0,0
10832,ElliotBayTrailMyrtlePark,03/28/2015 08:00:00 AM,48,-122,0,0,0
10833,ElliotBayTrailMyrtlePark,03/28/2015 09:00:00 AM,48,-122,0,0,0
10834,ElliotBayTrailMyrtlePark,03/28/2015 10:00:00 AM,48,-122,0,0,0
10835,ElliotBayTrailMyrtlePark,03/28/2015 11:00:00 AM,48,-122,0,0,0
10836,ElliotBayTrailMyrtlePark,03/28/2015 12:00:00 PM,48,-122,0,0,0
10837,ElliotBayTrailMyrtlePark,03/28/2015 01:00:00 PM,48,-122,0,0,0
10838,ElliotBayTrailMyrtlePark,03/28/2015 02:00:00 PM,48,-122,0,0,0
10839,ElliotBayTrailMyrtlePark,03/28/2015 03:00:00 PM,48,-122,0,0,0
10840,ElliotBayTrailMyrtlePark,03/28/2015 04:00:00 PM,48,-122,0,0,0
10841,ElliotBayTrailMyrtlePark,03/28/2015 05:00:00 PM,48,-122,0,0,0
10842,ElliotBayTrailMyrtlePark,03/28/2015 06:00:00 PM,48,-122,0,0,0
10843,ElliotBayTrailMyrtlePark,03/28/2015 07:00:00 PM,48,-122,0,0,0
10844,ElliotBayTrailMyrtlePark,03/28/2015 08:00:00 PM,48,-122,0,0,0
10845,ElliotBayTrailMyrtlePark,03/28/2015 09:00:00 PM,48,-122,0,0,0
10846,ElliotBayTrailMyrtlePark,03/28/2015 10:00:00 PM,48,-122,0,0,0
10847,ElliotBayTrailMyrtlePark,03/28/2015 11:00:00 PM,48,-122,0,0,0
10848,ElliotBayTrailMyrtlePark,03/29/2015 12:00:00 AM,48,-122,0,0,0
10849,ElliotBayTrailMyrtlePark,03/29/2015 01:00:00 AM,48,-122,0,0,0
10850,ElliotBayTrailMyrtlePark,03/29/2015 02:00:00 AM,48,-122,0,0,0
10851,ElliotBayTrailMyrtlePark,03/29/2015 03:00:00 AM,48,-122,0,0,0
10852,ElliotBayTrailMyrtlePark,03/29/2015 04:00:00 AM,48,-122,0,0,0
10853,ElliotBayTrailMyrtlePark,03/29/2015 05:00:00 AM,48,-122,0,0,0
10854,ElliotBayTrailMyrtlePark,03/29/2015 06:00:00 AM,48,-122,0,0,0
10855,ElliotBayTrailMyrtlePark,03/29/2015 07:00:00 AM,48,-122,0,0,0
10856,ElliotBayTrailMyrtlePark,03/29/2015 08:00:00 AM,48,-122,0,0,0
10857,ElliotBayTrailMyrtlePark,03/29/2015 09:00:00 AM,48,-122,0,0,0
10858,ElliotBayTrailMyrtlePark,03/29/2015 10:00:00 AM,48,-122,0,0,0
10859,ElliotBayTrailMyrtlePark,03/29/2015 11:00:00 AM,48,-122,0,0,0
10860,ElliotBayTrailMyrtlePark,03/29/2015 12:00:00 PM,48,-122,0,0,0
10861,ElliotBayTrailMyrtlePark,03/29/2015 01:00:00 PM,48,-122,0,0,0
10862,ElliotBayTrailMyrtlePark,03/29/2015 02:00:00 PM,48,-122,0,0,0
10863,ElliotBayTrailMyrtlePark,03/29/2015 03:00:00 PM,48,-122,0,0,0
10864,ElliotBayTrailMyrtlePark,03/29/2015 04:00:00 PM,48,-122,0,0,0
10865,ElliotBayTrailMyrtlePark,03/29/2015 05:00:00 PM,48,-122,0,0,0
10866,ElliotBayTrailMyrtlePark,03/29/2015 06:00:00 PM,48,-122,0,0,0
10867,ElliotBayTrailMyrtlePark,03/29/2015 07:00:00 PM,48,-122,0,0,0
10868,ElliotBayTrailMyrtlePark,03/29/2015 08:00:00 PM,48,-122,0,0,0
10869,ElliotBayTrailMyrtlePark,03/29/2015 09:00:00 PM,48,-122,0,0,0
10870,ElliotBayTrailMyrtlePark,03/29/2015 10:00:00 PM,48,-122,0,0,0
10871,ElliotBayTrailMyrtlePark,03/29/2015 11:00:00 PM,48,-122,0,0,0
10872,ElliotBayTrailMyrtlePark,03/30/2015 12:00:00 AM,48,-122,0,0,0
10873,ElliotBayTrailMyrtlePark,03/30/2015 01:00:00 AM,48,-122,0,0,0
10874,ElliotBayTrailMyrtlePark,03/30/2015 02:00:00 AM,48,-122,0,0,0
10875,ElliotBayTrailMyrtlePark,03/30/2015 03:00:00 AM,48,-122,0,0,0
10876,ElliotBayTrailMyrtlePark,03/30/2015 04:00:00 AM,48,-122,0,0,0
10877,ElliotBayTrailMyrtlePark,03/30/2015 05:00:00 AM,48,-122,0,0,0
10878,ElliotBayTrailMyrtlePark,03/30/2015 06:00:00 AM,48,-122,0,0,0
10879,ElliotBayTrailMyrtlePark,03/30/2015 07:00:00 AM,48,-122,0,0,0
10880,ElliotBayTrailMyrtlePark,03/30/2015 08:00:00 AM,48,-122,0,0,0
10881,ElliotBayTrailMyrtlePark,03/30/2015 09:00:00 AM,48,-122,0,0,0
10882,ElliotBayTrailMyrtlePark,03/30/2015 10:00:00 AM,48,-122,0,0,0
10883,ElliotBayTrailMyrtlePark,03/30/2015 11:00:00 AM,48,-122,0,0,0
10884,ElliotBayTrailMyrtlePark,03/30/2015 12:00:00 PM,48,-122,0,0,0
10885,ElliotBayTrailMyrtlePark,03/30/2015 01:00:00 PM,48,-122,0,0,0
10886,ElliotBayTrailMyrtlePark,03/30/2015 02:00:00 PM,48,-122,0,0,0
10887,ElliotBayTrailMyrtlePark,03/30/2015 03:00:00 PM,48,-122,0,0,0
10888,ElliotBayTrailMyrtlePark,03/30/2015 04:00:00 PM,48,-122,0,0,0
10889,ElliotBayTrailMyrtlePark,03/30/2015 05:00:00 PM,48,-122,0,0,0
10890,ElliotBayTrailMyrtlePark,03/30/2015 06:00:00 PM,48,-122,0,0,0
10891,ElliotBayTrailMyrtlePark,03/30/2015 07:00:00 PM,48,-122,0,0,0
10892,ElliotBayTrailMyrtlePark,03/30/2015 08:00:00 PM,48,-122,0,0,0
10893,ElliotBayTrailMyrtlePark,03/30/2015 09:00:00 PM,48,-122,0,0,0
10894,ElliotBayTrailMyrtlePark,03/30/2015 10:00:00 PM,48,-122,0,0,0
10895,ElliotBayTrailMyrtlePark,03/30/2015 11:00:00 PM,48,-122,0,0,0
10896,ElliotBayTrailMyrtlePark,03/31/2015 12:00:00 AM,48,-122,0,0,0
10897,ElliotBayTrailMyrtlePark,03/31/2015 01:00:00 AM,48,-122,0,0,0
10898,ElliotBayTrailMyrtlePark,03/31/2015 02:00:00 AM,48,-122,0,0,0
10899,ElliotBayTrailMyrtlePark,03/31/2015 03:00:00 AM,48,-122,0,0,0
10900,ElliotBayTrailMyrtlePark,03/31/2015 04:00:00 AM,48,-122,0,0,0
10901,ElliotBayTrailMyrtlePark,03/31/2015 05:00:00 AM,48,-122,0,0,0
10902,ElliotBayTrailMyrtlePark,03/31/2015 06:00:00 AM,48,-122,0,0,0
10903,ElliotBayTrailMyrtlePark,03/31/2015 07:00:00 AM,48,-122,0,0,0
10904,ElliotBayTrailMyrtlePark,03/31/2015 08:00:00 AM,48,-122,0,0,0
10905,ElliotBayTrailMyrtlePark,03/31/2015 09:00:00 AM,48,-122,0,0,0
10906,ElliotBayTrailMyrtlePark,03/31/2015 10:00:00 AM,48,-122,0,0,0
10907,ElliotBayTrailMyrtlePark,03/31/2015 11:00:00 AM,48,-122,0,0,0
10908,ElliotBayTrailMyrtlePark,03/31/2015 12:00:00 PM,48,-122,0,0,0
10909,ElliotBayTrailMyrtlePark,03/31/2015 01:00:00 PM,48,-122,0,0,0
10910,ElliotBayTrailMyrtlePark,03/31/2015 02:00:00 PM,48,-122,0,0,0
10911,ElliotBayTrailMyrtlePark,03/31/2015 03:00:00 PM,48,-122,0,0,0
10912,ElliotBayTrailMyrtlePark,03/31/2015 04:00:00 PM,48,-122,0,0,0
10913,ElliotBayTrailMyrtlePark,03/31/2015 05:00:00 PM,48,-122,0,0,0
10914,ElliotBayTrailMyrtlePark,03/31/2015 06:00:00 PM,48,-122,0,0,0
10915,ElliotBayTrailMyrtlePark,03/31/2015 07:00:00 PM,48,-122,0,0,0
10916,ElliotBayTrailMyrtlePark,03/31/2015 08:00:00 PM,48,-122,0,0,0
10917,ElliotBayTrailMyrtlePark,03/31/2015 09:00:00 PM,48,-122,0,0,0
10918,ElliotBayTrailMyrtlePark,03/31/2015 10:00:00 PM,48,-122,0,0,0
10919,ElliotBayTrailMyrtlePark,03/31/2015 11:00:00 PM,48,-122,0,0,0
10920,ElliotBayTrailMyrtlePark,04/01/2015 12:00:00 AM,48,-122,0,0,0
10921,ElliotBayTrailMyrtlePark,04/01/2015 01:00:00 AM,48,-122,0,0,0
10922,ElliotBayTrailMyrtlePark,04/01/2015 02:00:00 AM,48,-122,0,0,0
10923,ElliotBayTrailMyrtlePark,04/01/2015 03:00:00 AM,48,-122,0,0,0
10924,ElliotBayTrailMyrtlePark,04/01/2015 04:00:00 AM,48,-122,0,0,0
10925,ElliotBayTrailMyrtlePark,04/01/2015 05:00:00 AM,48,-122,0,0,0
10926,ElliotBayTrailMyrtlePark,04/01/2015 06:00:00 AM,48,-122,0,0,0
10927,ElliotBayTrailMyrtlePark,04/01/2015 07:00:00 AM,48,-122,0,0,0
10928,ElliotBayTrailMyrtlePark,04/01/2015 08:00:00 AM,48,-122,0,0,0
10929,ElliotBayTrailMyrtlePark,04/01/2015 09:00:00 AM,48,-122,0,0,0
10930,ElliotBayTrailMyrtlePark,04/01/2015 10:00:00 AM,48,-122,0,0,0
10931,ElliotBayTrailMyrtlePark,04/01/2015 11:00:00 AM,48,-122,0,0,0
10932,ElliotBayTrailMyrtlePark,04/01/2015 12:00:00 PM,48,-122,0,0,0
10933,ElliotBayTrailMyrtlePark,04/01/2015 01:00:00 PM,48,-122,0,0,0
10934,ElliotBayTrailMyrtlePark,04/01/2015 02:00:00 PM,48,-122,0,0,0
10935,ElliotBayTrailMyrtlePark,04/01/2015 03:00:00 PM,48,-122,0,0,0
10936,ElliotBayTrailMyrtlePark,04/01/2015 04:00:00 PM,48,-122,0,0,0
10937,ElliotBayTrailMyrtlePark,04/01/2015 05:00:00 PM,48,-122,0,0,0
10938,ElliotBayTrailMyrtlePark,04/01/2015 06:00:00 PM,48,-122,0,0,0
10939,ElliotBayTrailMyrtlePark,04/01/2015 07:00:00 PM,48,-122,0,0,0
10940,ElliotBayTrailMyrtlePark,04/01/2015 08:00:00 PM,48,-122,0,0,0
10941,ElliotBayTrailMyrtlePark,04/01/2015 09:00:00 PM,48,-122,0,0,0
10942,ElliotBayTrailMyrtlePark,04/01/2015 10:00:00 PM,48,-122,0,0,0
10943,ElliotBayTrailMyrtlePark,04/01/2015 11:00:00 PM,48,-122,0,0,0
10944,ElliotBayTrailMyrtlePark,04/02/2015 12:00:00 AM,48,-122,0,0,0
10945,ElliotBayTrailMyrtlePark,04/02/2015 01:00:00 AM,48,-122,0,0,0
10946,ElliotBayTrailMyrtlePark,04/02/2015 02:00:00 AM,48,-122,0,0,0
10947,ElliotBayTrailMyrtlePark,04/02/2015 03:00:00 AM,48,-122,0,0,0
10948,ElliotBayTrailMyrtlePark,04/02/2015 04:00:00 AM,48,-122,0,0,0
10949,ElliotBayTrailMyrtlePark,04/02/2015 05:00:00 AM,48,-122,0,0,0
10950,ElliotBayTrailMyrtlePark,04/02/2015 06:00:00 AM,48,-122,0,0,0
10951,ElliotBayTrailMyrtlePark,04/02/2015 07:00:00 AM,48,-122,0,0,0
10952,ElliotBayTrailMyrtlePark,04/02/2015 08:00:00 AM,48,-122,0,0,0
10953,ElliotBayTrailMyrtlePark,04/02/2015 09:00:00 AM,48,-122,0,0,0
10954,ElliotBayTrailMyrtlePark,04/02/2015 10:00:00 AM,48,-122,0,0,0
10955,ElliotBayTrailMyrtlePark,04/02/2015 11:00:00 AM,48,-122,0,0,0
10956,ElliotBayTrailMyrtlePark,04/02/2015 12:00:00 PM,48,-122,0,0,0
10957,ElliotBayTrailMyrtlePark,04/02/2015 01:00:00 PM,48,-122,10,13,23
10958,ElliotBayTrailMyrtlePark,04/02/2015 02:00:00 PM,48,-122,31,25,56
10959,ElliotBayTrailMyrtlePark,04/02/2015 03:00:00 PM,48,-122,26,25,51
10960,ElliotBayTrailMyrtlePark,04/02/2015 04:00:00 PM,48,-122,68,55,123
10961,ElliotBayTrailMyrtlePark,04/02/2015 05:00:00 PM,48,-122,142,67,209
10962,ElliotBayTrailMyrtlePark,04/02/2015 06:00:00 PM,48,-122,143,61,204
10963,ElliotBayTrailMyrtlePark,04/02/2015 07:00:00 PM,48,-122,90,38,128
10964,ElliotBayTrailMyrtlePark,04/02/2015 08:00:00 PM,48,-122,14,11,25
10965,ElliotBayTrailMyrtlePark,04/02/2015 09:00:00 PM,48,-122,11,1,12
10966,ElliotBayTrailMyrtlePark,04/02/2015 10:00:00 PM,48,-122,6,3,9
10967,ElliotBayTrailMyrtlePark,04/02/2015 11:00:00 PM,48,-122,1,12,13
10968,ElliotBayTrailMyrtlePark,04/03/2015 12:00:00 AM,48,-122,1,10,11
10969,ElliotBayTrailMyrtlePark,04/03/2015 01:00:00 AM,48,-122,1,2,3
10970,ElliotBayTrailMyrtlePark,04/03/2015 02:00:00 AM,48,-122,2,4,6
10971,ElliotBayTrailMyrtlePark,04/03/2015 03:00:00 AM,48,-122,0,0,0
10972,ElliotBayTrailMyrtlePark,04/03/2015 04:00:00 AM,48,-122,0,0,0
10973,ElliotBayTrailMyrtlePark,04/03/2015 05:00:00 AM,48,-122,4,8,12
10974,ElliotBayTrailMyrtlePark,04/03/2015 06:00:00 AM,48,-122,18,16,34
10975,ElliotBayTrailMyrtlePark,04/03/2015 07:00:00 AM,48,-122,23,61,84
10976,ElliotBayTrailMyrtlePark,04/03/2015 08:00:00 AM,48,-122,22,114,136
10977,ElliotBayTrailMyrtlePark,04/03/2015 09:00:00 AM,48,-122,15,81,96
10978,ElliotBayTrailMyrtlePark,04/03/2015 10:00:00 AM,48,-122,8,13,21
10979,ElliotBayTrailMyrtlePark,04/03/2015 11:00:00 AM,48,-122,14,25,39
10980,ElliotBayTrailMyrtlePark,04/03/2015 12:00:00 PM,48,-122,12,10,22
10981,ElliotBayTrailMyrtlePark,04/03/2015 01:00:00 PM,48,-122,13,8,21
10982,ElliotBayTrailMyrtlePark,04/03/2015 02:00:00 PM,48,-122,25,8,33
10983,ElliotBayTrailMyrtlePark,04/03/2015 03:00:00 PM,48,-122,28,21,49
10984,ElliotBayTrailMyrtlePark,04/03/2015 04:00:00 PM,48,-122,60,23,83
10985,ElliotBayTrailMyrtlePark,04/03/2015 05:00:00 PM,48,-122,106,39,145
10986,ElliotBayTrailMyrtlePark,04/03/2015 06:00:00 PM,48,-122,79,41,120
10987,ElliotBayTrailMyrtlePark,04/03/2015 07:00:00 PM,48,-122,30,14,44
10988,ElliotBayTrailMyrtlePark,04/03/2015 08:00:00 PM,48,-122,11,5,16
10989,ElliotBayTrailMyrtlePark,04/03/2015 09:00:00 PM,48,-122,6,1,7
10990,ElliotBayTrailMyrtlePark,04/03/2015 10:00:00 PM,48,-122,4,3,7
10991,ElliotBayTrailMyrtlePark,04/03/2015 11:00:00 PM,48,-122,3,1,4
10992,ElliotBayTrailMyrtlePark,04/04/2015 12:00:00 AM,48,-122,2,1,3
10993,ElliotBayTrailMyrtlePark,04/04/2015 01:00:00 AM,48,-122,2,0,2
10994,ElliotBayTrailMyrtlePark,04/04/2015 02:00:00 AM,48,-122,1,0,1
10995,ElliotBayTrailMyrtlePark,04/04/2015 03:00:00 AM,48,-122,0,0,0
10996,ElliotBayTrailMyrtlePark,04/04/2015 04:00:00 AM,48,-122,0,0,0
10997,ElliotBayTrailMyrtlePark,04/04/2015 05:00:00 AM,48,-122,0,1,1
10998,ElliotBayTrailMyrtlePark,04/04/2015 06:00:00 AM,48,-122,1,2,3
10999,ElliotBayTrailMyrtlePark,04/04/2015 07:00:00 AM,48,-122,12,16,28
11000,ElliotBayTrailMyrtlePark,04/04/2015 08:00:00 AM,48,-122,28,32,60
11001,ElliotBayTrailMyrtlePark,04/04/2015 09:00:00 AM,48,-122,13,25,38
11002,ElliotBayTrailMyrtlePark,04/04/2015 10:00:00 AM,48,-122,41,43,84
11003,ElliotBayTrailMyrtlePark,04/04/2015 11:00:00 AM,48,-122,55,56,111
11004,ElliotBayTrailMyrtlePark,04/04/2015 12:00:00 PM,48,-122,42,50,92
11005,ElliotBayTrailMyrtlePark,04/04/2015 01:00:00 PM,48,-122,54,71,125
11006,ElliotBayTrailMyrtlePark,04/04/2015 02:00:00 PM,48,-122,60,32,92
11007,ElliotBayTrailMyrtlePark,04/04/2015 03:00:00 PM,48,-122,61,59,120
11008,ElliotBayTrailMyrtlePark,04/04/2015 04:00:00 PM,48,-122,69,52,121
11009,ElliotBayTrailMyrtlePark,04/04/2015 05:00:00 PM,48,-122,63,55,118
11010,ElliotBayTrailMyrtlePark,04/04/2015 06:00:00 PM,48,-122,52,66,118
11011,ElliotBayTrailMyrtlePark,04/04/2015 07:00:00 PM,48,-122,32,39,71
11012,ElliotBayTrailMyrtlePark,04/04/2015 08:00:00 PM,48,-122,6,8,14
11013,ElliotBayTrailMyrtlePark,04/04/2015 09:00:00 PM,48,-122,27,1,28
11014,ElliotBayTrailMyrtlePark,04/04/2015 10:00:00 PM,48,-122,16,0,16
11015,ElliotBayTrailMyrtlePark,04/04/2015 11:00:00 PM,48,-122,6,1,7
11016,ElliotBayTrailMyrtlePark,04/05/2015 12:00:00 AM,48,-122,1,1,2
11017,ElliotBayTrailMyrtlePark,04/05/2015 01:00:00 AM,48,-122,1,0,1
11018,ElliotBayTrailMyrtlePark,04/05/2015 02:00:00 AM,48,-122,1,0,1
11019,ElliotBayTrailMyrtlePark,04/05/2015 03:00:00 AM,48,-122,1,0,1
11020,ElliotBayTrailMyrtlePark,04/05/2015 04:00:00 AM,48,-122,0,0,0
11021,ElliotBayTrailMyrtlePark,04/05/2015 05:00:00 AM,48,-122,1,1,2
11022,ElliotBayTrailMyrtlePark,04/05/2015 06:00:00 AM,48,-122,1,3,4
11023,ElliotBayTrailMyrtlePark,04/05/2015 07:00:00 AM,48,-122,4,4,8
11024,ElliotBayTrailMyrtlePark,04/05/2015 08:00:00 AM,48,-122,10,9,19
11025,ElliotBayTrailMyrtlePark,04/05/2015 09:00:00 AM,48,-122,37,30,67
11026,ElliotBayTrailMyrtlePark,04/05/2015 10:00:00 AM,48,-122,47,24,71
11027,ElliotBayTrailMyrtlePark,04/05/2015 11:00:00 AM,48,-122,48,39,87
11028,ElliotBayTrailMyrtlePark,04/05/2015 12:00:00 PM,48,-122,61,36,97
11029,ElliotBayTrailMyrtlePark,04/05/2015 01:00:00 PM,48,-122,75,64,139
11030,ElliotBayTrailMyrtlePark,04/05/2015 02:00:00 PM,48,-122,61,58,119
11031,ElliotBayTrailMyrtlePark,04/05/2015 03:00:00 PM,48,-122,60,46,106
11032,ElliotBayTrailMyrtlePark,04/05/2015 04:00:00 PM,48,-122,65,58,123
11033,ElliotBayTrailMyrtlePark,04/05/2015 05:00:00 PM,48,-122,47,54,101
11034,ElliotBayTrailMyrtlePark,04/05/2015 06:00:00 PM,48,-122,29,29,58
11035,ElliotBayTrailMyrtlePark,04/05/2015 07:00:00 PM,48,-122,24,22,46
11036,ElliotBayTrailMyrtlePark,04/05/2015 08:00:00 PM,48,-122,13,12,25
11037,ElliotBayTrailMyrtlePark,04/05/2015 09:00:00 PM,48,-122,1,1,2
11038,ElliotBayTrailMyrtlePark,04/05/2015 10:00:00 PM,48,-122,0,3,3
11039,ElliotBayTrailMyrtlePark,04/05/2015 11:00:00 PM,48,-122,1,0,1
11040,ElliotBayTrailMyrtlePark,04/06/2015 12:00:00 AM,48,-122,0,0,0
11041,ElliotBayTrailMyrtlePark,04/06/2015 01:00:00 AM,48,-122,1,0,1
11042,ElliotBayTrailMyrtlePark,04/06/2015 02:00:00 AM,48,-122,1,0,1
11043,ElliotBayTrailMyrtlePark,04/06/2015 03:00:00 AM,48,-122,1,0,1
11044,ElliotBayTrailMyrtlePark,04/06/2015 04:00:00 AM,48,-122,0,0,0
11045,ElliotBayTrailMyrtlePark,04/06/2015 05:00:00 AM,48,-122,5,18,23
11046,ElliotBayTrailMyrtlePark,04/06/2015 06:00:00 AM,48,-122,17,24,41
11047,ElliotBayTrailMyrtlePark,04/06/2015 07:00:00 AM,48,-122,30,79,109
11048,ElliotBayTrailMyrtlePark,04/06/2015 08:00:00 AM,48,-122,37,127,164
11049,ElliotBayTrailMyrtlePark,04/06/2015 09:00:00 AM,48,-122,21,74,95
11050,ElliotBayTrailMyrtlePark,04/06/2015 10:00:00 AM,48,-122,3,19,22
11051,ElliotBayTrailMyrtlePark,04/06/2015 11:00:00 AM,48,-122,15,23,38
11052,ElliotBayTrailMyrtlePark,04/06/2015 12:00:00 PM,48,-122,7,20,27
11053,ElliotBayTrailMyrtlePark,04/06/2015 01:00:00 PM,48,-122,49,10,59
11054,ElliotBayTrailMyrtlePark,04/06/2015 02:00:00 PM,48,-122,19,27,46
11055,ElliotBayTrailMyrtlePark,04/06/2015 03:00:00 PM,48,-122,30,55,85
11056,ElliotBayTrailMyrtlePark,04/06/2015 04:00:00 PM,48,-122,120,40,160
11057,ElliotBayTrailMyrtlePark,04/06/2015 05:00:00 PM,48,-122,190,49,239
11058,ElliotBayTrailMyrtlePark,04/06/2015 06:00:00 PM,48,-122,131,44,175
11059,ElliotBayTrailMyrtlePark,04/06/2015 07:00:00 PM,48,-122,44,35,79
11060,ElliotBayTrailMyrtlePark,04/06/2015 08:00:00 PM,48,-122,17,8,25
11061,ElliotBayTrailMyrtlePark,04/06/2015 09:00:00 PM,48,-122,2,0,2
11062,ElliotBayTrailMyrtlePark,04/06/2015 10:00:00 PM,48,-122,2,3,5
11063,ElliotBayTrailMyrtlePark,04/06/2015 11:00:00 PM,48,-122,1,0,1
11064,ElliotBayTrailMyrtlePark,04/07/2015 12:00:00 AM,48,-122,0,2,2
11065,ElliotBayTrailMyrtlePark,04/07/2015 01:00:00 AM,48,-122,2,0,2
11066,ElliotBayTrailMyrtlePark,04/07/2015 02:00:00 AM,48,-122,1,0,1
11067,ElliotBayTrailMyrtlePark,04/07/2015 03:00:00 AM,48,-122,2,0,2
11068,ElliotBayTrailMyrtlePark,04/07/2015 04:00:00 AM,48,-122,0,1,1
11069,ElliotBayTrailMyrtlePark,04/07/2015 05:00:00 AM,48,-122,6,14,20
11070,ElliotBayTrailMyrtlePark,04/07/2015 06:00:00 AM,48,-122,20,31,51
11071,ElliotBayTrailMyrtlePark,04/07/2015 07:00:00 AM,48,-122,34,98,132
11072,ElliotBayTrailMyrtlePark,04/07/2015 08:00:00 AM,48,-122,44,159,203
11073,ElliotBayTrailMyrtlePark,04/07/2015 09:00:00 AM,48,-122,17,76,93
11074,ElliotBayTrailMyrtlePark,04/07/2015 10:00:00 AM,48,-122,7,12,19
11075,ElliotBayTrailMyrtlePark,04/07/2015 11:00:00 AM,48,-122,11,9,20
11076,ElliotBayTrailMyrtlePark,04/07/2015 12:00:00 PM,48,-122,8,4,12
11077,ElliotBayTrailMyrtlePark,04/07/2015 01:00:00 PM,48,-122,9,14,23
11078,ElliotBayTrailMyrtlePark,04/07/2015 02:00:00 PM,48,-122,43,22,65
11079,ElliotBayTrailMyrtlePark,04/07/2015 03:00:00 PM,48,-122,36,55,91
11080,ElliotBayTrailMyrtlePark,04/07/2015 04:00:00 PM,48,-122,56,35,91
11081,ElliotBayTrailMyrtlePark,04/07/2015 05:00:00 PM,48,-122,169,74,243
11082,ElliotBayTrailMyrtlePark,04/07/2015 06:00:00 PM,48,-122,118,50,168
11083,ElliotBayTrailMyrtlePark,04/07/2015 07:00:00 PM,48,-122,61,22,83
11084,ElliotBayTrailMyrtlePark,04/07/2015 08:00:00 PM,48,-122,15,9,24
11085,ElliotBayTrailMyrtlePark,04/07/2015 09:00:00 PM,48,-122,7,1,8
11086,ElliotBayTrailMyrtlePark,04/07/2015 10:00:00 PM,48,-122,10,3,13
11087,ElliotBayTrailMyrtlePark,04/07/2015 11:00:00 PM,48,-122,3,0,3
11088,ElliotBayTrailMyrtlePark,04/08/2015 12:00:00 AM,48,-122,5,0,5
11089,ElliotBayTrailMyrtlePark,04/08/2015 01:00:00 AM,48,-122,3,0,3
11090,ElliotBayTrailMyrtlePark,04/08/2015 02:00:00 AM,48,-122,0,1,1
11091,ElliotBayTrailMyrtlePark,04/08/2015 03:00:00 AM,48,-122,0,0,0
11092,ElliotBayTrailMyrtlePark,04/08/2015 04:00:00 AM,48,-122,0,0,0
11093,ElliotBayTrailMyrtlePark,04/08/2015 05:00:00 AM,48,-122,3,18,21
11094,ElliotBayTrailMyrtlePark,04/08/2015 06:00:00 AM,48,-122,20,31,51
11095,ElliotBayTrailMyrtlePark,04/08/2015 07:00:00 AM,48,-122,40,74,114
11096,ElliotBayTrailMyrtlePark,04/08/2015 08:00:00 AM,48,-122,30,123,153
11097,ElliotBayTrailMyrtlePark,04/08/2015 09:00:00 AM,48,-122,15,79,94
11098,ElliotBayTrailMyrtlePark,04/08/2015 10:00:00 AM,48,-122,13,23,36
11099,ElliotBayTrailMyrtlePark,04/08/2015 11:00:00 AM,48,-122,9,18,27
11100,ElliotBayTrailMyrtlePark,04/08/2015 12:00:00 PM,48,-122,18,16,34
11101,ElliotBayTrailMyrtlePark,04/08/2015 01:00:00 PM,48,-122,31,26,57
11102,ElliotBayTrailMyrtlePark,04/08/2015 02:00:00 PM,48,-122,33,32,65
11103,ElliotBayTrailMyrtlePark,04/08/2015 03:00:00 PM,48,-122,50,49,99
11104,ElliotBayTrailMyrtlePark,04/08/2015 04:00:00 PM,48,-122,94,66,160
11105,ElliotBayTrailMyrtlePark,04/08/2015 05:00:00 PM,48,-122,196,112,308
11106,ElliotBayTrailMyrtlePark,04/08/2015 06:00:00 PM,48,-122,124,62,186
11107,ElliotBayTrailMyrtlePark,04/08/2015 07:00:00 PM,48,-122,54,37,91
11108,ElliotBayTrailMyrtlePark,04/08/2015 08:00:00 PM,48,-122,19,21,40
11109,ElliotBayTrailMyrtlePark,04/08/2015 09:00:00 PM,48,-122,3,1,4
11110,ElliotBayTrailMyrtlePark,04/08/2015 10:00:00 PM,48,-122,18,1,19
11111,ElliotBayTrailMyrtlePark,04/08/2015 11:00:00 PM,48,-122,7,2,9
11112,ElliotBayTrailMyrtlePark,04/09/2015 12:00:00 AM,48,-122,2,2,4
11113,ElliotBayTrailMyrtlePark,04/09/2015 01:00:00 AM,48,-122,0,0,0
11114,ElliotBayTrailMyrtlePark,04/09/2015 02:00:00 AM,48,-122,1,0,1
11115,ElliotBayTrailMyrtlePark,04/09/2015 03:00:00 AM,48,-122,0,0,0
11116,ElliotBayTrailMyrtlePark,04/09/2015 04:00:00 AM,48,-122,0,0,0
11117,ElliotBayTrailMyrtlePark,04/09/2015 05:00:00 AM,48,-122,5,14,19
11118,ElliotBayTrailMyrtlePark,04/09/2015 06:00:00 AM,48,-122,24,30,54
11119,ElliotBayTrailMyrtlePark,04/09/2015 07:00:00 AM,48,-122,45,100,145
11120,ElliotBayTrailMyrtlePark,04/09/2015 08:00:00 AM,48,-122,36,158,194
11121,ElliotBayTrailMyrtlePark,04/09/2015 09:00:00 AM,48,-122,21,80,101
11122,ElliotBayTrailMyrtlePark,04/09/2015 10:00:00 AM,48,-122,19,20,39
11123,ElliotBayTrailMyrtlePark,04/09/2015 11:00:00 AM,48,-122,19,21,40
11124,ElliotBayTrailMyrtlePark,04/09/2015 12:00:00 PM,48,-122,27,16,43
11125,ElliotBayTrailMyrtlePark,04/09/2015 01:00:00 PM,48,-122,32,30,62
11126,ElliotBayTrailMyrtlePark,04/09/2015 02:00:00 PM,48,-122,36,46,82
11127,ElliotBayTrailMyrtlePark,04/09/2015 03:00:00 PM,48,-122,56,51,107
11128,ElliotBayTrailMyrtlePark,04/09/2015 04:00:00 PM,48,-122,87,79,166
11129,ElliotBayTrailMyrtlePark,04/09/2015 05:00:00 PM,48,-122,219,88,307
11130,ElliotBayTrailMyrtlePark,04/09/2015 06:00:00 PM,48,-122,159,68,227
11131,ElliotBayTrailMyrtlePark,04/09/2015 07:00:00 PM,48,-122,78,50,128
11132,ElliotBayTrailMyrtlePark,04/09/2015 08:00:00 PM,48,-122,21,20,41
11133,ElliotBayTrailMyrtlePark,04/09/2015 09:00:00 PM,48,-122,9,4,13
11134,ElliotBayTrailMyrtlePark,04/09/2015 10:00:00 PM,48,-122,6,1,7
11135,ElliotBayTrailMyrtlePark,04/09/2015 11:00:00 PM,48,-122,9,0,9
11136,ElliotBayTrailMyrtlePark,04/10/2015 12:00:00 AM,48,-122,2,1,3
11137,ElliotBayTrailMyrtlePark,04/10/2015 01:00:00 AM,48,-122,1,0,1
11138,ElliotBayTrailMyrtlePark,04/10/2015 02:00:00 AM,48,-122,1,0,1
11139,ElliotBayTrailMyrtlePark,04/10/2015 03:00:00 AM,48,-122,0,0,0
11140,ElliotBayTrailMyrtlePark,04/10/2015 04:00:00 AM,48,-122,1,0,1
11141,ElliotBayTrailMyrtlePark,04/10/2015 05:00:00 AM,48,-122,3,13,16
11142,ElliotBayTrailMyrtlePark,04/10/2015 06:00:00 AM,48,-122,16,16,32
11143,ElliotBayTrailMyrtlePark,04/10/2015 07:00:00 AM,48,-122,33,78,111
11144,ElliotBayTrailMyrtlePark,04/10/2015 08:00:00 AM,48,-122,30,123,153
11145,ElliotBayTrailMyrtlePark,04/10/2015 09:00:00 AM,48,-122,19,77,96
11146,ElliotBayTrailMyrtlePark,04/10/2015 10:00:00 AM,48,-122,17,21,38
11147,ElliotBayTrailMyrtlePark,04/10/2015 11:00:00 AM,48,-122,27,15,42
11148,ElliotBayTrailMyrtlePark,04/10/2015 12:00:00 PM,48,-122,12,20,32
11149,ElliotBayTrailMyrtlePark,04/10/2015 01:00:00 PM,48,-122,25,17,42
11150,ElliotBayTrailMyrtlePark,04/10/2015 02:00:00 PM,48,-122,32,24,56
11151,ElliotBayTrailMyrtlePark,04/10/2015 03:00:00 PM,48,-122,35,24,59
11152,ElliotBayTrailMyrtlePark,04/10/2015 04:00:00 PM,48,-122,59,32,91
11153,ElliotBayTrailMyrtlePark,04/10/2015 05:00:00 PM,48,-122,112,30,142
11154,ElliotBayTrailMyrtlePark,04/10/2015 06:00:00 PM,48,-122,66,12,78
11155,ElliotBayTrailMyrtlePark,04/10/2015 07:00:00 PM,48,-122,14,4,18
11156,ElliotBayTrailMyrtlePark,04/10/2015 08:00:00 PM,48,-122,9,3,12
11157,ElliotBayTrailMyrtlePark,04/10/2015 09:00:00 PM,48,-122,4,0,4
11158,ElliotBayTrailMyrtlePark,04/10/2015 10:00:00 PM,48,-122,0,3,3
11159,ElliotBayTrailMyrtlePark,04/10/2015 11:00:00 PM,48,-122,2,1,3
11160,ElliotBayTrailMyrtlePark,04/11/2015 12:00:00 AM,48,-122,3,1,4
11161,ElliotBayTrailMyrtlePark,04/11/2015 01:00:00 AM,48,-122,1,1,2
11162,ElliotBayTrailMyrtlePark,04/11/2015 02:00:00 AM,48,-122,0,0,0
11163,ElliotBayTrailMyrtlePark,04/11/2015 03:00:00 AM,48,-122,0,0,0
11164,ElliotBayTrailMyrtlePark,04/11/2015 04:00:00 AM,48,-122,0,0,0
11165,ElliotBayTrailMyrtlePark,04/11/2015 05:00:00 AM,48,-122,0,2,2
11166,ElliotBayTrailMyrtlePark,04/11/2015 06:00:00 AM,48,-122,1,1,2
11167,ElliotBayTrailMyrtlePark,04/11/2015 07:00:00 AM,48,-122,8,12,20
11168,ElliotBayTrailMyrtlePark,04/11/2015 08:00:00 AM,48,-122,16,11,27
11169,ElliotBayTrailMyrtlePark,04/11/2015 09:00:00 AM,48,-122,14,22,36
11170,ElliotBayTrailMyrtlePark,04/11/2015 10:00:00 AM,48,-122,22,29,51
11171,ElliotBayTrailMyrtlePark,04/11/2015 11:00:00 AM,48,-122,23,28,51
11172,ElliotBayTrailMyrtlePark,04/11/2015 12:00:00 PM,48,-122,26,26,52
11173,ElliotBayTrailMyrtlePark,04/11/2015 01:00:00 PM,48,-122,33,40,73
11174,ElliotBayTrailMyrtlePark,04/11/2015 02:00:00 PM,48,-122,37,55,92
11175,ElliotBayTrailMyrtlePark,04/11/2015 03:00:00 PM,48,-122,22,29,51
11176,ElliotBayTrailMyrtlePark,04/11/2015 04:00:00 PM,48,-122,8,23,31
11177,ElliotBayTrailMyrtlePark,04/11/2015 05:00:00 PM,48,-122,13,9,22
11178,ElliotBayTrailMyrtlePark,04/11/2015 06:00:00 PM,48,-122,19,16,35
11179,ElliotBayTrailMyrtlePark,04/11/2015 07:00:00 PM,48,-122,15,13,28
11180,ElliotBayTrailMyrtlePark,04/11/2015 08:00:00 PM,48,-122,17,8,25
11181,ElliotBayTrailMyrtlePark,04/11/2015 09:00:00 PM,48,-122,1,1,2
11182,ElliotBayTrailMyrtlePark,04/11/2015 10:00:00 PM,48,-122,2,0,2
11183,ElliotBayTrailMyrtlePark,04/11/2015 11:00:00 PM,48,-122,1,0,1
11184,ElliotBayTrailMyrtlePark,04/12/2015 12:00:00 AM,48,-122,2,0,2
11185,ElliotBayTrailMyrtlePark,04/12/2015 01:00:00 AM,48,-122,0,0,0
11186,ElliotBayTrailMyrtlePark,04/12/2015 02:00:00 AM,48,-122,0,1,1
11187,ElliotBayTrailMyrtlePark,04/12/2015 03:00:00 AM,48,-122,1,0,1
11188,ElliotBayTrailMyrtlePark,04/12/2015 04:00:00 AM,48,-122,0,0,0
11189,ElliotBayTrailMyrtlePark,04/12/2015 05:00:00 AM,48,-122,1,1,2
11190,ElliotBayTrailMyrtlePark,04/12/2015 06:00:00 AM,48,-122,0,0,0
11191,ElliotBayTrailMyrtlePark,04/12/2015 07:00:00 AM,48,-122,8,5,13
11192,ElliotBayTrailMyrtlePark,04/12/2015 08:00:00 AM,48,-122,14,17,31
11193,ElliotBayTrailMyrtlePark,04/12/2015 09:00:00 AM,48,-122,25,18,43
11194,ElliotBayTrailMyrtlePark,04/12/2015 10:00:00 AM,48,-122,21,27,48
11195,ElliotBayTrailMyrtlePark,04/12/2015 11:00:00 AM,48,-122,47,39,86
11196,ElliotBayTrailMyrtlePark,04/12/2015 12:00:00 PM,48,-122,42,42,84
11197,ElliotBayTrailMyrtlePark,04/12/2015 01:00:00 PM,48,-122,56,54,110
11198,ElliotBayTrailMyrtlePark,04/12/2015 02:00:00 PM,48,-122,72,56,128
11199,ElliotBayTrailMyrtlePark,04/12/2015 03:00:00 PM,48,-122,44,42,86
11200,ElliotBayTrailMyrtlePark,04/12/2015 04:00:00 PM,48,-122,46,35,81
11201,ElliotBayTrailMyrtlePark,04/12/2015 05:00:00 PM,48,-122,39,36,75
11202,ElliotBayTrailMyrtlePark,04/12/2015 06:00:00 PM,48,-122,29,20,49
11203,ElliotBayTrailMyrtlePark,04/12/2015 07:00:00 PM,48,-122,11,8,19
11204,ElliotBayTrailMyrtlePark,04/12/2015 08:00:00 PM,48,-122,8,10,18
11205,ElliotBayTrailMyrtlePark,04/12/2015 09:00:00 PM,48,-122,0,3,3
11206,ElliotBayTrailMyrtlePark,04/12/2015 10:00:00 PM,48,-122,2,5,7
11207,ElliotBayTrailMyrtlePark,04/12/2015 11:00:00 PM,48,-122,0,1,1
11208,ElliotBayTrailMyrtlePark,04/13/2015 12:00:00 AM,48,-122,0,0,0
11209,ElliotBayTrailMyrtlePark,04/13/2015 01:00:00 AM,48,-122,0,0,0
11210,ElliotBayTrailMyrtlePark,04/13/2015 02:00:00 AM,48,-122,1,1,2
11211,ElliotBayTrailMyrtlePark,04/13/2015 03:00:00 AM,48,-122,1,0,1
11212,ElliotBayTrailMyrtlePark,04/13/2015 04:00:00 AM,48,-122,0,1,1
11213,ElliotBayTrailMyrtlePark,04/13/2015 05:00:00 AM,48,-122,4,11,15
11214,ElliotBayTrailMyrtlePark,04/13/2015 06:00:00 AM,48,-122,15,22,37
11215,ElliotBayTrailMyrtlePark,04/13/2015 07:00:00 AM,48,-122,28,78,106
11216,ElliotBayTrailMyrtlePark,04/13/2015 08:00:00 AM,48,-122,31,98,129
11217,ElliotBayTrailMyrtlePark,04/13/2015 09:00:00 AM,48,-122,23,52,75
11218,ElliotBayTrailMyrtlePark,04/13/2015 10:00:00 AM,48,-122,12,19,31
11219,ElliotBayTrailMyrtlePark,04/13/2015 11:00:00 AM,48,-122,12,6,18
11220,ElliotBayTrailMyrtlePark,04/13/2015 12:00:00 PM,48,-122,10,4,14
11221,ElliotBayTrailMyrtlePark,04/13/2015 01:00:00 PM,48,-122,11,1,12
11222,ElliotBayTrailMyrtlePark,04/13/2015 02:00:00 PM,48,-122,7,9,16
11223,ElliotBayTrailMyrtlePark,04/13/2015 03:00:00 PM,48,-122,16,18,34
11224,ElliotBayTrailMyrtlePark,04/13/2015 04:00:00 PM,48,-122,42,24,66
11225,ElliotBayTrailMyrtlePark,04/13/2015 05:00:00 PM,48,-122,102,30,132
11226,ElliotBayTrailMyrtlePark,04/13/2015 06:00:00 PM,48,-122,55,10,65
11227,ElliotBayTrailMyrtlePark,04/13/2015 07:00:00 PM,48,-122,29,3,32
11228,ElliotBayTrailMyrtlePark,04/13/2015 08:00:00 PM,48,-122,3,1,4
11229,ElliotBayTrailMyrtlePark,04/13/2015 09:00:00 PM,48,-122,1,0,1
11230,ElliotBayTrailMyrtlePark,04/13/2015 10:00:00 PM,48,-122,2,0,2
11231,ElliotBayTrailMyrtlePark,04/13/2015 11:00:00 PM,48,-122,2,0,2
11232,ElliotBayTrailMyrtlePark,04/14/2015 12:00:00 AM,48,-122,1,0,1
11233,ElliotBayTrailMyrtlePark,04/14/2015 01:00:00 AM,48,-122,1,0,1
11234,ElliotBayTrailMyrtlePark,04/14/2015 02:00:00 AM,48,-122,0,0,0
11235,ElliotBayTrailMyrtlePark,04/14/2015 03:00:00 AM,48,-122,0,0,0
11236,ElliotBayTrailMyrtlePark,04/14/2015 04:00:00 AM,48,-122,0,1,1
11237,ElliotBayTrailMyrtlePark,04/14/2015 05:00:00 AM,48,-122,5,8,13
11238,ElliotBayTrailMyrtlePark,04/14/2015 06:00:00 AM,48,-122,11,21,32
11239,ElliotBayTrailMyrtlePark,04/14/2015 07:00:00 AM,48,-122,37,49,86
11240,ElliotBayTrailMyrtlePark,04/14/2015 08:00:00 AM,48,-122,42,99,141
11241,ElliotBayTrailMyrtlePark,04/14/2015 09:00:00 AM,48,-122,23,66,89
11242,ElliotBayTrailMyrtlePark,04/14/2015 10:00:00 AM,48,-122,9,13,22
11243,ElliotBayTrailMyrtlePark,04/14/2015 11:00:00 AM,48,-122,9,13,22
11244,ElliotBayTrailMyrtlePark,04/14/2015 12:00:00 PM,48,-122,20,13,33
11245,ElliotBayTrailMyrtlePark,04/14/2015 01:00:00 PM,48,-122,19,5,24
11246,ElliotBayTrailMyrtlePark,04/14/2015 02:00:00 PM,48,-122,19,30,49
11247,ElliotBayTrailMyrtlePark,04/14/2015 03:00:00 PM,48,-122,20,14,34
11248,ElliotBayTrailMyrtlePark,04/14/2015 04:00:00 PM,48,-122,40,28,68
11249,ElliotBayTrailMyrtlePark,04/14/2015 05:00:00 PM,48,-122,92,33,125
11250,ElliotBayTrailMyrtlePark,04/14/2015 06:00:00 PM,48,-122,87,19,106
11251,ElliotBayTrailMyrtlePark,04/14/2015 07:00:00 PM,48,-122,28,16,44
11252,ElliotBayTrailMyrtlePark,04/14/2015 08:00:00 PM,48,-122,15,6,21
11253,ElliotBayTrailMyrtlePark,04/14/2015 09:00:00 PM,48,-122,0,1,1
11254,ElliotBayTrailMyrtlePark,04/14/2015 10:00:00 PM,48,-122,5,1,6
11255,ElliotBayTrailMyrtlePark,04/14/2015 11:00:00 PM,48,-122,1,1,2
11256,ElliotBayTrailMyrtlePark,04/15/2015 12:00:00 AM,48,-122,1,0,1
11257,ElliotBayTrailMyrtlePark,04/15/2015 01:00:00 AM,48,-122,0,0,0
11258,ElliotBayTrailMyrtlePark,04/15/2015 02:00:00 AM,48,-122,1,0,1
11259,ElliotBayTrailMyrtlePark,04/15/2015 03:00:00 AM,48,-122,0,0,0
11260,ElliotBayTrailMyrtlePark,04/15/2015 04:00:00 AM,48,-122,0,1,1
11261,ElliotBayTrailMyrtlePark,04/15/2015 05:00:00 AM,48,-122,5,11,16
11262,ElliotBayTrailMyrtlePark,04/15/2015 06:00:00 AM,48,-122,21,24,45
11263,ElliotBayTrailMyrtlePark,04/15/2015 07:00:00 AM,48,-122,48,69,117
11264,ElliotBayTrailMyrtlePark,04/15/2015 08:00:00 AM,48,-122,45,158,203
11265,ElliotBayTrailMyrtlePark,04/15/2015 09:00:00 AM,48,-122,31,61,92
11266,ElliotBayTrailMyrtlePark,04/15/2015 10:00:00 AM,48,-122,20,15,35
11267,ElliotBayTrailMyrtlePark,04/15/2015 11:00:00 AM,48,-122,22,19,41
11268,ElliotBayTrailMyrtlePark,04/15/2015 12:00:00 PM,48,-122,17,13,30
11269,ElliotBayTrailMyrtlePark,04/15/2015 01:00:00 PM,48,-122,17,21,38
11270,ElliotBayTrailMyrtlePark,04/15/2015 02:00:00 PM,48,-122,21,32,53
11271,ElliotBayTrailMyrtlePark,04/15/2015 03:00:00 PM,48,-122,45,40,85
11272,ElliotBayTrailMyrtlePark,04/15/2015 04:00:00 PM,48,-122,78,63,141
11273,ElliotBayTrailMyrtlePark,04/15/2015 05:00:00 PM,48,-122,190,78,268
11274,ElliotBayTrailMyrtlePark,04/15/2015 06:00:00 PM,48,-122,122,62,184
11275,ElliotBayTrailMyrtlePark,04/15/2015 07:00:00 PM,48,-122,68,62,130
11276,ElliotBayTrailMyrtlePark,04/15/2015 08:00:00 PM,48,-122,19,19,38
11277,ElliotBayTrailMyrtlePark,04/15/2015 09:00:00 PM,48,-122,9,2,11
11278,ElliotBayTrailMyrtlePark,04/15/2015 10:00:00 PM,48,-122,9,3,12
11279,ElliotBayTrailMyrtlePark,04/15/2015 11:00:00 PM,48,-122,2,3,5
11280,ElliotBayTrailMyrtlePark,04/16/2015 12:00:00 AM,48,-122,1,0,1
11281,ElliotBayTrailMyrtlePark,04/16/2015 01:00:00 AM,48,-122,0,1,1
11282,ElliotBayTrailMyrtlePark,04/16/2015 02:00:00 AM,48,-122,0,0,0
11283,ElliotBayTrailMyrtlePark,04/16/2015 03:00:00 AM,48,-122,0,0,0
11284,ElliotBayTrailMyrtlePark,04/16/2015 04:00:00 AM,48,-122,1,0,1
11285,ElliotBayTrailMyrtlePark,04/16/2015 05:00:00 AM,48,-122,3,10,13
11286,ElliotBayTrailMyrtlePark,04/16/2015 06:00:00 AM,48,-122,20,31,51
11287,ElliotBayTrailMyrtlePark,04/16/2015 07:00:00 AM,48,-122,38,86,124
11288,ElliotBayTrailMyrtlePark,04/16/2015 08:00:00 AM,48,-122,45,170,215
11289,ElliotBayTrailMyrtlePark,04/16/2015 09:00:00 AM,48,-122,32,72,104
11290,ElliotBayTrailMyrtlePark,04/16/2015 10:00:00 AM,48,-122,27,29,56
11291,ElliotBayTrailMyrtlePark,04/16/2015 11:00:00 AM,48,-122,17,19,36
11292,ElliotBayTrailMyrtlePark,04/16/2015 12:00:00 PM,48,-122,28,35,63
11293,ElliotBayTrailMyrtlePark,04/16/2015 01:00:00 PM,48,-122,24,29,53
11294,ElliotBayTrailMyrtlePark,04/16/2015 02:00:00 PM,48,-122,25,35,60
11295,ElliotBayTrailMyrtlePark,04/16/2015 03:00:00 PM,48,-122,49,50,99
11296,ElliotBayTrailMyrtlePark,04/16/2015 04:00:00 PM,48,-122,89,72,161
11297,ElliotBayTrailMyrtlePark,04/16/2015 05:00:00 PM,48,-122,175,78,253
11298,ElliotBayTrailMyrtlePark,04/16/2015 06:00:00 PM,48,-122,161,72,233
11299,ElliotBayTrailMyrtlePark,04/16/2015 07:00:00 PM,48,-122,73,58,131
11300,ElliotBayTrailMyrtlePark,04/16/2015 08:00:00 PM,48,-122,23,24,47
11301,ElliotBayTrailMyrtlePark,04/16/2015 09:00:00 PM,48,-122,5,5,10
11302,ElliotBayTrailMyrtlePark,04/16/2015 10:00:00 PM,48,-122,4,2,6
11303,ElliotBayTrailMyrtlePark,04/16/2015 11:00:00 PM,48,-122,5,2,7
11304,ElliotBayTrailMyrtlePark,04/17/2015 12:00:00 AM,48,-122,2,1,3
11305,ElliotBayTrailMyrtlePark,04/17/2015 01:00:00 AM,48,-122,0,1,1
11306,ElliotBayTrailMyrtlePark,04/17/2015 02:00:00 AM,48,-122,2,0,2
11307,ElliotBayTrailMyrtlePark,04/17/2015 03:00:00 AM,48,-122,1,0,1
11308,ElliotBayTrailMyrtlePark,04/17/2015 04:00:00 AM,48,-122,0,0,0
11309,ElliotBayTrailMyrtlePark,04/17/2015 05:00:00 AM,48,-122,4,12,16
11310,ElliotBayTrailMyrtlePark,04/17/2015 06:00:00 AM,48,-122,19,17,36
11311,ElliotBayTrailMyrtlePark,04/17/2015 07:00:00 AM,48,-122,33,111,144
11312,ElliotBayTrailMyrtlePark,04/17/2015 08:00:00 AM,48,-122,32,119,151
11313,ElliotBayTrailMyrtlePark,04/17/2015 09:00:00 AM,48,-122,18,69,87
11314,ElliotBayTrailMyrtlePark,04/17/2015 10:00:00 AM,48,-122,19,27,46
11315,ElliotBayTrailMyrtlePark,04/17/2015 11:00:00 AM,48,-122,31,25,56
11316,ElliotBayTrailMyrtlePark,04/17/2015 12:00:00 PM,48,-122,24,29,53
11317,ElliotBayTrailMyrtlePark,04/17/2015 01:00:00 PM,48,-122,41,35,76
11318,ElliotBayTrailMyrtlePark,04/17/2015 02:00:00 PM,48,-122,39,44,83
11319,ElliotBayTrailMyrtlePark,04/17/2015 03:00:00 PM,48,-122,64,50,114
11320,ElliotBayTrailMyrtlePark,04/17/2015 04:00:00 PM,48,-122,99,62,161
11321,ElliotBayTrailMyrtlePark,04/17/2015 05:00:00 PM,48,-122,186,101,287
11322,ElliotBayTrailMyrtlePark,04/17/2015 06:00:00 PM,48,-122,111,43,154
11323,ElliotBayTrailMyrtlePark,04/17/2015 07:00:00 PM,48,-122,42,33,75
11324,ElliotBayTrailMyrtlePark,04/17/2015 08:00:00 PM,48,-122,14,18,32
11325,ElliotBayTrailMyrtlePark,04/17/2015 09:00:00 PM,48,-122,14,7,21
11326,ElliotBayTrailMyrtlePark,04/17/2015 10:00:00 PM,48,-122,5,4,9
11327,ElliotBayTrailMyrtlePark,04/17/2015 11:00:00 PM,48,-122,12,1,13
11328,ElliotBayTrailMyrtlePark,04/18/2015 12:00:00 AM,48,-122,1,0,1
11329,ElliotBayTrailMyrtlePark,04/18/2015 01:00:00 AM,48,-122,3,0,3
11330,ElliotBayTrailMyrtlePark,04/18/2015 02:00:00 AM,48,-122,1,0,1
11331,ElliotBayTrailMyrtlePark,04/18/2015 03:00:00 AM,48,-122,1,0,1
11332,ElliotBayTrailMyrtlePark,04/18/2015 04:00:00 AM,48,-122,0,0,0
11333,ElliotBayTrailMyrtlePark,04/18/2015 05:00:00 AM,48,-122,0,1,1
11334,ElliotBayTrailMyrtlePark,04/18/2015 06:00:00 AM,48,-122,2,3,5
11335,ElliotBayTrailMyrtlePark,04/18/2015 07:00:00 AM,48,-122,5,18,23
11336,ElliotBayTrailMyrtlePark,04/18/2015 08:00:00 AM,48,-122,10,12,22
11337,ElliotBayTrailMyrtlePark,04/18/2015 09:00:00 AM,48,-122,42,40,82
11338,ElliotBayTrailMyrtlePark,04/18/2015 10:00:00 AM,48,-122,42,41,83
11339,ElliotBayTrailMyrtlePark,04/18/2015 11:00:00 AM,48,-122,81,73,154
11340,ElliotBayTrailMyrtlePark,04/18/2015 12:00:00 PM,48,-122,87,74,161
11341,ElliotBayTrailMyrtlePark,04/18/2015 01:00:00 PM,48,-122,72,82,154
11342,ElliotBayTrailMyrtlePark,04/18/2015 02:00:00 PM,48,-122,124,68,192
11343,ElliotBayTrailMyrtlePark,04/18/2015 03:00:00 PM,48,-122,111,113,224
11344,ElliotBayTrailMyrtlePark,04/18/2015 04:00:00 PM,48,-122,67,93,160
11345,ElliotBayTrailMyrtlePark,04/18/2015 05:00:00 PM,48,-122,71,71,142
11346,ElliotBayTrailMyrtlePark,04/18/2015 06:00:00 PM,48,-122,55,49,104
11347,ElliotBayTrailMyrtlePark,04/18/2015 07:00:00 PM,48,-122,51,35,86
11348,ElliotBayTrailMyrtlePark,04/18/2015 08:00:00 PM,48,-122,24,21,45
11349,ElliotBayTrailMyrtlePark,04/18/2015 09:00:00 PM,48,-122,9,2,11
11350,ElliotBayTrailMyrtlePark,04/18/2015 10:00:00 PM,48,-122,18,6,24
11351,ElliotBayTrailMyrtlePark,04/18/2015 11:00:00 PM,48,-122,5,2,7
11352,ElliotBayTrailMyrtlePark,04/19/2015 12:00:00 AM,48,-122,6,0,6
11353,ElliotBayTrailMyrtlePark,04/19/2015 01:00:00 AM,48,-122,2,1,3
11354,ElliotBayTrailMyrtlePark,04/19/2015 02:00:00 AM,48,-122,4,0,4
11355,ElliotBayTrailMyrtlePark,04/19/2015 03:00:00 AM,48,-122,2,0,2
11356,ElliotBayTrailMyrtlePark,04/19/2015 04:00:00 AM,48,-122,0,1,1
11357,ElliotBayTrailMyrtlePark,04/19/2015 05:00:00 AM,48,-122,0,1,1
11358,ElliotBayTrailMyrtlePark,04/19/2015 06:00:00 AM,48,-122,1,3,4
11359,ElliotBayTrailMyrtlePark,04/19/2015 07:00:00 AM,48,-122,8,8,16
11360,ElliotBayTrailMyrtlePark,04/19/2015 08:00:00 AM,48,-122,12,17,29
11361,ElliotBayTrailMyrtlePark,04/19/2015 09:00:00 AM,48,-122,46,41,87
11362,ElliotBayTrailMyrtlePark,04/19/2015 10:00:00 AM,48,-122,60,53,113
11363,ElliotBayTrailMyrtlePark,04/19/2015 11:00:00 AM,48,-122,71,62,133
11364,ElliotBayTrailMyrtlePark,04/19/2015 12:00:00 PM,48,-122,86,80,166
11365,ElliotBayTrailMyrtlePark,04/19/2015 01:00:00 PM,48,-122,79,101,180
11366,ElliotBayTrailMyrtlePark,04/19/2015 02:00:00 PM,48,-122,89,102,191
11367,ElliotBayTrailMyrtlePark,04/19/2015 03:00:00 PM,48,-122,139,84,223
11368,ElliotBayTrailMyrtlePark,04/19/2015 04:00:00 PM,48,-122,80,92,172
11369,ElliotBayTrailMyrtlePark,04/19/2015 05:00:00 PM,48,-122,84,63,147
11370,ElliotBayTrailMyrtlePark,04/19/2015 06:00:00 PM,48,-122,52,50,102
11371,ElliotBayTrailMyrtlePark,04/19/2015 07:00:00 PM,48,-122,23,35,58
11372,ElliotBayTrailMyrtlePark,04/19/2015 08:00:00 PM,48,-122,16,23,39
11373,ElliotBayTrailMyrtlePark,04/19/2015 09:00:00 PM,48,-122,1,1,2
11374,ElliotBayTrailMyrtlePark,04/19/2015 10:00:00 PM,48,-122,5,0,5
11375,ElliotBayTrailMyrtlePark,04/19/2015 11:00:00 PM,48,-122,2,1,3
11376,ElliotBayTrailMyrtlePark,04/20/2015 12:00:00 AM,48,-122,0,2,2
11377,ElliotBayTrailMyrtlePark,04/20/2015 01:00:00 AM,48,-122,4,0,4
11378,ElliotBayTrailMyrtlePark,04/20/2015 02:00:00 AM,48,-122,4,0,4
11379,ElliotBayTrailMyrtlePark,04/20/2015 03:00:00 AM,48,-122,3,1,4
11380,ElliotBayTrailMyrtlePark,04/20/2015 04:00:00 AM,48,-122,0,1,1
11381,ElliotBayTrailMyrtlePark,04/20/2015 05:00:00 AM,48,-122,3,8,11
11382,ElliotBayTrailMyrtlePark,04/20/2015 06:00:00 AM,48,-122,22,27,49
11383,ElliotBayTrailMyrtlePark,04/20/2015 07:00:00 AM,48,-122,38,104,142
11384,ElliotBayTrailMyrtlePark,04/20/2015 08:00:00 AM,48,-122,41,186,227
11385,ElliotBayTrailMyrtlePark,04/20/2015 09:00:00 AM,48,-122,34,93,127
11386,ElliotBayTrailMyrtlePark,04/20/2015 10:00:00 AM,48,-122,25,41,66
11387,ElliotBayTrailMyrtlePark,04/20/2015 11:00:00 AM,48,-122,20,26,46
11388,ElliotBayTrailMyrtlePark,04/20/2015 12:00:00 PM,48,-122,41,29,70
11389,ElliotBayTrailMyrtlePark,04/20/2015 01:00:00 PM,48,-122,35,35,70
11390,ElliotBayTrailMyrtlePark,04/20/2015 02:00:00 PM,48,-122,51,45,96
11391,ElliotBayTrailMyrtlePark,04/20/2015 03:00:00 PM,48,-122,59,58,117
11392,ElliotBayTrailMyrtlePark,04/20/2015 04:00:00 PM,48,-122,133,84,217
11393,ElliotBayTrailMyrtlePark,04/20/2015 05:00:00 PM,48,-122,260,113,373
11394,ElliotBayTrailMyrtlePark,04/20/2015 06:00:00 PM,48,-122,211,77,288
11395,ElliotBayTrailMyrtlePark,04/20/2015 07:00:00 PM,48,-122,108,63,171
11396,ElliotBayTrailMyrtlePark,04/20/2015 08:00:00 PM,48,-122,27,40,67
11397,ElliotBayTrailMyrtlePark,04/20/2015 09:00:00 PM,48,-122,2,5,7
11398,ElliotBayTrailMyrtlePark,04/20/2015 10:00:00 PM,48,-122,16,6,22
11399,ElliotBayTrailMyrtlePark,04/20/2015 11:00:00 PM,48,-122,4,0,4
11400,ElliotBayTrailMyrtlePark,04/21/2015 12:00:00 AM,48,-122,2,0,2
11401,ElliotBayTrailMyrtlePark,04/21/2015 01:00:00 AM,48,-122,1,0,1
11402,ElliotBayTrailMyrtlePark,04/21/2015 02:00:00 AM,48,-122,0,0,0
11403,ElliotBayTrailMyrtlePark,04/21/2015 03:00:00 AM,48,-122,2,2,4
11404,ElliotBayTrailMyrtlePark,04/21/2015 04:00:00 AM,48,-122,0,1,1
11405,ElliotBayTrailMyrtlePark,04/21/2015 05:00:00 AM,48,-122,8,13,21
11406,ElliotBayTrailMyrtlePark,04/21/2015 06:00:00 AM,48,-122,20,33,53
11407,ElliotBayTrailMyrtlePark,04/21/2015 07:00:00 AM,48,-122,28,102,130
11408,ElliotBayTrailMyrtlePark,04/21/2015 08:00:00 AM,48,-122,47,161,208
11409,ElliotBayTrailMyrtlePark,04/21/2015 09:00:00 AM,48,-122,28,95,123
11410,ElliotBayTrailMyrtlePark,04/21/2015 10:00:00 AM,48,-122,18,24,42
11411,ElliotBayTrailMyrtlePark,04/21/2015 11:00:00 AM,48,-122,44,21,65
11412,ElliotBayTrailMyrtlePark,04/21/2015 12:00:00 PM,48,-122,17,23,40
11413,ElliotBayTrailMyrtlePark,04/21/2015 01:00:00 PM,48,-122,17,18,35
11414,ElliotBayTrailMyrtlePark,04/21/2015 02:00:00 PM,48,-122,19,31,50
11415,ElliotBayTrailMyrtlePark,04/21/2015 03:00:00 PM,48,-122,48,32,80
11416,ElliotBayTrailMyrtlePark,04/21/2015 04:00:00 PM,48,-122,67,62,129
11417,ElliotBayTrailMyrtlePark,04/21/2015 05:00:00 PM,48,-122,171,34,205
11418,ElliotBayTrailMyrtlePark,04/21/2015 06:00:00 PM,48,-122,123,20,143
11419,ElliotBayTrailMyrtlePark,04/21/2015 07:00:00 PM,48,-122,34,12,46
11420,ElliotBayTrailMyrtlePark,04/21/2015 08:00:00 PM,48,-122,8,2,10
11421,ElliotBayTrailMyrtlePark,04/21/2015 09:00:00 PM,48,-122,3,0,3
11422,ElliotBayTrailMyrtlePark,04/21/2015 10:00:00 PM,48,-122,7,1,8
11423,ElliotBayTrailMyrtlePark,04/21/2015 11:00:00 PM,48,-122,2,1,3
11424,ElliotBayTrailMyrtlePark,04/22/2015 12:00:00 AM,48,-122,0,0,0
11425,ElliotBayTrailMyrtlePark,04/22/2015 01:00:00 AM,48,-122,1,1,2
11426,ElliotBayTrailMyrtlePark,04/22/2015 02:00:00 AM,48,-122,0,0,0
11427,ElliotBayTrailMyrtlePark,04/22/2015 03:00:00 AM,48,-122,1,0,1
11428,ElliotBayTrailMyrtlePark,04/22/2015 04:00:00 AM,48,-122,0,1,1
11429,ElliotBayTrailMyrtlePark,04/22/2015 05:00:00 AM,48,-122,6,9,15
11430,ElliotBayTrailMyrtlePark,04/22/2015 06:00:00 AM,48,-122,12,25,37
11431,ElliotBayTrailMyrtlePark,04/22/2015 07:00:00 AM,48,-122,36,72,108
11432,ElliotBayTrailMyrtlePark,04/22/2015 08:00:00 AM,48,-122,42,128,170
11433,ElliotBayTrailMyrtlePark,04/22/2015 09:00:00 AM,48,-122,28,69,97
11434,ElliotBayTrailMyrtlePark,04/22/2015 10:00:00 AM,48,-122,13,22,35
11435,ElliotBayTrailMyrtlePark,04/22/2015 11:00:00 AM,48,-122,8,10,18
11436,ElliotBayTrailMyrtlePark,04/22/2015 12:00:00 PM,48,-122,27,24,51
11437,ElliotBayTrailMyrtlePark,04/22/2015 01:00:00 PM,48,-122,17,17,34
11438,ElliotBayTrailMyrtlePark,04/22/2015 02:00:00 PM,48,-122,25,21,46
11439,ElliotBayTrailMyrtlePark,04/22/2015 03:00:00 PM,48,-122,43,39,82
11440,ElliotBayTrailMyrtlePark,04/22/2015 04:00:00 PM,48,-122,73,59,132
11441,ElliotBayTrailMyrtlePark,04/22/2015 05:00:00 PM,48,-122,171,82,253
11442,ElliotBayTrailMyrtlePark,04/22/2015 06:00:00 PM,48,-122,120,68,188
11443,ElliotBayTrailMyrtlePark,04/22/2015 07:00:00 PM,48,-122,56,30,86
11444,ElliotBayTrailMyrtlePark,04/22/2015 08:00:00 PM,48,-122,13,11,24
11445,ElliotBayTrailMyrtlePark,04/22/2015 09:00:00 PM,48,-122,7,3,10
11446,ElliotBayTrailMyrtlePark,04/22/2015 10:00:00 PM,48,-122,12,2,14
11447,ElliotBayTrailMyrtlePark,04/22/2015 11:00:00 PM,48,-122,2,0,2
11448,ElliotBayTrailMyrtlePark,04/23/2015 12:00:00 AM,48,-122,0,1,1
11449,ElliotBayTrailMyrtlePark,04/23/2015 01:00:00 AM,48,-122,1,0,1
11450,ElliotBayTrailMyrtlePark,04/23/2015 02:00:00 AM,48,-122,0,0,0
11451,ElliotBayTrailMyrtlePark,04/23/2015 03:00:00 AM,48,-122,1,0,1
11452,ElliotBayTrailMyrtlePark,04/23/2015 04:00:00 AM,48,-122,0,0,0
11453,ElliotBayTrailMyrtlePark,04/23/2015 05:00:00 AM,48,-122,3,9,12
11454,ElliotBayTrailMyrtlePark,04/23/2015 06:00:00 AM,48,-122,14,18,32
11455,ElliotBayTrailMyrtlePark,04/23/2015 07:00:00 AM,48,-122,34,68,102
11456,ElliotBayTrailMyrtlePark,04/23/2015 08:00:00 AM,48,-122,39,119,158
11457,ElliotBayTrailMyrtlePark,04/23/2015 09:00:00 AM,48,-122,18,64,82
11458,ElliotBayTrailMyrtlePark,04/23/2015 10:00:00 AM,48,-122,3,23,26
11459,ElliotBayTrailMyrtlePark,04/23/2015 11:00:00 AM,48,-122,12,13,25
11460,ElliotBayTrailMyrtlePark,04/23/2015 12:00:00 PM,48,-122,10,5,15
11461,ElliotBayTrailMyrtlePark,04/23/2015 01:00:00 PM,48,-122,3,6,9
11462,ElliotBayTrailMyrtlePark,04/23/2015 02:00:00 PM,48,-122,9,11,20
11463,ElliotBayTrailMyrtlePark,04/23/2015 03:00:00 PM,48,-122,14,9,23
11464,ElliotBayTrailMyrtlePark,04/23/2015 04:00:00 PM,48,-122,43,28,71
11465,ElliotBayTrailMyrtlePark,04/23/2015 05:00:00 PM,48,-122,116,29,145
11466,ElliotBayTrailMyrtlePark,04/23/2015 06:00:00 PM,48,-122,94,14,108
11467,ElliotBayTrailMyrtlePark,04/23/2015 07:00:00 PM,48,-122,36,11,47
11468,ElliotBayTrailMyrtlePark,04/23/2015 08:00:00 PM,48,-122,13,3,16
11469,ElliotBayTrailMyrtlePark,04/23/2015 09:00:00 PM,48,-122,4,5,9
11470,ElliotBayTrailMyrtlePark,04/23/2015 10:00:00 PM,48,-122,8,1,9
11471,ElliotBayTrailMyrtlePark,04/23/2015 11:00:00 PM,48,-122,1,0,1
11472,ElliotBayTrailMyrtlePark,04/24/2015 12:00:00 AM,48,-122,1,0,1
11473,ElliotBayTrailMyrtlePark,04/24/2015 01:00:00 AM,48,-122,0,1,1
11474,ElliotBayTrailMyrtlePark,04/24/2015 02:00:00 AM,48,-122,0,0,0
11475,ElliotBayTrailMyrtlePark,04/24/2015 03:00:00 AM,48,-122,1,0,1
11476,ElliotBayTrailMyrtlePark,04/24/2015 04:00:00 AM,48,-122,0,0,0
11477,ElliotBayTrailMyrtlePark,04/24/2015 05:00:00 AM,48,-122,3,10,13
11478,ElliotBayTrailMyrtlePark,04/24/2015 06:00:00 AM,48,-122,10,21,31
11479,ElliotBayTrailMyrtlePark,04/24/2015 07:00:00 AM,48,-122,27,45,72
11480,ElliotBayTrailMyrtlePark,04/24/2015 08:00:00 AM,48,-122,31,98,129
11481,ElliotBayTrailMyrtlePark,04/24/2015 09:00:00 AM,48,-122,19,49,68
11482,ElliotBayTrailMyrtlePark,04/24/2015 10:00:00 AM,48,-122,9,12,21
11483,ElliotBayTrailMyrtlePark,04/24/2015 11:00:00 AM,48,-122,4,11,15
11484,ElliotBayTrailMyrtlePark,04/24/2015 12:00:00 PM,48,-122,12,11,23
11485,ElliotBayTrailMyrtlePark,04/24/2015 01:00:00 PM,48,-122,13,11,24
11486,ElliotBayTrailMyrtlePark,04/24/2015 02:00:00 PM,48,-122,21,13,34
11487,ElliotBayTrailMyrtlePark,04/24/2015 03:00:00 PM,48,-122,29,24,53
11488,ElliotBayTrailMyrtlePark,04/24/2015 04:00:00 PM,48,-122,50,34,84
11489,ElliotBayTrailMyrtlePark,04/24/2015 05:00:00 PM,48,-122,93,26,119
11490,ElliotBayTrailMyrtlePark,04/24/2015 06:00:00 PM,48,-122,69,26,95
11491,ElliotBayTrailMyrtlePark,04/24/2015 07:00:00 PM,48,-122,27,16,43
11492,ElliotBayTrailMyrtlePark,04/24/2015 08:00:00 PM,48,-122,9,8,17
11493,ElliotBayTrailMyrtlePark,04/24/2015 09:00:00 PM,48,-122,7,5,12
11494,ElliotBayTrailMyrtlePark,04/24/2015 10:00:00 PM,48,-122,4,0,4
11495,ElliotBayTrailMyrtlePark,04/24/2015 11:00:00 PM,48,-122,0,0,0
11496,ElliotBayTrailMyrtlePark,04/25/2015 12:00:00 AM,48,-122,1,0,1
11497,ElliotBayTrailMyrtlePark,04/25/2015 01:00:00 AM,48,-122,1,0,1
11498,ElliotBayTrailMyrtlePark,04/25/2015 02:00:00 AM,48,-122,5,0,5
11499,ElliotBayTrailMyrtlePark,04/25/2015 03:00:00 AM,48,-122,0,0,0
11500,ElliotBayTrailMyrtlePark,04/25/2015 04:00:00 AM,48,-122,0,0,0
11501,ElliotBayTrailMyrtlePark,04/25/2015 05:00:00 AM,48,-122,1,1,2
11502,ElliotBayTrailMyrtlePark,04/25/2015 06:00:00 AM,48,-122,0,3,3
11503,ElliotBayTrailMyrtlePark,04/25/2015 07:00:00 AM,48,-122,7,15,22
11504,ElliotBayTrailMyrtlePark,04/25/2015 08:00:00 AM,48,-122,17,26,43
11505,ElliotBayTrailMyrtlePark,04/25/2015 09:00:00 AM,48,-122,14,16,30
11506,ElliotBayTrailMyrtlePark,04/25/2015 10:00:00 AM,48,-122,39,34,73
11507,ElliotBayTrailMyrtlePark,04/25/2015 11:00:00 AM,48,-122,57,57,114
11508,ElliotBayTrailMyrtlePark,04/25/2015 12:00:00 PM,48,-122,35,63,98
11509,ElliotBayTrailMyrtlePark,04/25/2015 01:00:00 PM,48,-122,46,50,96
11510,ElliotBayTrailMyrtlePark,04/25/2015 02:00:00 PM,48,-122,52,51,103
11511,ElliotBayTrailMyrtlePark,04/25/2015 03:00:00 PM,48,-122,59,35,94
11512,ElliotBayTrailMyrtlePark,04/25/2015 04:00:00 PM,48,-122,44,37,81
11513,ElliotBayTrailMyrtlePark,04/25/2015 05:00:00 PM,48,-122,33,32,65
11514,ElliotBayTrailMyrtlePark,04/25/2015 06:00:00 PM,48,-122,33,21,54
11515,ElliotBayTrailMyrtlePark,04/25/2015 07:00:00 PM,48,-122,21,19,40
11516,ElliotBayTrailMyrtlePark,04/25/2015 08:00:00 PM,48,-122,24,29,53
11517,ElliotBayTrailMyrtlePark,04/25/2015 09:00:00 PM,48,-122,5,1,6
11518,ElliotBayTrailMyrtlePark,04/25/2015 10:00:00 PM,48,-122,8,3,11
11519,ElliotBayTrailMyrtlePark,04/25/2015 11:00:00 PM,48,-122,3,2,5
11520,ElliotBayTrailMyrtlePark,04/26/2015 12:00:00 AM,48,-122,0,0,0
11521,ElliotBayTrailMyrtlePark,04/26/2015 01:00:00 AM,48,-122,5,1,6
11522,ElliotBayTrailMyrtlePark,04/26/2015 02:00:00 AM,48,-122,0,2,2
11523,ElliotBayTrailMyrtlePark,04/26/2015 03:00:00 AM,48,-122,2,0,2
11524,ElliotBayTrailMyrtlePark,04/26/2015 04:00:00 AM,48,-122,0,0,0
11525,ElliotBayTrailMyrtlePark,04/26/2015 05:00:00 AM,48,-122,0,2,2
11526,ElliotBayTrailMyrtlePark,04/26/2015 06:00:00 AM,48,-122,1,5,6
11527,ElliotBayTrailMyrtlePark,04/26/2015 07:00:00 AM,48,-122,8,8,16
11528,ElliotBayTrailMyrtlePark,04/26/2015 08:00:00 AM,48,-122,16,11,27
11529,ElliotBayTrailMyrtlePark,04/26/2015 09:00:00 AM,48,-122,21,18,39
11530,ElliotBayTrailMyrtlePark,04/26/2015 10:00:00 AM,48,-122,22,34,56
11531,ElliotBayTrailMyrtlePark,04/26/2015 11:00:00 AM,48,-122,39,53,92
11532,ElliotBayTrailMyrtlePark,04/26/2015 12:00:00 PM,48,-122,53,62,115
11533,ElliotBayTrailMyrtlePark,04/26/2015 01:00:00 PM,48,-122,79,57,136
11534,ElliotBayTrailMyrtlePark,04/26/2015 02:00:00 PM,48,-122,88,47,135
11535,ElliotBayTrailMyrtlePark,04/26/2015 03:00:00 PM,48,-122,64,80,144
11536,ElliotBayTrailMyrtlePark,04/26/2015 04:00:00 PM,48,-122,56,57,113
11537,ElliotBayTrailMyrtlePark,04/26/2015 05:00:00 PM,48,-122,74,68,142
11538,ElliotBayTrailMyrtlePark,04/26/2015 06:00:00 PM,48,-122,34,25,59
11539,ElliotBayTrailMyrtlePark,04/26/2015 07:00:00 PM,48,-122,9,8,17
11540,ElliotBayTrailMyrtlePark,04/26/2015 08:00:00 PM,48,-122,16,4,20
11541,ElliotBayTrailMyrtlePark,04/26/2015 09:00:00 PM,48,-122,14,1,15
11542,ElliotBayTrailMyrtlePark,04/26/2015 10:00:00 PM,48,-122,5,3,8
11543,ElliotBayTrailMyrtlePark,04/26/2015 11:00:00 PM,48,-122,2,1,3
11544,ElliotBayTrailMyrtlePark,04/27/2015 12:00:00 AM,48,-122,2,2,4
11545,ElliotBayTrailMyrtlePark,04/27/2015 01:00:00 AM,48,-122,0,0,0
11546,ElliotBayTrailMyrtlePark,04/27/2015 02:00:00 AM,48,-122,2,0,2
11547,ElliotBayTrailMyrtlePark,04/27/2015 03:00:00 AM,48,-122,1,1,2
11548,ElliotBayTrailMyrtlePark,04/27/2015 04:00:00 AM,48,-122,0,1,1
11549,ElliotBayTrailMyrtlePark,04/27/2015 05:00:00 AM,48,-122,4,11,15
11550,ElliotBayTrailMyrtlePark,04/27/2015 06:00:00 AM,48,-122,20,39,59
11551,ElliotBayTrailMyrtlePark,04/27/2015 07:00:00 AM,48,-122,34,83,117
11552,ElliotBayTrailMyrtlePark,04/27/2015 08:00:00 AM,48,-122,33,182,215
11553,ElliotBayTrailMyrtlePark,04/27/2015 09:00:00 AM,48,-122,27,82,109
11554,ElliotBayTrailMyrtlePark,04/27/2015 10:00:00 AM,48,-122,19,24,43
11555,ElliotBayTrailMyrtlePark,04/27/2015 11:00:00 AM,48,-122,19,20,39
11556,ElliotBayTrailMyrtlePark,04/27/2015 12:00:00 PM,48,-122,25,25,50
11557,ElliotBayTrailMyrtlePark,04/27/2015 01:00:00 PM,48,-122,40,39,79
11558,ElliotBayTrailMyrtlePark,04/27/2015 02:00:00 PM,48,-122,49,45,94
11559,ElliotBayTrailMyrtlePark,04/27/2015 03:00:00 PM,48,-122,61,62,123
11560,ElliotBayTrailMyrtlePark,04/27/2015 04:00:00 PM,48,-122,111,84,195
11561,ElliotBayTrailMyrtlePark,04/27/2015 05:00:00 PM,48,-122,259,118,377
11562,ElliotBayTrailMyrtlePark,04/27/2015 06:00:00 PM,48,-122,190,84,274
11563,ElliotBayTrailMyrtlePark,04/27/2015 07:00:00 PM,48,-122,104,69,173
11564,ElliotBayTrailMyrtlePark,04/27/2015 08:00:00 PM,48,-122,52,50,102
11565,ElliotBayTrailMyrtlePark,04/27/2015 09:00:00 PM,48,-122,5,7,12
11566,ElliotBayTrailMyrtlePark,04/27/2015 10:00:00 PM,48,-122,9,3,12
11567,ElliotBayTrailMyrtlePark,04/27/2015 11:00:00 PM,48,-122,3,1,4
11568,ElliotBayTrailMyrtlePark,04/28/2015 12:00:00 AM,48,-122,4,0,4
11569,ElliotBayTrailMyrtlePark,04/28/2015 01:00:00 AM,48,-122,0,0,0
11570,ElliotBayTrailMyrtlePark,04/28/2015 02:00:00 AM,48,-122,2,0,2
11571,ElliotBayTrailMyrtlePark,04/28/2015 03:00:00 AM,48,-122,1,0,1
11572,ElliotBayTrailMyrtlePark,04/28/2015 04:00:00 AM,48,-122,0,0,0
11573,ElliotBayTrailMyrtlePark,04/28/2015 05:00:00 AM,48,-122,9,15,24
11574,ElliotBayTrailMyrtlePark,04/28/2015 06:00:00 AM,48,-122,17,26,43
11575,ElliotBayTrailMyrtlePark,04/28/2015 07:00:00 AM,48,-122,47,68,115
11576,ElliotBayTrailMyrtlePark,04/28/2015 08:00:00 AM,48,-122,36,127,163
11577,ElliotBayTrailMyrtlePark,04/28/2015 09:00:00 AM,48,-122,29,68,97
11578,ElliotBayTrailMyrtlePark,04/28/2015 10:00:00 AM,48,-122,11,26,37
11579,ElliotBayTrailMyrtlePark,04/28/2015 11:00:00 AM,48,-122,11,11,22
11580,ElliotBayTrailMyrtlePark,04/28/2015 12:00:00 PM,48,-122,15,6,21
11581,ElliotBayTrailMyrtlePark,04/28/2015 01:00:00 PM,48,-122,3,10,13
11582,ElliotBayTrailMyrtlePark,04/28/2015 02:00:00 PM,48,-122,16,12,28
11583,ElliotBayTrailMyrtlePark,04/28/2015 03:00:00 PM,48,-122,22,22,44
11584,ElliotBayTrailMyrtlePark,04/28/2015 04:00:00 PM,48,-122,53,32,85
11585,ElliotBayTrailMyrtlePark,04/28/2015 05:00:00 PM,48,-122,119,37,156
11586,ElliotBayTrailMyrtlePark,04/28/2015 06:00:00 PM,48,-122,92,25,117
11587,ElliotBayTrailMyrtlePark,04/28/2015 07:00:00 PM,48,-122,27,18,45
11588,ElliotBayTrailMyrtlePark,04/28/2015 08:00:00 PM,48,-122,5,8,13
11589,ElliotBayTrailMyrtlePark,04/28/2015 09:00:00 PM,48,-122,1,1,2
11590,ElliotBayTrailMyrtlePark,04/28/2015 10:00:00 PM,48,-122,2,2,4
11591,ElliotBayTrailMyrtlePark,04/28/2015 11:00:00 PM,48,-122,1,0,1
11592,ElliotBayTrailMyrtlePark,04/29/2015 12:00:00 AM,48,-122,0,0,0
11593,ElliotBayTrailMyrtlePark,04/29/2015 01:00:00 AM,48,-122,0,0,0
11594,ElliotBayTrailMyrtlePark,04/29/2015 02:00:00 AM,48,-122,0,0,0
11595,ElliotBayTrailMyrtlePark,04/29/2015 03:00:00 AM,48,-122,0,0,0
11596,ElliotBayTrailMyrtlePark,04/29/2015 04:00:00 AM,48,-122,1,0,1
11597,ElliotBayTrailMyrtlePark,04/29/2015 05:00:00 AM,48,-122,7,13,20
11598,ElliotBayTrailMyrtlePark,04/29/2015 06:00:00 AM,48,-122,15,23,38
11599,ElliotBayTrailMyrtlePark,04/29/2015 07:00:00 AM,48,-122,36,89,125
11600,ElliotBayTrailMyrtlePark,04/29/2015 08:00:00 AM,48,-122,42,134,176
11601,ElliotBayTrailMyrtlePark,04/29/2015 09:00:00 AM,48,-122,19,74,93
11602,ElliotBayTrailMyrtlePark,04/29/2015 10:00:00 AM,48,-122,13,21,34
11603,ElliotBayTrailMyrtlePark,04/29/2015 11:00:00 AM,48,-122,9,17,26
11604,ElliotBayTrailMyrtlePark,04/29/2015 12:00:00 PM,48,-122,22,17,39
11605,ElliotBayTrailMyrtlePark,04/29/2015 01:00:00 PM,48,-122,17,24,41
11606,ElliotBayTrailMyrtlePark,04/29/2015 02:00:00 PM,48,-122,30,19,49
11607,ElliotBayTrailMyrtlePark,04/29/2015 03:00:00 PM,48,-122,34,24,58
11608,ElliotBayTrailMyrtlePark,04/29/2015 04:00:00 PM,48,-122,74,51,125
11609,ElliotBayTrailMyrtlePark,04/29/2015 05:00:00 PM,48,-122,189,74,263
11610,ElliotBayTrailMyrtlePark,04/29/2015 06:00:00 PM,48,-122,157,61,218
11611,ElliotBayTrailMyrtlePark,04/29/2015 07:00:00 PM,48,-122,78,40,118
11612,ElliotBayTrailMyrtlePark,04/29/2015 08:00:00 PM,48,-122,39,31,70
11613,ElliotBayTrailMyrtlePark,04/29/2015 09:00:00 PM,48,-122,9,4,13
11614,ElliotBayTrailMyrtlePark,04/29/2015 10:00:00 PM,48,-122,6,0,6
11615,ElliotBayTrailMyrtlePark,04/29/2015 11:00:00 PM,48,-122,0,3,3
11616,ElliotBayTrailMyrtlePark,04/30/2015 12:00:00 AM,48,-122,3,1,4
11617,ElliotBayTrailMyrtlePark,04/30/2015 01:00:00 AM,48,-122,0,0,0
11618,ElliotBayTrailMyrtlePark,04/30/2015 02:00:00 AM,48,-122,0,0,0
11619,ElliotBayTrailMyrtlePark,04/30/2015 03:00:00 AM,48,-122,0,0,0
11620,ElliotBayTrailMyrtlePark,04/30/2015 04:00:00 AM,48,-122,0,0,0
11621,ElliotBayTrailMyrtlePark,04/30/2015 05:00:00 AM,48,-122,7,17,24
11622,ElliotBayTrailMyrtlePark,04/30/2015 06:00:00 AM,48,-122,15,23,38
11623,ElliotBayTrailMyrtlePark,04/30/2015 07:00:00 AM,48,-122,39,105,144
11624,ElliotBayTrailMyrtlePark,04/30/2015 08:00:00 AM,48,-122,32,147,179
11625,ElliotBayTrailMyrtlePark,04/30/2015 09:00:00 AM,48,-122,16,77,93
11626,ElliotBayTrailMyrtlePark,04/30/2015 10:00:00 AM,48,-122,18,32,50
11627,ElliotBayTrailMyrtlePark,04/30/2015 11:00:00 AM,48,-122,21,19,40
11628,ElliotBayTrailMyrtlePark,04/30/2015 12:00:00 PM,48,-122,20,11,31
11629,ElliotBayTrailMyrtlePark,04/30/2015 01:00:00 PM,48,-122,23,22,45
11630,ElliotBayTrailMyrtlePark,04/30/2015 02:00:00 PM,48,-122,30,35,65
11631,ElliotBayTrailMyrtlePark,04/30/2015 03:00:00 PM,48,-122,42,34,76
11632,ElliotBayTrailMyrtlePark,04/30/2015 04:00:00 PM,48,-122,76,46,122
11633,ElliotBayTrailMyrtlePark,04/30/2015 05:00:00 PM,48,-122,199,69,268
11634,ElliotBayTrailMyrtlePark,04/30/2015 06:00:00 PM,48,-122,134,53,187
11635,ElliotBayTrailMyrtlePark,04/30/2015 07:00:00 PM,48,-122,50,37,87
11636,ElliotBayTrailMyrtlePark,04/30/2015 08:00:00 PM,48,-122,25,15,40
11637,ElliotBayTrailMyrtlePark,04/30/2015 09:00:00 PM,48,-122,3,0,3
11638,ElliotBayTrailMyrtlePark,04/30/2015 10:00:00 PM,48,-122,12,0,12
11639,ElliotBayTrailMyrtlePark,04/30/2015 11:00:00 PM,48,-122,3,3,6
11640,ElliotBayTrailMyrtlePark,05/01/2015 12:00:00 AM,48,-122,3,1,4
11641,ElliotBayTrailMyrtlePark,05/01/2015 01:00:00 AM,48,-122,2,0,2
11642,ElliotBayTrailMyrtlePark,05/01/2015 02:00:00 AM,48,-122,0,0,0
11643,ElliotBayTrailMyrtlePark,05/01/2015 03:00:00 AM,48,-122,3,1,4
11644,ElliotBayTrailMyrtlePark,05/01/2015 04:00:00 AM,48,-122,0,0,0
11645,ElliotBayTrailMyrtlePark,05/01/2015 05:00:00 AM,48,-122,6,14,20
11646,ElliotBayTrailMyrtlePark,05/01/2015 06:00:00 AM,48,-122,27,45,72
11647,ElliotBayTrailMyrtlePark,05/01/2015 07:00:00 AM,48,-122,39,117,156
11648,ElliotBayTrailMyrtlePark,05/01/2015 08:00:00 AM,48,-122,49,197,246
11649,ElliotBayTrailMyrtlePark,05/01/2015 09:00:00 AM,48,-122,28,100,128
11650,ElliotBayTrailMyrtlePark,05/01/2015 10:00:00 AM,48,-122,15,34,49
11651,ElliotBayTrailMyrtlePark,05/01/2015 11:00:00 AM,48,-122,30,14,44
11652,ElliotBayTrailMyrtlePark,05/01/2015 12:00:00 PM,48,-122,26,22,48
11653,ElliotBayTrailMyrtlePark,05/01/2015 01:00:00 PM,48,-122,27,28,55
11654,ElliotBayTrailMyrtlePark,05/01/2015 02:00:00 PM,48,-122,56,40,96
11655,ElliotBayTrailMyrtlePark,05/01/2015 03:00:00 PM,48,-122,95,61,156
11656,ElliotBayTrailMyrtlePark,05/01/2015 04:00:00 PM,48,-122,166,82,248
11657,ElliotBayTrailMyrtlePark,05/01/2015 05:00:00 PM,48,-122,227,58,285
11658,ElliotBayTrailMyrtlePark,05/01/2015 06:00:00 PM,48,-122,148,42,190
11659,ElliotBayTrailMyrtlePark,05/01/2015 07:00:00 PM,48,-122,63,24,87
11660,ElliotBayTrailMyrtlePark,05/01/2015 08:00:00 PM,48,-122,25,22,47
11661,ElliotBayTrailMyrtlePark,05/01/2015 09:00:00 PM,48,-122,8,5,13
11662,ElliotBayTrailMyrtlePark,05/01/2015 10:00:00 PM,48,-122,22,2,24
11663,ElliotBayTrailMyrtlePark,05/01/2015 11:00:00 PM,48,-122,1,6,7
11664,ElliotBayTrailMyrtlePark,05/02/2015 12:00:00 AM,48,-122,2,2,4
11665,ElliotBayTrailMyrtlePark,05/02/2015 01:00:00 AM,48,-122,4,4,8
11666,ElliotBayTrailMyrtlePark,05/02/2015 02:00:00 AM,48,-122,1,0,1
11667,ElliotBayTrailMyrtlePark,05/02/2015 03:00:00 AM,48,-122,1,0,1
11668,ElliotBayTrailMyrtlePark,05/02/2015 04:00:00 AM,48,-122,0,0,0
11669,ElliotBayTrailMyrtlePark,05/02/2015 05:00:00 AM,48,-122,2,1,3
11670,ElliotBayTrailMyrtlePark,05/02/2015 06:00:00 AM,48,-122,8,7,15
11671,ElliotBayTrailMyrtlePark,05/02/2015 07:00:00 AM,48,-122,6,11,17
11672,ElliotBayTrailMyrtlePark,05/02/2015 08:00:00 AM,48,-122,27,27,54
11673,ElliotBayTrailMyrtlePark,05/02/2015 09:00:00 AM,48,-122,53,38,91
11674,ElliotBayTrailMyrtlePark,05/02/2015 10:00:00 AM,48,-122,30,66,96
11675,ElliotBayTrailMyrtlePark,05/02/2015 11:00:00 AM,48,-122,48,86,134
11676,ElliotBayTrailMyrtlePark,05/02/2015 12:00:00 PM,48,-122,63,55,118
11677,ElliotBayTrailMyrtlePark,05/02/2015 01:00:00 PM,48,-122,80,82,162
11678,ElliotBayTrailMyrtlePark,05/02/2015 02:00:00 PM,48,-122,80,71,151
11679,ElliotBayTrailMyrtlePark,05/02/2015 03:00:00 PM,48,-122,103,83,186
11680,ElliotBayTrailMyrtlePark,05/02/2015 04:00:00 PM,48,-122,76,73,149
11681,ElliotBayTrailMyrtlePark,05/02/2015 05:00:00 PM,48,-122,79,84,163
11682,ElliotBayTrailMyrtlePark,05/02/2015 06:00:00 PM,48,-122,30,56,86
11683,ElliotBayTrailMyrtlePark,05/02/2015 07:00:00 PM,48,-122,23,20,43
11684,ElliotBayTrailMyrtlePark,05/02/2015 08:00:00 PM,48,-122,15,21,36
11685,ElliotBayTrailMyrtlePark,05/02/2015 09:00:00 PM,48,-122,12,0,12
11686,ElliotBayTrailMyrtlePark,05/02/2015 10:00:00 PM,48,-122,10,2,12
11687,ElliotBayTrailMyrtlePark,05/02/2015 11:00:00 PM,48,-122,7,2,9
11688,ElliotBayTrailMyrtlePark,05/03/2015 12:00:00 AM,48,-122,10,0,10
11689,ElliotBayTrailMyrtlePark,05/03/2015 01:00:00 AM,48,-122,0,0,0
11690,ElliotBayTrailMyrtlePark,05/03/2015 02:00:00 AM,48,-122,2,0,2
11691,ElliotBayTrailMyrtlePark,05/03/2015 03:00:00 AM,48,-122,0,0,0
11692,ElliotBayTrailMyrtlePark,05/03/2015 04:00:00 AM,48,-122,0,0,0
11693,ElliotBayTrailMyrtlePark,05/03/2015 05:00:00 AM,48,-122,1,2,3
11694,ElliotBayTrailMyrtlePark,05/03/2015 06:00:00 AM,48,-122,5,5,10
11695,ElliotBayTrailMyrtlePark,05/03/2015 07:00:00 AM,48,-122,12,3,15
11696,ElliotBayTrailMyrtlePark,05/03/2015 08:00:00 AM,48,-122,23,18,41
11697,ElliotBayTrailMyrtlePark,05/03/2015 09:00:00 AM,48,-122,37,37,74
11698,ElliotBayTrailMyrtlePark,05/03/2015 10:00:00 AM,48,-122,64,62,126
11699,ElliotBayTrailMyrtlePark,05/03/2015 11:00:00 AM,48,-122,68,103,171
11700,ElliotBayTrailMyrtlePark,05/03/2015 12:00:00 PM,48,-122,51,72,123
11701,ElliotBayTrailMyrtlePark,05/03/2015 01:00:00 PM,48,-122,119,77,196
11702,ElliotBayTrailMyrtlePark,05/03/2015 02:00:00 PM,48,-122,103,93,196
11703,ElliotBayTrailMyrtlePark,05/03/2015 03:00:00 PM,48,-122,126,111,237
11704,ElliotBayTrailMyrtlePark,05/03/2015 04:00:00 PM,48,-122,112,83,195
11705,ElliotBayTrailMyrtlePark,05/03/2015 05:00:00 PM,48,-122,81,90,171
11706,ElliotBayTrailMyrtlePark,05/03/2015 06:00:00 PM,48,-122,51,55,106
11707,ElliotBayTrailMyrtlePark,05/03/2015 07:00:00 PM,48,-122,63,42,105
11708,ElliotBayTrailMyrtlePark,05/03/2015 08:00:00 PM,48,-122,18,21,39
11709,ElliotBayTrailMyrtlePark,05/03/2015 09:00:00 PM,48,-122,5,7,12
11710,ElliotBayTrailMyrtlePark,05/03/2015 10:00:00 PM,48,-122,4,6,10
11711,ElliotBayTrailMyrtlePark,05/03/2015 11:00:00 PM,48,-122,1,2,3
11712,ElliotBayTrailMyrtlePark,05/04/2015 12:00:00 AM,48,-122,0,0,0
11713,ElliotBayTrailMyrtlePark,05/04/2015 01:00:00 AM,48,-122,4,0,4
11714,ElliotBayTrailMyrtlePark,05/04/2015 02:00:00 AM,48,-122,0,1,1
11715,ElliotBayTrailMyrtlePark,05/04/2015 03:00:00 AM,48,-122,1,1,2
11716,ElliotBayTrailMyrtlePark,05/04/2015 04:00:00 AM,48,-122,0,0,0
11717,ElliotBayTrailMyrtlePark,05/04/2015 05:00:00 AM,48,-122,5,12,17
11718,ElliotBayTrailMyrtlePark,05/04/2015 06:00:00 AM,48,-122,32,38,70
11719,ElliotBayTrailMyrtlePark,05/04/2015 07:00:00 AM,48,-122,45,133,178
11720,ElliotBayTrailMyrtlePark,05/04/2015 08:00:00 AM,48,-122,44,212,256
11721,ElliotBayTrailMyrtlePark,05/04/2015 09:00:00 AM,48,-122,31,110,141
11722,ElliotBayTrailMyrtlePark,05/04/2015 10:00:00 AM,48,-122,17,44,61
11723,ElliotBayTrailMyrtlePark,05/04/2015 11:00:00 AM,48,-122,20,23,43
11724,ElliotBayTrailMyrtlePark,05/04/2015 12:00:00 PM,48,-122,22,24,46
11725,ElliotBayTrailMyrtlePark,05/04/2015 01:00:00 PM,48,-122,35,25,60
11726,ElliotBayTrailMyrtlePark,05/04/2015 02:00:00 PM,48,-122,16,28,44
11727,ElliotBayTrailMyrtlePark,05/04/2015 03:00:00 PM,48,-122,51,23,74
11728,ElliotBayTrailMyrtlePark,05/04/2015 04:00:00 PM,48,-122,108,70,178
11729,ElliotBayTrailMyrtlePark,05/04/2015 05:00:00 PM,48,-122,282,101,383
11730,ElliotBayTrailMyrtlePark,05/04/2015 06:00:00 PM,48,-122,210,59,269
11731,ElliotBayTrailMyrtlePark,05/04/2015 07:00:00 PM,48,-122,71,30,101
11732,ElliotBayTrailMyrtlePark,05/04/2015 08:00:00 PM,48,-122,27,21,48
11733,ElliotBayTrailMyrtlePark,05/04/2015 09:00:00 PM,48,-122,8,1,9
11734,ElliotBayTrailMyrtlePark,05/04/2015 10:00:00 PM,48,-122,5,2,7
11735,ElliotBayTrailMyrtlePark,05/04/2015 11:00:00 PM,48,-122,2,1,3
11736,ElliotBayTrailMyrtlePark,05/05/2015 12:00:00 AM,48,-122,0,0,0
11737,ElliotBayTrailMyrtlePark,05/05/2015 01:00:00 AM,48,-122,0,0,0
11738,ElliotBayTrailMyrtlePark,05/05/2015 02:00:00 AM,48,-122,0,0,0
11739,ElliotBayTrailMyrtlePark,05/05/2015 03:00:00 AM,48,-122,1,0,1
11740,ElliotBayTrailMyrtlePark,05/05/2015 04:00:00 AM,48,-122,2,0,2
11741,ElliotBayTrailMyrtlePark,05/05/2015 05:00:00 AM,48,-122,6,16,22
11742,ElliotBayTrailMyrtlePark,05/05/2015 06:00:00 AM,48,-122,18,20,38
11743,ElliotBayTrailMyrtlePark,05/05/2015 07:00:00 AM,48,-122,27,70,97
11744,ElliotBayTrailMyrtlePark,05/05/2015 08:00:00 AM,48,-122,35,144,179
11745,ElliotBayTrailMyrtlePark,05/05/2015 09:00:00 AM,48,-122,20,68,88
11746,ElliotBayTrailMyrtlePark,05/05/2015 10:00:00 AM,48,-122,7,23,30
11747,ElliotBayTrailMyrtlePark,05/05/2015 11:00:00 AM,48,-122,11,10,21
11748,ElliotBayTrailMyrtlePark,05/05/2015 12:00:00 PM,48,-122,7,7,14
11749,ElliotBayTrailMyrtlePark,05/05/2015 01:00:00 PM,48,-122,8,12,20
11750,ElliotBayTrailMyrtlePark,05/05/2015 02:00:00 PM,48,-122,15,8,23
11751,ElliotBayTrailMyrtlePark,05/05/2015 03:00:00 PM,48,-122,24,9,33
11752,ElliotBayTrailMyrtlePark,05/05/2015 04:00:00 PM,48,-122,49,34,83
11753,ElliotBayTrailMyrtlePark,05/05/2015 05:00:00 PM,48,-122,128,31,159
11754,ElliotBayTrailMyrtlePark,05/05/2015 06:00:00 PM,48,-122,99,18,117
11755,ElliotBayTrailMyrtlePark,05/05/2015 07:00:00 PM,48,-122,33,8,41
11756,ElliotBayTrailMyrtlePark,05/05/2015 08:00:00 PM,48,-122,11,4,15
11757,ElliotBayTrailMyrtlePark,05/05/2015 09:00:00 PM,48,-122,6,3,9
11758,ElliotBayTrailMyrtlePark,05/05/2015 10:00:00 PM,48,-122,3,2,5
11759,ElliotBayTrailMyrtlePark,05/05/2015 11:00:00 PM,48,-122,0,0,0
11760,ElliotBayTrailMyrtlePark,05/06/2015 12:00:00 AM,48,-122,0,0,0
11761,ElliotBayTrailMyrtlePark,05/06/2015 01:00:00 AM,48,-122,1,0,1
11762,ElliotBayTrailMyrtlePark,05/06/2015 02:00:00 AM,48,-122,0,0,0
11763,ElliotBayTrailMyrtlePark,05/06/2015 03:00:00 AM,48,-122,1,0,1
11764,ElliotBayTrailMyrtlePark,05/06/2015 04:00:00 AM,48,-122,0,1,1
11765,ElliotBayTrailMyrtlePark,05/06/2015 05:00:00 AM,48,-122,6,12,18
11766,ElliotBayTrailMyrtlePark,05/06/2015 06:00:00 AM,48,-122,18,30,48
11767,ElliotBayTrailMyrtlePark,05/06/2015 07:00:00 AM,48,-122,39,105,144
11768,ElliotBayTrailMyrtlePark,05/06/2015 08:00:00 AM,48,-122,40,210,250
11769,ElliotBayTrailMyrtlePark,05/06/2015 09:00:00 AM,48,-122,32,99,131
11770,ElliotBayTrailMyrtlePark,05/06/2015 10:00:00 AM,48,-122,14,22,36
11771,ElliotBayTrailMyrtlePark,05/06/2015 11:00:00 AM,48,-122,15,11,26
11772,ElliotBayTrailMyrtlePark,05/06/2015 12:00:00 PM,48,-122,9,6,15
11773,ElliotBayTrailMyrtlePark,05/06/2015 01:00:00 PM,48,-122,26,19,45
11774,ElliotBayTrailMyrtlePark,05/06/2015 02:00:00 PM,48,-122,26,24,50
11775,ElliotBayTrailMyrtlePark,05/06/2015 03:00:00 PM,48,-122,30,28,58
11776,ElliotBayTrailMyrtlePark,05/06/2015 04:00:00 PM,48,-122,94,60,154
11777,ElliotBayTrailMyrtlePark,05/06/2015 05:00:00 PM,48,-122,218,65,283
11778,ElliotBayTrailMyrtlePark,05/06/2015 06:00:00 PM,48,-122,167,73,240
11779,ElliotBayTrailMyrtlePark,05/06/2015 07:00:00 PM,48,-122,66,28,94
11780,ElliotBayTrailMyrtlePark,05/06/2015 08:00:00 PM,48,-122,43,26,69
11781,ElliotBayTrailMyrtlePark,05/06/2015 09:00:00 PM,48,-122,4,4,8
11782,ElliotBayTrailMyrtlePark,05/06/2015 10:00:00 PM,48,-122,3,7,10
11783,ElliotBayTrailMyrtlePark,05/06/2015 11:00:00 PM,48,-122,3,2,5
11784,ElliotBayTrailMyrtlePark,05/07/2015 12:00:00 AM,48,-122,0,0,0
11785,ElliotBayTrailMyrtlePark,05/07/2015 01:00:00 AM,48,-122,2,0,2
11786,ElliotBayTrailMyrtlePark,05/07/2015 02:00:00 AM,48,-122,2,0,2
11787,ElliotBayTrailMyrtlePark,05/07/2015 03:00:00 AM,48,-122,0,0,0
11788,ElliotBayTrailMyrtlePark,05/07/2015 04:00:00 AM,48,-122,3,0,3
11789,ElliotBayTrailMyrtlePark,05/07/2015 05:00:00 AM,48,-122,6,13,19
11790,ElliotBayTrailMyrtlePark,05/07/2015 06:00:00 AM,48,-122,28,39,67
11791,ElliotBayTrailMyrtlePark,05/07/2015 07:00:00 AM,48,-122,53,118,171
11792,ElliotBayTrailMyrtlePark,05/07/2015 08:00:00 AM,48,-122,47,221,268
11793,ElliotBayTrailMyrtlePark,05/07/2015 09:00:00 AM,48,-122,39,115,154
11794,ElliotBayTrailMyrtlePark,05/07/2015 10:00:00 AM,48,-122,35,40,75
11795,ElliotBayTrailMyrtlePark,05/07/2015 11:00:00 AM,48,-122,25,33,58
11796,ElliotBayTrailMyrtlePark,05/07/2015 12:00:00 PM,48,-122,40,32,72
11797,ElliotBayTrailMyrtlePark,05/07/2015 01:00:00 PM,48,-122,40,32,72
11798,ElliotBayTrailMyrtlePark,05/07/2015 02:00:00 PM,48,-122,45,39,84
11799,ElliotBayTrailMyrtlePark,05/07/2015 03:00:00 PM,48,-122,48,45,93
11800,ElliotBayTrailMyrtlePark,05/07/2015 04:00:00 PM,48,-122,106,75,181
11801,ElliotBayTrailMyrtlePark,05/07/2015 05:00:00 PM,48,-122,248,106,354
11802,ElliotBayTrailMyrtlePark,05/07/2015 06:00:00 PM,48,-122,212,76,288
11803,ElliotBayTrailMyrtlePark,05/07/2015 07:00:00 PM,48,-122,98,61,159
11804,ElliotBayTrailMyrtlePark,05/07/2015 08:00:00 PM,48,-122,43,34,77
11805,ElliotBayTrailMyrtlePark,05/07/2015 09:00:00 PM,48,-122,18,4,22
11806,ElliotBayTrailMyrtlePark,05/07/2015 10:00:00 PM,48,-122,10,6,16
11807,ElliotBayTrailMyrtlePark,05/07/2015 11:00:00 PM,48,-122,4,2,6
11808,ElliotBayTrailMyrtlePark,05/08/2015 12:00:00 AM,48,-122,3,3,6
11809,ElliotBayTrailMyrtlePark,05/08/2015 01:00:00 AM,48,-122,11,2,13
11810,ElliotBayTrailMyrtlePark,05/08/2015 02:00:00 AM,48,-122,2,0,2
11811,ElliotBayTrailMyrtlePark,05/08/2015 03:00:00 AM,48,-122,2,1,3
11812,ElliotBayTrailMyrtlePark,05/08/2015 04:00:00 AM,48,-122,0,0,0
11813,ElliotBayTrailMyrtlePark,05/08/2015 05:00:00 AM,48,-122,4,15,19
11814,ElliotBayTrailMyrtlePark,05/08/2015 06:00:00 AM,48,-122,27,41,68
11815,ElliotBayTrailMyrtlePark,05/08/2015 07:00:00 AM,48,-122,56,112,168
11816,ElliotBayTrailMyrtlePark,05/08/2015 08:00:00 AM,48,-122,56,226,282
11817,ElliotBayTrailMyrtlePark,05/08/2015 09:00:00 AM,48,-122,34,104,138
11818,ElliotBayTrailMyrtlePark,05/08/2015 10:00:00 AM,48,-122,20,30,50
11819,ElliotBayTrailMyrtlePark,05/08/2015 11:00:00 AM,48,-122,25,24,49
11820,ElliotBayTrailMyrtlePark,05/08/2015 12:00:00 PM,48,-122,33,26,59
11821,ElliotBayTrailMyrtlePark,05/08/2015 01:00:00 PM,48,-122,37,36,73
11822,ElliotBayTrailMyrtlePark,05/08/2015 02:00:00 PM,48,-122,45,36,81
11823,ElliotBayTrailMyrtlePark,05/08/2015 03:00:00 PM,48,-122,71,45,116
11824,ElliotBayTrailMyrtlePark,05/08/2015 04:00:00 PM,48,-122,166,80,246
11825,ElliotBayTrailMyrtlePark,05/08/2015 05:00:00 PM,48,-122,258,82,340
11826,ElliotBayTrailMyrtlePark,05/08/2015 06:00:00 PM,48,-122,146,61,207
11827,ElliotBayTrailMyrtlePark,05/08/2015 07:00:00 PM,48,-122,69,51,120
11828,ElliotBayTrailMyrtlePark,05/08/2015 08:00:00 PM,48,-122,35,34,69
11829,ElliotBayTrailMyrtlePark,05/08/2015 09:00:00 PM,48,-122,12,5,17
11830,ElliotBayTrailMyrtlePark,05/08/2015 10:00:00 PM,48,-122,8,7,15
11831,ElliotBayTrailMyrtlePark,05/08/2015 11:00:00 PM,48,-122,15,1,16
11832,ElliotBayTrailMyrtlePark,05/09/2015 12:00:00 AM,48,-122,2,1,3
11833,ElliotBayTrailMyrtlePark,05/09/2015 01:00:00 AM,48,-122,8,2,10
11834,ElliotBayTrailMyrtlePark,05/09/2015 02:00:00 AM,48,-122,0,0,0
11835,ElliotBayTrailMyrtlePark,05/09/2015 03:00:00 AM,48,-122,3,0,3
11836,ElliotBayTrailMyrtlePark,05/09/2015 04:00:00 AM,48,-122,0,0,0
11837,ElliotBayTrailMyrtlePark,05/09/2015 05:00:00 AM,48,-122,4,8,12
11838,ElliotBayTrailMyrtlePark,05/09/2015 06:00:00 AM,48,-122,8,10,18
11839,ElliotBayTrailMyrtlePark,05/09/2015 07:00:00 AM,48,-122,17,20,37
11840,ElliotBayTrailMyrtlePark,05/09/2015 08:00:00 AM,48,-122,23,35,58
11841,ElliotBayTrailMyrtlePark,05/09/2015 09:00:00 AM,48,-122,36,43,79
11842,ElliotBayTrailMyrtlePark,05/09/2015 10:00:00 AM,48,-122,74,63,137
11843,ElliotBayTrailMyrtlePark,05/09/2015 11:00:00 AM,48,-122,67,67,134
11844,ElliotBayTrailMyrtlePark,05/09/2015 12:00:00 PM,48,-122,76,68,144
11845,ElliotBayTrailMyrtlePark,05/09/2015 01:00:00 PM,48,-122,82,111,193
11846,ElliotBayTrailMyrtlePark,05/09/2015 02:00:00 PM,48,-122,100,85,185
11847,ElliotBayTrailMyrtlePark,05/09/2015 03:00:00 PM,48,-122,115,94,209
11848,ElliotBayTrailMyrtlePark,05/09/2015 04:00:00 PM,48,-122,90,76,166
11849,ElliotBayTrailMyrtlePark,05/09/2015 05:00:00 PM,48,-122,80,62,142
11850,ElliotBayTrailMyrtlePark,05/09/2015 06:00:00 PM,48,-122,73,58,131
11851,ElliotBayTrailMyrtlePark,05/09/2015 07:00:00 PM,48,-122,43,40,83
11852,ElliotBayTrailMyrtlePark,05/09/2015 08:00:00 PM,48,-122,22,41,63
11853,ElliotBayTrailMyrtlePark,05/09/2015 09:00:00 PM,48,-122,11,5,16
11854,ElliotBayTrailMyrtlePark,05/09/2015 10:00:00 PM,48,-122,8,5,13
11855,ElliotBayTrailMyrtlePark,05/09/2015 11:00:00 PM,48,-122,7,2,9
11856,ElliotBayTrailMyrtlePark,05/10/2015 12:00:00 AM,48,-122,1,3,4
11857,ElliotBayTrailMyrtlePark,05/10/2015 01:00:00 AM,48,-122,2,4,6
11858,ElliotBayTrailMyrtlePark,05/10/2015 02:00:00 AM,48,-122,2,1,3
11859,ElliotBayTrailMyrtlePark,05/10/2015 03:00:00 AM,48,-122,2,0,2
11860,ElliotBayTrailMyrtlePark,05/10/2015 04:00:00 AM,48,-122,0,0,0
11861,ElliotBayTrailMyrtlePark,05/10/2015 05:00:00 AM,48,-122,0,3,3
11862,ElliotBayTrailMyrtlePark,05/10/2015 06:00:00 AM,48,-122,4,3,7
11863,ElliotBayTrailMyrtlePark,05/10/2015 07:00:00 AM,48,-122,5,4,9
11864,ElliotBayTrailMyrtlePark,05/10/2015 08:00:00 AM,48,-122,22,15,37
11865,ElliotBayTrailMyrtlePark,05/10/2015 09:00:00 AM,48,-122,25,33,58
11866,ElliotBayTrailMyrtlePark,05/10/2015 10:00:00 AM,48,-122,41,47,88
11867,ElliotBayTrailMyrtlePark,05/10/2015 11:00:00 AM,48,-122,48,76,124
11868,ElliotBayTrailMyrtlePark,05/10/2015 12:00:00 PM,48,-122,75,69,144
11869,ElliotBayTrailMyrtlePark,05/10/2015 01:00:00 PM,48,-122,88,85,173
11870,ElliotBayTrailMyrtlePark,05/10/2015 02:00:00 PM,48,-122,66,87,153
11871,ElliotBayTrailMyrtlePark,05/10/2015 03:00:00 PM,48,-122,92,80,172
11872,ElliotBayTrailMyrtlePark,05/10/2015 04:00:00 PM,48,-122,104,62,166
11873,ElliotBayTrailMyrtlePark,05/10/2015 05:00:00 PM,48,-122,66,40,106
11874,ElliotBayTrailMyrtlePark,05/10/2015 06:00:00 PM,48,-122,54,42,96
11875,ElliotBayTrailMyrtlePark,05/10/2015 07:00:00 PM,48,-122,16,19,35
11876,ElliotBayTrailMyrtlePark,05/10/2015 08:00:00 PM,48,-122,16,26,42
11877,ElliotBayTrailMyrtlePark,05/10/2015 09:00:00 PM,48,-122,2,4,6
11878,ElliotBayTrailMyrtlePark,05/10/2015 10:00:00 PM,48,-122,2,0,2
11879,ElliotBayTrailMyrtlePark,05/10/2015 11:00:00 PM,48,-122,5,1,6
11880,ElliotBayTrailMyrtlePark,05/11/2015 12:00:00 AM,48,-122,0,2,2
11881,ElliotBayTrailMyrtlePark,05/11/2015 01:00:00 AM,48,-122,0,0,0
11882,ElliotBayTrailMyrtlePark,05/11/2015 02:00:00 AM,48,-122,0,0,0
11883,ElliotBayTrailMyrtlePark,05/11/2015 03:00:00 AM,48,-122,1,0,1
11884,ElliotBayTrailMyrtlePark,05/11/2015 04:00:00 AM,48,-122,1,0,1
11885,ElliotBayTrailMyrtlePark,05/11/2015 05:00:00 AM,48,-122,3,13,16
11886,ElliotBayTrailMyrtlePark,05/11/2015 06:00:00 AM,48,-122,23,33,56
11887,ElliotBayTrailMyrtlePark,05/11/2015 07:00:00 AM,48,-122,40,112,152
11888,ElliotBayTrailMyrtlePark,05/11/2015 08:00:00 AM,48,-122,41,200,241
11889,ElliotBayTrailMyrtlePark,05/11/2015 09:00:00 AM,48,-122,30,96,126
11890,ElliotBayTrailMyrtlePark,05/11/2015 10:00:00 AM,48,-122,12,29,41
11891,ElliotBayTrailMyrtlePark,05/11/2015 11:00:00 AM,48,-122,12,16,28
11892,ElliotBayTrailMyrtlePark,05/11/2015 12:00:00 PM,48,-122,4,8,12
11893,ElliotBayTrailMyrtlePark,05/11/2015 01:00:00 PM,48,-122,16,11,27
11894,ElliotBayTrailMyrtlePark,05/11/2015 02:00:00 PM,48,-122,28,21,49
11895,ElliotBayTrailMyrtlePark,05/11/2015 03:00:00 PM,48,-122,25,26,51
11896,ElliotBayTrailMyrtlePark,05/11/2015 04:00:00 PM,48,-122,66,37,103
11897,ElliotBayTrailMyrtlePark,05/11/2015 05:00:00 PM,48,-122,265,48,313
11898,ElliotBayTrailMyrtlePark,05/11/2015 06:00:00 PM,48,-122,178,67,245
11899,ElliotBayTrailMyrtlePark,05/11/2015 07:00:00 PM,48,-122,65,31,96
11900,ElliotBayTrailMyrtlePark,05/11/2015 08:00:00 PM,48,-122,23,20,43
11901,ElliotBayTrailMyrtlePark,05/11/2015 09:00:00 PM,48,-122,9,0,9
11902,ElliotBayTrailMyrtlePark,05/11/2015 10:00:00 PM,48,-122,4,2,6
11903,ElliotBayTrailMyrtlePark,05/11/2015 11:00:00 PM,48,-122,6,1,7
11904,ElliotBayTrailMyrtlePark,05/12/2015 12:00:00 AM,48,-122,1,0,1
11905,ElliotBayTrailMyrtlePark,05/12/2015 01:00:00 AM,48,-122,1,1,2
11906,ElliotBayTrailMyrtlePark,05/12/2015 02:00:00 AM,48,-122,0,0,0
11907,ElliotBayTrailMyrtlePark,05/12/2015 03:00:00 AM,48,-122,0,0,0
11908,ElliotBayTrailMyrtlePark,05/12/2015 04:00:00 AM,48,-122,2,0,2
11909,ElliotBayTrailMyrtlePark,05/12/2015 05:00:00 AM,48,-122,6,14,20
11910,ElliotBayTrailMyrtlePark,05/12/2015 06:00:00 AM,48,-122,15,35,50
11911,ElliotBayTrailMyrtlePark,05/12/2015 07:00:00 AM,48,-122,45,122,167
11912,ElliotBayTrailMyrtlePark,05/12/2015 08:00:00 AM,48,-122,38,200,238
11913,ElliotBayTrailMyrtlePark,05/12/2015 09:00:00 AM,48,-122,23,88,111
11914,ElliotBayTrailMyrtlePark,05/12/2015 10:00:00 AM,48,-122,13,23,36
11915,ElliotBayTrailMyrtlePark,05/12/2015 11:00:00 AM,48,-122,16,20,36
11916,ElliotBayTrailMyrtlePark,05/12/2015 12:00:00 PM,48,-122,11,17,28
11917,ElliotBayTrailMyrtlePark,05/12/2015 01:00:00 PM,48,-122,26,33,59
11918,ElliotBayTrailMyrtlePark,05/12/2015 02:00:00 PM,48,-122,8,20,28
11919,ElliotBayTrailMyrtlePark,05/12/2015 03:00:00 PM,48,-122,25,11,36
11920,ElliotBayTrailMyrtlePark,05/12/2015 04:00:00 PM,48,-122,65,28,93
11921,ElliotBayTrailMyrtlePark,05/12/2015 05:00:00 PM,48,-122,225,50,275
11922,ElliotBayTrailMyrtlePark,05/12/2015 06:00:00 PM,48,-122,149,37,186
11923,ElliotBayTrailMyrtlePark,05/12/2015 07:00:00 PM,48,-122,62,25,87
11924,ElliotBayTrailMyrtlePark,05/12/2015 08:00:00 PM,48,-122,22,10,32
11925,ElliotBayTrailMyrtlePark,05/12/2015 09:00:00 PM,48,-122,8,8,16
11926,ElliotBayTrailMyrtlePark,05/12/2015 10:00:00 PM,48,-122,2,9,11
11927,ElliotBayTrailMyrtlePark,05/12/2015 11:00:00 PM,48,-122,4,0,4
11928,ElliotBayTrailMyrtlePark,05/13/2015 12:00:00 AM,48,-122,2,1,3
11929,ElliotBayTrailMyrtlePark,05/13/2015 01:00:00 AM,48,-122,0,0,0
11930,ElliotBayTrailMyrtlePark,05/13/2015 02:00:00 AM,48,-122,2,0,2
11931,ElliotBayTrailMyrtlePark,05/13/2015 03:00:00 AM,48,-122,1,0,1
11932,ElliotBayTrailMyrtlePark,05/13/2015 04:00:00 AM,48,-122,0,0,0
11933,ElliotBayTrailMyrtlePark,05/13/2015 05:00:00 AM,48,-122,6,14,20
11934,ElliotBayTrailMyrtlePark,05/13/2015 06:00:00 AM,48,-122,23,31,54
11935,ElliotBayTrailMyrtlePark,05/13/2015 07:00:00 AM,48,-122,35,75,110
11936,ElliotBayTrailMyrtlePark,05/13/2015 08:00:00 AM,48,-122,36,126,162
11937,ElliotBayTrailMyrtlePark,05/13/2015 09:00:00 AM,48,-122,31,69,100
11938,ElliotBayTrailMyrtlePark,05/13/2015 10:00:00 AM,48,-122,9,12,21
11939,ElliotBayTrailMyrtlePark,05/13/2015 11:00:00 AM,48,-122,6,12,18
11940,ElliotBayTrailMyrtlePark,05/13/2015 12:00:00 PM,48,-122,7,10,17
11941,ElliotBayTrailMyrtlePark,05/13/2015 01:00:00 PM,48,-122,6,10,16
11942,ElliotBayTrailMyrtlePark,05/13/2015 02:00:00 PM,48,-122,6,9,15
11943,ElliotBayTrailMyrtlePark,05/13/2015 03:00:00 PM,48,-122,13,12,25
11944,ElliotBayTrailMyrtlePark,05/13/2015 04:00:00 PM,48,-122,35,22,57
11945,ElliotBayTrailMyrtlePark,05/13/2015 05:00:00 PM,48,-122,136,38,174
11946,ElliotBayTrailMyrtlePark,05/13/2015 06:00:00 PM,48,-122,89,20,109
11947,ElliotBayTrailMyrtlePark,05/13/2015 07:00:00 PM,48,-122,28,9,37
11948,ElliotBayTrailMyrtlePark,05/13/2015 08:00:00 PM,48,-122,21,5,26
11949,ElliotBayTrailMyrtlePark,05/13/2015 09:00:00 PM,48,-122,10,1,11
11950,ElliotBayTrailMyrtlePark,05/13/2015 10:00:00 PM,48,-122,4,0,4
11951,ElliotBayTrailMyrtlePark,05/13/2015 11:00:00 PM,48,-122,5,0,5
11952,ElliotBayTrailMyrtlePark,05/14/2015 12:00:00 AM,48,-122,1,1,2
11953,ElliotBayTrailMyrtlePark,05/14/2015 01:00:00 AM,48,-122,0,0,0
11954,ElliotBayTrailMyrtlePark,05/14/2015 02:00:00 AM,48,-122,0,0,0
11955,ElliotBayTrailMyrtlePark,05/14/2015 03:00:00 AM,48,-122,1,0,1
11956,ElliotBayTrailMyrtlePark,05/14/2015 04:00:00 AM,48,-122,1,0,1
11957,ElliotBayTrailMyrtlePark,05/14/2015 05:00:00 AM,48,-122,4,11,15
11958,ElliotBayTrailMyrtlePark,05/14/2015 06:00:00 AM,48,-122,20,38,58
11959,ElliotBayTrailMyrtlePark,05/14/2015 07:00:00 AM,48,-122,31,90,121
11960,ElliotBayTrailMyrtlePark,05/14/2015 08:00:00 AM,48,-122,45,156,201
11961,ElliotBayTrailMyrtlePark,05/14/2015 09:00:00 AM,48,-122,25,95,120
11962,ElliotBayTrailMyrtlePark,05/14/2015 10:00:00 AM,48,-122,12,24,36
11963,ElliotBayTrailMyrtlePark,05/14/2015 11:00:00 AM,48,-122,15,18,33
11964,ElliotBayTrailMyrtlePark,05/14/2015 12:00:00 PM,48,-122,17,18,35
11965,ElliotBayTrailMyrtlePark,05/14/2015 01:00:00 PM,48,-122,17,13,30
11966,ElliotBayTrailMyrtlePark,05/14/2015 02:00:00 PM,48,-122,30,27,57
11967,ElliotBayTrailMyrtlePark,05/14/2015 03:00:00 PM,48,-122,40,30,70
11968,ElliotBayTrailMyrtlePark,05/14/2015 04:00:00 PM,48,-122,96,54,150
11969,ElliotBayTrailMyrtlePark,05/14/2015 05:00:00 PM,48,-122,202,70,272
11970,ElliotBayTrailMyrtlePark,05/14/2015 06:00:00 PM,48,-122,150,72,222
11971,ElliotBayTrailMyrtlePark,05/14/2015 07:00:00 PM,48,-122,96,53,149
11972,ElliotBayTrailMyrtlePark,05/14/2015 08:00:00 PM,48,-122,39,38,77
11973,ElliotBayTrailMyrtlePark,05/14/2015 09:00:00 PM,48,-122,9,4,13
11974,ElliotBayTrailMyrtlePark,05/14/2015 10:00:00 PM,48,-122,7,5,12
11975,ElliotBayTrailMyrtlePark,05/14/2015 11:00:00 PM,48,-122,3,2,5
11976,ElliotBayTrailMyrtlePark,05/15/2015 12:00:00 AM,48,-122,4,3,7
11977,ElliotBayTrailMyrtlePark,05/15/2015 01:00:00 AM,48,-122,1,1,2
11978,ElliotBayTrailMyrtlePark,05/15/2015 02:00:00 AM,48,-122,1,0,1
11979,ElliotBayTrailMyrtlePark,05/15/2015 03:00:00 AM,48,-122,1,0,1
11980,ElliotBayTrailMyrtlePark,05/15/2015 04:00:00 AM,48,-122,0,0,0
11981,ElliotBayTrailMyrtlePark,05/15/2015 05:00:00 AM,48,-122,2,15,17
11982,ElliotBayTrailMyrtlePark,05/15/2015 06:00:00 AM,48,-122,26,51,77
11983,ElliotBayTrailMyrtlePark,05/15/2015 07:00:00 AM,48,-122,45,147,192
11984,ElliotBayTrailMyrtlePark,05/15/2015 08:00:00 AM,48,-122,65,242,307
11985,ElliotBayTrailMyrtlePark,05/15/2015 09:00:00 AM,48,-122,61,95,156
11986,ElliotBayTrailMyrtlePark,05/15/2015 10:00:00 AM,48,-122,30,29,59
11987,ElliotBayTrailMyrtlePark,05/15/2015 11:00:00 AM,48,-122,34,20,54
11988,ElliotBayTrailMyrtlePark,05/15/2015 12:00:00 PM,48,-122,22,28,50
11989,ElliotBayTrailMyrtlePark,05/15/2015 01:00:00 PM,48,-122,51,37,88
11990,ElliotBayTrailMyrtlePark,05/15/2015 02:00:00 PM,48,-122,43,43,86
11991,ElliotBayTrailMyrtlePark,05/15/2015 03:00:00 PM,48,-122,98,50,148
11992,ElliotBayTrailMyrtlePark,05/15/2015 04:00:00 PM,48,-122,170,76,246
11993,ElliotBayTrailMyrtlePark,05/15/2015 05:00:00 PM,48,-122,245,82,327
11994,ElliotBayTrailMyrtlePark,05/15/2015 06:00:00 PM,48,-122,157,73,230
11995,ElliotBayTrailMyrtlePark,05/15/2015 07:00:00 PM,48,-122,66,28,94
11996,ElliotBayTrailMyrtlePark,05/15/2015 08:00:00 PM,48,-122,41,24,65
11997,ElliotBayTrailMyrtlePark,05/15/2015 09:00:00 PM,48,-122,9,5,14
11998,ElliotBayTrailMyrtlePark,05/15/2015 10:00:00 PM,48,-122,16,8,24
11999,ElliotBayTrailMyrtlePark,05/15/2015 11:00:00 PM,48,-122,5,2,7
12000,ElliotBayTrailMyrtlePark,05/16/2015 12:00:00 AM,48,-122,1,3,4
12001,ElliotBayTrailMyrtlePark,05/16/2015 01:00:00 AM,48,-122,3,0,3
12002,ElliotBayTrailMyrtlePark,05/16/2015 02:00:00 AM,48,-122,2,0,2
12003,ElliotBayTrailMyrtlePark,05/16/2015 03:00:00 AM,48,-122,2,0,2
12004,ElliotBayTrailMyrtlePark,05/16/2015 04:00:00 AM,48,-122,0,0,0
12005,ElliotBayTrailMyrtlePark,05/16/2015 05:00:00 AM,48,-122,0,1,1
12006,ElliotBayTrailMyrtlePark,05/16/2015 06:00:00 AM,48,-122,2,7,9
12007,ElliotBayTrailMyrtlePark,05/16/2015 07:00:00 AM,48,-122,14,15,29
12008,ElliotBayTrailMyrtlePark,05/16/2015 08:00:00 AM,48,-122,23,36,59
12009,ElliotBayTrailMyrtlePark,05/16/2015 09:00:00 AM,48,-122,27,22,49
12010,ElliotBayTrailMyrtlePark,05/16/2015 10:00:00 AM,48,-122,37,39,76
12011,ElliotBayTrailMyrtlePark,05/16/2015 11:00:00 AM,48,-122,36,38,74
12012,ElliotBayTrailMyrtlePark,05/16/2015 12:00:00 PM,48,-122,34,68,102
12013,ElliotBayTrailMyrtlePark,05/16/2015 01:00:00 PM,48,-122,58,30,88
12014,ElliotBayTrailMyrtlePark,05/16/2015 02:00:00 PM,48,-122,54,26,80
12015,ElliotBayTrailMyrtlePark,05/16/2015 03:00:00 PM,48,-122,47,48,95
12016,ElliotBayTrailMyrtlePark,05/16/2015 04:00:00 PM,48,-122,62,45,107
12017,ElliotBayTrailMyrtlePark,05/16/2015 05:00:00 PM,48,-122,66,39,105
12018,ElliotBayTrailMyrtlePark,05/16/2015 06:00:00 PM,48,-122,35,41,76
12019,ElliotBayTrailMyrtlePark,05/16/2015 07:00:00 PM,48,-122,32,14,46
12020,ElliotBayTrailMyrtlePark,05/16/2015 08:00:00 PM,48,-122,14,26,40
12021,ElliotBayTrailMyrtlePark,05/16/2015 09:00:00 PM,48,-122,17,2,19
12022,ElliotBayTrailMyrtlePark,05/16/2015 10:00:00 PM,48,-122,9,2,11
12023,ElliotBayTrailMyrtlePark,05/16/2015 11:00:00 PM,48,-122,2,3,5
12024,ElliotBayTrailMyrtlePark,05/17/2015 12:00:00 AM,48,-122,2,3,5
12025,ElliotBayTrailMyrtlePark,05/17/2015 01:00:00 AM,48,-122,0,0,0
12026,ElliotBayTrailMyrtlePark,05/17/2015 02:00:00 AM,48,-122,0,0,0
12027,ElliotBayTrailMyrtlePark,05/17/2015 03:00:00 AM,48,-122,1,0,1
12028,ElliotBayTrailMyrtlePark,05/17/2015 04:00:00 AM,48,-122,1,1,2
12029,ElliotBayTrailMyrtlePark,05/17/2015 05:00:00 AM,48,-122,0,2,2
12030,ElliotBayTrailMyrtlePark,05/17/2015 06:00:00 AM,48,-122,4,3,7
12031,ElliotBayTrailMyrtlePark,05/17/2015 07:00:00 AM,48,-122,5,6,11
12032,ElliotBayTrailMyrtlePark,05/17/2015 08:00:00 AM,48,-122,17,24,41
12033,ElliotBayTrailMyrtlePark,05/17/2015 09:00:00 AM,48,-122,40,23,63
12034,ElliotBayTrailMyrtlePark,05/17/2015 10:00:00 AM,48,-122,26,43,69
12035,ElliotBayTrailMyrtlePark,05/17/2015 11:00:00 AM,48,-122,44,36,80
12036,ElliotBayTrailMyrtlePark,05/17/2015 12:00:00 PM,48,-122,46,60,106
12037,ElliotBayTrailMyrtlePark,05/17/2015 01:00:00 PM,48,-122,59,69,128
12038,ElliotBayTrailMyrtlePark,05/17/2015 02:00:00 PM,48,-122,67,53,120
12039,ElliotBayTrailMyrtlePark,05/17/2015 03:00:00 PM,48,-122,69,62,131
12040,ElliotBayTrailMyrtlePark,05/17/2015 04:00:00 PM,48,-122,68,49,117
12041,ElliotBayTrailMyrtlePark,05/17/2015 05:00:00 PM,48,-122,88,63,151
12042,ElliotBayTrailMyrtlePark,05/17/2015 06:00:00 PM,48,-122,64,45,109
12043,ElliotBayTrailMyrtlePark,05/17/2015 07:00:00 PM,48,-122,35,42,77
12044,ElliotBayTrailMyrtlePark,05/17/2015 08:00:00 PM,48,-122,19,40,59
12045,ElliotBayTrailMyrtlePark,05/17/2015 09:00:00 PM,48,-122,10,16,26
12046,ElliotBayTrailMyrtlePark,05/17/2015 10:00:00 PM,48,-122,1,3,4
12047,ElliotBayTrailMyrtlePark,05/17/2015 11:00:00 PM,48,-122,3,1,4
12048,ElliotBayTrailMyrtlePark,05/18/2015 12:00:00 AM,48,-122,2,7,9
12049,ElliotBayTrailMyrtlePark,05/18/2015 01:00:00 AM,48,-122,1,0,1
12050,ElliotBayTrailMyrtlePark,05/18/2015 02:00:00 AM,48,-122,2,1,3
12051,ElliotBayTrailMyrtlePark,05/18/2015 03:00:00 AM,48,-122,2,0,2
12052,ElliotBayTrailMyrtlePark,05/18/2015 04:00:00 AM,48,-122,0,0,0
12053,ElliotBayTrailMyrtlePark,05/18/2015 05:00:00 AM,48,-122,4,11,15
12054,ElliotBayTrailMyrtlePark,05/18/2015 06:00:00 AM,48,-122,20,45,65
12055,ElliotBayTrailMyrtlePark,05/18/2015 07:00:00 AM,48,-122,44,134,178
12056,ElliotBayTrailMyrtlePark,05/18/2015 08:00:00 AM,48,-122,45,214,259
12057,ElliotBayTrailMyrtlePark,05/18/2015 09:00:00 AM,48,-122,48,101,149
12058,ElliotBayTrailMyrtlePark,05/18/2015 10:00:00 AM,48,-122,20,40,60
12059,ElliotBayTrailMyrtlePark,05/18/2015 11:00:00 AM,48,-122,28,27,55
12060,ElliotBayTrailMyrtlePark,05/18/2015 12:00:00 PM,48,-122,30,27,57
12061,ElliotBayTrailMyrtlePark,05/18/2015 01:00:00 PM,48,-122,28,50,78
12062,ElliotBayTrailMyrtlePark,05/18/2015 02:00:00 PM,48,-122,37,25,62
12063,ElliotBayTrailMyrtlePark,05/18/2015 03:00:00 PM,48,-122,65,49,114
12064,ElliotBayTrailMyrtlePark,05/18/2015 04:00:00 PM,48,-122,137,69,206
12065,ElliotBayTrailMyrtlePark,05/18/2015 05:00:00 PM,48,-122,278,102,380
12066,ElliotBayTrailMyrtlePark,05/18/2015 06:00:00 PM,48,-122,224,81,305
12067,ElliotBayTrailMyrtlePark,05/18/2015 07:00:00 PM,48,-122,78,52,130
12068,ElliotBayTrailMyrtlePark,05/18/2015 08:00:00 PM,48,-122,41,29,70
12069,ElliotBayTrailMyrtlePark,05/18/2015 09:00:00 PM,48,-122,15,3,18
12070,ElliotBayTrailMyrtlePark,05/18/2015 10:00:00 PM,48,-122,7,3,10
12071,ElliotBayTrailMyrtlePark,05/18/2015 11:00:00 PM,48,-122,3,0,3
12072,ElliotBayTrailMyrtlePark,05/19/2015 12:00:00 AM,48,-122,2,2,4
12073,ElliotBayTrailMyrtlePark,05/19/2015 01:00:00 AM,48,-122,0,0,0
12074,ElliotBayTrailMyrtlePark,05/19/2015 02:00:00 AM,48,-122,4,0,4
12075,ElliotBayTrailMyrtlePark,05/19/2015 03:00:00 AM,48,-122,1,0,1
12076,ElliotBayTrailMyrtlePark,05/19/2015 04:00:00 AM,48,-122,0,0,0
12077,ElliotBayTrailMyrtlePark,05/19/2015 05:00:00 AM,48,-122,5,15,20
12078,ElliotBayTrailMyrtlePark,05/19/2015 06:00:00 AM,48,-122,19,48,67
12079,ElliotBayTrailMyrtlePark,05/19/2015 07:00:00 AM,48,-122,52,143,195
12080,ElliotBayTrailMyrtlePark,05/19/2015 08:00:00 AM,48,-122,50,237,287
12081,ElliotBayTrailMyrtlePark,05/19/2015 09:00:00 AM,48,-122,38,113,151
12082,ElliotBayTrailMyrtlePark,05/19/2015 10:00:00 AM,48,-122,24,36,60
12083,ElliotBayTrailMyrtlePark,05/19/2015 11:00:00 AM,48,-122,18,28,46
12084,ElliotBayTrailMyrtlePark,05/19/2015 12:00:00 PM,48,-122,20,19,39
12085,ElliotBayTrailMyrtlePark,05/19/2015 01:00:00 PM,48,-122,35,21,56
12086,ElliotBayTrailMyrtlePark,05/19/2015 02:00:00 PM,48,-122,43,33,76
12087,ElliotBayTrailMyrtlePark,05/19/2015 03:00:00 PM,48,-122,64,40,104
12088,ElliotBayTrailMyrtlePark,05/19/2015 04:00:00 PM,48,-122,147,72,219
12089,ElliotBayTrailMyrtlePark,05/19/2015 05:00:00 PM,48,-122,259,88,347
12090,ElliotBayTrailMyrtlePark,05/19/2015 06:00:00 PM,48,-122,202,69,271
12091,ElliotBayTrailMyrtlePark,05/19/2015 07:00:00 PM,48,-122,94,62,156
12092,ElliotBayTrailMyrtlePark,05/19/2015 08:00:00 PM,48,-122,45,33,78
12093,ElliotBayTrailMyrtlePark,05/19/2015 09:00:00 PM,48,-122,13,15,28
12094,ElliotBayTrailMyrtlePark,05/19/2015 10:00:00 PM,48,-122,14,9,23
12095,ElliotBayTrailMyrtlePark,05/19/2015 11:00:00 PM,48,-122,2,1,3
12096,ElliotBayTrailMyrtlePark,05/20/2015 12:00:00 AM,48,-122,0,0,0
12097,ElliotBayTrailMyrtlePark,05/20/2015 01:00:00 AM,48,-122,0,0,0
12098,ElliotBayTrailMyrtlePark,05/20/2015 02:00:00 AM,48,-122,2,0,2
12099,ElliotBayTrailMyrtlePark,05/20/2015 03:00:00 AM,48,-122,0,0,0
12100,ElliotBayTrailMyrtlePark,05/20/2015 04:00:00 AM,48,-122,0,0,0
12101,ElliotBayTrailMyrtlePark,05/20/2015 05:00:00 AM,48,-122,6,9,15
12102,ElliotBayTrailMyrtlePark,05/20/2015 06:00:00 AM,48,-122,15,48,63
12103,ElliotBayTrailMyrtlePark,05/20/2015 07:00:00 AM,48,-122,52,127,179
12104,ElliotBayTrailMyrtlePark,05/20/2015 08:00:00 AM,48,-122,52,191,243
12105,ElliotBayTrailMyrtlePark,05/20/2015 09:00:00 AM,48,-122,23,120,143
12106,ElliotBayTrailMyrtlePark,05/20/2015 10:00:00 AM,48,-122,23,25,48
12107,ElliotBayTrailMyrtlePark,05/20/2015 11:00:00 AM,48,-122,10,22,32
12108,ElliotBayTrailMyrtlePark,05/20/2015 12:00:00 PM,48,-122,32,27,59
12109,ElliotBayTrailMyrtlePark,05/20/2015 01:00:00 PM,48,-122,24,20,44
12110,ElliotBayTrailMyrtlePark,05/20/2015 02:00:00 PM,48,-122,33,41,74
12111,ElliotBayTrailMyrtlePark,05/20/2015 03:00:00 PM,48,-122,54,47,101
12112,ElliotBayTrailMyrtlePark,05/20/2015 04:00:00 PM,48,-122,133,70,203
12113,ElliotBayTrailMyrtlePark,05/20/2015 05:00:00 PM,48,-122,263,98,361
12114,ElliotBayTrailMyrtlePark,05/20/2015 06:00:00 PM,48,-122,231,96,327
12115,ElliotBayTrailMyrtlePark,05/20/2015 07:00:00 PM,48,-122,77,65,142
12116,ElliotBayTrailMyrtlePark,05/20/2015 08:00:00 PM,48,-122,71,34,105
12117,ElliotBayTrailMyrtlePark,05/20/2015 09:00:00 PM,48,-122,19,12,31
12118,ElliotBayTrailMyrtlePark,05/20/2015 10:00:00 PM,48,-122,4,14,18
12119,ElliotBayTrailMyrtlePark,05/20/2015 11:00:00 PM,48,-122,3,2,5
12120,ElliotBayTrailMyrtlePark,05/21/2015 12:00:00 AM,48,-122,3,1,4
12121,ElliotBayTrailMyrtlePark,05/21/2015 01:00:00 AM,48,-122,1,2,3
12122,ElliotBayTrailMyrtlePark,05/21/2015 02:00:00 AM,48,-122,2,0,2
12123,ElliotBayTrailMyrtlePark,05/21/2015 03:00:00 AM,48,-122,1,1,2
12124,ElliotBayTrailMyrtlePark,05/21/2015 04:00:00 AM,48,-122,0,1,1
12125,ElliotBayTrailMyrtlePark,05/21/2015 05:00:00 AM,48,-122,3,13,16
12126,ElliotBayTrailMyrtlePark,05/21/2015 06:00:00 AM,48,-122,26,44,70
12127,ElliotBayTrailMyrtlePark,05/21/2015 07:00:00 AM,48,-122,52,138,190
12128,ElliotBayTrailMyrtlePark,05/21/2015 08:00:00 AM,48,-122,62,203,265
12129,ElliotBayTrailMyrtlePark,05/21/2015 09:00:00 AM,48,-122,28,111,139
12130,ElliotBayTrailMyrtlePark,05/21/2015 10:00:00 AM,48,-122,22,38,60
12131,ElliotBayTrailMyrtlePark,05/21/2015 11:00:00 AM,48,-122,24,27,51
12132,ElliotBayTrailMyrtlePark,05/21/2015 12:00:00 PM,48,-122,35,30,65
12133,ElliotBayTrailMyrtlePark,05/21/2015 01:00:00 PM,48,-122,32,28,60
12134,ElliotBayTrailMyrtlePark,05/21/2015 02:00:00 PM,48,-122,51,42,93
12135,ElliotBayTrailMyrtlePark,05/21/2015 03:00:00 PM,48,-122,62,48,110
12136,ElliotBayTrailMyrtlePark,05/21/2015 04:00:00 PM,48,-122,111,69,180
12137,ElliotBayTrailMyrtlePark,05/21/2015 05:00:00 PM,48,-122,266,110,376
12138,ElliotBayTrailMyrtlePark,05/21/2015 06:00:00 PM,48,-122,177,69,246
12139,ElliotBayTrailMyrtlePark,05/21/2015 07:00:00 PM,48,-122,144,39,183
12140,ElliotBayTrailMyrtlePark,05/21/2015 08:00:00 PM,48,-122,52,30,82
12141,ElliotBayTrailMyrtlePark,05/21/2015 09:00:00 PM,48,-122,11,7,18
12142,ElliotBayTrailMyrtlePark,05/21/2015 10:00:00 PM,48,-122,8,17,25
12143,ElliotBayTrailMyrtlePark,05/21/2015 11:00:00 PM,48,-122,7,1,8
12144,ElliotBayTrailMyrtlePark,05/22/2015 12:00:00 AM,48,-122,1,3,4
12145,ElliotBayTrailMyrtlePark,05/22/2015 01:00:00 AM,48,-122,0,0,0
12146,ElliotBayTrailMyrtlePark,05/22/2015 02:00:00 AM,48,-122,0,0,0
12147,ElliotBayTrailMyrtlePark,05/22/2015 03:00:00 AM,48,-122,3,0,3
12148,ElliotBayTrailMyrtlePark,05/22/2015 04:00:00 AM,48,-122,0,1,1
12149,ElliotBayTrailMyrtlePark,05/22/2015 05:00:00 AM,48,-122,2,10,12
12150,ElliotBayTrailMyrtlePark,05/22/2015 06:00:00 AM,48,-122,25,29,54
12151,ElliotBayTrailMyrtlePark,05/22/2015 07:00:00 AM,48,-122,38,93,131
12152,ElliotBayTrailMyrtlePark,05/22/2015 08:00:00 AM,48,-122,45,168,213
12153,ElliotBayTrailMyrtlePark,05/22/2015 09:00:00 AM,48,-122,32,87,119
12154,ElliotBayTrailMyrtlePark,05/22/2015 10:00:00 AM,48,-122,27,21,48
12155,ElliotBayTrailMyrtlePark,05/22/2015 11:00:00 AM,48,-122,19,31,50
12156,ElliotBayTrailMyrtlePark,05/22/2015 12:00:00 PM,48,-122,26,21,47
12157,ElliotBayTrailMyrtlePark,05/22/2015 01:00:00 PM,48,-122,35,25,60
12158,ElliotBayTrailMyrtlePark,05/22/2015 02:00:00 PM,48,-122,42,42,84
12159,ElliotBayTrailMyrtlePark,05/22/2015 03:00:00 PM,48,-122,48,36,84
12160,ElliotBayTrailMyrtlePark,05/22/2015 04:00:00 PM,48,-122,105,62,167
12161,ElliotBayTrailMyrtlePark,05/22/2015 05:00:00 PM,48,-122,175,65,240
12162,ElliotBayTrailMyrtlePark,05/22/2015 06:00:00 PM,48,-122,103,39,142
12163,ElliotBayTrailMyrtlePark,05/22/2015 07:00:00 PM,48,-122,42,24,66
12164,ElliotBayTrailMyrtlePark,05/22/2015 08:00:00 PM,48,-122,31,20,51
12165,ElliotBayTrailMyrtlePark,05/22/2015 09:00:00 PM,48,-122,3,7,10
12166,ElliotBayTrailMyrtlePark,05/22/2015 10:00:00 PM,48,-122,8,1,9
12167,ElliotBayTrailMyrtlePark,05/22/2015 11:00:00 PM,48,-122,6,1,7
12168,ElliotBayTrailMyrtlePark,05/23/2015 12:00:00 AM,48,-122,2,4,6
12169,ElliotBayTrailMyrtlePark,05/23/2015 01:00:00 AM,48,-122,0,0,0
12170,ElliotBayTrailMyrtlePark,05/23/2015 02:00:00 AM,48,-122,2,0,2
12171,ElliotBayTrailMyrtlePark,05/23/2015 03:00:00 AM,48,-122,1,0,1
12172,ElliotBayTrailMyrtlePark,05/23/2015 04:00:00 AM,48,-122,0,1,1
12173,ElliotBayTrailMyrtlePark,05/23/2015 05:00:00 AM,48,-122,2,3,5
12174,ElliotBayTrailMyrtlePark,05/23/2015 06:00:00 AM,48,-122,5,5,10
12175,ElliotBayTrailMyrtlePark,05/23/2015 07:00:00 AM,48,-122,7,17,24
12176,ElliotBayTrailMyrtlePark,05/23/2015 08:00:00 AM,48,-122,19,15,34
12177,ElliotBayTrailMyrtlePark,05/23/2015 09:00:00 AM,48,-122,22,19,41
12178,ElliotBayTrailMyrtlePark,05/23/2015 10:00:00 AM,48,-122,34,21,55
12179,ElliotBayTrailMyrtlePark,05/23/2015 11:00:00 AM,48,-122,28,29,57
12180,ElliotBayTrailMyrtlePark,05/23/2015 12:00:00 PM,48,-122,40,20,60
12181,ElliotBayTrailMyrtlePark,05/23/2015 01:00:00 PM,48,-122,47,25,72
12182,ElliotBayTrailMyrtlePark,05/23/2015 02:00:00 PM,48,-122,35,42,77
12183,ElliotBayTrailMyrtlePark,05/23/2015 03:00:00 PM,48,-122,57,25,82
12184,ElliotBayTrailMyrtlePark,05/23/2015 04:00:00 PM,48,-122,38,47,85
12185,ElliotBayTrailMyrtlePark,05/23/2015 05:00:00 PM,48,-122,35,34,69
12186,ElliotBayTrailMyrtlePark,05/23/2015 06:00:00 PM,48,-122,21,35,56
12187,ElliotBayTrailMyrtlePark,05/23/2015 07:00:00 PM,48,-122,29,19,48
12188,ElliotBayTrailMyrtlePark,05/23/2015 08:00:00 PM,48,-122,26,35,61
12189,ElliotBayTrailMyrtlePark,05/23/2015 09:00:00 PM,48,-122,32,20,52
12190,ElliotBayTrailMyrtlePark,05/23/2015 10:00:00 PM,48,-122,6,4,10
12191,ElliotBayTrailMyrtlePark,05/23/2015 11:00:00 PM,48,-122,5,3,8
12192,ElliotBayTrailMyrtlePark,05/24/2015 12:00:00 AM,48,-122,5,1,6
12193,ElliotBayTrailMyrtlePark,05/24/2015 01:00:00 AM,48,-122,3,0,3
12194,ElliotBayTrailMyrtlePark,05/24/2015 02:00:00 AM,48,-122,2,0,2
12195,ElliotBayTrailMyrtlePark,05/24/2015 03:00:00 AM,48,-122,0,1,1
12196,ElliotBayTrailMyrtlePark,05/24/2015 04:00:00 AM,48,-122,1,2,3
12197,ElliotBayTrailMyrtlePark,05/24/2015 05:00:00 AM,48,-122,0,4,4
12198,ElliotBayTrailMyrtlePark,05/24/2015 06:00:00 AM,48,-122,4,7,11
12199,ElliotBayTrailMyrtlePark,05/24/2015 07:00:00 AM,48,-122,2,11,13
12200,ElliotBayTrailMyrtlePark,05/24/2015 08:00:00 AM,48,-122,13,14,27
12201,ElliotBayTrailMyrtlePark,05/24/2015 09:00:00 AM,48,-122,29,32,61
12202,ElliotBayTrailMyrtlePark,05/24/2015 10:00:00 AM,48,-122,36,42,78
12203,ElliotBayTrailMyrtlePark,05/24/2015 11:00:00 AM,48,-122,35,45,80
12204,ElliotBayTrailMyrtlePark,05/24/2015 12:00:00 PM,48,-122,51,41,92
12205,ElliotBayTrailMyrtlePark,05/24/2015 01:00:00 PM,48,-122,66,39,105
12206,ElliotBayTrailMyrtlePark,05/24/2015 02:00:00 PM,48,-122,70,40,110
12207,ElliotBayTrailMyrtlePark,05/24/2015 03:00:00 PM,48,-122,55,60,115
12208,ElliotBayTrailMyrtlePark,05/24/2015 04:00:00 PM,48,-122,70,37,107
12209,ElliotBayTrailMyrtlePark,05/24/2015 05:00:00 PM,48,-122,47,45,92
12210,ElliotBayTrailMyrtlePark,05/24/2015 06:00:00 PM,48,-122,43,19,62
12211,ElliotBayTrailMyrtlePark,05/24/2015 07:00:00 PM,48,-122,17,21,38
12212,ElliotBayTrailMyrtlePark,05/24/2015 08:00:00 PM,48,-122,20,13,33
12213,ElliotBayTrailMyrtlePark,05/24/2015 09:00:00 PM,48,-122,6,6,12
12214,ElliotBayTrailMyrtlePark,05/24/2015 10:00:00 PM,48,-122,8,10,18
12215,ElliotBayTrailMyrtlePark,05/24/2015 11:00:00 PM,48,-122,2,4,6
12216,ElliotBayTrailMyrtlePark,05/25/2015 12:00:00 AM,48,-122,1,1,2
12217,ElliotBayTrailMyrtlePark,05/25/2015 01:00:00 AM,48,-122,0,1,1
12218,ElliotBayTrailMyrtlePark,05/25/2015 02:00:00 AM,48,-122,2,2,4
12219,ElliotBayTrailMyrtlePark,05/25/2015 03:00:00 AM,48,-122,1,0,1
12220,ElliotBayTrailMyrtlePark,05/25/2015 04:00:00 AM,48,-122,0,0,0
12221,ElliotBayTrailMyrtlePark,05/25/2015 05:00:00 AM,48,-122,0,2,2
12222,ElliotBayTrailMyrtlePark,05/25/2015 06:00:00 AM,48,-122,2,5,7
12223,ElliotBayTrailMyrtlePark,05/25/2015 07:00:00 AM,48,-122,12,12,24
12224,ElliotBayTrailMyrtlePark,05/25/2015 08:00:00 AM,48,-122,19,31,50
12225,ElliotBayTrailMyrtlePark,05/25/2015 09:00:00 AM,48,-122,20,31,51
12226,ElliotBayTrailMyrtlePark,05/25/2015 10:00:00 AM,48,-122,54,39,93
12227,ElliotBayTrailMyrtlePark,05/25/2015 11:00:00 AM,48,-122,58,58,116
12228,ElliotBayTrailMyrtlePark,05/25/2015 12:00:00 PM,48,-122,52,52,104
12229,ElliotBayTrailMyrtlePark,05/25/2015 01:00:00 PM,48,-122,49,52,101
12230,ElliotBayTrailMyrtlePark,05/25/2015 02:00:00 PM,48,-122,88,68,156
12231,ElliotBayTrailMyrtlePark,05/25/2015 03:00:00 PM,48,-122,63,59,122
12232,ElliotBayTrailMyrtlePark,05/25/2015 04:00:00 PM,48,-122,50,59,109
12233,ElliotBayTrailMyrtlePark,05/25/2015 05:00:00 PM,48,-122,47,37,84
12234,ElliotBayTrailMyrtlePark,05/25/2015 06:00:00 PM,48,-122,27,41,68
12235,ElliotBayTrailMyrtlePark,05/25/2015 07:00:00 PM,48,-122,26,24,50
12236,ElliotBayTrailMyrtlePark,05/25/2015 08:00:00 PM,48,-122,14,10,24
12237,ElliotBayTrailMyrtlePark,05/25/2015 09:00:00 PM,48,-122,12,11,23
12238,ElliotBayTrailMyrtlePark,05/25/2015 10:00:00 PM,48,-122,4,0,4
12239,ElliotBayTrailMyrtlePark,05/25/2015 11:00:00 PM,48,-122,2,4,6
12240,ElliotBayTrailMyrtlePark,05/26/2015 12:00:00 AM,48,-122,7,0,7
12241,ElliotBayTrailMyrtlePark,05/26/2015 01:00:00 AM,48,-122,0,0,0
12242,ElliotBayTrailMyrtlePark,05/26/2015 02:00:00 AM,48,-122,0,0,0
12243,ElliotBayTrailMyrtlePark,05/26/2015 03:00:00 AM,48,-122,0,0,0
12244,ElliotBayTrailMyrtlePark,05/26/2015 04:00:00 AM,48,-122,6,2,8
12245,ElliotBayTrailMyrtlePark,05/26/2015 05:00:00 AM,48,-122,3,12,15
12246,ElliotBayTrailMyrtlePark,05/26/2015 06:00:00 AM,48,-122,16,40,56
12247,ElliotBayTrailMyrtlePark,05/26/2015 07:00:00 AM,48,-122,43,128,171
12248,ElliotBayTrailMyrtlePark,05/26/2015 08:00:00 AM,48,-122,44,213,257
12249,ElliotBayTrailMyrtlePark,05/26/2015 09:00:00 AM,48,-122,33,107,140
12250,ElliotBayTrailMyrtlePark,05/26/2015 10:00:00 AM,48,-122,18,28,46
12251,ElliotBayTrailMyrtlePark,05/26/2015 11:00:00 AM,48,-122,25,19,44
12252,ElliotBayTrailMyrtlePark,05/26/2015 12:00:00 PM,48,-122,24,20,44
12253,ElliotBayTrailMyrtlePark,05/26/2015 01:00:00 PM,48,-122,19,32,51
12254,ElliotBayTrailMyrtlePark,05/26/2015 02:00:00 PM,48,-122,48,28,76
12255,ElliotBayTrailMyrtlePark,05/26/2015 03:00:00 PM,48,-122,53,38,91
12256,ElliotBayTrailMyrtlePark,05/26/2015 04:00:00 PM,48,-122,112,73,185
12257,ElliotBayTrailMyrtlePark,05/26/2015 05:00:00 PM,48,-122,277,67,344
12258,ElliotBayTrailMyrtlePark,05/26/2015 06:00:00 PM,48,-122,208,79,287
12259,ElliotBayTrailMyrtlePark,05/26/2015 07:00:00 PM,48,-122,63,42,105
12260,ElliotBayTrailMyrtlePark,05/26/2015 08:00:00 PM,48,-122,37,14,51
12261,ElliotBayTrailMyrtlePark,05/26/2015 09:00:00 PM,48,-122,14,7,21
12262,ElliotBayTrailMyrtlePark,05/26/2015 10:00:00 PM,48,-122,1,6,7
12263,ElliotBayTrailMyrtlePark,05/26/2015 11:00:00 PM,48,-122,2,0,2
12264,ElliotBayTrailMyrtlePark,05/27/2015 12:00:00 AM,48,-122,1,0,1
12265,ElliotBayTrailMyrtlePark,05/27/2015 01:00:00 AM,48,-122,1,0,1
12266,ElliotBayTrailMyrtlePark,05/27/2015 02:00:00 AM,48,-122,0,0,0
12267,ElliotBayTrailMyrtlePark,05/27/2015 03:00:00 AM,48,-122,1,0,1
12268,ElliotBayTrailMyrtlePark,05/27/2015 04:00:00 AM,48,-122,0,0,0
12269,ElliotBayTrailMyrtlePark,05/27/2015 05:00:00 AM,48,-122,4,15,19
12270,ElliotBayTrailMyrtlePark,05/27/2015 06:00:00 AM,48,-122,20,58,78
12271,ElliotBayTrailMyrtlePark,05/27/2015 07:00:00 AM,48,-122,58,156,214
12272,ElliotBayTrailMyrtlePark,05/27/2015 08:00:00 AM,48,-122,62,214,276
12273,ElliotBayTrailMyrtlePark,05/27/2015 09:00:00 AM,48,-122,35,106,141
12274,ElliotBayTrailMyrtlePark,05/27/2015 10:00:00 AM,48,-122,20,33,53
12275,ElliotBayTrailMyrtlePark,05/27/2015 11:00:00 AM,48,-122,17,17,34
12276,ElliotBayTrailMyrtlePark,05/27/2015 12:00:00 PM,48,-122,24,21,45
12277,ElliotBayTrailMyrtlePark,05/27/2015 01:00:00 PM,48,-122,27,29,56
12278,ElliotBayTrailMyrtlePark,05/27/2015 02:00:00 PM,48,-122,34,26,60
12279,ElliotBayTrailMyrtlePark,05/27/2015 03:00:00 PM,48,-122,62,39,101
12280,ElliotBayTrailMyrtlePark,05/27/2015 04:00:00 PM,48,-122,128,73,201
12281,ElliotBayTrailMyrtlePark,05/27/2015 05:00:00 PM,48,-122,238,99,337
12282,ElliotBayTrailMyrtlePark,05/27/2015 06:00:00 PM,48,-122,215,86,301
12283,ElliotBayTrailMyrtlePark,05/27/2015 07:00:00 PM,48,-122,90,58,148
12284,ElliotBayTrailMyrtlePark,05/27/2015 08:00:00 PM,48,-122,65,37,102
12285,ElliotBayTrailMyrtlePark,05/27/2015 09:00:00 PM,48,-122,71,17,88
12286,ElliotBayTrailMyrtlePark,05/27/2015 10:00:00 PM,48,-122,19,3,22
12287,ElliotBayTrailMyrtlePark,05/27/2015 11:00:00 PM,48,-122,4,2,6
12288,ElliotBayTrailMyrtlePark,05/28/2015 12:00:00 AM,48,-122,5,0,5
12289,ElliotBayTrailMyrtlePark,05/28/2015 01:00:00 AM,48,-122,2,1,3
12290,ElliotBayTrailMyrtlePark,05/28/2015 02:00:00 AM,48,-122,0,0,0
12291,ElliotBayTrailMyrtlePark,05/28/2015 03:00:00 AM,48,-122,1,0,1
12292,ElliotBayTrailMyrtlePark,05/28/2015 04:00:00 AM,48,-122,1,1,2
12293,ElliotBayTrailMyrtlePark,05/28/2015 05:00:00 AM,48,-122,5,11,16
12294,ElliotBayTrailMyrtlePark,05/28/2015 06:00:00 AM,48,-122,29,48,77
12295,ElliotBayTrailMyrtlePark,05/28/2015 07:00:00 AM,48,-122,47,138,185
12296,ElliotBayTrailMyrtlePark,05/28/2015 08:00:00 AM,48,-122,70,203,273
12297,ElliotBayTrailMyrtlePark,05/28/2015 09:00:00 AM,48,-122,53,145,198
12298,ElliotBayTrailMyrtlePark,05/28/2015 10:00:00 AM,48,-122,22,40,62
12299,ElliotBayTrailMyrtlePark,05/28/2015 11:00:00 AM,48,-122,30,32,62
12300,ElliotBayTrailMyrtlePark,05/28/2015 12:00:00 PM,48,-122,29,22,51
12301,ElliotBayTrailMyrtlePark,05/28/2015 01:00:00 PM,48,-122,35,36,71
12302,ElliotBayTrailMyrtlePark,05/28/2015 02:00:00 PM,48,-122,47,48,95
12303,ElliotBayTrailMyrtlePark,05/28/2015 03:00:00 PM,48,-122,60,45,105
12304,ElliotBayTrailMyrtlePark,05/28/2015 04:00:00 PM,48,-122,117,69,186
12305,ElliotBayTrailMyrtlePark,05/28/2015 05:00:00 PM,48,-122,274,86,360
12306,ElliotBayTrailMyrtlePark,05/28/2015 06:00:00 PM,48,-122,247,98,345
12307,ElliotBayTrailMyrtlePark,05/28/2015 07:00:00 PM,48,-122,87,89,176
12308,ElliotBayTrailMyrtlePark,05/28/2015 08:00:00 PM,48,-122,69,52,121
12309,ElliotBayTrailMyrtlePark,05/28/2015 09:00:00 PM,48,-122,18,9,27
12310,ElliotBayTrailMyrtlePark,05/28/2015 10:00:00 PM,48,-122,25,9,34
12311,ElliotBayTrailMyrtlePark,05/28/2015 11:00:00 PM,48,-122,10,4,14
12312,ElliotBayTrailMyrtlePark,05/29/2015 12:00:00 AM,48,-122,8,0,8
12313,ElliotBayTrailMyrtlePark,05/29/2015 01:00:00 AM,48,-122,1,0,1
12314,ElliotBayTrailMyrtlePark,05/29/2015 02:00:00 AM,48,-122,0,0,0
12315,ElliotBayTrailMyrtlePark,05/29/2015 03:00:00 AM,48,-122,0,0,0
12316,ElliotBayTrailMyrtlePark,05/29/2015 04:00:00 AM,48,-122,1,0,1
12317,ElliotBayTrailMyrtlePark,05/29/2015 05:00:00 AM,48,-122,4,14,18
12318,ElliotBayTrailMyrtlePark,05/29/2015 06:00:00 AM,48,-122,25,37,62
12319,ElliotBayTrailMyrtlePark,05/29/2015 07:00:00 AM,48,-122,50,110,160
12320,ElliotBayTrailMyrtlePark,05/29/2015 08:00:00 AM,48,-122,59,209,268
12321,ElliotBayTrailMyrtlePark,05/29/2015 09:00:00 AM,48,-122,44,115,159
12322,ElliotBayTrailMyrtlePark,05/29/2015 10:00:00 AM,48,-122,40,33,73
12323,ElliotBayTrailMyrtlePark,05/29/2015 11:00:00 AM,48,-122,22,22,44
12324,ElliotBayTrailMyrtlePark,05/29/2015 12:00:00 PM,48,-122,37,34,71
12325,ElliotBayTrailMyrtlePark,05/29/2015 01:00:00 PM,48,-122,32,55,87
12326,ElliotBayTrailMyrtlePark,05/29/2015 02:00:00 PM,48,-122,40,56,96
12327,ElliotBayTrailMyrtlePark,05/29/2015 03:00:00 PM,48,-122,76,53,129
12328,ElliotBayTrailMyrtlePark,05/29/2015 04:00:00 PM,48,-122,150,79,229
12329,ElliotBayTrailMyrtlePark,05/29/2015 05:00:00 PM,48,-122,276,82,358
12330,ElliotBayTrailMyrtlePark,05/29/2015 06:00:00 PM,48,-122,202,60,262
12331,ElliotBayTrailMyrtlePark,05/29/2015 07:00:00 PM,48,-122,66,39,105
12332,ElliotBayTrailMyrtlePark,05/29/2015 08:00:00 PM,48,-122,39,43,82
12333,ElliotBayTrailMyrtlePark,05/29/2015 09:00:00 PM,48,-122,17,20,37
12334,ElliotBayTrailMyrtlePark,05/29/2015 10:00:00 PM,48,-122,19,9,28
12335,ElliotBayTrailMyrtlePark,05/29/2015 11:00:00 PM,48,-122,5,8,13
12336,ElliotBayTrailMyrtlePark,05/30/2015 12:00:00 AM,48,-122,9,0,9
12337,ElliotBayTrailMyrtlePark,05/30/2015 01:00:00 AM,48,-122,1,0,1
12338,ElliotBayTrailMyrtlePark,05/30/2015 02:00:00 AM,48,-122,8,2,10
12339,ElliotBayTrailMyrtlePark,05/30/2015 03:00:00 AM,48,-122,1,0,1
12340,ElliotBayTrailMyrtlePark,05/30/2015 04:00:00 AM,48,-122,0,0,0
12341,ElliotBayTrailMyrtlePark,05/30/2015 05:00:00 AM,48,-122,0,1,1
12342,ElliotBayTrailMyrtlePark,05/30/2015 06:00:00 AM,48,-122,8,11,19
12343,ElliotBayTrailMyrtlePark,05/30/2015 07:00:00 AM,48,-122,15,23,38
12344,ElliotBayTrailMyrtlePark,05/30/2015 08:00:00 AM,48,-122,34,26,60
12345,ElliotBayTrailMyrtlePark,05/30/2015 09:00:00 AM,48,-122,32,35,67
12346,ElliotBayTrailMyrtlePark,05/30/2015 10:00:00 AM,48,-122,37,69,106
12347,ElliotBayTrailMyrtlePark,05/30/2015 11:00:00 AM,48,-122,53,59,112
12348,ElliotBayTrailMyrtlePark,05/30/2015 12:00:00 PM,48,-122,59,70,129
12349,ElliotBayTrailMyrtlePark,05/30/2015 01:00:00 PM,48,-122,68,73,141
12350,ElliotBayTrailMyrtlePark,05/30/2015 02:00:00 PM,48,-122,88,82,170
12351,ElliotBayTrailMyrtlePark,05/30/2015 03:00:00 PM,48,-122,94,74,168
12352,ElliotBayTrailMyrtlePark,05/30/2015 04:00:00 PM,48,-122,81,72,153
12353,ElliotBayTrailMyrtlePark,05/30/2015 05:00:00 PM,48,-122,102,72,174
12354,ElliotBayTrailMyrtlePark,05/30/2015 06:00:00 PM,48,-122,69,65,134
12355,ElliotBayTrailMyrtlePark,05/30/2015 07:00:00 PM,48,-122,62,40,102
12356,ElliotBayTrailMyrtlePark,05/30/2015 08:00:00 PM,48,-122,38,32,70
12357,ElliotBayTrailMyrtlePark,05/30/2015 09:00:00 PM,48,-122,17,34,51
12358,ElliotBayTrailMyrtlePark,05/30/2015 10:00:00 PM,48,-122,24,8,32
12359,ElliotBayTrailMyrtlePark,05/30/2015 11:00:00 PM,48,-122,11,9,20
12360,ElliotBayTrailMyrtlePark,05/31/2015 12:00:00 AM,48,-122,5,5,10
12361,ElliotBayTrailMyrtlePark,05/31/2015 01:00:00 AM,48,-122,2,0,2
12362,ElliotBayTrailMyrtlePark,05/31/2015 02:00:00 AM,48,-122,0,0,0
12363,ElliotBayTrailMyrtlePark,05/31/2015 03:00:00 AM,48,-122,3,0,3
12364,ElliotBayTrailMyrtlePark,05/31/2015 04:00:00 AM,48,-122,0,0,0
12365,ElliotBayTrailMyrtlePark,05/31/2015 05:00:00 AM,48,-122,0,2,2
12366,ElliotBayTrailMyrtlePark,05/31/2015 06:00:00 AM,48,-122,4,4,8
12367,ElliotBayTrailMyrtlePark,05/31/2015 07:00:00 AM,48,-122,9,14,23
12368,ElliotBayTrailMyrtlePark,05/31/2015 08:00:00 AM,48,-122,20,18,38
12369,ElliotBayTrailMyrtlePark,05/31/2015 09:00:00 AM,48,-122,22,43,65
12370,ElliotBayTrailMyrtlePark,05/31/2015 10:00:00 AM,48,-122,53,56,109
12371,ElliotBayTrailMyrtlePark,05/31/2015 11:00:00 AM,48,-122,50,76,126
12372,ElliotBayTrailMyrtlePark,05/31/2015 12:00:00 PM,48,-122,68,99,167
12373,ElliotBayTrailMyrtlePark,05/31/2015 01:00:00 PM,48,-122,79,126,205
12374,ElliotBayTrailMyrtlePark,05/31/2015 02:00:00 PM,48,-122,66,66,132
12375,ElliotBayTrailMyrtlePark,05/31/2015 03:00:00 PM,48,-122,84,74,158
12376,ElliotBayTrailMyrtlePark,05/31/2015 04:00:00 PM,48,-122,181,85,266
12377,ElliotBayTrailMyrtlePark,05/31/2015 05:00:00 PM,48,-122,108,51,159
12378,ElliotBayTrailMyrtlePark,05/31/2015 06:00:00 PM,48,-122,76,40,116
12379,ElliotBayTrailMyrtlePark,05/31/2015 07:00:00 PM,48,-122,35,24,59
12380,ElliotBayTrailMyrtlePark,05/31/2015 08:00:00 PM,48,-122,37,33,70
12381,ElliotBayTrailMyrtlePark,05/31/2015 09:00:00 PM,48,-122,7,10,17
12382,ElliotBayTrailMyrtlePark,05/31/2015 10:00:00 PM,48,-122,6,4,10
12383,ElliotBayTrailMyrtlePark,05/31/2015 11:00:00 PM,48,-122,2,4,6
12384,ElliotBayTrailMyrtlePark,06/01/2015 12:00:00 AM,48,-122,0,4,4
12385,ElliotBayTrailMyrtlePark,06/01/2015 01:00:00 AM,48,-122,2,0,2
12386,ElliotBayTrailMyrtlePark,06/01/2015 02:00:00 AM,48,-122,2,0,2
12387,ElliotBayTrailMyrtlePark,06/01/2015 03:00:00 AM,48,-122,0,0,0
12388,ElliotBayTrailMyrtlePark,06/01/2015 04:00:00 AM,48,-122,1,1,2
12389,ElliotBayTrailMyrtlePark,06/01/2015 05:00:00 AM,48,-122,4,11,15
12390,ElliotBayTrailMyrtlePark,06/01/2015 06:00:00 AM,48,-122,19,28,47
12391,ElliotBayTrailMyrtlePark,06/01/2015 07:00:00 AM,48,-122,39,92,131
12392,ElliotBayTrailMyrtlePark,06/01/2015 08:00:00 AM,48,-122,50,167,217
12393,ElliotBayTrailMyrtlePark,06/01/2015 09:00:00 AM,48,-122,17,75,92
12394,ElliotBayTrailMyrtlePark,06/01/2015 10:00:00 AM,48,-122,9,14,23
12395,ElliotBayTrailMyrtlePark,06/01/2015 11:00:00 AM,48,-122,4,3,7
12396,ElliotBayTrailMyrtlePark,06/01/2015 12:00:00 PM,48,-122,3,7,10
12397,ElliotBayTrailMyrtlePark,06/01/2015 01:00:00 PM,48,-122,6,10,16
12398,ElliotBayTrailMyrtlePark,06/01/2015 02:00:00 PM,48,-122,18,18,36
12399,ElliotBayTrailMyrtlePark,06/01/2015 03:00:00 PM,48,-122,17,19,36
12400,ElliotBayTrailMyrtlePark,06/01/2015 04:00:00 PM,48,-122,63,32,95
12401,ElliotBayTrailMyrtlePark,06/01/2015 05:00:00 PM,48,-122,180,46,226
12402,ElliotBayTrailMyrtlePark,06/01/2015 06:00:00 PM,48,-122,142,35,177
12403,ElliotBayTrailMyrtlePark,06/01/2015 07:00:00 PM,48,-122,40,23,63
12404,ElliotBayTrailMyrtlePark,06/01/2015 08:00:00 PM,48,-122,20,13,33
12405,ElliotBayTrailMyrtlePark,06/01/2015 09:00:00 PM,48,-122,7,2,9
12406,ElliotBayTrailMyrtlePark,06/01/2015 10:00:00 PM,48,-122,22,3,25
12407,ElliotBayTrailMyrtlePark,06/01/2015 11:00:00 PM,48,-122,3,2,5
12408,ElliotBayTrailMyrtlePark,06/02/2015 12:00:00 AM,48,-122,2,0,2
12409,ElliotBayTrailMyrtlePark,06/02/2015 01:00:00 AM,48,-122,1,0,1
12410,ElliotBayTrailMyrtlePark,06/02/2015 02:00:00 AM,48,-122,0,0,0
12411,ElliotBayTrailMyrtlePark,06/02/2015 03:00:00 AM,48,-122,0,0,0
12412,ElliotBayTrailMyrtlePark,06/02/2015 04:00:00 AM,48,-122,0,0,0
12413,ElliotBayTrailMyrtlePark,06/02/2015 05:00:00 AM,48,-122,5,11,16
12414,ElliotBayTrailMyrtlePark,06/02/2015 06:00:00 AM,48,-122,17,27,44
12415,ElliotBayTrailMyrtlePark,06/02/2015 07:00:00 AM,48,-122,41,88,129
12416,ElliotBayTrailMyrtlePark,06/02/2015 08:00:00 AM,48,-122,36,158,194
12417,ElliotBayTrailMyrtlePark,06/02/2015 09:00:00 AM,48,-122,20,68,88
12418,ElliotBayTrailMyrtlePark,06/02/2015 10:00:00 AM,48,-122,12,35,47
12419,ElliotBayTrailMyrtlePark,06/02/2015 11:00:00 AM,48,-122,18,17,35
12420,ElliotBayTrailMyrtlePark,06/02/2015 12:00:00 PM,48,-122,15,13,28
12421,ElliotBayTrailMyrtlePark,06/02/2015 01:00:00 PM,48,-122,11,14,25
12422,ElliotBayTrailMyrtlePark,06/02/2015 02:00:00 PM,48,-122,20,15,35
12423,ElliotBayTrailMyrtlePark,06/02/2015 03:00:00 PM,48,-122,23,14,37
12424,ElliotBayTrailMyrtlePark,06/02/2015 04:00:00 PM,48,-122,60,28,88
12425,ElliotBayTrailMyrtlePark,06/02/2015 05:00:00 PM,48,-122,138,57,195
12426,ElliotBayTrailMyrtlePark,06/02/2015 06:00:00 PM,48,-122,148,43,191
12427,ElliotBayTrailMyrtlePark,06/02/2015 07:00:00 PM,48,-122,34,16,50
12428,ElliotBayTrailMyrtlePark,06/02/2015 08:00:00 PM,48,-122,22,14,36
12429,ElliotBayTrailMyrtlePark,06/02/2015 09:00:00 PM,48,-122,11,3,14
12430,ElliotBayTrailMyrtlePark,06/02/2015 10:00:00 PM,48,-122,6,1,7
12431,ElliotBayTrailMyrtlePark,06/02/2015 11:00:00 PM,48,-122,10,0,10
12432,ElliotBayTrailMyrtlePark,06/03/2015 12:00:00 AM,48,-122,0,1,1
12433,ElliotBayTrailMyrtlePark,06/03/2015 01:00:00 AM,48,-122,3,0,3
12434,ElliotBayTrailMyrtlePark,06/03/2015 02:00:00 AM,48,-122,1,0,1
12435,ElliotBayTrailMyrtlePark,06/03/2015 03:00:00 AM,48,-122,0,1,1
12436,ElliotBayTrailMyrtlePark,06/03/2015 04:00:00 AM,48,-122,0,1,1
12437,ElliotBayTrailMyrtlePark,06/03/2015 05:00:00 AM,48,-122,5,7,12
12438,ElliotBayTrailMyrtlePark,06/03/2015 06:00:00 AM,48,-122,15,33,48
12439,ElliotBayTrailMyrtlePark,06/03/2015 07:00:00 AM,48,-122,44,96,140
12440,ElliotBayTrailMyrtlePark,06/03/2015 08:00:00 AM,48,-122,39,151,190
12441,ElliotBayTrailMyrtlePark,06/03/2015 09:00:00 AM,48,-122,23,81,104
12442,ElliotBayTrailMyrtlePark,06/03/2015 10:00:00 AM,48,-122,15,20,35
12443,ElliotBayTrailMyrtlePark,06/03/2015 11:00:00 AM,48,-122,10,10,20
12444,ElliotBayTrailMyrtlePark,06/03/2015 12:00:00 PM,48,-122,9,16,25
12445,ElliotBayTrailMyrtlePark,06/03/2015 01:00:00 PM,48,-122,29,17,46
12446,ElliotBayTrailMyrtlePark,06/03/2015 02:00:00 PM,48,-122,25,32,57
12447,ElliotBayTrailMyrtlePark,06/03/2015 03:00:00 PM,48,-122,41,26,67
12448,ElliotBayTrailMyrtlePark,06/03/2015 04:00:00 PM,48,-122,96,59,155
12449,ElliotBayTrailMyrtlePark,06/03/2015 05:00:00 PM,48,-122,201,77,278
12450,ElliotBayTrailMyrtlePark,06/03/2015 06:00:00 PM,48,-122,145,66,211
12451,ElliotBayTrailMyrtlePark,06/03/2015 07:00:00 PM,48,-122,72,30,102
12452,ElliotBayTrailMyrtlePark,06/03/2015 08:00:00 PM,48,-122,34,17,51
12453,ElliotBayTrailMyrtlePark,06/03/2015 09:00:00 PM,48,-122,12,13,25
12454,ElliotBayTrailMyrtlePark,06/03/2015 10:00:00 PM,48,-122,12,4,16
12455,ElliotBayTrailMyrtlePark,06/03/2015 11:00:00 PM,48,-122,7,3,10
12456,ElliotBayTrailMyrtlePark,06/04/2015 12:00:00 AM,48,-122,1,0,1
12457,ElliotBayTrailMyrtlePark,06/04/2015 01:00:00 AM,48,-122,0,1,1
12458,ElliotBayTrailMyrtlePark,06/04/2015 02:00:00 AM,48,-122,4,0,4
12459,ElliotBayTrailMyrtlePark,06/04/2015 03:00:00 AM,48,-122,1,2,3
12460,ElliotBayTrailMyrtlePark,06/04/2015 04:00:00 AM,48,-122,1,0,1
12461,ElliotBayTrailMyrtlePark,06/04/2015 05:00:00 AM,48,-122,8,13,21
12462,ElliotBayTrailMyrtlePark,06/04/2015 06:00:00 AM,48,-122,22,45,67
12463,ElliotBayTrailMyrtlePark,06/04/2015 07:00:00 AM,48,-122,45,111,156
12464,ElliotBayTrailMyrtlePark,06/04/2015 08:00:00 AM,48,-122,53,206,259
12465,ElliotBayTrailMyrtlePark,06/04/2015 09:00:00 AM,48,-122,37,108,145
12466,ElliotBayTrailMyrtlePark,06/04/2015 10:00:00 AM,48,-122,20,43,63
12467,ElliotBayTrailMyrtlePark,06/04/2015 11:00:00 AM,48,-122,19,22,41
12468,ElliotBayTrailMyrtlePark,06/04/2015 12:00:00 PM,48,-122,27,30,57
12469,ElliotBayTrailMyrtlePark,06/04/2015 01:00:00 PM,48,-122,35,35,70
12470,ElliotBayTrailMyrtlePark,06/04/2015 02:00:00 PM,48,-122,31,27,58
12471,ElliotBayTrailMyrtlePark,06/04/2015 03:00:00 PM,48,-122,45,41,86
12472,ElliotBayTrailMyrtlePark,06/04/2015 04:00:00 PM,48,-122,114,72,186
12473,ElliotBayTrailMyrtlePark,06/04/2015 05:00:00 PM,48,-122,238,81,319
12474,ElliotBayTrailMyrtlePark,06/04/2015 06:00:00 PM,48,-122,175,100,275
12475,ElliotBayTrailMyrtlePark,06/04/2015 07:00:00 PM,48,-122,95,74,169
12476,ElliotBayTrailMyrtlePark,06/04/2015 08:00:00 PM,48,-122,44,40,84
12477,ElliotBayTrailMyrtlePark,06/04/2015 09:00:00 PM,48,-122,16,6,22
12478,ElliotBayTrailMyrtlePark,06/04/2015 10:00:00 PM,48,-122,14,3,17
12479,ElliotBayTrailMyrtlePark,06/04/2015 11:00:00 PM,48,-122,6,0,6
12480,ElliotBayTrailMyrtlePark,06/05/2015 12:00:00 AM,48,-122,2,1,3
12481,ElliotBayTrailMyrtlePark,06/05/2015 01:00:00 AM,48,-122,2,0,2
12482,ElliotBayTrailMyrtlePark,06/05/2015 02:00:00 AM,48,-122,0,0,0
12483,ElliotBayTrailMyrtlePark,06/05/2015 03:00:00 AM,48,-122,1,0,1
12484,ElliotBayTrailMyrtlePark,06/05/2015 04:00:00 AM,48,-122,1,0,1
12485,ElliotBayTrailMyrtlePark,06/05/2015 05:00:00 AM,48,-122,3,15,18
12486,ElliotBayTrailMyrtlePark,06/05/2015 06:00:00 AM,48,-122,24,32,56
12487,ElliotBayTrailMyrtlePark,06/05/2015 07:00:00 AM,48,-122,47,113,160
12488,ElliotBayTrailMyrtlePark,06/05/2015 08:00:00 AM,48,-122,65,188,253
12489,ElliotBayTrailMyrtlePark,06/05/2015 09:00:00 AM,48,-122,48,115,163
12490,ElliotBayTrailMyrtlePark,06/05/2015 10:00:00 AM,48,-122,29,35,64
12491,ElliotBayTrailMyrtlePark,06/05/2015 11:00:00 AM,48,-122,36,35,71
12492,ElliotBayTrailMyrtlePark,06/05/2015 12:00:00 PM,48,-122,25,21,46
12493,ElliotBayTrailMyrtlePark,06/05/2015 01:00:00 PM,48,-122,41,33,74
12494,ElliotBayTrailMyrtlePark,06/05/2015 02:00:00 PM,48,-122,41,43,84
12495,ElliotBayTrailMyrtlePark,06/05/2015 03:00:00 PM,48,-122,74,77,151
12496,ElliotBayTrailMyrtlePark,06/05/2015 04:00:00 PM,48,-122,139,57,196
12497,ElliotBayTrailMyrtlePark,06/05/2015 05:00:00 PM,48,-122,246,97,343
12498,ElliotBayTrailMyrtlePark,06/05/2015 06:00:00 PM,48,-122,150,69,219
12499,ElliotBayTrailMyrtlePark,06/05/2015 07:00:00 PM,48,-122,66,46,112
12500,ElliotBayTrailMyrtlePark,06/05/2015 08:00:00 PM,48,-122,42,24,66
12501,ElliotBayTrailMyrtlePark,06/05/2015 09:00:00 PM,48,-122,12,14,26
12502,ElliotBayTrailMyrtlePark,06/05/2015 10:00:00 PM,48,-122,13,9,22
12503,ElliotBayTrailMyrtlePark,06/05/2015 11:00:00 PM,48,-122,7,5,12
12504,ElliotBayTrailMyrtlePark,06/06/2015 12:00:00 AM,48,-122,7,2,9
12505,ElliotBayTrailMyrtlePark,06/06/2015 01:00:00 AM,48,-122,3,2,5
12506,ElliotBayTrailMyrtlePark,06/06/2015 02:00:00 AM,48,-122,3,0,3
12507,ElliotBayTrailMyrtlePark,06/06/2015 03:00:00 AM,48,-122,2,2,4
12508,ElliotBayTrailMyrtlePark,06/06/2015 04:00:00 AM,48,-122,3,0,3
12509,ElliotBayTrailMyrtlePark,06/06/2015 05:00:00 AM,48,-122,0,5,5
12510,ElliotBayTrailMyrtlePark,06/06/2015 06:00:00 AM,48,-122,7,6,13
12511,ElliotBayTrailMyrtlePark,06/06/2015 07:00:00 AM,48,-122,12,31,43
12512,ElliotBayTrailMyrtlePark,06/06/2015 08:00:00 AM,48,-122,34,28,62
12513,ElliotBayTrailMyrtlePark,06/06/2015 09:00:00 AM,48,-122,41,39,80
12514,ElliotBayTrailMyrtlePark,06/06/2015 10:00:00 AM,48,-122,60,55,115
12515,ElliotBayTrailMyrtlePark,06/06/2015 11:00:00 AM,48,-122,64,66,130
12516,ElliotBayTrailMyrtlePark,06/06/2015 12:00:00 PM,48,-122,85,55,140
12517,ElliotBayTrailMyrtlePark,06/06/2015 01:00:00 PM,48,-122,83,87,170
12518,ElliotBayTrailMyrtlePark,06/06/2015 02:00:00 PM,48,-122,91,75,166
12519,ElliotBayTrailMyrtlePark,06/06/2015 03:00:00 PM,48,-122,78,66,144
12520,ElliotBayTrailMyrtlePark,06/06/2015 04:00:00 PM,48,-122,69,67,136
12521,ElliotBayTrailMyrtlePark,06/06/2015 05:00:00 PM,48,-122,82,62,144
12522,ElliotBayTrailMyrtlePark,06/06/2015 06:00:00 PM,48,-122,55,52,107
12523,ElliotBayTrailMyrtlePark,06/06/2015 07:00:00 PM,48,-122,42,43,85
12524,ElliotBayTrailMyrtlePark,06/06/2015 08:00:00 PM,48,-122,41,49,90
12525,ElliotBayTrailMyrtlePark,06/06/2015 09:00:00 PM,48,-122,8,14,22
12526,ElliotBayTrailMyrtlePark,06/06/2015 10:00:00 PM,48,-122,23,15,38
12527,ElliotBayTrailMyrtlePark,06/06/2015 11:00:00 PM,48,-122,7,2,9
12528,ElliotBayTrailMyrtlePark,06/07/2015 12:00:00 AM,48,-122,2,2,4
12529,ElliotBayTrailMyrtlePark,06/07/2015 01:00:00 AM,48,-122,3,2,5
12530,ElliotBayTrailMyrtlePark,06/07/2015 02:00:00 AM,48,-122,1,2,3
12531,ElliotBayTrailMyrtlePark,06/07/2015 03:00:00 AM,48,-122,4,1,5
12532,ElliotBayTrailMyrtlePark,06/07/2015 04:00:00 AM,48,-122,2,2,4
12533,ElliotBayTrailMyrtlePark,06/07/2015 05:00:00 AM,48,-122,0,0,0
12534,ElliotBayTrailMyrtlePark,06/07/2015 06:00:00 AM,48,-122,9,12,21
12535,ElliotBayTrailMyrtlePark,06/07/2015 07:00:00 AM,48,-122,12,10,22
12536,ElliotBayTrailMyrtlePark,06/07/2015 08:00:00 AM,48,-122,31,21,52
12537,ElliotBayTrailMyrtlePark,06/07/2015 09:00:00 AM,48,-122,44,56,100
12538,ElliotBayTrailMyrtlePark,06/07/2015 10:00:00 AM,48,-122,87,65,152
12539,ElliotBayTrailMyrtlePark,06/07/2015 11:00:00 AM,48,-122,69,90,159
12540,ElliotBayTrailMyrtlePark,06/07/2015 12:00:00 PM,48,-122,72,94,166
12541,ElliotBayTrailMyrtlePark,06/07/2015 01:00:00 PM,48,-122,73,71,144
12542,ElliotBayTrailMyrtlePark,06/07/2015 02:00:00 PM,48,-122,101,78,179
12543,ElliotBayTrailMyrtlePark,06/07/2015 03:00:00 PM,48,-122,86,85,171
12544,ElliotBayTrailMyrtlePark,06/07/2015 04:00:00 PM,48,-122,96,83,179
12545,ElliotBayTrailMyrtlePark,06/07/2015 05:00:00 PM,48,-122,86,45,131
12546,ElliotBayTrailMyrtlePark,06/07/2015 06:00:00 PM,48,-122,42,32,74
12547,ElliotBayTrailMyrtlePark,06/07/2015 07:00:00 PM,48,-122,45,46,91
12548,ElliotBayTrailMyrtlePark,06/07/2015 08:00:00 PM,48,-122,32,16,48
12549,ElliotBayTrailMyrtlePark,06/07/2015 09:00:00 PM,48,-122,17,29,46
12550,ElliotBayTrailMyrtlePark,06/07/2015 10:00:00 PM,48,-122,9,5,14
12551,ElliotBayTrailMyrtlePark,06/07/2015 11:00:00 PM,48,-122,8,5,13
12552,ElliotBayTrailMyrtlePark,06/08/2015 12:00:00 AM,48,-122,7,1,8
12553,ElliotBayTrailMyrtlePark,06/08/2015 01:00:00 AM,48,-122,0,0,0
12554,ElliotBayTrailMyrtlePark,06/08/2015 02:00:00 AM,48,-122,0,0,0
12555,ElliotBayTrailMyrtlePark,06/08/2015 03:00:00 AM,48,-122,0,0,0
12556,ElliotBayTrailMyrtlePark,06/08/2015 04:00:00 AM,48,-122,1,1,2
12557,ElliotBayTrailMyrtlePark,06/08/2015 05:00:00 AM,48,-122,3,20,23
12558,ElliotBayTrailMyrtlePark,06/08/2015 06:00:00 AM,48,-122,19,48,67
12559,ElliotBayTrailMyrtlePark,06/08/2015 07:00:00 AM,48,-122,45,116,161
12560,ElliotBayTrailMyrtlePark,06/08/2015 08:00:00 AM,48,-122,77,192,269
12561,ElliotBayTrailMyrtlePark,06/08/2015 09:00:00 AM,48,-122,45,111,156
12562,ElliotBayTrailMyrtlePark,06/08/2015 10:00:00 AM,48,-122,32,35,67
12563,ElliotBayTrailMyrtlePark,06/08/2015 11:00:00 AM,48,-122,29,25,54
12564,ElliotBayTrailMyrtlePark,06/08/2015 12:00:00 PM,48,-122,24,34,58
12565,ElliotBayTrailMyrtlePark,06/08/2015 01:00:00 PM,48,-122,28,31,59
12566,ElliotBayTrailMyrtlePark,06/08/2015 02:00:00 PM,48,-122,37,39,76
12567,ElliotBayTrailMyrtlePark,06/08/2015 03:00:00 PM,48,-122,51,43,94
12568,ElliotBayTrailMyrtlePark,06/08/2015 04:00:00 PM,48,-122,124,61,185
12569,ElliotBayTrailMyrtlePark,06/08/2015 05:00:00 PM,48,-122,283,89,372
12570,ElliotBayTrailMyrtlePark,06/08/2015 06:00:00 PM,48,-122,210,65,275
12571,ElliotBayTrailMyrtlePark,06/08/2015 07:00:00 PM,48,-122,75,55,130
12572,ElliotBayTrailMyrtlePark,06/08/2015 08:00:00 PM,48,-122,58,48,106
12573,ElliotBayTrailMyrtlePark,06/08/2015 09:00:00 PM,48,-122,19,25,44
12574,ElliotBayTrailMyrtlePark,06/08/2015 10:00:00 PM,48,-122,5,3,8
12575,ElliotBayTrailMyrtlePark,06/08/2015 11:00:00 PM,48,-122,3,1,4
12576,ElliotBayTrailMyrtlePark,06/09/2015 12:00:00 AM,48,-122,2,1,3
12577,ElliotBayTrailMyrtlePark,06/09/2015 01:00:00 AM,48,-122,2,0,2
12578,ElliotBayTrailMyrtlePark,06/09/2015 02:00:00 AM,48,-122,0,0,0
12579,ElliotBayTrailMyrtlePark,06/09/2015 03:00:00 AM,48,-122,2,0,2
12580,ElliotBayTrailMyrtlePark,06/09/2015 04:00:00 AM,48,-122,0,0,0
12581,ElliotBayTrailMyrtlePark,06/09/2015 05:00:00 AM,48,-122,3,19,22
12582,ElliotBayTrailMyrtlePark,06/09/2015 06:00:00 AM,48,-122,25,54,79
12583,ElliotBayTrailMyrtlePark,06/09/2015 07:00:00 AM,48,-122,49,143,192
12584,ElliotBayTrailMyrtlePark,06/09/2015 08:00:00 AM,48,-122,81,214,295
12585,ElliotBayTrailMyrtlePark,06/09/2015 09:00:00 AM,48,-122,49,127,176
12586,ElliotBayTrailMyrtlePark,06/09/2015 10:00:00 AM,48,-122,25,37,62
12587,ElliotBayTrailMyrtlePark,06/09/2015 11:00:00 AM,48,-122,30,33,63
12588,ElliotBayTrailMyrtlePark,06/09/2015 12:00:00 PM,48,-122,48,31,79
12589,ElliotBayTrailMyrtlePark,06/09/2015 01:00:00 PM,48,-122,36,38,74
12590,ElliotBayTrailMyrtlePark,06/09/2015 02:00:00 PM,48,-122,34,23,57
12591,ElliotBayTrailMyrtlePark,06/09/2015 03:00:00 PM,48,-122,37,37,74
12592,ElliotBayTrailMyrtlePark,06/09/2015 04:00:00 PM,48,-122,106,68,174
12593,ElliotBayTrailMyrtlePark,06/09/2015 05:00:00 PM,48,-122,293,89,382
12594,ElliotBayTrailMyrtlePark,06/09/2015 06:00:00 PM,48,-122,222,71,293
12595,ElliotBayTrailMyrtlePark,06/09/2015 07:00:00 PM,48,-122,115,49,164
12596,ElliotBayTrailMyrtlePark,06/09/2015 08:00:00 PM,48,-122,54,46,100
12597,ElliotBayTrailMyrtlePark,06/09/2015 09:00:00 PM,48,-122,24,30,54
12598,ElliotBayTrailMyrtlePark,06/09/2015 10:00:00 PM,48,-122,8,7,15
12599,ElliotBayTrailMyrtlePark,06/09/2015 11:00:00 PM,48,-122,3,2,5
12600,ElliotBayTrailMyrtlePark,06/10/2015 12:00:00 AM,48,-122,2,1,3
12601,ElliotBayTrailMyrtlePark,06/10/2015 01:00:00 AM,48,-122,0,0,0
12602,ElliotBayTrailMyrtlePark,06/10/2015 02:00:00 AM,48,-122,2,0,2
12603,ElliotBayTrailMyrtlePark,06/10/2015 03:00:00 AM,48,-122,0,0,0
12604,ElliotBayTrailMyrtlePark,06/10/2015 04:00:00 AM,48,-122,2,0,2
12605,ElliotBayTrailMyrtlePark,06/10/2015 05:00:00 AM,48,-122,10,14,24
12606,ElliotBayTrailMyrtlePark,06/10/2015 06:00:00 AM,48,-122,22,43,65
12607,ElliotBayTrailMyrtlePark,06/10/2015 07:00:00 AM,48,-122,65,134,199
12608,ElliotBayTrailMyrtlePark,06/10/2015 08:00:00 AM,48,-122,55,215,270
12609,ElliotBayTrailMyrtlePark,06/10/2015 09:00:00 AM,48,-122,35,111,146
12610,ElliotBayTrailMyrtlePark,06/10/2015 10:00:00 AM,48,-122,26,36,62
12611,ElliotBayTrailMyrtlePark,06/10/2015 11:00:00 AM,48,-122,24,81,105
12612,ElliotBayTrailMyrtlePark,06/10/2015 12:00:00 PM,48,-122,31,30,61
12613,ElliotBayTrailMyrtlePark,06/10/2015 01:00:00 PM,48,-122,25,40,65
12614,ElliotBayTrailMyrtlePark,06/10/2015 02:00:00 PM,48,-122,76,31,107
12615,ElliotBayTrailMyrtlePark,06/10/2015 03:00:00 PM,48,-122,62,38,100
12616,ElliotBayTrailMyrtlePark,06/10/2015 04:00:00 PM,48,-122,107,62,169
12617,ElliotBayTrailMyrtlePark,06/10/2015 05:00:00 PM,48,-122,311,91,402
12618,ElliotBayTrailMyrtlePark,06/10/2015 06:00:00 PM,48,-122,222,66,288
12619,ElliotBayTrailMyrtlePark,06/10/2015 07:00:00 PM,48,-122,98,57,155
12620,ElliotBayTrailMyrtlePark,06/10/2015 08:00:00 PM,48,-122,65,44,109
12621,ElliotBayTrailMyrtlePark,06/10/2015 09:00:00 PM,48,-122,26,16,42
12622,ElliotBayTrailMyrtlePark,06/10/2015 10:00:00 PM,48,-122,13,2,15
12623,ElliotBayTrailMyrtlePark,06/10/2015 11:00:00 PM,48,-122,4,0,4
12624,ElliotBayTrailMyrtlePark,06/11/2015 12:00:00 AM,48,-122,3,2,5
12625,ElliotBayTrailMyrtlePark,06/11/2015 01:00:00 AM,48,-122,0,3,3
12626,ElliotBayTrailMyrtlePark,06/11/2015 02:00:00 AM,48,-122,0,0,0
12627,ElliotBayTrailMyrtlePark,06/11/2015 03:00:00 AM,48,-122,2,0,2
12628,ElliotBayTrailMyrtlePark,06/11/2015 04:00:00 AM,48,-122,1,1,2
12629,ElliotBayTrailMyrtlePark,06/11/2015 05:00:00 AM,48,-122,3,13,16
12630,ElliotBayTrailMyrtlePark,06/11/2015 06:00:00 AM,48,-122,32,41,73
12631,ElliotBayTrailMyrtlePark,06/11/2015 07:00:00 AM,48,-122,39,128,167
12632,ElliotBayTrailMyrtlePark,06/11/2015 08:00:00 AM,48,-122,62,207,269
12633,ElliotBayTrailMyrtlePark,06/11/2015 09:00:00 AM,48,-122,36,106,142
12634,ElliotBayTrailMyrtlePark,06/11/2015 10:00:00 AM,48,-122,29,96,125
12635,ElliotBayTrailMyrtlePark,06/11/2015 11:00:00 AM,48,-122,22,25,47
12636,ElliotBayTrailMyrtlePark,06/11/2015 12:00:00 PM,48,-122,19,29,48
12637,ElliotBayTrailMyrtlePark,06/11/2015 01:00:00 PM,48,-122,34,31,65
12638,ElliotBayTrailMyrtlePark,06/11/2015 02:00:00 PM,48,-122,115,38,153
12639,ElliotBayTrailMyrtlePark,06/11/2015 03:00:00 PM,48,-122,53,49,102
12640,ElliotBayTrailMyrtlePark,06/11/2015 04:00:00 PM,48,-122,108,65,173
12641,ElliotBayTrailMyrtlePark,06/11/2015 05:00:00 PM,48,-122,285,88,373
12642,ElliotBayTrailMyrtlePark,06/11/2015 06:00:00 PM,48,-122,204,81,285
12643,ElliotBayTrailMyrtlePark,06/11/2015 07:00:00 PM,48,-122,72,34,106
12644,ElliotBayTrailMyrtlePark,06/11/2015 08:00:00 PM,48,-122,45,27,72
12645,ElliotBayTrailMyrtlePark,06/11/2015 09:00:00 PM,48,-122,14,11,25
12646,ElliotBayTrailMyrtlePark,06/11/2015 10:00:00 PM,48,-122,14,10,24
12647,ElliotBayTrailMyrtlePark,06/11/2015 11:00:00 PM,48,-122,11,1,12
12648,ElliotBayTrailMyrtlePark,06/12/2015 12:00:00 AM,48,-122,2,1,3
12649,ElliotBayTrailMyrtlePark,06/12/2015 01:00:00 AM,48,-122,0,3,3
12650,ElliotBayTrailMyrtlePark,06/12/2015 02:00:00 AM,48,-122,2,0,2
12651,ElliotBayTrailMyrtlePark,06/12/2015 03:00:00 AM,48,-122,1,0,1
12652,ElliotBayTrailMyrtlePark,06/12/2015 04:00:00 AM,48,-122,1,0,1
12653,ElliotBayTrailMyrtlePark,06/12/2015 05:00:00 AM,48,-122,2,13,15
12654,ElliotBayTrailMyrtlePark,06/12/2015 06:00:00 AM,48,-122,24,31,55
12655,ElliotBayTrailMyrtlePark,06/12/2015 07:00:00 AM,48,-122,46,78,124
12656,ElliotBayTrailMyrtlePark,06/12/2015 08:00:00 AM,48,-122,39,167,206
12657,ElliotBayTrailMyrtlePark,06/12/2015 09:00:00 AM,48,-122,42,93,135
12658,ElliotBayTrailMyrtlePark,06/12/2015 10:00:00 AM,48,-122,16,26,42
12659,ElliotBayTrailMyrtlePark,06/12/2015 11:00:00 AM,48,-122,26,16,42
12660,ElliotBayTrailMyrtlePark,06/12/2015 12:00:00 PM,48,-122,17,17,34
12661,ElliotBayTrailMyrtlePark,06/12/2015 01:00:00 PM,48,-122,14,24,38
12662,ElliotBayTrailMyrtlePark,06/12/2015 02:00:00 PM,48,-122,30,26,56
12663,ElliotBayTrailMyrtlePark,06/12/2015 03:00:00 PM,48,-122,42,35,77
12664,ElliotBayTrailMyrtlePark,06/12/2015 04:00:00 PM,48,-122,100,51,151
12665,ElliotBayTrailMyrtlePark,06/12/2015 05:00:00 PM,48,-122,203,60,263
12666,ElliotBayTrailMyrtlePark,06/12/2015 06:00:00 PM,48,-122,117,49,166
12667,ElliotBayTrailMyrtlePark,06/12/2015 07:00:00 PM,48,-122,64,32,96
12668,ElliotBayTrailMyrtlePark,06/12/2015 08:00:00 PM,48,-122,31,26,57
12669,ElliotBayTrailMyrtlePark,06/12/2015 09:00:00 PM,48,-122,12,7,19
12670,ElliotBayTrailMyrtlePark,06/12/2015 10:00:00 PM,48,-122,6,5,11
12671,ElliotBayTrailMyrtlePark,06/12/2015 11:00:00 PM,48,-122,2,1,3
12672,ElliotBayTrailMyrtlePark,06/13/2015 12:00:00 AM,48,-122,3,1,4
12673,ElliotBayTrailMyrtlePark,06/13/2015 01:00:00 AM,48,-122,4,0,4
12674,ElliotBayTrailMyrtlePark,06/13/2015 02:00:00 AM,48,-122,1,0,1
12675,ElliotBayTrailMyrtlePark,06/13/2015 03:00:00 AM,48,-122,1,0,1
12676,ElliotBayTrailMyrtlePark,06/13/2015 04:00:00 AM,48,-122,0,0,0
12677,ElliotBayTrailMyrtlePark,06/13/2015 05:00:00 AM,48,-122,1,3,4
12678,ElliotBayTrailMyrtlePark,06/13/2015 06:00:00 AM,48,-122,7,9,16
12679,ElliotBayTrailMyrtlePark,06/13/2015 07:00:00 AM,48,-122,10,30,40
12680,ElliotBayTrailMyrtlePark,06/13/2015 08:00:00 AM,48,-122,45,23,68
12681,ElliotBayTrailMyrtlePark,06/13/2015 09:00:00 AM,48,-122,39,48,87
12682,ElliotBayTrailMyrtlePark,06/13/2015 10:00:00 AM,48,-122,46,57,103
12683,ElliotBayTrailMyrtlePark,06/13/2015 11:00:00 AM,48,-122,49,48,97
12684,ElliotBayTrailMyrtlePark,06/13/2015 12:00:00 PM,48,-122,70,65,135
12685,ElliotBayTrailMyrtlePark,06/13/2015 01:00:00 PM,48,-122,53,67,120
12686,ElliotBayTrailMyrtlePark,06/13/2015 02:00:00 PM,48,-122,87,91,178
12687,ElliotBayTrailMyrtlePark,06/13/2015 03:00:00 PM,48,-122,77,68,145
12688,ElliotBayTrailMyrtlePark,06/13/2015 04:00:00 PM,48,-122,82,83,165
12689,ElliotBayTrailMyrtlePark,06/13/2015 05:00:00 PM,48,-122,80,91,171
12690,ElliotBayTrailMyrtlePark,06/13/2015 06:00:00 PM,48,-122,81,82,163
12691,ElliotBayTrailMyrtlePark,06/13/2015 07:00:00 PM,48,-122,49,65,114
12692,ElliotBayTrailMyrtlePark,06/13/2015 08:00:00 PM,48,-122,48,19,67
12693,ElliotBayTrailMyrtlePark,06/13/2015 09:00:00 PM,48,-122,67,34,101
12694,ElliotBayTrailMyrtlePark,06/13/2015 10:00:00 PM,48,-122,23,28,51
12695,ElliotBayTrailMyrtlePark,06/13/2015 11:00:00 PM,48,-122,6,8,14
12696,ElliotBayTrailMyrtlePark,06/14/2015 12:00:00 AM,48,-122,6,4,10
12697,ElliotBayTrailMyrtlePark,06/14/2015 01:00:00 AM,48,-122,2,2,4
12698,ElliotBayTrailMyrtlePark,06/14/2015 02:00:00 AM,48,-122,4,0,4
12699,ElliotBayTrailMyrtlePark,06/14/2015 03:00:00 AM,48,-122,0,1,1
12700,ElliotBayTrailMyrtlePark,06/14/2015 04:00:00 AM,48,-122,1,0,1
12701,ElliotBayTrailMyrtlePark,06/14/2015 05:00:00 AM,48,-122,0,2,2
12702,ElliotBayTrailMyrtlePark,06/14/2015 06:00:00 AM,48,-122,5,4,9
12703,ElliotBayTrailMyrtlePark,06/14/2015 07:00:00 AM,48,-122,6,12,18
12704,ElliotBayTrailMyrtlePark,06/14/2015 08:00:00 AM,48,-122,18,18,36
12705,ElliotBayTrailMyrtlePark,06/14/2015 09:00:00 AM,48,-122,54,49,103
12706,ElliotBayTrailMyrtlePark,06/14/2015 10:00:00 AM,48,-122,39,59,98
12707,ElliotBayTrailMyrtlePark,06/14/2015 11:00:00 AM,48,-122,56,82,138
12708,ElliotBayTrailMyrtlePark,06/14/2015 12:00:00 PM,48,-122,68,72,140
12709,ElliotBayTrailMyrtlePark,06/14/2015 01:00:00 PM,48,-122,96,61,157
12710,ElliotBayTrailMyrtlePark,06/14/2015 02:00:00 PM,48,-122,93,73,166
12711,ElliotBayTrailMyrtlePark,06/14/2015 03:00:00 PM,48,-122,78,80,158
12712,ElliotBayTrailMyrtlePark,06/14/2015 04:00:00 PM,48,-122,88,80,168
12713,ElliotBayTrailMyrtlePark,06/14/2015 05:00:00 PM,48,-122,68,34,102
12714,ElliotBayTrailMyrtlePark,06/14/2015 06:00:00 PM,48,-122,44,60,104
12715,ElliotBayTrailMyrtlePark,06/14/2015 07:00:00 PM,48,-122,46,29,75
12716,ElliotBayTrailMyrtlePark,06/14/2015 08:00:00 PM,48,-122,25,26,51
12717,ElliotBayTrailMyrtlePark,06/14/2015 09:00:00 PM,48,-122,10,17,27
12718,ElliotBayTrailMyrtlePark,06/14/2015 10:00:00 PM,48,-122,8,9,17
12719,ElliotBayTrailMyrtlePark,06/14/2015 11:00:00 PM,48,-122,1,0,1
12720,ElliotBayTrailMyrtlePark,06/15/2015 12:00:00 AM,48,-122,0,0,0
12721,ElliotBayTrailMyrtlePark,06/15/2015 01:00:00 AM,48,-122,0,0,0
12722,ElliotBayTrailMyrtlePark,06/15/2015 02:00:00 AM,48,-122,1,0,1
12723,ElliotBayTrailMyrtlePark,06/15/2015 03:00:00 AM,48,-122,0,0,0
12724,ElliotBayTrailMyrtlePark,06/15/2015 04:00:00 AM,48,-122,0,1,1
12725,ElliotBayTrailMyrtlePark,06/15/2015 05:00:00 AM,48,-122,7,7,14
12726,ElliotBayTrailMyrtlePark,06/15/2015 06:00:00 AM,48,-122,25,41,66
12727,ElliotBayTrailMyrtlePark,06/15/2015 07:00:00 AM,48,-122,51,125,176
12728,ElliotBayTrailMyrtlePark,06/15/2015 08:00:00 AM,48,-122,64,186,250
12729,ElliotBayTrailMyrtlePark,06/15/2015 09:00:00 AM,48,-122,53,119,172
12730,ElliotBayTrailMyrtlePark,06/15/2015 10:00:00 AM,48,-122,21,38,59
12731,ElliotBayTrailMyrtlePark,06/15/2015 11:00:00 AM,48,-122,25,30,55
12732,ElliotBayTrailMyrtlePark,06/15/2015 12:00:00 PM,48,-122,22,22,44
12733,ElliotBayTrailMyrtlePark,06/15/2015 01:00:00 PM,48,-122,30,37,67
12734,ElliotBayTrailMyrtlePark,06/15/2015 02:00:00 PM,48,-122,41,29,70
12735,ElliotBayTrailMyrtlePark,06/15/2015 03:00:00 PM,48,-122,41,40,81
12736,ElliotBayTrailMyrtlePark,06/15/2015 04:00:00 PM,48,-122,110,66,176
12737,ElliotBayTrailMyrtlePark,06/15/2015 05:00:00 PM,48,-122,260,81,341
12738,ElliotBayTrailMyrtlePark,06/15/2015 06:00:00 PM,48,-122,182,84,266
12739,ElliotBayTrailMyrtlePark,06/15/2015 07:00:00 PM,48,-122,67,49,116
12740,ElliotBayTrailMyrtlePark,06/15/2015 08:00:00 PM,48,-122,50,31,81
12741,ElliotBayTrailMyrtlePark,06/15/2015 09:00:00 PM,48,-122,18,19,37
12742,ElliotBayTrailMyrtlePark,06/15/2015 10:00:00 PM,48,-122,8,6,14
12743,ElliotBayTrailMyrtlePark,06/15/2015 11:00:00 PM,48,-122,2,1,3
12744,ElliotBayTrailMyrtlePark,06/16/2015 12:00:00 AM,48,-122,1,0,1
12745,ElliotBayTrailMyrtlePark,06/16/2015 01:00:00 AM,48,-122,2,1,3
12746,ElliotBayTrailMyrtlePark,06/16/2015 02:00:00 AM,48,-122,1,0,1
12747,ElliotBayTrailMyrtlePark,06/16/2015 03:00:00 AM,48,-122,0,0,0
12748,ElliotBayTrailMyrtlePark,06/16/2015 04:00:00 AM,48,-122,1,0,1
12749,ElliotBayTrailMyrtlePark,06/16/2015 05:00:00 AM,48,-122,4,16,20
12750,ElliotBayTrailMyrtlePark,06/16/2015 06:00:00 AM,48,-122,24,43,67
12751,ElliotBayTrailMyrtlePark,06/16/2015 07:00:00 AM,48,-122,50,120,170
12752,ElliotBayTrailMyrtlePark,06/16/2015 08:00:00 AM,48,-122,43,176,219
12753,ElliotBayTrailMyrtlePark,06/16/2015 09:00:00 AM,48,-122,36,103,139
12754,ElliotBayTrailMyrtlePark,06/16/2015 10:00:00 AM,48,-122,14,27,41
12755,ElliotBayTrailMyrtlePark,06/16/2015 11:00:00 AM,48,-122,26,28,54
12756,ElliotBayTrailMyrtlePark,06/16/2015 12:00:00 PM,48,-122,31,36,67
12757,ElliotBayTrailMyrtlePark,06/16/2015 01:00:00 PM,48,-122,21,17,38
12758,ElliotBayTrailMyrtlePark,06/16/2015 02:00:00 PM,48,-122,31,39,70
12759,ElliotBayTrailMyrtlePark,06/16/2015 03:00:00 PM,48,-122,46,29,75
12760,ElliotBayTrailMyrtlePark,06/16/2015 04:00:00 PM,48,-122,110,63,173
12761,ElliotBayTrailMyrtlePark,06/16/2015 05:00:00 PM,48,-122,273,102,375
12762,ElliotBayTrailMyrtlePark,06/16/2015 06:00:00 PM,48,-122,182,68,250
12763,ElliotBayTrailMyrtlePark,06/16/2015 07:00:00 PM,48,-122,78,35,113
12764,ElliotBayTrailMyrtlePark,06/16/2015 08:00:00 PM,48,-122,47,42,89
12765,ElliotBayTrailMyrtlePark,06/16/2015 09:00:00 PM,48,-122,12,6,18
12766,ElliotBayTrailMyrtlePark,06/16/2015 10:00:00 PM,48,-122,8,3,11
12767,ElliotBayTrailMyrtlePark,06/16/2015 11:00:00 PM,48,-122,8,2,10
12768,ElliotBayTrailMyrtlePark,06/17/2015 12:00:00 AM,48,-122,2,0,2
12769,ElliotBayTrailMyrtlePark,06/17/2015 01:00:00 AM,48,-122,0,2,2
12770,ElliotBayTrailMyrtlePark,06/17/2015 02:00:00 AM,48,-122,4,0,4
12771,ElliotBayTrailMyrtlePark,06/17/2015 03:00:00 AM,48,-122,0,0,0
12772,ElliotBayTrailMyrtlePark,06/17/2015 04:00:00 AM,48,-122,0,0,0
12773,ElliotBayTrailMyrtlePark,06/17/2015 05:00:00 AM,48,-122,4,13,17
12774,ElliotBayTrailMyrtlePark,06/17/2015 06:00:00 AM,48,-122,26,37,63
12775,ElliotBayTrailMyrtlePark,06/17/2015 07:00:00 AM,48,-122,44,128,172
12776,ElliotBayTrailMyrtlePark,06/17/2015 08:00:00 AM,48,-122,52,199,251
12777,ElliotBayTrailMyrtlePark,06/17/2015 09:00:00 AM,48,-122,36,116,152
12778,ElliotBayTrailMyrtlePark,06/17/2015 10:00:00 AM,48,-122,17,44,61
12779,ElliotBayTrailMyrtlePark,06/17/2015 11:00:00 AM,48,-122,30,28,58
12780,ElliotBayTrailMyrtlePark,06/17/2015 12:00:00 PM,48,-122,26,33,59
12781,ElliotBayTrailMyrtlePark,06/17/2015 01:00:00 PM,48,-122,40,35,75
12782,ElliotBayTrailMyrtlePark,06/17/2015 02:00:00 PM,48,-122,39,28,67
12783,ElliotBayTrailMyrtlePark,06/17/2015 03:00:00 PM,48,-122,39,33,72
12784,ElliotBayTrailMyrtlePark,06/17/2015 04:00:00 PM,48,-122,102,48,150
12785,ElliotBayTrailMyrtlePark,06/17/2015 05:00:00 PM,48,-122,237,94,331
12786,ElliotBayTrailMyrtlePark,06/17/2015 06:00:00 PM,48,-122,179,79,258
12787,ElliotBayTrailMyrtlePark,06/17/2015 07:00:00 PM,48,-122,90,41,131
12788,ElliotBayTrailMyrtlePark,06/17/2015 08:00:00 PM,48,-122,57,34,91
12789,ElliotBayTrailMyrtlePark,06/17/2015 09:00:00 PM,48,-122,9,17,26
12790,ElliotBayTrailMyrtlePark,06/17/2015 10:00:00 PM,48,-122,15,6,21
12791,ElliotBayTrailMyrtlePark,06/17/2015 11:00:00 PM,48,-122,5,2,7
12792,ElliotBayTrailMyrtlePark,06/18/2015 12:00:00 AM,48,-122,8,3,11
12793,ElliotBayTrailMyrtlePark,06/18/2015 01:00:00 AM,48,-122,1,1,2
12794,ElliotBayTrailMyrtlePark,06/18/2015 02:00:00 AM,48,-122,3,1,4
12795,ElliotBayTrailMyrtlePark,06/18/2015 03:00:00 AM,48,-122,4,0,4
12796,ElliotBayTrailMyrtlePark,06/18/2015 04:00:00 AM,48,-122,2,0,2
12797,ElliotBayTrailMyrtlePark,06/18/2015 05:00:00 AM,48,-122,6,10,16
12798,ElliotBayTrailMyrtlePark,06/18/2015 06:00:00 AM,48,-122,22,38,60
12799,ElliotBayTrailMyrtlePark,06/18/2015 07:00:00 AM,48,-122,43,96,139
12800,ElliotBayTrailMyrtlePark,06/18/2015 08:00:00 AM,48,-122,55,190,245
12801,ElliotBayTrailMyrtlePark,06/18/2015 09:00:00 AM,48,-122,38,101,139
12802,ElliotBayTrailMyrtlePark,06/18/2015 10:00:00 AM,48,-122,31,34,65
12803,ElliotBayTrailMyrtlePark,06/18/2015 11:00:00 AM,48,-122,16,24,40
12804,ElliotBayTrailMyrtlePark,06/18/2015 12:00:00 PM,48,-122,38,23,61
12805,ElliotBayTrailMyrtlePark,06/18/2015 01:00:00 PM,48,-122,22,40,62
12806,ElliotBayTrailMyrtlePark,06/18/2015 02:00:00 PM,48,-122,32,30,62
12807,ElliotBayTrailMyrtlePark,06/18/2015 03:00:00 PM,48,-122,29,28,57
12808,ElliotBayTrailMyrtlePark,06/18/2015 04:00:00 PM,48,-122,95,59,154
12809,ElliotBayTrailMyrtlePark,06/18/2015 05:00:00 PM,48,-122,207,73,280
12810,ElliotBayTrailMyrtlePark,06/18/2015 06:00:00 PM,48,-122,183,57,240
12811,ElliotBayTrailMyrtlePark,06/18/2015 07:00:00 PM,48,-122,75,50,125
12812,ElliotBayTrailMyrtlePark,06/18/2015 08:00:00 PM,48,-122,28,21,49
12813,ElliotBayTrailMyrtlePark,06/18/2015 09:00:00 PM,48,-122,12,13,25
12814,ElliotBayTrailMyrtlePark,06/18/2015 10:00:00 PM,48,-122,14,6,20
12815,ElliotBayTrailMyrtlePark,06/18/2015 11:00:00 PM,48,-122,6,1,7
12816,ElliotBayTrailMyrtlePark,06/19/2015 12:00:00 AM,48,-122,1,2,3
12817,ElliotBayTrailMyrtlePark,06/19/2015 01:00:00 AM,48,-122,0,2,2
12818,ElliotBayTrailMyrtlePark,06/19/2015 02:00:00 AM,48,-122,1,0,1
12819,ElliotBayTrailMyrtlePark,06/19/2015 03:00:00 AM,48,-122,0,0,0
12820,ElliotBayTrailMyrtlePark,06/19/2015 04:00:00 AM,48,-122,1,0,1
12821,ElliotBayTrailMyrtlePark,06/19/2015 05:00:00 AM,48,-122,5,8,13
12822,ElliotBayTrailMyrtlePark,06/19/2015 06:00:00 AM,48,-122,16,20,36
12823,ElliotBayTrailMyrtlePark,06/19/2015 07:00:00 AM,48,-122,30,66,96
12824,ElliotBayTrailMyrtlePark,06/19/2015 08:00:00 AM,48,-122,42,132,174
12825,ElliotBayTrailMyrtlePark,06/19/2015 09:00:00 AM,48,-122,33,79,112
12826,ElliotBayTrailMyrtlePark,06/19/2015 10:00:00 AM,48,-122,20,30,50
12827,ElliotBayTrailMyrtlePark,06/19/2015 11:00:00 AM,48,-122,26,19,45
12828,ElliotBayTrailMyrtlePark,06/19/2015 12:00:00 PM,48,-122,23,30,53
12829,ElliotBayTrailMyrtlePark,06/19/2015 01:00:00 PM,48,-122,23,33,56
12830,ElliotBayTrailMyrtlePark,06/19/2015 02:00:00 PM,48,-122,37,34,71
12831,ElliotBayTrailMyrtlePark,06/19/2015 03:00:00 PM,48,-122,53,52,105
12832,ElliotBayTrailMyrtlePark,06/19/2015 04:00:00 PM,48,-122,112,69,181
12833,ElliotBayTrailMyrtlePark,06/19/2015 05:00:00 PM,48,-122,169,75,244
12834,ElliotBayTrailMyrtlePark,06/19/2015 06:00:00 PM,48,-122,120,43,163
12835,ElliotBayTrailMyrtlePark,06/19/2015 07:00:00 PM,48,-122,73,31,104
12836,ElliotBayTrailMyrtlePark,06/19/2015 08:00:00 PM,48,-122,28,34,62
12837,ElliotBayTrailMyrtlePark,06/19/2015 09:00:00 PM,48,-122,4,6,10
12838,ElliotBayTrailMyrtlePark,06/19/2015 10:00:00 PM,48,-122,4,13,17
12839,ElliotBayTrailMyrtlePark,06/19/2015 11:00:00 PM,48,-122,16,1,17
12840,ElliotBayTrailMyrtlePark,06/20/2015 12:00:00 AM,48,-122,1,0,1
12841,ElliotBayTrailMyrtlePark,06/20/2015 01:00:00 AM,48,-122,1,0,1
12842,ElliotBayTrailMyrtlePark,06/20/2015 02:00:00 AM,48,-122,7,0,7
12843,ElliotBayTrailMyrtlePark,06/20/2015 03:00:00 AM,48,-122,2,0,2
12844,ElliotBayTrailMyrtlePark,06/20/2015 04:00:00 AM,48,-122,4,0,4
12845,ElliotBayTrailMyrtlePark,06/20/2015 05:00:00 AM,48,-122,1,3,4
12846,ElliotBayTrailMyrtlePark,06/20/2015 06:00:00 AM,48,-122,6,14,20
12847,ElliotBayTrailMyrtlePark,06/20/2015 07:00:00 AM,48,-122,16,22,38
12848,ElliotBayTrailMyrtlePark,06/20/2015 08:00:00 AM,48,-122,29,19,48
12849,ElliotBayTrailMyrtlePark,06/20/2015 09:00:00 AM,48,-122,42,62,104
12850,ElliotBayTrailMyrtlePark,06/20/2015 10:00:00 AM,48,-122,43,47,90
12851,ElliotBayTrailMyrtlePark,06/20/2015 11:00:00 AM,48,-122,81,79,160
12852,ElliotBayTrailMyrtlePark,06/20/2015 12:00:00 PM,48,-122,63,98,161
12853,ElliotBayTrailMyrtlePark,06/20/2015 01:00:00 PM,48,-122,65,62,127
12854,ElliotBayTrailMyrtlePark,06/20/2015 02:00:00 PM,48,-122,78,44,122
12855,ElliotBayTrailMyrtlePark,06/20/2015 03:00:00 PM,48,-122,134,72,206
12856,ElliotBayTrailMyrtlePark,06/20/2015 04:00:00 PM,48,-122,87,73,160
12857,ElliotBayTrailMyrtlePark,06/20/2015 05:00:00 PM,48,-122,69,54,123
12858,ElliotBayTrailMyrtlePark,06/20/2015 06:00:00 PM,48,-122,44,46,90
12859,ElliotBayTrailMyrtlePark,06/20/2015 07:00:00 PM,48,-122,36,41,77
12860,ElliotBayTrailMyrtlePark,06/20/2015 08:00:00 PM,48,-122,27,20,47
12861,ElliotBayTrailMyrtlePark,06/20/2015 09:00:00 PM,48,-122,17,18,35
12862,ElliotBayTrailMyrtlePark,06/20/2015 10:00:00 PM,48,-122,9,6,15
12863,ElliotBayTrailMyrtlePark,06/20/2015 11:00:00 PM,48,-122,7,5,12
12864,ElliotBayTrailMyrtlePark,06/21/2015 12:00:00 AM,48,-122,3,1,4
12865,ElliotBayTrailMyrtlePark,06/21/2015 01:00:00 AM,48,-122,1,2,3
12866,ElliotBayTrailMyrtlePark,06/21/2015 02:00:00 AM,48,-122,1,0,1
12867,ElliotBayTrailMyrtlePark,06/21/2015 03:00:00 AM,48,-122,1,0,1
12868,ElliotBayTrailMyrtlePark,06/21/2015 04:00:00 AM,48,-122,0,0,0
12869,ElliotBayTrailMyrtlePark,06/21/2015 05:00:00 AM,48,-122,1,2,3
12870,ElliotBayTrailMyrtlePark,06/21/2015 06:00:00 AM,48,-122,8,7,15
12871,ElliotBayTrailMyrtlePark,06/21/2015 07:00:00 AM,48,-122,9,4,13
12872,ElliotBayTrailMyrtlePark,06/21/2015 08:00:00 AM,48,-122,16,28,44
12873,ElliotBayTrailMyrtlePark,06/21/2015 09:00:00 AM,48,-122,52,58,110
12874,ElliotBayTrailMyrtlePark,06/21/2015 10:00:00 AM,48,-122,50,40,90
12875,ElliotBayTrailMyrtlePark,06/21/2015 11:00:00 AM,48,-122,43,54,97
12876,ElliotBayTrailMyrtlePark,06/21/2015 12:00:00 PM,48,-122,57,104,161
12877,ElliotBayTrailMyrtlePark,06/21/2015 01:00:00 PM,48,-122,96,73,169
12878,ElliotBayTrailMyrtlePark,06/21/2015 02:00:00 PM,48,-122,100,69,169
12879,ElliotBayTrailMyrtlePark,06/21/2015 03:00:00 PM,48,-122,112,80,192
12880,ElliotBayTrailMyrtlePark,06/21/2015 04:00:00 PM,48,-122,104,71,175
12881,ElliotBayTrailMyrtlePark,06/21/2015 05:00:00 PM,48,-122,82,90,172
12882,ElliotBayTrailMyrtlePark,06/21/2015 06:00:00 PM,48,-122,39,37,76
12883,ElliotBayTrailMyrtlePark,06/21/2015 07:00:00 PM,48,-122,43,28,71
12884,ElliotBayTrailMyrtlePark,06/21/2015 08:00:00 PM,48,-122,31,36,67
12885,ElliotBayTrailMyrtlePark,06/21/2015 09:00:00 PM,48,-122,14,16,30
12886,ElliotBayTrailMyrtlePark,06/21/2015 10:00:00 PM,48,-122,14,10,24
12887,ElliotBayTrailMyrtlePark,06/21/2015 11:00:00 PM,48,-122,3,2,5
12888,ElliotBayTrailMyrtlePark,06/22/2015 12:00:00 AM,48,-122,1,2,3
12889,ElliotBayTrailMyrtlePark,06/22/2015 01:00:00 AM,48,-122,3,1,4
12890,ElliotBayTrailMyrtlePark,06/22/2015 02:00:00 AM,48,-122,2,3,5
12891,ElliotBayTrailMyrtlePark,06/22/2015 03:00:00 AM,48,-122,0,0,0
12892,ElliotBayTrailMyrtlePark,06/22/2015 04:00:00 AM,48,-122,1,1,2
12893,ElliotBayTrailMyrtlePark,06/22/2015 05:00:00 AM,48,-122,9,13,22
12894,ElliotBayTrailMyrtlePark,06/22/2015 06:00:00 AM,48,-122,21,35,56
12895,ElliotBayTrailMyrtlePark,06/22/2015 07:00:00 AM,48,-122,44,95,139
12896,ElliotBayTrailMyrtlePark,06/22/2015 08:00:00 AM,48,-122,41,194,235
12897,ElliotBayTrailMyrtlePark,06/22/2015 09:00:00 AM,48,-122,38,109,147
12898,ElliotBayTrailMyrtlePark,06/22/2015 10:00:00 AM,48,-122,19,40,59
12899,ElliotBayTrailMyrtlePark,06/22/2015 11:00:00 AM,48,-122,33,30,63
12900,ElliotBayTrailMyrtlePark,06/22/2015 12:00:00 PM,48,-122,20,24,44
12901,ElliotBayTrailMyrtlePark,06/22/2015 01:00:00 PM,48,-122,26,35,61
12902,ElliotBayTrailMyrtlePark,06/22/2015 02:00:00 PM,48,-122,30,32,62
12903,ElliotBayTrailMyrtlePark,06/22/2015 03:00:00 PM,48,-122,52,32,84
12904,ElliotBayTrailMyrtlePark,06/22/2015 04:00:00 PM,48,-122,86,58,144
12905,ElliotBayTrailMyrtlePark,06/22/2015 05:00:00 PM,48,-122,238,89,327
12906,ElliotBayTrailMyrtlePark,06/22/2015 06:00:00 PM,48,-122,157,83,240
12907,ElliotBayTrailMyrtlePark,06/22/2015 07:00:00 PM,48,-122,78,51,129
12908,ElliotBayTrailMyrtlePark,06/22/2015 08:00:00 PM,48,-122,42,28,70
12909,ElliotBayTrailMyrtlePark,06/22/2015 09:00:00 PM,48,-122,20,17,37
12910,ElliotBayTrailMyrtlePark,06/22/2015 10:00:00 PM,48,-122,14,7,21
12911,ElliotBayTrailMyrtlePark,06/22/2015 11:00:00 PM,48,-122,10,3,13
12912,ElliotBayTrailMyrtlePark,06/23/2015 12:00:00 AM,48,-122,11,1,12
12913,ElliotBayTrailMyrtlePark,06/23/2015 01:00:00 AM,48,-122,2,0,2
12914,ElliotBayTrailMyrtlePark,06/23/2015 02:00:00 AM,48,-122,1,2,3
12915,ElliotBayTrailMyrtlePark,06/23/2015 03:00:00 AM,48,-122,1,0,1
12916,ElliotBayTrailMyrtlePark,06/23/2015 04:00:00 AM,48,-122,0,1,1
12917,ElliotBayTrailMyrtlePark,06/23/2015 05:00:00 AM,48,-122,8,16,24
12918,ElliotBayTrailMyrtlePark,06/23/2015 06:00:00 AM,48,-122,29,37,66
12919,ElliotBayTrailMyrtlePark,06/23/2015 07:00:00 AM,48,-122,49,129,178
12920,ElliotBayTrailMyrtlePark,06/23/2015 08:00:00 AM,48,-122,57,223,280
12921,ElliotBayTrailMyrtlePark,06/23/2015 09:00:00 AM,48,-122,44,117,161
12922,ElliotBayTrailMyrtlePark,06/23/2015 10:00:00 AM,48,-122,20,46,66
12923,ElliotBayTrailMyrtlePark,06/23/2015 11:00:00 AM,48,-122,22,22,44
12924,ElliotBayTrailMyrtlePark,06/23/2015 12:00:00 PM,48,-122,31,40,71
12925,ElliotBayTrailMyrtlePark,06/23/2015 01:00:00 PM,48,-122,23,33,56
12926,ElliotBayTrailMyrtlePark,06/23/2015 02:00:00 PM,48,-122,33,33,66
12927,ElliotBayTrailMyrtlePark,06/23/2015 03:00:00 PM,48,-122,39,41,80
12928,ElliotBayTrailMyrtlePark,06/23/2015 04:00:00 PM,48,-122,105,89,194
12929,ElliotBayTrailMyrtlePark,06/23/2015 05:00:00 PM,48,-122,266,101,367
12930,ElliotBayTrailMyrtlePark,06/23/2015 06:00:00 PM,48,-122,213,94,307
12931,ElliotBayTrailMyrtlePark,06/23/2015 07:00:00 PM,48,-122,104,49,153
12932,ElliotBayTrailMyrtlePark,06/23/2015 08:00:00 PM,48,-122,59,56,115
12933,ElliotBayTrailMyrtlePark,06/23/2015 09:00:00 PM,48,-122,14,17,31
12934,ElliotBayTrailMyrtlePark,06/23/2015 10:00:00 PM,48,-122,15,8,23
12935,ElliotBayTrailMyrtlePark,06/23/2015 11:00:00 PM,48,-122,11,3,14
12936,ElliotBayTrailMyrtlePark,06/24/2015 12:00:00 AM,48,-122,5,2,7
12937,ElliotBayTrailMyrtlePark,06/24/2015 01:00:00 AM,48,-122,1,0,1
12938,ElliotBayTrailMyrtlePark,06/24/2015 02:00:00 AM,48,-122,2,0,2
12939,ElliotBayTrailMyrtlePark,06/24/2015 03:00:00 AM,48,-122,0,0,0
12940,ElliotBayTrailMyrtlePark,06/24/2015 04:00:00 AM,48,-122,1,2,3
12941,ElliotBayTrailMyrtlePark,06/24/2015 05:00:00 AM,48,-122,13,13,26
12942,ElliotBayTrailMyrtlePark,06/24/2015 06:00:00 AM,48,-122,29,46,75
12943,ElliotBayTrailMyrtlePark,06/24/2015 07:00:00 AM,48,-122,51,118,169
12944,ElliotBayTrailMyrtlePark,06/24/2015 08:00:00 AM,48,-122,77,189,266
12945,ElliotBayTrailMyrtlePark,06/24/2015 09:00:00 AM,48,-122,46,99,145
12946,ElliotBayTrailMyrtlePark,06/24/2015 10:00:00 AM,48,-122,24,30,54
12947,ElliotBayTrailMyrtlePark,06/24/2015 11:00:00 AM,48,-122,38,24,62
12948,ElliotBayTrailMyrtlePark,06/24/2015 12:00:00 PM,48,-122,24,23,47
12949,ElliotBayTrailMyrtlePark,06/24/2015 01:00:00 PM,48,-122,22,38,60
12950,ElliotBayTrailMyrtlePark,06/24/2015 02:00:00 PM,48,-122,25,26,51
12951,ElliotBayTrailMyrtlePark,06/24/2015 03:00:00 PM,48,-122,41,24,65
12952,ElliotBayTrailMyrtlePark,06/24/2015 04:00:00 PM,48,-122,79,48,127
12953,ElliotBayTrailMyrtlePark,06/24/2015 05:00:00 PM,48,-122,227,75,302
12954,ElliotBayTrailMyrtlePark,06/24/2015 06:00:00 PM,48,-122,190,66,256
12955,ElliotBayTrailMyrtlePark,06/24/2015 07:00:00 PM,48,-122,90,57,147
12956,ElliotBayTrailMyrtlePark,06/24/2015 08:00:00 PM,48,-122,29,34,63
12957,ElliotBayTrailMyrtlePark,06/24/2015 09:00:00 PM,48,-122,15,14,29
12958,ElliotBayTrailMyrtlePark,06/24/2015 10:00:00 PM,48,-122,20,13,33
12959,ElliotBayTrailMyrtlePark,06/24/2015 11:00:00 PM,48,-122,4,4,8
12960,ElliotBayTrailMyrtlePark,06/25/2015 12:00:00 AM,48,-122,5,2,7
12961,ElliotBayTrailMyrtlePark,06/25/2015 01:00:00 AM,48,-122,1,0,1
12962,ElliotBayTrailMyrtlePark,06/25/2015 02:00:00 AM,48,-122,2,0,2
12963,ElliotBayTrailMyrtlePark,06/25/2015 03:00:00 AM,48,-122,1,0,1
12964,ElliotBayTrailMyrtlePark,06/25/2015 04:00:00 AM,48,-122,3,1,4
12965,ElliotBayTrailMyrtlePark,06/25/2015 05:00:00 AM,48,-122,5,14,19
12966,ElliotBayTrailMyrtlePark,06/25/2015 06:00:00 AM,48,-122,23,37,60
12967,ElliotBayTrailMyrtlePark,06/25/2015 07:00:00 AM,48,-122,54,122,176
12968,ElliotBayTrailMyrtlePark,06/25/2015 08:00:00 AM,48,-122,109,157,266
12969,ElliotBayTrailMyrtlePark,06/25/2015 09:00:00 AM,48,-122,70,79,149
12970,ElliotBayTrailMyrtlePark,06/25/2015 10:00:00 AM,48,-122,37,37,74
12971,ElliotBayTrailMyrtlePark,06/25/2015 11:00:00 AM,48,-122,38,36,74
12972,ElliotBayTrailMyrtlePark,06/25/2015 12:00:00 PM,48,-122,24,39,63
12973,ElliotBayTrailMyrtlePark,06/25/2015 01:00:00 PM,48,-122,34,47,81
12974,ElliotBayTrailMyrtlePark,06/25/2015 02:00:00 PM,48,-122,37,30,67
12975,ElliotBayTrailMyrtlePark,06/25/2015 03:00:00 PM,48,-122,35,37,72
12976,ElliotBayTrailMyrtlePark,06/25/2015 04:00:00 PM,48,-122,113,51,164
12977,ElliotBayTrailMyrtlePark,06/25/2015 05:00:00 PM,48,-122,227,94,321
12978,ElliotBayTrailMyrtlePark,06/25/2015 06:00:00 PM,48,-122,177,58,235
12979,ElliotBayTrailMyrtlePark,06/25/2015 07:00:00 PM,48,-122,102,58,160
12980,ElliotBayTrailMyrtlePark,06/25/2015 08:00:00 PM,48,-122,64,30,94
12981,ElliotBayTrailMyrtlePark,06/25/2015 09:00:00 PM,48,-122,22,19,41
12982,ElliotBayTrailMyrtlePark,06/25/2015 10:00:00 PM,48,-122,12,15,27
12983,ElliotBayTrailMyrtlePark,06/25/2015 11:00:00 PM,48,-122,5,1,6
12984,ElliotBayTrailMyrtlePark,06/26/2015 12:00:00 AM,48,-122,4,4,8
12985,ElliotBayTrailMyrtlePark,06/26/2015 01:00:00 AM,48,-122,0,2,2
12986,ElliotBayTrailMyrtlePark,06/26/2015 02:00:00 AM,48,-122,7,2,9
12987,ElliotBayTrailMyrtlePark,06/26/2015 03:00:00 AM,48,-122,1,1,2
12988,ElliotBayTrailMyrtlePark,06/26/2015 04:00:00 AM,48,-122,2,0,2
12989,ElliotBayTrailMyrtlePark,06/26/2015 05:00:00 AM,48,-122,3,14,17
12990,ElliotBayTrailMyrtlePark,06/26/2015 06:00:00 AM,48,-122,27,28,55
12991,ElliotBayTrailMyrtlePark,06/26/2015 07:00:00 AM,48,-122,44,84,128
12992,ElliotBayTrailMyrtlePark,06/26/2015 08:00:00 AM,48,-122,99,110,209
12993,ElliotBayTrailMyrtlePark,06/26/2015 09:00:00 AM,48,-122,70,80,150
12994,ElliotBayTrailMyrtlePark,06/26/2015 10:00:00 AM,48,-122,34,41,75
12995,ElliotBayTrailMyrtlePark,06/26/2015 11:00:00 AM,48,-122,48,24,72
12996,ElliotBayTrailMyrtlePark,06/26/2015 12:00:00 PM,48,-122,30,44,74
12997,ElliotBayTrailMyrtlePark,06/26/2015 01:00:00 PM,48,-122,45,26,71
12998,ElliotBayTrailMyrtlePark,06/26/2015 02:00:00 PM,48,-122,29,39,68
12999,ElliotBayTrailMyrtlePark,06/26/2015 03:00:00 PM,48,-122,69,41,110
13000,ElliotBayTrailMyrtlePark,06/26/2015 04:00:00 PM,48,-122,114,49,163
13001,ElliotBayTrailMyrtlePark,06/26/2015 05:00:00 PM,48,-122,178,75,253
13002,ElliotBayTrailMyrtlePark,06/26/2015 06:00:00 PM,48,-122,91,51,142
13003,ElliotBayTrailMyrtlePark,06/26/2015 07:00:00 PM,48,-122,58,33,91
13004,ElliotBayTrailMyrtlePark,06/26/2015 08:00:00 PM,48,-122,38,25,63
13005,ElliotBayTrailMyrtlePark,06/26/2015 09:00:00 PM,48,-122,21,16,37
13006,ElliotBayTrailMyrtlePark,06/26/2015 10:00:00 PM,48,-122,14,14,28
13007,ElliotBayTrailMyrtlePark,06/26/2015 11:00:00 PM,48,-122,3,3,6
13008,ElliotBayTrailMyrtlePark,06/27/2015 12:00:00 AM,48,-122,6,1,7
13009,ElliotBayTrailMyrtlePark,06/27/2015 01:00:00 AM,48,-122,2,1,3
13010,ElliotBayTrailMyrtlePark,06/27/2015 02:00:00 AM,48,-122,3,2,5
13011,ElliotBayTrailMyrtlePark,06/27/2015 03:00:00 AM,48,-122,3,0,3
13012,ElliotBayTrailMyrtlePark,06/27/2015 04:00:00 AM,48,-122,0,1,1
13013,ElliotBayTrailMyrtlePark,06/27/2015 05:00:00 AM,48,-122,1,3,4
13014,ElliotBayTrailMyrtlePark,06/27/2015 06:00:00 AM,48,-122,11,12,23
13015,ElliotBayTrailMyrtlePark,06/27/2015 07:00:00 AM,48,-122,17,24,41
13016,ElliotBayTrailMyrtlePark,06/27/2015 08:00:00 AM,48,-122,44,41,85
13017,ElliotBayTrailMyrtlePark,06/27/2015 09:00:00 AM,48,-122,46,61,107
13018,ElliotBayTrailMyrtlePark,06/27/2015 10:00:00 AM,48,-122,51,54,105
13019,ElliotBayTrailMyrtlePark,06/27/2015 11:00:00 AM,48,-122,40,55,95
13020,ElliotBayTrailMyrtlePark,06/27/2015 12:00:00 PM,48,-122,46,39,85
13021,ElliotBayTrailMyrtlePark,06/27/2015 01:00:00 PM,48,-122,62,46,108
13022,ElliotBayTrailMyrtlePark,06/27/2015 02:00:00 PM,48,-122,48,47,95
13023,ElliotBayTrailMyrtlePark,06/27/2015 03:00:00 PM,48,-122,60,39,99
13024,ElliotBayTrailMyrtlePark,06/27/2015 04:00:00 PM,48,-122,67,36,103
13025,ElliotBayTrailMyrtlePark,06/27/2015 05:00:00 PM,48,-122,54,46,100
13026,ElliotBayTrailMyrtlePark,06/27/2015 06:00:00 PM,48,-122,27,29,56
13027,ElliotBayTrailMyrtlePark,06/27/2015 07:00:00 PM,48,-122,22,17,39
13028,ElliotBayTrailMyrtlePark,06/27/2015 08:00:00 PM,48,-122,53,25,78
13029,ElliotBayTrailMyrtlePark,06/27/2015 09:00:00 PM,48,-122,12,44,56
13030,ElliotBayTrailMyrtlePark,06/27/2015 10:00:00 PM,48,-122,6,10,16
13031,ElliotBayTrailMyrtlePark,06/27/2015 11:00:00 PM,48,-122,17,9,26
13032,ElliotBayTrailMyrtlePark,06/28/2015 12:00:00 AM,48,-122,3,5,8
13033,ElliotBayTrailMyrtlePark,06/28/2015 01:00:00 AM,48,-122,2,0,2
13034,ElliotBayTrailMyrtlePark,06/28/2015 02:00:00 AM,48,-122,2,3,5
13035,ElliotBayTrailMyrtlePark,06/28/2015 03:00:00 AM,48,-122,0,0,0
13036,ElliotBayTrailMyrtlePark,06/28/2015 04:00:00 AM,48,-122,2,0,2
13037,ElliotBayTrailMyrtlePark,06/28/2015 05:00:00 AM,48,-122,2,2,4
13038,ElliotBayTrailMyrtlePark,06/28/2015 06:00:00 AM,48,-122,7,8,15
13039,ElliotBayTrailMyrtlePark,06/28/2015 07:00:00 AM,48,-122,14,15,29
13040,ElliotBayTrailMyrtlePark,06/28/2015 08:00:00 AM,48,-122,32,24,56
13041,ElliotBayTrailMyrtlePark,06/28/2015 09:00:00 AM,48,-122,49,36,85
13042,ElliotBayTrailMyrtlePark,06/28/2015 10:00:00 AM,48,-122,51,54,105
13043,ElliotBayTrailMyrtlePark,06/28/2015 11:00:00 AM,48,-122,30,34,64
13044,ElliotBayTrailMyrtlePark,06/28/2015 12:00:00 PM,48,-122,59,36,95
13045,ElliotBayTrailMyrtlePark,06/28/2015 01:00:00 PM,48,-122,30,51,81
13046,ElliotBayTrailMyrtlePark,06/28/2015 02:00:00 PM,48,-122,75,30,105
13047,ElliotBayTrailMyrtlePark,06/28/2015 03:00:00 PM,48,-122,62,33,95
13048,ElliotBayTrailMyrtlePark,06/28/2015 04:00:00 PM,48,-122,58,54,112
13049,ElliotBayTrailMyrtlePark,06/28/2015 05:00:00 PM,48,-122,42,36,78
13050,ElliotBayTrailMyrtlePark,06/28/2015 06:00:00 PM,48,-122,34,35,69
13051,ElliotBayTrailMyrtlePark,06/28/2015 07:00:00 PM,48,-122,20,21,41
13052,ElliotBayTrailMyrtlePark,06/28/2015 08:00:00 PM,48,-122,19,13,32
13053,ElliotBayTrailMyrtlePark,06/28/2015 09:00:00 PM,48,-122,6,10,16
13054,ElliotBayTrailMyrtlePark,06/28/2015 10:00:00 PM,48,-122,9,1,10
13055,ElliotBayTrailMyrtlePark,06/28/2015 11:00:00 PM,48,-122,6,0,6
13056,ElliotBayTrailMyrtlePark,06/29/2015 12:00:00 AM,48,-122,1,0,1
13057,ElliotBayTrailMyrtlePark,06/29/2015 01:00:00 AM,48,-122,3,0,3
13058,ElliotBayTrailMyrtlePark,06/29/2015 02:00:00 AM,48,-122,0,0,0
13059,ElliotBayTrailMyrtlePark,06/29/2015 03:00:00 AM,48,-122,0,0,0
13060,ElliotBayTrailMyrtlePark,06/29/2015 04:00:00 AM,48,-122,1,1,2
13061,ElliotBayTrailMyrtlePark,06/29/2015 05:00:00 AM,48,-122,6,8,14
13062,ElliotBayTrailMyrtlePark,06/29/2015 06:00:00 AM,48,-122,27,32,59
13063,ElliotBayTrailMyrtlePark,06/29/2015 07:00:00 AM,48,-122,50,99,149
13064,ElliotBayTrailMyrtlePark,06/29/2015 08:00:00 AM,48,-122,104,133,237
13065,ElliotBayTrailMyrtlePark,06/29/2015 09:00:00 AM,48,-122,61,80,141
13066,ElliotBayTrailMyrtlePark,06/29/2015 10:00:00 AM,48,-122,21,40,61
13067,ElliotBayTrailMyrtlePark,06/29/2015 11:00:00 AM,48,-122,19,19,38
13068,ElliotBayTrailMyrtlePark,06/29/2015 12:00:00 PM,48,-122,25,29,54
13069,ElliotBayTrailMyrtlePark,06/29/2015 01:00:00 PM,48,-122,25,45,70
13070,ElliotBayTrailMyrtlePark,06/29/2015 02:00:00 PM,48,-122,23,26,49
13071,ElliotBayTrailMyrtlePark,06/29/2015 03:00:00 PM,48,-122,44,24,68
13072,ElliotBayTrailMyrtlePark,06/29/2015 04:00:00 PM,48,-122,100,53,153
13073,ElliotBayTrailMyrtlePark,06/29/2015 05:00:00 PM,48,-122,230,50,280
13074,ElliotBayTrailMyrtlePark,06/29/2015 06:00:00 PM,48,-122,187,68,255
13075,ElliotBayTrailMyrtlePark,06/29/2015 07:00:00 PM,48,-122,107,59,166
13076,ElliotBayTrailMyrtlePark,06/29/2015 08:00:00 PM,48,-122,64,34,98
13077,ElliotBayTrailMyrtlePark,06/29/2015 09:00:00 PM,48,-122,9,20,29
13078,ElliotBayTrailMyrtlePark,06/29/2015 10:00:00 PM,48,-122,7,9,16
13079,ElliotBayTrailMyrtlePark,06/29/2015 11:00:00 PM,48,-122,2,3,5
13080,ElliotBayTrailMyrtlePark,06/30/2015 12:00:00 AM,48,-122,4,0,4
13081,ElliotBayTrailMyrtlePark,06/30/2015 01:00:00 AM,48,-122,2,0,2
13082,ElliotBayTrailMyrtlePark,06/30/2015 02:00:00 AM,48,-122,0,0,0
13083,ElliotBayTrailMyrtlePark,06/30/2015 03:00:00 AM,48,-122,0,0,0
13084,ElliotBayTrailMyrtlePark,06/30/2015 04:00:00 AM,48,-122,0,1,1
13085,ElliotBayTrailMyrtlePark,06/30/2015 05:00:00 AM,48,-122,10,17,27
13086,ElliotBayTrailMyrtlePark,06/30/2015 06:00:00 AM,48,-122,25,45,70
13087,ElliotBayTrailMyrtlePark,06/30/2015 07:00:00 AM,48,-122,53,117,170
13088,ElliotBayTrailMyrtlePark,06/30/2015 08:00:00 AM,48,-122,49,206,255
13089,ElliotBayTrailMyrtlePark,06/30/2015 09:00:00 AM,48,-122,35,113,148
13090,ElliotBayTrailMyrtlePark,06/30/2015 10:00:00 AM,48,-122,30,36,66
13091,ElliotBayTrailMyrtlePark,06/30/2015 11:00:00 AM,48,-122,36,21,57
13092,ElliotBayTrailMyrtlePark,06/30/2015 12:00:00 PM,48,-122,25,25,50
13093,ElliotBayTrailMyrtlePark,06/30/2015 01:00:00 PM,48,-122,37,29,66
13094,ElliotBayTrailMyrtlePark,06/30/2015 02:00:00 PM,48,-122,37,31,68
13095,ElliotBayTrailMyrtlePark,06/30/2015 03:00:00 PM,48,-122,50,39,89
13096,ElliotBayTrailMyrtlePark,06/30/2015 04:00:00 PM,48,-122,111,67,178
13097,ElliotBayTrailMyrtlePark,06/30/2015 05:00:00 PM,48,-122,240,78,318
13098,ElliotBayTrailMyrtlePark,06/30/2015 06:00:00 PM,48,-122,201,54,255
13099,ElliotBayTrailMyrtlePark,06/30/2015 07:00:00 PM,48,-122,105,55,160
13100,ElliotBayTrailMyrtlePark,06/30/2015 08:00:00 PM,48,-122,61,35,96
13101,ElliotBayTrailMyrtlePark,06/30/2015 09:00:00 PM,48,-122,17,16,33
13102,ElliotBayTrailMyrtlePark,06/30/2015 10:00:00 PM,48,-122,25,19,44
13103,ElliotBayTrailMyrtlePark,06/30/2015 11:00:00 PM,48,-122,3,2,5
13104,ElliotBayTrailMyrtlePark,07/01/2015 12:00:00 AM,48,-122,2,3,5
13105,ElliotBayTrailMyrtlePark,07/01/2015 01:00:00 AM,48,-122,0,1,1
13106,ElliotBayTrailMyrtlePark,07/01/2015 02:00:00 AM,48,-122,1,0,1
13107,ElliotBayTrailMyrtlePark,07/01/2015 03:00:00 AM,48,-122,0,0,0
13108,ElliotBayTrailMyrtlePark,07/01/2015 04:00:00 AM,48,-122,0,0,0
13109,ElliotBayTrailMyrtlePark,07/01/2015 05:00:00 AM,48,-122,7,13,20
13110,ElliotBayTrailMyrtlePark,07/01/2015 06:00:00 AM,48,-122,25,46,71
13111,ElliotBayTrailMyrtlePark,07/01/2015 07:00:00 AM,48,-122,53,120,173
13112,ElliotBayTrailMyrtlePark,07/01/2015 08:00:00 AM,48,-122,97,150,247
13113,ElliotBayTrailMyrtlePark,07/01/2015 09:00:00 AM,48,-122,75,89,164
13114,ElliotBayTrailMyrtlePark,07/01/2015 10:00:00 AM,48,-122,21,30,51
13115,ElliotBayTrailMyrtlePark,07/01/2015 11:00:00 AM,48,-122,21,30,51
13116,ElliotBayTrailMyrtlePark,07/01/2015 12:00:00 PM,48,-122,39,28,67
13117,ElliotBayTrailMyrtlePark,07/01/2015 01:00:00 PM,48,-122,25,31,56
13118,ElliotBayTrailMyrtlePark,07/01/2015 02:00:00 PM,48,-122,33,26,59
13119,ElliotBayTrailMyrtlePark,07/01/2015 03:00:00 PM,48,-122,53,40,93
13120,ElliotBayTrailMyrtlePark,07/01/2015 04:00:00 PM,48,-122,98,55,153
13121,ElliotBayTrailMyrtlePark,07/01/2015 05:00:00 PM,48,-122,232,72,304
13122,ElliotBayTrailMyrtlePark,07/01/2015 06:00:00 PM,48,-122,195,64,259
13123,ElliotBayTrailMyrtlePark,07/01/2015 07:00:00 PM,48,-122,75,44,119
13124,ElliotBayTrailMyrtlePark,07/01/2015 08:00:00 PM,48,-122,55,39,94
13125,ElliotBayTrailMyrtlePark,07/01/2015 09:00:00 PM,48,-122,30,29,59
13126,ElliotBayTrailMyrtlePark,07/01/2015 10:00:00 PM,48,-122,31,10,41
13127,ElliotBayTrailMyrtlePark,07/01/2015 11:00:00 PM,48,-122,11,7,18
13128,ElliotBayTrailMyrtlePark,07/02/2015 12:00:00 AM,48,-122,1,3,4
13129,ElliotBayTrailMyrtlePark,07/02/2015 01:00:00 AM,48,-122,2,1,3
13130,ElliotBayTrailMyrtlePark,07/02/2015 02:00:00 AM,48,-122,1,0,1
13131,ElliotBayTrailMyrtlePark,07/02/2015 03:00:00 AM,48,-122,0,0,0
13132,ElliotBayTrailMyrtlePark,07/02/2015 04:00:00 AM,48,-122,1,0,1
13133,ElliotBayTrailMyrtlePark,07/02/2015 05:00:00 AM,48,-122,8,11,19
13134,ElliotBayTrailMyrtlePark,07/02/2015 06:00:00 AM,48,-122,24,37,61
13135,ElliotBayTrailMyrtlePark,07/02/2015 07:00:00 AM,48,-122,44,98,142
13136,ElliotBayTrailMyrtlePark,07/02/2015 08:00:00 AM,48,-122,82,134,216
13137,ElliotBayTrailMyrtlePark,07/02/2015 09:00:00 AM,48,-122,67,79,146
13138,ElliotBayTrailMyrtlePark,07/02/2015 10:00:00 AM,48,-122,30,40,70
13139,ElliotBayTrailMyrtlePark,07/02/2015 11:00:00 AM,48,-122,23,32,55
13140,ElliotBayTrailMyrtlePark,07/02/2015 12:00:00 PM,48,-122,25,33,58
13141,ElliotBayTrailMyrtlePark,07/02/2015 01:00:00 PM,48,-122,23,30,53
13142,ElliotBayTrailMyrtlePark,07/02/2015 02:00:00 PM,48,-122,52,31,83
13143,ElliotBayTrailMyrtlePark,07/02/2015 03:00:00 PM,48,-122,59,33,92
13144,ElliotBayTrailMyrtlePark,07/02/2015 04:00:00 PM,48,-122,91,70,161
13145,ElliotBayTrailMyrtlePark,07/02/2015 05:00:00 PM,48,-122,184,57,241
13146,ElliotBayTrailMyrtlePark,07/02/2015 06:00:00 PM,48,-122,120,47,167
13147,ElliotBayTrailMyrtlePark,07/02/2015 07:00:00 PM,48,-122,65,37,102
13148,ElliotBayTrailMyrtlePark,07/02/2015 08:00:00 PM,48,-122,42,24,66
13149,ElliotBayTrailMyrtlePark,07/02/2015 09:00:00 PM,48,-122,21,7,28
13150,ElliotBayTrailMyrtlePark,07/02/2015 10:00:00 PM,48,-122,13,10,23
13151,ElliotBayTrailMyrtlePark,07/02/2015 11:00:00 PM,48,-122,7,3,10
13152,ElliotBayTrailMyrtlePark,07/03/2015 12:00:00 AM,48,-122,8,6,14
13153,ElliotBayTrailMyrtlePark,07/03/2015 01:00:00 AM,48,-122,4,0,4
13154,ElliotBayTrailMyrtlePark,07/03/2015 02:00:00 AM,48,-122,7,1,8
13155,ElliotBayTrailMyrtlePark,07/03/2015 03:00:00 AM,48,-122,2,0,2
13156,ElliotBayTrailMyrtlePark,07/03/2015 04:00:00 AM,48,-122,2,2,4
13157,ElliotBayTrailMyrtlePark,07/03/2015 05:00:00 AM,48,-122,3,3,6
13158,ElliotBayTrailMyrtlePark,07/03/2015 06:00:00 AM,48,-122,6,20,26
13159,ElliotBayTrailMyrtlePark,07/03/2015 07:00:00 AM,48,-122,15,25,40
13160,ElliotBayTrailMyrtlePark,07/03/2015 08:00:00 AM,48,-122,53,36,89
13161,ElliotBayTrailMyrtlePark,07/03/2015 09:00:00 AM,48,-122,59,31,90
13162,ElliotBayTrailMyrtlePark,07/03/2015 10:00:00 AM,48,-122,61,66,127
13163,ElliotBayTrailMyrtlePark,07/03/2015 11:00:00 AM,48,-122,43,60,103
13164,ElliotBayTrailMyrtlePark,07/03/2015 12:00:00 PM,48,-122,62,58,120
13165,ElliotBayTrailMyrtlePark,07/03/2015 01:00:00 PM,48,-122,57,43,100
13166,ElliotBayTrailMyrtlePark,07/03/2015 02:00:00 PM,48,-122,45,54,99
13167,ElliotBayTrailMyrtlePark,07/03/2015 03:00:00 PM,48,-122,82,65,147
13168,ElliotBayTrailMyrtlePark,07/03/2015 04:00:00 PM,48,-122,62,64,126
13169,ElliotBayTrailMyrtlePark,07/03/2015 05:00:00 PM,48,-122,57,45,102
13170,ElliotBayTrailMyrtlePark,07/03/2015 06:00:00 PM,48,-122,39,53,92
13171,ElliotBayTrailMyrtlePark,07/03/2015 07:00:00 PM,48,-122,42,52,94
13172,ElliotBayTrailMyrtlePark,07/03/2015 08:00:00 PM,48,-122,26,19,45
13173,ElliotBayTrailMyrtlePark,07/03/2015 09:00:00 PM,48,-122,16,13,29
13174,ElliotBayTrailMyrtlePark,07/03/2015 10:00:00 PM,48,-122,46,14,60
13175,ElliotBayTrailMyrtlePark,07/03/2015 11:00:00 PM,48,-122,23,3,26
13176,ElliotBayTrailMyrtlePark,07/04/2015 12:00:00 AM,48,-122,11,13,24
13177,ElliotBayTrailMyrtlePark,07/04/2015 01:00:00 AM,48,-122,2,0,2
13178,ElliotBayTrailMyrtlePark,07/04/2015 02:00:00 AM,48,-122,2,0,2
13179,ElliotBayTrailMyrtlePark,07/04/2015 03:00:00 AM,48,-122,0,1,1
13180,ElliotBayTrailMyrtlePark,07/04/2015 04:00:00 AM,48,-122,1,0,1
13181,ElliotBayTrailMyrtlePark,07/04/2015 05:00:00 AM,48,-122,1,1,2
13182,ElliotBayTrailMyrtlePark,07/04/2015 06:00:00 AM,48,-122,6,9,15
13183,ElliotBayTrailMyrtlePark,07/04/2015 07:00:00 AM,48,-122,13,11,24
13184,ElliotBayTrailMyrtlePark,07/04/2015 08:00:00 AM,48,-122,38,26,64
13185,ElliotBayTrailMyrtlePark,07/04/2015 09:00:00 AM,48,-122,56,37,93
13186,ElliotBayTrailMyrtlePark,07/04/2015 10:00:00 AM,48,-122,49,58,107
13187,ElliotBayTrailMyrtlePark,07/04/2015 11:00:00 AM,48,-122,64,75,139
13188,ElliotBayTrailMyrtlePark,07/04/2015 12:00:00 PM,48,-122,62,63,125
13189,ElliotBayTrailMyrtlePark,07/04/2015 01:00:00 PM,48,-122,56,59,115
13190,ElliotBayTrailMyrtlePark,07/04/2015 02:00:00 PM,48,-122,68,53,121
13191,ElliotBayTrailMyrtlePark,07/04/2015 03:00:00 PM,48,-122,50,52,102
13192,ElliotBayTrailMyrtlePark,07/04/2015 04:00:00 PM,48,-122,53,66,119
13193,ElliotBayTrailMyrtlePark,07/04/2015 05:00:00 PM,48,-122,43,36,79
13194,ElliotBayTrailMyrtlePark,07/04/2015 06:00:00 PM,48,-122,43,28,71
13195,ElliotBayTrailMyrtlePark,07/04/2015 07:00:00 PM,48,-122,17,12,29
13196,ElliotBayTrailMyrtlePark,07/04/2015 08:00:00 PM,48,-122,33,14,47
13197,ElliotBayTrailMyrtlePark,07/04/2015 09:00:00 PM,48,-122,20,11,31
13198,ElliotBayTrailMyrtlePark,07/04/2015 10:00:00 PM,48,-122,10,4,14
13199,ElliotBayTrailMyrtlePark,07/04/2015 11:00:00 PM,48,-122,3,9,12
13200,ElliotBayTrailMyrtlePark,07/05/2015 12:00:00 AM,48,-122,4,5,9
13201,ElliotBayTrailMyrtlePark,07/05/2015 01:00:00 AM,48,-122,6,1,7
13202,ElliotBayTrailMyrtlePark,07/05/2015 02:00:00 AM,48,-122,0,0,0
13203,ElliotBayTrailMyrtlePark,07/05/2015 03:00:00 AM,48,-122,5,0,5
13204,ElliotBayTrailMyrtlePark,07/05/2015 04:00:00 AM,48,-122,1,0,1
13205,ElliotBayTrailMyrtlePark,07/05/2015 05:00:00 AM,48,-122,1,0,1
13206,ElliotBayTrailMyrtlePark,07/05/2015 06:00:00 AM,48,-122,7,7,14
13207,ElliotBayTrailMyrtlePark,07/05/2015 07:00:00 AM,48,-122,12,19,31
13208,ElliotBayTrailMyrtlePark,07/05/2015 08:00:00 AM,48,-122,29,26,55
13209,ElliotBayTrailMyrtlePark,07/05/2015 09:00:00 AM,48,-122,48,32,80
13210,ElliotBayTrailMyrtlePark,07/05/2015 10:00:00 AM,48,-122,44,70,114
13211,ElliotBayTrailMyrtlePark,07/05/2015 11:00:00 AM,48,-122,78,59,137
13212,ElliotBayTrailMyrtlePark,07/05/2015 12:00:00 PM,48,-122,51,61,112
13213,ElliotBayTrailMyrtlePark,07/05/2015 01:00:00 PM,48,-122,56,71,127
13214,ElliotBayTrailMyrtlePark,07/05/2015 02:00:00 PM,48,-122,64,37,101
13215,ElliotBayTrailMyrtlePark,07/05/2015 03:00:00 PM,48,-122,48,42,90
13216,ElliotBayTrailMyrtlePark,07/05/2015 04:00:00 PM,48,-122,60,37,97
13217,ElliotBayTrailMyrtlePark,07/05/2015 05:00:00 PM,48,-122,49,35,84
13218,ElliotBayTrailMyrtlePark,07/05/2015 06:00:00 PM,48,-122,36,35,71
13219,ElliotBayTrailMyrtlePark,07/05/2015 07:00:00 PM,48,-122,26,24,50
13220,ElliotBayTrailMyrtlePark,07/05/2015 08:00:00 PM,48,-122,32,31,63
13221,ElliotBayTrailMyrtlePark,07/05/2015 09:00:00 PM,48,-122,10,16,26
13222,ElliotBayTrailMyrtlePark,07/05/2015 10:00:00 PM,48,-122,8,5,13
13223,ElliotBayTrailMyrtlePark,07/05/2015 11:00:00 PM,48,-122,9,2,11
13224,ElliotBayTrailMyrtlePark,07/06/2015 12:00:00 AM,48,-122,5,2,7
13225,ElliotBayTrailMyrtlePark,07/06/2015 01:00:00 AM,48,-122,0,0,0
13226,ElliotBayTrailMyrtlePark,07/06/2015 02:00:00 AM,48,-122,0,0,0
13227,ElliotBayTrailMyrtlePark,07/06/2015 03:00:00 AM,48,-122,1,1,2
13228,ElliotBayTrailMyrtlePark,07/06/2015 04:00:00 AM,48,-122,0,2,2
13229,ElliotBayTrailMyrtlePark,07/06/2015 05:00:00 AM,48,-122,9,7,16
13230,ElliotBayTrailMyrtlePark,07/06/2015 06:00:00 AM,48,-122,26,34,60
13231,ElliotBayTrailMyrtlePark,07/06/2015 07:00:00 AM,48,-122,41,94,135
13232,ElliotBayTrailMyrtlePark,07/06/2015 08:00:00 AM,48,-122,56,186,242
13233,ElliotBayTrailMyrtlePark,07/06/2015 09:00:00 AM,48,-122,73,93,166
13234,ElliotBayTrailMyrtlePark,07/06/2015 10:00:00 AM,48,-122,21,36,57
13235,ElliotBayTrailMyrtlePark,07/06/2015 11:00:00 AM,48,-122,28,26,54
13236,ElliotBayTrailMyrtlePark,07/06/2015 12:00:00 PM,48,-122,21,16,37
13237,ElliotBayTrailMyrtlePark,07/06/2015 01:00:00 PM,48,-122,29,36,65
13238,ElliotBayTrailMyrtlePark,07/06/2015 02:00:00 PM,48,-122,13,27,40
13239,ElliotBayTrailMyrtlePark,07/06/2015 03:00:00 PM,48,-122,38,24,62
13240,ElliotBayTrailMyrtlePark,07/06/2015 04:00:00 PM,48,-122,75,50,125
13241,ElliotBayTrailMyrtlePark,07/06/2015 05:00:00 PM,48,-122,229,71,300
13242,ElliotBayTrailMyrtlePark,07/06/2015 06:00:00 PM,48,-122,186,64,250
13243,ElliotBayTrailMyrtlePark,07/06/2015 07:00:00 PM,48,-122,77,38,115
13244,ElliotBayTrailMyrtlePark,07/06/2015 08:00:00 PM,48,-122,56,27,83
13245,ElliotBayTrailMyrtlePark,07/06/2015 09:00:00 PM,48,-122,15,27,42
13246,ElliotBayTrailMyrtlePark,07/06/2015 10:00:00 PM,48,-122,10,4,14
13247,ElliotBayTrailMyrtlePark,07/06/2015 11:00:00 PM,48,-122,11,2,13
13248,ElliotBayTrailMyrtlePark,07/07/2015 12:00:00 AM,48,-122,2,0,2
13249,ElliotBayTrailMyrtlePark,07/07/2015 01:00:00 AM,48,-122,0,0,0
13250,ElliotBayTrailMyrtlePark,07/07/2015 02:00:00 AM,48,-122,0,0,0
13251,ElliotBayTrailMyrtlePark,07/07/2015 03:00:00 AM,48,-122,1,1,2
13252,ElliotBayTrailMyrtlePark,07/07/2015 04:00:00 AM,48,-122,0,1,1
13253,ElliotBayTrailMyrtlePark,07/07/2015 05:00:00 AM,48,-122,13,11,24
13254,ElliotBayTrailMyrtlePark,07/07/2015 06:00:00 AM,48,-122,23,38,61
13255,ElliotBayTrailMyrtlePark,07/07/2015 07:00:00 AM,48,-122,54,111,165
13256,ElliotBayTrailMyrtlePark,07/07/2015 08:00:00 AM,48,-122,55,212,267
13257,ElliotBayTrailMyrtlePark,07/07/2015 09:00:00 AM,48,-122,34,127,161
13258,ElliotBayTrailMyrtlePark,07/07/2015 10:00:00 AM,48,-122,19,44,63
13259,ElliotBayTrailMyrtlePark,07/07/2015 11:00:00 AM,48,-122,22,23,45
13260,ElliotBayTrailMyrtlePark,07/07/2015 12:00:00 PM,48,-122,19,34,53
13261,ElliotBayTrailMyrtlePark,07/07/2015 01:00:00 PM,48,-122,25,22,47
13262,ElliotBayTrailMyrtlePark,07/07/2015 02:00:00 PM,48,-122,26,37,63
13263,ElliotBayTrailMyrtlePark,07/07/2015 03:00:00 PM,48,-122,43,37,80
13264,ElliotBayTrailMyrtlePark,07/07/2015 04:00:00 PM,48,-122,93,62,155
13265,ElliotBayTrailMyrtlePark,07/07/2015 05:00:00 PM,48,-122,244,81,325
13266,ElliotBayTrailMyrtlePark,07/07/2015 06:00:00 PM,48,-122,198,61,259
13267,ElliotBayTrailMyrtlePark,07/07/2015 07:00:00 PM,48,-122,95,48,143
13268,ElliotBayTrailMyrtlePark,07/07/2015 08:00:00 PM,48,-122,54,31,85
13269,ElliotBayTrailMyrtlePark,07/07/2015 09:00:00 PM,48,-122,14,14,28
13270,ElliotBayTrailMyrtlePark,07/07/2015 10:00:00 PM,48,-122,12,4,16
13271,ElliotBayTrailMyrtlePark,07/07/2015 11:00:00 PM,48,-122,16,7,23
13272,ElliotBayTrailMyrtlePark,07/08/2015 12:00:00 AM,48,-122,3,2,5
13273,ElliotBayTrailMyrtlePark,07/08/2015 01:00:00 AM,48,-122,0,0,0
13274,ElliotBayTrailMyrtlePark,07/08/2015 02:00:00 AM,48,-122,1,0,1
13275,ElliotBayTrailMyrtlePark,07/08/2015 03:00:00 AM,48,-122,1,0,1
13276,ElliotBayTrailMyrtlePark,07/08/2015 04:00:00 AM,48,-122,1,2,3
13277,ElliotBayTrailMyrtlePark,07/08/2015 05:00:00 AM,48,-122,7,12,19
13278,ElliotBayTrailMyrtlePark,07/08/2015 06:00:00 AM,48,-122,27,49,76
13279,ElliotBayTrailMyrtlePark,07/08/2015 07:00:00 AM,48,-122,53,118,171
13280,ElliotBayTrailMyrtlePark,07/08/2015 08:00:00 AM,48,-122,58,185,243
13281,ElliotBayTrailMyrtlePark,07/08/2015 09:00:00 AM,48,-122,37,125,162
13282,ElliotBayTrailMyrtlePark,07/08/2015 10:00:00 AM,48,-122,33,43,76
13283,ElliotBayTrailMyrtlePark,07/08/2015 11:00:00 AM,48,-122,18,41,59
13284,ElliotBayTrailMyrtlePark,07/08/2015 12:00:00 PM,48,-122,35,38,73
13285,ElliotBayTrailMyrtlePark,07/08/2015 01:00:00 PM,48,-122,30,32,62
13286,ElliotBayTrailMyrtlePark,07/08/2015 02:00:00 PM,48,-122,29,26,55
13287,ElliotBayTrailMyrtlePark,07/08/2015 03:00:00 PM,48,-122,52,28,80
13288,ElliotBayTrailMyrtlePark,07/08/2015 04:00:00 PM,48,-122,85,70,155
13289,ElliotBayTrailMyrtlePark,07/08/2015 05:00:00 PM,48,-122,239,70,309
13290,ElliotBayTrailMyrtlePark,07/08/2015 06:00:00 PM,48,-122,210,58,268
13291,ElliotBayTrailMyrtlePark,07/08/2015 07:00:00 PM,48,-122,92,31,123
13292,ElliotBayTrailMyrtlePark,07/08/2015 08:00:00 PM,48,-122,52,38,90
13293,ElliotBayTrailMyrtlePark,07/08/2015 09:00:00 PM,48,-122,17,25,42
13294,ElliotBayTrailMyrtlePark,07/08/2015 10:00:00 PM,48,-122,16,5,21
13295,ElliotBayTrailMyrtlePark,07/08/2015 11:00:00 PM,48,-122,5,2,7
13296,ElliotBayTrailMyrtlePark,07/09/2015 12:00:00 AM,48,-122,1,3,4
13297,ElliotBayTrailMyrtlePark,07/09/2015 01:00:00 AM,48,-122,0,0,0
13298,ElliotBayTrailMyrtlePark,07/09/2015 02:00:00 AM,48,-122,1,0,1
13299,ElliotBayTrailMyrtlePark,07/09/2015 03:00:00 AM,48,-122,1,0,1
13300,ElliotBayTrailMyrtlePark,07/09/2015 04:00:00 AM,48,-122,0,2,2
13301,ElliotBayTrailMyrtlePark,07/09/2015 05:00:00 AM,48,-122,6,13,19
13302,ElliotBayTrailMyrtlePark,07/09/2015 06:00:00 AM,48,-122,31,38,69
13303,ElliotBayTrailMyrtlePark,07/09/2015 07:00:00 AM,48,-122,47,102,149
13304,ElliotBayTrailMyrtlePark,07/09/2015 08:00:00 AM,48,-122,64,184,248
13305,ElliotBayTrailMyrtlePark,07/09/2015 09:00:00 AM,48,-122,51,117,168
13306,ElliotBayTrailMyrtlePark,07/09/2015 10:00:00 AM,48,-122,21,34,55
13307,ElliotBayTrailMyrtlePark,07/09/2015 11:00:00 AM,48,-122,11,33,44
13308,ElliotBayTrailMyrtlePark,07/09/2015 12:00:00 PM,48,-122,43,31,74
13309,ElliotBayTrailMyrtlePark,07/09/2015 01:00:00 PM,48,-122,26,23,49
13310,ElliotBayTrailMyrtlePark,07/09/2015 02:00:00 PM,48,-122,31,34,65
13311,ElliotBayTrailMyrtlePark,07/09/2015 03:00:00 PM,48,-122,46,26,72
13312,ElliotBayTrailMyrtlePark,07/09/2015 04:00:00 PM,48,-122,94,70,164
13313,ElliotBayTrailMyrtlePark,07/09/2015 05:00:00 PM,48,-122,211,75,286
13314,ElliotBayTrailMyrtlePark,07/09/2015 06:00:00 PM,48,-122,200,106,306
13315,ElliotBayTrailMyrtlePark,07/09/2015 07:00:00 PM,48,-122,93,64,157
13316,ElliotBayTrailMyrtlePark,07/09/2015 08:00:00 PM,48,-122,77,45,122
13317,ElliotBayTrailMyrtlePark,07/09/2015 09:00:00 PM,48,-122,16,23,39
13318,ElliotBayTrailMyrtlePark,07/09/2015 10:00:00 PM,48,-122,17,11,28
13319,ElliotBayTrailMyrtlePark,07/09/2015 11:00:00 PM,48,-122,15,4,19
13320,ElliotBayTrailMyrtlePark,07/10/2015 12:00:00 AM,48,-122,2,1,3
13321,ElliotBayTrailMyrtlePark,07/10/2015 01:00:00 AM,48,-122,1,1,2
13322,ElliotBayTrailMyrtlePark,07/10/2015 02:00:00 AM,48,-122,1,0,1
13323,ElliotBayTrailMyrtlePark,07/10/2015 03:00:00 AM,48,-122,0,0,0
13324,ElliotBayTrailMyrtlePark,07/10/2015 04:00:00 AM,48,-122,2,0,2
13325,ElliotBayTrailMyrtlePark,07/10/2015 05:00:00 AM,48,-122,4,10,14
13326,ElliotBayTrailMyrtlePark,07/10/2015 06:00:00 AM,48,-122,25,30,55
13327,ElliotBayTrailMyrtlePark,07/10/2015 07:00:00 AM,48,-122,38,85,123
13328,ElliotBayTrailMyrtlePark,07/10/2015 08:00:00 AM,48,-122,33,145,178
13329,ElliotBayTrailMyrtlePark,07/10/2015 09:00:00 AM,48,-122,42,110,152
13330,ElliotBayTrailMyrtlePark,07/10/2015 10:00:00 AM,48,-122,14,46,60
13331,ElliotBayTrailMyrtlePark,07/10/2015 11:00:00 AM,48,-122,22,30,52
13332,ElliotBayTrailMyrtlePark,07/10/2015 12:00:00 PM,48,-122,32,25,57
13333,ElliotBayTrailMyrtlePark,07/10/2015 01:00:00 PM,48,-122,45,43,88
13334,ElliotBayTrailMyrtlePark,07/10/2015 02:00:00 PM,48,-122,33,34,67
13335,ElliotBayTrailMyrtlePark,07/10/2015 03:00:00 PM,48,-122,70,37,107
13336,ElliotBayTrailMyrtlePark,07/10/2015 04:00:00 PM,48,-122,86,59,145
13337,ElliotBayTrailMyrtlePark,07/10/2015 05:00:00 PM,48,-122,190,63,253
13338,ElliotBayTrailMyrtlePark,07/10/2015 06:00:00 PM,48,-122,124,56,180
13339,ElliotBayTrailMyrtlePark,07/10/2015 07:00:00 PM,48,-122,46,14,60
13340,ElliotBayTrailMyrtlePark,07/10/2015 08:00:00 PM,48,-122,21,23,44
13341,ElliotBayTrailMyrtlePark,07/10/2015 09:00:00 PM,48,-122,7,4,11
13342,ElliotBayTrailMyrtlePark,07/10/2015 10:00:00 PM,48,-122,20,7,27
13343,ElliotBayTrailMyrtlePark,07/10/2015 11:00:00 PM,48,-122,17,3,20
13344,ElliotBayTrailMyrtlePark,07/11/2015 12:00:00 AM,48,-122,2,3,5
13345,ElliotBayTrailMyrtlePark,07/11/2015 01:00:00 AM,48,-122,3,1,4
13346,ElliotBayTrailMyrtlePark,07/11/2015 02:00:00 AM,48,-122,1,0,1
13347,ElliotBayTrailMyrtlePark,07/11/2015 03:00:00 AM,48,-122,4,1,5
13348,ElliotBayTrailMyrtlePark,07/11/2015 04:00:00 AM,48,-122,0,1,1
13349,ElliotBayTrailMyrtlePark,07/11/2015 05:00:00 AM,48,-122,1,2,3
13350,ElliotBayTrailMyrtlePark,07/11/2015 06:00:00 AM,48,-122,3,8,11
13351,ElliotBayTrailMyrtlePark,07/11/2015 07:00:00 AM,48,-122,6,12,18
13352,ElliotBayTrailMyrtlePark,07/11/2015 08:00:00 AM,48,-122,19,18,37
13353,ElliotBayTrailMyrtlePark,07/11/2015 09:00:00 AM,48,-122,25,40,65
13354,ElliotBayTrailMyrtlePark,07/11/2015 10:00:00 AM,48,-122,41,30,71
13355,ElliotBayTrailMyrtlePark,07/11/2015 11:00:00 AM,48,-122,48,33,81
13356,ElliotBayTrailMyrtlePark,07/11/2015 12:00:00 PM,48,-122,43,36,79
13357,ElliotBayTrailMyrtlePark,07/11/2015 01:00:00 PM,48,-122,56,40,96
13358,ElliotBayTrailMyrtlePark,07/11/2015 02:00:00 PM,48,-122,49,30,79
13359,ElliotBayTrailMyrtlePark,07/11/2015 03:00:00 PM,48,-122,42,57,99
13360,ElliotBayTrailMyrtlePark,07/11/2015 04:00:00 PM,48,-122,58,48,106
13361,ElliotBayTrailMyrtlePark,07/11/2015 05:00:00 PM,48,-122,43,36,79
13362,ElliotBayTrailMyrtlePark,07/11/2015 06:00:00 PM,48,-122,37,64,101
13363,ElliotBayTrailMyrtlePark,07/11/2015 07:00:00 PM,48,-122,28,24,52
13364,ElliotBayTrailMyrtlePark,07/11/2015 08:00:00 PM,48,-122,16,11,27
13365,ElliotBayTrailMyrtlePark,07/11/2015 09:00:00 PM,48,-122,15,9,24
13366,ElliotBayTrailMyrtlePark,07/11/2015 10:00:00 PM,48,-122,8,6,14
13367,ElliotBayTrailMyrtlePark,07/11/2015 11:00:00 PM,48,-122,13,0,13
13368,ElliotBayTrailMyrtlePark,07/12/2015 12:00:00 AM,48,-122,4,2,6
13369,ElliotBayTrailMyrtlePark,07/12/2015 01:00:00 AM,48,-122,4,0,4
13370,ElliotBayTrailMyrtlePark,07/12/2015 02:00:00 AM,48,-122,1,1,2
13371,ElliotBayTrailMyrtlePark,07/12/2015 03:00:00 AM,48,-122,0,0,0
13372,ElliotBayTrailMyrtlePark,07/12/2015 04:00:00 AM,48,-122,0,0,0
13373,ElliotBayTrailMyrtlePark,07/12/2015 05:00:00 AM,48,-122,3,0,3
13374,ElliotBayTrailMyrtlePark,07/12/2015 06:00:00 AM,48,-122,2,6,8
13375,ElliotBayTrailMyrtlePark,07/12/2015 07:00:00 AM,48,-122,8,4,12
13376,ElliotBayTrailMyrtlePark,07/12/2015 08:00:00 AM,48,-122,18,26,44
13377,ElliotBayTrailMyrtlePark,07/12/2015 09:00:00 AM,48,-122,28,25,53
13378,ElliotBayTrailMyrtlePark,07/12/2015 10:00:00 AM,48,-122,51,30,81
13379,ElliotBayTrailMyrtlePark,07/12/2015 11:00:00 AM,48,-122,41,39,80
13380,ElliotBayTrailMyrtlePark,07/12/2015 12:00:00 PM,48,-122,46,69,115
13381,ElliotBayTrailMyrtlePark,07/12/2015 01:00:00 PM,48,-122,73,90,163
13382,ElliotBayTrailMyrtlePark,07/12/2015 02:00:00 PM,48,-122,58,67,125
13383,ElliotBayTrailMyrtlePark,07/12/2015 03:00:00 PM,48,-122,85,58,143
13384,ElliotBayTrailMyrtlePark,07/12/2015 04:00:00 PM,48,-122,114,62,176
13385,ElliotBayTrailMyrtlePark,07/12/2015 05:00:00 PM,48,-122,85,52,137
13386,ElliotBayTrailMyrtlePark,07/12/2015 06:00:00 PM,48,-122,55,50,105
13387,ElliotBayTrailMyrtlePark,07/12/2015 07:00:00 PM,48,-122,47,27,74
13388,ElliotBayTrailMyrtlePark,07/12/2015 08:00:00 PM,48,-122,26,31,57
13389,ElliotBayTrailMyrtlePark,07/12/2015 09:00:00 PM,48,-122,4,13,17
13390,ElliotBayTrailMyrtlePark,07/12/2015 10:00:00 PM,48,-122,10,9,19
13391,ElliotBayTrailMyrtlePark,07/12/2015 11:00:00 PM,48,-122,2,1,3
13392,ElliotBayTrailMyrtlePark,07/13/2015 12:00:00 AM,48,-122,2,1,3
13393,ElliotBayTrailMyrtlePark,07/13/2015 01:00:00 AM,48,-122,3,0,3
13394,ElliotBayTrailMyrtlePark,07/13/2015 02:00:00 AM,48,-122,0,0,0
13395,ElliotBayTrailMyrtlePark,07/13/2015 03:00:00 AM,48,-122,4,0,4
13396,ElliotBayTrailMyrtlePark,07/13/2015 04:00:00 AM,48,-122,2,0,2
13397,ElliotBayTrailMyrtlePark,07/13/2015 05:00:00 AM,48,-122,6,7,13
13398,ElliotBayTrailMyrtlePark,07/13/2015 06:00:00 AM,48,-122,15,33,48
13399,ElliotBayTrailMyrtlePark,07/13/2015 07:00:00 AM,48,-122,33,97,130
13400,ElliotBayTrailMyrtlePark,07/13/2015 08:00:00 AM,48,-122,45,183,228
13401,ElliotBayTrailMyrtlePark,07/13/2015 09:00:00 AM,48,-122,23,85,108
13402,ElliotBayTrailMyrtlePark,07/13/2015 10:00:00 AM,48,-122,12,35,47
13403,ElliotBayTrailMyrtlePark,07/13/2015 11:00:00 AM,48,-122,29,27,56
13404,ElliotBayTrailMyrtlePark,07/13/2015 12:00:00 PM,48,-122,24,24,48
13405,ElliotBayTrailMyrtlePark,07/13/2015 01:00:00 PM,48,-122,14,30,44
13406,ElliotBayTrailMyrtlePark,07/13/2015 02:00:00 PM,48,-122,35,25,60
13407,ElliotBayTrailMyrtlePark,07/13/2015 03:00:00 PM,48,-122,49,32,81
13408,ElliotBayTrailMyrtlePark,07/13/2015 04:00:00 PM,48,-122,90,71,161
13409,ElliotBayTrailMyrtlePark,07/13/2015 05:00:00 PM,48,-122,214,67,281
13410,ElliotBayTrailMyrtlePark,07/13/2015 06:00:00 PM,48,-122,158,59,217
13411,ElliotBayTrailMyrtlePark,07/13/2015 07:00:00 PM,48,-122,62,29,91
13412,ElliotBayTrailMyrtlePark,07/13/2015 08:00:00 PM,48,-122,38,32,70
13413,ElliotBayTrailMyrtlePark,07/13/2015 09:00:00 PM,48,-122,16,15,31
13414,ElliotBayTrailMyrtlePark,07/13/2015 10:00:00 PM,48,-122,13,3,16
13415,ElliotBayTrailMyrtlePark,07/13/2015 11:00:00 PM,48,-122,5,2,7
13416,ElliotBayTrailMyrtlePark,07/14/2015 12:00:00 AM,48,-122,3,2,5
13417,ElliotBayTrailMyrtlePark,07/14/2015 01:00:00 AM,48,-122,1,0,1
13418,ElliotBayTrailMyrtlePark,07/14/2015 02:00:00 AM,48,-122,2,0,2
13419,ElliotBayTrailMyrtlePark,07/14/2015 03:00:00 AM,48,-122,2,1,3
13420,ElliotBayTrailMyrtlePark,07/14/2015 04:00:00 AM,48,-122,0,0,0
13421,ElliotBayTrailMyrtlePark,07/14/2015 05:00:00 AM,48,-122,8,16,24
13422,ElliotBayTrailMyrtlePark,07/14/2015 06:00:00 AM,48,-122,23,37,60
13423,ElliotBayTrailMyrtlePark,07/14/2015 07:00:00 AM,48,-122,45,121,166
13424,ElliotBayTrailMyrtlePark,07/14/2015 08:00:00 AM,48,-122,72,197,269
13425,ElliotBayTrailMyrtlePark,07/14/2015 09:00:00 AM,48,-122,61,79,140
13426,ElliotBayTrailMyrtlePark,07/14/2015 10:00:00 AM,48,-122,22,39,61
13427,ElliotBayTrailMyrtlePark,07/14/2015 11:00:00 AM,48,-122,26,20,46
13428,ElliotBayTrailMyrtlePark,07/14/2015 12:00:00 PM,48,-122,23,23,46
13429,ElliotBayTrailMyrtlePark,07/14/2015 01:00:00 PM,48,-122,33,34,67
13430,ElliotBayTrailMyrtlePark,07/14/2015 02:00:00 PM,48,-122,32,34,66
13431,ElliotBayTrailMyrtlePark,07/14/2015 03:00:00 PM,48,-122,52,38,90
13432,ElliotBayTrailMyrtlePark,07/14/2015 04:00:00 PM,48,-122,102,59,161
13433,ElliotBayTrailMyrtlePark,07/14/2015 05:00:00 PM,48,-122,282,103,385
13434,ElliotBayTrailMyrtlePark,07/14/2015 06:00:00 PM,48,-122,217,69,286
13435,ElliotBayTrailMyrtlePark,07/14/2015 07:00:00 PM,48,-122,104,52,156
13436,ElliotBayTrailMyrtlePark,07/14/2015 08:00:00 PM,48,-122,49,37,86
13437,ElliotBayTrailMyrtlePark,07/14/2015 09:00:00 PM,48,-122,21,13,34
13438,ElliotBayTrailMyrtlePark,07/14/2015 10:00:00 PM,48,-122,10,11,21
13439,ElliotBayTrailMyrtlePark,07/14/2015 11:00:00 PM,48,-122,17,3,20
13440,ElliotBayTrailMyrtlePark,07/15/2015 12:00:00 AM,48,-122,3,1,4
13441,ElliotBayTrailMyrtlePark,07/15/2015 01:00:00 AM,48,-122,0,1,1
13442,ElliotBayTrailMyrtlePark,07/15/2015 02:00:00 AM,48,-122,2,1,3
13443,ElliotBayTrailMyrtlePark,07/15/2015 03:00:00 AM,48,-122,0,0,0
13444,ElliotBayTrailMyrtlePark,07/15/2015 04:00:00 AM,48,-122,1,0,1
13445,ElliotBayTrailMyrtlePark,07/15/2015 05:00:00 AM,48,-122,8,12,20
13446,ElliotBayTrailMyrtlePark,07/15/2015 06:00:00 AM,48,-122,27,36,63
13447,ElliotBayTrailMyrtlePark,07/15/2015 07:00:00 AM,48,-122,62,105,167
13448,ElliotBayTrailMyrtlePark,07/15/2015 08:00:00 AM,48,-122,78,189,267
13449,ElliotBayTrailMyrtlePark,07/15/2015 09:00:00 AM,48,-122,44,104,148
13450,ElliotBayTrailMyrtlePark,07/15/2015 10:00:00 AM,48,-122,27,50,77
13451,ElliotBayTrailMyrtlePark,07/15/2015 11:00:00 AM,48,-122,29,33,62
13452,ElliotBayTrailMyrtlePark,07/15/2015 12:00:00 PM,48,-122,28,36,64
13453,ElliotBayTrailMyrtlePark,07/15/2015 01:00:00 PM,48,-122,30,26,56
13454,ElliotBayTrailMyrtlePark,07/15/2015 02:00:00 PM,48,-122,35,23,58
13455,ElliotBayTrailMyrtlePark,07/15/2015 03:00:00 PM,48,-122,39,32,71
13456,ElliotBayTrailMyrtlePark,07/15/2015 04:00:00 PM,48,-122,113,53,166
13457,ElliotBayTrailMyrtlePark,07/15/2015 05:00:00 PM,48,-122,254,96,350
13458,ElliotBayTrailMyrtlePark,07/15/2015 06:00:00 PM,48,-122,195,61,256
13459,ElliotBayTrailMyrtlePark,07/15/2015 07:00:00 PM,48,-122,81,46,127
13460,ElliotBayTrailMyrtlePark,07/15/2015 08:00:00 PM,48,-122,41,50,91
13461,ElliotBayTrailMyrtlePark,07/15/2015 09:00:00 PM,48,-122,13,15,28
13462,ElliotBayTrailMyrtlePark,07/15/2015 10:00:00 PM,48,-122,2,2,4
13463,ElliotBayTrailMyrtlePark,07/15/2015 11:00:00 PM,48,-122,8,4,12
13464,ElliotBayTrailMyrtlePark,07/16/2015 12:00:00 AM,48,-122,6,2,8
13465,ElliotBayTrailMyrtlePark,07/16/2015 01:00:00 AM,48,-122,2,1,3
13466,ElliotBayTrailMyrtlePark,07/16/2015 02:00:00 AM,48,-122,2,1,3
13467,ElliotBayTrailMyrtlePark,07/16/2015 03:00:00 AM,48,-122,1,0,1
13468,ElliotBayTrailMyrtlePark,07/16/2015 04:00:00 AM,48,-122,1,0,1
13469,ElliotBayTrailMyrtlePark,07/16/2015 05:00:00 AM,48,-122,8,9,17
13470,ElliotBayTrailMyrtlePark,07/16/2015 06:00:00 AM,48,-122,22,33,55
13471,ElliotBayTrailMyrtlePark,07/16/2015 07:00:00 AM,48,-122,45,94,139
13472,ElliotBayTrailMyrtlePark,07/16/2015 08:00:00 AM,48,-122,63,178,241
13473,ElliotBayTrailMyrtlePark,07/16/2015 09:00:00 AM,48,-122,30,113,143
13474,ElliotBayTrailMyrtlePark,07/16/2015 10:00:00 AM,48,-122,31,45,76
13475,ElliotBayTrailMyrtlePark,07/16/2015 11:00:00 AM,48,-122,18,38,56
13476,ElliotBayTrailMyrtlePark,07/16/2015 12:00:00 PM,48,-122,44,32,76
13477,ElliotBayTrailMyrtlePark,07/16/2015 01:00:00 PM,48,-122,29,39,68
13478,ElliotBayTrailMyrtlePark,07/16/2015 02:00:00 PM,48,-122,42,48,90
13479,ElliotBayTrailMyrtlePark,07/16/2015 03:00:00 PM,48,-122,47,33,80
13480,ElliotBayTrailMyrtlePark,07/16/2015 04:00:00 PM,48,-122,110,74,184
13481,ElliotBayTrailMyrtlePark,07/16/2015 05:00:00 PM,48,-122,222,83,305
13482,ElliotBayTrailMyrtlePark,07/16/2015 06:00:00 PM,48,-122,142,62,204
13483,ElliotBayTrailMyrtlePark,07/16/2015 07:00:00 PM,48,-122,129,51,180
13484,ElliotBayTrailMyrtlePark,07/16/2015 08:00:00 PM,48,-122,51,19,70
13485,ElliotBayTrailMyrtlePark,07/16/2015 09:00:00 PM,48,-122,17,21,38
13486,ElliotBayTrailMyrtlePark,07/16/2015 10:00:00 PM,48,-122,15,10,25
13487,ElliotBayTrailMyrtlePark,07/16/2015 11:00:00 PM,48,-122,9,8,17
13488,ElliotBayTrailMyrtlePark,07/17/2015 12:00:00 AM,48,-122,6,1,7
13489,ElliotBayTrailMyrtlePark,07/17/2015 01:00:00 AM,48,-122,0,0,0
13490,ElliotBayTrailMyrtlePark,07/17/2015 02:00:00 AM,48,-122,0,0,0
13491,ElliotBayTrailMyrtlePark,07/17/2015 03:00:00 AM,48,-122,5,1,6
13492,ElliotBayTrailMyrtlePark,07/17/2015 04:00:00 AM,48,-122,0,0,0
13493,ElliotBayTrailMyrtlePark,07/17/2015 05:00:00 AM,48,-122,6,11,17
13494,ElliotBayTrailMyrtlePark,07/17/2015 06:00:00 AM,48,-122,32,29,61
13495,ElliotBayTrailMyrtlePark,07/17/2015 07:00:00 AM,48,-122,42,95,137
13496,ElliotBayTrailMyrtlePark,07/17/2015 08:00:00 AM,48,-122,47,185,232
13497,ElliotBayTrailMyrtlePark,07/17/2015 09:00:00 AM,48,-122,42,92,134
13498,ElliotBayTrailMyrtlePark,07/17/2015 10:00:00 AM,48,-122,18,32,50
13499,ElliotBayTrailMyrtlePark,07/17/2015 11:00:00 AM,48,-122,32,32,64
13500,ElliotBayTrailMyrtlePark,07/17/2015 12:00:00 PM,48,-122,31,39,70
13501,ElliotBayTrailMyrtlePark,07/17/2015 01:00:00 PM,48,-122,38,30,68
13502,ElliotBayTrailMyrtlePark,07/17/2015 02:00:00 PM,48,-122,61,43,104
13503,ElliotBayTrailMyrtlePark,07/17/2015 03:00:00 PM,48,-122,64,67,131
13504,ElliotBayTrailMyrtlePark,07/17/2015 04:00:00 PM,48,-122,120,59,179
13505,ElliotBayTrailMyrtlePark,07/17/2015 05:00:00 PM,48,-122,156,75,231
13506,ElliotBayTrailMyrtlePark,07/17/2015 06:00:00 PM,48,-122,123,53,176
13507,ElliotBayTrailMyrtlePark,07/17/2015 07:00:00 PM,48,-122,64,42,106
13508,ElliotBayTrailMyrtlePark,07/17/2015 08:00:00 PM,48,-122,42,32,74
13509,ElliotBayTrailMyrtlePark,07/17/2015 09:00:00 PM,48,-122,16,18,34
13510,ElliotBayTrailMyrtlePark,07/17/2015 10:00:00 PM,48,-122,23,12,35
13511,ElliotBayTrailMyrtlePark,07/17/2015 11:00:00 PM,48,-122,10,10,20
13512,ElliotBayTrailMyrtlePark,07/18/2015 12:00:00 AM,48,-122,5,1,6
13513,ElliotBayTrailMyrtlePark,07/18/2015 01:00:00 AM,48,-122,6,1,7
13514,ElliotBayTrailMyrtlePark,07/18/2015 02:00:00 AM,48,-122,2,1,3
13515,ElliotBayTrailMyrtlePark,07/18/2015 03:00:00 AM,48,-122,2,0,2
13516,ElliotBayTrailMyrtlePark,07/18/2015 04:00:00 AM,48,-122,2,0,2
13517,ElliotBayTrailMyrtlePark,07/18/2015 05:00:00 AM,48,-122,2,2,4
13518,ElliotBayTrailMyrtlePark,07/18/2015 06:00:00 AM,48,-122,6,11,17
13519,ElliotBayTrailMyrtlePark,07/18/2015 07:00:00 AM,48,-122,16,14,30
13520,ElliotBayTrailMyrtlePark,07/18/2015 08:00:00 AM,48,-122,30,23,53
13521,ElliotBayTrailMyrtlePark,07/18/2015 09:00:00 AM,48,-122,45,43,88
13522,ElliotBayTrailMyrtlePark,07/18/2015 10:00:00 AM,48,-122,52,73,125
13523,ElliotBayTrailMyrtlePark,07/18/2015 11:00:00 AM,48,-122,65,49,114
13524,ElliotBayTrailMyrtlePark,07/18/2015 12:00:00 PM,48,-122,49,60,109
13525,ElliotBayTrailMyrtlePark,07/18/2015 01:00:00 PM,48,-122,68,66,134
13526,ElliotBayTrailMyrtlePark,07/18/2015 02:00:00 PM,48,-122,58,51,109
13527,ElliotBayTrailMyrtlePark,07/18/2015 03:00:00 PM,48,-122,68,49,117
13528,ElliotBayTrailMyrtlePark,07/18/2015 04:00:00 PM,48,-122,83,67,150
13529,ElliotBayTrailMyrtlePark,07/18/2015 05:00:00 PM,48,-122,58,64,122
13530,ElliotBayTrailMyrtlePark,07/18/2015 06:00:00 PM,48,-122,55,74,129
13531,ElliotBayTrailMyrtlePark,07/18/2015 07:00:00 PM,48,-122,46,33,79
13532,ElliotBayTrailMyrtlePark,07/18/2015 08:00:00 PM,48,-122,39,38,77
13533,ElliotBayTrailMyrtlePark,07/18/2015 09:00:00 PM,48,-122,56,22,78
13534,ElliotBayTrailMyrtlePark,07/18/2015 10:00:00 PM,48,-122,14,21,35
13535,ElliotBayTrailMyrtlePark,07/18/2015 11:00:00 PM,48,-122,24,5,29
13536,ElliotBayTrailMyrtlePark,07/19/2015 12:00:00 AM,48,-122,6,1,7
13537,ElliotBayTrailMyrtlePark,07/19/2015 01:00:00 AM,48,-122,5,1,6
13538,ElliotBayTrailMyrtlePark,07/19/2015 02:00:00 AM,48,-122,4,0,4
13539,ElliotBayTrailMyrtlePark,07/19/2015 03:00:00 AM,48,-122,0,2,2
13540,ElliotBayTrailMyrtlePark,07/19/2015 04:00:00 AM,48,-122,3,1,4
13541,ElliotBayTrailMyrtlePark,07/19/2015 05:00:00 AM,48,-122,0,1,1
13542,ElliotBayTrailMyrtlePark,07/19/2015 06:00:00 AM,48,-122,3,3,6
13543,ElliotBayTrailMyrtlePark,07/19/2015 07:00:00 AM,48,-122,9,9,18
13544,ElliotBayTrailMyrtlePark,07/19/2015 08:00:00 AM,48,-122,28,21,49
13545,ElliotBayTrailMyrtlePark,07/19/2015 09:00:00 AM,48,-122,49,44,93
13546,ElliotBayTrailMyrtlePark,07/19/2015 10:00:00 AM,48,-122,44,60,104
13547,ElliotBayTrailMyrtlePark,07/19/2015 11:00:00 AM,48,-122,82,64,146
13548,ElliotBayTrailMyrtlePark,07/19/2015 12:00:00 PM,48,-122,68,84,152
13549,ElliotBayTrailMyrtlePark,07/19/2015 01:00:00 PM,48,-122,74,43,117
13550,ElliotBayTrailMyrtlePark,07/19/2015 02:00:00 PM,48,-122,73,37,110
13551,ElliotBayTrailMyrtlePark,07/19/2015 03:00:00 PM,48,-122,49,37,86
13552,ElliotBayTrailMyrtlePark,07/19/2015 04:00:00 PM,48,-122,37,41,78
13553,ElliotBayTrailMyrtlePark,07/19/2015 05:00:00 PM,48,-122,31,36,67
13554,ElliotBayTrailMyrtlePark,07/19/2015 06:00:00 PM,48,-122,32,22,54
13555,ElliotBayTrailMyrtlePark,07/19/2015 07:00:00 PM,48,-122,40,22,62
13556,ElliotBayTrailMyrtlePark,07/19/2015 08:00:00 PM,48,-122,21,20,41
13557,ElliotBayTrailMyrtlePark,07/19/2015 09:00:00 PM,48,-122,16,21,37
13558,ElliotBayTrailMyrtlePark,07/19/2015 10:00:00 PM,48,-122,6,3,9
13559,ElliotBayTrailMyrtlePark,07/19/2015 11:00:00 PM,48,-122,2,2,4
13560,ElliotBayTrailMyrtlePark,07/20/2015 12:00:00 AM,48,-122,1,2,3
13561,ElliotBayTrailMyrtlePark,07/20/2015 01:00:00 AM,48,-122,0,0,0
13562,ElliotBayTrailMyrtlePark,07/20/2015 02:00:00 AM,48,-122,0,0,0
13563,ElliotBayTrailMyrtlePark,07/20/2015 03:00:00 AM,48,-122,1,2,3
13564,ElliotBayTrailMyrtlePark,07/20/2015 04:00:00 AM,48,-122,1,0,1
13565,ElliotBayTrailMyrtlePark,07/20/2015 05:00:00 AM,48,-122,8,9,17
13566,ElliotBayTrailMyrtlePark,07/20/2015 06:00:00 AM,48,-122,20,25,45
13567,ElliotBayTrailMyrtlePark,07/20/2015 07:00:00 AM,48,-122,36,65,101
13568,ElliotBayTrailMyrtlePark,07/20/2015 08:00:00 AM,48,-122,38,179,217
13569,ElliotBayTrailMyrtlePark,07/20/2015 09:00:00 AM,48,-122,38,115,153
13570,ElliotBayTrailMyrtlePark,07/20/2015 10:00:00 AM,48,-122,19,50,69
13571,ElliotBayTrailMyrtlePark,07/20/2015 11:00:00 AM,48,-122,21,21,42
13572,ElliotBayTrailMyrtlePark,07/20/2015 12:00:00 PM,48,-122,30,30,60
13573,ElliotBayTrailMyrtlePark,07/20/2015 01:00:00 PM,48,-122,16,23,39
13574,ElliotBayTrailMyrtlePark,07/20/2015 02:00:00 PM,48,-122,18,19,37
13575,ElliotBayTrailMyrtlePark,07/20/2015 03:00:00 PM,48,-122,46,21,67
13576,ElliotBayTrailMyrtlePark,07/20/2015 04:00:00 PM,48,-122,97,43,140
13577,ElliotBayTrailMyrtlePark,07/20/2015 05:00:00 PM,48,-122,209,63,272
13578,ElliotBayTrailMyrtlePark,07/20/2015 06:00:00 PM,48,-122,181,51,232
13579,ElliotBayTrailMyrtlePark,07/20/2015 07:00:00 PM,48,-122,84,41,125
13580,ElliotBayTrailMyrtlePark,07/20/2015 08:00:00 PM,48,-122,57,27,84
13581,ElliotBayTrailMyrtlePark,07/20/2015 09:00:00 PM,48,-122,8,14,22
13582,ElliotBayTrailMyrtlePark,07/20/2015 10:00:00 PM,48,-122,6,3,9
13583,ElliotBayTrailMyrtlePark,07/20/2015 11:00:00 PM,48,-122,3,0,3
13584,ElliotBayTrailMyrtlePark,07/21/2015 12:00:00 AM,48,-122,4,0,4
13585,ElliotBayTrailMyrtlePark,07/21/2015 01:00:00 AM,48,-122,1,0,1
13586,ElliotBayTrailMyrtlePark,07/21/2015 02:00:00 AM,48,-122,0,0,0
13587,ElliotBayTrailMyrtlePark,07/21/2015 03:00:00 AM,48,-122,1,1,2
13588,ElliotBayTrailMyrtlePark,07/21/2015 04:00:00 AM,48,-122,1,2,3
13589,ElliotBayTrailMyrtlePark,07/21/2015 05:00:00 AM,48,-122,4,14,18
13590,ElliotBayTrailMyrtlePark,07/21/2015 06:00:00 AM,48,-122,29,48,77
13591,ElliotBayTrailMyrtlePark,07/21/2015 07:00:00 AM,48,-122,36,105,141
13592,ElliotBayTrailMyrtlePark,07/21/2015 08:00:00 AM,48,-122,57,206,263
13593,ElliotBayTrailMyrtlePark,07/21/2015 09:00:00 AM,48,-122,26,120,146
13594,ElliotBayTrailMyrtlePark,07/21/2015 10:00:00 AM,48,-122,13,27,40
13595,ElliotBayTrailMyrtlePark,07/21/2015 11:00:00 AM,48,-122,14,17,31
13596,ElliotBayTrailMyrtlePark,07/21/2015 12:00:00 PM,48,-122,25,16,41
13597,ElliotBayTrailMyrtlePark,07/21/2015 01:00:00 PM,48,-122,22,24,46
13598,ElliotBayTrailMyrtlePark,07/21/2015 02:00:00 PM,48,-122,33,31,64
13599,ElliotBayTrailMyrtlePark,07/21/2015 03:00:00 PM,48,-122,45,31,76
13600,ElliotBayTrailMyrtlePark,07/21/2015 04:00:00 PM,48,-122,91,50,141
13601,ElliotBayTrailMyrtlePark,07/21/2015 05:00:00 PM,48,-122,212,67,279
13602,ElliotBayTrailMyrtlePark,07/21/2015 06:00:00 PM,48,-122,190,49,239
13603,ElliotBayTrailMyrtlePark,07/21/2015 07:00:00 PM,48,-122,76,37,113
13604,ElliotBayTrailMyrtlePark,07/21/2015 08:00:00 PM,48,-122,34,22,56
13605,ElliotBayTrailMyrtlePark,07/21/2015 09:00:00 PM,48,-122,23,14,37
13606,ElliotBayTrailMyrtlePark,07/21/2015 10:00:00 PM,48,-122,9,7,16
13607,ElliotBayTrailMyrtlePark,07/21/2015 11:00:00 PM,48,-122,6,1,7
13608,ElliotBayTrailMyrtlePark,07/22/2015 12:00:00 AM,48,-122,3,0,3
13609,ElliotBayTrailMyrtlePark,07/22/2015 01:00:00 AM,48,-122,1,0,1
13610,ElliotBayTrailMyrtlePark,07/22/2015 02:00:00 AM,48,-122,1,0,1
13611,ElliotBayTrailMyrtlePark,07/22/2015 03:00:00 AM,48,-122,0,1,1
13612,ElliotBayTrailMyrtlePark,07/22/2015 04:00:00 AM,48,-122,0,1,1
13613,ElliotBayTrailMyrtlePark,07/22/2015 05:00:00 AM,48,-122,5,10,15
13614,ElliotBayTrailMyrtlePark,07/22/2015 06:00:00 AM,48,-122,27,34,61
13615,ElliotBayTrailMyrtlePark,07/22/2015 07:00:00 AM,48,-122,40,113,153
13616,ElliotBayTrailMyrtlePark,07/22/2015 08:00:00 AM,48,-122,64,202,266
13617,ElliotBayTrailMyrtlePark,07/22/2015 09:00:00 AM,48,-122,36,117,153
13618,ElliotBayTrailMyrtlePark,07/22/2015 10:00:00 AM,48,-122,25,44,69
13619,ElliotBayTrailMyrtlePark,07/22/2015 11:00:00 AM,48,-122,27,47,74
13620,ElliotBayTrailMyrtlePark,07/22/2015 12:00:00 PM,48,-122,27,26,53
13621,ElliotBayTrailMyrtlePark,07/22/2015 01:00:00 PM,48,-122,44,29,73
13622,ElliotBayTrailMyrtlePark,07/22/2015 02:00:00 PM,48,-122,36,19,55
13623,ElliotBayTrailMyrtlePark,07/22/2015 03:00:00 PM,48,-122,54,39,93
13624,ElliotBayTrailMyrtlePark,07/22/2015 04:00:00 PM,48,-122,107,71,178
13625,ElliotBayTrailMyrtlePark,07/22/2015 05:00:00 PM,48,-122,226,101,327
13626,ElliotBayTrailMyrtlePark,07/22/2015 06:00:00 PM,48,-122,209,63,272
13627,ElliotBayTrailMyrtlePark,07/22/2015 07:00:00 PM,48,-122,85,59,144
13628,ElliotBayTrailMyrtlePark,07/22/2015 08:00:00 PM,48,-122,45,28,73
13629,ElliotBayTrailMyrtlePark,07/22/2015 09:00:00 PM,48,-122,9,10,19
13630,ElliotBayTrailMyrtlePark,07/22/2015 10:00:00 PM,48,-122,7,7,14
13631,ElliotBayTrailMyrtlePark,07/22/2015 11:00:00 PM,48,-122,7,8,15
13632,ElliotBayTrailMyrtlePark,07/23/2015 12:00:00 AM,48,-122,7,0,7
13633,ElliotBayTrailMyrtlePark,07/23/2015 01:00:00 AM,48,-122,0,0,0
13634,ElliotBayTrailMyrtlePark,07/23/2015 02:00:00 AM,48,-122,1,0,1
13635,ElliotBayTrailMyrtlePark,07/23/2015 03:00:00 AM,48,-122,2,0,2
13636,ElliotBayTrailMyrtlePark,07/23/2015 04:00:00 AM,48,-122,0,1,1
13637,ElliotBayTrailMyrtlePark,07/23/2015 05:00:00 AM,48,-122,3,8,11
13638,ElliotBayTrailMyrtlePark,07/23/2015 06:00:00 AM,48,-122,27,29,56
13639,ElliotBayTrailMyrtlePark,07/23/2015 07:00:00 AM,48,-122,45,87,132
13640,ElliotBayTrailMyrtlePark,07/23/2015 08:00:00 AM,48,-122,48,197,245
13641,ElliotBayTrailMyrtlePark,07/23/2015 09:00:00 AM,48,-122,30,111,141
13642,ElliotBayTrailMyrtlePark,07/23/2015 10:00:00 AM,48,-122,36,39,75
13643,ElliotBayTrailMyrtlePark,07/23/2015 11:00:00 AM,48,-122,27,42,69
13644,ElliotBayTrailMyrtlePark,07/23/2015 12:00:00 PM,48,-122,29,44,73
13645,ElliotBayTrailMyrtlePark,07/23/2015 01:00:00 PM,48,-122,31,38,69
13646,ElliotBayTrailMyrtlePark,07/23/2015 02:00:00 PM,48,-122,35,31,66
13647,ElliotBayTrailMyrtlePark,07/23/2015 03:00:00 PM,48,-122,68,43,111
13648,ElliotBayTrailMyrtlePark,07/23/2015 04:00:00 PM,48,-122,100,78,178
13649,ElliotBayTrailMyrtlePark,07/23/2015 05:00:00 PM,48,-122,212,81,293
13650,ElliotBayTrailMyrtlePark,07/23/2015 06:00:00 PM,48,-122,193,68,261
13651,ElliotBayTrailMyrtlePark,07/23/2015 07:00:00 PM,48,-122,87,39,126
13652,ElliotBayTrailMyrtlePark,07/23/2015 08:00:00 PM,48,-122,54,21,75
13653,ElliotBayTrailMyrtlePark,07/23/2015 09:00:00 PM,48,-122,22,15,37
13654,ElliotBayTrailMyrtlePark,07/23/2015 10:00:00 PM,48,-122,18,6,24
13655,ElliotBayTrailMyrtlePark,07/23/2015 11:00:00 PM,48,-122,8,3,11
13656,ElliotBayTrailMyrtlePark,07/24/2015 12:00:00 AM,48,-122,8,4,12
13657,ElliotBayTrailMyrtlePark,07/24/2015 01:00:00 AM,48,-122,0,0,0
13658,ElliotBayTrailMyrtlePark,07/24/2015 02:00:00 AM,48,-122,3,3,6
13659,ElliotBayTrailMyrtlePark,07/24/2015 03:00:00 AM,48,-122,1,0,1
13660,ElliotBayTrailMyrtlePark,07/24/2015 04:00:00 AM,48,-122,1,1,2
13661,ElliotBayTrailMyrtlePark,07/24/2015 05:00:00 AM,48,-122,3,13,16
13662,ElliotBayTrailMyrtlePark,07/24/2015 06:00:00 AM,48,-122,24,17,41
13663,ElliotBayTrailMyrtlePark,07/24/2015 07:00:00 AM,48,-122,38,70,108
13664,ElliotBayTrailMyrtlePark,07/24/2015 08:00:00 AM,48,-122,48,158,206
13665,ElliotBayTrailMyrtlePark,07/24/2015 09:00:00 AM,48,-122,31,84,115
13666,ElliotBayTrailMyrtlePark,07/24/2015 10:00:00 AM,48,-122,34,32,66
13667,ElliotBayTrailMyrtlePark,07/24/2015 11:00:00 AM,48,-122,26,21,47
13668,ElliotBayTrailMyrtlePark,07/24/2015 12:00:00 PM,48,-122,23,23,46
13669,ElliotBayTrailMyrtlePark,07/24/2015 01:00:00 PM,48,-122,19,13,32
13670,ElliotBayTrailMyrtlePark,07/24/2015 02:00:00 PM,48,-122,23,23,46
13671,ElliotBayTrailMyrtlePark,07/24/2015 03:00:00 PM,48,-122,41,30,71
13672,ElliotBayTrailMyrtlePark,07/24/2015 04:00:00 PM,48,-122,82,31,113
13673,ElliotBayTrailMyrtlePark,07/24/2015 05:00:00 PM,48,-122,130,55,185
13674,ElliotBayTrailMyrtlePark,07/24/2015 06:00:00 PM,48,-122,115,39,154
13675,ElliotBayTrailMyrtlePark,07/24/2015 07:00:00 PM,48,-122,46,27,73
13676,ElliotBayTrailMyrtlePark,07/24/2015 08:00:00 PM,48,-122,29,15,44
13677,ElliotBayTrailMyrtlePark,07/24/2015 09:00:00 PM,48,-122,7,8,15
13678,ElliotBayTrailMyrtlePark,07/24/2015 10:00:00 PM,48,-122,10,5,15
13679,ElliotBayTrailMyrtlePark,07/24/2015 11:00:00 PM,48,-122,8,5,13
13680,ElliotBayTrailMyrtlePark,07/25/2015 12:00:00 AM,48,-122,5,1,6
13681,ElliotBayTrailMyrtlePark,07/25/2015 01:00:00 AM,48,-122,3,3,6
13682,ElliotBayTrailMyrtlePark,07/25/2015 02:00:00 AM,48,-122,0,0,0
13683,ElliotBayTrailMyrtlePark,07/25/2015 03:00:00 AM,48,-122,0,0,0
13684,ElliotBayTrailMyrtlePark,07/25/2015 04:00:00 AM,48,-122,0,0,0
13685,ElliotBayTrailMyrtlePark,07/25/2015 05:00:00 AM,48,-122,1,1,2
13686,ElliotBayTrailMyrtlePark,07/25/2015 06:00:00 AM,48,-122,4,6,10
13687,ElliotBayTrailMyrtlePark,07/25/2015 07:00:00 AM,48,-122,12,11,23
13688,ElliotBayTrailMyrtlePark,07/25/2015 08:00:00 AM,48,-122,9,18,27
13689,ElliotBayTrailMyrtlePark,07/25/2015 09:00:00 AM,48,-122,11,20,31
13690,ElliotBayTrailMyrtlePark,07/25/2015 10:00:00 AM,48,-122,16,22,38
13691,ElliotBayTrailMyrtlePark,07/25/2015 11:00:00 AM,48,-122,32,41,73
13692,ElliotBayTrailMyrtlePark,07/25/2015 12:00:00 PM,48,-122,38,32,70
13693,ElliotBayTrailMyrtlePark,07/25/2015 01:00:00 PM,48,-122,36,45,81
13694,ElliotBayTrailMyrtlePark,07/25/2015 02:00:00 PM,48,-122,39,40,79
13695,ElliotBayTrailMyrtlePark,07/25/2015 03:00:00 PM,48,-122,47,41,88
13696,ElliotBayTrailMyrtlePark,07/25/2015 04:00:00 PM,48,-122,38,24,62
13697,ElliotBayTrailMyrtlePark,07/25/2015 05:00:00 PM,48,-122,40,25,65
13698,ElliotBayTrailMyrtlePark,07/25/2015 06:00:00 PM,48,-122,33,36,69
13699,ElliotBayTrailMyrtlePark,07/25/2015 07:00:00 PM,48,-122,19,20,39
13700,ElliotBayTrailMyrtlePark,07/25/2015 08:00:00 PM,48,-122,24,13,37
13701,ElliotBayTrailMyrtlePark,07/25/2015 09:00:00 PM,48,-122,6,4,10
13702,ElliotBayTrailMyrtlePark,07/25/2015 10:00:00 PM,48,-122,11,2,13
13703,ElliotBayTrailMyrtlePark,07/25/2015 11:00:00 PM,48,-122,6,4,10
13704,ElliotBayTrailMyrtlePark,07/26/2015 12:00:00 AM,48,-122,1,1,2
13705,ElliotBayTrailMyrtlePark,07/26/2015 01:00:00 AM,48,-122,2,0,2
13706,ElliotBayTrailMyrtlePark,07/26/2015 02:00:00 AM,48,-122,3,1,4
13707,ElliotBayTrailMyrtlePark,07/26/2015 03:00:00 AM,48,-122,3,0,3
13708,ElliotBayTrailMyrtlePark,07/26/2015 04:00:00 AM,48,-122,0,0,0
13709,ElliotBayTrailMyrtlePark,07/26/2015 05:00:00 AM,48,-122,1,0,1
13710,ElliotBayTrailMyrtlePark,07/26/2015 06:00:00 AM,48,-122,0,3,3
13711,ElliotBayTrailMyrtlePark,07/26/2015 07:00:00 AM,48,-122,2,7,9
13712,ElliotBayTrailMyrtlePark,07/26/2015 08:00:00 AM,48,-122,23,22,45
13713,ElliotBayTrailMyrtlePark,07/26/2015 09:00:00 AM,48,-122,24,31,55
13714,ElliotBayTrailMyrtlePark,07/26/2015 10:00:00 AM,48,-122,50,31,81
13715,ElliotBayTrailMyrtlePark,07/26/2015 11:00:00 AM,48,-122,52,36,88
13716,ElliotBayTrailMyrtlePark,07/26/2015 12:00:00 PM,48,-122,38,48,86
13717,ElliotBayTrailMyrtlePark,07/26/2015 01:00:00 PM,48,-122,58,65,123
13718,ElliotBayTrailMyrtlePark,07/26/2015 02:00:00 PM,48,-122,44,49,93
13719,ElliotBayTrailMyrtlePark,07/26/2015 03:00:00 PM,48,-122,46,49,95
13720,ElliotBayTrailMyrtlePark,07/26/2015 04:00:00 PM,48,-122,26,21,47
13721,ElliotBayTrailMyrtlePark,07/26/2015 05:00:00 PM,48,-122,15,6,21
13722,ElliotBayTrailMyrtlePark,07/26/2015 06:00:00 PM,48,-122,5,7,12
13723,ElliotBayTrailMyrtlePark,07/26/2015 07:00:00 PM,48,-122,17,5,22
13724,ElliotBayTrailMyrtlePark,07/26/2015 08:00:00 PM,48,-122,20,15,35
13725,ElliotBayTrailMyrtlePark,07/26/2015 09:00:00 PM,48,-122,5,9,14
13726,ElliotBayTrailMyrtlePark,07/26/2015 10:00:00 PM,48,-122,5,1,6
13727,ElliotBayTrailMyrtlePark,07/26/2015 11:00:00 PM,48,-122,6,2,8
13728,ElliotBayTrailMyrtlePark,07/27/2015 12:00:00 AM,48,-122,6,0,6
13729,ElliotBayTrailMyrtlePark,07/27/2015 01:00:00 AM,48,-122,0,0,0
13730,ElliotBayTrailMyrtlePark,07/27/2015 02:00:00 AM,48,-122,0,0,0
13731,ElliotBayTrailMyrtlePark,07/27/2015 03:00:00 AM,48,-122,2,2,4
13732,ElliotBayTrailMyrtlePark,07/27/2015 04:00:00 AM,48,-122,0,0,0
13733,ElliotBayTrailMyrtlePark,07/27/2015 05:00:00 AM,48,-122,5,4,9
13734,ElliotBayTrailMyrtlePark,07/27/2015 06:00:00 AM,48,-122,23,39,62
13735,ElliotBayTrailMyrtlePark,07/27/2015 07:00:00 AM,48,-122,32,92,124
13736,ElliotBayTrailMyrtlePark,07/27/2015 08:00:00 AM,48,-122,48,178,226
13737,ElliotBayTrailMyrtlePark,07/27/2015 09:00:00 AM,48,-122,27,103,130
13738,ElliotBayTrailMyrtlePark,07/27/2015 10:00:00 AM,48,-122,30,34,64
13739,ElliotBayTrailMyrtlePark,07/27/2015 11:00:00 AM,48,-122,40,25,65
13740,ElliotBayTrailMyrtlePark,07/27/2015 12:00:00 PM,48,-122,26,34,60
13741,ElliotBayTrailMyrtlePark,07/27/2015 01:00:00 PM,48,-122,31,37,68
13742,ElliotBayTrailMyrtlePark,07/27/2015 02:00:00 PM,48,-122,42,40,82
13743,ElliotBayTrailMyrtlePark,07/27/2015 03:00:00 PM,48,-122,56,37,93
13744,ElliotBayTrailMyrtlePark,07/27/2015 04:00:00 PM,48,-122,86,75,161
13745,ElliotBayTrailMyrtlePark,07/27/2015 05:00:00 PM,48,-122,208,75,283
13746,ElliotBayTrailMyrtlePark,07/27/2015 06:00:00 PM,48,-122,155,73,228
13747,ElliotBayTrailMyrtlePark,07/27/2015 07:00:00 PM,48,-122,77,42,119
13748,ElliotBayTrailMyrtlePark,07/27/2015 08:00:00 PM,48,-122,43,28,71
13749,ElliotBayTrailMyrtlePark,07/27/2015 09:00:00 PM,48,-122,19,12,31
13750,ElliotBayTrailMyrtlePark,07/27/2015 10:00:00 PM,48,-122,7,4,11
13751,ElliotBayTrailMyrtlePark,07/27/2015 11:00:00 PM,48,-122,10,3,13
13752,ElliotBayTrailMyrtlePark,07/28/2015 12:00:00 AM,48,-122,1,0,1
13753,ElliotBayTrailMyrtlePark,07/28/2015 01:00:00 AM,48,-122,1,0,1
13754,ElliotBayTrailMyrtlePark,07/28/2015 02:00:00 AM,48,-122,0,0,0
13755,ElliotBayTrailMyrtlePark,07/28/2015 03:00:00 AM,48,-122,0,0,0
13756,ElliotBayTrailMyrtlePark,07/28/2015 04:00:00 AM,48,-122,2,0,2
13757,ElliotBayTrailMyrtlePark,07/28/2015 05:00:00 AM,48,-122,6,6,12
13758,ElliotBayTrailMyrtlePark,07/28/2015 06:00:00 AM,48,-122,22,36,58
13759,ElliotBayTrailMyrtlePark,07/28/2015 07:00:00 AM,48,-122,39,121,160
13760,ElliotBayTrailMyrtlePark,07/28/2015 08:00:00 AM,48,-122,58,199,257
13761,ElliotBayTrailMyrtlePark,07/28/2015 09:00:00 AM,48,-122,46,116,162
13762,ElliotBayTrailMyrtlePark,07/28/2015 10:00:00 AM,48,-122,30,49,79
13763,ElliotBayTrailMyrtlePark,07/28/2015 11:00:00 AM,48,-122,20,27,47
13764,ElliotBayTrailMyrtlePark,07/28/2015 12:00:00 PM,48,-122,32,33,65
13765,ElliotBayTrailMyrtlePark,07/28/2015 01:00:00 PM,48,-122,37,30,67
13766,ElliotBayTrailMyrtlePark,07/28/2015 02:00:00 PM,48,-122,30,38,68
13767,ElliotBayTrailMyrtlePark,07/28/2015 03:00:00 PM,48,-122,54,30,84
13768,ElliotBayTrailMyrtlePark,07/28/2015 04:00:00 PM,48,-122,105,66,171
13769,ElliotBayTrailMyrtlePark,07/28/2015 05:00:00 PM,48,-122,233,91,324
13770,ElliotBayTrailMyrtlePark,07/28/2015 06:00:00 PM,48,-122,220,68,288
13771,ElliotBayTrailMyrtlePark,07/28/2015 07:00:00 PM,48,-122,106,59,165
13772,ElliotBayTrailMyrtlePark,07/28/2015 08:00:00 PM,48,-122,55,63,118
13773,ElliotBayTrailMyrtlePark,07/28/2015 09:00:00 PM,48,-122,22,34,56
13774,ElliotBayTrailMyrtlePark,07/28/2015 10:00:00 PM,48,-122,22,17,39
13775,ElliotBayTrailMyrtlePark,07/28/2015 11:00:00 PM,48,-122,5,2,7
13776,ElliotBayTrailMyrtlePark,07/29/2015 12:00:00 AM,48,-122,3,3,6
13777,ElliotBayTrailMyrtlePark,07/29/2015 01:00:00 AM,48,-122,2,0,2
13778,ElliotBayTrailMyrtlePark,07/29/2015 02:00:00 AM,48,-122,1,0,1
13779,ElliotBayTrailMyrtlePark,07/29/2015 03:00:00 AM,48,-122,0,0,0
13780,ElliotBayTrailMyrtlePark,07/29/2015 04:00:00 AM,48,-122,1,0,1
13781,ElliotBayTrailMyrtlePark,07/29/2015 05:00:00 AM,48,-122,7,13,20
13782,ElliotBayTrailMyrtlePark,07/29/2015 06:00:00 AM,48,-122,31,50,81
13783,ElliotBayTrailMyrtlePark,07/29/2015 07:00:00 AM,48,-122,51,104,155
13784,ElliotBayTrailMyrtlePark,07/29/2015 08:00:00 AM,48,-122,62,176,238
13785,ElliotBayTrailMyrtlePark,07/29/2015 09:00:00 AM,48,-122,63,95,158
13786,ElliotBayTrailMyrtlePark,07/29/2015 10:00:00 AM,48,-122,26,39,65
13787,ElliotBayTrailMyrtlePark,07/29/2015 11:00:00 AM,48,-122,24,26,50
13788,ElliotBayTrailMyrtlePark,07/29/2015 12:00:00 PM,48,-122,28,55,83
13789,ElliotBayTrailMyrtlePark,07/29/2015 01:00:00 PM,48,-122,42,49,91
13790,ElliotBayTrailMyrtlePark,07/29/2015 02:00:00 PM,48,-122,44,27,71
13791,ElliotBayTrailMyrtlePark,07/29/2015 03:00:00 PM,48,-122,65,42,107
13792,ElliotBayTrailMyrtlePark,07/29/2015 04:00:00 PM,48,-122,115,43,158
13793,ElliotBayTrailMyrtlePark,07/29/2015 05:00:00 PM,48,-122,231,80,311
13794,ElliotBayTrailMyrtlePark,07/29/2015 06:00:00 PM,48,-122,205,76,281
13795,ElliotBayTrailMyrtlePark,07/29/2015 07:00:00 PM,48,-122,82,55,137
13796,ElliotBayTrailMyrtlePark,07/29/2015 08:00:00 PM,48,-122,66,32,98
13797,ElliotBayTrailMyrtlePark,07/29/2015 09:00:00 PM,48,-122,18,23,41
13798,ElliotBayTrailMyrtlePark,07/29/2015 10:00:00 PM,48,-122,12,8,20
13799,ElliotBayTrailMyrtlePark,07/29/2015 11:00:00 PM,48,-122,5,2,7
13800,ElliotBayTrailMyrtlePark,07/30/2015 12:00:00 AM,48,-122,5,3,8
13801,ElliotBayTrailMyrtlePark,07/30/2015 01:00:00 AM,48,-122,2,0,2
13802,ElliotBayTrailMyrtlePark,07/30/2015 02:00:00 AM,48,-122,4,0,4
13803,ElliotBayTrailMyrtlePark,07/30/2015 03:00:00 AM,48,-122,1,2,3
13804,ElliotBayTrailMyrtlePark,07/30/2015 04:00:00 AM,48,-122,2,3,5
13805,ElliotBayTrailMyrtlePark,07/30/2015 05:00:00 AM,48,-122,7,11,18
13806,ElliotBayTrailMyrtlePark,07/30/2015 06:00:00 AM,48,-122,25,38,63
13807,ElliotBayTrailMyrtlePark,07/30/2015 07:00:00 AM,48,-122,47,83,130
13808,ElliotBayTrailMyrtlePark,07/30/2015 08:00:00 AM,48,-122,56,211,267
13809,ElliotBayTrailMyrtlePark,07/30/2015 09:00:00 AM,48,-122,53,105,158
13810,ElliotBayTrailMyrtlePark,07/30/2015 10:00:00 AM,48,-122,46,50,96
13811,ElliotBayTrailMyrtlePark,07/30/2015 11:00:00 AM,48,-122,25,40,65
13812,ElliotBayTrailMyrtlePark,07/30/2015 12:00:00 PM,48,-122,42,50,92
13813,ElliotBayTrailMyrtlePark,07/30/2015 01:00:00 PM,48,-122,21,27,48
13814,ElliotBayTrailMyrtlePark,07/30/2015 02:00:00 PM,48,-122,41,34,75
13815,ElliotBayTrailMyrtlePark,07/30/2015 03:00:00 PM,48,-122,45,34,79
13816,ElliotBayTrailMyrtlePark,07/30/2015 04:00:00 PM,48,-122,84,54,138
13817,ElliotBayTrailMyrtlePark,07/30/2015 05:00:00 PM,48,-122,210,83,293
13818,ElliotBayTrailMyrtlePark,07/30/2015 06:00:00 PM,48,-122,165,76,241
13819,ElliotBayTrailMyrtlePark,07/30/2015 07:00:00 PM,48,-122,65,51,116
13820,ElliotBayTrailMyrtlePark,07/30/2015 08:00:00 PM,48,-122,45,41,86
13821,ElliotBayTrailMyrtlePark,07/30/2015 09:00:00 PM,48,-122,21,17,38
13822,ElliotBayTrailMyrtlePark,07/30/2015 10:00:00 PM,48,-122,21,13,34
13823,ElliotBayTrailMyrtlePark,07/30/2015 11:00:00 PM,48,-122,6,0,6
13824,ElliotBayTrailMyrtlePark,07/31/2015 12:00:00 AM,48,-122,13,3,16
13825,ElliotBayTrailMyrtlePark,07/31/2015 01:00:00 AM,48,-122,7,6,13
13826,ElliotBayTrailMyrtlePark,07/31/2015 02:00:00 AM,48,-122,4,0,4
13827,ElliotBayTrailMyrtlePark,07/31/2015 03:00:00 AM,48,-122,1,0,1
13828,ElliotBayTrailMyrtlePark,07/31/2015 04:00:00 AM,48,-122,0,2,2
13829,ElliotBayTrailMyrtlePark,07/31/2015 05:00:00 AM,48,-122,7,12,19
13830,ElliotBayTrailMyrtlePark,07/31/2015 06:00:00 AM,48,-122,25,35,60
13831,ElliotBayTrailMyrtlePark,07/31/2015 07:00:00 AM,48,-122,35,59,94
13832,ElliotBayTrailMyrtlePark,07/31/2015 08:00:00 AM,48,-122,70,173,243
13833,ElliotBayTrailMyrtlePark,07/31/2015 09:00:00 AM,48,-122,69,106,175
13834,ElliotBayTrailMyrtlePark,07/31/2015 10:00:00 AM,48,-122,34,47,81
13835,ElliotBayTrailMyrtlePark,07/31/2015 11:00:00 AM,48,-122,36,37,73
13836,ElliotBayTrailMyrtlePark,07/31/2015 12:00:00 PM,48,-122,34,32,66
13837,ElliotBayTrailMyrtlePark,07/31/2015 01:00:00 PM,48,-122,38,40,78
13838,ElliotBayTrailMyrtlePark,07/31/2015 02:00:00 PM,48,-122,44,39,83
13839,ElliotBayTrailMyrtlePark,07/31/2015 03:00:00 PM,48,-122,67,49,116
13840,ElliotBayTrailMyrtlePark,07/31/2015 04:00:00 PM,48,-122,93,73,166
13841,ElliotBayTrailMyrtlePark,07/31/2015 05:00:00 PM,48,-122,201,64,265
13842,ElliotBayTrailMyrtlePark,07/31/2015 06:00:00 PM,48,-122,109,43,152
13843,ElliotBayTrailMyrtlePark,07/31/2015 07:00:00 PM,48,-122,68,50,118
13844,ElliotBayTrailMyrtlePark,07/31/2015 08:00:00 PM,48,-122,37,32,69
13845,ElliotBayTrailMyrtlePark,07/31/2015 09:00:00 PM,48,-122,26,15,41
13846,ElliotBayTrailMyrtlePark,07/31/2015 10:00:00 PM,48,-122,10,10,20
13847,ElliotBayTrailMyrtlePark,07/31/2015 11:00:00 PM,48,-122,10,5,15
13848,ElliotBayTrailMyrtlePark,08/01/2015 12:00:00 AM,48,-122,5,7,12
13849,ElliotBayTrailMyrtlePark,08/01/2015 01:00:00 AM,48,-122,2,0,2
13850,ElliotBayTrailMyrtlePark,08/01/2015 02:00:00 AM,48,-122,2,1,3
13851,ElliotBayTrailMyrtlePark,08/01/2015 03:00:00 AM,48,-122,2,1,3
13852,ElliotBayTrailMyrtlePark,08/01/2015 04:00:00 AM,48,-122,1,0,1
13853,ElliotBayTrailMyrtlePark,08/01/2015 05:00:00 AM,48,-122,0,5,5
13854,ElliotBayTrailMyrtlePark,08/01/2015 06:00:00 AM,48,-122,2,5,7
13855,ElliotBayTrailMyrtlePark,08/01/2015 07:00:00 AM,48,-122,12,15,27
13856,ElliotBayTrailMyrtlePark,08/01/2015 08:00:00 AM,48,-122,30,28,58
13857,ElliotBayTrailMyrtlePark,08/01/2015 09:00:00 AM,48,-122,31,31,62
13858,ElliotBayTrailMyrtlePark,08/01/2015 10:00:00 AM,48,-122,49,69,118
13859,ElliotBayTrailMyrtlePark,08/01/2015 11:00:00 AM,48,-122,58,71,129
13860,ElliotBayTrailMyrtlePark,08/01/2015 12:00:00 PM,48,-122,60,67,127
13861,ElliotBayTrailMyrtlePark,08/01/2015 01:00:00 PM,48,-122,61,55,116
13862,ElliotBayTrailMyrtlePark,08/01/2015 02:00:00 PM,48,-122,64,67,131
13863,ElliotBayTrailMyrtlePark,08/01/2015 03:00:00 PM,48,-122,91,67,158
13864,ElliotBayTrailMyrtlePark,08/01/2015 04:00:00 PM,48,-122,51,61,112
13865,ElliotBayTrailMyrtlePark,08/01/2015 05:00:00 PM,48,-122,36,52,88
13866,ElliotBayTrailMyrtlePark,08/01/2015 06:00:00 PM,48,-122,37,70,107
13867,ElliotBayTrailMyrtlePark,08/01/2015 07:00:00 PM,48,-122,34,35,69
13868,ElliotBayTrailMyrtlePark,08/01/2015 08:00:00 PM,48,-122,43,25,68
13869,ElliotBayTrailMyrtlePark,08/01/2015 09:00:00 PM,48,-122,53,9,62
13870,ElliotBayTrailMyrtlePark,08/01/2015 10:00:00 PM,48,-122,13,7,20
13871,ElliotBayTrailMyrtlePark,08/01/2015 11:00:00 PM,48,-122,10,8,18
13872,ElliotBayTrailMyrtlePark,08/02/2015 12:00:00 AM,48,-122,4,1,5
13873,ElliotBayTrailMyrtlePark,08/02/2015 01:00:00 AM,48,-122,3,0,3
13874,ElliotBayTrailMyrtlePark,08/02/2015 02:00:00 AM,48,-122,1,1,2
13875,ElliotBayTrailMyrtlePark,08/02/2015 03:00:00 AM,48,-122,2,0,2
13876,ElliotBayTrailMyrtlePark,08/02/2015 04:00:00 AM,48,-122,1,1,2
13877,ElliotBayTrailMyrtlePark,08/02/2015 05:00:00 AM,48,-122,0,1,1
13878,ElliotBayTrailMyrtlePark,08/02/2015 06:00:00 AM,48,-122,3,5,8
13879,ElliotBayTrailMyrtlePark,08/02/2015 07:00:00 AM,48,-122,12,9,21
13880,ElliotBayTrailMyrtlePark,08/02/2015 08:00:00 AM,48,-122,35,29,64
13881,ElliotBayTrailMyrtlePark,08/02/2015 09:00:00 AM,48,-122,40,41,81
13882,ElliotBayTrailMyrtlePark,08/02/2015 10:00:00 AM,48,-122,58,72,130
13883,ElliotBayTrailMyrtlePark,08/02/2015 11:00:00 AM,48,-122,40,54,94
13884,ElliotBayTrailMyrtlePark,08/02/2015 12:00:00 PM,48,-122,53,63,116
13885,ElliotBayTrailMyrtlePark,08/02/2015 01:00:00 PM,48,-122,59,65,124
13886,ElliotBayTrailMyrtlePark,08/02/2015 02:00:00 PM,48,-122,71,64,135
13887,ElliotBayTrailMyrtlePark,08/02/2015 03:00:00 PM,48,-122,93,65,158
13888,ElliotBayTrailMyrtlePark,08/02/2015 04:00:00 PM,48,-122,80,61,141
13889,ElliotBayTrailMyrtlePark,08/02/2015 05:00:00 PM,48,-122,63,38,101
13890,ElliotBayTrailMyrtlePark,08/02/2015 06:00:00 PM,48,-122,55,45,100
13891,ElliotBayTrailMyrtlePark,08/02/2015 07:00:00 PM,48,-122,55,32,87
13892,ElliotBayTrailMyrtlePark,08/02/2015 08:00:00 PM,48,-122,41,52,93
13893,ElliotBayTrailMyrtlePark,08/02/2015 09:00:00 PM,48,-122,11,22,33
13894,ElliotBayTrailMyrtlePark,08/02/2015 10:00:00 PM,48,-122,7,12,19
13895,ElliotBayTrailMyrtlePark,08/02/2015 11:00:00 PM,48,-122,3,1,4
13896,ElliotBayTrailMyrtlePark,08/03/2015 12:00:00 AM,48,-122,3,1,4
13897,ElliotBayTrailMyrtlePark,08/03/2015 01:00:00 AM,48,-122,0,0,0
13898,ElliotBayTrailMyrtlePark,08/03/2015 02:00:00 AM,48,-122,4,0,4
13899,ElliotBayTrailMyrtlePark,08/03/2015 03:00:00 AM,48,-122,2,0,2
13900,ElliotBayTrailMyrtlePark,08/03/2015 04:00:00 AM,48,-122,0,0,0
13901,ElliotBayTrailMyrtlePark,08/03/2015 05:00:00 AM,48,-122,4,10,14
13902,ElliotBayTrailMyrtlePark,08/03/2015 06:00:00 AM,48,-122,24,33,57
13903,ElliotBayTrailMyrtlePark,08/03/2015 07:00:00 AM,48,-122,36,84,120
13904,ElliotBayTrailMyrtlePark,08/03/2015 08:00:00 AM,48,-122,53,200,253
13905,ElliotBayTrailMyrtlePark,08/03/2015 09:00:00 AM,48,-122,31,105,136
13906,ElliotBayTrailMyrtlePark,08/03/2015 10:00:00 AM,48,-122,34,39,73
13907,ElliotBayTrailMyrtlePark,08/03/2015 11:00:00 AM,48,-122,11,38,49
13908,ElliotBayTrailMyrtlePark,08/03/2015 12:00:00 PM,48,-122,42,29,71
13909,ElliotBayTrailMyrtlePark,08/03/2015 01:00:00 PM,48,-122,32,37,69
13910,ElliotBayTrailMyrtlePark,08/03/2015 02:00:00 PM,48,-122,32,38,70
13911,ElliotBayTrailMyrtlePark,08/03/2015 03:00:00 PM,48,-122,48,34,82
13912,ElliotBayTrailMyrtlePark,08/03/2015 04:00:00 PM,48,-122,111,49,160
13913,ElliotBayTrailMyrtlePark,08/03/2015 05:00:00 PM,48,-122,222,63,285
13914,ElliotBayTrailMyrtlePark,08/03/2015 06:00:00 PM,48,-122,179,56,235
13915,ElliotBayTrailMyrtlePark,08/03/2015 07:00:00 PM,48,-122,68,48,116
13916,ElliotBayTrailMyrtlePark,08/03/2015 08:00:00 PM,48,-122,52,33,85
13917,ElliotBayTrailMyrtlePark,08/03/2015 09:00:00 PM,48,-122,18,13,31
13918,ElliotBayTrailMyrtlePark,08/03/2015 10:00:00 PM,48,-122,11,11,22
13919,ElliotBayTrailMyrtlePark,08/03/2015 11:00:00 PM,48,-122,6,7,13
13920,ElliotBayTrailMyrtlePark,08/04/2015 12:00:00 AM,48,-122,12,2,14
13921,ElliotBayTrailMyrtlePark,08/04/2015 01:00:00 AM,48,-122,3,0,3
13922,ElliotBayTrailMyrtlePark,08/04/2015 02:00:00 AM,48,-122,1,0,1
13923,ElliotBayTrailMyrtlePark,08/04/2015 03:00:00 AM,48,-122,2,0,2
13924,ElliotBayTrailMyrtlePark,08/04/2015 04:00:00 AM,48,-122,1,0,1
13925,ElliotBayTrailMyrtlePark,08/04/2015 05:00:00 AM,48,-122,7,8,15
13926,ElliotBayTrailMyrtlePark,08/04/2015 06:00:00 AM,48,-122,22,41,63
13927,ElliotBayTrailMyrtlePark,08/04/2015 07:00:00 AM,48,-122,43,107,150
13928,ElliotBayTrailMyrtlePark,08/04/2015 08:00:00 AM,48,-122,47,185,232
13929,ElliotBayTrailMyrtlePark,08/04/2015 09:00:00 AM,48,-122,41,112,153
13930,ElliotBayTrailMyrtlePark,08/04/2015 10:00:00 AM,48,-122,20,35,55
13931,ElliotBayTrailMyrtlePark,08/04/2015 11:00:00 AM,48,-122,21,30,51
13932,ElliotBayTrailMyrtlePark,08/04/2015 12:00:00 PM,48,-122,38,36,74
13933,ElliotBayTrailMyrtlePark,08/04/2015 01:00:00 PM,48,-122,43,35,78
13934,ElliotBayTrailMyrtlePark,08/04/2015 02:00:00 PM,48,-122,55,40,95
13935,ElliotBayTrailMyrtlePark,08/04/2015 03:00:00 PM,48,-122,49,35,84
13936,ElliotBayTrailMyrtlePark,08/04/2015 04:00:00 PM,48,-122,105,70,175
13937,ElliotBayTrailMyrtlePark,08/04/2015 05:00:00 PM,48,-122,217,85,302
13938,ElliotBayTrailMyrtlePark,08/04/2015 06:00:00 PM,48,-122,184,71,255
13939,ElliotBayTrailMyrtlePark,08/04/2015 07:00:00 PM,48,-122,69,39,108
13940,ElliotBayTrailMyrtlePark,08/04/2015 08:00:00 PM,48,-122,42,27,69
13941,ElliotBayTrailMyrtlePark,08/04/2015 09:00:00 PM,48,-122,15,11,26
13942,ElliotBayTrailMyrtlePark,08/04/2015 10:00:00 PM,48,-122,4,3,7
13943,ElliotBayTrailMyrtlePark,08/04/2015 11:00:00 PM,48,-122,3,4,7
13944,ElliotBayTrailMyrtlePark,08/05/2015 12:00:00 AM,48,-122,3,1,4
13945,ElliotBayTrailMyrtlePark,08/05/2015 01:00:00 AM,48,-122,1,0,1
13946,ElliotBayTrailMyrtlePark,08/05/2015 02:00:00 AM,48,-122,1,0,1
13947,ElliotBayTrailMyrtlePark,08/05/2015 03:00:00 AM,48,-122,0,0,0
13948,ElliotBayTrailMyrtlePark,08/05/2015 04:00:00 AM,48,-122,1,0,1
13949,ElliotBayTrailMyrtlePark,08/05/2015 05:00:00 AM,48,-122,5,6,11
13950,ElliotBayTrailMyrtlePark,08/05/2015 06:00:00 AM,48,-122,29,42,71
13951,ElliotBayTrailMyrtlePark,08/05/2015 07:00:00 AM,48,-122,52,84,136
13952,ElliotBayTrailMyrtlePark,08/05/2015 08:00:00 AM,48,-122,52,168,220
13953,ElliotBayTrailMyrtlePark,08/05/2015 09:00:00 AM,48,-122,37,108,145
13954,ElliotBayTrailMyrtlePark,08/05/2015 10:00:00 AM,48,-122,35,29,64
13955,ElliotBayTrailMyrtlePark,08/05/2015 11:00:00 AM,48,-122,16,35,51
13956,ElliotBayTrailMyrtlePark,08/05/2015 12:00:00 PM,48,-122,18,23,41
13957,ElliotBayTrailMyrtlePark,08/05/2015 01:00:00 PM,48,-122,34,24,58
13958,ElliotBayTrailMyrtlePark,08/05/2015 02:00:00 PM,48,-122,30,30,60
13959,ElliotBayTrailMyrtlePark,08/05/2015 03:00:00 PM,48,-122,38,28,66
13960,ElliotBayTrailMyrtlePark,08/05/2015 04:00:00 PM,48,-122,79,56,135
13961,ElliotBayTrailMyrtlePark,08/05/2015 05:00:00 PM,48,-122,155,72,227
13962,ElliotBayTrailMyrtlePark,08/05/2015 06:00:00 PM,48,-122,168,55,223
13963,ElliotBayTrailMyrtlePark,08/05/2015 07:00:00 PM,48,-122,72,32,104
13964,ElliotBayTrailMyrtlePark,08/05/2015 08:00:00 PM,48,-122,26,12,38
13965,ElliotBayTrailMyrtlePark,08/05/2015 09:00:00 PM,48,-122,8,8,16
13966,ElliotBayTrailMyrtlePark,08/05/2015 10:00:00 PM,48,-122,9,2,11
13967,ElliotBayTrailMyrtlePark,08/05/2015 11:00:00 PM,48,-122,4,2,6
13968,ElliotBayTrailMyrtlePark,08/06/2015 12:00:00 AM,48,-122,3,0,3
13969,ElliotBayTrailMyrtlePark,08/06/2015 01:00:00 AM,48,-122,1,0,1
13970,ElliotBayTrailMyrtlePark,08/06/2015 02:00:00 AM,48,-122,0,0,0
13971,ElliotBayTrailMyrtlePark,08/06/2015 03:00:00 AM,48,-122,1,0,1
13972,ElliotBayTrailMyrtlePark,08/06/2015 04:00:00 AM,48,-122,2,0,2
13973,ElliotBayTrailMyrtlePark,08/06/2015 05:00:00 AM,48,-122,10,8,18
13974,ElliotBayTrailMyrtlePark,08/06/2015 06:00:00 AM,48,-122,26,39,65
13975,ElliotBayTrailMyrtlePark,08/06/2015 07:00:00 AM,48,-122,39,74,113
13976,ElliotBayTrailMyrtlePark,08/06/2015 08:00:00 AM,48,-122,58,159,217
13977,ElliotBayTrailMyrtlePark,08/06/2015 09:00:00 AM,48,-122,48,121,169
13978,ElliotBayTrailMyrtlePark,08/06/2015 10:00:00 AM,48,-122,35,38,73
13979,ElliotBayTrailMyrtlePark,08/06/2015 11:00:00 AM,48,-122,31,42,73
13980,ElliotBayTrailMyrtlePark,08/06/2015 12:00:00 PM,48,-122,28,41,69
13981,ElliotBayTrailMyrtlePark,08/06/2015 01:00:00 PM,48,-122,33,39,72
13982,ElliotBayTrailMyrtlePark,08/06/2015 02:00:00 PM,48,-122,39,45,84
13983,ElliotBayTrailMyrtlePark,08/06/2015 03:00:00 PM,48,-122,41,31,72
13984,ElliotBayTrailMyrtlePark,08/06/2015 04:00:00 PM,48,-122,91,65,156
13985,ElliotBayTrailMyrtlePark,08/06/2015 05:00:00 PM,48,-122,187,67,254
13986,ElliotBayTrailMyrtlePark,08/06/2015 06:00:00 PM,48,-122,197,74,271
13987,ElliotBayTrailMyrtlePark,08/06/2015 07:00:00 PM,48,-122,78,37,115
13988,ElliotBayTrailMyrtlePark,08/06/2015 08:00:00 PM,48,-122,57,25,82
13989,ElliotBayTrailMyrtlePark,08/06/2015 09:00:00 PM,48,-122,15,26,41
13990,ElliotBayTrailMyrtlePark,08/06/2015 10:00:00 PM,48,-122,13,4,17
13991,ElliotBayTrailMyrtlePark,08/06/2015 11:00:00 PM,48,-122,4,3,7
13992,ElliotBayTrailMyrtlePark,08/07/2015 12:00:00 AM,48,-122,3,2,5
13993,ElliotBayTrailMyrtlePark,08/07/2015 01:00:00 AM,48,-122,4,2,6
13994,ElliotBayTrailMyrtlePark,08/07/2015 02:00:00 AM,48,-122,4,1,5
13995,ElliotBayTrailMyrtlePark,08/07/2015 03:00:00 AM,48,-122,4,0,4
13996,ElliotBayTrailMyrtlePark,08/07/2015 04:00:00 AM,48,-122,0,1,1
13997,ElliotBayTrailMyrtlePark,08/07/2015 05:00:00 AM,48,-122,8,9,17
13998,ElliotBayTrailMyrtlePark,08/07/2015 06:00:00 AM,48,-122,15,35,50
13999,ElliotBayTrailMyrtlePark,08/07/2015 07:00:00 AM,48,-122,43,82,125
14000,ElliotBayTrailMyrtlePark,08/07/2015 08:00:00 AM,48,-122,57,156,213
14001,ElliotBayTrailMyrtlePark,08/07/2015 09:00:00 AM,48,-122,49,80,129
14002,ElliotBayTrailMyrtlePark,08/07/2015 10:00:00 AM,48,-122,25,33,58
14003,ElliotBayTrailMyrtlePark,08/07/2015 11:00:00 AM,48,-122,39,25,64
14004,ElliotBayTrailMyrtlePark,08/07/2015 12:00:00 PM,48,-122,36,43,79
14005,ElliotBayTrailMyrtlePark,08/07/2015 01:00:00 PM,48,-122,31,47,78
14006,ElliotBayTrailMyrtlePark,08/07/2015 02:00:00 PM,48,-122,44,47,91
14007,ElliotBayTrailMyrtlePark,08/07/2015 03:00:00 PM,48,-122,70,63,133
14008,ElliotBayTrailMyrtlePark,08/07/2015 04:00:00 PM,48,-122,104,57,161
14009,ElliotBayTrailMyrtlePark,08/07/2015 05:00:00 PM,48,-122,162,80,242
14010,ElliotBayTrailMyrtlePark,08/07/2015 06:00:00 PM,48,-122,132,54,186
14011,ElliotBayTrailMyrtlePark,08/07/2015 07:00:00 PM,48,-122,56,29,85
14012,ElliotBayTrailMyrtlePark,08/07/2015 08:00:00 PM,48,-122,39,31,70
14013,ElliotBayTrailMyrtlePark,08/07/2015 09:00:00 PM,48,-122,14,11,25
14014,ElliotBayTrailMyrtlePark,08/07/2015 10:00:00 PM,48,-122,19,4,23
14015,ElliotBayTrailMyrtlePark,08/07/2015 11:00:00 PM,48,-122,25,2,27
14016,ElliotBayTrailMyrtlePark,08/08/2015 12:00:00 AM,48,-122,17,1,18
14017,ElliotBayTrailMyrtlePark,08/08/2015 01:00:00 AM,48,-122,28,0,28
14018,ElliotBayTrailMyrtlePark,08/08/2015 02:00:00 AM,48,-122,13,1,14
14019,ElliotBayTrailMyrtlePark,08/08/2015 03:00:00 AM,48,-122,2,0,2
14020,ElliotBayTrailMyrtlePark,08/08/2015 04:00:00 AM,48,-122,3,1,4
14021,ElliotBayTrailMyrtlePark,08/08/2015 05:00:00 AM,48,-122,5,2,7
14022,ElliotBayTrailMyrtlePark,08/08/2015 06:00:00 AM,48,-122,3,7,10
14023,ElliotBayTrailMyrtlePark,08/08/2015 07:00:00 AM,48,-122,13,21,34
14024,ElliotBayTrailMyrtlePark,08/08/2015 08:00:00 AM,48,-122,22,15,37
14025,ElliotBayTrailMyrtlePark,08/08/2015 09:00:00 AM,48,-122,25,34,59
14026,ElliotBayTrailMyrtlePark,08/08/2015 10:00:00 AM,48,-122,38,49,87
14027,ElliotBayTrailMyrtlePark,08/08/2015 11:00:00 AM,48,-122,39,30,69
14028,ElliotBayTrailMyrtlePark,08/08/2015 12:00:00 PM,48,-122,39,68,107
14029,ElliotBayTrailMyrtlePark,08/08/2015 01:00:00 PM,48,-122,59,58,117
14030,ElliotBayTrailMyrtlePark,08/08/2015 02:00:00 PM,48,-122,62,43,105
14031,ElliotBayTrailMyrtlePark,08/08/2015 03:00:00 PM,48,-122,89,51,140
14032,ElliotBayTrailMyrtlePark,08/08/2015 04:00:00 PM,48,-122,64,40,104
14033,ElliotBayTrailMyrtlePark,08/08/2015 05:00:00 PM,48,-122,62,38,100
14034,ElliotBayTrailMyrtlePark,08/08/2015 06:00:00 PM,48,-122,45,38,83
14035,ElliotBayTrailMyrtlePark,08/08/2015 07:00:00 PM,48,-122,48,22,70
14036,ElliotBayTrailMyrtlePark,08/08/2015 08:00:00 PM,48,-122,23,11,34
14037,ElliotBayTrailMyrtlePark,08/08/2015 09:00:00 PM,48,-122,8,12,20
14038,ElliotBayTrailMyrtlePark,08/08/2015 10:00:00 PM,48,-122,3,4,7
14039,ElliotBayTrailMyrtlePark,08/08/2015 11:00:00 PM,48,-122,6,3,9
14040,ElliotBayTrailMyrtlePark,08/09/2015 12:00:00 AM,48,-122,8,1,9
14041,ElliotBayTrailMyrtlePark,08/09/2015 01:00:00 AM,48,-122,1,0,1
14042,ElliotBayTrailMyrtlePark,08/09/2015 02:00:00 AM,48,-122,4,0,4
14043,ElliotBayTrailMyrtlePark,08/09/2015 03:00:00 AM,48,-122,4,0,4
14044,ElliotBayTrailMyrtlePark,08/09/2015 04:00:00 AM,48,-122,1,0,1
14045,ElliotBayTrailMyrtlePark,08/09/2015 05:00:00 AM,48,-122,2,1,3
14046,ElliotBayTrailMyrtlePark,08/09/2015 06:00:00 AM,48,-122,1,6,7
14047,ElliotBayTrailMyrtlePark,08/09/2015 07:00:00 AM,48,-122,6,12,18
14048,ElliotBayTrailMyrtlePark,08/09/2015 08:00:00 AM,48,-122,19,20,39
14049,ElliotBayTrailMyrtlePark,08/09/2015 09:00:00 AM,48,-122,33,46,79
14050,ElliotBayTrailMyrtlePark,08/09/2015 10:00:00 AM,48,-122,36,54,90
14051,ElliotBayTrailMyrtlePark,08/09/2015 11:00:00 AM,48,-122,59,67,126
14052,ElliotBayTrailMyrtlePark,08/09/2015 12:00:00 PM,48,-122,60,59,119
14053,ElliotBayTrailMyrtlePark,08/09/2015 01:00:00 PM,48,-122,60,68,128
14054,ElliotBayTrailMyrtlePark,08/09/2015 02:00:00 PM,48,-122,96,77,173
14055,ElliotBayTrailMyrtlePark,08/09/2015 03:00:00 PM,48,-122,75,93,168
14056,ElliotBayTrailMyrtlePark,08/09/2015 04:00:00 PM,48,-122,96,67,163
14057,ElliotBayTrailMyrtlePark,08/09/2015 05:00:00 PM,48,-122,72,64,136
14058,ElliotBayTrailMyrtlePark,08/09/2015 06:00:00 PM,48,-122,60,32,92
14059,ElliotBayTrailMyrtlePark,08/09/2015 07:00:00 PM,48,-122,54,36,90
14060,ElliotBayTrailMyrtlePark,08/09/2015 08:00:00 PM,48,-122,36,29,65
14061,ElliotBayTrailMyrtlePark,08/09/2015 09:00:00 PM,48,-122,8,27,35
14062,ElliotBayTrailMyrtlePark,08/09/2015 10:00:00 PM,48,-122,12,3,15
14063,ElliotBayTrailMyrtlePark,08/09/2015 11:00:00 PM,48,-122,6,1,7
14064,ElliotBayTrailMyrtlePark,08/10/2015 12:00:00 AM,48,-122,0,0,0
14065,ElliotBayTrailMyrtlePark,08/10/2015 01:00:00 AM,48,-122,1,0,1
14066,ElliotBayTrailMyrtlePark,08/10/2015 02:00:00 AM,48,-122,5,4,9
14067,ElliotBayTrailMyrtlePark,08/10/2015 03:00:00 AM,48,-122,2,0,2
14068,ElliotBayTrailMyrtlePark,08/10/2015 04:00:00 AM,48,-122,1,0,1
14069,ElliotBayTrailMyrtlePark,08/10/2015 05:00:00 AM,48,-122,8,4,12
14070,ElliotBayTrailMyrtlePark,08/10/2015 06:00:00 AM,48,-122,18,35,53
14071,ElliotBayTrailMyrtlePark,08/10/2015 07:00:00 AM,48,-122,41,92,133
14072,ElliotBayTrailMyrtlePark,08/10/2015 08:00:00 AM,48,-122,55,156,211
14073,ElliotBayTrailMyrtlePark,08/10/2015 09:00:00 AM,48,-122,41,94,135
14074,ElliotBayTrailMyrtlePark,08/10/2015 10:00:00 AM,48,-122,29,25,54
14075,ElliotBayTrailMyrtlePark,08/10/2015 11:00:00 AM,48,-122,21,26,47
14076,ElliotBayTrailMyrtlePark,08/10/2015 12:00:00 PM,48,-122,10,22,32
14077,ElliotBayTrailMyrtlePark,08/10/2015 01:00:00 PM,48,-122,24,26,50
14078,ElliotBayTrailMyrtlePark,08/10/2015 02:00:00 PM,48,-122,37,33,70
14079,ElliotBayTrailMyrtlePark,08/10/2015 03:00:00 PM,48,-122,43,35,78
14080,ElliotBayTrailMyrtlePark,08/10/2015 04:00:00 PM,48,-122,63,65,128
14081,ElliotBayTrailMyrtlePark,08/10/2015 05:00:00 PM,48,-122,192,77,269
14082,ElliotBayTrailMyrtlePark,08/10/2015 06:00:00 PM,48,-122,172,45,217
14083,ElliotBayTrailMyrtlePark,08/10/2015 07:00:00 PM,48,-122,73,60,133
14084,ElliotBayTrailMyrtlePark,08/10/2015 08:00:00 PM,48,-122,32,37,69
14085,ElliotBayTrailMyrtlePark,08/10/2015 09:00:00 PM,48,-122,14,9,23
14086,ElliotBayTrailMyrtlePark,08/10/2015 10:00:00 PM,48,-122,19,6,25
14087,ElliotBayTrailMyrtlePark,08/10/2015 11:00:00 PM,48,-122,3,4,7
14088,ElliotBayTrailMyrtlePark,08/11/2015 12:00:00 AM,48,-122,3,0,3
14089,ElliotBayTrailMyrtlePark,08/11/2015 01:00:00 AM,48,-122,3,0,3
14090,ElliotBayTrailMyrtlePark,08/11/2015 02:00:00 AM,48,-122,4,1,5
14091,ElliotBayTrailMyrtlePark,08/11/2015 03:00:00 AM,48,-122,0,2,2
14092,ElliotBayTrailMyrtlePark,08/11/2015 04:00:00 AM,48,-122,1,0,1
14093,ElliotBayTrailMyrtlePark,08/11/2015 05:00:00 AM,48,-122,6,6,12
14094,ElliotBayTrailMyrtlePark,08/11/2015 06:00:00 AM,48,-122,18,35,53
14095,ElliotBayTrailMyrtlePark,08/11/2015 07:00:00 AM,48,-122,53,108,161
14096,ElliotBayTrailMyrtlePark,08/11/2015 08:00:00 AM,48,-122,50,162,212
14097,ElliotBayTrailMyrtlePark,08/11/2015 09:00:00 AM,48,-122,50,94,144
14098,ElliotBayTrailMyrtlePark,08/11/2015 10:00:00 AM,48,-122,17,49,66
14099,ElliotBayTrailMyrtlePark,08/11/2015 11:00:00 AM,48,-122,34,46,80
14100,ElliotBayTrailMyrtlePark,08/11/2015 12:00:00 PM,48,-122,30,41,71
14101,ElliotBayTrailMyrtlePark,08/11/2015 01:00:00 PM,48,-122,28,21,49
14102,ElliotBayTrailMyrtlePark,08/11/2015 02:00:00 PM,48,-122,32,27,59
14103,ElliotBayTrailMyrtlePark,08/11/2015 03:00:00 PM,48,-122,41,37,78
14104,ElliotBayTrailMyrtlePark,08/11/2015 04:00:00 PM,48,-122,84,60,144
14105,ElliotBayTrailMyrtlePark,08/11/2015 05:00:00 PM,48,-122,228,83,311
14106,ElliotBayTrailMyrtlePark,08/11/2015 06:00:00 PM,48,-122,167,69,236
14107,ElliotBayTrailMyrtlePark,08/11/2015 07:00:00 PM,48,-122,85,46,131
14108,ElliotBayTrailMyrtlePark,08/11/2015 08:00:00 PM,48,-122,43,35,78
14109,ElliotBayTrailMyrtlePark,08/11/2015 09:00:00 PM,48,-122,13,9,22
14110,ElliotBayTrailMyrtlePark,08/11/2015 10:00:00 PM,48,-122,10,2,12
14111,ElliotBayTrailMyrtlePark,08/11/2015 11:00:00 PM,48,-122,11,5,16
14112,ElliotBayTrailMyrtlePark,08/12/2015 12:00:00 AM,48,-122,6,1,7
14113,ElliotBayTrailMyrtlePark,08/12/2015 01:00:00 AM,48,-122,3,0,3
14114,ElliotBayTrailMyrtlePark,08/12/2015 02:00:00 AM,48,-122,2,0,2
14115,ElliotBayTrailMyrtlePark,08/12/2015 03:00:00 AM,48,-122,0,0,0
14116,ElliotBayTrailMyrtlePark,08/12/2015 04:00:00 AM,48,-122,0,0,0
14117,ElliotBayTrailMyrtlePark,08/12/2015 05:00:00 AM,48,-122,4,7,11
14118,ElliotBayTrailMyrtlePark,08/12/2015 06:00:00 AM,48,-122,26,39,65
14119,ElliotBayTrailMyrtlePark,08/12/2015 07:00:00 AM,48,-122,35,72,107
14120,ElliotBayTrailMyrtlePark,08/12/2015 08:00:00 AM,48,-122,68,170,238
14121,ElliotBayTrailMyrtlePark,08/12/2015 09:00:00 AM,48,-122,37,104,141
14122,ElliotBayTrailMyrtlePark,08/12/2015 10:00:00 AM,48,-122,22,38,60
14123,ElliotBayTrailMyrtlePark,08/12/2015 11:00:00 AM,48,-122,14,27,41
14124,ElliotBayTrailMyrtlePark,08/12/2015 12:00:00 PM,48,-122,11,34,45
14125,ElliotBayTrailMyrtlePark,08/12/2015 01:00:00 PM,48,-122,18,21,39
14126,ElliotBayTrailMyrtlePark,08/12/2015 02:00:00 PM,48,-122,23,26,49
14127,ElliotBayTrailMyrtlePark,08/12/2015 03:00:00 PM,48,-122,37,36,73
14128,ElliotBayTrailMyrtlePark,08/12/2015 04:00:00 PM,48,-122,112,57,169
14129,ElliotBayTrailMyrtlePark,08/12/2015 05:00:00 PM,48,-122,192,73,265
14130,ElliotBayTrailMyrtlePark,08/12/2015 06:00:00 PM,48,-122,158,64,222
14131,ElliotBayTrailMyrtlePark,08/12/2015 07:00:00 PM,48,-122,75,38,113
14132,ElliotBayTrailMyrtlePark,08/12/2015 08:00:00 PM,48,-122,38,21,59
14133,ElliotBayTrailMyrtlePark,08/12/2015 09:00:00 PM,48,-122,7,14,21
14134,ElliotBayTrailMyrtlePark,08/12/2015 10:00:00 PM,48,-122,7,13,20
14135,ElliotBayTrailMyrtlePark,08/12/2015 11:00:00 PM,48,-122,4,2,6
14136,ElliotBayTrailMyrtlePark,08/13/2015 12:00:00 AM,48,-122,3,1,4
14137,ElliotBayTrailMyrtlePark,08/13/2015 01:00:00 AM,48,-122,0,1,1
14138,ElliotBayTrailMyrtlePark,08/13/2015 02:00:00 AM,48,-122,2,0,2
14139,ElliotBayTrailMyrtlePark,08/13/2015 03:00:00 AM,48,-122,3,0,3
14140,ElliotBayTrailMyrtlePark,08/13/2015 04:00:00 AM,48,-122,0,0,0
14141,ElliotBayTrailMyrtlePark,08/13/2015 05:00:00 AM,48,-122,1,3,4
14142,ElliotBayTrailMyrtlePark,08/13/2015 06:00:00 AM,48,-122,18,39,57
14143,ElliotBayTrailMyrtlePark,08/13/2015 07:00:00 AM,48,-122,38,75,113
14144,ElliotBayTrailMyrtlePark,08/13/2015 08:00:00 AM,48,-122,58,169,227
14145,ElliotBayTrailMyrtlePark,08/13/2015 09:00:00 AM,48,-122,32,104,136
14146,ElliotBayTrailMyrtlePark,08/13/2015 10:00:00 AM,48,-122,23,48,71
14147,ElliotBayTrailMyrtlePark,08/13/2015 11:00:00 AM,48,-122,20,35,55
14148,ElliotBayTrailMyrtlePark,08/13/2015 12:00:00 PM,48,-122,37,44,81
14149,ElliotBayTrailMyrtlePark,08/13/2015 01:00:00 PM,48,-122,36,40,76
14150,ElliotBayTrailMyrtlePark,08/13/2015 02:00:00 PM,48,-122,27,37,64
14151,ElliotBayTrailMyrtlePark,08/13/2015 03:00:00 PM,48,-122,42,45,87
14152,ElliotBayTrailMyrtlePark,08/13/2015 04:00:00 PM,48,-122,66,61,127
14153,ElliotBayTrailMyrtlePark,08/13/2015 05:00:00 PM,48,-122,173,59,232
14154,ElliotBayTrailMyrtlePark,08/13/2015 06:00:00 PM,48,-122,138,69,207
14155,ElliotBayTrailMyrtlePark,08/13/2015 07:00:00 PM,48,-122,76,37,113
14156,ElliotBayTrailMyrtlePark,08/13/2015 08:00:00 PM,48,-122,58,45,103
14157,ElliotBayTrailMyrtlePark,08/13/2015 09:00:00 PM,48,-122,11,13,24
14158,ElliotBayTrailMyrtlePark,08/13/2015 10:00:00 PM,48,-122,9,15,24
14159,ElliotBayTrailMyrtlePark,08/13/2015 11:00:00 PM,48,-122,1,1,2
14160,ElliotBayTrailMyrtlePark,08/14/2015 12:00:00 AM,48,-122,3,1,4
14161,ElliotBayTrailMyrtlePark,08/14/2015 01:00:00 AM,48,-122,2,1,3
14162,ElliotBayTrailMyrtlePark,08/14/2015 02:00:00 AM,48,-122,5,5,10
14163,ElliotBayTrailMyrtlePark,08/14/2015 03:00:00 AM,48,-122,1,0,1
14164,ElliotBayTrailMyrtlePark,08/14/2015 04:00:00 AM,48,-122,1,2,3
14165,ElliotBayTrailMyrtlePark,08/14/2015 05:00:00 AM,48,-122,5,2,7
14166,ElliotBayTrailMyrtlePark,08/14/2015 06:00:00 AM,48,-122,13,16,29
14167,ElliotBayTrailMyrtlePark,08/14/2015 07:00:00 AM,48,-122,32,23,55
14168,ElliotBayTrailMyrtlePark,08/14/2015 08:00:00 AM,48,-122,33,60,93
14169,ElliotBayTrailMyrtlePark,08/14/2015 09:00:00 AM,48,-122,25,48,73
14170,ElliotBayTrailMyrtlePark,08/14/2015 10:00:00 AM,48,-122,16,31,47
14171,ElliotBayTrailMyrtlePark,08/14/2015 11:00:00 AM,48,-122,14,14,28
14172,ElliotBayTrailMyrtlePark,08/14/2015 12:00:00 PM,48,-122,17,13,30
14173,ElliotBayTrailMyrtlePark,08/14/2015 01:00:00 PM,48,-122,17,11,28
14174,ElliotBayTrailMyrtlePark,08/14/2015 02:00:00 PM,48,-122,9,8,17
14175,ElliotBayTrailMyrtlePark,08/14/2015 03:00:00 PM,48,-122,8,11,19
14176,ElliotBayTrailMyrtlePark,08/14/2015 04:00:00 PM,48,-122,16,14,30
14177,ElliotBayTrailMyrtlePark,08/14/2015 05:00:00 PM,48,-122,27,12,39
14178,ElliotBayTrailMyrtlePark,08/14/2015 06:00:00 PM,48,-122,25,16,41
14179,ElliotBayTrailMyrtlePark,08/14/2015 07:00:00 PM,48,-122,8,16,24
14180,ElliotBayTrailMyrtlePark,08/14/2015 08:00:00 PM,48,-122,15,27,42
14181,ElliotBayTrailMyrtlePark,08/14/2015 09:00:00 PM,48,-122,3,10,13
14182,ElliotBayTrailMyrtlePark,08/14/2015 10:00:00 PM,48,-122,0,1,1
14183,ElliotBayTrailMyrtlePark,08/14/2015 11:00:00 PM,48,-122,5,2,7
14184,ElliotBayTrailMyrtlePark,08/15/2015 12:00:00 AM,48,-122,7,3,10
14185,ElliotBayTrailMyrtlePark,08/15/2015 01:00:00 AM,48,-122,1,2,3
14186,ElliotBayTrailMyrtlePark,08/15/2015 02:00:00 AM,48,-122,1,0,1
14187,ElliotBayTrailMyrtlePark,08/15/2015 03:00:00 AM,48,-122,1,10,11
14188,ElliotBayTrailMyrtlePark,08/15/2015 04:00:00 AM,48,-122,1,0,1
14189,ElliotBayTrailMyrtlePark,08/15/2015 05:00:00 AM,48,-122,0,1,1
14190,ElliotBayTrailMyrtlePark,08/15/2015 06:00:00 AM,48,-122,0,6,6
14191,ElliotBayTrailMyrtlePark,08/15/2015 07:00:00 AM,48,-122,6,4,10
14192,ElliotBayTrailMyrtlePark,08/15/2015 08:00:00 AM,48,-122,11,15,26
14193,ElliotBayTrailMyrtlePark,08/15/2015 09:00:00 AM,48,-122,13,15,28
14194,ElliotBayTrailMyrtlePark,08/15/2015 10:00:00 AM,48,-122,16,11,27
14195,ElliotBayTrailMyrtlePark,08/15/2015 11:00:00 AM,48,-122,31,15,46
14196,ElliotBayTrailMyrtlePark,08/15/2015 12:00:00 PM,48,-122,14,18,32
14197,ElliotBayTrailMyrtlePark,08/15/2015 01:00:00 PM,48,-122,15,28,43
14198,ElliotBayTrailMyrtlePark,08/15/2015 02:00:00 PM,48,-122,21,23,44
14199,ElliotBayTrailMyrtlePark,08/15/2015 03:00:00 PM,48,-122,14,10,24
14200,ElliotBayTrailMyrtlePark,08/15/2015 04:00:00 PM,48,-122,9,18,27
14201,ElliotBayTrailMyrtlePark,08/15/2015 05:00:00 PM,48,-122,23,11,34
14202,ElliotBayTrailMyrtlePark,08/15/2015 06:00:00 PM,48,-122,18,6,24
14203,ElliotBayTrailMyrtlePark,08/15/2015 07:00:00 PM,48,-122,11,15,26
14204,ElliotBayTrailMyrtlePark,08/15/2015 08:00:00 PM,48,-122,14,22,36
14205,ElliotBayTrailMyrtlePark,08/15/2015 09:00:00 PM,48,-122,5,17,22
14206,ElliotBayTrailMyrtlePark,08/15/2015 10:00:00 PM,48,-122,2,14,16
14207,ElliotBayTrailMyrtlePark,08/15/2015 11:00:00 PM,48,-122,0,0,0
14208,ElliotBayTrailMyrtlePark,08/16/2015 12:00:00 AM,48,-122,5,1,6
14209,ElliotBayTrailMyrtlePark,08/16/2015 01:00:00 AM,48,-122,3,3,6
14210,ElliotBayTrailMyrtlePark,08/16/2015 02:00:00 AM,48,-122,0,1,1
14211,ElliotBayTrailMyrtlePark,08/16/2015 03:00:00 AM,48,-122,0,0,0
14212,ElliotBayTrailMyrtlePark,08/16/2015 04:00:00 AM,48,-122,0,13,13
14213,ElliotBayTrailMyrtlePark,08/16/2015 05:00:00 AM,48,-122,1,1,2
14214,ElliotBayTrailMyrtlePark,08/16/2015 06:00:00 AM,48,-122,1,2,3
14215,ElliotBayTrailMyrtlePark,08/16/2015 07:00:00 AM,48,-122,2,7,9
14216,ElliotBayTrailMyrtlePark,08/16/2015 08:00:00 AM,48,-122,10,25,35
14217,ElliotBayTrailMyrtlePark,08/16/2015 09:00:00 AM,48,-122,11,14,25
14218,ElliotBayTrailMyrtlePark,08/16/2015 10:00:00 AM,48,-122,27,18,45
14219,ElliotBayTrailMyrtlePark,08/16/2015 11:00:00 AM,48,-122,42,39,81
14220,ElliotBayTrailMyrtlePark,08/16/2015 12:00:00 PM,48,-122,41,31,72
14221,ElliotBayTrailMyrtlePark,08/16/2015 01:00:00 PM,48,-122,36,31,67
14222,ElliotBayTrailMyrtlePark,08/16/2015 02:00:00 PM,48,-122,30,26,56
14223,ElliotBayTrailMyrtlePark,08/16/2015 03:00:00 PM,48,-122,18,21,39
14224,ElliotBayTrailMyrtlePark,08/16/2015 04:00:00 PM,48,-122,22,18,40
14225,ElliotBayTrailMyrtlePark,08/16/2015 05:00:00 PM,48,-122,13,16,29
14226,ElliotBayTrailMyrtlePark,08/16/2015 06:00:00 PM,48,-122,16,21,37
14227,ElliotBayTrailMyrtlePark,08/16/2015 07:00:00 PM,48,-122,22,15,37
14228,ElliotBayTrailMyrtlePark,08/16/2015 08:00:00 PM,48,-122,10,35,45
14229,ElliotBayTrailMyrtlePark,08/16/2015 09:00:00 PM,48,-122,4,6,10
14230,ElliotBayTrailMyrtlePark,08/16/2015 10:00:00 PM,48,-122,0,37,37
14231,ElliotBayTrailMyrtlePark,08/16/2015 11:00:00 PM,48,-122,2,21,23
14232,ElliotBayTrailMyrtlePark,08/17/2015 12:00:00 AM,48,-122,2,12,14
14233,ElliotBayTrailMyrtlePark,08/17/2015 01:00:00 AM,48,-122,1,1,2
14234,ElliotBayTrailMyrtlePark,08/17/2015 02:00:00 AM,48,-122,1,3,4
14235,ElliotBayTrailMyrtlePark,08/17/2015 03:00:00 AM,48,-122,6,3,9
14236,ElliotBayTrailMyrtlePark,08/17/2015 04:00:00 AM,48,-122,10,10,20
14237,ElliotBayTrailMyrtlePark,08/17/2015 05:00:00 AM,48,-122,6,8,14
14238,ElliotBayTrailMyrtlePark,08/17/2015 06:00:00 AM,48,-122,27,28,55
14239,ElliotBayTrailMyrtlePark,08/17/2015 07:00:00 AM,48,-122,35,86,121
14240,ElliotBayTrailMyrtlePark,08/17/2015 08:00:00 AM,48,-122,48,163,211
14241,ElliotBayTrailMyrtlePark,08/17/2015 09:00:00 AM,48,-122,34,104,138
14242,ElliotBayTrailMyrtlePark,08/17/2015 10:00:00 AM,48,-122,22,34,56
14243,ElliotBayTrailMyrtlePark,08/17/2015 11:00:00 AM,48,-122,24,19,43
14244,ElliotBayTrailMyrtlePark,08/17/2015 12:00:00 PM,48,-122,23,21,44
14245,ElliotBayTrailMyrtlePark,08/17/2015 01:00:00 PM,48,-122,21,30,51
14246,ElliotBayTrailMyrtlePark,08/17/2015 02:00:00 PM,48,-122,34,26,60
14247,ElliotBayTrailMyrtlePark,08/17/2015 03:00:00 PM,48,-122,41,39,80
14248,ElliotBayTrailMyrtlePark,08/17/2015 04:00:00 PM,48,-122,91,82,173
14249,ElliotBayTrailMyrtlePark,08/17/2015 05:00:00 PM,48,-122,186,75,261
14250,ElliotBayTrailMyrtlePark,08/17/2015 06:00:00 PM,48,-122,170,66,236
14251,ElliotBayTrailMyrtlePark,08/17/2015 07:00:00 PM,48,-122,83,53,136
14252,ElliotBayTrailMyrtlePark,08/17/2015 08:00:00 PM,48,-122,31,33,64
14253,ElliotBayTrailMyrtlePark,08/17/2015 09:00:00 PM,48,-122,10,12,22
14254,ElliotBayTrailMyrtlePark,08/17/2015 10:00:00 PM,48,-122,6,4,10
14255,ElliotBayTrailMyrtlePark,08/17/2015 11:00:00 PM,48,-122,4,2,6
14256,ElliotBayTrailMyrtlePark,08/18/2015 12:00:00 AM,48,-122,2,3,5
14257,ElliotBayTrailMyrtlePark,08/18/2015 01:00:00 AM,48,-122,1,0,1
14258,ElliotBayTrailMyrtlePark,08/18/2015 02:00:00 AM,48,-122,2,1,3
14259,ElliotBayTrailMyrtlePark,08/18/2015 03:00:00 AM,48,-122,0,0,0
14260,ElliotBayTrailMyrtlePark,08/18/2015 04:00:00 AM,48,-122,0,0,0
14261,ElliotBayTrailMyrtlePark,08/18/2015 05:00:00 AM,48,-122,7,6,13
14262,ElliotBayTrailMyrtlePark,08/18/2015 06:00:00 AM,48,-122,24,39,63
14263,ElliotBayTrailMyrtlePark,08/18/2015 07:00:00 AM,48,-122,38,100,138
14264,ElliotBayTrailMyrtlePark,08/18/2015 08:00:00 AM,48,-122,57,197,254
14265,ElliotBayTrailMyrtlePark,08/18/2015 09:00:00 AM,48,-122,46,103,149
14266,ElliotBayTrailMyrtlePark,08/18/2015 10:00:00 AM,48,-122,19,39,58
14267,ElliotBayTrailMyrtlePark,08/18/2015 11:00:00 AM,48,-122,31,42,73
14268,ElliotBayTrailMyrtlePark,08/18/2015 12:00:00 PM,48,-122,26,32,58
14269,ElliotBayTrailMyrtlePark,08/18/2015 01:00:00 PM,48,-122,25,22,47
14270,ElliotBayTrailMyrtlePark,08/18/2015 02:00:00 PM,48,-122,29,29,58
14271,ElliotBayTrailMyrtlePark,08/18/2015 03:00:00 PM,48,-122,48,52,100
14272,ElliotBayTrailMyrtlePark,08/18/2015 04:00:00 PM,48,-122,72,55,127
14273,ElliotBayTrailMyrtlePark,08/18/2015 05:00:00 PM,48,-122,237,68,305
14274,ElliotBayTrailMyrtlePark,08/18/2015 06:00:00 PM,48,-122,216,64,280
14275,ElliotBayTrailMyrtlePark,08/18/2015 07:00:00 PM,48,-122,81,48,129
14276,ElliotBayTrailMyrtlePark,08/18/2015 08:00:00 PM,48,-122,46,36,82
14277,ElliotBayTrailMyrtlePark,08/18/2015 09:00:00 PM,48,-122,6,11,17
14278,ElliotBayTrailMyrtlePark,08/18/2015 10:00:00 PM,48,-122,10,7,17
14279,ElliotBayTrailMyrtlePark,08/18/2015 11:00:00 PM,48,-122,7,6,13
14280,ElliotBayTrailMyrtlePark,08/19/2015 12:00:00 AM,48,-122,3,6,9
14281,ElliotBayTrailMyrtlePark,08/19/2015 01:00:00 AM,48,-122,0,0,0
14282,ElliotBayTrailMyrtlePark,08/19/2015 02:00:00 AM,48,-122,1,1,2
14283,ElliotBayTrailMyrtlePark,08/19/2015 03:00:00 AM,48,-122,1,0,1
14284,ElliotBayTrailMyrtlePark,08/19/2015 04:00:00 AM,48,-122,1,0,1
14285,ElliotBayTrailMyrtlePark,08/19/2015 05:00:00 AM,48,-122,6,8,14
14286,ElliotBayTrailMyrtlePark,08/19/2015 06:00:00 AM,48,-122,23,31,54
14287,ElliotBayTrailMyrtlePark,08/19/2015 07:00:00 AM,48,-122,38,94,132
14288,ElliotBayTrailMyrtlePark,08/19/2015 08:00:00 AM,48,-122,53,202,255
14289,ElliotBayTrailMyrtlePark,08/19/2015 09:00:00 AM,48,-122,37,108,145
14290,ElliotBayTrailMyrtlePark,08/19/2015 10:00:00 AM,48,-122,17,24,41
14291,ElliotBayTrailMyrtlePark,08/19/2015 11:00:00 AM,48,-122,29,32,61
14292,ElliotBayTrailMyrtlePark,08/19/2015 12:00:00 PM,48,-122,35,35,70
14293,ElliotBayTrailMyrtlePark,08/19/2015 01:00:00 PM,48,-122,24,25,49
14294,ElliotBayTrailMyrtlePark,08/19/2015 02:00:00 PM,48,-122,31,41,72
14295,ElliotBayTrailMyrtlePark,08/19/2015 03:00:00 PM,48,-122,40,45,85
14296,ElliotBayTrailMyrtlePark,08/19/2015 04:00:00 PM,48,-122,80,75,155
14297,ElliotBayTrailMyrtlePark,08/19/2015 05:00:00 PM,48,-122,222,62,284
14298,ElliotBayTrailMyrtlePark,08/19/2015 06:00:00 PM,48,-122,162,78,240
14299,ElliotBayTrailMyrtlePark,08/19/2015 07:00:00 PM,48,-122,87,57,144
14300,ElliotBayTrailMyrtlePark,08/19/2015 08:00:00 PM,48,-122,47,44,91
14301,ElliotBayTrailMyrtlePark,08/19/2015 09:00:00 PM,48,-122,50,15,65
14302,ElliotBayTrailMyrtlePark,08/19/2015 10:00:00 PM,48,-122,16,3,19
14303,ElliotBayTrailMyrtlePark,08/19/2015 11:00:00 PM,48,-122,11,3,14
14304,ElliotBayTrailMyrtlePark,08/20/2015 12:00:00 AM,48,-122,6,1,7
14305,ElliotBayTrailMyrtlePark,08/20/2015 01:00:00 AM,48,-122,0,0,0
14306,ElliotBayTrailMyrtlePark,08/20/2015 02:00:00 AM,48,-122,1,0,1
14307,ElliotBayTrailMyrtlePark,08/20/2015 03:00:00 AM,48,-122,2,0,2
14308,ElliotBayTrailMyrtlePark,08/20/2015 04:00:00 AM,48,-122,1,4,5
14309,ElliotBayTrailMyrtlePark,08/20/2015 05:00:00 AM,48,-122,7,7,14
14310,ElliotBayTrailMyrtlePark,08/20/2015 06:00:00 AM,48,-122,21,35,56
14311,ElliotBayTrailMyrtlePark,08/20/2015 07:00:00 AM,48,-122,37,102,139
14312,ElliotBayTrailMyrtlePark,08/20/2015 08:00:00 AM,48,-122,39,155,194
14313,ElliotBayTrailMyrtlePark,08/20/2015 09:00:00 AM,48,-122,37,108,145
14314,ElliotBayTrailMyrtlePark,08/20/2015 10:00:00 AM,48,-122,16,43,59
14315,ElliotBayTrailMyrtlePark,08/20/2015 11:00:00 AM,48,-122,29,25,54
14316,ElliotBayTrailMyrtlePark,08/20/2015 12:00:00 PM,48,-122,30,17,47
14317,ElliotBayTrailMyrtlePark,08/20/2015 01:00:00 PM,48,-122,19,12,31
14318,ElliotBayTrailMyrtlePark,08/20/2015 02:00:00 PM,48,-122,21,33,54
14319,ElliotBayTrailMyrtlePark,08/20/2015 03:00:00 PM,48,-122,35,55,90
14320,ElliotBayTrailMyrtlePark,08/20/2015 04:00:00 PM,48,-122,98,53,151
14321,ElliotBayTrailMyrtlePark,08/20/2015 05:00:00 PM,48,-122,168,64,232
14322,ElliotBayTrailMyrtlePark,08/20/2015 06:00:00 PM,48,-122,178,46,224
14323,ElliotBayTrailMyrtlePark,08/20/2015 07:00:00 PM,48,-122,78,45,123
14324,ElliotBayTrailMyrtlePark,08/20/2015 08:00:00 PM,48,-122,59,35,94
14325,ElliotBayTrailMyrtlePark,08/20/2015 09:00:00 PM,48,-122,13,4,17
14326,ElliotBayTrailMyrtlePark,08/20/2015 10:00:00 PM,48,-122,7,7,14
14327,ElliotBayTrailMyrtlePark,08/20/2015 11:00:00 PM,48,-122,4,2,6
14328,ElliotBayTrailMyrtlePark,08/21/2015 12:00:00 AM,48,-122,3,3,6
14329,ElliotBayTrailMyrtlePark,08/21/2015 01:00:00 AM,48,-122,0,1,1
14330,ElliotBayTrailMyrtlePark,08/21/2015 02:00:00 AM,48,-122,0,1,1
14331,ElliotBayTrailMyrtlePark,08/21/2015 03:00:00 AM,48,-122,3,0,3
14332,ElliotBayTrailMyrtlePark,08/21/2015 04:00:00 AM,48,-122,0,1,1
14333,ElliotBayTrailMyrtlePark,08/21/2015 05:00:00 AM,48,-122,4,8,12
14334,ElliotBayTrailMyrtlePark,08/21/2015 06:00:00 AM,48,-122,19,31,50
14335,ElliotBayTrailMyrtlePark,08/21/2015 07:00:00 AM,48,-122,25,76,101
14336,ElliotBayTrailMyrtlePark,08/21/2015 08:00:00 AM,48,-122,44,131,175
14337,ElliotBayTrailMyrtlePark,08/21/2015 09:00:00 AM,48,-122,28,91,119
14338,ElliotBayTrailMyrtlePark,08/21/2015 10:00:00 AM,48,-122,19,40,59
14339,ElliotBayTrailMyrtlePark,08/21/2015 11:00:00 AM,48,-122,14,27,41
14340,ElliotBayTrailMyrtlePark,08/21/2015 12:00:00 PM,48,-122,35,22,57
14341,ElliotBayTrailMyrtlePark,08/21/2015 01:00:00 PM,48,-122,28,28,56
14342,ElliotBayTrailMyrtlePark,08/21/2015 02:00:00 PM,48,-122,33,27,60
14343,ElliotBayTrailMyrtlePark,08/21/2015 03:00:00 PM,48,-122,61,36,97
14344,ElliotBayTrailMyrtlePark,08/21/2015 04:00:00 PM,48,-122,94,59,153
14345,ElliotBayTrailMyrtlePark,08/21/2015 05:00:00 PM,48,-122,143,67,210
14346,ElliotBayTrailMyrtlePark,08/21/2015 06:00:00 PM,48,-122,92,51,143
14347,ElliotBayTrailMyrtlePark,08/21/2015 07:00:00 PM,48,-122,60,31,91
14348,ElliotBayTrailMyrtlePark,08/21/2015 08:00:00 PM,48,-122,31,27,58
14349,ElliotBayTrailMyrtlePark,08/21/2015 09:00:00 PM,48,-122,9,10,19
14350,ElliotBayTrailMyrtlePark,08/21/2015 10:00:00 PM,48,-122,8,8,16
14351,ElliotBayTrailMyrtlePark,08/21/2015 11:00:00 PM,48,-122,10,0,10
14352,ElliotBayTrailMyrtlePark,08/22/2015 12:00:00 AM,48,-122,14,4,18
14353,ElliotBayTrailMyrtlePark,08/22/2015 01:00:00 AM,48,-122,1,0,1
14354,ElliotBayTrailMyrtlePark,08/22/2015 02:00:00 AM,48,-122,0,0,0
14355,ElliotBayTrailMyrtlePark,08/22/2015 03:00:00 AM,48,-122,3,1,4
14356,ElliotBayTrailMyrtlePark,08/22/2015 04:00:00 AM,48,-122,1,0,1
14357,ElliotBayTrailMyrtlePark,08/22/2015 05:00:00 AM,48,-122,1,3,4
14358,ElliotBayTrailMyrtlePark,08/22/2015 06:00:00 AM,48,-122,6,8,14
14359,ElliotBayTrailMyrtlePark,08/22/2015 07:00:00 AM,48,-122,10,10,20
14360,ElliotBayTrailMyrtlePark,08/22/2015 08:00:00 AM,48,-122,35,17,52
14361,ElliotBayTrailMyrtlePark,08/22/2015 09:00:00 AM,48,-122,24,40,64
14362,ElliotBayTrailMyrtlePark,08/22/2015 10:00:00 AM,48,-122,39,39,78
14363,ElliotBayTrailMyrtlePark,08/22/2015 11:00:00 AM,48,-122,42,53,95
14364,ElliotBayTrailMyrtlePark,08/22/2015 12:00:00 PM,48,-122,61,68,129
14365,ElliotBayTrailMyrtlePark,08/22/2015 01:00:00 PM,48,-122,51,31,82
14366,ElliotBayTrailMyrtlePark,08/22/2015 02:00:00 PM,48,-122,67,59,126
14367,ElliotBayTrailMyrtlePark,08/22/2015 03:00:00 PM,48,-122,78,74,152
14368,ElliotBayTrailMyrtlePark,08/22/2015 04:00:00 PM,48,-122,63,57,120
14369,ElliotBayTrailMyrtlePark,08/22/2015 05:00:00 PM,48,-122,68,60,128
14370,ElliotBayTrailMyrtlePark,08/22/2015 06:00:00 PM,48,-122,42,55,97
14371,ElliotBayTrailMyrtlePark,08/22/2015 07:00:00 PM,48,-122,33,33,66
14372,ElliotBayTrailMyrtlePark,08/22/2015 08:00:00 PM,48,-122,25,18,43
14373,ElliotBayTrailMyrtlePark,08/22/2015 09:00:00 PM,48,-122,5,5,10
14374,ElliotBayTrailMyrtlePark,08/22/2015 10:00:00 PM,48,-122,17,1,18
14375,ElliotBayTrailMyrtlePark,08/22/2015 11:00:00 PM,48,-122,14,6,20
14376,ElliotBayTrailMyrtlePark,08/23/2015 12:00:00 AM,48,-122,1,0,1
14377,ElliotBayTrailMyrtlePark,08/23/2015 01:00:00 AM,48,-122,1,9,10
14378,ElliotBayTrailMyrtlePark,08/23/2015 02:00:00 AM,48,-122,1,1,2
14379,ElliotBayTrailMyrtlePark,08/23/2015 03:00:00 AM,48,-122,4,2,6
14380,ElliotBayTrailMyrtlePark,08/23/2015 04:00:00 AM,48,-122,1,0,1
14381,ElliotBayTrailMyrtlePark,08/23/2015 05:00:00 AM,48,-122,0,1,1
14382,ElliotBayTrailMyrtlePark,08/23/2015 06:00:00 AM,48,-122,2,5,7
14383,ElliotBayTrailMyrtlePark,08/23/2015 07:00:00 AM,48,-122,6,11,17
14384,ElliotBayTrailMyrtlePark,08/23/2015 08:00:00 AM,48,-122,32,20,52
14385,ElliotBayTrailMyrtlePark,08/23/2015 09:00:00 AM,48,-122,30,43,73
14386,ElliotBayTrailMyrtlePark,08/23/2015 10:00:00 AM,48,-122,45,52,97
14387,ElliotBayTrailMyrtlePark,08/23/2015 11:00:00 AM,48,-122,74,60,134
14388,ElliotBayTrailMyrtlePark,08/23/2015 12:00:00 PM,48,-122,65,97,162
14389,ElliotBayTrailMyrtlePark,08/23/2015 01:00:00 PM,48,-122,70,69,139
14390,ElliotBayTrailMyrtlePark,08/23/2015 02:00:00 PM,48,-122,70,42,112
14391,ElliotBayTrailMyrtlePark,08/23/2015 03:00:00 PM,48,-122,70,66,136
14392,ElliotBayTrailMyrtlePark,08/23/2015 04:00:00 PM,48,-122,99,52,151
14393,ElliotBayTrailMyrtlePark,08/23/2015 05:00:00 PM,48,-122,54,42,96
14394,ElliotBayTrailMyrtlePark,08/23/2015 06:00:00 PM,48,-122,48,46,94
14395,ElliotBayTrailMyrtlePark,08/23/2015 07:00:00 PM,48,-122,38,38,76
14396,ElliotBayTrailMyrtlePark,08/23/2015 08:00:00 PM,48,-122,37,8,45
14397,ElliotBayTrailMyrtlePark,08/23/2015 09:00:00 PM,48,-122,11,9,20
14398,ElliotBayTrailMyrtlePark,08/23/2015 10:00:00 PM,48,-122,8,0,8
14399,ElliotBayTrailMyrtlePark,08/23/2015 11:00:00 PM,48,-122,4,1,5
14400,ElliotBayTrailMyrtlePark,08/24/2015 12:00:00 AM,48,-122,2,0,2
14401,ElliotBayTrailMyrtlePark,08/24/2015 01:00:00 AM,48,-122,2,0,2
14402,ElliotBayTrailMyrtlePark,08/24/2015 02:00:00 AM,48,-122,1,0,1
14403,ElliotBayTrailMyrtlePark,08/24/2015 03:00:00 AM,48,-122,2,0,2
14404,ElliotBayTrailMyrtlePark,08/24/2015 04:00:00 AM,48,-122,1,0,1
14405,ElliotBayTrailMyrtlePark,08/24/2015 05:00:00 AM,48,-122,8,6,14
14406,ElliotBayTrailMyrtlePark,08/24/2015 06:00:00 AM,48,-122,13,34,47
14407,ElliotBayTrailMyrtlePark,08/24/2015 07:00:00 AM,48,-122,43,94,137
14408,ElliotBayTrailMyrtlePark,08/24/2015 08:00:00 AM,48,-122,46,164,210
14409,ElliotBayTrailMyrtlePark,08/24/2015 09:00:00 AM,48,-122,44,117,161
14410,ElliotBayTrailMyrtlePark,08/24/2015 10:00:00 AM,48,-122,20,38,58
14411,ElliotBayTrailMyrtlePark,08/24/2015 11:00:00 AM,48,-122,22,27,49
14412,ElliotBayTrailMyrtlePark,08/24/2015 12:00:00 PM,48,-122,30,24,54
14413,ElliotBayTrailMyrtlePark,08/24/2015 01:00:00 PM,48,-122,22,19,41
14414,ElliotBayTrailMyrtlePark,08/24/2015 02:00:00 PM,48,-122,25,36,61
14415,ElliotBayTrailMyrtlePark,08/24/2015 03:00:00 PM,48,-122,46,41,87
14416,ElliotBayTrailMyrtlePark,08/24/2015 04:00:00 PM,48,-122,87,50,137
14417,ElliotBayTrailMyrtlePark,08/24/2015 05:00:00 PM,48,-122,209,80,289
14418,ElliotBayTrailMyrtlePark,08/24/2015 06:00:00 PM,48,-122,164,50,214
14419,ElliotBayTrailMyrtlePark,08/24/2015 07:00:00 PM,48,-122,73,32,105
14420,ElliotBayTrailMyrtlePark,08/24/2015 08:00:00 PM,48,-122,29,38,67
14421,ElliotBayTrailMyrtlePark,08/24/2015 09:00:00 PM,48,-122,7,2,9
14422,ElliotBayTrailMyrtlePark,08/24/2015 10:00:00 PM,48,-122,13,5,18
14423,ElliotBayTrailMyrtlePark,08/24/2015 11:00:00 PM,48,-122,12,2,14
14424,ElliotBayTrailMyrtlePark,08/25/2015 12:00:00 AM,48,-122,3,0,3
14425,ElliotBayTrailMyrtlePark,08/25/2015 01:00:00 AM,48,-122,3,1,4
14426,ElliotBayTrailMyrtlePark,08/25/2015 02:00:00 AM,48,-122,0,1,1
14427,ElliotBayTrailMyrtlePark,08/25/2015 03:00:00 AM,48,-122,2,0,2
14428,ElliotBayTrailMyrtlePark,08/25/2015 04:00:00 AM,48,-122,1,0,1
14429,ElliotBayTrailMyrtlePark,08/25/2015 05:00:00 AM,48,-122,3,6,9
14430,ElliotBayTrailMyrtlePark,08/25/2015 06:00:00 AM,48,-122,24,42,66
14431,ElliotBayTrailMyrtlePark,08/25/2015 07:00:00 AM,48,-122,44,115,159
14432,ElliotBayTrailMyrtlePark,08/25/2015 08:00:00 AM,48,-122,47,187,234
14433,ElliotBayTrailMyrtlePark,08/25/2015 09:00:00 AM,48,-122,42,114,156
14434,ElliotBayTrailMyrtlePark,08/25/2015 10:00:00 AM,48,-122,25,38,63
14435,ElliotBayTrailMyrtlePark,08/25/2015 11:00:00 AM,48,-122,14,31,45
14436,ElliotBayTrailMyrtlePark,08/25/2015 12:00:00 PM,48,-122,41,45,86
14437,ElliotBayTrailMyrtlePark,08/25/2015 01:00:00 PM,48,-122,24,36,60
14438,ElliotBayTrailMyrtlePark,08/25/2015 02:00:00 PM,48,-122,41,35,76
14439,ElliotBayTrailMyrtlePark,08/25/2015 03:00:00 PM,48,-122,44,35,79
14440,ElliotBayTrailMyrtlePark,08/25/2015 04:00:00 PM,48,-122,114,60,174
14441,ElliotBayTrailMyrtlePark,08/25/2015 05:00:00 PM,48,-122,207,68,275
14442,ElliotBayTrailMyrtlePark,08/25/2015 06:00:00 PM,48,-122,171,63,234
14443,ElliotBayTrailMyrtlePark,08/25/2015 07:00:00 PM,48,-122,88,37,125
14444,ElliotBayTrailMyrtlePark,08/25/2015 08:00:00 PM,48,-122,41,34,75
14445,ElliotBayTrailMyrtlePark,08/25/2015 09:00:00 PM,48,-122,5,11,16
14446,ElliotBayTrailMyrtlePark,08/25/2015 10:00:00 PM,48,-122,11,2,13
14447,ElliotBayTrailMyrtlePark,08/25/2015 11:00:00 PM,48,-122,6,2,8
14448,ElliotBayTrailMyrtlePark,08/26/2015 12:00:00 AM,48,-122,5,0,5
14449,ElliotBayTrailMyrtlePark,08/26/2015 01:00:00 AM,48,-122,2,0,2
14450,ElliotBayTrailMyrtlePark,08/26/2015 02:00:00 AM,48,-122,0,0,0
14451,ElliotBayTrailMyrtlePark,08/26/2015 03:00:00 AM,48,-122,1,0,1
14452,ElliotBayTrailMyrtlePark,08/26/2015 04:00:00 AM,48,-122,0,0,0
14453,ElliotBayTrailMyrtlePark,08/26/2015 05:00:00 AM,48,-122,5,6,11
14454,ElliotBayTrailMyrtlePark,08/26/2015 06:00:00 AM,48,-122,21,35,56
14455,ElliotBayTrailMyrtlePark,08/26/2015 07:00:00 AM,48,-122,39,90,129
14456,ElliotBayTrailMyrtlePark,08/26/2015 08:00:00 AM,48,-122,60,176,236
14457,ElliotBayTrailMyrtlePark,08/26/2015 09:00:00 AM,48,-122,35,105,140
14458,ElliotBayTrailMyrtlePark,08/26/2015 10:00:00 AM,48,-122,29,37,66
14459,ElliotBayTrailMyrtlePark,08/26/2015 11:00:00 AM,48,-122,12,23,35
14460,ElliotBayTrailMyrtlePark,08/26/2015 12:00:00 PM,48,-122,50,50,100
14461,ElliotBayTrailMyrtlePark,08/26/2015 01:00:00 PM,48,-122,32,21,53
14462,ElliotBayTrailMyrtlePark,08/26/2015 02:00:00 PM,48,-122,25,34,59
14463,ElliotBayTrailMyrtlePark,08/26/2015 03:00:00 PM,48,-122,36,30,66
14464,ElliotBayTrailMyrtlePark,08/26/2015 04:00:00 PM,48,-122,99,80,179
14465,ElliotBayTrailMyrtlePark,08/26/2015 05:00:00 PM,48,-122,213,67,280
14466,ElliotBayTrailMyrtlePark,08/26/2015 06:00:00 PM,48,-122,185,89,274
14467,ElliotBayTrailMyrtlePark,08/26/2015 07:00:00 PM,48,-122,84,48,132
14468,ElliotBayTrailMyrtlePark,08/26/2015 08:00:00 PM,48,-122,43,35,78
14469,ElliotBayTrailMyrtlePark,08/26/2015 09:00:00 PM,48,-122,20,20,40
14470,ElliotBayTrailMyrtlePark,08/26/2015 10:00:00 PM,48,-122,5,8,13
14471,ElliotBayTrailMyrtlePark,08/26/2015 11:00:00 PM,48,-122,3,5,8
14472,ElliotBayTrailMyrtlePark,08/27/2015 12:00:00 AM,48,-122,1,0,1
14473,ElliotBayTrailMyrtlePark,08/27/2015 01:00:00 AM,48,-122,3,3,6
14474,ElliotBayTrailMyrtlePark,08/27/2015 02:00:00 AM,48,-122,0,0,0
14475,ElliotBayTrailMyrtlePark,08/27/2015 03:00:00 AM,48,-122,1,0,1
14476,ElliotBayTrailMyrtlePark,08/27/2015 04:00:00 AM,48,-122,1,1,2
14477,ElliotBayTrailMyrtlePark,08/27/2015 05:00:00 AM,48,-122,7,7,14
14478,ElliotBayTrailMyrtlePark,08/27/2015 06:00:00 AM,48,-122,21,33,54
14479,ElliotBayTrailMyrtlePark,08/27/2015 07:00:00 AM,48,-122,42,100,142
14480,ElliotBayTrailMyrtlePark,08/27/2015 08:00:00 AM,48,-122,63,201,264
14481,ElliotBayTrailMyrtlePark,08/27/2015 09:00:00 AM,48,-122,32,101,133
14482,ElliotBayTrailMyrtlePark,08/27/2015 10:00:00 AM,48,-122,29,44,73
14483,ElliotBayTrailMyrtlePark,08/27/2015 11:00:00 AM,48,-122,30,33,63
14484,ElliotBayTrailMyrtlePark,08/27/2015 12:00:00 PM,48,-122,33,31,64
14485,ElliotBayTrailMyrtlePark,08/27/2015 01:00:00 PM,48,-122,40,39,79
14486,ElliotBayTrailMyrtlePark,08/27/2015 02:00:00 PM,48,-122,45,27,72
14487,ElliotBayTrailMyrtlePark,08/27/2015 03:00:00 PM,48,-122,60,48,108
14488,ElliotBayTrailMyrtlePark,08/27/2015 04:00:00 PM,48,-122,110,72,182
14489,ElliotBayTrailMyrtlePark,08/27/2015 05:00:00 PM,48,-122,206,77,283
14490,ElliotBayTrailMyrtlePark,08/27/2015 06:00:00 PM,48,-122,212,100,312
14491,ElliotBayTrailMyrtlePark,08/27/2015 07:00:00 PM,48,-122,90,68,158
14492,ElliotBayTrailMyrtlePark,08/27/2015 08:00:00 PM,48,-122,71,36,107
14493,ElliotBayTrailMyrtlePark,08/27/2015 09:00:00 PM,48,-122,12,24,36
14494,ElliotBayTrailMyrtlePark,08/27/2015 10:00:00 PM,48,-122,3,16,19
14495,ElliotBayTrailMyrtlePark,08/27/2015 11:00:00 PM,48,-122,5,3,8
14496,ElliotBayTrailMyrtlePark,08/28/2015 12:00:00 AM,48,-122,3,4,7
14497,ElliotBayTrailMyrtlePark,08/28/2015 01:00:00 AM,48,-122,2,0,2
14498,ElliotBayTrailMyrtlePark,08/28/2015 02:00:00 AM,48,-122,2,0,2
14499,ElliotBayTrailMyrtlePark,08/28/2015 03:00:00 AM,48,-122,2,1,3
14500,ElliotBayTrailMyrtlePark,08/28/2015 04:00:00 AM,48,-122,0,0,0
14501,ElliotBayTrailMyrtlePark,08/28/2015 05:00:00 AM,48,-122,3,8,11
14502,ElliotBayTrailMyrtlePark,08/28/2015 06:00:00 AM,48,-122,17,20,37
14503,ElliotBayTrailMyrtlePark,08/28/2015 07:00:00 AM,48,-122,31,46,77
14504,ElliotBayTrailMyrtlePark,08/28/2015 08:00:00 AM,48,-122,29,122,151
14505,ElliotBayTrailMyrtlePark,08/28/2015 09:00:00 AM,48,-122,31,72,103
14506,ElliotBayTrailMyrtlePark,08/28/2015 10:00:00 AM,48,-122,18,29,47
14507,ElliotBayTrailMyrtlePark,08/28/2015 11:00:00 AM,48,-122,20,24,44
14508,ElliotBayTrailMyrtlePark,08/28/2015 12:00:00 PM,48,-122,31,27,58
14509,ElliotBayTrailMyrtlePark,08/28/2015 01:00:00 PM,48,-122,17,17,34
14510,ElliotBayTrailMyrtlePark,08/28/2015 02:00:00 PM,48,-122,35,22,57
14511,ElliotBayTrailMyrtlePark,08/28/2015 03:00:00 PM,48,-122,42,29,71
14512,ElliotBayTrailMyrtlePark,08/28/2015 04:00:00 PM,48,-122,81,48,129
14513,ElliotBayTrailMyrtlePark,08/28/2015 05:00:00 PM,48,-122,114,47,161
14514,ElliotBayTrailMyrtlePark,08/28/2015 06:00:00 PM,48,-122,87,32,119
14515,ElliotBayTrailMyrtlePark,08/28/2015 07:00:00 PM,48,-122,24,13,37
14516,ElliotBayTrailMyrtlePark,08/28/2015 08:00:00 PM,48,-122,24,14,38
14517,ElliotBayTrailMyrtlePark,08/28/2015 09:00:00 PM,48,-122,7,3,10
14518,ElliotBayTrailMyrtlePark,08/28/2015 10:00:00 PM,48,-122,4,3,7
14519,ElliotBayTrailMyrtlePark,08/28/2015 11:00:00 PM,48,-122,6,2,8
14520,ElliotBayTrailMyrtlePark,08/29/2015 12:00:00 AM,48,-122,1,1,2
14521,ElliotBayTrailMyrtlePark,08/29/2015 01:00:00 AM,48,-122,2,0,2
14522,ElliotBayTrailMyrtlePark,08/29/2015 02:00:00 AM,48,-122,1,0,1
14523,ElliotBayTrailMyrtlePark,08/29/2015 03:00:00 AM,48,-122,1,0,1
14524,ElliotBayTrailMyrtlePark,08/29/2015 04:00:00 AM,48,-122,0,0,0
14525,ElliotBayTrailMyrtlePark,08/29/2015 05:00:00 AM,48,-122,0,0,0
14526,ElliotBayTrailMyrtlePark,08/29/2015 06:00:00 AM,48,-122,3,2,5
14527,ElliotBayTrailMyrtlePark,08/29/2015 07:00:00 AM,48,-122,2,1,3
14528,ElliotBayTrailMyrtlePark,08/29/2015 08:00:00 AM,48,-122,6,6,12
14529,ElliotBayTrailMyrtlePark,08/29/2015 09:00:00 AM,48,-122,11,8,19
14530,ElliotBayTrailMyrtlePark,08/29/2015 10:00:00 AM,48,-122,12,14,26
14531,ElliotBayTrailMyrtlePark,08/29/2015 11:00:00 AM,48,-122,4,14,18
14532,ElliotBayTrailMyrtlePark,08/29/2015 12:00:00 PM,48,-122,10,9,19
14533,ElliotBayTrailMyrtlePark,08/29/2015 01:00:00 PM,48,-122,8,3,11
14534,ElliotBayTrailMyrtlePark,08/29/2015 02:00:00 PM,48,-122,13,13,26
14535,ElliotBayTrailMyrtlePark,08/29/2015 03:00:00 PM,48,-122,17,15,32
14536,ElliotBayTrailMyrtlePark,08/29/2015 04:00:00 PM,48,-122,15,16,31
14537,ElliotBayTrailMyrtlePark,08/29/2015 05:00:00 PM,48,-122,19,20,39
14538,ElliotBayTrailMyrtlePark,08/29/2015 06:00:00 PM,48,-122,17,7,24
14539,ElliotBayTrailMyrtlePark,08/29/2015 07:00:00 PM,48,-122,4,3,7
14540,ElliotBayTrailMyrtlePark,08/29/2015 08:00:00 PM,48,-122,2,1,3
14541,ElliotBayTrailMyrtlePark,08/29/2015 09:00:00 PM,48,-122,0,5,5
14542,ElliotBayTrailMyrtlePark,08/29/2015 10:00:00 PM,48,-122,1,0,1
14543,ElliotBayTrailMyrtlePark,08/29/2015 11:00:00 PM,48,-122,0,5,5
14544,ElliotBayTrailMyrtlePark,08/30/2015 12:00:00 AM,48,-122,2,0,2
14545,ElliotBayTrailMyrtlePark,08/30/2015 01:00:00 AM,48,-122,0,2,2
14546,ElliotBayTrailMyrtlePark,08/30/2015 02:00:00 AM,48,-122,0,1,1
14547,ElliotBayTrailMyrtlePark,08/30/2015 03:00:00 AM,48,-122,1,0,1
14548,ElliotBayTrailMyrtlePark,08/30/2015 04:00:00 AM,48,-122,2,1,3
14549,ElliotBayTrailMyrtlePark,08/30/2015 05:00:00 AM,48,-122,0,0,0
14550,ElliotBayTrailMyrtlePark,08/30/2015 06:00:00 AM,48,-122,1,1,2
14551,ElliotBayTrailMyrtlePark,08/30/2015 07:00:00 AM,48,-122,0,2,2
14552,ElliotBayTrailMyrtlePark,08/30/2015 08:00:00 AM,48,-122,7,2,9
14553,ElliotBayTrailMyrtlePark,08/30/2015 09:00:00 AM,48,-122,4,7,11
14554,ElliotBayTrailMyrtlePark,08/30/2015 10:00:00 AM,48,-122,18,14,32
14555,ElliotBayTrailMyrtlePark,08/30/2015 11:00:00 AM,48,-122,21,26,47
14556,ElliotBayTrailMyrtlePark,08/30/2015 12:00:00 PM,48,-122,21,28,49
14557,ElliotBayTrailMyrtlePark,08/30/2015 01:00:00 PM,48,-122,20,55,75
14558,ElliotBayTrailMyrtlePark,08/30/2015 02:00:00 PM,48,-122,28,46,74
14559,ElliotBayTrailMyrtlePark,08/30/2015 03:00:00 PM,48,-122,39,24,63
14560,ElliotBayTrailMyrtlePark,08/30/2015 04:00:00 PM,48,-122,81,34,115
14561,ElliotBayTrailMyrtlePark,08/30/2015 05:00:00 PM,48,-122,42,24,66
14562,ElliotBayTrailMyrtlePark,08/30/2015 06:00:00 PM,48,-122,21,17,38
14563,ElliotBayTrailMyrtlePark,08/30/2015 07:00:00 PM,48,-122,17,16,33
14564,ElliotBayTrailMyrtlePark,08/30/2015 08:00:00 PM,48,-122,19,9,28
14565,ElliotBayTrailMyrtlePark,08/30/2015 09:00:00 PM,48,-122,1,3,4
14566,ElliotBayTrailMyrtlePark,08/30/2015 10:00:00 PM,48,-122,6,3,9
14567,ElliotBayTrailMyrtlePark,08/30/2015 11:00:00 PM,48,-122,1,1,2
14568,ElliotBayTrailMyrtlePark,08/31/2015 12:00:00 AM,48,-122,0,2,2
14569,ElliotBayTrailMyrtlePark,08/31/2015 01:00:00 AM,48,-122,1,0,1
14570,ElliotBayTrailMyrtlePark,08/31/2015 02:00:00 AM,48,-122,1,0,1
14571,ElliotBayTrailMyrtlePark,08/31/2015 03:00:00 AM,48,-122,0,0,0
14572,ElliotBayTrailMyrtlePark,08/31/2015 04:00:00 AM,48,-122,0,0,0
14573,ElliotBayTrailMyrtlePark,08/31/2015 05:00:00 AM,48,-122,6,4,10
14574,ElliotBayTrailMyrtlePark,08/31/2015 06:00:00 AM,48,-122,13,15,28
14575,ElliotBayTrailMyrtlePark,08/31/2015 07:00:00 AM,48,-122,37,60,97
14576,ElliotBayTrailMyrtlePark,08/31/2015 08:00:00 AM,48,-122,30,128,158
14577,ElliotBayTrailMyrtlePark,08/31/2015 09:00:00 AM,48,-122,25,91,116
14578,ElliotBayTrailMyrtlePark,08/31/2015 10:00:00 AM,48,-122,9,25,34
14579,ElliotBayTrailMyrtlePark,08/31/2015 11:00:00 AM,48,-122,14,3,17
14580,ElliotBayTrailMyrtlePark,08/31/2015 12:00:00 PM,48,-122,2,7,9
14581,ElliotBayTrailMyrtlePark,08/31/2015 01:00:00 PM,48,-122,11,5,16
14582,ElliotBayTrailMyrtlePark,08/31/2015 02:00:00 PM,48,-122,9,17,26
14583,ElliotBayTrailMyrtlePark,08/31/2015 03:00:00 PM,48,-122,16,10,26
14584,ElliotBayTrailMyrtlePark,08/31/2015 04:00:00 PM,48,-122,45,35,80
14585,ElliotBayTrailMyrtlePark,08/31/2015 05:00:00 PM,48,-122,145,42,187
14586,ElliotBayTrailMyrtlePark,08/31/2015 06:00:00 PM,48,-122,113,22,135
14587,ElliotBayTrailMyrtlePark,08/31/2015 07:00:00 PM,48,-122,46,16,62
14588,ElliotBayTrailMyrtlePark,08/31/2015 08:00:00 PM,48,-122,19,10,29
14589,ElliotBayTrailMyrtlePark,08/31/2015 09:00:00 PM,48,-122,3,1,4
14590,ElliotBayTrailMyrtlePark,08/31/2015 10:00:00 PM,48,-122,4,3,7
14591,ElliotBayTrailMyrtlePark,08/31/2015 11:00:00 PM,48,-122,1,1,2
14592,ElliotBayTrailMyrtlePark,09/01/2015 12:00:00 AM,48,-122,2,2,4
14593,ElliotBayTrailMyrtlePark,09/01/2015 01:00:00 AM,48,-122,0,0,0
14594,ElliotBayTrailMyrtlePark,09/01/2015 02:00:00 AM,48,-122,0,0,0
14595,ElliotBayTrailMyrtlePark,09/01/2015 03:00:00 AM,48,-122,2,1,3
14596,ElliotBayTrailMyrtlePark,09/01/2015 04:00:00 AM,48,-122,0,0,0
14597,ElliotBayTrailMyrtlePark,09/01/2015 05:00:00 AM,48,-122,7,6,13
14598,ElliotBayTrailMyrtlePark,09/01/2015 06:00:00 AM,48,-122,12,27,39
14599,ElliotBayTrailMyrtlePark,09/01/2015 07:00:00 AM,48,-122,36,66,102
14600,ElliotBayTrailMyrtlePark,09/01/2015 08:00:00 AM,48,-122,28,160,188
14601,ElliotBayTrailMyrtlePark,09/01/2015 09:00:00 AM,48,-122,27,62,89
14602,ElliotBayTrailMyrtlePark,09/01/2015 10:00:00 AM,48,-122,8,17,25
14603,ElliotBayTrailMyrtlePark,09/01/2015 11:00:00 AM,48,-122,5,7,12
14604,ElliotBayTrailMyrtlePark,09/01/2015 12:00:00 PM,48,-122,15,14,29
14605,ElliotBayTrailMyrtlePark,09/01/2015 01:00:00 PM,48,-122,14,12,26
14606,ElliotBayTrailMyrtlePark,09/01/2015 02:00:00 PM,48,-122,16,11,27
14607,ElliotBayTrailMyrtlePark,09/01/2015 03:00:00 PM,48,-122,16,18,34
14608,ElliotBayTrailMyrtlePark,09/01/2015 04:00:00 PM,48,-122,42,40,82
14609,ElliotBayTrailMyrtlePark,09/01/2015 05:00:00 PM,48,-122,121,50,171
14610,ElliotBayTrailMyrtlePark,09/01/2015 06:00:00 PM,48,-122,120,31,151
14611,ElliotBayTrailMyrtlePark,09/01/2015 07:00:00 PM,48,-122,53,21,74
14612,ElliotBayTrailMyrtlePark,09/01/2015 08:00:00 PM,48,-122,16,5,21
14613,ElliotBayTrailMyrtlePark,09/01/2015 09:00:00 PM,48,-122,2,3,5
14614,ElliotBayTrailMyrtlePark,09/01/2015 10:00:00 PM,48,-122,0,2,2
14615,ElliotBayTrailMyrtlePark,09/01/2015 11:00:00 PM,48,-122,6,1,7
14616,ElliotBayTrailMyrtlePark,09/02/2015 12:00:00 AM,48,-122,1,0,1
14617,ElliotBayTrailMyrtlePark,09/02/2015 01:00:00 AM,48,-122,0,0,0
14618,ElliotBayTrailMyrtlePark,09/02/2015 02:00:00 AM,48,-122,0,0,0
14619,ElliotBayTrailMyrtlePark,09/02/2015 03:00:00 AM,48,-122,4,0,4
14620,ElliotBayTrailMyrtlePark,09/02/2015 04:00:00 AM,48,-122,1,1,2
14621,ElliotBayTrailMyrtlePark,09/02/2015 05:00:00 AM,48,-122,3,6,9
14622,ElliotBayTrailMyrtlePark,09/02/2015 06:00:00 AM,48,-122,17,25,42
14623,ElliotBayTrailMyrtlePark,09/02/2015 07:00:00 AM,48,-122,35,83,118
14624,ElliotBayTrailMyrtlePark,09/02/2015 08:00:00 AM,48,-122,38,152,190
14625,ElliotBayTrailMyrtlePark,09/02/2015 09:00:00 AM,48,-122,23,89,112
14626,ElliotBayTrailMyrtlePark,09/02/2015 10:00:00 AM,48,-122,21,40,61
14627,ElliotBayTrailMyrtlePark,09/02/2015 11:00:00 AM,48,-122,19,17,36
14628,ElliotBayTrailMyrtlePark,09/02/2015 12:00:00 PM,48,-122,28,23,51
14629,ElliotBayTrailMyrtlePark,09/02/2015 01:00:00 PM,48,-122,16,24,40
14630,ElliotBayTrailMyrtlePark,09/02/2015 02:00:00 PM,48,-122,28,24,52
14631,ElliotBayTrailMyrtlePark,09/02/2015 03:00:00 PM,48,-122,35,22,57
14632,ElliotBayTrailMyrtlePark,09/02/2015 04:00:00 PM,48,-122,72,45,117
14633,ElliotBayTrailMyrtlePark,09/02/2015 05:00:00 PM,48,-122,175,60,235
14634,ElliotBayTrailMyrtlePark,09/02/2015 06:00:00 PM,48,-122,135,55,190
14635,ElliotBayTrailMyrtlePark,09/02/2015 07:00:00 PM,48,-122,61,24,85
14636,ElliotBayTrailMyrtlePark,09/02/2015 08:00:00 PM,48,-122,17,7,24
14637,ElliotBayTrailMyrtlePark,09/02/2015 09:00:00 PM,48,-122,6,3,9
14638,ElliotBayTrailMyrtlePark,09/02/2015 10:00:00 PM,48,-122,1,7,8
14639,ElliotBayTrailMyrtlePark,09/02/2015 11:00:00 PM,48,-122,8,1,9
14640,ElliotBayTrailMyrtlePark,09/03/2015 12:00:00 AM,48,-122,0,0,0
14641,ElliotBayTrailMyrtlePark,09/03/2015 01:00:00 AM,48,-122,0,0,0
14642,ElliotBayTrailMyrtlePark,09/03/2015 02:00:00 AM,48,-122,1,0,1
14643,ElliotBayTrailMyrtlePark,09/03/2015 03:00:00 AM,48,-122,2,0,2
14644,ElliotBayTrailMyrtlePark,09/03/2015 04:00:00 AM,48,-122,0,1,1
14645,ElliotBayTrailMyrtlePark,09/03/2015 05:00:00 AM,48,-122,4,6,10
14646,ElliotBayTrailMyrtlePark,09/03/2015 06:00:00 AM,48,-122,12,23,35
14647,ElliotBayTrailMyrtlePark,09/03/2015 07:00:00 AM,48,-122,40,62,102
14648,ElliotBayTrailMyrtlePark,09/03/2015 08:00:00 AM,48,-122,41,116,157
14649,ElliotBayTrailMyrtlePark,09/03/2015 09:00:00 AM,48,-122,19,95,114
14650,ElliotBayTrailMyrtlePark,09/03/2015 10:00:00 AM,48,-122,22,30,52
14651,ElliotBayTrailMyrtlePark,09/03/2015 11:00:00 AM,48,-122,20,21,41
14652,ElliotBayTrailMyrtlePark,09/03/2015 12:00:00 PM,48,-122,27,19,46
14653,ElliotBayTrailMyrtlePark,09/03/2015 01:00:00 PM,48,-122,20,24,44
14654,ElliotBayTrailMyrtlePark,09/03/2015 02:00:00 PM,48,-122,26,18,44
14655,ElliotBayTrailMyrtlePark,09/03/2015 03:00:00 PM,48,-122,33,39,72
14656,ElliotBayTrailMyrtlePark,09/03/2015 04:00:00 PM,48,-122,67,46,113
14657,ElliotBayTrailMyrtlePark,09/03/2015 05:00:00 PM,48,-122,138,67,205
14658,ElliotBayTrailMyrtlePark,09/03/2015 06:00:00 PM,48,-122,117,45,162
14659,ElliotBayTrailMyrtlePark,09/03/2015 07:00:00 PM,48,-122,50,30,80
14660,ElliotBayTrailMyrtlePark,09/03/2015 08:00:00 PM,48,-122,23,7,30
14661,ElliotBayTrailMyrtlePark,09/03/2015 09:00:00 PM,48,-122,3,4,7
14662,ElliotBayTrailMyrtlePark,09/03/2015 10:00:00 PM,48,-122,12,1,13
14663,ElliotBayTrailMyrtlePark,09/03/2015 11:00:00 PM,48,-122,9,0,9
14664,ElliotBayTrailMyrtlePark,09/04/2015 12:00:00 AM,48,-122,2,0,2
14665,ElliotBayTrailMyrtlePark,09/04/2015 01:00:00 AM,48,-122,3,1,4
14666,ElliotBayTrailMyrtlePark,09/04/2015 02:00:00 AM,48,-122,1,0,1
14667,ElliotBayTrailMyrtlePark,09/04/2015 03:00:00 AM,48,-122,3,1,4
14668,ElliotBayTrailMyrtlePark,09/04/2015 04:00:00 AM,48,-122,0,1,1
14669,ElliotBayTrailMyrtlePark,09/04/2015 05:00:00 AM,48,-122,4,7,11
14670,ElliotBayTrailMyrtlePark,09/04/2015 06:00:00 AM,48,-122,19,21,40
14671,ElliotBayTrailMyrtlePark,09/04/2015 07:00:00 AM,48,-122,29,68,97
14672,ElliotBayTrailMyrtlePark,09/04/2015 08:00:00 AM,48,-122,33,107,140
14673,ElliotBayTrailMyrtlePark,09/04/2015 09:00:00 AM,48,-122,27,79,106
14674,ElliotBayTrailMyrtlePark,09/04/2015 10:00:00 AM,48,-122,25,31,56
14675,ElliotBayTrailMyrtlePark,09/04/2015 11:00:00 AM,48,-122,16,16,32
14676,ElliotBayTrailMyrtlePark,09/04/2015 12:00:00 PM,48,-122,20,32,52
14677,ElliotBayTrailMyrtlePark,09/04/2015 01:00:00 PM,48,-122,41,22,63
14678,ElliotBayTrailMyrtlePark,09/04/2015 02:00:00 PM,48,-122,26,21,47
14679,ElliotBayTrailMyrtlePark,09/04/2015 03:00:00 PM,48,-122,59,32,91
14680,ElliotBayTrailMyrtlePark,09/04/2015 04:00:00 PM,48,-122,72,53,125
14681,ElliotBayTrailMyrtlePark,09/04/2015 05:00:00 PM,48,-122,127,50,177
14682,ElliotBayTrailMyrtlePark,09/04/2015 06:00:00 PM,48,-122,88,33,121
14683,ElliotBayTrailMyrtlePark,09/04/2015 07:00:00 PM,48,-122,40,21,61
14684,ElliotBayTrailMyrtlePark,09/04/2015 08:00:00 PM,48,-122,5,12,17
14685,ElliotBayTrailMyrtlePark,09/04/2015 09:00:00 PM,48,-122,1,1,2
14686,ElliotBayTrailMyrtlePark,09/04/2015 10:00:00 PM,48,-122,2,0,2
14687,ElliotBayTrailMyrtlePark,09/04/2015 11:00:00 PM,48,-122,1,0,1
14688,ElliotBayTrailMyrtlePark,09/05/2015 12:00:00 AM,48,-122,14,3,17
14689,ElliotBayTrailMyrtlePark,09/05/2015 01:00:00 AM,48,-122,2,0,2
14690,ElliotBayTrailMyrtlePark,09/05/2015 02:00:00 AM,48,-122,2,1,3
14691,ElliotBayTrailMyrtlePark,09/05/2015 03:00:00 AM,48,-122,0,0,0
14692,ElliotBayTrailMyrtlePark,09/05/2015 04:00:00 AM,48,-122,0,0,0
14693,ElliotBayTrailMyrtlePark,09/05/2015 05:00:00 AM,48,-122,0,0,0
14694,ElliotBayTrailMyrtlePark,09/05/2015 06:00:00 AM,48,-122,2,9,11
14695,ElliotBayTrailMyrtlePark,09/05/2015 07:00:00 AM,48,-122,2,22,24
14696,ElliotBayTrailMyrtlePark,09/05/2015 08:00:00 AM,48,-122,14,18,32
14697,ElliotBayTrailMyrtlePark,09/05/2015 09:00:00 AM,48,-122,23,29,52
14698,ElliotBayTrailMyrtlePark,09/05/2015 10:00:00 AM,48,-122,48,35,83
14699,ElliotBayTrailMyrtlePark,09/05/2015 11:00:00 AM,48,-122,50,46,96
14700,ElliotBayTrailMyrtlePark,09/05/2015 12:00:00 PM,48,-122,38,59,97
14701,ElliotBayTrailMyrtlePark,09/05/2015 01:00:00 PM,48,-122,65,74,139
14702,ElliotBayTrailMyrtlePark,09/05/2015 02:00:00 PM,48,-122,64,62,126
14703,ElliotBayTrailMyrtlePark,09/05/2015 03:00:00 PM,48,-122,75,64,139
14704,ElliotBayTrailMyrtlePark,09/05/2015 04:00:00 PM,48,-122,50,32,82
14705,ElliotBayTrailMyrtlePark,09/05/2015 05:00:00 PM,48,-122,44,16,60
14706,ElliotBayTrailMyrtlePark,09/05/2015 06:00:00 PM,48,-122,13,11,24
14707,ElliotBayTrailMyrtlePark,09/05/2015 07:00:00 PM,48,-122,17,17,34
14708,ElliotBayTrailMyrtlePark,09/05/2015 08:00:00 PM,48,-122,16,5,21
14709,ElliotBayTrailMyrtlePark,09/05/2015 09:00:00 PM,48,-122,7,1,8
14710,ElliotBayTrailMyrtlePark,09/05/2015 10:00:00 PM,48,-122,2,1,3
14711,ElliotBayTrailMyrtlePark,09/05/2015 11:00:00 PM,48,-122,10,1,11
14712,ElliotBayTrailMyrtlePark,09/06/2015 12:00:00 AM,48,-122,3,2,5
14713,ElliotBayTrailMyrtlePark,09/06/2015 01:00:00 AM,48,-122,0,0,0
14714,ElliotBayTrailMyrtlePark,09/06/2015 02:00:00 AM,48,-122,2,0,2
14715,ElliotBayTrailMyrtlePark,09/06/2015 03:00:00 AM,48,-122,0,0,0
14716,ElliotBayTrailMyrtlePark,09/06/2015 04:00:00 AM,48,-122,0,1,1
14717,ElliotBayTrailMyrtlePark,09/06/2015 05:00:00 AM,48,-122,0,0,0
14718,ElliotBayTrailMyrtlePark,09/06/2015 06:00:00 AM,48,-122,0,1,1
14719,ElliotBayTrailMyrtlePark,09/06/2015 07:00:00 AM,48,-122,3,1,4
14720,ElliotBayTrailMyrtlePark,09/06/2015 08:00:00 AM,48,-122,6,2,8
14721,ElliotBayTrailMyrtlePark,09/06/2015 09:00:00 AM,48,-122,7,7,14
14722,ElliotBayTrailMyrtlePark,09/06/2015 10:00:00 AM,48,-122,8,9,17
14723,ElliotBayTrailMyrtlePark,09/06/2015 11:00:00 AM,48,-122,35,25,60
14724,ElliotBayTrailMyrtlePark,09/06/2015 12:00:00 PM,48,-122,23,17,40
14725,ElliotBayTrailMyrtlePark,09/06/2015 01:00:00 PM,48,-122,22,31,53
14726,ElliotBayTrailMyrtlePark,09/06/2015 02:00:00 PM,48,-122,34,15,49
14727,ElliotBayTrailMyrtlePark,09/06/2015 03:00:00 PM,48,-122,18,21,39
14728,ElliotBayTrailMyrtlePark,09/06/2015 04:00:00 PM,48,-122,19,26,45
14729,ElliotBayTrailMyrtlePark,09/06/2015 05:00:00 PM,48,-122,22,19,41
14730,ElliotBayTrailMyrtlePark,09/06/2015 06:00:00 PM,48,-122,20,21,41
14731,ElliotBayTrailMyrtlePark,09/06/2015 07:00:00 PM,48,-122,13,17,30
14732,ElliotBayTrailMyrtlePark,09/06/2015 08:00:00 PM,48,-122,4,2,6
14733,ElliotBayTrailMyrtlePark,09/06/2015 09:00:00 PM,48,-122,2,1,3
14734,ElliotBayTrailMyrtlePark,09/06/2015 10:00:00 PM,48,-122,0,0,0
14735,ElliotBayTrailMyrtlePark,09/06/2015 11:00:00 PM,48,-122,6,2,8
14736,ElliotBayTrailMyrtlePark,09/07/2015 12:00:00 AM,48,-122,0,3,3
14737,ElliotBayTrailMyrtlePark,09/07/2015 01:00:00 AM,48,-122,0,0,0
14738,ElliotBayTrailMyrtlePark,09/07/2015 02:00:00 AM,48,-122,0,0,0
14739,ElliotBayTrailMyrtlePark,09/07/2015 03:00:00 AM,48,-122,0,0,0
14740,ElliotBayTrailMyrtlePark,09/07/2015 04:00:00 AM,48,-122,0,0,0
14741,ElliotBayTrailMyrtlePark,09/07/2015 05:00:00 AM,48,-122,0,0,0
14742,ElliotBayTrailMyrtlePark,09/07/2015 06:00:00 AM,48,-122,0,2,2
14743,ElliotBayTrailMyrtlePark,09/07/2015 07:00:00 AM,48,-122,3,5,8
14744,ElliotBayTrailMyrtlePark,09/07/2015 08:00:00 AM,48,-122,14,14,28
14745,ElliotBayTrailMyrtlePark,09/07/2015 09:00:00 AM,48,-122,21,72,93
14746,ElliotBayTrailMyrtlePark,09/07/2015 10:00:00 AM,48,-122,37,43,80
14747,ElliotBayTrailMyrtlePark,09/07/2015 11:00:00 AM,48,-122,48,62,110
14748,ElliotBayTrailMyrtlePark,09/07/2015 12:00:00 PM,48,-122,65,63,128
14749,ElliotBayTrailMyrtlePark,09/07/2015 01:00:00 PM,48,-122,63,66,129
14750,ElliotBayTrailMyrtlePark,09/07/2015 02:00:00 PM,48,-122,90,66,156
14751,ElliotBayTrailMyrtlePark,09/07/2015 03:00:00 PM,48,-122,98,106,204
14752,ElliotBayTrailMyrtlePark,09/07/2015 04:00:00 PM,48,-122,84,84,168
14753,ElliotBayTrailMyrtlePark,09/07/2015 05:00:00 PM,48,-122,89,61,150
14754,ElliotBayTrailMyrtlePark,09/07/2015 06:00:00 PM,48,-122,68,51,119
14755,ElliotBayTrailMyrtlePark,09/07/2015 07:00:00 PM,48,-122,37,31,68
14756,ElliotBayTrailMyrtlePark,09/07/2015 08:00:00 PM,48,-122,20,19,39
14757,ElliotBayTrailMyrtlePark,09/07/2015 09:00:00 PM,48,-122,3,4,7
14758,ElliotBayTrailMyrtlePark,09/07/2015 10:00:00 PM,48,-122,5,1,6
14759,ElliotBayTrailMyrtlePark,09/07/2015 11:00:00 PM,48,-122,2,2,4
14760,ElliotBayTrailMyrtlePark,09/08/2015 12:00:00 AM,48,-122,0,0,0
14761,ElliotBayTrailMyrtlePark,09/08/2015 01:00:00 AM,48,-122,2,0,2
14762,ElliotBayTrailMyrtlePark,09/08/2015 02:00:00 AM,48,-122,0,0,0
14763,ElliotBayTrailMyrtlePark,09/08/2015 03:00:00 AM,48,-122,0,0,0
14764,ElliotBayTrailMyrtlePark,09/08/2015 04:00:00 AM,48,-122,0,0,0
14765,ElliotBayTrailMyrtlePark,09/08/2015 05:00:00 AM,48,-122,5,1,6
14766,ElliotBayTrailMyrtlePark,09/08/2015 06:00:00 AM,48,-122,18,21,39
14767,ElliotBayTrailMyrtlePark,09/08/2015 07:00:00 AM,48,-122,40,84,124
14768,ElliotBayTrailMyrtlePark,09/08/2015 08:00:00 AM,48,-122,53,151,204
14769,ElliotBayTrailMyrtlePark,09/08/2015 09:00:00 AM,48,-122,37,106,143
14770,ElliotBayTrailMyrtlePark,09/08/2015 10:00:00 AM,48,-122,17,25,42
14771,ElliotBayTrailMyrtlePark,09/08/2015 11:00:00 AM,48,-122,13,22,35
14772,ElliotBayTrailMyrtlePark,09/08/2015 12:00:00 PM,48,-122,19,25,44
14773,ElliotBayTrailMyrtlePark,09/08/2015 01:00:00 PM,48,-122,22,15,37
14774,ElliotBayTrailMyrtlePark,09/08/2015 02:00:00 PM,48,-122,23,24,47
14775,ElliotBayTrailMyrtlePark,09/08/2015 03:00:00 PM,48,-122,38,25,63
14776,ElliotBayTrailMyrtlePark,09/08/2015 04:00:00 PM,48,-122,71,40,111
14777,ElliotBayTrailMyrtlePark,09/08/2015 05:00:00 PM,48,-122,178,64,242
14778,ElliotBayTrailMyrtlePark,09/08/2015 06:00:00 PM,48,-122,160,59,219
14779,ElliotBayTrailMyrtlePark,09/08/2015 07:00:00 PM,48,-122,62,26,88
14780,ElliotBayTrailMyrtlePark,09/08/2015 08:00:00 PM,48,-122,20,26,46
14781,ElliotBayTrailMyrtlePark,09/08/2015 09:00:00 PM,48,-122,5,3,8
14782,ElliotBayTrailMyrtlePark,09/08/2015 10:00:00 PM,48,-122,5,1,6
14783,ElliotBayTrailMyrtlePark,09/08/2015 11:00:00 PM,48,-122,6,3,9
14784,ElliotBayTrailMyrtlePark,09/09/2015 12:00:00 AM,48,-122,3,0,3
14785,ElliotBayTrailMyrtlePark,09/09/2015 01:00:00 AM,48,-122,1,2,3
14786,ElliotBayTrailMyrtlePark,09/09/2015 02:00:00 AM,48,-122,1,3,4
14787,ElliotBayTrailMyrtlePark,09/09/2015 03:00:00 AM,48,-122,2,0,2
14788,ElliotBayTrailMyrtlePark,09/09/2015 04:00:00 AM,48,-122,0,1,1
14789,ElliotBayTrailMyrtlePark,09/09/2015 05:00:00 AM,48,-122,10,7,17
14790,ElliotBayTrailMyrtlePark,09/09/2015 06:00:00 AM,48,-122,20,27,47
14791,ElliotBayTrailMyrtlePark,09/09/2015 07:00:00 AM,48,-122,44,89,133
14792,ElliotBayTrailMyrtlePark,09/09/2015 08:00:00 AM,48,-122,48,189,237
14793,ElliotBayTrailMyrtlePark,09/09/2015 09:00:00 AM,48,-122,41,119,160
14794,ElliotBayTrailMyrtlePark,09/09/2015 10:00:00 AM,48,-122,20,36,56
14795,ElliotBayTrailMyrtlePark,09/09/2015 11:00:00 AM,48,-122,19,19,38
14796,ElliotBayTrailMyrtlePark,09/09/2015 12:00:00 PM,48,-122,18,21,39
14797,ElliotBayTrailMyrtlePark,09/09/2015 01:00:00 PM,48,-122,25,42,67
14798,ElliotBayTrailMyrtlePark,09/09/2015 02:00:00 PM,48,-122,35,33,68
14799,ElliotBayTrailMyrtlePark,09/09/2015 03:00:00 PM,48,-122,44,41,85
14800,ElliotBayTrailMyrtlePark,09/09/2015 04:00:00 PM,48,-122,92,54,146
14801,ElliotBayTrailMyrtlePark,09/09/2015 05:00:00 PM,48,-122,240,77,317
14802,ElliotBayTrailMyrtlePark,09/09/2015 06:00:00 PM,48,-122,188,72,260
14803,ElliotBayTrailMyrtlePark,09/09/2015 07:00:00 PM,48,-122,85,48,133
14804,ElliotBayTrailMyrtlePark,09/09/2015 08:00:00 PM,48,-122,35,26,61
14805,ElliotBayTrailMyrtlePark,09/09/2015 09:00:00 PM,48,-122,9,11,20
14806,ElliotBayTrailMyrtlePark,09/09/2015 10:00:00 PM,48,-122,15,4,19
14807,ElliotBayTrailMyrtlePark,09/09/2015 11:00:00 PM,48,-122,6,0,6
14808,ElliotBayTrailMyrtlePark,09/10/2015 12:00:00 AM,48,-122,1,4,5
14809,ElliotBayTrailMyrtlePark,09/10/2015 01:00:00 AM,48,-122,3,2,5
14810,ElliotBayTrailMyrtlePark,09/10/2015 02:00:00 AM,48,-122,2,0,2
14811,ElliotBayTrailMyrtlePark,09/10/2015 03:00:00 AM,48,-122,0,0,0
14812,ElliotBayTrailMyrtlePark,09/10/2015 04:00:00 AM,48,-122,0,1,1
14813,ElliotBayTrailMyrtlePark,09/10/2015 05:00:00 AM,48,-122,6,11,17
14814,ElliotBayTrailMyrtlePark,09/10/2015 06:00:00 AM,48,-122,14,25,39
14815,ElliotBayTrailMyrtlePark,09/10/2015 07:00:00 AM,48,-122,39,90,129
14816,ElliotBayTrailMyrtlePark,09/10/2015 08:00:00 AM,48,-122,55,180,235
14817,ElliotBayTrailMyrtlePark,09/10/2015 09:00:00 AM,48,-122,30,110,140
14818,ElliotBayTrailMyrtlePark,09/10/2015 10:00:00 AM,48,-122,30,30,60
14819,ElliotBayTrailMyrtlePark,09/10/2015 11:00:00 AM,48,-122,20,22,42
14820,ElliotBayTrailMyrtlePark,09/10/2015 12:00:00 PM,48,-122,32,43,75
14821,ElliotBayTrailMyrtlePark,09/10/2015 01:00:00 PM,48,-122,20,35,55
14822,ElliotBayTrailMyrtlePark,09/10/2015 02:00:00 PM,48,-122,38,29,67
14823,ElliotBayTrailMyrtlePark,09/10/2015 03:00:00 PM,48,-122,42,30,72
14824,ElliotBayTrailMyrtlePark,09/10/2015 04:00:00 PM,48,-122,79,60,139
14825,ElliotBayTrailMyrtlePark,09/10/2015 05:00:00 PM,48,-122,199,51,250
14826,ElliotBayTrailMyrtlePark,09/10/2015 06:00:00 PM,48,-122,162,67,229
14827,ElliotBayTrailMyrtlePark,09/10/2015 07:00:00 PM,48,-122,89,35,124
14828,ElliotBayTrailMyrtlePark,09/10/2015 08:00:00 PM,48,-122,26,23,49
14829,ElliotBayTrailMyrtlePark,09/10/2015 09:00:00 PM,48,-122,16,12,28
14830,ElliotBayTrailMyrtlePark,09/10/2015 10:00:00 PM,48,-122,6,9,15
14831,ElliotBayTrailMyrtlePark,09/10/2015 11:00:00 PM,48,-122,7,1,8
14832,ElliotBayTrailMyrtlePark,09/11/2015 12:00:00 AM,48,-122,2,0,2
14833,ElliotBayTrailMyrtlePark,09/11/2015 01:00:00 AM,48,-122,2,0,2
14834,ElliotBayTrailMyrtlePark,09/11/2015 02:00:00 AM,48,-122,1,0,1
14835,ElliotBayTrailMyrtlePark,09/11/2015 03:00:00 AM,48,-122,1,1,2
14836,ElliotBayTrailMyrtlePark,09/11/2015 04:00:00 AM,48,-122,2,0,2
14837,ElliotBayTrailMyrtlePark,09/11/2015 05:00:00 AM,48,-122,5,11,16
14838,ElliotBayTrailMyrtlePark,09/11/2015 06:00:00 AM,48,-122,23,15,38
14839,ElliotBayTrailMyrtlePark,09/11/2015 07:00:00 AM,48,-122,30,69,99
14840,ElliotBayTrailMyrtlePark,09/11/2015 08:00:00 AM,48,-122,48,167,215
14841,ElliotBayTrailMyrtlePark,09/11/2015 09:00:00 AM,48,-122,39,98,137
14842,ElliotBayTrailMyrtlePark,09/11/2015 10:00:00 AM,48,-122,20,34,54
14843,ElliotBayTrailMyrtlePark,09/11/2015 11:00:00 AM,48,-122,40,26,66
14844,ElliotBayTrailMyrtlePark,09/11/2015 12:00:00 PM,48,-122,25,19,44
14845,ElliotBayTrailMyrtlePark,09/11/2015 01:00:00 PM,48,-122,38,26,64
14846,ElliotBayTrailMyrtlePark,09/11/2015 02:00:00 PM,48,-122,41,25,66
14847,ElliotBayTrailMyrtlePark,09/11/2015 03:00:00 PM,48,-122,51,56,107
14848,ElliotBayTrailMyrtlePark,09/11/2015 04:00:00 PM,48,-122,94,58,152
14849,ElliotBayTrailMyrtlePark,09/11/2015 05:00:00 PM,48,-122,174,58,232
14850,ElliotBayTrailMyrtlePark,09/11/2015 06:00:00 PM,48,-122,120,61,181
14851,ElliotBayTrailMyrtlePark,09/11/2015 07:00:00 PM,48,-122,56,37,93
14852,ElliotBayTrailMyrtlePark,09/11/2015 08:00:00 PM,48,-122,25,22,47
14853,ElliotBayTrailMyrtlePark,09/11/2015 09:00:00 PM,48,-122,13,6,19
14854,ElliotBayTrailMyrtlePark,09/11/2015 10:00:00 PM,48,-122,9,7,16
14855,ElliotBayTrailMyrtlePark,09/11/2015 11:00:00 PM,48,-122,10,1,11
14856,ElliotBayTrailMyrtlePark,09/12/2015 12:00:00 AM,48,-122,3,0,3
14857,ElliotBayTrailMyrtlePark,09/12/2015 01:00:00 AM,48,-122,4,3,7
14858,ElliotBayTrailMyrtlePark,09/12/2015 02:00:00 AM,48,-122,1,0,1
14859,ElliotBayTrailMyrtlePark,09/12/2015 03:00:00 AM,48,-122,2,0,2
14860,ElliotBayTrailMyrtlePark,09/12/2015 04:00:00 AM,48,-122,2,0,2
14861,ElliotBayTrailMyrtlePark,09/12/2015 05:00:00 AM,48,-122,0,0,0
14862,ElliotBayTrailMyrtlePark,09/12/2015 06:00:00 AM,48,-122,2,2,4
14863,ElliotBayTrailMyrtlePark,09/12/2015 07:00:00 AM,48,-122,4,11,15
14864,ElliotBayTrailMyrtlePark,09/12/2015 08:00:00 AM,48,-122,26,19,45
14865,ElliotBayTrailMyrtlePark,09/12/2015 09:00:00 AM,48,-122,28,28,56
14866,ElliotBayTrailMyrtlePark,09/12/2015 10:00:00 AM,48,-122,35,32,67
14867,ElliotBayTrailMyrtlePark,09/12/2015 11:00:00 AM,48,-122,67,50,117
14868,ElliotBayTrailMyrtlePark,09/12/2015 12:00:00 PM,48,-122,55,55,110
14869,ElliotBayTrailMyrtlePark,09/12/2015 01:00:00 PM,48,-122,70,73,143
14870,ElliotBayTrailMyrtlePark,09/12/2015 02:00:00 PM,48,-122,71,73,144
14871,ElliotBayTrailMyrtlePark,09/12/2015 03:00:00 PM,48,-122,67,64,131
14872,ElliotBayTrailMyrtlePark,09/12/2015 04:00:00 PM,48,-122,71,69,140
14873,ElliotBayTrailMyrtlePark,09/12/2015 05:00:00 PM,48,-122,74,57,131
14874,ElliotBayTrailMyrtlePark,09/12/2015 06:00:00 PM,48,-122,53,44,97
14875,ElliotBayTrailMyrtlePark,09/12/2015 07:00:00 PM,48,-122,47,36,83
14876,ElliotBayTrailMyrtlePark,09/12/2015 08:00:00 PM,48,-122,19,22,41
14877,ElliotBayTrailMyrtlePark,09/12/2015 09:00:00 PM,48,-122,5,1,6
14878,ElliotBayTrailMyrtlePark,09/12/2015 10:00:00 PM,48,-122,10,3,13
14879,ElliotBayTrailMyrtlePark,09/12/2015 11:00:00 PM,48,-122,4,0,4
14880,ElliotBayTrailMyrtlePark,09/13/2015 12:00:00 AM,48,-122,3,1,4
14881,ElliotBayTrailMyrtlePark,09/13/2015 01:00:00 AM,48,-122,3,0,3
14882,ElliotBayTrailMyrtlePark,09/13/2015 02:00:00 AM,48,-122,0,1,1
14883,ElliotBayTrailMyrtlePark,09/13/2015 03:00:00 AM,48,-122,2,0,2
14884,ElliotBayTrailMyrtlePark,09/13/2015 04:00:00 AM,48,-122,0,0,0
14885,ElliotBayTrailMyrtlePark,09/13/2015 05:00:00 AM,48,-122,0,0,0
14886,ElliotBayTrailMyrtlePark,09/13/2015 06:00:00 AM,48,-122,4,1,5
14887,ElliotBayTrailMyrtlePark,09/13/2015 07:00:00 AM,48,-122,7,12,19
14888,ElliotBayTrailMyrtlePark,09/13/2015 08:00:00 AM,48,-122,35,27,62
14889,ElliotBayTrailMyrtlePark,09/13/2015 09:00:00 AM,48,-122,105,31,136
14890,ElliotBayTrailMyrtlePark,09/13/2015 10:00:00 AM,48,-122,28,29,57
14891,ElliotBayTrailMyrtlePark,09/13/2015 11:00:00 AM,48,-122,23,7,30
14892,ElliotBayTrailMyrtlePark,09/13/2015 12:00:00 PM,48,-122,20,27,47
14893,ElliotBayTrailMyrtlePark,09/13/2015 01:00:00 PM,48,-122,18,32,50
14894,ElliotBayTrailMyrtlePark,09/13/2015 02:00:00 PM,48,-122,20,48,68
14895,ElliotBayTrailMyrtlePark,09/13/2015 03:00:00 PM,48,-122,32,30,62
14896,ElliotBayTrailMyrtlePark,09/13/2015 04:00:00 PM,48,-122,38,43,81
14897,ElliotBayTrailMyrtlePark,09/13/2015 05:00:00 PM,48,-122,30,33,63
14898,ElliotBayTrailMyrtlePark,09/13/2015 06:00:00 PM,48,-122,19,10,29
14899,ElliotBayTrailMyrtlePark,09/13/2015 07:00:00 PM,48,-122,18,15,33
14900,ElliotBayTrailMyrtlePark,09/13/2015 08:00:00 PM,48,-122,6,8,14
14901,ElliotBayTrailMyrtlePark,09/13/2015 09:00:00 PM,48,-122,1,2,3
14902,ElliotBayTrailMyrtlePark,09/13/2015 10:00:00 PM,48,-122,2,0,2
14903,ElliotBayTrailMyrtlePark,09/13/2015 11:00:00 PM,48,-122,3,0,3
14904,ElliotBayTrailMyrtlePark,09/14/2015 12:00:00 AM,48,-122,1,2,3
14905,ElliotBayTrailMyrtlePark,09/14/2015 01:00:00 AM,48,-122,0,0,0
14906,ElliotBayTrailMyrtlePark,09/14/2015 02:00:00 AM,48,-122,1,0,1
14907,ElliotBayTrailMyrtlePark,09/14/2015 03:00:00 AM,48,-122,0,0,0
14908,ElliotBayTrailMyrtlePark,09/14/2015 04:00:00 AM,48,-122,0,0,0
14909,ElliotBayTrailMyrtlePark,09/14/2015 05:00:00 AM,48,-122,3,7,10
14910,ElliotBayTrailMyrtlePark,09/14/2015 06:00:00 AM,48,-122,13,20,33
14911,ElliotBayTrailMyrtlePark,09/14/2015 07:00:00 AM,48,-122,25,70,95
14912,ElliotBayTrailMyrtlePark,09/14/2015 08:00:00 AM,48,-122,42,145,187
14913,ElliotBayTrailMyrtlePark,09/14/2015 09:00:00 AM,48,-122,32,115,147
14914,ElliotBayTrailMyrtlePark,09/14/2015 10:00:00 AM,48,-122,17,33,50
14915,ElliotBayTrailMyrtlePark,09/14/2015 11:00:00 AM,48,-122,19,30,49
14916,ElliotBayTrailMyrtlePark,09/14/2015 12:00:00 PM,48,-122,14,26,40
14917,ElliotBayTrailMyrtlePark,09/14/2015 01:00:00 PM,48,-122,27,16,43
14918,ElliotBayTrailMyrtlePark,09/14/2015 02:00:00 PM,48,-122,10,15,25
14919,ElliotBayTrailMyrtlePark,09/14/2015 03:00:00 PM,48,-122,16,24,40
14920,ElliotBayTrailMyrtlePark,09/14/2015 04:00:00 PM,48,-122,67,39,106
14921,ElliotBayTrailMyrtlePark,09/14/2015 05:00:00 PM,48,-122,179,57,236
14922,ElliotBayTrailMyrtlePark,09/14/2015 06:00:00 PM,48,-122,149,35,184
14923,ElliotBayTrailMyrtlePark,09/14/2015 07:00:00 PM,48,-122,48,28,76
14924,ElliotBayTrailMyrtlePark,09/14/2015 08:00:00 PM,48,-122,24,5,29
14925,ElliotBayTrailMyrtlePark,09/14/2015 09:00:00 PM,48,-122,4,1,5
14926,ElliotBayTrailMyrtlePark,09/14/2015 10:00:00 PM,48,-122,4,1,5
14927,ElliotBayTrailMyrtlePark,09/14/2015 11:00:00 PM,48,-122,3,1,4
14928,ElliotBayTrailMyrtlePark,09/15/2015 12:00:00 AM,48,-122,3,0,3
14929,ElliotBayTrailMyrtlePark,09/15/2015 01:00:00 AM,48,-122,0,0,0
14930,ElliotBayTrailMyrtlePark,09/15/2015 02:00:00 AM,48,-122,2,0,2
14931,ElliotBayTrailMyrtlePark,09/15/2015 03:00:00 AM,48,-122,0,0,0
14932,ElliotBayTrailMyrtlePark,09/15/2015 04:00:00 AM,48,-122,0,0,0
14933,ElliotBayTrailMyrtlePark,09/15/2015 05:00:00 AM,48,-122,8,4,12
14934,ElliotBayTrailMyrtlePark,09/15/2015 06:00:00 AM,48,-122,21,27,48
14935,ElliotBayTrailMyrtlePark,09/15/2015 07:00:00 AM,48,-122,33,64,97
14936,ElliotBayTrailMyrtlePark,09/15/2015 08:00:00 AM,48,-122,51,162,213
14937,ElliotBayTrailMyrtlePark,09/15/2015 09:00:00 AM,48,-122,38,89,127
14938,ElliotBayTrailMyrtlePark,09/15/2015 10:00:00 AM,48,-122,20,37,57
14939,ElliotBayTrailMyrtlePark,09/15/2015 11:00:00 AM,48,-122,15,14,29
14940,ElliotBayTrailMyrtlePark,09/15/2015 12:00:00 PM,48,-122,18,14,32
14941,ElliotBayTrailMyrtlePark,09/15/2015 01:00:00 PM,48,-122,21,23,44
14942,ElliotBayTrailMyrtlePark,09/15/2015 02:00:00 PM,48,-122,20,17,37
14943,ElliotBayTrailMyrtlePark,09/15/2015 03:00:00 PM,48,-122,34,22,56
14944,ElliotBayTrailMyrtlePark,09/15/2015 04:00:00 PM,48,-122,56,49,105
14945,ElliotBayTrailMyrtlePark,09/15/2015 05:00:00 PM,48,-122,172,59,231
14946,ElliotBayTrailMyrtlePark,09/15/2015 06:00:00 PM,48,-122,148,42,190
14947,ElliotBayTrailMyrtlePark,09/15/2015 07:00:00 PM,48,-122,42,32,74
14948,ElliotBayTrailMyrtlePark,09/15/2015 08:00:00 PM,48,-122,23,7,30
14949,ElliotBayTrailMyrtlePark,09/15/2015 09:00:00 PM,48,-122,6,6,12
14950,ElliotBayTrailMyrtlePark,09/15/2015 10:00:00 PM,48,-122,11,0,11
14951,ElliotBayTrailMyrtlePark,09/15/2015 11:00:00 PM,48,-122,6,1,7
14952,ElliotBayTrailMyrtlePark,09/16/2015 12:00:00 AM,48,-122,1,0,1
14953,ElliotBayTrailMyrtlePark,09/16/2015 01:00:00 AM,48,-122,1,0,1
14954,ElliotBayTrailMyrtlePark,09/16/2015 02:00:00 AM,48,-122,0,0,0
14955,ElliotBayTrailMyrtlePark,09/16/2015 03:00:00 AM,48,-122,1,0,1
14956,ElliotBayTrailMyrtlePark,09/16/2015 04:00:00 AM,48,-122,0,0,0
14957,ElliotBayTrailMyrtlePark,09/16/2015 05:00:00 AM,48,-122,2,6,8
14958,ElliotBayTrailMyrtlePark,09/16/2015 06:00:00 AM,48,-122,21,17,38
14959,ElliotBayTrailMyrtlePark,09/16/2015 07:00:00 AM,48,-122,38,72,110
14960,ElliotBayTrailMyrtlePark,09/16/2015 08:00:00 AM,48,-122,36,149,185
14961,ElliotBayTrailMyrtlePark,09/16/2015 09:00:00 AM,48,-122,36,110,146
14962,ElliotBayTrailMyrtlePark,09/16/2015 10:00:00 AM,48,-122,18,31,49
14963,ElliotBayTrailMyrtlePark,09/16/2015 11:00:00 AM,48,-122,26,14,40
14964,ElliotBayTrailMyrtlePark,09/16/2015 12:00:00 PM,48,-122,35,35,70
14965,ElliotBayTrailMyrtlePark,09/16/2015 01:00:00 PM,48,-122,27,28,55
14966,ElliotBayTrailMyrtlePark,09/16/2015 02:00:00 PM,48,-122,17,33,50
14967,ElliotBayTrailMyrtlePark,09/16/2015 03:00:00 PM,48,-122,38,25,63
14968,ElliotBayTrailMyrtlePark,09/16/2015 04:00:00 PM,48,-122,103,49,152
14969,ElliotBayTrailMyrtlePark,09/16/2015 05:00:00 PM,48,-122,150,67,217
14970,ElliotBayTrailMyrtlePark,09/16/2015 06:00:00 PM,48,-122,143,37,180
14971,ElliotBayTrailMyrtlePark,09/16/2015 07:00:00 PM,48,-122,50,32,82
14972,ElliotBayTrailMyrtlePark,09/16/2015 08:00:00 PM,48,-122,18,18,36
14973,ElliotBayTrailMyrtlePark,09/16/2015 09:00:00 PM,48,-122,8,2,10
14974,ElliotBayTrailMyrtlePark,09/16/2015 10:00:00 PM,48,-122,4,1,5
14975,ElliotBayTrailMyrtlePark,09/16/2015 11:00:00 PM,48,-122,4,0,4
14976,ElliotBayTrailMyrtlePark,09/17/2015 12:00:00 AM,48,-122,2,0,2
14977,ElliotBayTrailMyrtlePark,09/17/2015 01:00:00 AM,48,-122,1,0,1
14978,ElliotBayTrailMyrtlePark,09/17/2015 02:00:00 AM,48,-122,0,0,0
14979,ElliotBayTrailMyrtlePark,09/17/2015 03:00:00 AM,48,-122,0,0,0
14980,ElliotBayTrailMyrtlePark,09/17/2015 04:00:00 AM,48,-122,1,0,1
14981,ElliotBayTrailMyrtlePark,09/17/2015 05:00:00 AM,48,-122,7,3,10
14982,ElliotBayTrailMyrtlePark,09/17/2015 06:00:00 AM,48,-122,14,25,39
14983,ElliotBayTrailMyrtlePark,09/17/2015 07:00:00 AM,48,-122,20,44,64
14984,ElliotBayTrailMyrtlePark,09/17/2015 08:00:00 AM,48,-122,37,108,145
14985,ElliotBayTrailMyrtlePark,09/17/2015 09:00:00 AM,48,-122,27,67,94
14986,ElliotBayTrailMyrtlePark,09/17/2015 10:00:00 AM,48,-122,15,27,42
14987,ElliotBayTrailMyrtlePark,09/17/2015 11:00:00 AM,48,-122,11,14,25
14988,ElliotBayTrailMyrtlePark,09/17/2015 12:00:00 PM,48,-122,5,5,10
14989,ElliotBayTrailMyrtlePark,09/17/2015 01:00:00 PM,48,-122,6,7,13
14990,ElliotBayTrailMyrtlePark,09/17/2015 02:00:00 PM,48,-122,9,13,22
14991,ElliotBayTrailMyrtlePark,09/17/2015 03:00:00 PM,48,-122,16,8,24
14992,ElliotBayTrailMyrtlePark,09/17/2015 04:00:00 PM,48,-122,33,15,48
14993,ElliotBayTrailMyrtlePark,09/17/2015 05:00:00 PM,48,-122,100,21,121
14994,ElliotBayTrailMyrtlePark,09/17/2015 06:00:00 PM,48,-122,80,17,97
14995,ElliotBayTrailMyrtlePark,09/17/2015 07:00:00 PM,48,-122,32,10,42
14996,ElliotBayTrailMyrtlePark,09/17/2015 08:00:00 PM,48,-122,13,5,18
14997,ElliotBayTrailMyrtlePark,09/17/2015 09:00:00 PM,48,-122,10,1,11
14998,ElliotBayTrailMyrtlePark,09/17/2015 10:00:00 PM,48,-122,6,1,7
14999,ElliotBayTrailMyrtlePark,09/17/2015 11:00:00 PM,48,-122,5,1,6
15000,ElliotBayTrailMyrtlePark,09/18/2015 12:00:00 AM,48,-122,11,1,12
15001,ElliotBayTrailMyrtlePark,09/18/2015 01:00:00 AM,48,-122,3,0,3
15002,ElliotBayTrailMyrtlePark,09/18/2015 02:00:00 AM,48,-122,0,0,0
15003,ElliotBayTrailMyrtlePark,09/18/2015 03:00:00 AM,48,-122,1,0,1
15004,ElliotBayTrailMyrtlePark,09/18/2015 04:00:00 AM,48,-122,0,0,0
15005,ElliotBayTrailMyrtlePark,09/18/2015 05:00:00 AM,48,-122,5,7,12
15006,ElliotBayTrailMyrtlePark,09/18/2015 06:00:00 AM,48,-122,14,20,34
15007,ElliotBayTrailMyrtlePark,09/18/2015 07:00:00 AM,48,-122,22,46,68
15008,ElliotBayTrailMyrtlePark,09/18/2015 08:00:00 AM,48,-122,34,131,165
15009,ElliotBayTrailMyrtlePark,09/18/2015 09:00:00 AM,48,-122,21,72,93
15010,ElliotBayTrailMyrtlePark,09/18/2015 10:00:00 AM,48,-122,10,32,42
15011,ElliotBayTrailMyrtlePark,09/18/2015 11:00:00 AM,48,-122,18,21,39
15012,ElliotBayTrailMyrtlePark,09/18/2015 12:00:00 PM,48,-122,20,20,40
15013,ElliotBayTrailMyrtlePark,09/18/2015 01:00:00 PM,48,-122,37,25,62
15014,ElliotBayTrailMyrtlePark,09/18/2015 02:00:00 PM,48,-122,21,25,46
15015,ElliotBayTrailMyrtlePark,09/18/2015 03:00:00 PM,48,-122,47,28,75
15016,ElliotBayTrailMyrtlePark,09/18/2015 04:00:00 PM,48,-122,74,38,112
15017,ElliotBayTrailMyrtlePark,09/18/2015 05:00:00 PM,48,-122,130,49,179
15018,ElliotBayTrailMyrtlePark,09/18/2015 06:00:00 PM,48,-122,93,32,125
15019,ElliotBayTrailMyrtlePark,09/18/2015 07:00:00 PM,48,-122,44,15,59
15020,ElliotBayTrailMyrtlePark,09/18/2015 08:00:00 PM,48,-122,11,9,20
15021,ElliotBayTrailMyrtlePark,09/18/2015 09:00:00 PM,48,-122,5,2,7
15022,ElliotBayTrailMyrtlePark,09/18/2015 10:00:00 PM,48,-122,6,1,7
15023,ElliotBayTrailMyrtlePark,09/18/2015 11:00:00 PM,48,-122,5,2,7
15024,ElliotBayTrailMyrtlePark,09/19/2015 12:00:00 AM,48,-122,8,1,9
15025,ElliotBayTrailMyrtlePark,09/19/2015 01:00:00 AM,48,-122,0,0,0
15026,ElliotBayTrailMyrtlePark,09/19/2015 02:00:00 AM,48,-122,3,0,3
15027,ElliotBayTrailMyrtlePark,09/19/2015 03:00:00 AM,48,-122,4,4,8
15028,ElliotBayTrailMyrtlePark,09/19/2015 04:00:00 AM,48,-122,1,0,1
15029,ElliotBayTrailMyrtlePark,09/19/2015 05:00:00 AM,48,-122,0,0,0
15030,ElliotBayTrailMyrtlePark,09/19/2015 06:00:00 AM,48,-122,2,10,12
15031,ElliotBayTrailMyrtlePark,09/19/2015 07:00:00 AM,48,-122,4,7,11
15032,ElliotBayTrailMyrtlePark,09/19/2015 08:00:00 AM,48,-122,20,20,40
15033,ElliotBayTrailMyrtlePark,09/19/2015 09:00:00 AM,48,-122,32,20,52
15034,ElliotBayTrailMyrtlePark,09/19/2015 10:00:00 AM,48,-122,31,39,70
15035,ElliotBayTrailMyrtlePark,09/19/2015 11:00:00 AM,48,-122,37,35,72
15036,ElliotBayTrailMyrtlePark,09/19/2015 12:00:00 PM,48,-122,28,44,72
15037,ElliotBayTrailMyrtlePark,09/19/2015 01:00:00 PM,48,-122,46,25,71
15038,ElliotBayTrailMyrtlePark,09/19/2015 02:00:00 PM,48,-122,40,33,73
15039,ElliotBayTrailMyrtlePark,09/19/2015 03:00:00 PM,48,-122,53,43,96
15040,ElliotBayTrailMyrtlePark,09/19/2015 04:00:00 PM,48,-122,42,51,93
15041,ElliotBayTrailMyrtlePark,09/19/2015 05:00:00 PM,48,-122,48,51,99
15042,ElliotBayTrailMyrtlePark,09/19/2015 06:00:00 PM,48,-122,28,33,61
15043,ElliotBayTrailMyrtlePark,09/19/2015 07:00:00 PM,48,-122,20,25,45
15044,ElliotBayTrailMyrtlePark,09/19/2015 08:00:00 PM,48,-122,14,11,25
15045,ElliotBayTrailMyrtlePark,09/19/2015 09:00:00 PM,48,-122,4,5,9
15046,ElliotBayTrailMyrtlePark,09/19/2015 10:00:00 PM,48,-122,4,0,4
15047,ElliotBayTrailMyrtlePark,09/19/2015 11:00:00 PM,48,-122,0,4,4
15048,ElliotBayTrailMyrtlePark,09/20/2015 12:00:00 AM,48,-122,1,6,7
15049,ElliotBayTrailMyrtlePark,09/20/2015 01:00:00 AM,48,-122,0,2,2
15050,ElliotBayTrailMyrtlePark,09/20/2015 02:00:00 AM,48,-122,0,2,2
15051,ElliotBayTrailMyrtlePark,09/20/2015 03:00:00 AM,48,-122,1,0,1
15052,ElliotBayTrailMyrtlePark,09/20/2015 04:00:00 AM,48,-122,0,0,0
15053,ElliotBayTrailMyrtlePark,09/20/2015 05:00:00 AM,48,-122,0,0,0
15054,ElliotBayTrailMyrtlePark,09/20/2015 06:00:00 AM,48,-122,1,2,3
15055,ElliotBayTrailMyrtlePark,09/20/2015 07:00:00 AM,48,-122,1,5,6
15056,ElliotBayTrailMyrtlePark,09/20/2015 08:00:00 AM,48,-122,15,9,24
15057,ElliotBayTrailMyrtlePark,09/20/2015 09:00:00 AM,48,-122,33,22,55
15058,ElliotBayTrailMyrtlePark,09/20/2015 10:00:00 AM,48,-122,25,25,50
15059,ElliotBayTrailMyrtlePark,09/20/2015 11:00:00 AM,48,-122,32,20,52
15060,ElliotBayTrailMyrtlePark,09/20/2015 12:00:00 PM,48,-122,42,26,68
15061,ElliotBayTrailMyrtlePark,09/20/2015 01:00:00 PM,48,-122,31,35,66
15062,ElliotBayTrailMyrtlePark,09/20/2015 02:00:00 PM,48,-122,26,43,69
15063,ElliotBayTrailMyrtlePark,09/20/2015 03:00:00 PM,48,-122,47,53,100
15064,ElliotBayTrailMyrtlePark,09/20/2015 04:00:00 PM,48,-122,29,37,66
15065,ElliotBayTrailMyrtlePark,09/20/2015 05:00:00 PM,48,-122,21,24,45
15066,ElliotBayTrailMyrtlePark,09/20/2015 06:00:00 PM,48,-122,19,12,31
15067,ElliotBayTrailMyrtlePark,09/20/2015 07:00:00 PM,48,-122,17,16,33
15068,ElliotBayTrailMyrtlePark,09/20/2015 08:00:00 PM,48,-122,10,4,14
15069,ElliotBayTrailMyrtlePark,09/20/2015 09:00:00 PM,48,-122,3,0,3
15070,ElliotBayTrailMyrtlePark,09/20/2015 10:00:00 PM,48,-122,2,0,2
15071,ElliotBayTrailMyrtlePark,09/20/2015 11:00:00 PM,48,-122,0,1,1
15072,ElliotBayTrailMyrtlePark,09/21/2015 12:00:00 AM,48,-122,1,0,1
15073,ElliotBayTrailMyrtlePark,09/21/2015 01:00:00 AM,48,-122,0,0,0
15074,ElliotBayTrailMyrtlePark,09/21/2015 02:00:00 AM,48,-122,0,0,0
15075,ElliotBayTrailMyrtlePark,09/21/2015 03:00:00 AM,48,-122,1,0,1
15076,ElliotBayTrailMyrtlePark,09/21/2015 04:00:00 AM,48,-122,0,0,0
15077,ElliotBayTrailMyrtlePark,09/21/2015 05:00:00 AM,48,-122,5,5,10
15078,ElliotBayTrailMyrtlePark,09/21/2015 06:00:00 AM,48,-122,16,21,37
15079,ElliotBayTrailMyrtlePark,09/21/2015 07:00:00 AM,48,-122,32,66,98
15080,ElliotBayTrailMyrtlePark,09/21/2015 08:00:00 AM,48,-122,54,204,258
15081,ElliotBayTrailMyrtlePark,09/21/2015 09:00:00 AM,48,-122,40,106,146
15082,ElliotBayTrailMyrtlePark,09/21/2015 10:00:00 AM,48,-122,19,38,57
15083,ElliotBayTrailMyrtlePark,09/21/2015 11:00:00 AM,48,-122,22,27,49
15084,ElliotBayTrailMyrtlePark,09/21/2015 12:00:00 PM,48,-122,31,30,61
15085,ElliotBayTrailMyrtlePark,09/21/2015 01:00:00 PM,48,-122,17,17,34
15086,ElliotBayTrailMyrtlePark,09/21/2015 02:00:00 PM,48,-122,24,28,52
15087,ElliotBayTrailMyrtlePark,09/21/2015 03:00:00 PM,48,-122,34,35,69
15088,ElliotBayTrailMyrtlePark,09/21/2015 04:00:00 PM,48,-122,99,49,148
15089,ElliotBayTrailMyrtlePark,09/21/2015 05:00:00 PM,48,-122,192,75,267
15090,ElliotBayTrailMyrtlePark,09/21/2015 06:00:00 PM,48,-122,168,49,217
15091,ElliotBayTrailMyrtlePark,09/21/2015 07:00:00 PM,48,-122,80,45,125
15092,ElliotBayTrailMyrtlePark,09/21/2015 08:00:00 PM,48,-122,25,11,36
15093,ElliotBayTrailMyrtlePark,09/21/2015 09:00:00 PM,48,-122,4,2,6
15094,ElliotBayTrailMyrtlePark,09/21/2015 10:00:00 PM,48,-122,6,1,7
15095,ElliotBayTrailMyrtlePark,09/21/2015 11:00:00 PM,48,-122,1,1,2
15096,ElliotBayTrailMyrtlePark,09/22/2015 12:00:00 AM,48,-122,3,0,3
15097,ElliotBayTrailMyrtlePark,09/22/2015 01:00:00 AM,48,-122,2,1,3
15098,ElliotBayTrailMyrtlePark,09/22/2015 02:00:00 AM,48,-122,0,0,0
15099,ElliotBayTrailMyrtlePark,09/22/2015 03:00:00 AM,48,-122,2,0,2
15100,ElliotBayTrailMyrtlePark,09/22/2015 04:00:00 AM,48,-122,0,1,1
15101,ElliotBayTrailMyrtlePark,09/22/2015 05:00:00 AM,48,-122,6,3,9
15102,ElliotBayTrailMyrtlePark,09/22/2015 06:00:00 AM,48,-122,24,28,52
15103,ElliotBayTrailMyrtlePark,09/22/2015 07:00:00 AM,48,-122,39,109,148
15104,ElliotBayTrailMyrtlePark,09/22/2015 08:00:00 AM,48,-122,55,237,292
15105,ElliotBayTrailMyrtlePark,09/22/2015 09:00:00 AM,48,-122,41,145,186
15106,ElliotBayTrailMyrtlePark,09/22/2015 10:00:00 AM,48,-122,17,42,59
15107,ElliotBayTrailMyrtlePark,09/22/2015 11:00:00 AM,48,-122,20,25,45
15108,ElliotBayTrailMyrtlePark,09/22/2015 12:00:00 PM,48,-122,12,27,39
15109,ElliotBayTrailMyrtlePark,09/22/2015 01:00:00 PM,48,-122,25,25,50
15110,ElliotBayTrailMyrtlePark,09/22/2015 02:00:00 PM,48,-122,26,27,53
15111,ElliotBayTrailMyrtlePark,09/22/2015 03:00:00 PM,48,-122,52,35,87
15112,ElliotBayTrailMyrtlePark,09/22/2015 04:00:00 PM,48,-122,108,60,168
15113,ElliotBayTrailMyrtlePark,09/22/2015 05:00:00 PM,48,-122,241,85,326
15114,ElliotBayTrailMyrtlePark,09/22/2015 06:00:00 PM,48,-122,227,67,294
15115,ElliotBayTrailMyrtlePark,09/22/2015 07:00:00 PM,48,-122,90,53,143
15116,ElliotBayTrailMyrtlePark,09/22/2015 08:00:00 PM,48,-122,28,5,33
15117,ElliotBayTrailMyrtlePark,09/22/2015 09:00:00 PM,48,-122,6,10,16
15118,ElliotBayTrailMyrtlePark,09/22/2015 10:00:00 PM,48,-122,8,2,10
15119,ElliotBayTrailMyrtlePark,09/22/2015 11:00:00 PM,48,-122,5,3,8
15120,ElliotBayTrailMyrtlePark,09/23/2015 12:00:00 AM,48,-122,0,0,0
15121,ElliotBayTrailMyrtlePark,09/23/2015 01:00:00 AM,48,-122,2,0,2
15122,ElliotBayTrailMyrtlePark,09/23/2015 02:00:00 AM,48,-122,0,0,0
15123,ElliotBayTrailMyrtlePark,09/23/2015 03:00:00 AM,48,-122,1,0,1
15124,ElliotBayTrailMyrtlePark,09/23/2015 04:00:00 AM,48,-122,0,0,0
15125,ElliotBayTrailMyrtlePark,09/23/2015 05:00:00 AM,48,-122,5,4,9
15126,ElliotBayTrailMyrtlePark,09/23/2015 06:00:00 AM,48,-122,24,22,46
15127,ElliotBayTrailMyrtlePark,09/23/2015 07:00:00 AM,48,-122,39,85,124
15128,ElliotBayTrailMyrtlePark,09/23/2015 08:00:00 AM,48,-122,60,198,258
15129,ElliotBayTrailMyrtlePark,09/23/2015 09:00:00 AM,48,-122,44,138,182
15130,ElliotBayTrailMyrtlePark,09/23/2015 10:00:00 AM,48,-122,31,37,68
15131,ElliotBayTrailMyrtlePark,09/23/2015 11:00:00 AM,48,-122,19,32,51
15132,ElliotBayTrailMyrtlePark,09/23/2015 12:00:00 PM,48,-122,42,35,77
15133,ElliotBayTrailMyrtlePark,09/23/2015 01:00:00 PM,48,-122,23,30,53
15134,ElliotBayTrailMyrtlePark,09/23/2015 02:00:00 PM,48,-122,35,38,73
15135,ElliotBayTrailMyrtlePark,09/23/2015 03:00:00 PM,48,-122,35,35,70
15136,ElliotBayTrailMyrtlePark,09/23/2015 04:00:00 PM,48,-122,99,75,174
15137,ElliotBayTrailMyrtlePark,09/23/2015 05:00:00 PM,48,-122,205,100,305
15138,ElliotBayTrailMyrtlePark,09/23/2015 06:00:00 PM,48,-122,184,83,267
15139,ElliotBayTrailMyrtlePark,09/23/2015 07:00:00 PM,48,-122,61,47,108
15140,ElliotBayTrailMyrtlePark,09/23/2015 08:00:00 PM,48,-122,26,11,37
15141,ElliotBayTrailMyrtlePark,09/23/2015 09:00:00 PM,48,-122,59,2,61
15142,ElliotBayTrailMyrtlePark,09/23/2015 10:00:00 PM,48,-122,18,0,18
15143,ElliotBayTrailMyrtlePark,09/23/2015 11:00:00 PM,48,-122,11,0,11
15144,ElliotBayTrailMyrtlePark,09/24/2015 12:00:00 AM,48,-122,1,0,1
15145,ElliotBayTrailMyrtlePark,09/24/2015 01:00:00 AM,48,-122,1,1,2
15146,ElliotBayTrailMyrtlePark,09/24/2015 02:00:00 AM,48,-122,0,0,0
15147,ElliotBayTrailMyrtlePark,09/24/2015 03:00:00 AM,48,-122,1,0,1
15148,ElliotBayTrailMyrtlePark,09/24/2015 04:00:00 AM,48,-122,2,0,2
15149,ElliotBayTrailMyrtlePark,09/24/2015 05:00:00 AM,48,-122,5,4,9
15150,ElliotBayTrailMyrtlePark,09/24/2015 06:00:00 AM,48,-122,18,28,46
15151,ElliotBayTrailMyrtlePark,09/24/2015 07:00:00 AM,48,-122,41,88,129
15152,ElliotBayTrailMyrtlePark,09/24/2015 08:00:00 AM,48,-122,43,166,209
15153,ElliotBayTrailMyrtlePark,09/24/2015 09:00:00 AM,48,-122,41,114,155
15154,ElliotBayTrailMyrtlePark,09/24/2015 10:00:00 AM,48,-122,26,45,71
15155,ElliotBayTrailMyrtlePark,09/24/2015 11:00:00 AM,48,-122,16,23,39
15156,ElliotBayTrailMyrtlePark,09/24/2015 12:00:00 PM,48,-122,21,22,43
15157,ElliotBayTrailMyrtlePark,09/24/2015 01:00:00 PM,48,-122,33,28,61
15158,ElliotBayTrailMyrtlePark,09/24/2015 02:00:00 PM,48,-122,35,28,63
15159,ElliotBayTrailMyrtlePark,09/24/2015 03:00:00 PM,48,-122,39,30,69
15160,ElliotBayTrailMyrtlePark,09/24/2015 04:00:00 PM,48,-122,102,72,174
15161,ElliotBayTrailMyrtlePark,09/24/2015 05:00:00 PM,48,-122,214,64,278
15162,ElliotBayTrailMyrtlePark,09/24/2015 06:00:00 PM,48,-122,150,44,194
15163,ElliotBayTrailMyrtlePark,09/24/2015 07:00:00 PM,48,-122,60,29,89
15164,ElliotBayTrailMyrtlePark,09/24/2015 08:00:00 PM,48,-122,13,10,23
15165,ElliotBayTrailMyrtlePark,09/24/2015 09:00:00 PM,48,-122,9,2,11
15166,ElliotBayTrailMyrtlePark,09/24/2015 10:00:00 PM,48,-122,3,2,5
15167,ElliotBayTrailMyrtlePark,09/24/2015 11:00:00 PM,48,-122,1,1,2
15168,ElliotBayTrailMyrtlePark,09/25/2015 12:00:00 AM,48,-122,2,0,2
15169,ElliotBayTrailMyrtlePark,09/25/2015 01:00:00 AM,48,-122,1,0,1
15170,ElliotBayTrailMyrtlePark,09/25/2015 02:00:00 AM,48,-122,3,1,4
15171,ElliotBayTrailMyrtlePark,09/25/2015 03:00:00 AM,48,-122,1,0,1
15172,ElliotBayTrailMyrtlePark,09/25/2015 04:00:00 AM,48,-122,1,1,2
15173,ElliotBayTrailMyrtlePark,09/25/2015 05:00:00 AM,48,-122,4,4,8
15174,ElliotBayTrailMyrtlePark,09/25/2015 06:00:00 AM,48,-122,9,16,25
15175,ElliotBayTrailMyrtlePark,09/25/2015 07:00:00 AM,48,-122,24,50,74
15176,ElliotBayTrailMyrtlePark,09/25/2015 08:00:00 AM,48,-122,24,102,126
15177,ElliotBayTrailMyrtlePark,09/25/2015 09:00:00 AM,48,-122,18,70,88
15178,ElliotBayTrailMyrtlePark,09/25/2015 10:00:00 AM,48,-122,10,25,35
15179,ElliotBayTrailMyrtlePark,09/25/2015 11:00:00 AM,48,-122,8,17,25
15180,ElliotBayTrailMyrtlePark,09/25/2015 12:00:00 PM,48,-122,15,13,28
15181,ElliotBayTrailMyrtlePark,09/25/2015 01:00:00 PM,48,-122,16,8,24
15182,ElliotBayTrailMyrtlePark,09/25/2015 02:00:00 PM,48,-122,20,10,30
15183,ElliotBayTrailMyrtlePark,09/25/2015 03:00:00 PM,48,-122,36,27,63
15184,ElliotBayTrailMyrtlePark,09/25/2015 04:00:00 PM,48,-122,48,27,75
15185,ElliotBayTrailMyrtlePark,09/25/2015 05:00:00 PM,48,-122,147,32,179
15186,ElliotBayTrailMyrtlePark,09/25/2015 06:00:00 PM,48,-122,88,18,106
15187,ElliotBayTrailMyrtlePark,09/25/2015 07:00:00 PM,48,-122,70,20,90
15188,ElliotBayTrailMyrtlePark,09/25/2015 08:00:00 PM,48,-122,10,6,16
15189,ElliotBayTrailMyrtlePark,09/25/2015 09:00:00 PM,48,-122,5,1,6
15190,ElliotBayTrailMyrtlePark,09/25/2015 10:00:00 PM,48,-122,1,2,3
15191,ElliotBayTrailMyrtlePark,09/25/2015 11:00:00 PM,48,-122,4,0,4
15192,ElliotBayTrailMyrtlePark,09/26/2015 12:00:00 AM,48,-122,3,1,4
15193,ElliotBayTrailMyrtlePark,09/26/2015 01:00:00 AM,48,-122,1,0,1
15194,ElliotBayTrailMyrtlePark,09/26/2015 02:00:00 AM,48,-122,0,1,1
15195,ElliotBayTrailMyrtlePark,09/26/2015 03:00:00 AM,48,-122,3,0,3
15196,ElliotBayTrailMyrtlePark,09/26/2015 04:00:00 AM,48,-122,1,0,1
15197,ElliotBayTrailMyrtlePark,09/26/2015 05:00:00 AM,48,-122,0,1,1
15198,ElliotBayTrailMyrtlePark,09/26/2015 06:00:00 AM,48,-122,4,4,8
15199,ElliotBayTrailMyrtlePark,09/26/2015 07:00:00 AM,48,-122,10,4,14
15200,ElliotBayTrailMyrtlePark,09/26/2015 08:00:00 AM,48,-122,14,18,32
15201,ElliotBayTrailMyrtlePark,09/26/2015 09:00:00 AM,48,-122,16,19,35
15202,ElliotBayTrailMyrtlePark,09/26/2015 10:00:00 AM,48,-122,33,32,65
15203,ElliotBayTrailMyrtlePark,09/26/2015 11:00:00 AM,48,-122,21,49,70
15204,ElliotBayTrailMyrtlePark,09/26/2015 12:00:00 PM,48,-122,50,38,88
15205,ElliotBayTrailMyrtlePark,09/26/2015 01:00:00 PM,48,-122,28,34,62
15206,ElliotBayTrailMyrtlePark,09/26/2015 02:00:00 PM,48,-122,31,33,64
15207,ElliotBayTrailMyrtlePark,09/26/2015 03:00:00 PM,48,-122,41,33,74
15208,ElliotBayTrailMyrtlePark,09/26/2015 04:00:00 PM,48,-122,42,46,88
15209,ElliotBayTrailMyrtlePark,09/26/2015 05:00:00 PM,48,-122,43,44,87
15210,ElliotBayTrailMyrtlePark,09/26/2015 06:00:00 PM,48,-122,29,22,51
15211,ElliotBayTrailMyrtlePark,09/26/2015 07:00:00 PM,48,-122,19,25,44
15212,ElliotBayTrailMyrtlePark,09/26/2015 08:00:00 PM,48,-122,9,7,16
15213,ElliotBayTrailMyrtlePark,09/26/2015 09:00:00 PM,48,-122,0,6,6
15214,ElliotBayTrailMyrtlePark,09/26/2015 10:00:00 PM,48,-122,3,1,4
15215,ElliotBayTrailMyrtlePark,09/26/2015 11:00:00 PM,48,-122,7,0,7
15216,ElliotBayTrailMyrtlePark,09/27/2015 12:00:00 AM,48,-122,1,3,4
15217,ElliotBayTrailMyrtlePark,09/27/2015 01:00:00 AM,48,-122,0,0,0
15218,ElliotBayTrailMyrtlePark,09/27/2015 02:00:00 AM,48,-122,2,0,2
15219,ElliotBayTrailMyrtlePark,09/27/2015 03:00:00 AM,48,-122,1,0,1
15220,ElliotBayTrailMyrtlePark,09/27/2015 04:00:00 AM,48,-122,1,0,1
15221,ElliotBayTrailMyrtlePark,09/27/2015 05:00:00 AM,48,-122,0,0,0
15222,ElliotBayTrailMyrtlePark,09/27/2015 06:00:00 AM,48,-122,4,5,9
15223,ElliotBayTrailMyrtlePark,09/27/2015 07:00:00 AM,48,-122,2,9,11
15224,ElliotBayTrailMyrtlePark,09/27/2015 08:00:00 AM,48,-122,15,8,23
15225,ElliotBayTrailMyrtlePark,09/27/2015 09:00:00 AM,48,-122,12,21,33
15226,ElliotBayTrailMyrtlePark,09/27/2015 10:00:00 AM,48,-122,20,32,52
15227,ElliotBayTrailMyrtlePark,09/27/2015 11:00:00 AM,48,-122,31,50,81
15228,ElliotBayTrailMyrtlePark,09/27/2015 12:00:00 PM,48,-122,56,58,114
15229,ElliotBayTrailMyrtlePark,09/27/2015 01:00:00 PM,48,-122,58,34,92
15230,ElliotBayTrailMyrtlePark,09/27/2015 02:00:00 PM,48,-122,52,57,109
15231,ElliotBayTrailMyrtlePark,09/27/2015 03:00:00 PM,48,-122,60,54,114
15232,ElliotBayTrailMyrtlePark,09/27/2015 04:00:00 PM,48,-122,62,33,95
15233,ElliotBayTrailMyrtlePark,09/27/2015 05:00:00 PM,48,-122,43,36,79
15234,ElliotBayTrailMyrtlePark,09/27/2015 06:00:00 PM,48,-122,30,28,58
15235,ElliotBayTrailMyrtlePark,09/27/2015 07:00:00 PM,48,-122,23,13,36
15236,ElliotBayTrailMyrtlePark,09/27/2015 08:00:00 PM,48,-122,6,11,17
15237,ElliotBayTrailMyrtlePark,09/27/2015 09:00:00 PM,48,-122,2,1,3
15238,ElliotBayTrailMyrtlePark,09/27/2015 10:00:00 PM,48,-122,3,2,5
15239,ElliotBayTrailMyrtlePark,09/27/2015 11:00:00 PM,48,-122,1,2,3
15240,ElliotBayTrailMyrtlePark,09/28/2015 12:00:00 AM,48,-122,1,0,1
15241,ElliotBayTrailMyrtlePark,09/28/2015 01:00:00 AM,48,-122,0,0,0
15242,ElliotBayTrailMyrtlePark,09/28/2015 02:00:00 AM,48,-122,0,0,0
15243,ElliotBayTrailMyrtlePark,09/28/2015 03:00:00 AM,48,-122,0,0,0
15244,ElliotBayTrailMyrtlePark,09/28/2015 04:00:00 AM,48,-122,0,1,1
15245,ElliotBayTrailMyrtlePark,09/28/2015 05:00:00 AM,48,-122,5,5,10
15246,ElliotBayTrailMyrtlePark,09/28/2015 06:00:00 AM,48,-122,15,14,29
15247,ElliotBayTrailMyrtlePark,09/28/2015 07:00:00 AM,48,-122,44,68,112
15248,ElliotBayTrailMyrtlePark,09/28/2015 08:00:00 AM,48,-122,46,187,233
15249,ElliotBayTrailMyrtlePark,09/28/2015 09:00:00 AM,48,-122,30,103,133
15250,ElliotBayTrailMyrtlePark,09/28/2015 10:00:00 AM,48,-122,22,34,56
15251,ElliotBayTrailMyrtlePark,09/28/2015 11:00:00 AM,48,-122,20,30,50
15252,ElliotBayTrailMyrtlePark,09/28/2015 12:00:00 PM,48,-122,15,15,30
15253,ElliotBayTrailMyrtlePark,09/28/2015 01:00:00 PM,48,-122,26,34,60
15254,ElliotBayTrailMyrtlePark,09/28/2015 02:00:00 PM,48,-122,36,22,58
15255,ElliotBayTrailMyrtlePark,09/28/2015 03:00:00 PM,48,-122,34,32,66
15256,ElliotBayTrailMyrtlePark,09/28/2015 04:00:00 PM,48,-122,86,53,139
15257,ElliotBayTrailMyrtlePark,09/28/2015 05:00:00 PM,48,-122,212,64,276
15258,ElliotBayTrailMyrtlePark,09/28/2015 06:00:00 PM,48,-122,172,46,218
15259,ElliotBayTrailMyrtlePark,09/28/2015 07:00:00 PM,48,-122,60,38,98
15260,ElliotBayTrailMyrtlePark,09/28/2015 08:00:00 PM,48,-122,23,9,32
15261,ElliotBayTrailMyrtlePark,09/28/2015 09:00:00 PM,48,-122,5,4,9
15262,ElliotBayTrailMyrtlePark,09/28/2015 10:00:00 PM,48,-122,5,5,10
15263,ElliotBayTrailMyrtlePark,09/28/2015 11:00:00 PM,48,-122,3,1,4
15264,ElliotBayTrailMyrtlePark,09/29/2015 12:00:00 AM,48,-122,2,0,2
15265,ElliotBayTrailMyrtlePark,09/29/2015 01:00:00 AM,48,-122,1,0,1
15266,ElliotBayTrailMyrtlePark,09/29/2015 02:00:00 AM,48,-122,0,0,0
15267,ElliotBayTrailMyrtlePark,09/29/2015 03:00:00 AM,48,-122,1,0,1
15268,ElliotBayTrailMyrtlePark,09/29/2015 04:00:00 AM,48,-122,0,0,0
15269,ElliotBayTrailMyrtlePark,09/29/2015 05:00:00 AM,48,-122,6,5,11
15270,ElliotBayTrailMyrtlePark,09/29/2015 06:00:00 AM,48,-122,18,25,43
15271,ElliotBayTrailMyrtlePark,09/29/2015 07:00:00 AM,48,-122,35,76,111
15272,ElliotBayTrailMyrtlePark,09/29/2015 08:00:00 AM,48,-122,40,197,237
15273,ElliotBayTrailMyrtlePark,09/29/2015 09:00:00 AM,48,-122,36,115,151
15274,ElliotBayTrailMyrtlePark,09/29/2015 10:00:00 AM,48,-122,9,31,40
15275,ElliotBayTrailMyrtlePark,09/29/2015 11:00:00 AM,48,-122,14,24,38
15276,ElliotBayTrailMyrtlePark,09/29/2015 12:00:00 PM,48,-122,20,27,47
15277,ElliotBayTrailMyrtlePark,09/29/2015 01:00:00 PM,48,-122,20,21,41
15278,ElliotBayTrailMyrtlePark,09/29/2015 02:00:00 PM,48,-122,42,41,83
15279,ElliotBayTrailMyrtlePark,09/29/2015 03:00:00 PM,48,-122,41,27,68
15280,ElliotBayTrailMyrtlePark,09/29/2015 04:00:00 PM,48,-122,107,65,172
15281,ElliotBayTrailMyrtlePark,09/29/2015 05:00:00 PM,48,-122,192,66,258
15282,ElliotBayTrailMyrtlePark,09/29/2015 06:00:00 PM,48,-122,188,56,244
15283,ElliotBayTrailMyrtlePark,09/29/2015 07:00:00 PM,48,-122,65,32,97
15284,ElliotBayTrailMyrtlePark,09/29/2015 08:00:00 PM,48,-122,22,11,33
15285,ElliotBayTrailMyrtlePark,09/29/2015 09:00:00 PM,48,-122,7,1,8
15286,ElliotBayTrailMyrtlePark,09/29/2015 10:00:00 PM,48,-122,10,8,18
15287,ElliotBayTrailMyrtlePark,09/29/2015 11:00:00 PM,48,-122,6,2,8
15288,ElliotBayTrailMyrtlePark,09/30/2015 12:00:00 AM,48,-122,2,0,2
15289,ElliotBayTrailMyrtlePark,09/30/2015 01:00:00 AM,48,-122,0,0,0
15290,ElliotBayTrailMyrtlePark,09/30/2015 02:00:00 AM,48,-122,0,0,0
15291,ElliotBayTrailMyrtlePark,09/30/2015 03:00:00 AM,48,-122,1,0,1
15292,ElliotBayTrailMyrtlePark,09/30/2015 04:00:00 AM,48,-122,0,0,0
15293,ElliotBayTrailMyrtlePark,09/30/2015 05:00:00 AM,48,-122,4,6,10
15294,ElliotBayTrailMyrtlePark,09/30/2015 06:00:00 AM,48,-122,23,27,50
15295,ElliotBayTrailMyrtlePark,09/30/2015 07:00:00 AM,48,-122,35,71,106
15296,ElliotBayTrailMyrtlePark,09/30/2015 08:00:00 AM,48,-122,43,165,208
15297,ElliotBayTrailMyrtlePark,09/30/2015 09:00:00 AM,48,-122,32,115,147
15298,ElliotBayTrailMyrtlePark,09/30/2015 10:00:00 AM,48,-122,10,29,39
15299,ElliotBayTrailMyrtlePark,09/30/2015 11:00:00 AM,48,-122,16,21,37
15300,ElliotBayTrailMyrtlePark,09/30/2015 12:00:00 PM,48,-122,17,18,35
15301,ElliotBayTrailMyrtlePark,09/30/2015 01:00:00 PM,48,-122,18,16,34
15302,ElliotBayTrailMyrtlePark,09/30/2015 02:00:00 PM,48,-122,21,16,37
15303,ElliotBayTrailMyrtlePark,09/30/2015 03:00:00 PM,48,-122,46,27,73
15304,ElliotBayTrailMyrtlePark,09/30/2015 04:00:00 PM,48,-122,75,55,130
15305,ElliotBayTrailMyrtlePark,09/30/2015 05:00:00 PM,48,-122,175,82,257
15306,ElliotBayTrailMyrtlePark,09/30/2015 06:00:00 PM,48,-122,178,49,227
15307,ElliotBayTrailMyrtlePark,09/30/2015 07:00:00 PM,48,-122,73,43,116
15308,ElliotBayTrailMyrtlePark,09/30/2015 08:00:00 PM,48,-122,23,13,36
15309,ElliotBayTrailMyrtlePark,09/30/2015 09:00:00 PM,48,-122,8,1,9
15310,ElliotBayTrailMyrtlePark,09/30/2015 10:00:00 PM,48,-122,6,4,10
15311,ElliotBayTrailMyrtlePark,09/30/2015 11:00:00 PM,48,-122,10,2,12
15312,ElliotBayTrailMyrtlePark,10/01/2015 12:00:00 AM,48,-122,2,0,2
15313,ElliotBayTrailMyrtlePark,10/01/2015 01:00:00 AM,48,-122,0,2,2
15314,ElliotBayTrailMyrtlePark,10/01/2015 02:00:00 AM,48,-122,0,0,0
15315,ElliotBayTrailMyrtlePark,10/01/2015 03:00:00 AM,48,-122,2,1,3
15316,ElliotBayTrailMyrtlePark,10/01/2015 04:00:00 AM,48,-122,0,0,0
15317,ElliotBayTrailMyrtlePark,10/01/2015 05:00:00 AM,48,-122,4,2,6
15318,ElliotBayTrailMyrtlePark,10/01/2015 06:00:00 AM,48,-122,18,24,42
15319,ElliotBayTrailMyrtlePark,10/01/2015 07:00:00 AM,48,-122,26,75,101
15320,ElliotBayTrailMyrtlePark,10/01/2015 08:00:00 AM,48,-122,28,167,195
15321,ElliotBayTrailMyrtlePark,10/01/2015 09:00:00 AM,48,-122,28,84,112
15322,ElliotBayTrailMyrtlePark,10/01/2015 10:00:00 AM,48,-122,21,40,61
15323,ElliotBayTrailMyrtlePark,10/01/2015 11:00:00 AM,48,-122,19,28,47
15324,ElliotBayTrailMyrtlePark,10/01/2015 12:00:00 PM,48,-122,22,22,44
15325,ElliotBayTrailMyrtlePark,10/01/2015 01:00:00 PM,48,-122,28,15,43
15326,ElliotBayTrailMyrtlePark,10/01/2015 02:00:00 PM,48,-122,23,19,42
15327,ElliotBayTrailMyrtlePark,10/01/2015 03:00:00 PM,48,-122,47,30,77
15328,ElliotBayTrailMyrtlePark,10/01/2015 04:00:00 PM,48,-122,75,50,125
15329,ElliotBayTrailMyrtlePark,10/01/2015 05:00:00 PM,48,-122,173,57,230
15330,ElliotBayTrailMyrtlePark,10/01/2015 06:00:00 PM,48,-122,146,43,189
15331,ElliotBayTrailMyrtlePark,10/01/2015 07:00:00 PM,48,-122,55,28,83
15332,ElliotBayTrailMyrtlePark,10/01/2015 08:00:00 PM,48,-122,27,6,33
15333,ElliotBayTrailMyrtlePark,10/01/2015 09:00:00 PM,48,-122,6,4,10
15334,ElliotBayTrailMyrtlePark,10/01/2015 10:00:00 PM,48,-122,2,10,12
15335,ElliotBayTrailMyrtlePark,10/01/2015 11:00:00 PM,48,-122,6,4,10
15336,ElliotBayTrailMyrtlePark,10/02/2015 12:00:00 AM,48,-122,2,2,4
15337,ElliotBayTrailMyrtlePark,10/02/2015 01:00:00 AM,48,-122,0,0,0
15338,ElliotBayTrailMyrtlePark,10/02/2015 02:00:00 AM,48,-122,1,0,1
15339,ElliotBayTrailMyrtlePark,10/02/2015 03:00:00 AM,48,-122,0,0,0
15340,ElliotBayTrailMyrtlePark,10/02/2015 04:00:00 AM,48,-122,0,0,0
15341,ElliotBayTrailMyrtlePark,10/02/2015 05:00:00 AM,48,-122,6,6,12
15342,ElliotBayTrailMyrtlePark,10/02/2015 06:00:00 AM,48,-122,14,18,32
15343,ElliotBayTrailMyrtlePark,10/02/2015 07:00:00 AM,48,-122,27,55,82
15344,ElliotBayTrailMyrtlePark,10/02/2015 08:00:00 AM,48,-122,28,137,165
15345,ElliotBayTrailMyrtlePark,10/02/2015 09:00:00 AM,48,-122,21,66,87
15346,ElliotBayTrailMyrtlePark,10/02/2015 10:00:00 AM,48,-122,6,25,31
15347,ElliotBayTrailMyrtlePark,10/02/2015 11:00:00 AM,48,-122,30,13,43
15348,ElliotBayTrailMyrtlePark,10/02/2015 12:00:00 PM,48,-122,17,8,25
15349,ElliotBayTrailMyrtlePark,10/02/2015 01:00:00 PM,48,-122,17,10,27
15350,ElliotBayTrailMyrtlePark,10/02/2015 02:00:00 PM,48,-122,24,12,36
15351,ElliotBayTrailMyrtlePark,10/02/2015 03:00:00 PM,48,-122,20,21,41
15352,ElliotBayTrailMyrtlePark,10/02/2015 04:00:00 PM,48,-122,64,44,108
15353,ElliotBayTrailMyrtlePark,10/02/2015 05:00:00 PM,48,-122,124,44,168
15354,ElliotBayTrailMyrtlePark,10/02/2015 06:00:00 PM,48,-122,101,28,129
15355,ElliotBayTrailMyrtlePark,10/02/2015 07:00:00 PM,48,-122,30,25,55
15356,ElliotBayTrailMyrtlePark,10/02/2015 08:00:00 PM,48,-122,11,6,17
15357,ElliotBayTrailMyrtlePark,10/02/2015 09:00:00 PM,48,-122,3,3,6
15358,ElliotBayTrailMyrtlePark,10/02/2015 10:00:00 PM,48,-122,9,1,10
15359,ElliotBayTrailMyrtlePark,10/02/2015 11:00:00 PM,48,-122,14,0,14
15360,ElliotBayTrailMyrtlePark,10/03/2015 12:00:00 AM,48,-122,4,2,6
15361,ElliotBayTrailMyrtlePark,10/03/2015 01:00:00 AM,48,-122,1,0,1
15362,ElliotBayTrailMyrtlePark,10/03/2015 02:00:00 AM,48,-122,0,0,0
15363,ElliotBayTrailMyrtlePark,10/03/2015 03:00:00 AM,48,-122,2,0,2
15364,ElliotBayTrailMyrtlePark,10/03/2015 04:00:00 AM,48,-122,0,0,0
15365,ElliotBayTrailMyrtlePark,10/03/2015 05:00:00 AM,48,-122,1,2,3
15366,ElliotBayTrailMyrtlePark,10/03/2015 06:00:00 AM,48,-122,2,8,10
15367,ElliotBayTrailMyrtlePark,10/03/2015 07:00:00 AM,48,-122,2,4,6
15368,ElliotBayTrailMyrtlePark,10/03/2015 08:00:00 AM,48,-122,18,15,33
15369,ElliotBayTrailMyrtlePark,10/03/2015 09:00:00 AM,48,-122,14,21,35
15370,ElliotBayTrailMyrtlePark,10/03/2015 10:00:00 AM,48,-122,33,30,63
15371,ElliotBayTrailMyrtlePark,10/03/2015 11:00:00 AM,48,-122,35,30,65
15372,ElliotBayTrailMyrtlePark,10/03/2015 12:00:00 PM,48,-122,31,53,84
15373,ElliotBayTrailMyrtlePark,10/03/2015 01:00:00 PM,48,-122,35,67,102
15374,ElliotBayTrailMyrtlePark,10/03/2015 02:00:00 PM,48,-122,62,32,94
15375,ElliotBayTrailMyrtlePark,10/03/2015 03:00:00 PM,48,-122,53,66,119
15376,ElliotBayTrailMyrtlePark,10/03/2015 04:00:00 PM,48,-122,65,65,130
15377,ElliotBayTrailMyrtlePark,10/03/2015 05:00:00 PM,48,-122,62,52,114
15378,ElliotBayTrailMyrtlePark,10/03/2015 06:00:00 PM,48,-122,38,35,73
15379,ElliotBayTrailMyrtlePark,10/03/2015 07:00:00 PM,48,-122,25,24,49
15380,ElliotBayTrailMyrtlePark,10/03/2015 08:00:00 PM,48,-122,11,5,16
15381,ElliotBayTrailMyrtlePark,10/03/2015 09:00:00 PM,48,-122,3,3,6
15382,ElliotBayTrailMyrtlePark,10/03/2015 10:00:00 PM,48,-122,6,2,8
15383,ElliotBayTrailMyrtlePark,10/03/2015 11:00:00 PM,48,-122,16,0,16
15384,ElliotBayTrailMyrtlePark,10/04/2015 12:00:00 AM,48,-122,4,0,4
15385,ElliotBayTrailMyrtlePark,10/04/2015 01:00:00 AM,48,-122,2,0,2
15386,ElliotBayTrailMyrtlePark,10/04/2015 02:00:00 AM,48,-122,1,0,1
15387,ElliotBayTrailMyrtlePark,10/04/2015 03:00:00 AM,48,-122,2,0,2
15388,ElliotBayTrailMyrtlePark,10/04/2015 04:00:00 AM,48,-122,0,0,0
15389,ElliotBayTrailMyrtlePark,10/04/2015 05:00:00 AM,48,-122,0,0,0
15390,ElliotBayTrailMyrtlePark,10/04/2015 06:00:00 AM,48,-122,0,4,4
15391,ElliotBayTrailMyrtlePark,10/04/2015 07:00:00 AM,48,-122,0,10,10
15392,ElliotBayTrailMyrtlePark,10/04/2015 08:00:00 AM,48,-122,17,11,28
15393,ElliotBayTrailMyrtlePark,10/04/2015 09:00:00 AM,48,-122,30,20,50
15394,ElliotBayTrailMyrtlePark,10/04/2015 10:00:00 AM,48,-122,23,35,58
15395,ElliotBayTrailMyrtlePark,10/04/2015 11:00:00 AM,48,-122,46,65,111
15396,ElliotBayTrailMyrtlePark,10/04/2015 12:00:00 PM,48,-122,60,59,119
15397,ElliotBayTrailMyrtlePark,10/04/2015 01:00:00 PM,48,-122,81,70,151
15398,ElliotBayTrailMyrtlePark,10/04/2015 02:00:00 PM,48,-122,84,59,143
15399,ElliotBayTrailMyrtlePark,10/04/2015 03:00:00 PM,48,-122,89,75,164
15400,ElliotBayTrailMyrtlePark,10/04/2015 04:00:00 PM,48,-122,71,67,138
15401,ElliotBayTrailMyrtlePark,10/04/2015 05:00:00 PM,48,-122,61,89,150
15402,ElliotBayTrailMyrtlePark,10/04/2015 06:00:00 PM,48,-122,46,64,110
15403,ElliotBayTrailMyrtlePark,10/04/2015 07:00:00 PM,48,-122,22,22,44
15404,ElliotBayTrailMyrtlePark,10/04/2015 08:00:00 PM,48,-122,16,7,23
15405,ElliotBayTrailMyrtlePark,10/04/2015 09:00:00 PM,48,-122,43,1,44
15406,ElliotBayTrailMyrtlePark,10/04/2015 10:00:00 PM,48,-122,13,1,14
15407,ElliotBayTrailMyrtlePark,10/04/2015 11:00:00 PM,48,-122,8,0,8
15408,ElliotBayTrailMyrtlePark,10/05/2015 12:00:00 AM,48,-122,2,3,5
15409,ElliotBayTrailMyrtlePark,10/05/2015 01:00:00 AM,48,-122,1,1,2
15410,ElliotBayTrailMyrtlePark,10/05/2015 02:00:00 AM,48,-122,1,0,1
15411,ElliotBayTrailMyrtlePark,10/05/2015 03:00:00 AM,48,-122,1,0,1
15412,ElliotBayTrailMyrtlePark,10/05/2015 04:00:00 AM,48,-122,0,1,1
15413,ElliotBayTrailMyrtlePark,10/05/2015 05:00:00 AM,48,-122,6,6,12
15414,ElliotBayTrailMyrtlePark,10/05/2015 06:00:00 AM,48,-122,18,21,39
15415,ElliotBayTrailMyrtlePark,10/05/2015 07:00:00 AM,48,-122,34,89,123
15416,ElliotBayTrailMyrtlePark,10/05/2015 08:00:00 AM,48,-122,56,187,243
15417,ElliotBayTrailMyrtlePark,10/05/2015 09:00:00 AM,48,-122,34,118,152
15418,ElliotBayTrailMyrtlePark,10/05/2015 10:00:00 AM,48,-122,17,34,51
15419,ElliotBayTrailMyrtlePark,10/05/2015 11:00:00 AM,48,-122,29,26,55
15420,ElliotBayTrailMyrtlePark,10/05/2015 12:00:00 PM,48,-122,12,12,24
15421,ElliotBayTrailMyrtlePark,10/05/2015 01:00:00 PM,48,-122,21,20,41
15422,ElliotBayTrailMyrtlePark,10/05/2015 02:00:00 PM,48,-122,30,31,61
15423,ElliotBayTrailMyrtlePark,10/05/2015 03:00:00 PM,48,-122,50,55,105
15424,ElliotBayTrailMyrtlePark,10/05/2015 04:00:00 PM,48,-122,131,73,204
15425,ElliotBayTrailMyrtlePark,10/05/2015 05:00:00 PM,48,-122,224,80,304
15426,ElliotBayTrailMyrtlePark,10/05/2015 06:00:00 PM,48,-122,114,45,159
15427,ElliotBayTrailMyrtlePark,10/05/2015 07:00:00 PM,48,-122,59,35,94
15428,ElliotBayTrailMyrtlePark,10/05/2015 08:00:00 PM,48,-122,14,1,15
15429,ElliotBayTrailMyrtlePark,10/05/2015 09:00:00 PM,48,-122,17,2,19
15430,ElliotBayTrailMyrtlePark,10/05/2015 10:00:00 PM,48,-122,7,2,9
15431,ElliotBayTrailMyrtlePark,10/05/2015 11:00:00 PM,48,-122,4,1,5
15432,ElliotBayTrailMyrtlePark,10/06/2015 12:00:00 AM,48,-122,3,0,3
15433,ElliotBayTrailMyrtlePark,10/06/2015 01:00:00 AM,48,-122,0,0,0
15434,ElliotBayTrailMyrtlePark,10/06/2015 02:00:00 AM,48,-122,0,1,1
15435,ElliotBayTrailMyrtlePark,10/06/2015 03:00:00 AM,48,-122,2,1,3
15436,ElliotBayTrailMyrtlePark,10/06/2015 04:00:00 AM,48,-122,0,0,0
15437,ElliotBayTrailMyrtlePark,10/06/2015 05:00:00 AM,48,-122,2,7,9
15438,ElliotBayTrailMyrtlePark,10/06/2015 06:00:00 AM,48,-122,18,32,50
15439,ElliotBayTrailMyrtlePark,10/06/2015 07:00:00 AM,48,-122,35,82,117
15440,ElliotBayTrailMyrtlePark,10/06/2015 08:00:00 AM,48,-122,46,164,210
15441,ElliotBayTrailMyrtlePark,10/06/2015 09:00:00 AM,48,-122,27,102,129
15442,ElliotBayTrailMyrtlePark,10/06/2015 10:00:00 AM,48,-122,11,33,44
15443,ElliotBayTrailMyrtlePark,10/06/2015 11:00:00 AM,48,-122,14,18,32
15444,ElliotBayTrailMyrtlePark,10/06/2015 12:00:00 PM,48,-122,15,14,29
15445,ElliotBayTrailMyrtlePark,10/06/2015 01:00:00 PM,48,-122,20,14,34
15446,ElliotBayTrailMyrtlePark,10/06/2015 02:00:00 PM,48,-122,12,14,26
15447,ElliotBayTrailMyrtlePark,10/06/2015 03:00:00 PM,48,-122,35,25,60
15448,ElliotBayTrailMyrtlePark,10/06/2015 04:00:00 PM,48,-122,77,44,121
15449,ElliotBayTrailMyrtlePark,10/06/2015 05:00:00 PM,48,-122,181,53,234
15450,ElliotBayTrailMyrtlePark,10/06/2015 06:00:00 PM,48,-122,153,39,192
15451,ElliotBayTrailMyrtlePark,10/06/2015 07:00:00 PM,48,-122,51,15,66
15452,ElliotBayTrailMyrtlePark,10/06/2015 08:00:00 PM,48,-122,15,5,20
15453,ElliotBayTrailMyrtlePark,10/06/2015 09:00:00 PM,48,-122,5,3,8
15454,ElliotBayTrailMyrtlePark,10/06/2015 10:00:00 PM,48,-122,7,5,12
15455,ElliotBayTrailMyrtlePark,10/06/2015 11:00:00 PM,48,-122,1,2,3
15456,ElliotBayTrailMyrtlePark,10/07/2015 12:00:00 AM,48,-122,4,1,5
15457,ElliotBayTrailMyrtlePark,10/07/2015 01:00:00 AM,48,-122,2,0,2
15458,ElliotBayTrailMyrtlePark,10/07/2015 02:00:00 AM,48,-122,0,0,0
15459,ElliotBayTrailMyrtlePark,10/07/2015 03:00:00 AM,48,-122,1,0,1
15460,ElliotBayTrailMyrtlePark,10/07/2015 04:00:00 AM,48,-122,0,0,0
15461,ElliotBayTrailMyrtlePark,10/07/2015 05:00:00 AM,48,-122,3,5,8
15462,ElliotBayTrailMyrtlePark,10/07/2015 06:00:00 AM,48,-122,14,22,36
15463,ElliotBayTrailMyrtlePark,10/07/2015 07:00:00 AM,48,-122,22,48,70
15464,ElliotBayTrailMyrtlePark,10/07/2015 08:00:00 AM,48,-122,30,104,134
15465,ElliotBayTrailMyrtlePark,10/07/2015 09:00:00 AM,48,-122,18,55,73
15466,ElliotBayTrailMyrtlePark,10/07/2015 10:00:00 AM,48,-122,4,8,12
15467,ElliotBayTrailMyrtlePark,10/07/2015 11:00:00 AM,48,-122,1,7,8
15468,ElliotBayTrailMyrtlePark,10/07/2015 12:00:00 PM,48,-122,4,2,6
15469,ElliotBayTrailMyrtlePark,10/07/2015 01:00:00 PM,48,-122,7,5,12
15470,ElliotBayTrailMyrtlePark,10/07/2015 02:00:00 PM,48,-122,7,6,13
15471,ElliotBayTrailMyrtlePark,10/07/2015 03:00:00 PM,48,-122,13,13,26
15472,ElliotBayTrailMyrtlePark,10/07/2015 04:00:00 PM,48,-122,37,15,52
15473,ElliotBayTrailMyrtlePark,10/07/2015 05:00:00 PM,48,-122,91,28,119
15474,ElliotBayTrailMyrtlePark,10/07/2015 06:00:00 PM,48,-122,87,19,106
15475,ElliotBayTrailMyrtlePark,10/07/2015 07:00:00 PM,48,-122,37,14,51
15476,ElliotBayTrailMyrtlePark,10/07/2015 08:00:00 PM,48,-122,6,1,7
15477,ElliotBayTrailMyrtlePark,10/07/2015 09:00:00 PM,48,-122,8,0,8
15478,ElliotBayTrailMyrtlePark,10/07/2015 10:00:00 PM,48,-122,4,3,7
15479,ElliotBayTrailMyrtlePark,10/07/2015 11:00:00 PM,48,-122,4,0,4
15480,ElliotBayTrailMyrtlePark,10/08/2015 12:00:00 AM,48,-122,1,1,2
15481,ElliotBayTrailMyrtlePark,10/08/2015 01:00:00 AM,48,-122,0,0,0
15482,ElliotBayTrailMyrtlePark,10/08/2015 02:00:00 AM,48,-122,0,0,0
15483,ElliotBayTrailMyrtlePark,10/08/2015 03:00:00 AM,48,-122,1,0,1
15484,ElliotBayTrailMyrtlePark,10/08/2015 04:00:00 AM,48,-122,0,1,1
15485,ElliotBayTrailMyrtlePark,10/08/2015 05:00:00 AM,48,-122,5,6,11
15486,ElliotBayTrailMyrtlePark,10/08/2015 06:00:00 AM,48,-122,13,25,38
15487,ElliotBayTrailMyrtlePark,10/08/2015 07:00:00 AM,48,-122,30,65,95
15488,ElliotBayTrailMyrtlePark,10/08/2015 08:00:00 AM,48,-122,44,141,185
15489,ElliotBayTrailMyrtlePark,10/08/2015 09:00:00 AM,48,-122,28,83,111
15490,ElliotBayTrailMyrtlePark,10/08/2015 10:00:00 AM,48,-122,11,25,36
15491,ElliotBayTrailMyrtlePark,10/08/2015 11:00:00 AM,48,-122,9,11,20
15492,ElliotBayTrailMyrtlePark,10/08/2015 12:00:00 PM,48,-122,8,8,16
15493,ElliotBayTrailMyrtlePark,10/08/2015 01:00:00 PM,48,-122,12,18,30
15494,ElliotBayTrailMyrtlePark,10/08/2015 02:00:00 PM,48,-122,18,11,29
15495,ElliotBayTrailMyrtlePark,10/08/2015 03:00:00 PM,48,-122,36,22,58
15496,ElliotBayTrailMyrtlePark,10/08/2015 04:00:00 PM,48,-122,71,42,113
15497,ElliotBayTrailMyrtlePark,10/08/2015 05:00:00 PM,48,-122,164,56,220
15498,ElliotBayTrailMyrtlePark,10/08/2015 06:00:00 PM,48,-122,144,43,187
15499,ElliotBayTrailMyrtlePark,10/08/2015 07:00:00 PM,48,-122,52,17,69
15500,ElliotBayTrailMyrtlePark,10/08/2015 08:00:00 PM,48,-122,11,6,17
15501,ElliotBayTrailMyrtlePark,10/08/2015 09:00:00 PM,48,-122,8,2,10
15502,ElliotBayTrailMyrtlePark,10/08/2015 10:00:00 PM,48,-122,6,0,6
15503,ElliotBayTrailMyrtlePark,10/08/2015 11:00:00 PM,48,-122,1,1,2
15504,ElliotBayTrailMyrtlePark,10/09/2015 12:00:00 AM,48,-122,5,1,6
15505,ElliotBayTrailMyrtlePark,10/09/2015 01:00:00 AM,48,-122,3,1,4
15506,ElliotBayTrailMyrtlePark,10/09/2015 02:00:00 AM,48,-122,1,0,1
15507,ElliotBayTrailMyrtlePark,10/09/2015 03:00:00 AM,48,-122,3,0,3
15508,ElliotBayTrailMyrtlePark,10/09/2015 04:00:00 AM,48,-122,1,0,1
15509,ElliotBayTrailMyrtlePark,10/09/2015 05:00:00 AM,48,-122,3,7,10
15510,ElliotBayTrailMyrtlePark,10/09/2015 06:00:00 AM,48,-122,13,17,30
15511,ElliotBayTrailMyrtlePark,10/09/2015 07:00:00 AM,48,-122,29,61,90
15512,ElliotBayTrailMyrtlePark,10/09/2015 08:00:00 AM,48,-122,33,129,162
15513,ElliotBayTrailMyrtlePark,10/09/2015 09:00:00 AM,48,-122,24,100,124
15514,ElliotBayTrailMyrtlePark,10/09/2015 10:00:00 AM,48,-122,14,34,48
15515,ElliotBayTrailMyrtlePark,10/09/2015 11:00:00 AM,48,-122,10,17,27
15516,ElliotBayTrailMyrtlePark,10/09/2015 12:00:00 PM,48,-122,13,15,28
15517,ElliotBayTrailMyrtlePark,10/09/2015 01:00:00 PM,48,-122,24,13,37
15518,ElliotBayTrailMyrtlePark,10/09/2015 02:00:00 PM,48,-122,23,15,38
15519,ElliotBayTrailMyrtlePark,10/09/2015 03:00:00 PM,48,-122,27,21,48
15520,ElliotBayTrailMyrtlePark,10/09/2015 04:00:00 PM,48,-122,86,28,114
15521,ElliotBayTrailMyrtlePark,10/09/2015 05:00:00 PM,48,-122,143,42,185
15522,ElliotBayTrailMyrtlePark,10/09/2015 06:00:00 PM,48,-122,85,28,113
15523,ElliotBayTrailMyrtlePark,10/09/2015 07:00:00 PM,48,-122,36,21,57
15524,ElliotBayTrailMyrtlePark,10/09/2015 08:00:00 PM,48,-122,11,4,15
15525,ElliotBayTrailMyrtlePark,10/09/2015 09:00:00 PM,48,-122,9,6,15
15526,ElliotBayTrailMyrtlePark,10/09/2015 10:00:00 PM,48,-122,4,4,8
15527,ElliotBayTrailMyrtlePark,10/09/2015 11:00:00 PM,48,-122,2,2,4
15528,ElliotBayTrailMyrtlePark,10/10/2015 12:00:00 AM,48,-122,4,1,5
15529,ElliotBayTrailMyrtlePark,10/10/2015 01:00:00 AM,48,-122,4,1,5
15530,ElliotBayTrailMyrtlePark,10/10/2015 02:00:00 AM,48,-122,1,1,2
15531,ElliotBayTrailMyrtlePark,10/10/2015 03:00:00 AM,48,-122,1,0,1
15532,ElliotBayTrailMyrtlePark,10/10/2015 04:00:00 AM,48,-122,1,0,1
15533,ElliotBayTrailMyrtlePark,10/10/2015 05:00:00 AM,48,-122,1,0,1
15534,ElliotBayTrailMyrtlePark,10/10/2015 06:00:00 AM,48,-122,3,4,7
15535,ElliotBayTrailMyrtlePark,10/10/2015 07:00:00 AM,48,-122,3,3,6
15536,ElliotBayTrailMyrtlePark,10/10/2015 08:00:00 AM,48,-122,8,8,16
15537,ElliotBayTrailMyrtlePark,10/10/2015 09:00:00 AM,48,-122,9,9,18
15538,ElliotBayTrailMyrtlePark,10/10/2015 10:00:00 AM,48,-122,2,2,4
15539,ElliotBayTrailMyrtlePark,10/10/2015 11:00:00 AM,48,-122,6,1,7
15540,ElliotBayTrailMyrtlePark,10/10/2015 12:00:00 PM,48,-122,4,4,8
15541,ElliotBayTrailMyrtlePark,10/10/2015 01:00:00 PM,48,-122,6,8,14
15542,ElliotBayTrailMyrtlePark,10/10/2015 02:00:00 PM,48,-122,1,1,2
15543,ElliotBayTrailMyrtlePark,10/10/2015 03:00:00 PM,48,-122,6,3,9
15544,ElliotBayTrailMyrtlePark,10/10/2015 04:00:00 PM,48,-122,7,1,8
15545,ElliotBayTrailMyrtlePark,10/10/2015 05:00:00 PM,48,-122,4,8,12
15546,ElliotBayTrailMyrtlePark,10/10/2015 06:00:00 PM,48,-122,4,4,8
15547,ElliotBayTrailMyrtlePark,10/10/2015 07:00:00 PM,48,-122,2,2,4
15548,ElliotBayTrailMyrtlePark,10/10/2015 08:00:00 PM,48,-122,4,0,4
15549,ElliotBayTrailMyrtlePark,10/10/2015 09:00:00 PM,48,-122,1,3,4
15550,ElliotBayTrailMyrtlePark,10/10/2015 10:00:00 PM,48,-122,3,2,5
15551,ElliotBayTrailMyrtlePark,10/10/2015 11:00:00 PM,48,-122,3,1,4
15552,ElliotBayTrailMyrtlePark,10/11/2015 12:00:00 AM,48,-122,3,2,5
15553,ElliotBayTrailMyrtlePark,10/11/2015 01:00:00 AM,48,-122,2,0,2
15554,ElliotBayTrailMyrtlePark,10/11/2015 02:00:00 AM,48,-122,0,0,0
15555,ElliotBayTrailMyrtlePark,10/11/2015 03:00:00 AM,48,-122,0,2,2
15556,ElliotBayTrailMyrtlePark,10/11/2015 04:00:00 AM,48,-122,0,0,0
15557,ElliotBayTrailMyrtlePark,10/11/2015 05:00:00 AM,48,-122,0,1,1
15558,ElliotBayTrailMyrtlePark,10/11/2015 06:00:00 AM,48,-122,0,4,4
15559,ElliotBayTrailMyrtlePark,10/11/2015 07:00:00 AM,48,-122,3,1,4
15560,ElliotBayTrailMyrtlePark,10/11/2015 08:00:00 AM,48,-122,9,16,25
15561,ElliotBayTrailMyrtlePark,10/11/2015 09:00:00 AM,48,-122,27,16,43
15562,ElliotBayTrailMyrtlePark,10/11/2015 10:00:00 AM,48,-122,44,25,69
15563,ElliotBayTrailMyrtlePark,10/11/2015 11:00:00 AM,48,-122,38,20,58
15564,ElliotBayTrailMyrtlePark,10/11/2015 12:00:00 PM,48,-122,36,32,68
15565,ElliotBayTrailMyrtlePark,10/11/2015 01:00:00 PM,48,-122,42,46,88
15566,ElliotBayTrailMyrtlePark,10/11/2015 02:00:00 PM,48,-122,46,52,98
15567,ElliotBayTrailMyrtlePark,10/11/2015 03:00:00 PM,48,-122,64,81,145
15568,ElliotBayTrailMyrtlePark,10/11/2015 04:00:00 PM,48,-122,66,47,113
15569,ElliotBayTrailMyrtlePark,10/11/2015 05:00:00 PM,48,-122,39,34,73
15570,ElliotBayTrailMyrtlePark,10/11/2015 06:00:00 PM,48,-122,16,24,40
15571,ElliotBayTrailMyrtlePark,10/11/2015 07:00:00 PM,48,-122,16,11,27
15572,ElliotBayTrailMyrtlePark,10/11/2015 08:00:00 PM,48,-122,7,3,10
15573,ElliotBayTrailMyrtlePark,10/11/2015 09:00:00 PM,48,-122,3,0,3
15574,ElliotBayTrailMyrtlePark,10/11/2015 10:00:00 PM,48,-122,3,1,4
15575,ElliotBayTrailMyrtlePark,10/11/2015 11:00:00 PM,48,-122,3,3,6
15576,ElliotBayTrailMyrtlePark,10/12/2015 12:00:00 AM,48,-122,1,1,2
15577,ElliotBayTrailMyrtlePark,10/12/2015 01:00:00 AM,48,-122,0,0,0
15578,ElliotBayTrailMyrtlePark,10/12/2015 02:00:00 AM,48,-122,0,1,1
15579,ElliotBayTrailMyrtlePark,10/12/2015 03:00:00 AM,48,-122,0,1,1
15580,ElliotBayTrailMyrtlePark,10/12/2015 04:00:00 AM,48,-122,0,0,0
15581,ElliotBayTrailMyrtlePark,10/12/2015 05:00:00 AM,48,-122,4,2,6
15582,ElliotBayTrailMyrtlePark,10/12/2015 06:00:00 AM,48,-122,19,14,33
15583,ElliotBayTrailMyrtlePark,10/12/2015 07:00:00 AM,48,-122,23,55,78
15584,ElliotBayTrailMyrtlePark,10/12/2015 08:00:00 AM,48,-122,38,162,200
15585,ElliotBayTrailMyrtlePark,10/12/2015 09:00:00 AM,48,-122,30,94,124
15586,ElliotBayTrailMyrtlePark,10/12/2015 10:00:00 AM,48,-122,24,36,60
15587,ElliotBayTrailMyrtlePark,10/12/2015 11:00:00 AM,48,-122,14,24,38
15588,ElliotBayTrailMyrtlePark,10/12/2015 12:00:00 PM,48,-122,16,15,31
15589,ElliotBayTrailMyrtlePark,10/12/2015 01:00:00 PM,48,-122,9,21,30
15590,ElliotBayTrailMyrtlePark,10/12/2015 02:00:00 PM,48,-122,18,11,29
15591,ElliotBayTrailMyrtlePark,10/12/2015 03:00:00 PM,48,-122,24,21,45
15592,ElliotBayTrailMyrtlePark,10/12/2015 04:00:00 PM,48,-122,54,32,86
15593,ElliotBayTrailMyrtlePark,10/12/2015 05:00:00 PM,48,-122,146,46,192
15594,ElliotBayTrailMyrtlePark,10/12/2015 06:00:00 PM,48,-122,136,24,160
15595,ElliotBayTrailMyrtlePark,10/12/2015 07:00:00 PM,48,-122,36,21,57
15596,ElliotBayTrailMyrtlePark,10/12/2015 08:00:00 PM,48,-122,12,2,14
15597,ElliotBayTrailMyrtlePark,10/12/2015 09:00:00 PM,48,-122,0,1,1
15598,ElliotBayTrailMyrtlePark,10/12/2015 10:00:00 PM,48,-122,3,0,3
15599,ElliotBayTrailMyrtlePark,10/12/2015 11:00:00 PM,48,-122,1,0,1
15600,ElliotBayTrailMyrtlePark,10/13/2015 12:00:00 AM,48,-122,1,0,1
15601,ElliotBayTrailMyrtlePark,10/13/2015 01:00:00 AM,48,-122,2,0,2
15602,ElliotBayTrailMyrtlePark,10/13/2015 02:00:00 AM,48,-122,0,0,0
15603,ElliotBayTrailMyrtlePark,10/13/2015 03:00:00 AM,48,-122,1,0,1
15604,ElliotBayTrailMyrtlePark,10/13/2015 04:00:00 AM,48,-122,0,0,0
15605,ElliotBayTrailMyrtlePark,10/13/2015 05:00:00 AM,48,-122,4,8,12
15606,ElliotBayTrailMyrtlePark,10/13/2015 06:00:00 AM,48,-122,14,23,37
15607,ElliotBayTrailMyrtlePark,10/13/2015 07:00:00 AM,48,-122,35,66,101
15608,ElliotBayTrailMyrtlePark,10/13/2015 08:00:00 AM,48,-122,37,164,201
15609,ElliotBayTrailMyrtlePark,10/13/2015 09:00:00 AM,48,-122,34,92,126
15610,ElliotBayTrailMyrtlePark,10/13/2015 10:00:00 AM,48,-122,11,32,43
15611,ElliotBayTrailMyrtlePark,10/13/2015 11:00:00 AM,48,-122,17,10,27
15612,ElliotBayTrailMyrtlePark,10/13/2015 12:00:00 PM,48,-122,13,14,27
15613,ElliotBayTrailMyrtlePark,10/13/2015 01:00:00 PM,48,-122,10,13,23
15614,ElliotBayTrailMyrtlePark,10/13/2015 02:00:00 PM,48,-122,18,14,32
15615,ElliotBayTrailMyrtlePark,10/13/2015 03:00:00 PM,48,-122,18,24,42
15616,ElliotBayTrailMyrtlePark,10/13/2015 04:00:00 PM,48,-122,60,37,97
15617,ElliotBayTrailMyrtlePark,10/13/2015 05:00:00 PM,48,-122,183,64,247
15618,ElliotBayTrailMyrtlePark,10/13/2015 06:00:00 PM,48,-122,156,43,199
15619,ElliotBayTrailMyrtlePark,10/13/2015 07:00:00 PM,48,-122,42,26,68
15620,ElliotBayTrailMyrtlePark,10/13/2015 08:00:00 PM,48,-122,11,5,16
15621,ElliotBayTrailMyrtlePark,10/13/2015 09:00:00 PM,48,-122,1,1,2
15622,ElliotBayTrailMyrtlePark,10/13/2015 10:00:00 PM,48,-122,3,1,4
15623,ElliotBayTrailMyrtlePark,10/13/2015 11:00:00 PM,48,-122,5,4,9
15624,ElliotBayTrailMyrtlePark,10/14/2015 12:00:00 AM,48,-122,2,0,2
15625,ElliotBayTrailMyrtlePark,10/14/2015 01:00:00 AM,48,-122,0,0,0
15626,ElliotBayTrailMyrtlePark,10/14/2015 02:00:00 AM,48,-122,0,0,0
15627,ElliotBayTrailMyrtlePark,10/14/2015 03:00:00 AM,48,-122,1,0,1
15628,ElliotBayTrailMyrtlePark,10/14/2015 04:00:00 AM,48,-122,0,0,0
15629,ElliotBayTrailMyrtlePark,10/14/2015 05:00:00 AM,48,-122,7,9,16
15630,ElliotBayTrailMyrtlePark,10/14/2015 06:00:00 AM,48,-122,15,24,39
15631,ElliotBayTrailMyrtlePark,10/14/2015 07:00:00 AM,48,-122,37,88,125
15632,ElliotBayTrailMyrtlePark,10/14/2015 08:00:00 AM,48,-122,40,158,198
15633,ElliotBayTrailMyrtlePark,10/14/2015 09:00:00 AM,48,-122,33,104,137
15634,ElliotBayTrailMyrtlePark,10/14/2015 10:00:00 AM,48,-122,22,35,57
15635,ElliotBayTrailMyrtlePark,10/14/2015 11:00:00 AM,48,-122,11,14,25
15636,ElliotBayTrailMyrtlePark,10/14/2015 12:00:00 PM,48,-122,19,15,34
15637,ElliotBayTrailMyrtlePark,10/14/2015 01:00:00 PM,48,-122,14,20,34
15638,ElliotBayTrailMyrtlePark,10/14/2015 02:00:00 PM,48,-122,17,14,31
15639,ElliotBayTrailMyrtlePark,10/14/2015 03:00:00 PM,48,-122,37,15,52
15640,ElliotBayTrailMyrtlePark,10/14/2015 04:00:00 PM,48,-122,83,48,131
15641,ElliotBayTrailMyrtlePark,10/14/2015 05:00:00 PM,48,-122,175,81,256
15642,ElliotBayTrailMyrtlePark,10/14/2015 06:00:00 PM,48,-122,143,44,187
15643,ElliotBayTrailMyrtlePark,10/14/2015 07:00:00 PM,48,-122,47,14,61
15644,ElliotBayTrailMyrtlePark,10/14/2015 08:00:00 PM,48,-122,19,9,28
15645,ElliotBayTrailMyrtlePark,10/14/2015 09:00:00 PM,48,-122,11,0,11
15646,ElliotBayTrailMyrtlePark,10/14/2015 10:00:00 PM,48,-122,7,5,12
15647,ElliotBayTrailMyrtlePark,10/14/2015 11:00:00 PM,48,-122,1,4,5
15648,ElliotBayTrailMyrtlePark,10/15/2015 12:00:00 AM,48,-122,2,3,5
15649,ElliotBayTrailMyrtlePark,10/15/2015 01:00:00 AM,48,-122,0,0,0
15650,ElliotBayTrailMyrtlePark,10/15/2015 02:00:00 AM,48,-122,0,0,0
15651,ElliotBayTrailMyrtlePark,10/15/2015 03:00:00 AM,48,-122,3,0,3
15652,ElliotBayTrailMyrtlePark,10/15/2015 04:00:00 AM,48,-122,0,0,0
15653,ElliotBayTrailMyrtlePark,10/15/2015 05:00:00 AM,48,-122,6,11,17
15654,ElliotBayTrailMyrtlePark,10/15/2015 06:00:00 AM,48,-122,23,21,44
15655,ElliotBayTrailMyrtlePark,10/15/2015 07:00:00 AM,48,-122,37,61,98
15656,ElliotBayTrailMyrtlePark,10/15/2015 08:00:00 AM,48,-122,27,151,178
15657,ElliotBayTrailMyrtlePark,10/15/2015 09:00:00 AM,48,-122,30,95,125
15658,ElliotBayTrailMyrtlePark,10/15/2015 10:00:00 AM,48,-122,20,20,40
15659,ElliotBayTrailMyrtlePark,10/15/2015 11:00:00 AM,48,-122,10,20,30
15660,ElliotBayTrailMyrtlePark,10/15/2015 12:00:00 PM,48,-122,23,20,43
15661,ElliotBayTrailMyrtlePark,10/15/2015 01:00:00 PM,48,-122,25,28,53
15662,ElliotBayTrailMyrtlePark,10/15/2015 02:00:00 PM,48,-122,42,26,68
15663,ElliotBayTrailMyrtlePark,10/15/2015 03:00:00 PM,48,-122,25,37,62
15664,ElliotBayTrailMyrtlePark,10/15/2015 04:00:00 PM,48,-122,73,46,119
15665,ElliotBayTrailMyrtlePark,10/15/2015 05:00:00 PM,48,-122,175,79,254
15666,ElliotBayTrailMyrtlePark,10/15/2015 06:00:00 PM,48,-122,130,29,159
15667,ElliotBayTrailMyrtlePark,10/15/2015 07:00:00 PM,48,-122,39,16,55
15668,ElliotBayTrailMyrtlePark,10/15/2015 08:00:00 PM,48,-122,22,9,31
15669,ElliotBayTrailMyrtlePark,10/15/2015 09:00:00 PM,48,-122,0,0,0
15670,ElliotBayTrailMyrtlePark,10/15/2015 10:00:00 PM,48,-122,4,5,9
15671,ElliotBayTrailMyrtlePark,10/15/2015 11:00:00 PM,48,-122,2,0,2
15672,ElliotBayTrailMyrtlePark,10/16/2015 12:00:00 AM,48,-122,2,0,2
15673,ElliotBayTrailMyrtlePark,10/16/2015 01:00:00 AM,48,-122,3,1,4
15674,ElliotBayTrailMyrtlePark,10/16/2015 02:00:00 AM,48,-122,1,0,1
15675,ElliotBayTrailMyrtlePark,10/16/2015 03:00:00 AM,48,-122,1,0,1
15676,ElliotBayTrailMyrtlePark,10/16/2015 04:00:00 AM,48,-122,0,0,0
15677,ElliotBayTrailMyrtlePark,10/16/2015 05:00:00 AM,48,-122,3,9,12
15678,ElliotBayTrailMyrtlePark,10/16/2015 06:00:00 AM,48,-122,23,27,50
15679,ElliotBayTrailMyrtlePark,10/16/2015 07:00:00 AM,48,-122,34,74,108
15680,ElliotBayTrailMyrtlePark,10/16/2015 08:00:00 AM,48,-122,41,140,181
15681,ElliotBayTrailMyrtlePark,10/16/2015 09:00:00 AM,48,-122,29,96,125
15682,ElliotBayTrailMyrtlePark,10/16/2015 10:00:00 AM,48,-122,18,36,54
15683,ElliotBayTrailMyrtlePark,10/16/2015 11:00:00 AM,48,-122,25,27,52
15684,ElliotBayTrailMyrtlePark,10/16/2015 12:00:00 PM,48,-122,26,26,52
15685,ElliotBayTrailMyrtlePark,10/16/2015 01:00:00 PM,48,-122,20,24,44
15686,ElliotBayTrailMyrtlePark,10/16/2015 02:00:00 PM,48,-122,36,27,63
15687,ElliotBayTrailMyrtlePark,10/16/2015 03:00:00 PM,48,-122,78,36,114
15688,ElliotBayTrailMyrtlePark,10/16/2015 04:00:00 PM,48,-122,84,55,139
15689,ElliotBayTrailMyrtlePark,10/16/2015 05:00:00 PM,48,-122,183,80,263
15690,ElliotBayTrailMyrtlePark,10/16/2015 06:00:00 PM,48,-122,116,46,162
15691,ElliotBayTrailMyrtlePark,10/16/2015 07:00:00 PM,48,-122,33,13,46
15692,ElliotBayTrailMyrtlePark,10/16/2015 08:00:00 PM,48,-122,12,7,19
15693,ElliotBayTrailMyrtlePark,10/16/2015 09:00:00 PM,48,-122,7,4,11
15694,ElliotBayTrailMyrtlePark,10/16/2015 10:00:00 PM,48,-122,6,3,9
15695,ElliotBayTrailMyrtlePark,10/16/2015 11:00:00 PM,48,-122,2,5,7
15696,ElliotBayTrailMyrtlePark,10/17/2015 12:00:00 AM,48,-122,3,2,5
15697,ElliotBayTrailMyrtlePark,10/17/2015 01:00:00 AM,48,-122,2,3,5
15698,ElliotBayTrailMyrtlePark,10/17/2015 02:00:00 AM,48,-122,0,0,0
15699,ElliotBayTrailMyrtlePark,10/17/2015 03:00:00 AM,48,-122,0,0,0
15700,ElliotBayTrailMyrtlePark,10/17/2015 04:00:00 AM,48,-122,0,0,0
15701,ElliotBayTrailMyrtlePark,10/17/2015 05:00:00 AM,48,-122,0,0,0
15702,ElliotBayTrailMyrtlePark,10/17/2015 06:00:00 AM,48,-122,1,5,6
15703,ElliotBayTrailMyrtlePark,10/17/2015 07:00:00 AM,48,-122,0,6,6
15704,ElliotBayTrailMyrtlePark,10/17/2015 08:00:00 AM,48,-122,11,22,33
15705,ElliotBayTrailMyrtlePark,10/17/2015 09:00:00 AM,48,-122,28,21,49
15706,ElliotBayTrailMyrtlePark,10/17/2015 10:00:00 AM,48,-122,29,31,60
15707,ElliotBayTrailMyrtlePark,10/17/2015 11:00:00 AM,48,-122,33,33,66
15708,ElliotBayTrailMyrtlePark,10/17/2015 12:00:00 PM,48,-122,33,44,77
15709,ElliotBayTrailMyrtlePark,10/17/2015 01:00:00 PM,48,-122,42,44,86
15710,ElliotBayTrailMyrtlePark,10/17/2015 02:00:00 PM,48,-122,46,27,73
15711,ElliotBayTrailMyrtlePark,10/17/2015 03:00:00 PM,48,-122,37,41,78
15712,ElliotBayTrailMyrtlePark,10/17/2015 04:00:00 PM,48,-122,31,47,78
15713,ElliotBayTrailMyrtlePark,10/17/2015 05:00:00 PM,48,-122,23,14,37
15714,ElliotBayTrailMyrtlePark,10/17/2015 06:00:00 PM,48,-122,16,17,33
15715,ElliotBayTrailMyrtlePark,10/17/2015 07:00:00 PM,48,-122,8,16,24
15716,ElliotBayTrailMyrtlePark,10/17/2015 08:00:00 PM,48,-122,4,0,4
15717,ElliotBayTrailMyrtlePark,10/17/2015 09:00:00 PM,48,-122,3,4,7
15718,ElliotBayTrailMyrtlePark,10/17/2015 10:00:00 PM,48,-122,19,1,20
15719,ElliotBayTrailMyrtlePark,10/17/2015 11:00:00 PM,48,-122,2,1,3
15720,ElliotBayTrailMyrtlePark,10/18/2015 12:00:00 AM,48,-122,0,0,0
15721,ElliotBayTrailMyrtlePark,10/18/2015 01:00:00 AM,48,-122,1,0,1
15722,ElliotBayTrailMyrtlePark,10/18/2015 02:00:00 AM,48,-122,0,1,1
15723,ElliotBayTrailMyrtlePark,10/18/2015 03:00:00 AM,48,-122,0,0,0
15724,ElliotBayTrailMyrtlePark,10/18/2015 04:00:00 AM,48,-122,0,0,0
15725,ElliotBayTrailMyrtlePark,10/18/2015 05:00:00 AM,48,-122,0,0,0
15726,ElliotBayTrailMyrtlePark,10/18/2015 06:00:00 AM,48,-122,0,4,4
15727,ElliotBayTrailMyrtlePark,10/18/2015 07:00:00 AM,48,-122,3,6,9
15728,ElliotBayTrailMyrtlePark,10/18/2015 08:00:00 AM,48,-122,3,5,8
15729,ElliotBayTrailMyrtlePark,10/18/2015 09:00:00 AM,48,-122,15,8,23
15730,ElliotBayTrailMyrtlePark,10/18/2015 10:00:00 AM,48,-122,26,30,56
15731,ElliotBayTrailMyrtlePark,10/18/2015 11:00:00 AM,48,-122,21,23,44
15732,ElliotBayTrailMyrtlePark,10/18/2015 12:00:00 PM,48,-122,8,16,24
15733,ElliotBayTrailMyrtlePark,10/18/2015 01:00:00 PM,48,-122,17,16,33
15734,ElliotBayTrailMyrtlePark,10/18/2015 02:00:00 PM,48,-122,11,12,23
15735,ElliotBayTrailMyrtlePark,10/18/2015 03:00:00 PM,48,-122,13,10,23
15736,ElliotBayTrailMyrtlePark,10/18/2015 04:00:00 PM,48,-122,25,18,43
15737,ElliotBayTrailMyrtlePark,10/18/2015 05:00:00 PM,48,-122,18,11,29
15738,ElliotBayTrailMyrtlePark,10/18/2015 06:00:00 PM,48,-122,13,3,16
15739,ElliotBayTrailMyrtlePark,10/18/2015 07:00:00 PM,48,-122,3,0,3
15740,ElliotBayTrailMyrtlePark,10/18/2015 08:00:00 PM,48,-122,4,1,5
15741,ElliotBayTrailMyrtlePark,10/18/2015 09:00:00 PM,48,-122,1,1,2
15742,ElliotBayTrailMyrtlePark,10/18/2015 10:00:00 PM,48,-122,3,0,3
15743,ElliotBayTrailMyrtlePark,10/18/2015 11:00:00 PM,48,-122,2,1,3
15744,ElliotBayTrailMyrtlePark,10/19/2015 12:00:00 AM,48,-122,2,0,2
15745,ElliotBayTrailMyrtlePark,10/19/2015 01:00:00 AM,48,-122,0,0,0
15746,ElliotBayTrailMyrtlePark,10/19/2015 02:00:00 AM,48,-122,1,0,1
15747,ElliotBayTrailMyrtlePark,10/19/2015 03:00:00 AM,48,-122,0,0,0
15748,ElliotBayTrailMyrtlePark,10/19/2015 04:00:00 AM,48,-122,0,0,0
15749,ElliotBayTrailMyrtlePark,10/19/2015 05:00:00 AM,48,-122,4,8,12
15750,ElliotBayTrailMyrtlePark,10/19/2015 06:00:00 AM,48,-122,14,16,30
15751,ElliotBayTrailMyrtlePark,10/19/2015 07:00:00 AM,48,-122,25,56,81
15752,ElliotBayTrailMyrtlePark,10/19/2015 08:00:00 AM,48,-122,32,141,173
15753,ElliotBayTrailMyrtlePark,10/19/2015 09:00:00 AM,48,-122,23,73,96
15754,ElliotBayTrailMyrtlePark,10/19/2015 10:00:00 AM,48,-122,12,25,37
15755,ElliotBayTrailMyrtlePark,10/19/2015 11:00:00 AM,48,-122,17,19,36
15756,ElliotBayTrailMyrtlePark,10/19/2015 12:00:00 PM,48,-122,13,18,31
15757,ElliotBayTrailMyrtlePark,10/19/2015 01:00:00 PM,48,-122,12,21,33
15758,ElliotBayTrailMyrtlePark,10/19/2015 02:00:00 PM,48,-122,51,27,78
15759,ElliotBayTrailMyrtlePark,10/19/2015 03:00:00 PM,48,-122,20,31,51
15760,ElliotBayTrailMyrtlePark,10/19/2015 04:00:00 PM,48,-122,56,53,109
15761,ElliotBayTrailMyrtlePark,10/19/2015 05:00:00 PM,48,-122,141,46,187
15762,ElliotBayTrailMyrtlePark,10/19/2015 06:00:00 PM,48,-122,123,35,158
15763,ElliotBayTrailMyrtlePark,10/19/2015 07:00:00 PM,48,-122,33,14,47
15764,ElliotBayTrailMyrtlePark,10/19/2015 08:00:00 PM,48,-122,10,2,12
15765,ElliotBayTrailMyrtlePark,10/19/2015 09:00:00 PM,48,-122,5,4,9
15766,ElliotBayTrailMyrtlePark,10/19/2015 10:00:00 PM,48,-122,3,2,5
15767,ElliotBayTrailMyrtlePark,10/19/2015 11:00:00 PM,48,-122,2,4,6
15768,ElliotBayTrailMyrtlePark,10/20/2015 12:00:00 AM,48,-122,2,0,2
15769,ElliotBayTrailMyrtlePark,10/20/2015 01:00:00 AM,48,-122,0,0,0
15770,ElliotBayTrailMyrtlePark,10/20/2015 02:00:00 AM,48,-122,0,0,0
15771,ElliotBayTrailMyrtlePark,10/20/2015 03:00:00 AM,48,-122,1,0,1
15772,ElliotBayTrailMyrtlePark,10/20/2015 04:00:00 AM,48,-122,1,0,1
15773,ElliotBayTrailMyrtlePark,10/20/2015 05:00:00 AM,48,-122,4,11,15
15774,ElliotBayTrailMyrtlePark,10/20/2015 06:00:00 AM,48,-122,17,26,43
15775,ElliotBayTrailMyrtlePark,10/20/2015 07:00:00 AM,48,-122,27,81,108
15776,ElliotBayTrailMyrtlePark,10/20/2015 08:00:00 AM,48,-122,35,175,210
15777,ElliotBayTrailMyrtlePark,10/20/2015 09:00:00 AM,48,-122,39,101,140
15778,ElliotBayTrailMyrtlePark,10/20/2015 10:00:00 AM,48,-122,19,28,47
15779,ElliotBayTrailMyrtlePark,10/20/2015 11:00:00 AM,48,-122,19,14,33
15780,ElliotBayTrailMyrtlePark,10/20/2015 12:00:00 PM,48,-122,24,15,39
15781,ElliotBayTrailMyrtlePark,10/20/2015 01:00:00 PM,48,-122,32,25,57
15782,ElliotBayTrailMyrtlePark,10/20/2015 02:00:00 PM,48,-122,27,30,57
15783,ElliotBayTrailMyrtlePark,10/20/2015 03:00:00 PM,48,-122,35,35,70
15784,ElliotBayTrailMyrtlePark,10/20/2015 04:00:00 PM,48,-122,86,72,158
15785,ElliotBayTrailMyrtlePark,10/20/2015 05:00:00 PM,48,-122,222,100,322
15786,ElliotBayTrailMyrtlePark,10/20/2015 06:00:00 PM,48,-122,138,72,210
15787,ElliotBayTrailMyrtlePark,10/20/2015 07:00:00 PM,48,-122,43,26,69
15788,ElliotBayTrailMyrtlePark,10/20/2015 08:00:00 PM,48,-122,16,4,20
15789,ElliotBayTrailMyrtlePark,10/20/2015 09:00:00 PM,48,-122,7,4,11
15790,ElliotBayTrailMyrtlePark,10/20/2015 10:00:00 PM,48,-122,6,7,13
15791,ElliotBayTrailMyrtlePark,10/20/2015 11:00:00 PM,48,-122,1,0,1
15792,ElliotBayTrailMyrtlePark,10/21/2015 12:00:00 AM,48,-122,2,0,2
15793,ElliotBayTrailMyrtlePark,10/21/2015 01:00:00 AM,48,-122,3,1,4
15794,ElliotBayTrailMyrtlePark,10/21/2015 02:00:00 AM,48,-122,0,0,0
15795,ElliotBayTrailMyrtlePark,10/21/2015 03:00:00 AM,48,-122,0,0,0
15796,ElliotBayTrailMyrtlePark,10/21/2015 04:00:00 AM,48,-122,1,0,1
15797,ElliotBayTrailMyrtlePark,10/21/2015 05:00:00 AM,48,-122,5,9,14
15798,ElliotBayTrailMyrtlePark,10/21/2015 06:00:00 AM,48,-122,17,21,38
15799,ElliotBayTrailMyrtlePark,10/21/2015 07:00:00 AM,48,-122,31,75,106
15800,ElliotBayTrailMyrtlePark,10/21/2015 08:00:00 AM,48,-122,37,150,187
15801,ElliotBayTrailMyrtlePark,10/21/2015 09:00:00 AM,48,-122,26,90,116
15802,ElliotBayTrailMyrtlePark,10/21/2015 10:00:00 AM,48,-122,14,28,42
15803,ElliotBayTrailMyrtlePark,10/21/2015 11:00:00 AM,48,-122,14,13,27
15804,ElliotBayTrailMyrtlePark,10/21/2015 12:00:00 PM,48,-122,15,20,35
15805,ElliotBayTrailMyrtlePark,10/21/2015 01:00:00 PM,48,-122,11,18,29
15806,ElliotBayTrailMyrtlePark,10/21/2015 02:00:00 PM,48,-122,18,25,43
15807,ElliotBayTrailMyrtlePark,10/21/2015 03:00:00 PM,48,-122,41,19,60
15808,ElliotBayTrailMyrtlePark,10/21/2015 04:00:00 PM,48,-122,62,42,104
15809,ElliotBayTrailMyrtlePark,10/21/2015 05:00:00 PM,48,-122,166,61,227
15810,ElliotBayTrailMyrtlePark,10/21/2015 06:00:00 PM,48,-122,138,52,190
15811,ElliotBayTrailMyrtlePark,10/21/2015 07:00:00 PM,48,-122,43,23,66
15812,ElliotBayTrailMyrtlePark,10/21/2015 08:00:00 PM,48,-122,12,6,18
15813,ElliotBayTrailMyrtlePark,10/21/2015 09:00:00 PM,48,-122,11,1,12
15814,ElliotBayTrailMyrtlePark,10/21/2015 10:00:00 PM,48,-122,9,5,14
15815,ElliotBayTrailMyrtlePark,10/21/2015 11:00:00 PM,48,-122,4,1,5
15816,ElliotBayTrailMyrtlePark,10/22/2015 12:00:00 AM,48,-122,4,0,4
15817,ElliotBayTrailMyrtlePark,10/22/2015 01:00:00 AM,48,-122,1,0,1
15818,ElliotBayTrailMyrtlePark,10/22/2015 02:00:00 AM,48,-122,0,0,0
15819,ElliotBayTrailMyrtlePark,10/22/2015 03:00:00 AM,48,-122,1,0,1
15820,ElliotBayTrailMyrtlePark,10/22/2015 04:00:00 AM,48,-122,1,0,1
15821,ElliotBayTrailMyrtlePark,10/22/2015 05:00:00 AM,48,-122,3,7,10
15822,ElliotBayTrailMyrtlePark,10/22/2015 06:00:00 AM,48,-122,14,26,40
15823,ElliotBayTrailMyrtlePark,10/22/2015 07:00:00 AM,48,-122,29,60,89
15824,ElliotBayTrailMyrtlePark,10/22/2015 08:00:00 AM,48,-122,33,150,183
15825,ElliotBayTrailMyrtlePark,10/22/2015 09:00:00 AM,48,-122,31,123,154
15826,ElliotBayTrailMyrtlePark,10/22/2015 10:00:00 AM,48,-122,16,24,40
15827,ElliotBayTrailMyrtlePark,10/22/2015 11:00:00 AM,48,-122,13,17,30
15828,ElliotBayTrailMyrtlePark,10/22/2015 12:00:00 PM,48,-122,20,18,38
15829,ElliotBayTrailMyrtlePark,10/22/2015 01:00:00 PM,48,-122,12,15,27
15830,ElliotBayTrailMyrtlePark,10/22/2015 02:00:00 PM,48,-122,28,30,58
15831,ElliotBayTrailMyrtlePark,10/22/2015 03:00:00 PM,48,-122,43,23,66
15832,ElliotBayTrailMyrtlePark,10/22/2015 04:00:00 PM,48,-122,70,46,116
15833,ElliotBayTrailMyrtlePark,10/22/2015 05:00:00 PM,48,-122,163,63,226
15834,ElliotBayTrailMyrtlePark,10/22/2015 06:00:00 PM,48,-122,115,40,155
15835,ElliotBayTrailMyrtlePark,10/22/2015 07:00:00 PM,48,-122,26,13,39
15836,ElliotBayTrailMyrtlePark,10/22/2015 08:00:00 PM,48,-122,16,6,22
15837,ElliotBayTrailMyrtlePark,10/22/2015 09:00:00 PM,48,-122,3,1,4
15838,ElliotBayTrailMyrtlePark,10/22/2015 10:00:00 PM,48,-122,9,9,18
15839,ElliotBayTrailMyrtlePark,10/22/2015 11:00:00 PM,48,-122,4,2,6
15840,ElliotBayTrailMyrtlePark,10/23/2015 12:00:00 AM,48,-122,1,8,9
15841,ElliotBayTrailMyrtlePark,10/23/2015 01:00:00 AM,48,-122,1,5,6
15842,ElliotBayTrailMyrtlePark,10/23/2015 02:00:00 AM,48,-122,0,6,6
15843,ElliotBayTrailMyrtlePark,10/23/2015 03:00:00 AM,48,-122,3,0,3
15844,ElliotBayTrailMyrtlePark,10/23/2015 04:00:00 AM,48,-122,0,0,0
15845,ElliotBayTrailMyrtlePark,10/23/2015 05:00:00 AM,48,-122,3,7,10
15846,ElliotBayTrailMyrtlePark,10/23/2015 06:00:00 AM,48,-122,12,16,28
15847,ElliotBayTrailMyrtlePark,10/23/2015 07:00:00 AM,48,-122,35,55,90
15848,ElliotBayTrailMyrtlePark,10/23/2015 08:00:00 AM,48,-122,34,131,165
15849,ElliotBayTrailMyrtlePark,10/23/2015 09:00:00 AM,48,-122,26,99,125
15850,ElliotBayTrailMyrtlePark,10/23/2015 10:00:00 AM,48,-122,11,23,34
15851,ElliotBayTrailMyrtlePark,10/23/2015 11:00:00 AM,48,-122,14,13,27
15852,ElliotBayTrailMyrtlePark,10/23/2015 12:00:00 PM,48,-122,15,16,31
15853,ElliotBayTrailMyrtlePark,10/23/2015 01:00:00 PM,48,-122,10,10,20
15854,ElliotBayTrailMyrtlePark,10/23/2015 02:00:00 PM,48,-122,22,14,36
15855,ElliotBayTrailMyrtlePark,10/23/2015 03:00:00 PM,48,-122,26,23,49
15856,ElliotBayTrailMyrtlePark,10/23/2015 04:00:00 PM,48,-122,69,41,110
15857,ElliotBayTrailMyrtlePark,10/23/2015 05:00:00 PM,48,-122,149,56,205
15858,ElliotBayTrailMyrtlePark,10/23/2015 06:00:00 PM,48,-122,102,28,130
15859,ElliotBayTrailMyrtlePark,10/23/2015 07:00:00 PM,48,-122,24,10,34
15860,ElliotBayTrailMyrtlePark,10/23/2015 08:00:00 PM,48,-122,9,4,13
15861,ElliotBayTrailMyrtlePark,10/23/2015 09:00:00 PM,48,-122,4,4,8
15862,ElliotBayTrailMyrtlePark,10/23/2015 10:00:00 PM,48,-122,11,10,21
15863,ElliotBayTrailMyrtlePark,10/23/2015 11:00:00 PM,48,-122,6,3,9
15864,ElliotBayTrailMyrtlePark,10/24/2015 12:00:00 AM,48,-122,2,2,4
15865,ElliotBayTrailMyrtlePark,10/24/2015 01:00:00 AM,48,-122,4,1,5
15866,ElliotBayTrailMyrtlePark,10/24/2015 02:00:00 AM,48,-122,0,0,0
15867,ElliotBayTrailMyrtlePark,10/24/2015 03:00:00 AM,48,-122,0,0,0
15868,ElliotBayTrailMyrtlePark,10/24/2015 04:00:00 AM,48,-122,0,0,0
15869,ElliotBayTrailMyrtlePark,10/24/2015 05:00:00 AM,48,-122,0,0,0
15870,ElliotBayTrailMyrtlePark,10/24/2015 06:00:00 AM,48,-122,1,2,3
15871,ElliotBayTrailMyrtlePark,10/24/2015 07:00:00 AM,48,-122,0,4,4
15872,ElliotBayTrailMyrtlePark,10/24/2015 08:00:00 AM,48,-122,5,10,15
15873,ElliotBayTrailMyrtlePark,10/24/2015 09:00:00 AM,48,-122,13,23,36
15874,ElliotBayTrailMyrtlePark,10/24/2015 10:00:00 AM,48,-122,14,22,36
15875,ElliotBayTrailMyrtlePark,10/24/2015 11:00:00 AM,48,-122,19,35,54
15876,ElliotBayTrailMyrtlePark,10/24/2015 12:00:00 PM,48,-122,16,14,30
15877,ElliotBayTrailMyrtlePark,10/24/2015 01:00:00 PM,48,-122,37,20,57
15878,ElliotBayTrailMyrtlePark,10/24/2015 02:00:00 PM,48,-122,28,12,40
15879,ElliotBayTrailMyrtlePark,10/24/2015 03:00:00 PM,48,-122,35,27,62
15880,ElliotBayTrailMyrtlePark,10/24/2015 04:00:00 PM,48,-122,23,21,44
15881,ElliotBayTrailMyrtlePark,10/24/2015 05:00:00 PM,48,-122,29,28,57
15882,ElliotBayTrailMyrtlePark,10/24/2015 06:00:00 PM,48,-122,18,26,44
15883,ElliotBayTrailMyrtlePark,10/24/2015 07:00:00 PM,48,-122,8,7,15
15884,ElliotBayTrailMyrtlePark,10/24/2015 08:00:00 PM,48,-122,5,1,6
15885,ElliotBayTrailMyrtlePark,10/24/2015 09:00:00 PM,48,-122,3,1,4
15886,ElliotBayTrailMyrtlePark,10/24/2015 10:00:00 PM,48,-122,3,3,6
15887,ElliotBayTrailMyrtlePark,10/24/2015 11:00:00 PM,48,-122,0,1,1
15888,ElliotBayTrailMyrtlePark,10/25/2015 12:00:00 AM,48,-122,2,0,2
15889,ElliotBayTrailMyrtlePark,10/25/2015 01:00:00 AM,48,-122,0,0,0
15890,ElliotBayTrailMyrtlePark,10/25/2015 02:00:00 AM,48,-122,1,1,2
15891,ElliotBayTrailMyrtlePark,10/25/2015 03:00:00 AM,48,-122,1,0,1
15892,ElliotBayTrailMyrtlePark,10/25/2015 04:00:00 AM,48,-122,0,0,0
15893,ElliotBayTrailMyrtlePark,10/25/2015 05:00:00 AM,48,-122,0,0,0
15894,ElliotBayTrailMyrtlePark,10/25/2015 06:00:00 AM,48,-122,0,1,1
15895,ElliotBayTrailMyrtlePark,10/25/2015 07:00:00 AM,48,-122,1,6,7
15896,ElliotBayTrailMyrtlePark,10/25/2015 08:00:00 AM,48,-122,12,3,15
15897,ElliotBayTrailMyrtlePark,10/25/2015 09:00:00 AM,48,-122,14,22,36
15898,ElliotBayTrailMyrtlePark,10/25/2015 10:00:00 AM,48,-122,21,23,44
15899,ElliotBayTrailMyrtlePark,10/25/2015 11:00:00 AM,48,-122,31,17,48
15900,ElliotBayTrailMyrtlePark,10/25/2015 12:00:00 PM,48,-122,36,42,78
15901,ElliotBayTrailMyrtlePark,10/25/2015 01:00:00 PM,48,-122,33,36,69
15902,ElliotBayTrailMyrtlePark,10/25/2015 02:00:00 PM,48,-122,26,40,66
15903,ElliotBayTrailMyrtlePark,10/25/2015 03:00:00 PM,48,-122,29,36,65
15904,ElliotBayTrailMyrtlePark,10/25/2015 04:00:00 PM,48,-122,25,19,44
15905,ElliotBayTrailMyrtlePark,10/25/2015 05:00:00 PM,48,-122,8,12,20
15906,ElliotBayTrailMyrtlePark,10/25/2015 06:00:00 PM,48,-122,10,4,14
15907,ElliotBayTrailMyrtlePark,10/25/2015 07:00:00 PM,48,-122,18,1,19
15908,ElliotBayTrailMyrtlePark,10/25/2015 08:00:00 PM,48,-122,2,0,2
15909,ElliotBayTrailMyrtlePark,10/25/2015 09:00:00 PM,48,-122,1,0,1
15910,ElliotBayTrailMyrtlePark,10/25/2015 10:00:00 PM,48,-122,0,0,0
15911,ElliotBayTrailMyrtlePark,10/25/2015 11:00:00 PM,48,-122,0,0,0
15912,ElliotBayTrailMyrtlePark,10/26/2015 12:00:00 AM,48,-122,2,2,4
15913,ElliotBayTrailMyrtlePark,10/26/2015 01:00:00 AM,48,-122,0,0,0
15914,ElliotBayTrailMyrtlePark,10/26/2015 02:00:00 AM,48,-122,0,0,0
15915,ElliotBayTrailMyrtlePark,10/26/2015 03:00:00 AM,48,-122,0,0,0
15916,ElliotBayTrailMyrtlePark,10/26/2015 04:00:00 AM,48,-122,0,0,0
15917,ElliotBayTrailMyrtlePark,10/26/2015 05:00:00 AM,48,-122,5,4,9
15918,ElliotBayTrailMyrtlePark,10/26/2015 06:00:00 AM,48,-122,11,14,25
15919,ElliotBayTrailMyrtlePark,10/26/2015 07:00:00 AM,48,-122,26,36,62
15920,ElliotBayTrailMyrtlePark,10/26/2015 08:00:00 AM,48,-122,31,103,134
15921,ElliotBayTrailMyrtlePark,10/26/2015 09:00:00 AM,48,-122,14,74,88
15922,ElliotBayTrailMyrtlePark,10/26/2015 10:00:00 AM,48,-122,9,15,24
15923,ElliotBayTrailMyrtlePark,10/26/2015 11:00:00 AM,48,-122,5,7,12
15924,ElliotBayTrailMyrtlePark,10/26/2015 12:00:00 PM,48,-122,7,5,12
15925,ElliotBayTrailMyrtlePark,10/26/2015 01:00:00 PM,48,-122,5,9,14
15926,ElliotBayTrailMyrtlePark,10/26/2015 02:00:00 PM,48,-122,2,8,10
15927,ElliotBayTrailMyrtlePark,10/26/2015 03:00:00 PM,48,-122,13,11,24
15928,ElliotBayTrailMyrtlePark,10/26/2015 04:00:00 PM,48,-122,33,22,55
15929,ElliotBayTrailMyrtlePark,10/26/2015 05:00:00 PM,48,-122,112,45,157
15930,ElliotBayTrailMyrtlePark,10/26/2015 06:00:00 PM,48,-122,95,18,113
15931,ElliotBayTrailMyrtlePark,10/26/2015 07:00:00 PM,48,-122,33,9,42
15932,ElliotBayTrailMyrtlePark,10/26/2015 08:00:00 PM,48,-122,22,7,29
15933,ElliotBayTrailMyrtlePark,10/26/2015 09:00:00 PM,48,-122,2,2,4
15934,ElliotBayTrailMyrtlePark,10/26/2015 10:00:00 PM,48,-122,1,3,4
15935,ElliotBayTrailMyrtlePark,10/26/2015 11:00:00 PM,48,-122,1,1,2
15936,ElliotBayTrailMyrtlePark,10/27/2015 12:00:00 AM,48,-122,1,0,1
15937,ElliotBayTrailMyrtlePark,10/27/2015 01:00:00 AM,48,-122,0,0,0
15938,ElliotBayTrailMyrtlePark,10/27/2015 02:00:00 AM,48,-122,2,0,2
15939,ElliotBayTrailMyrtlePark,10/27/2015 03:00:00 AM,48,-122,1,1,2
15940,ElliotBayTrailMyrtlePark,10/27/2015 04:00:00 AM,48,-122,0,0,0
15941,ElliotBayTrailMyrtlePark,10/27/2015 05:00:00 AM,48,-122,3,9,12
15942,ElliotBayTrailMyrtlePark,10/27/2015 06:00:00 AM,48,-122,18,24,42
15943,ElliotBayTrailMyrtlePark,10/27/2015 07:00:00 AM,48,-122,26,56,82
15944,ElliotBayTrailMyrtlePark,10/27/2015 08:00:00 AM,48,-122,36,165,201
15945,ElliotBayTrailMyrtlePark,10/27/2015 09:00:00 AM,48,-122,33,123,156
15946,ElliotBayTrailMyrtlePark,10/27/2015 10:00:00 AM,48,-122,16,23,39
15947,ElliotBayTrailMyrtlePark,10/27/2015 11:00:00 AM,48,-122,22,18,40
15948,ElliotBayTrailMyrtlePark,10/27/2015 12:00:00 PM,48,-122,19,10,29
15949,ElliotBayTrailMyrtlePark,10/27/2015 01:00:00 PM,48,-122,16,21,37
15950,ElliotBayTrailMyrtlePark,10/27/2015 02:00:00 PM,48,-122,27,16,43
15951,ElliotBayTrailMyrtlePark,10/27/2015 03:00:00 PM,48,-122,34,31,65
15952,ElliotBayTrailMyrtlePark,10/27/2015 04:00:00 PM,48,-122,76,53,129
15953,ElliotBayTrailMyrtlePark,10/27/2015 05:00:00 PM,48,-122,197,61,258
15954,ElliotBayTrailMyrtlePark,10/27/2015 06:00:00 PM,48,-122,147,52,199
15955,ElliotBayTrailMyrtlePark,10/27/2015 07:00:00 PM,48,-122,42,24,66
15956,ElliotBayTrailMyrtlePark,10/27/2015 08:00:00 PM,48,-122,22,9,31
15957,ElliotBayTrailMyrtlePark,10/27/2015 09:00:00 PM,48,-122,4,1,5
15958,ElliotBayTrailMyrtlePark,10/27/2015 10:00:00 PM,48,-122,6,13,19
15959,ElliotBayTrailMyrtlePark,10/27/2015 11:00:00 PM,48,-122,1,2,3
15960,ElliotBayTrailMyrtlePark,10/28/2015 12:00:00 AM,48,-122,4,2,6
15961,ElliotBayTrailMyrtlePark,10/28/2015 01:00:00 AM,48,-122,8,3,11
15962,ElliotBayTrailMyrtlePark,10/28/2015 02:00:00 AM,48,-122,0,1,1
15963,ElliotBayTrailMyrtlePark,10/28/2015 03:00:00 AM,48,-122,1,0,1
15964,ElliotBayTrailMyrtlePark,10/28/2015 04:00:00 AM,48,-122,0,0,0
15965,ElliotBayTrailMyrtlePark,10/28/2015 05:00:00 AM,48,-122,4,6,10
15966,ElliotBayTrailMyrtlePark,10/28/2015 06:00:00 AM,48,-122,16,15,31
15967,ElliotBayTrailMyrtlePark,10/28/2015 07:00:00 AM,48,-122,23,48,71
15968,ElliotBayTrailMyrtlePark,10/28/2015 08:00:00 AM,48,-122,26,112,138
15969,ElliotBayTrailMyrtlePark,10/28/2015 09:00:00 AM,48,-122,31,79,110
15970,ElliotBayTrailMyrtlePark,10/28/2015 10:00:00 AM,48,-122,12,18,30
15971,ElliotBayTrailMyrtlePark,10/28/2015 11:00:00 AM,48,-122,6,10,16
15972,ElliotBayTrailMyrtlePark,10/28/2015 12:00:00 PM,48,-122,7,10,17
15973,ElliotBayTrailMyrtlePark,10/28/2015 01:00:00 PM,48,-122,9,5,14
15974,ElliotBayTrailMyrtlePark,10/28/2015 02:00:00 PM,48,-122,12,10,22
15975,ElliotBayTrailMyrtlePark,10/28/2015 03:00:00 PM,48,-122,19,14,33
15976,ElliotBayTrailMyrtlePark,10/28/2015 04:00:00 PM,48,-122,44,24,68
15977,ElliotBayTrailMyrtlePark,10/28/2015 05:00:00 PM,48,-122,121,40,161
15978,ElliotBayTrailMyrtlePark,10/28/2015 06:00:00 PM,48,-122,101,46,147
15979,ElliotBayTrailMyrtlePark,10/28/2015 07:00:00 PM,48,-122,23,13,36
15980,ElliotBayTrailMyrtlePark,10/28/2015 08:00:00 PM,48,-122,9,1,10
15981,ElliotBayTrailMyrtlePark,10/28/2015 09:00:00 PM,48,-122,6,1,7
15982,ElliotBayTrailMyrtlePark,10/28/2015 10:00:00 PM,48,-122,23,3,26
15983,ElliotBayTrailMyrtlePark,10/28/2015 11:00:00 PM,48,-122,8,2,10
15984,ElliotBayTrailMyrtlePark,10/29/2015 12:00:00 AM,48,-122,1,0,1
15985,ElliotBayTrailMyrtlePark,10/29/2015 01:00:00 AM,48,-122,1,0,1
15986,ElliotBayTrailMyrtlePark,10/29/2015 02:00:00 AM,48,-122,0,0,0
15987,ElliotBayTrailMyrtlePark,10/29/2015 03:00:00 AM,48,-122,1,0,1
15988,ElliotBayTrailMyrtlePark,10/29/2015 04:00:00 AM,48,-122,0,0,0
15989,ElliotBayTrailMyrtlePark,10/29/2015 05:00:00 AM,48,-122,4,5,9
15990,ElliotBayTrailMyrtlePark,10/29/2015 06:00:00 AM,48,-122,17,18,35
15991,ElliotBayTrailMyrtlePark,10/29/2015 07:00:00 AM,48,-122,27,44,71
15992,ElliotBayTrailMyrtlePark,10/29/2015 08:00:00 AM,48,-122,23,114,137
15993,ElliotBayTrailMyrtlePark,10/29/2015 09:00:00 AM,48,-122,29,98,127
15994,ElliotBayTrailMyrtlePark,10/29/2015 10:00:00 AM,48,-122,11,30,41
15995,ElliotBayTrailMyrtlePark,10/29/2015 11:00:00 AM,48,-122,12,15,27
15996,ElliotBayTrailMyrtlePark,10/29/2015 12:00:00 PM,48,-122,16,12,28
15997,ElliotBayTrailMyrtlePark,10/29/2015 01:00:00 PM,48,-122,13,9,22
15998,ElliotBayTrailMyrtlePark,10/29/2015 02:00:00 PM,48,-122,12,16,28
15999,ElliotBayTrailMyrtlePark,10/29/2015 03:00:00 PM,48,-122,22,15,37
16000,ElliotBayTrailMyrtlePark,10/29/2015 04:00:00 PM,48,-122,52,27,79
16001,ElliotBayTrailMyrtlePark,10/29/2015 05:00:00 PM,48,-122,119,51,170
16002,ElliotBayTrailMyrtlePark,10/29/2015 06:00:00 PM,48,-122,124,34,158
16003,ElliotBayTrailMyrtlePark,10/29/2015 07:00:00 PM,48,-122,33,10,43
16004,ElliotBayTrailMyrtlePark,10/29/2015 08:00:00 PM,48,-122,10,3,13
16005,ElliotBayTrailMyrtlePark,10/29/2015 09:00:00 PM,48,-122,4,1,5
16006,ElliotBayTrailMyrtlePark,10/29/2015 10:00:00 PM,48,-122,9,4,13
16007,ElliotBayTrailMyrtlePark,10/29/2015 11:00:00 PM,48,-122,7,1,8
16008,ElliotBayTrailMyrtlePark,10/30/2015 12:00:00 AM,48,-122,0,3,3
16009,ElliotBayTrailMyrtlePark,10/30/2015 01:00:00 AM,48,-122,0,0,0
16010,ElliotBayTrailMyrtlePark,10/30/2015 02:00:00 AM,48,-122,1,0,1
16011,ElliotBayTrailMyrtlePark,10/30/2015 03:00:00 AM,48,-122,1,0,1
16012,ElliotBayTrailMyrtlePark,10/30/2015 04:00:00 AM,48,-122,1,0,1
16013,ElliotBayTrailMyrtlePark,10/30/2015 05:00:00 AM,48,-122,3,4,7
16014,ElliotBayTrailMyrtlePark,10/30/2015 06:00:00 AM,48,-122,10,9,19
16015,ElliotBayTrailMyrtlePark,10/30/2015 07:00:00 AM,48,-122,15,31,46
16016,ElliotBayTrailMyrtlePark,10/30/2015 08:00:00 AM,48,-122,16,63,79
16017,ElliotBayTrailMyrtlePark,10/30/2015 09:00:00 AM,48,-122,22,56,78
16018,ElliotBayTrailMyrtlePark,10/30/2015 10:00:00 AM,48,-122,7,17,24
16019,ElliotBayTrailMyrtlePark,10/30/2015 11:00:00 AM,48,-122,7,7,14
16020,ElliotBayTrailMyrtlePark,10/30/2015 12:00:00 PM,48,-122,7,6,13
16021,ElliotBayTrailMyrtlePark,10/30/2015 01:00:00 PM,48,-122,12,11,23
16022,ElliotBayTrailMyrtlePark,10/30/2015 02:00:00 PM,48,-122,13,19,32
16023,ElliotBayTrailMyrtlePark,10/30/2015 03:00:00 PM,48,-122,23,21,44
16024,ElliotBayTrailMyrtlePark,10/30/2015 04:00:00 PM,48,-122,46,29,75
16025,ElliotBayTrailMyrtlePark,10/30/2015 05:00:00 PM,48,-122,90,28,118
16026,ElliotBayTrailMyrtlePark,10/30/2015 06:00:00 PM,48,-122,57,14,71
16027,ElliotBayTrailMyrtlePark,10/30/2015 07:00:00 PM,48,-122,12,4,16
16028,ElliotBayTrailMyrtlePark,10/30/2015 08:00:00 PM,48,-122,84,10,94
16029,ElliotBayTrailMyrtlePark,10/30/2015 09:00:00 PM,48,-122,1,3,4
16030,ElliotBayTrailMyrtlePark,10/30/2015 10:00:00 PM,48,-122,0,0,0
16031,ElliotBayTrailMyrtlePark,10/30/2015 11:00:00 PM,48,-122,0,0,0
16032,ElliotBayTrailMyrtlePark,10/31/2015 12:00:00 AM,48,-122,1,0,1
16033,ElliotBayTrailMyrtlePark,10/31/2015 01:00:00 AM,48,-122,1,0,1
16034,ElliotBayTrailMyrtlePark,10/31/2015 02:00:00 AM,48,-122,0,0,0
16035,ElliotBayTrailMyrtlePark,10/31/2015 03:00:00 AM,48,-122,0,0,0
16036,ElliotBayTrailMyrtlePark,10/31/2015 04:00:00 AM,48,-122,1,0,1
16037,ElliotBayTrailMyrtlePark,10/31/2015 05:00:00 AM,48,-122,0,1,1
16038,ElliotBayTrailMyrtlePark,10/31/2015 06:00:00 AM,48,-122,0,3,3
16039,ElliotBayTrailMyrtlePark,10/31/2015 07:00:00 AM,48,-122,0,6,6
16040,ElliotBayTrailMyrtlePark,10/31/2015 08:00:00 AM,48,-122,3,6,9
16041,ElliotBayTrailMyrtlePark,10/31/2015 09:00:00 AM,48,-122,3,2,5
16042,ElliotBayTrailMyrtlePark,10/31/2015 10:00:00 AM,48,-122,2,5,7
16043,ElliotBayTrailMyrtlePark,10/31/2015 11:00:00 AM,48,-122,5,1,6
16044,ElliotBayTrailMyrtlePark,10/31/2015 12:00:00 PM,48,-122,10,4,14
16045,ElliotBayTrailMyrtlePark,10/31/2015 01:00:00 PM,48,-122,11,3,14
16046,ElliotBayTrailMyrtlePark,10/31/2015 02:00:00 PM,48,-122,5,11,16
16047,ElliotBayTrailMyrtlePark,10/31/2015 03:00:00 PM,48,-122,10,8,18
16048,ElliotBayTrailMyrtlePark,10/31/2015 04:00:00 PM,48,-122,3,6,9
16049,ElliotBayTrailMyrtlePark,10/31/2015 05:00:00 PM,48,-122,12,3,15
16050,ElliotBayTrailMyrtlePark,10/31/2015 06:00:00 PM,48,-122,4,1,5
16051,ElliotBayTrailMyrtlePark,10/31/2015 07:00:00 PM,48,-122,2,2,4
16052,ElliotBayTrailMyrtlePark,10/31/2015 08:00:00 PM,48,-122,2,3,5
16053,ElliotBayTrailMyrtlePark,10/31/2015 09:00:00 PM,48,-122,0,1,1
16054,ElliotBayTrailMyrtlePark,10/31/2015 10:00:00 PM,48,-122,0,2,2
16055,ElliotBayTrailMyrtlePark,10/31/2015 11:00:00 PM,48,-122,0,0,0
16056,ElliotBayTrailMyrtlePark,11/01/2015 12:00:00 AM,48,-122,2,10,12
16057,ElliotBayTrailMyrtlePark,11/01/2015 01:00:00 AM,48,-122,1,2,3
16058,ElliotBayTrailMyrtlePark,11/01/2015 02:00:00 AM,48,-122,0,0,0
16059,ElliotBayTrailMyrtlePark,11/01/2015 03:00:00 AM,48,-122,0,0,0
16060,ElliotBayTrailMyrtlePark,11/01/2015 04:00:00 AM,48,-122,1,0,1
16061,ElliotBayTrailMyrtlePark,11/01/2015 05:00:00 AM,48,-122,0,0,0
16062,ElliotBayTrailMyrtlePark,11/01/2015 06:00:00 AM,48,-122,1,3,4
16063,ElliotBayTrailMyrtlePark,11/01/2015 07:00:00 AM,48,-122,1,2,3
16064,ElliotBayTrailMyrtlePark,11/01/2015 08:00:00 AM,48,-122,14,5,19
16065,ElliotBayTrailMyrtlePark,11/01/2015 09:00:00 AM,48,-122,23,16,39
16066,ElliotBayTrailMyrtlePark,11/01/2015 10:00:00 AM,48,-122,21,20,41
16067,ElliotBayTrailMyrtlePark,11/01/2015 11:00:00 AM,48,-122,10,7,17
16068,ElliotBayTrailMyrtlePark,11/01/2015 12:00:00 PM,48,-122,9,3,12
16069,ElliotBayTrailMyrtlePark,11/01/2015 01:00:00 PM,48,-122,1,3,4
16070,ElliotBayTrailMyrtlePark,11/01/2015 02:00:00 PM,48,-122,9,3,12
16071,ElliotBayTrailMyrtlePark,11/01/2015 03:00:00 PM,48,-122,4,3,7
16072,ElliotBayTrailMyrtlePark,11/01/2015 04:00:00 PM,48,-122,5,5,10
16073,ElliotBayTrailMyrtlePark,11/01/2015 05:00:00 PM,48,-122,5,8,13
16074,ElliotBayTrailMyrtlePark,11/01/2015 06:00:00 PM,48,-122,4,9,13
16075,ElliotBayTrailMyrtlePark,11/01/2015 07:00:00 PM,48,-122,1,1,2
16076,ElliotBayTrailMyrtlePark,11/01/2015 08:00:00 PM,48,-122,0,2,2
16077,ElliotBayTrailMyrtlePark,11/01/2015 09:00:00 PM,48,-122,14,3,17
16078,ElliotBayTrailMyrtlePark,11/01/2015 10:00:00 PM,48,-122,2,2,4
16079,ElliotBayTrailMyrtlePark,11/01/2015 11:00:00 PM,48,-122,3,1,4
16080,ElliotBayTrailMyrtlePark,11/02/2015 12:00:00 AM,48,-122,0,0,0
16081,ElliotBayTrailMyrtlePark,11/02/2015 01:00:00 AM,48,-122,0,0,0
16082,ElliotBayTrailMyrtlePark,11/02/2015 02:00:00 AM,48,-122,1,0,1
16083,ElliotBayTrailMyrtlePark,11/02/2015 03:00:00 AM,48,-122,0,0,0
16084,ElliotBayTrailMyrtlePark,11/02/2015 04:00:00 AM,48,-122,0,0,0
16085,ElliotBayTrailMyrtlePark,11/02/2015 05:00:00 AM,48,-122,4,6,10
16086,ElliotBayTrailMyrtlePark,11/02/2015 06:00:00 AM,48,-122,12,19,31
16087,ElliotBayTrailMyrtlePark,11/02/2015 07:00:00 AM,48,-122,29,55,84
16088,ElliotBayTrailMyrtlePark,11/02/2015 08:00:00 AM,48,-122,30,143,173
16089,ElliotBayTrailMyrtlePark,11/02/2015 09:00:00 AM,48,-122,24,85,109
16090,ElliotBayTrailMyrtlePark,11/02/2015 10:00:00 AM,48,-122,10,15,25
16091,ElliotBayTrailMyrtlePark,11/02/2015 11:00:00 AM,48,-122,7,7,14
16092,ElliotBayTrailMyrtlePark,11/02/2015 12:00:00 PM,48,-122,8,9,17
16093,ElliotBayTrailMyrtlePark,11/02/2015 01:00:00 PM,48,-122,10,10,20
16094,ElliotBayTrailMyrtlePark,11/02/2015 02:00:00 PM,48,-122,13,17,30
16095,ElliotBayTrailMyrtlePark,11/02/2015 03:00:00 PM,48,-122,20,11,31
16096,ElliotBayTrailMyrtlePark,11/02/2015 04:00:00 PM,48,-122,53,31,84
16097,ElliotBayTrailMyrtlePark,11/02/2015 05:00:00 PM,48,-122,149,35,184
16098,ElliotBayTrailMyrtlePark,11/02/2015 06:00:00 PM,48,-122,112,28,140
16099,ElliotBayTrailMyrtlePark,11/02/2015 07:00:00 PM,48,-122,26,9,35
16100,ElliotBayTrailMyrtlePark,11/02/2015 08:00:00 PM,48,-122,8,2,10
16101,ElliotBayTrailMyrtlePark,11/02/2015 09:00:00 PM,48,-122,1,5,6
16102,ElliotBayTrailMyrtlePark,11/02/2015 10:00:00 PM,48,-122,2,0,2
16103,ElliotBayTrailMyrtlePark,11/02/2015 11:00:00 PM,48,-122,0,0,0
16104,ElliotBayTrailMyrtlePark,11/03/2015 12:00:00 AM,48,-122,2,0,2
16105,ElliotBayTrailMyrtlePark,11/03/2015 01:00:00 AM,48,-122,1,0,1
16106,ElliotBayTrailMyrtlePark,11/03/2015 02:00:00 AM,48,-122,4,0,4
16107,ElliotBayTrailMyrtlePark,11/03/2015 03:00:00 AM,48,-122,0,0,0
16108,ElliotBayTrailMyrtlePark,11/03/2015 04:00:00 AM,48,-122,0,0,0
16109,ElliotBayTrailMyrtlePark,11/03/2015 05:00:00 AM,48,-122,3,7,10
16110,ElliotBayTrailMyrtlePark,11/03/2015 06:00:00 AM,48,-122,17,23,40
16111,ElliotBayTrailMyrtlePark,11/03/2015 07:00:00 AM,48,-122,27,64,91
16112,ElliotBayTrailMyrtlePark,11/03/2015 08:00:00 AM,48,-122,29,137,166
16113,ElliotBayTrailMyrtlePark,11/03/2015 09:00:00 AM,48,-122,39,71,110
16114,ElliotBayTrailMyrtlePark,11/03/2015 10:00:00 AM,48,-122,11,35,46
16115,ElliotBayTrailMyrtlePark,11/03/2015 11:00:00 AM,48,-122,7,6,13
16116,ElliotBayTrailMyrtlePark,11/03/2015 12:00:00 PM,48,-122,9,10,19
16117,ElliotBayTrailMyrtlePark,11/03/2015 01:00:00 PM,48,-122,9,11,20
16118,ElliotBayTrailMyrtlePark,11/03/2015 02:00:00 PM,48,-122,22,23,45
16119,ElliotBayTrailMyrtlePark,11/03/2015 03:00:00 PM,48,-122,27,18,45
16120,ElliotBayTrailMyrtlePark,11/03/2015 04:00:00 PM,48,-122,62,41,103
16121,ElliotBayTrailMyrtlePark,11/03/2015 05:00:00 PM,48,-122,138,68,206
16122,ElliotBayTrailMyrtlePark,11/03/2015 06:00:00 PM,48,-122,124,26,150
16123,ElliotBayTrailMyrtlePark,11/03/2015 07:00:00 PM,48,-122,30,4,34
16124,ElliotBayTrailMyrtlePark,11/03/2015 08:00:00 PM,48,-122,9,1,10
16125,ElliotBayTrailMyrtlePark,11/03/2015 09:00:00 PM,48,-122,10,3,13
16126,ElliotBayTrailMyrtlePark,11/03/2015 10:00:00 PM,48,-122,3,1,4
16127,ElliotBayTrailMyrtlePark,11/03/2015 11:00:00 PM,48,-122,4,1,5
16128,ElliotBayTrailMyrtlePark,11/04/2015 12:00:00 AM,48,-122,4,0,4
16129,ElliotBayTrailMyrtlePark,11/04/2015 01:00:00 AM,48,-122,1,0,1
16130,ElliotBayTrailMyrtlePark,11/04/2015 02:00:00 AM,48,-122,0,0,0
16131,ElliotBayTrailMyrtlePark,11/04/2015 03:00:00 AM,48,-122,1,0,1
16132,ElliotBayTrailMyrtlePark,11/04/2015 04:00:00 AM,48,-122,0,1,1
16133,ElliotBayTrailMyrtlePark,11/04/2015 05:00:00 AM,48,-122,3,7,10
16134,ElliotBayTrailMyrtlePark,11/04/2015 06:00:00 AM,48,-122,11,17,28
16135,ElliotBayTrailMyrtlePark,11/04/2015 07:00:00 AM,48,-122,31,64,95
16136,ElliotBayTrailMyrtlePark,11/04/2015 08:00:00 AM,48,-122,40,152,192
16137,ElliotBayTrailMyrtlePark,11/04/2015 09:00:00 AM,48,-122,22,97,119
16138,ElliotBayTrailMyrtlePark,11/04/2015 10:00:00 AM,48,-122,20,38,58
16139,ElliotBayTrailMyrtlePark,11/04/2015 11:00:00 AM,48,-122,12,9,21
16140,ElliotBayTrailMyrtlePark,11/04/2015 12:00:00 PM,48,-122,31,21,52
16141,ElliotBayTrailMyrtlePark,11/04/2015 01:00:00 PM,48,-122,15,16,31
16142,ElliotBayTrailMyrtlePark,11/04/2015 02:00:00 PM,48,-122,19,24,43
16143,ElliotBayTrailMyrtlePark,11/04/2015 03:00:00 PM,48,-122,24,24,48
16144,ElliotBayTrailMyrtlePark,11/04/2015 04:00:00 PM,48,-122,57,38,95
16145,ElliotBayTrailMyrtlePark,11/04/2015 05:00:00 PM,48,-122,160,50,210
16146,ElliotBayTrailMyrtlePark,11/04/2015 06:00:00 PM,48,-122,122,26,148
16147,ElliotBayTrailMyrtlePark,11/04/2015 07:00:00 PM,48,-122,54,13,67
16148,ElliotBayTrailMyrtlePark,11/04/2015 08:00:00 PM,48,-122,12,2,14
16149,ElliotBayTrailMyrtlePark,11/04/2015 09:00:00 PM,48,-122,8,5,13
16150,ElliotBayTrailMyrtlePark,11/04/2015 10:00:00 PM,48,-122,5,2,7
16151,ElliotBayTrailMyrtlePark,11/04/2015 11:00:00 PM,48,-122,3,1,4
16152,ElliotBayTrailMyrtlePark,11/05/2015 12:00:00 AM,48,-122,3,1,4
16153,ElliotBayTrailMyrtlePark,11/05/2015 01:00:00 AM,48,-122,2,0,2
16154,ElliotBayTrailMyrtlePark,11/05/2015 02:00:00 AM,48,-122,0,0,0
16155,ElliotBayTrailMyrtlePark,11/05/2015 03:00:00 AM,48,-122,0,0,0
16156,ElliotBayTrailMyrtlePark,11/05/2015 04:00:00 AM,48,-122,1,0,1
16157,ElliotBayTrailMyrtlePark,11/05/2015 05:00:00 AM,48,-122,5,3,8
16158,ElliotBayTrailMyrtlePark,11/05/2015 06:00:00 AM,48,-122,15,17,32
16159,ElliotBayTrailMyrtlePark,11/05/2015 07:00:00 AM,48,-122,31,47,78
16160,ElliotBayTrailMyrtlePark,11/05/2015 08:00:00 AM,48,-122,29,131,160
16161,ElliotBayTrailMyrtlePark,11/05/2015 09:00:00 AM,48,-122,34,81,115
16162,ElliotBayTrailMyrtlePark,11/05/2015 10:00:00 AM,48,-122,24,24,48
16163,ElliotBayTrailMyrtlePark,11/05/2015 11:00:00 AM,48,-122,12,11,23
16164,ElliotBayTrailMyrtlePark,11/05/2015 12:00:00 PM,48,-122,12,15,27
16165,ElliotBayTrailMyrtlePark,11/05/2015 01:00:00 PM,48,-122,12,7,19
16166,ElliotBayTrailMyrtlePark,11/05/2015 02:00:00 PM,48,-122,13,13,26
16167,ElliotBayTrailMyrtlePark,11/05/2015 03:00:00 PM,48,-122,28,13,41
16168,ElliotBayTrailMyrtlePark,11/05/2015 04:00:00 PM,48,-122,41,39,80
16169,ElliotBayTrailMyrtlePark,11/05/2015 05:00:00 PM,48,-122,131,43,174
16170,ElliotBayTrailMyrtlePark,11/05/2015 06:00:00 PM,48,-122,92,15,107
16171,ElliotBayTrailMyrtlePark,11/05/2015 07:00:00 PM,48,-122,31,9,40
16172,ElliotBayTrailMyrtlePark,11/05/2015 08:00:00 PM,48,-122,11,1,12
16173,ElliotBayTrailMyrtlePark,11/05/2015 09:00:00 PM,48,-122,7,2,9
16174,ElliotBayTrailMyrtlePark,11/05/2015 10:00:00 PM,48,-122,4,4,8
16175,ElliotBayTrailMyrtlePark,11/05/2015 11:00:00 PM,48,-122,1,1,2
16176,ElliotBayTrailMyrtlePark,11/06/2015 12:00:00 AM,48,-122,0,0,0
16177,ElliotBayTrailMyrtlePark,11/06/2015 01:00:00 AM,48,-122,0,0,0
16178,ElliotBayTrailMyrtlePark,11/06/2015 02:00:00 AM,48,-122,0,0,0
16179,ElliotBayTrailMyrtlePark,11/06/2015 03:00:00 AM,48,-122,1,0,1
16180,ElliotBayTrailMyrtlePark,11/06/2015 04:00:00 AM,48,-122,4,0,4
16181,ElliotBayTrailMyrtlePark,11/06/2015 05:00:00 AM,48,-122,3,5,8
16182,ElliotBayTrailMyrtlePark,11/06/2015 06:00:00 AM,48,-122,10,17,27
16183,ElliotBayTrailMyrtlePark,11/06/2015 07:00:00 AM,48,-122,25,47,72
16184,ElliotBayTrailMyrtlePark,11/06/2015 08:00:00 AM,48,-122,23,105,128
16185,ElliotBayTrailMyrtlePark,11/06/2015 09:00:00 AM,48,-122,25,57,82
16186,ElliotBayTrailMyrtlePark,11/06/2015 10:00:00 AM,48,-122,11,22,33
16187,ElliotBayTrailMyrtlePark,11/06/2015 11:00:00 AM,48,-122,7,7,14
16188,ElliotBayTrailMyrtlePark,11/06/2015 12:00:00 PM,48,-122,11,10,21
16189,ElliotBayTrailMyrtlePark,11/06/2015 01:00:00 PM,48,-122,10,8,18
16190,ElliotBayTrailMyrtlePark,11/06/2015 02:00:00 PM,48,-122,14,19,33
16191,ElliotBayTrailMyrtlePark,11/06/2015 03:00:00 PM,48,-122,36,27,63
16192,ElliotBayTrailMyrtlePark,11/06/2015 04:00:00 PM,48,-122,63,25,88
16193,ElliotBayTrailMyrtlePark,11/06/2015 05:00:00 PM,48,-122,110,42,152
16194,ElliotBayTrailMyrtlePark,11/06/2015 06:00:00 PM,48,-122,65,10,75
16195,ElliotBayTrailMyrtlePark,11/06/2015 07:00:00 PM,48,-122,23,3,26
16196,ElliotBayTrailMyrtlePark,11/06/2015 08:00:00 PM,48,-122,8,1,9
16197,ElliotBayTrailMyrtlePark,11/06/2015 09:00:00 PM,48,-122,4,4,8
16198,ElliotBayTrailMyrtlePark,11/06/2015 10:00:00 PM,48,-122,1,4,5
16199,ElliotBayTrailMyrtlePark,11/06/2015 11:00:00 PM,48,-122,4,2,6
16200,ElliotBayTrailMyrtlePark,11/07/2015 12:00:00 AM,48,-122,4,1,5
16201,ElliotBayTrailMyrtlePark,11/07/2015 01:00:00 AM,48,-122,1,2,3
16202,ElliotBayTrailMyrtlePark,11/07/2015 02:00:00 AM,48,-122,1,0,1
16203,ElliotBayTrailMyrtlePark,11/07/2015 03:00:00 AM,48,-122,2,0,2
16204,ElliotBayTrailMyrtlePark,11/07/2015 04:00:00 AM,48,-122,0,0,0
16205,ElliotBayTrailMyrtlePark,11/07/2015 05:00:00 AM,48,-122,0,0,0
16206,ElliotBayTrailMyrtlePark,11/07/2015 06:00:00 AM,48,-122,1,2,3
16207,ElliotBayTrailMyrtlePark,11/07/2015 07:00:00 AM,48,-122,4,3,7
16208,ElliotBayTrailMyrtlePark,11/07/2015 08:00:00 AM,48,-122,11,5,16
16209,ElliotBayTrailMyrtlePark,11/07/2015 09:00:00 AM,48,-122,7,9,16
16210,ElliotBayTrailMyrtlePark,11/07/2015 10:00:00 AM,48,-122,2,7,9
16211,ElliotBayTrailMyrtlePark,11/07/2015 11:00:00 AM,48,-122,4,8,12
16212,ElliotBayTrailMyrtlePark,11/07/2015 12:00:00 PM,48,-122,8,8,16
16213,ElliotBayTrailMyrtlePark,11/07/2015 01:00:00 PM,48,-122,6,4,10
16214,ElliotBayTrailMyrtlePark,11/07/2015 02:00:00 PM,48,-122,4,5,9
16215,ElliotBayTrailMyrtlePark,11/07/2015 03:00:00 PM,48,-122,7,3,10
16216,ElliotBayTrailMyrtlePark,11/07/2015 04:00:00 PM,48,-122,11,1,12
16217,ElliotBayTrailMyrtlePark,11/07/2015 05:00:00 PM,48,-122,2,4,6
16218,ElliotBayTrailMyrtlePark,11/07/2015 06:00:00 PM,48,-122,3,4,7
16219,ElliotBayTrailMyrtlePark,11/07/2015 07:00:00 PM,48,-122,1,1,2
16220,ElliotBayTrailMyrtlePark,11/07/2015 08:00:00 PM,48,-122,0,0,0
16221,ElliotBayTrailMyrtlePark,11/07/2015 09:00:00 PM,48,-122,1,2,3
16222,ElliotBayTrailMyrtlePark,11/07/2015 10:00:00 PM,48,-122,0,0,0
16223,ElliotBayTrailMyrtlePark,11/07/2015 11:00:00 PM,48,-122,1,1,2
16224,ElliotBayTrailMyrtlePark,11/08/2015 12:00:00 AM,48,-122,1,0,1
16225,ElliotBayTrailMyrtlePark,11/08/2015 01:00:00 AM,48,-122,2,0,2
16226,ElliotBayTrailMyrtlePark,11/08/2015 02:00:00 AM,48,-122,0,0,0
16227,ElliotBayTrailMyrtlePark,11/08/2015 03:00:00 AM,48,-122,2,0,2
16228,ElliotBayTrailMyrtlePark,11/08/2015 04:00:00 AM,48,-122,0,0,0
16229,ElliotBayTrailMyrtlePark,11/08/2015 05:00:00 AM,48,-122,0,0,0
16230,ElliotBayTrailMyrtlePark,11/08/2015 06:00:00 AM,48,-122,0,2,2
16231,ElliotBayTrailMyrtlePark,11/08/2015 07:00:00 AM,48,-122,0,4,4
16232,ElliotBayTrailMyrtlePark,11/08/2015 08:00:00 AM,48,-122,10,5,15
16233,ElliotBayTrailMyrtlePark,11/08/2015 09:00:00 AM,48,-122,14,14,28
16234,ElliotBayTrailMyrtlePark,11/08/2015 10:00:00 AM,48,-122,12,20,32
16235,ElliotBayTrailMyrtlePark,11/08/2015 11:00:00 AM,48,-122,13,4,17
16236,ElliotBayTrailMyrtlePark,11/08/2015 12:00:00 PM,48,-122,2,4,6
16237,ElliotBayTrailMyrtlePark,11/08/2015 01:00:00 PM,48,-122,12,9,21
16238,ElliotBayTrailMyrtlePark,11/08/2015 02:00:00 PM,48,-122,17,17,34
16239,ElliotBayTrailMyrtlePark,11/08/2015 03:00:00 PM,48,-122,29,18,47
16240,ElliotBayTrailMyrtlePark,11/08/2015 04:00:00 PM,48,-122,30,33,63
16241,ElliotBayTrailMyrtlePark,11/08/2015 05:00:00 PM,48,-122,11,24,35
16242,ElliotBayTrailMyrtlePark,11/08/2015 06:00:00 PM,48,-122,7,10,17
16243,ElliotBayTrailMyrtlePark,11/08/2015 07:00:00 PM,48,-122,1,3,4
16244,ElliotBayTrailMyrtlePark,11/08/2015 08:00:00 PM,48,-122,1,1,2
16245,ElliotBayTrailMyrtlePark,11/08/2015 09:00:00 PM,48,-122,0,0,0
16246,ElliotBayTrailMyrtlePark,11/08/2015 10:00:00 PM,48,-122,2,0,2
16247,ElliotBayTrailMyrtlePark,11/08/2015 11:00:00 PM,48,-122,1,0,1
16248,ElliotBayTrailMyrtlePark,11/09/2015 12:00:00 AM,48,-122,2,1,3
16249,ElliotBayTrailMyrtlePark,11/09/2015 01:00:00 AM,48,-122,1,0,1
16250,ElliotBayTrailMyrtlePark,11/09/2015 02:00:00 AM,48,-122,0,0,0
16251,ElliotBayTrailMyrtlePark,11/09/2015 03:00:00 AM,48,-122,1,0,1
16252,ElliotBayTrailMyrtlePark,11/09/2015 04:00:00 AM,48,-122,0,0,0
16253,ElliotBayTrailMyrtlePark,11/09/2015 05:00:00 AM,48,-122,4,5,9
16254,ElliotBayTrailMyrtlePark,11/09/2015 06:00:00 AM,48,-122,10,22,32
16255,ElliotBayTrailMyrtlePark,11/09/2015 07:00:00 AM,48,-122,23,54,77
16256,ElliotBayTrailMyrtlePark,11/09/2015 08:00:00 AM,48,-122,25,100,125
16257,ElliotBayTrailMyrtlePark,11/09/2015 09:00:00 AM,48,-122,23,80,103
16258,ElliotBayTrailMyrtlePark,11/09/2015 10:00:00 AM,48,-122,8,10,18
16259,ElliotBayTrailMyrtlePark,11/09/2015 11:00:00 AM,48,-122,5,10,15
16260,ElliotBayTrailMyrtlePark,11/09/2015 12:00:00 PM,48,-122,10,7,17
16261,ElliotBayTrailMyrtlePark,11/09/2015 01:00:00 PM,48,-122,5,6,11
16262,ElliotBayTrailMyrtlePark,11/09/2015 02:00:00 PM,48,-122,9,11,20
16263,ElliotBayTrailMyrtlePark,11/09/2015 03:00:00 PM,48,-122,14,11,25
16264,ElliotBayTrailMyrtlePark,11/09/2015 04:00:00 PM,48,-122,42,35,77
16265,ElliotBayTrailMyrtlePark,11/09/2015 05:00:00 PM,48,-122,111,39,150
16266,ElliotBayTrailMyrtlePark,11/09/2015 06:00:00 PM,48,-122,101,16,117
16267,ElliotBayTrailMyrtlePark,11/09/2015 07:00:00 PM,48,-122,42,9,51
16268,ElliotBayTrailMyrtlePark,11/09/2015 08:00:00 PM,48,-122,5,2,7
16269,ElliotBayTrailMyrtlePark,11/09/2015 09:00:00 PM,48,-122,7,1,8
16270,ElliotBayTrailMyrtlePark,11/09/2015 10:00:00 PM,48,-122,4,1,5
16271,ElliotBayTrailMyrtlePark,11/09/2015 11:00:00 PM,48,-122,1,2,3
16272,ElliotBayTrailMyrtlePark,11/10/2015 12:00:00 AM,48,-122,2,0,2
16273,ElliotBayTrailMyrtlePark,11/10/2015 01:00:00 AM,48,-122,0,0,0
16274,ElliotBayTrailMyrtlePark,11/10/2015 02:00:00 AM,48,-122,0,0,0
16275,ElliotBayTrailMyrtlePark,11/10/2015 03:00:00 AM,48,-122,0,0,0
16276,ElliotBayTrailMyrtlePark,11/10/2015 04:00:00 AM,48,-122,1,0,1
16277,ElliotBayTrailMyrtlePark,11/10/2015 05:00:00 AM,48,-122,2,3,5
16278,ElliotBayTrailMyrtlePark,11/10/2015 06:00:00 AM,48,-122,14,27,41
16279,ElliotBayTrailMyrtlePark,11/10/2015 07:00:00 AM,48,-122,27,57,84
16280,ElliotBayTrailMyrtlePark,11/10/2015 08:00:00 AM,48,-122,31,140,171
16281,ElliotBayTrailMyrtlePark,11/10/2015 09:00:00 AM,48,-122,32,104,136
16282,ElliotBayTrailMyrtlePark,11/10/2015 10:00:00 AM,48,-122,14,28,42
16283,ElliotBayTrailMyrtlePark,11/10/2015 11:00:00 AM,48,-122,9,12,21
16284,ElliotBayTrailMyrtlePark,11/10/2015 12:00:00 PM,48,-122,21,6,27
16285,ElliotBayTrailMyrtlePark,11/10/2015 01:00:00 PM,48,-122,22,17,39
16286,ElliotBayTrailMyrtlePark,11/10/2015 02:00:00 PM,48,-122,20,24,44
16287,ElliotBayTrailMyrtlePark,11/10/2015 03:00:00 PM,48,-122,20,17,37
16288,ElliotBayTrailMyrtlePark,11/10/2015 04:00:00 PM,48,-122,56,39,95
16289,ElliotBayTrailMyrtlePark,11/10/2015 05:00:00 PM,48,-122,142,37,179
16290,ElliotBayTrailMyrtlePark,11/10/2015 06:00:00 PM,48,-122,120,16,136
16291,ElliotBayTrailMyrtlePark,11/10/2015 07:00:00 PM,48,-122,36,14,50
16292,ElliotBayTrailMyrtlePark,11/10/2015 08:00:00 PM,48,-122,3,0,3
16293,ElliotBayTrailMyrtlePark,11/10/2015 09:00:00 PM,48,-122,7,3,10
16294,ElliotBayTrailMyrtlePark,11/10/2015 10:00:00 PM,48,-122,4,3,7
16295,ElliotBayTrailMyrtlePark,11/10/2015 11:00:00 PM,48,-122,0,0,0
16296,ElliotBayTrailMyrtlePark,11/11/2015 12:00:00 AM,48,-122,1,0,1
16297,ElliotBayTrailMyrtlePark,11/11/2015 01:00:00 AM,48,-122,1,0,1
16298,ElliotBayTrailMyrtlePark,11/11/2015 02:00:00 AM,48,-122,0,0,0
16299,ElliotBayTrailMyrtlePark,11/11/2015 03:00:00 AM,48,-122,1,0,1
16300,ElliotBayTrailMyrtlePark,11/11/2015 04:00:00 AM,48,-122,0,0,0
16301,ElliotBayTrailMyrtlePark,11/11/2015 05:00:00 AM,48,-122,6,2,8
16302,ElliotBayTrailMyrtlePark,11/11/2015 06:00:00 AM,48,-122,13,14,27
16303,ElliotBayTrailMyrtlePark,11/11/2015 07:00:00 AM,48,-122,15,48,63
16304,ElliotBayTrailMyrtlePark,11/11/2015 08:00:00 AM,48,-122,30,89,119
16305,ElliotBayTrailMyrtlePark,11/11/2015 09:00:00 AM,48,-122,23,75,98
16306,ElliotBayTrailMyrtlePark,11/11/2015 10:00:00 AM,48,-122,15,32,47
16307,ElliotBayTrailMyrtlePark,11/11/2015 11:00:00 AM,48,-122,21,26,47
16308,ElliotBayTrailMyrtlePark,11/11/2015 12:00:00 PM,48,-122,23,24,47
16309,ElliotBayTrailMyrtlePark,11/11/2015 01:00:00 PM,48,-122,25,24,49
16310,ElliotBayTrailMyrtlePark,11/11/2015 02:00:00 PM,48,-122,21,32,53
16311,ElliotBayTrailMyrtlePark,11/11/2015 03:00:00 PM,48,-122,36,18,54
16312,ElliotBayTrailMyrtlePark,11/11/2015 04:00:00 PM,48,-122,54,32,86
16313,ElliotBayTrailMyrtlePark,11/11/2015 05:00:00 PM,48,-122,86,38,124
16314,ElliotBayTrailMyrtlePark,11/11/2015 06:00:00 PM,48,-122,102,25,127
16315,ElliotBayTrailMyrtlePark,11/11/2015 07:00:00 PM,48,-122,28,9,37
16316,ElliotBayTrailMyrtlePark,11/11/2015 08:00:00 PM,48,-122,7,0,7
16317,ElliotBayTrailMyrtlePark,11/11/2015 09:00:00 PM,48,-122,10,1,11
16318,ElliotBayTrailMyrtlePark,11/11/2015 10:00:00 PM,48,-122,1,2,3
16319,ElliotBayTrailMyrtlePark,11/11/2015 11:00:00 PM,48,-122,5,1,6
16320,ElliotBayTrailMyrtlePark,11/12/2015 12:00:00 AM,48,-122,1,0,1
16321,ElliotBayTrailMyrtlePark,11/12/2015 01:00:00 AM,48,-122,1,0,1
16322,ElliotBayTrailMyrtlePark,11/12/2015 02:00:00 AM,48,-122,0,0,0
16323,ElliotBayTrailMyrtlePark,11/12/2015 03:00:00 AM,48,-122,1,0,1
16324,ElliotBayTrailMyrtlePark,11/12/2015 04:00:00 AM,48,-122,2,0,2
16325,ElliotBayTrailMyrtlePark,11/12/2015 05:00:00 AM,48,-122,4,4,8
16326,ElliotBayTrailMyrtlePark,11/12/2015 06:00:00 AM,48,-122,10,22,32
16327,ElliotBayTrailMyrtlePark,11/12/2015 07:00:00 AM,48,-122,21,53,74
16328,ElliotBayTrailMyrtlePark,11/12/2015 08:00:00 AM,48,-122,27,117,144
16329,ElliotBayTrailMyrtlePark,11/12/2015 09:00:00 AM,48,-122,27,48,75
16330,ElliotBayTrailMyrtlePark,11/12/2015 10:00:00 AM,48,-122,11,27,38
16331,ElliotBayTrailMyrtlePark,11/12/2015 11:00:00 AM,48,-122,7,13,20
16332,ElliotBayTrailMyrtlePark,11/12/2015 12:00:00 PM,48,-122,13,13,26
16333,ElliotBayTrailMyrtlePark,11/12/2015 01:00:00 PM,48,-122,8,9,17
16334,ElliotBayTrailMyrtlePark,11/12/2015 02:00:00 PM,48,-122,9,7,16
16335,ElliotBayTrailMyrtlePark,11/12/2015 03:00:00 PM,48,-122,12,10,22
16336,ElliotBayTrailMyrtlePark,11/12/2015 04:00:00 PM,48,-122,39,20,59
16337,ElliotBayTrailMyrtlePark,11/12/2015 05:00:00 PM,48,-122,105,24,129
16338,ElliotBayTrailMyrtlePark,11/12/2015 06:00:00 PM,48,-122,83,4,87
16339,ElliotBayTrailMyrtlePark,11/12/2015 07:00:00 PM,48,-122,31,7,38
16340,ElliotBayTrailMyrtlePark,11/12/2015 08:00:00 PM,48,-122,7,1,8
16341,ElliotBayTrailMyrtlePark,11/12/2015 09:00:00 PM,48,-122,7,2,9
16342,ElliotBayTrailMyrtlePark,11/12/2015 10:00:00 PM,48,-122,1,3,4
16343,ElliotBayTrailMyrtlePark,11/12/2015 11:00:00 PM,48,-122,2,3,5
16344,ElliotBayTrailMyrtlePark,11/13/2015 12:00:00 AM,48,-122,0,3,3
16345,ElliotBayTrailMyrtlePark,11/13/2015 01:00:00 AM,48,-122,0,0,0
16346,ElliotBayTrailMyrtlePark,11/13/2015 02:00:00 AM,48,-122,2,0,2
16347,ElliotBayTrailMyrtlePark,11/13/2015 03:00:00 AM,48,-122,0,0,0
16348,ElliotBayTrailMyrtlePark,11/13/2015 04:00:00 AM,48,-122,0,0,0
16349,ElliotBayTrailMyrtlePark,11/13/2015 05:00:00 AM,48,-122,4,1,5
16350,ElliotBayTrailMyrtlePark,11/13/2015 06:00:00 AM,48,-122,7,6,13
16351,ElliotBayTrailMyrtlePark,11/13/2015 07:00:00 AM,48,-122,13,27,40
16352,ElliotBayTrailMyrtlePark,11/13/2015 08:00:00 AM,48,-122,22,62,84
16353,ElliotBayTrailMyrtlePark,11/13/2015 09:00:00 AM,48,-122,16,36,52
16354,ElliotBayTrailMyrtlePark,11/13/2015 10:00:00 AM,48,-122,6,14,20
16355,ElliotBayTrailMyrtlePark,11/13/2015 11:00:00 AM,48,-122,3,8,11
16356,ElliotBayTrailMyrtlePark,11/13/2015 12:00:00 PM,48,-122,4,8,12
16357,ElliotBayTrailMyrtlePark,11/13/2015 01:00:00 PM,48,-122,4,3,7
16358,ElliotBayTrailMyrtlePark,11/13/2015 02:00:00 PM,48,-122,6,6,12
16359,ElliotBayTrailMyrtlePark,11/13/2015 03:00:00 PM,48,-122,19,14,33
16360,ElliotBayTrailMyrtlePark,11/13/2015 04:00:00 PM,48,-122,25,13,38
16361,ElliotBayTrailMyrtlePark,11/13/2015 05:00:00 PM,48,-122,62,21,83
16362,ElliotBayTrailMyrtlePark,11/13/2015 06:00:00 PM,48,-122,64,6,70
16363,ElliotBayTrailMyrtlePark,11/13/2015 07:00:00 PM,48,-122,11,8,19
16364,ElliotBayTrailMyrtlePark,11/13/2015 08:00:00 PM,48,-122,6,0,6
16365,ElliotBayTrailMyrtlePark,11/13/2015 09:00:00 PM,48,-122,0,0,0
16366,ElliotBayTrailMyrtlePark,11/13/2015 10:00:00 PM,48,-122,1,1,2
16367,ElliotBayTrailMyrtlePark,11/13/2015 11:00:00 PM,48,-122,4,3,7
16368,ElliotBayTrailMyrtlePark,11/14/2015 12:00:00 AM,48,-122,0,0,0
16369,ElliotBayTrailMyrtlePark,11/14/2015 01:00:00 AM,48,-122,3,0,3
16370,ElliotBayTrailMyrtlePark,11/14/2015 02:00:00 AM,48,-122,1,2,3
16371,ElliotBayTrailMyrtlePark,11/14/2015 03:00:00 AM,48,-122,1,0,1
16372,ElliotBayTrailMyrtlePark,11/14/2015 04:00:00 AM,48,-122,0,0,0
16373,ElliotBayTrailMyrtlePark,11/14/2015 05:00:00 AM,48,-122,0,0,0
16374,ElliotBayTrailMyrtlePark,11/14/2015 06:00:00 AM,48,-122,0,3,3
16375,ElliotBayTrailMyrtlePark,11/14/2015 07:00:00 AM,48,-122,1,3,4
16376,ElliotBayTrailMyrtlePark,11/14/2015 08:00:00 AM,48,-122,7,1,8
16377,ElliotBayTrailMyrtlePark,11/14/2015 09:00:00 AM,48,-122,1,1,2
16378,ElliotBayTrailMyrtlePark,11/14/2015 10:00:00 AM,48,-122,6,7,13
16379,ElliotBayTrailMyrtlePark,11/14/2015 11:00:00 AM,48,-122,5,7,12
16380,ElliotBayTrailMyrtlePark,11/14/2015 12:00:00 PM,48,-122,3,8,11
16381,ElliotBayTrailMyrtlePark,11/14/2015 01:00:00 PM,48,-122,4,2,6
16382,ElliotBayTrailMyrtlePark,11/14/2015 02:00:00 PM,48,-122,6,7,13
16383,ElliotBayTrailMyrtlePark,11/14/2015 03:00:00 PM,48,-122,2,3,5
16384,ElliotBayTrailMyrtlePark,11/14/2015 04:00:00 PM,48,-122,9,8,17
16385,ElliotBayTrailMyrtlePark,11/14/2015 05:00:00 PM,48,-122,0,3,3
16386,ElliotBayTrailMyrtlePark,11/14/2015 06:00:00 PM,48,-122,3,1,4
16387,ElliotBayTrailMyrtlePark,11/14/2015 07:00:00 PM,48,-122,2,0,2
16388,ElliotBayTrailMyrtlePark,11/14/2015 08:00:00 PM,48,-122,0,1,1
16389,ElliotBayTrailMyrtlePark,11/14/2015 09:00:00 PM,48,-122,3,1,4
16390,ElliotBayTrailMyrtlePark,11/14/2015 10:00:00 PM,48,-122,0,0,0
16391,ElliotBayTrailMyrtlePark,11/14/2015 11:00:00 PM,48,-122,0,0,0
16392,ElliotBayTrailMyrtlePark,11/15/2015 12:00:00 AM,48,-122,2,0,2
16393,ElliotBayTrailMyrtlePark,11/15/2015 01:00:00 AM,48,-122,0,0,0
16394,ElliotBayTrailMyrtlePark,11/15/2015 02:00:00 AM,48,-122,0,0,0
16395,ElliotBayTrailMyrtlePark,11/15/2015 03:00:00 AM,48,-122,1,0,1
16396,ElliotBayTrailMyrtlePark,11/15/2015 04:00:00 AM,48,-122,0,0,0
16397,ElliotBayTrailMyrtlePark,11/15/2015 05:00:00 AM,48,-122,0,0,0
16398,ElliotBayTrailMyrtlePark,11/15/2015 06:00:00 AM,48,-122,0,1,1
16399,ElliotBayTrailMyrtlePark,11/15/2015 07:00:00 AM,48,-122,4,2,6
16400,ElliotBayTrailMyrtlePark,11/15/2015 08:00:00 AM,48,-122,6,2,8
16401,ElliotBayTrailMyrtlePark,11/15/2015 09:00:00 AM,48,-122,5,6,11
16402,ElliotBayTrailMyrtlePark,11/15/2015 10:00:00 AM,48,-122,5,8,13
16403,ElliotBayTrailMyrtlePark,11/15/2015 11:00:00 AM,48,-122,14,6,20
16404,ElliotBayTrailMyrtlePark,11/15/2015 12:00:00 PM,48,-122,14,20,34
16405,ElliotBayTrailMyrtlePark,11/15/2015 01:00:00 PM,48,-122,17,26,43
16406,ElliotBayTrailMyrtlePark,11/15/2015 02:00:00 PM,48,-122,45,36,81
16407,ElliotBayTrailMyrtlePark,11/15/2015 03:00:00 PM,48,-122,34,25,59
16408,ElliotBayTrailMyrtlePark,11/15/2015 04:00:00 PM,48,-122,37,35,72
16409,ElliotBayTrailMyrtlePark,11/15/2015 05:00:00 PM,48,-122,10,24,34
16410,ElliotBayTrailMyrtlePark,11/15/2015 06:00:00 PM,48,-122,3,1,4
16411,ElliotBayTrailMyrtlePark,11/15/2015 07:00:00 PM,48,-122,1,4,5
16412,ElliotBayTrailMyrtlePark,11/15/2015 08:00:00 PM,48,-122,2,1,3
16413,ElliotBayTrailMyrtlePark,11/15/2015 09:00:00 PM,48,-122,4,2,6
16414,ElliotBayTrailMyrtlePark,11/15/2015 10:00:00 PM,48,-122,10,0,10
16415,ElliotBayTrailMyrtlePark,11/15/2015 11:00:00 PM,48,-122,5,0,5
16416,ElliotBayTrailMyrtlePark,11/16/2015 12:00:00 AM,48,-122,0,3,3
16417,ElliotBayTrailMyrtlePark,11/16/2015 01:00:00 AM,48,-122,0,0,0
16418,ElliotBayTrailMyrtlePark,11/16/2015 02:00:00 AM,48,-122,0,0,0
16419,ElliotBayTrailMyrtlePark,11/16/2015 03:00:00 AM,48,-122,0,0,0
16420,ElliotBayTrailMyrtlePark,11/16/2015 04:00:00 AM,48,-122,0,0,0
16421,ElliotBayTrailMyrtlePark,11/16/2015 05:00:00 AM,48,-122,6,4,10
16422,ElliotBayTrailMyrtlePark,11/16/2015 06:00:00 AM,48,-122,12,18,30
16423,ElliotBayTrailMyrtlePark,11/16/2015 07:00:00 AM,48,-122,24,43,67
16424,ElliotBayTrailMyrtlePark,11/16/2015 08:00:00 AM,48,-122,32,124,156
16425,ElliotBayTrailMyrtlePark,11/16/2015 09:00:00 AM,48,-122,26,77,103
16426,ElliotBayTrailMyrtlePark,11/16/2015 10:00:00 AM,48,-122,15,25,40
16427,ElliotBayTrailMyrtlePark,11/16/2015 11:00:00 AM,48,-122,7,5,12
16428,ElliotBayTrailMyrtlePark,11/16/2015 12:00:00 PM,48,-122,6,8,14
16429,ElliotBayTrailMyrtlePark,11/16/2015 01:00:00 PM,48,-122,4,6,10
16430,ElliotBayTrailMyrtlePark,11/16/2015 02:00:00 PM,48,-122,13,7,20
16431,ElliotBayTrailMyrtlePark,11/16/2015 03:00:00 PM,48,-122,13,11,24
16432,ElliotBayTrailMyrtlePark,11/16/2015 04:00:00 PM,48,-122,45,26,71
16433,ElliotBayTrailMyrtlePark,11/16/2015 05:00:00 PM,48,-122,100,24,124
16434,ElliotBayTrailMyrtlePark,11/16/2015 06:00:00 PM,48,-122,108,14,122
16435,ElliotBayTrailMyrtlePark,11/16/2015 07:00:00 PM,48,-122,32,8,40
16436,ElliotBayTrailMyrtlePark,11/16/2015 08:00:00 PM,48,-122,8,1,9
16437,ElliotBayTrailMyrtlePark,11/16/2015 09:00:00 PM,48,-122,2,3,5
16438,ElliotBayTrailMyrtlePark,11/16/2015 10:00:00 PM,48,-122,6,0,6
16439,ElliotBayTrailMyrtlePark,11/16/2015 11:00:00 PM,48,-122,2,3,5
16440,ElliotBayTrailMyrtlePark,11/17/2015 12:00:00 AM,48,-122,1,0,1
16441,ElliotBayTrailMyrtlePark,11/17/2015 01:00:00 AM,48,-122,0,0,0
16442,ElliotBayTrailMyrtlePark,11/17/2015 02:00:00 AM,48,-122,1,0,1
16443,ElliotBayTrailMyrtlePark,11/17/2015 03:00:00 AM,48,-122,1,0,1
16444,ElliotBayTrailMyrtlePark,11/17/2015 04:00:00 AM,48,-122,0,0,0
16445,ElliotBayTrailMyrtlePark,11/17/2015 05:00:00 AM,48,-122,3,3,6
16446,ElliotBayTrailMyrtlePark,11/17/2015 06:00:00 AM,48,-122,11,12,23
16447,ElliotBayTrailMyrtlePark,11/17/2015 07:00:00 AM,48,-122,13,33,46
16448,ElliotBayTrailMyrtlePark,11/17/2015 08:00:00 AM,48,-122,17,70,87
16449,ElliotBayTrailMyrtlePark,11/17/2015 09:00:00 AM,48,-122,20,49,69
16450,ElliotBayTrailMyrtlePark,11/17/2015 10:00:00 AM,48,-122,7,14,21
16451,ElliotBayTrailMyrtlePark,11/17/2015 11:00:00 AM,48,-122,1,3,4
16452,ElliotBayTrailMyrtlePark,11/17/2015 12:00:00 PM,48,-122,4,2,6
16453,ElliotBayTrailMyrtlePark,11/17/2015 01:00:00 PM,48,-122,2,2,4
16454,ElliotBayTrailMyrtlePark,11/17/2015 02:00:00 PM,48,-122,4,4,8
16455,ElliotBayTrailMyrtlePark,11/17/2015 03:00:00 PM,48,-122,8,9,17
16456,ElliotBayTrailMyrtlePark,11/17/2015 04:00:00 PM,48,-122,30,13,43
16457,ElliotBayTrailMyrtlePark,11/17/2015 05:00:00 PM,48,-122,75,27,102
16458,ElliotBayTrailMyrtlePark,11/17/2015 06:00:00 PM,48,-122,62,8,70
16459,ElliotBayTrailMyrtlePark,11/17/2015 07:00:00 PM,48,-122,22,5,27
16460,ElliotBayTrailMyrtlePark,11/17/2015 08:00:00 PM,48,-122,2,2,4
16461,ElliotBayTrailMyrtlePark,11/17/2015 09:00:00 PM,48,-122,3,0,3
16462,ElliotBayTrailMyrtlePark,11/17/2015 10:00:00 PM,48,-122,2,0,2
16463,ElliotBayTrailMyrtlePark,11/17/2015 11:00:00 PM,48,-122,0,1,1
16464,ElliotBayTrailMyrtlePark,11/18/2015 12:00:00 AM,48,-122,2,0,2
16465,ElliotBayTrailMyrtlePark,11/18/2015 01:00:00 AM,48,-122,1,0,1
16466,ElliotBayTrailMyrtlePark,11/18/2015 02:00:00 AM,48,-122,0,0,0
16467,ElliotBayTrailMyrtlePark,11/18/2015 03:00:00 AM,48,-122,1,0,1
16468,ElliotBayTrailMyrtlePark,11/18/2015 04:00:00 AM,48,-122,2,0,2
16469,ElliotBayTrailMyrtlePark,11/18/2015 05:00:00 AM,48,-122,4,4,8
16470,ElliotBayTrailMyrtlePark,11/18/2015 06:00:00 AM,48,-122,13,15,28
16471,ElliotBayTrailMyrtlePark,11/18/2015 07:00:00 AM,48,-122,23,47,70
16472,ElliotBayTrailMyrtlePark,11/18/2015 08:00:00 AM,48,-122,32,121,153
16473,ElliotBayTrailMyrtlePark,11/18/2015 09:00:00 AM,48,-122,23,85,108
16474,ElliotBayTrailMyrtlePark,11/18/2015 10:00:00 AM,48,-122,11,31,42
16475,ElliotBayTrailMyrtlePark,11/18/2015 11:00:00 AM,48,-122,9,11,20
16476,ElliotBayTrailMyrtlePark,11/18/2015 12:00:00 PM,48,-122,17,18,35
16477,ElliotBayTrailMyrtlePark,11/18/2015 01:00:00 PM,48,-122,16,13,29
16478,ElliotBayTrailMyrtlePark,11/18/2015 02:00:00 PM,48,-122,21,16,37
16479,ElliotBayTrailMyrtlePark,11/18/2015 03:00:00 PM,48,-122,15,12,27
16480,ElliotBayTrailMyrtlePark,11/18/2015 04:00:00 PM,48,-122,53,35,88
16481,ElliotBayTrailMyrtlePark,11/18/2015 05:00:00 PM,48,-122,120,43,163
16482,ElliotBayTrailMyrtlePark,11/18/2015 06:00:00 PM,48,-122,106,11,117
16483,ElliotBayTrailMyrtlePark,11/18/2015 07:00:00 PM,48,-122,38,10,48
16484,ElliotBayTrailMyrtlePark,11/18/2015 08:00:00 PM,48,-122,11,4,15
16485,ElliotBayTrailMyrtlePark,11/18/2015 09:00:00 PM,48,-122,7,4,11
16486,ElliotBayTrailMyrtlePark,11/18/2015 10:00:00 PM,48,-122,2,2,4
16487,ElliotBayTrailMyrtlePark,11/18/2015 11:00:00 PM,48,-122,2,1,3
16488,ElliotBayTrailMyrtlePark,11/19/2015 12:00:00 AM,48,-122,0,0,0
16489,ElliotBayTrailMyrtlePark,11/19/2015 01:00:00 AM,48,-122,0,1,1
16490,ElliotBayTrailMyrtlePark,11/19/2015 02:00:00 AM,48,-122,1,0,1
16491,ElliotBayTrailMyrtlePark,11/19/2015 03:00:00 AM,48,-122,1,0,1
16492,ElliotBayTrailMyrtlePark,11/19/2015 04:00:00 AM,48,-122,1,0,1
16493,ElliotBayTrailMyrtlePark,11/19/2015 05:00:00 AM,48,-122,5,7,12
16494,ElliotBayTrailMyrtlePark,11/19/2015 06:00:00 AM,48,-122,9,15,24
16495,ElliotBayTrailMyrtlePark,11/19/2015 07:00:00 AM,48,-122,19,36,55
16496,ElliotBayTrailMyrtlePark,11/19/2015 08:00:00 AM,48,-122,23,132,155
16497,ElliotBayTrailMyrtlePark,11/19/2015 09:00:00 AM,48,-122,28,81,109
16498,ElliotBayTrailMyrtlePark,11/19/2015 10:00:00 AM,48,-122,16,23,39
16499,ElliotBayTrailMyrtlePark,11/19/2015 11:00:00 AM,48,-122,6,6,12
16500,ElliotBayTrailMyrtlePark,11/19/2015 12:00:00 PM,48,-122,13,27,40
16501,ElliotBayTrailMyrtlePark,11/19/2015 01:00:00 PM,48,-122,12,15,27
16502,ElliotBayTrailMyrtlePark,11/19/2015 02:00:00 PM,48,-122,10,20,30
16503,ElliotBayTrailMyrtlePark,11/19/2015 03:00:00 PM,48,-122,29,22,51
16504,ElliotBayTrailMyrtlePark,11/19/2015 04:00:00 PM,48,-122,54,31,85
16505,ElliotBayTrailMyrtlePark,11/19/2015 05:00:00 PM,48,-122,100,51,151
16506,ElliotBayTrailMyrtlePark,11/19/2015 06:00:00 PM,48,-122,102,18,120
16507,ElliotBayTrailMyrtlePark,11/19/2015 07:00:00 PM,48,-122,34,7,41
16508,ElliotBayTrailMyrtlePark,11/19/2015 08:00:00 PM,48,-122,11,4,15
16509,ElliotBayTrailMyrtlePark,11/19/2015 09:00:00 PM,48,-122,6,1,7
16510,ElliotBayTrailMyrtlePark,11/19/2015 10:00:00 PM,48,-122,10,5,15
16511,ElliotBayTrailMyrtlePark,11/19/2015 11:00:00 PM,48,-122,8,1,9
16512,ElliotBayTrailMyrtlePark,11/20/2015 12:00:00 AM,48,-122,0,1,1
16513,ElliotBayTrailMyrtlePark,11/20/2015 01:00:00 AM,48,-122,0,0,0
16514,ElliotBayTrailMyrtlePark,11/20/2015 02:00:00 AM,48,-122,1,0,1
16515,ElliotBayTrailMyrtlePark,11/20/2015 03:00:00 AM,48,-122,0,0,0
16516,ElliotBayTrailMyrtlePark,11/20/2015 04:00:00 AM,48,-122,0,0,0
16517,ElliotBayTrailMyrtlePark,11/20/2015 05:00:00 AM,48,-122,8,7,15
16518,ElliotBayTrailMyrtlePark,11/20/2015 06:00:00 AM,48,-122,11,18,29
16519,ElliotBayTrailMyrtlePark,11/20/2015 07:00:00 AM,48,-122,20,53,73
16520,ElliotBayTrailMyrtlePark,11/20/2015 08:00:00 AM,48,-122,21,102,123
16521,ElliotBayTrailMyrtlePark,11/20/2015 09:00:00 AM,48,-122,23,73,96
16522,ElliotBayTrailMyrtlePark,11/20/2015 10:00:00 AM,48,-122,9,25,34
16523,ElliotBayTrailMyrtlePark,11/20/2015 11:00:00 AM,48,-122,15,10,25
16524,ElliotBayTrailMyrtlePark,11/20/2015 12:00:00 PM,48,-122,13,18,31
16525,ElliotBayTrailMyrtlePark,11/20/2015 01:00:00 PM,48,-122,12,18,30
16526,ElliotBayTrailMyrtlePark,11/20/2015 02:00:00 PM,48,-122,26,24,50
16527,ElliotBayTrailMyrtlePark,11/20/2015 03:00:00 PM,48,-122,30,21,51
16528,ElliotBayTrailMyrtlePark,11/20/2015 04:00:00 PM,48,-122,44,38,82
16529,ElliotBayTrailMyrtlePark,11/20/2015 05:00:00 PM,48,-122,116,29,145
16530,ElliotBayTrailMyrtlePark,11/20/2015 06:00:00 PM,48,-122,93,11,104
16531,ElliotBayTrailMyrtlePark,11/20/2015 07:00:00 PM,48,-122,19,9,28
16532,ElliotBayTrailMyrtlePark,11/20/2015 08:00:00 PM,48,-122,5,1,6
16533,ElliotBayTrailMyrtlePark,11/20/2015 09:00:00 PM,48,-122,5,6,11
16534,ElliotBayTrailMyrtlePark,11/20/2015 10:00:00 PM,48,-122,8,3,11
16535,ElliotBayTrailMyrtlePark,11/20/2015 11:00:00 PM,48,-122,3,3,6
16536,ElliotBayTrailMyrtlePark,11/21/2015 12:00:00 AM,48,-122,1,2,3
16537,ElliotBayTrailMyrtlePark,11/21/2015 01:00:00 AM,48,-122,1,0,1
16538,ElliotBayTrailMyrtlePark,11/21/2015 02:00:00 AM,48,-122,0,0,0
16539,ElliotBayTrailMyrtlePark,11/21/2015 03:00:00 AM,48,-122,2,0,2
16540,ElliotBayTrailMyrtlePark,11/21/2015 04:00:00 AM,48,-122,0,0,0
16541,ElliotBayTrailMyrtlePark,11/21/2015 05:00:00 AM,48,-122,0,0,0
16542,ElliotBayTrailMyrtlePark,11/21/2015 06:00:00 AM,48,-122,2,3,5
16543,ElliotBayTrailMyrtlePark,11/21/2015 07:00:00 AM,48,-122,2,1,3
16544,ElliotBayTrailMyrtlePark,11/21/2015 08:00:00 AM,48,-122,3,17,20
16545,ElliotBayTrailMyrtlePark,11/21/2015 09:00:00 AM,48,-122,9,10,19
16546,ElliotBayTrailMyrtlePark,11/21/2015 10:00:00 AM,48,-122,20,14,34
16547,ElliotBayTrailMyrtlePark,11/21/2015 11:00:00 AM,48,-122,23,37,60
16548,ElliotBayTrailMyrtlePark,11/21/2015 12:00:00 PM,48,-122,28,32,60
16549,ElliotBayTrailMyrtlePark,11/21/2015 01:00:00 PM,48,-122,21,44,65
16550,ElliotBayTrailMyrtlePark,11/21/2015 02:00:00 PM,48,-122,37,27,64
16551,ElliotBayTrailMyrtlePark,11/21/2015 03:00:00 PM,48,-122,58,40,98
16552,ElliotBayTrailMyrtlePark,11/21/2015 04:00:00 PM,48,-122,51,28,79
16553,ElliotBayTrailMyrtlePark,11/21/2015 05:00:00 PM,48,-122,8,11,19
16554,ElliotBayTrailMyrtlePark,11/21/2015 06:00:00 PM,48,-122,9,2,11
16555,ElliotBayTrailMyrtlePark,11/21/2015 07:00:00 PM,48,-122,6,2,8
16556,ElliotBayTrailMyrtlePark,11/21/2015 08:00:00 PM,48,-122,3,0,3
16557,ElliotBayTrailMyrtlePark,11/21/2015 09:00:00 PM,48,-122,3,1,4
16558,ElliotBayTrailMyrtlePark,11/21/2015 10:00:00 PM,48,-122,1,0,1
16559,ElliotBayTrailMyrtlePark,11/21/2015 11:00:00 PM,48,-122,1,2,3
16560,ElliotBayTrailMyrtlePark,11/22/2015 12:00:00 AM,48,-122,1,0,1
16561,ElliotBayTrailMyrtlePark,11/22/2015 01:00:00 AM,48,-122,1,1,2
16562,ElliotBayTrailMyrtlePark,11/22/2015 02:00:00 AM,48,-122,1,1,2
16563,ElliotBayTrailMyrtlePark,11/22/2015 03:00:00 AM,48,-122,1,0,1
16564,ElliotBayTrailMyrtlePark,11/22/2015 04:00:00 AM,48,-122,0,0,0
16565,ElliotBayTrailMyrtlePark,11/22/2015 05:00:00 AM,48,-122,0,0,0
16566,ElliotBayTrailMyrtlePark,11/22/2015 06:00:00 AM,48,-122,1,2,3
16567,ElliotBayTrailMyrtlePark,11/22/2015 07:00:00 AM,48,-122,2,2,4
16568,ElliotBayTrailMyrtlePark,11/22/2015 08:00:00 AM,48,-122,3,0,3
16569,ElliotBayTrailMyrtlePark,11/22/2015 09:00:00 AM,48,-122,13,10,23
16570,ElliotBayTrailMyrtlePark,11/22/2015 10:00:00 AM,48,-122,16,24,40
16571,ElliotBayTrailMyrtlePark,11/22/2015 11:00:00 AM,48,-122,22,28,50
16572,ElliotBayTrailMyrtlePark,11/22/2015 12:00:00 PM,48,-122,48,35,83
16573,ElliotBayTrailMyrtlePark,11/22/2015 01:00:00 PM,48,-122,35,37,72
16574,ElliotBayTrailMyrtlePark,11/22/2015 02:00:00 PM,48,-122,31,39,70
16575,ElliotBayTrailMyrtlePark,11/22/2015 03:00:00 PM,48,-122,28,25,53
16576,ElliotBayTrailMyrtlePark,11/22/2015 04:00:00 PM,48,-122,43,31,74
16577,ElliotBayTrailMyrtlePark,11/22/2015 05:00:00 PM,48,-122,13,14,27
16578,ElliotBayTrailMyrtlePark,11/22/2015 06:00:00 PM,48,-122,3,4,7
16579,ElliotBayTrailMyrtlePark,11/22/2015 07:00:00 PM,48,-122,4,3,7
16580,ElliotBayTrailMyrtlePark,11/22/2015 08:00:00 PM,48,-122,1,0,1
16581,ElliotBayTrailMyrtlePark,11/22/2015 09:00:00 PM,48,-122,1,0,1
16582,ElliotBayTrailMyrtlePark,11/22/2015 10:00:00 PM,48,-122,1,1,2
16583,ElliotBayTrailMyrtlePark,11/22/2015 11:00:00 PM,48,-122,0,1,1
16584,ElliotBayTrailMyrtlePark,11/23/2015 12:00:00 AM,48,-122,0,0,0
16585,ElliotBayTrailMyrtlePark,11/23/2015 01:00:00 AM,48,-122,0,0,0
16586,ElliotBayTrailMyrtlePark,11/23/2015 02:00:00 AM,48,-122,0,0,0
16587,ElliotBayTrailMyrtlePark,11/23/2015 03:00:00 AM,48,-122,1,0,1
16588,ElliotBayTrailMyrtlePark,11/23/2015 04:00:00 AM,48,-122,0,0,0
16589,ElliotBayTrailMyrtlePark,11/23/2015 05:00:00 AM,48,-122,5,5,10
16590,ElliotBayTrailMyrtlePark,11/23/2015 06:00:00 AM,48,-122,9,22,31
16591,ElliotBayTrailMyrtlePark,11/23/2015 07:00:00 AM,48,-122,23,43,66
16592,ElliotBayTrailMyrtlePark,11/23/2015 08:00:00 AM,48,-122,37,116,153
16593,ElliotBayTrailMyrtlePark,11/23/2015 09:00:00 AM,48,-122,25,66,91
16594,ElliotBayTrailMyrtlePark,11/23/2015 10:00:00 AM,48,-122,9,20,29
16595,ElliotBayTrailMyrtlePark,11/23/2015 11:00:00 AM,48,-122,12,13,25
16596,ElliotBayTrailMyrtlePark,11/23/2015 12:00:00 PM,48,-122,12,12,24
16597,ElliotBayTrailMyrtlePark,11/23/2015 01:00:00 PM,48,-122,6,15,21
16598,ElliotBayTrailMyrtlePark,11/23/2015 02:00:00 PM,48,-122,19,12,31
16599,ElliotBayTrailMyrtlePark,11/23/2015 03:00:00 PM,48,-122,22,13,35
16600,ElliotBayTrailMyrtlePark,11/23/2015 04:00:00 PM,48,-122,38,23,61
16601,ElliotBayTrailMyrtlePark,11/23/2015 05:00:00 PM,48,-122,95,28,123
16602,ElliotBayTrailMyrtlePark,11/23/2015 06:00:00 PM,48,-122,91,10,101
16603,ElliotBayTrailMyrtlePark,11/23/2015 07:00:00 PM,48,-122,26,9,35
16604,ElliotBayTrailMyrtlePark,11/23/2015 08:00:00 PM,48,-122,8,1,9
16605,ElliotBayTrailMyrtlePark,11/23/2015 09:00:00 PM,48,-122,1,0,1
16606,ElliotBayTrailMyrtlePark,11/23/2015 10:00:00 PM,48,-122,2,2,4
16607,ElliotBayTrailMyrtlePark,11/23/2015 11:00:00 PM,48,-122,0,0,0
16608,ElliotBayTrailMyrtlePark,11/24/2015 12:00:00 AM,48,-122,0,0,0
16609,ElliotBayTrailMyrtlePark,11/24/2015 01:00:00 AM,48,-122,0,0,0
16610,ElliotBayTrailMyrtlePark,11/24/2015 02:00:00 AM,48,-122,0,0,0
16611,ElliotBayTrailMyrtlePark,11/24/2015 03:00:00 AM,48,-122,2,0,2
16612,ElliotBayTrailMyrtlePark,11/24/2015 04:00:00 AM,48,-122,0,0,0
16613,ElliotBayTrailMyrtlePark,11/24/2015 05:00:00 AM,48,-122,3,2,5
16614,ElliotBayTrailMyrtlePark,11/24/2015 06:00:00 AM,48,-122,11,21,32
16615,ElliotBayTrailMyrtlePark,11/24/2015 07:00:00 AM,48,-122,20,23,43
16616,ElliotBayTrailMyrtlePark,11/24/2015 08:00:00 AM,48,-122,22,88,110
16617,ElliotBayTrailMyrtlePark,11/24/2015 09:00:00 AM,48,-122,24,52,76
16618,ElliotBayTrailMyrtlePark,11/24/2015 10:00:00 AM,48,-122,10,14,24
16619,ElliotBayTrailMyrtlePark,11/24/2015 11:00:00 AM,48,-122,4,6,10
16620,ElliotBayTrailMyrtlePark,11/24/2015 12:00:00 PM,48,-122,8,8,16
16621,ElliotBayTrailMyrtlePark,11/24/2015 01:00:00 PM,48,-122,6,6,12
16622,ElliotBayTrailMyrtlePark,11/24/2015 02:00:00 PM,48,-122,16,12,28
16623,ElliotBayTrailMyrtlePark,11/24/2015 03:00:00 PM,48,-122,16,15,31
16624,ElliotBayTrailMyrtlePark,11/24/2015 04:00:00 PM,48,-122,34,25,59
16625,ElliotBayTrailMyrtlePark,11/24/2015 05:00:00 PM,48,-122,90,27,117
16626,ElliotBayTrailMyrtlePark,11/24/2015 06:00:00 PM,48,-122,74,10,84
16627,ElliotBayTrailMyrtlePark,11/24/2015 07:00:00 PM,48,-122,21,5,26
16628,ElliotBayTrailMyrtlePark,11/24/2015 08:00:00 PM,48,-122,10,4,14
16629,ElliotBayTrailMyrtlePark,11/24/2015 09:00:00 PM,48,-122,1,2,3
16630,ElliotBayTrailMyrtlePark,11/24/2015 10:00:00 PM,48,-122,3,1,4
16631,ElliotBayTrailMyrtlePark,11/24/2015 11:00:00 PM,48,-122,0,0,0
16632,ElliotBayTrailMyrtlePark,11/25/2015 12:00:00 AM,48,-122,1,0,1
16633,ElliotBayTrailMyrtlePark,11/25/2015 01:00:00 AM,48,-122,0,0,0
16634,ElliotBayTrailMyrtlePark,11/25/2015 02:00:00 AM,48,-122,1,0,1
16635,ElliotBayTrailMyrtlePark,11/25/2015 03:00:00 AM,48,-122,0,0,0
16636,ElliotBayTrailMyrtlePark,11/25/2015 04:00:00 AM,48,-122,1,0,1
16637,ElliotBayTrailMyrtlePark,11/25/2015 05:00:00 AM,48,-122,2,4,6
16638,ElliotBayTrailMyrtlePark,11/25/2015 06:00:00 AM,48,-122,10,15,25
16639,ElliotBayTrailMyrtlePark,11/25/2015 07:00:00 AM,48,-122,7,34,41
16640,ElliotBayTrailMyrtlePark,11/25/2015 08:00:00 AM,48,-122,28,70,98
16641,ElliotBayTrailMyrtlePark,11/25/2015 09:00:00 AM,48,-122,14,38,52
16642,ElliotBayTrailMyrtlePark,11/25/2015 10:00:00 AM,48,-122,7,26,33
16643,ElliotBayTrailMyrtlePark,11/25/2015 11:00:00 AM,48,-122,11,20,31
16644,ElliotBayTrailMyrtlePark,11/25/2015 12:00:00 PM,48,-122,9,15,24
16645,ElliotBayTrailMyrtlePark,11/25/2015 01:00:00 PM,48,-122,23,13,36
16646,ElliotBayTrailMyrtlePark,11/25/2015 02:00:00 PM,48,-122,24,14,38
16647,ElliotBayTrailMyrtlePark,11/25/2015 03:00:00 PM,48,-122,49,26,75
16648,ElliotBayTrailMyrtlePark,11/25/2015 04:00:00 PM,48,-122,57,38,95
16649,ElliotBayTrailMyrtlePark,11/25/2015 05:00:00 PM,48,-122,53,25,78
16650,ElliotBayTrailMyrtlePark,11/25/2015 06:00:00 PM,48,-122,33,7,40
16651,ElliotBayTrailMyrtlePark,11/25/2015 07:00:00 PM,48,-122,16,2,18
16652,ElliotBayTrailMyrtlePark,11/25/2015 08:00:00 PM,48,-122,7,1,8
16653,ElliotBayTrailMyrtlePark,11/25/2015 09:00:00 PM,48,-122,4,4,8
16654,ElliotBayTrailMyrtlePark,11/25/2015 10:00:00 PM,48,-122,2,1,3
16655,ElliotBayTrailMyrtlePark,11/25/2015 11:00:00 PM,48,-122,1,2,3
16656,ElliotBayTrailMyrtlePark,11/26/2015 12:00:00 AM,48,-122,0,2,2
16657,ElliotBayTrailMyrtlePark,11/26/2015 01:00:00 AM,48,-122,2,0,2
16658,ElliotBayTrailMyrtlePark,11/26/2015 02:00:00 AM,48,-122,1,1,2
16659,ElliotBayTrailMyrtlePark,11/26/2015 03:00:00 AM,48,-122,1,0,1
16660,ElliotBayTrailMyrtlePark,11/26/2015 04:00:00 AM,48,-122,0,0,0
16661,ElliotBayTrailMyrtlePark,11/26/2015 05:00:00 AM,48,-122,1,0,1
16662,ElliotBayTrailMyrtlePark,11/26/2015 06:00:00 AM,48,-122,0,1,1
16663,ElliotBayTrailMyrtlePark,11/26/2015 07:00:00 AM,48,-122,0,3,3
16664,ElliotBayTrailMyrtlePark,11/26/2015 08:00:00 AM,48,-122,5,4,9
16665,ElliotBayTrailMyrtlePark,11/26/2015 09:00:00 AM,48,-122,13,17,30
16666,ElliotBayTrailMyrtlePark,11/26/2015 10:00:00 AM,48,-122,12,5,17
16667,ElliotBayTrailMyrtlePark,11/26/2015 11:00:00 AM,48,-122,25,17,42
16668,ElliotBayTrailMyrtlePark,11/26/2015 12:00:00 PM,48,-122,15,14,29
16669,ElliotBayTrailMyrtlePark,11/26/2015 01:00:00 PM,48,-122,40,39,79
16670,ElliotBayTrailMyrtlePark,11/26/2015 02:00:00 PM,48,-122,20,20,40
16671,ElliotBayTrailMyrtlePark,11/26/2015 03:00:00 PM,48,-122,12,20,32
16672,ElliotBayTrailMyrtlePark,11/26/2015 04:00:00 PM,48,-122,13,11,24
16673,ElliotBayTrailMyrtlePark,11/26/2015 05:00:00 PM,48,-122,3,4,7
16674,ElliotBayTrailMyrtlePark,11/26/2015 06:00:00 PM,48,-122,3,3,6
16675,ElliotBayTrailMyrtlePark,11/26/2015 07:00:00 PM,48,-122,0,0,0
16676,ElliotBayTrailMyrtlePark,11/26/2015 08:00:00 PM,48,-122,2,0,2
16677,ElliotBayTrailMyrtlePark,11/26/2015 09:00:00 PM,48,-122,0,2,2
16678,ElliotBayTrailMyrtlePark,11/26/2015 10:00:00 PM,48,-122,1,0,1
16679,ElliotBayTrailMyrtlePark,11/26/2015 11:00:00 PM,48,-122,0,0,0
16680,ElliotBayTrailMyrtlePark,11/27/2015 12:00:00 AM,48,-122,0,0,0
16681,ElliotBayTrailMyrtlePark,11/27/2015 01:00:00 AM,48,-122,0,0,0
16682,ElliotBayTrailMyrtlePark,11/27/2015 02:00:00 AM,48,-122,0,0,0
16683,ElliotBayTrailMyrtlePark,11/27/2015 03:00:00 AM,48,-122,0,0,0
16684,ElliotBayTrailMyrtlePark,11/27/2015 04:00:00 AM,48,-122,0,0,0
16685,ElliotBayTrailMyrtlePark,11/27/2015 05:00:00 AM,48,-122,1,0,1
16686,ElliotBayTrailMyrtlePark,11/27/2015 06:00:00 AM,48,-122,1,4,5
16687,ElliotBayTrailMyrtlePark,11/27/2015 07:00:00 AM,48,-122,1,4,5
16688,ElliotBayTrailMyrtlePark,11/27/2015 08:00:00 AM,48,-122,2,9,11
16689,ElliotBayTrailMyrtlePark,11/27/2015 09:00:00 AM,48,-122,3,8,11
16690,ElliotBayTrailMyrtlePark,11/27/2015 10:00:00 AM,48,-122,12,15,27
16691,ElliotBayTrailMyrtlePark,11/27/2015 11:00:00 AM,48,-122,11,22,33
16692,ElliotBayTrailMyrtlePark,11/27/2015 12:00:00 PM,48,-122,22,34,56
16693,ElliotBayTrailMyrtlePark,11/27/2015 01:00:00 PM,48,-122,27,23,50
16694,ElliotBayTrailMyrtlePark,11/27/2015 02:00:00 PM,48,-122,34,18,52
16695,ElliotBayTrailMyrtlePark,11/27/2015 03:00:00 PM,48,-122,35,20,55
16696,ElliotBayTrailMyrtlePark,11/27/2015 04:00:00 PM,48,-122,29,26,55
16697,ElliotBayTrailMyrtlePark,11/27/2015 05:00:00 PM,48,-122,7,8,15
16698,ElliotBayTrailMyrtlePark,11/27/2015 06:00:00 PM,48,-122,5,6,11
16699,ElliotBayTrailMyrtlePark,11/27/2015 07:00:00 PM,48,-122,6,1,7
16700,ElliotBayTrailMyrtlePark,11/27/2015 08:00:00 PM,48,-122,1,0,1
16701,ElliotBayTrailMyrtlePark,11/27/2015 09:00:00 PM,48,-122,0,3,3
16702,ElliotBayTrailMyrtlePark,11/27/2015 10:00:00 PM,48,-122,2,2,4
16703,ElliotBayTrailMyrtlePark,11/27/2015 11:00:00 PM,48,-122,1,0,1
16704,ElliotBayTrailMyrtlePark,11/28/2015 12:00:00 AM,48,-122,1,0,1
16705,ElliotBayTrailMyrtlePark,11/28/2015 01:00:00 AM,48,-122,2,0,2
16706,ElliotBayTrailMyrtlePark,11/28/2015 02:00:00 AM,48,-122,0,0,0
16707,ElliotBayTrailMyrtlePark,11/28/2015 03:00:00 AM,48,-122,1,1,2
16708,ElliotBayTrailMyrtlePark,11/28/2015 04:00:00 AM,48,-122,0,1,1
16709,ElliotBayTrailMyrtlePark,11/28/2015 05:00:00 AM,48,-122,0,0,0
16710,ElliotBayTrailMyrtlePark,11/28/2015 06:00:00 AM,48,-122,0,7,7
16711,ElliotBayTrailMyrtlePark,11/28/2015 07:00:00 AM,48,-122,0,1,1
16712,ElliotBayTrailMyrtlePark,11/28/2015 08:00:00 AM,48,-122,2,1,3
16713,ElliotBayTrailMyrtlePark,11/28/2015 09:00:00 AM,48,-122,6,3,9
16714,ElliotBayTrailMyrtlePark,11/28/2015 10:00:00 AM,48,-122,4,12,16
16715,ElliotBayTrailMyrtlePark,11/28/2015 11:00:00 AM,48,-122,12,15,27
16716,ElliotBayTrailMyrtlePark,11/28/2015 12:00:00 PM,48,-122,16,19,35
16717,ElliotBayTrailMyrtlePark,11/28/2015 01:00:00 PM,48,-122,21,32,53
16718,ElliotBayTrailMyrtlePark,11/28/2015 02:00:00 PM,48,-122,36,36,72
16719,ElliotBayTrailMyrtlePark,11/28/2015 03:00:00 PM,48,-122,38,24,62
16720,ElliotBayTrailMyrtlePark,11/28/2015 04:00:00 PM,48,-122,40,28,68
16721,ElliotBayTrailMyrtlePark,11/28/2015 05:00:00 PM,48,-122,9,12,21
16722,ElliotBayTrailMyrtlePark,11/28/2015 06:00:00 PM,48,-122,3,14,17
16723,ElliotBayTrailMyrtlePark,11/28/2015 07:00:00 PM,48,-122,4,3,7
16724,ElliotBayTrailMyrtlePark,11/28/2015 08:00:00 PM,48,-122,6,0,6
16725,ElliotBayTrailMyrtlePark,11/28/2015 09:00:00 PM,48,-122,1,4,5
16726,ElliotBayTrailMyrtlePark,11/28/2015 10:00:00 PM,48,-122,2,1,3
16727,ElliotBayTrailMyrtlePark,11/28/2015 11:00:00 PM,48,-122,7,1,8
16728,ElliotBayTrailMyrtlePark,11/29/2015 12:00:00 AM,48,-122,0,0,0
16729,ElliotBayTrailMyrtlePark,11/29/2015 01:00:00 AM,48,-122,0,0,0
16730,ElliotBayTrailMyrtlePark,11/29/2015 02:00:00 AM,48,-122,0,0,0
16731,ElliotBayTrailMyrtlePark,11/29/2015 03:00:00 AM,48,-122,1,0,1
16732,ElliotBayTrailMyrtlePark,11/29/2015 04:00:00 AM,48,-122,0,0,0
16733,ElliotBayTrailMyrtlePark,11/29/2015 05:00:00 AM,48,-122,0,0,0
16734,ElliotBayTrailMyrtlePark,11/29/2015 06:00:00 AM,48,-122,0,3,3
16735,ElliotBayTrailMyrtlePark,11/29/2015 07:00:00 AM,48,-122,1,1,2
16736,ElliotBayTrailMyrtlePark,11/29/2015 08:00:00 AM,48,-122,3,4,7
16737,ElliotBayTrailMyrtlePark,11/29/2015 09:00:00 AM,48,-122,7,5,12
16738,ElliotBayTrailMyrtlePark,11/29/2015 10:00:00 AM,48,-122,9,15,24
16739,ElliotBayTrailMyrtlePark,11/29/2015 11:00:00 AM,48,-122,24,18,42
16740,ElliotBayTrailMyrtlePark,11/29/2015 12:00:00 PM,48,-122,13,20,33
16741,ElliotBayTrailMyrtlePark,11/29/2015 01:00:00 PM,48,-122,29,31,60
16742,ElliotBayTrailMyrtlePark,11/29/2015 02:00:00 PM,48,-122,21,12,33
16743,ElliotBayTrailMyrtlePark,11/29/2015 03:00:00 PM,48,-122,24,19,43
16744,ElliotBayTrailMyrtlePark,11/29/2015 04:00:00 PM,48,-122,6,10,16
16745,ElliotBayTrailMyrtlePark,11/29/2015 05:00:00 PM,48,-122,8,6,14
16746,ElliotBayTrailMyrtlePark,11/29/2015 06:00:00 PM,48,-122,7,3,10
16747,ElliotBayTrailMyrtlePark,11/29/2015 07:00:00 PM,48,-122,6,1,7
16748,ElliotBayTrailMyrtlePark,11/29/2015 08:00:00 PM,48,-122,1,0,1
16749,ElliotBayTrailMyrtlePark,11/29/2015 09:00:00 PM,48,-122,2,1,3
16750,ElliotBayTrailMyrtlePark,11/29/2015 10:00:00 PM,48,-122,2,0,2
16751,ElliotBayTrailMyrtlePark,11/29/2015 11:00:00 PM,48,-122,2,1,3
16752,ElliotBayTrailMyrtlePark,11/30/2015 12:00:00 AM,48,-122,0,0,0
16753,ElliotBayTrailMyrtlePark,11/30/2015 01:00:00 AM,48,-122,1,0,1
16754,ElliotBayTrailMyrtlePark,11/30/2015 02:00:00 AM,48,-122,1,0,1
16755,ElliotBayTrailMyrtlePark,11/30/2015 03:00:00 AM,48,-122,0,0,0
16756,ElliotBayTrailMyrtlePark,11/30/2015 04:00:00 AM,48,-122,0,0,0
16757,ElliotBayTrailMyrtlePark,11/30/2015 05:00:00 AM,48,-122,3,2,5
16758,ElliotBayTrailMyrtlePark,11/30/2015 06:00:00 AM,48,-122,7,22,29
16759,ElliotBayTrailMyrtlePark,11/30/2015 07:00:00 AM,48,-122,19,40,59
16760,ElliotBayTrailMyrtlePark,11/30/2015 08:00:00 AM,48,-122,27,93,120
16761,ElliotBayTrailMyrtlePark,11/30/2015 09:00:00 AM,48,-122,19,60,79
16762,ElliotBayTrailMyrtlePark,11/30/2015 10:00:00 AM,48,-122,8,27,35
16763,ElliotBayTrailMyrtlePark,11/30/2015 11:00:00 AM,48,-122,9,4,13
16764,ElliotBayTrailMyrtlePark,11/30/2015 12:00:00 PM,48,-122,9,11,20
16765,ElliotBayTrailMyrtlePark,11/30/2015 01:00:00 PM,48,-122,12,14,26
16766,ElliotBayTrailMyrtlePark,11/30/2015 02:00:00 PM,48,-122,25,23,48
16767,ElliotBayTrailMyrtlePark,11/30/2015 03:00:00 PM,48,-122,12,17,29
16768,ElliotBayTrailMyrtlePark,11/30/2015 04:00:00 PM,48,-122,35,25,60
16769,ElliotBayTrailMyrtlePark,11/30/2015 05:00:00 PM,48,-122,100,25,125
16770,ElliotBayTrailMyrtlePark,11/30/2015 06:00:00 PM,48,-122,74,10,84
16771,ElliotBayTrailMyrtlePark,11/30/2015 07:00:00 PM,48,-122,29,5,34
16772,ElliotBayTrailMyrtlePark,11/30/2015 08:00:00 PM,48,-122,9,1,10
16773,ElliotBayTrailMyrtlePark,11/30/2015 09:00:00 PM,48,-122,9,4,13
16774,ElliotBayTrailMyrtlePark,11/30/2015 10:00:00 PM,48,-122,1,0,1
16775,ElliotBayTrailMyrtlePark,11/30/2015 11:00:00 PM,48,-122,1,2,3
16776,ElliotBayTrailMyrtlePark,12/01/2015 12:00:00 AM,48,-122,1,0,1
16777,ElliotBayTrailMyrtlePark,12/01/2015 01:00:00 AM,48,-122,0,0,0
16778,ElliotBayTrailMyrtlePark,12/01/2015 02:00:00 AM,48,-122,1,0,1
16779,ElliotBayTrailMyrtlePark,12/01/2015 03:00:00 AM,48,-122,1,0,1
16780,ElliotBayTrailMyrtlePark,12/01/2015 04:00:00 AM,48,-122,0,0,0
16781,ElliotBayTrailMyrtlePark,12/01/2015 05:00:00 AM,48,-122,4,3,7
16782,ElliotBayTrailMyrtlePark,12/01/2015 06:00:00 AM,48,-122,11,31,42
16783,ElliotBayTrailMyrtlePark,12/01/2015 07:00:00 AM,48,-122,14,40,54
16784,ElliotBayTrailMyrtlePark,12/01/2015 08:00:00 AM,48,-122,24,115,139
16785,ElliotBayTrailMyrtlePark,12/01/2015 09:00:00 AM,48,-122,29,70,99
16786,ElliotBayTrailMyrtlePark,12/01/2015 10:00:00 AM,48,-122,16,29,45
16787,ElliotBayTrailMyrtlePark,12/01/2015 11:00:00 AM,48,-122,10,12,22
16788,ElliotBayTrailMyrtlePark,12/01/2015 12:00:00 PM,48,-122,17,18,35
16789,ElliotBayTrailMyrtlePark,12/01/2015 01:00:00 PM,48,-122,15,12,27
16790,ElliotBayTrailMyrtlePark,12/01/2015 02:00:00 PM,48,-122,22,14,36
16791,ElliotBayTrailMyrtlePark,12/01/2015 03:00:00 PM,48,-122,24,14,38
16792,ElliotBayTrailMyrtlePark,12/01/2015 04:00:00 PM,48,-122,35,26,61
16793,ElliotBayTrailMyrtlePark,12/01/2015 05:00:00 PM,48,-122,118,27,145
16794,ElliotBayTrailMyrtlePark,12/01/2015 06:00:00 PM,48,-122,102,12,114
16795,ElliotBayTrailMyrtlePark,12/01/2015 07:00:00 PM,48,-122,24,4,28
16796,ElliotBayTrailMyrtlePark,12/01/2015 08:00:00 PM,48,-122,3,2,5
16797,ElliotBayTrailMyrtlePark,12/01/2015 09:00:00 PM,48,-122,2,1,3
16798,ElliotBayTrailMyrtlePark,12/01/2015 10:00:00 PM,48,-122,2,0,2
16799,ElliotBayTrailMyrtlePark,12/01/2015 11:00:00 PM,48,-122,1,0,1
16800,ElliotBayTrailMyrtlePark,12/02/2015 12:00:00 AM,48,-122,0,0,0
16801,ElliotBayTrailMyrtlePark,12/02/2015 01:00:00 AM,48,-122,1,0,1
16802,ElliotBayTrailMyrtlePark,12/02/2015 02:00:00 AM,48,-122,0,0,0
16803,ElliotBayTrailMyrtlePark,12/02/2015 03:00:00 AM,48,-122,0,0,0
16804,ElliotBayTrailMyrtlePark,12/02/2015 04:00:00 AM,48,-122,1,0,1
16805,ElliotBayTrailMyrtlePark,12/02/2015 05:00:00 AM,48,-122,3,4,7
16806,ElliotBayTrailMyrtlePark,12/02/2015 06:00:00 AM,48,-122,8,25,33
16807,ElliotBayTrailMyrtlePark,12/02/2015 07:00:00 AM,48,-122,19,34,53
16808,ElliotBayTrailMyrtlePark,12/02/2015 08:00:00 AM,48,-122,30,113,143
16809,ElliotBayTrailMyrtlePark,12/02/2015 09:00:00 AM,48,-122,13,66,79
16810,ElliotBayTrailMyrtlePark,12/02/2015 10:00:00 AM,48,-122,17,27,44
16811,ElliotBayTrailMyrtlePark,12/02/2015 11:00:00 AM,48,-122,3,8,11
16812,ElliotBayTrailMyrtlePark,12/02/2015 12:00:00 PM,48,-122,9,11,20
16813,ElliotBayTrailMyrtlePark,12/02/2015 01:00:00 PM,48,-122,12,12,24
16814,ElliotBayTrailMyrtlePark,12/02/2015 02:00:00 PM,48,-122,12,17,29
16815,ElliotBayTrailMyrtlePark,12/02/2015 03:00:00 PM,48,-122,21,10,31
16816,ElliotBayTrailMyrtlePark,12/02/2015 04:00:00 PM,48,-122,43,27,70
16817,ElliotBayTrailMyrtlePark,12/02/2015 05:00:00 PM,48,-122,106,30,136
16818,ElliotBayTrailMyrtlePark,12/02/2015 06:00:00 PM,48,-122,102,11,113
16819,ElliotBayTrailMyrtlePark,12/02/2015 07:00:00 PM,48,-122,29,6,35
16820,ElliotBayTrailMyrtlePark,12/02/2015 08:00:00 PM,48,-122,5,1,6
16821,ElliotBayTrailMyrtlePark,12/02/2015 09:00:00 PM,48,-122,6,7,13
16822,ElliotBayTrailMyrtlePark,12/02/2015 10:00:00 PM,48,-122,2,3,5
16823,ElliotBayTrailMyrtlePark,12/02/2015 11:00:00 PM,48,-122,4,1,5
16824,ElliotBayTrailMyrtlePark,12/03/2015 12:00:00 AM,48,-122,1,0,1
16825,ElliotBayTrailMyrtlePark,12/03/2015 01:00:00 AM,48,-122,1,2,3
16826,ElliotBayTrailMyrtlePark,12/03/2015 02:00:00 AM,48,-122,0,0,0
16827,ElliotBayTrailMyrtlePark,12/03/2015 03:00:00 AM,48,-122,2,0,2
16828,ElliotBayTrailMyrtlePark,12/03/2015 04:00:00 AM,48,-122,0,0,0
16829,ElliotBayTrailMyrtlePark,12/03/2015 05:00:00 AM,48,-122,6,2,8
16830,ElliotBayTrailMyrtlePark,12/03/2015 06:00:00 AM,48,-122,7,13,20
16831,ElliotBayTrailMyrtlePark,12/03/2015 07:00:00 AM,48,-122,14,30,44
16832,ElliotBayTrailMyrtlePark,12/03/2015 08:00:00 AM,48,-122,25,70,95
16833,ElliotBayTrailMyrtlePark,12/03/2015 09:00:00 AM,48,-122,16,43,59
16834,ElliotBayTrailMyrtlePark,12/03/2015 10:00:00 AM,48,-122,7,13,20
16835,ElliotBayTrailMyrtlePark,12/03/2015 11:00:00 AM,48,-122,3,12,15
16836,ElliotBayTrailMyrtlePark,12/03/2015 12:00:00 PM,48,-122,3,7,10
16837,ElliotBayTrailMyrtlePark,12/03/2015 01:00:00 PM,48,-122,5,5,10
16838,ElliotBayTrailMyrtlePark,12/03/2015 02:00:00 PM,48,-122,7,4,11
16839,ElliotBayTrailMyrtlePark,12/03/2015 03:00:00 PM,48,-122,7,12,19
16840,ElliotBayTrailMyrtlePark,12/03/2015 04:00:00 PM,48,-122,20,20,40
16841,ElliotBayTrailMyrtlePark,12/03/2015 05:00:00 PM,48,-122,75,23,98
16842,ElliotBayTrailMyrtlePark,12/03/2015 06:00:00 PM,48,-122,58,9,67
16843,ElliotBayTrailMyrtlePark,12/03/2015 07:00:00 PM,48,-122,25,4,29
16844,ElliotBayTrailMyrtlePark,12/03/2015 08:00:00 PM,48,-122,8,1,9
16845,ElliotBayTrailMyrtlePark,12/03/2015 09:00:00 PM,48,-122,7,3,10
16846,ElliotBayTrailMyrtlePark,12/03/2015 10:00:00 PM,48,-122,1,1,2
16847,ElliotBayTrailMyrtlePark,12/03/2015 11:00:00 PM,48,-122,2,0,2
16848,ElliotBayTrailMyrtlePark,12/04/2015 12:00:00 AM,48,-122,0,0,0
16849,ElliotBayTrailMyrtlePark,12/04/2015 01:00:00 AM,48,-122,0,0,0
16850,ElliotBayTrailMyrtlePark,12/04/2015 02:00:00 AM,48,-122,2,0,2
16851,ElliotBayTrailMyrtlePark,12/04/2015 03:00:00 AM,48,-122,1,0,1
16852,ElliotBayTrailMyrtlePark,12/04/2015 04:00:00 AM,48,-122,0,0,0
16853,ElliotBayTrailMyrtlePark,12/04/2015 05:00:00 AM,48,-122,6,5,11
16854,ElliotBayTrailMyrtlePark,12/04/2015 06:00:00 AM,48,-122,5,19,24
16855,ElliotBayTrailMyrtlePark,12/04/2015 07:00:00 AM,48,-122,12,31,43
16856,ElliotBayTrailMyrtlePark,12/04/2015 08:00:00 AM,48,-122,22,98,120
16857,ElliotBayTrailMyrtlePark,12/04/2015 09:00:00 AM,48,-122,19,59,78
16858,ElliotBayTrailMyrtlePark,12/04/2015 10:00:00 AM,48,-122,9,23,32
16859,ElliotBayTrailMyrtlePark,12/04/2015 11:00:00 AM,48,-122,13,18,31
16860,ElliotBayTrailMyrtlePark,12/04/2015 12:00:00 PM,48,-122,7,17,24
16861,ElliotBayTrailMyrtlePark,12/04/2015 01:00:00 PM,48,-122,8,10,18
16862,ElliotBayTrailMyrtlePark,12/04/2015 02:00:00 PM,48,-122,19,17,36
16863,ElliotBayTrailMyrtlePark,12/04/2015 03:00:00 PM,48,-122,22,16,38
16864,ElliotBayTrailMyrtlePark,12/04/2015 04:00:00 PM,48,-122,44,29,73
16865,ElliotBayTrailMyrtlePark,12/04/2015 05:00:00 PM,48,-122,109,25,134
16866,ElliotBayTrailMyrtlePark,12/04/2015 06:00:00 PM,48,-122,79,10,89
16867,ElliotBayTrailMyrtlePark,12/04/2015 07:00:00 PM,48,-122,24,2,26
16868,ElliotBayTrailMyrtlePark,12/04/2015 08:00:00 PM,48,-122,6,2,8
16869,ElliotBayTrailMyrtlePark,12/04/2015 09:00:00 PM,48,-122,0,4,4
16870,ElliotBayTrailMyrtlePark,12/04/2015 10:00:00 PM,48,-122,4,3,7
16871,ElliotBayTrailMyrtlePark,12/04/2015 11:00:00 PM,48,-122,7,2,9
16872,ElliotBayTrailMyrtlePark,12/05/2015 12:00:00 AM,48,-122,1,1,2
16873,ElliotBayTrailMyrtlePark,12/05/2015 01:00:00 AM,48,-122,5,0,5
16874,ElliotBayTrailMyrtlePark,12/05/2015 02:00:00 AM,48,-122,0,0,0
16875,ElliotBayTrailMyrtlePark,12/05/2015 03:00:00 AM,48,-122,9,0,9
16876,ElliotBayTrailMyrtlePark,12/05/2015 04:00:00 AM,48,-122,0,0,0
16877,ElliotBayTrailMyrtlePark,12/05/2015 05:00:00 AM,48,-122,1,0,1
16878,ElliotBayTrailMyrtlePark,12/05/2015 06:00:00 AM,48,-122,1,4,5
16879,ElliotBayTrailMyrtlePark,12/05/2015 07:00:00 AM,48,-122,1,5,6
16880,ElliotBayTrailMyrtlePark,12/05/2015 08:00:00 AM,48,-122,3,6,9
16881,ElliotBayTrailMyrtlePark,12/05/2015 09:00:00 AM,48,-122,4,9,13
16882,ElliotBayTrailMyrtlePark,12/05/2015 10:00:00 AM,48,-122,2,4,6
16883,ElliotBayTrailMyrtlePark,12/05/2015 11:00:00 AM,48,-122,7,2,9
16884,ElliotBayTrailMyrtlePark,12/05/2015 12:00:00 PM,48,-122,3,1,4
16885,ElliotBayTrailMyrtlePark,12/05/2015 01:00:00 PM,48,-122,4,4,8
16886,ElliotBayTrailMyrtlePark,12/05/2015 02:00:00 PM,48,-122,4,4,8
16887,ElliotBayTrailMyrtlePark,12/05/2015 03:00:00 PM,48,-122,3,3,6
16888,ElliotBayTrailMyrtlePark,12/05/2015 04:00:00 PM,48,-122,4,4,8
16889,ElliotBayTrailMyrtlePark,12/05/2015 05:00:00 PM,48,-122,2,1,3
16890,ElliotBayTrailMyrtlePark,12/05/2015 06:00:00 PM,48,-122,0,1,1
16891,ElliotBayTrailMyrtlePark,12/05/2015 07:00:00 PM,48,-122,3,0,3
16892,ElliotBayTrailMyrtlePark,12/05/2015 08:00:00 PM,48,-122,1,0,1
16893,ElliotBayTrailMyrtlePark,12/05/2015 09:00:00 PM,48,-122,0,2,2
16894,ElliotBayTrailMyrtlePark,12/05/2015 10:00:00 PM,48,-122,0,0,0
16895,ElliotBayTrailMyrtlePark,12/05/2015 11:00:00 PM,48,-122,0,0,0
16896,ElliotBayTrailMyrtlePark,12/06/2015 12:00:00 AM,48,-122,0,0,0
16897,ElliotBayTrailMyrtlePark,12/06/2015 01:00:00 AM,48,-122,0,0,0
16898,ElliotBayTrailMyrtlePark,12/06/2015 02:00:00 AM,48,-122,0,0,0
16899,ElliotBayTrailMyrtlePark,12/06/2015 03:00:00 AM,48,-122,1,0,1
16900,ElliotBayTrailMyrtlePark,12/06/2015 04:00:00 AM,48,-122,0,0,0
16901,ElliotBayTrailMyrtlePark,12/06/2015 05:00:00 AM,48,-122,0,0,0
16902,ElliotBayTrailMyrtlePark,12/06/2015 06:00:00 AM,48,-122,0,1,1
16903,ElliotBayTrailMyrtlePark,12/06/2015 07:00:00 AM,48,-122,1,1,2
16904,ElliotBayTrailMyrtlePark,12/06/2015 08:00:00 AM,48,-122,1,1,2
16905,ElliotBayTrailMyrtlePark,12/06/2015 09:00:00 AM,48,-122,6,3,9
16906,ElliotBayTrailMyrtlePark,12/06/2015 10:00:00 AM,48,-122,7,4,11
16907,ElliotBayTrailMyrtlePark,12/06/2015 11:00:00 AM,48,-122,10,9,19
16908,ElliotBayTrailMyrtlePark,12/06/2015 12:00:00 PM,48,-122,19,11,30
16909,ElliotBayTrailMyrtlePark,12/06/2015 01:00:00 PM,48,-122,14,11,25
16910,ElliotBayTrailMyrtlePark,12/06/2015 02:00:00 PM,48,-122,19,16,35
16911,ElliotBayTrailMyrtlePark,12/06/2015 03:00:00 PM,48,-122,22,19,41
16912,ElliotBayTrailMyrtlePark,12/06/2015 04:00:00 PM,48,-122,10,14,24
16913,ElliotBayTrailMyrtlePark,12/06/2015 05:00:00 PM,48,-122,5,4,9
16914,ElliotBayTrailMyrtlePark,12/06/2015 06:00:00 PM,48,-122,0,0,0
16915,ElliotBayTrailMyrtlePark,12/06/2015 07:00:00 PM,48,-122,1,0,1
16916,ElliotBayTrailMyrtlePark,12/06/2015 08:00:00 PM,48,-122,1,0,1
16917,ElliotBayTrailMyrtlePark,12/06/2015 09:00:00 PM,48,-122,1,2,3
16918,ElliotBayTrailMyrtlePark,12/06/2015 10:00:00 PM,48,-122,0,1,1
16919,ElliotBayTrailMyrtlePark,12/06/2015 11:00:00 PM,48,-122,0,1,1
16920,ElliotBayTrailMyrtlePark,12/07/2015 12:00:00 AM,48,-122,1,0,1
16921,ElliotBayTrailMyrtlePark,12/07/2015 01:00:00 AM,48,-122,1,0,1
16922,ElliotBayTrailMyrtlePark,12/07/2015 02:00:00 AM,48,-122,0,1,1
16923,ElliotBayTrailMyrtlePark,12/07/2015 03:00:00 AM,48,-122,1,0,1
16924,ElliotBayTrailMyrtlePark,12/07/2015 04:00:00 AM,48,-122,0,0,0
16925,ElliotBayTrailMyrtlePark,12/07/2015 05:00:00 AM,48,-122,5,1,6
16926,ElliotBayTrailMyrtlePark,12/07/2015 06:00:00 AM,48,-122,8,20,28
16927,ElliotBayTrailMyrtlePark,12/07/2015 07:00:00 AM,48,-122,17,37,54
16928,ElliotBayTrailMyrtlePark,12/07/2015 08:00:00 AM,48,-122,24,98,122
16929,ElliotBayTrailMyrtlePark,12/07/2015 09:00:00 AM,48,-122,22,59,81
16930,ElliotBayTrailMyrtlePark,12/07/2015 10:00:00 AM,48,-122,5,15,20
16931,ElliotBayTrailMyrtlePark,12/07/2015 11:00:00 AM,48,-122,3,7,10
16932,ElliotBayTrailMyrtlePark,12/07/2015 12:00:00 PM,48,-122,3,6,9
16933,ElliotBayTrailMyrtlePark,12/07/2015 01:00:00 PM,48,-122,6,2,8
16934,ElliotBayTrailMyrtlePark,12/07/2015 02:00:00 PM,48,-122,3,3,6
16935,ElliotBayTrailMyrtlePark,12/07/2015 03:00:00 PM,48,-122,9,7,16
16936,ElliotBayTrailMyrtlePark,12/07/2015 04:00:00 PM,48,-122,29,21,50
16937,ElliotBayTrailMyrtlePark,12/07/2015 05:00:00 PM,48,-122,88,25,113
16938,ElliotBayTrailMyrtlePark,12/07/2015 06:00:00 PM,48,-122,88,11,99
16939,ElliotBayTrailMyrtlePark,12/07/2015 07:00:00 PM,48,-122,23,5,28
16940,ElliotBayTrailMyrtlePark,12/07/2015 08:00:00 PM,48,-122,10,0,10
16941,ElliotBayTrailMyrtlePark,12/07/2015 09:00:00 PM,48,-122,4,2,6
16942,ElliotBayTrailMyrtlePark,12/07/2015 10:00:00 PM,48,-122,3,0,3
16943,ElliotBayTrailMyrtlePark,12/07/2015 11:00:00 PM,48,-122,1,0,1
16944,ElliotBayTrailMyrtlePark,12/08/2015 12:00:00 AM,48,-122,1,1,2
16945,ElliotBayTrailMyrtlePark,12/08/2015 01:00:00 AM,48,-122,0,0,0
16946,ElliotBayTrailMyrtlePark,12/08/2015 02:00:00 AM,48,-122,0,0,0
16947,ElliotBayTrailMyrtlePark,12/08/2015 03:00:00 AM,48,-122,1,1,2
16948,ElliotBayTrailMyrtlePark,12/08/2015 04:00:00 AM,48,-122,0,0,0
16949,ElliotBayTrailMyrtlePark,12/08/2015 05:00:00 AM,48,-122,4,5,9
16950,ElliotBayTrailMyrtlePark,12/08/2015 06:00:00 AM,48,-122,8,17,25
16951,ElliotBayTrailMyrtlePark,12/08/2015 07:00:00 AM,48,-122,13,29,42
16952,ElliotBayTrailMyrtlePark,12/08/2015 08:00:00 AM,48,-122,17,74,91
16953,ElliotBayTrailMyrtlePark,12/08/2015 09:00:00 AM,48,-122,22,53,75
16954,ElliotBayTrailMyrtlePark,12/08/2015 10:00:00 AM,48,-122,7,10,17
16955,ElliotBayTrailMyrtlePark,12/08/2015 11:00:00 AM,48,-122,7,11,18
16956,ElliotBayTrailMyrtlePark,12/08/2015 12:00:00 PM,48,-122,3,2,5
16957,ElliotBayTrailMyrtlePark,12/08/2015 01:00:00 PM,48,-122,1,4,5
16958,ElliotBayTrailMyrtlePark,12/08/2015 02:00:00 PM,48,-122,7,1,8
16959,ElliotBayTrailMyrtlePark,12/08/2015 03:00:00 PM,48,-122,7,10,17
16960,ElliotBayTrailMyrtlePark,12/08/2015 04:00:00 PM,48,-122,23,20,43
16961,ElliotBayTrailMyrtlePark,12/08/2015 05:00:00 PM,48,-122,60,26,86
16962,ElliotBayTrailMyrtlePark,12/08/2015 06:00:00 PM,48,-122,68,4,72
16963,ElliotBayTrailMyrtlePark,12/08/2015 07:00:00 PM,48,-122,22,7,29
16964,ElliotBayTrailMyrtlePark,12/08/2015 08:00:00 PM,48,-122,4,0,4
16965,ElliotBayTrailMyrtlePark,12/08/2015 09:00:00 PM,48,-122,1,3,4
16966,ElliotBayTrailMyrtlePark,12/08/2015 10:00:00 PM,48,-122,1,0,1
16967,ElliotBayTrailMyrtlePark,12/08/2015 11:00:00 PM,48,-122,0,0,0
16968,ElliotBayTrailMyrtlePark,12/09/2015 12:00:00 AM,48,-122,0,0,0
16969,ElliotBayTrailMyrtlePark,12/09/2015 01:00:00 AM,48,-122,2,0,2
16970,ElliotBayTrailMyrtlePark,12/09/2015 02:00:00 AM,48,-122,0,0,0
16971,ElliotBayTrailMyrtlePark,12/09/2015 03:00:00 AM,48,-122,1,0,1
16972,ElliotBayTrailMyrtlePark,12/09/2015 04:00:00 AM,48,-122,0,0,0
16973,ElliotBayTrailMyrtlePark,12/09/2015 05:00:00 AM,48,-122,5,4,9
16974,ElliotBayTrailMyrtlePark,12/09/2015 06:00:00 AM,48,-122,8,14,22
16975,ElliotBayTrailMyrtlePark,12/09/2015 07:00:00 AM,48,-122,19,25,44
16976,ElliotBayTrailMyrtlePark,12/09/2015 08:00:00 AM,48,-122,24,63,87
16977,ElliotBayTrailMyrtlePark,12/09/2015 09:00:00 AM,48,-122,18,59,77
16978,ElliotBayTrailMyrtlePark,12/09/2015 10:00:00 AM,48,-122,8,22,30
16979,ElliotBayTrailMyrtlePark,12/09/2015 11:00:00 AM,48,-122,4,9,13
16980,ElliotBayTrailMyrtlePark,12/09/2015 12:00:00 PM,48,-122,12,9,21
16981,ElliotBayTrailMyrtlePark,12/09/2015 01:00:00 PM,48,-122,6,12,18
16982,ElliotBayTrailMyrtlePark,12/09/2015 02:00:00 PM,48,-122,16,10,26
16983,ElliotBayTrailMyrtlePark,12/09/2015 03:00:00 PM,48,-122,15,18,33
16984,ElliotBayTrailMyrtlePark,12/09/2015 04:00:00 PM,48,-122,43,21,64
16985,ElliotBayTrailMyrtlePark,12/09/2015 05:00:00 PM,48,-122,86,26,112
16986,ElliotBayTrailMyrtlePark,12/09/2015 06:00:00 PM,48,-122,76,18,94
16987,ElliotBayTrailMyrtlePark,12/09/2015 07:00:00 PM,48,-122,36,13,49
16988,ElliotBayTrailMyrtlePark,12/09/2015 08:00:00 PM,48,-122,3,2,5
16989,ElliotBayTrailMyrtlePark,12/09/2015 09:00:00 PM,48,-122,8,1,9
16990,ElliotBayTrailMyrtlePark,12/09/2015 10:00:00 PM,48,-122,2,0,2
16991,ElliotBayTrailMyrtlePark,12/09/2015 11:00:00 PM,48,-122,4,3,7
16992,ElliotBayTrailMyrtlePark,12/10/2015 12:00:00 AM,48,-122,1,1,2
16993,ElliotBayTrailMyrtlePark,12/10/2015 01:00:00 AM,48,-122,0,0,0
16994,ElliotBayTrailMyrtlePark,12/10/2015 02:00:00 AM,48,-122,0,0,0
16995,ElliotBayTrailMyrtlePark,12/10/2015 03:00:00 AM,48,-122,0,0,0
16996,ElliotBayTrailMyrtlePark,12/10/2015 04:00:00 AM,48,-122,2,0,2
16997,ElliotBayTrailMyrtlePark,12/10/2015 05:00:00 AM,48,-122,7,1,8
16998,ElliotBayTrailMyrtlePark,12/10/2015 06:00:00 AM,48,-122,7,21,28
16999,ElliotBayTrailMyrtlePark,12/10/2015 07:00:00 AM,48,-122,18,35,53
17000,ElliotBayTrailMyrtlePark,12/10/2015 08:00:00 AM,48,-122,23,81,104
17001,ElliotBayTrailMyrtlePark,12/10/2015 09:00:00 AM,48,-122,14,56,70
17002,ElliotBayTrailMyrtlePark,12/10/2015 10:00:00 AM,48,-122,4,11,15
17003,ElliotBayTrailMyrtlePark,12/10/2015 11:00:00 AM,48,-122,3,4,7
17004,ElliotBayTrailMyrtlePark,12/10/2015 12:00:00 PM,48,-122,2,1,3
17005,ElliotBayTrailMyrtlePark,12/10/2015 01:00:00 PM,48,-122,2,3,5
17006,ElliotBayTrailMyrtlePark,12/10/2015 02:00:00 PM,48,-122,10,3,13
17007,ElliotBayTrailMyrtlePark,12/10/2015 03:00:00 PM,48,-122,11,13,24
17008,ElliotBayTrailMyrtlePark,12/10/2015 04:00:00 PM,48,-122,22,14,36
17009,ElliotBayTrailMyrtlePark,12/10/2015 05:00:00 PM,48,-122,64,21,85
17010,ElliotBayTrailMyrtlePark,12/10/2015 06:00:00 PM,48,-122,64,8,72
17011,ElliotBayTrailMyrtlePark,12/10/2015 07:00:00 PM,48,-122,26,2,28
17012,ElliotBayTrailMyrtlePark,12/10/2015 08:00:00 PM,48,-122,5,0,5
17013,ElliotBayTrailMyrtlePark,12/10/2015 09:00:00 PM,48,-122,3,1,4
17014,ElliotBayTrailMyrtlePark,12/10/2015 10:00:00 PM,48,-122,2,5,7
17015,ElliotBayTrailMyrtlePark,12/10/2015 11:00:00 PM,48,-122,4,0,4
17016,ElliotBayTrailMyrtlePark,12/11/2015 12:00:00 AM,48,-122,1,0,1
17017,ElliotBayTrailMyrtlePark,12/11/2015 01:00:00 AM,48,-122,0,0,0
17018,ElliotBayTrailMyrtlePark,12/11/2015 02:00:00 AM,48,-122,0,0,0
17019,ElliotBayTrailMyrtlePark,12/11/2015 03:00:00 AM,48,-122,2,0,2
17020,ElliotBayTrailMyrtlePark,12/11/2015 04:00:00 AM,48,-122,0,0,0
17021,ElliotBayTrailMyrtlePark,12/11/2015 05:00:00 AM,48,-122,6,6,12
17022,ElliotBayTrailMyrtlePark,12/11/2015 06:00:00 AM,48,-122,5,18,23
17023,ElliotBayTrailMyrtlePark,12/11/2015 07:00:00 AM,48,-122,16,33,49
17024,ElliotBayTrailMyrtlePark,12/11/2015 08:00:00 AM,48,-122,19,83,102
17025,ElliotBayTrailMyrtlePark,12/11/2015 09:00:00 AM,48,-122,26,53,79
17026,ElliotBayTrailMyrtlePark,12/11/2015 10:00:00 AM,48,-122,7,26,33
17027,ElliotBayTrailMyrtlePark,12/11/2015 11:00:00 AM,48,-122,8,16,24
17028,ElliotBayTrailMyrtlePark,12/11/2015 12:00:00 PM,48,-122,8,13,21
17029,ElliotBayTrailMyrtlePark,12/11/2015 01:00:00 PM,48,-122,14,16,30
17030,ElliotBayTrailMyrtlePark,12/11/2015 02:00:00 PM,48,-122,14,17,31
17031,ElliotBayTrailMyrtlePark,12/11/2015 03:00:00 PM,48,-122,22,21,43
17032,ElliotBayTrailMyrtlePark,12/11/2015 04:00:00 PM,48,-122,44,36,80
17033,ElliotBayTrailMyrtlePark,12/11/2015 05:00:00 PM,48,-122,83,27,110
17034,ElliotBayTrailMyrtlePark,12/11/2015 06:00:00 PM,48,-122,64,12,76
17035,ElliotBayTrailMyrtlePark,12/11/2015 07:00:00 PM,48,-122,23,6,29
17036,ElliotBayTrailMyrtlePark,12/11/2015 08:00:00 PM,48,-122,3,2,5
17037,ElliotBayTrailMyrtlePark,12/11/2015 09:00:00 PM,48,-122,8,4,12
17038,ElliotBayTrailMyrtlePark,12/11/2015 10:00:00 PM,48,-122,0,4,4
17039,ElliotBayTrailMyrtlePark,12/11/2015 11:00:00 PM,48,-122,2,4,6
17040,ElliotBayTrailMyrtlePark,12/12/2015 12:00:00 AM,48,-122,2,0,2
17041,ElliotBayTrailMyrtlePark,12/12/2015 01:00:00 AM,48,-122,1,0,1
17042,ElliotBayTrailMyrtlePark,12/12/2015 02:00:00 AM,48,-122,5,3,8
17043,ElliotBayTrailMyrtlePark,12/12/2015 03:00:00 AM,48,-122,1,0,1
17044,ElliotBayTrailMyrtlePark,12/12/2015 04:00:00 AM,48,-122,0,0,0
17045,ElliotBayTrailMyrtlePark,12/12/2015 05:00:00 AM,48,-122,1,1,2
17046,ElliotBayTrailMyrtlePark,12/12/2015 06:00:00 AM,48,-122,1,3,4
17047,ElliotBayTrailMyrtlePark,12/12/2015 07:00:00 AM,48,-122,2,4,6
17048,ElliotBayTrailMyrtlePark,12/12/2015 08:00:00 AM,48,-122,3,3,6
17049,ElliotBayTrailMyrtlePark,12/12/2015 09:00:00 AM,48,-122,6,3,9
17050,ElliotBayTrailMyrtlePark,12/12/2015 10:00:00 AM,48,-122,4,10,14
17051,ElliotBayTrailMyrtlePark,12/12/2015 11:00:00 AM,48,-122,5,3,8
17052,ElliotBayTrailMyrtlePark,12/12/2015 12:00:00 PM,48,-122,8,6,14
17053,ElliotBayTrailMyrtlePark,12/12/2015 01:00:00 PM,48,-122,4,1,5
17054,ElliotBayTrailMyrtlePark,12/12/2015 02:00:00 PM,48,-122,0,2,2
17055,ElliotBayTrailMyrtlePark,12/12/2015 03:00:00 PM,48,-122,7,2,9
17056,ElliotBayTrailMyrtlePark,12/12/2015 04:00:00 PM,48,-122,4,3,7
17057,ElliotBayTrailMyrtlePark,12/12/2015 05:00:00 PM,48,-122,1,5,6
17058,ElliotBayTrailMyrtlePark,12/12/2015 06:00:00 PM,48,-122,2,2,4
17059,ElliotBayTrailMyrtlePark,12/12/2015 07:00:00 PM,48,-122,4,0,4
17060,ElliotBayTrailMyrtlePark,12/12/2015 08:00:00 PM,48,-122,1,0,1
17061,ElliotBayTrailMyrtlePark,12/12/2015 09:00:00 PM,48,-122,3,0,3
17062,ElliotBayTrailMyrtlePark,12/12/2015 10:00:00 PM,48,-122,0,0,0
17063,ElliotBayTrailMyrtlePark,12/12/2015 11:00:00 PM,48,-122,1,0,1
17064,ElliotBayTrailMyrtlePark,12/13/2015 12:00:00 AM,48,-122,2,2,4
17065,ElliotBayTrailMyrtlePark,12/13/2015 01:00:00 AM,48,-122,0,0,0
17066,ElliotBayTrailMyrtlePark,12/13/2015 02:00:00 AM,48,-122,0,2,2
17067,ElliotBayTrailMyrtlePark,12/13/2015 03:00:00 AM,48,-122,1,0,1
17068,ElliotBayTrailMyrtlePark,12/13/2015 04:00:00 AM,48,-122,0,0,0
17069,ElliotBayTrailMyrtlePark,12/13/2015 05:00:00 AM,48,-122,0,0,0
17070,ElliotBayTrailMyrtlePark,12/13/2015 06:00:00 AM,48,-122,0,1,1
17071,ElliotBayTrailMyrtlePark,12/13/2015 07:00:00 AM,48,-122,3,2,5
17072,ElliotBayTrailMyrtlePark,12/13/2015 08:00:00 AM,48,-122,4,1,5
17073,ElliotBayTrailMyrtlePark,12/13/2015 09:00:00 AM,48,-122,3,2,5
17074,ElliotBayTrailMyrtlePark,12/13/2015 10:00:00 AM,48,-122,14,10,24
17075,ElliotBayTrailMyrtlePark,12/13/2015 11:00:00 AM,48,-122,6,6,12
17076,ElliotBayTrailMyrtlePark,12/13/2015 12:00:00 PM,48,-122,8,8,16
17077,ElliotBayTrailMyrtlePark,12/13/2015 01:00:00 PM,48,-122,8,9,17
17078,ElliotBayTrailMyrtlePark,12/13/2015 02:00:00 PM,48,-122,8,16,24
17079,ElliotBayTrailMyrtlePark,12/13/2015 03:00:00 PM,48,-122,15,11,26
17080,ElliotBayTrailMyrtlePark,12/13/2015 04:00:00 PM,48,-122,5,9,14
17081,ElliotBayTrailMyrtlePark,12/13/2015 05:00:00 PM,48,-122,0,3,3
17082,ElliotBayTrailMyrtlePark,12/13/2015 06:00:00 PM,48,-122,4,2,6
17083,ElliotBayTrailMyrtlePark,12/13/2015 07:00:00 PM,48,-122,1,0,1
17084,ElliotBayTrailMyrtlePark,12/13/2015 08:00:00 PM,48,-122,1,0,1
17085,ElliotBayTrailMyrtlePark,12/13/2015 09:00:00 PM,48,-122,1,1,2
17086,ElliotBayTrailMyrtlePark,12/13/2015 10:00:00 PM,48,-122,0,0,0
17087,ElliotBayTrailMyrtlePark,12/13/2015 11:00:00 PM,48,-122,1,0,1
17088,ElliotBayTrailMyrtlePark,12/14/2015 12:00:00 AM,48,-122,1,0,1
17089,ElliotBayTrailMyrtlePark,12/14/2015 01:00:00 AM,48,-122,0,0,0
17090,ElliotBayTrailMyrtlePark,12/14/2015 02:00:00 AM,48,-122,0,0,0
17091,ElliotBayTrailMyrtlePark,12/14/2015 03:00:00 AM,48,-122,2,0,2
17092,ElliotBayTrailMyrtlePark,12/14/2015 04:00:00 AM,48,-122,0,0,0
17093,ElliotBayTrailMyrtlePark,12/14/2015 05:00:00 AM,48,-122,3,4,7
17094,ElliotBayTrailMyrtlePark,12/14/2015 06:00:00 AM,48,-122,8,16,24
17095,ElliotBayTrailMyrtlePark,12/14/2015 07:00:00 AM,48,-122,24,53,77
17096,ElliotBayTrailMyrtlePark,12/14/2015 08:00:00 AM,48,-122,27,108,135
17097,ElliotBayTrailMyrtlePark,12/14/2015 09:00:00 AM,48,-122,20,90,110
17098,ElliotBayTrailMyrtlePark,12/14/2015 10:00:00 AM,48,-122,5,25,30
17099,ElliotBayTrailMyrtlePark,12/14/2015 11:00:00 AM,48,-122,10,10,20
17100,ElliotBayTrailMyrtlePark,12/14/2015 12:00:00 PM,48,-122,21,15,36
17101,ElliotBayTrailMyrtlePark,12/14/2015 01:00:00 PM,48,-122,13,23,36
17102,ElliotBayTrailMyrtlePark,12/14/2015 02:00:00 PM,48,-122,19,15,34
17103,ElliotBayTrailMyrtlePark,12/14/2015 03:00:00 PM,48,-122,29,15,44
17104,ElliotBayTrailMyrtlePark,12/14/2015 04:00:00 PM,48,-122,37,32,69
17105,ElliotBayTrailMyrtlePark,12/14/2015 05:00:00 PM,48,-122,117,32,149
17106,ElliotBayTrailMyrtlePark,12/14/2015 06:00:00 PM,48,-122,102,12,114
17107,ElliotBayTrailMyrtlePark,12/14/2015 07:00:00 PM,48,-122,35,6,41
17108,ElliotBayTrailMyrtlePark,12/14/2015 08:00:00 PM,48,-122,11,6,17
17109,ElliotBayTrailMyrtlePark,12/14/2015 09:00:00 PM,48,-122,6,1,7
17110,ElliotBayTrailMyrtlePark,12/14/2015 10:00:00 PM,48,-122,5,2,7
17111,ElliotBayTrailMyrtlePark,12/14/2015 11:00:00 PM,48,-122,4,3,7
17112,ElliotBayTrailMyrtlePark,12/15/2015 12:00:00 AM,48,-122,1,0,1
17113,ElliotBayTrailMyrtlePark,12/15/2015 01:00:00 AM,48,-122,0,0,0
17114,ElliotBayTrailMyrtlePark,12/15/2015 02:00:00 AM,48,-122,0,0,0
17115,ElliotBayTrailMyrtlePark,12/15/2015 03:00:00 AM,48,-122,1,0,1
17116,ElliotBayTrailMyrtlePark,12/15/2015 04:00:00 AM,48,-122,0,0,0
17117,ElliotBayTrailMyrtlePark,12/15/2015 05:00:00 AM,48,-122,3,4,7
17118,ElliotBayTrailMyrtlePark,12/15/2015 06:00:00 AM,48,-122,10,16,26
17119,ElliotBayTrailMyrtlePark,12/15/2015 07:00:00 AM,48,-122,20,35,55
17120,ElliotBayTrailMyrtlePark,12/15/2015 08:00:00 AM,48,-122,31,106,137
17121,ElliotBayTrailMyrtlePark,12/15/2015 09:00:00 AM,48,-122,31,83,114
17122,ElliotBayTrailMyrtlePark,12/15/2015 10:00:00 AM,48,-122,7,21,28
17123,ElliotBayTrailMyrtlePark,12/15/2015 11:00:00 AM,48,-122,8,6,14
17124,ElliotBayTrailMyrtlePark,12/15/2015 12:00:00 PM,48,-122,10,9,19
17125,ElliotBayTrailMyrtlePark,12/15/2015 01:00:00 PM,48,-122,4,10,14
17126,ElliotBayTrailMyrtlePark,12/15/2015 02:00:00 PM,48,-122,19,13,32
17127,ElliotBayTrailMyrtlePark,12/15/2015 03:00:00 PM,48,-122,21,17,38
17128,ElliotBayTrailMyrtlePark,12/15/2015 04:00:00 PM,48,-122,33,19,52
17129,ElliotBayTrailMyrtlePark,12/15/2015 05:00:00 PM,48,-122,98,35,133
17130,ElliotBayTrailMyrtlePark,12/15/2015 06:00:00 PM,48,-122,96,10,106
17131,ElliotBayTrailMyrtlePark,12/15/2015 07:00:00 PM,48,-122,36,9,45
17132,ElliotBayTrailMyrtlePark,12/15/2015 08:00:00 PM,48,-122,12,0,12
17133,ElliotBayTrailMyrtlePark,12/15/2015 09:00:00 PM,48,-122,5,2,7
17134,ElliotBayTrailMyrtlePark,12/15/2015 10:00:00 PM,48,-122,5,5,10
17135,ElliotBayTrailMyrtlePark,12/15/2015 11:00:00 PM,48,-122,0,0,0
17136,ElliotBayTrailMyrtlePark,12/16/2015 12:00:00 AM,48,-122,0,0,0
17137,ElliotBayTrailMyrtlePark,12/16/2015 01:00:00 AM,48,-122,0,0,0
17138,ElliotBayTrailMyrtlePark,12/16/2015 02:00:00 AM,48,-122,0,0,0
17139,ElliotBayTrailMyrtlePark,12/16/2015 03:00:00 AM,48,-122,0,0,0
17140,ElliotBayTrailMyrtlePark,12/16/2015 04:00:00 AM,48,-122,1,0,1
17141,ElliotBayTrailMyrtlePark,12/16/2015 05:00:00 AM,48,-122,3,5,8
17142,ElliotBayTrailMyrtlePark,12/16/2015 06:00:00 AM,48,-122,13,14,27
17143,ElliotBayTrailMyrtlePark,12/16/2015 07:00:00 AM,48,-122,30,35,65
17144,ElliotBayTrailMyrtlePark,12/16/2015 08:00:00 AM,48,-122,22,97,119
17145,ElliotBayTrailMyrtlePark,12/16/2015 09:00:00 AM,48,-122,23,74,97
17146,ElliotBayTrailMyrtlePark,12/16/2015 10:00:00 AM,48,-122,11,28,39
17147,ElliotBayTrailMyrtlePark,12/16/2015 11:00:00 AM,48,-122,18,12,30
17148,ElliotBayTrailMyrtlePark,12/16/2015 12:00:00 PM,48,-122,6,13,19
17149,ElliotBayTrailMyrtlePark,12/16/2015 01:00:00 PM,48,-122,13,8,21
17150,ElliotBayTrailMyrtlePark,12/16/2015 02:00:00 PM,48,-122,12,11,23
17151,ElliotBayTrailMyrtlePark,12/16/2015 03:00:00 PM,48,-122,23,18,41
17152,ElliotBayTrailMyrtlePark,12/16/2015 04:00:00 PM,48,-122,37,26,63
17153,ElliotBayTrailMyrtlePark,12/16/2015 05:00:00 PM,48,-122,99,46,145
17154,ElliotBayTrailMyrtlePark,12/16/2015 06:00:00 PM,48,-122,98,23,121
17155,ElliotBayTrailMyrtlePark,12/16/2015 07:00:00 PM,48,-122,38,4,42
17156,ElliotBayTrailMyrtlePark,12/16/2015 08:00:00 PM,48,-122,3,2,5
17157,ElliotBayTrailMyrtlePark,12/16/2015 09:00:00 PM,48,-122,8,9,17
17158,ElliotBayTrailMyrtlePark,12/16/2015 10:00:00 PM,48,-122,5,0,5
17159,ElliotBayTrailMyrtlePark,12/16/2015 11:00:00 PM,48,-122,0,0,0
17160,ElliotBayTrailMyrtlePark,12/17/2015 12:00:00 AM,48,-122,0,0,0
17161,ElliotBayTrailMyrtlePark,12/17/2015 01:00:00 AM,48,-122,0,0,0
17162,ElliotBayTrailMyrtlePark,12/17/2015 02:00:00 AM,48,-122,0,0,0
17163,ElliotBayTrailMyrtlePark,12/17/2015 03:00:00 AM,48,-122,0,0,0
17164,ElliotBayTrailMyrtlePark,12/17/2015 04:00:00 AM,48,-122,1,0,1
17165,ElliotBayTrailMyrtlePark,12/17/2015 05:00:00 AM,48,-122,2,5,7
17166,ElliotBayTrailMyrtlePark,12/17/2015 06:00:00 AM,48,-122,7,16,23
17167,ElliotBayTrailMyrtlePark,12/17/2015 07:00:00 AM,48,-122,16,33,49
17168,ElliotBayTrailMyrtlePark,12/17/2015 08:00:00 AM,48,-122,32,79,111
17169,ElliotBayTrailMyrtlePark,12/17/2015 09:00:00 AM,48,-122,22,36,58
17170,ElliotBayTrailMyrtlePark,12/17/2015 10:00:00 AM,48,-122,8,15,23
17171,ElliotBayTrailMyrtlePark,12/17/2015 11:00:00 AM,48,-122,1,4,5
17172,ElliotBayTrailMyrtlePark,12/17/2015 12:00:00 PM,48,-122,2,1,3
17173,ElliotBayTrailMyrtlePark,12/17/2015 01:00:00 PM,48,-122,6,5,11
17174,ElliotBayTrailMyrtlePark,12/17/2015 02:00:00 PM,48,-122,9,3,12
17175,ElliotBayTrailMyrtlePark,12/17/2015 03:00:00 PM,48,-122,8,8,16
17176,ElliotBayTrailMyrtlePark,12/17/2015 04:00:00 PM,48,-122,21,22,43
17177,ElliotBayTrailMyrtlePark,12/17/2015 05:00:00 PM,48,-122,63,18,81
17178,ElliotBayTrailMyrtlePark,12/17/2015 06:00:00 PM,48,-122,50,7,57
17179,ElliotBayTrailMyrtlePark,12/17/2015 07:00:00 PM,48,-122,26,2,28
17180,ElliotBayTrailMyrtlePark,12/17/2015 08:00:00 PM,48,-122,6,2,8
17181,ElliotBayTrailMyrtlePark,12/17/2015 09:00:00 PM,48,-122,3,1,4
17182,ElliotBayTrailMyrtlePark,12/17/2015 10:00:00 PM,48,-122,2,0,2
17183,ElliotBayTrailMyrtlePark,12/17/2015 11:00:00 PM,48,-122,0,0,0
17184,ElliotBayTrailMyrtlePark,12/18/2015 12:00:00 AM,48,-122,0,0,0
17185,ElliotBayTrailMyrtlePark,12/18/2015 01:00:00 AM,48,-122,0,0,0
17186,ElliotBayTrailMyrtlePark,12/18/2015 02:00:00 AM,48,-122,0,0,0
17187,ElliotBayTrailMyrtlePark,12/18/2015 03:00:00 AM,48,-122,0,0,0
17188,ElliotBayTrailMyrtlePark,12/18/2015 04:00:00 AM,48,-122,0,0,0
17189,ElliotBayTrailMyrtlePark,12/18/2015 05:00:00 AM,48,-122,4,1,5
17190,ElliotBayTrailMyrtlePark,12/18/2015 06:00:00 AM,48,-122,6,16,22
17191,ElliotBayTrailMyrtlePark,12/18/2015 07:00:00 AM,48,-122,9,27,36
17192,ElliotBayTrailMyrtlePark,12/18/2015 08:00:00 AM,48,-122,18,63,81
17193,ElliotBayTrailMyrtlePark,12/18/2015 09:00:00 AM,48,-122,20,54,74
17194,ElliotBayTrailMyrtlePark,12/18/2015 10:00:00 AM,48,-122,15,18,33
17195,ElliotBayTrailMyrtlePark,12/18/2015 11:00:00 AM,48,-122,3,8,11
17196,ElliotBayTrailMyrtlePark,12/18/2015 12:00:00 PM,48,-122,14,14,28
17197,ElliotBayTrailMyrtlePark,12/18/2015 01:00:00 PM,48,-122,8,5,13
17198,ElliotBayTrailMyrtlePark,12/18/2015 02:00:00 PM,48,-122,10,10,20
17199,ElliotBayTrailMyrtlePark,12/18/2015 03:00:00 PM,48,-122,17,14,31
17200,ElliotBayTrailMyrtlePark,12/18/2015 04:00:00 PM,48,-122,35,18,53
17201,ElliotBayTrailMyrtlePark,12/18/2015 05:00:00 PM,48,-122,82,20,102
17202,ElliotBayTrailMyrtlePark,12/18/2015 06:00:00 PM,48,-122,55,6,61
17203,ElliotBayTrailMyrtlePark,12/18/2015 07:00:00 PM,48,-122,19,2,21
17204,ElliotBayTrailMyrtlePark,12/18/2015 08:00:00 PM,48,-122,2,0,2
17205,ElliotBayTrailMyrtlePark,12/18/2015 09:00:00 PM,48,-122,2,2,4
17206,ElliotBayTrailMyrtlePark,12/18/2015 10:00:00 PM,48,-122,5,1,6
17207,ElliotBayTrailMyrtlePark,12/18/2015 11:00:00 PM,48,-122,1,1,2
17208,ElliotBayTrailMyrtlePark,12/19/2015 12:00:00 AM,48,-122,0,2,2
17209,ElliotBayTrailMyrtlePark,12/19/2015 01:00:00 AM,48,-122,1,0,1
17210,ElliotBayTrailMyrtlePark,12/19/2015 02:00:00 AM,48,-122,2,0,2
17211,ElliotBayTrailMyrtlePark,12/19/2015 03:00:00 AM,48,-122,0,0,0
17212,ElliotBayTrailMyrtlePark,12/19/2015 04:00:00 AM,48,-122,1,0,1
17213,ElliotBayTrailMyrtlePark,12/19/2015 05:00:00 AM,48,-122,1,0,1
17214,ElliotBayTrailMyrtlePark,12/19/2015 06:00:00 AM,48,-122,0,3,3
17215,ElliotBayTrailMyrtlePark,12/19/2015 07:00:00 AM,48,-122,0,2,2
17216,ElliotBayTrailMyrtlePark,12/19/2015 08:00:00 AM,48,-122,3,2,5
17217,ElliotBayTrailMyrtlePark,12/19/2015 09:00:00 AM,48,-122,4,6,10
17218,ElliotBayTrailMyrtlePark,12/19/2015 10:00:00 AM,48,-122,11,12,23
17219,ElliotBayTrailMyrtlePark,12/19/2015 11:00:00 AM,48,-122,14,18,32
17220,ElliotBayTrailMyrtlePark,12/19/2015 12:00:00 PM,48,-122,15,18,33
17221,ElliotBayTrailMyrtlePark,12/19/2015 01:00:00 PM,48,-122,14,22,36
17222,ElliotBayTrailMyrtlePark,12/19/2015 02:00:00 PM,48,-122,23,20,43
17223,ElliotBayTrailMyrtlePark,12/19/2015 03:00:00 PM,48,-122,19,19,38
17224,ElliotBayTrailMyrtlePark,12/19/2015 04:00:00 PM,48,-122,16,11,27
17225,ElliotBayTrailMyrtlePark,12/19/2015 05:00:00 PM,48,-122,4,2,6
17226,ElliotBayTrailMyrtlePark,12/19/2015 06:00:00 PM,48,-122,6,1,7
17227,ElliotBayTrailMyrtlePark,12/19/2015 07:00:00 PM,48,-122,3,0,3
17228,ElliotBayTrailMyrtlePark,12/19/2015 08:00:00 PM,48,-122,2,0,2
17229,ElliotBayTrailMyrtlePark,12/19/2015 09:00:00 PM,48,-122,0,1,1
17230,ElliotBayTrailMyrtlePark,12/19/2015 10:00:00 PM,48,-122,1,1,2
17231,ElliotBayTrailMyrtlePark,12/19/2015 11:00:00 PM,48,-122,1,1,2
17232,ElliotBayTrailMyrtlePark,12/20/2015 12:00:00 AM,48,-122,1,2,3
17233,ElliotBayTrailMyrtlePark,12/20/2015 01:00:00 AM,48,-122,0,0,0
17234,ElliotBayTrailMyrtlePark,12/20/2015 02:00:00 AM,48,-122,0,0,0
17235,ElliotBayTrailMyrtlePark,12/20/2015 03:00:00 AM,48,-122,1,0,1
17236,ElliotBayTrailMyrtlePark,12/20/2015 04:00:00 AM,48,-122,0,0,0
17237,ElliotBayTrailMyrtlePark,12/20/2015 05:00:00 AM,48,-122,0,2,2
17238,ElliotBayTrailMyrtlePark,12/20/2015 06:00:00 AM,48,-122,0,1,1
17239,ElliotBayTrailMyrtlePark,12/20/2015 07:00:00 AM,48,-122,1,2,3
17240,ElliotBayTrailMyrtlePark,12/20/2015 08:00:00 AM,48,-122,4,2,6
17241,ElliotBayTrailMyrtlePark,12/20/2015 09:00:00 AM,48,-122,2,1,3
17242,ElliotBayTrailMyrtlePark,12/20/2015 10:00:00 AM,48,-122,5,15,20
17243,ElliotBayTrailMyrtlePark,12/20/2015 11:00:00 AM,48,-122,7,9,16
17244,ElliotBayTrailMyrtlePark,12/20/2015 12:00:00 PM,48,-122,17,14,31
17245,ElliotBayTrailMyrtlePark,12/20/2015 01:00:00 PM,48,-122,8,11,19
17246,ElliotBayTrailMyrtlePark,12/20/2015 02:00:00 PM,48,-122,14,10,24
17247,ElliotBayTrailMyrtlePark,12/20/2015 03:00:00 PM,48,-122,9,9,18
17248,ElliotBayTrailMyrtlePark,12/20/2015 04:00:00 PM,48,-122,8,7,15
17249,ElliotBayTrailMyrtlePark,12/20/2015 05:00:00 PM,48,-122,4,4,8
17250,ElliotBayTrailMyrtlePark,12/20/2015 06:00:00 PM,48,-122,1,1,2
17251,ElliotBayTrailMyrtlePark,12/20/2015 07:00:00 PM,48,-122,1,0,1
17252,ElliotBayTrailMyrtlePark,12/20/2015 08:00:00 PM,48,-122,0,0,0
17253,ElliotBayTrailMyrtlePark,12/20/2015 09:00:00 PM,48,-122,2,2,4
17254,ElliotBayTrailMyrtlePark,12/20/2015 10:00:00 PM,48,-122,2,2,4
17255,ElliotBayTrailMyrtlePark,12/20/2015 11:00:00 PM,48,-122,0,0,0
17256,ElliotBayTrailMyrtlePark,12/21/2015 12:00:00 AM,48,-122,1,0,1
17257,ElliotBayTrailMyrtlePark,12/21/2015 01:00:00 AM,48,-122,0,0,0
17258,ElliotBayTrailMyrtlePark,12/21/2015 02:00:00 AM,48,-122,1,0,1
17259,ElliotBayTrailMyrtlePark,12/21/2015 03:00:00 AM,48,-122,0,0,0
17260,ElliotBayTrailMyrtlePark,12/21/2015 04:00:00 AM,48,-122,1,0,1
17261,ElliotBayTrailMyrtlePark,12/21/2015 05:00:00 AM,48,-122,4,3,7
17262,ElliotBayTrailMyrtlePark,12/21/2015 06:00:00 AM,48,-122,11,10,21
17263,ElliotBayTrailMyrtlePark,12/21/2015 07:00:00 AM,48,-122,17,17,34
17264,ElliotBayTrailMyrtlePark,12/21/2015 08:00:00 AM,48,-122,45,42,87
17265,ElliotBayTrailMyrtlePark,12/21/2015 09:00:00 AM,48,-122,27,26,53
17266,ElliotBayTrailMyrtlePark,12/21/2015 10:00:00 AM,48,-122,7,7,14
17267,ElliotBayTrailMyrtlePark,12/21/2015 11:00:00 AM,48,-122,4,2,6
17268,ElliotBayTrailMyrtlePark,12/21/2015 12:00:00 PM,48,-122,5,2,7
17269,ElliotBayTrailMyrtlePark,12/21/2015 01:00:00 PM,48,-122,4,3,7
17270,ElliotBayTrailMyrtlePark,12/21/2015 02:00:00 PM,48,-122,5,5,10
17271,ElliotBayTrailMyrtlePark,12/21/2015 03:00:00 PM,48,-122,6,6,12
17272,ElliotBayTrailMyrtlePark,12/21/2015 04:00:00 PM,48,-122,20,19,39
17273,ElliotBayTrailMyrtlePark,12/21/2015 05:00:00 PM,48,-122,39,33,72
17274,ElliotBayTrailMyrtlePark,12/21/2015 06:00:00 PM,48,-122,40,36,76
17275,ElliotBayTrailMyrtlePark,12/21/2015 07:00:00 PM,48,-122,10,8,18
17276,ElliotBayTrailMyrtlePark,12/21/2015 08:00:00 PM,48,-122,4,4,8
17277,ElliotBayTrailMyrtlePark,12/21/2015 09:00:00 PM,48,-122,1,0,1
17278,ElliotBayTrailMyrtlePark,12/21/2015 10:00:00 PM,48,-122,1,1,2
17279,ElliotBayTrailMyrtlePark,12/21/2015 11:00:00 PM,48,-122,1,0,1
17280,ElliotBayTrailMyrtlePark,12/22/2015 12:00:00 AM,48,-122,1,0,1
17281,ElliotBayTrailMyrtlePark,12/22/2015 01:00:00 AM,48,-122,0,0,0
17282,ElliotBayTrailMyrtlePark,12/22/2015 02:00:00 AM,48,-122,0,0,0
17283,ElliotBayTrailMyrtlePark,12/22/2015 03:00:00 AM,48,-122,1,0,1
17284,ElliotBayTrailMyrtlePark,12/22/2015 04:00:00 AM,48,-122,0,0,0
17285,ElliotBayTrailMyrtlePark,12/22/2015 05:00:00 AM,48,-122,4,3,7
17286,ElliotBayTrailMyrtlePark,12/22/2015 06:00:00 AM,48,-122,7,13,20
17287,ElliotBayTrailMyrtlePark,12/22/2015 07:00:00 AM,48,-122,7,21,28
17288,ElliotBayTrailMyrtlePark,12/22/2015 08:00:00 AM,48,-122,14,75,89
17289,ElliotBayTrailMyrtlePark,12/22/2015 09:00:00 AM,48,-122,19,56,75
17290,ElliotBayTrailMyrtlePark,12/22/2015 10:00:00 AM,48,-122,7,21,28
17291,ElliotBayTrailMyrtlePark,12/22/2015 11:00:00 AM,48,-122,11,9,20
17292,ElliotBayTrailMyrtlePark,12/22/2015 12:00:00 PM,48,-122,3,13,16
17293,ElliotBayTrailMyrtlePark,12/22/2015 01:00:00 PM,48,-122,11,6,17
17294,ElliotBayTrailMyrtlePark,12/22/2015 02:00:00 PM,48,-122,15,13,28
17295,ElliotBayTrailMyrtlePark,12/22/2015 03:00:00 PM,48,-122,16,15,31
17296,ElliotBayTrailMyrtlePark,12/22/2015 04:00:00 PM,48,-122,31,20,51
17297,ElliotBayTrailMyrtlePark,12/22/2015 05:00:00 PM,48,-122,68,23,91
17298,ElliotBayTrailMyrtlePark,12/22/2015 06:00:00 PM,48,-122,47,5,52
17299,ElliotBayTrailMyrtlePark,12/22/2015 07:00:00 PM,48,-122,15,1,16
17300,ElliotBayTrailMyrtlePark,12/22/2015 08:00:00 PM,48,-122,10,0,10
17301,ElliotBayTrailMyrtlePark,12/22/2015 09:00:00 PM,48,-122,1,0,1
17302,ElliotBayTrailMyrtlePark,12/22/2015 10:00:00 PM,48,-122,2,3,5
17303,ElliotBayTrailMyrtlePark,12/22/2015 11:00:00 PM,48,-122,5,0,5
17304,ElliotBayTrailMyrtlePark,12/23/2015 12:00:00 AM,48,-122,0,0,0
17305,ElliotBayTrailMyrtlePark,12/23/2015 01:00:00 AM,48,-122,0,0,0
17306,ElliotBayTrailMyrtlePark,12/23/2015 02:00:00 AM,48,-122,0,0,0
17307,ElliotBayTrailMyrtlePark,12/23/2015 03:00:00 AM,48,-122,1,0,1
17308,ElliotBayTrailMyrtlePark,12/23/2015 04:00:00 AM,48,-122,1,0,1
17309,ElliotBayTrailMyrtlePark,12/23/2015 05:00:00 AM,48,-122,6,3,9
17310,ElliotBayTrailMyrtlePark,12/23/2015 06:00:00 AM,48,-122,7,10,17
17311,ElliotBayTrailMyrtlePark,12/23/2015 07:00:00 AM,48,-122,7,18,25
17312,ElliotBayTrailMyrtlePark,12/23/2015 08:00:00 AM,48,-122,13,48,61
17313,ElliotBayTrailMyrtlePark,12/23/2015 09:00:00 AM,48,-122,6,27,33
17314,ElliotBayTrailMyrtlePark,12/23/2015 10:00:00 AM,48,-122,7,6,13
17315,ElliotBayTrailMyrtlePark,12/23/2015 11:00:00 AM,48,-122,9,13,22
17316,ElliotBayTrailMyrtlePark,12/23/2015 12:00:00 PM,48,-122,9,3,12
17317,ElliotBayTrailMyrtlePark,12/23/2015 01:00:00 PM,48,-122,15,10,25
17318,ElliotBayTrailMyrtlePark,12/23/2015 02:00:00 PM,48,-122,4,4,8
17319,ElliotBayTrailMyrtlePark,12/23/2015 03:00:00 PM,48,-122,14,10,24
17320,ElliotBayTrailMyrtlePark,12/23/2015 04:00:00 PM,48,-122,25,10,35
17321,ElliotBayTrailMyrtlePark,12/23/2015 05:00:00 PM,48,-122,43,9,52
17322,ElliotBayTrailMyrtlePark,12/23/2015 06:00:00 PM,48,-122,31,5,36
17323,ElliotBayTrailMyrtlePark,12/23/2015 07:00:00 PM,48,-122,11,2,13
17324,ElliotBayTrailMyrtlePark,12/23/2015 08:00:00 PM,48,-122,4,0,4
17325,ElliotBayTrailMyrtlePark,12/23/2015 09:00:00 PM,48,-122,4,0,4
17326,ElliotBayTrailMyrtlePark,12/23/2015 10:00:00 PM,48,-122,0,0,0
17327,ElliotBayTrailMyrtlePark,12/23/2015 11:00:00 PM,48,-122,0,2,2
17328,ElliotBayTrailMyrtlePark,12/24/2015 12:00:00 AM,48,-122,0,0,0
17329,ElliotBayTrailMyrtlePark,12/24/2015 01:00:00 AM,48,-122,0,0,0
17330,ElliotBayTrailMyrtlePark,12/24/2015 02:00:00 AM,48,-122,1,0,1
17331,ElliotBayTrailMyrtlePark,12/24/2015 03:00:00 AM,48,-122,0,0,0
17332,ElliotBayTrailMyrtlePark,12/24/2015 04:00:00 AM,48,-122,0,0,0
17333,ElliotBayTrailMyrtlePark,12/24/2015 05:00:00 AM,48,-122,2,1,3
17334,ElliotBayTrailMyrtlePark,12/24/2015 06:00:00 AM,48,-122,3,4,7
17335,ElliotBayTrailMyrtlePark,12/24/2015 07:00:00 AM,48,-122,1,12,13
17336,ElliotBayTrailMyrtlePark,12/24/2015 08:00:00 AM,48,-122,2,15,17
17337,ElliotBayTrailMyrtlePark,12/24/2015 09:00:00 AM,48,-122,6,12,18
17338,ElliotBayTrailMyrtlePark,12/24/2015 10:00:00 AM,48,-122,5,10,15
17339,ElliotBayTrailMyrtlePark,12/24/2015 11:00:00 AM,48,-122,15,8,23
17340,ElliotBayTrailMyrtlePark,12/24/2015 12:00:00 PM,48,-122,18,9,27
17341,ElliotBayTrailMyrtlePark,12/24/2015 01:00:00 PM,48,-122,20,9,29
17342,ElliotBayTrailMyrtlePark,12/24/2015 02:00:00 PM,48,-122,17,7,24
17343,ElliotBayTrailMyrtlePark,12/24/2015 03:00:00 PM,48,-122,11,5,16
17344,ElliotBayTrailMyrtlePark,12/24/2015 04:00:00 PM,48,-122,11,4,15
17345,ElliotBayTrailMyrtlePark,12/24/2015 05:00:00 PM,48,-122,0,0,0
17346,ElliotBayTrailMyrtlePark,12/24/2015 06:00:00 PM,48,-122,1,1,2
17347,ElliotBayTrailMyrtlePark,12/24/2015 07:00:00 PM,48,-122,0,1,1
17348,ElliotBayTrailMyrtlePark,12/24/2015 08:00:00 PM,48,-122,0,1,1
17349,ElliotBayTrailMyrtlePark,12/24/2015 09:00:00 PM,48,-122,0,0,0
17350,ElliotBayTrailMyrtlePark,12/24/2015 10:00:00 PM,48,-122,1,0,1
17351,ElliotBayTrailMyrtlePark,12/24/2015 11:00:00 PM,48,-122,0,0,0
17352,ElliotBayTrailMyrtlePark,12/25/2015 12:00:00 AM,48,-122,1,0,1
17353,ElliotBayTrailMyrtlePark,12/25/2015 01:00:00 AM,48,-122,1,0,1
17354,ElliotBayTrailMyrtlePark,12/25/2015 02:00:00 AM,48,-122,0,0,0
17355,ElliotBayTrailMyrtlePark,12/25/2015 03:00:00 AM,48,-122,0,0,0
17356,ElliotBayTrailMyrtlePark,12/25/2015 04:00:00 AM,48,-122,0,0,0
17357,ElliotBayTrailMyrtlePark,12/25/2015 05:00:00 AM,48,-122,0,0,0
17358,ElliotBayTrailMyrtlePark,12/25/2015 06:00:00 AM,48,-122,0,1,1
17359,ElliotBayTrailMyrtlePark,12/25/2015 07:00:00 AM,48,-122,1,0,1
17360,ElliotBayTrailMyrtlePark,12/25/2015 08:00:00 AM,48,-122,1,0,1
17361,ElliotBayTrailMyrtlePark,12/25/2015 09:00:00 AM,48,-122,1,0,1
17362,ElliotBayTrailMyrtlePark,12/25/2015 10:00:00 AM,48,-122,2,3,5
17363,ElliotBayTrailMyrtlePark,12/25/2015 11:00:00 AM,48,-122,3,2,5
17364,ElliotBayTrailMyrtlePark,12/25/2015 12:00:00 PM,48,-122,14,19,33
17365,ElliotBayTrailMyrtlePark,12/25/2015 01:00:00 PM,48,-122,14,9,23
17366,ElliotBayTrailMyrtlePark,12/25/2015 02:00:00 PM,48,-122,21,3,24
17367,ElliotBayTrailMyrtlePark,12/25/2015 03:00:00 PM,48,-122,30,15,45
17368,ElliotBayTrailMyrtlePark,12/25/2015 04:00:00 PM,48,-122,11,9,20
17369,ElliotBayTrailMyrtlePark,12/25/2015 05:00:00 PM,48,-122,3,7,10
17370,ElliotBayTrailMyrtlePark,12/25/2015 06:00:00 PM,48,-122,3,1,4
17371,ElliotBayTrailMyrtlePark,12/25/2015 07:00:00 PM,48,-122,0,0,0
17372,ElliotBayTrailMyrtlePark,12/25/2015 08:00:00 PM,48,-122,0,0,0
17373,ElliotBayTrailMyrtlePark,12/25/2015 09:00:00 PM,48,-122,0,0,0
17374,ElliotBayTrailMyrtlePark,12/25/2015 10:00:00 PM,48,-122,3,1,4
17375,ElliotBayTrailMyrtlePark,12/25/2015 11:00:00 PM,48,-122,0,0,0
17376,ElliotBayTrailMyrtlePark,12/26/2015 12:00:00 AM,48,-122,0,0,0
17377,ElliotBayTrailMyrtlePark,12/26/2015 01:00:00 AM,48,-122,0,0,0
17378,ElliotBayTrailMyrtlePark,12/26/2015 02:00:00 AM,48,-122,0,0,0
17379,ElliotBayTrailMyrtlePark,12/26/2015 03:00:00 AM,48,-122,0,0,0
17380,ElliotBayTrailMyrtlePark,12/26/2015 04:00:00 AM,48,-122,0,0,0
17381,ElliotBayTrailMyrtlePark,12/26/2015 05:00:00 AM,48,-122,0,0,0
17382,ElliotBayTrailMyrtlePark,12/26/2015 06:00:00 AM,48,-122,0,6,6
17383,ElliotBayTrailMyrtlePark,12/26/2015 07:00:00 AM,48,-122,1,4,5
17384,ElliotBayTrailMyrtlePark,12/26/2015 08:00:00 AM,48,-122,3,1,4
17385,ElliotBayTrailMyrtlePark,12/26/2015 09:00:00 AM,48,-122,1,5,6
17386,ElliotBayTrailMyrtlePark,12/26/2015 10:00:00 AM,48,-122,5,12,17
17387,ElliotBayTrailMyrtlePark,12/26/2015 11:00:00 AM,48,-122,15,15,30
17388,ElliotBayTrailMyrtlePark,12/26/2015 12:00:00 PM,48,-122,15,12,27
17389,ElliotBayTrailMyrtlePark,12/26/2015 01:00:00 PM,48,-122,16,23,39
17390,ElliotBayTrailMyrtlePark,12/26/2015 02:00:00 PM,48,-122,16,19,35
17391,ElliotBayTrailMyrtlePark,12/26/2015 03:00:00 PM,48,-122,25,12,37
17392,ElliotBayTrailMyrtlePark,12/26/2015 04:00:00 PM,48,-122,12,7,19
17393,ElliotBayTrailMyrtlePark,12/26/2015 05:00:00 PM,48,-122,3,11,14
17394,ElliotBayTrailMyrtlePark,12/26/2015 06:00:00 PM,48,-122,2,5,7
17395,ElliotBayTrailMyrtlePark,12/26/2015 07:00:00 PM,48,-122,1,2,3
17396,ElliotBayTrailMyrtlePark,12/26/2015 08:00:00 PM,48,-122,3,1,4
17397,ElliotBayTrailMyrtlePark,12/26/2015 09:00:00 PM,48,-122,1,1,2
17398,ElliotBayTrailMyrtlePark,12/26/2015 10:00:00 PM,48,-122,0,1,1
17399,ElliotBayTrailMyrtlePark,12/26/2015 11:00:00 PM,48,-122,1,2,3
17400,ElliotBayTrailMyrtlePark,12/27/2015 12:00:00 AM,48,-122,0,0,0
17401,ElliotBayTrailMyrtlePark,12/27/2015 01:00:00 AM,48,-122,0,0,0
17402,ElliotBayTrailMyrtlePark,12/27/2015 02:00:00 AM,48,-122,0,0,0
17403,ElliotBayTrailMyrtlePark,12/27/2015 03:00:00 AM,48,-122,0,0,0
17404,ElliotBayTrailMyrtlePark,12/27/2015 04:00:00 AM,48,-122,0,0,0
17405,ElliotBayTrailMyrtlePark,12/27/2015 05:00:00 AM,48,-122,0,0,0
17406,ElliotBayTrailMyrtlePark,12/27/2015 06:00:00 AM,48,-122,0,2,2
17407,ElliotBayTrailMyrtlePark,12/27/2015 07:00:00 AM,48,-122,1,4,5
17408,ElliotBayTrailMyrtlePark,12/27/2015 08:00:00 AM,48,-122,4,3,7
17409,ElliotBayTrailMyrtlePark,12/27/2015 09:00:00 AM,48,-122,7,6,13
17410,ElliotBayTrailMyrtlePark,12/27/2015 10:00:00 AM,48,-122,4,4,8
17411,ElliotBayTrailMyrtlePark,12/27/2015 11:00:00 AM,48,-122,4,12,16
17412,ElliotBayTrailMyrtlePark,12/27/2015 12:00:00 PM,48,-122,1,4,5
17413,ElliotBayTrailMyrtlePark,12/27/2015 01:00:00 PM,48,-122,2,2,4
17414,ElliotBayTrailMyrtlePark,12/27/2015 02:00:00 PM,48,-122,1,2,3
17415,ElliotBayTrailMyrtlePark,12/27/2015 03:00:00 PM,48,-122,3,4,7
17416,ElliotBayTrailMyrtlePark,12/27/2015 04:00:00 PM,48,-122,3,0,3
17417,ElliotBayTrailMyrtlePark,12/27/2015 05:00:00 PM,48,-122,3,2,5
17418,ElliotBayTrailMyrtlePark,12/27/2015 06:00:00 PM,48,-122,8,1,9
17419,ElliotBayTrailMyrtlePark,12/27/2015 07:00:00 PM,48,-122,0,0,0
17420,ElliotBayTrailMyrtlePark,12/27/2015 08:00:00 PM,48,-122,3,0,3
17421,ElliotBayTrailMyrtlePark,12/27/2015 09:00:00 PM,48,-122,0,1,1
17422,ElliotBayTrailMyrtlePark,12/27/2015 10:00:00 PM,48,-122,0,0,0
17423,ElliotBayTrailMyrtlePark,12/27/2015 11:00:00 PM,48,-122,1,0,1
17424,ElliotBayTrailMyrtlePark,12/28/2015 12:00:00 AM,48,-122,0,0,0
17425,ElliotBayTrailMyrtlePark,12/28/2015 01:00:00 AM,48,-122,0,0,0
17426,ElliotBayTrailMyrtlePark,12/28/2015 02:00:00 AM,48,-122,0,0,0
17427,ElliotBayTrailMyrtlePark,12/28/2015 03:00:00 AM,48,-122,0,0,0
17428,ElliotBayTrailMyrtlePark,12/28/2015 04:00:00 AM,48,-122,0,0,0
17429,ElliotBayTrailMyrtlePark,12/28/2015 05:00:00 AM,48,-122,3,2,5
17430,ElliotBayTrailMyrtlePark,12/28/2015 06:00:00 AM,48,-122,5,7,12
17431,ElliotBayTrailMyrtlePark,12/28/2015 07:00:00 AM,48,-122,13,24,37
17432,ElliotBayTrailMyrtlePark,12/28/2015 08:00:00 AM,48,-122,20,61,81
17433,ElliotBayTrailMyrtlePark,12/28/2015 09:00:00 AM,48,-122,9,43,52
17434,ElliotBayTrailMyrtlePark,12/28/2015 10:00:00 AM,48,-122,5,13,18
17435,ElliotBayTrailMyrtlePark,12/28/2015 11:00:00 AM,48,-122,10,9,19
17436,ElliotBayTrailMyrtlePark,12/28/2015 12:00:00 PM,48,-122,9,11,20
17437,ElliotBayTrailMyrtlePark,12/28/2015 01:00:00 PM,48,-122,8,11,19
17438,ElliotBayTrailMyrtlePark,12/28/2015 02:00:00 PM,48,-122,12,15,27
17439,ElliotBayTrailMyrtlePark,12/28/2015 03:00:00 PM,48,-122,16,16,32
17440,ElliotBayTrailMyrtlePark,12/28/2015 04:00:00 PM,48,-122,30,18,48
17441,ElliotBayTrailMyrtlePark,12/28/2015 05:00:00 PM,48,-122,62,13,75
17442,ElliotBayTrailMyrtlePark,12/28/2015 06:00:00 PM,48,-122,39,8,47
17443,ElliotBayTrailMyrtlePark,12/28/2015 07:00:00 PM,48,-122,9,1,10
17444,ElliotBayTrailMyrtlePark,12/28/2015 08:00:00 PM,48,-122,2,0,2
17445,ElliotBayTrailMyrtlePark,12/28/2015 09:00:00 PM,48,-122,1,2,3
17446,ElliotBayTrailMyrtlePark,12/28/2015 10:00:00 PM,48,-122,1,1,2
17447,ElliotBayTrailMyrtlePark,12/28/2015 11:00:00 PM,48,-122,0,0,0
17448,ElliotBayTrailMyrtlePark,12/29/2015 12:00:00 AM,48,-122,2,0,2
17449,ElliotBayTrailMyrtlePark,12/29/2015 01:00:00 AM,48,-122,0,0,0
17450,ElliotBayTrailMyrtlePark,12/29/2015 02:00:00 AM,48,-122,0,0,0
17451,ElliotBayTrailMyrtlePark,12/29/2015 03:00:00 AM,48,-122,0,0,0
17452,ElliotBayTrailMyrtlePark,12/29/2015 04:00:00 AM,48,-122,0,0,0
17453,ElliotBayTrailMyrtlePark,12/29/2015 05:00:00 AM,48,-122,4,2,6
17454,ElliotBayTrailMyrtlePark,12/29/2015 06:00:00 AM,48,-122,7,10,17
17455,ElliotBayTrailMyrtlePark,12/29/2015 07:00:00 AM,48,-122,16,23,39
17456,ElliotBayTrailMyrtlePark,12/29/2015 08:00:00 AM,48,-122,14,56,70
17457,ElliotBayTrailMyrtlePark,12/29/2015 09:00:00 AM,48,-122,21,48,69
17458,ElliotBayTrailMyrtlePark,12/29/2015 10:00:00 AM,48,-122,6,21,27
17459,ElliotBayTrailMyrtlePark,12/29/2015 11:00:00 AM,48,-122,11,17,28
17460,ElliotBayTrailMyrtlePark,12/29/2015 12:00:00 PM,48,-122,10,10,20
17461,ElliotBayTrailMyrtlePark,12/29/2015 01:00:00 PM,48,-122,13,1,14
17462,ElliotBayTrailMyrtlePark,12/29/2015 02:00:00 PM,48,-122,12,13,25
17463,ElliotBayTrailMyrtlePark,12/29/2015 03:00:00 PM,48,-122,20,21,41
17464,ElliotBayTrailMyrtlePark,12/29/2015 04:00:00 PM,48,-122,48,42,90
17465,ElliotBayTrailMyrtlePark,12/29/2015 05:00:00 PM,48,-122,64,25,89
17466,ElliotBayTrailMyrtlePark,12/29/2015 06:00:00 PM,48,-122,63,7,70
17467,ElliotBayTrailMyrtlePark,12/29/2015 07:00:00 PM,48,-122,16,2,18
17468,ElliotBayTrailMyrtlePark,12/29/2015 08:00:00 PM,48,-122,2,3,5
17469,ElliotBayTrailMyrtlePark,12/29/2015 09:00:00 PM,48,-122,0,7,7
17470,ElliotBayTrailMyrtlePark,12/29/2015 10:00:00 PM,48,-122,3,6,9
17471,ElliotBayTrailMyrtlePark,12/29/2015 11:00:00 PM,48,-122,0,1,1
17472,ElliotBayTrailMyrtlePark,12/30/2015 12:00:00 AM,48,-122,2,1,3
17473,ElliotBayTrailMyrtlePark,12/30/2015 01:00:00 AM,48,-122,0,1,1
17474,ElliotBayTrailMyrtlePark,12/30/2015 02:00:00 AM,48,-122,0,0,0
17475,ElliotBayTrailMyrtlePark,12/30/2015 03:00:00 AM,48,-122,1,0,1
17476,ElliotBayTrailMyrtlePark,12/30/2015 04:00:00 AM,48,-122,0,0,0
17477,ElliotBayTrailMyrtlePark,12/30/2015 05:00:00 AM,48,-122,4,2,6
17478,ElliotBayTrailMyrtlePark,12/30/2015 06:00:00 AM,48,-122,8,10,18
17479,ElliotBayTrailMyrtlePark,12/30/2015 07:00:00 AM,48,-122,8,24,32
17480,ElliotBayTrailMyrtlePark,12/30/2015 08:00:00 AM,48,-122,18,49,67
17481,ElliotBayTrailMyrtlePark,12/30/2015 09:00:00 AM,48,-122,12,34,46
17482,ElliotBayTrailMyrtlePark,12/30/2015 10:00:00 AM,48,-122,9,17,26
17483,ElliotBayTrailMyrtlePark,12/30/2015 11:00:00 AM,48,-122,14,14,28
17484,ElliotBayTrailMyrtlePark,12/30/2015 12:00:00 PM,48,-122,20,12,32
17485,ElliotBayTrailMyrtlePark,12/30/2015 01:00:00 PM,48,-122,13,10,23
17486,ElliotBayTrailMyrtlePark,12/30/2015 02:00:00 PM,48,-122,25,23,48
17487,ElliotBayTrailMyrtlePark,12/30/2015 03:00:00 PM,48,-122,34,25,59
17488,ElliotBayTrailMyrtlePark,12/30/2015 04:00:00 PM,48,-122,43,32,75
17489,ElliotBayTrailMyrtlePark,12/30/2015 05:00:00 PM,48,-122,60,31,91
17490,ElliotBayTrailMyrtlePark,12/30/2015 06:00:00 PM,48,-122,46,8,54
17491,ElliotBayTrailMyrtlePark,12/30/2015 07:00:00 PM,48,-122,13,4,17
17492,ElliotBayTrailMyrtlePark,12/30/2015 08:00:00 PM,48,-122,4,0,4
17493,ElliotBayTrailMyrtlePark,12/30/2015 09:00:00 PM,48,-122,2,6,8
17494,ElliotBayTrailMyrtlePark,12/30/2015 10:00:00 PM,48,-122,3,0,3
17495,ElliotBayTrailMyrtlePark,12/30/2015 11:00:00 PM,48,-122,3,1,4
17496,ElliotBayTrailMyrtlePark,12/31/2015 12:00:00 AM,48,-122,0,0,0
17497,ElliotBayTrailMyrtlePark,12/31/2015 01:00:00 AM,48,-122,0,1,1
17498,ElliotBayTrailMyrtlePark,12/31/2015 02:00:00 AM,48,-122,1,0,1
17499,ElliotBayTrailMyrtlePark,12/31/2015 03:00:00 AM,48,-122,0,0,0
17500,ElliotBayTrailMyrtlePark,12/31/2015 04:00:00 AM,48,-122,0,0,0
17501,ElliotBayTrailMyrtlePark,12/31/2015 05:00:00 AM,48,-122,3,2,5
17502,ElliotBayTrailMyrtlePark,12/31/2015 06:00:00 AM,48,-122,5,9,14
17503,ElliotBayTrailMyrtlePark,12/31/2015 07:00:00 AM,48,-122,3,12,15
17504,ElliotBayTrailMyrtlePark,12/31/2015 08:00:00 AM,48,-122,15,33,48
17505,ElliotBayTrailMyrtlePark,12/31/2015 09:00:00 AM,48,-122,11,28,39
17506,ElliotBayTrailMyrtlePark,12/31/2015 10:00:00 AM,48,-122,11,6,17
17507,ElliotBayTrailMyrtlePark,12/31/2015 11:00:00 AM,48,-122,12,11,23
17508,ElliotBayTrailMyrtlePark,12/31/2015 12:00:00 PM,48,-122,18,15,33
17509,ElliotBayTrailMyrtlePark,12/31/2015 01:00:00 PM,48,-122,34,29,63
17510,ElliotBayTrailMyrtlePark,12/31/2015 02:00:00 PM,48,-122,40,29,69
17511,ElliotBayTrailMyrtlePark,12/31/2015 03:00:00 PM,48,-122,47,44,91
17512,ElliotBayTrailMyrtlePark,12/31/2015 04:00:00 PM,48,-122,33,39,72
17513,ElliotBayTrailMyrtlePark,12/31/2015 05:00:00 PM,48,-122,25,13,38
17514,ElliotBayTrailMyrtlePark,12/31/2015 06:00:00 PM,48,-122,13,4,17
17515,ElliotBayTrailMyrtlePark,12/31/2015 07:00:00 PM,48,-122,2,0,2
17516,ElliotBayTrailMyrtlePark,12/31/2015 08:00:00 PM,48,-122,27,0,27
17517,ElliotBayTrailMyrtlePark,12/31/2015 09:00:00 PM,48,-122,4,0,4
17518,ElliotBayTrailMyrtlePark,12/31/2015 10:00:00 PM,48,-122,1,3,4
17519,ElliotBayTrailMyrtlePark,12/31/2015 11:00:00 PM,48,-122,2,1,3
17520,ElliotBayTrailMyrtlePark,01/01/2016 12:00:00 AM,48,-122,1,1,2
17521,ElliotBayTrailMyrtlePark,01/01/2016 01:00:00 AM,48,-122,1,1,2
17522,ElliotBayTrailMyrtlePark,01/01/2016 02:00:00 AM,48,-122,2,0,2
17523,ElliotBayTrailMyrtlePark,01/01/2016 03:00:00 AM,48,-122,1,0,1
17524,ElliotBayTrailMyrtlePark,01/01/2016 04:00:00 AM,48,-122,0,2,2
17525,ElliotBayTrailMyrtlePark,01/01/2016 05:00:00 AM,48,-122,0,2,2
17526,ElliotBayTrailMyrtlePark,01/01/2016 06:00:00 AM,48,-122,0,2,2
17527,ElliotBayTrailMyrtlePark,01/01/2016 07:00:00 AM,48,-122,0,2,2
17528,ElliotBayTrailMyrtlePark,01/01/2016 08:00:00 AM,48,-122,5,1,6
17529,ElliotBayTrailMyrtlePark,01/01/2016 09:00:00 AM,48,-122,1,2,3
17530,ElliotBayTrailMyrtlePark,01/01/2016 10:00:00 AM,48,-122,4,6,10
17531,ElliotBayTrailMyrtlePark,01/01/2016 11:00:00 AM,48,-122,17,12,29
17532,ElliotBayTrailMyrtlePark,01/01/2016 12:00:00 PM,48,-122,19,25,44
17533,ElliotBayTrailMyrtlePark,01/01/2016 01:00:00 PM,48,-122,44,30,74
17534,ElliotBayTrailMyrtlePark,01/01/2016 02:00:00 PM,48,-122,21,33,54
17535,ElliotBayTrailMyrtlePark,01/01/2016 03:00:00 PM,48,-122,43,30,73
17536,ElliotBayTrailMyrtlePark,01/01/2016 04:00:00 PM,48,-122,43,19,62
17537,ElliotBayTrailMyrtlePark,01/01/2016 05:00:00 PM,48,-122,8,13,21
17538,ElliotBayTrailMyrtlePark,01/01/2016 06:00:00 PM,48,-122,5,2,7
17539,ElliotBayTrailMyrtlePark,01/01/2016 07:00:00 PM,48,-122,1,1,2
17540,ElliotBayTrailMyrtlePark,01/01/2016 08:00:00 PM,48,-122,0,0,0
17541,ElliotBayTrailMyrtlePark,01/01/2016 09:00:00 PM,48,-122,0,0,0
17542,ElliotBayTrailMyrtlePark,01/01/2016 10:00:00 PM,48,-122,0,0,0
17543,ElliotBayTrailMyrtlePark,01/01/2016 11:00:00 PM,48,-122,1,1,2
17544,ElliotBayTrailMyrtlePark,01/02/2016 12:00:00 AM,48,-122,1,2,3
17545,ElliotBayTrailMyrtlePark,01/02/2016 01:00:00 AM,48,-122,0,0,0
17546,ElliotBayTrailMyrtlePark,01/02/2016 02:00:00 AM,48,-122,0,0,0
17547,ElliotBayTrailMyrtlePark,01/02/2016 03:00:00 AM,48,-122,0,0,0
17548,ElliotBayTrailMyrtlePark,01/02/2016 04:00:00 AM,48,-122,0,0,0
17549,ElliotBayTrailMyrtlePark,01/02/2016 05:00:00 AM,48,-122,0,1,1
17550,ElliotBayTrailMyrtlePark,01/02/2016 06:00:00 AM,48,-122,1,1,2
17551,ElliotBayTrailMyrtlePark,01/02/2016 07:00:00 AM,48,-122,1,1,2
17552,ElliotBayTrailMyrtlePark,01/02/2016 08:00:00 AM,48,-122,4,0,4
17553,ElliotBayTrailMyrtlePark,01/02/2016 09:00:00 AM,48,-122,3,8,11
17554,ElliotBayTrailMyrtlePark,01/02/2016 10:00:00 AM,48,-122,10,14,24
17555,ElliotBayTrailMyrtlePark,01/02/2016 11:00:00 AM,48,-122,7,9,16
17556,ElliotBayTrailMyrtlePark,01/02/2016 12:00:00 PM,48,-122,23,23,46
17557,ElliotBayTrailMyrtlePark,01/02/2016 01:00:00 PM,48,-122,26,33,59
17558,ElliotBayTrailMyrtlePark,01/02/2016 02:00:00 PM,48,-122,19,31,50
17559,ElliotBayTrailMyrtlePark,01/02/2016 03:00:00 PM,48,-122,27,31,58
17560,ElliotBayTrailMyrtlePark,01/02/2016 04:00:00 PM,48,-122,26,32,58
17561,ElliotBayTrailMyrtlePark,01/02/2016 05:00:00 PM,48,-122,19,15,34
17562,ElliotBayTrailMyrtlePark,01/02/2016 06:00:00 PM,48,-122,4,3,7
17563,ElliotBayTrailMyrtlePark,01/02/2016 07:00:00 PM,48,-122,4,1,5
17564,ElliotBayTrailMyrtlePark,01/02/2016 08:00:00 PM,48,-122,1,2,3
17565,ElliotBayTrailMyrtlePark,01/02/2016 09:00:00 PM,48,-122,3,3,6
17566,ElliotBayTrailMyrtlePark,01/02/2016 10:00:00 PM,48,-122,0,1,1
17567,ElliotBayTrailMyrtlePark,01/02/2016 11:00:00 PM,48,-122,0,0,0
17568,ElliotBayTrailMyrtlePark,01/03/2016 12:00:00 AM,48,-122,2,1,3
17569,ElliotBayTrailMyrtlePark,01/03/2016 01:00:00 AM,48,-122,0,1,1
17570,ElliotBayTrailMyrtlePark,01/03/2016 02:00:00 AM,48,-122,0,0,0
17571,ElliotBayTrailMyrtlePark,01/03/2016 03:00:00 AM,48,-122,1,0,1
17572,ElliotBayTrailMyrtlePark,01/03/2016 04:00:00 AM,48,-122,0,0,0
17573,ElliotBayTrailMyrtlePark,01/03/2016 05:00:00 AM,48,-122,0,1,1
17574,ElliotBayTrailMyrtlePark,01/03/2016 06:00:00 AM,48,-122,0,1,1
17575,ElliotBayTrailMyrtlePark,01/03/2016 07:00:00 AM,48,-122,0,3,3
17576,ElliotBayTrailMyrtlePark,01/03/2016 08:00:00 AM,48,-122,1,4,5
17577,ElliotBayTrailMyrtlePark,01/03/2016 09:00:00 AM,48,-122,7,5,12
17578,ElliotBayTrailMyrtlePark,01/03/2016 10:00:00 AM,48,-122,15,11,26
17579,ElliotBayTrailMyrtlePark,01/03/2016 11:00:00 AM,48,-122,11,13,24
17580,ElliotBayTrailMyrtlePark,01/03/2016 12:00:00 PM,48,-122,14,21,35
17581,ElliotBayTrailMyrtlePark,01/03/2016 01:00:00 PM,48,-122,10,15,25
17582,ElliotBayTrailMyrtlePark,01/03/2016 02:00:00 PM,48,-122,12,10,22
17583,ElliotBayTrailMyrtlePark,01/03/2016 03:00:00 PM,48,-122,16,13,29
17584,ElliotBayTrailMyrtlePark,01/03/2016 04:00:00 PM,48,-122,3,1,4
17585,ElliotBayTrailMyrtlePark,01/03/2016 05:00:00 PM,48,-122,3,1,4
17586,ElliotBayTrailMyrtlePark,01/03/2016 06:00:00 PM,48,-122,4,2,6
17587,ElliotBayTrailMyrtlePark,01/03/2016 07:00:00 PM,48,-122,1,0,1
17588,ElliotBayTrailMyrtlePark,01/03/2016 08:00:00 PM,48,-122,1,0,1
17589,ElliotBayTrailMyrtlePark,01/03/2016 09:00:00 PM,48,-122,3,1,4
17590,ElliotBayTrailMyrtlePark,01/03/2016 10:00:00 PM,48,-122,1,1,2
17591,ElliotBayTrailMyrtlePark,01/03/2016 11:00:00 PM,48,-122,2,1,3
17592,ElliotBayTrailMyrtlePark,01/04/2016 12:00:00 AM,48,-122,0,0,0
17593,ElliotBayTrailMyrtlePark,01/04/2016 01:00:00 AM,48,-122,0,0,0
17594,ElliotBayTrailMyrtlePark,01/04/2016 02:00:00 AM,48,-122,0,0,0
17595,ElliotBayTrailMyrtlePark,01/04/2016 03:00:00 AM,48,-122,1,0,1
17596,ElliotBayTrailMyrtlePark,01/04/2016 04:00:00 AM,48,-122,0,0,0
17597,ElliotBayTrailMyrtlePark,01/04/2016 05:00:00 AM,48,-122,4,4,8
17598,ElliotBayTrailMyrtlePark,01/04/2016 06:00:00 AM,48,-122,12,14,26
17599,ElliotBayTrailMyrtlePark,01/04/2016 07:00:00 AM,48,-122,14,28,42
17600,ElliotBayTrailMyrtlePark,01/04/2016 08:00:00 AM,48,-122,26,89,115
17601,ElliotBayTrailMyrtlePark,01/04/2016 09:00:00 AM,48,-122,20,52,72
17602,ElliotBayTrailMyrtlePark,01/04/2016 10:00:00 AM,48,-122,3,9,12
17603,ElliotBayTrailMyrtlePark,01/04/2016 11:00:00 AM,48,-122,1,7,8
17604,ElliotBayTrailMyrtlePark,01/04/2016 12:00:00 PM,48,-122,6,5,11
17605,ElliotBayTrailMyrtlePark,01/04/2016 01:00:00 PM,48,-122,4,4,8
17606,ElliotBayTrailMyrtlePark,01/04/2016 02:00:00 PM,48,-122,7,5,12
17607,ElliotBayTrailMyrtlePark,01/04/2016 03:00:00 PM,48,-122,10,7,17
17608,ElliotBayTrailMyrtlePark,01/04/2016 04:00:00 PM,48,-122,30,27,57
17609,ElliotBayTrailMyrtlePark,01/04/2016 05:00:00 PM,48,-122,75,36,111
17610,ElliotBayTrailMyrtlePark,01/04/2016 06:00:00 PM,48,-122,85,5,90
17611,ElliotBayTrailMyrtlePark,01/04/2016 07:00:00 PM,48,-122,20,4,24
17612,ElliotBayTrailMyrtlePark,01/04/2016 08:00:00 PM,48,-122,0,0,0
17613,ElliotBayTrailMyrtlePark,01/04/2016 09:00:00 PM,48,-122,1,0,1
17614,ElliotBayTrailMyrtlePark,01/04/2016 10:00:00 PM,48,-122,0,2,2
17615,ElliotBayTrailMyrtlePark,01/04/2016 11:00:00 PM,48,-122,1,0,1
17616,ElliotBayTrailMyrtlePark,01/05/2016 12:00:00 AM,48,-122,1,0,1
17617,ElliotBayTrailMyrtlePark,01/05/2016 01:00:00 AM,48,-122,0,0,0
17618,ElliotBayTrailMyrtlePark,01/05/2016 02:00:00 AM,48,-122,1,0,1
17619,ElliotBayTrailMyrtlePark,01/05/2016 03:00:00 AM,48,-122,0,0,0
17620,ElliotBayTrailMyrtlePark,01/05/2016 04:00:00 AM,48,-122,0,0,0
17621,ElliotBayTrailMyrtlePark,01/05/2016 05:00:00 AM,48,-122,5,3,8
17622,ElliotBayTrailMyrtlePark,01/05/2016 06:00:00 AM,48,-122,4,19,23
17623,ElliotBayTrailMyrtlePark,01/05/2016 07:00:00 AM,48,-122,18,36,54
17624,ElliotBayTrailMyrtlePark,01/05/2016 08:00:00 AM,48,-122,23,93,116
17625,ElliotBayTrailMyrtlePark,01/05/2016 09:00:00 AM,48,-122,23,48,71
17626,ElliotBayTrailMyrtlePark,01/05/2016 10:00:00 AM,48,-122,7,13,20
17627,ElliotBayTrailMyrtlePark,01/05/2016 11:00:00 AM,48,-122,1,5,6
17628,ElliotBayTrailMyrtlePark,01/05/2016 12:00:00 PM,48,-122,5,4,9
17629,ElliotBayTrailMyrtlePark,01/05/2016 01:00:00 PM,48,-122,4,4,8
17630,ElliotBayTrailMyrtlePark,01/05/2016 02:00:00 PM,48,-122,6,3,9
17631,ElliotBayTrailMyrtlePark,01/05/2016 03:00:00 PM,48,-122,10,8,18
17632,ElliotBayTrailMyrtlePark,01/05/2016 04:00:00 PM,48,-122,28,22,50
17633,ElliotBayTrailMyrtlePark,01/05/2016 05:00:00 PM,48,-122,72,27,99
17634,ElliotBayTrailMyrtlePark,01/05/2016 06:00:00 PM,48,-122,89,9,98
17635,ElliotBayTrailMyrtlePark,01/05/2016 07:00:00 PM,48,-122,27,5,32
17636,ElliotBayTrailMyrtlePark,01/05/2016 08:00:00 PM,48,-122,1,0,1
17637,ElliotBayTrailMyrtlePark,01/05/2016 09:00:00 PM,48,-122,5,1,6
17638,ElliotBayTrailMyrtlePark,01/05/2016 10:00:00 PM,48,-122,0,2,2
17639,ElliotBayTrailMyrtlePark,01/05/2016 11:00:00 PM,48,-122,2,0,2
17640,ElliotBayTrailMyrtlePark,01/06/2016 12:00:00 AM,48,-122,2,0,2
17641,ElliotBayTrailMyrtlePark,01/06/2016 01:00:00 AM,48,-122,0,0,0
17642,ElliotBayTrailMyrtlePark,01/06/2016 02:00:00 AM,48,-122,2,0,2
17643,ElliotBayTrailMyrtlePark,01/06/2016 03:00:00 AM,48,-122,1,0,1
17644,ElliotBayTrailMyrtlePark,01/06/2016 04:00:00 AM,48,-122,0,0,0
17645,ElliotBayTrailMyrtlePark,01/06/2016 05:00:00 AM,48,-122,3,3,6
17646,ElliotBayTrailMyrtlePark,01/06/2016 06:00:00 AM,48,-122,11,24,35
17647,ElliotBayTrailMyrtlePark,01/06/2016 07:00:00 AM,48,-122,17,40,57
17648,ElliotBayTrailMyrtlePark,01/06/2016 08:00:00 AM,48,-122,30,120,150
17649,ElliotBayTrailMyrtlePark,01/06/2016 09:00:00 AM,48,-122,25,72,97
17650,ElliotBayTrailMyrtlePark,01/06/2016 10:00:00 AM,48,-122,11,31,42
17651,ElliotBayTrailMyrtlePark,01/06/2016 11:00:00 AM,48,-122,7,18,25
17652,ElliotBayTrailMyrtlePark,01/06/2016 12:00:00 PM,48,-122,16,11,27
17653,ElliotBayTrailMyrtlePark,01/06/2016 01:00:00 PM,48,-122,18,14,32
17654,ElliotBayTrailMyrtlePark,01/06/2016 02:00:00 PM,48,-122,21,23,44
17655,ElliotBayTrailMyrtlePark,01/06/2016 03:00:00 PM,48,-122,27,25,52
17656,ElliotBayTrailMyrtlePark,01/06/2016 04:00:00 PM,48,-122,57,36,93
17657,ElliotBayTrailMyrtlePark,01/06/2016 05:00:00 PM,48,-122,97,45,142
17658,ElliotBayTrailMyrtlePark,01/06/2016 06:00:00 PM,48,-122,99,21,120
17659,ElliotBayTrailMyrtlePark,01/06/2016 07:00:00 PM,48,-122,49,3,52
17660,ElliotBayTrailMyrtlePark,01/06/2016 08:00:00 PM,48,-122,4,2,6
17661,ElliotBayTrailMyrtlePark,01/06/2016 09:00:00 PM,48,-122,2,2,4
17662,ElliotBayTrailMyrtlePark,01/06/2016 10:00:00 PM,48,-122,4,0,4
17663,ElliotBayTrailMyrtlePark,01/06/2016 11:00:00 PM,48,-122,3,1,4
17664,ElliotBayTrailMyrtlePark,01/07/2016 12:00:00 AM,48,-122,0,0,0
17665,ElliotBayTrailMyrtlePark,01/07/2016 01:00:00 AM,48,-122,0,0,0
17666,ElliotBayTrailMyrtlePark,01/07/2016 02:00:00 AM,48,-122,0,0,0
17667,ElliotBayTrailMyrtlePark,01/07/2016 03:00:00 AM,48,-122,1,0,1
17668,ElliotBayTrailMyrtlePark,01/07/2016 04:00:00 AM,48,-122,0,0,0
17669,ElliotBayTrailMyrtlePark,01/07/2016 05:00:00 AM,48,-122,2,1,3
17670,ElliotBayTrailMyrtlePark,01/07/2016 06:00:00 AM,48,-122,11,21,32
17671,ElliotBayTrailMyrtlePark,01/07/2016 07:00:00 AM,48,-122,22,39,61
17672,ElliotBayTrailMyrtlePark,01/07/2016 08:00:00 AM,48,-122,22,98,120
17673,ElliotBayTrailMyrtlePark,01/07/2016 09:00:00 AM,48,-122,27,84,111
17674,ElliotBayTrailMyrtlePark,01/07/2016 10:00:00 AM,48,-122,15,14,29
17675,ElliotBayTrailMyrtlePark,01/07/2016 11:00:00 AM,48,-122,8,10,18
17676,ElliotBayTrailMyrtlePark,01/07/2016 12:00:00 PM,48,-122,16,4,20
17677,ElliotBayTrailMyrtlePark,01/07/2016 01:00:00 PM,48,-122,7,10,17
17678,ElliotBayTrailMyrtlePark,01/07/2016 02:00:00 PM,48,-122,15,14,29
17679,ElliotBayTrailMyrtlePark,01/07/2016 03:00:00 PM,48,-122,13,16,29
17680,ElliotBayTrailMyrtlePark,01/07/2016 04:00:00 PM,48,-122,44,28,72
17681,ElliotBayTrailMyrtlePark,01/07/2016 05:00:00 PM,48,-122,103,40,143
17682,ElliotBayTrailMyrtlePark,01/07/2016 06:00:00 PM,48,-122,102,11,113
17683,ElliotBayTrailMyrtlePark,01/07/2016 07:00:00 PM,48,-122,33,7,40
17684,ElliotBayTrailMyrtlePark,01/07/2016 08:00:00 PM,48,-122,11,3,14
17685,ElliotBayTrailMyrtlePark,01/07/2016 09:00:00 PM,48,-122,5,1,6
17686,ElliotBayTrailMyrtlePark,01/07/2016 10:00:00 PM,48,-122,3,1,4
17687,ElliotBayTrailMyrtlePark,01/07/2016 11:00:00 PM,48,-122,1,5,6
17688,ElliotBayTrailMyrtlePark,01/08/2016 12:00:00 AM,48,-122,0,1,1
17689,ElliotBayTrailMyrtlePark,01/08/2016 01:00:00 AM,48,-122,0,2,2
17690,ElliotBayTrailMyrtlePark,01/08/2016 02:00:00 AM,48,-122,1,0,1
17691,ElliotBayTrailMyrtlePark,01/08/2016 03:00:00 AM,48,-122,0,0,0
17692,ElliotBayTrailMyrtlePark,01/08/2016 04:00:00 AM,48,-122,0,0,0
17693,ElliotBayTrailMyrtlePark,01/08/2016 05:00:00 AM,48,-122,4,2,6
17694,ElliotBayTrailMyrtlePark,01/08/2016 06:00:00 AM,48,-122,7,11,18
17695,ElliotBayTrailMyrtlePark,01/08/2016 07:00:00 AM,48,-122,21,47,68
17696,ElliotBayTrailMyrtlePark,01/08/2016 08:00:00 AM,48,-122,26,97,123
17697,ElliotBayTrailMyrtlePark,01/08/2016 09:00:00 AM,48,-122,22,58,80
17698,ElliotBayTrailMyrtlePark,01/08/2016 10:00:00 AM,48,-122,12,20,32
17699,ElliotBayTrailMyrtlePark,01/08/2016 11:00:00 AM,48,-122,12,21,33
17700,ElliotBayTrailMyrtlePark,01/08/2016 12:00:00 PM,48,-122,16,12,28
17701,ElliotBayTrailMyrtlePark,01/08/2016 01:00:00 PM,48,-122,16,22,38
17702,ElliotBayTrailMyrtlePark,01/08/2016 02:00:00 PM,48,-122,27,18,45
17703,ElliotBayTrailMyrtlePark,01/08/2016 03:00:00 PM,48,-122,36,25,61
17704,ElliotBayTrailMyrtlePark,01/08/2016 04:00:00 PM,48,-122,54,43,97
17705,ElliotBayTrailMyrtlePark,01/08/2016 05:00:00 PM,48,-122,99,41,140
17706,ElliotBayTrailMyrtlePark,01/08/2016 06:00:00 PM,48,-122,64,21,85
17707,ElliotBayTrailMyrtlePark,01/08/2016 07:00:00 PM,48,-122,27,10,37
17708,ElliotBayTrailMyrtlePark,01/08/2016 08:00:00 PM,48,-122,11,1,12
17709,ElliotBayTrailMyrtlePark,01/08/2016 09:00:00 PM,48,-122,2,2,4
17710,ElliotBayTrailMyrtlePark,01/08/2016 10:00:00 PM,48,-122,2,1,3
17711,ElliotBayTrailMyrtlePark,01/08/2016 11:00:00 PM,48,-122,3,1,4
17712,ElliotBayTrailMyrtlePark,01/09/2016 12:00:00 AM,48,-122,2,0,2
17713,ElliotBayTrailMyrtlePark,01/09/2016 01:00:00 AM,48,-122,1,0,1
17714,ElliotBayTrailMyrtlePark,01/09/2016 02:00:00 AM,48,-122,1,0,1
17715,ElliotBayTrailMyrtlePark,01/09/2016 03:00:00 AM,48,-122,3,0,3
17716,ElliotBayTrailMyrtlePark,01/09/2016 04:00:00 AM,48,-122,0,0,0
17717,ElliotBayTrailMyrtlePark,01/09/2016 05:00:00 AM,48,-122,0,2,2
17718,ElliotBayTrailMyrtlePark,01/09/2016 06:00:00 AM,48,-122,2,2,4
17719,ElliotBayTrailMyrtlePark,01/09/2016 07:00:00 AM,48,-122,0,1,1
17720,ElliotBayTrailMyrtlePark,01/09/2016 08:00:00 AM,48,-122,10,4,14
17721,ElliotBayTrailMyrtlePark,01/09/2016 09:00:00 AM,48,-122,6,8,14
17722,ElliotBayTrailMyrtlePark,01/09/2016 10:00:00 AM,48,-122,12,16,28
17723,ElliotBayTrailMyrtlePark,01/09/2016 11:00:00 AM,48,-122,10,20,30
17724,ElliotBayTrailMyrtlePark,01/09/2016 12:00:00 PM,48,-122,19,25,44
17725,ElliotBayTrailMyrtlePark,01/09/2016 01:00:00 PM,48,-122,37,36,73
17726,ElliotBayTrailMyrtlePark,01/09/2016 02:00:00 PM,48,-122,35,24,59
17727,ElliotBayTrailMyrtlePark,01/09/2016 03:00:00 PM,48,-122,40,41,81
17728,ElliotBayTrailMyrtlePark,01/09/2016 04:00:00 PM,48,-122,42,36,78
17729,ElliotBayTrailMyrtlePark,01/09/2016 05:00:00 PM,48,-122,17,20,37
17730,ElliotBayTrailMyrtlePark,01/09/2016 06:00:00 PM,48,-122,2,15,17
17731,ElliotBayTrailMyrtlePark,01/09/2016 07:00:00 PM,48,-122,5,2,7
17732,ElliotBayTrailMyrtlePark,01/09/2016 08:00:00 PM,48,-122,0,0,0
17733,ElliotBayTrailMyrtlePark,01/09/2016 09:00:00 PM,48,-122,2,2,4
17734,ElliotBayTrailMyrtlePark,01/09/2016 10:00:00 PM,48,-122,1,1,2
17735,ElliotBayTrailMyrtlePark,01/09/2016 11:00:00 PM,48,-122,10,0,10
17736,ElliotBayTrailMyrtlePark,01/10/2016 12:00:00 AM,48,-122,0,0,0
17737,ElliotBayTrailMyrtlePark,01/10/2016 01:00:00 AM,48,-122,0,1,1
17738,ElliotBayTrailMyrtlePark,01/10/2016 02:00:00 AM,48,-122,0,0,0
17739,ElliotBayTrailMyrtlePark,01/10/2016 03:00:00 AM,48,-122,3,0,3
17740,ElliotBayTrailMyrtlePark,01/10/2016 04:00:00 AM,48,-122,0,1,1
17741,ElliotBayTrailMyrtlePark,01/10/2016 05:00:00 AM,48,-122,0,1,1
17742,ElliotBayTrailMyrtlePark,01/10/2016 06:00:00 AM,48,-122,0,0,0
17743,ElliotBayTrailMyrtlePark,01/10/2016 07:00:00 AM,48,-122,1,2,3
17744,ElliotBayTrailMyrtlePark,01/10/2016 08:00:00 AM,48,-122,1,4,5
17745,ElliotBayTrailMyrtlePark,01/10/2016 09:00:00 AM,48,-122,18,6,24
17746,ElliotBayTrailMyrtlePark,01/10/2016 10:00:00 AM,48,-122,10,14,24
17747,ElliotBayTrailMyrtlePark,01/10/2016 11:00:00 AM,48,-122,23,30,53
17748,ElliotBayTrailMyrtlePark,01/10/2016 12:00:00 PM,48,-122,25,20,45
17749,ElliotBayTrailMyrtlePark,01/10/2016 01:00:00 PM,48,-122,37,24,61
17750,ElliotBayTrailMyrtlePark,01/10/2016 02:00:00 PM,48,-122,50,43,93
17751,ElliotBayTrailMyrtlePark,01/10/2016 03:00:00 PM,48,-122,46,68,114
17752,ElliotBayTrailMyrtlePark,01/10/2016 04:00:00 PM,48,-122,40,42,82
17753,ElliotBayTrailMyrtlePark,01/10/2016 05:00:00 PM,48,-122,15,28,43
17754,ElliotBayTrailMyrtlePark,01/10/2016 06:00:00 PM,48,-122,6,8,14
17755,ElliotBayTrailMyrtlePark,01/10/2016 07:00:00 PM,48,-122,2,2,4
17756,ElliotBayTrailMyrtlePark,01/10/2016 08:00:00 PM,48,-122,3,1,4
17757,ElliotBayTrailMyrtlePark,01/10/2016 09:00:00 PM,48,-122,0,1,1
17758,ElliotBayTrailMyrtlePark,01/10/2016 10:00:00 PM,48,-122,0,1,1
17759,ElliotBayTrailMyrtlePark,01/10/2016 11:00:00 PM,48,-122,0,0,0
17760,ElliotBayTrailMyrtlePark,01/11/2016 12:00:00 AM,48,-122,0,0,0
17761,ElliotBayTrailMyrtlePark,01/11/2016 01:00:00 AM,48,-122,0,2,2
17762,ElliotBayTrailMyrtlePark,01/11/2016 02:00:00 AM,48,-122,0,0,0
17763,ElliotBayTrailMyrtlePark,01/11/2016 03:00:00 AM,48,-122,1,0,1
17764,ElliotBayTrailMyrtlePark,01/11/2016 04:00:00 AM,48,-122,0,0,0
17765,ElliotBayTrailMyrtlePark,01/11/2016 05:00:00 AM,48,-122,5,4,9
17766,ElliotBayTrailMyrtlePark,01/11/2016 06:00:00 AM,48,-122,8,23,31
17767,ElliotBayTrailMyrtlePark,01/11/2016 07:00:00 AM,48,-122,14,31,45
17768,ElliotBayTrailMyrtlePark,01/11/2016 08:00:00 AM,48,-122,31,101,132
17769,ElliotBayTrailMyrtlePark,01/11/2016 09:00:00 AM,48,-122,20,69,89
17770,ElliotBayTrailMyrtlePark,01/11/2016 10:00:00 AM,48,-122,13,13,26
17771,ElliotBayTrailMyrtlePark,01/11/2016 11:00:00 AM,48,-122,4,13,17
17772,ElliotBayTrailMyrtlePark,01/11/2016 12:00:00 PM,48,-122,7,6,13
17773,ElliotBayTrailMyrtlePark,01/11/2016 01:00:00 PM,48,-122,7,3,10
17774,ElliotBayTrailMyrtlePark,01/11/2016 02:00:00 PM,48,-122,7,4,11
17775,ElliotBayTrailMyrtlePark,01/11/2016 03:00:00 PM,48,-122,13,10,23
17776,ElliotBayTrailMyrtlePark,01/11/2016 04:00:00 PM,48,-122,29,27,56
17777,ElliotBayTrailMyrtlePark,01/11/2016 05:00:00 PM,48,-122,93,26,119
17778,ElliotBayTrailMyrtlePark,01/11/2016 06:00:00 PM,48,-122,93,12,105
17779,ElliotBayTrailMyrtlePark,01/11/2016 07:00:00 PM,48,-122,34,3,37
17780,ElliotBayTrailMyrtlePark,01/11/2016 08:00:00 PM,48,-122,6,0,6
17781,ElliotBayTrailMyrtlePark,01/11/2016 09:00:00 PM,48,-122,3,1,4
17782,ElliotBayTrailMyrtlePark,01/11/2016 10:00:00 PM,48,-122,1,0,1
17783,ElliotBayTrailMyrtlePark,01/11/2016 11:00:00 PM,48,-122,0,1,1
17784,ElliotBayTrailMyrtlePark,01/12/2016 12:00:00 AM,48,-122,2,0,2
17785,ElliotBayTrailMyrtlePark,01/12/2016 01:00:00 AM,48,-122,0,0,0
17786,ElliotBayTrailMyrtlePark,01/12/2016 02:00:00 AM,48,-122,0,0,0
17787,ElliotBayTrailMyrtlePark,01/12/2016 03:00:00 AM,48,-122,1,0,1
17788,ElliotBayTrailMyrtlePark,01/12/2016 04:00:00 AM,48,-122,0,0,0
17789,ElliotBayTrailMyrtlePark,01/12/2016 05:00:00 AM,48,-122,4,4,8
17790,ElliotBayTrailMyrtlePark,01/12/2016 06:00:00 AM,48,-122,9,18,27
17791,ElliotBayTrailMyrtlePark,01/12/2016 07:00:00 AM,48,-122,20,36,56
17792,ElliotBayTrailMyrtlePark,01/12/2016 08:00:00 AM,48,-122,21,69,90
17793,ElliotBayTrailMyrtlePark,01/12/2016 09:00:00 AM,48,-122,21,50,71
17794,ElliotBayTrailMyrtlePark,01/12/2016 10:00:00 AM,48,-122,6,13,19
17795,ElliotBayTrailMyrtlePark,01/12/2016 11:00:00 AM,48,-122,3,15,18
17796,ElliotBayTrailMyrtlePark,01/12/2016 12:00:00 PM,48,-122,5,5,10
17797,ElliotBayTrailMyrtlePark,01/12/2016 01:00:00 PM,48,-122,6,4,10
17798,ElliotBayTrailMyrtlePark,01/12/2016 02:00:00 PM,48,-122,5,4,9
17799,ElliotBayTrailMyrtlePark,01/12/2016 03:00:00 PM,48,-122,4,9,13
17800,ElliotBayTrailMyrtlePark,01/12/2016 04:00:00 PM,48,-122,18,23,41
17801,ElliotBayTrailMyrtlePark,01/12/2016 05:00:00 PM,48,-122,66,19,85
17802,ElliotBayTrailMyrtlePark,01/12/2016 06:00:00 PM,48,-122,80,10,90
17803,ElliotBayTrailMyrtlePark,01/12/2016 07:00:00 PM,48,-122,20,1,21
17804,ElliotBayTrailMyrtlePark,01/12/2016 08:00:00 PM,48,-122,5,2,7
17805,ElliotBayTrailMyrtlePark,01/12/2016 09:00:00 PM,48,-122,6,0,6
17806,ElliotBayTrailMyrtlePark,01/12/2016 10:00:00 PM,48,-122,4,1,5
17807,ElliotBayTrailMyrtlePark,01/12/2016 11:00:00 PM,48,-122,0,0,0
17808,ElliotBayTrailMyrtlePark,01/13/2016 12:00:00 AM,48,-122,0,0,0
17809,ElliotBayTrailMyrtlePark,01/13/2016 01:00:00 AM,48,-122,0,1,1
17810,ElliotBayTrailMyrtlePark,01/13/2016 02:00:00 AM,48,-122,0,1,1
17811,ElliotBayTrailMyrtlePark,01/13/2016 03:00:00 AM,48,-122,0,0,0
17812,ElliotBayTrailMyrtlePark,01/13/2016 04:00:00 AM,48,-122,0,0,0
17813,ElliotBayTrailMyrtlePark,01/13/2016 05:00:00 AM,48,-122,2,4,6
17814,ElliotBayTrailMyrtlePark,01/13/2016 06:00:00 AM,48,-122,8,20,28
17815,ElliotBayTrailMyrtlePark,01/13/2016 07:00:00 AM,48,-122,14,34,48
17816,ElliotBayTrailMyrtlePark,01/13/2016 08:00:00 AM,48,-122,17,61,78
17817,ElliotBayTrailMyrtlePark,01/13/2016 09:00:00 AM,48,-122,13,46,59
17818,ElliotBayTrailMyrtlePark,01/13/2016 10:00:00 AM,48,-122,7,13,20
17819,ElliotBayTrailMyrtlePark,01/13/2016 11:00:00 AM,48,-122,4,12,16
17820,ElliotBayTrailMyrtlePark,01/13/2016 12:00:00 PM,48,-122,2,8,10
17821,ElliotBayTrailMyrtlePark,01/13/2016 01:00:00 PM,48,-122,5,2,7
17822,ElliotBayTrailMyrtlePark,01/13/2016 02:00:00 PM,48,-122,6,7,13
17823,ElliotBayTrailMyrtlePark,01/13/2016 03:00:00 PM,48,-122,10,9,19
17824,ElliotBayTrailMyrtlePark,01/13/2016 04:00:00 PM,48,-122,29,23,52
17825,ElliotBayTrailMyrtlePark,01/13/2016 05:00:00 PM,48,-122,70,29,99
17826,ElliotBayTrailMyrtlePark,01/13/2016 06:00:00 PM,48,-122,77,13,90
17827,ElliotBayTrailMyrtlePark,01/13/2016 07:00:00 PM,48,-122,25,4,29
17828,ElliotBayTrailMyrtlePark,01/13/2016 08:00:00 PM,48,-122,4,0,4
17829,ElliotBayTrailMyrtlePark,01/13/2016 09:00:00 PM,48,-122,1,2,3
17830,ElliotBayTrailMyrtlePark,01/13/2016 10:00:00 PM,48,-122,2,1,3
17831,ElliotBayTrailMyrtlePark,01/13/2016 11:00:00 PM,48,-122,0,0,0
17832,ElliotBayTrailMyrtlePark,01/14/2016 12:00:00 AM,48,-122,1,0,1
17833,ElliotBayTrailMyrtlePark,01/14/2016 01:00:00 AM,48,-122,0,2,2
17834,ElliotBayTrailMyrtlePark,01/14/2016 02:00:00 AM,48,-122,0,0,0
17835,ElliotBayTrailMyrtlePark,01/14/2016 03:00:00 AM,48,-122,0,0,0
17836,ElliotBayTrailMyrtlePark,01/14/2016 04:00:00 AM,48,-122,1,0,1
17837,ElliotBayTrailMyrtlePark,01/14/2016 05:00:00 AM,48,-122,5,0,5
17838,ElliotBayTrailMyrtlePark,01/14/2016 06:00:00 AM,48,-122,6,18,24
17839,ElliotBayTrailMyrtlePark,01/14/2016 07:00:00 AM,48,-122,21,26,47
17840,ElliotBayTrailMyrtlePark,01/14/2016 08:00:00 AM,48,-122,16,101,117
17841,ElliotBayTrailMyrtlePark,01/14/2016 09:00:00 AM,48,-122,22,65,87
17842,ElliotBayTrailMyrtlePark,01/14/2016 10:00:00 AM,48,-122,12,25,37
17843,ElliotBayTrailMyrtlePark,01/14/2016 11:00:00 AM,48,-122,23,17,40
17844,ElliotBayTrailMyrtlePark,01/14/2016 12:00:00 PM,48,-122,24,20,44
17845,ElliotBayTrailMyrtlePark,01/14/2016 01:00:00 PM,48,-122,17,34,51
17846,ElliotBayTrailMyrtlePark,01/14/2016 02:00:00 PM,48,-122,13,20,33
17847,ElliotBayTrailMyrtlePark,01/14/2016 03:00:00 PM,48,-122,26,23,49
17848,ElliotBayTrailMyrtlePark,01/14/2016 04:00:00 PM,48,-122,37,36,73
17849,ElliotBayTrailMyrtlePark,01/14/2016 05:00:00 PM,48,-122,99,43,142
17850,ElliotBayTrailMyrtlePark,01/14/2016 06:00:00 PM,48,-122,99,26,125
17851,ElliotBayTrailMyrtlePark,01/14/2016 07:00:00 PM,48,-122,29,6,35
17852,ElliotBayTrailMyrtlePark,01/14/2016 08:00:00 PM,48,-122,7,4,11
17853,ElliotBayTrailMyrtlePark,01/14/2016 09:00:00 PM,48,-122,4,2,6
17854,ElliotBayTrailMyrtlePark,01/14/2016 10:00:00 PM,48,-122,5,1,6
17855,ElliotBayTrailMyrtlePark,01/14/2016 11:00:00 PM,48,-122,2,1,3
17856,ElliotBayTrailMyrtlePark,01/15/2016 12:00:00 AM,48,-122,4,0,4
17857,ElliotBayTrailMyrtlePark,01/15/2016 01:00:00 AM,48,-122,0,0,0
17858,ElliotBayTrailMyrtlePark,01/15/2016 02:00:00 AM,48,-122,0,0,0
17859,ElliotBayTrailMyrtlePark,01/15/2016 03:00:00 AM,48,-122,2,0,2
17860,ElliotBayTrailMyrtlePark,01/15/2016 04:00:00 AM,48,-122,0,1,1
17861,ElliotBayTrailMyrtlePark,01/15/2016 05:00:00 AM,48,-122,3,5,8
17862,ElliotBayTrailMyrtlePark,01/15/2016 06:00:00 AM,48,-122,7,24,31
17863,ElliotBayTrailMyrtlePark,01/15/2016 07:00:00 AM,48,-122,15,33,48
17864,ElliotBayTrailMyrtlePark,01/15/2016 08:00:00 AM,48,-122,24,75,99
17865,ElliotBayTrailMyrtlePark,01/15/2016 09:00:00 AM,48,-122,23,61,84
17866,ElliotBayTrailMyrtlePark,01/15/2016 10:00:00 AM,48,-122,9,18,27
17867,ElliotBayTrailMyrtlePark,01/15/2016 11:00:00 AM,48,-122,9,6,15
17868,ElliotBayTrailMyrtlePark,01/15/2016 12:00:00 PM,48,-122,4,9,13
17869,ElliotBayTrailMyrtlePark,01/15/2016 01:00:00 PM,48,-122,8,5,13
17870,ElliotBayTrailMyrtlePark,01/15/2016 02:00:00 PM,48,-122,11,10,21
17871,ElliotBayTrailMyrtlePark,01/15/2016 03:00:00 PM,48,-122,15,8,23
17872,ElliotBayTrailMyrtlePark,01/15/2016 04:00:00 PM,48,-122,33,26,59
17873,ElliotBayTrailMyrtlePark,01/15/2016 05:00:00 PM,48,-122,89,18,107
17874,ElliotBayTrailMyrtlePark,01/15/2016 06:00:00 PM,48,-122,66,13,79
17875,ElliotBayTrailMyrtlePark,01/15/2016 07:00:00 PM,48,-122,19,6,25
17876,ElliotBayTrailMyrtlePark,01/15/2016 08:00:00 PM,48,-122,9,1,10
17877,ElliotBayTrailMyrtlePark,01/15/2016 09:00:00 PM,48,-122,7,4,11
17878,ElliotBayTrailMyrtlePark,01/15/2016 10:00:00 PM,48,-122,2,4,6
17879,ElliotBayTrailMyrtlePark,01/15/2016 11:00:00 PM,48,-122,2,0,2
17880,ElliotBayTrailMyrtlePark,01/16/2016 12:00:00 AM,48,-122,0,0,0
17881,ElliotBayTrailMyrtlePark,01/16/2016 01:00:00 AM,48,-122,1,0,1
17882,ElliotBayTrailMyrtlePark,01/16/2016 02:00:00 AM,48,-122,0,0,0
17883,ElliotBayTrailMyrtlePark,01/16/2016 03:00:00 AM,48,-122,0,0,0
17884,ElliotBayTrailMyrtlePark,01/16/2016 04:00:00 AM,48,-122,0,0,0
17885,ElliotBayTrailMyrtlePark,01/16/2016 05:00:00 AM,48,-122,1,2,3
17886,ElliotBayTrailMyrtlePark,01/16/2016 06:00:00 AM,48,-122,0,1,1
17887,ElliotBayTrailMyrtlePark,01/16/2016 07:00:00 AM,48,-122,0,1,1
17888,ElliotBayTrailMyrtlePark,01/16/2016 08:00:00 AM,48,-122,3,1,4
17889,ElliotBayTrailMyrtlePark,01/16/2016 09:00:00 AM,48,-122,0,1,1
17890,ElliotBayTrailMyrtlePark,01/16/2016 10:00:00 AM,48,-122,3,6,9
17891,ElliotBayTrailMyrtlePark,01/16/2016 11:00:00 AM,48,-122,8,12,20
17892,ElliotBayTrailMyrtlePark,01/16/2016 12:00:00 PM,48,-122,11,9,20
17893,ElliotBayTrailMyrtlePark,01/16/2016 01:00:00 PM,48,-122,17,20,37
17894,ElliotBayTrailMyrtlePark,01/16/2016 02:00:00 PM,48,-122,23,14,37
17895,ElliotBayTrailMyrtlePark,01/16/2016 03:00:00 PM,48,-122,10,7,17
17896,ElliotBayTrailMyrtlePark,01/16/2016 04:00:00 PM,48,-122,7,10,17
17897,ElliotBayTrailMyrtlePark,01/16/2016 05:00:00 PM,48,-122,1,4,5
17898,ElliotBayTrailMyrtlePark,01/16/2016 06:00:00 PM,48,-122,2,0,2
17899,ElliotBayTrailMyrtlePark,01/16/2016 07:00:00 PM,48,-122,2,2,4
17900,ElliotBayTrailMyrtlePark,01/16/2016 08:00:00 PM,48,-122,2,0,2
17901,ElliotBayTrailMyrtlePark,01/16/2016 09:00:00 PM,48,-122,0,4,4
17902,ElliotBayTrailMyrtlePark,01/16/2016 10:00:00 PM,48,-122,4,2,6
17903,ElliotBayTrailMyrtlePark,01/16/2016 11:00:00 PM,48,-122,5,0,5
17904,ElliotBayTrailMyrtlePark,01/17/2016 12:00:00 AM,48,-122,1,3,4
17905,ElliotBayTrailMyrtlePark,01/17/2016 01:00:00 AM,48,-122,0,0,0
17906,ElliotBayTrailMyrtlePark,01/17/2016 02:00:00 AM,48,-122,0,0,0
17907,ElliotBayTrailMyrtlePark,01/17/2016 03:00:00 AM,48,-122,0,0,0
17908,ElliotBayTrailMyrtlePark,01/17/2016 04:00:00 AM,48,-122,0,0,0
17909,ElliotBayTrailMyrtlePark,01/17/2016 05:00:00 AM,48,-122,0,1,1
17910,ElliotBayTrailMyrtlePark,01/17/2016 06:00:00 AM,48,-122,0,1,1
17911,ElliotBayTrailMyrtlePark,01/17/2016 07:00:00 AM,48,-122,2,4,6
17912,ElliotBayTrailMyrtlePark,01/17/2016 08:00:00 AM,48,-122,0,2,2
17913,ElliotBayTrailMyrtlePark,01/17/2016 09:00:00 AM,48,-122,7,5,12
17914,ElliotBayTrailMyrtlePark,01/17/2016 10:00:00 AM,48,-122,2,7,9
17915,ElliotBayTrailMyrtlePark,01/17/2016 11:00:00 AM,48,-122,1,5,6
17916,ElliotBayTrailMyrtlePark,01/17/2016 12:00:00 PM,48,-122,9,5,14
17917,ElliotBayTrailMyrtlePark,01/17/2016 01:00:00 PM,48,-122,3,9,12
17918,ElliotBayTrailMyrtlePark,01/17/2016 02:00:00 PM,48,-122,14,2,16
17919,ElliotBayTrailMyrtlePark,01/17/2016 03:00:00 PM,48,-122,6,7,13
17920,ElliotBayTrailMyrtlePark,01/17/2016 04:00:00 PM,48,-122,6,6,12
17921,ElliotBayTrailMyrtlePark,01/17/2016 05:00:00 PM,48,-122,6,1,7
17922,ElliotBayTrailMyrtlePark,01/17/2016 06:00:00 PM,48,-122,5,2,7
17923,ElliotBayTrailMyrtlePark,01/17/2016 07:00:00 PM,48,-122,3,0,3
17924,ElliotBayTrailMyrtlePark,01/17/2016 08:00:00 PM,48,-122,0,3,3
17925,ElliotBayTrailMyrtlePark,01/17/2016 09:00:00 PM,48,-122,2,0,2
17926,ElliotBayTrailMyrtlePark,01/17/2016 10:00:00 PM,48,-122,0,1,1
17927,ElliotBayTrailMyrtlePark,01/17/2016 11:00:00 PM,48,-122,0,0,0
17928,ElliotBayTrailMyrtlePark,01/18/2016 12:00:00 AM,48,-122,0,0,0
17929,ElliotBayTrailMyrtlePark,01/18/2016 01:00:00 AM,48,-122,0,0,0
17930,ElliotBayTrailMyrtlePark,01/18/2016 02:00:00 AM,48,-122,0,0,0
17931,ElliotBayTrailMyrtlePark,01/18/2016 03:00:00 AM,48,-122,0,0,0
17932,ElliotBayTrailMyrtlePark,01/18/2016 04:00:00 AM,48,-122,0,0,0
17933,ElliotBayTrailMyrtlePark,01/18/2016 05:00:00 AM,48,-122,4,2,6
17934,ElliotBayTrailMyrtlePark,01/18/2016 06:00:00 AM,48,-122,4,5,9
17935,ElliotBayTrailMyrtlePark,01/18/2016 07:00:00 AM,48,-122,19,13,32
17936,ElliotBayTrailMyrtlePark,01/18/2016 08:00:00 AM,48,-122,21,44,65
17937,ElliotBayTrailMyrtlePark,01/18/2016 09:00:00 AM,48,-122,13,44,57
17938,ElliotBayTrailMyrtlePark,01/18/2016 10:00:00 AM,48,-122,14,26,40
17939,ElliotBayTrailMyrtlePark,01/18/2016 11:00:00 AM,48,-122,11,19,30
17940,ElliotBayTrailMyrtlePark,01/18/2016 12:00:00 PM,48,-122,18,20,38
17941,ElliotBayTrailMyrtlePark,01/18/2016 01:00:00 PM,48,-122,28,27,55
17942,ElliotBayTrailMyrtlePark,01/18/2016 02:00:00 PM,48,-122,38,38,76
17943,ElliotBayTrailMyrtlePark,01/18/2016 03:00:00 PM,48,-122,21,23,44
17944,ElliotBayTrailMyrtlePark,01/18/2016 04:00:00 PM,48,-122,33,35,68
17945,ElliotBayTrailMyrtlePark,01/18/2016 05:00:00 PM,48,-122,62,25,87
17946,ElliotBayTrailMyrtlePark,01/18/2016 06:00:00 PM,48,-122,46,12,58
17947,ElliotBayTrailMyrtlePark,01/18/2016 07:00:00 PM,48,-122,15,11,26
17948,ElliotBayTrailMyrtlePark,01/18/2016 08:00:00 PM,48,-122,7,0,7
17949,ElliotBayTrailMyrtlePark,01/18/2016 09:00:00 PM,48,-122,4,2,6
17950,ElliotBayTrailMyrtlePark,01/18/2016 10:00:00 PM,48,-122,0,2,2
17951,ElliotBayTrailMyrtlePark,01/18/2016 11:00:00 PM,48,-122,0,0,0
17952,ElliotBayTrailMyrtlePark,01/19/2016 12:00:00 AM,48,-122,1,0,1
17953,ElliotBayTrailMyrtlePark,01/19/2016 01:00:00 AM,48,-122,0,0,0
17954,ElliotBayTrailMyrtlePark,01/19/2016 02:00:00 AM,48,-122,0,0,0
17955,ElliotBayTrailMyrtlePark,01/19/2016 03:00:00 AM,48,-122,0,0,0
17956,ElliotBayTrailMyrtlePark,01/19/2016 04:00:00 AM,48,-122,0,1,1
17957,ElliotBayTrailMyrtlePark,01/19/2016 05:00:00 AM,48,-122,4,2,6
17958,ElliotBayTrailMyrtlePark,01/19/2016 06:00:00 AM,48,-122,9,25,34
17959,ElliotBayTrailMyrtlePark,01/19/2016 07:00:00 AM,48,-122,20,28,48
17960,ElliotBayTrailMyrtlePark,01/19/2016 08:00:00 AM,48,-122,33,126,159
17961,ElliotBayTrailMyrtlePark,01/19/2016 09:00:00 AM,48,-122,33,59,92
17962,ElliotBayTrailMyrtlePark,01/19/2016 10:00:00 AM,48,-122,10,26,36
17963,ElliotBayTrailMyrtlePark,01/19/2016 11:00:00 AM,48,-122,8,7,15
17964,ElliotBayTrailMyrtlePark,01/19/2016 12:00:00 PM,48,-122,8,11,19
17965,ElliotBayTrailMyrtlePark,01/19/2016 01:00:00 PM,48,-122,8,4,12
17966,ElliotBayTrailMyrtlePark,01/19/2016 02:00:00 PM,48,-122,4,11,15
17967,ElliotBayTrailMyrtlePark,01/19/2016 03:00:00 PM,48,-122,11,5,16
17968,ElliotBayTrailMyrtlePark,01/19/2016 04:00:00 PM,48,-122,25,21,46
17969,ElliotBayTrailMyrtlePark,01/19/2016 05:00:00 PM,48,-122,99,26,125
17970,ElliotBayTrailMyrtlePark,01/19/2016 06:00:00 PM,48,-122,89,11,100
17971,ElliotBayTrailMyrtlePark,01/19/2016 07:00:00 PM,48,-122,23,8,31
17972,ElliotBayTrailMyrtlePark,01/19/2016 08:00:00 PM,48,-122,8,3,11
17973,ElliotBayTrailMyrtlePark,01/19/2016 09:00:00 PM,48,-122,7,2,9
17974,ElliotBayTrailMyrtlePark,01/19/2016 10:00:00 PM,48,-122,0,0,0
17975,ElliotBayTrailMyrtlePark,01/19/2016 11:00:00 PM,48,-122,0,0,0
17976,ElliotBayTrailMyrtlePark,01/20/2016 12:00:00 AM,48,-122,0,0,0
17977,ElliotBayTrailMyrtlePark,01/20/2016 01:00:00 AM,48,-122,0,0,0
17978,ElliotBayTrailMyrtlePark,01/20/2016 02:00:00 AM,48,-122,0,0,0
17979,ElliotBayTrailMyrtlePark,01/20/2016 03:00:00 AM,48,-122,1,0,1
17980,ElliotBayTrailMyrtlePark,01/20/2016 04:00:00 AM,48,-122,0,0,0
17981,ElliotBayTrailMyrtlePark,01/20/2016 05:00:00 AM,48,-122,3,4,7
17982,ElliotBayTrailMyrtlePark,01/20/2016 06:00:00 AM,48,-122,10,22,32
17983,ElliotBayTrailMyrtlePark,01/20/2016 07:00:00 AM,48,-122,29,29,58
17984,ElliotBayTrailMyrtlePark,01/20/2016 08:00:00 AM,48,-122,25,93,118
17985,ElliotBayTrailMyrtlePark,01/20/2016 09:00:00 AM,48,-122,27,66,93
17986,ElliotBayTrailMyrtlePark,01/20/2016 10:00:00 AM,48,-122,12,22,34
17987,ElliotBayTrailMyrtlePark,01/20/2016 11:00:00 AM,48,-122,15,10,25
17988,ElliotBayTrailMyrtlePark,01/20/2016 12:00:00 PM,48,-122,13,6,19
17989,ElliotBayTrailMyrtlePark,01/20/2016 01:00:00 PM,48,-122,12,9,21
17990,ElliotBayTrailMyrtlePark,01/20/2016 02:00:00 PM,48,-122,19,14,33
17991,ElliotBayTrailMyrtlePark,01/20/2016 03:00:00 PM,48,-122,13,20,33
17992,ElliotBayTrailMyrtlePark,01/20/2016 04:00:00 PM,48,-122,42,26,68
17993,ElliotBayTrailMyrtlePark,01/20/2016 05:00:00 PM,48,-122,108,37,145
17994,ElliotBayTrailMyrtlePark,01/20/2016 06:00:00 PM,48,-122,96,25,121
17995,ElliotBayTrailMyrtlePark,01/20/2016 07:00:00 PM,48,-122,33,6,39
17996,ElliotBayTrailMyrtlePark,01/20/2016 08:00:00 PM,48,-122,16,2,18
17997,ElliotBayTrailMyrtlePark,01/20/2016 09:00:00 PM,48,-122,4,5,9
17998,ElliotBayTrailMyrtlePark,01/20/2016 10:00:00 PM,48,-122,4,2,6
17999,ElliotBayTrailMyrtlePark,01/20/2016 11:00:00 PM,48,-122,2,0,2
18000,ElliotBayTrailMyrtlePark,01/21/2016 12:00:00 AM,48,-122,0,0,0
18001,ElliotBayTrailMyrtlePark,01/21/2016 01:00:00 AM,48,-122,0,2,2
18002,ElliotBayTrailMyrtlePark,01/21/2016 02:00:00 AM,48,-122,1,0,1
18003,ElliotBayTrailMyrtlePark,01/21/2016 03:00:00 AM,48,-122,1,0,1
18004,ElliotBayTrailMyrtlePark,01/21/2016 04:00:00 AM,48,-122,0,0,0
18005,ElliotBayTrailMyrtlePark,01/21/2016 05:00:00 AM,48,-122,3,2,5
18006,ElliotBayTrailMyrtlePark,01/21/2016 06:00:00 AM,48,-122,11,10,21
18007,ElliotBayTrailMyrtlePark,01/21/2016 07:00:00 AM,48,-122,15,24,39
18008,ElliotBayTrailMyrtlePark,01/21/2016 08:00:00 AM,48,-122,22,62,84
18009,ElliotBayTrailMyrtlePark,01/21/2016 09:00:00 AM,48,-122,15,31,46
18010,ElliotBayTrailMyrtlePark,01/21/2016 10:00:00 AM,48,-122,5,12,17
18011,ElliotBayTrailMyrtlePark,01/21/2016 11:00:00 AM,48,-122,1,7,8
18012,ElliotBayTrailMyrtlePark,01/21/2016 12:00:00 PM,48,-122,4,1,5
18013,ElliotBayTrailMyrtlePark,01/21/2016 01:00:00 PM,48,-122,1,3,4
18014,ElliotBayTrailMyrtlePark,01/21/2016 02:00:00 PM,48,-122,5,4,9
18015,ElliotBayTrailMyrtlePark,01/21/2016 03:00:00 PM,48,-122,6,9,15
18016,ElliotBayTrailMyrtlePark,01/21/2016 04:00:00 PM,48,-122,9,21,30
18017,ElliotBayTrailMyrtlePark,01/21/2016 05:00:00 PM,48,-122,62,20,82
18018,ElliotBayTrailMyrtlePark,01/21/2016 06:00:00 PM,48,-122,70,10,80
18019,ElliotBayTrailMyrtlePark,01/21/2016 07:00:00 PM,48,-122,18,2,20
18020,ElliotBayTrailMyrtlePark,01/21/2016 08:00:00 PM,48,-122,6,0,6
18021,ElliotBayTrailMyrtlePark,01/21/2016 09:00:00 PM,48,-122,3,0,3
18022,ElliotBayTrailMyrtlePark,01/21/2016 10:00:00 PM,48,-122,0,1,1
18023,ElliotBayTrailMyrtlePark,01/21/2016 11:00:00 PM,48,-122,1,1,2
18024,ElliotBayTrailMyrtlePark,01/22/2016 12:00:00 AM,48,-122,0,0,0
18025,ElliotBayTrailMyrtlePark,01/22/2016 01:00:00 AM,48,-122,1,0,1
18026,ElliotBayTrailMyrtlePark,01/22/2016 02:00:00 AM,48,-122,1,0,1
18027,ElliotBayTrailMyrtlePark,01/22/2016 03:00:00 AM,48,-122,1,1,2
18028,ElliotBayTrailMyrtlePark,01/22/2016 04:00:00 AM,48,-122,0,0,0
18029,ElliotBayTrailMyrtlePark,01/22/2016 05:00:00 AM,48,-122,5,5,10
18030,ElliotBayTrailMyrtlePark,01/22/2016 06:00:00 AM,48,-122,11,11,22
18031,ElliotBayTrailMyrtlePark,01/22/2016 07:00:00 AM,48,-122,12,18,30
18032,ElliotBayTrailMyrtlePark,01/22/2016 08:00:00 AM,48,-122,19,84,103
18033,ElliotBayTrailMyrtlePark,01/22/2016 09:00:00 AM,48,-122,15,57,72
18034,ElliotBayTrailMyrtlePark,01/22/2016 10:00:00 AM,48,-122,8,22,30
18035,ElliotBayTrailMyrtlePark,01/22/2016 11:00:00 AM,48,-122,11,13,24
18036,ElliotBayTrailMyrtlePark,01/22/2016 12:00:00 PM,48,-122,11,15,26
18037,ElliotBayTrailMyrtlePark,01/22/2016 01:00:00 PM,48,-122,11,12,23
18038,ElliotBayTrailMyrtlePark,01/22/2016 02:00:00 PM,48,-122,23,14,37
18039,ElliotBayTrailMyrtlePark,01/22/2016 03:00:00 PM,48,-122,23,29,52
18040,ElliotBayTrailMyrtlePark,01/22/2016 04:00:00 PM,48,-122,40,28,68
18041,ElliotBayTrailMyrtlePark,01/22/2016 05:00:00 PM,48,-122,92,35,127
18042,ElliotBayTrailMyrtlePark,01/22/2016 06:00:00 PM,48,-122,82,17,99
18043,ElliotBayTrailMyrtlePark,01/22/2016 07:00:00 PM,48,-122,27,4,31
18044,ElliotBayTrailMyrtlePark,01/22/2016 08:00:00 PM,48,-122,10,5,15
18045,ElliotBayTrailMyrtlePark,01/22/2016 09:00:00 PM,48,-122,6,3,9
18046,ElliotBayTrailMyrtlePark,01/22/2016 10:00:00 PM,48,-122,7,3,10
18047,ElliotBayTrailMyrtlePark,01/22/2016 11:00:00 PM,48,-122,6,3,9
18048,ElliotBayTrailMyrtlePark,01/23/2016 12:00:00 AM,48,-122,3,1,4
18049,ElliotBayTrailMyrtlePark,01/23/2016 01:00:00 AM,48,-122,0,1,1
18050,ElliotBayTrailMyrtlePark,01/23/2016 02:00:00 AM,48,-122,2,1,3
18051,ElliotBayTrailMyrtlePark,01/23/2016 03:00:00 AM,48,-122,1,0,1
18052,ElliotBayTrailMyrtlePark,01/23/2016 04:00:00 AM,48,-122,0,0,0
18053,ElliotBayTrailMyrtlePark,01/23/2016 05:00:00 AM,48,-122,1,2,3
18054,ElliotBayTrailMyrtlePark,01/23/2016 06:00:00 AM,48,-122,0,3,3
18055,ElliotBayTrailMyrtlePark,01/23/2016 07:00:00 AM,48,-122,0,1,1
18056,ElliotBayTrailMyrtlePark,01/23/2016 08:00:00 AM,48,-122,3,1,4
18057,ElliotBayTrailMyrtlePark,01/23/2016 09:00:00 AM,48,-122,4,7,11
18058,ElliotBayTrailMyrtlePark,01/23/2016 10:00:00 AM,48,-122,1,2,3
18059,ElliotBayTrailMyrtlePark,01/23/2016 11:00:00 AM,48,-122,4,5,9
18060,ElliotBayTrailMyrtlePark,01/23/2016 12:00:00 PM,48,-122,3,3,6
18061,ElliotBayTrailMyrtlePark,01/23/2016 01:00:00 PM,48,-122,11,2,13
18062,ElliotBayTrailMyrtlePark,01/23/2016 02:00:00 PM,48,-122,7,11,18
18063,ElliotBayTrailMyrtlePark,01/23/2016 03:00:00 PM,48,-122,7,4,11
18064,ElliotBayTrailMyrtlePark,01/23/2016 04:00:00 PM,48,-122,6,5,11
18065,ElliotBayTrailMyrtlePark,01/23/2016 05:00:00 PM,48,-122,2,1,3
18066,ElliotBayTrailMyrtlePark,01/23/2016 06:00:00 PM,48,-122,9,9,18
18067,ElliotBayTrailMyrtlePark,01/23/2016 07:00:00 PM,48,-122,6,8,14
18068,ElliotBayTrailMyrtlePark,01/23/2016 08:00:00 PM,48,-122,1,0,1
18069,ElliotBayTrailMyrtlePark,01/23/2016 09:00:00 PM,48,-122,4,2,6
18070,ElliotBayTrailMyrtlePark,01/23/2016 10:00:00 PM,48,-122,0,0,0
18071,ElliotBayTrailMyrtlePark,01/23/2016 11:00:00 PM,48,-122,0,1,1
18072,ElliotBayTrailMyrtlePark,01/24/2016 12:00:00 AM,48,-122,1,0,1
18073,ElliotBayTrailMyrtlePark,01/24/2016 01:00:00 AM,48,-122,0,0,0
18074,ElliotBayTrailMyrtlePark,01/24/2016 02:00:00 AM,48,-122,0,0,0
18075,ElliotBayTrailMyrtlePark,01/24/2016 03:00:00 AM,48,-122,0,0,0
18076,ElliotBayTrailMyrtlePark,01/24/2016 04:00:00 AM,48,-122,0,0,0
18077,ElliotBayTrailMyrtlePark,01/24/2016 05:00:00 AM,48,-122,0,1,1
18078,ElliotBayTrailMyrtlePark,01/24/2016 06:00:00 AM,48,-122,0,1,1
18079,ElliotBayTrailMyrtlePark,01/24/2016 07:00:00 AM,48,-122,0,3,3
18080,ElliotBayTrailMyrtlePark,01/24/2016 08:00:00 AM,48,-122,9,7,16
18081,ElliotBayTrailMyrtlePark,01/24/2016 09:00:00 AM,48,-122,16,14,30
18082,ElliotBayTrailMyrtlePark,01/24/2016 10:00:00 AM,48,-122,28,21,49
18083,ElliotBayTrailMyrtlePark,01/24/2016 11:00:00 AM,48,-122,49,48,97
18084,ElliotBayTrailMyrtlePark,01/24/2016 12:00:00 PM,48,-122,37,36,73
18085,ElliotBayTrailMyrtlePark,01/24/2016 01:00:00 PM,48,-122,32,50,82
18086,ElliotBayTrailMyrtlePark,01/24/2016 02:00:00 PM,48,-122,62,50,112
18087,ElliotBayTrailMyrtlePark,01/24/2016 03:00:00 PM,48,-122,67,49,116
18088,ElliotBayTrailMyrtlePark,01/24/2016 04:00:00 PM,48,-122,35,28,63
18089,ElliotBayTrailMyrtlePark,01/24/2016 05:00:00 PM,48,-122,16,16,32
18090,ElliotBayTrailMyrtlePark,01/24/2016 06:00:00 PM,48,-122,10,6,16
18091,ElliotBayTrailMyrtlePark,01/24/2016 07:00:00 PM,48,-122,1,2,3
18092,ElliotBayTrailMyrtlePark,01/24/2016 08:00:00 PM,48,-122,1,0,1
18093,ElliotBayTrailMyrtlePark,01/24/2016 09:00:00 PM,48,-122,3,1,4
18094,ElliotBayTrailMyrtlePark,01/24/2016 10:00:00 PM,48,-122,0,4,4
18095,ElliotBayTrailMyrtlePark,01/24/2016 11:00:00 PM,48,-122,2,0,2
18096,ElliotBayTrailMyrtlePark,01/25/2016 12:00:00 AM,48,-122,3,2,5
18097,ElliotBayTrailMyrtlePark,01/25/2016 01:00:00 AM,48,-122,1,0,1
18098,ElliotBayTrailMyrtlePark,01/25/2016 02:00:00 AM,48,-122,0,0,0
18099,ElliotBayTrailMyrtlePark,01/25/2016 03:00:00 AM,48,-122,1,0,1
18100,ElliotBayTrailMyrtlePark,01/25/2016 04:00:00 AM,48,-122,1,0,1
18101,ElliotBayTrailMyrtlePark,01/25/2016 05:00:00 AM,48,-122,7,4,11
18102,ElliotBayTrailMyrtlePark,01/25/2016 06:00:00 AM,48,-122,8,18,26
18103,ElliotBayTrailMyrtlePark,01/25/2016 07:00:00 AM,48,-122,19,45,64
18104,ElliotBayTrailMyrtlePark,01/25/2016 08:00:00 AM,48,-122,33,129,162
18105,ElliotBayTrailMyrtlePark,01/25/2016 09:00:00 AM,48,-122,26,84,110
18106,ElliotBayTrailMyrtlePark,01/25/2016 10:00:00 AM,48,-122,15,23,38
18107,ElliotBayTrailMyrtlePark,01/25/2016 11:00:00 AM,48,-122,8,16,24
18108,ElliotBayTrailMyrtlePark,01/25/2016 12:00:00 PM,48,-122,13,16,29
18109,ElliotBayTrailMyrtlePark,01/25/2016 01:00:00 PM,48,-122,16,23,39
18110,ElliotBayTrailMyrtlePark,01/25/2016 02:00:00 PM,48,-122,21,26,47
18111,ElliotBayTrailMyrtlePark,01/25/2016 03:00:00 PM,48,-122,18,26,44
18112,ElliotBayTrailMyrtlePark,01/25/2016 04:00:00 PM,48,-122,45,37,82
18113,ElliotBayTrailMyrtlePark,01/25/2016 05:00:00 PM,48,-122,148,46,194
18114,ElliotBayTrailMyrtlePark,01/25/2016 06:00:00 PM,48,-122,114,13,127
18115,ElliotBayTrailMyrtlePark,01/25/2016 07:00:00 PM,48,-122,30,7,37
18116,ElliotBayTrailMyrtlePark,01/25/2016 08:00:00 PM,48,-122,9,2,11
18117,ElliotBayTrailMyrtlePark,01/25/2016 09:00:00 PM,48,-122,6,2,8
18118,ElliotBayTrailMyrtlePark,01/25/2016 10:00:00 PM,48,-122,1,3,4
18119,ElliotBayTrailMyrtlePark,01/25/2016 11:00:00 PM,48,-122,1,1,2
18120,ElliotBayTrailMyrtlePark,01/26/2016 12:00:00 AM,48,-122,1,0,1
18121,ElliotBayTrailMyrtlePark,01/26/2016 01:00:00 AM,48,-122,2,1,3
18122,ElliotBayTrailMyrtlePark,01/26/2016 02:00:00 AM,48,-122,1,0,1
18123,ElliotBayTrailMyrtlePark,01/26/2016 03:00:00 AM,48,-122,2,0,2
18124,ElliotBayTrailMyrtlePark,01/26/2016 04:00:00 AM,48,-122,0,2,2
18125,ElliotBayTrailMyrtlePark,01/26/2016 05:00:00 AM,48,-122,4,4,8
18126,ElliotBayTrailMyrtlePark,01/26/2016 06:00:00 AM,48,-122,12,18,30
18127,ElliotBayTrailMyrtlePark,01/26/2016 07:00:00 AM,48,-122,16,40,56
18128,ElliotBayTrailMyrtlePark,01/26/2016 08:00:00 AM,48,-122,15,86,101
18129,ElliotBayTrailMyrtlePark,01/26/2016 09:00:00 AM,48,-122,24,52,76
18130,ElliotBayTrailMyrtlePark,01/26/2016 10:00:00 AM,48,-122,7,11,18
18131,ElliotBayTrailMyrtlePark,01/26/2016 11:00:00 AM,48,-122,3,8,11
18132,ElliotBayTrailMyrtlePark,01/26/2016 12:00:00 PM,48,-122,7,3,10
18133,ElliotBayTrailMyrtlePark,01/26/2016 01:00:00 PM,48,-122,6,4,10
18134,ElliotBayTrailMyrtlePark,01/26/2016 02:00:00 PM,48,-122,9,12,21
18135,ElliotBayTrailMyrtlePark,01/26/2016 03:00:00 PM,48,-122,13,16,29
18136,ElliotBayTrailMyrtlePark,01/26/2016 04:00:00 PM,48,-122,28,18,46
18137,ElliotBayTrailMyrtlePark,01/26/2016 05:00:00 PM,48,-122,96,29,125
18138,ElliotBayTrailMyrtlePark,01/26/2016 06:00:00 PM,48,-122,85,11,96
18139,ElliotBayTrailMyrtlePark,01/26/2016 07:00:00 PM,48,-122,37,5,42
18140,ElliotBayTrailMyrtlePark,01/26/2016 08:00:00 PM,48,-122,9,0,9
18141,ElliotBayTrailMyrtlePark,01/26/2016 09:00:00 PM,48,-122,5,1,6
18142,ElliotBayTrailMyrtlePark,01/26/2016 10:00:00 PM,48,-122,5,1,6
18143,ElliotBayTrailMyrtlePark,01/26/2016 11:00:00 PM,48,-122,0,0,0
18144,ElliotBayTrailMyrtlePark,01/27/2016 12:00:00 AM,48,-122,0,1,1
18145,ElliotBayTrailMyrtlePark,01/27/2016 01:00:00 AM,48,-122,1,0,1
18146,ElliotBayTrailMyrtlePark,01/27/2016 02:00:00 AM,48,-122,1,0,1
18147,ElliotBayTrailMyrtlePark,01/27/2016 03:00:00 AM,48,-122,1,0,1
18148,ElliotBayTrailMyrtlePark,01/27/2016 04:00:00 AM,48,-122,0,0,0
18149,ElliotBayTrailMyrtlePark,01/27/2016 05:00:00 AM,48,-122,6,6,12
18150,ElliotBayTrailMyrtlePark,01/27/2016 06:00:00 AM,48,-122,10,14,24
18151,ElliotBayTrailMyrtlePark,01/27/2016 07:00:00 AM,48,-122,9,34,43
18152,ElliotBayTrailMyrtlePark,01/27/2016 08:00:00 AM,48,-122,27,87,114
18153,ElliotBayTrailMyrtlePark,01/27/2016 09:00:00 AM,48,-122,21,66,87
18154,ElliotBayTrailMyrtlePark,01/27/2016 10:00:00 AM,48,-122,12,25,37
18155,ElliotBayTrailMyrtlePark,01/27/2016 11:00:00 AM,48,-122,12,11,23
18156,ElliotBayTrailMyrtlePark,01/27/2016 12:00:00 PM,48,-122,12,6,18
18157,ElliotBayTrailMyrtlePark,01/27/2016 01:00:00 PM,48,-122,17,14,31
18158,ElliotBayTrailMyrtlePark,01/27/2016 02:00:00 PM,48,-122,12,11,23
18159,ElliotBayTrailMyrtlePark,01/27/2016 03:00:00 PM,48,-122,17,14,31
18160,ElliotBayTrailMyrtlePark,01/27/2016 04:00:00 PM,48,-122,37,16,53
18161,ElliotBayTrailMyrtlePark,01/27/2016 05:00:00 PM,48,-122,91,29,120
18162,ElliotBayTrailMyrtlePark,01/27/2016 06:00:00 PM,48,-122,73,9,82
18163,ElliotBayTrailMyrtlePark,01/27/2016 07:00:00 PM,48,-122,27,5,32
18164,ElliotBayTrailMyrtlePark,01/27/2016 08:00:00 PM,48,-122,7,1,8
18165,ElliotBayTrailMyrtlePark,01/27/2016 09:00:00 PM,48,-122,5,3,8
18166,ElliotBayTrailMyrtlePark,01/27/2016 10:00:00 PM,48,-122,2,0,2
18167,ElliotBayTrailMyrtlePark,01/27/2016 11:00:00 PM,48,-122,0,0,0
18168,ElliotBayTrailMyrtlePark,01/28/2016 12:00:00 AM,48,-122,2,1,3
18169,ElliotBayTrailMyrtlePark,01/28/2016 01:00:00 AM,48,-122,0,0,0
18170,ElliotBayTrailMyrtlePark,01/28/2016 02:00:00 AM,48,-122,0,0,0
18171,ElliotBayTrailMyrtlePark,01/28/2016 03:00:00 AM,48,-122,1,0,1
18172,ElliotBayTrailMyrtlePark,01/28/2016 04:00:00 AM,48,-122,0,0,0
18173,ElliotBayTrailMyrtlePark,01/28/2016 05:00:00 AM,48,-122,2,0,2
18174,ElliotBayTrailMyrtlePark,01/28/2016 06:00:00 AM,48,-122,8,9,17
18175,ElliotBayTrailMyrtlePark,01/28/2016 07:00:00 AM,48,-122,12,10,22
18176,ElliotBayTrailMyrtlePark,01/28/2016 08:00:00 AM,48,-122,21,67,88
18177,ElliotBayTrailMyrtlePark,01/28/2016 09:00:00 AM,48,-122,13,46,59
18178,ElliotBayTrailMyrtlePark,01/28/2016 10:00:00 AM,48,-122,9,13,22
18179,ElliotBayTrailMyrtlePark,01/28/2016 11:00:00 AM,48,-122,7,13,20
18180,ElliotBayTrailMyrtlePark,01/28/2016 12:00:00 PM,48,-122,7,5,12
18181,ElliotBayTrailMyrtlePark,01/28/2016 01:00:00 PM,48,-122,6,12,18
18182,ElliotBayTrailMyrtlePark,01/28/2016 02:00:00 PM,48,-122,16,15,31
18183,ElliotBayTrailMyrtlePark,01/28/2016 03:00:00 PM,48,-122,11,17,28
18184,ElliotBayTrailMyrtlePark,01/28/2016 04:00:00 PM,48,-122,41,19,60
18185,ElliotBayTrailMyrtlePark,01/28/2016 05:00:00 PM,48,-122,83,42,125
18186,ElliotBayTrailMyrtlePark,01/28/2016 06:00:00 PM,48,-122,73,24,97
18187,ElliotBayTrailMyrtlePark,01/28/2016 07:00:00 PM,48,-122,30,7,37
18188,ElliotBayTrailMyrtlePark,01/28/2016 08:00:00 PM,48,-122,12,1,13
18189,ElliotBayTrailMyrtlePark,01/28/2016 09:00:00 PM,48,-122,9,9,18
18190,ElliotBayTrailMyrtlePark,01/28/2016 10:00:00 PM,48,-122,2,2,4
18191,ElliotBayTrailMyrtlePark,01/28/2016 11:00:00 PM,48,-122,3,2,5
18192,ElliotBayTrailMyrtlePark,01/29/2016 12:00:00 AM,48,-122,0,4,4
18193,ElliotBayTrailMyrtlePark,01/29/2016 01:00:00 AM,48,-122,1,0,1
18194,ElliotBayTrailMyrtlePark,01/29/2016 02:00:00 AM,48,-122,1,2,3
18195,ElliotBayTrailMyrtlePark,01/29/2016 03:00:00 AM,48,-122,1,0,1
18196,ElliotBayTrailMyrtlePark,01/29/2016 04:00:00 AM,48,-122,1,0,1
18197,ElliotBayTrailMyrtlePark,01/29/2016 05:00:00 AM,48,-122,4,6,10
18198,ElliotBayTrailMyrtlePark,01/29/2016 06:00:00 AM,48,-122,4,14,18
18199,ElliotBayTrailMyrtlePark,01/29/2016 07:00:00 AM,48,-122,14,21,35
18200,ElliotBayTrailMyrtlePark,01/29/2016 08:00:00 AM,48,-122,22,77,99
18201,ElliotBayTrailMyrtlePark,01/29/2016 09:00:00 AM,48,-122,18,42,60
18202,ElliotBayTrailMyrtlePark,01/29/2016 10:00:00 AM,48,-122,3,15,18
18203,ElliotBayTrailMyrtlePark,01/29/2016 11:00:00 AM,48,-122,5,10,15
18204,ElliotBayTrailMyrtlePark,01/29/2016 12:00:00 PM,48,-122,6,5,11
18205,ElliotBayTrailMyrtlePark,01/29/2016 01:00:00 PM,48,-122,5,5,10
18206,ElliotBayTrailMyrtlePark,01/29/2016 02:00:00 PM,48,-122,18,18,36
18207,ElliotBayTrailMyrtlePark,01/29/2016 03:00:00 PM,48,-122,23,18,41
18208,ElliotBayTrailMyrtlePark,01/29/2016 04:00:00 PM,48,-122,46,26,72
18209,ElliotBayTrailMyrtlePark,01/29/2016 05:00:00 PM,48,-122,85,42,127
18210,ElliotBayTrailMyrtlePark,01/29/2016 06:00:00 PM,48,-122,65,11,76
18211,ElliotBayTrailMyrtlePark,01/29/2016 07:00:00 PM,48,-122,27,2,29
18212,ElliotBayTrailMyrtlePark,01/29/2016 08:00:00 PM,48,-122,7,1,8
18213,ElliotBayTrailMyrtlePark,01/29/2016 09:00:00 PM,48,-122,2,2,4
18214,ElliotBayTrailMyrtlePark,01/29/2016 10:00:00 PM,48,-122,3,4,7
18215,ElliotBayTrailMyrtlePark,01/29/2016 11:00:00 PM,48,-122,1,0,1
18216,ElliotBayTrailMyrtlePark,01/30/2016 12:00:00 AM,48,-122,0,0,0
18217,ElliotBayTrailMyrtlePark,01/30/2016 01:00:00 AM,48,-122,2,1,3
18218,ElliotBayTrailMyrtlePark,01/30/2016 02:00:00 AM,48,-122,0,0,0
18219,ElliotBayTrailMyrtlePark,01/30/2016 03:00:00 AM,48,-122,3,0,3
18220,ElliotBayTrailMyrtlePark,01/30/2016 04:00:00 AM,48,-122,0,2,2
18221,ElliotBayTrailMyrtlePark,01/30/2016 05:00:00 AM,48,-122,0,1,1
18222,ElliotBayTrailMyrtlePark,01/30/2016 06:00:00 AM,48,-122,1,4,5
18223,ElliotBayTrailMyrtlePark,01/30/2016 07:00:00 AM,48,-122,0,2,2
18224,ElliotBayTrailMyrtlePark,01/30/2016 08:00:00 AM,48,-122,4,3,7
18225,ElliotBayTrailMyrtlePark,01/30/2016 09:00:00 AM,48,-122,5,7,12
18226,ElliotBayTrailMyrtlePark,01/30/2016 10:00:00 AM,48,-122,9,12,21
18227,ElliotBayTrailMyrtlePark,01/30/2016 11:00:00 AM,48,-122,11,13,24
18228,ElliotBayTrailMyrtlePark,01/30/2016 12:00:00 PM,48,-122,27,16,43
18229,ElliotBayTrailMyrtlePark,01/30/2016 01:00:00 PM,48,-122,30,24,54
18230,ElliotBayTrailMyrtlePark,01/30/2016 02:00:00 PM,48,-122,33,23,56
18231,ElliotBayTrailMyrtlePark,01/30/2016 03:00:00 PM,48,-122,24,18,42
18232,ElliotBayTrailMyrtlePark,01/30/2016 04:00:00 PM,48,-122,23,27,50
18233,ElliotBayTrailMyrtlePark,01/30/2016 05:00:00 PM,48,-122,19,12,31
18234,ElliotBayTrailMyrtlePark,01/30/2016 06:00:00 PM,48,-122,8,7,15
18235,ElliotBayTrailMyrtlePark,01/30/2016 07:00:00 PM,48,-122,3,3,6
18236,ElliotBayTrailMyrtlePark,01/30/2016 08:00:00 PM,48,-122,4,2,6
18237,ElliotBayTrailMyrtlePark,01/30/2016 09:00:00 PM,48,-122,1,1,2
18238,ElliotBayTrailMyrtlePark,01/30/2016 10:00:00 PM,48,-122,0,1,1
18239,ElliotBayTrailMyrtlePark,01/30/2016 11:00:00 PM,48,-122,8,2,10
18240,ElliotBayTrailMyrtlePark,01/31/2016 12:00:00 AM,48,-122,1,3,4
18241,ElliotBayTrailMyrtlePark,01/31/2016 01:00:00 AM,48,-122,1,1,2
18242,ElliotBayTrailMyrtlePark,01/31/2016 02:00:00 AM,48,-122,3,0,3
18243,ElliotBayTrailMyrtlePark,01/31/2016 03:00:00 AM,48,-122,1,1,2
18244,ElliotBayTrailMyrtlePark,01/31/2016 04:00:00 AM,48,-122,1,0,1
18245,ElliotBayTrailMyrtlePark,01/31/2016 05:00:00 AM,48,-122,0,2,2
18246,ElliotBayTrailMyrtlePark,01/31/2016 06:00:00 AM,48,-122,0,1,1
18247,ElliotBayTrailMyrtlePark,01/31/2016 07:00:00 AM,48,-122,3,2,5
18248,ElliotBayTrailMyrtlePark,01/31/2016 08:00:00 AM,48,-122,2,10,12
18249,ElliotBayTrailMyrtlePark,01/31/2016 09:00:00 AM,48,-122,14,7,21
18250,ElliotBayTrailMyrtlePark,01/31/2016 10:00:00 AM,48,-122,15,26,41
18251,ElliotBayTrailMyrtlePark,01/31/2016 11:00:00 AM,48,-122,15,10,25
18252,ElliotBayTrailMyrtlePark,01/31/2016 12:00:00 PM,48,-122,16,23,39
18253,ElliotBayTrailMyrtlePark,01/31/2016 01:00:00 PM,48,-122,18,20,38
18254,ElliotBayTrailMyrtlePark,01/31/2016 02:00:00 PM,48,-122,16,18,34
18255,ElliotBayTrailMyrtlePark,01/31/2016 03:00:00 PM,48,-122,22,13,35
18256,ElliotBayTrailMyrtlePark,01/31/2016 04:00:00 PM,48,-122,11,10,21
18257,ElliotBayTrailMyrtlePark,01/31/2016 05:00:00 PM,48,-122,13,13,26
18258,ElliotBayTrailMyrtlePark,01/31/2016 06:00:00 PM,48,-122,9,6,15
18259,ElliotBayTrailMyrtlePark,01/31/2016 07:00:00 PM,48,-122,1,2,3
18260,ElliotBayTrailMyrtlePark,01/31/2016 08:00:00 PM,48,-122,0,2,2
18261,ElliotBayTrailMyrtlePark,01/31/2016 09:00:00 PM,48,-122,3,1,4
18262,ElliotBayTrailMyrtlePark,01/31/2016 10:00:00 PM,48,-122,0,0,0
18263,ElliotBayTrailMyrtlePark,01/31/2016 11:00:00 PM,48,-122,0,0,0
18264,ElliotBayTrailMyrtlePark,02/01/2016 12:00:00 AM,48,-122,0,0,0
18265,ElliotBayTrailMyrtlePark,02/01/2016 01:00:00 AM,48,-122,0,0,0
18266,ElliotBayTrailMyrtlePark,02/01/2016 02:00:00 AM,48,-122,1,0,1
18267,ElliotBayTrailMyrtlePark,02/01/2016 03:00:00 AM,48,-122,1,0,1
18268,ElliotBayTrailMyrtlePark,02/01/2016 04:00:00 AM,48,-122,0,0,0
18269,ElliotBayTrailMyrtlePark,02/01/2016 05:00:00 AM,48,-122,5,4,9
18270,ElliotBayTrailMyrtlePark,02/01/2016 06:00:00 AM,48,-122,10,25,35
18271,ElliotBayTrailMyrtlePark,02/01/2016 07:00:00 AM,48,-122,21,38,59
18272,ElliotBayTrailMyrtlePark,02/01/2016 08:00:00 AM,48,-122,28,111,139
18273,ElliotBayTrailMyrtlePark,02/01/2016 09:00:00 AM,48,-122,29,79,108
18274,ElliotBayTrailMyrtlePark,02/01/2016 10:00:00 AM,48,-122,11,23,34
18275,ElliotBayTrailMyrtlePark,02/01/2016 11:00:00 AM,48,-122,9,17,26
18276,ElliotBayTrailMyrtlePark,02/01/2016 12:00:00 PM,48,-122,10,11,21
18277,ElliotBayTrailMyrtlePark,02/01/2016 01:00:00 PM,48,-122,9,11,20
18278,ElliotBayTrailMyrtlePark,02/01/2016 02:00:00 PM,48,-122,16,19,35
18279,ElliotBayTrailMyrtlePark,02/01/2016 03:00:00 PM,48,-122,10,18,28
18280,ElliotBayTrailMyrtlePark,02/01/2016 04:00:00 PM,48,-122,51,27,78
18281,ElliotBayTrailMyrtlePark,02/01/2016 05:00:00 PM,48,-122,112,43,155
18282,ElliotBayTrailMyrtlePark,02/01/2016 06:00:00 PM,48,-122,134,20,154
18283,ElliotBayTrailMyrtlePark,02/01/2016 07:00:00 PM,48,-122,29,6,35
18284,ElliotBayTrailMyrtlePark,02/01/2016 08:00:00 PM,48,-122,6,2,8
18285,ElliotBayTrailMyrtlePark,02/01/2016 09:00:00 PM,48,-122,7,3,10
18286,ElliotBayTrailMyrtlePark,02/01/2016 10:00:00 PM,48,-122,1,1,2
18287,ElliotBayTrailMyrtlePark,02/01/2016 11:00:00 PM,48,-122,1,0,1
18288,ElliotBayTrailMyrtlePark,02/02/2016 12:00:00 AM,48,-122,1,0,1
18289,ElliotBayTrailMyrtlePark,02/02/2016 01:00:00 AM,48,-122,0,0,0
18290,ElliotBayTrailMyrtlePark,02/02/2016 02:00:00 AM,48,-122,0,0,0
18291,ElliotBayTrailMyrtlePark,02/02/2016 03:00:00 AM,48,-122,2,0,2
18292,ElliotBayTrailMyrtlePark,02/02/2016 04:00:00 AM,48,-122,0,0,0
18293,ElliotBayTrailMyrtlePark,02/02/2016 05:00:00 AM,48,-122,4,3,7
18294,ElliotBayTrailMyrtlePark,02/02/2016 06:00:00 AM,48,-122,10,20,30
18295,ElliotBayTrailMyrtlePark,02/02/2016 07:00:00 AM,48,-122,24,47,71
18296,ElliotBayTrailMyrtlePark,02/02/2016 08:00:00 AM,48,-122,28,141,169
18297,ElliotBayTrailMyrtlePark,02/02/2016 09:00:00 AM,48,-122,33,71,104
18298,ElliotBayTrailMyrtlePark,02/02/2016 10:00:00 AM,48,-122,6,33,39
18299,ElliotBayTrailMyrtlePark,02/02/2016 11:00:00 AM,48,-122,23,16,39
18300,ElliotBayTrailMyrtlePark,02/02/2016 12:00:00 PM,48,-122,21,16,37
18301,ElliotBayTrailMyrtlePark,02/02/2016 01:00:00 PM,48,-122,20,25,45
18302,ElliotBayTrailMyrtlePark,02/02/2016 02:00:00 PM,48,-122,21,22,43
18303,ElliotBayTrailMyrtlePark,02/02/2016 03:00:00 PM,48,-122,24,30,54
18304,ElliotBayTrailMyrtlePark,02/02/2016 04:00:00 PM,48,-122,64,62,126
18305,ElliotBayTrailMyrtlePark,02/02/2016 05:00:00 PM,48,-122,127,68,195
18306,ElliotBayTrailMyrtlePark,02/02/2016 06:00:00 PM,48,-122,121,23,144
18307,ElliotBayTrailMyrtlePark,02/02/2016 07:00:00 PM,48,-122,37,7,44
18308,ElliotBayTrailMyrtlePark,02/02/2016 08:00:00 PM,48,-122,13,4,17
18309,ElliotBayTrailMyrtlePark,02/02/2016 09:00:00 PM,48,-122,13,0,13
18310,ElliotBayTrailMyrtlePark,02/02/2016 10:00:00 PM,48,-122,3,5,8
18311,ElliotBayTrailMyrtlePark,02/02/2016 11:00:00 PM,48,-122,0,2,2
18312,ElliotBayTrailMyrtlePark,02/03/2016 12:00:00 AM,48,-122,3,1,4
18313,ElliotBayTrailMyrtlePark,02/03/2016 01:00:00 AM,48,-122,1,1,2
18314,ElliotBayTrailMyrtlePark,02/03/2016 02:00:00 AM,48,-122,0,0,0
18315,ElliotBayTrailMyrtlePark,02/03/2016 03:00:00 AM,48,-122,1,0,1
18316,ElliotBayTrailMyrtlePark,02/03/2016 04:00:00 AM,48,-122,0,0,0
18317,ElliotBayTrailMyrtlePark,02/03/2016 05:00:00 AM,48,-122,2,6,8
18318,ElliotBayTrailMyrtlePark,02/03/2016 06:00:00 AM,48,-122,12,19,31
18319,ElliotBayTrailMyrtlePark,02/03/2016 07:00:00 AM,48,-122,18,31,49
18320,ElliotBayTrailMyrtlePark,02/03/2016 08:00:00 AM,48,-122,29,96,125
18321,ElliotBayTrailMyrtlePark,02/03/2016 09:00:00 AM,48,-122,27,56,83
18322,ElliotBayTrailMyrtlePark,02/03/2016 10:00:00 AM,48,-122,11,23,34
18323,ElliotBayTrailMyrtlePark,02/03/2016 11:00:00 AM,48,-122,7,15,22
18324,ElliotBayTrailMyrtlePark,02/03/2016 12:00:00 PM,48,-122,2,8,10
18325,ElliotBayTrailMyrtlePark,02/03/2016 01:00:00 PM,48,-122,7,2,9
18326,ElliotBayTrailMyrtlePark,02/03/2016 02:00:00 PM,48,-122,7,6,13
18327,ElliotBayTrailMyrtlePark,02/03/2016 03:00:00 PM,48,-122,8,9,17
18328,ElliotBayTrailMyrtlePark,02/03/2016 04:00:00 PM,48,-122,24,21,45
18329,ElliotBayTrailMyrtlePark,02/03/2016 05:00:00 PM,48,-122,77,28,105
18330,ElliotBayTrailMyrtlePark,02/03/2016 06:00:00 PM,48,-122,81,13,94
18331,ElliotBayTrailMyrtlePark,02/03/2016 07:00:00 PM,48,-122,29,3,32
18332,ElliotBayTrailMyrtlePark,02/03/2016 08:00:00 PM,48,-122,2,0,2
18333,ElliotBayTrailMyrtlePark,02/03/2016 09:00:00 PM,48,-122,6,0,6
18334,ElliotBayTrailMyrtlePark,02/03/2016 10:00:00 PM,48,-122,3,1,4
18335,ElliotBayTrailMyrtlePark,02/03/2016 11:00:00 PM,48,-122,2,1,3
18336,ElliotBayTrailMyrtlePark,02/04/2016 12:00:00 AM,48,-122,0,0,0
18337,ElliotBayTrailMyrtlePark,02/04/2016 01:00:00 AM,48,-122,1,0,1
18338,ElliotBayTrailMyrtlePark,02/04/2016 02:00:00 AM,48,-122,1,0,1
18339,ElliotBayTrailMyrtlePark,02/04/2016 03:00:00 AM,48,-122,2,0,2
18340,ElliotBayTrailMyrtlePark,02/04/2016 04:00:00 AM,48,-122,0,1,1
18341,ElliotBayTrailMyrtlePark,02/04/2016 05:00:00 AM,48,-122,3,1,4
18342,ElliotBayTrailMyrtlePark,02/04/2016 06:00:00 AM,48,-122,11,18,29
18343,ElliotBayTrailMyrtlePark,02/04/2016 07:00:00 AM,48,-122,14,26,40
18344,ElliotBayTrailMyrtlePark,02/04/2016 08:00:00 AM,48,-122,21,95,116
18345,ElliotBayTrailMyrtlePark,02/04/2016 09:00:00 AM,48,-122,27,60,87
18346,ElliotBayTrailMyrtlePark,02/04/2016 10:00:00 AM,48,-122,7,30,37
18347,ElliotBayTrailMyrtlePark,02/04/2016 11:00:00 AM,48,-122,4,7,11
18348,ElliotBayTrailMyrtlePark,02/04/2016 12:00:00 PM,48,-122,10,8,18
18349,ElliotBayTrailMyrtlePark,02/04/2016 01:00:00 PM,48,-122,7,9,16
18350,ElliotBayTrailMyrtlePark,02/04/2016 02:00:00 PM,48,-122,9,12,21
18351,ElliotBayTrailMyrtlePark,02/04/2016 03:00:00 PM,48,-122,14,9,23
18352,ElliotBayTrailMyrtlePark,02/04/2016 04:00:00 PM,48,-122,39,19,58
18353,ElliotBayTrailMyrtlePark,02/04/2016 05:00:00 PM,48,-122,101,40,141
18354,ElliotBayTrailMyrtlePark,02/04/2016 06:00:00 PM,48,-122,84,21,105
18355,ElliotBayTrailMyrtlePark,02/04/2016 07:00:00 PM,48,-122,30,5,35
18356,ElliotBayTrailMyrtlePark,02/04/2016 08:00:00 PM,48,-122,3,2,5
18357,ElliotBayTrailMyrtlePark,02/04/2016 09:00:00 PM,48,-122,9,2,11
18358,ElliotBayTrailMyrtlePark,02/04/2016 10:00:00 PM,48,-122,9,4,13
18359,ElliotBayTrailMyrtlePark,02/04/2016 11:00:00 PM,48,-122,2,0,2
18360,ElliotBayTrailMyrtlePark,02/05/2016 12:00:00 AM,48,-122,0,0,0
18361,ElliotBayTrailMyrtlePark,02/05/2016 01:00:00 AM,48,-122,1,0,1
18362,ElliotBayTrailMyrtlePark,02/05/2016 02:00:00 AM,48,-122,2,0,2
18363,ElliotBayTrailMyrtlePark,02/05/2016 03:00:00 AM,48,-122,1,0,1
18364,ElliotBayTrailMyrtlePark,02/05/2016 04:00:00 AM,48,-122,0,0,0
18365,ElliotBayTrailMyrtlePark,02/05/2016 05:00:00 AM,48,-122,3,7,10
18366,ElliotBayTrailMyrtlePark,02/05/2016 06:00:00 AM,48,-122,8,10,18
18367,ElliotBayTrailMyrtlePark,02/05/2016 07:00:00 AM,48,-122,10,26,36
18368,ElliotBayTrailMyrtlePark,02/05/2016 08:00:00 AM,48,-122,26,96,122
18369,ElliotBayTrailMyrtlePark,02/05/2016 09:00:00 AM,48,-122,27,46,73
18370,ElliotBayTrailMyrtlePark,02/05/2016 10:00:00 AM,48,-122,18,19,37
18371,ElliotBayTrailMyrtlePark,02/05/2016 11:00:00 AM,48,-122,15,17,32
18372,ElliotBayTrailMyrtlePark,02/05/2016 12:00:00 PM,48,-122,12,13,25
18373,ElliotBayTrailMyrtlePark,02/05/2016 01:00:00 PM,48,-122,9,16,25
18374,ElliotBayTrailMyrtlePark,02/05/2016 02:00:00 PM,48,-122,13,9,22
18375,ElliotBayTrailMyrtlePark,02/05/2016 03:00:00 PM,48,-122,24,15,39
18376,ElliotBayTrailMyrtlePark,02/05/2016 04:00:00 PM,48,-122,42,27,69
18377,ElliotBayTrailMyrtlePark,02/05/2016 05:00:00 PM,48,-122,73,31,104
18378,ElliotBayTrailMyrtlePark,02/05/2016 06:00:00 PM,48,-122,56,4,60
18379,ElliotBayTrailMyrtlePark,02/05/2016 07:00:00 PM,48,-122,24,2,26
18380,ElliotBayTrailMyrtlePark,02/05/2016 08:00:00 PM,48,-122,4,2,6
18381,ElliotBayTrailMyrtlePark,02/05/2016 09:00:00 PM,48,-122,1,3,4
18382,ElliotBayTrailMyrtlePark,02/05/2016 10:00:00 PM,48,-122,2,3,5
18383,ElliotBayTrailMyrtlePark,02/05/2016 11:00:00 PM,48,-122,4,1,5
18384,ElliotBayTrailMyrtlePark,02/06/2016 12:00:00 AM,48,-122,1,0,1
18385,ElliotBayTrailMyrtlePark,02/06/2016 01:00:00 AM,48,-122,2,0,2
18386,ElliotBayTrailMyrtlePark,02/06/2016 02:00:00 AM,48,-122,1,0,1
18387,ElliotBayTrailMyrtlePark,02/06/2016 03:00:00 AM,48,-122,0,0,0
18388,ElliotBayTrailMyrtlePark,02/06/2016 04:00:00 AM,48,-122,0,0,0
18389,ElliotBayTrailMyrtlePark,02/06/2016 05:00:00 AM,48,-122,1,1,2
18390,ElliotBayTrailMyrtlePark,02/06/2016 06:00:00 AM,48,-122,0,2,2
18391,ElliotBayTrailMyrtlePark,02/06/2016 07:00:00 AM,48,-122,0,1,1
18392,ElliotBayTrailMyrtlePark,02/06/2016 08:00:00 AM,48,-122,9,8,17
18393,ElliotBayTrailMyrtlePark,02/06/2016 09:00:00 AM,48,-122,10,11,21
18394,ElliotBayTrailMyrtlePark,02/06/2016 10:00:00 AM,48,-122,20,9,29
18395,ElliotBayTrailMyrtlePark,02/06/2016 11:00:00 AM,48,-122,18,17,35
18396,ElliotBayTrailMyrtlePark,02/06/2016 12:00:00 PM,48,-122,21,25,46
18397,ElliotBayTrailMyrtlePark,02/06/2016 01:00:00 PM,48,-122,28,39,67
18398,ElliotBayTrailMyrtlePark,02/06/2016 02:00:00 PM,48,-122,26,17,43
18399,ElliotBayTrailMyrtlePark,02/06/2016 03:00:00 PM,48,-122,25,25,50
18400,ElliotBayTrailMyrtlePark,02/06/2016 04:00:00 PM,48,-122,35,15,50
18401,ElliotBayTrailMyrtlePark,02/06/2016 05:00:00 PM,48,-122,25,22,47
18402,ElliotBayTrailMyrtlePark,02/06/2016 06:00:00 PM,48,-122,19,26,45
18403,ElliotBayTrailMyrtlePark,02/06/2016 07:00:00 PM,48,-122,7,4,11
18404,ElliotBayTrailMyrtlePark,02/06/2016 08:00:00 PM,48,-122,4,2,6
18405,ElliotBayTrailMyrtlePark,02/06/2016 09:00:00 PM,48,-122,3,1,4
18406,ElliotBayTrailMyrtlePark,02/06/2016 10:00:00 PM,48,-122,0,3,3
18407,ElliotBayTrailMyrtlePark,02/06/2016 11:00:00 PM,48,-122,1,0,1
18408,ElliotBayTrailMyrtlePark,02/07/2016 12:00:00 AM,48,-122,0,2,2
18409,ElliotBayTrailMyrtlePark,02/07/2016 01:00:00 AM,48,-122,2,0,2
18410,ElliotBayTrailMyrtlePark,02/07/2016 02:00:00 AM,48,-122,0,0,0
18411,ElliotBayTrailMyrtlePark,02/07/2016 03:00:00 AM,48,-122,1,0,1
18412,ElliotBayTrailMyrtlePark,02/07/2016 04:00:00 AM,48,-122,1,0,1
18413,ElliotBayTrailMyrtlePark,02/07/2016 05:00:00 AM,48,-122,0,1,1
18414,ElliotBayTrailMyrtlePark,02/07/2016 06:00:00 AM,48,-122,0,0,0
18415,ElliotBayTrailMyrtlePark,02/07/2016 07:00:00 AM,48,-122,0,4,4
18416,ElliotBayTrailMyrtlePark,02/07/2016 08:00:00 AM,48,-122,7,9,16
18417,ElliotBayTrailMyrtlePark,02/07/2016 09:00:00 AM,48,-122,14,19,33
18418,ElliotBayTrailMyrtlePark,02/07/2016 10:00:00 AM,48,-122,23,18,41
18419,ElliotBayTrailMyrtlePark,02/07/2016 11:00:00 AM,48,-122,46,51,97
18420,ElliotBayTrailMyrtlePark,02/07/2016 12:00:00 PM,48,-122,33,41,74
18421,ElliotBayTrailMyrtlePark,02/07/2016 01:00:00 PM,48,-122,32,25,57
18422,ElliotBayTrailMyrtlePark,02/07/2016 02:00:00 PM,48,-122,34,43,77
18423,ElliotBayTrailMyrtlePark,02/07/2016 03:00:00 PM,48,-122,30,26,56
18424,ElliotBayTrailMyrtlePark,02/07/2016 04:00:00 PM,48,-122,28,19,47
18425,ElliotBayTrailMyrtlePark,02/07/2016 05:00:00 PM,48,-122,9,5,14
18426,ElliotBayTrailMyrtlePark,02/07/2016 06:00:00 PM,48,-122,8,2,10
18427,ElliotBayTrailMyrtlePark,02/07/2016 07:00:00 PM,48,-122,4,1,5
18428,ElliotBayTrailMyrtlePark,02/07/2016 08:00:00 PM,48,-122,4,1,5
18429,ElliotBayTrailMyrtlePark,02/07/2016 09:00:00 PM,48,-122,3,0,3
18430,ElliotBayTrailMyrtlePark,02/07/2016 10:00:00 PM,48,-122,3,1,4
18431,ElliotBayTrailMyrtlePark,02/07/2016 11:00:00 PM,48,-122,2,2,4
18432,ElliotBayTrailMyrtlePark,02/08/2016 12:00:00 AM,48,-122,0,0,0
18433,ElliotBayTrailMyrtlePark,02/08/2016 01:00:00 AM,48,-122,0,0,0
18434,ElliotBayTrailMyrtlePark,02/08/2016 02:00:00 AM,48,-122,0,0,0
18435,ElliotBayTrailMyrtlePark,02/08/2016 03:00:00 AM,48,-122,0,0,0
18436,ElliotBayTrailMyrtlePark,02/08/2016 04:00:00 AM,48,-122,1,0,1
18437,ElliotBayTrailMyrtlePark,02/08/2016 05:00:00 AM,48,-122,3,3,6
18438,ElliotBayTrailMyrtlePark,02/08/2016 06:00:00 AM,48,-122,6,16,22
18439,ElliotBayTrailMyrtlePark,02/08/2016 07:00:00 AM,48,-122,34,52,86
18440,ElliotBayTrailMyrtlePark,02/08/2016 08:00:00 AM,48,-122,31,144,175
18441,ElliotBayTrailMyrtlePark,02/08/2016 09:00:00 AM,48,-122,34,82,116
18442,ElliotBayTrailMyrtlePark,02/08/2016 10:00:00 AM,48,-122,11,26,37
18443,ElliotBayTrailMyrtlePark,02/08/2016 11:00:00 AM,48,-122,13,15,28
18444,ElliotBayTrailMyrtlePark,02/08/2016 12:00:00 PM,48,-122,20,23,43
18445,ElliotBayTrailMyrtlePark,02/08/2016 01:00:00 PM,48,-122,22,28,50
18446,ElliotBayTrailMyrtlePark,02/08/2016 02:00:00 PM,48,-122,27,32,59
18447,ElliotBayTrailMyrtlePark,02/08/2016 03:00:00 PM,48,-122,41,48,89
18448,ElliotBayTrailMyrtlePark,02/08/2016 04:00:00 PM,48,-122,68,57,125
18449,ElliotBayTrailMyrtlePark,02/08/2016 05:00:00 PM,48,-122,156,80,236
18450,ElliotBayTrailMyrtlePark,02/08/2016 06:00:00 PM,48,-122,133,45,178
18451,ElliotBayTrailMyrtlePark,02/08/2016 07:00:00 PM,48,-122,29,11,40
18452,ElliotBayTrailMyrtlePark,02/08/2016 08:00:00 PM,48,-122,8,1,9
18453,ElliotBayTrailMyrtlePark,02/08/2016 09:00:00 PM,48,-122,11,4,15
18454,ElliotBayTrailMyrtlePark,02/08/2016 10:00:00 PM,48,-122,2,3,5
18455,ElliotBayTrailMyrtlePark,02/08/2016 11:00:00 PM,48,-122,0,0,0
18456,ElliotBayTrailMyrtlePark,02/09/2016 12:00:00 AM,48,-122,2,0,2
18457,ElliotBayTrailMyrtlePark,02/09/2016 01:00:00 AM,48,-122,0,0,0
18458,ElliotBayTrailMyrtlePark,02/09/2016 02:00:00 AM,48,-122,0,0,0
18459,ElliotBayTrailMyrtlePark,02/09/2016 03:00:00 AM,48,-122,2,0,2
18460,ElliotBayTrailMyrtlePark,02/09/2016 04:00:00 AM,48,-122,0,0,0
18461,ElliotBayTrailMyrtlePark,02/09/2016 05:00:00 AM,48,-122,1,2,3
18462,ElliotBayTrailMyrtlePark,02/09/2016 06:00:00 AM,48,-122,10,20,30
18463,ElliotBayTrailMyrtlePark,02/09/2016 07:00:00 AM,48,-122,19,62,81
18464,ElliotBayTrailMyrtlePark,02/09/2016 08:00:00 AM,48,-122,27,147,174
18465,ElliotBayTrailMyrtlePark,02/09/2016 09:00:00 AM,48,-122,32,81,113
18466,ElliotBayTrailMyrtlePark,02/09/2016 10:00:00 AM,48,-122,13,18,31
18467,ElliotBayTrailMyrtlePark,02/09/2016 11:00:00 AM,48,-122,11,10,21
18468,ElliotBayTrailMyrtlePark,02/09/2016 12:00:00 PM,48,-122,16,13,29
18469,ElliotBayTrailMyrtlePark,02/09/2016 01:00:00 PM,48,-122,17,26,43
18470,ElliotBayTrailMyrtlePark,02/09/2016 02:00:00 PM,48,-122,32,33,65
18471,ElliotBayTrailMyrtlePark,02/09/2016 03:00:00 PM,48,-122,49,31,80
18472,ElliotBayTrailMyrtlePark,02/09/2016 04:00:00 PM,48,-122,91,49,140
18473,ElliotBayTrailMyrtlePark,02/09/2016 05:00:00 PM,48,-122,142,60,202
18474,ElliotBayTrailMyrtlePark,02/09/2016 06:00:00 PM,48,-122,136,32,168
18475,ElliotBayTrailMyrtlePark,02/09/2016 07:00:00 PM,48,-122,49,17,66
18476,ElliotBayTrailMyrtlePark,02/09/2016 08:00:00 PM,48,-122,13,6,19
18477,ElliotBayTrailMyrtlePark,02/09/2016 09:00:00 PM,48,-122,9,3,12
18478,ElliotBayTrailMyrtlePark,02/09/2016 10:00:00 PM,48,-122,7,3,10
18479,ElliotBayTrailMyrtlePark,02/09/2016 11:00:00 PM,48,-122,4,0,4
18480,ElliotBayTrailMyrtlePark,02/10/2016 12:00:00 AM,48,-122,0,1,1
18481,ElliotBayTrailMyrtlePark,02/10/2016 01:00:00 AM,48,-122,1,0,1
18482,ElliotBayTrailMyrtlePark,02/10/2016 02:00:00 AM,48,-122,2,0,2
18483,ElliotBayTrailMyrtlePark,02/10/2016 03:00:00 AM,48,-122,2,0,2
18484,ElliotBayTrailMyrtlePark,02/10/2016 04:00:00 AM,48,-122,0,1,1
18485,ElliotBayTrailMyrtlePark,02/10/2016 05:00:00 AM,48,-122,4,4,8
18486,ElliotBayTrailMyrtlePark,02/10/2016 06:00:00 AM,48,-122,15,19,34
18487,ElliotBayTrailMyrtlePark,02/10/2016 07:00:00 AM,48,-122,24,54,78
18488,ElliotBayTrailMyrtlePark,02/10/2016 08:00:00 AM,48,-122,33,128,161
18489,ElliotBayTrailMyrtlePark,02/10/2016 09:00:00 AM,48,-122,25,65,90
18490,ElliotBayTrailMyrtlePark,02/10/2016 10:00:00 AM,48,-122,13,27,40
18491,ElliotBayTrailMyrtlePark,02/10/2016 11:00:00 AM,48,-122,4,6,10
18492,ElliotBayTrailMyrtlePark,02/10/2016 12:00:00 PM,48,-122,8,7,15
18493,ElliotBayTrailMyrtlePark,02/10/2016 01:00:00 PM,48,-122,7,7,14
18494,ElliotBayTrailMyrtlePark,02/10/2016 02:00:00 PM,48,-122,10,6,16
18495,ElliotBayTrailMyrtlePark,02/10/2016 03:00:00 PM,48,-122,21,12,33
18496,ElliotBayTrailMyrtlePark,02/10/2016 04:00:00 PM,48,-122,34,31,65
18497,ElliotBayTrailMyrtlePark,02/10/2016 05:00:00 PM,48,-122,101,36,137
18498,ElliotBayTrailMyrtlePark,02/10/2016 06:00:00 PM,48,-122,114,21,135
18499,ElliotBayTrailMyrtlePark,02/10/2016 07:00:00 PM,48,-122,29,11,40
18500,ElliotBayTrailMyrtlePark,02/10/2016 08:00:00 PM,48,-122,9,1,10
18501,ElliotBayTrailMyrtlePark,02/10/2016 09:00:00 PM,48,-122,8,5,13
18502,ElliotBayTrailMyrtlePark,02/10/2016 10:00:00 PM,48,-122,2,2,4
18503,ElliotBayTrailMyrtlePark,02/10/2016 11:00:00 PM,48,-122,1,0,1
18504,ElliotBayTrailMyrtlePark,02/11/2016 12:00:00 AM,48,-122,1,0,1
18505,ElliotBayTrailMyrtlePark,02/11/2016 01:00:00 AM,48,-122,0,0,0
18506,ElliotBayTrailMyrtlePark,02/11/2016 02:00:00 AM,48,-122,1,0,1
18507,ElliotBayTrailMyrtlePark,02/11/2016 03:00:00 AM,48,-122,1,0,1
18508,ElliotBayTrailMyrtlePark,02/11/2016 04:00:00 AM,48,-122,0,0,0
18509,ElliotBayTrailMyrtlePark,02/11/2016 05:00:00 AM,48,-122,2,2,4
18510,ElliotBayTrailMyrtlePark,02/11/2016 06:00:00 AM,48,-122,11,10,21
18511,ElliotBayTrailMyrtlePark,02/11/2016 07:00:00 AM,48,-122,22,31,53
18512,ElliotBayTrailMyrtlePark,02/11/2016 08:00:00 AM,48,-122,20,84,104
18513,ElliotBayTrailMyrtlePark,02/11/2016 09:00:00 AM,48,-122,29,61,90
18514,ElliotBayTrailMyrtlePark,02/11/2016 10:00:00 AM,48,-122,8,24,32
18515,ElliotBayTrailMyrtlePark,02/11/2016 11:00:00 AM,48,-122,7,13,20
18516,ElliotBayTrailMyrtlePark,02/11/2016 12:00:00 PM,48,-122,8,3,11
18517,ElliotBayTrailMyrtlePark,02/11/2016 01:00:00 PM,48,-122,6,11,17
18518,ElliotBayTrailMyrtlePark,02/11/2016 02:00:00 PM,48,-122,8,6,14
18519,ElliotBayTrailMyrtlePark,02/11/2016 03:00:00 PM,48,-122,6,14,20
18520,ElliotBayTrailMyrtlePark,02/11/2016 04:00:00 PM,48,-122,17,14,31
18521,ElliotBayTrailMyrtlePark,02/11/2016 05:00:00 PM,48,-122,67,24,91
18522,ElliotBayTrailMyrtlePark,02/11/2016 06:00:00 PM,48,-122,79,19,98
18523,ElliotBayTrailMyrtlePark,02/11/2016 07:00:00 PM,48,-122,33,2,35
18524,ElliotBayTrailMyrtlePark,02/11/2016 08:00:00 PM,48,-122,7,1,8
18525,ElliotBayTrailMyrtlePark,02/11/2016 09:00:00 PM,48,-122,8,3,11
18526,ElliotBayTrailMyrtlePark,02/11/2016 10:00:00 PM,48,-122,2,1,3
18527,ElliotBayTrailMyrtlePark,02/11/2016 11:00:00 PM,48,-122,1,0,1
18528,ElliotBayTrailMyrtlePark,02/12/2016 12:00:00 AM,48,-122,0,1,1
18529,ElliotBayTrailMyrtlePark,02/12/2016 01:00:00 AM,48,-122,3,0,3
18530,ElliotBayTrailMyrtlePark,02/12/2016 02:00:00 AM,48,-122,1,0,1
18531,ElliotBayTrailMyrtlePark,02/12/2016 03:00:00 AM,48,-122,1,0,1
18532,ElliotBayTrailMyrtlePark,02/12/2016 04:00:00 AM,48,-122,2,0,2
18533,ElliotBayTrailMyrtlePark,02/12/2016 05:00:00 AM,48,-122,3,4,7
18534,ElliotBayTrailMyrtlePark,02/12/2016 06:00:00 AM,48,-122,10,7,17
18535,ElliotBayTrailMyrtlePark,02/12/2016 07:00:00 AM,48,-122,12,20,32
18536,ElliotBayTrailMyrtlePark,02/12/2016 08:00:00 AM,48,-122,28,82,110
18537,ElliotBayTrailMyrtlePark,02/12/2016 09:00:00 AM,48,-122,17,47,64
18538,ElliotBayTrailMyrtlePark,02/12/2016 10:00:00 AM,48,-122,5,12,17
18539,ElliotBayTrailMyrtlePark,02/12/2016 11:00:00 AM,48,-122,3,8,11
18540,ElliotBayTrailMyrtlePark,02/12/2016 12:00:00 PM,48,-122,7,6,13
18541,ElliotBayTrailMyrtlePark,02/12/2016 01:00:00 PM,48,-122,16,8,24
18542,ElliotBayTrailMyrtlePark,02/12/2016 02:00:00 PM,48,-122,19,13,32
18543,ElliotBayTrailMyrtlePark,02/12/2016 03:00:00 PM,48,-122,42,30,72
18544,ElliotBayTrailMyrtlePark,02/12/2016 04:00:00 PM,48,-122,41,39,80
18545,ElliotBayTrailMyrtlePark,02/12/2016 05:00:00 PM,48,-122,99,35,134
18546,ElliotBayTrailMyrtlePark,02/12/2016 06:00:00 PM,48,-122,66,25,91
18547,ElliotBayTrailMyrtlePark,02/12/2016 07:00:00 PM,48,-122,35,4,39
18548,ElliotBayTrailMyrtlePark,02/12/2016 08:00:00 PM,48,-122,7,0,7
18549,ElliotBayTrailMyrtlePark,02/12/2016 09:00:00 PM,48,-122,4,2,6
18550,ElliotBayTrailMyrtlePark,02/12/2016 10:00:00 PM,48,-122,1,2,3
18551,ElliotBayTrailMyrtlePark,02/12/2016 11:00:00 PM,48,-122,1,2,3
18552,ElliotBayTrailMyrtlePark,02/13/2016 12:00:00 AM,48,-122,0,0,0
18553,ElliotBayTrailMyrtlePark,02/13/2016 01:00:00 AM,48,-122,3,0,3
18554,ElliotBayTrailMyrtlePark,02/13/2016 02:00:00 AM,48,-122,0,0,0
18555,ElliotBayTrailMyrtlePark,02/13/2016 03:00:00 AM,48,-122,1,0,1
18556,ElliotBayTrailMyrtlePark,02/13/2016 04:00:00 AM,48,-122,0,0,0
18557,ElliotBayTrailMyrtlePark,02/13/2016 05:00:00 AM,48,-122,0,0,0
18558,ElliotBayTrailMyrtlePark,02/13/2016 06:00:00 AM,48,-122,0,5,5
18559,ElliotBayTrailMyrtlePark,02/13/2016 07:00:00 AM,48,-122,0,4,4
18560,ElliotBayTrailMyrtlePark,02/13/2016 08:00:00 AM,48,-122,7,11,18
18561,ElliotBayTrailMyrtlePark,02/13/2016 09:00:00 AM,48,-122,21,16,37
18562,ElliotBayTrailMyrtlePark,02/13/2016 10:00:00 AM,48,-122,24,30,54
18563,ElliotBayTrailMyrtlePark,02/13/2016 11:00:00 AM,48,-122,33,26,59
18564,ElliotBayTrailMyrtlePark,02/13/2016 12:00:00 PM,48,-122,24,17,41
18565,ElliotBayTrailMyrtlePark,02/13/2016 01:00:00 PM,48,-122,11,17,28
18566,ElliotBayTrailMyrtlePark,02/13/2016 02:00:00 PM,48,-122,4,2,6
18567,ElliotBayTrailMyrtlePark,02/13/2016 03:00:00 PM,48,-122,9,4,13
18568,ElliotBayTrailMyrtlePark,02/13/2016 04:00:00 PM,48,-122,7,1,8
18569,ElliotBayTrailMyrtlePark,02/13/2016 05:00:00 PM,48,-122,6,5,11
18570,ElliotBayTrailMyrtlePark,02/13/2016 06:00:00 PM,48,-122,1,1,2
18571,ElliotBayTrailMyrtlePark,02/13/2016 07:00:00 PM,48,-122,3,2,5
18572,ElliotBayTrailMyrtlePark,02/13/2016 08:00:00 PM,48,-122,2,3,5
18573,ElliotBayTrailMyrtlePark,02/13/2016 09:00:00 PM,48,-122,2,1,3
18574,ElliotBayTrailMyrtlePark,02/13/2016 10:00:00 PM,48,-122,2,2,4
18575,ElliotBayTrailMyrtlePark,02/13/2016 11:00:00 PM,48,-122,2,1,3
18576,ElliotBayTrailMyrtlePark,02/14/2016 12:00:00 AM,48,-122,4,0,4
18577,ElliotBayTrailMyrtlePark,02/14/2016 01:00:00 AM,48,-122,0,0,0
18578,ElliotBayTrailMyrtlePark,02/14/2016 02:00:00 AM,48,-122,0,2,2
18579,ElliotBayTrailMyrtlePark,02/14/2016 03:00:00 AM,48,-122,1,0,1
18580,ElliotBayTrailMyrtlePark,02/14/2016 04:00:00 AM,48,-122,0,0,0
18581,ElliotBayTrailMyrtlePark,02/14/2016 05:00:00 AM,48,-122,0,1,1
18582,ElliotBayTrailMyrtlePark,02/14/2016 06:00:00 AM,48,-122,1,1,2
18583,ElliotBayTrailMyrtlePark,02/14/2016 07:00:00 AM,48,-122,0,0,0
18584,ElliotBayTrailMyrtlePark,02/14/2016 08:00:00 AM,48,-122,3,1,4
18585,ElliotBayTrailMyrtlePark,02/14/2016 09:00:00 AM,48,-122,6,1,7
18586,ElliotBayTrailMyrtlePark,02/14/2016 10:00:00 AM,48,-122,12,11,23
18587,ElliotBayTrailMyrtlePark,02/14/2016 11:00:00 AM,48,-122,5,13,18
18588,ElliotBayTrailMyrtlePark,02/14/2016 12:00:00 PM,48,-122,15,11,26
18589,ElliotBayTrailMyrtlePark,02/14/2016 01:00:00 PM,48,-122,12,17,29
18590,ElliotBayTrailMyrtlePark,02/14/2016 02:00:00 PM,48,-122,11,13,24
18591,ElliotBayTrailMyrtlePark,02/14/2016 03:00:00 PM,48,-122,21,18,39
18592,ElliotBayTrailMyrtlePark,02/14/2016 04:00:00 PM,48,-122,15,20,35
18593,ElliotBayTrailMyrtlePark,02/14/2016 05:00:00 PM,48,-122,13,11,24
18594,ElliotBayTrailMyrtlePark,02/14/2016 06:00:00 PM,48,-122,2,6,8
18595,ElliotBayTrailMyrtlePark,02/14/2016 07:00:00 PM,48,-122,8,4,12
18596,ElliotBayTrailMyrtlePark,02/14/2016 08:00:00 PM,48,-122,2,0,2
18597,ElliotBayTrailMyrtlePark,02/14/2016 09:00:00 PM,48,-122,1,0,1
18598,ElliotBayTrailMyrtlePark,02/14/2016 10:00:00 PM,48,-122,0,1,1
18599,ElliotBayTrailMyrtlePark,02/14/2016 11:00:00 PM,48,-122,0,3,3
18600,ElliotBayTrailMyrtlePark,02/15/2016 12:00:00 AM,48,-122,1,0,1
18601,ElliotBayTrailMyrtlePark,02/15/2016 01:00:00 AM,48,-122,0,0,0
18602,ElliotBayTrailMyrtlePark,02/15/2016 02:00:00 AM,48,-122,0,0,0
18603,ElliotBayTrailMyrtlePark,02/15/2016 03:00:00 AM,48,-122,1,0,1
18604,ElliotBayTrailMyrtlePark,02/15/2016 04:00:00 AM,48,-122,1,0,1
18605,ElliotBayTrailMyrtlePark,02/15/2016 05:00:00 AM,48,-122,3,0,3
18606,ElliotBayTrailMyrtlePark,02/15/2016 06:00:00 AM,48,-122,3,4,7
18607,ElliotBayTrailMyrtlePark,02/15/2016 07:00:00 AM,48,-122,4,8,12
18608,ElliotBayTrailMyrtlePark,02/15/2016 08:00:00 AM,48,-122,6,38,44
18609,ElliotBayTrailMyrtlePark,02/15/2016 09:00:00 AM,48,-122,20,26,46
18610,ElliotBayTrailMyrtlePark,02/15/2016 10:00:00 AM,48,-122,10,15,25
18611,ElliotBayTrailMyrtlePark,02/15/2016 11:00:00 AM,48,-122,11,9,20
18612,ElliotBayTrailMyrtlePark,02/15/2016 12:00:00 PM,48,-122,9,7,16
18613,ElliotBayTrailMyrtlePark,02/15/2016 01:00:00 PM,48,-122,7,3,10
18614,ElliotBayTrailMyrtlePark,02/15/2016 02:00:00 PM,48,-122,5,4,9
18615,ElliotBayTrailMyrtlePark,02/15/2016 03:00:00 PM,48,-122,4,10,14
18616,ElliotBayTrailMyrtlePark,02/15/2016 04:00:00 PM,48,-122,16,12,28
18617,ElliotBayTrailMyrtlePark,02/15/2016 05:00:00 PM,48,-122,23,10,33
18618,ElliotBayTrailMyrtlePark,02/15/2016 06:00:00 PM,48,-122,32,4,36
18619,ElliotBayTrailMyrtlePark,02/15/2016 07:00:00 PM,48,-122,12,2,14
18620,ElliotBayTrailMyrtlePark,02/15/2016 08:00:00 PM,48,-122,4,0,4
18621,ElliotBayTrailMyrtlePark,02/15/2016 09:00:00 PM,48,-122,2,1,3
18622,ElliotBayTrailMyrtlePark,02/15/2016 10:00:00 PM,48,-122,2,1,3
18623,ElliotBayTrailMyrtlePark,02/15/2016 11:00:00 PM,48,-122,0,1,1
18624,ElliotBayTrailMyrtlePark,02/16/2016 12:00:00 AM,48,-122,2,0,2
18625,ElliotBayTrailMyrtlePark,02/16/2016 01:00:00 AM,48,-122,0,0,0
18626,ElliotBayTrailMyrtlePark,02/16/2016 02:00:00 AM,48,-122,1,0,1
18627,ElliotBayTrailMyrtlePark,02/16/2016 03:00:00 AM,48,-122,1,0,1
18628,ElliotBayTrailMyrtlePark,02/16/2016 04:00:00 AM,48,-122,0,0,0
18629,ElliotBayTrailMyrtlePark,02/16/2016 05:00:00 AM,48,-122,4,2,6
18630,ElliotBayTrailMyrtlePark,02/16/2016 06:00:00 AM,48,-122,9,17,26
18631,ElliotBayTrailMyrtlePark,02/16/2016 07:00:00 AM,48,-122,15,27,42
18632,ElliotBayTrailMyrtlePark,02/16/2016 08:00:00 AM,48,-122,20,94,114
18633,ElliotBayTrailMyrtlePark,02/16/2016 09:00:00 AM,48,-122,19,63,82
18634,ElliotBayTrailMyrtlePark,02/16/2016 10:00:00 AM,48,-122,6,23,29
18635,ElliotBayTrailMyrtlePark,02/16/2016 11:00:00 AM,48,-122,11,12,23
18636,ElliotBayTrailMyrtlePark,02/16/2016 12:00:00 PM,48,-122,12,5,17
18637,ElliotBayTrailMyrtlePark,02/16/2016 01:00:00 PM,48,-122,19,16,35
18638,ElliotBayTrailMyrtlePark,02/16/2016 02:00:00 PM,48,-122,26,21,47
18639,ElliotBayTrailMyrtlePark,02/16/2016 03:00:00 PM,48,-122,28,28,56
18640,ElliotBayTrailMyrtlePark,02/16/2016 04:00:00 PM,48,-122,44,32,76
18641,ElliotBayTrailMyrtlePark,02/16/2016 05:00:00 PM,48,-122,97,36,133
18642,ElliotBayTrailMyrtlePark,02/16/2016 06:00:00 PM,48,-122,94,24,118
18643,ElliotBayTrailMyrtlePark,02/16/2016 07:00:00 PM,48,-122,18,8,26
18644,ElliotBayTrailMyrtlePark,02/16/2016 08:00:00 PM,48,-122,10,3,13
18645,ElliotBayTrailMyrtlePark,02/16/2016 09:00:00 PM,48,-122,7,1,8
18646,ElliotBayTrailMyrtlePark,02/16/2016 10:00:00 PM,48,-122,5,3,8
18647,ElliotBayTrailMyrtlePark,02/16/2016 11:00:00 PM,48,-122,0,1,1
18648,ElliotBayTrailMyrtlePark,02/17/2016 12:00:00 AM,48,-122,5,1,6
18649,ElliotBayTrailMyrtlePark,02/17/2016 01:00:00 AM,48,-122,0,1,1
18650,ElliotBayTrailMyrtlePark,02/17/2016 02:00:00 AM,48,-122,0,0,0
18651,ElliotBayTrailMyrtlePark,02/17/2016 03:00:00 AM,48,-122,3,0,3
18652,ElliotBayTrailMyrtlePark,02/17/2016 04:00:00 AM,48,-122,0,0,0
18653,ElliotBayTrailMyrtlePark,02/17/2016 05:00:00 AM,48,-122,5,3,8
18654,ElliotBayTrailMyrtlePark,02/17/2016 06:00:00 AM,48,-122,10,15,25
18655,ElliotBayTrailMyrtlePark,02/17/2016 07:00:00 AM,48,-122,22,38,60
18656,ElliotBayTrailMyrtlePark,02/17/2016 08:00:00 AM,48,-122,28,104,132
18657,ElliotBayTrailMyrtlePark,02/17/2016 09:00:00 AM,48,-122,27,81,108
18658,ElliotBayTrailMyrtlePark,02/17/2016 10:00:00 AM,48,-122,14,29,43
18659,ElliotBayTrailMyrtlePark,02/17/2016 11:00:00 AM,48,-122,13,15,28
18660,ElliotBayTrailMyrtlePark,02/17/2016 12:00:00 PM,48,-122,15,10,25
18661,ElliotBayTrailMyrtlePark,02/17/2016 01:00:00 PM,48,-122,14,17,31
18662,ElliotBayTrailMyrtlePark,02/17/2016 02:00:00 PM,48,-122,19,17,36
18663,ElliotBayTrailMyrtlePark,02/17/2016 03:00:00 PM,48,-122,9,13,22
18664,ElliotBayTrailMyrtlePark,02/17/2016 04:00:00 PM,48,-122,33,16,49
18665,ElliotBayTrailMyrtlePark,02/17/2016 05:00:00 PM,48,-122,93,29,122
18666,ElliotBayTrailMyrtlePark,02/17/2016 06:00:00 PM,48,-122,102,31,133
18667,ElliotBayTrailMyrtlePark,02/17/2016 07:00:00 PM,48,-122,32,6,38
18668,ElliotBayTrailMyrtlePark,02/17/2016 08:00:00 PM,48,-122,6,2,8
18669,ElliotBayTrailMyrtlePark,02/17/2016 09:00:00 PM,48,-122,4,0,4
18670,ElliotBayTrailMyrtlePark,02/17/2016 10:00:00 PM,48,-122,2,0,2
18671,ElliotBayTrailMyrtlePark,02/17/2016 11:00:00 PM,48,-122,4,0,4
18672,ElliotBayTrailMyrtlePark,02/18/2016 12:00:00 AM,48,-122,3,1,4
18673,ElliotBayTrailMyrtlePark,02/18/2016 01:00:00 AM,48,-122,0,0,0
18674,ElliotBayTrailMyrtlePark,02/18/2016 02:00:00 AM,48,-122,1,0,1
18675,ElliotBayTrailMyrtlePark,02/18/2016 03:00:00 AM,48,-122,1,0,1
18676,ElliotBayTrailMyrtlePark,02/18/2016 04:00:00 AM,48,-122,0,0,0
18677,ElliotBayTrailMyrtlePark,02/18/2016 05:00:00 AM,48,-122,4,1,5
18678,ElliotBayTrailMyrtlePark,02/18/2016 06:00:00 AM,48,-122,10,13,23
18679,ElliotBayTrailMyrtlePark,02/18/2016 07:00:00 AM,48,-122,15,30,45
18680,ElliotBayTrailMyrtlePark,02/18/2016 08:00:00 AM,48,-122,20,103,123
18681,ElliotBayTrailMyrtlePark,02/18/2016 09:00:00 AM,48,-122,22,57,79
18682,ElliotBayTrailMyrtlePark,02/18/2016 10:00:00 AM,48,-122,14,16,30
18683,ElliotBayTrailMyrtlePark,02/18/2016 11:00:00 AM,48,-122,14,19,33
18684,ElliotBayTrailMyrtlePark,02/18/2016 12:00:00 PM,48,-122,11,11,22
18685,ElliotBayTrailMyrtlePark,02/18/2016 01:00:00 PM,48,-122,13,14,27
18686,ElliotBayTrailMyrtlePark,02/18/2016 02:00:00 PM,48,-122,20,14,34
18687,ElliotBayTrailMyrtlePark,02/18/2016 03:00:00 PM,48,-122,22,27,49
18688,ElliotBayTrailMyrtlePark,02/18/2016 04:00:00 PM,48,-122,39,24,63
18689,ElliotBayTrailMyrtlePark,02/18/2016 05:00:00 PM,48,-122,95,36,131
18690,ElliotBayTrailMyrtlePark,02/18/2016 06:00:00 PM,48,-122,94,18,112
18691,ElliotBayTrailMyrtlePark,02/18/2016 07:00:00 PM,48,-122,40,9,49
18692,ElliotBayTrailMyrtlePark,02/18/2016 08:00:00 PM,48,-122,4,1,5
18693,ElliotBayTrailMyrtlePark,02/18/2016 09:00:00 PM,48,-122,3,1,4
18694,ElliotBayTrailMyrtlePark,02/18/2016 10:00:00 PM,48,-122,4,2,6
18695,ElliotBayTrailMyrtlePark,02/18/2016 11:00:00 PM,48,-122,3,1,4
18696,ElliotBayTrailMyrtlePark,02/19/2016 12:00:00 AM,48,-122,3,0,3
18697,ElliotBayTrailMyrtlePark,02/19/2016 01:00:00 AM,48,-122,1,0,1
18698,ElliotBayTrailMyrtlePark,02/19/2016 02:00:00 AM,48,-122,0,0,0
18699,ElliotBayTrailMyrtlePark,02/19/2016 03:00:00 AM,48,-122,1,0,1
18700,ElliotBayTrailMyrtlePark,02/19/2016 04:00:00 AM,48,-122,0,0,0
18701,ElliotBayTrailMyrtlePark,02/19/2016 05:00:00 AM,48,-122,4,4,8
18702,ElliotBayTrailMyrtlePark,02/19/2016 06:00:00 AM,48,-122,7,9,16
18703,ElliotBayTrailMyrtlePark,02/19/2016 07:00:00 AM,48,-122,8,20,28
18704,ElliotBayTrailMyrtlePark,02/19/2016 08:00:00 AM,48,-122,15,60,75
18705,ElliotBayTrailMyrtlePark,02/19/2016 09:00:00 AM,48,-122,17,38,55
18706,ElliotBayTrailMyrtlePark,02/19/2016 10:00:00 AM,48,-122,5,17,22
18707,ElliotBayTrailMyrtlePark,02/19/2016 11:00:00 AM,48,-122,4,3,7
18708,ElliotBayTrailMyrtlePark,02/19/2016 12:00:00 PM,48,-122,4,3,7
18709,ElliotBayTrailMyrtlePark,02/19/2016 01:00:00 PM,48,-122,1,9,10
18710,ElliotBayTrailMyrtlePark,02/19/2016 02:00:00 PM,48,-122,8,3,11
18711,ElliotBayTrailMyrtlePark,02/19/2016 03:00:00 PM,48,-122,11,7,18
18712,ElliotBayTrailMyrtlePark,02/19/2016 04:00:00 PM,48,-122,22,14,36
18713,ElliotBayTrailMyrtlePark,02/19/2016 05:00:00 PM,48,-122,54,22,76
18714,ElliotBayTrailMyrtlePark,02/19/2016 06:00:00 PM,48,-122,48,8,56
18715,ElliotBayTrailMyrtlePark,02/19/2016 07:00:00 PM,48,-122,15,3,18
18716,ElliotBayTrailMyrtlePark,02/19/2016 08:00:00 PM,48,-122,0,0,0
18717,ElliotBayTrailMyrtlePark,02/19/2016 09:00:00 PM,48,-122,4,0,4
18718,ElliotBayTrailMyrtlePark,02/19/2016 10:00:00 PM,48,-122,3,0,3
18719,ElliotBayTrailMyrtlePark,02/19/2016 11:00:00 PM,48,-122,2,1,3
18720,ElliotBayTrailMyrtlePark,02/20/2016 12:00:00 AM,48,-122,0,0,0
18721,ElliotBayTrailMyrtlePark,02/20/2016 01:00:00 AM,48,-122,2,0,2
18722,ElliotBayTrailMyrtlePark,02/20/2016 02:00:00 AM,48,-122,2,1,3
18723,ElliotBayTrailMyrtlePark,02/20/2016 03:00:00 AM,48,-122,0,1,1
18724,ElliotBayTrailMyrtlePark,02/20/2016 04:00:00 AM,48,-122,0,0,0
18725,ElliotBayTrailMyrtlePark,02/20/2016 05:00:00 AM,48,-122,0,1,1
18726,ElliotBayTrailMyrtlePark,02/20/2016 06:00:00 AM,48,-122,0,3,3
18727,ElliotBayTrailMyrtlePark,02/20/2016 07:00:00 AM,48,-122,3,3,6
18728,ElliotBayTrailMyrtlePark,02/20/2016 08:00:00 AM,48,-122,3,9,12
18729,ElliotBayTrailMyrtlePark,02/20/2016 09:00:00 AM,48,-122,8,21,29
18730,ElliotBayTrailMyrtlePark,02/20/2016 10:00:00 AM,48,-122,19,24,43
18731,ElliotBayTrailMyrtlePark,02/20/2016 11:00:00 AM,48,-122,48,41,89
18732,ElliotBayTrailMyrtlePark,02/20/2016 12:00:00 PM,48,-122,41,51,92
18733,ElliotBayTrailMyrtlePark,02/20/2016 01:00:00 PM,48,-122,57,57,114
18734,ElliotBayTrailMyrtlePark,02/20/2016 02:00:00 PM,48,-122,84,82,166
18735,ElliotBayTrailMyrtlePark,02/20/2016 03:00:00 PM,48,-122,64,67,131
18736,ElliotBayTrailMyrtlePark,02/20/2016 04:00:00 PM,48,-122,53,65,118
18737,ElliotBayTrailMyrtlePark,02/20/2016 05:00:00 PM,48,-122,64,52,116
18738,ElliotBayTrailMyrtlePark,02/20/2016 06:00:00 PM,48,-122,14,25,39
18739,ElliotBayTrailMyrtlePark,02/20/2016 07:00:00 PM,48,-122,4,7,11
18740,ElliotBayTrailMyrtlePark,02/20/2016 08:00:00 PM,48,-122,2,0,2
18741,ElliotBayTrailMyrtlePark,02/20/2016 09:00:00 PM,48,-122,6,0,6
18742,ElliotBayTrailMyrtlePark,02/20/2016 10:00:00 PM,48,-122,14,2,16
18743,ElliotBayTrailMyrtlePark,02/20/2016 11:00:00 PM,48,-122,1,2,3
18744,ElliotBayTrailMyrtlePark,02/21/2016 12:00:00 AM,48,-122,3,2,5
18745,ElliotBayTrailMyrtlePark,02/21/2016 01:00:00 AM,48,-122,1,0,1
18746,ElliotBayTrailMyrtlePark,02/21/2016 02:00:00 AM,48,-122,1,0,1
18747,ElliotBayTrailMyrtlePark,02/21/2016 03:00:00 AM,48,-122,1,0,1
18748,ElliotBayTrailMyrtlePark,02/21/2016 04:00:00 AM,48,-122,0,0,0
18749,ElliotBayTrailMyrtlePark,02/21/2016 05:00:00 AM,48,-122,0,0,0
18750,ElliotBayTrailMyrtlePark,02/21/2016 06:00:00 AM,48,-122,1,3,4
18751,ElliotBayTrailMyrtlePark,02/21/2016 07:00:00 AM,48,-122,4,2,6
18752,ElliotBayTrailMyrtlePark,02/21/2016 08:00:00 AM,48,-122,5,5,10
18753,ElliotBayTrailMyrtlePark,02/21/2016 09:00:00 AM,48,-122,11,6,17
18754,ElliotBayTrailMyrtlePark,02/21/2016 10:00:00 AM,48,-122,16,20,36
18755,ElliotBayTrailMyrtlePark,02/21/2016 11:00:00 AM,48,-122,15,27,42
18756,ElliotBayTrailMyrtlePark,02/21/2016 12:00:00 PM,48,-122,15,11,26
18757,ElliotBayTrailMyrtlePark,02/21/2016 01:00:00 PM,48,-122,6,3,9
18758,ElliotBayTrailMyrtlePark,02/21/2016 02:00:00 PM,48,-122,17,5,22
18759,ElliotBayTrailMyrtlePark,02/21/2016 03:00:00 PM,48,-122,17,11,28
18760,ElliotBayTrailMyrtlePark,02/21/2016 04:00:00 PM,48,-122,17,15,32
18761,ElliotBayTrailMyrtlePark,02/21/2016 05:00:00 PM,48,-122,28,25,53
18762,ElliotBayTrailMyrtlePark,02/21/2016 06:00:00 PM,48,-122,19,15,34
18763,ElliotBayTrailMyrtlePark,02/21/2016 07:00:00 PM,48,-122,4,1,5
18764,ElliotBayTrailMyrtlePark,02/21/2016 08:00:00 PM,48,-122,2,1,3
18765,ElliotBayTrailMyrtlePark,02/21/2016 09:00:00 PM,48,-122,2,2,4
18766,ElliotBayTrailMyrtlePark,02/21/2016 10:00:00 PM,48,-122,0,0,0
18767,ElliotBayTrailMyrtlePark,02/21/2016 11:00:00 PM,48,-122,2,1,3
18768,ElliotBayTrailMyrtlePark,02/22/2016 12:00:00 AM,48,-122,1,0,1
18769,ElliotBayTrailMyrtlePark,02/22/2016 01:00:00 AM,48,-122,0,1,1
18770,ElliotBayTrailMyrtlePark,02/22/2016 02:00:00 AM,48,-122,0,0,0
18771,ElliotBayTrailMyrtlePark,02/22/2016 03:00:00 AM,48,-122,0,0,0
18772,ElliotBayTrailMyrtlePark,02/22/2016 04:00:00 AM,48,-122,0,0,0
18773,ElliotBayTrailMyrtlePark,02/22/2016 05:00:00 AM,48,-122,3,2,5
18774,ElliotBayTrailMyrtlePark,02/22/2016 06:00:00 AM,48,-122,12,19,31
18775,ElliotBayTrailMyrtlePark,02/22/2016 07:00:00 AM,48,-122,18,45,63
18776,ElliotBayTrailMyrtlePark,02/22/2016 08:00:00 AM,48,-122,30,123,153
18777,ElliotBayTrailMyrtlePark,02/22/2016 09:00:00 AM,48,-122,31,82,113
18778,ElliotBayTrailMyrtlePark,02/22/2016 10:00:00 AM,48,-122,11,21,32
18779,ElliotBayTrailMyrtlePark,02/22/2016 11:00:00 AM,48,-122,13,9,22
18780,ElliotBayTrailMyrtlePark,02/22/2016 12:00:00 PM,48,-122,13,10,23
18781,ElliotBayTrailMyrtlePark,02/22/2016 01:00:00 PM,48,-122,7,13,20
18782,ElliotBayTrailMyrtlePark,02/22/2016 02:00:00 PM,48,-122,16,11,27
18783,ElliotBayTrailMyrtlePark,02/22/2016 03:00:00 PM,48,-122,24,27,51
18784,ElliotBayTrailMyrtlePark,02/22/2016 04:00:00 PM,48,-122,53,30,83
18785,ElliotBayTrailMyrtlePark,02/22/2016 05:00:00 PM,48,-122,126,63,189
18786,ElliotBayTrailMyrtlePark,02/22/2016 06:00:00 PM,48,-122,120,33,153
18787,ElliotBayTrailMyrtlePark,02/22/2016 07:00:00 PM,48,-122,32,8,40
18788,ElliotBayTrailMyrtlePark,02/22/2016 08:00:00 PM,48,-122,8,2,10
18789,ElliotBayTrailMyrtlePark,02/22/2016 09:00:00 PM,48,-122,4,5,9
18790,ElliotBayTrailMyrtlePark,02/22/2016 10:00:00 PM,48,-122,6,2,8
18791,ElliotBayTrailMyrtlePark,02/22/2016 11:00:00 PM,48,-122,2,2,4
18792,ElliotBayTrailMyrtlePark,02/23/2016 12:00:00 AM,48,-122,1,0,1
18793,ElliotBayTrailMyrtlePark,02/23/2016 01:00:00 AM,48,-122,0,1,1
18794,ElliotBayTrailMyrtlePark,02/23/2016 02:00:00 AM,48,-122,1,0,1
18795,ElliotBayTrailMyrtlePark,02/23/2016 03:00:00 AM,48,-122,1,1,2
18796,ElliotBayTrailMyrtlePark,02/23/2016 04:00:00 AM,48,-122,0,0,0
18797,ElliotBayTrailMyrtlePark,02/23/2016 05:00:00 AM,48,-122,2,1,3
18798,ElliotBayTrailMyrtlePark,02/23/2016 06:00:00 AM,48,-122,17,21,38
18799,ElliotBayTrailMyrtlePark,02/23/2016 07:00:00 AM,48,-122,23,58,81
18800,ElliotBayTrailMyrtlePark,02/23/2016 08:00:00 AM,48,-122,34,145,179
18801,ElliotBayTrailMyrtlePark,02/23/2016 09:00:00 AM,48,-122,37,88,125
18802,ElliotBayTrailMyrtlePark,02/23/2016 10:00:00 AM,48,-122,19,30,49
18803,ElliotBayTrailMyrtlePark,02/23/2016 11:00:00 AM,48,-122,14,18,32
18804,ElliotBayTrailMyrtlePark,02/23/2016 12:00:00 PM,48,-122,26,32,58
18805,ElliotBayTrailMyrtlePark,02/23/2016 01:00:00 PM,48,-122,25,29,54
18806,ElliotBayTrailMyrtlePark,02/23/2016 02:00:00 PM,48,-122,31,30,61
18807,ElliotBayTrailMyrtlePark,02/23/2016 03:00:00 PM,48,-122,29,33,62
18808,ElliotBayTrailMyrtlePark,02/23/2016 04:00:00 PM,48,-122,68,43,111
18809,ElliotBayTrailMyrtlePark,02/23/2016 05:00:00 PM,48,-122,154,53,207
18810,ElliotBayTrailMyrtlePark,02/23/2016 06:00:00 PM,48,-122,126,52,178
18811,ElliotBayTrailMyrtlePark,02/23/2016 07:00:00 PM,48,-122,40,12,52
18812,ElliotBayTrailMyrtlePark,02/23/2016 08:00:00 PM,48,-122,14,1,15
18813,ElliotBayTrailMyrtlePark,02/23/2016 09:00:00 PM,48,-122,26,8,34
18814,ElliotBayTrailMyrtlePark,02/23/2016 10:00:00 PM,48,-122,9,4,13
18815,ElliotBayTrailMyrtlePark,02/23/2016 11:00:00 PM,48,-122,6,5,11
18816,ElliotBayTrailMyrtlePark,02/24/2016 12:00:00 AM,48,-122,1,2,3
18817,ElliotBayTrailMyrtlePark,02/24/2016 01:00:00 AM,48,-122,1,0,1
18818,ElliotBayTrailMyrtlePark,02/24/2016 02:00:00 AM,48,-122,1,0,1
18819,ElliotBayTrailMyrtlePark,02/24/2016 03:00:00 AM,48,-122,1,0,1
18820,ElliotBayTrailMyrtlePark,02/24/2016 04:00:00 AM,48,-122,0,0,0
18821,ElliotBayTrailMyrtlePark,02/24/2016 05:00:00 AM,48,-122,3,1,4
18822,ElliotBayTrailMyrtlePark,02/24/2016 06:00:00 AM,48,-122,14,21,35
18823,ElliotBayTrailMyrtlePark,02/24/2016 07:00:00 AM,48,-122,18,55,73
18824,ElliotBayTrailMyrtlePark,02/24/2016 08:00:00 AM,48,-122,38,125,163
18825,ElliotBayTrailMyrtlePark,02/24/2016 09:00:00 AM,48,-122,30,89,119
18826,ElliotBayTrailMyrtlePark,02/24/2016 10:00:00 AM,48,-122,17,29,46
18827,ElliotBayTrailMyrtlePark,02/24/2016 11:00:00 AM,48,-122,13,13,26
18828,ElliotBayTrailMyrtlePark,02/24/2016 12:00:00 PM,48,-122,23,21,44
18829,ElliotBayTrailMyrtlePark,02/24/2016 01:00:00 PM,48,-122,21,14,35
18830,ElliotBayTrailMyrtlePark,02/24/2016 02:00:00 PM,48,-122,16,14,30
18831,ElliotBayTrailMyrtlePark,02/24/2016 03:00:00 PM,48,-122,24,26,50
18832,ElliotBayTrailMyrtlePark,02/24/2016 04:00:00 PM,48,-122,60,26,86
18833,ElliotBayTrailMyrtlePark,02/24/2016 05:00:00 PM,48,-122,129,39,168
18834,ElliotBayTrailMyrtlePark,02/24/2016 06:00:00 PM,48,-122,86,35,121
18835,ElliotBayTrailMyrtlePark,02/24/2016 07:00:00 PM,48,-122,36,12,48
18836,ElliotBayTrailMyrtlePark,02/24/2016 08:00:00 PM,48,-122,9,1,10
18837,ElliotBayTrailMyrtlePark,02/24/2016 09:00:00 PM,48,-122,2,1,3
18838,ElliotBayTrailMyrtlePark,02/24/2016 10:00:00 PM,48,-122,1,1,2
18839,ElliotBayTrailMyrtlePark,02/24/2016 11:00:00 PM,48,-122,2,0,2
18840,ElliotBayTrailMyrtlePark,02/25/2016 12:00:00 AM,48,-122,2,1,3
18841,ElliotBayTrailMyrtlePark,02/25/2016 01:00:00 AM,48,-122,2,0,2
18842,ElliotBayTrailMyrtlePark,02/25/2016 02:00:00 AM,48,-122,1,0,1
18843,ElliotBayTrailMyrtlePark,02/25/2016 03:00:00 AM,48,-122,1,0,1
18844,ElliotBayTrailMyrtlePark,02/25/2016 04:00:00 AM,48,-122,0,0,0
18845,ElliotBayTrailMyrtlePark,02/25/2016 05:00:00 AM,48,-122,5,4,9
18846,ElliotBayTrailMyrtlePark,02/25/2016 06:00:00 AM,48,-122,13,22,35
18847,ElliotBayTrailMyrtlePark,02/25/2016 07:00:00 AM,48,-122,18,61,79
18848,ElliotBayTrailMyrtlePark,02/25/2016 08:00:00 AM,48,-122,27,140,167
18849,ElliotBayTrailMyrtlePark,02/25/2016 09:00:00 AM,48,-122,30,85,115
18850,ElliotBayTrailMyrtlePark,02/25/2016 10:00:00 AM,48,-122,26,31,57
18851,ElliotBayTrailMyrtlePark,02/25/2016 11:00:00 AM,48,-122,20,27,47
18852,ElliotBayTrailMyrtlePark,02/25/2016 12:00:00 PM,48,-122,13,28,41
18853,ElliotBayTrailMyrtlePark,02/25/2016 01:00:00 PM,48,-122,23,20,43
18854,ElliotBayTrailMyrtlePark,02/25/2016 02:00:00 PM,48,-122,26,25,51
18855,ElliotBayTrailMyrtlePark,02/25/2016 03:00:00 PM,48,-122,40,36,76
18856,ElliotBayTrailMyrtlePark,02/25/2016 04:00:00 PM,48,-122,79,44,123
18857,ElliotBayTrailMyrtlePark,02/25/2016 05:00:00 PM,48,-122,184,63,247
18858,ElliotBayTrailMyrtlePark,02/25/2016 06:00:00 PM,48,-122,141,49,190
18859,ElliotBayTrailMyrtlePark,02/25/2016 07:00:00 PM,48,-122,38,12,50
18860,ElliotBayTrailMyrtlePark,02/25/2016 08:00:00 PM,48,-122,61,5,66
18861,ElliotBayTrailMyrtlePark,02/25/2016 09:00:00 PM,48,-122,9,3,12
18862,ElliotBayTrailMyrtlePark,02/25/2016 10:00:00 PM,48,-122,5,2,7
18863,ElliotBayTrailMyrtlePark,02/25/2016 11:00:00 PM,48,-122,1,4,5
18864,ElliotBayTrailMyrtlePark,02/26/2016 12:00:00 AM,48,-122,3,8,11
18865,ElliotBayTrailMyrtlePark,02/26/2016 01:00:00 AM,48,-122,1,3,4
18866,ElliotBayTrailMyrtlePark,02/26/2016 02:00:00 AM,48,-122,1,3,4
18867,ElliotBayTrailMyrtlePark,02/26/2016 03:00:00 AM,48,-122,2,0,2
18868,ElliotBayTrailMyrtlePark,02/26/2016 04:00:00 AM,48,-122,0,0,0
18869,ElliotBayTrailMyrtlePark,02/26/2016 05:00:00 AM,48,-122,4,4,8
18870,ElliotBayTrailMyrtlePark,02/26/2016 06:00:00 AM,48,-122,8,14,22
18871,ElliotBayTrailMyrtlePark,02/26/2016 07:00:00 AM,48,-122,15,41,56
18872,ElliotBayTrailMyrtlePark,02/26/2016 08:00:00 AM,48,-122,26,108,134
18873,ElliotBayTrailMyrtlePark,02/26/2016 09:00:00 AM,48,-122,29,84,113
18874,ElliotBayTrailMyrtlePark,02/26/2016 10:00:00 AM,48,-122,16,27,43
18875,ElliotBayTrailMyrtlePark,02/26/2016 11:00:00 AM,48,-122,19,22,41
18876,ElliotBayTrailMyrtlePark,02/26/2016 12:00:00 PM,48,-122,17,16,33
18877,ElliotBayTrailMyrtlePark,02/26/2016 01:00:00 PM,48,-122,25,17,42
18878,ElliotBayTrailMyrtlePark,02/26/2016 02:00:00 PM,48,-122,22,16,38
18879,ElliotBayTrailMyrtlePark,02/26/2016 03:00:00 PM,48,-122,36,20,56
18880,ElliotBayTrailMyrtlePark,02/26/2016 04:00:00 PM,48,-122,54,21,75
18881,ElliotBayTrailMyrtlePark,02/26/2016 05:00:00 PM,48,-122,85,26,111
18882,ElliotBayTrailMyrtlePark,02/26/2016 06:00:00 PM,48,-122,66,6,72
18883,ElliotBayTrailMyrtlePark,02/26/2016 07:00:00 PM,48,-122,42,2,44
18884,ElliotBayTrailMyrtlePark,02/26/2016 08:00:00 PM,48,-122,5,1,6
18885,ElliotBayTrailMyrtlePark,02/26/2016 09:00:00 PM,48,-122,1,0,1
18886,ElliotBayTrailMyrtlePark,02/26/2016 10:00:00 PM,48,-122,2,2,4
18887,ElliotBayTrailMyrtlePark,02/26/2016 11:00:00 PM,48,-122,2,2,4
18888,ElliotBayTrailMyrtlePark,02/27/2016 12:00:00 AM,48,-122,1,0,1
18889,ElliotBayTrailMyrtlePark,02/27/2016 01:00:00 AM,48,-122,1,1,2
18890,ElliotBayTrailMyrtlePark,02/27/2016 02:00:00 AM,48,-122,0,0,0
18891,ElliotBayTrailMyrtlePark,02/27/2016 03:00:00 AM,48,-122,0,0,0
18892,ElliotBayTrailMyrtlePark,02/27/2016 04:00:00 AM,48,-122,1,0,1
18893,ElliotBayTrailMyrtlePark,02/27/2016 05:00:00 AM,48,-122,0,1,1
18894,ElliotBayTrailMyrtlePark,02/27/2016 06:00:00 AM,48,-122,1,5,6
18895,ElliotBayTrailMyrtlePark,02/27/2016 07:00:00 AM,48,-122,6,4,10
18896,ElliotBayTrailMyrtlePark,02/27/2016 08:00:00 AM,48,-122,3,11,14
18897,ElliotBayTrailMyrtlePark,02/27/2016 09:00:00 AM,48,-122,6,16,22
18898,ElliotBayTrailMyrtlePark,02/27/2016 10:00:00 AM,48,-122,10,18,28
18899,ElliotBayTrailMyrtlePark,02/27/2016 11:00:00 AM,48,-122,34,21,55
18900,ElliotBayTrailMyrtlePark,02/27/2016 12:00:00 PM,48,-122,23,32,55
18901,ElliotBayTrailMyrtlePark,02/27/2016 01:00:00 PM,48,-122,31,39,70
18902,ElliotBayTrailMyrtlePark,02/27/2016 02:00:00 PM,48,-122,57,37,94
18903,ElliotBayTrailMyrtlePark,02/27/2016 03:00:00 PM,48,-122,51,38,89
18904,ElliotBayTrailMyrtlePark,02/27/2016 04:00:00 PM,48,-122,36,39,75
18905,ElliotBayTrailMyrtlePark,02/27/2016 05:00:00 PM,48,-122,32,42,74
18906,ElliotBayTrailMyrtlePark,02/27/2016 06:00:00 PM,48,-122,22,18,40
18907,ElliotBayTrailMyrtlePark,02/27/2016 07:00:00 PM,48,-122,5,2,7
18908,ElliotBayTrailMyrtlePark,02/27/2016 08:00:00 PM,48,-122,4,3,7
18909,ElliotBayTrailMyrtlePark,02/27/2016 09:00:00 PM,48,-122,3,1,4
18910,ElliotBayTrailMyrtlePark,02/27/2016 10:00:00 PM,48,-122,1,4,5
18911,ElliotBayTrailMyrtlePark,02/27/2016 11:00:00 PM,48,-122,3,4,7
18912,ElliotBayTrailMyrtlePark,02/28/2016 12:00:00 AM,48,-122,2,1,3
18913,ElliotBayTrailMyrtlePark,02/28/2016 01:00:00 AM,48,-122,0,0,0
18914,ElliotBayTrailMyrtlePark,02/28/2016 02:00:00 AM,48,-122,0,0,0
18915,ElliotBayTrailMyrtlePark,02/28/2016 03:00:00 AM,48,-122,3,1,4
18916,ElliotBayTrailMyrtlePark,02/28/2016 04:00:00 AM,48,-122,0,0,0
18917,ElliotBayTrailMyrtlePark,02/28/2016 05:00:00 AM,48,-122,0,0,0
18918,ElliotBayTrailMyrtlePark,02/28/2016 06:00:00 AM,48,-122,0,7,7
18919,ElliotBayTrailMyrtlePark,02/28/2016 07:00:00 AM,48,-122,4,46,50
18920,ElliotBayTrailMyrtlePark,02/28/2016 08:00:00 AM,48,-122,6,48,54
18921,ElliotBayTrailMyrtlePark,02/28/2016 09:00:00 AM,48,-122,8,30,38
18922,ElliotBayTrailMyrtlePark,02/28/2016 10:00:00 AM,48,-122,12,21,33
18923,ElliotBayTrailMyrtlePark,02/28/2016 11:00:00 AM,48,-122,10,9,19
18924,ElliotBayTrailMyrtlePark,02/28/2016 12:00:00 PM,48,-122,19,14,33
18925,ElliotBayTrailMyrtlePark,02/28/2016 01:00:00 PM,48,-122,51,3,54
18926,ElliotBayTrailMyrtlePark,02/28/2016 02:00:00 PM,48,-122,57,3,60
18927,ElliotBayTrailMyrtlePark,02/28/2016 03:00:00 PM,48,-122,48,3,51
18928,ElliotBayTrailMyrtlePark,02/28/2016 04:00:00 PM,48,-122,35,6,41
18929,ElliotBayTrailMyrtlePark,02/28/2016 05:00:00 PM,48,-122,8,18,26
18930,ElliotBayTrailMyrtlePark,02/28/2016 06:00:00 PM,48,-122,8,5,13
18931,ElliotBayTrailMyrtlePark,02/28/2016 07:00:00 PM,48,-122,5,8,13
18932,ElliotBayTrailMyrtlePark,02/28/2016 08:00:00 PM,48,-122,0,0,0
18933,ElliotBayTrailMyrtlePark,02/28/2016 09:00:00 PM,48,-122,1,1,2
18934,ElliotBayTrailMyrtlePark,02/28/2016 10:00:00 PM,48,-122,0,1,1
18935,ElliotBayTrailMyrtlePark,02/28/2016 11:00:00 PM,48,-122,0,0,0
18936,ElliotBayTrailMyrtlePark,02/29/2016 12:00:00 AM,48,-122,0,0,0
18937,ElliotBayTrailMyrtlePark,02/29/2016 01:00:00 AM,48,-122,0,0,0
18938,ElliotBayTrailMyrtlePark,02/29/2016 02:00:00 AM,48,-122,0,0,0
18939,ElliotBayTrailMyrtlePark,02/29/2016 03:00:00 AM,48,-122,0,0,0
18940,ElliotBayTrailMyrtlePark,02/29/2016 04:00:00 AM,48,-122,0,0,0
18941,ElliotBayTrailMyrtlePark,02/29/2016 05:00:00 AM,48,-122,3,3,6
18942,ElliotBayTrailMyrtlePark,02/29/2016 06:00:00 AM,48,-122,10,19,29
18943,ElliotBayTrailMyrtlePark,02/29/2016 07:00:00 AM,48,-122,22,37,59
18944,ElliotBayTrailMyrtlePark,02/29/2016 08:00:00 AM,48,-122,28,96,124
18945,ElliotBayTrailMyrtlePark,02/29/2016 09:00:00 AM,48,-122,18,76,94
18946,ElliotBayTrailMyrtlePark,02/29/2016 10:00:00 AM,48,-122,8,16,24
18947,ElliotBayTrailMyrtlePark,02/29/2016 11:00:00 AM,48,-122,20,19,39
18948,ElliotBayTrailMyrtlePark,02/29/2016 12:00:00 PM,48,-122,20,11,31
18949,ElliotBayTrailMyrtlePark,02/29/2016 01:00:00 PM,48,-122,27,17,44
18950,ElliotBayTrailMyrtlePark,02/29/2016 02:00:00 PM,48,-122,14,19,33
18951,ElliotBayTrailMyrtlePark,02/29/2016 03:00:00 PM,48,-122,21,20,41
18952,ElliotBayTrailMyrtlePark,02/29/2016 04:00:00 PM,48,-122,36,24,60
18953,ElliotBayTrailMyrtlePark,02/29/2016 05:00:00 PM,48,-122,114,42,156
18954,ElliotBayTrailMyrtlePark,02/29/2016 06:00:00 PM,48,-122,110,32,142
18955,ElliotBayTrailMyrtlePark,02/29/2016 07:00:00 PM,48,-122,28,8,36
18956,ElliotBayTrailMyrtlePark,02/29/2016 08:00:00 PM,48,-122,8,4,12
18957,ElliotBayTrailMyrtlePark,02/29/2016 09:00:00 PM,48,-122,8,2,10
18958,ElliotBayTrailMyrtlePark,02/29/2016 10:00:00 PM,48,-122,3,1,4
18959,ElliotBayTrailMyrtlePark,02/29/2016 11:00:00 PM,48,-122,2,1,3
18960,ElliotBayTrailMyrtlePark,03/01/2016 12:00:00 AM,48,-122,1,0,1
18961,ElliotBayTrailMyrtlePark,03/01/2016 01:00:00 AM,48,-122,0,0,0
18962,ElliotBayTrailMyrtlePark,03/01/2016 02:00:00 AM,48,-122,0,0,0
18963,ElliotBayTrailMyrtlePark,03/01/2016 03:00:00 AM,48,-122,2,0,2
18964,ElliotBayTrailMyrtlePark,03/01/2016 04:00:00 AM,48,-122,0,0,0
18965,ElliotBayTrailMyrtlePark,03/01/2016 05:00:00 AM,48,-122,3,2,5
18966,ElliotBayTrailMyrtlePark,03/01/2016 06:00:00 AM,48,-122,8,12,20
18967,ElliotBayTrailMyrtlePark,03/01/2016 07:00:00 AM,48,-122,17,24,41
18968,ElliotBayTrailMyrtlePark,03/01/2016 08:00:00 AM,48,-122,14,81,95
18969,ElliotBayTrailMyrtlePark,03/01/2016 09:00:00 AM,48,-122,18,64,82
18970,ElliotBayTrailMyrtlePark,03/01/2016 10:00:00 AM,48,-122,7,13,20
18971,ElliotBayTrailMyrtlePark,03/01/2016 11:00:00 AM,48,-122,13,5,18
18972,ElliotBayTrailMyrtlePark,03/01/2016 12:00:00 PM,48,-122,9,8,17
18973,ElliotBayTrailMyrtlePark,03/01/2016 01:00:00 PM,48,-122,3,4,7
18974,ElliotBayTrailMyrtlePark,03/01/2016 02:00:00 PM,48,-122,2,6,8
18975,ElliotBayTrailMyrtlePark,03/01/2016 03:00:00 PM,48,-122,7,10,17
18976,ElliotBayTrailMyrtlePark,03/01/2016 04:00:00 PM,48,-122,13,14,27
18977,ElliotBayTrailMyrtlePark,03/01/2016 05:00:00 PM,48,-122,75,21,96
18978,ElliotBayTrailMyrtlePark,03/01/2016 06:00:00 PM,48,-122,76,15,91
18979,ElliotBayTrailMyrtlePark,03/01/2016 07:00:00 PM,48,-122,22,4,26
18980,ElliotBayTrailMyrtlePark,03/01/2016 08:00:00 PM,48,-122,5,0,5
18981,ElliotBayTrailMyrtlePark,03/01/2016 09:00:00 PM,48,-122,2,2,4
18982,ElliotBayTrailMyrtlePark,03/01/2016 10:00:00 PM,48,-122,5,1,6
18983,ElliotBayTrailMyrtlePark,03/01/2016 11:00:00 PM,48,-122,0,0,0
18984,ElliotBayTrailMyrtlePark,03/02/2016 12:00:00 AM,48,-122,0,0,0
18985,ElliotBayTrailMyrtlePark,03/02/2016 01:00:00 AM,48,-122,0,0,0
18986,ElliotBayTrailMyrtlePark,03/02/2016 02:00:00 AM,48,-122,0,0,0
18987,ElliotBayTrailMyrtlePark,03/02/2016 03:00:00 AM,48,-122,2,0,2
18988,ElliotBayTrailMyrtlePark,03/02/2016 04:00:00 AM,48,-122,0,0,0
18989,ElliotBayTrailMyrtlePark,03/02/2016 05:00:00 AM,48,-122,3,1,4
18990,ElliotBayTrailMyrtlePark,03/02/2016 06:00:00 AM,48,-122,11,13,24
18991,ElliotBayTrailMyrtlePark,03/02/2016 07:00:00 AM,48,-122,30,36,66
18992,ElliotBayTrailMyrtlePark,03/02/2016 08:00:00 AM,48,-122,30,112,142
18993,ElliotBayTrailMyrtlePark,03/02/2016 09:00:00 AM,48,-122,21,81,102
18994,ElliotBayTrailMyrtlePark,03/02/2016 10:00:00 AM,48,-122,13,22,35
18995,ElliotBayTrailMyrtlePark,03/02/2016 11:00:00 AM,48,-122,14,15,29
18996,ElliotBayTrailMyrtlePark,03/02/2016 12:00:00 PM,48,-122,13,11,24
18997,ElliotBayTrailMyrtlePark,03/02/2016 01:00:00 PM,48,-122,11,18,29
18998,ElliotBayTrailMyrtlePark,03/02/2016 02:00:00 PM,48,-122,17,12,29
18999,ElliotBayTrailMyrtlePark,03/02/2016 03:00:00 PM,48,-122,15,16,31
19000,ElliotBayTrailMyrtlePark,03/02/2016 04:00:00 PM,48,-122,35,24,59
19001,ElliotBayTrailMyrtlePark,03/02/2016 05:00:00 PM,48,-122,89,29,118
19002,ElliotBayTrailMyrtlePark,03/02/2016 06:00:00 PM,48,-122,103,18,121
19003,ElliotBayTrailMyrtlePark,03/02/2016 07:00:00 PM,48,-122,34,3,37
19004,ElliotBayTrailMyrtlePark,03/02/2016 08:00:00 PM,48,-122,11,2,13
19005,ElliotBayTrailMyrtlePark,03/02/2016 09:00:00 PM,48,-122,4,1,5
19006,ElliotBayTrailMyrtlePark,03/02/2016 10:00:00 PM,48,-122,4,12,16
19007,ElliotBayTrailMyrtlePark,03/02/2016 11:00:00 PM,48,-122,1,1,2
19008,ElliotBayTrailMyrtlePark,03/03/2016 12:00:00 AM,48,-122,3,0,3
19009,ElliotBayTrailMyrtlePark,03/03/2016 01:00:00 AM,48,-122,0,0,0
19010,ElliotBayTrailMyrtlePark,03/03/2016 02:00:00 AM,48,-122,0,0,0
19011,ElliotBayTrailMyrtlePark,03/03/2016 03:00:00 AM,48,-122,1,0,1
19012,ElliotBayTrailMyrtlePark,03/03/2016 04:00:00 AM,48,-122,2,0,2
19013,ElliotBayTrailMyrtlePark,03/03/2016 05:00:00 AM,48,-122,8,0,8
19014,ElliotBayTrailMyrtlePark,03/03/2016 06:00:00 AM,48,-122,8,20,28
19015,ElliotBayTrailMyrtlePark,03/03/2016 07:00:00 AM,48,-122,20,31,51
19016,ElliotBayTrailMyrtlePark,03/03/2016 08:00:00 AM,48,-122,14,95,109
19017,ElliotBayTrailMyrtlePark,03/03/2016 09:00:00 AM,48,-122,23,72,95
19018,ElliotBayTrailMyrtlePark,03/03/2016 10:00:00 AM,48,-122,13,23,36
19019,ElliotBayTrailMyrtlePark,03/03/2016 11:00:00 AM,48,-122,13,13,26
19020,ElliotBayTrailMyrtlePark,03/03/2016 12:00:00 PM,48,-122,10,6,16
19021,ElliotBayTrailMyrtlePark,03/03/2016 01:00:00 PM,48,-122,9,11,20
19022,ElliotBayTrailMyrtlePark,03/03/2016 02:00:00 PM,48,-122,10,3,13
19023,ElliotBayTrailMyrtlePark,03/03/2016 03:00:00 PM,48,-122,13,15,28
19024,ElliotBayTrailMyrtlePark,03/03/2016 04:00:00 PM,48,-122,39,21,60
19025,ElliotBayTrailMyrtlePark,03/03/2016 05:00:00 PM,48,-122,96,35,131
19026,ElliotBayTrailMyrtlePark,03/03/2016 06:00:00 PM,48,-122,94,30,124
19027,ElliotBayTrailMyrtlePark,03/03/2016 07:00:00 PM,48,-122,37,2,39
19028,ElliotBayTrailMyrtlePark,03/03/2016 08:00:00 PM,48,-122,6,4,10
19029,ElliotBayTrailMyrtlePark,03/03/2016 09:00:00 PM,48,-122,5,5,10
19030,ElliotBayTrailMyrtlePark,03/03/2016 10:00:00 PM,48,-122,3,3,6
19031,ElliotBayTrailMyrtlePark,03/03/2016 11:00:00 PM,48,-122,3,0,3
19032,ElliotBayTrailMyrtlePark,03/04/2016 12:00:00 AM,48,-122,1,0,1
19033,ElliotBayTrailMyrtlePark,03/04/2016 01:00:00 AM,48,-122,0,0,0
19034,ElliotBayTrailMyrtlePark,03/04/2016 02:00:00 AM,48,-122,1,0,1
19035,ElliotBayTrailMyrtlePark,03/04/2016 03:00:00 AM,48,-122,0,0,0
19036,ElliotBayTrailMyrtlePark,03/04/2016 04:00:00 AM,48,-122,1,0,1
19037,ElliotBayTrailMyrtlePark,03/04/2016 05:00:00 AM,48,-122,5,5,10
19038,ElliotBayTrailMyrtlePark,03/04/2016 06:00:00 AM,48,-122,10,12,22
19039,ElliotBayTrailMyrtlePark,03/04/2016 07:00:00 AM,48,-122,17,39,56
19040,ElliotBayTrailMyrtlePark,03/04/2016 08:00:00 AM,48,-122,22,109,131
19041,ElliotBayTrailMyrtlePark,03/04/2016 09:00:00 AM,48,-122,19,59,78
19042,ElliotBayTrailMyrtlePark,03/04/2016 10:00:00 AM,48,-122,11,23,34
19043,ElliotBayTrailMyrtlePark,03/04/2016 11:00:00 AM,48,-122,12,7,19
19044,ElliotBayTrailMyrtlePark,03/04/2016 12:00:00 PM,48,-122,13,10,23
19045,ElliotBayTrailMyrtlePark,03/04/2016 01:00:00 PM,48,-122,16,11,27
19046,ElliotBayTrailMyrtlePark,03/04/2016 02:00:00 PM,48,-122,18,10,28
19047,ElliotBayTrailMyrtlePark,03/04/2016 03:00:00 PM,48,-122,18,10,28
19048,ElliotBayTrailMyrtlePark,03/04/2016 04:00:00 PM,48,-122,35,21,56
19049,ElliotBayTrailMyrtlePark,03/04/2016 05:00:00 PM,48,-122,94,27,121
19050,ElliotBayTrailMyrtlePark,03/04/2016 06:00:00 PM,48,-122,64,8,72
19051,ElliotBayTrailMyrtlePark,03/04/2016 07:00:00 PM,48,-122,20,5,25
19052,ElliotBayTrailMyrtlePark,03/04/2016 08:00:00 PM,48,-122,4,0,4
19053,ElliotBayTrailMyrtlePark,03/04/2016 09:00:00 PM,48,-122,3,1,4
19054,ElliotBayTrailMyrtlePark,03/04/2016 10:00:00 PM,48,-122,2,7,9
19055,ElliotBayTrailMyrtlePark,03/04/2016 11:00:00 PM,48,-122,0,0,0
19056,ElliotBayTrailMyrtlePark,03/05/2016 12:00:00 AM,48,-122,1,1,2
19057,ElliotBayTrailMyrtlePark,03/05/2016 01:00:00 AM,48,-122,1,0,1
19058,ElliotBayTrailMyrtlePark,03/05/2016 02:00:00 AM,48,-122,0,0,0
19059,ElliotBayTrailMyrtlePark,03/05/2016 03:00:00 AM,48,-122,1,0,1
19060,ElliotBayTrailMyrtlePark,03/05/2016 04:00:00 AM,48,-122,0,0,0
19061,ElliotBayTrailMyrtlePark,03/05/2016 05:00:00 AM,48,-122,1,0,1
19062,ElliotBayTrailMyrtlePark,03/05/2016 06:00:00 AM,48,-122,0,5,5
19063,ElliotBayTrailMyrtlePark,03/05/2016 07:00:00 AM,48,-122,4,3,7
19064,ElliotBayTrailMyrtlePark,03/05/2016 08:00:00 AM,48,-122,14,13,27
19065,ElliotBayTrailMyrtlePark,03/05/2016 09:00:00 AM,48,-122,22,20,42
19066,ElliotBayTrailMyrtlePark,03/05/2016 10:00:00 AM,48,-122,26,44,70
19067,ElliotBayTrailMyrtlePark,03/05/2016 11:00:00 AM,48,-122,50,31,81
19068,ElliotBayTrailMyrtlePark,03/05/2016 12:00:00 PM,48,-122,51,59,110
19069,ElliotBayTrailMyrtlePark,03/05/2016 01:00:00 PM,48,-122,66,77,143
19070,ElliotBayTrailMyrtlePark,03/05/2016 02:00:00 PM,48,-122,88,72,160
19071,ElliotBayTrailMyrtlePark,03/05/2016 03:00:00 PM,48,-122,77,80,157
19072,ElliotBayTrailMyrtlePark,03/05/2016 04:00:00 PM,48,-122,62,57,119
19073,ElliotBayTrailMyrtlePark,03/05/2016 05:00:00 PM,48,-122,44,24,68
19074,ElliotBayTrailMyrtlePark,03/05/2016 06:00:00 PM,48,-122,21,13,34
19075,ElliotBayTrailMyrtlePark,03/05/2016 07:00:00 PM,48,-122,9,11,20
19076,ElliotBayTrailMyrtlePark,03/05/2016 08:00:00 PM,48,-122,0,3,3
19077,ElliotBayTrailMyrtlePark,03/05/2016 09:00:00 PM,48,-122,9,4,13
19078,ElliotBayTrailMyrtlePark,03/05/2016 10:00:00 PM,48,-122,3,1,4
19079,ElliotBayTrailMyrtlePark,03/05/2016 11:00:00 PM,48,-122,1,0,1
19080,ElliotBayTrailMyrtlePark,03/06/2016 12:00:00 AM,48,-122,3,1,4
19081,ElliotBayTrailMyrtlePark,03/06/2016 01:00:00 AM,48,-122,1,2,3
19082,ElliotBayTrailMyrtlePark,03/06/2016 02:00:00 AM,48,-122,0,1,1
19083,ElliotBayTrailMyrtlePark,03/06/2016 03:00:00 AM,48,-122,1,0,1
19084,ElliotBayTrailMyrtlePark,03/06/2016 04:00:00 AM,48,-122,0,0,0
19085,ElliotBayTrailMyrtlePark,03/06/2016 05:00:00 AM,48,-122,0,0,0
19086,ElliotBayTrailMyrtlePark,03/06/2016 06:00:00 AM,48,-122,0,3,3
19087,ElliotBayTrailMyrtlePark,03/06/2016 07:00:00 AM,48,-122,6,3,9
19088,ElliotBayTrailMyrtlePark,03/06/2016 08:00:00 AM,48,-122,5,7,12
19089,ElliotBayTrailMyrtlePark,03/06/2016 09:00:00 AM,48,-122,10,9,19
19090,ElliotBayTrailMyrtlePark,03/06/2016 10:00:00 AM,48,-122,9,13,22
19091,ElliotBayTrailMyrtlePark,03/06/2016 11:00:00 AM,48,-122,4,13,17
19092,ElliotBayTrailMyrtlePark,03/06/2016 12:00:00 PM,48,-122,16,18,34
19093,ElliotBayTrailMyrtlePark,03/06/2016 01:00:00 PM,48,-122,11,8,19
19094,ElliotBayTrailMyrtlePark,03/06/2016 02:00:00 PM,48,-122,18,9,27
19095,ElliotBayTrailMyrtlePark,03/06/2016 03:00:00 PM,48,-122,17,15,32
19096,ElliotBayTrailMyrtlePark,03/06/2016 04:00:00 PM,48,-122,29,16,45
19097,ElliotBayTrailMyrtlePark,03/06/2016 05:00:00 PM,48,-122,18,16,34
19098,ElliotBayTrailMyrtlePark,03/06/2016 06:00:00 PM,48,-122,6,6,12
19099,ElliotBayTrailMyrtlePark,03/06/2016 07:00:00 PM,48,-122,6,3,9
19100,ElliotBayTrailMyrtlePark,03/06/2016 08:00:00 PM,48,-122,1,1,2
19101,ElliotBayTrailMyrtlePark,03/06/2016 09:00:00 PM,48,-122,2,1,3
19102,ElliotBayTrailMyrtlePark,03/06/2016 10:00:00 PM,48,-122,0,1,1
19103,ElliotBayTrailMyrtlePark,03/06/2016 11:00:00 PM,48,-122,0,1,1
19104,ElliotBayTrailMyrtlePark,03/07/2016 12:00:00 AM,48,-122,2,0,2
19105,ElliotBayTrailMyrtlePark,03/07/2016 01:00:00 AM,48,-122,0,0,0
19106,ElliotBayTrailMyrtlePark,03/07/2016 02:00:00 AM,48,-122,0,0,0
19107,ElliotBayTrailMyrtlePark,03/07/2016 03:00:00 AM,48,-122,0,0,0
19108,ElliotBayTrailMyrtlePark,03/07/2016 04:00:00 AM,48,-122,0,0,0
19109,ElliotBayTrailMyrtlePark,03/07/2016 05:00:00 AM,48,-122,4,2,6
19110,ElliotBayTrailMyrtlePark,03/07/2016 06:00:00 AM,48,-122,6,15,21
19111,ElliotBayTrailMyrtlePark,03/07/2016 07:00:00 AM,48,-122,19,32,51
19112,ElliotBayTrailMyrtlePark,03/07/2016 08:00:00 AM,48,-122,17,91,108
19113,ElliotBayTrailMyrtlePark,03/07/2016 09:00:00 AM,48,-122,13,47,60
19114,ElliotBayTrailMyrtlePark,03/07/2016 10:00:00 AM,48,-122,5,11,16
19115,ElliotBayTrailMyrtlePark,03/07/2016 11:00:00 AM,48,-122,9,8,17
19116,ElliotBayTrailMyrtlePark,03/07/2016 12:00:00 PM,48,-122,9,8,17
19117,ElliotBayTrailMyrtlePark,03/07/2016 01:00:00 PM,48,-122,6,7,13
19118,ElliotBayTrailMyrtlePark,03/07/2016 02:00:00 PM,48,-122,7,4,11
19119,ElliotBayTrailMyrtlePark,03/07/2016 03:00:00 PM,48,-122,19,12,31
19120,ElliotBayTrailMyrtlePark,03/07/2016 04:00:00 PM,48,-122,33,19,52
19121,ElliotBayTrailMyrtlePark,03/07/2016 05:00:00 PM,48,-122,100,35,135
19122,ElliotBayTrailMyrtlePark,03/07/2016 06:00:00 PM,48,-122,92,29,121
19123,ElliotBayTrailMyrtlePark,03/07/2016 07:00:00 PM,48,-122,29,7,36
19124,ElliotBayTrailMyrtlePark,03/07/2016 08:00:00 PM,48,-122,9,2,11
19125,ElliotBayTrailMyrtlePark,03/07/2016 09:00:00 PM,48,-122,9,2,11
19126,ElliotBayTrailMyrtlePark,03/07/2016 10:00:00 PM,48,-122,4,3,7
19127,ElliotBayTrailMyrtlePark,03/07/2016 11:00:00 PM,48,-122,2,0,2
19128,ElliotBayTrailMyrtlePark,03/08/2016 12:00:00 AM,48,-122,1,0,1
19129,ElliotBayTrailMyrtlePark,03/08/2016 01:00:00 AM,48,-122,0,2,2
19130,ElliotBayTrailMyrtlePark,03/08/2016 02:00:00 AM,48,-122,1,0,1
19131,ElliotBayTrailMyrtlePark,03/08/2016 03:00:00 AM,48,-122,0,0,0
19132,ElliotBayTrailMyrtlePark,03/08/2016 04:00:00 AM,48,-122,1,0,1
19133,ElliotBayTrailMyrtlePark,03/08/2016 05:00:00 AM,48,-122,3,2,5
19134,ElliotBayTrailMyrtlePark,03/08/2016 06:00:00 AM,48,-122,12,17,29
19135,ElliotBayTrailMyrtlePark,03/08/2016 07:00:00 AM,48,-122,23,45,68
19136,ElliotBayTrailMyrtlePark,03/08/2016 08:00:00 AM,48,-122,31,128,159
19137,ElliotBayTrailMyrtlePark,03/08/2016 09:00:00 AM,48,-122,19,76,95
19138,ElliotBayTrailMyrtlePark,03/08/2016 10:00:00 AM,48,-122,14,14,28
19139,ElliotBayTrailMyrtlePark,03/08/2016 11:00:00 AM,48,-122,13,12,25
19140,ElliotBayTrailMyrtlePark,03/08/2016 12:00:00 PM,48,-122,16,8,24
19141,ElliotBayTrailMyrtlePark,03/08/2016 01:00:00 PM,48,-122,5,14,19
19142,ElliotBayTrailMyrtlePark,03/08/2016 02:00:00 PM,48,-122,20,18,38
19143,ElliotBayTrailMyrtlePark,03/08/2016 03:00:00 PM,48,-122,16,13,29
19144,ElliotBayTrailMyrtlePark,03/08/2016 04:00:00 PM,48,-122,49,37,86
19145,ElliotBayTrailMyrtlePark,03/08/2016 05:00:00 PM,48,-122,112,44,156
19146,ElliotBayTrailMyrtlePark,03/08/2016 06:00:00 PM,48,-122,113,25,138
19147,ElliotBayTrailMyrtlePark,03/08/2016 07:00:00 PM,48,-122,32,3,35
19148,ElliotBayTrailMyrtlePark,03/08/2016 08:00:00 PM,48,-122,3,6,9
19149,ElliotBayTrailMyrtlePark,03/08/2016 09:00:00 PM,48,-122,14,3,17
19150,ElliotBayTrailMyrtlePark,03/08/2016 10:00:00 PM,48,-122,2,2,4
19151,ElliotBayTrailMyrtlePark,03/08/2016 11:00:00 PM,48,-122,2,2,4
19152,ElliotBayTrailMyrtlePark,03/09/2016 12:00:00 AM,48,-122,0,0,0
19153,ElliotBayTrailMyrtlePark,03/09/2016 01:00:00 AM,48,-122,0,0,0
19154,ElliotBayTrailMyrtlePark,03/09/2016 02:00:00 AM,48,-122,0,0,0
19155,ElliotBayTrailMyrtlePark,03/09/2016 03:00:00 AM,48,-122,0,0,0
19156,ElliotBayTrailMyrtlePark,03/09/2016 04:00:00 AM,48,-122,1,0,1
19157,ElliotBayTrailMyrtlePark,03/09/2016 05:00:00 AM,48,-122,2,6,8
19158,ElliotBayTrailMyrtlePark,03/09/2016 06:00:00 AM,48,-122,8,12,20
19159,ElliotBayTrailMyrtlePark,03/09/2016 07:00:00 AM,48,-122,22,54,76
19160,ElliotBayTrailMyrtlePark,03/09/2016 08:00:00 AM,48,-122,28,91,119
19161,ElliotBayTrailMyrtlePark,03/09/2016 09:00:00 AM,48,-122,18,64,82
19162,ElliotBayTrailMyrtlePark,03/09/2016 10:00:00 AM,48,-122,12,18,30
19163,ElliotBayTrailMyrtlePark,03/09/2016 11:00:00 AM,48,-122,6,13,19
19164,ElliotBayTrailMyrtlePark,03/09/2016 12:00:00 PM,48,-122,12,7,19
19165,ElliotBayTrailMyrtlePark,03/09/2016 01:00:00 PM,48,-122,5,10,15
19166,ElliotBayTrailMyrtlePark,03/09/2016 02:00:00 PM,48,-122,6,1,7
19167,ElliotBayTrailMyrtlePark,03/09/2016 03:00:00 PM,48,-122,7,12,19
19168,ElliotBayTrailMyrtlePark,03/09/2016 04:00:00 PM,48,-122,18,15,33
19169,ElliotBayTrailMyrtlePark,03/09/2016 05:00:00 PM,48,-122,71,21,92
19170,ElliotBayTrailMyrtlePark,03/09/2016 06:00:00 PM,48,-122,73,14,87
19171,ElliotBayTrailMyrtlePark,03/09/2016 07:00:00 PM,48,-122,25,1,26
19172,ElliotBayTrailMyrtlePark,03/09/2016 08:00:00 PM,48,-122,6,0,6
19173,ElliotBayTrailMyrtlePark,03/09/2016 09:00:00 PM,48,-122,1,0,1
19174,ElliotBayTrailMyrtlePark,03/09/2016 10:00:00 PM,48,-122,2,1,3
19175,ElliotBayTrailMyrtlePark,03/09/2016 11:00:00 PM,48,-122,1,0,1
19176,ElliotBayTrailMyrtlePark,03/10/2016 12:00:00 AM,48,-122,3,0,3
19177,ElliotBayTrailMyrtlePark,03/10/2016 01:00:00 AM,48,-122,1,0,1
19178,ElliotBayTrailMyrtlePark,03/10/2016 02:00:00 AM,48,-122,1,0,1
19179,ElliotBayTrailMyrtlePark,03/10/2016 03:00:00 AM,48,-122,1,0,1
19180,ElliotBayTrailMyrtlePark,03/10/2016 04:00:00 AM,48,-122,0,0,0
19181,ElliotBayTrailMyrtlePark,03/10/2016 05:00:00 AM,48,-122,2,0,2
19182,ElliotBayTrailMyrtlePark,03/10/2016 06:00:00 AM,48,-122,4,9,13
19183,ElliotBayTrailMyrtlePark,03/10/2016 07:00:00 AM,48,-122,10,23,33
19184,ElliotBayTrailMyrtlePark,03/10/2016 08:00:00 AM,48,-122,21,61,82
19185,ElliotBayTrailMyrtlePark,03/10/2016 09:00:00 AM,48,-122,18,53,71
19186,ElliotBayTrailMyrtlePark,03/10/2016 10:00:00 AM,48,-122,12,17,29
19187,ElliotBayTrailMyrtlePark,03/10/2016 11:00:00 AM,48,-122,4,9,13
19188,ElliotBayTrailMyrtlePark,03/10/2016 12:00:00 PM,48,-122,10,6,16
19189,ElliotBayTrailMyrtlePark,03/10/2016 01:00:00 PM,48,-122,6,8,14
19190,ElliotBayTrailMyrtlePark,03/10/2016 02:00:00 PM,48,-122,3,6,9
19191,ElliotBayTrailMyrtlePark,03/10/2016 03:00:00 PM,48,-122,10,10,20
19192,ElliotBayTrailMyrtlePark,03/10/2016 04:00:00 PM,48,-122,23,11,34
19193,ElliotBayTrailMyrtlePark,03/10/2016 05:00:00 PM,48,-122,81,28,109
19194,ElliotBayTrailMyrtlePark,03/10/2016 06:00:00 PM,48,-122,80,32,112
19195,ElliotBayTrailMyrtlePark,03/10/2016 07:00:00 PM,48,-122,29,4,33
19196,ElliotBayTrailMyrtlePark,03/10/2016 08:00:00 PM,48,-122,5,0,5
19197,ElliotBayTrailMyrtlePark,03/10/2016 09:00:00 PM,48,-122,2,4,6
19198,ElliotBayTrailMyrtlePark,03/10/2016 10:00:00 PM,48,-122,4,1,5
19199,ElliotBayTrailMyrtlePark,03/10/2016 11:00:00 PM,48,-122,2,0,2
19200,ElliotBayTrailMyrtlePark,03/11/2016 12:00:00 AM,48,-122,1,1,2
19201,ElliotBayTrailMyrtlePark,03/11/2016 01:00:00 AM,48,-122,0,0,0
19202,ElliotBayTrailMyrtlePark,03/11/2016 02:00:00 AM,48,-122,2,0,2
19203,ElliotBayTrailMyrtlePark,03/11/2016 03:00:00 AM,48,-122,2,1,3
19204,ElliotBayTrailMyrtlePark,03/11/2016 04:00:00 AM,48,-122,0,0,0
19205,ElliotBayTrailMyrtlePark,03/11/2016 05:00:00 AM,48,-122,4,5,9
19206,ElliotBayTrailMyrtlePark,03/11/2016 06:00:00 AM,48,-122,8,9,17
19207,ElliotBayTrailMyrtlePark,03/11/2016 07:00:00 AM,48,-122,18,43,61
19208,ElliotBayTrailMyrtlePark,03/11/2016 08:00:00 AM,48,-122,22,92,114
19209,ElliotBayTrailMyrtlePark,03/11/2016 09:00:00 AM,48,-122,22,64,86
19210,ElliotBayTrailMyrtlePark,03/11/2016 10:00:00 AM,48,-122,19,24,43
19211,ElliotBayTrailMyrtlePark,03/11/2016 11:00:00 AM,48,-122,29,17,46
19212,ElliotBayTrailMyrtlePark,03/11/2016 12:00:00 PM,48,-122,30,21,51
19213,ElliotBayTrailMyrtlePark,03/11/2016 01:00:00 PM,48,-122,16,16,32
19214,ElliotBayTrailMyrtlePark,03/11/2016 02:00:00 PM,48,-122,17,10,27
19215,ElliotBayTrailMyrtlePark,03/11/2016 03:00:00 PM,48,-122,19,6,25
19216,ElliotBayTrailMyrtlePark,03/11/2016 04:00:00 PM,48,-122,39,14,53
19217,ElliotBayTrailMyrtlePark,03/11/2016 05:00:00 PM,48,-122,97,22,119
19218,ElliotBayTrailMyrtlePark,03/11/2016 06:00:00 PM,48,-122,75,11,86
19219,ElliotBayTrailMyrtlePark,03/11/2016 07:00:00 PM,48,-122,28,1,29
19220,ElliotBayTrailMyrtlePark,03/11/2016 08:00:00 PM,48,-122,7,0,7
19221,ElliotBayTrailMyrtlePark,03/11/2016 09:00:00 PM,48,-122,3,2,5
19222,ElliotBayTrailMyrtlePark,03/11/2016 10:00:00 PM,48,-122,1,4,5
19223,ElliotBayTrailMyrtlePark,03/11/2016 11:00:00 PM,48,-122,2,1,3
19224,ElliotBayTrailMyrtlePark,03/12/2016 12:00:00 AM,48,-122,0,1,1
19225,ElliotBayTrailMyrtlePark,03/12/2016 01:00:00 AM,48,-122,1,0,1
19226,ElliotBayTrailMyrtlePark,03/12/2016 02:00:00 AM,48,-122,0,0,0
19227,ElliotBayTrailMyrtlePark,03/12/2016 03:00:00 AM,48,-122,0,0,0
19228,ElliotBayTrailMyrtlePark,03/12/2016 04:00:00 AM,48,-122,1,0,1
19229,ElliotBayTrailMyrtlePark,03/12/2016 05:00:00 AM,48,-122,0,1,1
19230,ElliotBayTrailMyrtlePark,03/12/2016 06:00:00 AM,48,-122,0,2,2
19231,ElliotBayTrailMyrtlePark,03/12/2016 07:00:00 AM,48,-122,2,3,5
19232,ElliotBayTrailMyrtlePark,03/12/2016 08:00:00 AM,48,-122,4,0,4
19233,ElliotBayTrailMyrtlePark,03/12/2016 09:00:00 AM,48,-122,5,11,16
19234,ElliotBayTrailMyrtlePark,03/12/2016 10:00:00 AM,48,-122,5,6,11
19235,ElliotBayTrailMyrtlePark,03/12/2016 11:00:00 AM,48,-122,9,17,26
19236,ElliotBayTrailMyrtlePark,03/12/2016 12:00:00 PM,48,-122,18,17,35
19237,ElliotBayTrailMyrtlePark,03/12/2016 01:00:00 PM,48,-122,24,30,54
19238,ElliotBayTrailMyrtlePark,03/12/2016 02:00:00 PM,48,-122,17,15,32
19239,ElliotBayTrailMyrtlePark,03/12/2016 03:00:00 PM,48,-122,18,10,28
19240,ElliotBayTrailMyrtlePark,03/12/2016 04:00:00 PM,48,-122,10,7,17
19241,ElliotBayTrailMyrtlePark,03/12/2016 05:00:00 PM,48,-122,12,9,21
19242,ElliotBayTrailMyrtlePark,03/12/2016 06:00:00 PM,48,-122,5,3,8
19243,ElliotBayTrailMyrtlePark,03/12/2016 07:00:00 PM,48,-122,4,0,4
19244,ElliotBayTrailMyrtlePark,03/12/2016 08:00:00 PM,48,-122,5,2,7
19245,ElliotBayTrailMyrtlePark,03/12/2016 09:00:00 PM,48,-122,1,1,2
19246,ElliotBayTrailMyrtlePark,03/12/2016 10:00:00 PM,48,-122,0,2,2
19247,ElliotBayTrailMyrtlePark,03/12/2016 11:00:00 PM,48,-122,1,2,3
19248,ElliotBayTrailMyrtlePark,03/13/2016 12:00:00 AM,48,-122,2,0,2
19249,ElliotBayTrailMyrtlePark,03/13/2016 01:00:00 AM,48,-122,0,0,0
19250,ElliotBayTrailMyrtlePark,03/13/2016 02:00:00 AM,48,-122,,,
19251,ElliotBayTrailMyrtlePark,03/13/2016 03:00:00 AM,48,-122,0,0,0
19252,ElliotBayTrailMyrtlePark,03/13/2016 04:00:00 AM,48,-122,1,0,1
19253,ElliotBayTrailMyrtlePark,03/13/2016 05:00:00 AM,48,-122,0,1,1
19254,ElliotBayTrailMyrtlePark,03/13/2016 06:00:00 AM,48,-122,0,3,3
19255,ElliotBayTrailMyrtlePark,03/13/2016 07:00:00 AM,48,-122,1,0,1
19256,ElliotBayTrailMyrtlePark,03/13/2016 08:00:00 AM,48,-122,3,2,5
19257,ElliotBayTrailMyrtlePark,03/13/2016 09:00:00 AM,48,-122,4,4,8
19258,ElliotBayTrailMyrtlePark,03/13/2016 10:00:00 AM,48,-122,7,1,8
19259,ElliotBayTrailMyrtlePark,03/13/2016 11:00:00 AM,48,-122,3,8,11
19260,ElliotBayTrailMyrtlePark,03/13/2016 12:00:00 PM,48,-122,2,3,5
19261,ElliotBayTrailMyrtlePark,03/13/2016 01:00:00 PM,48,-122,5,12,17
19262,ElliotBayTrailMyrtlePark,03/13/2016 02:00:00 PM,48,-122,7,5,12
19263,ElliotBayTrailMyrtlePark,03/13/2016 03:00:00 PM,48,-122,4,5,9
19264,ElliotBayTrailMyrtlePark,03/13/2016 04:00:00 PM,48,-122,4,2,6
19265,ElliotBayTrailMyrtlePark,03/13/2016 05:00:00 PM,48,-122,4,2,6
19266,ElliotBayTrailMyrtlePark,03/13/2016 06:00:00 PM,48,-122,3,3,6
19267,ElliotBayTrailMyrtlePark,03/13/2016 07:00:00 PM,48,-122,3,2,5
19268,ElliotBayTrailMyrtlePark,03/13/2016 08:00:00 PM,48,-122,2,1,3
19269,ElliotBayTrailMyrtlePark,03/13/2016 09:00:00 PM,48,-122,0,1,1
19270,ElliotBayTrailMyrtlePark,03/13/2016 10:00:00 PM,48,-122,0,0,0
19271,ElliotBayTrailMyrtlePark,03/13/2016 11:00:00 PM,48,-122,0,0,0
19272,ElliotBayTrailMyrtlePark,03/14/2016 12:00:00 AM,48,-122,0,1,1
19273,ElliotBayTrailMyrtlePark,03/14/2016 01:00:00 AM,48,-122,0,0,0
19274,ElliotBayTrailMyrtlePark,03/14/2016 02:00:00 AM,48,-122,0,0,0
19275,ElliotBayTrailMyrtlePark,03/14/2016 03:00:00 AM,48,-122,0,0,0
19276,ElliotBayTrailMyrtlePark,03/14/2016 04:00:00 AM,48,-122,0,0,0
19277,ElliotBayTrailMyrtlePark,03/14/2016 05:00:00 AM,48,-122,3,3,6
19278,ElliotBayTrailMyrtlePark,03/14/2016 06:00:00 AM,48,-122,8,6,14
19279,ElliotBayTrailMyrtlePark,03/14/2016 07:00:00 AM,48,-122,18,19,37
19280,ElliotBayTrailMyrtlePark,03/14/2016 08:00:00 AM,48,-122,22,96,118
19281,ElliotBayTrailMyrtlePark,03/14/2016 09:00:00 AM,48,-122,18,68,86
19282,ElliotBayTrailMyrtlePark,03/14/2016 10:00:00 AM,48,-122,5,16,21
19283,ElliotBayTrailMyrtlePark,03/14/2016 11:00:00 AM,48,-122,10,13,23
19284,ElliotBayTrailMyrtlePark,03/14/2016 12:00:00 PM,48,-122,11,5,16
19285,ElliotBayTrailMyrtlePark,03/14/2016 01:00:00 PM,48,-122,10,8,18
19286,ElliotBayTrailMyrtlePark,03/14/2016 02:00:00 PM,48,-122,8,16,24
19287,ElliotBayTrailMyrtlePark,03/14/2016 03:00:00 PM,48,-122,16,9,25
19288,ElliotBayTrailMyrtlePark,03/14/2016 04:00:00 PM,48,-122,18,20,38
19289,ElliotBayTrailMyrtlePark,03/14/2016 05:00:00 PM,48,-122,80,30,110
19290,ElliotBayTrailMyrtlePark,03/14/2016 06:00:00 PM,48,-122,88,25,113
19291,ElliotBayTrailMyrtlePark,03/14/2016 07:00:00 PM,48,-122,41,11,52
19292,ElliotBayTrailMyrtlePark,03/14/2016 08:00:00 PM,48,-122,13,1,14
19293,ElliotBayTrailMyrtlePark,03/14/2016 09:00:00 PM,48,-122,5,1,6
19294,ElliotBayTrailMyrtlePark,03/14/2016 10:00:00 PM,48,-122,0,1,1
19295,ElliotBayTrailMyrtlePark,03/14/2016 11:00:00 PM,48,-122,4,1,5
19296,ElliotBayTrailMyrtlePark,03/15/2016 12:00:00 AM,48,-122,1,1,2
19297,ElliotBayTrailMyrtlePark,03/15/2016 01:00:00 AM,48,-122,0,0,0
19298,ElliotBayTrailMyrtlePark,03/15/2016 02:00:00 AM,48,-122,1,0,1
19299,ElliotBayTrailMyrtlePark,03/15/2016 03:00:00 AM,48,-122,1,0,1
19300,ElliotBayTrailMyrtlePark,03/15/2016 04:00:00 AM,48,-122,0,1,1
19301,ElliotBayTrailMyrtlePark,03/15/2016 05:00:00 AM,48,-122,5,3,8
19302,ElliotBayTrailMyrtlePark,03/15/2016 06:00:00 AM,48,-122,8,19,27
19303,ElliotBayTrailMyrtlePark,03/15/2016 07:00:00 AM,48,-122,23,25,48
19304,ElliotBayTrailMyrtlePark,03/15/2016 08:00:00 AM,48,-122,23,120,143
19305,ElliotBayTrailMyrtlePark,03/15/2016 09:00:00 AM,48,-122,25,66,91
19306,ElliotBayTrailMyrtlePark,03/15/2016 10:00:00 AM,48,-122,14,21,35
19307,ElliotBayTrailMyrtlePark,03/15/2016 11:00:00 AM,48,-122,11,14,25
19308,ElliotBayTrailMyrtlePark,03/15/2016 12:00:00 PM,48,-122,13,9,22
19309,ElliotBayTrailMyrtlePark,03/15/2016 01:00:00 PM,48,-122,12,9,21
19310,ElliotBayTrailMyrtlePark,03/15/2016 02:00:00 PM,48,-122,10,12,22
19311,ElliotBayTrailMyrtlePark,03/15/2016 03:00:00 PM,48,-122,18,8,26
19312,ElliotBayTrailMyrtlePark,03/15/2016 04:00:00 PM,48,-122,31,34,65
19313,ElliotBayTrailMyrtlePark,03/15/2016 05:00:00 PM,48,-122,96,46,142
19314,ElliotBayTrailMyrtlePark,03/15/2016 06:00:00 PM,48,-122,128,27,155
19315,ElliotBayTrailMyrtlePark,03/15/2016 07:00:00 PM,48,-122,38,16,54
19316,ElliotBayTrailMyrtlePark,03/15/2016 08:00:00 PM,48,-122,23,4,27
19317,ElliotBayTrailMyrtlePark,03/15/2016 09:00:00 PM,48,-122,1,0,1
19318,ElliotBayTrailMyrtlePark,03/15/2016 10:00:00 PM,48,-122,8,2,10
19319,ElliotBayTrailMyrtlePark,03/15/2016 11:00:00 PM,48,-122,3,4,7
19320,ElliotBayTrailMyrtlePark,03/16/2016 12:00:00 AM,48,-122,3,1,4
19321,ElliotBayTrailMyrtlePark,03/16/2016 01:00:00 AM,48,-122,0,0,0
19322,ElliotBayTrailMyrtlePark,03/16/2016 02:00:00 AM,48,-122,0,0,0
19323,ElliotBayTrailMyrtlePark,03/16/2016 03:00:00 AM,48,-122,1,0,1
19324,ElliotBayTrailMyrtlePark,03/16/2016 04:00:00 AM,48,-122,0,0,0
19325,ElliotBayTrailMyrtlePark,03/16/2016 05:00:00 AM,48,-122,6,3,9
19326,ElliotBayTrailMyrtlePark,03/16/2016 06:00:00 AM,48,-122,13,17,30
19327,ElliotBayTrailMyrtlePark,03/16/2016 07:00:00 AM,48,-122,20,33,53
19328,ElliotBayTrailMyrtlePark,03/16/2016 08:00:00 AM,48,-122,37,117,154
19329,ElliotBayTrailMyrtlePark,03/16/2016 09:00:00 AM,48,-122,32,93,125
19330,ElliotBayTrailMyrtlePark,03/16/2016 10:00:00 AM,48,-122,9,28,37
19331,ElliotBayTrailMyrtlePark,03/16/2016 11:00:00 AM,48,-122,15,21,36
19332,ElliotBayTrailMyrtlePark,03/16/2016 12:00:00 PM,48,-122,19,17,36
19333,ElliotBayTrailMyrtlePark,03/16/2016 01:00:00 PM,48,-122,14,13,27
19334,ElliotBayTrailMyrtlePark,03/16/2016 02:00:00 PM,48,-122,16,15,31
19335,ElliotBayTrailMyrtlePark,03/16/2016 03:00:00 PM,48,-122,19,16,35
19336,ElliotBayTrailMyrtlePark,03/16/2016 04:00:00 PM,48,-122,37,33,70
19337,ElliotBayTrailMyrtlePark,03/16/2016 05:00:00 PM,48,-122,141,56,197
19338,ElliotBayTrailMyrtlePark,03/16/2016 06:00:00 PM,48,-122,141,44,185
19339,ElliotBayTrailMyrtlePark,03/16/2016 07:00:00 PM,48,-122,46,30,76
19340,ElliotBayTrailMyrtlePark,03/16/2016 08:00:00 PM,48,-122,28,12,40
19341,ElliotBayTrailMyrtlePark,03/16/2016 09:00:00 PM,48,-122,6,1,7
19342,ElliotBayTrailMyrtlePark,03/16/2016 10:00:00 PM,48,-122,2,2,4
19343,ElliotBayTrailMyrtlePark,03/16/2016 11:00:00 PM,48,-122,1,0,1
19344,ElliotBayTrailMyrtlePark,03/17/2016 12:00:00 AM,48,-122,4,2,6
19345,ElliotBayTrailMyrtlePark,03/17/2016 01:00:00 AM,48,-122,1,0,1
19346,ElliotBayTrailMyrtlePark,03/17/2016 02:00:00 AM,48,-122,0,0,0
19347,ElliotBayTrailMyrtlePark,03/17/2016 03:00:00 AM,48,-122,3,0,3
19348,ElliotBayTrailMyrtlePark,03/17/2016 04:00:00 AM,48,-122,0,0,0
19349,ElliotBayTrailMyrtlePark,03/17/2016 05:00:00 AM,48,-122,4,2,6
19350,ElliotBayTrailMyrtlePark,03/17/2016 06:00:00 AM,48,-122,12,15,27
19351,ElliotBayTrailMyrtlePark,03/17/2016 07:00:00 AM,48,-122,19,46,65
19352,ElliotBayTrailMyrtlePark,03/17/2016 08:00:00 AM,48,-122,28,129,157
19353,ElliotBayTrailMyrtlePark,03/17/2016 09:00:00 AM,48,-122,31,68,99
19354,ElliotBayTrailMyrtlePark,03/17/2016 10:00:00 AM,48,-122,15,28,43
19355,ElliotBayTrailMyrtlePark,03/17/2016 11:00:00 AM,48,-122,26,18,44
19356,ElliotBayTrailMyrtlePark,03/17/2016 12:00:00 PM,48,-122,16,26,42
19357,ElliotBayTrailMyrtlePark,03/17/2016 01:00:00 PM,48,-122,19,19,38
19358,ElliotBayTrailMyrtlePark,03/17/2016 02:00:00 PM,48,-122,22,18,40
19359,ElliotBayTrailMyrtlePark,03/17/2016 03:00:00 PM,48,-122,32,24,56
19360,ElliotBayTrailMyrtlePark,03/17/2016 04:00:00 PM,48,-122,59,50,109
19361,ElliotBayTrailMyrtlePark,03/17/2016 05:00:00 PM,48,-122,158,50,208
19362,ElliotBayTrailMyrtlePark,03/17/2016 06:00:00 PM,48,-122,140,44,184
19363,ElliotBayTrailMyrtlePark,03/17/2016 07:00:00 PM,48,-122,57,53,110
19364,ElliotBayTrailMyrtlePark,03/17/2016 08:00:00 PM,48,-122,37,17,54
19365,ElliotBayTrailMyrtlePark,03/17/2016 09:00:00 PM,48,-122,5,2,7
19366,ElliotBayTrailMyrtlePark,03/17/2016 10:00:00 PM,48,-122,11,8,19
19367,ElliotBayTrailMyrtlePark,03/17/2016 11:00:00 PM,48,-122,1,1,2
19368,ElliotBayTrailMyrtlePark,03/18/2016 12:00:00 AM,48,-122,3,0,3
19369,ElliotBayTrailMyrtlePark,03/18/2016 01:00:00 AM,48,-122,0,1,1
19370,ElliotBayTrailMyrtlePark,03/18/2016 02:00:00 AM,48,-122,1,0,1
19371,ElliotBayTrailMyrtlePark,03/18/2016 03:00:00 AM,48,-122,3,0,3
19372,ElliotBayTrailMyrtlePark,03/18/2016 04:00:00 AM,48,-122,2,1,3
19373,ElliotBayTrailMyrtlePark,03/18/2016 05:00:00 AM,48,-122,6,4,10
19374,ElliotBayTrailMyrtlePark,03/18/2016 06:00:00 AM,48,-122,14,15,29
19375,ElliotBayTrailMyrtlePark,03/18/2016 07:00:00 AM,48,-122,14,37,51
19376,ElliotBayTrailMyrtlePark,03/18/2016 08:00:00 AM,48,-122,26,93,119
19377,ElliotBayTrailMyrtlePark,03/18/2016 09:00:00 AM,48,-122,26,70,96
19378,ElliotBayTrailMyrtlePark,03/18/2016 10:00:00 AM,48,-122,23,30,53
19379,ElliotBayTrailMyrtlePark,03/18/2016 11:00:00 AM,48,-122,11,23,34
19380,ElliotBayTrailMyrtlePark,03/18/2016 12:00:00 PM,48,-122,33,23,56
19381,ElliotBayTrailMyrtlePark,03/18/2016 01:00:00 PM,48,-122,41,33,74
19382,ElliotBayTrailMyrtlePark,03/18/2016 02:00:00 PM,48,-122,39,26,65
19383,ElliotBayTrailMyrtlePark,03/18/2016 03:00:00 PM,48,-122,52,29,81
19384,ElliotBayTrailMyrtlePark,03/18/2016 04:00:00 PM,48,-122,74,64,138
19385,ElliotBayTrailMyrtlePark,03/18/2016 05:00:00 PM,48,-122,113,54,167
19386,ElliotBayTrailMyrtlePark,03/18/2016 06:00:00 PM,48,-122,108,41,149
19387,ElliotBayTrailMyrtlePark,03/18/2016 07:00:00 PM,48,-122,50,40,90
19388,ElliotBayTrailMyrtlePark,03/18/2016 08:00:00 PM,48,-122,14,16,30
19389,ElliotBayTrailMyrtlePark,03/18/2016 09:00:00 PM,48,-122,3,2,5
19390,ElliotBayTrailMyrtlePark,03/18/2016 10:00:00 PM,48,-122,2,6,8
19391,ElliotBayTrailMyrtlePark,03/18/2016 11:00:00 PM,48,-122,6,4,10
19392,ElliotBayTrailMyrtlePark,03/19/2016 12:00:00 AM,48,-122,3,1,4
19393,ElliotBayTrailMyrtlePark,03/19/2016 01:00:00 AM,48,-122,3,1,4
19394,ElliotBayTrailMyrtlePark,03/19/2016 02:00:00 AM,48,-122,2,0,2
19395,ElliotBayTrailMyrtlePark,03/19/2016 03:00:00 AM,48,-122,1,0,1
19396,ElliotBayTrailMyrtlePark,03/19/2016 04:00:00 AM,48,-122,0,0,0
19397,ElliotBayTrailMyrtlePark,03/19/2016 05:00:00 AM,48,-122,0,0,0
19398,ElliotBayTrailMyrtlePark,03/19/2016 06:00:00 AM,48,-122,0,5,5
19399,ElliotBayTrailMyrtlePark,03/19/2016 07:00:00 AM,48,-122,4,6,10
19400,ElliotBayTrailMyrtlePark,03/19/2016 08:00:00 AM,48,-122,11,16,27
19401,ElliotBayTrailMyrtlePark,03/19/2016 09:00:00 AM,48,-122,16,19,35
19402,ElliotBayTrailMyrtlePark,03/19/2016 10:00:00 AM,48,-122,21,19,40
19403,ElliotBayTrailMyrtlePark,03/19/2016 11:00:00 AM,48,-122,27,45,72
19404,ElliotBayTrailMyrtlePark,03/19/2016 12:00:00 PM,48,-122,41,46,87
19405,ElliotBayTrailMyrtlePark,03/19/2016 01:00:00 PM,48,-122,40,47,87
19406,ElliotBayTrailMyrtlePark,03/19/2016 02:00:00 PM,48,-122,52,36,88
19407,ElliotBayTrailMyrtlePark,03/19/2016 03:00:00 PM,48,-122,37,46,83
19408,ElliotBayTrailMyrtlePark,03/19/2016 04:00:00 PM,48,-122,47,32,79
19409,ElliotBayTrailMyrtlePark,03/19/2016 05:00:00 PM,48,-122,38,43,81
19410,ElliotBayTrailMyrtlePark,03/19/2016 06:00:00 PM,48,-122,14,24,38
19411,ElliotBayTrailMyrtlePark,03/19/2016 07:00:00 PM,48,-122,32,26,58
19412,ElliotBayTrailMyrtlePark,03/19/2016 08:00:00 PM,48,-122,6,1,7
19413,ElliotBayTrailMyrtlePark,03/19/2016 09:00:00 PM,48,-122,3,4,7
19414,ElliotBayTrailMyrtlePark,03/19/2016 10:00:00 PM,48,-122,9,2,11
19415,ElliotBayTrailMyrtlePark,03/19/2016 11:00:00 PM,48,-122,17,2,19
19416,ElliotBayTrailMyrtlePark,03/20/2016 12:00:00 AM,48,-122,3,0,3
19417,ElliotBayTrailMyrtlePark,03/20/2016 01:00:00 AM,48,-122,1,0,1
19418,ElliotBayTrailMyrtlePark,03/20/2016 02:00:00 AM,48,-122,1,0,1
19419,ElliotBayTrailMyrtlePark,03/20/2016 03:00:00 AM,48,-122,1,0,1
19420,ElliotBayTrailMyrtlePark,03/20/2016 04:00:00 AM,48,-122,2,0,2
19421,ElliotBayTrailMyrtlePark,03/20/2016 05:00:00 AM,48,-122,0,0,0
19422,ElliotBayTrailMyrtlePark,03/20/2016 06:00:00 AM,48,-122,0,3,3
19423,ElliotBayTrailMyrtlePark,03/20/2016 07:00:00 AM,48,-122,2,1,3
19424,ElliotBayTrailMyrtlePark,03/20/2016 08:00:00 AM,48,-122,8,3,11
19425,ElliotBayTrailMyrtlePark,03/20/2016 09:00:00 AM,48,-122,17,13,30
19426,ElliotBayTrailMyrtlePark,03/20/2016 10:00:00 AM,48,-122,10,15,25
19427,ElliotBayTrailMyrtlePark,03/20/2016 11:00:00 AM,48,-122,16,15,31
19428,ElliotBayTrailMyrtlePark,03/20/2016 12:00:00 PM,48,-122,5,12,17
19429,ElliotBayTrailMyrtlePark,03/20/2016 01:00:00 PM,48,-122,21,4,25
19430,ElliotBayTrailMyrtlePark,03/20/2016 02:00:00 PM,48,-122,12,4,16
19431,ElliotBayTrailMyrtlePark,03/20/2016 03:00:00 PM,48,-122,6,6,12
19432,ElliotBayTrailMyrtlePark,03/20/2016 04:00:00 PM,48,-122,10,9,19
19433,ElliotBayTrailMyrtlePark,03/20/2016 05:00:00 PM,48,-122,6,0,6
19434,ElliotBayTrailMyrtlePark,03/20/2016 06:00:00 PM,48,-122,4,6,10
19435,ElliotBayTrailMyrtlePark,03/20/2016 07:00:00 PM,48,-122,6,3,9
19436,ElliotBayTrailMyrtlePark,03/20/2016 08:00:00 PM,48,-122,2,1,3
19437,ElliotBayTrailMyrtlePark,03/20/2016 09:00:00 PM,48,-122,1,1,2
19438,ElliotBayTrailMyrtlePark,03/20/2016 10:00:00 PM,48,-122,0,0,0
19439,ElliotBayTrailMyrtlePark,03/20/2016 11:00:00 PM,48,-122,0,3,3
19440,ElliotBayTrailMyrtlePark,03/21/2016 12:00:00 AM,48,-122,0,1,1
19441,ElliotBayTrailMyrtlePark,03/21/2016 01:00:00 AM,48,-122,0,0,0
19442,ElliotBayTrailMyrtlePark,03/21/2016 02:00:00 AM,48,-122,0,1,1
19443,ElliotBayTrailMyrtlePark,03/21/2016 03:00:00 AM,48,-122,1,0,1
19444,ElliotBayTrailMyrtlePark,03/21/2016 04:00:00 AM,48,-122,0,0,0
19445,ElliotBayTrailMyrtlePark,03/21/2016 05:00:00 AM,48,-122,2,2,4
19446,ElliotBayTrailMyrtlePark,03/21/2016 06:00:00 AM,48,-122,9,14,23
19447,ElliotBayTrailMyrtlePark,03/21/2016 07:00:00 AM,48,-122,20,27,47
19448,ElliotBayTrailMyrtlePark,03/21/2016 08:00:00 AM,48,-122,18,97,115
19449,ElliotBayTrailMyrtlePark,03/21/2016 09:00:00 AM,48,-122,22,52,74
19450,ElliotBayTrailMyrtlePark,03/21/2016 10:00:00 AM,48,-122,9,18,27
19451,ElliotBayTrailMyrtlePark,03/21/2016 11:00:00 AM,48,-122,4,9,13
19452,ElliotBayTrailMyrtlePark,03/21/2016 12:00:00 PM,48,-122,8,16,24
19453,ElliotBayTrailMyrtlePark,03/21/2016 01:00:00 PM,48,-122,14,3,17
19454,ElliotBayTrailMyrtlePark,03/21/2016 02:00:00 PM,48,-122,6,5,11
19455,ElliotBayTrailMyrtlePark,03/21/2016 03:00:00 PM,48,-122,10,12,22
19456,ElliotBayTrailMyrtlePark,03/21/2016 04:00:00 PM,48,-122,17,25,42
19457,ElliotBayTrailMyrtlePark,03/21/2016 05:00:00 PM,48,-122,101,33,134
19458,ElliotBayTrailMyrtlePark,03/21/2016 06:00:00 PM,48,-122,86,21,107
19459,ElliotBayTrailMyrtlePark,03/21/2016 07:00:00 PM,48,-122,36,5,41
19460,ElliotBayTrailMyrtlePark,03/21/2016 08:00:00 PM,48,-122,9,0,9
19461,ElliotBayTrailMyrtlePark,03/21/2016 09:00:00 PM,48,-122,3,3,6
19462,ElliotBayTrailMyrtlePark,03/21/2016 10:00:00 PM,48,-122,2,1,3
19463,ElliotBayTrailMyrtlePark,03/21/2016 11:00:00 PM,48,-122,4,2,6
19464,ElliotBayTrailMyrtlePark,03/22/2016 12:00:00 AM,48,-122,0,1,1
19465,ElliotBayTrailMyrtlePark,03/22/2016 01:00:00 AM,48,-122,0,0,0
19466,ElliotBayTrailMyrtlePark,03/22/2016 02:00:00 AM,48,-122,1,0,1
19467,ElliotBayTrailMyrtlePark,03/22/2016 03:00:00 AM,48,-122,1,1,2
19468,ElliotBayTrailMyrtlePark,03/22/2016 04:00:00 AM,48,-122,1,0,1
19469,ElliotBayTrailMyrtlePark,03/22/2016 05:00:00 AM,48,-122,3,3,6
19470,ElliotBayTrailMyrtlePark,03/22/2016 06:00:00 AM,48,-122,14,13,27
19471,ElliotBayTrailMyrtlePark,03/22/2016 07:00:00 AM,48,-122,21,41,62
19472,ElliotBayTrailMyrtlePark,03/22/2016 08:00:00 AM,48,-122,21,113,134
19473,ElliotBayTrailMyrtlePark,03/22/2016 09:00:00 AM,48,-122,22,70,92
19474,ElliotBayTrailMyrtlePark,03/22/2016 10:00:00 AM,48,-122,14,18,32
19475,ElliotBayTrailMyrtlePark,03/22/2016 11:00:00 AM,48,-122,9,13,22
19476,ElliotBayTrailMyrtlePark,03/22/2016 12:00:00 PM,48,-122,12,11,23
19477,ElliotBayTrailMyrtlePark,03/22/2016 01:00:00 PM,48,-122,21,19,40
19478,ElliotBayTrailMyrtlePark,03/22/2016 02:00:00 PM,48,-122,24,23,47
19479,ElliotBayTrailMyrtlePark,03/22/2016 03:00:00 PM,48,-122,27,23,50
19480,ElliotBayTrailMyrtlePark,03/22/2016 04:00:00 PM,48,-122,40,27,67
19481,ElliotBayTrailMyrtlePark,03/22/2016 05:00:00 PM,48,-122,113,37,150
19482,ElliotBayTrailMyrtlePark,03/22/2016 06:00:00 PM,48,-122,108,28,136
19483,ElliotBayTrailMyrtlePark,03/22/2016 07:00:00 PM,48,-122,45,12,57
19484,ElliotBayTrailMyrtlePark,03/22/2016 08:00:00 PM,48,-122,10,4,14
19485,ElliotBayTrailMyrtlePark,03/22/2016 09:00:00 PM,48,-122,4,1,5
19486,ElliotBayTrailMyrtlePark,03/22/2016 10:00:00 PM,48,-122,5,2,7
19487,ElliotBayTrailMyrtlePark,03/22/2016 11:00:00 PM,48,-122,0,2,2
19488,ElliotBayTrailMyrtlePark,03/23/2016 12:00:00 AM,48,-122,0,1,1
19489,ElliotBayTrailMyrtlePark,03/23/2016 01:00:00 AM,48,-122,1,0,1
19490,ElliotBayTrailMyrtlePark,03/23/2016 02:00:00 AM,48,-122,0,0,0
19491,ElliotBayTrailMyrtlePark,03/23/2016 03:00:00 AM,48,-122,1,0,1
19492,ElliotBayTrailMyrtlePark,03/23/2016 04:00:00 AM,48,-122,0,0,0
19493,ElliotBayTrailMyrtlePark,03/23/2016 05:00:00 AM,48,-122,5,3,8
19494,ElliotBayTrailMyrtlePark,03/23/2016 06:00:00 AM,48,-122,15,13,28
19495,ElliotBayTrailMyrtlePark,03/23/2016 07:00:00 AM,48,-122,21,39,60
19496,ElliotBayTrailMyrtlePark,03/23/2016 08:00:00 AM,48,-122,13,92,105
19497,ElliotBayTrailMyrtlePark,03/23/2016 09:00:00 AM,48,-122,20,71,91
19498,ElliotBayTrailMyrtlePark,03/23/2016 10:00:00 AM,48,-122,10,28,38
19499,ElliotBayTrailMyrtlePark,03/23/2016 11:00:00 AM,48,-122,7,13,20
19500,ElliotBayTrailMyrtlePark,03/23/2016 12:00:00 PM,48,-122,8,6,14
19501,ElliotBayTrailMyrtlePark,03/23/2016 01:00:00 PM,48,-122,10,14,24
19502,ElliotBayTrailMyrtlePark,03/23/2016 02:00:00 PM,48,-122,12,7,19
19503,ElliotBayTrailMyrtlePark,03/23/2016 03:00:00 PM,48,-122,15,14,29
19504,ElliotBayTrailMyrtlePark,03/23/2016 04:00:00 PM,48,-122,36,19,55
19505,ElliotBayTrailMyrtlePark,03/23/2016 05:00:00 PM,48,-122,87,40,127
19506,ElliotBayTrailMyrtlePark,03/23/2016 06:00:00 PM,48,-122,109,12,121
19507,ElliotBayTrailMyrtlePark,03/23/2016 07:00:00 PM,48,-122,28,13,41
19508,ElliotBayTrailMyrtlePark,03/23/2016 08:00:00 PM,48,-122,8,1,9
19509,ElliotBayTrailMyrtlePark,03/23/2016 09:00:00 PM,48,-122,2,0,2
19510,ElliotBayTrailMyrtlePark,03/23/2016 10:00:00 PM,48,-122,3,0,3
19511,ElliotBayTrailMyrtlePark,03/23/2016 11:00:00 PM,48,-122,3,0,3
19512,ElliotBayTrailMyrtlePark,03/24/2016 12:00:00 AM,48,-122,1,0,1
19513,ElliotBayTrailMyrtlePark,03/24/2016 01:00:00 AM,48,-122,0,0,0
19514,ElliotBayTrailMyrtlePark,03/24/2016 02:00:00 AM,48,-122,2,0,2
19515,ElliotBayTrailMyrtlePark,03/24/2016 03:00:00 AM,48,-122,2,0,2
19516,ElliotBayTrailMyrtlePark,03/24/2016 04:00:00 AM,48,-122,0,0,0
19517,ElliotBayTrailMyrtlePark,03/24/2016 05:00:00 AM,48,-122,8,0,8
19518,ElliotBayTrailMyrtlePark,03/24/2016 06:00:00 AM,48,-122,6,12,18
19519,ElliotBayTrailMyrtlePark,03/24/2016 07:00:00 AM,48,-122,15,43,58
19520,ElliotBayTrailMyrtlePark,03/24/2016 08:00:00 AM,48,-122,12,117,129
19521,ElliotBayTrailMyrtlePark,03/24/2016 09:00:00 AM,48,-122,27,84,111
19522,ElliotBayTrailMyrtlePark,03/24/2016 10:00:00 AM,48,-122,18,32,50
19523,ElliotBayTrailMyrtlePark,03/24/2016 11:00:00 AM,48,-122,15,11,26
19524,ElliotBayTrailMyrtlePark,03/24/2016 12:00:00 PM,48,-122,9,13,22
19525,ElliotBayTrailMyrtlePark,03/24/2016 01:00:00 PM,48,-122,12,14,26
19526,ElliotBayTrailMyrtlePark,03/24/2016 02:00:00 PM,48,-122,21,12,33
19527,ElliotBayTrailMyrtlePark,03/24/2016 03:00:00 PM,48,-122,17,11,28
19528,ElliotBayTrailMyrtlePark,03/24/2016 04:00:00 PM,48,-122,39,24,63
19529,ElliotBayTrailMyrtlePark,03/24/2016 05:00:00 PM,48,-122,103,36,139
19530,ElliotBayTrailMyrtlePark,03/24/2016 06:00:00 PM,48,-122,133,36,169
19531,ElliotBayTrailMyrtlePark,03/24/2016 07:00:00 PM,48,-122,41,13,54
19532,ElliotBayTrailMyrtlePark,03/24/2016 08:00:00 PM,48,-122,9,7,16
19533,ElliotBayTrailMyrtlePark,03/24/2016 09:00:00 PM,48,-122,2,1,3
19534,ElliotBayTrailMyrtlePark,03/24/2016 10:00:00 PM,48,-122,3,3,6
19535,ElliotBayTrailMyrtlePark,03/24/2016 11:00:00 PM,48,-122,4,0,4
19536,ElliotBayTrailMyrtlePark,03/25/2016 12:00:00 AM,48,-122,2,0,2
19537,ElliotBayTrailMyrtlePark,03/25/2016 01:00:00 AM,48,-122,0,0,0
19538,ElliotBayTrailMyrtlePark,03/25/2016 02:00:00 AM,48,-122,0,0,0
19539,ElliotBayTrailMyrtlePark,03/25/2016 03:00:00 AM,48,-122,0,0,0
19540,ElliotBayTrailMyrtlePark,03/25/2016 04:00:00 AM,48,-122,1,0,1
19541,ElliotBayTrailMyrtlePark,03/25/2016 05:00:00 AM,48,-122,2,4,6
19542,ElliotBayTrailMyrtlePark,03/25/2016 06:00:00 AM,48,-122,10,10,20
19543,ElliotBayTrailMyrtlePark,03/25/2016 07:00:00 AM,48,-122,23,40,63
19544,ElliotBayTrailMyrtlePark,03/25/2016 08:00:00 AM,48,-122,18,107,125
19545,ElliotBayTrailMyrtlePark,03/25/2016 09:00:00 AM,48,-122,23,96,119
19546,ElliotBayTrailMyrtlePark,03/25/2016 10:00:00 AM,48,-122,15,27,42
19547,ElliotBayTrailMyrtlePark,03/25/2016 11:00:00 AM,48,-122,16,21,37
19548,ElliotBayTrailMyrtlePark,03/25/2016 12:00:00 PM,48,-122,17,16,33
19549,ElliotBayTrailMyrtlePark,03/25/2016 01:00:00 PM,48,-122,20,22,42
19550,ElliotBayTrailMyrtlePark,03/25/2016 02:00:00 PM,48,-122,41,42,83
19551,ElliotBayTrailMyrtlePark,03/25/2016 03:00:00 PM,48,-122,44,38,82
19552,ElliotBayTrailMyrtlePark,03/25/2016 04:00:00 PM,48,-122,80,47,127
19553,ElliotBayTrailMyrtlePark,03/25/2016 05:00:00 PM,48,-122,134,66,200
19554,ElliotBayTrailMyrtlePark,03/25/2016 06:00:00 PM,48,-122,113,52,165
19555,ElliotBayTrailMyrtlePark,03/25/2016 07:00:00 PM,48,-122,48,29,77
19556,ElliotBayTrailMyrtlePark,03/25/2016 08:00:00 PM,48,-122,26,16,42
19557,ElliotBayTrailMyrtlePark,03/25/2016 09:00:00 PM,48,-122,23,3,26
19558,ElliotBayTrailMyrtlePark,03/25/2016 10:00:00 PM,48,-122,8,6,14
19559,ElliotBayTrailMyrtlePark,03/25/2016 11:00:00 PM,48,-122,1,2,3
19560,ElliotBayTrailMyrtlePark,03/26/2016 12:00:00 AM,48,-122,3,2,5
19561,ElliotBayTrailMyrtlePark,03/26/2016 01:00:00 AM,48,-122,9,0,9
19562,ElliotBayTrailMyrtlePark,03/26/2016 02:00:00 AM,48,-122,0,2,2
19563,ElliotBayTrailMyrtlePark,03/26/2016 03:00:00 AM,48,-122,1,0,1
19564,ElliotBayTrailMyrtlePark,03/26/2016 04:00:00 AM,48,-122,1,1,2
19565,ElliotBayTrailMyrtlePark,03/26/2016 05:00:00 AM,48,-122,0,0,0
19566,ElliotBayTrailMyrtlePark,03/26/2016 06:00:00 AM,48,-122,2,4,6
19567,ElliotBayTrailMyrtlePark,03/26/2016 07:00:00 AM,48,-122,2,8,10
19568,ElliotBayTrailMyrtlePark,03/26/2016 08:00:00 AM,48,-122,11,12,23
19569,ElliotBayTrailMyrtlePark,03/26/2016 09:00:00 AM,48,-122,22,19,41
19570,ElliotBayTrailMyrtlePark,03/26/2016 10:00:00 AM,48,-122,17,24,41
19571,ElliotBayTrailMyrtlePark,03/26/2016 11:00:00 AM,48,-122,36,33,69
19572,ElliotBayTrailMyrtlePark,03/26/2016 12:00:00 PM,48,-122,40,38,78
19573,ElliotBayTrailMyrtlePark,03/26/2016 01:00:00 PM,48,-122,58,81,139
19574,ElliotBayTrailMyrtlePark,03/26/2016 02:00:00 PM,48,-122,60,60,120
19575,ElliotBayTrailMyrtlePark,03/26/2016 03:00:00 PM,48,-122,71,67,138
19576,ElliotBayTrailMyrtlePark,03/26/2016 04:00:00 PM,48,-122,58,54,112
19577,ElliotBayTrailMyrtlePark,03/26/2016 05:00:00 PM,48,-122,43,39,82
19578,ElliotBayTrailMyrtlePark,03/26/2016 06:00:00 PM,48,-122,38,28,66
19579,ElliotBayTrailMyrtlePark,03/26/2016 07:00:00 PM,48,-122,19,11,30
19580,ElliotBayTrailMyrtlePark,03/26/2016 08:00:00 PM,48,-122,2,7,9
19581,ElliotBayTrailMyrtlePark,03/26/2016 09:00:00 PM,48,-122,0,2,2
19582,ElliotBayTrailMyrtlePark,03/26/2016 10:00:00 PM,48,-122,3,1,4
19583,ElliotBayTrailMyrtlePark,03/26/2016 11:00:00 PM,48,-122,1,1,2
19584,ElliotBayTrailMyrtlePark,03/27/2016 12:00:00 AM,48,-122,0,1,1
19585,ElliotBayTrailMyrtlePark,03/27/2016 01:00:00 AM,48,-122,1,0,1
19586,ElliotBayTrailMyrtlePark,03/27/2016 02:00:00 AM,48,-122,1,0,1
19587,ElliotBayTrailMyrtlePark,03/27/2016 03:00:00 AM,48,-122,1,0,1
19588,ElliotBayTrailMyrtlePark,03/27/2016 04:00:00 AM,48,-122,0,0,0
19589,ElliotBayTrailMyrtlePark,03/27/2016 05:00:00 AM,48,-122,0,1,1
19590,ElliotBayTrailMyrtlePark,03/27/2016 06:00:00 AM,48,-122,2,2,4
19591,ElliotBayTrailMyrtlePark,03/27/2016 07:00:00 AM,48,-122,3,0,3
19592,ElliotBayTrailMyrtlePark,03/27/2016 08:00:00 AM,48,-122,6,7,13
19593,ElliotBayTrailMyrtlePark,03/27/2016 09:00:00 AM,48,-122,12,6,18
19594,ElliotBayTrailMyrtlePark,03/27/2016 10:00:00 AM,48,-122,5,7,12
19595,ElliotBayTrailMyrtlePark,03/27/2016 11:00:00 AM,48,-122,11,8,19
19596,ElliotBayTrailMyrtlePark,03/27/2016 12:00:00 PM,48,-122,2,6,8
19597,ElliotBayTrailMyrtlePark,03/27/2016 01:00:00 PM,48,-122,12,9,21
19598,ElliotBayTrailMyrtlePark,03/27/2016 02:00:00 PM,48,-122,12,10,22
19599,ElliotBayTrailMyrtlePark,03/27/2016 03:00:00 PM,48,-122,12,9,21
19600,ElliotBayTrailMyrtlePark,03/27/2016 04:00:00 PM,48,-122,6,8,14
19601,ElliotBayTrailMyrtlePark,03/27/2016 05:00:00 PM,48,-122,8,2,10
19602,ElliotBayTrailMyrtlePark,03/27/2016 06:00:00 PM,48,-122,2,1,3
19603,ElliotBayTrailMyrtlePark,03/27/2016 07:00:00 PM,48,-122,1,2,3
19604,ElliotBayTrailMyrtlePark,03/27/2016 08:00:00 PM,48,-122,3,3,6
19605,ElliotBayTrailMyrtlePark,03/27/2016 09:00:00 PM,48,-122,0,2,2
19606,ElliotBayTrailMyrtlePark,03/27/2016 10:00:00 PM,48,-122,1,2,3
19607,ElliotBayTrailMyrtlePark,03/27/2016 11:00:00 PM,48,-122,1,0,1
19608,ElliotBayTrailMyrtlePark,03/28/2016 12:00:00 AM,48,-122,0,0,0
19609,ElliotBayTrailMyrtlePark,03/28/2016 01:00:00 AM,48,-122,1,0,1
19610,ElliotBayTrailMyrtlePark,03/28/2016 02:00:00 AM,48,-122,0,0,0
19611,ElliotBayTrailMyrtlePark,03/28/2016 03:00:00 AM,48,-122,1,0,1
19612,ElliotBayTrailMyrtlePark,03/28/2016 04:00:00 AM,48,-122,0,0,0
19613,ElliotBayTrailMyrtlePark,03/28/2016 05:00:00 AM,48,-122,6,4,10
19614,ElliotBayTrailMyrtlePark,03/28/2016 06:00:00 AM,48,-122,10,23,33
19615,ElliotBayTrailMyrtlePark,03/28/2016 07:00:00 AM,48,-122,22,38,60
19616,ElliotBayTrailMyrtlePark,03/28/2016 08:00:00 AM,48,-122,24,150,174
19617,ElliotBayTrailMyrtlePark,03/28/2016 09:00:00 AM,48,-122,29,92,121
19618,ElliotBayTrailMyrtlePark,03/28/2016 10:00:00 AM,48,-122,19,20,39
19619,ElliotBayTrailMyrtlePark,03/28/2016 11:00:00 AM,48,-122,7,9,16
19620,ElliotBayTrailMyrtlePark,03/28/2016 12:00:00 PM,48,-122,14,13,27
19621,ElliotBayTrailMyrtlePark,03/28/2016 01:00:00 PM,48,-122,13,8,21
19622,ElliotBayTrailMyrtlePark,03/28/2016 02:00:00 PM,48,-122,19,9,28
19623,ElliotBayTrailMyrtlePark,03/28/2016 03:00:00 PM,48,-122,26,20,46
19624,ElliotBayTrailMyrtlePark,03/28/2016 04:00:00 PM,48,-122,58,37,95
19625,ElliotBayTrailMyrtlePark,03/28/2016 05:00:00 PM,48,-122,145,57,202
19626,ElliotBayTrailMyrtlePark,03/28/2016 06:00:00 PM,48,-122,152,47,199
19627,ElliotBayTrailMyrtlePark,03/28/2016 07:00:00 PM,48,-122,65,32,97
19628,ElliotBayTrailMyrtlePark,03/28/2016 08:00:00 PM,48,-122,20,15,35
19629,ElliotBayTrailMyrtlePark,03/28/2016 09:00:00 PM,48,-122,5,5,10
19630,ElliotBayTrailMyrtlePark,03/28/2016 10:00:00 PM,48,-122,2,2,4
19631,ElliotBayTrailMyrtlePark,03/28/2016 11:00:00 PM,48,-122,0,0,0
19632,ElliotBayTrailMyrtlePark,03/29/2016 12:00:00 AM,48,-122,3,3,6
19633,ElliotBayTrailMyrtlePark,03/29/2016 01:00:00 AM,48,-122,0,0,0
19634,ElliotBayTrailMyrtlePark,03/29/2016 02:00:00 AM,48,-122,1,0,1
19635,ElliotBayTrailMyrtlePark,03/29/2016 03:00:00 AM,48,-122,1,0,1
19636,ElliotBayTrailMyrtlePark,03/29/2016 04:00:00 AM,48,-122,0,0,0
19637,ElliotBayTrailMyrtlePark,03/29/2016 05:00:00 AM,48,-122,4,2,6
19638,ElliotBayTrailMyrtlePark,03/29/2016 06:00:00 AM,48,-122,10,22,32
19639,ElliotBayTrailMyrtlePark,03/29/2016 07:00:00 AM,48,-122,29,74,103
19640,ElliotBayTrailMyrtlePark,03/29/2016 08:00:00 AM,48,-122,33,185,218
19641,ElliotBayTrailMyrtlePark,03/29/2016 09:00:00 AM,48,-122,41,109,150
19642,ElliotBayTrailMyrtlePark,03/29/2016 10:00:00 AM,48,-122,23,35,58
19643,ElliotBayTrailMyrtlePark,03/29/2016 11:00:00 AM,48,-122,21,24,45
19644,ElliotBayTrailMyrtlePark,03/29/2016 12:00:00 PM,48,-122,19,15,34
19645,ElliotBayTrailMyrtlePark,03/29/2016 01:00:00 PM,48,-122,23,25,48
19646,ElliotBayTrailMyrtlePark,03/29/2016 02:00:00 PM,48,-122,48,23,71
19647,ElliotBayTrailMyrtlePark,03/29/2016 03:00:00 PM,48,-122,45,35,80
19648,ElliotBayTrailMyrtlePark,03/29/2016 04:00:00 PM,48,-122,89,53,142
19649,ElliotBayTrailMyrtlePark,03/29/2016 05:00:00 PM,48,-122,186,61,247
19650,ElliotBayTrailMyrtlePark,03/29/2016 06:00:00 PM,48,-122,194,61,255
19651,ElliotBayTrailMyrtlePark,03/29/2016 07:00:00 PM,48,-122,68,50,118
19652,ElliotBayTrailMyrtlePark,03/29/2016 08:00:00 PM,48,-122,23,35,58
19653,ElliotBayTrailMyrtlePark,03/29/2016 09:00:00 PM,48,-122,11,3,14
19654,ElliotBayTrailMyrtlePark,03/29/2016 10:00:00 PM,48,-122,1,4,5
19655,ElliotBayTrailMyrtlePark,03/29/2016 11:00:00 PM,48,-122,3,1,4
19656,ElliotBayTrailMyrtlePark,03/30/2016 12:00:00 AM,48,-122,4,0,4
19657,ElliotBayTrailMyrtlePark,03/30/2016 01:00:00 AM,48,-122,0,1,1
19658,ElliotBayTrailMyrtlePark,03/30/2016 02:00:00 AM,48,-122,0,0,0
19659,ElliotBayTrailMyrtlePark,03/30/2016 03:00:00 AM,48,-122,2,0,2
19660,ElliotBayTrailMyrtlePark,03/30/2016 04:00:00 AM,48,-122,1,0,1
19661,ElliotBayTrailMyrtlePark,03/30/2016 05:00:00 AM,48,-122,4,4,8
19662,ElliotBayTrailMyrtlePark,03/30/2016 06:00:00 AM,48,-122,16,22,38
19663,ElliotBayTrailMyrtlePark,03/30/2016 07:00:00 AM,48,-122,35,59,94
19664,ElliotBayTrailMyrtlePark,03/30/2016 08:00:00 AM,48,-122,33,181,214
19665,ElliotBayTrailMyrtlePark,03/30/2016 09:00:00 AM,48,-122,36,105,141
19666,ElliotBayTrailMyrtlePark,03/30/2016 10:00:00 AM,48,-122,17,38,55
19667,ElliotBayTrailMyrtlePark,03/30/2016 11:00:00 AM,48,-122,20,22,42
19668,ElliotBayTrailMyrtlePark,03/30/2016 12:00:00 PM,48,-122,26,25,51
19669,ElliotBayTrailMyrtlePark,03/30/2016 01:00:00 PM,48,-122,38,29,67
19670,ElliotBayTrailMyrtlePark,03/30/2016 02:00:00 PM,48,-122,38,35,73
19671,ElliotBayTrailMyrtlePark,03/30/2016 03:00:00 PM,48,-122,34,33,67
19672,ElliotBayTrailMyrtlePark,03/30/2016 04:00:00 PM,48,-122,104,89,193
19673,ElliotBayTrailMyrtlePark,03/30/2016 05:00:00 PM,48,-122,188,86,274
19674,ElliotBayTrailMyrtlePark,03/30/2016 06:00:00 PM,48,-122,201,74,275
19675,ElliotBayTrailMyrtlePark,03/30/2016 07:00:00 PM,48,-122,106,76,182
19676,ElliotBayTrailMyrtlePark,03/30/2016 08:00:00 PM,48,-122,34,32,66
19677,ElliotBayTrailMyrtlePark,03/30/2016 09:00:00 PM,48,-122,5,3,8
19678,ElliotBayTrailMyrtlePark,03/30/2016 10:00:00 PM,48,-122,5,1,6
19679,ElliotBayTrailMyrtlePark,03/30/2016 11:00:00 PM,48,-122,5,1,6
19680,ElliotBayTrailMyrtlePark,03/31/2016 12:00:00 AM,48,-122,2,0,2
19681,ElliotBayTrailMyrtlePark,03/31/2016 01:00:00 AM,48,-122,0,0,0
19682,ElliotBayTrailMyrtlePark,03/31/2016 02:00:00 AM,48,-122,2,0,2
19683,ElliotBayTrailMyrtlePark,03/31/2016 03:00:00 AM,48,-122,2,1,3
19684,ElliotBayTrailMyrtlePark,03/31/2016 04:00:00 AM,48,-122,0,0,0
19685,ElliotBayTrailMyrtlePark,03/31/2016 05:00:00 AM,48,-122,8,1,9
19686,ElliotBayTrailMyrtlePark,03/31/2016 06:00:00 AM,48,-122,15,23,38
19687,ElliotBayTrailMyrtlePark,03/31/2016 07:00:00 AM,48,-122,28,74,102
19688,ElliotBayTrailMyrtlePark,03/31/2016 08:00:00 AM,48,-122,28,180,208
19689,ElliotBayTrailMyrtlePark,03/31/2016 09:00:00 AM,48,-122,42,115,157
19690,ElliotBayTrailMyrtlePark,03/31/2016 10:00:00 AM,48,-122,22,44,66
19691,ElliotBayTrailMyrtlePark,03/31/2016 11:00:00 AM,48,-122,18,30,48
19692,ElliotBayTrailMyrtlePark,03/31/2016 12:00:00 PM,48,-122,26,24,50
19693,ElliotBayTrailMyrtlePark,03/31/2016 01:00:00 PM,48,-122,30,29,59
19694,ElliotBayTrailMyrtlePark,03/31/2016 02:00:00 PM,48,-122,25,37,62
19695,ElliotBayTrailMyrtlePark,03/31/2016 03:00:00 PM,48,-122,37,39,76
19696,ElliotBayTrailMyrtlePark,03/31/2016 04:00:00 PM,48,-122,95,62,157
19697,ElliotBayTrailMyrtlePark,03/31/2016 05:00:00 PM,48,-122,184,84,268
19698,ElliotBayTrailMyrtlePark,03/31/2016 06:00:00 PM,48,-122,187,61,248
19699,ElliotBayTrailMyrtlePark,03/31/2016 07:00:00 PM,48,-122,119,49,168
19700,ElliotBayTrailMyrtlePark,03/31/2016 08:00:00 PM,48,-122,34,29,63
19701,ElliotBayTrailMyrtlePark,03/31/2016 09:00:00 PM,48,-122,8,6,14
19702,ElliotBayTrailMyrtlePark,03/31/2016 10:00:00 PM,48,-122,10,5,15
19703,ElliotBayTrailMyrtlePark,03/31/2016 11:00:00 PM,48,-122,5,2,7
19704,ElliotBayTrailMyrtlePark,04/01/2016 12:00:00 AM,48,-122,4,3,7
19705,ElliotBayTrailMyrtlePark,04/01/2016 01:00:00 AM,48,-122,0,0,0
19706,ElliotBayTrailMyrtlePark,04/01/2016 02:00:00 AM,48,-122,0,2,2
19707,ElliotBayTrailMyrtlePark,04/01/2016 03:00:00 AM,48,-122,2,0,2
19708,ElliotBayTrailMyrtlePark,04/01/2016 04:00:00 AM,48,-122,0,1,1
19709,ElliotBayTrailMyrtlePark,04/01/2016 05:00:00 AM,48,-122,4,4,8
19710,ElliotBayTrailMyrtlePark,04/01/2016 06:00:00 AM,48,-122,16,19,35
19711,ElliotBayTrailMyrtlePark,04/01/2016 07:00:00 AM,48,-122,22,57,79
19712,ElliotBayTrailMyrtlePark,04/01/2016 08:00:00 AM,48,-122,30,155,185
19713,ElliotBayTrailMyrtlePark,04/01/2016 09:00:00 AM,48,-122,33,103,136
19714,ElliotBayTrailMyrtlePark,04/01/2016 10:00:00 AM,48,-122,29,54,83
19715,ElliotBayTrailMyrtlePark,04/01/2016 11:00:00 AM,48,-122,27,37,64
19716,ElliotBayTrailMyrtlePark,04/01/2016 12:00:00 PM,48,-122,27,21,48
19717,ElliotBayTrailMyrtlePark,04/01/2016 01:00:00 PM,48,-122,43,48,91
19718,ElliotBayTrailMyrtlePark,04/01/2016 02:00:00 PM,48,-122,49,46,95
19719,ElliotBayTrailMyrtlePark,04/01/2016 03:00:00 PM,48,-122,73,35,108
19720,ElliotBayTrailMyrtlePark,04/01/2016 04:00:00 PM,48,-122,124,70,194
19721,ElliotBayTrailMyrtlePark,04/01/2016 05:00:00 PM,48,-122,221,72,293
19722,ElliotBayTrailMyrtlePark,04/01/2016 06:00:00 PM,48,-122,156,86,242
19723,ElliotBayTrailMyrtlePark,04/01/2016 07:00:00 PM,48,-122,89,57,146
19724,ElliotBayTrailMyrtlePark,04/01/2016 08:00:00 PM,48,-122,30,27,57
19725,ElliotBayTrailMyrtlePark,04/01/2016 09:00:00 PM,48,-122,10,9,19
19726,ElliotBayTrailMyrtlePark,04/01/2016 10:00:00 PM,48,-122,7,5,12
19727,ElliotBayTrailMyrtlePark,04/01/2016 11:00:00 PM,48,-122,4,4,8
19728,ElliotBayTrailMyrtlePark,04/02/2016 12:00:00 AM,48,-122,2,0,2
19729,ElliotBayTrailMyrtlePark,04/02/2016 01:00:00 AM,48,-122,1,2,3
19730,ElliotBayTrailMyrtlePark,04/02/2016 02:00:00 AM,48,-122,1,0,1
19731,ElliotBayTrailMyrtlePark,04/02/2016 03:00:00 AM,48,-122,0,0,0
19732,ElliotBayTrailMyrtlePark,04/02/2016 04:00:00 AM,48,-122,1,0,1
19733,ElliotBayTrailMyrtlePark,04/02/2016 05:00:00 AM,48,-122,0,1,1
19734,ElliotBayTrailMyrtlePark,04/02/2016 06:00:00 AM,48,-122,4,3,7
19735,ElliotBayTrailMyrtlePark,04/02/2016 07:00:00 AM,48,-122,2,3,5
19736,ElliotBayTrailMyrtlePark,04/02/2016 08:00:00 AM,48,-122,11,10,21
19737,ElliotBayTrailMyrtlePark,04/02/2016 09:00:00 AM,48,-122,23,29,52
19738,ElliotBayTrailMyrtlePark,04/02/2016 10:00:00 AM,48,-122,25,37,62
19739,ElliotBayTrailMyrtlePark,04/02/2016 11:00:00 AM,48,-122,69,35,104
19740,ElliotBayTrailMyrtlePark,04/02/2016 12:00:00 PM,48,-122,33,44,77
19741,ElliotBayTrailMyrtlePark,04/02/2016 01:00:00 PM,48,-122,54,46,100
19742,ElliotBayTrailMyrtlePark,04/02/2016 02:00:00 PM,48,-122,53,54,107
19743,ElliotBayTrailMyrtlePark,04/02/2016 03:00:00 PM,48,-122,64,87,151
19744,ElliotBayTrailMyrtlePark,04/02/2016 04:00:00 PM,48,-122,70,55,125
19745,ElliotBayTrailMyrtlePark,04/02/2016 05:00:00 PM,48,-122,53,75,128
19746,ElliotBayTrailMyrtlePark,04/02/2016 06:00:00 PM,48,-122,49,60,109
19747,ElliotBayTrailMyrtlePark,04/02/2016 07:00:00 PM,48,-122,25,41,66
19748,ElliotBayTrailMyrtlePark,04/02/2016 08:00:00 PM,48,-122,30,20,50
19749,ElliotBayTrailMyrtlePark,04/02/2016 09:00:00 PM,48,-122,12,1,13
19750,ElliotBayTrailMyrtlePark,04/02/2016 10:00:00 PM,48,-122,16,1,17
19751,ElliotBayTrailMyrtlePark,04/02/2016 11:00:00 PM,48,-122,9,0,9
19752,ElliotBayTrailMyrtlePark,04/03/2016 12:00:00 AM,48,-122,21,2,23
19753,ElliotBayTrailMyrtlePark,04/03/2016 01:00:00 AM,48,-122,2,0,2
19754,ElliotBayTrailMyrtlePark,04/03/2016 02:00:00 AM,48,-122,0,0,0
19755,ElliotBayTrailMyrtlePark,04/03/2016 03:00:00 AM,48,-122,4,0,4
19756,ElliotBayTrailMyrtlePark,04/03/2016 04:00:00 AM,48,-122,0,0,0
19757,ElliotBayTrailMyrtlePark,04/03/2016 05:00:00 AM,48,-122,1,1,2
19758,ElliotBayTrailMyrtlePark,04/03/2016 06:00:00 AM,48,-122,5,2,7
19759,ElliotBayTrailMyrtlePark,04/03/2016 07:00:00 AM,48,-122,2,3,5
19760,ElliotBayTrailMyrtlePark,04/03/2016 08:00:00 AM,48,-122,9,14,23
19761,ElliotBayTrailMyrtlePark,04/03/2016 09:00:00 AM,48,-122,23,22,45
19762,ElliotBayTrailMyrtlePark,04/03/2016 10:00:00 AM,48,-122,44,34,78
19763,ElliotBayTrailMyrtlePark,04/03/2016 11:00:00 AM,48,-122,76,74,150
19764,ElliotBayTrailMyrtlePark,04/03/2016 12:00:00 PM,48,-122,71,56,127
19765,ElliotBayTrailMyrtlePark,04/03/2016 01:00:00 PM,48,-122,79,60,139
19766,ElliotBayTrailMyrtlePark,04/03/2016 02:00:00 PM,48,-122,82,73,155
19767,ElliotBayTrailMyrtlePark,04/03/2016 03:00:00 PM,48,-122,72,73,145
19768,ElliotBayTrailMyrtlePark,04/03/2016 04:00:00 PM,48,-122,92,78,170
19769,ElliotBayTrailMyrtlePark,04/03/2016 05:00:00 PM,48,-122,60,70,130
19770,ElliotBayTrailMyrtlePark,04/03/2016 06:00:00 PM,48,-122,37,48,85
19771,ElliotBayTrailMyrtlePark,04/03/2016 07:00:00 PM,48,-122,22,28,50
19772,ElliotBayTrailMyrtlePark,04/03/2016 08:00:00 PM,48,-122,4,10,14
19773,ElliotBayTrailMyrtlePark,04/03/2016 09:00:00 PM,48,-122,2,1,3
19774,ElliotBayTrailMyrtlePark,04/03/2016 10:00:00 PM,48,-122,0,2,2
19775,ElliotBayTrailMyrtlePark,04/03/2016 11:00:00 PM,48,-122,2,1,3
19776,ElliotBayTrailMyrtlePark,04/04/2016 12:00:00 AM,48,-122,0,1,1
19777,ElliotBayTrailMyrtlePark,04/04/2016 01:00:00 AM,48,-122,0,0,0
19778,ElliotBayTrailMyrtlePark,04/04/2016 02:00:00 AM,48,-122,0,0,0
19779,ElliotBayTrailMyrtlePark,04/04/2016 03:00:00 AM,48,-122,1,0,1
19780,ElliotBayTrailMyrtlePark,04/04/2016 04:00:00 AM,48,-122,0,0,0
19781,ElliotBayTrailMyrtlePark,04/04/2016 05:00:00 AM,48,-122,3,2,5
19782,ElliotBayTrailMyrtlePark,04/04/2016 06:00:00 AM,48,-122,15,13,28
19783,ElliotBayTrailMyrtlePark,04/04/2016 07:00:00 AM,48,-122,18,41,59
19784,ElliotBayTrailMyrtlePark,04/04/2016 08:00:00 AM,48,-122,22,115,137
19785,ElliotBayTrailMyrtlePark,04/04/2016 09:00:00 AM,48,-122,16,83,99
19786,ElliotBayTrailMyrtlePark,04/04/2016 10:00:00 AM,48,-122,8,20,28
19787,ElliotBayTrailMyrtlePark,04/04/2016 11:00:00 AM,48,-122,13,18,31
19788,ElliotBayTrailMyrtlePark,04/04/2016 12:00:00 PM,48,-122,22,10,32
19789,ElliotBayTrailMyrtlePark,04/04/2016 01:00:00 PM,48,-122,15,15,30
19790,ElliotBayTrailMyrtlePark,04/04/2016 02:00:00 PM,48,-122,12,15,27
19791,ElliotBayTrailMyrtlePark,04/04/2016 03:00:00 PM,48,-122,15,13,28
19792,ElliotBayTrailMyrtlePark,04/04/2016 04:00:00 PM,48,-122,36,26,62
19793,ElliotBayTrailMyrtlePark,04/04/2016 05:00:00 PM,48,-122,120,56,176
19794,ElliotBayTrailMyrtlePark,04/04/2016 06:00:00 PM,48,-122,122,26,148
19795,ElliotBayTrailMyrtlePark,04/04/2016 07:00:00 PM,48,-122,34,25,59
19796,ElliotBayTrailMyrtlePark,04/04/2016 08:00:00 PM,48,-122,17,6,23
19797,ElliotBayTrailMyrtlePark,04/04/2016 09:00:00 PM,48,-122,6,9,15
19798,ElliotBayTrailMyrtlePark,04/04/2016 10:00:00 PM,48,-122,1,0,1
19799,ElliotBayTrailMyrtlePark,04/04/2016 11:00:00 PM,48,-122,2,1,3
19800,ElliotBayTrailMyrtlePark,04/05/2016 12:00:00 AM,48,-122,1,1,2
19801,ElliotBayTrailMyrtlePark,04/05/2016 01:00:00 AM,48,-122,0,0,0
19802,ElliotBayTrailMyrtlePark,04/05/2016 02:00:00 AM,48,-122,0,0,0
19803,ElliotBayTrailMyrtlePark,04/05/2016 03:00:00 AM,48,-122,2,1,3
19804,ElliotBayTrailMyrtlePark,04/05/2016 04:00:00 AM,48,-122,0,0,0
19805,ElliotBayTrailMyrtlePark,04/05/2016 05:00:00 AM,48,-122,5,2,7
19806,ElliotBayTrailMyrtlePark,04/05/2016 06:00:00 AM,48,-122,12,21,33
19807,ElliotBayTrailMyrtlePark,04/05/2016 07:00:00 AM,48,-122,19,49,68
19808,ElliotBayTrailMyrtlePark,04/05/2016 08:00:00 AM,48,-122,29,170,199
19809,ElliotBayTrailMyrtlePark,04/05/2016 09:00:00 AM,48,-122,24,97,121
19810,ElliotBayTrailMyrtlePark,04/05/2016 10:00:00 AM,48,-122,19,36,55
19811,ElliotBayTrailMyrtlePark,04/05/2016 11:00:00 AM,48,-122,14,13,27
19812,ElliotBayTrailMyrtlePark,04/05/2016 12:00:00 PM,48,-122,16,13,29
19813,ElliotBayTrailMyrtlePark,04/05/2016 01:00:00 PM,48,-122,19,15,34
19814,ElliotBayTrailMyrtlePark,04/05/2016 02:00:00 PM,48,-122,9,8,17
19815,ElliotBayTrailMyrtlePark,04/05/2016 03:00:00 PM,48,-122,16,15,31
19816,ElliotBayTrailMyrtlePark,04/05/2016 04:00:00 PM,48,-122,51,41,92
19817,ElliotBayTrailMyrtlePark,04/05/2016 05:00:00 PM,48,-122,132,47,179
19818,ElliotBayTrailMyrtlePark,04/05/2016 06:00:00 PM,48,-122,158,43,201
19819,ElliotBayTrailMyrtlePark,04/05/2016 07:00:00 PM,48,-122,48,18,66
19820,ElliotBayTrailMyrtlePark,04/05/2016 08:00:00 PM,48,-122,36,12,48
19821,ElliotBayTrailMyrtlePark,04/05/2016 09:00:00 PM,48,-122,9,3,12
19822,ElliotBayTrailMyrtlePark,04/05/2016 10:00:00 PM,48,-122,3,1,4
19823,ElliotBayTrailMyrtlePark,04/05/2016 11:00:00 PM,48,-122,0,3,3
19824,ElliotBayTrailMyrtlePark,04/06/2016 12:00:00 AM,48,-122,3,0,3
19825,ElliotBayTrailMyrtlePark,04/06/2016 01:00:00 AM,48,-122,2,1,3
19826,ElliotBayTrailMyrtlePark,04/06/2016 02:00:00 AM,48,-122,3,0,3
19827,ElliotBayTrailMyrtlePark,04/06/2016 03:00:00 AM,48,-122,0,0,0
19828,ElliotBayTrailMyrtlePark,04/06/2016 04:00:00 AM,48,-122,2,1,3
19829,ElliotBayTrailMyrtlePark,04/06/2016 05:00:00 AM,48,-122,7,1,8
19830,ElliotBayTrailMyrtlePark,04/06/2016 06:00:00 AM,48,-122,12,19,31
19831,ElliotBayTrailMyrtlePark,04/06/2016 07:00:00 AM,48,-122,35,60,95
19832,ElliotBayTrailMyrtlePark,04/06/2016 08:00:00 AM,48,-122,39,180,219
19833,ElliotBayTrailMyrtlePark,04/06/2016 09:00:00 AM,48,-122,37,119,156
19834,ElliotBayTrailMyrtlePark,04/06/2016 10:00:00 AM,48,-122,26,28,54
19835,ElliotBayTrailMyrtlePark,04/06/2016 11:00:00 AM,48,-122,23,31,54
19836,ElliotBayTrailMyrtlePark,04/06/2016 12:00:00 PM,48,-122,21,27,48
19837,ElliotBayTrailMyrtlePark,04/06/2016 01:00:00 PM,48,-122,28,33,61
19838,ElliotBayTrailMyrtlePark,04/06/2016 02:00:00 PM,48,-122,33,29,62
19839,ElliotBayTrailMyrtlePark,04/06/2016 03:00:00 PM,48,-122,47,26,73
19840,ElliotBayTrailMyrtlePark,04/06/2016 04:00:00 PM,48,-122,96,66,162
19841,ElliotBayTrailMyrtlePark,04/06/2016 05:00:00 PM,48,-122,187,64,251
19842,ElliotBayTrailMyrtlePark,04/06/2016 06:00:00 PM,48,-122,184,73,257
19843,ElliotBayTrailMyrtlePark,04/06/2016 07:00:00 PM,48,-122,96,42,138
19844,ElliotBayTrailMyrtlePark,04/06/2016 08:00:00 PM,48,-122,35,22,57
19845,ElliotBayTrailMyrtlePark,04/06/2016 09:00:00 PM,48,-122,9,2,11
19846,ElliotBayTrailMyrtlePark,04/06/2016 10:00:00 PM,48,-122,2,1,3
19847,ElliotBayTrailMyrtlePark,04/06/2016 11:00:00 PM,48,-122,8,0,8
19848,ElliotBayTrailMyrtlePark,04/07/2016 12:00:00 AM,48,-122,0,1,1
19849,ElliotBayTrailMyrtlePark,04/07/2016 01:00:00 AM,48,-122,1,0,1
19850,ElliotBayTrailMyrtlePark,04/07/2016 02:00:00 AM,48,-122,1,0,1
19851,ElliotBayTrailMyrtlePark,04/07/2016 03:00:00 AM,48,-122,2,0,2
19852,ElliotBayTrailMyrtlePark,04/07/2016 04:00:00 AM,48,-122,0,0,0
19853,ElliotBayTrailMyrtlePark,04/07/2016 05:00:00 AM,48,-122,8,2,10
19854,ElliotBayTrailMyrtlePark,04/07/2016 06:00:00 AM,48,-122,12,26,38
19855,ElliotBayTrailMyrtlePark,04/07/2016 07:00:00 AM,48,-122,31,68,99
19856,ElliotBayTrailMyrtlePark,04/07/2016 08:00:00 AM,48,-122,31,210,241
19857,ElliotBayTrailMyrtlePark,04/07/2016 09:00:00 AM,48,-122,32,111,143
19858,ElliotBayTrailMyrtlePark,04/07/2016 10:00:00 AM,48,-122,18,35,53
19859,ElliotBayTrailMyrtlePark,04/07/2016 11:00:00 AM,48,-122,33,25,58
19860,ElliotBayTrailMyrtlePark,04/07/2016 12:00:00 PM,48,-122,37,46,83
19861,ElliotBayTrailMyrtlePark,04/07/2016 01:00:00 PM,48,-122,28,33,61
19862,ElliotBayTrailMyrtlePark,04/07/2016 02:00:00 PM,48,-122,60,42,102
19863,ElliotBayTrailMyrtlePark,04/07/2016 03:00:00 PM,48,-122,56,42,98
19864,ElliotBayTrailMyrtlePark,04/07/2016 04:00:00 PM,48,-122,129,78,207
19865,ElliotBayTrailMyrtlePark,04/07/2016 05:00:00 PM,48,-122,219,86,305
19866,ElliotBayTrailMyrtlePark,04/07/2016 06:00:00 PM,48,-122,182,79,261
19867,ElliotBayTrailMyrtlePark,04/07/2016 07:00:00 PM,48,-122,111,59,170
19868,ElliotBayTrailMyrtlePark,04/07/2016 08:00:00 PM,48,-122,92,55,147
19869,ElliotBayTrailMyrtlePark,04/07/2016 09:00:00 PM,48,-122,16,10,26
19870,ElliotBayTrailMyrtlePark,04/07/2016 10:00:00 PM,48,-122,4,14,18
19871,ElliotBayTrailMyrtlePark,04/07/2016 11:00:00 PM,48,-122,6,11,17
19872,ElliotBayTrailMyrtlePark,04/08/2016 12:00:00 AM,48,-122,2,9,11
19873,ElliotBayTrailMyrtlePark,04/08/2016 01:00:00 AM,48,-122,3,2,5
19874,ElliotBayTrailMyrtlePark,04/08/2016 02:00:00 AM,48,-122,1,2,3
19875,ElliotBayTrailMyrtlePark,04/08/2016 03:00:00 AM,48,-122,1,0,1
19876,ElliotBayTrailMyrtlePark,04/08/2016 04:00:00 AM,48,-122,1,1,2
19877,ElliotBayTrailMyrtlePark,04/08/2016 05:00:00 AM,48,-122,3,4,7
19878,ElliotBayTrailMyrtlePark,04/08/2016 06:00:00 AM,48,-122,13,20,33
19879,ElliotBayTrailMyrtlePark,04/08/2016 07:00:00 AM,48,-122,24,78,102
19880,ElliotBayTrailMyrtlePark,04/08/2016 08:00:00 AM,48,-122,26,188,214
19881,ElliotBayTrailMyrtlePark,04/08/2016 09:00:00 AM,48,-122,29,104,133
19882,ElliotBayTrailMyrtlePark,04/08/2016 10:00:00 AM,48,-122,15,41,56
19883,ElliotBayTrailMyrtlePark,04/08/2016 11:00:00 AM,48,-122,24,29,53
19884,ElliotBayTrailMyrtlePark,04/08/2016 12:00:00 PM,48,-122,21,22,43
19885,ElliotBayTrailMyrtlePark,04/08/2016 01:00:00 PM,48,-122,35,31,66
19886,ElliotBayTrailMyrtlePark,04/08/2016 02:00:00 PM,48,-122,46,34,80
19887,ElliotBayTrailMyrtlePark,04/08/2016 03:00:00 PM,48,-122,63,48,111
19888,ElliotBayTrailMyrtlePark,04/08/2016 04:00:00 PM,48,-122,125,77,202
19889,ElliotBayTrailMyrtlePark,04/08/2016 05:00:00 PM,48,-122,167,98,265
19890,ElliotBayTrailMyrtlePark,04/08/2016 06:00:00 PM,48,-122,135,61,196
19891,ElliotBayTrailMyrtlePark,04/08/2016 07:00:00 PM,48,-122,73,26,99
19892,ElliotBayTrailMyrtlePark,04/08/2016 08:00:00 PM,48,-122,27,25,52
19893,ElliotBayTrailMyrtlePark,04/08/2016 09:00:00 PM,48,-122,9,5,14
19894,ElliotBayTrailMyrtlePark,04/08/2016 10:00:00 PM,48,-122,10,4,14
19895,ElliotBayTrailMyrtlePark,04/08/2016 11:00:00 PM,48,-122,28,2,30
19896,ElliotBayTrailMyrtlePark,04/09/2016 12:00:00 AM,48,-122,7,1,8
19897,ElliotBayTrailMyrtlePark,04/09/2016 01:00:00 AM,48,-122,6,0,6
19898,ElliotBayTrailMyrtlePark,04/09/2016 02:00:00 AM,48,-122,1,1,2
19899,ElliotBayTrailMyrtlePark,04/09/2016 03:00:00 AM,48,-122,1,0,1
19900,ElliotBayTrailMyrtlePark,04/09/2016 04:00:00 AM,48,-122,1,0,1
19901,ElliotBayTrailMyrtlePark,04/09/2016 05:00:00 AM,48,-122,1,0,1
19902,ElliotBayTrailMyrtlePark,04/09/2016 06:00:00 AM,48,-122,4,3,7
19903,ElliotBayTrailMyrtlePark,04/09/2016 07:00:00 AM,48,-122,2,5,7
19904,ElliotBayTrailMyrtlePark,04/09/2016 08:00:00 AM,48,-122,19,18,37
19905,ElliotBayTrailMyrtlePark,04/09/2016 09:00:00 AM,48,-122,16,23,39
19906,ElliotBayTrailMyrtlePark,04/09/2016 10:00:00 AM,48,-122,63,34,97
19907,ElliotBayTrailMyrtlePark,04/09/2016 11:00:00 AM,48,-122,48,66,114
19908,ElliotBayTrailMyrtlePark,04/09/2016 12:00:00 PM,48,-122,69,94,163
19909,ElliotBayTrailMyrtlePark,04/09/2016 01:00:00 PM,48,-122,62,68,130
19910,ElliotBayTrailMyrtlePark,04/09/2016 02:00:00 PM,48,-122,67,91,158
19911,ElliotBayTrailMyrtlePark,04/09/2016 03:00:00 PM,48,-122,107,102,209
19912,ElliotBayTrailMyrtlePark,04/09/2016 04:00:00 PM,48,-122,95,83,178
19913,ElliotBayTrailMyrtlePark,04/09/2016 05:00:00 PM,48,-122,113,62,175
19914,ElliotBayTrailMyrtlePark,04/09/2016 06:00:00 PM,48,-122,49,56,105
19915,ElliotBayTrailMyrtlePark,04/09/2016 07:00:00 PM,48,-122,36,35,71
19916,ElliotBayTrailMyrtlePark,04/09/2016 08:00:00 PM,48,-122,33,32,65
19917,ElliotBayTrailMyrtlePark,04/09/2016 09:00:00 PM,48,-122,13,8,21
19918,ElliotBayTrailMyrtlePark,04/09/2016 10:00:00 PM,48,-122,13,5,18
19919,ElliotBayTrailMyrtlePark,04/09/2016 11:00:00 PM,48,-122,4,1,5
19920,ElliotBayTrailMyrtlePark,04/10/2016 12:00:00 AM,48,-122,2,2,4
19921,ElliotBayTrailMyrtlePark,04/10/2016 01:00:00 AM,48,-122,3,1,4
19922,ElliotBayTrailMyrtlePark,04/10/2016 02:00:00 AM,48,-122,3,0,3
19923,ElliotBayTrailMyrtlePark,04/10/2016 03:00:00 AM,48,-122,1,0,1
19924,ElliotBayTrailMyrtlePark,04/10/2016 04:00:00 AM,48,-122,0,0,0
19925,ElliotBayTrailMyrtlePark,04/10/2016 05:00:00 AM,48,-122,1,0,1
19926,ElliotBayTrailMyrtlePark,04/10/2016 06:00:00 AM,48,-122,1,1,2
19927,ElliotBayTrailMyrtlePark,04/10/2016 07:00:00 AM,48,-122,3,4,7
19928,ElliotBayTrailMyrtlePark,04/10/2016 08:00:00 AM,48,-122,7,9,16
19929,ElliotBayTrailMyrtlePark,04/10/2016 09:00:00 AM,48,-122,14,24,38
19930,ElliotBayTrailMyrtlePark,04/10/2016 10:00:00 AM,48,-122,24,18,42
19931,ElliotBayTrailMyrtlePark,04/10/2016 11:00:00 AM,48,-122,41,46,87
19932,ElliotBayTrailMyrtlePark,04/10/2016 12:00:00 PM,48,-122,49,41,90
19933,ElliotBayTrailMyrtlePark,04/10/2016 01:00:00 PM,48,-122,52,54,106
19934,ElliotBayTrailMyrtlePark,04/10/2016 02:00:00 PM,48,-122,59,41,100
19935,ElliotBayTrailMyrtlePark,04/10/2016 03:00:00 PM,48,-122,47,34,81
19936,ElliotBayTrailMyrtlePark,04/10/2016 04:00:00 PM,48,-122,60,56,116
19937,ElliotBayTrailMyrtlePark,04/10/2016 05:00:00 PM,48,-122,68,45,113
19938,ElliotBayTrailMyrtlePark,04/10/2016 06:00:00 PM,48,-122,50,25,75
19939,ElliotBayTrailMyrtlePark,04/10/2016 07:00:00 PM,48,-122,27,31,58
19940,ElliotBayTrailMyrtlePark,04/10/2016 08:00:00 PM,48,-122,12,20,32
19941,ElliotBayTrailMyrtlePark,04/10/2016 09:00:00 PM,48,-122,2,0,2
19942,ElliotBayTrailMyrtlePark,04/10/2016 10:00:00 PM,48,-122,1,4,5
19943,ElliotBayTrailMyrtlePark,04/10/2016 11:00:00 PM,48,-122,1,0,1
19944,ElliotBayTrailMyrtlePark,04/11/2016 12:00:00 AM,48,-122,1,0,1
19945,ElliotBayTrailMyrtlePark,04/11/2016 01:00:00 AM,48,-122,0,0,0
19946,ElliotBayTrailMyrtlePark,04/11/2016 02:00:00 AM,48,-122,2,1,3
19947,ElliotBayTrailMyrtlePark,04/11/2016 03:00:00 AM,48,-122,2,0,2
19948,ElliotBayTrailMyrtlePark,04/11/2016 04:00:00 AM,48,-122,0,1,1
19949,ElliotBayTrailMyrtlePark,04/11/2016 05:00:00 AM,48,-122,7,4,11
19950,ElliotBayTrailMyrtlePark,04/11/2016 06:00:00 AM,48,-122,13,19,32
19951,ElliotBayTrailMyrtlePark,04/11/2016 07:00:00 AM,48,-122,22,43,65
19952,ElliotBayTrailMyrtlePark,04/11/2016 08:00:00 AM,48,-122,34,161,195
19953,ElliotBayTrailMyrtlePark,04/11/2016 09:00:00 AM,48,-122,38,106,144
19954,ElliotBayTrailMyrtlePark,04/11/2016 10:00:00 AM,48,-122,10,27,37
19955,ElliotBayTrailMyrtlePark,04/11/2016 11:00:00 AM,48,-122,20,16,36
19956,ElliotBayTrailMyrtlePark,04/11/2016 12:00:00 PM,48,-122,21,27,48
19957,ElliotBayTrailMyrtlePark,04/11/2016 01:00:00 PM,48,-122,13,14,27
19958,ElliotBayTrailMyrtlePark,04/11/2016 02:00:00 PM,48,-122,21,13,34
19959,ElliotBayTrailMyrtlePark,04/11/2016 03:00:00 PM,48,-122,21,17,38
19960,ElliotBayTrailMyrtlePark,04/11/2016 04:00:00 PM,48,-122,47,34,81
19961,ElliotBayTrailMyrtlePark,04/11/2016 05:00:00 PM,48,-122,130,60,190
19962,ElliotBayTrailMyrtlePark,04/11/2016 06:00:00 PM,48,-122,150,37,187
19963,ElliotBayTrailMyrtlePark,04/11/2016 07:00:00 PM,48,-122,55,27,82
19964,ElliotBayTrailMyrtlePark,04/11/2016 08:00:00 PM,48,-122,22,15,37
19965,ElliotBayTrailMyrtlePark,04/11/2016 09:00:00 PM,48,-122,2,3,5
19966,ElliotBayTrailMyrtlePark,04/11/2016 10:00:00 PM,48,-122,12,1,13
19967,ElliotBayTrailMyrtlePark,04/11/2016 11:00:00 PM,48,-122,5,3,8
19968,ElliotBayTrailMyrtlePark,04/12/2016 12:00:00 AM,48,-122,0,0,0
19969,ElliotBayTrailMyrtlePark,04/12/2016 01:00:00 AM,48,-122,1,0,1
19970,ElliotBayTrailMyrtlePark,04/12/2016 02:00:00 AM,48,-122,4,0,4
19971,ElliotBayTrailMyrtlePark,04/12/2016 03:00:00 AM,48,-122,1,0,1
19972,ElliotBayTrailMyrtlePark,04/12/2016 04:00:00 AM,48,-122,1,1,2
19973,ElliotBayTrailMyrtlePark,04/12/2016 05:00:00 AM,48,-122,4,3,7
19974,ElliotBayTrailMyrtlePark,04/12/2016 06:00:00 AM,48,-122,12,14,26
19975,ElliotBayTrailMyrtlePark,04/12/2016 07:00:00 AM,48,-122,24,41,65
19976,ElliotBayTrailMyrtlePark,04/12/2016 08:00:00 AM,48,-122,23,129,152
19977,ElliotBayTrailMyrtlePark,04/12/2016 09:00:00 AM,48,-122,21,84,105
19978,ElliotBayTrailMyrtlePark,04/12/2016 10:00:00 AM,48,-122,11,16,27
19979,ElliotBayTrailMyrtlePark,04/12/2016 11:00:00 AM,48,-122,14,21,35
19980,ElliotBayTrailMyrtlePark,04/12/2016 12:00:00 PM,48,-122,12,16,28
19981,ElliotBayTrailMyrtlePark,04/12/2016 01:00:00 PM,48,-122,10,12,22
19982,ElliotBayTrailMyrtlePark,04/12/2016 02:00:00 PM,48,-122,16,10,26
19983,ElliotBayTrailMyrtlePark,04/12/2016 03:00:00 PM,48,-122,15,10,25
19984,ElliotBayTrailMyrtlePark,04/12/2016 04:00:00 PM,48,-122,31,17,48
19985,ElliotBayTrailMyrtlePark,04/12/2016 05:00:00 PM,48,-122,78,33,111
19986,ElliotBayTrailMyrtlePark,04/12/2016 06:00:00 PM,48,-122,94,9,103
19987,ElliotBayTrailMyrtlePark,04/12/2016 07:00:00 PM,48,-122,33,5,38
19988,ElliotBayTrailMyrtlePark,04/12/2016 08:00:00 PM,48,-122,11,3,14
19989,ElliotBayTrailMyrtlePark,04/12/2016 09:00:00 PM,48,-122,3,1,4
19990,ElliotBayTrailMyrtlePark,04/12/2016 10:00:00 PM,48,-122,5,1,6
19991,ElliotBayTrailMyrtlePark,04/12/2016 11:00:00 PM,48,-122,0,0,0
19992,ElliotBayTrailMyrtlePark,04/13/2016 12:00:00 AM,48,-122,0,0,0
19993,ElliotBayTrailMyrtlePark,04/13/2016 01:00:00 AM,48,-122,0,0,0
19994,ElliotBayTrailMyrtlePark,04/13/2016 02:00:00 AM,48,-122,0,0,0
19995,ElliotBayTrailMyrtlePark,04/13/2016 03:00:00 AM,48,-122,0,0,0
19996,ElliotBayTrailMyrtlePark,04/13/2016 04:00:00 AM,48,-122,1,0,1
19997,ElliotBayTrailMyrtlePark,04/13/2016 05:00:00 AM,48,-122,7,2,9
19998,ElliotBayTrailMyrtlePark,04/13/2016 06:00:00 AM,48,-122,13,18,31
19999,ElliotBayTrailMyrtlePark,04/13/2016 07:00:00 AM,48,-122,17,41,58
20000,ElliotBayTrailMyrtlePark,04/13/2016 08:00:00 AM,48,-122,31,111,142
20001,ElliotBayTrailMyrtlePark,04/13/2016 09:00:00 AM,48,-122,26,76,102
20002,ElliotBayTrailMyrtlePark,04/13/2016 10:00:00 AM,48,-122,13,29,42
20003,ElliotBayTrailMyrtlePark,04/13/2016 11:00:00 AM,48,-122,11,22,33
20004,ElliotBayTrailMyrtlePark,04/13/2016 12:00:00 PM,48,-122,16,23,39
20005,ElliotBayTrailMyrtlePark,04/13/2016 01:00:00 PM,48,-122,16,22,38
20006,ElliotBayTrailMyrtlePark,04/13/2016 02:00:00 PM,48,-122,23,22,45
20007,ElliotBayTrailMyrtlePark,04/13/2016 03:00:00 PM,48,-122,27,27,54
20008,ElliotBayTrailMyrtlePark,04/13/2016 04:00:00 PM,48,-122,46,29,75
20009,ElliotBayTrailMyrtlePark,04/13/2016 05:00:00 PM,48,-122,121,63,184
20010,ElliotBayTrailMyrtlePark,04/13/2016 06:00:00 PM,48,-122,123,36,159
20011,ElliotBayTrailMyrtlePark,04/13/2016 07:00:00 PM,48,-122,49,34,83
20012,ElliotBayTrailMyrtlePark,04/13/2016 08:00:00 PM,48,-122,24,11,35
20013,ElliotBayTrailMyrtlePark,04/13/2016 09:00:00 PM,48,-122,8,3,11
20014,ElliotBayTrailMyrtlePark,04/13/2016 10:00:00 PM,48,-122,1,3,4
20015,ElliotBayTrailMyrtlePark,04/13/2016 11:00:00 PM,48,-122,1,1,2
20016,ElliotBayTrailMyrtlePark,04/14/2016 12:00:00 AM,48,-122,0,0,0
20017,ElliotBayTrailMyrtlePark,04/14/2016 01:00:00 AM,48,-122,0,0,0
20018,ElliotBayTrailMyrtlePark,04/14/2016 02:00:00 AM,48,-122,1,0,1
20019,ElliotBayTrailMyrtlePark,04/14/2016 03:00:00 AM,48,-122,1,0,1
20020,ElliotBayTrailMyrtlePark,04/14/2016 04:00:00 AM,48,-122,0,0,0
20021,ElliotBayTrailMyrtlePark,04/14/2016 05:00:00 AM,48,-122,8,0,8
20022,ElliotBayTrailMyrtlePark,04/14/2016 06:00:00 AM,48,-122,7,17,24
20023,ElliotBayTrailMyrtlePark,04/14/2016 07:00:00 AM,48,-122,19,55,74
20024,ElliotBayTrailMyrtlePark,04/14/2016 08:00:00 AM,48,-122,27,124,151
20025,ElliotBayTrailMyrtlePark,04/14/2016 09:00:00 AM,48,-122,37,84,121
20026,ElliotBayTrailMyrtlePark,04/14/2016 10:00:00 AM,48,-122,20,31,51
20027,ElliotBayTrailMyrtlePark,04/14/2016 11:00:00 AM,48,-122,11,25,36
20028,ElliotBayTrailMyrtlePark,04/14/2016 12:00:00 PM,48,-122,18,20,38
20029,ElliotBayTrailMyrtlePark,04/14/2016 01:00:00 PM,48,-122,20,22,42
20030,ElliotBayTrailMyrtlePark,04/14/2016 02:00:00 PM,48,-122,32,22,54
20031,ElliotBayTrailMyrtlePark,04/14/2016 03:00:00 PM,48,-122,20,19,39
20032,ElliotBayTrailMyrtlePark,04/14/2016 04:00:00 PM,48,-122,62,48,110
20033,ElliotBayTrailMyrtlePark,04/14/2016 05:00:00 PM,48,-122,129,54,183
20034,ElliotBayTrailMyrtlePark,04/14/2016 06:00:00 PM,48,-122,158,45,203
20035,ElliotBayTrailMyrtlePark,04/14/2016 07:00:00 PM,48,-122,69,28,97
20036,ElliotBayTrailMyrtlePark,04/14/2016 08:00:00 PM,48,-122,33,16,49
20037,ElliotBayTrailMyrtlePark,04/14/2016 09:00:00 PM,48,-122,4,10,14
20038,ElliotBayTrailMyrtlePark,04/14/2016 10:00:00 PM,48,-122,10,3,13
20039,ElliotBayTrailMyrtlePark,04/14/2016 11:00:00 PM,48,-122,2,5,7
20040,ElliotBayTrailMyrtlePark,04/15/2016 12:00:00 AM,48,-122,2,2,4
20041,ElliotBayTrailMyrtlePark,04/15/2016 01:00:00 AM,48,-122,0,3,3
20042,ElliotBayTrailMyrtlePark,04/15/2016 02:00:00 AM,48,-122,0,0,0
20043,ElliotBayTrailMyrtlePark,04/15/2016 03:00:00 AM,48,-122,1,1,2
20044,ElliotBayTrailMyrtlePark,04/15/2016 04:00:00 AM,48,-122,0,0,0
20045,ElliotBayTrailMyrtlePark,04/15/2016 05:00:00 AM,48,-122,7,5,12
20046,ElliotBayTrailMyrtlePark,04/15/2016 06:00:00 AM,48,-122,13,17,30
20047,ElliotBayTrailMyrtlePark,04/15/2016 07:00:00 AM,48,-122,21,66,87
20048,ElliotBayTrailMyrtlePark,04/15/2016 08:00:00 AM,48,-122,28,111,139
20049,ElliotBayTrailMyrtlePark,04/15/2016 09:00:00 AM,48,-122,29,85,114
20050,ElliotBayTrailMyrtlePark,04/15/2016 10:00:00 AM,48,-122,24,29,53
20051,ElliotBayTrailMyrtlePark,04/15/2016 11:00:00 AM,48,-122,29,24,53
20052,ElliotBayTrailMyrtlePark,04/15/2016 12:00:00 PM,48,-122,16,24,40
20053,ElliotBayTrailMyrtlePark,04/15/2016 01:00:00 PM,48,-122,26,11,37
20054,ElliotBayTrailMyrtlePark,04/15/2016 02:00:00 PM,48,-122,32,23,55
20055,ElliotBayTrailMyrtlePark,04/15/2016 03:00:00 PM,48,-122,50,18,68
20056,ElliotBayTrailMyrtlePark,04/15/2016 04:00:00 PM,48,-122,49,42,91
20057,ElliotBayTrailMyrtlePark,04/15/2016 05:00:00 PM,48,-122,131,46,177
20058,ElliotBayTrailMyrtlePark,04/15/2016 06:00:00 PM,48,-122,94,31,125
20059,ElliotBayTrailMyrtlePark,04/15/2016 07:00:00 PM,48,-122,41,16,57
20060,ElliotBayTrailMyrtlePark,04/15/2016 08:00:00 PM,48,-122,23,10,33
20061,ElliotBayTrailMyrtlePark,04/15/2016 09:00:00 PM,48,-122,2,2,4
20062,ElliotBayTrailMyrtlePark,04/15/2016 10:00:00 PM,48,-122,2,3,5
20063,ElliotBayTrailMyrtlePark,04/15/2016 11:00:00 PM,48,-122,2,0,2
20064,ElliotBayTrailMyrtlePark,04/16/2016 12:00:00 AM,48,-122,2,1,3
20065,ElliotBayTrailMyrtlePark,04/16/2016 01:00:00 AM,48,-122,1,0,1
20066,ElliotBayTrailMyrtlePark,04/16/2016 02:00:00 AM,48,-122,2,0,2
20067,ElliotBayTrailMyrtlePark,04/16/2016 03:00:00 AM,48,-122,2,0,2
20068,ElliotBayTrailMyrtlePark,04/16/2016 04:00:00 AM,48,-122,0,0,0
20069,ElliotBayTrailMyrtlePark,04/16/2016 05:00:00 AM,48,-122,0,3,3
20070,ElliotBayTrailMyrtlePark,04/16/2016 06:00:00 AM,48,-122,2,5,7
20071,ElliotBayTrailMyrtlePark,04/16/2016 07:00:00 AM,48,-122,2,14,16
20072,ElliotBayTrailMyrtlePark,04/16/2016 08:00:00 AM,48,-122,15,16,31
20073,ElliotBayTrailMyrtlePark,04/16/2016 09:00:00 AM,48,-122,27,31,58
20074,ElliotBayTrailMyrtlePark,04/16/2016 10:00:00 AM,48,-122,20,32,52
20075,ElliotBayTrailMyrtlePark,04/16/2016 11:00:00 AM,48,-122,47,59,106
20076,ElliotBayTrailMyrtlePark,04/16/2016 12:00:00 PM,48,-122,67,56,123
20077,ElliotBayTrailMyrtlePark,04/16/2016 01:00:00 PM,48,-122,67,67,134
20078,ElliotBayTrailMyrtlePark,04/16/2016 02:00:00 PM,48,-122,61,62,123
20079,ElliotBayTrailMyrtlePark,04/16/2016 03:00:00 PM,48,-122,82,77,159
20080,ElliotBayTrailMyrtlePark,04/16/2016 04:00:00 PM,48,-122,57,43,100
20081,ElliotBayTrailMyrtlePark,04/16/2016 05:00:00 PM,48,-122,67,83,150
20082,ElliotBayTrailMyrtlePark,04/16/2016 06:00:00 PM,48,-122,69,87,156
20083,ElliotBayTrailMyrtlePark,04/16/2016 07:00:00 PM,48,-122,25,46,71
20084,ElliotBayTrailMyrtlePark,04/16/2016 08:00:00 PM,48,-122,28,19,47
20085,ElliotBayTrailMyrtlePark,04/16/2016 09:00:00 PM,48,-122,30,2,32
20086,ElliotBayTrailMyrtlePark,04/16/2016 10:00:00 PM,48,-122,13,10,23
20087,ElliotBayTrailMyrtlePark,04/16/2016 11:00:00 PM,48,-122,21,5,26
20088,ElliotBayTrailMyrtlePark,04/17/2016 12:00:00 AM,48,-122,4,2,6
20089,ElliotBayTrailMyrtlePark,04/17/2016 01:00:00 AM,48,-122,4,0,4
20090,ElliotBayTrailMyrtlePark,04/17/2016 02:00:00 AM,48,-122,1,0,1
20091,ElliotBayTrailMyrtlePark,04/17/2016 03:00:00 AM,48,-122,3,0,3
20092,ElliotBayTrailMyrtlePark,04/17/2016 04:00:00 AM,48,-122,0,0,0
20093,ElliotBayTrailMyrtlePark,04/17/2016 05:00:00 AM,48,-122,0,2,2
20094,ElliotBayTrailMyrtlePark,04/17/2016 06:00:00 AM,48,-122,1,2,3
20095,ElliotBayTrailMyrtlePark,04/17/2016 07:00:00 AM,48,-122,3,8,11
20096,ElliotBayTrailMyrtlePark,04/17/2016 08:00:00 AM,48,-122,17,14,31
20097,ElliotBayTrailMyrtlePark,04/17/2016 09:00:00 AM,48,-122,32,36,68
20098,ElliotBayTrailMyrtlePark,04/17/2016 10:00:00 AM,48,-122,56,63,119
20099,ElliotBayTrailMyrtlePark,04/17/2016 11:00:00 AM,48,-122,80,70,150
20100,ElliotBayTrailMyrtlePark,04/17/2016 12:00:00 PM,48,-122,78,102,180
20101,ElliotBayTrailMyrtlePark,04/17/2016 01:00:00 PM,48,-122,114,65,179
20102,ElliotBayTrailMyrtlePark,04/17/2016 02:00:00 PM,48,-122,111,72,183
20103,ElliotBayTrailMyrtlePark,04/17/2016 03:00:00 PM,48,-122,83,99,182
20104,ElliotBayTrailMyrtlePark,04/17/2016 04:00:00 PM,48,-122,80,79,159
20105,ElliotBayTrailMyrtlePark,04/17/2016 05:00:00 PM,48,-122,93,86,179
20106,ElliotBayTrailMyrtlePark,04/17/2016 06:00:00 PM,48,-122,40,45,85
20107,ElliotBayTrailMyrtlePark,04/17/2016 07:00:00 PM,48,-122,44,46,90
20108,ElliotBayTrailMyrtlePark,04/17/2016 08:00:00 PM,48,-122,18,24,42
20109,ElliotBayTrailMyrtlePark,04/17/2016 09:00:00 PM,48,-122,2,1,3
20110,ElliotBayTrailMyrtlePark,04/17/2016 10:00:00 PM,48,-122,2,4,6
20111,ElliotBayTrailMyrtlePark,04/17/2016 11:00:00 PM,48,-122,0,4,4
20112,ElliotBayTrailMyrtlePark,04/18/2016 12:00:00 AM,48,-122,2,6,8
20113,ElliotBayTrailMyrtlePark,04/18/2016 01:00:00 AM,48,-122,0,0,0
20114,ElliotBayTrailMyrtlePark,04/18/2016 02:00:00 AM,48,-122,1,0,1
20115,ElliotBayTrailMyrtlePark,04/18/2016 03:00:00 AM,48,-122,4,0,4
20116,ElliotBayTrailMyrtlePark,04/18/2016 04:00:00 AM,48,-122,1,1,2
20117,ElliotBayTrailMyrtlePark,04/18/2016 05:00:00 AM,48,-122,4,2,6
20118,ElliotBayTrailMyrtlePark,04/18/2016 06:00:00 AM,48,-122,22,28,50
20119,ElliotBayTrailMyrtlePark,04/18/2016 07:00:00 AM,48,-122,36,95,131
20120,ElliotBayTrailMyrtlePark,04/18/2016 08:00:00 AM,48,-122,50,191,241
20121,ElliotBayTrailMyrtlePark,04/18/2016 09:00:00 AM,48,-122,43,128,171
20122,ElliotBayTrailMyrtlePark,04/18/2016 10:00:00 AM,48,-122,31,42,73
20123,ElliotBayTrailMyrtlePark,04/18/2016 11:00:00 AM,48,-122,23,31,54
20124,ElliotBayTrailMyrtlePark,04/18/2016 12:00:00 PM,48,-122,25,48,73
20125,ElliotBayTrailMyrtlePark,04/18/2016 01:00:00 PM,48,-122,37,38,75
20126,ElliotBayTrailMyrtlePark,04/18/2016 02:00:00 PM,48,-122,39,23,62
20127,ElliotBayTrailMyrtlePark,04/18/2016 03:00:00 PM,48,-122,44,40,84
20128,ElliotBayTrailMyrtlePark,04/18/2016 04:00:00 PM,48,-122,106,69,175
20129,ElliotBayTrailMyrtlePark,04/18/2016 05:00:00 PM,48,-122,267,86,353
20130,ElliotBayTrailMyrtlePark,04/18/2016 06:00:00 PM,48,-122,219,67,286
20131,ElliotBayTrailMyrtlePark,04/18/2016 07:00:00 PM,48,-122,117,56,173
20132,ElliotBayTrailMyrtlePark,04/18/2016 08:00:00 PM,48,-122,48,34,82
20133,ElliotBayTrailMyrtlePark,04/18/2016 09:00:00 PM,48,-122,9,19,28
20134,ElliotBayTrailMyrtlePark,04/18/2016 10:00:00 PM,48,-122,8,3,11
20135,ElliotBayTrailMyrtlePark,04/18/2016 11:00:00 PM,48,-122,1,3,4
20136,ElliotBayTrailMyrtlePark,04/19/2016 12:00:00 AM,48,-122,2,0,2
20137,ElliotBayTrailMyrtlePark,04/19/2016 01:00:00 AM,48,-122,0,0,0
20138,ElliotBayTrailMyrtlePark,04/19/2016 02:00:00 AM,48,-122,2,0,2
20139,ElliotBayTrailMyrtlePark,04/19/2016 03:00:00 AM,48,-122,2,0,2
20140,ElliotBayTrailMyrtlePark,04/19/2016 04:00:00 AM,48,-122,0,0,0
20141,ElliotBayTrailMyrtlePark,04/19/2016 05:00:00 AM,48,-122,10,3,13
20142,ElliotBayTrailMyrtlePark,04/19/2016 06:00:00 AM,48,-122,20,33,53
20143,ElliotBayTrailMyrtlePark,04/19/2016 07:00:00 AM,48,-122,51,106,157
20144,ElliotBayTrailMyrtlePark,04/19/2016 08:00:00 AM,48,-122,56,233,289
20145,ElliotBayTrailMyrtlePark,04/19/2016 09:00:00 AM,48,-122,39,134,173
20146,ElliotBayTrailMyrtlePark,04/19/2016 10:00:00 AM,48,-122,28,37,65
20147,ElliotBayTrailMyrtlePark,04/19/2016 11:00:00 AM,48,-122,30,23,53
20148,ElliotBayTrailMyrtlePark,04/19/2016 12:00:00 PM,48,-122,23,26,49
20149,ElliotBayTrailMyrtlePark,04/19/2016 01:00:00 PM,48,-122,25,33,58
20150,ElliotBayTrailMyrtlePark,04/19/2016 02:00:00 PM,48,-122,48,45,93
20151,ElliotBayTrailMyrtlePark,04/19/2016 03:00:00 PM,48,-122,57,48,105
20152,ElliotBayTrailMyrtlePark,04/19/2016 04:00:00 PM,48,-122,143,73,216
20153,ElliotBayTrailMyrtlePark,04/19/2016 05:00:00 PM,48,-122,244,87,331
20154,ElliotBayTrailMyrtlePark,04/19/2016 06:00:00 PM,48,-122,242,66,308
20155,ElliotBayTrailMyrtlePark,04/19/2016 07:00:00 PM,48,-122,126,50,176
20156,ElliotBayTrailMyrtlePark,04/19/2016 08:00:00 PM,48,-122,45,53,98
20157,ElliotBayTrailMyrtlePark,04/19/2016 09:00:00 PM,48,-122,12,9,21
20158,ElliotBayTrailMyrtlePark,04/19/2016 10:00:00 PM,48,-122,11,15,26
20159,ElliotBayTrailMyrtlePark,04/19/2016 11:00:00 PM,48,-122,3,3,6
20160,ElliotBayTrailMyrtlePark,04/20/2016 12:00:00 AM,48,-122,2,1,3
20161,ElliotBayTrailMyrtlePark,04/20/2016 01:00:00 AM,48,-122,3,2,5
20162,ElliotBayTrailMyrtlePark,04/20/2016 02:00:00 AM,48,-122,1,0,1
20163,ElliotBayTrailMyrtlePark,04/20/2016 03:00:00 AM,48,-122,1,0,1
20164,ElliotBayTrailMyrtlePark,04/20/2016 04:00:00 AM,48,-122,1,0,1
20165,ElliotBayTrailMyrtlePark,04/20/2016 05:00:00 AM,48,-122,4,5,9
20166,ElliotBayTrailMyrtlePark,04/20/2016 06:00:00 AM,48,-122,17,25,42
20167,ElliotBayTrailMyrtlePark,04/20/2016 07:00:00 AM,48,-122,39,106,145
20168,ElliotBayTrailMyrtlePark,04/20/2016 08:00:00 AM,48,-122,52,203,255
20169,ElliotBayTrailMyrtlePark,04/20/2016 09:00:00 AM,48,-122,40,108,148
20170,ElliotBayTrailMyrtlePark,04/20/2016 10:00:00 AM,48,-122,29,43,72
20171,ElliotBayTrailMyrtlePark,04/20/2016 11:00:00 AM,48,-122,20,32,52
20172,ElliotBayTrailMyrtlePark,04/20/2016 12:00:00 PM,48,-122,39,27,66
20173,ElliotBayTrailMyrtlePark,04/20/2016 01:00:00 PM,48,-122,35,31,66
20174,ElliotBayTrailMyrtlePark,04/20/2016 02:00:00 PM,48,-122,27,28,55
20175,ElliotBayTrailMyrtlePark,04/20/2016 03:00:00 PM,48,-122,41,39,80
20176,ElliotBayTrailMyrtlePark,04/20/2016 04:00:00 PM,48,-122,91,59,150
20177,ElliotBayTrailMyrtlePark,04/20/2016 05:00:00 PM,48,-122,204,95,299
20178,ElliotBayTrailMyrtlePark,04/20/2016 06:00:00 PM,48,-122,200,91,291
20179,ElliotBayTrailMyrtlePark,04/20/2016 07:00:00 PM,48,-122,92,52,144
20180,ElliotBayTrailMyrtlePark,04/20/2016 08:00:00 PM,48,-122,51,39,90
20181,ElliotBayTrailMyrtlePark,04/20/2016 09:00:00 PM,48,-122,13,15,28
20182,ElliotBayTrailMyrtlePark,04/20/2016 10:00:00 PM,48,-122,10,2,12
20183,ElliotBayTrailMyrtlePark,04/20/2016 11:00:00 PM,48,-122,2,8,10
20184,ElliotBayTrailMyrtlePark,04/21/2016 12:00:00 AM,48,-122,2,1,3
20185,ElliotBayTrailMyrtlePark,04/21/2016 01:00:00 AM,48,-122,2,1,3
20186,ElliotBayTrailMyrtlePark,04/21/2016 02:00:00 AM,48,-122,0,0,0
20187,ElliotBayTrailMyrtlePark,04/21/2016 03:00:00 AM,48,-122,1,0,1
20188,ElliotBayTrailMyrtlePark,04/21/2016 04:00:00 AM,48,-122,1,0,1
20189,ElliotBayTrailMyrtlePark,04/21/2016 05:00:00 AM,48,-122,8,4,12
20190,ElliotBayTrailMyrtlePark,04/21/2016 06:00:00 AM,48,-122,24,29,53
20191,ElliotBayTrailMyrtlePark,04/21/2016 07:00:00 AM,48,-122,35,59,94
20192,ElliotBayTrailMyrtlePark,04/21/2016 08:00:00 AM,48,-122,45,190,235
20193,ElliotBayTrailMyrtlePark,04/21/2016 09:00:00 AM,48,-122,42,111,153
20194,ElliotBayTrailMyrtlePark,04/21/2016 10:00:00 AM,48,-122,20,30,50
20195,ElliotBayTrailMyrtlePark,04/21/2016 11:00:00 AM,48,-122,32,33,65
20196,ElliotBayTrailMyrtlePark,04/21/2016 12:00:00 PM,48,-122,25,17,42
20197,ElliotBayTrailMyrtlePark,04/21/2016 01:00:00 PM,48,-122,26,24,50
20198,ElliotBayTrailMyrtlePark,04/21/2016 02:00:00 PM,48,-122,25,32,57
20199,ElliotBayTrailMyrtlePark,04/21/2016 03:00:00 PM,48,-122,61,46,107
20200,ElliotBayTrailMyrtlePark,04/21/2016 04:00:00 PM,48,-122,79,61,140
20201,ElliotBayTrailMyrtlePark,04/21/2016 05:00:00 PM,48,-122,192,84,276
20202,ElliotBayTrailMyrtlePark,04/21/2016 06:00:00 PM,48,-122,182,56,238
20203,ElliotBayTrailMyrtlePark,04/21/2016 07:00:00 PM,48,-122,92,50,142
20204,ElliotBayTrailMyrtlePark,04/21/2016 08:00:00 PM,48,-122,50,28,78
20205,ElliotBayTrailMyrtlePark,04/21/2016 09:00:00 PM,48,-122,5,7,12
20206,ElliotBayTrailMyrtlePark,04/21/2016 10:00:00 PM,48,-122,5,5,10
20207,ElliotBayTrailMyrtlePark,04/21/2016 11:00:00 PM,48,-122,9,4,13
20208,ElliotBayTrailMyrtlePark,04/22/2016 12:00:00 AM,48,-122,1,0,1
20209,ElliotBayTrailMyrtlePark,04/22/2016 01:00:00 AM,48,-122,0,0,0
20210,ElliotBayTrailMyrtlePark,04/22/2016 02:00:00 AM,48,-122,1,0,1
20211,ElliotBayTrailMyrtlePark,04/22/2016 03:00:00 AM,48,-122,3,0,3
20212,ElliotBayTrailMyrtlePark,04/22/2016 04:00:00 AM,48,-122,0,0,0
20213,ElliotBayTrailMyrtlePark,04/22/2016 05:00:00 AM,48,-122,6,7,13
20214,ElliotBayTrailMyrtlePark,04/22/2016 06:00:00 AM,48,-122,14,20,34
20215,ElliotBayTrailMyrtlePark,04/22/2016 07:00:00 AM,48,-122,19,48,67
20216,ElliotBayTrailMyrtlePark,04/22/2016 08:00:00 AM,48,-122,32,133,165
20217,ElliotBayTrailMyrtlePark,04/22/2016 09:00:00 AM,48,-122,25,84,109
20218,ElliotBayTrailMyrtlePark,04/22/2016 10:00:00 AM,48,-122,18,30,48
20219,ElliotBayTrailMyrtlePark,04/22/2016 11:00:00 AM,48,-122,25,28,53
20220,ElliotBayTrailMyrtlePark,04/22/2016 12:00:00 PM,48,-122,15,16,31
20221,ElliotBayTrailMyrtlePark,04/22/2016 01:00:00 PM,48,-122,15,10,25
20222,ElliotBayTrailMyrtlePark,04/22/2016 02:00:00 PM,48,-122,22,16,38
20223,ElliotBayTrailMyrtlePark,04/22/2016 03:00:00 PM,48,-122,27,17,44
20224,ElliotBayTrailMyrtlePark,04/22/2016 04:00:00 PM,48,-122,54,27,81
20225,ElliotBayTrailMyrtlePark,04/22/2016 05:00:00 PM,48,-122,124,38,162
20226,ElliotBayTrailMyrtlePark,04/22/2016 06:00:00 PM,48,-122,112,27,139
20227,ElliotBayTrailMyrtlePark,04/22/2016 07:00:00 PM,48,-122,40,15,55
20228,ElliotBayTrailMyrtlePark,04/22/2016 08:00:00 PM,48,-122,16,5,21
20229,ElliotBayTrailMyrtlePark,04/22/2016 09:00:00 PM,48,-122,3,3,6
20230,ElliotBayTrailMyrtlePark,04/22/2016 10:00:00 PM,48,-122,2,3,5
20231,ElliotBayTrailMyrtlePark,04/22/2016 11:00:00 PM,48,-122,1,3,4
20232,ElliotBayTrailMyrtlePark,04/23/2016 12:00:00 AM,48,-122,0,1,1
20233,ElliotBayTrailMyrtlePark,04/23/2016 01:00:00 AM,48,-122,1,1,2
20234,ElliotBayTrailMyrtlePark,04/23/2016 02:00:00 AM,48,-122,0,0,0
20235,ElliotBayTrailMyrtlePark,04/23/2016 03:00:00 AM,48,-122,2,0,2
20236,ElliotBayTrailMyrtlePark,04/23/2016 04:00:00 AM,48,-122,1,0,1
20237,ElliotBayTrailMyrtlePark,04/23/2016 05:00:00 AM,48,-122,0,0,0
20238,ElliotBayTrailMyrtlePark,04/23/2016 06:00:00 AM,48,-122,4,7,11
20239,ElliotBayTrailMyrtlePark,04/23/2016 07:00:00 AM,48,-122,2,8,10
20240,ElliotBayTrailMyrtlePark,04/23/2016 08:00:00 AM,48,-122,8,15,23
20241,ElliotBayTrailMyrtlePark,04/23/2016 09:00:00 AM,48,-122,16,20,36
20242,ElliotBayTrailMyrtlePark,04/23/2016 10:00:00 AM,48,-122,24,38,62
20243,ElliotBayTrailMyrtlePark,04/23/2016 11:00:00 AM,48,-122,38,41,79
20244,ElliotBayTrailMyrtlePark,04/23/2016 12:00:00 PM,48,-122,55,42,97
20245,ElliotBayTrailMyrtlePark,04/23/2016 01:00:00 PM,48,-122,45,30,75
20246,ElliotBayTrailMyrtlePark,04/23/2016 02:00:00 PM,48,-122,64,52,116
20247,ElliotBayTrailMyrtlePark,04/23/2016 03:00:00 PM,48,-122,55,53,108
20248,ElliotBayTrailMyrtlePark,04/23/2016 04:00:00 PM,48,-122,67,46,113
20249,ElliotBayTrailMyrtlePark,04/23/2016 05:00:00 PM,48,-122,33,38,71
20250,ElliotBayTrailMyrtlePark,04/23/2016 06:00:00 PM,48,-122,30,15,45
20251,ElliotBayTrailMyrtlePark,04/23/2016 07:00:00 PM,48,-122,12,8,20
20252,ElliotBayTrailMyrtlePark,04/23/2016 08:00:00 PM,48,-122,17,8,25
20253,ElliotBayTrailMyrtlePark,04/23/2016 09:00:00 PM,48,-122,5,3,8
20254,ElliotBayTrailMyrtlePark,04/23/2016 10:00:00 PM,48,-122,2,2,4
20255,ElliotBayTrailMyrtlePark,04/23/2016 11:00:00 PM,48,-122,0,3,3
20256,ElliotBayTrailMyrtlePark,04/24/2016 12:00:00 AM,48,-122,2,0,2
20257,ElliotBayTrailMyrtlePark,04/24/2016 01:00:00 AM,48,-122,1,0,1
20258,ElliotBayTrailMyrtlePark,04/24/2016 02:00:00 AM,48,-122,0,2,2
20259,ElliotBayTrailMyrtlePark,04/24/2016 03:00:00 AM,48,-122,2,0,2
20260,ElliotBayTrailMyrtlePark,04/24/2016 04:00:00 AM,48,-122,0,0,0
20261,ElliotBayTrailMyrtlePark,04/24/2016 05:00:00 AM,48,-122,0,0,0
20262,ElliotBayTrailMyrtlePark,04/24/2016 06:00:00 AM,48,-122,1,3,4
20263,ElliotBayTrailMyrtlePark,04/24/2016 07:00:00 AM,48,-122,5,4,9
20264,ElliotBayTrailMyrtlePark,04/24/2016 08:00:00 AM,48,-122,6,8,14
20265,ElliotBayTrailMyrtlePark,04/24/2016 09:00:00 AM,48,-122,4,2,6
20266,ElliotBayTrailMyrtlePark,04/24/2016 10:00:00 AM,48,-122,2,8,10
20267,ElliotBayTrailMyrtlePark,04/24/2016 11:00:00 AM,48,-122,2,3,5
20268,ElliotBayTrailMyrtlePark,04/24/2016 12:00:00 PM,48,-122,9,5,14
20269,ElliotBayTrailMyrtlePark,04/24/2016 01:00:00 PM,48,-122,9,2,11
20270,ElliotBayTrailMyrtlePark,04/24/2016 02:00:00 PM,48,-122,7,2,9
20271,ElliotBayTrailMyrtlePark,04/24/2016 03:00:00 PM,48,-122,6,7,13
20272,ElliotBayTrailMyrtlePark,04/24/2016 04:00:00 PM,48,-122,9,16,25
20273,ElliotBayTrailMyrtlePark,04/24/2016 05:00:00 PM,48,-122,17,13,30
20274,ElliotBayTrailMyrtlePark,04/24/2016 06:00:00 PM,48,-122,6,12,18
20275,ElliotBayTrailMyrtlePark,04/24/2016 07:00:00 PM,48,-122,2,1,3
20276,ElliotBayTrailMyrtlePark,04/24/2016 08:00:00 PM,48,-122,3,3,6
20277,ElliotBayTrailMyrtlePark,04/24/2016 09:00:00 PM,48,-122,0,0,0
20278,ElliotBayTrailMyrtlePark,04/24/2016 10:00:00 PM,48,-122,3,4,7
20279,ElliotBayTrailMyrtlePark,04/24/2016 11:00:00 PM,48,-122,0,0,0
20280,ElliotBayTrailMyrtlePark,04/25/2016 12:00:00 AM,48,-122,0,0,0
20281,ElliotBayTrailMyrtlePark,04/25/2016 01:00:00 AM,48,-122,1,0,1
20282,ElliotBayTrailMyrtlePark,04/25/2016 02:00:00 AM,48,-122,1,0,1
20283,ElliotBayTrailMyrtlePark,04/25/2016 03:00:00 AM,48,-122,2,0,2
20284,ElliotBayTrailMyrtlePark,04/25/2016 04:00:00 AM,48,-122,0,0,0
20285,ElliotBayTrailMyrtlePark,04/25/2016 05:00:00 AM,48,-122,4,3,7
20286,ElliotBayTrailMyrtlePark,04/25/2016 06:00:00 AM,48,-122,12,23,35
20287,ElliotBayTrailMyrtlePark,04/25/2016 07:00:00 AM,48,-122,26,45,71
20288,ElliotBayTrailMyrtlePark,04/25/2016 08:00:00 AM,48,-122,36,109,145
20289,ElliotBayTrailMyrtlePark,04/25/2016 09:00:00 AM,48,-122,24,73,97
20290,ElliotBayTrailMyrtlePark,04/25/2016 10:00:00 AM,48,-122,7,23,30
20291,ElliotBayTrailMyrtlePark,04/25/2016 11:00:00 AM,48,-122,19,15,34
20292,ElliotBayTrailMyrtlePark,04/25/2016 12:00:00 PM,48,-122,22,14,36
20293,ElliotBayTrailMyrtlePark,04/25/2016 01:00:00 PM,48,-122,15,17,32
20294,ElliotBayTrailMyrtlePark,04/25/2016 02:00:00 PM,48,-122,32,23,55
20295,ElliotBayTrailMyrtlePark,04/25/2016 03:00:00 PM,48,-122,37,20,57
20296,ElliotBayTrailMyrtlePark,04/25/2016 04:00:00 PM,48,-122,49,46,95
20297,ElliotBayTrailMyrtlePark,04/25/2016 05:00:00 PM,48,-122,130,62,192
20298,ElliotBayTrailMyrtlePark,04/25/2016 06:00:00 PM,48,-122,147,69,216
20299,ElliotBayTrailMyrtlePark,04/25/2016 07:00:00 PM,48,-122,61,20,81
20300,ElliotBayTrailMyrtlePark,04/25/2016 08:00:00 PM,48,-122,22,17,39
20301,ElliotBayTrailMyrtlePark,04/25/2016 09:00:00 PM,48,-122,4,11,15
20302,ElliotBayTrailMyrtlePark,04/25/2016 10:00:00 PM,48,-122,13,12,25
20303,ElliotBayTrailMyrtlePark,04/25/2016 11:00:00 PM,48,-122,1,1,2
20304,ElliotBayTrailMyrtlePark,04/26/2016 12:00:00 AM,48,-122,2,4,6
20305,ElliotBayTrailMyrtlePark,04/26/2016 01:00:00 AM,48,-122,0,0,0
20306,ElliotBayTrailMyrtlePark,04/26/2016 02:00:00 AM,48,-122,2,0,2
20307,ElliotBayTrailMyrtlePark,04/26/2016 03:00:00 AM,48,-122,0,0,0
20308,ElliotBayTrailMyrtlePark,04/26/2016 04:00:00 AM,48,-122,0,0,0
20309,ElliotBayTrailMyrtlePark,04/26/2016 05:00:00 AM,48,-122,4,2,6
20310,ElliotBayTrailMyrtlePark,04/26/2016 06:00:00 AM,48,-122,17,27,44
20311,ElliotBayTrailMyrtlePark,04/26/2016 07:00:00 AM,48,-122,37,67,104
20312,ElliotBayTrailMyrtlePark,04/26/2016 08:00:00 AM,48,-122,47,185,232
20313,ElliotBayTrailMyrtlePark,04/26/2016 09:00:00 AM,48,-122,36,129,165
20314,ElliotBayTrailMyrtlePark,04/26/2016 10:00:00 AM,48,-122,26,33,59
20315,ElliotBayTrailMyrtlePark,04/26/2016 11:00:00 AM,48,-122,20,21,41
20316,ElliotBayTrailMyrtlePark,04/26/2016 12:00:00 PM,48,-122,22,21,43
20317,ElliotBayTrailMyrtlePark,04/26/2016 01:00:00 PM,48,-122,16,14,30
20318,ElliotBayTrailMyrtlePark,04/26/2016 02:00:00 PM,48,-122,35,24,59
20319,ElliotBayTrailMyrtlePark,04/26/2016 03:00:00 PM,48,-122,39,44,83
20320,ElliotBayTrailMyrtlePark,04/26/2016 04:00:00 PM,48,-122,77,63,140
20321,ElliotBayTrailMyrtlePark,04/26/2016 05:00:00 PM,48,-122,202,79,281
20322,ElliotBayTrailMyrtlePark,04/26/2016 06:00:00 PM,48,-122,153,55,208
20323,ElliotBayTrailMyrtlePark,04/26/2016 07:00:00 PM,48,-122,70,42,112
20324,ElliotBayTrailMyrtlePark,04/26/2016 08:00:00 PM,48,-122,33,9,42
20325,ElliotBayTrailMyrtlePark,04/26/2016 09:00:00 PM,48,-122,4,5,9
20326,ElliotBayTrailMyrtlePark,04/26/2016 10:00:00 PM,48,-122,8,5,13
20327,ElliotBayTrailMyrtlePark,04/26/2016 11:00:00 PM,48,-122,17,2,19
20328,ElliotBayTrailMyrtlePark,04/27/2016 12:00:00 AM,48,-122,0,0,0
20329,ElliotBayTrailMyrtlePark,04/27/2016 01:00:00 AM,48,-122,1,0,1
20330,ElliotBayTrailMyrtlePark,04/27/2016 02:00:00 AM,48,-122,0,0,0
20331,ElliotBayTrailMyrtlePark,04/27/2016 03:00:00 AM,48,-122,2,0,2
20332,ElliotBayTrailMyrtlePark,04/27/2016 04:00:00 AM,48,-122,0,0,0
20333,ElliotBayTrailMyrtlePark,04/27/2016 05:00:00 AM,48,-122,4,2,6
20334,ElliotBayTrailMyrtlePark,04/27/2016 06:00:00 AM,48,-122,18,25,43
20335,ElliotBayTrailMyrtlePark,04/27/2016 07:00:00 AM,48,-122,31,65,96
20336,ElliotBayTrailMyrtlePark,04/27/2016 08:00:00 AM,48,-122,48,152,200
20337,ElliotBayTrailMyrtlePark,04/27/2016 09:00:00 AM,48,-122,34,105,139
20338,ElliotBayTrailMyrtlePark,04/27/2016 10:00:00 AM,48,-122,23,39,62
20339,ElliotBayTrailMyrtlePark,04/27/2016 11:00:00 AM,48,-122,22,37,59
20340,ElliotBayTrailMyrtlePark,04/27/2016 12:00:00 PM,48,-122,13,21,34
20341,ElliotBayTrailMyrtlePark,04/27/2016 01:00:00 PM,48,-122,22,15,37
20342,ElliotBayTrailMyrtlePark,04/27/2016 02:00:00 PM,48,-122,23,25,48
20343,ElliotBayTrailMyrtlePark,04/27/2016 03:00:00 PM,48,-122,26,21,47
20344,ElliotBayTrailMyrtlePark,04/27/2016 04:00:00 PM,48,-122,75,40,115
20345,ElliotBayTrailMyrtlePark,04/27/2016 05:00:00 PM,48,-122,192,80,272
20346,ElliotBayTrailMyrtlePark,04/27/2016 06:00:00 PM,48,-122,175,61,236
20347,ElliotBayTrailMyrtlePark,04/27/2016 07:00:00 PM,48,-122,80,41,121
20348,ElliotBayTrailMyrtlePark,04/27/2016 08:00:00 PM,48,-122,35,15,50
20349,ElliotBayTrailMyrtlePark,04/27/2016 09:00:00 PM,48,-122,9,8,17
20350,ElliotBayTrailMyrtlePark,04/27/2016 10:00:00 PM,48,-122,11,2,13
20351,ElliotBayTrailMyrtlePark,04/27/2016 11:00:00 PM,48,-122,13,0,13
20352,ElliotBayTrailMyrtlePark,04/28/2016 12:00:00 AM,48,-122,1,0,1
20353,ElliotBayTrailMyrtlePark,04/28/2016 01:00:00 AM,48,-122,1,1,2
20354,ElliotBayTrailMyrtlePark,04/28/2016 02:00:00 AM,48,-122,2,0,2
20355,ElliotBayTrailMyrtlePark,04/28/2016 03:00:00 AM,48,-122,1,0,1
20356,ElliotBayTrailMyrtlePark,04/28/2016 04:00:00 AM,48,-122,1,0,1
20357,ElliotBayTrailMyrtlePark,04/28/2016 05:00:00 AM,48,-122,5,3,8
20358,ElliotBayTrailMyrtlePark,04/28/2016 06:00:00 AM,48,-122,19,26,45
20359,ElliotBayTrailMyrtlePark,04/28/2016 07:00:00 AM,48,-122,43,93,136
20360,ElliotBayTrailMyrtlePark,04/28/2016 08:00:00 AM,48,-122,41,164,205
20361,ElliotBayTrailMyrtlePark,04/28/2016 09:00:00 AM,48,-122,26,102,128
20362,ElliotBayTrailMyrtlePark,04/28/2016 10:00:00 AM,48,-122,31,31,62
20363,ElliotBayTrailMyrtlePark,04/28/2016 11:00:00 AM,48,-122,24,24,48
20364,ElliotBayTrailMyrtlePark,04/28/2016 12:00:00 PM,48,-122,15,25,40
20365,ElliotBayTrailMyrtlePark,04/28/2016 01:00:00 PM,48,-122,21,18,39
20366,ElliotBayTrailMyrtlePark,04/28/2016 02:00:00 PM,48,-122,29,20,49
20367,ElliotBayTrailMyrtlePark,04/28/2016 03:00:00 PM,48,-122,30,39,69
20368,ElliotBayTrailMyrtlePark,04/28/2016 04:00:00 PM,48,-122,73,48,121
20369,ElliotBayTrailMyrtlePark,04/28/2016 05:00:00 PM,48,-122,157,74,231
20370,ElliotBayTrailMyrtlePark,04/28/2016 06:00:00 PM,48,-122,160,60,220
20371,ElliotBayTrailMyrtlePark,04/28/2016 07:00:00 PM,48,-122,82,21,103
20372,ElliotBayTrailMyrtlePark,04/28/2016 08:00:00 PM,48,-122,24,18,42
20373,ElliotBayTrailMyrtlePark,04/28/2016 09:00:00 PM,48,-122,7,3,10
20374,ElliotBayTrailMyrtlePark,04/28/2016 10:00:00 PM,48,-122,3,5,8
20375,ElliotBayTrailMyrtlePark,04/28/2016 11:00:00 PM,48,-122,8,4,12
20376,ElliotBayTrailMyrtlePark,04/29/2016 12:00:00 AM,48,-122,4,1,5
20377,ElliotBayTrailMyrtlePark,04/29/2016 01:00:00 AM,48,-122,0,0,0
20378,ElliotBayTrailMyrtlePark,04/29/2016 02:00:00 AM,48,-122,0,0,0
20379,ElliotBayTrailMyrtlePark,04/29/2016 03:00:00 AM,48,-122,2,0,2
20380,ElliotBayTrailMyrtlePark,04/29/2016 04:00:00 AM,48,-122,2,1,3
20381,ElliotBayTrailMyrtlePark,04/29/2016 05:00:00 AM,48,-122,5,7,12
20382,ElliotBayTrailMyrtlePark,04/29/2016 06:00:00 AM,48,-122,23,30,53
20383,ElliotBayTrailMyrtlePark,04/29/2016 07:00:00 AM,48,-122,45,87,132
20384,ElliotBayTrailMyrtlePark,04/29/2016 08:00:00 AM,48,-122,48,167,215
20385,ElliotBayTrailMyrtlePark,04/29/2016 09:00:00 AM,48,-122,32,91,123
20386,ElliotBayTrailMyrtlePark,04/29/2016 10:00:00 AM,48,-122,19,23,42
20387,ElliotBayTrailMyrtlePark,04/29/2016 11:00:00 AM,48,-122,13,15,28
20388,ElliotBayTrailMyrtlePark,04/29/2016 12:00:00 PM,48,-122,13,3,16
20389,ElliotBayTrailMyrtlePark,04/29/2016 01:00:00 PM,48,-122,15,11,26
20390,ElliotBayTrailMyrtlePark,04/29/2016 02:00:00 PM,48,-122,23,11,34
20391,ElliotBayTrailMyrtlePark,04/29/2016 03:00:00 PM,48,-122,41,32,73
20392,ElliotBayTrailMyrtlePark,04/29/2016 04:00:00 PM,48,-122,72,53,125
20393,ElliotBayTrailMyrtlePark,04/29/2016 05:00:00 PM,48,-122,198,86,284
20394,ElliotBayTrailMyrtlePark,04/29/2016 06:00:00 PM,48,-122,114,59,173
20395,ElliotBayTrailMyrtlePark,04/29/2016 07:00:00 PM,48,-122,59,43,102
20396,ElliotBayTrailMyrtlePark,04/29/2016 08:00:00 PM,48,-122,33,26,59
20397,ElliotBayTrailMyrtlePark,04/29/2016 09:00:00 PM,48,-122,8,5,13
20398,ElliotBayTrailMyrtlePark,04/29/2016 10:00:00 PM,48,-122,11,7,18
20399,ElliotBayTrailMyrtlePark,04/29/2016 11:00:00 PM,48,-122,12,3,15
20400,ElliotBayTrailMyrtlePark,04/30/2016 12:00:00 AM,48,-122,1,0,1
20401,ElliotBayTrailMyrtlePark,04/30/2016 01:00:00 AM,48,-122,1,1,2
20402,ElliotBayTrailMyrtlePark,04/30/2016 02:00:00 AM,48,-122,1,0,1
20403,ElliotBayTrailMyrtlePark,04/30/2016 03:00:00 AM,48,-122,4,0,4
20404,ElliotBayTrailMyrtlePark,04/30/2016 04:00:00 AM,48,-122,0,0,0
20405,ElliotBayTrailMyrtlePark,04/30/2016 05:00:00 AM,48,-122,2,2,4
20406,ElliotBayTrailMyrtlePark,04/30/2016 06:00:00 AM,48,-122,4,9,13
20407,ElliotBayTrailMyrtlePark,04/30/2016 07:00:00 AM,48,-122,4,16,20
20408,ElliotBayTrailMyrtlePark,04/30/2016 08:00:00 AM,48,-122,9,18,27
20409,ElliotBayTrailMyrtlePark,04/30/2016 09:00:00 AM,48,-122,27,34,61
20410,ElliotBayTrailMyrtlePark,04/30/2016 10:00:00 AM,48,-122,43,42,85
20411,ElliotBayTrailMyrtlePark,04/30/2016 11:00:00 AM,48,-122,61,96,157
20412,ElliotBayTrailMyrtlePark,04/30/2016 12:00:00 PM,48,-122,65,116,181
20413,ElliotBayTrailMyrtlePark,04/30/2016 01:00:00 PM,48,-122,99,123,222
20414,ElliotBayTrailMyrtlePark,04/30/2016 02:00:00 PM,48,-122,98,66,164
20415,ElliotBayTrailMyrtlePark,04/30/2016 03:00:00 PM,48,-122,140,85,225
20416,ElliotBayTrailMyrtlePark,04/30/2016 04:00:00 PM,48,-122,143,82,225
20417,ElliotBayTrailMyrtlePark,04/30/2016 05:00:00 PM,48,-122,114,97,211
20418,ElliotBayTrailMyrtlePark,04/30/2016 06:00:00 PM,48,-122,58,59,117
20419,ElliotBayTrailMyrtlePark,04/30/2016 07:00:00 PM,48,-122,37,76,113
20420,ElliotBayTrailMyrtlePark,04/30/2016 08:00:00 PM,48,-122,36,33,69
20421,ElliotBayTrailMyrtlePark,04/30/2016 09:00:00 PM,48,-122,15,12,27
20422,ElliotBayTrailMyrtlePark,04/30/2016 10:00:00 PM,48,-122,15,6,21
20423,ElliotBayTrailMyrtlePark,04/30/2016 11:00:00 PM,48,-122,10,2,12
20424,ElliotBayTrailMyrtlePark,05/01/2016 12:00:00 AM,48,-122,11,3,14
20425,ElliotBayTrailMyrtlePark,05/01/2016 01:00:00 AM,48,-122,6,0,6
20426,ElliotBayTrailMyrtlePark,05/01/2016 02:00:00 AM,48,-122,3,1,4
20427,ElliotBayTrailMyrtlePark,05/01/2016 03:00:00 AM,48,-122,7,0,7
20428,ElliotBayTrailMyrtlePark,05/01/2016 04:00:00 AM,48,-122,1,0,1
20429,ElliotBayTrailMyrtlePark,05/01/2016 05:00:00 AM,48,-122,0,4,4
20430,ElliotBayTrailMyrtlePark,05/01/2016 06:00:00 AM,48,-122,3,2,5
20431,ElliotBayTrailMyrtlePark,05/01/2016 07:00:00 AM,48,-122,4,3,7
20432,ElliotBayTrailMyrtlePark,05/01/2016 08:00:00 AM,48,-122,14,24,38
20433,ElliotBayTrailMyrtlePark,05/01/2016 09:00:00 AM,48,-122,32,41,73
20434,ElliotBayTrailMyrtlePark,05/01/2016 10:00:00 AM,48,-122,85,64,149
20435,ElliotBayTrailMyrtlePark,05/01/2016 11:00:00 AM,48,-122,76,95,171
20436,ElliotBayTrailMyrtlePark,05/01/2016 12:00:00 PM,48,-122,87,68,155
20437,ElliotBayTrailMyrtlePark,05/01/2016 01:00:00 PM,48,-122,123,111,234
20438,ElliotBayTrailMyrtlePark,05/01/2016 02:00:00 PM,48,-122,105,93,198
20439,ElliotBayTrailMyrtlePark,05/01/2016 03:00:00 PM,48,-122,104,99,203
20440,ElliotBayTrailMyrtlePark,05/01/2016 04:00:00 PM,48,-122,103,75,178
20441,ElliotBayTrailMyrtlePark,05/01/2016 05:00:00 PM,48,-122,108,78,186
20442,ElliotBayTrailMyrtlePark,05/01/2016 06:00:00 PM,48,-122,63,59,122
20443,ElliotBayTrailMyrtlePark,05/01/2016 07:00:00 PM,48,-122,38,52,90
20444,ElliotBayTrailMyrtlePark,05/01/2016 08:00:00 PM,48,-122,21,30,51
20445,ElliotBayTrailMyrtlePark,05/01/2016 09:00:00 PM,48,-122,4,9,13
20446,ElliotBayTrailMyrtlePark,05/01/2016 10:00:00 PM,48,-122,5,2,7
20447,ElliotBayTrailMyrtlePark,05/01/2016 11:00:00 PM,48,-122,3,0,3
20448,ElliotBayTrailMyrtlePark,05/02/2016 12:00:00 AM,48,-122,1,1,2
20449,ElliotBayTrailMyrtlePark,05/02/2016 01:00:00 AM,48,-122,1,0,1
20450,ElliotBayTrailMyrtlePark,05/02/2016 02:00:00 AM,48,-122,1,0,1
20451,ElliotBayTrailMyrtlePark,05/02/2016 03:00:00 AM,48,-122,3,0,3
20452,ElliotBayTrailMyrtlePark,05/02/2016 04:00:00 AM,48,-122,1,1,2
20453,ElliotBayTrailMyrtlePark,05/02/2016 05:00:00 AM,48,-122,9,3,12
20454,ElliotBayTrailMyrtlePark,05/02/2016 06:00:00 AM,48,-122,32,45,77
20455,ElliotBayTrailMyrtlePark,05/02/2016 07:00:00 AM,48,-122,74,151,225
20456,ElliotBayTrailMyrtlePark,05/02/2016 08:00:00 AM,48,-122,84,271,355
20457,ElliotBayTrailMyrtlePark,05/02/2016 09:00:00 AM,48,-122,59,166,225
20458,ElliotBayTrailMyrtlePark,05/02/2016 10:00:00 AM,48,-122,31,45,76
20459,ElliotBayTrailMyrtlePark,05/02/2016 11:00:00 AM,48,-122,34,33,67
20460,ElliotBayTrailMyrtlePark,05/02/2016 12:00:00 PM,48,-122,39,35,74
20461,ElliotBayTrailMyrtlePark,05/02/2016 01:00:00 PM,48,-122,44,51,95
20462,ElliotBayTrailMyrtlePark,05/02/2016 02:00:00 PM,48,-122,49,51,100
20463,ElliotBayTrailMyrtlePark,05/02/2016 03:00:00 PM,48,-122,66,72,138
20464,ElliotBayTrailMyrtlePark,05/02/2016 04:00:00 PM,48,-122,135,88,223
20465,ElliotBayTrailMyrtlePark,05/02/2016 05:00:00 PM,48,-122,321,110,431
20466,ElliotBayTrailMyrtlePark,05/02/2016 06:00:00 PM,48,-122,322,111,433
20467,ElliotBayTrailMyrtlePark,05/02/2016 07:00:00 PM,48,-122,142,76,218
20468,ElliotBayTrailMyrtlePark,05/02/2016 08:00:00 PM,48,-122,57,43,100
20469,ElliotBayTrailMyrtlePark,05/02/2016 09:00:00 PM,48,-122,24,26,50
20470,ElliotBayTrailMyrtlePark,05/02/2016 10:00:00 PM,48,-122,9,7,16
20471,ElliotBayTrailMyrtlePark,05/02/2016 11:00:00 PM,48,-122,5,12,17
20472,ElliotBayTrailMyrtlePark,05/03/2016 12:00:00 AM,48,-122,7,9,16
20473,ElliotBayTrailMyrtlePark,05/03/2016 01:00:00 AM,48,-122,2,5,7
20474,ElliotBayTrailMyrtlePark,05/03/2016 02:00:00 AM,48,-122,3,0,3
20475,ElliotBayTrailMyrtlePark,05/03/2016 03:00:00 AM,48,-122,1,0,1
20476,ElliotBayTrailMyrtlePark,05/03/2016 04:00:00 AM,48,-122,0,0,0
20477,ElliotBayTrailMyrtlePark,05/03/2016 05:00:00 AM,48,-122,12,3,15
20478,ElliotBayTrailMyrtlePark,05/03/2016 06:00:00 AM,48,-122,37,47,84
20479,ElliotBayTrailMyrtlePark,05/03/2016 07:00:00 AM,48,-122,70,136,206
20480,ElliotBayTrailMyrtlePark,05/03/2016 08:00:00 AM,48,-122,74,265,339
20481,ElliotBayTrailMyrtlePark,05/03/2016 09:00:00 AM,48,-122,49,147,196
20482,ElliotBayTrailMyrtlePark,05/03/2016 10:00:00 AM,48,-122,34,51,85
20483,ElliotBayTrailMyrtlePark,05/03/2016 11:00:00 AM,48,-122,25,29,54
20484,ElliotBayTrailMyrtlePark,05/03/2016 12:00:00 PM,48,-122,21,22,43
20485,ElliotBayTrailMyrtlePark,05/03/2016 01:00:00 PM,48,-122,23,20,43
20486,ElliotBayTrailMyrtlePark,05/03/2016 02:00:00 PM,48,-122,14,19,33
20487,ElliotBayTrailMyrtlePark,05/03/2016 03:00:00 PM,48,-122,53,45,98
20488,ElliotBayTrailMyrtlePark,05/03/2016 04:00:00 PM,48,-122,122,69,191
20489,ElliotBayTrailMyrtlePark,05/03/2016 05:00:00 PM,48,-122,289,113,402
20490,ElliotBayTrailMyrtlePark,05/03/2016 06:00:00 PM,48,-122,279,80,359
20491,ElliotBayTrailMyrtlePark,05/03/2016 07:00:00 PM,48,-122,102,59,161
20492,ElliotBayTrailMyrtlePark,05/03/2016 08:00:00 PM,48,-122,35,19,54
20493,ElliotBayTrailMyrtlePark,05/03/2016 09:00:00 PM,48,-122,13,8,21
20494,ElliotBayTrailMyrtlePark,05/03/2016 10:00:00 PM,48,-122,5,8,13
20495,ElliotBayTrailMyrtlePark,05/03/2016 11:00:00 PM,48,-122,7,2,9
20496,ElliotBayTrailMyrtlePark,05/04/2016 12:00:00 AM,48,-122,2,0,2
20497,ElliotBayTrailMyrtlePark,05/04/2016 01:00:00 AM,48,-122,0,0,0
20498,ElliotBayTrailMyrtlePark,05/04/2016 02:00:00 AM,48,-122,2,0,2
20499,ElliotBayTrailMyrtlePark,05/04/2016 03:00:00 AM,48,-122,3,0,3
20500,ElliotBayTrailMyrtlePark,05/04/2016 04:00:00 AM,48,-122,0,0,0
20501,ElliotBayTrailMyrtlePark,05/04/2016 05:00:00 AM,48,-122,8,7,15
20502,ElliotBayTrailMyrtlePark,05/04/2016 06:00:00 AM,48,-122,35,43,78
20503,ElliotBayTrailMyrtlePark,05/04/2016 07:00:00 AM,48,-122,71,108,179
20504,ElliotBayTrailMyrtlePark,05/04/2016 08:00:00 AM,48,-122,61,203,264
20505,ElliotBayTrailMyrtlePark,05/04/2016 09:00:00 AM,48,-122,50,137,187
20506,ElliotBayTrailMyrtlePark,05/04/2016 10:00:00 AM,48,-122,20,35,55
20507,ElliotBayTrailMyrtlePark,05/04/2016 11:00:00 AM,48,-122,24,18,42
20508,ElliotBayTrailMyrtlePark,05/04/2016 12:00:00 PM,48,-122,12,13,25
20509,ElliotBayTrailMyrtlePark,05/04/2016 01:00:00 PM,48,-122,15,19,34
20510,ElliotBayTrailMyrtlePark,05/04/2016 02:00:00 PM,48,-122,13,17,30
20511,ElliotBayTrailMyrtlePark,05/04/2016 03:00:00 PM,48,-122,33,29,62
20512,ElliotBayTrailMyrtlePark,05/04/2016 04:00:00 PM,48,-122,61,59,120
20513,ElliotBayTrailMyrtlePark,05/04/2016 05:00:00 PM,48,-122,187,91,278
20514,ElliotBayTrailMyrtlePark,05/04/2016 06:00:00 PM,48,-122,193,60,253
20515,ElliotBayTrailMyrtlePark,05/04/2016 07:00:00 PM,48,-122,97,29,126
20516,ElliotBayTrailMyrtlePark,05/04/2016 08:00:00 PM,48,-122,40,19,59
20517,ElliotBayTrailMyrtlePark,05/04/2016 09:00:00 PM,48,-122,4,4,8
20518,ElliotBayTrailMyrtlePark,05/04/2016 10:00:00 PM,48,-122,4,3,7
20519,ElliotBayTrailMyrtlePark,05/04/2016 11:00:00 PM,48,-122,4,3,7
20520,ElliotBayTrailMyrtlePark,05/05/2016 12:00:00 AM,48,-122,2,0,2
20521,ElliotBayTrailMyrtlePark,05/05/2016 01:00:00 AM,48,-122,0,1,1
20522,ElliotBayTrailMyrtlePark,05/05/2016 02:00:00 AM,48,-122,0,0,0
20523,ElliotBayTrailMyrtlePark,05/05/2016 03:00:00 AM,48,-122,0,0,0
20524,ElliotBayTrailMyrtlePark,05/05/2016 04:00:00 AM,48,-122,1,0,1
20525,ElliotBayTrailMyrtlePark,05/05/2016 05:00:00 AM,48,-122,13,2,15
20526,ElliotBayTrailMyrtlePark,05/05/2016 06:00:00 AM,48,-122,31,30,61
20527,ElliotBayTrailMyrtlePark,05/05/2016 07:00:00 AM,48,-122,61,105,166
20528,ElliotBayTrailMyrtlePark,05/05/2016 08:00:00 AM,48,-122,75,253,328
20529,ElliotBayTrailMyrtlePark,05/05/2016 09:00:00 AM,48,-122,51,143,194
20530,ElliotBayTrailMyrtlePark,05/05/2016 10:00:00 AM,48,-122,27,45,72
20531,ElliotBayTrailMyrtlePark,05/05/2016 11:00:00 AM,48,-122,17,20,37
20532,ElliotBayTrailMyrtlePark,05/05/2016 12:00:00 PM,48,-122,29,31,60
20533,ElliotBayTrailMyrtlePark,05/05/2016 01:00:00 PM,48,-122,32,25,57
20534,ElliotBayTrailMyrtlePark,05/05/2016 02:00:00 PM,48,-122,20,28,48
20535,ElliotBayTrailMyrtlePark,05/05/2016 03:00:00 PM,48,-122,35,41,76
20536,ElliotBayTrailMyrtlePark,05/05/2016 04:00:00 PM,48,-122,93,72,165
20537,ElliotBayTrailMyrtlePark,05/05/2016 05:00:00 PM,48,-122,249,86,335
20538,ElliotBayTrailMyrtlePark,05/05/2016 06:00:00 PM,48,-122,235,74,309
20539,ElliotBayTrailMyrtlePark,05/05/2016 07:00:00 PM,48,-122,120,43,163
20540,ElliotBayTrailMyrtlePark,05/05/2016 08:00:00 PM,48,-122,59,41,100
20541,ElliotBayTrailMyrtlePark,05/05/2016 09:00:00 PM,48,-122,15,9,24
20542,ElliotBayTrailMyrtlePark,05/05/2016 10:00:00 PM,48,-122,34,7,41
20543,ElliotBayTrailMyrtlePark,05/05/2016 11:00:00 PM,48,-122,9,4,13
20544,ElliotBayTrailMyrtlePark,05/06/2016 12:00:00 AM,48,-122,2,5,7
20545,ElliotBayTrailMyrtlePark,05/06/2016 01:00:00 AM,48,-122,2,4,6
20546,ElliotBayTrailMyrtlePark,05/06/2016 02:00:00 AM,48,-122,1,1,2
20547,ElliotBayTrailMyrtlePark,05/06/2016 03:00:00 AM,48,-122,2,0,2
20548,ElliotBayTrailMyrtlePark,05/06/2016 04:00:00 AM,48,-122,1,0,1
20549,ElliotBayTrailMyrtlePark,05/06/2016 05:00:00 AM,48,-122,9,5,14
20550,ElliotBayTrailMyrtlePark,05/06/2016 06:00:00 AM,48,-122,26,29,55
20551,ElliotBayTrailMyrtlePark,05/06/2016 07:00:00 AM,48,-122,51,103,154
20552,ElliotBayTrailMyrtlePark,05/06/2016 08:00:00 AM,48,-122,65,212,277
20553,ElliotBayTrailMyrtlePark,05/06/2016 09:00:00 AM,48,-122,63,143,206
20554,ElliotBayTrailMyrtlePark,05/06/2016 10:00:00 AM,48,-122,28,42,70
20555,ElliotBayTrailMyrtlePark,05/06/2016 11:00:00 AM,48,-122,26,32,58
20556,ElliotBayTrailMyrtlePark,05/06/2016 12:00:00 PM,48,-122,33,36,69
20557,ElliotBayTrailMyrtlePark,05/06/2016 01:00:00 PM,48,-122,36,28,64
20558,ElliotBayTrailMyrtlePark,05/06/2016 02:00:00 PM,48,-122,35,40,75
20559,ElliotBayTrailMyrtlePark,05/06/2016 03:00:00 PM,48,-122,68,67,135
20560,ElliotBayTrailMyrtlePark,05/06/2016 04:00:00 PM,48,-122,130,85,215
20561,ElliotBayTrailMyrtlePark,05/06/2016 05:00:00 PM,48,-122,237,103,340
20562,ElliotBayTrailMyrtlePark,05/06/2016 06:00:00 PM,48,-122,197,77,274
20563,ElliotBayTrailMyrtlePark,05/06/2016 07:00:00 PM,48,-122,88,39,127
20564,ElliotBayTrailMyrtlePark,05/06/2016 08:00:00 PM,48,-122,50,35,85
20565,ElliotBayTrailMyrtlePark,05/06/2016 09:00:00 PM,48,-122,54,14,68
20566,ElliotBayTrailMyrtlePark,05/06/2016 10:00:00 PM,48,-122,12,21,33
20567,ElliotBayTrailMyrtlePark,05/06/2016 11:00:00 PM,48,-122,5,16,21
20568,ElliotBayTrailMyrtlePark,05/07/2016 12:00:00 AM,48,-122,4,3,7
20569,ElliotBayTrailMyrtlePark,05/07/2016 01:00:00 AM,48,-122,6,1,7
20570,ElliotBayTrailMyrtlePark,05/07/2016 02:00:00 AM,48,-122,0,1,1
20571,ElliotBayTrailMyrtlePark,05/07/2016 03:00:00 AM,48,-122,3,2,5
20572,ElliotBayTrailMyrtlePark,05/07/2016 04:00:00 AM,48,-122,0,2,2
20573,ElliotBayTrailMyrtlePark,05/07/2016 05:00:00 AM,48,-122,2,2,4
20574,ElliotBayTrailMyrtlePark,05/07/2016 06:00:00 AM,48,-122,6,7,13
20575,ElliotBayTrailMyrtlePark,05/07/2016 07:00:00 AM,48,-122,10,20,30
20576,ElliotBayTrailMyrtlePark,05/07/2016 08:00:00 AM,48,-122,28,27,55
20577,ElliotBayTrailMyrtlePark,05/07/2016 09:00:00 AM,48,-122,52,48,100
20578,ElliotBayTrailMyrtlePark,05/07/2016 10:00:00 AM,48,-122,60,54,114
20579,ElliotBayTrailMyrtlePark,05/07/2016 11:00:00 AM,48,-122,71,76,147
20580,ElliotBayTrailMyrtlePark,05/07/2016 12:00:00 PM,48,-122,110,84,194
20581,ElliotBayTrailMyrtlePark,05/07/2016 01:00:00 PM,48,-122,78,98,176
20582,ElliotBayTrailMyrtlePark,05/07/2016 02:00:00 PM,48,-122,83,101,184
20583,ElliotBayTrailMyrtlePark,05/07/2016 03:00:00 PM,48,-122,105,96,201
20584,ElliotBayTrailMyrtlePark,05/07/2016 04:00:00 PM,48,-122,115,95,210
20585,ElliotBayTrailMyrtlePark,05/07/2016 05:00:00 PM,48,-122,79,86,165
20586,ElliotBayTrailMyrtlePark,05/07/2016 06:00:00 PM,48,-122,73,77,150
20587,ElliotBayTrailMyrtlePark,05/07/2016 07:00:00 PM,48,-122,62,59,121
20588,ElliotBayTrailMyrtlePark,05/07/2016 08:00:00 PM,48,-122,30,36,66
20589,ElliotBayTrailMyrtlePark,05/07/2016 09:00:00 PM,48,-122,56,15,71
20590,ElliotBayTrailMyrtlePark,05/07/2016 10:00:00 PM,48,-122,21,6,27
20591,ElliotBayTrailMyrtlePark,05/07/2016 11:00:00 PM,48,-122,9,2,11
20592,ElliotBayTrailMyrtlePark,05/08/2016 12:00:00 AM,48,-122,2,3,5
20593,ElliotBayTrailMyrtlePark,05/08/2016 01:00:00 AM,48,-122,2,1,3
20594,ElliotBayTrailMyrtlePark,05/08/2016 02:00:00 AM,48,-122,0,0,0
20595,ElliotBayTrailMyrtlePark,05/08/2016 03:00:00 AM,48,-122,2,0,2
20596,ElliotBayTrailMyrtlePark,05/08/2016 04:00:00 AM,48,-122,0,0,0
20597,ElliotBayTrailMyrtlePark,05/08/2016 05:00:00 AM,48,-122,1,3,4
20598,ElliotBayTrailMyrtlePark,05/08/2016 06:00:00 AM,48,-122,1,5,6
20599,ElliotBayTrailMyrtlePark,05/08/2016 07:00:00 AM,48,-122,1,5,6
20600,ElliotBayTrailMyrtlePark,05/08/2016 08:00:00 AM,48,-122,6,2,8
20601,ElliotBayTrailMyrtlePark,05/08/2016 09:00:00 AM,48,-122,10,15,25
20602,ElliotBayTrailMyrtlePark,05/08/2016 10:00:00 AM,48,-122,13,8,21
20603,ElliotBayTrailMyrtlePark,05/08/2016 11:00:00 AM,48,-122,13,31,44
20604,ElliotBayTrailMyrtlePark,05/08/2016 12:00:00 PM,48,-122,21,26,47
20605,ElliotBayTrailMyrtlePark,05/08/2016 01:00:00 PM,48,-122,28,30,58
20606,ElliotBayTrailMyrtlePark,05/08/2016 02:00:00 PM,48,-122,67,45,112
20607,ElliotBayTrailMyrtlePark,05/08/2016 03:00:00 PM,48,-122,30,30,60
20608,ElliotBayTrailMyrtlePark,05/08/2016 04:00:00 PM,48,-122,47,30,77
20609,ElliotBayTrailMyrtlePark,05/08/2016 05:00:00 PM,48,-122,52,33,85
20610,ElliotBayTrailMyrtlePark,05/08/2016 06:00:00 PM,48,-122,22,14,36
20611,ElliotBayTrailMyrtlePark,05/08/2016 07:00:00 PM,48,-122,18,18,36
20612,ElliotBayTrailMyrtlePark,05/08/2016 08:00:00 PM,48,-122,4,7,11
20613,ElliotBayTrailMyrtlePark,05/08/2016 09:00:00 PM,48,-122,5,4,9
20614,ElliotBayTrailMyrtlePark,05/08/2016 10:00:00 PM,48,-122,4,2,6
20615,ElliotBayTrailMyrtlePark,05/08/2016 11:00:00 PM,48,-122,0,0,0
20616,ElliotBayTrailMyrtlePark,05/09/2016 12:00:00 AM,48,-122,0,0,0
20617,ElliotBayTrailMyrtlePark,05/09/2016 01:00:00 AM,48,-122,1,0,1
20618,ElliotBayTrailMyrtlePark,05/09/2016 02:00:00 AM,48,-122,0,0,0
20619,ElliotBayTrailMyrtlePark,05/09/2016 03:00:00 AM,48,-122,1,0,1
20620,ElliotBayTrailMyrtlePark,05/09/2016 04:00:00 AM,48,-122,1,1,2
20621,ElliotBayTrailMyrtlePark,05/09/2016 05:00:00 AM,48,-122,8,6,14
20622,ElliotBayTrailMyrtlePark,05/09/2016 06:00:00 AM,48,-122,23,34,57
20623,ElliotBayTrailMyrtlePark,05/09/2016 07:00:00 AM,48,-122,48,95,143
20624,ElliotBayTrailMyrtlePark,05/09/2016 08:00:00 AM,48,-122,51,187,238
20625,ElliotBayTrailMyrtlePark,05/09/2016 09:00:00 AM,48,-122,54,137,191
20626,ElliotBayTrailMyrtlePark,05/09/2016 10:00:00 AM,48,-122,23,45,68
20627,ElliotBayTrailMyrtlePark,05/09/2016 11:00:00 AM,48,-122,26,22,48
20628,ElliotBayTrailMyrtlePark,05/09/2016 12:00:00 PM,48,-122,26,24,50
20629,ElliotBayTrailMyrtlePark,05/09/2016 01:00:00 PM,48,-122,20,21,41
20630,ElliotBayTrailMyrtlePark,05/09/2016 02:00:00 PM,48,-122,31,23,54
20631,ElliotBayTrailMyrtlePark,05/09/2016 03:00:00 PM,48,-122,42,42,84
20632,ElliotBayTrailMyrtlePark,05/09/2016 04:00:00 PM,48,-122,86,49,135
20633,ElliotBayTrailMyrtlePark,05/09/2016 05:00:00 PM,48,-122,230,83,313
20634,ElliotBayTrailMyrtlePark,05/09/2016 06:00:00 PM,48,-122,239,87,326
20635,ElliotBayTrailMyrtlePark,05/09/2016 07:00:00 PM,48,-122,92,42,134
20636,ElliotBayTrailMyrtlePark,05/09/2016 08:00:00 PM,48,-122,48,37,85
20637,ElliotBayTrailMyrtlePark,05/09/2016 09:00:00 PM,48,-122,14,4,18
20638,ElliotBayTrailMyrtlePark,05/09/2016 10:00:00 PM,48,-122,13,3,16
20639,ElliotBayTrailMyrtlePark,05/09/2016 11:00:00 PM,48,-122,13,2,15
20640,ElliotBayTrailMyrtlePark,05/10/2016 12:00:00 AM,48,-122,0,1,1
20641,ElliotBayTrailMyrtlePark,05/10/2016 01:00:00 AM,48,-122,0,0,0
20642,ElliotBayTrailMyrtlePark,05/10/2016 02:00:00 AM,48,-122,0,0,0
20643,ElliotBayTrailMyrtlePark,05/10/2016 03:00:00 AM,48,-122,2,0,2
20644,ElliotBayTrailMyrtlePark,05/10/2016 04:00:00 AM,48,-122,0,0,0
20645,ElliotBayTrailMyrtlePark,05/10/2016 05:00:00 AM,48,-122,10,4,14
20646,ElliotBayTrailMyrtlePark,05/10/2016 06:00:00 AM,48,-122,22,42,64
20647,ElliotBayTrailMyrtlePark,05/10/2016 07:00:00 AM,48,-122,52,123,175
20648,ElliotBayTrailMyrtlePark,05/10/2016 08:00:00 AM,48,-122,67,265,332
20649,ElliotBayTrailMyrtlePark,05/10/2016 09:00:00 AM,48,-122,52,153,205
20650,ElliotBayTrailMyrtlePark,05/10/2016 10:00:00 AM,48,-122,30,44,74
20651,ElliotBayTrailMyrtlePark,05/10/2016 11:00:00 AM,48,-122,25,34,59
20652,ElliotBayTrailMyrtlePark,05/10/2016 12:00:00 PM,48,-122,17,25,42
20653,ElliotBayTrailMyrtlePark,05/10/2016 01:00:00 PM,48,-122,30,32,62
20654,ElliotBayTrailMyrtlePark,05/10/2016 02:00:00 PM,48,-122,23,29,52
20655,ElliotBayTrailMyrtlePark,05/10/2016 03:00:00 PM,48,-122,35,37,72
20656,ElliotBayTrailMyrtlePark,05/10/2016 04:00:00 PM,48,-122,112,71,183
20657,ElliotBayTrailMyrtlePark,05/10/2016 05:00:00 PM,48,-122,298,110,408
20658,ElliotBayTrailMyrtlePark,05/10/2016 06:00:00 PM,48,-122,273,100,373
20659,ElliotBayTrailMyrtlePark,05/10/2016 07:00:00 PM,48,-122,109,67,176
20660,ElliotBayTrailMyrtlePark,05/10/2016 08:00:00 PM,48,-122,66,31,97
20661,ElliotBayTrailMyrtlePark,05/10/2016 09:00:00 PM,48,-122,16,9,25
20662,ElliotBayTrailMyrtlePark,05/10/2016 10:00:00 PM,48,-122,13,6,19
20663,ElliotBayTrailMyrtlePark,05/10/2016 11:00:00 PM,48,-122,11,1,12
20664,ElliotBayTrailMyrtlePark,05/11/2016 12:00:00 AM,48,-122,0,0,0
20665,ElliotBayTrailMyrtlePark,05/11/2016 01:00:00 AM,48,-122,0,0,0
20666,ElliotBayTrailMyrtlePark,05/11/2016 02:00:00 AM,48,-122,0,0,0
20667,ElliotBayTrailMyrtlePark,05/11/2016 03:00:00 AM,48,-122,1,0,1
20668,ElliotBayTrailMyrtlePark,05/11/2016 04:00:00 AM,48,-122,1,0,1
20669,ElliotBayTrailMyrtlePark,05/11/2016 05:00:00 AM,48,-122,9,5,14
20670,ElliotBayTrailMyrtlePark,05/11/2016 06:00:00 AM,48,-122,26,42,68
20671,ElliotBayTrailMyrtlePark,05/11/2016 07:00:00 AM,48,-122,47,113,160
20672,ElliotBayTrailMyrtlePark,05/11/2016 08:00:00 AM,48,-122,64,259,323
20673,ElliotBayTrailMyrtlePark,05/11/2016 09:00:00 AM,48,-122,50,147,197
20674,ElliotBayTrailMyrtlePark,05/11/2016 10:00:00 AM,48,-122,27,56,83
20675,ElliotBayTrailMyrtlePark,05/11/2016 11:00:00 AM,48,-122,27,29,56
20676,ElliotBayTrailMyrtlePark,05/11/2016 12:00:00 PM,48,-122,48,49,97
20677,ElliotBayTrailMyrtlePark,05/11/2016 01:00:00 PM,48,-122,26,28,54
20678,ElliotBayTrailMyrtlePark,05/11/2016 02:00:00 PM,48,-122,32,35,67
20679,ElliotBayTrailMyrtlePark,05/11/2016 03:00:00 PM,48,-122,39,30,69
20680,ElliotBayTrailMyrtlePark,05/11/2016 04:00:00 PM,48,-122,102,43,145
20681,ElliotBayTrailMyrtlePark,05/11/2016 05:00:00 PM,48,-122,276,78,354
20682,ElliotBayTrailMyrtlePark,05/11/2016 06:00:00 PM,48,-122,282,83,365
20683,ElliotBayTrailMyrtlePark,05/11/2016 07:00:00 PM,48,-122,116,47,163
20684,ElliotBayTrailMyrtlePark,05/11/2016 08:00:00 PM,48,-122,55,42,97
20685,ElliotBayTrailMyrtlePark,05/11/2016 09:00:00 PM,48,-122,9,17,26
20686,ElliotBayTrailMyrtlePark,05/11/2016 10:00:00 PM,48,-122,7,3,10
20687,ElliotBayTrailMyrtlePark,05/11/2016 11:00:00 PM,48,-122,8,5,13
20688,ElliotBayTrailMyrtlePark,05/12/2016 12:00:00 AM,48,-122,3,2,5
20689,ElliotBayTrailMyrtlePark,05/12/2016 01:00:00 AM,48,-122,1,0,1
20690,ElliotBayTrailMyrtlePark,05/12/2016 02:00:00 AM,48,-122,0,0,0
20691,ElliotBayTrailMyrtlePark,05/12/2016 03:00:00 AM,48,-122,1,0,1
20692,ElliotBayTrailMyrtlePark,05/12/2016 04:00:00 AM,48,-122,2,0,2
20693,ElliotBayTrailMyrtlePark,05/12/2016 05:00:00 AM,48,-122,8,2,10
20694,ElliotBayTrailMyrtlePark,05/12/2016 06:00:00 AM,48,-122,23,34,57
20695,ElliotBayTrailMyrtlePark,05/12/2016 07:00:00 AM,48,-122,46,102,148
20696,ElliotBayTrailMyrtlePark,05/12/2016 08:00:00 AM,48,-122,66,220,286
20697,ElliotBayTrailMyrtlePark,05/12/2016 09:00:00 AM,48,-122,50,137,187
20698,ElliotBayTrailMyrtlePark,05/12/2016 10:00:00 AM,48,-122,32,50,82
20699,ElliotBayTrailMyrtlePark,05/12/2016 11:00:00 AM,48,-122,25,27,52
20700,ElliotBayTrailMyrtlePark,05/12/2016 12:00:00 PM,48,-122,27,42,69
20701,ElliotBayTrailMyrtlePark,05/12/2016 01:00:00 PM,48,-122,20,33,53
20702,ElliotBayTrailMyrtlePark,05/12/2016 02:00:00 PM,48,-122,44,31,75
20703,ElliotBayTrailMyrtlePark,05/12/2016 03:00:00 PM,48,-122,50,36,86
20704,ElliotBayTrailMyrtlePark,05/12/2016 04:00:00 PM,48,-122,84,72,156
20705,ElliotBayTrailMyrtlePark,05/12/2016 05:00:00 PM,48,-122,232,89,321
20706,ElliotBayTrailMyrtlePark,05/12/2016 06:00:00 PM,48,-122,241,93,334
20707,ElliotBayTrailMyrtlePark,05/12/2016 07:00:00 PM,48,-122,102,62,164
20708,ElliotBayTrailMyrtlePark,05/12/2016 08:00:00 PM,48,-122,32,45,77
20709,ElliotBayTrailMyrtlePark,05/12/2016 09:00:00 PM,48,-122,15,10,25
20710,ElliotBayTrailMyrtlePark,05/12/2016 10:00:00 PM,48,-122,17,2,19
20711,ElliotBayTrailMyrtlePark,05/12/2016 11:00:00 PM,48,-122,3,6,9
20712,ElliotBayTrailMyrtlePark,05/13/2016 12:00:00 AM,48,-122,3,0,3
20713,ElliotBayTrailMyrtlePark,05/13/2016 01:00:00 AM,48,-122,1,0,1
20714,ElliotBayTrailMyrtlePark,05/13/2016 02:00:00 AM,48,-122,1,0,1
20715,ElliotBayTrailMyrtlePark,05/13/2016 03:00:00 AM,48,-122,1,0,1
20716,ElliotBayTrailMyrtlePark,05/13/2016 04:00:00 AM,48,-122,1,0,1
20717,ElliotBayTrailMyrtlePark,05/13/2016 05:00:00 AM,48,-122,4,6,10
20718,ElliotBayTrailMyrtlePark,05/13/2016 06:00:00 AM,48,-122,19,24,43
20719,ElliotBayTrailMyrtlePark,05/13/2016 07:00:00 AM,48,-122,45,100,145
20720,ElliotBayTrailMyrtlePark,05/13/2016 08:00:00 AM,48,-122,52,190,242
20721,ElliotBayTrailMyrtlePark,05/13/2016 09:00:00 AM,48,-122,49,136,185
20722,ElliotBayTrailMyrtlePark,05/13/2016 10:00:00 AM,48,-122,26,61,87
20723,ElliotBayTrailMyrtlePark,05/13/2016 11:00:00 AM,48,-122,33,41,74
20724,ElliotBayTrailMyrtlePark,05/13/2016 12:00:00 PM,48,-122,37,36,73
20725,ElliotBayTrailMyrtlePark,05/13/2016 01:00:00 PM,48,-122,42,37,79
20726,ElliotBayTrailMyrtlePark,05/13/2016 02:00:00 PM,48,-122,45,36,81
20727,ElliotBayTrailMyrtlePark,05/13/2016 03:00:00 PM,48,-122,64,39,103
20728,ElliotBayTrailMyrtlePark,05/13/2016 04:00:00 PM,48,-122,119,66,185
20729,ElliotBayTrailMyrtlePark,05/13/2016 05:00:00 PM,48,-122,240,81,321
20730,ElliotBayTrailMyrtlePark,05/13/2016 06:00:00 PM,48,-122,195,73,268
20731,ElliotBayTrailMyrtlePark,05/13/2016 07:00:00 PM,48,-122,77,38,115
20732,ElliotBayTrailMyrtlePark,05/13/2016 08:00:00 PM,48,-122,50,29,79
20733,ElliotBayTrailMyrtlePark,05/13/2016 09:00:00 PM,48,-122,13,15,28
20734,ElliotBayTrailMyrtlePark,05/13/2016 10:00:00 PM,48,-122,16,7,23
20735,ElliotBayTrailMyrtlePark,05/13/2016 11:00:00 PM,48,-122,10,2,12
20736,ElliotBayTrailMyrtlePark,05/14/2016 12:00:00 AM,48,-122,6,1,7
20737,ElliotBayTrailMyrtlePark,05/14/2016 01:00:00 AM,48,-122,2,3,5
20738,ElliotBayTrailMyrtlePark,05/14/2016 02:00:00 AM,48,-122,1,0,1
20739,ElliotBayTrailMyrtlePark,05/14/2016 03:00:00 AM,48,-122,1,0,1
20740,ElliotBayTrailMyrtlePark,05/14/2016 04:00:00 AM,48,-122,1,0,1
20741,ElliotBayTrailMyrtlePark,05/14/2016 05:00:00 AM,48,-122,0,2,2
20742,ElliotBayTrailMyrtlePark,05/14/2016 06:00:00 AM,48,-122,3,7,10
20743,ElliotBayTrailMyrtlePark,05/14/2016 07:00:00 AM,48,-122,7,14,21
20744,ElliotBayTrailMyrtlePark,05/14/2016 08:00:00 AM,48,-122,23,26,49
20745,ElliotBayTrailMyrtlePark,05/14/2016 09:00:00 AM,48,-122,23,27,50
20746,ElliotBayTrailMyrtlePark,05/14/2016 10:00:00 AM,48,-122,37,47,84
20747,ElliotBayTrailMyrtlePark,05/14/2016 11:00:00 AM,48,-122,31,56,87
20748,ElliotBayTrailMyrtlePark,05/14/2016 12:00:00 PM,48,-122,99,45,144
20749,ElliotBayTrailMyrtlePark,05/14/2016 01:00:00 PM,48,-122,124,24,148
20750,ElliotBayTrailMyrtlePark,05/14/2016 02:00:00 PM,48,-122,39,16,55
20751,ElliotBayTrailMyrtlePark,05/14/2016 03:00:00 PM,48,-122,25,13,38
20752,ElliotBayTrailMyrtlePark,05/14/2016 04:00:00 PM,48,-122,24,31,55
20753,ElliotBayTrailMyrtlePark,05/14/2016 05:00:00 PM,48,-122,23,21,44
20754,ElliotBayTrailMyrtlePark,05/14/2016 06:00:00 PM,48,-122,19,18,37
20755,ElliotBayTrailMyrtlePark,05/14/2016 07:00:00 PM,48,-122,15,21,36
20756,ElliotBayTrailMyrtlePark,05/14/2016 08:00:00 PM,48,-122,16,11,27
20757,ElliotBayTrailMyrtlePark,05/14/2016 09:00:00 PM,48,-122,5,5,10
20758,ElliotBayTrailMyrtlePark,05/14/2016 10:00:00 PM,48,-122,7,1,8
20759,ElliotBayTrailMyrtlePark,05/14/2016 11:00:00 PM,48,-122,2,1,3
20760,ElliotBayTrailMyrtlePark,05/15/2016 12:00:00 AM,48,-122,12,2,14
20761,ElliotBayTrailMyrtlePark,05/15/2016 01:00:00 AM,48,-122,4,2,6
20762,ElliotBayTrailMyrtlePark,05/15/2016 02:00:00 AM,48,-122,0,0,0
20763,ElliotBayTrailMyrtlePark,05/15/2016 03:00:00 AM,48,-122,1,0,1
20764,ElliotBayTrailMyrtlePark,05/15/2016 04:00:00 AM,48,-122,0,0,0
20765,ElliotBayTrailMyrtlePark,05/15/2016 05:00:00 AM,48,-122,0,0,0
20766,ElliotBayTrailMyrtlePark,05/15/2016 06:00:00 AM,48,-122,2,5,7
20767,ElliotBayTrailMyrtlePark,05/15/2016 07:00:00 AM,48,-122,4,4,8
20768,ElliotBayTrailMyrtlePark,05/15/2016 08:00:00 AM,48,-122,13,10,23
20769,ElliotBayTrailMyrtlePark,05/15/2016 09:00:00 AM,48,-122,21,21,42
20770,ElliotBayTrailMyrtlePark,05/15/2016 10:00:00 AM,48,-122,17,28,45
20771,ElliotBayTrailMyrtlePark,05/15/2016 11:00:00 AM,48,-122,25,31,56
20772,ElliotBayTrailMyrtlePark,05/15/2016 12:00:00 PM,48,-122,30,23,53
20773,ElliotBayTrailMyrtlePark,05/15/2016 01:00:00 PM,48,-122,24,45,69
20774,ElliotBayTrailMyrtlePark,05/15/2016 02:00:00 PM,48,-122,28,29,57
20775,ElliotBayTrailMyrtlePark,05/15/2016 03:00:00 PM,48,-122,42,17,59
20776,ElliotBayTrailMyrtlePark,05/15/2016 04:00:00 PM,48,-122,29,20,49
20777,ElliotBayTrailMyrtlePark,05/15/2016 05:00:00 PM,48,-122,31,19,50
20778,ElliotBayTrailMyrtlePark,05/15/2016 06:00:00 PM,48,-122,15,16,31
20779,ElliotBayTrailMyrtlePark,05/15/2016 07:00:00 PM,48,-122,9,5,14
20780,ElliotBayTrailMyrtlePark,05/15/2016 08:00:00 PM,48,-122,3,3,6
20781,ElliotBayTrailMyrtlePark,05/15/2016 09:00:00 PM,48,-122,0,3,3
20782,ElliotBayTrailMyrtlePark,05/15/2016 10:00:00 PM,48,-122,2,1,3
20783,ElliotBayTrailMyrtlePark,05/15/2016 11:00:00 PM,48,-122,0,0,0
20784,ElliotBayTrailMyrtlePark,05/16/2016 12:00:00 AM,48,-122,0,0,0
20785,ElliotBayTrailMyrtlePark,05/16/2016 01:00:00 AM,48,-122,1,0,1
20786,ElliotBayTrailMyrtlePark,05/16/2016 02:00:00 AM,48,-122,0,0,0
20787,ElliotBayTrailMyrtlePark,05/16/2016 03:00:00 AM,48,-122,1,0,1
20788,ElliotBayTrailMyrtlePark,05/16/2016 04:00:00 AM,48,-122,0,0,0
20789,ElliotBayTrailMyrtlePark,05/16/2016 05:00:00 AM,48,-122,4,4,8
20790,ElliotBayTrailMyrtlePark,05/16/2016 06:00:00 AM,48,-122,12,23,35
20791,ElliotBayTrailMyrtlePark,05/16/2016 07:00:00 AM,48,-122,44,69,113
20792,ElliotBayTrailMyrtlePark,05/16/2016 08:00:00 AM,48,-122,37,175,212
20793,ElliotBayTrailMyrtlePark,05/16/2016 09:00:00 AM,48,-122,27,115,142
20794,ElliotBayTrailMyrtlePark,05/16/2016 10:00:00 AM,48,-122,18,35,53
20795,ElliotBayTrailMyrtlePark,05/16/2016 11:00:00 AM,48,-122,13,18,31
20796,ElliotBayTrailMyrtlePark,05/16/2016 12:00:00 PM,48,-122,12,15,27
20797,ElliotBayTrailMyrtlePark,05/16/2016 01:00:00 PM,48,-122,21,25,46
20798,ElliotBayTrailMyrtlePark,05/16/2016 02:00:00 PM,48,-122,10,15,25
20799,ElliotBayTrailMyrtlePark,05/16/2016 03:00:00 PM,48,-122,24,18,42
20800,ElliotBayTrailMyrtlePark,05/16/2016 04:00:00 PM,48,-122,56,45,101
20801,ElliotBayTrailMyrtlePark,05/16/2016 05:00:00 PM,48,-122,146,64,210
20802,ElliotBayTrailMyrtlePark,05/16/2016 06:00:00 PM,48,-122,187,46,233
20803,ElliotBayTrailMyrtlePark,05/16/2016 07:00:00 PM,48,-122,66,26,92
20804,ElliotBayTrailMyrtlePark,05/16/2016 08:00:00 PM,48,-122,24,20,44
20805,ElliotBayTrailMyrtlePark,05/16/2016 09:00:00 PM,48,-122,13,11,24
20806,ElliotBayTrailMyrtlePark,05/16/2016 10:00:00 PM,48,-122,3,5,8
20807,ElliotBayTrailMyrtlePark,05/16/2016 11:00:00 PM,48,-122,1,1,2
20808,ElliotBayTrailMyrtlePark,05/17/2016 12:00:00 AM,48,-122,3,0,3
20809,ElliotBayTrailMyrtlePark,05/17/2016 01:00:00 AM,48,-122,0,0,0
20810,ElliotBayTrailMyrtlePark,05/17/2016 02:00:00 AM,48,-122,0,0,0
20811,ElliotBayTrailMyrtlePark,05/17/2016 03:00:00 AM,48,-122,2,0,2
20812,ElliotBayTrailMyrtlePark,05/17/2016 04:00:00 AM,48,-122,1,0,1
20813,ElliotBayTrailMyrtlePark,05/17/2016 05:00:00 AM,48,-122,6,5,11
20814,ElliotBayTrailMyrtlePark,05/17/2016 06:00:00 AM,48,-122,26,42,68
20815,ElliotBayTrailMyrtlePark,05/17/2016 07:00:00 AM,48,-122,46,104,150
20816,ElliotBayTrailMyrtlePark,05/17/2016 08:00:00 AM,48,-122,54,249,303
20817,ElliotBayTrailMyrtlePark,05/17/2016 09:00:00 AM,48,-122,58,148,206
20818,ElliotBayTrailMyrtlePark,05/17/2016 10:00:00 AM,48,-122,35,40,75
20819,ElliotBayTrailMyrtlePark,05/17/2016 11:00:00 AM,48,-122,26,30,56
20820,ElliotBayTrailMyrtlePark,05/17/2016 12:00:00 PM,48,-122,26,28,54
20821,ElliotBayTrailMyrtlePark,05/17/2016 01:00:00 PM,48,-122,21,35,56
20822,ElliotBayTrailMyrtlePark,05/17/2016 02:00:00 PM,48,-122,34,28,62
20823,ElliotBayTrailMyrtlePark,05/17/2016 03:00:00 PM,48,-122,38,28,66
20824,ElliotBayTrailMyrtlePark,05/17/2016 04:00:00 PM,48,-122,91,56,147
20825,ElliotBayTrailMyrtlePark,05/17/2016 05:00:00 PM,48,-122,243,93,336
20826,ElliotBayTrailMyrtlePark,05/17/2016 06:00:00 PM,48,-122,239,65,304
20827,ElliotBayTrailMyrtlePark,05/17/2016 07:00:00 PM,48,-122,109,34,143
20828,ElliotBayTrailMyrtlePark,05/17/2016 08:00:00 PM,48,-122,37,52,89
20829,ElliotBayTrailMyrtlePark,05/17/2016 09:00:00 PM,48,-122,18,16,34
20830,ElliotBayTrailMyrtlePark,05/17/2016 10:00:00 PM,48,-122,12,9,21
20831,ElliotBayTrailMyrtlePark,05/17/2016 11:00:00 PM,48,-122,2,2,4
20832,ElliotBayTrailMyrtlePark,05/18/2016 12:00:00 AM,48,-122,2,1,3
20833,ElliotBayTrailMyrtlePark,05/18/2016 01:00:00 AM,48,-122,2,0,2
20834,ElliotBayTrailMyrtlePark,05/18/2016 02:00:00 AM,48,-122,0,0,0
20835,ElliotBayTrailMyrtlePark,05/18/2016 03:00:00 AM,48,-122,1,0,1
20836,ElliotBayTrailMyrtlePark,05/18/2016 04:00:00 AM,48,-122,2,1,3
20837,ElliotBayTrailMyrtlePark,05/18/2016 05:00:00 AM,48,-122,5,6,11
20838,ElliotBayTrailMyrtlePark,05/18/2016 06:00:00 AM,48,-122,21,34,55
20839,ElliotBayTrailMyrtlePark,05/18/2016 07:00:00 AM,48,-122,48,103,151
20840,ElliotBayTrailMyrtlePark,05/18/2016 08:00:00 AM,48,-122,47,213,260
20841,ElliotBayTrailMyrtlePark,05/18/2016 09:00:00 AM,48,-122,51,119,170
20842,ElliotBayTrailMyrtlePark,05/18/2016 10:00:00 AM,48,-122,24,46,70
20843,ElliotBayTrailMyrtlePark,05/18/2016 11:00:00 AM,48,-122,20,34,54
20844,ElliotBayTrailMyrtlePark,05/18/2016 12:00:00 PM,48,-122,21,19,40
20845,ElliotBayTrailMyrtlePark,05/18/2016 01:00:00 PM,48,-122,26,28,54
20846,ElliotBayTrailMyrtlePark,05/18/2016 02:00:00 PM,48,-122,27,21,48
20847,ElliotBayTrailMyrtlePark,05/18/2016 03:00:00 PM,48,-122,35,25,60
20848,ElliotBayTrailMyrtlePark,05/18/2016 04:00:00 PM,48,-122,74,53,127
20849,ElliotBayTrailMyrtlePark,05/18/2016 05:00:00 PM,48,-122,204,65,269
20850,ElliotBayTrailMyrtlePark,05/18/2016 06:00:00 PM,48,-122,166,56,222
20851,ElliotBayTrailMyrtlePark,05/18/2016 07:00:00 PM,48,-122,78,30,108
20852,ElliotBayTrailMyrtlePark,05/18/2016 08:00:00 PM,48,-122,35,15,50
20853,ElliotBayTrailMyrtlePark,05/18/2016 09:00:00 PM,48,-122,9,4,13
20854,ElliotBayTrailMyrtlePark,05/18/2016 10:00:00 PM,48,-122,4,2,6
20855,ElliotBayTrailMyrtlePark,05/18/2016 11:00:00 PM,48,-122,3,2,5
20856,ElliotBayTrailMyrtlePark,05/19/2016 12:00:00 AM,48,-122,7,2,9
20857,ElliotBayTrailMyrtlePark,05/19/2016 01:00:00 AM,48,-122,1,0,1
20858,ElliotBayTrailMyrtlePark,05/19/2016 02:00:00 AM,48,-122,0,0,0
20859,ElliotBayTrailMyrtlePark,05/19/2016 03:00:00 AM,48,-122,1,0,1
20860,ElliotBayTrailMyrtlePark,05/19/2016 04:00:00 AM,48,-122,1,0,1
20861,ElliotBayTrailMyrtlePark,05/19/2016 05:00:00 AM,48,-122,4,1,5
20862,ElliotBayTrailMyrtlePark,05/19/2016 06:00:00 AM,48,-122,13,18,31
20863,ElliotBayTrailMyrtlePark,05/19/2016 07:00:00 AM,48,-122,27,45,72
20864,ElliotBayTrailMyrtlePark,05/19/2016 08:00:00 AM,48,-122,47,153,200
20865,ElliotBayTrailMyrtlePark,05/19/2016 09:00:00 AM,48,-122,31,76,107
20866,ElliotBayTrailMyrtlePark,05/19/2016 10:00:00 AM,48,-122,16,26,42
20867,ElliotBayTrailMyrtlePark,05/19/2016 11:00:00 AM,48,-122,8,13,21
20868,ElliotBayTrailMyrtlePark,05/19/2016 12:00:00 PM,48,-122,15,21,36
20869,ElliotBayTrailMyrtlePark,05/19/2016 01:00:00 PM,48,-122,9,8,17
20870,ElliotBayTrailMyrtlePark,05/19/2016 02:00:00 PM,48,-122,13,15,28
20871,ElliotBayTrailMyrtlePark,05/19/2016 03:00:00 PM,48,-122,21,22,43
20872,ElliotBayTrailMyrtlePark,05/19/2016 04:00:00 PM,48,-122,54,37,91
20873,ElliotBayTrailMyrtlePark,05/19/2016 05:00:00 PM,48,-122,128,49,177
20874,ElliotBayTrailMyrtlePark,05/19/2016 06:00:00 PM,48,-122,143,52,195
20875,ElliotBayTrailMyrtlePark,05/19/2016 07:00:00 PM,48,-122,51,14,65
20876,ElliotBayTrailMyrtlePark,05/19/2016 08:00:00 PM,48,-122,11,10,21
20877,ElliotBayTrailMyrtlePark,05/19/2016 09:00:00 PM,48,-122,4,4,8
20878,ElliotBayTrailMyrtlePark,05/19/2016 10:00:00 PM,48,-122,7,2,9
20879,ElliotBayTrailMyrtlePark,05/19/2016 11:00:00 PM,48,-122,3,2,5
20880,ElliotBayTrailMyrtlePark,05/20/2016 12:00:00 AM,48,-122,0,0,0
20881,ElliotBayTrailMyrtlePark,05/20/2016 01:00:00 AM,48,-122,0,0,0
20882,ElliotBayTrailMyrtlePark,05/20/2016 02:00:00 AM,48,-122,0,0,0
20883,ElliotBayTrailMyrtlePark,05/20/2016 03:00:00 AM,48,-122,0,0,0
20884,ElliotBayTrailMyrtlePark,05/20/2016 04:00:00 AM,48,-122,1,0,1
20885,ElliotBayTrailMyrtlePark,05/20/2016 05:00:00 AM,48,-122,4,10,14
20886,ElliotBayTrailMyrtlePark,05/20/2016 06:00:00 AM,48,-122,12,25,37
20887,ElliotBayTrailMyrtlePark,05/20/2016 07:00:00 AM,48,-122,39,64,103
20888,ElliotBayTrailMyrtlePark,05/20/2016 08:00:00 AM,48,-122,55,195,250
20889,ElliotBayTrailMyrtlePark,05/20/2016 09:00:00 AM,48,-122,53,98,151
20890,ElliotBayTrailMyrtlePark,05/20/2016 10:00:00 AM,48,-122,26,46,72
20891,ElliotBayTrailMyrtlePark,05/20/2016 11:00:00 AM,48,-122,23,23,46
20892,ElliotBayTrailMyrtlePark,05/20/2016 12:00:00 PM,48,-122,26,25,51
20893,ElliotBayTrailMyrtlePark,05/20/2016 01:00:00 PM,48,-122,37,50,87
20894,ElliotBayTrailMyrtlePark,05/20/2016 02:00:00 PM,48,-122,53,40,93
20895,ElliotBayTrailMyrtlePark,05/20/2016 03:00:00 PM,48,-122,49,35,84
20896,ElliotBayTrailMyrtlePark,05/20/2016 04:00:00 PM,48,-122,113,77,190
20897,ElliotBayTrailMyrtlePark,05/20/2016 05:00:00 PM,48,-122,161,83,244
20898,ElliotBayTrailMyrtlePark,05/20/2016 06:00:00 PM,48,-122,168,55,223
20899,ElliotBayTrailMyrtlePark,05/20/2016 07:00:00 PM,48,-122,58,24,82
20900,ElliotBayTrailMyrtlePark,05/20/2016 08:00:00 PM,48,-122,30,24,54
20901,ElliotBayTrailMyrtlePark,05/20/2016 09:00:00 PM,48,-122,16,9,25
20902,ElliotBayTrailMyrtlePark,05/20/2016 10:00:00 PM,48,-122,7,7,14
20903,ElliotBayTrailMyrtlePark,05/20/2016 11:00:00 PM,48,-122,0,5,5
20904,ElliotBayTrailMyrtlePark,05/21/2016 12:00:00 AM,48,-122,3,1,4
20905,ElliotBayTrailMyrtlePark,05/21/2016 01:00:00 AM,48,-122,4,3,7
20906,ElliotBayTrailMyrtlePark,05/21/2016 02:00:00 AM,48,-122,1,0,1
20907,ElliotBayTrailMyrtlePark,05/21/2016 03:00:00 AM,48,-122,1,0,1
20908,ElliotBayTrailMyrtlePark,05/21/2016 04:00:00 AM,48,-122,1,0,1
20909,ElliotBayTrailMyrtlePark,05/21/2016 05:00:00 AM,48,-122,0,2,2
20910,ElliotBayTrailMyrtlePark,05/21/2016 06:00:00 AM,48,-122,0,1,1
20911,ElliotBayTrailMyrtlePark,05/21/2016 07:00:00 AM,48,-122,0,3,3
20912,ElliotBayTrailMyrtlePark,05/21/2016 08:00:00 AM,48,-122,8,17,25
20913,ElliotBayTrailMyrtlePark,05/21/2016 09:00:00 AM,48,-122,6,15,21
20914,ElliotBayTrailMyrtlePark,05/21/2016 10:00:00 AM,48,-122,4,4,8
20915,ElliotBayTrailMyrtlePark,05/21/2016 11:00:00 AM,48,-122,5,1,6
20916,ElliotBayTrailMyrtlePark,05/21/2016 12:00:00 PM,48,-122,3,7,10
20917,ElliotBayTrailMyrtlePark,05/21/2016 01:00:00 PM,48,-122,11,9,20
20918,ElliotBayTrailMyrtlePark,05/21/2016 02:00:00 PM,48,-122,24,7,31
20919,ElliotBayTrailMyrtlePark,05/21/2016 03:00:00 PM,48,-122,29,18,47
20920,ElliotBayTrailMyrtlePark,05/21/2016 04:00:00 PM,48,-122,16,24,40
20921,ElliotBayTrailMyrtlePark,05/21/2016 05:00:00 PM,48,-122,20,26,46
20922,ElliotBayTrailMyrtlePark,05/21/2016 06:00:00 PM,48,-122,11,17,28
20923,ElliotBayTrailMyrtlePark,05/21/2016 07:00:00 PM,48,-122,14,17,31
20924,ElliotBayTrailMyrtlePark,05/21/2016 08:00:00 PM,48,-122,9,11,20
20925,ElliotBayTrailMyrtlePark,05/21/2016 09:00:00 PM,48,-122,10,0,10
20926,ElliotBayTrailMyrtlePark,05/21/2016 10:00:00 PM,48,-122,7,2,9
20927,ElliotBayTrailMyrtlePark,05/21/2016 11:00:00 PM,48,-122,5,0,5
20928,ElliotBayTrailMyrtlePark,05/22/2016 12:00:00 AM,48,-122,0,0,0
20929,ElliotBayTrailMyrtlePark,05/22/2016 01:00:00 AM,48,-122,3,3,6
20930,ElliotBayTrailMyrtlePark,05/22/2016 02:00:00 AM,48,-122,0,0,0
20931,ElliotBayTrailMyrtlePark,05/22/2016 03:00:00 AM,48,-122,2,0,2
20932,ElliotBayTrailMyrtlePark,05/22/2016 04:00:00 AM,48,-122,0,0,0
20933,ElliotBayTrailMyrtlePark,05/22/2016 05:00:00 AM,48,-122,0,1,1
20934,ElliotBayTrailMyrtlePark,05/22/2016 06:00:00 AM,48,-122,2,6,8
20935,ElliotBayTrailMyrtlePark,05/22/2016 07:00:00 AM,48,-122,5,3,8
20936,ElliotBayTrailMyrtlePark,05/22/2016 08:00:00 AM,48,-122,17,14,31
20937,ElliotBayTrailMyrtlePark,05/22/2016 09:00:00 AM,48,-122,16,16,32
20938,ElliotBayTrailMyrtlePark,05/22/2016 10:00:00 AM,48,-122,20,38,58
20939,ElliotBayTrailMyrtlePark,05/22/2016 11:00:00 AM,48,-122,44,50,94
20940,ElliotBayTrailMyrtlePark,05/22/2016 12:00:00 PM,48,-122,53,50,103
20941,ElliotBayTrailMyrtlePark,05/22/2016 01:00:00 PM,48,-122,57,44,101
20942,ElliotBayTrailMyrtlePark,05/22/2016 02:00:00 PM,48,-122,56,64,120
20943,ElliotBayTrailMyrtlePark,05/22/2016 03:00:00 PM,48,-122,83,68,151
20944,ElliotBayTrailMyrtlePark,05/22/2016 04:00:00 PM,48,-122,67,59,126
20945,ElliotBayTrailMyrtlePark,05/22/2016 05:00:00 PM,48,-122,59,64,123
20946,ElliotBayTrailMyrtlePark,05/22/2016 06:00:00 PM,48,-122,32,34,66
20947,ElliotBayTrailMyrtlePark,05/22/2016 07:00:00 PM,48,-122,19,32,51
20948,ElliotBayTrailMyrtlePark,05/22/2016 08:00:00 PM,48,-122,16,25,41
20949,ElliotBayTrailMyrtlePark,05/22/2016 09:00:00 PM,48,-122,9,7,16
20950,ElliotBayTrailMyrtlePark,05/22/2016 10:00:00 PM,48,-122,1,3,4
20951,ElliotBayTrailMyrtlePark,05/22/2016 11:00:00 PM,48,-122,0,0,0
20952,ElliotBayTrailMyrtlePark,05/23/2016 12:00:00 AM,48,-122,1,3,4
20953,ElliotBayTrailMyrtlePark,05/23/2016 01:00:00 AM,48,-122,2,1,3
20954,ElliotBayTrailMyrtlePark,05/23/2016 02:00:00 AM,48,-122,3,0,3
20955,ElliotBayTrailMyrtlePark,05/23/2016 03:00:00 AM,48,-122,3,1,4
20956,ElliotBayTrailMyrtlePark,05/23/2016 04:00:00 AM,48,-122,0,1,1
20957,ElliotBayTrailMyrtlePark,05/23/2016 05:00:00 AM,48,-122,5,3,8
20958,ElliotBayTrailMyrtlePark,05/23/2016 06:00:00 AM,48,-122,16,31,47
20959,ElliotBayTrailMyrtlePark,05/23/2016 07:00:00 AM,48,-122,35,71,106
20960,ElliotBayTrailMyrtlePark,05/23/2016 08:00:00 AM,48,-122,42,178,220
20961,ElliotBayTrailMyrtlePark,05/23/2016 09:00:00 AM,48,-122,42,133,175
20962,ElliotBayTrailMyrtlePark,05/23/2016 10:00:00 AM,48,-122,19,36,55
20963,ElliotBayTrailMyrtlePark,05/23/2016 11:00:00 AM,48,-122,22,25,47
20964,ElliotBayTrailMyrtlePark,05/23/2016 12:00:00 PM,48,-122,13,15,28
20965,ElliotBayTrailMyrtlePark,05/23/2016 01:00:00 PM,48,-122,21,25,46
20966,ElliotBayTrailMyrtlePark,05/23/2016 02:00:00 PM,48,-122,21,25,46
20967,ElliotBayTrailMyrtlePark,05/23/2016 03:00:00 PM,48,-122,32,24,56
20968,ElliotBayTrailMyrtlePark,05/23/2016 04:00:00 PM,48,-122,71,50,121
20969,ElliotBayTrailMyrtlePark,05/23/2016 05:00:00 PM,48,-122,181,76,257
20970,ElliotBayTrailMyrtlePark,05/23/2016 06:00:00 PM,48,-122,203,58,261
20971,ElliotBayTrailMyrtlePark,05/23/2016 07:00:00 PM,48,-122,77,28,105
20972,ElliotBayTrailMyrtlePark,05/23/2016 08:00:00 PM,48,-122,37,20,57
20973,ElliotBayTrailMyrtlePark,05/23/2016 09:00:00 PM,48,-122,7,3,10
20974,ElliotBayTrailMyrtlePark,05/23/2016 10:00:00 PM,48,-122,6,4,10
20975,ElliotBayTrailMyrtlePark,05/23/2016 11:00:00 PM,48,-122,5,1,6
20976,ElliotBayTrailMyrtlePark,05/24/2016 12:00:00 AM,48,-122,1,0,1
20977,ElliotBayTrailMyrtlePark,05/24/2016 01:00:00 AM,48,-122,0,0,0
20978,ElliotBayTrailMyrtlePark,05/24/2016 02:00:00 AM,48,-122,0,0,0
20979,ElliotBayTrailMyrtlePark,05/24/2016 03:00:00 AM,48,-122,2,0,2
20980,ElliotBayTrailMyrtlePark,05/24/2016 04:00:00 AM,48,-122,1,0,1
20981,ElliotBayTrailMyrtlePark,05/24/2016 05:00:00 AM,48,-122,8,2,10
20982,ElliotBayTrailMyrtlePark,05/24/2016 06:00:00 AM,48,-122,22,29,51
20983,ElliotBayTrailMyrtlePark,05/24/2016 07:00:00 AM,48,-122,33,86,119
20984,ElliotBayTrailMyrtlePark,05/24/2016 08:00:00 AM,48,-122,46,215,261
20985,ElliotBayTrailMyrtlePark,05/24/2016 09:00:00 AM,48,-122,42,138,180
20986,ElliotBayTrailMyrtlePark,05/24/2016 10:00:00 AM,48,-122,25,42,67
20987,ElliotBayTrailMyrtlePark,05/24/2016 11:00:00 AM,48,-122,20,19,39
20988,ElliotBayTrailMyrtlePark,05/24/2016 12:00:00 PM,48,-122,35,23,58
20989,ElliotBayTrailMyrtlePark,05/24/2016 01:00:00 PM,48,-122,27,17,44
20990,ElliotBayTrailMyrtlePark,05/24/2016 02:00:00 PM,48,-122,22,28,50
20991,ElliotBayTrailMyrtlePark,05/24/2016 03:00:00 PM,48,-122,40,29,69
20992,ElliotBayTrailMyrtlePark,05/24/2016 04:00:00 PM,48,-122,90,55,145
20993,ElliotBayTrailMyrtlePark,05/24/2016 05:00:00 PM,48,-122,204,102,306
20994,ElliotBayTrailMyrtlePark,05/24/2016 06:00:00 PM,48,-122,230,72,302
20995,ElliotBayTrailMyrtlePark,05/24/2016 07:00:00 PM,48,-122,85,36,121
20996,ElliotBayTrailMyrtlePark,05/24/2016 08:00:00 PM,48,-122,39,23,62
20997,ElliotBayTrailMyrtlePark,05/24/2016 09:00:00 PM,48,-122,8,10,18
20998,ElliotBayTrailMyrtlePark,05/24/2016 10:00:00 PM,48,-122,8,5,13
20999,ElliotBayTrailMyrtlePark,05/24/2016 11:00:00 PM,48,-122,11,2,13
21000,ElliotBayTrailMyrtlePark,05/25/2016 12:00:00 AM,48,-122,1,1,2
21001,ElliotBayTrailMyrtlePark,05/25/2016 01:00:00 AM,48,-122,0,0,0
21002,ElliotBayTrailMyrtlePark,05/25/2016 02:00:00 AM,48,-122,0,0,0
21003,ElliotBayTrailMyrtlePark,05/25/2016 03:00:00 AM,48,-122,0,0,0
21004,ElliotBayTrailMyrtlePark,05/25/2016 04:00:00 AM,48,-122,0,0,0
21005,ElliotBayTrailMyrtlePark,05/25/2016 05:00:00 AM,48,-122,7,6,13
21006,ElliotBayTrailMyrtlePark,05/25/2016 06:00:00 AM,48,-122,28,21,49
21007,ElliotBayTrailMyrtlePark,05/25/2016 07:00:00 AM,48,-122,44,101,145
21008,ElliotBayTrailMyrtlePark,05/25/2016 08:00:00 AM,48,-122,58,180,238
21009,ElliotBayTrailMyrtlePark,05/25/2016 09:00:00 AM,48,-122,41,129,170
21010,ElliotBayTrailMyrtlePark,05/25/2016 10:00:00 AM,48,-122,18,43,61
21011,ElliotBayTrailMyrtlePark,05/25/2016 11:00:00 AM,48,-122,23,22,45
21012,ElliotBayTrailMyrtlePark,05/25/2016 12:00:00 PM,48,-122,44,24,68
21013,ElliotBayTrailMyrtlePark,05/25/2016 01:00:00 PM,48,-122,47,39,86
21014,ElliotBayTrailMyrtlePark,05/25/2016 02:00:00 PM,48,-122,28,26,54
21015,ElliotBayTrailMyrtlePark,05/25/2016 03:00:00 PM,48,-122,24,23,47
21016,ElliotBayTrailMyrtlePark,05/25/2016 04:00:00 PM,48,-122,69,50,119
21017,ElliotBayTrailMyrtlePark,05/25/2016 05:00:00 PM,48,-122,196,67,263
21018,ElliotBayTrailMyrtlePark,05/25/2016 06:00:00 PM,48,-122,180,56,236
21019,ElliotBayTrailMyrtlePark,05/25/2016 07:00:00 PM,48,-122,68,37,105
21020,ElliotBayTrailMyrtlePark,05/25/2016 08:00:00 PM,48,-122,38,13,51
21021,ElliotBayTrailMyrtlePark,05/25/2016 09:00:00 PM,48,-122,5,10,15
21022,ElliotBayTrailMyrtlePark,05/25/2016 10:00:00 PM,48,-122,12,4,16
21023,ElliotBayTrailMyrtlePark,05/25/2016 11:00:00 PM,48,-122,6,1,7
21024,ElliotBayTrailMyrtlePark,05/26/2016 12:00:00 AM,48,-122,0,0,0
21025,ElliotBayTrailMyrtlePark,05/26/2016 01:00:00 AM,48,-122,0,1,1
21026,ElliotBayTrailMyrtlePark,05/26/2016 02:00:00 AM,48,-122,0,1,1
21027,ElliotBayTrailMyrtlePark,05/26/2016 03:00:00 AM,48,-122,0,0,0
21028,ElliotBayTrailMyrtlePark,05/26/2016 04:00:00 AM,48,-122,2,0,2
21029,ElliotBayTrailMyrtlePark,05/26/2016 05:00:00 AM,48,-122,5,5,10
21030,ElliotBayTrailMyrtlePark,05/26/2016 06:00:00 AM,48,-122,14,26,40
21031,ElliotBayTrailMyrtlePark,05/26/2016 07:00:00 AM,48,-122,43,80,123
21032,ElliotBayTrailMyrtlePark,05/26/2016 08:00:00 AM,48,-122,44,147,191
21033,ElliotBayTrailMyrtlePark,05/26/2016 09:00:00 AM,48,-122,40,133,173
21034,ElliotBayTrailMyrtlePark,05/26/2016 10:00:00 AM,48,-122,22,37,59
21035,ElliotBayTrailMyrtlePark,05/26/2016 11:00:00 AM,48,-122,16,21,37
21036,ElliotBayTrailMyrtlePark,05/26/2016 12:00:00 PM,48,-122,18,20,38
21037,ElliotBayTrailMyrtlePark,05/26/2016 01:00:00 PM,48,-122,27,28,55
21038,ElliotBayTrailMyrtlePark,05/26/2016 02:00:00 PM,48,-122,21,13,34
21039,ElliotBayTrailMyrtlePark,05/26/2016 03:00:00 PM,48,-122,30,22,52
21040,ElliotBayTrailMyrtlePark,05/26/2016 04:00:00 PM,48,-122,62,45,107
21041,ElliotBayTrailMyrtlePark,05/26/2016 05:00:00 PM,48,-122,174,59,233
21042,ElliotBayTrailMyrtlePark,05/26/2016 06:00:00 PM,48,-122,176,47,223
21043,ElliotBayTrailMyrtlePark,05/26/2016 07:00:00 PM,48,-122,63,17,80
21044,ElliotBayTrailMyrtlePark,05/26/2016 08:00:00 PM,48,-122,35,16,51
21045,ElliotBayTrailMyrtlePark,05/26/2016 09:00:00 PM,48,-122,8,11,19
21046,ElliotBayTrailMyrtlePark,05/26/2016 10:00:00 PM,48,-122,10,5,15
21047,ElliotBayTrailMyrtlePark,05/26/2016 11:00:00 PM,48,-122,8,1,9
21048,ElliotBayTrailMyrtlePark,05/27/2016 12:00:00 AM,48,-122,5,1,6
21049,ElliotBayTrailMyrtlePark,05/27/2016 01:00:00 AM,48,-122,1,0,1
21050,ElliotBayTrailMyrtlePark,05/27/2016 02:00:00 AM,48,-122,0,0,0
21051,ElliotBayTrailMyrtlePark,05/27/2016 03:00:00 AM,48,-122,0,0,0
21052,ElliotBayTrailMyrtlePark,05/27/2016 04:00:00 AM,48,-122,1,0,1
21053,ElliotBayTrailMyrtlePark,05/27/2016 05:00:00 AM,48,-122,3,5,8
21054,ElliotBayTrailMyrtlePark,05/27/2016 06:00:00 AM,48,-122,9,18,27
21055,ElliotBayTrailMyrtlePark,05/27/2016 07:00:00 AM,48,-122,21,23,44
21056,ElliotBayTrailMyrtlePark,05/27/2016 08:00:00 AM,48,-122,31,116,147
21057,ElliotBayTrailMyrtlePark,05/27/2016 09:00:00 AM,48,-122,37,114,151
21058,ElliotBayTrailMyrtlePark,05/27/2016 10:00:00 AM,48,-122,20,40,60
21059,ElliotBayTrailMyrtlePark,05/27/2016 11:00:00 AM,48,-122,16,28,44
21060,ElliotBayTrailMyrtlePark,05/27/2016 12:00:00 PM,48,-122,27,26,53
21061,ElliotBayTrailMyrtlePark,05/27/2016 01:00:00 PM,48,-122,24,25,49
21062,ElliotBayTrailMyrtlePark,05/27/2016 02:00:00 PM,48,-122,31,24,55
21063,ElliotBayTrailMyrtlePark,05/27/2016 03:00:00 PM,48,-122,55,34,89
21064,ElliotBayTrailMyrtlePark,05/27/2016 04:00:00 PM,48,-122,66,44,110
21065,ElliotBayTrailMyrtlePark,05/27/2016 05:00:00 PM,48,-122,116,46,162
21066,ElliotBayTrailMyrtlePark,05/27/2016 06:00:00 PM,48,-122,105,30,135
21067,ElliotBayTrailMyrtlePark,05/27/2016 07:00:00 PM,48,-122,38,13,51
21068,ElliotBayTrailMyrtlePark,05/27/2016 08:00:00 PM,48,-122,21,8,29
21069,ElliotBayTrailMyrtlePark,05/27/2016 09:00:00 PM,48,-122,4,7,11
21070,ElliotBayTrailMyrtlePark,05/27/2016 10:00:00 PM,48,-122,4,2,6
21071,ElliotBayTrailMyrtlePark,05/27/2016 11:00:00 PM,48,-122,8,1,9
21072,ElliotBayTrailMyrtlePark,05/28/2016 12:00:00 AM,48,-122,1,0,1
21073,ElliotBayTrailMyrtlePark,05/28/2016 01:00:00 AM,48,-122,2,0,2
21074,ElliotBayTrailMyrtlePark,05/28/2016 02:00:00 AM,48,-122,4,2,6
21075,ElliotBayTrailMyrtlePark,05/28/2016 03:00:00 AM,48,-122,0,0,0
21076,ElliotBayTrailMyrtlePark,05/28/2016 04:00:00 AM,48,-122,1,0,1
21077,ElliotBayTrailMyrtlePark,05/28/2016 05:00:00 AM,48,-122,0,1,1
21078,ElliotBayTrailMyrtlePark,05/28/2016 06:00:00 AM,48,-122,5,5,10
21079,ElliotBayTrailMyrtlePark,05/28/2016 07:00:00 AM,48,-122,3,4,7
21080,ElliotBayTrailMyrtlePark,05/28/2016 08:00:00 AM,48,-122,13,9,22
21081,ElliotBayTrailMyrtlePark,05/28/2016 09:00:00 AM,48,-122,19,30,49
21082,ElliotBayTrailMyrtlePark,05/28/2016 10:00:00 AM,48,-122,14,23,37
21083,ElliotBayTrailMyrtlePark,05/28/2016 11:00:00 AM,48,-122,18,32,50
21084,ElliotBayTrailMyrtlePark,05/28/2016 12:00:00 PM,48,-122,33,21,54
21085,ElliotBayTrailMyrtlePark,05/28/2016 01:00:00 PM,48,-122,20,13,33
21086,ElliotBayTrailMyrtlePark,05/28/2016 02:00:00 PM,48,-122,32,27,59
21087,ElliotBayTrailMyrtlePark,05/28/2016 03:00:00 PM,48,-122,41,35,76
21088,ElliotBayTrailMyrtlePark,05/28/2016 04:00:00 PM,48,-122,28,33,61
21089,ElliotBayTrailMyrtlePark,05/28/2016 05:00:00 PM,48,-122,18,17,35
21090,ElliotBayTrailMyrtlePark,05/28/2016 06:00:00 PM,48,-122,13,12,25
21091,ElliotBayTrailMyrtlePark,05/28/2016 07:00:00 PM,48,-122,14,35,49
21092,ElliotBayTrailMyrtlePark,05/28/2016 08:00:00 PM,48,-122,12,7,19
21093,ElliotBayTrailMyrtlePark,05/28/2016 09:00:00 PM,48,-122,4,6,10
21094,ElliotBayTrailMyrtlePark,05/28/2016 10:00:00 PM,48,-122,1,7,8
21095,ElliotBayTrailMyrtlePark,05/28/2016 11:00:00 PM,48,-122,16,3,19
21096,ElliotBayTrailMyrtlePark,05/29/2016 12:00:00 AM,48,-122,3,1,4
21097,ElliotBayTrailMyrtlePark,05/29/2016 01:00:00 AM,48,-122,2,5,7
21098,ElliotBayTrailMyrtlePark,05/29/2016 02:00:00 AM,48,-122,1,1,2
21099,ElliotBayTrailMyrtlePark,05/29/2016 03:00:00 AM,48,-122,1,0,1
21100,ElliotBayTrailMyrtlePark,05/29/2016 04:00:00 AM,48,-122,0,0,0
21101,ElliotBayTrailMyrtlePark,05/29/2016 05:00:00 AM,48,-122,0,0,0
21102,ElliotBayTrailMyrtlePark,05/29/2016 06:00:00 AM,48,-122,2,3,5
21103,ElliotBayTrailMyrtlePark,05/29/2016 07:00:00 AM,48,-122,5,2,7
21104,ElliotBayTrailMyrtlePark,05/29/2016 08:00:00 AM,48,-122,2,8,10
21105,ElliotBayTrailMyrtlePark,05/29/2016 09:00:00 AM,48,-122,9,8,17
21106,ElliotBayTrailMyrtlePark,05/29/2016 10:00:00 AM,48,-122,7,12,19
21107,ElliotBayTrailMyrtlePark,05/29/2016 11:00:00 AM,48,-122,14,17,31
21108,ElliotBayTrailMyrtlePark,05/29/2016 12:00:00 PM,48,-122,8,11,19
21109,ElliotBayTrailMyrtlePark,05/29/2016 01:00:00 PM,48,-122,17,14,31
21110,ElliotBayTrailMyrtlePark,05/29/2016 02:00:00 PM,48,-122,34,37,71
21111,ElliotBayTrailMyrtlePark,05/29/2016 03:00:00 PM,48,-122,26,9,35
21112,ElliotBayTrailMyrtlePark,05/29/2016 04:00:00 PM,48,-122,36,24,60
21113,ElliotBayTrailMyrtlePark,05/29/2016 05:00:00 PM,48,-122,22,29,51
21114,ElliotBayTrailMyrtlePark,05/29/2016 06:00:00 PM,48,-122,36,27,63
21115,ElliotBayTrailMyrtlePark,05/29/2016 07:00:00 PM,48,-122,30,31,61
21116,ElliotBayTrailMyrtlePark,05/29/2016 08:00:00 PM,48,-122,22,23,45
21117,ElliotBayTrailMyrtlePark,05/29/2016 09:00:00 PM,48,-122,4,12,16
21118,ElliotBayTrailMyrtlePark,05/29/2016 10:00:00 PM,48,-122,6,1,7
21119,ElliotBayTrailMyrtlePark,05/29/2016 11:00:00 PM,48,-122,2,0,2
21120,ElliotBayTrailMyrtlePark,05/30/2016 12:00:00 AM,48,-122,2,4,6
21121,ElliotBayTrailMyrtlePark,05/30/2016 01:00:00 AM,48,-122,0,0,0
21122,ElliotBayTrailMyrtlePark,05/30/2016 02:00:00 AM,48,-122,0,0,0
21123,ElliotBayTrailMyrtlePark,05/30/2016 03:00:00 AM,48,-122,1,0,1
21124,ElliotBayTrailMyrtlePark,05/30/2016 04:00:00 AM,48,-122,1,0,1
21125,ElliotBayTrailMyrtlePark,05/30/2016 05:00:00 AM,48,-122,0,3,3
21126,ElliotBayTrailMyrtlePark,05/30/2016 06:00:00 AM,48,-122,4,10,14
21127,ElliotBayTrailMyrtlePark,05/30/2016 07:00:00 AM,48,-122,6,13,19
21128,ElliotBayTrailMyrtlePark,05/30/2016 08:00:00 AM,48,-122,16,17,33
21129,ElliotBayTrailMyrtlePark,05/30/2016 09:00:00 AM,48,-122,28,32,60
21130,ElliotBayTrailMyrtlePark,05/30/2016 10:00:00 AM,48,-122,59,64,123
21131,ElliotBayTrailMyrtlePark,05/30/2016 11:00:00 AM,48,-122,84,95,179
21132,ElliotBayTrailMyrtlePark,05/30/2016 12:00:00 PM,48,-122,101,109,210
21133,ElliotBayTrailMyrtlePark,05/30/2016 01:00:00 PM,48,-122,99,96,195
21134,ElliotBayTrailMyrtlePark,05/30/2016 02:00:00 PM,48,-122,167,124,291
21135,ElliotBayTrailMyrtlePark,05/30/2016 03:00:00 PM,48,-122,127,132,259
21136,ElliotBayTrailMyrtlePark,05/30/2016 04:00:00 PM,48,-122,123,98,221
21137,ElliotBayTrailMyrtlePark,05/30/2016 05:00:00 PM,48,-122,115,96,211
21138,ElliotBayTrailMyrtlePark,05/30/2016 06:00:00 PM,48,-122,82,49,131
21139,ElliotBayTrailMyrtlePark,05/30/2016 07:00:00 PM,48,-122,39,46,85
21140,ElliotBayTrailMyrtlePark,05/30/2016 08:00:00 PM,48,-122,37,27,64
21141,ElliotBayTrailMyrtlePark,05/30/2016 09:00:00 PM,48,-122,14,8,22
21142,ElliotBayTrailMyrtlePark,05/30/2016 10:00:00 PM,48,-122,6,5,11
21143,ElliotBayTrailMyrtlePark,05/30/2016 11:00:00 PM,48,-122,3,5,8
21144,ElliotBayTrailMyrtlePark,05/31/2016 12:00:00 AM,48,-122,2,1,3
21145,ElliotBayTrailMyrtlePark,05/31/2016 01:00:00 AM,48,-122,3,1,4
21146,ElliotBayTrailMyrtlePark,05/31/2016 02:00:00 AM,48,-122,3,0,3
21147,ElliotBayTrailMyrtlePark,05/31/2016 03:00:00 AM,48,-122,0,0,0
21148,ElliotBayTrailMyrtlePark,05/31/2016 04:00:00 AM,48,-122,0,0,0
21149,ElliotBayTrailMyrtlePark,05/31/2016 05:00:00 AM,48,-122,6,4,10
21150,ElliotBayTrailMyrtlePark,05/31/2016 06:00:00 AM,48,-122,20,24,44
21151,ElliotBayTrailMyrtlePark,05/31/2016 07:00:00 AM,48,-122,42,100,142
21152,ElliotBayTrailMyrtlePark,05/31/2016 08:00:00 AM,48,-122,67,224,291
21153,ElliotBayTrailMyrtlePark,05/31/2016 09:00:00 AM,48,-122,53,139,192
21154,ElliotBayTrailMyrtlePark,05/31/2016 10:00:00 AM,48,-122,36,46,82
21155,ElliotBayTrailMyrtlePark,05/31/2016 11:00:00 AM,48,-122,34,25,59
21156,ElliotBayTrailMyrtlePark,05/31/2016 12:00:00 PM,48,-122,39,39,78
21157,ElliotBayTrailMyrtlePark,05/31/2016 01:00:00 PM,48,-122,35,36,71
21158,ElliotBayTrailMyrtlePark,05/31/2016 02:00:00 PM,48,-122,37,46,83
21159,ElliotBayTrailMyrtlePark,05/31/2016 03:00:00 PM,48,-122,40,40,80
21160,ElliotBayTrailMyrtlePark,05/31/2016 04:00:00 PM,48,-122,97,81,178
21161,ElliotBayTrailMyrtlePark,05/31/2016 05:00:00 PM,48,-122,208,101,309
21162,ElliotBayTrailMyrtlePark,05/31/2016 06:00:00 PM,48,-122,245,68,313
21163,ElliotBayTrailMyrtlePark,05/31/2016 07:00:00 PM,48,-122,95,30,125
21164,ElliotBayTrailMyrtlePark,05/31/2016 08:00:00 PM,48,-122,57,42,99
21165,ElliotBayTrailMyrtlePark,05/31/2016 09:00:00 PM,48,-122,20,9,29
21166,ElliotBayTrailMyrtlePark,05/31/2016 10:00:00 PM,48,-122,4,4,8
21167,ElliotBayTrailMyrtlePark,05/31/2016 11:00:00 PM,48,-122,1,1,2
21168,ElliotBayTrailMyrtlePark,06/01/2016 12:00:00 AM,48,-122,3,1,4
21169,ElliotBayTrailMyrtlePark,06/01/2016 01:00:00 AM,48,-122,0,0,0
21170,ElliotBayTrailMyrtlePark,06/01/2016 02:00:00 AM,48,-122,2,0,2
21171,ElliotBayTrailMyrtlePark,06/01/2016 03:00:00 AM,48,-122,1,0,1
21172,ElliotBayTrailMyrtlePark,06/01/2016 04:00:00 AM,48,-122,2,0,2
21173,ElliotBayTrailMyrtlePark,06/01/2016 05:00:00 AM,48,-122,6,8,14
21174,ElliotBayTrailMyrtlePark,06/01/2016 06:00:00 AM,48,-122,22,27,49
21175,ElliotBayTrailMyrtlePark,06/01/2016 07:00:00 AM,48,-122,50,116,166
21176,ElliotBayTrailMyrtlePark,06/01/2016 08:00:00 AM,48,-122,68,203,271
21177,ElliotBayTrailMyrtlePark,06/01/2016 09:00:00 AM,48,-122,51,133,184
21178,ElliotBayTrailMyrtlePark,06/01/2016 10:00:00 AM,48,-122,21,62,83
21179,ElliotBayTrailMyrtlePark,06/01/2016 11:00:00 AM,48,-122,29,35,64
21180,ElliotBayTrailMyrtlePark,06/01/2016 12:00:00 PM,48,-122,28,36,64
21181,ElliotBayTrailMyrtlePark,06/01/2016 01:00:00 PM,48,-122,39,22,61
21182,ElliotBayTrailMyrtlePark,06/01/2016 02:00:00 PM,48,-122,34,17,51
21183,ElliotBayTrailMyrtlePark,06/01/2016 03:00:00 PM,48,-122,42,25,67
21184,ElliotBayTrailMyrtlePark,06/01/2016 04:00:00 PM,48,-122,84,64,148
21185,ElliotBayTrailMyrtlePark,06/01/2016 05:00:00 PM,48,-122,204,69,273
21186,ElliotBayTrailMyrtlePark,06/01/2016 06:00:00 PM,48,-122,205,79,284
21187,ElliotBayTrailMyrtlePark,06/01/2016 07:00:00 PM,48,-122,69,27,96
21188,ElliotBayTrailMyrtlePark,06/01/2016 08:00:00 PM,48,-122,42,30,72
21189,ElliotBayTrailMyrtlePark,06/01/2016 09:00:00 PM,48,-122,13,8,21
21190,ElliotBayTrailMyrtlePark,06/01/2016 10:00:00 PM,48,-122,10,2,12
21191,ElliotBayTrailMyrtlePark,06/01/2016 11:00:00 PM,48,-122,3,1,4
21192,ElliotBayTrailMyrtlePark,06/02/2016 12:00:00 AM,48,-122,0,1,1
21193,ElliotBayTrailMyrtlePark,06/02/2016 01:00:00 AM,48,-122,1,1,2
21194,ElliotBayTrailMyrtlePark,06/02/2016 02:00:00 AM,48,-122,1,1,2
21195,ElliotBayTrailMyrtlePark,06/02/2016 03:00:00 AM,48,-122,0,0,0
21196,ElliotBayTrailMyrtlePark,06/02/2016 04:00:00 AM,48,-122,2,0,2
21197,ElliotBayTrailMyrtlePark,06/02/2016 05:00:00 AM,48,-122,6,1,7
21198,ElliotBayTrailMyrtlePark,06/02/2016 06:00:00 AM,48,-122,23,32,55
21199,ElliotBayTrailMyrtlePark,06/02/2016 07:00:00 AM,48,-122,37,76,113
21200,ElliotBayTrailMyrtlePark,06/02/2016 08:00:00 AM,48,-122,39,171,210
21201,ElliotBayTrailMyrtlePark,06/02/2016 09:00:00 AM,48,-122,30,115,145
21202,ElliotBayTrailMyrtlePark,06/02/2016 10:00:00 AM,48,-122,13,37,50
21203,ElliotBayTrailMyrtlePark,06/02/2016 11:00:00 AM,48,-122,17,25,42
21204,ElliotBayTrailMyrtlePark,06/02/2016 12:00:00 PM,48,-122,23,18,41
21205,ElliotBayTrailMyrtlePark,06/02/2016 01:00:00 PM,48,-122,15,18,33
21206,ElliotBayTrailMyrtlePark,06/02/2016 02:00:00 PM,48,-122,24,12,36
21207,ElliotBayTrailMyrtlePark,06/02/2016 03:00:00 PM,48,-122,26,22,48
21208,ElliotBayTrailMyrtlePark,06/02/2016 04:00:00 PM,48,-122,65,51,116
21209,ElliotBayTrailMyrtlePark,06/02/2016 05:00:00 PM,48,-122,171,89,260
21210,ElliotBayTrailMyrtlePark,06/02/2016 06:00:00 PM,48,-122,169,52,221
21211,ElliotBayTrailMyrtlePark,06/02/2016 07:00:00 PM,48,-122,63,25,88
21212,ElliotBayTrailMyrtlePark,06/02/2016 08:00:00 PM,48,-122,87,31,118
21213,ElliotBayTrailMyrtlePark,06/02/2016 09:00:00 PM,48,-122,11,12,23
21214,ElliotBayTrailMyrtlePark,06/02/2016 10:00:00 PM,48,-122,9,7,16
21215,ElliotBayTrailMyrtlePark,06/02/2016 11:00:00 PM,48,-122,7,7,14
21216,ElliotBayTrailMyrtlePark,06/03/2016 12:00:00 AM,48,-122,1,0,1
21217,ElliotBayTrailMyrtlePark,06/03/2016 01:00:00 AM,48,-122,0,0,0
21218,ElliotBayTrailMyrtlePark,06/03/2016 02:00:00 AM,48,-122,2,1,3
21219,ElliotBayTrailMyrtlePark,06/03/2016 03:00:00 AM,48,-122,1,0,1
21220,ElliotBayTrailMyrtlePark,06/03/2016 04:00:00 AM,48,-122,0,1,1
21221,ElliotBayTrailMyrtlePark,06/03/2016 05:00:00 AM,48,-122,6,6,12
21222,ElliotBayTrailMyrtlePark,06/03/2016 06:00:00 AM,48,-122,19,24,43
21223,ElliotBayTrailMyrtlePark,06/03/2016 07:00:00 AM,48,-122,32,80,112
21224,ElliotBayTrailMyrtlePark,06/03/2016 08:00:00 AM,48,-122,75,158,233
21225,ElliotBayTrailMyrtlePark,06/03/2016 09:00:00 AM,48,-122,91,90,181
21226,ElliotBayTrailMyrtlePark,06/03/2016 10:00:00 AM,48,-122,26,60,86
21227,ElliotBayTrailMyrtlePark,06/03/2016 11:00:00 AM,48,-122,28,26,54
21228,ElliotBayTrailMyrtlePark,06/03/2016 12:00:00 PM,48,-122,29,31,60
21229,ElliotBayTrailMyrtlePark,06/03/2016 01:00:00 PM,48,-122,42,56,98
21230,ElliotBayTrailMyrtlePark,06/03/2016 02:00:00 PM,48,-122,53,38,91
21231,ElliotBayTrailMyrtlePark,06/03/2016 03:00:00 PM,48,-122,68,36,104
21232,ElliotBayTrailMyrtlePark,06/03/2016 04:00:00 PM,48,-122,111,63,174
21233,ElliotBayTrailMyrtlePark,06/03/2016 05:00:00 PM,48,-122,182,67,249
21234,ElliotBayTrailMyrtlePark,06/03/2016 06:00:00 PM,48,-122,193,70,263
21235,ElliotBayTrailMyrtlePark,06/03/2016 07:00:00 PM,48,-122,67,33,100
21236,ElliotBayTrailMyrtlePark,06/03/2016 08:00:00 PM,48,-122,41,29,70
21237,ElliotBayTrailMyrtlePark,06/03/2016 09:00:00 PM,48,-122,7,11,18
21238,ElliotBayTrailMyrtlePark,06/03/2016 10:00:00 PM,48,-122,8,11,19
21239,ElliotBayTrailMyrtlePark,06/03/2016 11:00:00 PM,48,-122,4,11,15
21240,ElliotBayTrailMyrtlePark,06/04/2016 12:00:00 AM,48,-122,4,5,9
21241,ElliotBayTrailMyrtlePark,06/04/2016 01:00:00 AM,48,-122,3,0,3
21242,ElliotBayTrailMyrtlePark,06/04/2016 02:00:00 AM,48,-122,0,0,0
21243,ElliotBayTrailMyrtlePark,06/04/2016 03:00:00 AM,48,-122,0,0,0
21244,ElliotBayTrailMyrtlePark,06/04/2016 04:00:00 AM,48,-122,0,0,0
21245,ElliotBayTrailMyrtlePark,06/04/2016 05:00:00 AM,48,-122,1,1,2
21246,ElliotBayTrailMyrtlePark,06/04/2016 06:00:00 AM,48,-122,5,7,12
21247,ElliotBayTrailMyrtlePark,06/04/2016 07:00:00 AM,48,-122,10,11,21
21248,ElliotBayTrailMyrtlePark,06/04/2016 08:00:00 AM,48,-122,28,15,43
21249,ElliotBayTrailMyrtlePark,06/04/2016 09:00:00 AM,48,-122,38,43,81
21250,ElliotBayTrailMyrtlePark,06/04/2016 10:00:00 AM,48,-122,62,61,123
21251,ElliotBayTrailMyrtlePark,06/04/2016 11:00:00 AM,48,-122,78,57,135
21252,ElliotBayTrailMyrtlePark,06/04/2016 12:00:00 PM,48,-122,109,62,171
21253,ElliotBayTrailMyrtlePark,06/04/2016 01:00:00 PM,48,-122,76,85,161
21254,ElliotBayTrailMyrtlePark,06/04/2016 02:00:00 PM,48,-122,82,64,146
21255,ElliotBayTrailMyrtlePark,06/04/2016 03:00:00 PM,48,-122,69,86,155
21256,ElliotBayTrailMyrtlePark,06/04/2016 04:00:00 PM,48,-122,55,65,120
21257,ElliotBayTrailMyrtlePark,06/04/2016 05:00:00 PM,48,-122,56,80,136
21258,ElliotBayTrailMyrtlePark,06/04/2016 06:00:00 PM,48,-122,58,54,112
21259,ElliotBayTrailMyrtlePark,06/04/2016 07:00:00 PM,48,-122,65,37,102
21260,ElliotBayTrailMyrtlePark,06/04/2016 08:00:00 PM,48,-122,38,19,57
21261,ElliotBayTrailMyrtlePark,06/04/2016 09:00:00 PM,48,-122,23,24,47
21262,ElliotBayTrailMyrtlePark,06/04/2016 10:00:00 PM,48,-122,12,16,28
21263,ElliotBayTrailMyrtlePark,06/04/2016 11:00:00 PM,48,-122,5,6,11
21264,ElliotBayTrailMyrtlePark,06/05/2016 12:00:00 AM,48,-122,5,5,10
21265,ElliotBayTrailMyrtlePark,06/05/2016 01:00:00 AM,48,-122,4,1,5
21266,ElliotBayTrailMyrtlePark,06/05/2016 02:00:00 AM,48,-122,2,0,2
21267,ElliotBayTrailMyrtlePark,06/05/2016 03:00:00 AM,48,-122,2,2,4
21268,ElliotBayTrailMyrtlePark,06/05/2016 04:00:00 AM,48,-122,1,2,3
21269,ElliotBayTrailMyrtlePark,06/05/2016 05:00:00 AM,48,-122,0,0,0
21270,ElliotBayTrailMyrtlePark,06/05/2016 06:00:00 AM,48,-122,6,10,16
21271,ElliotBayTrailMyrtlePark,06/05/2016 07:00:00 AM,48,-122,6,14,20
21272,ElliotBayTrailMyrtlePark,06/05/2016 08:00:00 AM,48,-122,27,18,45
21273,ElliotBayTrailMyrtlePark,06/05/2016 09:00:00 AM,48,-122,49,46,95
21274,ElliotBayTrailMyrtlePark,06/05/2016 10:00:00 AM,48,-122,59,47,106
21275,ElliotBayTrailMyrtlePark,06/05/2016 11:00:00 AM,48,-122,64,87,151
21276,ElliotBayTrailMyrtlePark,06/05/2016 12:00:00 PM,48,-122,69,98,167
21277,ElliotBayTrailMyrtlePark,06/05/2016 01:00:00 PM,48,-122,89,58,147
21278,ElliotBayTrailMyrtlePark,06/05/2016 02:00:00 PM,48,-122,97,63,160
21279,ElliotBayTrailMyrtlePark,06/05/2016 03:00:00 PM,48,-122,99,60,159
21280,ElliotBayTrailMyrtlePark,06/05/2016 04:00:00 PM,48,-122,56,46,102
21281,ElliotBayTrailMyrtlePark,06/05/2016 05:00:00 PM,48,-122,42,55,97
21282,ElliotBayTrailMyrtlePark,06/05/2016 06:00:00 PM,48,-122,44,34,78
21283,ElliotBayTrailMyrtlePark,06/05/2016 07:00:00 PM,48,-122,31,20,51
21284,ElliotBayTrailMyrtlePark,06/05/2016 08:00:00 PM,48,-122,33,27,60
21285,ElliotBayTrailMyrtlePark,06/05/2016 09:00:00 PM,48,-122,9,26,35
21286,ElliotBayTrailMyrtlePark,06/05/2016 10:00:00 PM,48,-122,5,7,12
21287,ElliotBayTrailMyrtlePark,06/05/2016 11:00:00 PM,48,-122,4,0,4
21288,ElliotBayTrailMyrtlePark,06/06/2016 12:00:00 AM,48,-122,1,1,2
21289,ElliotBayTrailMyrtlePark,06/06/2016 01:00:00 AM,48,-122,4,1,5
21290,ElliotBayTrailMyrtlePark,06/06/2016 02:00:00 AM,48,-122,1,0,1
21291,ElliotBayTrailMyrtlePark,06/06/2016 03:00:00 AM,48,-122,1,0,1
21292,ElliotBayTrailMyrtlePark,06/06/2016 04:00:00 AM,48,-122,1,0,1
21293,ElliotBayTrailMyrtlePark,06/06/2016 05:00:00 AM,48,-122,9,4,13
21294,ElliotBayTrailMyrtlePark,06/06/2016 06:00:00 AM,48,-122,14,34,48
21295,ElliotBayTrailMyrtlePark,06/06/2016 07:00:00 AM,48,-122,49,93,142
21296,ElliotBayTrailMyrtlePark,06/06/2016 08:00:00 AM,48,-122,94,169,263
21297,ElliotBayTrailMyrtlePark,06/06/2016 09:00:00 AM,48,-122,77,106,183
21298,ElliotBayTrailMyrtlePark,06/06/2016 10:00:00 AM,48,-122,26,50,76
21299,ElliotBayTrailMyrtlePark,06/06/2016 11:00:00 AM,48,-122,19,25,44
21300,ElliotBayTrailMyrtlePark,06/06/2016 12:00:00 PM,48,-122,32,39,71
21301,ElliotBayTrailMyrtlePark,06/06/2016 01:00:00 PM,48,-122,28,39,67
21302,ElliotBayTrailMyrtlePark,06/06/2016 02:00:00 PM,48,-122,27,26,53
21303,ElliotBayTrailMyrtlePark,06/06/2016 03:00:00 PM,48,-122,40,24,64
21304,ElliotBayTrailMyrtlePark,06/06/2016 04:00:00 PM,48,-122,98,67,165
21305,ElliotBayTrailMyrtlePark,06/06/2016 05:00:00 PM,48,-122,210,72,282
21306,ElliotBayTrailMyrtlePark,06/06/2016 06:00:00 PM,48,-122,219,69,288
21307,ElliotBayTrailMyrtlePark,06/06/2016 07:00:00 PM,48,-122,103,48,151
21308,ElliotBayTrailMyrtlePark,06/06/2016 08:00:00 PM,48,-122,51,30,81
21309,ElliotBayTrailMyrtlePark,06/06/2016 09:00:00 PM,48,-122,18,35,53
21310,ElliotBayTrailMyrtlePark,06/06/2016 10:00:00 PM,48,-122,13,16,29
21311,ElliotBayTrailMyrtlePark,06/06/2016 11:00:00 PM,48,-122,5,3,8
21312,ElliotBayTrailMyrtlePark,06/07/2016 12:00:00 AM,48,-122,4,1,5
21313,ElliotBayTrailMyrtlePark,06/07/2016 01:00:00 AM,48,-122,0,0,0
21314,ElliotBayTrailMyrtlePark,06/07/2016 02:00:00 AM,48,-122,0,0,0
21315,ElliotBayTrailMyrtlePark,06/07/2016 03:00:00 AM,48,-122,2,0,2
21316,ElliotBayTrailMyrtlePark,06/07/2016 04:00:00 AM,48,-122,1,0,1
21317,ElliotBayTrailMyrtlePark,06/07/2016 05:00:00 AM,48,-122,6,5,11
21318,ElliotBayTrailMyrtlePark,06/07/2016 06:00:00 AM,48,-122,27,36,63
21319,ElliotBayTrailMyrtlePark,06/07/2016 07:00:00 AM,48,-122,40,113,153
21320,ElliotBayTrailMyrtlePark,06/07/2016 08:00:00 AM,48,-122,79,189,268
21321,ElliotBayTrailMyrtlePark,06/07/2016 09:00:00 AM,48,-122,62,123,185
21322,ElliotBayTrailMyrtlePark,06/07/2016 10:00:00 AM,48,-122,29,45,74
21323,ElliotBayTrailMyrtlePark,06/07/2016 11:00:00 AM,48,-122,21,25,46
21324,ElliotBayTrailMyrtlePark,06/07/2016 12:00:00 PM,48,-122,22,36,58
21325,ElliotBayTrailMyrtlePark,06/07/2016 01:00:00 PM,48,-122,31,33,64
21326,ElliotBayTrailMyrtlePark,06/07/2016 02:00:00 PM,48,-122,20,27,47
21327,ElliotBayTrailMyrtlePark,06/07/2016 03:00:00 PM,48,-122,52,35,87
21328,ElliotBayTrailMyrtlePark,06/07/2016 04:00:00 PM,48,-122,97,58,155
21329,ElliotBayTrailMyrtlePark,06/07/2016 05:00:00 PM,48,-122,209,94,303
21330,ElliotBayTrailMyrtlePark,06/07/2016 06:00:00 PM,48,-122,228,55,283
21331,ElliotBayTrailMyrtlePark,06/07/2016 07:00:00 PM,48,-122,111,38,149
21332,ElliotBayTrailMyrtlePark,06/07/2016 08:00:00 PM,48,-122,45,36,81
21333,ElliotBayTrailMyrtlePark,06/07/2016 09:00:00 PM,48,-122,15,19,34
21334,ElliotBayTrailMyrtlePark,06/07/2016 10:00:00 PM,48,-122,18,8,26
21335,ElliotBayTrailMyrtlePark,06/07/2016 11:00:00 PM,48,-122,8,1,9
21336,ElliotBayTrailMyrtlePark,06/08/2016 12:00:00 AM,48,-122,1,4,5
21337,ElliotBayTrailMyrtlePark,06/08/2016 01:00:00 AM,48,-122,0,0,0
21338,ElliotBayTrailMyrtlePark,06/08/2016 02:00:00 AM,48,-122,1,2,3
21339,ElliotBayTrailMyrtlePark,06/08/2016 03:00:00 AM,48,-122,1,0,1
21340,ElliotBayTrailMyrtlePark,06/08/2016 04:00:00 AM,48,-122,1,0,1
21341,ElliotBayTrailMyrtlePark,06/08/2016 05:00:00 AM,48,-122,3,7,10
21342,ElliotBayTrailMyrtlePark,06/08/2016 06:00:00 AM,48,-122,33,31,64
21343,ElliotBayTrailMyrtlePark,06/08/2016 07:00:00 AM,48,-122,33,90,123
21344,ElliotBayTrailMyrtlePark,06/08/2016 08:00:00 AM,48,-122,50,170,220
21345,ElliotBayTrailMyrtlePark,06/08/2016 09:00:00 AM,48,-122,65,129,194
21346,ElliotBayTrailMyrtlePark,06/08/2016 10:00:00 AM,48,-122,15,50,65
21347,ElliotBayTrailMyrtlePark,06/08/2016 11:00:00 AM,48,-122,31,32,63
21348,ElliotBayTrailMyrtlePark,06/08/2016 12:00:00 PM,48,-122,41,27,68
21349,ElliotBayTrailMyrtlePark,06/08/2016 01:00:00 PM,48,-122,28,30,58
21350,ElliotBayTrailMyrtlePark,06/08/2016 02:00:00 PM,48,-122,17,34,51
21351,ElliotBayTrailMyrtlePark,06/08/2016 03:00:00 PM,48,-122,37,17,54
21352,ElliotBayTrailMyrtlePark,06/08/2016 04:00:00 PM,48,-122,83,47,130
21353,ElliotBayTrailMyrtlePark,06/08/2016 05:00:00 PM,48,-122,177,67,244
21354,ElliotBayTrailMyrtlePark,06/08/2016 06:00:00 PM,48,-122,193,46,239
21355,ElliotBayTrailMyrtlePark,06/08/2016 07:00:00 PM,48,-122,72,31,103
21356,ElliotBayTrailMyrtlePark,06/08/2016 08:00:00 PM,48,-122,43,32,75
21357,ElliotBayTrailMyrtlePark,06/08/2016 09:00:00 PM,48,-122,14,11,25
21358,ElliotBayTrailMyrtlePark,06/08/2016 10:00:00 PM,48,-122,10,1,11
21359,ElliotBayTrailMyrtlePark,06/08/2016 11:00:00 PM,48,-122,4,2,6
21360,ElliotBayTrailMyrtlePark,06/09/2016 12:00:00 AM,48,-122,0,1,1
21361,ElliotBayTrailMyrtlePark,06/09/2016 01:00:00 AM,48,-122,1,0,1
21362,ElliotBayTrailMyrtlePark,06/09/2016 02:00:00 AM,48,-122,0,1,1
21363,ElliotBayTrailMyrtlePark,06/09/2016 03:00:00 AM,48,-122,0,0,0
21364,ElliotBayTrailMyrtlePark,06/09/2016 04:00:00 AM,48,-122,1,0,1
21365,ElliotBayTrailMyrtlePark,06/09/2016 05:00:00 AM,48,-122,7,1,8
21366,ElliotBayTrailMyrtlePark,06/09/2016 06:00:00 AM,48,-122,15,25,40
21367,ElliotBayTrailMyrtlePark,06/09/2016 07:00:00 AM,48,-122,29,66,95
21368,ElliotBayTrailMyrtlePark,06/09/2016 08:00:00 AM,48,-122,41,158,199
21369,ElliotBayTrailMyrtlePark,06/09/2016 09:00:00 AM,48,-122,52,100,152
21370,ElliotBayTrailMyrtlePark,06/09/2016 10:00:00 AM,48,-122,17,46,63
21371,ElliotBayTrailMyrtlePark,06/09/2016 11:00:00 AM,48,-122,20,28,48
21372,ElliotBayTrailMyrtlePark,06/09/2016 12:00:00 PM,48,-122,18,10,28
21373,ElliotBayTrailMyrtlePark,06/09/2016 01:00:00 PM,48,-122,14,26,40
21374,ElliotBayTrailMyrtlePark,06/09/2016 02:00:00 PM,48,-122,41,17,58
21375,ElliotBayTrailMyrtlePark,06/09/2016 03:00:00 PM,48,-122,33,26,59
21376,ElliotBayTrailMyrtlePark,06/09/2016 04:00:00 PM,48,-122,53,40,93
21377,ElliotBayTrailMyrtlePark,06/09/2016 05:00:00 PM,48,-122,164,53,217
21378,ElliotBayTrailMyrtlePark,06/09/2016 06:00:00 PM,48,-122,186,44,230
21379,ElliotBayTrailMyrtlePark,06/09/2016 07:00:00 PM,48,-122,63,32,95
21380,ElliotBayTrailMyrtlePark,06/09/2016 08:00:00 PM,48,-122,35,25,60
21381,ElliotBayTrailMyrtlePark,06/09/2016 09:00:00 PM,48,-122,14,10,24
21382,ElliotBayTrailMyrtlePark,06/09/2016 10:00:00 PM,48,-122,5,2,7
21383,ElliotBayTrailMyrtlePark,06/09/2016 11:00:00 PM,48,-122,5,1,6
21384,ElliotBayTrailMyrtlePark,06/10/2016 12:00:00 AM,48,-122,5,0,5
21385,ElliotBayTrailMyrtlePark,06/10/2016 01:00:00 AM,48,-122,0,0,0
21386,ElliotBayTrailMyrtlePark,06/10/2016 02:00:00 AM,48,-122,0,0,0
21387,ElliotBayTrailMyrtlePark,06/10/2016 03:00:00 AM,48,-122,1,0,1
21388,ElliotBayTrailMyrtlePark,06/10/2016 04:00:00 AM,48,-122,0,0,0
21389,ElliotBayTrailMyrtlePark,06/10/2016 05:00:00 AM,48,-122,3,5,8
21390,ElliotBayTrailMyrtlePark,06/10/2016 06:00:00 AM,48,-122,12,17,29
21391,ElliotBayTrailMyrtlePark,06/10/2016 07:00:00 AM,48,-122,31,49,80
21392,ElliotBayTrailMyrtlePark,06/10/2016 08:00:00 AM,48,-122,40,109,149
21393,ElliotBayTrailMyrtlePark,06/10/2016 09:00:00 AM,48,-122,36,96,132
21394,ElliotBayTrailMyrtlePark,06/10/2016 10:00:00 AM,48,-122,20,48,68
21395,ElliotBayTrailMyrtlePark,06/10/2016 11:00:00 AM,48,-122,25,29,54
21396,ElliotBayTrailMyrtlePark,06/10/2016 12:00:00 PM,48,-122,22,17,39
21397,ElliotBayTrailMyrtlePark,06/10/2016 01:00:00 PM,48,-122,32,30,62
21398,ElliotBayTrailMyrtlePark,06/10/2016 02:00:00 PM,48,-122,30,27,57
21399,ElliotBayTrailMyrtlePark,06/10/2016 03:00:00 PM,48,-122,31,35,66
21400,ElliotBayTrailMyrtlePark,06/10/2016 04:00:00 PM,48,-122,66,36,102
21401,ElliotBayTrailMyrtlePark,06/10/2016 05:00:00 PM,48,-122,141,55,196
21402,ElliotBayTrailMyrtlePark,06/10/2016 06:00:00 PM,48,-122,89,29,118
21403,ElliotBayTrailMyrtlePark,06/10/2016 07:00:00 PM,48,-122,41,5,46
21404,ElliotBayTrailMyrtlePark,06/10/2016 08:00:00 PM,48,-122,16,8,24
21405,ElliotBayTrailMyrtlePark,06/10/2016 09:00:00 PM,48,-122,8,2,10
21406,ElliotBayTrailMyrtlePark,06/10/2016 10:00:00 PM,48,-122,3,6,9
21407,ElliotBayTrailMyrtlePark,06/10/2016 11:00:00 PM,48,-122,4,2,6
21408,ElliotBayTrailMyrtlePark,06/11/2016 12:00:00 AM,48,-122,3,1,4
21409,ElliotBayTrailMyrtlePark,06/11/2016 01:00:00 AM,48,-122,2,1,3
21410,ElliotBayTrailMyrtlePark,06/11/2016 02:00:00 AM,48,-122,0,0,0
21411,ElliotBayTrailMyrtlePark,06/11/2016 03:00:00 AM,48,-122,0,0,0
21412,ElliotBayTrailMyrtlePark,06/11/2016 04:00:00 AM,48,-122,1,0,1
21413,ElliotBayTrailMyrtlePark,06/11/2016 05:00:00 AM,48,-122,2,3,5
21414,ElliotBayTrailMyrtlePark,06/11/2016 06:00:00 AM,48,-122,3,4,7
21415,ElliotBayTrailMyrtlePark,06/11/2016 07:00:00 AM,48,-122,8,6,14
21416,ElliotBayTrailMyrtlePark,06/11/2016 08:00:00 AM,48,-122,19,15,34
21417,ElliotBayTrailMyrtlePark,06/11/2016 09:00:00 AM,48,-122,23,29,52
21418,ElliotBayTrailMyrtlePark,06/11/2016 10:00:00 AM,48,-122,31,31,62
21419,ElliotBayTrailMyrtlePark,06/11/2016 11:00:00 AM,48,-122,51,47,98
21420,ElliotBayTrailMyrtlePark,06/11/2016 12:00:00 PM,48,-122,63,45,108
21421,ElliotBayTrailMyrtlePark,06/11/2016 01:00:00 PM,48,-122,58,58,116
21422,ElliotBayTrailMyrtlePark,06/11/2016 02:00:00 PM,48,-122,52,66,118
21423,ElliotBayTrailMyrtlePark,06/11/2016 03:00:00 PM,48,-122,46,45,91
21424,ElliotBayTrailMyrtlePark,06/11/2016 04:00:00 PM,48,-122,43,48,91
21425,ElliotBayTrailMyrtlePark,06/11/2016 05:00:00 PM,48,-122,41,24,65
21426,ElliotBayTrailMyrtlePark,06/11/2016 06:00:00 PM,48,-122,32,23,55
21427,ElliotBayTrailMyrtlePark,06/11/2016 07:00:00 PM,48,-122,28,39,67
21428,ElliotBayTrailMyrtlePark,06/11/2016 08:00:00 PM,48,-122,20,23,43
21429,ElliotBayTrailMyrtlePark,06/11/2016 09:00:00 PM,48,-122,10,13,23
21430,ElliotBayTrailMyrtlePark,06/11/2016 10:00:00 PM,48,-122,4,20,24
21431,ElliotBayTrailMyrtlePark,06/11/2016 11:00:00 PM,48,-122,5,12,17
21432,ElliotBayTrailMyrtlePark,06/12/2016 12:00:00 AM,48,-122,0,5,5
21433,ElliotBayTrailMyrtlePark,06/12/2016 01:00:00 AM,48,-122,0,2,2
21434,ElliotBayTrailMyrtlePark,06/12/2016 02:00:00 AM,48,-122,1,0,1
21435,ElliotBayTrailMyrtlePark,06/12/2016 03:00:00 AM,48,-122,0,0,0
21436,ElliotBayTrailMyrtlePark,06/12/2016 04:00:00 AM,48,-122,0,0,0
21437,ElliotBayTrailMyrtlePark,06/12/2016 05:00:00 AM,48,-122,0,1,1
21438,ElliotBayTrailMyrtlePark,06/12/2016 06:00:00 AM,48,-122,1,4,5
21439,ElliotBayTrailMyrtlePark,06/12/2016 07:00:00 AM,48,-122,5,4,9
21440,ElliotBayTrailMyrtlePark,06/12/2016 08:00:00 AM,48,-122,8,8,16
21441,ElliotBayTrailMyrtlePark,06/12/2016 09:00:00 AM,48,-122,37,30,67
21442,ElliotBayTrailMyrtlePark,06/12/2016 10:00:00 AM,48,-122,49,49,98
21443,ElliotBayTrailMyrtlePark,06/12/2016 11:00:00 AM,48,-122,67,66,133
21444,ElliotBayTrailMyrtlePark,06/12/2016 12:00:00 PM,48,-122,59,79,138
21445,ElliotBayTrailMyrtlePark,06/12/2016 01:00:00 PM,48,-122,58,84,142
21446,ElliotBayTrailMyrtlePark,06/12/2016 02:00:00 PM,48,-122,78,59,137
21447,ElliotBayTrailMyrtlePark,06/12/2016 03:00:00 PM,48,-122,87,84,171
21448,ElliotBayTrailMyrtlePark,06/12/2016 04:00:00 PM,48,-122,130,70,200
21449,ElliotBayTrailMyrtlePark,06/12/2016 05:00:00 PM,48,-122,103,60,163
21450,ElliotBayTrailMyrtlePark,06/12/2016 06:00:00 PM,48,-122,50,50,100
21451,ElliotBayTrailMyrtlePark,06/12/2016 07:00:00 PM,48,-122,36,42,78
21452,ElliotBayTrailMyrtlePark,06/12/2016 08:00:00 PM,48,-122,27,27,54
21453,ElliotBayTrailMyrtlePark,06/12/2016 09:00:00 PM,48,-122,4,10,14
21454,ElliotBayTrailMyrtlePark,06/12/2016 10:00:00 PM,48,-122,4,3,7
21455,ElliotBayTrailMyrtlePark,06/12/2016 11:00:00 PM,48,-122,1,0,1
21456,ElliotBayTrailMyrtlePark,06/13/2016 12:00:00 AM,48,-122,2,1,3
21457,ElliotBayTrailMyrtlePark,06/13/2016 01:00:00 AM,48,-122,0,1,1
21458,ElliotBayTrailMyrtlePark,06/13/2016 02:00:00 AM,48,-122,1,0,1
21459,ElliotBayTrailMyrtlePark,06/13/2016 03:00:00 AM,48,-122,1,0,1
21460,ElliotBayTrailMyrtlePark,06/13/2016 04:00:00 AM,48,-122,0,1,1
21461,ElliotBayTrailMyrtlePark,06/13/2016 05:00:00 AM,48,-122,5,4,9
21462,ElliotBayTrailMyrtlePark,06/13/2016 06:00:00 AM,48,-122,16,23,39
21463,ElliotBayTrailMyrtlePark,06/13/2016 07:00:00 AM,48,-122,28,69,97
21464,ElliotBayTrailMyrtlePark,06/13/2016 08:00:00 AM,48,-122,38,169,207
21465,ElliotBayTrailMyrtlePark,06/13/2016 09:00:00 AM,48,-122,36,112,148
21466,ElliotBayTrailMyrtlePark,06/13/2016 10:00:00 AM,48,-122,20,30,50
21467,ElliotBayTrailMyrtlePark,06/13/2016 11:00:00 AM,48,-122,22,30,52
21468,ElliotBayTrailMyrtlePark,06/13/2016 12:00:00 PM,48,-122,16,11,27
21469,ElliotBayTrailMyrtlePark,06/13/2016 01:00:00 PM,48,-122,11,20,31
21470,ElliotBayTrailMyrtlePark,06/13/2016 02:00:00 PM,48,-122,31,27,58
21471,ElliotBayTrailMyrtlePark,06/13/2016 03:00:00 PM,48,-122,20,20,40
21472,ElliotBayTrailMyrtlePark,06/13/2016 04:00:00 PM,48,-122,64,38,102
21473,ElliotBayTrailMyrtlePark,06/13/2016 05:00:00 PM,48,-122,180,65,245
21474,ElliotBayTrailMyrtlePark,06/13/2016 06:00:00 PM,48,-122,169,45,214
21475,ElliotBayTrailMyrtlePark,06/13/2016 07:00:00 PM,48,-122,60,26,86
21476,ElliotBayTrailMyrtlePark,06/13/2016 08:00:00 PM,48,-122,20,12,32
21477,ElliotBayTrailMyrtlePark,06/13/2016 09:00:00 PM,48,-122,14,4,18
21478,ElliotBayTrailMyrtlePark,06/13/2016 10:00:00 PM,48,-122,5,2,7
21479,ElliotBayTrailMyrtlePark,06/13/2016 11:00:00 PM,48,-122,1,1,2
21480,ElliotBayTrailMyrtlePark,06/14/2016 12:00:00 AM,48,-122,0,0,0
21481,ElliotBayTrailMyrtlePark,06/14/2016 01:00:00 AM,48,-122,1,0,1
21482,ElliotBayTrailMyrtlePark,06/14/2016 02:00:00 AM,48,-122,0,1,1
21483,ElliotBayTrailMyrtlePark,06/14/2016 03:00:00 AM,48,-122,2,0,2
21484,ElliotBayTrailMyrtlePark,06/14/2016 04:00:00 AM,48,-122,0,0,0
21485,ElliotBayTrailMyrtlePark,06/14/2016 05:00:00 AM,48,-122,4,2,6
21486,ElliotBayTrailMyrtlePark,06/14/2016 06:00:00 AM,48,-122,15,25,40
21487,ElliotBayTrailMyrtlePark,06/14/2016 07:00:00 AM,48,-122,37,60,97
21488,ElliotBayTrailMyrtlePark,06/14/2016 08:00:00 AM,48,-122,32,122,154
21489,ElliotBayTrailMyrtlePark,06/14/2016 09:00:00 AM,48,-122,36,87,123
21490,ElliotBayTrailMyrtlePark,06/14/2016 10:00:00 AM,48,-122,18,22,40
21491,ElliotBayTrailMyrtlePark,06/14/2016 11:00:00 AM,48,-122,8,16,24
21492,ElliotBayTrailMyrtlePark,06/14/2016 12:00:00 PM,48,-122,12,17,29
21493,ElliotBayTrailMyrtlePark,06/14/2016 01:00:00 PM,48,-122,16,18,34
21494,ElliotBayTrailMyrtlePark,06/14/2016 02:00:00 PM,48,-122,18,13,31
21495,ElliotBayTrailMyrtlePark,06/14/2016 03:00:00 PM,48,-122,14,11,25
21496,ElliotBayTrailMyrtlePark,06/14/2016 04:00:00 PM,48,-122,40,33,73
21497,ElliotBayTrailMyrtlePark,06/14/2016 05:00:00 PM,48,-122,125,58,183
21498,ElliotBayTrailMyrtlePark,06/14/2016 06:00:00 PM,48,-122,138,44,182
21499,ElliotBayTrailMyrtlePark,06/14/2016 07:00:00 PM,48,-122,60,25,85
21500,ElliotBayTrailMyrtlePark,06/14/2016 08:00:00 PM,48,-122,23,8,31
21501,ElliotBayTrailMyrtlePark,06/14/2016 09:00:00 PM,48,-122,12,2,14
21502,ElliotBayTrailMyrtlePark,06/14/2016 10:00:00 PM,48,-122,21,9,30
21503,ElliotBayTrailMyrtlePark,06/14/2016 11:00:00 PM,48,-122,2,0,2
21504,ElliotBayTrailMyrtlePark,06/15/2016 12:00:00 AM,48,-122,1,1,2
21505,ElliotBayTrailMyrtlePark,06/15/2016 01:00:00 AM,48,-122,1,4,5
21506,ElliotBayTrailMyrtlePark,06/15/2016 02:00:00 AM,48,-122,0,1,1
21507,ElliotBayTrailMyrtlePark,06/15/2016 03:00:00 AM,48,-122,0,0,0
21508,ElliotBayTrailMyrtlePark,06/15/2016 04:00:00 AM,48,-122,0,0,0
21509,ElliotBayTrailMyrtlePark,06/15/2016 05:00:00 AM,48,-122,6,5,11
21510,ElliotBayTrailMyrtlePark,06/15/2016 06:00:00 AM,48,-122,16,29,45
21511,ElliotBayTrailMyrtlePark,06/15/2016 07:00:00 AM,48,-122,29,80,109
21512,ElliotBayTrailMyrtlePark,06/15/2016 08:00:00 AM,48,-122,52,174,226
21513,ElliotBayTrailMyrtlePark,06/15/2016 09:00:00 AM,48,-122,46,116,162
21514,ElliotBayTrailMyrtlePark,06/15/2016 10:00:00 AM,48,-122,16,37,53
21515,ElliotBayTrailMyrtlePark,06/15/2016 11:00:00 AM,48,-122,34,25,59
21516,ElliotBayTrailMyrtlePark,06/15/2016 12:00:00 PM,48,-122,23,17,40
21517,ElliotBayTrailMyrtlePark,06/15/2016 01:00:00 PM,48,-122,29,26,55
21518,ElliotBayTrailMyrtlePark,06/15/2016 02:00:00 PM,48,-122,31,36,67
21519,ElliotBayTrailMyrtlePark,06/15/2016 03:00:00 PM,48,-122,41,42,83
21520,ElliotBayTrailMyrtlePark,06/15/2016 04:00:00 PM,48,-122,89,61,150
21521,ElliotBayTrailMyrtlePark,06/15/2016 05:00:00 PM,48,-122,189,84,273
21522,ElliotBayTrailMyrtlePark,06/15/2016 06:00:00 PM,48,-122,210,64,274
21523,ElliotBayTrailMyrtlePark,06/15/2016 07:00:00 PM,48,-122,88,46,134
21524,ElliotBayTrailMyrtlePark,06/15/2016 08:00:00 PM,48,-122,41,26,67
21525,ElliotBayTrailMyrtlePark,06/15/2016 09:00:00 PM,48,-122,12,8,20
21526,ElliotBayTrailMyrtlePark,06/15/2016 10:00:00 PM,48,-122,7,11,18
21527,ElliotBayTrailMyrtlePark,06/15/2016 11:00:00 PM,48,-122,6,1,7
21528,ElliotBayTrailMyrtlePark,06/16/2016 12:00:00 AM,48,-122,0,2,2
21529,ElliotBayTrailMyrtlePark,06/16/2016 01:00:00 AM,48,-122,0,3,3
21530,ElliotBayTrailMyrtlePark,06/16/2016 02:00:00 AM,48,-122,0,1,1
21531,ElliotBayTrailMyrtlePark,06/16/2016 03:00:00 AM,48,-122,0,0,0
21532,ElliotBayTrailMyrtlePark,06/16/2016 04:00:00 AM,48,-122,0,0,0
21533,ElliotBayTrailMyrtlePark,06/16/2016 05:00:00 AM,48,-122,6,3,9
21534,ElliotBayTrailMyrtlePark,06/16/2016 06:00:00 AM,48,-122,18,31,49
21535,ElliotBayTrailMyrtlePark,06/16/2016 07:00:00 AM,48,-122,31,77,108
21536,ElliotBayTrailMyrtlePark,06/16/2016 08:00:00 AM,48,-122,60,167,227
21537,ElliotBayTrailMyrtlePark,06/16/2016 09:00:00 AM,48,-122,52,134,186
21538,ElliotBayTrailMyrtlePark,06/16/2016 10:00:00 AM,48,-122,43,52,95
21539,ElliotBayTrailMyrtlePark,06/16/2016 11:00:00 AM,48,-122,27,33,60
21540,ElliotBayTrailMyrtlePark,06/16/2016 12:00:00 PM,48,-122,30,43,73
21541,ElliotBayTrailMyrtlePark,06/16/2016 01:00:00 PM,48,-122,25,43,68
21542,ElliotBayTrailMyrtlePark,06/16/2016 02:00:00 PM,48,-122,30,36,66
21543,ElliotBayTrailMyrtlePark,06/16/2016 03:00:00 PM,48,-122,38,34,72
21544,ElliotBayTrailMyrtlePark,06/16/2016 04:00:00 PM,48,-122,81,76,157
21545,ElliotBayTrailMyrtlePark,06/16/2016 05:00:00 PM,48,-122,174,96,270
21546,ElliotBayTrailMyrtlePark,06/16/2016 06:00:00 PM,48,-122,154,62,216
21547,ElliotBayTrailMyrtlePark,06/16/2016 07:00:00 PM,48,-122,72,32,104
21548,ElliotBayTrailMyrtlePark,06/16/2016 08:00:00 PM,48,-122,39,27,66
21549,ElliotBayTrailMyrtlePark,06/16/2016 09:00:00 PM,48,-122,43,15,58
21550,ElliotBayTrailMyrtlePark,06/16/2016 10:00:00 PM,48,-122,22,7,29
21551,ElliotBayTrailMyrtlePark,06/16/2016 11:00:00 PM,48,-122,5,1,6
21552,ElliotBayTrailMyrtlePark,06/17/2016 12:00:00 AM,48,-122,6,1,7
21553,ElliotBayTrailMyrtlePark,06/17/2016 01:00:00 AM,48,-122,5,2,7
21554,ElliotBayTrailMyrtlePark,06/17/2016 02:00:00 AM,48,-122,1,0,1
21555,ElliotBayTrailMyrtlePark,06/17/2016 03:00:00 AM,48,-122,1,0,1
21556,ElliotBayTrailMyrtlePark,06/17/2016 04:00:00 AM,48,-122,0,0,0
21557,ElliotBayTrailMyrtlePark,06/17/2016 05:00:00 AM,48,-122,7,7,14
21558,ElliotBayTrailMyrtlePark,06/17/2016 06:00:00 AM,48,-122,18,28,46
21559,ElliotBayTrailMyrtlePark,06/17/2016 07:00:00 AM,48,-122,19,65,84
21560,ElliotBayTrailMyrtlePark,06/17/2016 08:00:00 AM,48,-122,61,133,194
21561,ElliotBayTrailMyrtlePark,06/17/2016 09:00:00 AM,48,-122,42,105,147
21562,ElliotBayTrailMyrtlePark,06/17/2016 10:00:00 AM,48,-122,26,46,72
21563,ElliotBayTrailMyrtlePark,06/17/2016 11:00:00 AM,48,-122,20,23,43
21564,ElliotBayTrailMyrtlePark,06/17/2016 12:00:00 PM,48,-122,43,40,83
21565,ElliotBayTrailMyrtlePark,06/17/2016 01:00:00 PM,48,-122,36,27,63
21566,ElliotBayTrailMyrtlePark,06/17/2016 02:00:00 PM,48,-122,28,26,54
21567,ElliotBayTrailMyrtlePark,06/17/2016 03:00:00 PM,48,-122,53,44,97
21568,ElliotBayTrailMyrtlePark,06/17/2016 04:00:00 PM,48,-122,81,40,121
21569,ElliotBayTrailMyrtlePark,06/17/2016 05:00:00 PM,48,-122,123,48,171
21570,ElliotBayTrailMyrtlePark,06/17/2016 06:00:00 PM,48,-122,102,24,126
21571,ElliotBayTrailMyrtlePark,06/17/2016 07:00:00 PM,48,-122,47,15,62
21572,ElliotBayTrailMyrtlePark,06/17/2016 08:00:00 PM,48,-122,23,7,30
21573,ElliotBayTrailMyrtlePark,06/17/2016 09:00:00 PM,48,-122,11,13,24
21574,ElliotBayTrailMyrtlePark,06/17/2016 10:00:00 PM,48,-122,3,9,12
21575,ElliotBayTrailMyrtlePark,06/17/2016 11:00:00 PM,48,-122,6,1,7
21576,ElliotBayTrailMyrtlePark,06/18/2016 12:00:00 AM,48,-122,1,2,3
21577,ElliotBayTrailMyrtlePark,06/18/2016 01:00:00 AM,48,-122,2,0,2
21578,ElliotBayTrailMyrtlePark,06/18/2016 02:00:00 AM,48,-122,0,0,0
21579,ElliotBayTrailMyrtlePark,06/18/2016 03:00:00 AM,48,-122,0,0,0
21580,ElliotBayTrailMyrtlePark,06/18/2016 04:00:00 AM,48,-122,0,0,0
21581,ElliotBayTrailMyrtlePark,06/18/2016 05:00:00 AM,48,-122,0,1,1
21582,ElliotBayTrailMyrtlePark,06/18/2016 06:00:00 AM,48,-122,5,3,8
21583,ElliotBayTrailMyrtlePark,06/18/2016 07:00:00 AM,48,-122,8,11,19
21584,ElliotBayTrailMyrtlePark,06/18/2016 08:00:00 AM,48,-122,12,10,22
21585,ElliotBayTrailMyrtlePark,06/18/2016 09:00:00 AM,48,-122,16,11,27
21586,ElliotBayTrailMyrtlePark,06/18/2016 10:00:00 AM,48,-122,23,19,42
21587,ElliotBayTrailMyrtlePark,06/18/2016 11:00:00 AM,48,-122,17,17,34
21588,ElliotBayTrailMyrtlePark,06/18/2016 12:00:00 PM,48,-122,22,24,46
21589,ElliotBayTrailMyrtlePark,06/18/2016 01:00:00 PM,48,-122,29,19,48
21590,ElliotBayTrailMyrtlePark,06/18/2016 02:00:00 PM,48,-122,27,20,47
21591,ElliotBayTrailMyrtlePark,06/18/2016 03:00:00 PM,48,-122,24,31,55
21592,ElliotBayTrailMyrtlePark,06/18/2016 04:00:00 PM,48,-122,23,17,40
21593,ElliotBayTrailMyrtlePark,06/18/2016 05:00:00 PM,48,-122,33,17,50
21594,ElliotBayTrailMyrtlePark,06/18/2016 06:00:00 PM,48,-122,21,18,39
21595,ElliotBayTrailMyrtlePark,06/18/2016 07:00:00 PM,48,-122,22,10,32
21596,ElliotBayTrailMyrtlePark,06/18/2016 08:00:00 PM,48,-122,7,4,11
21597,ElliotBayTrailMyrtlePark,06/18/2016 09:00:00 PM,48,-122,7,6,13
21598,ElliotBayTrailMyrtlePark,06/18/2016 10:00:00 PM,48,-122,6,6,12
21599,ElliotBayTrailMyrtlePark,06/18/2016 11:00:00 PM,48,-122,5,0,5
21600,ElliotBayTrailMyrtlePark,06/19/2016 12:00:00 AM,48,-122,1,2,3
21601,ElliotBayTrailMyrtlePark,06/19/2016 01:00:00 AM,48,-122,0,1,1
21602,ElliotBayTrailMyrtlePark,06/19/2016 02:00:00 AM,48,-122,0,1,1
21603,ElliotBayTrailMyrtlePark,06/19/2016 03:00:00 AM,48,-122,1,1,2
21604,ElliotBayTrailMyrtlePark,06/19/2016 04:00:00 AM,48,-122,1,0,1
21605,ElliotBayTrailMyrtlePark,06/19/2016 05:00:00 AM,48,-122,0,0,0
21606,ElliotBayTrailMyrtlePark,06/19/2016 06:00:00 AM,48,-122,1,8,9
21607,ElliotBayTrailMyrtlePark,06/19/2016 07:00:00 AM,48,-122,7,12,19
21608,ElliotBayTrailMyrtlePark,06/19/2016 08:00:00 AM,48,-122,30,15,45
21609,ElliotBayTrailMyrtlePark,06/19/2016 09:00:00 AM,48,-122,34,23,57
21610,ElliotBayTrailMyrtlePark,06/19/2016 10:00:00 AM,48,-122,43,56,99
21611,ElliotBayTrailMyrtlePark,06/19/2016 11:00:00 AM,48,-122,77,85,162
21612,ElliotBayTrailMyrtlePark,06/19/2016 12:00:00 PM,48,-122,83,109,192
21613,ElliotBayTrailMyrtlePark,06/19/2016 01:00:00 PM,48,-122,91,91,182
21614,ElliotBayTrailMyrtlePark,06/19/2016 02:00:00 PM,48,-122,138,104,242
21615,ElliotBayTrailMyrtlePark,06/19/2016 03:00:00 PM,48,-122,84,89,173
21616,ElliotBayTrailMyrtlePark,06/19/2016 04:00:00 PM,48,-122,116,103,219
21617,ElliotBayTrailMyrtlePark,06/19/2016 05:00:00 PM,48,-122,65,60,125
21618,ElliotBayTrailMyrtlePark,06/19/2016 06:00:00 PM,48,-122,46,37,83
21619,ElliotBayTrailMyrtlePark,06/19/2016 07:00:00 PM,48,-122,36,37,73
21620,ElliotBayTrailMyrtlePark,06/19/2016 08:00:00 PM,48,-122,18,15,33
21621,ElliotBayTrailMyrtlePark,06/19/2016 09:00:00 PM,48,-122,12,4,16
21622,ElliotBayTrailMyrtlePark,06/19/2016 10:00:00 PM,48,-122,3,6,9
21623,ElliotBayTrailMyrtlePark,06/19/2016 11:00:00 PM,48,-122,7,0,7
21624,ElliotBayTrailMyrtlePark,06/20/2016 12:00:00 AM,48,-122,1,0,1
21625,ElliotBayTrailMyrtlePark,06/20/2016 01:00:00 AM,48,-122,0,0,0
21626,ElliotBayTrailMyrtlePark,06/20/2016 02:00:00 AM,48,-122,1,0,1
21627,ElliotBayTrailMyrtlePark,06/20/2016 03:00:00 AM,48,-122,1,0,1
21628,ElliotBayTrailMyrtlePark,06/20/2016 04:00:00 AM,48,-122,0,2,2
21629,ElliotBayTrailMyrtlePark,06/20/2016 05:00:00 AM,48,-122,2,5,7
21630,ElliotBayTrailMyrtlePark,06/20/2016 06:00:00 AM,48,-122,15,33,48
21631,ElliotBayTrailMyrtlePark,06/20/2016 07:00:00 AM,48,-122,37,65,102
21632,ElliotBayTrailMyrtlePark,06/20/2016 08:00:00 AM,48,-122,57,156,213
21633,ElliotBayTrailMyrtlePark,06/20/2016 09:00:00 AM,48,-122,45,119,164
21634,ElliotBayTrailMyrtlePark,06/20/2016 10:00:00 AM,48,-122,27,44,71
21635,ElliotBayTrailMyrtlePark,06/20/2016 11:00:00 AM,48,-122,24,39,63
21636,ElliotBayTrailMyrtlePark,06/20/2016 12:00:00 PM,48,-122,23,19,42
21637,ElliotBayTrailMyrtlePark,06/20/2016 01:00:00 PM,48,-122,29,25,54
21638,ElliotBayTrailMyrtlePark,06/20/2016 02:00:00 PM,48,-122,32,23,55
21639,ElliotBayTrailMyrtlePark,06/20/2016 03:00:00 PM,48,-122,43,26,69
21640,ElliotBayTrailMyrtlePark,06/20/2016 04:00:00 PM,48,-122,68,45,113
21641,ElliotBayTrailMyrtlePark,06/20/2016 05:00:00 PM,48,-122,198,83,281
21642,ElliotBayTrailMyrtlePark,06/20/2016 06:00:00 PM,48,-122,210,84,294
21643,ElliotBayTrailMyrtlePark,06/20/2016 07:00:00 PM,48,-122,81,35,116
21644,ElliotBayTrailMyrtlePark,06/20/2016 08:00:00 PM,48,-122,46,30,76
21645,ElliotBayTrailMyrtlePark,06/20/2016 09:00:00 PM,48,-122,18,23,41
21646,ElliotBayTrailMyrtlePark,06/20/2016 10:00:00 PM,48,-122,10,10,20
21647,ElliotBayTrailMyrtlePark,06/20/2016 11:00:00 PM,48,-122,2,2,4
21648,ElliotBayTrailMyrtlePark,06/21/2016 12:00:00 AM,48,-122,1,0,1
21649,ElliotBayTrailMyrtlePark,06/21/2016 01:00:00 AM,48,-122,0,0,0
21650,ElliotBayTrailMyrtlePark,06/21/2016 02:00:00 AM,48,-122,1,0,1
21651,ElliotBayTrailMyrtlePark,06/21/2016 03:00:00 AM,48,-122,0,0,0
21652,ElliotBayTrailMyrtlePark,06/21/2016 04:00:00 AM,48,-122,0,1,1
21653,ElliotBayTrailMyrtlePark,06/21/2016 05:00:00 AM,48,-122,2,2,4
21654,ElliotBayTrailMyrtlePark,06/21/2016 06:00:00 AM,48,-122,19,25,44
21655,ElliotBayTrailMyrtlePark,06/21/2016 07:00:00 AM,48,-122,39,80,119
21656,ElliotBayTrailMyrtlePark,06/21/2016 08:00:00 AM,48,-122,39,166,205
21657,ElliotBayTrailMyrtlePark,06/21/2016 09:00:00 AM,48,-122,45,115,160
21658,ElliotBayTrailMyrtlePark,06/21/2016 10:00:00 AM,48,-122,21,28,49
21659,ElliotBayTrailMyrtlePark,06/21/2016 11:00:00 AM,48,-122,15,18,33
21660,ElliotBayTrailMyrtlePark,06/21/2016 12:00:00 PM,48,-122,10,18,28
21661,ElliotBayTrailMyrtlePark,06/21/2016 01:00:00 PM,48,-122,22,16,38
21662,ElliotBayTrailMyrtlePark,06/21/2016 02:00:00 PM,48,-122,40,27,67
21663,ElliotBayTrailMyrtlePark,06/21/2016 03:00:00 PM,48,-122,39,28,67
21664,ElliotBayTrailMyrtlePark,06/21/2016 04:00:00 PM,48,-122,81,70,151
21665,ElliotBayTrailMyrtlePark,06/21/2016 05:00:00 PM,48,-122,171,88,259
21666,ElliotBayTrailMyrtlePark,06/21/2016 06:00:00 PM,48,-122,179,62,241
21667,ElliotBayTrailMyrtlePark,06/21/2016 07:00:00 PM,48,-122,73,56,129
21668,ElliotBayTrailMyrtlePark,06/21/2016 08:00:00 PM,48,-122,75,42,117
21669,ElliotBayTrailMyrtlePark,06/21/2016 09:00:00 PM,48,-122,16,23,39
21670,ElliotBayTrailMyrtlePark,06/21/2016 10:00:00 PM,48,-122,7,12,19
21671,ElliotBayTrailMyrtlePark,06/21/2016 11:00:00 PM,48,-122,10,1,11
21672,ElliotBayTrailMyrtlePark,06/22/2016 12:00:00 AM,48,-122,3,0,3
21673,ElliotBayTrailMyrtlePark,06/22/2016 01:00:00 AM,48,-122,1,0,1
21674,ElliotBayTrailMyrtlePark,06/22/2016 02:00:00 AM,48,-122,0,0,0
21675,ElliotBayTrailMyrtlePark,06/22/2016 03:00:00 AM,48,-122,0,0,0
21676,ElliotBayTrailMyrtlePark,06/22/2016 04:00:00 AM,48,-122,0,1,1
21677,ElliotBayTrailMyrtlePark,06/22/2016 05:00:00 AM,48,-122,5,6,11
21678,ElliotBayTrailMyrtlePark,06/22/2016 06:00:00 AM,48,-122,25,30,55
21679,ElliotBayTrailMyrtlePark,06/22/2016 07:00:00 AM,48,-122,35,83,118
21680,ElliotBayTrailMyrtlePark,06/22/2016 08:00:00 AM,48,-122,45,173,218
21681,ElliotBayTrailMyrtlePark,06/22/2016 09:00:00 AM,48,-122,56,131,187
21682,ElliotBayTrailMyrtlePark,06/22/2016 10:00:00 AM,48,-122,39,55,94
21683,ElliotBayTrailMyrtlePark,06/22/2016 11:00:00 AM,48,-122,22,33,55
21684,ElliotBayTrailMyrtlePark,06/22/2016 12:00:00 PM,48,-122,27,55,82
21685,ElliotBayTrailMyrtlePark,06/22/2016 01:00:00 PM,48,-122,49,29,78
21686,ElliotBayTrailMyrtlePark,06/22/2016 02:00:00 PM,48,-122,32,23,55
21687,ElliotBayTrailMyrtlePark,06/22/2016 03:00:00 PM,48,-122,45,29,74
21688,ElliotBayTrailMyrtlePark,06/22/2016 04:00:00 PM,48,-122,104,59,163
21689,ElliotBayTrailMyrtlePark,06/22/2016 05:00:00 PM,48,-122,202,80,282
21690,ElliotBayTrailMyrtlePark,06/22/2016 06:00:00 PM,48,-122,206,70,276
21691,ElliotBayTrailMyrtlePark,06/22/2016 07:00:00 PM,48,-122,82,47,129
21692,ElliotBayTrailMyrtlePark,06/22/2016 08:00:00 PM,48,-122,29,27,56
21693,ElliotBayTrailMyrtlePark,06/22/2016 09:00:00 PM,48,-122,20,7,27
21694,ElliotBayTrailMyrtlePark,06/22/2016 10:00:00 PM,48,-122,8,13,21
21695,ElliotBayTrailMyrtlePark,06/22/2016 11:00:00 PM,48,-122,4,3,7
21696,ElliotBayTrailMyrtlePark,06/23/2016 12:00:00 AM,48,-122,4,0,4
21697,ElliotBayTrailMyrtlePark,06/23/2016 01:00:00 AM,48,-122,3,1,4
21698,ElliotBayTrailMyrtlePark,06/23/2016 02:00:00 AM,48,-122,0,0,0
21699,ElliotBayTrailMyrtlePark,06/23/2016 03:00:00 AM,48,-122,2,0,2
21700,ElliotBayTrailMyrtlePark,06/23/2016 04:00:00 AM,48,-122,1,1,2
21701,ElliotBayTrailMyrtlePark,06/23/2016 05:00:00 AM,48,-122,5,1,6
21702,ElliotBayTrailMyrtlePark,06/23/2016 06:00:00 AM,48,-122,11,14,25
21703,ElliotBayTrailMyrtlePark,06/23/2016 07:00:00 AM,48,-122,26,30,56
21704,ElliotBayTrailMyrtlePark,06/23/2016 08:00:00 AM,48,-122,23,89,112
21705,ElliotBayTrailMyrtlePark,06/23/2016 09:00:00 AM,48,-122,30,94,124
21706,ElliotBayTrailMyrtlePark,06/23/2016 10:00:00 AM,48,-122,12,39,51
21707,ElliotBayTrailMyrtlePark,06/23/2016 11:00:00 AM,48,-122,8,9,17
21708,ElliotBayTrailMyrtlePark,06/23/2016 12:00:00 PM,48,-122,11,19,30
21709,ElliotBayTrailMyrtlePark,06/23/2016 01:00:00 PM,48,-122,21,24,45
21710,ElliotBayTrailMyrtlePark,06/23/2016 02:00:00 PM,48,-122,9,9,18
21711,ElliotBayTrailMyrtlePark,06/23/2016 03:00:00 PM,48,-122,20,14,34
21712,ElliotBayTrailMyrtlePark,06/23/2016 04:00:00 PM,48,-122,45,22,67
21713,ElliotBayTrailMyrtlePark,06/23/2016 05:00:00 PM,48,-122,87,24,111
21714,ElliotBayTrailMyrtlePark,06/23/2016 06:00:00 PM,48,-122,100,28,128
21715,ElliotBayTrailMyrtlePark,06/23/2016 07:00:00 PM,48,-122,42,11,53
21716,ElliotBayTrailMyrtlePark,06/23/2016 08:00:00 PM,48,-122,18,4,22
21717,ElliotBayTrailMyrtlePark,06/23/2016 09:00:00 PM,48,-122,5,2,7
21718,ElliotBayTrailMyrtlePark,06/23/2016 10:00:00 PM,48,-122,8,5,13
21719,ElliotBayTrailMyrtlePark,06/23/2016 11:00:00 PM,48,-122,5,2,7
21720,ElliotBayTrailMyrtlePark,06/24/2016 12:00:00 AM,48,-122,0,0,0
21721,ElliotBayTrailMyrtlePark,06/24/2016 01:00:00 AM,48,-122,0,2,2
21722,ElliotBayTrailMyrtlePark,06/24/2016 02:00:00 AM,48,-122,0,0,0
21723,ElliotBayTrailMyrtlePark,06/24/2016 03:00:00 AM,48,-122,0,0,0
21724,ElliotBayTrailMyrtlePark,06/24/2016 04:00:00 AM,48,-122,0,0,0
21725,ElliotBayTrailMyrtlePark,06/24/2016 05:00:00 AM,48,-122,2,3,5
21726,ElliotBayTrailMyrtlePark,06/24/2016 06:00:00 AM,48,-122,12,13,25
21727,ElliotBayTrailMyrtlePark,06/24/2016 07:00:00 AM,48,-122,26,33,59
21728,ElliotBayTrailMyrtlePark,06/24/2016 08:00:00 AM,48,-122,34,103,137
21729,ElliotBayTrailMyrtlePark,06/24/2016 09:00:00 AM,48,-122,29,83,112
21730,ElliotBayTrailMyrtlePark,06/24/2016 10:00:00 AM,48,-122,6,30,36
21731,ElliotBayTrailMyrtlePark,06/24/2016 11:00:00 AM,48,-122,22,23,45
21732,ElliotBayTrailMyrtlePark,06/24/2016 12:00:00 PM,48,-122,19,30,49
21733,ElliotBayTrailMyrtlePark,06/24/2016 01:00:00 PM,48,-122,23,15,38
21734,ElliotBayTrailMyrtlePark,06/24/2016 02:00:00 PM,48,-122,32,22,54
21735,ElliotBayTrailMyrtlePark,06/24/2016 03:00:00 PM,48,-122,39,37,76
21736,ElliotBayTrailMyrtlePark,06/24/2016 04:00:00 PM,48,-122,67,72,139
21737,ElliotBayTrailMyrtlePark,06/24/2016 05:00:00 PM,48,-122,114,59,173
21738,ElliotBayTrailMyrtlePark,06/24/2016 06:00:00 PM,48,-122,85,33,118
21739,ElliotBayTrailMyrtlePark,06/24/2016 07:00:00 PM,48,-122,37,18,55
21740,ElliotBayTrailMyrtlePark,06/24/2016 08:00:00 PM,48,-122,19,12,31
21741,ElliotBayTrailMyrtlePark,06/24/2016 09:00:00 PM,48,-122,8,5,13
21742,ElliotBayTrailMyrtlePark,06/24/2016 10:00:00 PM,48,-122,7,6,13
21743,ElliotBayTrailMyrtlePark,06/24/2016 11:00:00 PM,48,-122,10,1,11
21744,ElliotBayTrailMyrtlePark,06/25/2016 12:00:00 AM,48,-122,1,5,6
21745,ElliotBayTrailMyrtlePark,06/25/2016 01:00:00 AM,48,-122,4,2,6
21746,ElliotBayTrailMyrtlePark,06/25/2016 02:00:00 AM,48,-122,1,0,1
21747,ElliotBayTrailMyrtlePark,06/25/2016 03:00:00 AM,48,-122,0,0,0
21748,ElliotBayTrailMyrtlePark,06/25/2016 04:00:00 AM,48,-122,1,0,1
21749,ElliotBayTrailMyrtlePark,06/25/2016 05:00:00 AM,48,-122,2,1,3
21750,ElliotBayTrailMyrtlePark,06/25/2016 06:00:00 AM,48,-122,6,4,10
21751,ElliotBayTrailMyrtlePark,06/25/2016 07:00:00 AM,48,-122,8,10,18
21752,ElliotBayTrailMyrtlePark,06/25/2016 08:00:00 AM,48,-122,10,18,28
21753,ElliotBayTrailMyrtlePark,06/25/2016 09:00:00 AM,48,-122,22,28,50
21754,ElliotBayTrailMyrtlePark,06/25/2016 10:00:00 AM,48,-122,22,18,40
21755,ElliotBayTrailMyrtlePark,06/25/2016 11:00:00 AM,48,-122,39,44,83
21756,ElliotBayTrailMyrtlePark,06/25/2016 12:00:00 PM,48,-122,46,62,108
21757,ElliotBayTrailMyrtlePark,06/25/2016 01:00:00 PM,48,-122,53,101,154
21758,ElliotBayTrailMyrtlePark,06/25/2016 02:00:00 PM,48,-122,61,94,155
21759,ElliotBayTrailMyrtlePark,06/25/2016 03:00:00 PM,48,-122,78,63,141
21760,ElliotBayTrailMyrtlePark,06/25/2016 04:00:00 PM,48,-122,100,61,161
21761,ElliotBayTrailMyrtlePark,06/25/2016 05:00:00 PM,48,-122,111,58,169
21762,ElliotBayTrailMyrtlePark,06/25/2016 06:00:00 PM,48,-122,70,47,117
21763,ElliotBayTrailMyrtlePark,06/25/2016 07:00:00 PM,48,-122,40,46,86
21764,ElliotBayTrailMyrtlePark,06/25/2016 08:00:00 PM,48,-122,38,31,69
21765,ElliotBayTrailMyrtlePark,06/25/2016 09:00:00 PM,48,-122,14,15,29
21766,ElliotBayTrailMyrtlePark,06/25/2016 10:00:00 PM,48,-122,19,5,24
21767,ElliotBayTrailMyrtlePark,06/25/2016 11:00:00 PM,48,-122,15,1,16
21768,ElliotBayTrailMyrtlePark,06/26/2016 12:00:00 AM,48,-122,3,1,4
21769,ElliotBayTrailMyrtlePark,06/26/2016 01:00:00 AM,48,-122,4,1,5
21770,ElliotBayTrailMyrtlePark,06/26/2016 02:00:00 AM,48,-122,0,2,2
21771,ElliotBayTrailMyrtlePark,06/26/2016 03:00:00 AM,48,-122,2,0,2
21772,ElliotBayTrailMyrtlePark,06/26/2016 04:00:00 AM,48,-122,0,0,0
21773,ElliotBayTrailMyrtlePark,06/26/2016 05:00:00 AM,48,-122,1,0,1
21774,ElliotBayTrailMyrtlePark,06/26/2016 06:00:00 AM,48,-122,3,4,7
21775,ElliotBayTrailMyrtlePark,06/26/2016 07:00:00 AM,48,-122,4,6,10
21776,ElliotBayTrailMyrtlePark,06/26/2016 08:00:00 AM,48,-122,21,27,48
21777,ElliotBayTrailMyrtlePark,06/26/2016 09:00:00 AM,48,-122,35,42,77
21778,ElliotBayTrailMyrtlePark,06/26/2016 10:00:00 AM,48,-122,54,56,110
21779,ElliotBayTrailMyrtlePark,06/26/2016 11:00:00 AM,48,-122,38,72,110
21780,ElliotBayTrailMyrtlePark,06/26/2016 12:00:00 PM,48,-122,63,73,136
21781,ElliotBayTrailMyrtlePark,06/26/2016 01:00:00 PM,48,-122,93,118,211
21782,ElliotBayTrailMyrtlePark,06/26/2016 02:00:00 PM,48,-122,104,67,171
21783,ElliotBayTrailMyrtlePark,06/26/2016 03:00:00 PM,48,-122,96,60,156
21784,ElliotBayTrailMyrtlePark,06/26/2016 04:00:00 PM,48,-122,100,76,176
21785,ElliotBayTrailMyrtlePark,06/26/2016 05:00:00 PM,48,-122,79,57,136
21786,ElliotBayTrailMyrtlePark,06/26/2016 06:00:00 PM,48,-122,57,47,104
21787,ElliotBayTrailMyrtlePark,06/26/2016 07:00:00 PM,48,-122,38,32,70
21788,ElliotBayTrailMyrtlePark,06/26/2016 08:00:00 PM,48,-122,41,27,68
21789,ElliotBayTrailMyrtlePark,06/26/2016 09:00:00 PM,48,-122,8,14,22
21790,ElliotBayTrailMyrtlePark,06/26/2016 10:00:00 PM,48,-122,8,7,15
21791,ElliotBayTrailMyrtlePark,06/26/2016 11:00:00 PM,48,-122,7,3,10
21792,ElliotBayTrailMyrtlePark,06/27/2016 12:00:00 AM,48,-122,2,4,6
21793,ElliotBayTrailMyrtlePark,06/27/2016 01:00:00 AM,48,-122,1,0,1
21794,ElliotBayTrailMyrtlePark,06/27/2016 02:00:00 AM,48,-122,1,0,1
21795,ElliotBayTrailMyrtlePark,06/27/2016 03:00:00 AM,48,-122,3,0,3
21796,ElliotBayTrailMyrtlePark,06/27/2016 04:00:00 AM,48,-122,0,0,0
21797,ElliotBayTrailMyrtlePark,06/27/2016 05:00:00 AM,48,-122,6,2,8
21798,ElliotBayTrailMyrtlePark,06/27/2016 06:00:00 AM,48,-122,18,30,48
21799,ElliotBayTrailMyrtlePark,06/27/2016 07:00:00 AM,48,-122,32,84,116
21800,ElliotBayTrailMyrtlePark,06/27/2016 08:00:00 AM,48,-122,48,180,228
21801,ElliotBayTrailMyrtlePark,06/27/2016 09:00:00 AM,48,-122,58,105,163
21802,ElliotBayTrailMyrtlePark,06/27/2016 10:00:00 AM,48,-122,31,42,73
21803,ElliotBayTrailMyrtlePark,06/27/2016 11:00:00 AM,48,-122,19,29,48
21804,ElliotBayTrailMyrtlePark,06/27/2016 12:00:00 PM,48,-122,24,31,55
21805,ElliotBayTrailMyrtlePark,06/27/2016 01:00:00 PM,48,-122,12,45,57
21806,ElliotBayTrailMyrtlePark,06/27/2016 02:00:00 PM,48,-122,25,25,50
21807,ElliotBayTrailMyrtlePark,06/27/2016 03:00:00 PM,48,-122,36,38,74
21808,ElliotBayTrailMyrtlePark,06/27/2016 04:00:00 PM,48,-122,90,66,156
21809,ElliotBayTrailMyrtlePark,06/27/2016 05:00:00 PM,48,-122,180,76,256
21810,ElliotBayTrailMyrtlePark,06/27/2016 06:00:00 PM,48,-122,253,65,318
21811,ElliotBayTrailMyrtlePark,06/27/2016 07:00:00 PM,48,-122,73,43,116
21812,ElliotBayTrailMyrtlePark,06/27/2016 08:00:00 PM,48,-122,53,40,93
21813,ElliotBayTrailMyrtlePark,06/27/2016 09:00:00 PM,48,-122,20,23,43
21814,ElliotBayTrailMyrtlePark,06/27/2016 10:00:00 PM,48,-122,10,6,16
21815,ElliotBayTrailMyrtlePark,06/27/2016 11:00:00 PM,48,-122,1,2,3
21816,ElliotBayTrailMyrtlePark,06/28/2016 12:00:00 AM,48,-122,1,0,1
21817,ElliotBayTrailMyrtlePark,06/28/2016 01:00:00 AM,48,-122,0,0,0
21818,ElliotBayTrailMyrtlePark,06/28/2016 02:00:00 AM,48,-122,2,1,3
21819,ElliotBayTrailMyrtlePark,06/28/2016 03:00:00 AM,48,-122,1,0,1
21820,ElliotBayTrailMyrtlePark,06/28/2016 04:00:00 AM,48,-122,0,0,0
21821,ElliotBayTrailMyrtlePark,06/28/2016 05:00:00 AM,48,-122,8,5,13
21822,ElliotBayTrailMyrtlePark,06/28/2016 06:00:00 AM,48,-122,12,32,44
21823,ElliotBayTrailMyrtlePark,06/28/2016 07:00:00 AM,48,-122,42,96,138
21824,ElliotBayTrailMyrtlePark,06/28/2016 08:00:00 AM,48,-122,60,189,249
21825,ElliotBayTrailMyrtlePark,06/28/2016 09:00:00 AM,48,-122,44,124,168
21826,ElliotBayTrailMyrtlePark,06/28/2016 10:00:00 AM,48,-122,25,49,74
21827,ElliotBayTrailMyrtlePark,06/28/2016 11:00:00 AM,48,-122,30,24,54
21828,ElliotBayTrailMyrtlePark,06/28/2016 12:00:00 PM,48,-122,19,18,37
21829,ElliotBayTrailMyrtlePark,06/28/2016 01:00:00 PM,48,-122,26,22,48
21830,ElliotBayTrailMyrtlePark,06/28/2016 02:00:00 PM,48,-122,24,28,52
21831,ElliotBayTrailMyrtlePark,06/28/2016 03:00:00 PM,48,-122,38,35,73
21832,ElliotBayTrailMyrtlePark,06/28/2016 04:00:00 PM,48,-122,107,69,176
21833,ElliotBayTrailMyrtlePark,06/28/2016 05:00:00 PM,48,-122,217,79,296
21834,ElliotBayTrailMyrtlePark,06/28/2016 06:00:00 PM,48,-122,214,83,297
21835,ElliotBayTrailMyrtlePark,06/28/2016 07:00:00 PM,48,-122,93,47,140
21836,ElliotBayTrailMyrtlePark,06/28/2016 08:00:00 PM,48,-122,49,36,85
21837,ElliotBayTrailMyrtlePark,06/28/2016 09:00:00 PM,48,-122,20,29,49
21838,ElliotBayTrailMyrtlePark,06/28/2016 10:00:00 PM,48,-122,19,18,37
21839,ElliotBayTrailMyrtlePark,06/28/2016 11:00:00 PM,48,-122,21,3,24
21840,ElliotBayTrailMyrtlePark,06/29/2016 12:00:00 AM,48,-122,2,4,6
21841,ElliotBayTrailMyrtlePark,06/29/2016 01:00:00 AM,48,-122,0,2,2
21842,ElliotBayTrailMyrtlePark,06/29/2016 02:00:00 AM,48,-122,0,0,0
21843,ElliotBayTrailMyrtlePark,06/29/2016 03:00:00 AM,48,-122,3,0,3
21844,ElliotBayTrailMyrtlePark,06/29/2016 04:00:00 AM,48,-122,1,0,1
21845,ElliotBayTrailMyrtlePark,06/29/2016 05:00:00 AM,48,-122,3,4,7
21846,ElliotBayTrailMyrtlePark,06/29/2016 06:00:00 AM,48,-122,23,28,51
21847,ElliotBayTrailMyrtlePark,06/29/2016 07:00:00 AM,48,-122,32,70,102
21848,ElliotBayTrailMyrtlePark,06/29/2016 08:00:00 AM,48,-122,57,177,234
21849,ElliotBayTrailMyrtlePark,06/29/2016 09:00:00 AM,48,-122,49,110,159
21850,ElliotBayTrailMyrtlePark,06/29/2016 10:00:00 AM,48,-122,25,51,76
21851,ElliotBayTrailMyrtlePark,06/29/2016 11:00:00 AM,48,-122,21,25,46
21852,ElliotBayTrailMyrtlePark,06/29/2016 12:00:00 PM,48,-122,36,15,51
21853,ElliotBayTrailMyrtlePark,06/29/2016 01:00:00 PM,48,-122,18,31,49
21854,ElliotBayTrailMyrtlePark,06/29/2016 02:00:00 PM,48,-122,22,27,49
21855,ElliotBayTrailMyrtlePark,06/29/2016 03:00:00 PM,48,-122,40,28,68
21856,ElliotBayTrailMyrtlePark,06/29/2016 04:00:00 PM,48,-122,89,63,152
21857,ElliotBayTrailMyrtlePark,06/29/2016 05:00:00 PM,48,-122,201,77,278
21858,ElliotBayTrailMyrtlePark,06/29/2016 06:00:00 PM,48,-122,217,70,287
21859,ElliotBayTrailMyrtlePark,06/29/2016 07:00:00 PM,48,-122,100,51,151
21860,ElliotBayTrailMyrtlePark,06/29/2016 08:00:00 PM,48,-122,68,45,113
21861,ElliotBayTrailMyrtlePark,06/29/2016 09:00:00 PM,48,-122,25,24,49
21862,ElliotBayTrailMyrtlePark,06/29/2016 10:00:00 PM,48,-122,17,15,32
21863,ElliotBayTrailMyrtlePark,06/29/2016 11:00:00 PM,48,-122,8,6,14
21864,ElliotBayTrailMyrtlePark,06/30/2016 12:00:00 AM,48,-122,3,1,4
21865,ElliotBayTrailMyrtlePark,06/30/2016 01:00:00 AM,48,-122,1,2,3
21866,ElliotBayTrailMyrtlePark,06/30/2016 02:00:00 AM,48,-122,1,0,1
21867,ElliotBayTrailMyrtlePark,06/30/2016 03:00:00 AM,48,-122,1,0,1
21868,ElliotBayTrailMyrtlePark,06/30/2016 04:00:00 AM,48,-122,1,0,1
21869,ElliotBayTrailMyrtlePark,06/30/2016 05:00:00 AM,48,-122,5,3,8
21870,ElliotBayTrailMyrtlePark,06/30/2016 06:00:00 AM,48,-122,22,23,45
21871,ElliotBayTrailMyrtlePark,06/30/2016 07:00:00 AM,48,-122,32,71,103
21872,ElliotBayTrailMyrtlePark,06/30/2016 08:00:00 AM,48,-122,41,156,197
21873,ElliotBayTrailMyrtlePark,06/30/2016 09:00:00 AM,48,-122,29,109,138
21874,ElliotBayTrailMyrtlePark,06/30/2016 10:00:00 AM,48,-122,35,49,84
21875,ElliotBayTrailMyrtlePark,06/30/2016 11:00:00 AM,48,-122,21,26,47
21876,ElliotBayTrailMyrtlePark,06/30/2016 12:00:00 PM,48,-122,23,34,57
21877,ElliotBayTrailMyrtlePark,06/30/2016 01:00:00 PM,48,-122,27,29,56
21878,ElliotBayTrailMyrtlePark,06/30/2016 02:00:00 PM,48,-122,33,43,76
21879,ElliotBayTrailMyrtlePark,06/30/2016 03:00:00 PM,48,-122,29,32,61
21880,ElliotBayTrailMyrtlePark,06/30/2016 04:00:00 PM,48,-122,103,66,169
21881,ElliotBayTrailMyrtlePark,06/30/2016 05:00:00 PM,48,-122,177,70,247
21882,ElliotBayTrailMyrtlePark,06/30/2016 06:00:00 PM,48,-122,202,78,280
21883,ElliotBayTrailMyrtlePark,06/30/2016 07:00:00 PM,48,-122,84,45,129
21884,ElliotBayTrailMyrtlePark,06/30/2016 08:00:00 PM,48,-122,55,43,98
21885,ElliotBayTrailMyrtlePark,06/30/2016 09:00:00 PM,48,-122,23,19,42
21886,ElliotBayTrailMyrtlePark,06/30/2016 10:00:00 PM,48,-122,19,8,27
21887,ElliotBayTrailMyrtlePark,06/30/2016 11:00:00 PM,48,-122,3,1,4
21888,ElliotBayTrailMyrtlePark,07/01/2016 12:00:00 AM,48,-122,5,5,10
21889,ElliotBayTrailMyrtlePark,07/01/2016 01:00:00 AM,48,-122,2,1,3
21890,ElliotBayTrailMyrtlePark,07/01/2016 02:00:00 AM,48,-122,0,0,0
21891,ElliotBayTrailMyrtlePark,07/01/2016 03:00:00 AM,48,-122,1,0,1
21892,ElliotBayTrailMyrtlePark,07/01/2016 04:00:00 AM,48,-122,0,0,0
21893,ElliotBayTrailMyrtlePark,07/01/2016 05:00:00 AM,48,-122,4,4,8
21894,ElliotBayTrailMyrtlePark,07/01/2016 06:00:00 AM,48,-122,21,25,46
21895,ElliotBayTrailMyrtlePark,07/01/2016 07:00:00 AM,48,-122,29,42,71
21896,ElliotBayTrailMyrtlePark,07/01/2016 08:00:00 AM,48,-122,43,138,181
21897,ElliotBayTrailMyrtlePark,07/01/2016 09:00:00 AM,48,-122,39,106,145
21898,ElliotBayTrailMyrtlePark,07/01/2016 10:00:00 AM,48,-122,21,39,60
21899,ElliotBayTrailMyrtlePark,07/01/2016 11:00:00 AM,48,-122,23,23,46
21900,ElliotBayTrailMyrtlePark,07/01/2016 12:00:00 PM,48,-122,25,40,65
21901,ElliotBayTrailMyrtlePark,07/01/2016 01:00:00 PM,48,-122,29,20,49
21902,ElliotBayTrailMyrtlePark,07/01/2016 02:00:00 PM,48,-122,56,30,86
21903,ElliotBayTrailMyrtlePark,07/01/2016 03:00:00 PM,48,-122,62,54,116
21904,ElliotBayTrailMyrtlePark,07/01/2016 04:00:00 PM,48,-122,112,63,175
21905,ElliotBayTrailMyrtlePark,07/01/2016 05:00:00 PM,48,-122,139,62,201
21906,ElliotBayTrailMyrtlePark,07/01/2016 06:00:00 PM,48,-122,98,44,142
21907,ElliotBayTrailMyrtlePark,07/01/2016 07:00:00 PM,48,-122,51,22,73
21908,ElliotBayTrailMyrtlePark,07/01/2016 08:00:00 PM,48,-122,44,22,66
21909,ElliotBayTrailMyrtlePark,07/01/2016 09:00:00 PM,48,-122,6,16,22
21910,ElliotBayTrailMyrtlePark,07/01/2016 10:00:00 PM,48,-122,12,9,21
21911,ElliotBayTrailMyrtlePark,07/01/2016 11:00:00 PM,48,-122,19,5,24
21912,ElliotBayTrailMyrtlePark,07/02/2016 12:00:00 AM,48,-122,4,2,6
21913,ElliotBayTrailMyrtlePark,07/02/2016 01:00:00 AM,48,-122,2,1,3
21914,ElliotBayTrailMyrtlePark,07/02/2016 02:00:00 AM,48,-122,1,1,2
21915,ElliotBayTrailMyrtlePark,07/02/2016 03:00:00 AM,48,-122,3,0,3
21916,ElliotBayTrailMyrtlePark,07/02/2016 04:00:00 AM,48,-122,1,0,1
21917,ElliotBayTrailMyrtlePark,07/02/2016 05:00:00 AM,48,-122,0,2,2
21918,ElliotBayTrailMyrtlePark,07/02/2016 06:00:00 AM,48,-122,5,4,9
21919,ElliotBayTrailMyrtlePark,07/02/2016 07:00:00 AM,48,-122,5,10,15
21920,ElliotBayTrailMyrtlePark,07/02/2016 08:00:00 AM,48,-122,12,17,29
21921,ElliotBayTrailMyrtlePark,07/02/2016 09:00:00 AM,48,-122,21,24,45
21922,ElliotBayTrailMyrtlePark,07/02/2016 10:00:00 AM,48,-122,43,43,86
21923,ElliotBayTrailMyrtlePark,07/02/2016 11:00:00 AM,48,-122,49,45,94
21924,ElliotBayTrailMyrtlePark,07/02/2016 12:00:00 PM,48,-122,57,72,129
21925,ElliotBayTrailMyrtlePark,07/02/2016 01:00:00 PM,48,-122,63,61,124
21926,ElliotBayTrailMyrtlePark,07/02/2016 02:00:00 PM,48,-122,72,53,125
21927,ElliotBayTrailMyrtlePark,07/02/2016 03:00:00 PM,48,-122,50,49,99
21928,ElliotBayTrailMyrtlePark,07/02/2016 04:00:00 PM,48,-122,83,87,170
21929,ElliotBayTrailMyrtlePark,07/02/2016 05:00:00 PM,48,-122,70,59,129
21930,ElliotBayTrailMyrtlePark,07/02/2016 06:00:00 PM,48,-122,57,47,104
21931,ElliotBayTrailMyrtlePark,07/02/2016 07:00:00 PM,48,-122,53,32,85
21932,ElliotBayTrailMyrtlePark,07/02/2016 08:00:00 PM,48,-122,35,35,70
21933,ElliotBayTrailMyrtlePark,07/02/2016 09:00:00 PM,48,-122,14,17,31
21934,ElliotBayTrailMyrtlePark,07/02/2016 10:00:00 PM,48,-122,7,13,20
21935,ElliotBayTrailMyrtlePark,07/02/2016 11:00:00 PM,48,-122,6,2,8
21936,ElliotBayTrailMyrtlePark,07/03/2016 12:00:00 AM,48,-122,2,1,3
21937,ElliotBayTrailMyrtlePark,07/03/2016 01:00:00 AM,48,-122,1,0,1
21938,ElliotBayTrailMyrtlePark,07/03/2016 02:00:00 AM,48,-122,0,1,1
21939,ElliotBayTrailMyrtlePark,07/03/2016 03:00:00 AM,48,-122,2,0,2
21940,ElliotBayTrailMyrtlePark,07/03/2016 04:00:00 AM,48,-122,1,0,1
21941,ElliotBayTrailMyrtlePark,07/03/2016 05:00:00 AM,48,-122,1,0,1
21942,ElliotBayTrailMyrtlePark,07/03/2016 06:00:00 AM,48,-122,5,4,9
21943,ElliotBayTrailMyrtlePark,07/03/2016 07:00:00 AM,48,-122,3,2,5
21944,ElliotBayTrailMyrtlePark,07/03/2016 08:00:00 AM,48,-122,12,14,26
21945,ElliotBayTrailMyrtlePark,07/03/2016 09:00:00 AM,48,-122,16,20,36
21946,ElliotBayTrailMyrtlePark,07/03/2016 10:00:00 AM,48,-122,19,27,46
21947,ElliotBayTrailMyrtlePark,07/03/2016 11:00:00 AM,48,-122,56,31,87
21948,ElliotBayTrailMyrtlePark,07/03/2016 12:00:00 PM,48,-122,34,44,78
21949,ElliotBayTrailMyrtlePark,07/03/2016 01:00:00 PM,48,-122,44,46,90
21950,ElliotBayTrailMyrtlePark,07/03/2016 02:00:00 PM,48,-122,70,43,113
21951,ElliotBayTrailMyrtlePark,07/03/2016 03:00:00 PM,48,-122,77,87,164
21952,ElliotBayTrailMyrtlePark,07/03/2016 04:00:00 PM,48,-122,49,65,114
21953,ElliotBayTrailMyrtlePark,07/03/2016 05:00:00 PM,48,-122,100,66,166
21954,ElliotBayTrailMyrtlePark,07/03/2016 06:00:00 PM,48,-122,54,40,94
21955,ElliotBayTrailMyrtlePark,07/03/2016 07:00:00 PM,48,-122,26,31,57
21956,ElliotBayTrailMyrtlePark,07/03/2016 08:00:00 PM,48,-122,17,23,40
21957,ElliotBayTrailMyrtlePark,07/03/2016 09:00:00 PM,48,-122,11,15,26
21958,ElliotBayTrailMyrtlePark,07/03/2016 10:00:00 PM,48,-122,9,13,22
21959,ElliotBayTrailMyrtlePark,07/03/2016 11:00:00 PM,48,-122,1,3,4
21960,ElliotBayTrailMyrtlePark,07/04/2016 12:00:00 AM,48,-122,2,1,3
21961,ElliotBayTrailMyrtlePark,07/04/2016 01:00:00 AM,48,-122,3,0,3
21962,ElliotBayTrailMyrtlePark,07/04/2016 02:00:00 AM,48,-122,0,1,1
21963,ElliotBayTrailMyrtlePark,07/04/2016 03:00:00 AM,48,-122,2,0,2
21964,ElliotBayTrailMyrtlePark,07/04/2016 04:00:00 AM,48,-122,0,1,1
21965,ElliotBayTrailMyrtlePark,07/04/2016 05:00:00 AM,48,-122,0,1,1
21966,ElliotBayTrailMyrtlePark,07/04/2016 06:00:00 AM,48,-122,2,3,5
21967,ElliotBayTrailMyrtlePark,07/04/2016 07:00:00 AM,48,-122,2,2,4
21968,ElliotBayTrailMyrtlePark,07/04/2016 08:00:00 AM,48,-122,7,11,18
21969,ElliotBayTrailMyrtlePark,07/04/2016 09:00:00 AM,48,-122,16,14,30
21970,ElliotBayTrailMyrtlePark,07/04/2016 10:00:00 AM,48,-122,34,48,82
21971,ElliotBayTrailMyrtlePark,07/04/2016 11:00:00 AM,48,-122,38,40,78
21972,ElliotBayTrailMyrtlePark,07/04/2016 12:00:00 PM,48,-122,66,69,135
21973,ElliotBayTrailMyrtlePark,07/04/2016 01:00:00 PM,48,-122,80,69,149
21974,ElliotBayTrailMyrtlePark,07/04/2016 02:00:00 PM,48,-122,55,50,105
21975,ElliotBayTrailMyrtlePark,07/04/2016 03:00:00 PM,48,-122,72,62,134
21976,ElliotBayTrailMyrtlePark,07/04/2016 04:00:00 PM,48,-122,68,37,105
21977,ElliotBayTrailMyrtlePark,07/04/2016 05:00:00 PM,48,-122,41,36,77
21978,ElliotBayTrailMyrtlePark,07/04/2016 06:00:00 PM,48,-122,27,26,53
21979,ElliotBayTrailMyrtlePark,07/04/2016 07:00:00 PM,48,-122,21,9,30
21980,ElliotBayTrailMyrtlePark,07/04/2016 08:00:00 PM,48,-122,17,11,28
21981,ElliotBayTrailMyrtlePark,07/04/2016 09:00:00 PM,48,-122,4,4,8
21982,ElliotBayTrailMyrtlePark,07/04/2016 10:00:00 PM,48,-122,2,2,4
21983,ElliotBayTrailMyrtlePark,07/04/2016 11:00:00 PM,48,-122,7,3,10
21984,ElliotBayTrailMyrtlePark,07/05/2016 12:00:00 AM,48,-122,2,5,7
21985,ElliotBayTrailMyrtlePark,07/05/2016 01:00:00 AM,48,-122,1,2,3
21986,ElliotBayTrailMyrtlePark,07/05/2016 02:00:00 AM,48,-122,0,0,0
21987,ElliotBayTrailMyrtlePark,07/05/2016 03:00:00 AM,48,-122,0,0,0
21988,ElliotBayTrailMyrtlePark,07/05/2016 04:00:00 AM,48,-122,1,1,2
21989,ElliotBayTrailMyrtlePark,07/05/2016 05:00:00 AM,48,-122,2,0,2
21990,ElliotBayTrailMyrtlePark,07/05/2016 06:00:00 AM,48,-122,12,25,37
21991,ElliotBayTrailMyrtlePark,07/05/2016 07:00:00 AM,48,-122,18,42,60
21992,ElliotBayTrailMyrtlePark,07/05/2016 08:00:00 AM,48,-122,32,113,145
21993,ElliotBayTrailMyrtlePark,07/05/2016 09:00:00 AM,48,-122,34,98,132
21994,ElliotBayTrailMyrtlePark,07/05/2016 10:00:00 AM,48,-122,24,30,54
21995,ElliotBayTrailMyrtlePark,07/05/2016 11:00:00 AM,48,-122,12,15,27
21996,ElliotBayTrailMyrtlePark,07/05/2016 12:00:00 PM,48,-122,14,19,33
21997,ElliotBayTrailMyrtlePark,07/05/2016 01:00:00 PM,48,-122,16,17,33
21998,ElliotBayTrailMyrtlePark,07/05/2016 02:00:00 PM,48,-122,22,16,38
21999,ElliotBayTrailMyrtlePark,07/05/2016 03:00:00 PM,48,-122,29,23,52
22000,ElliotBayTrailMyrtlePark,07/05/2016 04:00:00 PM,48,-122,51,34,85
22001,ElliotBayTrailMyrtlePark,07/05/2016 05:00:00 PM,48,-122,112,51,163
22002,ElliotBayTrailMyrtlePark,07/05/2016 06:00:00 PM,48,-122,143,40,183
22003,ElliotBayTrailMyrtlePark,07/05/2016 07:00:00 PM,48,-122,65,44,109
22004,ElliotBayTrailMyrtlePark,07/05/2016 08:00:00 PM,48,-122,18,14,32
22005,ElliotBayTrailMyrtlePark,07/05/2016 09:00:00 PM,48,-122,11,9,20
22006,ElliotBayTrailMyrtlePark,07/05/2016 10:00:00 PM,48,-122,25,8,33
22007,ElliotBayTrailMyrtlePark,07/05/2016 11:00:00 PM,48,-122,6,3,9
22008,ElliotBayTrailMyrtlePark,07/06/2016 12:00:00 AM,48,-122,1,4,5
22009,ElliotBayTrailMyrtlePark,07/06/2016 01:00:00 AM,48,-122,1,1,2
22010,ElliotBayTrailMyrtlePark,07/06/2016 02:00:00 AM,48,-122,1,0,1
22011,ElliotBayTrailMyrtlePark,07/06/2016 03:00:00 AM,48,-122,4,0,4
22012,ElliotBayTrailMyrtlePark,07/06/2016 04:00:00 AM,48,-122,0,0,0
22013,ElliotBayTrailMyrtlePark,07/06/2016 05:00:00 AM,48,-122,5,3,8
22014,ElliotBayTrailMyrtlePark,07/06/2016 06:00:00 AM,48,-122,18,33,51
22015,ElliotBayTrailMyrtlePark,07/06/2016 07:00:00 AM,48,-122,33,76,109
22016,ElliotBayTrailMyrtlePark,07/06/2016 08:00:00 AM,48,-122,56,204,260
22017,ElliotBayTrailMyrtlePark,07/06/2016 09:00:00 AM,48,-122,54,131,185
22018,ElliotBayTrailMyrtlePark,07/06/2016 10:00:00 AM,48,-122,27,41,68
22019,ElliotBayTrailMyrtlePark,07/06/2016 11:00:00 AM,48,-122,25,30,55
22020,ElliotBayTrailMyrtlePark,07/06/2016 12:00:00 PM,48,-122,29,25,54
22021,ElliotBayTrailMyrtlePark,07/06/2016 01:00:00 PM,48,-122,30,46,76
22022,ElliotBayTrailMyrtlePark,07/06/2016 02:00:00 PM,48,-122,34,32,66
22023,ElliotBayTrailMyrtlePark,07/06/2016 03:00:00 PM,48,-122,52,37,89
22024,ElliotBayTrailMyrtlePark,07/06/2016 04:00:00 PM,48,-122,76,54,130
22025,ElliotBayTrailMyrtlePark,07/06/2016 05:00:00 PM,48,-122,239,111,350
22026,ElliotBayTrailMyrtlePark,07/06/2016 06:00:00 PM,48,-122,225,74,299
22027,ElliotBayTrailMyrtlePark,07/06/2016 07:00:00 PM,48,-122,122,64,186
22028,ElliotBayTrailMyrtlePark,07/06/2016 08:00:00 PM,48,-122,75,49,124
22029,ElliotBayTrailMyrtlePark,07/06/2016 09:00:00 PM,48,-122,12,22,34
22030,ElliotBayTrailMyrtlePark,07/06/2016 10:00:00 PM,48,-122,11,11,22
22031,ElliotBayTrailMyrtlePark,07/06/2016 11:00:00 PM,48,-122,6,4,10
22032,ElliotBayTrailMyrtlePark,07/07/2016 12:00:00 AM,48,-122,1,2,3
22033,ElliotBayTrailMyrtlePark,07/07/2016 01:00:00 AM,48,-122,1,0,1
22034,ElliotBayTrailMyrtlePark,07/07/2016 02:00:00 AM,48,-122,0,0,0
22035,ElliotBayTrailMyrtlePark,07/07/2016 03:00:00 AM,48,-122,0,0,0
22036,ElliotBayTrailMyrtlePark,07/07/2016 04:00:00 AM,48,-122,1,0,1
22037,ElliotBayTrailMyrtlePark,07/07/2016 05:00:00 AM,48,-122,4,1,5
22038,ElliotBayTrailMyrtlePark,07/07/2016 06:00:00 AM,48,-122,12,27,39
22039,ElliotBayTrailMyrtlePark,07/07/2016 07:00:00 AM,48,-122,33,53,86
22040,ElliotBayTrailMyrtlePark,07/07/2016 08:00:00 AM,48,-122,33,118,151
22041,ElliotBayTrailMyrtlePark,07/07/2016 09:00:00 AM,48,-122,46,96,142
22042,ElliotBayTrailMyrtlePark,07/07/2016 10:00:00 AM,48,-122,29,35,64
22043,ElliotBayTrailMyrtlePark,07/07/2016 11:00:00 AM,48,-122,17,19,36
22044,ElliotBayTrailMyrtlePark,07/07/2016 12:00:00 PM,48,-122,17,17,34
22045,ElliotBayTrailMyrtlePark,07/07/2016 01:00:00 PM,48,-122,18,17,35
22046,ElliotBayTrailMyrtlePark,07/07/2016 02:00:00 PM,48,-122,17,13,30
22047,ElliotBayTrailMyrtlePark,07/07/2016 03:00:00 PM,48,-122,30,25,55
22048,ElliotBayTrailMyrtlePark,07/07/2016 04:00:00 PM,48,-122,49,36,85
22049,ElliotBayTrailMyrtlePark,07/07/2016 05:00:00 PM,48,-122,119,58,177
22050,ElliotBayTrailMyrtlePark,07/07/2016 06:00:00 PM,48,-122,133,50,183
22051,ElliotBayTrailMyrtlePark,07/07/2016 07:00:00 PM,48,-122,37,13,50
22052,ElliotBayTrailMyrtlePark,07/07/2016 08:00:00 PM,48,-122,28,6,34
22053,ElliotBayTrailMyrtlePark,07/07/2016 09:00:00 PM,48,-122,7,8,15
22054,ElliotBayTrailMyrtlePark,07/07/2016 10:00:00 PM,48,-122,13,2,15
22055,ElliotBayTrailMyrtlePark,07/07/2016 11:00:00 PM,48,-122,5,0,5
22056,ElliotBayTrailMyrtlePark,07/08/2016 12:00:00 AM,48,-122,1,1,2
22057,ElliotBayTrailMyrtlePark,07/08/2016 01:00:00 AM,48,-122,0,6,6
22058,ElliotBayTrailMyrtlePark,07/08/2016 02:00:00 AM,48,-122,0,0,0
22059,ElliotBayTrailMyrtlePark,07/08/2016 03:00:00 AM,48,-122,0,0,0
22060,ElliotBayTrailMyrtlePark,07/08/2016 04:00:00 AM,48,-122,1,0,1
22061,ElliotBayTrailMyrtlePark,07/08/2016 05:00:00 AM,48,-122,3,3,6
22062,ElliotBayTrailMyrtlePark,07/08/2016 06:00:00 AM,48,-122,10,15,25
22063,ElliotBayTrailMyrtlePark,07/08/2016 07:00:00 AM,48,-122,21,35,56
22064,ElliotBayTrailMyrtlePark,07/08/2016 08:00:00 AM,48,-122,33,106,139
22065,ElliotBayTrailMyrtlePark,07/08/2016 09:00:00 AM,48,-122,28,73,101
22066,ElliotBayTrailMyrtlePark,07/08/2016 10:00:00 AM,48,-122,22,24,46
22067,ElliotBayTrailMyrtlePark,07/08/2016 11:00:00 AM,48,-122,19,12,31
22068,ElliotBayTrailMyrtlePark,07/08/2016 12:00:00 PM,48,-122,31,19,50
22069,ElliotBayTrailMyrtlePark,07/08/2016 01:00:00 PM,48,-122,18,29,47
22070,ElliotBayTrailMyrtlePark,07/08/2016 02:00:00 PM,48,-122,33,20,53
22071,ElliotBayTrailMyrtlePark,07/08/2016 03:00:00 PM,48,-122,31,31,62
22072,ElliotBayTrailMyrtlePark,07/08/2016 04:00:00 PM,48,-122,62,56,118
22073,ElliotBayTrailMyrtlePark,07/08/2016 05:00:00 PM,48,-122,126,51,177
22074,ElliotBayTrailMyrtlePark,07/08/2016 06:00:00 PM,48,-122,121,52,173
22075,ElliotBayTrailMyrtlePark,07/08/2016 07:00:00 PM,48,-122,74,40,114
22076,ElliotBayTrailMyrtlePark,07/08/2016 08:00:00 PM,48,-122,28,20,48
22077,ElliotBayTrailMyrtlePark,07/08/2016 09:00:00 PM,48,-122,12,12,24
22078,ElliotBayTrailMyrtlePark,07/08/2016 10:00:00 PM,48,-122,9,9,18
22079,ElliotBayTrailMyrtlePark,07/08/2016 11:00:00 PM,48,-122,7,6,13
22080,ElliotBayTrailMyrtlePark,07/09/2016 12:00:00 AM,48,-122,0,1,1
22081,ElliotBayTrailMyrtlePark,07/09/2016 01:00:00 AM,48,-122,1,1,2
22082,ElliotBayTrailMyrtlePark,07/09/2016 02:00:00 AM,48,-122,0,0,0
22083,ElliotBayTrailMyrtlePark,07/09/2016 03:00:00 AM,48,-122,1,0,1
22084,ElliotBayTrailMyrtlePark,07/09/2016 04:00:00 AM,48,-122,0,0,0
22085,ElliotBayTrailMyrtlePark,07/09/2016 05:00:00 AM,48,-122,0,0,0
22086,ElliotBayTrailMyrtlePark,07/09/2016 06:00:00 AM,48,-122,4,6,10
22087,ElliotBayTrailMyrtlePark,07/09/2016 07:00:00 AM,48,-122,6,7,13
22088,ElliotBayTrailMyrtlePark,07/09/2016 08:00:00 AM,48,-122,20,21,41
22089,ElliotBayTrailMyrtlePark,07/09/2016 09:00:00 AM,48,-122,20,31,51
22090,ElliotBayTrailMyrtlePark,07/09/2016 10:00:00 AM,48,-122,47,46,93
22091,ElliotBayTrailMyrtlePark,07/09/2016 11:00:00 AM,48,-122,28,101,129
22092,ElliotBayTrailMyrtlePark,07/09/2016 12:00:00 PM,48,-122,53,73,126
22093,ElliotBayTrailMyrtlePark,07/09/2016 01:00:00 PM,48,-122,54,49,103
22094,ElliotBayTrailMyrtlePark,07/09/2016 02:00:00 PM,48,-122,56,37,93
22095,ElliotBayTrailMyrtlePark,07/09/2016 03:00:00 PM,48,-122,118,39,157
22096,ElliotBayTrailMyrtlePark,07/09/2016 04:00:00 PM,48,-122,69,46,115
22097,ElliotBayTrailMyrtlePark,07/09/2016 05:00:00 PM,48,-122,43,33,76
22098,ElliotBayTrailMyrtlePark,07/09/2016 06:00:00 PM,48,-122,28,27,55
22099,ElliotBayTrailMyrtlePark,07/09/2016 07:00:00 PM,48,-122,9,10,19
22100,ElliotBayTrailMyrtlePark,07/09/2016 08:00:00 PM,48,-122,19,8,27
22101,ElliotBayTrailMyrtlePark,07/09/2016 09:00:00 PM,48,-122,6,4,10
22102,ElliotBayTrailMyrtlePark,07/09/2016 10:00:00 PM,48,-122,8,7,15
22103,ElliotBayTrailMyrtlePark,07/09/2016 11:00:00 PM,48,-122,5,1,6
22104,ElliotBayTrailMyrtlePark,07/10/2016 12:00:00 AM,48,-122,8,1,9
22105,ElliotBayTrailMyrtlePark,07/10/2016 01:00:00 AM,48,-122,0,1,1
22106,ElliotBayTrailMyrtlePark,07/10/2016 02:00:00 AM,48,-122,2,1,3
22107,ElliotBayTrailMyrtlePark,07/10/2016 03:00:00 AM,48,-122,1,0,1
22108,ElliotBayTrailMyrtlePark,07/10/2016 04:00:00 AM,48,-122,1,0,1
22109,ElliotBayTrailMyrtlePark,07/10/2016 05:00:00 AM,48,-122,0,0,0
22110,ElliotBayTrailMyrtlePark,07/10/2016 06:00:00 AM,48,-122,4,8,12
22111,ElliotBayTrailMyrtlePark,07/10/2016 07:00:00 AM,48,-122,6,5,11
22112,ElliotBayTrailMyrtlePark,07/10/2016 08:00:00 AM,48,-122,16,26,42
22113,ElliotBayTrailMyrtlePark,07/10/2016 09:00:00 AM,48,-122,22,23,45
22114,ElliotBayTrailMyrtlePark,07/10/2016 10:00:00 AM,48,-122,44,44,88
22115,ElliotBayTrailMyrtlePark,07/10/2016 11:00:00 AM,48,-122,42,54,96
22116,ElliotBayTrailMyrtlePark,07/10/2016 12:00:00 PM,48,-122,45,52,97
22117,ElliotBayTrailMyrtlePark,07/10/2016 01:00:00 PM,48,-122,73,45,118
22118,ElliotBayTrailMyrtlePark,07/10/2016 02:00:00 PM,48,-122,61,51,112
22119,ElliotBayTrailMyrtlePark,07/10/2016 03:00:00 PM,48,-122,99,80,179
22120,ElliotBayTrailMyrtlePark,07/10/2016 04:00:00 PM,48,-122,85,74,159
22121,ElliotBayTrailMyrtlePark,07/10/2016 05:00:00 PM,48,-122,79,76,155
22122,ElliotBayTrailMyrtlePark,07/10/2016 06:00:00 PM,48,-122,46,28,74
22123,ElliotBayTrailMyrtlePark,07/10/2016 07:00:00 PM,48,-122,22,28,50
22124,ElliotBayTrailMyrtlePark,07/10/2016 08:00:00 PM,48,-122,34,27,61
22125,ElliotBayTrailMyrtlePark,07/10/2016 09:00:00 PM,48,-122,13,17,30
22126,ElliotBayTrailMyrtlePark,07/10/2016 10:00:00 PM,48,-122,6,5,11
22127,ElliotBayTrailMyrtlePark,07/10/2016 11:00:00 PM,48,-122,7,2,9
22128,ElliotBayTrailMyrtlePark,07/11/2016 12:00:00 AM,48,-122,2,3,5
22129,ElliotBayTrailMyrtlePark,07/11/2016 01:00:00 AM,48,-122,0,0,0
22130,ElliotBayTrailMyrtlePark,07/11/2016 02:00:00 AM,48,-122,0,0,0
22131,ElliotBayTrailMyrtlePark,07/11/2016 03:00:00 AM,48,-122,1,1,2
22132,ElliotBayTrailMyrtlePark,07/11/2016 04:00:00 AM,48,-122,2,0,2
22133,ElliotBayTrailMyrtlePark,07/11/2016 05:00:00 AM,48,-122,3,2,5
22134,ElliotBayTrailMyrtlePark,07/11/2016 06:00:00 AM,48,-122,19,22,41
22135,ElliotBayTrailMyrtlePark,07/11/2016 07:00:00 AM,48,-122,25,73,98
22136,ElliotBayTrailMyrtlePark,07/11/2016 08:00:00 AM,48,-122,44,143,187
22137,ElliotBayTrailMyrtlePark,07/11/2016 09:00:00 AM,48,-122,33,102,135
22138,ElliotBayTrailMyrtlePark,07/11/2016 10:00:00 AM,48,-122,24,39,63
22139,ElliotBayTrailMyrtlePark,07/11/2016 11:00:00 AM,48,-122,20,20,40
22140,ElliotBayTrailMyrtlePark,07/11/2016 12:00:00 PM,48,-122,16,17,33
22141,ElliotBayTrailMyrtlePark,07/11/2016 01:00:00 PM,48,-122,27,25,52
22142,ElliotBayTrailMyrtlePark,07/11/2016 02:00:00 PM,48,-122,31,21,52
22143,ElliotBayTrailMyrtlePark,07/11/2016 03:00:00 PM,48,-122,42,38,80
22144,ElliotBayTrailMyrtlePark,07/11/2016 04:00:00 PM,48,-122,72,59,131
22145,ElliotBayTrailMyrtlePark,07/11/2016 05:00:00 PM,48,-122,179,88,267
22146,ElliotBayTrailMyrtlePark,07/11/2016 06:00:00 PM,48,-122,212,67,279
22147,ElliotBayTrailMyrtlePark,07/11/2016 07:00:00 PM,48,-122,92,59,151
22148,ElliotBayTrailMyrtlePark,07/11/2016 08:00:00 PM,48,-122,47,34,81
22149,ElliotBayTrailMyrtlePark,07/11/2016 09:00:00 PM,48,-122,21,22,43
22150,ElliotBayTrailMyrtlePark,07/11/2016 10:00:00 PM,48,-122,14,13,27
22151,ElliotBayTrailMyrtlePark,07/11/2016 11:00:00 PM,48,-122,4,5,9
22152,ElliotBayTrailMyrtlePark,07/12/2016 12:00:00 AM,48,-122,4,0,4
22153,ElliotBayTrailMyrtlePark,07/12/2016 01:00:00 AM,48,-122,0,0,0
22154,ElliotBayTrailMyrtlePark,07/12/2016 02:00:00 AM,48,-122,3,0,3
22155,ElliotBayTrailMyrtlePark,07/12/2016 03:00:00 AM,48,-122,3,0,3
22156,ElliotBayTrailMyrtlePark,07/12/2016 04:00:00 AM,48,-122,0,1,1
22157,ElliotBayTrailMyrtlePark,07/12/2016 05:00:00 AM,48,-122,6,1,7
22158,ElliotBayTrailMyrtlePark,07/12/2016 06:00:00 AM,48,-122,15,32,47
22159,ElliotBayTrailMyrtlePark,07/12/2016 07:00:00 AM,48,-122,27,61,88
22160,ElliotBayTrailMyrtlePark,07/12/2016 08:00:00 AM,48,-122,52,166,218
22161,ElliotBayTrailMyrtlePark,07/12/2016 09:00:00 AM,48,-122,39,116,155
22162,ElliotBayTrailMyrtlePark,07/12/2016 10:00:00 AM,48,-122,27,55,82
22163,ElliotBayTrailMyrtlePark,07/12/2016 11:00:00 AM,48,-122,29,33,62
22164,ElliotBayTrailMyrtlePark,07/12/2016 12:00:00 PM,48,-122,25,28,53
22165,ElliotBayTrailMyrtlePark,07/12/2016 01:00:00 PM,48,-122,27,29,56
22166,ElliotBayTrailMyrtlePark,07/12/2016 02:00:00 PM,48,-122,30,28,58
22167,ElliotBayTrailMyrtlePark,07/12/2016 03:00:00 PM,48,-122,33,49,82
22168,ElliotBayTrailMyrtlePark,07/12/2016 04:00:00 PM,48,-122,83,43,126
22169,ElliotBayTrailMyrtlePark,07/12/2016 05:00:00 PM,48,-122,186,84,270
22170,ElliotBayTrailMyrtlePark,07/12/2016 06:00:00 PM,48,-122,177,92,269
22171,ElliotBayTrailMyrtlePark,07/12/2016 07:00:00 PM,48,-122,88,48,136
22172,ElliotBayTrailMyrtlePark,07/12/2016 08:00:00 PM,48,-122,56,46,102
22173,ElliotBayTrailMyrtlePark,07/12/2016 09:00:00 PM,48,-122,20,28,48
22174,ElliotBayTrailMyrtlePark,07/12/2016 10:00:00 PM,48,-122,10,14,24
22175,ElliotBayTrailMyrtlePark,07/12/2016 11:00:00 PM,48,-122,8,2,10
22176,ElliotBayTrailMyrtlePark,07/13/2016 12:00:00 AM,48,-122,5,3,8
22177,ElliotBayTrailMyrtlePark,07/13/2016 01:00:00 AM,48,-122,1,0,1
22178,ElliotBayTrailMyrtlePark,07/13/2016 02:00:00 AM,48,-122,2,0,2
22179,ElliotBayTrailMyrtlePark,07/13/2016 03:00:00 AM,48,-122,1,0,1
22180,ElliotBayTrailMyrtlePark,07/13/2016 04:00:00 AM,48,-122,0,0,0
22181,ElliotBayTrailMyrtlePark,07/13/2016 05:00:00 AM,48,-122,5,2,7
22182,ElliotBayTrailMyrtlePark,07/13/2016 06:00:00 AM,48,-122,18,31,49
22183,ElliotBayTrailMyrtlePark,07/13/2016 07:00:00 AM,48,-122,36,75,111
22184,ElliotBayTrailMyrtlePark,07/13/2016 08:00:00 AM,48,-122,41,184,225
22185,ElliotBayTrailMyrtlePark,07/13/2016 09:00:00 AM,48,-122,38,134,172
22186,ElliotBayTrailMyrtlePark,07/13/2016 10:00:00 AM,48,-122,34,36,70
22187,ElliotBayTrailMyrtlePark,07/13/2016 11:00:00 AM,48,-122,25,22,47
22188,ElliotBayTrailMyrtlePark,07/13/2016 12:00:00 PM,48,-122,26,33,59
22189,ElliotBayTrailMyrtlePark,07/13/2016 01:00:00 PM,48,-122,29,30,59
22190,ElliotBayTrailMyrtlePark,07/13/2016 02:00:00 PM,48,-122,31,36,67
22191,ElliotBayTrailMyrtlePark,07/13/2016 03:00:00 PM,48,-122,35,39,74
22192,ElliotBayTrailMyrtlePark,07/13/2016 04:00:00 PM,48,-122,79,55,134
22193,ElliotBayTrailMyrtlePark,07/13/2016 05:00:00 PM,48,-122,177,100,277
22194,ElliotBayTrailMyrtlePark,07/13/2016 06:00:00 PM,48,-122,204,76,280
22195,ElliotBayTrailMyrtlePark,07/13/2016 07:00:00 PM,48,-122,109,75,184
22196,ElliotBayTrailMyrtlePark,07/13/2016 08:00:00 PM,48,-122,48,43,91
22197,ElliotBayTrailMyrtlePark,07/13/2016 09:00:00 PM,48,-122,21,19,40
22198,ElliotBayTrailMyrtlePark,07/13/2016 10:00:00 PM,48,-122,40,8,48
22199,ElliotBayTrailMyrtlePark,07/13/2016 11:00:00 PM,48,-122,15,4,19
22200,ElliotBayTrailMyrtlePark,07/14/2016 12:00:00 AM,48,-122,4,1,5
22201,ElliotBayTrailMyrtlePark,07/14/2016 01:00:00 AM,48,-122,1,0,1
22202,ElliotBayTrailMyrtlePark,07/14/2016 02:00:00 AM,48,-122,0,0,0
22203,ElliotBayTrailMyrtlePark,07/14/2016 03:00:00 AM,48,-122,1,0,1
22204,ElliotBayTrailMyrtlePark,07/14/2016 04:00:00 AM,48,-122,1,0,1
22205,ElliotBayTrailMyrtlePark,07/14/2016 05:00:00 AM,48,-122,8,0,8
22206,ElliotBayTrailMyrtlePark,07/14/2016 06:00:00 AM,48,-122,14,24,38
22207,ElliotBayTrailMyrtlePark,07/14/2016 07:00:00 AM,48,-122,28,77,105
22208,ElliotBayTrailMyrtlePark,07/14/2016 08:00:00 AM,48,-122,52,155,207
22209,ElliotBayTrailMyrtlePark,07/14/2016 09:00:00 AM,48,-122,65,103,168
22210,ElliotBayTrailMyrtlePark,07/14/2016 10:00:00 AM,48,-122,25,60,85
22211,ElliotBayTrailMyrtlePark,07/14/2016 11:00:00 AM,48,-122,21,30,51
22212,ElliotBayTrailMyrtlePark,07/14/2016 12:00:00 PM,48,-122,30,39,69
22213,ElliotBayTrailMyrtlePark,07/14/2016 01:00:00 PM,48,-122,36,39,75
22214,ElliotBayTrailMyrtlePark,07/14/2016 02:00:00 PM,48,-122,39,39,78
22215,ElliotBayTrailMyrtlePark,07/14/2016 03:00:00 PM,48,-122,40,47,87
22216,ElliotBayTrailMyrtlePark,07/14/2016 04:00:00 PM,48,-122,76,75,151
22217,ElliotBayTrailMyrtlePark,07/14/2016 05:00:00 PM,48,-122,188,99,287
22218,ElliotBayTrailMyrtlePark,07/14/2016 06:00:00 PM,48,-122,222,75,297
22219,ElliotBayTrailMyrtlePark,07/14/2016 07:00:00 PM,48,-122,87,62,149
22220,ElliotBayTrailMyrtlePark,07/14/2016 08:00:00 PM,48,-122,60,34,94
22221,ElliotBayTrailMyrtlePark,07/14/2016 09:00:00 PM,48,-122,21,15,36
22222,ElliotBayTrailMyrtlePark,07/14/2016 10:00:00 PM,48,-122,10,6,16
22223,ElliotBayTrailMyrtlePark,07/14/2016 11:00:00 PM,48,-122,6,3,9
22224,ElliotBayTrailMyrtlePark,07/15/2016 12:00:00 AM,48,-122,5,1,6
22225,ElliotBayTrailMyrtlePark,07/15/2016 01:00:00 AM,48,-122,0,1,1
22226,ElliotBayTrailMyrtlePark,07/15/2016 02:00:00 AM,48,-122,1,2,3
22227,ElliotBayTrailMyrtlePark,07/15/2016 03:00:00 AM,48,-122,1,1,2
22228,ElliotBayTrailMyrtlePark,07/15/2016 04:00:00 AM,48,-122,1,0,1
22229,ElliotBayTrailMyrtlePark,07/15/2016 05:00:00 AM,48,-122,3,2,5
22230,ElliotBayTrailMyrtlePark,07/15/2016 06:00:00 AM,48,-122,17,23,40
22231,ElliotBayTrailMyrtlePark,07/15/2016 07:00:00 AM,48,-122,34,52,86
22232,ElliotBayTrailMyrtlePark,07/15/2016 08:00:00 AM,48,-122,34,155,189
22233,ElliotBayTrailMyrtlePark,07/15/2016 09:00:00 AM,48,-122,27,97,124
22234,ElliotBayTrailMyrtlePark,07/15/2016 10:00:00 AM,48,-122,28,34,62
22235,ElliotBayTrailMyrtlePark,07/15/2016 11:00:00 AM,48,-122,31,37,68
22236,ElliotBayTrailMyrtlePark,07/15/2016 12:00:00 PM,48,-122,36,43,79
22237,ElliotBayTrailMyrtlePark,07/15/2016 01:00:00 PM,48,-122,43,33,76
22238,ElliotBayTrailMyrtlePark,07/15/2016 02:00:00 PM,48,-122,34,31,65
22239,ElliotBayTrailMyrtlePark,07/15/2016 03:00:00 PM,48,-122,56,47,103
22240,ElliotBayTrailMyrtlePark,07/15/2016 04:00:00 PM,48,-122,88,61,149
22241,ElliotBayTrailMyrtlePark,07/15/2016 05:00:00 PM,48,-122,177,80,257
22242,ElliotBayTrailMyrtlePark,07/15/2016 06:00:00 PM,48,-122,148,54,202
22243,ElliotBayTrailMyrtlePark,07/15/2016 07:00:00 PM,48,-122,67,34,101
22244,ElliotBayTrailMyrtlePark,07/15/2016 08:00:00 PM,48,-122,35,30,65
22245,ElliotBayTrailMyrtlePark,07/15/2016 09:00:00 PM,48,-122,19,22,41
22246,ElliotBayTrailMyrtlePark,07/15/2016 10:00:00 PM,48,-122,16,20,36
22247,ElliotBayTrailMyrtlePark,07/15/2016 11:00:00 PM,48,-122,12,7,19
22248,ElliotBayTrailMyrtlePark,07/16/2016 12:00:00 AM,48,-122,10,1,11
22249,ElliotBayTrailMyrtlePark,07/16/2016 01:00:00 AM,48,-122,4,0,4
22250,ElliotBayTrailMyrtlePark,07/16/2016 02:00:00 AM,48,-122,1,0,1
22251,ElliotBayTrailMyrtlePark,07/16/2016 03:00:00 AM,48,-122,0,1,1
22252,ElliotBayTrailMyrtlePark,07/16/2016 04:00:00 AM,48,-122,1,0,1
22253,ElliotBayTrailMyrtlePark,07/16/2016 05:00:00 AM,48,-122,0,2,2
22254,ElliotBayTrailMyrtlePark,07/16/2016 06:00:00 AM,48,-122,5,12,17
22255,ElliotBayTrailMyrtlePark,07/16/2016 07:00:00 AM,48,-122,13,9,22
22256,ElliotBayTrailMyrtlePark,07/16/2016 08:00:00 AM,48,-122,27,18,45
22257,ElliotBayTrailMyrtlePark,07/16/2016 09:00:00 AM,48,-122,21,29,50
22258,ElliotBayTrailMyrtlePark,07/16/2016 10:00:00 AM,48,-122,37,26,63
22259,ElliotBayTrailMyrtlePark,07/16/2016 11:00:00 AM,48,-122,55,35,90
22260,ElliotBayTrailMyrtlePark,07/16/2016 12:00:00 PM,48,-122,58,58,116
22261,ElliotBayTrailMyrtlePark,07/16/2016 01:00:00 PM,48,-122,59,69,128
22262,ElliotBayTrailMyrtlePark,07/16/2016 02:00:00 PM,48,-122,45,39,84
22263,ElliotBayTrailMyrtlePark,07/16/2016 03:00:00 PM,48,-122,57,60,117
22264,ElliotBayTrailMyrtlePark,07/16/2016 04:00:00 PM,48,-122,62,60,122
22265,ElliotBayTrailMyrtlePark,07/16/2016 05:00:00 PM,48,-122,54,48,102
22266,ElliotBayTrailMyrtlePark,07/16/2016 06:00:00 PM,48,-122,54,52,106
22267,ElliotBayTrailMyrtlePark,07/16/2016 07:00:00 PM,48,-122,45,37,82
22268,ElliotBayTrailMyrtlePark,07/16/2016 08:00:00 PM,48,-122,30,17,47
22269,ElliotBayTrailMyrtlePark,07/16/2016 09:00:00 PM,48,-122,16,14,30
22270,ElliotBayTrailMyrtlePark,07/16/2016 10:00:00 PM,48,-122,11,8,19
22271,ElliotBayTrailMyrtlePark,07/16/2016 11:00:00 PM,48,-122,10,3,13
22272,ElliotBayTrailMyrtlePark,07/17/2016 12:00:00 AM,48,-122,2,3,5
22273,ElliotBayTrailMyrtlePark,07/17/2016 01:00:00 AM,48,-122,2,3,5
22274,ElliotBayTrailMyrtlePark,07/17/2016 02:00:00 AM,48,-122,0,0,0
22275,ElliotBayTrailMyrtlePark,07/17/2016 03:00:00 AM,48,-122,3,0,3
22276,ElliotBayTrailMyrtlePark,07/17/2016 04:00:00 AM,48,-122,0,1,1
22277,ElliotBayTrailMyrtlePark,07/17/2016 05:00:00 AM,48,-122,0,0,0
22278,ElliotBayTrailMyrtlePark,07/17/2016 06:00:00 AM,48,-122,2,2,4
22279,ElliotBayTrailMyrtlePark,07/17/2016 07:00:00 AM,48,-122,4,4,8
22280,ElliotBayTrailMyrtlePark,07/17/2016 08:00:00 AM,48,-122,17,14,31
22281,ElliotBayTrailMyrtlePark,07/17/2016 09:00:00 AM,48,-122,33,29,62
22282,ElliotBayTrailMyrtlePark,07/17/2016 10:00:00 AM,48,-122,45,30,75
22283,ElliotBayTrailMyrtlePark,07/17/2016 11:00:00 AM,48,-122,56,41,97
22284,ElliotBayTrailMyrtlePark,07/17/2016 12:00:00 PM,48,-122,86,93,179
22285,ElliotBayTrailMyrtlePark,07/17/2016 01:00:00 PM,48,-122,91,62,153
22286,ElliotBayTrailMyrtlePark,07/17/2016 02:00:00 PM,48,-122,89,83,172
22287,ElliotBayTrailMyrtlePark,07/17/2016 03:00:00 PM,48,-122,96,61,157
22288,ElliotBayTrailMyrtlePark,07/17/2016 04:00:00 PM,48,-122,72,82,154
22289,ElliotBayTrailMyrtlePark,07/17/2016 05:00:00 PM,48,-122,71,48,119
22290,ElliotBayTrailMyrtlePark,07/17/2016 06:00:00 PM,48,-122,62,57,119
22291,ElliotBayTrailMyrtlePark,07/17/2016 07:00:00 PM,48,-122,44,51,95
22292,ElliotBayTrailMyrtlePark,07/17/2016 08:00:00 PM,48,-122,34,26,60
22293,ElliotBayTrailMyrtlePark,07/17/2016 09:00:00 PM,48,-122,10,27,37
22294,ElliotBayTrailMyrtlePark,07/17/2016 10:00:00 PM,48,-122,6,8,14
22295,ElliotBayTrailMyrtlePark,07/17/2016 11:00:00 PM,48,-122,6,4,10
22296,ElliotBayTrailMyrtlePark,07/18/2016 12:00:00 AM,48,-122,1,0,1
22297,ElliotBayTrailMyrtlePark,07/18/2016 01:00:00 AM,48,-122,0,1,1
22298,ElliotBayTrailMyrtlePark,07/18/2016 02:00:00 AM,48,-122,1,0,1
22299,ElliotBayTrailMyrtlePark,07/18/2016 03:00:00 AM,48,-122,5,0,5
22300,ElliotBayTrailMyrtlePark,07/18/2016 04:00:00 AM,48,-122,0,0,0
22301,ElliotBayTrailMyrtlePark,07/18/2016 05:00:00 AM,48,-122,5,2,7
22302,ElliotBayTrailMyrtlePark,07/18/2016 06:00:00 AM,48,-122,17,22,39
22303,ElliotBayTrailMyrtlePark,07/18/2016 07:00:00 AM,48,-122,31,56,87
22304,ElliotBayTrailMyrtlePark,07/18/2016 08:00:00 AM,48,-122,50,174,224
22305,ElliotBayTrailMyrtlePark,07/18/2016 09:00:00 AM,48,-122,38,114,152
22306,ElliotBayTrailMyrtlePark,07/18/2016 10:00:00 AM,48,-122,24,53,77
22307,ElliotBayTrailMyrtlePark,07/18/2016 11:00:00 AM,48,-122,29,34,63
22308,ElliotBayTrailMyrtlePark,07/18/2016 12:00:00 PM,48,-122,14,35,49
22309,ElliotBayTrailMyrtlePark,07/18/2016 01:00:00 PM,48,-122,16,18,34
22310,ElliotBayTrailMyrtlePark,07/18/2016 02:00:00 PM,48,-122,24,34,58
22311,ElliotBayTrailMyrtlePark,07/18/2016 03:00:00 PM,48,-122,33,19,52
22312,ElliotBayTrailMyrtlePark,07/18/2016 04:00:00 PM,48,-122,47,45,92
22313,ElliotBayTrailMyrtlePark,07/18/2016 05:00:00 PM,48,-122,165,63,228
22314,ElliotBayTrailMyrtlePark,07/18/2016 06:00:00 PM,48,-122,201,41,242
22315,ElliotBayTrailMyrtlePark,07/18/2016 07:00:00 PM,48,-122,71,29,100
22316,ElliotBayTrailMyrtlePark,07/18/2016 08:00:00 PM,48,-122,40,34,74
22317,ElliotBayTrailMyrtlePark,07/18/2016 09:00:00 PM,48,-122,3,8,11
22318,ElliotBayTrailMyrtlePark,07/18/2016 10:00:00 PM,48,-122,4,3,7
22319,ElliotBayTrailMyrtlePark,07/18/2016 11:00:00 PM,48,-122,4,1,5
22320,ElliotBayTrailMyrtlePark,07/19/2016 12:00:00 AM,48,-122,0,0,0
22321,ElliotBayTrailMyrtlePark,07/19/2016 01:00:00 AM,48,-122,2,0,2
22322,ElliotBayTrailMyrtlePark,07/19/2016 02:00:00 AM,48,-122,2,0,2
22323,ElliotBayTrailMyrtlePark,07/19/2016 03:00:00 AM,48,-122,1,0,1
22324,ElliotBayTrailMyrtlePark,07/19/2016 04:00:00 AM,48,-122,2,1,3
22325,ElliotBayTrailMyrtlePark,07/19/2016 05:00:00 AM,48,-122,13,31,44
22326,ElliotBayTrailMyrtlePark,07/19/2016 06:00:00 AM,48,-122,38,65,103
22327,ElliotBayTrailMyrtlePark,07/19/2016 07:00:00 AM,48,-122,33,167,200
22328,ElliotBayTrailMyrtlePark,07/19/2016 08:00:00 AM,48,-122,61,120,181
22329,ElliotBayTrailMyrtlePark,07/19/2016 09:00:00 AM,48,-122,27,49,76
22330,ElliotBayTrailMyrtlePark,07/19/2016 10:00:00 AM,48,-122,39,36,75
22331,ElliotBayTrailMyrtlePark,07/19/2016 11:00:00 AM,48,-122,21,29,50
22332,ElliotBayTrailMyrtlePark,07/19/2016 12:00:00 PM,48,-122,28,32,60
22333,ElliotBayTrailMyrtlePark,07/19/2016 01:00:00 PM,48,-122,24,24,48
22334,ElliotBayTrailMyrtlePark,07/19/2016 02:00:00 PM,48,-122,35,32,67
22335,ElliotBayTrailMyrtlePark,07/19/2016 03:00:00 PM,48,-122,86,45,131
22336,ElliotBayTrailMyrtlePark,07/19/2016 04:00:00 PM,48,-122,190,89,279
22337,ElliotBayTrailMyrtlePark,07/19/2016 05:00:00 PM,48,-122,234,85,319
22338,ElliotBayTrailMyrtlePark,07/19/2016 06:00:00 PM,48,-122,102,52,154
22339,ElliotBayTrailMyrtlePark,07/19/2016 07:00:00 PM,48,-122,49,53,102
22340,ElliotBayTrailMyrtlePark,07/19/2016 08:00:00 PM,48,-122,0,0,0
22341,ElliotBayTrailMyrtlePark,07/19/2016 09:00:00 PM,48,-122,31,32,63
22342,ElliotBayTrailMyrtlePark,07/19/2016 10:00:00 PM,48,-122,13,11,24
22343,ElliotBayTrailMyrtlePark,07/19/2016 11:00:00 PM,48,-122,9,1,10
22344,ElliotBayTrailMyrtlePark,07/20/2016 12:00:00 AM,48,-122,1,1,2
22345,ElliotBayTrailMyrtlePark,07/20/2016 01:00:00 AM,48,-122,2,0,2
22346,ElliotBayTrailMyrtlePark,07/20/2016 02:00:00 AM,48,-122,1,0,1
22347,ElliotBayTrailMyrtlePark,07/20/2016 03:00:00 AM,48,-122,1,1,2
22348,ElliotBayTrailMyrtlePark,07/20/2016 04:00:00 AM,48,-122,1,0,1
22349,ElliotBayTrailMyrtlePark,07/20/2016 05:00:00 AM,48,-122,5,4,9
22350,ElliotBayTrailMyrtlePark,07/20/2016 06:00:00 AM,48,-122,25,37,62
22351,ElliotBayTrailMyrtlePark,07/20/2016 07:00:00 AM,48,-122,32,82,114
22352,ElliotBayTrailMyrtlePark,07/20/2016 08:00:00 AM,48,-122,43,199,242
22353,ElliotBayTrailMyrtlePark,07/20/2016 09:00:00 AM,48,-122,44,117,161
22354,ElliotBayTrailMyrtlePark,07/20/2016 10:00:00 AM,48,-122,20,42,62
22355,ElliotBayTrailMyrtlePark,07/20/2016 11:00:00 AM,48,-122,31,34,65
22356,ElliotBayTrailMyrtlePark,07/20/2016 12:00:00 PM,48,-122,30,53,83
22357,ElliotBayTrailMyrtlePark,07/20/2016 01:00:00 PM,48,-122,27,33,60
22358,ElliotBayTrailMyrtlePark,07/20/2016 02:00:00 PM,48,-122,47,37,84
22359,ElliotBayTrailMyrtlePark,07/20/2016 03:00:00 PM,48,-122,58,43,101
22360,ElliotBayTrailMyrtlePark,07/20/2016 04:00:00 PM,48,-122,98,61,159
22361,ElliotBayTrailMyrtlePark,07/20/2016 05:00:00 PM,48,-122,227,86,313
22362,ElliotBayTrailMyrtlePark,07/20/2016 06:00:00 PM,48,-122,227,72,299
22363,ElliotBayTrailMyrtlePark,07/20/2016 07:00:00 PM,48,-122,97,53,150
22364,ElliotBayTrailMyrtlePark,07/20/2016 08:00:00 PM,48,-122,64,43,107
22365,ElliotBayTrailMyrtlePark,07/20/2016 09:00:00 PM,48,-122,21,29,50
22366,ElliotBayTrailMyrtlePark,07/20/2016 10:00:00 PM,48,-122,24,14,38
22367,ElliotBayTrailMyrtlePark,07/20/2016 11:00:00 PM,48,-122,1,7,8
22368,ElliotBayTrailMyrtlePark,07/21/2016 12:00:00 AM,48,-122,3,6,9
22369,ElliotBayTrailMyrtlePark,07/21/2016 01:00:00 AM,48,-122,2,0,2
22370,ElliotBayTrailMyrtlePark,07/21/2016 02:00:00 AM,48,-122,2,0,2
22371,ElliotBayTrailMyrtlePark,07/21/2016 03:00:00 AM,48,-122,4,0,4
22372,ElliotBayTrailMyrtlePark,07/21/2016 04:00:00 AM,48,-122,0,0,0
22373,ElliotBayTrailMyrtlePark,07/21/2016 05:00:00 AM,48,-122,5,4,9
22374,ElliotBayTrailMyrtlePark,07/21/2016 06:00:00 AM,48,-122,24,25,49
22375,ElliotBayTrailMyrtlePark,07/21/2016 07:00:00 AM,48,-122,41,88,129
22376,ElliotBayTrailMyrtlePark,07/21/2016 08:00:00 AM,48,-122,52,167,219
22377,ElliotBayTrailMyrtlePark,07/21/2016 09:00:00 AM,48,-122,96,74,170
22378,ElliotBayTrailMyrtlePark,07/21/2016 10:00:00 AM,48,-122,35,52,87
22379,ElliotBayTrailMyrtlePark,07/21/2016 11:00:00 AM,48,-122,37,41,78
22380,ElliotBayTrailMyrtlePark,07/21/2016 12:00:00 PM,48,-122,32,30,62
22381,ElliotBayTrailMyrtlePark,07/21/2016 01:00:00 PM,48,-122,40,46,86
22382,ElliotBayTrailMyrtlePark,07/21/2016 02:00:00 PM,48,-122,38,41,79
22383,ElliotBayTrailMyrtlePark,07/21/2016 03:00:00 PM,48,-122,41,48,89
22384,ElliotBayTrailMyrtlePark,07/21/2016 04:00:00 PM,48,-122,66,45,111
22385,ElliotBayTrailMyrtlePark,07/21/2016 05:00:00 PM,48,-122,195,100,295
22386,ElliotBayTrailMyrtlePark,07/21/2016 06:00:00 PM,48,-122,186,71,257
22387,ElliotBayTrailMyrtlePark,07/21/2016 07:00:00 PM,48,-122,102,45,147
22388,ElliotBayTrailMyrtlePark,07/21/2016 08:00:00 PM,48,-122,48,49,97
22389,ElliotBayTrailMyrtlePark,07/21/2016 09:00:00 PM,48,-122,15,8,23
22390,ElliotBayTrailMyrtlePark,07/21/2016 10:00:00 PM,48,-122,2,4,6
22391,ElliotBayTrailMyrtlePark,07/21/2016 11:00:00 PM,48,-122,6,0,6
22392,ElliotBayTrailMyrtlePark,07/22/2016 12:00:00 AM,48,-122,2,0,2
22393,ElliotBayTrailMyrtlePark,07/22/2016 01:00:00 AM,48,-122,1,2,3
22394,ElliotBayTrailMyrtlePark,07/22/2016 02:00:00 AM,48,-122,2,1,3
22395,ElliotBayTrailMyrtlePark,07/22/2016 03:00:00 AM,48,-122,0,0,0
22396,ElliotBayTrailMyrtlePark,07/22/2016 04:00:00 AM,48,-122,4,6,10
22397,ElliotBayTrailMyrtlePark,07/22/2016 05:00:00 AM,48,-122,12,17,29
22398,ElliotBayTrailMyrtlePark,07/22/2016 06:00:00 AM,48,-122,14,20,34
22399,ElliotBayTrailMyrtlePark,07/22/2016 07:00:00 AM,48,-122,21,52,73
22400,ElliotBayTrailMyrtlePark,07/22/2016 08:00:00 AM,48,-122,15,54,69
22401,ElliotBayTrailMyrtlePark,07/22/2016 09:00:00 AM,48,-122,7,17,24
22402,ElliotBayTrailMyrtlePark,07/22/2016 10:00:00 AM,48,-122,16,17,33
22403,ElliotBayTrailMyrtlePark,07/22/2016 11:00:00 AM,48,-122,13,14,27
22404,ElliotBayTrailMyrtlePark,07/22/2016 12:00:00 PM,48,-122,22,12,34
22405,ElliotBayTrailMyrtlePark,07/22/2016 01:00:00 PM,48,-122,24,22,46
22406,ElliotBayTrailMyrtlePark,07/22/2016 02:00:00 PM,48,-122,23,31,54
22407,ElliotBayTrailMyrtlePark,07/22/2016 03:00:00 PM,48,-122,54,51,105
22408,ElliotBayTrailMyrtlePark,07/22/2016 04:00:00 PM,48,-122,66,50,116
22409,ElliotBayTrailMyrtlePark,07/22/2016 05:00:00 PM,48,-122,84,31,115
22410,ElliotBayTrailMyrtlePark,07/22/2016 06:00:00 PM,48,-122,31,18,49
22411,ElliotBayTrailMyrtlePark,07/22/2016 07:00:00 PM,48,-122,4,12,16
22412,ElliotBayTrailMyrtlePark,07/22/2016 08:00:00 PM,48,-122,5,2,7
22413,ElliotBayTrailMyrtlePark,07/22/2016 09:00:00 PM,48,-122,9,4,13
22414,ElliotBayTrailMyrtlePark,07/22/2016 10:00:00 PM,48,-122,7,0,7
22415,ElliotBayTrailMyrtlePark,07/22/2016 11:00:00 PM,48,-122,1,0,1
22416,ElliotBayTrailMyrtlePark,07/23/2016 12:00:00 AM,48,-122,2,0,2
22417,ElliotBayTrailMyrtlePark,07/23/2016 01:00:00 AM,48,-122,5,1,6
22418,ElliotBayTrailMyrtlePark,07/23/2016 02:00:00 AM,48,-122,0,0,0
22419,ElliotBayTrailMyrtlePark,07/23/2016 03:00:00 AM,48,-122,1,0,1
22420,ElliotBayTrailMyrtlePark,07/23/2016 04:00:00 AM,48,-122,0,0,0
22421,ElliotBayTrailMyrtlePark,07/23/2016 05:00:00 AM,48,-122,5,4,9
22422,ElliotBayTrailMyrtlePark,07/23/2016 06:00:00 AM,48,-122,8,7,15
22423,ElliotBayTrailMyrtlePark,07/23/2016 07:00:00 AM,48,-122,18,15,33
22424,ElliotBayTrailMyrtlePark,07/23/2016 08:00:00 AM,48,-122,21,30,51
22425,ElliotBayTrailMyrtlePark,07/23/2016 09:00:00 AM,48,-122,38,31,69
22426,ElliotBayTrailMyrtlePark,07/23/2016 10:00:00 AM,48,-122,38,55,93
22427,ElliotBayTrailMyrtlePark,07/23/2016 11:00:00 AM,48,-122,46,36,82
22428,ElliotBayTrailMyrtlePark,07/23/2016 12:00:00 PM,48,-122,50,59,109
22429,ElliotBayTrailMyrtlePark,07/23/2016 01:00:00 PM,48,-122,51,48,99
22430,ElliotBayTrailMyrtlePark,07/23/2016 02:00:00 PM,48,-122,55,73,128
22431,ElliotBayTrailMyrtlePark,07/23/2016 03:00:00 PM,48,-122,58,61,119
22432,ElliotBayTrailMyrtlePark,07/23/2016 04:00:00 PM,48,-122,59,57,116
22433,ElliotBayTrailMyrtlePark,07/23/2016 05:00:00 PM,48,-122,74,64,138
22434,ElliotBayTrailMyrtlePark,07/23/2016 06:00:00 PM,48,-122,46,27,73
22435,ElliotBayTrailMyrtlePark,07/23/2016 07:00:00 PM,48,-122,27,34,61
22436,ElliotBayTrailMyrtlePark,07/23/2016 08:00:00 PM,48,-122,0,0,0
22437,ElliotBayTrailMyrtlePark,07/23/2016 09:00:00 PM,48,-122,18,22,40
22438,ElliotBayTrailMyrtlePark,07/23/2016 10:00:00 PM,48,-122,15,6,21
22439,ElliotBayTrailMyrtlePark,07/23/2016 11:00:00 PM,48,-122,10,2,12
22440,ElliotBayTrailMyrtlePark,07/24/2016 12:00:00 AM,48,-122,10,2,12
22441,ElliotBayTrailMyrtlePark,07/24/2016 01:00:00 AM,48,-122,13,0,13
22442,ElliotBayTrailMyrtlePark,07/24/2016 02:00:00 AM,48,-122,0,0,0
22443,ElliotBayTrailMyrtlePark,07/24/2016 03:00:00 AM,48,-122,3,0,3
22444,ElliotBayTrailMyrtlePark,07/24/2016 04:00:00 AM,48,-122,0,2,2
22445,ElliotBayTrailMyrtlePark,07/24/2016 05:00:00 AM,48,-122,2,2,4
22446,ElliotBayTrailMyrtlePark,07/24/2016 06:00:00 AM,48,-122,6,3,9
22447,ElliotBayTrailMyrtlePark,07/24/2016 07:00:00 AM,48,-122,5,10,15
22448,ElliotBayTrailMyrtlePark,07/24/2016 08:00:00 AM,48,-122,18,12,30
22449,ElliotBayTrailMyrtlePark,07/24/2016 09:00:00 AM,48,-122,30,43,73
22450,ElliotBayTrailMyrtlePark,07/24/2016 10:00:00 AM,48,-122,40,49,89
22451,ElliotBayTrailMyrtlePark,07/24/2016 11:00:00 AM,48,-122,61,83,144
22452,ElliotBayTrailMyrtlePark,07/24/2016 12:00:00 PM,48,-122,57,90,147
22453,ElliotBayTrailMyrtlePark,07/24/2016 01:00:00 PM,48,-122,78,80,158
22454,ElliotBayTrailMyrtlePark,07/24/2016 02:00:00 PM,48,-122,98,64,162
22455,ElliotBayTrailMyrtlePark,07/24/2016 03:00:00 PM,48,-122,94,119,213
22456,ElliotBayTrailMyrtlePark,07/24/2016 04:00:00 PM,48,-122,75,83,158
22457,ElliotBayTrailMyrtlePark,07/24/2016 05:00:00 PM,48,-122,83,51,134
22458,ElliotBayTrailMyrtlePark,07/24/2016 06:00:00 PM,48,-122,60,55,115
22459,ElliotBayTrailMyrtlePark,07/24/2016 07:00:00 PM,48,-122,45,50,95
22460,ElliotBayTrailMyrtlePark,07/24/2016 08:00:00 PM,48,-122,39,39,78
22461,ElliotBayTrailMyrtlePark,07/24/2016 09:00:00 PM,48,-122,15,10,25
22462,ElliotBayTrailMyrtlePark,07/24/2016 10:00:00 PM,48,-122,1,3,4
22463,ElliotBayTrailMyrtlePark,07/24/2016 11:00:00 PM,48,-122,3,0,3
22464,ElliotBayTrailMyrtlePark,07/25/2016 12:00:00 AM,48,-122,0,2,2
22465,ElliotBayTrailMyrtlePark,07/25/2016 01:00:00 AM,48,-122,0,1,1
22466,ElliotBayTrailMyrtlePark,07/25/2016 02:00:00 AM,48,-122,7,0,7
22467,ElliotBayTrailMyrtlePark,07/25/2016 03:00:00 AM,48,-122,0,0,0
22468,ElliotBayTrailMyrtlePark,07/25/2016 04:00:00 AM,48,-122,5,5,10
22469,ElliotBayTrailMyrtlePark,07/25/2016 05:00:00 AM,48,-122,12,32,44
22470,ElliotBayTrailMyrtlePark,07/25/2016 06:00:00 AM,48,-122,41,75,116
22471,ElliotBayTrailMyrtlePark,07/25/2016 07:00:00 AM,48,-122,61,177,238
22472,ElliotBayTrailMyrtlePark,07/25/2016 08:00:00 AM,48,-122,72,113,185
22473,ElliotBayTrailMyrtlePark,07/25/2016 09:00:00 AM,48,-122,36,37,73
22474,ElliotBayTrailMyrtlePark,07/25/2016 10:00:00 AM,48,-122,28,32,60
22475,ElliotBayTrailMyrtlePark,07/25/2016 11:00:00 AM,48,-122,22,28,50
22476,ElliotBayTrailMyrtlePark,07/25/2016 12:00:00 PM,48,-122,35,22,57
22477,ElliotBayTrailMyrtlePark,07/25/2016 01:00:00 PM,48,-122,26,32,58
22478,ElliotBayTrailMyrtlePark,07/25/2016 02:00:00 PM,48,-122,43,61,104
22479,ElliotBayTrailMyrtlePark,07/25/2016 03:00:00 PM,48,-122,66,72,138
22480,ElliotBayTrailMyrtlePark,07/25/2016 04:00:00 PM,48,-122,191,78,269
22481,ElliotBayTrailMyrtlePark,07/25/2016 05:00:00 PM,48,-122,225,80,305
22482,ElliotBayTrailMyrtlePark,07/25/2016 06:00:00 PM,48,-122,119,51,170
22483,ElliotBayTrailMyrtlePark,07/25/2016 07:00:00 PM,48,-122,57,42,99
22484,ElliotBayTrailMyrtlePark,07/25/2016 08:00:00 PM,48,-122,21,22,43
22485,ElliotBayTrailMyrtlePark,07/25/2016 09:00:00 PM,48,-122,9,15,24
22486,ElliotBayTrailMyrtlePark,07/25/2016 10:00:00 PM,48,-122,4,5,9
22487,ElliotBayTrailMyrtlePark,07/25/2016 11:00:00 PM,48,-122,3,3,6
22488,ElliotBayTrailMyrtlePark,07/26/2016 12:00:00 AM,48,-122,1,1,2
22489,ElliotBayTrailMyrtlePark,07/26/2016 01:00:00 AM,48,-122,3,0,3
22490,ElliotBayTrailMyrtlePark,07/26/2016 02:00:00 AM,48,-122,3,0,3
22491,ElliotBayTrailMyrtlePark,07/26/2016 03:00:00 AM,48,-122,0,1,1
22492,ElliotBayTrailMyrtlePark,07/26/2016 04:00:00 AM,48,-122,4,4,8
22493,ElliotBayTrailMyrtlePark,07/26/2016 05:00:00 AM,48,-122,20,33,53
22494,ElliotBayTrailMyrtlePark,07/26/2016 06:00:00 AM,48,-122,32,79,111
22495,ElliotBayTrailMyrtlePark,07/26/2016 07:00:00 AM,48,-122,58,180,238
22496,ElliotBayTrailMyrtlePark,07/26/2016 08:00:00 AM,48,-122,54,122,176
22497,ElliotBayTrailMyrtlePark,07/26/2016 09:00:00 AM,48,-122,35,58,93
22498,ElliotBayTrailMyrtlePark,07/26/2016 10:00:00 AM,48,-122,22,14,36
22499,ElliotBayTrailMyrtlePark,07/26/2016 11:00:00 AM,48,-122,22,15,37
22500,ElliotBayTrailMyrtlePark,07/26/2016 12:00:00 PM,48,-122,34,14,48
22501,ElliotBayTrailMyrtlePark,07/26/2016 01:00:00 PM,48,-122,22,29,51
22502,ElliotBayTrailMyrtlePark,07/26/2016 02:00:00 PM,48,-122,42,38,80
22503,ElliotBayTrailMyrtlePark,07/26/2016 03:00:00 PM,48,-122,80,58,138
22504,ElliotBayTrailMyrtlePark,07/26/2016 04:00:00 PM,48,-122,196,85,281
22505,ElliotBayTrailMyrtlePark,07/26/2016 05:00:00 PM,48,-122,232,78,310
22506,ElliotBayTrailMyrtlePark,07/26/2016 06:00:00 PM,48,-122,111,53,164
22507,ElliotBayTrailMyrtlePark,07/26/2016 07:00:00 PM,48,-122,66,40,106
22508,ElliotBayTrailMyrtlePark,07/26/2016 08:00:00 PM,48,-122,17,18,35
22509,ElliotBayTrailMyrtlePark,07/26/2016 09:00:00 PM,48,-122,11,32,43
22510,ElliotBayTrailMyrtlePark,07/26/2016 10:00:00 PM,48,-122,5,3,8
22511,ElliotBayTrailMyrtlePark,07/26/2016 11:00:00 PM,48,-122,1,2,3
22512,ElliotBayTrailMyrtlePark,07/27/2016 12:00:00 AM,48,-122,2,0,2
22513,ElliotBayTrailMyrtlePark,07/27/2016 01:00:00 AM,48,-122,0,0,0
22514,ElliotBayTrailMyrtlePark,07/27/2016 02:00:00 AM,48,-122,0,0,0
22515,ElliotBayTrailMyrtlePark,07/27/2016 03:00:00 AM,48,-122,1,0,1
22516,ElliotBayTrailMyrtlePark,07/27/2016 04:00:00 AM,48,-122,4,1,5
22517,ElliotBayTrailMyrtlePark,07/27/2016 05:00:00 AM,48,-122,22,32,54
22518,ElliotBayTrailMyrtlePark,07/27/2016 06:00:00 AM,48,-122,40,92,132
22519,ElliotBayTrailMyrtlePark,07/27/2016 07:00:00 AM,48,-122,51,173,224
22520,ElliotBayTrailMyrtlePark,07/27/2016 08:00:00 AM,48,-122,87,89,176
22521,ElliotBayTrailMyrtlePark,07/27/2016 09:00:00 AM,48,-122,42,44,86
22522,ElliotBayTrailMyrtlePark,07/27/2016 10:00:00 AM,48,-122,34,39,73
22523,ElliotBayTrailMyrtlePark,07/27/2016 11:00:00 AM,48,-122,32,38,70
22524,ElliotBayTrailMyrtlePark,07/27/2016 12:00:00 PM,48,-122,30,30,60
22525,ElliotBayTrailMyrtlePark,07/27/2016 01:00:00 PM,48,-122,27,28,55
22526,ElliotBayTrailMyrtlePark,07/27/2016 02:00:00 PM,48,-122,48,45,93
22527,ElliotBayTrailMyrtlePark,07/27/2016 03:00:00 PM,48,-122,84,57,141
22528,ElliotBayTrailMyrtlePark,07/27/2016 04:00:00 PM,48,-122,211,70,281
22529,ElliotBayTrailMyrtlePark,07/27/2016 05:00:00 PM,48,-122,218,74,292
22530,ElliotBayTrailMyrtlePark,07/27/2016 06:00:00 PM,48,-122,109,53,162
22531,ElliotBayTrailMyrtlePark,07/27/2016 07:00:00 PM,48,-122,54,34,88
22532,ElliotBayTrailMyrtlePark,07/27/2016 08:00:00 PM,48,-122,15,23,38
22533,ElliotBayTrailMyrtlePark,07/27/2016 09:00:00 PM,48,-122,14,14,28
22534,ElliotBayTrailMyrtlePark,07/27/2016 10:00:00 PM,48,-122,3,2,5
22535,ElliotBayTrailMyrtlePark,07/27/2016 11:00:00 PM,48,-122,0,2,2
22536,ElliotBayTrailMyrtlePark,07/28/2016 12:00:00 AM,48,-122,1,1,2
22537,ElliotBayTrailMyrtlePark,07/28/2016 01:00:00 AM,48,-122,0,0,0
22538,ElliotBayTrailMyrtlePark,07/28/2016 02:00:00 AM,48,-122,0,0,0
22539,ElliotBayTrailMyrtlePark,07/28/2016 03:00:00 AM,48,-122,0,0,0
22540,ElliotBayTrailMyrtlePark,07/28/2016 04:00:00 AM,48,-122,3,3,6
22541,ElliotBayTrailMyrtlePark,07/28/2016 05:00:00 AM,48,-122,16,25,41
22542,ElliotBayTrailMyrtlePark,07/28/2016 06:00:00 AM,48,-122,42,65,107
22543,ElliotBayTrailMyrtlePark,07/28/2016 07:00:00 AM,48,-122,49,169,218
22544,ElliotBayTrailMyrtlePark,07/28/2016 08:00:00 AM,48,-122,70,94,164
22545,ElliotBayTrailMyrtlePark,07/28/2016 09:00:00 AM,48,-122,31,49,80
22546,ElliotBayTrailMyrtlePark,07/28/2016 10:00:00 AM,48,-122,29,32,61
22547,ElliotBayTrailMyrtlePark,07/28/2016 11:00:00 AM,48,-122,29,31,60
22548,ElliotBayTrailMyrtlePark,07/28/2016 12:00:00 PM,48,-122,39,37,76
22549,ElliotBayTrailMyrtlePark,07/28/2016 01:00:00 PM,48,-122,33,43,76
22550,ElliotBayTrailMyrtlePark,07/28/2016 02:00:00 PM,48,-122,52,44,96
22551,ElliotBayTrailMyrtlePark,07/28/2016 03:00:00 PM,48,-122,88,57,145
22552,ElliotBayTrailMyrtlePark,07/28/2016 04:00:00 PM,48,-122,163,68,231
22553,ElliotBayTrailMyrtlePark,07/28/2016 05:00:00 PM,48,-122,190,71,261
22554,ElliotBayTrailMyrtlePark,07/28/2016 06:00:00 PM,48,-122,92,50,142
22555,ElliotBayTrailMyrtlePark,07/28/2016 07:00:00 PM,48,-122,68,34,102
22556,ElliotBayTrailMyrtlePark,07/28/2016 08:00:00 PM,48,-122,17,35,52
22557,ElliotBayTrailMyrtlePark,07/28/2016 09:00:00 PM,48,-122,12,13,25
22558,ElliotBayTrailMyrtlePark,07/28/2016 10:00:00 PM,48,-122,3,1,4
22559,ElliotBayTrailMyrtlePark,07/28/2016 11:00:00 PM,48,-122,1,5,6
22560,ElliotBayTrailMyrtlePark,07/29/2016 12:00:00 AM,48,-122,1,0,1
22561,ElliotBayTrailMyrtlePark,07/29/2016 01:00:00 AM,48,-122,0,1,1
22562,ElliotBayTrailMyrtlePark,07/29/2016 02:00:00 AM,48,-122,1,0,1
22563,ElliotBayTrailMyrtlePark,07/29/2016 03:00:00 AM,48,-122,0,0,0
22564,ElliotBayTrailMyrtlePark,07/29/2016 04:00:00 AM,48,-122,3,3,6
22565,ElliotBayTrailMyrtlePark,07/29/2016 05:00:00 AM,48,-122,10,18,28
22566,ElliotBayTrailMyrtlePark,07/29/2016 06:00:00 AM,48,-122,39,66,105
22567,ElliotBayTrailMyrtlePark,07/29/2016 07:00:00 AM,48,-122,48,158,206
22568,ElliotBayTrailMyrtlePark,07/29/2016 08:00:00 AM,48,-122,70,75,145
22569,ElliotBayTrailMyrtlePark,07/29/2016 09:00:00 AM,48,-122,30,29,59
22570,ElliotBayTrailMyrtlePark,07/29/2016 10:00:00 AM,48,-122,32,41,73
22571,ElliotBayTrailMyrtlePark,07/29/2016 11:00:00 AM,48,-122,36,35,71
22572,ElliotBayTrailMyrtlePark,07/29/2016 12:00:00 PM,48,-122,30,38,68
22573,ElliotBayTrailMyrtlePark,07/29/2016 01:00:00 PM,48,-122,44,38,82
22574,ElliotBayTrailMyrtlePark,07/29/2016 02:00:00 PM,48,-122,47,39,86
22575,ElliotBayTrailMyrtlePark,07/29/2016 03:00:00 PM,48,-122,100,70,170
22576,ElliotBayTrailMyrtlePark,07/29/2016 04:00:00 PM,48,-122,154,66,220
22577,ElliotBayTrailMyrtlePark,07/29/2016 05:00:00 PM,48,-122,165,65,230
22578,ElliotBayTrailMyrtlePark,07/29/2016 06:00:00 PM,48,-122,66,41,107
22579,ElliotBayTrailMyrtlePark,07/29/2016 07:00:00 PM,48,-122,39,31,70
22580,ElliotBayTrailMyrtlePark,07/29/2016 08:00:00 PM,48,-122,5,4,9
22581,ElliotBayTrailMyrtlePark,07/29/2016 09:00:00 PM,48,-122,11,11,22
22582,ElliotBayTrailMyrtlePark,07/29/2016 10:00:00 PM,48,-122,5,3,8
22583,ElliotBayTrailMyrtlePark,07/29/2016 11:00:00 PM,48,-122,3,5,8
22584,ElliotBayTrailMyrtlePark,07/30/2016 12:00:00 AM,48,-122,2,0,2
22585,ElliotBayTrailMyrtlePark,07/30/2016 01:00:00 AM,48,-122,2,1,3
22586,ElliotBayTrailMyrtlePark,07/30/2016 02:00:00 AM,48,-122,0,1,1
22587,ElliotBayTrailMyrtlePark,07/30/2016 03:00:00 AM,48,-122,0,0,0
22588,ElliotBayTrailMyrtlePark,07/30/2016 04:00:00 AM,48,-122,0,4,4
22589,ElliotBayTrailMyrtlePark,07/30/2016 05:00:00 AM,48,-122,5,3,8
22590,ElliotBayTrailMyrtlePark,07/30/2016 06:00:00 AM,48,-122,7,8,15
22591,ElliotBayTrailMyrtlePark,07/30/2016 07:00:00 AM,48,-122,16,19,35
22592,ElliotBayTrailMyrtlePark,07/30/2016 08:00:00 AM,48,-122,22,36,58
22593,ElliotBayTrailMyrtlePark,07/30/2016 09:00:00 AM,48,-122,26,44,70
22594,ElliotBayTrailMyrtlePark,07/30/2016 10:00:00 AM,48,-122,41,43,84
22595,ElliotBayTrailMyrtlePark,07/30/2016 11:00:00 AM,48,-122,57,61,118
22596,ElliotBayTrailMyrtlePark,07/30/2016 12:00:00 PM,48,-122,57,65,122
22597,ElliotBayTrailMyrtlePark,07/30/2016 01:00:00 PM,48,-122,68,49,117
22598,ElliotBayTrailMyrtlePark,07/30/2016 02:00:00 PM,48,-122,94,65,159
22599,ElliotBayTrailMyrtlePark,07/30/2016 03:00:00 PM,48,-122,78,65,143
22600,ElliotBayTrailMyrtlePark,07/30/2016 04:00:00 PM,48,-122,54,51,105
22601,ElliotBayTrailMyrtlePark,07/30/2016 05:00:00 PM,48,-122,47,48,95
22602,ElliotBayTrailMyrtlePark,07/30/2016 06:00:00 PM,48,-122,45,32,77
22603,ElliotBayTrailMyrtlePark,07/30/2016 07:00:00 PM,48,-122,29,23,52
22604,ElliotBayTrailMyrtlePark,07/30/2016 08:00:00 PM,48,-122,10,12,22
22605,ElliotBayTrailMyrtlePark,07/30/2016 09:00:00 PM,48,-122,14,4,18
22606,ElliotBayTrailMyrtlePark,07/30/2016 10:00:00 PM,48,-122,11,15,26
22607,ElliotBayTrailMyrtlePark,07/30/2016 11:00:00 PM,48,-122,2,3,5
22608,ElliotBayTrailMyrtlePark,07/31/2016 12:00:00 AM,48,-122,4,0,4
22609,ElliotBayTrailMyrtlePark,07/31/2016 01:00:00 AM,48,-122,0,0,0
22610,ElliotBayTrailMyrtlePark,07/31/2016 02:00:00 AM,48,-122,2,0,2
22611,ElliotBayTrailMyrtlePark,07/31/2016 03:00:00 AM,48,-122,1,0,1
22612,ElliotBayTrailMyrtlePark,07/31/2016 04:00:00 AM,48,-122,0,1,1
22613,ElliotBayTrailMyrtlePark,07/31/2016 05:00:00 AM,48,-122,2,4,6
22614,ElliotBayTrailMyrtlePark,07/31/2016 06:00:00 AM,48,-122,6,2,8
22615,ElliotBayTrailMyrtlePark,07/31/2016 07:00:00 AM,48,-122,7,16,23
22616,ElliotBayTrailMyrtlePark,07/31/2016 08:00:00 AM,48,-122,46,40,86
22617,ElliotBayTrailMyrtlePark,07/31/2016 09:00:00 AM,48,-122,22,43,65
22618,ElliotBayTrailMyrtlePark,07/31/2016 10:00:00 AM,48,-122,37,48,85
22619,ElliotBayTrailMyrtlePark,07/31/2016 11:00:00 AM,48,-122,54,99,153
22620,ElliotBayTrailMyrtlePark,07/31/2016 12:00:00 PM,48,-122,68,67,135
22621,ElliotBayTrailMyrtlePark,07/31/2016 01:00:00 PM,48,-122,52,75,127
22622,ElliotBayTrailMyrtlePark,07/31/2016 02:00:00 PM,48,-122,105,69,174
22623,ElliotBayTrailMyrtlePark,07/31/2016 03:00:00 PM,48,-122,101,83,184
22624,ElliotBayTrailMyrtlePark,07/31/2016 04:00:00 PM,48,-122,71,30,101
22625,ElliotBayTrailMyrtlePark,07/31/2016 05:00:00 PM,48,-122,50,40,90
22626,ElliotBayTrailMyrtlePark,07/31/2016 06:00:00 PM,48,-122,60,42,102
22627,ElliotBayTrailMyrtlePark,07/31/2016 07:00:00 PM,48,-122,26,29,55
22628,ElliotBayTrailMyrtlePark,07/31/2016 08:00:00 PM,48,-122,8,16,24
22629,ElliotBayTrailMyrtlePark,07/31/2016 09:00:00 PM,48,-122,6,3,9
22630,ElliotBayTrailMyrtlePark,07/31/2016 10:00:00 PM,48,-122,2,4,6
22631,ElliotBayTrailMyrtlePark,07/31/2016 11:00:00 PM,48,-122,1,1,2
22632,ElliotBayTrailMyrtlePark,08/01/2016 12:00:00 AM,48,-122,0,0,0
22633,ElliotBayTrailMyrtlePark,08/01/2016 01:00:00 AM,48,-122,1,1,2
22634,ElliotBayTrailMyrtlePark,08/01/2016 02:00:00 AM,48,-122,2,0,2
22635,ElliotBayTrailMyrtlePark,08/01/2016 03:00:00 AM,48,-122,0,0,0
22636,ElliotBayTrailMyrtlePark,08/01/2016 04:00:00 AM,48,-122,6,5,11
22637,ElliotBayTrailMyrtlePark,08/01/2016 05:00:00 AM,48,-122,16,22,38
22638,ElliotBayTrailMyrtlePark,08/01/2016 06:00:00 AM,48,-122,35,68,103
22639,ElliotBayTrailMyrtlePark,08/01/2016 07:00:00 AM,48,-122,30,146,176
22640,ElliotBayTrailMyrtlePark,08/01/2016 08:00:00 AM,48,-122,27,129,156
22641,ElliotBayTrailMyrtlePark,08/01/2016 09:00:00 AM,48,-122,31,31,62
22642,ElliotBayTrailMyrtlePark,08/01/2016 10:00:00 AM,48,-122,20,25,45
22643,ElliotBayTrailMyrtlePark,08/01/2016 11:00:00 AM,48,-122,32,35,67
22644,ElliotBayTrailMyrtlePark,08/01/2016 12:00:00 PM,48,-122,18,15,33
22645,ElliotBayTrailMyrtlePark,08/01/2016 01:00:00 PM,48,-122,39,33,72
22646,ElliotBayTrailMyrtlePark,08/01/2016 02:00:00 PM,48,-122,34,41,75
22647,ElliotBayTrailMyrtlePark,08/01/2016 03:00:00 PM,48,-122,61,61,122
22648,ElliotBayTrailMyrtlePark,08/01/2016 04:00:00 PM,48,-122,172,67,239
22649,ElliotBayTrailMyrtlePark,08/01/2016 05:00:00 PM,48,-122,239,60,299
22650,ElliotBayTrailMyrtlePark,08/01/2016 06:00:00 PM,48,-122,90,44,134
22651,ElliotBayTrailMyrtlePark,08/01/2016 07:00:00 PM,48,-122,50,37,87
22652,ElliotBayTrailMyrtlePark,08/01/2016 08:00:00 PM,48,-122,18,11,29
22653,ElliotBayTrailMyrtlePark,08/01/2016 09:00:00 PM,48,-122,10,9,19
22654,ElliotBayTrailMyrtlePark,08/01/2016 10:00:00 PM,48,-122,4,2,6
22655,ElliotBayTrailMyrtlePark,08/01/2016 11:00:00 PM,48,-122,3,0,3
22656,ElliotBayTrailMyrtlePark,08/02/2016 12:00:00 AM,48,-122,2,2,4
22657,ElliotBayTrailMyrtlePark,08/02/2016 01:00:00 AM,48,-122,2,0,2
22658,ElliotBayTrailMyrtlePark,08/02/2016 02:00:00 AM,48,-122,4,0,4
22659,ElliotBayTrailMyrtlePark,08/02/2016 03:00:00 AM,48,-122,0,0,0
22660,ElliotBayTrailMyrtlePark,08/02/2016 04:00:00 AM,48,-122,4,2,6
22661,ElliotBayTrailMyrtlePark,08/02/2016 05:00:00 AM,48,-122,20,24,44
22662,ElliotBayTrailMyrtlePark,08/02/2016 06:00:00 AM,48,-122,24,60,84
22663,ElliotBayTrailMyrtlePark,08/02/2016 07:00:00 AM,48,-122,41,126,167
22664,ElliotBayTrailMyrtlePark,08/02/2016 08:00:00 AM,48,-122,31,101,132
22665,ElliotBayTrailMyrtlePark,08/02/2016 09:00:00 AM,48,-122,13,43,56
22666,ElliotBayTrailMyrtlePark,08/02/2016 10:00:00 AM,48,-122,31,22,53
22667,ElliotBayTrailMyrtlePark,08/02/2016 11:00:00 AM,48,-122,17,12,29
22668,ElliotBayTrailMyrtlePark,08/02/2016 12:00:00 PM,48,-122,11,33,44
22669,ElliotBayTrailMyrtlePark,08/02/2016 01:00:00 PM,48,-122,27,19,46
22670,ElliotBayTrailMyrtlePark,08/02/2016 02:00:00 PM,48,-122,32,34,66
22671,ElliotBayTrailMyrtlePark,08/02/2016 03:00:00 PM,48,-122,67,54,121
22672,ElliotBayTrailMyrtlePark,08/02/2016 04:00:00 PM,48,-122,139,54,193
22673,ElliotBayTrailMyrtlePark,08/02/2016 05:00:00 PM,48,-122,159,65,224
22674,ElliotBayTrailMyrtlePark,08/02/2016 06:00:00 PM,48,-122,54,32,86
22675,ElliotBayTrailMyrtlePark,08/02/2016 07:00:00 PM,48,-122,34,20,54
22676,ElliotBayTrailMyrtlePark,08/02/2016 08:00:00 PM,48,-122,0,0,0
22677,ElliotBayTrailMyrtlePark,08/02/2016 09:00:00 PM,48,-122,0,0,0
22678,ElliotBayTrailMyrtlePark,08/02/2016 10:00:00 PM,48,-122,0,0,0
22679,ElliotBayTrailMyrtlePark,08/02/2016 11:00:00 PM,48,-122,0,0,0
22680,ElliotBayTrailMyrtlePark,08/03/2016 12:00:00 AM,48,-122,0,0,0
22681,ElliotBayTrailMyrtlePark,08/03/2016 01:00:00 AM,48,-122,0,0,0
22682,ElliotBayTrailMyrtlePark,08/03/2016 02:00:00 AM,48,-122,0,0,0
22683,ElliotBayTrailMyrtlePark,08/03/2016 03:00:00 AM,48,-122,0,0,0
22684,ElliotBayTrailMyrtlePark,08/03/2016 04:00:00 AM,48,-122,0,0,0
22685,ElliotBayTrailMyrtlePark,08/03/2016 05:00:00 AM,48,-122,0,0,0
22686,ElliotBayTrailMyrtlePark,08/03/2016 06:00:00 AM,48,-122,0,0,0
22687,ElliotBayTrailMyrtlePark,08/03/2016 07:00:00 AM,48,-122,0,0,0
22688,ElliotBayTrailMyrtlePark,08/03/2016 08:00:00 AM,48,-122,0,0,0
22689,ElliotBayTrailMyrtlePark,08/03/2016 09:00:00 AM,48,-122,0,0,0
22690,ElliotBayTrailMyrtlePark,08/03/2016 10:00:00 AM,48,-122,0,0,0
22691,ElliotBayTrailMyrtlePark,08/03/2016 11:00:00 AM,48,-122,0,0,0
22692,ElliotBayTrailMyrtlePark,08/03/2016 12:00:00 PM,48,-122,0,0,0
22693,ElliotBayTrailMyrtlePark,08/03/2016 01:00:00 PM,48,-122,0,0,0
22694,ElliotBayTrailMyrtlePark,08/03/2016 02:00:00 PM,48,-122,0,0,0
22695,ElliotBayTrailMyrtlePark,08/03/2016 03:00:00 PM,48,-122,0,0,0
22696,ElliotBayTrailMyrtlePark,08/03/2016 04:00:00 PM,48,-122,0,0,0
22697,ElliotBayTrailMyrtlePark,08/03/2016 05:00:00 PM,48,-122,0,0,0
22698,ElliotBayTrailMyrtlePark,08/03/2016 06:00:00 PM,48,-122,0,0,0
22699,ElliotBayTrailMyrtlePark,08/03/2016 07:00:00 PM,48,-122,0,0,0
22700,ElliotBayTrailMyrtlePark,08/03/2016 08:00:00 PM,48,-122,0,0,0
22701,ElliotBayTrailMyrtlePark,08/03/2016 09:00:00 PM,48,-122,0,0,0
22702,ElliotBayTrailMyrtlePark,08/03/2016 10:00:00 PM,48,-122,0,0,0
22703,ElliotBayTrailMyrtlePark,08/03/2016 11:00:00 PM,48,-122,0,0,0
22704,ElliotBayTrailMyrtlePark,08/04/2016 12:00:00 AM,48,-122,0,0,0
22705,ElliotBayTrailMyrtlePark,08/04/2016 01:00:00 AM,48,-122,0,0,0
22706,ElliotBayTrailMyrtlePark,08/04/2016 02:00:00 AM,48,-122,0,0,0
22707,ElliotBayTrailMyrtlePark,08/04/2016 03:00:00 AM,48,-122,0,0,0
22708,ElliotBayTrailMyrtlePark,08/04/2016 04:00:00 AM,48,-122,0,0,0
22709,ElliotBayTrailMyrtlePark,08/04/2016 05:00:00 AM,48,-122,0,0,0
22710,ElliotBayTrailMyrtlePark,08/04/2016 06:00:00 AM,48,-122,0,0,0
22711,ElliotBayTrailMyrtlePark,08/04/2016 07:00:00 AM,48,-122,0,0,0
22712,ElliotBayTrailMyrtlePark,08/04/2016 08:00:00 AM,48,-122,0,0,0
22713,ElliotBayTrailMyrtlePark,08/04/2016 09:00:00 AM,48,-122,0,0,0
22714,ElliotBayTrailMyrtlePark,08/04/2016 10:00:00 AM,48,-122,0,0,0
22715,ElliotBayTrailMyrtlePark,08/04/2016 11:00:00 AM,48,-122,0,0,0
22716,ElliotBayTrailMyrtlePark,08/04/2016 12:00:00 PM,48,-122,0,0,0
22717,ElliotBayTrailMyrtlePark,08/04/2016 01:00:00 PM,48,-122,0,0,0
22718,ElliotBayTrailMyrtlePark,08/04/2016 02:00:00 PM,48,-122,0,0,0
22719,ElliotBayTrailMyrtlePark,08/04/2016 03:00:00 PM,48,-122,0,0,0
22720,ElliotBayTrailMyrtlePark,08/04/2016 04:00:00 PM,48,-122,0,0,0
22721,ElliotBayTrailMyrtlePark,08/04/2016 05:00:00 PM,48,-122,0,0,0
22722,ElliotBayTrailMyrtlePark,08/04/2016 06:00:00 PM,48,-122,0,0,0
22723,ElliotBayTrailMyrtlePark,08/04/2016 07:00:00 PM,48,-122,0,0,0
22724,ElliotBayTrailMyrtlePark,08/04/2016 08:00:00 PM,48,-122,0,0,0
22725,ElliotBayTrailMyrtlePark,08/04/2016 09:00:00 PM,48,-122,0,0,0
22726,ElliotBayTrailMyrtlePark,08/04/2016 10:00:00 PM,48,-122,0,0,0
22727,ElliotBayTrailMyrtlePark,08/04/2016 11:00:00 PM,48,-122,0,0,0
22728,ElliotBayTrailMyrtlePark,08/05/2016 12:00:00 AM,48,-122,0,0,0
22729,ElliotBayTrailMyrtlePark,08/05/2016 01:00:00 AM,48,-122,0,0,0
22730,ElliotBayTrailMyrtlePark,08/05/2016 02:00:00 AM,48,-122,0,0,0
22731,ElliotBayTrailMyrtlePark,08/05/2016 03:00:00 AM,48,-122,0,0,0
22732,ElliotBayTrailMyrtlePark,08/05/2016 04:00:00 AM,48,-122,0,0,0
22733,ElliotBayTrailMyrtlePark,08/05/2016 05:00:00 AM,48,-122,0,0,0
22734,ElliotBayTrailMyrtlePark,08/05/2016 06:00:00 AM,48,-122,0,0,0
22735,ElliotBayTrailMyrtlePark,08/05/2016 07:00:00 AM,48,-122,0,0,0
22736,ElliotBayTrailMyrtlePark,08/05/2016 08:00:00 AM,48,-122,0,0,0
22737,ElliotBayTrailMyrtlePark,08/05/2016 09:00:00 AM,48,-122,0,0,0
22738,ElliotBayTrailMyrtlePark,08/05/2016 10:00:00 AM,48,-122,10,4,14
22739,ElliotBayTrailMyrtlePark,08/05/2016 11:00:00 AM,48,-122,31,47,78
22740,ElliotBayTrailMyrtlePark,08/05/2016 12:00:00 PM,48,-122,48,41,89
22741,ElliotBayTrailMyrtlePark,08/05/2016 01:00:00 PM,48,-122,50,36,86
22742,ElliotBayTrailMyrtlePark,08/05/2016 02:00:00 PM,48,-122,69,40,109
22743,ElliotBayTrailMyrtlePark,08/05/2016 03:00:00 PM,48,-122,91,80,171
22744,ElliotBayTrailMyrtlePark,08/05/2016 04:00:00 PM,48,-122,181,87,268
22745,ElliotBayTrailMyrtlePark,08/05/2016 05:00:00 PM,48,-122,153,43,196
22746,ElliotBayTrailMyrtlePark,08/05/2016 06:00:00 PM,48,-122,77,44,121
22747,ElliotBayTrailMyrtlePark,08/05/2016 07:00:00 PM,48,-122,30,28,58
22748,ElliotBayTrailMyrtlePark,08/05/2016 08:00:00 PM,48,-122,18,18,36
22749,ElliotBayTrailMyrtlePark,08/05/2016 09:00:00 PM,48,-122,13,7,20
22750,ElliotBayTrailMyrtlePark,08/05/2016 10:00:00 PM,48,-122,12,7,19
22751,ElliotBayTrailMyrtlePark,08/05/2016 11:00:00 PM,48,-122,3,1,4
22752,ElliotBayTrailMyrtlePark,08/06/2016 12:00:00 AM,48,-122,4,2,6
22753,ElliotBayTrailMyrtlePark,08/06/2016 01:00:00 AM,48,-122,0,0,0
22754,ElliotBayTrailMyrtlePark,08/06/2016 02:00:00 AM,48,-122,2,0,2
22755,ElliotBayTrailMyrtlePark,08/06/2016 03:00:00 AM,48,-122,2,1,3
22756,ElliotBayTrailMyrtlePark,08/06/2016 04:00:00 AM,48,-122,1,1,2
22757,ElliotBayTrailMyrtlePark,08/06/2016 05:00:00 AM,48,-122,1,6,7
22758,ElliotBayTrailMyrtlePark,08/06/2016 06:00:00 AM,48,-122,6,3,9
22759,ElliotBayTrailMyrtlePark,08/06/2016 07:00:00 AM,48,-122,17,22,39
22760,ElliotBayTrailMyrtlePark,08/06/2016 08:00:00 AM,48,-122,23,36,59
22761,ElliotBayTrailMyrtlePark,08/06/2016 09:00:00 AM,48,-122,33,30,63
22762,ElliotBayTrailMyrtlePark,08/06/2016 10:00:00 AM,48,-122,30,41,71
22763,ElliotBayTrailMyrtlePark,08/06/2016 11:00:00 AM,48,-122,49,60,109
22764,ElliotBayTrailMyrtlePark,08/06/2016 12:00:00 PM,48,-122,55,45,100
22765,ElliotBayTrailMyrtlePark,08/06/2016 01:00:00 PM,48,-122,64,64,128
22766,ElliotBayTrailMyrtlePark,08/06/2016 02:00:00 PM,48,-122,61,31,92
22767,ElliotBayTrailMyrtlePark,08/06/2016 03:00:00 PM,48,-122,44,49,93
22768,ElliotBayTrailMyrtlePark,08/06/2016 04:00:00 PM,48,-122,62,70,132
22769,ElliotBayTrailMyrtlePark,08/06/2016 05:00:00 PM,48,-122,38,42,80
22770,ElliotBayTrailMyrtlePark,08/06/2016 06:00:00 PM,48,-122,60,58,118
22771,ElliotBayTrailMyrtlePark,08/06/2016 07:00:00 PM,48,-122,24,27,51
22772,ElliotBayTrailMyrtlePark,08/06/2016 08:00:00 PM,48,-122,8,10,18
22773,ElliotBayTrailMyrtlePark,08/06/2016 09:00:00 PM,48,-122,17,6,23
22774,ElliotBayTrailMyrtlePark,08/06/2016 10:00:00 PM,48,-122,11,8,19
22775,ElliotBayTrailMyrtlePark,08/06/2016 11:00:00 PM,48,-122,28,3,31
22776,ElliotBayTrailMyrtlePark,08/07/2016 12:00:00 AM,48,-122,13,1,14
22777,ElliotBayTrailMyrtlePark,08/07/2016 01:00:00 AM,48,-122,0,0,0
22778,ElliotBayTrailMyrtlePark,08/07/2016 02:00:00 AM,48,-122,1,0,1
22779,ElliotBayTrailMyrtlePark,08/07/2016 03:00:00 AM,48,-122,1,0,1
22780,ElliotBayTrailMyrtlePark,08/07/2016 04:00:00 AM,48,-122,1,2,3
22781,ElliotBayTrailMyrtlePark,08/07/2016 05:00:00 AM,48,-122,0,1,1
22782,ElliotBayTrailMyrtlePark,08/07/2016 06:00:00 AM,48,-122,6,7,13
22783,ElliotBayTrailMyrtlePark,08/07/2016 07:00:00 AM,48,-122,10,17,27
22784,ElliotBayTrailMyrtlePark,08/07/2016 08:00:00 AM,48,-122,20,21,41
22785,ElliotBayTrailMyrtlePark,08/07/2016 09:00:00 AM,48,-122,35,47,82
22786,ElliotBayTrailMyrtlePark,08/07/2016 10:00:00 AM,48,-122,43,49,92
22787,ElliotBayTrailMyrtlePark,08/07/2016 11:00:00 AM,48,-122,40,46,86
22788,ElliotBayTrailMyrtlePark,08/07/2016 12:00:00 PM,48,-122,39,36,75
22789,ElliotBayTrailMyrtlePark,08/07/2016 01:00:00 PM,48,-122,49,50,99
22790,ElliotBayTrailMyrtlePark,08/07/2016 02:00:00 PM,48,-122,56,51,107
22791,ElliotBayTrailMyrtlePark,08/07/2016 03:00:00 PM,48,-122,62,43,105
22792,ElliotBayTrailMyrtlePark,08/07/2016 04:00:00 PM,48,-122,50,32,82
22793,ElliotBayTrailMyrtlePark,08/07/2016 05:00:00 PM,48,-122,48,46,94
22794,ElliotBayTrailMyrtlePark,08/07/2016 06:00:00 PM,48,-122,37,34,71
22795,ElliotBayTrailMyrtlePark,08/07/2016 07:00:00 PM,48,-122,17,22,39
22796,ElliotBayTrailMyrtlePark,08/07/2016 08:00:00 PM,48,-122,0,0,0
22797,ElliotBayTrailMyrtlePark,08/07/2016 09:00:00 PM,48,-122,8,8,16
22798,ElliotBayTrailMyrtlePark,08/07/2016 10:00:00 PM,48,-122,3,4,7
22799,ElliotBayTrailMyrtlePark,08/07/2016 11:00:00 PM,48,-122,0,0,0
22800,ElliotBayTrailMyrtlePark,08/08/2016 12:00:00 AM,48,-122,2,0,2
22801,ElliotBayTrailMyrtlePark,08/08/2016 01:00:00 AM,48,-122,0,0,0
22802,ElliotBayTrailMyrtlePark,08/08/2016 02:00:00 AM,48,-122,2,0,2
22803,ElliotBayTrailMyrtlePark,08/08/2016 03:00:00 AM,48,-122,0,0,0
22804,ElliotBayTrailMyrtlePark,08/08/2016 04:00:00 AM,48,-122,4,0,4
22805,ElliotBayTrailMyrtlePark,08/08/2016 05:00:00 AM,48,-122,17,29,46
22806,ElliotBayTrailMyrtlePark,08/08/2016 06:00:00 AM,48,-122,27,48,75
22807,ElliotBayTrailMyrtlePark,08/08/2016 07:00:00 AM,48,-122,40,143,183
22808,ElliotBayTrailMyrtlePark,08/08/2016 08:00:00 AM,48,-122,39,110,149
22809,ElliotBayTrailMyrtlePark,08/08/2016 09:00:00 AM,48,-122,21,36,57
22810,ElliotBayTrailMyrtlePark,08/08/2016 10:00:00 AM,48,-122,12,14,26
22811,ElliotBayTrailMyrtlePark,08/08/2016 11:00:00 AM,48,-122,25,27,52
22812,ElliotBayTrailMyrtlePark,08/08/2016 12:00:00 PM,48,-122,11,13,24
22813,ElliotBayTrailMyrtlePark,08/08/2016 01:00:00 PM,48,-122,14,21,35
22814,ElliotBayTrailMyrtlePark,08/08/2016 02:00:00 PM,48,-122,20,22,42
22815,ElliotBayTrailMyrtlePark,08/08/2016 03:00:00 PM,48,-122,62,53,115
22816,ElliotBayTrailMyrtlePark,08/08/2016 04:00:00 PM,48,-122,167,87,254
22817,ElliotBayTrailMyrtlePark,08/08/2016 05:00:00 PM,48,-122,154,74,228
22818,ElliotBayTrailMyrtlePark,08/08/2016 06:00:00 PM,48,-122,72,41,113
22819,ElliotBayTrailMyrtlePark,08/08/2016 07:00:00 PM,48,-122,46,43,89
22820,ElliotBayTrailMyrtlePark,08/08/2016 08:00:00 PM,48,-122,7,11,18
22821,ElliotBayTrailMyrtlePark,08/08/2016 09:00:00 PM,48,-122,17,4,21
22822,ElliotBayTrailMyrtlePark,08/08/2016 10:00:00 PM,48,-122,4,0,4
22823,ElliotBayTrailMyrtlePark,08/08/2016 11:00:00 PM,48,-122,4,0,4
22824,ElliotBayTrailMyrtlePark,08/09/2016 12:00:00 AM,48,-122,0,0,0
22825,ElliotBayTrailMyrtlePark,08/09/2016 01:00:00 AM,48,-122,1,0,1
22826,ElliotBayTrailMyrtlePark,08/09/2016 02:00:00 AM,48,-122,4,0,4
22827,ElliotBayTrailMyrtlePark,08/09/2016 03:00:00 AM,48,-122,0,0,0
22828,ElliotBayTrailMyrtlePark,08/09/2016 04:00:00 AM,48,-122,3,3,6
22829,ElliotBayTrailMyrtlePark,08/09/2016 05:00:00 AM,48,-122,19,30,49
22830,ElliotBayTrailMyrtlePark,08/09/2016 06:00:00 AM,48,-122,31,64,95
22831,ElliotBayTrailMyrtlePark,08/09/2016 07:00:00 AM,48,-122,42,171,213
22832,ElliotBayTrailMyrtlePark,08/09/2016 08:00:00 AM,48,-122,39,115,154
22833,ElliotBayTrailMyrtlePark,08/09/2016 09:00:00 AM,48,-122,16,35,51
22834,ElliotBayTrailMyrtlePark,08/09/2016 10:00:00 AM,48,-122,22,29,51
22835,ElliotBayTrailMyrtlePark,08/09/2016 11:00:00 AM,48,-122,18,32,50
22836,ElliotBayTrailMyrtlePark,08/09/2016 12:00:00 PM,48,-122,27,20,47
22837,ElliotBayTrailMyrtlePark,08/09/2016 01:00:00 PM,48,-122,39,24,63
22838,ElliotBayTrailMyrtlePark,08/09/2016 02:00:00 PM,48,-122,37,30,67
22839,ElliotBayTrailMyrtlePark,08/09/2016 03:00:00 PM,48,-122,70,63,133
22840,ElliotBayTrailMyrtlePark,08/09/2016 04:00:00 PM,48,-122,166,76,242
22841,ElliotBayTrailMyrtlePark,08/09/2016 05:00:00 PM,48,-122,178,66,244
22842,ElliotBayTrailMyrtlePark,08/09/2016 06:00:00 PM,48,-122,71,43,114
22843,ElliotBayTrailMyrtlePark,08/09/2016 07:00:00 PM,48,-122,32,15,47
22844,ElliotBayTrailMyrtlePark,08/09/2016 08:00:00 PM,48,-122,8,13,21
22845,ElliotBayTrailMyrtlePark,08/09/2016 09:00:00 PM,48,-122,3,4,7
22846,ElliotBayTrailMyrtlePark,08/09/2016 10:00:00 PM,48,-122,5,2,7
22847,ElliotBayTrailMyrtlePark,08/09/2016 11:00:00 PM,48,-122,4,0,4
22848,ElliotBayTrailMyrtlePark,08/10/2016 12:00:00 AM,48,-122,3,0,3
22849,ElliotBayTrailMyrtlePark,08/10/2016 01:00:00 AM,48,-122,3,0,3
22850,ElliotBayTrailMyrtlePark,08/10/2016 02:00:00 AM,48,-122,2,0,2
22851,ElliotBayTrailMyrtlePark,08/10/2016 03:00:00 AM,48,-122,1,0,1
22852,ElliotBayTrailMyrtlePark,08/10/2016 04:00:00 AM,48,-122,3,3,6
22853,ElliotBayTrailMyrtlePark,08/10/2016 05:00:00 AM,48,-122,13,24,37
22854,ElliotBayTrailMyrtlePark,08/10/2016 06:00:00 AM,48,-122,32,70,102
22855,ElliotBayTrailMyrtlePark,08/10/2016 07:00:00 AM,48,-122,41,177,218
22856,ElliotBayTrailMyrtlePark,08/10/2016 08:00:00 AM,48,-122,47,110,157
22857,ElliotBayTrailMyrtlePark,08/10/2016 09:00:00 AM,48,-122,26,51,77
22858,ElliotBayTrailMyrtlePark,08/10/2016 10:00:00 AM,48,-122,16,33,49
22859,ElliotBayTrailMyrtlePark,08/10/2016 11:00:00 AM,48,-122,36,28,64
22860,ElliotBayTrailMyrtlePark,08/10/2016 12:00:00 PM,48,-122,25,31,56
22861,ElliotBayTrailMyrtlePark,08/10/2016 01:00:00 PM,48,-122,57,36,93
22862,ElliotBayTrailMyrtlePark,08/10/2016 02:00:00 PM,48,-122,46,54,100
22863,ElliotBayTrailMyrtlePark,08/10/2016 03:00:00 PM,48,-122,68,50,118
22864,ElliotBayTrailMyrtlePark,08/10/2016 04:00:00 PM,48,-122,201,78,279
22865,ElliotBayTrailMyrtlePark,08/10/2016 05:00:00 PM,48,-122,197,78,275
22866,ElliotBayTrailMyrtlePark,08/10/2016 06:00:00 PM,48,-122,91,63,154
22867,ElliotBayTrailMyrtlePark,08/10/2016 07:00:00 PM,48,-122,43,34,77
22868,ElliotBayTrailMyrtlePark,08/10/2016 08:00:00 PM,48,-122,16,9,25
22869,ElliotBayTrailMyrtlePark,08/10/2016 09:00:00 PM,48,-122,8,15,23
22870,ElliotBayTrailMyrtlePark,08/10/2016 10:00:00 PM,48,-122,17,5,22
22871,ElliotBayTrailMyrtlePark,08/10/2016 11:00:00 PM,48,-122,4,0,4
22872,ElliotBayTrailMyrtlePark,08/11/2016 12:00:00 AM,48,-122,0,0,0
22873,ElliotBayTrailMyrtlePark,08/11/2016 01:00:00 AM,48,-122,0,0,0
22874,ElliotBayTrailMyrtlePark,08/11/2016 02:00:00 AM,48,-122,2,0,2
22875,ElliotBayTrailMyrtlePark,08/11/2016 03:00:00 AM,48,-122,1,0,1
22876,ElliotBayTrailMyrtlePark,08/11/2016 04:00:00 AM,48,-122,5,3,8
22877,ElliotBayTrailMyrtlePark,08/11/2016 05:00:00 AM,48,-122,15,27,42
22878,ElliotBayTrailMyrtlePark,08/11/2016 06:00:00 AM,48,-122,40,67,107
22879,ElliotBayTrailMyrtlePark,08/11/2016 07:00:00 AM,48,-122,47,159,206
22880,ElliotBayTrailMyrtlePark,08/11/2016 08:00:00 AM,48,-122,56,124,180
22881,ElliotBayTrailMyrtlePark,08/11/2016 09:00:00 AM,48,-122,36,52,88
22882,ElliotBayTrailMyrtlePark,08/11/2016 10:00:00 AM,48,-122,20,42,62
22883,ElliotBayTrailMyrtlePark,08/11/2016 11:00:00 AM,48,-122,27,28,55
22884,ElliotBayTrailMyrtlePark,08/11/2016 12:00:00 PM,48,-122,34,37,71
22885,ElliotBayTrailMyrtlePark,08/11/2016 01:00:00 PM,48,-122,38,26,64
22886,ElliotBayTrailMyrtlePark,08/11/2016 02:00:00 PM,48,-122,53,49,102
22887,ElliotBayTrailMyrtlePark,08/11/2016 03:00:00 PM,48,-122,76,52,128
22888,ElliotBayTrailMyrtlePark,08/11/2016 04:00:00 PM,48,-122,171,77,248
22889,ElliotBayTrailMyrtlePark,08/11/2016 05:00:00 PM,48,-122,187,125,312
22890,ElliotBayTrailMyrtlePark,08/11/2016 06:00:00 PM,48,-122,106,56,162
22891,ElliotBayTrailMyrtlePark,08/11/2016 07:00:00 PM,48,-122,115,36,151
22892,ElliotBayTrailMyrtlePark,08/11/2016 08:00:00 PM,48,-122,31,21,52
22893,ElliotBayTrailMyrtlePark,08/11/2016 09:00:00 PM,48,-122,9,12,21
22894,ElliotBayTrailMyrtlePark,08/11/2016 10:00:00 PM,48,-122,11,8,19
22895,ElliotBayTrailMyrtlePark,08/11/2016 11:00:00 PM,48,-122,4,9,13
22896,ElliotBayTrailMyrtlePark,08/12/2016 12:00:00 AM,48,-122,3,1,4
22897,ElliotBayTrailMyrtlePark,08/12/2016 01:00:00 AM,48,-122,1,5,6
22898,ElliotBayTrailMyrtlePark,08/12/2016 02:00:00 AM,48,-122,1,0,1
22899,ElliotBayTrailMyrtlePark,08/12/2016 03:00:00 AM,48,-122,0,0,0
22900,ElliotBayTrailMyrtlePark,08/12/2016 04:00:00 AM,48,-122,2,3,5
22901,ElliotBayTrailMyrtlePark,08/12/2016 05:00:00 AM,48,-122,15,27,42
22902,ElliotBayTrailMyrtlePark,08/12/2016 06:00:00 AM,48,-122,36,62,98
22903,ElliotBayTrailMyrtlePark,08/12/2016 07:00:00 AM,48,-122,41,138,179
22904,ElliotBayTrailMyrtlePark,08/12/2016 08:00:00 AM,48,-122,51,94,145
22905,ElliotBayTrailMyrtlePark,08/12/2016 09:00:00 AM,48,-122,27,45,72
22906,ElliotBayTrailMyrtlePark,08/12/2016 10:00:00 AM,48,-122,26,36,62
22907,ElliotBayTrailMyrtlePark,08/12/2016 11:00:00 AM,48,-122,21,28,49
22908,ElliotBayTrailMyrtlePark,08/12/2016 12:00:00 PM,48,-122,35,42,77
22909,ElliotBayTrailMyrtlePark,08/12/2016 01:00:00 PM,48,-122,51,38,89
22910,ElliotBayTrailMyrtlePark,08/12/2016 02:00:00 PM,48,-122,64,43,107
22911,ElliotBayTrailMyrtlePark,08/12/2016 03:00:00 PM,48,-122,96,58,154
22912,ElliotBayTrailMyrtlePark,08/12/2016 04:00:00 PM,48,-122,150,71,221
22913,ElliotBayTrailMyrtlePark,08/12/2016 05:00:00 PM,48,-122,153,57,210
22914,ElliotBayTrailMyrtlePark,08/12/2016 06:00:00 PM,48,-122,61,26,87
22915,ElliotBayTrailMyrtlePark,08/12/2016 07:00:00 PM,48,-122,35,40,75
22916,ElliotBayTrailMyrtlePark,08/12/2016 08:00:00 PM,48,-122,11,15,26
22917,ElliotBayTrailMyrtlePark,08/12/2016 09:00:00 PM,48,-122,9,7,16
22918,ElliotBayTrailMyrtlePark,08/12/2016 10:00:00 PM,48,-122,3,5,8
22919,ElliotBayTrailMyrtlePark,08/12/2016 11:00:00 PM,48,-122,4,9,13
22920,ElliotBayTrailMyrtlePark,08/13/2016 12:00:00 AM,48,-122,4,2,6
22921,ElliotBayTrailMyrtlePark,08/13/2016 01:00:00 AM,48,-122,13,4,17
22922,ElliotBayTrailMyrtlePark,08/13/2016 02:00:00 AM,48,-122,1,1,2
22923,ElliotBayTrailMyrtlePark,08/13/2016 03:00:00 AM,48,-122,1,0,1
22924,ElliotBayTrailMyrtlePark,08/13/2016 04:00:00 AM,48,-122,1,2,3
22925,ElliotBayTrailMyrtlePark,08/13/2016 05:00:00 AM,48,-122,3,3,6
22926,ElliotBayTrailMyrtlePark,08/13/2016 06:00:00 AM,48,-122,7,20,27
22927,ElliotBayTrailMyrtlePark,08/13/2016 07:00:00 AM,48,-122,16,17,33
22928,ElliotBayTrailMyrtlePark,08/13/2016 08:00:00 AM,48,-122,28,36,64
22929,ElliotBayTrailMyrtlePark,08/13/2016 09:00:00 AM,48,-122,52,47,99
22930,ElliotBayTrailMyrtlePark,08/13/2016 10:00:00 AM,48,-122,73,64,137
22931,ElliotBayTrailMyrtlePark,08/13/2016 11:00:00 AM,48,-122,57,92,149
22932,ElliotBayTrailMyrtlePark,08/13/2016 12:00:00 PM,48,-122,75,85,160
22933,ElliotBayTrailMyrtlePark,08/13/2016 01:00:00 PM,48,-122,58,43,101
22934,ElliotBayTrailMyrtlePark,08/13/2016 02:00:00 PM,48,-122,67,75,142
22935,ElliotBayTrailMyrtlePark,08/13/2016 03:00:00 PM,48,-122,50,60,110
22936,ElliotBayTrailMyrtlePark,08/13/2016 04:00:00 PM,48,-122,53,26,79
22937,ElliotBayTrailMyrtlePark,08/13/2016 05:00:00 PM,48,-122,46,35,81
22938,ElliotBayTrailMyrtlePark,08/13/2016 06:00:00 PM,48,-122,45,24,69
22939,ElliotBayTrailMyrtlePark,08/13/2016 07:00:00 PM,48,-122,26,25,51
22940,ElliotBayTrailMyrtlePark,08/13/2016 08:00:00 PM,48,-122,21,10,31
22941,ElliotBayTrailMyrtlePark,08/13/2016 09:00:00 PM,48,-122,12,4,16
22942,ElliotBayTrailMyrtlePark,08/13/2016 10:00:00 PM,48,-122,2,1,3
22943,ElliotBayTrailMyrtlePark,08/13/2016 11:00:00 PM,48,-122,2,1,3
22944,ElliotBayTrailMyrtlePark,08/14/2016 12:00:00 AM,48,-122,2,0,2
22945,ElliotBayTrailMyrtlePark,08/14/2016 01:00:00 AM,48,-122,2,0,2
22946,ElliotBayTrailMyrtlePark,08/14/2016 02:00:00 AM,48,-122,3,1,4
22947,ElliotBayTrailMyrtlePark,08/14/2016 03:00:00 AM,48,-122,0,0,0
22948,ElliotBayTrailMyrtlePark,08/14/2016 04:00:00 AM,48,-122,0,1,1
22949,ElliotBayTrailMyrtlePark,08/14/2016 05:00:00 AM,48,-122,0,4,4
22950,ElliotBayTrailMyrtlePark,08/14/2016 06:00:00 AM,48,-122,10,7,17
22951,ElliotBayTrailMyrtlePark,08/14/2016 07:00:00 AM,48,-122,21,20,41
22952,ElliotBayTrailMyrtlePark,08/14/2016 08:00:00 AM,48,-122,42,42,84
22953,ElliotBayTrailMyrtlePark,08/14/2016 09:00:00 AM,48,-122,45,29,74
22954,ElliotBayTrailMyrtlePark,08/14/2016 10:00:00 AM,48,-122,69,67,136
22955,ElliotBayTrailMyrtlePark,08/14/2016 11:00:00 AM,48,-122,56,66,122
22956,ElliotBayTrailMyrtlePark,08/14/2016 12:00:00 PM,48,-122,72,63,135
22957,ElliotBayTrailMyrtlePark,08/14/2016 01:00:00 PM,48,-122,84,86,170
22958,ElliotBayTrailMyrtlePark,08/14/2016 02:00:00 PM,48,-122,84,81,165
22959,ElliotBayTrailMyrtlePark,08/14/2016 03:00:00 PM,48,-122,63,79,142
22960,ElliotBayTrailMyrtlePark,08/14/2016 04:00:00 PM,48,-122,52,64,116
22961,ElliotBayTrailMyrtlePark,08/14/2016 05:00:00 PM,48,-122,61,48,109
22962,ElliotBayTrailMyrtlePark,08/14/2016 06:00:00 PM,48,-122,94,35,129
22963,ElliotBayTrailMyrtlePark,08/14/2016 07:00:00 PM,48,-122,46,26,72
22964,ElliotBayTrailMyrtlePark,08/14/2016 08:00:00 PM,48,-122,8,9,17
22965,ElliotBayTrailMyrtlePark,08/14/2016 09:00:00 PM,48,-122,12,4,16
22966,ElliotBayTrailMyrtlePark,08/14/2016 10:00:00 PM,48,-122,1,7,8
22967,ElliotBayTrailMyrtlePark,08/14/2016 11:00:00 PM,48,-122,1,1,2
22968,ElliotBayTrailMyrtlePark,08/15/2016 12:00:00 AM,48,-122,2,0,2
22969,ElliotBayTrailMyrtlePark,08/15/2016 01:00:00 AM,48,-122,1,0,1
22970,ElliotBayTrailMyrtlePark,08/15/2016 02:00:00 AM,48,-122,7,0,7
22971,ElliotBayTrailMyrtlePark,08/15/2016 03:00:00 AM,48,-122,1,0,1
22972,ElliotBayTrailMyrtlePark,08/15/2016 04:00:00 AM,48,-122,5,4,9
22973,ElliotBayTrailMyrtlePark,08/15/2016 05:00:00 AM,48,-122,17,27,44
22974,ElliotBayTrailMyrtlePark,08/15/2016 06:00:00 AM,48,-122,36,68,104
22975,ElliotBayTrailMyrtlePark,08/15/2016 07:00:00 AM,48,-122,48,170,218
22976,ElliotBayTrailMyrtlePark,08/15/2016 08:00:00 AM,48,-122,38,128,166
22977,ElliotBayTrailMyrtlePark,08/15/2016 09:00:00 AM,48,-122,43,32,75
22978,ElliotBayTrailMyrtlePark,08/15/2016 10:00:00 AM,48,-122,30,25,55
22979,ElliotBayTrailMyrtlePark,08/15/2016 11:00:00 AM,48,-122,18,20,38
22980,ElliotBayTrailMyrtlePark,08/15/2016 12:00:00 PM,48,-122,20,29,49
22981,ElliotBayTrailMyrtlePark,08/15/2016 01:00:00 PM,48,-122,40,32,72
22982,ElliotBayTrailMyrtlePark,08/15/2016 02:00:00 PM,48,-122,38,45,83
22983,ElliotBayTrailMyrtlePark,08/15/2016 03:00:00 PM,48,-122,84,52,136
22984,ElliotBayTrailMyrtlePark,08/15/2016 04:00:00 PM,48,-122,190,74,264
22985,ElliotBayTrailMyrtlePark,08/15/2016 05:00:00 PM,48,-122,204,61,265
22986,ElliotBayTrailMyrtlePark,08/15/2016 06:00:00 PM,48,-122,94,43,137
22987,ElliotBayTrailMyrtlePark,08/15/2016 07:00:00 PM,48,-122,32,36,68
22988,ElliotBayTrailMyrtlePark,08/15/2016 08:00:00 PM,48,-122,16,17,33
22989,ElliotBayTrailMyrtlePark,08/15/2016 09:00:00 PM,48,-122,8,6,14
22990,ElliotBayTrailMyrtlePark,08/15/2016 10:00:00 PM,48,-122,5,1,6
22991,ElliotBayTrailMyrtlePark,08/15/2016 11:00:00 PM,48,-122,2,1,3
22992,ElliotBayTrailMyrtlePark,08/16/2016 12:00:00 AM,48,-122,1,4,5
22993,ElliotBayTrailMyrtlePark,08/16/2016 01:00:00 AM,48,-122,2,0,2
22994,ElliotBayTrailMyrtlePark,08/16/2016 02:00:00 AM,48,-122,6,2,8
22995,ElliotBayTrailMyrtlePark,08/16/2016 03:00:00 AM,48,-122,1,0,1
22996,ElliotBayTrailMyrtlePark,08/16/2016 04:00:00 AM,48,-122,3,4,7
22997,ElliotBayTrailMyrtlePark,08/16/2016 05:00:00 AM,48,-122,22,28,50
22998,ElliotBayTrailMyrtlePark,08/16/2016 06:00:00 AM,48,-122,33,75,108
22999,ElliotBayTrailMyrtlePark,08/16/2016 07:00:00 AM,48,-122,40,177,217
23000,ElliotBayTrailMyrtlePark,08/16/2016 08:00:00 AM,48,-122,49,123,172
23001,ElliotBayTrailMyrtlePark,08/16/2016 09:00:00 AM,48,-122,19,49,68
23002,ElliotBayTrailMyrtlePark,08/16/2016 10:00:00 AM,48,-122,26,38,64
23003,ElliotBayTrailMyrtlePark,08/16/2016 11:00:00 AM,48,-122,17,24,41
23004,ElliotBayTrailMyrtlePark,08/16/2016 12:00:00 PM,48,-122,37,22,59
23005,ElliotBayTrailMyrtlePark,08/16/2016 01:00:00 PM,48,-122,29,30,59
23006,ElliotBayTrailMyrtlePark,08/16/2016 02:00:00 PM,48,-122,45,51,96
23007,ElliotBayTrailMyrtlePark,08/16/2016 03:00:00 PM,48,-122,76,62,138
23008,ElliotBayTrailMyrtlePark,08/16/2016 04:00:00 PM,48,-122,163,70,233
23009,ElliotBayTrailMyrtlePark,08/16/2016 05:00:00 PM,48,-122,190,78,268
23010,ElliotBayTrailMyrtlePark,08/16/2016 06:00:00 PM,48,-122,96,51,147
23011,ElliotBayTrailMyrtlePark,08/16/2016 07:00:00 PM,48,-122,33,42,75
23012,ElliotBayTrailMyrtlePark,08/16/2016 08:00:00 PM,48,-122,13,16,29
23013,ElliotBayTrailMyrtlePark,08/16/2016 09:00:00 PM,48,-122,17,18,35
23014,ElliotBayTrailMyrtlePark,08/16/2016 10:00:00 PM,48,-122,4,0,4
23015,ElliotBayTrailMyrtlePark,08/16/2016 11:00:00 PM,48,-122,4,4,8
23016,ElliotBayTrailMyrtlePark,08/17/2016 12:00:00 AM,48,-122,2,5,7
23017,ElliotBayTrailMyrtlePark,08/17/2016 01:00:00 AM,48,-122,0,0,0
23018,ElliotBayTrailMyrtlePark,08/17/2016 02:00:00 AM,48,-122,1,0,1
23019,ElliotBayTrailMyrtlePark,08/17/2016 03:00:00 AM,48,-122,0,1,1
23020,ElliotBayTrailMyrtlePark,08/17/2016 04:00:00 AM,48,-122,2,4,6
23021,ElliotBayTrailMyrtlePark,08/17/2016 05:00:00 AM,48,-122,18,27,45
23022,ElliotBayTrailMyrtlePark,08/17/2016 06:00:00 AM,48,-122,38,68,106
23023,ElliotBayTrailMyrtlePark,08/17/2016 07:00:00 AM,48,-122,41,162,203
23024,ElliotBayTrailMyrtlePark,08/17/2016 08:00:00 AM,48,-122,44,109,153
23025,ElliotBayTrailMyrtlePark,08/17/2016 09:00:00 AM,48,-122,29,47,76
23026,ElliotBayTrailMyrtlePark,08/17/2016 10:00:00 AM,48,-122,40,36,76
23027,ElliotBayTrailMyrtlePark,08/17/2016 11:00:00 AM,48,-122,21,41,62
23028,ElliotBayTrailMyrtlePark,08/17/2016 12:00:00 PM,48,-122,26,34,60
23029,ElliotBayTrailMyrtlePark,08/17/2016 01:00:00 PM,48,-122,31,33,64
23030,ElliotBayTrailMyrtlePark,08/17/2016 02:00:00 PM,48,-122,42,36,78
23031,ElliotBayTrailMyrtlePark,08/17/2016 03:00:00 PM,48,-122,64,52,116
23032,ElliotBayTrailMyrtlePark,08/17/2016 04:00:00 PM,48,-122,139,85,224
23033,ElliotBayTrailMyrtlePark,08/17/2016 05:00:00 PM,48,-122,176,66,242
23034,ElliotBayTrailMyrtlePark,08/17/2016 06:00:00 PM,48,-122,107,41,148
23035,ElliotBayTrailMyrtlePark,08/17/2016 07:00:00 PM,48,-122,74,33,107
23036,ElliotBayTrailMyrtlePark,08/17/2016 08:00:00 PM,48,-122,11,20,31
23037,ElliotBayTrailMyrtlePark,08/17/2016 09:00:00 PM,48,-122,8,12,20
23038,ElliotBayTrailMyrtlePark,08/17/2016 10:00:00 PM,48,-122,4,4,8
23039,ElliotBayTrailMyrtlePark,08/17/2016 11:00:00 PM,48,-122,4,1,5
23040,ElliotBayTrailMyrtlePark,08/18/2016 12:00:00 AM,48,-122,2,0,2
23041,ElliotBayTrailMyrtlePark,08/18/2016 01:00:00 AM,48,-122,0,0,0
23042,ElliotBayTrailMyrtlePark,08/18/2016 02:00:00 AM,48,-122,1,0,1
23043,ElliotBayTrailMyrtlePark,08/18/2016 03:00:00 AM,48,-122,1,0,1
23044,ElliotBayTrailMyrtlePark,08/18/2016 04:00:00 AM,48,-122,4,3,7
23045,ElliotBayTrailMyrtlePark,08/18/2016 05:00:00 AM,48,-122,13,22,35
23046,ElliotBayTrailMyrtlePark,08/18/2016 06:00:00 AM,48,-122,35,55,90
23047,ElliotBayTrailMyrtlePark,08/18/2016 07:00:00 AM,48,-122,32,136,168
23048,ElliotBayTrailMyrtlePark,08/18/2016 08:00:00 AM,48,-122,43,91,134
23049,ElliotBayTrailMyrtlePark,08/18/2016 09:00:00 AM,48,-122,21,46,67
23050,ElliotBayTrailMyrtlePark,08/18/2016 10:00:00 AM,48,-122,20,44,64
23051,ElliotBayTrailMyrtlePark,08/18/2016 11:00:00 AM,48,-122,23,25,48
23052,ElliotBayTrailMyrtlePark,08/18/2016 12:00:00 PM,48,-122,24,43,67
23053,ElliotBayTrailMyrtlePark,08/18/2016 01:00:00 PM,48,-122,39,38,77
23054,ElliotBayTrailMyrtlePark,08/18/2016 02:00:00 PM,48,-122,29,24,53
23055,ElliotBayTrailMyrtlePark,08/18/2016 03:00:00 PM,48,-122,55,39,94
23056,ElliotBayTrailMyrtlePark,08/18/2016 04:00:00 PM,48,-122,141,63,204
23057,ElliotBayTrailMyrtlePark,08/18/2016 05:00:00 PM,48,-122,144,51,195
23058,ElliotBayTrailMyrtlePark,08/18/2016 06:00:00 PM,48,-122,74,56,130
23059,ElliotBayTrailMyrtlePark,08/18/2016 07:00:00 PM,48,-122,40,42,82
23060,ElliotBayTrailMyrtlePark,08/18/2016 08:00:00 PM,48,-122,21,28,49
23061,ElliotBayTrailMyrtlePark,08/18/2016 09:00:00 PM,48,-122,14,12,26
23062,ElliotBayTrailMyrtlePark,08/18/2016 10:00:00 PM,48,-122,15,7,22
23063,ElliotBayTrailMyrtlePark,08/18/2016 11:00:00 PM,48,-122,5,7,12
23064,ElliotBayTrailMyrtlePark,08/19/2016 12:00:00 AM,48,-122,2,3,5
23065,ElliotBayTrailMyrtlePark,08/19/2016 01:00:00 AM,48,-122,3,0,3
23066,ElliotBayTrailMyrtlePark,08/19/2016 02:00:00 AM,48,-122,3,3,6
23067,ElliotBayTrailMyrtlePark,08/19/2016 03:00:00 AM,48,-122,1,0,1
23068,ElliotBayTrailMyrtlePark,08/19/2016 04:00:00 AM,48,-122,3,7,10
23069,ElliotBayTrailMyrtlePark,08/19/2016 05:00:00 AM,48,-122,10,20,30
23070,ElliotBayTrailMyrtlePark,08/19/2016 06:00:00 AM,48,-122,17,48,65
23071,ElliotBayTrailMyrtlePark,08/19/2016 07:00:00 AM,48,-122,37,101,138
23072,ElliotBayTrailMyrtlePark,08/19/2016 08:00:00 AM,48,-122,57,82,139
23073,ElliotBayTrailMyrtlePark,08/19/2016 09:00:00 AM,48,-122,18,45,63
23074,ElliotBayTrailMyrtlePark,08/19/2016 10:00:00 AM,48,-122,23,18,41
23075,ElliotBayTrailMyrtlePark,08/19/2016 11:00:00 AM,48,-122,34,17,51
23076,ElliotBayTrailMyrtlePark,08/19/2016 12:00:00 PM,48,-122,33,19,52
23077,ElliotBayTrailMyrtlePark,08/19/2016 01:00:00 PM,48,-122,27,23,50
23078,ElliotBayTrailMyrtlePark,08/19/2016 02:00:00 PM,48,-122,20,24,44
23079,ElliotBayTrailMyrtlePark,08/19/2016 03:00:00 PM,48,-122,16,16,32
23080,ElliotBayTrailMyrtlePark,08/19/2016 04:00:00 PM,48,-122,16,23,39
23081,ElliotBayTrailMyrtlePark,08/19/2016 05:00:00 PM,48,-122,32,36,68
23082,ElliotBayTrailMyrtlePark,08/19/2016 06:00:00 PM,48,-122,22,10,32
23083,ElliotBayTrailMyrtlePark,08/19/2016 07:00:00 PM,48,-122,6,25,31
23084,ElliotBayTrailMyrtlePark,08/19/2016 08:00:00 PM,48,-122,1,14,15
23085,ElliotBayTrailMyrtlePark,08/19/2016 09:00:00 PM,48,-122,7,10,17
23086,ElliotBayTrailMyrtlePark,08/19/2016 10:00:00 PM,48,-122,2,6,8
23087,ElliotBayTrailMyrtlePark,08/19/2016 11:00:00 PM,48,-122,2,1,3
23088,ElliotBayTrailMyrtlePark,08/20/2016 12:00:00 AM,48,-122,5,7,12
23089,ElliotBayTrailMyrtlePark,08/20/2016 01:00:00 AM,48,-122,0,0,0
23090,ElliotBayTrailMyrtlePark,08/20/2016 02:00:00 AM,48,-122,1,11,12
23091,ElliotBayTrailMyrtlePark,08/20/2016 03:00:00 AM,48,-122,0,0,0
23092,ElliotBayTrailMyrtlePark,08/20/2016 04:00:00 AM,48,-122,0,2,2
23093,ElliotBayTrailMyrtlePark,08/20/2016 05:00:00 AM,48,-122,0,2,2
23094,ElliotBayTrailMyrtlePark,08/20/2016 06:00:00 AM,48,-122,13,13,26
23095,ElliotBayTrailMyrtlePark,08/20/2016 07:00:00 AM,48,-122,23,22,45
23096,ElliotBayTrailMyrtlePark,08/20/2016 08:00:00 AM,48,-122,33,44,77
23097,ElliotBayTrailMyrtlePark,08/20/2016 09:00:00 AM,48,-122,27,18,45
23098,ElliotBayTrailMyrtlePark,08/20/2016 10:00:00 AM,48,-122,32,41,73
23099,ElliotBayTrailMyrtlePark,08/20/2016 11:00:00 AM,48,-122,21,12,33
23100,ElliotBayTrailMyrtlePark,08/20/2016 12:00:00 PM,48,-122,22,25,47
23101,ElliotBayTrailMyrtlePark,08/20/2016 01:00:00 PM,48,-122,24,17,41
23102,ElliotBayTrailMyrtlePark,08/20/2016 02:00:00 PM,48,-122,23,21,44
23103,ElliotBayTrailMyrtlePark,08/20/2016 03:00:00 PM,48,-122,14,8,22
23104,ElliotBayTrailMyrtlePark,08/20/2016 04:00:00 PM,48,-122,18,17,35
23105,ElliotBayTrailMyrtlePark,08/20/2016 05:00:00 PM,48,-122,17,25,42
23106,ElliotBayTrailMyrtlePark,08/20/2016 06:00:00 PM,48,-122,10,16,26
23107,ElliotBayTrailMyrtlePark,08/20/2016 07:00:00 PM,48,-122,8,32,40
23108,ElliotBayTrailMyrtlePark,08/20/2016 08:00:00 PM,48,-122,4,8,12
23109,ElliotBayTrailMyrtlePark,08/20/2016 09:00:00 PM,48,-122,8,6,14
23110,ElliotBayTrailMyrtlePark,08/20/2016 10:00:00 PM,48,-122,0,5,5
23111,ElliotBayTrailMyrtlePark,08/20/2016 11:00:00 PM,48,-122,3,0,3
23112,ElliotBayTrailMyrtlePark,08/21/2016 12:00:00 AM,48,-122,4,3,7
23113,ElliotBayTrailMyrtlePark,08/21/2016 01:00:00 AM,48,-122,9,3,12
23114,ElliotBayTrailMyrtlePark,08/21/2016 02:00:00 AM,48,-122,0,10,10
23115,ElliotBayTrailMyrtlePark,08/21/2016 03:00:00 AM,48,-122,2,0,2
23116,ElliotBayTrailMyrtlePark,08/21/2016 04:00:00 AM,48,-122,1,3,4
23117,ElliotBayTrailMyrtlePark,08/21/2016 05:00:00 AM,48,-122,2,5,7
23118,ElliotBayTrailMyrtlePark,08/21/2016 06:00:00 AM,48,-122,2,2,4
23119,ElliotBayTrailMyrtlePark,08/21/2016 07:00:00 AM,48,-122,7,17,24
23120,ElliotBayTrailMyrtlePark,08/21/2016 08:00:00 AM,48,-122,7,23,30
23121,ElliotBayTrailMyrtlePark,08/21/2016 09:00:00 AM,48,-122,20,14,34
23122,ElliotBayTrailMyrtlePark,08/21/2016 10:00:00 AM,48,-122,36,24,60
23123,ElliotBayTrailMyrtlePark,08/21/2016 11:00:00 AM,48,-122,25,15,40
23124,ElliotBayTrailMyrtlePark,08/21/2016 12:00:00 PM,48,-122,25,21,46
23125,ElliotBayTrailMyrtlePark,08/21/2016 01:00:00 PM,48,-122,21,13,34
23126,ElliotBayTrailMyrtlePark,08/21/2016 02:00:00 PM,48,-122,25,16,41
23127,ElliotBayTrailMyrtlePark,08/21/2016 03:00:00 PM,48,-122,20,25,45
23128,ElliotBayTrailMyrtlePark,08/21/2016 04:00:00 PM,48,-122,22,14,36
23129,ElliotBayTrailMyrtlePark,08/21/2016 05:00:00 PM,48,-122,23,27,50
23130,ElliotBayTrailMyrtlePark,08/21/2016 06:00:00 PM,48,-122,23,29,52
23131,ElliotBayTrailMyrtlePark,08/21/2016 07:00:00 PM,48,-122,11,32,43
23132,ElliotBayTrailMyrtlePark,08/21/2016 08:00:00 PM,48,-122,10,10,20
23133,ElliotBayTrailMyrtlePark,08/21/2016 09:00:00 PM,48,-122,8,55,63
23134,ElliotBayTrailMyrtlePark,08/21/2016 10:00:00 PM,48,-122,12,33,45
23135,ElliotBayTrailMyrtlePark,08/21/2016 11:00:00 PM,48,-122,1,12,13
23136,ElliotBayTrailMyrtlePark,08/22/2016 12:00:00 AM,48,-122,5,4,9
23137,ElliotBayTrailMyrtlePark,08/22/2016 01:00:00 AM,48,-122,2,0,2
23138,ElliotBayTrailMyrtlePark,08/22/2016 02:00:00 AM,48,-122,0,7,7
23139,ElliotBayTrailMyrtlePark,08/22/2016 03:00:00 AM,48,-122,1,7,8
23140,ElliotBayTrailMyrtlePark,08/22/2016 04:00:00 AM,48,-122,6,7,13
23141,ElliotBayTrailMyrtlePark,08/22/2016 05:00:00 AM,48,-122,10,31,41
23142,ElliotBayTrailMyrtlePark,08/22/2016 06:00:00 AM,48,-122,37,48,85
23143,ElliotBayTrailMyrtlePark,08/22/2016 07:00:00 AM,48,-122,46,147,193
23144,ElliotBayTrailMyrtlePark,08/22/2016 08:00:00 AM,48,-122,44,128,172
23145,ElliotBayTrailMyrtlePark,08/22/2016 09:00:00 AM,48,-122,21,30,51
23146,ElliotBayTrailMyrtlePark,08/22/2016 10:00:00 AM,48,-122,18,29,47
23147,ElliotBayTrailMyrtlePark,08/22/2016 11:00:00 AM,48,-122,17,27,44
23148,ElliotBayTrailMyrtlePark,08/22/2016 12:00:00 PM,48,-122,18,20,38
23149,ElliotBayTrailMyrtlePark,08/22/2016 01:00:00 PM,48,-122,19,19,38
23150,ElliotBayTrailMyrtlePark,08/22/2016 02:00:00 PM,48,-122,40,40,80
23151,ElliotBayTrailMyrtlePark,08/22/2016 03:00:00 PM,48,-122,70,42,112
23152,ElliotBayTrailMyrtlePark,08/22/2016 04:00:00 PM,48,-122,146,69,215
23153,ElliotBayTrailMyrtlePark,08/22/2016 05:00:00 PM,48,-122,178,74,252
23154,ElliotBayTrailMyrtlePark,08/22/2016 06:00:00 PM,48,-122,83,43,126
23155,ElliotBayTrailMyrtlePark,08/22/2016 07:00:00 PM,48,-122,46,32,78
23156,ElliotBayTrailMyrtlePark,08/22/2016 08:00:00 PM,48,-122,8,21,29
23157,ElliotBayTrailMyrtlePark,08/22/2016 09:00:00 PM,48,-122,5,7,12
23158,ElliotBayTrailMyrtlePark,08/22/2016 10:00:00 PM,48,-122,10,0,10
23159,ElliotBayTrailMyrtlePark,08/22/2016 11:00:00 PM,48,-122,1,4,5
23160,ElliotBayTrailMyrtlePark,08/23/2016 12:00:00 AM,48,-122,2,0,2
23161,ElliotBayTrailMyrtlePark,08/23/2016 01:00:00 AM,48,-122,2,3,5
23162,ElliotBayTrailMyrtlePark,08/23/2016 02:00:00 AM,48,-122,1,0,1
23163,ElliotBayTrailMyrtlePark,08/23/2016 03:00:00 AM,48,-122,0,0,0
23164,ElliotBayTrailMyrtlePark,08/23/2016 04:00:00 AM,48,-122,5,3,8
23165,ElliotBayTrailMyrtlePark,08/23/2016 05:00:00 AM,48,-122,15,22,37
23166,ElliotBayTrailMyrtlePark,08/23/2016 06:00:00 AM,48,-122,41,64,105
23167,ElliotBayTrailMyrtlePark,08/23/2016 07:00:00 AM,48,-122,64,197,261
23168,ElliotBayTrailMyrtlePark,08/23/2016 08:00:00 AM,48,-122,41,115,156
23169,ElliotBayTrailMyrtlePark,08/23/2016 09:00:00 AM,48,-122,38,44,82
23170,ElliotBayTrailMyrtlePark,08/23/2016 10:00:00 AM,48,-122,13,35,48
23171,ElliotBayTrailMyrtlePark,08/23/2016 11:00:00 AM,48,-122,21,25,46
23172,ElliotBayTrailMyrtlePark,08/23/2016 12:00:00 PM,48,-122,20,34,54
23173,ElliotBayTrailMyrtlePark,08/23/2016 01:00:00 PM,48,-122,24,35,59
23174,ElliotBayTrailMyrtlePark,08/23/2016 02:00:00 PM,48,-122,47,45,92
23175,ElliotBayTrailMyrtlePark,08/23/2016 03:00:00 PM,48,-122,61,48,109
23176,ElliotBayTrailMyrtlePark,08/23/2016 04:00:00 PM,48,-122,180,93,273
23177,ElliotBayTrailMyrtlePark,08/23/2016 05:00:00 PM,48,-122,204,64,268
23178,ElliotBayTrailMyrtlePark,08/23/2016 06:00:00 PM,48,-122,86,52,138
23179,ElliotBayTrailMyrtlePark,08/23/2016 07:00:00 PM,48,-122,40,47,87
23180,ElliotBayTrailMyrtlePark,08/23/2016 08:00:00 PM,48,-122,10,6,16
23181,ElliotBayTrailMyrtlePark,08/23/2016 09:00:00 PM,48,-122,9,4,13
23182,ElliotBayTrailMyrtlePark,08/23/2016 10:00:00 PM,48,-122,6,3,9
23183,ElliotBayTrailMyrtlePark,08/23/2016 11:00:00 PM,48,-122,5,1,6
23184,ElliotBayTrailMyrtlePark,08/24/2016 12:00:00 AM,48,-122,4,2,6
23185,ElliotBayTrailMyrtlePark,08/24/2016 01:00:00 AM,48,-122,1,0,1
23186,ElliotBayTrailMyrtlePark,08/24/2016 02:00:00 AM,48,-122,0,1,1
23187,ElliotBayTrailMyrtlePark,08/24/2016 03:00:00 AM,48,-122,1,0,1
23188,ElliotBayTrailMyrtlePark,08/24/2016 04:00:00 AM,48,-122,5,6,11
23189,ElliotBayTrailMyrtlePark,08/24/2016 05:00:00 AM,48,-122,20,24,44
23190,ElliotBayTrailMyrtlePark,08/24/2016 06:00:00 AM,48,-122,31,75,106
23191,ElliotBayTrailMyrtlePark,08/24/2016 07:00:00 AM,48,-122,45,187,232
23192,ElliotBayTrailMyrtlePark,08/24/2016 08:00:00 AM,48,-122,49,121,170
23193,ElliotBayTrailMyrtlePark,08/24/2016 09:00:00 AM,48,-122,35,42,77
23194,ElliotBayTrailMyrtlePark,08/24/2016 10:00:00 AM,48,-122,24,30,54
23195,ElliotBayTrailMyrtlePark,08/24/2016 11:00:00 AM,48,-122,27,38,65
23196,ElliotBayTrailMyrtlePark,08/24/2016 12:00:00 PM,48,-122,21,38,59
23197,ElliotBayTrailMyrtlePark,08/24/2016 01:00:00 PM,48,-122,37,29,66
23198,ElliotBayTrailMyrtlePark,08/24/2016 02:00:00 PM,48,-122,43,30,73
23199,ElliotBayTrailMyrtlePark,08/24/2016 03:00:00 PM,48,-122,90,55,145
23200,ElliotBayTrailMyrtlePark,08/24/2016 04:00:00 PM,48,-122,202,73,275
23201,ElliotBayTrailMyrtlePark,08/24/2016 05:00:00 PM,48,-122,181,54,235
23202,ElliotBayTrailMyrtlePark,08/24/2016 06:00:00 PM,48,-122,94,47,141
23203,ElliotBayTrailMyrtlePark,08/24/2016 07:00:00 PM,48,-122,44,38,82
23204,ElliotBayTrailMyrtlePark,08/24/2016 08:00:00 PM,48,-122,22,13,35
23205,ElliotBayTrailMyrtlePark,08/24/2016 09:00:00 PM,48,-122,8,7,15
23206,ElliotBayTrailMyrtlePark,08/24/2016 10:00:00 PM,48,-122,0,4,4
23207,ElliotBayTrailMyrtlePark,08/24/2016 11:00:00 PM,48,-122,2,2,4
23208,ElliotBayTrailMyrtlePark,08/25/2016 12:00:00 AM,48,-122,1,0,1
23209,ElliotBayTrailMyrtlePark,08/25/2016 01:00:00 AM,48,-122,0,0,0
23210,ElliotBayTrailMyrtlePark,08/25/2016 02:00:00 AM,48,-122,1,0,1
23211,ElliotBayTrailMyrtlePark,08/25/2016 03:00:00 AM,48,-122,0,2,2
23212,ElliotBayTrailMyrtlePark,08/25/2016 04:00:00 AM,48,-122,6,4,10
23213,ElliotBayTrailMyrtlePark,08/25/2016 05:00:00 AM,48,-122,12,26,38
23214,ElliotBayTrailMyrtlePark,08/25/2016 06:00:00 AM,48,-122,37,66,103
23215,ElliotBayTrailMyrtlePark,08/25/2016 07:00:00 AM,48,-122,56,154,210
23216,ElliotBayTrailMyrtlePark,08/25/2016 08:00:00 AM,48,-122,48,118,166
23217,ElliotBayTrailMyrtlePark,08/25/2016 09:00:00 AM,48,-122,33,54,87
23218,ElliotBayTrailMyrtlePark,08/25/2016 10:00:00 AM,48,-122,29,30,59
23219,ElliotBayTrailMyrtlePark,08/25/2016 11:00:00 AM,48,-122,29,34,63
23220,ElliotBayTrailMyrtlePark,08/25/2016 12:00:00 PM,48,-122,30,54,84
23221,ElliotBayTrailMyrtlePark,08/25/2016 01:00:00 PM,48,-122,32,39,71
23222,ElliotBayTrailMyrtlePark,08/25/2016 02:00:00 PM,48,-122,40,39,79
23223,ElliotBayTrailMyrtlePark,08/25/2016 03:00:00 PM,48,-122,84,52,136
23224,ElliotBayTrailMyrtlePark,08/25/2016 04:00:00 PM,48,-122,165,91,256
23225,ElliotBayTrailMyrtlePark,08/25/2016 05:00:00 PM,48,-122,209,74,283
23226,ElliotBayTrailMyrtlePark,08/25/2016 06:00:00 PM,48,-122,88,30,118
23227,ElliotBayTrailMyrtlePark,08/25/2016 07:00:00 PM,48,-122,39,30,69
23228,ElliotBayTrailMyrtlePark,08/25/2016 08:00:00 PM,48,-122,12,15,27
23229,ElliotBayTrailMyrtlePark,08/25/2016 09:00:00 PM,48,-122,21,4,25
23230,ElliotBayTrailMyrtlePark,08/25/2016 10:00:00 PM,48,-122,12,4,16
23231,ElliotBayTrailMyrtlePark,08/25/2016 11:00:00 PM,48,-122,3,1,4
23232,ElliotBayTrailMyrtlePark,08/26/2016 12:00:00 AM,48,-122,0,2,2
23233,ElliotBayTrailMyrtlePark,08/26/2016 01:00:00 AM,48,-122,3,0,3
23234,ElliotBayTrailMyrtlePark,08/26/2016 02:00:00 AM,48,-122,0,0,0
23235,ElliotBayTrailMyrtlePark,08/26/2016 03:00:00 AM,48,-122,0,0,0
23236,ElliotBayTrailMyrtlePark,08/26/2016 04:00:00 AM,48,-122,3,4,7
23237,ElliotBayTrailMyrtlePark,08/26/2016 05:00:00 AM,48,-122,13,19,32
23238,ElliotBayTrailMyrtlePark,08/26/2016 06:00:00 AM,48,-122,30,52,82
23239,ElliotBayTrailMyrtlePark,08/26/2016 07:00:00 AM,48,-122,46,122,168
23240,ElliotBayTrailMyrtlePark,08/26/2016 08:00:00 AM,48,-122,37,98,135
23241,ElliotBayTrailMyrtlePark,08/26/2016 09:00:00 AM,48,-122,32,45,77
23242,ElliotBayTrailMyrtlePark,08/26/2016 10:00:00 AM,48,-122,31,24,55
23243,ElliotBayTrailMyrtlePark,08/26/2016 11:00:00 AM,48,-122,36,43,79
23244,ElliotBayTrailMyrtlePark,08/26/2016 12:00:00 PM,48,-122,33,37,70
23245,ElliotBayTrailMyrtlePark,08/26/2016 01:00:00 PM,48,-122,29,36,65
23246,ElliotBayTrailMyrtlePark,08/26/2016 02:00:00 PM,48,-122,65,48,113
23247,ElliotBayTrailMyrtlePark,08/26/2016 03:00:00 PM,48,-122,78,52,130
23248,ElliotBayTrailMyrtlePark,08/26/2016 04:00:00 PM,48,-122,138,66,204
23249,ElliotBayTrailMyrtlePark,08/26/2016 05:00:00 PM,48,-122,126,39,165
23250,ElliotBayTrailMyrtlePark,08/26/2016 06:00:00 PM,48,-122,71,34,105
23251,ElliotBayTrailMyrtlePark,08/26/2016 07:00:00 PM,48,-122,29,22,51
23252,ElliotBayTrailMyrtlePark,08/26/2016 08:00:00 PM,48,-122,7,4,11
23253,ElliotBayTrailMyrtlePark,08/26/2016 09:00:00 PM,48,-122,6,3,9
23254,ElliotBayTrailMyrtlePark,08/26/2016 10:00:00 PM,48,-122,6,7,13
23255,ElliotBayTrailMyrtlePark,08/26/2016 11:00:00 PM,48,-122,6,4,10
23256,ElliotBayTrailMyrtlePark,08/27/2016 12:00:00 AM,48,-122,1,0,1
23257,ElliotBayTrailMyrtlePark,08/27/2016 01:00:00 AM,48,-122,1,0,1
23258,ElliotBayTrailMyrtlePark,08/27/2016 02:00:00 AM,48,-122,0,0,0
23259,ElliotBayTrailMyrtlePark,08/27/2016 03:00:00 AM,48,-122,0,0,0
23260,ElliotBayTrailMyrtlePark,08/27/2016 04:00:00 AM,48,-122,0,3,3
23261,ElliotBayTrailMyrtlePark,08/27/2016 05:00:00 AM,48,-122,6,2,8
23262,ElliotBayTrailMyrtlePark,08/27/2016 06:00:00 AM,48,-122,11,12,23
23263,ElliotBayTrailMyrtlePark,08/27/2016 07:00:00 AM,48,-122,16,26,42
23264,ElliotBayTrailMyrtlePark,08/27/2016 08:00:00 AM,48,-122,39,50,89
23265,ElliotBayTrailMyrtlePark,08/27/2016 09:00:00 AM,48,-122,32,35,67
23266,ElliotBayTrailMyrtlePark,08/27/2016 10:00:00 AM,48,-122,29,30,59
23267,ElliotBayTrailMyrtlePark,08/27/2016 11:00:00 AM,48,-122,35,63,98
23268,ElliotBayTrailMyrtlePark,08/27/2016 12:00:00 PM,48,-122,35,47,82
23269,ElliotBayTrailMyrtlePark,08/27/2016 01:00:00 PM,48,-122,74,37,111
23270,ElliotBayTrailMyrtlePark,08/27/2016 02:00:00 PM,48,-122,45,25,70
23271,ElliotBayTrailMyrtlePark,08/27/2016 03:00:00 PM,48,-122,41,38,79
23272,ElliotBayTrailMyrtlePark,08/27/2016 04:00:00 PM,48,-122,46,48,94
23273,ElliotBayTrailMyrtlePark,08/27/2016 05:00:00 PM,48,-122,44,28,72
23274,ElliotBayTrailMyrtlePark,08/27/2016 06:00:00 PM,48,-122,21,14,35
23275,ElliotBayTrailMyrtlePark,08/27/2016 07:00:00 PM,48,-122,15,22,37
23276,ElliotBayTrailMyrtlePark,08/27/2016 08:00:00 PM,48,-122,4,10,14
23277,ElliotBayTrailMyrtlePark,08/27/2016 09:00:00 PM,48,-122,10,3,13
23278,ElliotBayTrailMyrtlePark,08/27/2016 10:00:00 PM,48,-122,6,7,13
23279,ElliotBayTrailMyrtlePark,08/27/2016 11:00:00 PM,48,-122,0,1,1
23280,ElliotBayTrailMyrtlePark,08/28/2016 12:00:00 AM,48,-122,0,0,0
23281,ElliotBayTrailMyrtlePark,08/28/2016 01:00:00 AM,48,-122,1,0,1
23282,ElliotBayTrailMyrtlePark,08/28/2016 02:00:00 AM,48,-122,3,0,3
23283,ElliotBayTrailMyrtlePark,08/28/2016 03:00:00 AM,48,-122,1,0,1
23284,ElliotBayTrailMyrtlePark,08/28/2016 04:00:00 AM,48,-122,0,2,2
23285,ElliotBayTrailMyrtlePark,08/28/2016 05:00:00 AM,48,-122,0,0,0
23286,ElliotBayTrailMyrtlePark,08/28/2016 06:00:00 AM,48,-122,6,8,14
23287,ElliotBayTrailMyrtlePark,08/28/2016 07:00:00 AM,48,-122,14,21,35
23288,ElliotBayTrailMyrtlePark,08/28/2016 08:00:00 AM,48,-122,30,25,55
23289,ElliotBayTrailMyrtlePark,08/28/2016 09:00:00 AM,48,-122,45,29,74
23290,ElliotBayTrailMyrtlePark,08/28/2016 10:00:00 AM,48,-122,50,42,92
23291,ElliotBayTrailMyrtlePark,08/28/2016 11:00:00 AM,48,-122,36,55,91
23292,ElliotBayTrailMyrtlePark,08/28/2016 12:00:00 PM,48,-122,58,40,98
23293,ElliotBayTrailMyrtlePark,08/28/2016 01:00:00 PM,48,-122,55,59,114
23294,ElliotBayTrailMyrtlePark,08/28/2016 02:00:00 PM,48,-122,57,39,96
23295,ElliotBayTrailMyrtlePark,08/28/2016 03:00:00 PM,48,-122,30,37,67
23296,ElliotBayTrailMyrtlePark,08/28/2016 04:00:00 PM,48,-122,44,36,80
23297,ElliotBayTrailMyrtlePark,08/28/2016 05:00:00 PM,48,-122,27,35,62
23298,ElliotBayTrailMyrtlePark,08/28/2016 06:00:00 PM,48,-122,13,19,32
23299,ElliotBayTrailMyrtlePark,08/28/2016 07:00:00 PM,48,-122,19,6,25
23300,ElliotBayTrailMyrtlePark,08/28/2016 08:00:00 PM,48,-122,5,2,7
23301,ElliotBayTrailMyrtlePark,08/28/2016 09:00:00 PM,48,-122,6,8,14
23302,ElliotBayTrailMyrtlePark,08/28/2016 10:00:00 PM,48,-122,5,1,6
23303,ElliotBayTrailMyrtlePark,08/28/2016 11:00:00 PM,48,-122,1,1,2
23304,ElliotBayTrailMyrtlePark,08/29/2016 12:00:00 AM,48,-122,0,0,0
23305,ElliotBayTrailMyrtlePark,08/29/2016 01:00:00 AM,48,-122,0,0,0
23306,ElliotBayTrailMyrtlePark,08/29/2016 02:00:00 AM,48,-122,2,0,2
23307,ElliotBayTrailMyrtlePark,08/29/2016 03:00:00 AM,48,-122,0,1,1
23308,ElliotBayTrailMyrtlePark,08/29/2016 04:00:00 AM,48,-122,5,3,8
23309,ElliotBayTrailMyrtlePark,08/29/2016 05:00:00 AM,48,-122,11,22,33
23310,ElliotBayTrailMyrtlePark,08/29/2016 06:00:00 AM,48,-122,34,60,94
23311,ElliotBayTrailMyrtlePark,08/29/2016 07:00:00 AM,48,-122,34,144,178
23312,ElliotBayTrailMyrtlePark,08/29/2016 08:00:00 AM,48,-122,48,123,171
23313,ElliotBayTrailMyrtlePark,08/29/2016 09:00:00 AM,48,-122,26,26,52
23314,ElliotBayTrailMyrtlePark,08/29/2016 10:00:00 AM,48,-122,21,21,42
23315,ElliotBayTrailMyrtlePark,08/29/2016 11:00:00 AM,48,-122,26,17,43
23316,ElliotBayTrailMyrtlePark,08/29/2016 12:00:00 PM,48,-122,25,31,56
23317,ElliotBayTrailMyrtlePark,08/29/2016 01:00:00 PM,48,-122,35,34,69
23318,ElliotBayTrailMyrtlePark,08/29/2016 02:00:00 PM,48,-122,30,38,68
23319,ElliotBayTrailMyrtlePark,08/29/2016 03:00:00 PM,48,-122,87,46,133
23320,ElliotBayTrailMyrtlePark,08/29/2016 04:00:00 PM,48,-122,163,89,252
23321,ElliotBayTrailMyrtlePark,08/29/2016 05:00:00 PM,48,-122,218,62,280
23322,ElliotBayTrailMyrtlePark,08/29/2016 06:00:00 PM,48,-122,87,37,124
23323,ElliotBayTrailMyrtlePark,08/29/2016 07:00:00 PM,48,-122,54,40,94
23324,ElliotBayTrailMyrtlePark,08/29/2016 08:00:00 PM,48,-122,14,9,23
23325,ElliotBayTrailMyrtlePark,08/29/2016 09:00:00 PM,48,-122,6,4,10
23326,ElliotBayTrailMyrtlePark,08/29/2016 10:00:00 PM,48,-122,4,1,5
23327,ElliotBayTrailMyrtlePark,08/29/2016 11:00:00 PM,48,-122,2,0,2
23328,ElliotBayTrailMyrtlePark,08/30/2016 12:00:00 AM,48,-122,3,0,3
23329,ElliotBayTrailMyrtlePark,08/30/2016 01:00:00 AM,48,-122,0,3,3
23330,ElliotBayTrailMyrtlePark,08/30/2016 02:00:00 AM,48,-122,1,0,1
23331,ElliotBayTrailMyrtlePark,08/30/2016 03:00:00 AM,48,-122,1,0,1
23332,ElliotBayTrailMyrtlePark,08/30/2016 04:00:00 AM,48,-122,5,3,8
23333,ElliotBayTrailMyrtlePark,08/30/2016 05:00:00 AM,48,-122,16,19,35
23334,ElliotBayTrailMyrtlePark,08/30/2016 06:00:00 AM,48,-122,26,66,92
23335,ElliotBayTrailMyrtlePark,08/30/2016 07:00:00 AM,48,-122,45,176,221
23336,ElliotBayTrailMyrtlePark,08/30/2016 08:00:00 AM,48,-122,58,129,187
23337,ElliotBayTrailMyrtlePark,08/30/2016 09:00:00 AM,48,-122,21,45,66
23338,ElliotBayTrailMyrtlePark,08/30/2016 10:00:00 AM,48,-122,24,19,43
23339,ElliotBayTrailMyrtlePark,08/30/2016 11:00:00 AM,48,-122,22,22,44
23340,ElliotBayTrailMyrtlePark,08/30/2016 12:00:00 PM,48,-122,15,23,38
23341,ElliotBayTrailMyrtlePark,08/30/2016 01:00:00 PM,48,-122,24,26,50
23342,ElliotBayTrailMyrtlePark,08/30/2016 02:00:00 PM,48,-122,46,41,87
23343,ElliotBayTrailMyrtlePark,08/30/2016 03:00:00 PM,48,-122,77,36,113
23344,ElliotBayTrailMyrtlePark,08/30/2016 04:00:00 PM,48,-122,165,87,252
23345,ElliotBayTrailMyrtlePark,08/30/2016 05:00:00 PM,48,-122,210,55,265
23346,ElliotBayTrailMyrtlePark,08/30/2016 06:00:00 PM,48,-122,89,47,136
23347,ElliotBayTrailMyrtlePark,08/30/2016 07:00:00 PM,48,-122,31,24,55
23348,ElliotBayTrailMyrtlePark,08/30/2016 08:00:00 PM,48,-122,5,5,10
23349,ElliotBayTrailMyrtlePark,08/30/2016 09:00:00 PM,48,-122,11,11,22
23350,ElliotBayTrailMyrtlePark,08/30/2016 10:00:00 PM,48,-122,6,2,8
23351,ElliotBayTrailMyrtlePark,08/30/2016 11:00:00 PM,48,-122,1,0,1
23352,ElliotBayTrailMyrtlePark,08/31/2016 12:00:00 AM,48,-122,0,1,1
23353,ElliotBayTrailMyrtlePark,08/31/2016 01:00:00 AM,48,-122,1,0,1
23354,ElliotBayTrailMyrtlePark,08/31/2016 02:00:00 AM,48,-122,2,0,2
23355,ElliotBayTrailMyrtlePark,08/31/2016 03:00:00 AM,48,-122,3,1,4
23356,ElliotBayTrailMyrtlePark,08/31/2016 04:00:00 AM,48,-122,4,2,6
23357,ElliotBayTrailMyrtlePark,08/31/2016 05:00:00 AM,48,-122,13,22,35
23358,ElliotBayTrailMyrtlePark,08/31/2016 06:00:00 AM,48,-122,22,61,83
23359,ElliotBayTrailMyrtlePark,08/31/2016 07:00:00 AM,48,-122,37,163,200
23360,ElliotBayTrailMyrtlePark,08/31/2016 08:00:00 AM,48,-122,39,117,156
23361,ElliotBayTrailMyrtlePark,08/31/2016 09:00:00 AM,48,-122,33,33,66
23362,ElliotBayTrailMyrtlePark,08/31/2016 10:00:00 AM,48,-122,10,23,33
23363,ElliotBayTrailMyrtlePark,08/31/2016 11:00:00 AM,48,-122,11,11,22
23364,ElliotBayTrailMyrtlePark,08/31/2016 12:00:00 PM,48,-122,15,18,33
23365,ElliotBayTrailMyrtlePark,08/31/2016 01:00:00 PM,48,-122,9,10,19
23366,ElliotBayTrailMyrtlePark,08/31/2016 02:00:00 PM,48,-122,13,11,24
23367,ElliotBayTrailMyrtlePark,08/31/2016 03:00:00 PM,48,-122,37,34,71
23368,ElliotBayTrailMyrtlePark,08/31/2016 04:00:00 PM,48,-122,109,47,156
23369,ElliotBayTrailMyrtlePark,08/31/2016 05:00:00 PM,48,-122,149,46,195
23370,ElliotBayTrailMyrtlePark,08/31/2016 06:00:00 PM,48,-122,73,17,90
23371,ElliotBayTrailMyrtlePark,08/31/2016 07:00:00 PM,48,-122,33,15,48
23372,ElliotBayTrailMyrtlePark,08/31/2016 08:00:00 PM,48,-122,9,7,16
23373,ElliotBayTrailMyrtlePark,08/31/2016 09:00:00 PM,48,-122,11,8,19
23374,ElliotBayTrailMyrtlePark,08/31/2016 10:00:00 PM,48,-122,5,2,7
23375,ElliotBayTrailMyrtlePark,08/31/2016 11:00:00 PM,48,-122,0,1,1
23376,ElliotBayTrailMyrtlePark,09/01/2016 12:00:00 AM,48,-122,0,0,0
23377,ElliotBayTrailMyrtlePark,09/01/2016 01:00:00 AM,48,-122,0,0,0
23378,ElliotBayTrailMyrtlePark,09/01/2016 02:00:00 AM,48,-122,1,0,1
23379,ElliotBayTrailMyrtlePark,09/01/2016 03:00:00 AM,48,-122,0,1,1
23380,ElliotBayTrailMyrtlePark,09/01/2016 04:00:00 AM,48,-122,6,1,7
23381,ElliotBayTrailMyrtlePark,09/01/2016 05:00:00 AM,48,-122,9,22,31
23382,ElliotBayTrailMyrtlePark,09/01/2016 06:00:00 AM,48,-122,27,43,70
23383,ElliotBayTrailMyrtlePark,09/01/2016 07:00:00 AM,48,-122,39,128,167
23384,ElliotBayTrailMyrtlePark,09/01/2016 08:00:00 AM,48,-122,50,85,135
23385,ElliotBayTrailMyrtlePark,09/01/2016 09:00:00 AM,48,-122,25,33,58
23386,ElliotBayTrailMyrtlePark,09/01/2016 10:00:00 AM,48,-122,21,21,42
23387,ElliotBayTrailMyrtlePark,09/01/2016 11:00:00 AM,48,-122,15,11,26
23388,ElliotBayTrailMyrtlePark,09/01/2016 12:00:00 PM,48,-122,19,29,48
23389,ElliotBayTrailMyrtlePark,09/01/2016 01:00:00 PM,48,-122,17,21,38
23390,ElliotBayTrailMyrtlePark,09/01/2016 02:00:00 PM,48,-122,19,25,44
23391,ElliotBayTrailMyrtlePark,09/01/2016 03:00:00 PM,48,-122,44,31,75
23392,ElliotBayTrailMyrtlePark,09/01/2016 04:00:00 PM,48,-122,113,59,172
23393,ElliotBayTrailMyrtlePark,09/01/2016 05:00:00 PM,48,-122,126,36,162
23394,ElliotBayTrailMyrtlePark,09/01/2016 06:00:00 PM,48,-122,47,12,59
23395,ElliotBayTrailMyrtlePark,09/01/2016 07:00:00 PM,48,-122,22,15,37
23396,ElliotBayTrailMyrtlePark,09/01/2016 08:00:00 PM,48,-122,4,6,10
23397,ElliotBayTrailMyrtlePark,09/01/2016 09:00:00 PM,48,-122,10,3,13
23398,ElliotBayTrailMyrtlePark,09/01/2016 10:00:00 PM,48,-122,3,1,4
23399,ElliotBayTrailMyrtlePark,09/01/2016 11:00:00 PM,48,-122,0,0,0
23400,ElliotBayTrailMyrtlePark,09/02/2016 12:00:00 AM,48,-122,4,0,4
23401,ElliotBayTrailMyrtlePark,09/02/2016 01:00:00 AM,48,-122,1,0,1
23402,ElliotBayTrailMyrtlePark,09/02/2016 02:00:00 AM,48,-122,1,0,1
23403,ElliotBayTrailMyrtlePark,09/02/2016 03:00:00 AM,48,-122,0,1,1
23404,ElliotBayTrailMyrtlePark,09/02/2016 04:00:00 AM,48,-122,5,1,6
23405,ElliotBayTrailMyrtlePark,09/02/2016 05:00:00 AM,48,-122,11,8,19
23406,ElliotBayTrailMyrtlePark,09/02/2016 06:00:00 AM,48,-122,23,26,49
23407,ElliotBayTrailMyrtlePark,09/02/2016 07:00:00 AM,48,-122,32,71,103
23408,ElliotBayTrailMyrtlePark,09/02/2016 08:00:00 AM,48,-122,18,70,88
23409,ElliotBayTrailMyrtlePark,09/02/2016 09:00:00 AM,48,-122,9,17,26
23410,ElliotBayTrailMyrtlePark,09/02/2016 10:00:00 AM,48,-122,3,4,7
23411,ElliotBayTrailMyrtlePark,09/02/2016 11:00:00 AM,48,-122,3,8,11
23412,ElliotBayTrailMyrtlePark,09/02/2016 12:00:00 PM,48,-122,22,8,30
23413,ElliotBayTrailMyrtlePark,09/02/2016 01:00:00 PM,48,-122,15,15,30
23414,ElliotBayTrailMyrtlePark,09/02/2016 02:00:00 PM,48,-122,40,28,68
23415,ElliotBayTrailMyrtlePark,09/02/2016 03:00:00 PM,48,-122,51,38,89
23416,ElliotBayTrailMyrtlePark,09/02/2016 04:00:00 PM,48,-122,76,43,119
23417,ElliotBayTrailMyrtlePark,09/02/2016 05:00:00 PM,48,-122,58,24,82
23418,ElliotBayTrailMyrtlePark,09/02/2016 06:00:00 PM,48,-122,14,11,25
23419,ElliotBayTrailMyrtlePark,09/02/2016 07:00:00 PM,48,-122,18,13,31
23420,ElliotBayTrailMyrtlePark,09/02/2016 08:00:00 PM,48,-122,4,6,10
23421,ElliotBayTrailMyrtlePark,09/02/2016 09:00:00 PM,48,-122,4,4,8
23422,ElliotBayTrailMyrtlePark,09/02/2016 10:00:00 PM,48,-122,6,2,8
23423,ElliotBayTrailMyrtlePark,09/02/2016 11:00:00 PM,48,-122,3,4,7
23424,ElliotBayTrailMyrtlePark,09/03/2016 12:00:00 AM,48,-122,1,1,2
23425,ElliotBayTrailMyrtlePark,09/03/2016 01:00:00 AM,48,-122,1,1,2
23426,ElliotBayTrailMyrtlePark,09/03/2016 02:00:00 AM,48,-122,0,0,0
23427,ElliotBayTrailMyrtlePark,09/03/2016 03:00:00 AM,48,-122,0,0,0
23428,ElliotBayTrailMyrtlePark,09/03/2016 04:00:00 AM,48,-122,1,1,2
23429,ElliotBayTrailMyrtlePark,09/03/2016 05:00:00 AM,48,-122,1,1,2
23430,ElliotBayTrailMyrtlePark,09/03/2016 06:00:00 AM,48,-122,1,7,8
23431,ElliotBayTrailMyrtlePark,09/03/2016 07:00:00 AM,48,-122,9,6,15
23432,ElliotBayTrailMyrtlePark,09/03/2016 08:00:00 AM,48,-122,7,16,23
23433,ElliotBayTrailMyrtlePark,09/03/2016 09:00:00 AM,48,-122,10,12,22
23434,ElliotBayTrailMyrtlePark,09/03/2016 10:00:00 AM,48,-122,23,33,56
23435,ElliotBayTrailMyrtlePark,09/03/2016 11:00:00 AM,48,-122,20,15,35
23436,ElliotBayTrailMyrtlePark,09/03/2016 12:00:00 PM,48,-122,29,27,56
23437,ElliotBayTrailMyrtlePark,09/03/2016 01:00:00 PM,48,-122,33,30,63
23438,ElliotBayTrailMyrtlePark,09/03/2016 02:00:00 PM,48,-122,30,31,61
23439,ElliotBayTrailMyrtlePark,09/03/2016 03:00:00 PM,48,-122,54,34,88
23440,ElliotBayTrailMyrtlePark,09/03/2016 04:00:00 PM,48,-122,50,40,90
23441,ElliotBayTrailMyrtlePark,09/03/2016 05:00:00 PM,48,-122,51,40,91
23442,ElliotBayTrailMyrtlePark,09/03/2016 06:00:00 PM,48,-122,32,26,58
23443,ElliotBayTrailMyrtlePark,09/03/2016 07:00:00 PM,48,-122,14,33,47
23444,ElliotBayTrailMyrtlePark,09/03/2016 08:00:00 PM,48,-122,2,3,5
23445,ElliotBayTrailMyrtlePark,09/03/2016 09:00:00 PM,48,-122,6,4,10
23446,ElliotBayTrailMyrtlePark,09/03/2016 10:00:00 PM,48,-122,13,1,14
23447,ElliotBayTrailMyrtlePark,09/03/2016 11:00:00 PM,48,-122,0,2,2
23448,ElliotBayTrailMyrtlePark,09/04/2016 12:00:00 AM,48,-122,1,0,1
23449,ElliotBayTrailMyrtlePark,09/04/2016 01:00:00 AM,48,-122,1,2,3
23450,ElliotBayTrailMyrtlePark,09/04/2016 02:00:00 AM,48,-122,1,2,3
23451,ElliotBayTrailMyrtlePark,09/04/2016 03:00:00 AM,48,-122,0,0,0
23452,ElliotBayTrailMyrtlePark,09/04/2016 04:00:00 AM,48,-122,0,1,1
23453,ElliotBayTrailMyrtlePark,09/04/2016 05:00:00 AM,48,-122,0,4,4
23454,ElliotBayTrailMyrtlePark,09/04/2016 06:00:00 AM,48,-122,2,5,7
23455,ElliotBayTrailMyrtlePark,09/04/2016 07:00:00 AM,48,-122,14,9,23
23456,ElliotBayTrailMyrtlePark,09/04/2016 08:00:00 AM,48,-122,15,26,41
23457,ElliotBayTrailMyrtlePark,09/04/2016 09:00:00 AM,48,-122,34,32,66
23458,ElliotBayTrailMyrtlePark,09/04/2016 10:00:00 AM,48,-122,25,41,66
23459,ElliotBayTrailMyrtlePark,09/04/2016 11:00:00 AM,48,-122,48,56,104
23460,ElliotBayTrailMyrtlePark,09/04/2016 12:00:00 PM,48,-122,58,90,148
23461,ElliotBayTrailMyrtlePark,09/04/2016 01:00:00 PM,48,-122,61,68,129
23462,ElliotBayTrailMyrtlePark,09/04/2016 02:00:00 PM,48,-122,75,91,166
23463,ElliotBayTrailMyrtlePark,09/04/2016 03:00:00 PM,48,-122,81,62,143
23464,ElliotBayTrailMyrtlePark,09/04/2016 04:00:00 PM,48,-122,86,57,143
23465,ElliotBayTrailMyrtlePark,09/04/2016 05:00:00 PM,48,-122,63,36,99
23466,ElliotBayTrailMyrtlePark,09/04/2016 06:00:00 PM,48,-122,55,35,90
23467,ElliotBayTrailMyrtlePark,09/04/2016 07:00:00 PM,48,-122,18,30,48
23468,ElliotBayTrailMyrtlePark,09/04/2016 08:00:00 PM,48,-122,5,10,15
23469,ElliotBayTrailMyrtlePark,09/04/2016 09:00:00 PM,48,-122,2,0,2
23470,ElliotBayTrailMyrtlePark,09/04/2016 10:00:00 PM,48,-122,4,3,7
23471,ElliotBayTrailMyrtlePark,09/04/2016 11:00:00 PM,48,-122,0,0,0
23472,ElliotBayTrailMyrtlePark,09/05/2016 12:00:00 AM,48,-122,2,0,2
23473,ElliotBayTrailMyrtlePark,09/05/2016 01:00:00 AM,48,-122,1,0,1
23474,ElliotBayTrailMyrtlePark,09/05/2016 02:00:00 AM,48,-122,1,0,1
23475,ElliotBayTrailMyrtlePark,09/05/2016 03:00:00 AM,48,-122,0,1,1
23476,ElliotBayTrailMyrtlePark,09/05/2016 04:00:00 AM,48,-122,0,0,0
23477,ElliotBayTrailMyrtlePark,09/05/2016 05:00:00 AM,48,-122,2,3,5
23478,ElliotBayTrailMyrtlePark,09/05/2016 06:00:00 AM,48,-122,2,1,3
23479,ElliotBayTrailMyrtlePark,09/05/2016 07:00:00 AM,48,-122,11,9,20
23480,ElliotBayTrailMyrtlePark,09/05/2016 08:00:00 AM,48,-122,16,23,39
23481,ElliotBayTrailMyrtlePark,09/05/2016 09:00:00 AM,48,-122,44,37,81
23482,ElliotBayTrailMyrtlePark,09/05/2016 10:00:00 AM,48,-122,33,47,80
23483,ElliotBayTrailMyrtlePark,09/05/2016 11:00:00 AM,48,-122,41,65,106
23484,ElliotBayTrailMyrtlePark,09/05/2016 12:00:00 PM,48,-122,41,47,88
23485,ElliotBayTrailMyrtlePark,09/05/2016 01:00:00 PM,48,-122,52,36,88
23486,ElliotBayTrailMyrtlePark,09/05/2016 02:00:00 PM,48,-122,67,44,111
23487,ElliotBayTrailMyrtlePark,09/05/2016 03:00:00 PM,48,-122,59,56,115
23488,ElliotBayTrailMyrtlePark,09/05/2016 04:00:00 PM,48,-122,60,31,91
23489,ElliotBayTrailMyrtlePark,09/05/2016 05:00:00 PM,48,-122,37,29,66
23490,ElliotBayTrailMyrtlePark,09/05/2016 06:00:00 PM,48,-122,16,17,33
23491,ElliotBayTrailMyrtlePark,09/05/2016 07:00:00 PM,48,-122,17,9,26
23492,ElliotBayTrailMyrtlePark,09/05/2016 08:00:00 PM,48,-122,2,6,8
23493,ElliotBayTrailMyrtlePark,09/05/2016 09:00:00 PM,48,-122,3,1,4
23494,ElliotBayTrailMyrtlePark,09/05/2016 10:00:00 PM,48,-122,0,0,0
23495,ElliotBayTrailMyrtlePark,09/05/2016 11:00:00 PM,48,-122,4,0,4
23496,ElliotBayTrailMyrtlePark,09/06/2016 12:00:00 AM,48,-122,3,0,3
23497,ElliotBayTrailMyrtlePark,09/06/2016 01:00:00 AM,48,-122,1,0,1
23498,ElliotBayTrailMyrtlePark,09/06/2016 02:00:00 AM,48,-122,0,0,0
23499,ElliotBayTrailMyrtlePark,09/06/2016 03:00:00 AM,48,-122,0,0,0
23500,ElliotBayTrailMyrtlePark,09/06/2016 04:00:00 AM,48,-122,4,0,4
23501,ElliotBayTrailMyrtlePark,09/06/2016 05:00:00 AM,48,-122,11,10,21
23502,ElliotBayTrailMyrtlePark,09/06/2016 06:00:00 AM,48,-122,21,29,50
23503,ElliotBayTrailMyrtlePark,09/06/2016 07:00:00 AM,48,-122,24,98,122
23504,ElliotBayTrailMyrtlePark,09/06/2016 08:00:00 AM,48,-122,34,93,127
23505,ElliotBayTrailMyrtlePark,09/06/2016 09:00:00 AM,48,-122,17,30,47
23506,ElliotBayTrailMyrtlePark,09/06/2016 10:00:00 AM,48,-122,12,17,29
23507,ElliotBayTrailMyrtlePark,09/06/2016 11:00:00 AM,48,-122,9,15,24
23508,ElliotBayTrailMyrtlePark,09/06/2016 12:00:00 PM,48,-122,14,2,16
23509,ElliotBayTrailMyrtlePark,09/06/2016 01:00:00 PM,48,-122,13,18,31
23510,ElliotBayTrailMyrtlePark,09/06/2016 02:00:00 PM,48,-122,20,22,42
23511,ElliotBayTrailMyrtlePark,09/06/2016 03:00:00 PM,48,-122,27,26,53
23512,ElliotBayTrailMyrtlePark,09/06/2016 04:00:00 PM,48,-122,97,64,161
23513,ElliotBayTrailMyrtlePark,09/06/2016 05:00:00 PM,48,-122,129,49,178
23514,ElliotBayTrailMyrtlePark,09/06/2016 06:00:00 PM,48,-122,63,29,92
23515,ElliotBayTrailMyrtlePark,09/06/2016 07:00:00 PM,48,-122,18,10,28
23516,ElliotBayTrailMyrtlePark,09/06/2016 08:00:00 PM,48,-122,3,4,7
23517,ElliotBayTrailMyrtlePark,09/06/2016 09:00:00 PM,48,-122,4,2,6
23518,ElliotBayTrailMyrtlePark,09/06/2016 10:00:00 PM,48,-122,1,3,4
23519,ElliotBayTrailMyrtlePark,09/06/2016 11:00:00 PM,48,-122,1,0,1
23520,ElliotBayTrailMyrtlePark,09/07/2016 12:00:00 AM,48,-122,0,0,0
23521,ElliotBayTrailMyrtlePark,09/07/2016 01:00:00 AM,48,-122,1,0,1
23522,ElliotBayTrailMyrtlePark,09/07/2016 02:00:00 AM,48,-122,1,0,1
23523,ElliotBayTrailMyrtlePark,09/07/2016 03:00:00 AM,48,-122,0,1,1
23524,ElliotBayTrailMyrtlePark,09/07/2016 04:00:00 AM,48,-122,3,3,6
23525,ElliotBayTrailMyrtlePark,09/07/2016 05:00:00 AM,48,-122,20,21,41
23526,ElliotBayTrailMyrtlePark,09/07/2016 06:00:00 AM,48,-122,31,44,75
23527,ElliotBayTrailMyrtlePark,09/07/2016 07:00:00 AM,48,-122,37,134,171
23528,ElliotBayTrailMyrtlePark,09/07/2016 08:00:00 AM,48,-122,40,119,159
23529,ElliotBayTrailMyrtlePark,09/07/2016 09:00:00 AM,48,-122,21,33,54
23530,ElliotBayTrailMyrtlePark,09/07/2016 10:00:00 AM,48,-122,17,27,44
23531,ElliotBayTrailMyrtlePark,09/07/2016 11:00:00 AM,48,-122,24,10,34
23532,ElliotBayTrailMyrtlePark,09/07/2016 12:00:00 PM,48,-122,18,12,30
23533,ElliotBayTrailMyrtlePark,09/07/2016 01:00:00 PM,48,-122,25,18,43
23534,ElliotBayTrailMyrtlePark,09/07/2016 02:00:00 PM,48,-122,26,31,57
23535,ElliotBayTrailMyrtlePark,09/07/2016 03:00:00 PM,48,-122,43,32,75
23536,ElliotBayTrailMyrtlePark,09/07/2016 04:00:00 PM,48,-122,103,45,148
23537,ElliotBayTrailMyrtlePark,09/07/2016 05:00:00 PM,48,-122,147,35,182
23538,ElliotBayTrailMyrtlePark,09/07/2016 06:00:00 PM,48,-122,57,19,76
23539,ElliotBayTrailMyrtlePark,09/07/2016 07:00:00 PM,48,-122,20,8,28
23540,ElliotBayTrailMyrtlePark,09/07/2016 08:00:00 PM,48,-122,10,4,14
23541,ElliotBayTrailMyrtlePark,09/07/2016 09:00:00 PM,48,-122,1,4,5
23542,ElliotBayTrailMyrtlePark,09/07/2016 10:00:00 PM,48,-122,3,2,5
23543,ElliotBayTrailMyrtlePark,09/07/2016 11:00:00 PM,48,-122,0,2,2
23544,ElliotBayTrailMyrtlePark,09/08/2016 12:00:00 AM,48,-122,0,0,0
23545,ElliotBayTrailMyrtlePark,09/08/2016 01:00:00 AM,48,-122,1,1,2
23546,ElliotBayTrailMyrtlePark,09/08/2016 02:00:00 AM,48,-122,0,0,0
23547,ElliotBayTrailMyrtlePark,09/08/2016 03:00:00 AM,48,-122,0,1,1
23548,ElliotBayTrailMyrtlePark,09/08/2016 04:00:00 AM,48,-122,2,4,6
23549,ElliotBayTrailMyrtlePark,09/08/2016 05:00:00 AM,48,-122,15,29,44
23550,ElliotBayTrailMyrtlePark,09/08/2016 06:00:00 AM,48,-122,31,61,92
23551,ElliotBayTrailMyrtlePark,09/08/2016 07:00:00 AM,48,-122,33,128,161
23552,ElliotBayTrailMyrtlePark,09/08/2016 08:00:00 AM,48,-122,36,117,153
23553,ElliotBayTrailMyrtlePark,09/08/2016 09:00:00 AM,48,-122,19,35,54
23554,ElliotBayTrailMyrtlePark,09/08/2016 10:00:00 AM,48,-122,13,20,33
23555,ElliotBayTrailMyrtlePark,09/08/2016 11:00:00 AM,48,-122,21,30,51
23556,ElliotBayTrailMyrtlePark,09/08/2016 12:00:00 PM,48,-122,16,23,39
23557,ElliotBayTrailMyrtlePark,09/08/2016 01:00:00 PM,48,-122,24,24,48
23558,ElliotBayTrailMyrtlePark,09/08/2016 02:00:00 PM,48,-122,29,30,59
23559,ElliotBayTrailMyrtlePark,09/08/2016 03:00:00 PM,48,-122,54,31,85
23560,ElliotBayTrailMyrtlePark,09/08/2016 04:00:00 PM,48,-122,147,84,231
23561,ElliotBayTrailMyrtlePark,09/08/2016 05:00:00 PM,48,-122,188,62,250
23562,ElliotBayTrailMyrtlePark,09/08/2016 06:00:00 PM,48,-122,80,34,114
23563,ElliotBayTrailMyrtlePark,09/08/2016 07:00:00 PM,48,-122,39,34,73
23564,ElliotBayTrailMyrtlePark,09/08/2016 08:00:00 PM,48,-122,1,4,5
23565,ElliotBayTrailMyrtlePark,09/08/2016 09:00:00 PM,48,-122,5,3,8
23566,ElliotBayTrailMyrtlePark,09/08/2016 10:00:00 PM,48,-122,7,1,8
23567,ElliotBayTrailMyrtlePark,09/08/2016 11:00:00 PM,48,-122,1,0,1
23568,ElliotBayTrailMyrtlePark,09/09/2016 12:00:00 AM,48,-122,0,0,0
23569,ElliotBayTrailMyrtlePark,09/09/2016 01:00:00 AM,48,-122,2,0,2
23570,ElliotBayTrailMyrtlePark,09/09/2016 02:00:00 AM,48,-122,1,1,2
23571,ElliotBayTrailMyrtlePark,09/09/2016 03:00:00 AM,48,-122,0,0,0
23572,ElliotBayTrailMyrtlePark,09/09/2016 04:00:00 AM,48,-122,6,3,9
23573,ElliotBayTrailMyrtlePark,09/09/2016 05:00:00 AM,48,-122,14,20,34
23574,ElliotBayTrailMyrtlePark,09/09/2016 06:00:00 AM,48,-122,40,45,85
23575,ElliotBayTrailMyrtlePark,09/09/2016 07:00:00 AM,48,-122,40,129,169
23576,ElliotBayTrailMyrtlePark,09/09/2016 08:00:00 AM,48,-122,46,125,171
23577,ElliotBayTrailMyrtlePark,09/09/2016 09:00:00 AM,48,-122,18,33,51
23578,ElliotBayTrailMyrtlePark,09/09/2016 10:00:00 AM,48,-122,31,33,64
23579,ElliotBayTrailMyrtlePark,09/09/2016 11:00:00 AM,48,-122,62,45,107
23580,ElliotBayTrailMyrtlePark,09/09/2016 12:00:00 PM,48,-122,41,37,78
23581,ElliotBayTrailMyrtlePark,09/09/2016 01:00:00 PM,48,-122,44,24,68
23582,ElliotBayTrailMyrtlePark,09/09/2016 02:00:00 PM,48,-122,44,47,91
23583,ElliotBayTrailMyrtlePark,09/09/2016 03:00:00 PM,48,-122,84,55,139
23584,ElliotBayTrailMyrtlePark,09/09/2016 04:00:00 PM,48,-122,161,80,241
23585,ElliotBayTrailMyrtlePark,09/09/2016 05:00:00 PM,48,-122,132,46,178
23586,ElliotBayTrailMyrtlePark,09/09/2016 06:00:00 PM,48,-122,75,37,112
23587,ElliotBayTrailMyrtlePark,09/09/2016 07:00:00 PM,48,-122,21,30,51
23588,ElliotBayTrailMyrtlePark,09/09/2016 08:00:00 PM,48,-122,5,5,10
23589,ElliotBayTrailMyrtlePark,09/09/2016 09:00:00 PM,48,-122,1,5,6
23590,ElliotBayTrailMyrtlePark,09/09/2016 10:00:00 PM,48,-122,8,3,11
23591,ElliotBayTrailMyrtlePark,09/09/2016 11:00:00 PM,48,-122,2,0,2
23592,ElliotBayTrailMyrtlePark,09/10/2016 12:00:00 AM,48,-122,1,1,2
23593,ElliotBayTrailMyrtlePark,09/10/2016 01:00:00 AM,48,-122,2,0,2
23594,ElliotBayTrailMyrtlePark,09/10/2016 02:00:00 AM,48,-122,0,0,0
23595,ElliotBayTrailMyrtlePark,09/10/2016 03:00:00 AM,48,-122,2,0,2
23596,ElliotBayTrailMyrtlePark,09/10/2016 04:00:00 AM,48,-122,3,2,5
23597,ElliotBayTrailMyrtlePark,09/10/2016 05:00:00 AM,48,-122,1,0,1
23598,ElliotBayTrailMyrtlePark,09/10/2016 06:00:00 AM,48,-122,4,4,8
23599,ElliotBayTrailMyrtlePark,09/10/2016 07:00:00 AM,48,-122,18,26,44
23600,ElliotBayTrailMyrtlePark,09/10/2016 08:00:00 AM,48,-122,12,24,36
23601,ElliotBayTrailMyrtlePark,09/10/2016 09:00:00 AM,48,-122,38,34,72
23602,ElliotBayTrailMyrtlePark,09/10/2016 10:00:00 AM,48,-122,37,30,67
23603,ElliotBayTrailMyrtlePark,09/10/2016 11:00:00 AM,48,-122,41,51,92
23604,ElliotBayTrailMyrtlePark,09/10/2016 12:00:00 PM,48,-122,71,70,141
23605,ElliotBayTrailMyrtlePark,09/10/2016 01:00:00 PM,48,-122,63,71,134
23606,ElliotBayTrailMyrtlePark,09/10/2016 02:00:00 PM,48,-122,60,68,128
23607,ElliotBayTrailMyrtlePark,09/10/2016 03:00:00 PM,48,-122,99,60,159
23608,ElliotBayTrailMyrtlePark,09/10/2016 04:00:00 PM,48,-122,89,66,155
23609,ElliotBayTrailMyrtlePark,09/10/2016 05:00:00 PM,48,-122,48,50,98
23610,ElliotBayTrailMyrtlePark,09/10/2016 06:00:00 PM,48,-122,34,33,67
23611,ElliotBayTrailMyrtlePark,09/10/2016 07:00:00 PM,48,-122,17,19,36
23612,ElliotBayTrailMyrtlePark,09/10/2016 08:00:00 PM,48,-122,2,2,4
23613,ElliotBayTrailMyrtlePark,09/10/2016 09:00:00 PM,48,-122,5,4,9
23614,ElliotBayTrailMyrtlePark,09/10/2016 10:00:00 PM,48,-122,3,0,3
23615,ElliotBayTrailMyrtlePark,09/10/2016 11:00:00 PM,48,-122,0,0,0
23616,ElliotBayTrailMyrtlePark,09/11/2016 12:00:00 AM,48,-122,1,0,1
23617,ElliotBayTrailMyrtlePark,09/11/2016 01:00:00 AM,48,-122,1,0,1
23618,ElliotBayTrailMyrtlePark,09/11/2016 02:00:00 AM,48,-122,0,0,0
23619,ElliotBayTrailMyrtlePark,09/11/2016 03:00:00 AM,48,-122,3,1,4
23620,ElliotBayTrailMyrtlePark,09/11/2016 04:00:00 AM,48,-122,0,1,1
23621,ElliotBayTrailMyrtlePark,09/11/2016 05:00:00 AM,48,-122,1,3,4
23622,ElliotBayTrailMyrtlePark,09/11/2016 06:00:00 AM,48,-122,5,8,13
23623,ElliotBayTrailMyrtlePark,09/11/2016 07:00:00 AM,48,-122,13,11,24
23624,ElliotBayTrailMyrtlePark,09/11/2016 08:00:00 AM,48,-122,28,15,43
23625,ElliotBayTrailMyrtlePark,09/11/2016 09:00:00 AM,48,-122,44,42,86
23626,ElliotBayTrailMyrtlePark,09/11/2016 10:00:00 AM,48,-122,37,57,94
23627,ElliotBayTrailMyrtlePark,09/11/2016 11:00:00 AM,48,-122,34,63,97
23628,ElliotBayTrailMyrtlePark,09/11/2016 12:00:00 PM,48,-122,36,42,78
23629,ElliotBayTrailMyrtlePark,09/11/2016 01:00:00 PM,48,-122,53,34,87
23630,ElliotBayTrailMyrtlePark,09/11/2016 02:00:00 PM,48,-122,49,44,93
23631,ElliotBayTrailMyrtlePark,09/11/2016 03:00:00 PM,48,-122,37,39,76
23632,ElliotBayTrailMyrtlePark,09/11/2016 04:00:00 PM,48,-122,74,46,120
23633,ElliotBayTrailMyrtlePark,09/11/2016 05:00:00 PM,48,-122,41,44,85
23634,ElliotBayTrailMyrtlePark,09/11/2016 06:00:00 PM,48,-122,38,24,62
23635,ElliotBayTrailMyrtlePark,09/11/2016 07:00:00 PM,48,-122,21,15,36
23636,ElliotBayTrailMyrtlePark,09/11/2016 08:00:00 PM,48,-122,4,6,10
23637,ElliotBayTrailMyrtlePark,09/11/2016 09:00:00 PM,48,-122,1,0,1
23638,ElliotBayTrailMyrtlePark,09/11/2016 10:00:00 PM,48,-122,3,0,3
23639,ElliotBayTrailMyrtlePark,09/11/2016 11:00:00 PM,48,-122,2,0,2
23640,ElliotBayTrailMyrtlePark,09/12/2016 12:00:00 AM,48,-122,0,0,0
23641,ElliotBayTrailMyrtlePark,09/12/2016 01:00:00 AM,48,-122,1,0,1
23642,ElliotBayTrailMyrtlePark,09/12/2016 02:00:00 AM,48,-122,1,0,1
23643,ElliotBayTrailMyrtlePark,09/12/2016 03:00:00 AM,48,-122,1,1,2
23644,ElliotBayTrailMyrtlePark,09/12/2016 04:00:00 AM,48,-122,6,4,10
23645,ElliotBayTrailMyrtlePark,09/12/2016 05:00:00 AM,48,-122,17,21,38
23646,ElliotBayTrailMyrtlePark,09/12/2016 06:00:00 AM,48,-122,38,47,85
23647,ElliotBayTrailMyrtlePark,09/12/2016 07:00:00 AM,48,-122,40,161,201
23648,ElliotBayTrailMyrtlePark,09/12/2016 08:00:00 AM,48,-122,43,138,181
23649,ElliotBayTrailMyrtlePark,09/12/2016 09:00:00 AM,48,-122,18,43,61
23650,ElliotBayTrailMyrtlePark,09/12/2016 10:00:00 AM,48,-122,11,23,34
23651,ElliotBayTrailMyrtlePark,09/12/2016 11:00:00 AM,48,-122,23,19,42
23652,ElliotBayTrailMyrtlePark,09/12/2016 12:00:00 PM,48,-122,25,22,47
23653,ElliotBayTrailMyrtlePark,09/12/2016 01:00:00 PM,48,-122,15,28,43
23654,ElliotBayTrailMyrtlePark,09/12/2016 02:00:00 PM,48,-122,38,26,64
23655,ElliotBayTrailMyrtlePark,09/12/2016 03:00:00 PM,48,-122,72,46,118
23656,ElliotBayTrailMyrtlePark,09/12/2016 04:00:00 PM,48,-122,183,65,248
23657,ElliotBayTrailMyrtlePark,09/12/2016 05:00:00 PM,48,-122,198,84,282
23658,ElliotBayTrailMyrtlePark,09/12/2016 06:00:00 PM,48,-122,76,58,134
23659,ElliotBayTrailMyrtlePark,09/12/2016 07:00:00 PM,48,-122,21,23,44
23660,ElliotBayTrailMyrtlePark,09/12/2016 08:00:00 PM,48,-122,6,8,14
23661,ElliotBayTrailMyrtlePark,09/12/2016 09:00:00 PM,48,-122,9,11,20
23662,ElliotBayTrailMyrtlePark,09/12/2016 10:00:00 PM,48,-122,3,1,4
23663,ElliotBayTrailMyrtlePark,09/12/2016 11:00:00 PM,48,-122,0,0,0
23664,ElliotBayTrailMyrtlePark,09/13/2016 12:00:00 AM,48,-122,1,0,1
23665,ElliotBayTrailMyrtlePark,09/13/2016 01:00:00 AM,48,-122,2,0,2
23666,ElliotBayTrailMyrtlePark,09/13/2016 02:00:00 AM,48,-122,1,0,1
23667,ElliotBayTrailMyrtlePark,09/13/2016 03:00:00 AM,48,-122,0,2,2
23668,ElliotBayTrailMyrtlePark,09/13/2016 04:00:00 AM,48,-122,5,2,7
23669,ElliotBayTrailMyrtlePark,09/13/2016 05:00:00 AM,48,-122,17,27,44
23670,ElliotBayTrailMyrtlePark,09/13/2016 06:00:00 AM,48,-122,40,70,110
23671,ElliotBayTrailMyrtlePark,09/13/2016 07:00:00 AM,48,-122,54,181,235
23672,ElliotBayTrailMyrtlePark,09/13/2016 08:00:00 AM,48,-122,44,137,181
23673,ElliotBayTrailMyrtlePark,09/13/2016 09:00:00 AM,48,-122,30,38,68
23674,ElliotBayTrailMyrtlePark,09/13/2016 10:00:00 AM,48,-122,19,25,44
23675,ElliotBayTrailMyrtlePark,09/13/2016 11:00:00 AM,48,-122,20,24,44
23676,ElliotBayTrailMyrtlePark,09/13/2016 12:00:00 PM,48,-122,26,23,49
23677,ElliotBayTrailMyrtlePark,09/13/2016 01:00:00 PM,48,-122,32,40,72
23678,ElliotBayTrailMyrtlePark,09/13/2016 02:00:00 PM,48,-122,33,36,69
23679,ElliotBayTrailMyrtlePark,09/13/2016 03:00:00 PM,48,-122,62,42,104
23680,ElliotBayTrailMyrtlePark,09/13/2016 04:00:00 PM,48,-122,184,82,266
23681,ElliotBayTrailMyrtlePark,09/13/2016 05:00:00 PM,48,-122,187,66,253
23682,ElliotBayTrailMyrtlePark,09/13/2016 06:00:00 PM,48,-122,102,42,144
23683,ElliotBayTrailMyrtlePark,09/13/2016 07:00:00 PM,48,-122,33,20,53
23684,ElliotBayTrailMyrtlePark,09/13/2016 08:00:00 PM,48,-122,4,2,6
23685,ElliotBayTrailMyrtlePark,09/13/2016 09:00:00 PM,48,-122,11,10,21
23686,ElliotBayTrailMyrtlePark,09/13/2016 10:00:00 PM,48,-122,8,3,11
23687,ElliotBayTrailMyrtlePark,09/13/2016 11:00:00 PM,48,-122,0,1,1
23688,ElliotBayTrailMyrtlePark,09/14/2016 12:00:00 AM,48,-122,1,0,1
23689,ElliotBayTrailMyrtlePark,09/14/2016 01:00:00 AM,48,-122,1,0,1
23690,ElliotBayTrailMyrtlePark,09/14/2016 02:00:00 AM,48,-122,2,0,2
23691,ElliotBayTrailMyrtlePark,09/14/2016 03:00:00 AM,48,-122,0,1,1
23692,ElliotBayTrailMyrtlePark,09/14/2016 04:00:00 AM,48,-122,4,2,6
23693,ElliotBayTrailMyrtlePark,09/14/2016 05:00:00 AM,48,-122,18,16,34
23694,ElliotBayTrailMyrtlePark,09/14/2016 06:00:00 AM,48,-122,32,62,94
23695,ElliotBayTrailMyrtlePark,09/14/2016 07:00:00 AM,48,-122,49,176,225
23696,ElliotBayTrailMyrtlePark,09/14/2016 08:00:00 AM,48,-122,43,143,186
23697,ElliotBayTrailMyrtlePark,09/14/2016 09:00:00 AM,48,-122,27,51,78
23698,ElliotBayTrailMyrtlePark,09/14/2016 10:00:00 AM,48,-122,20,27,47
23699,ElliotBayTrailMyrtlePark,09/14/2016 11:00:00 AM,48,-122,23,24,47
23700,ElliotBayTrailMyrtlePark,09/14/2016 12:00:00 PM,48,-122,24,40,64
23701,ElliotBayTrailMyrtlePark,09/14/2016 01:00:00 PM,48,-122,34,23,57
23702,ElliotBayTrailMyrtlePark,09/14/2016 02:00:00 PM,48,-122,39,36,75
23703,ElliotBayTrailMyrtlePark,09/14/2016 03:00:00 PM,48,-122,59,60,119
23704,ElliotBayTrailMyrtlePark,09/14/2016 04:00:00 PM,48,-122,205,71,276
23705,ElliotBayTrailMyrtlePark,09/14/2016 05:00:00 PM,48,-122,224,79,303
23706,ElliotBayTrailMyrtlePark,09/14/2016 06:00:00 PM,48,-122,85,53,138
23707,ElliotBayTrailMyrtlePark,09/14/2016 07:00:00 PM,48,-122,43,31,74
23708,ElliotBayTrailMyrtlePark,09/14/2016 08:00:00 PM,48,-122,10,3,13
23709,ElliotBayTrailMyrtlePark,09/14/2016 09:00:00 PM,48,-122,6,3,9
23710,ElliotBayTrailMyrtlePark,09/14/2016 10:00:00 PM,48,-122,8,2,10
23711,ElliotBayTrailMyrtlePark,09/14/2016 11:00:00 PM,48,-122,2,0,2
23712,ElliotBayTrailMyrtlePark,09/15/2016 12:00:00 AM,48,-122,2,2,4
23713,ElliotBayTrailMyrtlePark,09/15/2016 01:00:00 AM,48,-122,0,1,1
23714,ElliotBayTrailMyrtlePark,09/15/2016 02:00:00 AM,48,-122,2,0,2
23715,ElliotBayTrailMyrtlePark,09/15/2016 03:00:00 AM,48,-122,0,1,1
23716,ElliotBayTrailMyrtlePark,09/15/2016 04:00:00 AM,48,-122,5,2,7
23717,ElliotBayTrailMyrtlePark,09/15/2016 05:00:00 AM,48,-122,13,23,36
23718,ElliotBayTrailMyrtlePark,09/15/2016 06:00:00 AM,48,-122,25,58,83
23719,ElliotBayTrailMyrtlePark,09/15/2016 07:00:00 AM,48,-122,41,144,185
23720,ElliotBayTrailMyrtlePark,09/15/2016 08:00:00 AM,48,-122,40,130,170
23721,ElliotBayTrailMyrtlePark,09/15/2016 09:00:00 AM,48,-122,20,34,54
23722,ElliotBayTrailMyrtlePark,09/15/2016 10:00:00 AM,48,-122,15,27,42
23723,ElliotBayTrailMyrtlePark,09/15/2016 11:00:00 AM,48,-122,11,21,32
23724,ElliotBayTrailMyrtlePark,09/15/2016 12:00:00 PM,48,-122,26,23,49
23725,ElliotBayTrailMyrtlePark,09/15/2016 01:00:00 PM,48,-122,28,23,51
23726,ElliotBayTrailMyrtlePark,09/15/2016 02:00:00 PM,48,-122,31,36,67
23727,ElliotBayTrailMyrtlePark,09/15/2016 03:00:00 PM,48,-122,61,46,107
23728,ElliotBayTrailMyrtlePark,09/15/2016 04:00:00 PM,48,-122,144,64,208
23729,ElliotBayTrailMyrtlePark,09/15/2016 05:00:00 PM,48,-122,183,59,242
23730,ElliotBayTrailMyrtlePark,09/15/2016 06:00:00 PM,48,-122,89,51,140
23731,ElliotBayTrailMyrtlePark,09/15/2016 07:00:00 PM,48,-122,30,19,49
23732,ElliotBayTrailMyrtlePark,09/15/2016 08:00:00 PM,48,-122,10,8,18
23733,ElliotBayTrailMyrtlePark,09/15/2016 09:00:00 PM,48,-122,5,3,8
23734,ElliotBayTrailMyrtlePark,09/15/2016 10:00:00 PM,48,-122,6,0,6
23735,ElliotBayTrailMyrtlePark,09/15/2016 11:00:00 PM,48,-122,0,1,1
23736,ElliotBayTrailMyrtlePark,09/16/2016 12:00:00 AM,48,-122,1,0,1
23737,ElliotBayTrailMyrtlePark,09/16/2016 01:00:00 AM,48,-122,1,0,1
23738,ElliotBayTrailMyrtlePark,09/16/2016 02:00:00 AM,48,-122,2,0,2
23739,ElliotBayTrailMyrtlePark,09/16/2016 03:00:00 AM,48,-122,3,3,6
23740,ElliotBayTrailMyrtlePark,09/16/2016 04:00:00 AM,48,-122,0,2,2
23741,ElliotBayTrailMyrtlePark,09/16/2016 05:00:00 AM,48,-122,14,17,31
23742,ElliotBayTrailMyrtlePark,09/16/2016 06:00:00 AM,48,-122,35,55,90
23743,ElliotBayTrailMyrtlePark,09/16/2016 07:00:00 AM,48,-122,40,132,172
23744,ElliotBayTrailMyrtlePark,09/16/2016 08:00:00 AM,48,-122,50,108,158
23745,ElliotBayTrailMyrtlePark,09/16/2016 09:00:00 AM,48,-122,33,49,82
23746,ElliotBayTrailMyrtlePark,09/16/2016 10:00:00 AM,48,-122,17,13,30
23747,ElliotBayTrailMyrtlePark,09/16/2016 11:00:00 AM,48,-122,22,26,48
23748,ElliotBayTrailMyrtlePark,09/16/2016 12:00:00 PM,48,-122,29,44,73
23749,ElliotBayTrailMyrtlePark,09/16/2016 01:00:00 PM,48,-122,28,35,63
23750,ElliotBayTrailMyrtlePark,09/16/2016 02:00:00 PM,48,-122,30,37,67
23751,ElliotBayTrailMyrtlePark,09/16/2016 03:00:00 PM,48,-122,89,83,172
23752,ElliotBayTrailMyrtlePark,09/16/2016 04:00:00 PM,48,-122,150,71,221
23753,ElliotBayTrailMyrtlePark,09/16/2016 05:00:00 PM,48,-122,129,52,181
23754,ElliotBayTrailMyrtlePark,09/16/2016 06:00:00 PM,48,-122,43,32,75
23755,ElliotBayTrailMyrtlePark,09/16/2016 07:00:00 PM,48,-122,17,11,28
23756,ElliotBayTrailMyrtlePark,09/16/2016 08:00:00 PM,48,-122,11,5,16
23757,ElliotBayTrailMyrtlePark,09/16/2016 09:00:00 PM,48,-122,7,4,11
23758,ElliotBayTrailMyrtlePark,09/16/2016 10:00:00 PM,48,-122,10,0,10
23759,ElliotBayTrailMyrtlePark,09/16/2016 11:00:00 PM,48,-122,0,0,0
23760,ElliotBayTrailMyrtlePark,09/17/2016 12:00:00 AM,48,-122,1,1,2
23761,ElliotBayTrailMyrtlePark,09/17/2016 01:00:00 AM,48,-122,1,1,2
23762,ElliotBayTrailMyrtlePark,09/17/2016 02:00:00 AM,48,-122,2,1,3
23763,ElliotBayTrailMyrtlePark,09/17/2016 03:00:00 AM,48,-122,0,0,0
23764,ElliotBayTrailMyrtlePark,09/17/2016 04:00:00 AM,48,-122,0,1,1
23765,ElliotBayTrailMyrtlePark,09/17/2016 05:00:00 AM,48,-122,2,0,2
23766,ElliotBayTrailMyrtlePark,09/17/2016 06:00:00 AM,48,-122,3,2,5
23767,ElliotBayTrailMyrtlePark,09/17/2016 07:00:00 AM,48,-122,5,4,9
23768,ElliotBayTrailMyrtlePark,09/17/2016 08:00:00 AM,48,-122,3,4,7
23769,ElliotBayTrailMyrtlePark,09/17/2016 09:00:00 AM,48,-122,11,4,15
23770,ElliotBayTrailMyrtlePark,09/17/2016 10:00:00 AM,48,-122,11,11,22
23771,ElliotBayTrailMyrtlePark,09/17/2016 11:00:00 AM,48,-122,6,17,23
23772,ElliotBayTrailMyrtlePark,09/17/2016 12:00:00 PM,48,-122,15,16,31
23773,ElliotBayTrailMyrtlePark,09/17/2016 01:00:00 PM,48,-122,15,9,24
23774,ElliotBayTrailMyrtlePark,09/17/2016 02:00:00 PM,48,-122,29,25,54
23775,ElliotBayTrailMyrtlePark,09/17/2016 03:00:00 PM,48,-122,29,9,38
23776,ElliotBayTrailMyrtlePark,09/17/2016 04:00:00 PM,48,-122,28,17,45
23777,ElliotBayTrailMyrtlePark,09/17/2016 05:00:00 PM,48,-122,38,17,55
23778,ElliotBayTrailMyrtlePark,09/17/2016 06:00:00 PM,48,-122,15,12,27
23779,ElliotBayTrailMyrtlePark,09/17/2016 07:00:00 PM,48,-122,5,5,10
23780,ElliotBayTrailMyrtlePark,09/17/2016 08:00:00 PM,48,-122,4,5,9
23781,ElliotBayTrailMyrtlePark,09/17/2016 09:00:00 PM,48,-122,2,2,4
23782,ElliotBayTrailMyrtlePark,09/17/2016 10:00:00 PM,48,-122,6,6,12
23783,ElliotBayTrailMyrtlePark,09/17/2016 11:00:00 PM,48,-122,0,4,4
23784,ElliotBayTrailMyrtlePark,09/18/2016 12:00:00 AM,48,-122,1,0,1
23785,ElliotBayTrailMyrtlePark,09/18/2016 01:00:00 AM,48,-122,0,0,0
23786,ElliotBayTrailMyrtlePark,09/18/2016 02:00:00 AM,48,-122,1,0,1
23787,ElliotBayTrailMyrtlePark,09/18/2016 03:00:00 AM,48,-122,0,1,1
23788,ElliotBayTrailMyrtlePark,09/18/2016 04:00:00 AM,48,-122,0,1,1
23789,ElliotBayTrailMyrtlePark,09/18/2016 05:00:00 AM,48,-122,1,2,3
23790,ElliotBayTrailMyrtlePark,09/18/2016 06:00:00 AM,48,-122,6,5,11
23791,ElliotBayTrailMyrtlePark,09/18/2016 07:00:00 AM,48,-122,7,13,20
23792,ElliotBayTrailMyrtlePark,09/18/2016 08:00:00 AM,48,-122,23,14,37
23793,ElliotBayTrailMyrtlePark,09/18/2016 09:00:00 AM,48,-122,28,39,67
23794,ElliotBayTrailMyrtlePark,09/18/2016 10:00:00 AM,48,-122,29,24,53
23795,ElliotBayTrailMyrtlePark,09/18/2016 11:00:00 AM,48,-122,43,57,100
23796,ElliotBayTrailMyrtlePark,09/18/2016 12:00:00 PM,48,-122,43,46,89
23797,ElliotBayTrailMyrtlePark,09/18/2016 01:00:00 PM,48,-122,51,34,85
23798,ElliotBayTrailMyrtlePark,09/18/2016 02:00:00 PM,48,-122,64,49,113
23799,ElliotBayTrailMyrtlePark,09/18/2016 03:00:00 PM,48,-122,63,40,103
23800,ElliotBayTrailMyrtlePark,09/18/2016 04:00:00 PM,48,-122,35,41,76
23801,ElliotBayTrailMyrtlePark,09/18/2016 05:00:00 PM,48,-122,39,37,76
23802,ElliotBayTrailMyrtlePark,09/18/2016 06:00:00 PM,48,-122,34,34,68
23803,ElliotBayTrailMyrtlePark,09/18/2016 07:00:00 PM,48,-122,7,14,21
23804,ElliotBayTrailMyrtlePark,09/18/2016 08:00:00 PM,48,-122,3,0,3
23805,ElliotBayTrailMyrtlePark,09/18/2016 09:00:00 PM,48,-122,7,1,8
23806,ElliotBayTrailMyrtlePark,09/18/2016 10:00:00 PM,48,-122,1,0,1
23807,ElliotBayTrailMyrtlePark,09/18/2016 11:00:00 PM,48,-122,0,3,3
23808,ElliotBayTrailMyrtlePark,09/19/2016 12:00:00 AM,48,-122,1,0,1
23809,ElliotBayTrailMyrtlePark,09/19/2016 01:00:00 AM,48,-122,0,0,0
23810,ElliotBayTrailMyrtlePark,09/19/2016 02:00:00 AM,48,-122,3,0,3
23811,ElliotBayTrailMyrtlePark,09/19/2016 03:00:00 AM,48,-122,0,1,1
23812,ElliotBayTrailMyrtlePark,09/19/2016 04:00:00 AM,48,-122,4,2,6
23813,ElliotBayTrailMyrtlePark,09/19/2016 05:00:00 AM,48,-122,12,14,26
23814,ElliotBayTrailMyrtlePark,09/19/2016 06:00:00 AM,48,-122,25,27,52
23815,ElliotBayTrailMyrtlePark,09/19/2016 07:00:00 AM,48,-122,41,93,134
23816,ElliotBayTrailMyrtlePark,09/19/2016 08:00:00 AM,48,-122,25,113,138
23817,ElliotBayTrailMyrtlePark,09/19/2016 09:00:00 AM,48,-122,16,23,39
23818,ElliotBayTrailMyrtlePark,09/19/2016 10:00:00 AM,48,-122,11,16,27
23819,ElliotBayTrailMyrtlePark,09/19/2016 11:00:00 AM,48,-122,15,15,30
23820,ElliotBayTrailMyrtlePark,09/19/2016 12:00:00 PM,48,-122,21,13,34
23821,ElliotBayTrailMyrtlePark,09/19/2016 01:00:00 PM,48,-122,21,19,40
23822,ElliotBayTrailMyrtlePark,09/19/2016 02:00:00 PM,48,-122,15,23,38
23823,ElliotBayTrailMyrtlePark,09/19/2016 03:00:00 PM,48,-122,28,35,63
23824,ElliotBayTrailMyrtlePark,09/19/2016 04:00:00 PM,48,-122,123,52,175
23825,ElliotBayTrailMyrtlePark,09/19/2016 05:00:00 PM,48,-122,142,51,193
23826,ElliotBayTrailMyrtlePark,09/19/2016 06:00:00 PM,48,-122,49,27,76
23827,ElliotBayTrailMyrtlePark,09/19/2016 07:00:00 PM,48,-122,18,19,37
23828,ElliotBayTrailMyrtlePark,09/19/2016 08:00:00 PM,48,-122,0,2,2
23829,ElliotBayTrailMyrtlePark,09/19/2016 09:00:00 PM,48,-122,2,8,10
23830,ElliotBayTrailMyrtlePark,09/19/2016 10:00:00 PM,48,-122,4,0,4
23831,ElliotBayTrailMyrtlePark,09/19/2016 11:00:00 PM,48,-122,2,0,2
23832,ElliotBayTrailMyrtlePark,09/20/2016 12:00:00 AM,48,-122,4,2,6
23833,ElliotBayTrailMyrtlePark,09/20/2016 01:00:00 AM,48,-122,0,0,0
23834,ElliotBayTrailMyrtlePark,09/20/2016 02:00:00 AM,48,-122,2,0,2
23835,ElliotBayTrailMyrtlePark,09/20/2016 03:00:00 AM,48,-122,0,2,2
23836,ElliotBayTrailMyrtlePark,09/20/2016 04:00:00 AM,48,-122,6,1,7
23837,ElliotBayTrailMyrtlePark,09/20/2016 05:00:00 AM,48,-122,16,27,43
23838,ElliotBayTrailMyrtlePark,09/20/2016 06:00:00 AM,48,-122,28,48,76
23839,ElliotBayTrailMyrtlePark,09/20/2016 07:00:00 AM,48,-122,40,179,219
23840,ElliotBayTrailMyrtlePark,09/20/2016 08:00:00 AM,48,-122,43,134,177
23841,ElliotBayTrailMyrtlePark,09/20/2016 09:00:00 AM,48,-122,17,43,60
23842,ElliotBayTrailMyrtlePark,09/20/2016 10:00:00 AM,48,-122,20,13,33
23843,ElliotBayTrailMyrtlePark,09/20/2016 11:00:00 AM,48,-122,10,23,33
23844,ElliotBayTrailMyrtlePark,09/20/2016 12:00:00 PM,48,-122,22,21,43
23845,ElliotBayTrailMyrtlePark,09/20/2016 01:00:00 PM,48,-122,39,26,65
23846,ElliotBayTrailMyrtlePark,09/20/2016 02:00:00 PM,48,-122,36,36,72
23847,ElliotBayTrailMyrtlePark,09/20/2016 03:00:00 PM,48,-122,79,49,128
23848,ElliotBayTrailMyrtlePark,09/20/2016 04:00:00 PM,48,-122,153,79,232
23849,ElliotBayTrailMyrtlePark,09/20/2016 05:00:00 PM,48,-122,178,70,248
23850,ElliotBayTrailMyrtlePark,09/20/2016 06:00:00 PM,48,-122,72,47,119
23851,ElliotBayTrailMyrtlePark,09/20/2016 07:00:00 PM,48,-122,22,19,41
23852,ElliotBayTrailMyrtlePark,09/20/2016 08:00:00 PM,48,-122,3,6,9
23853,ElliotBayTrailMyrtlePark,09/20/2016 09:00:00 PM,48,-122,10,3,13
23854,ElliotBayTrailMyrtlePark,09/20/2016 10:00:00 PM,48,-122,17,1,18
23855,ElliotBayTrailMyrtlePark,09/20/2016 11:00:00 PM,48,-122,6,1,7
23856,ElliotBayTrailMyrtlePark,09/21/2016 12:00:00 AM,48,-122,2,0,2
23857,ElliotBayTrailMyrtlePark,09/21/2016 01:00:00 AM,48,-122,0,0,0
23858,ElliotBayTrailMyrtlePark,09/21/2016 02:00:00 AM,48,-122,2,0,2
23859,ElliotBayTrailMyrtlePark,09/21/2016 03:00:00 AM,48,-122,0,1,1
23860,ElliotBayTrailMyrtlePark,09/21/2016 04:00:00 AM,48,-122,4,4,8
23861,ElliotBayTrailMyrtlePark,09/21/2016 05:00:00 AM,48,-122,15,24,39
23862,ElliotBayTrailMyrtlePark,09/21/2016 06:00:00 AM,48,-122,28,49,77
23863,ElliotBayTrailMyrtlePark,09/21/2016 07:00:00 AM,48,-122,46,150,196
23864,ElliotBayTrailMyrtlePark,09/21/2016 08:00:00 AM,48,-122,32,126,158
23865,ElliotBayTrailMyrtlePark,09/21/2016 09:00:00 AM,48,-122,18,29,47
23866,ElliotBayTrailMyrtlePark,09/21/2016 10:00:00 AM,48,-122,15,25,40
23867,ElliotBayTrailMyrtlePark,09/21/2016 11:00:00 AM,48,-122,20,26,46
23868,ElliotBayTrailMyrtlePark,09/21/2016 12:00:00 PM,48,-122,18,20,38
23869,ElliotBayTrailMyrtlePark,09/21/2016 01:00:00 PM,48,-122,21,27,48
23870,ElliotBayTrailMyrtlePark,09/21/2016 02:00:00 PM,48,-122,37,31,68
23871,ElliotBayTrailMyrtlePark,09/21/2016 03:00:00 PM,48,-122,64,47,111
23872,ElliotBayTrailMyrtlePark,09/21/2016 04:00:00 PM,48,-122,151,73,224
23873,ElliotBayTrailMyrtlePark,09/21/2016 05:00:00 PM,48,-122,218,51,269
23874,ElliotBayTrailMyrtlePark,09/21/2016 06:00:00 PM,48,-122,68,31,99
23875,ElliotBayTrailMyrtlePark,09/21/2016 07:00:00 PM,48,-122,26,15,41
23876,ElliotBayTrailMyrtlePark,09/21/2016 08:00:00 PM,48,-122,3,5,8
23877,ElliotBayTrailMyrtlePark,09/21/2016 09:00:00 PM,48,-122,8,5,13
23878,ElliotBayTrailMyrtlePark,09/21/2016 10:00:00 PM,48,-122,6,2,8
23879,ElliotBayTrailMyrtlePark,09/21/2016 11:00:00 PM,48,-122,1,1,2
23880,ElliotBayTrailMyrtlePark,09/22/2016 12:00:00 AM,48,-122,1,0,1
23881,ElliotBayTrailMyrtlePark,09/22/2016 01:00:00 AM,48,-122,0,0,0
23882,ElliotBayTrailMyrtlePark,09/22/2016 02:00:00 AM,48,-122,1,0,1
23883,ElliotBayTrailMyrtlePark,09/22/2016 03:00:00 AM,48,-122,0,2,2
23884,ElliotBayTrailMyrtlePark,09/22/2016 04:00:00 AM,48,-122,4,3,7
23885,ElliotBayTrailMyrtlePark,09/22/2016 05:00:00 AM,48,-122,16,24,40
23886,ElliotBayTrailMyrtlePark,09/22/2016 06:00:00 AM,48,-122,28,54,82
23887,ElliotBayTrailMyrtlePark,09/22/2016 07:00:00 AM,48,-122,40,144,184
23888,ElliotBayTrailMyrtlePark,09/22/2016 08:00:00 AM,48,-122,44,116,160
23889,ElliotBayTrailMyrtlePark,09/22/2016 09:00:00 AM,48,-122,31,48,79
23890,ElliotBayTrailMyrtlePark,09/22/2016 10:00:00 AM,48,-122,23,21,44
23891,ElliotBayTrailMyrtlePark,09/22/2016 11:00:00 AM,48,-122,22,21,43
23892,ElliotBayTrailMyrtlePark,09/22/2016 12:00:00 PM,48,-122,29,14,43
23893,ElliotBayTrailMyrtlePark,09/22/2016 01:00:00 PM,48,-122,24,25,49
23894,ElliotBayTrailMyrtlePark,09/22/2016 02:00:00 PM,48,-122,34,25,59
23895,ElliotBayTrailMyrtlePark,09/22/2016 03:00:00 PM,48,-122,59,43,102
23896,ElliotBayTrailMyrtlePark,09/22/2016 04:00:00 PM,48,-122,154,67,221
23897,ElliotBayTrailMyrtlePark,09/22/2016 05:00:00 PM,48,-122,193,68,261
23898,ElliotBayTrailMyrtlePark,09/22/2016 06:00:00 PM,48,-122,60,36,96
23899,ElliotBayTrailMyrtlePark,09/22/2016 07:00:00 PM,48,-122,61,18,79
23900,ElliotBayTrailMyrtlePark,09/22/2016 08:00:00 PM,48,-122,6,6,12
23901,ElliotBayTrailMyrtlePark,09/22/2016 09:00:00 PM,48,-122,5,3,8
23902,ElliotBayTrailMyrtlePark,09/22/2016 10:00:00 PM,48,-122,4,2,6
23903,ElliotBayTrailMyrtlePark,09/22/2016 11:00:00 PM,48,-122,2,0,2
23904,ElliotBayTrailMyrtlePark,09/23/2016 12:00:00 AM,48,-122,1,0,1
23905,ElliotBayTrailMyrtlePark,09/23/2016 01:00:00 AM,48,-122,2,0,2
23906,ElliotBayTrailMyrtlePark,09/23/2016 02:00:00 AM,48,-122,2,0,2
23907,ElliotBayTrailMyrtlePark,09/23/2016 03:00:00 AM,48,-122,0,1,1
23908,ElliotBayTrailMyrtlePark,09/23/2016 04:00:00 AM,48,-122,4,2,6
23909,ElliotBayTrailMyrtlePark,09/23/2016 05:00:00 AM,48,-122,11,12,23
23910,ElliotBayTrailMyrtlePark,09/23/2016 06:00:00 AM,48,-122,25,31,56
23911,ElliotBayTrailMyrtlePark,09/23/2016 07:00:00 AM,48,-122,35,86,121
23912,ElliotBayTrailMyrtlePark,09/23/2016 08:00:00 AM,48,-122,31,90,121
23913,ElliotBayTrailMyrtlePark,09/23/2016 09:00:00 AM,48,-122,8,20,28
23914,ElliotBayTrailMyrtlePark,09/23/2016 10:00:00 AM,48,-122,11,13,24
23915,ElliotBayTrailMyrtlePark,09/23/2016 11:00:00 AM,48,-122,18,8,26
23916,ElliotBayTrailMyrtlePark,09/23/2016 12:00:00 PM,48,-122,14,17,31
23917,ElliotBayTrailMyrtlePark,09/23/2016 01:00:00 PM,48,-122,12,10,22
23918,ElliotBayTrailMyrtlePark,09/23/2016 02:00:00 PM,48,-122,25,17,42
23919,ElliotBayTrailMyrtlePark,09/23/2016 03:00:00 PM,48,-122,37,25,62
23920,ElliotBayTrailMyrtlePark,09/23/2016 04:00:00 PM,48,-122,119,45,164
23921,ElliotBayTrailMyrtlePark,09/23/2016 05:00:00 PM,48,-122,85,20,105
23922,ElliotBayTrailMyrtlePark,09/23/2016 06:00:00 PM,48,-122,40,28,68
23923,ElliotBayTrailMyrtlePark,09/23/2016 07:00:00 PM,48,-122,15,6,21
23924,ElliotBayTrailMyrtlePark,09/23/2016 08:00:00 PM,48,-122,6,1,7
23925,ElliotBayTrailMyrtlePark,09/23/2016 09:00:00 PM,48,-122,2,5,7
23926,ElliotBayTrailMyrtlePark,09/23/2016 10:00:00 PM,48,-122,1,5,6
23927,ElliotBayTrailMyrtlePark,09/23/2016 11:00:00 PM,48,-122,3,1,4
23928,ElliotBayTrailMyrtlePark,09/24/2016 12:00:00 AM,48,-122,2,4,6
23929,ElliotBayTrailMyrtlePark,09/24/2016 01:00:00 AM,48,-122,2,0,2
23930,ElliotBayTrailMyrtlePark,09/24/2016 02:00:00 AM,48,-122,0,1,1
23931,ElliotBayTrailMyrtlePark,09/24/2016 03:00:00 AM,48,-122,1,0,1
23932,ElliotBayTrailMyrtlePark,09/24/2016 04:00:00 AM,48,-122,0,1,1
23933,ElliotBayTrailMyrtlePark,09/24/2016 05:00:00 AM,48,-122,2,0,2
23934,ElliotBayTrailMyrtlePark,09/24/2016 06:00:00 AM,48,-122,4,2,6
23935,ElliotBayTrailMyrtlePark,09/24/2016 07:00:00 AM,48,-122,13,12,25
23936,ElliotBayTrailMyrtlePark,09/24/2016 08:00:00 AM,48,-122,10,25,35
23937,ElliotBayTrailMyrtlePark,09/24/2016 09:00:00 AM,48,-122,36,26,62
23938,ElliotBayTrailMyrtlePark,09/24/2016 10:00:00 AM,48,-122,51,43,94
23939,ElliotBayTrailMyrtlePark,09/24/2016 11:00:00 AM,48,-122,42,32,74
23940,ElliotBayTrailMyrtlePark,09/24/2016 12:00:00 PM,48,-122,55,70,125
23941,ElliotBayTrailMyrtlePark,09/24/2016 01:00:00 PM,48,-122,52,33,85
23942,ElliotBayTrailMyrtlePark,09/24/2016 02:00:00 PM,48,-122,58,56,114
23943,ElliotBayTrailMyrtlePark,09/24/2016 03:00:00 PM,48,-122,49,36,85
23944,ElliotBayTrailMyrtlePark,09/24/2016 04:00:00 PM,48,-122,48,35,83
23945,ElliotBayTrailMyrtlePark,09/24/2016 05:00:00 PM,48,-122,21,24,45
23946,ElliotBayTrailMyrtlePark,09/24/2016 06:00:00 PM,48,-122,9,11,20
23947,ElliotBayTrailMyrtlePark,09/24/2016 07:00:00 PM,48,-122,14,10,24
23948,ElliotBayTrailMyrtlePark,09/24/2016 08:00:00 PM,48,-122,5,4,9
23949,ElliotBayTrailMyrtlePark,09/24/2016 09:00:00 PM,48,-122,4,3,7
23950,ElliotBayTrailMyrtlePark,09/24/2016 10:00:00 PM,48,-122,2,3,5
23951,ElliotBayTrailMyrtlePark,09/24/2016 11:00:00 PM,48,-122,0,2,2
23952,ElliotBayTrailMyrtlePark,09/25/2016 12:00:00 AM,48,-122,0,1,1
23953,ElliotBayTrailMyrtlePark,09/25/2016 01:00:00 AM,48,-122,0,0,0
23954,ElliotBayTrailMyrtlePark,09/25/2016 02:00:00 AM,48,-122,1,1,2
23955,ElliotBayTrailMyrtlePark,09/25/2016 03:00:00 AM,48,-122,4,1,5
23956,ElliotBayTrailMyrtlePark,09/25/2016 04:00:00 AM,48,-122,0,1,1
23957,ElliotBayTrailMyrtlePark,09/25/2016 05:00:00 AM,48,-122,0,2,2
23958,ElliotBayTrailMyrtlePark,09/25/2016 06:00:00 AM,48,-122,3,2,5
23959,ElliotBayTrailMyrtlePark,09/25/2016 07:00:00 AM,48,-122,9,7,16
23960,ElliotBayTrailMyrtlePark,09/25/2016 08:00:00 AM,48,-122,12,28,40
23961,ElliotBayTrailMyrtlePark,09/25/2016 09:00:00 AM,48,-122,25,35,60
23962,ElliotBayTrailMyrtlePark,09/25/2016 10:00:00 AM,48,-122,20,43,63
23963,ElliotBayTrailMyrtlePark,09/25/2016 11:00:00 AM,48,-122,67,49,116
23964,ElliotBayTrailMyrtlePark,09/25/2016 12:00:00 PM,48,-122,52,57,109
23965,ElliotBayTrailMyrtlePark,09/25/2016 01:00:00 PM,48,-122,52,35,87
23966,ElliotBayTrailMyrtlePark,09/25/2016 02:00:00 PM,48,-122,58,62,120
23967,ElliotBayTrailMyrtlePark,09/25/2016 03:00:00 PM,48,-122,77,49,126
23968,ElliotBayTrailMyrtlePark,09/25/2016 04:00:00 PM,48,-122,61,50,111
23969,ElliotBayTrailMyrtlePark,09/25/2016 05:00:00 PM,48,-122,39,37,76
23970,ElliotBayTrailMyrtlePark,09/25/2016 06:00:00 PM,48,-122,30,27,57
23971,ElliotBayTrailMyrtlePark,09/25/2016 07:00:00 PM,48,-122,5,9,14
23972,ElliotBayTrailMyrtlePark,09/25/2016 08:00:00 PM,48,-122,2,2,4
23973,ElliotBayTrailMyrtlePark,09/25/2016 09:00:00 PM,48,-122,4,2,6
23974,ElliotBayTrailMyrtlePark,09/25/2016 10:00:00 PM,48,-122,1,0,1
23975,ElliotBayTrailMyrtlePark,09/25/2016 11:00:00 PM,48,-122,1,0,1
23976,ElliotBayTrailMyrtlePark,09/26/2016 12:00:00 AM,48,-122,0,0,0
23977,ElliotBayTrailMyrtlePark,09/26/2016 01:00:00 AM,48,-122,0,0,0
23978,ElliotBayTrailMyrtlePark,09/26/2016 02:00:00 AM,48,-122,4,0,4
23979,ElliotBayTrailMyrtlePark,09/26/2016 03:00:00 AM,48,-122,0,1,1
23980,ElliotBayTrailMyrtlePark,09/26/2016 04:00:00 AM,48,-122,2,0,2
23981,ElliotBayTrailMyrtlePark,09/26/2016 05:00:00 AM,48,-122,16,17,33
23982,ElliotBayTrailMyrtlePark,09/26/2016 06:00:00 AM,48,-122,31,57,88
23983,ElliotBayTrailMyrtlePark,09/26/2016 07:00:00 AM,48,-122,50,152,202
23984,ElliotBayTrailMyrtlePark,09/26/2016 08:00:00 AM,48,-122,47,149,196
23985,ElliotBayTrailMyrtlePark,09/26/2016 09:00:00 AM,48,-122,27,39,66
23986,ElliotBayTrailMyrtlePark,09/26/2016 10:00:00 AM,48,-122,21,17,38
23987,ElliotBayTrailMyrtlePark,09/26/2016 11:00:00 AM,48,-122,28,28,56
23988,ElliotBayTrailMyrtlePark,09/26/2016 12:00:00 PM,48,-122,28,22,50
23989,ElliotBayTrailMyrtlePark,09/26/2016 01:00:00 PM,48,-122,27,37,64
23990,ElliotBayTrailMyrtlePark,09/26/2016 02:00:00 PM,48,-122,38,43,81
23991,ElliotBayTrailMyrtlePark,09/26/2016 03:00:00 PM,48,-122,88,49,137
23992,ElliotBayTrailMyrtlePark,09/26/2016 04:00:00 PM,48,-122,207,87,294
23993,ElliotBayTrailMyrtlePark,09/26/2016 05:00:00 PM,48,-122,162,45,207
23994,ElliotBayTrailMyrtlePark,09/26/2016 06:00:00 PM,48,-122,60,44,104
23995,ElliotBayTrailMyrtlePark,09/26/2016 07:00:00 PM,48,-122,22,22,44
23996,ElliotBayTrailMyrtlePark,09/26/2016 08:00:00 PM,48,-122,5,2,7
23997,ElliotBayTrailMyrtlePark,09/26/2016 09:00:00 PM,48,-122,5,6,11
23998,ElliotBayTrailMyrtlePark,09/26/2016 10:00:00 PM,48,-122,3,4,7
23999,ElliotBayTrailMyrtlePark,09/26/2016 11:00:00 PM,48,-122,0,0,0
24000,ElliotBayTrailMyrtlePark,09/27/2016 12:00:00 AM,48,-122,1,0,1
24001,ElliotBayTrailMyrtlePark,09/27/2016 01:00:00 AM,48,-122,1,0,1
24002,ElliotBayTrailMyrtlePark,09/27/2016 02:00:00 AM,48,-122,2,0,2
24003,ElliotBayTrailMyrtlePark,09/27/2016 03:00:00 AM,48,-122,0,2,2
24004,ElliotBayTrailMyrtlePark,09/27/2016 04:00:00 AM,48,-122,4,1,5
24005,ElliotBayTrailMyrtlePark,09/27/2016 05:00:00 AM,48,-122,13,24,37
24006,ElliotBayTrailMyrtlePark,09/27/2016 06:00:00 AM,48,-122,20,55,75
24007,ElliotBayTrailMyrtlePark,09/27/2016 07:00:00 AM,48,-122,39,144,183
24008,ElliotBayTrailMyrtlePark,09/27/2016 08:00:00 AM,48,-122,42,124,166
24009,ElliotBayTrailMyrtlePark,09/27/2016 09:00:00 AM,48,-122,17,44,61
24010,ElliotBayTrailMyrtlePark,09/27/2016 10:00:00 AM,48,-122,13,22,35
24011,ElliotBayTrailMyrtlePark,09/27/2016 11:00:00 AM,48,-122,14,19,33
24012,ElliotBayTrailMyrtlePark,09/27/2016 12:00:00 PM,48,-122,23,25,48
24013,ElliotBayTrailMyrtlePark,09/27/2016 01:00:00 PM,48,-122,22,23,45
24014,ElliotBayTrailMyrtlePark,09/27/2016 02:00:00 PM,48,-122,26,28,54
24015,ElliotBayTrailMyrtlePark,09/27/2016 03:00:00 PM,48,-122,86,52,138
24016,ElliotBayTrailMyrtlePark,09/27/2016 04:00:00 PM,48,-122,157,74,231
24017,ElliotBayTrailMyrtlePark,09/27/2016 05:00:00 PM,48,-122,195,68,263
24018,ElliotBayTrailMyrtlePark,09/27/2016 06:00:00 PM,48,-122,71,40,111
24019,ElliotBayTrailMyrtlePark,09/27/2016 07:00:00 PM,48,-122,15,8,23
24020,ElliotBayTrailMyrtlePark,09/27/2016 08:00:00 PM,48,-122,7,3,10
24021,ElliotBayTrailMyrtlePark,09/27/2016 09:00:00 PM,48,-122,5,5,10
24022,ElliotBayTrailMyrtlePark,09/27/2016 10:00:00 PM,48,-122,5,0,5
24023,ElliotBayTrailMyrtlePark,09/27/2016 11:00:00 PM,48,-122,2,0,2
24024,ElliotBayTrailMyrtlePark,09/28/2016 12:00:00 AM,48,-122,0,0,0
24025,ElliotBayTrailMyrtlePark,09/28/2016 01:00:00 AM,48,-122,2,1,3
24026,ElliotBayTrailMyrtlePark,09/28/2016 02:00:00 AM,48,-122,2,0,2
24027,ElliotBayTrailMyrtlePark,09/28/2016 03:00:00 AM,48,-122,0,1,1
24028,ElliotBayTrailMyrtlePark,09/28/2016 04:00:00 AM,48,-122,5,2,7
24029,ElliotBayTrailMyrtlePark,09/28/2016 05:00:00 AM,48,-122,15,25,40
24030,ElliotBayTrailMyrtlePark,09/28/2016 06:00:00 AM,48,-122,30,55,85
24031,ElliotBayTrailMyrtlePark,09/28/2016 07:00:00 AM,48,-122,34,143,177
24032,ElliotBayTrailMyrtlePark,09/28/2016 08:00:00 AM,48,-122,50,149,199
24033,ElliotBayTrailMyrtlePark,09/28/2016 09:00:00 AM,48,-122,14,36,50
24034,ElliotBayTrailMyrtlePark,09/28/2016 10:00:00 AM,48,-122,18,24,42
24035,ElliotBayTrailMyrtlePark,09/28/2016 11:00:00 AM,48,-122,25,23,48
24036,ElliotBayTrailMyrtlePark,09/28/2016 12:00:00 PM,48,-122,26,14,40
24037,ElliotBayTrailMyrtlePark,09/28/2016 01:00:00 PM,48,-122,32,15,47
24038,ElliotBayTrailMyrtlePark,09/28/2016 02:00:00 PM,48,-122,34,30,64
24039,ElliotBayTrailMyrtlePark,09/28/2016 03:00:00 PM,48,-122,64,59,123
24040,ElliotBayTrailMyrtlePark,09/28/2016 04:00:00 PM,48,-122,157,73,230
24041,ElliotBayTrailMyrtlePark,09/28/2016 05:00:00 PM,48,-122,205,80,285
24042,ElliotBayTrailMyrtlePark,09/28/2016 06:00:00 PM,48,-122,80,53,133
24043,ElliotBayTrailMyrtlePark,09/28/2016 07:00:00 PM,48,-122,24,12,36
24044,ElliotBayTrailMyrtlePark,09/28/2016 08:00:00 PM,48,-122,5,5,10
24045,ElliotBayTrailMyrtlePark,09/28/2016 09:00:00 PM,48,-122,42,6,48
24046,ElliotBayTrailMyrtlePark,09/28/2016 10:00:00 PM,48,-122,7,1,8
24047,ElliotBayTrailMyrtlePark,09/28/2016 11:00:00 PM,48,-122,1,1,2
24048,ElliotBayTrailMyrtlePark,09/29/2016 12:00:00 AM,48,-122,0,0,0
24049,ElliotBayTrailMyrtlePark,09/29/2016 01:00:00 AM,48,-122,0,2,2
24050,ElliotBayTrailMyrtlePark,09/29/2016 02:00:00 AM,48,-122,1,0,1
24051,ElliotBayTrailMyrtlePark,09/29/2016 03:00:00 AM,48,-122,0,3,3
24052,ElliotBayTrailMyrtlePark,09/29/2016 04:00:00 AM,48,-122,5,0,5
24053,ElliotBayTrailMyrtlePark,09/29/2016 05:00:00 AM,48,-122,15,24,39
24054,ElliotBayTrailMyrtlePark,09/29/2016 06:00:00 AM,48,-122,30,54,84
24055,ElliotBayTrailMyrtlePark,09/29/2016 07:00:00 AM,48,-122,39,120,159
24056,ElliotBayTrailMyrtlePark,09/29/2016 08:00:00 AM,48,-122,51,127,178
24057,ElliotBayTrailMyrtlePark,09/29/2016 09:00:00 AM,48,-122,42,43,85
24058,ElliotBayTrailMyrtlePark,09/29/2016 10:00:00 AM,48,-122,17,32,49
24059,ElliotBayTrailMyrtlePark,09/29/2016 11:00:00 AM,48,-122,28,29,57
24060,ElliotBayTrailMyrtlePark,09/29/2016 12:00:00 PM,48,-122,31,24,55
24061,ElliotBayTrailMyrtlePark,09/29/2016 01:00:00 PM,48,-122,22,15,37
24062,ElliotBayTrailMyrtlePark,09/29/2016 02:00:00 PM,48,-122,46,32,78
24063,ElliotBayTrailMyrtlePark,09/29/2016 03:00:00 PM,48,-122,73,63,136
24064,ElliotBayTrailMyrtlePark,09/29/2016 04:00:00 PM,48,-122,145,71,216
24065,ElliotBayTrailMyrtlePark,09/29/2016 05:00:00 PM,48,-122,162,57,219
24066,ElliotBayTrailMyrtlePark,09/29/2016 06:00:00 PM,48,-122,47,32,79
24067,ElliotBayTrailMyrtlePark,09/29/2016 07:00:00 PM,48,-122,21,10,31
24068,ElliotBayTrailMyrtlePark,09/29/2016 08:00:00 PM,48,-122,2,2,4
24069,ElliotBayTrailMyrtlePark,09/29/2016 09:00:00 PM,48,-122,12,7,19
24070,ElliotBayTrailMyrtlePark,09/29/2016 10:00:00 PM,48,-122,5,0,5
24071,ElliotBayTrailMyrtlePark,09/29/2016 11:00:00 PM,48,-122,0,3,3
24072,ElliotBayTrailMyrtlePark,09/30/2016 12:00:00 AM,48,-122,2,0,2
24073,ElliotBayTrailMyrtlePark,09/30/2016 01:00:00 AM,48,-122,3,0,3
24074,ElliotBayTrailMyrtlePark,09/30/2016 02:00:00 AM,48,-122,3,0,3
24075,ElliotBayTrailMyrtlePark,09/30/2016 03:00:00 AM,48,-122,0,0,0
24076,ElliotBayTrailMyrtlePark,09/30/2016 04:00:00 AM,48,-122,5,2,7
24077,ElliotBayTrailMyrtlePark,09/30/2016 05:00:00 AM,48,-122,10,12,22
24078,ElliotBayTrailMyrtlePark,09/30/2016 06:00:00 AM,48,-122,29,33,62
24079,ElliotBayTrailMyrtlePark,09/30/2016 07:00:00 AM,48,-122,33,126,159
24080,ElliotBayTrailMyrtlePark,09/30/2016 08:00:00 AM,48,-122,38,120,158
24081,ElliotBayTrailMyrtlePark,09/30/2016 09:00:00 AM,48,-122,30,38,68
24082,ElliotBayTrailMyrtlePark,09/30/2016 10:00:00 AM,48,-122,18,31,49
24083,ElliotBayTrailMyrtlePark,09/30/2016 11:00:00 AM,48,-122,14,17,31
24084,ElliotBayTrailMyrtlePark,09/30/2016 12:00:00 PM,48,-122,36,27,63
24085,ElliotBayTrailMyrtlePark,09/30/2016 01:00:00 PM,48,-122,29,25,54
24086,ElliotBayTrailMyrtlePark,09/30/2016 02:00:00 PM,48,-122,59,30,89
24087,ElliotBayTrailMyrtlePark,09/30/2016 03:00:00 PM,48,-122,76,36,112
24088,ElliotBayTrailMyrtlePark,09/30/2016 04:00:00 PM,48,-122,130,58,188
24089,ElliotBayTrailMyrtlePark,09/30/2016 05:00:00 PM,48,-122,148,55,203
24090,ElliotBayTrailMyrtlePark,09/30/2016 06:00:00 PM,48,-122,58,21,79
24091,ElliotBayTrailMyrtlePark,09/30/2016 07:00:00 PM,48,-122,10,8,18
24092,ElliotBayTrailMyrtlePark,09/30/2016 08:00:00 PM,48,-122,4,4,8
24093,ElliotBayTrailMyrtlePark,09/30/2016 09:00:00 PM,48,-122,19,5,24
24094,ElliotBayTrailMyrtlePark,09/30/2016 10:00:00 PM,48,-122,7,0,7
24095,ElliotBayTrailMyrtlePark,09/30/2016 11:00:00 PM,48,-122,1,0,1
24096,ElliotBayTrailMyrtlePark,10/01/2016 12:00:00 AM,48,-122,2,0,2
24097,ElliotBayTrailMyrtlePark,10/01/2016 01:00:00 AM,48,-122,2,2,4
24098,ElliotBayTrailMyrtlePark,10/01/2016 02:00:00 AM,48,-122,0,0,0
24099,ElliotBayTrailMyrtlePark,10/01/2016 03:00:00 AM,48,-122,1,0,1
24100,ElliotBayTrailMyrtlePark,10/01/2016 04:00:00 AM,48,-122,0,1,1
24101,ElliotBayTrailMyrtlePark,10/01/2016 05:00:00 AM,48,-122,3,2,5
24102,ElliotBayTrailMyrtlePark,10/01/2016 06:00:00 AM,48,-122,4,3,7
24103,ElliotBayTrailMyrtlePark,10/01/2016 07:00:00 AM,48,-122,15,13,28
24104,ElliotBayTrailMyrtlePark,10/01/2016 08:00:00 AM,48,-122,9,15,24
24105,ElliotBayTrailMyrtlePark,10/01/2016 09:00:00 AM,48,-122,12,13,25
24106,ElliotBayTrailMyrtlePark,10/01/2016 10:00:00 AM,48,-122,16,21,37
24107,ElliotBayTrailMyrtlePark,10/01/2016 11:00:00 AM,48,-122,15,22,37
24108,ElliotBayTrailMyrtlePark,10/01/2016 12:00:00 PM,48,-122,14,9,23
24109,ElliotBayTrailMyrtlePark,10/01/2016 01:00:00 PM,48,-122,8,10,18
24110,ElliotBayTrailMyrtlePark,10/01/2016 02:00:00 PM,48,-122,20,16,36
24111,ElliotBayTrailMyrtlePark,10/01/2016 03:00:00 PM,48,-122,17,14,31
24112,ElliotBayTrailMyrtlePark,10/01/2016 04:00:00 PM,48,-122,29,27,56
24113,ElliotBayTrailMyrtlePark,10/01/2016 05:00:00 PM,48,-122,4,10,14
24114,ElliotBayTrailMyrtlePark,10/01/2016 06:00:00 PM,48,-122,3,5,8
24115,ElliotBayTrailMyrtlePark,10/01/2016 07:00:00 PM,48,-122,2,1,3
24116,ElliotBayTrailMyrtlePark,10/01/2016 08:00:00 PM,48,-122,2,5,7
24117,ElliotBayTrailMyrtlePark,10/01/2016 09:00:00 PM,48,-122,2,6,8
24118,ElliotBayTrailMyrtlePark,10/01/2016 10:00:00 PM,48,-122,4,1,5
24119,ElliotBayTrailMyrtlePark,10/01/2016 11:00:00 PM,48,-122,1,0,1
24120,ElliotBayTrailMyrtlePark,10/02/2016 12:00:00 AM,48,-122,0,1,1
24121,ElliotBayTrailMyrtlePark,10/02/2016 01:00:00 AM,48,-122,0,0,0
24122,ElliotBayTrailMyrtlePark,10/02/2016 02:00:00 AM,48,-122,1,0,1
24123,ElliotBayTrailMyrtlePark,10/02/2016 03:00:00 AM,48,-122,1,1,2
24124,ElliotBayTrailMyrtlePark,10/02/2016 04:00:00 AM,48,-122,0,1,1
24125,ElliotBayTrailMyrtlePark,10/02/2016 05:00:00 AM,48,-122,0,1,1
24126,ElliotBayTrailMyrtlePark,10/02/2016 06:00:00 AM,48,-122,1,3,4
24127,ElliotBayTrailMyrtlePark,10/02/2016 07:00:00 AM,48,-122,3,8,11
24128,ElliotBayTrailMyrtlePark,10/02/2016 08:00:00 AM,48,-122,13,11,24
24129,ElliotBayTrailMyrtlePark,10/02/2016 09:00:00 AM,48,-122,25,21,46
24130,ElliotBayTrailMyrtlePark,10/02/2016 10:00:00 AM,48,-122,27,42,69
24131,ElliotBayTrailMyrtlePark,10/02/2016 11:00:00 AM,48,-122,45,56,101
24132,ElliotBayTrailMyrtlePark,10/02/2016 12:00:00 PM,48,-122,47,19,66
24133,ElliotBayTrailMyrtlePark,10/02/2016 01:00:00 PM,48,-122,61,44,105
24134,ElliotBayTrailMyrtlePark,10/02/2016 02:00:00 PM,48,-122,68,60,128
24135,ElliotBayTrailMyrtlePark,10/02/2016 03:00:00 PM,48,-122,62,29,91
24136,ElliotBayTrailMyrtlePark,10/02/2016 04:00:00 PM,48,-122,57,37,94
24137,ElliotBayTrailMyrtlePark,10/02/2016 05:00:00 PM,48,-122,31,49,80
24138,ElliotBayTrailMyrtlePark,10/02/2016 06:00:00 PM,48,-122,12,20,32
24139,ElliotBayTrailMyrtlePark,10/02/2016 07:00:00 PM,48,-122,3,5,8
24140,ElliotBayTrailMyrtlePark,10/02/2016 08:00:00 PM,48,-122,6,1,7
24141,ElliotBayTrailMyrtlePark,10/02/2016 09:00:00 PM,48,-122,1,1,2
24142,ElliotBayTrailMyrtlePark,10/02/2016 10:00:00 PM,48,-122,0,0,0
24143,ElliotBayTrailMyrtlePark,10/02/2016 11:00:00 PM,48,-122,2,0,2
24144,ElliotBayTrailMyrtlePark,10/03/2016 12:00:00 AM,48,-122,1,0,1
24145,ElliotBayTrailMyrtlePark,10/03/2016 01:00:00 AM,48,-122,0,0,0
24146,ElliotBayTrailMyrtlePark,10/03/2016 02:00:00 AM,48,-122,1,0,1
24147,ElliotBayTrailMyrtlePark,10/03/2016 03:00:00 AM,48,-122,1,1,2
24148,ElliotBayTrailMyrtlePark,10/03/2016 04:00:00 AM,48,-122,2,0,2
24149,ElliotBayTrailMyrtlePark,10/03/2016 05:00:00 AM,48,-122,14,15,29
24150,ElliotBayTrailMyrtlePark,10/03/2016 06:00:00 AM,48,-122,23,44,67
24151,ElliotBayTrailMyrtlePark,10/03/2016 07:00:00 AM,48,-122,44,158,202
24152,ElliotBayTrailMyrtlePark,10/03/2016 08:00:00 AM,48,-122,35,120,155
24153,ElliotBayTrailMyrtlePark,10/03/2016 09:00:00 AM,48,-122,23,36,59
24154,ElliotBayTrailMyrtlePark,10/03/2016 10:00:00 AM,48,-122,19,12,31
24155,ElliotBayTrailMyrtlePark,10/03/2016 11:00:00 AM,48,-122,12,18,30
24156,ElliotBayTrailMyrtlePark,10/03/2016 12:00:00 PM,48,-122,12,17,29
24157,ElliotBayTrailMyrtlePark,10/03/2016 01:00:00 PM,48,-122,52,15,67
24158,ElliotBayTrailMyrtlePark,10/03/2016 02:00:00 PM,48,-122,30,17,47
24159,ElliotBayTrailMyrtlePark,10/03/2016 03:00:00 PM,48,-122,56,79,135
24160,ElliotBayTrailMyrtlePark,10/03/2016 04:00:00 PM,48,-122,141,51,192
24161,ElliotBayTrailMyrtlePark,10/03/2016 05:00:00 PM,48,-122,176,56,232
24162,ElliotBayTrailMyrtlePark,10/03/2016 06:00:00 PM,48,-122,64,18,82
24163,ElliotBayTrailMyrtlePark,10/03/2016 07:00:00 PM,48,-122,10,11,21
24164,ElliotBayTrailMyrtlePark,10/03/2016 08:00:00 PM,48,-122,1,6,7
24165,ElliotBayTrailMyrtlePark,10/03/2016 09:00:00 PM,48,-122,3,4,7
24166,ElliotBayTrailMyrtlePark,10/03/2016 10:00:00 PM,48,-122,3,0,3
24167,ElliotBayTrailMyrtlePark,10/03/2016 11:00:00 PM,48,-122,1,0,1
24168,ElliotBayTrailMyrtlePark,10/04/2016 12:00:00 AM,48,-122,1,0,1
24169,ElliotBayTrailMyrtlePark,10/04/2016 01:00:00 AM,48,-122,4,1,5
24170,ElliotBayTrailMyrtlePark,10/04/2016 02:00:00 AM,48,-122,1,1,2
24171,ElliotBayTrailMyrtlePark,10/04/2016 03:00:00 AM,48,-122,0,2,2
24172,ElliotBayTrailMyrtlePark,10/04/2016 04:00:00 AM,48,-122,4,2,6
24173,ElliotBayTrailMyrtlePark,10/04/2016 05:00:00 AM,48,-122,12,15,27
24174,ElliotBayTrailMyrtlePark,10/04/2016 06:00:00 AM,48,-122,18,33,51
24175,ElliotBayTrailMyrtlePark,10/04/2016 07:00:00 AM,48,-122,33,117,150
24176,ElliotBayTrailMyrtlePark,10/04/2016 08:00:00 AM,48,-122,26,106,132
24177,ElliotBayTrailMyrtlePark,10/04/2016 09:00:00 AM,48,-122,7,23,30
24178,ElliotBayTrailMyrtlePark,10/04/2016 10:00:00 AM,48,-122,9,13,22
24179,ElliotBayTrailMyrtlePark,10/04/2016 11:00:00 AM,48,-122,17,10,27
24180,ElliotBayTrailMyrtlePark,10/04/2016 12:00:00 PM,48,-122,16,17,33
24181,ElliotBayTrailMyrtlePark,10/04/2016 01:00:00 PM,48,-122,13,9,22
24182,ElliotBayTrailMyrtlePark,10/04/2016 02:00:00 PM,48,-122,56,17,73
24183,ElliotBayTrailMyrtlePark,10/04/2016 03:00:00 PM,48,-122,36,54,90
24184,ElliotBayTrailMyrtlePark,10/04/2016 04:00:00 PM,48,-122,101,54,155
24185,ElliotBayTrailMyrtlePark,10/04/2016 05:00:00 PM,48,-122,135,26,161
24186,ElliotBayTrailMyrtlePark,10/04/2016 06:00:00 PM,48,-122,43,11,54
24187,ElliotBayTrailMyrtlePark,10/04/2016 07:00:00 PM,48,-122,7,2,9
24188,ElliotBayTrailMyrtlePark,10/04/2016 08:00:00 PM,48,-122,5,2,7
24189,ElliotBayTrailMyrtlePark,10/04/2016 09:00:00 PM,48,-122,0,5,5
24190,ElliotBayTrailMyrtlePark,10/04/2016 10:00:00 PM,48,-122,1,1,2
24191,ElliotBayTrailMyrtlePark,10/04/2016 11:00:00 PM,48,-122,2,2,4
24192,ElliotBayTrailMyrtlePark,10/05/2016 12:00:00 AM,48,-122,1,0,1
24193,ElliotBayTrailMyrtlePark,10/05/2016 01:00:00 AM,48,-122,2,0,2
24194,ElliotBayTrailMyrtlePark,10/05/2016 02:00:00 AM,48,-122,0,0,0
24195,ElliotBayTrailMyrtlePark,10/05/2016 03:00:00 AM,48,-122,2,2,4
24196,ElliotBayTrailMyrtlePark,10/05/2016 04:00:00 AM,48,-122,4,1,5
24197,ElliotBayTrailMyrtlePark,10/05/2016 05:00:00 AM,48,-122,10,17,27
24198,ElliotBayTrailMyrtlePark,10/05/2016 06:00:00 AM,48,-122,14,30,44
24199,ElliotBayTrailMyrtlePark,10/05/2016 07:00:00 AM,48,-122,30,120,150
24200,ElliotBayTrailMyrtlePark,10/05/2016 08:00:00 AM,48,-122,26,95,121
24201,ElliotBayTrailMyrtlePark,10/05/2016 09:00:00 AM,48,-122,11,33,44
24202,ElliotBayTrailMyrtlePark,10/05/2016 10:00:00 AM,48,-122,8,11,19
24203,ElliotBayTrailMyrtlePark,10/05/2016 11:00:00 AM,48,-122,13,12,25
24204,ElliotBayTrailMyrtlePark,10/05/2016 12:00:00 PM,48,-122,15,15,30
24205,ElliotBayTrailMyrtlePark,10/05/2016 01:00:00 PM,48,-122,31,14,45
24206,ElliotBayTrailMyrtlePark,10/05/2016 02:00:00 PM,48,-122,18,27,45
24207,ElliotBayTrailMyrtlePark,10/05/2016 03:00:00 PM,48,-122,51,47,98
24208,ElliotBayTrailMyrtlePark,10/05/2016 04:00:00 PM,48,-122,115,58,173
24209,ElliotBayTrailMyrtlePark,10/05/2016 05:00:00 PM,48,-122,144,47,191
24210,ElliotBayTrailMyrtlePark,10/05/2016 06:00:00 PM,48,-122,59,35,94
24211,ElliotBayTrailMyrtlePark,10/05/2016 07:00:00 PM,48,-122,15,8,23
24212,ElliotBayTrailMyrtlePark,10/05/2016 08:00:00 PM,48,-122,1,4,5
24213,ElliotBayTrailMyrtlePark,10/05/2016 09:00:00 PM,48,-122,3,3,6
24214,ElliotBayTrailMyrtlePark,10/05/2016 10:00:00 PM,48,-122,3,2,5
24215,ElliotBayTrailMyrtlePark,10/05/2016 11:00:00 PM,48,-122,1,2,3
24216,ElliotBayTrailMyrtlePark,10/06/2016 12:00:00 AM,48,-122,0,0,0
24217,ElliotBayTrailMyrtlePark,10/06/2016 01:00:00 AM,48,-122,2,0,2
24218,ElliotBayTrailMyrtlePark,10/06/2016 02:00:00 AM,48,-122,0,2,2
24219,ElliotBayTrailMyrtlePark,10/06/2016 03:00:00 AM,48,-122,0,1,1
24220,ElliotBayTrailMyrtlePark,10/06/2016 04:00:00 AM,48,-122,7,0,7
24221,ElliotBayTrailMyrtlePark,10/06/2016 05:00:00 AM,48,-122,14,22,36
24222,ElliotBayTrailMyrtlePark,10/06/2016 06:00:00 AM,48,-122,15,34,49
24223,ElliotBayTrailMyrtlePark,10/06/2016 07:00:00 AM,48,-122,37,100,137
24224,ElliotBayTrailMyrtlePark,10/06/2016 08:00:00 AM,48,-122,38,108,146
24225,ElliotBayTrailMyrtlePark,10/06/2016 09:00:00 AM,48,-122,20,37,57
24226,ElliotBayTrailMyrtlePark,10/06/2016 10:00:00 AM,48,-122,10,31,41
24227,ElliotBayTrailMyrtlePark,10/06/2016 11:00:00 AM,48,-122,14,20,34
24228,ElliotBayTrailMyrtlePark,10/06/2016 12:00:00 PM,48,-122,22,16,38
24229,ElliotBayTrailMyrtlePark,10/06/2016 01:00:00 PM,48,-122,14,9,23
24230,ElliotBayTrailMyrtlePark,10/06/2016 02:00:00 PM,48,-122,27,24,51
24231,ElliotBayTrailMyrtlePark,10/06/2016 03:00:00 PM,48,-122,37,23,60
24232,ElliotBayTrailMyrtlePark,10/06/2016 04:00:00 PM,48,-122,110,49,159
24233,ElliotBayTrailMyrtlePark,10/06/2016 05:00:00 PM,48,-122,133,26,159
24234,ElliotBayTrailMyrtlePark,10/06/2016 06:00:00 PM,48,-122,38,13,51
24235,ElliotBayTrailMyrtlePark,10/06/2016 07:00:00 PM,48,-122,18,6,24
24236,ElliotBayTrailMyrtlePark,10/06/2016 08:00:00 PM,48,-122,6,1,7
24237,ElliotBayTrailMyrtlePark,10/06/2016 09:00:00 PM,48,-122,3,3,6
24238,ElliotBayTrailMyrtlePark,10/06/2016 10:00:00 PM,48,-122,3,1,4
24239,ElliotBayTrailMyrtlePark,10/06/2016 11:00:00 PM,48,-122,1,0,1
24240,ElliotBayTrailMyrtlePark,10/07/2016 12:00:00 AM,48,-122,0,0,0
24241,ElliotBayTrailMyrtlePark,10/07/2016 01:00:00 AM,48,-122,2,0,2
24242,ElliotBayTrailMyrtlePark,10/07/2016 02:00:00 AM,48,-122,0,0,0
24243,ElliotBayTrailMyrtlePark,10/07/2016 03:00:00 AM,48,-122,0,0,0
24244,ElliotBayTrailMyrtlePark,10/07/2016 04:00:00 AM,48,-122,0,0,0
24245,ElliotBayTrailMyrtlePark,10/07/2016 05:00:00 AM,48,-122,11,14,25
24246,ElliotBayTrailMyrtlePark,10/07/2016 06:00:00 AM,48,-122,13,23,36
24247,ElliotBayTrailMyrtlePark,10/07/2016 07:00:00 AM,48,-122,32,71,103
24248,ElliotBayTrailMyrtlePark,10/07/2016 08:00:00 AM,48,-122,29,65,94
24249,ElliotBayTrailMyrtlePark,10/07/2016 09:00:00 AM,48,-122,14,15,29
24250,ElliotBayTrailMyrtlePark,10/07/2016 10:00:00 AM,48,-122,11,9,20
24251,ElliotBayTrailMyrtlePark,10/07/2016 11:00:00 AM,48,-122,10,6,16
24252,ElliotBayTrailMyrtlePark,10/07/2016 12:00:00 PM,48,-122,22,18,40
24253,ElliotBayTrailMyrtlePark,10/07/2016 01:00:00 PM,48,-122,22,14,36
24254,ElliotBayTrailMyrtlePark,10/07/2016 02:00:00 PM,48,-122,30,21,51
24255,ElliotBayTrailMyrtlePark,10/07/2016 03:00:00 PM,48,-122,47,29,76
24256,ElliotBayTrailMyrtlePark,10/07/2016 04:00:00 PM,48,-122,78,53,131
24257,ElliotBayTrailMyrtlePark,10/07/2016 05:00:00 PM,48,-122,78,18,96
24258,ElliotBayTrailMyrtlePark,10/07/2016 06:00:00 PM,48,-122,23,13,36
24259,ElliotBayTrailMyrtlePark,10/07/2016 07:00:00 PM,48,-122,8,11,19
24260,ElliotBayTrailMyrtlePark,10/07/2016 08:00:00 PM,48,-122,1,1,2
24261,ElliotBayTrailMyrtlePark,10/07/2016 09:00:00 PM,48,-122,0,3,3
24262,ElliotBayTrailMyrtlePark,10/07/2016 10:00:00 PM,48,-122,0,3,3
24263,ElliotBayTrailMyrtlePark,10/07/2016 11:00:00 PM,48,-122,1,0,1
24264,ElliotBayTrailMyrtlePark,10/08/2016 12:00:00 AM,48,-122,3,1,4
24265,ElliotBayTrailMyrtlePark,10/08/2016 01:00:00 AM,48,-122,0,0,0
24266,ElliotBayTrailMyrtlePark,10/08/2016 02:00:00 AM,48,-122,1,0,1
24267,ElliotBayTrailMyrtlePark,10/08/2016 03:00:00 AM,48,-122,1,0,1
24268,ElliotBayTrailMyrtlePark,10/08/2016 04:00:00 AM,48,-122,0,0,0
24269,ElliotBayTrailMyrtlePark,10/08/2016 05:00:00 AM,48,-122,1,3,4
24270,ElliotBayTrailMyrtlePark,10/08/2016 06:00:00 AM,48,-122,0,1,1
24271,ElliotBayTrailMyrtlePark,10/08/2016 07:00:00 AM,48,-122,6,1,7
24272,ElliotBayTrailMyrtlePark,10/08/2016 08:00:00 AM,48,-122,8,15,23
24273,ElliotBayTrailMyrtlePark,10/08/2016 09:00:00 AM,48,-122,6,13,19
24274,ElliotBayTrailMyrtlePark,10/08/2016 10:00:00 AM,48,-122,17,13,30
24275,ElliotBayTrailMyrtlePark,10/08/2016 11:00:00 AM,48,-122,14,11,25
24276,ElliotBayTrailMyrtlePark,10/08/2016 12:00:00 PM,48,-122,14,16,30
24277,ElliotBayTrailMyrtlePark,10/08/2016 01:00:00 PM,48,-122,8,8,16
24278,ElliotBayTrailMyrtlePark,10/08/2016 02:00:00 PM,48,-122,4,6,10
24279,ElliotBayTrailMyrtlePark,10/08/2016 03:00:00 PM,48,-122,8,4,12
24280,ElliotBayTrailMyrtlePark,10/08/2016 04:00:00 PM,48,-122,2,4,6
24281,ElliotBayTrailMyrtlePark,10/08/2016 05:00:00 PM,48,-122,2,3,5
24282,ElliotBayTrailMyrtlePark,10/08/2016 06:00:00 PM,48,-122,0,1,1
24283,ElliotBayTrailMyrtlePark,10/08/2016 07:00:00 PM,48,-122,3,0,3
24284,ElliotBayTrailMyrtlePark,10/08/2016 08:00:00 PM,48,-122,0,1,1
24285,ElliotBayTrailMyrtlePark,10/08/2016 09:00:00 PM,48,-122,2,1,3
24286,ElliotBayTrailMyrtlePark,10/08/2016 10:00:00 PM,48,-122,0,1,1
24287,ElliotBayTrailMyrtlePark,10/08/2016 11:00:00 PM,48,-122,0,0,0
24288,ElliotBayTrailMyrtlePark,10/09/2016 12:00:00 AM,48,-122,0,0,0
24289,ElliotBayTrailMyrtlePark,10/09/2016 01:00:00 AM,48,-122,0,1,1
24290,ElliotBayTrailMyrtlePark,10/09/2016 02:00:00 AM,48,-122,0,0,0
24291,ElliotBayTrailMyrtlePark,10/09/2016 03:00:00 AM,48,-122,0,0,0
24292,ElliotBayTrailMyrtlePark,10/09/2016 04:00:00 AM,48,-122,0,1,1
24293,ElliotBayTrailMyrtlePark,10/09/2016 05:00:00 AM,48,-122,1,2,3
24294,ElliotBayTrailMyrtlePark,10/09/2016 06:00:00 AM,48,-122,3,0,3
24295,ElliotBayTrailMyrtlePark,10/09/2016 07:00:00 AM,48,-122,7,4,11
24296,ElliotBayTrailMyrtlePark,10/09/2016 08:00:00 AM,48,-122,10,7,17
24297,ElliotBayTrailMyrtlePark,10/09/2016 09:00:00 AM,48,-122,24,16,40
24298,ElliotBayTrailMyrtlePark,10/09/2016 10:00:00 AM,48,-122,24,18,42
24299,ElliotBayTrailMyrtlePark,10/09/2016 11:00:00 AM,48,-122,30,20,50
24300,ElliotBayTrailMyrtlePark,10/09/2016 12:00:00 PM,48,-122,22,21,43
24301,ElliotBayTrailMyrtlePark,10/09/2016 01:00:00 PM,48,-122,34,27,61
24302,ElliotBayTrailMyrtlePark,10/09/2016 02:00:00 PM,48,-122,28,39,67
24303,ElliotBayTrailMyrtlePark,10/09/2016 03:00:00 PM,48,-122,47,23,70
24304,ElliotBayTrailMyrtlePark,10/09/2016 04:00:00 PM,48,-122,16,19,35
24305,ElliotBayTrailMyrtlePark,10/09/2016 05:00:00 PM,48,-122,7,9,16
24306,ElliotBayTrailMyrtlePark,10/09/2016 06:00:00 PM,48,-122,1,0,1
24307,ElliotBayTrailMyrtlePark,10/09/2016 07:00:00 PM,48,-122,10,0,10
24308,ElliotBayTrailMyrtlePark,10/09/2016 08:00:00 PM,48,-122,1,1,2
24309,ElliotBayTrailMyrtlePark,10/09/2016 09:00:00 PM,48,-122,1,0,1
24310,ElliotBayTrailMyrtlePark,10/09/2016 10:00:00 PM,48,-122,0,0,0
24311,ElliotBayTrailMyrtlePark,10/09/2016 11:00:00 PM,48,-122,1,0,1
24312,ElliotBayTrailMyrtlePark,10/10/2016 12:00:00 AM,48,-122,0,0,0
24313,ElliotBayTrailMyrtlePark,10/10/2016 01:00:00 AM,48,-122,0,0,0
24314,ElliotBayTrailMyrtlePark,10/10/2016 02:00:00 AM,48,-122,1,0,1
24315,ElliotBayTrailMyrtlePark,10/10/2016 03:00:00 AM,48,-122,0,1,1
24316,ElliotBayTrailMyrtlePark,10/10/2016 04:00:00 AM,48,-122,6,0,6
24317,ElliotBayTrailMyrtlePark,10/10/2016 05:00:00 AM,48,-122,15,15,30
24318,ElliotBayTrailMyrtlePark,10/10/2016 06:00:00 AM,48,-122,19,28,47
24319,ElliotBayTrailMyrtlePark,10/10/2016 07:00:00 AM,48,-122,35,125,160
24320,ElliotBayTrailMyrtlePark,10/10/2016 08:00:00 AM,48,-122,33,113,146
24321,ElliotBayTrailMyrtlePark,10/10/2016 09:00:00 AM,48,-122,8,36,44
24322,ElliotBayTrailMyrtlePark,10/10/2016 10:00:00 AM,48,-122,13,25,38
24323,ElliotBayTrailMyrtlePark,10/10/2016 11:00:00 AM,48,-122,19,19,38
24324,ElliotBayTrailMyrtlePark,10/10/2016 12:00:00 PM,48,-122,20,21,41
24325,ElliotBayTrailMyrtlePark,10/10/2016 01:00:00 PM,48,-122,18,21,39
24326,ElliotBayTrailMyrtlePark,10/10/2016 02:00:00 PM,48,-122,35,23,58
24327,ElliotBayTrailMyrtlePark,10/10/2016 03:00:00 PM,48,-122,56,46,102
24328,ElliotBayTrailMyrtlePark,10/10/2016 04:00:00 PM,48,-122,105,60,165
24329,ElliotBayTrailMyrtlePark,10/10/2016 05:00:00 PM,48,-122,164,43,207
24330,ElliotBayTrailMyrtlePark,10/10/2016 06:00:00 PM,48,-122,53,30,83
24331,ElliotBayTrailMyrtlePark,10/10/2016 07:00:00 PM,48,-122,12,4,16
24332,ElliotBayTrailMyrtlePark,10/10/2016 08:00:00 PM,48,-122,4,3,7
24333,ElliotBayTrailMyrtlePark,10/10/2016 09:00:00 PM,48,-122,1,5,6
24334,ElliotBayTrailMyrtlePark,10/10/2016 10:00:00 PM,48,-122,6,4,10
24335,ElliotBayTrailMyrtlePark,10/10/2016 11:00:00 PM,48,-122,2,0,2
24336,ElliotBayTrailMyrtlePark,10/11/2016 12:00:00 AM,48,-122,2,0,2
24337,ElliotBayTrailMyrtlePark,10/11/2016 01:00:00 AM,48,-122,0,0,0
24338,ElliotBayTrailMyrtlePark,10/11/2016 02:00:00 AM,48,-122,0,0,0
24339,ElliotBayTrailMyrtlePark,10/11/2016 03:00:00 AM,48,-122,0,1,1
24340,ElliotBayTrailMyrtlePark,10/11/2016 04:00:00 AM,48,-122,5,1,6
24341,ElliotBayTrailMyrtlePark,10/11/2016 05:00:00 AM,48,-122,13,34,47
24342,ElliotBayTrailMyrtlePark,10/11/2016 06:00:00 AM,48,-122,29,47,76
24343,ElliotBayTrailMyrtlePark,10/11/2016 07:00:00 AM,48,-122,41,123,164
24344,ElliotBayTrailMyrtlePark,10/11/2016 08:00:00 AM,48,-122,34,128,162
24345,ElliotBayTrailMyrtlePark,10/11/2016 09:00:00 AM,48,-122,15,34,49
24346,ElliotBayTrailMyrtlePark,10/11/2016 10:00:00 AM,48,-122,15,12,27
24347,ElliotBayTrailMyrtlePark,10/11/2016 11:00:00 AM,48,-122,30,22,52
24348,ElliotBayTrailMyrtlePark,10/11/2016 12:00:00 PM,48,-122,28,19,47
24349,ElliotBayTrailMyrtlePark,10/11/2016 01:00:00 PM,48,-122,19,10,29
24350,ElliotBayTrailMyrtlePark,10/11/2016 02:00:00 PM,48,-122,27,41,68
24351,ElliotBayTrailMyrtlePark,10/11/2016 03:00:00 PM,48,-122,51,47,98
24352,ElliotBayTrailMyrtlePark,10/11/2016 04:00:00 PM,48,-122,150,75,225
24353,ElliotBayTrailMyrtlePark,10/11/2016 05:00:00 PM,48,-122,162,69,231
24354,ElliotBayTrailMyrtlePark,10/11/2016 06:00:00 PM,48,-122,64,36,100
24355,ElliotBayTrailMyrtlePark,10/11/2016 07:00:00 PM,48,-122,15,6,21
24356,ElliotBayTrailMyrtlePark,10/11/2016 08:00:00 PM,48,-122,2,3,5
24357,ElliotBayTrailMyrtlePark,10/11/2016 09:00:00 PM,48,-122,4,3,7
24358,ElliotBayTrailMyrtlePark,10/11/2016 10:00:00 PM,48,-122,2,0,2
24359,ElliotBayTrailMyrtlePark,10/11/2016 11:00:00 PM,48,-122,0,0,0
24360,ElliotBayTrailMyrtlePark,10/12/2016 12:00:00 AM,48,-122,0,0,0
24361,ElliotBayTrailMyrtlePark,10/12/2016 01:00:00 AM,48,-122,1,0,1
24362,ElliotBayTrailMyrtlePark,10/12/2016 02:00:00 AM,48,-122,1,0,1
24363,ElliotBayTrailMyrtlePark,10/12/2016 03:00:00 AM,48,-122,0,1,1
24364,ElliotBayTrailMyrtlePark,10/12/2016 04:00:00 AM,48,-122,4,1,5
24365,ElliotBayTrailMyrtlePark,10/12/2016 05:00:00 AM,48,-122,14,14,28
24366,ElliotBayTrailMyrtlePark,10/12/2016 06:00:00 AM,48,-122,25,45,70
24367,ElliotBayTrailMyrtlePark,10/12/2016 07:00:00 AM,48,-122,38,132,170
24368,ElliotBayTrailMyrtlePark,10/12/2016 08:00:00 AM,48,-122,35,117,152
24369,ElliotBayTrailMyrtlePark,10/12/2016 09:00:00 AM,48,-122,24,23,47
24370,ElliotBayTrailMyrtlePark,10/12/2016 10:00:00 AM,48,-122,17,29,46
24371,ElliotBayTrailMyrtlePark,10/12/2016 11:00:00 AM,48,-122,16,22,38
24372,ElliotBayTrailMyrtlePark,10/12/2016 12:00:00 PM,48,-122,24,17,41
24373,ElliotBayTrailMyrtlePark,10/12/2016 01:00:00 PM,48,-122,23,29,52
24374,ElliotBayTrailMyrtlePark,10/12/2016 02:00:00 PM,48,-122,28,26,54
24375,ElliotBayTrailMyrtlePark,10/12/2016 03:00:00 PM,48,-122,54,53,107
24376,ElliotBayTrailMyrtlePark,10/12/2016 04:00:00 PM,48,-122,144,64,208
24377,ElliotBayTrailMyrtlePark,10/12/2016 05:00:00 PM,48,-122,173,57,230
24378,ElliotBayTrailMyrtlePark,10/12/2016 06:00:00 PM,48,-122,43,31,74
24379,ElliotBayTrailMyrtlePark,10/12/2016 07:00:00 PM,48,-122,13,4,17
24380,ElliotBayTrailMyrtlePark,10/12/2016 08:00:00 PM,48,-122,7,2,9
24381,ElliotBayTrailMyrtlePark,10/12/2016 09:00:00 PM,48,-122,23,2,25
24382,ElliotBayTrailMyrtlePark,10/12/2016 10:00:00 PM,48,-122,7,1,8
24383,ElliotBayTrailMyrtlePark,10/12/2016 11:00:00 PM,48,-122,0,2,2
24384,ElliotBayTrailMyrtlePark,10/13/2016 12:00:00 AM,48,-122,0,0,0
24385,ElliotBayTrailMyrtlePark,10/13/2016 01:00:00 AM,48,-122,1,0,1
24386,ElliotBayTrailMyrtlePark,10/13/2016 02:00:00 AM,48,-122,1,0,1
24387,ElliotBayTrailMyrtlePark,10/13/2016 03:00:00 AM,48,-122,0,1,1
24388,ElliotBayTrailMyrtlePark,10/13/2016 04:00:00 AM,48,-122,0,0,0
24389,ElliotBayTrailMyrtlePark,10/13/2016 05:00:00 AM,48,-122,5,15,20
24390,ElliotBayTrailMyrtlePark,10/13/2016 06:00:00 AM,48,-122,13,14,27
24391,ElliotBayTrailMyrtlePark,10/13/2016 07:00:00 AM,48,-122,16,52,68
24392,ElliotBayTrailMyrtlePark,10/13/2016 08:00:00 AM,48,-122,13,44,57
24393,ElliotBayTrailMyrtlePark,10/13/2016 09:00:00 AM,48,-122,9,13,22
24394,ElliotBayTrailMyrtlePark,10/13/2016 10:00:00 AM,48,-122,1,5,6
24395,ElliotBayTrailMyrtlePark,10/13/2016 11:00:00 AM,48,-122,4,4,8
24396,ElliotBayTrailMyrtlePark,10/13/2016 12:00:00 PM,48,-122,4,3,7
24397,ElliotBayTrailMyrtlePark,10/13/2016 01:00:00 PM,48,-122,6,6,12
24398,ElliotBayTrailMyrtlePark,10/13/2016 02:00:00 PM,48,-122,12,9,21
24399,ElliotBayTrailMyrtlePark,10/13/2016 03:00:00 PM,48,-122,22,9,31
24400,ElliotBayTrailMyrtlePark,10/13/2016 04:00:00 PM,48,-122,40,19,59
24401,ElliotBayTrailMyrtlePark,10/13/2016 05:00:00 PM,48,-122,66,11,77
24402,ElliotBayTrailMyrtlePark,10/13/2016 06:00:00 PM,48,-122,9,7,16
24403,ElliotBayTrailMyrtlePark,10/13/2016 07:00:00 PM,48,-122,8,0,8
24404,ElliotBayTrailMyrtlePark,10/13/2016 08:00:00 PM,48,-122,1,1,2
24405,ElliotBayTrailMyrtlePark,10/13/2016 09:00:00 PM,48,-122,1,1,2
24406,ElliotBayTrailMyrtlePark,10/13/2016 10:00:00 PM,48,-122,1,0,1
24407,ElliotBayTrailMyrtlePark,10/13/2016 11:00:00 PM,48,-122,0,0,0
24408,ElliotBayTrailMyrtlePark,10/14/2016 12:00:00 AM,48,-122,1,0,1
24409,ElliotBayTrailMyrtlePark,10/14/2016 01:00:00 AM,48,-122,3,0,3
24410,ElliotBayTrailMyrtlePark,10/14/2016 02:00:00 AM,48,-122,0,0,0
24411,ElliotBayTrailMyrtlePark,10/14/2016 03:00:00 AM,48,-122,0,0,0
24412,ElliotBayTrailMyrtlePark,10/14/2016 04:00:00 AM,48,-122,1,0,1
24413,ElliotBayTrailMyrtlePark,10/14/2016 05:00:00 AM,48,-122,3,10,13
24414,ElliotBayTrailMyrtlePark,10/14/2016 06:00:00 AM,48,-122,9,7,16
24415,ElliotBayTrailMyrtlePark,10/14/2016 07:00:00 AM,48,-122,15,23,38
24416,ElliotBayTrailMyrtlePark,10/14/2016 08:00:00 AM,48,-122,8,30,38
24417,ElliotBayTrailMyrtlePark,10/14/2016 09:00:00 AM,48,-122,7,7,14
24418,ElliotBayTrailMyrtlePark,10/14/2016 10:00:00 AM,48,-122,6,2,8
24419,ElliotBayTrailMyrtlePark,10/14/2016 11:00:00 AM,48,-122,4,5,9
24420,ElliotBayTrailMyrtlePark,10/14/2016 12:00:00 PM,48,-122,3,1,4
24421,ElliotBayTrailMyrtlePark,10/14/2016 01:00:00 PM,48,-122,7,9,16
24422,ElliotBayTrailMyrtlePark,10/14/2016 02:00:00 PM,48,-122,12,3,15
24423,ElliotBayTrailMyrtlePark,10/14/2016 03:00:00 PM,48,-122,21,4,25
24424,ElliotBayTrailMyrtlePark,10/14/2016 04:00:00 PM,48,-122,28,16,44
24425,ElliotBayTrailMyrtlePark,10/14/2016 05:00:00 PM,48,-122,29,6,35
24426,ElliotBayTrailMyrtlePark,10/14/2016 06:00:00 PM,48,-122,17,5,22
24427,ElliotBayTrailMyrtlePark,10/14/2016 07:00:00 PM,48,-122,1,0,1
24428,ElliotBayTrailMyrtlePark,10/14/2016 08:00:00 PM,48,-122,0,1,1
24429,ElliotBayTrailMyrtlePark,10/14/2016 09:00:00 PM,48,-122,4,0,4
24430,ElliotBayTrailMyrtlePark,10/14/2016 10:00:00 PM,48,-122,2,1,3
24431,ElliotBayTrailMyrtlePark,10/14/2016 11:00:00 PM,48,-122,0,0,0
24432,ElliotBayTrailMyrtlePark,10/15/2016 12:00:00 AM,48,-122,1,0,1
24433,ElliotBayTrailMyrtlePark,10/15/2016 01:00:00 AM,48,-122,2,0,2
24434,ElliotBayTrailMyrtlePark,10/15/2016 02:00:00 AM,48,-122,0,0,0
24435,ElliotBayTrailMyrtlePark,10/15/2016 03:00:00 AM,48,-122,0,1,1
24436,ElliotBayTrailMyrtlePark,10/15/2016 04:00:00 AM,48,-122,0,1,1
24437,ElliotBayTrailMyrtlePark,10/15/2016 05:00:00 AM,48,-122,0,1,1
24438,ElliotBayTrailMyrtlePark,10/15/2016 06:00:00 AM,48,-122,2,3,5
24439,ElliotBayTrailMyrtlePark,10/15/2016 07:00:00 AM,48,-122,2,0,2
24440,ElliotBayTrailMyrtlePark,10/15/2016 08:00:00 AM,48,-122,1,5,6
24441,ElliotBayTrailMyrtlePark,10/15/2016 09:00:00 AM,48,-122,7,3,10
24442,ElliotBayTrailMyrtlePark,10/15/2016 10:00:00 AM,48,-122,14,6,20
24443,ElliotBayTrailMyrtlePark,10/15/2016 11:00:00 AM,48,-122,1,1,2
24444,ElliotBayTrailMyrtlePark,10/15/2016 12:00:00 PM,48,-122,2,2,4
24445,ElliotBayTrailMyrtlePark,10/15/2016 01:00:00 PM,48,-122,5,1,6
24446,ElliotBayTrailMyrtlePark,10/15/2016 02:00:00 PM,48,-122,4,2,6
24447,ElliotBayTrailMyrtlePark,10/15/2016 03:00:00 PM,48,-122,3,3,6
24448,ElliotBayTrailMyrtlePark,10/15/2016 04:00:00 PM,48,-122,5,4,9
24449,ElliotBayTrailMyrtlePark,10/15/2016 05:00:00 PM,48,-122,21,4,25
24450,ElliotBayTrailMyrtlePark,10/15/2016 06:00:00 PM,48,-122,1,1,2
24451,ElliotBayTrailMyrtlePark,10/15/2016 07:00:00 PM,48,-122,2,1,3
24452,ElliotBayTrailMyrtlePark,10/15/2016 08:00:00 PM,48,-122,7,0,7
24453,ElliotBayTrailMyrtlePark,10/15/2016 09:00:00 PM,48,-122,2,3,5
24454,ElliotBayTrailMyrtlePark,10/15/2016 10:00:00 PM,48,-122,0,0,0
24455,ElliotBayTrailMyrtlePark,10/15/2016 11:00:00 PM,48,-122,1,1,2
24456,ElliotBayTrailMyrtlePark,10/16/2016 12:00:00 AM,48,-122,0,1,1
24457,ElliotBayTrailMyrtlePark,10/16/2016 01:00:00 AM,48,-122,0,0,0
24458,ElliotBayTrailMyrtlePark,10/16/2016 02:00:00 AM,48,-122,2,0,2
24459,ElliotBayTrailMyrtlePark,10/16/2016 03:00:00 AM,48,-122,0,0,0
24460,ElliotBayTrailMyrtlePark,10/16/2016 04:00:00 AM,48,-122,0,1,1
24461,ElliotBayTrailMyrtlePark,10/16/2016 05:00:00 AM,48,-122,0,1,1
24462,ElliotBayTrailMyrtlePark,10/16/2016 06:00:00 AM,48,-122,2,1,3
24463,ElliotBayTrailMyrtlePark,10/16/2016 07:00:00 AM,48,-122,2,0,2
24464,ElliotBayTrailMyrtlePark,10/16/2016 08:00:00 AM,48,-122,4,4,8
24465,ElliotBayTrailMyrtlePark,10/16/2016 09:00:00 AM,48,-122,10,6,16
24466,ElliotBayTrailMyrtlePark,10/16/2016 10:00:00 AM,48,-122,3,12,15
24467,ElliotBayTrailMyrtlePark,10/16/2016 11:00:00 AM,48,-122,6,6,12
24468,ElliotBayTrailMyrtlePark,10/16/2016 12:00:00 PM,48,-122,8,8,16
24469,ElliotBayTrailMyrtlePark,10/16/2016 01:00:00 PM,48,-122,9,2,11
24470,ElliotBayTrailMyrtlePark,10/16/2016 02:00:00 PM,48,-122,9,8,17
24471,ElliotBayTrailMyrtlePark,10/16/2016 03:00:00 PM,48,-122,12,15,27
24472,ElliotBayTrailMyrtlePark,10/16/2016 04:00:00 PM,48,-122,15,10,25
24473,ElliotBayTrailMyrtlePark,10/16/2016 05:00:00 PM,48,-122,7,9,16
24474,ElliotBayTrailMyrtlePark,10/16/2016 06:00:00 PM,48,-122,4,1,5
24475,ElliotBayTrailMyrtlePark,10/16/2016 07:00:00 PM,48,-122,3,1,4
24476,ElliotBayTrailMyrtlePark,10/16/2016 08:00:00 PM,48,-122,3,4,7
24477,ElliotBayTrailMyrtlePark,10/16/2016 09:00:00 PM,48,-122,1,1,2
24478,ElliotBayTrailMyrtlePark,10/16/2016 10:00:00 PM,48,-122,1,0,1
24479,ElliotBayTrailMyrtlePark,10/16/2016 11:00:00 PM,48,-122,0,1,1
24480,ElliotBayTrailMyrtlePark,10/17/2016 12:00:00 AM,48,-122,0,0,0
24481,ElliotBayTrailMyrtlePark,10/17/2016 01:00:00 AM,48,-122,0,0,0
24482,ElliotBayTrailMyrtlePark,10/17/2016 02:00:00 AM,48,-122,1,0,1
24483,ElliotBayTrailMyrtlePark,10/17/2016 03:00:00 AM,48,-122,0,1,1
24484,ElliotBayTrailMyrtlePark,10/17/2016 04:00:00 AM,48,-122,5,0,5
24485,ElliotBayTrailMyrtlePark,10/17/2016 05:00:00 AM,48,-122,5,14,19
24486,ElliotBayTrailMyrtlePark,10/17/2016 06:00:00 AM,48,-122,24,29,53
24487,ElliotBayTrailMyrtlePark,10/17/2016 07:00:00 AM,48,-122,21,92,113
24488,ElliotBayTrailMyrtlePark,10/17/2016 08:00:00 AM,48,-122,34,88,122
24489,ElliotBayTrailMyrtlePark,10/17/2016 09:00:00 AM,48,-122,8,32,40
24490,ElliotBayTrailMyrtlePark,10/17/2016 10:00:00 AM,48,-122,9,19,28
24491,ElliotBayTrailMyrtlePark,10/17/2016 11:00:00 AM,48,-122,10,9,19
24492,ElliotBayTrailMyrtlePark,10/17/2016 12:00:00 PM,48,-122,6,7,13
24493,ElliotBayTrailMyrtlePark,10/17/2016 01:00:00 PM,48,-122,5,10,15
24494,ElliotBayTrailMyrtlePark,10/17/2016 02:00:00 PM,48,-122,18,19,37
24495,ElliotBayTrailMyrtlePark,10/17/2016 03:00:00 PM,48,-122,31,25,56
24496,ElliotBayTrailMyrtlePark,10/17/2016 04:00:00 PM,48,-122,95,47,142
24497,ElliotBayTrailMyrtlePark,10/17/2016 05:00:00 PM,48,-122,117,45,162
24498,ElliotBayTrailMyrtlePark,10/17/2016 06:00:00 PM,48,-122,37,14,51
24499,ElliotBayTrailMyrtlePark,10/17/2016 07:00:00 PM,48,-122,9,4,13
24500,ElliotBayTrailMyrtlePark,10/17/2016 08:00:00 PM,48,-122,9,1,10
24501,ElliotBayTrailMyrtlePark,10/17/2016 09:00:00 PM,48,-122,2,4,6
24502,ElliotBayTrailMyrtlePark,10/17/2016 10:00:00 PM,48,-122,0,0,0
24503,ElliotBayTrailMyrtlePark,10/17/2016 11:00:00 PM,48,-122,1,0,1
24504,ElliotBayTrailMyrtlePark,10/18/2016 12:00:00 AM,48,-122,2,1,3
24505,ElliotBayTrailMyrtlePark,10/18/2016 01:00:00 AM,48,-122,1,0,1
24506,ElliotBayTrailMyrtlePark,10/18/2016 02:00:00 AM,48,-122,1,0,1
24507,ElliotBayTrailMyrtlePark,10/18/2016 03:00:00 AM,48,-122,0,0,0
24508,ElliotBayTrailMyrtlePark,10/18/2016 04:00:00 AM,48,-122,1,1,2
24509,ElliotBayTrailMyrtlePark,10/18/2016 05:00:00 AM,48,-122,15,13,28
24510,ElliotBayTrailMyrtlePark,10/18/2016 06:00:00 AM,48,-122,16,33,49
24511,ElliotBayTrailMyrtlePark,10/18/2016 07:00:00 AM,48,-122,26,101,127
24512,ElliotBayTrailMyrtlePark,10/18/2016 08:00:00 AM,48,-122,37,99,136
24513,ElliotBayTrailMyrtlePark,10/18/2016 09:00:00 AM,48,-122,22,23,45
24514,ElliotBayTrailMyrtlePark,10/18/2016 10:00:00 AM,48,-122,6,17,23
24515,ElliotBayTrailMyrtlePark,10/18/2016 11:00:00 AM,48,-122,12,9,21
24516,ElliotBayTrailMyrtlePark,10/18/2016 12:00:00 PM,48,-122,17,10,27
24517,ElliotBayTrailMyrtlePark,10/18/2016 01:00:00 PM,48,-122,13,14,27
24518,ElliotBayTrailMyrtlePark,10/18/2016 02:00:00 PM,48,-122,13,14,27
24519,ElliotBayTrailMyrtlePark,10/18/2016 03:00:00 PM,48,-122,40,30,70
24520,ElliotBayTrailMyrtlePark,10/18/2016 04:00:00 PM,48,-122,106,41,147
24521,ElliotBayTrailMyrtlePark,10/18/2016 05:00:00 PM,48,-122,137,52,189
24522,ElliotBayTrailMyrtlePark,10/18/2016 06:00:00 PM,48,-122,36,18,54
24523,ElliotBayTrailMyrtlePark,10/18/2016 07:00:00 PM,48,-122,16,5,21
24524,ElliotBayTrailMyrtlePark,10/18/2016 08:00:00 PM,48,-122,2,0,2
24525,ElliotBayTrailMyrtlePark,10/18/2016 09:00:00 PM,48,-122,3,1,4
24526,ElliotBayTrailMyrtlePark,10/18/2016 10:00:00 PM,48,-122,1,2,3
24527,ElliotBayTrailMyrtlePark,10/18/2016 11:00:00 PM,48,-122,2,0,2
24528,ElliotBayTrailMyrtlePark,10/19/2016 12:00:00 AM,48,-122,0,0,0
24529,ElliotBayTrailMyrtlePark,10/19/2016 01:00:00 AM,48,-122,2,0,2
24530,ElliotBayTrailMyrtlePark,10/19/2016 02:00:00 AM,48,-122,2,1,3
24531,ElliotBayTrailMyrtlePark,10/19/2016 03:00:00 AM,48,-122,0,1,1
24532,ElliotBayTrailMyrtlePark,10/19/2016 04:00:00 AM,48,-122,2,3,5
24533,ElliotBayTrailMyrtlePark,10/19/2016 05:00:00 AM,48,-122,12,15,27
24534,ElliotBayTrailMyrtlePark,10/19/2016 06:00:00 AM,48,-122,28,33,61
24535,ElliotBayTrailMyrtlePark,10/19/2016 07:00:00 AM,48,-122,39,138,177
24536,ElliotBayTrailMyrtlePark,10/19/2016 08:00:00 AM,48,-122,41,105,146
24537,ElliotBayTrailMyrtlePark,10/19/2016 09:00:00 AM,48,-122,15,36,51
24538,ElliotBayTrailMyrtlePark,10/19/2016 10:00:00 AM,48,-122,14,21,35
24539,ElliotBayTrailMyrtlePark,10/19/2016 11:00:00 AM,48,-122,24,10,34
24540,ElliotBayTrailMyrtlePark,10/19/2016 12:00:00 PM,48,-122,16,22,38
24541,ElliotBayTrailMyrtlePark,10/19/2016 01:00:00 PM,48,-122,18,29,47
24542,ElliotBayTrailMyrtlePark,10/19/2016 02:00:00 PM,48,-122,24,25,49
24543,ElliotBayTrailMyrtlePark,10/19/2016 03:00:00 PM,48,-122,46,28,74
24544,ElliotBayTrailMyrtlePark,10/19/2016 04:00:00 PM,48,-122,101,54,155
24545,ElliotBayTrailMyrtlePark,10/19/2016 05:00:00 PM,48,-122,150,26,176
24546,ElliotBayTrailMyrtlePark,10/19/2016 06:00:00 PM,48,-122,26,16,42
24547,ElliotBayTrailMyrtlePark,10/19/2016 07:00:00 PM,48,-122,11,9,20
24548,ElliotBayTrailMyrtlePark,10/19/2016 08:00:00 PM,48,-122,3,2,5
24549,ElliotBayTrailMyrtlePark,10/19/2016 09:00:00 PM,48,-122,1,1,2
24550,ElliotBayTrailMyrtlePark,10/19/2016 10:00:00 PM,48,-122,2,0,2
24551,ElliotBayTrailMyrtlePark,10/19/2016 11:00:00 PM,48,-122,0,1,1
24552,ElliotBayTrailMyrtlePark,10/20/2016 12:00:00 AM,48,-122,1,0,1
24553,ElliotBayTrailMyrtlePark,10/20/2016 01:00:00 AM,48,-122,2,0,2
24554,ElliotBayTrailMyrtlePark,10/20/2016 02:00:00 AM,48,-122,0,0,0
24555,ElliotBayTrailMyrtlePark,10/20/2016 03:00:00 AM,48,-122,0,1,1
24556,ElliotBayTrailMyrtlePark,10/20/2016 04:00:00 AM,48,-122,1,2,3
24557,ElliotBayTrailMyrtlePark,10/20/2016 05:00:00 AM,48,-122,17,8,25
24558,ElliotBayTrailMyrtlePark,10/20/2016 06:00:00 AM,48,-122,14,17,31
24559,ElliotBayTrailMyrtlePark,10/20/2016 07:00:00 AM,48,-122,29,59,88
24560,ElliotBayTrailMyrtlePark,10/20/2016 08:00:00 AM,48,-122,31,61,92
24561,ElliotBayTrailMyrtlePark,10/20/2016 09:00:00 AM,48,-122,15,14,29
24562,ElliotBayTrailMyrtlePark,10/20/2016 10:00:00 AM,48,-122,4,4,8
24563,ElliotBayTrailMyrtlePark,10/20/2016 11:00:00 AM,48,-122,4,3,7
24564,ElliotBayTrailMyrtlePark,10/20/2016 12:00:00 PM,48,-122,8,6,14
24565,ElliotBayTrailMyrtlePark,10/20/2016 01:00:00 PM,48,-122,15,5,20
24566,ElliotBayTrailMyrtlePark,10/20/2016 02:00:00 PM,48,-122,28,15,43
24567,ElliotBayTrailMyrtlePark,10/20/2016 03:00:00 PM,48,-122,24,10,34
24568,ElliotBayTrailMyrtlePark,10/20/2016 04:00:00 PM,48,-122,75,39,114
24569,ElliotBayTrailMyrtlePark,10/20/2016 05:00:00 PM,48,-122,104,39,143
24570,ElliotBayTrailMyrtlePark,10/20/2016 06:00:00 PM,48,-122,38,18,56
24571,ElliotBayTrailMyrtlePark,10/20/2016 07:00:00 PM,48,-122,11,3,14
24572,ElliotBayTrailMyrtlePark,10/20/2016 08:00:00 PM,48,-122,3,1,4
24573,ElliotBayTrailMyrtlePark,10/20/2016 09:00:00 PM,48,-122,2,1,3
24574,ElliotBayTrailMyrtlePark,10/20/2016 10:00:00 PM,48,-122,1,0,1
24575,ElliotBayTrailMyrtlePark,10/20/2016 11:00:00 PM,48,-122,1,1,2
24576,ElliotBayTrailMyrtlePark,10/21/2016 12:00:00 AM,48,-122,0,0,0
24577,ElliotBayTrailMyrtlePark,10/21/2016 01:00:00 AM,48,-122,1,0,1
24578,ElliotBayTrailMyrtlePark,10/21/2016 02:00:00 AM,48,-122,1,1,2
24579,ElliotBayTrailMyrtlePark,10/21/2016 03:00:00 AM,48,-122,0,0,0
24580,ElliotBayTrailMyrtlePark,10/21/2016 04:00:00 AM,48,-122,2,3,5
24581,ElliotBayTrailMyrtlePark,10/21/2016 05:00:00 AM,48,-122,7,16,23
24582,ElliotBayTrailMyrtlePark,10/21/2016 06:00:00 AM,48,-122,17,27,44
24583,ElliotBayTrailMyrtlePark,10/21/2016 07:00:00 AM,48,-122,27,83,110
24584,ElliotBayTrailMyrtlePark,10/21/2016 08:00:00 AM,48,-122,22,89,111
24585,ElliotBayTrailMyrtlePark,10/21/2016 09:00:00 AM,48,-122,9,28,37
24586,ElliotBayTrailMyrtlePark,10/21/2016 10:00:00 AM,48,-122,14,12,26
24587,ElliotBayTrailMyrtlePark,10/21/2016 11:00:00 AM,48,-122,15,21,36
24588,ElliotBayTrailMyrtlePark,10/21/2016 12:00:00 PM,48,-122,21,11,32
24589,ElliotBayTrailMyrtlePark,10/21/2016 01:00:00 PM,48,-122,24,22,46
24590,ElliotBayTrailMyrtlePark,10/21/2016 02:00:00 PM,48,-122,25,21,46
24591,ElliotBayTrailMyrtlePark,10/21/2016 03:00:00 PM,48,-122,39,24,63
24592,ElliotBayTrailMyrtlePark,10/21/2016 04:00:00 PM,48,-122,90,47,137
24593,ElliotBayTrailMyrtlePark,10/21/2016 05:00:00 PM,48,-122,92,16,108
24594,ElliotBayTrailMyrtlePark,10/21/2016 06:00:00 PM,48,-122,27,9,36
24595,ElliotBayTrailMyrtlePark,10/21/2016 07:00:00 PM,48,-122,7,4,11
24596,ElliotBayTrailMyrtlePark,10/21/2016 08:00:00 PM,48,-122,8,3,11
24597,ElliotBayTrailMyrtlePark,10/21/2016 09:00:00 PM,48,-122,3,2,5
24598,ElliotBayTrailMyrtlePark,10/21/2016 10:00:00 PM,48,-122,4,1,5
24599,ElliotBayTrailMyrtlePark,10/21/2016 11:00:00 PM,48,-122,4,1,5
24600,ElliotBayTrailMyrtlePark,10/22/2016 12:00:00 AM,48,-122,0,0,0
24601,ElliotBayTrailMyrtlePark,10/22/2016 01:00:00 AM,48,-122,2,0,2
24602,ElliotBayTrailMyrtlePark,10/22/2016 02:00:00 AM,48,-122,1,0,1
24603,ElliotBayTrailMyrtlePark,10/22/2016 03:00:00 AM,48,-122,1,0,1
24604,ElliotBayTrailMyrtlePark,10/22/2016 04:00:00 AM,48,-122,0,1,1
24605,ElliotBayTrailMyrtlePark,10/22/2016 05:00:00 AM,48,-122,1,2,3
24606,ElliotBayTrailMyrtlePark,10/22/2016 06:00:00 AM,48,-122,1,4,5
24607,ElliotBayTrailMyrtlePark,10/22/2016 07:00:00 AM,48,-122,6,9,15
24608,ElliotBayTrailMyrtlePark,10/22/2016 08:00:00 AM,48,-122,15,18,33
24609,ElliotBayTrailMyrtlePark,10/22/2016 09:00:00 AM,48,-122,12,16,28
24610,ElliotBayTrailMyrtlePark,10/22/2016 10:00:00 AM,48,-122,23,34,57
24611,ElliotBayTrailMyrtlePark,10/22/2016 11:00:00 AM,48,-122,50,43,93
24612,ElliotBayTrailMyrtlePark,10/22/2016 12:00:00 PM,48,-122,41,52,93
24613,ElliotBayTrailMyrtlePark,10/22/2016 01:00:00 PM,48,-122,47,58,105
24614,ElliotBayTrailMyrtlePark,10/22/2016 02:00:00 PM,48,-122,65,65,130
24615,ElliotBayTrailMyrtlePark,10/22/2016 03:00:00 PM,48,-122,88,43,131
24616,ElliotBayTrailMyrtlePark,10/22/2016 04:00:00 PM,48,-122,41,37,78
24617,ElliotBayTrailMyrtlePark,10/22/2016 05:00:00 PM,48,-122,37,23,60
24618,ElliotBayTrailMyrtlePark,10/22/2016 06:00:00 PM,48,-122,13,11,24
24619,ElliotBayTrailMyrtlePark,10/22/2016 07:00:00 PM,48,-122,8,2,10
24620,ElliotBayTrailMyrtlePark,10/22/2016 08:00:00 PM,48,-122,5,2,7
24621,ElliotBayTrailMyrtlePark,10/22/2016 09:00:00 PM,48,-122,5,5,10
24622,ElliotBayTrailMyrtlePark,10/22/2016 10:00:00 PM,48,-122,0,3,3
24623,ElliotBayTrailMyrtlePark,10/22/2016 11:00:00 PM,48,-122,0,0,0
24624,ElliotBayTrailMyrtlePark,10/23/2016 12:00:00 AM,48,-122,0,0,0
24625,ElliotBayTrailMyrtlePark,10/23/2016 01:00:00 AM,48,-122,1,0,1
24626,ElliotBayTrailMyrtlePark,10/23/2016 02:00:00 AM,48,-122,0,0,0
24627,ElliotBayTrailMyrtlePark,10/23/2016 03:00:00 AM,48,-122,0,0,0
24628,ElliotBayTrailMyrtlePark,10/23/2016 04:00:00 AM,48,-122,0,1,1
24629,ElliotBayTrailMyrtlePark,10/23/2016 05:00:00 AM,48,-122,0,2,2
24630,ElliotBayTrailMyrtlePark,10/23/2016 06:00:00 AM,48,-122,0,0,0
24631,ElliotBayTrailMyrtlePark,10/23/2016 07:00:00 AM,48,-122,3,4,7
24632,ElliotBayTrailMyrtlePark,10/23/2016 08:00:00 AM,48,-122,7,6,13
24633,ElliotBayTrailMyrtlePark,10/23/2016 09:00:00 AM,48,-122,11,11,22
24634,ElliotBayTrailMyrtlePark,10/23/2016 10:00:00 AM,48,-122,13,22,35
24635,ElliotBayTrailMyrtlePark,10/23/2016 11:00:00 AM,48,-122,44,39,83
24636,ElliotBayTrailMyrtlePark,10/23/2016 12:00:00 PM,48,-122,36,45,81
24637,ElliotBayTrailMyrtlePark,10/23/2016 01:00:00 PM,48,-122,35,45,80
24638,ElliotBayTrailMyrtlePark,10/23/2016 02:00:00 PM,48,-122,46,48,94
24639,ElliotBayTrailMyrtlePark,10/23/2016 03:00:00 PM,48,-122,66,39,105
24640,ElliotBayTrailMyrtlePark,10/23/2016 04:00:00 PM,48,-122,28,22,50
24641,ElliotBayTrailMyrtlePark,10/23/2016 05:00:00 PM,48,-122,10,14,24
24642,ElliotBayTrailMyrtlePark,10/23/2016 06:00:00 PM,48,-122,8,1,9
24643,ElliotBayTrailMyrtlePark,10/23/2016 07:00:00 PM,48,-122,5,2,7
24644,ElliotBayTrailMyrtlePark,10/23/2016 08:00:00 PM,48,-122,3,1,4
24645,ElliotBayTrailMyrtlePark,10/23/2016 09:00:00 PM,48,-122,5,2,7
24646,ElliotBayTrailMyrtlePark,10/23/2016 10:00:00 PM,48,-122,2,1,3
24647,ElliotBayTrailMyrtlePark,10/23/2016 11:00:00 PM,48,-122,1,1,2
24648,ElliotBayTrailMyrtlePark,10/24/2016 12:00:00 AM,48,-122,1,0,1
24649,ElliotBayTrailMyrtlePark,10/24/2016 01:00:00 AM,48,-122,0,1,1
24650,ElliotBayTrailMyrtlePark,10/24/2016 02:00:00 AM,48,-122,1,1,2
24651,ElliotBayTrailMyrtlePark,10/24/2016 03:00:00 AM,48,-122,0,1,1
24652,ElliotBayTrailMyrtlePark,10/24/2016 04:00:00 AM,48,-122,3,1,4
24653,ElliotBayTrailMyrtlePark,10/24/2016 05:00:00 AM,48,-122,11,25,36
24654,ElliotBayTrailMyrtlePark,10/24/2016 06:00:00 AM,48,-122,20,33,53
24655,ElliotBayTrailMyrtlePark,10/24/2016 07:00:00 AM,48,-122,31,113,144
24656,ElliotBayTrailMyrtlePark,10/24/2016 08:00:00 AM,48,-122,24,104,128
24657,ElliotBayTrailMyrtlePark,10/24/2016 09:00:00 AM,48,-122,14,34,48
24658,ElliotBayTrailMyrtlePark,10/24/2016 10:00:00 AM,48,-122,7,13,20
24659,ElliotBayTrailMyrtlePark,10/24/2016 11:00:00 AM,48,-122,10,9,19
24660,ElliotBayTrailMyrtlePark,10/24/2016 12:00:00 PM,48,-122,10,18,28
24661,ElliotBayTrailMyrtlePark,10/24/2016 01:00:00 PM,48,-122,23,11,34
24662,ElliotBayTrailMyrtlePark,10/24/2016 02:00:00 PM,48,-122,17,20,37
24663,ElliotBayTrailMyrtlePark,10/24/2016 03:00:00 PM,48,-122,46,26,72
24664,ElliotBayTrailMyrtlePark,10/24/2016 04:00:00 PM,48,-122,98,32,130
24665,ElliotBayTrailMyrtlePark,10/24/2016 05:00:00 PM,48,-122,122,24,146
24666,ElliotBayTrailMyrtlePark,10/24/2016 06:00:00 PM,48,-122,34,4,38
24667,ElliotBayTrailMyrtlePark,10/24/2016 07:00:00 PM,48,-122,14,0,14
24668,ElliotBayTrailMyrtlePark,10/24/2016 08:00:00 PM,48,-122,5,2,7
24669,ElliotBayTrailMyrtlePark,10/24/2016 09:00:00 PM,48,-122,1,2,3
24670,ElliotBayTrailMyrtlePark,10/24/2016 10:00:00 PM,48,-122,2,1,3
24671,ElliotBayTrailMyrtlePark,10/24/2016 11:00:00 PM,48,-122,1,0,1
24672,ElliotBayTrailMyrtlePark,10/25/2016 12:00:00 AM,48,-122,1,0,1
24673,ElliotBayTrailMyrtlePark,10/25/2016 01:00:00 AM,48,-122,2,0,2
24674,ElliotBayTrailMyrtlePark,10/25/2016 02:00:00 AM,48,-122,1,0,1
24675,ElliotBayTrailMyrtlePark,10/25/2016 03:00:00 AM,48,-122,0,1,1
24676,ElliotBayTrailMyrtlePark,10/25/2016 04:00:00 AM,48,-122,5,0,5
24677,ElliotBayTrailMyrtlePark,10/25/2016 05:00:00 AM,48,-122,13,17,30
24678,ElliotBayTrailMyrtlePark,10/25/2016 06:00:00 AM,48,-122,15,33,48
24679,ElliotBayTrailMyrtlePark,10/25/2016 07:00:00 AM,48,-122,34,129,163
24680,ElliotBayTrailMyrtlePark,10/25/2016 08:00:00 AM,48,-122,26,96,122
24681,ElliotBayTrailMyrtlePark,10/25/2016 09:00:00 AM,48,-122,10,31,41
24682,ElliotBayTrailMyrtlePark,10/25/2016 10:00:00 AM,48,-122,9,21,30
24683,ElliotBayTrailMyrtlePark,10/25/2016 11:00:00 AM,48,-122,14,14,28
24684,ElliotBayTrailMyrtlePark,10/25/2016 12:00:00 PM,48,-122,13,16,29
24685,ElliotBayTrailMyrtlePark,10/25/2016 01:00:00 PM,48,-122,30,12,42
24686,ElliotBayTrailMyrtlePark,10/25/2016 02:00:00 PM,48,-122,14,20,34
24687,ElliotBayTrailMyrtlePark,10/25/2016 03:00:00 PM,48,-122,44,22,66
24688,ElliotBayTrailMyrtlePark,10/25/2016 04:00:00 PM,48,-122,128,60,188
24689,ElliotBayTrailMyrtlePark,10/25/2016 05:00:00 PM,48,-122,143,39,182
24690,ElliotBayTrailMyrtlePark,10/25/2016 06:00:00 PM,48,-122,52,11,63
24691,ElliotBayTrailMyrtlePark,10/25/2016 07:00:00 PM,48,-122,15,8,23
24692,ElliotBayTrailMyrtlePark,10/25/2016 08:00:00 PM,48,-122,4,1,5
24693,ElliotBayTrailMyrtlePark,10/25/2016 09:00:00 PM,48,-122,4,3,7
24694,ElliotBayTrailMyrtlePark,10/25/2016 10:00:00 PM,48,-122,4,3,7
24695,ElliotBayTrailMyrtlePark,10/25/2016 11:00:00 PM,48,-122,0,1,1
24696,ElliotBayTrailMyrtlePark,10/26/2016 12:00:00 AM,48,-122,1,0,1
24697,ElliotBayTrailMyrtlePark,10/26/2016 01:00:00 AM,48,-122,1,0,1
24698,ElliotBayTrailMyrtlePark,10/26/2016 02:00:00 AM,48,-122,1,0,1
24699,ElliotBayTrailMyrtlePark,10/26/2016 03:00:00 AM,48,-122,0,1,1
24700,ElliotBayTrailMyrtlePark,10/26/2016 04:00:00 AM,48,-122,4,1,5
24701,ElliotBayTrailMyrtlePark,10/26/2016 05:00:00 AM,48,-122,7,16,23
24702,ElliotBayTrailMyrtlePark,10/26/2016 06:00:00 AM,48,-122,14,31,45
24703,ElliotBayTrailMyrtlePark,10/26/2016 07:00:00 AM,48,-122,29,69,98
24704,ElliotBayTrailMyrtlePark,10/26/2016 08:00:00 AM,48,-122,16,65,81
24705,ElliotBayTrailMyrtlePark,10/26/2016 09:00:00 AM,48,-122,8,11,19
24706,ElliotBayTrailMyrtlePark,10/26/2016 10:00:00 AM,48,-122,3,3,6
24707,ElliotBayTrailMyrtlePark,10/26/2016 11:00:00 AM,48,-122,3,4,7
24708,ElliotBayTrailMyrtlePark,10/26/2016 12:00:00 PM,48,-122,4,3,7
24709,ElliotBayTrailMyrtlePark,10/26/2016 01:00:00 PM,48,-122,5,2,7
24710,ElliotBayTrailMyrtlePark,10/26/2016 02:00:00 PM,48,-122,5,14,19
24711,ElliotBayTrailMyrtlePark,10/26/2016 03:00:00 PM,48,-122,19,12,31
24712,ElliotBayTrailMyrtlePark,10/26/2016 04:00:00 PM,48,-122,55,26,81
24713,ElliotBayTrailMyrtlePark,10/26/2016 05:00:00 PM,48,-122,78,9,87
24714,ElliotBayTrailMyrtlePark,10/26/2016 06:00:00 PM,48,-122,32,7,39
24715,ElliotBayTrailMyrtlePark,10/26/2016 07:00:00 PM,48,-122,3,4,7
24716,ElliotBayTrailMyrtlePark,10/26/2016 08:00:00 PM,48,-122,2,0,2
24717,ElliotBayTrailMyrtlePark,10/26/2016 09:00:00 PM,48,-122,1,1,2
24718,ElliotBayTrailMyrtlePark,10/26/2016 10:00:00 PM,48,-122,3,0,3
24719,ElliotBayTrailMyrtlePark,10/26/2016 11:00:00 PM,48,-122,0,0,0
24720,ElliotBayTrailMyrtlePark,10/27/2016 12:00:00 AM,48,-122,1,0,1
24721,ElliotBayTrailMyrtlePark,10/27/2016 01:00:00 AM,48,-122,1,0,1
24722,ElliotBayTrailMyrtlePark,10/27/2016 02:00:00 AM,48,-122,1,0,1
24723,ElliotBayTrailMyrtlePark,10/27/2016 03:00:00 AM,48,-122,0,2,2
24724,ElliotBayTrailMyrtlePark,10/27/2016 04:00:00 AM,48,-122,1,1,2
24725,ElliotBayTrailMyrtlePark,10/27/2016 05:00:00 AM,48,-122,12,19,31
24726,ElliotBayTrailMyrtlePark,10/27/2016 06:00:00 AM,48,-122,21,25,46
24727,ElliotBayTrailMyrtlePark,10/27/2016 07:00:00 AM,48,-122,35,90,125
24728,ElliotBayTrailMyrtlePark,10/27/2016 08:00:00 AM,48,-122,30,86,116
24729,ElliotBayTrailMyrtlePark,10/27/2016 09:00:00 AM,48,-122,7,29,36
24730,ElliotBayTrailMyrtlePark,10/27/2016 10:00:00 AM,48,-122,16,13,29
24731,ElliotBayTrailMyrtlePark,10/27/2016 11:00:00 AM,48,-122,13,7,20
24732,ElliotBayTrailMyrtlePark,10/27/2016 12:00:00 PM,48,-122,12,11,23
24733,ElliotBayTrailMyrtlePark,10/27/2016 01:00:00 PM,48,-122,13,12,25
24734,ElliotBayTrailMyrtlePark,10/27/2016 02:00:00 PM,48,-122,19,25,44
24735,ElliotBayTrailMyrtlePark,10/27/2016 03:00:00 PM,48,-122,35,24,59
24736,ElliotBayTrailMyrtlePark,10/27/2016 04:00:00 PM,48,-122,81,46,127
24737,ElliotBayTrailMyrtlePark,10/27/2016 05:00:00 PM,48,-122,104,23,127
24738,ElliotBayTrailMyrtlePark,10/27/2016 06:00:00 PM,48,-122,33,6,39
24739,ElliotBayTrailMyrtlePark,10/27/2016 07:00:00 PM,48,-122,40,3,43
24740,ElliotBayTrailMyrtlePark,10/27/2016 08:00:00 PM,48,-122,3,2,5
24741,ElliotBayTrailMyrtlePark,10/27/2016 09:00:00 PM,48,-122,9,6,15
24742,ElliotBayTrailMyrtlePark,10/27/2016 10:00:00 PM,48,-122,1,0,1
24743,ElliotBayTrailMyrtlePark,10/27/2016 11:00:00 PM,48,-122,2,1,3
24744,ElliotBayTrailMyrtlePark,10/28/2016 12:00:00 AM,48,-122,0,1,1
24745,ElliotBayTrailMyrtlePark,10/28/2016 01:00:00 AM,48,-122,3,1,4
24746,ElliotBayTrailMyrtlePark,10/28/2016 02:00:00 AM,48,-122,2,2,4
24747,ElliotBayTrailMyrtlePark,10/28/2016 03:00:00 AM,48,-122,0,0,0
24748,ElliotBayTrailMyrtlePark,10/28/2016 04:00:00 AM,48,-122,0,4,4
24749,ElliotBayTrailMyrtlePark,10/28/2016 05:00:00 AM,48,-122,11,18,29
24750,ElliotBayTrailMyrtlePark,10/28/2016 06:00:00 AM,48,-122,17,28,45
24751,ElliotBayTrailMyrtlePark,10/28/2016 07:00:00 AM,48,-122,32,85,117
24752,ElliotBayTrailMyrtlePark,10/28/2016 08:00:00 AM,48,-122,26,89,115
24753,ElliotBayTrailMyrtlePark,10/28/2016 09:00:00 AM,48,-122,25,23,48
24754,ElliotBayTrailMyrtlePark,10/28/2016 10:00:00 AM,48,-122,11,24,35
24755,ElliotBayTrailMyrtlePark,10/28/2016 11:00:00 AM,48,-122,25,12,37
24756,ElliotBayTrailMyrtlePark,10/28/2016 12:00:00 PM,48,-122,15,17,32
24757,ElliotBayTrailMyrtlePark,10/28/2016 01:00:00 PM,48,-122,28,20,48
24758,ElliotBayTrailMyrtlePark,10/28/2016 02:00:00 PM,48,-122,42,41,83
24759,ElliotBayTrailMyrtlePark,10/28/2016 03:00:00 PM,48,-122,69,51,120
24760,ElliotBayTrailMyrtlePark,10/28/2016 04:00:00 PM,48,-122,122,67,189
24761,ElliotBayTrailMyrtlePark,10/28/2016 05:00:00 PM,48,-122,108,45,153
24762,ElliotBayTrailMyrtlePark,10/28/2016 06:00:00 PM,48,-122,41,14,55
24763,ElliotBayTrailMyrtlePark,10/28/2016 07:00:00 PM,48,-122,12,9,21
24764,ElliotBayTrailMyrtlePark,10/28/2016 08:00:00 PM,48,-122,12,2,14
24765,ElliotBayTrailMyrtlePark,10/28/2016 09:00:00 PM,48,-122,2,5,7
24766,ElliotBayTrailMyrtlePark,10/28/2016 10:00:00 PM,48,-122,2,1,3
24767,ElliotBayTrailMyrtlePark,10/28/2016 11:00:00 PM,48,-122,1,0,1
24768,ElliotBayTrailMyrtlePark,10/29/2016 12:00:00 AM,48,-122,1,0,1
24769,ElliotBayTrailMyrtlePark,10/29/2016 01:00:00 AM,48,-122,2,0,2
24770,ElliotBayTrailMyrtlePark,10/29/2016 02:00:00 AM,48,-122,1,1,2
24771,ElliotBayTrailMyrtlePark,10/29/2016 03:00:00 AM,48,-122,1,0,1
24772,ElliotBayTrailMyrtlePark,10/29/2016 04:00:00 AM,48,-122,0,1,1
24773,ElliotBayTrailMyrtlePark,10/29/2016 05:00:00 AM,48,-122,3,3,6
24774,ElliotBayTrailMyrtlePark,10/29/2016 06:00:00 AM,48,-122,3,4,7
24775,ElliotBayTrailMyrtlePark,10/29/2016 07:00:00 AM,48,-122,5,6,11
24776,ElliotBayTrailMyrtlePark,10/29/2016 08:00:00 AM,48,-122,1,8,9
24777,ElliotBayTrailMyrtlePark,10/29/2016 09:00:00 AM,48,-122,2,3,5
24778,ElliotBayTrailMyrtlePark,10/29/2016 10:00:00 AM,48,-122,8,4,12
24779,ElliotBayTrailMyrtlePark,10/29/2016 11:00:00 AM,48,-122,6,7,13
24780,ElliotBayTrailMyrtlePark,10/29/2016 12:00:00 PM,48,-122,5,5,10
24781,ElliotBayTrailMyrtlePark,10/29/2016 01:00:00 PM,48,-122,1,1,2
24782,ElliotBayTrailMyrtlePark,10/29/2016 02:00:00 PM,48,-122,23,7,30
24783,ElliotBayTrailMyrtlePark,10/29/2016 03:00:00 PM,48,-122,30,27,57
24784,ElliotBayTrailMyrtlePark,10/29/2016 04:00:00 PM,48,-122,28,27,55
24785,ElliotBayTrailMyrtlePark,10/29/2016 05:00:00 PM,48,-122,22,32,54
24786,ElliotBayTrailMyrtlePark,10/29/2016 06:00:00 PM,48,-122,7,7,14
24787,ElliotBayTrailMyrtlePark,10/29/2016 07:00:00 PM,48,-122,8,3,11
24788,ElliotBayTrailMyrtlePark,10/29/2016 08:00:00 PM,48,-122,1,2,3
24789,ElliotBayTrailMyrtlePark,10/29/2016 09:00:00 PM,48,-122,2,2,4
24790,ElliotBayTrailMyrtlePark,10/29/2016 10:00:00 PM,48,-122,3,0,3
24791,ElliotBayTrailMyrtlePark,10/29/2016 11:00:00 PM,48,-122,13,0,13
24792,ElliotBayTrailMyrtlePark,10/30/2016 12:00:00 AM,48,-122,2,1,3
24793,ElliotBayTrailMyrtlePark,10/30/2016 01:00:00 AM,48,-122,1,0,1
24794,ElliotBayTrailMyrtlePark,10/30/2016 02:00:00 AM,48,-122,1,0,1
24795,ElliotBayTrailMyrtlePark,10/30/2016 03:00:00 AM,48,-122,0,1,1
24796,ElliotBayTrailMyrtlePark,10/30/2016 04:00:00 AM,48,-122,0,1,1
24797,ElliotBayTrailMyrtlePark,10/30/2016 05:00:00 AM,48,-122,2,5,7
24798,ElliotBayTrailMyrtlePark,10/30/2016 06:00:00 AM,48,-122,2,1,3
24799,ElliotBayTrailMyrtlePark,10/30/2016 07:00:00 AM,48,-122,5,8,13
24800,ElliotBayTrailMyrtlePark,10/30/2016 08:00:00 AM,48,-122,26,14,40
24801,ElliotBayTrailMyrtlePark,10/30/2016 09:00:00 AM,48,-122,35,25,60
24802,ElliotBayTrailMyrtlePark,10/30/2016 10:00:00 AM,48,-122,27,28,55
24803,ElliotBayTrailMyrtlePark,10/30/2016 11:00:00 AM,48,-122,22,18,40
24804,ElliotBayTrailMyrtlePark,10/30/2016 12:00:00 PM,48,-122,19,62,81
24805,ElliotBayTrailMyrtlePark,10/30/2016 01:00:00 PM,48,-122,19,17,36
24806,ElliotBayTrailMyrtlePark,10/30/2016 02:00:00 PM,48,-122,13,12,25
24807,ElliotBayTrailMyrtlePark,10/30/2016 03:00:00 PM,48,-122,9,3,12
24808,ElliotBayTrailMyrtlePark,10/30/2016 04:00:00 PM,48,-122,4,9,13
24809,ElliotBayTrailMyrtlePark,10/30/2016 05:00:00 PM,48,-122,6,7,13
24810,ElliotBayTrailMyrtlePark,10/30/2016 06:00:00 PM,48,-122,5,1,6
24811,ElliotBayTrailMyrtlePark,10/30/2016 07:00:00 PM,48,-122,9,2,11
24812,ElliotBayTrailMyrtlePark,10/30/2016 08:00:00 PM,48,-122,9,0,9
24813,ElliotBayTrailMyrtlePark,10/30/2016 09:00:00 PM,48,-122,2,0,2
24814,ElliotBayTrailMyrtlePark,10/30/2016 10:00:00 PM,48,-122,0,1,1
24815,ElliotBayTrailMyrtlePark,10/30/2016 11:00:00 PM,48,-122,0,0,0
24816,ElliotBayTrailMyrtlePark,10/31/2016 12:00:00 AM,48,-122,0,0,0
24817,ElliotBayTrailMyrtlePark,10/31/2016 01:00:00 AM,48,-122,0,0,0
24818,ElliotBayTrailMyrtlePark,10/31/2016 02:00:00 AM,48,-122,0,0,0
24819,ElliotBayTrailMyrtlePark,10/31/2016 03:00:00 AM,48,-122,0,1,1
24820,ElliotBayTrailMyrtlePark,10/31/2016 04:00:00 AM,48,-122,6,0,6
24821,ElliotBayTrailMyrtlePark,10/31/2016 05:00:00 AM,48,-122,7,14,21
24822,ElliotBayTrailMyrtlePark,10/31/2016 06:00:00 AM,48,-122,18,29,47
24823,ElliotBayTrailMyrtlePark,10/31/2016 07:00:00 AM,48,-122,24,96,120
24824,ElliotBayTrailMyrtlePark,10/31/2016 08:00:00 AM,48,-122,21,59,80
24825,ElliotBayTrailMyrtlePark,10/31/2016 09:00:00 AM,48,-122,5,10,15
24826,ElliotBayTrailMyrtlePark,10/31/2016 10:00:00 AM,48,-122,2,10,12
24827,ElliotBayTrailMyrtlePark,10/31/2016 11:00:00 AM,48,-122,10,4,14
24828,ElliotBayTrailMyrtlePark,10/31/2016 12:00:00 PM,48,-122,4,4,8
24829,ElliotBayTrailMyrtlePark,10/31/2016 01:00:00 PM,48,-122,10,11,21
24830,ElliotBayTrailMyrtlePark,10/31/2016 02:00:00 PM,48,-122,14,15,29
24831,ElliotBayTrailMyrtlePark,10/31/2016 03:00:00 PM,48,-122,37,24,61
24832,ElliotBayTrailMyrtlePark,10/31/2016 04:00:00 PM,48,-122,96,39,135
24833,ElliotBayTrailMyrtlePark,10/31/2016 05:00:00 PM,48,-122,72,18,90
24834,ElliotBayTrailMyrtlePark,10/31/2016 06:00:00 PM,48,-122,17,5,22
24835,ElliotBayTrailMyrtlePark,10/31/2016 07:00:00 PM,48,-122,2,1,3
24836,ElliotBayTrailMyrtlePark,10/31/2016 08:00:00 PM,48,-122,2,0,2
24837,ElliotBayTrailMyrtlePark,10/31/2016 09:00:00 PM,48,-122,2,1,3
24838,ElliotBayTrailMyrtlePark,10/31/2016 10:00:00 PM,48,-122,1,1,2
24839,ElliotBayTrailMyrtlePark,10/31/2016 11:00:00 PM,48,-122,0,0,0
24840,ElliotBayTrailMyrtlePark,11/01/2016 12:00:00 AM,48,-122,4,0,4
24841,ElliotBayTrailMyrtlePark,11/01/2016 01:00:00 AM,48,-122,2,0,2
24842,ElliotBayTrailMyrtlePark,11/01/2016 02:00:00 AM,48,-122,0,0,0
24843,ElliotBayTrailMyrtlePark,11/01/2016 03:00:00 AM,48,-122,0,1,1
24844,ElliotBayTrailMyrtlePark,11/01/2016 04:00:00 AM,48,-122,2,3,5
24845,ElliotBayTrailMyrtlePark,11/01/2016 05:00:00 AM,48,-122,12,15,27
24846,ElliotBayTrailMyrtlePark,11/01/2016 06:00:00 AM,48,-122,14,27,41
24847,ElliotBayTrailMyrtlePark,11/01/2016 07:00:00 AM,48,-122,27,90,117
24848,ElliotBayTrailMyrtlePark,11/01/2016 08:00:00 AM,48,-122,28,79,107
24849,ElliotBayTrailMyrtlePark,11/01/2016 09:00:00 AM,48,-122,12,18,30
24850,ElliotBayTrailMyrtlePark,11/01/2016 10:00:00 AM,48,-122,4,7,11
24851,ElliotBayTrailMyrtlePark,11/01/2016 11:00:00 AM,48,-122,5,8,13
24852,ElliotBayTrailMyrtlePark,11/01/2016 12:00:00 PM,48,-122,5,5,10
24853,ElliotBayTrailMyrtlePark,11/01/2016 01:00:00 PM,48,-122,12,10,22
24854,ElliotBayTrailMyrtlePark,11/01/2016 02:00:00 PM,48,-122,14,18,32
24855,ElliotBayTrailMyrtlePark,11/01/2016 03:00:00 PM,48,-122,25,17,42
24856,ElliotBayTrailMyrtlePark,11/01/2016 04:00:00 PM,48,-122,98,35,133
24857,ElliotBayTrailMyrtlePark,11/01/2016 05:00:00 PM,48,-122,104,19,123
24858,ElliotBayTrailMyrtlePark,11/01/2016 06:00:00 PM,48,-122,31,6,37
24859,ElliotBayTrailMyrtlePark,11/01/2016 07:00:00 PM,48,-122,9,3,12
24860,ElliotBayTrailMyrtlePark,11/01/2016 08:00:00 PM,48,-122,3,2,5
24861,ElliotBayTrailMyrtlePark,11/01/2016 09:00:00 PM,48,-122,1,3,4
24862,ElliotBayTrailMyrtlePark,11/01/2016 10:00:00 PM,48,-122,1,1,2
24863,ElliotBayTrailMyrtlePark,11/01/2016 11:00:00 PM,48,-122,0,1,1
24864,ElliotBayTrailMyrtlePark,11/02/2016 12:00:00 AM,48,-122,2,0,2
24865,ElliotBayTrailMyrtlePark,11/02/2016 01:00:00 AM,48,-122,1,0,1
24866,ElliotBayTrailMyrtlePark,11/02/2016 02:00:00 AM,48,-122,1,0,1
24867,ElliotBayTrailMyrtlePark,11/02/2016 03:00:00 AM,48,-122,0,1,1
24868,ElliotBayTrailMyrtlePark,11/02/2016 04:00:00 AM,48,-122,3,1,4
24869,ElliotBayTrailMyrtlePark,11/02/2016 05:00:00 AM,48,-122,8,11,19
24870,ElliotBayTrailMyrtlePark,11/02/2016 06:00:00 AM,48,-122,11,36,47
24871,ElliotBayTrailMyrtlePark,11/02/2016 07:00:00 AM,48,-122,35,82,117
24872,ElliotBayTrailMyrtlePark,11/02/2016 08:00:00 AM,48,-122,20,86,106
24873,ElliotBayTrailMyrtlePark,11/02/2016 09:00:00 AM,48,-122,7,15,22
24874,ElliotBayTrailMyrtlePark,11/02/2016 10:00:00 AM,48,-122,1,5,6
24875,ElliotBayTrailMyrtlePark,11/02/2016 11:00:00 AM,48,-122,6,4,10
24876,ElliotBayTrailMyrtlePark,11/02/2016 12:00:00 PM,48,-122,9,3,12
24877,ElliotBayTrailMyrtlePark,11/02/2016 01:00:00 PM,48,-122,11,10,21
24878,ElliotBayTrailMyrtlePark,11/02/2016 02:00:00 PM,48,-122,5,12,17
24879,ElliotBayTrailMyrtlePark,11/02/2016 03:00:00 PM,48,-122,28,24,52
24880,ElliotBayTrailMyrtlePark,11/02/2016 04:00:00 PM,48,-122,79,31,110
24881,ElliotBayTrailMyrtlePark,11/02/2016 05:00:00 PM,48,-122,111,28,139
24882,ElliotBayTrailMyrtlePark,11/02/2016 06:00:00 PM,48,-122,23,2,25
24883,ElliotBayTrailMyrtlePark,11/02/2016 07:00:00 PM,48,-122,6,5,11
24884,ElliotBayTrailMyrtlePark,11/02/2016 08:00:00 PM,48,-122,0,3,3
24885,ElliotBayTrailMyrtlePark,11/02/2016 09:00:00 PM,48,-122,2,3,5
24886,ElliotBayTrailMyrtlePark,11/02/2016 10:00:00 PM,48,-122,0,2,2
24887,ElliotBayTrailMyrtlePark,11/02/2016 11:00:00 PM,48,-122,0,0,0
24888,ElliotBayTrailMyrtlePark,11/03/2016 12:00:00 AM,48,-122,2,0,2
24889,ElliotBayTrailMyrtlePark,11/03/2016 01:00:00 AM,48,-122,1,0,1
24890,ElliotBayTrailMyrtlePark,11/03/2016 02:00:00 AM,48,-122,0,0,0
24891,ElliotBayTrailMyrtlePark,11/03/2016 03:00:00 AM,48,-122,1,1,2
24892,ElliotBayTrailMyrtlePark,11/03/2016 04:00:00 AM,48,-122,6,2,8
24893,ElliotBayTrailMyrtlePark,11/03/2016 05:00:00 AM,48,-122,8,24,32
24894,ElliotBayTrailMyrtlePark,11/03/2016 06:00:00 AM,48,-122,21,32,53
24895,ElliotBayTrailMyrtlePark,11/03/2016 07:00:00 AM,48,-122,38,93,131
24896,ElliotBayTrailMyrtlePark,11/03/2016 08:00:00 AM,48,-122,44,123,167
24897,ElliotBayTrailMyrtlePark,11/03/2016 09:00:00 AM,48,-122,17,33,50
24898,ElliotBayTrailMyrtlePark,11/03/2016 10:00:00 AM,48,-122,16,23,39
24899,ElliotBayTrailMyrtlePark,11/03/2016 11:00:00 AM,48,-122,16,19,35
24900,ElliotBayTrailMyrtlePark,11/03/2016 12:00:00 PM,48,-122,26,28,54
24901,ElliotBayTrailMyrtlePark,11/03/2016 01:00:00 PM,48,-122,23,27,50
24902,ElliotBayTrailMyrtlePark,11/03/2016 02:00:00 PM,48,-122,34,34,68
24903,ElliotBayTrailMyrtlePark,11/03/2016 03:00:00 PM,48,-122,68,43,111
24904,ElliotBayTrailMyrtlePark,11/03/2016 04:00:00 PM,48,-122,118,96,214
24905,ElliotBayTrailMyrtlePark,11/03/2016 05:00:00 PM,48,-122,150,79,229
24906,ElliotBayTrailMyrtlePark,11/03/2016 06:00:00 PM,48,-122,49,20,69
24907,ElliotBayTrailMyrtlePark,11/03/2016 07:00:00 PM,48,-122,18,4,22
24908,ElliotBayTrailMyrtlePark,11/03/2016 08:00:00 PM,48,-122,7,9,16
24909,ElliotBayTrailMyrtlePark,11/03/2016 09:00:00 PM,48,-122,2,0,2
24910,ElliotBayTrailMyrtlePark,11/03/2016 10:00:00 PM,48,-122,10,3,13
24911,ElliotBayTrailMyrtlePark,11/03/2016 11:00:00 PM,48,-122,4,0,4
24912,ElliotBayTrailMyrtlePark,11/04/2016 12:00:00 AM,48,-122,5,0,5
24913,ElliotBayTrailMyrtlePark,11/04/2016 01:00:00 AM,48,-122,4,0,4
24914,ElliotBayTrailMyrtlePark,11/04/2016 02:00:00 AM,48,-122,1,0,1
24915,ElliotBayTrailMyrtlePark,11/04/2016 03:00:00 AM,48,-122,0,0,0
24916,ElliotBayTrailMyrtlePark,11/04/2016 04:00:00 AM,48,-122,1,3,4
24917,ElliotBayTrailMyrtlePark,11/04/2016 05:00:00 AM,48,-122,13,17,30
24918,ElliotBayTrailMyrtlePark,11/04/2016 06:00:00 AM,48,-122,13,33,46
24919,ElliotBayTrailMyrtlePark,11/04/2016 07:00:00 AM,48,-122,27,100,127
24920,ElliotBayTrailMyrtlePark,11/04/2016 08:00:00 AM,48,-122,28,112,140
24921,ElliotBayTrailMyrtlePark,11/04/2016 09:00:00 AM,48,-122,25,32,57
24922,ElliotBayTrailMyrtlePark,11/04/2016 10:00:00 AM,48,-122,24,37,61
24923,ElliotBayTrailMyrtlePark,11/04/2016 11:00:00 AM,48,-122,28,25,53
24924,ElliotBayTrailMyrtlePark,11/04/2016 12:00:00 PM,48,-122,34,38,72
24925,ElliotBayTrailMyrtlePark,11/04/2016 01:00:00 PM,48,-122,21,37,58
24926,ElliotBayTrailMyrtlePark,11/04/2016 02:00:00 PM,48,-122,34,29,63
24927,ElliotBayTrailMyrtlePark,11/04/2016 03:00:00 PM,48,-122,73,48,121
24928,ElliotBayTrailMyrtlePark,11/04/2016 04:00:00 PM,48,-122,132,66,198
24929,ElliotBayTrailMyrtlePark,11/04/2016 05:00:00 PM,48,-122,142,34,176
24930,ElliotBayTrailMyrtlePark,11/04/2016 06:00:00 PM,48,-122,26,11,37
24931,ElliotBayTrailMyrtlePark,11/04/2016 07:00:00 PM,48,-122,8,2,10
24932,ElliotBayTrailMyrtlePark,11/04/2016 08:00:00 PM,48,-122,3,5,8
24933,ElliotBayTrailMyrtlePark,11/04/2016 09:00:00 PM,48,-122,4,3,7
24934,ElliotBayTrailMyrtlePark,11/04/2016 10:00:00 PM,48,-122,2,3,5
24935,ElliotBayTrailMyrtlePark,11/04/2016 11:00:00 PM,48,-122,6,6,12
24936,ElliotBayTrailMyrtlePark,11/05/2016 12:00:00 AM,48,-122,2,0,2
24937,ElliotBayTrailMyrtlePark,11/05/2016 01:00:00 AM,48,-122,3,0,3
24938,ElliotBayTrailMyrtlePark,11/05/2016 02:00:00 AM,48,-122,2,1,3
24939,ElliotBayTrailMyrtlePark,11/05/2016 03:00:00 AM,48,-122,0,0,0
24940,ElliotBayTrailMyrtlePark,11/05/2016 04:00:00 AM,48,-122,0,1,1
24941,ElliotBayTrailMyrtlePark,11/05/2016 05:00:00 AM,48,-122,3,0,3
24942,ElliotBayTrailMyrtlePark,11/05/2016 06:00:00 AM,48,-122,0,4,4
24943,ElliotBayTrailMyrtlePark,11/05/2016 07:00:00 AM,48,-122,6,8,14
24944,ElliotBayTrailMyrtlePark,11/05/2016 08:00:00 AM,48,-122,1,2,3
24945,ElliotBayTrailMyrtlePark,11/05/2016 09:00:00 AM,48,-122,6,4,10
24946,ElliotBayTrailMyrtlePark,11/05/2016 10:00:00 AM,48,-122,4,2,6
24947,ElliotBayTrailMyrtlePark,11/05/2016 11:00:00 AM,48,-122,8,3,11
24948,ElliotBayTrailMyrtlePark,11/05/2016 12:00:00 PM,48,-122,4,4,8
24949,ElliotBayTrailMyrtlePark,11/05/2016 01:00:00 PM,48,-122,6,8,14
24950,ElliotBayTrailMyrtlePark,11/05/2016 02:00:00 PM,48,-122,4,12,16
24951,ElliotBayTrailMyrtlePark,11/05/2016 03:00:00 PM,48,-122,8,4,12
24952,ElliotBayTrailMyrtlePark,11/05/2016 04:00:00 PM,48,-122,8,5,13
24953,ElliotBayTrailMyrtlePark,11/05/2016 05:00:00 PM,48,-122,5,5,10
24954,ElliotBayTrailMyrtlePark,11/05/2016 06:00:00 PM,48,-122,5,4,9
24955,ElliotBayTrailMyrtlePark,11/05/2016 07:00:00 PM,48,-122,2,2,4
24956,ElliotBayTrailMyrtlePark,11/05/2016 08:00:00 PM,48,-122,0,0,0
24957,ElliotBayTrailMyrtlePark,11/05/2016 09:00:00 PM,48,-122,0,1,1
24958,ElliotBayTrailMyrtlePark,11/05/2016 10:00:00 PM,48,-122,1,0,1
24959,ElliotBayTrailMyrtlePark,11/05/2016 11:00:00 PM,48,-122,1,0,1
24960,ElliotBayTrailMyrtlePark,11/06/2016 12:00:00 AM,48,-122,0,1,1
24961,ElliotBayTrailMyrtlePark,11/06/2016 01:00:00 AM,48,-122,3,0,3
24962,ElliotBayTrailMyrtlePark,11/06/2016 02:00:00 AM,48,-122,0,0,0
24963,ElliotBayTrailMyrtlePark,11/06/2016 03:00:00 AM,48,-122,1,0,1
24964,ElliotBayTrailMyrtlePark,11/06/2016 04:00:00 AM,48,-122,0,1,1
24965,ElliotBayTrailMyrtlePark,11/06/2016 05:00:00 AM,48,-122,0,1,1
24966,ElliotBayTrailMyrtlePark,11/06/2016 06:00:00 AM,48,-122,3,0,3
24967,ElliotBayTrailMyrtlePark,11/06/2016 07:00:00 AM,48,-122,6,5,11
24968,ElliotBayTrailMyrtlePark,11/06/2016 08:00:00 AM,48,-122,12,20,32
24969,ElliotBayTrailMyrtlePark,11/06/2016 09:00:00 AM,48,-122,28,22,50
24970,ElliotBayTrailMyrtlePark,11/06/2016 10:00:00 AM,48,-122,51,37,88
24971,ElliotBayTrailMyrtlePark,11/06/2016 11:00:00 AM,48,-122,54,30,84
24972,ElliotBayTrailMyrtlePark,11/06/2016 12:00:00 PM,48,-122,74,38,112
24973,ElliotBayTrailMyrtlePark,11/06/2016 01:00:00 PM,48,-122,57,44,101
24974,ElliotBayTrailMyrtlePark,11/06/2016 02:00:00 PM,48,-122,56,44,100
24975,ElliotBayTrailMyrtlePark,11/06/2016 03:00:00 PM,48,-122,48,47,95
24976,ElliotBayTrailMyrtlePark,11/06/2016 04:00:00 PM,48,-122,20,29,49
24977,ElliotBayTrailMyrtlePark,11/06/2016 05:00:00 PM,48,-122,10,3,13
24978,ElliotBayTrailMyrtlePark,11/06/2016 06:00:00 PM,48,-122,1,8,9
24979,ElliotBayTrailMyrtlePark,11/06/2016 07:00:00 PM,48,-122,2,0,2
24980,ElliotBayTrailMyrtlePark,11/06/2016 08:00:00 PM,48,-122,4,0,4
24981,ElliotBayTrailMyrtlePark,11/06/2016 09:00:00 PM,48,-122,5,2,7
24982,ElliotBayTrailMyrtlePark,11/06/2016 10:00:00 PM,48,-122,5,3,8
24983,ElliotBayTrailMyrtlePark,11/06/2016 11:00:00 PM,48,-122,1,1,2
24984,ElliotBayTrailMyrtlePark,11/07/2016 12:00:00 AM,48,-122,1,0,1
24985,ElliotBayTrailMyrtlePark,11/07/2016 01:00:00 AM,48,-122,0,0,0
24986,ElliotBayTrailMyrtlePark,11/07/2016 02:00:00 AM,48,-122,0,0,0
24987,ElliotBayTrailMyrtlePark,11/07/2016 03:00:00 AM,48,-122,0,0,0
24988,ElliotBayTrailMyrtlePark,11/07/2016 04:00:00 AM,48,-122,3,1,4
24989,ElliotBayTrailMyrtlePark,11/07/2016 05:00:00 AM,48,-122,10,14,24
24990,ElliotBayTrailMyrtlePark,11/07/2016 06:00:00 AM,48,-122,27,36,63
24991,ElliotBayTrailMyrtlePark,11/07/2016 07:00:00 AM,48,-122,35,147,182
24992,ElliotBayTrailMyrtlePark,11/07/2016 08:00:00 AM,48,-122,35,92,127
24993,ElliotBayTrailMyrtlePark,11/07/2016 09:00:00 AM,48,-122,17,28,45
24994,ElliotBayTrailMyrtlePark,11/07/2016 10:00:00 AM,48,-122,5,12,17
24995,ElliotBayTrailMyrtlePark,11/07/2016 11:00:00 AM,48,-122,13,20,33
24996,ElliotBayTrailMyrtlePark,11/07/2016 12:00:00 PM,48,-122,13,10,23
24997,ElliotBayTrailMyrtlePark,11/07/2016 01:00:00 PM,48,-122,21,15,36
24998,ElliotBayTrailMyrtlePark,11/07/2016 02:00:00 PM,48,-122,23,28,51
24999,ElliotBayTrailMyrtlePark,11/07/2016 03:00:00 PM,48,-122,58,35,93
25000,ElliotBayTrailMyrtlePark,11/07/2016 04:00:00 PM,48,-122,130,50,180
25001,ElliotBayTrailMyrtlePark,11/07/2016 05:00:00 PM,48,-122,127,22,149
25002,ElliotBayTrailMyrtlePark,11/07/2016 06:00:00 PM,48,-122,31,8,39
25003,ElliotBayTrailMyrtlePark,11/07/2016 07:00:00 PM,48,-122,8,2,10
25004,ElliotBayTrailMyrtlePark,11/07/2016 08:00:00 PM,48,-122,12,2,14
25005,ElliotBayTrailMyrtlePark,11/07/2016 09:00:00 PM,48,-122,10,3,13
25006,ElliotBayTrailMyrtlePark,11/07/2016 10:00:00 PM,48,-122,2,1,3
25007,ElliotBayTrailMyrtlePark,11/07/2016 11:00:00 PM,48,-122,1,1,2
25008,ElliotBayTrailMyrtlePark,11/08/2016 12:00:00 AM,48,-122,1,0,1
25009,ElliotBayTrailMyrtlePark,11/08/2016 01:00:00 AM,48,-122,1,0,1
25010,ElliotBayTrailMyrtlePark,11/08/2016 02:00:00 AM,48,-122,1,0,1
25011,ElliotBayTrailMyrtlePark,11/08/2016 03:00:00 AM,48,-122,1,1,2
25012,ElliotBayTrailMyrtlePark,11/08/2016 04:00:00 AM,48,-122,2,3,5
25013,ElliotBayTrailMyrtlePark,11/08/2016 05:00:00 AM,48,-122,13,23,36
25014,ElliotBayTrailMyrtlePark,11/08/2016 06:00:00 AM,48,-122,31,61,92
25015,ElliotBayTrailMyrtlePark,11/08/2016 07:00:00 AM,48,-122,30,149,179
25016,ElliotBayTrailMyrtlePark,11/08/2016 08:00:00 AM,48,-122,37,120,157
25017,ElliotBayTrailMyrtlePark,11/08/2016 09:00:00 AM,48,-122,22,35,57
25018,ElliotBayTrailMyrtlePark,11/08/2016 10:00:00 AM,48,-122,19,25,44
25019,ElliotBayTrailMyrtlePark,11/08/2016 11:00:00 AM,48,-122,16,16,32
25020,ElliotBayTrailMyrtlePark,11/08/2016 12:00:00 PM,48,-122,42,31,73
25021,ElliotBayTrailMyrtlePark,11/08/2016 01:00:00 PM,48,-122,29,30,59
25022,ElliotBayTrailMyrtlePark,11/08/2016 02:00:00 PM,48,-122,60,35,95
25023,ElliotBayTrailMyrtlePark,11/08/2016 03:00:00 PM,48,-122,81,70,151
25024,ElliotBayTrailMyrtlePark,11/08/2016 04:00:00 PM,48,-122,150,68,218
25025,ElliotBayTrailMyrtlePark,11/08/2016 05:00:00 PM,48,-122,152,32,184
25026,ElliotBayTrailMyrtlePark,11/08/2016 06:00:00 PM,48,-122,40,6,46
25027,ElliotBayTrailMyrtlePark,11/08/2016 07:00:00 PM,48,-122,11,1,12
25028,ElliotBayTrailMyrtlePark,11/08/2016 08:00:00 PM,48,-122,5,7,12
25029,ElliotBayTrailMyrtlePark,11/08/2016 09:00:00 PM,48,-122,1,0,1
25030,ElliotBayTrailMyrtlePark,11/08/2016 10:00:00 PM,48,-122,4,3,7
25031,ElliotBayTrailMyrtlePark,11/08/2016 11:00:00 PM,48,-122,3,2,5
25032,ElliotBayTrailMyrtlePark,11/09/2016 12:00:00 AM,48,-122,0,0,0
25033,ElliotBayTrailMyrtlePark,11/09/2016 01:00:00 AM,48,-122,3,0,3
25034,ElliotBayTrailMyrtlePark,11/09/2016 02:00:00 AM,48,-122,1,0,1
25035,ElliotBayTrailMyrtlePark,11/09/2016 03:00:00 AM,48,-122,1,1,2
25036,ElliotBayTrailMyrtlePark,11/09/2016 04:00:00 AM,48,-122,2,3,5
25037,ElliotBayTrailMyrtlePark,11/09/2016 05:00:00 AM,48,-122,8,16,24
25038,ElliotBayTrailMyrtlePark,11/09/2016 06:00:00 AM,48,-122,15,32,47
25039,ElliotBayTrailMyrtlePark,11/09/2016 07:00:00 AM,48,-122,28,85,113
25040,ElliotBayTrailMyrtlePark,11/09/2016 08:00:00 AM,48,-122,22,92,114
25041,ElliotBayTrailMyrtlePark,11/09/2016 09:00:00 AM,48,-122,9,22,31
25042,ElliotBayTrailMyrtlePark,11/09/2016 10:00:00 AM,48,-122,5,4,9
25043,ElliotBayTrailMyrtlePark,11/09/2016 11:00:00 AM,48,-122,10,11,21
25044,ElliotBayTrailMyrtlePark,11/09/2016 12:00:00 PM,48,-122,11,7,18
25045,ElliotBayTrailMyrtlePark,11/09/2016 01:00:00 PM,48,-122,20,10,30
25046,ElliotBayTrailMyrtlePark,11/09/2016 02:00:00 PM,48,-122,19,34,53
25047,ElliotBayTrailMyrtlePark,11/09/2016 03:00:00 PM,48,-122,58,40,98
25048,ElliotBayTrailMyrtlePark,11/09/2016 04:00:00 PM,48,-122,89,46,135
25049,ElliotBayTrailMyrtlePark,11/09/2016 05:00:00 PM,48,-122,115,25,140
25050,ElliotBayTrailMyrtlePark,11/09/2016 06:00:00 PM,48,-122,38,17,55
25051,ElliotBayTrailMyrtlePark,11/09/2016 07:00:00 PM,48,-122,12,1,13
25052,ElliotBayTrailMyrtlePark,11/09/2016 08:00:00 PM,48,-122,8,1,9
25053,ElliotBayTrailMyrtlePark,11/09/2016 09:00:00 PM,48,-122,3,1,4
25054,ElliotBayTrailMyrtlePark,11/09/2016 10:00:00 PM,48,-122,0,2,2
25055,ElliotBayTrailMyrtlePark,11/09/2016 11:00:00 PM,48,-122,1,0,1
25056,ElliotBayTrailMyrtlePark,11/10/2016 12:00:00 AM,48,-122,0,1,1
25057,ElliotBayTrailMyrtlePark,11/10/2016 01:00:00 AM,48,-122,1,0,1
25058,ElliotBayTrailMyrtlePark,11/10/2016 02:00:00 AM,48,-122,1,0,1
25059,ElliotBayTrailMyrtlePark,11/10/2016 03:00:00 AM,48,-122,1,1,2
25060,ElliotBayTrailMyrtlePark,11/10/2016 04:00:00 AM,48,-122,1,4,5
25061,ElliotBayTrailMyrtlePark,11/10/2016 05:00:00 AM,48,-122,11,21,32
25062,ElliotBayTrailMyrtlePark,11/10/2016 06:00:00 AM,48,-122,14,32,46
25063,ElliotBayTrailMyrtlePark,11/10/2016 07:00:00 AM,48,-122,36,132,168
25064,ElliotBayTrailMyrtlePark,11/10/2016 08:00:00 AM,48,-122,34,95,129
25065,ElliotBayTrailMyrtlePark,11/10/2016 09:00:00 AM,48,-122,17,28,45
25066,ElliotBayTrailMyrtlePark,11/10/2016 10:00:00 AM,48,-122,13,24,37
25067,ElliotBayTrailMyrtlePark,11/10/2016 11:00:00 AM,48,-122,17,14,31
25068,ElliotBayTrailMyrtlePark,11/10/2016 12:00:00 PM,48,-122,15,21,36
25069,ElliotBayTrailMyrtlePark,11/10/2016 01:00:00 PM,48,-122,35,20,55
25070,ElliotBayTrailMyrtlePark,11/10/2016 02:00:00 PM,48,-122,31,29,60
25071,ElliotBayTrailMyrtlePark,11/10/2016 03:00:00 PM,48,-122,53,45,98
25072,ElliotBayTrailMyrtlePark,11/10/2016 04:00:00 PM,48,-122,94,54,148
25073,ElliotBayTrailMyrtlePark,11/10/2016 05:00:00 PM,48,-122,123,26,149
25074,ElliotBayTrailMyrtlePark,11/10/2016 06:00:00 PM,48,-122,48,5,53
25075,ElliotBayTrailMyrtlePark,11/10/2016 07:00:00 PM,48,-122,16,4,20
25076,ElliotBayTrailMyrtlePark,11/10/2016 08:00:00 PM,48,-122,5,2,7
25077,ElliotBayTrailMyrtlePark,11/10/2016 09:00:00 PM,48,-122,3,1,4
25078,ElliotBayTrailMyrtlePark,11/10/2016 10:00:00 PM,48,-122,4,0,4
25079,ElliotBayTrailMyrtlePark,11/10/2016 11:00:00 PM,48,-122,2,0,2
25080,ElliotBayTrailMyrtlePark,11/11/2016 12:00:00 AM,48,-122,2,0,2
25081,ElliotBayTrailMyrtlePark,11/11/2016 01:00:00 AM,48,-122,1,0,1
25082,ElliotBayTrailMyrtlePark,11/11/2016 02:00:00 AM,48,-122,1,0,1
25083,ElliotBayTrailMyrtlePark,11/11/2016 03:00:00 AM,48,-122,0,1,1
25084,ElliotBayTrailMyrtlePark,11/11/2016 04:00:00 AM,48,-122,2,3,5
25085,ElliotBayTrailMyrtlePark,11/11/2016 05:00:00 AM,48,-122,9,12,21
25086,ElliotBayTrailMyrtlePark,11/11/2016 06:00:00 AM,48,-122,13,26,39
25087,ElliotBayTrailMyrtlePark,11/11/2016 07:00:00 AM,48,-122,26,96,122
25088,ElliotBayTrailMyrtlePark,11/11/2016 08:00:00 AM,48,-122,22,69,91
25089,ElliotBayTrailMyrtlePark,11/11/2016 09:00:00 AM,48,-122,23,30,53
25090,ElliotBayTrailMyrtlePark,11/11/2016 10:00:00 AM,48,-122,22,43,65
25091,ElliotBayTrailMyrtlePark,11/11/2016 11:00:00 AM,48,-122,18,21,39
25092,ElliotBayTrailMyrtlePark,11/11/2016 12:00:00 PM,48,-122,16,19,35
25093,ElliotBayTrailMyrtlePark,11/11/2016 01:00:00 PM,48,-122,42,19,61
25094,ElliotBayTrailMyrtlePark,11/11/2016 02:00:00 PM,48,-122,41,36,77
25095,ElliotBayTrailMyrtlePark,11/11/2016 03:00:00 PM,48,-122,67,38,105
25096,ElliotBayTrailMyrtlePark,11/11/2016 04:00:00 PM,48,-122,84,38,122
25097,ElliotBayTrailMyrtlePark,11/11/2016 05:00:00 PM,48,-122,74,16,90
25098,ElliotBayTrailMyrtlePark,11/11/2016 06:00:00 PM,48,-122,27,7,34
25099,ElliotBayTrailMyrtlePark,11/11/2016 07:00:00 PM,48,-122,5,1,6
25100,ElliotBayTrailMyrtlePark,11/11/2016 08:00:00 PM,48,-122,3,4,7
25101,ElliotBayTrailMyrtlePark,11/11/2016 09:00:00 PM,48,-122,4,7,11
25102,ElliotBayTrailMyrtlePark,11/11/2016 10:00:00 PM,48,-122,5,5,10
25103,ElliotBayTrailMyrtlePark,11/11/2016 11:00:00 PM,48,-122,6,2,8
25104,ElliotBayTrailMyrtlePark,11/12/2016 12:00:00 AM,48,-122,9,0,9
25105,ElliotBayTrailMyrtlePark,11/12/2016 01:00:00 AM,48,-122,1,0,1
25106,ElliotBayTrailMyrtlePark,11/12/2016 02:00:00 AM,48,-122,0,0,0
25107,ElliotBayTrailMyrtlePark,11/12/2016 03:00:00 AM,48,-122,0,0,0
25108,ElliotBayTrailMyrtlePark,11/12/2016 04:00:00 AM,48,-122,0,1,1
25109,ElliotBayTrailMyrtlePark,11/12/2016 05:00:00 AM,48,-122,1,0,1
25110,ElliotBayTrailMyrtlePark,11/12/2016 06:00:00 AM,48,-122,2,3,5
25111,ElliotBayTrailMyrtlePark,11/12/2016 07:00:00 AM,48,-122,7,4,11
25112,ElliotBayTrailMyrtlePark,11/12/2016 08:00:00 AM,48,-122,5,10,15
25113,ElliotBayTrailMyrtlePark,11/12/2016 09:00:00 AM,48,-122,10,4,14
25114,ElliotBayTrailMyrtlePark,11/12/2016 10:00:00 AM,48,-122,18,4,22
25115,ElliotBayTrailMyrtlePark,11/12/2016 11:00:00 AM,48,-122,6,13,19
25116,ElliotBayTrailMyrtlePark,11/12/2016 12:00:00 PM,48,-122,9,10,19
25117,ElliotBayTrailMyrtlePark,11/12/2016 01:00:00 PM,48,-122,22,14,36
25118,ElliotBayTrailMyrtlePark,11/12/2016 02:00:00 PM,48,-122,14,16,30
25119,ElliotBayTrailMyrtlePark,11/12/2016 03:00:00 PM,48,-122,50,30,80
25120,ElliotBayTrailMyrtlePark,11/12/2016 04:00:00 PM,48,-122,22,7,29
25121,ElliotBayTrailMyrtlePark,11/12/2016 05:00:00 PM,48,-122,4,7,11
25122,ElliotBayTrailMyrtlePark,11/12/2016 06:00:00 PM,48,-122,5,1,6
25123,ElliotBayTrailMyrtlePark,11/12/2016 07:00:00 PM,48,-122,2,3,5
25124,ElliotBayTrailMyrtlePark,11/12/2016 08:00:00 PM,48,-122,3,3,6
25125,ElliotBayTrailMyrtlePark,11/12/2016 09:00:00 PM,48,-122,4,0,4
25126,ElliotBayTrailMyrtlePark,11/12/2016 10:00:00 PM,48,-122,2,1,3
25127,ElliotBayTrailMyrtlePark,11/12/2016 11:00:00 PM,48,-122,12,1,13
25128,ElliotBayTrailMyrtlePark,11/13/2016 12:00:00 AM,48,-122,0,0,0
25129,ElliotBayTrailMyrtlePark,11/13/2016 01:00:00 AM,48,-122,1,1,2
25130,ElliotBayTrailMyrtlePark,11/13/2016 02:00:00 AM,48,-122,0,0,0
25131,ElliotBayTrailMyrtlePark,11/13/2016 03:00:00 AM,48,-122,0,1,1
25132,ElliotBayTrailMyrtlePark,11/13/2016 04:00:00 AM,48,-122,0,1,1
25133,ElliotBayTrailMyrtlePark,11/13/2016 05:00:00 AM,48,-122,1,1,2
25134,ElliotBayTrailMyrtlePark,11/13/2016 06:00:00 AM,48,-122,3,1,4
25135,ElliotBayTrailMyrtlePark,11/13/2016 07:00:00 AM,48,-122,6,1,7
25136,ElliotBayTrailMyrtlePark,11/13/2016 08:00:00 AM,48,-122,3,5,8
25137,ElliotBayTrailMyrtlePark,11/13/2016 09:00:00 AM,48,-122,6,4,10
25138,ElliotBayTrailMyrtlePark,11/13/2016 10:00:00 AM,48,-122,9,9,18
25139,ElliotBayTrailMyrtlePark,11/13/2016 11:00:00 AM,48,-122,10,10,20
25140,ElliotBayTrailMyrtlePark,11/13/2016 12:00:00 PM,48,-122,12,8,20
25141,ElliotBayTrailMyrtlePark,11/13/2016 01:00:00 PM,48,-122,12,11,23
25142,ElliotBayTrailMyrtlePark,11/13/2016 02:00:00 PM,48,-122,8,8,16
25143,ElliotBayTrailMyrtlePark,11/13/2016 03:00:00 PM,48,-122,10,12,22
25144,ElliotBayTrailMyrtlePark,11/13/2016 04:00:00 PM,48,-122,3,12,15
25145,ElliotBayTrailMyrtlePark,11/13/2016 05:00:00 PM,48,-122,3,3,6
25146,ElliotBayTrailMyrtlePark,11/13/2016 06:00:00 PM,48,-122,3,1,4
25147,ElliotBayTrailMyrtlePark,11/13/2016 07:00:00 PM,48,-122,2,0,2
25148,ElliotBayTrailMyrtlePark,11/13/2016 08:00:00 PM,48,-122,1,0,1
25149,ElliotBayTrailMyrtlePark,11/13/2016 09:00:00 PM,48,-122,2,0,2
25150,ElliotBayTrailMyrtlePark,11/13/2016 10:00:00 PM,48,-122,1,0,1
25151,ElliotBayTrailMyrtlePark,11/13/2016 11:00:00 PM,48,-122,0,0,0
25152,ElliotBayTrailMyrtlePark,11/14/2016 12:00:00 AM,48,-122,0,0,0
25153,ElliotBayTrailMyrtlePark,11/14/2016 01:00:00 AM,48,-122,1,0,1
25154,ElliotBayTrailMyrtlePark,11/14/2016 02:00:00 AM,48,-122,0,0,0
25155,ElliotBayTrailMyrtlePark,11/14/2016 03:00:00 AM,48,-122,0,1,1
25156,ElliotBayTrailMyrtlePark,11/14/2016 04:00:00 AM,48,-122,3,1,4
25157,ElliotBayTrailMyrtlePark,11/14/2016 05:00:00 AM,48,-122,10,16,26
25158,ElliotBayTrailMyrtlePark,11/14/2016 06:00:00 AM,48,-122,19,31,50
25159,ElliotBayTrailMyrtlePark,11/14/2016 07:00:00 AM,48,-122,35,114,149
25160,ElliotBayTrailMyrtlePark,11/14/2016 08:00:00 AM,48,-122,29,110,139
25161,ElliotBayTrailMyrtlePark,11/14/2016 09:00:00 AM,48,-122,11,25,36
25162,ElliotBayTrailMyrtlePark,11/14/2016 10:00:00 AM,48,-122,4,13,17
25163,ElliotBayTrailMyrtlePark,11/14/2016 11:00:00 AM,48,-122,17,15,32
25164,ElliotBayTrailMyrtlePark,11/14/2016 12:00:00 PM,48,-122,6,15,21
25165,ElliotBayTrailMyrtlePark,11/14/2016 01:00:00 PM,48,-122,23,11,34
25166,ElliotBayTrailMyrtlePark,11/14/2016 02:00:00 PM,48,-122,25,26,51
25167,ElliotBayTrailMyrtlePark,11/14/2016 03:00:00 PM,48,-122,46,36,82
25168,ElliotBayTrailMyrtlePark,11/14/2016 04:00:00 PM,48,-122,111,46,157
25169,ElliotBayTrailMyrtlePark,11/14/2016 05:00:00 PM,48,-122,116,24,140
25170,ElliotBayTrailMyrtlePark,11/14/2016 06:00:00 PM,48,-122,65,10,75
25171,ElliotBayTrailMyrtlePark,11/14/2016 07:00:00 PM,48,-122,7,3,10
25172,ElliotBayTrailMyrtlePark,11/14/2016 08:00:00 PM,48,-122,3,3,6
25173,ElliotBayTrailMyrtlePark,11/14/2016 09:00:00 PM,48,-122,0,1,1
25174,ElliotBayTrailMyrtlePark,11/14/2016 10:00:00 PM,48,-122,1,0,1
25175,ElliotBayTrailMyrtlePark,11/14/2016 11:00:00 PM,48,-122,2,2,4
25176,ElliotBayTrailMyrtlePark,11/15/2016 12:00:00 AM,48,-122,1,1,2
25177,ElliotBayTrailMyrtlePark,11/15/2016 01:00:00 AM,48,-122,0,0,0
25178,ElliotBayTrailMyrtlePark,11/15/2016 02:00:00 AM,48,-122,0,1,1
25179,ElliotBayTrailMyrtlePark,11/15/2016 03:00:00 AM,48,-122,0,0,0
25180,ElliotBayTrailMyrtlePark,11/15/2016 04:00:00 AM,48,-122,4,4,8
25181,ElliotBayTrailMyrtlePark,11/15/2016 05:00:00 AM,48,-122,7,12,19
25182,ElliotBayTrailMyrtlePark,11/15/2016 06:00:00 AM,48,-122,14,24,38
25183,ElliotBayTrailMyrtlePark,11/15/2016 07:00:00 AM,48,-122,26,81,107
25184,ElliotBayTrailMyrtlePark,11/15/2016 08:00:00 AM,48,-122,24,96,120
25185,ElliotBayTrailMyrtlePark,11/15/2016 09:00:00 AM,48,-122,18,22,40
25186,ElliotBayTrailMyrtlePark,11/15/2016 10:00:00 AM,48,-122,10,11,21
25187,ElliotBayTrailMyrtlePark,11/15/2016 11:00:00 AM,48,-122,5,10,15
25188,ElliotBayTrailMyrtlePark,11/15/2016 12:00:00 PM,48,-122,10,8,18
25189,ElliotBayTrailMyrtlePark,11/15/2016 01:00:00 PM,48,-122,18,11,29
25190,ElliotBayTrailMyrtlePark,11/15/2016 02:00:00 PM,48,-122,15,17,32
25191,ElliotBayTrailMyrtlePark,11/15/2016 03:00:00 PM,48,-122,33,19,52
25192,ElliotBayTrailMyrtlePark,11/15/2016 04:00:00 PM,48,-122,76,40,116
25193,ElliotBayTrailMyrtlePark,11/15/2016 05:00:00 PM,48,-122,111,17,128
25194,ElliotBayTrailMyrtlePark,11/15/2016 06:00:00 PM,48,-122,28,2,30
25195,ElliotBayTrailMyrtlePark,11/15/2016 07:00:00 PM,48,-122,9,2,11
25196,ElliotBayTrailMyrtlePark,11/15/2016 08:00:00 PM,48,-122,5,0,5
25197,ElliotBayTrailMyrtlePark,11/15/2016 09:00:00 PM,48,-122,1,1,2
25198,ElliotBayTrailMyrtlePark,11/15/2016 10:00:00 PM,48,-122,0,2,2
25199,ElliotBayTrailMyrtlePark,11/15/2016 11:00:00 PM,48,-122,0,0,0
25200,ElliotBayTrailMyrtlePark,11/16/2016 12:00:00 AM,48,-122,0,0,0
25201,ElliotBayTrailMyrtlePark,11/16/2016 01:00:00 AM,48,-122,2,0,2
25202,ElliotBayTrailMyrtlePark,11/16/2016 02:00:00 AM,48,-122,0,0,0
25203,ElliotBayTrailMyrtlePark,11/16/2016 03:00:00 AM,48,-122,0,1,1
25204,ElliotBayTrailMyrtlePark,11/16/2016 04:00:00 AM,48,-122,0,2,2
25205,ElliotBayTrailMyrtlePark,11/16/2016 05:00:00 AM,48,-122,8,12,20
25206,ElliotBayTrailMyrtlePark,11/16/2016 06:00:00 AM,48,-122,16,30,46
25207,ElliotBayTrailMyrtlePark,11/16/2016 07:00:00 AM,48,-122,29,115,144
25208,ElliotBayTrailMyrtlePark,11/16/2016 08:00:00 AM,48,-122,30,110,140
25209,ElliotBayTrailMyrtlePark,11/16/2016 09:00:00 AM,48,-122,11,24,35
25210,ElliotBayTrailMyrtlePark,11/16/2016 10:00:00 AM,48,-122,6,10,16
25211,ElliotBayTrailMyrtlePark,11/16/2016 11:00:00 AM,48,-122,11,10,21
25212,ElliotBayTrailMyrtlePark,11/16/2016 12:00:00 PM,48,-122,21,19,40
25213,ElliotBayTrailMyrtlePark,11/16/2016 01:00:00 PM,48,-122,5,3,8
25214,ElliotBayTrailMyrtlePark,11/16/2016 02:00:00 PM,48,-122,17,13,30
25215,ElliotBayTrailMyrtlePark,11/16/2016 03:00:00 PM,48,-122,48,30,78
25216,ElliotBayTrailMyrtlePark,11/16/2016 04:00:00 PM,48,-122,86,41,127
25217,ElliotBayTrailMyrtlePark,11/16/2016 05:00:00 PM,48,-122,132,27,159
25218,ElliotBayTrailMyrtlePark,11/16/2016 06:00:00 PM,48,-122,27,5,32
25219,ElliotBayTrailMyrtlePark,11/16/2016 07:00:00 PM,48,-122,6,4,10
25220,ElliotBayTrailMyrtlePark,11/16/2016 08:00:00 PM,48,-122,10,0,10
25221,ElliotBayTrailMyrtlePark,11/16/2016 09:00:00 PM,48,-122,1,2,3
25222,ElliotBayTrailMyrtlePark,11/16/2016 10:00:00 PM,48,-122,0,0,0
25223,ElliotBayTrailMyrtlePark,11/16/2016 11:00:00 PM,48,-122,3,0,3
25224,ElliotBayTrailMyrtlePark,11/17/2016 12:00:00 AM,48,-122,1,0,1
25225,ElliotBayTrailMyrtlePark,11/17/2016 01:00:00 AM,48,-122,0,0,0
25226,ElliotBayTrailMyrtlePark,11/17/2016 02:00:00 AM,48,-122,1,0,1
25227,ElliotBayTrailMyrtlePark,11/17/2016 03:00:00 AM,48,-122,0,1,1
25228,ElliotBayTrailMyrtlePark,11/17/2016 04:00:00 AM,48,-122,0,1,1
25229,ElliotBayTrailMyrtlePark,11/17/2016 05:00:00 AM,48,-122,13,18,31
25230,ElliotBayTrailMyrtlePark,11/17/2016 06:00:00 AM,48,-122,16,34,50
25231,ElliotBayTrailMyrtlePark,11/17/2016 07:00:00 AM,48,-122,29,113,142
25232,ElliotBayTrailMyrtlePark,11/17/2016 08:00:00 AM,48,-122,32,102,134
25233,ElliotBayTrailMyrtlePark,11/17/2016 09:00:00 AM,48,-122,24,21,45
25234,ElliotBayTrailMyrtlePark,11/17/2016 10:00:00 AM,48,-122,10,18,28
25235,ElliotBayTrailMyrtlePark,11/17/2016 11:00:00 AM,48,-122,18,16,34
25236,ElliotBayTrailMyrtlePark,11/17/2016 12:00:00 PM,48,-122,16,15,31
25237,ElliotBayTrailMyrtlePark,11/17/2016 01:00:00 PM,48,-122,17,10,27
25238,ElliotBayTrailMyrtlePark,11/17/2016 02:00:00 PM,48,-122,25,27,52
25239,ElliotBayTrailMyrtlePark,11/17/2016 03:00:00 PM,48,-122,46,24,70
25240,ElliotBayTrailMyrtlePark,11/17/2016 04:00:00 PM,48,-122,100,40,140
25241,ElliotBayTrailMyrtlePark,11/17/2016 05:00:00 PM,48,-122,137,25,162
25242,ElliotBayTrailMyrtlePark,11/17/2016 06:00:00 PM,48,-122,33,5,38
25243,ElliotBayTrailMyrtlePark,11/17/2016 07:00:00 PM,48,-122,40,7,47
25244,ElliotBayTrailMyrtlePark,11/17/2016 08:00:00 PM,48,-122,5,3,8
25245,ElliotBayTrailMyrtlePark,11/17/2016 09:00:00 PM,48,-122,4,3,7
25246,ElliotBayTrailMyrtlePark,11/17/2016 10:00:00 PM,48,-122,2,1,3
25247,ElliotBayTrailMyrtlePark,11/17/2016 11:00:00 PM,48,-122,1,1,2
25248,ElliotBayTrailMyrtlePark,11/18/2016 12:00:00 AM,48,-122,0,0,0
25249,ElliotBayTrailMyrtlePark,11/18/2016 01:00:00 AM,48,-122,0,1,1
25250,ElliotBayTrailMyrtlePark,11/18/2016 02:00:00 AM,48,-122,0,0,0
25251,ElliotBayTrailMyrtlePark,11/18/2016 03:00:00 AM,48,-122,0,0,0
25252,ElliotBayTrailMyrtlePark,11/18/2016 04:00:00 AM,48,-122,2,2,4
25253,ElliotBayTrailMyrtlePark,11/18/2016 05:00:00 AM,48,-122,12,15,27
25254,ElliotBayTrailMyrtlePark,11/18/2016 06:00:00 AM,48,-122,14,28,42
25255,ElliotBayTrailMyrtlePark,11/18/2016 07:00:00 AM,48,-122,25,94,119
25256,ElliotBayTrailMyrtlePark,11/18/2016 08:00:00 AM,48,-122,20,93,113
25257,ElliotBayTrailMyrtlePark,11/18/2016 09:00:00 AM,48,-122,17,25,42
25258,ElliotBayTrailMyrtlePark,11/18/2016 10:00:00 AM,48,-122,10,15,25
25259,ElliotBayTrailMyrtlePark,11/18/2016 11:00:00 AM,48,-122,13,20,33
25260,ElliotBayTrailMyrtlePark,11/18/2016 12:00:00 PM,48,-122,11,10,21
25261,ElliotBayTrailMyrtlePark,11/18/2016 01:00:00 PM,48,-122,21,19,40
25262,ElliotBayTrailMyrtlePark,11/18/2016 02:00:00 PM,48,-122,20,27,47
25263,ElliotBayTrailMyrtlePark,11/18/2016 03:00:00 PM,48,-122,44,28,72
25264,ElliotBayTrailMyrtlePark,11/18/2016 04:00:00 PM,48,-122,98,38,136
25265,ElliotBayTrailMyrtlePark,11/18/2016 05:00:00 PM,48,-122,100,21,121
25266,ElliotBayTrailMyrtlePark,11/18/2016 06:00:00 PM,48,-122,37,4,41
25267,ElliotBayTrailMyrtlePark,11/18/2016 07:00:00 PM,48,-122,7,2,9
25268,ElliotBayTrailMyrtlePark,11/18/2016 08:00:00 PM,48,-122,3,1,4
25269,ElliotBayTrailMyrtlePark,11/18/2016 09:00:00 PM,48,-122,3,3,6
25270,ElliotBayTrailMyrtlePark,11/18/2016 10:00:00 PM,48,-122,5,0,5
25271,ElliotBayTrailMyrtlePark,11/18/2016 11:00:00 PM,48,-122,0,2,2
25272,ElliotBayTrailMyrtlePark,11/19/2016 12:00:00 AM,48,-122,1,0,1
25273,ElliotBayTrailMyrtlePark,11/19/2016 01:00:00 AM,48,-122,1,0,1
25274,ElliotBayTrailMyrtlePark,11/19/2016 02:00:00 AM,48,-122,2,0,2
25275,ElliotBayTrailMyrtlePark,11/19/2016 03:00:00 AM,48,-122,0,0,0
25276,ElliotBayTrailMyrtlePark,11/19/2016 04:00:00 AM,48,-122,0,1,1
25277,ElliotBayTrailMyrtlePark,11/19/2016 05:00:00 AM,48,-122,1,0,1
25278,ElliotBayTrailMyrtlePark,11/19/2016 06:00:00 AM,48,-122,1,1,2
25279,ElliotBayTrailMyrtlePark,11/19/2016 07:00:00 AM,48,-122,8,1,9
25280,ElliotBayTrailMyrtlePark,11/19/2016 08:00:00 AM,48,-122,6,5,11
25281,ElliotBayTrailMyrtlePark,11/19/2016 09:00:00 AM,48,-122,11,9,20
25282,ElliotBayTrailMyrtlePark,11/19/2016 10:00:00 AM,48,-122,5,9,14
25283,ElliotBayTrailMyrtlePark,11/19/2016 11:00:00 AM,48,-122,19,17,36
25284,ElliotBayTrailMyrtlePark,11/19/2016 12:00:00 PM,48,-122,9,4,13
25285,ElliotBayTrailMyrtlePark,11/19/2016 01:00:00 PM,48,-122,13,5,18
25286,ElliotBayTrailMyrtlePark,11/19/2016 02:00:00 PM,48,-122,11,13,24
25287,ElliotBayTrailMyrtlePark,11/19/2016 03:00:00 PM,48,-122,16,18,34
25288,ElliotBayTrailMyrtlePark,11/19/2016 04:00:00 PM,48,-122,8,11,19
25289,ElliotBayTrailMyrtlePark,11/19/2016 05:00:00 PM,48,-122,7,6,13
25290,ElliotBayTrailMyrtlePark,11/19/2016 06:00:00 PM,48,-122,6,0,6
25291,ElliotBayTrailMyrtlePark,11/19/2016 07:00:00 PM,48,-122,5,1,6
25292,ElliotBayTrailMyrtlePark,11/19/2016 08:00:00 PM,48,-122,2,1,3
25293,ElliotBayTrailMyrtlePark,11/19/2016 09:00:00 PM,48,-122,5,2,7
25294,ElliotBayTrailMyrtlePark,11/19/2016 10:00:00 PM,48,-122,1,1,2
25295,ElliotBayTrailMyrtlePark,11/19/2016 11:00:00 PM,48,-122,4,15,19
25296,ElliotBayTrailMyrtlePark,11/20/2016 12:00:00 AM,48,-122,0,1,1
25297,ElliotBayTrailMyrtlePark,11/20/2016 01:00:00 AM,48,-122,1,0,1
25298,ElliotBayTrailMyrtlePark,11/20/2016 02:00:00 AM,48,-122,0,0,0
25299,ElliotBayTrailMyrtlePark,11/20/2016 03:00:00 AM,48,-122,0,1,1
25300,ElliotBayTrailMyrtlePark,11/20/2016 04:00:00 AM,48,-122,0,1,1
25301,ElliotBayTrailMyrtlePark,11/20/2016 05:00:00 AM,48,-122,1,1,2
25302,ElliotBayTrailMyrtlePark,11/20/2016 06:00:00 AM,48,-122,3,0,3
25303,ElliotBayTrailMyrtlePark,11/20/2016 07:00:00 AM,48,-122,1,0,1
25304,ElliotBayTrailMyrtlePark,11/20/2016 08:00:00 AM,48,-122,6,8,14
25305,ElliotBayTrailMyrtlePark,11/20/2016 09:00:00 AM,48,-122,3,6,9
25306,ElliotBayTrailMyrtlePark,11/20/2016 10:00:00 AM,48,-122,7,6,13
25307,ElliotBayTrailMyrtlePark,11/20/2016 11:00:00 AM,48,-122,3,11,14
25308,ElliotBayTrailMyrtlePark,11/20/2016 12:00:00 PM,48,-122,9,16,25
25309,ElliotBayTrailMyrtlePark,11/20/2016 01:00:00 PM,48,-122,8,6,14
25310,ElliotBayTrailMyrtlePark,11/20/2016 02:00:00 PM,48,-122,7,5,12
25311,ElliotBayTrailMyrtlePark,11/20/2016 03:00:00 PM,48,-122,7,5,12
25312,ElliotBayTrailMyrtlePark,11/20/2016 04:00:00 PM,48,-122,5,3,8
25313,ElliotBayTrailMyrtlePark,11/20/2016 05:00:00 PM,48,-122,3,1,4
25314,ElliotBayTrailMyrtlePark,11/20/2016 06:00:00 PM,48,-122,2,1,3
25315,ElliotBayTrailMyrtlePark,11/20/2016 07:00:00 PM,48,-122,1,1,2
25316,ElliotBayTrailMyrtlePark,11/20/2016 08:00:00 PM,48,-122,0,1,1
25317,ElliotBayTrailMyrtlePark,11/20/2016 09:00:00 PM,48,-122,2,3,5
25318,ElliotBayTrailMyrtlePark,11/20/2016 10:00:00 PM,48,-122,0,0,0
25319,ElliotBayTrailMyrtlePark,11/20/2016 11:00:00 PM,48,-122,0,0,0
25320,ElliotBayTrailMyrtlePark,11/21/2016 12:00:00 AM,48,-122,2,0,2
25321,ElliotBayTrailMyrtlePark,11/21/2016 01:00:00 AM,48,-122,0,1,1
25322,ElliotBayTrailMyrtlePark,11/21/2016 02:00:00 AM,48,-122,0,0,0
25323,ElliotBayTrailMyrtlePark,11/21/2016 03:00:00 AM,48,-122,0,2,2
25324,ElliotBayTrailMyrtlePark,11/21/2016 04:00:00 AM,48,-122,4,0,4
25325,ElliotBayTrailMyrtlePark,11/21/2016 05:00:00 AM,48,-122,10,15,25
25326,ElliotBayTrailMyrtlePark,11/21/2016 06:00:00 AM,48,-122,19,27,46
25327,ElliotBayTrailMyrtlePark,11/21/2016 07:00:00 AM,48,-122,30,105,135
25328,ElliotBayTrailMyrtlePark,11/21/2016 08:00:00 AM,48,-122,33,107,140
25329,ElliotBayTrailMyrtlePark,11/21/2016 09:00:00 AM,48,-122,16,21,37
25330,ElliotBayTrailMyrtlePark,11/21/2016 10:00:00 AM,48,-122,14,13,27
25331,ElliotBayTrailMyrtlePark,11/21/2016 11:00:00 AM,48,-122,10,8,18
25332,ElliotBayTrailMyrtlePark,11/21/2016 12:00:00 PM,48,-122,13,14,27
25333,ElliotBayTrailMyrtlePark,11/21/2016 01:00:00 PM,48,-122,25,19,44
25334,ElliotBayTrailMyrtlePark,11/21/2016 02:00:00 PM,48,-122,24,22,46
25335,ElliotBayTrailMyrtlePark,11/21/2016 03:00:00 PM,48,-122,45,30,75
25336,ElliotBayTrailMyrtlePark,11/21/2016 04:00:00 PM,48,-122,108,50,158
25337,ElliotBayTrailMyrtlePark,11/21/2016 05:00:00 PM,48,-122,111,40,151
25338,ElliotBayTrailMyrtlePark,11/21/2016 06:00:00 PM,48,-122,33,14,47
25339,ElliotBayTrailMyrtlePark,11/21/2016 07:00:00 PM,48,-122,9,1,10
25340,ElliotBayTrailMyrtlePark,11/21/2016 08:00:00 PM,48,-122,5,2,7
25341,ElliotBayTrailMyrtlePark,11/21/2016 09:00:00 PM,48,-122,1,3,4
25342,ElliotBayTrailMyrtlePark,11/21/2016 10:00:00 PM,48,-122,4,0,4
25343,ElliotBayTrailMyrtlePark,11/21/2016 11:00:00 PM,48,-122,0,1,1
25344,ElliotBayTrailMyrtlePark,11/22/2016 12:00:00 AM,48,-122,0,3,3
25345,ElliotBayTrailMyrtlePark,11/22/2016 01:00:00 AM,48,-122,1,0,1
25346,ElliotBayTrailMyrtlePark,11/22/2016 02:00:00 AM,48,-122,0,0,0
25347,ElliotBayTrailMyrtlePark,11/22/2016 03:00:00 AM,48,-122,0,2,2
25348,ElliotBayTrailMyrtlePark,11/22/2016 04:00:00 AM,48,-122,5,1,6
25349,ElliotBayTrailMyrtlePark,11/22/2016 05:00:00 AM,48,-122,7,15,22
25350,ElliotBayTrailMyrtlePark,11/22/2016 06:00:00 AM,48,-122,13,20,33
25351,ElliotBayTrailMyrtlePark,11/22/2016 07:00:00 AM,48,-122,34,95,129
25352,ElliotBayTrailMyrtlePark,11/22/2016 08:00:00 AM,48,-122,26,74,100
25353,ElliotBayTrailMyrtlePark,11/22/2016 09:00:00 AM,48,-122,10,20,30
25354,ElliotBayTrailMyrtlePark,11/22/2016 10:00:00 AM,48,-122,8,11,19
25355,ElliotBayTrailMyrtlePark,11/22/2016 11:00:00 AM,48,-122,10,10,20
25356,ElliotBayTrailMyrtlePark,11/22/2016 12:00:00 PM,48,-122,8,10,18
25357,ElliotBayTrailMyrtlePark,11/22/2016 01:00:00 PM,48,-122,7,9,16
25358,ElliotBayTrailMyrtlePark,11/22/2016 02:00:00 PM,48,-122,14,14,28
25359,ElliotBayTrailMyrtlePark,11/22/2016 03:00:00 PM,48,-122,32,17,49
25360,ElliotBayTrailMyrtlePark,11/22/2016 04:00:00 PM,48,-122,61,28,89
25361,ElliotBayTrailMyrtlePark,11/22/2016 05:00:00 PM,48,-122,77,19,96
25362,ElliotBayTrailMyrtlePark,11/22/2016 06:00:00 PM,48,-122,31,4,35
25363,ElliotBayTrailMyrtlePark,11/22/2016 07:00:00 PM,48,-122,6,5,11
25364,ElliotBayTrailMyrtlePark,11/22/2016 08:00:00 PM,48,-122,1,0,1
25365,ElliotBayTrailMyrtlePark,11/22/2016 09:00:00 PM,48,-122,6,2,8
25366,ElliotBayTrailMyrtlePark,11/22/2016 10:00:00 PM,48,-122,3,1,4
25367,ElliotBayTrailMyrtlePark,11/22/2016 11:00:00 PM,48,-122,3,0,3
25368,ElliotBayTrailMyrtlePark,11/23/2016 12:00:00 AM,48,-122,0,0,0
25369,ElliotBayTrailMyrtlePark,11/23/2016 01:00:00 AM,48,-122,0,0,0
25370,ElliotBayTrailMyrtlePark,11/23/2016 02:00:00 AM,48,-122,1,0,1
25371,ElliotBayTrailMyrtlePark,11/23/2016 03:00:00 AM,48,-122,0,2,2
25372,ElliotBayTrailMyrtlePark,11/23/2016 04:00:00 AM,48,-122,3,2,5
25373,ElliotBayTrailMyrtlePark,11/23/2016 05:00:00 AM,48,-122,3,16,19
25374,ElliotBayTrailMyrtlePark,11/23/2016 06:00:00 AM,48,-122,10,17,27
25375,ElliotBayTrailMyrtlePark,11/23/2016 07:00:00 AM,48,-122,26,57,83
25376,ElliotBayTrailMyrtlePark,11/23/2016 08:00:00 AM,48,-122,15,67,82
25377,ElliotBayTrailMyrtlePark,11/23/2016 09:00:00 AM,48,-122,13,16,29
25378,ElliotBayTrailMyrtlePark,11/23/2016 10:00:00 AM,48,-122,5,12,17
25379,ElliotBayTrailMyrtlePark,11/23/2016 11:00:00 AM,48,-122,21,25,46
25380,ElliotBayTrailMyrtlePark,11/23/2016 12:00:00 PM,48,-122,13,8,21
25381,ElliotBayTrailMyrtlePark,11/23/2016 01:00:00 PM,48,-122,21,11,32
25382,ElliotBayTrailMyrtlePark,11/23/2016 02:00:00 PM,48,-122,43,19,62
25383,ElliotBayTrailMyrtlePark,11/23/2016 03:00:00 PM,48,-122,47,14,61
25384,ElliotBayTrailMyrtlePark,11/23/2016 04:00:00 PM,48,-122,52,16,68
25385,ElliotBayTrailMyrtlePark,11/23/2016 05:00:00 PM,48,-122,34,3,37
25386,ElliotBayTrailMyrtlePark,11/23/2016 06:00:00 PM,48,-122,12,2,14
25387,ElliotBayTrailMyrtlePark,11/23/2016 07:00:00 PM,48,-122,2,2,4
25388,ElliotBayTrailMyrtlePark,11/23/2016 08:00:00 PM,48,-122,3,0,3
25389,ElliotBayTrailMyrtlePark,11/23/2016 09:00:00 PM,48,-122,0,1,1
25390,ElliotBayTrailMyrtlePark,11/23/2016 10:00:00 PM,48,-122,2,0,2
25391,ElliotBayTrailMyrtlePark,11/23/2016 11:00:00 PM,48,-122,0,0,0
25392,ElliotBayTrailMyrtlePark,11/24/2016 12:00:00 AM,48,-122,0,1,1
25393,ElliotBayTrailMyrtlePark,11/24/2016 01:00:00 AM,48,-122,0,1,1
25394,ElliotBayTrailMyrtlePark,11/24/2016 02:00:00 AM,48,-122,0,0,0
25395,ElliotBayTrailMyrtlePark,11/24/2016 03:00:00 AM,48,-122,0,0,0
25396,ElliotBayTrailMyrtlePark,11/24/2016 04:00:00 AM,48,-122,0,0,0
25397,ElliotBayTrailMyrtlePark,11/24/2016 05:00:00 AM,48,-122,0,2,2
25398,ElliotBayTrailMyrtlePark,11/24/2016 06:00:00 AM,48,-122,0,1,1
25399,ElliotBayTrailMyrtlePark,11/24/2016 07:00:00 AM,48,-122,0,0,0
25400,ElliotBayTrailMyrtlePark,11/24/2016 08:00:00 AM,48,-122,6,0,6
25401,ElliotBayTrailMyrtlePark,11/24/2016 09:00:00 AM,48,-122,1,1,2
25402,ElliotBayTrailMyrtlePark,11/24/2016 10:00:00 AM,48,-122,1,2,3
25403,ElliotBayTrailMyrtlePark,11/24/2016 11:00:00 AM,48,-122,6,6,12
25404,ElliotBayTrailMyrtlePark,11/24/2016 12:00:00 PM,48,-122,0,0,0
25405,ElliotBayTrailMyrtlePark,11/24/2016 01:00:00 PM,48,-122,4,5,9
25406,ElliotBayTrailMyrtlePark,11/24/2016 02:00:00 PM,48,-122,1,2,3
25407,ElliotBayTrailMyrtlePark,11/24/2016 03:00:00 PM,48,-122,2,1,3
25408,ElliotBayTrailMyrtlePark,11/24/2016 04:00:00 PM,48,-122,0,2,2
25409,ElliotBayTrailMyrtlePark,11/24/2016 05:00:00 PM,48,-122,0,0,0
25410,ElliotBayTrailMyrtlePark,11/24/2016 06:00:00 PM,48,-122,3,1,4
25411,ElliotBayTrailMyrtlePark,11/24/2016 07:00:00 PM,48,-122,2,0,2
25412,ElliotBayTrailMyrtlePark,11/24/2016 08:00:00 PM,48,-122,0,0,0
25413,ElliotBayTrailMyrtlePark,11/24/2016 09:00:00 PM,48,-122,1,0,1
25414,ElliotBayTrailMyrtlePark,11/24/2016 10:00:00 PM,48,-122,0,0,0
25415,ElliotBayTrailMyrtlePark,11/24/2016 11:00:00 PM,48,-122,0,0,0
25416,ElliotBayTrailMyrtlePark,11/25/2016 12:00:00 AM,48,-122,0,0,0
25417,ElliotBayTrailMyrtlePark,11/25/2016 01:00:00 AM,48,-122,0,0,0
25418,ElliotBayTrailMyrtlePark,11/25/2016 02:00:00 AM,48,-122,0,0,0
25419,ElliotBayTrailMyrtlePark,11/25/2016 03:00:00 AM,48,-122,0,0,0
25420,ElliotBayTrailMyrtlePark,11/25/2016 04:00:00 AM,48,-122,0,0,0
25421,ElliotBayTrailMyrtlePark,11/25/2016 05:00:00 AM,48,-122,0,6,6
25422,ElliotBayTrailMyrtlePark,11/25/2016 06:00:00 AM,48,-122,2,1,3
25423,ElliotBayTrailMyrtlePark,11/25/2016 07:00:00 AM,48,-122,4,10,14
25424,ElliotBayTrailMyrtlePark,11/25/2016 08:00:00 AM,48,-122,7,14,21
25425,ElliotBayTrailMyrtlePark,11/25/2016 09:00:00 AM,48,-122,14,14,28
25426,ElliotBayTrailMyrtlePark,11/25/2016 10:00:00 AM,48,-122,20,18,38
25427,ElliotBayTrailMyrtlePark,11/25/2016 11:00:00 AM,48,-122,33,30,63
25428,ElliotBayTrailMyrtlePark,11/25/2016 12:00:00 PM,48,-122,25,34,59
25429,ElliotBayTrailMyrtlePark,11/25/2016 01:00:00 PM,48,-122,32,30,62
25430,ElliotBayTrailMyrtlePark,11/25/2016 02:00:00 PM,48,-122,39,25,64
25431,ElliotBayTrailMyrtlePark,11/25/2016 03:00:00 PM,48,-122,19,17,36
25432,ElliotBayTrailMyrtlePark,11/25/2016 04:00:00 PM,48,-122,13,9,22
25433,ElliotBayTrailMyrtlePark,11/25/2016 05:00:00 PM,48,-122,4,3,7
25434,ElliotBayTrailMyrtlePark,11/25/2016 06:00:00 PM,48,-122,27,4,31
25435,ElliotBayTrailMyrtlePark,11/25/2016 07:00:00 PM,48,-122,2,1,3
25436,ElliotBayTrailMyrtlePark,11/25/2016 08:00:00 PM,48,-122,1,4,5
25437,ElliotBayTrailMyrtlePark,11/25/2016 09:00:00 PM,48,-122,1,1,2
25438,ElliotBayTrailMyrtlePark,11/25/2016 10:00:00 PM,48,-122,0,0,0
25439,ElliotBayTrailMyrtlePark,11/25/2016 11:00:00 PM,48,-122,2,1,3
25440,ElliotBayTrailMyrtlePark,11/26/2016 12:00:00 AM,48,-122,0,0,0
25441,ElliotBayTrailMyrtlePark,11/26/2016 01:00:00 AM,48,-122,0,0,0
25442,ElliotBayTrailMyrtlePark,11/26/2016 02:00:00 AM,48,-122,0,0,0
25443,ElliotBayTrailMyrtlePark,11/26/2016 03:00:00 AM,48,-122,0,0,0
25444,ElliotBayTrailMyrtlePark,11/26/2016 04:00:00 AM,48,-122,0,0,0
25445,ElliotBayTrailMyrtlePark,11/26/2016 05:00:00 AM,48,-122,0,0,0
25446,ElliotBayTrailMyrtlePark,11/26/2016 06:00:00 AM,48,-122,0,0,0
25447,ElliotBayTrailMyrtlePark,11/26/2016 07:00:00 AM,48,-122,2,0,2
25448,ElliotBayTrailMyrtlePark,11/26/2016 08:00:00 AM,48,-122,0,1,1
25449,ElliotBayTrailMyrtlePark,11/26/2016 09:00:00 AM,48,-122,0,1,1
25450,ElliotBayTrailMyrtlePark,11/26/2016 10:00:00 AM,48,-122,2,3,5
25451,ElliotBayTrailMyrtlePark,11/26/2016 11:00:00 AM,48,-122,9,2,11
25452,ElliotBayTrailMyrtlePark,11/26/2016 12:00:00 PM,48,-122,7,8,15
25453,ElliotBayTrailMyrtlePark,11/26/2016 01:00:00 PM,48,-122,9,5,14
25454,ElliotBayTrailMyrtlePark,11/26/2016 02:00:00 PM,48,-122,7,16,23
25455,ElliotBayTrailMyrtlePark,11/26/2016 03:00:00 PM,48,-122,6,8,14
25456,ElliotBayTrailMyrtlePark,11/26/2016 04:00:00 PM,48,-122,6,7,13
25457,ElliotBayTrailMyrtlePark,11/26/2016 05:00:00 PM,48,-122,2,1,3
25458,ElliotBayTrailMyrtlePark,11/26/2016 06:00:00 PM,48,-122,2,11,13
25459,ElliotBayTrailMyrtlePark,11/26/2016 07:00:00 PM,48,-122,13,1,14
25460,ElliotBayTrailMyrtlePark,11/26/2016 08:00:00 PM,48,-122,0,1,1
25461,ElliotBayTrailMyrtlePark,11/26/2016 09:00:00 PM,48,-122,0,2,2
25462,ElliotBayTrailMyrtlePark,11/26/2016 10:00:00 PM,48,-122,1,0,1
25463,ElliotBayTrailMyrtlePark,11/26/2016 11:00:00 PM,48,-122,0,0,0
25464,ElliotBayTrailMyrtlePark,11/27/2016 12:00:00 AM,48,-122,0,0,0
25465,ElliotBayTrailMyrtlePark,11/27/2016 01:00:00 AM,48,-122,0,0,0
25466,ElliotBayTrailMyrtlePark,11/27/2016 02:00:00 AM,48,-122,0,0,0
25467,ElliotBayTrailMyrtlePark,11/27/2016 03:00:00 AM,48,-122,1,1,2
25468,ElliotBayTrailMyrtlePark,11/27/2016 04:00:00 AM,48,-122,0,0,0
25469,ElliotBayTrailMyrtlePark,11/27/2016 05:00:00 AM,48,-122,1,0,1
25470,ElliotBayTrailMyrtlePark,11/27/2016 06:00:00 AM,48,-122,0,1,1
25471,ElliotBayTrailMyrtlePark,11/27/2016 07:00:00 AM,48,-122,10,5,15
25472,ElliotBayTrailMyrtlePark,11/27/2016 08:00:00 AM,48,-122,5,11,16
25473,ElliotBayTrailMyrtlePark,11/27/2016 09:00:00 AM,48,-122,16,14,30
25474,ElliotBayTrailMyrtlePark,11/27/2016 10:00:00 AM,48,-122,12,11,23
25475,ElliotBayTrailMyrtlePark,11/27/2016 11:00:00 AM,48,-122,28,9,37
25476,ElliotBayTrailMyrtlePark,11/27/2016 12:00:00 PM,48,-122,8,7,15
25477,ElliotBayTrailMyrtlePark,11/27/2016 01:00:00 PM,48,-122,7,3,10
25478,ElliotBayTrailMyrtlePark,11/27/2016 02:00:00 PM,48,-122,4,5,9
25479,ElliotBayTrailMyrtlePark,11/27/2016 03:00:00 PM,48,-122,4,4,8
25480,ElliotBayTrailMyrtlePark,11/27/2016 04:00:00 PM,48,-122,1,2,3
25481,ElliotBayTrailMyrtlePark,11/27/2016 05:00:00 PM,48,-122,0,0,0
25482,ElliotBayTrailMyrtlePark,11/27/2016 06:00:00 PM,48,-122,2,2,4
25483,ElliotBayTrailMyrtlePark,11/27/2016 07:00:00 PM,48,-122,1,0,1
25484,ElliotBayTrailMyrtlePark,11/27/2016 08:00:00 PM,48,-122,2,1,3
25485,ElliotBayTrailMyrtlePark,11/27/2016 09:00:00 PM,48,-122,0,0,0
25486,ElliotBayTrailMyrtlePark,11/27/2016 10:00:00 PM,48,-122,0,1,1
25487,ElliotBayTrailMyrtlePark,11/27/2016 11:00:00 PM,48,-122,1,0,1
25488,ElliotBayTrailMyrtlePark,11/28/2016 12:00:00 AM,48,-122,0,0,0
25489,ElliotBayTrailMyrtlePark,11/28/2016 01:00:00 AM,48,-122,0,0,0
25490,ElliotBayTrailMyrtlePark,11/28/2016 02:00:00 AM,48,-122,0,0,0
25491,ElliotBayTrailMyrtlePark,11/28/2016 03:00:00 AM,48,-122,0,1,1
25492,ElliotBayTrailMyrtlePark,11/28/2016 04:00:00 AM,48,-122,3,1,4
25493,ElliotBayTrailMyrtlePark,11/28/2016 05:00:00 AM,48,-122,9,15,24
25494,ElliotBayTrailMyrtlePark,11/28/2016 06:00:00 AM,48,-122,17,27,44
25495,ElliotBayTrailMyrtlePark,11/28/2016 07:00:00 AM,48,-122,32,94,126
25496,ElliotBayTrailMyrtlePark,11/28/2016 08:00:00 AM,48,-122,28,95,123
25497,ElliotBayTrailMyrtlePark,11/28/2016 09:00:00 AM,48,-122,12,23,35
25498,ElliotBayTrailMyrtlePark,11/28/2016 10:00:00 AM,48,-122,9,5,14
25499,ElliotBayTrailMyrtlePark,11/28/2016 11:00:00 AM,48,-122,9,15,24
25500,ElliotBayTrailMyrtlePark,11/28/2016 12:00:00 PM,48,-122,8,6,14
25501,ElliotBayTrailMyrtlePark,11/28/2016 01:00:00 PM,48,-122,12,14,26
25502,ElliotBayTrailMyrtlePark,11/28/2016 02:00:00 PM,48,-122,22,24,46
25503,ElliotBayTrailMyrtlePark,11/28/2016 03:00:00 PM,48,-122,48,24,72
25504,ElliotBayTrailMyrtlePark,11/28/2016 04:00:00 PM,48,-122,85,38,123
25505,ElliotBayTrailMyrtlePark,11/28/2016 05:00:00 PM,48,-122,123,21,144
25506,ElliotBayTrailMyrtlePark,11/28/2016 06:00:00 PM,48,-122,42,5,47
25507,ElliotBayTrailMyrtlePark,11/28/2016 07:00:00 PM,48,-122,7,4,11
25508,ElliotBayTrailMyrtlePark,11/28/2016 08:00:00 PM,48,-122,2,1,3
25509,ElliotBayTrailMyrtlePark,11/28/2016 09:00:00 PM,48,-122,4,2,6
25510,ElliotBayTrailMyrtlePark,11/28/2016 10:00:00 PM,48,-122,2,1,3
25511,ElliotBayTrailMyrtlePark,11/28/2016 11:00:00 PM,48,-122,2,2,4
25512,ElliotBayTrailMyrtlePark,11/29/2016 12:00:00 AM,48,-122,1,0,1
25513,ElliotBayTrailMyrtlePark,11/29/2016 01:00:00 AM,48,-122,0,0,0
25514,ElliotBayTrailMyrtlePark,11/29/2016 02:00:00 AM,48,-122,1,1,2
25515,ElliotBayTrailMyrtlePark,11/29/2016 03:00:00 AM,48,-122,0,2,2
25516,ElliotBayTrailMyrtlePark,11/29/2016 04:00:00 AM,48,-122,2,1,3
25517,ElliotBayTrailMyrtlePark,11/29/2016 05:00:00 AM,48,-122,12,18,30
25518,ElliotBayTrailMyrtlePark,11/29/2016 06:00:00 AM,48,-122,21,35,56
25519,ElliotBayTrailMyrtlePark,11/29/2016 07:00:00 AM,48,-122,35,104,139
25520,ElliotBayTrailMyrtlePark,11/29/2016 08:00:00 AM,48,-122,33,96,129
25521,ElliotBayTrailMyrtlePark,11/29/2016 09:00:00 AM,48,-122,24,21,45
25522,ElliotBayTrailMyrtlePark,11/29/2016 10:00:00 AM,48,-122,7,29,36
25523,ElliotBayTrailMyrtlePark,11/29/2016 11:00:00 AM,48,-122,12,13,25
25524,ElliotBayTrailMyrtlePark,11/29/2016 12:00:00 PM,48,-122,19,10,29
25525,ElliotBayTrailMyrtlePark,11/29/2016 01:00:00 PM,48,-122,14,12,26
25526,ElliotBayTrailMyrtlePark,11/29/2016 02:00:00 PM,48,-122,16,31,47
25527,ElliotBayTrailMyrtlePark,11/29/2016 03:00:00 PM,48,-122,40,34,74
25528,ElliotBayTrailMyrtlePark,11/29/2016 04:00:00 PM,48,-122,109,27,136
25529,ElliotBayTrailMyrtlePark,11/29/2016 05:00:00 PM,48,-122,155,28,183
25530,ElliotBayTrailMyrtlePark,11/29/2016 06:00:00 PM,48,-122,36,18,54
25531,ElliotBayTrailMyrtlePark,11/29/2016 07:00:00 PM,48,-122,15,3,18
25532,ElliotBayTrailMyrtlePark,11/29/2016 08:00:00 PM,48,-122,2,2,4
25533,ElliotBayTrailMyrtlePark,11/29/2016 09:00:00 PM,48,-122,1,4,5
25534,ElliotBayTrailMyrtlePark,11/29/2016 10:00:00 PM,48,-122,1,1,2
25535,ElliotBayTrailMyrtlePark,11/29/2016 11:00:00 PM,48,-122,3,1,4
25536,ElliotBayTrailMyrtlePark,11/30/2016 12:00:00 AM,48,-122,0,0,0
25537,ElliotBayTrailMyrtlePark,11/30/2016 01:00:00 AM,48,-122,0,0,0
25538,ElliotBayTrailMyrtlePark,11/30/2016 02:00:00 AM,48,-122,1,0,1
25539,ElliotBayTrailMyrtlePark,11/30/2016 03:00:00 AM,48,-122,0,1,1
25540,ElliotBayTrailMyrtlePark,11/30/2016 04:00:00 AM,48,-122,3,3,6
25541,ElliotBayTrailMyrtlePark,11/30/2016 05:00:00 AM,48,-122,8,13,21
25542,ElliotBayTrailMyrtlePark,11/30/2016 06:00:00 AM,48,-122,18,31,49
25543,ElliotBayTrailMyrtlePark,11/30/2016 07:00:00 AM,48,-122,29,81,110
25544,ElliotBayTrailMyrtlePark,11/30/2016 08:00:00 AM,48,-122,25,92,117
25545,ElliotBayTrailMyrtlePark,11/30/2016 09:00:00 AM,48,-122,8,19,27
25546,ElliotBayTrailMyrtlePark,11/30/2016 10:00:00 AM,48,-122,8,7,15
25547,ElliotBayTrailMyrtlePark,11/30/2016 11:00:00 AM,48,-122,8,3,11
25548,ElliotBayTrailMyrtlePark,11/30/2016 12:00:00 PM,48,-122,6,6,12
25549,ElliotBayTrailMyrtlePark,11/30/2016 01:00:00 PM,48,-122,12,5,17
25550,ElliotBayTrailMyrtlePark,11/30/2016 02:00:00 PM,48,-122,12,12,24
25551,ElliotBayTrailMyrtlePark,11/30/2016 03:00:00 PM,48,-122,29,20,49
25552,ElliotBayTrailMyrtlePark,11/30/2016 04:00:00 PM,48,-122,91,32,123
25553,ElliotBayTrailMyrtlePark,11/30/2016 05:00:00 PM,48,-122,95,20,115
25554,ElliotBayTrailMyrtlePark,11/30/2016 06:00:00 PM,48,-122,36,6,42
25555,ElliotBayTrailMyrtlePark,11/30/2016 07:00:00 PM,48,-122,12,2,14
25556,ElliotBayTrailMyrtlePark,11/30/2016 08:00:00 PM,48,-122,7,1,8
25557,ElliotBayTrailMyrtlePark,11/30/2016 09:00:00 PM,48,-122,2,1,3
25558,ElliotBayTrailMyrtlePark,11/30/2016 10:00:00 PM,48,-122,0,2,2
25559,ElliotBayTrailMyrtlePark,11/30/2016 11:00:00 PM,48,-122,4,1,5
25560,ElliotBayTrailMyrtlePark,12/01/2016 12:00:00 AM,48,-122,0,0,0
25561,ElliotBayTrailMyrtlePark,12/01/2016 01:00:00 AM,48,-122,1,0,1
25562,ElliotBayTrailMyrtlePark,12/01/2016 02:00:00 AM,48,-122,0,1,1
25563,ElliotBayTrailMyrtlePark,12/01/2016 03:00:00 AM,48,-122,0,2,2
25564,ElliotBayTrailMyrtlePark,12/01/2016 04:00:00 AM,48,-122,3,2,5
25565,ElliotBayTrailMyrtlePark,12/01/2016 05:00:00 AM,48,-122,10,14,24
25566,ElliotBayTrailMyrtlePark,12/01/2016 06:00:00 AM,48,-122,21,35,56
25567,ElliotBayTrailMyrtlePark,12/01/2016 07:00:00 AM,48,-122,27,92,119
25568,ElliotBayTrailMyrtlePark,12/01/2016 08:00:00 AM,48,-122,42,92,134
25569,ElliotBayTrailMyrtlePark,12/01/2016 09:00:00 AM,48,-122,17,42,59
25570,ElliotBayTrailMyrtlePark,12/01/2016 10:00:00 AM,48,-122,14,12,26
25571,ElliotBayTrailMyrtlePark,12/01/2016 11:00:00 AM,48,-122,13,13,26
25572,ElliotBayTrailMyrtlePark,12/01/2016 12:00:00 PM,48,-122,11,18,29
25573,ElliotBayTrailMyrtlePark,12/01/2016 01:00:00 PM,48,-122,14,6,20
25574,ElliotBayTrailMyrtlePark,12/01/2016 02:00:00 PM,48,-122,20,14,34
25575,ElliotBayTrailMyrtlePark,12/01/2016 03:00:00 PM,48,-122,29,28,57
25576,ElliotBayTrailMyrtlePark,12/01/2016 04:00:00 PM,48,-122,83,42,125
25577,ElliotBayTrailMyrtlePark,12/01/2016 05:00:00 PM,48,-122,97,21,118
25578,ElliotBayTrailMyrtlePark,12/01/2016 06:00:00 PM,48,-122,37,7,44
25579,ElliotBayTrailMyrtlePark,12/01/2016 07:00:00 PM,48,-122,18,2,20
25580,ElliotBayTrailMyrtlePark,12/01/2016 08:00:00 PM,48,-122,1,6,7
25581,ElliotBayTrailMyrtlePark,12/01/2016 09:00:00 PM,48,-122,2,3,5
25582,ElliotBayTrailMyrtlePark,12/01/2016 10:00:00 PM,48,-122,1,0,1
25583,ElliotBayTrailMyrtlePark,12/01/2016 11:00:00 PM,48,-122,1,0,1
25584,ElliotBayTrailMyrtlePark,12/02/2016 12:00:00 AM,48,-122,0,0,0
25585,ElliotBayTrailMyrtlePark,12/02/2016 01:00:00 AM,48,-122,0,0,0
25586,ElliotBayTrailMyrtlePark,12/02/2016 02:00:00 AM,48,-122,1,0,1
25587,ElliotBayTrailMyrtlePark,12/02/2016 03:00:00 AM,48,-122,0,0,0
25588,ElliotBayTrailMyrtlePark,12/02/2016 04:00:00 AM,48,-122,2,1,3
25589,ElliotBayTrailMyrtlePark,12/02/2016 05:00:00 AM,48,-122,6,10,16
25590,ElliotBayTrailMyrtlePark,12/02/2016 06:00:00 AM,48,-122,13,16,29
25591,ElliotBayTrailMyrtlePark,12/02/2016 07:00:00 AM,48,-122,17,63,80
25592,ElliotBayTrailMyrtlePark,12/02/2016 08:00:00 AM,48,-122,26,53,79
25593,ElliotBayTrailMyrtlePark,12/02/2016 09:00:00 AM,48,-122,11,13,24
25594,ElliotBayTrailMyrtlePark,12/02/2016 10:00:00 AM,48,-122,4,9,13
25595,ElliotBayTrailMyrtlePark,12/02/2016 11:00:00 AM,48,-122,4,6,10
25596,ElliotBayTrailMyrtlePark,12/02/2016 12:00:00 PM,48,-122,7,2,9
25597,ElliotBayTrailMyrtlePark,12/02/2016 01:00:00 PM,48,-122,6,10,16
25598,ElliotBayTrailMyrtlePark,12/02/2016 02:00:00 PM,48,-122,14,9,23
25599,ElliotBayTrailMyrtlePark,12/02/2016 03:00:00 PM,48,-122,20,25,45
25600,ElliotBayTrailMyrtlePark,12/02/2016 04:00:00 PM,48,-122,52,18,70
25601,ElliotBayTrailMyrtlePark,12/02/2016 05:00:00 PM,48,-122,50,14,64
25602,ElliotBayTrailMyrtlePark,12/02/2016 06:00:00 PM,48,-122,19,7,26
25603,ElliotBayTrailMyrtlePark,12/02/2016 07:00:00 PM,48,-122,5,2,7
25604,ElliotBayTrailMyrtlePark,12/02/2016 08:00:00 PM,48,-122,5,2,7
25605,ElliotBayTrailMyrtlePark,12/02/2016 09:00:00 PM,48,-122,4,3,7
25606,ElliotBayTrailMyrtlePark,12/02/2016 10:00:00 PM,48,-122,1,0,1
25607,ElliotBayTrailMyrtlePark,12/02/2016 11:00:00 PM,48,-122,0,0,0
25608,ElliotBayTrailMyrtlePark,12/03/2016 12:00:00 AM,48,-122,2,0,2
25609,ElliotBayTrailMyrtlePark,12/03/2016 01:00:00 AM,48,-122,0,0,0
25610,ElliotBayTrailMyrtlePark,12/03/2016 02:00:00 AM,48,-122,1,0,1
25611,ElliotBayTrailMyrtlePark,12/03/2016 03:00:00 AM,48,-122,0,0,0
25612,ElliotBayTrailMyrtlePark,12/03/2016 04:00:00 AM,48,-122,0,0,0
25613,ElliotBayTrailMyrtlePark,12/03/2016 05:00:00 AM,48,-122,2,1,3
25614,ElliotBayTrailMyrtlePark,12/03/2016 06:00:00 AM,48,-122,2,3,5
25615,ElliotBayTrailMyrtlePark,12/03/2016 07:00:00 AM,48,-122,7,10,17
25616,ElliotBayTrailMyrtlePark,12/03/2016 08:00:00 AM,48,-122,3,9,12
25617,ElliotBayTrailMyrtlePark,12/03/2016 09:00:00 AM,48,-122,8,18,26
25618,ElliotBayTrailMyrtlePark,12/03/2016 10:00:00 AM,48,-122,18,16,34
25619,ElliotBayTrailMyrtlePark,12/03/2016 11:00:00 AM,48,-122,24,18,42
25620,ElliotBayTrailMyrtlePark,12/03/2016 12:00:00 PM,48,-122,18,14,32
25621,ElliotBayTrailMyrtlePark,12/03/2016 01:00:00 PM,48,-122,11,20,31
25622,ElliotBayTrailMyrtlePark,12/03/2016 02:00:00 PM,48,-122,17,19,36
25623,ElliotBayTrailMyrtlePark,12/03/2016 03:00:00 PM,48,-122,19,12,31
25624,ElliotBayTrailMyrtlePark,12/03/2016 04:00:00 PM,48,-122,5,7,12
25625,ElliotBayTrailMyrtlePark,12/03/2016 05:00:00 PM,48,-122,6,2,8
25626,ElliotBayTrailMyrtlePark,12/03/2016 06:00:00 PM,48,-122,3,0,3
25627,ElliotBayTrailMyrtlePark,12/03/2016 07:00:00 PM,48,-122,2,2,4
25628,ElliotBayTrailMyrtlePark,12/03/2016 08:00:00 PM,48,-122,3,1,4
25629,ElliotBayTrailMyrtlePark,12/03/2016 09:00:00 PM,48,-122,0,2,2
25630,ElliotBayTrailMyrtlePark,12/03/2016 10:00:00 PM,48,-122,1,1,2
25631,ElliotBayTrailMyrtlePark,12/03/2016 11:00:00 PM,48,-122,0,0,0
25632,ElliotBayTrailMyrtlePark,12/04/2016 12:00:00 AM,48,-122,0,0,0
25633,ElliotBayTrailMyrtlePark,12/04/2016 01:00:00 AM,48,-122,0,0,0
25634,ElliotBayTrailMyrtlePark,12/04/2016 02:00:00 AM,48,-122,0,0,0
25635,ElliotBayTrailMyrtlePark,12/04/2016 03:00:00 AM,48,-122,0,0,0
25636,ElliotBayTrailMyrtlePark,12/04/2016 04:00:00 AM,48,-122,0,0,0
25637,ElliotBayTrailMyrtlePark,12/04/2016 05:00:00 AM,48,-122,0,2,2
25638,ElliotBayTrailMyrtlePark,12/04/2016 06:00:00 AM,48,-122,0,0,0
25639,ElliotBayTrailMyrtlePark,12/04/2016 07:00:00 AM,48,-122,4,0,4
25640,ElliotBayTrailMyrtlePark,12/04/2016 08:00:00 AM,48,-122,4,4,8
25641,ElliotBayTrailMyrtlePark,12/04/2016 09:00:00 AM,48,-122,6,8,14
25642,ElliotBayTrailMyrtlePark,12/04/2016 10:00:00 AM,48,-122,19,18,37
25643,ElliotBayTrailMyrtlePark,12/04/2016 11:00:00 AM,48,-122,23,25,48
25644,ElliotBayTrailMyrtlePark,12/04/2016 12:00:00 PM,48,-122,33,29,62
25645,ElliotBayTrailMyrtlePark,12/04/2016 01:00:00 PM,48,-122,30,27,57
25646,ElliotBayTrailMyrtlePark,12/04/2016 02:00:00 PM,48,-122,39,40,79
25647,ElliotBayTrailMyrtlePark,12/04/2016 03:00:00 PM,48,-122,28,25,53
25648,ElliotBayTrailMyrtlePark,12/04/2016 04:00:00 PM,48,-122,13,23,36
25649,ElliotBayTrailMyrtlePark,12/04/2016 05:00:00 PM,48,-122,4,0,4
25650,ElliotBayTrailMyrtlePark,12/04/2016 06:00:00 PM,48,-122,1,0,1
25651,ElliotBayTrailMyrtlePark,12/04/2016 07:00:00 PM,48,-122,4,8,12
25652,ElliotBayTrailMyrtlePark,12/04/2016 08:00:00 PM,48,-122,4,1,5
25653,ElliotBayTrailMyrtlePark,12/04/2016 09:00:00 PM,48,-122,5,0,5
25654,ElliotBayTrailMyrtlePark,12/04/2016 10:00:00 PM,48,-122,2,0,2
25655,ElliotBayTrailMyrtlePark,12/04/2016 11:00:00 PM,48,-122,1,1,2
25656,ElliotBayTrailMyrtlePark,12/05/2016 12:00:00 AM,48,-122,0,0,0
25657,ElliotBayTrailMyrtlePark,12/05/2016 01:00:00 AM,48,-122,0,0,0
25658,ElliotBayTrailMyrtlePark,12/05/2016 02:00:00 AM,48,-122,1,0,1
25659,ElliotBayTrailMyrtlePark,12/05/2016 03:00:00 AM,48,-122,0,3,3
25660,ElliotBayTrailMyrtlePark,12/05/2016 04:00:00 AM,48,-122,2,2,4
25661,ElliotBayTrailMyrtlePark,12/05/2016 05:00:00 AM,48,-122,6,12,18
25662,ElliotBayTrailMyrtlePark,12/05/2016 06:00:00 AM,48,-122,13,16,29
25663,ElliotBayTrailMyrtlePark,12/05/2016 07:00:00 AM,48,-122,19,56,75
25664,ElliotBayTrailMyrtlePark,12/05/2016 08:00:00 AM,48,-122,11,61,72
25665,ElliotBayTrailMyrtlePark,12/05/2016 09:00:00 AM,48,-122,9,12,21
25666,ElliotBayTrailMyrtlePark,12/05/2016 10:00:00 AM,48,-122,6,5,11
25667,ElliotBayTrailMyrtlePark,12/05/2016 11:00:00 AM,48,-122,2,2,4
25668,ElliotBayTrailMyrtlePark,12/05/2016 12:00:00 PM,48,-122,5,0,5
25669,ElliotBayTrailMyrtlePark,12/05/2016 01:00:00 PM,48,-122,7,4,11
25670,ElliotBayTrailMyrtlePark,12/05/2016 02:00:00 PM,48,-122,10,11,21
25671,ElliotBayTrailMyrtlePark,12/05/2016 03:00:00 PM,48,-122,23,10,33
25672,ElliotBayTrailMyrtlePark,12/05/2016 04:00:00 PM,48,-122,65,22,87
25673,ElliotBayTrailMyrtlePark,12/05/2016 05:00:00 PM,48,-122,60,7,67
25674,ElliotBayTrailMyrtlePark,12/05/2016 06:00:00 PM,48,-122,28,3,31
25675,ElliotBayTrailMyrtlePark,12/05/2016 07:00:00 PM,48,-122,3,0,3
25676,ElliotBayTrailMyrtlePark,12/05/2016 08:00:00 PM,48,-122,1,2,3
25677,ElliotBayTrailMyrtlePark,12/05/2016 09:00:00 PM,48,-122,0,1,1
25678,ElliotBayTrailMyrtlePark,12/05/2016 10:00:00 PM,48,-122,1,0,1
25679,ElliotBayTrailMyrtlePark,12/05/2016 11:00:00 PM,48,-122,0,1,1
25680,ElliotBayTrailMyrtlePark,12/06/2016 12:00:00 AM,48,-122,0,0,0
25681,ElliotBayTrailMyrtlePark,12/06/2016 01:00:00 AM,48,-122,0,0,0
25682,ElliotBayTrailMyrtlePark,12/06/2016 02:00:00 AM,48,-122,2,0,2
25683,ElliotBayTrailMyrtlePark,12/06/2016 03:00:00 AM,48,-122,0,1,1
25684,ElliotBayTrailMyrtlePark,12/06/2016 04:00:00 AM,48,-122,1,1,2
25685,ElliotBayTrailMyrtlePark,12/06/2016 05:00:00 AM,48,-122,7,17,24
25686,ElliotBayTrailMyrtlePark,12/06/2016 06:00:00 AM,48,-122,10,9,19
25687,ElliotBayTrailMyrtlePark,12/06/2016 07:00:00 AM,48,-122,18,55,73
25688,ElliotBayTrailMyrtlePark,12/06/2016 08:00:00 AM,48,-122,19,74,93
25689,ElliotBayTrailMyrtlePark,12/06/2016 09:00:00 AM,48,-122,12,28,40
25690,ElliotBayTrailMyrtlePark,12/06/2016 10:00:00 AM,48,-122,2,4,6
25691,ElliotBayTrailMyrtlePark,12/06/2016 11:00:00 AM,48,-122,7,6,13
25692,ElliotBayTrailMyrtlePark,12/06/2016 12:00:00 PM,48,-122,15,14,29
25693,ElliotBayTrailMyrtlePark,12/06/2016 01:00:00 PM,48,-122,10,16,26
25694,ElliotBayTrailMyrtlePark,12/06/2016 02:00:00 PM,48,-122,12,22,34
25695,ElliotBayTrailMyrtlePark,12/06/2016 03:00:00 PM,48,-122,31,20,51
25696,ElliotBayTrailMyrtlePark,12/06/2016 04:00:00 PM,48,-122,51,25,76
25697,ElliotBayTrailMyrtlePark,12/06/2016 05:00:00 PM,48,-122,83,9,92
25698,ElliotBayTrailMyrtlePark,12/06/2016 06:00:00 PM,48,-122,29,5,34
25699,ElliotBayTrailMyrtlePark,12/06/2016 07:00:00 PM,48,-122,3,1,4
25700,ElliotBayTrailMyrtlePark,12/06/2016 08:00:00 PM,48,-122,2,3,5
25701,ElliotBayTrailMyrtlePark,12/06/2016 09:00:00 PM,48,-122,0,5,5
25702,ElliotBayTrailMyrtlePark,12/06/2016 10:00:00 PM,48,-122,3,1,4
25703,ElliotBayTrailMyrtlePark,12/06/2016 11:00:00 PM,48,-122,0,0,0
25704,ElliotBayTrailMyrtlePark,12/07/2016 12:00:00 AM,48,-122,2,0,2
25705,ElliotBayTrailMyrtlePark,12/07/2016 01:00:00 AM,48,-122,0,0,0
25706,ElliotBayTrailMyrtlePark,12/07/2016 02:00:00 AM,48,-122,0,0,0
25707,ElliotBayTrailMyrtlePark,12/07/2016 03:00:00 AM,48,-122,1,2,3
25708,ElliotBayTrailMyrtlePark,12/07/2016 04:00:00 AM,48,-122,1,2,3
25709,ElliotBayTrailMyrtlePark,12/07/2016 05:00:00 AM,48,-122,9,16,25
25710,ElliotBayTrailMyrtlePark,12/07/2016 06:00:00 AM,48,-122,10,19,29
25711,ElliotBayTrailMyrtlePark,12/07/2016 07:00:00 AM,48,-122,15,64,79
25712,ElliotBayTrailMyrtlePark,12/07/2016 08:00:00 AM,48,-122,17,66,83
25713,ElliotBayTrailMyrtlePark,12/07/2016 09:00:00 AM,48,-122,11,29,40
25714,ElliotBayTrailMyrtlePark,12/07/2016 10:00:00 AM,48,-122,10,9,19
25715,ElliotBayTrailMyrtlePark,12/07/2016 11:00:00 AM,48,-122,7,10,17
25716,ElliotBayTrailMyrtlePark,12/07/2016 12:00:00 PM,48,-122,15,10,25
25717,ElliotBayTrailMyrtlePark,12/07/2016 01:00:00 PM,48,-122,11,16,27
25718,ElliotBayTrailMyrtlePark,12/07/2016 02:00:00 PM,48,-122,11,13,24
25719,ElliotBayTrailMyrtlePark,12/07/2016 03:00:00 PM,48,-122,30,19,49
25720,ElliotBayTrailMyrtlePark,12/07/2016 04:00:00 PM,48,-122,66,29,95
25721,ElliotBayTrailMyrtlePark,12/07/2016 05:00:00 PM,48,-122,71,9,80
25722,ElliotBayTrailMyrtlePark,12/07/2016 06:00:00 PM,48,-122,37,6,43
25723,ElliotBayTrailMyrtlePark,12/07/2016 07:00:00 PM,48,-122,7,1,8
25724,ElliotBayTrailMyrtlePark,12/07/2016 08:00:00 PM,48,-122,4,0,4
25725,ElliotBayTrailMyrtlePark,12/07/2016 09:00:00 PM,48,-122,2,2,4
25726,ElliotBayTrailMyrtlePark,12/07/2016 10:00:00 PM,48,-122,3,1,4
25727,ElliotBayTrailMyrtlePark,12/07/2016 11:00:00 PM,48,-122,0,0,0
25728,ElliotBayTrailMyrtlePark,12/08/2016 12:00:00 AM,48,-122,0,0,0
25729,ElliotBayTrailMyrtlePark,12/08/2016 01:00:00 AM,48,-122,0,0,0
25730,ElliotBayTrailMyrtlePark,12/08/2016 02:00:00 AM,48,-122,0,0,0
25731,ElliotBayTrailMyrtlePark,12/08/2016 03:00:00 AM,48,-122,1,1,2
25732,ElliotBayTrailMyrtlePark,12/08/2016 04:00:00 AM,48,-122,1,3,4
25733,ElliotBayTrailMyrtlePark,12/08/2016 05:00:00 AM,48,-122,5,12,17
25734,ElliotBayTrailMyrtlePark,12/08/2016 06:00:00 AM,48,-122,11,16,27
25735,ElliotBayTrailMyrtlePark,12/08/2016 07:00:00 AM,48,-122,12,46,58
25736,ElliotBayTrailMyrtlePark,12/08/2016 08:00:00 AM,48,-122,16,52,68
25737,ElliotBayTrailMyrtlePark,12/08/2016 09:00:00 AM,48,-122,12,22,34
25738,ElliotBayTrailMyrtlePark,12/08/2016 10:00:00 AM,48,-122,6,7,13
25739,ElliotBayTrailMyrtlePark,12/08/2016 11:00:00 AM,48,-122,6,7,13
25740,ElliotBayTrailMyrtlePark,12/08/2016 12:00:00 PM,48,-122,8,2,10
25741,ElliotBayTrailMyrtlePark,12/08/2016 01:00:00 PM,48,-122,9,15,24
25742,ElliotBayTrailMyrtlePark,12/08/2016 02:00:00 PM,48,-122,11,9,20
25743,ElliotBayTrailMyrtlePark,12/08/2016 03:00:00 PM,48,-122,26,18,44
25744,ElliotBayTrailMyrtlePark,12/08/2016 04:00:00 PM,48,-122,57,19,76
25745,ElliotBayTrailMyrtlePark,12/08/2016 05:00:00 PM,48,-122,62,6,68
25746,ElliotBayTrailMyrtlePark,12/08/2016 06:00:00 PM,48,-122,22,3,25
25747,ElliotBayTrailMyrtlePark,12/08/2016 07:00:00 PM,48,-122,4,0,4
25748,ElliotBayTrailMyrtlePark,12/08/2016 08:00:00 PM,48,-122,0,1,1
25749,ElliotBayTrailMyrtlePark,12/08/2016 09:00:00 PM,48,-122,1,0,1
25750,ElliotBayTrailMyrtlePark,12/08/2016 10:00:00 PM,48,-122,1,0,1
25751,ElliotBayTrailMyrtlePark,12/08/2016 11:00:00 PM,48,-122,1,1,2
25752,ElliotBayTrailMyrtlePark,12/09/2016 12:00:00 AM,48,-122,0,0,0
25753,ElliotBayTrailMyrtlePark,12/09/2016 01:00:00 AM,48,-122,0,0,0
25754,ElliotBayTrailMyrtlePark,12/09/2016 02:00:00 AM,48,-122,0,0,0
25755,ElliotBayTrailMyrtlePark,12/09/2016 03:00:00 AM,48,-122,1,1,2
25756,ElliotBayTrailMyrtlePark,12/09/2016 04:00:00 AM,48,-122,0,1,1
25757,ElliotBayTrailMyrtlePark,12/09/2016 05:00:00 AM,48,-122,1,1,2
25758,ElliotBayTrailMyrtlePark,12/09/2016 06:00:00 AM,48,-122,3,0,3
25759,ElliotBayTrailMyrtlePark,12/09/2016 07:00:00 AM,48,-122,4,11,15
25760,ElliotBayTrailMyrtlePark,12/09/2016 08:00:00 AM,48,-122,2,15,17
25761,ElliotBayTrailMyrtlePark,12/09/2016 09:00:00 AM,48,-122,2,9,11
25762,ElliotBayTrailMyrtlePark,12/09/2016 10:00:00 AM,48,-122,1,5,6
25763,ElliotBayTrailMyrtlePark,12/09/2016 11:00:00 AM,48,-122,3,0,3
25764,ElliotBayTrailMyrtlePark,12/09/2016 12:00:00 PM,48,-122,2,2,4
25765,ElliotBayTrailMyrtlePark,12/09/2016 01:00:00 PM,48,-122,3,6,9
25766,ElliotBayTrailMyrtlePark,12/09/2016 02:00:00 PM,48,-122,5,2,7
25767,ElliotBayTrailMyrtlePark,12/09/2016 03:00:00 PM,48,-122,6,7,13
25768,ElliotBayTrailMyrtlePark,12/09/2016 04:00:00 PM,48,-122,10,12,22
25769,ElliotBayTrailMyrtlePark,12/09/2016 05:00:00 PM,48,-122,23,3,26
25770,ElliotBayTrailMyrtlePark,12/09/2016 06:00:00 PM,48,-122,5,1,6
25771,ElliotBayTrailMyrtlePark,12/09/2016 07:00:00 PM,48,-122,3,0,3
25772,ElliotBayTrailMyrtlePark,12/09/2016 08:00:00 PM,48,-122,0,2,2
25773,ElliotBayTrailMyrtlePark,12/09/2016 09:00:00 PM,48,-122,1,0,1
25774,ElliotBayTrailMyrtlePark,12/09/2016 10:00:00 PM,48,-122,0,1,1
25775,ElliotBayTrailMyrtlePark,12/09/2016 11:00:00 PM,48,-122,0,0,0
25776,ElliotBayTrailMyrtlePark,12/10/2016 12:00:00 AM,48,-122,1,0,1
25777,ElliotBayTrailMyrtlePark,12/10/2016 01:00:00 AM,48,-122,0,0,0
25778,ElliotBayTrailMyrtlePark,12/10/2016 02:00:00 AM,48,-122,1,0,1
25779,ElliotBayTrailMyrtlePark,12/10/2016 03:00:00 AM,48,-122,0,0,0
25780,ElliotBayTrailMyrtlePark,12/10/2016 04:00:00 AM,48,-122,0,0,0
25781,ElliotBayTrailMyrtlePark,12/10/2016 05:00:00 AM,48,-122,1,2,3
25782,ElliotBayTrailMyrtlePark,12/10/2016 06:00:00 AM,48,-122,0,0,0
25783,ElliotBayTrailMyrtlePark,12/10/2016 07:00:00 AM,48,-122,4,1,5
25784,ElliotBayTrailMyrtlePark,12/10/2016 08:00:00 AM,48,-122,8,9,17
25785,ElliotBayTrailMyrtlePark,12/10/2016 09:00:00 AM,48,-122,7,3,10
25786,ElliotBayTrailMyrtlePark,12/10/2016 10:00:00 AM,48,-122,17,10,27
25787,ElliotBayTrailMyrtlePark,12/10/2016 11:00:00 AM,48,-122,2,14,16
25788,ElliotBayTrailMyrtlePark,12/10/2016 12:00:00 PM,48,-122,2,4,6
25789,ElliotBayTrailMyrtlePark,12/10/2016 01:00:00 PM,48,-122,1,2,3
25790,ElliotBayTrailMyrtlePark,12/10/2016 02:00:00 PM,48,-122,9,5,14
25791,ElliotBayTrailMyrtlePark,12/10/2016 03:00:00 PM,48,-122,2,3,5
25792,ElliotBayTrailMyrtlePark,12/10/2016 04:00:00 PM,48,-122,2,4,6
25793,ElliotBayTrailMyrtlePark,12/10/2016 05:00:00 PM,48,-122,1,1,2
25794,ElliotBayTrailMyrtlePark,12/10/2016 06:00:00 PM,48,-122,2,12,14
25795,ElliotBayTrailMyrtlePark,12/10/2016 07:00:00 PM,48,-122,2,3,5
25796,ElliotBayTrailMyrtlePark,12/10/2016 08:00:00 PM,48,-122,0,1,1
25797,ElliotBayTrailMyrtlePark,12/10/2016 09:00:00 PM,48,-122,12,2,14
25798,ElliotBayTrailMyrtlePark,12/10/2016 10:00:00 PM,48,-122,0,0,0
25799,ElliotBayTrailMyrtlePark,12/10/2016 11:00:00 PM,48,-122,1,0,1
25800,ElliotBayTrailMyrtlePark,12/11/2016 12:00:00 AM,48,-122,1,0,1
25801,ElliotBayTrailMyrtlePark,12/11/2016 01:00:00 AM,48,-122,0,0,0
25802,ElliotBayTrailMyrtlePark,12/11/2016 02:00:00 AM,48,-122,1,0,1
25803,ElliotBayTrailMyrtlePark,12/11/2016 03:00:00 AM,48,-122,1,0,1
25804,ElliotBayTrailMyrtlePark,12/11/2016 04:00:00 AM,48,-122,0,0,0
25805,ElliotBayTrailMyrtlePark,12/11/2016 05:00:00 AM,48,-122,0,0,0
25806,ElliotBayTrailMyrtlePark,12/11/2016 06:00:00 AM,48,-122,1,0,1
25807,ElliotBayTrailMyrtlePark,12/11/2016 07:00:00 AM,48,-122,2,0,2
25808,ElliotBayTrailMyrtlePark,12/11/2016 08:00:00 AM,48,-122,2,7,9
25809,ElliotBayTrailMyrtlePark,12/11/2016 09:00:00 AM,48,-122,3,3,6
25810,ElliotBayTrailMyrtlePark,12/11/2016 10:00:00 AM,48,-122,15,5,20
25811,ElliotBayTrailMyrtlePark,12/11/2016 11:00:00 AM,48,-122,8,5,13
25812,ElliotBayTrailMyrtlePark,12/11/2016 12:00:00 PM,48,-122,15,5,20
25813,ElliotBayTrailMyrtlePark,12/11/2016 01:00:00 PM,48,-122,3,4,7
25814,ElliotBayTrailMyrtlePark,12/11/2016 02:00:00 PM,48,-122,8,6,14
25815,ElliotBayTrailMyrtlePark,12/11/2016 03:00:00 PM,48,-122,7,2,9
25816,ElliotBayTrailMyrtlePark,12/11/2016 04:00:00 PM,48,-122,3,3,6
25817,ElliotBayTrailMyrtlePark,12/11/2016 05:00:00 PM,48,-122,3,3,6
25818,ElliotBayTrailMyrtlePark,12/11/2016 06:00:00 PM,48,-122,1,4,5
25819,ElliotBayTrailMyrtlePark,12/11/2016 07:00:00 PM,48,-122,2,3,5
25820,ElliotBayTrailMyrtlePark,12/11/2016 08:00:00 PM,48,-122,0,0,0
25821,ElliotBayTrailMyrtlePark,12/11/2016 09:00:00 PM,48,-122,0,0,0
25822,ElliotBayTrailMyrtlePark,12/11/2016 10:00:00 PM,48,-122,0,0,0
25823,ElliotBayTrailMyrtlePark,12/11/2016 11:00:00 PM,48,-122,0,2,2
25824,ElliotBayTrailMyrtlePark,12/12/2016 12:00:00 AM,48,-122,0,0,0
25825,ElliotBayTrailMyrtlePark,12/12/2016 01:00:00 AM,48,-122,0,0,0
25826,ElliotBayTrailMyrtlePark,12/12/2016 02:00:00 AM,48,-122,1,0,1
25827,ElliotBayTrailMyrtlePark,12/12/2016 03:00:00 AM,48,-122,1,1,2
25828,ElliotBayTrailMyrtlePark,12/12/2016 04:00:00 AM,48,-122,3,3,6
25829,ElliotBayTrailMyrtlePark,12/12/2016 05:00:00 AM,48,-122,7,14,21
25830,ElliotBayTrailMyrtlePark,12/12/2016 06:00:00 AM,48,-122,14,13,27
25831,ElliotBayTrailMyrtlePark,12/12/2016 07:00:00 AM,48,-122,27,80,107
25832,ElliotBayTrailMyrtlePark,12/12/2016 08:00:00 AM,48,-122,16,79,95
25833,ElliotBayTrailMyrtlePark,12/12/2016 09:00:00 AM,48,-122,6,23,29
25834,ElliotBayTrailMyrtlePark,12/12/2016 10:00:00 AM,48,-122,8,5,13
25835,ElliotBayTrailMyrtlePark,12/12/2016 11:00:00 AM,48,-122,6,1,7
25836,ElliotBayTrailMyrtlePark,12/12/2016 12:00:00 PM,48,-122,3,7,10
25837,ElliotBayTrailMyrtlePark,12/12/2016 01:00:00 PM,48,-122,3,10,13
25838,ElliotBayTrailMyrtlePark,12/12/2016 02:00:00 PM,48,-122,11,11,22
25839,ElliotBayTrailMyrtlePark,12/12/2016 03:00:00 PM,48,-122,23,19,42
25840,ElliotBayTrailMyrtlePark,12/12/2016 04:00:00 PM,48,-122,70,28,98
25841,ElliotBayTrailMyrtlePark,12/12/2016 05:00:00 PM,48,-122,97,14,111
25842,ElliotBayTrailMyrtlePark,12/12/2016 06:00:00 PM,48,-122,34,7,41
25843,ElliotBayTrailMyrtlePark,12/12/2016 07:00:00 PM,48,-122,7,3,10
25844,ElliotBayTrailMyrtlePark,12/12/2016 08:00:00 PM,48,-122,3,4,7
25845,ElliotBayTrailMyrtlePark,12/12/2016 09:00:00 PM,48,-122,0,2,2
25846,ElliotBayTrailMyrtlePark,12/12/2016 10:00:00 PM,48,-122,1,0,1
25847,ElliotBayTrailMyrtlePark,12/12/2016 11:00:00 PM,48,-122,1,0,1
25848,ElliotBayTrailMyrtlePark,12/13/2016 12:00:00 AM,48,-122,1,0,1
25849,ElliotBayTrailMyrtlePark,12/13/2016 01:00:00 AM,48,-122,0,0,0
25850,ElliotBayTrailMyrtlePark,12/13/2016 02:00:00 AM,48,-122,3,0,3
25851,ElliotBayTrailMyrtlePark,12/13/2016 03:00:00 AM,48,-122,0,1,1
25852,ElliotBayTrailMyrtlePark,12/13/2016 04:00:00 AM,48,-122,0,2,2
25853,ElliotBayTrailMyrtlePark,12/13/2016 05:00:00 AM,48,-122,8,10,18
25854,ElliotBayTrailMyrtlePark,12/13/2016 06:00:00 AM,48,-122,9,27,36
25855,ElliotBayTrailMyrtlePark,12/13/2016 07:00:00 AM,48,-122,32,102,134
25856,ElliotBayTrailMyrtlePark,12/13/2016 08:00:00 AM,48,-122,24,83,107
25857,ElliotBayTrailMyrtlePark,12/13/2016 09:00:00 AM,48,-122,6,24,30
25858,ElliotBayTrailMyrtlePark,12/13/2016 10:00:00 AM,48,-122,8,11,19
25859,ElliotBayTrailMyrtlePark,12/13/2016 11:00:00 AM,48,-122,6,6,12
25860,ElliotBayTrailMyrtlePark,12/13/2016 12:00:00 PM,48,-122,9,10,19
25861,ElliotBayTrailMyrtlePark,12/13/2016 01:00:00 PM,48,-122,10,12,22
25862,ElliotBayTrailMyrtlePark,12/13/2016 02:00:00 PM,48,-122,14,15,29
25863,ElliotBayTrailMyrtlePark,12/13/2016 03:00:00 PM,48,-122,39,30,69
25864,ElliotBayTrailMyrtlePark,12/13/2016 04:00:00 PM,48,-122,73,38,111
25865,ElliotBayTrailMyrtlePark,12/13/2016 05:00:00 PM,48,-122,102,12,114
25866,ElliotBayTrailMyrtlePark,12/13/2016 06:00:00 PM,48,-122,48,4,52
25867,ElliotBayTrailMyrtlePark,12/13/2016 07:00:00 PM,48,-122,7,2,9
25868,ElliotBayTrailMyrtlePark,12/13/2016 08:00:00 PM,48,-122,4,0,4
25869,ElliotBayTrailMyrtlePark,12/13/2016 09:00:00 PM,48,-122,0,3,3
25870,ElliotBayTrailMyrtlePark,12/13/2016 10:00:00 PM,48,-122,5,1,6
25871,ElliotBayTrailMyrtlePark,12/13/2016 11:00:00 PM,48,-122,0,0,0
25872,ElliotBayTrailMyrtlePark,12/14/2016 12:00:00 AM,48,-122,0,0,0
25873,ElliotBayTrailMyrtlePark,12/14/2016 01:00:00 AM,48,-122,0,0,0
25874,ElliotBayTrailMyrtlePark,12/14/2016 02:00:00 AM,48,-122,2,0,2
25875,ElliotBayTrailMyrtlePark,12/14/2016 03:00:00 AM,48,-122,0,1,1
25876,ElliotBayTrailMyrtlePark,12/14/2016 04:00:00 AM,48,-122,3,2,5
25877,ElliotBayTrailMyrtlePark,12/14/2016 05:00:00 AM,48,-122,6,5,11
25878,ElliotBayTrailMyrtlePark,12/14/2016 06:00:00 AM,48,-122,10,29,39
25879,ElliotBayTrailMyrtlePark,12/14/2016 07:00:00 AM,48,-122,27,77,104
25880,ElliotBayTrailMyrtlePark,12/14/2016 08:00:00 AM,48,-122,15,66,81
25881,ElliotBayTrailMyrtlePark,12/14/2016 09:00:00 AM,48,-122,11,26,37
25882,ElliotBayTrailMyrtlePark,12/14/2016 10:00:00 AM,48,-122,9,7,16
25883,ElliotBayTrailMyrtlePark,12/14/2016 11:00:00 AM,48,-122,6,5,11
25884,ElliotBayTrailMyrtlePark,12/14/2016 12:00:00 PM,48,-122,6,8,14
25885,ElliotBayTrailMyrtlePark,12/14/2016 01:00:00 PM,48,-122,7,10,17
25886,ElliotBayTrailMyrtlePark,12/14/2016 02:00:00 PM,48,-122,14,9,23
25887,ElliotBayTrailMyrtlePark,12/14/2016 03:00:00 PM,48,-122,21,21,42
25888,ElliotBayTrailMyrtlePark,12/14/2016 04:00:00 PM,48,-122,51,28,79
25889,ElliotBayTrailMyrtlePark,12/14/2016 05:00:00 PM,48,-122,90,20,110
25890,ElliotBayTrailMyrtlePark,12/14/2016 06:00:00 PM,48,-122,28,4,32
25891,ElliotBayTrailMyrtlePark,12/14/2016 07:00:00 PM,48,-122,6,1,7
25892,ElliotBayTrailMyrtlePark,12/14/2016 08:00:00 PM,48,-122,4,2,6
25893,ElliotBayTrailMyrtlePark,12/14/2016 09:00:00 PM,48,-122,4,0,4
25894,ElliotBayTrailMyrtlePark,12/14/2016 10:00:00 PM,48,-122,2,2,4
25895,ElliotBayTrailMyrtlePark,12/14/2016 11:00:00 PM,48,-122,2,1,3
25896,ElliotBayTrailMyrtlePark,12/15/2016 12:00:00 AM,48,-122,1,1,2
25897,ElliotBayTrailMyrtlePark,12/15/2016 01:00:00 AM,48,-122,0,0,0
25898,ElliotBayTrailMyrtlePark,12/15/2016 02:00:00 AM,48,-122,1,0,1
25899,ElliotBayTrailMyrtlePark,12/15/2016 03:00:00 AM,48,-122,0,1,1
25900,ElliotBayTrailMyrtlePark,12/15/2016 04:00:00 AM,48,-122,2,3,5
25901,ElliotBayTrailMyrtlePark,12/15/2016 05:00:00 AM,48,-122,10,16,26
25902,ElliotBayTrailMyrtlePark,12/15/2016 06:00:00 AM,48,-122,11,15,26
25903,ElliotBayTrailMyrtlePark,12/15/2016 07:00:00 AM,48,-122,23,62,85
25904,ElliotBayTrailMyrtlePark,12/15/2016 08:00:00 AM,48,-122,17,77,94
25905,ElliotBayTrailMyrtlePark,12/15/2016 09:00:00 AM,48,-122,8,24,32
25906,ElliotBayTrailMyrtlePark,12/15/2016 10:00:00 AM,48,-122,9,6,15
25907,ElliotBayTrailMyrtlePark,12/15/2016 11:00:00 AM,48,-122,10,13,23
25908,ElliotBayTrailMyrtlePark,12/15/2016 12:00:00 PM,48,-122,10,13,23
25909,ElliotBayTrailMyrtlePark,12/15/2016 01:00:00 PM,48,-122,14,10,24
25910,ElliotBayTrailMyrtlePark,12/15/2016 02:00:00 PM,48,-122,13,15,28
25911,ElliotBayTrailMyrtlePark,12/15/2016 03:00:00 PM,48,-122,20,17,37
25912,ElliotBayTrailMyrtlePark,12/15/2016 04:00:00 PM,48,-122,84,28,112
25913,ElliotBayTrailMyrtlePark,12/15/2016 05:00:00 PM,48,-122,66,12,78
25914,ElliotBayTrailMyrtlePark,12/15/2016 06:00:00 PM,48,-122,22,6,28
25915,ElliotBayTrailMyrtlePark,12/15/2016 07:00:00 PM,48,-122,3,3,6
25916,ElliotBayTrailMyrtlePark,12/15/2016 08:00:00 PM,48,-122,9,4,13
25917,ElliotBayTrailMyrtlePark,12/15/2016 09:00:00 PM,48,-122,4,0,4
25918,ElliotBayTrailMyrtlePark,12/15/2016 10:00:00 PM,48,-122,3,0,3
25919,ElliotBayTrailMyrtlePark,12/15/2016 11:00:00 PM,48,-122,1,0,1
25920,ElliotBayTrailMyrtlePark,12/16/2016 12:00:00 AM,48,-122,1,0,1
25921,ElliotBayTrailMyrtlePark,12/16/2016 01:00:00 AM,48,-122,0,0,0
25922,ElliotBayTrailMyrtlePark,12/16/2016 02:00:00 AM,48,-122,1,0,1
25923,ElliotBayTrailMyrtlePark,12/16/2016 03:00:00 AM,48,-122,0,1,1
25924,ElliotBayTrailMyrtlePark,12/16/2016 04:00:00 AM,48,-122,0,3,3
25925,ElliotBayTrailMyrtlePark,12/16/2016 05:00:00 AM,48,-122,6,14,20
25926,ElliotBayTrailMyrtlePark,12/16/2016 06:00:00 AM,48,-122,6,13,19
25927,ElliotBayTrailMyrtlePark,12/16/2016 07:00:00 AM,48,-122,19,38,57
25928,ElliotBayTrailMyrtlePark,12/16/2016 08:00:00 AM,48,-122,13,60,73
25929,ElliotBayTrailMyrtlePark,12/16/2016 09:00:00 AM,48,-122,4,14,18
25930,ElliotBayTrailMyrtlePark,12/16/2016 10:00:00 AM,48,-122,4,6,10
25931,ElliotBayTrailMyrtlePark,12/16/2016 11:00:00 AM,48,-122,10,2,12
25932,ElliotBayTrailMyrtlePark,12/16/2016 12:00:00 PM,48,-122,8,8,16
25933,ElliotBayTrailMyrtlePark,12/16/2016 01:00:00 PM,48,-122,8,11,19
25934,ElliotBayTrailMyrtlePark,12/16/2016 02:00:00 PM,48,-122,16,14,30
25935,ElliotBayTrailMyrtlePark,12/16/2016 03:00:00 PM,48,-122,29,14,43
25936,ElliotBayTrailMyrtlePark,12/16/2016 04:00:00 PM,48,-122,49,18,67
25937,ElliotBayTrailMyrtlePark,12/16/2016 05:00:00 PM,48,-122,51,4,55
25938,ElliotBayTrailMyrtlePark,12/16/2016 06:00:00 PM,48,-122,13,5,18
25939,ElliotBayTrailMyrtlePark,12/16/2016 07:00:00 PM,48,-122,6,1,7
25940,ElliotBayTrailMyrtlePark,12/16/2016 08:00:00 PM,48,-122,2,1,3
25941,ElliotBayTrailMyrtlePark,12/16/2016 09:00:00 PM,48,-122,0,3,3
25942,ElliotBayTrailMyrtlePark,12/16/2016 10:00:00 PM,48,-122,0,2,2
25943,ElliotBayTrailMyrtlePark,12/16/2016 11:00:00 PM,48,-122,0,0,0
25944,ElliotBayTrailMyrtlePark,12/17/2016 12:00:00 AM,48,-122,1,0,1
25945,ElliotBayTrailMyrtlePark,12/17/2016 01:00:00 AM,48,-122,0,0,0
25946,ElliotBayTrailMyrtlePark,12/17/2016 02:00:00 AM,48,-122,1,0,1
25947,ElliotBayTrailMyrtlePark,12/17/2016 03:00:00 AM,48,-122,0,0,0
25948,ElliotBayTrailMyrtlePark,12/17/2016 04:00:00 AM,48,-122,0,0,0
25949,ElliotBayTrailMyrtlePark,12/17/2016 05:00:00 AM,48,-122,0,2,2
25950,ElliotBayTrailMyrtlePark,12/17/2016 06:00:00 AM,48,-122,2,0,2
25951,ElliotBayTrailMyrtlePark,12/17/2016 07:00:00 AM,48,-122,4,1,5
25952,ElliotBayTrailMyrtlePark,12/17/2016 08:00:00 AM,48,-122,3,3,6
25953,ElliotBayTrailMyrtlePark,12/17/2016 09:00:00 AM,48,-122,5,7,12
25954,ElliotBayTrailMyrtlePark,12/17/2016 10:00:00 AM,48,-122,7,13,20
25955,ElliotBayTrailMyrtlePark,12/17/2016 11:00:00 AM,48,-122,13,7,20
25956,ElliotBayTrailMyrtlePark,12/17/2016 12:00:00 PM,48,-122,8,4,12
25957,ElliotBayTrailMyrtlePark,12/17/2016 01:00:00 PM,48,-122,7,7,14
25958,ElliotBayTrailMyrtlePark,12/17/2016 02:00:00 PM,48,-122,12,8,20
25959,ElliotBayTrailMyrtlePark,12/17/2016 03:00:00 PM,48,-122,18,13,31
25960,ElliotBayTrailMyrtlePark,12/17/2016 04:00:00 PM,48,-122,10,4,14
25961,ElliotBayTrailMyrtlePark,12/17/2016 05:00:00 PM,48,-122,2,3,5
25962,ElliotBayTrailMyrtlePark,12/17/2016 06:00:00 PM,48,-122,2,0,2
25963,ElliotBayTrailMyrtlePark,12/17/2016 07:00:00 PM,48,-122,6,1,7
25964,ElliotBayTrailMyrtlePark,12/17/2016 08:00:00 PM,48,-122,2,1,3
25965,ElliotBayTrailMyrtlePark,12/17/2016 09:00:00 PM,48,-122,0,3,3
25966,ElliotBayTrailMyrtlePark,12/17/2016 10:00:00 PM,48,-122,6,2,8
25967,ElliotBayTrailMyrtlePark,12/17/2016 11:00:00 PM,48,-122,0,7,7
25968,ElliotBayTrailMyrtlePark,12/18/2016 12:00:00 AM,48,-122,0,10,10
25969,ElliotBayTrailMyrtlePark,12/18/2016 01:00:00 AM,48,-122,1,3,4
25970,ElliotBayTrailMyrtlePark,12/18/2016 02:00:00 AM,48,-122,0,0,0
25971,ElliotBayTrailMyrtlePark,12/18/2016 03:00:00 AM,48,-122,0,0,0
25972,ElliotBayTrailMyrtlePark,12/18/2016 04:00:00 AM,48,-122,0,1,1
25973,ElliotBayTrailMyrtlePark,12/18/2016 05:00:00 AM,48,-122,0,1,1
25974,ElliotBayTrailMyrtlePark,12/18/2016 06:00:00 AM,48,-122,0,0,0
25975,ElliotBayTrailMyrtlePark,12/18/2016 07:00:00 AM,48,-122,2,1,3
25976,ElliotBayTrailMyrtlePark,12/18/2016 08:00:00 AM,48,-122,7,1,8
25977,ElliotBayTrailMyrtlePark,12/18/2016 09:00:00 AM,48,-122,2,4,6
25978,ElliotBayTrailMyrtlePark,12/18/2016 10:00:00 AM,48,-122,8,8,16
25979,ElliotBayTrailMyrtlePark,12/18/2016 11:00:00 AM,48,-122,16,8,24
25980,ElliotBayTrailMyrtlePark,12/18/2016 12:00:00 PM,48,-122,10,16,26
25981,ElliotBayTrailMyrtlePark,12/18/2016 01:00:00 PM,48,-122,8,7,15
25982,ElliotBayTrailMyrtlePark,12/18/2016 02:00:00 PM,48,-122,13,18,31
25983,ElliotBayTrailMyrtlePark,12/18/2016 03:00:00 PM,48,-122,12,14,26
25984,ElliotBayTrailMyrtlePark,12/18/2016 04:00:00 PM,48,-122,5,9,14
25985,ElliotBayTrailMyrtlePark,12/18/2016 05:00:00 PM,48,-122,3,3,6
25986,ElliotBayTrailMyrtlePark,12/18/2016 06:00:00 PM,48,-122,1,4,5
25987,ElliotBayTrailMyrtlePark,12/18/2016 07:00:00 PM,48,-122,3,1,4
25988,ElliotBayTrailMyrtlePark,12/18/2016 08:00:00 PM,48,-122,4,1,5
25989,ElliotBayTrailMyrtlePark,12/18/2016 09:00:00 PM,48,-122,0,0,0
25990,ElliotBayTrailMyrtlePark,12/18/2016 10:00:00 PM,48,-122,0,0,0
25991,ElliotBayTrailMyrtlePark,12/18/2016 11:00:00 PM,48,-122,0,0,0
25992,ElliotBayTrailMyrtlePark,12/19/2016 12:00:00 AM,48,-122,0,0,0
25993,ElliotBayTrailMyrtlePark,12/19/2016 01:00:00 AM,48,-122,0,0,0
25994,ElliotBayTrailMyrtlePark,12/19/2016 02:00:00 AM,48,-122,0,0,0
25995,ElliotBayTrailMyrtlePark,12/19/2016 03:00:00 AM,48,-122,0,0,0
25996,ElliotBayTrailMyrtlePark,12/19/2016 04:00:00 AM,48,-122,0,1,1
25997,ElliotBayTrailMyrtlePark,12/19/2016 05:00:00 AM,48,-122,4,6,10
25998,ElliotBayTrailMyrtlePark,12/19/2016 06:00:00 AM,48,-122,6,13,19
25999,ElliotBayTrailMyrtlePark,12/19/2016 07:00:00 AM,48,-122,15,57,72
26000,ElliotBayTrailMyrtlePark,12/19/2016 08:00:00 AM,48,-122,11,52,63
26001,ElliotBayTrailMyrtlePark,12/19/2016 09:00:00 AM,48,-122,8,10,18
26002,ElliotBayTrailMyrtlePark,12/19/2016 10:00:00 AM,48,-122,4,5,9
26003,ElliotBayTrailMyrtlePark,12/19/2016 11:00:00 AM,48,-122,6,5,11
26004,ElliotBayTrailMyrtlePark,12/19/2016 12:00:00 PM,48,-122,4,6,10
26005,ElliotBayTrailMyrtlePark,12/19/2016 01:00:00 PM,48,-122,4,2,6
26006,ElliotBayTrailMyrtlePark,12/19/2016 02:00:00 PM,48,-122,9,11,20
26007,ElliotBayTrailMyrtlePark,12/19/2016 03:00:00 PM,48,-122,11,9,20
26008,ElliotBayTrailMyrtlePark,12/19/2016 04:00:00 PM,48,-122,46,18,64
26009,ElliotBayTrailMyrtlePark,12/19/2016 05:00:00 PM,48,-122,69,10,79
26010,ElliotBayTrailMyrtlePark,12/19/2016 06:00:00 PM,48,-122,27,4,31
26011,ElliotBayTrailMyrtlePark,12/19/2016 07:00:00 PM,48,-122,4,1,5
26012,ElliotBayTrailMyrtlePark,12/19/2016 08:00:00 PM,48,-122,0,0,0
26013,ElliotBayTrailMyrtlePark,12/19/2016 09:00:00 PM,48,-122,1,3,4
26014,ElliotBayTrailMyrtlePark,12/19/2016 10:00:00 PM,48,-122,0,1,1
26015,ElliotBayTrailMyrtlePark,12/19/2016 11:00:00 PM,48,-122,0,0,0
26016,ElliotBayTrailMyrtlePark,12/20/2016 12:00:00 AM,48,-122,1,0,1
26017,ElliotBayTrailMyrtlePark,12/20/2016 01:00:00 AM,48,-122,0,1,1
26018,ElliotBayTrailMyrtlePark,12/20/2016 02:00:00 AM,48,-122,4,0,4
26019,ElliotBayTrailMyrtlePark,12/20/2016 03:00:00 AM,48,-122,0,0,0
26020,ElliotBayTrailMyrtlePark,12/20/2016 04:00:00 AM,48,-122,0,2,2
26021,ElliotBayTrailMyrtlePark,12/20/2016 05:00:00 AM,48,-122,5,5,10
26022,ElliotBayTrailMyrtlePark,12/20/2016 06:00:00 AM,48,-122,6,20,26
26023,ElliotBayTrailMyrtlePark,12/20/2016 07:00:00 AM,48,-122,16,50,66
26024,ElliotBayTrailMyrtlePark,12/20/2016 08:00:00 AM,48,-122,19,60,79
26025,ElliotBayTrailMyrtlePark,12/20/2016 09:00:00 AM,48,-122,4,27,31
26026,ElliotBayTrailMyrtlePark,12/20/2016 10:00:00 AM,48,-122,9,12,21
26027,ElliotBayTrailMyrtlePark,12/20/2016 11:00:00 AM,48,-122,13,12,25
26028,ElliotBayTrailMyrtlePark,12/20/2016 12:00:00 PM,48,-122,11,12,23
26029,ElliotBayTrailMyrtlePark,12/20/2016 01:00:00 PM,48,-122,12,15,27
26030,ElliotBayTrailMyrtlePark,12/20/2016 02:00:00 PM,48,-122,24,26,50
26031,ElliotBayTrailMyrtlePark,12/20/2016 03:00:00 PM,48,-122,29,25,54
26032,ElliotBayTrailMyrtlePark,12/20/2016 04:00:00 PM,48,-122,71,23,94
26033,ElliotBayTrailMyrtlePark,12/20/2016 05:00:00 PM,48,-122,75,12,87
26034,ElliotBayTrailMyrtlePark,12/20/2016 06:00:00 PM,48,-122,26,5,31
26035,ElliotBayTrailMyrtlePark,12/20/2016 07:00:00 PM,48,-122,5,2,7
26036,ElliotBayTrailMyrtlePark,12/20/2016 08:00:00 PM,48,-122,1,4,5
26037,ElliotBayTrailMyrtlePark,12/20/2016 09:00:00 PM,48,-122,3,2,5
26038,ElliotBayTrailMyrtlePark,12/20/2016 10:00:00 PM,48,-122,6,0,6
26039,ElliotBayTrailMyrtlePark,12/20/2016 11:00:00 PM,48,-122,1,1,2
26040,ElliotBayTrailMyrtlePark,12/21/2016 12:00:00 AM,48,-122,0,1,1
26041,ElliotBayTrailMyrtlePark,12/21/2016 01:00:00 AM,48,-122,0,0,0
26042,ElliotBayTrailMyrtlePark,12/21/2016 02:00:00 AM,48,-122,1,0,1
26043,ElliotBayTrailMyrtlePark,12/21/2016 03:00:00 AM,48,-122,1,0,1
26044,ElliotBayTrailMyrtlePark,12/21/2016 04:00:00 AM,48,-122,0,3,3
26045,ElliotBayTrailMyrtlePark,12/21/2016 05:00:00 AM,48,-122,5,17,22
26046,ElliotBayTrailMyrtlePark,12/21/2016 06:00:00 AM,48,-122,16,21,37
26047,ElliotBayTrailMyrtlePark,12/21/2016 07:00:00 AM,48,-122,16,68,84
26048,ElliotBayTrailMyrtlePark,12/21/2016 08:00:00 AM,48,-122,23,68,91
26049,ElliotBayTrailMyrtlePark,12/21/2016 09:00:00 AM,48,-122,13,38,51
26050,ElliotBayTrailMyrtlePark,12/21/2016 10:00:00 AM,48,-122,14,20,34
26051,ElliotBayTrailMyrtlePark,12/21/2016 11:00:00 AM,48,-122,14,15,29
26052,ElliotBayTrailMyrtlePark,12/21/2016 12:00:00 PM,48,-122,19,13,32
26053,ElliotBayTrailMyrtlePark,12/21/2016 01:00:00 PM,48,-122,10,18,28
26054,ElliotBayTrailMyrtlePark,12/21/2016 02:00:00 PM,48,-122,19,14,33
26055,ElliotBayTrailMyrtlePark,12/21/2016 03:00:00 PM,48,-122,30,21,51
26056,ElliotBayTrailMyrtlePark,12/21/2016 04:00:00 PM,48,-122,78,25,103
26057,ElliotBayTrailMyrtlePark,12/21/2016 05:00:00 PM,48,-122,81,11,92
26058,ElliotBayTrailMyrtlePark,12/21/2016 06:00:00 PM,48,-122,30,4,34
26059,ElliotBayTrailMyrtlePark,12/21/2016 07:00:00 PM,48,-122,4,2,6
26060,ElliotBayTrailMyrtlePark,12/21/2016 08:00:00 PM,48,-122,6,4,10
26061,ElliotBayTrailMyrtlePark,12/21/2016 09:00:00 PM,48,-122,1,0,1
26062,ElliotBayTrailMyrtlePark,12/21/2016 10:00:00 PM,48,-122,0,0,0
26063,ElliotBayTrailMyrtlePark,12/21/2016 11:00:00 PM,48,-122,1,1,2
26064,ElliotBayTrailMyrtlePark,12/22/2016 12:00:00 AM,48,-122,0,1,1
26065,ElliotBayTrailMyrtlePark,12/22/2016 01:00:00 AM,48,-122,0,0,0
26066,ElliotBayTrailMyrtlePark,12/22/2016 02:00:00 AM,48,-122,2,0,2
26067,ElliotBayTrailMyrtlePark,12/22/2016 03:00:00 AM,48,-122,0,1,1
26068,ElliotBayTrailMyrtlePark,12/22/2016 04:00:00 AM,48,-122,1,1,2
26069,ElliotBayTrailMyrtlePark,12/22/2016 05:00:00 AM,48,-122,8,11,19
26070,ElliotBayTrailMyrtlePark,12/22/2016 06:00:00 AM,48,-122,12,17,29
26071,ElliotBayTrailMyrtlePark,12/22/2016 07:00:00 AM,48,-122,14,46,60
26072,ElliotBayTrailMyrtlePark,12/22/2016 08:00:00 AM,48,-122,14,47,61
26073,ElliotBayTrailMyrtlePark,12/22/2016 09:00:00 AM,48,-122,9,33,42
26074,ElliotBayTrailMyrtlePark,12/22/2016 10:00:00 AM,48,-122,9,6,15
26075,ElliotBayTrailMyrtlePark,12/22/2016 11:00:00 AM,48,-122,6,3,9
26076,ElliotBayTrailMyrtlePark,12/22/2016 12:00:00 PM,48,-122,12,6,18
26077,ElliotBayTrailMyrtlePark,12/22/2016 01:00:00 PM,48,-122,11,7,18
26078,ElliotBayTrailMyrtlePark,12/22/2016 02:00:00 PM,48,-122,17,10,27
26079,ElliotBayTrailMyrtlePark,12/22/2016 03:00:00 PM,48,-122,17,22,39
26080,ElliotBayTrailMyrtlePark,12/22/2016 04:00:00 PM,48,-122,45,18,63
26081,ElliotBayTrailMyrtlePark,12/22/2016 05:00:00 PM,48,-122,51,10,61
26082,ElliotBayTrailMyrtlePark,12/22/2016 06:00:00 PM,48,-122,13,2,15
26083,ElliotBayTrailMyrtlePark,12/22/2016 07:00:00 PM,48,-122,33,1,34
26084,ElliotBayTrailMyrtlePark,12/22/2016 08:00:00 PM,48,-122,4,0,4
26085,ElliotBayTrailMyrtlePark,12/22/2016 09:00:00 PM,48,-122,0,4,4
26086,ElliotBayTrailMyrtlePark,12/22/2016 10:00:00 PM,48,-122,1,0,1
26087,ElliotBayTrailMyrtlePark,12/22/2016 11:00:00 PM,48,-122,0,2,2
26088,ElliotBayTrailMyrtlePark,12/23/2016 12:00:00 AM,48,-122,0,2,2
26089,ElliotBayTrailMyrtlePark,12/23/2016 01:00:00 AM,48,-122,1,0,1
26090,ElliotBayTrailMyrtlePark,12/23/2016 02:00:00 AM,48,-122,0,0,0
26091,ElliotBayTrailMyrtlePark,12/23/2016 03:00:00 AM,48,-122,0,0,0
26092,ElliotBayTrailMyrtlePark,12/23/2016 04:00:00 AM,48,-122,0,0,0
26093,ElliotBayTrailMyrtlePark,12/23/2016 05:00:00 AM,48,-122,3,4,7
26094,ElliotBayTrailMyrtlePark,12/23/2016 06:00:00 AM,48,-122,3,5,8
26095,ElliotBayTrailMyrtlePark,12/23/2016 07:00:00 AM,48,-122,5,16,21
26096,ElliotBayTrailMyrtlePark,12/23/2016 08:00:00 AM,48,-122,10,16,26
26097,ElliotBayTrailMyrtlePark,12/23/2016 09:00:00 AM,48,-122,4,11,15
26098,ElliotBayTrailMyrtlePark,12/23/2016 10:00:00 AM,48,-122,2,3,5
26099,ElliotBayTrailMyrtlePark,12/23/2016 11:00:00 AM,48,-122,4,0,4
26100,ElliotBayTrailMyrtlePark,12/23/2016 12:00:00 PM,48,-122,4,4,8
26101,ElliotBayTrailMyrtlePark,12/23/2016 01:00:00 PM,48,-122,8,3,11
26102,ElliotBayTrailMyrtlePark,12/23/2016 02:00:00 PM,48,-122,7,4,11
26103,ElliotBayTrailMyrtlePark,12/23/2016 03:00:00 PM,48,-122,22,9,31
26104,ElliotBayTrailMyrtlePark,12/23/2016 04:00:00 PM,48,-122,12,4,16
26105,ElliotBayTrailMyrtlePark,12/23/2016 05:00:00 PM,48,-122,12,0,12
26106,ElliotBayTrailMyrtlePark,12/23/2016 06:00:00 PM,48,-122,1,0,1
26107,ElliotBayTrailMyrtlePark,12/23/2016 07:00:00 PM,48,-122,0,1,1
26108,ElliotBayTrailMyrtlePark,12/23/2016 08:00:00 PM,48,-122,0,1,1
26109,ElliotBayTrailMyrtlePark,12/23/2016 09:00:00 PM,48,-122,0,0,0
26110,ElliotBayTrailMyrtlePark,12/23/2016 10:00:00 PM,48,-122,0,0,0
26111,ElliotBayTrailMyrtlePark,12/23/2016 11:00:00 PM,48,-122,0,0,0
26112,ElliotBayTrailMyrtlePark,12/24/2016 12:00:00 AM,48,-122,2,0,2
26113,ElliotBayTrailMyrtlePark,12/24/2016 01:00:00 AM,48,-122,1,0,1
26114,ElliotBayTrailMyrtlePark,12/24/2016 02:00:00 AM,48,-122,0,0,0
26115,ElliotBayTrailMyrtlePark,12/24/2016 03:00:00 AM,48,-122,1,0,1
26116,ElliotBayTrailMyrtlePark,12/24/2016 04:00:00 AM,48,-122,0,0,0
26117,ElliotBayTrailMyrtlePark,12/24/2016 05:00:00 AM,48,-122,0,1,1
26118,ElliotBayTrailMyrtlePark,12/24/2016 06:00:00 AM,48,-122,0,2,2
26119,ElliotBayTrailMyrtlePark,12/24/2016 07:00:00 AM,48,-122,3,0,3
26120,ElliotBayTrailMyrtlePark,12/24/2016 08:00:00 AM,48,-122,8,10,18
26121,ElliotBayTrailMyrtlePark,12/24/2016 09:00:00 AM,48,-122,7,5,12
26122,ElliotBayTrailMyrtlePark,12/24/2016 10:00:00 AM,48,-122,10,2,12
26123,ElliotBayTrailMyrtlePark,12/24/2016 11:00:00 AM,48,-122,4,12,16
26124,ElliotBayTrailMyrtlePark,12/24/2016 12:00:00 PM,48,-122,11,11,22
26125,ElliotBayTrailMyrtlePark,12/24/2016 01:00:00 PM,48,-122,10,8,18
26126,ElliotBayTrailMyrtlePark,12/24/2016 02:00:00 PM,48,-122,9,9,18
26127,ElliotBayTrailMyrtlePark,12/24/2016 03:00:00 PM,48,-122,8,10,18
26128,ElliotBayTrailMyrtlePark,12/24/2016 04:00:00 PM,48,-122,13,3,16
26129,ElliotBayTrailMyrtlePark,12/24/2016 05:00:00 PM,48,-122,2,1,3
26130,ElliotBayTrailMyrtlePark,12/24/2016 06:00:00 PM,48,-122,1,2,3
26131,ElliotBayTrailMyrtlePark,12/24/2016 07:00:00 PM,48,-122,0,1,1
26132,ElliotBayTrailMyrtlePark,12/24/2016 08:00:00 PM,48,-122,0,0,0
26133,ElliotBayTrailMyrtlePark,12/24/2016 09:00:00 PM,48,-122,0,0,0
26134,ElliotBayTrailMyrtlePark,12/24/2016 10:00:00 PM,48,-122,0,0,0
26135,ElliotBayTrailMyrtlePark,12/24/2016 11:00:00 PM,48,-122,0,1,1
26136,ElliotBayTrailMyrtlePark,12/25/2016 12:00:00 AM,48,-122,0,0,0
26137,ElliotBayTrailMyrtlePark,12/25/2016 01:00:00 AM,48,-122,0,0,0
26138,ElliotBayTrailMyrtlePark,12/25/2016 02:00:00 AM,48,-122,0,0,0
26139,ElliotBayTrailMyrtlePark,12/25/2016 03:00:00 AM,48,-122,0,0,0
26140,ElliotBayTrailMyrtlePark,12/25/2016 04:00:00 AM,48,-122,0,0,0
26141,ElliotBayTrailMyrtlePark,12/25/2016 05:00:00 AM,48,-122,0,0,0
26142,ElliotBayTrailMyrtlePark,12/25/2016 06:00:00 AM,48,-122,0,0,0
26143,ElliotBayTrailMyrtlePark,12/25/2016 07:00:00 AM,48,-122,1,0,1
26144,ElliotBayTrailMyrtlePark,12/25/2016 08:00:00 AM,48,-122,2,1,3
26145,ElliotBayTrailMyrtlePark,12/25/2016 09:00:00 AM,48,-122,8,2,10
26146,ElliotBayTrailMyrtlePark,12/25/2016 10:00:00 AM,48,-122,4,8,12
26147,ElliotBayTrailMyrtlePark,12/25/2016 11:00:00 AM,48,-122,13,15,28
26148,ElliotBayTrailMyrtlePark,12/25/2016 12:00:00 PM,48,-122,8,11,19
26149,ElliotBayTrailMyrtlePark,12/25/2016 01:00:00 PM,48,-122,25,7,32
26150,ElliotBayTrailMyrtlePark,12/25/2016 02:00:00 PM,48,-122,12,14,26
26151,ElliotBayTrailMyrtlePark,12/25/2016 03:00:00 PM,48,-122,18,13,31
26152,ElliotBayTrailMyrtlePark,12/25/2016 04:00:00 PM,48,-122,7,6,13
26153,ElliotBayTrailMyrtlePark,12/25/2016 05:00:00 PM,48,-122,2,0,2
26154,ElliotBayTrailMyrtlePark,12/25/2016 06:00:00 PM,48,-122,0,1,1
26155,ElliotBayTrailMyrtlePark,12/25/2016 07:00:00 PM,48,-122,1,0,1
26156,ElliotBayTrailMyrtlePark,12/25/2016 08:00:00 PM,48,-122,1,1,2
26157,ElliotBayTrailMyrtlePark,12/25/2016 09:00:00 PM,48,-122,0,0,0
26158,ElliotBayTrailMyrtlePark,12/25/2016 10:00:00 PM,48,-122,0,0,0
26159,ElliotBayTrailMyrtlePark,12/25/2016 11:00:00 PM,48,-122,1,0,1
26160,ElliotBayTrailMyrtlePark,12/26/2016 12:00:00 AM,48,-122,0,0,0
26161,ElliotBayTrailMyrtlePark,12/26/2016 01:00:00 AM,48,-122,0,0,0
26162,ElliotBayTrailMyrtlePark,12/26/2016 02:00:00 AM,48,-122,0,0,0
26163,ElliotBayTrailMyrtlePark,12/26/2016 03:00:00 AM,48,-122,0,0,0
26164,ElliotBayTrailMyrtlePark,12/26/2016 04:00:00 AM,48,-122,0,0,0
26165,ElliotBayTrailMyrtlePark,12/26/2016 05:00:00 AM,48,-122,1,4,5
26166,ElliotBayTrailMyrtlePark,12/26/2016 06:00:00 AM,48,-122,1,2,3
26167,ElliotBayTrailMyrtlePark,12/26/2016 07:00:00 AM,48,-122,2,3,5
26168,ElliotBayTrailMyrtlePark,12/26/2016 08:00:00 AM,48,-122,6,5,11
26169,ElliotBayTrailMyrtlePark,12/26/2016 09:00:00 AM,48,-122,5,6,11
26170,ElliotBayTrailMyrtlePark,12/26/2016 10:00:00 AM,48,-122,10,15,25
26171,ElliotBayTrailMyrtlePark,12/26/2016 11:00:00 AM,48,-122,4,12,16
26172,ElliotBayTrailMyrtlePark,12/26/2016 12:00:00 PM,48,-122,8,15,23
26173,ElliotBayTrailMyrtlePark,12/26/2016 01:00:00 PM,48,-122,22,17,39
26174,ElliotBayTrailMyrtlePark,12/26/2016 02:00:00 PM,48,-122,9,1,10
26175,ElliotBayTrailMyrtlePark,12/26/2016 03:00:00 PM,48,-122,5,7,12
26176,ElliotBayTrailMyrtlePark,12/26/2016 04:00:00 PM,48,-122,3,5,8
26177,ElliotBayTrailMyrtlePark,12/26/2016 05:00:00 PM,48,-122,2,0,2
26178,ElliotBayTrailMyrtlePark,12/26/2016 06:00:00 PM,48,-122,0,0,0
26179,ElliotBayTrailMyrtlePark,12/26/2016 07:00:00 PM,48,-122,0,0,0
26180,ElliotBayTrailMyrtlePark,12/26/2016 08:00:00 PM,48,-122,2,0,2
26181,ElliotBayTrailMyrtlePark,12/26/2016 09:00:00 PM,48,-122,0,1,1
26182,ElliotBayTrailMyrtlePark,12/26/2016 10:00:00 PM,48,-122,1,0,1
26183,ElliotBayTrailMyrtlePark,12/26/2016 11:00:00 PM,48,-122,3,0,3
26184,ElliotBayTrailMyrtlePark,12/27/2016 12:00:00 AM,48,-122,1,1,2
26185,ElliotBayTrailMyrtlePark,12/27/2016 01:00:00 AM,48,-122,0,0,0
26186,ElliotBayTrailMyrtlePark,12/27/2016 02:00:00 AM,48,-122,1,0,1
26187,ElliotBayTrailMyrtlePark,12/27/2016 03:00:00 AM,48,-122,0,1,1
26188,ElliotBayTrailMyrtlePark,12/27/2016 04:00:00 AM,48,-122,3,0,3
26189,ElliotBayTrailMyrtlePark,12/27/2016 05:00:00 AM,48,-122,4,3,7
26190,ElliotBayTrailMyrtlePark,12/27/2016 06:00:00 AM,48,-122,9,13,22
26191,ElliotBayTrailMyrtlePark,12/27/2016 07:00:00 AM,48,-122,8,23,31
26192,ElliotBayTrailMyrtlePark,12/27/2016 08:00:00 AM,48,-122,19,39,58
26193,ElliotBayTrailMyrtlePark,12/27/2016 09:00:00 AM,48,-122,13,21,34
26194,ElliotBayTrailMyrtlePark,12/27/2016 10:00:00 AM,48,-122,10,9,19
26195,ElliotBayTrailMyrtlePark,12/27/2016 11:00:00 AM,48,-122,9,9,18
26196,ElliotBayTrailMyrtlePark,12/27/2016 12:00:00 PM,48,-122,8,4,12
26197,ElliotBayTrailMyrtlePark,12/27/2016 01:00:00 PM,48,-122,10,6,16
26198,ElliotBayTrailMyrtlePark,12/27/2016 02:00:00 PM,48,-122,8,9,17
26199,ElliotBayTrailMyrtlePark,12/27/2016 03:00:00 PM,48,-122,28,16,44
26200,ElliotBayTrailMyrtlePark,12/27/2016 04:00:00 PM,48,-122,41,18,59
26201,ElliotBayTrailMyrtlePark,12/27/2016 05:00:00 PM,48,-122,29,8,37
26202,ElliotBayTrailMyrtlePark,12/27/2016 06:00:00 PM,48,-122,8,2,10
26203,ElliotBayTrailMyrtlePark,12/27/2016 07:00:00 PM,48,-122,0,0,0
26204,ElliotBayTrailMyrtlePark,12/27/2016 08:00:00 PM,48,-122,0,1,1
26205,ElliotBayTrailMyrtlePark,12/27/2016 09:00:00 PM,48,-122,0,0,0
26206,ElliotBayTrailMyrtlePark,12/27/2016 10:00:00 PM,48,-122,1,1,2
26207,ElliotBayTrailMyrtlePark,12/27/2016 11:00:00 PM,48,-122,0,0,0
26208,ElliotBayTrailMyrtlePark,12/28/2016 12:00:00 AM,48,-122,0,0,0
26209,ElliotBayTrailMyrtlePark,12/28/2016 01:00:00 AM,48,-122,0,0,0
26210,ElliotBayTrailMyrtlePark,12/28/2016 02:00:00 AM,48,-122,1,0,1
26211,ElliotBayTrailMyrtlePark,12/28/2016 03:00:00 AM,48,-122,1,2,3
26212,ElliotBayTrailMyrtlePark,12/28/2016 04:00:00 AM,48,-122,2,0,2
26213,ElliotBayTrailMyrtlePark,12/28/2016 05:00:00 AM,48,-122,2,7,9
26214,ElliotBayTrailMyrtlePark,12/28/2016 06:00:00 AM,48,-122,5,18,23
26215,ElliotBayTrailMyrtlePark,12/28/2016 07:00:00 AM,48,-122,11,42,53
26216,ElliotBayTrailMyrtlePark,12/28/2016 08:00:00 AM,48,-122,12,46,58
26217,ElliotBayTrailMyrtlePark,12/28/2016 09:00:00 AM,48,-122,10,16,26
26218,ElliotBayTrailMyrtlePark,12/28/2016 10:00:00 AM,48,-122,9,7,16
26219,ElliotBayTrailMyrtlePark,12/28/2016 11:00:00 AM,48,-122,11,15,26
26220,ElliotBayTrailMyrtlePark,12/28/2016 12:00:00 PM,48,-122,14,17,31
26221,ElliotBayTrailMyrtlePark,12/28/2016 01:00:00 PM,48,-122,36,35,71
26222,ElliotBayTrailMyrtlePark,12/28/2016 02:00:00 PM,48,-122,20,16,36
26223,ElliotBayTrailMyrtlePark,12/28/2016 03:00:00 PM,48,-122,39,28,67
26224,ElliotBayTrailMyrtlePark,12/28/2016 04:00:00 PM,48,-122,44,25,69
26225,ElliotBayTrailMyrtlePark,12/28/2016 05:00:00 PM,48,-122,49,7,56
26226,ElliotBayTrailMyrtlePark,12/28/2016 06:00:00 PM,48,-122,17,6,23
26227,ElliotBayTrailMyrtlePark,12/28/2016 07:00:00 PM,48,-122,1,2,3
26228,ElliotBayTrailMyrtlePark,12/28/2016 08:00:00 PM,48,-122,2,0,2
26229,ElliotBayTrailMyrtlePark,12/28/2016 09:00:00 PM,48,-122,1,0,1
26230,ElliotBayTrailMyrtlePark,12/28/2016 10:00:00 PM,48,-122,2,1,3
26231,ElliotBayTrailMyrtlePark,12/28/2016 11:00:00 PM,48,-122,1,0,1
26232,ElliotBayTrailMyrtlePark,12/29/2016 12:00:00 AM,48,-122,0,0,0
26233,ElliotBayTrailMyrtlePark,12/29/2016 01:00:00 AM,48,-122,0,0,0
26234,ElliotBayTrailMyrtlePark,12/29/2016 02:00:00 AM,48,-122,1,0,1
26235,ElliotBayTrailMyrtlePark,12/29/2016 03:00:00 AM,48,-122,0,1,1
26236,ElliotBayTrailMyrtlePark,12/29/2016 04:00:00 AM,48,-122,0,2,2
26237,ElliotBayTrailMyrtlePark,12/29/2016 05:00:00 AM,48,-122,3,5,8
26238,ElliotBayTrailMyrtlePark,12/29/2016 06:00:00 AM,48,-122,8,14,22
26239,ElliotBayTrailMyrtlePark,12/29/2016 07:00:00 AM,48,-122,11,27,38
26240,ElliotBayTrailMyrtlePark,12/29/2016 08:00:00 AM,48,-122,21,35,56
26241,ElliotBayTrailMyrtlePark,12/29/2016 09:00:00 AM,48,-122,4,23,27
26242,ElliotBayTrailMyrtlePark,12/29/2016 10:00:00 AM,48,-122,8,2,10
26243,ElliotBayTrailMyrtlePark,12/29/2016 11:00:00 AM,48,-122,7,8,15
26244,ElliotBayTrailMyrtlePark,12/29/2016 12:00:00 PM,48,-122,7,6,13
26245,ElliotBayTrailMyrtlePark,12/29/2016 01:00:00 PM,48,-122,11,9,20
26246,ElliotBayTrailMyrtlePark,12/29/2016 02:00:00 PM,48,-122,8,3,11
26247,ElliotBayTrailMyrtlePark,12/29/2016 03:00:00 PM,48,-122,14,12,26
26248,ElliotBayTrailMyrtlePark,12/29/2016 04:00:00 PM,48,-122,38,14,52
26249,ElliotBayTrailMyrtlePark,12/29/2016 05:00:00 PM,48,-122,25,5,30
26250,ElliotBayTrailMyrtlePark,12/29/2016 06:00:00 PM,48,-122,8,1,9
26251,ElliotBayTrailMyrtlePark,12/29/2016 07:00:00 PM,48,-122,0,1,1
26252,ElliotBayTrailMyrtlePark,12/29/2016 08:00:00 PM,48,-122,0,0,0
26253,ElliotBayTrailMyrtlePark,12/29/2016 09:00:00 PM,48,-122,0,1,1
26254,ElliotBayTrailMyrtlePark,12/29/2016 10:00:00 PM,48,-122,1,0,1
26255,ElliotBayTrailMyrtlePark,12/29/2016 11:00:00 PM,48,-122,2,0,2
26256,ElliotBayTrailMyrtlePark,12/30/2016 12:00:00 AM,48,-122,0,0,0
26257,ElliotBayTrailMyrtlePark,12/30/2016 01:00:00 AM,48,-122,1,0,1
26258,ElliotBayTrailMyrtlePark,12/30/2016 02:00:00 AM,48,-122,0,0,0
26259,ElliotBayTrailMyrtlePark,12/30/2016 03:00:00 AM,48,-122,0,0,0
26260,ElliotBayTrailMyrtlePark,12/30/2016 04:00:00 AM,48,-122,0,1,1
26261,ElliotBayTrailMyrtlePark,12/30/2016 05:00:00 AM,48,-122,2,4,6
26262,ElliotBayTrailMyrtlePark,12/30/2016 06:00:00 AM,48,-122,3,12,15
26263,ElliotBayTrailMyrtlePark,12/30/2016 07:00:00 AM,48,-122,10,20,30
26264,ElliotBayTrailMyrtlePark,12/30/2016 08:00:00 AM,48,-122,17,25,42
26265,ElliotBayTrailMyrtlePark,12/30/2016 09:00:00 AM,48,-122,5,7,12
26266,ElliotBayTrailMyrtlePark,12/30/2016 10:00:00 AM,48,-122,12,11,23
26267,ElliotBayTrailMyrtlePark,12/30/2016 11:00:00 AM,48,-122,11,14,25
26268,ElliotBayTrailMyrtlePark,12/30/2016 12:00:00 PM,48,-122,18,24,42
26269,ElliotBayTrailMyrtlePark,12/30/2016 01:00:00 PM,48,-122,30,27,57
26270,ElliotBayTrailMyrtlePark,12/30/2016 02:00:00 PM,48,-122,22,18,40
26271,ElliotBayTrailMyrtlePark,12/30/2016 03:00:00 PM,48,-122,27,26,53
26272,ElliotBayTrailMyrtlePark,12/30/2016 04:00:00 PM,48,-122,35,12,47
26273,ElliotBayTrailMyrtlePark,12/30/2016 05:00:00 PM,48,-122,25,2,27
26274,ElliotBayTrailMyrtlePark,12/30/2016 06:00:00 PM,48,-122,15,4,19
26275,ElliotBayTrailMyrtlePark,12/30/2016 07:00:00 PM,48,-122,1,2,3
26276,ElliotBayTrailMyrtlePark,12/30/2016 08:00:00 PM,48,-122,0,1,1
26277,ElliotBayTrailMyrtlePark,12/30/2016 09:00:00 PM,48,-122,0,0,0
26278,ElliotBayTrailMyrtlePark,12/30/2016 10:00:00 PM,48,-122,1,3,4
26279,ElliotBayTrailMyrtlePark,12/30/2016 11:00:00 PM,48,-122,0,0,0
26280,ElliotBayTrailMyrtlePark,12/31/2016 12:00:00 AM,48,-122,0,0,0
26281,ElliotBayTrailMyrtlePark,12/31/2016 01:00:00 AM,48,-122,1,0,1
26282,ElliotBayTrailMyrtlePark,12/31/2016 02:00:00 AM,48,-122,0,0,0
26283,ElliotBayTrailMyrtlePark,12/31/2016 03:00:00 AM,48,-122,1,0,1
26284,ElliotBayTrailMyrtlePark,12/31/2016 04:00:00 AM,48,-122,0,0,0
26285,ElliotBayTrailMyrtlePark,12/31/2016 05:00:00 AM,48,-122,0,2,2
26286,ElliotBayTrailMyrtlePark,12/31/2016 06:00:00 AM,48,-122,0,2,2
26287,ElliotBayTrailMyrtlePark,12/31/2016 07:00:00 AM,48,-122,4,2,6
26288,ElliotBayTrailMyrtlePark,12/31/2016 08:00:00 AM,48,-122,2,5,7
26289,ElliotBayTrailMyrtlePark,12/31/2016 09:00:00 AM,48,-122,4,4,8
26290,ElliotBayTrailMyrtlePark,12/31/2016 10:00:00 AM,48,-122,7,5,12
26291,ElliotBayTrailMyrtlePark,12/31/2016 11:00:00 AM,48,-122,9,4,13
26292,ElliotBayTrailMyrtlePark,12/31/2016 12:00:00 PM,48,-122,6,5,11
26293,ElliotBayTrailMyrtlePark,12/31/2016 01:00:00 PM,48,-122,7,7,14
26294,ElliotBayTrailMyrtlePark,12/31/2016 02:00:00 PM,48,-122,16,9,25
26295,ElliotBayTrailMyrtlePark,12/31/2016 03:00:00 PM,48,-122,3,10,13
26296,ElliotBayTrailMyrtlePark,12/31/2016 04:00:00 PM,48,-122,7,4,11
26297,ElliotBayTrailMyrtlePark,12/31/2016 05:00:00 PM,48,-122,3,0,3
26298,ElliotBayTrailMyrtlePark,12/31/2016 06:00:00 PM,48,-122,2,0,2
26299,ElliotBayTrailMyrtlePark,12/31/2016 07:00:00 PM,48,-122,0,0,0
26300,ElliotBayTrailMyrtlePark,12/31/2016 08:00:00 PM,48,-122,0,0,0
26301,ElliotBayTrailMyrtlePark,12/31/2016 09:00:00 PM,48,-122,0,1,1
26302,ElliotBayTrailMyrtlePark,12/31/2016 10:00:00 PM,48,-122,0,0,0
26303,ElliotBayTrailMyrtlePark,12/31/2016 11:00:00 PM,48,-122,3,2,5
26304,ElliotBayTrailMyrtlePark,01/01/2017 12:00:00 AM,48,-122,0,0,0
26305,ElliotBayTrailMyrtlePark,01/01/2017 01:00:00 AM,48,-122,0,0,0
26306,ElliotBayTrailMyrtlePark,01/01/2017 02:00:00 AM,48,-122,1,1,2
26307,ElliotBayTrailMyrtlePark,01/01/2017 03:00:00 AM,48,-122,1,0,1
26308,ElliotBayTrailMyrtlePark,01/01/2017 04:00:00 AM,48,-122,0,1,1
26309,ElliotBayTrailMyrtlePark,01/01/2017 05:00:00 AM,48,-122,0,0,0
26310,ElliotBayTrailMyrtlePark,01/01/2017 06:00:00 AM,48,-122,0,3,3
26311,ElliotBayTrailMyrtlePark,01/01/2017 07:00:00 AM,48,-122,1,0,1
26312,ElliotBayTrailMyrtlePark,01/01/2017 08:00:00 AM,48,-122,4,1,5
26313,ElliotBayTrailMyrtlePark,01/01/2017 09:00:00 AM,48,-122,6,12,18
26314,ElliotBayTrailMyrtlePark,01/01/2017 10:00:00 AM,48,-122,1,4,5
26315,ElliotBayTrailMyrtlePark,01/01/2017 11:00:00 AM,48,-122,7,5,12
26316,ElliotBayTrailMyrtlePark,01/01/2017 12:00:00 PM,48,-122,10,10,20
26317,ElliotBayTrailMyrtlePark,01/01/2017 01:00:00 PM,48,-122,11,7,18
26318,ElliotBayTrailMyrtlePark,01/01/2017 02:00:00 PM,48,-122,20,24,44
26319,ElliotBayTrailMyrtlePark,01/01/2017 03:00:00 PM,48,-122,8,8,16
26320,ElliotBayTrailMyrtlePark,01/01/2017 04:00:00 PM,48,-122,9,10,19
26321,ElliotBayTrailMyrtlePark,01/01/2017 05:00:00 PM,48,-122,0,0,0
26322,ElliotBayTrailMyrtlePark,01/01/2017 06:00:00 PM,48,-122,1,0,1
26323,ElliotBayTrailMyrtlePark,01/01/2017 07:00:00 PM,48,-122,1,1,2
26324,ElliotBayTrailMyrtlePark,01/01/2017 08:00:00 PM,48,-122,0,1,1
26325,ElliotBayTrailMyrtlePark,01/01/2017 09:00:00 PM,48,-122,0,1,1
26326,ElliotBayTrailMyrtlePark,01/01/2017 10:00:00 PM,48,-122,0,0,0
26327,ElliotBayTrailMyrtlePark,01/01/2017 11:00:00 PM,48,-122,0,0,0
26328,ElliotBayTrailMyrtlePark,01/02/2017 12:00:00 AM,48,-122,0,0,0
26329,ElliotBayTrailMyrtlePark,01/02/2017 01:00:00 AM,48,-122,0,0,0
26330,ElliotBayTrailMyrtlePark,01/02/2017 02:00:00 AM,48,-122,0,0,0
26331,ElliotBayTrailMyrtlePark,01/02/2017 03:00:00 AM,48,-122,0,0,0
26332,ElliotBayTrailMyrtlePark,01/02/2017 04:00:00 AM,48,-122,0,0,0
26333,ElliotBayTrailMyrtlePark,01/02/2017 05:00:00 AM,48,-122,2,2,4
26334,ElliotBayTrailMyrtlePark,01/02/2017 06:00:00 AM,48,-122,0,1,1
26335,ElliotBayTrailMyrtlePark,01/02/2017 07:00:00 AM,48,-122,6,2,8
26336,ElliotBayTrailMyrtlePark,01/02/2017 08:00:00 AM,48,-122,5,6,11
26337,ElliotBayTrailMyrtlePark,01/02/2017 09:00:00 AM,48,-122,7,1,8
26338,ElliotBayTrailMyrtlePark,01/02/2017 10:00:00 AM,48,-122,6,6,12
26339,ElliotBayTrailMyrtlePark,01/02/2017 11:00:00 AM,48,-122,16,19,35
26340,ElliotBayTrailMyrtlePark,01/02/2017 12:00:00 PM,48,-122,13,23,36
26341,ElliotBayTrailMyrtlePark,01/02/2017 01:00:00 PM,48,-122,26,19,45
26342,ElliotBayTrailMyrtlePark,01/02/2017 02:00:00 PM,48,-122,29,24,53
26343,ElliotBayTrailMyrtlePark,01/02/2017 03:00:00 PM,48,-122,26,20,46
26344,ElliotBayTrailMyrtlePark,01/02/2017 04:00:00 PM,48,-122,14,16,30
26345,ElliotBayTrailMyrtlePark,01/02/2017 05:00:00 PM,48,-122,11,5,16
26346,ElliotBayTrailMyrtlePark,01/02/2017 06:00:00 PM,48,-122,2,1,3
26347,ElliotBayTrailMyrtlePark,01/02/2017 07:00:00 PM,48,-122,2,1,3
26348,ElliotBayTrailMyrtlePark,01/02/2017 08:00:00 PM,48,-122,1,0,1
26349,ElliotBayTrailMyrtlePark,01/02/2017 09:00:00 PM,48,-122,1,2,3
26350,ElliotBayTrailMyrtlePark,01/02/2017 10:00:00 PM,48,-122,0,0,0
26351,ElliotBayTrailMyrtlePark,01/02/2017 11:00:00 PM,48,-122,0,0,0
26352,ElliotBayTrailMyrtlePark,01/03/2017 12:00:00 AM,48,-122,1,0,1
26353,ElliotBayTrailMyrtlePark,01/03/2017 01:00:00 AM,48,-122,0,0,0
26354,ElliotBayTrailMyrtlePark,01/03/2017 02:00:00 AM,48,-122,2,0,2
26355,ElliotBayTrailMyrtlePark,01/03/2017 03:00:00 AM,48,-122,0,1,1
26356,ElliotBayTrailMyrtlePark,01/03/2017 04:00:00 AM,48,-122,1,0,1
26357,ElliotBayTrailMyrtlePark,01/03/2017 05:00:00 AM,48,-122,6,11,17
26358,ElliotBayTrailMyrtlePark,01/03/2017 06:00:00 AM,48,-122,13,21,34
26359,ElliotBayTrailMyrtlePark,01/03/2017 07:00:00 AM,48,-122,19,62,81
26360,ElliotBayTrailMyrtlePark,01/03/2017 08:00:00 AM,48,-122,19,57,76
26361,ElliotBayTrailMyrtlePark,01/03/2017 09:00:00 AM,48,-122,8,16,24
26362,ElliotBayTrailMyrtlePark,01/03/2017 10:00:00 AM,48,-122,4,9,13
26363,ElliotBayTrailMyrtlePark,01/03/2017 11:00:00 AM,48,-122,3,9,12
26364,ElliotBayTrailMyrtlePark,01/03/2017 12:00:00 PM,48,-122,15,10,25
26365,ElliotBayTrailMyrtlePark,01/03/2017 01:00:00 PM,48,-122,10,7,17
26366,ElliotBayTrailMyrtlePark,01/03/2017 02:00:00 PM,48,-122,4,16,20
26367,ElliotBayTrailMyrtlePark,01/03/2017 03:00:00 PM,48,-122,21,26,47
26368,ElliotBayTrailMyrtlePark,01/03/2017 04:00:00 PM,48,-122,52,27,79
26369,ElliotBayTrailMyrtlePark,01/03/2017 05:00:00 PM,48,-122,86,9,95
26370,ElliotBayTrailMyrtlePark,01/03/2017 06:00:00 PM,48,-122,30,1,31
26371,ElliotBayTrailMyrtlePark,01/03/2017 07:00:00 PM,48,-122,4,2,6
26372,ElliotBayTrailMyrtlePark,01/03/2017 08:00:00 PM,48,-122,1,1,2
26373,ElliotBayTrailMyrtlePark,01/03/2017 09:00:00 PM,48,-122,1,1,2
26374,ElliotBayTrailMyrtlePark,01/03/2017 10:00:00 PM,48,-122,0,0,0
26375,ElliotBayTrailMyrtlePark,01/03/2017 11:00:00 PM,48,-122,1,0,1
26376,ElliotBayTrailMyrtlePark,01/04/2017 12:00:00 AM,48,-122,0,0,0
26377,ElliotBayTrailMyrtlePark,01/04/2017 01:00:00 AM,48,-122,0,0,0
26378,ElliotBayTrailMyrtlePark,01/04/2017 02:00:00 AM,48,-122,2,0,2
26379,ElliotBayTrailMyrtlePark,01/04/2017 03:00:00 AM,48,-122,0,1,1
26380,ElliotBayTrailMyrtlePark,01/04/2017 04:00:00 AM,48,-122,0,2,2
26381,ElliotBayTrailMyrtlePark,01/04/2017 05:00:00 AM,48,-122,12,7,19
26382,ElliotBayTrailMyrtlePark,01/04/2017 06:00:00 AM,48,-122,5,21,26
26383,ElliotBayTrailMyrtlePark,01/04/2017 07:00:00 AM,48,-122,22,59,81
26384,ElliotBayTrailMyrtlePark,01/04/2017 08:00:00 AM,48,-122,17,56,73
26385,ElliotBayTrailMyrtlePark,01/04/2017 09:00:00 AM,48,-122,5,18,23
26386,ElliotBayTrailMyrtlePark,01/04/2017 10:00:00 AM,48,-122,4,6,10
26387,ElliotBayTrailMyrtlePark,01/04/2017 11:00:00 AM,48,-122,7,5,12
26388,ElliotBayTrailMyrtlePark,01/04/2017 12:00:00 PM,48,-122,6,12,18
26389,ElliotBayTrailMyrtlePark,01/04/2017 01:00:00 PM,48,-122,10,7,17
26390,ElliotBayTrailMyrtlePark,01/04/2017 02:00:00 PM,48,-122,14,13,27
26391,ElliotBayTrailMyrtlePark,01/04/2017 03:00:00 PM,48,-122,22,32,54
26392,ElliotBayTrailMyrtlePark,01/04/2017 04:00:00 PM,48,-122,63,31,94
26393,ElliotBayTrailMyrtlePark,01/04/2017 05:00:00 PM,48,-122,75,15,90
26394,ElliotBayTrailMyrtlePark,01/04/2017 06:00:00 PM,48,-122,30,3,33
26395,ElliotBayTrailMyrtlePark,01/04/2017 07:00:00 PM,48,-122,3,1,4
26396,ElliotBayTrailMyrtlePark,01/04/2017 08:00:00 PM,48,-122,1,0,1
26397,ElliotBayTrailMyrtlePark,01/04/2017 09:00:00 PM,48,-122,3,0,3
26398,ElliotBayTrailMyrtlePark,01/04/2017 10:00:00 PM,48,-122,1,0,1
26399,ElliotBayTrailMyrtlePark,01/04/2017 11:00:00 PM,48,-122,0,0,0
26400,ElliotBayTrailMyrtlePark,01/05/2017 12:00:00 AM,48,-122,0,0,0
26401,ElliotBayTrailMyrtlePark,01/05/2017 01:00:00 AM,48,-122,0,0,0
26402,ElliotBayTrailMyrtlePark,01/05/2017 02:00:00 AM,48,-122,1,0,1
26403,ElliotBayTrailMyrtlePark,01/05/2017 03:00:00 AM,48,-122,0,1,1
26404,ElliotBayTrailMyrtlePark,01/05/2017 04:00:00 AM,48,-122,1,1,2
26405,ElliotBayTrailMyrtlePark,01/05/2017 05:00:00 AM,48,-122,8,9,17
26406,ElliotBayTrailMyrtlePark,01/05/2017 06:00:00 AM,48,-122,9,22,31
26407,ElliotBayTrailMyrtlePark,01/05/2017 07:00:00 AM,48,-122,18,46,64
26408,ElliotBayTrailMyrtlePark,01/05/2017 08:00:00 AM,48,-122,27,59,86
26409,ElliotBayTrailMyrtlePark,01/05/2017 09:00:00 AM,48,-122,15,29,44
26410,ElliotBayTrailMyrtlePark,01/05/2017 10:00:00 AM,48,-122,4,8,12
26411,ElliotBayTrailMyrtlePark,01/05/2017 11:00:00 AM,48,-122,6,4,10
26412,ElliotBayTrailMyrtlePark,01/05/2017 12:00:00 PM,48,-122,14,10,24
26413,ElliotBayTrailMyrtlePark,01/05/2017 01:00:00 PM,48,-122,14,10,24
26414,ElliotBayTrailMyrtlePark,01/05/2017 02:00:00 PM,48,-122,14,10,24
26415,ElliotBayTrailMyrtlePark,01/05/2017 03:00:00 PM,48,-122,34,25,59
26416,ElliotBayTrailMyrtlePark,01/05/2017 04:00:00 PM,48,-122,59,26,85
26417,ElliotBayTrailMyrtlePark,01/05/2017 05:00:00 PM,48,-122,72,14,86
26418,ElliotBayTrailMyrtlePark,01/05/2017 06:00:00 PM,48,-122,37,2,39
26419,ElliotBayTrailMyrtlePark,01/05/2017 07:00:00 PM,48,-122,2,1,3
26420,ElliotBayTrailMyrtlePark,01/05/2017 08:00:00 PM,48,-122,4,0,4
26421,ElliotBayTrailMyrtlePark,01/05/2017 09:00:00 PM,48,-122,0,2,2
26422,ElliotBayTrailMyrtlePark,01/05/2017 10:00:00 PM,48,-122,0,1,1
26423,ElliotBayTrailMyrtlePark,01/05/2017 11:00:00 PM,48,-122,0,0,0
26424,ElliotBayTrailMyrtlePark,01/06/2017 12:00:00 AM,48,-122,1,0,1
26425,ElliotBayTrailMyrtlePark,01/06/2017 01:00:00 AM,48,-122,0,0,0
26426,ElliotBayTrailMyrtlePark,01/06/2017 02:00:00 AM,48,-122,0,0,0
26427,ElliotBayTrailMyrtlePark,01/06/2017 03:00:00 AM,48,-122,0,0,0
26428,ElliotBayTrailMyrtlePark,01/06/2017 04:00:00 AM,48,-122,0,2,2
26429,ElliotBayTrailMyrtlePark,01/06/2017 05:00:00 AM,48,-122,10,8,18
26430,ElliotBayTrailMyrtlePark,01/06/2017 06:00:00 AM,48,-122,10,11,21
26431,ElliotBayTrailMyrtlePark,01/06/2017 07:00:00 AM,48,-122,19,51,70
26432,ElliotBayTrailMyrtlePark,01/06/2017 08:00:00 AM,48,-122,17,57,74
26433,ElliotBayTrailMyrtlePark,01/06/2017 09:00:00 AM,48,-122,12,11,23
26434,ElliotBayTrailMyrtlePark,01/06/2017 10:00:00 AM,48,-122,6,20,26
26435,ElliotBayTrailMyrtlePark,01/06/2017 11:00:00 AM,48,-122,5,3,8
26436,ElliotBayTrailMyrtlePark,01/06/2017 12:00:00 PM,48,-122,17,7,24
26437,ElliotBayTrailMyrtlePark,01/06/2017 01:00:00 PM,48,-122,19,14,33
26438,ElliotBayTrailMyrtlePark,01/06/2017 02:00:00 PM,48,-122,12,17,29
26439,ElliotBayTrailMyrtlePark,01/06/2017 03:00:00 PM,48,-122,21,18,39
26440,ElliotBayTrailMyrtlePark,01/06/2017 04:00:00 PM,48,-122,61,28,89
26441,ElliotBayTrailMyrtlePark,01/06/2017 05:00:00 PM,48,-122,72,15,87
26442,ElliotBayTrailMyrtlePark,01/06/2017 06:00:00 PM,48,-122,24,6,30
26443,ElliotBayTrailMyrtlePark,01/06/2017 07:00:00 PM,48,-122,6,0,6
26444,ElliotBayTrailMyrtlePark,01/06/2017 08:00:00 PM,48,-122,1,1,2
26445,ElliotBayTrailMyrtlePark,01/06/2017 09:00:00 PM,48,-122,2,3,5
26446,ElliotBayTrailMyrtlePark,01/06/2017 10:00:00 PM,48,-122,1,0,1
26447,ElliotBayTrailMyrtlePark,01/06/2017 11:00:00 PM,48,-122,2,0,2
26448,ElliotBayTrailMyrtlePark,01/07/2017 12:00:00 AM,48,-122,1,0,1
26449,ElliotBayTrailMyrtlePark,01/07/2017 01:00:00 AM,48,-122,0,0,0
26450,ElliotBayTrailMyrtlePark,01/07/2017 02:00:00 AM,48,-122,0,0,0
26451,ElliotBayTrailMyrtlePark,01/07/2017 03:00:00 AM,48,-122,0,0,0
26452,ElliotBayTrailMyrtlePark,01/07/2017 04:00:00 AM,48,-122,0,0,0
26453,ElliotBayTrailMyrtlePark,01/07/2017 05:00:00 AM,48,-122,0,2,2
26454,ElliotBayTrailMyrtlePark,01/07/2017 06:00:00 AM,48,-122,1,2,3
26455,ElliotBayTrailMyrtlePark,01/07/2017 07:00:00 AM,48,-122,5,5,10
26456,ElliotBayTrailMyrtlePark,01/07/2017 08:00:00 AM,48,-122,5,11,16
26457,ElliotBayTrailMyrtlePark,01/07/2017 09:00:00 AM,48,-122,16,3,19
26458,ElliotBayTrailMyrtlePark,01/07/2017 10:00:00 AM,48,-122,14,13,27
26459,ElliotBayTrailMyrtlePark,01/07/2017 11:00:00 AM,48,-122,17,12,29
26460,ElliotBayTrailMyrtlePark,01/07/2017 12:00:00 PM,48,-122,18,13,31
26461,ElliotBayTrailMyrtlePark,01/07/2017 01:00:00 PM,48,-122,20,21,41
26462,ElliotBayTrailMyrtlePark,01/07/2017 02:00:00 PM,48,-122,15,14,29
26463,ElliotBayTrailMyrtlePark,01/07/2017 03:00:00 PM,48,-122,21,15,36
26464,ElliotBayTrailMyrtlePark,01/07/2017 04:00:00 PM,48,-122,6,9,15
26465,ElliotBayTrailMyrtlePark,01/07/2017 05:00:00 PM,48,-122,4,3,7
26466,ElliotBayTrailMyrtlePark,01/07/2017 06:00:00 PM,48,-122,4,1,5
26467,ElliotBayTrailMyrtlePark,01/07/2017 07:00:00 PM,48,-122,2,2,4
26468,ElliotBayTrailMyrtlePark,01/07/2017 08:00:00 PM,48,-122,4,0,4
26469,ElliotBayTrailMyrtlePark,01/07/2017 09:00:00 PM,48,-122,1,3,4
26470,ElliotBayTrailMyrtlePark,01/07/2017 10:00:00 PM,48,-122,7,0,7
26471,ElliotBayTrailMyrtlePark,01/07/2017 11:00:00 PM,48,-122,1,1,2
26472,ElliotBayTrailMyrtlePark,01/08/2017 12:00:00 AM,48,-122,0,0,0
26473,ElliotBayTrailMyrtlePark,01/08/2017 01:00:00 AM,48,-122,1,0,1
26474,ElliotBayTrailMyrtlePark,01/08/2017 02:00:00 AM,48,-122,0,0,0
26475,ElliotBayTrailMyrtlePark,01/08/2017 03:00:00 AM,48,-122,1,0,1
26476,ElliotBayTrailMyrtlePark,01/08/2017 04:00:00 AM,48,-122,3,0,3
26477,ElliotBayTrailMyrtlePark,01/08/2017 05:00:00 AM,48,-122,1,1,2
26478,ElliotBayTrailMyrtlePark,01/08/2017 06:00:00 AM,48,-122,1,0,1
26479,ElliotBayTrailMyrtlePark,01/08/2017 07:00:00 AM,48,-122,2,0,2
26480,ElliotBayTrailMyrtlePark,01/08/2017 08:00:00 AM,48,-122,6,6,12
26481,ElliotBayTrailMyrtlePark,01/08/2017 09:00:00 AM,48,-122,2,4,6
26482,ElliotBayTrailMyrtlePark,01/08/2017 10:00:00 AM,48,-122,4,2,6
26483,ElliotBayTrailMyrtlePark,01/08/2017 11:00:00 AM,48,-122,5,2,7
26484,ElliotBayTrailMyrtlePark,01/08/2017 12:00:00 PM,48,-122,1,4,5
26485,ElliotBayTrailMyrtlePark,01/08/2017 01:00:00 PM,48,-122,3,4,7
26486,ElliotBayTrailMyrtlePark,01/08/2017 02:00:00 PM,48,-122,1,2,3
26487,ElliotBayTrailMyrtlePark,01/08/2017 03:00:00 PM,48,-122,1,3,4
26488,ElliotBayTrailMyrtlePark,01/08/2017 04:00:00 PM,48,-122,1,1,2
26489,ElliotBayTrailMyrtlePark,01/08/2017 05:00:00 PM,48,-122,1,2,3
26490,ElliotBayTrailMyrtlePark,01/08/2017 06:00:00 PM,48,-122,1,1,2
26491,ElliotBayTrailMyrtlePark,01/08/2017 07:00:00 PM,48,-122,0,0,0
26492,ElliotBayTrailMyrtlePark,01/08/2017 08:00:00 PM,48,-122,1,1,2
26493,ElliotBayTrailMyrtlePark,01/08/2017 09:00:00 PM,48,-122,0,0,0
26494,ElliotBayTrailMyrtlePark,01/08/2017 10:00:00 PM,48,-122,0,0,0
26495,ElliotBayTrailMyrtlePark,01/08/2017 11:00:00 PM,48,-122,1,0,1
26496,ElliotBayTrailMyrtlePark,01/09/2017 12:00:00 AM,48,-122,0,2,2
26497,ElliotBayTrailMyrtlePark,01/09/2017 01:00:00 AM,48,-122,0,0,0
26498,ElliotBayTrailMyrtlePark,01/09/2017 02:00:00 AM,48,-122,0,0,0
26499,ElliotBayTrailMyrtlePark,01/09/2017 03:00:00 AM,48,-122,0,0,0
26500,ElliotBayTrailMyrtlePark,01/09/2017 04:00:00 AM,48,-122,0,1,1
26501,ElliotBayTrailMyrtlePark,01/09/2017 05:00:00 AM,48,-122,3,2,5
26502,ElliotBayTrailMyrtlePark,01/09/2017 06:00:00 AM,48,-122,7,13,20
26503,ElliotBayTrailMyrtlePark,01/09/2017 07:00:00 AM,48,-122,14,24,38
26504,ElliotBayTrailMyrtlePark,01/09/2017 08:00:00 AM,48,-122,27,74,101
26505,ElliotBayTrailMyrtlePark,01/09/2017 09:00:00 AM,48,-122,24,86,110
26506,ElliotBayTrailMyrtlePark,01/09/2017 10:00:00 AM,48,-122,12,19,31
26507,ElliotBayTrailMyrtlePark,01/09/2017 11:00:00 AM,48,-122,7,14,21
26508,ElliotBayTrailMyrtlePark,01/09/2017 12:00:00 PM,48,-122,5,7,12
26509,ElliotBayTrailMyrtlePark,01/09/2017 01:00:00 PM,48,-122,5,5,10
26510,ElliotBayTrailMyrtlePark,01/09/2017 02:00:00 PM,48,-122,6,7,13
26511,ElliotBayTrailMyrtlePark,01/09/2017 03:00:00 PM,48,-122,11,10,21
26512,ElliotBayTrailMyrtlePark,01/09/2017 04:00:00 PM,48,-122,23,22,45
26513,ElliotBayTrailMyrtlePark,01/09/2017 05:00:00 PM,48,-122,77,28,105
26514,ElliotBayTrailMyrtlePark,01/09/2017 06:00:00 PM,48,-122,87,10,97
26515,ElliotBayTrailMyrtlePark,01/09/2017 07:00:00 PM,48,-122,47,3,50
26516,ElliotBayTrailMyrtlePark,01/09/2017 08:00:00 PM,48,-122,3,1,4
26517,ElliotBayTrailMyrtlePark,01/09/2017 09:00:00 PM,48,-122,4,0,4
26518,ElliotBayTrailMyrtlePark,01/09/2017 10:00:00 PM,48,-122,1,2,3
26519,ElliotBayTrailMyrtlePark,01/09/2017 11:00:00 PM,48,-122,2,1,3
26520,ElliotBayTrailMyrtlePark,01/10/2017 12:00:00 AM,48,-122,2,0,2
26521,ElliotBayTrailMyrtlePark,01/10/2017 01:00:00 AM,48,-122,1,2,3
26522,ElliotBayTrailMyrtlePark,01/10/2017 02:00:00 AM,48,-122,1,1,2
26523,ElliotBayTrailMyrtlePark,01/10/2017 03:00:00 AM,48,-122,0,0,0
26524,ElliotBayTrailMyrtlePark,01/10/2017 04:00:00 AM,48,-122,0,1,1
26525,ElliotBayTrailMyrtlePark,01/10/2017 05:00:00 AM,48,-122,2,1,3
26526,ElliotBayTrailMyrtlePark,01/10/2017 06:00:00 AM,48,-122,7,12,19
26527,ElliotBayTrailMyrtlePark,01/10/2017 07:00:00 AM,48,-122,8,18,26
26528,ElliotBayTrailMyrtlePark,01/10/2017 08:00:00 AM,48,-122,14,54,68
26529,ElliotBayTrailMyrtlePark,01/10/2017 09:00:00 AM,48,-122,15,56,71
26530,ElliotBayTrailMyrtlePark,01/10/2017 10:00:00 AM,48,-122,4,18,22
26531,ElliotBayTrailMyrtlePark,01/10/2017 11:00:00 AM,48,-122,8,10,18
26532,ElliotBayTrailMyrtlePark,01/10/2017 12:00:00 PM,48,-122,4,6,10
26533,ElliotBayTrailMyrtlePark,01/10/2017 01:00:00 PM,48,-122,5,3,8
26534,ElliotBayTrailMyrtlePark,01/10/2017 02:00:00 PM,48,-122,6,6,12
26535,ElliotBayTrailMyrtlePark,01/10/2017 03:00:00 PM,48,-122,8,12,20
26536,ElliotBayTrailMyrtlePark,01/10/2017 04:00:00 PM,48,-122,23,19,42
26537,ElliotBayTrailMyrtlePark,01/10/2017 05:00:00 PM,48,-122,49,26,75
26538,ElliotBayTrailMyrtlePark,01/10/2017 06:00:00 PM,48,-122,76,9,85
26539,ElliotBayTrailMyrtlePark,01/10/2017 07:00:00 PM,48,-122,6,0,6
26540,ElliotBayTrailMyrtlePark,01/10/2017 08:00:00 PM,48,-122,4,2,6
26541,ElliotBayTrailMyrtlePark,01/10/2017 09:00:00 PM,48,-122,3,2,5
26542,ElliotBayTrailMyrtlePark,01/10/2017 10:00:00 PM,48,-122,1,1,2
26543,ElliotBayTrailMyrtlePark,01/10/2017 11:00:00 PM,48,-122,1,0,1
26544,ElliotBayTrailMyrtlePark,01/11/2017 12:00:00 AM,48,-122,0,0,0
26545,ElliotBayTrailMyrtlePark,01/11/2017 01:00:00 AM,48,-122,0,0,0
26546,ElliotBayTrailMyrtlePark,01/11/2017 02:00:00 AM,48,-122,0,0,0
26547,ElliotBayTrailMyrtlePark,01/11/2017 03:00:00 AM,48,-122,1,1,2
26548,ElliotBayTrailMyrtlePark,01/11/2017 04:00:00 AM,48,-122,2,2,4
26549,ElliotBayTrailMyrtlePark,01/11/2017 05:00:00 AM,48,-122,10,12,22
26550,ElliotBayTrailMyrtlePark,01/11/2017 06:00:00 AM,48,-122,8,18,26
26551,ElliotBayTrailMyrtlePark,01/11/2017 07:00:00 AM,48,-122,18,61,79
26552,ElliotBayTrailMyrtlePark,01/11/2017 08:00:00 AM,48,-122,22,63,85
26553,ElliotBayTrailMyrtlePark,01/11/2017 09:00:00 AM,48,-122,7,18,25
26554,ElliotBayTrailMyrtlePark,01/11/2017 10:00:00 AM,48,-122,16,12,28
26555,ElliotBayTrailMyrtlePark,01/11/2017 11:00:00 AM,48,-122,9,8,17
26556,ElliotBayTrailMyrtlePark,01/11/2017 12:00:00 PM,48,-122,11,12,23
26557,ElliotBayTrailMyrtlePark,01/11/2017 01:00:00 PM,48,-122,10,9,19
26558,ElliotBayTrailMyrtlePark,01/11/2017 02:00:00 PM,48,-122,11,13,24
26559,ElliotBayTrailMyrtlePark,01/11/2017 03:00:00 PM,48,-122,16,13,29
26560,ElliotBayTrailMyrtlePark,01/11/2017 04:00:00 PM,48,-122,42,31,73
26561,ElliotBayTrailMyrtlePark,01/11/2017 05:00:00 PM,48,-122,88,13,101
26562,ElliotBayTrailMyrtlePark,01/11/2017 06:00:00 PM,48,-122,31,6,37
26563,ElliotBayTrailMyrtlePark,01/11/2017 07:00:00 PM,48,-122,7,0,7
26564,ElliotBayTrailMyrtlePark,01/11/2017 08:00:00 PM,48,-122,1,0,1
26565,ElliotBayTrailMyrtlePark,01/11/2017 09:00:00 PM,48,-122,1,0,1
26566,ElliotBayTrailMyrtlePark,01/11/2017 10:00:00 PM,48,-122,2,2,4
26567,ElliotBayTrailMyrtlePark,01/11/2017 11:00:00 PM,48,-122,1,0,1
26568,ElliotBayTrailMyrtlePark,01/12/2017 12:00:00 AM,48,-122,0,0,0
26569,ElliotBayTrailMyrtlePark,01/12/2017 01:00:00 AM,48,-122,0,0,0
26570,ElliotBayTrailMyrtlePark,01/12/2017 02:00:00 AM,48,-122,1,0,1
26571,ElliotBayTrailMyrtlePark,01/12/2017 03:00:00 AM,48,-122,0,1,1
26572,ElliotBayTrailMyrtlePark,01/12/2017 04:00:00 AM,48,-122,0,1,1
26573,ElliotBayTrailMyrtlePark,01/12/2017 05:00:00 AM,48,-122,8,8,16
26574,ElliotBayTrailMyrtlePark,01/12/2017 06:00:00 AM,48,-122,15,18,33
26575,ElliotBayTrailMyrtlePark,01/12/2017 07:00:00 AM,48,-122,15,65,80
26576,ElliotBayTrailMyrtlePark,01/12/2017 08:00:00 AM,48,-122,19,67,86
26577,ElliotBayTrailMyrtlePark,01/12/2017 09:00:00 AM,48,-122,9,24,33
26578,ElliotBayTrailMyrtlePark,01/12/2017 10:00:00 AM,48,-122,6,9,15
26579,ElliotBayTrailMyrtlePark,01/12/2017 11:00:00 AM,48,-122,7,5,12
26580,ElliotBayTrailMyrtlePark,01/12/2017 12:00:00 PM,48,-122,12,11,23
26581,ElliotBayTrailMyrtlePark,01/12/2017 01:00:00 PM,48,-122,19,15,34
26582,ElliotBayTrailMyrtlePark,01/12/2017 02:00:00 PM,48,-122,11,16,27
26583,ElliotBayTrailMyrtlePark,01/12/2017 03:00:00 PM,48,-122,14,30,44
26584,ElliotBayTrailMyrtlePark,01/12/2017 04:00:00 PM,48,-122,60,22,82
26585,ElliotBayTrailMyrtlePark,01/12/2017 05:00:00 PM,48,-122,81,19,100
26586,ElliotBayTrailMyrtlePark,01/12/2017 06:00:00 PM,48,-122,40,1,41
26587,ElliotBayTrailMyrtlePark,01/12/2017 07:00:00 PM,48,-122,7,3,10
26588,ElliotBayTrailMyrtlePark,01/12/2017 08:00:00 PM,48,-122,2,5,7
26589,ElliotBayTrailMyrtlePark,01/12/2017 09:00:00 PM,48,-122,1,0,1
26590,ElliotBayTrailMyrtlePark,01/12/2017 10:00:00 PM,48,-122,2,0,2
26591,ElliotBayTrailMyrtlePark,01/12/2017 11:00:00 PM,48,-122,2,1,3
26592,ElliotBayTrailMyrtlePark,01/13/2017 12:00:00 AM,48,-122,1,2,3
26593,ElliotBayTrailMyrtlePark,01/13/2017 01:00:00 AM,48,-122,1,3,4
26594,ElliotBayTrailMyrtlePark,01/13/2017 02:00:00 AM,48,-122,0,2,2
26595,ElliotBayTrailMyrtlePark,01/13/2017 03:00:00 AM,48,-122,0,0,0
26596,ElliotBayTrailMyrtlePark,01/13/2017 04:00:00 AM,48,-122,0,4,4
26597,ElliotBayTrailMyrtlePark,01/13/2017 05:00:00 AM,48,-122,5,9,14
26598,ElliotBayTrailMyrtlePark,01/13/2017 06:00:00 AM,48,-122,12,20,32
26599,ElliotBayTrailMyrtlePark,01/13/2017 07:00:00 AM,48,-122,22,53,75
26600,ElliotBayTrailMyrtlePark,01/13/2017 08:00:00 AM,48,-122,17,55,72
26601,ElliotBayTrailMyrtlePark,01/13/2017 09:00:00 AM,48,-122,7,26,33
26602,ElliotBayTrailMyrtlePark,01/13/2017 10:00:00 AM,48,-122,5,6,11
26603,ElliotBayTrailMyrtlePark,01/13/2017 11:00:00 AM,48,-122,3,3,6
26604,ElliotBayTrailMyrtlePark,01/13/2017 12:00:00 PM,48,-122,16,8,24
26605,ElliotBayTrailMyrtlePark,01/13/2017 01:00:00 PM,48,-122,15,14,29
26606,ElliotBayTrailMyrtlePark,01/13/2017 02:00:00 PM,48,-122,13,10,23
26607,ElliotBayTrailMyrtlePark,01/13/2017 03:00:00 PM,48,-122,28,17,45
26608,ElliotBayTrailMyrtlePark,01/13/2017 04:00:00 PM,48,-122,54,32,86
26609,ElliotBayTrailMyrtlePark,01/13/2017 05:00:00 PM,48,-122,66,10,76
26610,ElliotBayTrailMyrtlePark,01/13/2017 06:00:00 PM,48,-122,30,2,32
26611,ElliotBayTrailMyrtlePark,01/13/2017 07:00:00 PM,48,-122,6,1,7
26612,ElliotBayTrailMyrtlePark,01/13/2017 08:00:00 PM,48,-122,1,1,2
26613,ElliotBayTrailMyrtlePark,01/13/2017 09:00:00 PM,48,-122,0,1,1
26614,ElliotBayTrailMyrtlePark,01/13/2017 10:00:00 PM,48,-122,1,3,4
26615,ElliotBayTrailMyrtlePark,01/13/2017 11:00:00 PM,48,-122,1,0,1
26616,ElliotBayTrailMyrtlePark,01/14/2017 12:00:00 AM,48,-122,1,0,1
26617,ElliotBayTrailMyrtlePark,01/14/2017 01:00:00 AM,48,-122,0,1,1
26618,ElliotBayTrailMyrtlePark,01/14/2017 02:00:00 AM,48,-122,1,0,1
26619,ElliotBayTrailMyrtlePark,01/14/2017 03:00:00 AM,48,-122,0,0,0
26620,ElliotBayTrailMyrtlePark,01/14/2017 04:00:00 AM,48,-122,0,0,0
26621,ElliotBayTrailMyrtlePark,01/14/2017 05:00:00 AM,48,-122,1,3,4
26622,ElliotBayTrailMyrtlePark,01/14/2017 06:00:00 AM,48,-122,0,5,5
26623,ElliotBayTrailMyrtlePark,01/14/2017 07:00:00 AM,48,-122,5,2,7
26624,ElliotBayTrailMyrtlePark,01/14/2017 08:00:00 AM,48,-122,6,5,11
26625,ElliotBayTrailMyrtlePark,01/14/2017 09:00:00 AM,48,-122,4,3,7
26626,ElliotBayTrailMyrtlePark,01/14/2017 10:00:00 AM,48,-122,22,18,40
26627,ElliotBayTrailMyrtlePark,01/14/2017 11:00:00 AM,48,-122,18,15,33
26628,ElliotBayTrailMyrtlePark,01/14/2017 12:00:00 PM,48,-122,23,21,44
26629,ElliotBayTrailMyrtlePark,01/14/2017 01:00:00 PM,48,-122,25,22,47
26630,ElliotBayTrailMyrtlePark,01/14/2017 02:00:00 PM,48,-122,20,22,42
26631,ElliotBayTrailMyrtlePark,01/14/2017 03:00:00 PM,48,-122,24,23,47
26632,ElliotBayTrailMyrtlePark,01/14/2017 04:00:00 PM,48,-122,13,15,28
26633,ElliotBayTrailMyrtlePark,01/14/2017 05:00:00 PM,48,-122,9,7,16
26634,ElliotBayTrailMyrtlePark,01/14/2017 06:00:00 PM,48,-122,0,1,1
26635,ElliotBayTrailMyrtlePark,01/14/2017 07:00:00 PM,48,-122,1,1,2
26636,ElliotBayTrailMyrtlePark,01/14/2017 08:00:00 PM,48,-122,1,3,4
26637,ElliotBayTrailMyrtlePark,01/14/2017 09:00:00 PM,48,-122,1,1,2
26638,ElliotBayTrailMyrtlePark,01/14/2017 10:00:00 PM,48,-122,1,0,1
26639,ElliotBayTrailMyrtlePark,01/14/2017 11:00:00 PM,48,-122,0,1,1
26640,ElliotBayTrailMyrtlePark,01/15/2017 12:00:00 AM,48,-122,1,0,1
26641,ElliotBayTrailMyrtlePark,01/15/2017 01:00:00 AM,48,-122,0,0,0
26642,ElliotBayTrailMyrtlePark,01/15/2017 02:00:00 AM,48,-122,0,0,0
26643,ElliotBayTrailMyrtlePark,01/15/2017 03:00:00 AM,48,-122,1,0,1
26644,ElliotBayTrailMyrtlePark,01/15/2017 04:00:00 AM,48,-122,0,0,0
26645,ElliotBayTrailMyrtlePark,01/15/2017 05:00:00 AM,48,-122,1,1,2
26646,ElliotBayTrailMyrtlePark,01/15/2017 06:00:00 AM,48,-122,1,1,2
26647,ElliotBayTrailMyrtlePark,01/15/2017 07:00:00 AM,48,-122,2,2,4
26648,ElliotBayTrailMyrtlePark,01/15/2017 08:00:00 AM,48,-122,3,4,7
26649,ElliotBayTrailMyrtlePark,01/15/2017 09:00:00 AM,48,-122,3,5,8
26650,ElliotBayTrailMyrtlePark,01/15/2017 10:00:00 AM,48,-122,17,11,28
26651,ElliotBayTrailMyrtlePark,01/15/2017 11:00:00 AM,48,-122,27,28,55
26652,ElliotBayTrailMyrtlePark,01/15/2017 12:00:00 PM,48,-122,40,45,85
26653,ElliotBayTrailMyrtlePark,01/15/2017 01:00:00 PM,48,-122,46,29,75
26654,ElliotBayTrailMyrtlePark,01/15/2017 02:00:00 PM,48,-122,33,41,74
26655,ElliotBayTrailMyrtlePark,01/15/2017 03:00:00 PM,48,-122,22,31,53
26656,ElliotBayTrailMyrtlePark,01/15/2017 04:00:00 PM,48,-122,3,12,15
26657,ElliotBayTrailMyrtlePark,01/15/2017 05:00:00 PM,48,-122,8,2,10
26658,ElliotBayTrailMyrtlePark,01/15/2017 06:00:00 PM,48,-122,2,1,3
26659,ElliotBayTrailMyrtlePark,01/15/2017 07:00:00 PM,48,-122,3,0,3
26660,ElliotBayTrailMyrtlePark,01/15/2017 08:00:00 PM,48,-122,1,5,6
26661,ElliotBayTrailMyrtlePark,01/15/2017 09:00:00 PM,48,-122,1,5,6
26662,ElliotBayTrailMyrtlePark,01/15/2017 10:00:00 PM,48,-122,0,2,2
26663,ElliotBayTrailMyrtlePark,01/15/2017 11:00:00 PM,48,-122,0,0,0
26664,ElliotBayTrailMyrtlePark,01/16/2017 12:00:00 AM,48,-122,0,1,1
26665,ElliotBayTrailMyrtlePark,01/16/2017 01:00:00 AM,48,-122,1,0,1
26666,ElliotBayTrailMyrtlePark,01/16/2017 02:00:00 AM,48,-122,0,0,0
26667,ElliotBayTrailMyrtlePark,01/16/2017 03:00:00 AM,48,-122,0,0,0
26668,ElliotBayTrailMyrtlePark,01/16/2017 04:00:00 AM,48,-122,3,0,3
26669,ElliotBayTrailMyrtlePark,01/16/2017 05:00:00 AM,48,-122,6,4,10
26670,ElliotBayTrailMyrtlePark,01/16/2017 06:00:00 AM,48,-122,7,14,21
26671,ElliotBayTrailMyrtlePark,01/16/2017 07:00:00 AM,48,-122,22,41,63
26672,ElliotBayTrailMyrtlePark,01/16/2017 08:00:00 AM,48,-122,23,50,73
26673,ElliotBayTrailMyrtlePark,01/16/2017 09:00:00 AM,48,-122,9,15,24
26674,ElliotBayTrailMyrtlePark,01/16/2017 10:00:00 AM,48,-122,8,9,17
26675,ElliotBayTrailMyrtlePark,01/16/2017 11:00:00 AM,48,-122,14,11,25
26676,ElliotBayTrailMyrtlePark,01/16/2017 12:00:00 PM,48,-122,15,14,29
26677,ElliotBayTrailMyrtlePark,01/16/2017 01:00:00 PM,48,-122,13,25,38
26678,ElliotBayTrailMyrtlePark,01/16/2017 02:00:00 PM,48,-122,28,14,42
26679,ElliotBayTrailMyrtlePark,01/16/2017 03:00:00 PM,48,-122,20,23,43
26680,ElliotBayTrailMyrtlePark,01/16/2017 04:00:00 PM,48,-122,34,22,56
26681,ElliotBayTrailMyrtlePark,01/16/2017 05:00:00 PM,48,-122,52,11,63
26682,ElliotBayTrailMyrtlePark,01/16/2017 06:00:00 PM,48,-122,18,1,19
26683,ElliotBayTrailMyrtlePark,01/16/2017 07:00:00 PM,48,-122,3,4,7
26684,ElliotBayTrailMyrtlePark,01/16/2017 08:00:00 PM,48,-122,2,3,5
26685,ElliotBayTrailMyrtlePark,01/16/2017 09:00:00 PM,48,-122,2,2,4
26686,ElliotBayTrailMyrtlePark,01/16/2017 10:00:00 PM,48,-122,0,2,2
26687,ElliotBayTrailMyrtlePark,01/16/2017 11:00:00 PM,48,-122,0,0,0
26688,ElliotBayTrailMyrtlePark,01/17/2017 12:00:00 AM,48,-122,0,0,0
26689,ElliotBayTrailMyrtlePark,01/17/2017 01:00:00 AM,48,-122,2,0,2
26690,ElliotBayTrailMyrtlePark,01/17/2017 02:00:00 AM,48,-122,0,1,1
26691,ElliotBayTrailMyrtlePark,01/17/2017 03:00:00 AM,48,-122,0,1,1
26692,ElliotBayTrailMyrtlePark,01/17/2017 04:00:00 AM,48,-122,0,2,2
26693,ElliotBayTrailMyrtlePark,01/17/2017 05:00:00 AM,48,-122,11,14,25
26694,ElliotBayTrailMyrtlePark,01/17/2017 06:00:00 AM,48,-122,11,17,28
26695,ElliotBayTrailMyrtlePark,01/17/2017 07:00:00 AM,48,-122,22,68,90
26696,ElliotBayTrailMyrtlePark,01/17/2017 08:00:00 AM,48,-122,30,72,102
26697,ElliotBayTrailMyrtlePark,01/17/2017 09:00:00 AM,48,-122,10,19,29
26698,ElliotBayTrailMyrtlePark,01/17/2017 10:00:00 AM,48,-122,10,6,16
26699,ElliotBayTrailMyrtlePark,01/17/2017 11:00:00 AM,48,-122,7,15,22
26700,ElliotBayTrailMyrtlePark,01/17/2017 12:00:00 PM,48,-122,2,1,3
26701,ElliotBayTrailMyrtlePark,01/17/2017 01:00:00 PM,48,-122,5,9,14
26702,ElliotBayTrailMyrtlePark,01/17/2017 02:00:00 PM,48,-122,3,13,16
26703,ElliotBayTrailMyrtlePark,01/17/2017 03:00:00 PM,48,-122,21,19,40
26704,ElliotBayTrailMyrtlePark,01/17/2017 04:00:00 PM,48,-122,46,27,73
26705,ElliotBayTrailMyrtlePark,01/17/2017 05:00:00 PM,48,-122,76,12,88
26706,ElliotBayTrailMyrtlePark,01/17/2017 06:00:00 PM,48,-122,35,6,41
26707,ElliotBayTrailMyrtlePark,01/17/2017 07:00:00 PM,48,-122,9,4,13
26708,ElliotBayTrailMyrtlePark,01/17/2017 08:00:00 PM,48,-122,4,6,10
26709,ElliotBayTrailMyrtlePark,01/17/2017 09:00:00 PM,48,-122,3,0,3
26710,ElliotBayTrailMyrtlePark,01/17/2017 10:00:00 PM,48,-122,2,3,5
26711,ElliotBayTrailMyrtlePark,01/17/2017 11:00:00 PM,48,-122,0,0,0
26712,ElliotBayTrailMyrtlePark,01/18/2017 12:00:00 AM,48,-122,1,0,1
26713,ElliotBayTrailMyrtlePark,01/18/2017 01:00:00 AM,48,-122,1,0,1
26714,ElliotBayTrailMyrtlePark,01/18/2017 02:00:00 AM,48,-122,0,0,0
26715,ElliotBayTrailMyrtlePark,01/18/2017 03:00:00 AM,48,-122,0,1,1
26716,ElliotBayTrailMyrtlePark,01/18/2017 04:00:00 AM,48,-122,0,4,4
26717,ElliotBayTrailMyrtlePark,01/18/2017 05:00:00 AM,48,-122,10,7,17
26718,ElliotBayTrailMyrtlePark,01/18/2017 06:00:00 AM,48,-122,8,15,23
26719,ElliotBayTrailMyrtlePark,01/18/2017 07:00:00 AM,48,-122,17,50,67
26720,ElliotBayTrailMyrtlePark,01/18/2017 08:00:00 AM,48,-122,18,37,55
26721,ElliotBayTrailMyrtlePark,01/18/2017 09:00:00 AM,48,-122,7,18,25
26722,ElliotBayTrailMyrtlePark,01/18/2017 10:00:00 AM,48,-122,4,4,8
26723,ElliotBayTrailMyrtlePark,01/18/2017 11:00:00 AM,48,-122,6,4,10
26724,ElliotBayTrailMyrtlePark,01/18/2017 12:00:00 PM,48,-122,7,4,11
26725,ElliotBayTrailMyrtlePark,01/18/2017 01:00:00 PM,48,-122,13,6,19
26726,ElliotBayTrailMyrtlePark,01/18/2017 02:00:00 PM,48,-122,14,7,21
26727,ElliotBayTrailMyrtlePark,01/18/2017 03:00:00 PM,48,-122,17,22,39
26728,ElliotBayTrailMyrtlePark,01/18/2017 04:00:00 PM,48,-122,41,26,67
26729,ElliotBayTrailMyrtlePark,01/18/2017 05:00:00 PM,48,-122,75,8,83
26730,ElliotBayTrailMyrtlePark,01/18/2017 06:00:00 PM,48,-122,19,0,19
26731,ElliotBayTrailMyrtlePark,01/18/2017 07:00:00 PM,48,-122,1,1,2
26732,ElliotBayTrailMyrtlePark,01/18/2017 08:00:00 PM,48,-122,4,1,5
26733,ElliotBayTrailMyrtlePark,01/18/2017 09:00:00 PM,48,-122,0,0,0
26734,ElliotBayTrailMyrtlePark,01/18/2017 10:00:00 PM,48,-122,0,1,1
26735,ElliotBayTrailMyrtlePark,01/18/2017 11:00:00 PM,48,-122,1,1,2
26736,ElliotBayTrailMyrtlePark,01/19/2017 12:00:00 AM,48,-122,0,0,0
26737,ElliotBayTrailMyrtlePark,01/19/2017 01:00:00 AM,48,-122,1,0,1
26738,ElliotBayTrailMyrtlePark,01/19/2017 02:00:00 AM,48,-122,0,0,0
26739,ElliotBayTrailMyrtlePark,01/19/2017 03:00:00 AM,48,-122,0,1,1
26740,ElliotBayTrailMyrtlePark,01/19/2017 04:00:00 AM,48,-122,0,1,1
26741,ElliotBayTrailMyrtlePark,01/19/2017 05:00:00 AM,48,-122,9,8,17
26742,ElliotBayTrailMyrtlePark,01/19/2017 06:00:00 AM,48,-122,13,19,32
26743,ElliotBayTrailMyrtlePark,01/19/2017 07:00:00 AM,48,-122,18,64,82
26744,ElliotBayTrailMyrtlePark,01/19/2017 08:00:00 AM,48,-122,20,81,101
26745,ElliotBayTrailMyrtlePark,01/19/2017 09:00:00 AM,48,-122,18,14,32
26746,ElliotBayTrailMyrtlePark,01/19/2017 10:00:00 AM,48,-122,8,17,25
26747,ElliotBayTrailMyrtlePark,01/19/2017 11:00:00 AM,48,-122,2,3,5
26748,ElliotBayTrailMyrtlePark,01/19/2017 12:00:00 PM,48,-122,12,7,19
26749,ElliotBayTrailMyrtlePark,01/19/2017 01:00:00 PM,48,-122,5,4,9
26750,ElliotBayTrailMyrtlePark,01/19/2017 02:00:00 PM,48,-122,5,10,15
26751,ElliotBayTrailMyrtlePark,01/19/2017 03:00:00 PM,48,-122,21,20,41
26752,ElliotBayTrailMyrtlePark,01/19/2017 04:00:00 PM,48,-122,68,21,89
26753,ElliotBayTrailMyrtlePark,01/19/2017 05:00:00 PM,48,-122,75,15,90
26754,ElliotBayTrailMyrtlePark,01/19/2017 06:00:00 PM,48,-122,36,5,41
26755,ElliotBayTrailMyrtlePark,01/19/2017 07:00:00 PM,48,-122,4,1,5
26756,ElliotBayTrailMyrtlePark,01/19/2017 08:00:00 PM,48,-122,5,2,7
26757,ElliotBayTrailMyrtlePark,01/19/2017 09:00:00 PM,48,-122,3,1,4
26758,ElliotBayTrailMyrtlePark,01/19/2017 10:00:00 PM,48,-122,1,1,2
26759,ElliotBayTrailMyrtlePark,01/19/2017 11:00:00 PM,48,-122,0,0,0
26760,ElliotBayTrailMyrtlePark,01/20/2017 12:00:00 AM,48,-122,0,0,0
26761,ElliotBayTrailMyrtlePark,01/20/2017 01:00:00 AM,48,-122,0,0,0
26762,ElliotBayTrailMyrtlePark,01/20/2017 02:00:00 AM,48,-122,1,0,1
26763,ElliotBayTrailMyrtlePark,01/20/2017 03:00:00 AM,48,-122,0,0,0
26764,ElliotBayTrailMyrtlePark,01/20/2017 04:00:00 AM,48,-122,1,1,2
26765,ElliotBayTrailMyrtlePark,01/20/2017 05:00:00 AM,48,-122,11,17,28
26766,ElliotBayTrailMyrtlePark,01/20/2017 06:00:00 AM,48,-122,18,21,39
26767,ElliotBayTrailMyrtlePark,01/20/2017 07:00:00 AM,48,-122,23,87,110
26768,ElliotBayTrailMyrtlePark,01/20/2017 08:00:00 AM,48,-122,28,66,94
26769,ElliotBayTrailMyrtlePark,01/20/2017 09:00:00 AM,48,-122,8,30,38
26770,ElliotBayTrailMyrtlePark,01/20/2017 10:00:00 AM,48,-122,10,9,19
26771,ElliotBayTrailMyrtlePark,01/20/2017 11:00:00 AM,48,-122,10,11,21
26772,ElliotBayTrailMyrtlePark,01/20/2017 12:00:00 PM,48,-122,20,14,34
26773,ElliotBayTrailMyrtlePark,01/20/2017 01:00:00 PM,48,-122,23,11,34
26774,ElliotBayTrailMyrtlePark,01/20/2017 02:00:00 PM,48,-122,18,24,42
26775,ElliotBayTrailMyrtlePark,01/20/2017 03:00:00 PM,48,-122,47,27,74
26776,ElliotBayTrailMyrtlePark,01/20/2017 04:00:00 PM,48,-122,75,36,111
26777,ElliotBayTrailMyrtlePark,01/20/2017 05:00:00 PM,48,-122,75,6,81
26778,ElliotBayTrailMyrtlePark,01/20/2017 06:00:00 PM,48,-122,20,6,26
26779,ElliotBayTrailMyrtlePark,01/20/2017 07:00:00 PM,48,-122,8,1,9
26780,ElliotBayTrailMyrtlePark,01/20/2017 08:00:00 PM,48,-122,5,3,8
26781,ElliotBayTrailMyrtlePark,01/20/2017 09:00:00 PM,48,-122,5,2,7
26782,ElliotBayTrailMyrtlePark,01/20/2017 10:00:00 PM,48,-122,2,0,2
26783,ElliotBayTrailMyrtlePark,01/20/2017 11:00:00 PM,48,-122,1,0,1
26784,ElliotBayTrailMyrtlePark,01/21/2017 12:00:00 AM,48,-122,2,0,2
26785,ElliotBayTrailMyrtlePark,01/21/2017 01:00:00 AM,48,-122,0,1,1
26786,ElliotBayTrailMyrtlePark,01/21/2017 02:00:00 AM,48,-122,2,0,2
26787,ElliotBayTrailMyrtlePark,01/21/2017 03:00:00 AM,48,-122,1,0,1
26788,ElliotBayTrailMyrtlePark,01/21/2017 04:00:00 AM,48,-122,0,0,0
26789,ElliotBayTrailMyrtlePark,01/21/2017 05:00:00 AM,48,-122,4,3,7
26790,ElliotBayTrailMyrtlePark,01/21/2017 06:00:00 AM,48,-122,0,1,1
26791,ElliotBayTrailMyrtlePark,01/21/2017 07:00:00 AM,48,-122,5,2,7
26792,ElliotBayTrailMyrtlePark,01/21/2017 08:00:00 AM,48,-122,6,12,18
26793,ElliotBayTrailMyrtlePark,01/21/2017 09:00:00 AM,48,-122,6,21,27
26794,ElliotBayTrailMyrtlePark,01/21/2017 10:00:00 AM,48,-122,5,25,30
26795,ElliotBayTrailMyrtlePark,01/21/2017 11:00:00 AM,48,-122,21,24,45
26796,ElliotBayTrailMyrtlePark,01/21/2017 12:00:00 PM,48,-122,28,23,51
26797,ElliotBayTrailMyrtlePark,01/21/2017 01:00:00 PM,48,-122,31,41,72
26798,ElliotBayTrailMyrtlePark,01/21/2017 02:00:00 PM,48,-122,41,37,78
26799,ElliotBayTrailMyrtlePark,01/21/2017 03:00:00 PM,48,-122,36,24,60
26800,ElliotBayTrailMyrtlePark,01/21/2017 04:00:00 PM,48,-122,14,7,21
26801,ElliotBayTrailMyrtlePark,01/21/2017 05:00:00 PM,48,-122,9,14,23
26802,ElliotBayTrailMyrtlePark,01/21/2017 06:00:00 PM,48,-122,4,2,6
26803,ElliotBayTrailMyrtlePark,01/21/2017 07:00:00 PM,48,-122,2,2,4
26804,ElliotBayTrailMyrtlePark,01/21/2017 08:00:00 PM,48,-122,0,3,3
26805,ElliotBayTrailMyrtlePark,01/21/2017 09:00:00 PM,48,-122,1,2,3
26806,ElliotBayTrailMyrtlePark,01/21/2017 10:00:00 PM,48,-122,10,2,12
26807,ElliotBayTrailMyrtlePark,01/21/2017 11:00:00 PM,48,-122,2,4,6
26808,ElliotBayTrailMyrtlePark,01/22/2017 12:00:00 AM,48,-122,1,1,2
26809,ElliotBayTrailMyrtlePark,01/22/2017 01:00:00 AM,48,-122,1,0,1
26810,ElliotBayTrailMyrtlePark,01/22/2017 02:00:00 AM,48,-122,0,0,0
26811,ElliotBayTrailMyrtlePark,01/22/2017 03:00:00 AM,48,-122,0,1,1
26812,ElliotBayTrailMyrtlePark,01/22/2017 04:00:00 AM,48,-122,0,0,0
26813,ElliotBayTrailMyrtlePark,01/22/2017 05:00:00 AM,48,-122,1,1,2
26814,ElliotBayTrailMyrtlePark,01/22/2017 06:00:00 AM,48,-122,1,1,2
26815,ElliotBayTrailMyrtlePark,01/22/2017 07:00:00 AM,48,-122,4,2,6
26816,ElliotBayTrailMyrtlePark,01/22/2017 08:00:00 AM,48,-122,0,7,7
26817,ElliotBayTrailMyrtlePark,01/22/2017 09:00:00 AM,48,-122,2,7,9
26818,ElliotBayTrailMyrtlePark,01/22/2017 10:00:00 AM,48,-122,2,2,4
26819,ElliotBayTrailMyrtlePark,01/22/2017 11:00:00 AM,48,-122,7,0,7
26820,ElliotBayTrailMyrtlePark,01/22/2017 12:00:00 PM,48,-122,5,5,10
26821,ElliotBayTrailMyrtlePark,01/22/2017 01:00:00 PM,48,-122,5,6,11
26822,ElliotBayTrailMyrtlePark,01/22/2017 02:00:00 PM,48,-122,11,11,22
26823,ElliotBayTrailMyrtlePark,01/22/2017 03:00:00 PM,48,-122,9,13,22
26824,ElliotBayTrailMyrtlePark,01/22/2017 04:00:00 PM,48,-122,9,15,24
26825,ElliotBayTrailMyrtlePark,01/22/2017 05:00:00 PM,48,-122,1,4,5
26826,ElliotBayTrailMyrtlePark,01/22/2017 06:00:00 PM,48,-122,2,0,2
26827,ElliotBayTrailMyrtlePark,01/22/2017 07:00:00 PM,48,-122,1,1,2
26828,ElliotBayTrailMyrtlePark,01/22/2017 08:00:00 PM,48,-122,0,1,1
26829,ElliotBayTrailMyrtlePark,01/22/2017 09:00:00 PM,48,-122,1,0,1
26830,ElliotBayTrailMyrtlePark,01/22/2017 10:00:00 PM,48,-122,0,1,1
26831,ElliotBayTrailMyrtlePark,01/22/2017 11:00:00 PM,48,-122,0,1,1
26832,ElliotBayTrailMyrtlePark,01/23/2017 12:00:00 AM,48,-122,0,0,0
26833,ElliotBayTrailMyrtlePark,01/23/2017 01:00:00 AM,48,-122,4,0,4
26834,ElliotBayTrailMyrtlePark,01/23/2017 02:00:00 AM,48,-122,1,0,1
26835,ElliotBayTrailMyrtlePark,01/23/2017 03:00:00 AM,48,-122,1,0,1
26836,ElliotBayTrailMyrtlePark,01/23/2017 04:00:00 AM,48,-122,5,1,6
26837,ElliotBayTrailMyrtlePark,01/23/2017 05:00:00 AM,48,-122,8,13,21
26838,ElliotBayTrailMyrtlePark,01/23/2017 06:00:00 AM,48,-122,18,23,41
26839,ElliotBayTrailMyrtlePark,01/23/2017 07:00:00 AM,48,-122,29,85,114
26840,ElliotBayTrailMyrtlePark,01/23/2017 08:00:00 AM,48,-122,37,92,129
26841,ElliotBayTrailMyrtlePark,01/23/2017 09:00:00 AM,48,-122,15,31,46
26842,ElliotBayTrailMyrtlePark,01/23/2017 10:00:00 AM,48,-122,8,9,17
26843,ElliotBayTrailMyrtlePark,01/23/2017 11:00:00 AM,48,-122,13,14,27
26844,ElliotBayTrailMyrtlePark,01/23/2017 12:00:00 PM,48,-122,5,10,15
26845,ElliotBayTrailMyrtlePark,01/23/2017 01:00:00 PM,48,-122,17,15,32
26846,ElliotBayTrailMyrtlePark,01/23/2017 02:00:00 PM,48,-122,17,17,34
26847,ElliotBayTrailMyrtlePark,01/23/2017 03:00:00 PM,48,-122,29,29,58
26848,ElliotBayTrailMyrtlePark,01/23/2017 04:00:00 PM,48,-122,102,44,146
26849,ElliotBayTrailMyrtlePark,01/23/2017 05:00:00 PM,48,-122,109,23,132
26850,ElliotBayTrailMyrtlePark,01/23/2017 06:00:00 PM,48,-122,44,5,49
26851,ElliotBayTrailMyrtlePark,01/23/2017 07:00:00 PM,48,-122,3,2,5
26852,ElliotBayTrailMyrtlePark,01/23/2017 08:00:00 PM,48,-122,3,1,4
26853,ElliotBayTrailMyrtlePark,01/23/2017 09:00:00 PM,48,-122,2,2,4
26854,ElliotBayTrailMyrtlePark,01/23/2017 10:00:00 PM,48,-122,3,1,4
26855,ElliotBayTrailMyrtlePark,01/23/2017 11:00:00 PM,48,-122,1,0,1
26856,ElliotBayTrailMyrtlePark,01/24/2017 12:00:00 AM,48,-122,0,0,0
26857,ElliotBayTrailMyrtlePark,01/24/2017 01:00:00 AM,48,-122,1,0,1
26858,ElliotBayTrailMyrtlePark,01/24/2017 02:00:00 AM,48,-122,1,0,1
26859,ElliotBayTrailMyrtlePark,01/24/2017 03:00:00 AM,48,-122,0,1,1
26860,ElliotBayTrailMyrtlePark,01/24/2017 04:00:00 AM,48,-122,0,2,2
26861,ElliotBayTrailMyrtlePark,01/24/2017 05:00:00 AM,48,-122,20,11,31
26862,ElliotBayTrailMyrtlePark,01/24/2017 06:00:00 AM,48,-122,17,26,43
26863,ElliotBayTrailMyrtlePark,01/24/2017 07:00:00 AM,48,-122,26,83,109
26864,ElliotBayTrailMyrtlePark,01/24/2017 08:00:00 AM,48,-122,30,103,133
26865,ElliotBayTrailMyrtlePark,01/24/2017 09:00:00 AM,48,-122,14,21,35
26866,ElliotBayTrailMyrtlePark,01/24/2017 10:00:00 AM,48,-122,14,11,25
26867,ElliotBayTrailMyrtlePark,01/24/2017 11:00:00 AM,48,-122,9,13,22
26868,ElliotBayTrailMyrtlePark,01/24/2017 12:00:00 PM,48,-122,4,11,15
26869,ElliotBayTrailMyrtlePark,01/24/2017 01:00:00 PM,48,-122,12,12,24
26870,ElliotBayTrailMyrtlePark,01/24/2017 02:00:00 PM,48,-122,22,26,48
26871,ElliotBayTrailMyrtlePark,01/24/2017 03:00:00 PM,48,-122,34,25,59
26872,ElliotBayTrailMyrtlePark,01/24/2017 04:00:00 PM,48,-122,91,32,123
26873,ElliotBayTrailMyrtlePark,01/24/2017 05:00:00 PM,48,-122,104,19,123
26874,ElliotBayTrailMyrtlePark,01/24/2017 06:00:00 PM,48,-122,45,6,51
26875,ElliotBayTrailMyrtlePark,01/24/2017 07:00:00 PM,48,-122,6,1,7
26876,ElliotBayTrailMyrtlePark,01/24/2017 08:00:00 PM,48,-122,7,1,8
26877,ElliotBayTrailMyrtlePark,01/24/2017 09:00:00 PM,48,-122,4,1,5
26878,ElliotBayTrailMyrtlePark,01/24/2017 10:00:00 PM,48,-122,1,1,2
26879,ElliotBayTrailMyrtlePark,01/24/2017 11:00:00 PM,48,-122,0,0,0
26880,ElliotBayTrailMyrtlePark,01/25/2017 12:00:00 AM,48,-122,0,0,0
26881,ElliotBayTrailMyrtlePark,01/25/2017 01:00:00 AM,48,-122,0,0,0
26882,ElliotBayTrailMyrtlePark,01/25/2017 02:00:00 AM,48,-122,1,0,1
26883,ElliotBayTrailMyrtlePark,01/25/2017 03:00:00 AM,48,-122,0,1,1
26884,ElliotBayTrailMyrtlePark,01/25/2017 04:00:00 AM,48,-122,3,3,6
26885,ElliotBayTrailMyrtlePark,01/25/2017 05:00:00 AM,48,-122,11,12,23
26886,ElliotBayTrailMyrtlePark,01/25/2017 06:00:00 AM,48,-122,14,31,45
26887,ElliotBayTrailMyrtlePark,01/25/2017 07:00:00 AM,48,-122,20,101,121
26888,ElliotBayTrailMyrtlePark,01/25/2017 08:00:00 AM,48,-122,26,74,100
26889,ElliotBayTrailMyrtlePark,01/25/2017 09:00:00 AM,48,-122,5,21,26
26890,ElliotBayTrailMyrtlePark,01/25/2017 10:00:00 AM,48,-122,7,10,17
26891,ElliotBayTrailMyrtlePark,01/25/2017 11:00:00 AM,48,-122,9,12,21
26892,ElliotBayTrailMyrtlePark,01/25/2017 12:00:00 PM,48,-122,11,6,17
26893,ElliotBayTrailMyrtlePark,01/25/2017 01:00:00 PM,48,-122,10,6,16
26894,ElliotBayTrailMyrtlePark,01/25/2017 02:00:00 PM,48,-122,17,10,27
26895,ElliotBayTrailMyrtlePark,01/25/2017 03:00:00 PM,48,-122,22,21,43
26896,ElliotBayTrailMyrtlePark,01/25/2017 04:00:00 PM,48,-122,70,33,103
26897,ElliotBayTrailMyrtlePark,01/25/2017 05:00:00 PM,48,-122,108,8,116
26898,ElliotBayTrailMyrtlePark,01/25/2017 06:00:00 PM,48,-122,38,3,41
26899,ElliotBayTrailMyrtlePark,01/25/2017 07:00:00 PM,48,-122,4,0,4
26900,ElliotBayTrailMyrtlePark,01/25/2017 08:00:00 PM,48,-122,4,2,6
26901,ElliotBayTrailMyrtlePark,01/25/2017 09:00:00 PM,48,-122,3,1,4
26902,ElliotBayTrailMyrtlePark,01/25/2017 10:00:00 PM,48,-122,4,3,7
26903,ElliotBayTrailMyrtlePark,01/25/2017 11:00:00 PM,48,-122,0,0,0
26904,ElliotBayTrailMyrtlePark,01/26/2017 12:00:00 AM,48,-122,3,0,3
26905,ElliotBayTrailMyrtlePark,01/26/2017 01:00:00 AM,48,-122,0,0,0
26906,ElliotBayTrailMyrtlePark,01/26/2017 02:00:00 AM,48,-122,0,0,0
26907,ElliotBayTrailMyrtlePark,01/26/2017 03:00:00 AM,48,-122,1,1,2
26908,ElliotBayTrailMyrtlePark,01/26/2017 04:00:00 AM,48,-122,0,3,3
26909,ElliotBayTrailMyrtlePark,01/26/2017 05:00:00 AM,48,-122,14,13,27
26910,ElliotBayTrailMyrtlePark,01/26/2017 06:00:00 AM,48,-122,15,34,49
26911,ElliotBayTrailMyrtlePark,01/26/2017 07:00:00 AM,48,-122,22,78,100
26912,ElliotBayTrailMyrtlePark,01/26/2017 08:00:00 AM,48,-122,34,78,112
26913,ElliotBayTrailMyrtlePark,01/26/2017 09:00:00 AM,48,-122,13,29,42
26914,ElliotBayTrailMyrtlePark,01/26/2017 10:00:00 AM,48,-122,9,8,17
26915,ElliotBayTrailMyrtlePark,01/26/2017 11:00:00 AM,48,-122,10,9,19
26916,ElliotBayTrailMyrtlePark,01/26/2017 12:00:00 PM,48,-122,14,11,25
26917,ElliotBayTrailMyrtlePark,01/26/2017 01:00:00 PM,48,-122,13,15,28
26918,ElliotBayTrailMyrtlePark,01/26/2017 02:00:00 PM,48,-122,16,14,30
26919,ElliotBayTrailMyrtlePark,01/26/2017 03:00:00 PM,48,-122,33,27,60
26920,ElliotBayTrailMyrtlePark,01/26/2017 04:00:00 PM,48,-122,87,35,122
26921,ElliotBayTrailMyrtlePark,01/26/2017 05:00:00 PM,48,-122,94,31,125
26922,ElliotBayTrailMyrtlePark,01/26/2017 06:00:00 PM,48,-122,35,5,40
26923,ElliotBayTrailMyrtlePark,01/26/2017 07:00:00 PM,48,-122,8,3,11
26924,ElliotBayTrailMyrtlePark,01/26/2017 08:00:00 PM,48,-122,6,1,7
26925,ElliotBayTrailMyrtlePark,01/26/2017 09:00:00 PM,48,-122,5,3,8
26926,ElliotBayTrailMyrtlePark,01/26/2017 10:00:00 PM,48,-122,2,4,6
26927,ElliotBayTrailMyrtlePark,01/26/2017 11:00:00 PM,48,-122,0,0,0
26928,ElliotBayTrailMyrtlePark,01/27/2017 12:00:00 AM,48,-122,1,0,1
26929,ElliotBayTrailMyrtlePark,01/27/2017 01:00:00 AM,48,-122,0,1,1
26930,ElliotBayTrailMyrtlePark,01/27/2017 02:00:00 AM,48,-122,1,0,1
26931,ElliotBayTrailMyrtlePark,01/27/2017 03:00:00 AM,48,-122,0,0,0
26932,ElliotBayTrailMyrtlePark,01/27/2017 04:00:00 AM,48,-122,0,1,1
26933,ElliotBayTrailMyrtlePark,01/27/2017 05:00:00 AM,48,-122,16,12,28
26934,ElliotBayTrailMyrtlePark,01/27/2017 06:00:00 AM,48,-122,13,20,33
26935,ElliotBayTrailMyrtlePark,01/27/2017 07:00:00 AM,48,-122,17,72,89
26936,ElliotBayTrailMyrtlePark,01/27/2017 08:00:00 AM,48,-122,26,79,105
26937,ElliotBayTrailMyrtlePark,01/27/2017 09:00:00 AM,48,-122,12,35,47
26938,ElliotBayTrailMyrtlePark,01/27/2017 10:00:00 AM,48,-122,15,12,27
26939,ElliotBayTrailMyrtlePark,01/27/2017 11:00:00 AM,48,-122,11,11,22
26940,ElliotBayTrailMyrtlePark,01/27/2017 12:00:00 PM,48,-122,20,14,34
26941,ElliotBayTrailMyrtlePark,01/27/2017 01:00:00 PM,48,-122,20,20,40
26942,ElliotBayTrailMyrtlePark,01/27/2017 02:00:00 PM,48,-122,26,26,52
26943,ElliotBayTrailMyrtlePark,01/27/2017 03:00:00 PM,48,-122,56,36,92
26944,ElliotBayTrailMyrtlePark,01/27/2017 04:00:00 PM,48,-122,92,50,142
26945,ElliotBayTrailMyrtlePark,01/27/2017 05:00:00 PM,48,-122,79,25,104
26946,ElliotBayTrailMyrtlePark,01/27/2017 06:00:00 PM,48,-122,21,7,28
26947,ElliotBayTrailMyrtlePark,01/27/2017 07:00:00 PM,48,-122,7,4,11
26948,ElliotBayTrailMyrtlePark,01/27/2017 08:00:00 PM,48,-122,14,3,17
26949,ElliotBayTrailMyrtlePark,01/27/2017 09:00:00 PM,48,-122,4,4,8
26950,ElliotBayTrailMyrtlePark,01/27/2017 10:00:00 PM,48,-122,1,1,2
26951,ElliotBayTrailMyrtlePark,01/27/2017 11:00:00 PM,48,-122,1,0,1
26952,ElliotBayTrailMyrtlePark,01/28/2017 12:00:00 AM,48,-122,0,0,0
26953,ElliotBayTrailMyrtlePark,01/28/2017 01:00:00 AM,48,-122,3,0,3
26954,ElliotBayTrailMyrtlePark,01/28/2017 02:00:00 AM,48,-122,0,0,0
26955,ElliotBayTrailMyrtlePark,01/28/2017 03:00:00 AM,48,-122,0,0,0
26956,ElliotBayTrailMyrtlePark,01/28/2017 04:00:00 AM,48,-122,0,0,0
26957,ElliotBayTrailMyrtlePark,01/28/2017 05:00:00 AM,48,-122,1,5,6
26958,ElliotBayTrailMyrtlePark,01/28/2017 06:00:00 AM,48,-122,2,5,7
26959,ElliotBayTrailMyrtlePark,01/28/2017 07:00:00 AM,48,-122,6,9,15
26960,ElliotBayTrailMyrtlePark,01/28/2017 08:00:00 AM,48,-122,10,19,29
26961,ElliotBayTrailMyrtlePark,01/28/2017 09:00:00 AM,48,-122,19,37,56
26962,ElliotBayTrailMyrtlePark,01/28/2017 10:00:00 AM,48,-122,17,32,49
26963,ElliotBayTrailMyrtlePark,01/28/2017 11:00:00 AM,48,-122,40,38,78
26964,ElliotBayTrailMyrtlePark,01/28/2017 12:00:00 PM,48,-122,40,31,71
26965,ElliotBayTrailMyrtlePark,01/28/2017 01:00:00 PM,48,-122,42,35,77
26966,ElliotBayTrailMyrtlePark,01/28/2017 02:00:00 PM,48,-122,42,27,69
26967,ElliotBayTrailMyrtlePark,01/28/2017 03:00:00 PM,48,-122,27,29,56
26968,ElliotBayTrailMyrtlePark,01/28/2017 04:00:00 PM,48,-122,34,38,72
26969,ElliotBayTrailMyrtlePark,01/28/2017 05:00:00 PM,48,-122,16,3,19
26970,ElliotBayTrailMyrtlePark,01/28/2017 06:00:00 PM,48,-122,9,2,11
26971,ElliotBayTrailMyrtlePark,01/28/2017 07:00:00 PM,48,-122,2,1,3
26972,ElliotBayTrailMyrtlePark,01/28/2017 08:00:00 PM,48,-122,5,0,5
26973,ElliotBayTrailMyrtlePark,01/28/2017 09:00:00 PM,48,-122,1,1,2
26974,ElliotBayTrailMyrtlePark,01/28/2017 10:00:00 PM,48,-122,1,0,1
26975,ElliotBayTrailMyrtlePark,01/28/2017 11:00:00 PM,48,-122,1,0,1
26976,ElliotBayTrailMyrtlePark,01/29/2017 12:00:00 AM,48,-122,0,0,0
26977,ElliotBayTrailMyrtlePark,01/29/2017 01:00:00 AM,48,-122,0,0,0
26978,ElliotBayTrailMyrtlePark,01/29/2017 02:00:00 AM,48,-122,0,0,0
26979,ElliotBayTrailMyrtlePark,01/29/2017 03:00:00 AM,48,-122,0,0,0
26980,ElliotBayTrailMyrtlePark,01/29/2017 04:00:00 AM,48,-122,0,0,0
26981,ElliotBayTrailMyrtlePark,01/29/2017 05:00:00 AM,48,-122,0,2,2
26982,ElliotBayTrailMyrtlePark,01/29/2017 06:00:00 AM,48,-122,2,2,4
26983,ElliotBayTrailMyrtlePark,01/29/2017 07:00:00 AM,48,-122,11,5,16
26984,ElliotBayTrailMyrtlePark,01/29/2017 08:00:00 AM,48,-122,9,15,24
26985,ElliotBayTrailMyrtlePark,01/29/2017 09:00:00 AM,48,-122,17,9,26
26986,ElliotBayTrailMyrtlePark,01/29/2017 10:00:00 AM,48,-122,35,19,54
26987,ElliotBayTrailMyrtlePark,01/29/2017 11:00:00 AM,48,-122,26,18,44
26988,ElliotBayTrailMyrtlePark,01/29/2017 12:00:00 PM,48,-122,25,40,65
26989,ElliotBayTrailMyrtlePark,01/29/2017 01:00:00 PM,48,-122,17,13,30
26990,ElliotBayTrailMyrtlePark,01/29/2017 02:00:00 PM,48,-122,18,12,30
26991,ElliotBayTrailMyrtlePark,01/29/2017 03:00:00 PM,48,-122,23,7,30
26992,ElliotBayTrailMyrtlePark,01/29/2017 04:00:00 PM,48,-122,13,15,28
26993,ElliotBayTrailMyrtlePark,01/29/2017 05:00:00 PM,48,-122,4,9,13
26994,ElliotBayTrailMyrtlePark,01/29/2017 06:00:00 PM,48,-122,2,1,3
26995,ElliotBayTrailMyrtlePark,01/29/2017 07:00:00 PM,48,-122,6,1,7
26996,ElliotBayTrailMyrtlePark,01/29/2017 08:00:00 PM,48,-122,1,0,1
26997,ElliotBayTrailMyrtlePark,01/29/2017 09:00:00 PM,48,-122,0,0,0
26998,ElliotBayTrailMyrtlePark,01/29/2017 10:00:00 PM,48,-122,0,1,1
26999,ElliotBayTrailMyrtlePark,01/29/2017 11:00:00 PM,48,-122,0,0,0
27000,ElliotBayTrailMyrtlePark,01/30/2017 12:00:00 AM,48,-122,0,2,2
27001,ElliotBayTrailMyrtlePark,01/30/2017 01:00:00 AM,48,-122,0,0,0
27002,ElliotBayTrailMyrtlePark,01/30/2017 02:00:00 AM,48,-122,1,0,1
27003,ElliotBayTrailMyrtlePark,01/30/2017 03:00:00 AM,48,-122,0,1,1
27004,ElliotBayTrailMyrtlePark,01/30/2017 04:00:00 AM,48,-122,2,2,4
27005,ElliotBayTrailMyrtlePark,01/30/2017 05:00:00 AM,48,-122,14,16,30
27006,ElliotBayTrailMyrtlePark,01/30/2017 06:00:00 AM,48,-122,18,33,51
27007,ElliotBayTrailMyrtlePark,01/30/2017 07:00:00 AM,48,-122,27,113,140
27008,ElliotBayTrailMyrtlePark,01/30/2017 08:00:00 AM,48,-122,27,94,121
27009,ElliotBayTrailMyrtlePark,01/30/2017 09:00:00 AM,48,-122,10,33,43
27010,ElliotBayTrailMyrtlePark,01/30/2017 10:00:00 AM,48,-122,11,13,24
27011,ElliotBayTrailMyrtlePark,01/30/2017 11:00:00 AM,48,-122,9,12,21
27012,ElliotBayTrailMyrtlePark,01/30/2017 12:00:00 PM,48,-122,11,11,22
27013,ElliotBayTrailMyrtlePark,01/30/2017 01:00:00 PM,48,-122,9,5,14
27014,ElliotBayTrailMyrtlePark,01/30/2017 02:00:00 PM,48,-122,19,19,38
27015,ElliotBayTrailMyrtlePark,01/30/2017 03:00:00 PM,48,-122,33,29,62
27016,ElliotBayTrailMyrtlePark,01/30/2017 04:00:00 PM,48,-122,75,41,116
27017,ElliotBayTrailMyrtlePark,01/30/2017 05:00:00 PM,48,-122,148,18,166
27018,ElliotBayTrailMyrtlePark,01/30/2017 06:00:00 PM,48,-122,48,7,55
27019,ElliotBayTrailMyrtlePark,01/30/2017 07:00:00 PM,48,-122,11,2,13
27020,ElliotBayTrailMyrtlePark,01/30/2017 08:00:00 PM,48,-122,7,1,8
27021,ElliotBayTrailMyrtlePark,01/30/2017 09:00:00 PM,48,-122,1,2,3
27022,ElliotBayTrailMyrtlePark,01/30/2017 10:00:00 PM,48,-122,1,0,1
27023,ElliotBayTrailMyrtlePark,01/30/2017 11:00:00 PM,48,-122,2,2,4
27024,ElliotBayTrailMyrtlePark,01/31/2017 12:00:00 AM,48,-122,1,0,1
27025,ElliotBayTrailMyrtlePark,01/31/2017 01:00:00 AM,48,-122,1,0,1
27026,ElliotBayTrailMyrtlePark,01/31/2017 02:00:00 AM,48,-122,0,0,0
27027,ElliotBayTrailMyrtlePark,01/31/2017 03:00:00 AM,48,-122,0,1,1
27028,ElliotBayTrailMyrtlePark,01/31/2017 04:00:00 AM,48,-122,0,2,2
27029,ElliotBayTrailMyrtlePark,01/31/2017 05:00:00 AM,48,-122,14,13,27
27030,ElliotBayTrailMyrtlePark,01/31/2017 06:00:00 AM,48,-122,19,37,56
27031,ElliotBayTrailMyrtlePark,01/31/2017 07:00:00 AM,48,-122,28,105,133
27032,ElliotBayTrailMyrtlePark,01/31/2017 08:00:00 AM,48,-122,28,95,123
27033,ElliotBayTrailMyrtlePark,01/31/2017 09:00:00 AM,48,-122,9,30,39
27034,ElliotBayTrailMyrtlePark,01/31/2017 10:00:00 AM,48,-122,12,9,21
27035,ElliotBayTrailMyrtlePark,01/31/2017 11:00:00 AM,48,-122,8,11,19
27036,ElliotBayTrailMyrtlePark,01/31/2017 12:00:00 PM,48,-122,7,9,16
27037,ElliotBayTrailMyrtlePark,01/31/2017 01:00:00 PM,48,-122,4,22,26
27038,ElliotBayTrailMyrtlePark,01/31/2017 02:00:00 PM,48,-122,22,20,42
27039,ElliotBayTrailMyrtlePark,01/31/2017 03:00:00 PM,48,-122,35,31,66
27040,ElliotBayTrailMyrtlePark,01/31/2017 04:00:00 PM,48,-122,95,43,138
27041,ElliotBayTrailMyrtlePark,01/31/2017 05:00:00 PM,48,-122,128,25,153
27042,ElliotBayTrailMyrtlePark,01/31/2017 06:00:00 PM,48,-122,48,9,57
27043,ElliotBayTrailMyrtlePark,01/31/2017 07:00:00 PM,48,-122,6,1,7
27044,ElliotBayTrailMyrtlePark,01/31/2017 08:00:00 PM,48,-122,6,3,9
27045,ElliotBayTrailMyrtlePark,01/31/2017 09:00:00 PM,48,-122,1,3,4
27046,ElliotBayTrailMyrtlePark,01/31/2017 10:00:00 PM,48,-122,2,0,2
27047,ElliotBayTrailMyrtlePark,01/31/2017 11:00:00 PM,48,-122,0,0,0
27048,ElliotBayTrailMyrtlePark,02/01/2017 12:00:00 AM,48,-122,0,0,0
27049,ElliotBayTrailMyrtlePark,02/01/2017 01:00:00 AM,48,-122,0,0,0
27050,ElliotBayTrailMyrtlePark,02/01/2017 02:00:00 AM,48,-122,0,0,0
27051,ElliotBayTrailMyrtlePark,02/01/2017 03:00:00 AM,48,-122,0,1,1
27052,ElliotBayTrailMyrtlePark,02/01/2017 04:00:00 AM,48,-122,0,3,3
27053,ElliotBayTrailMyrtlePark,02/01/2017 05:00:00 AM,48,-122,18,13,31
27054,ElliotBayTrailMyrtlePark,02/01/2017 06:00:00 AM,48,-122,7,24,31
27055,ElliotBayTrailMyrtlePark,02/01/2017 07:00:00 AM,48,-122,32,80,112
27056,ElliotBayTrailMyrtlePark,02/01/2017 08:00:00 AM,48,-122,21,92,113
27057,ElliotBayTrailMyrtlePark,02/01/2017 09:00:00 AM,48,-122,11,30,41
27058,ElliotBayTrailMyrtlePark,02/01/2017 10:00:00 AM,48,-122,7,13,20
27059,ElliotBayTrailMyrtlePark,02/01/2017 11:00:00 AM,48,-122,15,10,25
27060,ElliotBayTrailMyrtlePark,02/01/2017 12:00:00 PM,48,-122,24,19,43
27061,ElliotBayTrailMyrtlePark,02/01/2017 01:00:00 PM,48,-122,18,13,31
27062,ElliotBayTrailMyrtlePark,02/01/2017 02:00:00 PM,48,-122,19,29,48
27063,ElliotBayTrailMyrtlePark,02/01/2017 03:00:00 PM,48,-122,42,27,69
27064,ElliotBayTrailMyrtlePark,02/01/2017 04:00:00 PM,48,-122,79,48,127
27065,ElliotBayTrailMyrtlePark,02/01/2017 05:00:00 PM,48,-122,91,26,117
27066,ElliotBayTrailMyrtlePark,02/01/2017 06:00:00 PM,48,-122,42,3,45
27067,ElliotBayTrailMyrtlePark,02/01/2017 07:00:00 PM,48,-122,10,1,11
27068,ElliotBayTrailMyrtlePark,02/01/2017 08:00:00 PM,48,-122,7,4,11
27069,ElliotBayTrailMyrtlePark,02/01/2017 09:00:00 PM,48,-122,5,3,8
27070,ElliotBayTrailMyrtlePark,02/01/2017 10:00:00 PM,48,-122,2,3,5
27071,ElliotBayTrailMyrtlePark,02/01/2017 11:00:00 PM,48,-122,2,0,2
27072,ElliotBayTrailMyrtlePark,02/02/2017 12:00:00 AM,48,-122,1,0,1
27073,ElliotBayTrailMyrtlePark,02/02/2017 01:00:00 AM,48,-122,1,0,1
27074,ElliotBayTrailMyrtlePark,02/02/2017 02:00:00 AM,48,-122,1,0,1
27075,ElliotBayTrailMyrtlePark,02/02/2017 03:00:00 AM,48,-122,0,4,4
27076,ElliotBayTrailMyrtlePark,02/02/2017 04:00:00 AM,48,-122,0,1,1
27077,ElliotBayTrailMyrtlePark,02/02/2017 05:00:00 AM,48,-122,13,15,28
27078,ElliotBayTrailMyrtlePark,02/02/2017 06:00:00 AM,48,-122,11,25,36
27079,ElliotBayTrailMyrtlePark,02/02/2017 07:00:00 AM,48,-122,21,80,101
27080,ElliotBayTrailMyrtlePark,02/02/2017 08:00:00 AM,48,-122,29,96,125
27081,ElliotBayTrailMyrtlePark,02/02/2017 09:00:00 AM,48,-122,12,29,41
27082,ElliotBayTrailMyrtlePark,02/02/2017 10:00:00 AM,48,-122,10,5,15
27083,ElliotBayTrailMyrtlePark,02/02/2017 11:00:00 AM,48,-122,11,12,23
27084,ElliotBayTrailMyrtlePark,02/02/2017 12:00:00 PM,48,-122,13,16,29
27085,ElliotBayTrailMyrtlePark,02/02/2017 01:00:00 PM,48,-122,14,19,33
27086,ElliotBayTrailMyrtlePark,02/02/2017 02:00:00 PM,48,-122,20,23,43
27087,ElliotBayTrailMyrtlePark,02/02/2017 03:00:00 PM,48,-122,37,26,63
27088,ElliotBayTrailMyrtlePark,02/02/2017 04:00:00 PM,48,-122,88,43,131
27089,ElliotBayTrailMyrtlePark,02/02/2017 05:00:00 PM,48,-122,99,18,117
27090,ElliotBayTrailMyrtlePark,02/02/2017 06:00:00 PM,48,-122,41,3,44
27091,ElliotBayTrailMyrtlePark,02/02/2017 07:00:00 PM,48,-122,5,5,10
27092,ElliotBayTrailMyrtlePark,02/02/2017 08:00:00 PM,48,-122,8,1,9
27093,ElliotBayTrailMyrtlePark,02/02/2017 09:00:00 PM,48,-122,4,7,11
27094,ElliotBayTrailMyrtlePark,02/02/2017 10:00:00 PM,48,-122,2,0,2
27095,ElliotBayTrailMyrtlePark,02/02/2017 11:00:00 PM,48,-122,1,0,1
27096,ElliotBayTrailMyrtlePark,02/03/2017 12:00:00 AM,48,-122,0,1,1
27097,ElliotBayTrailMyrtlePark,02/03/2017 01:00:00 AM,48,-122,0,0,0
27098,ElliotBayTrailMyrtlePark,02/03/2017 02:00:00 AM,48,-122,1,0,1
27099,ElliotBayTrailMyrtlePark,02/03/2017 03:00:00 AM,48,-122,0,0,0
27100,ElliotBayTrailMyrtlePark,02/03/2017 04:00:00 AM,48,-122,0,1,1
27101,ElliotBayTrailMyrtlePark,02/03/2017 05:00:00 AM,48,-122,6,7,13
27102,ElliotBayTrailMyrtlePark,02/03/2017 06:00:00 AM,48,-122,9,13,22
27103,ElliotBayTrailMyrtlePark,02/03/2017 07:00:00 AM,48,-122,14,34,48
27104,ElliotBayTrailMyrtlePark,02/03/2017 08:00:00 AM,48,-122,9,37,46
27105,ElliotBayTrailMyrtlePark,02/03/2017 09:00:00 AM,48,-122,4,17,21
27106,ElliotBayTrailMyrtlePark,02/03/2017 10:00:00 AM,48,-122,6,4,10
27107,ElliotBayTrailMyrtlePark,02/03/2017 11:00:00 AM,48,-122,6,3,9
27108,ElliotBayTrailMyrtlePark,02/03/2017 12:00:00 PM,48,-122,1,3,4
27109,ElliotBayTrailMyrtlePark,02/03/2017 01:00:00 PM,48,-122,3,2,5
27110,ElliotBayTrailMyrtlePark,02/03/2017 02:00:00 PM,48,-122,6,9,15
27111,ElliotBayTrailMyrtlePark,02/03/2017 03:00:00 PM,48,-122,13,7,20
27112,ElliotBayTrailMyrtlePark,02/03/2017 04:00:00 PM,48,-122,26,13,39
27113,ElliotBayTrailMyrtlePark,02/03/2017 05:00:00 PM,48,-122,52,8,60
27114,ElliotBayTrailMyrtlePark,02/03/2017 06:00:00 PM,48,-122,16,3,19
27115,ElliotBayTrailMyrtlePark,02/03/2017 07:00:00 PM,48,-122,6,1,7
27116,ElliotBayTrailMyrtlePark,02/03/2017 08:00:00 PM,48,-122,0,1,1
27117,ElliotBayTrailMyrtlePark,02/03/2017 09:00:00 PM,48,-122,0,4,4
27118,ElliotBayTrailMyrtlePark,02/03/2017 10:00:00 PM,48,-122,2,1,3
27119,ElliotBayTrailMyrtlePark,02/03/2017 11:00:00 PM,48,-122,1,1,2
27120,ElliotBayTrailMyrtlePark,02/04/2017 12:00:00 AM,48,-122,2,0,2
27121,ElliotBayTrailMyrtlePark,02/04/2017 01:00:00 AM,48,-122,0,0,0
27122,ElliotBayTrailMyrtlePark,02/04/2017 02:00:00 AM,48,-122,0,0,0
27123,ElliotBayTrailMyrtlePark,02/04/2017 03:00:00 AM,48,-122,0,0,0
27124,ElliotBayTrailMyrtlePark,02/04/2017 04:00:00 AM,48,-122,0,1,1
27125,ElliotBayTrailMyrtlePark,02/04/2017 05:00:00 AM,48,-122,0,0,0
27126,ElliotBayTrailMyrtlePark,02/04/2017 06:00:00 AM,48,-122,0,1,1
27127,ElliotBayTrailMyrtlePark,02/04/2017 07:00:00 AM,48,-122,4,8,12
27128,ElliotBayTrailMyrtlePark,02/04/2017 08:00:00 AM,48,-122,2,2,4
27129,ElliotBayTrailMyrtlePark,02/04/2017 09:00:00 AM,48,-122,5,6,11
27130,ElliotBayTrailMyrtlePark,02/04/2017 10:00:00 AM,48,-122,12,9,21
27131,ElliotBayTrailMyrtlePark,02/04/2017 11:00:00 AM,48,-122,7,5,12
27132,ElliotBayTrailMyrtlePark,02/04/2017 12:00:00 PM,48,-122,3,2,5
27133,ElliotBayTrailMyrtlePark,02/04/2017 01:00:00 PM,48,-122,8,3,11
27134,ElliotBayTrailMyrtlePark,02/04/2017 02:00:00 PM,48,-122,7,5,12
27135,ElliotBayTrailMyrtlePark,02/04/2017 03:00:00 PM,48,-122,7,2,9
27136,ElliotBayTrailMyrtlePark,02/04/2017 04:00:00 PM,48,-122,4,4,8
27137,ElliotBayTrailMyrtlePark,02/04/2017 05:00:00 PM,48,-122,7,6,13
27138,ElliotBayTrailMyrtlePark,02/04/2017 06:00:00 PM,48,-122,2,2,4
27139,ElliotBayTrailMyrtlePark,02/04/2017 07:00:00 PM,48,-122,3,0,3
27140,ElliotBayTrailMyrtlePark,02/04/2017 08:00:00 PM,48,-122,0,2,2
27141,ElliotBayTrailMyrtlePark,02/04/2017 09:00:00 PM,48,-122,0,1,1
27142,ElliotBayTrailMyrtlePark,02/04/2017 10:00:00 PM,48,-122,0,2,2
27143,ElliotBayTrailMyrtlePark,02/04/2017 11:00:00 PM,48,-122,0,0,0
27144,ElliotBayTrailMyrtlePark,02/05/2017 12:00:00 AM,48,-122,0,0,0
27145,ElliotBayTrailMyrtlePark,02/05/2017 01:00:00 AM,48,-122,0,0,0
27146,ElliotBayTrailMyrtlePark,02/05/2017 02:00:00 AM,48,-122,0,0,0
27147,ElliotBayTrailMyrtlePark,02/05/2017 03:00:00 AM,48,-122,0,0,0
27148,ElliotBayTrailMyrtlePark,02/05/2017 04:00:00 AM,48,-122,0,0,0
27149,ElliotBayTrailMyrtlePark,02/05/2017 05:00:00 AM,48,-122,0,1,1
27150,ElliotBayTrailMyrtlePark,02/05/2017 06:00:00 AM,48,-122,2,0,2
27151,ElliotBayTrailMyrtlePark,02/05/2017 07:00:00 AM,48,-122,7,2,9
27152,ElliotBayTrailMyrtlePark,02/05/2017 08:00:00 AM,48,-122,6,7,13
27153,ElliotBayTrailMyrtlePark,02/05/2017 09:00:00 AM,48,-122,7,2,9
27154,ElliotBayTrailMyrtlePark,02/05/2017 10:00:00 AM,48,-122,3,5,8
27155,ElliotBayTrailMyrtlePark,02/05/2017 11:00:00 AM,48,-122,4,9,13
27156,ElliotBayTrailMyrtlePark,02/05/2017 12:00:00 PM,48,-122,6,5,11
27157,ElliotBayTrailMyrtlePark,02/05/2017 01:00:00 PM,48,-122,3,11,14
27158,ElliotBayTrailMyrtlePark,02/05/2017 02:00:00 PM,48,-122,3,1,4
27159,ElliotBayTrailMyrtlePark,02/05/2017 03:00:00 PM,48,-122,3,1,4
27160,ElliotBayTrailMyrtlePark,02/05/2017 04:00:00 PM,48,-122,3,1,4
27161,ElliotBayTrailMyrtlePark,02/05/2017 05:00:00 PM,48,-122,3,0,3
27162,ElliotBayTrailMyrtlePark,02/05/2017 06:00:00 PM,48,-122,0,0,0
27163,ElliotBayTrailMyrtlePark,02/05/2017 07:00:00 PM,48,-122,0,1,1
27164,ElliotBayTrailMyrtlePark,02/05/2017 08:00:00 PM,48,-122,1,0,1
27165,ElliotBayTrailMyrtlePark,02/05/2017 09:00:00 PM,48,-122,0,1,1
27166,ElliotBayTrailMyrtlePark,02/05/2017 10:00:00 PM,48,-122,0,0,0
27167,ElliotBayTrailMyrtlePark,02/05/2017 11:00:00 PM,48,-122,0,1,1
27168,ElliotBayTrailMyrtlePark,02/06/2017 12:00:00 AM,48,-122,0,0,0
27169,ElliotBayTrailMyrtlePark,02/06/2017 01:00:00 AM,48,-122,0,0,0
27170,ElliotBayTrailMyrtlePark,02/06/2017 02:00:00 AM,48,-122,0,0,0
27171,ElliotBayTrailMyrtlePark,02/06/2017 03:00:00 AM,48,-122,0,1,1
27172,ElliotBayTrailMyrtlePark,02/06/2017 04:00:00 AM,48,-122,0,0,0
27173,ElliotBayTrailMyrtlePark,02/06/2017 05:00:00 AM,48,-122,1,0,1
27174,ElliotBayTrailMyrtlePark,02/06/2017 06:00:00 AM,48,-122,2,5,7
27175,ElliotBayTrailMyrtlePark,02/06/2017 07:00:00 AM,48,-122,7,8,15
27176,ElliotBayTrailMyrtlePark,02/06/2017 08:00:00 AM,48,-122,3,7,10
27177,ElliotBayTrailMyrtlePark,02/06/2017 09:00:00 AM,48,-122,5,5,10
27178,ElliotBayTrailMyrtlePark,02/06/2017 10:00:00 AM,48,-122,2,6,8
27179,ElliotBayTrailMyrtlePark,02/06/2017 11:00:00 AM,48,-122,4,4,8
27180,ElliotBayTrailMyrtlePark,02/06/2017 12:00:00 PM,48,-122,2,0,2
27181,ElliotBayTrailMyrtlePark,02/06/2017 01:00:00 PM,48,-122,1,3,4
27182,ElliotBayTrailMyrtlePark,02/06/2017 02:00:00 PM,48,-122,5,1,6
27183,ElliotBayTrailMyrtlePark,02/06/2017 03:00:00 PM,48,-122,10,5,15
27184,ElliotBayTrailMyrtlePark,02/06/2017 04:00:00 PM,48,-122,8,5,13
27185,ElliotBayTrailMyrtlePark,02/06/2017 05:00:00 PM,48,-122,15,4,19
27186,ElliotBayTrailMyrtlePark,02/06/2017 06:00:00 PM,48,-122,5,1,6
27187,ElliotBayTrailMyrtlePark,02/06/2017 07:00:00 PM,48,-122,0,0,0
27188,ElliotBayTrailMyrtlePark,02/06/2017 08:00:00 PM,48,-122,0,1,1
27189,ElliotBayTrailMyrtlePark,02/06/2017 09:00:00 PM,48,-122,1,1,2
27190,ElliotBayTrailMyrtlePark,02/06/2017 10:00:00 PM,48,-122,0,0,0
27191,ElliotBayTrailMyrtlePark,02/06/2017 11:00:00 PM,48,-122,0,0,0
27192,ElliotBayTrailMyrtlePark,02/07/2017 12:00:00 AM,48,-122,0,0,0
27193,ElliotBayTrailMyrtlePark,02/07/2017 01:00:00 AM,48,-122,0,0,0
27194,ElliotBayTrailMyrtlePark,02/07/2017 02:00:00 AM,48,-122,0,0,0
27195,ElliotBayTrailMyrtlePark,02/07/2017 03:00:00 AM,48,-122,0,1,1
27196,ElliotBayTrailMyrtlePark,02/07/2017 04:00:00 AM,48,-122,0,1,1
27197,ElliotBayTrailMyrtlePark,02/07/2017 05:00:00 AM,48,-122,8,7,15
27198,ElliotBayTrailMyrtlePark,02/07/2017 06:00:00 AM,48,-122,5,12,17
27199,ElliotBayTrailMyrtlePark,02/07/2017 07:00:00 AM,48,-122,12,54,66
27200,ElliotBayTrailMyrtlePark,02/07/2017 08:00:00 AM,48,-122,3,51,54
27201,ElliotBayTrailMyrtlePark,02/07/2017 09:00:00 AM,48,-122,12,16,28
27202,ElliotBayTrailMyrtlePark,02/07/2017 10:00:00 AM,48,-122,1,6,7
27203,ElliotBayTrailMyrtlePark,02/07/2017 11:00:00 AM,48,-122,2,6,8
27204,ElliotBayTrailMyrtlePark,02/07/2017 12:00:00 PM,48,-122,10,10,20
27205,ElliotBayTrailMyrtlePark,02/07/2017 01:00:00 PM,48,-122,15,12,27
27206,ElliotBayTrailMyrtlePark,02/07/2017 02:00:00 PM,48,-122,5,6,11
27207,ElliotBayTrailMyrtlePark,02/07/2017 03:00:00 PM,48,-122,12,8,20
27208,ElliotBayTrailMyrtlePark,02/07/2017 04:00:00 PM,48,-122,27,13,40
27209,ElliotBayTrailMyrtlePark,02/07/2017 05:00:00 PM,48,-122,54,16,70
27210,ElliotBayTrailMyrtlePark,02/07/2017 06:00:00 PM,48,-122,40,4,44
27211,ElliotBayTrailMyrtlePark,02/07/2017 07:00:00 PM,48,-122,9,2,11
27212,ElliotBayTrailMyrtlePark,02/07/2017 08:00:00 PM,48,-122,4,0,4
27213,ElliotBayTrailMyrtlePark,02/07/2017 09:00:00 PM,48,-122,2,2,4
27214,ElliotBayTrailMyrtlePark,02/07/2017 10:00:00 PM,48,-122,1,0,1
27215,ElliotBayTrailMyrtlePark,02/07/2017 11:00:00 PM,48,-122,0,2,2
27216,ElliotBayTrailMyrtlePark,02/08/2017 12:00:00 AM,48,-122,0,0,0
27217,ElliotBayTrailMyrtlePark,02/08/2017 01:00:00 AM,48,-122,2,0,2
27218,ElliotBayTrailMyrtlePark,02/08/2017 02:00:00 AM,48,-122,0,0,0
27219,ElliotBayTrailMyrtlePark,02/08/2017 03:00:00 AM,48,-122,0,1,1
27220,ElliotBayTrailMyrtlePark,02/08/2017 04:00:00 AM,48,-122,0,1,1
27221,ElliotBayTrailMyrtlePark,02/08/2017 05:00:00 AM,48,-122,4,8,12
27222,ElliotBayTrailMyrtlePark,02/08/2017 06:00:00 AM,48,-122,9,12,21
27223,ElliotBayTrailMyrtlePark,02/08/2017 07:00:00 AM,48,-122,15,44,59
27224,ElliotBayTrailMyrtlePark,02/08/2017 08:00:00 AM,48,-122,16,60,76
27225,ElliotBayTrailMyrtlePark,02/08/2017 09:00:00 AM,48,-122,9,28,37
27226,ElliotBayTrailMyrtlePark,02/08/2017 10:00:00 AM,48,-122,2,8,10
27227,ElliotBayTrailMyrtlePark,02/08/2017 11:00:00 AM,48,-122,1,3,4
27228,ElliotBayTrailMyrtlePark,02/08/2017 12:00:00 PM,48,-122,7,2,9
27229,ElliotBayTrailMyrtlePark,02/08/2017 01:00:00 PM,48,-122,6,2,8
27230,ElliotBayTrailMyrtlePark,02/08/2017 02:00:00 PM,48,-122,6,12,18
27231,ElliotBayTrailMyrtlePark,02/08/2017 03:00:00 PM,48,-122,7,6,13
27232,ElliotBayTrailMyrtlePark,02/08/2017 04:00:00 PM,48,-122,28,16,44
27233,ElliotBayTrailMyrtlePark,02/08/2017 05:00:00 PM,48,-122,66,19,85
27234,ElliotBayTrailMyrtlePark,02/08/2017 06:00:00 PM,48,-122,25,5,30
27235,ElliotBayTrailMyrtlePark,02/08/2017 07:00:00 PM,48,-122,15,3,18
27236,ElliotBayTrailMyrtlePark,02/08/2017 08:00:00 PM,48,-122,2,1,3
27237,ElliotBayTrailMyrtlePark,02/08/2017 09:00:00 PM,48,-122,5,3,8
27238,ElliotBayTrailMyrtlePark,02/08/2017 10:00:00 PM,48,-122,3,0,3
27239,ElliotBayTrailMyrtlePark,02/08/2017 11:00:00 PM,48,-122,0,0,0
27240,ElliotBayTrailMyrtlePark,02/09/2017 12:00:00 AM,48,-122,0,0,0
27241,ElliotBayTrailMyrtlePark,02/09/2017 01:00:00 AM,48,-122,0,0,0
27242,ElliotBayTrailMyrtlePark,02/09/2017 02:00:00 AM,48,-122,1,0,1
27243,ElliotBayTrailMyrtlePark,02/09/2017 03:00:00 AM,48,-122,1,0,1
27244,ElliotBayTrailMyrtlePark,02/09/2017 04:00:00 AM,48,-122,0,1,1
27245,ElliotBayTrailMyrtlePark,02/09/2017 05:00:00 AM,48,-122,7,3,10
27246,ElliotBayTrailMyrtlePark,02/09/2017 06:00:00 AM,48,-122,17,6,23
27247,ElliotBayTrailMyrtlePark,02/09/2017 07:00:00 AM,48,-122,32,20,52
27248,ElliotBayTrailMyrtlePark,02/09/2017 08:00:00 AM,48,-122,27,24,51
27249,ElliotBayTrailMyrtlePark,02/09/2017 09:00:00 AM,48,-122,15,17,32
27250,ElliotBayTrailMyrtlePark,02/09/2017 10:00:00 AM,48,-122,6,6,12
27251,ElliotBayTrailMyrtlePark,02/09/2017 11:00:00 AM,48,-122,4,3,7
27252,ElliotBayTrailMyrtlePark,02/09/2017 12:00:00 PM,48,-122,5,1,6
27253,ElliotBayTrailMyrtlePark,02/09/2017 01:00:00 PM,48,-122,3,4,7
27254,ElliotBayTrailMyrtlePark,02/09/2017 02:00:00 PM,48,-122,6,8,14
27255,ElliotBayTrailMyrtlePark,02/09/2017 03:00:00 PM,48,-122,11,15,26
27256,ElliotBayTrailMyrtlePark,02/09/2017 04:00:00 PM,48,-122,27,19,46
27257,ElliotBayTrailMyrtlePark,02/09/2017 05:00:00 PM,48,-122,47,16,63
27258,ElliotBayTrailMyrtlePark,02/09/2017 06:00:00 PM,48,-122,32,7,39
27259,ElliotBayTrailMyrtlePark,02/09/2017 07:00:00 PM,48,-122,21,9,30
27260,ElliotBayTrailMyrtlePark,02/09/2017 08:00:00 PM,48,-122,3,1,4
27261,ElliotBayTrailMyrtlePark,02/09/2017 09:00:00 PM,48,-122,5,2,7
27262,ElliotBayTrailMyrtlePark,02/09/2017 10:00:00 PM,48,-122,3,0,3
27263,ElliotBayTrailMyrtlePark,02/09/2017 11:00:00 PM,48,-122,3,1,4
27264,ElliotBayTrailMyrtlePark,02/10/2017 12:00:00 AM,48,-122,3,0,3
27265,ElliotBayTrailMyrtlePark,02/10/2017 01:00:00 AM,48,-122,0,0,0
27266,ElliotBayTrailMyrtlePark,02/10/2017 02:00:00 AM,48,-122,1,0,1
27267,ElliotBayTrailMyrtlePark,02/10/2017 03:00:00 AM,48,-122,0,0,0
27268,ElliotBayTrailMyrtlePark,02/10/2017 04:00:00 AM,48,-122,0,1,1
27269,ElliotBayTrailMyrtlePark,02/10/2017 05:00:00 AM,48,-122,6,6,12
27270,ElliotBayTrailMyrtlePark,02/10/2017 06:00:00 AM,48,-122,8,7,15
27271,ElliotBayTrailMyrtlePark,02/10/2017 07:00:00 AM,48,-122,25,36,61
27272,ElliotBayTrailMyrtlePark,02/10/2017 08:00:00 AM,48,-122,22,66,88
27273,ElliotBayTrailMyrtlePark,02/10/2017 09:00:00 AM,48,-122,18,33,51
27274,ElliotBayTrailMyrtlePark,02/10/2017 10:00:00 AM,48,-122,8,10,18
27275,ElliotBayTrailMyrtlePark,02/10/2017 11:00:00 AM,48,-122,4,6,10
27276,ElliotBayTrailMyrtlePark,02/10/2017 12:00:00 PM,48,-122,4,1,5
27277,ElliotBayTrailMyrtlePark,02/10/2017 01:00:00 PM,48,-122,10,1,11
27278,ElliotBayTrailMyrtlePark,02/10/2017 02:00:00 PM,48,-122,14,10,24
27279,ElliotBayTrailMyrtlePark,02/10/2017 03:00:00 PM,48,-122,13,11,24
27280,ElliotBayTrailMyrtlePark,02/10/2017 04:00:00 PM,48,-122,37,26,63
27281,ElliotBayTrailMyrtlePark,02/10/2017 05:00:00 PM,48,-122,83,29,112
27282,ElliotBayTrailMyrtlePark,02/10/2017 06:00:00 PM,48,-122,30,6,36
27283,ElliotBayTrailMyrtlePark,02/10/2017 07:00:00 PM,48,-122,16,3,19
27284,ElliotBayTrailMyrtlePark,02/10/2017 08:00:00 PM,48,-122,4,2,6
27285,ElliotBayTrailMyrtlePark,02/10/2017 09:00:00 PM,48,-122,1,2,3
27286,ElliotBayTrailMyrtlePark,02/10/2017 10:00:00 PM,48,-122,0,0,0
27287,ElliotBayTrailMyrtlePark,02/10/2017 11:00:00 PM,48,-122,2,0,2
27288,ElliotBayTrailMyrtlePark,02/11/2017 12:00:00 AM,48,-122,3,0,3
27289,ElliotBayTrailMyrtlePark,02/11/2017 01:00:00 AM,48,-122,0,0,0
27290,ElliotBayTrailMyrtlePark,02/11/2017 02:00:00 AM,48,-122,0,0,0
27291,ElliotBayTrailMyrtlePark,02/11/2017 03:00:00 AM,48,-122,0,0,0
27292,ElliotBayTrailMyrtlePark,02/11/2017 04:00:00 AM,48,-122,1,0,1
27293,ElliotBayTrailMyrtlePark,02/11/2017 05:00:00 AM,48,-122,1,1,2
27294,ElliotBayTrailMyrtlePark,02/11/2017 06:00:00 AM,48,-122,1,2,3
27295,ElliotBayTrailMyrtlePark,02/11/2017 07:00:00 AM,48,-122,5,3,8
27296,ElliotBayTrailMyrtlePark,02/11/2017 08:00:00 AM,48,-122,13,13,26
27297,ElliotBayTrailMyrtlePark,02/11/2017 09:00:00 AM,48,-122,12,12,24
27298,ElliotBayTrailMyrtlePark,02/11/2017 10:00:00 AM,48,-122,15,20,35
27299,ElliotBayTrailMyrtlePark,02/11/2017 11:00:00 AM,48,-122,33,27,60
27300,ElliotBayTrailMyrtlePark,02/11/2017 12:00:00 PM,48,-122,30,36,66
27301,ElliotBayTrailMyrtlePark,02/11/2017 01:00:00 PM,48,-122,34,27,61
27302,ElliotBayTrailMyrtlePark,02/11/2017 02:00:00 PM,48,-122,23,26,49
27303,ElliotBayTrailMyrtlePark,02/11/2017 03:00:00 PM,48,-122,42,33,75
27304,ElliotBayTrailMyrtlePark,02/11/2017 04:00:00 PM,48,-122,30,28,58
27305,ElliotBayTrailMyrtlePark,02/11/2017 05:00:00 PM,48,-122,17,18,35
27306,ElliotBayTrailMyrtlePark,02/11/2017 06:00:00 PM,48,-122,10,3,13
27307,ElliotBayTrailMyrtlePark,02/11/2017 07:00:00 PM,48,-122,4,3,7
27308,ElliotBayTrailMyrtlePark,02/11/2017 08:00:00 PM,48,-122,0,1,1
27309,ElliotBayTrailMyrtlePark,02/11/2017 09:00:00 PM,48,-122,4,1,5
27310,ElliotBayTrailMyrtlePark,02/11/2017 10:00:00 PM,48,-122,3,0,3
27311,ElliotBayTrailMyrtlePark,02/11/2017 11:00:00 PM,48,-122,0,2,2
27312,ElliotBayTrailMyrtlePark,02/12/2017 12:00:00 AM,48,-122,0,0,0
27313,ElliotBayTrailMyrtlePark,02/12/2017 01:00:00 AM,48,-122,0,0,0
27314,ElliotBayTrailMyrtlePark,02/12/2017 02:00:00 AM,48,-122,0,0,0
27315,ElliotBayTrailMyrtlePark,02/12/2017 03:00:00 AM,48,-122,0,1,1
27316,ElliotBayTrailMyrtlePark,02/12/2017 04:00:00 AM,48,-122,0,0,0
27317,ElliotBayTrailMyrtlePark,02/12/2017 05:00:00 AM,48,-122,0,0,0
27318,ElliotBayTrailMyrtlePark,02/12/2017 06:00:00 AM,48,-122,1,1,2
27319,ElliotBayTrailMyrtlePark,02/12/2017 07:00:00 AM,48,-122,6,2,8
27320,ElliotBayTrailMyrtlePark,02/12/2017 08:00:00 AM,48,-122,4,9,13
27321,ElliotBayTrailMyrtlePark,02/12/2017 09:00:00 AM,48,-122,19,19,38
27322,ElliotBayTrailMyrtlePark,02/12/2017 10:00:00 AM,48,-122,14,5,19
27323,ElliotBayTrailMyrtlePark,02/12/2017 11:00:00 AM,48,-122,32,39,71
27324,ElliotBayTrailMyrtlePark,02/12/2017 12:00:00 PM,48,-122,45,26,71
27325,ElliotBayTrailMyrtlePark,02/12/2017 01:00:00 PM,48,-122,54,49,103
27326,ElliotBayTrailMyrtlePark,02/12/2017 02:00:00 PM,48,-122,61,50,111
27327,ElliotBayTrailMyrtlePark,02/12/2017 03:00:00 PM,48,-122,56,57,113
27328,ElliotBayTrailMyrtlePark,02/12/2017 04:00:00 PM,48,-122,42,45,87
27329,ElliotBayTrailMyrtlePark,02/12/2017 05:00:00 PM,48,-122,31,20,51
27330,ElliotBayTrailMyrtlePark,02/12/2017 06:00:00 PM,48,-122,11,4,15
27331,ElliotBayTrailMyrtlePark,02/12/2017 07:00:00 PM,48,-122,2,0,2
27332,ElliotBayTrailMyrtlePark,02/12/2017 08:00:00 PM,48,-122,3,4,7
27333,ElliotBayTrailMyrtlePark,02/12/2017 09:00:00 PM,48,-122,0,0,0
27334,ElliotBayTrailMyrtlePark,02/12/2017 10:00:00 PM,48,-122,1,0,1
27335,ElliotBayTrailMyrtlePark,02/12/2017 11:00:00 PM,48,-122,0,1,1
27336,ElliotBayTrailMyrtlePark,02/13/2017 12:00:00 AM,48,-122,1,2,3
27337,ElliotBayTrailMyrtlePark,02/13/2017 01:00:00 AM,48,-122,0,0,0
27338,ElliotBayTrailMyrtlePark,02/13/2017 02:00:00 AM,48,-122,0,0,0
27339,ElliotBayTrailMyrtlePark,02/13/2017 03:00:00 AM,48,-122,0,1,1
27340,ElliotBayTrailMyrtlePark,02/13/2017 04:00:00 AM,48,-122,0,0,0
27341,ElliotBayTrailMyrtlePark,02/13/2017 05:00:00 AM,48,-122,3,9,12
27342,ElliotBayTrailMyrtlePark,02/13/2017 06:00:00 AM,48,-122,21,23,44
27343,ElliotBayTrailMyrtlePark,02/13/2017 07:00:00 AM,48,-122,30,73,103
27344,ElliotBayTrailMyrtlePark,02/13/2017 08:00:00 AM,48,-122,25,144,169
27345,ElliotBayTrailMyrtlePark,02/13/2017 09:00:00 AM,48,-122,18,52,70
27346,ElliotBayTrailMyrtlePark,02/13/2017 10:00:00 AM,48,-122,9,24,33
27347,ElliotBayTrailMyrtlePark,02/13/2017 11:00:00 AM,48,-122,22,23,45
27348,ElliotBayTrailMyrtlePark,02/13/2017 12:00:00 PM,48,-122,15,13,28
27349,ElliotBayTrailMyrtlePark,02/13/2017 01:00:00 PM,48,-122,19,18,37
27350,ElliotBayTrailMyrtlePark,02/13/2017 02:00:00 PM,48,-122,22,22,44
27351,ElliotBayTrailMyrtlePark,02/13/2017 03:00:00 PM,48,-122,45,43,88
27352,ElliotBayTrailMyrtlePark,02/13/2017 04:00:00 PM,48,-122,96,53,149
27353,ElliotBayTrailMyrtlePark,02/13/2017 05:00:00 PM,48,-122,147,62,209
27354,ElliotBayTrailMyrtlePark,02/13/2017 06:00:00 PM,48,-122,71,22,93
27355,ElliotBayTrailMyrtlePark,02/13/2017 07:00:00 PM,48,-122,17,10,27
27356,ElliotBayTrailMyrtlePark,02/13/2017 08:00:00 PM,48,-122,14,0,14
27357,ElliotBayTrailMyrtlePark,02/13/2017 09:00:00 PM,48,-122,3,4,7
27358,ElliotBayTrailMyrtlePark,02/13/2017 10:00:00 PM,48,-122,4,0,4
27359,ElliotBayTrailMyrtlePark,02/13/2017 11:00:00 PM,48,-122,1,1,2
27360,ElliotBayTrailMyrtlePark,02/14/2017 12:00:00 AM,48,-122,0,0,0
27361,ElliotBayTrailMyrtlePark,02/14/2017 01:00:00 AM,48,-122,0,0,0
27362,ElliotBayTrailMyrtlePark,02/14/2017 02:00:00 AM,48,-122,0,0,0
27363,ElliotBayTrailMyrtlePark,02/14/2017 03:00:00 AM,48,-122,1,1,2
27364,ElliotBayTrailMyrtlePark,02/14/2017 04:00:00 AM,48,-122,0,0,0
27365,ElliotBayTrailMyrtlePark,02/14/2017 05:00:00 AM,48,-122,7,14,21
27366,ElliotBayTrailMyrtlePark,02/14/2017 06:00:00 AM,48,-122,11,29,40
27367,ElliotBayTrailMyrtlePark,02/14/2017 07:00:00 AM,48,-122,32,68,100
27368,ElliotBayTrailMyrtlePark,02/14/2017 08:00:00 AM,48,-122,28,134,162
27369,ElliotBayTrailMyrtlePark,02/14/2017 09:00:00 AM,48,-122,14,45,59
27370,ElliotBayTrailMyrtlePark,02/14/2017 10:00:00 AM,48,-122,7,20,27
27371,ElliotBayTrailMyrtlePark,02/14/2017 11:00:00 AM,48,-122,10,18,28
27372,ElliotBayTrailMyrtlePark,02/14/2017 12:00:00 PM,48,-122,18,15,33
27373,ElliotBayTrailMyrtlePark,02/14/2017 01:00:00 PM,48,-122,19,9,28
27374,ElliotBayTrailMyrtlePark,02/14/2017 02:00:00 PM,48,-122,13,14,27
27375,ElliotBayTrailMyrtlePark,02/14/2017 03:00:00 PM,48,-122,32,21,53
27376,ElliotBayTrailMyrtlePark,02/14/2017 04:00:00 PM,48,-122,74,33,107
27377,ElliotBayTrailMyrtlePark,02/14/2017 05:00:00 PM,48,-122,159,41,200
27378,ElliotBayTrailMyrtlePark,02/14/2017 06:00:00 PM,48,-122,65,7,72
27379,ElliotBayTrailMyrtlePark,02/14/2017 07:00:00 PM,48,-122,17,2,19
27380,ElliotBayTrailMyrtlePark,02/14/2017 08:00:00 PM,48,-122,11,2,13
27381,ElliotBayTrailMyrtlePark,02/14/2017 09:00:00 PM,48,-122,2,1,3
27382,ElliotBayTrailMyrtlePark,02/14/2017 10:00:00 PM,48,-122,3,1,4
27383,ElliotBayTrailMyrtlePark,02/14/2017 11:00:00 PM,48,-122,0,0,0
27384,ElliotBayTrailMyrtlePark,02/15/2017 12:00:00 AM,48,-122,0,0,0
27385,ElliotBayTrailMyrtlePark,02/15/2017 01:00:00 AM,48,-122,2,0,2
27386,ElliotBayTrailMyrtlePark,02/15/2017 02:00:00 AM,48,-122,1,0,1
27387,ElliotBayTrailMyrtlePark,02/15/2017 03:00:00 AM,48,-122,0,1,1
27388,ElliotBayTrailMyrtlePark,02/15/2017 04:00:00 AM,48,-122,0,1,1
27389,ElliotBayTrailMyrtlePark,02/15/2017 05:00:00 AM,48,-122,3,6,9
27390,ElliotBayTrailMyrtlePark,02/15/2017 06:00:00 AM,48,-122,15,18,33
27391,ElliotBayTrailMyrtlePark,02/15/2017 07:00:00 AM,48,-122,24,39,63
27392,ElliotBayTrailMyrtlePark,02/15/2017 08:00:00 AM,48,-122,25,51,76
27393,ElliotBayTrailMyrtlePark,02/15/2017 09:00:00 AM,48,-122,6,31,37
27394,ElliotBayTrailMyrtlePark,02/15/2017 10:00:00 AM,48,-122,0,6,6
27395,ElliotBayTrailMyrtlePark,02/15/2017 11:00:00 AM,48,-122,2,4,6
27396,ElliotBayTrailMyrtlePark,02/15/2017 12:00:00 PM,48,-122,4,0,4
27397,ElliotBayTrailMyrtlePark,02/15/2017 01:00:00 PM,48,-122,7,2,9
27398,ElliotBayTrailMyrtlePark,02/15/2017 02:00:00 PM,48,-122,3,4,7
27399,ElliotBayTrailMyrtlePark,02/15/2017 03:00:00 PM,48,-122,9,9,18
27400,ElliotBayTrailMyrtlePark,02/15/2017 04:00:00 PM,48,-122,29,10,39
27401,ElliotBayTrailMyrtlePark,02/15/2017 05:00:00 PM,48,-122,75,28,103
27402,ElliotBayTrailMyrtlePark,02/15/2017 06:00:00 PM,48,-122,34,3,37
27403,ElliotBayTrailMyrtlePark,02/15/2017 07:00:00 PM,48,-122,11,2,13
27404,ElliotBayTrailMyrtlePark,02/15/2017 08:00:00 PM,48,-122,4,0,4
27405,ElliotBayTrailMyrtlePark,02/15/2017 09:00:00 PM,48,-122,5,1,6
27406,ElliotBayTrailMyrtlePark,02/15/2017 10:00:00 PM,48,-122,1,2,3
27407,ElliotBayTrailMyrtlePark,02/15/2017 11:00:00 PM,48,-122,2,0,2
27408,ElliotBayTrailMyrtlePark,02/16/2017 12:00:00 AM,48,-122,0,0,0
27409,ElliotBayTrailMyrtlePark,02/16/2017 01:00:00 AM,48,-122,0,1,1
27410,ElliotBayTrailMyrtlePark,02/16/2017 02:00:00 AM,48,-122,0,0,0
27411,ElliotBayTrailMyrtlePark,02/16/2017 03:00:00 AM,48,-122,1,0,1
27412,ElliotBayTrailMyrtlePark,02/16/2017 04:00:00 AM,48,-122,0,0,0
27413,ElliotBayTrailMyrtlePark,02/16/2017 05:00:00 AM,48,-122,3,8,11
27414,ElliotBayTrailMyrtlePark,02/16/2017 06:00:00 AM,48,-122,11,22,33
27415,ElliotBayTrailMyrtlePark,02/16/2017 07:00:00 AM,48,-122,29,40,69
27416,ElliotBayTrailMyrtlePark,02/16/2017 08:00:00 AM,48,-122,24,97,121
27417,ElliotBayTrailMyrtlePark,02/16/2017 09:00:00 AM,48,-122,12,27,39
27418,ElliotBayTrailMyrtlePark,02/16/2017 10:00:00 AM,48,-122,8,20,28
27419,ElliotBayTrailMyrtlePark,02/16/2017 11:00:00 AM,48,-122,9,14,23
27420,ElliotBayTrailMyrtlePark,02/16/2017 12:00:00 PM,48,-122,9,17,26
27421,ElliotBayTrailMyrtlePark,02/16/2017 01:00:00 PM,48,-122,18,9,27
27422,ElliotBayTrailMyrtlePark,02/16/2017 02:00:00 PM,48,-122,6,14,20
27423,ElliotBayTrailMyrtlePark,02/16/2017 03:00:00 PM,48,-122,30,26,56
27424,ElliotBayTrailMyrtlePark,02/16/2017 04:00:00 PM,48,-122,55,29,84
27425,ElliotBayTrailMyrtlePark,02/16/2017 05:00:00 PM,48,-122,102,28,130
27426,ElliotBayTrailMyrtlePark,02/16/2017 06:00:00 PM,48,-122,44,9,53
27427,ElliotBayTrailMyrtlePark,02/16/2017 07:00:00 PM,48,-122,17,8,25
27428,ElliotBayTrailMyrtlePark,02/16/2017 08:00:00 PM,48,-122,8,0,8
27429,ElliotBayTrailMyrtlePark,02/16/2017 09:00:00 PM,48,-122,2,5,7
27430,ElliotBayTrailMyrtlePark,02/16/2017 10:00:00 PM,48,-122,3,3,6
27431,ElliotBayTrailMyrtlePark,02/16/2017 11:00:00 PM,48,-122,0,0,0
27432,ElliotBayTrailMyrtlePark,02/17/2017 12:00:00 AM,48,-122,1,0,1
27433,ElliotBayTrailMyrtlePark,02/17/2017 01:00:00 AM,48,-122,0,0,0
27434,ElliotBayTrailMyrtlePark,02/17/2017 02:00:00 AM,48,-122,1,0,1
27435,ElliotBayTrailMyrtlePark,02/17/2017 03:00:00 AM,48,-122,0,0,0
27436,ElliotBayTrailMyrtlePark,02/17/2017 04:00:00 AM,48,-122,0,1,1
27437,ElliotBayTrailMyrtlePark,02/17/2017 05:00:00 AM,48,-122,6,9,15
27438,ElliotBayTrailMyrtlePark,02/17/2017 06:00:00 AM,48,-122,12,17,29
27439,ElliotBayTrailMyrtlePark,02/17/2017 07:00:00 AM,48,-122,26,59,85
27440,ElliotBayTrailMyrtlePark,02/17/2017 08:00:00 AM,48,-122,36,108,144
27441,ElliotBayTrailMyrtlePark,02/17/2017 09:00:00 AM,48,-122,17,35,52
27442,ElliotBayTrailMyrtlePark,02/17/2017 10:00:00 AM,48,-122,15,16,31
27443,ElliotBayTrailMyrtlePark,02/17/2017 11:00:00 AM,48,-122,13,17,30
27444,ElliotBayTrailMyrtlePark,02/17/2017 12:00:00 PM,48,-122,25,16,41
27445,ElliotBayTrailMyrtlePark,02/17/2017 01:00:00 PM,48,-122,21,22,43
27446,ElliotBayTrailMyrtlePark,02/17/2017 02:00:00 PM,48,-122,34,28,62
27447,ElliotBayTrailMyrtlePark,02/17/2017 03:00:00 PM,48,-122,45,35,80
27448,ElliotBayTrailMyrtlePark,02/17/2017 04:00:00 PM,48,-122,91,48,139
27449,ElliotBayTrailMyrtlePark,02/17/2017 05:00:00 PM,48,-122,105,48,153
27450,ElliotBayTrailMyrtlePark,02/17/2017 06:00:00 PM,48,-122,56,18,74
27451,ElliotBayTrailMyrtlePark,02/17/2017 07:00:00 PM,48,-122,13,5,18
27452,ElliotBayTrailMyrtlePark,02/17/2017 08:00:00 PM,48,-122,11,1,12
27453,ElliotBayTrailMyrtlePark,02/17/2017 09:00:00 PM,48,-122,3,2,5
27454,ElliotBayTrailMyrtlePark,02/17/2017 10:00:00 PM,48,-122,1,3,4
27455,ElliotBayTrailMyrtlePark,02/17/2017 11:00:00 PM,48,-122,4,1,5
27456,ElliotBayTrailMyrtlePark,02/18/2017 12:00:00 AM,48,-122,0,0,0
27457,ElliotBayTrailMyrtlePark,02/18/2017 01:00:00 AM,48,-122,1,0,1
27458,ElliotBayTrailMyrtlePark,02/18/2017 02:00:00 AM,48,-122,1,0,1
27459,ElliotBayTrailMyrtlePark,02/18/2017 03:00:00 AM,48,-122,0,0,0
27460,ElliotBayTrailMyrtlePark,02/18/2017 04:00:00 AM,48,-122,0,0,0
27461,ElliotBayTrailMyrtlePark,02/18/2017 05:00:00 AM,48,-122,0,3,3
27462,ElliotBayTrailMyrtlePark,02/18/2017 06:00:00 AM,48,-122,0,2,2
27463,ElliotBayTrailMyrtlePark,02/18/2017 07:00:00 AM,48,-122,3,5,8
27464,ElliotBayTrailMyrtlePark,02/18/2017 08:00:00 AM,48,-122,7,6,13
27465,ElliotBayTrailMyrtlePark,02/18/2017 09:00:00 AM,48,-122,3,9,12
27466,ElliotBayTrailMyrtlePark,02/18/2017 10:00:00 AM,48,-122,5,7,12
27467,ElliotBayTrailMyrtlePark,02/18/2017 11:00:00 AM,48,-122,12,14,26
27468,ElliotBayTrailMyrtlePark,02/18/2017 12:00:00 PM,48,-122,9,6,15
27469,ElliotBayTrailMyrtlePark,02/18/2017 01:00:00 PM,48,-122,9,7,16
27470,ElliotBayTrailMyrtlePark,02/18/2017 02:00:00 PM,48,-122,8,8,16
27471,ElliotBayTrailMyrtlePark,02/18/2017 03:00:00 PM,48,-122,13,5,18
27472,ElliotBayTrailMyrtlePark,02/18/2017 04:00:00 PM,48,-122,9,4,13
27473,ElliotBayTrailMyrtlePark,02/18/2017 05:00:00 PM,48,-122,7,8,15
27474,ElliotBayTrailMyrtlePark,02/18/2017 06:00:00 PM,48,-122,3,9,12
27475,ElliotBayTrailMyrtlePark,02/18/2017 07:00:00 PM,48,-122,4,2,6
27476,ElliotBayTrailMyrtlePark,02/18/2017 08:00:00 PM,48,-122,1,1,2
27477,ElliotBayTrailMyrtlePark,02/18/2017 09:00:00 PM,48,-122,1,1,2
27478,ElliotBayTrailMyrtlePark,02/18/2017 10:00:00 PM,48,-122,2,1,3
27479,ElliotBayTrailMyrtlePark,02/18/2017 11:00:00 PM,48,-122,0,1,1
27480,ElliotBayTrailMyrtlePark,02/19/2017 12:00:00 AM,48,-122,0,1,1
27481,ElliotBayTrailMyrtlePark,02/19/2017 01:00:00 AM,48,-122,0,0,0
27482,ElliotBayTrailMyrtlePark,02/19/2017 02:00:00 AM,48,-122,0,0,0
27483,ElliotBayTrailMyrtlePark,02/19/2017 03:00:00 AM,48,-122,0,0,0
27484,ElliotBayTrailMyrtlePark,02/19/2017 04:00:00 AM,48,-122,0,0,0
27485,ElliotBayTrailMyrtlePark,02/19/2017 05:00:00 AM,48,-122,0,1,1
27486,ElliotBayTrailMyrtlePark,02/19/2017 06:00:00 AM,48,-122,0,1,1
27487,ElliotBayTrailMyrtlePark,02/19/2017 07:00:00 AM,48,-122,2,1,3
27488,ElliotBayTrailMyrtlePark,02/19/2017 08:00:00 AM,48,-122,3,3,6
27489,ElliotBayTrailMyrtlePark,02/19/2017 09:00:00 AM,48,-122,5,11,16
27490,ElliotBayTrailMyrtlePark,02/19/2017 10:00:00 AM,48,-122,15,9,24
27491,ElliotBayTrailMyrtlePark,02/19/2017 11:00:00 AM,48,-122,11,6,17
27492,ElliotBayTrailMyrtlePark,02/19/2017 12:00:00 PM,48,-122,20,17,37
27493,ElliotBayTrailMyrtlePark,02/19/2017 01:00:00 PM,48,-122,10,8,18
27494,ElliotBayTrailMyrtlePark,02/19/2017 02:00:00 PM,48,-122,4,6,10
27495,ElliotBayTrailMyrtlePark,02/19/2017 03:00:00 PM,48,-122,2,9,11
27496,ElliotBayTrailMyrtlePark,02/19/2017 04:00:00 PM,48,-122,7,6,13
27497,ElliotBayTrailMyrtlePark,02/19/2017 05:00:00 PM,48,-122,7,2,9
27498,ElliotBayTrailMyrtlePark,02/19/2017 06:00:00 PM,48,-122,7,0,7
27499,ElliotBayTrailMyrtlePark,02/19/2017 07:00:00 PM,48,-122,0,0,0
27500,ElliotBayTrailMyrtlePark,02/19/2017 08:00:00 PM,48,-122,0,2,2
27501,ElliotBayTrailMyrtlePark,02/19/2017 09:00:00 PM,48,-122,3,1,4
27502,ElliotBayTrailMyrtlePark,02/19/2017 10:00:00 PM,48,-122,1,1,2
27503,ElliotBayTrailMyrtlePark,02/19/2017 11:00:00 PM,48,-122,0,0,0
27504,ElliotBayTrailMyrtlePark,02/20/2017 12:00:00 AM,48,-122,0,4,4
27505,ElliotBayTrailMyrtlePark,02/20/2017 01:00:00 AM,48,-122,0,0,0
27506,ElliotBayTrailMyrtlePark,02/20/2017 02:00:00 AM,48,-122,0,0,0
27507,ElliotBayTrailMyrtlePark,02/20/2017 03:00:00 AM,48,-122,0,0,0
27508,ElliotBayTrailMyrtlePark,02/20/2017 04:00:00 AM,48,-122,0,0,0
27509,ElliotBayTrailMyrtlePark,02/20/2017 05:00:00 AM,48,-122,9,1,10
27510,ElliotBayTrailMyrtlePark,02/20/2017 06:00:00 AM,48,-122,4,5,9
27511,ElliotBayTrailMyrtlePark,02/20/2017 07:00:00 AM,48,-122,5,20,25
27512,ElliotBayTrailMyrtlePark,02/20/2017 08:00:00 AM,48,-122,14,28,42
27513,ElliotBayTrailMyrtlePark,02/20/2017 09:00:00 AM,48,-122,11,18,29
27514,ElliotBayTrailMyrtlePark,02/20/2017 10:00:00 AM,48,-122,5,11,16
27515,ElliotBayTrailMyrtlePark,02/20/2017 11:00:00 AM,48,-122,5,6,11
27516,ElliotBayTrailMyrtlePark,02/20/2017 12:00:00 PM,48,-122,10,7,17
27517,ElliotBayTrailMyrtlePark,02/20/2017 01:00:00 PM,48,-122,11,3,14
27518,ElliotBayTrailMyrtlePark,02/20/2017 02:00:00 PM,48,-122,4,6,10
27519,ElliotBayTrailMyrtlePark,02/20/2017 03:00:00 PM,48,-122,11,4,15
27520,ElliotBayTrailMyrtlePark,02/20/2017 04:00:00 PM,48,-122,15,13,28
27521,ElliotBayTrailMyrtlePark,02/20/2017 05:00:00 PM,48,-122,32,9,41
27522,ElliotBayTrailMyrtlePark,02/20/2017 06:00:00 PM,48,-122,29,4,33
27523,ElliotBayTrailMyrtlePark,02/20/2017 07:00:00 PM,48,-122,5,4,9
27524,ElliotBayTrailMyrtlePark,02/20/2017 08:00:00 PM,48,-122,2,4,6
27525,ElliotBayTrailMyrtlePark,02/20/2017 09:00:00 PM,48,-122,0,2,2
27526,ElliotBayTrailMyrtlePark,02/20/2017 10:00:00 PM,48,-122,1,0,1
27527,ElliotBayTrailMyrtlePark,02/20/2017 11:00:00 PM,48,-122,0,0,0
27528,ElliotBayTrailMyrtlePark,02/21/2017 12:00:00 AM,48,-122,0,0,0
27529,ElliotBayTrailMyrtlePark,02/21/2017 01:00:00 AM,48,-122,0,0,0
27530,ElliotBayTrailMyrtlePark,02/21/2017 02:00:00 AM,48,-122,0,0,0
27531,ElliotBayTrailMyrtlePark,02/21/2017 03:00:00 AM,48,-122,1,0,1
27532,ElliotBayTrailMyrtlePark,02/21/2017 04:00:00 AM,48,-122,0,0,0
27533,ElliotBayTrailMyrtlePark,02/21/2017 05:00:00 AM,48,-122,3,11,14
27534,ElliotBayTrailMyrtlePark,02/21/2017 06:00:00 AM,48,-122,17,12,29
27535,ElliotBayTrailMyrtlePark,02/21/2017 07:00:00 AM,48,-122,21,47,68
27536,ElliotBayTrailMyrtlePark,02/21/2017 08:00:00 AM,48,-122,22,87,109
27537,ElliotBayTrailMyrtlePark,02/21/2017 09:00:00 AM,48,-122,14,30,44
27538,ElliotBayTrailMyrtlePark,02/21/2017 10:00:00 AM,48,-122,7,13,20
27539,ElliotBayTrailMyrtlePark,02/21/2017 11:00:00 AM,48,-122,4,6,10
27540,ElliotBayTrailMyrtlePark,02/21/2017 12:00:00 PM,48,-122,7,7,14
27541,ElliotBayTrailMyrtlePark,02/21/2017 01:00:00 PM,48,-122,6,6,12
27542,ElliotBayTrailMyrtlePark,02/21/2017 02:00:00 PM,48,-122,7,12,19
27543,ElliotBayTrailMyrtlePark,02/21/2017 03:00:00 PM,48,-122,26,15,41
27544,ElliotBayTrailMyrtlePark,02/21/2017 04:00:00 PM,48,-122,31,20,51
27545,ElliotBayTrailMyrtlePark,02/21/2017 05:00:00 PM,48,-122,84,31,115
27546,ElliotBayTrailMyrtlePark,02/21/2017 06:00:00 PM,48,-122,55,14,69
27547,ElliotBayTrailMyrtlePark,02/21/2017 07:00:00 PM,48,-122,18,3,21
27548,ElliotBayTrailMyrtlePark,02/21/2017 08:00:00 PM,48,-122,7,1,8
27549,ElliotBayTrailMyrtlePark,02/21/2017 09:00:00 PM,48,-122,4,0,4
27550,ElliotBayTrailMyrtlePark,02/21/2017 10:00:00 PM,48,-122,4,0,4
27551,ElliotBayTrailMyrtlePark,02/21/2017 11:00:00 PM,48,-122,0,1,1
27552,ElliotBayTrailMyrtlePark,02/22/2017 12:00:00 AM,48,-122,0,0,0
27553,ElliotBayTrailMyrtlePark,02/22/2017 01:00:00 AM,48,-122,0,0,0
27554,ElliotBayTrailMyrtlePark,02/22/2017 02:00:00 AM,48,-122,0,0,0
27555,ElliotBayTrailMyrtlePark,02/22/2017 03:00:00 AM,48,-122,0,0,0
27556,ElliotBayTrailMyrtlePark,02/22/2017 04:00:00 AM,48,-122,0,1,1
27557,ElliotBayTrailMyrtlePark,02/22/2017 05:00:00 AM,48,-122,6,7,13
27558,ElliotBayTrailMyrtlePark,02/22/2017 06:00:00 AM,48,-122,11,19,30
27559,ElliotBayTrailMyrtlePark,02/22/2017 07:00:00 AM,48,-122,23,55,78
27560,ElliotBayTrailMyrtlePark,02/22/2017 08:00:00 AM,48,-122,22,97,119
27561,ElliotBayTrailMyrtlePark,02/22/2017 09:00:00 AM,48,-122,9,36,45
27562,ElliotBayTrailMyrtlePark,02/22/2017 10:00:00 AM,48,-122,8,8,16
27563,ElliotBayTrailMyrtlePark,02/22/2017 11:00:00 AM,48,-122,8,8,16
27564,ElliotBayTrailMyrtlePark,02/22/2017 12:00:00 PM,48,-122,11,9,20
27565,ElliotBayTrailMyrtlePark,02/22/2017 01:00:00 PM,48,-122,4,10,14
27566,ElliotBayTrailMyrtlePark,02/22/2017 02:00:00 PM,48,-122,13,23,36
27567,ElliotBayTrailMyrtlePark,02/22/2017 03:00:00 PM,48,-122,32,18,50
27568,ElliotBayTrailMyrtlePark,02/22/2017 04:00:00 PM,48,-122,45,27,72
27569,ElliotBayTrailMyrtlePark,02/22/2017 05:00:00 PM,48,-122,103,37,140
27570,ElliotBayTrailMyrtlePark,02/22/2017 06:00:00 PM,48,-122,55,14,69
27571,ElliotBayTrailMyrtlePark,02/22/2017 07:00:00 PM,48,-122,21,7,28
27572,ElliotBayTrailMyrtlePark,02/22/2017 08:00:00 PM,48,-122,12,1,13
27573,ElliotBayTrailMyrtlePark,02/22/2017 09:00:00 PM,48,-122,3,1,4
27574,ElliotBayTrailMyrtlePark,02/22/2017 10:00:00 PM,48,-122,2,2,4
27575,ElliotBayTrailMyrtlePark,02/22/2017 11:00:00 PM,48,-122,2,0,2
27576,ElliotBayTrailMyrtlePark,02/23/2017 12:00:00 AM,48,-122,0,0,0
27577,ElliotBayTrailMyrtlePark,02/23/2017 01:00:00 AM,48,-122,1,0,1
27578,ElliotBayTrailMyrtlePark,02/23/2017 02:00:00 AM,48,-122,0,0,0
27579,ElliotBayTrailMyrtlePark,02/23/2017 03:00:00 AM,48,-122,1,0,1
27580,ElliotBayTrailMyrtlePark,02/23/2017 04:00:00 AM,48,-122,0,0,0
27581,ElliotBayTrailMyrtlePark,02/23/2017 05:00:00 AM,48,-122,5,8,13
27582,ElliotBayTrailMyrtlePark,02/23/2017 06:00:00 AM,48,-122,16,11,27
27583,ElliotBayTrailMyrtlePark,02/23/2017 07:00:00 AM,48,-122,22,56,78
27584,ElliotBayTrailMyrtlePark,02/23/2017 08:00:00 AM,48,-122,25,96,121
27585,ElliotBayTrailMyrtlePark,02/23/2017 09:00:00 AM,48,-122,14,34,48
27586,ElliotBayTrailMyrtlePark,02/23/2017 10:00:00 AM,48,-122,9,12,21
27587,ElliotBayTrailMyrtlePark,02/23/2017 11:00:00 AM,48,-122,8,11,19
27588,ElliotBayTrailMyrtlePark,02/23/2017 12:00:00 PM,48,-122,16,10,26
27589,ElliotBayTrailMyrtlePark,02/23/2017 01:00:00 PM,48,-122,6,11,17
27590,ElliotBayTrailMyrtlePark,02/23/2017 02:00:00 PM,48,-122,9,14,23
27591,ElliotBayTrailMyrtlePark,02/23/2017 03:00:00 PM,48,-122,25,20,45
27592,ElliotBayTrailMyrtlePark,02/23/2017 04:00:00 PM,48,-122,43,23,66
27593,ElliotBayTrailMyrtlePark,02/23/2017 05:00:00 PM,48,-122,96,29,125
27594,ElliotBayTrailMyrtlePark,02/23/2017 06:00:00 PM,48,-122,69,22,91
27595,ElliotBayTrailMyrtlePark,02/23/2017 07:00:00 PM,48,-122,23,1,24
27596,ElliotBayTrailMyrtlePark,02/23/2017 08:00:00 PM,48,-122,4,3,7
27597,ElliotBayTrailMyrtlePark,02/23/2017 09:00:00 PM,48,-122,1,3,4
27598,ElliotBayTrailMyrtlePark,02/23/2017 10:00:00 PM,48,-122,4,2,6
27599,ElliotBayTrailMyrtlePark,02/23/2017 11:00:00 PM,48,-122,2,2,4
27600,ElliotBayTrailMyrtlePark,02/24/2017 12:00:00 AM,48,-122,3,1,4
27601,ElliotBayTrailMyrtlePark,02/24/2017 01:00:00 AM,48,-122,0,1,1
27602,ElliotBayTrailMyrtlePark,02/24/2017 02:00:00 AM,48,-122,2,0,2
27603,ElliotBayTrailMyrtlePark,02/24/2017 03:00:00 AM,48,-122,0,0,0
27604,ElliotBayTrailMyrtlePark,02/24/2017 04:00:00 AM,48,-122,0,0,0
27605,ElliotBayTrailMyrtlePark,02/24/2017 05:00:00 AM,48,-122,6,12,18
27606,ElliotBayTrailMyrtlePark,02/24/2017 06:00:00 AM,48,-122,8,12,20
27607,ElliotBayTrailMyrtlePark,02/24/2017 07:00:00 AM,48,-122,21,29,50
27608,ElliotBayTrailMyrtlePark,02/24/2017 08:00:00 AM,48,-122,18,73,91
27609,ElliotBayTrailMyrtlePark,02/24/2017 09:00:00 AM,48,-122,10,30,40
27610,ElliotBayTrailMyrtlePark,02/24/2017 10:00:00 AM,48,-122,8,12,20
27611,ElliotBayTrailMyrtlePark,02/24/2017 11:00:00 AM,48,-122,7,6,13
27612,ElliotBayTrailMyrtlePark,02/24/2017 12:00:00 PM,48,-122,5,7,12
27613,ElliotBayTrailMyrtlePark,02/24/2017 01:00:00 PM,48,-122,8,11,19
27614,ElliotBayTrailMyrtlePark,02/24/2017 02:00:00 PM,48,-122,14,14,28
27615,ElliotBayTrailMyrtlePark,02/24/2017 03:00:00 PM,48,-122,34,15,49
27616,ElliotBayTrailMyrtlePark,02/24/2017 04:00:00 PM,48,-122,39,33,72
27617,ElliotBayTrailMyrtlePark,02/24/2017 05:00:00 PM,48,-122,81,47,128
27618,ElliotBayTrailMyrtlePark,02/24/2017 06:00:00 PM,48,-122,31,14,45
27619,ElliotBayTrailMyrtlePark,02/24/2017 07:00:00 PM,48,-122,21,5,26
27620,ElliotBayTrailMyrtlePark,02/24/2017 08:00:00 PM,48,-122,10,3,13
27621,ElliotBayTrailMyrtlePark,02/24/2017 09:00:00 PM,48,-122,4,9,13
27622,ElliotBayTrailMyrtlePark,02/24/2017 10:00:00 PM,48,-122,3,0,3
27623,ElliotBayTrailMyrtlePark,02/24/2017 11:00:00 PM,48,-122,1,1,2
27624,ElliotBayTrailMyrtlePark,02/25/2017 12:00:00 AM,48,-122,1,0,1
27625,ElliotBayTrailMyrtlePark,02/25/2017 01:00:00 AM,48,-122,0,0,0
27626,ElliotBayTrailMyrtlePark,02/25/2017 02:00:00 AM,48,-122,0,0,0
27627,ElliotBayTrailMyrtlePark,02/25/2017 03:00:00 AM,48,-122,1,0,1
27628,ElliotBayTrailMyrtlePark,02/25/2017 04:00:00 AM,48,-122,1,1,2
27629,ElliotBayTrailMyrtlePark,02/25/2017 05:00:00 AM,48,-122,0,0,0
27630,ElliotBayTrailMyrtlePark,02/25/2017 06:00:00 AM,48,-122,1,3,4
27631,ElliotBayTrailMyrtlePark,02/25/2017 07:00:00 AM,48,-122,4,4,8
27632,ElliotBayTrailMyrtlePark,02/25/2017 08:00:00 AM,48,-122,10,6,16
27633,ElliotBayTrailMyrtlePark,02/25/2017 09:00:00 AM,48,-122,13,16,29
27634,ElliotBayTrailMyrtlePark,02/25/2017 10:00:00 AM,48,-122,16,23,39
27635,ElliotBayTrailMyrtlePark,02/25/2017 11:00:00 AM,48,-122,53,36,89
27636,ElliotBayTrailMyrtlePark,02/25/2017 12:00:00 PM,48,-122,29,30,59
27637,ElliotBayTrailMyrtlePark,02/25/2017 01:00:00 PM,48,-122,34,30,64
27638,ElliotBayTrailMyrtlePark,02/25/2017 02:00:00 PM,48,-122,43,18,61
27639,ElliotBayTrailMyrtlePark,02/25/2017 03:00:00 PM,48,-122,13,20,33
27640,ElliotBayTrailMyrtlePark,02/25/2017 04:00:00 PM,48,-122,38,22,60
27641,ElliotBayTrailMyrtlePark,02/25/2017 05:00:00 PM,48,-122,19,11,30
27642,ElliotBayTrailMyrtlePark,02/25/2017 06:00:00 PM,48,-122,2,6,8
27643,ElliotBayTrailMyrtlePark,02/25/2017 07:00:00 PM,48,-122,2,1,3
27644,ElliotBayTrailMyrtlePark,02/25/2017 08:00:00 PM,48,-122,0,1,1
27645,ElliotBayTrailMyrtlePark,02/25/2017 09:00:00 PM,48,-122,0,1,1
27646,ElliotBayTrailMyrtlePark,02/25/2017 10:00:00 PM,48,-122,1,1,2
27647,ElliotBayTrailMyrtlePark,02/25/2017 11:00:00 PM,48,-122,2,0,2
27648,ElliotBayTrailMyrtlePark,02/26/2017 12:00:00 AM,48,-122,0,0,0
27649,ElliotBayTrailMyrtlePark,02/26/2017 01:00:00 AM,48,-122,0,0,0
27650,ElliotBayTrailMyrtlePark,02/26/2017 02:00:00 AM,48,-122,1,0,1
27651,ElliotBayTrailMyrtlePark,02/26/2017 03:00:00 AM,48,-122,0,0,0
27652,ElliotBayTrailMyrtlePark,02/26/2017 04:00:00 AM,48,-122,0,0,0
27653,ElliotBayTrailMyrtlePark,02/26/2017 05:00:00 AM,48,-122,0,1,1
27654,ElliotBayTrailMyrtlePark,02/26/2017 06:00:00 AM,48,-122,0,6,6
27655,ElliotBayTrailMyrtlePark,02/26/2017 07:00:00 AM,48,-122,2,36,38
27656,ElliotBayTrailMyrtlePark,02/26/2017 08:00:00 AM,48,-122,3,37,40
27657,ElliotBayTrailMyrtlePark,02/26/2017 09:00:00 AM,48,-122,6,28,34
27658,ElliotBayTrailMyrtlePark,02/26/2017 10:00:00 AM,48,-122,3,9,12
27659,ElliotBayTrailMyrtlePark,02/26/2017 11:00:00 AM,48,-122,4,4,8
27660,ElliotBayTrailMyrtlePark,02/26/2017 12:00:00 PM,48,-122,22,2,24
27661,ElliotBayTrailMyrtlePark,02/26/2017 01:00:00 PM,48,-122,28,6,34
27662,ElliotBayTrailMyrtlePark,02/26/2017 02:00:00 PM,48,-122,43,2,45
27663,ElliotBayTrailMyrtlePark,02/26/2017 03:00:00 PM,48,-122,27,7,34
27664,ElliotBayTrailMyrtlePark,02/26/2017 04:00:00 PM,48,-122,22,11,33
27665,ElliotBayTrailMyrtlePark,02/26/2017 05:00:00 PM,48,-122,11,7,18
27666,ElliotBayTrailMyrtlePark,02/26/2017 06:00:00 PM,48,-122,3,4,7
27667,ElliotBayTrailMyrtlePark,02/26/2017 07:00:00 PM,48,-122,5,0,5
27668,ElliotBayTrailMyrtlePark,02/26/2017 08:00:00 PM,48,-122,0,1,1
27669,ElliotBayTrailMyrtlePark,02/26/2017 09:00:00 PM,48,-122,1,1,2
27670,ElliotBayTrailMyrtlePark,02/26/2017 10:00:00 PM,48,-122,2,1,3
27671,ElliotBayTrailMyrtlePark,02/26/2017 11:00:00 PM,48,-122,0,1,1
27672,ElliotBayTrailMyrtlePark,02/27/2017 12:00:00 AM,48,-122,0,0,0
27673,ElliotBayTrailMyrtlePark,02/27/2017 01:00:00 AM,48,-122,0,0,0
27674,ElliotBayTrailMyrtlePark,02/27/2017 02:00:00 AM,48,-122,1,0,1
27675,ElliotBayTrailMyrtlePark,02/27/2017 03:00:00 AM,48,-122,0,1,1
27676,ElliotBayTrailMyrtlePark,02/27/2017 04:00:00 AM,48,-122,0,0,0
27677,ElliotBayTrailMyrtlePark,02/27/2017 05:00:00 AM,48,-122,4,10,14
27678,ElliotBayTrailMyrtlePark,02/27/2017 06:00:00 AM,48,-122,9,12,21
27679,ElliotBayTrailMyrtlePark,02/27/2017 07:00:00 AM,48,-122,22,24,46
27680,ElliotBayTrailMyrtlePark,02/27/2017 08:00:00 AM,48,-122,16,40,56
27681,ElliotBayTrailMyrtlePark,02/27/2017 09:00:00 AM,48,-122,10,20,30
27682,ElliotBayTrailMyrtlePark,02/27/2017 10:00:00 AM,48,-122,4,7,11
27683,ElliotBayTrailMyrtlePark,02/27/2017 11:00:00 AM,48,-122,3,0,3
27684,ElliotBayTrailMyrtlePark,02/27/2017 12:00:00 PM,48,-122,4,3,7
27685,ElliotBayTrailMyrtlePark,02/27/2017 01:00:00 PM,48,-122,4,0,4
27686,ElliotBayTrailMyrtlePark,02/27/2017 02:00:00 PM,48,-122,6,11,17
27687,ElliotBayTrailMyrtlePark,02/27/2017 03:00:00 PM,48,-122,15,6,21
27688,ElliotBayTrailMyrtlePark,02/27/2017 04:00:00 PM,48,-122,24,22,46
27689,ElliotBayTrailMyrtlePark,02/27/2017 05:00:00 PM,48,-122,50,12,62
27690,ElliotBayTrailMyrtlePark,02/27/2017 06:00:00 PM,48,-122,29,7,36
27691,ElliotBayTrailMyrtlePark,02/27/2017 07:00:00 PM,48,-122,5,1,6
27692,ElliotBayTrailMyrtlePark,02/27/2017 08:00:00 PM,48,-122,2,1,3
27693,ElliotBayTrailMyrtlePark,02/27/2017 09:00:00 PM,48,-122,1,2,3
27694,ElliotBayTrailMyrtlePark,02/27/2017 10:00:00 PM,48,-122,0,0,0
27695,ElliotBayTrailMyrtlePark,02/27/2017 11:00:00 PM,48,-122,0,0,0
27696,ElliotBayTrailMyrtlePark,02/28/2017 12:00:00 AM,48,-122,0,0,0
27697,ElliotBayTrailMyrtlePark,02/28/2017 01:00:00 AM,48,-122,1,0,1
27698,ElliotBayTrailMyrtlePark,02/28/2017 02:00:00 AM,48,-122,0,0,0
27699,ElliotBayTrailMyrtlePark,02/28/2017 03:00:00 AM,48,-122,0,1,1
27700,ElliotBayTrailMyrtlePark,02/28/2017 04:00:00 AM,48,-122,0,0,0
27701,ElliotBayTrailMyrtlePark,02/28/2017 05:00:00 AM,48,-122,3,6,9
27702,ElliotBayTrailMyrtlePark,02/28/2017 06:00:00 AM,48,-122,10,10,20
27703,ElliotBayTrailMyrtlePark,02/28/2017 07:00:00 AM,48,-122,21,42,63
27704,ElliotBayTrailMyrtlePark,02/28/2017 08:00:00 AM,48,-122,24,80,104
27705,ElliotBayTrailMyrtlePark,02/28/2017 09:00:00 AM,48,-122,17,36,53
27706,ElliotBayTrailMyrtlePark,02/28/2017 10:00:00 AM,48,-122,8,20,28
27707,ElliotBayTrailMyrtlePark,02/28/2017 11:00:00 AM,48,-122,6,8,14
27708,ElliotBayTrailMyrtlePark,02/28/2017 12:00:00 PM,48,-122,18,7,25
27709,ElliotBayTrailMyrtlePark,02/28/2017 01:00:00 PM,48,-122,12,6,18
27710,ElliotBayTrailMyrtlePark,02/28/2017 02:00:00 PM,48,-122,14,28,42
27711,ElliotBayTrailMyrtlePark,02/28/2017 03:00:00 PM,48,-122,19,16,35
27712,ElliotBayTrailMyrtlePark,02/28/2017 04:00:00 PM,48,-122,49,20,69
27713,ElliotBayTrailMyrtlePark,02/28/2017 05:00:00 PM,48,-122,82,33,115
27714,ElliotBayTrailMyrtlePark,02/28/2017 06:00:00 PM,48,-122,59,8,67
27715,ElliotBayTrailMyrtlePark,02/28/2017 07:00:00 PM,48,-122,15,1,16
27716,ElliotBayTrailMyrtlePark,02/28/2017 08:00:00 PM,48,-122,7,0,7
27717,ElliotBayTrailMyrtlePark,02/28/2017 09:00:00 PM,48,-122,2,1,3
27718,ElliotBayTrailMyrtlePark,02/28/2017 10:00:00 PM,48,-122,1,1,2
27719,ElliotBayTrailMyrtlePark,02/28/2017 11:00:00 PM,48,-122,1,0,1
27720,ElliotBayTrailMyrtlePark,03/01/2017 12:00:00 AM,48,-122,0,0,0
27721,ElliotBayTrailMyrtlePark,03/01/2017 01:00:00 AM,48,-122,0,0,0
27722,ElliotBayTrailMyrtlePark,03/01/2017 02:00:00 AM,48,-122,1,0,1
27723,ElliotBayTrailMyrtlePark,03/01/2017 03:00:00 AM,48,-122,0,1,1
27724,ElliotBayTrailMyrtlePark,03/01/2017 04:00:00 AM,48,-122,0,1,1
27725,ElliotBayTrailMyrtlePark,03/01/2017 05:00:00 AM,48,-122,11,5,16
27726,ElliotBayTrailMyrtlePark,03/01/2017 06:00:00 AM,48,-122,18,24,42
27727,ElliotBayTrailMyrtlePark,03/01/2017 07:00:00 AM,48,-122,19,56,75
27728,ElliotBayTrailMyrtlePark,03/01/2017 08:00:00 AM,48,-122,35,93,128
27729,ElliotBayTrailMyrtlePark,03/01/2017 09:00:00 AM,48,-122,15,34,49
27730,ElliotBayTrailMyrtlePark,03/01/2017 10:00:00 AM,48,-122,11,12,23
27731,ElliotBayTrailMyrtlePark,03/01/2017 11:00:00 AM,48,-122,7,8,15
27732,ElliotBayTrailMyrtlePark,03/01/2017 12:00:00 PM,48,-122,5,6,11
27733,ElliotBayTrailMyrtlePark,03/01/2017 01:00:00 PM,48,-122,13,10,23
27734,ElliotBayTrailMyrtlePark,03/01/2017 02:00:00 PM,48,-122,7,17,24
27735,ElliotBayTrailMyrtlePark,03/01/2017 03:00:00 PM,48,-122,24,14,38
27736,ElliotBayTrailMyrtlePark,03/01/2017 04:00:00 PM,48,-122,48,24,72
27737,ElliotBayTrailMyrtlePark,03/01/2017 05:00:00 PM,48,-122,113,44,157
27738,ElliotBayTrailMyrtlePark,03/01/2017 06:00:00 PM,48,-122,60,18,78
27739,ElliotBayTrailMyrtlePark,03/01/2017 07:00:00 PM,48,-122,12,3,15
27740,ElliotBayTrailMyrtlePark,03/01/2017 08:00:00 PM,48,-122,18,9,27
27741,ElliotBayTrailMyrtlePark,03/01/2017 09:00:00 PM,48,-122,1,3,4
27742,ElliotBayTrailMyrtlePark,03/01/2017 10:00:00 PM,48,-122,2,2,4
27743,ElliotBayTrailMyrtlePark,03/01/2017 11:00:00 PM,48,-122,0,0,0
27744,ElliotBayTrailMyrtlePark,03/02/2017 12:00:00 AM,48,-122,0,0,0
27745,ElliotBayTrailMyrtlePark,03/02/2017 01:00:00 AM,48,-122,0,0,0
27746,ElliotBayTrailMyrtlePark,03/02/2017 02:00:00 AM,48,-122,0,0,0
27747,ElliotBayTrailMyrtlePark,03/02/2017 03:00:00 AM,48,-122,1,1,2
27748,ElliotBayTrailMyrtlePark,03/02/2017 04:00:00 AM,48,-122,0,0,0
27749,ElliotBayTrailMyrtlePark,03/02/2017 05:00:00 AM,48,-122,13,12,25
27750,ElliotBayTrailMyrtlePark,03/02/2017 06:00:00 AM,48,-122,7,19,26
27751,ElliotBayTrailMyrtlePark,03/02/2017 07:00:00 AM,48,-122,31,49,80
27752,ElliotBayTrailMyrtlePark,03/02/2017 08:00:00 AM,48,-122,28,88,116
27753,ElliotBayTrailMyrtlePark,03/02/2017 09:00:00 AM,48,-122,10,26,36
27754,ElliotBayTrailMyrtlePark,03/02/2017 10:00:00 AM,48,-122,3,11,14
27755,ElliotBayTrailMyrtlePark,03/02/2017 11:00:00 AM,48,-122,4,6,10
27756,ElliotBayTrailMyrtlePark,03/02/2017 12:00:00 PM,48,-122,9,8,17
27757,ElliotBayTrailMyrtlePark,03/02/2017 01:00:00 PM,48,-122,10,6,16
27758,ElliotBayTrailMyrtlePark,03/02/2017 02:00:00 PM,48,-122,8,9,17
27759,ElliotBayTrailMyrtlePark,03/02/2017 03:00:00 PM,48,-122,13,12,25
27760,ElliotBayTrailMyrtlePark,03/02/2017 04:00:00 PM,48,-122,43,27,70
27761,ElliotBayTrailMyrtlePark,03/02/2017 05:00:00 PM,48,-122,83,30,113
27762,ElliotBayTrailMyrtlePark,03/02/2017 06:00:00 PM,48,-122,57,10,67
27763,ElliotBayTrailMyrtlePark,03/02/2017 07:00:00 PM,48,-122,21,2,23
27764,ElliotBayTrailMyrtlePark,03/02/2017 08:00:00 PM,48,-122,5,2,7
27765,ElliotBayTrailMyrtlePark,03/02/2017 09:00:00 PM,48,-122,3,2,5
27766,ElliotBayTrailMyrtlePark,03/02/2017 10:00:00 PM,48,-122,1,1,2
27767,ElliotBayTrailMyrtlePark,03/02/2017 11:00:00 PM,48,-122,0,0,0
27768,ElliotBayTrailMyrtlePark,03/03/2017 12:00:00 AM,48,-122,0,0,0
27769,ElliotBayTrailMyrtlePark,03/03/2017 01:00:00 AM,48,-122,0,0,0
27770,ElliotBayTrailMyrtlePark,03/03/2017 02:00:00 AM,48,-122,0,0,0
27771,ElliotBayTrailMyrtlePark,03/03/2017 03:00:00 AM,48,-122,0,0,0
27772,ElliotBayTrailMyrtlePark,03/03/2017 04:00:00 AM,48,-122,0,1,1
27773,ElliotBayTrailMyrtlePark,03/03/2017 05:00:00 AM,48,-122,7,5,12
27774,ElliotBayTrailMyrtlePark,03/03/2017 06:00:00 AM,48,-122,10,8,18
27775,ElliotBayTrailMyrtlePark,03/03/2017 07:00:00 AM,48,-122,19,39,58
27776,ElliotBayTrailMyrtlePark,03/03/2017 08:00:00 AM,48,-122,20,64,84
27777,ElliotBayTrailMyrtlePark,03/03/2017 09:00:00 AM,48,-122,9,27,36
27778,ElliotBayTrailMyrtlePark,03/03/2017 10:00:00 AM,48,-122,4,9,13
27779,ElliotBayTrailMyrtlePark,03/03/2017 11:00:00 AM,48,-122,4,6,10
27780,ElliotBayTrailMyrtlePark,03/03/2017 12:00:00 PM,48,-122,9,8,17
27781,ElliotBayTrailMyrtlePark,03/03/2017 01:00:00 PM,48,-122,13,3,16
27782,ElliotBayTrailMyrtlePark,03/03/2017 02:00:00 PM,48,-122,6,8,14
27783,ElliotBayTrailMyrtlePark,03/03/2017 03:00:00 PM,48,-122,13,13,26
27784,ElliotBayTrailMyrtlePark,03/03/2017 04:00:00 PM,48,-122,37,11,48
27785,ElliotBayTrailMyrtlePark,03/03/2017 05:00:00 PM,48,-122,57,16,73
27786,ElliotBayTrailMyrtlePark,03/03/2017 06:00:00 PM,48,-122,30,5,35
27787,ElliotBayTrailMyrtlePark,03/03/2017 07:00:00 PM,48,-122,6,2,8
27788,ElliotBayTrailMyrtlePark,03/03/2017 08:00:00 PM,48,-122,4,0,4
27789,ElliotBayTrailMyrtlePark,03/03/2017 09:00:00 PM,48,-122,2,1,3
27790,ElliotBayTrailMyrtlePark,03/03/2017 10:00:00 PM,48,-122,0,1,1
27791,ElliotBayTrailMyrtlePark,03/03/2017 11:00:00 PM,48,-122,0,3,3
27792,ElliotBayTrailMyrtlePark,03/04/2017 12:00:00 AM,48,-122,3,1,4
27793,ElliotBayTrailMyrtlePark,03/04/2017 01:00:00 AM,48,-122,2,0,2
27794,ElliotBayTrailMyrtlePark,03/04/2017 02:00:00 AM,48,-122,0,0,0
27795,ElliotBayTrailMyrtlePark,03/04/2017 03:00:00 AM,48,-122,0,0,0
27796,ElliotBayTrailMyrtlePark,03/04/2017 04:00:00 AM,48,-122,0,3,3
27797,ElliotBayTrailMyrtlePark,03/04/2017 05:00:00 AM,48,-122,0,0,0
27798,ElliotBayTrailMyrtlePark,03/04/2017 06:00:00 AM,48,-122,0,1,1
27799,ElliotBayTrailMyrtlePark,03/04/2017 07:00:00 AM,48,-122,7,7,14
27800,ElliotBayTrailMyrtlePark,03/04/2017 08:00:00 AM,48,-122,14,10,24
27801,ElliotBayTrailMyrtlePark,03/04/2017 09:00:00 AM,48,-122,13,24,37
27802,ElliotBayTrailMyrtlePark,03/04/2017 10:00:00 AM,48,-122,25,20,45
27803,ElliotBayTrailMyrtlePark,03/04/2017 11:00:00 AM,48,-122,28,33,61
27804,ElliotBayTrailMyrtlePark,03/04/2017 12:00:00 PM,48,-122,19,21,40
27805,ElliotBayTrailMyrtlePark,03/04/2017 01:00:00 PM,48,-122,26,41,67
27806,ElliotBayTrailMyrtlePark,03/04/2017 02:00:00 PM,48,-122,27,31,58
27807,ElliotBayTrailMyrtlePark,03/04/2017 03:00:00 PM,48,-122,27,16,43
27808,ElliotBayTrailMyrtlePark,03/04/2017 04:00:00 PM,48,-122,23,18,41
27809,ElliotBayTrailMyrtlePark,03/04/2017 05:00:00 PM,48,-122,18,9,27
27810,ElliotBayTrailMyrtlePark,03/04/2017 06:00:00 PM,48,-122,4,5,9
27811,ElliotBayTrailMyrtlePark,03/04/2017 07:00:00 PM,48,-122,8,4,12
27812,ElliotBayTrailMyrtlePark,03/04/2017 08:00:00 PM,48,-122,0,6,6
27813,ElliotBayTrailMyrtlePark,03/04/2017 09:00:00 PM,48,-122,3,0,3
27814,ElliotBayTrailMyrtlePark,03/04/2017 10:00:00 PM,48,-122,0,2,2
27815,ElliotBayTrailMyrtlePark,03/04/2017 11:00:00 PM,48,-122,7,2,9
27816,ElliotBayTrailMyrtlePark,03/05/2017 12:00:00 AM,48,-122,0,0,0
27817,ElliotBayTrailMyrtlePark,03/05/2017 01:00:00 AM,48,-122,1,1,2
27818,ElliotBayTrailMyrtlePark,03/05/2017 02:00:00 AM,48,-122,0,0,0
27819,ElliotBayTrailMyrtlePark,03/05/2017 03:00:00 AM,48,-122,0,0,0
27820,ElliotBayTrailMyrtlePark,03/05/2017 04:00:00 AM,48,-122,0,1,1
27821,ElliotBayTrailMyrtlePark,03/05/2017 05:00:00 AM,48,-122,0,0,0
27822,ElliotBayTrailMyrtlePark,03/05/2017 06:00:00 AM,48,-122,1,1,2
27823,ElliotBayTrailMyrtlePark,03/05/2017 07:00:00 AM,48,-122,6,3,9
27824,ElliotBayTrailMyrtlePark,03/05/2017 08:00:00 AM,48,-122,3,5,8
27825,ElliotBayTrailMyrtlePark,03/05/2017 09:00:00 AM,48,-122,14,10,24
27826,ElliotBayTrailMyrtlePark,03/05/2017 10:00:00 AM,48,-122,14,9,23
27827,ElliotBayTrailMyrtlePark,03/05/2017 11:00:00 AM,48,-122,7,11,18
27828,ElliotBayTrailMyrtlePark,03/05/2017 12:00:00 PM,48,-122,2,6,8
27829,ElliotBayTrailMyrtlePark,03/05/2017 01:00:00 PM,48,-122,10,8,18
27830,ElliotBayTrailMyrtlePark,03/05/2017 02:00:00 PM,48,-122,9,5,14
27831,ElliotBayTrailMyrtlePark,03/05/2017 03:00:00 PM,48,-122,10,12,22
27832,ElliotBayTrailMyrtlePark,03/05/2017 04:00:00 PM,48,-122,19,11,30
27833,ElliotBayTrailMyrtlePark,03/05/2017 05:00:00 PM,48,-122,4,5,9
27834,ElliotBayTrailMyrtlePark,03/05/2017 06:00:00 PM,48,-122,3,2,5
27835,ElliotBayTrailMyrtlePark,03/05/2017 07:00:00 PM,48,-122,1,3,4
27836,ElliotBayTrailMyrtlePark,03/05/2017 08:00:00 PM,48,-122,5,1,6
27837,ElliotBayTrailMyrtlePark,03/05/2017 09:00:00 PM,48,-122,0,0,0
27838,ElliotBayTrailMyrtlePark,03/05/2017 10:00:00 PM,48,-122,1,0,1
27839,ElliotBayTrailMyrtlePark,03/05/2017 11:00:00 PM,48,-122,0,1,1
27840,ElliotBayTrailMyrtlePark,03/06/2017 12:00:00 AM,48,-122,0,2,2
27841,ElliotBayTrailMyrtlePark,03/06/2017 01:00:00 AM,48,-122,0,0,0
27842,ElliotBayTrailMyrtlePark,03/06/2017 02:00:00 AM,48,-122,0,0,0
27843,ElliotBayTrailMyrtlePark,03/06/2017 03:00:00 AM,48,-122,0,1,1
27844,ElliotBayTrailMyrtlePark,03/06/2017 04:00:00 AM,48,-122,0,0,0
27845,ElliotBayTrailMyrtlePark,03/06/2017 05:00:00 AM,48,-122,6,7,13
27846,ElliotBayTrailMyrtlePark,03/06/2017 06:00:00 AM,48,-122,16,21,37
27847,ElliotBayTrailMyrtlePark,03/06/2017 07:00:00 AM,48,-122,29,49,78
27848,ElliotBayTrailMyrtlePark,03/06/2017 08:00:00 AM,48,-122,24,106,130
27849,ElliotBayTrailMyrtlePark,03/06/2017 09:00:00 AM,48,-122,11,45,56
27850,ElliotBayTrailMyrtlePark,03/06/2017 10:00:00 AM,48,-122,7,12,19
27851,ElliotBayTrailMyrtlePark,03/06/2017 11:00:00 AM,48,-122,4,7,11
27852,ElliotBayTrailMyrtlePark,03/06/2017 12:00:00 PM,48,-122,5,3,8
27853,ElliotBayTrailMyrtlePark,03/06/2017 01:00:00 PM,48,-122,10,2,12
27854,ElliotBayTrailMyrtlePark,03/06/2017 02:00:00 PM,48,-122,14,11,25
27855,ElliotBayTrailMyrtlePark,03/06/2017 03:00:00 PM,48,-122,28,20,48
27856,ElliotBayTrailMyrtlePark,03/06/2017 04:00:00 PM,48,-122,38,31,69
27857,ElliotBayTrailMyrtlePark,03/06/2017 05:00:00 PM,48,-122,119,31,150
27858,ElliotBayTrailMyrtlePark,03/06/2017 06:00:00 PM,48,-122,72,23,95
27859,ElliotBayTrailMyrtlePark,03/06/2017 07:00:00 PM,48,-122,15,5,20
27860,ElliotBayTrailMyrtlePark,03/06/2017 08:00:00 PM,48,-122,7,1,8
27861,ElliotBayTrailMyrtlePark,03/06/2017 09:00:00 PM,48,-122,4,3,7
27862,ElliotBayTrailMyrtlePark,03/06/2017 10:00:00 PM,48,-122,1,0,1
27863,ElliotBayTrailMyrtlePark,03/06/2017 11:00:00 PM,48,-122,1,0,1
27864,ElliotBayTrailMyrtlePark,03/07/2017 12:00:00 AM,48,-122,0,0,0
27865,ElliotBayTrailMyrtlePark,03/07/2017 01:00:00 AM,48,-122,0,0,0
27866,ElliotBayTrailMyrtlePark,03/07/2017 02:00:00 AM,48,-122,0,0,0
27867,ElliotBayTrailMyrtlePark,03/07/2017 03:00:00 AM,48,-122,0,1,1
27868,ElliotBayTrailMyrtlePark,03/07/2017 04:00:00 AM,48,-122,0,1,1
27869,ElliotBayTrailMyrtlePark,03/07/2017 05:00:00 AM,48,-122,6,10,16
27870,ElliotBayTrailMyrtlePark,03/07/2017 06:00:00 AM,48,-122,9,17,26
27871,ElliotBayTrailMyrtlePark,03/07/2017 07:00:00 AM,48,-122,31,45,76
27872,ElliotBayTrailMyrtlePark,03/07/2017 08:00:00 AM,48,-122,15,71,86
27873,ElliotBayTrailMyrtlePark,03/07/2017 09:00:00 AM,48,-122,14,32,46
27874,ElliotBayTrailMyrtlePark,03/07/2017 10:00:00 AM,48,-122,13,14,27
27875,ElliotBayTrailMyrtlePark,03/07/2017 11:00:00 AM,48,-122,6,4,10
27876,ElliotBayTrailMyrtlePark,03/07/2017 12:00:00 PM,48,-122,9,2,11
27877,ElliotBayTrailMyrtlePark,03/07/2017 01:00:00 PM,48,-122,3,3,6
27878,ElliotBayTrailMyrtlePark,03/07/2017 02:00:00 PM,48,-122,4,7,11
27879,ElliotBayTrailMyrtlePark,03/07/2017 03:00:00 PM,48,-122,15,10,25
27880,ElliotBayTrailMyrtlePark,03/07/2017 04:00:00 PM,48,-122,28,15,43
27881,ElliotBayTrailMyrtlePark,03/07/2017 05:00:00 PM,48,-122,92,27,119
27882,ElliotBayTrailMyrtlePark,03/07/2017 06:00:00 PM,48,-122,46,13,59
27883,ElliotBayTrailMyrtlePark,03/07/2017 07:00:00 PM,48,-122,16,3,19
27884,ElliotBayTrailMyrtlePark,03/07/2017 08:00:00 PM,48,-122,2,3,5
27885,ElliotBayTrailMyrtlePark,03/07/2017 09:00:00 PM,48,-122,1,2,3
27886,ElliotBayTrailMyrtlePark,03/07/2017 10:00:00 PM,48,-122,1,0,1
27887,ElliotBayTrailMyrtlePark,03/07/2017 11:00:00 PM,48,-122,0,0,0
27888,ElliotBayTrailMyrtlePark,03/08/2017 12:00:00 AM,48,-122,0,0,0
27889,ElliotBayTrailMyrtlePark,03/08/2017 01:00:00 AM,48,-122,1,0,1
27890,ElliotBayTrailMyrtlePark,03/08/2017 02:00:00 AM,48,-122,0,0,0
27891,ElliotBayTrailMyrtlePark,03/08/2017 03:00:00 AM,48,-122,0,1,1
27892,ElliotBayTrailMyrtlePark,03/08/2017 04:00:00 AM,48,-122,0,0,0
27893,ElliotBayTrailMyrtlePark,03/08/2017 05:00:00 AM,48,-122,2,6,8
27894,ElliotBayTrailMyrtlePark,03/08/2017 06:00:00 AM,48,-122,14,20,34
27895,ElliotBayTrailMyrtlePark,03/08/2017 07:00:00 AM,48,-122,30,50,80
27896,ElliotBayTrailMyrtlePark,03/08/2017 08:00:00 AM,48,-122,18,106,124
27897,ElliotBayTrailMyrtlePark,03/08/2017 09:00:00 AM,48,-122,18,42,60
27898,ElliotBayTrailMyrtlePark,03/08/2017 10:00:00 AM,48,-122,6,12,18
27899,ElliotBayTrailMyrtlePark,03/08/2017 11:00:00 AM,48,-122,7,6,13
27900,ElliotBayTrailMyrtlePark,03/08/2017 12:00:00 PM,48,-122,8,9,17
27901,ElliotBayTrailMyrtlePark,03/08/2017 01:00:00 PM,48,-122,10,12,22
27902,ElliotBayTrailMyrtlePark,03/08/2017 02:00:00 PM,48,-122,8,12,20
27903,ElliotBayTrailMyrtlePark,03/08/2017 03:00:00 PM,48,-122,18,11,29
27904,ElliotBayTrailMyrtlePark,03/08/2017 04:00:00 PM,48,-122,44,20,64
27905,ElliotBayTrailMyrtlePark,03/08/2017 05:00:00 PM,48,-122,97,20,117
27906,ElliotBayTrailMyrtlePark,03/08/2017 06:00:00 PM,48,-122,45,11,56
27907,ElliotBayTrailMyrtlePark,03/08/2017 07:00:00 PM,48,-122,14,3,17
27908,ElliotBayTrailMyrtlePark,03/08/2017 08:00:00 PM,48,-122,8,2,10
27909,ElliotBayTrailMyrtlePark,03/08/2017 09:00:00 PM,48,-122,3,1,4
27910,ElliotBayTrailMyrtlePark,03/08/2017 10:00:00 PM,48,-122,1,1,2
27911,ElliotBayTrailMyrtlePark,03/08/2017 11:00:00 PM,48,-122,0,0,0
27912,ElliotBayTrailMyrtlePark,03/09/2017 12:00:00 AM,48,-122,0,0,0
27913,ElliotBayTrailMyrtlePark,03/09/2017 01:00:00 AM,48,-122,0,0,0
27914,ElliotBayTrailMyrtlePark,03/09/2017 02:00:00 AM,48,-122,0,0,0
27915,ElliotBayTrailMyrtlePark,03/09/2017 03:00:00 AM,48,-122,0,1,1
27916,ElliotBayTrailMyrtlePark,03/09/2017 04:00:00 AM,48,-122,0,0,0
27917,ElliotBayTrailMyrtlePark,03/09/2017 05:00:00 AM,48,-122,4,8,12
27918,ElliotBayTrailMyrtlePark,03/09/2017 06:00:00 AM,48,-122,12,16,28
27919,ElliotBayTrailMyrtlePark,03/09/2017 07:00:00 AM,48,-122,22,49,71
27920,ElliotBayTrailMyrtlePark,03/09/2017 08:00:00 AM,48,-122,26,71,97
27921,ElliotBayTrailMyrtlePark,03/09/2017 09:00:00 AM,48,-122,13,30,43
27922,ElliotBayTrailMyrtlePark,03/09/2017 10:00:00 AM,48,-122,5,4,9
27923,ElliotBayTrailMyrtlePark,03/09/2017 11:00:00 AM,48,-122,7,3,10
27924,ElliotBayTrailMyrtlePark,03/09/2017 12:00:00 PM,48,-122,6,0,6
27925,ElliotBayTrailMyrtlePark,03/09/2017 01:00:00 PM,48,-122,7,2,9
27926,ElliotBayTrailMyrtlePark,03/09/2017 02:00:00 PM,48,-122,5,7,12
27927,ElliotBayTrailMyrtlePark,03/09/2017 03:00:00 PM,48,-122,11,11,22
27928,ElliotBayTrailMyrtlePark,03/09/2017 04:00:00 PM,48,-122,35,15,50
27929,ElliotBayTrailMyrtlePark,03/09/2017 05:00:00 PM,48,-122,83,20,103
27930,ElliotBayTrailMyrtlePark,03/09/2017 06:00:00 PM,48,-122,45,8,53
27931,ElliotBayTrailMyrtlePark,03/09/2017 07:00:00 PM,48,-122,15,3,18
27932,ElliotBayTrailMyrtlePark,03/09/2017 08:00:00 PM,48,-122,3,0,3
27933,ElliotBayTrailMyrtlePark,03/09/2017 09:00:00 PM,48,-122,4,2,6
27934,ElliotBayTrailMyrtlePark,03/09/2017 10:00:00 PM,48,-122,1,0,1
27935,ElliotBayTrailMyrtlePark,03/09/2017 11:00:00 PM,48,-122,1,0,1
27936,ElliotBayTrailMyrtlePark,03/10/2017 12:00:00 AM,48,-122,0,0,0
27937,ElliotBayTrailMyrtlePark,03/10/2017 01:00:00 AM,48,-122,0,0,0
27938,ElliotBayTrailMyrtlePark,03/10/2017 02:00:00 AM,48,-122,0,0,0
27939,ElliotBayTrailMyrtlePark,03/10/2017 03:00:00 AM,48,-122,1,2,3
27940,ElliotBayTrailMyrtlePark,03/10/2017 04:00:00 AM,48,-122,0,1,1
27941,ElliotBayTrailMyrtlePark,03/10/2017 05:00:00 AM,48,-122,6,6,12
27942,ElliotBayTrailMyrtlePark,03/10/2017 06:00:00 AM,48,-122,11,10,21
27943,ElliotBayTrailMyrtlePark,03/10/2017 07:00:00 AM,48,-122,26,34,60
27944,ElliotBayTrailMyrtlePark,03/10/2017 08:00:00 AM,48,-122,18,55,73
27945,ElliotBayTrailMyrtlePark,03/10/2017 09:00:00 AM,48,-122,8,39,47
27946,ElliotBayTrailMyrtlePark,03/10/2017 10:00:00 AM,48,-122,4,9,13
27947,ElliotBayTrailMyrtlePark,03/10/2017 11:00:00 AM,48,-122,4,6,10
27948,ElliotBayTrailMyrtlePark,03/10/2017 12:00:00 PM,48,-122,14,5,19
27949,ElliotBayTrailMyrtlePark,03/10/2017 01:00:00 PM,48,-122,11,7,18
27950,ElliotBayTrailMyrtlePark,03/10/2017 02:00:00 PM,48,-122,18,14,32
27951,ElliotBayTrailMyrtlePark,03/10/2017 03:00:00 PM,48,-122,39,24,63
27952,ElliotBayTrailMyrtlePark,03/10/2017 04:00:00 PM,48,-122,59,32,91
27953,ElliotBayTrailMyrtlePark,03/10/2017 05:00:00 PM,48,-122,89,45,134
27954,ElliotBayTrailMyrtlePark,03/10/2017 06:00:00 PM,48,-122,51,19,70
27955,ElliotBayTrailMyrtlePark,03/10/2017 07:00:00 PM,48,-122,12,4,16
27956,ElliotBayTrailMyrtlePark,03/10/2017 08:00:00 PM,48,-122,7,2,9
27957,ElliotBayTrailMyrtlePark,03/10/2017 09:00:00 PM,48,-122,1,4,5
27958,ElliotBayTrailMyrtlePark,03/10/2017 10:00:00 PM,48,-122,4,2,6
27959,ElliotBayTrailMyrtlePark,03/10/2017 11:00:00 PM,48,-122,0,0,0
27960,ElliotBayTrailMyrtlePark,03/11/2017 12:00:00 AM,48,-122,4,3,7
27961,ElliotBayTrailMyrtlePark,03/11/2017 01:00:00 AM,48,-122,1,2,3
27962,ElliotBayTrailMyrtlePark,03/11/2017 02:00:00 AM,48,-122,0,0,0
27963,ElliotBayTrailMyrtlePark,03/11/2017 03:00:00 AM,48,-122,1,0,1
27964,ElliotBayTrailMyrtlePark,03/11/2017 04:00:00 AM,48,-122,0,0,0
27965,ElliotBayTrailMyrtlePark,03/11/2017 05:00:00 AM,48,-122,0,1,1
27966,ElliotBayTrailMyrtlePark,03/11/2017 06:00:00 AM,48,-122,1,3,4
27967,ElliotBayTrailMyrtlePark,03/11/2017 07:00:00 AM,48,-122,5,5,10
27968,ElliotBayTrailMyrtlePark,03/11/2017 08:00:00 AM,48,-122,10,11,21
27969,ElliotBayTrailMyrtlePark,03/11/2017 09:00:00 AM,48,-122,5,13,18
27970,ElliotBayTrailMyrtlePark,03/11/2017 10:00:00 AM,48,-122,10,3,13
27971,ElliotBayTrailMyrtlePark,03/11/2017 11:00:00 AM,48,-122,5,2,7
27972,ElliotBayTrailMyrtlePark,03/11/2017 12:00:00 PM,48,-122,2,3,5
27973,ElliotBayTrailMyrtlePark,03/11/2017 01:00:00 PM,48,-122,6,5,11
27974,ElliotBayTrailMyrtlePark,03/11/2017 02:00:00 PM,48,-122,11,3,14
27975,ElliotBayTrailMyrtlePark,03/11/2017 03:00:00 PM,48,-122,8,12,20
27976,ElliotBayTrailMyrtlePark,03/11/2017 04:00:00 PM,48,-122,16,3,19
27977,ElliotBayTrailMyrtlePark,03/11/2017 05:00:00 PM,48,-122,5,8,13
27978,ElliotBayTrailMyrtlePark,03/11/2017 06:00:00 PM,48,-122,3,4,7
27979,ElliotBayTrailMyrtlePark,03/11/2017 07:00:00 PM,48,-122,3,0,3
27980,ElliotBayTrailMyrtlePark,03/11/2017 08:00:00 PM,48,-122,1,1,2
27981,ElliotBayTrailMyrtlePark,03/11/2017 09:00:00 PM,48,-122,2,2,4
27982,ElliotBayTrailMyrtlePark,03/11/2017 10:00:00 PM,48,-122,2,0,2
27983,ElliotBayTrailMyrtlePark,03/11/2017 11:00:00 PM,48,-122,0,1,1
27984,ElliotBayTrailMyrtlePark,03/12/2017 12:00:00 AM,48,-122,1,0,1
27985,ElliotBayTrailMyrtlePark,03/12/2017 01:00:00 AM,48,-122,0,0,0
27986,ElliotBayTrailMyrtlePark,03/12/2017 02:00:00 AM,48,-122,,,
27987,ElliotBayTrailMyrtlePark,03/12/2017 03:00:00 AM,48,-122,0,0,0
27988,ElliotBayTrailMyrtlePark,03/12/2017 04:00:00 AM,48,-122,0,0,0
27989,ElliotBayTrailMyrtlePark,03/12/2017 05:00:00 AM,48,-122,0,0,0
27990,ElliotBayTrailMyrtlePark,03/12/2017 06:00:00 AM,48,-122,0,2,2
27991,ElliotBayTrailMyrtlePark,03/12/2017 07:00:00 AM,48,-122,8,1,9
27992,ElliotBayTrailMyrtlePark,03/12/2017 08:00:00 AM,48,-122,4,7,11
27993,ElliotBayTrailMyrtlePark,03/12/2017 09:00:00 AM,48,-122,13,11,24
27994,ElliotBayTrailMyrtlePark,03/12/2017 10:00:00 AM,48,-122,16,12,28
27995,ElliotBayTrailMyrtlePark,03/12/2017 11:00:00 AM,48,-122,25,26,51
27996,ElliotBayTrailMyrtlePark,03/12/2017 12:00:00 PM,48,-122,13,12,25
27997,ElliotBayTrailMyrtlePark,03/12/2017 01:00:00 PM,48,-122,13,12,25
27998,ElliotBayTrailMyrtlePark,03/12/2017 02:00:00 PM,48,-122,16,10,26
27999,ElliotBayTrailMyrtlePark,03/12/2017 03:00:00 PM,48,-122,18,11,29
28000,ElliotBayTrailMyrtlePark,03/12/2017 04:00:00 PM,48,-122,17,10,27
28001,ElliotBayTrailMyrtlePark,03/12/2017 05:00:00 PM,48,-122,11,12,23
28002,ElliotBayTrailMyrtlePark,03/12/2017 06:00:00 PM,48,-122,9,10,19
28003,ElliotBayTrailMyrtlePark,03/12/2017 07:00:00 PM,48,-122,6,9,15
28004,ElliotBayTrailMyrtlePark,03/12/2017 08:00:00 PM,48,-122,3,3,6
28005,ElliotBayTrailMyrtlePark,03/12/2017 09:00:00 PM,48,-122,4,1,5
28006,ElliotBayTrailMyrtlePark,03/12/2017 10:00:00 PM,48,-122,1,0,1
28007,ElliotBayTrailMyrtlePark,03/12/2017 11:00:00 PM,48,-122,1,1,2
28008,ElliotBayTrailMyrtlePark,03/13/2017 12:00:00 AM,48,-122,3,2,5
28009,ElliotBayTrailMyrtlePark,03/13/2017 01:00:00 AM,48,-122,0,0,0
28010,ElliotBayTrailMyrtlePark,03/13/2017 02:00:00 AM,48,-122,0,0,0
28011,ElliotBayTrailMyrtlePark,03/13/2017 03:00:00 AM,48,-122,1,1,2
28012,ElliotBayTrailMyrtlePark,03/13/2017 04:00:00 AM,48,-122,0,0,0
28013,ElliotBayTrailMyrtlePark,03/13/2017 05:00:00 AM,48,-122,9,4,13
28014,ElliotBayTrailMyrtlePark,03/13/2017 06:00:00 AM,48,-122,9,8,17
28015,ElliotBayTrailMyrtlePark,03/13/2017 07:00:00 AM,48,-122,31,46,77
28016,ElliotBayTrailMyrtlePark,03/13/2017 08:00:00 AM,48,-122,24,84,108
28017,ElliotBayTrailMyrtlePark,03/13/2017 09:00:00 AM,48,-122,11,40,51
28018,ElliotBayTrailMyrtlePark,03/13/2017 10:00:00 AM,48,-122,6,5,11
28019,ElliotBayTrailMyrtlePark,03/13/2017 11:00:00 AM,48,-122,4,2,6
28020,ElliotBayTrailMyrtlePark,03/13/2017 12:00:00 PM,48,-122,9,4,13
28021,ElliotBayTrailMyrtlePark,03/13/2017 01:00:00 PM,48,-122,10,2,12
28022,ElliotBayTrailMyrtlePark,03/13/2017 02:00:00 PM,48,-122,5,8,13
28023,ElliotBayTrailMyrtlePark,03/13/2017 03:00:00 PM,48,-122,6,12,18
28024,ElliotBayTrailMyrtlePark,03/13/2017 04:00:00 PM,48,-122,29,19,48
28025,ElliotBayTrailMyrtlePark,03/13/2017 05:00:00 PM,48,-122,81,30,111
28026,ElliotBayTrailMyrtlePark,03/13/2017 06:00:00 PM,48,-122,70,14,84
28027,ElliotBayTrailMyrtlePark,03/13/2017 07:00:00 PM,48,-122,19,1,20
28028,ElliotBayTrailMyrtlePark,03/13/2017 08:00:00 PM,48,-122,3,2,5
28029,ElliotBayTrailMyrtlePark,03/13/2017 09:00:00 PM,48,-122,0,1,1
28030,ElliotBayTrailMyrtlePark,03/13/2017 10:00:00 PM,48,-122,1,1,2
28031,ElliotBayTrailMyrtlePark,03/13/2017 11:00:00 PM,48,-122,2,0,2
28032,ElliotBayTrailMyrtlePark,03/14/2017 12:00:00 AM,48,-122,2,0,2
28033,ElliotBayTrailMyrtlePark,03/14/2017 01:00:00 AM,48,-122,1,0,1
28034,ElliotBayTrailMyrtlePark,03/14/2017 02:00:00 AM,48,-122,1,1,2
28035,ElliotBayTrailMyrtlePark,03/14/2017 03:00:00 AM,48,-122,0,2,2
28036,ElliotBayTrailMyrtlePark,03/14/2017 04:00:00 AM,48,-122,0,0,0
28037,ElliotBayTrailMyrtlePark,03/14/2017 05:00:00 AM,48,-122,6,9,15
28038,ElliotBayTrailMyrtlePark,03/14/2017 06:00:00 AM,48,-122,7,7,14
28039,ElliotBayTrailMyrtlePark,03/14/2017 07:00:00 AM,48,-122,24,43,67
28040,ElliotBayTrailMyrtlePark,03/14/2017 08:00:00 AM,48,-122,23,82,105
28041,ElliotBayTrailMyrtlePark,03/14/2017 09:00:00 AM,48,-122,6,36,42
28042,ElliotBayTrailMyrtlePark,03/14/2017 10:00:00 AM,48,-122,8,8,16
28043,ElliotBayTrailMyrtlePark,03/14/2017 11:00:00 AM,48,-122,5,4,9
28044,ElliotBayTrailMyrtlePark,03/14/2017 12:00:00 PM,48,-122,10,4,14
28045,ElliotBayTrailMyrtlePark,03/14/2017 01:00:00 PM,48,-122,7,0,7
28046,ElliotBayTrailMyrtlePark,03/14/2017 02:00:00 PM,48,-122,3,7,10
28047,ElliotBayTrailMyrtlePark,03/14/2017 03:00:00 PM,48,-122,12,13,25
28048,ElliotBayTrailMyrtlePark,03/14/2017 04:00:00 PM,48,-122,33,14,47
28049,ElliotBayTrailMyrtlePark,03/14/2017 05:00:00 PM,48,-122,86,25,111
28050,ElliotBayTrailMyrtlePark,03/14/2017 06:00:00 PM,48,-122,61,17,78
28051,ElliotBayTrailMyrtlePark,03/14/2017 07:00:00 PM,48,-122,22,6,28
28052,ElliotBayTrailMyrtlePark,03/14/2017 08:00:00 PM,48,-122,5,2,7
28053,ElliotBayTrailMyrtlePark,03/14/2017 09:00:00 PM,48,-122,3,3,6
28054,ElliotBayTrailMyrtlePark,03/14/2017 10:00:00 PM,48,-122,2,3,5
28055,ElliotBayTrailMyrtlePark,03/14/2017 11:00:00 PM,48,-122,0,0,0
28056,ElliotBayTrailMyrtlePark,03/15/2017 12:00:00 AM,48,-122,1,0,1
28057,ElliotBayTrailMyrtlePark,03/15/2017 01:00:00 AM,48,-122,0,0,0
28058,ElliotBayTrailMyrtlePark,03/15/2017 02:00:00 AM,48,-122,0,0,0
28059,ElliotBayTrailMyrtlePark,03/15/2017 03:00:00 AM,48,-122,0,1,1
28060,ElliotBayTrailMyrtlePark,03/15/2017 04:00:00 AM,48,-122,2,1,3
28061,ElliotBayTrailMyrtlePark,03/15/2017 05:00:00 AM,48,-122,6,8,14
28062,ElliotBayTrailMyrtlePark,03/15/2017 06:00:00 AM,48,-122,9,13,22
28063,ElliotBayTrailMyrtlePark,03/15/2017 07:00:00 AM,48,-122,16,39,55
28064,ElliotBayTrailMyrtlePark,03/15/2017 08:00:00 AM,48,-122,16,71,87
28065,ElliotBayTrailMyrtlePark,03/15/2017 09:00:00 AM,48,-122,7,27,34
28066,ElliotBayTrailMyrtlePark,03/15/2017 10:00:00 AM,48,-122,4,5,9
28067,ElliotBayTrailMyrtlePark,03/15/2017 11:00:00 AM,48,-122,5,4,9
28068,ElliotBayTrailMyrtlePark,03/15/2017 12:00:00 PM,48,-122,7,1,8
28069,ElliotBayTrailMyrtlePark,03/15/2017 01:00:00 PM,48,-122,3,1,4
28070,ElliotBayTrailMyrtlePark,03/15/2017 02:00:00 PM,48,-122,10,10,20
28071,ElliotBayTrailMyrtlePark,03/15/2017 03:00:00 PM,48,-122,12,13,25
28072,ElliotBayTrailMyrtlePark,03/15/2017 04:00:00 PM,48,-122,23,14,37
28073,ElliotBayTrailMyrtlePark,03/15/2017 05:00:00 PM,48,-122,75,22,97
28074,ElliotBayTrailMyrtlePark,03/15/2017 06:00:00 PM,48,-122,55,14,69
28075,ElliotBayTrailMyrtlePark,03/15/2017 07:00:00 PM,48,-122,16,7,23
28076,ElliotBayTrailMyrtlePark,03/15/2017 08:00:00 PM,48,-122,3,1,4
28077,ElliotBayTrailMyrtlePark,03/15/2017 09:00:00 PM,48,-122,2,2,4
28078,ElliotBayTrailMyrtlePark,03/15/2017 10:00:00 PM,48,-122,2,1,3
28079,ElliotBayTrailMyrtlePark,03/15/2017 11:00:00 PM,48,-122,1,0,1
28080,ElliotBayTrailMyrtlePark,03/16/2017 12:00:00 AM,48,-122,0,0,0
28081,ElliotBayTrailMyrtlePark,03/16/2017 01:00:00 AM,48,-122,0,0,0
28082,ElliotBayTrailMyrtlePark,03/16/2017 02:00:00 AM,48,-122,1,0,1
28083,ElliotBayTrailMyrtlePark,03/16/2017 03:00:00 AM,48,-122,0,1,1
28084,ElliotBayTrailMyrtlePark,03/16/2017 04:00:00 AM,48,-122,2,2,4
28085,ElliotBayTrailMyrtlePark,03/16/2017 05:00:00 AM,48,-122,5,7,12
28086,ElliotBayTrailMyrtlePark,03/16/2017 06:00:00 AM,48,-122,10,15,25
28087,ElliotBayTrailMyrtlePark,03/16/2017 07:00:00 AM,48,-122,22,68,90
28088,ElliotBayTrailMyrtlePark,03/16/2017 08:00:00 AM,48,-122,29,106,135
28089,ElliotBayTrailMyrtlePark,03/16/2017 09:00:00 AM,48,-122,20,53,73
28090,ElliotBayTrailMyrtlePark,03/16/2017 10:00:00 AM,48,-122,7,15,22
28091,ElliotBayTrailMyrtlePark,03/16/2017 11:00:00 AM,48,-122,18,14,32
28092,ElliotBayTrailMyrtlePark,03/16/2017 12:00:00 PM,48,-122,17,15,32
28093,ElliotBayTrailMyrtlePark,03/16/2017 01:00:00 PM,48,-122,23,27,50
28094,ElliotBayTrailMyrtlePark,03/16/2017 02:00:00 PM,48,-122,19,19,38
28095,ElliotBayTrailMyrtlePark,03/16/2017 03:00:00 PM,48,-122,29,14,43
28096,ElliotBayTrailMyrtlePark,03/16/2017 04:00:00 PM,48,-122,52,35,87
28097,ElliotBayTrailMyrtlePark,03/16/2017 05:00:00 PM,48,-122,118,52,170
28098,ElliotBayTrailMyrtlePark,03/16/2017 06:00:00 PM,48,-122,93,44,137
28099,ElliotBayTrailMyrtlePark,03/16/2017 07:00:00 PM,48,-122,26,28,54
28100,ElliotBayTrailMyrtlePark,03/16/2017 08:00:00 PM,48,-122,7,6,13
28101,ElliotBayTrailMyrtlePark,03/16/2017 09:00:00 PM,48,-122,4,6,10
28102,ElliotBayTrailMyrtlePark,03/16/2017 10:00:00 PM,48,-122,4,3,7
28103,ElliotBayTrailMyrtlePark,03/16/2017 11:00:00 PM,48,-122,3,3,6
28104,ElliotBayTrailMyrtlePark,03/17/2017 12:00:00 AM,48,-122,4,9,13
28105,ElliotBayTrailMyrtlePark,03/17/2017 01:00:00 AM,48,-122,1,9,10
28106,ElliotBayTrailMyrtlePark,03/17/2017 02:00:00 AM,48,-122,2,1,3
28107,ElliotBayTrailMyrtlePark,03/17/2017 03:00:00 AM,48,-122,1,0,1
28108,ElliotBayTrailMyrtlePark,03/17/2017 04:00:00 AM,48,-122,1,1,2
28109,ElliotBayTrailMyrtlePark,03/17/2017 05:00:00 AM,48,-122,8,7,15
28110,ElliotBayTrailMyrtlePark,03/17/2017 06:00:00 AM,48,-122,8,11,19
28111,ElliotBayTrailMyrtlePark,03/17/2017 07:00:00 AM,48,-122,26,48,74
28112,ElliotBayTrailMyrtlePark,03/17/2017 08:00:00 AM,48,-122,25,84,109
28113,ElliotBayTrailMyrtlePark,03/17/2017 09:00:00 AM,48,-122,12,41,53
28114,ElliotBayTrailMyrtlePark,03/17/2017 10:00:00 AM,48,-122,14,17,31
28115,ElliotBayTrailMyrtlePark,03/17/2017 11:00:00 AM,48,-122,11,12,23
28116,ElliotBayTrailMyrtlePark,03/17/2017 12:00:00 PM,48,-122,9,5,14
28117,ElliotBayTrailMyrtlePark,03/17/2017 01:00:00 PM,48,-122,8,2,10
28118,ElliotBayTrailMyrtlePark,03/17/2017 02:00:00 PM,48,-122,15,9,24
28119,ElliotBayTrailMyrtlePark,03/17/2017 03:00:00 PM,48,-122,13,16,29
28120,ElliotBayTrailMyrtlePark,03/17/2017 04:00:00 PM,48,-122,43,20,63
28121,ElliotBayTrailMyrtlePark,03/17/2017 05:00:00 PM,48,-122,73,16,89
28122,ElliotBayTrailMyrtlePark,03/17/2017 06:00:00 PM,48,-122,41,7,48
28123,ElliotBayTrailMyrtlePark,03/17/2017 07:00:00 PM,48,-122,8,2,10
28124,ElliotBayTrailMyrtlePark,03/17/2017 08:00:00 PM,48,-122,4,0,4
28125,ElliotBayTrailMyrtlePark,03/17/2017 09:00:00 PM,48,-122,0,3,3
28126,ElliotBayTrailMyrtlePark,03/17/2017 10:00:00 PM,48,-122,3,1,4
28127,ElliotBayTrailMyrtlePark,03/17/2017 11:00:00 PM,48,-122,0,0,0
28128,ElliotBayTrailMyrtlePark,03/18/2017 12:00:00 AM,48,-122,1,1,2
28129,ElliotBayTrailMyrtlePark,03/18/2017 01:00:00 AM,48,-122,0,0,0
28130,ElliotBayTrailMyrtlePark,03/18/2017 02:00:00 AM,48,-122,0,0,0
28131,ElliotBayTrailMyrtlePark,03/18/2017 03:00:00 AM,48,-122,0,0,0
28132,ElliotBayTrailMyrtlePark,03/18/2017 04:00:00 AM,48,-122,0,1,1
28133,ElliotBayTrailMyrtlePark,03/18/2017 05:00:00 AM,48,-122,1,1,2
28134,ElliotBayTrailMyrtlePark,03/18/2017 06:00:00 AM,48,-122,0,1,1
28135,ElliotBayTrailMyrtlePark,03/18/2017 07:00:00 AM,48,-122,4,4,8
28136,ElliotBayTrailMyrtlePark,03/18/2017 08:00:00 AM,48,-122,1,5,6
28137,ElliotBayTrailMyrtlePark,03/18/2017 09:00:00 AM,48,-122,4,2,6
28138,ElliotBayTrailMyrtlePark,03/18/2017 10:00:00 AM,48,-122,4,5,9
28139,ElliotBayTrailMyrtlePark,03/18/2017 11:00:00 AM,48,-122,2,1,3
28140,ElliotBayTrailMyrtlePark,03/18/2017 12:00:00 PM,48,-122,10,7,17
28141,ElliotBayTrailMyrtlePark,03/18/2017 01:00:00 PM,48,-122,5,5,10
28142,ElliotBayTrailMyrtlePark,03/18/2017 02:00:00 PM,48,-122,22,8,30
28143,ElliotBayTrailMyrtlePark,03/18/2017 03:00:00 PM,48,-122,13,20,33
28144,ElliotBayTrailMyrtlePark,03/18/2017 04:00:00 PM,48,-122,22,25,47
28145,ElliotBayTrailMyrtlePark,03/18/2017 05:00:00 PM,48,-122,12,22,34
28146,ElliotBayTrailMyrtlePark,03/18/2017 06:00:00 PM,48,-122,16,7,23
28147,ElliotBayTrailMyrtlePark,03/18/2017 07:00:00 PM,48,-122,3,8,11
28148,ElliotBayTrailMyrtlePark,03/18/2017 08:00:00 PM,48,-122,0,1,1
28149,ElliotBayTrailMyrtlePark,03/18/2017 09:00:00 PM,48,-122,0,1,1
28150,ElliotBayTrailMyrtlePark,03/18/2017 10:00:00 PM,48,-122,1,1,2
28151,ElliotBayTrailMyrtlePark,03/18/2017 11:00:00 PM,48,-122,11,2,13
28152,ElliotBayTrailMyrtlePark,03/19/2017 12:00:00 AM,48,-122,0,1,1
28153,ElliotBayTrailMyrtlePark,03/19/2017 01:00:00 AM,48,-122,0,0,0
28154,ElliotBayTrailMyrtlePark,03/19/2017 02:00:00 AM,48,-122,0,0,0
28155,ElliotBayTrailMyrtlePark,03/19/2017 03:00:00 AM,48,-122,0,0,0
28156,ElliotBayTrailMyrtlePark,03/19/2017 04:00:00 AM,48,-122,0,1,1
28157,ElliotBayTrailMyrtlePark,03/19/2017 05:00:00 AM,48,-122,0,0,0
28158,ElliotBayTrailMyrtlePark,03/19/2017 06:00:00 AM,48,-122,0,1,1
28159,ElliotBayTrailMyrtlePark,03/19/2017 07:00:00 AM,48,-122,4,7,11
28160,ElliotBayTrailMyrtlePark,03/19/2017 08:00:00 AM,48,-122,18,11,29
28161,ElliotBayTrailMyrtlePark,03/19/2017 09:00:00 AM,48,-122,31,23,54
28162,ElliotBayTrailMyrtlePark,03/19/2017 10:00:00 AM,48,-122,31,30,61
28163,ElliotBayTrailMyrtlePark,03/19/2017 11:00:00 AM,48,-122,63,49,112
28164,ElliotBayTrailMyrtlePark,03/19/2017 12:00:00 PM,48,-122,62,71,133
28165,ElliotBayTrailMyrtlePark,03/19/2017 01:00:00 PM,48,-122,67,77,144
28166,ElliotBayTrailMyrtlePark,03/19/2017 02:00:00 PM,48,-122,95,88,183
28167,ElliotBayTrailMyrtlePark,03/19/2017 03:00:00 PM,48,-122,68,77,145
28168,ElliotBayTrailMyrtlePark,03/19/2017 04:00:00 PM,48,-122,49,62,111
28169,ElliotBayTrailMyrtlePark,03/19/2017 05:00:00 PM,48,-122,35,42,77
28170,ElliotBayTrailMyrtlePark,03/19/2017 06:00:00 PM,48,-122,51,21,72
28171,ElliotBayTrailMyrtlePark,03/19/2017 07:00:00 PM,48,-122,22,19,41
28172,ElliotBayTrailMyrtlePark,03/19/2017 08:00:00 PM,48,-122,8,3,11
28173,ElliotBayTrailMyrtlePark,03/19/2017 09:00:00 PM,48,-122,2,1,3
28174,ElliotBayTrailMyrtlePark,03/19/2017 10:00:00 PM,48,-122,1,1,2
28175,ElliotBayTrailMyrtlePark,03/19/2017 11:00:00 PM,48,-122,5,1,6
28176,ElliotBayTrailMyrtlePark,03/20/2017 12:00:00 AM,48,-122,0,3,3
28177,ElliotBayTrailMyrtlePark,03/20/2017 01:00:00 AM,48,-122,0,0,0
28178,ElliotBayTrailMyrtlePark,03/20/2017 02:00:00 AM,48,-122,0,0,0
28179,ElliotBayTrailMyrtlePark,03/20/2017 03:00:00 AM,48,-122,0,1,1
28180,ElliotBayTrailMyrtlePark,03/20/2017 04:00:00 AM,48,-122,0,0,0
28181,ElliotBayTrailMyrtlePark,03/20/2017 05:00:00 AM,48,-122,4,7,11
28182,ElliotBayTrailMyrtlePark,03/20/2017 06:00:00 AM,48,-122,18,20,38
28183,ElliotBayTrailMyrtlePark,03/20/2017 07:00:00 AM,48,-122,26,63,89
28184,ElliotBayTrailMyrtlePark,03/20/2017 08:00:00 AM,48,-122,31,117,148
28185,ElliotBayTrailMyrtlePark,03/20/2017 09:00:00 AM,48,-122,23,54,77
28186,ElliotBayTrailMyrtlePark,03/20/2017 10:00:00 AM,48,-122,10,18,28
28187,ElliotBayTrailMyrtlePark,03/20/2017 11:00:00 AM,48,-122,11,11,22
28188,ElliotBayTrailMyrtlePark,03/20/2017 12:00:00 PM,48,-122,18,13,31
28189,ElliotBayTrailMyrtlePark,03/20/2017 01:00:00 PM,48,-122,14,10,24
28190,ElliotBayTrailMyrtlePark,03/20/2017 02:00:00 PM,48,-122,20,13,33
28191,ElliotBayTrailMyrtlePark,03/20/2017 03:00:00 PM,48,-122,29,28,57
28192,ElliotBayTrailMyrtlePark,03/20/2017 04:00:00 PM,48,-122,53,32,85
28193,ElliotBayTrailMyrtlePark,03/20/2017 05:00:00 PM,48,-122,135,45,180
28194,ElliotBayTrailMyrtlePark,03/20/2017 06:00:00 PM,48,-122,64,17,81
28195,ElliotBayTrailMyrtlePark,03/20/2017 07:00:00 PM,48,-122,28,11,39
28196,ElliotBayTrailMyrtlePark,03/20/2017 08:00:00 PM,48,-122,7,0,7
28197,ElliotBayTrailMyrtlePark,03/20/2017 09:00:00 PM,48,-122,4,1,5
28198,ElliotBayTrailMyrtlePark,03/20/2017 10:00:00 PM,48,-122,1,1,2
28199,ElliotBayTrailMyrtlePark,03/20/2017 11:00:00 PM,48,-122,2,1,3
28200,ElliotBayTrailMyrtlePark,03/21/2017 12:00:00 AM,48,-122,0,0,0
28201,ElliotBayTrailMyrtlePark,03/21/2017 01:00:00 AM,48,-122,0,0,0
28202,ElliotBayTrailMyrtlePark,03/21/2017 02:00:00 AM,48,-122,0,0,0
28203,ElliotBayTrailMyrtlePark,03/21/2017 03:00:00 AM,48,-122,0,2,2
28204,ElliotBayTrailMyrtlePark,03/21/2017 04:00:00 AM,48,-122,0,0,0
28205,ElliotBayTrailMyrtlePark,03/21/2017 05:00:00 AM,48,-122,3,7,10
28206,ElliotBayTrailMyrtlePark,03/21/2017 06:00:00 AM,48,-122,6,13,19
28207,ElliotBayTrailMyrtlePark,03/21/2017 07:00:00 AM,48,-122,14,53,67
28208,ElliotBayTrailMyrtlePark,03/21/2017 08:00:00 AM,48,-122,21,93,114
28209,ElliotBayTrailMyrtlePark,03/21/2017 09:00:00 AM,48,-122,14,31,45
28210,ElliotBayTrailMyrtlePark,03/21/2017 10:00:00 AM,48,-122,10,8,18
28211,ElliotBayTrailMyrtlePark,03/21/2017 11:00:00 AM,48,-122,11,6,17
28212,ElliotBayTrailMyrtlePark,03/21/2017 12:00:00 PM,48,-122,5,9,14
28213,ElliotBayTrailMyrtlePark,03/21/2017 01:00:00 PM,48,-122,9,4,13
28214,ElliotBayTrailMyrtlePark,03/21/2017 02:00:00 PM,48,-122,13,10,23
28215,ElliotBayTrailMyrtlePark,03/21/2017 03:00:00 PM,48,-122,18,17,35
28216,ElliotBayTrailMyrtlePark,03/21/2017 04:00:00 PM,48,-122,38,27,65
28217,ElliotBayTrailMyrtlePark,03/21/2017 05:00:00 PM,48,-122,106,37,143
28218,ElliotBayTrailMyrtlePark,03/21/2017 06:00:00 PM,48,-122,62,32,94
28219,ElliotBayTrailMyrtlePark,03/21/2017 07:00:00 PM,48,-122,18,6,24
28220,ElliotBayTrailMyrtlePark,03/21/2017 08:00:00 PM,48,-122,2,4,6
28221,ElliotBayTrailMyrtlePark,03/21/2017 09:00:00 PM,48,-122,4,1,5
28222,ElliotBayTrailMyrtlePark,03/21/2017 10:00:00 PM,48,-122,0,3,3
28223,ElliotBayTrailMyrtlePark,03/21/2017 11:00:00 PM,48,-122,0,0,0
28224,ElliotBayTrailMyrtlePark,03/22/2017 12:00:00 AM,48,-122,0,0,0
28225,ElliotBayTrailMyrtlePark,03/22/2017 01:00:00 AM,48,-122,1,0,1
28226,ElliotBayTrailMyrtlePark,03/22/2017 02:00:00 AM,48,-122,1,0,1
28227,ElliotBayTrailMyrtlePark,03/22/2017 03:00:00 AM,48,-122,0,1,1
28228,ElliotBayTrailMyrtlePark,03/22/2017 04:00:00 AM,48,-122,0,2,2
28229,ElliotBayTrailMyrtlePark,03/22/2017 05:00:00 AM,48,-122,8,6,14
28230,ElliotBayTrailMyrtlePark,03/22/2017 06:00:00 AM,48,-122,10,13,23
28231,ElliotBayTrailMyrtlePark,03/22/2017 07:00:00 AM,48,-122,22,58,80
28232,ElliotBayTrailMyrtlePark,03/22/2017 08:00:00 AM,48,-122,21,110,131
28233,ElliotBayTrailMyrtlePark,03/22/2017 09:00:00 AM,48,-122,13,46,59
28234,ElliotBayTrailMyrtlePark,03/22/2017 10:00:00 AM,48,-122,13,11,24
28235,ElliotBayTrailMyrtlePark,03/22/2017 11:00:00 AM,48,-122,11,12,23
28236,ElliotBayTrailMyrtlePark,03/22/2017 12:00:00 PM,48,-122,9,5,14
28237,ElliotBayTrailMyrtlePark,03/22/2017 01:00:00 PM,48,-122,9,13,22
28238,ElliotBayTrailMyrtlePark,03/22/2017 02:00:00 PM,48,-122,13,14,27
28239,ElliotBayTrailMyrtlePark,03/22/2017 03:00:00 PM,48,-122,31,14,45
28240,ElliotBayTrailMyrtlePark,03/22/2017 04:00:00 PM,48,-122,54,25,79
28241,ElliotBayTrailMyrtlePark,03/22/2017 05:00:00 PM,48,-122,111,23,134
28242,ElliotBayTrailMyrtlePark,03/22/2017 06:00:00 PM,48,-122,65,22,87
28243,ElliotBayTrailMyrtlePark,03/22/2017 07:00:00 PM,48,-122,30,9,39
28244,ElliotBayTrailMyrtlePark,03/22/2017 08:00:00 PM,48,-122,4,2,6
28245,ElliotBayTrailMyrtlePark,03/22/2017 09:00:00 PM,48,-122,0,1,1
28246,ElliotBayTrailMyrtlePark,03/22/2017 10:00:00 PM,48,-122,5,5,10
28247,ElliotBayTrailMyrtlePark,03/22/2017 11:00:00 PM,48,-122,1,0,1
28248,ElliotBayTrailMyrtlePark,03/23/2017 12:00:00 AM,48,-122,2,0,2
28249,ElliotBayTrailMyrtlePark,03/23/2017 01:00:00 AM,48,-122,0,0,0
28250,ElliotBayTrailMyrtlePark,03/23/2017 02:00:00 AM,48,-122,1,0,1
28251,ElliotBayTrailMyrtlePark,03/23/2017 03:00:00 AM,48,-122,0,1,1
28252,ElliotBayTrailMyrtlePark,03/23/2017 04:00:00 AM,48,-122,0,2,2
28253,ElliotBayTrailMyrtlePark,03/23/2017 05:00:00 AM,48,-122,6,8,14
28254,ElliotBayTrailMyrtlePark,03/23/2017 06:00:00 AM,48,-122,9,18,27
28255,ElliotBayTrailMyrtlePark,03/23/2017 07:00:00 AM,48,-122,27,73,100
28256,ElliotBayTrailMyrtlePark,03/23/2017 08:00:00 AM,48,-122,27,116,143
28257,ElliotBayTrailMyrtlePark,03/23/2017 09:00:00 AM,48,-122,27,52,79
28258,ElliotBayTrailMyrtlePark,03/23/2017 10:00:00 AM,48,-122,9,19,28
28259,ElliotBayTrailMyrtlePark,03/23/2017 11:00:00 AM,48,-122,12,14,26
28260,ElliotBayTrailMyrtlePark,03/23/2017 12:00:00 PM,48,-122,16,10,26
28261,ElliotBayTrailMyrtlePark,03/23/2017 01:00:00 PM,48,-122,22,18,40
28262,ElliotBayTrailMyrtlePark,03/23/2017 02:00:00 PM,48,-122,19,19,38
28263,ElliotBayTrailMyrtlePark,03/23/2017 03:00:00 PM,48,-122,29,31,60
28264,ElliotBayTrailMyrtlePark,03/23/2017 04:00:00 PM,48,-122,70,42,112
28265,ElliotBayTrailMyrtlePark,03/23/2017 05:00:00 PM,48,-122,140,55,195
28266,ElliotBayTrailMyrtlePark,03/23/2017 06:00:00 PM,48,-122,100,21,121
28267,ElliotBayTrailMyrtlePark,03/23/2017 07:00:00 PM,48,-122,24,11,35
28268,ElliotBayTrailMyrtlePark,03/23/2017 08:00:00 PM,48,-122,5,4,9
28269,ElliotBayTrailMyrtlePark,03/23/2017 09:00:00 PM,48,-122,1,3,4
28270,ElliotBayTrailMyrtlePark,03/23/2017 10:00:00 PM,48,-122,3,0,3
28271,ElliotBayTrailMyrtlePark,03/23/2017 11:00:00 PM,48,-122,0,0,0
28272,ElliotBayTrailMyrtlePark,03/24/2017 12:00:00 AM,48,-122,1,1,2
28273,ElliotBayTrailMyrtlePark,03/24/2017 01:00:00 AM,48,-122,1,0,1
28274,ElliotBayTrailMyrtlePark,03/24/2017 02:00:00 AM,48,-122,0,0,0
28275,ElliotBayTrailMyrtlePark,03/24/2017 03:00:00 AM,48,-122,2,0,2
28276,ElliotBayTrailMyrtlePark,03/24/2017 04:00:00 AM,48,-122,1,1,2
28277,ElliotBayTrailMyrtlePark,03/24/2017 05:00:00 AM,48,-122,3,8,11
28278,ElliotBayTrailMyrtlePark,03/24/2017 06:00:00 AM,48,-122,9,10,19
28279,ElliotBayTrailMyrtlePark,03/24/2017 07:00:00 AM,48,-122,23,37,60
28280,ElliotBayTrailMyrtlePark,03/24/2017 08:00:00 AM,48,-122,19,61,80
28281,ElliotBayTrailMyrtlePark,03/24/2017 09:00:00 AM,48,-122,11,25,36
28282,ElliotBayTrailMyrtlePark,03/24/2017 10:00:00 AM,48,-122,4,11,15
28283,ElliotBayTrailMyrtlePark,03/24/2017 11:00:00 AM,48,-122,6,4,10
28284,ElliotBayTrailMyrtlePark,03/24/2017 12:00:00 PM,48,-122,17,5,22
28285,ElliotBayTrailMyrtlePark,03/24/2017 01:00:00 PM,48,-122,9,10,19
28286,ElliotBayTrailMyrtlePark,03/24/2017 02:00:00 PM,48,-122,3,11,14
28287,ElliotBayTrailMyrtlePark,03/24/2017 03:00:00 PM,48,-122,19,14,33
28288,ElliotBayTrailMyrtlePark,03/24/2017 04:00:00 PM,48,-122,40,16,56
28289,ElliotBayTrailMyrtlePark,03/24/2017 05:00:00 PM,48,-122,64,20,84
28290,ElliotBayTrailMyrtlePark,03/24/2017 06:00:00 PM,48,-122,35,4,39
28291,ElliotBayTrailMyrtlePark,03/24/2017 07:00:00 PM,48,-122,8,5,13
28292,ElliotBayTrailMyrtlePark,03/24/2017 08:00:00 PM,48,-122,7,5,12
28293,ElliotBayTrailMyrtlePark,03/24/2017 09:00:00 PM,48,-122,2,0,2
28294,ElliotBayTrailMyrtlePark,03/24/2017 10:00:00 PM,48,-122,7,2,9
28295,ElliotBayTrailMyrtlePark,03/24/2017 11:00:00 PM,48,-122,2,0,2
28296,ElliotBayTrailMyrtlePark,03/25/2017 12:00:00 AM,48,-122,0,0,0
28297,ElliotBayTrailMyrtlePark,03/25/2017 01:00:00 AM,48,-122,0,0,0
28298,ElliotBayTrailMyrtlePark,03/25/2017 02:00:00 AM,48,-122,0,0,0
28299,ElliotBayTrailMyrtlePark,03/25/2017 03:00:00 AM,48,-122,0,0,0
28300,ElliotBayTrailMyrtlePark,03/25/2017 04:00:00 AM,48,-122,0,0,0
28301,ElliotBayTrailMyrtlePark,03/25/2017 05:00:00 AM,48,-122,0,1,1
28302,ElliotBayTrailMyrtlePark,03/25/2017 06:00:00 AM,48,-122,2,1,3
28303,ElliotBayTrailMyrtlePark,03/25/2017 07:00:00 AM,48,-122,8,5,13
28304,ElliotBayTrailMyrtlePark,03/25/2017 08:00:00 AM,48,-122,3,5,8
28305,ElliotBayTrailMyrtlePark,03/25/2017 09:00:00 AM,48,-122,12,17,29
28306,ElliotBayTrailMyrtlePark,03/25/2017 10:00:00 AM,48,-122,23,33,56
28307,ElliotBayTrailMyrtlePark,03/25/2017 11:00:00 AM,48,-122,39,43,82
28308,ElliotBayTrailMyrtlePark,03/25/2017 12:00:00 PM,48,-122,40,34,74
28309,ElliotBayTrailMyrtlePark,03/25/2017 01:00:00 PM,48,-122,45,35,80
28310,ElliotBayTrailMyrtlePark,03/25/2017 02:00:00 PM,48,-122,58,41,99
28311,ElliotBayTrailMyrtlePark,03/25/2017 03:00:00 PM,48,-122,47,36,83
28312,ElliotBayTrailMyrtlePark,03/25/2017 04:00:00 PM,48,-122,42,39,81
28313,ElliotBayTrailMyrtlePark,03/25/2017 05:00:00 PM,48,-122,32,33,65
28314,ElliotBayTrailMyrtlePark,03/25/2017 06:00:00 PM,48,-122,25,23,48
28315,ElliotBayTrailMyrtlePark,03/25/2017 07:00:00 PM,48,-122,7,15,22
28316,ElliotBayTrailMyrtlePark,03/25/2017 08:00:00 PM,48,-122,4,3,7
28317,ElliotBayTrailMyrtlePark,03/25/2017 09:00:00 PM,48,-122,7,1,8
28318,ElliotBayTrailMyrtlePark,03/25/2017 10:00:00 PM,48,-122,0,0,0
28319,ElliotBayTrailMyrtlePark,03/25/2017 11:00:00 PM,48,-122,3,4,7
28320,ElliotBayTrailMyrtlePark,03/26/2017 12:00:00 AM,48,-122,1,0,1
28321,ElliotBayTrailMyrtlePark,03/26/2017 01:00:00 AM,48,-122,0,0,0
28322,ElliotBayTrailMyrtlePark,03/26/2017 02:00:00 AM,48,-122,0,0,0
28323,ElliotBayTrailMyrtlePark,03/26/2017 03:00:00 AM,48,-122,0,0,0
28324,ElliotBayTrailMyrtlePark,03/26/2017 04:00:00 AM,48,-122,0,1,1
28325,ElliotBayTrailMyrtlePark,03/26/2017 05:00:00 AM,48,-122,0,0,0
28326,ElliotBayTrailMyrtlePark,03/26/2017 06:00:00 AM,48,-122,0,2,2
28327,ElliotBayTrailMyrtlePark,03/26/2017 07:00:00 AM,48,-122,6,3,9
28328,ElliotBayTrailMyrtlePark,03/26/2017 08:00:00 AM,48,-122,7,10,17
28329,ElliotBayTrailMyrtlePark,03/26/2017 09:00:00 AM,48,-122,7,11,18
28330,ElliotBayTrailMyrtlePark,03/26/2017 10:00:00 AM,48,-122,6,6,12
28331,ElliotBayTrailMyrtlePark,03/26/2017 11:00:00 AM,48,-122,9,7,16
28332,ElliotBayTrailMyrtlePark,03/26/2017 12:00:00 PM,48,-122,10,7,17
28333,ElliotBayTrailMyrtlePark,03/26/2017 01:00:00 PM,48,-122,5,11,16
28334,ElliotBayTrailMyrtlePark,03/26/2017 02:00:00 PM,48,-122,9,8,17
28335,ElliotBayTrailMyrtlePark,03/26/2017 03:00:00 PM,48,-122,6,4,10
28336,ElliotBayTrailMyrtlePark,03/26/2017 04:00:00 PM,48,-122,1,0,1
28337,ElliotBayTrailMyrtlePark,03/26/2017 05:00:00 PM,48,-122,10,7,17
28338,ElliotBayTrailMyrtlePark,03/26/2017 06:00:00 PM,48,-122,5,3,8
28339,ElliotBayTrailMyrtlePark,03/26/2017 07:00:00 PM,48,-122,1,1,2
28340,ElliotBayTrailMyrtlePark,03/26/2017 08:00:00 PM,48,-122,1,2,3
28341,ElliotBayTrailMyrtlePark,03/26/2017 09:00:00 PM,48,-122,1,2,3
28342,ElliotBayTrailMyrtlePark,03/26/2017 10:00:00 PM,48,-122,1,0,1
28343,ElliotBayTrailMyrtlePark,03/26/2017 11:00:00 PM,48,-122,0,1,1
28344,ElliotBayTrailMyrtlePark,03/27/2017 12:00:00 AM,48,-122,0,0,0
28345,ElliotBayTrailMyrtlePark,03/27/2017 01:00:00 AM,48,-122,0,0,0
28346,ElliotBayTrailMyrtlePark,03/27/2017 02:00:00 AM,48,-122,0,0,0
28347,ElliotBayTrailMyrtlePark,03/27/2017 03:00:00 AM,48,-122,0,1,1
28348,ElliotBayTrailMyrtlePark,03/27/2017 04:00:00 AM,48,-122,0,1,1
28349,ElliotBayTrailMyrtlePark,03/27/2017 05:00:00 AM,48,-122,3,5,8
28350,ElliotBayTrailMyrtlePark,03/27/2017 06:00:00 AM,48,-122,17,14,31
28351,ElliotBayTrailMyrtlePark,03/27/2017 07:00:00 AM,48,-122,22,53,75
28352,ElliotBayTrailMyrtlePark,03/27/2017 08:00:00 AM,48,-122,30,113,143
28353,ElliotBayTrailMyrtlePark,03/27/2017 09:00:00 AM,48,-122,21,45,66
28354,ElliotBayTrailMyrtlePark,03/27/2017 10:00:00 AM,48,-122,12,14,26
28355,ElliotBayTrailMyrtlePark,03/27/2017 11:00:00 AM,48,-122,9,10,19
28356,ElliotBayTrailMyrtlePark,03/27/2017 12:00:00 PM,48,-122,12,10,22
28357,ElliotBayTrailMyrtlePark,03/27/2017 01:00:00 PM,48,-122,9,16,25
28358,ElliotBayTrailMyrtlePark,03/27/2017 02:00:00 PM,48,-122,13,12,25
28359,ElliotBayTrailMyrtlePark,03/27/2017 03:00:00 PM,48,-122,20,18,38
28360,ElliotBayTrailMyrtlePark,03/27/2017 04:00:00 PM,48,-122,50,26,76
28361,ElliotBayTrailMyrtlePark,03/27/2017 05:00:00 PM,48,-122,115,34,149
28362,ElliotBayTrailMyrtlePark,03/27/2017 06:00:00 PM,48,-122,93,23,116
28363,ElliotBayTrailMyrtlePark,03/27/2017 07:00:00 PM,48,-122,14,13,27
28364,ElliotBayTrailMyrtlePark,03/27/2017 08:00:00 PM,48,-122,7,0,7
28365,ElliotBayTrailMyrtlePark,03/27/2017 09:00:00 PM,48,-122,5,2,7
28366,ElliotBayTrailMyrtlePark,03/27/2017 10:00:00 PM,48,-122,1,0,1
28367,ElliotBayTrailMyrtlePark,03/27/2017 11:00:00 PM,48,-122,1,1,2
28368,ElliotBayTrailMyrtlePark,03/28/2017 12:00:00 AM,48,-122,2,0,2
28369,ElliotBayTrailMyrtlePark,03/28/2017 01:00:00 AM,48,-122,0,0,0
28370,ElliotBayTrailMyrtlePark,03/28/2017 02:00:00 AM,48,-122,2,0,2
28371,ElliotBayTrailMyrtlePark,03/28/2017 03:00:00 AM,48,-122,0,1,1
28372,ElliotBayTrailMyrtlePark,03/28/2017 04:00:00 AM,48,-122,1,3,4
28373,ElliotBayTrailMyrtlePark,03/28/2017 05:00:00 AM,48,-122,6,11,17
28374,ElliotBayTrailMyrtlePark,03/28/2017 06:00:00 AM,48,-122,12,10,22
28375,ElliotBayTrailMyrtlePark,03/28/2017 07:00:00 AM,48,-122,16,69,85
28376,ElliotBayTrailMyrtlePark,03/28/2017 08:00:00 AM,48,-122,25,99,124
28377,ElliotBayTrailMyrtlePark,03/28/2017 09:00:00 AM,48,-122,12,41,53
28378,ElliotBayTrailMyrtlePark,03/28/2017 10:00:00 AM,48,-122,13,11,24
28379,ElliotBayTrailMyrtlePark,03/28/2017 11:00:00 AM,48,-122,8,7,15
28380,ElliotBayTrailMyrtlePark,03/28/2017 12:00:00 PM,48,-122,9,7,16
28381,ElliotBayTrailMyrtlePark,03/28/2017 01:00:00 PM,48,-122,6,5,11
28382,ElliotBayTrailMyrtlePark,03/28/2017 02:00:00 PM,48,-122,4,8,12
28383,ElliotBayTrailMyrtlePark,03/28/2017 03:00:00 PM,48,-122,24,9,33
28384,ElliotBayTrailMyrtlePark,03/28/2017 04:00:00 PM,48,-122,39,22,61
28385,ElliotBayTrailMyrtlePark,03/28/2017 05:00:00 PM,48,-122,108,34,142
28386,ElliotBayTrailMyrtlePark,03/28/2017 06:00:00 PM,48,-122,64,15,79
28387,ElliotBayTrailMyrtlePark,03/28/2017 07:00:00 PM,48,-122,16,3,19
28388,ElliotBayTrailMyrtlePark,03/28/2017 08:00:00 PM,48,-122,3,0,3
28389,ElliotBayTrailMyrtlePark,03/28/2017 09:00:00 PM,48,-122,2,1,3
28390,ElliotBayTrailMyrtlePark,03/28/2017 10:00:00 PM,48,-122,7,1,8
28391,ElliotBayTrailMyrtlePark,03/28/2017 11:00:00 PM,48,-122,2,0,2
28392,ElliotBayTrailMyrtlePark,03/29/2017 12:00:00 AM,48,-122,1,2,3
28393,ElliotBayTrailMyrtlePark,03/29/2017 01:00:00 AM,48,-122,0,0,0
28394,ElliotBayTrailMyrtlePark,03/29/2017 02:00:00 AM,48,-122,2,0,2
28395,ElliotBayTrailMyrtlePark,03/29/2017 03:00:00 AM,48,-122,1,1,2
28396,ElliotBayTrailMyrtlePark,03/29/2017 04:00:00 AM,48,-122,0,1,1
28397,ElliotBayTrailMyrtlePark,03/29/2017 05:00:00 AM,48,-122,3,5,8
28398,ElliotBayTrailMyrtlePark,03/29/2017 06:00:00 AM,48,-122,6,15,21
28399,ElliotBayTrailMyrtlePark,03/29/2017 07:00:00 AM,48,-122,19,39,58
28400,ElliotBayTrailMyrtlePark,03/29/2017 08:00:00 AM,48,-122,19,80,99
28401,ElliotBayTrailMyrtlePark,03/29/2017 09:00:00 AM,48,-122,7,30,37
28402,ElliotBayTrailMyrtlePark,03/29/2017 10:00:00 AM,48,-122,5,9,14
28403,ElliotBayTrailMyrtlePark,03/29/2017 11:00:00 AM,48,-122,3,3,6
28404,ElliotBayTrailMyrtlePark,03/29/2017 12:00:00 PM,48,-122,8,2,10
28405,ElliotBayTrailMyrtlePark,03/29/2017 01:00:00 PM,48,-122,6,4,10
28406,ElliotBayTrailMyrtlePark,03/29/2017 02:00:00 PM,48,-122,9,8,17
28407,ElliotBayTrailMyrtlePark,03/29/2017 03:00:00 PM,48,-122,10,11,21
28408,ElliotBayTrailMyrtlePark,03/29/2017 04:00:00 PM,48,-122,35,20,55
28409,ElliotBayTrailMyrtlePark,03/29/2017 05:00:00 PM,48,-122,86,34,120
28410,ElliotBayTrailMyrtlePark,03/29/2017 06:00:00 PM,48,-122,82,23,105
28411,ElliotBayTrailMyrtlePark,03/29/2017 07:00:00 PM,48,-122,18,12,30
28412,ElliotBayTrailMyrtlePark,03/29/2017 08:00:00 PM,48,-122,6,9,15
28413,ElliotBayTrailMyrtlePark,03/29/2017 09:00:00 PM,48,-122,1,2,3
28414,ElliotBayTrailMyrtlePark,03/29/2017 10:00:00 PM,48,-122,1,1,2
28415,ElliotBayTrailMyrtlePark,03/29/2017 11:00:00 PM,48,-122,0,0,0
28416,ElliotBayTrailMyrtlePark,03/30/2017 12:00:00 AM,48,-122,0,0,0
28417,ElliotBayTrailMyrtlePark,03/30/2017 01:00:00 AM,48,-122,0,0,0
28418,ElliotBayTrailMyrtlePark,03/30/2017 02:00:00 AM,48,-122,1,0,1
28419,ElliotBayTrailMyrtlePark,03/30/2017 03:00:00 AM,48,-122,0,1,1
28420,ElliotBayTrailMyrtlePark,03/30/2017 04:00:00 AM,48,-122,0,1,1
28421,ElliotBayTrailMyrtlePark,03/30/2017 05:00:00 AM,48,-122,7,8,15
28422,ElliotBayTrailMyrtlePark,03/30/2017 06:00:00 AM,48,-122,9,16,25
28423,ElliotBayTrailMyrtlePark,03/30/2017 07:00:00 AM,48,-122,21,73,94
28424,ElliotBayTrailMyrtlePark,03/30/2017 08:00:00 AM,48,-122,31,121,152
28425,ElliotBayTrailMyrtlePark,03/30/2017 09:00:00 AM,48,-122,22,52,74
28426,ElliotBayTrailMyrtlePark,03/30/2017 10:00:00 AM,48,-122,5,21,26
28427,ElliotBayTrailMyrtlePark,03/30/2017 11:00:00 AM,48,-122,17,14,31
28428,ElliotBayTrailMyrtlePark,03/30/2017 12:00:00 PM,48,-122,17,11,28
28429,ElliotBayTrailMyrtlePark,03/30/2017 01:00:00 PM,48,-122,9,10,19
28430,ElliotBayTrailMyrtlePark,03/30/2017 02:00:00 PM,48,-122,20,14,34
28431,ElliotBayTrailMyrtlePark,03/30/2017 03:00:00 PM,48,-122,27,13,40
28432,ElliotBayTrailMyrtlePark,03/30/2017 04:00:00 PM,48,-122,55,29,84
28433,ElliotBayTrailMyrtlePark,03/30/2017 05:00:00 PM,48,-122,146,37,183
28434,ElliotBayTrailMyrtlePark,03/30/2017 06:00:00 PM,48,-122,84,30,114
28435,ElliotBayTrailMyrtlePark,03/30/2017 07:00:00 PM,48,-122,32,11,43
28436,ElliotBayTrailMyrtlePark,03/30/2017 08:00:00 PM,48,-122,12,6,18
28437,ElliotBayTrailMyrtlePark,03/30/2017 09:00:00 PM,48,-122,7,5,12
28438,ElliotBayTrailMyrtlePark,03/30/2017 10:00:00 PM,48,-122,2,2,4
28439,ElliotBayTrailMyrtlePark,03/30/2017 11:00:00 PM,48,-122,1,0,1
28440,ElliotBayTrailMyrtlePark,03/31/2017 12:00:00 AM,48,-122,1,0,1
28441,ElliotBayTrailMyrtlePark,03/31/2017 01:00:00 AM,48,-122,0,0,0
28442,ElliotBayTrailMyrtlePark,03/31/2017 02:00:00 AM,48,-122,1,0,1
28443,ElliotBayTrailMyrtlePark,03/31/2017 03:00:00 AM,48,-122,0,0,0
28444,ElliotBayTrailMyrtlePark,03/31/2017 04:00:00 AM,48,-122,0,2,2
28445,ElliotBayTrailMyrtlePark,03/31/2017 05:00:00 AM,48,-122,7,7,14
28446,ElliotBayTrailMyrtlePark,03/31/2017 06:00:00 AM,48,-122,10,15,25
28447,ElliotBayTrailMyrtlePark,03/31/2017 07:00:00 AM,48,-122,33,69,102
28448,ElliotBayTrailMyrtlePark,03/31/2017 08:00:00 AM,48,-122,44,126,170
28449,ElliotBayTrailMyrtlePark,03/31/2017 09:00:00 AM,48,-122,22,54,76
28450,ElliotBayTrailMyrtlePark,03/31/2017 10:00:00 AM,48,-122,15,22,37
28451,ElliotBayTrailMyrtlePark,03/31/2017 11:00:00 AM,48,-122,23,15,38
28452,ElliotBayTrailMyrtlePark,03/31/2017 12:00:00 PM,48,-122,23,19,42
28453,ElliotBayTrailMyrtlePark,03/31/2017 01:00:00 PM,48,-122,27,26,53
28454,ElliotBayTrailMyrtlePark,03/31/2017 02:00:00 PM,48,-122,19,12,31
28455,ElliotBayTrailMyrtlePark,03/31/2017 03:00:00 PM,48,-122,50,39,89
28456,ElliotBayTrailMyrtlePark,03/31/2017 04:00:00 PM,48,-122,107,47,154
28457,ElliotBayTrailMyrtlePark,03/31/2017 05:00:00 PM,48,-122,133,78,211
28458,ElliotBayTrailMyrtlePark,03/31/2017 06:00:00 PM,48,-122,96,54,150
28459,ElliotBayTrailMyrtlePark,03/31/2017 07:00:00 PM,48,-122,20,27,47
28460,ElliotBayTrailMyrtlePark,03/31/2017 08:00:00 PM,48,-122,10,7,17
28461,ElliotBayTrailMyrtlePark,03/31/2017 09:00:00 PM,48,-122,19,4,23
28462,ElliotBayTrailMyrtlePark,03/31/2017 10:00:00 PM,48,-122,6,5,11
28463,ElliotBayTrailMyrtlePark,03/31/2017 11:00:00 PM,48,-122,10,0,10
28464,ElliotBayTrailMyrtlePark,04/01/2017 12:00:00 AM,48,-122,4,1,5
28465,ElliotBayTrailMyrtlePark,04/01/2017 01:00:00 AM,48,-122,1,1,2
28466,ElliotBayTrailMyrtlePark,04/01/2017 02:00:00 AM,48,-122,1,0,1
28467,ElliotBayTrailMyrtlePark,04/01/2017 03:00:00 AM,48,-122,4,0,4
28468,ElliotBayTrailMyrtlePark,04/01/2017 04:00:00 AM,48,-122,1,0,1
28469,ElliotBayTrailMyrtlePark,04/01/2017 05:00:00 AM,48,-122,0,1,1
28470,ElliotBayTrailMyrtlePark,04/01/2017 06:00:00 AM,48,-122,1,2,3
28471,ElliotBayTrailMyrtlePark,04/01/2017 07:00:00 AM,48,-122,4,2,6
28472,ElliotBayTrailMyrtlePark,04/01/2017 08:00:00 AM,48,-122,6,5,11
28473,ElliotBayTrailMyrtlePark,04/01/2017 09:00:00 AM,48,-122,7,5,12
28474,ElliotBayTrailMyrtlePark,04/01/2017 10:00:00 AM,48,-122,13,10,23
28475,ElliotBayTrailMyrtlePark,04/01/2017 11:00:00 AM,48,-122,15,25,40
28476,ElliotBayTrailMyrtlePark,04/01/2017 12:00:00 PM,48,-122,21,27,48
28477,ElliotBayTrailMyrtlePark,04/01/2017 01:00:00 PM,48,-122,31,24,55
28478,ElliotBayTrailMyrtlePark,04/01/2017 02:00:00 PM,48,-122,31,36,67
28479,ElliotBayTrailMyrtlePark,04/01/2017 03:00:00 PM,48,-122,37,24,61
28480,ElliotBayTrailMyrtlePark,04/01/2017 04:00:00 PM,48,-122,25,21,46
28481,ElliotBayTrailMyrtlePark,04/01/2017 05:00:00 PM,48,-122,30,35,65
28482,ElliotBayTrailMyrtlePark,04/01/2017 06:00:00 PM,48,-122,11,29,40
28483,ElliotBayTrailMyrtlePark,04/01/2017 07:00:00 PM,48,-122,8,4,12
28484,ElliotBayTrailMyrtlePark,04/01/2017 08:00:00 PM,48,-122,13,7,20
28485,ElliotBayTrailMyrtlePark,04/01/2017 09:00:00 PM,48,-122,0,3,3
28486,ElliotBayTrailMyrtlePark,04/01/2017 10:00:00 PM,48,-122,11,0,11
28487,ElliotBayTrailMyrtlePark,04/01/2017 11:00:00 PM,48,-122,1,1,2
28488,ElliotBayTrailMyrtlePark,04/02/2017 12:00:00 AM,48,-122,0,3,3
28489,ElliotBayTrailMyrtlePark,04/02/2017 01:00:00 AM,48,-122,0,0,0
28490,ElliotBayTrailMyrtlePark,04/02/2017 02:00:00 AM,48,-122,0,0,0
28491,ElliotBayTrailMyrtlePark,04/02/2017 03:00:00 AM,48,-122,1,0,1
28492,ElliotBayTrailMyrtlePark,04/02/2017 04:00:00 AM,48,-122,0,1,1
28493,ElliotBayTrailMyrtlePark,04/02/2017 05:00:00 AM,48,-122,0,0,0
28494,ElliotBayTrailMyrtlePark,04/02/2017 06:00:00 AM,48,-122,2,1,3
28495,ElliotBayTrailMyrtlePark,04/02/2017 07:00:00 AM,48,-122,7,6,13
28496,ElliotBayTrailMyrtlePark,04/02/2017 08:00:00 AM,48,-122,12,8,20
28497,ElliotBayTrailMyrtlePark,04/02/2017 09:00:00 AM,48,-122,29,22,51
28498,ElliotBayTrailMyrtlePark,04/02/2017 10:00:00 AM,48,-122,22,21,43
28499,ElliotBayTrailMyrtlePark,04/02/2017 11:00:00 AM,48,-122,31,52,83
28500,ElliotBayTrailMyrtlePark,04/02/2017 12:00:00 PM,48,-122,48,40,88
28501,ElliotBayTrailMyrtlePark,04/02/2017 01:00:00 PM,48,-122,42,60,102
28502,ElliotBayTrailMyrtlePark,04/02/2017 02:00:00 PM,48,-122,51,36,87
28503,ElliotBayTrailMyrtlePark,04/02/2017 03:00:00 PM,48,-122,47,31,78
28504,ElliotBayTrailMyrtlePark,04/02/2017 04:00:00 PM,48,-122,26,26,52
28505,ElliotBayTrailMyrtlePark,04/02/2017 05:00:00 PM,48,-122,14,17,31
28506,ElliotBayTrailMyrtlePark,04/02/2017 06:00:00 PM,48,-122,9,8,17
28507,ElliotBayTrailMyrtlePark,04/02/2017 07:00:00 PM,48,-122,9,10,19
28508,ElliotBayTrailMyrtlePark,04/02/2017 08:00:00 PM,48,-122,2,2,4
28509,ElliotBayTrailMyrtlePark,04/02/2017 09:00:00 PM,48,-122,4,1,5
28510,ElliotBayTrailMyrtlePark,04/02/2017 10:00:00 PM,48,-122,2,0,2
28511,ElliotBayTrailMyrtlePark,04/02/2017 11:00:00 PM,48,-122,1,3,4
28512,ElliotBayTrailMyrtlePark,04/03/2017 12:00:00 AM,48,-122,0,0,0
28513,ElliotBayTrailMyrtlePark,04/03/2017 01:00:00 AM,48,-122,0,0,0
28514,ElliotBayTrailMyrtlePark,04/03/2017 02:00:00 AM,48,-122,1,0,1
28515,ElliotBayTrailMyrtlePark,04/03/2017 03:00:00 AM,48,-122,0,1,1
28516,ElliotBayTrailMyrtlePark,04/03/2017 04:00:00 AM,48,-122,2,4,6
28517,ElliotBayTrailMyrtlePark,04/03/2017 05:00:00 AM,48,-122,6,11,17
28518,ElliotBayTrailMyrtlePark,04/03/2017 06:00:00 AM,48,-122,14,23,37
28519,ElliotBayTrailMyrtlePark,04/03/2017 07:00:00 AM,48,-122,31,90,121
28520,ElliotBayTrailMyrtlePark,04/03/2017 08:00:00 AM,48,-122,33,145,178
28521,ElliotBayTrailMyrtlePark,04/03/2017 09:00:00 AM,48,-122,22,62,84
28522,ElliotBayTrailMyrtlePark,04/03/2017 10:00:00 AM,48,-122,10,22,32
28523,ElliotBayTrailMyrtlePark,04/03/2017 11:00:00 AM,48,-122,12,10,22
28524,ElliotBayTrailMyrtlePark,04/03/2017 12:00:00 PM,48,-122,44,26,70
28525,ElliotBayTrailMyrtlePark,04/03/2017 01:00:00 PM,48,-122,19,31,50
28526,ElliotBayTrailMyrtlePark,04/03/2017 02:00:00 PM,48,-122,24,41,65
28527,ElliotBayTrailMyrtlePark,04/03/2017 03:00:00 PM,48,-122,34,30,64
28528,ElliotBayTrailMyrtlePark,04/03/2017 04:00:00 PM,48,-122,105,49,154
28529,ElliotBayTrailMyrtlePark,04/03/2017 05:00:00 PM,48,-122,181,65,246
28530,ElliotBayTrailMyrtlePark,04/03/2017 06:00:00 PM,48,-122,104,47,151
28531,ElliotBayTrailMyrtlePark,04/03/2017 07:00:00 PM,48,-122,23,18,41
28532,ElliotBayTrailMyrtlePark,04/03/2017 08:00:00 PM,48,-122,17,9,26
28533,ElliotBayTrailMyrtlePark,04/03/2017 09:00:00 PM,48,-122,2,3,5
28534,ElliotBayTrailMyrtlePark,04/03/2017 10:00:00 PM,48,-122,5,6,11
28535,ElliotBayTrailMyrtlePark,04/03/2017 11:00:00 PM,48,-122,1,0,1
28536,ElliotBayTrailMyrtlePark,04/04/2017 12:00:00 AM,48,-122,1,0,1
28537,ElliotBayTrailMyrtlePark,04/04/2017 01:00:00 AM,48,-122,1,0,1
28538,ElliotBayTrailMyrtlePark,04/04/2017 02:00:00 AM,48,-122,2,0,2
28539,ElliotBayTrailMyrtlePark,04/04/2017 03:00:00 AM,48,-122,0,2,2
28540,ElliotBayTrailMyrtlePark,04/04/2017 04:00:00 AM,48,-122,0,2,2
28541,ElliotBayTrailMyrtlePark,04/04/2017 05:00:00 AM,48,-122,7,11,18
28542,ElliotBayTrailMyrtlePark,04/04/2017 06:00:00 AM,48,-122,13,27,40
28543,ElliotBayTrailMyrtlePark,04/04/2017 07:00:00 AM,48,-122,43,90,133
28544,ElliotBayTrailMyrtlePark,04/04/2017 08:00:00 AM,48,-122,35,127,162
28545,ElliotBayTrailMyrtlePark,04/04/2017 09:00:00 AM,48,-122,21,61,82
28546,ElliotBayTrailMyrtlePark,04/04/2017 10:00:00 AM,48,-122,8,20,28
28547,ElliotBayTrailMyrtlePark,04/04/2017 11:00:00 AM,48,-122,10,19,29
28548,ElliotBayTrailMyrtlePark,04/04/2017 12:00:00 PM,48,-122,29,15,44
28549,ElliotBayTrailMyrtlePark,04/04/2017 01:00:00 PM,48,-122,25,13,38
28550,ElliotBayTrailMyrtlePark,04/04/2017 02:00:00 PM,48,-122,40,27,67
28551,ElliotBayTrailMyrtlePark,04/04/2017 03:00:00 PM,48,-122,32,57,89
28552,ElliotBayTrailMyrtlePark,04/04/2017 04:00:00 PM,48,-122,74,55,129
28553,ElliotBayTrailMyrtlePark,04/04/2017 05:00:00 PM,48,-122,157,48,205
28554,ElliotBayTrailMyrtlePark,04/04/2017 06:00:00 PM,48,-122,97,30,127
28555,ElliotBayTrailMyrtlePark,04/04/2017 07:00:00 PM,48,-122,23,16,39
28556,ElliotBayTrailMyrtlePark,04/04/2017 08:00:00 PM,48,-122,9,7,16
28557,ElliotBayTrailMyrtlePark,04/04/2017 09:00:00 PM,48,-122,5,0,5
28558,ElliotBayTrailMyrtlePark,04/04/2017 10:00:00 PM,48,-122,1,3,4
28559,ElliotBayTrailMyrtlePark,04/04/2017 11:00:00 PM,48,-122,0,0,0
28560,ElliotBayTrailMyrtlePark,04/05/2017 12:00:00 AM,48,-122,0,1,1
28561,ElliotBayTrailMyrtlePark,04/05/2017 01:00:00 AM,48,-122,0,0,0
28562,ElliotBayTrailMyrtlePark,04/05/2017 02:00:00 AM,48,-122,1,0,1
28563,ElliotBayTrailMyrtlePark,04/05/2017 03:00:00 AM,48,-122,2,1,3
28564,ElliotBayTrailMyrtlePark,04/05/2017 04:00:00 AM,48,-122,2,2,4
28565,ElliotBayTrailMyrtlePark,04/05/2017 05:00:00 AM,48,-122,5,8,13
28566,ElliotBayTrailMyrtlePark,04/05/2017 06:00:00 AM,48,-122,6,13,19
28567,ElliotBayTrailMyrtlePark,04/05/2017 07:00:00 AM,48,-122,20,47,67
28568,ElliotBayTrailMyrtlePark,04/05/2017 08:00:00 AM,48,-122,18,75,93
28569,ElliotBayTrailMyrtlePark,04/05/2017 09:00:00 AM,48,-122,10,29,39
28570,ElliotBayTrailMyrtlePark,04/05/2017 10:00:00 AM,48,-122,12,12,24
28571,ElliotBayTrailMyrtlePark,04/05/2017 11:00:00 AM,48,-122,5,5,10
28572,ElliotBayTrailMyrtlePark,04/05/2017 12:00:00 PM,48,-122,12,5,17
28573,ElliotBayTrailMyrtlePark,04/05/2017 01:00:00 PM,48,-122,2,3,5
28574,ElliotBayTrailMyrtlePark,04/05/2017 02:00:00 PM,48,-122,2,7,9
28575,ElliotBayTrailMyrtlePark,04/05/2017 03:00:00 PM,48,-122,10,8,18
28576,ElliotBayTrailMyrtlePark,04/05/2017 04:00:00 PM,48,-122,39,21,60
28577,ElliotBayTrailMyrtlePark,04/05/2017 05:00:00 PM,48,-122,77,25,102
28578,ElliotBayTrailMyrtlePark,04/05/2017 06:00:00 PM,48,-122,56,16,72
28579,ElliotBayTrailMyrtlePark,04/05/2017 07:00:00 PM,48,-122,16,6,22
28580,ElliotBayTrailMyrtlePark,04/05/2017 08:00:00 PM,48,-122,10,5,15
28581,ElliotBayTrailMyrtlePark,04/05/2017 09:00:00 PM,48,-122,3,2,5
28582,ElliotBayTrailMyrtlePark,04/05/2017 10:00:00 PM,48,-122,2,1,3
28583,ElliotBayTrailMyrtlePark,04/05/2017 11:00:00 PM,48,-122,0,0,0
28584,ElliotBayTrailMyrtlePark,04/06/2017 12:00:00 AM,48,-122,1,0,1
28585,ElliotBayTrailMyrtlePark,04/06/2017 01:00:00 AM,48,-122,0,0,0
28586,ElliotBayTrailMyrtlePark,04/06/2017 02:00:00 AM,48,-122,1,0,1
28587,ElliotBayTrailMyrtlePark,04/06/2017 03:00:00 AM,48,-122,0,2,2
28588,ElliotBayTrailMyrtlePark,04/06/2017 04:00:00 AM,48,-122,0,0,0
28589,ElliotBayTrailMyrtlePark,04/06/2017 05:00:00 AM,48,-122,1,9,10
28590,ElliotBayTrailMyrtlePark,04/06/2017 06:00:00 AM,48,-122,8,16,24
28591,ElliotBayTrailMyrtlePark,04/06/2017 07:00:00 AM,48,-122,13,42,55
28592,ElliotBayTrailMyrtlePark,04/06/2017 08:00:00 AM,48,-122,19,69,88
28593,ElliotBayTrailMyrtlePark,04/06/2017 09:00:00 AM,48,-122,12,28,40
28594,ElliotBayTrailMyrtlePark,04/06/2017 10:00:00 AM,48,-122,3,15,18
28595,ElliotBayTrailMyrtlePark,04/06/2017 11:00:00 AM,48,-122,6,3,9
28596,ElliotBayTrailMyrtlePark,04/06/2017 12:00:00 PM,48,-122,7,3,10
28597,ElliotBayTrailMyrtlePark,04/06/2017 01:00:00 PM,48,-122,8,11,19
28598,ElliotBayTrailMyrtlePark,04/06/2017 02:00:00 PM,48,-122,6,15,21
28599,ElliotBayTrailMyrtlePark,04/06/2017 03:00:00 PM,48,-122,22,17,39
28600,ElliotBayTrailMyrtlePark,04/06/2017 04:00:00 PM,48,-122,46,33,79
28601,ElliotBayTrailMyrtlePark,04/06/2017 05:00:00 PM,48,-122,94,40,134
28602,ElliotBayTrailMyrtlePark,04/06/2017 06:00:00 PM,48,-122,83,42,125
28603,ElliotBayTrailMyrtlePark,04/06/2017 07:00:00 PM,48,-122,38,30,68
28604,ElliotBayTrailMyrtlePark,04/06/2017 08:00:00 PM,48,-122,10,6,16
28605,ElliotBayTrailMyrtlePark,04/06/2017 09:00:00 PM,48,-122,5,1,6
28606,ElliotBayTrailMyrtlePark,04/06/2017 10:00:00 PM,48,-122,7,0,7
28607,ElliotBayTrailMyrtlePark,04/06/2017 11:00:00 PM,48,-122,4,0,4
28608,ElliotBayTrailMyrtlePark,04/07/2017 12:00:00 AM,48,-122,1,0,1
28609,ElliotBayTrailMyrtlePark,04/07/2017 01:00:00 AM,48,-122,0,0,0
28610,ElliotBayTrailMyrtlePark,04/07/2017 02:00:00 AM,48,-122,0,0,0
28611,ElliotBayTrailMyrtlePark,04/07/2017 03:00:00 AM,48,-122,1,0,1
28612,ElliotBayTrailMyrtlePark,04/07/2017 04:00:00 AM,48,-122,3,4,7
28613,ElliotBayTrailMyrtlePark,04/07/2017 05:00:00 AM,48,-122,1,7,8
28614,ElliotBayTrailMyrtlePark,04/07/2017 06:00:00 AM,48,-122,6,15,21
28615,ElliotBayTrailMyrtlePark,04/07/2017 07:00:00 AM,48,-122,17,51,68
28616,ElliotBayTrailMyrtlePark,04/07/2017 08:00:00 AM,48,-122,24,69,93
28617,ElliotBayTrailMyrtlePark,04/07/2017 09:00:00 AM,48,-122,13,29,42
28618,ElliotBayTrailMyrtlePark,04/07/2017 10:00:00 AM,48,-122,2,12,14
28619,ElliotBayTrailMyrtlePark,04/07/2017 11:00:00 AM,48,-122,7,1,8
28620,ElliotBayTrailMyrtlePark,04/07/2017 12:00:00 PM,48,-122,16,7,23
28621,ElliotBayTrailMyrtlePark,04/07/2017 01:00:00 PM,48,-122,11,3,14
28622,ElliotBayTrailMyrtlePark,04/07/2017 02:00:00 PM,48,-122,9,7,16
28623,ElliotBayTrailMyrtlePark,04/07/2017 03:00:00 PM,48,-122,20,5,25
28624,ElliotBayTrailMyrtlePark,04/07/2017 04:00:00 PM,48,-122,41,12,53
28625,ElliotBayTrailMyrtlePark,04/07/2017 05:00:00 PM,48,-122,78,24,102
28626,ElliotBayTrailMyrtlePark,04/07/2017 06:00:00 PM,48,-122,31,7,38
28627,ElliotBayTrailMyrtlePark,04/07/2017 07:00:00 PM,48,-122,6,1,7
28628,ElliotBayTrailMyrtlePark,04/07/2017 08:00:00 PM,48,-122,3,2,5
28629,ElliotBayTrailMyrtlePark,04/07/2017 09:00:00 PM,48,-122,1,6,7
28630,ElliotBayTrailMyrtlePark,04/07/2017 10:00:00 PM,48,-122,1,1,2
28631,ElliotBayTrailMyrtlePark,04/07/2017 11:00:00 PM,48,-122,0,0,0
28632,ElliotBayTrailMyrtlePark,04/08/2017 12:00:00 AM,48,-122,2,0,2
28633,ElliotBayTrailMyrtlePark,04/08/2017 01:00:00 AM,48,-122,0,0,0
28634,ElliotBayTrailMyrtlePark,04/08/2017 02:00:00 AM,48,-122,0,0,0
28635,ElliotBayTrailMyrtlePark,04/08/2017 03:00:00 AM,48,-122,0,0,0
28636,ElliotBayTrailMyrtlePark,04/08/2017 04:00:00 AM,48,-122,1,1,2
28637,ElliotBayTrailMyrtlePark,04/08/2017 05:00:00 AM,48,-122,0,1,1
28638,ElliotBayTrailMyrtlePark,04/08/2017 06:00:00 AM,48,-122,2,4,6
28639,ElliotBayTrailMyrtlePark,04/08/2017 07:00:00 AM,48,-122,8,6,14
28640,ElliotBayTrailMyrtlePark,04/08/2017 08:00:00 AM,48,-122,8,13,21
28641,ElliotBayTrailMyrtlePark,04/08/2017 09:00:00 AM,48,-122,9,19,28
28642,ElliotBayTrailMyrtlePark,04/08/2017 10:00:00 AM,48,-122,25,22,47
28643,ElliotBayTrailMyrtlePark,04/08/2017 11:00:00 AM,48,-122,15,20,35
28644,ElliotBayTrailMyrtlePark,04/08/2017 12:00:00 PM,48,-122,18,20,38
28645,ElliotBayTrailMyrtlePark,04/08/2017 01:00:00 PM,48,-122,25,12,37
28646,ElliotBayTrailMyrtlePark,04/08/2017 02:00:00 PM,48,-122,13,10,23
28647,ElliotBayTrailMyrtlePark,04/08/2017 03:00:00 PM,48,-122,16,24,40
28648,ElliotBayTrailMyrtlePark,04/08/2017 04:00:00 PM,48,-122,29,14,43
28649,ElliotBayTrailMyrtlePark,04/08/2017 05:00:00 PM,48,-122,11,18,29
28650,ElliotBayTrailMyrtlePark,04/08/2017 06:00:00 PM,48,-122,19,15,34
28651,ElliotBayTrailMyrtlePark,04/08/2017 07:00:00 PM,48,-122,10,5,15
28652,ElliotBayTrailMyrtlePark,04/08/2017 08:00:00 PM,48,-122,1,6,7
28653,ElliotBayTrailMyrtlePark,04/08/2017 09:00:00 PM,48,-122,2,2,4
28654,ElliotBayTrailMyrtlePark,04/08/2017 10:00:00 PM,48,-122,1,0,1
28655,ElliotBayTrailMyrtlePark,04/08/2017 11:00:00 PM,48,-122,2,0,2
28656,ElliotBayTrailMyrtlePark,04/09/2017 12:00:00 AM,48,-122,0,0,0
28657,ElliotBayTrailMyrtlePark,04/09/2017 01:00:00 AM,48,-122,1,0,1
28658,ElliotBayTrailMyrtlePark,04/09/2017 02:00:00 AM,48,-122,0,0,0
28659,ElliotBayTrailMyrtlePark,04/09/2017 03:00:00 AM,48,-122,1,0,1
28660,ElliotBayTrailMyrtlePark,04/09/2017 04:00:00 AM,48,-122,0,0,0
28661,ElliotBayTrailMyrtlePark,04/09/2017 05:00:00 AM,48,-122,0,0,0
28662,ElliotBayTrailMyrtlePark,04/09/2017 06:00:00 AM,48,-122,0,5,5
28663,ElliotBayTrailMyrtlePark,04/09/2017 07:00:00 AM,48,-122,6,4,10
28664,ElliotBayTrailMyrtlePark,04/09/2017 08:00:00 AM,48,-122,11,19,30
28665,ElliotBayTrailMyrtlePark,04/09/2017 09:00:00 AM,48,-122,16,19,35
28666,ElliotBayTrailMyrtlePark,04/09/2017 10:00:00 AM,48,-122,49,28,77
28667,ElliotBayTrailMyrtlePark,04/09/2017 11:00:00 AM,48,-122,43,46,89
28668,ElliotBayTrailMyrtlePark,04/09/2017 12:00:00 PM,48,-122,62,50,112
28669,ElliotBayTrailMyrtlePark,04/09/2017 01:00:00 PM,48,-122,53,51,104
28670,ElliotBayTrailMyrtlePark,04/09/2017 02:00:00 PM,48,-122,42,52,94
28671,ElliotBayTrailMyrtlePark,04/09/2017 03:00:00 PM,48,-122,64,51,115
28672,ElliotBayTrailMyrtlePark,04/09/2017 04:00:00 PM,48,-122,55,56,111
28673,ElliotBayTrailMyrtlePark,04/09/2017 05:00:00 PM,48,-122,34,47,81
28674,ElliotBayTrailMyrtlePark,04/09/2017 06:00:00 PM,48,-122,15,24,39
28675,ElliotBayTrailMyrtlePark,04/09/2017 07:00:00 PM,48,-122,13,11,24
28676,ElliotBayTrailMyrtlePark,04/09/2017 08:00:00 PM,48,-122,4,4,8
28677,ElliotBayTrailMyrtlePark,04/09/2017 09:00:00 PM,48,-122,2,4,6
28678,ElliotBayTrailMyrtlePark,04/09/2017 10:00:00 PM,48,-122,1,0,1
28679,ElliotBayTrailMyrtlePark,04/09/2017 11:00:00 PM,48,-122,0,1,1
28680,ElliotBayTrailMyrtlePark,04/10/2017 12:00:00 AM,48,-122,0,0,0
28681,ElliotBayTrailMyrtlePark,04/10/2017 01:00:00 AM,48,-122,0,1,1
28682,ElliotBayTrailMyrtlePark,04/10/2017 02:00:00 AM,48,-122,0,0,0
28683,ElliotBayTrailMyrtlePark,04/10/2017 03:00:00 AM,48,-122,0,0,0
28684,ElliotBayTrailMyrtlePark,04/10/2017 04:00:00 AM,48,-122,0,0,0
28685,ElliotBayTrailMyrtlePark,04/10/2017 05:00:00 AM,48,-122,2,3,5
28686,ElliotBayTrailMyrtlePark,04/10/2017 06:00:00 AM,48,-122,10,16,26
28687,ElliotBayTrailMyrtlePark,04/10/2017 07:00:00 AM,48,-122,24,60,84
28688,ElliotBayTrailMyrtlePark,04/10/2017 08:00:00 AM,48,-122,30,109,139
28689,ElliotBayTrailMyrtlePark,04/10/2017 09:00:00 AM,48,-122,20,42,62
28690,ElliotBayTrailMyrtlePark,04/10/2017 10:00:00 AM,48,-122,9,18,27
28691,ElliotBayTrailMyrtlePark,04/10/2017 11:00:00 AM,48,-122,7,4,11
28692,ElliotBayTrailMyrtlePark,04/10/2017 12:00:00 PM,48,-122,8,7,15
28693,ElliotBayTrailMyrtlePark,04/10/2017 01:00:00 PM,48,-122,8,8,16
28694,ElliotBayTrailMyrtlePark,04/10/2017 02:00:00 PM,48,-122,7,4,11
28695,ElliotBayTrailMyrtlePark,04/10/2017 03:00:00 PM,48,-122,13,9,22
28696,ElliotBayTrailMyrtlePark,04/10/2017 04:00:00 PM,48,-122,57,20,77
28697,ElliotBayTrailMyrtlePark,04/10/2017 05:00:00 PM,48,-122,114,16,130
28698,ElliotBayTrailMyrtlePark,04/10/2017 06:00:00 PM,48,-122,56,15,71
28699,ElliotBayTrailMyrtlePark,04/10/2017 07:00:00 PM,48,-122,17,5,22
28700,ElliotBayTrailMyrtlePark,04/10/2017 08:00:00 PM,48,-122,8,1,9
28701,ElliotBayTrailMyrtlePark,04/10/2017 09:00:00 PM,48,-122,0,4,4
28702,ElliotBayTrailMyrtlePark,04/10/2017 10:00:00 PM,48,-122,1,0,1
28703,ElliotBayTrailMyrtlePark,04/10/2017 11:00:00 PM,48,-122,1,0,1
28704,ElliotBayTrailMyrtlePark,04/11/2017 12:00:00 AM,48,-122,0,0,0
28705,ElliotBayTrailMyrtlePark,04/11/2017 01:00:00 AM,48,-122,0,0,0
28706,ElliotBayTrailMyrtlePark,04/11/2017 02:00:00 AM,48,-122,2,1,3
28707,ElliotBayTrailMyrtlePark,04/11/2017 03:00:00 AM,48,-122,0,0,0
28708,ElliotBayTrailMyrtlePark,04/11/2017 04:00:00 AM,48,-122,4,3,7
28709,ElliotBayTrailMyrtlePark,04/11/2017 05:00:00 AM,48,-122,4,10,14
28710,ElliotBayTrailMyrtlePark,04/11/2017 06:00:00 AM,48,-122,22,28,50
28711,ElliotBayTrailMyrtlePark,04/11/2017 07:00:00 AM,48,-122,28,83,111
28712,ElliotBayTrailMyrtlePark,04/11/2017 08:00:00 AM,48,-122,40,139,179
28713,ElliotBayTrailMyrtlePark,04/11/2017 09:00:00 AM,48,-122,22,45,67
28714,ElliotBayTrailMyrtlePark,04/11/2017 10:00:00 AM,48,-122,21,41,62
28715,ElliotBayTrailMyrtlePark,04/11/2017 11:00:00 AM,48,-122,31,33,64
28716,ElliotBayTrailMyrtlePark,04/11/2017 12:00:00 PM,48,-122,36,20,56
28717,ElliotBayTrailMyrtlePark,04/11/2017 01:00:00 PM,48,-122,28,23,51
28718,ElliotBayTrailMyrtlePark,04/11/2017 02:00:00 PM,48,-122,26,18,44
28719,ElliotBayTrailMyrtlePark,04/11/2017 03:00:00 PM,48,-122,36,34,70
28720,ElliotBayTrailMyrtlePark,04/11/2017 04:00:00 PM,48,-122,62,41,103
28721,ElliotBayTrailMyrtlePark,04/11/2017 05:00:00 PM,48,-122,166,49,215
28722,ElliotBayTrailMyrtlePark,04/11/2017 06:00:00 PM,48,-122,106,39,145
28723,ElliotBayTrailMyrtlePark,04/11/2017 07:00:00 PM,48,-122,39,18,57
28724,ElliotBayTrailMyrtlePark,04/11/2017 08:00:00 PM,48,-122,12,8,20
28725,ElliotBayTrailMyrtlePark,04/11/2017 09:00:00 PM,48,-122,6,2,8
28726,ElliotBayTrailMyrtlePark,04/11/2017 10:00:00 PM,48,-122,5,1,6
28727,ElliotBayTrailMyrtlePark,04/11/2017 11:00:00 PM,48,-122,4,0,4
28728,ElliotBayTrailMyrtlePark,04/12/2017 12:00:00 AM,48,-122,2,1,3
28729,ElliotBayTrailMyrtlePark,04/12/2017 01:00:00 AM,48,-122,0,0,0
28730,ElliotBayTrailMyrtlePark,04/12/2017 02:00:00 AM,48,-122,0,0,0
28731,ElliotBayTrailMyrtlePark,04/12/2017 03:00:00 AM,48,-122,2,1,3
28732,ElliotBayTrailMyrtlePark,04/12/2017 04:00:00 AM,48,-122,1,2,3
28733,ElliotBayTrailMyrtlePark,04/12/2017 05:00:00 AM,48,-122,5,5,10
28734,ElliotBayTrailMyrtlePark,04/12/2017 06:00:00 AM,48,-122,9,12,21
28735,ElliotBayTrailMyrtlePark,04/12/2017 07:00:00 AM,48,-122,27,36,63
28736,ElliotBayTrailMyrtlePark,04/12/2017 08:00:00 AM,48,-122,22,67,89
28737,ElliotBayTrailMyrtlePark,04/12/2017 09:00:00 AM,48,-122,8,26,34
28738,ElliotBayTrailMyrtlePark,04/12/2017 10:00:00 AM,48,-122,5,9,14
28739,ElliotBayTrailMyrtlePark,04/12/2017 11:00:00 AM,48,-122,12,5,17
28740,ElliotBayTrailMyrtlePark,04/12/2017 12:00:00 PM,48,-122,5,9,14
28741,ElliotBayTrailMyrtlePark,04/12/2017 01:00:00 PM,48,-122,14,4,18
28742,ElliotBayTrailMyrtlePark,04/12/2017 02:00:00 PM,48,-122,14,18,32
28743,ElliotBayTrailMyrtlePark,04/12/2017 03:00:00 PM,48,-122,18,11,29
28744,ElliotBayTrailMyrtlePark,04/12/2017 04:00:00 PM,48,-122,35,24,59
28745,ElliotBayTrailMyrtlePark,04/12/2017 05:00:00 PM,48,-122,84,31,115
28746,ElliotBayTrailMyrtlePark,04/12/2017 06:00:00 PM,48,-122,58,27,85
28747,ElliotBayTrailMyrtlePark,04/12/2017 07:00:00 PM,48,-122,20,6,26
28748,ElliotBayTrailMyrtlePark,04/12/2017 08:00:00 PM,48,-122,4,7,11
28749,ElliotBayTrailMyrtlePark,04/12/2017 09:00:00 PM,48,-122,1,2,3
28750,ElliotBayTrailMyrtlePark,04/12/2017 10:00:00 PM,48,-122,2,0,2
28751,ElliotBayTrailMyrtlePark,04/12/2017 11:00:00 PM,48,-122,6,1,7
28752,ElliotBayTrailMyrtlePark,04/13/2017 12:00:00 AM,48,-122,0,0,0
28753,ElliotBayTrailMyrtlePark,04/13/2017 01:00:00 AM,48,-122,0,0,0
28754,ElliotBayTrailMyrtlePark,04/13/2017 02:00:00 AM,48,-122,0,0,0
28755,ElliotBayTrailMyrtlePark,04/13/2017 03:00:00 AM,48,-122,1,2,3
28756,ElliotBayTrailMyrtlePark,04/13/2017 04:00:00 AM,48,-122,5,2,7
28757,ElliotBayTrailMyrtlePark,04/13/2017 05:00:00 AM,48,-122,4,9,13
28758,ElliotBayTrailMyrtlePark,04/13/2017 06:00:00 AM,48,-122,8,18,26
28759,ElliotBayTrailMyrtlePark,04/13/2017 07:00:00 AM,48,-122,28,60,88
28760,ElliotBayTrailMyrtlePark,04/13/2017 08:00:00 AM,48,-122,30,78,108
28761,ElliotBayTrailMyrtlePark,04/13/2017 09:00:00 AM,48,-122,17,47,64
28762,ElliotBayTrailMyrtlePark,04/13/2017 10:00:00 AM,48,-122,5,13,18
28763,ElliotBayTrailMyrtlePark,04/13/2017 11:00:00 AM,48,-122,5,7,12
28764,ElliotBayTrailMyrtlePark,04/13/2017 12:00:00 PM,48,-122,15,15,30
28765,ElliotBayTrailMyrtlePark,04/13/2017 01:00:00 PM,48,-122,9,9,18
28766,ElliotBayTrailMyrtlePark,04/13/2017 02:00:00 PM,48,-122,13,11,24
28767,ElliotBayTrailMyrtlePark,04/13/2017 03:00:00 PM,48,-122,18,20,38
28768,ElliotBayTrailMyrtlePark,04/13/2017 04:00:00 PM,48,-122,44,19,63
28769,ElliotBayTrailMyrtlePark,04/13/2017 05:00:00 PM,48,-122,108,37,145
28770,ElliotBayTrailMyrtlePark,04/13/2017 06:00:00 PM,48,-122,43,22,65
28771,ElliotBayTrailMyrtlePark,04/13/2017 07:00:00 PM,48,-122,35,6,41
28772,ElliotBayTrailMyrtlePark,04/13/2017 08:00:00 PM,48,-122,11,3,14
28773,ElliotBayTrailMyrtlePark,04/13/2017 09:00:00 PM,48,-122,7,2,9
28774,ElliotBayTrailMyrtlePark,04/13/2017 10:00:00 PM,48,-122,7,2,9
28775,ElliotBayTrailMyrtlePark,04/13/2017 11:00:00 PM,48,-122,3,1,4
28776,ElliotBayTrailMyrtlePark,04/14/2017 12:00:00 AM,48,-122,0,1,1
28777,ElliotBayTrailMyrtlePark,04/14/2017 01:00:00 AM,48,-122,0,0,0
28778,ElliotBayTrailMyrtlePark,04/14/2017 02:00:00 AM,48,-122,0,0,0
28779,ElliotBayTrailMyrtlePark,04/14/2017 03:00:00 AM,48,-122,1,1,2
28780,ElliotBayTrailMyrtlePark,04/14/2017 04:00:00 AM,48,-122,0,1,1
28781,ElliotBayTrailMyrtlePark,04/14/2017 05:00:00 AM,48,-122,6,5,11
28782,ElliotBayTrailMyrtlePark,04/14/2017 06:00:00 AM,48,-122,7,14,21
28783,ElliotBayTrailMyrtlePark,04/14/2017 07:00:00 AM,48,-122,18,52,70
28784,ElliotBayTrailMyrtlePark,04/14/2017 08:00:00 AM,48,-122,36,93,129
28785,ElliotBayTrailMyrtlePark,04/14/2017 09:00:00 AM,48,-122,13,25,38
28786,ElliotBayTrailMyrtlePark,04/14/2017 10:00:00 AM,48,-122,14,12,26
28787,ElliotBayTrailMyrtlePark,04/14/2017 11:00:00 AM,48,-122,15,12,27
28788,ElliotBayTrailMyrtlePark,04/14/2017 12:00:00 PM,48,-122,16,14,30
28789,ElliotBayTrailMyrtlePark,04/14/2017 01:00:00 PM,48,-122,17,9,26
28790,ElliotBayTrailMyrtlePark,04/14/2017 02:00:00 PM,48,-122,17,17,34
28791,ElliotBayTrailMyrtlePark,04/14/2017 03:00:00 PM,48,-122,23,17,40
28792,ElliotBayTrailMyrtlePark,04/14/2017 04:00:00 PM,48,-122,57,36,93
28793,ElliotBayTrailMyrtlePark,04/14/2017 05:00:00 PM,48,-122,87,29,116
28794,ElliotBayTrailMyrtlePark,04/14/2017 06:00:00 PM,48,-122,56,24,80
28795,ElliotBayTrailMyrtlePark,04/14/2017 07:00:00 PM,48,-122,26,18,44
28796,ElliotBayTrailMyrtlePark,04/14/2017 08:00:00 PM,48,-122,13,10,23
28797,ElliotBayTrailMyrtlePark,04/14/2017 09:00:00 PM,48,-122,5,4,9
28798,ElliotBayTrailMyrtlePark,04/14/2017 10:00:00 PM,48,-122,2,5,7
28799,ElliotBayTrailMyrtlePark,04/14/2017 11:00:00 PM,48,-122,3,0,3
28800,ElliotBayTrailMyrtlePark,04/15/2017 12:00:00 AM,48,-122,3,1,4
28801,ElliotBayTrailMyrtlePark,04/15/2017 01:00:00 AM,48,-122,1,1,2
28802,ElliotBayTrailMyrtlePark,04/15/2017 02:00:00 AM,48,-122,0,0,0
28803,ElliotBayTrailMyrtlePark,04/15/2017 03:00:00 AM,48,-122,0,0,0
28804,ElliotBayTrailMyrtlePark,04/15/2017 04:00:00 AM,48,-122,0,0,0
28805,ElliotBayTrailMyrtlePark,04/15/2017 05:00:00 AM,48,-122,0,1,1
28806,ElliotBayTrailMyrtlePark,04/15/2017 06:00:00 AM,48,-122,2,3,5
28807,ElliotBayTrailMyrtlePark,04/15/2017 07:00:00 AM,48,-122,10,13,23
28808,ElliotBayTrailMyrtlePark,04/15/2017 08:00:00 AM,48,-122,27,15,42
28809,ElliotBayTrailMyrtlePark,04/15/2017 09:00:00 AM,48,-122,13,26,39
28810,ElliotBayTrailMyrtlePark,04/15/2017 10:00:00 AM,48,-122,30,38,68
28811,ElliotBayTrailMyrtlePark,04/15/2017 11:00:00 AM,48,-122,28,33,61
28812,ElliotBayTrailMyrtlePark,04/15/2017 12:00:00 PM,48,-122,54,48,102
28813,ElliotBayTrailMyrtlePark,04/15/2017 01:00:00 PM,48,-122,38,50,88
28814,ElliotBayTrailMyrtlePark,04/15/2017 02:00:00 PM,48,-122,66,58,124
28815,ElliotBayTrailMyrtlePark,04/15/2017 03:00:00 PM,48,-122,52,57,109
28816,ElliotBayTrailMyrtlePark,04/15/2017 04:00:00 PM,48,-122,57,44,101
28817,ElliotBayTrailMyrtlePark,04/15/2017 05:00:00 PM,48,-122,57,39,96
28818,ElliotBayTrailMyrtlePark,04/15/2017 06:00:00 PM,48,-122,43,33,76
28819,ElliotBayTrailMyrtlePark,04/15/2017 07:00:00 PM,48,-122,18,11,29
28820,ElliotBayTrailMyrtlePark,04/15/2017 08:00:00 PM,48,-122,9,15,24
28821,ElliotBayTrailMyrtlePark,04/15/2017 09:00:00 PM,48,-122,14,6,20
28822,ElliotBayTrailMyrtlePark,04/15/2017 10:00:00 PM,48,-122,12,2,14
28823,ElliotBayTrailMyrtlePark,04/15/2017 11:00:00 PM,48,-122,0,0,0
28824,ElliotBayTrailMyrtlePark,04/16/2017 12:00:00 AM,48,-122,4,1,5
28825,ElliotBayTrailMyrtlePark,04/16/2017 01:00:00 AM,48,-122,0,0,0
28826,ElliotBayTrailMyrtlePark,04/16/2017 02:00:00 AM,48,-122,0,0,0
28827,ElliotBayTrailMyrtlePark,04/16/2017 03:00:00 AM,48,-122,1,0,1
28828,ElliotBayTrailMyrtlePark,04/16/2017 04:00:00 AM,48,-122,0,1,1
28829,ElliotBayTrailMyrtlePark,04/16/2017 05:00:00 AM,48,-122,1,0,1
28830,ElliotBayTrailMyrtlePark,04/16/2017 06:00:00 AM,48,-122,3,3,6
28831,ElliotBayTrailMyrtlePark,04/16/2017 07:00:00 AM,48,-122,6,4,10
28832,ElliotBayTrailMyrtlePark,04/16/2017 08:00:00 AM,48,-122,6,13,19
28833,ElliotBayTrailMyrtlePark,04/16/2017 09:00:00 AM,48,-122,25,25,50
28834,ElliotBayTrailMyrtlePark,04/16/2017 10:00:00 AM,48,-122,49,44,93
28835,ElliotBayTrailMyrtlePark,04/16/2017 11:00:00 AM,48,-122,36,42,78
28836,ElliotBayTrailMyrtlePark,04/16/2017 12:00:00 PM,48,-122,47,38,85
28837,ElliotBayTrailMyrtlePark,04/16/2017 01:00:00 PM,48,-122,47,42,89
28838,ElliotBayTrailMyrtlePark,04/16/2017 02:00:00 PM,48,-122,46,49,95
28839,ElliotBayTrailMyrtlePark,04/16/2017 03:00:00 PM,48,-122,53,55,108
28840,ElliotBayTrailMyrtlePark,04/16/2017 04:00:00 PM,48,-122,44,47,91
28841,ElliotBayTrailMyrtlePark,04/16/2017 05:00:00 PM,48,-122,27,23,50
28842,ElliotBayTrailMyrtlePark,04/16/2017 06:00:00 PM,48,-122,23,22,45
28843,ElliotBayTrailMyrtlePark,04/16/2017 07:00:00 PM,48,-122,26,21,47
28844,ElliotBayTrailMyrtlePark,04/16/2017 08:00:00 PM,48,-122,12,2,14
28845,ElliotBayTrailMyrtlePark,04/16/2017 09:00:00 PM,48,-122,6,5,11
28846,ElliotBayTrailMyrtlePark,04/16/2017 10:00:00 PM,48,-122,2,1,3
28847,ElliotBayTrailMyrtlePark,04/16/2017 11:00:00 PM,48,-122,1,1,2
28848,ElliotBayTrailMyrtlePark,04/17/2017 12:00:00 AM,48,-122,2,0,2
28849,ElliotBayTrailMyrtlePark,04/17/2017 01:00:00 AM,48,-122,0,0,0
28850,ElliotBayTrailMyrtlePark,04/17/2017 02:00:00 AM,48,-122,0,0,0
28851,ElliotBayTrailMyrtlePark,04/17/2017 03:00:00 AM,48,-122,0,1,1
28852,ElliotBayTrailMyrtlePark,04/17/2017 04:00:00 AM,48,-122,3,2,5
28853,ElliotBayTrailMyrtlePark,04/17/2017 05:00:00 AM,48,-122,6,1,7
28854,ElliotBayTrailMyrtlePark,04/17/2017 06:00:00 AM,48,-122,15,25,40
28855,ElliotBayTrailMyrtlePark,04/17/2017 07:00:00 AM,48,-122,29,74,103
28856,ElliotBayTrailMyrtlePark,04/17/2017 08:00:00 AM,48,-122,32,117,149
28857,ElliotBayTrailMyrtlePark,04/17/2017 09:00:00 AM,48,-122,18,62,80
28858,ElliotBayTrailMyrtlePark,04/17/2017 10:00:00 AM,48,-122,6,20,26
28859,ElliotBayTrailMyrtlePark,04/17/2017 11:00:00 AM,48,-122,12,10,22
28860,ElliotBayTrailMyrtlePark,04/17/2017 12:00:00 PM,48,-122,11,7,18
28861,ElliotBayTrailMyrtlePark,04/17/2017 01:00:00 PM,48,-122,13,13,26
28862,ElliotBayTrailMyrtlePark,04/17/2017 02:00:00 PM,48,-122,11,16,27
28863,ElliotBayTrailMyrtlePark,04/17/2017 03:00:00 PM,48,-122,17,17,34
28864,ElliotBayTrailMyrtlePark,04/17/2017 04:00:00 PM,48,-122,47,25,72
28865,ElliotBayTrailMyrtlePark,04/17/2017 05:00:00 PM,48,-122,132,27,159
28866,ElliotBayTrailMyrtlePark,04/17/2017 06:00:00 PM,48,-122,82,14,96
28867,ElliotBayTrailMyrtlePark,04/17/2017 07:00:00 PM,48,-122,20,3,23
28868,ElliotBayTrailMyrtlePark,04/17/2017 08:00:00 PM,48,-122,8,5,13
28869,ElliotBayTrailMyrtlePark,04/17/2017 09:00:00 PM,48,-122,4,4,8
28870,ElliotBayTrailMyrtlePark,04/17/2017 10:00:00 PM,48,-122,3,2,5
28871,ElliotBayTrailMyrtlePark,04/17/2017 11:00:00 PM,48,-122,0,0,0
28872,ElliotBayTrailMyrtlePark,04/18/2017 12:00:00 AM,48,-122,3,0,3
28873,ElliotBayTrailMyrtlePark,04/18/2017 01:00:00 AM,48,-122,0,0,0
28874,ElliotBayTrailMyrtlePark,04/18/2017 02:00:00 AM,48,-122,1,0,1
28875,ElliotBayTrailMyrtlePark,04/18/2017 03:00:00 AM,48,-122,0,1,1
28876,ElliotBayTrailMyrtlePark,04/18/2017 04:00:00 AM,48,-122,0,1,1
28877,ElliotBayTrailMyrtlePark,04/18/2017 05:00:00 AM,48,-122,5,7,12
28878,ElliotBayTrailMyrtlePark,04/18/2017 06:00:00 AM,48,-122,13,25,38
28879,ElliotBayTrailMyrtlePark,04/18/2017 07:00:00 AM,48,-122,30,76,106
28880,ElliotBayTrailMyrtlePark,04/18/2017 08:00:00 AM,48,-122,30,103,133
28881,ElliotBayTrailMyrtlePark,04/18/2017 09:00:00 AM,48,-122,11,42,53
28882,ElliotBayTrailMyrtlePark,04/18/2017 10:00:00 AM,48,-122,12,19,31
28883,ElliotBayTrailMyrtlePark,04/18/2017 11:00:00 AM,48,-122,14,6,20
28884,ElliotBayTrailMyrtlePark,04/18/2017 12:00:00 PM,48,-122,9,10,19
28885,ElliotBayTrailMyrtlePark,04/18/2017 01:00:00 PM,48,-122,5,10,15
28886,ElliotBayTrailMyrtlePark,04/18/2017 02:00:00 PM,48,-122,17,14,31
28887,ElliotBayTrailMyrtlePark,04/18/2017 03:00:00 PM,48,-122,36,22,58
28888,ElliotBayTrailMyrtlePark,04/18/2017 04:00:00 PM,48,-122,59,24,83
28889,ElliotBayTrailMyrtlePark,04/18/2017 05:00:00 PM,48,-122,134,43,177
28890,ElliotBayTrailMyrtlePark,04/18/2017 06:00:00 PM,48,-122,75,28,103
28891,ElliotBayTrailMyrtlePark,04/18/2017 07:00:00 PM,48,-122,24,18,42
28892,ElliotBayTrailMyrtlePark,04/18/2017 08:00:00 PM,48,-122,12,7,19
28893,ElliotBayTrailMyrtlePark,04/18/2017 09:00:00 PM,48,-122,2,7,9
28894,ElliotBayTrailMyrtlePark,04/18/2017 10:00:00 PM,48,-122,5,3,8
28895,ElliotBayTrailMyrtlePark,04/18/2017 11:00:00 PM,48,-122,2,0,2
28896,ElliotBayTrailMyrtlePark,04/19/2017 12:00:00 AM,48,-122,1,1,2
28897,ElliotBayTrailMyrtlePark,04/19/2017 01:00:00 AM,48,-122,1,0,1
28898,ElliotBayTrailMyrtlePark,04/19/2017 02:00:00 AM,48,-122,1,0,1
28899,ElliotBayTrailMyrtlePark,04/19/2017 03:00:00 AM,48,-122,0,2,2
28900,ElliotBayTrailMyrtlePark,04/19/2017 04:00:00 AM,48,-122,1,0,1
28901,ElliotBayTrailMyrtlePark,04/19/2017 05:00:00 AM,48,-122,9,8,17
28902,ElliotBayTrailMyrtlePark,04/19/2017 06:00:00 AM,48,-122,12,27,39
28903,ElliotBayTrailMyrtlePark,04/19/2017 07:00:00 AM,48,-122,33,79,112
28904,ElliotBayTrailMyrtlePark,04/19/2017 08:00:00 AM,48,-122,28,119,147
28905,ElliotBayTrailMyrtlePark,04/19/2017 09:00:00 AM,48,-122,17,43,60
28906,ElliotBayTrailMyrtlePark,04/19/2017 10:00:00 AM,48,-122,3,15,18
28907,ElliotBayTrailMyrtlePark,04/19/2017 11:00:00 AM,48,-122,3,2,5
28908,ElliotBayTrailMyrtlePark,04/19/2017 12:00:00 PM,48,-122,7,1,8
28909,ElliotBayTrailMyrtlePark,04/19/2017 01:00:00 PM,48,-122,6,4,10
28910,ElliotBayTrailMyrtlePark,04/19/2017 02:00:00 PM,48,-122,10,8,18
28911,ElliotBayTrailMyrtlePark,04/19/2017 03:00:00 PM,48,-122,21,13,34
28912,ElliotBayTrailMyrtlePark,04/19/2017 04:00:00 PM,48,-122,49,23,72
28913,ElliotBayTrailMyrtlePark,04/19/2017 05:00:00 PM,48,-122,0,37,37
28914,ElliotBayTrailMyrtlePark,04/19/2017 06:00:00 PM,48,-122,78,26,104
28915,ElliotBayTrailMyrtlePark,04/19/2017 07:00:00 PM,48,-122,24,22,46
28916,ElliotBayTrailMyrtlePark,04/19/2017 08:00:00 PM,48,-122,12,10,22
28917,ElliotBayTrailMyrtlePark,04/19/2017 09:00:00 PM,48,-122,3,1,4
28918,ElliotBayTrailMyrtlePark,04/19/2017 10:00:00 PM,48,-122,1,1,2
28919,ElliotBayTrailMyrtlePark,04/19/2017 11:00:00 PM,48,-122,0,1,1
28920,ElliotBayTrailMyrtlePark,04/20/2017 12:00:00 AM,48,-122,2,0,2
28921,ElliotBayTrailMyrtlePark,04/20/2017 01:00:00 AM,48,-122,0,0,0
28922,ElliotBayTrailMyrtlePark,04/20/2017 02:00:00 AM,48,-122,0,0,0
28923,ElliotBayTrailMyrtlePark,04/20/2017 03:00:00 AM,48,-122,1,2,3
28924,ElliotBayTrailMyrtlePark,04/20/2017 04:00:00 AM,48,-122,0,1,1
28925,ElliotBayTrailMyrtlePark,04/20/2017 05:00:00 AM,48,-122,8,5,13
28926,ElliotBayTrailMyrtlePark,04/20/2017 06:00:00 AM,48,-122,21,17,38
28927,ElliotBayTrailMyrtlePark,04/20/2017 07:00:00 AM,48,-122,31,61,92
28928,ElliotBayTrailMyrtlePark,04/20/2017 08:00:00 AM,48,-122,31,108,139
28929,ElliotBayTrailMyrtlePark,04/20/2017 09:00:00 AM,48,-122,19,55,74
28930,ElliotBayTrailMyrtlePark,04/20/2017 10:00:00 AM,48,-122,6,20,26
28931,ElliotBayTrailMyrtlePark,04/20/2017 11:00:00 AM,48,-122,7,7,14
28932,ElliotBayTrailMyrtlePark,04/20/2017 12:00:00 PM,48,-122,16,21,37
28933,ElliotBayTrailMyrtlePark,04/20/2017 01:00:00 PM,48,-122,15,14,29
28934,ElliotBayTrailMyrtlePark,04/20/2017 02:00:00 PM,48,-122,26,16,42
28935,ElliotBayTrailMyrtlePark,04/20/2017 03:00:00 PM,48,-122,23,34,57
28936,ElliotBayTrailMyrtlePark,04/20/2017 04:00:00 PM,48,-122,55,33,88
28937,ElliotBayTrailMyrtlePark,04/20/2017 05:00:00 PM,48,-122,133,70,203
28938,ElliotBayTrailMyrtlePark,04/20/2017 06:00:00 PM,48,-122,108,33,141
28939,ElliotBayTrailMyrtlePark,04/20/2017 07:00:00 PM,48,-122,42,35,77
28940,ElliotBayTrailMyrtlePark,04/20/2017 08:00:00 PM,48,-122,14,9,23
28941,ElliotBayTrailMyrtlePark,04/20/2017 09:00:00 PM,48,-122,8,6,14
28942,ElliotBayTrailMyrtlePark,04/20/2017 10:00:00 PM,48,-122,1,0,1
28943,ElliotBayTrailMyrtlePark,04/20/2017 11:00:00 PM,48,-122,3,0,3
28944,ElliotBayTrailMyrtlePark,04/21/2017 12:00:00 AM,48,-122,0,1,1
28945,ElliotBayTrailMyrtlePark,04/21/2017 01:00:00 AM,48,-122,2,0,2
28946,ElliotBayTrailMyrtlePark,04/21/2017 02:00:00 AM,48,-122,2,1,3
28947,ElliotBayTrailMyrtlePark,04/21/2017 03:00:00 AM,48,-122,0,0,0
28948,ElliotBayTrailMyrtlePark,04/21/2017 04:00:00 AM,48,-122,0,2,2
28949,ElliotBayTrailMyrtlePark,04/21/2017 05:00:00 AM,48,-122,8,7,15
28950,ElliotBayTrailMyrtlePark,04/21/2017 06:00:00 AM,48,-122,17,37,54
28951,ElliotBayTrailMyrtlePark,04/21/2017 07:00:00 AM,48,-122,39,87,126
28952,ElliotBayTrailMyrtlePark,04/21/2017 08:00:00 AM,48,-122,36,142,178
28953,ElliotBayTrailMyrtlePark,04/21/2017 09:00:00 AM,48,-122,29,50,79
28954,ElliotBayTrailMyrtlePark,04/21/2017 10:00:00 AM,48,-122,18,23,41
28955,ElliotBayTrailMyrtlePark,04/21/2017 11:00:00 AM,48,-122,16,27,43
28956,ElliotBayTrailMyrtlePark,04/21/2017 12:00:00 PM,48,-122,49,22,71
28957,ElliotBayTrailMyrtlePark,04/21/2017 01:00:00 PM,48,-122,48,43,91
28958,ElliotBayTrailMyrtlePark,04/21/2017 02:00:00 PM,48,-122,65,53,118
28959,ElliotBayTrailMyrtlePark,04/21/2017 03:00:00 PM,48,-122,72,68,140
28960,ElliotBayTrailMyrtlePark,04/21/2017 04:00:00 PM,48,-122,165,83,248
28961,ElliotBayTrailMyrtlePark,04/21/2017 05:00:00 PM,48,-122,182,92,274
28962,ElliotBayTrailMyrtlePark,04/21/2017 06:00:00 PM,48,-122,136,40,176
28963,ElliotBayTrailMyrtlePark,04/21/2017 07:00:00 PM,48,-122,37,23,60
28964,ElliotBayTrailMyrtlePark,04/21/2017 08:00:00 PM,48,-122,11,10,21
28965,ElliotBayTrailMyrtlePark,04/21/2017 09:00:00 PM,48,-122,7,8,15
28966,ElliotBayTrailMyrtlePark,04/21/2017 10:00:00 PM,48,-122,1,2,3
28967,ElliotBayTrailMyrtlePark,04/21/2017 11:00:00 PM,48,-122,2,1,3
28968,ElliotBayTrailMyrtlePark,04/22/2017 12:00:00 AM,48,-122,2,3,5
28969,ElliotBayTrailMyrtlePark,04/22/2017 01:00:00 AM,48,-122,0,0,0
28970,ElliotBayTrailMyrtlePark,04/22/2017 02:00:00 AM,48,-122,0,0,0
28971,ElliotBayTrailMyrtlePark,04/22/2017 03:00:00 AM,48,-122,1,0,1
28972,ElliotBayTrailMyrtlePark,04/22/2017 04:00:00 AM,48,-122,0,0,0
28973,ElliotBayTrailMyrtlePark,04/22/2017 05:00:00 AM,48,-122,0,2,2
28974,ElliotBayTrailMyrtlePark,04/22/2017 06:00:00 AM,48,-122,3,2,5
28975,ElliotBayTrailMyrtlePark,04/22/2017 07:00:00 AM,48,-122,15,15,30
28976,ElliotBayTrailMyrtlePark,04/22/2017 08:00:00 AM,48,-122,17,11,28
28977,ElliotBayTrailMyrtlePark,04/22/2017 09:00:00 AM,48,-122,16,31,47
28978,ElliotBayTrailMyrtlePark,04/22/2017 10:00:00 AM,48,-122,20,20,40
28979,ElliotBayTrailMyrtlePark,04/22/2017 11:00:00 AM,48,-122,18,13,31
28980,ElliotBayTrailMyrtlePark,04/22/2017 12:00:00 PM,48,-122,15,9,24
28981,ElliotBayTrailMyrtlePark,04/22/2017 01:00:00 PM,48,-122,13,16,29
28982,ElliotBayTrailMyrtlePark,04/22/2017 02:00:00 PM,48,-122,16,10,26
28983,ElliotBayTrailMyrtlePark,04/22/2017 03:00:00 PM,48,-122,15,10,25
28984,ElliotBayTrailMyrtlePark,04/22/2017 04:00:00 PM,48,-122,13,21,34
28985,ElliotBayTrailMyrtlePark,04/22/2017 05:00:00 PM,48,-122,17,12,29
28986,ElliotBayTrailMyrtlePark,04/22/2017 06:00:00 PM,48,-122,17,10,27
28987,ElliotBayTrailMyrtlePark,04/22/2017 07:00:00 PM,48,-122,19,17,36
28988,ElliotBayTrailMyrtlePark,04/22/2017 08:00:00 PM,48,-122,4,7,11
28989,ElliotBayTrailMyrtlePark,04/22/2017 09:00:00 PM,48,-122,3,7,10
28990,ElliotBayTrailMyrtlePark,04/22/2017 10:00:00 PM,48,-122,2,0,2
28991,ElliotBayTrailMyrtlePark,04/22/2017 11:00:00 PM,48,-122,0,1,1
28992,ElliotBayTrailMyrtlePark,04/23/2017 12:00:00 AM,48,-122,1,0,1
28993,ElliotBayTrailMyrtlePark,04/23/2017 01:00:00 AM,48,-122,0,1,1
28994,ElliotBayTrailMyrtlePark,04/23/2017 02:00:00 AM,48,-122,0,0,0
28995,ElliotBayTrailMyrtlePark,04/23/2017 03:00:00 AM,48,-122,1,0,1
28996,ElliotBayTrailMyrtlePark,04/23/2017 04:00:00 AM,48,-122,0,0,0
28997,ElliotBayTrailMyrtlePark,04/23/2017 05:00:00 AM,48,-122,0,0,0
28998,ElliotBayTrailMyrtlePark,04/23/2017 06:00:00 AM,48,-122,2,7,9
28999,ElliotBayTrailMyrtlePark,04/23/2017 07:00:00 AM,48,-122,8,6,14
29000,ElliotBayTrailMyrtlePark,04/23/2017 08:00:00 AM,48,-122,27,8,35
29001,ElliotBayTrailMyrtlePark,04/23/2017 09:00:00 AM,48,-122,16,16,32
29002,ElliotBayTrailMyrtlePark,04/23/2017 10:00:00 AM,48,-122,23,32,55
29003,ElliotBayTrailMyrtlePark,04/23/2017 11:00:00 AM,48,-122,19,20,39
29004,ElliotBayTrailMyrtlePark,04/23/2017 12:00:00 PM,48,-122,11,12,23
29005,ElliotBayTrailMyrtlePark,04/23/2017 01:00:00 PM,48,-122,9,6,15
29006,ElliotBayTrailMyrtlePark,04/23/2017 02:00:00 PM,48,-122,17,8,25
29007,ElliotBayTrailMyrtlePark,04/23/2017 03:00:00 PM,48,-122,10,11,21
29008,ElliotBayTrailMyrtlePark,04/23/2017 04:00:00 PM,48,-122,11,2,13
29009,ElliotBayTrailMyrtlePark,04/23/2017 05:00:00 PM,48,-122,1,5,6
29010,ElliotBayTrailMyrtlePark,04/23/2017 06:00:00 PM,48,-122,2,6,8
29011,ElliotBayTrailMyrtlePark,04/23/2017 07:00:00 PM,48,-122,4,3,7
29012,ElliotBayTrailMyrtlePark,04/23/2017 08:00:00 PM,48,-122,1,0,1
29013,ElliotBayTrailMyrtlePark,04/23/2017 09:00:00 PM,48,-122,0,1,1
29014,ElliotBayTrailMyrtlePark,04/23/2017 10:00:00 PM,48,-122,1,2,3
29015,ElliotBayTrailMyrtlePark,04/23/2017 11:00:00 PM,48,-122,1,1,2
29016,ElliotBayTrailMyrtlePark,04/24/2017 12:00:00 AM,48,-122,0,0,0
29017,ElliotBayTrailMyrtlePark,04/24/2017 01:00:00 AM,48,-122,0,0,0
29018,ElliotBayTrailMyrtlePark,04/24/2017 02:00:00 AM,48,-122,0,0,0
29019,ElliotBayTrailMyrtlePark,04/24/2017 03:00:00 AM,48,-122,0,1,1
29020,ElliotBayTrailMyrtlePark,04/24/2017 04:00:00 AM,48,-122,0,2,2
29021,ElliotBayTrailMyrtlePark,04/24/2017 05:00:00 AM,48,-122,7,3,10
29022,ElliotBayTrailMyrtlePark,04/24/2017 06:00:00 AM,48,-122,15,31,46
29023,ElliotBayTrailMyrtlePark,04/24/2017 07:00:00 AM,48,-122,30,70,100
29024,ElliotBayTrailMyrtlePark,04/24/2017 08:00:00 AM,48,-122,38,133,171
29025,ElliotBayTrailMyrtlePark,04/24/2017 09:00:00 AM,48,-122,15,47,62
29026,ElliotBayTrailMyrtlePark,04/24/2017 10:00:00 AM,48,-122,11,15,26
29027,ElliotBayTrailMyrtlePark,04/24/2017 11:00:00 AM,48,-122,12,11,23
29028,ElliotBayTrailMyrtlePark,04/24/2017 12:00:00 PM,48,-122,15,6,21
29029,ElliotBayTrailMyrtlePark,04/24/2017 01:00:00 PM,48,-122,9,13,22
29030,ElliotBayTrailMyrtlePark,04/24/2017 02:00:00 PM,48,-122,13,10,23
29031,ElliotBayTrailMyrtlePark,04/24/2017 03:00:00 PM,48,-122,23,16,39
29032,ElliotBayTrailMyrtlePark,04/24/2017 04:00:00 PM,48,-122,65,38,103
29033,ElliotBayTrailMyrtlePark,04/24/2017 05:00:00 PM,48,-122,160,57,217
29034,ElliotBayTrailMyrtlePark,04/24/2017 06:00:00 PM,48,-122,102,32,134
29035,ElliotBayTrailMyrtlePark,04/24/2017 07:00:00 PM,48,-122,36,32,68
29036,ElliotBayTrailMyrtlePark,04/24/2017 08:00:00 PM,48,-122,18,17,35
29037,ElliotBayTrailMyrtlePark,04/24/2017 09:00:00 PM,48,-122,4,1,5
29038,ElliotBayTrailMyrtlePark,04/24/2017 10:00:00 PM,48,-122,2,0,2
29039,ElliotBayTrailMyrtlePark,04/24/2017 11:00:00 PM,48,-122,4,1,5
29040,ElliotBayTrailMyrtlePark,04/25/2017 12:00:00 AM,48,-122,2,0,2
29041,ElliotBayTrailMyrtlePark,04/25/2017 01:00:00 AM,48,-122,1,1,2
29042,ElliotBayTrailMyrtlePark,04/25/2017 02:00:00 AM,48,-122,1,0,1
29043,ElliotBayTrailMyrtlePark,04/25/2017 03:00:00 AM,48,-122,0,2,2
29044,ElliotBayTrailMyrtlePark,04/25/2017 04:00:00 AM,48,-122,4,4,8
29045,ElliotBayTrailMyrtlePark,04/25/2017 05:00:00 AM,48,-122,7,9,16
29046,ElliotBayTrailMyrtlePark,04/25/2017 06:00:00 AM,48,-122,18,26,44
29047,ElliotBayTrailMyrtlePark,04/25/2017 07:00:00 AM,48,-122,30,90,120
29048,ElliotBayTrailMyrtlePark,04/25/2017 08:00:00 AM,48,-122,38,117,155
29049,ElliotBayTrailMyrtlePark,04/25/2017 09:00:00 AM,48,-122,24,54,78
29050,ElliotBayTrailMyrtlePark,04/25/2017 10:00:00 AM,48,-122,12,22,34
29051,ElliotBayTrailMyrtlePark,04/25/2017 11:00:00 AM,48,-122,10,15,25
29052,ElliotBayTrailMyrtlePark,04/25/2017 12:00:00 PM,48,-122,18,16,34
29053,ElliotBayTrailMyrtlePark,04/25/2017 01:00:00 PM,48,-122,24,13,37
29054,ElliotBayTrailMyrtlePark,04/25/2017 02:00:00 PM,48,-122,14,10,24
29055,ElliotBayTrailMyrtlePark,04/25/2017 03:00:00 PM,48,-122,28,19,47
29056,ElliotBayTrailMyrtlePark,04/25/2017 04:00:00 PM,48,-122,66,32,98
29057,ElliotBayTrailMyrtlePark,04/25/2017 05:00:00 PM,48,-122,148,56,204
29058,ElliotBayTrailMyrtlePark,04/25/2017 06:00:00 PM,48,-122,90,20,110
29059,ElliotBayTrailMyrtlePark,04/25/2017 07:00:00 PM,48,-122,30,5,35
29060,ElliotBayTrailMyrtlePark,04/25/2017 08:00:00 PM,48,-122,7,4,11
29061,ElliotBayTrailMyrtlePark,04/25/2017 09:00:00 PM,48,-122,3,4,7
29062,ElliotBayTrailMyrtlePark,04/25/2017 10:00:00 PM,48,-122,2,0,2
29063,ElliotBayTrailMyrtlePark,04/25/2017 11:00:00 PM,48,-122,3,0,3
29064,ElliotBayTrailMyrtlePark,04/26/2017 12:00:00 AM,48,-122,2,1,3
29065,ElliotBayTrailMyrtlePark,04/26/2017 01:00:00 AM,48,-122,2,0,2
29066,ElliotBayTrailMyrtlePark,04/26/2017 02:00:00 AM,48,-122,2,0,2
29067,ElliotBayTrailMyrtlePark,04/26/2017 03:00:00 AM,48,-122,2,1,3
29068,ElliotBayTrailMyrtlePark,04/26/2017 04:00:00 AM,48,-122,4,6,10
29069,ElliotBayTrailMyrtlePark,04/26/2017 05:00:00 AM,48,-122,5,9,14
29070,ElliotBayTrailMyrtlePark,04/26/2017 06:00:00 AM,48,-122,15,22,37
29071,ElliotBayTrailMyrtlePark,04/26/2017 07:00:00 AM,48,-122,28,77,105
29072,ElliotBayTrailMyrtlePark,04/26/2017 08:00:00 AM,48,-122,33,106,139
29073,ElliotBayTrailMyrtlePark,04/26/2017 09:00:00 AM,48,-122,22,45,67
29074,ElliotBayTrailMyrtlePark,04/26/2017 10:00:00 AM,48,-122,5,26,31
29075,ElliotBayTrailMyrtlePark,04/26/2017 11:00:00 AM,48,-122,10,13,23
29076,ElliotBayTrailMyrtlePark,04/26/2017 12:00:00 PM,48,-122,12,16,28
29077,ElliotBayTrailMyrtlePark,04/26/2017 01:00:00 PM,48,-122,9,9,18
29078,ElliotBayTrailMyrtlePark,04/26/2017 02:00:00 PM,48,-122,9,11,20
29079,ElliotBayTrailMyrtlePark,04/26/2017 03:00:00 PM,48,-122,15,10,25
29080,ElliotBayTrailMyrtlePark,04/26/2017 04:00:00 PM,48,-122,53,32,85
29081,ElliotBayTrailMyrtlePark,04/26/2017 05:00:00 PM,48,-122,125,32,157
29082,ElliotBayTrailMyrtlePark,04/26/2017 06:00:00 PM,48,-122,60,17,77
29083,ElliotBayTrailMyrtlePark,04/26/2017 07:00:00 PM,48,-122,28,15,43
29084,ElliotBayTrailMyrtlePark,04/26/2017 08:00:00 PM,48,-122,12,4,16
29085,ElliotBayTrailMyrtlePark,04/26/2017 09:00:00 PM,48,-122,4,7,11
29086,ElliotBayTrailMyrtlePark,04/26/2017 10:00:00 PM,48,-122,5,2,7
29087,ElliotBayTrailMyrtlePark,04/26/2017 11:00:00 PM,48,-122,0,1,1
29088,ElliotBayTrailMyrtlePark,04/27/2017 12:00:00 AM,48,-122,0,0,0
29089,ElliotBayTrailMyrtlePark,04/27/2017 01:00:00 AM,48,-122,0,0,0
29090,ElliotBayTrailMyrtlePark,04/27/2017 02:00:00 AM,48,-122,1,0,1
29091,ElliotBayTrailMyrtlePark,04/27/2017 03:00:00 AM,48,-122,0,1,1
29092,ElliotBayTrailMyrtlePark,04/27/2017 04:00:00 AM,48,-122,0,1,1
29093,ElliotBayTrailMyrtlePark,04/27/2017 05:00:00 AM,48,-122,5,6,11
29094,ElliotBayTrailMyrtlePark,04/27/2017 06:00:00 AM,48,-122,18,30,48
29095,ElliotBayTrailMyrtlePark,04/27/2017 07:00:00 AM,48,-122,33,73,106
29096,ElliotBayTrailMyrtlePark,04/27/2017 08:00:00 AM,48,-122,29,110,139
29097,ElliotBayTrailMyrtlePark,04/27/2017 09:00:00 AM,48,-122,23,54,77
29098,ElliotBayTrailMyrtlePark,04/27/2017 10:00:00 AM,48,-122,10,18,28
29099,ElliotBayTrailMyrtlePark,04/27/2017 11:00:00 AM,48,-122,18,17,35
29100,ElliotBayTrailMyrtlePark,04/27/2017 12:00:00 PM,48,-122,20,19,39
29101,ElliotBayTrailMyrtlePark,04/27/2017 01:00:00 PM,48,-122,18,19,37
29102,ElliotBayTrailMyrtlePark,04/27/2017 02:00:00 PM,48,-122,17,34,51
29103,ElliotBayTrailMyrtlePark,04/27/2017 03:00:00 PM,48,-122,37,20,57
29104,ElliotBayTrailMyrtlePark,04/27/2017 04:00:00 PM,48,-122,78,38,116
29105,ElliotBayTrailMyrtlePark,04/27/2017 05:00:00 PM,48,-122,126,45,171
29106,ElliotBayTrailMyrtlePark,04/27/2017 06:00:00 PM,48,-122,84,34,118
29107,ElliotBayTrailMyrtlePark,04/27/2017 07:00:00 PM,48,-122,36,18,54
29108,ElliotBayTrailMyrtlePark,04/27/2017 08:00:00 PM,48,-122,11,1,12
29109,ElliotBayTrailMyrtlePark,04/27/2017 09:00:00 PM,48,-122,8,3,11
29110,ElliotBayTrailMyrtlePark,04/27/2017 10:00:00 PM,48,-122,2,1,3
29111,ElliotBayTrailMyrtlePark,04/27/2017 11:00:00 PM,48,-122,0,0,0
29112,ElliotBayTrailMyrtlePark,04/28/2017 12:00:00 AM,48,-122,0,0,0
29113,ElliotBayTrailMyrtlePark,04/28/2017 01:00:00 AM,48,-122,0,0,0
29114,ElliotBayTrailMyrtlePark,04/28/2017 02:00:00 AM,48,-122,1,0,1
29115,ElliotBayTrailMyrtlePark,04/28/2017 03:00:00 AM,48,-122,0,0,0
29116,ElliotBayTrailMyrtlePark,04/28/2017 04:00:00 AM,48,-122,2,3,5
29117,ElliotBayTrailMyrtlePark,04/28/2017 05:00:00 AM,48,-122,9,8,17
29118,ElliotBayTrailMyrtlePark,04/28/2017 06:00:00 AM,48,-122,14,23,37
29119,ElliotBayTrailMyrtlePark,04/28/2017 07:00:00 AM,48,-122,34,69,103
29120,ElliotBayTrailMyrtlePark,04/28/2017 08:00:00 AM,48,-122,38,133,171
29121,ElliotBayTrailMyrtlePark,04/28/2017 09:00:00 AM,48,-122,14,49,63
29122,ElliotBayTrailMyrtlePark,04/28/2017 10:00:00 AM,48,-122,17,20,37
29123,ElliotBayTrailMyrtlePark,04/28/2017 11:00:00 AM,48,-122,17,11,28
29124,ElliotBayTrailMyrtlePark,04/28/2017 12:00:00 PM,48,-122,17,19,36
29125,ElliotBayTrailMyrtlePark,04/28/2017 01:00:00 PM,48,-122,35,20,55
29126,ElliotBayTrailMyrtlePark,04/28/2017 02:00:00 PM,48,-122,48,32,80
29127,ElliotBayTrailMyrtlePark,04/28/2017 03:00:00 PM,48,-122,52,40,92
29128,ElliotBayTrailMyrtlePark,04/28/2017 04:00:00 PM,48,-122,96,54,150
29129,ElliotBayTrailMyrtlePark,04/28/2017 05:00:00 PM,48,-122,141,70,211
29130,ElliotBayTrailMyrtlePark,04/28/2017 06:00:00 PM,48,-122,69,33,102
29131,ElliotBayTrailMyrtlePark,04/28/2017 07:00:00 PM,48,-122,39,22,61
29132,ElliotBayTrailMyrtlePark,04/28/2017 08:00:00 PM,48,-122,11,7,18
29133,ElliotBayTrailMyrtlePark,04/28/2017 09:00:00 PM,48,-122,6,5,11
29134,ElliotBayTrailMyrtlePark,04/28/2017 10:00:00 PM,48,-122,4,3,7
29135,ElliotBayTrailMyrtlePark,04/28/2017 11:00:00 PM,48,-122,0,1,1
29136,ElliotBayTrailMyrtlePark,04/29/2017 12:00:00 AM,48,-122,2,1,3
29137,ElliotBayTrailMyrtlePark,04/29/2017 01:00:00 AM,48,-122,1,0,1
29138,ElliotBayTrailMyrtlePark,04/29/2017 02:00:00 AM,48,-122,0,1,1
29139,ElliotBayTrailMyrtlePark,04/29/2017 03:00:00 AM,48,-122,1,0,1
29140,ElliotBayTrailMyrtlePark,04/29/2017 04:00:00 AM,48,-122,0,0,0
29141,ElliotBayTrailMyrtlePark,04/29/2017 05:00:00 AM,48,-122,1,2,3
29142,ElliotBayTrailMyrtlePark,04/29/2017 06:00:00 AM,48,-122,0,6,6
29143,ElliotBayTrailMyrtlePark,04/29/2017 07:00:00 AM,48,-122,13,9,22
29144,ElliotBayTrailMyrtlePark,04/29/2017 08:00:00 AM,48,-122,13,25,38
29145,ElliotBayTrailMyrtlePark,04/29/2017 09:00:00 AM,48,-122,19,43,62
29146,ElliotBayTrailMyrtlePark,04/29/2017 10:00:00 AM,48,-122,21,28,49
29147,ElliotBayTrailMyrtlePark,04/29/2017 11:00:00 AM,48,-122,52,47,99
29148,ElliotBayTrailMyrtlePark,04/29/2017 12:00:00 PM,48,-122,62,44,106
29149,ElliotBayTrailMyrtlePark,04/29/2017 01:00:00 PM,48,-122,45,41,86
29150,ElliotBayTrailMyrtlePark,04/29/2017 02:00:00 PM,48,-122,33,44,77
29151,ElliotBayTrailMyrtlePark,04/29/2017 03:00:00 PM,48,-122,46,24,70
29152,ElliotBayTrailMyrtlePark,04/29/2017 04:00:00 PM,48,-122,22,20,42
29153,ElliotBayTrailMyrtlePark,04/29/2017 05:00:00 PM,48,-122,20,16,36
29154,ElliotBayTrailMyrtlePark,04/29/2017 06:00:00 PM,48,-122,19,29,48
29155,ElliotBayTrailMyrtlePark,04/29/2017 07:00:00 PM,48,-122,3,9,12
29156,ElliotBayTrailMyrtlePark,04/29/2017 08:00:00 PM,48,-122,1,3,4
29157,ElliotBayTrailMyrtlePark,04/29/2017 09:00:00 PM,48,-122,11,0,11
29158,ElliotBayTrailMyrtlePark,04/29/2017 10:00:00 PM,48,-122,5,0,5
29159,ElliotBayTrailMyrtlePark,04/29/2017 11:00:00 PM,48,-122,2,2,4
29160,ElliotBayTrailMyrtlePark,04/30/2017 12:00:00 AM,48,-122,0,1,1
29161,ElliotBayTrailMyrtlePark,04/30/2017 01:00:00 AM,48,-122,0,0,0
29162,ElliotBayTrailMyrtlePark,04/30/2017 02:00:00 AM,48,-122,0,0,0
29163,ElliotBayTrailMyrtlePark,04/30/2017 03:00:00 AM,48,-122,0,0,0
29164,ElliotBayTrailMyrtlePark,04/30/2017 04:00:00 AM,48,-122,0,0,0
29165,ElliotBayTrailMyrtlePark,04/30/2017 05:00:00 AM,48,-122,3,1,4
29166,ElliotBayTrailMyrtlePark,04/30/2017 06:00:00 AM,48,-122,1,5,6
29167,ElliotBayTrailMyrtlePark,04/30/2017 07:00:00 AM,48,-122,10,14,24
29168,ElliotBayTrailMyrtlePark,04/30/2017 08:00:00 AM,48,-122,12,9,21
29169,ElliotBayTrailMyrtlePark,04/30/2017 09:00:00 AM,48,-122,12,15,27
29170,ElliotBayTrailMyrtlePark,04/30/2017 10:00:00 AM,48,-122,20,20,40
29171,ElliotBayTrailMyrtlePark,04/30/2017 11:00:00 AM,48,-122,30,19,49
29172,ElliotBayTrailMyrtlePark,04/30/2017 12:00:00 PM,48,-122,46,46,92
29173,ElliotBayTrailMyrtlePark,04/30/2017 01:00:00 PM,48,-122,58,44,102
29174,ElliotBayTrailMyrtlePark,04/30/2017 02:00:00 PM,48,-122,63,46,109
29175,ElliotBayTrailMyrtlePark,04/30/2017 03:00:00 PM,48,-122,42,36,78
29176,ElliotBayTrailMyrtlePark,04/30/2017 04:00:00 PM,48,-122,34,34,68
29177,ElliotBayTrailMyrtlePark,04/30/2017 05:00:00 PM,48,-122,30,31,61
29178,ElliotBayTrailMyrtlePark,04/30/2017 06:00:00 PM,48,-122,23,21,44
29179,ElliotBayTrailMyrtlePark,04/30/2017 07:00:00 PM,48,-122,14,14,28
29180,ElliotBayTrailMyrtlePark,04/30/2017 08:00:00 PM,48,-122,6,4,10
29181,ElliotBayTrailMyrtlePark,04/30/2017 09:00:00 PM,48,-122,4,2,6
29182,ElliotBayTrailMyrtlePark,04/30/2017 10:00:00 PM,48,-122,2,1,3
29183,ElliotBayTrailMyrtlePark,04/30/2017 11:00:00 PM,48,-122,3,1,4
29184,ElliotBayTrailMyrtlePark,05/01/2017 12:00:00 AM,48,-122,0,0,0
29185,ElliotBayTrailMyrtlePark,05/01/2017 01:00:00 AM,48,-122,1,0,1
29186,ElliotBayTrailMyrtlePark,05/01/2017 02:00:00 AM,48,-122,0,0,0
29187,ElliotBayTrailMyrtlePark,05/01/2017 03:00:00 AM,48,-122,0,1,1
29188,ElliotBayTrailMyrtlePark,05/01/2017 04:00:00 AM,48,-122,0,1,1
29189,ElliotBayTrailMyrtlePark,05/01/2017 05:00:00 AM,48,-122,8,11,19
29190,ElliotBayTrailMyrtlePark,05/01/2017 06:00:00 AM,48,-122,28,37,65
29191,ElliotBayTrailMyrtlePark,05/01/2017 07:00:00 AM,48,-122,40,108,148
29192,ElliotBayTrailMyrtlePark,05/01/2017 08:00:00 AM,48,-122,39,164,203
29193,ElliotBayTrailMyrtlePark,05/01/2017 09:00:00 AM,48,-122,17,51,68
29194,ElliotBayTrailMyrtlePark,05/01/2017 10:00:00 AM,48,-122,13,17,30
29195,ElliotBayTrailMyrtlePark,05/01/2017 11:00:00 AM,48,-122,3,7,10
29196,ElliotBayTrailMyrtlePark,05/01/2017 12:00:00 PM,48,-122,10,5,15
29197,ElliotBayTrailMyrtlePark,05/01/2017 01:00:00 PM,48,-122,11,6,17
29198,ElliotBayTrailMyrtlePark,05/01/2017 02:00:00 PM,48,-122,17,20,37
29199,ElliotBayTrailMyrtlePark,05/01/2017 03:00:00 PM,48,-122,47,24,71
29200,ElliotBayTrailMyrtlePark,05/01/2017 04:00:00 PM,48,-122,93,47,140
29201,ElliotBayTrailMyrtlePark,05/01/2017 05:00:00 PM,48,-122,177,50,227
29202,ElliotBayTrailMyrtlePark,05/01/2017 06:00:00 PM,48,-122,88,19,107
29203,ElliotBayTrailMyrtlePark,05/01/2017 07:00:00 PM,48,-122,21,11,32
29204,ElliotBayTrailMyrtlePark,05/01/2017 08:00:00 PM,48,-122,9,7,16
29205,ElliotBayTrailMyrtlePark,05/01/2017 09:00:00 PM,48,-122,4,1,5
29206,ElliotBayTrailMyrtlePark,05/01/2017 10:00:00 PM,48,-122,5,1,6
29207,ElliotBayTrailMyrtlePark,05/01/2017 11:00:00 PM,48,-122,0,1,1
29208,ElliotBayTrailMyrtlePark,05/02/2017 12:00:00 AM,48,-122,0,0,0
29209,ElliotBayTrailMyrtlePark,05/02/2017 01:00:00 AM,48,-122,2,0,2
29210,ElliotBayTrailMyrtlePark,05/02/2017 02:00:00 AM,48,-122,1,0,1
29211,ElliotBayTrailMyrtlePark,05/02/2017 03:00:00 AM,48,-122,0,1,1
29212,ElliotBayTrailMyrtlePark,05/02/2017 04:00:00 AM,48,-122,1,2,3
29213,ElliotBayTrailMyrtlePark,05/02/2017 05:00:00 AM,48,-122,6,14,20
29214,ElliotBayTrailMyrtlePark,05/02/2017 06:00:00 AM,48,-122,18,43,61
29215,ElliotBayTrailMyrtlePark,05/02/2017 07:00:00 AM,48,-122,32,134,166
29216,ElliotBayTrailMyrtlePark,05/02/2017 08:00:00 AM,48,-122,38,148,186
29217,ElliotBayTrailMyrtlePark,05/02/2017 09:00:00 AM,48,-122,24,58,82
29218,ElliotBayTrailMyrtlePark,05/02/2017 10:00:00 AM,48,-122,16,24,40
29219,ElliotBayTrailMyrtlePark,05/02/2017 11:00:00 AM,48,-122,23,19,42
29220,ElliotBayTrailMyrtlePark,05/02/2017 12:00:00 PM,48,-122,21,20,41
29221,ElliotBayTrailMyrtlePark,05/02/2017 01:00:00 PM,48,-122,15,19,34
29222,ElliotBayTrailMyrtlePark,05/02/2017 02:00:00 PM,48,-122,13,17,30
29223,ElliotBayTrailMyrtlePark,05/02/2017 03:00:00 PM,48,-122,33,34,67
29224,ElliotBayTrailMyrtlePark,05/02/2017 04:00:00 PM,48,-122,90,32,122
29225,ElliotBayTrailMyrtlePark,05/02/2017 05:00:00 PM,48,-122,186,58,244
29226,ElliotBayTrailMyrtlePark,05/02/2017 06:00:00 PM,48,-122,113,33,146
29227,ElliotBayTrailMyrtlePark,05/02/2017 07:00:00 PM,48,-122,31,7,38
29228,ElliotBayTrailMyrtlePark,05/02/2017 08:00:00 PM,48,-122,8,7,15
29229,ElliotBayTrailMyrtlePark,05/02/2017 09:00:00 PM,48,-122,10,2,12
29230,ElliotBayTrailMyrtlePark,05/02/2017 10:00:00 PM,48,-122,11,0,11
29231,ElliotBayTrailMyrtlePark,05/02/2017 11:00:00 PM,48,-122,2,1,3
29232,ElliotBayTrailMyrtlePark,05/03/2017 12:00:00 AM,48,-122,1,0,1
29233,ElliotBayTrailMyrtlePark,05/03/2017 01:00:00 AM,48,-122,1,0,1
29234,ElliotBayTrailMyrtlePark,05/03/2017 02:00:00 AM,48,-122,1,0,1
29235,ElliotBayTrailMyrtlePark,05/03/2017 03:00:00 AM,48,-122,0,1,1
29236,ElliotBayTrailMyrtlePark,05/03/2017 04:00:00 AM,48,-122,0,3,3
29237,ElliotBayTrailMyrtlePark,05/03/2017 05:00:00 AM,48,-122,8,6,14
29238,ElliotBayTrailMyrtlePark,05/03/2017 06:00:00 AM,48,-122,25,26,51
29239,ElliotBayTrailMyrtlePark,05/03/2017 07:00:00 AM,48,-122,30,127,157
29240,ElliotBayTrailMyrtlePark,05/03/2017 08:00:00 AM,48,-122,43,179,222
29241,ElliotBayTrailMyrtlePark,05/03/2017 09:00:00 AM,48,-122,23,60,83
29242,ElliotBayTrailMyrtlePark,05/03/2017 10:00:00 AM,48,-122,7,23,30
29243,ElliotBayTrailMyrtlePark,05/03/2017 11:00:00 AM,48,-122,17,9,26
29244,ElliotBayTrailMyrtlePark,05/03/2017 12:00:00 PM,48,-122,24,20,44
29245,ElliotBayTrailMyrtlePark,05/03/2017 01:00:00 PM,48,-122,28,20,48
29246,ElliotBayTrailMyrtlePark,05/03/2017 02:00:00 PM,48,-122,45,33,78
29247,ElliotBayTrailMyrtlePark,05/03/2017 03:00:00 PM,48,-122,51,48,99
29248,ElliotBayTrailMyrtlePark,05/03/2017 04:00:00 PM,48,-122,136,79,215
29249,ElliotBayTrailMyrtlePark,05/03/2017 05:00:00 PM,48,-122,255,103,358
29250,ElliotBayTrailMyrtlePark,05/03/2017 06:00:00 PM,48,-122,171,76,247
29251,ElliotBayTrailMyrtlePark,05/03/2017 07:00:00 PM,48,-122,89,67,156
29252,ElliotBayTrailMyrtlePark,05/03/2017 08:00:00 PM,48,-122,44,37,81
29253,ElliotBayTrailMyrtlePark,05/03/2017 09:00:00 PM,48,-122,10,7,17
29254,ElliotBayTrailMyrtlePark,05/03/2017 10:00:00 PM,48,-122,14,8,22
29255,ElliotBayTrailMyrtlePark,05/03/2017 11:00:00 PM,48,-122,0,0,0
29256,ElliotBayTrailMyrtlePark,05/04/2017 12:00:00 AM,48,-122,1,0,1
29257,ElliotBayTrailMyrtlePark,05/04/2017 01:00:00 AM,48,-122,1,1,2
29258,ElliotBayTrailMyrtlePark,05/04/2017 02:00:00 AM,48,-122,3,0,3
29259,ElliotBayTrailMyrtlePark,05/04/2017 03:00:00 AM,48,-122,1,3,4
29260,ElliotBayTrailMyrtlePark,05/04/2017 04:00:00 AM,48,-122,0,1,1
29261,ElliotBayTrailMyrtlePark,05/04/2017 05:00:00 AM,48,-122,6,13,19
29262,ElliotBayTrailMyrtlePark,05/04/2017 06:00:00 AM,48,-122,28,49,77
29263,ElliotBayTrailMyrtlePark,05/04/2017 07:00:00 AM,48,-122,41,128,169
29264,ElliotBayTrailMyrtlePark,05/04/2017 08:00:00 AM,48,-122,36,152,188
29265,ElliotBayTrailMyrtlePark,05/04/2017 09:00:00 AM,48,-122,25,61,86
29266,ElliotBayTrailMyrtlePark,05/04/2017 10:00:00 AM,48,-122,24,33,57
29267,ElliotBayTrailMyrtlePark,05/04/2017 11:00:00 AM,48,-122,27,32,59
29268,ElliotBayTrailMyrtlePark,05/04/2017 12:00:00 PM,48,-122,28,20,48
29269,ElliotBayTrailMyrtlePark,05/04/2017 01:00:00 PM,48,-122,44,38,82
29270,ElliotBayTrailMyrtlePark,05/04/2017 02:00:00 PM,48,-122,46,33,79
29271,ElliotBayTrailMyrtlePark,05/04/2017 03:00:00 PM,48,-122,69,56,125
29272,ElliotBayTrailMyrtlePark,05/04/2017 04:00:00 PM,48,-122,84,36,120
29273,ElliotBayTrailMyrtlePark,05/04/2017 05:00:00 PM,48,-122,117,40,157
29274,ElliotBayTrailMyrtlePark,05/04/2017 06:00:00 PM,48,-122,64,9,73
29275,ElliotBayTrailMyrtlePark,05/04/2017 07:00:00 PM,48,-122,61,8,69
29276,ElliotBayTrailMyrtlePark,05/04/2017 08:00:00 PM,48,-122,18,10,28
29277,ElliotBayTrailMyrtlePark,05/04/2017 09:00:00 PM,48,-122,3,11,14
29278,ElliotBayTrailMyrtlePark,05/04/2017 10:00:00 PM,48,-122,7,0,7
29279,ElliotBayTrailMyrtlePark,05/04/2017 11:00:00 PM,48,-122,1,3,4
29280,ElliotBayTrailMyrtlePark,05/05/2017 12:00:00 AM,48,-122,1,1,2
29281,ElliotBayTrailMyrtlePark,05/05/2017 01:00:00 AM,48,-122,1,2,3
29282,ElliotBayTrailMyrtlePark,05/05/2017 02:00:00 AM,48,-122,0,1,1
29283,ElliotBayTrailMyrtlePark,05/05/2017 03:00:00 AM,48,-122,1,0,1
29284,ElliotBayTrailMyrtlePark,05/05/2017 04:00:00 AM,48,-122,0,1,1
29285,ElliotBayTrailMyrtlePark,05/05/2017 05:00:00 AM,48,-122,6,7,13
29286,ElliotBayTrailMyrtlePark,05/05/2017 06:00:00 AM,48,-122,12,23,35
29287,ElliotBayTrailMyrtlePark,05/05/2017 07:00:00 AM,48,-122,34,79,113
29288,ElliotBayTrailMyrtlePark,05/05/2017 08:00:00 AM,48,-122,35,115,150
29289,ElliotBayTrailMyrtlePark,05/05/2017 09:00:00 AM,48,-122,14,36,50
29290,ElliotBayTrailMyrtlePark,05/05/2017 10:00:00 AM,48,-122,10,10,20
29291,ElliotBayTrailMyrtlePark,05/05/2017 11:00:00 AM,48,-122,34,10,44
29292,ElliotBayTrailMyrtlePark,05/05/2017 12:00:00 PM,48,-122,7,8,15
29293,ElliotBayTrailMyrtlePark,05/05/2017 01:00:00 PM,48,-122,12,19,31
29294,ElliotBayTrailMyrtlePark,05/05/2017 02:00:00 PM,48,-122,29,20,49
29295,ElliotBayTrailMyrtlePark,05/05/2017 03:00:00 PM,48,-122,25,23,48
29296,ElliotBayTrailMyrtlePark,05/05/2017 04:00:00 PM,48,-122,93,34,127
29297,ElliotBayTrailMyrtlePark,05/05/2017 05:00:00 PM,48,-122,130,54,184
29298,ElliotBayTrailMyrtlePark,05/05/2017 06:00:00 PM,48,-122,82,29,111
29299,ElliotBayTrailMyrtlePark,05/05/2017 07:00:00 PM,48,-122,29,5,34
29300,ElliotBayTrailMyrtlePark,05/05/2017 08:00:00 PM,48,-122,14,11,25
29301,ElliotBayTrailMyrtlePark,05/05/2017 09:00:00 PM,48,-122,3,6,9
29302,ElliotBayTrailMyrtlePark,05/05/2017 10:00:00 PM,48,-122,2,3,5
29303,ElliotBayTrailMyrtlePark,05/05/2017 11:00:00 PM,48,-122,0,0,0
29304,ElliotBayTrailMyrtlePark,05/06/2017 12:00:00 AM,48,-122,6,0,6
29305,ElliotBayTrailMyrtlePark,05/06/2017 01:00:00 AM,48,-122,1,0,1
29306,ElliotBayTrailMyrtlePark,05/06/2017 02:00:00 AM,48,-122,0,0,0
29307,ElliotBayTrailMyrtlePark,05/06/2017 03:00:00 AM,48,-122,0,0,0
29308,ElliotBayTrailMyrtlePark,05/06/2017 04:00:00 AM,48,-122,0,0,0
29309,ElliotBayTrailMyrtlePark,05/06/2017 05:00:00 AM,48,-122,2,2,4
29310,ElliotBayTrailMyrtlePark,05/06/2017 06:00:00 AM,48,-122,2,7,9
29311,ElliotBayTrailMyrtlePark,05/06/2017 07:00:00 AM,48,-122,13,9,22
29312,ElliotBayTrailMyrtlePark,05/06/2017 08:00:00 AM,48,-122,12,24,36
29313,ElliotBayTrailMyrtlePark,05/06/2017 09:00:00 AM,48,-122,30,34,64
29314,ElliotBayTrailMyrtlePark,05/06/2017 10:00:00 AM,48,-122,36,38,74
29315,ElliotBayTrailMyrtlePark,05/06/2017 11:00:00 AM,48,-122,40,80,120
29316,ElliotBayTrailMyrtlePark,05/06/2017 12:00:00 PM,48,-122,47,34,81
29317,ElliotBayTrailMyrtlePark,05/06/2017 01:00:00 PM,48,-122,34,59,93
29318,ElliotBayTrailMyrtlePark,05/06/2017 02:00:00 PM,48,-122,147,92,239
29319,ElliotBayTrailMyrtlePark,05/06/2017 03:00:00 PM,48,-122,90,67,157
29320,ElliotBayTrailMyrtlePark,05/06/2017 04:00:00 PM,48,-122,65,55,120
29321,ElliotBayTrailMyrtlePark,05/06/2017 05:00:00 PM,48,-122,46,45,91
29322,ElliotBayTrailMyrtlePark,05/06/2017 06:00:00 PM,48,-122,27,37,64
29323,ElliotBayTrailMyrtlePark,05/06/2017 07:00:00 PM,48,-122,27,27,54
29324,ElliotBayTrailMyrtlePark,05/06/2017 08:00:00 PM,48,-122,9,9,18
29325,ElliotBayTrailMyrtlePark,05/06/2017 09:00:00 PM,48,-122,6,9,15
29326,ElliotBayTrailMyrtlePark,05/06/2017 10:00:00 PM,48,-122,4,1,5
29327,ElliotBayTrailMyrtlePark,05/06/2017 11:00:00 PM,48,-122,3,1,4
29328,ElliotBayTrailMyrtlePark,05/07/2017 12:00:00 AM,48,-122,0,3,3
29329,ElliotBayTrailMyrtlePark,05/07/2017 01:00:00 AM,48,-122,2,2,4
29330,ElliotBayTrailMyrtlePark,05/07/2017 02:00:00 AM,48,-122,0,0,0
29331,ElliotBayTrailMyrtlePark,05/07/2017 03:00:00 AM,48,-122,1,0,1
29332,ElliotBayTrailMyrtlePark,05/07/2017 04:00:00 AM,48,-122,1,1,2
29333,ElliotBayTrailMyrtlePark,05/07/2017 05:00:00 AM,48,-122,0,0,0
29334,ElliotBayTrailMyrtlePark,05/07/2017 06:00:00 AM,48,-122,7,7,14
29335,ElliotBayTrailMyrtlePark,05/07/2017 07:00:00 AM,48,-122,7,16,23
29336,ElliotBayTrailMyrtlePark,05/07/2017 08:00:00 AM,48,-122,12,21,33
29337,ElliotBayTrailMyrtlePark,05/07/2017 09:00:00 AM,48,-122,25,24,49
29338,ElliotBayTrailMyrtlePark,05/07/2017 10:00:00 AM,48,-122,38,41,79
29339,ElliotBayTrailMyrtlePark,05/07/2017 11:00:00 AM,48,-122,55,49,104
29340,ElliotBayTrailMyrtlePark,05/07/2017 12:00:00 PM,48,-122,46,44,90
29341,ElliotBayTrailMyrtlePark,05/07/2017 01:00:00 PM,48,-122,49,66,115
29342,ElliotBayTrailMyrtlePark,05/07/2017 02:00:00 PM,48,-122,90,65,155
29343,ElliotBayTrailMyrtlePark,05/07/2017 03:00:00 PM,48,-122,75,65,140
29344,ElliotBayTrailMyrtlePark,05/07/2017 04:00:00 PM,48,-122,68,51,119
29345,ElliotBayTrailMyrtlePark,05/07/2017 05:00:00 PM,48,-122,69,50,119
29346,ElliotBayTrailMyrtlePark,05/07/2017 06:00:00 PM,48,-122,28,32,60
29347,ElliotBayTrailMyrtlePark,05/07/2017 07:00:00 PM,48,-122,20,22,42
29348,ElliotBayTrailMyrtlePark,05/07/2017 08:00:00 PM,48,-122,17,14,31
29349,ElliotBayTrailMyrtlePark,05/07/2017 09:00:00 PM,48,-122,5,3,8
29350,ElliotBayTrailMyrtlePark,05/07/2017 10:00:00 PM,48,-122,0,1,1
29351,ElliotBayTrailMyrtlePark,05/07/2017 11:00:00 PM,48,-122,0,1,1
29352,ElliotBayTrailMyrtlePark,05/08/2017 12:00:00 AM,48,-122,0,0,0
29353,ElliotBayTrailMyrtlePark,05/08/2017 01:00:00 AM,48,-122,1,0,1
29354,ElliotBayTrailMyrtlePark,05/08/2017 02:00:00 AM,48,-122,1,0,1
29355,ElliotBayTrailMyrtlePark,05/08/2017 03:00:00 AM,48,-122,1,1,2
29356,ElliotBayTrailMyrtlePark,05/08/2017 04:00:00 AM,48,-122,4,3,7
29357,ElliotBayTrailMyrtlePark,05/08/2017 05:00:00 AM,48,-122,10,13,23
29358,ElliotBayTrailMyrtlePark,05/08/2017 06:00:00 AM,48,-122,25,47,72
29359,ElliotBayTrailMyrtlePark,05/08/2017 07:00:00 AM,48,-122,33,131,164
29360,ElliotBayTrailMyrtlePark,05/08/2017 08:00:00 AM,48,-122,47,187,234
29361,ElliotBayTrailMyrtlePark,05/08/2017 09:00:00 AM,48,-122,23,72,95
29362,ElliotBayTrailMyrtlePark,05/08/2017 10:00:00 AM,48,-122,10,19,29
29363,ElliotBayTrailMyrtlePark,05/08/2017 11:00:00 AM,48,-122,7,13,20
29364,ElliotBayTrailMyrtlePark,05/08/2017 12:00:00 PM,48,-122,12,11,23
29365,ElliotBayTrailMyrtlePark,05/08/2017 01:00:00 PM,48,-122,19,21,40
29366,ElliotBayTrailMyrtlePark,05/08/2017 02:00:00 PM,48,-122,32,19,51
29367,ElliotBayTrailMyrtlePark,05/08/2017 03:00:00 PM,48,-122,43,31,74
29368,ElliotBayTrailMyrtlePark,05/08/2017 04:00:00 PM,48,-122,128,53,181
29369,ElliotBayTrailMyrtlePark,05/08/2017 05:00:00 PM,48,-122,227,71,298
29370,ElliotBayTrailMyrtlePark,05/08/2017 06:00:00 PM,48,-122,148,64,212
29371,ElliotBayTrailMyrtlePark,05/08/2017 07:00:00 PM,48,-122,59,40,99
29372,ElliotBayTrailMyrtlePark,05/08/2017 08:00:00 PM,48,-122,24,18,42
29373,ElliotBayTrailMyrtlePark,05/08/2017 09:00:00 PM,48,-122,1,3,4
29374,ElliotBayTrailMyrtlePark,05/08/2017 10:00:00 PM,48,-122,3,5,8
29375,ElliotBayTrailMyrtlePark,05/08/2017 11:00:00 PM,48,-122,2,0,2
29376,ElliotBayTrailMyrtlePark,05/09/2017 12:00:00 AM,48,-122,4,1,5
29377,ElliotBayTrailMyrtlePark,05/09/2017 01:00:00 AM,48,-122,0,0,0
29378,ElliotBayTrailMyrtlePark,05/09/2017 02:00:00 AM,48,-122,2,0,2
29379,ElliotBayTrailMyrtlePark,05/09/2017 03:00:00 AM,48,-122,0,1,1
29380,ElliotBayTrailMyrtlePark,05/09/2017 04:00:00 AM,48,-122,0,1,1
29381,ElliotBayTrailMyrtlePark,05/09/2017 05:00:00 AM,48,-122,7,14,21
29382,ElliotBayTrailMyrtlePark,05/09/2017 06:00:00 AM,48,-122,27,65,92
29383,ElliotBayTrailMyrtlePark,05/09/2017 07:00:00 AM,48,-122,40,156,196
29384,ElliotBayTrailMyrtlePark,05/09/2017 08:00:00 AM,48,-122,57,196,253
29385,ElliotBayTrailMyrtlePark,05/09/2017 09:00:00 AM,48,-122,30,65,95
29386,ElliotBayTrailMyrtlePark,05/09/2017 10:00:00 AM,48,-122,12,31,43
29387,ElliotBayTrailMyrtlePark,05/09/2017 11:00:00 AM,48,-122,22,34,56
29388,ElliotBayTrailMyrtlePark,05/09/2017 12:00:00 PM,48,-122,48,30,78
29389,ElliotBayTrailMyrtlePark,05/09/2017 01:00:00 PM,48,-122,43,33,76
29390,ElliotBayTrailMyrtlePark,05/09/2017 02:00:00 PM,48,-122,34,39,73
29391,ElliotBayTrailMyrtlePark,05/09/2017 03:00:00 PM,48,-122,60,55,115
29392,ElliotBayTrailMyrtlePark,05/09/2017 04:00:00 PM,48,-122,145,68,213
29393,ElliotBayTrailMyrtlePark,05/09/2017 05:00:00 PM,48,-122,273,99,372
29394,ElliotBayTrailMyrtlePark,05/09/2017 06:00:00 PM,48,-122,175,65,240
29395,ElliotBayTrailMyrtlePark,05/09/2017 07:00:00 PM,48,-122,73,43,116
29396,ElliotBayTrailMyrtlePark,05/09/2017 08:00:00 PM,48,-122,42,31,73
29397,ElliotBayTrailMyrtlePark,05/09/2017 09:00:00 PM,48,-122,12,5,17
29398,ElliotBayTrailMyrtlePark,05/09/2017 10:00:00 PM,48,-122,9,7,16
29399,ElliotBayTrailMyrtlePark,05/09/2017 11:00:00 PM,48,-122,2,2,4
29400,ElliotBayTrailMyrtlePark,05/10/2017 12:00:00 AM,48,-122,6,7,13
29401,ElliotBayTrailMyrtlePark,05/10/2017 01:00:00 AM,48,-122,1,1,2
29402,ElliotBayTrailMyrtlePark,05/10/2017 02:00:00 AM,48,-122,0,0,0
29403,ElliotBayTrailMyrtlePark,05/10/2017 03:00:00 AM,48,-122,1,1,2
29404,ElliotBayTrailMyrtlePark,05/10/2017 04:00:00 AM,48,-122,5,4,9
29405,ElliotBayTrailMyrtlePark,05/10/2017 05:00:00 AM,48,-122,15,15,30
29406,ElliotBayTrailMyrtlePark,05/10/2017 06:00:00 AM,48,-122,25,42,67
29407,ElliotBayTrailMyrtlePark,05/10/2017 07:00:00 AM,48,-122,48,145,193
29408,ElliotBayTrailMyrtlePark,05/10/2017 08:00:00 AM,48,-122,49,189,238
29409,ElliotBayTrailMyrtlePark,05/10/2017 09:00:00 AM,48,-122,29,84,113
29410,ElliotBayTrailMyrtlePark,05/10/2017 10:00:00 AM,48,-122,17,39,56
29411,ElliotBayTrailMyrtlePark,05/10/2017 11:00:00 AM,48,-122,20,26,46
29412,ElliotBayTrailMyrtlePark,05/10/2017 12:00:00 PM,48,-122,40,30,70
29413,ElliotBayTrailMyrtlePark,05/10/2017 01:00:00 PM,48,-122,18,28,46
29414,ElliotBayTrailMyrtlePark,05/10/2017 02:00:00 PM,48,-122,29,23,52
29415,ElliotBayTrailMyrtlePark,05/10/2017 03:00:00 PM,48,-122,66,49,115
29416,ElliotBayTrailMyrtlePark,05/10/2017 04:00:00 PM,48,-122,153,52,205
29417,ElliotBayTrailMyrtlePark,05/10/2017 05:00:00 PM,48,-122,270,82,352
29418,ElliotBayTrailMyrtlePark,05/10/2017 06:00:00 PM,48,-122,154,63,217
29419,ElliotBayTrailMyrtlePark,05/10/2017 07:00:00 PM,48,-122,79,40,119
29420,ElliotBayTrailMyrtlePark,05/10/2017 08:00:00 PM,48,-122,30,46,76
29421,ElliotBayTrailMyrtlePark,05/10/2017 09:00:00 PM,48,-122,12,7,19
29422,ElliotBayTrailMyrtlePark,05/10/2017 10:00:00 PM,48,-122,4,2,6
29423,ElliotBayTrailMyrtlePark,05/10/2017 11:00:00 PM,48,-122,3,2,5
29424,ElliotBayTrailMyrtlePark,05/11/2017 12:00:00 AM,48,-122,0,0,0
29425,ElliotBayTrailMyrtlePark,05/11/2017 01:00:00 AM,48,-122,1,0,1
29426,ElliotBayTrailMyrtlePark,05/11/2017 02:00:00 AM,48,-122,0,0,0
29427,ElliotBayTrailMyrtlePark,05/11/2017 03:00:00 AM,48,-122,0,1,1
29428,ElliotBayTrailMyrtlePark,05/11/2017 04:00:00 AM,48,-122,0,1,1
29429,ElliotBayTrailMyrtlePark,05/11/2017 05:00:00 AM,48,-122,6,10,16
29430,ElliotBayTrailMyrtlePark,05/11/2017 06:00:00 AM,48,-122,16,25,41
29431,ElliotBayTrailMyrtlePark,05/11/2017 07:00:00 AM,48,-122,32,107,139
29432,ElliotBayTrailMyrtlePark,05/11/2017 08:00:00 AM,48,-122,37,125,162
29433,ElliotBayTrailMyrtlePark,05/11/2017 09:00:00 AM,48,-122,16,44,60
29434,ElliotBayTrailMyrtlePark,05/11/2017 10:00:00 AM,48,-122,6,16,22
29435,ElliotBayTrailMyrtlePark,05/11/2017 11:00:00 AM,48,-122,7,5,12
29436,ElliotBayTrailMyrtlePark,05/11/2017 12:00:00 PM,48,-122,10,5,15
29437,ElliotBayTrailMyrtlePark,05/11/2017 01:00:00 PM,48,-122,6,2,8
29438,ElliotBayTrailMyrtlePark,05/11/2017 02:00:00 PM,48,-122,11,6,17
29439,ElliotBayTrailMyrtlePark,05/11/2017 03:00:00 PM,48,-122,14,20,34
29440,ElliotBayTrailMyrtlePark,05/11/2017 04:00:00 PM,48,-122,70,26,96
29441,ElliotBayTrailMyrtlePark,05/11/2017 05:00:00 PM,48,-122,125,44,169
29442,ElliotBayTrailMyrtlePark,05/11/2017 06:00:00 PM,48,-122,74,17,91
29443,ElliotBayTrailMyrtlePark,05/11/2017 07:00:00 PM,48,-122,31,4,35
29444,ElliotBayTrailMyrtlePark,05/11/2017 08:00:00 PM,48,-122,11,10,21
29445,ElliotBayTrailMyrtlePark,05/11/2017 09:00:00 PM,48,-122,4,2,6
29446,ElliotBayTrailMyrtlePark,05/11/2017 10:00:00 PM,48,-122,3,0,3
29447,ElliotBayTrailMyrtlePark,05/11/2017 11:00:00 PM,48,-122,0,0,0
29448,ElliotBayTrailMyrtlePark,05/12/2017 12:00:00 AM,48,-122,0,1,1
29449,ElliotBayTrailMyrtlePark,05/12/2017 01:00:00 AM,48,-122,1,0,1
29450,ElliotBayTrailMyrtlePark,05/12/2017 02:00:00 AM,48,-122,2,0,2
29451,ElliotBayTrailMyrtlePark,05/12/2017 03:00:00 AM,48,-122,0,0,0
29452,ElliotBayTrailMyrtlePark,05/12/2017 04:00:00 AM,48,-122,3,3,6
29453,ElliotBayTrailMyrtlePark,05/12/2017 05:00:00 AM,48,-122,4,11,15
29454,ElliotBayTrailMyrtlePark,05/12/2017 06:00:00 AM,48,-122,20,34,54
29455,ElliotBayTrailMyrtlePark,05/12/2017 07:00:00 AM,48,-122,42,92,134
29456,ElliotBayTrailMyrtlePark,05/12/2017 08:00:00 AM,48,-122,46,140,186
29457,ElliotBayTrailMyrtlePark,05/12/2017 09:00:00 AM,48,-122,18,65,83
29458,ElliotBayTrailMyrtlePark,05/12/2017 10:00:00 AM,48,-122,26,18,44
29459,ElliotBayTrailMyrtlePark,05/12/2017 11:00:00 AM,48,-122,12,17,29
29460,ElliotBayTrailMyrtlePark,05/12/2017 12:00:00 PM,48,-122,15,12,27
29461,ElliotBayTrailMyrtlePark,05/12/2017 01:00:00 PM,48,-122,11,7,18
29462,ElliotBayTrailMyrtlePark,05/12/2017 02:00:00 PM,48,-122,11,12,23
29463,ElliotBayTrailMyrtlePark,05/12/2017 03:00:00 PM,48,-122,35,25,60
29464,ElliotBayTrailMyrtlePark,05/12/2017 04:00:00 PM,48,-122,92,30,122
29465,ElliotBayTrailMyrtlePark,05/12/2017 05:00:00 PM,48,-122,143,38,181
29466,ElliotBayTrailMyrtlePark,05/12/2017 06:00:00 PM,48,-122,80,26,106
29467,ElliotBayTrailMyrtlePark,05/12/2017 07:00:00 PM,48,-122,27,8,35
29468,ElliotBayTrailMyrtlePark,05/12/2017 08:00:00 PM,48,-122,4,6,10
29469,ElliotBayTrailMyrtlePark,05/12/2017 09:00:00 PM,48,-122,1,1,2
29470,ElliotBayTrailMyrtlePark,05/12/2017 10:00:00 PM,48,-122,3,0,3
29471,ElliotBayTrailMyrtlePark,05/12/2017 11:00:00 PM,48,-122,4,0,4
29472,ElliotBayTrailMyrtlePark,05/13/2017 12:00:00 AM,48,-122,3,0,3
29473,ElliotBayTrailMyrtlePark,05/13/2017 01:00:00 AM,48,-122,1,0,1
29474,ElliotBayTrailMyrtlePark,05/13/2017 02:00:00 AM,48,-122,0,0,0
29475,ElliotBayTrailMyrtlePark,05/13/2017 03:00:00 AM,48,-122,0,0,0
29476,ElliotBayTrailMyrtlePark,05/13/2017 04:00:00 AM,48,-122,1,0,1
29477,ElliotBayTrailMyrtlePark,05/13/2017 05:00:00 AM,48,-122,4,3,7
29478,ElliotBayTrailMyrtlePark,05/13/2017 06:00:00 AM,48,-122,6,5,11
29479,ElliotBayTrailMyrtlePark,05/13/2017 07:00:00 AM,48,-122,9,9,18
29480,ElliotBayTrailMyrtlePark,05/13/2017 08:00:00 AM,48,-122,6,19,25
29481,ElliotBayTrailMyrtlePark,05/13/2017 09:00:00 AM,48,-122,13,10,23
29482,ElliotBayTrailMyrtlePark,05/13/2017 10:00:00 AM,48,-122,21,35,56
29483,ElliotBayTrailMyrtlePark,05/13/2017 11:00:00 AM,48,-122,32,49,81
29484,ElliotBayTrailMyrtlePark,05/13/2017 12:00:00 PM,48,-122,26,21,47
29485,ElliotBayTrailMyrtlePark,05/13/2017 01:00:00 PM,48,-122,31,24,55
29486,ElliotBayTrailMyrtlePark,05/13/2017 02:00:00 PM,48,-122,41,46,87
29487,ElliotBayTrailMyrtlePark,05/13/2017 03:00:00 PM,48,-122,43,38,81
29488,ElliotBayTrailMyrtlePark,05/13/2017 04:00:00 PM,48,-122,57,29,86
29489,ElliotBayTrailMyrtlePark,05/13/2017 05:00:00 PM,48,-122,38,32,70
29490,ElliotBayTrailMyrtlePark,05/13/2017 06:00:00 PM,48,-122,27,10,37
29491,ElliotBayTrailMyrtlePark,05/13/2017 07:00:00 PM,48,-122,5,3,8
29492,ElliotBayTrailMyrtlePark,05/13/2017 08:00:00 PM,48,-122,5,10,15
29493,ElliotBayTrailMyrtlePark,05/13/2017 09:00:00 PM,48,-122,11,2,13
29494,ElliotBayTrailMyrtlePark,05/13/2017 10:00:00 PM,48,-122,10,2,12
29495,ElliotBayTrailMyrtlePark,05/13/2017 11:00:00 PM,48,-122,3,1,4
29496,ElliotBayTrailMyrtlePark,05/14/2017 12:00:00 AM,48,-122,1,0,1
29497,ElliotBayTrailMyrtlePark,05/14/2017 01:00:00 AM,48,-122,0,2,2
29498,ElliotBayTrailMyrtlePark,05/14/2017 02:00:00 AM,48,-122,1,0,1
29499,ElliotBayTrailMyrtlePark,05/14/2017 03:00:00 AM,48,-122,0,0,0
29500,ElliotBayTrailMyrtlePark,05/14/2017 04:00:00 AM,48,-122,0,1,1
29501,ElliotBayTrailMyrtlePark,05/14/2017 05:00:00 AM,48,-122,2,0,2
29502,ElliotBayTrailMyrtlePark,05/14/2017 06:00:00 AM,48,-122,0,1,1
29503,ElliotBayTrailMyrtlePark,05/14/2017 07:00:00 AM,48,-122,1,4,5
29504,ElliotBayTrailMyrtlePark,05/14/2017 08:00:00 AM,48,-122,8,12,20
29505,ElliotBayTrailMyrtlePark,05/14/2017 09:00:00 AM,48,-122,9,10,19
29506,ElliotBayTrailMyrtlePark,05/14/2017 10:00:00 AM,48,-122,11,25,36
29507,ElliotBayTrailMyrtlePark,05/14/2017 11:00:00 AM,48,-122,18,32,50
29508,ElliotBayTrailMyrtlePark,05/14/2017 12:00:00 PM,48,-122,22,15,37
29509,ElliotBayTrailMyrtlePark,05/14/2017 01:00:00 PM,48,-122,26,11,37
29510,ElliotBayTrailMyrtlePark,05/14/2017 02:00:00 PM,48,-122,28,26,54
29511,ElliotBayTrailMyrtlePark,05/14/2017 03:00:00 PM,48,-122,42,29,71
29512,ElliotBayTrailMyrtlePark,05/14/2017 04:00:00 PM,48,-122,27,28,55
29513,ElliotBayTrailMyrtlePark,05/14/2017 05:00:00 PM,48,-122,25,23,48
29514,ElliotBayTrailMyrtlePark,05/14/2017 06:00:00 PM,48,-122,18,19,37
29515,ElliotBayTrailMyrtlePark,05/14/2017 07:00:00 PM,48,-122,8,9,17
29516,ElliotBayTrailMyrtlePark,05/14/2017 08:00:00 PM,48,-122,9,7,16
29517,ElliotBayTrailMyrtlePark,05/14/2017 09:00:00 PM,48,-122,4,5,9
29518,ElliotBayTrailMyrtlePark,05/14/2017 10:00:00 PM,48,-122,3,0,3
29519,ElliotBayTrailMyrtlePark,05/14/2017 11:00:00 PM,48,-122,6,0,6
29520,ElliotBayTrailMyrtlePark,05/15/2017 12:00:00 AM,48,-122,1,0,1
29521,ElliotBayTrailMyrtlePark,05/15/2017 01:00:00 AM,48,-122,0,0,0
29522,ElliotBayTrailMyrtlePark,05/15/2017 02:00:00 AM,48,-122,0,0,0
29523,ElliotBayTrailMyrtlePark,05/15/2017 03:00:00 AM,48,-122,0,1,1
29524,ElliotBayTrailMyrtlePark,05/15/2017 04:00:00 AM,48,-122,1,0,1
29525,ElliotBayTrailMyrtlePark,05/15/2017 05:00:00 AM,48,-122,12,7,19
29526,ElliotBayTrailMyrtlePark,05/15/2017 06:00:00 AM,48,-122,15,32,47
29527,ElliotBayTrailMyrtlePark,05/15/2017 07:00:00 AM,48,-122,36,90,126
29528,ElliotBayTrailMyrtlePark,05/15/2017 08:00:00 AM,48,-122,41,152,193
29529,ElliotBayTrailMyrtlePark,05/15/2017 09:00:00 AM,48,-122,23,52,75
29530,ElliotBayTrailMyrtlePark,05/15/2017 10:00:00 AM,48,-122,5,15,20
29531,ElliotBayTrailMyrtlePark,05/15/2017 11:00:00 AM,48,-122,15,12,27
29532,ElliotBayTrailMyrtlePark,05/15/2017 12:00:00 PM,48,-122,18,19,37
29533,ElliotBayTrailMyrtlePark,05/15/2017 01:00:00 PM,48,-122,12,6,18
29534,ElliotBayTrailMyrtlePark,05/15/2017 02:00:00 PM,48,-122,4,7,11
29535,ElliotBayTrailMyrtlePark,05/15/2017 03:00:00 PM,48,-122,17,13,30
29536,ElliotBayTrailMyrtlePark,05/15/2017 04:00:00 PM,48,-122,49,27,76
29537,ElliotBayTrailMyrtlePark,05/15/2017 05:00:00 PM,48,-122,144,31,175
29538,ElliotBayTrailMyrtlePark,05/15/2017 06:00:00 PM,48,-122,86,17,103
29539,ElliotBayTrailMyrtlePark,05/15/2017 07:00:00 PM,48,-122,26,5,31
29540,ElliotBayTrailMyrtlePark,05/15/2017 08:00:00 PM,48,-122,11,2,13
29541,ElliotBayTrailMyrtlePark,05/15/2017 09:00:00 PM,48,-122,3,4,7
29542,ElliotBayTrailMyrtlePark,05/15/2017 10:00:00 PM,48,-122,1,0,1
29543,ElliotBayTrailMyrtlePark,05/15/2017 11:00:00 PM,48,-122,0,0,0
29544,ElliotBayTrailMyrtlePark,05/16/2017 12:00:00 AM,48,-122,2,0,2
29545,ElliotBayTrailMyrtlePark,05/16/2017 01:00:00 AM,48,-122,1,0,1
29546,ElliotBayTrailMyrtlePark,05/16/2017 02:00:00 AM,48,-122,0,0,0
29547,ElliotBayTrailMyrtlePark,05/16/2017 03:00:00 AM,48,-122,0,1,1
29548,ElliotBayTrailMyrtlePark,05/16/2017 04:00:00 AM,48,-122,1,2,3
29549,ElliotBayTrailMyrtlePark,05/16/2017 05:00:00 AM,48,-122,5,6,11
29550,ElliotBayTrailMyrtlePark,05/16/2017 06:00:00 AM,48,-122,9,19,28
29551,ElliotBayTrailMyrtlePark,05/16/2017 07:00:00 AM,48,-122,20,61,81
29552,ElliotBayTrailMyrtlePark,05/16/2017 08:00:00 AM,48,-122,26,95,121
29553,ElliotBayTrailMyrtlePark,05/16/2017 09:00:00 AM,48,-122,14,39,53
29554,ElliotBayTrailMyrtlePark,05/16/2017 10:00:00 AM,48,-122,5,7,12
29555,ElliotBayTrailMyrtlePark,05/16/2017 11:00:00 AM,48,-122,4,5,9
29556,ElliotBayTrailMyrtlePark,05/16/2017 12:00:00 PM,48,-122,12,5,17
29557,ElliotBayTrailMyrtlePark,05/16/2017 01:00:00 PM,48,-122,9,4,13
29558,ElliotBayTrailMyrtlePark,05/16/2017 02:00:00 PM,48,-122,7,23,30
29559,ElliotBayTrailMyrtlePark,05/16/2017 03:00:00 PM,48,-122,34,27,61
29560,ElliotBayTrailMyrtlePark,05/16/2017 04:00:00 PM,48,-122,56,31,87
29561,ElliotBayTrailMyrtlePark,05/16/2017 05:00:00 PM,48,-122,134,39,173
29562,ElliotBayTrailMyrtlePark,05/16/2017 06:00:00 PM,48,-122,77,32,109
29563,ElliotBayTrailMyrtlePark,05/16/2017 07:00:00 PM,48,-122,32,19,51
29564,ElliotBayTrailMyrtlePark,05/16/2017 08:00:00 PM,48,-122,15,6,21
29565,ElliotBayTrailMyrtlePark,05/16/2017 09:00:00 PM,48,-122,9,7,16
29566,ElliotBayTrailMyrtlePark,05/16/2017 10:00:00 PM,48,-122,3,0,3
29567,ElliotBayTrailMyrtlePark,05/16/2017 11:00:00 PM,48,-122,2,0,2
29568,ElliotBayTrailMyrtlePark,05/17/2017 12:00:00 AM,48,-122,3,0,3
29569,ElliotBayTrailMyrtlePark,05/17/2017 01:00:00 AM,48,-122,0,0,0
29570,ElliotBayTrailMyrtlePark,05/17/2017 02:00:00 AM,48,-122,1,0,1
29571,ElliotBayTrailMyrtlePark,05/17/2017 03:00:00 AM,48,-122,1,1,2
29572,ElliotBayTrailMyrtlePark,05/17/2017 04:00:00 AM,48,-122,5,8,13
29573,ElliotBayTrailMyrtlePark,05/17/2017 05:00:00 AM,48,-122,6,13,19
29574,ElliotBayTrailMyrtlePark,05/17/2017 06:00:00 AM,48,-122,27,42,69
29575,ElliotBayTrailMyrtlePark,05/17/2017 07:00:00 AM,48,-122,49,124,173
29576,ElliotBayTrailMyrtlePark,05/17/2017 08:00:00 AM,48,-122,47,169,216
29577,ElliotBayTrailMyrtlePark,05/17/2017 09:00:00 AM,48,-122,20,71,91
29578,ElliotBayTrailMyrtlePark,05/17/2017 10:00:00 AM,48,-122,11,25,36
29579,ElliotBayTrailMyrtlePark,05/17/2017 11:00:00 AM,48,-122,16,20,36
29580,ElliotBayTrailMyrtlePark,05/17/2017 12:00:00 PM,48,-122,12,9,21
29581,ElliotBayTrailMyrtlePark,05/17/2017 01:00:00 PM,48,-122,15,16,31
29582,ElliotBayTrailMyrtlePark,05/17/2017 02:00:00 PM,48,-122,26,20,46
29583,ElliotBayTrailMyrtlePark,05/17/2017 03:00:00 PM,48,-122,53,36,89
29584,ElliotBayTrailMyrtlePark,05/17/2017 04:00:00 PM,48,-122,127,58,185
29585,ElliotBayTrailMyrtlePark,05/17/2017 05:00:00 PM,48,-122,217,81,298
29586,ElliotBayTrailMyrtlePark,05/17/2017 06:00:00 PM,48,-122,121,36,157
29587,ElliotBayTrailMyrtlePark,05/17/2017 07:00:00 PM,48,-122,32,21,53
29588,ElliotBayTrailMyrtlePark,05/17/2017 08:00:00 PM,48,-122,20,15,35
29589,ElliotBayTrailMyrtlePark,05/17/2017 09:00:00 PM,48,-122,17,3,20
29590,ElliotBayTrailMyrtlePark,05/17/2017 10:00:00 PM,48,-122,5,2,7
29591,ElliotBayTrailMyrtlePark,05/17/2017 11:00:00 PM,48,-122,6,1,7
29592,ElliotBayTrailMyrtlePark,05/18/2017 12:00:00 AM,48,-122,1,1,2
29593,ElliotBayTrailMyrtlePark,05/18/2017 01:00:00 AM,48,-122,2,0,2
29594,ElliotBayTrailMyrtlePark,05/18/2017 02:00:00 AM,48,-122,0,0,0
29595,ElliotBayTrailMyrtlePark,05/18/2017 03:00:00 AM,48,-122,0,1,1
29596,ElliotBayTrailMyrtlePark,05/18/2017 04:00:00 AM,48,-122,1,2,3
29597,ElliotBayTrailMyrtlePark,05/18/2017 05:00:00 AM,48,-122,9,12,21
29598,ElliotBayTrailMyrtlePark,05/18/2017 06:00:00 AM,48,-122,28,37,65
29599,ElliotBayTrailMyrtlePark,05/18/2017 07:00:00 AM,48,-122,33,113,146
29600,ElliotBayTrailMyrtlePark,05/18/2017 08:00:00 AM,48,-122,47,154,201
29601,ElliotBayTrailMyrtlePark,05/18/2017 09:00:00 AM,48,-122,26,62,88
29602,ElliotBayTrailMyrtlePark,05/18/2017 10:00:00 AM,48,-122,28,32,60
29603,ElliotBayTrailMyrtlePark,05/18/2017 11:00:00 AM,48,-122,29,18,47
29604,ElliotBayTrailMyrtlePark,05/18/2017 12:00:00 PM,48,-122,21,23,44
29605,ElliotBayTrailMyrtlePark,05/18/2017 01:00:00 PM,48,-122,29,38,67
29606,ElliotBayTrailMyrtlePark,05/18/2017 02:00:00 PM,48,-122,27,31,58
29607,ElliotBayTrailMyrtlePark,05/18/2017 03:00:00 PM,48,-122,51,25,76
29608,ElliotBayTrailMyrtlePark,05/18/2017 04:00:00 PM,48,-122,114,59,173
29609,ElliotBayTrailMyrtlePark,05/18/2017 05:00:00 PM,48,-122,226,80,306
29610,ElliotBayTrailMyrtlePark,05/18/2017 06:00:00 PM,48,-122,126,60,186
29611,ElliotBayTrailMyrtlePark,05/18/2017 07:00:00 PM,48,-122,62,43,105
29612,ElliotBayTrailMyrtlePark,05/18/2017 08:00:00 PM,48,-122,21,17,38
29613,ElliotBayTrailMyrtlePark,05/18/2017 09:00:00 PM,48,-122,13,14,27
29614,ElliotBayTrailMyrtlePark,05/18/2017 10:00:00 PM,48,-122,7,4,11
29615,ElliotBayTrailMyrtlePark,05/18/2017 11:00:00 PM,48,-122,4,1,5
29616,ElliotBayTrailMyrtlePark,05/19/2017 12:00:00 AM,48,-122,0,0,0
29617,ElliotBayTrailMyrtlePark,05/19/2017 01:00:00 AM,48,-122,0,0,0
29618,ElliotBayTrailMyrtlePark,05/19/2017 02:00:00 AM,48,-122,1,0,1
29619,ElliotBayTrailMyrtlePark,05/19/2017 03:00:00 AM,48,-122,0,0,0
29620,ElliotBayTrailMyrtlePark,05/19/2017 04:00:00 AM,48,-122,5,5,10
29621,ElliotBayTrailMyrtlePark,05/19/2017 05:00:00 AM,48,-122,7,20,27
29622,ElliotBayTrailMyrtlePark,05/19/2017 06:00:00 AM,48,-122,35,54,89
29623,ElliotBayTrailMyrtlePark,05/19/2017 07:00:00 AM,48,-122,69,160,229
29624,ElliotBayTrailMyrtlePark,05/19/2017 08:00:00 AM,48,-122,59,185,244
29625,ElliotBayTrailMyrtlePark,05/19/2017 09:00:00 AM,48,-122,41,67,108
29626,ElliotBayTrailMyrtlePark,05/19/2017 10:00:00 AM,48,-122,21,40,61
29627,ElliotBayTrailMyrtlePark,05/19/2017 11:00:00 AM,48,-122,33,33,66
29628,ElliotBayTrailMyrtlePark,05/19/2017 12:00:00 PM,48,-122,34,36,70
29629,ElliotBayTrailMyrtlePark,05/19/2017 01:00:00 PM,48,-122,51,30,81
29630,ElliotBayTrailMyrtlePark,05/19/2017 02:00:00 PM,48,-122,50,53,103
29631,ElliotBayTrailMyrtlePark,05/19/2017 03:00:00 PM,48,-122,95,55,150
29632,ElliotBayTrailMyrtlePark,05/19/2017 04:00:00 PM,48,-122,202,75,277
29633,ElliotBayTrailMyrtlePark,05/19/2017 05:00:00 PM,48,-122,245,83,328
29634,ElliotBayTrailMyrtlePark,05/19/2017 06:00:00 PM,48,-122,97,46,143
29635,ElliotBayTrailMyrtlePark,05/19/2017 07:00:00 PM,48,-122,48,28,76
29636,ElliotBayTrailMyrtlePark,05/19/2017 08:00:00 PM,48,-122,16,15,31
29637,ElliotBayTrailMyrtlePark,05/19/2017 09:00:00 PM,48,-122,10,13,23
29638,ElliotBayTrailMyrtlePark,05/19/2017 10:00:00 PM,48,-122,20,5,25
29639,ElliotBayTrailMyrtlePark,05/19/2017 11:00:00 PM,48,-122,4,3,7
29640,ElliotBayTrailMyrtlePark,05/20/2017 12:00:00 AM,48,-122,1,2,3
29641,ElliotBayTrailMyrtlePark,05/20/2017 01:00:00 AM,48,-122,1,2,3
29642,ElliotBayTrailMyrtlePark,05/20/2017 02:00:00 AM,48,-122,0,0,0
29643,ElliotBayTrailMyrtlePark,05/20/2017 03:00:00 AM,48,-122,1,0,1
29644,ElliotBayTrailMyrtlePark,05/20/2017 04:00:00 AM,48,-122,0,1,1
29645,ElliotBayTrailMyrtlePark,05/20/2017 05:00:00 AM,48,-122,3,2,5
29646,ElliotBayTrailMyrtlePark,05/20/2017 06:00:00 AM,48,-122,3,8,11
29647,ElliotBayTrailMyrtlePark,05/20/2017 07:00:00 AM,48,-122,15,21,36
29648,ElliotBayTrailMyrtlePark,05/20/2017 08:00:00 AM,48,-122,21,22,43
29649,ElliotBayTrailMyrtlePark,05/20/2017 09:00:00 AM,48,-122,31,31,62
29650,ElliotBayTrailMyrtlePark,05/20/2017 10:00:00 AM,48,-122,42,44,86
29651,ElliotBayTrailMyrtlePark,05/20/2017 11:00:00 AM,48,-122,64,71,135
29652,ElliotBayTrailMyrtlePark,05/20/2017 12:00:00 PM,48,-122,66,61,127
29653,ElliotBayTrailMyrtlePark,05/20/2017 01:00:00 PM,48,-122,56,100,156
29654,ElliotBayTrailMyrtlePark,05/20/2017 02:00:00 PM,48,-122,85,52,137
29655,ElliotBayTrailMyrtlePark,05/20/2017 03:00:00 PM,48,-122,84,86,170
29656,ElliotBayTrailMyrtlePark,05/20/2017 04:00:00 PM,48,-122,118,77,195
29657,ElliotBayTrailMyrtlePark,05/20/2017 05:00:00 PM,48,-122,65,66,131
29658,ElliotBayTrailMyrtlePark,05/20/2017 06:00:00 PM,48,-122,47,34,81
29659,ElliotBayTrailMyrtlePark,05/20/2017 07:00:00 PM,48,-122,31,42,73
29660,ElliotBayTrailMyrtlePark,05/20/2017 08:00:00 PM,48,-122,21,17,38
29661,ElliotBayTrailMyrtlePark,05/20/2017 09:00:00 PM,48,-122,10,6,16
29662,ElliotBayTrailMyrtlePark,05/20/2017 10:00:00 PM,48,-122,13,3,16
29663,ElliotBayTrailMyrtlePark,05/20/2017 11:00:00 PM,48,-122,2,2,4
29664,ElliotBayTrailMyrtlePark,05/21/2017 12:00:00 AM,48,-122,1,2,3
29665,ElliotBayTrailMyrtlePark,05/21/2017 01:00:00 AM,48,-122,0,0,0
29666,ElliotBayTrailMyrtlePark,05/21/2017 02:00:00 AM,48,-122,0,0,0
29667,ElliotBayTrailMyrtlePark,05/21/2017 03:00:00 AM,48,-122,2,0,2
29668,ElliotBayTrailMyrtlePark,05/21/2017 04:00:00 AM,48,-122,2,1,3
29669,ElliotBayTrailMyrtlePark,05/21/2017 05:00:00 AM,48,-122,0,2,2
29670,ElliotBayTrailMyrtlePark,05/21/2017 06:00:00 AM,48,-122,6,4,10
29671,ElliotBayTrailMyrtlePark,05/21/2017 07:00:00 AM,48,-122,14,12,26
29672,ElliotBayTrailMyrtlePark,05/21/2017 08:00:00 AM,48,-122,19,29,48
29673,ElliotBayTrailMyrtlePark,05/21/2017 09:00:00 AM,48,-122,43,34,77
29674,ElliotBayTrailMyrtlePark,05/21/2017 10:00:00 AM,48,-122,58,71,129
29675,ElliotBayTrailMyrtlePark,05/21/2017 11:00:00 AM,48,-122,81,79,160
29676,ElliotBayTrailMyrtlePark,05/21/2017 12:00:00 PM,48,-122,69,87,156
29677,ElliotBayTrailMyrtlePark,05/21/2017 01:00:00 PM,48,-122,98,90,188
29678,ElliotBayTrailMyrtlePark,05/21/2017 02:00:00 PM,48,-122,101,103,204
29679,ElliotBayTrailMyrtlePark,05/21/2017 03:00:00 PM,48,-122,89,84,173
29680,ElliotBayTrailMyrtlePark,05/21/2017 04:00:00 PM,48,-122,96,79,175
29681,ElliotBayTrailMyrtlePark,05/21/2017 05:00:00 PM,48,-122,71,57,128
29682,ElliotBayTrailMyrtlePark,05/21/2017 06:00:00 PM,48,-122,31,36,67
29683,ElliotBayTrailMyrtlePark,05/21/2017 07:00:00 PM,48,-122,28,48,76
29684,ElliotBayTrailMyrtlePark,05/21/2017 08:00:00 PM,48,-122,26,22,48
29685,ElliotBayTrailMyrtlePark,05/21/2017 09:00:00 PM,48,-122,10,8,18
29686,ElliotBayTrailMyrtlePark,05/21/2017 10:00:00 PM,48,-122,4,2,6
29687,ElliotBayTrailMyrtlePark,05/21/2017 11:00:00 PM,48,-122,2,3,5
29688,ElliotBayTrailMyrtlePark,05/22/2017 12:00:00 AM,48,-122,2,2,4
29689,ElliotBayTrailMyrtlePark,05/22/2017 01:00:00 AM,48,-122,1,0,1
29690,ElliotBayTrailMyrtlePark,05/22/2017 02:00:00 AM,48,-122,0,0,0
29691,ElliotBayTrailMyrtlePark,05/22/2017 03:00:00 AM,48,-122,1,2,3
29692,ElliotBayTrailMyrtlePark,05/22/2017 04:00:00 AM,48,-122,0,1,1
29693,ElliotBayTrailMyrtlePark,05/22/2017 05:00:00 AM,48,-122,8,11,19
29694,ElliotBayTrailMyrtlePark,05/22/2017 06:00:00 AM,48,-122,31,53,84
29695,ElliotBayTrailMyrtlePark,05/22/2017 07:00:00 AM,48,-122,56,145,201
29696,ElliotBayTrailMyrtlePark,05/22/2017 08:00:00 AM,48,-122,65,198,263
29697,ElliotBayTrailMyrtlePark,05/22/2017 09:00:00 AM,48,-122,35,95,130
29698,ElliotBayTrailMyrtlePark,05/22/2017 10:00:00 AM,48,-122,27,51,78
29699,ElliotBayTrailMyrtlePark,05/22/2017 11:00:00 AM,48,-122,23,23,46
29700,ElliotBayTrailMyrtlePark,05/22/2017 12:00:00 PM,48,-122,28,30,58
29701,ElliotBayTrailMyrtlePark,05/22/2017 01:00:00 PM,48,-122,19,17,36
29702,ElliotBayTrailMyrtlePark,05/22/2017 02:00:00 PM,48,-122,41,26,67
29703,ElliotBayTrailMyrtlePark,05/22/2017 03:00:00 PM,48,-122,76,51,127
29704,ElliotBayTrailMyrtlePark,05/22/2017 04:00:00 PM,48,-122,160,77,237
29705,ElliotBayTrailMyrtlePark,05/22/2017 05:00:00 PM,48,-122,291,93,384
29706,ElliotBayTrailMyrtlePark,05/22/2017 06:00:00 PM,48,-122,152,58,210
29707,ElliotBayTrailMyrtlePark,05/22/2017 07:00:00 PM,48,-122,89,42,131
29708,ElliotBayTrailMyrtlePark,05/22/2017 08:00:00 PM,48,-122,48,36,84
29709,ElliotBayTrailMyrtlePark,05/22/2017 09:00:00 PM,48,-122,11,19,30
29710,ElliotBayTrailMyrtlePark,05/22/2017 10:00:00 PM,48,-122,5,1,6
29711,ElliotBayTrailMyrtlePark,05/22/2017 11:00:00 PM,48,-122,2,0,2
29712,ElliotBayTrailMyrtlePark,05/23/2017 12:00:00 AM,48,-122,1,1,2
29713,ElliotBayTrailMyrtlePark,05/23/2017 01:00:00 AM,48,-122,0,0,0
29714,ElliotBayTrailMyrtlePark,05/23/2017 02:00:00 AM,48,-122,2,2,4
29715,ElliotBayTrailMyrtlePark,05/23/2017 03:00:00 AM,48,-122,1,5,6
29716,ElliotBayTrailMyrtlePark,05/23/2017 04:00:00 AM,48,-122,4,2,6
29717,ElliotBayTrailMyrtlePark,05/23/2017 05:00:00 AM,48,-122,11,16,27
29718,ElliotBayTrailMyrtlePark,05/23/2017 06:00:00 AM,48,-122,32,66,98
29719,ElliotBayTrailMyrtlePark,05/23/2017 07:00:00 AM,48,-122,49,159,208
29720,ElliotBayTrailMyrtlePark,05/23/2017 08:00:00 AM,48,-122,86,198,284
29721,ElliotBayTrailMyrtlePark,05/23/2017 09:00:00 AM,48,-122,51,77,128
29722,ElliotBayTrailMyrtlePark,05/23/2017 10:00:00 AM,48,-122,31,29,60
29723,ElliotBayTrailMyrtlePark,05/23/2017 11:00:00 AM,48,-122,21,28,49
29724,ElliotBayTrailMyrtlePark,05/23/2017 12:00:00 PM,48,-122,35,39,74
29725,ElliotBayTrailMyrtlePark,05/23/2017 01:00:00 PM,48,-122,37,27,64
29726,ElliotBayTrailMyrtlePark,05/23/2017 02:00:00 PM,48,-122,27,38,65
29727,ElliotBayTrailMyrtlePark,05/23/2017 03:00:00 PM,48,-122,59,34,93
29728,ElliotBayTrailMyrtlePark,05/23/2017 04:00:00 PM,48,-122,155,74,229
29729,ElliotBayTrailMyrtlePark,05/23/2017 05:00:00 PM,48,-122,291,97,388
29730,ElliotBayTrailMyrtlePark,05/23/2017 06:00:00 PM,48,-122,171,58,229
29731,ElliotBayTrailMyrtlePark,05/23/2017 07:00:00 PM,48,-122,50,38,88
29732,ElliotBayTrailMyrtlePark,05/23/2017 08:00:00 PM,48,-122,16,12,28
29733,ElliotBayTrailMyrtlePark,05/23/2017 09:00:00 PM,48,-122,7,11,18
29734,ElliotBayTrailMyrtlePark,05/23/2017 10:00:00 PM,48,-122,6,5,11
29735,ElliotBayTrailMyrtlePark,05/23/2017 11:00:00 PM,48,-122,2,2,4
29736,ElliotBayTrailMyrtlePark,05/24/2017 12:00:00 AM,48,-122,1,1,2
29737,ElliotBayTrailMyrtlePark,05/24/2017 01:00:00 AM,48,-122,1,0,1
29738,ElliotBayTrailMyrtlePark,05/24/2017 02:00:00 AM,48,-122,0,0,0
29739,ElliotBayTrailMyrtlePark,05/24/2017 03:00:00 AM,48,-122,0,2,2
29740,ElliotBayTrailMyrtlePark,05/24/2017 04:00:00 AM,48,-122,3,2,5
29741,ElliotBayTrailMyrtlePark,05/24/2017 05:00:00 AM,48,-122,17,15,32
29742,ElliotBayTrailMyrtlePark,05/24/2017 06:00:00 AM,48,-122,22,47,69
29743,ElliotBayTrailMyrtlePark,05/24/2017 07:00:00 AM,48,-122,45,125,170
29744,ElliotBayTrailMyrtlePark,05/24/2017 08:00:00 AM,48,-122,62,197,259
29745,ElliotBayTrailMyrtlePark,05/24/2017 09:00:00 AM,48,-122,26,81,107
29746,ElliotBayTrailMyrtlePark,05/24/2017 10:00:00 AM,48,-122,13,23,36
29747,ElliotBayTrailMyrtlePark,05/24/2017 11:00:00 AM,48,-122,13,31,44
29748,ElliotBayTrailMyrtlePark,05/24/2017 12:00:00 PM,48,-122,27,19,46
29749,ElliotBayTrailMyrtlePark,05/24/2017 01:00:00 PM,48,-122,16,24,40
29750,ElliotBayTrailMyrtlePark,05/24/2017 02:00:00 PM,48,-122,29,21,50
29751,ElliotBayTrailMyrtlePark,05/24/2017 03:00:00 PM,48,-122,50,34,84
29752,ElliotBayTrailMyrtlePark,05/24/2017 04:00:00 PM,48,-122,102,42,144
29753,ElliotBayTrailMyrtlePark,05/24/2017 05:00:00 PM,48,-122,212,65,277
29754,ElliotBayTrailMyrtlePark,05/24/2017 06:00:00 PM,48,-122,138,43,181
29755,ElliotBayTrailMyrtlePark,05/24/2017 07:00:00 PM,48,-122,57,35,92
29756,ElliotBayTrailMyrtlePark,05/24/2017 08:00:00 PM,48,-122,40,31,71
29757,ElliotBayTrailMyrtlePark,05/24/2017 09:00:00 PM,48,-122,15,14,29
29758,ElliotBayTrailMyrtlePark,05/24/2017 10:00:00 PM,48,-122,12,15,27
29759,ElliotBayTrailMyrtlePark,05/24/2017 11:00:00 PM,48,-122,2,0,2
29760,ElliotBayTrailMyrtlePark,05/25/2017 12:00:00 AM,48,-122,0,0,0
29761,ElliotBayTrailMyrtlePark,05/25/2017 01:00:00 AM,48,-122,2,0,2
29762,ElliotBayTrailMyrtlePark,05/25/2017 02:00:00 AM,48,-122,2,2,4
29763,ElliotBayTrailMyrtlePark,05/25/2017 03:00:00 AM,48,-122,0,1,1
29764,ElliotBayTrailMyrtlePark,05/25/2017 04:00:00 AM,48,-122,4,4,8
29765,ElliotBayTrailMyrtlePark,05/25/2017 05:00:00 AM,48,-122,5,16,21
29766,ElliotBayTrailMyrtlePark,05/25/2017 06:00:00 AM,48,-122,31,40,71
29767,ElliotBayTrailMyrtlePark,05/25/2017 07:00:00 AM,48,-122,40,132,172
29768,ElliotBayTrailMyrtlePark,05/25/2017 08:00:00 AM,48,-122,57,179,236
29769,ElliotBayTrailMyrtlePark,05/25/2017 09:00:00 AM,48,-122,35,64,99
29770,ElliotBayTrailMyrtlePark,05/25/2017 10:00:00 AM,48,-122,27,31,58
29771,ElliotBayTrailMyrtlePark,05/25/2017 11:00:00 AM,48,-122,16,24,40
29772,ElliotBayTrailMyrtlePark,05/25/2017 12:00:00 PM,48,-122,33,22,55
29773,ElliotBayTrailMyrtlePark,05/25/2017 01:00:00 PM,48,-122,35,39,74
29774,ElliotBayTrailMyrtlePark,05/25/2017 02:00:00 PM,48,-122,47,31,78
29775,ElliotBayTrailMyrtlePark,05/25/2017 03:00:00 PM,48,-122,54,55,109
29776,ElliotBayTrailMyrtlePark,05/25/2017 04:00:00 PM,48,-122,117,52,169
29777,ElliotBayTrailMyrtlePark,05/25/2017 05:00:00 PM,48,-122,261,88,349
29778,ElliotBayTrailMyrtlePark,05/25/2017 06:00:00 PM,48,-122,139,65,204
29779,ElliotBayTrailMyrtlePark,05/25/2017 07:00:00 PM,48,-122,76,48,124
29780,ElliotBayTrailMyrtlePark,05/25/2017 08:00:00 PM,48,-122,32,35,67
29781,ElliotBayTrailMyrtlePark,05/25/2017 09:00:00 PM,48,-122,19,19,38
29782,ElliotBayTrailMyrtlePark,05/25/2017 10:00:00 PM,48,-122,4,6,10
29783,ElliotBayTrailMyrtlePark,05/25/2017 11:00:00 PM,48,-122,2,8,10
29784,ElliotBayTrailMyrtlePark,05/26/2017 12:00:00 AM,48,-122,2,7,9
29785,ElliotBayTrailMyrtlePark,05/26/2017 01:00:00 AM,48,-122,1,0,1
29786,ElliotBayTrailMyrtlePark,05/26/2017 02:00:00 AM,48,-122,1,0,1
29787,ElliotBayTrailMyrtlePark,05/26/2017 03:00:00 AM,48,-122,0,1,1
29788,ElliotBayTrailMyrtlePark,05/26/2017 04:00:00 AM,48,-122,2,3,5
29789,ElliotBayTrailMyrtlePark,05/26/2017 05:00:00 AM,48,-122,5,11,16
29790,ElliotBayTrailMyrtlePark,05/26/2017 06:00:00 AM,48,-122,24,38,62
29791,ElliotBayTrailMyrtlePark,05/26/2017 07:00:00 AM,48,-122,40,112,152
29792,ElliotBayTrailMyrtlePark,05/26/2017 08:00:00 AM,48,-122,57,153,210
29793,ElliotBayTrailMyrtlePark,05/26/2017 09:00:00 AM,48,-122,42,73,115
29794,ElliotBayTrailMyrtlePark,05/26/2017 10:00:00 AM,48,-122,24,35,59
29795,ElliotBayTrailMyrtlePark,05/26/2017 11:00:00 AM,48,-122,30,47,77
29796,ElliotBayTrailMyrtlePark,05/26/2017 12:00:00 PM,48,-122,51,32,83
29797,ElliotBayTrailMyrtlePark,05/26/2017 01:00:00 PM,48,-122,56,48,104
29798,ElliotBayTrailMyrtlePark,05/26/2017 02:00:00 PM,48,-122,75,45,120
29799,ElliotBayTrailMyrtlePark,05/26/2017 03:00:00 PM,48,-122,96,55,151
29800,ElliotBayTrailMyrtlePark,05/26/2017 04:00:00 PM,48,-122,143,81,224
29801,ElliotBayTrailMyrtlePark,05/26/2017 05:00:00 PM,48,-122,164,71,235
29802,ElliotBayTrailMyrtlePark,05/26/2017 06:00:00 PM,48,-122,88,40,128
29803,ElliotBayTrailMyrtlePark,05/26/2017 07:00:00 PM,48,-122,39,27,66
29804,ElliotBayTrailMyrtlePark,05/26/2017 08:00:00 PM,48,-122,28,21,49
29805,ElliotBayTrailMyrtlePark,05/26/2017 09:00:00 PM,48,-122,21,11,32
29806,ElliotBayTrailMyrtlePark,05/26/2017 10:00:00 PM,48,-122,4,11,15
29807,ElliotBayTrailMyrtlePark,05/26/2017 11:00:00 PM,48,-122,6,4,10
29808,ElliotBayTrailMyrtlePark,05/27/2017 12:00:00 AM,48,-122,3,7,10
29809,ElliotBayTrailMyrtlePark,05/27/2017 01:00:00 AM,48,-122,0,1,1
29810,ElliotBayTrailMyrtlePark,05/27/2017 02:00:00 AM,48,-122,1,0,1
29811,ElliotBayTrailMyrtlePark,05/27/2017 03:00:00 AM,48,-122,0,1,1
29812,ElliotBayTrailMyrtlePark,05/27/2017 04:00:00 AM,48,-122,0,1,1
29813,ElliotBayTrailMyrtlePark,05/27/2017 05:00:00 AM,48,-122,3,1,4
29814,ElliotBayTrailMyrtlePark,05/27/2017 06:00:00 AM,48,-122,2,16,18
29815,ElliotBayTrailMyrtlePark,05/27/2017 07:00:00 AM,48,-122,16,9,25
29816,ElliotBayTrailMyrtlePark,05/27/2017 08:00:00 AM,48,-122,23,39,62
29817,ElliotBayTrailMyrtlePark,05/27/2017 09:00:00 AM,48,-122,26,34,60
29818,ElliotBayTrailMyrtlePark,05/27/2017 10:00:00 AM,48,-122,62,63,125
29819,ElliotBayTrailMyrtlePark,05/27/2017 11:00:00 AM,48,-122,67,105,172
29820,ElliotBayTrailMyrtlePark,05/27/2017 12:00:00 PM,48,-122,52,83,135
29821,ElliotBayTrailMyrtlePark,05/27/2017 01:00:00 PM,48,-122,62,64,126
29822,ElliotBayTrailMyrtlePark,05/27/2017 02:00:00 PM,48,-122,133,57,190
29823,ElliotBayTrailMyrtlePark,05/27/2017 03:00:00 PM,48,-122,87,53,140
29824,ElliotBayTrailMyrtlePark,05/27/2017 04:00:00 PM,48,-122,71,45,116
29825,ElliotBayTrailMyrtlePark,05/27/2017 05:00:00 PM,48,-122,37,36,73
29826,ElliotBayTrailMyrtlePark,05/27/2017 06:00:00 PM,48,-122,45,51,96
29827,ElliotBayTrailMyrtlePark,05/27/2017 07:00:00 PM,48,-122,27,39,66
29828,ElliotBayTrailMyrtlePark,05/27/2017 08:00:00 PM,48,-122,31,26,57
29829,ElliotBayTrailMyrtlePark,05/27/2017 09:00:00 PM,48,-122,14,17,31
29830,ElliotBayTrailMyrtlePark,05/27/2017 10:00:00 PM,48,-122,11,8,19
29831,ElliotBayTrailMyrtlePark,05/27/2017 11:00:00 PM,48,-122,6,1,7
29832,ElliotBayTrailMyrtlePark,05/28/2017 12:00:00 AM,48,-122,1,1,2
29833,ElliotBayTrailMyrtlePark,05/28/2017 01:00:00 AM,48,-122,3,3,6
29834,ElliotBayTrailMyrtlePark,05/28/2017 02:00:00 AM,48,-122,3,1,4
29835,ElliotBayTrailMyrtlePark,05/28/2017 03:00:00 AM,48,-122,0,0,0
29836,ElliotBayTrailMyrtlePark,05/28/2017 04:00:00 AM,48,-122,1,0,1
29837,ElliotBayTrailMyrtlePark,05/28/2017 05:00:00 AM,48,-122,4,28,32
29838,ElliotBayTrailMyrtlePark,05/28/2017 06:00:00 AM,48,-122,8,138,146
29839,ElliotBayTrailMyrtlePark,05/28/2017 07:00:00 AM,48,-122,34,44,78
29840,ElliotBayTrailMyrtlePark,05/28/2017 08:00:00 AM,48,-122,58,36,94
29841,ElliotBayTrailMyrtlePark,05/28/2017 09:00:00 AM,48,-122,128,45,173
29842,ElliotBayTrailMyrtlePark,05/28/2017 10:00:00 AM,48,-122,160,79,239
29843,ElliotBayTrailMyrtlePark,05/28/2017 11:00:00 AM,48,-122,137,95,232
29844,ElliotBayTrailMyrtlePark,05/28/2017 12:00:00 PM,48,-122,106,46,152
29845,ElliotBayTrailMyrtlePark,05/28/2017 01:00:00 PM,48,-122,89,54,143
29846,ElliotBayTrailMyrtlePark,05/28/2017 02:00:00 PM,48,-122,70,65,135
29847,ElliotBayTrailMyrtlePark,05/28/2017 03:00:00 PM,48,-122,79,76,155
29848,ElliotBayTrailMyrtlePark,05/28/2017 04:00:00 PM,48,-122,49,57,106
29849,ElliotBayTrailMyrtlePark,05/28/2017 05:00:00 PM,48,-122,46,48,94
29850,ElliotBayTrailMyrtlePark,05/28/2017 06:00:00 PM,48,-122,44,43,87
29851,ElliotBayTrailMyrtlePark,05/28/2017 07:00:00 PM,48,-122,26,31,57
29852,ElliotBayTrailMyrtlePark,05/28/2017 08:00:00 PM,48,-122,23,17,40
29853,ElliotBayTrailMyrtlePark,05/28/2017 09:00:00 PM,48,-122,18,17,35
29854,ElliotBayTrailMyrtlePark,05/28/2017 10:00:00 PM,48,-122,9,3,12
29855,ElliotBayTrailMyrtlePark,05/28/2017 11:00:00 PM,48,-122,4,1,5
29856,ElliotBayTrailMyrtlePark,05/29/2017 12:00:00 AM,48,-122,3,1,4
29857,ElliotBayTrailMyrtlePark,05/29/2017 01:00:00 AM,48,-122,0,0,0
29858,ElliotBayTrailMyrtlePark,05/29/2017 02:00:00 AM,48,-122,1,0,1
29859,ElliotBayTrailMyrtlePark,05/29/2017 03:00:00 AM,48,-122,0,1,1
29860,ElliotBayTrailMyrtlePark,05/29/2017 04:00:00 AM,48,-122,0,0,0
29861,ElliotBayTrailMyrtlePark,05/29/2017 05:00:00 AM,48,-122,0,2,2
29862,ElliotBayTrailMyrtlePark,05/29/2017 06:00:00 AM,48,-122,4,6,10
29863,ElliotBayTrailMyrtlePark,05/29/2017 07:00:00 AM,48,-122,10,15,25
29864,ElliotBayTrailMyrtlePark,05/29/2017 08:00:00 AM,48,-122,25,20,45
29865,ElliotBayTrailMyrtlePark,05/29/2017 09:00:00 AM,48,-122,34,37,71
29866,ElliotBayTrailMyrtlePark,05/29/2017 10:00:00 AM,48,-122,37,50,87
29867,ElliotBayTrailMyrtlePark,05/29/2017 11:00:00 AM,48,-122,44,58,102
29868,ElliotBayTrailMyrtlePark,05/29/2017 12:00:00 PM,48,-122,68,58,126
29869,ElliotBayTrailMyrtlePark,05/29/2017 01:00:00 PM,48,-122,112,88,200
29870,ElliotBayTrailMyrtlePark,05/29/2017 02:00:00 PM,48,-122,99,60,159
29871,ElliotBayTrailMyrtlePark,05/29/2017 03:00:00 PM,48,-122,65,61,126
29872,ElliotBayTrailMyrtlePark,05/29/2017 04:00:00 PM,48,-122,99,66,165
29873,ElliotBayTrailMyrtlePark,05/29/2017 05:00:00 PM,48,-122,63,43,106
29874,ElliotBayTrailMyrtlePark,05/29/2017 06:00:00 PM,48,-122,38,58,96
29875,ElliotBayTrailMyrtlePark,05/29/2017 07:00:00 PM,48,-122,31,25,56
29876,ElliotBayTrailMyrtlePark,05/29/2017 08:00:00 PM,48,-122,14,25,39
29877,ElliotBayTrailMyrtlePark,05/29/2017 09:00:00 PM,48,-122,9,6,15
29878,ElliotBayTrailMyrtlePark,05/29/2017 10:00:00 PM,48,-122,7,4,11
29879,ElliotBayTrailMyrtlePark,05/29/2017 11:00:00 PM,48,-122,4,0,4
29880,ElliotBayTrailMyrtlePark,05/30/2017 12:00:00 AM,48,-122,1,2,3
29881,ElliotBayTrailMyrtlePark,05/30/2017 01:00:00 AM,48,-122,0,0,0
29882,ElliotBayTrailMyrtlePark,05/30/2017 02:00:00 AM,48,-122,2,0,2
29883,ElliotBayTrailMyrtlePark,05/30/2017 03:00:00 AM,48,-122,0,3,3
29884,ElliotBayTrailMyrtlePark,05/30/2017 04:00:00 AM,48,-122,1,2,3
29885,ElliotBayTrailMyrtlePark,05/30/2017 05:00:00 AM,48,-122,10,15,25
29886,ElliotBayTrailMyrtlePark,05/30/2017 06:00:00 AM,48,-122,21,36,57
29887,ElliotBayTrailMyrtlePark,05/30/2017 07:00:00 AM,48,-122,43,95,138
29888,ElliotBayTrailMyrtlePark,05/30/2017 08:00:00 AM,48,-122,34,142,176
29889,ElliotBayTrailMyrtlePark,05/30/2017 09:00:00 AM,48,-122,26,65,91
29890,ElliotBayTrailMyrtlePark,05/30/2017 10:00:00 AM,48,-122,8,16,24
29891,ElliotBayTrailMyrtlePark,05/30/2017 11:00:00 AM,48,-122,11,16,27
29892,ElliotBayTrailMyrtlePark,05/30/2017 12:00:00 PM,48,-122,12,16,28
29893,ElliotBayTrailMyrtlePark,05/30/2017 01:00:00 PM,48,-122,18,18,36
29894,ElliotBayTrailMyrtlePark,05/30/2017 02:00:00 PM,48,-122,14,10,24
29895,ElliotBayTrailMyrtlePark,05/30/2017 03:00:00 PM,48,-122,29,23,52
29896,ElliotBayTrailMyrtlePark,05/30/2017 04:00:00 PM,48,-122,62,33,95
29897,ElliotBayTrailMyrtlePark,05/30/2017 05:00:00 PM,48,-122,177,56,233
29898,ElliotBayTrailMyrtlePark,05/30/2017 06:00:00 PM,48,-122,81,32,113
29899,ElliotBayTrailMyrtlePark,05/30/2017 07:00:00 PM,48,-122,34,13,47
29900,ElliotBayTrailMyrtlePark,05/30/2017 08:00:00 PM,48,-122,13,12,25
29901,ElliotBayTrailMyrtlePark,05/30/2017 09:00:00 PM,48,-122,4,4,8
29902,ElliotBayTrailMyrtlePark,05/30/2017 10:00:00 PM,48,-122,5,0,5
29903,ElliotBayTrailMyrtlePark,05/30/2017 11:00:00 PM,48,-122,0,3,3
29904,ElliotBayTrailMyrtlePark,05/31/2017 12:00:00 AM,48,-122,0,0,0
29905,ElliotBayTrailMyrtlePark,05/31/2017 01:00:00 AM,48,-122,1,0,1
29906,ElliotBayTrailMyrtlePark,05/31/2017 02:00:00 AM,48,-122,0,1,1
29907,ElliotBayTrailMyrtlePark,05/31/2017 03:00:00 AM,48,-122,0,2,2
29908,ElliotBayTrailMyrtlePark,05/31/2017 04:00:00 AM,48,-122,2,1,3
29909,ElliotBayTrailMyrtlePark,05/31/2017 05:00:00 AM,48,-122,8,9,17
29910,ElliotBayTrailMyrtlePark,05/31/2017 06:00:00 AM,48,-122,30,46,76
29911,ElliotBayTrailMyrtlePark,05/31/2017 07:00:00 AM,48,-122,41,115,156
29912,ElliotBayTrailMyrtlePark,05/31/2017 08:00:00 AM,48,-122,47,182,229
29913,ElliotBayTrailMyrtlePark,05/31/2017 09:00:00 AM,48,-122,19,72,91
29914,ElliotBayTrailMyrtlePark,05/31/2017 10:00:00 AM,48,-122,12,31,43
29915,ElliotBayTrailMyrtlePark,05/31/2017 11:00:00 AM,48,-122,22,29,51
29916,ElliotBayTrailMyrtlePark,05/31/2017 12:00:00 PM,48,-122,25,28,53
29917,ElliotBayTrailMyrtlePark,05/31/2017 01:00:00 PM,48,-122,30,19,49
29918,ElliotBayTrailMyrtlePark,05/31/2017 02:00:00 PM,48,-122,30,31,61
29919,ElliotBayTrailMyrtlePark,05/31/2017 03:00:00 PM,48,-122,57,33,90
29920,ElliotBayTrailMyrtlePark,05/31/2017 04:00:00 PM,48,-122,83,60,143
29921,ElliotBayTrailMyrtlePark,05/31/2017 05:00:00 PM,48,-122,243,57,300
29922,ElliotBayTrailMyrtlePark,05/31/2017 06:00:00 PM,48,-122,116,58,174
29923,ElliotBayTrailMyrtlePark,05/31/2017 07:00:00 PM,48,-122,50,27,77
29924,ElliotBayTrailMyrtlePark,05/31/2017 08:00:00 PM,48,-122,33,13,46
29925,ElliotBayTrailMyrtlePark,05/31/2017 09:00:00 PM,48,-122,10,6,16
29926,ElliotBayTrailMyrtlePark,05/31/2017 10:00:00 PM,48,-122,11,4,15
29927,ElliotBayTrailMyrtlePark,05/31/2017 11:00:00 PM,48,-122,1,1,2
29928,ElliotBayTrailMyrtlePark,06/01/2017 12:00:00 AM,48,-122,2,0,2
29929,ElliotBayTrailMyrtlePark,06/01/2017 01:00:00 AM,48,-122,0,0,0
29930,ElliotBayTrailMyrtlePark,06/01/2017 02:00:00 AM,48,-122,0,1,1
29931,ElliotBayTrailMyrtlePark,06/01/2017 03:00:00 AM,48,-122,0,3,3
29932,ElliotBayTrailMyrtlePark,06/01/2017 04:00:00 AM,48,-122,0,2,2
29933,ElliotBayTrailMyrtlePark,06/01/2017 05:00:00 AM,48,-122,11,13,24
29934,ElliotBayTrailMyrtlePark,06/01/2017 06:00:00 AM,48,-122,17,40,57
29935,ElliotBayTrailMyrtlePark,06/01/2017 07:00:00 AM,48,-122,39,95,134
29936,ElliotBayTrailMyrtlePark,06/01/2017 08:00:00 AM,48,-122,39,130,169
29937,ElliotBayTrailMyrtlePark,06/01/2017 09:00:00 AM,48,-122,15,47,62
29938,ElliotBayTrailMyrtlePark,06/01/2017 10:00:00 AM,48,-122,12,30,42
29939,ElliotBayTrailMyrtlePark,06/01/2017 11:00:00 AM,48,-122,8,14,22
29940,ElliotBayTrailMyrtlePark,06/01/2017 12:00:00 PM,48,-122,14,15,29
29941,ElliotBayTrailMyrtlePark,06/01/2017 01:00:00 PM,48,-122,25,23,48
29942,ElliotBayTrailMyrtlePark,06/01/2017 02:00:00 PM,48,-122,29,29,58
29943,ElliotBayTrailMyrtlePark,06/01/2017 03:00:00 PM,48,-122,39,36,75
29944,ElliotBayTrailMyrtlePark,06/01/2017 04:00:00 PM,48,-122,97,45,142
29945,ElliotBayTrailMyrtlePark,06/01/2017 05:00:00 PM,48,-122,188,49,237
29946,ElliotBayTrailMyrtlePark,06/01/2017 06:00:00 PM,48,-122,116,57,173
29947,ElliotBayTrailMyrtlePark,06/01/2017 07:00:00 PM,48,-122,51,28,79
29948,ElliotBayTrailMyrtlePark,06/01/2017 08:00:00 PM,48,-122,21,9,30
29949,ElliotBayTrailMyrtlePark,06/01/2017 09:00:00 PM,48,-122,15,10,25
29950,ElliotBayTrailMyrtlePark,06/01/2017 10:00:00 PM,48,-122,8,1,9
29951,ElliotBayTrailMyrtlePark,06/01/2017 11:00:00 PM,48,-122,6,1,7
29952,ElliotBayTrailMyrtlePark,06/02/2017 12:00:00 AM,48,-122,1,1,2
29953,ElliotBayTrailMyrtlePark,06/02/2017 01:00:00 AM,48,-122,1,0,1
29954,ElliotBayTrailMyrtlePark,06/02/2017 02:00:00 AM,48,-122,2,1,3
29955,ElliotBayTrailMyrtlePark,06/02/2017 03:00:00 AM,48,-122,2,0,2
29956,ElliotBayTrailMyrtlePark,06/02/2017 04:00:00 AM,48,-122,0,2,2
29957,ElliotBayTrailMyrtlePark,06/02/2017 05:00:00 AM,48,-122,9,13,22
29958,ElliotBayTrailMyrtlePark,06/02/2017 06:00:00 AM,48,-122,27,43,70
29959,ElliotBayTrailMyrtlePark,06/02/2017 07:00:00 AM,48,-122,39,105,144
29960,ElliotBayTrailMyrtlePark,06/02/2017 08:00:00 AM,48,-122,43,157,200
29961,ElliotBayTrailMyrtlePark,06/02/2017 09:00:00 AM,48,-122,18,60,78
29962,ElliotBayTrailMyrtlePark,06/02/2017 10:00:00 AM,48,-122,12,19,31
29963,ElliotBayTrailMyrtlePark,06/02/2017 11:00:00 AM,48,-122,30,28,58
29964,ElliotBayTrailMyrtlePark,06/02/2017 12:00:00 PM,48,-122,25,26,51
29965,ElliotBayTrailMyrtlePark,06/02/2017 01:00:00 PM,48,-122,25,11,36
29966,ElliotBayTrailMyrtlePark,06/02/2017 02:00:00 PM,48,-122,41,39,80
29967,ElliotBayTrailMyrtlePark,06/02/2017 03:00:00 PM,48,-122,65,50,115
29968,ElliotBayTrailMyrtlePark,06/02/2017 04:00:00 PM,48,-122,134,64,198
29969,ElliotBayTrailMyrtlePark,06/02/2017 05:00:00 PM,48,-122,232,65,297
29970,ElliotBayTrailMyrtlePark,06/02/2017 06:00:00 PM,48,-122,106,46,152
29971,ElliotBayTrailMyrtlePark,06/02/2017 07:00:00 PM,48,-122,52,34,86
29972,ElliotBayTrailMyrtlePark,06/02/2017 08:00:00 PM,48,-122,23,20,43
29973,ElliotBayTrailMyrtlePark,06/02/2017 09:00:00 PM,48,-122,6,24,30
29974,ElliotBayTrailMyrtlePark,06/02/2017 10:00:00 PM,48,-122,3,4,7
29975,ElliotBayTrailMyrtlePark,06/02/2017 11:00:00 PM,48,-122,7,0,7
29976,ElliotBayTrailMyrtlePark,06/03/2017 12:00:00 AM,48,-122,2,0,2
29977,ElliotBayTrailMyrtlePark,06/03/2017 01:00:00 AM,48,-122,2,1,3
29978,ElliotBayTrailMyrtlePark,06/03/2017 02:00:00 AM,48,-122,2,0,2
29979,ElliotBayTrailMyrtlePark,06/03/2017 03:00:00 AM,48,-122,0,1,1
29980,ElliotBayTrailMyrtlePark,06/03/2017 04:00:00 AM,48,-122,0,0,0
29981,ElliotBayTrailMyrtlePark,06/03/2017 05:00:00 AM,48,-122,2,7,9
29982,ElliotBayTrailMyrtlePark,06/03/2017 06:00:00 AM,48,-122,8,2,10
29983,ElliotBayTrailMyrtlePark,06/03/2017 07:00:00 AM,48,-122,13,17,30
29984,ElliotBayTrailMyrtlePark,06/03/2017 08:00:00 AM,48,-122,13,25,38
29985,ElliotBayTrailMyrtlePark,06/03/2017 09:00:00 AM,48,-122,18,18,36
29986,ElliotBayTrailMyrtlePark,06/03/2017 10:00:00 AM,48,-122,43,42,85
29987,ElliotBayTrailMyrtlePark,06/03/2017 11:00:00 AM,48,-122,52,52,104
29988,ElliotBayTrailMyrtlePark,06/03/2017 12:00:00 PM,48,-122,53,46,99
29989,ElliotBayTrailMyrtlePark,06/03/2017 01:00:00 PM,48,-122,51,55,106
29990,ElliotBayTrailMyrtlePark,06/03/2017 02:00:00 PM,48,-122,46,30,76
29991,ElliotBayTrailMyrtlePark,06/03/2017 03:00:00 PM,48,-122,70,45,115
29992,ElliotBayTrailMyrtlePark,06/03/2017 04:00:00 PM,48,-122,50,36,86
29993,ElliotBayTrailMyrtlePark,06/03/2017 05:00:00 PM,48,-122,32,31,63
29994,ElliotBayTrailMyrtlePark,06/03/2017 06:00:00 PM,48,-122,38,24,62
29995,ElliotBayTrailMyrtlePark,06/03/2017 07:00:00 PM,48,-122,29,40,69
29996,ElliotBayTrailMyrtlePark,06/03/2017 08:00:00 PM,48,-122,6,12,18
29997,ElliotBayTrailMyrtlePark,06/03/2017 09:00:00 PM,48,-122,8,7,15
29998,ElliotBayTrailMyrtlePark,06/03/2017 10:00:00 PM,48,-122,9,2,11
29999,ElliotBayTrailMyrtlePark,06/03/2017 11:00:00 PM,48,-122,2,1,3
30000,ElliotBayTrailMyrtlePark,06/04/2017 12:00:00 AM,48,-122,3,0,3
30001,ElliotBayTrailMyrtlePark,06/04/2017 01:00:00 AM,48,-122,0,1,1
30002,ElliotBayTrailMyrtlePark,06/04/2017 02:00:00 AM,48,-122,3,0,3
30003,ElliotBayTrailMyrtlePark,06/04/2017 03:00:00 AM,48,-122,0,0,0
30004,ElliotBayTrailMyrtlePark,06/04/2017 04:00:00 AM,48,-122,0,0,0
30005,ElliotBayTrailMyrtlePark,06/04/2017 05:00:00 AM,48,-122,1,1,2
30006,ElliotBayTrailMyrtlePark,06/04/2017 06:00:00 AM,48,-122,1,5,6
30007,ElliotBayTrailMyrtlePark,06/04/2017 07:00:00 AM,48,-122,11,5,16
30008,ElliotBayTrailMyrtlePark,06/04/2017 08:00:00 AM,48,-122,28,15,43
30009,ElliotBayTrailMyrtlePark,06/04/2017 09:00:00 AM,48,-122,34,44,78
30010,ElliotBayTrailMyrtlePark,06/04/2017 10:00:00 AM,48,-122,44,42,86
30011,ElliotBayTrailMyrtlePark,06/04/2017 11:00:00 AM,48,-122,52,42,94
30012,ElliotBayTrailMyrtlePark,06/04/2017 12:00:00 PM,48,-122,49,40,89
30013,ElliotBayTrailMyrtlePark,06/04/2017 01:00:00 PM,48,-122,70,52,122
30014,ElliotBayTrailMyrtlePark,06/04/2017 02:00:00 PM,48,-122,61,63,124
30015,ElliotBayTrailMyrtlePark,06/04/2017 03:00:00 PM,48,-122,76,75,151
30016,ElliotBayTrailMyrtlePark,06/04/2017 04:00:00 PM,48,-122,65,82,147
30017,ElliotBayTrailMyrtlePark,06/04/2017 05:00:00 PM,48,-122,43,59,102
30018,ElliotBayTrailMyrtlePark,06/04/2017 06:00:00 PM,48,-122,34,25,59
30019,ElliotBayTrailMyrtlePark,06/04/2017 07:00:00 PM,48,-122,19,18,37
30020,ElliotBayTrailMyrtlePark,06/04/2017 08:00:00 PM,48,-122,21,17,38
30021,ElliotBayTrailMyrtlePark,06/04/2017 09:00:00 PM,48,-122,36,10,46
30022,ElliotBayTrailMyrtlePark,06/04/2017 10:00:00 PM,48,-122,6,2,8
30023,ElliotBayTrailMyrtlePark,06/04/2017 11:00:00 PM,48,-122,6,1,7
30024,ElliotBayTrailMyrtlePark,06/05/2017 12:00:00 AM,48,-122,0,3,3
30025,ElliotBayTrailMyrtlePark,06/05/2017 01:00:00 AM,48,-122,1,0,1
30026,ElliotBayTrailMyrtlePark,06/05/2017 02:00:00 AM,48,-122,0,0,0
30027,ElliotBayTrailMyrtlePark,06/05/2017 03:00:00 AM,48,-122,0,1,1
30028,ElliotBayTrailMyrtlePark,06/05/2017 04:00:00 AM,48,-122,1,1,2
30029,ElliotBayTrailMyrtlePark,06/05/2017 05:00:00 AM,48,-122,9,16,25
30030,ElliotBayTrailMyrtlePark,06/05/2017 06:00:00 AM,48,-122,26,47,73
30031,ElliotBayTrailMyrtlePark,06/05/2017 07:00:00 AM,48,-122,55,127,182
30032,ElliotBayTrailMyrtlePark,06/05/2017 08:00:00 AM,48,-122,45,199,244
30033,ElliotBayTrailMyrtlePark,06/05/2017 09:00:00 AM,48,-122,29,86,115
30034,ElliotBayTrailMyrtlePark,06/05/2017 10:00:00 AM,48,-122,22,31,53
30035,ElliotBayTrailMyrtlePark,06/05/2017 11:00:00 AM,48,-122,22,18,40
30036,ElliotBayTrailMyrtlePark,06/05/2017 12:00:00 PM,48,-122,28,24,52
30037,ElliotBayTrailMyrtlePark,06/05/2017 01:00:00 PM,48,-122,28,27,55
30038,ElliotBayTrailMyrtlePark,06/05/2017 02:00:00 PM,48,-122,36,22,58
30039,ElliotBayTrailMyrtlePark,06/05/2017 03:00:00 PM,48,-122,60,52,112
30040,ElliotBayTrailMyrtlePark,06/05/2017 04:00:00 PM,48,-122,131,67,198
30041,ElliotBayTrailMyrtlePark,06/05/2017 05:00:00 PM,48,-122,243,92,335
30042,ElliotBayTrailMyrtlePark,06/05/2017 06:00:00 PM,48,-122,153,48,201
30043,ElliotBayTrailMyrtlePark,06/05/2017 07:00:00 PM,48,-122,65,45,110
30044,ElliotBayTrailMyrtlePark,06/05/2017 08:00:00 PM,48,-122,32,32,64
30045,ElliotBayTrailMyrtlePark,06/05/2017 09:00:00 PM,48,-122,15,14,29
30046,ElliotBayTrailMyrtlePark,06/05/2017 10:00:00 PM,48,-122,8,8,16
30047,ElliotBayTrailMyrtlePark,06/05/2017 11:00:00 PM,48,-122,4,0,4
30048,ElliotBayTrailMyrtlePark,06/06/2017 12:00:00 AM,48,-122,3,1,4
30049,ElliotBayTrailMyrtlePark,06/06/2017 01:00:00 AM,48,-122,1,3,4
30050,ElliotBayTrailMyrtlePark,06/06/2017 02:00:00 AM,48,-122,1,1,2
30051,ElliotBayTrailMyrtlePark,06/06/2017 03:00:00 AM,48,-122,0,2,2
30052,ElliotBayTrailMyrtlePark,06/06/2017 04:00:00 AM,48,-122,5,4,9
30053,ElliotBayTrailMyrtlePark,06/06/2017 05:00:00 AM,48,-122,14,23,37
30054,ElliotBayTrailMyrtlePark,06/06/2017 06:00:00 AM,48,-122,40,53,93
30055,ElliotBayTrailMyrtlePark,06/06/2017 07:00:00 AM,48,-122,68,137,205
30056,ElliotBayTrailMyrtlePark,06/06/2017 08:00:00 AM,48,-122,59,183,242
30057,ElliotBayTrailMyrtlePark,06/06/2017 09:00:00 AM,48,-122,32,65,97
30058,ElliotBayTrailMyrtlePark,06/06/2017 10:00:00 AM,48,-122,27,39,66
30059,ElliotBayTrailMyrtlePark,06/06/2017 11:00:00 AM,48,-122,18,28,46
30060,ElliotBayTrailMyrtlePark,06/06/2017 12:00:00 PM,48,-122,28,25,53
30061,ElliotBayTrailMyrtlePark,06/06/2017 01:00:00 PM,48,-122,19,28,47
30062,ElliotBayTrailMyrtlePark,06/06/2017 02:00:00 PM,48,-122,42,43,85
30063,ElliotBayTrailMyrtlePark,06/06/2017 03:00:00 PM,48,-122,56,46,102
30064,ElliotBayTrailMyrtlePark,06/06/2017 04:00:00 PM,48,-122,120,58,178
30065,ElliotBayTrailMyrtlePark,06/06/2017 05:00:00 PM,48,-122,276,102,378
30066,ElliotBayTrailMyrtlePark,06/06/2017 06:00:00 PM,48,-122,158,76,234
30067,ElliotBayTrailMyrtlePark,06/06/2017 07:00:00 PM,48,-122,64,38,102
30068,ElliotBayTrailMyrtlePark,06/06/2017 08:00:00 PM,48,-122,37,27,64
30069,ElliotBayTrailMyrtlePark,06/06/2017 09:00:00 PM,48,-122,19,15,34
30070,ElliotBayTrailMyrtlePark,06/06/2017 10:00:00 PM,48,-122,14,2,16
30071,ElliotBayTrailMyrtlePark,06/06/2017 11:00:00 PM,48,-122,8,3,11
30072,ElliotBayTrailMyrtlePark,06/07/2017 12:00:00 AM,48,-122,1,0,1
30073,ElliotBayTrailMyrtlePark,06/07/2017 01:00:00 AM,48,-122,0,0,0
30074,ElliotBayTrailMyrtlePark,06/07/2017 02:00:00 AM,48,-122,1,1,2
30075,ElliotBayTrailMyrtlePark,06/07/2017 03:00:00 AM,48,-122,4,2,6
30076,ElliotBayTrailMyrtlePark,06/07/2017 04:00:00 AM,48,-122,2,3,5
30077,ElliotBayTrailMyrtlePark,06/07/2017 05:00:00 AM,48,-122,13,21,34
30078,ElliotBayTrailMyrtlePark,06/07/2017 06:00:00 AM,48,-122,33,59,92
30079,ElliotBayTrailMyrtlePark,06/07/2017 07:00:00 AM,48,-122,51,147,198
30080,ElliotBayTrailMyrtlePark,06/07/2017 08:00:00 AM,48,-122,64,194,258
30081,ElliotBayTrailMyrtlePark,06/07/2017 09:00:00 AM,48,-122,39,94,133
30082,ElliotBayTrailMyrtlePark,06/07/2017 10:00:00 AM,48,-122,19,22,41
30083,ElliotBayTrailMyrtlePark,06/07/2017 11:00:00 AM,48,-122,18,26,44
30084,ElliotBayTrailMyrtlePark,06/07/2017 12:00:00 PM,48,-122,42,39,81
30085,ElliotBayTrailMyrtlePark,06/07/2017 01:00:00 PM,48,-122,29,45,74
30086,ElliotBayTrailMyrtlePark,06/07/2017 02:00:00 PM,48,-122,38,24,62
30087,ElliotBayTrailMyrtlePark,06/07/2017 03:00:00 PM,48,-122,61,46,107
30088,ElliotBayTrailMyrtlePark,06/07/2017 04:00:00 PM,48,-122,130,68,198
30089,ElliotBayTrailMyrtlePark,06/07/2017 05:00:00 PM,48,-122,243,78,321
30090,ElliotBayTrailMyrtlePark,06/07/2017 06:00:00 PM,48,-122,147,52,199
30091,ElliotBayTrailMyrtlePark,06/07/2017 07:00:00 PM,48,-122,91,41,132
30092,ElliotBayTrailMyrtlePark,06/07/2017 08:00:00 PM,48,-122,20,14,34
30093,ElliotBayTrailMyrtlePark,06/07/2017 09:00:00 PM,48,-122,10,10,20
30094,ElliotBayTrailMyrtlePark,06/07/2017 10:00:00 PM,48,-122,12,5,17
30095,ElliotBayTrailMyrtlePark,06/07/2017 11:00:00 PM,48,-122,4,1,5
30096,ElliotBayTrailMyrtlePark,06/08/2017 12:00:00 AM,48,-122,0,1,1
30097,ElliotBayTrailMyrtlePark,06/08/2017 01:00:00 AM,48,-122,2,0,2
30098,ElliotBayTrailMyrtlePark,06/08/2017 02:00:00 AM,48,-122,1,0,1
30099,ElliotBayTrailMyrtlePark,06/08/2017 03:00:00 AM,48,-122,0,3,3
30100,ElliotBayTrailMyrtlePark,06/08/2017 04:00:00 AM,48,-122,1,1,2
30101,ElliotBayTrailMyrtlePark,06/08/2017 05:00:00 AM,48,-122,6,11,17
30102,ElliotBayTrailMyrtlePark,06/08/2017 06:00:00 AM,48,-122,14,18,32
30103,ElliotBayTrailMyrtlePark,06/08/2017 07:00:00 AM,48,-122,25,67,92
30104,ElliotBayTrailMyrtlePark,06/08/2017 08:00:00 AM,48,-122,30,66,96
30105,ElliotBayTrailMyrtlePark,06/08/2017 09:00:00 AM,48,-122,19,39,58
30106,ElliotBayTrailMyrtlePark,06/08/2017 10:00:00 AM,48,-122,4,18,22
30107,ElliotBayTrailMyrtlePark,06/08/2017 11:00:00 AM,48,-122,5,9,14
30108,ElliotBayTrailMyrtlePark,06/08/2017 12:00:00 PM,48,-122,9,4,13
30109,ElliotBayTrailMyrtlePark,06/08/2017 01:00:00 PM,48,-122,17,10,27
30110,ElliotBayTrailMyrtlePark,06/08/2017 02:00:00 PM,48,-122,13,16,29
30111,ElliotBayTrailMyrtlePark,06/08/2017 03:00:00 PM,48,-122,27,22,49
30112,ElliotBayTrailMyrtlePark,06/08/2017 04:00:00 PM,48,-122,60,27,87
30113,ElliotBayTrailMyrtlePark,06/08/2017 05:00:00 PM,48,-122,114,41,155
30114,ElliotBayTrailMyrtlePark,06/08/2017 06:00:00 PM,48,-122,63,29,92
30115,ElliotBayTrailMyrtlePark,06/08/2017 07:00:00 PM,48,-122,36,11,47
30116,ElliotBayTrailMyrtlePark,06/08/2017 08:00:00 PM,48,-122,21,23,44
30117,ElliotBayTrailMyrtlePark,06/08/2017 09:00:00 PM,48,-122,11,6,17
30118,ElliotBayTrailMyrtlePark,06/08/2017 10:00:00 PM,48,-122,13,3,16
30119,ElliotBayTrailMyrtlePark,06/08/2017 11:00:00 PM,48,-122,0,0,0
30120,ElliotBayTrailMyrtlePark,06/09/2017 12:00:00 AM,48,-122,4,1,5
30121,ElliotBayTrailMyrtlePark,06/09/2017 01:00:00 AM,48,-122,1,0,1
30122,ElliotBayTrailMyrtlePark,06/09/2017 02:00:00 AM,48,-122,1,1,2
30123,ElliotBayTrailMyrtlePark,06/09/2017 03:00:00 AM,48,-122,0,0,0
30124,ElliotBayTrailMyrtlePark,06/09/2017 04:00:00 AM,48,-122,5,5,10
30125,ElliotBayTrailMyrtlePark,06/09/2017 05:00:00 AM,48,-122,8,15,23
30126,ElliotBayTrailMyrtlePark,06/09/2017 06:00:00 AM,48,-122,24,35,59
30127,ElliotBayTrailMyrtlePark,06/09/2017 07:00:00 AM,48,-122,36,86,122
30128,ElliotBayTrailMyrtlePark,06/09/2017 08:00:00 AM,48,-122,39,114,153
30129,ElliotBayTrailMyrtlePark,06/09/2017 09:00:00 AM,48,-122,19,65,84
30130,ElliotBayTrailMyrtlePark,06/09/2017 10:00:00 AM,48,-122,18,29,47
30131,ElliotBayTrailMyrtlePark,06/09/2017 11:00:00 AM,48,-122,16,16,32
30132,ElliotBayTrailMyrtlePark,06/09/2017 12:00:00 PM,48,-122,25,23,48
30133,ElliotBayTrailMyrtlePark,06/09/2017 01:00:00 PM,48,-122,29,35,64
30134,ElliotBayTrailMyrtlePark,06/09/2017 02:00:00 PM,48,-122,26,18,44
30135,ElliotBayTrailMyrtlePark,06/09/2017 03:00:00 PM,48,-122,52,30,82
30136,ElliotBayTrailMyrtlePark,06/09/2017 04:00:00 PM,48,-122,100,56,156
30137,ElliotBayTrailMyrtlePark,06/09/2017 05:00:00 PM,48,-122,149,63,212
30138,ElliotBayTrailMyrtlePark,06/09/2017 06:00:00 PM,48,-122,66,28,94
30139,ElliotBayTrailMyrtlePark,06/09/2017 07:00:00 PM,48,-122,22,9,31
30140,ElliotBayTrailMyrtlePark,06/09/2017 08:00:00 PM,48,-122,15,15,30
30141,ElliotBayTrailMyrtlePark,06/09/2017 09:00:00 PM,48,-122,10,7,17
30142,ElliotBayTrailMyrtlePark,06/09/2017 10:00:00 PM,48,-122,6,4,10
30143,ElliotBayTrailMyrtlePark,06/09/2017 11:00:00 PM,48,-122,8,1,9
30144,ElliotBayTrailMyrtlePark,06/10/2017 12:00:00 AM,48,-122,2,0,2
30145,ElliotBayTrailMyrtlePark,06/10/2017 01:00:00 AM,48,-122,1,0,1
30146,ElliotBayTrailMyrtlePark,06/10/2017 02:00:00 AM,48,-122,0,0,0
30147,ElliotBayTrailMyrtlePark,06/10/2017 03:00:00 AM,48,-122,0,2,2
30148,ElliotBayTrailMyrtlePark,06/10/2017 04:00:00 AM,48,-122,1,1,2
30149,ElliotBayTrailMyrtlePark,06/10/2017 05:00:00 AM,48,-122,0,0,0
30150,ElliotBayTrailMyrtlePark,06/10/2017 06:00:00 AM,48,-122,5,6,11
30151,ElliotBayTrailMyrtlePark,06/10/2017 07:00:00 AM,48,-122,12,17,29
30152,ElliotBayTrailMyrtlePark,06/10/2017 08:00:00 AM,48,-122,34,22,56
30153,ElliotBayTrailMyrtlePark,06/10/2017 09:00:00 AM,48,-122,25,30,55
30154,ElliotBayTrailMyrtlePark,06/10/2017 10:00:00 AM,48,-122,45,48,93
30155,ElliotBayTrailMyrtlePark,06/10/2017 11:00:00 AM,48,-122,68,68,136
30156,ElliotBayTrailMyrtlePark,06/10/2017 12:00:00 PM,48,-122,64,57,121
30157,ElliotBayTrailMyrtlePark,06/10/2017 01:00:00 PM,48,-122,59,62,121
30158,ElliotBayTrailMyrtlePark,06/10/2017 02:00:00 PM,48,-122,75,57,132
30159,ElliotBayTrailMyrtlePark,06/10/2017 03:00:00 PM,48,-122,81,73,154
30160,ElliotBayTrailMyrtlePark,06/10/2017 04:00:00 PM,48,-122,41,58,99
30161,ElliotBayTrailMyrtlePark,06/10/2017 05:00:00 PM,48,-122,50,54,104
30162,ElliotBayTrailMyrtlePark,06/10/2017 06:00:00 PM,48,-122,32,47,79
30163,ElliotBayTrailMyrtlePark,06/10/2017 07:00:00 PM,48,-122,40,30,70
30164,ElliotBayTrailMyrtlePark,06/10/2017 08:00:00 PM,48,-122,19,13,32
30165,ElliotBayTrailMyrtlePark,06/10/2017 09:00:00 PM,48,-122,9,8,17
30166,ElliotBayTrailMyrtlePark,06/10/2017 10:00:00 PM,48,-122,8,7,15
30167,ElliotBayTrailMyrtlePark,06/10/2017 11:00:00 PM,48,-122,19,5,24
30168,ElliotBayTrailMyrtlePark,06/11/2017 12:00:00 AM,48,-122,0,1,1
30169,ElliotBayTrailMyrtlePark,06/11/2017 01:00:00 AM,48,-122,9,8,17
30170,ElliotBayTrailMyrtlePark,06/11/2017 02:00:00 AM,48,-122,1,3,4
30171,ElliotBayTrailMyrtlePark,06/11/2017 03:00:00 AM,48,-122,0,0,0
30172,ElliotBayTrailMyrtlePark,06/11/2017 04:00:00 AM,48,-122,0,4,4
30173,ElliotBayTrailMyrtlePark,06/11/2017 05:00:00 AM,48,-122,5,6,11
30174,ElliotBayTrailMyrtlePark,06/11/2017 06:00:00 AM,48,-122,4,4,8
30175,ElliotBayTrailMyrtlePark,06/11/2017 07:00:00 AM,48,-122,9,7,16
30176,ElliotBayTrailMyrtlePark,06/11/2017 08:00:00 AM,48,-122,33,24,57
30177,ElliotBayTrailMyrtlePark,06/11/2017 09:00:00 AM,48,-122,25,30,55
30178,ElliotBayTrailMyrtlePark,06/11/2017 10:00:00 AM,48,-122,45,48,93
30179,ElliotBayTrailMyrtlePark,06/11/2017 11:00:00 AM,48,-122,40,49,89
30180,ElliotBayTrailMyrtlePark,06/11/2017 12:00:00 PM,48,-122,49,65,114
30181,ElliotBayTrailMyrtlePark,06/11/2017 01:00:00 PM,48,-122,64,58,122
30182,ElliotBayTrailMyrtlePark,06/11/2017 02:00:00 PM,48,-122,83,60,143
30183,ElliotBayTrailMyrtlePark,06/11/2017 03:00:00 PM,48,-122,82,54,136
30184,ElliotBayTrailMyrtlePark,06/11/2017 04:00:00 PM,48,-122,69,59,128
30185,ElliotBayTrailMyrtlePark,06/11/2017 05:00:00 PM,48,-122,55,58,113
30186,ElliotBayTrailMyrtlePark,06/11/2017 06:00:00 PM,48,-122,33,37,70
30187,ElliotBayTrailMyrtlePark,06/11/2017 07:00:00 PM,48,-122,27,16,43
30188,ElliotBayTrailMyrtlePark,06/11/2017 08:00:00 PM,48,-122,21,11,32
30189,ElliotBayTrailMyrtlePark,06/11/2017 09:00:00 PM,48,-122,4,9,13
30190,ElliotBayTrailMyrtlePark,06/11/2017 10:00:00 PM,48,-122,1,3,4
30191,ElliotBayTrailMyrtlePark,06/11/2017 11:00:00 PM,48,-122,0,0,0
30192,ElliotBayTrailMyrtlePark,06/12/2017 12:00:00 AM,48,-122,0,0,0
30193,ElliotBayTrailMyrtlePark,06/12/2017 01:00:00 AM,48,-122,1,0,1
30194,ElliotBayTrailMyrtlePark,06/12/2017 02:00:00 AM,48,-122,1,0,1
30195,ElliotBayTrailMyrtlePark,06/12/2017 03:00:00 AM,48,-122,0,2,2
30196,ElliotBayTrailMyrtlePark,06/12/2017 04:00:00 AM,48,-122,1,3,4
30197,ElliotBayTrailMyrtlePark,06/12/2017 05:00:00 AM,48,-122,9,13,22
30198,ElliotBayTrailMyrtlePark,06/12/2017 06:00:00 AM,48,-122,23,43,66
30199,ElliotBayTrailMyrtlePark,06/12/2017 07:00:00 AM,48,-122,41,118,159
30200,ElliotBayTrailMyrtlePark,06/12/2017 08:00:00 AM,48,-122,38,181,219
30201,ElliotBayTrailMyrtlePark,06/12/2017 09:00:00 AM,48,-122,34,78,112
30202,ElliotBayTrailMyrtlePark,06/12/2017 10:00:00 AM,48,-122,14,18,32
30203,ElliotBayTrailMyrtlePark,06/12/2017 11:00:00 AM,48,-122,15,20,35
30204,ElliotBayTrailMyrtlePark,06/12/2017 12:00:00 PM,48,-122,21,20,41
30205,ElliotBayTrailMyrtlePark,06/12/2017 01:00:00 PM,48,-122,22,16,38
30206,ElliotBayTrailMyrtlePark,06/12/2017 02:00:00 PM,48,-122,23,18,41
30207,ElliotBayTrailMyrtlePark,06/12/2017 03:00:00 PM,48,-122,48,39,87
30208,ElliotBayTrailMyrtlePark,06/12/2017 04:00:00 PM,48,-122,95,40,135
30209,ElliotBayTrailMyrtlePark,06/12/2017 05:00:00 PM,48,-122,210,55,265
30210,ElliotBayTrailMyrtlePark,06/12/2017 06:00:00 PM,48,-122,148,35,183
30211,ElliotBayTrailMyrtlePark,06/12/2017 07:00:00 PM,48,-122,35,21,56
30212,ElliotBayTrailMyrtlePark,06/12/2017 08:00:00 PM,48,-122,16,9,25
30213,ElliotBayTrailMyrtlePark,06/12/2017 09:00:00 PM,48,-122,7,7,14
30214,ElliotBayTrailMyrtlePark,06/12/2017 10:00:00 PM,48,-122,4,7,11
30215,ElliotBayTrailMyrtlePark,06/12/2017 11:00:00 PM,48,-122,5,0,5
30216,ElliotBayTrailMyrtlePark,06/13/2017 12:00:00 AM,48,-122,0,0,0
30217,ElliotBayTrailMyrtlePark,06/13/2017 01:00:00 AM,48,-122,1,0,1
30218,ElliotBayTrailMyrtlePark,06/13/2017 02:00:00 AM,48,-122,0,1,1
30219,ElliotBayTrailMyrtlePark,06/13/2017 03:00:00 AM,48,-122,0,1,1
30220,ElliotBayTrailMyrtlePark,06/13/2017 04:00:00 AM,48,-122,4,3,7
30221,ElliotBayTrailMyrtlePark,06/13/2017 05:00:00 AM,48,-122,12,11,23
30222,ElliotBayTrailMyrtlePark,06/13/2017 06:00:00 AM,48,-122,20,33,53
30223,ElliotBayTrailMyrtlePark,06/13/2017 07:00:00 AM,48,-122,34,95,129
30224,ElliotBayTrailMyrtlePark,06/13/2017 08:00:00 AM,48,-122,35,134,169
30225,ElliotBayTrailMyrtlePark,06/13/2017 09:00:00 AM,48,-122,25,61,86
30226,ElliotBayTrailMyrtlePark,06/13/2017 10:00:00 AM,48,-122,14,23,37
30227,ElliotBayTrailMyrtlePark,06/13/2017 11:00:00 AM,48,-122,16,23,39
30228,ElliotBayTrailMyrtlePark,06/13/2017 12:00:00 PM,48,-122,14,17,31
30229,ElliotBayTrailMyrtlePark,06/13/2017 01:00:00 PM,48,-122,14,12,26
30230,ElliotBayTrailMyrtlePark,06/13/2017 02:00:00 PM,48,-122,22,19,41
30231,ElliotBayTrailMyrtlePark,06/13/2017 03:00:00 PM,48,-122,29,33,62
30232,ElliotBayTrailMyrtlePark,06/13/2017 04:00:00 PM,48,-122,69,40,109
30233,ElliotBayTrailMyrtlePark,06/13/2017 05:00:00 PM,48,-122,186,52,238
30234,ElliotBayTrailMyrtlePark,06/13/2017 06:00:00 PM,48,-122,118,40,158
30235,ElliotBayTrailMyrtlePark,06/13/2017 07:00:00 PM,48,-122,42,19,61
30236,ElliotBayTrailMyrtlePark,06/13/2017 08:00:00 PM,48,-122,20,21,41
30237,ElliotBayTrailMyrtlePark,06/13/2017 09:00:00 PM,48,-122,11,3,14
30238,ElliotBayTrailMyrtlePark,06/13/2017 10:00:00 PM,48,-122,10,2,12
30239,ElliotBayTrailMyrtlePark,06/13/2017 11:00:00 PM,48,-122,1,0,1
30240,ElliotBayTrailMyrtlePark,06/14/2017 12:00:00 AM,48,-122,0,0,0
30241,ElliotBayTrailMyrtlePark,06/14/2017 01:00:00 AM,48,-122,0,0,0
30242,ElliotBayTrailMyrtlePark,06/14/2017 02:00:00 AM,48,-122,1,1,2
30243,ElliotBayTrailMyrtlePark,06/14/2017 03:00:00 AM,48,-122,0,3,3
30244,ElliotBayTrailMyrtlePark,06/14/2017 04:00:00 AM,48,-122,1,3,4
30245,ElliotBayTrailMyrtlePark,06/14/2017 05:00:00 AM,48,-122,14,17,31
30246,ElliotBayTrailMyrtlePark,06/14/2017 06:00:00 AM,48,-122,38,43,81
30247,ElliotBayTrailMyrtlePark,06/14/2017 07:00:00 AM,48,-122,52,129,181
30248,ElliotBayTrailMyrtlePark,06/14/2017 08:00:00 AM,48,-122,43,166,209
30249,ElliotBayTrailMyrtlePark,06/14/2017 09:00:00 AM,48,-122,28,81,109
30250,ElliotBayTrailMyrtlePark,06/14/2017 10:00:00 AM,48,-122,19,23,42
30251,ElliotBayTrailMyrtlePark,06/14/2017 11:00:00 AM,48,-122,15,19,34
30252,ElliotBayTrailMyrtlePark,06/14/2017 12:00:00 PM,48,-122,35,27,62
30253,ElliotBayTrailMyrtlePark,06/14/2017 01:00:00 PM,48,-122,39,24,63
30254,ElliotBayTrailMyrtlePark,06/14/2017 02:00:00 PM,48,-122,20,32,52
30255,ElliotBayTrailMyrtlePark,06/14/2017 03:00:00 PM,48,-122,44,32,76
30256,ElliotBayTrailMyrtlePark,06/14/2017 04:00:00 PM,48,-122,111,56,167
30257,ElliotBayTrailMyrtlePark,06/14/2017 05:00:00 PM,48,-122,251,48,299
30258,ElliotBayTrailMyrtlePark,06/14/2017 06:00:00 PM,48,-122,137,46,183
30259,ElliotBayTrailMyrtlePark,06/14/2017 07:00:00 PM,48,-122,45,35,80
30260,ElliotBayTrailMyrtlePark,06/14/2017 08:00:00 PM,48,-122,41,19,60
30261,ElliotBayTrailMyrtlePark,06/14/2017 09:00:00 PM,48,-122,6,10,16
30262,ElliotBayTrailMyrtlePark,06/14/2017 10:00:00 PM,48,-122,14,5,19
30263,ElliotBayTrailMyrtlePark,06/14/2017 11:00:00 PM,48,-122,3,2,5
30264,ElliotBayTrailMyrtlePark,06/15/2017 12:00:00 AM,48,-122,0,2,2
30265,ElliotBayTrailMyrtlePark,06/15/2017 01:00:00 AM,48,-122,1,0,1
30266,ElliotBayTrailMyrtlePark,06/15/2017 02:00:00 AM,48,-122,1,1,2
30267,ElliotBayTrailMyrtlePark,06/15/2017 03:00:00 AM,48,-122,0,1,1
30268,ElliotBayTrailMyrtlePark,06/15/2017 04:00:00 AM,48,-122,2,1,3
30269,ElliotBayTrailMyrtlePark,06/15/2017 05:00:00 AM,48,-122,11,15,26
30270,ElliotBayTrailMyrtlePark,06/15/2017 06:00:00 AM,48,-122,12,20,32
30271,ElliotBayTrailMyrtlePark,06/15/2017 07:00:00 AM,48,-122,31,71,102
30272,ElliotBayTrailMyrtlePark,06/15/2017 08:00:00 AM,48,-122,29,95,124
30273,ElliotBayTrailMyrtlePark,06/15/2017 09:00:00 AM,48,-122,11,41,52
30274,ElliotBayTrailMyrtlePark,06/15/2017 10:00:00 AM,48,-122,6,14,20
30275,ElliotBayTrailMyrtlePark,06/15/2017 11:00:00 AM,48,-122,6,6,12
30276,ElliotBayTrailMyrtlePark,06/15/2017 12:00:00 PM,48,-122,2,4,6
30277,ElliotBayTrailMyrtlePark,06/15/2017 01:00:00 PM,48,-122,14,3,17
30278,ElliotBayTrailMyrtlePark,06/15/2017 02:00:00 PM,48,-122,10,13,23
30279,ElliotBayTrailMyrtlePark,06/15/2017 03:00:00 PM,48,-122,11,17,28
30280,ElliotBayTrailMyrtlePark,06/15/2017 04:00:00 PM,48,-122,57,32,89
30281,ElliotBayTrailMyrtlePark,06/15/2017 05:00:00 PM,48,-122,88,18,106
30282,ElliotBayTrailMyrtlePark,06/15/2017 06:00:00 PM,48,-122,63,19,82
30283,ElliotBayTrailMyrtlePark,06/15/2017 07:00:00 PM,48,-122,22,5,27
30284,ElliotBayTrailMyrtlePark,06/15/2017 08:00:00 PM,48,-122,3,5,8
30285,ElliotBayTrailMyrtlePark,06/15/2017 09:00:00 PM,48,-122,4,4,8
30286,ElliotBayTrailMyrtlePark,06/15/2017 10:00:00 PM,48,-122,6,0,6
30287,ElliotBayTrailMyrtlePark,06/15/2017 11:00:00 PM,48,-122,4,0,4
30288,ElliotBayTrailMyrtlePark,06/16/2017 12:00:00 AM,48,-122,0,0,0
30289,ElliotBayTrailMyrtlePark,06/16/2017 01:00:00 AM,48,-122,1,0,1
30290,ElliotBayTrailMyrtlePark,06/16/2017 02:00:00 AM,48,-122,1,1,2
30291,ElliotBayTrailMyrtlePark,06/16/2017 03:00:00 AM,48,-122,0,0,0
30292,ElliotBayTrailMyrtlePark,06/16/2017 04:00:00 AM,48,-122,3,1,4
30293,ElliotBayTrailMyrtlePark,06/16/2017 05:00:00 AM,48,-122,8,12,20
30294,ElliotBayTrailMyrtlePark,06/16/2017 06:00:00 AM,48,-122,20,34,54
30295,ElliotBayTrailMyrtlePark,06/16/2017 07:00:00 AM,48,-122,26,96,122
30296,ElliotBayTrailMyrtlePark,06/16/2017 08:00:00 AM,48,-122,43,129,172
30297,ElliotBayTrailMyrtlePark,06/16/2017 09:00:00 AM,48,-122,17,54,71
30298,ElliotBayTrailMyrtlePark,06/16/2017 10:00:00 AM,48,-122,15,28,43
30299,ElliotBayTrailMyrtlePark,06/16/2017 11:00:00 AM,48,-122,17,23,40
30300,ElliotBayTrailMyrtlePark,06/16/2017 12:00:00 PM,48,-122,14,14,28
30301,ElliotBayTrailMyrtlePark,06/16/2017 01:00:00 PM,48,-122,31,25,56
30302,ElliotBayTrailMyrtlePark,06/16/2017 02:00:00 PM,48,-122,34,23,57
30303,ElliotBayTrailMyrtlePark,06/16/2017 03:00:00 PM,48,-122,73,42,115
30304,ElliotBayTrailMyrtlePark,06/16/2017 04:00:00 PM,48,-122,104,61,165
30305,ElliotBayTrailMyrtlePark,06/16/2017 05:00:00 PM,48,-122,146,42,188
30306,ElliotBayTrailMyrtlePark,06/16/2017 06:00:00 PM,48,-122,88,40,128
30307,ElliotBayTrailMyrtlePark,06/16/2017 07:00:00 PM,48,-122,52,28,80
30308,ElliotBayTrailMyrtlePark,06/16/2017 08:00:00 PM,48,-122,24,19,43
30309,ElliotBayTrailMyrtlePark,06/16/2017 09:00:00 PM,48,-122,20,17,37
30310,ElliotBayTrailMyrtlePark,06/16/2017 10:00:00 PM,48,-122,7,6,13
30311,ElliotBayTrailMyrtlePark,06/16/2017 11:00:00 PM,48,-122,2,2,4
30312,ElliotBayTrailMyrtlePark,06/17/2017 12:00:00 AM,48,-122,9,0,9
30313,ElliotBayTrailMyrtlePark,06/17/2017 01:00:00 AM,48,-122,3,0,3
30314,ElliotBayTrailMyrtlePark,06/17/2017 02:00:00 AM,48,-122,0,0,0
30315,ElliotBayTrailMyrtlePark,06/17/2017 03:00:00 AM,48,-122,0,0,0
30316,ElliotBayTrailMyrtlePark,06/17/2017 04:00:00 AM,48,-122,0,0,0
30317,ElliotBayTrailMyrtlePark,06/17/2017 05:00:00 AM,48,-122,5,2,7
30318,ElliotBayTrailMyrtlePark,06/17/2017 06:00:00 AM,48,-122,5,6,11
30319,ElliotBayTrailMyrtlePark,06/17/2017 07:00:00 AM,48,-122,8,21,29
30320,ElliotBayTrailMyrtlePark,06/17/2017 08:00:00 AM,48,-122,20,31,51
30321,ElliotBayTrailMyrtlePark,06/17/2017 09:00:00 AM,48,-122,30,43,73
30322,ElliotBayTrailMyrtlePark,06/17/2017 10:00:00 AM,48,-122,32,23,55
30323,ElliotBayTrailMyrtlePark,06/17/2017 11:00:00 AM,48,-122,72,37,109
30324,ElliotBayTrailMyrtlePark,06/17/2017 12:00:00 PM,48,-122,64,39,103
30325,ElliotBayTrailMyrtlePark,06/17/2017 01:00:00 PM,48,-122,53,42,95
30326,ElliotBayTrailMyrtlePark,06/17/2017 02:00:00 PM,48,-122,48,38,86
30327,ElliotBayTrailMyrtlePark,06/17/2017 03:00:00 PM,48,-122,39,52,91
30328,ElliotBayTrailMyrtlePark,06/17/2017 04:00:00 PM,48,-122,37,51,88
30329,ElliotBayTrailMyrtlePark,06/17/2017 05:00:00 PM,48,-122,30,22,52
30330,ElliotBayTrailMyrtlePark,06/17/2017 06:00:00 PM,48,-122,17,14,31
30331,ElliotBayTrailMyrtlePark,06/17/2017 07:00:00 PM,48,-122,10,7,17
30332,ElliotBayTrailMyrtlePark,06/17/2017 08:00:00 PM,48,-122,7,7,14
30333,ElliotBayTrailMyrtlePark,06/17/2017 09:00:00 PM,48,-122,3,3,6
30334,ElliotBayTrailMyrtlePark,06/17/2017 10:00:00 PM,48,-122,3,6,9
30335,ElliotBayTrailMyrtlePark,06/17/2017 11:00:00 PM,48,-122,3,0,3
30336,ElliotBayTrailMyrtlePark,06/18/2017 12:00:00 AM,48,-122,0,2,2
30337,ElliotBayTrailMyrtlePark,06/18/2017 01:00:00 AM,48,-122,1,0,1
30338,ElliotBayTrailMyrtlePark,06/18/2017 02:00:00 AM,48,-122,1,1,2
30339,ElliotBayTrailMyrtlePark,06/18/2017 03:00:00 AM,48,-122,0,1,1
30340,ElliotBayTrailMyrtlePark,06/18/2017 04:00:00 AM,48,-122,0,0,0
30341,ElliotBayTrailMyrtlePark,06/18/2017 05:00:00 AM,48,-122,2,1,3
30342,ElliotBayTrailMyrtlePark,06/18/2017 06:00:00 AM,48,-122,6,4,10
30343,ElliotBayTrailMyrtlePark,06/18/2017 07:00:00 AM,48,-122,16,14,30
30344,ElliotBayTrailMyrtlePark,06/18/2017 08:00:00 AM,48,-122,14,13,27
30345,ElliotBayTrailMyrtlePark,06/18/2017 09:00:00 AM,48,-122,26,25,51
30346,ElliotBayTrailMyrtlePark,06/18/2017 10:00:00 AM,48,-122,28,44,72
30347,ElliotBayTrailMyrtlePark,06/18/2017 11:00:00 AM,48,-122,54,53,107
30348,ElliotBayTrailMyrtlePark,06/18/2017 12:00:00 PM,48,-122,56,58,114
30349,ElliotBayTrailMyrtlePark,06/18/2017 01:00:00 PM,48,-122,48,53,101
30350,ElliotBayTrailMyrtlePark,06/18/2017 02:00:00 PM,48,-122,51,35,86
30351,ElliotBayTrailMyrtlePark,06/18/2017 03:00:00 PM,48,-122,64,53,117
30352,ElliotBayTrailMyrtlePark,06/18/2017 04:00:00 PM,48,-122,48,45,93
30353,ElliotBayTrailMyrtlePark,06/18/2017 05:00:00 PM,48,-122,46,27,73
30354,ElliotBayTrailMyrtlePark,06/18/2017 06:00:00 PM,48,-122,37,34,71
30355,ElliotBayTrailMyrtlePark,06/18/2017 07:00:00 PM,48,-122,15,27,42
30356,ElliotBayTrailMyrtlePark,06/18/2017 08:00:00 PM,48,-122,15,16,31
30357,ElliotBayTrailMyrtlePark,06/18/2017 09:00:00 PM,48,-122,10,9,19
30358,ElliotBayTrailMyrtlePark,06/18/2017 10:00:00 PM,48,-122,6,3,9
30359,ElliotBayTrailMyrtlePark,06/18/2017 11:00:00 PM,48,-122,1,1,2
30360,ElliotBayTrailMyrtlePark,06/19/2017 12:00:00 AM,48,-122,0,0,0
30361,ElliotBayTrailMyrtlePark,06/19/2017 01:00:00 AM,48,-122,0,0,0
30362,ElliotBayTrailMyrtlePark,06/19/2017 02:00:00 AM,48,-122,0,0,0
30363,ElliotBayTrailMyrtlePark,06/19/2017 03:00:00 AM,48,-122,0,1,1
30364,ElliotBayTrailMyrtlePark,06/19/2017 04:00:00 AM,48,-122,1,1,2
30365,ElliotBayTrailMyrtlePark,06/19/2017 05:00:00 AM,48,-122,5,12,17
30366,ElliotBayTrailMyrtlePark,06/19/2017 06:00:00 AM,48,-122,22,41,63
30367,ElliotBayTrailMyrtlePark,06/19/2017 07:00:00 AM,48,-122,49,114,163
30368,ElliotBayTrailMyrtlePark,06/19/2017 08:00:00 AM,48,-122,47,166,213
30369,ElliotBayTrailMyrtlePark,06/19/2017 09:00:00 AM,48,-122,24,87,111
30370,ElliotBayTrailMyrtlePark,06/19/2017 10:00:00 AM,48,-122,16,26,42
30371,ElliotBayTrailMyrtlePark,06/19/2017 11:00:00 AM,48,-122,11,15,26
30372,ElliotBayTrailMyrtlePark,06/19/2017 12:00:00 PM,48,-122,38,22,60
30373,ElliotBayTrailMyrtlePark,06/19/2017 01:00:00 PM,48,-122,21,17,38
30374,ElliotBayTrailMyrtlePark,06/19/2017 02:00:00 PM,48,-122,28,26,54
30375,ElliotBayTrailMyrtlePark,06/19/2017 03:00:00 PM,48,-122,48,34,82
30376,ElliotBayTrailMyrtlePark,06/19/2017 04:00:00 PM,48,-122,99,68,167
30377,ElliotBayTrailMyrtlePark,06/19/2017 05:00:00 PM,48,-122,218,55,273
30378,ElliotBayTrailMyrtlePark,06/19/2017 06:00:00 PM,48,-122,130,52,182
30379,ElliotBayTrailMyrtlePark,06/19/2017 07:00:00 PM,48,-122,51,28,79
30380,ElliotBayTrailMyrtlePark,06/19/2017 08:00:00 PM,48,-122,23,22,45
30381,ElliotBayTrailMyrtlePark,06/19/2017 09:00:00 PM,48,-122,12,9,21
30382,ElliotBayTrailMyrtlePark,06/19/2017 10:00:00 PM,48,-122,16,4,20
30383,ElliotBayTrailMyrtlePark,06/19/2017 11:00:00 PM,48,-122,3,2,5
30384,ElliotBayTrailMyrtlePark,06/20/2017 12:00:00 AM,48,-122,2,0,2
30385,ElliotBayTrailMyrtlePark,06/20/2017 01:00:00 AM,48,-122,2,2,4
30386,ElliotBayTrailMyrtlePark,06/20/2017 02:00:00 AM,48,-122,2,1,3
30387,ElliotBayTrailMyrtlePark,06/20/2017 03:00:00 AM,48,-122,0,2,2
30388,ElliotBayTrailMyrtlePark,06/20/2017 04:00:00 AM,48,-122,1,0,1
30389,ElliotBayTrailMyrtlePark,06/20/2017 05:00:00 AM,48,-122,10,14,24
30390,ElliotBayTrailMyrtlePark,06/20/2017 06:00:00 AM,48,-122,19,39,58
30391,ElliotBayTrailMyrtlePark,06/20/2017 07:00:00 AM,48,-122,36,95,131
30392,ElliotBayTrailMyrtlePark,06/20/2017 08:00:00 AM,48,-122,28,124,152
30393,ElliotBayTrailMyrtlePark,06/20/2017 09:00:00 AM,48,-122,37,55,92
30394,ElliotBayTrailMyrtlePark,06/20/2017 10:00:00 AM,48,-122,15,20,35
30395,ElliotBayTrailMyrtlePark,06/20/2017 11:00:00 AM,48,-122,15,12,27
30396,ElliotBayTrailMyrtlePark,06/20/2017 12:00:00 PM,48,-122,31,29,60
30397,ElliotBayTrailMyrtlePark,06/20/2017 01:00:00 PM,48,-122,16,18,34
30398,ElliotBayTrailMyrtlePark,06/20/2017 02:00:00 PM,48,-122,13,22,35
30399,ElliotBayTrailMyrtlePark,06/20/2017 03:00:00 PM,48,-122,40,25,65
30400,ElliotBayTrailMyrtlePark,06/20/2017 04:00:00 PM,48,-122,88,44,132
30401,ElliotBayTrailMyrtlePark,06/20/2017 05:00:00 PM,48,-122,164,58,222
30402,ElliotBayTrailMyrtlePark,06/20/2017 06:00:00 PM,48,-122,113,40,153
30403,ElliotBayTrailMyrtlePark,06/20/2017 07:00:00 PM,48,-122,37,24,61
30404,ElliotBayTrailMyrtlePark,06/20/2017 08:00:00 PM,48,-122,16,12,28
30405,ElliotBayTrailMyrtlePark,06/20/2017 09:00:00 PM,48,-122,10,8,18
30406,ElliotBayTrailMyrtlePark,06/20/2017 10:00:00 PM,48,-122,11,2,13
30407,ElliotBayTrailMyrtlePark,06/20/2017 11:00:00 PM,48,-122,3,1,4
30408,ElliotBayTrailMyrtlePark,06/21/2017 12:00:00 AM,48,-122,0,0,0
30409,ElliotBayTrailMyrtlePark,06/21/2017 01:00:00 AM,48,-122,2,0,2
30410,ElliotBayTrailMyrtlePark,06/21/2017 02:00:00 AM,48,-122,0,1,1
30411,ElliotBayTrailMyrtlePark,06/21/2017 03:00:00 AM,48,-122,2,1,3
30412,ElliotBayTrailMyrtlePark,06/21/2017 04:00:00 AM,48,-122,1,1,2
30413,ElliotBayTrailMyrtlePark,06/21/2017 05:00:00 AM,48,-122,6,19,25
30414,ElliotBayTrailMyrtlePark,06/21/2017 06:00:00 AM,48,-122,28,45,73
30415,ElliotBayTrailMyrtlePark,06/21/2017 07:00:00 AM,48,-122,44,124,168
30416,ElliotBayTrailMyrtlePark,06/21/2017 08:00:00 AM,48,-122,53,174,227
30417,ElliotBayTrailMyrtlePark,06/21/2017 09:00:00 AM,48,-122,36,83,119
30418,ElliotBayTrailMyrtlePark,06/21/2017 10:00:00 AM,48,-122,22,31,53
30419,ElliotBayTrailMyrtlePark,06/21/2017 11:00:00 AM,48,-122,16,26,42
30420,ElliotBayTrailMyrtlePark,06/21/2017 12:00:00 PM,48,-122,24,29,53
30421,ElliotBayTrailMyrtlePark,06/21/2017 01:00:00 PM,48,-122,17,19,36
30422,ElliotBayTrailMyrtlePark,06/21/2017 02:00:00 PM,48,-122,29,27,56
30423,ElliotBayTrailMyrtlePark,06/21/2017 03:00:00 PM,48,-122,51,38,89
30424,ElliotBayTrailMyrtlePark,06/21/2017 04:00:00 PM,48,-122,133,63,196
30425,ElliotBayTrailMyrtlePark,06/21/2017 05:00:00 PM,48,-122,235,93,328
30426,ElliotBayTrailMyrtlePark,06/21/2017 06:00:00 PM,48,-122,162,69,231
30427,ElliotBayTrailMyrtlePark,06/21/2017 07:00:00 PM,48,-122,55,65,120
30428,ElliotBayTrailMyrtlePark,06/21/2017 08:00:00 PM,48,-122,46,41,87
30429,ElliotBayTrailMyrtlePark,06/21/2017 09:00:00 PM,48,-122,36,18,54
30430,ElliotBayTrailMyrtlePark,06/21/2017 10:00:00 PM,48,-122,36,11,47
30431,ElliotBayTrailMyrtlePark,06/21/2017 11:00:00 PM,48,-122,12,2,14
30432,ElliotBayTrailMyrtlePark,06/22/2017 12:00:00 AM,48,-122,2,0,2
30433,ElliotBayTrailMyrtlePark,06/22/2017 01:00:00 AM,48,-122,0,1,1
30434,ElliotBayTrailMyrtlePark,06/22/2017 02:00:00 AM,48,-122,1,1,2
30435,ElliotBayTrailMyrtlePark,06/22/2017 03:00:00 AM,48,-122,0,2,2
30436,ElliotBayTrailMyrtlePark,06/22/2017 04:00:00 AM,48,-122,0,1,1
30437,ElliotBayTrailMyrtlePark,06/22/2017 05:00:00 AM,48,-122,13,8,21
30438,ElliotBayTrailMyrtlePark,06/22/2017 06:00:00 AM,48,-122,29,43,72
30439,ElliotBayTrailMyrtlePark,06/22/2017 07:00:00 AM,48,-122,57,137,194
30440,ElliotBayTrailMyrtlePark,06/22/2017 08:00:00 AM,48,-122,99,136,235
30441,ElliotBayTrailMyrtlePark,06/22/2017 09:00:00 AM,48,-122,41,71,112
30442,ElliotBayTrailMyrtlePark,06/22/2017 10:00:00 AM,48,-122,28,46,74
30443,ElliotBayTrailMyrtlePark,06/22/2017 11:00:00 AM,48,-122,33,46,79
30444,ElliotBayTrailMyrtlePark,06/22/2017 12:00:00 PM,48,-122,19,20,39
30445,ElliotBayTrailMyrtlePark,06/22/2017 01:00:00 PM,48,-122,32,29,61
30446,ElliotBayTrailMyrtlePark,06/22/2017 02:00:00 PM,48,-122,44,34,78
30447,ElliotBayTrailMyrtlePark,06/22/2017 03:00:00 PM,48,-122,64,42,106
30448,ElliotBayTrailMyrtlePark,06/22/2017 04:00:00 PM,48,-122,127,56,183
30449,ElliotBayTrailMyrtlePark,06/22/2017 05:00:00 PM,48,-122,211,100,311
30450,ElliotBayTrailMyrtlePark,06/22/2017 06:00:00 PM,48,-122,158,73,231
30451,ElliotBayTrailMyrtlePark,06/22/2017 07:00:00 PM,48,-122,71,60,131
30452,ElliotBayTrailMyrtlePark,06/22/2017 08:00:00 PM,48,-122,42,33,75
30453,ElliotBayTrailMyrtlePark,06/22/2017 09:00:00 PM,48,-122,22,26,48
30454,ElliotBayTrailMyrtlePark,06/22/2017 10:00:00 PM,48,-122,11,5,16
30455,ElliotBayTrailMyrtlePark,06/22/2017 11:00:00 PM,48,-122,4,2,6
30456,ElliotBayTrailMyrtlePark,06/23/2017 12:00:00 AM,48,-122,3,2,5
30457,ElliotBayTrailMyrtlePark,06/23/2017 01:00:00 AM,48,-122,2,0,2
30458,ElliotBayTrailMyrtlePark,06/23/2017 02:00:00 AM,48,-122,0,1,1
30459,ElliotBayTrailMyrtlePark,06/23/2017 03:00:00 AM,48,-122,0,1,1
30460,ElliotBayTrailMyrtlePark,06/23/2017 04:00:00 AM,48,-122,0,3,3
30461,ElliotBayTrailMyrtlePark,06/23/2017 05:00:00 AM,48,-122,6,11,17
30462,ElliotBayTrailMyrtlePark,06/23/2017 06:00:00 AM,48,-122,18,32,50
30463,ElliotBayTrailMyrtlePark,06/23/2017 07:00:00 AM,48,-122,47,98,145
30464,ElliotBayTrailMyrtlePark,06/23/2017 08:00:00 AM,48,-122,59,141,200
30465,ElliotBayTrailMyrtlePark,06/23/2017 09:00:00 AM,48,-122,48,78,126
30466,ElliotBayTrailMyrtlePark,06/23/2017 10:00:00 AM,48,-122,24,47,71
30467,ElliotBayTrailMyrtlePark,06/23/2017 11:00:00 AM,48,-122,32,37,69
30468,ElliotBayTrailMyrtlePark,06/23/2017 12:00:00 PM,48,-122,24,39,63
30469,ElliotBayTrailMyrtlePark,06/23/2017 01:00:00 PM,48,-122,28,25,53
30470,ElliotBayTrailMyrtlePark,06/23/2017 02:00:00 PM,48,-122,54,35,89
30471,ElliotBayTrailMyrtlePark,06/23/2017 03:00:00 PM,48,-122,87,42,129
30472,ElliotBayTrailMyrtlePark,06/23/2017 04:00:00 PM,48,-122,150,69,219
30473,ElliotBayTrailMyrtlePark,06/23/2017 05:00:00 PM,48,-122,205,91,296
30474,ElliotBayTrailMyrtlePark,06/23/2017 06:00:00 PM,48,-122,89,45,134
30475,ElliotBayTrailMyrtlePark,06/23/2017 07:00:00 PM,48,-122,44,34,78
30476,ElliotBayTrailMyrtlePark,06/23/2017 08:00:00 PM,48,-122,35,19,54
30477,ElliotBayTrailMyrtlePark,06/23/2017 09:00:00 PM,48,-122,15,15,30
30478,ElliotBayTrailMyrtlePark,06/23/2017 10:00:00 PM,48,-122,9,8,17
30479,ElliotBayTrailMyrtlePark,06/23/2017 11:00:00 PM,48,-122,1,2,3
30480,ElliotBayTrailMyrtlePark,06/24/2017 12:00:00 AM,48,-122,1,0,1
30481,ElliotBayTrailMyrtlePark,06/24/2017 01:00:00 AM,48,-122,3,0,3
30482,ElliotBayTrailMyrtlePark,06/24/2017 02:00:00 AM,48,-122,3,1,4
30483,ElliotBayTrailMyrtlePark,06/24/2017 03:00:00 AM,48,-122,1,2,3
30484,ElliotBayTrailMyrtlePark,06/24/2017 04:00:00 AM,48,-122,0,0,0
30485,ElliotBayTrailMyrtlePark,06/24/2017 05:00:00 AM,48,-122,1,5,6
30486,ElliotBayTrailMyrtlePark,06/24/2017 06:00:00 AM,48,-122,5,4,9
30487,ElliotBayTrailMyrtlePark,06/24/2017 07:00:00 AM,48,-122,21,31,52
30488,ElliotBayTrailMyrtlePark,06/24/2017 08:00:00 AM,48,-122,36,32,68
30489,ElliotBayTrailMyrtlePark,06/24/2017 09:00:00 AM,48,-122,43,34,77
30490,ElliotBayTrailMyrtlePark,06/24/2017 10:00:00 AM,48,-122,79,72,151
30491,ElliotBayTrailMyrtlePark,06/24/2017 11:00:00 AM,48,-122,65,90,155
30492,ElliotBayTrailMyrtlePark,06/24/2017 12:00:00 PM,48,-122,52,58,110
30493,ElliotBayTrailMyrtlePark,06/24/2017 01:00:00 PM,48,-122,76,62,138
30494,ElliotBayTrailMyrtlePark,06/24/2017 02:00:00 PM,48,-122,71,51,122
30495,ElliotBayTrailMyrtlePark,06/24/2017 03:00:00 PM,48,-122,64,52,116
30496,ElliotBayTrailMyrtlePark,06/24/2017 04:00:00 PM,48,-122,55,56,111
30497,ElliotBayTrailMyrtlePark,06/24/2017 05:00:00 PM,48,-122,50,44,94
30498,ElliotBayTrailMyrtlePark,06/24/2017 06:00:00 PM,48,-122,58,57,115
30499,ElliotBayTrailMyrtlePark,06/24/2017 07:00:00 PM,48,-122,42,32,74
30500,ElliotBayTrailMyrtlePark,06/24/2017 08:00:00 PM,48,-122,27,24,51
30501,ElliotBayTrailMyrtlePark,06/24/2017 09:00:00 PM,48,-122,30,16,46
30502,ElliotBayTrailMyrtlePark,06/24/2017 10:00:00 PM,48,-122,15,4,19
30503,ElliotBayTrailMyrtlePark,06/24/2017 11:00:00 PM,48,-122,14,4,18
30504,ElliotBayTrailMyrtlePark,06/25/2017 12:00:00 AM,48,-122,22,5,27
30505,ElliotBayTrailMyrtlePark,06/25/2017 01:00:00 AM,48,-122,3,1,4
30506,ElliotBayTrailMyrtlePark,06/25/2017 02:00:00 AM,48,-122,0,0,0
30507,ElliotBayTrailMyrtlePark,06/25/2017 03:00:00 AM,48,-122,1,0,1
30508,ElliotBayTrailMyrtlePark,06/25/2017 04:00:00 AM,48,-122,1,1,2
30509,ElliotBayTrailMyrtlePark,06/25/2017 05:00:00 AM,48,-122,0,3,3
30510,ElliotBayTrailMyrtlePark,06/25/2017 06:00:00 AM,48,-122,8,14,22
30511,ElliotBayTrailMyrtlePark,06/25/2017 07:00:00 AM,48,-122,18,23,41
30512,ElliotBayTrailMyrtlePark,06/25/2017 08:00:00 AM,48,-122,34,33,67
30513,ElliotBayTrailMyrtlePark,06/25/2017 09:00:00 AM,48,-122,59,69,128
30514,ElliotBayTrailMyrtlePark,06/25/2017 10:00:00 AM,48,-122,44,71,115
30515,ElliotBayTrailMyrtlePark,06/25/2017 11:00:00 AM,48,-122,56,66,122
30516,ElliotBayTrailMyrtlePark,06/25/2017 12:00:00 PM,48,-122,59,63,122
30517,ElliotBayTrailMyrtlePark,06/25/2017 01:00:00 PM,48,-122,72,50,122
30518,ElliotBayTrailMyrtlePark,06/25/2017 02:00:00 PM,48,-122,54,26,80
30519,ElliotBayTrailMyrtlePark,06/25/2017 03:00:00 PM,48,-122,63,40,103
30520,ElliotBayTrailMyrtlePark,06/25/2017 04:00:00 PM,48,-122,66,45,111
30521,ElliotBayTrailMyrtlePark,06/25/2017 05:00:00 PM,48,-122,41,40,81
30522,ElliotBayTrailMyrtlePark,06/25/2017 06:00:00 PM,48,-122,34,29,63
30523,ElliotBayTrailMyrtlePark,06/25/2017 07:00:00 PM,48,-122,31,22,53
30524,ElliotBayTrailMyrtlePark,06/25/2017 08:00:00 PM,48,-122,30,24,54
30525,ElliotBayTrailMyrtlePark,06/25/2017 09:00:00 PM,48,-122,14,23,37
30526,ElliotBayTrailMyrtlePark,06/25/2017 10:00:00 PM,48,-122,11,5,16
30527,ElliotBayTrailMyrtlePark,06/25/2017 11:00:00 PM,48,-122,3,0,3
30528,ElliotBayTrailMyrtlePark,06/26/2017 12:00:00 AM,48,-122,0,2,2
30529,ElliotBayTrailMyrtlePark,06/26/2017 01:00:00 AM,48,-122,1,0,1
30530,ElliotBayTrailMyrtlePark,06/26/2017 02:00:00 AM,48,-122,0,0,0
30531,ElliotBayTrailMyrtlePark,06/26/2017 03:00:00 AM,48,-122,0,2,2
30532,ElliotBayTrailMyrtlePark,06/26/2017 04:00:00 AM,48,-122,0,1,1
30533,ElliotBayTrailMyrtlePark,06/26/2017 05:00:00 AM,48,-122,7,10,17
30534,ElliotBayTrailMyrtlePark,06/26/2017 06:00:00 AM,48,-122,25,50,75
30535,ElliotBayTrailMyrtlePark,06/26/2017 07:00:00 AM,48,-122,45,120,165
30536,ElliotBayTrailMyrtlePark,06/26/2017 08:00:00 AM,48,-122,39,170,209
30537,ElliotBayTrailMyrtlePark,06/26/2017 09:00:00 AM,48,-122,32,79,111
30538,ElliotBayTrailMyrtlePark,06/26/2017 10:00:00 AM,48,-122,15,29,44
30539,ElliotBayTrailMyrtlePark,06/26/2017 11:00:00 AM,48,-122,15,20,35
30540,ElliotBayTrailMyrtlePark,06/26/2017 12:00:00 PM,48,-122,29,27,56
30541,ElliotBayTrailMyrtlePark,06/26/2017 01:00:00 PM,48,-122,19,25,44
30542,ElliotBayTrailMyrtlePark,06/26/2017 02:00:00 PM,48,-122,24,21,45
30543,ElliotBayTrailMyrtlePark,06/26/2017 03:00:00 PM,48,-122,56,31,87
30544,ElliotBayTrailMyrtlePark,06/26/2017 04:00:00 PM,48,-122,121,64,185
30545,ElliotBayTrailMyrtlePark,06/26/2017 05:00:00 PM,48,-122,241,62,303
30546,ElliotBayTrailMyrtlePark,06/26/2017 06:00:00 PM,48,-122,127,41,168
30547,ElliotBayTrailMyrtlePark,06/26/2017 07:00:00 PM,48,-122,59,31,90
30548,ElliotBayTrailMyrtlePark,06/26/2017 08:00:00 PM,48,-122,31,25,56
30549,ElliotBayTrailMyrtlePark,06/26/2017 09:00:00 PM,48,-122,11,6,17
30550,ElliotBayTrailMyrtlePark,06/26/2017 10:00:00 PM,48,-122,6,6,12
30551,ElliotBayTrailMyrtlePark,06/26/2017 11:00:00 PM,48,-122,2,1,3
30552,ElliotBayTrailMyrtlePark,06/27/2017 12:00:00 AM,48,-122,2,2,4
30553,ElliotBayTrailMyrtlePark,06/27/2017 01:00:00 AM,48,-122,1,1,2
30554,ElliotBayTrailMyrtlePark,06/27/2017 02:00:00 AM,48,-122,0,0,0
30555,ElliotBayTrailMyrtlePark,06/27/2017 03:00:00 AM,48,-122,2,3,5
30556,ElliotBayTrailMyrtlePark,06/27/2017 04:00:00 AM,48,-122,2,1,3
30557,ElliotBayTrailMyrtlePark,06/27/2017 05:00:00 AM,48,-122,10,19,29
30558,ElliotBayTrailMyrtlePark,06/27/2017 06:00:00 AM,48,-122,24,43,67
30559,ElliotBayTrailMyrtlePark,06/27/2017 07:00:00 AM,48,-122,38,120,158
30560,ElliotBayTrailMyrtlePark,06/27/2017 08:00:00 AM,48,-122,44,168,212
30561,ElliotBayTrailMyrtlePark,06/27/2017 09:00:00 AM,48,-122,38,61,99
30562,ElliotBayTrailMyrtlePark,06/27/2017 10:00:00 AM,48,-122,9,34,43
30563,ElliotBayTrailMyrtlePark,06/27/2017 11:00:00 AM,48,-122,20,10,30
30564,ElliotBayTrailMyrtlePark,06/27/2017 12:00:00 PM,48,-122,25,22,47
30565,ElliotBayTrailMyrtlePark,06/27/2017 01:00:00 PM,48,-122,17,16,33
30566,ElliotBayTrailMyrtlePark,06/27/2017 02:00:00 PM,48,-122,22,25,47
30567,ElliotBayTrailMyrtlePark,06/27/2017 03:00:00 PM,48,-122,43,35,78
30568,ElliotBayTrailMyrtlePark,06/27/2017 04:00:00 PM,48,-122,131,45,176
30569,ElliotBayTrailMyrtlePark,06/27/2017 05:00:00 PM,48,-122,209,82,291
30570,ElliotBayTrailMyrtlePark,06/27/2017 06:00:00 PM,48,-122,130,60,190
30571,ElliotBayTrailMyrtlePark,06/27/2017 07:00:00 PM,48,-122,59,37,96
30572,ElliotBayTrailMyrtlePark,06/27/2017 08:00:00 PM,48,-122,39,36,75
30573,ElliotBayTrailMyrtlePark,06/27/2017 09:00:00 PM,48,-122,11,18,29
30574,ElliotBayTrailMyrtlePark,06/27/2017 10:00:00 PM,48,-122,14,9,23
30575,ElliotBayTrailMyrtlePark,06/27/2017 11:00:00 PM,48,-122,6,2,8
30576,ElliotBayTrailMyrtlePark,06/28/2017 12:00:00 AM,48,-122,0,1,1
30577,ElliotBayTrailMyrtlePark,06/28/2017 01:00:00 AM,48,-122,0,1,1
30578,ElliotBayTrailMyrtlePark,06/28/2017 02:00:00 AM,48,-122,2,1,3
30579,ElliotBayTrailMyrtlePark,06/28/2017 03:00:00 AM,48,-122,0,2,2
30580,ElliotBayTrailMyrtlePark,06/28/2017 04:00:00 AM,48,-122,0,1,1
30581,ElliotBayTrailMyrtlePark,06/28/2017 05:00:00 AM,48,-122,5,13,18
30582,ElliotBayTrailMyrtlePark,06/28/2017 06:00:00 AM,48,-122,27,48,75
30583,ElliotBayTrailMyrtlePark,06/28/2017 07:00:00 AM,48,-122,45,118,163
30584,ElliotBayTrailMyrtlePark,06/28/2017 08:00:00 AM,48,-122,41,174,215
30585,ElliotBayTrailMyrtlePark,06/28/2017 09:00:00 AM,48,-122,31,75,106
30586,ElliotBayTrailMyrtlePark,06/28/2017 10:00:00 AM,48,-122,16,26,42
30587,ElliotBayTrailMyrtlePark,06/28/2017 11:00:00 AM,48,-122,16,26,42
30588,ElliotBayTrailMyrtlePark,06/28/2017 12:00:00 PM,48,-122,23,28,51
30589,ElliotBayTrailMyrtlePark,06/28/2017 01:00:00 PM,48,-122,27,28,55
30590,ElliotBayTrailMyrtlePark,06/28/2017 02:00:00 PM,48,-122,32,15,47
30591,ElliotBayTrailMyrtlePark,06/28/2017 03:00:00 PM,48,-122,33,43,76
30592,ElliotBayTrailMyrtlePark,06/28/2017 04:00:00 PM,48,-122,109,64,173
30593,ElliotBayTrailMyrtlePark,06/28/2017 05:00:00 PM,48,-122,197,85,282
30594,ElliotBayTrailMyrtlePark,06/28/2017 06:00:00 PM,48,-122,144,57,201
30595,ElliotBayTrailMyrtlePark,06/28/2017 07:00:00 PM,48,-122,69,37,106
30596,ElliotBayTrailMyrtlePark,06/28/2017 08:00:00 PM,48,-122,32,27,59
30597,ElliotBayTrailMyrtlePark,06/28/2017 09:00:00 PM,48,-122,17,19,36
30598,ElliotBayTrailMyrtlePark,06/28/2017 10:00:00 PM,48,-122,9,5,14
30599,ElliotBayTrailMyrtlePark,06/28/2017 11:00:00 PM,48,-122,3,2,5
30600,ElliotBayTrailMyrtlePark,06/29/2017 12:00:00 AM,48,-122,1,1,2
30601,ElliotBayTrailMyrtlePark,06/29/2017 01:00:00 AM,48,-122,1,0,1
30602,ElliotBayTrailMyrtlePark,06/29/2017 02:00:00 AM,48,-122,0,1,1
30603,ElliotBayTrailMyrtlePark,06/29/2017 03:00:00 AM,48,-122,0,2,2
30604,ElliotBayTrailMyrtlePark,06/29/2017 04:00:00 AM,48,-122,0,2,2
30605,ElliotBayTrailMyrtlePark,06/29/2017 05:00:00 AM,48,-122,10,16,26
30606,ElliotBayTrailMyrtlePark,06/29/2017 06:00:00 AM,48,-122,25,43,68
30607,ElliotBayTrailMyrtlePark,06/29/2017 07:00:00 AM,48,-122,40,118,158
30608,ElliotBayTrailMyrtlePark,06/29/2017 08:00:00 AM,48,-122,80,148,228
30609,ElliotBayTrailMyrtlePark,06/29/2017 09:00:00 AM,48,-122,32,71,103
30610,ElliotBayTrailMyrtlePark,06/29/2017 10:00:00 AM,48,-122,20,43,63
30611,ElliotBayTrailMyrtlePark,06/29/2017 11:00:00 AM,48,-122,22,24,46
30612,ElliotBayTrailMyrtlePark,06/29/2017 12:00:00 PM,48,-122,19,21,40
30613,ElliotBayTrailMyrtlePark,06/29/2017 01:00:00 PM,48,-122,29,33,62
30614,ElliotBayTrailMyrtlePark,06/29/2017 02:00:00 PM,48,-122,38,47,85
30615,ElliotBayTrailMyrtlePark,06/29/2017 03:00:00 PM,48,-122,59,47,106
30616,ElliotBayTrailMyrtlePark,06/29/2017 04:00:00 PM,48,-122,121,59,180
30617,ElliotBayTrailMyrtlePark,06/29/2017 05:00:00 PM,48,-122,194,83,277
30618,ElliotBayTrailMyrtlePark,06/29/2017 06:00:00 PM,48,-122,143,58,201
30619,ElliotBayTrailMyrtlePark,06/29/2017 07:00:00 PM,48,-122,74,41,115
30620,ElliotBayTrailMyrtlePark,06/29/2017 08:00:00 PM,48,-122,40,33,73
30621,ElliotBayTrailMyrtlePark,06/29/2017 09:00:00 PM,48,-122,20,12,32
30622,ElliotBayTrailMyrtlePark,06/29/2017 10:00:00 PM,48,-122,10,9,19
30623,ElliotBayTrailMyrtlePark,06/29/2017 11:00:00 PM,48,-122,4,1,5
30624,ElliotBayTrailMyrtlePark,06/30/2017 12:00:00 AM,48,-122,3,0,3
30625,ElliotBayTrailMyrtlePark,06/30/2017 01:00:00 AM,48,-122,0,0,0
30626,ElliotBayTrailMyrtlePark,06/30/2017 02:00:00 AM,48,-122,0,1,1
30627,ElliotBayTrailMyrtlePark,06/30/2017 03:00:00 AM,48,-122,0,1,1
30628,ElliotBayTrailMyrtlePark,06/30/2017 04:00:00 AM,48,-122,1,3,4
30629,ElliotBayTrailMyrtlePark,06/30/2017 05:00:00 AM,48,-122,7,18,25
30630,ElliotBayTrailMyrtlePark,06/30/2017 06:00:00 AM,48,-122,19,37,56
30631,ElliotBayTrailMyrtlePark,06/30/2017 07:00:00 AM,48,-122,34,122,156
30632,ElliotBayTrailMyrtlePark,06/30/2017 08:00:00 AM,48,-122,57,137,194
30633,ElliotBayTrailMyrtlePark,06/30/2017 09:00:00 AM,48,-122,32,68,100
30634,ElliotBayTrailMyrtlePark,06/30/2017 10:00:00 AM,48,-122,28,39,67
30635,ElliotBayTrailMyrtlePark,06/30/2017 11:00:00 AM,48,-122,23,56,79
30636,ElliotBayTrailMyrtlePark,06/30/2017 12:00:00 PM,48,-122,30,26,56
30637,ElliotBayTrailMyrtlePark,06/30/2017 01:00:00 PM,48,-122,46,55,101
30638,ElliotBayTrailMyrtlePark,06/30/2017 02:00:00 PM,48,-122,54,34,88
30639,ElliotBayTrailMyrtlePark,06/30/2017 03:00:00 PM,48,-122,91,50,141
30640,ElliotBayTrailMyrtlePark,06/30/2017 04:00:00 PM,48,-122,136,67,203
30641,ElliotBayTrailMyrtlePark,06/30/2017 05:00:00 PM,48,-122,168,54,222
30642,ElliotBayTrailMyrtlePark,06/30/2017 06:00:00 PM,48,-122,115,50,165
30643,ElliotBayTrailMyrtlePark,06/30/2017 07:00:00 PM,48,-122,65,39,104
30644,ElliotBayTrailMyrtlePark,06/30/2017 08:00:00 PM,48,-122,22,26,48
30645,ElliotBayTrailMyrtlePark,06/30/2017 09:00:00 PM,48,-122,13,16,29
30646,ElliotBayTrailMyrtlePark,06/30/2017 10:00:00 PM,48,-122,11,14,25
30647,ElliotBayTrailMyrtlePark,06/30/2017 11:00:00 PM,48,-122,3,1,4
30648,ElliotBayTrailMyrtlePark,07/01/2017 12:00:00 AM,48,-122,2,1,3
30649,ElliotBayTrailMyrtlePark,07/01/2017 01:00:00 AM,48,-122,9,1,10
30650,ElliotBayTrailMyrtlePark,07/01/2017 02:00:00 AM,48,-122,0,1,1
30651,ElliotBayTrailMyrtlePark,07/01/2017 03:00:00 AM,48,-122,0,1,1
30652,ElliotBayTrailMyrtlePark,07/01/2017 04:00:00 AM,48,-122,2,0,2
30653,ElliotBayTrailMyrtlePark,07/01/2017 05:00:00 AM,48,-122,3,4,7
30654,ElliotBayTrailMyrtlePark,07/01/2017 06:00:00 AM,48,-122,10,8,18
30655,ElliotBayTrailMyrtlePark,07/01/2017 07:00:00 AM,48,-122,13,22,35
30656,ElliotBayTrailMyrtlePark,07/01/2017 08:00:00 AM,48,-122,12,40,52
30657,ElliotBayTrailMyrtlePark,07/01/2017 09:00:00 AM,48,-122,40,45,85
30658,ElliotBayTrailMyrtlePark,07/01/2017 10:00:00 AM,48,-122,36,37,73
30659,ElliotBayTrailMyrtlePark,07/01/2017 11:00:00 AM,48,-122,61,42,103
30660,ElliotBayTrailMyrtlePark,07/01/2017 12:00:00 PM,48,-122,46,61,107
30661,ElliotBayTrailMyrtlePark,07/01/2017 01:00:00 PM,48,-122,42,34,76
30662,ElliotBayTrailMyrtlePark,07/01/2017 02:00:00 PM,48,-122,99,65,164
30663,ElliotBayTrailMyrtlePark,07/01/2017 03:00:00 PM,48,-122,66,73,139
30664,ElliotBayTrailMyrtlePark,07/01/2017 04:00:00 PM,48,-122,78,58,136
30665,ElliotBayTrailMyrtlePark,07/01/2017 05:00:00 PM,48,-122,44,51,95
30666,ElliotBayTrailMyrtlePark,07/01/2017 06:00:00 PM,48,-122,38,44,82
30667,ElliotBayTrailMyrtlePark,07/01/2017 07:00:00 PM,48,-122,28,23,51
30668,ElliotBayTrailMyrtlePark,07/01/2017 08:00:00 PM,48,-122,37,22,59
30669,ElliotBayTrailMyrtlePark,07/01/2017 09:00:00 PM,48,-122,20,17,37
30670,ElliotBayTrailMyrtlePark,07/01/2017 10:00:00 PM,48,-122,6,7,13
30671,ElliotBayTrailMyrtlePark,07/01/2017 11:00:00 PM,48,-122,3,7,10
30672,ElliotBayTrailMyrtlePark,07/02/2017 12:00:00 AM,48,-122,2,3,5
30673,ElliotBayTrailMyrtlePark,07/02/2017 01:00:00 AM,48,-122,0,1,1
30674,ElliotBayTrailMyrtlePark,07/02/2017 02:00:00 AM,48,-122,1,0,1
30675,ElliotBayTrailMyrtlePark,07/02/2017 03:00:00 AM,48,-122,0,0,0
30676,ElliotBayTrailMyrtlePark,07/02/2017 04:00:00 AM,48,-122,3,0,3
30677,ElliotBayTrailMyrtlePark,07/02/2017 05:00:00 AM,48,-122,0,6,6
30678,ElliotBayTrailMyrtlePark,07/02/2017 06:00:00 AM,48,-122,5,6,11
30679,ElliotBayTrailMyrtlePark,07/02/2017 07:00:00 AM,48,-122,15,13,28
30680,ElliotBayTrailMyrtlePark,07/02/2017 08:00:00 AM,48,-122,12,44,56
30681,ElliotBayTrailMyrtlePark,07/02/2017 09:00:00 AM,48,-122,25,182,207
30682,ElliotBayTrailMyrtlePark,07/02/2017 10:00:00 AM,48,-122,31,75,106
30683,ElliotBayTrailMyrtlePark,07/02/2017 11:00:00 AM,48,-122,52,44,96
30684,ElliotBayTrailMyrtlePark,07/02/2017 12:00:00 PM,48,-122,103,89,192
30685,ElliotBayTrailMyrtlePark,07/02/2017 01:00:00 PM,48,-122,71,62,133
30686,ElliotBayTrailMyrtlePark,07/02/2017 02:00:00 PM,48,-122,88,70,158
30687,ElliotBayTrailMyrtlePark,07/02/2017 03:00:00 PM,48,-122,100,85,185
30688,ElliotBayTrailMyrtlePark,07/02/2017 04:00:00 PM,48,-122,55,67,122
30689,ElliotBayTrailMyrtlePark,07/02/2017 05:00:00 PM,48,-122,63,64,127
30690,ElliotBayTrailMyrtlePark,07/02/2017 06:00:00 PM,48,-122,31,31,62
30691,ElliotBayTrailMyrtlePark,07/02/2017 07:00:00 PM,48,-122,49,19,68
30692,ElliotBayTrailMyrtlePark,07/02/2017 08:00:00 PM,48,-122,29,23,52
30693,ElliotBayTrailMyrtlePark,07/02/2017 09:00:00 PM,48,-122,5,13,18
30694,ElliotBayTrailMyrtlePark,07/02/2017 10:00:00 PM,48,-122,5,1,6
30695,ElliotBayTrailMyrtlePark,07/02/2017 11:00:00 PM,48,-122,1,1,2
30696,ElliotBayTrailMyrtlePark,07/03/2017 12:00:00 AM,48,-122,0,2,2
30697,ElliotBayTrailMyrtlePark,07/03/2017 01:00:00 AM,48,-122,1,0,1
30698,ElliotBayTrailMyrtlePark,07/03/2017 02:00:00 AM,48,-122,1,0,1
30699,ElliotBayTrailMyrtlePark,07/03/2017 03:00:00 AM,48,-122,1,2,3
30700,ElliotBayTrailMyrtlePark,07/03/2017 04:00:00 AM,48,-122,7,5,12
30701,ElliotBayTrailMyrtlePark,07/03/2017 05:00:00 AM,48,-122,7,6,13
30702,ElliotBayTrailMyrtlePark,07/03/2017 06:00:00 AM,48,-122,10,25,35
30703,ElliotBayTrailMyrtlePark,07/03/2017 07:00:00 AM,48,-122,14,50,64
30704,ElliotBayTrailMyrtlePark,07/03/2017 08:00:00 AM,48,-122,32,97,129
30705,ElliotBayTrailMyrtlePark,07/03/2017 09:00:00 AM,48,-122,17,30,47
30706,ElliotBayTrailMyrtlePark,07/03/2017 10:00:00 AM,48,-122,36,29,65
30707,ElliotBayTrailMyrtlePark,07/03/2017 11:00:00 AM,48,-122,20,22,42
30708,ElliotBayTrailMyrtlePark,07/03/2017 12:00:00 PM,48,-122,37,42,79
30709,ElliotBayTrailMyrtlePark,07/03/2017 01:00:00 PM,48,-122,50,36,86
30710,ElliotBayTrailMyrtlePark,07/03/2017 02:00:00 PM,48,-122,42,31,73
30711,ElliotBayTrailMyrtlePark,07/03/2017 03:00:00 PM,48,-122,80,55,135
30712,ElliotBayTrailMyrtlePark,07/03/2017 04:00:00 PM,48,-122,81,59,140
30713,ElliotBayTrailMyrtlePark,07/03/2017 05:00:00 PM,48,-122,112,55,167
30714,ElliotBayTrailMyrtlePark,07/03/2017 06:00:00 PM,48,-122,52,41,93
30715,ElliotBayTrailMyrtlePark,07/03/2017 07:00:00 PM,48,-122,29,30,59
30716,ElliotBayTrailMyrtlePark,07/03/2017 08:00:00 PM,48,-122,36,25,61
30717,ElliotBayTrailMyrtlePark,07/03/2017 09:00:00 PM,48,-122,18,12,30
30718,ElliotBayTrailMyrtlePark,07/03/2017 10:00:00 PM,48,-122,15,2,17
30719,ElliotBayTrailMyrtlePark,07/03/2017 11:00:00 PM,48,-122,4,0,4
30720,ElliotBayTrailMyrtlePark,07/04/2017 12:00:00 AM,48,-122,2,2,4
30721,ElliotBayTrailMyrtlePark,07/04/2017 01:00:00 AM,48,-122,0,3,3
30722,ElliotBayTrailMyrtlePark,07/04/2017 02:00:00 AM,48,-122,1,0,1
30723,ElliotBayTrailMyrtlePark,07/04/2017 03:00:00 AM,48,-122,0,2,2
30724,ElliotBayTrailMyrtlePark,07/04/2017 04:00:00 AM,48,-122,1,1,2
30725,ElliotBayTrailMyrtlePark,07/04/2017 05:00:00 AM,48,-122,4,3,7
30726,ElliotBayTrailMyrtlePark,07/04/2017 06:00:00 AM,48,-122,6,10,16
30727,ElliotBayTrailMyrtlePark,07/04/2017 07:00:00 AM,48,-122,14,16,30
30728,ElliotBayTrailMyrtlePark,07/04/2017 08:00:00 AM,48,-122,18,25,43
30729,ElliotBayTrailMyrtlePark,07/04/2017 09:00:00 AM,48,-122,49,49,98
30730,ElliotBayTrailMyrtlePark,07/04/2017 10:00:00 AM,48,-122,63,75,138
30731,ElliotBayTrailMyrtlePark,07/04/2017 11:00:00 AM,48,-122,91,87,178
30732,ElliotBayTrailMyrtlePark,07/04/2017 12:00:00 PM,48,-122,71,94,165
30733,ElliotBayTrailMyrtlePark,07/04/2017 01:00:00 PM,48,-122,97,79,176
30734,ElliotBayTrailMyrtlePark,07/04/2017 02:00:00 PM,48,-122,102,97,199
30735,ElliotBayTrailMyrtlePark,07/04/2017 03:00:00 PM,48,-122,78,64,142
30736,ElliotBayTrailMyrtlePark,07/04/2017 04:00:00 PM,48,-122,88,42,130
30737,ElliotBayTrailMyrtlePark,07/04/2017 05:00:00 PM,48,-122,50,37,87
30738,ElliotBayTrailMyrtlePark,07/04/2017 06:00:00 PM,48,-122,56,36,92
30739,ElliotBayTrailMyrtlePark,07/04/2017 07:00:00 PM,48,-122,53,17,70
30740,ElliotBayTrailMyrtlePark,07/04/2017 08:00:00 PM,48,-122,25,19,44
30741,ElliotBayTrailMyrtlePark,07/04/2017 09:00:00 PM,48,-122,10,13,23
30742,ElliotBayTrailMyrtlePark,07/04/2017 10:00:00 PM,48,-122,15,6,21
30743,ElliotBayTrailMyrtlePark,07/04/2017 11:00:00 PM,48,-122,3,17,20
30744,ElliotBayTrailMyrtlePark,07/05/2017 12:00:00 AM,48,-122,2,1,3
30745,ElliotBayTrailMyrtlePark,07/05/2017 01:00:00 AM,48,-122,0,2,2
30746,ElliotBayTrailMyrtlePark,07/05/2017 02:00:00 AM,48,-122,1,0,1
30747,ElliotBayTrailMyrtlePark,07/05/2017 03:00:00 AM,48,-122,0,3,3
30748,ElliotBayTrailMyrtlePark,07/05/2017 04:00:00 AM,48,-122,3,4,7
30749,ElliotBayTrailMyrtlePark,07/05/2017 05:00:00 AM,48,-122,5,15,20
30750,ElliotBayTrailMyrtlePark,07/05/2017 06:00:00 AM,48,-122,18,34,52
30751,ElliotBayTrailMyrtlePark,07/05/2017 07:00:00 AM,48,-122,30,109,139
30752,ElliotBayTrailMyrtlePark,07/05/2017 08:00:00 AM,48,-122,71,164,235
30753,ElliotBayTrailMyrtlePark,07/05/2017 09:00:00 AM,48,-122,49,59,108
30754,ElliotBayTrailMyrtlePark,07/05/2017 10:00:00 AM,48,-122,28,42,70
30755,ElliotBayTrailMyrtlePark,07/05/2017 11:00:00 AM,48,-122,17,18,35
30756,ElliotBayTrailMyrtlePark,07/05/2017 12:00:00 PM,48,-122,33,24,57
30757,ElliotBayTrailMyrtlePark,07/05/2017 01:00:00 PM,48,-122,24,27,51
30758,ElliotBayTrailMyrtlePark,07/05/2017 02:00:00 PM,48,-122,26,19,45
30759,ElliotBayTrailMyrtlePark,07/05/2017 03:00:00 PM,48,-122,43,55,98
30760,ElliotBayTrailMyrtlePark,07/05/2017 04:00:00 PM,48,-122,140,57,197
30761,ElliotBayTrailMyrtlePark,07/05/2017 05:00:00 PM,48,-122,205,81,286
30762,ElliotBayTrailMyrtlePark,07/05/2017 06:00:00 PM,48,-122,130,57,187
30763,ElliotBayTrailMyrtlePark,07/05/2017 07:00:00 PM,48,-122,61,52,113
30764,ElliotBayTrailMyrtlePark,07/05/2017 08:00:00 PM,48,-122,31,34,65
30765,ElliotBayTrailMyrtlePark,07/05/2017 09:00:00 PM,48,-122,27,14,41
30766,ElliotBayTrailMyrtlePark,07/05/2017 10:00:00 PM,48,-122,4,10,14
30767,ElliotBayTrailMyrtlePark,07/05/2017 11:00:00 PM,48,-122,10,6,16
30768,ElliotBayTrailMyrtlePark,07/06/2017 12:00:00 AM,48,-122,1,0,1
30769,ElliotBayTrailMyrtlePark,07/06/2017 01:00:00 AM,48,-122,1,1,2
30770,ElliotBayTrailMyrtlePark,07/06/2017 02:00:00 AM,48,-122,0,0,0
30771,ElliotBayTrailMyrtlePark,07/06/2017 03:00:00 AM,48,-122,0,4,4
30772,ElliotBayTrailMyrtlePark,07/06/2017 04:00:00 AM,48,-122,1,2,3
30773,ElliotBayTrailMyrtlePark,07/06/2017 05:00:00 AM,48,-122,8,18,26
30774,ElliotBayTrailMyrtlePark,07/06/2017 06:00:00 AM,48,-122,30,47,77
30775,ElliotBayTrailMyrtlePark,07/06/2017 07:00:00 AM,48,-122,44,120,164
30776,ElliotBayTrailMyrtlePark,07/06/2017 08:00:00 AM,48,-122,60,164,224
30777,ElliotBayTrailMyrtlePark,07/06/2017 09:00:00 AM,48,-122,41,58,99
30778,ElliotBayTrailMyrtlePark,07/06/2017 10:00:00 AM,48,-122,23,39,62
30779,ElliotBayTrailMyrtlePark,07/06/2017 11:00:00 AM,48,-122,9,23,32
30780,ElliotBayTrailMyrtlePark,07/06/2017 12:00:00 PM,48,-122,26,32,58
30781,ElliotBayTrailMyrtlePark,07/06/2017 01:00:00 PM,48,-122,23,35,58
30782,ElliotBayTrailMyrtlePark,07/06/2017 02:00:00 PM,48,-122,36,27,63
30783,ElliotBayTrailMyrtlePark,07/06/2017 03:00:00 PM,48,-122,59,41,100
30784,ElliotBayTrailMyrtlePark,07/06/2017 04:00:00 PM,48,-122,126,71,197
30785,ElliotBayTrailMyrtlePark,07/06/2017 05:00:00 PM,48,-122,245,72,317
30786,ElliotBayTrailMyrtlePark,07/06/2017 06:00:00 PM,48,-122,151,71,222
30787,ElliotBayTrailMyrtlePark,07/06/2017 07:00:00 PM,48,-122,92,61,153
30788,ElliotBayTrailMyrtlePark,07/06/2017 08:00:00 PM,48,-122,36,30,66
30789,ElliotBayTrailMyrtlePark,07/06/2017 09:00:00 PM,48,-122,20,13,33
30790,ElliotBayTrailMyrtlePark,07/06/2017 10:00:00 PM,48,-122,15,4,19
30791,ElliotBayTrailMyrtlePark,07/06/2017 11:00:00 PM,48,-122,9,1,10
30792,ElliotBayTrailMyrtlePark,07/07/2017 12:00:00 AM,48,-122,1,3,4
30793,ElliotBayTrailMyrtlePark,07/07/2017 01:00:00 AM,48,-122,2,0,2
30794,ElliotBayTrailMyrtlePark,07/07/2017 02:00:00 AM,48,-122,0,1,1
30795,ElliotBayTrailMyrtlePark,07/07/2017 03:00:00 AM,48,-122,0,0,0
30796,ElliotBayTrailMyrtlePark,07/07/2017 04:00:00 AM,48,-122,6,4,10
30797,ElliotBayTrailMyrtlePark,07/07/2017 05:00:00 AM,48,-122,7,5,12
30798,ElliotBayTrailMyrtlePark,07/07/2017 06:00:00 AM,48,-122,15,39,54
30799,ElliotBayTrailMyrtlePark,07/07/2017 07:00:00 AM,48,-122,49,117,166
30800,ElliotBayTrailMyrtlePark,07/07/2017 08:00:00 AM,48,-122,40,160,200
30801,ElliotBayTrailMyrtlePark,07/07/2017 09:00:00 AM,48,-122,33,73,106
30802,ElliotBayTrailMyrtlePark,07/07/2017 10:00:00 AM,48,-122,20,41,61
30803,ElliotBayTrailMyrtlePark,07/07/2017 11:00:00 AM,48,-122,36,35,71
30804,ElliotBayTrailMyrtlePark,07/07/2017 12:00:00 PM,48,-122,26,34,60
30805,ElliotBayTrailMyrtlePark,07/07/2017 01:00:00 PM,48,-122,38,58,96
30806,ElliotBayTrailMyrtlePark,07/07/2017 02:00:00 PM,48,-122,61,46,107
30807,ElliotBayTrailMyrtlePark,07/07/2017 03:00:00 PM,48,-122,82,51,133
30808,ElliotBayTrailMyrtlePark,07/07/2017 04:00:00 PM,48,-122,118,77,195
30809,ElliotBayTrailMyrtlePark,07/07/2017 05:00:00 PM,48,-122,163,63,226
30810,ElliotBayTrailMyrtlePark,07/07/2017 06:00:00 PM,48,-122,108,37,145
30811,ElliotBayTrailMyrtlePark,07/07/2017 07:00:00 PM,48,-122,76,39,115
30812,ElliotBayTrailMyrtlePark,07/07/2017 08:00:00 PM,48,-122,42,28,70
30813,ElliotBayTrailMyrtlePark,07/07/2017 09:00:00 PM,48,-122,23,38,61
30814,ElliotBayTrailMyrtlePark,07/07/2017 10:00:00 PM,48,-122,12,4,16
30815,ElliotBayTrailMyrtlePark,07/07/2017 11:00:00 PM,48,-122,3,7,10
30816,ElliotBayTrailMyrtlePark,07/08/2017 12:00:00 AM,48,-122,2,2,4
30817,ElliotBayTrailMyrtlePark,07/08/2017 01:00:00 AM,48,-122,2,0,2
30818,ElliotBayTrailMyrtlePark,07/08/2017 02:00:00 AM,48,-122,0,0,0
30819,ElliotBayTrailMyrtlePark,07/08/2017 03:00:00 AM,48,-122,0,1,1
30820,ElliotBayTrailMyrtlePark,07/08/2017 04:00:00 AM,48,-122,0,0,0
30821,ElliotBayTrailMyrtlePark,07/08/2017 05:00:00 AM,48,-122,0,3,3
30822,ElliotBayTrailMyrtlePark,07/08/2017 06:00:00 AM,48,-122,14,8,22
30823,ElliotBayTrailMyrtlePark,07/08/2017 07:00:00 AM,48,-122,14,17,31
30824,ElliotBayTrailMyrtlePark,07/08/2017 08:00:00 AM,48,-122,22,20,42
30825,ElliotBayTrailMyrtlePark,07/08/2017 09:00:00 AM,48,-122,45,65,110
30826,ElliotBayTrailMyrtlePark,07/08/2017 10:00:00 AM,48,-122,52,63,115
30827,ElliotBayTrailMyrtlePark,07/08/2017 11:00:00 AM,48,-122,62,96,158
30828,ElliotBayTrailMyrtlePark,07/08/2017 12:00:00 PM,48,-122,82,84,166
30829,ElliotBayTrailMyrtlePark,07/08/2017 01:00:00 PM,48,-122,69,80,149
30830,ElliotBayTrailMyrtlePark,07/08/2017 02:00:00 PM,48,-122,107,58,165
30831,ElliotBayTrailMyrtlePark,07/08/2017 03:00:00 PM,48,-122,82,86,168
30832,ElliotBayTrailMyrtlePark,07/08/2017 04:00:00 PM,48,-122,68,72,140
30833,ElliotBayTrailMyrtlePark,07/08/2017 05:00:00 PM,48,-122,53,41,94
30834,ElliotBayTrailMyrtlePark,07/08/2017 06:00:00 PM,48,-122,54,57,111
30835,ElliotBayTrailMyrtlePark,07/08/2017 07:00:00 PM,48,-122,40,43,83
30836,ElliotBayTrailMyrtlePark,07/08/2017 08:00:00 PM,48,-122,22,37,59
30837,ElliotBayTrailMyrtlePark,07/08/2017 09:00:00 PM,48,-122,16,18,34
30838,ElliotBayTrailMyrtlePark,07/08/2017 10:00:00 PM,48,-122,18,4,22
30839,ElliotBayTrailMyrtlePark,07/08/2017 11:00:00 PM,48,-122,10,0,10
30840,ElliotBayTrailMyrtlePark,07/09/2017 12:00:00 AM,48,-122,17,1,18
30841,ElliotBayTrailMyrtlePark,07/09/2017 01:00:00 AM,48,-122,4,1,5
30842,ElliotBayTrailMyrtlePark,07/09/2017 02:00:00 AM,48,-122,0,0,0
30843,ElliotBayTrailMyrtlePark,07/09/2017 03:00:00 AM,48,-122,0,0,0
30844,ElliotBayTrailMyrtlePark,07/09/2017 04:00:00 AM,48,-122,0,1,1
30845,ElliotBayTrailMyrtlePark,07/09/2017 05:00:00 AM,48,-122,3,2,5
30846,ElliotBayTrailMyrtlePark,07/09/2017 06:00:00 AM,48,-122,5,7,12
30847,ElliotBayTrailMyrtlePark,07/09/2017 07:00:00 AM,48,-122,14,8,22
30848,ElliotBayTrailMyrtlePark,07/09/2017 08:00:00 AM,48,-122,19,24,43
30849,ElliotBayTrailMyrtlePark,07/09/2017 09:00:00 AM,48,-122,40,31,71
30850,ElliotBayTrailMyrtlePark,07/09/2017 10:00:00 AM,48,-122,57,50,107
30851,ElliotBayTrailMyrtlePark,07/09/2017 11:00:00 AM,48,-122,74,81,155
30852,ElliotBayTrailMyrtlePark,07/09/2017 12:00:00 PM,48,-122,72,89,161
30853,ElliotBayTrailMyrtlePark,07/09/2017 01:00:00 PM,48,-122,59,72,131
30854,ElliotBayTrailMyrtlePark,07/09/2017 02:00:00 PM,48,-122,70,49,119
30855,ElliotBayTrailMyrtlePark,07/09/2017 03:00:00 PM,48,-122,63,78,141
30856,ElliotBayTrailMyrtlePark,07/09/2017 04:00:00 PM,48,-122,83,37,120
30857,ElliotBayTrailMyrtlePark,07/09/2017 05:00:00 PM,48,-122,60,51,111
30858,ElliotBayTrailMyrtlePark,07/09/2017 06:00:00 PM,48,-122,38,29,67
30859,ElliotBayTrailMyrtlePark,07/09/2017 07:00:00 PM,48,-122,29,22,51
30860,ElliotBayTrailMyrtlePark,07/09/2017 08:00:00 PM,48,-122,30,14,44
30861,ElliotBayTrailMyrtlePark,07/09/2017 09:00:00 PM,48,-122,17,14,31
30862,ElliotBayTrailMyrtlePark,07/09/2017 10:00:00 PM,48,-122,1,2,3
30863,ElliotBayTrailMyrtlePark,07/09/2017 11:00:00 PM,48,-122,5,7,12
30864,ElliotBayTrailMyrtlePark,07/10/2017 12:00:00 AM,48,-122,0,7,7
30865,ElliotBayTrailMyrtlePark,07/10/2017 01:00:00 AM,48,-122,1,0,1
30866,ElliotBayTrailMyrtlePark,07/10/2017 02:00:00 AM,48,-122,0,2,2
30867,ElliotBayTrailMyrtlePark,07/10/2017 03:00:00 AM,48,-122,0,2,2
30868,ElliotBayTrailMyrtlePark,07/10/2017 04:00:00 AM,48,-122,2,3,5
30869,ElliotBayTrailMyrtlePark,07/10/2017 05:00:00 AM,48,-122,7,14,21
30870,ElliotBayTrailMyrtlePark,07/10/2017 06:00:00 AM,48,-122,17,39,56
30871,ElliotBayTrailMyrtlePark,07/10/2017 07:00:00 AM,48,-122,32,113,145
30872,ElliotBayTrailMyrtlePark,07/10/2017 08:00:00 AM,48,-122,52,183,235
30873,ElliotBayTrailMyrtlePark,07/10/2017 09:00:00 AM,48,-122,26,78,104
30874,ElliotBayTrailMyrtlePark,07/10/2017 10:00:00 AM,48,-122,23,29,52
30875,ElliotBayTrailMyrtlePark,07/10/2017 11:00:00 AM,48,-122,13,16,29
30876,ElliotBayTrailMyrtlePark,07/10/2017 12:00:00 PM,48,-122,25,22,47
30877,ElliotBayTrailMyrtlePark,07/10/2017 01:00:00 PM,48,-122,22,28,50
30878,ElliotBayTrailMyrtlePark,07/10/2017 02:00:00 PM,48,-122,39,20,59
30879,ElliotBayTrailMyrtlePark,07/10/2017 03:00:00 PM,48,-122,57,37,94
30880,ElliotBayTrailMyrtlePark,07/10/2017 04:00:00 PM,48,-122,119,46,165
30881,ElliotBayTrailMyrtlePark,07/10/2017 05:00:00 PM,48,-122,233,79,312
30882,ElliotBayTrailMyrtlePark,07/10/2017 06:00:00 PM,48,-122,137,57,194
30883,ElliotBayTrailMyrtlePark,07/10/2017 07:00:00 PM,48,-122,45,27,72
30884,ElliotBayTrailMyrtlePark,07/10/2017 08:00:00 PM,48,-122,27,21,48
30885,ElliotBayTrailMyrtlePark,07/10/2017 09:00:00 PM,48,-122,7,14,21
30886,ElliotBayTrailMyrtlePark,07/10/2017 10:00:00 PM,48,-122,7,5,12
30887,ElliotBayTrailMyrtlePark,07/10/2017 11:00:00 PM,48,-122,3,2,5
30888,ElliotBayTrailMyrtlePark,07/11/2017 12:00:00 AM,48,-122,1,0,1
30889,ElliotBayTrailMyrtlePark,07/11/2017 01:00:00 AM,48,-122,1,1,2
30890,ElliotBayTrailMyrtlePark,07/11/2017 02:00:00 AM,48,-122,0,1,1
30891,ElliotBayTrailMyrtlePark,07/11/2017 03:00:00 AM,48,-122,0,2,2
30892,ElliotBayTrailMyrtlePark,07/11/2017 04:00:00 AM,48,-122,5,1,6
30893,ElliotBayTrailMyrtlePark,07/11/2017 05:00:00 AM,48,-122,11,22,33
30894,ElliotBayTrailMyrtlePark,07/11/2017 06:00:00 AM,48,-122,29,44,73
30895,ElliotBayTrailMyrtlePark,07/11/2017 07:00:00 AM,48,-122,45,133,178
30896,ElliotBayTrailMyrtlePark,07/11/2017 08:00:00 AM,48,-122,35,179,214
30897,ElliotBayTrailMyrtlePark,07/11/2017 09:00:00 AM,48,-122,30,84,114
30898,ElliotBayTrailMyrtlePark,07/11/2017 10:00:00 AM,48,-122,15,36,51
30899,ElliotBayTrailMyrtlePark,07/11/2017 11:00:00 AM,48,-122,21,24,45
30900,ElliotBayTrailMyrtlePark,07/11/2017 12:00:00 PM,48,-122,29,27,56
30901,ElliotBayTrailMyrtlePark,07/11/2017 01:00:00 PM,48,-122,32,29,61
30902,ElliotBayTrailMyrtlePark,07/11/2017 02:00:00 PM,48,-122,42,30,72
30903,ElliotBayTrailMyrtlePark,07/11/2017 03:00:00 PM,48,-122,67,40,107
30904,ElliotBayTrailMyrtlePark,07/11/2017 04:00:00 PM,48,-122,122,62,184
30905,ElliotBayTrailMyrtlePark,07/11/2017 05:00:00 PM,48,-122,228,92,320
30906,ElliotBayTrailMyrtlePark,07/11/2017 06:00:00 PM,48,-122,167,61,228
30907,ElliotBayTrailMyrtlePark,07/11/2017 07:00:00 PM,48,-122,93,67,160
30908,ElliotBayTrailMyrtlePark,07/11/2017 08:00:00 PM,48,-122,44,35,79
30909,ElliotBayTrailMyrtlePark,07/11/2017 09:00:00 PM,48,-122,15,19,34
30910,ElliotBayTrailMyrtlePark,07/11/2017 10:00:00 PM,48,-122,7,9,16
30911,ElliotBayTrailMyrtlePark,07/11/2017 11:00:00 PM,48,-122,5,0,5
30912,ElliotBayTrailMyrtlePark,07/12/2017 12:00:00 AM,48,-122,1,1,2
30913,ElliotBayTrailMyrtlePark,07/12/2017 01:00:00 AM,48,-122,0,1,1
30914,ElliotBayTrailMyrtlePark,07/12/2017 02:00:00 AM,48,-122,1,0,1
30915,ElliotBayTrailMyrtlePark,07/12/2017 03:00:00 AM,48,-122,0,2,2
30916,ElliotBayTrailMyrtlePark,07/12/2017 04:00:00 AM,48,-122,4,3,7
30917,ElliotBayTrailMyrtlePark,07/12/2017 05:00:00 AM,48,-122,10,20,30
30918,ElliotBayTrailMyrtlePark,07/12/2017 06:00:00 AM,48,-122,31,52,83
30919,ElliotBayTrailMyrtlePark,07/12/2017 07:00:00 AM,48,-122,62,157,219
30920,ElliotBayTrailMyrtlePark,07/12/2017 08:00:00 AM,48,-122,57,208,265
30921,ElliotBayTrailMyrtlePark,07/12/2017 09:00:00 AM,48,-122,37,84,121
30922,ElliotBayTrailMyrtlePark,07/12/2017 10:00:00 AM,48,-122,23,36,59
30923,ElliotBayTrailMyrtlePark,07/12/2017 11:00:00 AM,48,-122,28,23,51
30924,ElliotBayTrailMyrtlePark,07/12/2017 12:00:00 PM,48,-122,28,32,60
30925,ElliotBayTrailMyrtlePark,07/12/2017 01:00:00 PM,48,-122,28,37,65
30926,ElliotBayTrailMyrtlePark,07/12/2017 02:00:00 PM,48,-122,34,33,67
30927,ElliotBayTrailMyrtlePark,07/12/2017 03:00:00 PM,48,-122,55,43,98
30928,ElliotBayTrailMyrtlePark,07/12/2017 04:00:00 PM,48,-122,111,59,170
30929,ElliotBayTrailMyrtlePark,07/12/2017 05:00:00 PM,48,-122,222,85,307
30930,ElliotBayTrailMyrtlePark,07/12/2017 06:00:00 PM,48,-122,148,77,225
30931,ElliotBayTrailMyrtlePark,07/12/2017 07:00:00 PM,48,-122,85,56,141
30932,ElliotBayTrailMyrtlePark,07/12/2017 08:00:00 PM,48,-122,43,40,83
30933,ElliotBayTrailMyrtlePark,07/12/2017 09:00:00 PM,48,-122,21,16,37
30934,ElliotBayTrailMyrtlePark,07/12/2017 10:00:00 PM,48,-122,14,1,15
30935,ElliotBayTrailMyrtlePark,07/12/2017 11:00:00 PM,48,-122,6,5,11
30936,ElliotBayTrailMyrtlePark,07/13/2017 12:00:00 AM,48,-122,3,1,4
30937,ElliotBayTrailMyrtlePark,07/13/2017 01:00:00 AM,48,-122,1,2,3
30938,ElliotBayTrailMyrtlePark,07/13/2017 02:00:00 AM,48,-122,0,1,1
30939,ElliotBayTrailMyrtlePark,07/13/2017 03:00:00 AM,48,-122,0,2,2
30940,ElliotBayTrailMyrtlePark,07/13/2017 04:00:00 AM,48,-122,3,1,4
30941,ElliotBayTrailMyrtlePark,07/13/2017 05:00:00 AM,48,-122,7,18,25
30942,ElliotBayTrailMyrtlePark,07/13/2017 06:00:00 AM,48,-122,25,41,66
30943,ElliotBayTrailMyrtlePark,07/13/2017 07:00:00 AM,48,-122,52,108,160
30944,ElliotBayTrailMyrtlePark,07/13/2017 08:00:00 AM,48,-122,42,151,193
30945,ElliotBayTrailMyrtlePark,07/13/2017 09:00:00 AM,48,-122,21,83,104
30946,ElliotBayTrailMyrtlePark,07/13/2017 10:00:00 AM,48,-122,14,21,35
30947,ElliotBayTrailMyrtlePark,07/13/2017 11:00:00 AM,48,-122,15,24,39
30948,ElliotBayTrailMyrtlePark,07/13/2017 12:00:00 PM,48,-122,26,21,47
30949,ElliotBayTrailMyrtlePark,07/13/2017 01:00:00 PM,48,-122,20,21,41
30950,ElliotBayTrailMyrtlePark,07/13/2017 02:00:00 PM,48,-122,46,34,80
30951,ElliotBayTrailMyrtlePark,07/13/2017 03:00:00 PM,48,-122,56,46,102
30952,ElliotBayTrailMyrtlePark,07/13/2017 04:00:00 PM,48,-122,117,58,175
30953,ElliotBayTrailMyrtlePark,07/13/2017 05:00:00 PM,48,-122,198,66,264
30954,ElliotBayTrailMyrtlePark,07/13/2017 06:00:00 PM,48,-122,141,62,203
30955,ElliotBayTrailMyrtlePark,07/13/2017 07:00:00 PM,48,-122,51,51,102
30956,ElliotBayTrailMyrtlePark,07/13/2017 08:00:00 PM,48,-122,54,28,82
30957,ElliotBayTrailMyrtlePark,07/13/2017 09:00:00 PM,48,-122,32,18,50
30958,ElliotBayTrailMyrtlePark,07/13/2017 10:00:00 PM,48,-122,14,7,21
30959,ElliotBayTrailMyrtlePark,07/13/2017 11:00:00 PM,48,-122,3,3,6
30960,ElliotBayTrailMyrtlePark,07/14/2017 12:00:00 AM,48,-122,3,1,4
30961,ElliotBayTrailMyrtlePark,07/14/2017 01:00:00 AM,48,-122,2,1,3
30962,ElliotBayTrailMyrtlePark,07/14/2017 02:00:00 AM,48,-122,2,1,3
30963,ElliotBayTrailMyrtlePark,07/14/2017 03:00:00 AM,48,-122,0,0,0
30964,ElliotBayTrailMyrtlePark,07/14/2017 04:00:00 AM,48,-122,8,2,10
30965,ElliotBayTrailMyrtlePark,07/14/2017 05:00:00 AM,48,-122,4,20,24
30966,ElliotBayTrailMyrtlePark,07/14/2017 06:00:00 AM,48,-122,20,28,48
30967,ElliotBayTrailMyrtlePark,07/14/2017 07:00:00 AM,48,-122,32,115,147
30968,ElliotBayTrailMyrtlePark,07/14/2017 08:00:00 AM,48,-122,70,144,214
30969,ElliotBayTrailMyrtlePark,07/14/2017 09:00:00 AM,48,-122,29,66,95
30970,ElliotBayTrailMyrtlePark,07/14/2017 10:00:00 AM,48,-122,29,39,68
30971,ElliotBayTrailMyrtlePark,07/14/2017 11:00:00 AM,48,-122,21,27,48
30972,ElliotBayTrailMyrtlePark,07/14/2017 12:00:00 PM,48,-122,44,39,83
30973,ElliotBayTrailMyrtlePark,07/14/2017 01:00:00 PM,48,-122,36,31,67
30974,ElliotBayTrailMyrtlePark,07/14/2017 02:00:00 PM,48,-122,50,32,82
30975,ElliotBayTrailMyrtlePark,07/14/2017 03:00:00 PM,48,-122,77,59,136
30976,ElliotBayTrailMyrtlePark,07/14/2017 04:00:00 PM,48,-122,124,62,186
30977,ElliotBayTrailMyrtlePark,07/14/2017 05:00:00 PM,48,-122,194,78,272
30978,ElliotBayTrailMyrtlePark,07/14/2017 06:00:00 PM,48,-122,109,60,169
30979,ElliotBayTrailMyrtlePark,07/14/2017 07:00:00 PM,48,-122,56,39,95
30980,ElliotBayTrailMyrtlePark,07/14/2017 08:00:00 PM,48,-122,26,29,55
30981,ElliotBayTrailMyrtlePark,07/14/2017 09:00:00 PM,48,-122,9,19,28
30982,ElliotBayTrailMyrtlePark,07/14/2017 10:00:00 PM,48,-122,9,7,16
30983,ElliotBayTrailMyrtlePark,07/14/2017 11:00:00 PM,48,-122,3,1,4
30984,ElliotBayTrailMyrtlePark,07/15/2017 12:00:00 AM,48,-122,4,1,5
30985,ElliotBayTrailMyrtlePark,07/15/2017 01:00:00 AM,48,-122,4,2,6
30986,ElliotBayTrailMyrtlePark,07/15/2017 02:00:00 AM,48,-122,1,0,1
30987,ElliotBayTrailMyrtlePark,07/15/2017 03:00:00 AM,48,-122,0,0,0
30988,ElliotBayTrailMyrtlePark,07/15/2017 04:00:00 AM,48,-122,0,0,0
30989,ElliotBayTrailMyrtlePark,07/15/2017 05:00:00 AM,48,-122,2,5,7
30990,ElliotBayTrailMyrtlePark,07/15/2017 06:00:00 AM,48,-122,6,8,14
30991,ElliotBayTrailMyrtlePark,07/15/2017 07:00:00 AM,48,-122,7,24,31
30992,ElliotBayTrailMyrtlePark,07/15/2017 08:00:00 AM,48,-122,28,36,64
30993,ElliotBayTrailMyrtlePark,07/15/2017 09:00:00 AM,48,-122,17,36,53
30994,ElliotBayTrailMyrtlePark,07/15/2017 10:00:00 AM,48,-122,59,46,105
30995,ElliotBayTrailMyrtlePark,07/15/2017 11:00:00 AM,48,-122,51,62,113
30996,ElliotBayTrailMyrtlePark,07/15/2017 12:00:00 PM,48,-122,52,76,128
30997,ElliotBayTrailMyrtlePark,07/15/2017 01:00:00 PM,48,-122,72,64,136
30998,ElliotBayTrailMyrtlePark,07/15/2017 02:00:00 PM,48,-122,72,42,114
30999,ElliotBayTrailMyrtlePark,07/15/2017 03:00:00 PM,48,-122,66,69,135
31000,ElliotBayTrailMyrtlePark,07/15/2017 04:00:00 PM,48,-122,61,49,110
31001,ElliotBayTrailMyrtlePark,07/15/2017 05:00:00 PM,48,-122,45,34,79
31002,ElliotBayTrailMyrtlePark,07/15/2017 06:00:00 PM,48,-122,33,44,77
31003,ElliotBayTrailMyrtlePark,07/15/2017 07:00:00 PM,48,-122,29,30,59
31004,ElliotBayTrailMyrtlePark,07/15/2017 08:00:00 PM,48,-122,23,23,46
31005,ElliotBayTrailMyrtlePark,07/15/2017 09:00:00 PM,48,-122,9,14,23
31006,ElliotBayTrailMyrtlePark,07/15/2017 10:00:00 PM,48,-122,4,4,8
31007,ElliotBayTrailMyrtlePark,07/15/2017 11:00:00 PM,48,-122,4,1,5
31008,ElliotBayTrailMyrtlePark,07/16/2017 12:00:00 AM,48,-122,1,1,2
31009,ElliotBayTrailMyrtlePark,07/16/2017 01:00:00 AM,48,-122,0,1,1
31010,ElliotBayTrailMyrtlePark,07/16/2017 02:00:00 AM,48,-122,1,0,1
31011,ElliotBayTrailMyrtlePark,07/16/2017 03:00:00 AM,48,-122,0,0,0
31012,ElliotBayTrailMyrtlePark,07/16/2017 04:00:00 AM,48,-122,1,0,1
31013,ElliotBayTrailMyrtlePark,07/16/2017 05:00:00 AM,48,-122,1,3,4
31014,ElliotBayTrailMyrtlePark,07/16/2017 06:00:00 AM,48,-122,4,4,8
31015,ElliotBayTrailMyrtlePark,07/16/2017 07:00:00 AM,48,-122,12,15,27
31016,ElliotBayTrailMyrtlePark,07/16/2017 08:00:00 AM,48,-122,25,14,39
31017,ElliotBayTrailMyrtlePark,07/16/2017 09:00:00 AM,48,-122,27,36,63
31018,ElliotBayTrailMyrtlePark,07/16/2017 10:00:00 AM,48,-122,65,36,101
31019,ElliotBayTrailMyrtlePark,07/16/2017 11:00:00 AM,48,-122,47,87,134
31020,ElliotBayTrailMyrtlePark,07/16/2017 12:00:00 PM,48,-122,54,54,108
31021,ElliotBayTrailMyrtlePark,07/16/2017 01:00:00 PM,48,-122,86,87,173
31022,ElliotBayTrailMyrtlePark,07/16/2017 02:00:00 PM,48,-122,95,63,158
31023,ElliotBayTrailMyrtlePark,07/16/2017 03:00:00 PM,48,-122,57,58,115
31024,ElliotBayTrailMyrtlePark,07/16/2017 04:00:00 PM,48,-122,69,63,132
31025,ElliotBayTrailMyrtlePark,07/16/2017 05:00:00 PM,48,-122,64,47,111
31026,ElliotBayTrailMyrtlePark,07/16/2017 06:00:00 PM,48,-122,37,31,68
31027,ElliotBayTrailMyrtlePark,07/16/2017 07:00:00 PM,48,-122,30,15,45
31028,ElliotBayTrailMyrtlePark,07/16/2017 08:00:00 PM,48,-122,25,26,51
31029,ElliotBayTrailMyrtlePark,07/16/2017 09:00:00 PM,48,-122,7,14,21
31030,ElliotBayTrailMyrtlePark,07/16/2017 10:00:00 PM,48,-122,4,1,5
31031,ElliotBayTrailMyrtlePark,07/16/2017 11:00:00 PM,48,-122,0,2,2
31032,ElliotBayTrailMyrtlePark,07/17/2017 12:00:00 AM,48,-122,0,0,0
31033,ElliotBayTrailMyrtlePark,07/17/2017 01:00:00 AM,48,-122,0,0,0
31034,ElliotBayTrailMyrtlePark,07/17/2017 02:00:00 AM,48,-122,0,0,0
31035,ElliotBayTrailMyrtlePark,07/17/2017 03:00:00 AM,48,-122,0,2,2
31036,ElliotBayTrailMyrtlePark,07/17/2017 04:00:00 AM,48,-122,2,1,3
31037,ElliotBayTrailMyrtlePark,07/17/2017 05:00:00 AM,48,-122,5,17,22
31038,ElliotBayTrailMyrtlePark,07/17/2017 06:00:00 AM,48,-122,22,28,50
31039,ElliotBayTrailMyrtlePark,07/17/2017 07:00:00 AM,48,-122,44,120,164
31040,ElliotBayTrailMyrtlePark,07/17/2017 08:00:00 AM,48,-122,51,169,220
31041,ElliotBayTrailMyrtlePark,07/17/2017 09:00:00 AM,48,-122,33,74,107
31042,ElliotBayTrailMyrtlePark,07/17/2017 10:00:00 AM,48,-122,16,30,46
31043,ElliotBayTrailMyrtlePark,07/17/2017 11:00:00 AM,48,-122,18,23,41
31044,ElliotBayTrailMyrtlePark,07/17/2017 12:00:00 PM,48,-122,36,15,51
31045,ElliotBayTrailMyrtlePark,07/17/2017 01:00:00 PM,48,-122,27,20,47
31046,ElliotBayTrailMyrtlePark,07/17/2017 02:00:00 PM,48,-122,31,23,54
31047,ElliotBayTrailMyrtlePark,07/17/2017 03:00:00 PM,48,-122,47,47,94
31048,ElliotBayTrailMyrtlePark,07/17/2017 04:00:00 PM,48,-122,142,64,206
31049,ElliotBayTrailMyrtlePark,07/17/2017 05:00:00 PM,48,-122,212,79,291
31050,ElliotBayTrailMyrtlePark,07/17/2017 06:00:00 PM,48,-122,130,39,169
31051,ElliotBayTrailMyrtlePark,07/17/2017 07:00:00 PM,48,-122,65,37,102
31052,ElliotBayTrailMyrtlePark,07/17/2017 08:00:00 PM,48,-122,32,31,63
31053,ElliotBayTrailMyrtlePark,07/17/2017 09:00:00 PM,48,-122,20,20,40
31054,ElliotBayTrailMyrtlePark,07/17/2017 10:00:00 PM,48,-122,8,3,11
31055,ElliotBayTrailMyrtlePark,07/17/2017 11:00:00 PM,48,-122,4,3,7
31056,ElliotBayTrailMyrtlePark,07/18/2017 12:00:00 AM,48,-122,0,1,1
31057,ElliotBayTrailMyrtlePark,07/18/2017 01:00:00 AM,48,-122,2,0,2
31058,ElliotBayTrailMyrtlePark,07/18/2017 02:00:00 AM,48,-122,0,0,0
31059,ElliotBayTrailMyrtlePark,07/18/2017 03:00:00 AM,48,-122,0,3,3
31060,ElliotBayTrailMyrtlePark,07/18/2017 04:00:00 AM,48,-122,1,2,3
31061,ElliotBayTrailMyrtlePark,07/18/2017 05:00:00 AM,48,-122,7,17,24
31062,ElliotBayTrailMyrtlePark,07/18/2017 06:00:00 AM,48,-122,24,43,67
31063,ElliotBayTrailMyrtlePark,07/18/2017 07:00:00 AM,48,-122,46,153,199
31064,ElliotBayTrailMyrtlePark,07/18/2017 08:00:00 AM,48,-122,59,160,219
31065,ElliotBayTrailMyrtlePark,07/18/2017 09:00:00 AM,48,-122,45,77,122
31066,ElliotBayTrailMyrtlePark,07/18/2017 10:00:00 AM,48,-122,27,31,58
31067,ElliotBayTrailMyrtlePark,07/18/2017 11:00:00 AM,48,-122,22,44,66
31068,ElliotBayTrailMyrtlePark,07/18/2017 12:00:00 PM,48,-122,36,35,71
31069,ElliotBayTrailMyrtlePark,07/18/2017 01:00:00 PM,48,-122,32,32,64
31070,ElliotBayTrailMyrtlePark,07/18/2017 02:00:00 PM,48,-122,38,24,62
31071,ElliotBayTrailMyrtlePark,07/18/2017 03:00:00 PM,48,-122,71,40,111
31072,ElliotBayTrailMyrtlePark,07/18/2017 04:00:00 PM,48,-122,156,48,204
31073,ElliotBayTrailMyrtlePark,07/18/2017 05:00:00 PM,48,-122,240,76,316
31074,ElliotBayTrailMyrtlePark,07/18/2017 06:00:00 PM,48,-122,152,37,189
31075,ElliotBayTrailMyrtlePark,07/18/2017 07:00:00 PM,48,-122,78,45,123
31076,ElliotBayTrailMyrtlePark,07/18/2017 08:00:00 PM,48,-122,28,35,63
31077,ElliotBayTrailMyrtlePark,07/18/2017 09:00:00 PM,48,-122,20,18,38
31078,ElliotBayTrailMyrtlePark,07/18/2017 10:00:00 PM,48,-122,13,6,19
31079,ElliotBayTrailMyrtlePark,07/18/2017 11:00:00 PM,48,-122,10,3,13
31080,ElliotBayTrailMyrtlePark,07/19/2017 12:00:00 AM,48,-122,0,3,3
31081,ElliotBayTrailMyrtlePark,07/19/2017 01:00:00 AM,48,-122,0,0,0
31082,ElliotBayTrailMyrtlePark,07/19/2017 02:00:00 AM,48,-122,1,0,1
31083,ElliotBayTrailMyrtlePark,07/19/2017 03:00:00 AM,48,-122,1,2,3
31084,ElliotBayTrailMyrtlePark,07/19/2017 04:00:00 AM,48,-122,6,3,9
31085,ElliotBayTrailMyrtlePark,07/19/2017 05:00:00 AM,48,-122,10,16,26
31086,ElliotBayTrailMyrtlePark,07/19/2017 06:00:00 AM,48,-122,28,56,84
31087,ElliotBayTrailMyrtlePark,07/19/2017 07:00:00 AM,48,-122,49,125,174
31088,ElliotBayTrailMyrtlePark,07/19/2017 08:00:00 AM,48,-122,59,186,245
31089,ElliotBayTrailMyrtlePark,07/19/2017 09:00:00 AM,48,-122,41,74,115
31090,ElliotBayTrailMyrtlePark,07/19/2017 10:00:00 AM,48,-122,19,38,57
31091,ElliotBayTrailMyrtlePark,07/19/2017 11:00:00 AM,48,-122,14,25,39
31092,ElliotBayTrailMyrtlePark,07/19/2017 12:00:00 PM,48,-122,26,34,60
31093,ElliotBayTrailMyrtlePark,07/19/2017 01:00:00 PM,48,-122,24,29,53
31094,ElliotBayTrailMyrtlePark,07/19/2017 02:00:00 PM,48,-122,35,33,68
31095,ElliotBayTrailMyrtlePark,07/19/2017 03:00:00 PM,48,-122,49,30,79
31096,ElliotBayTrailMyrtlePark,07/19/2017 04:00:00 PM,48,-122,107,50,157
31097,ElliotBayTrailMyrtlePark,07/19/2017 05:00:00 PM,48,-122,224,99,323
31098,ElliotBayTrailMyrtlePark,07/19/2017 06:00:00 PM,48,-122,149,53,202
31099,ElliotBayTrailMyrtlePark,07/19/2017 07:00:00 PM,48,-122,60,49,109
31100,ElliotBayTrailMyrtlePark,07/19/2017 08:00:00 PM,48,-122,45,25,70
31101,ElliotBayTrailMyrtlePark,07/19/2017 09:00:00 PM,48,-122,37,14,51
31102,ElliotBayTrailMyrtlePark,07/19/2017 10:00:00 PM,48,-122,36,8,44
31103,ElliotBayTrailMyrtlePark,07/19/2017 11:00:00 PM,48,-122,6,3,9
31104,ElliotBayTrailMyrtlePark,07/20/2017 12:00:00 AM,48,-122,3,0,3
31105,ElliotBayTrailMyrtlePark,07/20/2017 01:00:00 AM,48,-122,1,0,1
31106,ElliotBayTrailMyrtlePark,07/20/2017 02:00:00 AM,48,-122,0,0,0
31107,ElliotBayTrailMyrtlePark,07/20/2017 03:00:00 AM,48,-122,5,1,6
31108,ElliotBayTrailMyrtlePark,07/20/2017 04:00:00 AM,48,-122,1,1,2
31109,ElliotBayTrailMyrtlePark,07/20/2017 05:00:00 AM,48,-122,4,16,20
31110,ElliotBayTrailMyrtlePark,07/20/2017 06:00:00 AM,48,-122,20,33,53
31111,ElliotBayTrailMyrtlePark,07/20/2017 07:00:00 AM,48,-122,48,109,157
31112,ElliotBayTrailMyrtlePark,07/20/2017 08:00:00 AM,48,-122,49,152,201
31113,ElliotBayTrailMyrtlePark,07/20/2017 09:00:00 AM,48,-122,37,71,108
31114,ElliotBayTrailMyrtlePark,07/20/2017 10:00:00 AM,48,-122,14,30,44
31115,ElliotBayTrailMyrtlePark,07/20/2017 11:00:00 AM,48,-122,15,24,39
31116,ElliotBayTrailMyrtlePark,07/20/2017 12:00:00 PM,48,-122,30,28,58
31117,ElliotBayTrailMyrtlePark,07/20/2017 01:00:00 PM,48,-122,32,28,60
31118,ElliotBayTrailMyrtlePark,07/20/2017 02:00:00 PM,48,-122,31,33,64
31119,ElliotBayTrailMyrtlePark,07/20/2017 03:00:00 PM,48,-122,57,41,98
31120,ElliotBayTrailMyrtlePark,07/20/2017 04:00:00 PM,48,-122,117,45,162
31121,ElliotBayTrailMyrtlePark,07/20/2017 05:00:00 PM,48,-122,193,84,277
31122,ElliotBayTrailMyrtlePark,07/20/2017 06:00:00 PM,48,-122,129,58,187
31123,ElliotBayTrailMyrtlePark,07/20/2017 07:00:00 PM,48,-122,64,48,112
31124,ElliotBayTrailMyrtlePark,07/20/2017 08:00:00 PM,48,-122,38,16,54
31125,ElliotBayTrailMyrtlePark,07/20/2017 09:00:00 PM,48,-122,9,18,27
31126,ElliotBayTrailMyrtlePark,07/20/2017 10:00:00 PM,48,-122,19,3,22
31127,ElliotBayTrailMyrtlePark,07/20/2017 11:00:00 PM,48,-122,12,1,13
31128,ElliotBayTrailMyrtlePark,07/21/2017 12:00:00 AM,48,-122,0,1,1
31129,ElliotBayTrailMyrtlePark,07/21/2017 01:00:00 AM,48,-122,0,0,0
31130,ElliotBayTrailMyrtlePark,07/21/2017 02:00:00 AM,48,-122,1,0,1
31131,ElliotBayTrailMyrtlePark,07/21/2017 03:00:00 AM,48,-122,0,1,1
31132,ElliotBayTrailMyrtlePark,07/21/2017 04:00:00 AM,48,-122,5,1,6
31133,ElliotBayTrailMyrtlePark,07/21/2017 05:00:00 AM,48,-122,7,19,26
31134,ElliotBayTrailMyrtlePark,07/21/2017 06:00:00 AM,48,-122,15,33,48
31135,ElliotBayTrailMyrtlePark,07/21/2017 07:00:00 AM,48,-122,38,106,144
31136,ElliotBayTrailMyrtlePark,07/21/2017 08:00:00 AM,48,-122,55,166,221
31137,ElliotBayTrailMyrtlePark,07/21/2017 09:00:00 AM,48,-122,36,72,108
31138,ElliotBayTrailMyrtlePark,07/21/2017 10:00:00 AM,48,-122,22,48,70
31139,ElliotBayTrailMyrtlePark,07/21/2017 11:00:00 AM,48,-122,27,34,61
31140,ElliotBayTrailMyrtlePark,07/21/2017 12:00:00 PM,48,-122,35,35,70
31141,ElliotBayTrailMyrtlePark,07/21/2017 01:00:00 PM,48,-122,48,45,93
31142,ElliotBayTrailMyrtlePark,07/21/2017 02:00:00 PM,48,-122,84,49,133
31143,ElliotBayTrailMyrtlePark,07/21/2017 03:00:00 PM,48,-122,85,43,128
31144,ElliotBayTrailMyrtlePark,07/21/2017 04:00:00 PM,48,-122,138,76,214
31145,ElliotBayTrailMyrtlePark,07/21/2017 05:00:00 PM,48,-122,142,67,209
31146,ElliotBayTrailMyrtlePark,07/21/2017 06:00:00 PM,48,-122,120,50,170
31147,ElliotBayTrailMyrtlePark,07/21/2017 07:00:00 PM,48,-122,50,30,80
31148,ElliotBayTrailMyrtlePark,07/21/2017 08:00:00 PM,48,-122,21,13,34
31149,ElliotBayTrailMyrtlePark,07/21/2017 09:00:00 PM,48,-122,11,8,19
31150,ElliotBayTrailMyrtlePark,07/21/2017 10:00:00 PM,48,-122,9,4,13
31151,ElliotBayTrailMyrtlePark,07/21/2017 11:00:00 PM,48,-122,6,0,6
31152,ElliotBayTrailMyrtlePark,07/22/2017 12:00:00 AM,48,-122,5,4,9
31153,ElliotBayTrailMyrtlePark,07/22/2017 01:00:00 AM,48,-122,3,0,3
31154,ElliotBayTrailMyrtlePark,07/22/2017 02:00:00 AM,48,-122,1,0,1
31155,ElliotBayTrailMyrtlePark,07/22/2017 03:00:00 AM,48,-122,1,0,1
31156,ElliotBayTrailMyrtlePark,07/22/2017 04:00:00 AM,48,-122,0,0,0
31157,ElliotBayTrailMyrtlePark,07/22/2017 05:00:00 AM,48,-122,2,3,5
31158,ElliotBayTrailMyrtlePark,07/22/2017 06:00:00 AM,48,-122,7,8,15
31159,ElliotBayTrailMyrtlePark,07/22/2017 07:00:00 AM,48,-122,17,12,29
31160,ElliotBayTrailMyrtlePark,07/22/2017 08:00:00 AM,48,-122,12,33,45
31161,ElliotBayTrailMyrtlePark,07/22/2017 09:00:00 AM,48,-122,26,30,56
31162,ElliotBayTrailMyrtlePark,07/22/2017 10:00:00 AM,48,-122,48,32,80
31163,ElliotBayTrailMyrtlePark,07/22/2017 11:00:00 AM,48,-122,47,37,84
31164,ElliotBayTrailMyrtlePark,07/22/2017 12:00:00 PM,48,-122,62,71,133
31165,ElliotBayTrailMyrtlePark,07/22/2017 01:00:00 PM,48,-122,63,56,119
31166,ElliotBayTrailMyrtlePark,07/22/2017 02:00:00 PM,48,-122,68,50,118
31167,ElliotBayTrailMyrtlePark,07/22/2017 03:00:00 PM,48,-122,68,66,134
31168,ElliotBayTrailMyrtlePark,07/22/2017 04:00:00 PM,48,-122,54,50,104
31169,ElliotBayTrailMyrtlePark,07/22/2017 05:00:00 PM,48,-122,29,20,49
31170,ElliotBayTrailMyrtlePark,07/22/2017 06:00:00 PM,48,-122,33,30,63
31171,ElliotBayTrailMyrtlePark,07/22/2017 07:00:00 PM,48,-122,29,26,55
31172,ElliotBayTrailMyrtlePark,07/22/2017 08:00:00 PM,48,-122,25,19,44
31173,ElliotBayTrailMyrtlePark,07/22/2017 09:00:00 PM,48,-122,25,15,40
31174,ElliotBayTrailMyrtlePark,07/22/2017 10:00:00 PM,48,-122,17,5,22
31175,ElliotBayTrailMyrtlePark,07/22/2017 11:00:00 PM,48,-122,4,10,14
31176,ElliotBayTrailMyrtlePark,07/23/2017 12:00:00 AM,48,-122,20,2,22
31177,ElliotBayTrailMyrtlePark,07/23/2017 01:00:00 AM,48,-122,0,0,0
31178,ElliotBayTrailMyrtlePark,07/23/2017 02:00:00 AM,48,-122,4,0,4
31179,ElliotBayTrailMyrtlePark,07/23/2017 03:00:00 AM,48,-122,3,2,5
31180,ElliotBayTrailMyrtlePark,07/23/2017 04:00:00 AM,48,-122,2,1,3
31181,ElliotBayTrailMyrtlePark,07/23/2017 05:00:00 AM,48,-122,1,2,3
31182,ElliotBayTrailMyrtlePark,07/23/2017 06:00:00 AM,48,-122,3,5,8
31183,ElliotBayTrailMyrtlePark,07/23/2017 07:00:00 AM,48,-122,13,16,29
31184,ElliotBayTrailMyrtlePark,07/23/2017 08:00:00 AM,48,-122,19,21,40
31185,ElliotBayTrailMyrtlePark,07/23/2017 09:00:00 AM,48,-122,57,24,81
31186,ElliotBayTrailMyrtlePark,07/23/2017 10:00:00 AM,48,-122,42,45,87
31187,ElliotBayTrailMyrtlePark,07/23/2017 11:00:00 AM,48,-122,47,56,103
31188,ElliotBayTrailMyrtlePark,07/23/2017 12:00:00 PM,48,-122,67,92,159
31189,ElliotBayTrailMyrtlePark,07/23/2017 01:00:00 PM,48,-122,68,70,138
31190,ElliotBayTrailMyrtlePark,07/23/2017 02:00:00 PM,48,-122,61,41,102
31191,ElliotBayTrailMyrtlePark,07/23/2017 03:00:00 PM,48,-122,55,45,100
31192,ElliotBayTrailMyrtlePark,07/23/2017 04:00:00 PM,48,-122,53,34,87
31193,ElliotBayTrailMyrtlePark,07/23/2017 05:00:00 PM,48,-122,54,47,101
31194,ElliotBayTrailMyrtlePark,07/23/2017 06:00:00 PM,48,-122,49,49,98
31195,ElliotBayTrailMyrtlePark,07/23/2017 07:00:00 PM,48,-122,37,39,76
31196,ElliotBayTrailMyrtlePark,07/23/2017 08:00:00 PM,48,-122,35,32,67
31197,ElliotBayTrailMyrtlePark,07/23/2017 09:00:00 PM,48,-122,22,9,31
31198,ElliotBayTrailMyrtlePark,07/23/2017 10:00:00 PM,48,-122,29,8,37
31199,ElliotBayTrailMyrtlePark,07/23/2017 11:00:00 PM,48,-122,0,1,1
31200,ElliotBayTrailMyrtlePark,07/24/2017 12:00:00 AM,48,-122,0,0,0
31201,ElliotBayTrailMyrtlePark,07/24/2017 01:00:00 AM,48,-122,4,0,4
31202,ElliotBayTrailMyrtlePark,07/24/2017 02:00:00 AM,48,-122,0,0,0
31203,ElliotBayTrailMyrtlePark,07/24/2017 03:00:00 AM,48,-122,1,1,2
31204,ElliotBayTrailMyrtlePark,07/24/2017 04:00:00 AM,48,-122,0,1,1
31205,ElliotBayTrailMyrtlePark,07/24/2017 05:00:00 AM,48,-122,11,8,19
31206,ElliotBayTrailMyrtlePark,07/24/2017 06:00:00 AM,48,-122,23,37,60
31207,ElliotBayTrailMyrtlePark,07/24/2017 07:00:00 AM,48,-122,44,121,165
31208,ElliotBayTrailMyrtlePark,07/24/2017 08:00:00 AM,48,-122,78,179,257
31209,ElliotBayTrailMyrtlePark,07/24/2017 09:00:00 AM,48,-122,41,96,137
31210,ElliotBayTrailMyrtlePark,07/24/2017 10:00:00 AM,48,-122,39,31,70
31211,ElliotBayTrailMyrtlePark,07/24/2017 11:00:00 AM,48,-122,27,32,59
31212,ElliotBayTrailMyrtlePark,07/24/2017 12:00:00 PM,48,-122,37,42,79
31213,ElliotBayTrailMyrtlePark,07/24/2017 01:00:00 PM,48,-122,27,27,54
31214,ElliotBayTrailMyrtlePark,07/24/2017 02:00:00 PM,48,-122,36,43,79
31215,ElliotBayTrailMyrtlePark,07/24/2017 03:00:00 PM,48,-122,72,46,118
31216,ElliotBayTrailMyrtlePark,07/24/2017 04:00:00 PM,48,-122,110,57,167
31217,ElliotBayTrailMyrtlePark,07/24/2017 05:00:00 PM,48,-122,232,81,313
31218,ElliotBayTrailMyrtlePark,07/24/2017 06:00:00 PM,48,-122,147,56,203
31219,ElliotBayTrailMyrtlePark,07/24/2017 07:00:00 PM,48,-122,65,57,122
31220,ElliotBayTrailMyrtlePark,07/24/2017 08:00:00 PM,48,-122,41,36,77
31221,ElliotBayTrailMyrtlePark,07/24/2017 09:00:00 PM,48,-122,17,19,36
31222,ElliotBayTrailMyrtlePark,07/24/2017 10:00:00 PM,48,-122,18,7,25
31223,ElliotBayTrailMyrtlePark,07/24/2017 11:00:00 PM,48,-122,7,2,9
31224,ElliotBayTrailMyrtlePark,07/25/2017 12:00:00 AM,48,-122,3,3,6
31225,ElliotBayTrailMyrtlePark,07/25/2017 01:00:00 AM,48,-122,1,0,1
31226,ElliotBayTrailMyrtlePark,07/25/2017 02:00:00 AM,48,-122,1,2,3
31227,ElliotBayTrailMyrtlePark,07/25/2017 03:00:00 AM,48,-122,0,3,3
31228,ElliotBayTrailMyrtlePark,07/25/2017 04:00:00 AM,48,-122,3,2,5
31229,ElliotBayTrailMyrtlePark,07/25/2017 05:00:00 AM,48,-122,8,15,23
31230,ElliotBayTrailMyrtlePark,07/25/2017 06:00:00 AM,48,-122,32,58,90
31231,ElliotBayTrailMyrtlePark,07/25/2017 07:00:00 AM,48,-122,63,138,201
31232,ElliotBayTrailMyrtlePark,07/25/2017 08:00:00 AM,48,-122,73,170,243
31233,ElliotBayTrailMyrtlePark,07/25/2017 09:00:00 AM,48,-122,57,70,127
31234,ElliotBayTrailMyrtlePark,07/25/2017 10:00:00 AM,48,-122,19,29,48
31235,ElliotBayTrailMyrtlePark,07/25/2017 11:00:00 AM,48,-122,21,34,55
31236,ElliotBayTrailMyrtlePark,07/25/2017 12:00:00 PM,48,-122,34,30,64
31237,ElliotBayTrailMyrtlePark,07/25/2017 01:00:00 PM,48,-122,39,32,71
31238,ElliotBayTrailMyrtlePark,07/25/2017 02:00:00 PM,48,-122,27,37,64
31239,ElliotBayTrailMyrtlePark,07/25/2017 03:00:00 PM,48,-122,55,54,109
31240,ElliotBayTrailMyrtlePark,07/25/2017 04:00:00 PM,48,-122,133,65,198
31241,ElliotBayTrailMyrtlePark,07/25/2017 05:00:00 PM,48,-122,253,76,329
31242,ElliotBayTrailMyrtlePark,07/25/2017 06:00:00 PM,48,-122,158,68,226
31243,ElliotBayTrailMyrtlePark,07/25/2017 07:00:00 PM,48,-122,76,42,118
31244,ElliotBayTrailMyrtlePark,07/25/2017 08:00:00 PM,48,-122,50,62,112
31245,ElliotBayTrailMyrtlePark,07/25/2017 09:00:00 PM,48,-122,17,24,41
31246,ElliotBayTrailMyrtlePark,07/25/2017 10:00:00 PM,48,-122,14,15,29
31247,ElliotBayTrailMyrtlePark,07/25/2017 11:00:00 PM,48,-122,12,1,13
31248,ElliotBayTrailMyrtlePark,07/26/2017 12:00:00 AM,48,-122,5,2,7
31249,ElliotBayTrailMyrtlePark,07/26/2017 01:00:00 AM,48,-122,1,0,1
31250,ElliotBayTrailMyrtlePark,07/26/2017 02:00:00 AM,48,-122,1,0,1
31251,ElliotBayTrailMyrtlePark,07/26/2017 03:00:00 AM,48,-122,6,1,7
31252,ElliotBayTrailMyrtlePark,07/26/2017 04:00:00 AM,48,-122,0,3,3
31253,ElliotBayTrailMyrtlePark,07/26/2017 05:00:00 AM,48,-122,8,11,19
31254,ElliotBayTrailMyrtlePark,07/26/2017 06:00:00 AM,48,-122,33,49,82
31255,ElliotBayTrailMyrtlePark,07/26/2017 07:00:00 AM,48,-122,53,139,192
31256,ElliotBayTrailMyrtlePark,07/26/2017 08:00:00 AM,48,-122,50,169,219
31257,ElliotBayTrailMyrtlePark,07/26/2017 09:00:00 AM,48,-122,40,92,132
31258,ElliotBayTrailMyrtlePark,07/26/2017 10:00:00 AM,48,-122,34,43,77
31259,ElliotBayTrailMyrtlePark,07/26/2017 11:00:00 AM,48,-122,26,26,52
31260,ElliotBayTrailMyrtlePark,07/26/2017 12:00:00 PM,48,-122,27,36,63
31261,ElliotBayTrailMyrtlePark,07/26/2017 01:00:00 PM,48,-122,36,27,63
31262,ElliotBayTrailMyrtlePark,07/26/2017 02:00:00 PM,48,-122,45,39,84
31263,ElliotBayTrailMyrtlePark,07/26/2017 03:00:00 PM,48,-122,67,56,123
31264,ElliotBayTrailMyrtlePark,07/26/2017 04:00:00 PM,48,-122,134,56,190
31265,ElliotBayTrailMyrtlePark,07/26/2017 05:00:00 PM,48,-122,242,89,331
31266,ElliotBayTrailMyrtlePark,07/26/2017 06:00:00 PM,48,-122,167,61,228
31267,ElliotBayTrailMyrtlePark,07/26/2017 07:00:00 PM,48,-122,72,47,119
31268,ElliotBayTrailMyrtlePark,07/26/2017 08:00:00 PM,48,-122,46,48,94
31269,ElliotBayTrailMyrtlePark,07/26/2017 09:00:00 PM,48,-122,18,26,44
31270,ElliotBayTrailMyrtlePark,07/26/2017 10:00:00 PM,48,-122,11,3,14
31271,ElliotBayTrailMyrtlePark,07/26/2017 11:00:00 PM,48,-122,3,8,11
31272,ElliotBayTrailMyrtlePark,07/27/2017 12:00:00 AM,48,-122,1,1,2
31273,ElliotBayTrailMyrtlePark,07/27/2017 01:00:00 AM,48,-122,2,0,2
31274,ElliotBayTrailMyrtlePark,07/27/2017 02:00:00 AM,48,-122,2,0,2
31275,ElliotBayTrailMyrtlePark,07/27/2017 03:00:00 AM,48,-122,1,3,4
31276,ElliotBayTrailMyrtlePark,07/27/2017 04:00:00 AM,48,-122,4,1,5
31277,ElliotBayTrailMyrtlePark,07/27/2017 05:00:00 AM,48,-122,10,17,27
31278,ElliotBayTrailMyrtlePark,07/27/2017 06:00:00 AM,48,-122,19,46,65
31279,ElliotBayTrailMyrtlePark,07/27/2017 07:00:00 AM,48,-122,37,90,127
31280,ElliotBayTrailMyrtlePark,07/27/2017 08:00:00 AM,48,-122,39,143,182
31281,ElliotBayTrailMyrtlePark,07/27/2017 09:00:00 AM,48,-122,31,59,90
31282,ElliotBayTrailMyrtlePark,07/27/2017 10:00:00 AM,48,-122,30,32,62
31283,ElliotBayTrailMyrtlePark,07/27/2017 11:00:00 AM,48,-122,25,22,47
31284,ElliotBayTrailMyrtlePark,07/27/2017 12:00:00 PM,48,-122,26,22,48
31285,ElliotBayTrailMyrtlePark,07/27/2017 01:00:00 PM,48,-122,21,23,44
31286,ElliotBayTrailMyrtlePark,07/27/2017 02:00:00 PM,48,-122,20,23,43
31287,ElliotBayTrailMyrtlePark,07/27/2017 03:00:00 PM,48,-122,44,40,84
31288,ElliotBayTrailMyrtlePark,07/27/2017 04:00:00 PM,48,-122,109,61,170
31289,ElliotBayTrailMyrtlePark,07/27/2017 05:00:00 PM,48,-122,208,76,284
31290,ElliotBayTrailMyrtlePark,07/27/2017 06:00:00 PM,48,-122,138,76,214
31291,ElliotBayTrailMyrtlePark,07/27/2017 07:00:00 PM,48,-122,72,39,111
31292,ElliotBayTrailMyrtlePark,07/27/2017 08:00:00 PM,48,-122,46,40,86
31293,ElliotBayTrailMyrtlePark,07/27/2017 09:00:00 PM,48,-122,21,22,43
31294,ElliotBayTrailMyrtlePark,07/27/2017 10:00:00 PM,48,-122,11,5,16
31295,ElliotBayTrailMyrtlePark,07/27/2017 11:00:00 PM,48,-122,8,3,11
31296,ElliotBayTrailMyrtlePark,07/28/2017 12:00:00 AM,48,-122,4,3,7
31297,ElliotBayTrailMyrtlePark,07/28/2017 01:00:00 AM,48,-122,1,2,3
31298,ElliotBayTrailMyrtlePark,07/28/2017 02:00:00 AM,48,-122,1,2,3
31299,ElliotBayTrailMyrtlePark,07/28/2017 03:00:00 AM,48,-122,2,1,3
31300,ElliotBayTrailMyrtlePark,07/28/2017 04:00:00 AM,48,-122,2,3,5
31301,ElliotBayTrailMyrtlePark,07/28/2017 05:00:00 AM,48,-122,10,11,21
31302,ElliotBayTrailMyrtlePark,07/28/2017 06:00:00 AM,48,-122,17,36,53
31303,ElliotBayTrailMyrtlePark,07/28/2017 07:00:00 AM,48,-122,34,103,137
31304,ElliotBayTrailMyrtlePark,07/28/2017 08:00:00 AM,48,-122,47,150,197
31305,ElliotBayTrailMyrtlePark,07/28/2017 09:00:00 AM,48,-122,45,68,113
31306,ElliotBayTrailMyrtlePark,07/28/2017 10:00:00 AM,48,-122,19,48,67
31307,ElliotBayTrailMyrtlePark,07/28/2017 11:00:00 AM,48,-122,41,24,65
31308,ElliotBayTrailMyrtlePark,07/28/2017 12:00:00 PM,48,-122,36,44,80
31309,ElliotBayTrailMyrtlePark,07/28/2017 01:00:00 PM,48,-122,33,45,78
31310,ElliotBayTrailMyrtlePark,07/28/2017 02:00:00 PM,48,-122,43,51,94
31311,ElliotBayTrailMyrtlePark,07/28/2017 03:00:00 PM,48,-122,93,47,140
31312,ElliotBayTrailMyrtlePark,07/28/2017 04:00:00 PM,48,-122,124,73,197
31313,ElliotBayTrailMyrtlePark,07/28/2017 05:00:00 PM,48,-122,201,77,278
31314,ElliotBayTrailMyrtlePark,07/28/2017 06:00:00 PM,48,-122,100,59,159
31315,ElliotBayTrailMyrtlePark,07/28/2017 07:00:00 PM,48,-122,75,55,130
31316,ElliotBayTrailMyrtlePark,07/28/2017 08:00:00 PM,48,-122,46,22,68
31317,ElliotBayTrailMyrtlePark,07/28/2017 09:00:00 PM,48,-122,19,28,47
31318,ElliotBayTrailMyrtlePark,07/28/2017 10:00:00 PM,48,-122,11,5,16
31319,ElliotBayTrailMyrtlePark,07/28/2017 11:00:00 PM,48,-122,15,3,18
31320,ElliotBayTrailMyrtlePark,07/29/2017 12:00:00 AM,48,-122,7,1,8
31321,ElliotBayTrailMyrtlePark,07/29/2017 01:00:00 AM,48,-122,1,0,1
31322,ElliotBayTrailMyrtlePark,07/29/2017 02:00:00 AM,48,-122,1,2,3
31323,ElliotBayTrailMyrtlePark,07/29/2017 03:00:00 AM,48,-122,2,0,2
31324,ElliotBayTrailMyrtlePark,07/29/2017 04:00:00 AM,48,-122,1,0,1
31325,ElliotBayTrailMyrtlePark,07/29/2017 05:00:00 AM,48,-122,1,4,5
31326,ElliotBayTrailMyrtlePark,07/29/2017 06:00:00 AM,48,-122,7,8,15
31327,ElliotBayTrailMyrtlePark,07/29/2017 07:00:00 AM,48,-122,17,10,27
31328,ElliotBayTrailMyrtlePark,07/29/2017 08:00:00 AM,48,-122,34,35,69
31329,ElliotBayTrailMyrtlePark,07/29/2017 09:00:00 AM,48,-122,39,49,88
31330,ElliotBayTrailMyrtlePark,07/29/2017 10:00:00 AM,48,-122,49,64,113
31331,ElliotBayTrailMyrtlePark,07/29/2017 11:00:00 AM,48,-122,46,62,108
31332,ElliotBayTrailMyrtlePark,07/29/2017 12:00:00 PM,48,-122,88,86,174
31333,ElliotBayTrailMyrtlePark,07/29/2017 01:00:00 PM,48,-122,58,104,162
31334,ElliotBayTrailMyrtlePark,07/29/2017 02:00:00 PM,48,-122,81,62,143
31335,ElliotBayTrailMyrtlePark,07/29/2017 03:00:00 PM,48,-122,98,65,163
31336,ElliotBayTrailMyrtlePark,07/29/2017 04:00:00 PM,48,-122,86,51,137
31337,ElliotBayTrailMyrtlePark,07/29/2017 05:00:00 PM,48,-122,97,69,166
31338,ElliotBayTrailMyrtlePark,07/29/2017 06:00:00 PM,48,-122,72,47,119
31339,ElliotBayTrailMyrtlePark,07/29/2017 07:00:00 PM,48,-122,39,37,76
31340,ElliotBayTrailMyrtlePark,07/29/2017 08:00:00 PM,48,-122,57,27,84
31341,ElliotBayTrailMyrtlePark,07/29/2017 09:00:00 PM,48,-122,13,32,45
31342,ElliotBayTrailMyrtlePark,07/29/2017 10:00:00 PM,48,-122,17,15,32
31343,ElliotBayTrailMyrtlePark,07/29/2017 11:00:00 PM,48,-122,5,7,12
31344,ElliotBayTrailMyrtlePark,07/30/2017 12:00:00 AM,48,-122,10,7,17
31345,ElliotBayTrailMyrtlePark,07/30/2017 01:00:00 AM,48,-122,1,0,1
31346,ElliotBayTrailMyrtlePark,07/30/2017 02:00:00 AM,48,-122,1,0,1
31347,ElliotBayTrailMyrtlePark,07/30/2017 03:00:00 AM,48,-122,2,0,2
31348,ElliotBayTrailMyrtlePark,07/30/2017 04:00:00 AM,48,-122,0,1,1
31349,ElliotBayTrailMyrtlePark,07/30/2017 05:00:00 AM,48,-122,3,3,6
31350,ElliotBayTrailMyrtlePark,07/30/2017 06:00:00 AM,48,-122,5,4,9
31351,ElliotBayTrailMyrtlePark,07/30/2017 07:00:00 AM,48,-122,14,15,29
31352,ElliotBayTrailMyrtlePark,07/30/2017 08:00:00 AM,48,-122,14,16,30
31353,ElliotBayTrailMyrtlePark,07/30/2017 09:00:00 AM,48,-122,26,36,62
31354,ElliotBayTrailMyrtlePark,07/30/2017 10:00:00 AM,48,-122,52,59,111
31355,ElliotBayTrailMyrtlePark,07/30/2017 11:00:00 AM,48,-122,41,52,93
31356,ElliotBayTrailMyrtlePark,07/30/2017 12:00:00 PM,48,-122,82,87,169
31357,ElliotBayTrailMyrtlePark,07/30/2017 01:00:00 PM,48,-122,95,81,176
31358,ElliotBayTrailMyrtlePark,07/30/2017 02:00:00 PM,48,-122,86,78,164
31359,ElliotBayTrailMyrtlePark,07/30/2017 03:00:00 PM,48,-122,94,93,187
31360,ElliotBayTrailMyrtlePark,07/30/2017 04:00:00 PM,48,-122,110,78,188
31361,ElliotBayTrailMyrtlePark,07/30/2017 05:00:00 PM,48,-122,75,64,139
31362,ElliotBayTrailMyrtlePark,07/30/2017 06:00:00 PM,48,-122,57,32,89
31363,ElliotBayTrailMyrtlePark,07/30/2017 07:00:00 PM,48,-122,45,47,92
31364,ElliotBayTrailMyrtlePark,07/30/2017 08:00:00 PM,48,-122,61,59,120
31365,ElliotBayTrailMyrtlePark,07/30/2017 09:00:00 PM,48,-122,7,34,41
31366,ElliotBayTrailMyrtlePark,07/30/2017 10:00:00 PM,48,-122,15,9,24
31367,ElliotBayTrailMyrtlePark,07/30/2017 11:00:00 PM,48,-122,2,0,2
31368,ElliotBayTrailMyrtlePark,07/31/2017 12:00:00 AM,48,-122,4,0,4
31369,ElliotBayTrailMyrtlePark,07/31/2017 01:00:00 AM,48,-122,0,4,4
31370,ElliotBayTrailMyrtlePark,07/31/2017 02:00:00 AM,48,-122,2,0,2
31371,ElliotBayTrailMyrtlePark,07/31/2017 03:00:00 AM,48,-122,0,2,2
31372,ElliotBayTrailMyrtlePark,07/31/2017 04:00:00 AM,48,-122,5,2,7
31373,ElliotBayTrailMyrtlePark,07/31/2017 05:00:00 AM,48,-122,11,19,30
31374,ElliotBayTrailMyrtlePark,07/31/2017 06:00:00 AM,48,-122,18,44,62
31375,ElliotBayTrailMyrtlePark,07/31/2017 07:00:00 AM,48,-122,50,118,168
31376,ElliotBayTrailMyrtlePark,07/31/2017 08:00:00 AM,48,-122,76,177,253
31377,ElliotBayTrailMyrtlePark,07/31/2017 09:00:00 AM,48,-122,43,75,118
31378,ElliotBayTrailMyrtlePark,07/31/2017 10:00:00 AM,48,-122,25,49,74
31379,ElliotBayTrailMyrtlePark,07/31/2017 11:00:00 AM,48,-122,27,25,52
31380,ElliotBayTrailMyrtlePark,07/31/2017 12:00:00 PM,48,-122,41,39,80
31381,ElliotBayTrailMyrtlePark,07/31/2017 01:00:00 PM,48,-122,33,25,58
31382,ElliotBayTrailMyrtlePark,07/31/2017 02:00:00 PM,48,-122,39,36,75
31383,ElliotBayTrailMyrtlePark,07/31/2017 03:00:00 PM,48,-122,60,50,110
31384,ElliotBayTrailMyrtlePark,07/31/2017 04:00:00 PM,48,-122,118,69,187
31385,ElliotBayTrailMyrtlePark,07/31/2017 05:00:00 PM,48,-122,252,86,338
31386,ElliotBayTrailMyrtlePark,07/31/2017 06:00:00 PM,48,-122,161,61,222
31387,ElliotBayTrailMyrtlePark,07/31/2017 07:00:00 PM,48,-122,77,60,137
31388,ElliotBayTrailMyrtlePark,07/31/2017 08:00:00 PM,48,-122,33,30,63
31389,ElliotBayTrailMyrtlePark,07/31/2017 09:00:00 PM,48,-122,22,22,44
31390,ElliotBayTrailMyrtlePark,07/31/2017 10:00:00 PM,48,-122,5,5,10
31391,ElliotBayTrailMyrtlePark,07/31/2017 11:00:00 PM,48,-122,10,0,10
31392,ElliotBayTrailMyrtlePark,08/01/2017 12:00:00 AM,48,-122,4,2,6
31393,ElliotBayTrailMyrtlePark,08/01/2017 01:00:00 AM,48,-122,0,0,0
31394,ElliotBayTrailMyrtlePark,08/01/2017 02:00:00 AM,48,-122,0,0,0
31395,ElliotBayTrailMyrtlePark,08/01/2017 03:00:00 AM,48,-122,0,1,1
31396,ElliotBayTrailMyrtlePark,08/01/2017 04:00:00 AM,48,-122,0,1,1
31397,ElliotBayTrailMyrtlePark,08/01/2017 05:00:00 AM,48,-122,6,19,25
31398,ElliotBayTrailMyrtlePark,08/01/2017 06:00:00 AM,48,-122,35,41,76
31399,ElliotBayTrailMyrtlePark,08/01/2017 07:00:00 AM,48,-122,58,140,198
31400,ElliotBayTrailMyrtlePark,08/01/2017 08:00:00 AM,48,-122,61,199,260
31401,ElliotBayTrailMyrtlePark,08/01/2017 09:00:00 AM,48,-122,38,88,126
31402,ElliotBayTrailMyrtlePark,08/01/2017 10:00:00 AM,48,-122,22,37,59
31403,ElliotBayTrailMyrtlePark,08/01/2017 11:00:00 AM,48,-122,36,25,61
31404,ElliotBayTrailMyrtlePark,08/01/2017 12:00:00 PM,48,-122,33,33,66
31405,ElliotBayTrailMyrtlePark,08/01/2017 01:00:00 PM,48,-122,28,41,69
31406,ElliotBayTrailMyrtlePark,08/01/2017 02:00:00 PM,48,-122,40,36,76
31407,ElliotBayTrailMyrtlePark,08/01/2017 03:00:00 PM,48,-122,55,36,91
31408,ElliotBayTrailMyrtlePark,08/01/2017 04:00:00 PM,48,-122,126,83,209
31409,ElliotBayTrailMyrtlePark,08/01/2017 05:00:00 PM,48,-122,271,95,366
31410,ElliotBayTrailMyrtlePark,08/01/2017 06:00:00 PM,48,-122,151,52,203
31411,ElliotBayTrailMyrtlePark,08/01/2017 07:00:00 PM,48,-122,85,41,126
31412,ElliotBayTrailMyrtlePark,08/01/2017 08:00:00 PM,48,-122,50,46,96
31413,ElliotBayTrailMyrtlePark,08/01/2017 09:00:00 PM,48,-122,27,24,51
31414,ElliotBayTrailMyrtlePark,08/01/2017 10:00:00 PM,48,-122,20,7,27
31415,ElliotBayTrailMyrtlePark,08/01/2017 11:00:00 PM,48,-122,3,2,5
31416,ElliotBayTrailMyrtlePark,08/02/2017 12:00:00 AM,48,-122,2,1,3
31417,ElliotBayTrailMyrtlePark,08/02/2017 01:00:00 AM,48,-122,3,1,4
31418,ElliotBayTrailMyrtlePark,08/02/2017 02:00:00 AM,48,-122,2,3,5
31419,ElliotBayTrailMyrtlePark,08/02/2017 03:00:00 AM,48,-122,0,2,2
31420,ElliotBayTrailMyrtlePark,08/02/2017 04:00:00 AM,48,-122,0,1,1
31421,ElliotBayTrailMyrtlePark,08/02/2017 05:00:00 AM,48,-122,11,22,33
31422,ElliotBayTrailMyrtlePark,08/02/2017 06:00:00 AM,48,-122,31,53,84
31423,ElliotBayTrailMyrtlePark,08/02/2017 07:00:00 AM,48,-122,60,119,179
31424,ElliotBayTrailMyrtlePark,08/02/2017 08:00:00 AM,48,-122,57,177,234
31425,ElliotBayTrailMyrtlePark,08/02/2017 09:00:00 AM,48,-122,58,66,124
31426,ElliotBayTrailMyrtlePark,08/02/2017 10:00:00 AM,48,-122,23,52,75
31427,ElliotBayTrailMyrtlePark,08/02/2017 11:00:00 AM,48,-122,22,29,51
31428,ElliotBayTrailMyrtlePark,08/02/2017 12:00:00 PM,48,-122,35,22,57
31429,ElliotBayTrailMyrtlePark,08/02/2017 01:00:00 PM,48,-122,40,35,75
31430,ElliotBayTrailMyrtlePark,08/02/2017 02:00:00 PM,48,-122,40,27,67
31431,ElliotBayTrailMyrtlePark,08/02/2017 03:00:00 PM,48,-122,64,49,113
31432,ElliotBayTrailMyrtlePark,08/02/2017 04:00:00 PM,48,-122,89,52,141
31433,ElliotBayTrailMyrtlePark,08/02/2017 05:00:00 PM,48,-122,214,69,283
31434,ElliotBayTrailMyrtlePark,08/02/2017 06:00:00 PM,48,-122,121,55,176
31435,ElliotBayTrailMyrtlePark,08/02/2017 07:00:00 PM,48,-122,54,42,96
31436,ElliotBayTrailMyrtlePark,08/02/2017 08:00:00 PM,48,-122,46,43,89
31437,ElliotBayTrailMyrtlePark,08/02/2017 09:00:00 PM,48,-122,26,27,53
31438,ElliotBayTrailMyrtlePark,08/02/2017 10:00:00 PM,48,-122,16,3,19
31439,ElliotBayTrailMyrtlePark,08/02/2017 11:00:00 PM,48,-122,8,1,9
31440,ElliotBayTrailMyrtlePark,08/03/2017 12:00:00 AM,48,-122,4,2,6
31441,ElliotBayTrailMyrtlePark,08/03/2017 01:00:00 AM,48,-122,1,0,1
31442,ElliotBayTrailMyrtlePark,08/03/2017 02:00:00 AM,48,-122,1,0,1
31443,ElliotBayTrailMyrtlePark,08/03/2017 03:00:00 AM,48,-122,0,3,3
31444,ElliotBayTrailMyrtlePark,08/03/2017 04:00:00 AM,48,-122,1,1,2
31445,ElliotBayTrailMyrtlePark,08/03/2017 05:00:00 AM,48,-122,7,12,19
31446,ElliotBayTrailMyrtlePark,08/03/2017 06:00:00 AM,48,-122,24,33,57
31447,ElliotBayTrailMyrtlePark,08/03/2017 07:00:00 AM,48,-122,56,101,157
31448,ElliotBayTrailMyrtlePark,08/03/2017 08:00:00 AM,48,-122,42,147,189
31449,ElliotBayTrailMyrtlePark,08/03/2017 09:00:00 AM,48,-122,42,62,104
31450,ElliotBayTrailMyrtlePark,08/03/2017 10:00:00 AM,48,-122,24,38,62
31451,ElliotBayTrailMyrtlePark,08/03/2017 11:00:00 AM,48,-122,21,40,61
31452,ElliotBayTrailMyrtlePark,08/03/2017 12:00:00 PM,48,-122,27,37,64
31453,ElliotBayTrailMyrtlePark,08/03/2017 01:00:00 PM,48,-122,32,46,78
31454,ElliotBayTrailMyrtlePark,08/03/2017 02:00:00 PM,48,-122,32,26,58
31455,ElliotBayTrailMyrtlePark,08/03/2017 03:00:00 PM,48,-122,61,43,104
31456,ElliotBayTrailMyrtlePark,08/03/2017 04:00:00 PM,48,-122,94,53,147
31457,ElliotBayTrailMyrtlePark,08/03/2017 05:00:00 PM,48,-122,199,72,271
31458,ElliotBayTrailMyrtlePark,08/03/2017 06:00:00 PM,48,-122,121,53,174
31459,ElliotBayTrailMyrtlePark,08/03/2017 07:00:00 PM,48,-122,63,21,84
31460,ElliotBayTrailMyrtlePark,08/03/2017 08:00:00 PM,48,-122,38,36,74
31461,ElliotBayTrailMyrtlePark,08/03/2017 09:00:00 PM,48,-122,22,17,39
31462,ElliotBayTrailMyrtlePark,08/03/2017 10:00:00 PM,48,-122,8,11,19
31463,ElliotBayTrailMyrtlePark,08/03/2017 11:00:00 PM,48,-122,3,1,4
31464,ElliotBayTrailMyrtlePark,08/04/2017 12:00:00 AM,48,-122,3,4,7
31465,ElliotBayTrailMyrtlePark,08/04/2017 01:00:00 AM,48,-122,9,0,9
31466,ElliotBayTrailMyrtlePark,08/04/2017 02:00:00 AM,48,-122,1,2,3
31467,ElliotBayTrailMyrtlePark,08/04/2017 03:00:00 AM,48,-122,0,1,1
31468,ElliotBayTrailMyrtlePark,08/04/2017 04:00:00 AM,48,-122,0,2,2
31469,ElliotBayTrailMyrtlePark,08/04/2017 05:00:00 AM,48,-122,4,12,16
31470,ElliotBayTrailMyrtlePark,08/04/2017 06:00:00 AM,48,-122,21,31,52
31471,ElliotBayTrailMyrtlePark,08/04/2017 07:00:00 AM,48,-122,53,102,155
31472,ElliotBayTrailMyrtlePark,08/04/2017 08:00:00 AM,48,-122,43,138,181
31473,ElliotBayTrailMyrtlePark,08/04/2017 09:00:00 AM,48,-122,44,58,102
31474,ElliotBayTrailMyrtlePark,08/04/2017 10:00:00 AM,48,-122,21,29,50
31475,ElliotBayTrailMyrtlePark,08/04/2017 11:00:00 AM,48,-122,34,36,70
31476,ElliotBayTrailMyrtlePark,08/04/2017 12:00:00 PM,48,-122,36,30,66
31477,ElliotBayTrailMyrtlePark,08/04/2017 01:00:00 PM,48,-122,34,29,63
31478,ElliotBayTrailMyrtlePark,08/04/2017 02:00:00 PM,48,-122,41,53,94
31479,ElliotBayTrailMyrtlePark,08/04/2017 03:00:00 PM,48,-122,80,41,121
31480,ElliotBayTrailMyrtlePark,08/04/2017 04:00:00 PM,48,-122,87,57,144
31481,ElliotBayTrailMyrtlePark,08/04/2017 05:00:00 PM,48,-122,136,69,205
31482,ElliotBayTrailMyrtlePark,08/04/2017 06:00:00 PM,48,-122,92,40,132
31483,ElliotBayTrailMyrtlePark,08/04/2017 07:00:00 PM,48,-122,50,41,91
31484,ElliotBayTrailMyrtlePark,08/04/2017 08:00:00 PM,48,-122,18,17,35
31485,ElliotBayTrailMyrtlePark,08/04/2017 09:00:00 PM,48,-122,24,21,45
31486,ElliotBayTrailMyrtlePark,08/04/2017 10:00:00 PM,48,-122,13,6,19
31487,ElliotBayTrailMyrtlePark,08/04/2017 11:00:00 PM,48,-122,4,5,9
31488,ElliotBayTrailMyrtlePark,08/05/2017 12:00:00 AM,48,-122,2,1,3
31489,ElliotBayTrailMyrtlePark,08/05/2017 01:00:00 AM,48,-122,1,1,2
31490,ElliotBayTrailMyrtlePark,08/05/2017 02:00:00 AM,48,-122,0,0,0
31491,ElliotBayTrailMyrtlePark,08/05/2017 03:00:00 AM,48,-122,0,3,3
31492,ElliotBayTrailMyrtlePark,08/05/2017 04:00:00 AM,48,-122,0,0,0
31493,ElliotBayTrailMyrtlePark,08/05/2017 05:00:00 AM,48,-122,2,1,3
31494,ElliotBayTrailMyrtlePark,08/05/2017 06:00:00 AM,48,-122,7,6,13
31495,ElliotBayTrailMyrtlePark,08/05/2017 07:00:00 AM,48,-122,20,20,40
31496,ElliotBayTrailMyrtlePark,08/05/2017 08:00:00 AM,48,-122,18,43,61
31497,ElliotBayTrailMyrtlePark,08/05/2017 09:00:00 AM,48,-122,34,26,60
31498,ElliotBayTrailMyrtlePark,08/05/2017 10:00:00 AM,48,-122,59,61,120
31499,ElliotBayTrailMyrtlePark,08/05/2017 11:00:00 AM,48,-122,54,50,104
31500,ElliotBayTrailMyrtlePark,08/05/2017 12:00:00 PM,48,-122,49,47,96
31501,ElliotBayTrailMyrtlePark,08/05/2017 01:00:00 PM,48,-122,36,52,88
31502,ElliotBayTrailMyrtlePark,08/05/2017 02:00:00 PM,48,-122,65,45,110
31503,ElliotBayTrailMyrtlePark,08/05/2017 03:00:00 PM,48,-122,73,57,130
31504,ElliotBayTrailMyrtlePark,08/05/2017 04:00:00 PM,48,-122,55,51,106
31505,ElliotBayTrailMyrtlePark,08/05/2017 05:00:00 PM,48,-122,65,66,131
31506,ElliotBayTrailMyrtlePark,08/05/2017 06:00:00 PM,48,-122,45,46,91
31507,ElliotBayTrailMyrtlePark,08/05/2017 07:00:00 PM,48,-122,30,37,67
31508,ElliotBayTrailMyrtlePark,08/05/2017 08:00:00 PM,48,-122,54,37,91
31509,ElliotBayTrailMyrtlePark,08/05/2017 09:00:00 PM,48,-122,18,13,31
31510,ElliotBayTrailMyrtlePark,08/05/2017 10:00:00 PM,48,-122,11,2,13
31511,ElliotBayTrailMyrtlePark,08/05/2017 11:00:00 PM,48,-122,16,1,17
31512,ElliotBayTrailMyrtlePark,08/06/2017 12:00:00 AM,48,-122,10,4,14
31513,ElliotBayTrailMyrtlePark,08/06/2017 01:00:00 AM,48,-122,16,1,17
31514,ElliotBayTrailMyrtlePark,08/06/2017 02:00:00 AM,48,-122,3,3,6
31515,ElliotBayTrailMyrtlePark,08/06/2017 03:00:00 AM,48,-122,2,0,2
31516,ElliotBayTrailMyrtlePark,08/06/2017 04:00:00 AM,48,-122,2,1,3
31517,ElliotBayTrailMyrtlePark,08/06/2017 05:00:00 AM,48,-122,2,2,4
31518,ElliotBayTrailMyrtlePark,08/06/2017 06:00:00 AM,48,-122,9,3,12
31519,ElliotBayTrailMyrtlePark,08/06/2017 07:00:00 AM,48,-122,22,21,43
31520,ElliotBayTrailMyrtlePark,08/06/2017 08:00:00 AM,48,-122,20,58,78
31521,ElliotBayTrailMyrtlePark,08/06/2017 09:00:00 AM,48,-122,50,30,80
31522,ElliotBayTrailMyrtlePark,08/06/2017 10:00:00 AM,48,-122,63,60,123
31523,ElliotBayTrailMyrtlePark,08/06/2017 11:00:00 AM,48,-122,53,61,114
31524,ElliotBayTrailMyrtlePark,08/06/2017 12:00:00 PM,48,-122,52,66,118
31525,ElliotBayTrailMyrtlePark,08/06/2017 01:00:00 PM,48,-122,64,61,125
31526,ElliotBayTrailMyrtlePark,08/06/2017 02:00:00 PM,48,-122,88,74,162
31527,ElliotBayTrailMyrtlePark,08/06/2017 03:00:00 PM,48,-122,94,69,163
31528,ElliotBayTrailMyrtlePark,08/06/2017 04:00:00 PM,48,-122,71,62,133
31529,ElliotBayTrailMyrtlePark,08/06/2017 05:00:00 PM,48,-122,65,49,114
31530,ElliotBayTrailMyrtlePark,08/06/2017 06:00:00 PM,48,-122,62,33,95
31531,ElliotBayTrailMyrtlePark,08/06/2017 07:00:00 PM,48,-122,22,25,47
31532,ElliotBayTrailMyrtlePark,08/06/2017 08:00:00 PM,48,-122,42,20,62
31533,ElliotBayTrailMyrtlePark,08/06/2017 09:00:00 PM,48,-122,7,12,19
31534,ElliotBayTrailMyrtlePark,08/06/2017 10:00:00 PM,48,-122,7,0,7
31535,ElliotBayTrailMyrtlePark,08/06/2017 11:00:00 PM,48,-122,3,1,4
31536,ElliotBayTrailMyrtlePark,08/07/2017 12:00:00 AM,48,-122,0,2,2
31537,ElliotBayTrailMyrtlePark,08/07/2017 01:00:00 AM,48,-122,3,0,3
31538,ElliotBayTrailMyrtlePark,08/07/2017 02:00:00 AM,48,-122,1,0,1
31539,ElliotBayTrailMyrtlePark,08/07/2017 03:00:00 AM,48,-122,2,1,3
31540,ElliotBayTrailMyrtlePark,08/07/2017 04:00:00 AM,48,-122,4,2,6
31541,ElliotBayTrailMyrtlePark,08/07/2017 05:00:00 AM,48,-122,8,13,21
31542,ElliotBayTrailMyrtlePark,08/07/2017 06:00:00 AM,48,-122,18,37,55
31543,ElliotBayTrailMyrtlePark,08/07/2017 07:00:00 AM,48,-122,60,109,169
31544,ElliotBayTrailMyrtlePark,08/07/2017 08:00:00 AM,48,-122,60,170,230
31545,ElliotBayTrailMyrtlePark,08/07/2017 09:00:00 AM,48,-122,24,66,90
31546,ElliotBayTrailMyrtlePark,08/07/2017 10:00:00 AM,48,-122,22,25,47
31547,ElliotBayTrailMyrtlePark,08/07/2017 11:00:00 AM,48,-122,23,26,49
31548,ElliotBayTrailMyrtlePark,08/07/2017 12:00:00 PM,48,-122,36,41,77
31549,ElliotBayTrailMyrtlePark,08/07/2017 01:00:00 PM,48,-122,29,31,60
31550,ElliotBayTrailMyrtlePark,08/07/2017 02:00:00 PM,48,-122,34,28,62
31551,ElliotBayTrailMyrtlePark,08/07/2017 03:00:00 PM,48,-122,61,35,96
31552,ElliotBayTrailMyrtlePark,08/07/2017 04:00:00 PM,48,-122,88,59,147
31553,ElliotBayTrailMyrtlePark,08/07/2017 05:00:00 PM,48,-122,219,92,311
31554,ElliotBayTrailMyrtlePark,08/07/2017 06:00:00 PM,48,-122,130,53,183
31555,ElliotBayTrailMyrtlePark,08/07/2017 07:00:00 PM,48,-122,74,30,104
31556,ElliotBayTrailMyrtlePark,08/07/2017 08:00:00 PM,48,-122,40,30,70
31557,ElliotBayTrailMyrtlePark,08/07/2017 09:00:00 PM,48,-122,13,20,33
31558,ElliotBayTrailMyrtlePark,08/07/2017 10:00:00 PM,48,-122,11,3,14
31559,ElliotBayTrailMyrtlePark,08/07/2017 11:00:00 PM,48,-122,3,2,5
31560,ElliotBayTrailMyrtlePark,08/08/2017 12:00:00 AM,48,-122,1,0,1
31561,ElliotBayTrailMyrtlePark,08/08/2017 01:00:00 AM,48,-122,2,0,2
31562,ElliotBayTrailMyrtlePark,08/08/2017 02:00:00 AM,48,-122,1,0,1
31563,ElliotBayTrailMyrtlePark,08/08/2017 03:00:00 AM,48,-122,2,1,3
31564,ElliotBayTrailMyrtlePark,08/08/2017 04:00:00 AM,48,-122,0,4,4
31565,ElliotBayTrailMyrtlePark,08/08/2017 05:00:00 AM,48,-122,7,14,21
31566,ElliotBayTrailMyrtlePark,08/08/2017 06:00:00 AM,48,-122,23,44,67
31567,ElliotBayTrailMyrtlePark,08/08/2017 07:00:00 AM,48,-122,42,138,180
31568,ElliotBayTrailMyrtlePark,08/08/2017 08:00:00 AM,48,-122,57,181,238
31569,ElliotBayTrailMyrtlePark,08/08/2017 09:00:00 AM,48,-122,38,88,126
31570,ElliotBayTrailMyrtlePark,08/08/2017 10:00:00 AM,48,-122,30,29,59
31571,ElliotBayTrailMyrtlePark,08/08/2017 11:00:00 AM,48,-122,27,24,51
31572,ElliotBayTrailMyrtlePark,08/08/2017 12:00:00 PM,48,-122,28,46,74
31573,ElliotBayTrailMyrtlePark,08/08/2017 01:00:00 PM,48,-122,23,38,61
31574,ElliotBayTrailMyrtlePark,08/08/2017 02:00:00 PM,48,-122,42,33,75
31575,ElliotBayTrailMyrtlePark,08/08/2017 03:00:00 PM,48,-122,63,36,99
31576,ElliotBayTrailMyrtlePark,08/08/2017 04:00:00 PM,48,-122,123,65,188
31577,ElliotBayTrailMyrtlePark,08/08/2017 05:00:00 PM,48,-122,238,84,322
31578,ElliotBayTrailMyrtlePark,08/08/2017 06:00:00 PM,48,-122,142,49,191
31579,ElliotBayTrailMyrtlePark,08/08/2017 07:00:00 PM,48,-122,75,38,113
31580,ElliotBayTrailMyrtlePark,08/08/2017 08:00:00 PM,48,-122,48,45,93
31581,ElliotBayTrailMyrtlePark,08/08/2017 09:00:00 PM,48,-122,14,19,33
31582,ElliotBayTrailMyrtlePark,08/08/2017 10:00:00 PM,48,-122,9,13,22
31583,ElliotBayTrailMyrtlePark,08/08/2017 11:00:00 PM,48,-122,4,1,5
31584,ElliotBayTrailMyrtlePark,08/09/2017 12:00:00 AM,48,-122,2,4,6
31585,ElliotBayTrailMyrtlePark,08/09/2017 01:00:00 AM,48,-122,1,0,1
31586,ElliotBayTrailMyrtlePark,08/09/2017 02:00:00 AM,48,-122,4,1,5
31587,ElliotBayTrailMyrtlePark,08/09/2017 03:00:00 AM,48,-122,1,3,4
31588,ElliotBayTrailMyrtlePark,08/09/2017 04:00:00 AM,48,-122,2,2,4
31589,ElliotBayTrailMyrtlePark,08/09/2017 05:00:00 AM,48,-122,9,15,24
31590,ElliotBayTrailMyrtlePark,08/09/2017 06:00:00 AM,48,-122,25,43,68
31591,ElliotBayTrailMyrtlePark,08/09/2017 07:00:00 AM,48,-122,53,116,169
31592,ElliotBayTrailMyrtlePark,08/09/2017 08:00:00 AM,48,-122,43,153,196
31593,ElliotBayTrailMyrtlePark,08/09/2017 09:00:00 AM,48,-122,40,95,135
31594,ElliotBayTrailMyrtlePark,08/09/2017 10:00:00 AM,48,-122,29,39,68
31595,ElliotBayTrailMyrtlePark,08/09/2017 11:00:00 AM,48,-122,41,39,80
31596,ElliotBayTrailMyrtlePark,08/09/2017 12:00:00 PM,48,-122,27,42,69
31597,ElliotBayTrailMyrtlePark,08/09/2017 01:00:00 PM,48,-122,37,25,62
31598,ElliotBayTrailMyrtlePark,08/09/2017 02:00:00 PM,48,-122,39,32,71
31599,ElliotBayTrailMyrtlePark,08/09/2017 03:00:00 PM,48,-122,54,41,95
31600,ElliotBayTrailMyrtlePark,08/09/2017 04:00:00 PM,48,-122,89,78,167
31601,ElliotBayTrailMyrtlePark,08/09/2017 05:00:00 PM,48,-122,235,85,320
31602,ElliotBayTrailMyrtlePark,08/09/2017 06:00:00 PM,48,-122,144,45,189
31603,ElliotBayTrailMyrtlePark,08/09/2017 07:00:00 PM,48,-122,60,44,104
31604,ElliotBayTrailMyrtlePark,08/09/2017 08:00:00 PM,48,-122,56,40,96
31605,ElliotBayTrailMyrtlePark,08/09/2017 09:00:00 PM,48,-122,18,13,31
31606,ElliotBayTrailMyrtlePark,08/09/2017 10:00:00 PM,48,-122,5,8,13
31607,ElliotBayTrailMyrtlePark,08/09/2017 11:00:00 PM,48,-122,8,0,8
31608,ElliotBayTrailMyrtlePark,08/10/2017 12:00:00 AM,48,-122,3,0,3
31609,ElliotBayTrailMyrtlePark,08/10/2017 01:00:00 AM,48,-122,6,0,6
31610,ElliotBayTrailMyrtlePark,08/10/2017 02:00:00 AM,48,-122,10,4,14
31611,ElliotBayTrailMyrtlePark,08/10/2017 03:00:00 AM,48,-122,1,5,6
31612,ElliotBayTrailMyrtlePark,08/10/2017 04:00:00 AM,48,-122,3,4,7
31613,ElliotBayTrailMyrtlePark,08/10/2017 05:00:00 AM,48,-122,7,16,23
31614,ElliotBayTrailMyrtlePark,08/10/2017 06:00:00 AM,48,-122,19,40,59
31615,ElliotBayTrailMyrtlePark,08/10/2017 07:00:00 AM,48,-122,52,108,160
31616,ElliotBayTrailMyrtlePark,08/10/2017 08:00:00 AM,48,-122,48,153,201
31617,ElliotBayTrailMyrtlePark,08/10/2017 09:00:00 AM,48,-122,39,62,101
31618,ElliotBayTrailMyrtlePark,08/10/2017 10:00:00 AM,48,-122,23,32,55
31619,ElliotBayTrailMyrtlePark,08/10/2017 11:00:00 AM,48,-122,27,32,59
31620,ElliotBayTrailMyrtlePark,08/10/2017 12:00:00 PM,48,-122,31,22,53
31621,ElliotBayTrailMyrtlePark,08/10/2017 01:00:00 PM,48,-122,34,31,65
31622,ElliotBayTrailMyrtlePark,08/10/2017 02:00:00 PM,48,-122,34,35,69
31623,ElliotBayTrailMyrtlePark,08/10/2017 03:00:00 PM,48,-122,65,45,110
31624,ElliotBayTrailMyrtlePark,08/10/2017 04:00:00 PM,48,-122,105,57,162
31625,ElliotBayTrailMyrtlePark,08/10/2017 05:00:00 PM,48,-122,180,85,265
31626,ElliotBayTrailMyrtlePark,08/10/2017 06:00:00 PM,48,-122,136,57,193
31627,ElliotBayTrailMyrtlePark,08/10/2017 07:00:00 PM,48,-122,75,49,124
31628,ElliotBayTrailMyrtlePark,08/10/2017 08:00:00 PM,48,-122,42,40,82
31629,ElliotBayTrailMyrtlePark,08/10/2017 09:00:00 PM,48,-122,11,12,23
31630,ElliotBayTrailMyrtlePark,08/10/2017 10:00:00 PM,48,-122,13,4,17
31631,ElliotBayTrailMyrtlePark,08/10/2017 11:00:00 PM,48,-122,14,3,17
31632,ElliotBayTrailMyrtlePark,08/11/2017 12:00:00 AM,48,-122,0,0,0
31633,ElliotBayTrailMyrtlePark,08/11/2017 01:00:00 AM,48,-122,0,0,0
31634,ElliotBayTrailMyrtlePark,08/11/2017 02:00:00 AM,48,-122,1,0,1
31635,ElliotBayTrailMyrtlePark,08/11/2017 03:00:00 AM,48,-122,0,1,1
31636,ElliotBayTrailMyrtlePark,08/11/2017 04:00:00 AM,48,-122,1,2,3
31637,ElliotBayTrailMyrtlePark,08/11/2017 05:00:00 AM,48,-122,4,11,15
31638,ElliotBayTrailMyrtlePark,08/11/2017 06:00:00 AM,48,-122,12,21,33
31639,ElliotBayTrailMyrtlePark,08/11/2017 07:00:00 AM,48,-122,52,106,158
31640,ElliotBayTrailMyrtlePark,08/11/2017 08:00:00 AM,48,-122,49,131,180
31641,ElliotBayTrailMyrtlePark,08/11/2017 09:00:00 AM,48,-122,38,70,108
31642,ElliotBayTrailMyrtlePark,08/11/2017 10:00:00 AM,48,-122,18,39,57
31643,ElliotBayTrailMyrtlePark,08/11/2017 11:00:00 AM,48,-122,40,40,80
31644,ElliotBayTrailMyrtlePark,08/11/2017 12:00:00 PM,48,-122,26,40,66
31645,ElliotBayTrailMyrtlePark,08/11/2017 01:00:00 PM,48,-122,46,25,71
31646,ElliotBayTrailMyrtlePark,08/11/2017 02:00:00 PM,48,-122,50,35,85
31647,ElliotBayTrailMyrtlePark,08/11/2017 03:00:00 PM,48,-122,73,61,134
31648,ElliotBayTrailMyrtlePark,08/11/2017 04:00:00 PM,48,-122,114,55,169
31649,ElliotBayTrailMyrtlePark,08/11/2017 05:00:00 PM,48,-122,177,85,262
31650,ElliotBayTrailMyrtlePark,08/11/2017 06:00:00 PM,48,-122,104,50,154
31651,ElliotBayTrailMyrtlePark,08/11/2017 07:00:00 PM,48,-122,51,38,89
31652,ElliotBayTrailMyrtlePark,08/11/2017 08:00:00 PM,48,-122,32,32,64
31653,ElliotBayTrailMyrtlePark,08/11/2017 09:00:00 PM,48,-122,7,12,19
31654,ElliotBayTrailMyrtlePark,08/11/2017 10:00:00 PM,48,-122,21,2,23
31655,ElliotBayTrailMyrtlePark,08/11/2017 11:00:00 PM,48,-122,16,3,19
31656,ElliotBayTrailMyrtlePark,08/12/2017 12:00:00 AM,48,-122,3,3,6
31657,ElliotBayTrailMyrtlePark,08/12/2017 01:00:00 AM,48,-122,0,0,0
31658,ElliotBayTrailMyrtlePark,08/12/2017 02:00:00 AM,48,-122,3,0,3
31659,ElliotBayTrailMyrtlePark,08/12/2017 03:00:00 AM,48,-122,1,4,5
31660,ElliotBayTrailMyrtlePark,08/12/2017 04:00:00 AM,48,-122,0,0,0
31661,ElliotBayTrailMyrtlePark,08/12/2017 05:00:00 AM,48,-122,2,2,4
31662,ElliotBayTrailMyrtlePark,08/12/2017 06:00:00 AM,48,-122,4,4,8
31663,ElliotBayTrailMyrtlePark,08/12/2017 07:00:00 AM,48,-122,14,18,32
31664,ElliotBayTrailMyrtlePark,08/12/2017 08:00:00 AM,48,-122,41,47,88
31665,ElliotBayTrailMyrtlePark,08/12/2017 09:00:00 AM,48,-122,19,34,53
31666,ElliotBayTrailMyrtlePark,08/12/2017 10:00:00 AM,48,-122,32,25,57
31667,ElliotBayTrailMyrtlePark,08/12/2017 11:00:00 AM,48,-122,63,64,127
31668,ElliotBayTrailMyrtlePark,08/12/2017 12:00:00 PM,48,-122,50,126,176
31669,ElliotBayTrailMyrtlePark,08/12/2017 01:00:00 PM,48,-122,74,84,158
31670,ElliotBayTrailMyrtlePark,08/12/2017 02:00:00 PM,48,-122,56,63,119
31671,ElliotBayTrailMyrtlePark,08/12/2017 03:00:00 PM,48,-122,138,88,226
31672,ElliotBayTrailMyrtlePark,08/12/2017 04:00:00 PM,48,-122,86,54,140
31673,ElliotBayTrailMyrtlePark,08/12/2017 05:00:00 PM,48,-122,62,60,122
31674,ElliotBayTrailMyrtlePark,08/12/2017 06:00:00 PM,48,-122,55,45,100
31675,ElliotBayTrailMyrtlePark,08/12/2017 07:00:00 PM,48,-122,34,26,60
31676,ElliotBayTrailMyrtlePark,08/12/2017 08:00:00 PM,48,-122,28,31,59
31677,ElliotBayTrailMyrtlePark,08/12/2017 09:00:00 PM,48,-122,38,14,52
31678,ElliotBayTrailMyrtlePark,08/12/2017 10:00:00 PM,48,-122,15,1,16
31679,ElliotBayTrailMyrtlePark,08/12/2017 11:00:00 PM,48,-122,8,4,12
31680,ElliotBayTrailMyrtlePark,08/13/2017 12:00:00 AM,48,-122,1,0,1
31681,ElliotBayTrailMyrtlePark,08/13/2017 01:00:00 AM,48,-122,1,0,1
31682,ElliotBayTrailMyrtlePark,08/13/2017 02:00:00 AM,48,-122,0,0,0
31683,ElliotBayTrailMyrtlePark,08/13/2017 03:00:00 AM,48,-122,0,0,0
31684,ElliotBayTrailMyrtlePark,08/13/2017 04:00:00 AM,48,-122,0,0,0
31685,ElliotBayTrailMyrtlePark,08/13/2017 05:00:00 AM,48,-122,2,4,6
31686,ElliotBayTrailMyrtlePark,08/13/2017 06:00:00 AM,48,-122,2,4,6
31687,ElliotBayTrailMyrtlePark,08/13/2017 07:00:00 AM,48,-122,8,8,16
31688,ElliotBayTrailMyrtlePark,08/13/2017 08:00:00 AM,48,-122,6,15,21
31689,ElliotBayTrailMyrtlePark,08/13/2017 09:00:00 AM,48,-122,15,25,40
31690,ElliotBayTrailMyrtlePark,08/13/2017 10:00:00 AM,48,-122,23,25,48
31691,ElliotBayTrailMyrtlePark,08/13/2017 11:00:00 AM,48,-122,46,32,78
31692,ElliotBayTrailMyrtlePark,08/13/2017 12:00:00 PM,48,-122,60,41,101
31693,ElliotBayTrailMyrtlePark,08/13/2017 01:00:00 PM,48,-122,41,53,94
31694,ElliotBayTrailMyrtlePark,08/13/2017 02:00:00 PM,48,-122,48,34,82
31695,ElliotBayTrailMyrtlePark,08/13/2017 03:00:00 PM,48,-122,42,42,84
31696,ElliotBayTrailMyrtlePark,08/13/2017 04:00:00 PM,48,-122,70,56,126
31697,ElliotBayTrailMyrtlePark,08/13/2017 05:00:00 PM,48,-122,59,40,99
31698,ElliotBayTrailMyrtlePark,08/13/2017 06:00:00 PM,48,-122,50,54,104
31699,ElliotBayTrailMyrtlePark,08/13/2017 07:00:00 PM,48,-122,36,38,74
31700,ElliotBayTrailMyrtlePark,08/13/2017 08:00:00 PM,48,-122,23,22,45
31701,ElliotBayTrailMyrtlePark,08/13/2017 09:00:00 PM,48,-122,11,11,22
31702,ElliotBayTrailMyrtlePark,08/13/2017 10:00:00 PM,48,-122,6,6,12
31703,ElliotBayTrailMyrtlePark,08/13/2017 11:00:00 PM,48,-122,6,5,11
31704,ElliotBayTrailMyrtlePark,08/14/2017 12:00:00 AM,48,-122,0,0,0
31705,ElliotBayTrailMyrtlePark,08/14/2017 01:00:00 AM,48,-122,2,0,2
31706,ElliotBayTrailMyrtlePark,08/14/2017 02:00:00 AM,48,-122,1,0,1
31707,ElliotBayTrailMyrtlePark,08/14/2017 03:00:00 AM,48,-122,1,1,2
31708,ElliotBayTrailMyrtlePark,08/14/2017 04:00:00 AM,48,-122,3,3,6
31709,ElliotBayTrailMyrtlePark,08/14/2017 05:00:00 AM,48,-122,7,10,17
31710,ElliotBayTrailMyrtlePark,08/14/2017 06:00:00 AM,48,-122,21,40,61
31711,ElliotBayTrailMyrtlePark,08/14/2017 07:00:00 AM,48,-122,51,108,159
31712,ElliotBayTrailMyrtlePark,08/14/2017 08:00:00 AM,48,-122,52,195,247
31713,ElliotBayTrailMyrtlePark,08/14/2017 09:00:00 AM,48,-122,37,79,116
31714,ElliotBayTrailMyrtlePark,08/14/2017 10:00:00 AM,48,-122,42,37,79
31715,ElliotBayTrailMyrtlePark,08/14/2017 11:00:00 AM,48,-122,22,36,58
31716,ElliotBayTrailMyrtlePark,08/14/2017 12:00:00 PM,48,-122,23,50,73
31717,ElliotBayTrailMyrtlePark,08/14/2017 01:00:00 PM,48,-122,29,25,54
31718,ElliotBayTrailMyrtlePark,08/14/2017 02:00:00 PM,48,-122,43,37,80
31719,ElliotBayTrailMyrtlePark,08/14/2017 03:00:00 PM,48,-122,55,48,103
31720,ElliotBayTrailMyrtlePark,08/14/2017 04:00:00 PM,48,-122,125,66,191
31721,ElliotBayTrailMyrtlePark,08/14/2017 05:00:00 PM,48,-122,219,81,300
31722,ElliotBayTrailMyrtlePark,08/14/2017 06:00:00 PM,48,-122,171,56,227
31723,ElliotBayTrailMyrtlePark,08/14/2017 07:00:00 PM,48,-122,67,38,105
31724,ElliotBayTrailMyrtlePark,08/14/2017 08:00:00 PM,48,-122,34,40,74
31725,ElliotBayTrailMyrtlePark,08/14/2017 09:00:00 PM,48,-122,22,14,36
31726,ElliotBayTrailMyrtlePark,08/14/2017 10:00:00 PM,48,-122,9,8,17
31727,ElliotBayTrailMyrtlePark,08/14/2017 11:00:00 PM,48,-122,6,5,11
31728,ElliotBayTrailMyrtlePark,08/15/2017 12:00:00 AM,48,-122,2,3,5
31729,ElliotBayTrailMyrtlePark,08/15/2017 01:00:00 AM,48,-122,1,0,1
31730,ElliotBayTrailMyrtlePark,08/15/2017 02:00:00 AM,48,-122,0,0,0
31731,ElliotBayTrailMyrtlePark,08/15/2017 03:00:00 AM,48,-122,2,0,2
31732,ElliotBayTrailMyrtlePark,08/15/2017 04:00:00 AM,48,-122,2,3,5
31733,ElliotBayTrailMyrtlePark,08/15/2017 05:00:00 AM,48,-122,8,15,23
31734,ElliotBayTrailMyrtlePark,08/15/2017 06:00:00 AM,48,-122,25,35,60
31735,ElliotBayTrailMyrtlePark,08/15/2017 07:00:00 AM,48,-122,54,141,195
31736,ElliotBayTrailMyrtlePark,08/15/2017 08:00:00 AM,48,-122,47,196,243
31737,ElliotBayTrailMyrtlePark,08/15/2017 09:00:00 AM,48,-122,43,80,123
31738,ElliotBayTrailMyrtlePark,08/15/2017 10:00:00 AM,48,-122,27,37,64
31739,ElliotBayTrailMyrtlePark,08/15/2017 11:00:00 AM,48,-122,27,32,59
31740,ElliotBayTrailMyrtlePark,08/15/2017 12:00:00 PM,48,-122,48,29,77
31741,ElliotBayTrailMyrtlePark,08/15/2017 01:00:00 PM,48,-122,34,37,71
31742,ElliotBayTrailMyrtlePark,08/15/2017 02:00:00 PM,48,-122,39,36,75
31743,ElliotBayTrailMyrtlePark,08/15/2017 03:00:00 PM,48,-122,50,50,100
31744,ElliotBayTrailMyrtlePark,08/15/2017 04:00:00 PM,48,-122,128,53,181
31745,ElliotBayTrailMyrtlePark,08/15/2017 05:00:00 PM,48,-122,234,82,316
31746,ElliotBayTrailMyrtlePark,08/15/2017 06:00:00 PM,48,-122,151,73,224
31747,ElliotBayTrailMyrtlePark,08/15/2017 07:00:00 PM,48,-122,58,48,106
31748,ElliotBayTrailMyrtlePark,08/15/2017 08:00:00 PM,48,-122,42,34,76
31749,ElliotBayTrailMyrtlePark,08/15/2017 09:00:00 PM,48,-122,24,17,41
31750,ElliotBayTrailMyrtlePark,08/15/2017 10:00:00 PM,48,-122,13,2,15
31751,ElliotBayTrailMyrtlePark,08/15/2017 11:00:00 PM,48,-122,1,2,3
31752,ElliotBayTrailMyrtlePark,08/16/2017 12:00:00 AM,48,-122,4,0,4
31753,ElliotBayTrailMyrtlePark,08/16/2017 01:00:00 AM,48,-122,4,2,6
31754,ElliotBayTrailMyrtlePark,08/16/2017 02:00:00 AM,48,-122,2,0,2
31755,ElliotBayTrailMyrtlePark,08/16/2017 03:00:00 AM,48,-122,1,0,1
31756,ElliotBayTrailMyrtlePark,08/16/2017 04:00:00 AM,48,-122,1,3,4
31757,ElliotBayTrailMyrtlePark,08/16/2017 05:00:00 AM,48,-122,5,14,19
31758,ElliotBayTrailMyrtlePark,08/16/2017 06:00:00 AM,48,-122,30,37,67
31759,ElliotBayTrailMyrtlePark,08/16/2017 07:00:00 AM,48,-122,50,109,159
31760,ElliotBayTrailMyrtlePark,08/16/2017 08:00:00 AM,48,-122,62,181,243
31761,ElliotBayTrailMyrtlePark,08/16/2017 09:00:00 AM,48,-122,24,91,115
31762,ElliotBayTrailMyrtlePark,08/16/2017 10:00:00 AM,48,-122,18,44,62
31763,ElliotBayTrailMyrtlePark,08/16/2017 11:00:00 AM,48,-122,23,47,70
31764,ElliotBayTrailMyrtlePark,08/16/2017 12:00:00 PM,48,-122,23,32,55
31765,ElliotBayTrailMyrtlePark,08/16/2017 01:00:00 PM,48,-122,26,41,67
31766,ElliotBayTrailMyrtlePark,08/16/2017 02:00:00 PM,48,-122,33,35,68
31767,ElliotBayTrailMyrtlePark,08/16/2017 03:00:00 PM,48,-122,43,63,106
31768,ElliotBayTrailMyrtlePark,08/16/2017 04:00:00 PM,48,-122,129,57,186
31769,ElliotBayTrailMyrtlePark,08/16/2017 05:00:00 PM,48,-122,209,85,294
31770,ElliotBayTrailMyrtlePark,08/16/2017 06:00:00 PM,48,-122,155,57,212
31771,ElliotBayTrailMyrtlePark,08/16/2017 07:00:00 PM,48,-122,83,33,116
31772,ElliotBayTrailMyrtlePark,08/16/2017 08:00:00 PM,48,-122,53,45,98
31773,ElliotBayTrailMyrtlePark,08/16/2017 09:00:00 PM,48,-122,14,17,31
31774,ElliotBayTrailMyrtlePark,08/16/2017 10:00:00 PM,48,-122,16,7,23
31775,ElliotBayTrailMyrtlePark,08/16/2017 11:00:00 PM,48,-122,4,1,5
31776,ElliotBayTrailMyrtlePark,08/17/2017 12:00:00 AM,48,-122,1,3,4
31777,ElliotBayTrailMyrtlePark,08/17/2017 01:00:00 AM,48,-122,3,0,3
31778,ElliotBayTrailMyrtlePark,08/17/2017 02:00:00 AM,48,-122,2,0,2
31779,ElliotBayTrailMyrtlePark,08/17/2017 03:00:00 AM,48,-122,1,1,2
31780,ElliotBayTrailMyrtlePark,08/17/2017 04:00:00 AM,48,-122,0,2,2
31781,ElliotBayTrailMyrtlePark,08/17/2017 05:00:00 AM,48,-122,7,13,20
31782,ElliotBayTrailMyrtlePark,08/17/2017 06:00:00 AM,48,-122,14,29,43
31783,ElliotBayTrailMyrtlePark,08/17/2017 07:00:00 AM,48,-122,35,108,143
31784,ElliotBayTrailMyrtlePark,08/17/2017 08:00:00 AM,48,-122,50,150,200
31785,ElliotBayTrailMyrtlePark,08/17/2017 09:00:00 AM,48,-122,36,75,111
31786,ElliotBayTrailMyrtlePark,08/17/2017 10:00:00 AM,48,-122,21,25,46
31787,ElliotBayTrailMyrtlePark,08/17/2017 11:00:00 AM,48,-122,23,31,54
31788,ElliotBayTrailMyrtlePark,08/17/2017 12:00:00 PM,48,-122,25,40,65
31789,ElliotBayTrailMyrtlePark,08/17/2017 01:00:00 PM,48,-122,27,36,63
31790,ElliotBayTrailMyrtlePark,08/17/2017 02:00:00 PM,48,-122,39,39,78
31791,ElliotBayTrailMyrtlePark,08/17/2017 03:00:00 PM,48,-122,64,49,113
31792,ElliotBayTrailMyrtlePark,08/17/2017 04:00:00 PM,48,-122,120,60,180
31793,ElliotBayTrailMyrtlePark,08/17/2017 05:00:00 PM,48,-122,164,73,237
31794,ElliotBayTrailMyrtlePark,08/17/2017 06:00:00 PM,48,-122,116,48,164
31795,ElliotBayTrailMyrtlePark,08/17/2017 07:00:00 PM,48,-122,58,55,113
31796,ElliotBayTrailMyrtlePark,08/17/2017 08:00:00 PM,48,-122,49,29,78
31797,ElliotBayTrailMyrtlePark,08/17/2017 09:00:00 PM,48,-122,41,34,75
31798,ElliotBayTrailMyrtlePark,08/17/2017 10:00:00 PM,48,-122,12,8,20
31799,ElliotBayTrailMyrtlePark,08/17/2017 11:00:00 PM,48,-122,7,3,10
31800,ElliotBayTrailMyrtlePark,08/18/2017 12:00:00 AM,48,-122,3,3,6
31801,ElliotBayTrailMyrtlePark,08/18/2017 01:00:00 AM,48,-122,5,2,7
31802,ElliotBayTrailMyrtlePark,08/18/2017 02:00:00 AM,48,-122,2,2,4
31803,ElliotBayTrailMyrtlePark,08/18/2017 03:00:00 AM,48,-122,2,1,3
31804,ElliotBayTrailMyrtlePark,08/18/2017 04:00:00 AM,48,-122,1,1,2
31805,ElliotBayTrailMyrtlePark,08/18/2017 05:00:00 AM,48,-122,6,12,18
31806,ElliotBayTrailMyrtlePark,08/18/2017 06:00:00 AM,48,-122,29,19,48
31807,ElliotBayTrailMyrtlePark,08/18/2017 07:00:00 AM,48,-122,37,71,108
31808,ElliotBayTrailMyrtlePark,08/18/2017 08:00:00 AM,48,-122,42,107,149
31809,ElliotBayTrailMyrtlePark,08/18/2017 09:00:00 AM,48,-122,20,63,83
31810,ElliotBayTrailMyrtlePark,08/18/2017 10:00:00 AM,48,-122,10,29,39
31811,ElliotBayTrailMyrtlePark,08/18/2017 11:00:00 AM,48,-122,11,18,29
31812,ElliotBayTrailMyrtlePark,08/18/2017 12:00:00 PM,48,-122,31,26,57
31813,ElliotBayTrailMyrtlePark,08/18/2017 01:00:00 PM,48,-122,30,21,51
31814,ElliotBayTrailMyrtlePark,08/18/2017 02:00:00 PM,48,-122,21,19,40
31815,ElliotBayTrailMyrtlePark,08/18/2017 03:00:00 PM,48,-122,24,22,46
31816,ElliotBayTrailMyrtlePark,08/18/2017 04:00:00 PM,48,-122,33,27,60
31817,ElliotBayTrailMyrtlePark,08/18/2017 05:00:00 PM,48,-122,38,36,74
31818,ElliotBayTrailMyrtlePark,08/18/2017 06:00:00 PM,48,-122,37,30,67
31819,ElliotBayTrailMyrtlePark,08/18/2017 07:00:00 PM,48,-122,23,14,37
31820,ElliotBayTrailMyrtlePark,08/18/2017 08:00:00 PM,48,-122,3,44,47
31821,ElliotBayTrailMyrtlePark,08/18/2017 09:00:00 PM,48,-122,11,12,23
31822,ElliotBayTrailMyrtlePark,08/18/2017 10:00:00 PM,48,-122,18,18,36
31823,ElliotBayTrailMyrtlePark,08/18/2017 11:00:00 PM,48,-122,14,4,18
31824,ElliotBayTrailMyrtlePark,08/19/2017 12:00:00 AM,48,-122,0,3,3
31825,ElliotBayTrailMyrtlePark,08/19/2017 01:00:00 AM,48,-122,5,2,7
31826,ElliotBayTrailMyrtlePark,08/19/2017 02:00:00 AM,48,-122,6,2,8
31827,ElliotBayTrailMyrtlePark,08/19/2017 03:00:00 AM,48,-122,1,0,1
31828,ElliotBayTrailMyrtlePark,08/19/2017 04:00:00 AM,48,-122,2,0,2
31829,ElliotBayTrailMyrtlePark,08/19/2017 05:00:00 AM,48,-122,0,3,3
31830,ElliotBayTrailMyrtlePark,08/19/2017 06:00:00 AM,48,-122,3,4,7
31831,ElliotBayTrailMyrtlePark,08/19/2017 07:00:00 AM,48,-122,8,15,23
31832,ElliotBayTrailMyrtlePark,08/19/2017 08:00:00 AM,48,-122,15,19,34
31833,ElliotBayTrailMyrtlePark,08/19/2017 09:00:00 AM,48,-122,12,23,35
31834,ElliotBayTrailMyrtlePark,08/19/2017 10:00:00 AM,48,-122,23,20,43
31835,ElliotBayTrailMyrtlePark,08/19/2017 11:00:00 AM,48,-122,45,35,80
31836,ElliotBayTrailMyrtlePark,08/19/2017 12:00:00 PM,48,-122,27,25,52
31837,ElliotBayTrailMyrtlePark,08/19/2017 01:00:00 PM,48,-122,42,20,62
31838,ElliotBayTrailMyrtlePark,08/19/2017 02:00:00 PM,48,-122,35,15,50
31839,ElliotBayTrailMyrtlePark,08/19/2017 03:00:00 PM,48,-122,17,26,43
31840,ElliotBayTrailMyrtlePark,08/19/2017 04:00:00 PM,48,-122,19,12,31
31841,ElliotBayTrailMyrtlePark,08/19/2017 05:00:00 PM,48,-122,13,25,38
31842,ElliotBayTrailMyrtlePark,08/19/2017 06:00:00 PM,48,-122,19,20,39
31843,ElliotBayTrailMyrtlePark,08/19/2017 07:00:00 PM,48,-122,18,27,45
31844,ElliotBayTrailMyrtlePark,08/19/2017 08:00:00 PM,48,-122,5,29,34
31845,ElliotBayTrailMyrtlePark,08/19/2017 09:00:00 PM,48,-122,13,10,23
31846,ElliotBayTrailMyrtlePark,08/19/2017 10:00:00 PM,48,-122,11,5,16
31847,ElliotBayTrailMyrtlePark,08/19/2017 11:00:00 PM,48,-122,9,4,13
31848,ElliotBayTrailMyrtlePark,08/20/2017 12:00:00 AM,48,-122,2,1,3
31849,ElliotBayTrailMyrtlePark,08/20/2017 01:00:00 AM,48,-122,4,5,9
31850,ElliotBayTrailMyrtlePark,08/20/2017 02:00:00 AM,48,-122,2,2,4
31851,ElliotBayTrailMyrtlePark,08/20/2017 03:00:00 AM,48,-122,1,3,4
31852,ElliotBayTrailMyrtlePark,08/20/2017 04:00:00 AM,48,-122,2,3,5
31853,ElliotBayTrailMyrtlePark,08/20/2017 05:00:00 AM,48,-122,0,0,0
31854,ElliotBayTrailMyrtlePark,08/20/2017 06:00:00 AM,48,-122,7,4,11
31855,ElliotBayTrailMyrtlePark,08/20/2017 07:00:00 AM,48,-122,6,15,21
31856,ElliotBayTrailMyrtlePark,08/20/2017 08:00:00 AM,48,-122,12,31,43
31857,ElliotBayTrailMyrtlePark,08/20/2017 09:00:00 AM,48,-122,9,11,20
31858,ElliotBayTrailMyrtlePark,08/20/2017 10:00:00 AM,48,-122,18,23,41
31859,ElliotBayTrailMyrtlePark,08/20/2017 11:00:00 AM,48,-122,12,14,26
31860,ElliotBayTrailMyrtlePark,08/20/2017 12:00:00 PM,48,-122,19,14,33
31861,ElliotBayTrailMyrtlePark,08/20/2017 01:00:00 PM,48,-122,29,16,45
31862,ElliotBayTrailMyrtlePark,08/20/2017 02:00:00 PM,48,-122,18,12,30
31863,ElliotBayTrailMyrtlePark,08/20/2017 03:00:00 PM,48,-122,14,7,21
31864,ElliotBayTrailMyrtlePark,08/20/2017 04:00:00 PM,48,-122,14,11,25
31865,ElliotBayTrailMyrtlePark,08/20/2017 05:00:00 PM,48,-122,9,14,23
31866,ElliotBayTrailMyrtlePark,08/20/2017 06:00:00 PM,48,-122,17,17,34
31867,ElliotBayTrailMyrtlePark,08/20/2017 07:00:00 PM,48,-122,12,22,34
31868,ElliotBayTrailMyrtlePark,08/20/2017 08:00:00 PM,48,-122,1,35,36
31869,ElliotBayTrailMyrtlePark,08/20/2017 09:00:00 PM,48,-122,18,25,43
31870,ElliotBayTrailMyrtlePark,08/20/2017 10:00:00 PM,48,-122,7,36,43
31871,ElliotBayTrailMyrtlePark,08/20/2017 11:00:00 PM,48,-122,9,22,31
31872,ElliotBayTrailMyrtlePark,08/21/2017 12:00:00 AM,48,-122,5,16,21
31873,ElliotBayTrailMyrtlePark,08/21/2017 01:00:00 AM,48,-122,2,10,12
31874,ElliotBayTrailMyrtlePark,08/21/2017 02:00:00 AM,48,-122,4,3,7
31875,ElliotBayTrailMyrtlePark,08/21/2017 03:00:00 AM,48,-122,2,6,8
31876,ElliotBayTrailMyrtlePark,08/21/2017 04:00:00 AM,48,-122,2,8,10
31877,ElliotBayTrailMyrtlePark,08/21/2017 05:00:00 AM,48,-122,4,11,15
31878,ElliotBayTrailMyrtlePark,08/21/2017 06:00:00 AM,48,-122,15,28,43
31879,ElliotBayTrailMyrtlePark,08/21/2017 07:00:00 AM,48,-122,37,89,126
31880,ElliotBayTrailMyrtlePark,08/21/2017 08:00:00 AM,48,-122,38,128,166
31881,ElliotBayTrailMyrtlePark,08/21/2017 09:00:00 AM,48,-122,29,58,87
31882,ElliotBayTrailMyrtlePark,08/21/2017 10:00:00 AM,48,-122,14,28,42
31883,ElliotBayTrailMyrtlePark,08/21/2017 11:00:00 AM,48,-122,25,27,52
31884,ElliotBayTrailMyrtlePark,08/21/2017 12:00:00 PM,48,-122,28,38,66
31885,ElliotBayTrailMyrtlePark,08/21/2017 01:00:00 PM,48,-122,29,24,53
31886,ElliotBayTrailMyrtlePark,08/21/2017 02:00:00 PM,48,-122,33,31,64
31887,ElliotBayTrailMyrtlePark,08/21/2017 03:00:00 PM,48,-122,44,40,84
31888,ElliotBayTrailMyrtlePark,08/21/2017 04:00:00 PM,48,-122,94,52,146
31889,ElliotBayTrailMyrtlePark,08/21/2017 05:00:00 PM,48,-122,155,87,242
31890,ElliotBayTrailMyrtlePark,08/21/2017 06:00:00 PM,48,-122,102,43,145
31891,ElliotBayTrailMyrtlePark,08/21/2017 07:00:00 PM,48,-122,67,36,103
31892,ElliotBayTrailMyrtlePark,08/21/2017 08:00:00 PM,48,-122,32,33,65
31893,ElliotBayTrailMyrtlePark,08/21/2017 09:00:00 PM,48,-122,11,6,17
31894,ElliotBayTrailMyrtlePark,08/21/2017 10:00:00 PM,48,-122,7,3,10
31895,ElliotBayTrailMyrtlePark,08/21/2017 11:00:00 PM,48,-122,0,1,1
31896,ElliotBayTrailMyrtlePark,08/22/2017 12:00:00 AM,48,-122,0,1,1
31897,ElliotBayTrailMyrtlePark,08/22/2017 01:00:00 AM,48,-122,2,1,3
31898,ElliotBayTrailMyrtlePark,08/22/2017 02:00:00 AM,48,-122,5,5,10
31899,ElliotBayTrailMyrtlePark,08/22/2017 03:00:00 AM,48,-122,2,1,3
31900,ElliotBayTrailMyrtlePark,08/22/2017 04:00:00 AM,48,-122,1,2,3
31901,ElliotBayTrailMyrtlePark,08/22/2017 05:00:00 AM,48,-122,8,15,23
31902,ElliotBayTrailMyrtlePark,08/22/2017 06:00:00 AM,48,-122,30,33,63
31903,ElliotBayTrailMyrtlePark,08/22/2017 07:00:00 AM,48,-122,58,131,189
31904,ElliotBayTrailMyrtlePark,08/22/2017 08:00:00 AM,48,-122,52,165,217
31905,ElliotBayTrailMyrtlePark,08/22/2017 09:00:00 AM,48,-122,37,82,119
31906,ElliotBayTrailMyrtlePark,08/22/2017 10:00:00 AM,48,-122,29,26,55
31907,ElliotBayTrailMyrtlePark,08/22/2017 11:00:00 AM,48,-122,33,45,78
31908,ElliotBayTrailMyrtlePark,08/22/2017 12:00:00 PM,48,-122,32,32,64
31909,ElliotBayTrailMyrtlePark,08/22/2017 01:00:00 PM,48,-122,36,47,83
31910,ElliotBayTrailMyrtlePark,08/22/2017 02:00:00 PM,48,-122,22,29,51
31911,ElliotBayTrailMyrtlePark,08/22/2017 03:00:00 PM,48,-122,45,44,89
31912,ElliotBayTrailMyrtlePark,08/22/2017 04:00:00 PM,48,-122,135,80,215
31913,ElliotBayTrailMyrtlePark,08/22/2017 05:00:00 PM,48,-122,240,57,297
31914,ElliotBayTrailMyrtlePark,08/22/2017 06:00:00 PM,48,-122,134,49,183
31915,ElliotBayTrailMyrtlePark,08/22/2017 07:00:00 PM,48,-122,52,38,90
31916,ElliotBayTrailMyrtlePark,08/22/2017 08:00:00 PM,48,-122,38,38,76
31917,ElliotBayTrailMyrtlePark,08/22/2017 09:00:00 PM,48,-122,16,13,29
31918,ElliotBayTrailMyrtlePark,08/22/2017 10:00:00 PM,48,-122,6,6,12
31919,ElliotBayTrailMyrtlePark,08/22/2017 11:00:00 PM,48,-122,1,2,3
31920,ElliotBayTrailMyrtlePark,08/23/2017 12:00:00 AM,48,-122,0,0,0
31921,ElliotBayTrailMyrtlePark,08/23/2017 01:00:00 AM,48,-122,3,4,7
31922,ElliotBayTrailMyrtlePark,08/23/2017 02:00:00 AM,48,-122,2,0,2
31923,ElliotBayTrailMyrtlePark,08/23/2017 03:00:00 AM,48,-122,1,2,3
31924,ElliotBayTrailMyrtlePark,08/23/2017 04:00:00 AM,48,-122,0,2,2
31925,ElliotBayTrailMyrtlePark,08/23/2017 05:00:00 AM,48,-122,7,10,17
31926,ElliotBayTrailMyrtlePark,08/23/2017 06:00:00 AM,48,-122,27,41,68
31927,ElliotBayTrailMyrtlePark,08/23/2017 07:00:00 AM,48,-122,55,113,168
31928,ElliotBayTrailMyrtlePark,08/23/2017 08:00:00 AM,48,-122,49,193,242
31929,ElliotBayTrailMyrtlePark,08/23/2017 09:00:00 AM,48,-122,34,89,123
31930,ElliotBayTrailMyrtlePark,08/23/2017 10:00:00 AM,48,-122,16,40,56
31931,ElliotBayTrailMyrtlePark,08/23/2017 11:00:00 AM,48,-122,16,30,46
31932,ElliotBayTrailMyrtlePark,08/23/2017 12:00:00 PM,48,-122,14,40,54
31933,ElliotBayTrailMyrtlePark,08/23/2017 01:00:00 PM,48,-122,43,28,71
31934,ElliotBayTrailMyrtlePark,08/23/2017 02:00:00 PM,48,-122,40,39,79
31935,ElliotBayTrailMyrtlePark,08/23/2017 03:00:00 PM,48,-122,63,57,120
31936,ElliotBayTrailMyrtlePark,08/23/2017 04:00:00 PM,48,-122,145,56,201
31937,ElliotBayTrailMyrtlePark,08/23/2017 05:00:00 PM,48,-122,237,87,324
31938,ElliotBayTrailMyrtlePark,08/23/2017 06:00:00 PM,48,-122,165,67,232
31939,ElliotBayTrailMyrtlePark,08/23/2017 07:00:00 PM,48,-122,72,42,114
31940,ElliotBayTrailMyrtlePark,08/23/2017 08:00:00 PM,48,-122,31,38,69
31941,ElliotBayTrailMyrtlePark,08/23/2017 09:00:00 PM,48,-122,19,9,28
31942,ElliotBayTrailMyrtlePark,08/23/2017 10:00:00 PM,48,-122,5,4,9
31943,ElliotBayTrailMyrtlePark,08/23/2017 11:00:00 PM,48,-122,3,1,4
31944,ElliotBayTrailMyrtlePark,08/24/2017 12:00:00 AM,48,-122,4,2,6
31945,ElliotBayTrailMyrtlePark,08/24/2017 01:00:00 AM,48,-122,1,1,2
31946,ElliotBayTrailMyrtlePark,08/24/2017 02:00:00 AM,48,-122,1,0,1
31947,ElliotBayTrailMyrtlePark,08/24/2017 03:00:00 AM,48,-122,2,4,6
31948,ElliotBayTrailMyrtlePark,08/24/2017 04:00:00 AM,48,-122,2,2,4
31949,ElliotBayTrailMyrtlePark,08/24/2017 05:00:00 AM,48,-122,4,12,16
31950,ElliotBayTrailMyrtlePark,08/24/2017 06:00:00 AM,48,-122,17,43,60
31951,ElliotBayTrailMyrtlePark,08/24/2017 07:00:00 AM,48,-122,53,112,165
31952,ElliotBayTrailMyrtlePark,08/24/2017 08:00:00 AM,48,-122,48,144,192
31953,ElliotBayTrailMyrtlePark,08/24/2017 09:00:00 AM,48,-122,48,69,117
31954,ElliotBayTrailMyrtlePark,08/24/2017 10:00:00 AM,48,-122,19,38,57
31955,ElliotBayTrailMyrtlePark,08/24/2017 11:00:00 AM,48,-122,28,18,46
31956,ElliotBayTrailMyrtlePark,08/24/2017 12:00:00 PM,48,-122,19,26,45
31957,ElliotBayTrailMyrtlePark,08/24/2017 01:00:00 PM,48,-122,29,28,57
31958,ElliotBayTrailMyrtlePark,08/24/2017 02:00:00 PM,48,-122,24,32,56
31959,ElliotBayTrailMyrtlePark,08/24/2017 03:00:00 PM,48,-122,63,45,108
31960,ElliotBayTrailMyrtlePark,08/24/2017 04:00:00 PM,48,-122,94,57,151
31961,ElliotBayTrailMyrtlePark,08/24/2017 05:00:00 PM,48,-122,199,76,275
31962,ElliotBayTrailMyrtlePark,08/24/2017 06:00:00 PM,48,-122,170,60,230
31963,ElliotBayTrailMyrtlePark,08/24/2017 07:00:00 PM,48,-122,64,63,127
31964,ElliotBayTrailMyrtlePark,08/24/2017 08:00:00 PM,48,-122,41,30,71
31965,ElliotBayTrailMyrtlePark,08/24/2017 09:00:00 PM,48,-122,7,10,17
31966,ElliotBayTrailMyrtlePark,08/24/2017 10:00:00 PM,48,-122,2,5,7
31967,ElliotBayTrailMyrtlePark,08/24/2017 11:00:00 PM,48,-122,12,6,18
31968,ElliotBayTrailMyrtlePark,08/25/2017 12:00:00 AM,48,-122,3,0,3
31969,ElliotBayTrailMyrtlePark,08/25/2017 01:00:00 AM,48,-122,5,2,7
31970,ElliotBayTrailMyrtlePark,08/25/2017 02:00:00 AM,48,-122,2,3,5
31971,ElliotBayTrailMyrtlePark,08/25/2017 03:00:00 AM,48,-122,0,2,2
31972,ElliotBayTrailMyrtlePark,08/25/2017 04:00:00 AM,48,-122,0,3,3
31973,ElliotBayTrailMyrtlePark,08/25/2017 05:00:00 AM,48,-122,7,11,18
31974,ElliotBayTrailMyrtlePark,08/25/2017 06:00:00 AM,48,-122,16,40,56
31975,ElliotBayTrailMyrtlePark,08/25/2017 07:00:00 AM,48,-122,42,97,139
31976,ElliotBayTrailMyrtlePark,08/25/2017 08:00:00 AM,48,-122,53,149,202
31977,ElliotBayTrailMyrtlePark,08/25/2017 09:00:00 AM,48,-122,28,97,125
31978,ElliotBayTrailMyrtlePark,08/25/2017 10:00:00 AM,48,-122,13,33,46
31979,ElliotBayTrailMyrtlePark,08/25/2017 11:00:00 AM,48,-122,32,34,66
31980,ElliotBayTrailMyrtlePark,08/25/2017 12:00:00 PM,48,-122,33,27,60
31981,ElliotBayTrailMyrtlePark,08/25/2017 01:00:00 PM,48,-122,39,35,74
31982,ElliotBayTrailMyrtlePark,08/25/2017 02:00:00 PM,48,-122,50,47,97
31983,ElliotBayTrailMyrtlePark,08/25/2017 03:00:00 PM,48,-122,67,68,135
31984,ElliotBayTrailMyrtlePark,08/25/2017 04:00:00 PM,48,-122,126,80,206
31985,ElliotBayTrailMyrtlePark,08/25/2017 05:00:00 PM,48,-122,167,60,227
31986,ElliotBayTrailMyrtlePark,08/25/2017 06:00:00 PM,48,-122,111,54,165
31987,ElliotBayTrailMyrtlePark,08/25/2017 07:00:00 PM,48,-122,50,35,85
31988,ElliotBayTrailMyrtlePark,08/25/2017 08:00:00 PM,48,-122,38,21,59
31989,ElliotBayTrailMyrtlePark,08/25/2017 09:00:00 PM,48,-122,16,12,28
31990,ElliotBayTrailMyrtlePark,08/25/2017 10:00:00 PM,48,-122,14,8,22
31991,ElliotBayTrailMyrtlePark,08/25/2017 11:00:00 PM,48,-122,5,2,7
31992,ElliotBayTrailMyrtlePark,08/26/2017 12:00:00 AM,48,-122,5,0,5
31993,ElliotBayTrailMyrtlePark,08/26/2017 01:00:00 AM,48,-122,1,4,5
31994,ElliotBayTrailMyrtlePark,08/26/2017 02:00:00 AM,48,-122,0,0,0
31995,ElliotBayTrailMyrtlePark,08/26/2017 03:00:00 AM,48,-122,3,1,4
31996,ElliotBayTrailMyrtlePark,08/26/2017 04:00:00 AM,48,-122,0,2,2
31997,ElliotBayTrailMyrtlePark,08/26/2017 05:00:00 AM,48,-122,2,3,5
31998,ElliotBayTrailMyrtlePark,08/26/2017 06:00:00 AM,48,-122,7,4,11
31999,ElliotBayTrailMyrtlePark,08/26/2017 07:00:00 AM,48,-122,15,13,28
32000,ElliotBayTrailMyrtlePark,08/26/2017 08:00:00 AM,48,-122,16,23,39
32001,ElliotBayTrailMyrtlePark,08/26/2017 09:00:00 AM,48,-122,28,41,69
32002,ElliotBayTrailMyrtlePark,08/26/2017 10:00:00 AM,48,-122,41,52,93
32003,ElliotBayTrailMyrtlePark,08/26/2017 11:00:00 AM,48,-122,58,57,115
32004,ElliotBayTrailMyrtlePark,08/26/2017 12:00:00 PM,48,-122,52,71,123
32005,ElliotBayTrailMyrtlePark,08/26/2017 01:00:00 PM,48,-122,79,67,146
32006,ElliotBayTrailMyrtlePark,08/26/2017 02:00:00 PM,48,-122,59,68,127
32007,ElliotBayTrailMyrtlePark,08/26/2017 03:00:00 PM,48,-122,83,54,137
32008,ElliotBayTrailMyrtlePark,08/26/2017 04:00:00 PM,48,-122,81,70,151
32009,ElliotBayTrailMyrtlePark,08/26/2017 05:00:00 PM,48,-122,58,66,124
32010,ElliotBayTrailMyrtlePark,08/26/2017 06:00:00 PM,48,-122,56,52,108
32011,ElliotBayTrailMyrtlePark,08/26/2017 07:00:00 PM,48,-122,49,42,91
32012,ElliotBayTrailMyrtlePark,08/26/2017 08:00:00 PM,48,-122,35,36,71
32013,ElliotBayTrailMyrtlePark,08/26/2017 09:00:00 PM,48,-122,6,4,10
32014,ElliotBayTrailMyrtlePark,08/26/2017 10:00:00 PM,48,-122,8,5,13
32015,ElliotBayTrailMyrtlePark,08/26/2017 11:00:00 PM,48,-122,2,0,2
32016,ElliotBayTrailMyrtlePark,08/27/2017 12:00:00 AM,48,-122,2,1,3
32017,ElliotBayTrailMyrtlePark,08/27/2017 01:00:00 AM,48,-122,1,0,1
32018,ElliotBayTrailMyrtlePark,08/27/2017 02:00:00 AM,48,-122,2,2,4
32019,ElliotBayTrailMyrtlePark,08/27/2017 03:00:00 AM,48,-122,0,0,0
32020,ElliotBayTrailMyrtlePark,08/27/2017 04:00:00 AM,48,-122,0,1,1
32021,ElliotBayTrailMyrtlePark,08/27/2017 05:00:00 AM,48,-122,2,2,4
32022,ElliotBayTrailMyrtlePark,08/27/2017 06:00:00 AM,48,-122,6,4,10
32023,ElliotBayTrailMyrtlePark,08/27/2017 07:00:00 AM,48,-122,10,6,16
32024,ElliotBayTrailMyrtlePark,08/27/2017 08:00:00 AM,48,-122,25,20,45
32025,ElliotBayTrailMyrtlePark,08/27/2017 09:00:00 AM,48,-122,30,48,78
32026,ElliotBayTrailMyrtlePark,08/27/2017 10:00:00 AM,48,-122,54,49,103
32027,ElliotBayTrailMyrtlePark,08/27/2017 11:00:00 AM,48,-122,59,70,129
32028,ElliotBayTrailMyrtlePark,08/27/2017 12:00:00 PM,48,-122,65,86,151
32029,ElliotBayTrailMyrtlePark,08/27/2017 01:00:00 PM,48,-122,100,76,176
32030,ElliotBayTrailMyrtlePark,08/27/2017 02:00:00 PM,48,-122,92,96,188
32031,ElliotBayTrailMyrtlePark,08/27/2017 03:00:00 PM,48,-122,101,81,182
32032,ElliotBayTrailMyrtlePark,08/27/2017 04:00:00 PM,48,-122,83,82,165
32033,ElliotBayTrailMyrtlePark,08/27/2017 05:00:00 PM,48,-122,39,77,116
32034,ElliotBayTrailMyrtlePark,08/27/2017 06:00:00 PM,48,-122,37,66,103
32035,ElliotBayTrailMyrtlePark,08/27/2017 07:00:00 PM,48,-122,48,33,81
32036,ElliotBayTrailMyrtlePark,08/27/2017 08:00:00 PM,48,-122,46,26,72
32037,ElliotBayTrailMyrtlePark,08/27/2017 09:00:00 PM,48,-122,68,9,77
32038,ElliotBayTrailMyrtlePark,08/27/2017 10:00:00 PM,48,-122,11,1,12
32039,ElliotBayTrailMyrtlePark,08/27/2017 11:00:00 PM,48,-122,1,3,4
32040,ElliotBayTrailMyrtlePark,08/28/2017 12:00:00 AM,48,-122,1,1,2
32041,ElliotBayTrailMyrtlePark,08/28/2017 01:00:00 AM,48,-122,2,0,2
32042,ElliotBayTrailMyrtlePark,08/28/2017 02:00:00 AM,48,-122,1,0,1
32043,ElliotBayTrailMyrtlePark,08/28/2017 03:00:00 AM,48,-122,0,1,1
32044,ElliotBayTrailMyrtlePark,08/28/2017 04:00:00 AM,48,-122,3,4,7
32045,ElliotBayTrailMyrtlePark,08/28/2017 05:00:00 AM,48,-122,11,8,19
32046,ElliotBayTrailMyrtlePark,08/28/2017 06:00:00 AM,48,-122,21,37,58
32047,ElliotBayTrailMyrtlePark,08/28/2017 07:00:00 AM,48,-122,47,117,164
32048,ElliotBayTrailMyrtlePark,08/28/2017 08:00:00 AM,48,-122,46,196,242
32049,ElliotBayTrailMyrtlePark,08/28/2017 09:00:00 AM,48,-122,45,74,119
32050,ElliotBayTrailMyrtlePark,08/28/2017 10:00:00 AM,48,-122,25,49,74
32051,ElliotBayTrailMyrtlePark,08/28/2017 11:00:00 AM,48,-122,26,40,66
32052,ElliotBayTrailMyrtlePark,08/28/2017 12:00:00 PM,48,-122,49,36,85
32053,ElliotBayTrailMyrtlePark,08/28/2017 01:00:00 PM,48,-122,23,35,58
32054,ElliotBayTrailMyrtlePark,08/28/2017 02:00:00 PM,48,-122,32,36,68
32055,ElliotBayTrailMyrtlePark,08/28/2017 03:00:00 PM,48,-122,56,46,102
32056,ElliotBayTrailMyrtlePark,08/28/2017 04:00:00 PM,48,-122,86,73,159
32057,ElliotBayTrailMyrtlePark,08/28/2017 05:00:00 PM,48,-122,218,74,292
32058,ElliotBayTrailMyrtlePark,08/28/2017 06:00:00 PM,48,-122,132,42,174
32059,ElliotBayTrailMyrtlePark,08/28/2017 07:00:00 PM,48,-122,67,39,106
32060,ElliotBayTrailMyrtlePark,08/28/2017 08:00:00 PM,48,-122,18,21,39
32061,ElliotBayTrailMyrtlePark,08/28/2017 09:00:00 PM,48,-122,7,5,12
32062,ElliotBayTrailMyrtlePark,08/28/2017 10:00:00 PM,48,-122,3,6,9
32063,ElliotBayTrailMyrtlePark,08/28/2017 11:00:00 PM,48,-122,3,0,3
32064,ElliotBayTrailMyrtlePark,08/29/2017 12:00:00 AM,48,-122,1,0,1
32065,ElliotBayTrailMyrtlePark,08/29/2017 01:00:00 AM,48,-122,3,1,4
32066,ElliotBayTrailMyrtlePark,08/29/2017 02:00:00 AM,48,-122,1,0,1
32067,ElliotBayTrailMyrtlePark,08/29/2017 03:00:00 AM,48,-122,0,1,1
32068,ElliotBayTrailMyrtlePark,08/29/2017 04:00:00 AM,48,-122,1,2,3
32069,ElliotBayTrailMyrtlePark,08/29/2017 05:00:00 AM,48,-122,12,14,26
32070,ElliotBayTrailMyrtlePark,08/29/2017 06:00:00 AM,48,-122,28,41,69
32071,ElliotBayTrailMyrtlePark,08/29/2017 07:00:00 AM,48,-122,65,132,197
32072,ElliotBayTrailMyrtlePark,08/29/2017 08:00:00 AM,48,-122,53,194,247
32073,ElliotBayTrailMyrtlePark,08/29/2017 09:00:00 AM,48,-122,40,93,133
32074,ElliotBayTrailMyrtlePark,08/29/2017 10:00:00 AM,48,-122,29,35,64
32075,ElliotBayTrailMyrtlePark,08/29/2017 11:00:00 AM,48,-122,27,32,59
32076,ElliotBayTrailMyrtlePark,08/29/2017 12:00:00 PM,48,-122,34,32,66
32077,ElliotBayTrailMyrtlePark,08/29/2017 01:00:00 PM,48,-122,46,30,76
32078,ElliotBayTrailMyrtlePark,08/29/2017 02:00:00 PM,48,-122,34,34,68
32079,ElliotBayTrailMyrtlePark,08/29/2017 03:00:00 PM,48,-122,52,37,89
32080,ElliotBayTrailMyrtlePark,08/29/2017 04:00:00 PM,48,-122,119,58,177
32081,ElliotBayTrailMyrtlePark,08/29/2017 05:00:00 PM,48,-122,240,78,318
32082,ElliotBayTrailMyrtlePark,08/29/2017 06:00:00 PM,48,-122,165,62,227
32083,ElliotBayTrailMyrtlePark,08/29/2017 07:00:00 PM,48,-122,77,50,127
32084,ElliotBayTrailMyrtlePark,08/29/2017 08:00:00 PM,48,-122,27,22,49
32085,ElliotBayTrailMyrtlePark,08/29/2017 09:00:00 PM,48,-122,7,11,18
32086,ElliotBayTrailMyrtlePark,08/29/2017 10:00:00 PM,48,-122,10,4,14
32087,ElliotBayTrailMyrtlePark,08/29/2017 11:00:00 PM,48,-122,1,5,6
32088,ElliotBayTrailMyrtlePark,08/30/2017 12:00:00 AM,48,-122,0,0,0
32089,ElliotBayTrailMyrtlePark,08/30/2017 01:00:00 AM,48,-122,7,1,8
32090,ElliotBayTrailMyrtlePark,08/30/2017 02:00:00 AM,48,-122,0,0,0
32091,ElliotBayTrailMyrtlePark,08/30/2017 03:00:00 AM,48,-122,0,1,1
32092,ElliotBayTrailMyrtlePark,08/30/2017 04:00:00 AM,48,-122,3,4,7
32093,ElliotBayTrailMyrtlePark,08/30/2017 05:00:00 AM,48,-122,9,10,19
32094,ElliotBayTrailMyrtlePark,08/30/2017 06:00:00 AM,48,-122,21,46,67
32095,ElliotBayTrailMyrtlePark,08/30/2017 07:00:00 AM,48,-122,68,101,169
32096,ElliotBayTrailMyrtlePark,08/30/2017 08:00:00 AM,48,-122,36,185,221
32097,ElliotBayTrailMyrtlePark,08/30/2017 09:00:00 AM,48,-122,35,86,121
32098,ElliotBayTrailMyrtlePark,08/30/2017 10:00:00 AM,48,-122,22,25,47
32099,ElliotBayTrailMyrtlePark,08/30/2017 11:00:00 AM,48,-122,26,19,45
32100,ElliotBayTrailMyrtlePark,08/30/2017 12:00:00 PM,48,-122,42,34,76
32101,ElliotBayTrailMyrtlePark,08/30/2017 01:00:00 PM,48,-122,31,33,64
32102,ElliotBayTrailMyrtlePark,08/30/2017 02:00:00 PM,48,-122,30,30,60
32103,ElliotBayTrailMyrtlePark,08/30/2017 03:00:00 PM,48,-122,53,33,86
32104,ElliotBayTrailMyrtlePark,08/30/2017 04:00:00 PM,48,-122,105,73,178
32105,ElliotBayTrailMyrtlePark,08/30/2017 05:00:00 PM,48,-122,208,83,291
32106,ElliotBayTrailMyrtlePark,08/30/2017 06:00:00 PM,48,-122,152,63,215
32107,ElliotBayTrailMyrtlePark,08/30/2017 07:00:00 PM,48,-122,75,43,118
32108,ElliotBayTrailMyrtlePark,08/30/2017 08:00:00 PM,48,-122,34,38,72
32109,ElliotBayTrailMyrtlePark,08/30/2017 09:00:00 PM,48,-122,6,3,9
32110,ElliotBayTrailMyrtlePark,08/30/2017 10:00:00 PM,48,-122,3,8,11
32111,ElliotBayTrailMyrtlePark,08/30/2017 11:00:00 PM,48,-122,4,2,6
32112,ElliotBayTrailMyrtlePark,08/31/2017 12:00:00 AM,48,-122,3,1,4
32113,ElliotBayTrailMyrtlePark,08/31/2017 01:00:00 AM,48,-122,0,0,0
32114,ElliotBayTrailMyrtlePark,08/31/2017 02:00:00 AM,48,-122,3,1,4
32115,ElliotBayTrailMyrtlePark,08/31/2017 03:00:00 AM,48,-122,1,2,3
32116,ElliotBayTrailMyrtlePark,08/31/2017 04:00:00 AM,48,-122,0,2,2
32117,ElliotBayTrailMyrtlePark,08/31/2017 05:00:00 AM,48,-122,6,11,17
32118,ElliotBayTrailMyrtlePark,08/31/2017 06:00:00 AM,48,-122,20,30,50
32119,ElliotBayTrailMyrtlePark,08/31/2017 07:00:00 AM,48,-122,58,100,158
32120,ElliotBayTrailMyrtlePark,08/31/2017 08:00:00 AM,48,-122,43,157,200
32121,ElliotBayTrailMyrtlePark,08/31/2017 09:00:00 AM,48,-122,21,66,87
32122,ElliotBayTrailMyrtlePark,08/31/2017 10:00:00 AM,48,-122,13,32,45
32123,ElliotBayTrailMyrtlePark,08/31/2017 11:00:00 AM,48,-122,10,19,29
32124,ElliotBayTrailMyrtlePark,08/31/2017 12:00:00 PM,48,-122,18,12,30
32125,ElliotBayTrailMyrtlePark,08/31/2017 01:00:00 PM,48,-122,27,18,45
32126,ElliotBayTrailMyrtlePark,08/31/2017 02:00:00 PM,48,-122,27,21,48
32127,ElliotBayTrailMyrtlePark,08/31/2017 03:00:00 PM,48,-122,59,41,100
32128,ElliotBayTrailMyrtlePark,08/31/2017 04:00:00 PM,48,-122,92,72,164
32129,ElliotBayTrailMyrtlePark,08/31/2017 05:00:00 PM,48,-122,195,94,289
32130,ElliotBayTrailMyrtlePark,08/31/2017 06:00:00 PM,48,-122,145,64,209
32131,ElliotBayTrailMyrtlePark,08/31/2017 07:00:00 PM,48,-122,114,41,155
32132,ElliotBayTrailMyrtlePark,08/31/2017 08:00:00 PM,48,-122,46,26,72
32133,ElliotBayTrailMyrtlePark,08/31/2017 09:00:00 PM,48,-122,15,8,23
32134,ElliotBayTrailMyrtlePark,08/31/2017 10:00:00 PM,48,-122,9,4,13
32135,ElliotBayTrailMyrtlePark,08/31/2017 11:00:00 PM,48,-122,1,0,1
32136,ElliotBayTrailMyrtlePark,09/01/2017 12:00:00 AM,48,-122,4,3,7
32137,ElliotBayTrailMyrtlePark,09/01/2017 01:00:00 AM,48,-122,2,1,3
32138,ElliotBayTrailMyrtlePark,09/01/2017 02:00:00 AM,48,-122,0,0,0
32139,ElliotBayTrailMyrtlePark,09/01/2017 03:00:00 AM,48,-122,1,0,1
32140,ElliotBayTrailMyrtlePark,09/01/2017 04:00:00 AM,48,-122,0,3,3
32141,ElliotBayTrailMyrtlePark,09/01/2017 05:00:00 AM,48,-122,9,8,17
32142,ElliotBayTrailMyrtlePark,09/01/2017 06:00:00 AM,48,-122,15,24,39
32143,ElliotBayTrailMyrtlePark,09/01/2017 07:00:00 AM,48,-122,43,99,142
32144,ElliotBayTrailMyrtlePark,09/01/2017 08:00:00 AM,48,-122,40,143,183
32145,ElliotBayTrailMyrtlePark,09/01/2017 09:00:00 AM,48,-122,36,63,99
32146,ElliotBayTrailMyrtlePark,09/01/2017 10:00:00 AM,48,-122,31,38,69
32147,ElliotBayTrailMyrtlePark,09/01/2017 11:00:00 AM,48,-122,33,29,62
32148,ElliotBayTrailMyrtlePark,09/01/2017 12:00:00 PM,48,-122,41,52,93
32149,ElliotBayTrailMyrtlePark,09/01/2017 01:00:00 PM,48,-122,47,42,89
32150,ElliotBayTrailMyrtlePark,09/01/2017 02:00:00 PM,48,-122,63,52,115
32151,ElliotBayTrailMyrtlePark,09/01/2017 03:00:00 PM,48,-122,74,61,135
32152,ElliotBayTrailMyrtlePark,09/01/2017 04:00:00 PM,48,-122,128,71,199
32153,ElliotBayTrailMyrtlePark,09/01/2017 05:00:00 PM,48,-122,120,52,172
32154,ElliotBayTrailMyrtlePark,09/01/2017 06:00:00 PM,48,-122,77,57,134
32155,ElliotBayTrailMyrtlePark,09/01/2017 07:00:00 PM,48,-122,39,26,65
32156,ElliotBayTrailMyrtlePark,09/01/2017 08:00:00 PM,48,-122,30,10,40
32157,ElliotBayTrailMyrtlePark,09/01/2017 09:00:00 PM,48,-122,7,11,18
32158,ElliotBayTrailMyrtlePark,09/01/2017 10:00:00 PM,48,-122,24,3,27
32159,ElliotBayTrailMyrtlePark,09/01/2017 11:00:00 PM,48,-122,8,7,15
32160,ElliotBayTrailMyrtlePark,09/02/2017 12:00:00 AM,48,-122,2,10,12
32161,ElliotBayTrailMyrtlePark,09/02/2017 01:00:00 AM,48,-122,6,4,10
32162,ElliotBayTrailMyrtlePark,09/02/2017 02:00:00 AM,48,-122,5,3,8
32163,ElliotBayTrailMyrtlePark,09/02/2017 03:00:00 AM,48,-122,1,2,3
32164,ElliotBayTrailMyrtlePark,09/02/2017 04:00:00 AM,48,-122,0,0,0
32165,ElliotBayTrailMyrtlePark,09/02/2017 05:00:00 AM,48,-122,1,0,1
32166,ElliotBayTrailMyrtlePark,09/02/2017 06:00:00 AM,48,-122,2,5,7
32167,ElliotBayTrailMyrtlePark,09/02/2017 07:00:00 AM,48,-122,20,27,47
32168,ElliotBayTrailMyrtlePark,09/02/2017 08:00:00 AM,48,-122,21,26,47
32169,ElliotBayTrailMyrtlePark,09/02/2017 09:00:00 AM,48,-122,29,44,73
32170,ElliotBayTrailMyrtlePark,09/02/2017 10:00:00 AM,48,-122,49,42,91
32171,ElliotBayTrailMyrtlePark,09/02/2017 11:00:00 AM,48,-122,74,93,167
32172,ElliotBayTrailMyrtlePark,09/02/2017 12:00:00 PM,48,-122,57,74,131
32173,ElliotBayTrailMyrtlePark,09/02/2017 01:00:00 PM,48,-122,81,67,148
32174,ElliotBayTrailMyrtlePark,09/02/2017 02:00:00 PM,48,-122,72,49,121
32175,ElliotBayTrailMyrtlePark,09/02/2017 03:00:00 PM,48,-122,88,60,148
32176,ElliotBayTrailMyrtlePark,09/02/2017 04:00:00 PM,48,-122,71,45,116
32177,ElliotBayTrailMyrtlePark,09/02/2017 05:00:00 PM,48,-122,51,60,111
32178,ElliotBayTrailMyrtlePark,09/02/2017 06:00:00 PM,48,-122,40,57,97
32179,ElliotBayTrailMyrtlePark,09/02/2017 07:00:00 PM,48,-122,41,32,73
32180,ElliotBayTrailMyrtlePark,09/02/2017 08:00:00 PM,48,-122,20,18,38
32181,ElliotBayTrailMyrtlePark,09/02/2017 09:00:00 PM,48,-122,9,13,22
32182,ElliotBayTrailMyrtlePark,09/02/2017 10:00:00 PM,48,-122,6,4,10
32183,ElliotBayTrailMyrtlePark,09/02/2017 11:00:00 PM,48,-122,6,4,10
32184,ElliotBayTrailMyrtlePark,09/03/2017 12:00:00 AM,48,-122,7,4,11
32185,ElliotBayTrailMyrtlePark,09/03/2017 01:00:00 AM,48,-122,2,2,4
32186,ElliotBayTrailMyrtlePark,09/03/2017 02:00:00 AM,48,-122,1,0,1
32187,ElliotBayTrailMyrtlePark,09/03/2017 03:00:00 AM,48,-122,0,2,2
32188,ElliotBayTrailMyrtlePark,09/03/2017 04:00:00 AM,48,-122,3,0,3
32189,ElliotBayTrailMyrtlePark,09/03/2017 05:00:00 AM,48,-122,1,2,3
32190,ElliotBayTrailMyrtlePark,09/03/2017 06:00:00 AM,48,-122,4,4,8
32191,ElliotBayTrailMyrtlePark,09/03/2017 07:00:00 AM,48,-122,13,14,27
32192,ElliotBayTrailMyrtlePark,09/03/2017 08:00:00 AM,48,-122,16,21,37
32193,ElliotBayTrailMyrtlePark,09/03/2017 09:00:00 AM,48,-122,38,34,72
32194,ElliotBayTrailMyrtlePark,09/03/2017 10:00:00 AM,48,-122,52,53,105
32195,ElliotBayTrailMyrtlePark,09/03/2017 11:00:00 AM,48,-122,84,77,161
32196,ElliotBayTrailMyrtlePark,09/03/2017 12:00:00 PM,48,-122,63,92,155
32197,ElliotBayTrailMyrtlePark,09/03/2017 01:00:00 PM,48,-122,63,57,120
32198,ElliotBayTrailMyrtlePark,09/03/2017 02:00:00 PM,48,-122,53,60,113
32199,ElliotBayTrailMyrtlePark,09/03/2017 03:00:00 PM,48,-122,68,54,122
32200,ElliotBayTrailMyrtlePark,09/03/2017 04:00:00 PM,48,-122,84,55,139
32201,ElliotBayTrailMyrtlePark,09/03/2017 05:00:00 PM,48,-122,62,34,96
32202,ElliotBayTrailMyrtlePark,09/03/2017 06:00:00 PM,48,-122,53,46,99
32203,ElliotBayTrailMyrtlePark,09/03/2017 07:00:00 PM,48,-122,42,32,74
32204,ElliotBayTrailMyrtlePark,09/03/2017 08:00:00 PM,48,-122,21,38,59
32205,ElliotBayTrailMyrtlePark,09/03/2017 09:00:00 PM,48,-122,8,5,13
32206,ElliotBayTrailMyrtlePark,09/03/2017 10:00:00 PM,48,-122,13,5,18
32207,ElliotBayTrailMyrtlePark,09/03/2017 11:00:00 PM,48,-122,12,2,14
32208,ElliotBayTrailMyrtlePark,09/04/2017 12:00:00 AM,48,-122,3,1,4
32209,ElliotBayTrailMyrtlePark,09/04/2017 01:00:00 AM,48,-122,3,3,6
32210,ElliotBayTrailMyrtlePark,09/04/2017 02:00:00 AM,48,-122,1,0,1
32211,ElliotBayTrailMyrtlePark,09/04/2017 03:00:00 AM,48,-122,0,1,1
32212,ElliotBayTrailMyrtlePark,09/04/2017 04:00:00 AM,48,-122,0,1,1
32213,ElliotBayTrailMyrtlePark,09/04/2017 05:00:00 AM,48,-122,1,1,2
32214,ElliotBayTrailMyrtlePark,09/04/2017 06:00:00 AM,48,-122,3,3,6
32215,ElliotBayTrailMyrtlePark,09/04/2017 07:00:00 AM,48,-122,13,9,22
32216,ElliotBayTrailMyrtlePark,09/04/2017 08:00:00 AM,48,-122,36,58,94
32217,ElliotBayTrailMyrtlePark,09/04/2017 09:00:00 AM,48,-122,46,62,108
32218,ElliotBayTrailMyrtlePark,09/04/2017 10:00:00 AM,48,-122,61,48,109
32219,ElliotBayTrailMyrtlePark,09/04/2017 11:00:00 AM,48,-122,54,76,130
32220,ElliotBayTrailMyrtlePark,09/04/2017 12:00:00 PM,48,-122,61,59,120
32221,ElliotBayTrailMyrtlePark,09/04/2017 01:00:00 PM,48,-122,77,82,159
32222,ElliotBayTrailMyrtlePark,09/04/2017 02:00:00 PM,48,-122,53,83,136
32223,ElliotBayTrailMyrtlePark,09/04/2017 03:00:00 PM,48,-122,71,61,132
32224,ElliotBayTrailMyrtlePark,09/04/2017 04:00:00 PM,48,-122,74,46,120
32225,ElliotBayTrailMyrtlePark,09/04/2017 05:00:00 PM,48,-122,40,41,81
32226,ElliotBayTrailMyrtlePark,09/04/2017 06:00:00 PM,48,-122,52,33,85
32227,ElliotBayTrailMyrtlePark,09/04/2017 07:00:00 PM,48,-122,39,34,73
32228,ElliotBayTrailMyrtlePark,09/04/2017 08:00:00 PM,48,-122,13,11,24
32229,ElliotBayTrailMyrtlePark,09/04/2017 09:00:00 PM,48,-122,16,13,29
32230,ElliotBayTrailMyrtlePark,09/04/2017 10:00:00 PM,48,-122,15,9,24
32231,ElliotBayTrailMyrtlePark,09/04/2017 11:00:00 PM,48,-122,9,0,9
32232,ElliotBayTrailMyrtlePark,09/05/2017 12:00:00 AM,48,-122,1,1,2
32233,ElliotBayTrailMyrtlePark,09/05/2017 01:00:00 AM,48,-122,0,1,1
32234,ElliotBayTrailMyrtlePark,09/05/2017 02:00:00 AM,48,-122,2,1,3
32235,ElliotBayTrailMyrtlePark,09/05/2017 03:00:00 AM,48,-122,2,1,3
32236,ElliotBayTrailMyrtlePark,09/05/2017 04:00:00 AM,48,-122,2,4,6
32237,ElliotBayTrailMyrtlePark,09/05/2017 05:00:00 AM,48,-122,9,13,22
32238,ElliotBayTrailMyrtlePark,09/05/2017 06:00:00 AM,48,-122,30,37,67
32239,ElliotBayTrailMyrtlePark,09/05/2017 07:00:00 AM,48,-122,58,115,173
32240,ElliotBayTrailMyrtlePark,09/05/2017 08:00:00 AM,48,-122,51,149,200
32241,ElliotBayTrailMyrtlePark,09/05/2017 09:00:00 AM,48,-122,31,70,101
32242,ElliotBayTrailMyrtlePark,09/05/2017 10:00:00 AM,48,-122,20,29,49
32243,ElliotBayTrailMyrtlePark,09/05/2017 11:00:00 AM,48,-122,16,16,32
32244,ElliotBayTrailMyrtlePark,09/05/2017 12:00:00 PM,48,-122,34,13,47
32245,ElliotBayTrailMyrtlePark,09/05/2017 01:00:00 PM,48,-122,16,12,28
32246,ElliotBayTrailMyrtlePark,09/05/2017 02:00:00 PM,48,-122,27,14,41
32247,ElliotBayTrailMyrtlePark,09/05/2017 03:00:00 PM,48,-122,33,38,71
32248,ElliotBayTrailMyrtlePark,09/05/2017 04:00:00 PM,48,-122,93,66,159
32249,ElliotBayTrailMyrtlePark,09/05/2017 05:00:00 PM,48,-122,174,57,231
32250,ElliotBayTrailMyrtlePark,09/05/2017 06:00:00 PM,48,-122,93,26,119
32251,ElliotBayTrailMyrtlePark,09/05/2017 07:00:00 PM,48,-122,27,17,44
32252,ElliotBayTrailMyrtlePark,09/05/2017 08:00:00 PM,48,-122,18,9,27
32253,ElliotBayTrailMyrtlePark,09/05/2017 09:00:00 PM,48,-122,8,5,13
32254,ElliotBayTrailMyrtlePark,09/05/2017 10:00:00 PM,48,-122,10,3,13
32255,ElliotBayTrailMyrtlePark,09/05/2017 11:00:00 PM,48,-122,6,0,6
32256,ElliotBayTrailMyrtlePark,09/06/2017 12:00:00 AM,48,-122,0,3,3
32257,ElliotBayTrailMyrtlePark,09/06/2017 01:00:00 AM,48,-122,6,2,8
32258,ElliotBayTrailMyrtlePark,09/06/2017 02:00:00 AM,48,-122,0,1,1
32259,ElliotBayTrailMyrtlePark,09/06/2017 03:00:00 AM,48,-122,0,1,1
32260,ElliotBayTrailMyrtlePark,09/06/2017 04:00:00 AM,48,-122,3,2,5
32261,ElliotBayTrailMyrtlePark,09/06/2017 05:00:00 AM,48,-122,9,11,20
32262,ElliotBayTrailMyrtlePark,09/06/2017 06:00:00 AM,48,-122,30,37,67
32263,ElliotBayTrailMyrtlePark,09/06/2017 07:00:00 AM,48,-122,47,94,141
32264,ElliotBayTrailMyrtlePark,09/06/2017 08:00:00 AM,48,-122,36,142,178
32265,ElliotBayTrailMyrtlePark,09/06/2017 09:00:00 AM,48,-122,31,65,96
32266,ElliotBayTrailMyrtlePark,09/06/2017 10:00:00 AM,48,-122,10,29,39
32267,ElliotBayTrailMyrtlePark,09/06/2017 11:00:00 AM,48,-122,20,20,40
32268,ElliotBayTrailMyrtlePark,09/06/2017 12:00:00 PM,48,-122,18,13,31
32269,ElliotBayTrailMyrtlePark,09/06/2017 01:00:00 PM,48,-122,21,20,41
32270,ElliotBayTrailMyrtlePark,09/06/2017 02:00:00 PM,48,-122,30,32,62
32271,ElliotBayTrailMyrtlePark,09/06/2017 03:00:00 PM,48,-122,37,37,74
32272,ElliotBayTrailMyrtlePark,09/06/2017 04:00:00 PM,48,-122,92,42,134
32273,ElliotBayTrailMyrtlePark,09/06/2017 05:00:00 PM,48,-122,152,71,223
32274,ElliotBayTrailMyrtlePark,09/06/2017 06:00:00 PM,48,-122,117,50,167
32275,ElliotBayTrailMyrtlePark,09/06/2017 07:00:00 PM,48,-122,50,21,71
32276,ElliotBayTrailMyrtlePark,09/06/2017 08:00:00 PM,48,-122,15,6,21
32277,ElliotBayTrailMyrtlePark,09/06/2017 09:00:00 PM,48,-122,5,12,17
32278,ElliotBayTrailMyrtlePark,09/06/2017 10:00:00 PM,48,-122,6,3,9
32279,ElliotBayTrailMyrtlePark,09/06/2017 11:00:00 PM,48,-122,5,2,7
32280,ElliotBayTrailMyrtlePark,09/07/2017 12:00:00 AM,48,-122,2,1,3
32281,ElliotBayTrailMyrtlePark,09/07/2017 01:00:00 AM,48,-122,2,1,3
32282,ElliotBayTrailMyrtlePark,09/07/2017 02:00:00 AM,48,-122,1,0,1
32283,ElliotBayTrailMyrtlePark,09/07/2017 03:00:00 AM,48,-122,2,2,4
32284,ElliotBayTrailMyrtlePark,09/07/2017 04:00:00 AM,48,-122,4,3,7
32285,ElliotBayTrailMyrtlePark,09/07/2017 05:00:00 AM,48,-122,10,8,18
32286,ElliotBayTrailMyrtlePark,09/07/2017 06:00:00 AM,48,-122,29,27,56
32287,ElliotBayTrailMyrtlePark,09/07/2017 07:00:00 AM,48,-122,56,99,155
32288,ElliotBayTrailMyrtlePark,09/07/2017 08:00:00 AM,48,-122,41,150,191
32289,ElliotBayTrailMyrtlePark,09/07/2017 09:00:00 AM,48,-122,28,66,94
32290,ElliotBayTrailMyrtlePark,09/07/2017 10:00:00 AM,48,-122,14,25,39
32291,ElliotBayTrailMyrtlePark,09/07/2017 11:00:00 AM,48,-122,17,14,31
32292,ElliotBayTrailMyrtlePark,09/07/2017 12:00:00 PM,48,-122,15,11,26
32293,ElliotBayTrailMyrtlePark,09/07/2017 01:00:00 PM,48,-122,22,31,53
32294,ElliotBayTrailMyrtlePark,09/07/2017 02:00:00 PM,48,-122,39,26,65
32295,ElliotBayTrailMyrtlePark,09/07/2017 03:00:00 PM,48,-122,43,45,88
32296,ElliotBayTrailMyrtlePark,09/07/2017 04:00:00 PM,48,-122,89,57,146
32297,ElliotBayTrailMyrtlePark,09/07/2017 05:00:00 PM,48,-122,182,79,261
32298,ElliotBayTrailMyrtlePark,09/07/2017 06:00:00 PM,48,-122,113,33,146
32299,ElliotBayTrailMyrtlePark,09/07/2017 07:00:00 PM,48,-122,35,15,50
32300,ElliotBayTrailMyrtlePark,09/07/2017 08:00:00 PM,48,-122,15,8,23
32301,ElliotBayTrailMyrtlePark,09/07/2017 09:00:00 PM,48,-122,10,4,14
32302,ElliotBayTrailMyrtlePark,09/07/2017 10:00:00 PM,48,-122,9,4,13
32303,ElliotBayTrailMyrtlePark,09/07/2017 11:00:00 PM,48,-122,5,5,10
32304,ElliotBayTrailMyrtlePark,09/08/2017 12:00:00 AM,48,-122,3,2,5
32305,ElliotBayTrailMyrtlePark,09/08/2017 01:00:00 AM,48,-122,1,0,1
32306,ElliotBayTrailMyrtlePark,09/08/2017 02:00:00 AM,48,-122,2,1,3
32307,ElliotBayTrailMyrtlePark,09/08/2017 03:00:00 AM,48,-122,0,1,1
32308,ElliotBayTrailMyrtlePark,09/08/2017 04:00:00 AM,48,-122,1,2,3
32309,ElliotBayTrailMyrtlePark,09/08/2017 05:00:00 AM,48,-122,6,8,14
32310,ElliotBayTrailMyrtlePark,09/08/2017 06:00:00 AM,48,-122,26,31,57
32311,ElliotBayTrailMyrtlePark,09/08/2017 07:00:00 AM,48,-122,40,96,136
32312,ElliotBayTrailMyrtlePark,09/08/2017 08:00:00 AM,48,-122,36,120,156
32313,ElliotBayTrailMyrtlePark,09/08/2017 09:00:00 AM,48,-122,22,58,80
32314,ElliotBayTrailMyrtlePark,09/08/2017 10:00:00 AM,48,-122,22,25,47
32315,ElliotBayTrailMyrtlePark,09/08/2017 11:00:00 AM,48,-122,17,29,46
32316,ElliotBayTrailMyrtlePark,09/08/2017 12:00:00 PM,48,-122,26,24,50
32317,ElliotBayTrailMyrtlePark,09/08/2017 01:00:00 PM,48,-122,21,23,44
32318,ElliotBayTrailMyrtlePark,09/08/2017 02:00:00 PM,48,-122,38,43,81
32319,ElliotBayTrailMyrtlePark,09/08/2017 03:00:00 PM,48,-122,58,37,95
32320,ElliotBayTrailMyrtlePark,09/08/2017 04:00:00 PM,48,-122,104,65,169
32321,ElliotBayTrailMyrtlePark,09/08/2017 05:00:00 PM,48,-122,150,57,207
32322,ElliotBayTrailMyrtlePark,09/08/2017 06:00:00 PM,48,-122,84,25,109
32323,ElliotBayTrailMyrtlePark,09/08/2017 07:00:00 PM,48,-122,28,17,45
32324,ElliotBayTrailMyrtlePark,09/08/2017 08:00:00 PM,48,-122,10,13,23
32325,ElliotBayTrailMyrtlePark,09/08/2017 09:00:00 PM,48,-122,12,1,13
32326,ElliotBayTrailMyrtlePark,09/08/2017 10:00:00 PM,48,-122,14,9,23
32327,ElliotBayTrailMyrtlePark,09/08/2017 11:00:00 PM,48,-122,4,1,5
32328,ElliotBayTrailMyrtlePark,09/09/2017 12:00:00 AM,48,-122,4,1,5
32329,ElliotBayTrailMyrtlePark,09/09/2017 01:00:00 AM,48,-122,2,0,2
32330,ElliotBayTrailMyrtlePark,09/09/2017 02:00:00 AM,48,-122,2,0,2
32331,ElliotBayTrailMyrtlePark,09/09/2017 03:00:00 AM,48,-122,1,0,1
32332,ElliotBayTrailMyrtlePark,09/09/2017 04:00:00 AM,48,-122,0,0,0
32333,ElliotBayTrailMyrtlePark,09/09/2017 05:00:00 AM,48,-122,1,0,1
32334,ElliotBayTrailMyrtlePark,09/09/2017 06:00:00 AM,48,-122,2,2,4
32335,ElliotBayTrailMyrtlePark,09/09/2017 07:00:00 AM,48,-122,7,16,23
32336,ElliotBayTrailMyrtlePark,09/09/2017 08:00:00 AM,48,-122,15,19,34
32337,ElliotBayTrailMyrtlePark,09/09/2017 09:00:00 AM,48,-122,17,25,42
32338,ElliotBayTrailMyrtlePark,09/09/2017 10:00:00 AM,48,-122,31,33,64
32339,ElliotBayTrailMyrtlePark,09/09/2017 11:00:00 AM,48,-122,22,29,51
32340,ElliotBayTrailMyrtlePark,09/09/2017 12:00:00 PM,48,-122,40,38,78
32341,ElliotBayTrailMyrtlePark,09/09/2017 01:00:00 PM,48,-122,35,31,66
32342,ElliotBayTrailMyrtlePark,09/09/2017 02:00:00 PM,48,-122,39,31,70
32343,ElliotBayTrailMyrtlePark,09/09/2017 03:00:00 PM,48,-122,35,32,67
32344,ElliotBayTrailMyrtlePark,09/09/2017 04:00:00 PM,48,-122,29,33,62
32345,ElliotBayTrailMyrtlePark,09/09/2017 05:00:00 PM,48,-122,28,30,58
32346,ElliotBayTrailMyrtlePark,09/09/2017 06:00:00 PM,48,-122,31,24,55
32347,ElliotBayTrailMyrtlePark,09/09/2017 07:00:00 PM,48,-122,16,30,46
32348,ElliotBayTrailMyrtlePark,09/09/2017 08:00:00 PM,48,-122,8,10,18
32349,ElliotBayTrailMyrtlePark,09/09/2017 09:00:00 PM,48,-122,8,5,13
32350,ElliotBayTrailMyrtlePark,09/09/2017 10:00:00 PM,48,-122,6,0,6
32351,ElliotBayTrailMyrtlePark,09/09/2017 11:00:00 PM,48,-122,7,5,12
32352,ElliotBayTrailMyrtlePark,09/10/2017 12:00:00 AM,48,-122,4,1,5
32353,ElliotBayTrailMyrtlePark,09/10/2017 01:00:00 AM,48,-122,0,1,1
32354,ElliotBayTrailMyrtlePark,09/10/2017 02:00:00 AM,48,-122,3,0,3
32355,ElliotBayTrailMyrtlePark,09/10/2017 03:00:00 AM,48,-122,0,0,0
32356,ElliotBayTrailMyrtlePark,09/10/2017 04:00:00 AM,48,-122,0,0,0
32357,ElliotBayTrailMyrtlePark,09/10/2017 05:00:00 AM,48,-122,1,2,3
32358,ElliotBayTrailMyrtlePark,09/10/2017 06:00:00 AM,48,-122,4,2,6
32359,ElliotBayTrailMyrtlePark,09/10/2017 07:00:00 AM,48,-122,6,7,13
32360,ElliotBayTrailMyrtlePark,09/10/2017 08:00:00 AM,48,-122,19,22,41
32361,ElliotBayTrailMyrtlePark,09/10/2017 09:00:00 AM,48,-122,25,33,58
32362,ElliotBayTrailMyrtlePark,09/10/2017 10:00:00 AM,48,-122,43,47,90
32363,ElliotBayTrailMyrtlePark,09/10/2017 11:00:00 AM,48,-122,44,56,100
32364,ElliotBayTrailMyrtlePark,09/10/2017 12:00:00 PM,48,-122,52,63,115
32365,ElliotBayTrailMyrtlePark,09/10/2017 01:00:00 PM,48,-122,35,63,98
32366,ElliotBayTrailMyrtlePark,09/10/2017 02:00:00 PM,48,-122,60,48,108
32367,ElliotBayTrailMyrtlePark,09/10/2017 03:00:00 PM,48,-122,62,62,124
32368,ElliotBayTrailMyrtlePark,09/10/2017 04:00:00 PM,48,-122,73,59,132
32369,ElliotBayTrailMyrtlePark,09/10/2017 05:00:00 PM,48,-122,52,71,123
32370,ElliotBayTrailMyrtlePark,09/10/2017 06:00:00 PM,48,-122,59,48,107
32371,ElliotBayTrailMyrtlePark,09/10/2017 07:00:00 PM,48,-122,25,44,69
32372,ElliotBayTrailMyrtlePark,09/10/2017 08:00:00 PM,48,-122,62,15,77
32373,ElliotBayTrailMyrtlePark,09/10/2017 09:00:00 PM,48,-122,13,11,24
32374,ElliotBayTrailMyrtlePark,09/10/2017 10:00:00 PM,48,-122,3,3,6
32375,ElliotBayTrailMyrtlePark,09/10/2017 11:00:00 PM,48,-122,6,1,7
32376,ElliotBayTrailMyrtlePark,09/11/2017 12:00:00 AM,48,-122,2,4,6
32377,ElliotBayTrailMyrtlePark,09/11/2017 01:00:00 AM,48,-122,1,0,1
32378,ElliotBayTrailMyrtlePark,09/11/2017 02:00:00 AM,48,-122,1,0,1
32379,ElliotBayTrailMyrtlePark,09/11/2017 03:00:00 AM,48,-122,0,0,0
32380,ElliotBayTrailMyrtlePark,09/11/2017 04:00:00 AM,48,-122,3,2,5
32381,ElliotBayTrailMyrtlePark,09/11/2017 05:00:00 AM,48,-122,12,12,24
32382,ElliotBayTrailMyrtlePark,09/11/2017 06:00:00 AM,48,-122,29,34,63
32383,ElliotBayTrailMyrtlePark,09/11/2017 07:00:00 AM,48,-122,46,102,148
32384,ElliotBayTrailMyrtlePark,09/11/2017 08:00:00 AM,48,-122,38,197,235
32385,ElliotBayTrailMyrtlePark,09/11/2017 09:00:00 AM,48,-122,32,77,109
32386,ElliotBayTrailMyrtlePark,09/11/2017 10:00:00 AM,48,-122,24,30,54
32387,ElliotBayTrailMyrtlePark,09/11/2017 11:00:00 AM,48,-122,19,25,44
32388,ElliotBayTrailMyrtlePark,09/11/2017 12:00:00 PM,48,-122,33,28,61
32389,ElliotBayTrailMyrtlePark,09/11/2017 01:00:00 PM,48,-122,27,35,62
32390,ElliotBayTrailMyrtlePark,09/11/2017 02:00:00 PM,48,-122,48,24,72
32391,ElliotBayTrailMyrtlePark,09/11/2017 03:00:00 PM,48,-122,43,45,88
32392,ElliotBayTrailMyrtlePark,09/11/2017 04:00:00 PM,48,-122,114,69,183
32393,ElliotBayTrailMyrtlePark,09/11/2017 05:00:00 PM,48,-122,225,85,310
32394,ElliotBayTrailMyrtlePark,09/11/2017 06:00:00 PM,48,-122,165,57,222
32395,ElliotBayTrailMyrtlePark,09/11/2017 07:00:00 PM,48,-122,56,44,100
32396,ElliotBayTrailMyrtlePark,09/11/2017 08:00:00 PM,48,-122,17,22,39
32397,ElliotBayTrailMyrtlePark,09/11/2017 09:00:00 PM,48,-122,7,3,10
32398,ElliotBayTrailMyrtlePark,09/11/2017 10:00:00 PM,48,-122,6,7,13
32399,ElliotBayTrailMyrtlePark,09/11/2017 11:00:00 PM,48,-122,3,3,6
32400,ElliotBayTrailMyrtlePark,09/12/2017 12:00:00 AM,48,-122,3,0,3
32401,ElliotBayTrailMyrtlePark,09/12/2017 01:00:00 AM,48,-122,1,3,4
32402,ElliotBayTrailMyrtlePark,09/12/2017 02:00:00 AM,48,-122,1,1,2
32403,ElliotBayTrailMyrtlePark,09/12/2017 03:00:00 AM,48,-122,0,1,1
32404,ElliotBayTrailMyrtlePark,09/12/2017 04:00:00 AM,48,-122,4,2,6
32405,ElliotBayTrailMyrtlePark,09/12/2017 05:00:00 AM,48,-122,10,13,23
32406,ElliotBayTrailMyrtlePark,09/12/2017 06:00:00 AM,48,-122,32,42,74
32407,ElliotBayTrailMyrtlePark,09/12/2017 07:00:00 AM,48,-122,51,131,182
32408,ElliotBayTrailMyrtlePark,09/12/2017 08:00:00 AM,48,-122,66,184,250
32409,ElliotBayTrailMyrtlePark,09/12/2017 09:00:00 AM,48,-122,25,74,99
32410,ElliotBayTrailMyrtlePark,09/12/2017 10:00:00 AM,48,-122,20,29,49
32411,ElliotBayTrailMyrtlePark,09/12/2017 11:00:00 AM,48,-122,22,29,51
32412,ElliotBayTrailMyrtlePark,09/12/2017 12:00:00 PM,48,-122,32,37,69
32413,ElliotBayTrailMyrtlePark,09/12/2017 01:00:00 PM,48,-122,50,39,89
32414,ElliotBayTrailMyrtlePark,09/12/2017 02:00:00 PM,48,-122,34,31,65
32415,ElliotBayTrailMyrtlePark,09/12/2017 03:00:00 PM,48,-122,50,25,75
32416,ElliotBayTrailMyrtlePark,09/12/2017 04:00:00 PM,48,-122,136,86,222
32417,ElliotBayTrailMyrtlePark,09/12/2017 05:00:00 PM,48,-122,213,94,307
32418,ElliotBayTrailMyrtlePark,09/12/2017 06:00:00 PM,48,-122,126,62,188
32419,ElliotBayTrailMyrtlePark,09/12/2017 07:00:00 PM,48,-122,42,34,76
32420,ElliotBayTrailMyrtlePark,09/12/2017 08:00:00 PM,48,-122,23,9,32
32421,ElliotBayTrailMyrtlePark,09/12/2017 09:00:00 PM,48,-122,2,8,10
32422,ElliotBayTrailMyrtlePark,09/12/2017 10:00:00 PM,48,-122,9,6,15
32423,ElliotBayTrailMyrtlePark,09/12/2017 11:00:00 PM,48,-122,3,0,3
32424,ElliotBayTrailMyrtlePark,09/13/2017 12:00:00 AM,48,-122,1,3,4
32425,ElliotBayTrailMyrtlePark,09/13/2017 01:00:00 AM,48,-122,3,3,6
32426,ElliotBayTrailMyrtlePark,09/13/2017 02:00:00 AM,48,-122,1,0,1
32427,ElliotBayTrailMyrtlePark,09/13/2017 03:00:00 AM,48,-122,1,1,2
32428,ElliotBayTrailMyrtlePark,09/13/2017 04:00:00 AM,48,-122,6,4,10
32429,ElliotBayTrailMyrtlePark,09/13/2017 05:00:00 AM,48,-122,7,10,17
32430,ElliotBayTrailMyrtlePark,09/13/2017 06:00:00 AM,48,-122,27,47,74
32431,ElliotBayTrailMyrtlePark,09/13/2017 07:00:00 AM,48,-122,51,117,168
32432,ElliotBayTrailMyrtlePark,09/13/2017 08:00:00 AM,48,-122,52,166,218
32433,ElliotBayTrailMyrtlePark,09/13/2017 09:00:00 AM,48,-122,31,78,109
32434,ElliotBayTrailMyrtlePark,09/13/2017 10:00:00 AM,48,-122,14,36,50
32435,ElliotBayTrailMyrtlePark,09/13/2017 11:00:00 AM,48,-122,14,18,32
32436,ElliotBayTrailMyrtlePark,09/13/2017 12:00:00 PM,48,-122,23,21,44
32437,ElliotBayTrailMyrtlePark,09/13/2017 01:00:00 PM,48,-122,22,24,46
32438,ElliotBayTrailMyrtlePark,09/13/2017 02:00:00 PM,48,-122,38,30,68
32439,ElliotBayTrailMyrtlePark,09/13/2017 03:00:00 PM,48,-122,65,44,109
32440,ElliotBayTrailMyrtlePark,09/13/2017 04:00:00 PM,48,-122,116,67,183
32441,ElliotBayTrailMyrtlePark,09/13/2017 05:00:00 PM,48,-122,220,87,307
32442,ElliotBayTrailMyrtlePark,09/13/2017 06:00:00 PM,48,-122,149,48,197
32443,ElliotBayTrailMyrtlePark,09/13/2017 07:00:00 PM,48,-122,58,43,101
32444,ElliotBayTrailMyrtlePark,09/13/2017 08:00:00 PM,48,-122,13,15,28
32445,ElliotBayTrailMyrtlePark,09/13/2017 09:00:00 PM,48,-122,7,4,11
32446,ElliotBayTrailMyrtlePark,09/13/2017 10:00:00 PM,48,-122,4,0,4
32447,ElliotBayTrailMyrtlePark,09/13/2017 11:00:00 PM,48,-122,4,1,5
32448,ElliotBayTrailMyrtlePark,09/14/2017 12:00:00 AM,48,-122,3,3,6
32449,ElliotBayTrailMyrtlePark,09/14/2017 01:00:00 AM,48,-122,1,1,2
32450,ElliotBayTrailMyrtlePark,09/14/2017 02:00:00 AM,48,-122,1,0,1
32451,ElliotBayTrailMyrtlePark,09/14/2017 03:00:00 AM,48,-122,1,3,4
32452,ElliotBayTrailMyrtlePark,09/14/2017 04:00:00 AM,48,-122,3,3,6
32453,ElliotBayTrailMyrtlePark,09/14/2017 05:00:00 AM,48,-122,14,8,22
32454,ElliotBayTrailMyrtlePark,09/14/2017 06:00:00 AM,48,-122,26,37,63
32455,ElliotBayTrailMyrtlePark,09/14/2017 07:00:00 AM,48,-122,51,111,162
32456,ElliotBayTrailMyrtlePark,09/14/2017 08:00:00 AM,48,-122,52,167,219
32457,ElliotBayTrailMyrtlePark,09/14/2017 09:00:00 AM,48,-122,29,79,108
32458,ElliotBayTrailMyrtlePark,09/14/2017 10:00:00 AM,48,-122,21,30,51
32459,ElliotBayTrailMyrtlePark,09/14/2017 11:00:00 AM,48,-122,17,24,41
32460,ElliotBayTrailMyrtlePark,09/14/2017 12:00:00 PM,48,-122,23,16,39
32461,ElliotBayTrailMyrtlePark,09/14/2017 01:00:00 PM,48,-122,33,34,67
32462,ElliotBayTrailMyrtlePark,09/14/2017 02:00:00 PM,48,-122,32,26,58
32463,ElliotBayTrailMyrtlePark,09/14/2017 03:00:00 PM,48,-122,51,37,88
32464,ElliotBayTrailMyrtlePark,09/14/2017 04:00:00 PM,48,-122,95,66,161
32465,ElliotBayTrailMyrtlePark,09/14/2017 05:00:00 PM,48,-122,191,94,285
32466,ElliotBayTrailMyrtlePark,09/14/2017 06:00:00 PM,48,-122,106,46,152
32467,ElliotBayTrailMyrtlePark,09/14/2017 07:00:00 PM,48,-122,45,23,68
32468,ElliotBayTrailMyrtlePark,09/14/2017 08:00:00 PM,48,-122,20,15,35
32469,ElliotBayTrailMyrtlePark,09/14/2017 09:00:00 PM,48,-122,8,6,14
32470,ElliotBayTrailMyrtlePark,09/14/2017 10:00:00 PM,48,-122,7,2,9
32471,ElliotBayTrailMyrtlePark,09/14/2017 11:00:00 PM,48,-122,3,1,4
32472,ElliotBayTrailMyrtlePark,09/15/2017 12:00:00 AM,48,-122,1,0,1
32473,ElliotBayTrailMyrtlePark,09/15/2017 01:00:00 AM,48,-122,1,0,1
32474,ElliotBayTrailMyrtlePark,09/15/2017 02:00:00 AM,48,-122,1,0,1
32475,ElliotBayTrailMyrtlePark,09/15/2017 03:00:00 AM,48,-122,1,2,3
32476,ElliotBayTrailMyrtlePark,09/15/2017 04:00:00 AM,48,-122,4,4,8
32477,ElliotBayTrailMyrtlePark,09/15/2017 05:00:00 AM,48,-122,4,14,18
32478,ElliotBayTrailMyrtlePark,09/15/2017 06:00:00 AM,48,-122,14,33,47
32479,ElliotBayTrailMyrtlePark,09/15/2017 07:00:00 AM,48,-122,44,92,136
32480,ElliotBayTrailMyrtlePark,09/15/2017 08:00:00 AM,48,-122,37,145,182
32481,ElliotBayTrailMyrtlePark,09/15/2017 09:00:00 AM,48,-122,40,75,115
32482,ElliotBayTrailMyrtlePark,09/15/2017 10:00:00 AM,48,-122,10,48,58
32483,ElliotBayTrailMyrtlePark,09/15/2017 11:00:00 AM,48,-122,29,22,51
32484,ElliotBayTrailMyrtlePark,09/15/2017 12:00:00 PM,48,-122,33,39,72
32485,ElliotBayTrailMyrtlePark,09/15/2017 01:00:00 PM,48,-122,32,32,64
32486,ElliotBayTrailMyrtlePark,09/15/2017 02:00:00 PM,48,-122,45,34,79
32487,ElliotBayTrailMyrtlePark,09/15/2017 03:00:00 PM,48,-122,76,33,109
32488,ElliotBayTrailMyrtlePark,09/15/2017 04:00:00 PM,48,-122,137,75,212
32489,ElliotBayTrailMyrtlePark,09/15/2017 05:00:00 PM,48,-122,169,59,228
32490,ElliotBayTrailMyrtlePark,09/15/2017 06:00:00 PM,48,-122,98,43,141
32491,ElliotBayTrailMyrtlePark,09/15/2017 07:00:00 PM,48,-122,43,33,76
32492,ElliotBayTrailMyrtlePark,09/15/2017 08:00:00 PM,48,-122,10,7,17
32493,ElliotBayTrailMyrtlePark,09/15/2017 09:00:00 PM,48,-122,7,9,16
32494,ElliotBayTrailMyrtlePark,09/15/2017 10:00:00 PM,48,-122,16,9,25
32495,ElliotBayTrailMyrtlePark,09/15/2017 11:00:00 PM,48,-122,7,0,7
32496,ElliotBayTrailMyrtlePark,09/16/2017 12:00:00 AM,48,-122,9,4,13
32497,ElliotBayTrailMyrtlePark,09/16/2017 01:00:00 AM,48,-122,2,0,2
32498,ElliotBayTrailMyrtlePark,09/16/2017 02:00:00 AM,48,-122,2,3,5
32499,ElliotBayTrailMyrtlePark,09/16/2017 03:00:00 AM,48,-122,3,1,4
32500,ElliotBayTrailMyrtlePark,09/16/2017 04:00:00 AM,48,-122,0,0,0
32501,ElliotBayTrailMyrtlePark,09/16/2017 05:00:00 AM,48,-122,2,2,4
32502,ElliotBayTrailMyrtlePark,09/16/2017 06:00:00 AM,48,-122,3,7,10
32503,ElliotBayTrailMyrtlePark,09/16/2017 07:00:00 AM,48,-122,15,9,24
32504,ElliotBayTrailMyrtlePark,09/16/2017 08:00:00 AM,48,-122,19,22,41
32505,ElliotBayTrailMyrtlePark,09/16/2017 09:00:00 AM,48,-122,23,41,64
32506,ElliotBayTrailMyrtlePark,09/16/2017 10:00:00 AM,48,-122,37,26,63
32507,ElliotBayTrailMyrtlePark,09/16/2017 11:00:00 AM,48,-122,36,39,75
32508,ElliotBayTrailMyrtlePark,09/16/2017 12:00:00 PM,48,-122,47,38,85
32509,ElliotBayTrailMyrtlePark,09/16/2017 01:00:00 PM,48,-122,51,44,95
32510,ElliotBayTrailMyrtlePark,09/16/2017 02:00:00 PM,48,-122,61,50,111
32511,ElliotBayTrailMyrtlePark,09/16/2017 03:00:00 PM,48,-122,83,67,150
32512,ElliotBayTrailMyrtlePark,09/16/2017 04:00:00 PM,48,-122,53,48,101
32513,ElliotBayTrailMyrtlePark,09/16/2017 05:00:00 PM,48,-122,49,28,77
32514,ElliotBayTrailMyrtlePark,09/16/2017 06:00:00 PM,48,-122,26,35,61
32515,ElliotBayTrailMyrtlePark,09/16/2017 07:00:00 PM,48,-122,11,28,39
32516,ElliotBayTrailMyrtlePark,09/16/2017 08:00:00 PM,48,-122,10,7,17
32517,ElliotBayTrailMyrtlePark,09/16/2017 09:00:00 PM,48,-122,9,4,13
32518,ElliotBayTrailMyrtlePark,09/16/2017 10:00:00 PM,48,-122,5,4,9
32519,ElliotBayTrailMyrtlePark,09/16/2017 11:00:00 PM,48,-122,19,5,24
32520,ElliotBayTrailMyrtlePark,09/17/2017 12:00:00 AM,48,-122,0,4,4
32521,ElliotBayTrailMyrtlePark,09/17/2017 01:00:00 AM,48,-122,0,2,2
32522,ElliotBayTrailMyrtlePark,09/17/2017 02:00:00 AM,48,-122,2,1,3
32523,ElliotBayTrailMyrtlePark,09/17/2017 03:00:00 AM,48,-122,0,0,0
32524,ElliotBayTrailMyrtlePark,09/17/2017 04:00:00 AM,48,-122,0,1,1
32525,ElliotBayTrailMyrtlePark,09/17/2017 05:00:00 AM,48,-122,2,0,2
32526,ElliotBayTrailMyrtlePark,09/17/2017 06:00:00 AM,48,-122,2,5,7
32527,ElliotBayTrailMyrtlePark,09/17/2017 07:00:00 AM,48,-122,12,7,19
32528,ElliotBayTrailMyrtlePark,09/17/2017 08:00:00 AM,48,-122,25,21,46
32529,ElliotBayTrailMyrtlePark,09/17/2017 09:00:00 AM,48,-122,34,33,67
32530,ElliotBayTrailMyrtlePark,09/17/2017 10:00:00 AM,48,-122,27,46,73
32531,ElliotBayTrailMyrtlePark,09/17/2017 11:00:00 AM,48,-122,31,35,66
32532,ElliotBayTrailMyrtlePark,09/17/2017 12:00:00 PM,48,-122,43,46,89
32533,ElliotBayTrailMyrtlePark,09/17/2017 01:00:00 PM,48,-122,34,37,71
32534,ElliotBayTrailMyrtlePark,09/17/2017 02:00:00 PM,48,-122,27,10,37
32535,ElliotBayTrailMyrtlePark,09/17/2017 03:00:00 PM,48,-122,16,5,21
32536,ElliotBayTrailMyrtlePark,09/17/2017 04:00:00 PM,48,-122,15,11,26
32537,ElliotBayTrailMyrtlePark,09/17/2017 05:00:00 PM,48,-122,5,4,9
32538,ElliotBayTrailMyrtlePark,09/17/2017 06:00:00 PM,48,-122,6,6,12
32539,ElliotBayTrailMyrtlePark,09/17/2017 07:00:00 PM,48,-122,9,6,15
32540,ElliotBayTrailMyrtlePark,09/17/2017 08:00:00 PM,48,-122,5,4,9
32541,ElliotBayTrailMyrtlePark,09/17/2017 09:00:00 PM,48,-122,1,0,1
32542,ElliotBayTrailMyrtlePark,09/17/2017 10:00:00 PM,48,-122,4,0,4
32543,ElliotBayTrailMyrtlePark,09/17/2017 11:00:00 PM,48,-122,2,0,2
32544,ElliotBayTrailMyrtlePark,09/18/2017 12:00:00 AM,48,-122,3,2,5
32545,ElliotBayTrailMyrtlePark,09/18/2017 01:00:00 AM,48,-122,0,0,0
32546,ElliotBayTrailMyrtlePark,09/18/2017 02:00:00 AM,48,-122,1,0,1
32547,ElliotBayTrailMyrtlePark,09/18/2017 03:00:00 AM,48,-122,1,1,2
32548,ElliotBayTrailMyrtlePark,09/18/2017 04:00:00 AM,48,-122,5,3,8
32549,ElliotBayTrailMyrtlePark,09/18/2017 05:00:00 AM,48,-122,8,8,16
32550,ElliotBayTrailMyrtlePark,09/18/2017 06:00:00 AM,48,-122,17,23,40
32551,ElliotBayTrailMyrtlePark,09/18/2017 07:00:00 AM,48,-122,36,69,105
32552,ElliotBayTrailMyrtlePark,09/18/2017 08:00:00 AM,48,-122,35,120,155
32553,ElliotBayTrailMyrtlePark,09/18/2017 09:00:00 AM,48,-122,23,64,87
32554,ElliotBayTrailMyrtlePark,09/18/2017 10:00:00 AM,48,-122,18,19,37
32555,ElliotBayTrailMyrtlePark,09/18/2017 11:00:00 AM,48,-122,18,15,33
32556,ElliotBayTrailMyrtlePark,09/18/2017 12:00:00 PM,48,-122,25,24,49
32557,ElliotBayTrailMyrtlePark,09/18/2017 01:00:00 PM,48,-122,18,17,35
32558,ElliotBayTrailMyrtlePark,09/18/2017 02:00:00 PM,48,-122,21,18,39
32559,ElliotBayTrailMyrtlePark,09/18/2017 03:00:00 PM,48,-122,36,34,70
32560,ElliotBayTrailMyrtlePark,09/18/2017 04:00:00 PM,48,-122,58,31,89
32561,ElliotBayTrailMyrtlePark,09/18/2017 05:00:00 PM,48,-122,146,51,197
32562,ElliotBayTrailMyrtlePark,09/18/2017 06:00:00 PM,48,-122,81,17,98
32563,ElliotBayTrailMyrtlePark,09/18/2017 07:00:00 PM,48,-122,15,3,18
32564,ElliotBayTrailMyrtlePark,09/18/2017 08:00:00 PM,48,-122,5,3,8
32565,ElliotBayTrailMyrtlePark,09/18/2017 09:00:00 PM,48,-122,3,1,4
32566,ElliotBayTrailMyrtlePark,09/18/2017 10:00:00 PM,48,-122,1,2,3
32567,ElliotBayTrailMyrtlePark,09/18/2017 11:00:00 PM,48,-122,1,0,1
32568,ElliotBayTrailMyrtlePark,09/19/2017 12:00:00 AM,48,-122,1,0,1
32569,ElliotBayTrailMyrtlePark,09/19/2017 01:00:00 AM,48,-122,2,0,2
32570,ElliotBayTrailMyrtlePark,09/19/2017 02:00:00 AM,48,-122,0,0,0
32571,ElliotBayTrailMyrtlePark,09/19/2017 03:00:00 AM,48,-122,0,1,1
32572,ElliotBayTrailMyrtlePark,09/19/2017 04:00:00 AM,48,-122,2,3,5
32573,ElliotBayTrailMyrtlePark,09/19/2017 05:00:00 AM,48,-122,6,7,13
32574,ElliotBayTrailMyrtlePark,09/19/2017 06:00:00 AM,48,-122,17,27,44
32575,ElliotBayTrailMyrtlePark,09/19/2017 07:00:00 AM,48,-122,43,73,116
32576,ElliotBayTrailMyrtlePark,09/19/2017 08:00:00 AM,48,-122,25,114,139
32577,ElliotBayTrailMyrtlePark,09/19/2017 09:00:00 AM,48,-122,21,51,72
32578,ElliotBayTrailMyrtlePark,09/19/2017 10:00:00 AM,48,-122,12,16,28
32579,ElliotBayTrailMyrtlePark,09/19/2017 11:00:00 AM,48,-122,9,7,16
32580,ElliotBayTrailMyrtlePark,09/19/2017 12:00:00 PM,48,-122,14,12,26
32581,ElliotBayTrailMyrtlePark,09/19/2017 01:00:00 PM,48,-122,9,7,16
32582,ElliotBayTrailMyrtlePark,09/19/2017 02:00:00 PM,48,-122,7,12,19
32583,ElliotBayTrailMyrtlePark,09/19/2017 03:00:00 PM,48,-122,18,17,35
32584,ElliotBayTrailMyrtlePark,09/19/2017 04:00:00 PM,48,-122,53,32,85
32585,ElliotBayTrailMyrtlePark,09/19/2017 05:00:00 PM,48,-122,128,44,172
32586,ElliotBayTrailMyrtlePark,09/19/2017 06:00:00 PM,48,-122,73,14,87
32587,ElliotBayTrailMyrtlePark,09/19/2017 07:00:00 PM,48,-122,6,6,12
32588,ElliotBayTrailMyrtlePark,09/19/2017 08:00:00 PM,48,-122,11,0,11
32589,ElliotBayTrailMyrtlePark,09/19/2017 09:00:00 PM,48,-122,5,2,7
32590,ElliotBayTrailMyrtlePark,09/19/2017 10:00:00 PM,48,-122,3,0,3
32591,ElliotBayTrailMyrtlePark,09/19/2017 11:00:00 PM,48,-122,0,1,1
32592,ElliotBayTrailMyrtlePark,09/20/2017 12:00:00 AM,48,-122,1,3,4
32593,ElliotBayTrailMyrtlePark,09/20/2017 01:00:00 AM,48,-122,2,0,2
32594,ElliotBayTrailMyrtlePark,09/20/2017 02:00:00 AM,48,-122,0,0,0
32595,ElliotBayTrailMyrtlePark,09/20/2017 03:00:00 AM,48,-122,1,3,4
32596,ElliotBayTrailMyrtlePark,09/20/2017 04:00:00 AM,48,-122,1,1,2
32597,ElliotBayTrailMyrtlePark,09/20/2017 05:00:00 AM,48,-122,4,8,12
32598,ElliotBayTrailMyrtlePark,09/20/2017 06:00:00 AM,48,-122,20,22,42
32599,ElliotBayTrailMyrtlePark,09/20/2017 07:00:00 AM,48,-122,34,88,122
32600,ElliotBayTrailMyrtlePark,09/20/2017 08:00:00 AM,48,-122,31,144,175
32601,ElliotBayTrailMyrtlePark,09/20/2017 09:00:00 AM,48,-122,24,62,86
32602,ElliotBayTrailMyrtlePark,09/20/2017 10:00:00 AM,48,-122,6,29,35
32603,ElliotBayTrailMyrtlePark,09/20/2017 11:00:00 AM,48,-122,15,9,24
32604,ElliotBayTrailMyrtlePark,09/20/2017 12:00:00 PM,48,-122,15,15,30
32605,ElliotBayTrailMyrtlePark,09/20/2017 01:00:00 PM,48,-122,14,12,26
32606,ElliotBayTrailMyrtlePark,09/20/2017 02:00:00 PM,48,-122,23,21,44
32607,ElliotBayTrailMyrtlePark,09/20/2017 03:00:00 PM,48,-122,45,36,81
32608,ElliotBayTrailMyrtlePark,09/20/2017 04:00:00 PM,48,-122,70,44,114
32609,ElliotBayTrailMyrtlePark,09/20/2017 05:00:00 PM,48,-122,156,48,204
32610,ElliotBayTrailMyrtlePark,09/20/2017 06:00:00 PM,48,-122,101,42,143
32611,ElliotBayTrailMyrtlePark,09/20/2017 07:00:00 PM,48,-122,28,10,38
32612,ElliotBayTrailMyrtlePark,09/20/2017 08:00:00 PM,48,-122,7,5,12
32613,ElliotBayTrailMyrtlePark,09/20/2017 09:00:00 PM,48,-122,6,3,9
32614,ElliotBayTrailMyrtlePark,09/20/2017 10:00:00 PM,48,-122,2,1,3
32615,ElliotBayTrailMyrtlePark,09/20/2017 11:00:00 PM,48,-122,1,1,2
32616,ElliotBayTrailMyrtlePark,09/21/2017 12:00:00 AM,48,-122,2,1,3
32617,ElliotBayTrailMyrtlePark,09/21/2017 01:00:00 AM,48,-122,0,0,0
32618,ElliotBayTrailMyrtlePark,09/21/2017 02:00:00 AM,48,-122,1,1,2
32619,ElliotBayTrailMyrtlePark,09/21/2017 03:00:00 AM,48,-122,3,3,6
32620,ElliotBayTrailMyrtlePark,09/21/2017 04:00:00 AM,48,-122,0,2,2
32621,ElliotBayTrailMyrtlePark,09/21/2017 05:00:00 AM,48,-122,5,9,14
32622,ElliotBayTrailMyrtlePark,09/21/2017 06:00:00 AM,48,-122,25,38,63
32623,ElliotBayTrailMyrtlePark,09/21/2017 07:00:00 AM,48,-122,36,73,109
32624,ElliotBayTrailMyrtlePark,09/21/2017 08:00:00 AM,48,-122,33,119,152
32625,ElliotBayTrailMyrtlePark,09/21/2017 09:00:00 AM,48,-122,23,58,81
32626,ElliotBayTrailMyrtlePark,09/21/2017 10:00:00 AM,48,-122,15,13,28
32627,ElliotBayTrailMyrtlePark,09/21/2017 11:00:00 AM,48,-122,14,16,30
32628,ElliotBayTrailMyrtlePark,09/21/2017 12:00:00 PM,48,-122,10,10,20
32629,ElliotBayTrailMyrtlePark,09/21/2017 01:00:00 PM,48,-122,21,24,45
32630,ElliotBayTrailMyrtlePark,09/21/2017 02:00:00 PM,48,-122,23,23,46
32631,ElliotBayTrailMyrtlePark,09/21/2017 03:00:00 PM,48,-122,35,39,74
32632,ElliotBayTrailMyrtlePark,09/21/2017 04:00:00 PM,48,-122,73,53,126
32633,ElliotBayTrailMyrtlePark,09/21/2017 05:00:00 PM,48,-122,148,75,223
32634,ElliotBayTrailMyrtlePark,09/21/2017 06:00:00 PM,48,-122,93,44,137
32635,ElliotBayTrailMyrtlePark,09/21/2017 07:00:00 PM,48,-122,28,28,56
32636,ElliotBayTrailMyrtlePark,09/21/2017 08:00:00 PM,48,-122,17,1,18
32637,ElliotBayTrailMyrtlePark,09/21/2017 09:00:00 PM,48,-122,14,5,19
32638,ElliotBayTrailMyrtlePark,09/21/2017 10:00:00 PM,48,-122,8,4,12
32639,ElliotBayTrailMyrtlePark,09/21/2017 11:00:00 PM,48,-122,9,1,10
32640,ElliotBayTrailMyrtlePark,09/22/2017 12:00:00 AM,48,-122,3,1,4
32641,ElliotBayTrailMyrtlePark,09/22/2017 01:00:00 AM,48,-122,0,0,0
32642,ElliotBayTrailMyrtlePark,09/22/2017 02:00:00 AM,48,-122,1,0,1
32643,ElliotBayTrailMyrtlePark,09/22/2017 03:00:00 AM,48,-122,1,1,2
32644,ElliotBayTrailMyrtlePark,09/22/2017 04:00:00 AM,48,-122,1,2,3
32645,ElliotBayTrailMyrtlePark,09/22/2017 05:00:00 AM,48,-122,5,3,8
32646,ElliotBayTrailMyrtlePark,09/22/2017 06:00:00 AM,48,-122,19,33,52
32647,ElliotBayTrailMyrtlePark,09/22/2017 07:00:00 AM,48,-122,50,88,138
32648,ElliotBayTrailMyrtlePark,09/22/2017 08:00:00 AM,48,-122,39,135,174
32649,ElliotBayTrailMyrtlePark,09/22/2017 09:00:00 AM,48,-122,30,64,94
32650,ElliotBayTrailMyrtlePark,09/22/2017 10:00:00 AM,48,-122,13,35,48
32651,ElliotBayTrailMyrtlePark,09/22/2017 11:00:00 AM,48,-122,30,22,52
32652,ElliotBayTrailMyrtlePark,09/22/2017 12:00:00 PM,48,-122,35,39,74
32653,ElliotBayTrailMyrtlePark,09/22/2017 01:00:00 PM,48,-122,41,23,64
32654,ElliotBayTrailMyrtlePark,09/22/2017 02:00:00 PM,48,-122,54,42,96
32655,ElliotBayTrailMyrtlePark,09/22/2017 03:00:00 PM,48,-122,74,57,131
32656,ElliotBayTrailMyrtlePark,09/22/2017 04:00:00 PM,48,-122,139,70,209
32657,ElliotBayTrailMyrtlePark,09/22/2017 05:00:00 PM,48,-122,166,65,231
32658,ElliotBayTrailMyrtlePark,09/22/2017 06:00:00 PM,48,-122,83,44,127
32659,ElliotBayTrailMyrtlePark,09/22/2017 07:00:00 PM,48,-122,27,28,55
32660,ElliotBayTrailMyrtlePark,09/22/2017 08:00:00 PM,48,-122,12,6,18
32661,ElliotBayTrailMyrtlePark,09/22/2017 09:00:00 PM,48,-122,5,3,8
32662,ElliotBayTrailMyrtlePark,09/22/2017 10:00:00 PM,48,-122,7,1,8
32663,ElliotBayTrailMyrtlePark,09/22/2017 11:00:00 PM,48,-122,7,5,12
32664,ElliotBayTrailMyrtlePark,09/23/2017 12:00:00 AM,48,-122,4,0,4
32665,ElliotBayTrailMyrtlePark,09/23/2017 01:00:00 AM,48,-122,2,1,3
32666,ElliotBayTrailMyrtlePark,09/23/2017 02:00:00 AM,48,-122,1,0,1
32667,ElliotBayTrailMyrtlePark,09/23/2017 03:00:00 AM,48,-122,2,0,2
32668,ElliotBayTrailMyrtlePark,09/23/2017 04:00:00 AM,48,-122,0,0,0
32669,ElliotBayTrailMyrtlePark,09/23/2017 05:00:00 AM,48,-122,1,1,2
32670,ElliotBayTrailMyrtlePark,09/23/2017 06:00:00 AM,48,-122,3,2,5
32671,ElliotBayTrailMyrtlePark,09/23/2017 07:00:00 AM,48,-122,11,7,18
32672,ElliotBayTrailMyrtlePark,09/23/2017 08:00:00 AM,48,-122,16,20,36
32673,ElliotBayTrailMyrtlePark,09/23/2017 09:00:00 AM,48,-122,23,19,42
32674,ElliotBayTrailMyrtlePark,09/23/2017 10:00:00 AM,48,-122,38,52,90
32675,ElliotBayTrailMyrtlePark,09/23/2017 11:00:00 AM,48,-122,38,43,81
32676,ElliotBayTrailMyrtlePark,09/23/2017 12:00:00 PM,48,-122,50,58,108
32677,ElliotBayTrailMyrtlePark,09/23/2017 01:00:00 PM,48,-122,69,75,144
32678,ElliotBayTrailMyrtlePark,09/23/2017 02:00:00 PM,48,-122,68,70,138
32679,ElliotBayTrailMyrtlePark,09/23/2017 03:00:00 PM,48,-122,58,65,123
32680,ElliotBayTrailMyrtlePark,09/23/2017 04:00:00 PM,48,-122,62,41,103
32681,ElliotBayTrailMyrtlePark,09/23/2017 05:00:00 PM,48,-122,62,53,115
32682,ElliotBayTrailMyrtlePark,09/23/2017 06:00:00 PM,48,-122,40,42,82
32683,ElliotBayTrailMyrtlePark,09/23/2017 07:00:00 PM,48,-122,20,19,39
32684,ElliotBayTrailMyrtlePark,09/23/2017 08:00:00 PM,48,-122,7,12,19
32685,ElliotBayTrailMyrtlePark,09/23/2017 09:00:00 PM,48,-122,8,6,14
32686,ElliotBayTrailMyrtlePark,09/23/2017 10:00:00 PM,48,-122,2,2,4
32687,ElliotBayTrailMyrtlePark,09/23/2017 11:00:00 PM,48,-122,13,0,13
32688,ElliotBayTrailMyrtlePark,09/24/2017 12:00:00 AM,48,-122,3,2,5
32689,ElliotBayTrailMyrtlePark,09/24/2017 01:00:00 AM,48,-122,1,3,4
32690,ElliotBayTrailMyrtlePark,09/24/2017 02:00:00 AM,48,-122,0,1,1
32691,ElliotBayTrailMyrtlePark,09/24/2017 03:00:00 AM,48,-122,0,1,1
32692,ElliotBayTrailMyrtlePark,09/24/2017 04:00:00 AM,48,-122,1,0,1
32693,ElliotBayTrailMyrtlePark,09/24/2017 05:00:00 AM,48,-122,1,1,2
32694,ElliotBayTrailMyrtlePark,09/24/2017 06:00:00 AM,48,-122,4,4,8
32695,ElliotBayTrailMyrtlePark,09/24/2017 07:00:00 AM,48,-122,7,9,16
32696,ElliotBayTrailMyrtlePark,09/24/2017 08:00:00 AM,48,-122,15,8,23
32697,ElliotBayTrailMyrtlePark,09/24/2017 09:00:00 AM,48,-122,32,36,68
32698,ElliotBayTrailMyrtlePark,09/24/2017 10:00:00 AM,48,-122,31,29,60
32699,ElliotBayTrailMyrtlePark,09/24/2017 11:00:00 AM,48,-122,51,47,98
32700,ElliotBayTrailMyrtlePark,09/24/2017 12:00:00 PM,48,-122,48,66,114
32701,ElliotBayTrailMyrtlePark,09/24/2017 01:00:00 PM,48,-122,52,49,101
32702,ElliotBayTrailMyrtlePark,09/24/2017 02:00:00 PM,48,-122,49,68,117
32703,ElliotBayTrailMyrtlePark,09/24/2017 03:00:00 PM,48,-122,66,57,123
32704,ElliotBayTrailMyrtlePark,09/24/2017 04:00:00 PM,48,-122,72,55,127
32705,ElliotBayTrailMyrtlePark,09/24/2017 05:00:00 PM,48,-122,79,47,126
32706,ElliotBayTrailMyrtlePark,09/24/2017 06:00:00 PM,48,-122,44,58,102
32707,ElliotBayTrailMyrtlePark,09/24/2017 07:00:00 PM,48,-122,22,19,41
32708,ElliotBayTrailMyrtlePark,09/24/2017 08:00:00 PM,48,-122,8,3,11
32709,ElliotBayTrailMyrtlePark,09/24/2017 09:00:00 PM,48,-122,2,9,11
32710,ElliotBayTrailMyrtlePark,09/24/2017 10:00:00 PM,48,-122,2,3,5
32711,ElliotBayTrailMyrtlePark,09/24/2017 11:00:00 PM,48,-122,1,1,2
32712,ElliotBayTrailMyrtlePark,09/25/2017 12:00:00 AM,48,-122,0,1,1
32713,ElliotBayTrailMyrtlePark,09/25/2017 01:00:00 AM,48,-122,1,0,1
32714,ElliotBayTrailMyrtlePark,09/25/2017 02:00:00 AM,48,-122,0,0,0
32715,ElliotBayTrailMyrtlePark,09/25/2017 03:00:00 AM,48,-122,0,1,1
32716,ElliotBayTrailMyrtlePark,09/25/2017 04:00:00 AM,48,-122,2,0,2
32717,ElliotBayTrailMyrtlePark,09/25/2017 05:00:00 AM,48,-122,4,13,17
32718,ElliotBayTrailMyrtlePark,09/25/2017 06:00:00 AM,48,-122,17,25,42
32719,ElliotBayTrailMyrtlePark,09/25/2017 07:00:00 AM,48,-122,35,77,112
32720,ElliotBayTrailMyrtlePark,09/25/2017 08:00:00 AM,48,-122,41,140,181
32721,ElliotBayTrailMyrtlePark,09/25/2017 09:00:00 AM,48,-122,23,69,92
32722,ElliotBayTrailMyrtlePark,09/25/2017 10:00:00 AM,48,-122,9,21,30
32723,ElliotBayTrailMyrtlePark,09/25/2017 11:00:00 AM,48,-122,13,16,29
32724,ElliotBayTrailMyrtlePark,09/25/2017 12:00:00 PM,48,-122,22,12,34
32725,ElliotBayTrailMyrtlePark,09/25/2017 01:00:00 PM,48,-122,10,12,22
32726,ElliotBayTrailMyrtlePark,09/25/2017 02:00:00 PM,48,-122,24,11,35
32727,ElliotBayTrailMyrtlePark,09/25/2017 03:00:00 PM,48,-122,32,20,52
32728,ElliotBayTrailMyrtlePark,09/25/2017 04:00:00 PM,48,-122,72,52,124
32729,ElliotBayTrailMyrtlePark,09/25/2017 05:00:00 PM,48,-122,156,65,221
32730,ElliotBayTrailMyrtlePark,09/25/2017 06:00:00 PM,48,-122,95,34,129
32731,ElliotBayTrailMyrtlePark,09/25/2017 07:00:00 PM,48,-122,25,19,44
32732,ElliotBayTrailMyrtlePark,09/25/2017 08:00:00 PM,48,-122,11,4,15
32733,ElliotBayTrailMyrtlePark,09/25/2017 09:00:00 PM,48,-122,2,7,9
32734,ElliotBayTrailMyrtlePark,09/25/2017 10:00:00 PM,48,-122,4,2,6
32735,ElliotBayTrailMyrtlePark,09/25/2017 11:00:00 PM,48,-122,2,2,4
32736,ElliotBayTrailMyrtlePark,09/26/2017 12:00:00 AM,48,-122,1,1,2
32737,ElliotBayTrailMyrtlePark,09/26/2017 01:00:00 AM,48,-122,3,1,4
32738,ElliotBayTrailMyrtlePark,09/26/2017 02:00:00 AM,48,-122,2,0,2
32739,ElliotBayTrailMyrtlePark,09/26/2017 03:00:00 AM,48,-122,1,1,2
32740,ElliotBayTrailMyrtlePark,09/26/2017 04:00:00 AM,48,-122,1,2,3
32741,ElliotBayTrailMyrtlePark,09/26/2017 05:00:00 AM,48,-122,6,10,16
32742,ElliotBayTrailMyrtlePark,09/26/2017 06:00:00 AM,48,-122,24,33,57
32743,ElliotBayTrailMyrtlePark,09/26/2017 07:00:00 AM,48,-122,44,118,162
32744,ElliotBayTrailMyrtlePark,09/26/2017 08:00:00 AM,48,-122,48,192,240
32745,ElliotBayTrailMyrtlePark,09/26/2017 09:00:00 AM,48,-122,29,79,108
32746,ElliotBayTrailMyrtlePark,09/26/2017 10:00:00 AM,48,-122,16,22,38
32747,ElliotBayTrailMyrtlePark,09/26/2017 11:00:00 AM,48,-122,24,18,42
32748,ElliotBayTrailMyrtlePark,09/26/2017 12:00:00 PM,48,-122,22,33,55
32749,ElliotBayTrailMyrtlePark,09/26/2017 01:00:00 PM,48,-122,24,25,49
32750,ElliotBayTrailMyrtlePark,09/26/2017 02:00:00 PM,48,-122,39,24,63
32751,ElliotBayTrailMyrtlePark,09/26/2017 03:00:00 PM,48,-122,71,44,115
32752,ElliotBayTrailMyrtlePark,09/26/2017 04:00:00 PM,48,-122,125,55,180
32753,ElliotBayTrailMyrtlePark,09/26/2017 05:00:00 PM,48,-122,212,112,324
32754,ElliotBayTrailMyrtlePark,09/26/2017 06:00:00 PM,48,-122,140,63,203
32755,ElliotBayTrailMyrtlePark,09/26/2017 07:00:00 PM,48,-122,33,26,59
32756,ElliotBayTrailMyrtlePark,09/26/2017 08:00:00 PM,48,-122,17,9,26
32757,ElliotBayTrailMyrtlePark,09/26/2017 09:00:00 PM,48,-122,7,6,13
32758,ElliotBayTrailMyrtlePark,09/26/2017 10:00:00 PM,48,-122,9,3,12
32759,ElliotBayTrailMyrtlePark,09/26/2017 11:00:00 PM,48,-122,3,2,5
32760,ElliotBayTrailMyrtlePark,09/27/2017 12:00:00 AM,48,-122,1,1,2
32761,ElliotBayTrailMyrtlePark,09/27/2017 01:00:00 AM,48,-122,2,0,2
32762,ElliotBayTrailMyrtlePark,09/27/2017 02:00:00 AM,48,-122,0,0,0
32763,ElliotBayTrailMyrtlePark,09/27/2017 03:00:00 AM,48,-122,0,1,1
32764,ElliotBayTrailMyrtlePark,09/27/2017 04:00:00 AM,48,-122,2,1,3
32765,ElliotBayTrailMyrtlePark,09/27/2017 05:00:00 AM,48,-122,4,12,16
32766,ElliotBayTrailMyrtlePark,09/27/2017 06:00:00 AM,48,-122,27,33,60
32767,ElliotBayTrailMyrtlePark,09/27/2017 07:00:00 AM,48,-122,54,87,141
32768,ElliotBayTrailMyrtlePark,09/27/2017 08:00:00 AM,48,-122,46,183,229
32769,ElliotBayTrailMyrtlePark,09/27/2017 09:00:00 AM,48,-122,31,71,102
32770,ElliotBayTrailMyrtlePark,09/27/2017 10:00:00 AM,48,-122,20,49,69
32771,ElliotBayTrailMyrtlePark,09/27/2017 11:00:00 AM,48,-122,30,33,63
32772,ElliotBayTrailMyrtlePark,09/27/2017 12:00:00 PM,48,-122,29,30,59
32773,ElliotBayTrailMyrtlePark,09/27/2017 01:00:00 PM,48,-122,39,35,74
32774,ElliotBayTrailMyrtlePark,09/27/2017 02:00:00 PM,48,-122,29,34,63
32775,ElliotBayTrailMyrtlePark,09/27/2017 03:00:00 PM,48,-122,50,70,120
32776,ElliotBayTrailMyrtlePark,09/27/2017 04:00:00 PM,48,-122,120,77,197
32777,ElliotBayTrailMyrtlePark,09/27/2017 05:00:00 PM,48,-122,216,89,305
32778,ElliotBayTrailMyrtlePark,09/27/2017 06:00:00 PM,48,-122,131,80,211
32779,ElliotBayTrailMyrtlePark,09/27/2017 07:00:00 PM,48,-122,40,40,80
32780,ElliotBayTrailMyrtlePark,09/27/2017 08:00:00 PM,48,-122,14,6,20
32781,ElliotBayTrailMyrtlePark,09/27/2017 09:00:00 PM,48,-122,36,7,43
32782,ElliotBayTrailMyrtlePark,09/27/2017 10:00:00 PM,48,-122,29,3,32
32783,ElliotBayTrailMyrtlePark,09/27/2017 11:00:00 PM,48,-122,11,2,13
32784,ElliotBayTrailMyrtlePark,09/28/2017 12:00:00 AM,48,-122,2,2,4
32785,ElliotBayTrailMyrtlePark,09/28/2017 01:00:00 AM,48,-122,1,1,2
32786,ElliotBayTrailMyrtlePark,09/28/2017 02:00:00 AM,48,-122,2,0,2
32787,ElliotBayTrailMyrtlePark,09/28/2017 03:00:00 AM,48,-122,1,0,1
32788,ElliotBayTrailMyrtlePark,09/28/2017 04:00:00 AM,48,-122,1,1,2
32789,ElliotBayTrailMyrtlePark,09/28/2017 05:00:00 AM,48,-122,3,12,15
32790,ElliotBayTrailMyrtlePark,09/28/2017 06:00:00 AM,48,-122,31,33,64
32791,ElliotBayTrailMyrtlePark,09/28/2017 07:00:00 AM,48,-122,53,121,174
32792,ElliotBayTrailMyrtlePark,09/28/2017 08:00:00 AM,48,-122,51,160,211
32793,ElliotBayTrailMyrtlePark,09/28/2017 09:00:00 AM,48,-122,31,59,90
32794,ElliotBayTrailMyrtlePark,09/28/2017 10:00:00 AM,48,-122,28,39,67
32795,ElliotBayTrailMyrtlePark,09/28/2017 11:00:00 AM,48,-122,35,29,64
32796,ElliotBayTrailMyrtlePark,09/28/2017 12:00:00 PM,48,-122,39,44,83
32797,ElliotBayTrailMyrtlePark,09/28/2017 01:00:00 PM,48,-122,47,43,90
32798,ElliotBayTrailMyrtlePark,09/28/2017 02:00:00 PM,48,-122,67,46,113
32799,ElliotBayTrailMyrtlePark,09/28/2017 03:00:00 PM,48,-122,73,66,139
32800,ElliotBayTrailMyrtlePark,09/28/2017 04:00:00 PM,48,-122,148,80,228
32801,ElliotBayTrailMyrtlePark,09/28/2017 05:00:00 PM,48,-122,211,89,300
32802,ElliotBayTrailMyrtlePark,09/28/2017 06:00:00 PM,48,-122,140,68,208
32803,ElliotBayTrailMyrtlePark,09/28/2017 07:00:00 PM,48,-122,97,51,148
32804,ElliotBayTrailMyrtlePark,09/28/2017 08:00:00 PM,48,-122,15,11,26
32805,ElliotBayTrailMyrtlePark,09/28/2017 09:00:00 PM,48,-122,18,8,26
32806,ElliotBayTrailMyrtlePark,09/28/2017 10:00:00 PM,48,-122,3,3,6
32807,ElliotBayTrailMyrtlePark,09/28/2017 11:00:00 PM,48,-122,1,5,6
32808,ElliotBayTrailMyrtlePark,09/29/2017 12:00:00 AM,48,-122,2,9,11
32809,ElliotBayTrailMyrtlePark,09/29/2017 01:00:00 AM,48,-122,1,4,5
32810,ElliotBayTrailMyrtlePark,09/29/2017 02:00:00 AM,48,-122,1,0,1
32811,ElliotBayTrailMyrtlePark,09/29/2017 03:00:00 AM,48,-122,0,1,1
32812,ElliotBayTrailMyrtlePark,09/29/2017 04:00:00 AM,48,-122,1,2,3
32813,ElliotBayTrailMyrtlePark,09/29/2017 05:00:00 AM,48,-122,6,11,17
32814,ElliotBayTrailMyrtlePark,09/29/2017 06:00:00 AM,48,-122,14,21,35
32815,ElliotBayTrailMyrtlePark,09/29/2017 07:00:00 AM,48,-122,32,58,90
32816,ElliotBayTrailMyrtlePark,09/29/2017 08:00:00 AM,48,-122,29,100,129
32817,ElliotBayTrailMyrtlePark,09/29/2017 09:00:00 AM,48,-122,15,30,45
32818,ElliotBayTrailMyrtlePark,09/29/2017 10:00:00 AM,48,-122,5,16,21
32819,ElliotBayTrailMyrtlePark,09/29/2017 11:00:00 AM,48,-122,10,9,19
32820,ElliotBayTrailMyrtlePark,09/29/2017 12:00:00 PM,48,-122,15,14,29
32821,ElliotBayTrailMyrtlePark,09/29/2017 01:00:00 PM,48,-122,9,8,17
32822,ElliotBayTrailMyrtlePark,09/29/2017 02:00:00 PM,48,-122,19,16,35
32823,ElliotBayTrailMyrtlePark,09/29/2017 03:00:00 PM,48,-122,39,25,64
32824,ElliotBayTrailMyrtlePark,09/29/2017 04:00:00 PM,48,-122,81,69,150
32825,ElliotBayTrailMyrtlePark,09/29/2017 05:00:00 PM,48,-122,121,61,182
32826,ElliotBayTrailMyrtlePark,09/29/2017 06:00:00 PM,48,-122,57,33,90
32827,ElliotBayTrailMyrtlePark,09/29/2017 07:00:00 PM,48,-122,26,18,44
32828,ElliotBayTrailMyrtlePark,09/29/2017 08:00:00 PM,48,-122,6,5,11
32829,ElliotBayTrailMyrtlePark,09/29/2017 09:00:00 PM,48,-122,2,6,8
32830,ElliotBayTrailMyrtlePark,09/29/2017 10:00:00 PM,48,-122,4,0,4
32831,ElliotBayTrailMyrtlePark,09/29/2017 11:00:00 PM,48,-122,3,1,4
32832,ElliotBayTrailMyrtlePark,09/30/2017 12:00:00 AM,48,-122,6,2,8
32833,ElliotBayTrailMyrtlePark,09/30/2017 01:00:00 AM,48,-122,2,0,2
32834,ElliotBayTrailMyrtlePark,09/30/2017 02:00:00 AM,48,-122,2,0,2
32835,ElliotBayTrailMyrtlePark,09/30/2017 03:00:00 AM,48,-122,0,0,0
32836,ElliotBayTrailMyrtlePark,09/30/2017 04:00:00 AM,48,-122,0,0,0
32837,ElliotBayTrailMyrtlePark,09/30/2017 05:00:00 AM,48,-122,0,0,0
32838,ElliotBayTrailMyrtlePark,09/30/2017 06:00:00 AM,48,-122,2,3,5
32839,ElliotBayTrailMyrtlePark,09/30/2017 07:00:00 AM,48,-122,11,6,17
32840,ElliotBayTrailMyrtlePark,09/30/2017 08:00:00 AM,48,-122,6,13,19
32841,ElliotBayTrailMyrtlePark,09/30/2017 09:00:00 AM,48,-122,18,17,35
32842,ElliotBayTrailMyrtlePark,09/30/2017 10:00:00 AM,48,-122,22,22,44
32843,ElliotBayTrailMyrtlePark,09/30/2017 11:00:00 AM,48,-122,43,37,80
32844,ElliotBayTrailMyrtlePark,09/30/2017 12:00:00 PM,48,-122,34,38,72
32845,ElliotBayTrailMyrtlePark,09/30/2017 01:00:00 PM,48,-122,42,47,89
32846,ElliotBayTrailMyrtlePark,09/30/2017 02:00:00 PM,48,-122,53,37,90
32847,ElliotBayTrailMyrtlePark,09/30/2017 03:00:00 PM,48,-122,34,33,67
32848,ElliotBayTrailMyrtlePark,09/30/2017 04:00:00 PM,48,-122,26,19,45
32849,ElliotBayTrailMyrtlePark,09/30/2017 05:00:00 PM,48,-122,25,16,41
32850,ElliotBayTrailMyrtlePark,09/30/2017 06:00:00 PM,48,-122,14,18,32
32851,ElliotBayTrailMyrtlePark,09/30/2017 07:00:00 PM,48,-122,9,10,19
32852,ElliotBayTrailMyrtlePark,09/30/2017 08:00:00 PM,48,-122,4,3,7
32853,ElliotBayTrailMyrtlePark,09/30/2017 09:00:00 PM,48,-122,2,4,6
32854,ElliotBayTrailMyrtlePark,09/30/2017 10:00:00 PM,48,-122,3,7,10
32855,ElliotBayTrailMyrtlePark,09/30/2017 11:00:00 PM,48,-122,6,4,10
32856,ElliotBayTrailMyrtlePark,10/01/2017 12:00:00 AM,48,-122,13,0,13
32857,ElliotBayTrailMyrtlePark,10/01/2017 01:00:00 AM,48,-122,3,0,3
32858,ElliotBayTrailMyrtlePark,10/01/2017 02:00:00 AM,48,-122,0,0,0
32859,ElliotBayTrailMyrtlePark,10/01/2017 03:00:00 AM,48,-122,0,1,1
32860,ElliotBayTrailMyrtlePark,10/01/2017 04:00:00 AM,48,-122,3,0,3
32861,ElliotBayTrailMyrtlePark,10/01/2017 05:00:00 AM,48,-122,0,1,1
32862,ElliotBayTrailMyrtlePark,10/01/2017 06:00:00 AM,48,-122,2,3,5
32863,ElliotBayTrailMyrtlePark,10/01/2017 07:00:00 AM,48,-122,3,3,6
32864,ElliotBayTrailMyrtlePark,10/01/2017 08:00:00 AM,48,-122,15,6,21
32865,ElliotBayTrailMyrtlePark,10/01/2017 09:00:00 AM,48,-122,12,12,24
32866,ElliotBayTrailMyrtlePark,10/01/2017 10:00:00 AM,48,-122,25,26,51
32867,ElliotBayTrailMyrtlePark,10/01/2017 11:00:00 AM,48,-122,28,50,78
32868,ElliotBayTrailMyrtlePark,10/01/2017 12:00:00 PM,48,-122,31,36,67
32869,ElliotBayTrailMyrtlePark,10/01/2017 01:00:00 PM,48,-122,56,43,99
32870,ElliotBayTrailMyrtlePark,10/01/2017 02:00:00 PM,48,-122,54,37,91
32871,ElliotBayTrailMyrtlePark,10/01/2017 03:00:00 PM,48,-122,39,46,85
32872,ElliotBayTrailMyrtlePark,10/01/2017 04:00:00 PM,48,-122,29,33,62
32873,ElliotBayTrailMyrtlePark,10/01/2017 05:00:00 PM,48,-122,29,37,66
32874,ElliotBayTrailMyrtlePark,10/01/2017 06:00:00 PM,48,-122,14,24,38
32875,ElliotBayTrailMyrtlePark,10/01/2017 07:00:00 PM,48,-122,28,8,36
32876,ElliotBayTrailMyrtlePark,10/01/2017 08:00:00 PM,48,-122,8,5,13
32877,ElliotBayTrailMyrtlePark,10/01/2017 09:00:00 PM,48,-122,15,1,16
32878,ElliotBayTrailMyrtlePark,10/01/2017 10:00:00 PM,48,-122,7,1,8
32879,ElliotBayTrailMyrtlePark,10/01/2017 11:00:00 PM,48,-122,2,1,3
32880,ElliotBayTrailMyrtlePark,10/02/2017 12:00:00 AM,48,-122,0,0,0
32881,ElliotBayTrailMyrtlePark,10/02/2017 01:00:00 AM,48,-122,1,0,1
32882,ElliotBayTrailMyrtlePark,10/02/2017 02:00:00 AM,48,-122,1,0,1
32883,ElliotBayTrailMyrtlePark,10/02/2017 03:00:00 AM,48,-122,1,1,2
32884,ElliotBayTrailMyrtlePark,10/02/2017 04:00:00 AM,48,-122,4,2,6
32885,ElliotBayTrailMyrtlePark,10/02/2017 05:00:00 AM,48,-122,6,11,17
32886,ElliotBayTrailMyrtlePark,10/02/2017 06:00:00 AM,48,-122,18,29,47
32887,ElliotBayTrailMyrtlePark,10/02/2017 07:00:00 AM,48,-122,43,94,137
32888,ElliotBayTrailMyrtlePark,10/02/2017 08:00:00 AM,48,-122,32,177,209
32889,ElliotBayTrailMyrtlePark,10/02/2017 09:00:00 AM,48,-122,28,64,92
32890,ElliotBayTrailMyrtlePark,10/02/2017 10:00:00 AM,48,-122,22,28,50
32891,ElliotBayTrailMyrtlePark,10/02/2017 11:00:00 AM,48,-122,11,17,28
32892,ElliotBayTrailMyrtlePark,10/02/2017 12:00:00 PM,48,-122,22,25,47
32893,ElliotBayTrailMyrtlePark,10/02/2017 01:00:00 PM,48,-122,18,15,33
32894,ElliotBayTrailMyrtlePark,10/02/2017 02:00:00 PM,48,-122,20,28,48
32895,ElliotBayTrailMyrtlePark,10/02/2017 03:00:00 PM,48,-122,39,27,66
32896,ElliotBayTrailMyrtlePark,10/02/2017 04:00:00 PM,48,-122,84,57,141
32897,ElliotBayTrailMyrtlePark,10/02/2017 05:00:00 PM,48,-122,225,91,316
32898,ElliotBayTrailMyrtlePark,10/02/2017 06:00:00 PM,48,-122,109,33,142
32899,ElliotBayTrailMyrtlePark,10/02/2017 07:00:00 PM,48,-122,33,17,50
32900,ElliotBayTrailMyrtlePark,10/02/2017 08:00:00 PM,48,-122,10,4,14
32901,ElliotBayTrailMyrtlePark,10/02/2017 09:00:00 PM,48,-122,8,6,14
32902,ElliotBayTrailMyrtlePark,10/02/2017 10:00:00 PM,48,-122,9,4,13
32903,ElliotBayTrailMyrtlePark,10/02/2017 11:00:00 PM,48,-122,5,6,11
32904,ElliotBayTrailMyrtlePark,10/03/2017 12:00:00 AM,48,-122,3,2,5
32905,ElliotBayTrailMyrtlePark,10/03/2017 01:00:00 AM,48,-122,2,1,3
32906,ElliotBayTrailMyrtlePark,10/03/2017 02:00:00 AM,48,-122,1,0,1
32907,ElliotBayTrailMyrtlePark,10/03/2017 03:00:00 AM,48,-122,1,2,3
32908,ElliotBayTrailMyrtlePark,10/03/2017 04:00:00 AM,48,-122,1,1,2
32909,ElliotBayTrailMyrtlePark,10/03/2017 05:00:00 AM,48,-122,3,14,17
32910,ElliotBayTrailMyrtlePark,10/03/2017 06:00:00 AM,48,-122,34,30,64
32911,ElliotBayTrailMyrtlePark,10/03/2017 07:00:00 AM,48,-122,57,106,163
32912,ElliotBayTrailMyrtlePark,10/03/2017 08:00:00 AM,48,-122,51,151,202
32913,ElliotBayTrailMyrtlePark,10/03/2017 09:00:00 AM,48,-122,30,63,93
32914,ElliotBayTrailMyrtlePark,10/03/2017 10:00:00 AM,48,-122,12,18,30
32915,ElliotBayTrailMyrtlePark,10/03/2017 11:00:00 AM,48,-122,20,20,40
32916,ElliotBayTrailMyrtlePark,10/03/2017 12:00:00 PM,48,-122,20,33,53
32917,ElliotBayTrailMyrtlePark,10/03/2017 01:00:00 PM,48,-122,26,19,45
32918,ElliotBayTrailMyrtlePark,10/03/2017 02:00:00 PM,48,-122,34,45,79
32919,ElliotBayTrailMyrtlePark,10/03/2017 03:00:00 PM,48,-122,53,48,101
32920,ElliotBayTrailMyrtlePark,10/03/2017 04:00:00 PM,48,-122,118,69,187
32921,ElliotBayTrailMyrtlePark,10/03/2017 05:00:00 PM,48,-122,190,97,287
32922,ElliotBayTrailMyrtlePark,10/03/2017 06:00:00 PM,48,-122,127,39,166
32923,ElliotBayTrailMyrtlePark,10/03/2017 07:00:00 PM,48,-122,28,17,45
32924,ElliotBayTrailMyrtlePark,10/03/2017 08:00:00 PM,48,-122,9,3,12
32925,ElliotBayTrailMyrtlePark,10/03/2017 09:00:00 PM,48,-122,8,6,14
32926,ElliotBayTrailMyrtlePark,10/03/2017 10:00:00 PM,48,-122,6,2,8
32927,ElliotBayTrailMyrtlePark,10/03/2017 11:00:00 PM,48,-122,2,3,5
32928,ElliotBayTrailMyrtlePark,10/04/2017 12:00:00 AM,48,-122,2,1,3
32929,ElliotBayTrailMyrtlePark,10/04/2017 01:00:00 AM,48,-122,2,2,4
32930,ElliotBayTrailMyrtlePark,10/04/2017 02:00:00 AM,48,-122,2,0,2
32931,ElliotBayTrailMyrtlePark,10/04/2017 03:00:00 AM,48,-122,0,1,1
32932,ElliotBayTrailMyrtlePark,10/04/2017 04:00:00 AM,48,-122,0,2,2
32933,ElliotBayTrailMyrtlePark,10/04/2017 05:00:00 AM,48,-122,7,15,22
32934,ElliotBayTrailMyrtlePark,10/04/2017 06:00:00 AM,48,-122,29,22,51
32935,ElliotBayTrailMyrtlePark,10/04/2017 07:00:00 AM,48,-122,62,118,180
32936,ElliotBayTrailMyrtlePark,10/04/2017 08:00:00 AM,48,-122,51,168,219
32937,ElliotBayTrailMyrtlePark,10/04/2017 09:00:00 AM,48,-122,37,72,109
32938,ElliotBayTrailMyrtlePark,10/04/2017 10:00:00 AM,48,-122,17,32,49
32939,ElliotBayTrailMyrtlePark,10/04/2017 11:00:00 AM,48,-122,21,14,35
32940,ElliotBayTrailMyrtlePark,10/04/2017 12:00:00 PM,48,-122,18,14,32
32941,ElliotBayTrailMyrtlePark,10/04/2017 01:00:00 PM,48,-122,30,20,50
32942,ElliotBayTrailMyrtlePark,10/04/2017 02:00:00 PM,48,-122,49,32,81
32943,ElliotBayTrailMyrtlePark,10/04/2017 03:00:00 PM,48,-122,53,40,93
32944,ElliotBayTrailMyrtlePark,10/04/2017 04:00:00 PM,48,-122,108,76,184
32945,ElliotBayTrailMyrtlePark,10/04/2017 05:00:00 PM,48,-122,197,91,288
32946,ElliotBayTrailMyrtlePark,10/04/2017 06:00:00 PM,48,-122,110,58,168
32947,ElliotBayTrailMyrtlePark,10/04/2017 07:00:00 PM,48,-122,26,18,44
32948,ElliotBayTrailMyrtlePark,10/04/2017 08:00:00 PM,48,-122,9,7,16
32949,ElliotBayTrailMyrtlePark,10/04/2017 09:00:00 PM,48,-122,9,6,15
32950,ElliotBayTrailMyrtlePark,10/04/2017 10:00:00 PM,48,-122,3,2,5
32951,ElliotBayTrailMyrtlePark,10/04/2017 11:00:00 PM,48,-122,7,4,11
32952,ElliotBayTrailMyrtlePark,10/05/2017 12:00:00 AM,48,-122,6,5,11
32953,ElliotBayTrailMyrtlePark,10/05/2017 01:00:00 AM,48,-122,0,0,0
32954,ElliotBayTrailMyrtlePark,10/05/2017 02:00:00 AM,48,-122,0,0,0
32955,ElliotBayTrailMyrtlePark,10/05/2017 03:00:00 AM,48,-122,1,2,3
32956,ElliotBayTrailMyrtlePark,10/05/2017 04:00:00 AM,48,-122,1,1,2
32957,ElliotBayTrailMyrtlePark,10/05/2017 05:00:00 AM,48,-122,3,12,15
32958,ElliotBayTrailMyrtlePark,10/05/2017 06:00:00 AM,48,-122,30,29,59
32959,ElliotBayTrailMyrtlePark,10/05/2017 07:00:00 AM,48,-122,52,89,141
32960,ElliotBayTrailMyrtlePark,10/05/2017 08:00:00 AM,48,-122,48,164,212
32961,ElliotBayTrailMyrtlePark,10/05/2017 09:00:00 AM,48,-122,18,76,94
32962,ElliotBayTrailMyrtlePark,10/05/2017 10:00:00 AM,48,-122,20,30,50
32963,ElliotBayTrailMyrtlePark,10/05/2017 11:00:00 AM,48,-122,13,16,29
32964,ElliotBayTrailMyrtlePark,10/05/2017 12:00:00 PM,48,-122,21,22,43
32965,ElliotBayTrailMyrtlePark,10/05/2017 01:00:00 PM,48,-122,18,22,40
32966,ElliotBayTrailMyrtlePark,10/05/2017 02:00:00 PM,48,-122,39,27,66
32967,ElliotBayTrailMyrtlePark,10/05/2017 03:00:00 PM,48,-122,48,43,91
32968,ElliotBayTrailMyrtlePark,10/05/2017 04:00:00 PM,48,-122,119,56,175
32969,ElliotBayTrailMyrtlePark,10/05/2017 05:00:00 PM,48,-122,195,81,276
32970,ElliotBayTrailMyrtlePark,10/05/2017 06:00:00 PM,48,-122,105,40,145
32971,ElliotBayTrailMyrtlePark,10/05/2017 07:00:00 PM,48,-122,26,19,45
32972,ElliotBayTrailMyrtlePark,10/05/2017 08:00:00 PM,48,-122,10,6,16
32973,ElliotBayTrailMyrtlePark,10/05/2017 09:00:00 PM,48,-122,10,23,33
32974,ElliotBayTrailMyrtlePark,10/05/2017 10:00:00 PM,48,-122,10,3,13
32975,ElliotBayTrailMyrtlePark,10/05/2017 11:00:00 PM,48,-122,8,2,10
32976,ElliotBayTrailMyrtlePark,10/06/2017 12:00:00 AM,48,-122,0,3,3
32977,ElliotBayTrailMyrtlePark,10/06/2017 01:00:00 AM,48,-122,1,0,1
32978,ElliotBayTrailMyrtlePark,10/06/2017 02:00:00 AM,48,-122,2,0,2
32979,ElliotBayTrailMyrtlePark,10/06/2017 03:00:00 AM,48,-122,0,1,1
32980,ElliotBayTrailMyrtlePark,10/06/2017 04:00:00 AM,48,-122,0,0,0
32981,ElliotBayTrailMyrtlePark,10/06/2017 05:00:00 AM,48,-122,5,13,18
32982,ElliotBayTrailMyrtlePark,10/06/2017 06:00:00 AM,48,-122,18,7,25
32983,ElliotBayTrailMyrtlePark,10/06/2017 07:00:00 AM,48,-122,37,83,120
32984,ElliotBayTrailMyrtlePark,10/06/2017 08:00:00 AM,48,-122,49,115,164
32985,ElliotBayTrailMyrtlePark,10/06/2017 09:00:00 AM,48,-122,28,64,92
32986,ElliotBayTrailMyrtlePark,10/06/2017 10:00:00 AM,48,-122,19,27,46
32987,ElliotBayTrailMyrtlePark,10/06/2017 11:00:00 AM,48,-122,18,22,40
32988,ElliotBayTrailMyrtlePark,10/06/2017 12:00:00 PM,48,-122,27,26,53
32989,ElliotBayTrailMyrtlePark,10/06/2017 01:00:00 PM,48,-122,28,28,56
32990,ElliotBayTrailMyrtlePark,10/06/2017 02:00:00 PM,48,-122,39,29,68
32991,ElliotBayTrailMyrtlePark,10/06/2017 03:00:00 PM,48,-122,40,43,83
32992,ElliotBayTrailMyrtlePark,10/06/2017 04:00:00 PM,48,-122,95,43,138
32993,ElliotBayTrailMyrtlePark,10/06/2017 05:00:00 PM,48,-122,124,52,176
32994,ElliotBayTrailMyrtlePark,10/06/2017 06:00:00 PM,48,-122,57,18,75
32995,ElliotBayTrailMyrtlePark,10/06/2017 07:00:00 PM,48,-122,8,14,22
32996,ElliotBayTrailMyrtlePark,10/06/2017 08:00:00 PM,48,-122,3,3,6
32997,ElliotBayTrailMyrtlePark,10/06/2017 09:00:00 PM,48,-122,2,6,8
32998,ElliotBayTrailMyrtlePark,10/06/2017 10:00:00 PM,48,-122,0,0,0
32999,ElliotBayTrailMyrtlePark,10/06/2017 11:00:00 PM,48,-122,7,1,8
33000,ElliotBayTrailMyrtlePark,10/07/2017 12:00:00 AM,48,-122,6,1,7
33001,ElliotBayTrailMyrtlePark,10/07/2017 01:00:00 AM,48,-122,1,0,1
33002,ElliotBayTrailMyrtlePark,10/07/2017 02:00:00 AM,48,-122,0,0,0
33003,ElliotBayTrailMyrtlePark,10/07/2017 03:00:00 AM,48,-122,2,1,3
33004,ElliotBayTrailMyrtlePark,10/07/2017 04:00:00 AM,48,-122,0,0,0
33005,ElliotBayTrailMyrtlePark,10/07/2017 05:00:00 AM,48,-122,0,0,0
33006,ElliotBayTrailMyrtlePark,10/07/2017 06:00:00 AM,48,-122,0,1,1
33007,ElliotBayTrailMyrtlePark,10/07/2017 07:00:00 AM,48,-122,2,3,5
33008,ElliotBayTrailMyrtlePark,10/07/2017 08:00:00 AM,48,-122,8,15,23
33009,ElliotBayTrailMyrtlePark,10/07/2017 09:00:00 AM,48,-122,19,19,38
33010,ElliotBayTrailMyrtlePark,10/07/2017 10:00:00 AM,48,-122,18,23,41
33011,ElliotBayTrailMyrtlePark,10/07/2017 11:00:00 AM,48,-122,35,36,71
33012,ElliotBayTrailMyrtlePark,10/07/2017 12:00:00 PM,48,-122,35,35,70
33013,ElliotBayTrailMyrtlePark,10/07/2017 01:00:00 PM,48,-122,27,33,60
33014,ElliotBayTrailMyrtlePark,10/07/2017 02:00:00 PM,48,-122,30,23,53
33015,ElliotBayTrailMyrtlePark,10/07/2017 03:00:00 PM,48,-122,18,20,38
33016,ElliotBayTrailMyrtlePark,10/07/2017 04:00:00 PM,48,-122,20,17,37
33017,ElliotBayTrailMyrtlePark,10/07/2017 05:00:00 PM,48,-122,21,11,32
33018,ElliotBayTrailMyrtlePark,10/07/2017 06:00:00 PM,48,-122,15,8,23
33019,ElliotBayTrailMyrtlePark,10/07/2017 07:00:00 PM,48,-122,7,2,9
33020,ElliotBayTrailMyrtlePark,10/07/2017 08:00:00 PM,48,-122,3,4,7
33021,ElliotBayTrailMyrtlePark,10/07/2017 09:00:00 PM,48,-122,0,4,4
33022,ElliotBayTrailMyrtlePark,10/07/2017 10:00:00 PM,48,-122,6,1,7
33023,ElliotBayTrailMyrtlePark,10/07/2017 11:00:00 PM,48,-122,6,2,8
33024,ElliotBayTrailMyrtlePark,10/08/2017 12:00:00 AM,48,-122,3,0,3
33025,ElliotBayTrailMyrtlePark,10/08/2017 01:00:00 AM,48,-122,2,0,2
33026,ElliotBayTrailMyrtlePark,10/08/2017 02:00:00 AM,48,-122,0,0,0
33027,ElliotBayTrailMyrtlePark,10/08/2017 03:00:00 AM,48,-122,1,0,1
33028,ElliotBayTrailMyrtlePark,10/08/2017 04:00:00 AM,48,-122,0,0,0
33029,ElliotBayTrailMyrtlePark,10/08/2017 05:00:00 AM,48,-122,0,0,0
33030,ElliotBayTrailMyrtlePark,10/08/2017 06:00:00 AM,48,-122,3,1,4
33031,ElliotBayTrailMyrtlePark,10/08/2017 07:00:00 AM,48,-122,5,4,9
33032,ElliotBayTrailMyrtlePark,10/08/2017 08:00:00 AM,48,-122,10,11,21
33033,ElliotBayTrailMyrtlePark,10/08/2017 09:00:00 AM,48,-122,14,23,37
33034,ElliotBayTrailMyrtlePark,10/08/2017 10:00:00 AM,48,-122,21,26,47
33035,ElliotBayTrailMyrtlePark,10/08/2017 11:00:00 AM,48,-122,39,45,84
33036,ElliotBayTrailMyrtlePark,10/08/2017 12:00:00 PM,48,-122,27,32,59
33037,ElliotBayTrailMyrtlePark,10/08/2017 01:00:00 PM,48,-122,37,28,65
33038,ElliotBayTrailMyrtlePark,10/08/2017 02:00:00 PM,48,-122,48,50,98
33039,ElliotBayTrailMyrtlePark,10/08/2017 03:00:00 PM,48,-122,47,40,87
33040,ElliotBayTrailMyrtlePark,10/08/2017 04:00:00 PM,48,-122,53,58,111
33041,ElliotBayTrailMyrtlePark,10/08/2017 05:00:00 PM,48,-122,45,42,87
33042,ElliotBayTrailMyrtlePark,10/08/2017 06:00:00 PM,48,-122,35,33,68
33043,ElliotBayTrailMyrtlePark,10/08/2017 07:00:00 PM,48,-122,24,19,43
33044,ElliotBayTrailMyrtlePark,10/08/2017 08:00:00 PM,48,-122,4,6,10
33045,ElliotBayTrailMyrtlePark,10/08/2017 09:00:00 PM,48,-122,7,10,17
33046,ElliotBayTrailMyrtlePark,10/08/2017 10:00:00 PM,48,-122,1,1,2
33047,ElliotBayTrailMyrtlePark,10/08/2017 11:00:00 PM,48,-122,2,3,5
33048,ElliotBayTrailMyrtlePark,10/09/2017 12:00:00 AM,48,-122,2,0,2
33049,ElliotBayTrailMyrtlePark,10/09/2017 01:00:00 AM,48,-122,1,0,1
33050,ElliotBayTrailMyrtlePark,10/09/2017 02:00:00 AM,48,-122,1,0,1
33051,ElliotBayTrailMyrtlePark,10/09/2017 03:00:00 AM,48,-122,0,0,0
33052,ElliotBayTrailMyrtlePark,10/09/2017 04:00:00 AM,48,-122,0,0,0
33053,ElliotBayTrailMyrtlePark,10/09/2017 05:00:00 AM,48,-122,7,5,12
33054,ElliotBayTrailMyrtlePark,10/09/2017 06:00:00 AM,48,-122,18,22,40
33055,ElliotBayTrailMyrtlePark,10/09/2017 07:00:00 AM,48,-122,39,82,121
33056,ElliotBayTrailMyrtlePark,10/09/2017 08:00:00 AM,48,-122,28,151,179
33057,ElliotBayTrailMyrtlePark,10/09/2017 09:00:00 AM,48,-122,29,64,93
33058,ElliotBayTrailMyrtlePark,10/09/2017 10:00:00 AM,48,-122,23,21,44
33059,ElliotBayTrailMyrtlePark,10/09/2017 11:00:00 AM,48,-122,22,26,48
33060,ElliotBayTrailMyrtlePark,10/09/2017 12:00:00 PM,48,-122,22,21,43
33061,ElliotBayTrailMyrtlePark,10/09/2017 01:00:00 PM,48,-122,20,29,49
33062,ElliotBayTrailMyrtlePark,10/09/2017 02:00:00 PM,48,-122,33,31,64
33063,ElliotBayTrailMyrtlePark,10/09/2017 03:00:00 PM,48,-122,46,36,82
33064,ElliotBayTrailMyrtlePark,10/09/2017 04:00:00 PM,48,-122,95,56,151
33065,ElliotBayTrailMyrtlePark,10/09/2017 05:00:00 PM,48,-122,187,77,264
33066,ElliotBayTrailMyrtlePark,10/09/2017 06:00:00 PM,48,-122,105,48,153
33067,ElliotBayTrailMyrtlePark,10/09/2017 07:00:00 PM,48,-122,30,23,53
33068,ElliotBayTrailMyrtlePark,10/09/2017 08:00:00 PM,48,-122,11,3,14
33069,ElliotBayTrailMyrtlePark,10/09/2017 09:00:00 PM,48,-122,7,4,11
33070,ElliotBayTrailMyrtlePark,10/09/2017 10:00:00 PM,48,-122,3,2,5
33071,ElliotBayTrailMyrtlePark,10/09/2017 11:00:00 PM,48,-122,9,2,11
33072,ElliotBayTrailMyrtlePark,10/10/2017 12:00:00 AM,48,-122,1,5,6
33073,ElliotBayTrailMyrtlePark,10/10/2017 01:00:00 AM,48,-122,3,0,3
33074,ElliotBayTrailMyrtlePark,10/10/2017 02:00:00 AM,48,-122,1,0,1
33075,ElliotBayTrailMyrtlePark,10/10/2017 03:00:00 AM,48,-122,0,1,1
33076,ElliotBayTrailMyrtlePark,10/10/2017 04:00:00 AM,48,-122,0,0,0
33077,ElliotBayTrailMyrtlePark,10/10/2017 05:00:00 AM,48,-122,4,5,9
33078,ElliotBayTrailMyrtlePark,10/10/2017 06:00:00 AM,48,-122,24,40,64
33079,ElliotBayTrailMyrtlePark,10/10/2017 07:00:00 AM,48,-122,48,79,127
33080,ElliotBayTrailMyrtlePark,10/10/2017 08:00:00 AM,48,-122,46,128,174
33081,ElliotBayTrailMyrtlePark,10/10/2017 09:00:00 AM,48,-122,30,51,81
33082,ElliotBayTrailMyrtlePark,10/10/2017 10:00:00 AM,48,-122,14,23,37
33083,ElliotBayTrailMyrtlePark,10/10/2017 11:00:00 AM,48,-122,10,13,23
33084,ElliotBayTrailMyrtlePark,10/10/2017 12:00:00 PM,48,-122,13,14,27
33085,ElliotBayTrailMyrtlePark,10/10/2017 01:00:00 PM,48,-122,7,10,17
33086,ElliotBayTrailMyrtlePark,10/10/2017 02:00:00 PM,48,-122,17,13,30
33087,ElliotBayTrailMyrtlePark,10/10/2017 03:00:00 PM,48,-122,24,25,49
33088,ElliotBayTrailMyrtlePark,10/10/2017 04:00:00 PM,48,-122,64,49,113
33089,ElliotBayTrailMyrtlePark,10/10/2017 05:00:00 PM,48,-122,162,57,219
33090,ElliotBayTrailMyrtlePark,10/10/2017 06:00:00 PM,48,-122,78,27,105
33091,ElliotBayTrailMyrtlePark,10/10/2017 07:00:00 PM,48,-122,32,8,40
33092,ElliotBayTrailMyrtlePark,10/10/2017 08:00:00 PM,48,-122,6,9,15
33093,ElliotBayTrailMyrtlePark,10/10/2017 09:00:00 PM,48,-122,8,6,14
33094,ElliotBayTrailMyrtlePark,10/10/2017 10:00:00 PM,48,-122,2,2,4
33095,ElliotBayTrailMyrtlePark,10/10/2017 11:00:00 PM,48,-122,6,0,6
33096,ElliotBayTrailMyrtlePark,10/11/2017 12:00:00 AM,48,-122,0,4,4
33097,ElliotBayTrailMyrtlePark,10/11/2017 01:00:00 AM,48,-122,2,1,3
33098,ElliotBayTrailMyrtlePark,10/11/2017 02:00:00 AM,48,-122,1,0,1
33099,ElliotBayTrailMyrtlePark,10/11/2017 03:00:00 AM,48,-122,0,1,1
33100,ElliotBayTrailMyrtlePark,10/11/2017 04:00:00 AM,48,-122,0,0,0
33101,ElliotBayTrailMyrtlePark,10/11/2017 05:00:00 AM,48,-122,7,11,18
33102,ElliotBayTrailMyrtlePark,10/11/2017 06:00:00 AM,48,-122,25,31,56
33103,ElliotBayTrailMyrtlePark,10/11/2017 07:00:00 AM,48,-122,46,76,122
33104,ElliotBayTrailMyrtlePark,10/11/2017 08:00:00 AM,48,-122,29,144,173
33105,ElliotBayTrailMyrtlePark,10/11/2017 09:00:00 AM,48,-122,21,60,81
33106,ElliotBayTrailMyrtlePark,10/11/2017 10:00:00 AM,48,-122,16,17,33
33107,ElliotBayTrailMyrtlePark,10/11/2017 11:00:00 AM,48,-122,19,12,31
33108,ElliotBayTrailMyrtlePark,10/11/2017 12:00:00 PM,48,-122,11,20,31
33109,ElliotBayTrailMyrtlePark,10/11/2017 01:00:00 PM,48,-122,24,23,47
33110,ElliotBayTrailMyrtlePark,10/11/2017 02:00:00 PM,48,-122,17,21,38
33111,ElliotBayTrailMyrtlePark,10/11/2017 03:00:00 PM,48,-122,31,31,62
33112,ElliotBayTrailMyrtlePark,10/11/2017 04:00:00 PM,48,-122,71,40,111
33113,ElliotBayTrailMyrtlePark,10/11/2017 05:00:00 PM,48,-122,154,46,200
33114,ElliotBayTrailMyrtlePark,10/11/2017 06:00:00 PM,48,-122,69,31,100
33115,ElliotBayTrailMyrtlePark,10/11/2017 07:00:00 PM,48,-122,28,8,36
33116,ElliotBayTrailMyrtlePark,10/11/2017 08:00:00 PM,48,-122,9,6,15
33117,ElliotBayTrailMyrtlePark,10/11/2017 09:00:00 PM,48,-122,10,5,15
33118,ElliotBayTrailMyrtlePark,10/11/2017 10:00:00 PM,48,-122,4,1,5
33119,ElliotBayTrailMyrtlePark,10/11/2017 11:00:00 PM,48,-122,1,0,1
33120,ElliotBayTrailMyrtlePark,10/12/2017 12:00:00 AM,48,-122,0,0,0
33121,ElliotBayTrailMyrtlePark,10/12/2017 01:00:00 AM,48,-122,1,0,1
33122,ElliotBayTrailMyrtlePark,10/12/2017 02:00:00 AM,48,-122,2,0,2
33123,ElliotBayTrailMyrtlePark,10/12/2017 03:00:00 AM,48,-122,0,2,2
33124,ElliotBayTrailMyrtlePark,10/12/2017 04:00:00 AM,48,-122,0,1,1
33125,ElliotBayTrailMyrtlePark,10/12/2017 05:00:00 AM,48,-122,7,11,18
33126,ElliotBayTrailMyrtlePark,10/12/2017 06:00:00 AM,48,-122,14,19,33
33127,ElliotBayTrailMyrtlePark,10/12/2017 07:00:00 AM,48,-122,38,74,112
33128,ElliotBayTrailMyrtlePark,10/12/2017 08:00:00 AM,48,-122,32,115,147
33129,ElliotBayTrailMyrtlePark,10/12/2017 09:00:00 AM,48,-122,21,44,65
33130,ElliotBayTrailMyrtlePark,10/12/2017 10:00:00 AM,48,-122,8,17,25
33131,ElliotBayTrailMyrtlePark,10/12/2017 11:00:00 AM,48,-122,8,10,18
33132,ElliotBayTrailMyrtlePark,10/12/2017 12:00:00 PM,48,-122,12,4,16
33133,ElliotBayTrailMyrtlePark,10/12/2017 01:00:00 PM,48,-122,9,1,10
33134,ElliotBayTrailMyrtlePark,10/12/2017 02:00:00 PM,48,-122,10,11,21
33135,ElliotBayTrailMyrtlePark,10/12/2017 03:00:00 PM,48,-122,11,19,30
33136,ElliotBayTrailMyrtlePark,10/12/2017 04:00:00 PM,48,-122,61,34,95
33137,ElliotBayTrailMyrtlePark,10/12/2017 05:00:00 PM,48,-122,124,43,167
33138,ElliotBayTrailMyrtlePark,10/12/2017 06:00:00 PM,48,-122,50,14,64
33139,ElliotBayTrailMyrtlePark,10/12/2017 07:00:00 PM,48,-122,21,6,27
33140,ElliotBayTrailMyrtlePark,10/12/2017 08:00:00 PM,48,-122,5,6,11
33141,ElliotBayTrailMyrtlePark,10/12/2017 09:00:00 PM,48,-122,12,3,15
33142,ElliotBayTrailMyrtlePark,10/12/2017 10:00:00 PM,48,-122,2,1,3
33143,ElliotBayTrailMyrtlePark,10/12/2017 11:00:00 PM,48,-122,1,0,1
33144,ElliotBayTrailMyrtlePark,10/13/2017 12:00:00 AM,48,-122,1,0,1
33145,ElliotBayTrailMyrtlePark,10/13/2017 01:00:00 AM,48,-122,2,0,2
33146,ElliotBayTrailMyrtlePark,10/13/2017 02:00:00 AM,48,-122,1,0,1
33147,ElliotBayTrailMyrtlePark,10/13/2017 03:00:00 AM,48,-122,0,2,2
33148,ElliotBayTrailMyrtlePark,10/13/2017 04:00:00 AM,48,-122,0,1,1
33149,ElliotBayTrailMyrtlePark,10/13/2017 05:00:00 AM,48,-122,5,13,18
33150,ElliotBayTrailMyrtlePark,10/13/2017 06:00:00 AM,48,-122,20,18,38
33151,ElliotBayTrailMyrtlePark,10/13/2017 07:00:00 AM,48,-122,31,64,95
33152,ElliotBayTrailMyrtlePark,10/13/2017 08:00:00 AM,48,-122,33,105,138
33153,ElliotBayTrailMyrtlePark,10/13/2017 09:00:00 AM,48,-122,17,46,63
33154,ElliotBayTrailMyrtlePark,10/13/2017 10:00:00 AM,48,-122,10,11,21
33155,ElliotBayTrailMyrtlePark,10/13/2017 11:00:00 AM,48,-122,17,14,31
33156,ElliotBayTrailMyrtlePark,10/13/2017 12:00:00 PM,48,-122,21,20,41
33157,ElliotBayTrailMyrtlePark,10/13/2017 01:00:00 PM,48,-122,15,12,27
33158,ElliotBayTrailMyrtlePark,10/13/2017 02:00:00 PM,48,-122,31,18,49
33159,ElliotBayTrailMyrtlePark,10/13/2017 03:00:00 PM,48,-122,39,35,74
33160,ElliotBayTrailMyrtlePark,10/13/2017 04:00:00 PM,48,-122,82,52,134
33161,ElliotBayTrailMyrtlePark,10/13/2017 05:00:00 PM,48,-122,115,68,183
33162,ElliotBayTrailMyrtlePark,10/13/2017 06:00:00 PM,48,-122,74,30,104
33163,ElliotBayTrailMyrtlePark,10/13/2017 07:00:00 PM,48,-122,15,10,25
33164,ElliotBayTrailMyrtlePark,10/13/2017 08:00:00 PM,48,-122,7,0,7
33165,ElliotBayTrailMyrtlePark,10/13/2017 09:00:00 PM,48,-122,5,6,11
33166,ElliotBayTrailMyrtlePark,10/13/2017 10:00:00 PM,48,-122,7,1,8
33167,ElliotBayTrailMyrtlePark,10/13/2017 11:00:00 PM,48,-122,3,3,6
33168,ElliotBayTrailMyrtlePark,10/14/2017 12:00:00 AM,48,-122,8,4,12
33169,ElliotBayTrailMyrtlePark,10/14/2017 01:00:00 AM,48,-122,0,0,0
33170,ElliotBayTrailMyrtlePark,10/14/2017 02:00:00 AM,48,-122,2,0,2
33171,ElliotBayTrailMyrtlePark,10/14/2017 03:00:00 AM,48,-122,1,0,1
33172,ElliotBayTrailMyrtlePark,10/14/2017 04:00:00 AM,48,-122,0,0,0
33173,ElliotBayTrailMyrtlePark,10/14/2017 05:00:00 AM,48,-122,0,0,0
33174,ElliotBayTrailMyrtlePark,10/14/2017 06:00:00 AM,48,-122,0,3,3
33175,ElliotBayTrailMyrtlePark,10/14/2017 07:00:00 AM,48,-122,5,2,7
33176,ElliotBayTrailMyrtlePark,10/14/2017 08:00:00 AM,48,-122,7,11,18
33177,ElliotBayTrailMyrtlePark,10/14/2017 09:00:00 AM,48,-122,11,10,21
33178,ElliotBayTrailMyrtlePark,10/14/2017 10:00:00 AM,48,-122,21,25,46
33179,ElliotBayTrailMyrtlePark,10/14/2017 11:00:00 AM,48,-122,28,34,62
33180,ElliotBayTrailMyrtlePark,10/14/2017 12:00:00 PM,48,-122,33,30,63
33181,ElliotBayTrailMyrtlePark,10/14/2017 01:00:00 PM,48,-122,39,23,62
33182,ElliotBayTrailMyrtlePark,10/14/2017 02:00:00 PM,48,-122,49,42,91
33183,ElliotBayTrailMyrtlePark,10/14/2017 03:00:00 PM,48,-122,41,37,78
33184,ElliotBayTrailMyrtlePark,10/14/2017 04:00:00 PM,48,-122,46,27,73
33185,ElliotBayTrailMyrtlePark,10/14/2017 05:00:00 PM,48,-122,34,45,79
33186,ElliotBayTrailMyrtlePark,10/14/2017 06:00:00 PM,48,-122,39,36,75
33187,ElliotBayTrailMyrtlePark,10/14/2017 07:00:00 PM,48,-122,6,12,18
33188,ElliotBayTrailMyrtlePark,10/14/2017 08:00:00 PM,48,-122,9,2,11
33189,ElliotBayTrailMyrtlePark,10/14/2017 09:00:00 PM,48,-122,2,7,9
33190,ElliotBayTrailMyrtlePark,10/14/2017 10:00:00 PM,48,-122,2,6,8
33191,ElliotBayTrailMyrtlePark,10/14/2017 11:00:00 PM,48,-122,20,2,22
33192,ElliotBayTrailMyrtlePark,10/15/2017 12:00:00 AM,48,-122,1,4,5
33193,ElliotBayTrailMyrtlePark,10/15/2017 01:00:00 AM,48,-122,0,0,0
33194,ElliotBayTrailMyrtlePark,10/15/2017 02:00:00 AM,48,-122,1,0,1
33195,ElliotBayTrailMyrtlePark,10/15/2017 03:00:00 AM,48,-122,3,0,3
33196,ElliotBayTrailMyrtlePark,10/15/2017 04:00:00 AM,48,-122,1,0,1
33197,ElliotBayTrailMyrtlePark,10/15/2017 05:00:00 AM,48,-122,0,0,0
33198,ElliotBayTrailMyrtlePark,10/15/2017 06:00:00 AM,48,-122,1,2,3
33199,ElliotBayTrailMyrtlePark,10/15/2017 07:00:00 AM,48,-122,3,5,8
33200,ElliotBayTrailMyrtlePark,10/15/2017 08:00:00 AM,48,-122,5,6,11
33201,ElliotBayTrailMyrtlePark,10/15/2017 09:00:00 AM,48,-122,20,21,41
33202,ElliotBayTrailMyrtlePark,10/15/2017 10:00:00 AM,48,-122,42,27,69
33203,ElliotBayTrailMyrtlePark,10/15/2017 11:00:00 AM,48,-122,41,45,86
33204,ElliotBayTrailMyrtlePark,10/15/2017 12:00:00 PM,48,-122,62,75,137
33205,ElliotBayTrailMyrtlePark,10/15/2017 01:00:00 PM,48,-122,62,65,127
33206,ElliotBayTrailMyrtlePark,10/15/2017 02:00:00 PM,48,-122,70,83,153
33207,ElliotBayTrailMyrtlePark,10/15/2017 03:00:00 PM,48,-122,97,92,189
33208,ElliotBayTrailMyrtlePark,10/15/2017 04:00:00 PM,48,-122,79,79,158
33209,ElliotBayTrailMyrtlePark,10/15/2017 05:00:00 PM,48,-122,43,60,103
33210,ElliotBayTrailMyrtlePark,10/15/2017 06:00:00 PM,48,-122,50,33,83
33211,ElliotBayTrailMyrtlePark,10/15/2017 07:00:00 PM,48,-122,21,10,31
33212,ElliotBayTrailMyrtlePark,10/15/2017 08:00:00 PM,48,-122,8,1,9
33213,ElliotBayTrailMyrtlePark,10/15/2017 09:00:00 PM,48,-122,2,0,2
33214,ElliotBayTrailMyrtlePark,10/15/2017 10:00:00 PM,48,-122,1,4,5
33215,ElliotBayTrailMyrtlePark,10/15/2017 11:00:00 PM,48,-122,3,0,3
33216,ElliotBayTrailMyrtlePark,10/16/2017 12:00:00 AM,48,-122,4,1,5
33217,ElliotBayTrailMyrtlePark,10/16/2017 01:00:00 AM,48,-122,0,0,0
33218,ElliotBayTrailMyrtlePark,10/16/2017 02:00:00 AM,48,-122,0,1,1
33219,ElliotBayTrailMyrtlePark,10/16/2017 03:00:00 AM,48,-122,0,2,2
33220,ElliotBayTrailMyrtlePark,10/16/2017 04:00:00 AM,48,-122,0,1,1
33221,ElliotBayTrailMyrtlePark,10/16/2017 05:00:00 AM,48,-122,4,14,18
33222,ElliotBayTrailMyrtlePark,10/16/2017 06:00:00 AM,48,-122,25,33,58
33223,ElliotBayTrailMyrtlePark,10/16/2017 07:00:00 AM,48,-122,46,85,131
33224,ElliotBayTrailMyrtlePark,10/16/2017 08:00:00 AM,48,-122,37,173,210
33225,ElliotBayTrailMyrtlePark,10/16/2017 09:00:00 AM,48,-122,22,88,110
33226,ElliotBayTrailMyrtlePark,10/16/2017 10:00:00 AM,48,-122,9,23,32
33227,ElliotBayTrailMyrtlePark,10/16/2017 11:00:00 AM,48,-122,18,14,32
33228,ElliotBayTrailMyrtlePark,10/16/2017 12:00:00 PM,48,-122,20,15,35
33229,ElliotBayTrailMyrtlePark,10/16/2017 01:00:00 PM,48,-122,20,28,48
33230,ElliotBayTrailMyrtlePark,10/16/2017 02:00:00 PM,48,-122,40,34,74
33231,ElliotBayTrailMyrtlePark,10/16/2017 03:00:00 PM,48,-122,39,32,71
33232,ElliotBayTrailMyrtlePark,10/16/2017 04:00:00 PM,48,-122,105,62,167
33233,ElliotBayTrailMyrtlePark,10/16/2017 05:00:00 PM,48,-122,209,82,291
33234,ElliotBayTrailMyrtlePark,10/16/2017 06:00:00 PM,48,-122,115,32,147
33235,ElliotBayTrailMyrtlePark,10/16/2017 07:00:00 PM,48,-122,30,12,42
33236,ElliotBayTrailMyrtlePark,10/16/2017 08:00:00 PM,48,-122,5,1,6
33237,ElliotBayTrailMyrtlePark,10/16/2017 09:00:00 PM,48,-122,3,3,6
33238,ElliotBayTrailMyrtlePark,10/16/2017 10:00:00 PM,48,-122,4,2,6
33239,ElliotBayTrailMyrtlePark,10/16/2017 11:00:00 PM,48,-122,1,0,1
33240,ElliotBayTrailMyrtlePark,10/17/2017 12:00:00 AM,48,-122,1,1,2
33241,ElliotBayTrailMyrtlePark,10/17/2017 01:00:00 AM,48,-122,1,0,1
33242,ElliotBayTrailMyrtlePark,10/17/2017 02:00:00 AM,48,-122,1,0,1
33243,ElliotBayTrailMyrtlePark,10/17/2017 03:00:00 AM,48,-122,0,0,0
33244,ElliotBayTrailMyrtlePark,10/17/2017 04:00:00 AM,48,-122,0,0,0
33245,ElliotBayTrailMyrtlePark,10/17/2017 05:00:00 AM,48,-122,6,9,15
33246,ElliotBayTrailMyrtlePark,10/17/2017 06:00:00 AM,48,-122,24,25,49
33247,ElliotBayTrailMyrtlePark,10/17/2017 07:00:00 AM,48,-122,29,71,100
33248,ElliotBayTrailMyrtlePark,10/17/2017 08:00:00 AM,48,-122,32,92,124
33249,ElliotBayTrailMyrtlePark,10/17/2017 09:00:00 AM,48,-122,5,48,53
33250,ElliotBayTrailMyrtlePark,10/17/2017 10:00:00 AM,48,-122,3,14,17
33251,ElliotBayTrailMyrtlePark,10/17/2017 11:00:00 AM,48,-122,9,3,12
33252,ElliotBayTrailMyrtlePark,10/17/2017 12:00:00 PM,48,-122,6,8,14
33253,ElliotBayTrailMyrtlePark,10/17/2017 01:00:00 PM,48,-122,13,7,20
33254,ElliotBayTrailMyrtlePark,10/17/2017 02:00:00 PM,48,-122,10,9,19
33255,ElliotBayTrailMyrtlePark,10/17/2017 03:00:00 PM,48,-122,21,26,47
33256,ElliotBayTrailMyrtlePark,10/17/2017 04:00:00 PM,48,-122,61,36,97
33257,ElliotBayTrailMyrtlePark,10/17/2017 05:00:00 PM,48,-122,125,42,167
33258,ElliotBayTrailMyrtlePark,10/17/2017 06:00:00 PM,48,-122,57,23,80
33259,ElliotBayTrailMyrtlePark,10/17/2017 07:00:00 PM,48,-122,16,10,26
33260,ElliotBayTrailMyrtlePark,10/17/2017 08:00:00 PM,48,-122,7,2,9
33261,ElliotBayTrailMyrtlePark,10/17/2017 09:00:00 PM,48,-122,10,10,20
33262,ElliotBayTrailMyrtlePark,10/17/2017 10:00:00 PM,48,-122,4,2,6
33263,ElliotBayTrailMyrtlePark,10/17/2017 11:00:00 PM,48,-122,4,1,5
33264,ElliotBayTrailMyrtlePark,10/18/2017 12:00:00 AM,48,-122,2,0,2
33265,ElliotBayTrailMyrtlePark,10/18/2017 01:00:00 AM,48,-122,3,2,5
33266,ElliotBayTrailMyrtlePark,10/18/2017 02:00:00 AM,48,-122,0,2,2
33267,ElliotBayTrailMyrtlePark,10/18/2017 03:00:00 AM,48,-122,0,1,1
33268,ElliotBayTrailMyrtlePark,10/18/2017 04:00:00 AM,48,-122,0,0,0
33269,ElliotBayTrailMyrtlePark,10/18/2017 05:00:00 AM,48,-122,2,12,14
33270,ElliotBayTrailMyrtlePark,10/18/2017 06:00:00 AM,48,-122,18,24,42
33271,ElliotBayTrailMyrtlePark,10/18/2017 07:00:00 AM,48,-122,40,66,106
33272,ElliotBayTrailMyrtlePark,10/18/2017 08:00:00 AM,48,-122,34,119,153
33273,ElliotBayTrailMyrtlePark,10/18/2017 09:00:00 AM,48,-122,15,41,56
33274,ElliotBayTrailMyrtlePark,10/18/2017 10:00:00 AM,48,-122,5,13,18
33275,ElliotBayTrailMyrtlePark,10/18/2017 11:00:00 AM,48,-122,4,3,7
33276,ElliotBayTrailMyrtlePark,10/18/2017 12:00:00 PM,48,-122,4,0,4
33277,ElliotBayTrailMyrtlePark,10/18/2017 01:00:00 PM,48,-122,5,3,8
33278,ElliotBayTrailMyrtlePark,10/18/2017 02:00:00 PM,48,-122,19,8,27
33279,ElliotBayTrailMyrtlePark,10/18/2017 03:00:00 PM,48,-122,26,14,40
33280,ElliotBayTrailMyrtlePark,10/18/2017 04:00:00 PM,48,-122,52,35,87
33281,ElliotBayTrailMyrtlePark,10/18/2017 05:00:00 PM,48,-122,95,32,127
33282,ElliotBayTrailMyrtlePark,10/18/2017 06:00:00 PM,48,-122,42,11,53
33283,ElliotBayTrailMyrtlePark,10/18/2017 07:00:00 PM,48,-122,10,2,12
33284,ElliotBayTrailMyrtlePark,10/18/2017 08:00:00 PM,48,-122,6,1,7
33285,ElliotBayTrailMyrtlePark,10/18/2017 09:00:00 PM,48,-122,1,0,1
33286,ElliotBayTrailMyrtlePark,10/18/2017 10:00:00 PM,48,-122,0,1,1
33287,ElliotBayTrailMyrtlePark,10/18/2017 11:00:00 PM,48,-122,0,0,0
33288,ElliotBayTrailMyrtlePark,10/19/2017 12:00:00 AM,48,-122,0,0,0
33289,ElliotBayTrailMyrtlePark,10/19/2017 01:00:00 AM,48,-122,0,0,0
33290,ElliotBayTrailMyrtlePark,10/19/2017 02:00:00 AM,48,-122,1,0,1
33291,ElliotBayTrailMyrtlePark,10/19/2017 03:00:00 AM,48,-122,0,1,1
33292,ElliotBayTrailMyrtlePark,10/19/2017 04:00:00 AM,48,-122,1,0,1
33293,ElliotBayTrailMyrtlePark,10/19/2017 05:00:00 AM,48,-122,7,5,12
33294,ElliotBayTrailMyrtlePark,10/19/2017 06:00:00 AM,48,-122,13,20,33
33295,ElliotBayTrailMyrtlePark,10/19/2017 07:00:00 AM,48,-122,25,44,69
33296,ElliotBayTrailMyrtlePark,10/19/2017 08:00:00 AM,48,-122,24,94,118
33297,ElliotBayTrailMyrtlePark,10/19/2017 09:00:00 AM,48,-122,17,39,56
33298,ElliotBayTrailMyrtlePark,10/19/2017 10:00:00 AM,48,-122,3,7,10
33299,ElliotBayTrailMyrtlePark,10/19/2017 11:00:00 AM,48,-122,6,7,13
33300,ElliotBayTrailMyrtlePark,10/19/2017 12:00:00 PM,48,-122,16,10,26
33301,ElliotBayTrailMyrtlePark,10/19/2017 01:00:00 PM,48,-122,12,7,19
33302,ElliotBayTrailMyrtlePark,10/19/2017 02:00:00 PM,48,-122,17,9,26
33303,ElliotBayTrailMyrtlePark,10/19/2017 03:00:00 PM,48,-122,13,18,31
33304,ElliotBayTrailMyrtlePark,10/19/2017 04:00:00 PM,48,-122,33,24,57
33305,ElliotBayTrailMyrtlePark,10/19/2017 05:00:00 PM,48,-122,88,29,117
33306,ElliotBayTrailMyrtlePark,10/19/2017 06:00:00 PM,48,-122,43,13,56
33307,ElliotBayTrailMyrtlePark,10/19/2017 07:00:00 PM,48,-122,18,2,20
33308,ElliotBayTrailMyrtlePark,10/19/2017 08:00:00 PM,48,-122,4,1,5
33309,ElliotBayTrailMyrtlePark,10/19/2017 09:00:00 PM,48,-122,5,1,6
33310,ElliotBayTrailMyrtlePark,10/19/2017 10:00:00 PM,48,-122,2,0,2
33311,ElliotBayTrailMyrtlePark,10/19/2017 11:00:00 PM,48,-122,3,0,3
33312,ElliotBayTrailMyrtlePark,10/20/2017 12:00:00 AM,48,-122,0,0,0
33313,ElliotBayTrailMyrtlePark,10/20/2017 01:00:00 AM,48,-122,0,0,0
33314,ElliotBayTrailMyrtlePark,10/20/2017 02:00:00 AM,48,-122,1,0,1
33315,ElliotBayTrailMyrtlePark,10/20/2017 03:00:00 AM,48,-122,0,1,1
33316,ElliotBayTrailMyrtlePark,10/20/2017 04:00:00 AM,48,-122,1,0,1
33317,ElliotBayTrailMyrtlePark,10/20/2017 05:00:00 AM,48,-122,6,11,17
33318,ElliotBayTrailMyrtlePark,10/20/2017 06:00:00 AM,48,-122,12,16,28
33319,ElliotBayTrailMyrtlePark,10/20/2017 07:00:00 AM,48,-122,27,50,77
33320,ElliotBayTrailMyrtlePark,10/20/2017 08:00:00 AM,48,-122,27,90,117
33321,ElliotBayTrailMyrtlePark,10/20/2017 09:00:00 AM,48,-122,15,29,44
33322,ElliotBayTrailMyrtlePark,10/20/2017 10:00:00 AM,48,-122,8,7,15
33323,ElliotBayTrailMyrtlePark,10/20/2017 11:00:00 AM,48,-122,5,6,11
33324,ElliotBayTrailMyrtlePark,10/20/2017 12:00:00 PM,48,-122,5,2,7
33325,ElliotBayTrailMyrtlePark,10/20/2017 01:00:00 PM,48,-122,8,10,18
33326,ElliotBayTrailMyrtlePark,10/20/2017 02:00:00 PM,48,-122,19,11,30
33327,ElliotBayTrailMyrtlePark,10/20/2017 03:00:00 PM,48,-122,33,26,59
33328,ElliotBayTrailMyrtlePark,10/20/2017 04:00:00 PM,48,-122,52,33,85
33329,ElliotBayTrailMyrtlePark,10/20/2017 05:00:00 PM,48,-122,95,32,127
33330,ElliotBayTrailMyrtlePark,10/20/2017 06:00:00 PM,48,-122,49,18,67
33331,ElliotBayTrailMyrtlePark,10/20/2017 07:00:00 PM,48,-122,8,6,14
33332,ElliotBayTrailMyrtlePark,10/20/2017 08:00:00 PM,48,-122,4,1,5
33333,ElliotBayTrailMyrtlePark,10/20/2017 09:00:00 PM,48,-122,6,5,11
33334,ElliotBayTrailMyrtlePark,10/20/2017 10:00:00 PM,48,-122,2,2,4
33335,ElliotBayTrailMyrtlePark,10/20/2017 11:00:00 PM,48,-122,4,3,7
33336,ElliotBayTrailMyrtlePark,10/21/2017 12:00:00 AM,48,-122,9,6,15
33337,ElliotBayTrailMyrtlePark,10/21/2017 01:00:00 AM,48,-122,1,1,2
33338,ElliotBayTrailMyrtlePark,10/21/2017 02:00:00 AM,48,-122,0,2,2
33339,ElliotBayTrailMyrtlePark,10/21/2017 03:00:00 AM,48,-122,0,0,0
33340,ElliotBayTrailMyrtlePark,10/21/2017 04:00:00 AM,48,-122,0,1,1
33341,ElliotBayTrailMyrtlePark,10/21/2017 05:00:00 AM,48,-122,1,0,1
33342,ElliotBayTrailMyrtlePark,10/21/2017 06:00:00 AM,48,-122,0,3,3
33343,ElliotBayTrailMyrtlePark,10/21/2017 07:00:00 AM,48,-122,4,1,5
33344,ElliotBayTrailMyrtlePark,10/21/2017 08:00:00 AM,48,-122,4,2,6
33345,ElliotBayTrailMyrtlePark,10/21/2017 09:00:00 AM,48,-122,2,7,9
33346,ElliotBayTrailMyrtlePark,10/21/2017 10:00:00 AM,48,-122,3,7,10
33347,ElliotBayTrailMyrtlePark,10/21/2017 11:00:00 AM,48,-122,2,6,8
33348,ElliotBayTrailMyrtlePark,10/21/2017 12:00:00 PM,48,-122,5,8,13
33349,ElliotBayTrailMyrtlePark,10/21/2017 01:00:00 PM,48,-122,11,3,14
33350,ElliotBayTrailMyrtlePark,10/21/2017 02:00:00 PM,48,-122,4,4,8
33351,ElliotBayTrailMyrtlePark,10/21/2017 03:00:00 PM,48,-122,5,4,9
33352,ElliotBayTrailMyrtlePark,10/21/2017 04:00:00 PM,48,-122,6,3,9
33353,ElliotBayTrailMyrtlePark,10/21/2017 05:00:00 PM,48,-122,6,4,10
33354,ElliotBayTrailMyrtlePark,10/21/2017 06:00:00 PM,48,-122,3,3,6
33355,ElliotBayTrailMyrtlePark,10/21/2017 07:00:00 PM,48,-122,1,0,1
33356,ElliotBayTrailMyrtlePark,10/21/2017 08:00:00 PM,48,-122,1,1,2
33357,ElliotBayTrailMyrtlePark,10/21/2017 09:00:00 PM,48,-122,1,2,3
33358,ElliotBayTrailMyrtlePark,10/21/2017 10:00:00 PM,48,-122,0,0,0
33359,ElliotBayTrailMyrtlePark,10/21/2017 11:00:00 PM,48,-122,3,1,4
33360,ElliotBayTrailMyrtlePark,10/22/2017 12:00:00 AM,48,-122,0,1,1
33361,ElliotBayTrailMyrtlePark,10/22/2017 01:00:00 AM,48,-122,1,0,1
33362,ElliotBayTrailMyrtlePark,10/22/2017 02:00:00 AM,48,-122,0,0,0
33363,ElliotBayTrailMyrtlePark,10/22/2017 03:00:00 AM,48,-122,1,1,2
33364,ElliotBayTrailMyrtlePark,10/22/2017 04:00:00 AM,48,-122,0,0,0
33365,ElliotBayTrailMyrtlePark,10/22/2017 05:00:00 AM,48,-122,0,0,0
33366,ElliotBayTrailMyrtlePark,10/22/2017 06:00:00 AM,48,-122,2,1,3
33367,ElliotBayTrailMyrtlePark,10/22/2017 07:00:00 AM,48,-122,3,1,4
33368,ElliotBayTrailMyrtlePark,10/22/2017 08:00:00 AM,48,-122,4,4,8
33369,ElliotBayTrailMyrtlePark,10/22/2017 09:00:00 AM,48,-122,15,15,30
33370,ElliotBayTrailMyrtlePark,10/22/2017 10:00:00 AM,48,-122,14,30,44
33371,ElliotBayTrailMyrtlePark,10/22/2017 11:00:00 AM,48,-122,36,37,73
33372,ElliotBayTrailMyrtlePark,10/22/2017 12:00:00 PM,48,-122,47,72,119
33373,ElliotBayTrailMyrtlePark,10/22/2017 01:00:00 PM,48,-122,34,37,71
33374,ElliotBayTrailMyrtlePark,10/22/2017 02:00:00 PM,48,-122,19,28,47
33375,ElliotBayTrailMyrtlePark,10/22/2017 03:00:00 PM,48,-122,62,30,92
33376,ElliotBayTrailMyrtlePark,10/22/2017 04:00:00 PM,48,-122,55,44,99
33377,ElliotBayTrailMyrtlePark,10/22/2017 05:00:00 PM,48,-122,41,22,63
33378,ElliotBayTrailMyrtlePark,10/22/2017 06:00:00 PM,48,-122,17,12,29
33379,ElliotBayTrailMyrtlePark,10/22/2017 07:00:00 PM,48,-122,7,3,10
33380,ElliotBayTrailMyrtlePark,10/22/2017 08:00:00 PM,48,-122,9,3,12
33381,ElliotBayTrailMyrtlePark,10/22/2017 09:00:00 PM,48,-122,3,1,4
33382,ElliotBayTrailMyrtlePark,10/22/2017 10:00:00 PM,48,-122,3,3,6
33383,ElliotBayTrailMyrtlePark,10/22/2017 11:00:00 PM,48,-122,4,0,4
33384,ElliotBayTrailMyrtlePark,10/23/2017 12:00:00 AM,48,-122,3,1,4
33385,ElliotBayTrailMyrtlePark,10/23/2017 01:00:00 AM,48,-122,1,0,1
33386,ElliotBayTrailMyrtlePark,10/23/2017 02:00:00 AM,48,-122,1,1,2
33387,ElliotBayTrailMyrtlePark,10/23/2017 03:00:00 AM,48,-122,1,0,1
33388,ElliotBayTrailMyrtlePark,10/23/2017 04:00:00 AM,48,-122,0,0,0
33389,ElliotBayTrailMyrtlePark,10/23/2017 05:00:00 AM,48,-122,9,3,12
33390,ElliotBayTrailMyrtlePark,10/23/2017 06:00:00 AM,48,-122,26,40,66
33391,ElliotBayTrailMyrtlePark,10/23/2017 07:00:00 AM,48,-122,46,84,130
33392,ElliotBayTrailMyrtlePark,10/23/2017 08:00:00 AM,48,-122,41,178,219
33393,ElliotBayTrailMyrtlePark,10/23/2017 09:00:00 AM,48,-122,30,74,104
33394,ElliotBayTrailMyrtlePark,10/23/2017 10:00:00 AM,48,-122,27,23,50
33395,ElliotBayTrailMyrtlePark,10/23/2017 11:00:00 AM,48,-122,10,20,30
33396,ElliotBayTrailMyrtlePark,10/23/2017 12:00:00 PM,48,-122,35,23,58
33397,ElliotBayTrailMyrtlePark,10/23/2017 01:00:00 PM,48,-122,17,31,48
33398,ElliotBayTrailMyrtlePark,10/23/2017 02:00:00 PM,48,-122,25,37,62
33399,ElliotBayTrailMyrtlePark,10/23/2017 03:00:00 PM,48,-122,55,60,115
33400,ElliotBayTrailMyrtlePark,10/23/2017 04:00:00 PM,48,-122,105,60,165
33401,ElliotBayTrailMyrtlePark,10/23/2017 05:00:00 PM,48,-122,195,57,252
33402,ElliotBayTrailMyrtlePark,10/23/2017 06:00:00 PM,48,-122,97,42,139
33403,ElliotBayTrailMyrtlePark,10/23/2017 07:00:00 PM,48,-122,21,9,30
33404,ElliotBayTrailMyrtlePark,10/23/2017 08:00:00 PM,48,-122,13,5,18
33405,ElliotBayTrailMyrtlePark,10/23/2017 09:00:00 PM,48,-122,5,5,10
33406,ElliotBayTrailMyrtlePark,10/23/2017 10:00:00 PM,48,-122,4,4,8
33407,ElliotBayTrailMyrtlePark,10/23/2017 11:00:00 PM,48,-122,5,2,7
33408,ElliotBayTrailMyrtlePark,10/24/2017 12:00:00 AM,48,-122,1,1,2
33409,ElliotBayTrailMyrtlePark,10/24/2017 01:00:00 AM,48,-122,1,0,1
33410,ElliotBayTrailMyrtlePark,10/24/2017 02:00:00 AM,48,-122,0,0,0
33411,ElliotBayTrailMyrtlePark,10/24/2017 03:00:00 AM,48,-122,0,0,0
33412,ElliotBayTrailMyrtlePark,10/24/2017 04:00:00 AM,48,-122,0,0,0
33413,ElliotBayTrailMyrtlePark,10/24/2017 05:00:00 AM,48,-122,3,13,16
33414,ElliotBayTrailMyrtlePark,10/24/2017 06:00:00 AM,48,-122,31,29,60
33415,ElliotBayTrailMyrtlePark,10/24/2017 07:00:00 AM,48,-122,41,87,128
33416,ElliotBayTrailMyrtlePark,10/24/2017 08:00:00 AM,48,-122,42,170,212
33417,ElliotBayTrailMyrtlePark,10/24/2017 09:00:00 AM,48,-122,35,69,104
33418,ElliotBayTrailMyrtlePark,10/24/2017 10:00:00 AM,48,-122,24,28,52
33419,ElliotBayTrailMyrtlePark,10/24/2017 11:00:00 AM,48,-122,30,23,53
33420,ElliotBayTrailMyrtlePark,10/24/2017 12:00:00 PM,48,-122,31,27,58
33421,ElliotBayTrailMyrtlePark,10/24/2017 01:00:00 PM,48,-122,25,37,62
33422,ElliotBayTrailMyrtlePark,10/24/2017 02:00:00 PM,48,-122,32,32,64
33423,ElliotBayTrailMyrtlePark,10/24/2017 03:00:00 PM,48,-122,53,51,104
33424,ElliotBayTrailMyrtlePark,10/24/2017 04:00:00 PM,48,-122,120,78,198
33425,ElliotBayTrailMyrtlePark,10/24/2017 05:00:00 PM,48,-122,206,88,294
33426,ElliotBayTrailMyrtlePark,10/24/2017 06:00:00 PM,48,-122,108,49,157
33427,ElliotBayTrailMyrtlePark,10/24/2017 07:00:00 PM,48,-122,16,11,27
33428,ElliotBayTrailMyrtlePark,10/24/2017 08:00:00 PM,48,-122,15,2,17
33429,ElliotBayTrailMyrtlePark,10/24/2017 09:00:00 PM,48,-122,10,4,14
33430,ElliotBayTrailMyrtlePark,10/24/2017 10:00:00 PM,48,-122,4,1,5
33431,ElliotBayTrailMyrtlePark,10/24/2017 11:00:00 PM,48,-122,3,3,6
33432,ElliotBayTrailMyrtlePark,10/25/2017 12:00:00 AM,48,-122,1,2,3
33433,ElliotBayTrailMyrtlePark,10/25/2017 01:00:00 AM,48,-122,3,3,6
33434,ElliotBayTrailMyrtlePark,10/25/2017 02:00:00 AM,48,-122,0,0,0
33435,ElliotBayTrailMyrtlePark,10/25/2017 03:00:00 AM,48,-122,0,0,0
33436,ElliotBayTrailMyrtlePark,10/25/2017 04:00:00 AM,48,-122,3,0,3
33437,ElliotBayTrailMyrtlePark,10/25/2017 05:00:00 AM,48,-122,3,15,18
33438,ElliotBayTrailMyrtlePark,10/25/2017 06:00:00 AM,48,-122,20,31,51
33439,ElliotBayTrailMyrtlePark,10/25/2017 07:00:00 AM,48,-122,41,80,121
33440,ElliotBayTrailMyrtlePark,10/25/2017 08:00:00 AM,48,-122,36,140,176
33441,ElliotBayTrailMyrtlePark,10/25/2017 09:00:00 AM,48,-122,21,64,85
33442,ElliotBayTrailMyrtlePark,10/25/2017 10:00:00 AM,48,-122,11,14,25
33443,ElliotBayTrailMyrtlePark,10/25/2017 11:00:00 AM,48,-122,11,8,19
33444,ElliotBayTrailMyrtlePark,10/25/2017 12:00:00 PM,48,-122,11,9,20
33445,ElliotBayTrailMyrtlePark,10/25/2017 01:00:00 PM,48,-122,8,15,23
33446,ElliotBayTrailMyrtlePark,10/25/2017 02:00:00 PM,48,-122,21,23,44
33447,ElliotBayTrailMyrtlePark,10/25/2017 03:00:00 PM,48,-122,30,26,56
33448,ElliotBayTrailMyrtlePark,10/25/2017 04:00:00 PM,48,-122,76,41,117
33449,ElliotBayTrailMyrtlePark,10/25/2017 05:00:00 PM,48,-122,168,43,211
33450,ElliotBayTrailMyrtlePark,10/25/2017 06:00:00 PM,48,-122,75,25,100
33451,ElliotBayTrailMyrtlePark,10/25/2017 07:00:00 PM,48,-122,15,3,18
33452,ElliotBayTrailMyrtlePark,10/25/2017 08:00:00 PM,48,-122,12,3,15
33453,ElliotBayTrailMyrtlePark,10/25/2017 09:00:00 PM,48,-122,7,4,11
33454,ElliotBayTrailMyrtlePark,10/25/2017 10:00:00 PM,48,-122,5,4,9
33455,ElliotBayTrailMyrtlePark,10/25/2017 11:00:00 PM,48,-122,3,1,4
33456,ElliotBayTrailMyrtlePark,10/26/2017 12:00:00 AM,48,-122,1,0,1
33457,ElliotBayTrailMyrtlePark,10/26/2017 01:00:00 AM,48,-122,1,0,1
33458,ElliotBayTrailMyrtlePark,10/26/2017 02:00:00 AM,48,-122,2,0,2
33459,ElliotBayTrailMyrtlePark,10/26/2017 03:00:00 AM,48,-122,0,0,0
33460,ElliotBayTrailMyrtlePark,10/26/2017 04:00:00 AM,48,-122,2,1,3
33461,ElliotBayTrailMyrtlePark,10/26/2017 05:00:00 AM,48,-122,3,7,10
33462,ElliotBayTrailMyrtlePark,10/26/2017 06:00:00 AM,48,-122,17,36,53
33463,ElliotBayTrailMyrtlePark,10/26/2017 07:00:00 AM,48,-122,43,76,119
33464,ElliotBayTrailMyrtlePark,10/26/2017 08:00:00 AM,48,-122,30,131,161
33465,ElliotBayTrailMyrtlePark,10/26/2017 09:00:00 AM,48,-122,18,70,88
33466,ElliotBayTrailMyrtlePark,10/26/2017 10:00:00 AM,48,-122,11,20,31
33467,ElliotBayTrailMyrtlePark,10/26/2017 11:00:00 AM,48,-122,10,13,23
33468,ElliotBayTrailMyrtlePark,10/26/2017 12:00:00 PM,48,-122,21,20,41
33469,ElliotBayTrailMyrtlePark,10/26/2017 01:00:00 PM,48,-122,24,15,39
33470,ElliotBayTrailMyrtlePark,10/26/2017 02:00:00 PM,48,-122,29,19,48
33471,ElliotBayTrailMyrtlePark,10/26/2017 03:00:00 PM,48,-122,39,27,66
33472,ElliotBayTrailMyrtlePark,10/26/2017 04:00:00 PM,48,-122,89,59,148
33473,ElliotBayTrailMyrtlePark,10/26/2017 05:00:00 PM,48,-122,168,87,255
33474,ElliotBayTrailMyrtlePark,10/26/2017 06:00:00 PM,48,-122,79,39,118
33475,ElliotBayTrailMyrtlePark,10/26/2017 07:00:00 PM,48,-122,26,10,36
33476,ElliotBayTrailMyrtlePark,10/26/2017 08:00:00 PM,48,-122,13,3,16
33477,ElliotBayTrailMyrtlePark,10/26/2017 09:00:00 PM,48,-122,6,3,9
33478,ElliotBayTrailMyrtlePark,10/26/2017 10:00:00 PM,48,-122,8,0,8
33479,ElliotBayTrailMyrtlePark,10/26/2017 11:00:00 PM,48,-122,3,1,4
33480,ElliotBayTrailMyrtlePark,10/27/2017 12:00:00 AM,48,-122,2,0,2
33481,ElliotBayTrailMyrtlePark,10/27/2017 01:00:00 AM,48,-122,0,0,0
33482,ElliotBayTrailMyrtlePark,10/27/2017 02:00:00 AM,48,-122,0,0,0
33483,ElliotBayTrailMyrtlePark,10/27/2017 03:00:00 AM,48,-122,0,1,1
33484,ElliotBayTrailMyrtlePark,10/27/2017 04:00:00 AM,48,-122,0,0,0
33485,ElliotBayTrailMyrtlePark,10/27/2017 05:00:00 AM,48,-122,6,15,21
33486,ElliotBayTrailMyrtlePark,10/27/2017 06:00:00 AM,48,-122,18,20,38
33487,ElliotBayTrailMyrtlePark,10/27/2017 07:00:00 AM,48,-122,43,82,125
33488,ElliotBayTrailMyrtlePark,10/27/2017 08:00:00 AM,48,-122,47,107,154
33489,ElliotBayTrailMyrtlePark,10/27/2017 09:00:00 AM,48,-122,29,51,80
33490,ElliotBayTrailMyrtlePark,10/27/2017 10:00:00 AM,48,-122,10,25,35
33491,ElliotBayTrailMyrtlePark,10/27/2017 11:00:00 AM,48,-122,12,15,27
33492,ElliotBayTrailMyrtlePark,10/27/2017 12:00:00 PM,48,-122,29,26,55
33493,ElliotBayTrailMyrtlePark,10/27/2017 01:00:00 PM,48,-122,39,14,53
33494,ElliotBayTrailMyrtlePark,10/27/2017 02:00:00 PM,48,-122,49,23,72
33495,ElliotBayTrailMyrtlePark,10/27/2017 03:00:00 PM,48,-122,57,52,109
33496,ElliotBayTrailMyrtlePark,10/27/2017 04:00:00 PM,48,-122,120,87,207
33497,ElliotBayTrailMyrtlePark,10/27/2017 05:00:00 PM,48,-122,153,93,246
33498,ElliotBayTrailMyrtlePark,10/27/2017 06:00:00 PM,48,-122,61,42,103
33499,ElliotBayTrailMyrtlePark,10/27/2017 07:00:00 PM,48,-122,13,6,19
33500,ElliotBayTrailMyrtlePark,10/27/2017 08:00:00 PM,48,-122,9,1,10
33501,ElliotBayTrailMyrtlePark,10/27/2017 09:00:00 PM,48,-122,5,4,9
33502,ElliotBayTrailMyrtlePark,10/27/2017 10:00:00 PM,48,-122,2,4,6
33503,ElliotBayTrailMyrtlePark,10/27/2017 11:00:00 PM,48,-122,2,0,2
33504,ElliotBayTrailMyrtlePark,10/28/2017 12:00:00 AM,48,-122,3,0,3
33505,ElliotBayTrailMyrtlePark,10/28/2017 01:00:00 AM,48,-122,4,6,10
33506,ElliotBayTrailMyrtlePark,10/28/2017 02:00:00 AM,48,-122,2,1,3
33507,ElliotBayTrailMyrtlePark,10/28/2017 03:00:00 AM,48,-122,0,0,0
33508,ElliotBayTrailMyrtlePark,10/28/2017 04:00:00 AM,48,-122,1,1,2
33509,ElliotBayTrailMyrtlePark,10/28/2017 05:00:00 AM,48,-122,0,0,0
33510,ElliotBayTrailMyrtlePark,10/28/2017 06:00:00 AM,48,-122,5,4,9
33511,ElliotBayTrailMyrtlePark,10/28/2017 07:00:00 AM,48,-122,9,5,14
33512,ElliotBayTrailMyrtlePark,10/28/2017 08:00:00 AM,48,-122,8,21,29
33513,ElliotBayTrailMyrtlePark,10/28/2017 09:00:00 AM,48,-122,9,28,37
33514,ElliotBayTrailMyrtlePark,10/28/2017 10:00:00 AM,48,-122,28,23,51
33515,ElliotBayTrailMyrtlePark,10/28/2017 11:00:00 AM,48,-122,43,34,77
33516,ElliotBayTrailMyrtlePark,10/28/2017 12:00:00 PM,48,-122,43,54,97
33517,ElliotBayTrailMyrtlePark,10/28/2017 01:00:00 PM,48,-122,48,61,109
33518,ElliotBayTrailMyrtlePark,10/28/2017 02:00:00 PM,48,-122,42,44,86
33519,ElliotBayTrailMyrtlePark,10/28/2017 03:00:00 PM,48,-122,68,63,131
33520,ElliotBayTrailMyrtlePark,10/28/2017 04:00:00 PM,48,-122,81,54,135
33521,ElliotBayTrailMyrtlePark,10/28/2017 05:00:00 PM,48,-122,45,48,93
33522,ElliotBayTrailMyrtlePark,10/28/2017 06:00:00 PM,48,-122,19,38,57
33523,ElliotBayTrailMyrtlePark,10/28/2017 07:00:00 PM,48,-122,7,6,13
33524,ElliotBayTrailMyrtlePark,10/28/2017 08:00:00 PM,48,-122,4,5,9
33525,ElliotBayTrailMyrtlePark,10/28/2017 09:00:00 PM,48,-122,1,1,2
33526,ElliotBayTrailMyrtlePark,10/28/2017 10:00:00 PM,48,-122,9,2,11
33527,ElliotBayTrailMyrtlePark,10/28/2017 11:00:00 PM,48,-122,0,0,0
33528,ElliotBayTrailMyrtlePark,10/29/2017 12:00:00 AM,48,-122,11,2,13
33529,ElliotBayTrailMyrtlePark,10/29/2017 01:00:00 AM,48,-122,3,0,3
33530,ElliotBayTrailMyrtlePark,10/29/2017 02:00:00 AM,48,-122,0,1,1
33531,ElliotBayTrailMyrtlePark,10/29/2017 03:00:00 AM,48,-122,0,0,0
33532,ElliotBayTrailMyrtlePark,10/29/2017 04:00:00 AM,48,-122,0,0,0
33533,ElliotBayTrailMyrtlePark,10/29/2017 05:00:00 AM,48,-122,0,1,1
33534,ElliotBayTrailMyrtlePark,10/29/2017 06:00:00 AM,48,-122,2,3,5
33535,ElliotBayTrailMyrtlePark,10/29/2017 07:00:00 AM,48,-122,11,3,14
33536,ElliotBayTrailMyrtlePark,10/29/2017 08:00:00 AM,48,-122,4,11,15
33537,ElliotBayTrailMyrtlePark,10/29/2017 09:00:00 AM,48,-122,23,20,43
33538,ElliotBayTrailMyrtlePark,10/29/2017 10:00:00 AM,48,-122,23,30,53
33539,ElliotBayTrailMyrtlePark,10/29/2017 11:00:00 AM,48,-122,27,27,54
33540,ElliotBayTrailMyrtlePark,10/29/2017 12:00:00 PM,48,-122,24,46,70
33541,ElliotBayTrailMyrtlePark,10/29/2017 01:00:00 PM,48,-122,33,18,51
33542,ElliotBayTrailMyrtlePark,10/29/2017 02:00:00 PM,48,-122,47,35,82
33543,ElliotBayTrailMyrtlePark,10/29/2017 03:00:00 PM,48,-122,40,32,72
33544,ElliotBayTrailMyrtlePark,10/29/2017 04:00:00 PM,48,-122,34,33,67
33545,ElliotBayTrailMyrtlePark,10/29/2017 05:00:00 PM,48,-122,50,40,90
33546,ElliotBayTrailMyrtlePark,10/29/2017 06:00:00 PM,48,-122,22,28,50
33547,ElliotBayTrailMyrtlePark,10/29/2017 07:00:00 PM,48,-122,13,3,16
33548,ElliotBayTrailMyrtlePark,10/29/2017 08:00:00 PM,48,-122,5,2,7
33549,ElliotBayTrailMyrtlePark,10/29/2017 09:00:00 PM,48,-122,1,9,10
33550,ElliotBayTrailMyrtlePark,10/29/2017 10:00:00 PM,48,-122,3,0,3
33551,ElliotBayTrailMyrtlePark,10/29/2017 11:00:00 PM,48,-122,1,1,2
33552,ElliotBayTrailMyrtlePark,10/30/2017 12:00:00 AM,48,-122,2,1,3
33553,ElliotBayTrailMyrtlePark,10/30/2017 01:00:00 AM,48,-122,0,0,0
33554,ElliotBayTrailMyrtlePark,10/30/2017 02:00:00 AM,48,-122,0,0,0
33555,ElliotBayTrailMyrtlePark,10/30/2017 03:00:00 AM,48,-122,2,1,3
33556,ElliotBayTrailMyrtlePark,10/30/2017 04:00:00 AM,48,-122,3,1,4
33557,ElliotBayTrailMyrtlePark,10/30/2017 05:00:00 AM,48,-122,8,4,12
33558,ElliotBayTrailMyrtlePark,10/30/2017 06:00:00 AM,48,-122,20,35,55
33559,ElliotBayTrailMyrtlePark,10/30/2017 07:00:00 AM,48,-122,57,93,150
33560,ElliotBayTrailMyrtlePark,10/30/2017 08:00:00 AM,48,-122,35,174,209
33561,ElliotBayTrailMyrtlePark,10/30/2017 09:00:00 AM,48,-122,31,45,76
33562,ElliotBayTrailMyrtlePark,10/30/2017 10:00:00 AM,48,-122,14,25,39
33563,ElliotBayTrailMyrtlePark,10/30/2017 11:00:00 AM,48,-122,13,18,31
33564,ElliotBayTrailMyrtlePark,10/30/2017 12:00:00 PM,48,-122,21,16,37
33565,ElliotBayTrailMyrtlePark,10/30/2017 01:00:00 PM,48,-122,25,20,45
33566,ElliotBayTrailMyrtlePark,10/30/2017 02:00:00 PM,48,-122,28,37,65
33567,ElliotBayTrailMyrtlePark,10/30/2017 03:00:00 PM,48,-122,48,43,91
33568,ElliotBayTrailMyrtlePark,10/30/2017 04:00:00 PM,48,-122,115,67,182
33569,ElliotBayTrailMyrtlePark,10/30/2017 05:00:00 PM,48,-122,198,69,267
33570,ElliotBayTrailMyrtlePark,10/30/2017 06:00:00 PM,48,-122,95,35,130
33571,ElliotBayTrailMyrtlePark,10/30/2017 07:00:00 PM,48,-122,24,7,31
33572,ElliotBayTrailMyrtlePark,10/30/2017 08:00:00 PM,48,-122,11,3,14
33573,ElliotBayTrailMyrtlePark,10/30/2017 09:00:00 PM,48,-122,3,4,7
33574,ElliotBayTrailMyrtlePark,10/30/2017 10:00:00 PM,48,-122,3,2,5
33575,ElliotBayTrailMyrtlePark,10/30/2017 11:00:00 PM,48,-122,1,2,3
33576,ElliotBayTrailMyrtlePark,10/31/2017 12:00:00 AM,48,-122,4,1,5
33577,ElliotBayTrailMyrtlePark,10/31/2017 01:00:00 AM,48,-122,1,1,2
33578,ElliotBayTrailMyrtlePark,10/31/2017 02:00:00 AM,48,-122,1,0,1
33579,ElliotBayTrailMyrtlePark,10/31/2017 03:00:00 AM,48,-122,0,1,1
33580,ElliotBayTrailMyrtlePark,10/31/2017 04:00:00 AM,48,-122,0,1,1
33581,ElliotBayTrailMyrtlePark,10/31/2017 05:00:00 AM,48,-122,8,13,21
33582,ElliotBayTrailMyrtlePark,10/31/2017 06:00:00 AM,48,-122,25,31,56
33583,ElliotBayTrailMyrtlePark,10/31/2017 07:00:00 AM,48,-122,48,82,130
33584,ElliotBayTrailMyrtlePark,10/31/2017 08:00:00 AM,48,-122,49,147,196
33585,ElliotBayTrailMyrtlePark,10/31/2017 09:00:00 AM,48,-122,29,64,93
33586,ElliotBayTrailMyrtlePark,10/31/2017 10:00:00 AM,48,-122,15,38,53
33587,ElliotBayTrailMyrtlePark,10/31/2017 11:00:00 AM,48,-122,13,27,40
33588,ElliotBayTrailMyrtlePark,10/31/2017 12:00:00 PM,48,-122,30,17,47
33589,ElliotBayTrailMyrtlePark,10/31/2017 01:00:00 PM,48,-122,42,29,71
33590,ElliotBayTrailMyrtlePark,10/31/2017 02:00:00 PM,48,-122,27,31,58
33591,ElliotBayTrailMyrtlePark,10/31/2017 03:00:00 PM,48,-122,72,33,105
33592,ElliotBayTrailMyrtlePark,10/31/2017 04:00:00 PM,48,-122,126,65,191
33593,ElliotBayTrailMyrtlePark,10/31/2017 05:00:00 PM,48,-122,189,65,254
33594,ElliotBayTrailMyrtlePark,10/31/2017 06:00:00 PM,48,-122,65,20,85
33595,ElliotBayTrailMyrtlePark,10/31/2017 07:00:00 PM,48,-122,16,3,19
33596,ElliotBayTrailMyrtlePark,10/31/2017 08:00:00 PM,48,-122,4,2,6
33597,ElliotBayTrailMyrtlePark,10/31/2017 09:00:00 PM,48,-122,5,3,8
33598,ElliotBayTrailMyrtlePark,10/31/2017 10:00:00 PM,48,-122,7,0,7
33599,ElliotBayTrailMyrtlePark,10/31/2017 11:00:00 PM,48,-122,3,3,6
33600,ElliotBayTrailMyrtlePark,11/01/2017 12:00:00 AM,48,-122,3,1,4
33601,ElliotBayTrailMyrtlePark,11/01/2017 01:00:00 AM,48,-122,1,0,1
33602,ElliotBayTrailMyrtlePark,11/01/2017 02:00:00 AM,48,-122,0,0,0
33603,ElliotBayTrailMyrtlePark,11/01/2017 03:00:00 AM,48,-122,3,1,4
33604,ElliotBayTrailMyrtlePark,11/01/2017 04:00:00 AM,48,-122,1,0,1
33605,ElliotBayTrailMyrtlePark,11/01/2017 05:00:00 AM,48,-122,4,8,12
33606,ElliotBayTrailMyrtlePark,11/01/2017 06:00:00 AM,48,-122,21,27,48
33607,ElliotBayTrailMyrtlePark,11/01/2017 07:00:00 AM,48,-122,45,80,125
33608,ElliotBayTrailMyrtlePark,11/01/2017 08:00:00 AM,48,-122,37,134,171
33609,ElliotBayTrailMyrtlePark,11/01/2017 09:00:00 AM,48,-122,23,47,70
33610,ElliotBayTrailMyrtlePark,11/01/2017 10:00:00 AM,48,-122,6,15,21
33611,ElliotBayTrailMyrtlePark,11/01/2017 11:00:00 AM,48,-122,9,8,17
33612,ElliotBayTrailMyrtlePark,11/01/2017 12:00:00 PM,48,-122,6,15,21
33613,ElliotBayTrailMyrtlePark,11/01/2017 01:00:00 PM,48,-122,14,16,30
33614,ElliotBayTrailMyrtlePark,11/01/2017 02:00:00 PM,48,-122,21,12,33
33615,ElliotBayTrailMyrtlePark,11/01/2017 03:00:00 PM,48,-122,29,31,60
33616,ElliotBayTrailMyrtlePark,11/01/2017 04:00:00 PM,48,-122,67,36,103
33617,ElliotBayTrailMyrtlePark,11/01/2017 05:00:00 PM,48,-122,146,55,201
33618,ElliotBayTrailMyrtlePark,11/01/2017 06:00:00 PM,48,-122,72,35,107
33619,ElliotBayTrailMyrtlePark,11/01/2017 07:00:00 PM,48,-122,30,11,41
33620,ElliotBayTrailMyrtlePark,11/01/2017 08:00:00 PM,48,-122,11,3,14
33621,ElliotBayTrailMyrtlePark,11/01/2017 09:00:00 PM,48,-122,10,3,13
33622,ElliotBayTrailMyrtlePark,11/01/2017 10:00:00 PM,48,-122,4,2,6
33623,ElliotBayTrailMyrtlePark,11/01/2017 11:00:00 PM,48,-122,0,1,1
33624,ElliotBayTrailMyrtlePark,11/02/2017 12:00:00 AM,48,-122,1,0,1
33625,ElliotBayTrailMyrtlePark,11/02/2017 01:00:00 AM,48,-122,1,0,1
33626,ElliotBayTrailMyrtlePark,11/02/2017 02:00:00 AM,48,-122,0,0,0
33627,ElliotBayTrailMyrtlePark,11/02/2017 03:00:00 AM,48,-122,0,0,0
33628,ElliotBayTrailMyrtlePark,11/02/2017 04:00:00 AM,48,-122,0,0,0
33629,ElliotBayTrailMyrtlePark,11/02/2017 05:00:00 AM,48,-122,0,0,0
33630,ElliotBayTrailMyrtlePark,11/02/2017 06:00:00 AM,48,-122,0,0,0
33631,ElliotBayTrailMyrtlePark,11/02/2017 07:00:00 AM,48,-122,0,0,0
33632,ElliotBayTrailMyrtlePark,11/02/2017 08:00:00 AM,48,-122,0,0,0
33633,ElliotBayTrailMyrtlePark,11/02/2017 09:00:00 AM,48,-122,0,0,0
33634,ElliotBayTrailMyrtlePark,11/02/2017 10:00:00 AM,48,-122,0,0,0
33635,ElliotBayTrailMyrtlePark,11/02/2017 11:00:00 AM,48,-122,0,0,0
33636,ElliotBayTrailMyrtlePark,11/02/2017 12:00:00 PM,48,-122,0,0,0
33637,ElliotBayTrailMyrtlePark,11/02/2017 01:00:00 PM,48,-122,0,0,0
33638,ElliotBayTrailMyrtlePark,11/02/2017 02:00:00 PM,48,-122,0,0,0
33639,ElliotBayTrailMyrtlePark,11/02/2017 03:00:00 PM,48,-122,0,0,0
33640,ElliotBayTrailMyrtlePark,11/02/2017 04:00:00 PM,48,-122,0,0,0
33641,ElliotBayTrailMyrtlePark,11/02/2017 05:00:00 PM,48,-122,0,0,0
33642,ElliotBayTrailMyrtlePark,11/02/2017 06:00:00 PM,48,-122,0,0,0
33643,ElliotBayTrailMyrtlePark,11/02/2017 07:00:00 PM,48,-122,0,0,0
33644,ElliotBayTrailMyrtlePark,11/02/2017 08:00:00 PM,48,-122,0,0,0
33645,ElliotBayTrailMyrtlePark,11/02/2017 09:00:00 PM,48,-122,0,0,0
33646,ElliotBayTrailMyrtlePark,11/02/2017 10:00:00 PM,48,-122,0,0,0
33647,ElliotBayTrailMyrtlePark,11/02/2017 11:00:00 PM,48,-122,0,0,0
33648,ElliotBayTrailMyrtlePark,11/03/2017 12:00:00 AM,48,-122,0,0,0
33649,ElliotBayTrailMyrtlePark,11/03/2017 01:00:00 AM,48,-122,0,0,0
33650,ElliotBayTrailMyrtlePark,11/03/2017 02:00:00 AM,48,-122,0,0,0
33651,ElliotBayTrailMyrtlePark,11/03/2017 03:00:00 AM,48,-122,0,0,0
33652,ElliotBayTrailMyrtlePark,11/03/2017 04:00:00 AM,48,-122,0,0,0
33653,ElliotBayTrailMyrtlePark,11/03/2017 05:00:00 AM,48,-122,0,0,0
33654,ElliotBayTrailMyrtlePark,11/03/2017 06:00:00 AM,48,-122,0,0,0
33655,ElliotBayTrailMyrtlePark,11/03/2017 07:00:00 AM,48,-122,0,0,0
33656,ElliotBayTrailMyrtlePark,11/03/2017 08:00:00 AM,48,-122,0,0,0
33657,ElliotBayTrailMyrtlePark,11/03/2017 09:00:00 AM,48,-122,0,0,0
33658,ElliotBayTrailMyrtlePark,11/03/2017 10:00:00 AM,48,-122,0,0,0
33659,ElliotBayTrailMyrtlePark,11/03/2017 11:00:00 AM,48,-122,0,0,0
33660,ElliotBayTrailMyrtlePark,11/03/2017 12:00:00 PM,48,-122,0,0,0
33661,ElliotBayTrailMyrtlePark,11/03/2017 01:00:00 PM,48,-122,0,0,0
33662,ElliotBayTrailMyrtlePark,11/03/2017 02:00:00 PM,48,-122,0,0,0
33663,ElliotBayTrailMyrtlePark,11/03/2017 03:00:00 PM,48,-122,0,0,0
33664,ElliotBayTrailMyrtlePark,11/03/2017 04:00:00 PM,48,-122,0,0,0
33665,ElliotBayTrailMyrtlePark,11/03/2017 05:00:00 PM,48,-122,0,0,0
33666,ElliotBayTrailMyrtlePark,11/03/2017 06:00:00 PM,48,-122,0,0,0
33667,ElliotBayTrailMyrtlePark,11/03/2017 07:00:00 PM,48,-122,0,0,0
33668,ElliotBayTrailMyrtlePark,11/03/2017 08:00:00 PM,48,-122,0,0,0
33669,ElliotBayTrailMyrtlePark,11/03/2017 09:00:00 PM,48,-122,0,0,0
33670,ElliotBayTrailMyrtlePark,11/03/2017 10:00:00 PM,48,-122,0,0,0
33671,ElliotBayTrailMyrtlePark,11/03/2017 11:00:00 PM,48,-122,0,0,0
33672,ElliotBayTrailMyrtlePark,11/04/2017 12:00:00 AM,48,-122,0,0,0
33673,ElliotBayTrailMyrtlePark,11/04/2017 01:00:00 AM,48,-122,0,0,0
33674,ElliotBayTrailMyrtlePark,11/04/2017 02:00:00 AM,48,-122,0,0,0
33675,ElliotBayTrailMyrtlePark,11/04/2017 03:00:00 AM,48,-122,0,0,0
33676,ElliotBayTrailMyrtlePark,11/04/2017 04:00:00 AM,48,-122,0,0,0
33677,ElliotBayTrailMyrtlePark,11/04/2017 05:00:00 AM,48,-122,0,0,0
33678,ElliotBayTrailMyrtlePark,11/04/2017 06:00:00 AM,48,-122,0,0,0
33679,ElliotBayTrailMyrtlePark,11/04/2017 07:00:00 AM,48,-122,0,0,0
33680,ElliotBayTrailMyrtlePark,11/04/2017 08:00:00 AM,48,-122,0,0,0
33681,ElliotBayTrailMyrtlePark,11/04/2017 09:00:00 AM,48,-122,0,0,0
33682,ElliotBayTrailMyrtlePark,11/04/2017 10:00:00 AM,48,-122,0,0,0
33683,ElliotBayTrailMyrtlePark,11/04/2017 11:00:00 AM,48,-122,0,0,0
33684,ElliotBayTrailMyrtlePark,11/04/2017 12:00:00 PM,48,-122,0,0,0
33685,ElliotBayTrailMyrtlePark,11/04/2017 01:00:00 PM,48,-122,0,0,0
33686,ElliotBayTrailMyrtlePark,11/04/2017 02:00:00 PM,48,-122,0,0,0
33687,ElliotBayTrailMyrtlePark,11/04/2017 03:00:00 PM,48,-122,0,0,0
33688,ElliotBayTrailMyrtlePark,11/04/2017 04:00:00 PM,48,-122,0,0,0
33689,ElliotBayTrailMyrtlePark,11/04/2017 05:00:00 PM,48,-122,0,0,0
33690,ElliotBayTrailMyrtlePark,11/04/2017 06:00:00 PM,48,-122,0,0,0
33691,ElliotBayTrailMyrtlePark,11/04/2017 07:00:00 PM,48,-122,0,0,0
33692,ElliotBayTrailMyrtlePark,11/04/2017 08:00:00 PM,48,-122,0,0,0
33693,ElliotBayTrailMyrtlePark,11/04/2017 09:00:00 PM,48,-122,0,0,0
33694,ElliotBayTrailMyrtlePark,11/04/2017 10:00:00 PM,48,-122,0,0,0
33695,ElliotBayTrailMyrtlePark,11/04/2017 11:00:00 PM,48,-122,0,0,0
33696,ElliotBayTrailMyrtlePark,11/05/2017 12:00:00 AM,48,-122,0,0,0
33697,ElliotBayTrailMyrtlePark,11/05/2017 01:00:00 AM,48,-122,0,0,0
33698,ElliotBayTrailMyrtlePark,11/05/2017 02:00:00 AM,48,-122,0,0,0
33699,ElliotBayTrailMyrtlePark,11/05/2017 03:00:00 AM,48,-122,0,0,0
33700,ElliotBayTrailMyrtlePark,11/05/2017 04:00:00 AM,48,-122,0,0,0
33701,ElliotBayTrailMyrtlePark,11/05/2017 05:00:00 AM,48,-122,0,0,0
33702,ElliotBayTrailMyrtlePark,11/05/2017 06:00:00 AM,48,-122,0,0,0
33703,ElliotBayTrailMyrtlePark,11/05/2017 07:00:00 AM,48,-122,0,0,0
33704,ElliotBayTrailMyrtlePark,11/05/2017 08:00:00 AM,48,-122,0,0,0
33705,ElliotBayTrailMyrtlePark,11/05/2017 09:00:00 AM,48,-122,0,0,0
33706,ElliotBayTrailMyrtlePark,11/05/2017 10:00:00 AM,48,-122,0,0,0
33707,ElliotBayTrailMyrtlePark,11/05/2017 11:00:00 AM,48,-122,0,0,0
33708,ElliotBayTrailMyrtlePark,11/05/2017 12:00:00 PM,48,-122,0,0,0
33709,ElliotBayTrailMyrtlePark,11/05/2017 01:00:00 PM,48,-122,0,0,0
33710,ElliotBayTrailMyrtlePark,11/05/2017 02:00:00 PM,48,-122,0,0,0
33711,ElliotBayTrailMyrtlePark,11/05/2017 03:00:00 PM,48,-122,0,0,0
33712,ElliotBayTrailMyrtlePark,11/05/2017 04:00:00 PM,48,-122,0,0,0
33713,ElliotBayTrailMyrtlePark,11/05/2017 05:00:00 PM,48,-122,0,0,0
33714,ElliotBayTrailMyrtlePark,11/05/2017 06:00:00 PM,48,-122,0,0,0
33715,ElliotBayTrailMyrtlePark,11/05/2017 07:00:00 PM,48,-122,0,0,0
33716,ElliotBayTrailMyrtlePark,11/05/2017 08:00:00 PM,48,-122,0,0,0
33717,ElliotBayTrailMyrtlePark,11/05/2017 09:00:00 PM,48,-122,0,0,0
33718,ElliotBayTrailMyrtlePark,11/05/2017 10:00:00 PM,48,-122,0,0,0
33719,ElliotBayTrailMyrtlePark,11/05/2017 11:00:00 PM,48,-122,0,0,0
33720,ElliotBayTrailMyrtlePark,11/06/2017 12:00:00 AM,48,-122,0,0,0
33721,ElliotBayTrailMyrtlePark,11/06/2017 01:00:00 AM,48,-122,0,0,0
33722,ElliotBayTrailMyrtlePark,11/06/2017 02:00:00 AM,48,-122,0,0,0
33723,ElliotBayTrailMyrtlePark,11/06/2017 03:00:00 AM,48,-122,0,0,0
33724,ElliotBayTrailMyrtlePark,11/06/2017 04:00:00 AM,48,-122,0,0,0
33725,ElliotBayTrailMyrtlePark,11/06/2017 05:00:00 AM,48,-122,0,0,0
33726,ElliotBayTrailMyrtlePark,11/06/2017 06:00:00 AM,48,-122,0,0,0
33727,ElliotBayTrailMyrtlePark,11/06/2017 07:00:00 AM,48,-122,0,0,0
33728,ElliotBayTrailMyrtlePark,11/06/2017 08:00:00 AM,48,-122,0,0,0
33729,ElliotBayTrailMyrtlePark,11/06/2017 09:00:00 AM,48,-122,0,0,0
33730,ElliotBayTrailMyrtlePark,11/06/2017 10:00:00 AM,48,-122,0,0,0
33731,ElliotBayTrailMyrtlePark,11/06/2017 11:00:00 AM,48,-122,0,0,0
33732,ElliotBayTrailMyrtlePark,11/06/2017 12:00:00 PM,48,-122,0,0,0
33733,ElliotBayTrailMyrtlePark,11/06/2017 01:00:00 PM,48,-122,0,0,0
33734,ElliotBayTrailMyrtlePark,11/06/2017 02:00:00 PM,48,-122,0,0,0
33735,ElliotBayTrailMyrtlePark,11/06/2017 03:00:00 PM,48,-122,0,0,0
33736,ElliotBayTrailMyrtlePark,11/06/2017 04:00:00 PM,48,-122,0,0,0
33737,ElliotBayTrailMyrtlePark,11/06/2017 05:00:00 PM,48,-122,0,0,0
33738,ElliotBayTrailMyrtlePark,11/06/2017 06:00:00 PM,48,-122,0,0,0
33739,ElliotBayTrailMyrtlePark,11/06/2017 07:00:00 PM,48,-122,0,0,0
33740,ElliotBayTrailMyrtlePark,11/06/2017 08:00:00 PM,48,-122,0,0,0
33741,ElliotBayTrailMyrtlePark,11/06/2017 09:00:00 PM,48,-122,0,0,0
33742,ElliotBayTrailMyrtlePark,11/06/2017 10:00:00 PM,48,-122,0,0,0
33743,ElliotBayTrailMyrtlePark,11/06/2017 11:00:00 PM,48,-122,0,0,0
33744,ElliotBayTrailMyrtlePark,11/07/2017 12:00:00 AM,48,-122,0,0,0
33745,ElliotBayTrailMyrtlePark,11/07/2017 01:00:00 AM,48,-122,0,0,0
33746,ElliotBayTrailMyrtlePark,11/07/2017 02:00:00 AM,48,-122,0,0,0
33747,ElliotBayTrailMyrtlePark,11/07/2017 03:00:00 AM,48,-122,0,0,0
33748,ElliotBayTrailMyrtlePark,11/07/2017 04:00:00 AM,48,-122,0,0,0
33749,ElliotBayTrailMyrtlePark,11/07/2017 05:00:00 AM,48,-122,0,0,0
33750,ElliotBayTrailMyrtlePark,11/07/2017 06:00:00 AM,48,-122,0,0,0
33751,ElliotBayTrailMyrtlePark,11/07/2017 07:00:00 AM,48,-122,0,0,0
33752,ElliotBayTrailMyrtlePark,11/07/2017 08:00:00 AM,48,-122,0,0,0
33753,ElliotBayTrailMyrtlePark,11/07/2017 09:00:00 AM,48,-122,0,0,0
33754,ElliotBayTrailMyrtlePark,11/07/2017 10:00:00 AM,48,-122,2,10,12
33755,ElliotBayTrailMyrtlePark,11/07/2017 11:00:00 AM,48,-122,14,9,23
33756,ElliotBayTrailMyrtlePark,11/07/2017 12:00:00 PM,48,-122,9,10,19
33757,ElliotBayTrailMyrtlePark,11/07/2017 01:00:00 PM,48,-122,13,18,31
33758,ElliotBayTrailMyrtlePark,11/07/2017 02:00:00 PM,48,-122,21,9,30
33759,ElliotBayTrailMyrtlePark,11/07/2017 03:00:00 PM,48,-122,34,29,63
33760,ElliotBayTrailMyrtlePark,11/07/2017 04:00:00 PM,48,-122,77,56,133
33761,ElliotBayTrailMyrtlePark,11/07/2017 05:00:00 PM,48,-122,139,44,183
33762,ElliotBayTrailMyrtlePark,11/07/2017 06:00:00 PM,48,-122,82,12,94
33763,ElliotBayTrailMyrtlePark,11/07/2017 07:00:00 PM,48,-122,14,7,21
33764,ElliotBayTrailMyrtlePark,11/07/2017 08:00:00 PM,48,-122,8,4,12
33765,ElliotBayTrailMyrtlePark,11/07/2017 09:00:00 PM,48,-122,7,0,7
33766,ElliotBayTrailMyrtlePark,11/07/2017 10:00:00 PM,48,-122,6,3,9
33767,ElliotBayTrailMyrtlePark,11/07/2017 11:00:00 PM,48,-122,0,1,1
33768,ElliotBayTrailMyrtlePark,11/08/2017 12:00:00 AM,48,-122,2,0,2
33769,ElliotBayTrailMyrtlePark,11/08/2017 01:00:00 AM,48,-122,1,1,2
33770,ElliotBayTrailMyrtlePark,11/08/2017 02:00:00 AM,48,-122,0,0,0
33771,ElliotBayTrailMyrtlePark,11/08/2017 03:00:00 AM,48,-122,0,1,1
33772,ElliotBayTrailMyrtlePark,11/08/2017 04:00:00 AM,48,-122,0,1,1
33773,ElliotBayTrailMyrtlePark,11/08/2017 05:00:00 AM,48,-122,6,10,16
33774,ElliotBayTrailMyrtlePark,11/08/2017 06:00:00 AM,48,-122,24,36,60
33775,ElliotBayTrailMyrtlePark,11/08/2017 07:00:00 AM,48,-122,40,82,122
33776,ElliotBayTrailMyrtlePark,11/08/2017 08:00:00 AM,48,-122,22,128,150
33777,ElliotBayTrailMyrtlePark,11/08/2017 09:00:00 AM,48,-122,21,54,75
33778,ElliotBayTrailMyrtlePark,11/08/2017 10:00:00 AM,48,-122,11,7,18
33779,ElliotBayTrailMyrtlePark,11/08/2017 11:00:00 AM,48,-122,7,16,23
33780,ElliotBayTrailMyrtlePark,11/08/2017 12:00:00 PM,48,-122,17,12,29
33781,ElliotBayTrailMyrtlePark,11/08/2017 01:00:00 PM,48,-122,8,6,14
33782,ElliotBayTrailMyrtlePark,11/08/2017 02:00:00 PM,48,-122,9,16,25
33783,ElliotBayTrailMyrtlePark,11/08/2017 03:00:00 PM,48,-122,31,22,53
33784,ElliotBayTrailMyrtlePark,11/08/2017 04:00:00 PM,48,-122,61,34,95
33785,ElliotBayTrailMyrtlePark,11/08/2017 05:00:00 PM,48,-122,121,23,144
33786,ElliotBayTrailMyrtlePark,11/08/2017 06:00:00 PM,48,-122,53,10,63
33787,ElliotBayTrailMyrtlePark,11/08/2017 07:00:00 PM,48,-122,13,5,18
33788,ElliotBayTrailMyrtlePark,11/08/2017 08:00:00 PM,48,-122,6,2,8
33789,ElliotBayTrailMyrtlePark,11/08/2017 09:00:00 PM,48,-122,4,0,4
33790,ElliotBayTrailMyrtlePark,11/08/2017 10:00:00 PM,48,-122,12,2,14
33791,ElliotBayTrailMyrtlePark,11/08/2017 11:00:00 PM,48,-122,3,0,3
33792,ElliotBayTrailMyrtlePark,11/09/2017 12:00:00 AM,48,-122,1,0,1
33793,ElliotBayTrailMyrtlePark,11/09/2017 01:00:00 AM,48,-122,0,0,0
33794,ElliotBayTrailMyrtlePark,11/09/2017 02:00:00 AM,48,-122,3,4,7
33795,ElliotBayTrailMyrtlePark,11/09/2017 03:00:00 AM,48,-122,0,1,1
33796,ElliotBayTrailMyrtlePark,11/09/2017 04:00:00 AM,48,-122,1,0,1
33797,ElliotBayTrailMyrtlePark,11/09/2017 05:00:00 AM,48,-122,5,13,18
33798,ElliotBayTrailMyrtlePark,11/09/2017 06:00:00 AM,48,-122,15,17,32
33799,ElliotBayTrailMyrtlePark,11/09/2017 07:00:00 AM,48,-122,47,55,102
33800,ElliotBayTrailMyrtlePark,11/09/2017 08:00:00 AM,48,-122,23,92,115
33801,ElliotBayTrailMyrtlePark,11/09/2017 09:00:00 AM,48,-122,15,31,46
33802,ElliotBayTrailMyrtlePark,11/09/2017 10:00:00 AM,48,-122,14,5,19
33803,ElliotBayTrailMyrtlePark,11/09/2017 11:00:00 AM,48,-122,6,10,16
33804,ElliotBayTrailMyrtlePark,11/09/2017 12:00:00 PM,48,-122,7,8,15
33805,ElliotBayTrailMyrtlePark,11/09/2017 01:00:00 PM,48,-122,5,4,9
33806,ElliotBayTrailMyrtlePark,11/09/2017 02:00:00 PM,48,-122,9,8,17
33807,ElliotBayTrailMyrtlePark,11/09/2017 03:00:00 PM,48,-122,19,23,42
33808,ElliotBayTrailMyrtlePark,11/09/2017 04:00:00 PM,48,-122,52,36,88
33809,ElliotBayTrailMyrtlePark,11/09/2017 05:00:00 PM,48,-122,73,34,107
33810,ElliotBayTrailMyrtlePark,11/09/2017 06:00:00 PM,48,-122,51,10,61
33811,ElliotBayTrailMyrtlePark,11/09/2017 07:00:00 PM,48,-122,13,3,16
33812,ElliotBayTrailMyrtlePark,11/09/2017 08:00:00 PM,48,-122,4,1,5
33813,ElliotBayTrailMyrtlePark,11/09/2017 09:00:00 PM,48,-122,3,5,8
33814,ElliotBayTrailMyrtlePark,11/09/2017 10:00:00 PM,48,-122,2,0,2
33815,ElliotBayTrailMyrtlePark,11/09/2017 11:00:00 PM,48,-122,2,0,2
33816,ElliotBayTrailMyrtlePark,11/10/2017 12:00:00 AM,48,-122,0,0,0
33817,ElliotBayTrailMyrtlePark,11/10/2017 01:00:00 AM,48,-122,3,0,3
33818,ElliotBayTrailMyrtlePark,11/10/2017 02:00:00 AM,48,-122,1,0,1
33819,ElliotBayTrailMyrtlePark,11/10/2017 03:00:00 AM,48,-122,0,0,0
33820,ElliotBayTrailMyrtlePark,11/10/2017 04:00:00 AM,48,-122,0,0,0
33821,ElliotBayTrailMyrtlePark,11/10/2017 05:00:00 AM,48,-122,5,6,11
33822,ElliotBayTrailMyrtlePark,11/10/2017 06:00:00 AM,48,-122,4,15,19
33823,ElliotBayTrailMyrtlePark,11/10/2017 07:00:00 AM,48,-122,28,48,76
33824,ElliotBayTrailMyrtlePark,11/10/2017 08:00:00 AM,48,-122,22,73,95
33825,ElliotBayTrailMyrtlePark,11/10/2017 09:00:00 AM,48,-122,14,38,52
33826,ElliotBayTrailMyrtlePark,11/10/2017 10:00:00 AM,48,-122,15,25,40
33827,ElliotBayTrailMyrtlePark,11/10/2017 11:00:00 AM,48,-122,12,26,38
33828,ElliotBayTrailMyrtlePark,11/10/2017 12:00:00 PM,48,-122,25,22,47
33829,ElliotBayTrailMyrtlePark,11/10/2017 01:00:00 PM,48,-122,31,25,56
33830,ElliotBayTrailMyrtlePark,11/10/2017 02:00:00 PM,48,-122,41,33,74
33831,ElliotBayTrailMyrtlePark,11/10/2017 03:00:00 PM,48,-122,74,51,125
33832,ElliotBayTrailMyrtlePark,11/10/2017 04:00:00 PM,48,-122,72,54,126
33833,ElliotBayTrailMyrtlePark,11/10/2017 05:00:00 PM,48,-122,76,24,100
33834,ElliotBayTrailMyrtlePark,11/10/2017 06:00:00 PM,48,-122,41,7,48
33835,ElliotBayTrailMyrtlePark,11/10/2017 07:00:00 PM,48,-122,16,4,20
33836,ElliotBayTrailMyrtlePark,11/10/2017 08:00:00 PM,48,-122,3,4,7
33837,ElliotBayTrailMyrtlePark,11/10/2017 09:00:00 PM,48,-122,6,4,10
33838,ElliotBayTrailMyrtlePark,11/10/2017 10:00:00 PM,48,-122,1,6,7
33839,ElliotBayTrailMyrtlePark,11/10/2017 11:00:00 PM,48,-122,1,0,1
33840,ElliotBayTrailMyrtlePark,11/11/2017 12:00:00 AM,48,-122,1,1,2
33841,ElliotBayTrailMyrtlePark,11/11/2017 01:00:00 AM,48,-122,2,0,2
33842,ElliotBayTrailMyrtlePark,11/11/2017 02:00:00 AM,48,-122,0,0,0
33843,ElliotBayTrailMyrtlePark,11/11/2017 03:00:00 AM,48,-122,4,2,6
33844,ElliotBayTrailMyrtlePark,11/11/2017 04:00:00 AM,48,-122,0,4,4
33845,ElliotBayTrailMyrtlePark,11/11/2017 05:00:00 AM,48,-122,0,1,1
33846,ElliotBayTrailMyrtlePark,11/11/2017 06:00:00 AM,48,-122,0,1,1
33847,ElliotBayTrailMyrtlePark,11/11/2017 07:00:00 AM,48,-122,4,5,9
33848,ElliotBayTrailMyrtlePark,11/11/2017 08:00:00 AM,48,-122,9,13,22
33849,ElliotBayTrailMyrtlePark,11/11/2017 09:00:00 AM,48,-122,11,9,20
33850,ElliotBayTrailMyrtlePark,11/11/2017 10:00:00 AM,48,-122,9,3,12
33851,ElliotBayTrailMyrtlePark,11/11/2017 11:00:00 AM,48,-122,8,7,15
33852,ElliotBayTrailMyrtlePark,11/11/2017 12:00:00 PM,48,-122,19,7,26
33853,ElliotBayTrailMyrtlePark,11/11/2017 01:00:00 PM,48,-122,17,15,32
33854,ElliotBayTrailMyrtlePark,11/11/2017 02:00:00 PM,48,-122,5,10,15
33855,ElliotBayTrailMyrtlePark,11/11/2017 03:00:00 PM,48,-122,16,14,30
33856,ElliotBayTrailMyrtlePark,11/11/2017 04:00:00 PM,48,-122,18,14,32
33857,ElliotBayTrailMyrtlePark,11/11/2017 05:00:00 PM,48,-122,8,9,17
33858,ElliotBayTrailMyrtlePark,11/11/2017 06:00:00 PM,48,-122,3,1,4
33859,ElliotBayTrailMyrtlePark,11/11/2017 07:00:00 PM,48,-122,2,1,3
33860,ElliotBayTrailMyrtlePark,11/11/2017 08:00:00 PM,48,-122,1,2,3
33861,ElliotBayTrailMyrtlePark,11/11/2017 09:00:00 PM,48,-122,4,3,7
33862,ElliotBayTrailMyrtlePark,11/11/2017 10:00:00 PM,48,-122,1,2,3
33863,ElliotBayTrailMyrtlePark,11/11/2017 11:00:00 PM,48,-122,0,0,0
33864,ElliotBayTrailMyrtlePark,11/12/2017 12:00:00 AM,48,-122,0,2,2
33865,ElliotBayTrailMyrtlePark,11/12/2017 01:00:00 AM,48,-122,4,0,4
33866,ElliotBayTrailMyrtlePark,11/12/2017 02:00:00 AM,48,-122,0,4,4
33867,ElliotBayTrailMyrtlePark,11/12/2017 03:00:00 AM,48,-122,0,0,0
33868,ElliotBayTrailMyrtlePark,11/12/2017 04:00:00 AM,48,-122,0,1,1
33869,ElliotBayTrailMyrtlePark,11/12/2017 05:00:00 AM,48,-122,0,0,0
33870,ElliotBayTrailMyrtlePark,11/12/2017 06:00:00 AM,48,-122,0,1,1
33871,ElliotBayTrailMyrtlePark,11/12/2017 07:00:00 AM,48,-122,1,1,2
33872,ElliotBayTrailMyrtlePark,11/12/2017 08:00:00 AM,48,-122,8,5,13
33873,ElliotBayTrailMyrtlePark,11/12/2017 09:00:00 AM,48,-122,7,4,11
33874,ElliotBayTrailMyrtlePark,11/12/2017 10:00:00 AM,48,-122,14,16,30
33875,ElliotBayTrailMyrtlePark,11/12/2017 11:00:00 AM,48,-122,17,17,34
33876,ElliotBayTrailMyrtlePark,11/12/2017 12:00:00 PM,48,-122,17,22,39
33877,ElliotBayTrailMyrtlePark,11/12/2017 01:00:00 PM,48,-122,27,17,44
33878,ElliotBayTrailMyrtlePark,11/12/2017 02:00:00 PM,48,-122,11,17,28
33879,ElliotBayTrailMyrtlePark,11/12/2017 03:00:00 PM,48,-122,6,2,8
33880,ElliotBayTrailMyrtlePark,11/12/2017 04:00:00 PM,48,-122,3,8,11
33881,ElliotBayTrailMyrtlePark,11/12/2017 05:00:00 PM,48,-122,1,0,1
33882,ElliotBayTrailMyrtlePark,11/12/2017 06:00:00 PM,48,-122,0,2,2
33883,ElliotBayTrailMyrtlePark,11/12/2017 07:00:00 PM,48,-122,1,3,4
33884,ElliotBayTrailMyrtlePark,11/12/2017 08:00:00 PM,48,-122,1,1,2
33885,ElliotBayTrailMyrtlePark,11/12/2017 09:00:00 PM,48,-122,3,0,3
33886,ElliotBayTrailMyrtlePark,11/12/2017 10:00:00 PM,48,-122,0,2,2
33887,ElliotBayTrailMyrtlePark,11/12/2017 11:00:00 PM,48,-122,0,0,0
33888,ElliotBayTrailMyrtlePark,11/13/2017 12:00:00 AM,48,-122,0,1,1
33889,ElliotBayTrailMyrtlePark,11/13/2017 01:00:00 AM,48,-122,1,0,1
33890,ElliotBayTrailMyrtlePark,11/13/2017 02:00:00 AM,48,-122,0,0,0
33891,ElliotBayTrailMyrtlePark,11/13/2017 03:00:00 AM,48,-122,0,1,1
33892,ElliotBayTrailMyrtlePark,11/13/2017 04:00:00 AM,48,-122,0,0,0
33893,ElliotBayTrailMyrtlePark,11/13/2017 05:00:00 AM,48,-122,5,3,8
33894,ElliotBayTrailMyrtlePark,11/13/2017 06:00:00 AM,48,-122,11,12,23
33895,ElliotBayTrailMyrtlePark,11/13/2017 07:00:00 AM,48,-122,24,54,78
33896,ElliotBayTrailMyrtlePark,11/13/2017 08:00:00 AM,48,-122,15,98,113
33897,ElliotBayTrailMyrtlePark,11/13/2017 09:00:00 AM,48,-122,15,35,50
33898,ElliotBayTrailMyrtlePark,11/13/2017 10:00:00 AM,48,-122,4,16,20
33899,ElliotBayTrailMyrtlePark,11/13/2017 11:00:00 AM,48,-122,12,11,23
33900,ElliotBayTrailMyrtlePark,11/13/2017 12:00:00 PM,48,-122,8,3,11
33901,ElliotBayTrailMyrtlePark,11/13/2017 01:00:00 PM,48,-122,3,7,10
33902,ElliotBayTrailMyrtlePark,11/13/2017 02:00:00 PM,48,-122,9,5,14
33903,ElliotBayTrailMyrtlePark,11/13/2017 03:00:00 PM,48,-122,12,15,27
33904,ElliotBayTrailMyrtlePark,11/13/2017 04:00:00 PM,48,-122,44,17,61
33905,ElliotBayTrailMyrtlePark,11/13/2017 05:00:00 PM,48,-122,74,12,86
33906,ElliotBayTrailMyrtlePark,11/13/2017 06:00:00 PM,48,-122,34,1,35
33907,ElliotBayTrailMyrtlePark,11/13/2017 07:00:00 PM,48,-122,13,1,14
33908,ElliotBayTrailMyrtlePark,11/13/2017 08:00:00 PM,48,-122,6,1,7
33909,ElliotBayTrailMyrtlePark,11/13/2017 09:00:00 PM,48,-122,3,0,3
33910,ElliotBayTrailMyrtlePark,11/13/2017 10:00:00 PM,48,-122,3,2,5
33911,ElliotBayTrailMyrtlePark,11/13/2017 11:00:00 PM,48,-122,1,0,1
33912,ElliotBayTrailMyrtlePark,11/14/2017 12:00:00 AM,48,-122,1,0,1
33913,ElliotBayTrailMyrtlePark,11/14/2017 01:00:00 AM,48,-122,0,0,0
33914,ElliotBayTrailMyrtlePark,11/14/2017 02:00:00 AM,48,-122,0,0,0
33915,ElliotBayTrailMyrtlePark,11/14/2017 03:00:00 AM,48,-122,0,1,1
33916,ElliotBayTrailMyrtlePark,11/14/2017 04:00:00 AM,48,-122,0,0,0
33917,ElliotBayTrailMyrtlePark,11/14/2017 05:00:00 AM,48,-122,6,11,17
33918,ElliotBayTrailMyrtlePark,11/14/2017 06:00:00 AM,48,-122,11,12,23
33919,ElliotBayTrailMyrtlePark,11/14/2017 07:00:00 AM,48,-122,24,69,93
33920,ElliotBayTrailMyrtlePark,11/14/2017 08:00:00 AM,48,-122,21,79,100
33921,ElliotBayTrailMyrtlePark,11/14/2017 09:00:00 AM,48,-122,14,42,56
33922,ElliotBayTrailMyrtlePark,11/14/2017 10:00:00 AM,48,-122,11,11,22
33923,ElliotBayTrailMyrtlePark,11/14/2017 11:00:00 AM,48,-122,4,7,11
33924,ElliotBayTrailMyrtlePark,11/14/2017 12:00:00 PM,48,-122,9,5,14
33925,ElliotBayTrailMyrtlePark,11/14/2017 01:00:00 PM,48,-122,8,4,12
33926,ElliotBayTrailMyrtlePark,11/14/2017 02:00:00 PM,48,-122,11,7,18
33927,ElliotBayTrailMyrtlePark,11/14/2017 03:00:00 PM,48,-122,29,11,40
33928,ElliotBayTrailMyrtlePark,11/14/2017 04:00:00 PM,48,-122,63,29,92
33929,ElliotBayTrailMyrtlePark,11/14/2017 05:00:00 PM,48,-122,97,32,129
33930,ElliotBayTrailMyrtlePark,11/14/2017 06:00:00 PM,48,-122,52,15,67
33931,ElliotBayTrailMyrtlePark,11/14/2017 07:00:00 PM,48,-122,14,5,19
33932,ElliotBayTrailMyrtlePark,11/14/2017 08:00:00 PM,48,-122,7,3,10
33933,ElliotBayTrailMyrtlePark,11/14/2017 09:00:00 PM,48,-122,7,2,9
33934,ElliotBayTrailMyrtlePark,11/14/2017 10:00:00 PM,48,-122,2,0,2
33935,ElliotBayTrailMyrtlePark,11/14/2017 11:00:00 PM,48,-122,0,0,0
33936,ElliotBayTrailMyrtlePark,11/15/2017 12:00:00 AM,48,-122,3,0,3
33937,ElliotBayTrailMyrtlePark,11/15/2017 01:00:00 AM,48,-122,1,2,3
33938,ElliotBayTrailMyrtlePark,11/15/2017 02:00:00 AM,48,-122,0,0,0
33939,ElliotBayTrailMyrtlePark,11/15/2017 03:00:00 AM,48,-122,0,2,2
33940,ElliotBayTrailMyrtlePark,11/15/2017 04:00:00 AM,48,-122,0,1,1
33941,ElliotBayTrailMyrtlePark,11/15/2017 05:00:00 AM,48,-122,2,6,8
33942,ElliotBayTrailMyrtlePark,11/15/2017 06:00:00 AM,48,-122,11,19,30
33943,ElliotBayTrailMyrtlePark,11/15/2017 07:00:00 AM,48,-122,33,53,86
33944,ElliotBayTrailMyrtlePark,11/15/2017 08:00:00 AM,48,-122,21,81,102
33945,ElliotBayTrailMyrtlePark,11/15/2017 09:00:00 AM,48,-122,12,34,46
33946,ElliotBayTrailMyrtlePark,11/15/2017 10:00:00 AM,48,-122,8,10,18
33947,ElliotBayTrailMyrtlePark,11/15/2017 11:00:00 AM,48,-122,8,5,13
33948,ElliotBayTrailMyrtlePark,11/15/2017 12:00:00 PM,48,-122,4,6,10
33949,ElliotBayTrailMyrtlePark,11/15/2017 01:00:00 PM,48,-122,8,2,10
33950,ElliotBayTrailMyrtlePark,11/15/2017 02:00:00 PM,48,-122,10,6,16
33951,ElliotBayTrailMyrtlePark,11/15/2017 03:00:00 PM,48,-122,21,18,39
33952,ElliotBayTrailMyrtlePark,11/15/2017 04:00:00 PM,48,-122,37,24,61
33953,ElliotBayTrailMyrtlePark,11/15/2017 05:00:00 PM,48,-122,91,31,122
33954,ElliotBayTrailMyrtlePark,11/15/2017 06:00:00 PM,48,-122,62,19,81
33955,ElliotBayTrailMyrtlePark,11/15/2017 07:00:00 PM,48,-122,12,3,15
33956,ElliotBayTrailMyrtlePark,11/15/2017 08:00:00 PM,48,-122,8,2,10
33957,ElliotBayTrailMyrtlePark,11/15/2017 09:00:00 PM,48,-122,8,2,10
33958,ElliotBayTrailMyrtlePark,11/15/2017 10:00:00 PM,48,-122,4,2,6
33959,ElliotBayTrailMyrtlePark,11/15/2017 11:00:00 PM,48,-122,1,0,1
33960,ElliotBayTrailMyrtlePark,11/16/2017 12:00:00 AM,48,-122,1,0,1
33961,ElliotBayTrailMyrtlePark,11/16/2017 01:00:00 AM,48,-122,0,0,0
33962,ElliotBayTrailMyrtlePark,11/16/2017 02:00:00 AM,48,-122,1,0,1
33963,ElliotBayTrailMyrtlePark,11/16/2017 03:00:00 AM,48,-122,0,1,1
33964,ElliotBayTrailMyrtlePark,11/16/2017 04:00:00 AM,48,-122,0,0,0
33965,ElliotBayTrailMyrtlePark,11/16/2017 05:00:00 AM,48,-122,8,9,17
33966,ElliotBayTrailMyrtlePark,11/16/2017 06:00:00 AM,48,-122,15,22,37
33967,ElliotBayTrailMyrtlePark,11/16/2017 07:00:00 AM,48,-122,37,50,87
33968,ElliotBayTrailMyrtlePark,11/16/2017 08:00:00 AM,48,-122,27,90,117
33969,ElliotBayTrailMyrtlePark,11/16/2017 09:00:00 AM,48,-122,14,37,51
33970,ElliotBayTrailMyrtlePark,11/16/2017 10:00:00 AM,48,-122,7,12,19
33971,ElliotBayTrailMyrtlePark,11/16/2017 11:00:00 AM,48,-122,6,8,14
33972,ElliotBayTrailMyrtlePark,11/16/2017 12:00:00 PM,48,-122,6,9,15
33973,ElliotBayTrailMyrtlePark,11/16/2017 01:00:00 PM,48,-122,10,3,13
33974,ElliotBayTrailMyrtlePark,11/16/2017 02:00:00 PM,48,-122,14,7,21
33975,ElliotBayTrailMyrtlePark,11/16/2017 03:00:00 PM,48,-122,17,21,38
33976,ElliotBayTrailMyrtlePark,11/16/2017 04:00:00 PM,48,-122,46,27,73
33977,ElliotBayTrailMyrtlePark,11/16/2017 05:00:00 PM,48,-122,109,30,139
33978,ElliotBayTrailMyrtlePark,11/16/2017 06:00:00 PM,48,-122,60,20,80
33979,ElliotBayTrailMyrtlePark,11/16/2017 07:00:00 PM,48,-122,19,6,25
33980,ElliotBayTrailMyrtlePark,11/16/2017 08:00:00 PM,48,-122,8,3,11
33981,ElliotBayTrailMyrtlePark,11/16/2017 09:00:00 PM,48,-122,2,3,5
33982,ElliotBayTrailMyrtlePark,11/16/2017 10:00:00 PM,48,-122,4,1,5
33983,ElliotBayTrailMyrtlePark,11/16/2017 11:00:00 PM,48,-122,2,6,8
33984,ElliotBayTrailMyrtlePark,11/17/2017 12:00:00 AM,48,-122,0,3,3
33985,ElliotBayTrailMyrtlePark,11/17/2017 01:00:00 AM,48,-122,0,0,0
33986,ElliotBayTrailMyrtlePark,11/17/2017 02:00:00 AM,48,-122,1,0,1
33987,ElliotBayTrailMyrtlePark,11/17/2017 03:00:00 AM,48,-122,0,1,1
33988,ElliotBayTrailMyrtlePark,11/17/2017 04:00:00 AM,48,-122,1,0,1
33989,ElliotBayTrailMyrtlePark,11/17/2017 05:00:00 AM,48,-122,3,8,11
33990,ElliotBayTrailMyrtlePark,11/17/2017 06:00:00 AM,48,-122,12,20,32
33991,ElliotBayTrailMyrtlePark,11/17/2017 07:00:00 AM,48,-122,33,53,86
33992,ElliotBayTrailMyrtlePark,11/17/2017 08:00:00 AM,48,-122,37,119,156
33993,ElliotBayTrailMyrtlePark,11/17/2017 09:00:00 AM,48,-122,16,42,58
33994,ElliotBayTrailMyrtlePark,11/17/2017 10:00:00 AM,48,-122,8,19,27
33995,ElliotBayTrailMyrtlePark,11/17/2017 11:00:00 AM,48,-122,13,17,30
33996,ElliotBayTrailMyrtlePark,11/17/2017 12:00:00 PM,48,-122,16,13,29
33997,ElliotBayTrailMyrtlePark,11/17/2017 01:00:00 PM,48,-122,14,14,28
33998,ElliotBayTrailMyrtlePark,11/17/2017 02:00:00 PM,48,-122,24,21,45
33999,ElliotBayTrailMyrtlePark,11/17/2017 03:00:00 PM,48,-122,32,28,60
34000,ElliotBayTrailMyrtlePark,11/17/2017 04:00:00 PM,48,-122,61,43,104
34001,ElliotBayTrailMyrtlePark,11/17/2017 05:00:00 PM,48,-122,118,34,152
34002,ElliotBayTrailMyrtlePark,11/17/2017 06:00:00 PM,48,-122,53,15,68
34003,ElliotBayTrailMyrtlePark,11/17/2017 07:00:00 PM,48,-122,9,4,13
34004,ElliotBayTrailMyrtlePark,11/17/2017 08:00:00 PM,48,-122,8,1,9
34005,ElliotBayTrailMyrtlePark,11/17/2017 09:00:00 PM,48,-122,3,1,4
34006,ElliotBayTrailMyrtlePark,11/17/2017 10:00:00 PM,48,-122,3,5,8
34007,ElliotBayTrailMyrtlePark,11/17/2017 11:00:00 PM,48,-122,4,0,4
34008,ElliotBayTrailMyrtlePark,11/18/2017 12:00:00 AM,48,-122,4,1,5
34009,ElliotBayTrailMyrtlePark,11/18/2017 01:00:00 AM,48,-122,1,0,1
34010,ElliotBayTrailMyrtlePark,11/18/2017 02:00:00 AM,48,-122,1,2,3
34011,ElliotBayTrailMyrtlePark,11/18/2017 03:00:00 AM,48,-122,0,0,0
34012,ElliotBayTrailMyrtlePark,11/18/2017 04:00:00 AM,48,-122,0,0,0
34013,ElliotBayTrailMyrtlePark,11/18/2017 05:00:00 AM,48,-122,1,0,1
34014,ElliotBayTrailMyrtlePark,11/18/2017 06:00:00 AM,48,-122,2,3,5
34015,ElliotBayTrailMyrtlePark,11/18/2017 07:00:00 AM,48,-122,7,2,9
34016,ElliotBayTrailMyrtlePark,11/18/2017 08:00:00 AM,48,-122,10,14,24
34017,ElliotBayTrailMyrtlePark,11/18/2017 09:00:00 AM,48,-122,13,18,31
34018,ElliotBayTrailMyrtlePark,11/18/2017 10:00:00 AM,48,-122,24,32,56
34019,ElliotBayTrailMyrtlePark,11/18/2017 11:00:00 AM,48,-122,22,32,54
34020,ElliotBayTrailMyrtlePark,11/18/2017 12:00:00 PM,48,-122,57,33,90
34021,ElliotBayTrailMyrtlePark,11/18/2017 01:00:00 PM,48,-122,37,44,81
34022,ElliotBayTrailMyrtlePark,11/18/2017 02:00:00 PM,48,-122,48,46,94
34023,ElliotBayTrailMyrtlePark,11/18/2017 03:00:00 PM,48,-122,64,51,115
34024,ElliotBayTrailMyrtlePark,11/18/2017 04:00:00 PM,48,-122,51,35,86
34025,ElliotBayTrailMyrtlePark,11/18/2017 05:00:00 PM,48,-122,21,17,38
34026,ElliotBayTrailMyrtlePark,11/18/2017 06:00:00 PM,48,-122,12,7,19
34027,ElliotBayTrailMyrtlePark,11/18/2017 07:00:00 PM,48,-122,10,3,13
34028,ElliotBayTrailMyrtlePark,11/18/2017 08:00:00 PM,48,-122,0,3,3
34029,ElliotBayTrailMyrtlePark,11/18/2017 09:00:00 PM,48,-122,5,5,10
34030,ElliotBayTrailMyrtlePark,11/18/2017 10:00:00 PM,48,-122,2,1,3
34031,ElliotBayTrailMyrtlePark,11/18/2017 11:00:00 PM,48,-122,1,0,1
34032,ElliotBayTrailMyrtlePark,11/19/2017 12:00:00 AM,48,-122,2,2,4
34033,ElliotBayTrailMyrtlePark,11/19/2017 01:00:00 AM,48,-122,0,1,1
34034,ElliotBayTrailMyrtlePark,11/19/2017 02:00:00 AM,48,-122,3,0,3
34035,ElliotBayTrailMyrtlePark,11/19/2017 03:00:00 AM,48,-122,2,1,3
34036,ElliotBayTrailMyrtlePark,11/19/2017 04:00:00 AM,48,-122,0,0,0
34037,ElliotBayTrailMyrtlePark,11/19/2017 05:00:00 AM,48,-122,0,0,0
34038,ElliotBayTrailMyrtlePark,11/19/2017 06:00:00 AM,48,-122,3,1,4
34039,ElliotBayTrailMyrtlePark,11/19/2017 07:00:00 AM,48,-122,4,4,8
34040,ElliotBayTrailMyrtlePark,11/19/2017 08:00:00 AM,48,-122,4,5,9
34041,ElliotBayTrailMyrtlePark,11/19/2017 09:00:00 AM,48,-122,16,20,36
34042,ElliotBayTrailMyrtlePark,11/19/2017 10:00:00 AM,48,-122,26,18,44
34043,ElliotBayTrailMyrtlePark,11/19/2017 11:00:00 AM,48,-122,24,21,45
34044,ElliotBayTrailMyrtlePark,11/19/2017 12:00:00 PM,48,-122,31,24,55
34045,ElliotBayTrailMyrtlePark,11/19/2017 01:00:00 PM,48,-122,16,15,31
34046,ElliotBayTrailMyrtlePark,11/19/2017 02:00:00 PM,48,-122,16,14,30
34047,ElliotBayTrailMyrtlePark,11/19/2017 03:00:00 PM,48,-122,11,8,19
34048,ElliotBayTrailMyrtlePark,11/19/2017 04:00:00 PM,48,-122,2,7,9
34049,ElliotBayTrailMyrtlePark,11/19/2017 05:00:00 PM,48,-122,12,9,21
34050,ElliotBayTrailMyrtlePark,11/19/2017 06:00:00 PM,48,-122,1,1,2
34051,ElliotBayTrailMyrtlePark,11/19/2017 07:00:00 PM,48,-122,1,1,2
34052,ElliotBayTrailMyrtlePark,11/19/2017 08:00:00 PM,48,-122,0,1,1
34053,ElliotBayTrailMyrtlePark,11/19/2017 09:00:00 PM,48,-122,1,0,1
34054,ElliotBayTrailMyrtlePark,11/19/2017 10:00:00 PM,48,-122,2,0,2
34055,ElliotBayTrailMyrtlePark,11/19/2017 11:00:00 PM,48,-122,2,1,3
34056,ElliotBayTrailMyrtlePark,11/20/2017 12:00:00 AM,48,-122,0,0,0
34057,ElliotBayTrailMyrtlePark,11/20/2017 01:00:00 AM,48,-122,0,0,0
34058,ElliotBayTrailMyrtlePark,11/20/2017 02:00:00 AM,48,-122,0,0,0
34059,ElliotBayTrailMyrtlePark,11/20/2017 03:00:00 AM,48,-122,1,1,2
34060,ElliotBayTrailMyrtlePark,11/20/2017 04:00:00 AM,48,-122,0,0,0
34061,ElliotBayTrailMyrtlePark,11/20/2017 05:00:00 AM,48,-122,5,10,15
34062,ElliotBayTrailMyrtlePark,11/20/2017 06:00:00 AM,48,-122,22,21,43
34063,ElliotBayTrailMyrtlePark,11/20/2017 07:00:00 AM,48,-122,27,46,73
34064,ElliotBayTrailMyrtlePark,11/20/2017 08:00:00 AM,48,-122,19,65,84
34065,ElliotBayTrailMyrtlePark,11/20/2017 09:00:00 AM,48,-122,16,46,62
34066,ElliotBayTrailMyrtlePark,11/20/2017 10:00:00 AM,48,-122,7,10,17
34067,ElliotBayTrailMyrtlePark,11/20/2017 11:00:00 AM,48,-122,12,11,23
34068,ElliotBayTrailMyrtlePark,11/20/2017 12:00:00 PM,48,-122,11,10,21
34069,ElliotBayTrailMyrtlePark,11/20/2017 01:00:00 PM,48,-122,13,15,28
34070,ElliotBayTrailMyrtlePark,11/20/2017 02:00:00 PM,48,-122,4,8,12
34071,ElliotBayTrailMyrtlePark,11/20/2017 03:00:00 PM,48,-122,24,19,43
34072,ElliotBayTrailMyrtlePark,11/20/2017 04:00:00 PM,48,-122,55,35,90
34073,ElliotBayTrailMyrtlePark,11/20/2017 05:00:00 PM,48,-122,85,27,112
34074,ElliotBayTrailMyrtlePark,11/20/2017 06:00:00 PM,48,-122,33,3,36
34075,ElliotBayTrailMyrtlePark,11/20/2017 07:00:00 PM,48,-122,17,3,20
34076,ElliotBayTrailMyrtlePark,11/20/2017 08:00:00 PM,48,-122,5,3,8
34077,ElliotBayTrailMyrtlePark,11/20/2017 09:00:00 PM,48,-122,5,1,6
34078,ElliotBayTrailMyrtlePark,11/20/2017 10:00:00 PM,48,-122,0,0,0
34079,ElliotBayTrailMyrtlePark,11/20/2017 11:00:00 PM,48,-122,3,2,5
34080,ElliotBayTrailMyrtlePark,11/21/2017 12:00:00 AM,48,-122,0,0,0
34081,ElliotBayTrailMyrtlePark,11/21/2017 01:00:00 AM,48,-122,1,1,2
34082,ElliotBayTrailMyrtlePark,11/21/2017 02:00:00 AM,48,-122,0,0,0
34083,ElliotBayTrailMyrtlePark,11/21/2017 03:00:00 AM,48,-122,0,1,1
34084,ElliotBayTrailMyrtlePark,11/21/2017 04:00:00 AM,48,-122,0,0,0
34085,ElliotBayTrailMyrtlePark,11/21/2017 05:00:00 AM,48,-122,6,5,11
34086,ElliotBayTrailMyrtlePark,11/21/2017 06:00:00 AM,48,-122,15,6,21
34087,ElliotBayTrailMyrtlePark,11/21/2017 07:00:00 AM,48,-122,28,49,77
34088,ElliotBayTrailMyrtlePark,11/21/2017 08:00:00 AM,48,-122,17,69,86
34089,ElliotBayTrailMyrtlePark,11/21/2017 09:00:00 AM,48,-122,9,25,34
34090,ElliotBayTrailMyrtlePark,11/21/2017 10:00:00 AM,48,-122,6,6,12
34091,ElliotBayTrailMyrtlePark,11/21/2017 11:00:00 AM,48,-122,5,5,10
34092,ElliotBayTrailMyrtlePark,11/21/2017 12:00:00 PM,48,-122,7,6,13
34093,ElliotBayTrailMyrtlePark,11/21/2017 01:00:00 PM,48,-122,3,0,3
34094,ElliotBayTrailMyrtlePark,11/21/2017 02:00:00 PM,48,-122,10,9,19
34095,ElliotBayTrailMyrtlePark,11/21/2017 03:00:00 PM,48,-122,7,13,20
34096,ElliotBayTrailMyrtlePark,11/21/2017 04:00:00 PM,48,-122,41,27,68
34097,ElliotBayTrailMyrtlePark,11/21/2017 05:00:00 PM,48,-122,71,15,86
34098,ElliotBayTrailMyrtlePark,11/21/2017 06:00:00 PM,48,-122,48,10,58
34099,ElliotBayTrailMyrtlePark,11/21/2017 07:00:00 PM,48,-122,13,2,15
34100,ElliotBayTrailMyrtlePark,11/21/2017 08:00:00 PM,48,-122,3,3,6
34101,ElliotBayTrailMyrtlePark,11/21/2017 09:00:00 PM,48,-122,2,0,2
34102,ElliotBayTrailMyrtlePark,11/21/2017 10:00:00 PM,48,-122,1,1,2
34103,ElliotBayTrailMyrtlePark,11/21/2017 11:00:00 PM,48,-122,1,1,2
34104,ElliotBayTrailMyrtlePark,11/22/2017 12:00:00 AM,48,-122,0,0,0
34105,ElliotBayTrailMyrtlePark,11/22/2017 01:00:00 AM,48,-122,0,0,0
34106,ElliotBayTrailMyrtlePark,11/22/2017 02:00:00 AM,48,-122,0,0,0
34107,ElliotBayTrailMyrtlePark,11/22/2017 03:00:00 AM,48,-122,1,0,1
34108,ElliotBayTrailMyrtlePark,11/22/2017 04:00:00 AM,48,-122,1,1,2
34109,ElliotBayTrailMyrtlePark,11/22/2017 05:00:00 AM,48,-122,6,10,16
34110,ElliotBayTrailMyrtlePark,11/22/2017 06:00:00 AM,48,-122,19,13,32
34111,ElliotBayTrailMyrtlePark,11/22/2017 07:00:00 AM,48,-122,28,41,69
34112,ElliotBayTrailMyrtlePark,11/22/2017 08:00:00 AM,48,-122,22,73,95
34113,ElliotBayTrailMyrtlePark,11/22/2017 09:00:00 AM,48,-122,14,27,41
34114,ElliotBayTrailMyrtlePark,11/22/2017 10:00:00 AM,48,-122,11,6,17
34115,ElliotBayTrailMyrtlePark,11/22/2017 11:00:00 AM,48,-122,15,18,33
34116,ElliotBayTrailMyrtlePark,11/22/2017 12:00:00 PM,48,-122,15,8,23
34117,ElliotBayTrailMyrtlePark,11/22/2017 01:00:00 PM,48,-122,20,9,29
34118,ElliotBayTrailMyrtlePark,11/22/2017 02:00:00 PM,48,-122,42,27,69
34119,ElliotBayTrailMyrtlePark,11/22/2017 03:00:00 PM,48,-122,57,24,81
34120,ElliotBayTrailMyrtlePark,11/22/2017 04:00:00 PM,48,-122,64,36,100
34121,ElliotBayTrailMyrtlePark,11/22/2017 05:00:00 PM,48,-122,52,26,78
34122,ElliotBayTrailMyrtlePark,11/22/2017 06:00:00 PM,48,-122,7,3,10
34123,ElliotBayTrailMyrtlePark,11/22/2017 07:00:00 PM,48,-122,10,4,14
34124,ElliotBayTrailMyrtlePark,11/22/2017 08:00:00 PM,48,-122,3,2,5
34125,ElliotBayTrailMyrtlePark,11/22/2017 09:00:00 PM,48,-122,4,1,5
34126,ElliotBayTrailMyrtlePark,11/22/2017 10:00:00 PM,48,-122,1,0,1
34127,ElliotBayTrailMyrtlePark,11/22/2017 11:00:00 PM,48,-122,0,1,1
34128,ElliotBayTrailMyrtlePark,11/23/2017 12:00:00 AM,48,-122,0,0,0
34129,ElliotBayTrailMyrtlePark,11/23/2017 01:00:00 AM,48,-122,0,1,1
34130,ElliotBayTrailMyrtlePark,11/23/2017 02:00:00 AM,48,-122,1,0,1
34131,ElliotBayTrailMyrtlePark,11/23/2017 03:00:00 AM,48,-122,1,0,1
34132,ElliotBayTrailMyrtlePark,11/23/2017 04:00:00 AM,48,-122,2,1,3
34133,ElliotBayTrailMyrtlePark,11/23/2017 05:00:00 AM,48,-122,0,7,7
34134,ElliotBayTrailMyrtlePark,11/23/2017 06:00:00 AM,48,-122,0,1,1
34135,ElliotBayTrailMyrtlePark,11/23/2017 07:00:00 AM,48,-122,2,0,2
34136,ElliotBayTrailMyrtlePark,11/23/2017 08:00:00 AM,48,-122,9,6,15
34137,ElliotBayTrailMyrtlePark,11/23/2017 09:00:00 AM,48,-122,14,15,29
34138,ElliotBayTrailMyrtlePark,11/23/2017 10:00:00 AM,48,-122,11,2,13
34139,ElliotBayTrailMyrtlePark,11/23/2017 11:00:00 AM,48,-122,6,5,11
34140,ElliotBayTrailMyrtlePark,11/23/2017 12:00:00 PM,48,-122,5,9,14
34141,ElliotBayTrailMyrtlePark,11/23/2017 01:00:00 PM,48,-122,5,3,8
34142,ElliotBayTrailMyrtlePark,11/23/2017 02:00:00 PM,48,-122,7,10,17
34143,ElliotBayTrailMyrtlePark,11/23/2017 03:00:00 PM,48,-122,16,18,34
34144,ElliotBayTrailMyrtlePark,11/23/2017 04:00:00 PM,48,-122,12,23,35
34145,ElliotBayTrailMyrtlePark,11/23/2017 05:00:00 PM,48,-122,1,2,3
34146,ElliotBayTrailMyrtlePark,11/23/2017 06:00:00 PM,48,-122,6,1,7
34147,ElliotBayTrailMyrtlePark,11/23/2017 07:00:00 PM,48,-122,3,1,4
34148,ElliotBayTrailMyrtlePark,11/23/2017 08:00:00 PM,48,-122,2,0,2
34149,ElliotBayTrailMyrtlePark,11/23/2017 09:00:00 PM,48,-122,4,1,5
34150,ElliotBayTrailMyrtlePark,11/23/2017 10:00:00 PM,48,-122,2,0,2
34151,ElliotBayTrailMyrtlePark,11/23/2017 11:00:00 PM,48,-122,1,0,1
34152,ElliotBayTrailMyrtlePark,11/24/2017 12:00:00 AM,48,-122,0,0,0
34153,ElliotBayTrailMyrtlePark,11/24/2017 01:00:00 AM,48,-122,0,0,0
34154,ElliotBayTrailMyrtlePark,11/24/2017 02:00:00 AM,48,-122,0,0,0
34155,ElliotBayTrailMyrtlePark,11/24/2017 03:00:00 AM,48,-122,1,1,2
34156,ElliotBayTrailMyrtlePark,11/24/2017 04:00:00 AM,48,-122,0,0,0
34157,ElliotBayTrailMyrtlePark,11/24/2017 05:00:00 AM,48,-122,1,1,2
34158,ElliotBayTrailMyrtlePark,11/24/2017 06:00:00 AM,48,-122,3,0,3
34159,ElliotBayTrailMyrtlePark,11/24/2017 07:00:00 AM,48,-122,1,5,6
34160,ElliotBayTrailMyrtlePark,11/24/2017 08:00:00 AM,48,-122,5,9,14
34161,ElliotBayTrailMyrtlePark,11/24/2017 09:00:00 AM,48,-122,9,13,22
34162,ElliotBayTrailMyrtlePark,11/24/2017 10:00:00 AM,48,-122,29,24,53
34163,ElliotBayTrailMyrtlePark,11/24/2017 11:00:00 AM,48,-122,17,29,46
34164,ElliotBayTrailMyrtlePark,11/24/2017 12:00:00 PM,48,-122,25,22,47
34165,ElliotBayTrailMyrtlePark,11/24/2017 01:00:00 PM,48,-122,25,25,50
34166,ElliotBayTrailMyrtlePark,11/24/2017 02:00:00 PM,48,-122,25,20,45
34167,ElliotBayTrailMyrtlePark,11/24/2017 03:00:00 PM,48,-122,20,19,39
34168,ElliotBayTrailMyrtlePark,11/24/2017 04:00:00 PM,48,-122,22,15,37
34169,ElliotBayTrailMyrtlePark,11/24/2017 05:00:00 PM,48,-122,9,1,10
34170,ElliotBayTrailMyrtlePark,11/24/2017 06:00:00 PM,48,-122,5,4,9
34171,ElliotBayTrailMyrtlePark,11/24/2017 07:00:00 PM,48,-122,8,1,9
34172,ElliotBayTrailMyrtlePark,11/24/2017 08:00:00 PM,48,-122,0,1,1
34173,ElliotBayTrailMyrtlePark,11/24/2017 09:00:00 PM,48,-122,1,1,2
34174,ElliotBayTrailMyrtlePark,11/24/2017 10:00:00 PM,48,-122,2,2,4
34175,ElliotBayTrailMyrtlePark,11/24/2017 11:00:00 PM,48,-122,4,0,4
34176,ElliotBayTrailMyrtlePark,11/25/2017 12:00:00 AM,48,-122,0,0,0
34177,ElliotBayTrailMyrtlePark,11/25/2017 01:00:00 AM,48,-122,0,1,1
34178,ElliotBayTrailMyrtlePark,11/25/2017 02:00:00 AM,48,-122,0,0,0
34179,ElliotBayTrailMyrtlePark,11/25/2017 03:00:00 AM,48,-122,0,0,0
34180,ElliotBayTrailMyrtlePark,11/25/2017 04:00:00 AM,48,-122,0,0,0
34181,ElliotBayTrailMyrtlePark,11/25/2017 05:00:00 AM,48,-122,1,0,1
34182,ElliotBayTrailMyrtlePark,11/25/2017 06:00:00 AM,48,-122,2,1,3
34183,ElliotBayTrailMyrtlePark,11/25/2017 07:00:00 AM,48,-122,4,2,6
34184,ElliotBayTrailMyrtlePark,11/25/2017 08:00:00 AM,48,-122,13,14,27
34185,ElliotBayTrailMyrtlePark,11/25/2017 09:00:00 AM,48,-122,26,21,47
34186,ElliotBayTrailMyrtlePark,11/25/2017 10:00:00 AM,48,-122,19,22,41
34187,ElliotBayTrailMyrtlePark,11/25/2017 11:00:00 AM,48,-122,27,28,55
34188,ElliotBayTrailMyrtlePark,11/25/2017 12:00:00 PM,48,-122,23,36,59
34189,ElliotBayTrailMyrtlePark,11/25/2017 01:00:00 PM,48,-122,33,20,53
34190,ElliotBayTrailMyrtlePark,11/25/2017 02:00:00 PM,48,-122,30,30,60
34191,ElliotBayTrailMyrtlePark,11/25/2017 03:00:00 PM,48,-122,13,25,38
34192,ElliotBayTrailMyrtlePark,11/25/2017 04:00:00 PM,48,-122,9,4,13
34193,ElliotBayTrailMyrtlePark,11/25/2017 05:00:00 PM,48,-122,12,2,14
34194,ElliotBayTrailMyrtlePark,11/25/2017 06:00:00 PM,48,-122,9,2,11
34195,ElliotBayTrailMyrtlePark,11/25/2017 07:00:00 PM,48,-122,1,0,1
34196,ElliotBayTrailMyrtlePark,11/25/2017 08:00:00 PM,48,-122,0,2,2
34197,ElliotBayTrailMyrtlePark,11/25/2017 09:00:00 PM,48,-122,2,7,9
34198,ElliotBayTrailMyrtlePark,11/25/2017 10:00:00 PM,48,-122,1,0,1
34199,ElliotBayTrailMyrtlePark,11/25/2017 11:00:00 PM,48,-122,1,0,1
34200,ElliotBayTrailMyrtlePark,11/26/2017 12:00:00 AM,48,-122,2,1,3
34201,ElliotBayTrailMyrtlePark,11/26/2017 01:00:00 AM,48,-122,1,1,2
34202,ElliotBayTrailMyrtlePark,11/26/2017 02:00:00 AM,48,-122,0,0,0
34203,ElliotBayTrailMyrtlePark,11/26/2017 03:00:00 AM,48,-122,0,0,0
34204,ElliotBayTrailMyrtlePark,11/26/2017 04:00:00 AM,48,-122,0,1,1
34205,ElliotBayTrailMyrtlePark,11/26/2017 05:00:00 AM,48,-122,0,0,0
34206,ElliotBayTrailMyrtlePark,11/26/2017 06:00:00 AM,48,-122,0,0,0
34207,ElliotBayTrailMyrtlePark,11/26/2017 07:00:00 AM,48,-122,1,2,3
34208,ElliotBayTrailMyrtlePark,11/26/2017 08:00:00 AM,48,-122,5,1,6
34209,ElliotBayTrailMyrtlePark,11/26/2017 09:00:00 AM,48,-122,10,10,20
34210,ElliotBayTrailMyrtlePark,11/26/2017 10:00:00 AM,48,-122,12,12,24
34211,ElliotBayTrailMyrtlePark,11/26/2017 11:00:00 AM,48,-122,25,20,45
34212,ElliotBayTrailMyrtlePark,11/26/2017 12:00:00 PM,48,-122,6,11,17
34213,ElliotBayTrailMyrtlePark,11/26/2017 01:00:00 PM,48,-122,4,4,8
34214,ElliotBayTrailMyrtlePark,11/26/2017 02:00:00 PM,48,-122,6,2,8
34215,ElliotBayTrailMyrtlePark,11/26/2017 03:00:00 PM,48,-122,5,4,9
34216,ElliotBayTrailMyrtlePark,11/26/2017 04:00:00 PM,48,-122,14,1,15
34217,ElliotBayTrailMyrtlePark,11/26/2017 05:00:00 PM,48,-122,3,8,11
34218,ElliotBayTrailMyrtlePark,11/26/2017 06:00:00 PM,48,-122,1,2,3
34219,ElliotBayTrailMyrtlePark,11/26/2017 07:00:00 PM,48,-122,2,1,3
34220,ElliotBayTrailMyrtlePark,11/26/2017 08:00:00 PM,48,-122,0,2,2
34221,ElliotBayTrailMyrtlePark,11/26/2017 09:00:00 PM,48,-122,2,0,2
34222,ElliotBayTrailMyrtlePark,11/26/2017 10:00:00 PM,48,-122,1,0,1
34223,ElliotBayTrailMyrtlePark,11/26/2017 11:00:00 PM,48,-122,0,0,0
34224,ElliotBayTrailMyrtlePark,11/27/2017 12:00:00 AM,48,-122,0,0,0
34225,ElliotBayTrailMyrtlePark,11/27/2017 01:00:00 AM,48,-122,1,0,1
34226,ElliotBayTrailMyrtlePark,11/27/2017 02:00:00 AM,48,-122,0,1,1
34227,ElliotBayTrailMyrtlePark,11/27/2017 03:00:00 AM,48,-122,0,1,1
34228,ElliotBayTrailMyrtlePark,11/27/2017 04:00:00 AM,48,-122,0,0,0
34229,ElliotBayTrailMyrtlePark,11/27/2017 05:00:00 AM,48,-122,6,6,12
34230,ElliotBayTrailMyrtlePark,11/27/2017 06:00:00 AM,48,-122,19,27,46
34231,ElliotBayTrailMyrtlePark,11/27/2017 07:00:00 AM,48,-122,31,74,105
34232,ElliotBayTrailMyrtlePark,11/27/2017 08:00:00 AM,48,-122,27,134,161
34233,ElliotBayTrailMyrtlePark,11/27/2017 09:00:00 AM,48,-122,19,62,81
34234,ElliotBayTrailMyrtlePark,11/27/2017 10:00:00 AM,48,-122,13,15,28
34235,ElliotBayTrailMyrtlePark,11/27/2017 11:00:00 AM,48,-122,11,12,23
34236,ElliotBayTrailMyrtlePark,11/27/2017 12:00:00 PM,48,-122,15,13,28
34237,ElliotBayTrailMyrtlePark,11/27/2017 01:00:00 PM,48,-122,8,8,16
34238,ElliotBayTrailMyrtlePark,11/27/2017 02:00:00 PM,48,-122,24,15,39
34239,ElliotBayTrailMyrtlePark,11/27/2017 03:00:00 PM,48,-122,32,34,66
34240,ElliotBayTrailMyrtlePark,11/27/2017 04:00:00 PM,48,-122,72,49,121
34241,ElliotBayTrailMyrtlePark,11/27/2017 05:00:00 PM,48,-122,157,41,198
34242,ElliotBayTrailMyrtlePark,11/27/2017 06:00:00 PM,48,-122,68,12,80
34243,ElliotBayTrailMyrtlePark,11/27/2017 07:00:00 PM,48,-122,26,5,31
34244,ElliotBayTrailMyrtlePark,11/27/2017 08:00:00 PM,48,-122,4,4,8
34245,ElliotBayTrailMyrtlePark,11/27/2017 09:00:00 PM,48,-122,5,1,6
34246,ElliotBayTrailMyrtlePark,11/27/2017 10:00:00 PM,48,-122,3,5,8
34247,ElliotBayTrailMyrtlePark,11/27/2017 11:00:00 PM,48,-122,0,1,1
34248,ElliotBayTrailMyrtlePark,11/28/2017 12:00:00 AM,48,-122,0,0,0
34249,ElliotBayTrailMyrtlePark,11/28/2017 01:00:00 AM,48,-122,4,1,5
34250,ElliotBayTrailMyrtlePark,11/28/2017 02:00:00 AM,48,-122,1,0,1
34251,ElliotBayTrailMyrtlePark,11/28/2017 03:00:00 AM,48,-122,0,1,1
34252,ElliotBayTrailMyrtlePark,11/28/2017 04:00:00 AM,48,-122,0,1,1
34253,ElliotBayTrailMyrtlePark,11/28/2017 05:00:00 AM,48,-122,5,6,11
34254,ElliotBayTrailMyrtlePark,11/28/2017 06:00:00 AM,48,-122,17,19,36
34255,ElliotBayTrailMyrtlePark,11/28/2017 07:00:00 AM,48,-122,27,53,80
34256,ElliotBayTrailMyrtlePark,11/28/2017 08:00:00 AM,48,-122,29,93,122
34257,ElliotBayTrailMyrtlePark,11/28/2017 09:00:00 AM,48,-122,13,41,54
34258,ElliotBayTrailMyrtlePark,11/28/2017 10:00:00 AM,48,-122,7,9,16
34259,ElliotBayTrailMyrtlePark,11/28/2017 11:00:00 AM,48,-122,3,5,8
34260,ElliotBayTrailMyrtlePark,11/28/2017 12:00:00 PM,48,-122,3,2,5
34261,ElliotBayTrailMyrtlePark,11/28/2017 01:00:00 PM,48,-122,5,4,9
34262,ElliotBayTrailMyrtlePark,11/28/2017 02:00:00 PM,48,-122,6,5,11
34263,ElliotBayTrailMyrtlePark,11/28/2017 03:00:00 PM,48,-122,10,12,22
34264,ElliotBayTrailMyrtlePark,11/28/2017 04:00:00 PM,48,-122,42,31,73
34265,ElliotBayTrailMyrtlePark,11/28/2017 05:00:00 PM,48,-122,94,26,120
34266,ElliotBayTrailMyrtlePark,11/28/2017 06:00:00 PM,48,-122,66,18,84
34267,ElliotBayTrailMyrtlePark,11/28/2017 07:00:00 PM,48,-122,11,3,14
34268,ElliotBayTrailMyrtlePark,11/28/2017 08:00:00 PM,48,-122,3,2,5
34269,ElliotBayTrailMyrtlePark,11/28/2017 09:00:00 PM,48,-122,3,5,8
34270,ElliotBayTrailMyrtlePark,11/28/2017 10:00:00 PM,48,-122,2,0,2
34271,ElliotBayTrailMyrtlePark,11/28/2017 11:00:00 PM,48,-122,1,0,1
34272,ElliotBayTrailMyrtlePark,11/29/2017 12:00:00 AM,48,-122,0,0,0
34273,ElliotBayTrailMyrtlePark,11/29/2017 01:00:00 AM,48,-122,1,1,2
34274,ElliotBayTrailMyrtlePark,11/29/2017 02:00:00 AM,48,-122,2,0,2
34275,ElliotBayTrailMyrtlePark,11/29/2017 03:00:00 AM,48,-122,0,2,2
34276,ElliotBayTrailMyrtlePark,11/29/2017 04:00:00 AM,48,-122,0,0,0
34277,ElliotBayTrailMyrtlePark,11/29/2017 05:00:00 AM,48,-122,7,0,7
34278,ElliotBayTrailMyrtlePark,11/29/2017 06:00:00 AM,48,-122,26,22,48
34279,ElliotBayTrailMyrtlePark,11/29/2017 07:00:00 AM,48,-122,34,65,99
34280,ElliotBayTrailMyrtlePark,11/29/2017 08:00:00 AM,48,-122,29,119,148
34281,ElliotBayTrailMyrtlePark,11/29/2017 09:00:00 AM,48,-122,16,52,68
34282,ElliotBayTrailMyrtlePark,11/29/2017 10:00:00 AM,48,-122,14,12,26
34283,ElliotBayTrailMyrtlePark,11/29/2017 11:00:00 AM,48,-122,11,7,18
34284,ElliotBayTrailMyrtlePark,11/29/2017 12:00:00 PM,48,-122,7,14,21
34285,ElliotBayTrailMyrtlePark,11/29/2017 01:00:00 PM,48,-122,13,13,26
34286,ElliotBayTrailMyrtlePark,11/29/2017 02:00:00 PM,48,-122,23,20,43
34287,ElliotBayTrailMyrtlePark,11/29/2017 03:00:00 PM,48,-122,35,26,61
34288,ElliotBayTrailMyrtlePark,11/29/2017 04:00:00 PM,48,-122,64,35,99
34289,ElliotBayTrailMyrtlePark,11/29/2017 05:00:00 PM,48,-122,131,34,165
34290,ElliotBayTrailMyrtlePark,11/29/2017 06:00:00 PM,48,-122,68,18,86
34291,ElliotBayTrailMyrtlePark,11/29/2017 07:00:00 PM,48,-122,28,6,34
34292,ElliotBayTrailMyrtlePark,11/29/2017 08:00:00 PM,48,-122,3,4,7
34293,ElliotBayTrailMyrtlePark,11/29/2017 09:00:00 PM,48,-122,6,2,8
34294,ElliotBayTrailMyrtlePark,11/29/2017 10:00:00 PM,48,-122,4,1,5
34295,ElliotBayTrailMyrtlePark,11/29/2017 11:00:00 PM,48,-122,2,0,2
34296,ElliotBayTrailMyrtlePark,11/30/2017 12:00:00 AM,48,-122,1,0,1
34297,ElliotBayTrailMyrtlePark,11/30/2017 01:00:00 AM,48,-122,2,1,3
34298,ElliotBayTrailMyrtlePark,11/30/2017 02:00:00 AM,48,-122,0,0,0
34299,ElliotBayTrailMyrtlePark,11/30/2017 03:00:00 AM,48,-122,0,2,2
34300,ElliotBayTrailMyrtlePark,11/30/2017 04:00:00 AM,48,-122,0,1,1
34301,ElliotBayTrailMyrtlePark,11/30/2017 05:00:00 AM,48,-122,4,8,12
34302,ElliotBayTrailMyrtlePark,11/30/2017 06:00:00 AM,48,-122,15,18,33
34303,ElliotBayTrailMyrtlePark,11/30/2017 07:00:00 AM,48,-122,36,47,83
34304,ElliotBayTrailMyrtlePark,11/30/2017 08:00:00 AM,48,-122,21,66,87
34305,ElliotBayTrailMyrtlePark,11/30/2017 09:00:00 AM,48,-122,9,36,45
34306,ElliotBayTrailMyrtlePark,11/30/2017 10:00:00 AM,48,-122,1,8,9
34307,ElliotBayTrailMyrtlePark,11/30/2017 11:00:00 AM,48,-122,6,8,14
34308,ElliotBayTrailMyrtlePark,11/30/2017 12:00:00 PM,48,-122,9,5,14
34309,ElliotBayTrailMyrtlePark,11/30/2017 01:00:00 PM,48,-122,9,7,16
34310,ElliotBayTrailMyrtlePark,11/30/2017 02:00:00 PM,48,-122,10,8,18
34311,ElliotBayTrailMyrtlePark,11/30/2017 03:00:00 PM,48,-122,11,19,30
34312,ElliotBayTrailMyrtlePark,11/30/2017 04:00:00 PM,48,-122,47,27,74
34313,ElliotBayTrailMyrtlePark,11/30/2017 05:00:00 PM,48,-122,77,29,106
34314,ElliotBayTrailMyrtlePark,11/30/2017 06:00:00 PM,48,-122,36,21,57
34315,ElliotBayTrailMyrtlePark,11/30/2017 07:00:00 PM,48,-122,15,10,25
34316,ElliotBayTrailMyrtlePark,11/30/2017 08:00:00 PM,48,-122,7,1,8
34317,ElliotBayTrailMyrtlePark,11/30/2017 09:00:00 PM,48,-122,9,3,12
34318,ElliotBayTrailMyrtlePark,11/30/2017 10:00:00 PM,48,-122,19,3,22
34319,ElliotBayTrailMyrtlePark,11/30/2017 11:00:00 PM,48,-122,2,0,2
34320,ElliotBayTrailMyrtlePark,12/01/2017 12:00:00 AM,48,-122,5,1,6
34321,ElliotBayTrailMyrtlePark,12/01/2017 01:00:00 AM,48,-122,2,0,2
34322,ElliotBayTrailMyrtlePark,12/01/2017 02:00:00 AM,48,-122,0,0,0
34323,ElliotBayTrailMyrtlePark,12/01/2017 03:00:00 AM,48,-122,0,1,1
34324,ElliotBayTrailMyrtlePark,12/01/2017 04:00:00 AM,48,-122,0,0,0
34325,ElliotBayTrailMyrtlePark,12/01/2017 05:00:00 AM,48,-122,3,7,10
34326,ElliotBayTrailMyrtlePark,12/01/2017 06:00:00 AM,48,-122,13,21,34
34327,ElliotBayTrailMyrtlePark,12/01/2017 07:00:00 AM,48,-122,24,56,80
34328,ElliotBayTrailMyrtlePark,12/01/2017 08:00:00 AM,48,-122,22,88,110
34329,ElliotBayTrailMyrtlePark,12/01/2017 09:00:00 AM,48,-122,17,33,50
34330,ElliotBayTrailMyrtlePark,12/01/2017 10:00:00 AM,48,-122,7,18,25
34331,ElliotBayTrailMyrtlePark,12/01/2017 11:00:00 AM,48,-122,6,5,11
34332,ElliotBayTrailMyrtlePark,12/01/2017 12:00:00 PM,48,-122,10,9,19
34333,ElliotBayTrailMyrtlePark,12/01/2017 01:00:00 PM,48,-122,6,10,16
34334,ElliotBayTrailMyrtlePark,12/01/2017 02:00:00 PM,48,-122,14,3,17
34335,ElliotBayTrailMyrtlePark,12/01/2017 03:00:00 PM,48,-122,13,12,25
34336,ElliotBayTrailMyrtlePark,12/01/2017 04:00:00 PM,48,-122,55,26,81
34337,ElliotBayTrailMyrtlePark,12/01/2017 05:00:00 PM,48,-122,87,29,116
34338,ElliotBayTrailMyrtlePark,12/01/2017 06:00:00 PM,48,-122,32,2,34
34339,ElliotBayTrailMyrtlePark,12/01/2017 07:00:00 PM,48,-122,8,6,14
34340,ElliotBayTrailMyrtlePark,12/01/2017 08:00:00 PM,48,-122,2,2,4
34341,ElliotBayTrailMyrtlePark,12/01/2017 09:00:00 PM,48,-122,4,1,5
34342,ElliotBayTrailMyrtlePark,12/01/2017 10:00:00 PM,48,-122,3,3,6
34343,ElliotBayTrailMyrtlePark,12/01/2017 11:00:00 PM,48,-122,2,1,3
34344,ElliotBayTrailMyrtlePark,12/02/2017 12:00:00 AM,48,-122,1,1,2
34345,ElliotBayTrailMyrtlePark,12/02/2017 01:00:00 AM,48,-122,0,0,0
34346,ElliotBayTrailMyrtlePark,12/02/2017 02:00:00 AM,48,-122,0,0,0
34347,ElliotBayTrailMyrtlePark,12/02/2017 03:00:00 AM,48,-122,0,0,0
34348,ElliotBayTrailMyrtlePark,12/02/2017 04:00:00 AM,48,-122,0,0,0
34349,ElliotBayTrailMyrtlePark,12/02/2017 05:00:00 AM,48,-122,0,0,0
34350,ElliotBayTrailMyrtlePark,12/02/2017 06:00:00 AM,48,-122,2,4,6
34351,ElliotBayTrailMyrtlePark,12/02/2017 07:00:00 AM,48,-122,7,1,8
34352,ElliotBayTrailMyrtlePark,12/02/2017 08:00:00 AM,48,-122,5,8,13
34353,ElliotBayTrailMyrtlePark,12/02/2017 09:00:00 AM,48,-122,1,4,5
34354,ElliotBayTrailMyrtlePark,12/02/2017 10:00:00 AM,48,-122,3,0,3
34355,ElliotBayTrailMyrtlePark,12/02/2017 11:00:00 AM,48,-122,0,0,0
34356,ElliotBayTrailMyrtlePark,12/02/2017 12:00:00 PM,48,-122,3,4,7
34357,ElliotBayTrailMyrtlePark,12/02/2017 01:00:00 PM,48,-122,5,2,7
34358,ElliotBayTrailMyrtlePark,12/02/2017 02:00:00 PM,48,-122,7,3,10
34359,ElliotBayTrailMyrtlePark,12/02/2017 03:00:00 PM,48,-122,16,8,24
34360,ElliotBayTrailMyrtlePark,12/02/2017 04:00:00 PM,48,-122,0,1,1
34361,ElliotBayTrailMyrtlePark,12/02/2017 05:00:00 PM,48,-122,0,1,1
34362,ElliotBayTrailMyrtlePark,12/02/2017 06:00:00 PM,48,-122,2,1,3
34363,ElliotBayTrailMyrtlePark,12/02/2017 07:00:00 PM,48,-122,2,3,5
34364,ElliotBayTrailMyrtlePark,12/02/2017 08:00:00 PM,48,-122,1,0,1
34365,ElliotBayTrailMyrtlePark,12/02/2017 09:00:00 PM,48,-122,0,0,0
34366,ElliotBayTrailMyrtlePark,12/02/2017 10:00:00 PM,48,-122,0,2,2
34367,ElliotBayTrailMyrtlePark,12/02/2017 11:00:00 PM,48,-122,1,1,2
34368,ElliotBayTrailMyrtlePark,12/03/2017 12:00:00 AM,48,-122,0,0,0
34369,ElliotBayTrailMyrtlePark,12/03/2017 01:00:00 AM,48,-122,1,1,2
34370,ElliotBayTrailMyrtlePark,12/03/2017 02:00:00 AM,48,-122,0,0,0
34371,ElliotBayTrailMyrtlePark,12/03/2017 03:00:00 AM,48,-122,0,0,0
34372,ElliotBayTrailMyrtlePark,12/03/2017 04:00:00 AM,48,-122,0,0,0
34373,ElliotBayTrailMyrtlePark,12/03/2017 05:00:00 AM,48,-122,0,0,0
34374,ElliotBayTrailMyrtlePark,12/03/2017 06:00:00 AM,48,-122,0,2,2
34375,ElliotBayTrailMyrtlePark,12/03/2017 07:00:00 AM,48,-122,2,2,4
34376,ElliotBayTrailMyrtlePark,12/03/2017 08:00:00 AM,48,-122,3,6,9
34377,ElliotBayTrailMyrtlePark,12/03/2017 09:00:00 AM,48,-122,7,11,18
34378,ElliotBayTrailMyrtlePark,12/03/2017 10:00:00 AM,48,-122,23,12,35
34379,ElliotBayTrailMyrtlePark,12/03/2017 11:00:00 AM,48,-122,25,31,56
34380,ElliotBayTrailMyrtlePark,12/03/2017 12:00:00 PM,48,-122,15,20,35
34381,ElliotBayTrailMyrtlePark,12/03/2017 01:00:00 PM,48,-122,28,18,46
34382,ElliotBayTrailMyrtlePark,12/03/2017 02:00:00 PM,48,-122,20,13,33
34383,ElliotBayTrailMyrtlePark,12/03/2017 03:00:00 PM,48,-122,16,21,37
34384,ElliotBayTrailMyrtlePark,12/03/2017 04:00:00 PM,48,-122,15,17,32
34385,ElliotBayTrailMyrtlePark,12/03/2017 05:00:00 PM,48,-122,9,9,18
34386,ElliotBayTrailMyrtlePark,12/03/2017 06:00:00 PM,48,-122,5,0,5
34387,ElliotBayTrailMyrtlePark,12/03/2017 07:00:00 PM,48,-122,6,3,9
34388,ElliotBayTrailMyrtlePark,12/03/2017 08:00:00 PM,48,-122,6,0,6
34389,ElliotBayTrailMyrtlePark,12/03/2017 09:00:00 PM,48,-122,7,1,8
34390,ElliotBayTrailMyrtlePark,12/03/2017 10:00:00 PM,48,-122,1,1,2
34391,ElliotBayTrailMyrtlePark,12/03/2017 11:00:00 PM,48,-122,0,2,2
34392,ElliotBayTrailMyrtlePark,12/04/2017 12:00:00 AM,48,-122,0,0,0
34393,ElliotBayTrailMyrtlePark,12/04/2017 01:00:00 AM,48,-122,0,0,0
34394,ElliotBayTrailMyrtlePark,12/04/2017 02:00:00 AM,48,-122,1,0,1
34395,ElliotBayTrailMyrtlePark,12/04/2017 03:00:00 AM,48,-122,0,1,1
34396,ElliotBayTrailMyrtlePark,12/04/2017 04:00:00 AM,48,-122,0,0,0
34397,ElliotBayTrailMyrtlePark,12/04/2017 05:00:00 AM,48,-122,8,5,13
34398,ElliotBayTrailMyrtlePark,12/04/2017 06:00:00 AM,48,-122,22,15,37
34399,ElliotBayTrailMyrtlePark,12/04/2017 07:00:00 AM,48,-122,37,74,111
34400,ElliotBayTrailMyrtlePark,12/04/2017 08:00:00 AM,48,-122,21,124,145
34401,ElliotBayTrailMyrtlePark,12/04/2017 09:00:00 AM,48,-122,17,48,65
34402,ElliotBayTrailMyrtlePark,12/04/2017 10:00:00 AM,48,-122,10,16,26
34403,ElliotBayTrailMyrtlePark,12/04/2017 11:00:00 AM,48,-122,10,13,23
34404,ElliotBayTrailMyrtlePark,12/04/2017 12:00:00 PM,48,-122,12,7,19
34405,ElliotBayTrailMyrtlePark,12/04/2017 01:00:00 PM,48,-122,8,6,14
34406,ElliotBayTrailMyrtlePark,12/04/2017 02:00:00 PM,48,-122,19,12,31
34407,ElliotBayTrailMyrtlePark,12/04/2017 03:00:00 PM,48,-122,26,31,57
34408,ElliotBayTrailMyrtlePark,12/04/2017 04:00:00 PM,48,-122,53,47,100
34409,ElliotBayTrailMyrtlePark,12/04/2017 05:00:00 PM,48,-122,136,30,166
34410,ElliotBayTrailMyrtlePark,12/04/2017 06:00:00 PM,48,-122,67,11,78
34411,ElliotBayTrailMyrtlePark,12/04/2017 07:00:00 PM,48,-122,23,3,26
34412,ElliotBayTrailMyrtlePark,12/04/2017 08:00:00 PM,48,-122,11,2,13
34413,ElliotBayTrailMyrtlePark,12/04/2017 09:00:00 PM,48,-122,6,1,7
34414,ElliotBayTrailMyrtlePark,12/04/2017 10:00:00 PM,48,-122,1,1,2
34415,ElliotBayTrailMyrtlePark,12/04/2017 11:00:00 PM,48,-122,1,1,2
34416,ElliotBayTrailMyrtlePark,12/05/2017 12:00:00 AM,48,-122,0,0,0
34417,ElliotBayTrailMyrtlePark,12/05/2017 01:00:00 AM,48,-122,1,1,2
34418,ElliotBayTrailMyrtlePark,12/05/2017 02:00:00 AM,48,-122,1,0,1
34419,ElliotBayTrailMyrtlePark,12/05/2017 03:00:00 AM,48,-122,0,2,2
34420,ElliotBayTrailMyrtlePark,12/05/2017 04:00:00 AM,48,-122,0,1,1
34421,ElliotBayTrailMyrtlePark,12/05/2017 05:00:00 AM,48,-122,6,10,16
34422,ElliotBayTrailMyrtlePark,12/05/2017 06:00:00 AM,48,-122,29,15,44
34423,ElliotBayTrailMyrtlePark,12/05/2017 07:00:00 AM,48,-122,32,70,102
34424,ElliotBayTrailMyrtlePark,12/05/2017 08:00:00 AM,48,-122,26,112,138
34425,ElliotBayTrailMyrtlePark,12/05/2017 09:00:00 AM,48,-122,15,47,62
34426,ElliotBayTrailMyrtlePark,12/05/2017 10:00:00 AM,48,-122,5,14,19
34427,ElliotBayTrailMyrtlePark,12/05/2017 11:00:00 AM,48,-122,14,8,22
34428,ElliotBayTrailMyrtlePark,12/05/2017 12:00:00 PM,48,-122,13,17,30
34429,ElliotBayTrailMyrtlePark,12/05/2017 01:00:00 PM,48,-122,12,12,24
34430,ElliotBayTrailMyrtlePark,12/05/2017 02:00:00 PM,48,-122,16,11,27
34431,ElliotBayTrailMyrtlePark,12/05/2017 03:00:00 PM,48,-122,36,37,73
34432,ElliotBayTrailMyrtlePark,12/05/2017 04:00:00 PM,48,-122,66,38,104
34433,ElliotBayTrailMyrtlePark,12/05/2017 05:00:00 PM,48,-122,128,32,160
34434,ElliotBayTrailMyrtlePark,12/05/2017 06:00:00 PM,48,-122,64,15,79
34435,ElliotBayTrailMyrtlePark,12/05/2017 07:00:00 PM,48,-122,16,3,19
34436,ElliotBayTrailMyrtlePark,12/05/2017 08:00:00 PM,48,-122,5,4,9
34437,ElliotBayTrailMyrtlePark,12/05/2017 09:00:00 PM,48,-122,5,0,5
34438,ElliotBayTrailMyrtlePark,12/05/2017 10:00:00 PM,48,-122,2,3,5
34439,ElliotBayTrailMyrtlePark,12/05/2017 11:00:00 PM,48,-122,2,2,4
34440,ElliotBayTrailMyrtlePark,12/06/2017 12:00:00 AM,48,-122,0,0,0
34441,ElliotBayTrailMyrtlePark,12/06/2017 01:00:00 AM,48,-122,1,0,1
34442,ElliotBayTrailMyrtlePark,12/06/2017 02:00:00 AM,48,-122,2,0,2
34443,ElliotBayTrailMyrtlePark,12/06/2017 03:00:00 AM,48,-122,0,2,2
34444,ElliotBayTrailMyrtlePark,12/06/2017 04:00:00 AM,48,-122,0,1,1
34445,ElliotBayTrailMyrtlePark,12/06/2017 05:00:00 AM,48,-122,10,8,18
34446,ElliotBayTrailMyrtlePark,12/06/2017 06:00:00 AM,48,-122,19,31,50
34447,ElliotBayTrailMyrtlePark,12/06/2017 07:00:00 AM,48,-122,36,65,101
34448,ElliotBayTrailMyrtlePark,12/06/2017 08:00:00 AM,48,-122,21,118,139
34449,ElliotBayTrailMyrtlePark,12/06/2017 09:00:00 AM,48,-122,17,51,68
34450,ElliotBayTrailMyrtlePark,12/06/2017 10:00:00 AM,48,-122,10,15,25
34451,ElliotBayTrailMyrtlePark,12/06/2017 11:00:00 AM,48,-122,13,7,20
34452,ElliotBayTrailMyrtlePark,12/06/2017 12:00:00 PM,48,-122,20,11,31
34453,ElliotBayTrailMyrtlePark,12/06/2017 01:00:00 PM,48,-122,21,21,42
34454,ElliotBayTrailMyrtlePark,12/06/2017 02:00:00 PM,48,-122,35,21,56
34455,ElliotBayTrailMyrtlePark,12/06/2017 03:00:00 PM,48,-122,41,31,72
34456,ElliotBayTrailMyrtlePark,12/06/2017 04:00:00 PM,48,-122,57,58,115
34457,ElliotBayTrailMyrtlePark,12/06/2017 05:00:00 PM,48,-122,106,30,136
34458,ElliotBayTrailMyrtlePark,12/06/2017 06:00:00 PM,48,-122,58,15,73
34459,ElliotBayTrailMyrtlePark,12/06/2017 07:00:00 PM,48,-122,15,10,25
34460,ElliotBayTrailMyrtlePark,12/06/2017 08:00:00 PM,48,-122,7,5,12
34461,ElliotBayTrailMyrtlePark,12/06/2017 09:00:00 PM,48,-122,9,2,11
34462,ElliotBayTrailMyrtlePark,12/06/2017 10:00:00 PM,48,-122,8,1,9
34463,ElliotBayTrailMyrtlePark,12/06/2017 11:00:00 PM,48,-122,5,1,6
34464,ElliotBayTrailMyrtlePark,12/07/2017 12:00:00 AM,48,-122,0,0,0
34465,ElliotBayTrailMyrtlePark,12/07/2017 01:00:00 AM,48,-122,0,0,0
34466,ElliotBayTrailMyrtlePark,12/07/2017 02:00:00 AM,48,-122,0,0,0
34467,ElliotBayTrailMyrtlePark,12/07/2017 03:00:00 AM,48,-122,2,2,4
34468,ElliotBayTrailMyrtlePark,12/07/2017 04:00:00 AM,48,-122,0,1,1
34469,ElliotBayTrailMyrtlePark,12/07/2017 05:00:00 AM,48,-122,7,9,16
34470,ElliotBayTrailMyrtlePark,12/07/2017 06:00:00 AM,48,-122,17,22,39
34471,ElliotBayTrailMyrtlePark,12/07/2017 07:00:00 AM,48,-122,31,71,102
34472,ElliotBayTrailMyrtlePark,12/07/2017 08:00:00 AM,48,-122,22,92,114
34473,ElliotBayTrailMyrtlePark,12/07/2017 09:00:00 AM,48,-122,12,45,57
34474,ElliotBayTrailMyrtlePark,12/07/2017 10:00:00 AM,48,-122,15,15,30
34475,ElliotBayTrailMyrtlePark,12/07/2017 11:00:00 AM,48,-122,18,11,29
34476,ElliotBayTrailMyrtlePark,12/07/2017 12:00:00 PM,48,-122,14,17,31
34477,ElliotBayTrailMyrtlePark,12/07/2017 01:00:00 PM,48,-122,24,11,35
34478,ElliotBayTrailMyrtlePark,12/07/2017 02:00:00 PM,48,-122,19,17,36
34479,ElliotBayTrailMyrtlePark,12/07/2017 03:00:00 PM,48,-122,44,26,70
34480,ElliotBayTrailMyrtlePark,12/07/2017 04:00:00 PM,48,-122,76,50,126
34481,ElliotBayTrailMyrtlePark,12/07/2017 05:00:00 PM,48,-122,100,41,141
34482,ElliotBayTrailMyrtlePark,12/07/2017 06:00:00 PM,48,-122,50,11,61
34483,ElliotBayTrailMyrtlePark,12/07/2017 07:00:00 PM,48,-122,23,9,32
34484,ElliotBayTrailMyrtlePark,12/07/2017 08:00:00 PM,48,-122,8,1,9
34485,ElliotBayTrailMyrtlePark,12/07/2017 09:00:00 PM,48,-122,8,3,11
34486,ElliotBayTrailMyrtlePark,12/07/2017 10:00:00 PM,48,-122,7,1,8
34487,ElliotBayTrailMyrtlePark,12/07/2017 11:00:00 PM,48,-122,2,1,3
34488,ElliotBayTrailMyrtlePark,12/08/2017 12:00:00 AM,48,-122,1,0,1
34489,ElliotBayTrailMyrtlePark,12/08/2017 01:00:00 AM,48,-122,0,1,1
34490,ElliotBayTrailMyrtlePark,12/08/2017 02:00:00 AM,48,-122,2,0,2
34491,ElliotBayTrailMyrtlePark,12/08/2017 03:00:00 AM,48,-122,0,3,3
34492,ElliotBayTrailMyrtlePark,12/08/2017 04:00:00 AM,48,-122,0,0,0
34493,ElliotBayTrailMyrtlePark,12/08/2017 05:00:00 AM,48,-122,4,6,10
34494,ElliotBayTrailMyrtlePark,12/08/2017 06:00:00 AM,48,-122,12,20,32
34495,ElliotBayTrailMyrtlePark,12/08/2017 07:00:00 AM,48,-122,32,39,71
34496,ElliotBayTrailMyrtlePark,12/08/2017 08:00:00 AM,48,-122,15,71,86
34497,ElliotBayTrailMyrtlePark,12/08/2017 09:00:00 AM,48,-122,12,47,59
34498,ElliotBayTrailMyrtlePark,12/08/2017 10:00:00 AM,48,-122,8,14,22
34499,ElliotBayTrailMyrtlePark,12/08/2017 11:00:00 AM,48,-122,11,14,25
34500,ElliotBayTrailMyrtlePark,12/08/2017 12:00:00 PM,48,-122,14,11,25
34501,ElliotBayTrailMyrtlePark,12/08/2017 01:00:00 PM,48,-122,15,13,28
34502,ElliotBayTrailMyrtlePark,12/08/2017 02:00:00 PM,48,-122,28,27,55
34503,ElliotBayTrailMyrtlePark,12/08/2017 03:00:00 PM,48,-122,37,34,71
34504,ElliotBayTrailMyrtlePark,12/08/2017 04:00:00 PM,48,-122,69,50,119
34505,ElliotBayTrailMyrtlePark,12/08/2017 05:00:00 PM,48,-122,78,24,102
34506,ElliotBayTrailMyrtlePark,12/08/2017 06:00:00 PM,48,-122,38,6,44
34507,ElliotBayTrailMyrtlePark,12/08/2017 07:00:00 PM,48,-122,13,2,15
34508,ElliotBayTrailMyrtlePark,12/08/2017 08:00:00 PM,48,-122,4,1,5
34509,ElliotBayTrailMyrtlePark,12/08/2017 09:00:00 PM,48,-122,1,2,3
34510,ElliotBayTrailMyrtlePark,12/08/2017 10:00:00 PM,48,-122,2,1,3
34511,ElliotBayTrailMyrtlePark,12/08/2017 11:00:00 PM,48,-122,0,0,0
34512,ElliotBayTrailMyrtlePark,12/09/2017 12:00:00 AM,48,-122,1,0,1
34513,ElliotBayTrailMyrtlePark,12/09/2017 01:00:00 AM,48,-122,6,0,6
34514,ElliotBayTrailMyrtlePark,12/09/2017 02:00:00 AM,48,-122,0,2,2
34515,ElliotBayTrailMyrtlePark,12/09/2017 03:00:00 AM,48,-122,0,0,0
34516,ElliotBayTrailMyrtlePark,12/09/2017 04:00:00 AM,48,-122,0,0,0
34517,ElliotBayTrailMyrtlePark,12/09/2017 05:00:00 AM,48,-122,0,0,0
34518,ElliotBayTrailMyrtlePark,12/09/2017 06:00:00 AM,48,-122,0,2,2
34519,ElliotBayTrailMyrtlePark,12/09/2017 07:00:00 AM,48,-122,2,0,2
34520,ElliotBayTrailMyrtlePark,12/09/2017 08:00:00 AM,48,-122,1,2,3
34521,ElliotBayTrailMyrtlePark,12/09/2017 09:00:00 AM,48,-122,3,7,10
34522,ElliotBayTrailMyrtlePark,12/09/2017 10:00:00 AM,48,-122,7,8,15
34523,ElliotBayTrailMyrtlePark,12/09/2017 11:00:00 AM,48,-122,27,24,51
34524,ElliotBayTrailMyrtlePark,12/09/2017 12:00:00 PM,48,-122,30,21,51
34525,ElliotBayTrailMyrtlePark,12/09/2017 01:00:00 PM,48,-122,24,24,48
34526,ElliotBayTrailMyrtlePark,12/09/2017 02:00:00 PM,48,-122,26,27,53
34527,ElliotBayTrailMyrtlePark,12/09/2017 03:00:00 PM,48,-122,33,21,54
34528,ElliotBayTrailMyrtlePark,12/09/2017 04:00:00 PM,48,-122,20,16,36
34529,ElliotBayTrailMyrtlePark,12/09/2017 05:00:00 PM,48,-122,6,5,11
34530,ElliotBayTrailMyrtlePark,12/09/2017 06:00:00 PM,48,-122,8,14,22
34531,ElliotBayTrailMyrtlePark,12/09/2017 07:00:00 PM,48,-122,1,1,2
34532,ElliotBayTrailMyrtlePark,12/09/2017 08:00:00 PM,48,-122,0,2,2
34533,ElliotBayTrailMyrtlePark,12/09/2017 09:00:00 PM,48,-122,2,1,3
34534,ElliotBayTrailMyrtlePark,12/09/2017 10:00:00 PM,48,-122,11,3,14
34535,ElliotBayTrailMyrtlePark,12/09/2017 11:00:00 PM,48,-122,12,2,14
34536,ElliotBayTrailMyrtlePark,12/10/2017 12:00:00 AM,48,-122,3,0,3
34537,ElliotBayTrailMyrtlePark,12/10/2017 01:00:00 AM,48,-122,1,1,2
34538,ElliotBayTrailMyrtlePark,12/10/2017 02:00:00 AM,48,-122,0,0,0
34539,ElliotBayTrailMyrtlePark,12/10/2017 03:00:00 AM,48,-122,1,0,1
34540,ElliotBayTrailMyrtlePark,12/10/2017 04:00:00 AM,48,-122,1,2,3
34541,ElliotBayTrailMyrtlePark,12/10/2017 05:00:00 AM,48,-122,0,0,0
34542,ElliotBayTrailMyrtlePark,12/10/2017 06:00:00 AM,48,-122,0,1,1
34543,ElliotBayTrailMyrtlePark,12/10/2017 07:00:00 AM,48,-122,3,4,7
34544,ElliotBayTrailMyrtlePark,12/10/2017 08:00:00 AM,48,-122,6,7,13
34545,ElliotBayTrailMyrtlePark,12/10/2017 09:00:00 AM,48,-122,15,14,29
34546,ElliotBayTrailMyrtlePark,12/10/2017 10:00:00 AM,48,-122,7,14,21
34547,ElliotBayTrailMyrtlePark,12/10/2017 11:00:00 AM,48,-122,21,19,40
34548,ElliotBayTrailMyrtlePark,12/10/2017 12:00:00 PM,48,-122,29,31,60
34549,ElliotBayTrailMyrtlePark,12/10/2017 01:00:00 PM,48,-122,29,30,59
34550,ElliotBayTrailMyrtlePark,12/10/2017 02:00:00 PM,48,-122,51,33,84
34551,ElliotBayTrailMyrtlePark,12/10/2017 03:00:00 PM,48,-122,57,28,85
34552,ElliotBayTrailMyrtlePark,12/10/2017 04:00:00 PM,48,-122,16,23,39
34553,ElliotBayTrailMyrtlePark,12/10/2017 05:00:00 PM,48,-122,8,4,12
34554,ElliotBayTrailMyrtlePark,12/10/2017 06:00:00 PM,48,-122,5,4,9
34555,ElliotBayTrailMyrtlePark,12/10/2017 07:00:00 PM,48,-122,4,1,5
34556,ElliotBayTrailMyrtlePark,12/10/2017 08:00:00 PM,48,-122,0,2,2
34557,ElliotBayTrailMyrtlePark,12/10/2017 09:00:00 PM,48,-122,1,0,1
34558,ElliotBayTrailMyrtlePark,12/10/2017 10:00:00 PM,48,-122,3,1,4
34559,ElliotBayTrailMyrtlePark,12/10/2017 11:00:00 PM,48,-122,0,1,1
34560,ElliotBayTrailMyrtlePark,12/11/2017 12:00:00 AM,48,-122,2,0,2
34561,ElliotBayTrailMyrtlePark,12/11/2017 01:00:00 AM,48,-122,0,0,0
34562,ElliotBayTrailMyrtlePark,12/11/2017 02:00:00 AM,48,-122,0,0,0
34563,ElliotBayTrailMyrtlePark,12/11/2017 03:00:00 AM,48,-122,0,1,1
34564,ElliotBayTrailMyrtlePark,12/11/2017 04:00:00 AM,48,-122,0,0,0
34565,ElliotBayTrailMyrtlePark,12/11/2017 05:00:00 AM,48,-122,7,12,19
34566,ElliotBayTrailMyrtlePark,12/11/2017 06:00:00 AM,48,-122,18,19,37
34567,ElliotBayTrailMyrtlePark,12/11/2017 07:00:00 AM,48,-122,32,43,75
34568,ElliotBayTrailMyrtlePark,12/11/2017 08:00:00 AM,48,-122,30,93,123
34569,ElliotBayTrailMyrtlePark,12/11/2017 09:00:00 AM,48,-122,15,56,71
34570,ElliotBayTrailMyrtlePark,12/11/2017 10:00:00 AM,48,-122,13,17,30
34571,ElliotBayTrailMyrtlePark,12/11/2017 11:00:00 AM,48,-122,13,8,21
34572,ElliotBayTrailMyrtlePark,12/11/2017 12:00:00 PM,48,-122,16,13,29
34573,ElliotBayTrailMyrtlePark,12/11/2017 01:00:00 PM,48,-122,16,18,34
34574,ElliotBayTrailMyrtlePark,12/11/2017 02:00:00 PM,48,-122,24,18,42
34575,ElliotBayTrailMyrtlePark,12/11/2017 03:00:00 PM,48,-122,30,31,61
34576,ElliotBayTrailMyrtlePark,12/11/2017 04:00:00 PM,48,-122,52,53,105
34577,ElliotBayTrailMyrtlePark,12/11/2017 05:00:00 PM,48,-122,107,35,142
34578,ElliotBayTrailMyrtlePark,12/11/2017 06:00:00 PM,48,-122,68,8,76
34579,ElliotBayTrailMyrtlePark,12/11/2017 07:00:00 PM,48,-122,14,2,16
34580,ElliotBayTrailMyrtlePark,12/11/2017 08:00:00 PM,48,-122,8,3,11
34581,ElliotBayTrailMyrtlePark,12/11/2017 09:00:00 PM,48,-122,2,2,4
34582,ElliotBayTrailMyrtlePark,12/11/2017 10:00:00 PM,48,-122,1,0,1
34583,ElliotBayTrailMyrtlePark,12/11/2017 11:00:00 PM,48,-122,0,0,0
34584,ElliotBayTrailMyrtlePark,12/12/2017 12:00:00 AM,48,-122,0,0,0
34585,ElliotBayTrailMyrtlePark,12/12/2017 01:00:00 AM,48,-122,5,0,5
34586,ElliotBayTrailMyrtlePark,12/12/2017 02:00:00 AM,48,-122,0,0,0
34587,ElliotBayTrailMyrtlePark,12/12/2017 03:00:00 AM,48,-122,0,2,2
34588,ElliotBayTrailMyrtlePark,12/12/2017 04:00:00 AM,48,-122,0,0,0
34589,ElliotBayTrailMyrtlePark,12/12/2017 05:00:00 AM,48,-122,9,12,21
34590,ElliotBayTrailMyrtlePark,12/12/2017 06:00:00 AM,48,-122,18,19,37
34591,ElliotBayTrailMyrtlePark,12/12/2017 07:00:00 AM,48,-122,33,59,92
34592,ElliotBayTrailMyrtlePark,12/12/2017 08:00:00 AM,48,-122,27,122,149
34593,ElliotBayTrailMyrtlePark,12/12/2017 09:00:00 AM,48,-122,20,50,70
34594,ElliotBayTrailMyrtlePark,12/12/2017 10:00:00 AM,48,-122,8,12,20
34595,ElliotBayTrailMyrtlePark,12/12/2017 11:00:00 AM,48,-122,8,14,22
34596,ElliotBayTrailMyrtlePark,12/12/2017 12:00:00 PM,48,-122,17,12,29
34597,ElliotBayTrailMyrtlePark,12/12/2017 01:00:00 PM,48,-122,14,12,26
34598,ElliotBayTrailMyrtlePark,12/12/2017 02:00:00 PM,48,-122,17,11,28
34599,ElliotBayTrailMyrtlePark,12/12/2017 03:00:00 PM,48,-122,33,22,55
34600,ElliotBayTrailMyrtlePark,12/12/2017 04:00:00 PM,48,-122,66,38,104
34601,ElliotBayTrailMyrtlePark,12/12/2017 05:00:00 PM,48,-122,125,33,158
34602,ElliotBayTrailMyrtlePark,12/12/2017 06:00:00 PM,48,-122,68,13,81
34603,ElliotBayTrailMyrtlePark,12/12/2017 07:00:00 PM,48,-122,13,4,17
34604,ElliotBayTrailMyrtlePark,12/12/2017 08:00:00 PM,48,-122,11,3,14
34605,ElliotBayTrailMyrtlePark,12/12/2017 09:00:00 PM,48,-122,4,9,13
34606,ElliotBayTrailMyrtlePark,12/12/2017 10:00:00 PM,48,-122,4,2,6
34607,ElliotBayTrailMyrtlePark,12/12/2017 11:00:00 PM,48,-122,1,1,2
34608,ElliotBayTrailMyrtlePark,12/13/2017 12:00:00 AM,48,-122,3,0,3
34609,ElliotBayTrailMyrtlePark,12/13/2017 01:00:00 AM,48,-122,1,0,1
34610,ElliotBayTrailMyrtlePark,12/13/2017 02:00:00 AM,48,-122,0,0,0
34611,ElliotBayTrailMyrtlePark,12/13/2017 03:00:00 AM,48,-122,0,1,1
34612,ElliotBayTrailMyrtlePark,12/13/2017 04:00:00 AM,48,-122,0,2,2
34613,ElliotBayTrailMyrtlePark,12/13/2017 05:00:00 AM,48,-122,7,12,19
34614,ElliotBayTrailMyrtlePark,12/13/2017 06:00:00 AM,48,-122,16,20,36
34615,ElliotBayTrailMyrtlePark,12/13/2017 07:00:00 AM,48,-122,47,49,96
34616,ElliotBayTrailMyrtlePark,12/13/2017 08:00:00 AM,48,-122,24,118,142
34617,ElliotBayTrailMyrtlePark,12/13/2017 09:00:00 AM,48,-122,12,53,65
34618,ElliotBayTrailMyrtlePark,12/13/2017 10:00:00 AM,48,-122,13,22,35
34619,ElliotBayTrailMyrtlePark,12/13/2017 11:00:00 AM,48,-122,5,8,13
34620,ElliotBayTrailMyrtlePark,12/13/2017 12:00:00 PM,48,-122,9,11,20
34621,ElliotBayTrailMyrtlePark,12/13/2017 01:00:00 PM,48,-122,17,11,28
34622,ElliotBayTrailMyrtlePark,12/13/2017 02:00:00 PM,48,-122,19,15,34
34623,ElliotBayTrailMyrtlePark,12/13/2017 03:00:00 PM,48,-122,41,32,73
34624,ElliotBayTrailMyrtlePark,12/13/2017 04:00:00 PM,48,-122,63,34,97
34625,ElliotBayTrailMyrtlePark,12/13/2017 05:00:00 PM,48,-122,101,33,134
34626,ElliotBayTrailMyrtlePark,12/13/2017 06:00:00 PM,48,-122,57,13,70
34627,ElliotBayTrailMyrtlePark,12/13/2017 07:00:00 PM,48,-122,22,4,26
34628,ElliotBayTrailMyrtlePark,12/13/2017 08:00:00 PM,48,-122,9,2,11
34629,ElliotBayTrailMyrtlePark,12/13/2017 09:00:00 PM,48,-122,7,2,9
34630,ElliotBayTrailMyrtlePark,12/13/2017 10:00:00 PM,48,-122,3,1,4
34631,ElliotBayTrailMyrtlePark,12/13/2017 11:00:00 PM,48,-122,2,2,4
34632,ElliotBayTrailMyrtlePark,12/14/2017 12:00:00 AM,48,-122,1,0,1
34633,ElliotBayTrailMyrtlePark,12/14/2017 01:00:00 AM,48,-122,1,0,1
34634,ElliotBayTrailMyrtlePark,12/14/2017 02:00:00 AM,48,-122,0,0,0
34635,ElliotBayTrailMyrtlePark,12/14/2017 03:00:00 AM,48,-122,0,1,1
34636,ElliotBayTrailMyrtlePark,12/14/2017 04:00:00 AM,48,-122,0,1,1
34637,ElliotBayTrailMyrtlePark,12/14/2017 05:00:00 AM,48,-122,6,7,13
34638,ElliotBayTrailMyrtlePark,12/14/2017 06:00:00 AM,48,-122,19,15,34
34639,ElliotBayTrailMyrtlePark,12/14/2017 07:00:00 AM,48,-122,28,60,88
34640,ElliotBayTrailMyrtlePark,12/14/2017 08:00:00 AM,48,-122,20,92,112
34641,ElliotBayTrailMyrtlePark,12/14/2017 09:00:00 AM,48,-122,22,40,62
34642,ElliotBayTrailMyrtlePark,12/14/2017 10:00:00 AM,48,-122,7,17,24
34643,ElliotBayTrailMyrtlePark,12/14/2017 11:00:00 AM,48,-122,13,9,22
34644,ElliotBayTrailMyrtlePark,12/14/2017 12:00:00 PM,48,-122,10,11,21
34645,ElliotBayTrailMyrtlePark,12/14/2017 01:00:00 PM,48,-122,19,16,35
34646,ElliotBayTrailMyrtlePark,12/14/2017 02:00:00 PM,48,-122,24,17,41
34647,ElliotBayTrailMyrtlePark,12/14/2017 03:00:00 PM,48,-122,28,21,49
34648,ElliotBayTrailMyrtlePark,12/14/2017 04:00:00 PM,48,-122,66,50,116
34649,ElliotBayTrailMyrtlePark,12/14/2017 05:00:00 PM,48,-122,91,27,118
34650,ElliotBayTrailMyrtlePark,12/14/2017 06:00:00 PM,48,-122,55,19,74
34651,ElliotBayTrailMyrtlePark,12/14/2017 07:00:00 PM,48,-122,31,9,40
34652,ElliotBayTrailMyrtlePark,12/14/2017 08:00:00 PM,48,-122,19,4,23
34653,ElliotBayTrailMyrtlePark,12/14/2017 09:00:00 PM,48,-122,3,4,7
34654,ElliotBayTrailMyrtlePark,12/14/2017 10:00:00 PM,48,-122,5,1,6
34655,ElliotBayTrailMyrtlePark,12/14/2017 11:00:00 PM,48,-122,4,0,4
34656,ElliotBayTrailMyrtlePark,12/15/2017 12:00:00 AM,48,-122,1,0,1
34657,ElliotBayTrailMyrtlePark,12/15/2017 01:00:00 AM,48,-122,0,1,1
34658,ElliotBayTrailMyrtlePark,12/15/2017 02:00:00 AM,48,-122,1,0,1
34659,ElliotBayTrailMyrtlePark,12/15/2017 03:00:00 AM,48,-122,0,1,1
34660,ElliotBayTrailMyrtlePark,12/15/2017 04:00:00 AM,48,-122,0,0,0
34661,ElliotBayTrailMyrtlePark,12/15/2017 05:00:00 AM,48,-122,10,10,20
34662,ElliotBayTrailMyrtlePark,12/15/2017 06:00:00 AM,48,-122,7,13,20
34663,ElliotBayTrailMyrtlePark,12/15/2017 07:00:00 AM,48,-122,27,38,65
34664,ElliotBayTrailMyrtlePark,12/15/2017 08:00:00 AM,48,-122,17,67,84
34665,ElliotBayTrailMyrtlePark,12/15/2017 09:00:00 AM,48,-122,12,34,46
34666,ElliotBayTrailMyrtlePark,12/15/2017 10:00:00 AM,48,-122,12,23,35
34667,ElliotBayTrailMyrtlePark,12/15/2017 11:00:00 AM,48,-122,14,12,26
34668,ElliotBayTrailMyrtlePark,12/15/2017 12:00:00 PM,48,-122,18,10,28
34669,ElliotBayTrailMyrtlePark,12/15/2017 01:00:00 PM,48,-122,9,5,14
34670,ElliotBayTrailMyrtlePark,12/15/2017 02:00:00 PM,48,-122,16,10,26
34671,ElliotBayTrailMyrtlePark,12/15/2017 03:00:00 PM,48,-122,33,21,54
34672,ElliotBayTrailMyrtlePark,12/15/2017 04:00:00 PM,48,-122,47,21,68
34673,ElliotBayTrailMyrtlePark,12/15/2017 05:00:00 PM,48,-122,73,17,90
34674,ElliotBayTrailMyrtlePark,12/15/2017 06:00:00 PM,48,-122,40,6,46
34675,ElliotBayTrailMyrtlePark,12/15/2017 07:00:00 PM,48,-122,11,6,17
34676,ElliotBayTrailMyrtlePark,12/15/2017 08:00:00 PM,48,-122,3,1,4
34677,ElliotBayTrailMyrtlePark,12/15/2017 09:00:00 PM,48,-122,0,1,1
34678,ElliotBayTrailMyrtlePark,12/15/2017 10:00:00 PM,48,-122,2,2,4
34679,ElliotBayTrailMyrtlePark,12/15/2017 11:00:00 PM,48,-122,5,1,6
34680,ElliotBayTrailMyrtlePark,12/16/2017 12:00:00 AM,48,-122,4,1,5
34681,ElliotBayTrailMyrtlePark,12/16/2017 01:00:00 AM,48,-122,0,1,1
34682,ElliotBayTrailMyrtlePark,12/16/2017 02:00:00 AM,48,-122,0,0,0
34683,ElliotBayTrailMyrtlePark,12/16/2017 03:00:00 AM,48,-122,0,0,0
34684,ElliotBayTrailMyrtlePark,12/16/2017 04:00:00 AM,48,-122,0,0,0
34685,ElliotBayTrailMyrtlePark,12/16/2017 05:00:00 AM,48,-122,0,0,0
34686,ElliotBayTrailMyrtlePark,12/16/2017 06:00:00 AM,48,-122,0,6,6
34687,ElliotBayTrailMyrtlePark,12/16/2017 07:00:00 AM,48,-122,3,0,3
34688,ElliotBayTrailMyrtlePark,12/16/2017 08:00:00 AM,48,-122,9,7,16
34689,ElliotBayTrailMyrtlePark,12/16/2017 09:00:00 AM,48,-122,7,7,14
34690,ElliotBayTrailMyrtlePark,12/16/2017 10:00:00 AM,48,-122,22,21,43
34691,ElliotBayTrailMyrtlePark,12/16/2017 11:00:00 AM,48,-122,8,11,19
34692,ElliotBayTrailMyrtlePark,12/16/2017 12:00:00 PM,48,-122,21,20,41
34693,ElliotBayTrailMyrtlePark,12/16/2017 01:00:00 PM,48,-122,9,22,31
34694,ElliotBayTrailMyrtlePark,12/16/2017 02:00:00 PM,48,-122,20,26,46
34695,ElliotBayTrailMyrtlePark,12/16/2017 03:00:00 PM,48,-122,19,14,33
34696,ElliotBayTrailMyrtlePark,12/16/2017 04:00:00 PM,48,-122,15,14,29
34697,ElliotBayTrailMyrtlePark,12/16/2017 05:00:00 PM,48,-122,16,7,23
34698,ElliotBayTrailMyrtlePark,12/16/2017 06:00:00 PM,48,-122,4,0,4
34699,ElliotBayTrailMyrtlePark,12/16/2017 07:00:00 PM,48,-122,7,4,11
34700,ElliotBayTrailMyrtlePark,12/16/2017 08:00:00 PM,48,-122,1,1,2
34701,ElliotBayTrailMyrtlePark,12/16/2017 09:00:00 PM,48,-122,4,2,6
34702,ElliotBayTrailMyrtlePark,12/16/2017 10:00:00 PM,48,-122,0,0,0
34703,ElliotBayTrailMyrtlePark,12/16/2017 11:00:00 PM,48,-122,1,0,1
34704,ElliotBayTrailMyrtlePark,12/17/2017 12:00:00 AM,48,-122,0,0,0
34705,ElliotBayTrailMyrtlePark,12/17/2017 01:00:00 AM,48,-122,0,0,0
34706,ElliotBayTrailMyrtlePark,12/17/2017 02:00:00 AM,48,-122,1,0,1
34707,ElliotBayTrailMyrtlePark,12/17/2017 03:00:00 AM,48,-122,0,0,0
34708,ElliotBayTrailMyrtlePark,12/17/2017 04:00:00 AM,48,-122,0,1,1
34709,ElliotBayTrailMyrtlePark,12/17/2017 05:00:00 AM,48,-122,0,0,0
34710,ElliotBayTrailMyrtlePark,12/17/2017 06:00:00 AM,48,-122,0,1,1
34711,ElliotBayTrailMyrtlePark,12/17/2017 07:00:00 AM,48,-122,0,0,0
34712,ElliotBayTrailMyrtlePark,12/17/2017 08:00:00 AM,48,-122,2,5,7
34713,ElliotBayTrailMyrtlePark,12/17/2017 09:00:00 AM,48,-122,4,4,8
34714,ElliotBayTrailMyrtlePark,12/17/2017 10:00:00 AM,48,-122,4,7,11
34715,ElliotBayTrailMyrtlePark,12/17/2017 11:00:00 AM,48,-122,5,5,10
34716,ElliotBayTrailMyrtlePark,12/17/2017 12:00:00 PM,48,-122,6,4,10
34717,ElliotBayTrailMyrtlePark,12/17/2017 01:00:00 PM,48,-122,7,5,12
34718,ElliotBayTrailMyrtlePark,12/17/2017 02:00:00 PM,48,-122,8,6,14
34719,ElliotBayTrailMyrtlePark,12/17/2017 03:00:00 PM,48,-122,16,5,21
34720,ElliotBayTrailMyrtlePark,12/17/2017 04:00:00 PM,48,-122,17,6,23
34721,ElliotBayTrailMyrtlePark,12/17/2017 05:00:00 PM,48,-122,5,1,6
34722,ElliotBayTrailMyrtlePark,12/17/2017 06:00:00 PM,48,-122,2,2,4
34723,ElliotBayTrailMyrtlePark,12/17/2017 07:00:00 PM,48,-122,3,0,3
34724,ElliotBayTrailMyrtlePark,12/17/2017 08:00:00 PM,48,-122,2,2,4
34725,ElliotBayTrailMyrtlePark,12/17/2017 09:00:00 PM,48,-122,0,1,1
34726,ElliotBayTrailMyrtlePark,12/17/2017 10:00:00 PM,48,-122,1,1,2
34727,ElliotBayTrailMyrtlePark,12/17/2017 11:00:00 PM,48,-122,0,0,0
34728,ElliotBayTrailMyrtlePark,12/18/2017 12:00:00 AM,48,-122,0,0,0
34729,ElliotBayTrailMyrtlePark,12/18/2017 01:00:00 AM,48,-122,0,0,0
34730,ElliotBayTrailMyrtlePark,12/18/2017 02:00:00 AM,48,-122,0,0,0
34731,ElliotBayTrailMyrtlePark,12/18/2017 03:00:00 AM,48,-122,0,1,1
34732,ElliotBayTrailMyrtlePark,12/18/2017 04:00:00 AM,48,-122,0,0,0
34733,ElliotBayTrailMyrtlePark,12/18/2017 05:00:00 AM,48,-122,4,7,11
34734,ElliotBayTrailMyrtlePark,12/18/2017 06:00:00 AM,48,-122,11,18,29
34735,ElliotBayTrailMyrtlePark,12/18/2017 07:00:00 AM,48,-122,30,34,64
34736,ElliotBayTrailMyrtlePark,12/18/2017 08:00:00 AM,48,-122,25,93,118
34737,ElliotBayTrailMyrtlePark,12/18/2017 09:00:00 AM,48,-122,10,30,40
34738,ElliotBayTrailMyrtlePark,12/18/2017 10:00:00 AM,48,-122,9,10,19
34739,ElliotBayTrailMyrtlePark,12/18/2017 11:00:00 AM,48,-122,7,6,13
34740,ElliotBayTrailMyrtlePark,12/18/2017 12:00:00 PM,48,-122,8,4,12
34741,ElliotBayTrailMyrtlePark,12/18/2017 01:00:00 PM,48,-122,9,1,10
34742,ElliotBayTrailMyrtlePark,12/18/2017 02:00:00 PM,48,-122,6,7,13
34743,ElliotBayTrailMyrtlePark,12/18/2017 03:00:00 PM,48,-122,10,16,26
34744,ElliotBayTrailMyrtlePark,12/18/2017 04:00:00 PM,48,-122,41,25,66
34745,ElliotBayTrailMyrtlePark,12/18/2017 05:00:00 PM,48,-122,78,13,91
34746,ElliotBayTrailMyrtlePark,12/18/2017 06:00:00 PM,48,-122,46,11,57
34747,ElliotBayTrailMyrtlePark,12/18/2017 07:00:00 PM,48,-122,9,4,13
34748,ElliotBayTrailMyrtlePark,12/18/2017 08:00:00 PM,48,-122,4,1,5
34749,ElliotBayTrailMyrtlePark,12/18/2017 09:00:00 PM,48,-122,0,1,1
34750,ElliotBayTrailMyrtlePark,12/18/2017 10:00:00 PM,48,-122,2,1,3
34751,ElliotBayTrailMyrtlePark,12/18/2017 11:00:00 PM,48,-122,0,0,0
34752,ElliotBayTrailMyrtlePark,12/19/2017 12:00:00 AM,48,-122,0,0,0
34753,ElliotBayTrailMyrtlePark,12/19/2017 01:00:00 AM,48,-122,1,0,1
34754,ElliotBayTrailMyrtlePark,12/19/2017 02:00:00 AM,48,-122,1,0,1
34755,ElliotBayTrailMyrtlePark,12/19/2017 03:00:00 AM,48,-122,0,1,1
34756,ElliotBayTrailMyrtlePark,12/19/2017 04:00:00 AM,48,-122,0,0,0
34757,ElliotBayTrailMyrtlePark,12/19/2017 05:00:00 AM,48,-122,2,5,7
34758,ElliotBayTrailMyrtlePark,12/19/2017 06:00:00 AM,48,-122,12,10,22
34759,ElliotBayTrailMyrtlePark,12/19/2017 07:00:00 AM,48,-122,21,31,52
34760,ElliotBayTrailMyrtlePark,12/19/2017 08:00:00 AM,48,-122,22,45,67
34761,ElliotBayTrailMyrtlePark,12/19/2017 09:00:00 AM,48,-122,17,23,40
34762,ElliotBayTrailMyrtlePark,12/19/2017 10:00:00 AM,48,-122,11,6,17
34763,ElliotBayTrailMyrtlePark,12/19/2017 11:00:00 AM,48,-122,2,4,6
34764,ElliotBayTrailMyrtlePark,12/19/2017 12:00:00 PM,48,-122,3,0,3
34765,ElliotBayTrailMyrtlePark,12/19/2017 01:00:00 PM,48,-122,2,2,4
34766,ElliotBayTrailMyrtlePark,12/19/2017 02:00:00 PM,48,-122,11,11,22
34767,ElliotBayTrailMyrtlePark,12/19/2017 03:00:00 PM,48,-122,11,12,23
34768,ElliotBayTrailMyrtlePark,12/19/2017 04:00:00 PM,48,-122,33,21,54
34769,ElliotBayTrailMyrtlePark,12/19/2017 05:00:00 PM,48,-122,63,12,75
34770,ElliotBayTrailMyrtlePark,12/19/2017 06:00:00 PM,48,-122,26,7,33
34771,ElliotBayTrailMyrtlePark,12/19/2017 07:00:00 PM,48,-122,8,4,12
34772,ElliotBayTrailMyrtlePark,12/19/2017 08:00:00 PM,48,-122,0,3,3
34773,ElliotBayTrailMyrtlePark,12/19/2017 09:00:00 PM,48,-122,2,1,3
34774,ElliotBayTrailMyrtlePark,12/19/2017 10:00:00 PM,48,-122,3,0,3
34775,ElliotBayTrailMyrtlePark,12/19/2017 11:00:00 PM,48,-122,0,0,0
34776,ElliotBayTrailMyrtlePark,12/20/2017 12:00:00 AM,48,-122,0,0,0
34777,ElliotBayTrailMyrtlePark,12/20/2017 01:00:00 AM,48,-122,3,0,3
34778,ElliotBayTrailMyrtlePark,12/20/2017 02:00:00 AM,48,-122,0,0,0
34779,ElliotBayTrailMyrtlePark,12/20/2017 03:00:00 AM,48,-122,0,1,1
34780,ElliotBayTrailMyrtlePark,12/20/2017 04:00:00 AM,48,-122,0,1,1
34781,ElliotBayTrailMyrtlePark,12/20/2017 05:00:00 AM,48,-122,7,7,14
34782,ElliotBayTrailMyrtlePark,12/20/2017 06:00:00 AM,48,-122,17,15,32
34783,ElliotBayTrailMyrtlePark,12/20/2017 07:00:00 AM,48,-122,30,40,70
34784,ElliotBayTrailMyrtlePark,12/20/2017 08:00:00 AM,48,-122,21,96,117
34785,ElliotBayTrailMyrtlePark,12/20/2017 09:00:00 AM,48,-122,20,31,51
34786,ElliotBayTrailMyrtlePark,12/20/2017 10:00:00 AM,48,-122,11,16,27
34787,ElliotBayTrailMyrtlePark,12/20/2017 11:00:00 AM,48,-122,11,13,24
34788,ElliotBayTrailMyrtlePark,12/20/2017 12:00:00 PM,48,-122,12,13,25
34789,ElliotBayTrailMyrtlePark,12/20/2017 01:00:00 PM,48,-122,16,14,30
34790,ElliotBayTrailMyrtlePark,12/20/2017 02:00:00 PM,48,-122,15,12,27
34791,ElliotBayTrailMyrtlePark,12/20/2017 03:00:00 PM,48,-122,39,27,66
34792,ElliotBayTrailMyrtlePark,12/20/2017 04:00:00 PM,48,-122,58,40,98
34793,ElliotBayTrailMyrtlePark,12/20/2017 05:00:00 PM,48,-122,75,24,99
34794,ElliotBayTrailMyrtlePark,12/20/2017 06:00:00 PM,48,-122,33,10,43
34795,ElliotBayTrailMyrtlePark,12/20/2017 07:00:00 PM,48,-122,16,2,18
34796,ElliotBayTrailMyrtlePark,12/20/2017 08:00:00 PM,48,-122,5,1,6
34797,ElliotBayTrailMyrtlePark,12/20/2017 09:00:00 PM,48,-122,7,6,13
34798,ElliotBayTrailMyrtlePark,12/20/2017 10:00:00 PM,48,-122,3,2,5
34799,ElliotBayTrailMyrtlePark,12/20/2017 11:00:00 PM,48,-122,3,1,4
34800,ElliotBayTrailMyrtlePark,12/21/2017 12:00:00 AM,48,-122,0,0,0
34801,ElliotBayTrailMyrtlePark,12/21/2017 01:00:00 AM,48,-122,1,1,2
34802,ElliotBayTrailMyrtlePark,12/21/2017 02:00:00 AM,48,-122,0,0,0
34803,ElliotBayTrailMyrtlePark,12/21/2017 03:00:00 AM,48,-122,0,0,0
34804,ElliotBayTrailMyrtlePark,12/21/2017 04:00:00 AM,48,-122,0,0,0
34805,ElliotBayTrailMyrtlePark,12/21/2017 05:00:00 AM,48,-122,6,6,12
34806,ElliotBayTrailMyrtlePark,12/21/2017 06:00:00 AM,48,-122,9,15,24
34807,ElliotBayTrailMyrtlePark,12/21/2017 07:00:00 AM,48,-122,14,35,49
34808,ElliotBayTrailMyrtlePark,12/21/2017 08:00:00 AM,48,-122,11,53,64
34809,ElliotBayTrailMyrtlePark,12/21/2017 09:00:00 AM,48,-122,9,29,38
34810,ElliotBayTrailMyrtlePark,12/21/2017 10:00:00 AM,48,-122,11,17,28
34811,ElliotBayTrailMyrtlePark,12/21/2017 11:00:00 AM,48,-122,14,7,21
34812,ElliotBayTrailMyrtlePark,12/21/2017 12:00:00 PM,48,-122,12,11,23
34813,ElliotBayTrailMyrtlePark,12/21/2017 01:00:00 PM,48,-122,9,9,18
34814,ElliotBayTrailMyrtlePark,12/21/2017 02:00:00 PM,48,-122,12,10,22
34815,ElliotBayTrailMyrtlePark,12/21/2017 03:00:00 PM,48,-122,29,16,45
34816,ElliotBayTrailMyrtlePark,12/21/2017 04:00:00 PM,48,-122,36,35,71
34817,ElliotBayTrailMyrtlePark,12/21/2017 05:00:00 PM,48,-122,60,11,71
34818,ElliotBayTrailMyrtlePark,12/21/2017 06:00:00 PM,48,-122,42,2,44
34819,ElliotBayTrailMyrtlePark,12/21/2017 07:00:00 PM,48,-122,8,4,12
34820,ElliotBayTrailMyrtlePark,12/21/2017 08:00:00 PM,48,-122,3,4,7
34821,ElliotBayTrailMyrtlePark,12/21/2017 09:00:00 PM,48,-122,0,1,1
34822,ElliotBayTrailMyrtlePark,12/21/2017 10:00:00 PM,48,-122,2,0,2
34823,ElliotBayTrailMyrtlePark,12/21/2017 11:00:00 PM,48,-122,0,0,0
34824,ElliotBayTrailMyrtlePark,12/22/2017 12:00:00 AM,48,-122,0,0,0
34825,ElliotBayTrailMyrtlePark,12/22/2017 01:00:00 AM,48,-122,1,0,1
34826,ElliotBayTrailMyrtlePark,12/22/2017 02:00:00 AM,48,-122,0,0,0
34827,ElliotBayTrailMyrtlePark,12/22/2017 03:00:00 AM,48,-122,0,0,0
34828,ElliotBayTrailMyrtlePark,12/22/2017 04:00:00 AM,48,-122,0,0,0
34829,ElliotBayTrailMyrtlePark,12/22/2017 05:00:00 AM,48,-122,7,5,12
34830,ElliotBayTrailMyrtlePark,12/22/2017 06:00:00 AM,48,-122,8,12,20
34831,ElliotBayTrailMyrtlePark,12/22/2017 07:00:00 AM,48,-122,11,21,32
34832,ElliotBayTrailMyrtlePark,12/22/2017 08:00:00 AM,48,-122,7,37,44
34833,ElliotBayTrailMyrtlePark,12/22/2017 09:00:00 AM,48,-122,5,25,30
34834,ElliotBayTrailMyrtlePark,12/22/2017 10:00:00 AM,48,-122,5,8,13
34835,ElliotBayTrailMyrtlePark,12/22/2017 11:00:00 AM,48,-122,7,10,17
34836,ElliotBayTrailMyrtlePark,12/22/2017 12:00:00 PM,48,-122,13,7,20
34837,ElliotBayTrailMyrtlePark,12/22/2017 01:00:00 PM,48,-122,10,5,15
34838,ElliotBayTrailMyrtlePark,12/22/2017 02:00:00 PM,48,-122,20,10,30
34839,ElliotBayTrailMyrtlePark,12/22/2017 03:00:00 PM,48,-122,31,19,50
34840,ElliotBayTrailMyrtlePark,12/22/2017 04:00:00 PM,48,-122,37,23,60
34841,ElliotBayTrailMyrtlePark,12/22/2017 05:00:00 PM,48,-122,24,3,27
34842,ElliotBayTrailMyrtlePark,12/22/2017 06:00:00 PM,48,-122,11,7,18
34843,ElliotBayTrailMyrtlePark,12/22/2017 07:00:00 PM,48,-122,2,4,6
34844,ElliotBayTrailMyrtlePark,12/22/2017 08:00:00 PM,48,-122,1,4,5
34845,ElliotBayTrailMyrtlePark,12/22/2017 09:00:00 PM,48,-122,1,0,1
34846,ElliotBayTrailMyrtlePark,12/22/2017 10:00:00 PM,48,-122,0,1,1
34847,ElliotBayTrailMyrtlePark,12/22/2017 11:00:00 PM,48,-122,0,1,1
34848,ElliotBayTrailMyrtlePark,12/23/2017 12:00:00 AM,48,-122,5,4,9
34849,ElliotBayTrailMyrtlePark,12/23/2017 01:00:00 AM,48,-122,3,0,3
34850,ElliotBayTrailMyrtlePark,12/23/2017 02:00:00 AM,48,-122,2,2,4
34851,ElliotBayTrailMyrtlePark,12/23/2017 03:00:00 AM,48,-122,0,0,0
34852,ElliotBayTrailMyrtlePark,12/23/2017 04:00:00 AM,48,-122,0,0,0
34853,ElliotBayTrailMyrtlePark,12/23/2017 05:00:00 AM,48,-122,0,0,0
34854,ElliotBayTrailMyrtlePark,12/23/2017 06:00:00 AM,48,-122,1,3,4
34855,ElliotBayTrailMyrtlePark,12/23/2017 07:00:00 AM,48,-122,1,0,1
34856,ElliotBayTrailMyrtlePark,12/23/2017 08:00:00 AM,48,-122,2,6,8
34857,ElliotBayTrailMyrtlePark,12/23/2017 09:00:00 AM,48,-122,6,6,12
34858,ElliotBayTrailMyrtlePark,12/23/2017 10:00:00 AM,48,-122,13,9,22
34859,ElliotBayTrailMyrtlePark,12/23/2017 11:00:00 AM,48,-122,13,15,28
34860,ElliotBayTrailMyrtlePark,12/23/2017 12:00:00 PM,48,-122,14,15,29
34861,ElliotBayTrailMyrtlePark,12/23/2017 01:00:00 PM,48,-122,25,31,56
34862,ElliotBayTrailMyrtlePark,12/23/2017 02:00:00 PM,48,-122,17,29,46
34863,ElliotBayTrailMyrtlePark,12/23/2017 03:00:00 PM,48,-122,30,22,52
34864,ElliotBayTrailMyrtlePark,12/23/2017 04:00:00 PM,48,-122,8,19,27
34865,ElliotBayTrailMyrtlePark,12/23/2017 05:00:00 PM,48,-122,11,1,12
34866,ElliotBayTrailMyrtlePark,12/23/2017 06:00:00 PM,48,-122,1,2,3
34867,ElliotBayTrailMyrtlePark,12/23/2017 07:00:00 PM,48,-122,0,1,1
34868,ElliotBayTrailMyrtlePark,12/23/2017 08:00:00 PM,48,-122,4,0,4
34869,ElliotBayTrailMyrtlePark,12/23/2017 09:00:00 PM,48,-122,2,0,2
34870,ElliotBayTrailMyrtlePark,12/23/2017 10:00:00 PM,48,-122,0,2,2
34871,ElliotBayTrailMyrtlePark,12/23/2017 11:00:00 PM,48,-122,7,1,8
34872,ElliotBayTrailMyrtlePark,12/24/2017 12:00:00 AM,48,-122,0,2,2
34873,ElliotBayTrailMyrtlePark,12/24/2017 01:00:00 AM,48,-122,0,0,0
34874,ElliotBayTrailMyrtlePark,12/24/2017 02:00:00 AM,48,-122,2,0,2
34875,ElliotBayTrailMyrtlePark,12/24/2017 03:00:00 AM,48,-122,0,0,0
34876,ElliotBayTrailMyrtlePark,12/24/2017 04:00:00 AM,48,-122,0,0,0
34877,ElliotBayTrailMyrtlePark,12/24/2017 05:00:00 AM,48,-122,0,0,0
34878,ElliotBayTrailMyrtlePark,12/24/2017 06:00:00 AM,48,-122,2,2,4
34879,ElliotBayTrailMyrtlePark,12/24/2017 07:00:00 AM,48,-122,1,3,4
34880,ElliotBayTrailMyrtlePark,12/24/2017 08:00:00 AM,48,-122,2,3,5
34881,ElliotBayTrailMyrtlePark,12/24/2017 09:00:00 AM,48,-122,2,7,9
34882,ElliotBayTrailMyrtlePark,12/24/2017 10:00:00 AM,48,-122,9,2,11
34883,ElliotBayTrailMyrtlePark,12/24/2017 11:00:00 AM,48,-122,9,3,12
34884,ElliotBayTrailMyrtlePark,12/24/2017 12:00:00 PM,48,-122,9,11,20
34885,ElliotBayTrailMyrtlePark,12/24/2017 01:00:00 PM,48,-122,5,5,10
34886,ElliotBayTrailMyrtlePark,12/24/2017 02:00:00 PM,48,-122,6,5,11
34887,ElliotBayTrailMyrtlePark,12/24/2017 03:00:00 PM,48,-122,2,3,5
34888,ElliotBayTrailMyrtlePark,12/24/2017 04:00:00 PM,48,-122,1,1,2
34889,ElliotBayTrailMyrtlePark,12/24/2017 05:00:00 PM,48,-122,0,0,0
34890,ElliotBayTrailMyrtlePark,12/24/2017 06:00:00 PM,48,-122,2,2,4
34891,ElliotBayTrailMyrtlePark,12/24/2017 07:00:00 PM,48,-122,1,0,1
34892,ElliotBayTrailMyrtlePark,12/24/2017 08:00:00 PM,48,-122,0,1,1
34893,ElliotBayTrailMyrtlePark,12/24/2017 09:00:00 PM,48,-122,1,0,1
34894,ElliotBayTrailMyrtlePark,12/24/2017 10:00:00 PM,48,-122,0,0,0
34895,ElliotBayTrailMyrtlePark,12/24/2017 11:00:00 PM,48,-122,0,0,0
34896,ElliotBayTrailMyrtlePark,12/25/2017 12:00:00 AM,48,-122,0,0,0
34897,ElliotBayTrailMyrtlePark,12/25/2017 01:00:00 AM,48,-122,1,1,2
34898,ElliotBayTrailMyrtlePark,12/25/2017 02:00:00 AM,48,-122,0,1,1
34899,ElliotBayTrailMyrtlePark,12/25/2017 03:00:00 AM,48,-122,0,0,0
34900,ElliotBayTrailMyrtlePark,12/25/2017 04:00:00 AM,48,-122,0,0,0
34901,ElliotBayTrailMyrtlePark,12/25/2017 05:00:00 AM,48,-122,0,0,0
34902,ElliotBayTrailMyrtlePark,12/25/2017 06:00:00 AM,48,-122,0,0,0
34903,ElliotBayTrailMyrtlePark,12/25/2017 07:00:00 AM,48,-122,1,0,1
34904,ElliotBayTrailMyrtlePark,12/25/2017 08:00:00 AM,48,-122,0,1,1
34905,ElliotBayTrailMyrtlePark,12/25/2017 09:00:00 AM,48,-122,3,1,4
34906,ElliotBayTrailMyrtlePark,12/25/2017 10:00:00 AM,48,-122,0,2,2
34907,ElliotBayTrailMyrtlePark,12/25/2017 11:00:00 AM,48,-122,0,2,2
34908,ElliotBayTrailMyrtlePark,12/25/2017 12:00:00 PM,48,-122,3,0,3
34909,ElliotBayTrailMyrtlePark,12/25/2017 01:00:00 PM,48,-122,4,1,5
34910,ElliotBayTrailMyrtlePark,12/25/2017 02:00:00 PM,48,-122,0,5,5
34911,ElliotBayTrailMyrtlePark,12/25/2017 03:00:00 PM,48,-122,0,3,3
34912,ElliotBayTrailMyrtlePark,12/25/2017 04:00:00 PM,48,-122,2,5,7
34913,ElliotBayTrailMyrtlePark,12/25/2017 05:00:00 PM,48,-122,2,1,3
34914,ElliotBayTrailMyrtlePark,12/25/2017 06:00:00 PM,48,-122,0,1,1
34915,ElliotBayTrailMyrtlePark,12/25/2017 07:00:00 PM,48,-122,0,0,0
34916,ElliotBayTrailMyrtlePark,12/25/2017 08:00:00 PM,48,-122,1,2,3
34917,ElliotBayTrailMyrtlePark,12/25/2017 09:00:00 PM,48,-122,0,0,0
34918,ElliotBayTrailMyrtlePark,12/25/2017 10:00:00 PM,48,-122,0,0,0
34919,ElliotBayTrailMyrtlePark,12/25/2017 11:00:00 PM,48,-122,0,0,0
34920,ElliotBayTrailMyrtlePark,12/26/2017 12:00:00 AM,48,-122,0,0,0
34921,ElliotBayTrailMyrtlePark,12/26/2017 01:00:00 AM,48,-122,0,0,0
34922,ElliotBayTrailMyrtlePark,12/26/2017 02:00:00 AM,48,-122,0,0,0
34923,ElliotBayTrailMyrtlePark,12/26/2017 03:00:00 AM,48,-122,0,0,0
34924,ElliotBayTrailMyrtlePark,12/26/2017 04:00:00 AM,48,-122,0,1,1
34925,ElliotBayTrailMyrtlePark,12/26/2017 05:00:00 AM,48,-122,2,1,3
34926,ElliotBayTrailMyrtlePark,12/26/2017 06:00:00 AM,48,-122,5,1,6
34927,ElliotBayTrailMyrtlePark,12/26/2017 07:00:00 AM,48,-122,9,6,15
34928,ElliotBayTrailMyrtlePark,12/26/2017 08:00:00 AM,48,-122,1,11,12
34929,ElliotBayTrailMyrtlePark,12/26/2017 09:00:00 AM,48,-122,5,13,18
34930,ElliotBayTrailMyrtlePark,12/26/2017 10:00:00 AM,48,-122,7,7,14
34931,ElliotBayTrailMyrtlePark,12/26/2017 11:00:00 AM,48,-122,9,17,26
34932,ElliotBayTrailMyrtlePark,12/26/2017 12:00:00 PM,48,-122,10,7,17
34933,ElliotBayTrailMyrtlePark,12/26/2017 01:00:00 PM,48,-122,11,15,26
34934,ElliotBayTrailMyrtlePark,12/26/2017 02:00:00 PM,48,-122,11,15,26
34935,ElliotBayTrailMyrtlePark,12/26/2017 03:00:00 PM,48,-122,10,17,27
34936,ElliotBayTrailMyrtlePark,12/26/2017 04:00:00 PM,48,-122,18,11,29
34937,ElliotBayTrailMyrtlePark,12/26/2017 05:00:00 PM,48,-122,11,4,15
34938,ElliotBayTrailMyrtlePark,12/26/2017 06:00:00 PM,48,-122,7,0,7
34939,ElliotBayTrailMyrtlePark,12/26/2017 07:00:00 PM,48,-122,1,1,2
34940,ElliotBayTrailMyrtlePark,12/26/2017 08:00:00 PM,48,-122,1,0,1
34941,ElliotBayTrailMyrtlePark,12/26/2017 09:00:00 PM,48,-122,0,2,2
34942,ElliotBayTrailMyrtlePark,12/26/2017 10:00:00 PM,48,-122,7,1,8
34943,ElliotBayTrailMyrtlePark,12/26/2017 11:00:00 PM,48,-122,0,0,0
34944,ElliotBayTrailMyrtlePark,12/27/2017 12:00:00 AM,48,-122,1,0,1
34945,ElliotBayTrailMyrtlePark,12/27/2017 01:00:00 AM,48,-122,1,1,2
34946,ElliotBayTrailMyrtlePark,12/27/2017 02:00:00 AM,48,-122,0,0,0
34947,ElliotBayTrailMyrtlePark,12/27/2017 03:00:00 AM,48,-122,0,0,0
34948,ElliotBayTrailMyrtlePark,12/27/2017 04:00:00 AM,48,-122,0,0,0
34949,ElliotBayTrailMyrtlePark,12/27/2017 05:00:00 AM,48,-122,3,5,8
34950,ElliotBayTrailMyrtlePark,12/27/2017 06:00:00 AM,48,-122,5,10,15
34951,ElliotBayTrailMyrtlePark,12/27/2017 07:00:00 AM,48,-122,14,21,35
34952,ElliotBayTrailMyrtlePark,12/27/2017 08:00:00 AM,48,-122,3,27,30
34953,ElliotBayTrailMyrtlePark,12/27/2017 09:00:00 AM,48,-122,6,15,21
34954,ElliotBayTrailMyrtlePark,12/27/2017 10:00:00 AM,48,-122,8,9,17
34955,ElliotBayTrailMyrtlePark,12/27/2017 11:00:00 AM,48,-122,7,7,14
34956,ElliotBayTrailMyrtlePark,12/27/2017 12:00:00 PM,48,-122,13,11,24
34957,ElliotBayTrailMyrtlePark,12/27/2017 01:00:00 PM,48,-122,11,17,28
34958,ElliotBayTrailMyrtlePark,12/27/2017 02:00:00 PM,48,-122,15,16,31
34959,ElliotBayTrailMyrtlePark,12/27/2017 03:00:00 PM,48,-122,26,19,45
34960,ElliotBayTrailMyrtlePark,12/27/2017 04:00:00 PM,48,-122,30,17,47
34961,ElliotBayTrailMyrtlePark,12/27/2017 05:00:00 PM,48,-122,32,8,40
34962,ElliotBayTrailMyrtlePark,12/27/2017 06:00:00 PM,48,-122,14,7,21
34963,ElliotBayTrailMyrtlePark,12/27/2017 07:00:00 PM,48,-122,16,4,20
34964,ElliotBayTrailMyrtlePark,12/27/2017 08:00:00 PM,48,-122,2,1,3
34965,ElliotBayTrailMyrtlePark,12/27/2017 09:00:00 PM,48,-122,6,2,8
34966,ElliotBayTrailMyrtlePark,12/27/2017 10:00:00 PM,48,-122,7,1,8
34967,ElliotBayTrailMyrtlePark,12/27/2017 11:00:00 PM,48,-122,0,0,0
34968,ElliotBayTrailMyrtlePark,12/28/2017 12:00:00 AM,48,-122,2,0,2
34969,ElliotBayTrailMyrtlePark,12/28/2017 01:00:00 AM,48,-122,0,1,1
34970,ElliotBayTrailMyrtlePark,12/28/2017 02:00:00 AM,48,-122,1,0,1
34971,ElliotBayTrailMyrtlePark,12/28/2017 03:00:00 AM,48,-122,0,0,0
34972,ElliotBayTrailMyrtlePark,12/28/2017 04:00:00 AM,48,-122,0,0,0
34973,ElliotBayTrailMyrtlePark,12/28/2017 05:00:00 AM,48,-122,3,8,11
34974,ElliotBayTrailMyrtlePark,12/28/2017 06:00:00 AM,48,-122,8,11,19
34975,ElliotBayTrailMyrtlePark,12/28/2017 07:00:00 AM,48,-122,15,13,28
34976,ElliotBayTrailMyrtlePark,12/28/2017 08:00:00 AM,48,-122,8,39,47
34977,ElliotBayTrailMyrtlePark,12/28/2017 09:00:00 AM,48,-122,7,21,28
34978,ElliotBayTrailMyrtlePark,12/28/2017 10:00:00 AM,48,-122,2,3,5
34979,ElliotBayTrailMyrtlePark,12/28/2017 11:00:00 AM,48,-122,9,3,12
34980,ElliotBayTrailMyrtlePark,12/28/2017 12:00:00 PM,48,-122,10,6,16
34981,ElliotBayTrailMyrtlePark,12/28/2017 01:00:00 PM,48,-122,9,13,22
34982,ElliotBayTrailMyrtlePark,12/28/2017 02:00:00 PM,48,-122,12,7,19
34983,ElliotBayTrailMyrtlePark,12/28/2017 03:00:00 PM,48,-122,19,11,30
34984,ElliotBayTrailMyrtlePark,12/28/2017 04:00:00 PM,48,-122,29,15,44
34985,ElliotBayTrailMyrtlePark,12/28/2017 05:00:00 PM,48,-122,37,10,47
34986,ElliotBayTrailMyrtlePark,12/28/2017 06:00:00 PM,48,-122,15,6,21
34987,ElliotBayTrailMyrtlePark,12/28/2017 07:00:00 PM,48,-122,5,1,6
34988,ElliotBayTrailMyrtlePark,12/28/2017 08:00:00 PM,48,-122,4,7,11
34989,ElliotBayTrailMyrtlePark,12/28/2017 09:00:00 PM,48,-122,0,1,1
34990,ElliotBayTrailMyrtlePark,12/28/2017 10:00:00 PM,48,-122,2,0,2
34991,ElliotBayTrailMyrtlePark,12/28/2017 11:00:00 PM,48,-122,0,0,0
34992,ElliotBayTrailMyrtlePark,12/29/2017 12:00:00 AM,48,-122,0,1,1
34993,ElliotBayTrailMyrtlePark,12/29/2017 01:00:00 AM,48,-122,1,0,1
34994,ElliotBayTrailMyrtlePark,12/29/2017 02:00:00 AM,48,-122,1,0,1
34995,ElliotBayTrailMyrtlePark,12/29/2017 03:00:00 AM,48,-122,0,0,0
34996,ElliotBayTrailMyrtlePark,12/29/2017 04:00:00 AM,48,-122,0,0,0
34997,ElliotBayTrailMyrtlePark,12/29/2017 05:00:00 AM,48,-122,1,3,4
34998,ElliotBayTrailMyrtlePark,12/29/2017 06:00:00 AM,48,-122,1,6,7
34999,ElliotBayTrailMyrtlePark,12/29/2017 07:00:00 AM,48,-122,11,12,23
35000,ElliotBayTrailMyrtlePark,12/29/2017 08:00:00 AM,48,-122,5,19,24
35001,ElliotBayTrailMyrtlePark,12/29/2017 09:00:00 AM,48,-122,3,10,13
35002,ElliotBayTrailMyrtlePark,12/29/2017 10:00:00 AM,48,-122,2,9,11
35003,ElliotBayTrailMyrtlePark,12/29/2017 11:00:00 AM,48,-122,2,1,3
35004,ElliotBayTrailMyrtlePark,12/29/2017 12:00:00 PM,48,-122,8,1,9
35005,ElliotBayTrailMyrtlePark,12/29/2017 01:00:00 PM,48,-122,6,2,8
35006,ElliotBayTrailMyrtlePark,12/29/2017 02:00:00 PM,48,-122,6,8,14
35007,ElliotBayTrailMyrtlePark,12/29/2017 03:00:00 PM,48,-122,13,5,18
35008,ElliotBayTrailMyrtlePark,12/29/2017 04:00:00 PM,48,-122,15,13,28
35009,ElliotBayTrailMyrtlePark,12/29/2017 05:00:00 PM,48,-122,17,4,21
35010,ElliotBayTrailMyrtlePark,12/29/2017 06:00:00 PM,48,-122,6,2,8
35011,ElliotBayTrailMyrtlePark,12/29/2017 07:00:00 PM,48,-122,0,1,1
35012,ElliotBayTrailMyrtlePark,12/29/2017 08:00:00 PM,48,-122,1,3,4
35013,ElliotBayTrailMyrtlePark,12/29/2017 09:00:00 PM,48,-122,0,0,0
35014,ElliotBayTrailMyrtlePark,12/29/2017 10:00:00 PM,48,-122,1,2,3
35015,ElliotBayTrailMyrtlePark,12/29/2017 11:00:00 PM,48,-122,1,0,1
35016,ElliotBayTrailMyrtlePark,12/30/2017 12:00:00 AM,48,-122,0,0,0
35017,ElliotBayTrailMyrtlePark,12/30/2017 01:00:00 AM,48,-122,1,0,1
35018,ElliotBayTrailMyrtlePark,12/30/2017 02:00:00 AM,48,-122,0,0,0
35019,ElliotBayTrailMyrtlePark,12/30/2017 03:00:00 AM,48,-122,0,1,1
35020,ElliotBayTrailMyrtlePark,12/30/2017 04:00:00 AM,48,-122,0,0,0
35021,ElliotBayTrailMyrtlePark,12/30/2017 05:00:00 AM,48,-122,1,1,2
35022,ElliotBayTrailMyrtlePark,12/30/2017 06:00:00 AM,48,-122,0,1,1
35023,ElliotBayTrailMyrtlePark,12/30/2017 07:00:00 AM,48,-122,2,0,2
35024,ElliotBayTrailMyrtlePark,12/30/2017 08:00:00 AM,48,-122,0,10,10
35025,ElliotBayTrailMyrtlePark,12/30/2017 09:00:00 AM,48,-122,7,17,24
35026,ElliotBayTrailMyrtlePark,12/30/2017 10:00:00 AM,48,-122,10,18,28
35027,ElliotBayTrailMyrtlePark,12/30/2017 11:00:00 AM,48,-122,17,18,35
35028,ElliotBayTrailMyrtlePark,12/30/2017 12:00:00 PM,48,-122,14,19,33
35029,ElliotBayTrailMyrtlePark,12/30/2017 01:00:00 PM,48,-122,36,21,57
35030,ElliotBayTrailMyrtlePark,12/30/2017 02:00:00 PM,48,-122,34,25,59
35031,ElliotBayTrailMyrtlePark,12/30/2017 03:00:00 PM,48,-122,23,32,55
35032,ElliotBayTrailMyrtlePark,12/30/2017 04:00:00 PM,48,-122,19,16,35
35033,ElliotBayTrailMyrtlePark,12/30/2017 05:00:00 PM,48,-122,8,7,15
35034,ElliotBayTrailMyrtlePark,12/30/2017 06:00:00 PM,48,-122,2,1,3
35035,ElliotBayTrailMyrtlePark,12/30/2017 07:00:00 PM,48,-122,3,4,7
35036,ElliotBayTrailMyrtlePark,12/30/2017 08:00:00 PM,48,-122,2,2,4
35037,ElliotBayTrailMyrtlePark,12/30/2017 09:00:00 PM,48,-122,0,1,1
35038,ElliotBayTrailMyrtlePark,12/30/2017 10:00:00 PM,48,-122,4,1,5
35039,ElliotBayTrailMyrtlePark,12/30/2017 11:00:00 PM,48,-122,0,0,0
35040,ElliotBayTrailMyrtlePark,12/31/2017 12:00:00 AM,48,-122,2,1,3
35041,ElliotBayTrailMyrtlePark,12/31/2017 01:00:00 AM,48,-122,0,0,0
35042,ElliotBayTrailMyrtlePark,12/31/2017 02:00:00 AM,48,-122,0,0,0
35043,ElliotBayTrailMyrtlePark,12/31/2017 03:00:00 AM,48,-122,0,0,0
35044,ElliotBayTrailMyrtlePark,12/31/2017 04:00:00 AM,48,-122,0,0,0
35045,ElliotBayTrailMyrtlePark,12/31/2017 05:00:00 AM,48,-122,0,0,0
35046,ElliotBayTrailMyrtlePark,12/31/2017 06:00:00 AM,48,-122,1,4,5
35047,ElliotBayTrailMyrtlePark,12/31/2017 07:00:00 AM,48,-122,5,1,6
35048,ElliotBayTrailMyrtlePark,12/31/2017 08:00:00 AM,48,-122,3,4,7
35049,ElliotBayTrailMyrtlePark,12/31/2017 09:00:00 AM,48,-122,5,17,22
35050,ElliotBayTrailMyrtlePark,12/31/2017 10:00:00 AM,48,-122,6,34,40
35051,ElliotBayTrailMyrtlePark,12/31/2017 11:00:00 AM,48,-122,19,21,40
35052,ElliotBayTrailMyrtlePark,12/31/2017 12:00:00 PM,48,-122,19,16,35
35053,ElliotBayTrailMyrtlePark,12/31/2017 01:00:00 PM,48,-122,35,29,64
35054,ElliotBayTrailMyrtlePark,12/31/2017 02:00:00 PM,48,-122,38,34,72
35055,ElliotBayTrailMyrtlePark,12/31/2017 03:00:00 PM,48,-122,25,33,58
35056,ElliotBayTrailMyrtlePark,12/31/2017 04:00:00 PM,48,-122,19,15,34
35057,ElliotBayTrailMyrtlePark,12/31/2017 05:00:00 PM,48,-122,6,2,8
35058,ElliotBayTrailMyrtlePark,12/31/2017 06:00:00 PM,48,-122,1,2,3
35059,ElliotBayTrailMyrtlePark,12/31/2017 07:00:00 PM,48,-122,5,2,7
35060,ElliotBayTrailMyrtlePark,12/31/2017 08:00:00 PM,48,-122,5,0,5
35061,ElliotBayTrailMyrtlePark,12/31/2017 09:00:00 PM,48,-122,1,4,5
35062,ElliotBayTrailMyrtlePark,12/31/2017 10:00:00 PM,48,-122,3,2,5
35063,ElliotBayTrailMyrtlePark,12/31/2017 11:00:00 PM,48,-122,5,1,6
