,Name,Date,Latitude,Longitude,NB,SB,TotalCount
0,FremontBridge,10/03/2012 12:00:00 AM,48,-122,9,4,13
1,FremontBridge,10/03/2012 01:00:00 AM,48,-122,6,4,10
2,FremontBridge,10/03/2012 02:00:00 AM,48,-122,1,1,2
3,FremontBridge,10/03/2012 03:00:00 AM,48,-122,3,2,5
4,FremontBridge,10/03/2012 04:00:00 AM,48,-122,1,6,7
5,FremontBridge,10/03/2012 05:00:00 AM,48,-122,10,21,31
6,FremontBridge,10/03/2012 06:00:00 AM,48,-122,50,105,155
7,FremontBridge,10/03/2012 07:00:00 AM,48,-122,95,257,352
8,FremontBridge,10/03/2012 08:00:00 AM,48,-122,146,291,437
9,FremontBridge,10/03/2012 09:00:00 AM,48,-122,104,172,276
10,FremontBridge,10/03/2012 10:00:00 AM,48,-122,46,72,118
11,FremontBridge,10/03/2012 11:00:00 AM,48,-122,32,10,42
12,FremontBridge,10/03/2012 12:00:00 PM,48,-122,41,35,76
13,FremontBridge,10/03/2012 01:00:00 PM,48,-122,48,42,90
14,FremontBridge,10/03/2012 02:00:00 PM,48,-122,51,77,128
15,FremontBridge,10/03/2012 03:00:00 PM,48,-122,92,72,164
16,FremontBridge,10/03/2012 04:00:00 PM,48,-122,182,133,315
17,FremontBridge,10/03/2012 05:00:00 PM,48,-122,391,192,583
18,FremontBridge,10/03/2012 06:00:00 PM,48,-122,258,122,380
19,FremontBridge,10/03/2012 07:00:00 PM,48,-122,69,59,128
20,FremontBridge,10/03/2012 08:00:00 PM,48,-122,51,29,80
21,FremontBridge,10/03/2012 09:00:00 PM,48,-122,38,25,63
22,FremontBridge,10/03/2012 10:00:00 PM,48,-122,25,24,49
23,FremontBridge,10/03/2012 11:00:00 PM,48,-122,12,5,17
24,FremontBridge,10/04/2012 12:00:00 AM,48,-122,11,7,18
25,FremontBridge,10/04/2012 01:00:00 AM,48,-122,0,3,3
26,FremontBridge,10/04/2012 02:00:00 AM,48,-122,6,3,9
27,FremontBridge,10/04/2012 03:00:00 AM,48,-122,3,0,3
28,FremontBridge,10/04/2012 04:00:00 AM,48,-122,1,7,8
29,FremontBridge,10/04/2012 05:00:00 AM,48,-122,11,15,26
30,FremontBridge,10/04/2012 06:00:00 AM,48,-122,51,91,142
31,FremontBridge,10/04/2012 07:00:00 AM,48,-122,89,230,319
32,FremontBridge,10/04/2012 08:00:00 AM,48,-122,134,284,418
33,FremontBridge,10/04/2012 09:00:00 AM,48,-122,94,147,241
34,FremontBridge,10/04/2012 10:00:00 AM,48,-122,53,67,120
35,FremontBridge,10/04/2012 11:00:00 AM,48,-122,55,53,108
36,FremontBridge,10/04/2012 12:00:00 PM,48,-122,50,54,104
37,FremontBridge,10/04/2012 01:00:00 PM,48,-122,71,55,126
38,FremontBridge,10/04/2012 02:00:00 PM,48,-122,56,63,119
39,FremontBridge,10/04/2012 03:00:00 PM,48,-122,74,73,147
40,FremontBridge,10/04/2012 04:00:00 PM,48,-122,161,114,275
41,FremontBridge,10/04/2012 05:00:00 PM,48,-122,353,154,507
42,FremontBridge,10/04/2012 06:00:00 PM,48,-122,241,137,378
43,FremontBridge,10/04/2012 07:00:00 PM,48,-122,107,57,164
44,FremontBridge,10/04/2012 08:00:00 PM,48,-122,56,27,83
45,FremontBridge,10/04/2012 09:00:00 PM,48,-122,39,31,70
46,FremontBridge,10/04/2012 10:00:00 PM,48,-122,21,25,46
47,FremontBridge,10/04/2012 11:00:00 PM,48,-122,30,11,41
48,FremontBridge,10/05/2012 12:00:00 AM,48,-122,7,4,11
49,FremontBridge,10/05/2012 01:00:00 AM,48,-122,4,4,8
50,FremontBridge,10/05/2012 02:00:00 AM,48,-122,3,4,7
51,FremontBridge,10/05/2012 03:00:00 AM,48,-122,2,2,4
52,FremontBridge,10/05/2012 04:00:00 AM,48,-122,2,7,9
53,FremontBridge,10/05/2012 05:00:00 AM,48,-122,7,18,25
54,FremontBridge,10/05/2012 06:00:00 AM,48,-122,37,68,105
55,FremontBridge,10/05/2012 07:00:00 AM,48,-122,101,218,319
56,FremontBridge,10/05/2012 08:00:00 AM,48,-122,119,251,370
57,FremontBridge,10/05/2012 09:00:00 AM,48,-122,81,131,212
58,FremontBridge,10/05/2012 10:00:00 AM,48,-122,48,71,119
59,FremontBridge,10/05/2012 11:00:00 AM,48,-122,61,43,104
60,FremontBridge,10/05/2012 12:00:00 PM,48,-122,46,55,101
61,FremontBridge,10/05/2012 01:00:00 PM,48,-122,50,62,112
62,FremontBridge,10/05/2012 02:00:00 PM,48,-122,62,63,125
63,FremontBridge,10/05/2012 03:00:00 PM,48,-122,84,80,164
64,FremontBridge,10/05/2012 04:00:00 PM,48,-122,190,120,310
65,FremontBridge,10/05/2012 05:00:00 PM,48,-122,290,144,434
66,FremontBridge,10/05/2012 06:00:00 PM,48,-122,209,107,316
67,FremontBridge,10/05/2012 07:00:00 PM,48,-122,73,42,115
68,FremontBridge,10/05/2012 08:00:00 PM,48,-122,41,27,68
69,FremontBridge,10/05/2012 09:00:00 PM,48,-122,31,11,42
70,FremontBridge,10/05/2012 10:00:00 PM,48,-122,26,10,36
71,FremontBridge,10/05/2012 11:00:00 PM,48,-122,16,16,32
72,FremontBridge,10/06/2012 12:00:00 AM,48,-122,7,8,15
73,FremontBridge,10/06/2012 01:00:00 AM,48,-122,5,10,15
74,FremontBridge,10/06/2012 02:00:00 AM,48,-122,2,7,9
75,FremontBridge,10/06/2012 03:00:00 AM,48,-122,2,1,3
76,FremontBridge,10/06/2012 04:00:00 AM,48,-122,1,4,5
77,FremontBridge,10/06/2012 05:00:00 AM,48,-122,2,3,5
78,FremontBridge,10/06/2012 06:00:00 AM,48,-122,15,12,27
79,FremontBridge,10/06/2012 07:00:00 AM,48,-122,16,17,33
80,FremontBridge,10/06/2012 08:00:00 AM,48,-122,47,58,105
81,FremontBridge,10/06/2012 09:00:00 AM,48,-122,55,59,114
82,FremontBridge,10/06/2012 10:00:00 AM,48,-122,47,68,115
83,FremontBridge,10/06/2012 11:00:00 AM,48,-122,48,76,124
84,FremontBridge,10/06/2012 12:00:00 PM,48,-122,73,91,164
85,FremontBridge,10/06/2012 01:00:00 PM,48,-122,82,95,177
86,FremontBridge,10/06/2012 02:00:00 PM,48,-122,114,89,203
87,FremontBridge,10/06/2012 03:00:00 PM,48,-122,96,115,211
88,FremontBridge,10/06/2012 04:00:00 PM,48,-122,76,107,183
89,FremontBridge,10/06/2012 05:00:00 PM,48,-122,73,107,180
90,FremontBridge,10/06/2012 06:00:00 PM,48,-122,55,41,96
91,FremontBridge,10/06/2012 07:00:00 PM,48,-122,38,40,78
92,FremontBridge,10/06/2012 08:00:00 PM,48,-122,18,25,43
93,FremontBridge,10/06/2012 09:00:00 PM,48,-122,15,18,33
94,FremontBridge,10/06/2012 10:00:00 PM,48,-122,20,14,34
95,FremontBridge,10/06/2012 11:00:00 PM,48,-122,19,15,34
96,FremontBridge,10/07/2012 12:00:00 AM,48,-122,5,6,11
97,FremontBridge,10/07/2012 01:00:00 AM,48,-122,5,12,17
98,FremontBridge,10/07/2012 02:00:00 AM,48,-122,1,2,3
99,FremontBridge,10/07/2012 03:00:00 AM,48,-122,2,4,6
100,FremontBridge,10/07/2012 04:00:00 AM,48,-122,2,1,3
101,FremontBridge,10/07/2012 05:00:00 AM,48,-122,3,6,9
102,FremontBridge,10/07/2012 06:00:00 AM,48,-122,8,9,17
103,FremontBridge,10/07/2012 07:00:00 AM,48,-122,12,14,26
104,FremontBridge,10/07/2012 08:00:00 AM,48,-122,26,43,69
105,FremontBridge,10/07/2012 09:00:00 AM,48,-122,36,67,103
106,FremontBridge,10/07/2012 10:00:00 AM,48,-122,41,67,108
107,FremontBridge,10/07/2012 11:00:00 AM,48,-122,71,94,165
108,FremontBridge,10/07/2012 12:00:00 PM,48,-122,91,100,191
109,FremontBridge,10/07/2012 01:00:00 PM,48,-122,99,129,228
110,FremontBridge,10/07/2012 02:00:00 PM,48,-122,115,126,241
111,FremontBridge,10/07/2012 03:00:00 PM,48,-122,109,122,231
112,FremontBridge,10/07/2012 04:00:00 PM,48,-122,93,132,225
113,FremontBridge,10/07/2012 05:00:00 PM,48,-122,73,118,191
114,FremontBridge,10/07/2012 06:00:00 PM,48,-122,45,68,113
115,FremontBridge,10/07/2012 07:00:00 PM,48,-122,23,26,49
116,FremontBridge,10/07/2012 08:00:00 PM,48,-122,36,19,55
117,FremontBridge,10/07/2012 09:00:00 PM,48,-122,35,12,47
118,FremontBridge,10/07/2012 10:00:00 PM,48,-122,9,9,18
119,FremontBridge,10/07/2012 11:00:00 PM,48,-122,11,5,16
120,FremontBridge,10/08/2012 12:00:00 AM,48,-122,5,4,9
121,FremontBridge,10/08/2012 01:00:00 AM,48,-122,2,2,4
122,FremontBridge,10/08/2012 02:00:00 AM,48,-122,0,5,5
123,FremontBridge,10/08/2012 03:00:00 AM,48,-122,4,1,5
124,FremontBridge,10/08/2012 04:00:00 AM,48,-122,2,3,5
125,FremontBridge,10/08/2012 05:00:00 AM,48,-122,7,16,23
126,FremontBridge,10/08/2012 06:00:00 AM,48,-122,48,89,137
127,FremontBridge,10/08/2012 07:00:00 AM,48,-122,94,233,327
128,FremontBridge,10/08/2012 08:00:00 AM,48,-122,153,304,457
129,FremontBridge,10/08/2012 09:00:00 AM,48,-122,104,174,278
130,FremontBridge,10/08/2012 10:00:00 AM,48,-122,44,53,97
131,FremontBridge,10/08/2012 11:00:00 AM,48,-122,44,55,99
132,FremontBridge,10/08/2012 12:00:00 PM,48,-122,55,53,108
133,FremontBridge,10/08/2012 01:00:00 PM,48,-122,44,52,96
134,FremontBridge,10/08/2012 02:00:00 PM,48,-122,62,59,121
135,FremontBridge,10/08/2012 03:00:00 PM,48,-122,75,92,167
136,FremontBridge,10/08/2012 04:00:00 PM,48,-122,135,117,252
137,FremontBridge,10/08/2012 05:00:00 PM,48,-122,390,214,604
138,FremontBridge,10/08/2012 06:00:00 PM,48,-122,226,139,365
139,FremontBridge,10/08/2012 07:00:00 PM,48,-122,95,73,168
140,FremontBridge,10/08/2012 08:00:00 PM,48,-122,57,37,94
141,FremontBridge,10/08/2012 09:00:00 PM,48,-122,35,28,63
142,FremontBridge,10/08/2012 10:00:00 PM,48,-122,14,15,29
143,FremontBridge,10/08/2012 11:00:00 PM,48,-122,13,11,24
144,FremontBridge,10/09/2012 12:00:00 AM,48,-122,4,8,12
145,FremontBridge,10/09/2012 01:00:00 AM,48,-122,2,1,3
146,FremontBridge,10/09/2012 02:00:00 AM,48,-122,2,2,4
147,FremontBridge,10/09/2012 03:00:00 AM,48,-122,3,5,8
148,FremontBridge,10/09/2012 04:00:00 AM,48,-122,5,4,9
149,FremontBridge,10/09/2012 05:00:00 AM,48,-122,9,22,31
150,FremontBridge,10/09/2012 06:00:00 AM,48,-122,50,103,153
151,FremontBridge,10/09/2012 07:00:00 AM,48,-122,110,258,368
152,FremontBridge,10/09/2012 08:00:00 AM,48,-122,145,317,462
153,FremontBridge,10/09/2012 09:00:00 AM,48,-122,112,163,275
154,FremontBridge,10/09/2012 10:00:00 AM,48,-122,36,58,94
155,FremontBridge,10/09/2012 11:00:00 AM,48,-122,45,29,74
156,FremontBridge,10/09/2012 12:00:00 PM,48,-122,40,37,77
157,FremontBridge,10/09/2012 01:00:00 PM,48,-122,37,46,83
158,FremontBridge,10/09/2012 02:00:00 PM,48,-122,54,54,108
159,FremontBridge,10/09/2012 03:00:00 PM,48,-122,72,62,134
160,FremontBridge,10/09/2012 04:00:00 PM,48,-122,149,95,244
161,FremontBridge,10/09/2012 05:00:00 PM,48,-122,400,197,597
162,FremontBridge,10/09/2012 06:00:00 PM,48,-122,244,152,396
163,FremontBridge,10/09/2012 07:00:00 PM,48,-122,105,58,163
164,FremontBridge,10/09/2012 08:00:00 PM,48,-122,53,32,85
165,FremontBridge,10/09/2012 09:00:00 PM,48,-122,34,30,64
166,FremontBridge,10/09/2012 10:00:00 PM,48,-122,17,17,34
167,FremontBridge,10/09/2012 11:00:00 PM,48,-122,14,9,23
168,FremontBridge,10/10/2012 12:00:00 AM,48,-122,7,8,15
169,FremontBridge,10/10/2012 01:00:00 AM,48,-122,2,1,3
170,FremontBridge,10/10/2012 02:00:00 AM,48,-122,0,3,3
171,FremontBridge,10/10/2012 03:00:00 AM,48,-122,3,1,4
172,FremontBridge,10/10/2012 04:00:00 AM,48,-122,2,3,5
173,FremontBridge,10/10/2012 05:00:00 AM,48,-122,9,16,25
174,FremontBridge,10/10/2012 06:00:00 AM,48,-122,40,109,149
175,FremontBridge,10/10/2012 07:00:00 AM,48,-122,95,245,340
176,FremontBridge,10/10/2012 08:00:00 AM,48,-122,133,302,435
177,FremontBridge,10/10/2012 09:00:00 AM,48,-122,99,156,255
178,FremontBridge,10/10/2012 10:00:00 AM,48,-122,44,53,97
179,FremontBridge,10/10/2012 11:00:00 AM,48,-122,21,34,55
180,FremontBridge,10/10/2012 12:00:00 PM,48,-122,40,47,87
181,FremontBridge,10/10/2012 01:00:00 PM,48,-122,48,46,94
182,FremontBridge,10/10/2012 02:00:00 PM,48,-122,39,54,93
183,FremontBridge,10/10/2012 03:00:00 PM,48,-122,65,65,130
184,FremontBridge,10/10/2012 04:00:00 PM,48,-122,128,102,230
185,FremontBridge,10/10/2012 05:00:00 PM,48,-122,377,155,532
186,FremontBridge,10/10/2012 06:00:00 PM,48,-122,215,116,331
187,FremontBridge,10/10/2012 07:00:00 PM,48,-122,94,51,145
188,FremontBridge,10/10/2012 08:00:00 PM,48,-122,56,30,86
189,FremontBridge,10/10/2012 09:00:00 PM,48,-122,38,24,62
190,FremontBridge,10/10/2012 10:00:00 PM,48,-122,19,17,36
191,FremontBridge,10/10/2012 11:00:00 PM,48,-122,13,10,23
192,FremontBridge,10/11/2012 12:00:00 AM,48,-122,14,7,21
193,FremontBridge,10/11/2012 01:00:00 AM,48,-122,6,4,10
194,FremontBridge,10/11/2012 02:00:00 AM,48,-122,5,8,13
195,FremontBridge,10/11/2012 03:00:00 AM,48,-122,2,0,2
196,FremontBridge,10/11/2012 04:00:00 AM,48,-122,1,11,12
197,FremontBridge,10/11/2012 05:00:00 AM,48,-122,12,0,12
198,FremontBridge,10/11/2012 06:00:00 AM,48,-122,41,2,43
199,FremontBridge,10/11/2012 07:00:00 AM,48,-122,79,225,304
200,FremontBridge,10/11/2012 08:00:00 AM,48,-122,122,282,404
201,FremontBridge,10/11/2012 09:00:00 AM,48,-122,48,141,189
202,FremontBridge,10/11/2012 10:00:00 AM,48,-122,0,4,4
203,FremontBridge,10/11/2012 11:00:00 AM,48,-122,5,87,92
204,FremontBridge,10/11/2012 12:00:00 PM,48,-122,37,44,81
205,FremontBridge,10/11/2012 01:00:00 PM,48,-122,58,60,118
206,FremontBridge,10/11/2012 02:00:00 PM,48,-122,56,52,108
207,FremontBridge,10/11/2012 03:00:00 PM,48,-122,69,74,143
208,FremontBridge,10/11/2012 04:00:00 PM,48,-122,135,135,270
209,FremontBridge,10/11/2012 05:00:00 PM,48,-122,360,157,517
210,FremontBridge,10/11/2012 06:00:00 PM,48,-122,186,113,299
211,FremontBridge,10/11/2012 07:00:00 PM,48,-122,92,57,149
212,FremontBridge,10/11/2012 08:00:00 PM,48,-122,60,44,104
213,FremontBridge,10/11/2012 09:00:00 PM,48,-122,45,26,71
214,FremontBridge,10/11/2012 10:00:00 PM,48,-122,19,29,48
215,FremontBridge,10/11/2012 11:00:00 PM,48,-122,16,17,33
216,FremontBridge,10/12/2012 12:00:00 AM,48,-122,9,8,17
217,FremontBridge,10/12/2012 01:00:00 AM,48,-122,6,7,13
218,FremontBridge,10/12/2012 02:00:00 AM,48,-122,1,4,5
219,FremontBridge,10/12/2012 03:00:00 AM,48,-122,3,4,7
220,FremontBridge,10/12/2012 04:00:00 AM,48,-122,3,2,5
221,FremontBridge,10/12/2012 05:00:00 AM,48,-122,4,10,14
222,FremontBridge,10/12/2012 06:00:00 AM,48,-122,30,57,87
223,FremontBridge,10/12/2012 07:00:00 AM,48,-122,58,125,183
224,FremontBridge,10/12/2012 08:00:00 AM,48,-122,86,182,268
225,FremontBridge,10/12/2012 09:00:00 AM,48,-122,45,100,145
226,FremontBridge,10/12/2012 10:00:00 AM,48,-122,29,33,62
227,FremontBridge,10/12/2012 11:00:00 AM,48,-122,31,27,58
228,FremontBridge,10/12/2012 12:00:00 PM,48,-122,28,41,69
229,FremontBridge,10/12/2012 01:00:00 PM,48,-122,33,39,72
230,FremontBridge,10/12/2012 02:00:00 PM,48,-122,30,35,65
231,FremontBridge,10/12/2012 03:00:00 PM,48,-122,63,50,113
232,FremontBridge,10/12/2012 04:00:00 PM,48,-122,96,69,165
233,FremontBridge,10/12/2012 05:00:00 PM,48,-122,212,92,304
234,FremontBridge,10/12/2012 06:00:00 PM,48,-122,112,66,178
235,FremontBridge,10/12/2012 07:00:00 PM,48,-122,49,30,79
236,FremontBridge,10/12/2012 08:00:00 PM,48,-122,27,11,38
237,FremontBridge,10/12/2012 09:00:00 PM,48,-122,16,10,26
238,FremontBridge,10/12/2012 10:00:00 PM,48,-122,3,11,14
239,FremontBridge,10/12/2012 11:00:00 PM,48,-122,15,9,24
240,FremontBridge,10/13/2012 12:00:00 AM,48,-122,12,6,18
241,FremontBridge,10/13/2012 01:00:00 AM,48,-122,6,5,11
242,FremontBridge,10/13/2012 02:00:00 AM,48,-122,6,10,16
243,FremontBridge,10/13/2012 03:00:00 AM,48,-122,0,4,4
244,FremontBridge,10/13/2012 04:00:00 AM,48,-122,2,1,3
245,FremontBridge,10/13/2012 05:00:00 AM,48,-122,3,7,10
246,FremontBridge,10/13/2012 06:00:00 AM,48,-122,5,9,14
247,FremontBridge,10/13/2012 07:00:00 AM,48,-122,13,17,30
248,FremontBridge,10/13/2012 08:00:00 AM,48,-122,8,24,32
249,FremontBridge,10/13/2012 09:00:00 AM,48,-122,20,21,41
250,FremontBridge,10/13/2012 10:00:00 AM,48,-122,17,29,46
251,FremontBridge,10/13/2012 11:00:00 AM,48,-122,14,28,42
252,FremontBridge,10/13/2012 12:00:00 PM,48,-122,24,48,72
253,FremontBridge,10/13/2012 01:00:00 PM,48,-122,26,38,64
254,FremontBridge,10/13/2012 02:00:00 PM,48,-122,32,30,62
255,FremontBridge,10/13/2012 03:00:00 PM,48,-122,20,21,41
256,FremontBridge,10/13/2012 04:00:00 PM,48,-122,32,26,58
257,FremontBridge,10/13/2012 05:00:00 PM,48,-122,25,25,50
258,FremontBridge,10/13/2012 06:00:00 PM,48,-122,24,35,59
259,FremontBridge,10/13/2012 07:00:00 PM,48,-122,17,10,27
260,FremontBridge,10/13/2012 08:00:00 PM,48,-122,10,9,19
261,FremontBridge,10/13/2012 09:00:00 PM,48,-122,6,4,10
262,FremontBridge,10/13/2012 10:00:00 PM,48,-122,14,4,18
263,FremontBridge,10/13/2012 11:00:00 PM,48,-122,15,4,19
264,FremontBridge,10/14/2012 12:00:00 AM,48,-122,3,3,6
265,FremontBridge,10/14/2012 01:00:00 AM,48,-122,4,5,9
266,FremontBridge,10/14/2012 02:00:00 AM,48,-122,4,4,8
267,FremontBridge,10/14/2012 03:00:00 AM,48,-122,0,4,4
268,FremontBridge,10/14/2012 04:00:00 AM,48,-122,1,4,5
269,FremontBridge,10/14/2012 05:00:00 AM,48,-122,0,3,3
270,FremontBridge,10/14/2012 06:00:00 AM,48,-122,7,5,12
271,FremontBridge,10/14/2012 07:00:00 AM,48,-122,4,10,14
272,FremontBridge,10/14/2012 08:00:00 AM,48,-122,8,16,24
273,FremontBridge,10/14/2012 09:00:00 AM,48,-122,26,28,54
274,FremontBridge,10/14/2012 10:00:00 AM,48,-122,25,47,72
275,FremontBridge,10/14/2012 11:00:00 AM,48,-122,18,63,81
276,FremontBridge,10/14/2012 12:00:00 PM,48,-122,22,40,62
277,FremontBridge,10/14/2012 01:00:00 PM,48,-122,33,49,82
278,FremontBridge,10/14/2012 02:00:00 PM,48,-122,30,28,58
279,FremontBridge,10/14/2012 03:00:00 PM,48,-122,15,22,37
280,FremontBridge,10/14/2012 04:00:00 PM,48,-122,16,18,34
281,FremontBridge,10/14/2012 05:00:00 PM,48,-122,10,27,37
282,FremontBridge,10/14/2012 06:00:00 PM,48,-122,9,18,27
283,FremontBridge,10/14/2012 07:00:00 PM,48,-122,13,10,23
284,FremontBridge,10/14/2012 08:00:00 PM,48,-122,6,5,11
285,FremontBridge,10/14/2012 09:00:00 PM,48,-122,4,8,12
286,FremontBridge,10/14/2012 10:00:00 PM,48,-122,6,7,13
287,FremontBridge,10/14/2012 11:00:00 PM,48,-122,7,3,10
288,FremontBridge,10/15/2012 12:00:00 AM,48,-122,5,2,7
289,FremontBridge,10/15/2012 01:00:00 AM,48,-122,1,2,3
290,FremontBridge,10/15/2012 02:00:00 AM,48,-122,1,4,5
291,FremontBridge,10/15/2012 03:00:00 AM,48,-122,2,1,3
292,FremontBridge,10/15/2012 04:00:00 AM,48,-122,2,4,6
293,FremontBridge,10/15/2012 05:00:00 AM,48,-122,7,19,26
294,FremontBridge,10/15/2012 06:00:00 AM,48,-122,34,59,93
295,FremontBridge,10/15/2012 07:00:00 AM,48,-122,58,167,225
296,FremontBridge,10/15/2012 08:00:00 AM,48,-122,92,235,327
297,FremontBridge,10/15/2012 09:00:00 AM,48,-122,73,130,203
298,FremontBridge,10/15/2012 10:00:00 AM,48,-122,29,57,86
299,FremontBridge,10/15/2012 11:00:00 AM,48,-122,21,45,66
300,FremontBridge,10/15/2012 12:00:00 PM,48,-122,38,46,84
301,FremontBridge,10/15/2012 01:00:00 PM,48,-122,29,42,71
302,FremontBridge,10/15/2012 02:00:00 PM,48,-122,33,40,73
303,FremontBridge,10/15/2012 03:00:00 PM,48,-122,58,49,107
304,FremontBridge,10/15/2012 04:00:00 PM,48,-122,76,64,140
305,FremontBridge,10/15/2012 05:00:00 PM,48,-122,239,96,335
306,FremontBridge,10/15/2012 06:00:00 PM,48,-122,150,54,204
307,FremontBridge,10/15/2012 07:00:00 PM,48,-122,51,27,78
308,FremontBridge,10/15/2012 08:00:00 PM,48,-122,38,17,55
309,FremontBridge,10/15/2012 09:00:00 PM,48,-122,18,18,36
310,FremontBridge,10/15/2012 10:00:00 PM,48,-122,11,15,26
311,FremontBridge,10/15/2012 11:00:00 PM,48,-122,7,7,14
312,FremontBridge,10/16/2012 12:00:00 AM,48,-122,4,6,10
313,FremontBridge,10/16/2012 01:00:00 AM,48,-122,3,2,5
314,FremontBridge,10/16/2012 02:00:00 AM,48,-122,0,3,3
315,FremontBridge,10/16/2012 03:00:00 AM,48,-122,4,1,5
316,FremontBridge,10/16/2012 04:00:00 AM,48,-122,3,2,5
317,FremontBridge,10/16/2012 05:00:00 AM,48,-122,8,21,29
318,FremontBridge,10/16/2012 06:00:00 AM,48,-122,34,88,122
319,FremontBridge,10/16/2012 07:00:00 AM,48,-122,69,187,256
320,FremontBridge,10/16/2012 08:00:00 AM,48,-122,104,253,357
321,FremontBridge,10/16/2012 09:00:00 AM,48,-122,77,130,207
322,FremontBridge,10/16/2012 10:00:00 AM,48,-122,47,77,124
323,FremontBridge,10/16/2012 11:00:00 AM,48,-122,36,47,83
324,FremontBridge,10/16/2012 12:00:00 PM,48,-122,26,49,75
325,FremontBridge,10/16/2012 01:00:00 PM,48,-122,42,48,90
326,FremontBridge,10/16/2012 02:00:00 PM,48,-122,44,53,97
327,FremontBridge,10/16/2012 03:00:00 PM,48,-122,86,77,163
328,FremontBridge,10/16/2012 04:00:00 PM,48,-122,146,109,255
329,FremontBridge,10/16/2012 05:00:00 PM,48,-122,353,147,500
330,FremontBridge,10/16/2012 06:00:00 PM,48,-122,198,109,307
331,FremontBridge,10/16/2012 07:00:00 PM,48,-122,90,45,135
332,FremontBridge,10/16/2012 08:00:00 PM,48,-122,47,41,88
333,FremontBridge,10/16/2012 09:00:00 PM,48,-122,30,35,65
334,FremontBridge,10/16/2012 10:00:00 PM,48,-122,14,16,30
335,FremontBridge,10/16/2012 11:00:00 PM,48,-122,12,13,25
336,FremontBridge,10/17/2012 12:00:00 AM,48,-122,9,13,22
337,FremontBridge,10/17/2012 01:00:00 AM,48,-122,3,3,6
338,FremontBridge,10/17/2012 02:00:00 AM,48,-122,3,2,5
339,FremontBridge,10/17/2012 03:00:00 AM,48,-122,4,0,4
340,FremontBridge,10/17/2012 04:00:00 AM,48,-122,3,4,7
341,FremontBridge,10/17/2012 05:00:00 AM,48,-122,9,21,30
342,FremontBridge,10/17/2012 06:00:00 AM,48,-122,44,89,133
343,FremontBridge,10/17/2012 07:00:00 AM,48,-122,85,213,298
344,FremontBridge,10/17/2012 08:00:00 AM,48,-122,133,283,416
345,FremontBridge,10/17/2012 09:00:00 AM,48,-122,78,166,244
346,FremontBridge,10/17/2012 10:00:00 AM,48,-122,47,49,96
347,FremontBridge,10/17/2012 11:00:00 AM,48,-122,26,52,78
348,FremontBridge,10/17/2012 12:00:00 PM,48,-122,50,61,111
349,FremontBridge,10/17/2012 01:00:00 PM,48,-122,40,56,96
350,FremontBridge,10/17/2012 02:00:00 PM,48,-122,51,54,105
351,FremontBridge,10/17/2012 03:00:00 PM,48,-122,89,72,161
352,FremontBridge,10/17/2012 04:00:00 PM,48,-122,145,113,258
353,FremontBridge,10/17/2012 05:00:00 PM,48,-122,332,150,482
354,FremontBridge,10/17/2012 06:00:00 PM,48,-122,241,117,358
355,FremontBridge,10/17/2012 07:00:00 PM,48,-122,94,51,145
356,FremontBridge,10/17/2012 08:00:00 PM,48,-122,40,18,58
357,FremontBridge,10/17/2012 09:00:00 PM,48,-122,41,25,66
358,FremontBridge,10/17/2012 10:00:00 PM,48,-122,23,25,48
359,FremontBridge,10/17/2012 11:00:00 PM,48,-122,6,10,16
360,FremontBridge,10/18/2012 12:00:00 AM,48,-122,0,7,7
361,FremontBridge,10/18/2012 01:00:00 AM,48,-122,4,3,7
362,FremontBridge,10/18/2012 02:00:00 AM,48,-122,4,5,9
363,FremontBridge,10/18/2012 03:00:00 AM,48,-122,4,1,5
364,FremontBridge,10/18/2012 04:00:00 AM,48,-122,1,7,8
365,FremontBridge,10/18/2012 05:00:00 AM,48,-122,12,14,26
366,FremontBridge,10/18/2012 06:00:00 AM,48,-122,35,88,123
367,FremontBridge,10/18/2012 07:00:00 AM,48,-122,73,206,279
368,FremontBridge,10/18/2012 08:00:00 AM,48,-122,130,246,376
369,FremontBridge,10/18/2012 09:00:00 AM,48,-122,83,147,230
370,FremontBridge,10/18/2012 10:00:00 AM,48,-122,35,59,94
371,FremontBridge,10/18/2012 11:00:00 AM,48,-122,46,47,93
372,FremontBridge,10/18/2012 12:00:00 PM,48,-122,56,54,110
373,FremontBridge,10/18/2012 01:00:00 PM,48,-122,70,51,121
374,FremontBridge,10/18/2012 02:00:00 PM,48,-122,51,53,104
375,FremontBridge,10/18/2012 03:00:00 PM,48,-122,77,68,145
376,FremontBridge,10/18/2012 04:00:00 PM,48,-122,132,98,230
377,FremontBridge,10/18/2012 05:00:00 PM,48,-122,334,130,464
378,FremontBridge,10/18/2012 06:00:00 PM,48,-122,191,89,280
379,FremontBridge,10/18/2012 07:00:00 PM,48,-122,62,25,87
380,FremontBridge,10/18/2012 08:00:00 PM,48,-122,34,25,59
381,FremontBridge,10/18/2012 09:00:00 PM,48,-122,23,13,36
382,FremontBridge,10/18/2012 10:00:00 PM,48,-122,10,6,16
383,FremontBridge,10/18/2012 11:00:00 PM,48,-122,7,7,14
384,FremontBridge,10/19/2012 12:00:00 AM,48,-122,9,3,12
385,FremontBridge,10/19/2012 01:00:00 AM,48,-122,1,3,4
386,FremontBridge,10/19/2012 02:00:00 AM,48,-122,1,4,5
387,FremontBridge,10/19/2012 03:00:00 AM,48,-122,2,0,2
388,FremontBridge,10/19/2012 04:00:00 AM,48,-122,5,4,9
389,FremontBridge,10/19/2012 05:00:00 AM,48,-122,6,20,26
390,FremontBridge,10/19/2012 06:00:00 AM,48,-122,21,50,71
391,FremontBridge,10/19/2012 07:00:00 AM,48,-122,54,126,180
392,FremontBridge,10/19/2012 08:00:00 AM,48,-122,76,169,245
393,FremontBridge,10/19/2012 09:00:00 AM,48,-122,76,93,169
394,FremontBridge,10/19/2012 10:00:00 AM,48,-122,24,41,65
395,FremontBridge,10/19/2012 11:00:00 AM,48,-122,26,26,52
396,FremontBridge,10/19/2012 12:00:00 PM,48,-122,24,26,50
397,FremontBridge,10/19/2012 01:00:00 PM,48,-122,44,34,78
398,FremontBridge,10/19/2012 02:00:00 PM,48,-122,36,39,75
399,FremontBridge,10/19/2012 03:00:00 PM,48,-122,56,54,110
400,FremontBridge,10/19/2012 04:00:00 PM,48,-122,98,79,177
401,FremontBridge,10/19/2012 05:00:00 PM,48,-122,212,85,297
402,FremontBridge,10/19/2012 06:00:00 PM,48,-122,134,57,191
403,FremontBridge,10/19/2012 07:00:00 PM,48,-122,46,16,62
404,FremontBridge,10/19/2012 08:00:00 PM,48,-122,29,13,42
405,FremontBridge,10/19/2012 09:00:00 PM,48,-122,12,7,19
406,FremontBridge,10/19/2012 10:00:00 PM,48,-122,9,8,17
407,FremontBridge,10/19/2012 11:00:00 PM,48,-122,11,8,19
408,FremontBridge,10/20/2012 12:00:00 AM,48,-122,5,4,9
409,FremontBridge,10/20/2012 01:00:00 AM,48,-122,7,1,8
410,FremontBridge,10/20/2012 02:00:00 AM,48,-122,4,8,12
411,FremontBridge,10/20/2012 03:00:00 AM,48,-122,3,2,5
412,FremontBridge,10/20/2012 04:00:00 AM,48,-122,2,1,3
413,FremontBridge,10/20/2012 05:00:00 AM,48,-122,6,9,15
414,FremontBridge,10/20/2012 06:00:00 AM,48,-122,6,10,16
415,FremontBridge,10/20/2012 07:00:00 AM,48,-122,12,16,28
416,FremontBridge,10/20/2012 08:00:00 AM,48,-122,18,28,46
417,FremontBridge,10/20/2012 09:00:00 AM,48,-122,30,29,59
418,FremontBridge,10/20/2012 10:00:00 AM,48,-122,31,52,83
419,FremontBridge,10/20/2012 11:00:00 AM,48,-122,33,59,92
420,FremontBridge,10/20/2012 12:00:00 PM,48,-122,34,64,98
421,FremontBridge,10/20/2012 01:00:00 PM,48,-122,51,62,113
422,FremontBridge,10/20/2012 02:00:00 PM,48,-122,46,52,98
423,FremontBridge,10/20/2012 03:00:00 PM,48,-122,28,44,72
424,FremontBridge,10/20/2012 04:00:00 PM,48,-122,46,30,76
425,FremontBridge,10/20/2012 05:00:00 PM,48,-122,26,37,63
426,FremontBridge,10/20/2012 06:00:00 PM,48,-122,38,31,69
427,FremontBridge,10/20/2012 07:00:00 PM,48,-122,18,18,36
428,FremontBridge,10/20/2012 08:00:00 PM,48,-122,12,10,22
429,FremontBridge,10/20/2012 09:00:00 PM,48,-122,8,5,13
430,FremontBridge,10/20/2012 10:00:00 PM,48,-122,6,6,12
431,FremontBridge,10/20/2012 11:00:00 PM,48,-122,12,8,20
432,FremontBridge,10/21/2012 12:00:00 AM,48,-122,12,5,17
433,FremontBridge,10/21/2012 01:00:00 AM,48,-122,9,2,11
434,FremontBridge,10/21/2012 02:00:00 AM,48,-122,4,7,11
435,FremontBridge,10/21/2012 03:00:00 AM,48,-122,1,3,4
436,FremontBridge,10/21/2012 04:00:00 AM,48,-122,1,3,4
437,FremontBridge,10/21/2012 05:00:00 AM,48,-122,4,4,8
438,FremontBridge,10/21/2012 06:00:00 AM,48,-122,5,8,13
439,FremontBridge,10/21/2012 07:00:00 AM,48,-122,6,9,15
440,FremontBridge,10/21/2012 08:00:00 AM,48,-122,11,26,37
441,FremontBridge,10/21/2012 09:00:00 AM,48,-122,22,28,50
442,FremontBridge,10/21/2012 10:00:00 AM,48,-122,28,38,66
443,FremontBridge,10/21/2012 11:00:00 AM,48,-122,23,34,57
444,FremontBridge,10/21/2012 12:00:00 PM,48,-122,37,63,100
445,FremontBridge,10/21/2012 01:00:00 PM,48,-122,41,48,89
446,FremontBridge,10/21/2012 02:00:00 PM,48,-122,47,67,114
447,FremontBridge,10/21/2012 03:00:00 PM,48,-122,52,63,115
448,FremontBridge,10/21/2012 04:00:00 PM,48,-122,30,42,72
449,FremontBridge,10/21/2012 05:00:00 PM,48,-122,46,36,82
450,FremontBridge,10/21/2012 06:00:00 PM,48,-122,19,25,44
451,FremontBridge,10/21/2012 07:00:00 PM,48,-122,10,7,17
452,FremontBridge,10/21/2012 08:00:00 PM,48,-122,18,3,21
453,FremontBridge,10/21/2012 09:00:00 PM,48,-122,10,16,26
454,FremontBridge,10/21/2012 10:00:00 PM,48,-122,7,2,9
455,FremontBridge,10/21/2012 11:00:00 PM,48,-122,6,1,7
456,FremontBridge,10/22/2012 12:00:00 AM,48,-122,2,4,6
457,FremontBridge,10/22/2012 01:00:00 AM,48,-122,3,1,4
458,FremontBridge,10/22/2012 02:00:00 AM,48,-122,0,2,2
459,FremontBridge,10/22/2012 03:00:00 AM,48,-122,3,1,4
460,FremontBridge,10/22/2012 04:00:00 AM,48,-122,5,5,10
461,FremontBridge,10/22/2012 05:00:00 AM,48,-122,8,19,27
462,FremontBridge,10/22/2012 06:00:00 AM,48,-122,32,85,117
463,FremontBridge,10/22/2012 07:00:00 AM,48,-122,74,184,258
464,FremontBridge,10/22/2012 08:00:00 AM,48,-122,92,256,348
465,FremontBridge,10/22/2012 09:00:00 AM,48,-122,54,107,161
466,FremontBridge,10/22/2012 10:00:00 AM,48,-122,38,29,67
467,FremontBridge,10/22/2012 11:00:00 AM,48,-122,20,22,42
468,FremontBridge,10/22/2012 12:00:00 PM,48,-122,23,18,41
469,FremontBridge,10/22/2012 01:00:00 PM,48,-122,20,20,40
470,FremontBridge,10/22/2012 02:00:00 PM,48,-122,26,19,45
471,FremontBridge,10/22/2012 03:00:00 PM,48,-122,38,33,71
472,FremontBridge,10/22/2012 04:00:00 PM,48,-122,87,63,150
473,FremontBridge,10/22/2012 05:00:00 PM,48,-122,272,97,369
474,FremontBridge,10/22/2012 06:00:00 PM,48,-122,145,54,199
475,FremontBridge,10/22/2012 07:00:00 PM,48,-122,49,25,74
476,FremontBridge,10/22/2012 08:00:00 PM,48,-122,26,14,40
477,FremontBridge,10/22/2012 09:00:00 PM,48,-122,11,17,28
478,FremontBridge,10/22/2012 10:00:00 PM,48,-122,9,6,15
479,FremontBridge,10/22/2012 11:00:00 PM,48,-122,4,7,11
480,FremontBridge,10/23/2012 12:00:00 AM,48,-122,3,3,6
481,FremontBridge,10/23/2012 01:00:00 AM,48,-122,1,1,2
482,FremontBridge,10/23/2012 02:00:00 AM,48,-122,1,2,3
483,FremontBridge,10/23/2012 03:00:00 AM,48,-122,1,0,1
484,FremontBridge,10/23/2012 04:00:00 AM,48,-122,6,5,11
485,FremontBridge,10/23/2012 05:00:00 AM,48,-122,8,27,35
486,FremontBridge,10/23/2012 06:00:00 AM,48,-122,33,79,112
487,FremontBridge,10/23/2012 07:00:00 AM,48,-122,67,169,236
488,FremontBridge,10/23/2012 08:00:00 AM,48,-122,105,238,343
489,FremontBridge,10/23/2012 09:00:00 AM,48,-122,58,110,168
490,FremontBridge,10/23/2012 10:00:00 AM,48,-122,31,48,79
491,FremontBridge,10/23/2012 11:00:00 AM,48,-122,25,27,52
492,FremontBridge,10/23/2012 12:00:00 PM,48,-122,35,33,68
493,FremontBridge,10/23/2012 01:00:00 PM,48,-122,23,36,59
494,FremontBridge,10/23/2012 02:00:00 PM,48,-122,38,38,76
495,FremontBridge,10/23/2012 03:00:00 PM,48,-122,49,51,100
496,FremontBridge,10/23/2012 04:00:00 PM,48,-122,114,76,190
497,FremontBridge,10/23/2012 05:00:00 PM,48,-122,299,135,434
498,FremontBridge,10/23/2012 06:00:00 PM,48,-122,194,76,270
499,FremontBridge,10/23/2012 07:00:00 PM,48,-122,67,37,104
500,FremontBridge,10/23/2012 08:00:00 PM,48,-122,38,21,59
501,FremontBridge,10/23/2012 09:00:00 PM,48,-122,26,24,50
502,FremontBridge,10/23/2012 10:00:00 PM,48,-122,10,11,21
503,FremontBridge,10/23/2012 11:00:00 PM,48,-122,5,16,21
504,FremontBridge,10/24/2012 12:00:00 AM,48,-122,8,3,11
505,FremontBridge,10/24/2012 01:00:00 AM,48,-122,9,2,11
506,FremontBridge,10/24/2012 02:00:00 AM,48,-122,2,7,9
507,FremontBridge,10/24/2012 03:00:00 AM,48,-122,3,1,4
508,FremontBridge,10/24/2012 04:00:00 AM,48,-122,3,2,5
509,FremontBridge,10/24/2012 05:00:00 AM,48,-122,9,16,25
510,FremontBridge,10/24/2012 06:00:00 AM,48,-122,39,79,118
511,FremontBridge,10/24/2012 07:00:00 AM,48,-122,67,158,225
512,FremontBridge,10/24/2012 08:00:00 AM,48,-122,89,224,313
513,FremontBridge,10/24/2012 09:00:00 AM,48,-122,64,108,172
514,FremontBridge,10/24/2012 10:00:00 AM,48,-122,38,40,78
515,FremontBridge,10/24/2012 11:00:00 AM,48,-122,14,35,49
516,FremontBridge,10/24/2012 12:00:00 PM,48,-122,15,20,35
517,FremontBridge,10/24/2012 01:00:00 PM,48,-122,28,38,66
518,FremontBridge,10/24/2012 02:00:00 PM,48,-122,32,46,78
519,FremontBridge,10/24/2012 03:00:00 PM,48,-122,61,40,101
520,FremontBridge,10/24/2012 04:00:00 PM,48,-122,104,88,192
521,FremontBridge,10/24/2012 05:00:00 PM,48,-122,261,138,399
522,FremontBridge,10/24/2012 06:00:00 PM,48,-122,165,100,265
523,FremontBridge,10/24/2012 07:00:00 PM,48,-122,79,38,117
524,FremontBridge,10/24/2012 08:00:00 PM,48,-122,35,27,62
525,FremontBridge,10/24/2012 09:00:00 PM,48,-122,26,20,46
526,FremontBridge,10/24/2012 10:00:00 PM,48,-122,21,12,33
527,FremontBridge,10/24/2012 11:00:00 PM,48,-122,7,8,15
528,FremontBridge,10/25/2012 12:00:00 AM,48,-122,1,2,3
529,FremontBridge,10/25/2012 01:00:00 AM,48,-122,5,1,6
530,FremontBridge,10/25/2012 02:00:00 AM,48,-122,1,2,3
531,FremontBridge,10/25/2012 03:00:00 AM,48,-122,2,1,3
532,FremontBridge,10/25/2012 04:00:00 AM,48,-122,1,4,5
533,FremontBridge,10/25/2012 05:00:00 AM,48,-122,14,19,33
534,FremontBridge,10/25/2012 06:00:00 AM,48,-122,38,81,119
535,FremontBridge,10/25/2012 07:00:00 AM,48,-122,60,184,244
536,FremontBridge,10/25/2012 08:00:00 AM,48,-122,114,227,341
537,FremontBridge,10/25/2012 09:00:00 AM,48,-122,69,133,202
538,FremontBridge,10/25/2012 10:00:00 AM,48,-122,23,60,83
539,FremontBridge,10/25/2012 11:00:00 AM,48,-122,26,29,55
540,FremontBridge,10/25/2012 12:00:00 PM,48,-122,35,39,74
541,FremontBridge,10/25/2012 01:00:00 PM,48,-122,38,42,80
542,FremontBridge,10/25/2012 02:00:00 PM,48,-122,38,52,90
543,FremontBridge,10/25/2012 03:00:00 PM,48,-122,86,60,146
544,FremontBridge,10/25/2012 04:00:00 PM,48,-122,138,93,231
545,FremontBridge,10/25/2012 05:00:00 PM,48,-122,295,130,425
546,FremontBridge,10/25/2012 06:00:00 PM,48,-122,193,79,272
547,FremontBridge,10/25/2012 07:00:00 PM,48,-122,61,47,108
548,FremontBridge,10/25/2012 08:00:00 PM,48,-122,49,30,79
549,FremontBridge,10/25/2012 09:00:00 PM,48,-122,34,21,55
550,FremontBridge,10/25/2012 10:00:00 PM,48,-122,19,9,28
551,FremontBridge,10/25/2012 11:00:00 PM,48,-122,12,16,28
552,FremontBridge,10/26/2012 12:00:00 AM,48,-122,8,11,19
553,FremontBridge,10/26/2012 01:00:00 AM,48,-122,7,9,16
554,FremontBridge,10/26/2012 02:00:00 AM,48,-122,1,3,4
555,FremontBridge,10/26/2012 03:00:00 AM,48,-122,1,0,1
556,FremontBridge,10/26/2012 04:00:00 AM,48,-122,6,4,10
557,FremontBridge,10/26/2012 05:00:00 AM,48,-122,9,12,21
558,FremontBridge,10/26/2012 06:00:00 AM,48,-122,32,55,87
559,FremontBridge,10/26/2012 07:00:00 AM,48,-122,66,137,203
560,FremontBridge,10/26/2012 08:00:00 AM,48,-122,96,187,283
561,FremontBridge,10/26/2012 09:00:00 AM,48,-122,55,116,171
562,FremontBridge,10/26/2012 10:00:00 AM,48,-122,27,59,86
563,FremontBridge,10/26/2012 11:00:00 AM,48,-122,22,28,50
564,FremontBridge,10/26/2012 12:00:00 PM,48,-122,20,22,42
565,FremontBridge,10/26/2012 01:00:00 PM,48,-122,27,13,40
566,FremontBridge,10/26/2012 02:00:00 PM,48,-122,33,26,59
567,FremontBridge,10/26/2012 03:00:00 PM,48,-122,67,49,116
568,FremontBridge,10/26/2012 04:00:00 PM,48,-122,108,90,198
569,FremontBridge,10/26/2012 05:00:00 PM,48,-122,204,94,298
570,FremontBridge,10/26/2012 06:00:00 PM,48,-122,131,65,196
571,FremontBridge,10/26/2012 07:00:00 PM,48,-122,43,22,65
572,FremontBridge,10/26/2012 08:00:00 PM,48,-122,28,14,42
573,FremontBridge,10/26/2012 09:00:00 PM,48,-122,24,9,33
574,FremontBridge,10/26/2012 10:00:00 PM,48,-122,9,6,15
575,FremontBridge,10/26/2012 11:00:00 PM,48,-122,10,8,18
576,FremontBridge,10/27/2012 12:00:00 AM,48,-122,6,6,12
577,FremontBridge,10/27/2012 01:00:00 AM,48,-122,3,6,9
578,FremontBridge,10/27/2012 02:00:00 AM,48,-122,10,6,16
579,FremontBridge,10/27/2012 03:00:00 AM,48,-122,1,1,2
580,FremontBridge,10/27/2012 04:00:00 AM,48,-122,3,2,5
581,FremontBridge,10/27/2012 05:00:00 AM,48,-122,6,7,13
582,FremontBridge,10/27/2012 06:00:00 AM,48,-122,6,7,13
583,FremontBridge,10/27/2012 07:00:00 AM,48,-122,6,9,15
584,FremontBridge,10/27/2012 08:00:00 AM,48,-122,13,12,25
585,FremontBridge,10/27/2012 09:00:00 AM,48,-122,11,14,25
586,FremontBridge,10/27/2012 10:00:00 AM,48,-122,11,10,21
587,FremontBridge,10/27/2012 11:00:00 AM,48,-122,9,22,31
588,FremontBridge,10/27/2012 12:00:00 PM,48,-122,12,13,25
589,FremontBridge,10/27/2012 01:00:00 PM,48,-122,13,28,41
590,FremontBridge,10/27/2012 02:00:00 PM,48,-122,28,23,51
591,FremontBridge,10/27/2012 03:00:00 PM,48,-122,21,30,51
592,FremontBridge,10/27/2012 04:00:00 PM,48,-122,32,27,59
593,FremontBridge,10/27/2012 05:00:00 PM,48,-122,10,26,36
594,FremontBridge,10/27/2012 06:00:00 PM,48,-122,7,11,18
595,FremontBridge,10/27/2012 07:00:00 PM,48,-122,7,8,15
596,FremontBridge,10/27/2012 08:00:00 PM,48,-122,3,5,8
597,FremontBridge,10/27/2012 09:00:00 PM,48,-122,11,6,17
598,FremontBridge,10/27/2012 10:00:00 PM,48,-122,5,7,12
599,FremontBridge,10/27/2012 11:00:00 PM,48,-122,8,3,11
600,FremontBridge,10/28/2012 12:00:00 AM,48,-122,5,5,10
601,FremontBridge,10/28/2012 01:00:00 AM,48,-122,11,0,11
602,FremontBridge,10/28/2012 02:00:00 AM,48,-122,3,4,7
603,FremontBridge,10/28/2012 03:00:00 AM,48,-122,3,1,4
604,FremontBridge,10/28/2012 04:00:00 AM,48,-122,1,2,3
605,FremontBridge,10/28/2012 05:00:00 AM,48,-122,1,5,6
606,FremontBridge,10/28/2012 06:00:00 AM,48,-122,9,1,10
607,FremontBridge,10/28/2012 07:00:00 AM,48,-122,6,11,17
608,FremontBridge,10/28/2012 08:00:00 AM,48,-122,15,16,31
609,FremontBridge,10/28/2012 09:00:00 AM,48,-122,24,18,42
610,FremontBridge,10/28/2012 10:00:00 AM,48,-122,24,29,53
611,FremontBridge,10/28/2012 11:00:00 AM,48,-122,31,47,78
612,FremontBridge,10/28/2012 12:00:00 PM,48,-122,42,73,115
613,FremontBridge,10/28/2012 01:00:00 PM,48,-122,51,74,125
614,FremontBridge,10/28/2012 02:00:00 PM,48,-122,49,89,138
615,FremontBridge,10/28/2012 03:00:00 PM,48,-122,46,74,120
616,FremontBridge,10/28/2012 04:00:00 PM,48,-122,40,59,99
617,FremontBridge,10/28/2012 05:00:00 PM,48,-122,39,50,89
618,FremontBridge,10/28/2012 06:00:00 PM,48,-122,13,21,34
619,FremontBridge,10/28/2012 07:00:00 PM,48,-122,11,10,21
620,FremontBridge,10/28/2012 08:00:00 PM,48,-122,9,8,17
621,FremontBridge,10/28/2012 09:00:00 PM,48,-122,7,5,12
622,FremontBridge,10/28/2012 10:00:00 PM,48,-122,6,8,14
623,FremontBridge,10/28/2012 11:00:00 PM,48,-122,5,1,6
624,FremontBridge,10/29/2012 12:00:00 AM,48,-122,7,4,11
625,FremontBridge,10/29/2012 01:00:00 AM,48,-122,1,0,1
626,FremontBridge,10/29/2012 02:00:00 AM,48,-122,1,2,3
627,FremontBridge,10/29/2012 03:00:00 AM,48,-122,2,0,2
628,FremontBridge,10/29/2012 04:00:00 AM,48,-122,3,2,5
629,FremontBridge,10/29/2012 05:00:00 AM,48,-122,5,17,22
630,FremontBridge,10/29/2012 06:00:00 AM,48,-122,30,65,95
631,FremontBridge,10/29/2012 07:00:00 AM,48,-122,53,161,214
632,FremontBridge,10/29/2012 08:00:00 AM,48,-122,87,187,274
633,FremontBridge,10/29/2012 09:00:00 AM,48,-122,51,101,152
634,FremontBridge,10/29/2012 10:00:00 AM,48,-122,36,37,73
635,FremontBridge,10/29/2012 11:00:00 AM,48,-122,29,26,55
636,FremontBridge,10/29/2012 12:00:00 PM,48,-122,21,36,57
637,FremontBridge,10/29/2012 01:00:00 PM,48,-122,23,40,63
638,FremontBridge,10/29/2012 02:00:00 PM,48,-122,34,48,82
639,FremontBridge,10/29/2012 03:00:00 PM,48,-122,53,36,89
640,FremontBridge,10/29/2012 04:00:00 PM,48,-122,85,92,177
641,FremontBridge,10/29/2012 05:00:00 PM,48,-122,247,129,376
642,FremontBridge,10/29/2012 06:00:00 PM,48,-122,164,82,246
643,FremontBridge,10/29/2012 07:00:00 PM,48,-122,58,35,93
644,FremontBridge,10/29/2012 08:00:00 PM,48,-122,36,19,55
645,FremontBridge,10/29/2012 09:00:00 PM,48,-122,27,13,40
646,FremontBridge,10/29/2012 10:00:00 PM,48,-122,9,6,15
647,FremontBridge,10/29/2012 11:00:00 PM,48,-122,9,8,17
648,FremontBridge,10/30/2012 12:00:00 AM,48,-122,7,8,15
649,FremontBridge,10/30/2012 01:00:00 AM,48,-122,0,1,1
650,FremontBridge,10/30/2012 02:00:00 AM,48,-122,1,4,5
651,FremontBridge,10/30/2012 03:00:00 AM,48,-122,2,1,3
652,FremontBridge,10/30/2012 04:00:00 AM,48,-122,3,3,6
653,FremontBridge,10/30/2012 05:00:00 AM,48,-122,6,18,24
654,FremontBridge,10/30/2012 06:00:00 AM,48,-122,23,59,82
655,FremontBridge,10/30/2012 07:00:00 AM,48,-122,49,151,200
656,FremontBridge,10/30/2012 08:00:00 AM,48,-122,75,185,260
657,FremontBridge,10/30/2012 09:00:00 AM,48,-122,53,88,141
658,FremontBridge,10/30/2012 10:00:00 AM,48,-122,23,33,56
659,FremontBridge,10/30/2012 11:00:00 AM,48,-122,13,22,35
660,FremontBridge,10/30/2012 12:00:00 PM,48,-122,13,17,30
661,FremontBridge,10/30/2012 01:00:00 PM,48,-122,14,27,41
662,FremontBridge,10/30/2012 02:00:00 PM,48,-122,24,19,43
663,FremontBridge,10/30/2012 03:00:00 PM,48,-122,31,33,64
664,FremontBridge,10/30/2012 04:00:00 PM,48,-122,70,43,113
665,FremontBridge,10/30/2012 05:00:00 PM,48,-122,199,83,282
666,FremontBridge,10/30/2012 06:00:00 PM,48,-122,132,57,189
667,FremontBridge,10/30/2012 07:00:00 PM,48,-122,44,21,65
668,FremontBridge,10/30/2012 08:00:00 PM,48,-122,20,15,35
669,FremontBridge,10/30/2012 09:00:00 PM,48,-122,8,8,16
670,FremontBridge,10/30/2012 10:00:00 PM,48,-122,8,8,16
671,FremontBridge,10/30/2012 11:00:00 PM,48,-122,5,8,13
672,FremontBridge,10/31/2012 12:00:00 AM,48,-122,2,2,4
673,FremontBridge,10/31/2012 01:00:00 AM,48,-122,1,4,5
674,FremontBridge,10/31/2012 02:00:00 AM,48,-122,0,2,2
675,FremontBridge,10/31/2012 03:00:00 AM,48,-122,1,0,1
676,FremontBridge,10/31/2012 04:00:00 AM,48,-122,4,7,11
677,FremontBridge,10/31/2012 05:00:00 AM,48,-122,4,7,11
678,FremontBridge,10/31/2012 06:00:00 AM,48,-122,22,47,69
679,FremontBridge,10/31/2012 07:00:00 AM,48,-122,37,133,170
680,FremontBridge,10/31/2012 08:00:00 AM,48,-122,76,169,245
681,FremontBridge,10/31/2012 09:00:00 AM,48,-122,37,88,125
682,FremontBridge,10/31/2012 10:00:00 AM,48,-122,16,26,42
683,FremontBridge,10/31/2012 11:00:00 AM,48,-122,17,36,53
684,FremontBridge,10/31/2012 12:00:00 PM,48,-122,27,28,55
685,FremontBridge,10/31/2012 01:00:00 PM,48,-122,21,14,35
686,FremontBridge,10/31/2012 02:00:00 PM,48,-122,21,28,49
687,FremontBridge,10/31/2012 03:00:00 PM,48,-122,48,32,80
688,FremontBridge,10/31/2012 04:00:00 PM,48,-122,94,57,151
689,FremontBridge,10/31/2012 05:00:00 PM,48,-122,189,91,280
690,FremontBridge,10/31/2012 06:00:00 PM,48,-122,100,43,143
691,FremontBridge,10/31/2012 07:00:00 PM,48,-122,54,34,88
692,FremontBridge,10/31/2012 08:00:00 PM,48,-122,31,14,45
693,FremontBridge,10/31/2012 09:00:00 PM,48,-122,6,8,14
694,FremontBridge,10/31/2012 10:00:00 PM,48,-122,6,8,14
695,FremontBridge,10/31/2012 11:00:00 PM,48,-122,13,5,18
696,FremontBridge,11/01/2012 12:00:00 AM,48,-122,3,4,7
697,FremontBridge,11/01/2012 01:00:00 AM,48,-122,3,2,5
698,FremontBridge,11/01/2012 02:00:00 AM,48,-122,1,1,2
699,FremontBridge,11/01/2012 03:00:00 AM,48,-122,0,0,0
700,FremontBridge,11/01/2012 04:00:00 AM,48,-122,4,2,6
701,FremontBridge,11/01/2012 05:00:00 AM,48,-122,7,11,18
702,FremontBridge,11/01/2012 06:00:00 AM,48,-122,26,63,89
703,FremontBridge,11/01/2012 07:00:00 AM,48,-122,52,146,198
704,FremontBridge,11/01/2012 08:00:00 AM,48,-122,81,179,260
705,FremontBridge,11/01/2012 09:00:00 AM,48,-122,55,75,130
706,FremontBridge,11/01/2012 10:00:00 AM,48,-122,17,39,56
707,FremontBridge,11/01/2012 11:00:00 AM,48,-122,17,23,40
708,FremontBridge,11/01/2012 12:00:00 PM,48,-122,31,27,58
709,FremontBridge,11/01/2012 01:00:00 PM,48,-122,27,41,68
710,FremontBridge,11/01/2012 02:00:00 PM,48,-122,29,42,71
711,FremontBridge,11/01/2012 03:00:00 PM,48,-122,60,40,100
712,FremontBridge,11/01/2012 04:00:00 PM,48,-122,93,94,187
713,FremontBridge,11/01/2012 05:00:00 PM,48,-122,223,93,316
714,FremontBridge,11/01/2012 06:00:00 PM,48,-122,162,71,233
715,FremontBridge,11/01/2012 07:00:00 PM,48,-122,68,38,106
716,FremontBridge,11/01/2012 08:00:00 PM,48,-122,35,24,59
717,FremontBridge,11/01/2012 09:00:00 PM,48,-122,18,22,40
718,FremontBridge,11/01/2012 10:00:00 PM,48,-122,8,13,21
719,FremontBridge,11/01/2012 11:00:00 PM,48,-122,10,11,21
720,FremontBridge,11/02/2012 12:00:00 AM,48,-122,2,4,6
721,FremontBridge,11/02/2012 01:00:00 AM,48,-122,4,3,7
722,FremontBridge,11/02/2012 02:00:00 AM,48,-122,0,2,2
723,FremontBridge,11/02/2012 03:00:00 AM,48,-122,1,3,4
724,FremontBridge,11/02/2012 04:00:00 AM,48,-122,5,5,10
725,FremontBridge,11/02/2012 05:00:00 AM,48,-122,6,11,17
726,FremontBridge,11/02/2012 06:00:00 AM,48,-122,38,76,114
727,FremontBridge,11/02/2012 07:00:00 AM,48,-122,68,162,230
728,FremontBridge,11/02/2012 08:00:00 AM,48,-122,91,245,336
729,FremontBridge,11/02/2012 09:00:00 AM,48,-122,65,133,198
730,FremontBridge,11/02/2012 10:00:00 AM,48,-122,39,41,80
731,FremontBridge,11/02/2012 11:00:00 AM,48,-122,34,41,75
732,FremontBridge,11/02/2012 12:00:00 PM,48,-122,31,49,80
733,FremontBridge,11/02/2012 01:00:00 PM,48,-122,48,59,107
734,FremontBridge,11/02/2012 02:00:00 PM,48,-122,29,62,91
735,FremontBridge,11/02/2012 03:00:00 PM,48,-122,67,92,159
736,FremontBridge,11/02/2012 04:00:00 PM,48,-122,121,114,235
737,FremontBridge,11/02/2012 05:00:00 PM,48,-122,254,94,348
738,FremontBridge,11/02/2012 06:00:00 PM,48,-122,122,73,195
739,FremontBridge,11/02/2012 07:00:00 PM,48,-122,50,23,73
740,FremontBridge,11/02/2012 08:00:00 PM,48,-122,24,17,41
741,FremontBridge,11/02/2012 09:00:00 PM,48,-122,13,20,33
742,FremontBridge,11/02/2012 10:00:00 PM,48,-122,13,10,23
743,FremontBridge,11/02/2012 11:00:00 PM,48,-122,8,6,14
744,FremontBridge,11/03/2012 12:00:00 AM,48,-122,5,7,12
745,FremontBridge,11/03/2012 01:00:00 AM,48,-122,4,2,6
746,FremontBridge,11/03/2012 02:00:00 AM,48,-122,2,3,5
747,FremontBridge,11/03/2012 03:00:00 AM,48,-122,0,2,2
748,FremontBridge,11/03/2012 04:00:00 AM,48,-122,2,2,4
749,FremontBridge,11/03/2012 05:00:00 AM,48,-122,6,6,12
750,FremontBridge,11/03/2012 06:00:00 AM,48,-122,3,10,13
751,FremontBridge,11/03/2012 07:00:00 AM,48,-122,6,7,13
752,FremontBridge,11/03/2012 08:00:00 AM,48,-122,14,19,33
753,FremontBridge,11/03/2012 09:00:00 AM,48,-122,36,33,69
754,FremontBridge,11/03/2012 10:00:00 AM,48,-122,26,36,62
755,FremontBridge,11/03/2012 11:00:00 AM,48,-122,39,49,88
756,FremontBridge,11/03/2012 12:00:00 PM,48,-122,24,55,79
757,FremontBridge,11/03/2012 01:00:00 PM,48,-122,35,47,82
758,FremontBridge,11/03/2012 02:00:00 PM,48,-122,54,55,109
759,FremontBridge,11/03/2012 03:00:00 PM,48,-122,36,35,71
760,FremontBridge,11/03/2012 04:00:00 PM,48,-122,32,41,73
761,FremontBridge,11/03/2012 05:00:00 PM,48,-122,34,31,65
762,FremontBridge,11/03/2012 06:00:00 PM,48,-122,25,27,52
763,FremontBridge,11/03/2012 07:00:00 PM,48,-122,16,19,35
764,FremontBridge,11/03/2012 08:00:00 PM,48,-122,15,9,24
765,FremontBridge,11/03/2012 09:00:00 PM,48,-122,5,4,9
766,FremontBridge,11/03/2012 10:00:00 PM,48,-122,6,7,13
767,FremontBridge,11/03/2012 11:00:00 PM,48,-122,14,7,21
768,FremontBridge,11/04/2012 12:00:00 AM,48,-122,11,7,18
769,FremontBridge,11/04/2012 01:00:00 AM,48,-122,4,6,10
770,FremontBridge,11/04/2012 02:00:00 AM,48,-122,5,5,10
771,FremontBridge,11/04/2012 03:00:00 AM,48,-122,2,1,3
772,FremontBridge,11/04/2012 04:00:00 AM,48,-122,2,1,3
773,FremontBridge,11/04/2012 05:00:00 AM,48,-122,2,5,7
774,FremontBridge,11/04/2012 06:00:00 AM,48,-122,3,9,12
775,FremontBridge,11/04/2012 07:00:00 AM,48,-122,12,17,29
776,FremontBridge,11/04/2012 08:00:00 AM,48,-122,24,27,51
777,FremontBridge,11/04/2012 09:00:00 AM,48,-122,34,34,68
778,FremontBridge,11/04/2012 10:00:00 AM,48,-122,28,47,75
779,FremontBridge,11/04/2012 11:00:00 AM,48,-122,34,56,90
780,FremontBridge,11/04/2012 12:00:00 PM,48,-122,44,68,112
781,FremontBridge,11/04/2012 01:00:00 PM,48,-122,41,57,98
782,FremontBridge,11/04/2012 02:00:00 PM,48,-122,29,44,73
783,FremontBridge,11/04/2012 03:00:00 PM,48,-122,45,45,90
784,FremontBridge,11/04/2012 04:00:00 PM,48,-122,51,46,97
785,FremontBridge,11/04/2012 05:00:00 PM,48,-122,36,19,55
786,FremontBridge,11/04/2012 06:00:00 PM,48,-122,15,27,42
787,FremontBridge,11/04/2012 07:00:00 PM,48,-122,8,4,12
788,FremontBridge,11/04/2012 08:00:00 PM,48,-122,11,10,21
789,FremontBridge,11/04/2012 09:00:00 PM,48,-122,8,5,13
790,FremontBridge,11/04/2012 10:00:00 PM,48,-122,7,6,13
791,FremontBridge,11/04/2012 11:00:00 PM,48,-122,7,2,9
792,FremontBridge,11/05/2012 12:00:00 AM,48,-122,2,5,7
793,FremontBridge,11/05/2012 01:00:00 AM,48,-122,1,2,3
794,FremontBridge,11/05/2012 02:00:00 AM,48,-122,1,1,2
795,FremontBridge,11/05/2012 03:00:00 AM,48,-122,2,1,3
796,FremontBridge,11/05/2012 04:00:00 AM,48,-122,3,2,5
797,FremontBridge,11/05/2012 05:00:00 AM,48,-122,7,18,25
798,FremontBridge,11/05/2012 06:00:00 AM,48,-122,45,81,126
799,FremontBridge,11/05/2012 07:00:00 AM,48,-122,74,238,312
800,FremontBridge,11/05/2012 08:00:00 AM,48,-122,121,252,373
801,FremontBridge,11/05/2012 09:00:00 AM,48,-122,77,105,182
802,FremontBridge,11/05/2012 10:00:00 AM,48,-122,26,65,91
803,FremontBridge,11/05/2012 11:00:00 AM,48,-122,19,38,57
804,FremontBridge,11/05/2012 12:00:00 PM,48,-122,54,41,95
805,FremontBridge,11/05/2012 01:00:00 PM,48,-122,32,31,63
806,FremontBridge,11/05/2012 02:00:00 PM,48,-122,40,58,98
807,FremontBridge,11/05/2012 03:00:00 PM,48,-122,58,65,123
808,FremontBridge,11/05/2012 04:00:00 PM,48,-122,134,112,246
809,FremontBridge,11/05/2012 05:00:00 PM,48,-122,344,126,470
810,FremontBridge,11/05/2012 06:00:00 PM,48,-122,177,84,261
811,FremontBridge,11/05/2012 07:00:00 PM,48,-122,78,30,108
812,FremontBridge,11/05/2012 08:00:00 PM,48,-122,36,32,68
813,FremontBridge,11/05/2012 09:00:00 PM,48,-122,24,21,45
814,FremontBridge,11/05/2012 10:00:00 PM,48,-122,11,13,24
815,FremontBridge,11/05/2012 11:00:00 PM,48,-122,14,9,23
816,FremontBridge,11/06/2012 12:00:00 AM,48,-122,5,5,10
817,FremontBridge,11/06/2012 01:00:00 AM,48,-122,3,4,7
818,FremontBridge,11/06/2012 02:00:00 AM,48,-122,2,3,5
819,FremontBridge,11/06/2012 03:00:00 AM,48,-122,2,1,3
820,FremontBridge,11/06/2012 04:00:00 AM,48,-122,3,5,8
821,FremontBridge,11/06/2012 05:00:00 AM,48,-122,9,18,27
822,FremontBridge,11/06/2012 06:00:00 AM,48,-122,33,94,127
823,FremontBridge,11/06/2012 07:00:00 AM,48,-122,63,217,280
824,FremontBridge,11/06/2012 08:00:00 AM,48,-122,113,258,371
825,FremontBridge,11/06/2012 09:00:00 AM,48,-122,55,109,164
826,FremontBridge,11/06/2012 10:00:00 AM,48,-122,30,33,63
827,FremontBridge,11/06/2012 11:00:00 AM,48,-122,22,32,54
828,FremontBridge,11/06/2012 12:00:00 PM,48,-122,32,30,62
829,FremontBridge,11/06/2012 01:00:00 PM,48,-122,26,40,66
830,FremontBridge,11/06/2012 02:00:00 PM,48,-122,38,37,75
831,FremontBridge,11/06/2012 03:00:00 PM,48,-122,58,53,111
832,FremontBridge,11/06/2012 04:00:00 PM,48,-122,141,95,236
833,FremontBridge,11/06/2012 05:00:00 PM,48,-122,298,105,403
834,FremontBridge,11/06/2012 06:00:00 PM,48,-122,147,70,217
835,FremontBridge,11/06/2012 07:00:00 PM,48,-122,47,33,80
836,FremontBridge,11/06/2012 08:00:00 PM,48,-122,27,16,43
837,FremontBridge,11/06/2012 09:00:00 PM,48,-122,20,12,32
838,FremontBridge,11/06/2012 10:00:00 PM,48,-122,16,12,28
839,FremontBridge,11/06/2012 11:00:00 PM,48,-122,16,5,21
840,FremontBridge,11/07/2012 12:00:00 AM,48,-122,6,6,12
841,FremontBridge,11/07/2012 01:00:00 AM,48,-122,1,4,5
842,FremontBridge,11/07/2012 02:00:00 AM,48,-122,2,4,6
843,FremontBridge,11/07/2012 03:00:00 AM,48,-122,5,1,6
844,FremontBridge,11/07/2012 04:00:00 AM,48,-122,3,7,10
845,FremontBridge,11/07/2012 05:00:00 AM,48,-122,5,9,14
846,FremontBridge,11/07/2012 06:00:00 AM,48,-122,34,82,116
847,FremontBridge,11/07/2012 07:00:00 AM,48,-122,77,189,266
848,FremontBridge,11/07/2012 08:00:00 AM,48,-122,115,256,371
849,FremontBridge,11/07/2012 09:00:00 AM,48,-122,63,137,200
850,FremontBridge,11/07/2012 10:00:00 AM,48,-122,42,54,96
851,FremontBridge,11/07/2012 11:00:00 AM,48,-122,24,34,58
852,FremontBridge,11/07/2012 12:00:00 PM,48,-122,36,35,71
853,FremontBridge,11/07/2012 01:00:00 PM,48,-122,30,37,67
854,FremontBridge,11/07/2012 02:00:00 PM,48,-122,45,59,104
855,FremontBridge,11/07/2012 03:00:00 PM,48,-122,72,60,132
856,FremontBridge,11/07/2012 04:00:00 PM,48,-122,139,98,237
857,FremontBridge,11/07/2012 05:00:00 PM,48,-122,275,112,387
858,FremontBridge,11/07/2012 06:00:00 PM,48,-122,171,99,270
859,FremontBridge,11/07/2012 07:00:00 PM,48,-122,66,48,114
860,FremontBridge,11/07/2012 08:00:00 PM,48,-122,44,23,67
861,FremontBridge,11/07/2012 09:00:00 PM,48,-122,26,19,45
862,FremontBridge,11/07/2012 10:00:00 PM,48,-122,23,20,43
863,FremontBridge,11/07/2012 11:00:00 PM,48,-122,9,13,22
864,FremontBridge,11/08/2012 12:00:00 AM,48,-122,1,1,2
865,FremontBridge,11/08/2012 01:00:00 AM,48,-122,3,3,6
866,FremontBridge,11/08/2012 02:00:00 AM,48,-122,3,1,4
867,FremontBridge,11/08/2012 03:00:00 AM,48,-122,4,2,6
868,FremontBridge,11/08/2012 04:00:00 AM,48,-122,3,7,10
869,FremontBridge,11/08/2012 05:00:00 AM,48,-122,9,15,24
870,FremontBridge,11/08/2012 06:00:00 AM,48,-122,46,82,128
871,FremontBridge,11/08/2012 07:00:00 AM,48,-122,76,203,279
872,FremontBridge,11/08/2012 08:00:00 AM,48,-122,94,254,348
873,FremontBridge,11/08/2012 09:00:00 AM,48,-122,76,130,206
874,FremontBridge,11/08/2012 10:00:00 AM,48,-122,34,54,88
875,FremontBridge,11/08/2012 11:00:00 AM,48,-122,32,44,76
876,FremontBridge,11/08/2012 12:00:00 PM,48,-122,31,40,71
877,FremontBridge,11/08/2012 01:00:00 PM,48,-122,35,39,74
878,FremontBridge,11/08/2012 02:00:00 PM,48,-122,35,54,89
879,FremontBridge,11/08/2012 03:00:00 PM,48,-122,59,47,106
880,FremontBridge,11/08/2012 04:00:00 PM,48,-122,162,94,256
881,FremontBridge,11/08/2012 05:00:00 PM,48,-122,290,104,394
882,FremontBridge,11/08/2012 06:00:00 PM,48,-122,169,89,258
883,FremontBridge,11/08/2012 07:00:00 PM,48,-122,79,35,114
884,FremontBridge,11/08/2012 08:00:00 PM,48,-122,39,20,59
885,FremontBridge,11/08/2012 09:00:00 PM,48,-122,29,15,44
886,FremontBridge,11/08/2012 10:00:00 PM,48,-122,14,13,27
887,FremontBridge,11/08/2012 11:00:00 PM,48,-122,13,9,22
888,FremontBridge,11/09/2012 12:00:00 AM,48,-122,8,11,19
889,FremontBridge,11/09/2012 01:00:00 AM,48,-122,3,2,5
890,FremontBridge,11/09/2012 02:00:00 AM,48,-122,1,4,5
891,FremontBridge,11/09/2012 03:00:00 AM,48,-122,2,0,2
892,FremontBridge,11/09/2012 04:00:00 AM,48,-122,2,5,7
893,FremontBridge,11/09/2012 05:00:00 AM,48,-122,4,11,15
894,FremontBridge,11/09/2012 06:00:00 AM,48,-122,40,60,100
895,FremontBridge,11/09/2012 07:00:00 AM,48,-122,65,168,233
896,FremontBridge,11/09/2012 08:00:00 AM,48,-122,97,232,329
897,FremontBridge,11/09/2012 09:00:00 AM,48,-122,53,114,167
898,FremontBridge,11/09/2012 10:00:00 AM,48,-122,39,53,92
899,FremontBridge,11/09/2012 11:00:00 AM,48,-122,28,47,75
900,FremontBridge,11/09/2012 12:00:00 PM,48,-122,20,46,66
901,FremontBridge,11/09/2012 01:00:00 PM,48,-122,45,45,90
902,FremontBridge,11/09/2012 02:00:00 PM,48,-122,48,54,102
903,FremontBridge,11/09/2012 03:00:00 PM,48,-122,87,76,163
904,FremontBridge,11/09/2012 04:00:00 PM,48,-122,131,91,222
905,FremontBridge,11/09/2012 05:00:00 PM,48,-122,225,99,324
906,FremontBridge,11/09/2012 06:00:00 PM,48,-122,142,66,208
907,FremontBridge,11/09/2012 07:00:00 PM,48,-122,58,26,84
908,FremontBridge,11/09/2012 08:00:00 PM,48,-122,25,7,32
909,FremontBridge,11/09/2012 09:00:00 PM,48,-122,12,13,25
910,FremontBridge,11/09/2012 10:00:00 PM,48,-122,12,13,25
911,FremontBridge,11/09/2012 11:00:00 PM,48,-122,8,8,16
912,FremontBridge,11/10/2012 12:00:00 AM,48,-122,15,5,20
913,FremontBridge,11/10/2012 01:00:00 AM,48,-122,4,4,8
914,FremontBridge,11/10/2012 02:00:00 AM,48,-122,6,4,10
915,FremontBridge,11/10/2012 03:00:00 AM,48,-122,2,3,5
916,FremontBridge,11/10/2012 04:00:00 AM,48,-122,2,2,4
917,FremontBridge,11/10/2012 05:00:00 AM,48,-122,5,4,9
918,FremontBridge,11/10/2012 06:00:00 AM,48,-122,9,6,15
919,FremontBridge,11/10/2012 07:00:00 AM,48,-122,13,10,23
920,FremontBridge,11/10/2012 08:00:00 AM,48,-122,19,25,44
921,FremontBridge,11/10/2012 09:00:00 AM,48,-122,24,30,54
922,FremontBridge,11/10/2012 10:00:00 AM,48,-122,39,63,102
923,FremontBridge,11/10/2012 11:00:00 AM,48,-122,33,69,102
924,FremontBridge,11/10/2012 12:00:00 PM,48,-122,63,75,138
925,FremontBridge,11/10/2012 01:00:00 PM,48,-122,54,76,130
926,FremontBridge,11/10/2012 02:00:00 PM,48,-122,73,69,142
927,FremontBridge,11/10/2012 03:00:00 PM,48,-122,41,96,137
928,FremontBridge,11/10/2012 04:00:00 PM,48,-122,58,51,109
929,FremontBridge,11/10/2012 05:00:00 PM,48,-122,37,35,72
930,FremontBridge,11/10/2012 06:00:00 PM,48,-122,30,17,47
931,FremontBridge,11/10/2012 07:00:00 PM,48,-122,13,13,26
932,FremontBridge,11/10/2012 08:00:00 PM,48,-122,14,10,24
933,FremontBridge,11/10/2012 09:00:00 PM,48,-122,8,7,15
934,FremontBridge,11/10/2012 10:00:00 PM,48,-122,10,5,15
935,FremontBridge,11/10/2012 11:00:00 PM,48,-122,12,6,18
936,FremontBridge,11/11/2012 12:00:00 AM,48,-122,3,7,10
937,FremontBridge,11/11/2012 01:00:00 AM,48,-122,4,3,7
938,FremontBridge,11/11/2012 02:00:00 AM,48,-122,8,0,8
939,FremontBridge,11/11/2012 03:00:00 AM,48,-122,1,3,4
940,FremontBridge,11/11/2012 04:00:00 AM,48,-122,0,3,3
941,FremontBridge,11/11/2012 05:00:00 AM,48,-122,3,0,3
942,FremontBridge,11/11/2012 06:00:00 AM,48,-122,11,1,12
943,FremontBridge,11/11/2012 07:00:00 AM,48,-122,10,11,21
944,FremontBridge,11/11/2012 08:00:00 AM,48,-122,15,21,36
945,FremontBridge,11/11/2012 09:00:00 AM,48,-122,30,28,58
946,FremontBridge,11/11/2012 10:00:00 AM,48,-122,14,40,54
947,FremontBridge,11/11/2012 11:00:00 AM,48,-122,30,28,58
948,FremontBridge,11/11/2012 12:00:00 PM,48,-122,24,27,51
949,FremontBridge,11/11/2012 01:00:00 PM,48,-122,23,35,58
950,FremontBridge,11/11/2012 02:00:00 PM,48,-122,32,39,71
951,FremontBridge,11/11/2012 03:00:00 PM,48,-122,16,19,35
952,FremontBridge,11/11/2012 04:00:00 PM,48,-122,12,27,39
953,FremontBridge,11/11/2012 05:00:00 PM,48,-122,20,7,27
954,FremontBridge,11/11/2012 06:00:00 PM,48,-122,14,5,19
955,FremontBridge,11/11/2012 07:00:00 PM,48,-122,6,8,14
956,FremontBridge,11/11/2012 08:00:00 PM,48,-122,6,5,11
957,FremontBridge,11/11/2012 09:00:00 PM,48,-122,8,6,14
958,FremontBridge,11/11/2012 10:00:00 PM,48,-122,3,4,7
959,FremontBridge,11/11/2012 11:00:00 PM,48,-122,8,0,8
960,FremontBridge,11/12/2012 12:00:00 AM,48,-122,0,4,4
961,FremontBridge,11/12/2012 01:00:00 AM,48,-122,0,1,1
962,FremontBridge,11/12/2012 02:00:00 AM,48,-122,2,2,4
963,FremontBridge,11/12/2012 03:00:00 AM,48,-122,1,0,1
964,FremontBridge,11/12/2012 04:00:00 AM,48,-122,1,1,2
965,FremontBridge,11/12/2012 05:00:00 AM,48,-122,2,9,11
966,FremontBridge,11/12/2012 06:00:00 AM,48,-122,19,44,63
967,FremontBridge,11/12/2012 07:00:00 AM,48,-122,42,104,146
968,FremontBridge,11/12/2012 08:00:00 AM,48,-122,65,148,213
969,FremontBridge,11/12/2012 09:00:00 AM,48,-122,54,81,135
970,FremontBridge,11/12/2012 10:00:00 AM,48,-122,21,31,52
971,FremontBridge,11/12/2012 11:00:00 AM,48,-122,18,28,46
972,FremontBridge,11/12/2012 12:00:00 PM,48,-122,15,28,43
973,FremontBridge,11/12/2012 01:00:00 PM,48,-122,18,19,37
974,FremontBridge,11/12/2012 02:00:00 PM,48,-122,26,34,60
975,FremontBridge,11/12/2012 03:00:00 PM,48,-122,44,36,80
976,FremontBridge,11/12/2012 04:00:00 PM,48,-122,76,62,138
977,FremontBridge,11/12/2012 05:00:00 PM,48,-122,178,83,261
978,FremontBridge,11/12/2012 06:00:00 PM,48,-122,113,63,176
979,FremontBridge,11/12/2012 07:00:00 PM,48,-122,45,23,68
980,FremontBridge,11/12/2012 08:00:00 PM,48,-122,16,7,23
981,FremontBridge,11/12/2012 09:00:00 PM,48,-122,15,11,26
982,FremontBridge,11/12/2012 10:00:00 PM,48,-122,11,13,24
983,FremontBridge,11/12/2012 11:00:00 PM,48,-122,10,7,17
984,FremontBridge,11/13/2012 12:00:00 AM,48,-122,5,4,9
985,FremontBridge,11/13/2012 01:00:00 AM,48,-122,2,1,3
986,FremontBridge,11/13/2012 02:00:00 AM,48,-122,1,3,4
987,FremontBridge,11/13/2012 03:00:00 AM,48,-122,1,1,2
988,FremontBridge,11/13/2012 04:00:00 AM,48,-122,2,6,8
989,FremontBridge,11/13/2012 05:00:00 AM,48,-122,8,17,25
990,FremontBridge,11/13/2012 06:00:00 AM,48,-122,37,76,113
991,FremontBridge,11/13/2012 07:00:00 AM,48,-122,66,180,246
992,FremontBridge,11/13/2012 08:00:00 AM,48,-122,100,218,318
993,FremontBridge,11/13/2012 09:00:00 AM,48,-122,67,104,171
994,FremontBridge,11/13/2012 10:00:00 AM,48,-122,26,30,56
995,FremontBridge,11/13/2012 11:00:00 AM,48,-122,18,34,52
996,FremontBridge,11/13/2012 12:00:00 PM,48,-122,6,22,28
997,FremontBridge,11/13/2012 01:00:00 PM,48,-122,20,21,41
998,FremontBridge,11/13/2012 02:00:00 PM,48,-122,30,21,51
999,FremontBridge,11/13/2012 03:00:00 PM,48,-122,38,37,75
1000,FremontBridge,11/13/2012 04:00:00 PM,48,-122,106,58,164
1001,FremontBridge,11/13/2012 05:00:00 PM,48,-122,235,96,331
1002,FremontBridge,11/13/2012 06:00:00 PM,48,-122,142,63,205
1003,FremontBridge,11/13/2012 07:00:00 PM,48,-122,54,23,77
1004,FremontBridge,11/13/2012 08:00:00 PM,48,-122,29,11,40
1005,FremontBridge,11/13/2012 09:00:00 PM,48,-122,29,8,37
1006,FremontBridge,11/13/2012 10:00:00 PM,48,-122,10,9,19
1007,FremontBridge,11/13/2012 11:00:00 PM,48,-122,5,7,12
1008,FremontBridge,11/14/2012 12:00:00 AM,48,-122,1,0,1
1009,FremontBridge,11/14/2012 01:00:00 AM,48,-122,0,4,4
1010,FremontBridge,11/14/2012 02:00:00 AM,48,-122,1,3,4
1011,FremontBridge,11/14/2012 03:00:00 AM,48,-122,3,0,3
1012,FremontBridge,11/14/2012 04:00:00 AM,48,-122,3,5,8
1013,FremontBridge,11/14/2012 05:00:00 AM,48,-122,7,17,24
1014,FremontBridge,11/14/2012 06:00:00 AM,48,-122,37,86,123
1015,FremontBridge,11/14/2012 07:00:00 AM,48,-122,64,171,235
1016,FremontBridge,11/14/2012 08:00:00 AM,48,-122,106,247,353
1017,FremontBridge,11/14/2012 09:00:00 AM,48,-122,54,120,174
1018,FremontBridge,11/14/2012 10:00:00 AM,48,-122,37,56,93
1019,FremontBridge,11/14/2012 11:00:00 AM,48,-122,28,36,64
1020,FremontBridge,11/14/2012 12:00:00 PM,48,-122,39,31,70
1021,FremontBridge,11/14/2012 01:00:00 PM,48,-122,36,44,80
1022,FremontBridge,11/14/2012 02:00:00 PM,48,-122,36,42,78
1023,FremontBridge,11/14/2012 03:00:00 PM,48,-122,70,57,127
1024,FremontBridge,11/14/2012 04:00:00 PM,48,-122,127,91,218
1025,FremontBridge,11/14/2012 05:00:00 PM,48,-122,303,113,416
1026,FremontBridge,11/14/2012 06:00:00 PM,48,-122,169,75,244
1027,FremontBridge,11/14/2012 07:00:00 PM,48,-122,81,35,116
1028,FremontBridge,11/14/2012 08:00:00 PM,48,-122,41,26,67
1029,FremontBridge,11/14/2012 09:00:00 PM,48,-122,36,11,47
1030,FremontBridge,11/14/2012 10:00:00 PM,48,-122,17,12,29
1031,FremontBridge,11/14/2012 11:00:00 PM,48,-122,10,12,22
1032,FremontBridge,11/15/2012 12:00:00 AM,48,-122,4,2,6
1033,FremontBridge,11/15/2012 01:00:00 AM,48,-122,1,2,3
1034,FremontBridge,11/15/2012 02:00:00 AM,48,-122,1,3,4
1035,FremontBridge,11/15/2012 03:00:00 AM,48,-122,1,0,1
1036,FremontBridge,11/15/2012 04:00:00 AM,48,-122,3,5,8
1037,FremontBridge,11/15/2012 05:00:00 AM,48,-122,11,14,25
1038,FremontBridge,11/15/2012 06:00:00 AM,48,-122,30,79,109
1039,FremontBridge,11/15/2012 07:00:00 AM,48,-122,65,177,242
1040,FremontBridge,11/15/2012 08:00:00 AM,48,-122,95,214,309
1041,FremontBridge,11/15/2012 09:00:00 AM,48,-122,74,112,186
1042,FremontBridge,11/15/2012 10:00:00 AM,48,-122,25,51,76
1043,FremontBridge,11/15/2012 11:00:00 AM,48,-122,31,46,77
1044,FremontBridge,11/15/2012 12:00:00 PM,48,-122,35,42,77
1045,FremontBridge,11/15/2012 01:00:00 PM,48,-122,42,43,85
1046,FremontBridge,11/15/2012 02:00:00 PM,48,-122,48,57,105
1047,FremontBridge,11/15/2012 03:00:00 PM,48,-122,62,70,132
1048,FremontBridge,11/15/2012 04:00:00 PM,48,-122,132,72,204
1049,FremontBridge,11/15/2012 05:00:00 PM,48,-122,224,104,328
1050,FremontBridge,11/15/2012 06:00:00 PM,48,-122,170,76,246
1051,FremontBridge,11/15/2012 07:00:00 PM,48,-122,75,41,116
1052,FremontBridge,11/15/2012 08:00:00 PM,48,-122,34,29,63
1053,FremontBridge,11/15/2012 09:00:00 PM,48,-122,29,29,58
1054,FremontBridge,11/15/2012 10:00:00 PM,48,-122,12,20,32
1055,FremontBridge,11/15/2012 11:00:00 PM,48,-122,12,16,28
1056,FremontBridge,11/16/2012 12:00:00 AM,48,-122,4,6,10
1057,FremontBridge,11/16/2012 01:00:00 AM,48,-122,5,5,10
1058,FremontBridge,11/16/2012 02:00:00 AM,48,-122,1,2,3
1059,FremontBridge,11/16/2012 03:00:00 AM,48,-122,1,2,3
1060,FremontBridge,11/16/2012 04:00:00 AM,48,-122,3,7,10
1061,FremontBridge,11/16/2012 05:00:00 AM,48,-122,4,14,18
1062,FremontBridge,11/16/2012 06:00:00 AM,48,-122,31,60,91
1063,FremontBridge,11/16/2012 07:00:00 AM,48,-122,71,141,212
1064,FremontBridge,11/16/2012 08:00:00 AM,48,-122,85,192,277
1065,FremontBridge,11/16/2012 09:00:00 AM,48,-122,48,111,159
1066,FremontBridge,11/16/2012 10:00:00 AM,48,-122,36,53,89
1067,FremontBridge,11/16/2012 11:00:00 AM,48,-122,26,47,73
1068,FremontBridge,11/16/2012 12:00:00 PM,48,-122,32,35,67
1069,FremontBridge,11/16/2012 01:00:00 PM,48,-122,43,48,91
1070,FremontBridge,11/16/2012 02:00:00 PM,48,-122,41,34,75
1071,FremontBridge,11/16/2012 03:00:00 PM,48,-122,43,32,75
1072,FremontBridge,11/16/2012 04:00:00 PM,48,-122,87,66,153
1073,FremontBridge,11/16/2012 05:00:00 PM,48,-122,182,57,239
1074,FremontBridge,11/16/2012 06:00:00 PM,48,-122,106,50,156
1075,FremontBridge,11/16/2012 07:00:00 PM,48,-122,59,29,88
1076,FremontBridge,11/16/2012 08:00:00 PM,48,-122,30,16,46
1077,FremontBridge,11/16/2012 09:00:00 PM,48,-122,14,7,21
1078,FremontBridge,11/16/2012 10:00:00 PM,48,-122,18,4,22
1079,FremontBridge,11/16/2012 11:00:00 PM,48,-122,13,5,18
1080,FremontBridge,11/17/2012 12:00:00 AM,48,-122,10,4,14
1081,FremontBridge,11/17/2012 01:00:00 AM,48,-122,4,1,5
1082,FremontBridge,11/17/2012 02:00:00 AM,48,-122,1,4,5
1083,FremontBridge,11/17/2012 03:00:00 AM,48,-122,1,0,1
1084,FremontBridge,11/17/2012 04:00:00 AM,48,-122,1,3,4
1085,FremontBridge,11/17/2012 05:00:00 AM,48,-122,1,4,5
1086,FremontBridge,11/17/2012 06:00:00 AM,48,-122,8,4,12
1087,FremontBridge,11/17/2012 07:00:00 AM,48,-122,12,12,24
1088,FremontBridge,11/17/2012 08:00:00 AM,48,-122,13,18,31
1089,FremontBridge,11/17/2012 09:00:00 AM,48,-122,21,25,46
1090,FremontBridge,11/17/2012 10:00:00 AM,48,-122,21,28,49
1091,FremontBridge,11/17/2012 11:00:00 AM,48,-122,30,36,66
1092,FremontBridge,11/17/2012 12:00:00 PM,48,-122,25,56,81
1093,FremontBridge,11/17/2012 01:00:00 PM,48,-122,21,39,60
1094,FremontBridge,11/17/2012 02:00:00 PM,48,-122,22,21,43
1095,FremontBridge,11/17/2012 03:00:00 PM,48,-122,17,15,32
1096,FremontBridge,11/17/2012 04:00:00 PM,48,-122,20,20,40
1097,FremontBridge,11/17/2012 05:00:00 PM,48,-122,10,19,29
1098,FremontBridge,11/17/2012 06:00:00 PM,48,-122,14,9,23
1099,FremontBridge,11/17/2012 07:00:00 PM,48,-122,7,13,20
1100,FremontBridge,11/17/2012 08:00:00 PM,48,-122,13,2,15
1101,FremontBridge,11/17/2012 09:00:00 PM,48,-122,4,7,11
1102,FremontBridge,11/17/2012 10:00:00 PM,48,-122,7,5,12
1103,FremontBridge,11/17/2012 11:00:00 PM,48,-122,9,3,12
1104,FremontBridge,11/18/2012 12:00:00 AM,48,-122,5,6,11
1105,FremontBridge,11/18/2012 01:00:00 AM,48,-122,2,1,3
1106,FremontBridge,11/18/2012 02:00:00 AM,48,-122,2,1,3
1107,FremontBridge,11/18/2012 03:00:00 AM,48,-122,2,0,2
1108,FremontBridge,11/18/2012 04:00:00 AM,48,-122,1,4,5
1109,FremontBridge,11/18/2012 05:00:00 AM,48,-122,0,3,3
1110,FremontBridge,11/18/2012 06:00:00 AM,48,-122,3,3,6
1111,FremontBridge,11/18/2012 07:00:00 AM,48,-122,9,3,12
1112,FremontBridge,11/18/2012 08:00:00 AM,48,-122,10,6,16
1113,FremontBridge,11/18/2012 09:00:00 AM,48,-122,12,8,20
1114,FremontBridge,11/18/2012 10:00:00 AM,48,-122,4,17,21
1115,FremontBridge,11/18/2012 11:00:00 AM,48,-122,10,18,28
1116,FremontBridge,11/18/2012 12:00:00 PM,48,-122,11,23,34
1117,FremontBridge,11/18/2012 01:00:00 PM,48,-122,15,26,41
1118,FremontBridge,11/18/2012 02:00:00 PM,48,-122,17,28,45
1119,FremontBridge,11/18/2012 03:00:00 PM,48,-122,10,14,24
1120,FremontBridge,11/18/2012 04:00:00 PM,48,-122,10,20,30
1121,FremontBridge,11/18/2012 05:00:00 PM,48,-122,7,15,22
1122,FremontBridge,11/18/2012 06:00:00 PM,48,-122,6,6,12
1123,FremontBridge,11/18/2012 07:00:00 PM,48,-122,4,7,11
1124,FremontBridge,11/18/2012 08:00:00 PM,48,-122,9,5,14
1125,FremontBridge,11/18/2012 09:00:00 PM,48,-122,4,2,6
1126,FremontBridge,11/18/2012 10:00:00 PM,48,-122,9,2,11
1127,FremontBridge,11/18/2012 11:00:00 PM,48,-122,11,1,12
1128,FremontBridge,11/19/2012 12:00:00 AM,48,-122,0,3,3
1129,FremontBridge,11/19/2012 01:00:00 AM,48,-122,5,1,6
1130,FremontBridge,11/19/2012 02:00:00 AM,48,-122,1,1,2
1131,FremontBridge,11/19/2012 03:00:00 AM,48,-122,2,0,2
1132,FremontBridge,11/19/2012 04:00:00 AM,48,-122,4,4,8
1133,FremontBridge,11/19/2012 05:00:00 AM,48,-122,3,12,15
1134,FremontBridge,11/19/2012 06:00:00 AM,48,-122,13,33,46
1135,FremontBridge,11/19/2012 07:00:00 AM,48,-122,27,76,103
1136,FremontBridge,11/19/2012 08:00:00 AM,48,-122,49,90,139
1137,FremontBridge,11/19/2012 09:00:00 AM,48,-122,27,39,66
1138,FremontBridge,11/19/2012 10:00:00 AM,48,-122,12,23,35
1139,FremontBridge,11/19/2012 11:00:00 AM,48,-122,5,8,13
1140,FremontBridge,11/19/2012 12:00:00 PM,48,-122,9,9,18
1141,FremontBridge,11/19/2012 01:00:00 PM,48,-122,3,10,13
1142,FremontBridge,11/19/2012 02:00:00 PM,48,-122,19,13,32
1143,FremontBridge,11/19/2012 03:00:00 PM,48,-122,30,15,45
1144,FremontBridge,11/19/2012 04:00:00 PM,48,-122,49,29,78
1145,FremontBridge,11/19/2012 05:00:00 PM,48,-122,113,42,155
1146,FremontBridge,11/19/2012 06:00:00 PM,48,-122,54,24,78
1147,FremontBridge,11/19/2012 07:00:00 PM,48,-122,38,12,50
1148,FremontBridge,11/19/2012 08:00:00 PM,48,-122,11,7,18
1149,FremontBridge,11/19/2012 09:00:00 PM,48,-122,9,10,19
1150,FremontBridge,11/19/2012 10:00:00 PM,48,-122,6,9,15
1151,FremontBridge,11/19/2012 11:00:00 PM,48,-122,3,5,8
1152,FremontBridge,11/20/2012 12:00:00 AM,48,-122,5,2,7
1153,FremontBridge,11/20/2012 01:00:00 AM,48,-122,0,1,1
1154,FremontBridge,11/20/2012 02:00:00 AM,48,-122,0,3,3
1155,FremontBridge,11/20/2012 03:00:00 AM,48,-122,2,0,2
1156,FremontBridge,11/20/2012 04:00:00 AM,48,-122,1,2,3
1157,FremontBridge,11/20/2012 05:00:00 AM,48,-122,4,10,14
1158,FremontBridge,11/20/2012 06:00:00 AM,48,-122,28,55,83
1159,FremontBridge,11/20/2012 07:00:00 AM,48,-122,54,137,191
1160,FremontBridge,11/20/2012 08:00:00 AM,48,-122,79,184,263
1161,FremontBridge,11/20/2012 09:00:00 AM,48,-122,53,101,154
1162,FremontBridge,11/20/2012 10:00:00 AM,48,-122,26,37,63
1163,FremontBridge,11/20/2012 11:00:00 AM,48,-122,12,19,31
1164,FremontBridge,11/20/2012 12:00:00 PM,48,-122,14,23,37
1165,FremontBridge,11/20/2012 01:00:00 PM,48,-122,18,14,32
1166,FremontBridge,11/20/2012 02:00:00 PM,48,-122,17,20,37
1167,FremontBridge,11/20/2012 03:00:00 PM,48,-122,47,25,72
1168,FremontBridge,11/20/2012 04:00:00 PM,48,-122,72,55,127
1169,FremontBridge,11/20/2012 05:00:00 PM,48,-122,205,80,285
1170,FremontBridge,11/20/2012 06:00:00 PM,48,-122,130,54,184
1171,FremontBridge,11/20/2012 07:00:00 PM,48,-122,40,25,65
1172,FremontBridge,11/20/2012 08:00:00 PM,48,-122,19,14,33
1173,FremontBridge,11/20/2012 09:00:00 PM,48,-122,16,9,25
1174,FremontBridge,11/20/2012 10:00:00 PM,48,-122,12,6,18
1175,FremontBridge,11/20/2012 11:00:00 PM,48,-122,3,8,11
1176,FremontBridge,11/21/2012 12:00:00 AM,48,-122,6,3,9
1177,FremontBridge,11/21/2012 01:00:00 AM,48,-122,1,0,1
1178,FremontBridge,11/21/2012 02:00:00 AM,48,-122,1,2,3
1179,FremontBridge,11/21/2012 03:00:00 AM,48,-122,1,1,2
1180,FremontBridge,11/21/2012 04:00:00 AM,48,-122,1,5,6
1181,FremontBridge,11/21/2012 05:00:00 AM,48,-122,3,6,9
1182,FremontBridge,11/21/2012 06:00:00 AM,48,-122,15,37,52
1183,FremontBridge,11/21/2012 07:00:00 AM,48,-122,36,83,119
1184,FremontBridge,11/21/2012 08:00:00 AM,48,-122,58,125,183
1185,FremontBridge,11/21/2012 09:00:00 AM,48,-122,33,84,117
1186,FremontBridge,11/21/2012 10:00:00 AM,48,-122,41,17,58
1187,FremontBridge,11/21/2012 11:00:00 AM,48,-122,13,17,30
1188,FremontBridge,11/21/2012 12:00:00 PM,48,-122,16,14,30
1189,FremontBridge,11/21/2012 01:00:00 PM,48,-122,45,19,64
1190,FremontBridge,11/21/2012 02:00:00 PM,48,-122,40,34,74
1191,FremontBridge,11/21/2012 03:00:00 PM,48,-122,62,38,100
1192,FremontBridge,11/21/2012 04:00:00 PM,48,-122,97,51,148
1193,FremontBridge,11/21/2012 05:00:00 PM,48,-122,95,44,139
1194,FremontBridge,11/21/2012 06:00:00 PM,48,-122,61,36,97
1195,FremontBridge,11/21/2012 07:00:00 PM,48,-122,20,22,42
1196,FremontBridge,11/21/2012 08:00:00 PM,48,-122,30,10,40
1197,FremontBridge,11/21/2012 09:00:00 PM,48,-122,12,9,21
1198,FremontBridge,11/21/2012 10:00:00 PM,48,-122,10,7,17
1199,FremontBridge,11/21/2012 11:00:00 PM,48,-122,5,4,9
1200,FremontBridge,11/22/2012 12:00:00 AM,48,-122,3,5,8
1201,FremontBridge,11/22/2012 01:00:00 AM,48,-122,1,38,39
1202,FremontBridge,11/22/2012 02:00:00 AM,48,-122,1,3,4
1203,FremontBridge,11/22/2012 03:00:00 AM,48,-122,1,3,4
1204,FremontBridge,11/22/2012 04:00:00 AM,48,-122,0,1,1
1205,FremontBridge,11/22/2012 05:00:00 AM,48,-122,3,1,4
1206,FremontBridge,11/22/2012 06:00:00 AM,48,-122,3,1,4
1207,FremontBridge,11/22/2012 07:00:00 AM,48,-122,5,5,10
1208,FremontBridge,11/22/2012 08:00:00 AM,48,-122,10,13,23
1209,FremontBridge,11/22/2012 09:00:00 AM,48,-122,22,22,44
1210,FremontBridge,11/22/2012 10:00:00 AM,48,-122,25,39,64
1211,FremontBridge,11/22/2012 11:00:00 AM,48,-122,40,48,88
1212,FremontBridge,11/22/2012 12:00:00 PM,48,-122,29,39,68
1213,FremontBridge,11/22/2012 01:00:00 PM,48,-122,21,29,50
1214,FremontBridge,11/22/2012 02:00:00 PM,48,-122,18,19,37
1215,FremontBridge,11/22/2012 03:00:00 PM,48,-122,14,17,31
1216,FremontBridge,11/22/2012 04:00:00 PM,48,-122,9,14,23
1217,FremontBridge,11/22/2012 05:00:00 PM,48,-122,2,5,7
1218,FremontBridge,11/22/2012 06:00:00 PM,48,-122,2,2,4
1219,FremontBridge,11/22/2012 07:00:00 PM,48,-122,6,3,9
1220,FremontBridge,11/22/2012 08:00:00 PM,48,-122,5,4,9
1221,FremontBridge,11/22/2012 09:00:00 PM,48,-122,1,9,10
1222,FremontBridge,11/22/2012 10:00:00 PM,48,-122,4,2,6
1223,FremontBridge,11/22/2012 11:00:00 PM,48,-122,4,3,7
1224,FremontBridge,11/23/2012 12:00:00 AM,48,-122,3,12,15
1225,FremontBridge,11/23/2012 01:00:00 AM,48,-122,0,0,0
1226,FremontBridge,11/23/2012 02:00:00 AM,48,-122,1,1,2
1227,FremontBridge,11/23/2012 03:00:00 AM,48,-122,0,0,0
1228,FremontBridge,11/23/2012 04:00:00 AM,48,-122,2,1,3
1229,FremontBridge,11/23/2012 05:00:00 AM,48,-122,4,5,9
1230,FremontBridge,11/23/2012 06:00:00 AM,48,-122,7,4,11
1231,FremontBridge,11/23/2012 07:00:00 AM,48,-122,7,15,22
1232,FremontBridge,11/23/2012 08:00:00 AM,48,-122,11,14,25
1233,FremontBridge,11/23/2012 09:00:00 AM,48,-122,6,9,15
1234,FremontBridge,11/23/2012 10:00:00 AM,48,-122,16,16,32
1235,FremontBridge,11/23/2012 11:00:00 AM,48,-122,10,6,16
1236,FremontBridge,11/23/2012 12:00:00 PM,48,-122,10,7,17
1237,FremontBridge,11/23/2012 01:00:00 PM,48,-122,10,8,18
1238,FremontBridge,11/23/2012 02:00:00 PM,48,-122,15,8,23
1239,FremontBridge,11/23/2012 03:00:00 PM,48,-122,9,18,27
1240,FremontBridge,11/23/2012 04:00:00 PM,48,-122,15,7,22
1241,FremontBridge,11/23/2012 05:00:00 PM,48,-122,23,8,31
1242,FremontBridge,11/23/2012 06:00:00 PM,48,-122,8,7,15
1243,FremontBridge,11/23/2012 07:00:00 PM,48,-122,9,4,13
1244,FremontBridge,11/23/2012 08:00:00 PM,48,-122,8,6,14
1245,FremontBridge,11/23/2012 09:00:00 PM,48,-122,0,3,3
1246,FremontBridge,11/23/2012 10:00:00 PM,48,-122,5,8,13
1247,FremontBridge,11/23/2012 11:00:00 PM,48,-122,8,1,9
1248,FremontBridge,11/24/2012 12:00:00 AM,48,-122,2,1,3
1249,FremontBridge,11/24/2012 01:00:00 AM,48,-122,1,1,2
1250,FremontBridge,11/24/2012 02:00:00 AM,48,-122,1,3,4
1251,FremontBridge,11/24/2012 03:00:00 AM,48,-122,0,1,1
1252,FremontBridge,11/24/2012 04:00:00 AM,48,-122,1,5,6
1253,FremontBridge,11/24/2012 05:00:00 AM,48,-122,1,5,6
1254,FremontBridge,11/24/2012 06:00:00 AM,48,-122,8,3,11
1255,FremontBridge,11/24/2012 07:00:00 AM,48,-122,6,8,14
1256,FremontBridge,11/24/2012 08:00:00 AM,48,-122,13,17,30
1257,FremontBridge,11/24/2012 09:00:00 AM,48,-122,20,20,40
1258,FremontBridge,11/24/2012 10:00:00 AM,48,-122,21,35,56
1259,FremontBridge,11/24/2012 11:00:00 AM,48,-122,28,39,67
1260,FremontBridge,11/24/2012 12:00:00 PM,48,-122,43,57,100
1261,FremontBridge,11/24/2012 01:00:00 PM,48,-122,21,47,68
1262,FremontBridge,11/24/2012 02:00:00 PM,48,-122,61,56,117
1263,FremontBridge,11/24/2012 03:00:00 PM,48,-122,61,66,127
1264,FremontBridge,11/24/2012 04:00:00 PM,48,-122,31,32,63
1265,FremontBridge,11/24/2012 05:00:00 PM,48,-122,14,16,30
1266,FremontBridge,11/24/2012 06:00:00 PM,48,-122,21,12,33
1267,FremontBridge,11/24/2012 07:00:00 PM,48,-122,15,7,22
1268,FremontBridge,11/24/2012 08:00:00 PM,48,-122,10,6,16
1269,FremontBridge,11/24/2012 09:00:00 PM,48,-122,8,5,13
1270,FremontBridge,11/24/2012 10:00:00 PM,48,-122,7,4,11
1271,FremontBridge,11/24/2012 11:00:00 PM,48,-122,3,2,5
1272,FremontBridge,11/25/2012 12:00:00 AM,48,-122,3,6,9
1273,FremontBridge,11/25/2012 01:00:00 AM,48,-122,6,3,9
1274,FremontBridge,11/25/2012 02:00:00 AM,48,-122,0,2,2
1275,FremontBridge,11/25/2012 03:00:00 AM,48,-122,2,2,4
1276,FremontBridge,11/25/2012 04:00:00 AM,48,-122,2,1,3
1277,FremontBridge,11/25/2012 05:00:00 AM,48,-122,0,2,2
1278,FremontBridge,11/25/2012 06:00:00 AM,48,-122,4,9,13
1279,FremontBridge,11/25/2012 07:00:00 AM,48,-122,9,13,22
1280,FremontBridge,11/25/2012 08:00:00 AM,48,-122,14,19,33
1281,FremontBridge,11/25/2012 09:00:00 AM,48,-122,17,28,45
1282,FremontBridge,11/25/2012 10:00:00 AM,48,-122,23,29,52
1283,FremontBridge,11/25/2012 11:00:00 AM,48,-122,34,32,66
1284,FremontBridge,11/25/2012 12:00:00 PM,48,-122,34,48,82
1285,FremontBridge,11/25/2012 01:00:00 PM,48,-122,62,84,146
1286,FremontBridge,11/25/2012 02:00:00 PM,48,-122,65,89,154
1287,FremontBridge,11/25/2012 03:00:00 PM,48,-122,55,78,133
1288,FremontBridge,11/25/2012 04:00:00 PM,48,-122,44,44,88
1289,FremontBridge,11/25/2012 05:00:00 PM,48,-122,22,25,47
1290,FremontBridge,11/25/2012 06:00:00 PM,48,-122,14,16,30
1291,FremontBridge,11/25/2012 07:00:00 PM,48,-122,14,13,27
1292,FremontBridge,11/25/2012 08:00:00 PM,48,-122,9,8,17
1293,FremontBridge,11/25/2012 09:00:00 PM,48,-122,10,3,13
1294,FremontBridge,11/25/2012 10:00:00 PM,48,-122,4,3,7
1295,FremontBridge,11/25/2012 11:00:00 PM,48,-122,5,9,14
1296,FremontBridge,11/26/2012 12:00:00 AM,48,-122,1,2,3
1297,FremontBridge,11/26/2012 01:00:00 AM,48,-122,3,1,4
1298,FremontBridge,11/26/2012 02:00:00 AM,48,-122,0,0,0
1299,FremontBridge,11/26/2012 03:00:00 AM,48,-122,1,1,2
1300,FremontBridge,11/26/2012 04:00:00 AM,48,-122,3,4,7
1301,FremontBridge,11/26/2012 05:00:00 AM,48,-122,6,17,23
1302,FremontBridge,11/26/2012 06:00:00 AM,48,-122,33,67,100
1303,FremontBridge,11/26/2012 07:00:00 AM,48,-122,56,171,227
1304,FremontBridge,11/26/2012 08:00:00 AM,48,-122,99,213,312
1305,FremontBridge,11/26/2012 09:00:00 AM,48,-122,66,113,179
1306,FremontBridge,11/26/2012 10:00:00 AM,48,-122,43,41,84
1307,FremontBridge,11/26/2012 11:00:00 AM,48,-122,15,41,56
1308,FremontBridge,11/26/2012 12:00:00 PM,48,-122,30,37,67
1309,FremontBridge,11/26/2012 01:00:00 PM,48,-122,35,48,83
1310,FremontBridge,11/26/2012 02:00:00 PM,48,-122,50,48,98
1311,FremontBridge,11/26/2012 03:00:00 PM,48,-122,68,47,115
1312,FremontBridge,11/26/2012 04:00:00 PM,48,-122,120,74,194
1313,FremontBridge,11/26/2012 05:00:00 PM,48,-122,250,102,352
1314,FremontBridge,11/26/2012 06:00:00 PM,48,-122,150,66,216
1315,FremontBridge,11/26/2012 07:00:00 PM,48,-122,52,35,87
1316,FremontBridge,11/26/2012 08:00:00 PM,48,-122,48,19,67
1317,FremontBridge,11/26/2012 09:00:00 PM,48,-122,20,15,35
1318,FremontBridge,11/26/2012 10:00:00 PM,48,-122,23,12,35
1319,FremontBridge,11/26/2012 11:00:00 PM,48,-122,6,6,12
1320,FremontBridge,11/27/2012 12:00:00 AM,48,-122,4,6,10
1321,FremontBridge,11/27/2012 01:00:00 AM,48,-122,4,0,4
1322,FremontBridge,11/27/2012 02:00:00 AM,48,-122,1,0,1
1323,FremontBridge,11/27/2012 03:00:00 AM,48,-122,1,3,4
1324,FremontBridge,11/27/2012 04:00:00 AM,48,-122,3,5,8
1325,FremontBridge,11/27/2012 05:00:00 AM,48,-122,10,17,27
1326,FremontBridge,11/27/2012 06:00:00 AM,48,-122,31,74,105
1327,FremontBridge,11/27/2012 07:00:00 AM,48,-122,64,165,229
1328,FremontBridge,11/27/2012 08:00:00 AM,48,-122,103,263,366
1329,FremontBridge,11/27/2012 09:00:00 AM,48,-122,63,122,185
1330,FremontBridge,11/27/2012 10:00:00 AM,48,-122,29,39,68
1331,FremontBridge,11/27/2012 11:00:00 AM,48,-122,25,38,63
1332,FremontBridge,11/27/2012 12:00:00 PM,48,-122,18,37,55
1333,FremontBridge,11/27/2012 01:00:00 PM,48,-122,36,45,81
1334,FremontBridge,11/27/2012 02:00:00 PM,48,-122,53,30,83
1335,FremontBridge,11/27/2012 03:00:00 PM,48,-122,65,60,125
1336,FremontBridge,11/27/2012 04:00:00 PM,48,-122,129,103,232
1337,FremontBridge,11/27/2012 05:00:00 PM,48,-122,277,108,385
1338,FremontBridge,11/27/2012 06:00:00 PM,48,-122,183,75,258
1339,FremontBridge,11/27/2012 07:00:00 PM,48,-122,61,41,102
1340,FremontBridge,11/27/2012 08:00:00 PM,48,-122,37,25,62
1341,FremontBridge,11/27/2012 09:00:00 PM,48,-122,21,21,42
1342,FremontBridge,11/27/2012 10:00:00 PM,48,-122,17,15,32
1343,FremontBridge,11/27/2012 11:00:00 PM,48,-122,11,9,20
1344,FremontBridge,11/28/2012 12:00:00 AM,48,-122,5,2,7
1345,FremontBridge,11/28/2012 01:00:00 AM,48,-122,0,3,3
1346,FremontBridge,11/28/2012 02:00:00 AM,48,-122,1,2,3
1347,FremontBridge,11/28/2012 03:00:00 AM,48,-122,2,0,2
1348,FremontBridge,11/28/2012 04:00:00 AM,48,-122,1,7,8
1349,FremontBridge,11/28/2012 05:00:00 AM,48,-122,4,14,18
1350,FremontBridge,11/28/2012 06:00:00 AM,48,-122,29,67,96
1351,FremontBridge,11/28/2012 07:00:00 AM,48,-122,61,153,214
1352,FremontBridge,11/28/2012 08:00:00 AM,48,-122,105,212,317
1353,FremontBridge,11/28/2012 09:00:00 AM,48,-122,58,104,162
1354,FremontBridge,11/28/2012 10:00:00 AM,48,-122,33,52,85
1355,FremontBridge,11/28/2012 11:00:00 AM,48,-122,22,24,46
1356,FremontBridge,11/28/2012 12:00:00 PM,48,-122,23,26,49
1357,FremontBridge,11/28/2012 01:00:00 PM,48,-122,31,28,59
1358,FremontBridge,11/28/2012 02:00:00 PM,48,-122,16,19,35
1359,FremontBridge,11/28/2012 03:00:00 PM,48,-122,36,26,62
1360,FremontBridge,11/28/2012 04:00:00 PM,48,-122,83,61,144
1361,FremontBridge,11/28/2012 05:00:00 PM,48,-122,225,90,315
1362,FremontBridge,11/28/2012 06:00:00 PM,48,-122,139,51,190
1363,FremontBridge,11/28/2012 07:00:00 PM,48,-122,75,38,113
1364,FremontBridge,11/28/2012 08:00:00 PM,48,-122,26,18,44
1365,FremontBridge,11/28/2012 09:00:00 PM,48,-122,16,12,28
1366,FremontBridge,11/28/2012 10:00:00 PM,48,-122,14,9,23
1367,FremontBridge,11/28/2012 11:00:00 PM,48,-122,7,4,11
1368,FremontBridge,11/29/2012 12:00:00 AM,48,-122,1,4,5
1369,FremontBridge,11/29/2012 01:00:00 AM,48,-122,0,2,2
1370,FremontBridge,11/29/2012 02:00:00 AM,48,-122,0,5,5
1371,FremontBridge,11/29/2012 03:00:00 AM,48,-122,2,1,3
1372,FremontBridge,11/29/2012 04:00:00 AM,48,-122,1,6,7
1373,FremontBridge,11/29/2012 05:00:00 AM,48,-122,6,15,21
1374,FremontBridge,11/29/2012 06:00:00 AM,48,-122,27,63,90
1375,FremontBridge,11/29/2012 07:00:00 AM,48,-122,49,142,191
1376,FremontBridge,11/29/2012 08:00:00 AM,48,-122,90,188,278
1377,FremontBridge,11/29/2012 09:00:00 AM,48,-122,48,91,139
1378,FremontBridge,11/29/2012 10:00:00 AM,48,-122,29,16,45
1379,FremontBridge,11/29/2012 11:00:00 AM,48,-122,18,20,38
1380,FremontBridge,11/29/2012 12:00:00 PM,48,-122,17,24,41
1381,FremontBridge,11/29/2012 01:00:00 PM,48,-122,14,15,29
1382,FremontBridge,11/29/2012 02:00:00 PM,48,-122,18,28,46
1383,FremontBridge,11/29/2012 03:00:00 PM,48,-122,46,29,75
1384,FremontBridge,11/29/2012 04:00:00 PM,48,-122,85,66,151
1385,FremontBridge,11/29/2012 05:00:00 PM,48,-122,190,83,273
1386,FremontBridge,11/29/2012 06:00:00 PM,48,-122,118,64,182
1387,FremontBridge,11/29/2012 07:00:00 PM,48,-122,59,38,97
1388,FremontBridge,11/29/2012 08:00:00 PM,48,-122,23,19,42
1389,FremontBridge,11/29/2012 09:00:00 PM,48,-122,21,19,40
1390,FremontBridge,11/29/2012 10:00:00 PM,48,-122,17,7,24
1391,FremontBridge,11/29/2012 11:00:00 PM,48,-122,11,9,20
1392,FremontBridge,11/30/2012 12:00:00 AM,48,-122,2,5,7
1393,FremontBridge,11/30/2012 01:00:00 AM,48,-122,1,0,1
1394,FremontBridge,11/30/2012 02:00:00 AM,48,-122,1,0,1
1395,FremontBridge,11/30/2012 03:00:00 AM,48,-122,1,0,1
1396,FremontBridge,11/30/2012 04:00:00 AM,48,-122,2,6,8
1397,FremontBridge,11/30/2012 05:00:00 AM,48,-122,5,18,23
1398,FremontBridge,11/30/2012 06:00:00 AM,48,-122,27,53,80
1399,FremontBridge,11/30/2012 07:00:00 AM,48,-122,50,115,165
1400,FremontBridge,11/30/2012 08:00:00 AM,48,-122,81,161,242
1401,FremontBridge,11/30/2012 09:00:00 AM,48,-122,57,84,141
1402,FremontBridge,11/30/2012 10:00:00 AM,48,-122,32,27,59
1403,FremontBridge,11/30/2012 11:00:00 AM,48,-122,22,22,44
1404,FremontBridge,11/30/2012 12:00:00 PM,48,-122,20,19,39
1405,FremontBridge,11/30/2012 01:00:00 PM,48,-122,17,21,38
1406,FremontBridge,11/30/2012 02:00:00 PM,48,-122,25,21,46
1407,FremontBridge,11/30/2012 03:00:00 PM,48,-122,31,35,66
1408,FremontBridge,11/30/2012 04:00:00 PM,48,-122,92,47,139
1409,FremontBridge,11/30/2012 05:00:00 PM,48,-122,167,61,228
1410,FremontBridge,11/30/2012 06:00:00 PM,48,-122,93,52,145
1411,FremontBridge,11/30/2012 07:00:00 PM,48,-122,39,16,55
1412,FremontBridge,11/30/2012 08:00:00 PM,48,-122,20,8,28
1413,FremontBridge,11/30/2012 09:00:00 PM,48,-122,3,4,7
1414,FremontBridge,11/30/2012 10:00:00 PM,48,-122,3,7,10
1415,FremontBridge,11/30/2012 11:00:00 PM,48,-122,13,4,17
1416,FremontBridge,12/01/2012 12:00:00 AM,48,-122,8,2,10
1417,FremontBridge,12/01/2012 01:00:00 AM,48,-122,3,0,3
1418,FremontBridge,12/01/2012 02:00:00 AM,48,-122,2,1,3
1419,FremontBridge,12/01/2012 03:00:00 AM,48,-122,0,3,3
1420,FremontBridge,12/01/2012 04:00:00 AM,48,-122,1,2,3
1421,FremontBridge,12/01/2012 05:00:00 AM,48,-122,2,2,4
1422,FremontBridge,12/01/2012 06:00:00 AM,48,-122,7,3,10
1423,FremontBridge,12/01/2012 07:00:00 AM,48,-122,8,13,21
1424,FremontBridge,12/01/2012 08:00:00 AM,48,-122,20,17,37
1425,FremontBridge,12/01/2012 09:00:00 AM,48,-122,22,21,43
1426,FremontBridge,12/01/2012 10:00:00 AM,48,-122,25,26,51
1427,FremontBridge,12/01/2012 11:00:00 AM,48,-122,17,36,53
1428,FremontBridge,12/01/2012 12:00:00 PM,48,-122,28,34,62
1429,FremontBridge,12/01/2012 01:00:00 PM,48,-122,22,31,53
1430,FremontBridge,12/01/2012 02:00:00 PM,48,-122,16,35,51
1431,FremontBridge,12/01/2012 03:00:00 PM,48,-122,23,31,54
1432,FremontBridge,12/01/2012 04:00:00 PM,48,-122,13,31,44
1433,FremontBridge,12/01/2012 05:00:00 PM,48,-122,25,15,40
1434,FremontBridge,12/01/2012 06:00:00 PM,48,-122,16,8,24
1435,FremontBridge,12/01/2012 07:00:00 PM,48,-122,13,6,19
1436,FremontBridge,12/01/2012 08:00:00 PM,48,-122,7,3,10
1437,FremontBridge,12/01/2012 09:00:00 PM,48,-122,6,4,10
1438,FremontBridge,12/01/2012 10:00:00 PM,48,-122,6,6,12
1439,FremontBridge,12/01/2012 11:00:00 PM,48,-122,6,8,14
1440,FremontBridge,12/02/2012 12:00:00 AM,48,-122,7,9,16
1441,FremontBridge,12/02/2012 01:00:00 AM,48,-122,2,1,3
1442,FremontBridge,12/02/2012 02:00:00 AM,48,-122,2,2,4
1443,FremontBridge,12/02/2012 03:00:00 AM,48,-122,0,0,0
1444,FremontBridge,12/02/2012 04:00:00 AM,48,-122,0,3,3
1445,FremontBridge,12/02/2012 05:00:00 AM,48,-122,4,2,6
1446,FremontBridge,12/02/2012 06:00:00 AM,48,-122,7,3,10
1447,FremontBridge,12/02/2012 07:00:00 AM,48,-122,9,3,12
1448,FremontBridge,12/02/2012 08:00:00 AM,48,-122,12,19,31
1449,FremontBridge,12/02/2012 09:00:00 AM,48,-122,16,31,47
1450,FremontBridge,12/02/2012 10:00:00 AM,48,-122,16,29,45
1451,FremontBridge,12/02/2012 11:00:00 AM,48,-122,18,25,43
1452,FremontBridge,12/02/2012 12:00:00 PM,48,-122,31,34,65
1453,FremontBridge,12/02/2012 01:00:00 PM,48,-122,15,34,49
1454,FremontBridge,12/02/2012 02:00:00 PM,48,-122,16,25,41
1455,FremontBridge,12/02/2012 03:00:00 PM,48,-122,16,15,31
1456,FremontBridge,12/02/2012 04:00:00 PM,48,-122,16,22,38
1457,FremontBridge,12/02/2012 05:00:00 PM,48,-122,5,8,13
1458,FremontBridge,12/02/2012 06:00:00 PM,48,-122,9,10,19
1459,FremontBridge,12/02/2012 07:00:00 PM,48,-122,11,6,17
1460,FremontBridge,12/02/2012 08:00:00 PM,48,-122,7,1,8
1461,FremontBridge,12/02/2012 09:00:00 PM,48,-122,6,5,11
1462,FremontBridge,12/02/2012 10:00:00 PM,48,-122,5,2,7
1463,FremontBridge,12/02/2012 11:00:00 PM,48,-122,3,5,8
1464,FremontBridge,12/03/2012 12:00:00 AM,48,-122,1,1,2
1465,FremontBridge,12/03/2012 01:00:00 AM,48,-122,3,3,6
1466,FremontBridge,12/03/2012 02:00:00 AM,48,-122,1,2,3
1467,FremontBridge,12/03/2012 03:00:00 AM,48,-122,1,0,1
1468,FremontBridge,12/03/2012 04:00:00 AM,48,-122,1,1,2
1469,FremontBridge,12/03/2012 05:00:00 AM,48,-122,3,19,22
1470,FremontBridge,12/03/2012 06:00:00 AM,48,-122,29,60,89
1471,FremontBridge,12/03/2012 07:00:00 AM,48,-122,64,122,186
1472,FremontBridge,12/03/2012 08:00:00 AM,48,-122,100,190,290
1473,FremontBridge,12/03/2012 09:00:00 AM,48,-122,46,105,151
1474,FremontBridge,12/03/2012 10:00:00 AM,48,-122,23,39,62
1475,FremontBridge,12/03/2012 11:00:00 AM,48,-122,23,27,50
1476,FremontBridge,12/03/2012 12:00:00 PM,48,-122,22,29,51
1477,FremontBridge,12/03/2012 01:00:00 PM,48,-122,18,23,41
1478,FremontBridge,12/03/2012 02:00:00 PM,48,-122,20,23,43
1479,FremontBridge,12/03/2012 03:00:00 PM,48,-122,33,25,58
1480,FremontBridge,12/03/2012 04:00:00 PM,48,-122,83,56,139
1481,FremontBridge,12/03/2012 05:00:00 PM,48,-122,215,72,287
1482,FremontBridge,12/03/2012 06:00:00 PM,48,-122,140,56,196
1483,FremontBridge,12/03/2012 07:00:00 PM,48,-122,62,35,97
1484,FremontBridge,12/03/2012 08:00:00 PM,48,-122,21,18,39
1485,FremontBridge,12/03/2012 09:00:00 PM,48,-122,15,14,29
1486,FremontBridge,12/03/2012 10:00:00 PM,48,-122,6,9,15
1487,FremontBridge,12/03/2012 11:00:00 PM,48,-122,6,3,9
1488,FremontBridge,12/04/2012 12:00:00 AM,48,-122,3,8,11
1489,FremontBridge,12/04/2012 01:00:00 AM,48,-122,3,1,4
1490,FremontBridge,12/04/2012 02:00:00 AM,48,-122,3,0,3
1491,FremontBridge,12/04/2012 03:00:00 AM,48,-122,1,1,2
1492,FremontBridge,12/04/2012 04:00:00 AM,48,-122,3,4,7
1493,FremontBridge,12/04/2012 05:00:00 AM,48,-122,9,15,24
1494,FremontBridge,12/04/2012 06:00:00 AM,48,-122,27,60,87
1495,FremontBridge,12/04/2012 07:00:00 AM,48,-122,54,135,189
1496,FremontBridge,12/04/2012 08:00:00 AM,48,-122,111,188,299
1497,FremontBridge,12/04/2012 09:00:00 AM,48,-122,66,113,179
1498,FremontBridge,12/04/2012 10:00:00 AM,48,-122,26,42,68
1499,FremontBridge,12/04/2012 11:00:00 AM,48,-122,14,43,57
1500,FremontBridge,12/04/2012 12:00:00 PM,48,-122,26,30,56
1501,FremontBridge,12/04/2012 01:00:00 PM,48,-122,24,28,52
1502,FremontBridge,12/04/2012 02:00:00 PM,48,-122,23,33,56
1503,FremontBridge,12/04/2012 03:00:00 PM,48,-122,36,30,66
1504,FremontBridge,12/04/2012 04:00:00 PM,48,-122,85,62,147
1505,FremontBridge,12/04/2012 05:00:00 PM,48,-122,228,86,314
1506,FremontBridge,12/04/2012 06:00:00 PM,48,-122,124,49,173
1507,FremontBridge,12/04/2012 07:00:00 PM,48,-122,45,33,78
1508,FremontBridge,12/04/2012 08:00:00 PM,48,-122,32,23,55
1509,FremontBridge,12/04/2012 09:00:00 PM,48,-122,20,19,39
1510,FremontBridge,12/04/2012 10:00:00 PM,48,-122,14,7,21
1511,FremontBridge,12/04/2012 11:00:00 PM,48,-122,13,11,24
1512,FremontBridge,12/05/2012 12:00:00 AM,48,-122,6,3,9
1513,FremontBridge,12/05/2012 01:00:00 AM,48,-122,1,0,1
1514,FremontBridge,12/05/2012 02:00:00 AM,48,-122,1,2,3
1515,FremontBridge,12/05/2012 03:00:00 AM,48,-122,2,0,2
1516,FremontBridge,12/05/2012 04:00:00 AM,48,-122,1,5,6
1517,FremontBridge,12/05/2012 05:00:00 AM,48,-122,4,17,21
1518,FremontBridge,12/05/2012 06:00:00 AM,48,-122,25,59,84
1519,FremontBridge,12/05/2012 07:00:00 AM,48,-122,61,149,210
1520,FremontBridge,12/05/2012 08:00:00 AM,48,-122,95,217,312
1521,FremontBridge,12/05/2012 09:00:00 AM,48,-122,69,121,190
1522,FremontBridge,12/05/2012 10:00:00 AM,48,-122,25,52,77
1523,FremontBridge,12/05/2012 11:00:00 AM,48,-122,26,40,66
1524,FremontBridge,12/05/2012 12:00:00 PM,48,-122,30,33,63
1525,FremontBridge,12/05/2012 01:00:00 PM,48,-122,37,47,84
1526,FremontBridge,12/05/2012 02:00:00 PM,48,-122,33,34,67
1527,FremontBridge,12/05/2012 03:00:00 PM,48,-122,52,55,107
1528,FremontBridge,12/05/2012 04:00:00 PM,48,-122,96,78,174
1529,FremontBridge,12/05/2012 05:00:00 PM,48,-122,225,103,328
1530,FremontBridge,12/05/2012 06:00:00 PM,48,-122,175,75,250
1531,FremontBridge,12/05/2012 07:00:00 PM,48,-122,82,40,122
1532,FremontBridge,12/05/2012 08:00:00 PM,48,-122,32,13,45
1533,FremontBridge,12/05/2012 09:00:00 PM,48,-122,21,18,39
1534,FremontBridge,12/05/2012 10:00:00 PM,48,-122,14,12,26
1535,FremontBridge,12/05/2012 11:00:00 PM,48,-122,7,7,14
1536,FremontBridge,12/06/2012 12:00:00 AM,48,-122,2,2,4
1537,FremontBridge,12/06/2012 01:00:00 AM,48,-122,3,2,5
1538,FremontBridge,12/06/2012 02:00:00 AM,48,-122,1,0,1
1539,FremontBridge,12/06/2012 03:00:00 AM,48,-122,2,1,3
1540,FremontBridge,12/06/2012 04:00:00 AM,48,-122,3,10,13
1541,FremontBridge,12/06/2012 05:00:00 AM,48,-122,9,17,26
1542,FremontBridge,12/06/2012 06:00:00 AM,48,-122,31,67,98
1543,FremontBridge,12/06/2012 07:00:00 AM,48,-122,46,119,165
1544,FremontBridge,12/06/2012 08:00:00 AM,48,-122,87,193,280
1545,FremontBridge,12/06/2012 09:00:00 AM,48,-122,60,83,143
1546,FremontBridge,12/06/2012 10:00:00 AM,48,-122,20,37,57
1547,FremontBridge,12/06/2012 11:00:00 AM,48,-122,12,22,34
1548,FremontBridge,12/06/2012 12:00:00 PM,48,-122,20,27,47
1549,FremontBridge,12/06/2012 01:00:00 PM,48,-122,24,16,40
1550,FremontBridge,12/06/2012 02:00:00 PM,48,-122,23,21,44
1551,FremontBridge,12/06/2012 03:00:00 PM,48,-122,37,36,73
1552,FremontBridge,12/06/2012 04:00:00 PM,48,-122,115,62,177
1553,FremontBridge,12/06/2012 05:00:00 PM,48,-122,188,97,285
1554,FremontBridge,12/06/2012 06:00:00 PM,48,-122,108,62,170
1555,FremontBridge,12/06/2012 07:00:00 PM,48,-122,60,32,92
1556,FremontBridge,12/06/2012 08:00:00 PM,48,-122,32,12,44
1557,FremontBridge,12/06/2012 09:00:00 PM,48,-122,21,19,40
1558,FremontBridge,12/06/2012 10:00:00 PM,48,-122,16,10,26
1559,FremontBridge,12/06/2012 11:00:00 PM,48,-122,4,8,12
1560,FremontBridge,12/07/2012 12:00:00 AM,48,-122,6,3,9
1561,FremontBridge,12/07/2012 01:00:00 AM,48,-122,7,1,8
1562,FremontBridge,12/07/2012 02:00:00 AM,48,-122,0,0,0
1563,FremontBridge,12/07/2012 03:00:00 AM,48,-122,1,0,1
1564,FremontBridge,12/07/2012 04:00:00 AM,48,-122,3,4,7
1565,FremontBridge,12/07/2012 05:00:00 AM,48,-122,5,10,15
1566,FremontBridge,12/07/2012 06:00:00 AM,48,-122,29,51,80
1567,FremontBridge,12/07/2012 07:00:00 AM,48,-122,40,122,162
1568,FremontBridge,12/07/2012 08:00:00 AM,48,-122,70,185,255
1569,FremontBridge,12/07/2012 09:00:00 AM,48,-122,53,96,149
1570,FremontBridge,12/07/2012 10:00:00 AM,48,-122,41,40,81
1571,FremontBridge,12/07/2012 11:00:00 AM,48,-122,18,25,43
1572,FremontBridge,12/07/2012 12:00:00 PM,48,-122,23,22,45
1573,FremontBridge,12/07/2012 01:00:00 PM,48,-122,25,21,46
1574,FremontBridge,12/07/2012 02:00:00 PM,48,-122,31,20,51
1575,FremontBridge,12/07/2012 03:00:00 PM,48,-122,36,33,69
1576,FremontBridge,12/07/2012 04:00:00 PM,48,-122,111,60,171
1577,FremontBridge,12/07/2012 05:00:00 PM,48,-122,182,81,263
1578,FremontBridge,12/07/2012 06:00:00 PM,48,-122,108,56,164
1579,FremontBridge,12/07/2012 07:00:00 PM,48,-122,47,27,74
1580,FremontBridge,12/07/2012 08:00:00 PM,48,-122,29,9,38
1581,FremontBridge,12/07/2012 09:00:00 PM,48,-122,16,12,28
1582,FremontBridge,12/07/2012 10:00:00 PM,48,-122,15,18,33
1583,FremontBridge,12/07/2012 11:00:00 PM,48,-122,14,10,24
1584,FremontBridge,12/08/2012 12:00:00 AM,48,-122,9,8,17
1585,FremontBridge,12/08/2012 01:00:00 AM,48,-122,2,3,5
1586,FremontBridge,12/08/2012 02:00:00 AM,48,-122,3,0,3
1587,FremontBridge,12/08/2012 03:00:00 AM,48,-122,0,1,1
1588,FremontBridge,12/08/2012 04:00:00 AM,48,-122,0,2,2
1589,FremontBridge,12/08/2012 05:00:00 AM,48,-122,2,1,3
1590,FremontBridge,12/08/2012 06:00:00 AM,48,-122,7,5,12
1591,FremontBridge,12/08/2012 07:00:00 AM,48,-122,11,10,21
1592,FremontBridge,12/08/2012 08:00:00 AM,48,-122,17,29,46
1593,FremontBridge,12/08/2012 09:00:00 AM,48,-122,23,29,52
1594,FremontBridge,12/08/2012 10:00:00 AM,48,-122,15,51,66
1595,FremontBridge,12/08/2012 11:00:00 AM,48,-122,29,36,65
1596,FremontBridge,12/08/2012 12:00:00 PM,48,-122,33,34,67
1597,FremontBridge,12/08/2012 01:00:00 PM,48,-122,25,58,83
1598,FremontBridge,12/08/2012 02:00:00 PM,48,-122,35,60,95
1599,FremontBridge,12/08/2012 03:00:00 PM,48,-122,47,40,87
1600,FremontBridge,12/08/2012 04:00:00 PM,48,-122,34,24,58
1601,FremontBridge,12/08/2012 05:00:00 PM,48,-122,38,16,54
1602,FremontBridge,12/08/2012 06:00:00 PM,48,-122,21,13,34
1603,FremontBridge,12/08/2012 07:00:00 PM,48,-122,10,12,22
1604,FremontBridge,12/08/2012 08:00:00 PM,48,-122,11,7,18
1605,FremontBridge,12/08/2012 09:00:00 PM,48,-122,15,12,27
1606,FremontBridge,12/08/2012 10:00:00 PM,48,-122,6,13,19
1607,FremontBridge,12/08/2012 11:00:00 PM,48,-122,10,7,17
1608,FremontBridge,12/09/2012 12:00:00 AM,48,-122,4,2,6
1609,FremontBridge,12/09/2012 01:00:00 AM,48,-122,3,3,6
1610,FremontBridge,12/09/2012 02:00:00 AM,48,-122,4,1,5
1611,FremontBridge,12/09/2012 03:00:00 AM,48,-122,5,3,8
1612,FremontBridge,12/09/2012 04:00:00 AM,48,-122,1,2,3
1613,FremontBridge,12/09/2012 05:00:00 AM,48,-122,1,1,2
1614,FremontBridge,12/09/2012 06:00:00 AM,48,-122,5,3,8
1615,FremontBridge,12/09/2012 07:00:00 AM,48,-122,10,6,16
1616,FremontBridge,12/09/2012 08:00:00 AM,48,-122,15,14,29
1617,FremontBridge,12/09/2012 09:00:00 AM,48,-122,14,8,22
1618,FremontBridge,12/09/2012 10:00:00 AM,48,-122,15,14,29
1619,FremontBridge,12/09/2012 11:00:00 AM,48,-122,6,31,37
1620,FremontBridge,12/09/2012 12:00:00 PM,48,-122,15,24,39
1621,FremontBridge,12/09/2012 01:00:00 PM,48,-122,15,24,39
1622,FremontBridge,12/09/2012 02:00:00 PM,48,-122,13,16,29
1623,FremontBridge,12/09/2012 03:00:00 PM,48,-122,18,15,33
1624,FremontBridge,12/09/2012 04:00:00 PM,48,-122,17,10,27
1625,FremontBridge,12/09/2012 05:00:00 PM,48,-122,14,13,27
1626,FremontBridge,12/09/2012 06:00:00 PM,48,-122,11,9,20
1627,FremontBridge,12/09/2012 07:00:00 PM,48,-122,6,7,13
1628,FremontBridge,12/09/2012 08:00:00 PM,48,-122,4,6,10
1629,FremontBridge,12/09/2012 09:00:00 PM,48,-122,6,3,9
1630,FremontBridge,12/09/2012 10:00:00 PM,48,-122,1,2,3
1631,FremontBridge,12/09/2012 11:00:00 PM,48,-122,2,0,2
1632,FremontBridge,12/10/2012 12:00:00 AM,48,-122,4,2,6
1633,FremontBridge,12/10/2012 01:00:00 AM,48,-122,2,4,6
1634,FremontBridge,12/10/2012 02:00:00 AM,48,-122,0,2,2
1635,FremontBridge,12/10/2012 03:00:00 AM,48,-122,1,0,1
1636,FremontBridge,12/10/2012 04:00:00 AM,48,-122,2,2,4
1637,FremontBridge,12/10/2012 05:00:00 AM,48,-122,10,22,32
1638,FremontBridge,12/10/2012 06:00:00 AM,48,-122,26,68,94
1639,FremontBridge,12/10/2012 07:00:00 AM,48,-122,94,134,228
1640,FremontBridge,12/10/2012 08:00:00 AM,48,-122,92,212,304
1641,FremontBridge,12/10/2012 09:00:00 AM,48,-122,51,100,151
1642,FremontBridge,12/10/2012 10:00:00 AM,48,-122,25,41,66
1643,FremontBridge,12/10/2012 11:00:00 AM,48,-122,22,32,54
1644,FremontBridge,12/10/2012 12:00:00 PM,48,-122,20,33,53
1645,FremontBridge,12/10/2012 01:00:00 PM,48,-122,28,25,53
1646,FremontBridge,12/10/2012 02:00:00 PM,48,-122,33,31,64
1647,FremontBridge,12/10/2012 03:00:00 PM,48,-122,48,36,84
1648,FremontBridge,12/10/2012 04:00:00 PM,48,-122,89,75,164
1649,FremontBridge,12/10/2012 05:00:00 PM,48,-122,245,109,354
1650,FremontBridge,12/10/2012 06:00:00 PM,48,-122,161,55,216
1651,FremontBridge,12/10/2012 07:00:00 PM,48,-122,58,32,90
1652,FremontBridge,12/10/2012 08:00:00 PM,48,-122,35,25,60
1653,FremontBridge,12/10/2012 09:00:00 PM,48,-122,31,11,42
1654,FremontBridge,12/10/2012 10:00:00 PM,48,-122,10,10,20
1655,FremontBridge,12/10/2012 11:00:00 PM,48,-122,5,9,14
1656,FremontBridge,12/11/2012 12:00:00 AM,48,-122,8,4,12
1657,FremontBridge,12/11/2012 01:00:00 AM,48,-122,1,1,2
1658,FremontBridge,12/11/2012 02:00:00 AM,48,-122,0,3,3
1659,FremontBridge,12/11/2012 03:00:00 AM,48,-122,3,1,4
1660,FremontBridge,12/11/2012 04:00:00 AM,48,-122,3,5,8
1661,FremontBridge,12/11/2012 05:00:00 AM,48,-122,6,19,25
1662,FremontBridge,12/11/2012 06:00:00 AM,48,-122,30,60,90
1663,FremontBridge,12/11/2012 07:00:00 AM,48,-122,50,158,208
1664,FremontBridge,12/11/2012 08:00:00 AM,48,-122,98,201,299
1665,FremontBridge,12/11/2012 09:00:00 AM,48,-122,46,108,154
1666,FremontBridge,12/11/2012 10:00:00 AM,48,-122,25,32,57
1667,FremontBridge,12/11/2012 11:00:00 AM,48,-122,14,20,34
1668,FremontBridge,12/11/2012 12:00:00 PM,48,-122,15,19,34
1669,FremontBridge,12/11/2012 01:00:00 PM,48,-122,26,27,53
1670,FremontBridge,12/11/2012 02:00:00 PM,48,-122,26,32,58
1671,FremontBridge,12/11/2012 03:00:00 PM,48,-122,40,35,75
1672,FremontBridge,12/11/2012 04:00:00 PM,48,-122,75,61,136
1673,FremontBridge,12/11/2012 05:00:00 PM,48,-122,232,81,313
1674,FremontBridge,12/11/2012 06:00:00 PM,48,-122,133,54,187
1675,FremontBridge,12/11/2012 07:00:00 PM,48,-122,55,20,75
1676,FremontBridge,12/11/2012 08:00:00 PM,48,-122,28,26,54
1677,FremontBridge,12/11/2012 09:00:00 PM,48,-122,23,11,34
1678,FremontBridge,12/11/2012 10:00:00 PM,48,-122,9,11,20
1679,FremontBridge,12/11/2012 11:00:00 PM,48,-122,5,5,10
1680,FremontBridge,12/12/2012 12:00:00 AM,48,-122,7,2,9
1681,FremontBridge,12/12/2012 01:00:00 AM,48,-122,1,4,5
1682,FremontBridge,12/12/2012 02:00:00 AM,48,-122,0,1,1
1683,FremontBridge,12/12/2012 03:00:00 AM,48,-122,1,2,3
1684,FremontBridge,12/12/2012 04:00:00 AM,48,-122,2,3,5
1685,FremontBridge,12/12/2012 05:00:00 AM,48,-122,4,18,22
1686,FremontBridge,12/12/2012 06:00:00 AM,48,-122,28,56,84
1687,FremontBridge,12/12/2012 07:00:00 AM,48,-122,44,116,160
1688,FremontBridge,12/12/2012 08:00:00 AM,48,-122,74,207,281
1689,FremontBridge,12/12/2012 09:00:00 AM,48,-122,60,80,140
1690,FremontBridge,12/12/2012 10:00:00 AM,48,-122,12,38,50
1691,FremontBridge,12/12/2012 11:00:00 AM,48,-122,11,9,20
1692,FremontBridge,12/12/2012 12:00:00 PM,48,-122,15,24,39
1693,FremontBridge,12/12/2012 01:00:00 PM,48,-122,16,22,38
1694,FremontBridge,12/12/2012 02:00:00 PM,48,-122,33,39,72
1695,FremontBridge,12/12/2012 03:00:00 PM,48,-122,48,29,77
1696,FremontBridge,12/12/2012 04:00:00 PM,48,-122,84,54,138
1697,FremontBridge,12/12/2012 05:00:00 PM,48,-122,210,85,295
1698,FremontBridge,12/12/2012 06:00:00 PM,48,-122,137,50,187
1699,FremontBridge,12/12/2012 07:00:00 PM,48,-122,51,30,81
1700,FremontBridge,12/12/2012 08:00:00 PM,48,-122,40,19,59
1701,FremontBridge,12/12/2012 09:00:00 PM,48,-122,27,10,37
1702,FremontBridge,12/12/2012 10:00:00 PM,48,-122,19,14,33
1703,FremontBridge,12/12/2012 11:00:00 PM,48,-122,5,7,12
1704,FremontBridge,12/13/2012 12:00:00 AM,48,-122,3,3,6
1705,FremontBridge,12/13/2012 01:00:00 AM,48,-122,3,1,4
1706,FremontBridge,12/13/2012 02:00:00 AM,48,-122,5,2,7
1707,FremontBridge,12/13/2012 03:00:00 AM,48,-122,1,1,2
1708,FremontBridge,12/13/2012 04:00:00 AM,48,-122,3,2,5
1709,FremontBridge,12/13/2012 05:00:00 AM,48,-122,6,17,23
1710,FremontBridge,12/13/2012 06:00:00 AM,48,-122,27,73,100
1711,FremontBridge,12/13/2012 07:00:00 AM,48,-122,46,129,175
1712,FremontBridge,12/13/2012 08:00:00 AM,48,-122,96,188,284
1713,FremontBridge,12/13/2012 09:00:00 AM,48,-122,48,106,154
1714,FremontBridge,12/13/2012 10:00:00 AM,48,-122,24,47,71
1715,FremontBridge,12/13/2012 11:00:00 AM,48,-122,29,31,60
1716,FremontBridge,12/13/2012 12:00:00 PM,48,-122,24,48,72
1717,FremontBridge,12/13/2012 01:00:00 PM,48,-122,28,30,58
1718,FremontBridge,12/13/2012 02:00:00 PM,48,-122,32,27,59
1719,FremontBridge,12/13/2012 03:00:00 PM,48,-122,46,49,95
1720,FremontBridge,12/13/2012 04:00:00 PM,48,-122,102,69,171
1721,FremontBridge,12/13/2012 05:00:00 PM,48,-122,206,74,280
1722,FremontBridge,12/13/2012 06:00:00 PM,48,-122,97,58,155
1723,FremontBridge,12/13/2012 07:00:00 PM,48,-122,72,35,107
1724,FremontBridge,12/13/2012 08:00:00 PM,48,-122,29,31,60
1725,FremontBridge,12/13/2012 09:00:00 PM,48,-122,22,8,30
1726,FremontBridge,12/13/2012 10:00:00 PM,48,-122,8,12,20
1727,FremontBridge,12/13/2012 11:00:00 PM,48,-122,9,6,15
1728,FremontBridge,12/14/2012 12:00:00 AM,48,-122,4,4,8
1729,FremontBridge,12/14/2012 01:00:00 AM,48,-122,2,1,3
1730,FremontBridge,12/14/2012 02:00:00 AM,48,-122,1,0,1
1731,FremontBridge,12/14/2012 03:00:00 AM,48,-122,2,1,3
1732,FremontBridge,12/14/2012 04:00:00 AM,48,-122,3,2,5
1733,FremontBridge,12/14/2012 05:00:00 AM,48,-122,5,6,11
1734,FremontBridge,12/14/2012 06:00:00 AM,48,-122,19,45,64
1735,FremontBridge,12/14/2012 07:00:00 AM,48,-122,37,112,149
1736,FremontBridge,12/14/2012 08:00:00 AM,48,-122,65,149,214
1737,FremontBridge,12/14/2012 09:00:00 AM,48,-122,48,102,150
1738,FremontBridge,12/14/2012 10:00:00 AM,48,-122,20,33,53
1739,FremontBridge,12/14/2012 11:00:00 AM,48,-122,21,33,54
1740,FremontBridge,12/14/2012 12:00:00 PM,48,-122,21,35,56
1741,FremontBridge,12/14/2012 01:00:00 PM,48,-122,24,42,66
1742,FremontBridge,12/14/2012 02:00:00 PM,48,-122,30,37,67
1743,FremontBridge,12/14/2012 03:00:00 PM,48,-122,55,61,116
1744,FremontBridge,12/14/2012 04:00:00 PM,48,-122,104,61,165
1745,FremontBridge,12/14/2012 05:00:00 PM,48,-122,163,66,229
1746,FremontBridge,12/14/2012 06:00:00 PM,48,-122,97,41,138
1747,FremontBridge,12/14/2012 07:00:00 PM,48,-122,46,31,77
1748,FremontBridge,12/14/2012 08:00:00 PM,48,-122,16,13,29
1749,FremontBridge,12/14/2012 09:00:00 PM,48,-122,12,8,20
1750,FremontBridge,12/14/2012 10:00:00 PM,48,-122,11,3,14
1751,FremontBridge,12/14/2012 11:00:00 PM,48,-122,9,8,17
1752,FremontBridge,12/15/2012 12:00:00 AM,48,-122,8,14,22
1753,FremontBridge,12/15/2012 01:00:00 AM,48,-122,3,3,6
1754,FremontBridge,12/15/2012 02:00:00 AM,48,-122,5,6,11
1755,FremontBridge,12/15/2012 03:00:00 AM,48,-122,1,3,4
1756,FremontBridge,12/15/2012 04:00:00 AM,48,-122,0,3,3
1757,FremontBridge,12/15/2012 05:00:00 AM,48,-122,3,7,10
1758,FremontBridge,12/15/2012 06:00:00 AM,48,-122,10,9,19
1759,FremontBridge,12/15/2012 07:00:00 AM,48,-122,8,9,17
1760,FremontBridge,12/15/2012 08:00:00 AM,48,-122,18,22,40
1761,FremontBridge,12/15/2012 09:00:00 AM,48,-122,15,31,46
1762,FremontBridge,12/15/2012 10:00:00 AM,48,-122,25,17,42
1763,FremontBridge,12/15/2012 11:00:00 AM,48,-122,10,19,29
1764,FremontBridge,12/15/2012 12:00:00 PM,48,-122,10,22,32
1765,FremontBridge,12/15/2012 01:00:00 PM,48,-122,8,8,16
1766,FremontBridge,12/15/2012 02:00:00 PM,48,-122,15,18,33
1767,FremontBridge,12/15/2012 03:00:00 PM,48,-122,12,7,19
1768,FremontBridge,12/15/2012 04:00:00 PM,48,-122,7,15,22
1769,FremontBridge,12/15/2012 05:00:00 PM,48,-122,10,9,19
1770,FremontBridge,12/15/2012 06:00:00 PM,48,-122,9,14,23
1771,FremontBridge,12/15/2012 07:00:00 PM,48,-122,13,2,15
1772,FremontBridge,12/15/2012 08:00:00 PM,48,-122,5,5,10
1773,FremontBridge,12/15/2012 09:00:00 PM,48,-122,6,5,11
1774,FremontBridge,12/15/2012 10:00:00 PM,48,-122,3,3,6
1775,FremontBridge,12/15/2012 11:00:00 PM,48,-122,1,7,8
1776,FremontBridge,12/16/2012 12:00:00 AM,48,-122,4,5,9
1777,FremontBridge,12/16/2012 01:00:00 AM,48,-122,2,2,4
1778,FremontBridge,12/16/2012 02:00:00 AM,48,-122,3,2,5
1779,FremontBridge,12/16/2012 03:00:00 AM,48,-122,2,0,2
1780,FremontBridge,12/16/2012 04:00:00 AM,48,-122,1,1,2
1781,FremontBridge,12/16/2012 05:00:00 AM,48,-122,1,0,1
1782,FremontBridge,12/16/2012 06:00:00 AM,48,-122,6,3,9
1783,FremontBridge,12/16/2012 07:00:00 AM,48,-122,5,7,12
1784,FremontBridge,12/16/2012 08:00:00 AM,48,-122,10,11,21
1785,FremontBridge,12/16/2012 09:00:00 AM,48,-122,12,27,39
1786,FremontBridge,12/16/2012 10:00:00 AM,48,-122,12,27,39
1787,FremontBridge,12/16/2012 11:00:00 AM,48,-122,14,24,38
1788,FremontBridge,12/16/2012 12:00:00 PM,48,-122,8,18,26
1789,FremontBridge,12/16/2012 01:00:00 PM,48,-122,12,13,25
1790,FremontBridge,12/16/2012 02:00:00 PM,48,-122,9,12,21
1791,FremontBridge,12/16/2012 03:00:00 PM,48,-122,9,14,23
1792,FremontBridge,12/16/2012 04:00:00 PM,48,-122,12,7,19
1793,FremontBridge,12/16/2012 05:00:00 PM,48,-122,5,3,8
1794,FremontBridge,12/16/2012 06:00:00 PM,48,-122,2,4,6
1795,FremontBridge,12/16/2012 07:00:00 PM,48,-122,8,4,12
1796,FremontBridge,12/16/2012 08:00:00 PM,48,-122,3,5,8
1797,FremontBridge,12/16/2012 09:00:00 PM,48,-122,3,6,9
1798,FremontBridge,12/16/2012 10:00:00 PM,48,-122,5,6,11
1799,FremontBridge,12/16/2012 11:00:00 PM,48,-122,1,1,2
1800,FremontBridge,12/17/2012 12:00:00 AM,48,-122,1,0,1
1801,FremontBridge,12/17/2012 01:00:00 AM,48,-122,0,1,1
1802,FremontBridge,12/17/2012 02:00:00 AM,48,-122,5,2,7
1803,FremontBridge,12/17/2012 03:00:00 AM,48,-122,1,0,1
1804,FremontBridge,12/17/2012 04:00:00 AM,48,-122,2,2,4
1805,FremontBridge,12/17/2012 05:00:00 AM,48,-122,3,9,12
1806,FremontBridge,12/17/2012 06:00:00 AM,48,-122,13,46,59
1807,FremontBridge,12/17/2012 07:00:00 AM,48,-122,30,93,123
1808,FremontBridge,12/17/2012 08:00:00 AM,48,-122,62,134,196
1809,FremontBridge,12/17/2012 09:00:00 AM,48,-122,36,82,118
1810,FremontBridge,12/17/2012 10:00:00 AM,48,-122,17,36,53
1811,FremontBridge,12/17/2012 11:00:00 AM,48,-122,13,21,34
1812,FremontBridge,12/17/2012 12:00:00 PM,48,-122,14,19,33
1813,FremontBridge,12/17/2012 01:00:00 PM,48,-122,16,26,42
1814,FremontBridge,12/17/2012 02:00:00 PM,48,-122,36,16,52
1815,FremontBridge,12/17/2012 03:00:00 PM,48,-122,31,27,58
1816,FremontBridge,12/17/2012 04:00:00 PM,48,-122,83,48,131
1817,FremontBridge,12/17/2012 05:00:00 PM,48,-122,152,68,220
1818,FremontBridge,12/17/2012 06:00:00 PM,48,-122,109,42,151
1819,FremontBridge,12/17/2012 07:00:00 PM,48,-122,66,19,85
1820,FremontBridge,12/17/2012 08:00:00 PM,48,-122,18,16,34
1821,FremontBridge,12/17/2012 09:00:00 PM,48,-122,19,17,36
1822,FremontBridge,12/17/2012 10:00:00 PM,48,-122,11,15,26
1823,FremontBridge,12/17/2012 11:00:00 PM,48,-122,7,8,15
1824,FremontBridge,12/18/2012 12:00:00 AM,48,-122,8,4,12
1825,FremontBridge,12/18/2012 01:00:00 AM,48,-122,3,6,9
1826,FremontBridge,12/18/2012 02:00:00 AM,48,-122,1,2,3
1827,FremontBridge,12/18/2012 03:00:00 AM,48,-122,2,1,3
1828,FremontBridge,12/18/2012 04:00:00 AM,48,-122,1,5,6
1829,FremontBridge,12/18/2012 05:00:00 AM,48,-122,9,14,23
1830,FremontBridge,12/18/2012 06:00:00 AM,48,-122,15,46,61
1831,FremontBridge,12/18/2012 07:00:00 AM,48,-122,48,114,162
1832,FremontBridge,12/18/2012 08:00:00 AM,48,-122,96,160,256
1833,FremontBridge,12/18/2012 09:00:00 AM,48,-122,44,88,132
1834,FremontBridge,12/18/2012 10:00:00 AM,48,-122,17,30,47
1835,FremontBridge,12/18/2012 11:00:00 AM,48,-122,17,16,33
1836,FremontBridge,12/18/2012 12:00:00 PM,48,-122,17,22,39
1837,FremontBridge,12/18/2012 01:00:00 PM,48,-122,21,30,51
1838,FremontBridge,12/18/2012 02:00:00 PM,48,-122,16,33,49
1839,FremontBridge,12/18/2012 03:00:00 PM,48,-122,52,34,86
1840,FremontBridge,12/18/2012 04:00:00 PM,48,-122,59,42,101
1841,FremontBridge,12/18/2012 05:00:00 PM,48,-122,193,82,275
1842,FremontBridge,12/18/2012 06:00:00 PM,48,-122,118,62,180
1843,FremontBridge,12/18/2012 07:00:00 PM,48,-122,49,27,76
1844,FremontBridge,12/18/2012 08:00:00 PM,48,-122,25,16,41
1845,FremontBridge,12/18/2012 09:00:00 PM,48,-122,13,12,25
1846,FremontBridge,12/18/2012 10:00:00 PM,48,-122,12,12,24
1847,FremontBridge,12/18/2012 11:00:00 PM,48,-122,4,4,8
1848,FremontBridge,12/19/2012 12:00:00 AM,48,-122,4,2,6
1849,FremontBridge,12/19/2012 01:00:00 AM,48,-122,1,4,5
1850,FremontBridge,12/19/2012 02:00:00 AM,48,-122,2,3,5
1851,FremontBridge,12/19/2012 03:00:00 AM,48,-122,1,0,1
1852,FremontBridge,12/19/2012 04:00:00 AM,48,-122,3,3,6
1853,FremontBridge,12/19/2012 05:00:00 AM,48,-122,3,11,14
1854,FremontBridge,12/19/2012 06:00:00 AM,48,-122,18,25,43
1855,FremontBridge,12/19/2012 07:00:00 AM,48,-122,34,64,98
1856,FremontBridge,12/19/2012 08:00:00 AM,48,-122,52,89,141
1857,FremontBridge,12/19/2012 09:00:00 AM,48,-122,29,49,78
1858,FremontBridge,12/19/2012 10:00:00 AM,48,-122,15,22,37
1859,FremontBridge,12/19/2012 11:00:00 AM,48,-122,10,12,22
1860,FremontBridge,12/19/2012 12:00:00 PM,48,-122,11,11,22
1861,FremontBridge,12/19/2012 01:00:00 PM,48,-122,15,14,29
1862,FremontBridge,12/19/2012 02:00:00 PM,48,-122,10,16,26
1863,FremontBridge,12/19/2012 03:00:00 PM,48,-122,25,13,38
1864,FremontBridge,12/19/2012 04:00:00 PM,48,-122,40,36,76
1865,FremontBridge,12/19/2012 05:00:00 PM,48,-122,100,47,147
1866,FremontBridge,12/19/2012 06:00:00 PM,48,-122,86,35,121
1867,FremontBridge,12/19/2012 07:00:00 PM,48,-122,39,14,53
1868,FremontBridge,12/19/2012 08:00:00 PM,48,-122,11,10,21
1869,FremontBridge,12/19/2012 09:00:00 PM,48,-122,6,3,9
1870,FremontBridge,12/19/2012 10:00:00 PM,48,-122,5,11,16
1871,FremontBridge,12/19/2012 11:00:00 PM,48,-122,4,2,6
1872,FremontBridge,12/20/2012 12:00:00 AM,48,-122,0,4,4
1873,FremontBridge,12/20/2012 01:00:00 AM,48,-122,0,1,1
1874,FremontBridge,12/20/2012 02:00:00 AM,48,-122,0,1,1
1875,FremontBridge,12/20/2012 03:00:00 AM,48,-122,1,0,1
1876,FremontBridge,12/20/2012 04:00:00 AM,48,-122,2,3,5
1877,FremontBridge,12/20/2012 05:00:00 AM,48,-122,3,5,8
1878,FremontBridge,12/20/2012 06:00:00 AM,48,-122,23,32,55
1879,FremontBridge,12/20/2012 07:00:00 AM,48,-122,32,71,103
1880,FremontBridge,12/20/2012 08:00:00 AM,48,-122,56,85,141
1881,FremontBridge,12/20/2012 09:00:00 AM,48,-122,27,40,67
1882,FremontBridge,12/20/2012 10:00:00 AM,48,-122,9,18,27
1883,FremontBridge,12/20/2012 11:00:00 AM,48,-122,13,10,23
1884,FremontBridge,12/20/2012 12:00:00 PM,48,-122,3,13,16
1885,FremontBridge,12/20/2012 01:00:00 PM,48,-122,6,18,24
1886,FremontBridge,12/20/2012 02:00:00 PM,48,-122,12,13,25
1887,FremontBridge,12/20/2012 03:00:00 PM,48,-122,27,26,53
1888,FremontBridge,12/20/2012 04:00:00 PM,48,-122,55,28,83
1889,FremontBridge,12/20/2012 05:00:00 PM,48,-122,114,65,179
1890,FremontBridge,12/20/2012 06:00:00 PM,48,-122,81,45,126
1891,FremontBridge,12/20/2012 07:00:00 PM,48,-122,31,18,49
1892,FremontBridge,12/20/2012 08:00:00 PM,48,-122,27,6,33
1893,FremontBridge,12/20/2012 09:00:00 PM,48,-122,12,7,19
1894,FremontBridge,12/20/2012 10:00:00 PM,48,-122,10,12,22
1895,FremontBridge,12/20/2012 11:00:00 PM,48,-122,7,5,12
1896,FremontBridge,12/21/2012 12:00:00 AM,48,-122,2,6,8
1897,FremontBridge,12/21/2012 01:00:00 AM,48,-122,0,2,2
1898,FremontBridge,12/21/2012 02:00:00 AM,48,-122,1,3,4
1899,FremontBridge,12/21/2012 03:00:00 AM,48,-122,1,1,2
1900,FremontBridge,12/21/2012 04:00:00 AM,48,-122,2,4,6
1901,FremontBridge,12/21/2012 05:00:00 AM,48,-122,3,6,9
1902,FremontBridge,12/21/2012 06:00:00 AM,48,-122,12,24,36
1903,FremontBridge,12/21/2012 07:00:00 AM,48,-122,36,67,103
1904,FremontBridge,12/21/2012 08:00:00 AM,48,-122,51,99,150
1905,FremontBridge,12/21/2012 09:00:00 AM,48,-122,36,58,94
1906,FremontBridge,12/21/2012 10:00:00 AM,48,-122,12,22,34
1907,FremontBridge,12/21/2012 11:00:00 AM,48,-122,13,22,35
1908,FremontBridge,12/21/2012 12:00:00 PM,48,-122,14,14,28
1909,FremontBridge,12/21/2012 01:00:00 PM,48,-122,13,25,38
1910,FremontBridge,12/21/2012 02:00:00 PM,48,-122,42,35,77
1911,FremontBridge,12/21/2012 03:00:00 PM,48,-122,61,66,127
1912,FremontBridge,12/21/2012 04:00:00 PM,48,-122,75,36,111
1913,FremontBridge,12/21/2012 05:00:00 PM,48,-122,112,49,161
1914,FremontBridge,12/21/2012 06:00:00 PM,48,-122,69,23,92
1915,FremontBridge,12/21/2012 07:00:00 PM,48,-122,26,12,38
1916,FremontBridge,12/21/2012 08:00:00 PM,48,-122,18,5,23
1917,FremontBridge,12/21/2012 09:00:00 PM,48,-122,11,10,21
1918,FremontBridge,12/21/2012 10:00:00 PM,48,-122,10,7,17
1919,FremontBridge,12/21/2012 11:00:00 PM,48,-122,7,9,16
1920,FremontBridge,12/22/2012 12:00:00 AM,48,-122,6,2,8
1921,FremontBridge,12/22/2012 01:00:00 AM,48,-122,0,6,6
1922,FremontBridge,12/22/2012 02:00:00 AM,48,-122,1,4,5
1923,FremontBridge,12/22/2012 03:00:00 AM,48,-122,3,5,8
1924,FremontBridge,12/22/2012 04:00:00 AM,48,-122,1,2,3
1925,FremontBridge,12/22/2012 05:00:00 AM,48,-122,0,5,5
1926,FremontBridge,12/22/2012 06:00:00 AM,48,-122,5,3,8
1927,FremontBridge,12/22/2012 07:00:00 AM,48,-122,5,15,20
1928,FremontBridge,12/22/2012 08:00:00 AM,48,-122,13,13,26
1929,FremontBridge,12/22/2012 09:00:00 AM,48,-122,12,16,28
1930,FremontBridge,12/22/2012 10:00:00 AM,48,-122,11,21,32
1931,FremontBridge,12/22/2012 11:00:00 AM,48,-122,18,19,37
1932,FremontBridge,12/22/2012 12:00:00 PM,48,-122,17,19,36
1933,FremontBridge,12/22/2012 01:00:00 PM,48,-122,24,32,56
1934,FremontBridge,12/22/2012 02:00:00 PM,48,-122,18,25,43
1935,FremontBridge,12/22/2012 03:00:00 PM,48,-122,29,24,53
1936,FremontBridge,12/22/2012 04:00:00 PM,48,-122,17,16,33
1937,FremontBridge,12/22/2012 05:00:00 PM,48,-122,12,8,20
1938,FremontBridge,12/22/2012 06:00:00 PM,48,-122,9,11,20
1939,FremontBridge,12/22/2012 07:00:00 PM,48,-122,10,8,18
1940,FremontBridge,12/22/2012 08:00:00 PM,48,-122,9,2,11
1941,FremontBridge,12/22/2012 09:00:00 PM,48,-122,3,2,5
1942,FremontBridge,12/22/2012 10:00:00 PM,48,-122,3,4,7
1943,FremontBridge,12/22/2012 11:00:00 PM,48,-122,4,1,5
1944,FremontBridge,12/23/2012 12:00:00 AM,48,-122,5,3,8
1945,FremontBridge,12/23/2012 01:00:00 AM,48,-122,1,6,7
1946,FremontBridge,12/23/2012 02:00:00 AM,48,-122,2,3,5
1947,FremontBridge,12/23/2012 03:00:00 AM,48,-122,0,2,2
1948,FremontBridge,12/23/2012 04:00:00 AM,48,-122,1,3,4
1949,FremontBridge,12/23/2012 05:00:00 AM,48,-122,0,2,2
1950,FremontBridge,12/23/2012 06:00:00 AM,48,-122,6,2,8
1951,FremontBridge,12/23/2012 07:00:00 AM,48,-122,8,7,15
1952,FremontBridge,12/23/2012 08:00:00 AM,48,-122,7,6,13
1953,FremontBridge,12/23/2012 09:00:00 AM,48,-122,5,6,11
1954,FremontBridge,12/23/2012 10:00:00 AM,48,-122,13,10,23
1955,FremontBridge,12/23/2012 11:00:00 AM,48,-122,16,32,48
1956,FremontBridge,12/23/2012 12:00:00 PM,48,-122,10,27,37
1957,FremontBridge,12/23/2012 01:00:00 PM,48,-122,19,30,49
1958,FremontBridge,12/23/2012 02:00:00 PM,48,-122,16,26,42
1959,FremontBridge,12/23/2012 03:00:00 PM,48,-122,17,24,41
1960,FremontBridge,12/23/2012 04:00:00 PM,48,-122,12,21,33
1961,FremontBridge,12/23/2012 05:00:00 PM,48,-122,12,13,25
1962,FremontBridge,12/23/2012 06:00:00 PM,48,-122,5,8,13
1963,FremontBridge,12/23/2012 07:00:00 PM,48,-122,8,2,10
1964,FremontBridge,12/23/2012 08:00:00 PM,48,-122,6,3,9
1965,FremontBridge,12/23/2012 09:00:00 PM,48,-122,6,4,10
1966,FremontBridge,12/23/2012 10:00:00 PM,48,-122,5,10,15
1967,FremontBridge,12/23/2012 11:00:00 PM,48,-122,8,3,11
1968,FremontBridge,12/24/2012 12:00:00 AM,48,-122,4,2,6
1969,FremontBridge,12/24/2012 01:00:00 AM,48,-122,2,0,2
1970,FremontBridge,12/24/2012 02:00:00 AM,48,-122,1,0,1
1971,FremontBridge,12/24/2012 03:00:00 AM,48,-122,1,0,1
1972,FremontBridge,12/24/2012 04:00:00 AM,48,-122,1,3,4
1973,FremontBridge,12/24/2012 05:00:00 AM,48,-122,1,10,11
1974,FremontBridge,12/24/2012 06:00:00 AM,48,-122,8,8,16
1975,FremontBridge,12/24/2012 07:00:00 AM,48,-122,15,22,37
1976,FremontBridge,12/24/2012 08:00:00 AM,48,-122,11,18,29
1977,FremontBridge,12/24/2012 09:00:00 AM,48,-122,16,26,42
1978,FremontBridge,12/24/2012 10:00:00 AM,48,-122,12,24,36
1979,FremontBridge,12/24/2012 11:00:00 AM,48,-122,11,20,31
1980,FremontBridge,12/24/2012 12:00:00 PM,48,-122,19,23,42
1981,FremontBridge,12/24/2012 01:00:00 PM,48,-122,22,35,57
1982,FremontBridge,12/24/2012 02:00:00 PM,48,-122,28,25,53
1983,FremontBridge,12/24/2012 03:00:00 PM,48,-122,38,34,72
1984,FremontBridge,12/24/2012 04:00:00 PM,48,-122,30,24,54
1985,FremontBridge,12/24/2012 05:00:00 PM,48,-122,12,8,20
1986,FremontBridge,12/24/2012 06:00:00 PM,48,-122,15,2,17
1987,FremontBridge,12/24/2012 07:00:00 PM,48,-122,12,6,18
1988,FremontBridge,12/24/2012 08:00:00 PM,48,-122,5,4,9
1989,FremontBridge,12/24/2012 09:00:00 PM,48,-122,0,1,1
1990,FremontBridge,12/24/2012 10:00:00 PM,48,-122,2,7,9
1991,FremontBridge,12/24/2012 11:00:00 PM,48,-122,4,2,6
1992,FremontBridge,12/25/2012 12:00:00 AM,48,-122,1,1,2
1993,FremontBridge,12/25/2012 01:00:00 AM,48,-122,0,2,2
1994,FremontBridge,12/25/2012 02:00:00 AM,48,-122,0,1,1
1995,FremontBridge,12/25/2012 03:00:00 AM,48,-122,1,1,2
1996,FremontBridge,12/25/2012 04:00:00 AM,48,-122,0,1,1
1997,FremontBridge,12/25/2012 05:00:00 AM,48,-122,0,1,1
1998,FremontBridge,12/25/2012 06:00:00 AM,48,-122,1,2,3
1999,FremontBridge,12/25/2012 07:00:00 AM,48,-122,2,2,4
2000,FremontBridge,12/25/2012 08:00:00 AM,48,-122,1,3,4
2001,FremontBridge,12/25/2012 09:00:00 AM,48,-122,5,2,7
2002,FremontBridge,12/25/2012 10:00:00 AM,48,-122,2,4,6
2003,FremontBridge,12/25/2012 11:00:00 AM,48,-122,3,0,3
2004,FremontBridge,12/25/2012 12:00:00 PM,48,-122,3,4,7
2005,FremontBridge,12/25/2012 01:00:00 PM,48,-122,8,3,11
2006,FremontBridge,12/25/2012 02:00:00 PM,48,-122,4,4,8
2007,FremontBridge,12/25/2012 03:00:00 PM,48,-122,1,2,3
2008,FremontBridge,12/25/2012 04:00:00 PM,48,-122,5,2,7
2009,FremontBridge,12/25/2012 05:00:00 PM,48,-122,5,6,11
2010,FremontBridge,12/25/2012 06:00:00 PM,48,-122,1,2,3
2011,FremontBridge,12/25/2012 07:00:00 PM,48,-122,1,1,2
2012,FremontBridge,12/25/2012 08:00:00 PM,48,-122,0,1,1
2013,FremontBridge,12/25/2012 09:00:00 PM,48,-122,3,2,5
2014,FremontBridge,12/25/2012 10:00:00 PM,48,-122,0,3,3
2015,FremontBridge,12/25/2012 11:00:00 PM,48,-122,1,0,1
2016,FremontBridge,12/26/2012 12:00:00 AM,48,-122,1,1,2
2017,FremontBridge,12/26/2012 01:00:00 AM,48,-122,0,0,0
2018,FremontBridge,12/26/2012 02:00:00 AM,48,-122,0,1,1
2019,FremontBridge,12/26/2012 03:00:00 AM,48,-122,1,0,1
2020,FremontBridge,12/26/2012 04:00:00 AM,48,-122,1,3,4
2021,FremontBridge,12/26/2012 05:00:00 AM,48,-122,2,7,9
2022,FremontBridge,12/26/2012 06:00:00 AM,48,-122,10,27,37
2023,FremontBridge,12/26/2012 07:00:00 AM,48,-122,23,46,69
2024,FremontBridge,12/26/2012 08:00:00 AM,48,-122,37,65,102
2025,FremontBridge,12/26/2012 09:00:00 AM,48,-122,20,36,56
2026,FremontBridge,12/26/2012 10:00:00 AM,48,-122,13,20,33
2027,FremontBridge,12/26/2012 11:00:00 AM,48,-122,8,25,33
2028,FremontBridge,12/26/2012 12:00:00 PM,48,-122,23,25,48
2029,FremontBridge,12/26/2012 01:00:00 PM,48,-122,14,20,34
2030,FremontBridge,12/26/2012 02:00:00 PM,48,-122,17,24,41
2031,FremontBridge,12/26/2012 03:00:00 PM,48,-122,36,27,63
2032,FremontBridge,12/26/2012 04:00:00 PM,48,-122,52,21,73
2033,FremontBridge,12/26/2012 05:00:00 PM,48,-122,66,38,104
2034,FremontBridge,12/26/2012 06:00:00 PM,48,-122,52,13,65
2035,FremontBridge,12/26/2012 07:00:00 PM,48,-122,14,6,20
2036,FremontBridge,12/26/2012 08:00:00 PM,48,-122,12,10,22
2037,FremontBridge,12/26/2012 09:00:00 PM,48,-122,8,4,12
2038,FremontBridge,12/26/2012 10:00:00 PM,48,-122,4,7,11
2039,FremontBridge,12/26/2012 11:00:00 PM,48,-122,1,4,5
2040,FremontBridge,12/27/2012 12:00:00 AM,48,-122,2,3,5
2041,FremontBridge,12/27/2012 01:00:00 AM,48,-122,2,0,2
2042,FremontBridge,12/27/2012 02:00:00 AM,48,-122,0,0,0
2043,FremontBridge,12/27/2012 03:00:00 AM,48,-122,0,0,0
2044,FremontBridge,12/27/2012 04:00:00 AM,48,-122,5,3,8
2045,FremontBridge,12/27/2012 05:00:00 AM,48,-122,5,6,11
2046,FremontBridge,12/27/2012 06:00:00 AM,48,-122,17,38,55
2047,FremontBridge,12/27/2012 07:00:00 AM,48,-122,31,64,95
2048,FremontBridge,12/27/2012 08:00:00 AM,48,-122,42,80,122
2049,FremontBridge,12/27/2012 09:00:00 AM,48,-122,21,57,78
2050,FremontBridge,12/27/2012 10:00:00 AM,48,-122,22,31,53
2051,FremontBridge,12/27/2012 11:00:00 AM,48,-122,9,25,34
2052,FremontBridge,12/27/2012 12:00:00 PM,48,-122,12,27,39
2053,FremontBridge,12/27/2012 01:00:00 PM,48,-122,22,20,42
2054,FremontBridge,12/27/2012 02:00:00 PM,48,-122,26,23,49
2055,FremontBridge,12/27/2012 03:00:00 PM,48,-122,45,31,76
2056,FremontBridge,12/27/2012 04:00:00 PM,48,-122,77,37,114
2057,FremontBridge,12/27/2012 05:00:00 PM,48,-122,105,48,153
2058,FremontBridge,12/27/2012 06:00:00 PM,48,-122,55,35,90
2059,FremontBridge,12/27/2012 07:00:00 PM,48,-122,47,18,65
2060,FremontBridge,12/27/2012 08:00:00 PM,48,-122,10,7,17
2061,FremontBridge,12/27/2012 09:00:00 PM,48,-122,8,6,14
2062,FremontBridge,12/27/2012 10:00:00 PM,48,-122,8,10,18
2063,FremontBridge,12/27/2012 11:00:00 PM,48,-122,4,4,8
2064,FremontBridge,12/28/2012 12:00:00 AM,48,-122,5,0,5
2065,FremontBridge,12/28/2012 01:00:00 AM,48,-122,1,0,1
2066,FremontBridge,12/28/2012 02:00:00 AM,48,-122,3,0,3
2067,FremontBridge,12/28/2012 03:00:00 AM,48,-122,1,1,2
2068,FremontBridge,12/28/2012 04:00:00 AM,48,-122,1,3,4
2069,FremontBridge,12/28/2012 05:00:00 AM,48,-122,2,5,7
2070,FremontBridge,12/28/2012 06:00:00 AM,48,-122,19,37,56
2071,FremontBridge,12/28/2012 07:00:00 AM,48,-122,19,52,71
2072,FremontBridge,12/28/2012 08:00:00 AM,48,-122,49,77,126
2073,FremontBridge,12/28/2012 09:00:00 AM,48,-122,30,54,84
2074,FremontBridge,12/28/2012 10:00:00 AM,48,-122,24,21,45
2075,FremontBridge,12/28/2012 11:00:00 AM,48,-122,27,42,69
2076,FremontBridge,12/28/2012 12:00:00 PM,48,-122,25,43,68
2077,FremontBridge,12/28/2012 01:00:00 PM,48,-122,36,45,81
2078,FremontBridge,12/28/2012 02:00:00 PM,48,-122,36,35,71
2079,FremontBridge,12/28/2012 03:00:00 PM,48,-122,47,54,101
2080,FremontBridge,12/28/2012 04:00:00 PM,48,-122,81,48,129
2081,FremontBridge,12/28/2012 05:00:00 PM,48,-122,96,46,142
2082,FremontBridge,12/28/2012 06:00:00 PM,48,-122,48,28,76
2083,FremontBridge,12/28/2012 07:00:00 PM,48,-122,20,9,29
2084,FremontBridge,12/28/2012 08:00:00 PM,48,-122,21,7,28
2085,FremontBridge,12/28/2012 09:00:00 PM,48,-122,20,6,26
2086,FremontBridge,12/28/2012 10:00:00 PM,48,-122,14,10,24
2087,FremontBridge,12/28/2012 11:00:00 PM,48,-122,1,8,9
2088,FremontBridge,12/29/2012 12:00:00 AM,48,-122,11,1,12
2089,FremontBridge,12/29/2012 01:00:00 AM,48,-122,3,2,5
2090,FremontBridge,12/29/2012 02:00:00 AM,48,-122,2,7,9
2091,FremontBridge,12/29/2012 03:00:00 AM,48,-122,1,6,7
2092,FremontBridge,12/29/2012 04:00:00 AM,48,-122,0,7,7
2093,FremontBridge,12/29/2012 05:00:00 AM,48,-122,1,2,3
2094,FremontBridge,12/29/2012 06:00:00 AM,48,-122,7,4,11
2095,FremontBridge,12/29/2012 07:00:00 AM,48,-122,9,14,23
2096,FremontBridge,12/29/2012 08:00:00 AM,48,-122,16,14,30
2097,FremontBridge,12/29/2012 09:00:00 AM,48,-122,10,11,21
2098,FremontBridge,12/29/2012 10:00:00 AM,48,-122,14,9,23
2099,FremontBridge,12/29/2012 11:00:00 AM,48,-122,21,27,48
2100,FremontBridge,12/29/2012 12:00:00 PM,48,-122,17,24,41
2101,FremontBridge,12/29/2012 01:00:00 PM,48,-122,15,11,26
2102,FremontBridge,12/29/2012 02:00:00 PM,48,-122,18,18,36
2103,FremontBridge,12/29/2012 03:00:00 PM,48,-122,17,31,48
2104,FremontBridge,12/29/2012 04:00:00 PM,48,-122,20,17,37
2105,FremontBridge,12/29/2012 05:00:00 PM,48,-122,10,10,20
2106,FremontBridge,12/29/2012 06:00:00 PM,48,-122,15,14,29
2107,FremontBridge,12/29/2012 07:00:00 PM,48,-122,10,8,18
2108,FremontBridge,12/29/2012 08:00:00 PM,48,-122,9,5,14
2109,FremontBridge,12/29/2012 09:00:00 PM,48,-122,4,4,8
2110,FremontBridge,12/29/2012 10:00:00 PM,48,-122,6,2,8
2111,FremontBridge,12/29/2012 11:00:00 PM,48,-122,2,1,3
2112,FremontBridge,12/30/2012 12:00:00 AM,48,-122,2,3,5
2113,FremontBridge,12/30/2012 01:00:00 AM,48,-122,1,1,2
2114,FremontBridge,12/30/2012 02:00:00 AM,48,-122,3,3,6
2115,FremontBridge,12/30/2012 03:00:00 AM,48,-122,0,1,1
2116,FremontBridge,12/30/2012 04:00:00 AM,48,-122,2,3,5
2117,FremontBridge,12/30/2012 05:00:00 AM,48,-122,0,1,1
2118,FremontBridge,12/30/2012 06:00:00 AM,48,-122,3,2,5
2119,FremontBridge,12/30/2012 07:00:00 AM,48,-122,6,4,10
2120,FremontBridge,12/30/2012 08:00:00 AM,48,-122,10,19,29
2121,FremontBridge,12/30/2012 09:00:00 AM,48,-122,10,31,41
2122,FremontBridge,12/30/2012 10:00:00 AM,48,-122,15,57,72
2123,FremontBridge,12/30/2012 11:00:00 AM,48,-122,23,24,47
2124,FremontBridge,12/30/2012 12:00:00 PM,48,-122,32,40,72
2125,FremontBridge,12/30/2012 01:00:00 PM,48,-122,59,41,100
2126,FremontBridge,12/30/2012 02:00:00 PM,48,-122,34,43,77
2127,FremontBridge,12/30/2012 03:00:00 PM,48,-122,33,28,61
2128,FremontBridge,12/30/2012 04:00:00 PM,48,-122,32,26,58
2129,FremontBridge,12/30/2012 05:00:00 PM,48,-122,20,16,36
2130,FremontBridge,12/30/2012 06:00:00 PM,48,-122,5,8,13
2131,FremontBridge,12/30/2012 07:00:00 PM,48,-122,11,6,17
2132,FremontBridge,12/30/2012 08:00:00 PM,48,-122,8,6,14
2133,FremontBridge,12/30/2012 09:00:00 PM,48,-122,5,2,7
2134,FremontBridge,12/30/2012 10:00:00 PM,48,-122,2,9,11
2135,FremontBridge,12/30/2012 11:00:00 PM,48,-122,4,1,5
2136,FremontBridge,12/31/2012 12:00:00 AM,48,-122,0,1,1
2137,FremontBridge,12/31/2012 01:00:00 AM,48,-122,3,3,6
2138,FremontBridge,12/31/2012 02:00:00 AM,48,-122,2,3,5
2139,FremontBridge,12/31/2012 03:00:00 AM,48,-122,1,0,1
2140,FremontBridge,12/31/2012 04:00:00 AM,48,-122,0,5,5
2141,FremontBridge,12/31/2012 05:00:00 AM,48,-122,2,7,9
2142,FremontBridge,12/31/2012 06:00:00 AM,48,-122,16,26,42
2143,FremontBridge,12/31/2012 07:00:00 AM,48,-122,16,48,64
2144,FremontBridge,12/31/2012 08:00:00 AM,48,-122,28,61,89
2145,FremontBridge,12/31/2012 09:00:00 AM,48,-122,32,38,70
2146,FremontBridge,12/31/2012 10:00:00 AM,48,-122,19,20,39
2147,FremontBridge,12/31/2012 11:00:00 AM,48,-122,15,21,36
2148,FremontBridge,12/31/2012 12:00:00 PM,48,-122,15,40,55
2149,FremontBridge,12/31/2012 01:00:00 PM,48,-122,21,27,48
2150,FremontBridge,12/31/2012 02:00:00 PM,48,-122,36,50,86
2151,FremontBridge,12/31/2012 03:00:00 PM,48,-122,43,38,81
2152,FremontBridge,12/31/2012 04:00:00 PM,48,-122,78,60,138
2153,FremontBridge,12/31/2012 05:00:00 PM,48,-122,51,41,92
2154,FremontBridge,12/31/2012 06:00:00 PM,48,-122,27,14,41
2155,FremontBridge,12/31/2012 07:00:00 PM,48,-122,8,20,28
2156,FremontBridge,12/31/2012 08:00:00 PM,48,-122,15,6,21
2157,FremontBridge,12/31/2012 09:00:00 PM,48,-122,1,5,6
2158,FremontBridge,12/31/2012 10:00:00 PM,48,-122,6,5,11
2159,FremontBridge,12/31/2012 11:00:00 PM,48,-122,5,7,12
2160,FremontBridge,01/01/2013 12:00:00 AM,48,-122,5,2,7
2161,FremontBridge,01/01/2013 01:00:00 AM,48,-122,12,9,21
2162,FremontBridge,01/01/2013 02:00:00 AM,48,-122,8,8,16
2163,FremontBridge,01/01/2013 03:00:00 AM,48,-122,4,2,6
2164,FremontBridge,01/01/2013 04:00:00 AM,48,-122,2,2,4
2165,FremontBridge,01/01/2013 05:00:00 AM,48,-122,2,1,3
2166,FremontBridge,01/01/2013 06:00:00 AM,48,-122,1,6,7
2167,FremontBridge,01/01/2013 07:00:00 AM,48,-122,2,1,3
2168,FremontBridge,01/01/2013 08:00:00 AM,48,-122,4,7,11
2169,FremontBridge,01/01/2013 09:00:00 AM,48,-122,5,9,14
2170,FremontBridge,01/01/2013 10:00:00 AM,48,-122,35,11,46
2171,FremontBridge,01/01/2013 11:00:00 AM,48,-122,29,33,62
2172,FremontBridge,01/01/2013 12:00:00 PM,48,-122,33,44,77
2173,FremontBridge,01/01/2013 01:00:00 PM,48,-122,64,48,112
2174,FremontBridge,01/01/2013 02:00:00 PM,48,-122,32,43,75
2175,FremontBridge,01/01/2013 03:00:00 PM,48,-122,32,46,78
2176,FremontBridge,01/01/2013 04:00:00 PM,48,-122,24,33,57
2177,FremontBridge,01/01/2013 05:00:00 PM,48,-122,12,18,30
2178,FremontBridge,01/01/2013 06:00:00 PM,48,-122,8,6,14
2179,FremontBridge,01/01/2013 07:00:00 PM,48,-122,4,8,12
2180,FremontBridge,01/01/2013 08:00:00 PM,48,-122,5,2,7
2181,FremontBridge,01/01/2013 09:00:00 PM,48,-122,3,2,5
2182,FremontBridge,01/01/2013 10:00:00 PM,48,-122,4,1,5
2183,FremontBridge,01/01/2013 11:00:00 PM,48,-122,4,2,6
2184,FremontBridge,01/02/2013 12:00:00 AM,48,-122,1,0,1
2185,FremontBridge,01/02/2013 01:00:00 AM,48,-122,0,1,1
2186,FremontBridge,01/02/2013 02:00:00 AM,48,-122,1,1,2
2187,FremontBridge,01/02/2013 03:00:00 AM,48,-122,1,0,1
2188,FremontBridge,01/02/2013 04:00:00 AM,48,-122,2,3,5
2189,FremontBridge,01/02/2013 05:00:00 AM,48,-122,8,13,21
2190,FremontBridge,01/02/2013 06:00:00 AM,48,-122,32,54,86
2191,FremontBridge,01/02/2013 07:00:00 AM,48,-122,42,115,157
2192,FremontBridge,01/02/2013 08:00:00 AM,48,-122,68,162,230
2193,FremontBridge,01/02/2013 09:00:00 AM,48,-122,48,96,144
2194,FremontBridge,01/02/2013 10:00:00 AM,48,-122,22,41,63
2195,FremontBridge,01/02/2013 11:00:00 AM,48,-122,19,32,51
2196,FremontBridge,01/02/2013 12:00:00 PM,48,-122,29,36,65
2197,FremontBridge,01/02/2013 01:00:00 PM,48,-122,22,23,45
2198,FremontBridge,01/02/2013 02:00:00 PM,48,-122,35,35,70
2199,FremontBridge,01/02/2013 03:00:00 PM,48,-122,48,56,104
2200,FremontBridge,01/02/2013 04:00:00 PM,48,-122,101,63,164
2201,FremontBridge,01/02/2013 05:00:00 PM,48,-122,221,78,299
2202,FremontBridge,01/02/2013 06:00:00 PM,48,-122,127,44,171
2203,FremontBridge,01/02/2013 07:00:00 PM,48,-122,48,24,72
2204,FremontBridge,01/02/2013 08:00:00 PM,48,-122,30,15,45
2205,FremontBridge,01/02/2013 09:00:00 PM,48,-122,18,3,21
2206,FremontBridge,01/02/2013 10:00:00 PM,48,-122,6,5,11
2207,FremontBridge,01/02/2013 11:00:00 PM,48,-122,2,4,6
2208,FremontBridge,01/03/2013 12:00:00 AM,48,-122,5,5,10
2209,FremontBridge,01/03/2013 01:00:00 AM,48,-122,1,2,3
2210,FremontBridge,01/03/2013 02:00:00 AM,48,-122,1,2,3
2211,FremontBridge,01/03/2013 03:00:00 AM,48,-122,1,0,1
2212,FremontBridge,01/03/2013 04:00:00 AM,48,-122,1,5,6
2213,FremontBridge,01/03/2013 05:00:00 AM,48,-122,9,11,20
2214,FremontBridge,01/03/2013 06:00:00 AM,48,-122,22,47,69
2215,FremontBridge,01/03/2013 07:00:00 AM,48,-122,41,108,149
2216,FremontBridge,01/03/2013 08:00:00 AM,48,-122,69,159,228
2217,FremontBridge,01/03/2013 09:00:00 AM,48,-122,54,84,138
2218,FremontBridge,01/03/2013 10:00:00 AM,48,-122,20,50,70
2219,FremontBridge,01/03/2013 11:00:00 AM,48,-122,27,29,56
2220,FremontBridge,01/03/2013 12:00:00 PM,48,-122,24,33,57
2221,FremontBridge,01/03/2013 01:00:00 PM,48,-122,33,26,59
2222,FremontBridge,01/03/2013 02:00:00 PM,48,-122,57,46,103
2223,FremontBridge,01/03/2013 03:00:00 PM,48,-122,60,44,104
2224,FremontBridge,01/03/2013 04:00:00 PM,48,-122,96,55,151
2225,FremontBridge,01/03/2013 05:00:00 PM,48,-122,176,76,252
2226,FremontBridge,01/03/2013 06:00:00 PM,48,-122,122,53,175
2227,FremontBridge,01/03/2013 07:00:00 PM,48,-122,45,24,69
2228,FremontBridge,01/03/2013 08:00:00 PM,48,-122,29,12,41
2229,FremontBridge,01/03/2013 09:00:00 PM,48,-122,10,6,16
2230,FremontBridge,01/03/2013 10:00:00 PM,48,-122,6,8,14
2231,FremontBridge,01/03/2013 11:00:00 PM,48,-122,4,5,9
2232,FremontBridge,01/04/2013 12:00:00 AM,48,-122,3,4,7
2233,FremontBridge,01/04/2013 01:00:00 AM,48,-122,1,1,2
2234,FremontBridge,01/04/2013 02:00:00 AM,48,-122,1,1,2
2235,FremontBridge,01/04/2013 03:00:00 AM,48,-122,1,1,2
2236,FremontBridge,01/04/2013 04:00:00 AM,48,-122,3,2,5
2237,FremontBridge,01/04/2013 05:00:00 AM,48,-122,4,9,13
2238,FremontBridge,01/04/2013 06:00:00 AM,48,-122,20,43,63
2239,FremontBridge,01/04/2013 07:00:00 AM,48,-122,40,98,138
2240,FremontBridge,01/04/2013 08:00:00 AM,48,-122,74,155,229
2241,FremontBridge,01/04/2013 09:00:00 AM,48,-122,40,85,125
2242,FremontBridge,01/04/2013 10:00:00 AM,48,-122,25,30,55
2243,FremontBridge,01/04/2013 11:00:00 AM,48,-122,23,33,56
2244,FremontBridge,01/04/2013 12:00:00 PM,48,-122,30,15,45
2245,FremontBridge,01/04/2013 01:00:00 PM,48,-122,31,32,63
2246,FremontBridge,01/04/2013 02:00:00 PM,48,-122,34,45,79
2247,FremontBridge,01/04/2013 03:00:00 PM,48,-122,50,39,89
2248,FremontBridge,01/04/2013 04:00:00 PM,48,-122,100,58,158
2249,FremontBridge,01/04/2013 05:00:00 PM,48,-122,171,74,245
2250,FremontBridge,01/04/2013 06:00:00 PM,48,-122,108,48,156
2251,FremontBridge,01/04/2013 07:00:00 PM,48,-122,58,21,79
2252,FremontBridge,01/04/2013 08:00:00 PM,48,-122,30,15,45
2253,FremontBridge,01/04/2013 09:00:00 PM,48,-122,14,14,28
2254,FremontBridge,01/04/2013 10:00:00 PM,48,-122,8,4,12
2255,FremontBridge,01/04/2013 11:00:00 PM,48,-122,7,9,16
2256,FremontBridge,01/05/2013 12:00:00 AM,48,-122,7,3,10
2257,FremontBridge,01/05/2013 01:00:00 AM,48,-122,0,1,1
2258,FremontBridge,01/05/2013 02:00:00 AM,48,-122,0,2,2
2259,FremontBridge,01/05/2013 03:00:00 AM,48,-122,0,2,2
2260,FremontBridge,01/05/2013 04:00:00 AM,48,-122,2,1,3
2261,FremontBridge,01/05/2013 05:00:00 AM,48,-122,4,4,8
2262,FremontBridge,01/05/2013 06:00:00 AM,48,-122,8,11,19
2263,FremontBridge,01/05/2013 07:00:00 AM,48,-122,8,5,13
2264,FremontBridge,01/05/2013 08:00:00 AM,48,-122,27,32,59
2265,FremontBridge,01/05/2013 09:00:00 AM,48,-122,16,18,34
2266,FremontBridge,01/05/2013 10:00:00 AM,48,-122,16,28,44
2267,FremontBridge,01/05/2013 11:00:00 AM,48,-122,22,29,51
2268,FremontBridge,01/05/2013 12:00:00 PM,48,-122,19,34,53
2269,FremontBridge,01/05/2013 01:00:00 PM,48,-122,30,43,73
2270,FremontBridge,01/05/2013 02:00:00 PM,48,-122,29,44,73
2271,FremontBridge,01/05/2013 03:00:00 PM,48,-122,40,44,84
2272,FremontBridge,01/05/2013 04:00:00 PM,48,-122,26,33,59
2273,FremontBridge,01/05/2013 05:00:00 PM,48,-122,15,26,41
2274,FremontBridge,01/05/2013 06:00:00 PM,48,-122,13,13,26
2275,FremontBridge,01/05/2013 07:00:00 PM,48,-122,9,7,16
2276,FremontBridge,01/05/2013 08:00:00 PM,48,-122,14,12,26
2277,FremontBridge,01/05/2013 09:00:00 PM,48,-122,1,6,7
2278,FremontBridge,01/05/2013 10:00:00 PM,48,-122,5,3,8
2279,FremontBridge,01/05/2013 11:00:00 PM,48,-122,5,2,7
2280,FremontBridge,01/06/2013 12:00:00 AM,48,-122,6,5,11
2281,FremontBridge,01/06/2013 01:00:00 AM,48,-122,5,4,9
2282,FremontBridge,01/06/2013 02:00:00 AM,48,-122,3,4,7
2283,FremontBridge,01/06/2013 03:00:00 AM,48,-122,0,1,1
2284,FremontBridge,01/06/2013 04:00:00 AM,48,-122,1,2,3
2285,FremontBridge,01/06/2013 05:00:00 AM,48,-122,2,2,4
2286,FremontBridge,01/06/2013 06:00:00 AM,48,-122,2,7,9
2287,FremontBridge,01/06/2013 07:00:00 AM,48,-122,7,6,13
2288,FremontBridge,01/06/2013 08:00:00 AM,48,-122,14,23,37
2289,FremontBridge,01/06/2013 09:00:00 AM,48,-122,18,25,43
2290,FremontBridge,01/06/2013 10:00:00 AM,48,-122,15,44,59
2291,FremontBridge,01/06/2013 11:00:00 AM,48,-122,43,62,105
2292,FremontBridge,01/06/2013 12:00:00 PM,48,-122,34,41,75
2293,FremontBridge,01/06/2013 01:00:00 PM,48,-122,44,52,96
2294,FremontBridge,01/06/2013 02:00:00 PM,48,-122,23,22,45
2295,FremontBridge,01/06/2013 03:00:00 PM,48,-122,14,28,42
2296,FremontBridge,01/06/2013 04:00:00 PM,48,-122,15,17,32
2297,FremontBridge,01/06/2013 05:00:00 PM,48,-122,19,16,35
2298,FremontBridge,01/06/2013 06:00:00 PM,48,-122,22,9,31
2299,FremontBridge,01/06/2013 07:00:00 PM,48,-122,7,8,15
2300,FremontBridge,01/06/2013 08:00:00 PM,48,-122,6,8,14
2301,FremontBridge,01/06/2013 09:00:00 PM,48,-122,6,6,12
2302,FremontBridge,01/06/2013 10:00:00 PM,48,-122,6,0,6
2303,FremontBridge,01/06/2013 11:00:00 PM,48,-122,2,0,2
2304,FremontBridge,01/07/2013 12:00:00 AM,48,-122,1,2,3
2305,FremontBridge,01/07/2013 01:00:00 AM,48,-122,2,1,3
2306,FremontBridge,01/07/2013 02:00:00 AM,48,-122,0,0,0
2307,FremontBridge,01/07/2013 03:00:00 AM,48,-122,0,0,0
2308,FremontBridge,01/07/2013 04:00:00 AM,48,-122,1,3,4
2309,FremontBridge,01/07/2013 05:00:00 AM,48,-122,8,15,23
2310,FremontBridge,01/07/2013 06:00:00 AM,48,-122,29,59,88
2311,FremontBridge,01/07/2013 07:00:00 AM,48,-122,55,133,188
2312,FremontBridge,01/07/2013 08:00:00 AM,48,-122,77,204,281
2313,FremontBridge,01/07/2013 09:00:00 AM,48,-122,50,100,150
2314,FremontBridge,01/07/2013 10:00:00 AM,48,-122,25,24,49
2315,FremontBridge,01/07/2013 11:00:00 AM,48,-122,16,25,41
2316,FremontBridge,01/07/2013 12:00:00 PM,48,-122,21,12,33
2317,FremontBridge,01/07/2013 01:00:00 PM,48,-122,20,22,42
2318,FremontBridge,01/07/2013 02:00:00 PM,48,-122,19,22,41
2319,FremontBridge,01/07/2013 03:00:00 PM,48,-122,52,32,84
2320,FremontBridge,01/07/2013 04:00:00 PM,48,-122,81,68,149
2321,FremontBridge,01/07/2013 05:00:00 PM,48,-122,208,105,313
2322,FremontBridge,01/07/2013 06:00:00 PM,48,-122,153,62,215
2323,FremontBridge,01/07/2013 07:00:00 PM,48,-122,48,41,89
2324,FremontBridge,01/07/2013 08:00:00 PM,48,-122,27,17,44
2325,FremontBridge,01/07/2013 09:00:00 PM,48,-122,12,11,23
2326,FremontBridge,01/07/2013 10:00:00 PM,48,-122,13,9,22
2327,FremontBridge,01/07/2013 11:00:00 PM,48,-122,7,1,8
2328,FremontBridge,01/08/2013 12:00:00 AM,48,-122,4,6,10
2329,FremontBridge,01/08/2013 01:00:00 AM,48,-122,0,2,2
2330,FremontBridge,01/08/2013 02:00:00 AM,48,-122,1,1,2
2331,FremontBridge,01/08/2013 03:00:00 AM,48,-122,1,1,2
2332,FremontBridge,01/08/2013 04:00:00 AM,48,-122,2,4,6
2333,FremontBridge,01/08/2013 05:00:00 AM,48,-122,10,15,25
2334,FremontBridge,01/08/2013 06:00:00 AM,48,-122,28,53,81
2335,FremontBridge,01/08/2013 07:00:00 AM,48,-122,59,141,200
2336,FremontBridge,01/08/2013 08:00:00 AM,48,-122,77,175,252
2337,FremontBridge,01/08/2013 09:00:00 AM,48,-122,50,58,108
2338,FremontBridge,01/08/2013 10:00:00 AM,48,-122,9,23,32
2339,FremontBridge,01/08/2013 11:00:00 AM,48,-122,16,14,30
2340,FremontBridge,01/08/2013 12:00:00 PM,48,-122,10,17,27
2341,FremontBridge,01/08/2013 01:00:00 PM,48,-122,13,17,30
2342,FremontBridge,01/08/2013 02:00:00 PM,48,-122,18,11,29
2343,FremontBridge,01/08/2013 03:00:00 PM,48,-122,33,24,57
2344,FremontBridge,01/08/2013 04:00:00 PM,48,-122,69,47,116
2345,FremontBridge,01/08/2013 05:00:00 PM,48,-122,194,75,269
2346,FremontBridge,01/08/2013 06:00:00 PM,48,-122,133,56,189
2347,FremontBridge,01/08/2013 07:00:00 PM,48,-122,31,17,48
2348,FremontBridge,01/08/2013 08:00:00 PM,48,-122,22,6,28
2349,FremontBridge,01/08/2013 09:00:00 PM,48,-122,7,8,15
2350,FremontBridge,01/08/2013 10:00:00 PM,48,-122,6,8,14
2351,FremontBridge,01/08/2013 11:00:00 PM,48,-122,4,2,6
2352,FremontBridge,01/09/2013 12:00:00 AM,48,-122,2,1,3
2353,FremontBridge,01/09/2013 01:00:00 AM,48,-122,0,0,0
2354,FremontBridge,01/09/2013 02:00:00 AM,48,-122,0,1,1
2355,FremontBridge,01/09/2013 03:00:00 AM,48,-122,1,1,2
2356,FremontBridge,01/09/2013 04:00:00 AM,48,-122,2,3,5
2357,FremontBridge,01/09/2013 05:00:00 AM,48,-122,2,11,13
2358,FremontBridge,01/09/2013 06:00:00 AM,48,-122,19,44,63
2359,FremontBridge,01/09/2013 07:00:00 AM,48,-122,29,76,105
2360,FremontBridge,01/09/2013 08:00:00 AM,48,-122,49,138,187
2361,FremontBridge,01/09/2013 09:00:00 AM,48,-122,40,63,103
2362,FremontBridge,01/09/2013 10:00:00 AM,48,-122,12,28,40
2363,FremontBridge,01/09/2013 11:00:00 AM,48,-122,10,14,24
2364,FremontBridge,01/09/2013 12:00:00 PM,48,-122,15,17,32
2365,FremontBridge,01/09/2013 01:00:00 PM,48,-122,8,19,27
2366,FremontBridge,01/09/2013 02:00:00 PM,48,-122,16,22,38
2367,FremontBridge,01/09/2013 03:00:00 PM,48,-122,31,27,58
2368,FremontBridge,01/09/2013 04:00:00 PM,48,-122,69,51,120
2369,FremontBridge,01/09/2013 05:00:00 PM,48,-122,142,74,216
2370,FremontBridge,01/09/2013 06:00:00 PM,48,-122,107,48,155
2371,FremontBridge,01/09/2013 07:00:00 PM,48,-122,52,22,74
2372,FremontBridge,01/09/2013 08:00:00 PM,48,-122,26,15,41
2373,FremontBridge,01/09/2013 09:00:00 PM,48,-122,10,7,17
2374,FremontBridge,01/09/2013 10:00:00 PM,48,-122,3,10,13
2375,FremontBridge,01/09/2013 11:00:00 PM,48,-122,5,5,10
2376,FremontBridge,01/10/2013 12:00:00 AM,48,-122,4,2,6
2377,FremontBridge,01/10/2013 01:00:00 AM,48,-122,1,4,5
2378,FremontBridge,01/10/2013 02:00:00 AM,48,-122,0,1,1
2379,FremontBridge,01/10/2013 03:00:00 AM,48,-122,0,0,0
2380,FremontBridge,01/10/2013 04:00:00 AM,48,-122,2,5,7
2381,FremontBridge,01/10/2013 05:00:00 AM,48,-122,2,10,12
2382,FremontBridge,01/10/2013 06:00:00 AM,48,-122,26,59,85
2383,FremontBridge,01/10/2013 07:00:00 AM,48,-122,52,111,163
2384,FremontBridge,01/10/2013 08:00:00 AM,48,-122,81,192,273
2385,FremontBridge,01/10/2013 09:00:00 AM,48,-122,57,102,159
2386,FremontBridge,01/10/2013 10:00:00 AM,48,-122,16,26,42
2387,FremontBridge,01/10/2013 11:00:00 AM,48,-122,23,23,46
2388,FremontBridge,01/10/2013 12:00:00 PM,48,-122,19,26,45
2389,FremontBridge,01/10/2013 01:00:00 PM,48,-122,15,23,38
2390,FremontBridge,01/10/2013 02:00:00 PM,48,-122,25,21,46
2391,FremontBridge,01/10/2013 03:00:00 PM,48,-122,34,28,62
2392,FremontBridge,01/10/2013 04:00:00 PM,48,-122,81,55,136
2393,FremontBridge,01/10/2013 05:00:00 PM,48,-122,180,98,278
2394,FremontBridge,01/10/2013 06:00:00 PM,48,-122,138,68,206
2395,FremontBridge,01/10/2013 07:00:00 PM,48,-122,52,31,83
2396,FremontBridge,01/10/2013 08:00:00 PM,48,-122,29,15,44
2397,FremontBridge,01/10/2013 09:00:00 PM,48,-122,20,8,28
2398,FremontBridge,01/10/2013 10:00:00 PM,48,-122,12,14,26
2399,FremontBridge,01/10/2013 11:00:00 PM,48,-122,6,13,19
2400,FremontBridge,01/11/2013 12:00:00 AM,48,-122,7,7,14
2401,FremontBridge,01/11/2013 01:00:00 AM,48,-122,4,8,12
2402,FremontBridge,01/11/2013 02:00:00 AM,48,-122,0,2,2
2403,FremontBridge,01/11/2013 03:00:00 AM,48,-122,0,0,0
2404,FremontBridge,01/11/2013 04:00:00 AM,48,-122,2,5,7
2405,FremontBridge,01/11/2013 05:00:00 AM,48,-122,5,6,11
2406,FremontBridge,01/11/2013 06:00:00 AM,48,-122,17,37,54
2407,FremontBridge,01/11/2013 07:00:00 AM,48,-122,36,77,113
2408,FremontBridge,01/11/2013 08:00:00 AM,48,-122,63,151,214
2409,FremontBridge,01/11/2013 09:00:00 AM,48,-122,50,88,138
2410,FremontBridge,01/11/2013 10:00:00 AM,48,-122,21,31,52
2411,FremontBridge,01/11/2013 11:00:00 AM,48,-122,17,31,48
2412,FremontBridge,01/11/2013 12:00:00 PM,48,-122,35,27,62
2413,FremontBridge,01/11/2013 01:00:00 PM,48,-122,23,31,54
2414,FremontBridge,01/11/2013 02:00:00 PM,48,-122,19,32,51
2415,FremontBridge,01/11/2013 03:00:00 PM,48,-122,49,42,91
2416,FremontBridge,01/11/2013 04:00:00 PM,48,-122,86,62,148
2417,FremontBridge,01/11/2013 05:00:00 PM,48,-122,139,67,206
2418,FremontBridge,01/11/2013 06:00:00 PM,48,-122,102,42,144
2419,FremontBridge,01/11/2013 07:00:00 PM,48,-122,45,20,65
2420,FremontBridge,01/11/2013 08:00:00 PM,48,-122,16,10,26
2421,FremontBridge,01/11/2013 09:00:00 PM,48,-122,7,10,17
2422,FremontBridge,01/11/2013 10:00:00 PM,48,-122,17,14,31
2423,FremontBridge,01/11/2013 11:00:00 PM,48,-122,6,4,10
2424,FremontBridge,01/12/2013 12:00:00 AM,48,-122,4,1,5
2425,FremontBridge,01/12/2013 01:00:00 AM,48,-122,3,2,5
2426,FremontBridge,01/12/2013 02:00:00 AM,48,-122,2,1,3
2427,FremontBridge,01/12/2013 03:00:00 AM,48,-122,0,1,1
2428,FremontBridge,01/12/2013 04:00:00 AM,48,-122,3,1,4
2429,FremontBridge,01/12/2013 05:00:00 AM,48,-122,2,3,5
2430,FremontBridge,01/12/2013 06:00:00 AM,48,-122,4,5,9
2431,FremontBridge,01/12/2013 07:00:00 AM,48,-122,6,6,12
2432,FremontBridge,01/12/2013 08:00:00 AM,48,-122,12,13,25
2433,FremontBridge,01/12/2013 09:00:00 AM,48,-122,16,19,35
2434,FremontBridge,01/12/2013 10:00:00 AM,48,-122,19,16,35
2435,FremontBridge,01/12/2013 11:00:00 AM,48,-122,25,29,54
2436,FremontBridge,01/12/2013 12:00:00 PM,48,-122,15,27,42
2437,FremontBridge,01/12/2013 01:00:00 PM,48,-122,43,37,80
2438,FremontBridge,01/12/2013 02:00:00 PM,48,-122,37,41,78
2439,FremontBridge,01/12/2013 03:00:00 PM,48,-122,38,42,80
2440,FremontBridge,01/12/2013 04:00:00 PM,48,-122,39,20,59
2441,FremontBridge,01/12/2013 05:00:00 PM,48,-122,12,28,40
2442,FremontBridge,01/12/2013 06:00:00 PM,48,-122,16,16,32
2443,FremontBridge,01/12/2013 07:00:00 PM,48,-122,15,10,25
2444,FremontBridge,01/12/2013 08:00:00 PM,48,-122,9,4,13
2445,FremontBridge,01/12/2013 09:00:00 PM,48,-122,3,3,6
2446,FremontBridge,01/12/2013 10:00:00 PM,48,-122,6,8,14
2447,FremontBridge,01/12/2013 11:00:00 PM,48,-122,7,8,15
2448,FremontBridge,01/13/2013 12:00:00 AM,48,-122,2,6,8
2449,FremontBridge,01/13/2013 01:00:00 AM,48,-122,2,4,6
2450,FremontBridge,01/13/2013 02:00:00 AM,48,-122,3,4,7
2451,FremontBridge,01/13/2013 03:00:00 AM,48,-122,0,0,0
2452,FremontBridge,01/13/2013 04:00:00 AM,48,-122,0,1,1
2453,FremontBridge,01/13/2013 05:00:00 AM,48,-122,2,0,2
2454,FremontBridge,01/13/2013 06:00:00 AM,48,-122,5,1,6
2455,FremontBridge,01/13/2013 07:00:00 AM,48,-122,4,8,12
2456,FremontBridge,01/13/2013 08:00:00 AM,48,-122,10,8,18
2457,FremontBridge,01/13/2013 09:00:00 AM,48,-122,6,17,23
2458,FremontBridge,01/13/2013 10:00:00 AM,48,-122,12,27,39
2459,FremontBridge,01/13/2013 11:00:00 AM,48,-122,19,13,32
2460,FremontBridge,01/13/2013 12:00:00 PM,48,-122,14,32,46
2461,FremontBridge,01/13/2013 01:00:00 PM,48,-122,21,38,59
2462,FremontBridge,01/13/2013 02:00:00 PM,48,-122,37,40,77
2463,FremontBridge,01/13/2013 03:00:00 PM,48,-122,24,47,71
2464,FremontBridge,01/13/2013 04:00:00 PM,48,-122,15,33,48
2465,FremontBridge,01/13/2013 05:00:00 PM,48,-122,15,18,33
2466,FremontBridge,01/13/2013 06:00:00 PM,48,-122,6,12,18
2467,FremontBridge,01/13/2013 07:00:00 PM,48,-122,6,10,16
2468,FremontBridge,01/13/2013 08:00:00 PM,48,-122,8,6,14
2469,FremontBridge,01/13/2013 09:00:00 PM,48,-122,8,4,12
2470,FremontBridge,01/13/2013 10:00:00 PM,48,-122,2,2,4
2471,FremontBridge,01/13/2013 11:00:00 PM,48,-122,3,4,7
2472,FremontBridge,01/14/2013 12:00:00 AM,48,-122,3,4,7
2473,FremontBridge,01/14/2013 01:00:00 AM,48,-122,1,1,2
2474,FremontBridge,01/14/2013 02:00:00 AM,48,-122,0,2,2
2475,FremontBridge,01/14/2013 03:00:00 AM,48,-122,1,2,3
2476,FremontBridge,01/14/2013 04:00:00 AM,48,-122,2,3,5
2477,FremontBridge,01/14/2013 05:00:00 AM,48,-122,6,13,19
2478,FremontBridge,01/14/2013 06:00:00 AM,48,-122,23,58,81
2479,FremontBridge,01/14/2013 07:00:00 AM,48,-122,46,106,152
2480,FremontBridge,01/14/2013 08:00:00 AM,48,-122,89,187,276
2481,FremontBridge,01/14/2013 09:00:00 AM,48,-122,48,100,148
2482,FremontBridge,01/14/2013 10:00:00 AM,48,-122,21,36,57
2483,FremontBridge,01/14/2013 11:00:00 AM,48,-122,26,25,51
2484,FremontBridge,01/14/2013 12:00:00 PM,48,-122,23,30,53
2485,FremontBridge,01/14/2013 01:00:00 PM,48,-122,23,18,41
2486,FremontBridge,01/14/2013 02:00:00 PM,48,-122,25,34,59
2487,FremontBridge,01/14/2013 03:00:00 PM,48,-122,46,28,74
2488,FremontBridge,01/14/2013 04:00:00 PM,48,-122,88,58,146
2489,FremontBridge,01/14/2013 05:00:00 PM,48,-122,196,87,283
2490,FremontBridge,01/14/2013 06:00:00 PM,48,-122,149,60,209
2491,FremontBridge,01/14/2013 07:00:00 PM,48,-122,61,30,91
2492,FremontBridge,01/14/2013 08:00:00 PM,48,-122,27,26,53
2493,FremontBridge,01/14/2013 09:00:00 PM,48,-122,14,12,26
2494,FremontBridge,01/14/2013 10:00:00 PM,48,-122,12,11,23
2495,FremontBridge,01/14/2013 11:00:00 PM,48,-122,5,3,8
2496,FremontBridge,01/15/2013 12:00:00 AM,48,-122,7,5,12
2497,FremontBridge,01/15/2013 01:00:00 AM,48,-122,1,0,1
2498,FremontBridge,01/15/2013 02:00:00 AM,48,-122,1,2,3
2499,FremontBridge,01/15/2013 03:00:00 AM,48,-122,1,2,3
2500,FremontBridge,01/15/2013 04:00:00 AM,48,-122,0,6,6
2501,FremontBridge,01/15/2013 05:00:00 AM,48,-122,8,8,16
2502,FremontBridge,01/15/2013 06:00:00 AM,48,-122,19,48,67
2503,FremontBridge,01/15/2013 07:00:00 AM,48,-122,52,150,202
2504,FremontBridge,01/15/2013 08:00:00 AM,48,-122,93,194,287
2505,FremontBridge,01/15/2013 09:00:00 AM,48,-122,62,109,171
2506,FremontBridge,01/15/2013 10:00:00 AM,48,-122,22,43,65
2507,FremontBridge,01/15/2013 11:00:00 AM,48,-122,13,30,43
2508,FremontBridge,01/15/2013 12:00:00 PM,48,-122,28,22,50
2509,FremontBridge,01/15/2013 01:00:00 PM,48,-122,33,30,63
2510,FremontBridge,01/15/2013 02:00:00 PM,48,-122,32,38,70
2511,FremontBridge,01/15/2013 03:00:00 PM,48,-122,59,47,106
2512,FremontBridge,01/15/2013 04:00:00 PM,48,-122,102,61,163
2513,FremontBridge,01/15/2013 05:00:00 PM,48,-122,193,115,308
2514,FremontBridge,01/15/2013 06:00:00 PM,48,-122,158,72,230
2515,FremontBridge,01/15/2013 07:00:00 PM,48,-122,55,35,90
2516,FremontBridge,01/15/2013 08:00:00 PM,48,-122,35,19,54
2517,FremontBridge,01/15/2013 09:00:00 PM,48,-122,17,16,33
2518,FremontBridge,01/15/2013 10:00:00 PM,48,-122,9,7,16
2519,FremontBridge,01/15/2013 11:00:00 PM,48,-122,1,6,7
2520,FremontBridge,01/16/2013 12:00:00 AM,48,-122,5,1,6
2521,FremontBridge,01/16/2013 01:00:00 AM,48,-122,0,2,2
2522,FremontBridge,01/16/2013 02:00:00 AM,48,-122,2,2,4
2523,FremontBridge,01/16/2013 03:00:00 AM,48,-122,2,2,4
2524,FremontBridge,01/16/2013 04:00:00 AM,48,-122,5,8,13
2525,FremontBridge,01/16/2013 05:00:00 AM,48,-122,3,12,15
2526,FremontBridge,01/16/2013 06:00:00 AM,48,-122,26,49,75
2527,FremontBridge,01/16/2013 07:00:00 AM,48,-122,46,119,165
2528,FremontBridge,01/16/2013 08:00:00 AM,48,-122,83,168,251
2529,FremontBridge,01/16/2013 09:00:00 AM,48,-122,56,98,154
2530,FremontBridge,01/16/2013 10:00:00 AM,48,-122,31,33,64
2531,FremontBridge,01/16/2013 11:00:00 AM,48,-122,26,25,51
2532,FremontBridge,01/16/2013 12:00:00 PM,48,-122,23,27,50
2533,FremontBridge,01/16/2013 01:00:00 PM,48,-122,29,26,55
2534,FremontBridge,01/16/2013 02:00:00 PM,48,-122,31,49,80
2535,FremontBridge,01/16/2013 03:00:00 PM,48,-122,40,55,95
2536,FremontBridge,01/16/2013 04:00:00 PM,48,-122,100,60,160
2537,FremontBridge,01/16/2013 05:00:00 PM,48,-122,202,86,288
2538,FremontBridge,01/16/2013 06:00:00 PM,48,-122,128,78,206
2539,FremontBridge,01/16/2013 07:00:00 PM,48,-122,64,21,85
2540,FremontBridge,01/16/2013 08:00:00 PM,48,-122,40,27,67
2541,FremontBridge,01/16/2013 09:00:00 PM,48,-122,18,6,24
2542,FremontBridge,01/16/2013 10:00:00 PM,48,-122,14,10,24
2543,FremontBridge,01/16/2013 11:00:00 PM,48,-122,6,6,12
2544,FremontBridge,01/17/2013 12:00:00 AM,48,-122,1,2,3
2545,FremontBridge,01/17/2013 01:00:00 AM,48,-122,2,1,3
2546,FremontBridge,01/17/2013 02:00:00 AM,48,-122,1,2,3
2547,FremontBridge,01/17/2013 03:00:00 AM,48,-122,1,1,2
2548,FremontBridge,01/17/2013 04:00:00 AM,48,-122,4,7,11
2549,FremontBridge,01/17/2013 05:00:00 AM,48,-122,2,13,15
2550,FremontBridge,01/17/2013 06:00:00 AM,48,-122,16,56,72
2551,FremontBridge,01/17/2013 07:00:00 AM,48,-122,44,120,164
2552,FremontBridge,01/17/2013 08:00:00 AM,48,-122,78,167,245
2553,FremontBridge,01/17/2013 09:00:00 AM,48,-122,50,84,134
2554,FremontBridge,01/17/2013 10:00:00 AM,48,-122,32,33,65
2555,FremontBridge,01/17/2013 11:00:00 AM,48,-122,25,22,47
2556,FremontBridge,01/17/2013 12:00:00 PM,48,-122,21,24,45
2557,FremontBridge,01/17/2013 01:00:00 PM,48,-122,32,23,55
2558,FremontBridge,01/17/2013 02:00:00 PM,48,-122,33,27,60
2559,FremontBridge,01/17/2013 03:00:00 PM,48,-122,45,26,71
2560,FremontBridge,01/17/2013 04:00:00 PM,48,-122,64,53,117
2561,FremontBridge,01/17/2013 05:00:00 PM,48,-122,204,74,278
2562,FremontBridge,01/17/2013 06:00:00 PM,48,-122,133,64,197
2563,FremontBridge,01/17/2013 07:00:00 PM,48,-122,51,37,88
2564,FremontBridge,01/17/2013 08:00:00 PM,48,-122,16,12,28
2565,FremontBridge,01/17/2013 09:00:00 PM,48,-122,16,14,30
2566,FremontBridge,01/17/2013 10:00:00 PM,48,-122,17,10,27
2567,FremontBridge,01/17/2013 11:00:00 PM,48,-122,6,11,17
2568,FremontBridge,01/18/2013 12:00:00 AM,48,-122,8,2,10
2569,FremontBridge,01/18/2013 01:00:00 AM,48,-122,5,1,6
2570,FremontBridge,01/18/2013 02:00:00 AM,48,-122,0,2,2
2571,FremontBridge,01/18/2013 03:00:00 AM,48,-122,0,2,2
2572,FremontBridge,01/18/2013 04:00:00 AM,48,-122,2,2,4
2573,FremontBridge,01/18/2013 05:00:00 AM,48,-122,3,4,7
2574,FremontBridge,01/18/2013 06:00:00 AM,48,-122,16,36,52
2575,FremontBridge,01/18/2013 07:00:00 AM,48,-122,46,91,137
2576,FremontBridge,01/18/2013 08:00:00 AM,48,-122,58,137,195
2577,FremontBridge,01/18/2013 09:00:00 AM,48,-122,58,81,139
2578,FremontBridge,01/18/2013 10:00:00 AM,48,-122,15,40,55
2579,FremontBridge,01/18/2013 11:00:00 AM,48,-122,22,31,53
2580,FremontBridge,01/18/2013 12:00:00 PM,48,-122,25,24,49
2581,FremontBridge,01/18/2013 01:00:00 PM,48,-122,30,25,55
2582,FremontBridge,01/18/2013 02:00:00 PM,48,-122,30,36,66
2583,FremontBridge,01/18/2013 03:00:00 PM,48,-122,37,29,66
2584,FremontBridge,01/18/2013 04:00:00 PM,48,-122,62,57,119
2585,FremontBridge,01/18/2013 05:00:00 PM,48,-122,158,87,245
2586,FremontBridge,01/18/2013 06:00:00 PM,48,-122,97,60,157
2587,FremontBridge,01/18/2013 07:00:00 PM,48,-122,47,23,70
2588,FremontBridge,01/18/2013 08:00:00 PM,48,-122,24,9,33
2589,FremontBridge,01/18/2013 09:00:00 PM,48,-122,8,13,21
2590,FremontBridge,01/18/2013 10:00:00 PM,48,-122,12,9,21
2591,FremontBridge,01/18/2013 11:00:00 PM,48,-122,12,9,21
2592,FremontBridge,01/19/2013 12:00:00 AM,48,-122,9,5,14
2593,FremontBridge,01/19/2013 01:00:00 AM,48,-122,6,2,8
2594,FremontBridge,01/19/2013 02:00:00 AM,48,-122,3,3,6
2595,FremontBridge,01/19/2013 03:00:00 AM,48,-122,0,2,2
2596,FremontBridge,01/19/2013 04:00:00 AM,48,-122,0,1,1
2597,FremontBridge,01/19/2013 05:00:00 AM,48,-122,1,4,5
2598,FremontBridge,01/19/2013 06:00:00 AM,48,-122,6,4,10
2599,FremontBridge,01/19/2013 07:00:00 AM,48,-122,6,13,19
2600,FremontBridge,01/19/2013 08:00:00 AM,48,-122,11,16,27
2601,FremontBridge,01/19/2013 09:00:00 AM,48,-122,17,20,37
2602,FremontBridge,01/19/2013 10:00:00 AM,48,-122,15,22,37
2603,FremontBridge,01/19/2013 11:00:00 AM,48,-122,30,34,64
2604,FremontBridge,01/19/2013 12:00:00 PM,48,-122,31,37,68
2605,FremontBridge,01/19/2013 01:00:00 PM,48,-122,35,42,77
2606,FremontBridge,01/19/2013 02:00:00 PM,48,-122,26,45,71
2607,FremontBridge,01/19/2013 03:00:00 PM,48,-122,28,51,79
2608,FremontBridge,01/19/2013 04:00:00 PM,48,-122,26,53,79
2609,FremontBridge,01/19/2013 05:00:00 PM,48,-122,28,18,46
2610,FremontBridge,01/19/2013 06:00:00 PM,48,-122,17,9,26
2611,FremontBridge,01/19/2013 07:00:00 PM,48,-122,9,12,21
2612,FremontBridge,01/19/2013 08:00:00 PM,48,-122,15,9,24
2613,FremontBridge,01/19/2013 09:00:00 PM,48,-122,9,6,15
2614,FremontBridge,01/19/2013 10:00:00 PM,48,-122,5,9,14
2615,FremontBridge,01/19/2013 11:00:00 PM,48,-122,6,4,10
2616,FremontBridge,01/20/2013 12:00:00 AM,48,-122,8,3,11
2617,FremontBridge,01/20/2013 01:00:00 AM,48,-122,6,5,11
2618,FremontBridge,01/20/2013 02:00:00 AM,48,-122,2,5,7
2619,FremontBridge,01/20/2013 03:00:00 AM,48,-122,0,0,0
2620,FremontBridge,01/20/2013 04:00:00 AM,48,-122,4,1,5
2621,FremontBridge,01/20/2013 05:00:00 AM,48,-122,0,1,1
2622,FremontBridge,01/20/2013 06:00:00 AM,48,-122,5,3,8
2623,FremontBridge,01/20/2013 07:00:00 AM,48,-122,7,9,16
2624,FremontBridge,01/20/2013 08:00:00 AM,48,-122,8,18,26
2625,FremontBridge,01/20/2013 09:00:00 AM,48,-122,16,15,31
2626,FremontBridge,01/20/2013 10:00:00 AM,48,-122,16,24,40
2627,FremontBridge,01/20/2013 11:00:00 AM,48,-122,28,33,61
2628,FremontBridge,01/20/2013 12:00:00 PM,48,-122,24,50,74
2629,FremontBridge,01/20/2013 01:00:00 PM,48,-122,27,52,79
2630,FremontBridge,01/20/2013 02:00:00 PM,48,-122,32,60,92
2631,FremontBridge,01/20/2013 03:00:00 PM,48,-122,41,54,95
2632,FremontBridge,01/20/2013 04:00:00 PM,48,-122,40,47,87
2633,FremontBridge,01/20/2013 05:00:00 PM,48,-122,26,24,50
2634,FremontBridge,01/20/2013 06:00:00 PM,48,-122,11,11,22
2635,FremontBridge,01/20/2013 07:00:00 PM,48,-122,9,15,24
2636,FremontBridge,01/20/2013 08:00:00 PM,48,-122,6,12,18
2637,FremontBridge,01/20/2013 09:00:00 PM,48,-122,6,4,10
2638,FremontBridge,01/20/2013 10:00:00 PM,48,-122,6,11,17
2639,FremontBridge,01/20/2013 11:00:00 PM,48,-122,6,10,16
2640,FremontBridge,01/21/2013 12:00:00 AM,48,-122,3,4,7
2641,FremontBridge,01/21/2013 01:00:00 AM,48,-122,0,1,1
2642,FremontBridge,01/21/2013 02:00:00 AM,48,-122,4,2,6
2643,FremontBridge,01/21/2013 03:00:00 AM,48,-122,1,1,2
2644,FremontBridge,01/21/2013 04:00:00 AM,48,-122,1,4,5
2645,FremontBridge,01/21/2013 05:00:00 AM,48,-122,2,8,10
2646,FremontBridge,01/21/2013 06:00:00 AM,48,-122,10,22,32
2647,FremontBridge,01/21/2013 07:00:00 AM,48,-122,34,56,90
2648,FremontBridge,01/21/2013 08:00:00 AM,48,-122,44,90,134
2649,FremontBridge,01/21/2013 09:00:00 AM,48,-122,39,63,102
2650,FremontBridge,01/21/2013 10:00:00 AM,48,-122,21,27,48
2651,FremontBridge,01/21/2013 11:00:00 AM,48,-122,15,23,38
2652,FremontBridge,01/21/2013 12:00:00 PM,48,-122,29,36,65
2653,FremontBridge,01/21/2013 01:00:00 PM,48,-122,17,31,48
2654,FremontBridge,01/21/2013 02:00:00 PM,48,-122,35,29,64
2655,FremontBridge,01/21/2013 03:00:00 PM,48,-122,16,41,57
2656,FremontBridge,01/21/2013 04:00:00 PM,48,-122,63,50,113
2657,FremontBridge,01/21/2013 05:00:00 PM,48,-122,111,51,162
2658,FremontBridge,01/21/2013 06:00:00 PM,48,-122,81,39,120
2659,FremontBridge,01/21/2013 07:00:00 PM,48,-122,44,27,71
2660,FremontBridge,01/21/2013 08:00:00 PM,48,-122,21,13,34
2661,FremontBridge,01/21/2013 09:00:00 PM,48,-122,12,9,21
2662,FremontBridge,01/21/2013 10:00:00 PM,48,-122,17,10,27
2663,FremontBridge,01/21/2013 11:00:00 PM,48,-122,12,7,19
2664,FremontBridge,01/22/2013 12:00:00 AM,48,-122,2,4,6
2665,FremontBridge,01/22/2013 01:00:00 AM,48,-122,2,0,2
2666,FremontBridge,01/22/2013 02:00:00 AM,48,-122,3,1,4
2667,FremontBridge,01/22/2013 03:00:00 AM,48,-122,1,0,1
2668,FremontBridge,01/22/2013 04:00:00 AM,48,-122,1,4,5
2669,FremontBridge,01/22/2013 05:00:00 AM,48,-122,5,15,20
2670,FremontBridge,01/22/2013 06:00:00 AM,48,-122,21,63,84
2671,FremontBridge,01/22/2013 07:00:00 AM,48,-122,51,144,195
2672,FremontBridge,01/22/2013 08:00:00 AM,48,-122,90,171,261
2673,FremontBridge,01/22/2013 09:00:00 AM,48,-122,63,84,147
2674,FremontBridge,01/22/2013 10:00:00 AM,48,-122,22,40,62
2675,FremontBridge,01/22/2013 11:00:00 AM,48,-122,21,31,52
2676,FremontBridge,01/22/2013 12:00:00 PM,48,-122,22,27,49
2677,FremontBridge,01/22/2013 01:00:00 PM,48,-122,33,26,59
2678,FremontBridge,01/22/2013 02:00:00 PM,48,-122,36,26,62
2679,FremontBridge,01/22/2013 03:00:00 PM,48,-122,58,37,95
2680,FremontBridge,01/22/2013 04:00:00 PM,48,-122,74,72,146
2681,FremontBridge,01/22/2013 05:00:00 PM,48,-122,217,100,317
2682,FremontBridge,01/22/2013 06:00:00 PM,48,-122,155,62,217
2683,FremontBridge,01/22/2013 07:00:00 PM,48,-122,51,31,82
2684,FremontBridge,01/22/2013 08:00:00 PM,48,-122,22,16,38
2685,FremontBridge,01/22/2013 09:00:00 PM,48,-122,12,17,29
2686,FremontBridge,01/22/2013 10:00:00 PM,48,-122,13,6,19
2687,FremontBridge,01/22/2013 11:00:00 PM,48,-122,6,7,13
2688,FremontBridge,01/23/2013 12:00:00 AM,48,-122,3,3,6
2689,FremontBridge,01/23/2013 01:00:00 AM,48,-122,0,3,3
2690,FremontBridge,01/23/2013 02:00:00 AM,48,-122,1,2,3
2691,FremontBridge,01/23/2013 03:00:00 AM,48,-122,1,1,2
2692,FremontBridge,01/23/2013 04:00:00 AM,48,-122,3,7,10
2693,FremontBridge,01/23/2013 05:00:00 AM,48,-122,6,23,29
2694,FremontBridge,01/23/2013 06:00:00 AM,48,-122,21,63,84
2695,FremontBridge,01/23/2013 07:00:00 AM,48,-122,68,122,190
2696,FremontBridge,01/23/2013 08:00:00 AM,48,-122,88,193,281
2697,FremontBridge,01/23/2013 09:00:00 AM,48,-122,59,101,160
2698,FremontBridge,01/23/2013 10:00:00 AM,48,-122,18,38,56
2699,FremontBridge,01/23/2013 11:00:00 AM,48,-122,14,13,27
2700,FremontBridge,01/23/2013 12:00:00 PM,48,-122,12,15,27
2701,FremontBridge,01/23/2013 01:00:00 PM,48,-122,18,17,35
2702,FremontBridge,01/23/2013 02:00:00 PM,48,-122,15,23,38
2703,FremontBridge,01/23/2013 03:00:00 PM,48,-122,31,24,55
2704,FremontBridge,01/23/2013 04:00:00 PM,48,-122,68,44,112
2705,FremontBridge,01/23/2013 05:00:00 PM,48,-122,205,81,286
2706,FremontBridge,01/23/2013 06:00:00 PM,48,-122,125,58,183
2707,FremontBridge,01/23/2013 07:00:00 PM,48,-122,52,23,75
2708,FremontBridge,01/23/2013 08:00:00 PM,48,-122,35,22,57
2709,FremontBridge,01/23/2013 09:00:00 PM,48,-122,12,6,18
2710,FremontBridge,01/23/2013 10:00:00 PM,48,-122,9,9,18
2711,FremontBridge,01/23/2013 11:00:00 PM,48,-122,7,5,12
2712,FremontBridge,01/24/2013 12:00:00 AM,48,-122,1,4,5
2713,FremontBridge,01/24/2013 01:00:00 AM,48,-122,1,3,4
2714,FremontBridge,01/24/2013 02:00:00 AM,48,-122,1,2,3
2715,FremontBridge,01/24/2013 03:00:00 AM,48,-122,1,2,3
2716,FremontBridge,01/24/2013 04:00:00 AM,48,-122,1,6,7
2717,FremontBridge,01/24/2013 05:00:00 AM,48,-122,6,12,18
2718,FremontBridge,01/24/2013 06:00:00 AM,48,-122,26,72,98
2719,FremontBridge,01/24/2013 07:00:00 AM,48,-122,45,128,173
2720,FremontBridge,01/24/2013 08:00:00 AM,48,-122,89,179,268
2721,FremontBridge,01/24/2013 09:00:00 AM,48,-122,62,101,163
2722,FremontBridge,01/24/2013 10:00:00 AM,48,-122,33,39,72
2723,FremontBridge,01/24/2013 11:00:00 AM,48,-122,29,28,57
2724,FremontBridge,01/24/2013 12:00:00 PM,48,-122,25,43,68
2725,FremontBridge,01/24/2013 01:00:00 PM,48,-122,31,23,54
2726,FremontBridge,01/24/2013 02:00:00 PM,48,-122,30,36,66
2727,FremontBridge,01/24/2013 03:00:00 PM,48,-122,46,46,92
2728,FremontBridge,01/24/2013 04:00:00 PM,48,-122,80,45,125
2729,FremontBridge,01/24/2013 05:00:00 PM,48,-122,198,85,283
2730,FremontBridge,01/24/2013 06:00:00 PM,48,-122,123,67,190
2731,FremontBridge,01/24/2013 07:00:00 PM,48,-122,53,40,93
2732,FremontBridge,01/24/2013 08:00:00 PM,48,-122,37,17,54
2733,FremontBridge,01/24/2013 09:00:00 PM,48,-122,14,12,26
2734,FremontBridge,01/24/2013 10:00:00 PM,48,-122,14,6,20
2735,FremontBridge,01/24/2013 11:00:00 PM,48,-122,6,7,13
2736,FremontBridge,01/25/2013 12:00:00 AM,48,-122,3,3,6
2737,FremontBridge,01/25/2013 01:00:00 AM,48,-122,0,3,3
2738,FremontBridge,01/25/2013 02:00:00 AM,48,-122,2,2,4
2739,FremontBridge,01/25/2013 03:00:00 AM,48,-122,0,0,0
2740,FremontBridge,01/25/2013 04:00:00 AM,48,-122,0,5,5
2741,FremontBridge,01/25/2013 05:00:00 AM,48,-122,6,12,18
2742,FremontBridge,01/25/2013 06:00:00 AM,48,-122,31,58,89
2743,FremontBridge,01/25/2013 07:00:00 AM,48,-122,45,99,144
2744,FremontBridge,01/25/2013 08:00:00 AM,48,-122,84,164,248
2745,FremontBridge,01/25/2013 09:00:00 AM,48,-122,53,82,135
2746,FremontBridge,01/25/2013 10:00:00 AM,48,-122,20,34,54
2747,FremontBridge,01/25/2013 11:00:00 AM,48,-122,16,21,37
2748,FremontBridge,01/25/2013 12:00:00 PM,48,-122,20,34,54
2749,FremontBridge,01/25/2013 01:00:00 PM,48,-122,30,23,53
2750,FremontBridge,01/25/2013 02:00:00 PM,48,-122,36,26,62
2751,FremontBridge,01/25/2013 03:00:00 PM,48,-122,64,48,112
2752,FremontBridge,01/25/2013 04:00:00 PM,48,-122,114,80,194
2753,FremontBridge,01/25/2013 05:00:00 PM,48,-122,192,95,287
2754,FremontBridge,01/25/2013 06:00:00 PM,48,-122,109,53,162
2755,FremontBridge,01/25/2013 07:00:00 PM,48,-122,45,22,67
2756,FremontBridge,01/25/2013 08:00:00 PM,48,-122,34,20,54
2757,FremontBridge,01/25/2013 09:00:00 PM,48,-122,12,15,27
2758,FremontBridge,01/25/2013 10:00:00 PM,48,-122,14,8,22
2759,FremontBridge,01/25/2013 11:00:00 PM,48,-122,6,18,24
2760,FremontBridge,01/26/2013 12:00:00 AM,48,-122,9,9,18
2761,FremontBridge,01/26/2013 01:00:00 AM,48,-122,2,5,7
2762,FremontBridge,01/26/2013 02:00:00 AM,48,-122,7,1,8
2763,FremontBridge,01/26/2013 03:00:00 AM,48,-122,0,4,4
2764,FremontBridge,01/26/2013 04:00:00 AM,48,-122,2,0,2
2765,FremontBridge,01/26/2013 05:00:00 AM,48,-122,2,5,7
2766,FremontBridge,01/26/2013 06:00:00 AM,48,-122,8,5,13
2767,FremontBridge,01/26/2013 07:00:00 AM,48,-122,1,10,11
2768,FremontBridge,01/26/2013 08:00:00 AM,48,-122,7,12,19
2769,FremontBridge,01/26/2013 09:00:00 AM,48,-122,17,15,32
2770,FremontBridge,01/26/2013 10:00:00 AM,48,-122,18,17,35
2771,FremontBridge,01/26/2013 11:00:00 AM,48,-122,30,16,46
2772,FremontBridge,01/26/2013 12:00:00 PM,48,-122,22,20,42
2773,FremontBridge,01/26/2013 01:00:00 PM,48,-122,15,31,46
2774,FremontBridge,01/26/2013 02:00:00 PM,48,-122,18,16,34
2775,FremontBridge,01/26/2013 03:00:00 PM,48,-122,22,23,45
2776,FremontBridge,01/26/2013 04:00:00 PM,48,-122,16,31,47
2777,FremontBridge,01/26/2013 05:00:00 PM,48,-122,13,17,30
2778,FremontBridge,01/26/2013 06:00:00 PM,48,-122,14,13,27
2779,FremontBridge,01/26/2013 07:00:00 PM,48,-122,10,5,15
2780,FremontBridge,01/26/2013 08:00:00 PM,48,-122,6,11,17
2781,FremontBridge,01/26/2013 09:00:00 PM,48,-122,10,6,16
2782,FremontBridge,01/26/2013 10:00:00 PM,48,-122,4,5,9
2783,FremontBridge,01/26/2013 11:00:00 PM,48,-122,5,9,14
2784,FremontBridge,01/27/2013 12:00:00 AM,48,-122,7,3,10
2785,FremontBridge,01/27/2013 01:00:00 AM,48,-122,2,10,12
2786,FremontBridge,01/27/2013 02:00:00 AM,48,-122,1,1,2
2787,FremontBridge,01/27/2013 03:00:00 AM,48,-122,1,0,1
2788,FremontBridge,01/27/2013 04:00:00 AM,48,-122,0,1,1
2789,FremontBridge,01/27/2013 05:00:00 AM,48,-122,1,1,2
2790,FremontBridge,01/27/2013 06:00:00 AM,48,-122,9,3,12
2791,FremontBridge,01/27/2013 07:00:00 AM,48,-122,7,10,17
2792,FremontBridge,01/27/2013 08:00:00 AM,48,-122,10,17,27
2793,FremontBridge,01/27/2013 09:00:00 AM,48,-122,21,27,48
2794,FremontBridge,01/27/2013 10:00:00 AM,48,-122,33,33,66
2795,FremontBridge,01/27/2013 11:00:00 AM,48,-122,20,49,69
2796,FremontBridge,01/27/2013 12:00:00 PM,48,-122,20,39,59
2797,FremontBridge,01/27/2013 01:00:00 PM,48,-122,23,20,43
2798,FremontBridge,01/27/2013 02:00:00 PM,48,-122,20,39,59
2799,FremontBridge,01/27/2013 03:00:00 PM,48,-122,24,26,50
2800,FremontBridge,01/27/2013 04:00:00 PM,48,-122,24,28,52
2801,FremontBridge,01/27/2013 05:00:00 PM,48,-122,12,14,26
2802,FremontBridge,01/27/2013 06:00:00 PM,48,-122,12,12,24
2803,FremontBridge,01/27/2013 07:00:00 PM,48,-122,14,4,18
2804,FremontBridge,01/27/2013 08:00:00 PM,48,-122,9,5,14
2805,FremontBridge,01/27/2013 09:00:00 PM,48,-122,5,7,12
2806,FremontBridge,01/27/2013 10:00:00 PM,48,-122,6,3,9
2807,FremontBridge,01/27/2013 11:00:00 PM,48,-122,4,6,10
2808,FremontBridge,01/28/2013 12:00:00 AM,48,-122,0,5,5
2809,FremontBridge,01/28/2013 01:00:00 AM,48,-122,0,2,2
2810,FremontBridge,01/28/2013 02:00:00 AM,48,-122,1,1,2
2811,FremontBridge,01/28/2013 03:00:00 AM,48,-122,1,0,1
2812,FremontBridge,01/28/2013 04:00:00 AM,48,-122,1,2,3
2813,FremontBridge,01/28/2013 05:00:00 AM,48,-122,3,17,20
2814,FremontBridge,01/28/2013 06:00:00 AM,48,-122,26,71,97
2815,FremontBridge,01/28/2013 07:00:00 AM,48,-122,41,136,177
2816,FremontBridge,01/28/2013 08:00:00 AM,48,-122,87,181,268
2817,FremontBridge,01/28/2013 09:00:00 AM,48,-122,53,84,137
2818,FremontBridge,01/28/2013 10:00:00 AM,48,-122,18,26,44
2819,FremontBridge,01/28/2013 11:00:00 AM,48,-122,19,25,44
2820,FremontBridge,01/28/2013 12:00:00 PM,48,-122,19,19,38
2821,FremontBridge,01/28/2013 01:00:00 PM,48,-122,20,14,34
2822,FremontBridge,01/28/2013 02:00:00 PM,48,-122,18,13,31
2823,FremontBridge,01/28/2013 03:00:00 PM,48,-122,33,22,55
2824,FremontBridge,01/28/2013 04:00:00 PM,48,-122,89,62,151
2825,FremontBridge,01/28/2013 05:00:00 PM,48,-122,192,80,272
2826,FremontBridge,01/28/2013 06:00:00 PM,48,-122,124,61,185
2827,FremontBridge,01/28/2013 07:00:00 PM,48,-122,42,28,70
2828,FremontBridge,01/28/2013 08:00:00 PM,48,-122,25,10,35
2829,FremontBridge,01/28/2013 09:00:00 PM,48,-122,12,5,17
2830,FremontBridge,01/28/2013 10:00:00 PM,48,-122,6,9,15
2831,FremontBridge,01/28/2013 11:00:00 PM,48,-122,1,4,5
2832,FremontBridge,01/29/2013 12:00:00 AM,48,-122,1,5,6
2833,FremontBridge,01/29/2013 01:00:00 AM,48,-122,1,1,2
2834,FremontBridge,01/29/2013 02:00:00 AM,48,-122,0,2,2
2835,FremontBridge,01/29/2013 03:00:00 AM,48,-122,2,2,4
2836,FremontBridge,01/29/2013 04:00:00 AM,48,-122,2,6,8
2837,FremontBridge,01/29/2013 05:00:00 AM,48,-122,5,16,21
2838,FremontBridge,01/29/2013 06:00:00 AM,48,-122,21,62,83
2839,FremontBridge,01/29/2013 07:00:00 AM,48,-122,59,130,189
2840,FremontBridge,01/29/2013 08:00:00 AM,48,-122,76,175,251
2841,FremontBridge,01/29/2013 09:00:00 AM,48,-122,53,89,142
2842,FremontBridge,01/29/2013 10:00:00 AM,48,-122,9,39,48
2843,FremontBridge,01/29/2013 11:00:00 AM,48,-122,13,33,46
2844,FremontBridge,01/29/2013 12:00:00 PM,48,-122,24,28,52
2845,FremontBridge,01/29/2013 01:00:00 PM,48,-122,17,24,41
2846,FremontBridge,01/29/2013 02:00:00 PM,48,-122,21,22,43
2847,FremontBridge,01/29/2013 03:00:00 PM,48,-122,35,24,59
2848,FremontBridge,01/29/2013 04:00:00 PM,48,-122,87,46,133
2849,FremontBridge,01/29/2013 05:00:00 PM,48,-122,198,88,286
2850,FremontBridge,01/29/2013 06:00:00 PM,48,-122,138,53,191
2851,FremontBridge,01/29/2013 07:00:00 PM,48,-122,61,27,88
2852,FremontBridge,01/29/2013 08:00:00 PM,48,-122,23,17,40
2853,FremontBridge,01/29/2013 09:00:00 PM,48,-122,17,9,26
2854,FremontBridge,01/29/2013 10:00:00 PM,48,-122,10,8,18
2855,FremontBridge,01/29/2013 11:00:00 PM,48,-122,6,4,10
2856,FremontBridge,01/30/2013 12:00:00 AM,48,-122,1,3,4
2857,FremontBridge,01/30/2013 01:00:00 AM,48,-122,0,0,0
2858,FremontBridge,01/30/2013 02:00:00 AM,48,-122,0,4,4
2859,FremontBridge,01/30/2013 03:00:00 AM,48,-122,0,2,2
2860,FremontBridge,01/30/2013 04:00:00 AM,48,-122,3,8,11
2861,FremontBridge,01/30/2013 05:00:00 AM,48,-122,7,15,22
2862,FremontBridge,01/30/2013 06:00:00 AM,48,-122,30,42,72
2863,FremontBridge,01/30/2013 07:00:00 AM,48,-122,54,120,174
2864,FremontBridge,01/30/2013 08:00:00 AM,48,-122,73,186,259
2865,FremontBridge,01/30/2013 09:00:00 AM,48,-122,52,83,135
2866,FremontBridge,01/30/2013 10:00:00 AM,48,-122,18,38,56
2867,FremontBridge,01/30/2013 11:00:00 AM,48,-122,13,22,35
2868,FremontBridge,01/30/2013 12:00:00 PM,48,-122,23,20,43
2869,FremontBridge,01/30/2013 01:00:00 PM,48,-122,11,20,31
2870,FremontBridge,01/30/2013 02:00:00 PM,48,-122,26,24,50
2871,FremontBridge,01/30/2013 03:00:00 PM,48,-122,26,30,56
2872,FremontBridge,01/30/2013 04:00:00 PM,48,-122,74,53,127
2873,FremontBridge,01/30/2013 05:00:00 PM,48,-122,202,84,286
2874,FremontBridge,01/30/2013 06:00:00 PM,48,-122,143,49,192
2875,FremontBridge,01/30/2013 07:00:00 PM,48,-122,62,25,87
2876,FremontBridge,01/30/2013 08:00:00 PM,48,-122,30,23,53
2877,FremontBridge,01/30/2013 09:00:00 PM,48,-122,22,7,29
2878,FremontBridge,01/30/2013 10:00:00 PM,48,-122,8,9,17
2879,FremontBridge,01/30/2013 11:00:00 PM,48,-122,9,6,15
2880,FremontBridge,01/31/2013 12:00:00 AM,48,-122,1,4,5
2881,FremontBridge,01/31/2013 01:00:00 AM,48,-122,1,2,3
2882,FremontBridge,01/31/2013 02:00:00 AM,48,-122,0,2,2
2883,FremontBridge,01/31/2013 03:00:00 AM,48,-122,0,1,1
2884,FremontBridge,01/31/2013 04:00:00 AM,48,-122,1,6,7
2885,FremontBridge,01/31/2013 05:00:00 AM,48,-122,11,14,25
2886,FremontBridge,01/31/2013 06:00:00 AM,48,-122,26,59,85
2887,FremontBridge,01/31/2013 07:00:00 AM,48,-122,49,128,177
2888,FremontBridge,01/31/2013 08:00:00 AM,48,-122,87,184,271
2889,FremontBridge,01/31/2013 09:00:00 AM,48,-122,56,104,160
2890,FremontBridge,01/31/2013 10:00:00 AM,48,-122,12,27,39
2891,FremontBridge,01/31/2013 11:00:00 AM,48,-122,17,28,45
2892,FremontBridge,01/31/2013 12:00:00 PM,48,-122,15,32,47
2893,FremontBridge,01/31/2013 01:00:00 PM,48,-122,24,30,54
2894,FremontBridge,01/31/2013 02:00:00 PM,48,-122,29,32,61
2895,FremontBridge,01/31/2013 03:00:00 PM,48,-122,29,32,61
2896,FremontBridge,01/31/2013 04:00:00 PM,48,-122,92,49,141
2897,FremontBridge,01/31/2013 05:00:00 PM,48,-122,215,95,310
2898,FremontBridge,01/31/2013 06:00:00 PM,48,-122,110,67,177
2899,FremontBridge,01/31/2013 07:00:00 PM,48,-122,79,35,114
2900,FremontBridge,01/31/2013 08:00:00 PM,48,-122,52,15,67
2901,FremontBridge,01/31/2013 09:00:00 PM,48,-122,22,8,30
2902,FremontBridge,01/31/2013 10:00:00 PM,48,-122,12,12,24
2903,FremontBridge,01/31/2013 11:00:00 PM,48,-122,7,8,15
2904,FremontBridge,02/01/2013 12:00:00 AM,48,-122,8,4,12
2905,FremontBridge,02/01/2013 01:00:00 AM,48,-122,0,4,4
2906,FremontBridge,02/01/2013 02:00:00 AM,48,-122,0,3,3
2907,FremontBridge,02/01/2013 03:00:00 AM,48,-122,0,0,0
2908,FremontBridge,02/01/2013 04:00:00 AM,48,-122,2,4,6
2909,FremontBridge,02/01/2013 05:00:00 AM,48,-122,3,12,15
2910,FremontBridge,02/01/2013 06:00:00 AM,48,-122,21,53,74
2911,FremontBridge,02/01/2013 07:00:00 AM,48,-122,53,142,195
2912,FremontBridge,02/01/2013 08:00:00 AM,48,-122,72,189,261
2913,FremontBridge,02/01/2013 09:00:00 AM,48,-122,58,96,154
2914,FremontBridge,02/01/2013 10:00:00 AM,48,-122,34,58,92
2915,FremontBridge,02/01/2013 11:00:00 AM,48,-122,31,27,58
2916,FremontBridge,02/01/2013 12:00:00 PM,48,-122,35,36,71
2917,FremontBridge,02/01/2013 01:00:00 PM,48,-122,40,34,74
2918,FremontBridge,02/01/2013 02:00:00 PM,48,-122,43,53,96
2919,FremontBridge,02/01/2013 03:00:00 PM,48,-122,59,72,131
2920,FremontBridge,02/01/2013 04:00:00 PM,48,-122,109,73,182
2921,FremontBridge,02/01/2013 05:00:00 PM,48,-122,207,94,301
2922,FremontBridge,02/01/2013 06:00:00 PM,48,-122,118,72,190
2923,FremontBridge,02/01/2013 07:00:00 PM,48,-122,51,31,82
2924,FremontBridge,02/01/2013 08:00:00 PM,48,-122,31,12,43
2925,FremontBridge,02/01/2013 09:00:00 PM,48,-122,10,5,15
2926,FremontBridge,02/01/2013 10:00:00 PM,48,-122,20,7,27
2927,FremontBridge,02/01/2013 11:00:00 PM,48,-122,11,11,22
2928,FremontBridge,02/02/2013 12:00:00 AM,48,-122,9,7,16
2929,FremontBridge,02/02/2013 01:00:00 AM,48,-122,7,5,12
2930,FremontBridge,02/02/2013 02:00:00 AM,48,-122,4,3,7
2931,FremontBridge,02/02/2013 03:00:00 AM,48,-122,0,2,2
2932,FremontBridge,02/02/2013 04:00:00 AM,48,-122,1,0,1
2933,FremontBridge,02/02/2013 05:00:00 AM,48,-122,1,2,3
2934,FremontBridge,02/02/2013 06:00:00 AM,48,-122,8,7,15
2935,FremontBridge,02/02/2013 07:00:00 AM,48,-122,7,17,24
2936,FremontBridge,02/02/2013 08:00:00 AM,48,-122,28,28,56
2937,FremontBridge,02/02/2013 09:00:00 AM,48,-122,26,32,58
2938,FremontBridge,02/02/2013 10:00:00 AM,48,-122,18,40,58
2939,FremontBridge,02/02/2013 11:00:00 AM,48,-122,46,67,113
2940,FremontBridge,02/02/2013 12:00:00 PM,48,-122,40,69,109
2941,FremontBridge,02/02/2013 01:00:00 PM,48,-122,38,66,104
2942,FremontBridge,02/02/2013 02:00:00 PM,48,-122,59,63,122
2943,FremontBridge,02/02/2013 03:00:00 PM,48,-122,52,70,122
2944,FremontBridge,02/02/2013 04:00:00 PM,48,-122,44,75,119
2945,FremontBridge,02/02/2013 05:00:00 PM,48,-122,38,30,68
2946,FremontBridge,02/02/2013 06:00:00 PM,48,-122,19,21,40
2947,FremontBridge,02/02/2013 07:00:00 PM,48,-122,18,9,27
2948,FremontBridge,02/02/2013 08:00:00 PM,48,-122,6,15,21
2949,FremontBridge,02/02/2013 09:00:00 PM,48,-122,8,9,17
2950,FremontBridge,02/02/2013 10:00:00 PM,48,-122,5,4,9
2951,FremontBridge,02/02/2013 11:00:00 PM,48,-122,6,4,10
2952,FremontBridge,02/03/2013 12:00:00 AM,48,-122,11,3,14
2953,FremontBridge,02/03/2013 01:00:00 AM,48,-122,5,4,9
2954,FremontBridge,02/03/2013 02:00:00 AM,48,-122,4,3,7
2955,FremontBridge,02/03/2013 03:00:00 AM,48,-122,0,0,0
2956,FremontBridge,02/03/2013 04:00:00 AM,48,-122,1,2,3
2957,FremontBridge,02/03/2013 05:00:00 AM,48,-122,0,3,3
2958,FremontBridge,02/03/2013 06:00:00 AM,48,-122,6,7,13
2959,FremontBridge,02/03/2013 07:00:00 AM,48,-122,7,7,14
2960,FremontBridge,02/03/2013 08:00:00 AM,48,-122,12,16,28
2961,FremontBridge,02/03/2013 09:00:00 AM,48,-122,22,24,46
2962,FremontBridge,02/03/2013 10:00:00 AM,48,-122,30,62,92
2963,FremontBridge,02/03/2013 11:00:00 AM,48,-122,28,43,71
2964,FremontBridge,02/03/2013 12:00:00 PM,48,-122,42,48,90
2965,FremontBridge,02/03/2013 01:00:00 PM,48,-122,50,44,94
2966,FremontBridge,02/03/2013 02:00:00 PM,48,-122,42,43,85
2967,FremontBridge,02/03/2013 03:00:00 PM,48,-122,28,62,90
2968,FremontBridge,02/03/2013 04:00:00 PM,48,-122,32,21,53
2969,FremontBridge,02/03/2013 05:00:00 PM,48,-122,18,25,43
2970,FremontBridge,02/03/2013 06:00:00 PM,48,-122,13,12,25
2971,FremontBridge,02/03/2013 07:00:00 PM,48,-122,9,9,18
2972,FremontBridge,02/03/2013 08:00:00 PM,48,-122,9,17,26
2973,FremontBridge,02/03/2013 09:00:00 PM,48,-122,10,11,21
2974,FremontBridge,02/03/2013 10:00:00 PM,48,-122,6,7,13
2975,FremontBridge,02/03/2013 11:00:00 PM,48,-122,6,4,10
2976,FremontBridge,02/04/2013 12:00:00 AM,48,-122,2,2,4
2977,FremontBridge,02/04/2013 01:00:00 AM,48,-122,2,2,4
2978,FremontBridge,02/04/2013 02:00:00 AM,48,-122,1,2,3
2979,FremontBridge,02/04/2013 03:00:00 AM,48,-122,0,1,1
2980,FremontBridge,02/04/2013 04:00:00 AM,48,-122,2,4,6
2981,FremontBridge,02/04/2013 05:00:00 AM,48,-122,5,19,24
2982,FremontBridge,02/04/2013 06:00:00 AM,48,-122,32,82,114
2983,FremontBridge,02/04/2013 07:00:00 AM,48,-122,58,152,210
2984,FremontBridge,02/04/2013 08:00:00 AM,48,-122,102,214,316
2985,FremontBridge,02/04/2013 09:00:00 AM,48,-122,74,123,197
2986,FremontBridge,02/04/2013 10:00:00 AM,48,-122,31,36,67
2987,FremontBridge,02/04/2013 11:00:00 AM,48,-122,25,26,51
2988,FremontBridge,02/04/2013 12:00:00 PM,48,-122,31,29,60
2989,FremontBridge,02/04/2013 01:00:00 PM,48,-122,20,26,46
2990,FremontBridge,02/04/2013 02:00:00 PM,48,-122,30,39,69
2991,FremontBridge,02/04/2013 03:00:00 PM,48,-122,43,56,99
2992,FremontBridge,02/04/2013 04:00:00 PM,48,-122,96,74,170
2993,FremontBridge,02/04/2013 05:00:00 PM,48,-122,255,123,378
2994,FremontBridge,02/04/2013 06:00:00 PM,48,-122,169,83,252
2995,FremontBridge,02/04/2013 07:00:00 PM,48,-122,65,42,107
2996,FremontBridge,02/04/2013 08:00:00 PM,48,-122,30,13,43
2997,FremontBridge,02/04/2013 09:00:00 PM,48,-122,23,16,39
2998,FremontBridge,02/04/2013 10:00:00 PM,48,-122,10,7,17
2999,FremontBridge,02/04/2013 11:00:00 PM,48,-122,8,3,11
3000,FremontBridge,02/05/2013 12:00:00 AM,48,-122,5,3,8
3001,FremontBridge,02/05/2013 01:00:00 AM,48,-122,3,1,4
3002,FremontBridge,02/05/2013 02:00:00 AM,48,-122,1,2,3
3003,FremontBridge,02/05/2013 03:00:00 AM,48,-122,1,2,3
3004,FremontBridge,02/05/2013 04:00:00 AM,48,-122,2,4,6
3005,FremontBridge,02/05/2013 05:00:00 AM,48,-122,6,13,19
3006,FremontBridge,02/05/2013 06:00:00 AM,48,-122,30,57,87
3007,FremontBridge,02/05/2013 07:00:00 AM,48,-122,44,148,192
3008,FremontBridge,02/05/2013 08:00:00 AM,48,-122,88,217,305
3009,FremontBridge,02/05/2013 09:00:00 AM,48,-122,63,108,171
3010,FremontBridge,02/05/2013 10:00:00 AM,48,-122,23,39,62
3011,FremontBridge,02/05/2013 11:00:00 AM,48,-122,19,36,55
3012,FremontBridge,02/05/2013 12:00:00 PM,48,-122,19,28,47
3013,FremontBridge,02/05/2013 01:00:00 PM,48,-122,30,26,56
3014,FremontBridge,02/05/2013 02:00:00 PM,48,-122,30,40,70
3015,FremontBridge,02/05/2013 03:00:00 PM,48,-122,31,28,59
3016,FremontBridge,02/05/2013 04:00:00 PM,48,-122,78,48,126
3017,FremontBridge,02/05/2013 05:00:00 PM,48,-122,224,82,306
3018,FremontBridge,02/05/2013 06:00:00 PM,48,-122,160,67,227
3019,FremontBridge,02/05/2013 07:00:00 PM,48,-122,53,33,86
3020,FremontBridge,02/05/2013 08:00:00 PM,48,-122,32,18,50
3021,FremontBridge,02/05/2013 09:00:00 PM,48,-122,16,15,31
3022,FremontBridge,02/05/2013 10:00:00 PM,48,-122,15,8,23
3023,FremontBridge,02/05/2013 11:00:00 PM,48,-122,9,7,16
3024,FremontBridge,02/06/2013 12:00:00 AM,48,-122,3,4,7
3025,FremontBridge,02/06/2013 01:00:00 AM,48,-122,4,0,4
3026,FremontBridge,02/06/2013 02:00:00 AM,48,-122,0,2,2
3027,FremontBridge,02/06/2013 03:00:00 AM,48,-122,0,1,1
3028,FremontBridge,02/06/2013 04:00:00 AM,48,-122,2,5,7
3029,FremontBridge,02/06/2013 05:00:00 AM,48,-122,7,19,26
3030,FremontBridge,02/06/2013 06:00:00 AM,48,-122,24,67,91
3031,FremontBridge,02/06/2013 07:00:00 AM,48,-122,67,125,192
3032,FremontBridge,02/06/2013 08:00:00 AM,48,-122,93,192,285
3033,FremontBridge,02/06/2013 09:00:00 AM,48,-122,55,100,155
3034,FremontBridge,02/06/2013 10:00:00 AM,48,-122,21,33,54
3035,FremontBridge,02/06/2013 11:00:00 AM,48,-122,31,34,65
3036,FremontBridge,02/06/2013 12:00:00 PM,48,-122,31,31,62
3037,FremontBridge,02/06/2013 01:00:00 PM,48,-122,19,29,48
3038,FremontBridge,02/06/2013 02:00:00 PM,48,-122,25,43,68
3039,FremontBridge,02/06/2013 03:00:00 PM,48,-122,43,32,75
3040,FremontBridge,02/06/2013 04:00:00 PM,48,-122,99,56,155
3041,FremontBridge,02/06/2013 05:00:00 PM,48,-122,202,91,293
3042,FremontBridge,02/06/2013 06:00:00 PM,48,-122,122,74,196
3043,FremontBridge,02/06/2013 07:00:00 PM,48,-122,51,36,87
3044,FremontBridge,02/06/2013 08:00:00 PM,48,-122,42,17,59
3045,FremontBridge,02/06/2013 09:00:00 PM,48,-122,18,12,30
3046,FremontBridge,02/06/2013 10:00:00 PM,48,-122,11,9,20
3047,FremontBridge,02/06/2013 11:00:00 PM,48,-122,9,4,13
3048,FremontBridge,02/07/2013 12:00:00 AM,48,-122,4,2,6
3049,FremontBridge,02/07/2013 01:00:00 AM,48,-122,1,5,6
3050,FremontBridge,02/07/2013 02:00:00 AM,48,-122,0,2,2
3051,FremontBridge,02/07/2013 03:00:00 AM,48,-122,0,0,0
3052,FremontBridge,02/07/2013 04:00:00 AM,48,-122,2,4,6
3053,FremontBridge,02/07/2013 05:00:00 AM,48,-122,5,12,17
3054,FremontBridge,02/07/2013 06:00:00 AM,48,-122,21,47,68
3055,FremontBridge,02/07/2013 07:00:00 AM,48,-122,52,144,196
3056,FremontBridge,02/07/2013 08:00:00 AM,48,-122,92,186,278
3057,FremontBridge,02/07/2013 09:00:00 AM,48,-122,60,100,160
3058,FremontBridge,02/07/2013 10:00:00 AM,48,-122,26,33,59
3059,FremontBridge,02/07/2013 11:00:00 AM,48,-122,26,38,64
3060,FremontBridge,02/07/2013 12:00:00 PM,48,-122,23,37,60
3061,FremontBridge,02/07/2013 01:00:00 PM,48,-122,30,39,69
3062,FremontBridge,02/07/2013 02:00:00 PM,48,-122,56,48,104
3063,FremontBridge,02/07/2013 03:00:00 PM,48,-122,55,49,104
3064,FremontBridge,02/07/2013 04:00:00 PM,48,-122,96,83,179
3065,FremontBridge,02/07/2013 05:00:00 PM,48,-122,204,120,324
3066,FremontBridge,02/07/2013 06:00:00 PM,48,-122,144,79,223
3067,FremontBridge,02/07/2013 07:00:00 PM,48,-122,67,29,96
3068,FremontBridge,02/07/2013 08:00:00 PM,48,-122,40,22,62
3069,FremontBridge,02/07/2013 09:00:00 PM,48,-122,41,14,55
3070,FremontBridge,02/07/2013 10:00:00 PM,48,-122,17,15,32
3071,FremontBridge,02/07/2013 11:00:00 PM,48,-122,10,7,17
3072,FremontBridge,02/08/2013 12:00:00 AM,48,-122,9,4,13
3073,FremontBridge,02/08/2013 01:00:00 AM,48,-122,3,3,6
3074,FremontBridge,02/08/2013 02:00:00 AM,48,-122,1,2,3
3075,FremontBridge,02/08/2013 03:00:00 AM,48,-122,0,0,0
3076,FremontBridge,02/08/2013 04:00:00 AM,48,-122,4,0,4
3077,FremontBridge,02/08/2013 05:00:00 AM,48,-122,6,6,12
3078,FremontBridge,02/08/2013 06:00:00 AM,48,-122,30,63,93
3079,FremontBridge,02/08/2013 07:00:00 AM,48,-122,60,145,205
3080,FremontBridge,02/08/2013 08:00:00 AM,48,-122,80,215,295
3081,FremontBridge,02/08/2013 09:00:00 AM,48,-122,67,107,174
3082,FremontBridge,02/08/2013 10:00:00 AM,48,-122,19,49,68
3083,FremontBridge,02/08/2013 11:00:00 AM,48,-122,26,36,62
3084,FremontBridge,02/08/2013 12:00:00 PM,48,-122,30,38,68
3085,FremontBridge,02/08/2013 01:00:00 PM,48,-122,51,39,90
3086,FremontBridge,02/08/2013 02:00:00 PM,48,-122,41,46,87
3087,FremontBridge,02/08/2013 03:00:00 PM,48,-122,51,44,95
3088,FremontBridge,02/08/2013 04:00:00 PM,48,-122,117,79,196
3089,FremontBridge,02/08/2013 05:00:00 PM,48,-122,218,105,323
3090,FremontBridge,02/08/2013 06:00:00 PM,48,-122,128,59,187
3091,FremontBridge,02/08/2013 07:00:00 PM,48,-122,43,24,67
3092,FremontBridge,02/08/2013 08:00:00 PM,48,-122,19,19,38
3093,FremontBridge,02/08/2013 09:00:00 PM,48,-122,20,13,33
3094,FremontBridge,02/08/2013 10:00:00 PM,48,-122,8,12,20
3095,FremontBridge,02/08/2013 11:00:00 PM,48,-122,11,11,22
3096,FremontBridge,02/09/2013 12:00:00 AM,48,-122,10,7,17
3097,FremontBridge,02/09/2013 01:00:00 AM,48,-122,6,3,9
3098,FremontBridge,02/09/2013 02:00:00 AM,48,-122,4,2,6
3099,FremontBridge,02/09/2013 03:00:00 AM,48,-122,0,1,1
3100,FremontBridge,02/09/2013 04:00:00 AM,48,-122,3,0,3
3101,FremontBridge,02/09/2013 05:00:00 AM,48,-122,1,3,4
3102,FremontBridge,02/09/2013 06:00:00 AM,48,-122,10,6,16
3103,FremontBridge,02/09/2013 07:00:00 AM,48,-122,8,16,24
3104,FremontBridge,02/09/2013 08:00:00 AM,48,-122,30,26,56
3105,FremontBridge,02/09/2013 09:00:00 AM,48,-122,27,38,65
3106,FremontBridge,02/09/2013 10:00:00 AM,48,-122,26,61,87
3107,FremontBridge,02/09/2013 11:00:00 AM,48,-122,33,63,96
3108,FremontBridge,02/09/2013 12:00:00 PM,48,-122,43,61,104
3109,FremontBridge,02/09/2013 01:00:00 PM,48,-122,47,66,113
3110,FremontBridge,02/09/2013 02:00:00 PM,48,-122,62,73,135
3111,FremontBridge,02/09/2013 03:00:00 PM,48,-122,45,61,106
3112,FremontBridge,02/09/2013 04:00:00 PM,48,-122,37,39,76
3113,FremontBridge,02/09/2013 05:00:00 PM,48,-122,32,37,69
3114,FremontBridge,02/09/2013 06:00:00 PM,48,-122,17,12,29
3115,FremontBridge,02/09/2013 07:00:00 PM,48,-122,18,14,32
3116,FremontBridge,02/09/2013 08:00:00 PM,48,-122,9,15,24
3117,FremontBridge,02/09/2013 09:00:00 PM,48,-122,5,8,13
3118,FremontBridge,02/09/2013 10:00:00 PM,48,-122,8,10,18
3119,FremontBridge,02/09/2013 11:00:00 PM,48,-122,6,5,11
3120,FremontBridge,02/10/2013 12:00:00 AM,48,-122,6,7,13
3121,FremontBridge,02/10/2013 01:00:00 AM,48,-122,0,2,2
3122,FremontBridge,02/10/2013 02:00:00 AM,48,-122,1,2,3
3123,FremontBridge,02/10/2013 03:00:00 AM,48,-122,1,3,4
3124,FremontBridge,02/10/2013 04:00:00 AM,48,-122,2,2,4
3125,FremontBridge,02/10/2013 05:00:00 AM,48,-122,0,3,3
3126,FremontBridge,02/10/2013 06:00:00 AM,48,-122,5,5,10
3127,FremontBridge,02/10/2013 07:00:00 AM,48,-122,12,6,18
3128,FremontBridge,02/10/2013 08:00:00 AM,48,-122,17,27,44
3129,FremontBridge,02/10/2013 09:00:00 AM,48,-122,26,48,74
3130,FremontBridge,02/10/2013 10:00:00 AM,48,-122,38,45,83
3131,FremontBridge,02/10/2013 11:00:00 AM,48,-122,47,55,102
3132,FremontBridge,02/10/2013 12:00:00 PM,48,-122,52,97,149
3133,FremontBridge,02/10/2013 01:00:00 PM,48,-122,76,88,164
3134,FremontBridge,02/10/2013 02:00:00 PM,48,-122,93,113,206
3135,FremontBridge,02/10/2013 03:00:00 PM,48,-122,67,80,147
3136,FremontBridge,02/10/2013 04:00:00 PM,48,-122,40,66,106
3137,FremontBridge,02/10/2013 05:00:00 PM,48,-122,35,31,66
3138,FremontBridge,02/10/2013 06:00:00 PM,48,-122,20,19,39
3139,FremontBridge,02/10/2013 07:00:00 PM,48,-122,8,13,21
3140,FremontBridge,02/10/2013 08:00:00 PM,48,-122,9,6,15
3141,FremontBridge,02/10/2013 09:00:00 PM,48,-122,9,7,16
3142,FremontBridge,02/10/2013 10:00:00 PM,48,-122,3,8,11
3143,FremontBridge,02/10/2013 11:00:00 PM,48,-122,10,2,12
3144,FremontBridge,02/11/2013 12:00:00 AM,48,-122,2,4,6
3145,FremontBridge,02/11/2013 01:00:00 AM,48,-122,2,1,3
3146,FremontBridge,02/11/2013 02:00:00 AM,48,-122,0,1,1
3147,FremontBridge,02/11/2013 03:00:00 AM,48,-122,0,0,0
3148,FremontBridge,02/11/2013 04:00:00 AM,48,-122,3,7,10
3149,FremontBridge,02/11/2013 05:00:00 AM,48,-122,3,14,17
3150,FremontBridge,02/11/2013 06:00:00 AM,48,-122,37,63,100
3151,FremontBridge,02/11/2013 07:00:00 AM,48,-122,73,164,237
3152,FremontBridge,02/11/2013 08:00:00 AM,48,-122,92,194,286
3153,FremontBridge,02/11/2013 09:00:00 AM,48,-122,47,102,149
3154,FremontBridge,02/11/2013 10:00:00 AM,48,-122,30,34,64
3155,FremontBridge,02/11/2013 11:00:00 AM,48,-122,18,20,38
3156,FremontBridge,02/11/2013 12:00:00 PM,48,-122,24,34,58
3157,FremontBridge,02/11/2013 01:00:00 PM,48,-122,26,16,42
3158,FremontBridge,02/11/2013 02:00:00 PM,48,-122,29,32,61
3159,FremontBridge,02/11/2013 03:00:00 PM,48,-122,47,44,91
3160,FremontBridge,02/11/2013 04:00:00 PM,48,-122,94,85,179
3161,FremontBridge,02/11/2013 05:00:00 PM,48,-122,241,93,334
3162,FremontBridge,02/11/2013 06:00:00 PM,48,-122,172,87,259
3163,FremontBridge,02/11/2013 07:00:00 PM,48,-122,54,33,87
3164,FremontBridge,02/11/2013 08:00:00 PM,48,-122,31,23,54
3165,FremontBridge,02/11/2013 09:00:00 PM,48,-122,25,12,37
3166,FremontBridge,02/11/2013 10:00:00 PM,48,-122,13,9,22
3167,FremontBridge,02/11/2013 11:00:00 PM,48,-122,6,4,10
3168,FremontBridge,02/12/2013 12:00:00 AM,48,-122,3,5,8
3169,FremontBridge,02/12/2013 01:00:00 AM,48,-122,0,4,4
3170,FremontBridge,02/12/2013 02:00:00 AM,48,-122,0,0,0
3171,FremontBridge,02/12/2013 03:00:00 AM,48,-122,1,2,3
3172,FremontBridge,02/12/2013 04:00:00 AM,48,-122,3,5,8
3173,FremontBridge,02/12/2013 05:00:00 AM,48,-122,5,17,22
3174,FremontBridge,02/12/2013 06:00:00 AM,48,-122,28,69,97
3175,FremontBridge,02/12/2013 07:00:00 AM,48,-122,57,163,220
3176,FremontBridge,02/12/2013 08:00:00 AM,48,-122,102,221,323
3177,FremontBridge,02/12/2013 09:00:00 AM,48,-122,57,105,162
3178,FremontBridge,02/12/2013 10:00:00 AM,48,-122,30,26,56
3179,FremontBridge,02/12/2013 11:00:00 AM,48,-122,23,20,43
3180,FremontBridge,02/12/2013 12:00:00 PM,48,-122,17,17,34
3181,FremontBridge,02/12/2013 01:00:00 PM,48,-122,25,20,45
3182,FremontBridge,02/12/2013 02:00:00 PM,48,-122,28,26,54
3183,FremontBridge,02/12/2013 03:00:00 PM,48,-122,38,29,67
3184,FremontBridge,02/12/2013 04:00:00 PM,48,-122,92,61,153
3185,FremontBridge,02/12/2013 05:00:00 PM,48,-122,237,99,336
3186,FremontBridge,02/12/2013 06:00:00 PM,48,-122,146,83,229
3187,FremontBridge,02/12/2013 07:00:00 PM,48,-122,64,50,114
3188,FremontBridge,02/12/2013 08:00:00 PM,48,-122,28,26,54
3189,FremontBridge,02/12/2013 09:00:00 PM,48,-122,16,13,29
3190,FremontBridge,02/12/2013 10:00:00 PM,48,-122,16,9,25
3191,FremontBridge,02/12/2013 11:00:00 PM,48,-122,7,12,19
3192,FremontBridge,02/13/2013 12:00:00 AM,48,-122,4,3,7
3193,FremontBridge,02/13/2013 01:00:00 AM,48,-122,1,2,3
3194,FremontBridge,02/13/2013 02:00:00 AM,48,-122,1,0,1
3195,FremontBridge,02/13/2013 03:00:00 AM,48,-122,0,1,1
3196,FremontBridge,02/13/2013 04:00:00 AM,48,-122,2,9,11
3197,FremontBridge,02/13/2013 05:00:00 AM,48,-122,6,12,18
3198,FremontBridge,02/13/2013 06:00:00 AM,48,-122,22,61,83
3199,FremontBridge,02/13/2013 07:00:00 AM,48,-122,56,148,204
3200,FremontBridge,02/13/2013 08:00:00 AM,48,-122,94,198,292
3201,FremontBridge,02/13/2013 09:00:00 AM,48,-122,57,95,152
3202,FremontBridge,02/13/2013 10:00:00 AM,48,-122,28,31,59
3203,FremontBridge,02/13/2013 11:00:00 AM,48,-122,21,34,55
3204,FremontBridge,02/13/2013 12:00:00 PM,48,-122,16,35,51
3205,FremontBridge,02/13/2013 01:00:00 PM,48,-122,19,21,40
3206,FremontBridge,02/13/2013 02:00:00 PM,48,-122,24,25,49
3207,FremontBridge,02/13/2013 03:00:00 PM,48,-122,44,42,86
3208,FremontBridge,02/13/2013 04:00:00 PM,48,-122,95,71,166
3209,FremontBridge,02/13/2013 05:00:00 PM,48,-122,230,104,334
3210,FremontBridge,02/13/2013 06:00:00 PM,48,-122,140,69,209
3211,FremontBridge,02/13/2013 07:00:00 PM,48,-122,55,36,91
3212,FremontBridge,02/13/2013 08:00:00 PM,48,-122,47,21,68
3213,FremontBridge,02/13/2013 09:00:00 PM,48,-122,26,16,42
3214,FremontBridge,02/13/2013 10:00:00 PM,48,-122,14,10,24
3215,FremontBridge,02/13/2013 11:00:00 PM,48,-122,14,6,20
3216,FremontBridge,02/14/2013 12:00:00 AM,48,-122,4,1,5
3217,FremontBridge,02/14/2013 01:00:00 AM,48,-122,0,4,4
3218,FremontBridge,02/14/2013 02:00:00 AM,48,-122,0,2,2
3219,FremontBridge,02/14/2013 03:00:00 AM,48,-122,0,0,0
3220,FremontBridge,02/14/2013 04:00:00 AM,48,-122,1,5,6
3221,FremontBridge,02/14/2013 05:00:00 AM,48,-122,7,11,18
3222,FremontBridge,02/14/2013 06:00:00 AM,48,-122,35,58,93
3223,FremontBridge,02/14/2013 07:00:00 AM,48,-122,47,113,160
3224,FremontBridge,02/14/2013 08:00:00 AM,48,-122,79,176,255
3225,FremontBridge,02/14/2013 09:00:00 AM,48,-122,56,79,135
3226,FremontBridge,02/14/2013 10:00:00 AM,48,-122,20,26,46
3227,FremontBridge,02/14/2013 11:00:00 AM,48,-122,22,23,45
3228,FremontBridge,02/14/2013 12:00:00 PM,48,-122,24,30,54
3229,FremontBridge,02/14/2013 01:00:00 PM,48,-122,16,32,48
3230,FremontBridge,02/14/2013 02:00:00 PM,48,-122,33,31,64
3231,FremontBridge,02/14/2013 03:00:00 PM,48,-122,33,56,89
3232,FremontBridge,02/14/2013 04:00:00 PM,48,-122,83,59,142
3233,FremontBridge,02/14/2013 05:00:00 PM,48,-122,187,97,284
3234,FremontBridge,02/14/2013 06:00:00 PM,48,-122,136,74,210
3235,FremontBridge,02/14/2013 07:00:00 PM,48,-122,56,27,83
3236,FremontBridge,02/14/2013 08:00:00 PM,48,-122,32,21,53
3237,FremontBridge,02/14/2013 09:00:00 PM,48,-122,12,12,24
3238,FremontBridge,02/14/2013 10:00:00 PM,48,-122,11,18,29
3239,FremontBridge,02/14/2013 11:00:00 PM,48,-122,10,25,35
3240,FremontBridge,02/15/2013 12:00:00 AM,48,-122,6,5,11
3241,FremontBridge,02/15/2013 01:00:00 AM,48,-122,3,7,10
3242,FremontBridge,02/15/2013 02:00:00 AM,48,-122,0,2,2
3243,FremontBridge,02/15/2013 03:00:00 AM,48,-122,2,2,4
3244,FremontBridge,02/15/2013 04:00:00 AM,48,-122,2,3,5
3245,FremontBridge,02/15/2013 05:00:00 AM,48,-122,3,8,11
3246,FremontBridge,02/15/2013 06:00:00 AM,48,-122,26,53,79
3247,FremontBridge,02/15/2013 07:00:00 AM,48,-122,52,118,170
3248,FremontBridge,02/15/2013 08:00:00 AM,48,-122,78,177,255
3249,FremontBridge,02/15/2013 09:00:00 AM,48,-122,59,103,162
3250,FremontBridge,02/15/2013 10:00:00 AM,48,-122,28,56,84
3251,FremontBridge,02/15/2013 11:00:00 AM,48,-122,27,34,61
3252,FremontBridge,02/15/2013 12:00:00 PM,48,-122,41,45,86
3253,FremontBridge,02/15/2013 01:00:00 PM,48,-122,41,59,100
3254,FremontBridge,02/15/2013 02:00:00 PM,48,-122,57,76,133
3255,FremontBridge,02/15/2013 03:00:00 PM,48,-122,75,90,165
3256,FremontBridge,02/15/2013 04:00:00 PM,48,-122,153,96,249
3257,FremontBridge,02/15/2013 05:00:00 PM,48,-122,207,118,325
3258,FremontBridge,02/15/2013 06:00:00 PM,48,-122,123,84,207
3259,FremontBridge,02/15/2013 07:00:00 PM,48,-122,54,17,71
3260,FremontBridge,02/15/2013 08:00:00 PM,48,-122,22,28,50
3261,FremontBridge,02/15/2013 09:00:00 PM,48,-122,20,9,29
3262,FremontBridge,02/15/2013 10:00:00 PM,48,-122,10,9,19
3263,FremontBridge,02/15/2013 11:00:00 PM,48,-122,9,7,16
3264,FremontBridge,02/16/2013 12:00:00 AM,48,-122,10,11,21
3265,FremontBridge,02/16/2013 01:00:00 AM,48,-122,4,0,4
3266,FremontBridge,02/16/2013 02:00:00 AM,48,-122,4,3,7
3267,FremontBridge,02/16/2013 03:00:00 AM,48,-122,3,6,9
3268,FremontBridge,02/16/2013 04:00:00 AM,48,-122,1,2,3
3269,FremontBridge,02/16/2013 05:00:00 AM,48,-122,2,4,6
3270,FremontBridge,02/16/2013 06:00:00 AM,48,-122,3,7,10
3271,FremontBridge,02/16/2013 07:00:00 AM,48,-122,10,18,28
3272,FremontBridge,02/16/2013 08:00:00 AM,48,-122,18,21,39
3273,FremontBridge,02/16/2013 09:00:00 AM,48,-122,21,39,60
3274,FremontBridge,02/16/2013 10:00:00 AM,48,-122,15,40,55
3275,FremontBridge,02/16/2013 11:00:00 AM,48,-122,25,40,65
3276,FremontBridge,02/16/2013 12:00:00 PM,48,-122,47,45,92
3277,FremontBridge,02/16/2013 01:00:00 PM,48,-122,65,55,120
3278,FremontBridge,02/16/2013 02:00:00 PM,48,-122,48,73,121
3279,FremontBridge,02/16/2013 03:00:00 PM,48,-122,44,73,117
3280,FremontBridge,02/16/2013 04:00:00 PM,48,-122,37,30,67
3281,FremontBridge,02/16/2013 05:00:00 PM,48,-122,25,34,59
3282,FremontBridge,02/16/2013 06:00:00 PM,48,-122,27,29,56
3283,FremontBridge,02/16/2013 07:00:00 PM,48,-122,8,11,19
3284,FremontBridge,02/16/2013 08:00:00 PM,48,-122,12,11,23
3285,FremontBridge,02/16/2013 09:00:00 PM,48,-122,8,11,19
3286,FremontBridge,02/16/2013 10:00:00 PM,48,-122,2,3,5
3287,FremontBridge,02/16/2013 11:00:00 PM,48,-122,5,7,12
3288,FremontBridge,02/17/2013 12:00:00 AM,48,-122,8,6,14
3289,FremontBridge,02/17/2013 01:00:00 AM,48,-122,2,3,5
3290,FremontBridge,02/17/2013 02:00:00 AM,48,-122,4,3,7
3291,FremontBridge,02/17/2013 03:00:00 AM,48,-122,7,3,10
3292,FremontBridge,02/17/2013 04:00:00 AM,48,-122,1,1,2
3293,FremontBridge,02/17/2013 05:00:00 AM,48,-122,1,2,3
3294,FremontBridge,02/17/2013 06:00:00 AM,48,-122,5,1,6
3295,FremontBridge,02/17/2013 07:00:00 AM,48,-122,7,13,20
3296,FremontBridge,02/17/2013 08:00:00 AM,48,-122,19,7,26
3297,FremontBridge,02/17/2013 09:00:00 AM,48,-122,24,31,55
3298,FremontBridge,02/17/2013 10:00:00 AM,48,-122,25,25,50
3299,FremontBridge,02/17/2013 11:00:00 AM,48,-122,20,30,50
3300,FremontBridge,02/17/2013 12:00:00 PM,48,-122,25,37,62
3301,FremontBridge,02/17/2013 01:00:00 PM,48,-122,37,46,83
3302,FremontBridge,02/17/2013 02:00:00 PM,48,-122,38,56,94
3303,FremontBridge,02/17/2013 03:00:00 PM,48,-122,38,60,98
3304,FremontBridge,02/17/2013 04:00:00 PM,48,-122,43,49,92
3305,FremontBridge,02/17/2013 05:00:00 PM,48,-122,39,29,68
3306,FremontBridge,02/17/2013 06:00:00 PM,48,-122,17,24,41
3307,FremontBridge,02/17/2013 07:00:00 PM,48,-122,13,15,28
3308,FremontBridge,02/17/2013 08:00:00 PM,48,-122,6,12,18
3309,FremontBridge,02/17/2013 09:00:00 PM,48,-122,6,7,13
3310,FremontBridge,02/17/2013 10:00:00 PM,48,-122,8,7,15
3311,FremontBridge,02/17/2013 11:00:00 PM,48,-122,5,4,9
3312,FremontBridge,02/18/2013 12:00:00 AM,48,-122,4,3,7
3313,FremontBridge,02/18/2013 01:00:00 AM,48,-122,2,1,3
3314,FremontBridge,02/18/2013 02:00:00 AM,48,-122,3,2,5
3315,FremontBridge,02/18/2013 03:00:00 AM,48,-122,1,2,3
3316,FremontBridge,02/18/2013 04:00:00 AM,48,-122,1,3,4
3317,FremontBridge,02/18/2013 05:00:00 AM,48,-122,3,8,11
3318,FremontBridge,02/18/2013 06:00:00 AM,48,-122,17,20,37
3319,FremontBridge,02/18/2013 07:00:00 AM,48,-122,27,68,95
3320,FremontBridge,02/18/2013 08:00:00 AM,48,-122,42,98,140
3321,FremontBridge,02/18/2013 09:00:00 AM,48,-122,52,59,111
3322,FremontBridge,02/18/2013 10:00:00 AM,48,-122,33,43,76
3323,FremontBridge,02/18/2013 11:00:00 AM,48,-122,30,42,72
3324,FremontBridge,02/18/2013 12:00:00 PM,48,-122,31,47,78
3325,FremontBridge,02/18/2013 01:00:00 PM,48,-122,43,40,83
3326,FremontBridge,02/18/2013 02:00:00 PM,48,-122,42,52,94
3327,FremontBridge,02/18/2013 03:00:00 PM,48,-122,61,50,111
3328,FremontBridge,02/18/2013 04:00:00 PM,48,-122,61,78,139
3329,FremontBridge,02/18/2013 05:00:00 PM,48,-122,119,50,169
3330,FremontBridge,02/18/2013 06:00:00 PM,48,-122,67,40,107
3331,FremontBridge,02/18/2013 07:00:00 PM,48,-122,44,23,67
3332,FremontBridge,02/18/2013 08:00:00 PM,48,-122,17,11,28
3333,FremontBridge,02/18/2013 09:00:00 PM,48,-122,6,6,12
3334,FremontBridge,02/18/2013 10:00:00 PM,48,-122,12,8,20
3335,FremontBridge,02/18/2013 11:00:00 PM,48,-122,5,4,9
3336,FremontBridge,02/19/2013 12:00:00 AM,48,-122,3,1,4
3337,FremontBridge,02/19/2013 01:00:00 AM,48,-122,3,0,3
3338,FremontBridge,02/19/2013 02:00:00 AM,48,-122,0,1,1
3339,FremontBridge,02/19/2013 03:00:00 AM,48,-122,2,0,2
3340,FremontBridge,02/19/2013 04:00:00 AM,48,-122,2,3,5
3341,FremontBridge,02/19/2013 05:00:00 AM,48,-122,7,14,21
3342,FremontBridge,02/19/2013 06:00:00 AM,48,-122,25,72,97
3343,FremontBridge,02/19/2013 07:00:00 AM,48,-122,66,168,234
3344,FremontBridge,02/19/2013 08:00:00 AM,48,-122,100,241,341
3345,FremontBridge,02/19/2013 09:00:00 AM,48,-122,70,127,197
3346,FremontBridge,02/19/2013 10:00:00 AM,48,-122,32,47,79
3347,FremontBridge,02/19/2013 11:00:00 AM,48,-122,30,28,58
3348,FremontBridge,02/19/2013 12:00:00 PM,48,-122,30,53,83
3349,FremontBridge,02/19/2013 01:00:00 PM,48,-122,39,50,89
3350,FremontBridge,02/19/2013 02:00:00 PM,48,-122,49,52,101
3351,FremontBridge,02/19/2013 03:00:00 PM,48,-122,56,50,106
3352,FremontBridge,02/19/2013 04:00:00 PM,48,-122,116,104,220
3353,FremontBridge,02/19/2013 05:00:00 PM,48,-122,275,124,399
3354,FremontBridge,02/19/2013 06:00:00 PM,48,-122,190,95,285
3355,FremontBridge,02/19/2013 07:00:00 PM,48,-122,76,44,120
3356,FremontBridge,02/19/2013 08:00:00 PM,48,-122,23,24,47
3357,FremontBridge,02/19/2013 09:00:00 PM,48,-122,24,17,41
3358,FremontBridge,02/19/2013 10:00:00 PM,48,-122,17,11,28
3359,FremontBridge,02/19/2013 11:00:00 PM,48,-122,18,7,25
3360,FremontBridge,02/20/2013 12:00:00 AM,48,-122,4,4,8
3361,FremontBridge,02/20/2013 01:00:00 AM,48,-122,1,0,1
3362,FremontBridge,02/20/2013 02:00:00 AM,48,-122,0,2,2
3363,FremontBridge,02/20/2013 03:00:00 AM,48,-122,1,0,1
3364,FremontBridge,02/20/2013 04:00:00 AM,48,-122,1,8,9
3365,FremontBridge,02/20/2013 05:00:00 AM,48,-122,3,21,24
3366,FremontBridge,02/20/2013 06:00:00 AM,48,-122,25,82,107
3367,FremontBridge,02/20/2013 07:00:00 AM,48,-122,61,159,220
3368,FremontBridge,02/20/2013 08:00:00 AM,48,-122,100,220,320
3369,FremontBridge,02/20/2013 09:00:00 AM,48,-122,57,130,187
3370,FremontBridge,02/20/2013 10:00:00 AM,48,-122,33,40,73
3371,FremontBridge,02/20/2013 11:00:00 AM,48,-122,20,36,56
3372,FremontBridge,02/20/2013 12:00:00 PM,48,-122,31,38,69
3373,FremontBridge,02/20/2013 01:00:00 PM,48,-122,32,28,60
3374,FremontBridge,02/20/2013 02:00:00 PM,48,-122,35,38,73
3375,FremontBridge,02/20/2013 03:00:00 PM,48,-122,46,31,77
3376,FremontBridge,02/20/2013 04:00:00 PM,48,-122,92,61,153
3377,FremontBridge,02/20/2013 05:00:00 PM,48,-122,229,101,330
3378,FremontBridge,02/20/2013 06:00:00 PM,48,-122,163,66,229
3379,FremontBridge,02/20/2013 07:00:00 PM,48,-122,52,25,77
3380,FremontBridge,02/20/2013 08:00:00 PM,48,-122,42,12,54
3381,FremontBridge,02/20/2013 09:00:00 PM,48,-122,24,20,44
3382,FremontBridge,02/20/2013 10:00:00 PM,48,-122,15,11,26
3383,FremontBridge,02/20/2013 11:00:00 PM,48,-122,8,9,17
3384,FremontBridge,02/21/2013 12:00:00 AM,48,-122,3,1,4
3385,FremontBridge,02/21/2013 01:00:00 AM,48,-122,0,0,0
3386,FremontBridge,02/21/2013 02:00:00 AM,48,-122,1,1,2
3387,FremontBridge,02/21/2013 03:00:00 AM,48,-122,0,1,1
3388,FremontBridge,02/21/2013 04:00:00 AM,48,-122,0,5,5
3389,FremontBridge,02/21/2013 05:00:00 AM,48,-122,7,12,19
3390,FremontBridge,02/21/2013 06:00:00 AM,48,-122,26,67,93
3391,FremontBridge,02/21/2013 07:00:00 AM,48,-122,52,119,171
3392,FremontBridge,02/21/2013 08:00:00 AM,48,-122,82,171,253
3393,FremontBridge,02/21/2013 09:00:00 AM,48,-122,53,92,145
3394,FremontBridge,02/21/2013 10:00:00 AM,48,-122,22,33,55
3395,FremontBridge,02/21/2013 11:00:00 AM,48,-122,24,24,48
3396,FremontBridge,02/21/2013 12:00:00 PM,48,-122,20,17,37
3397,FremontBridge,02/21/2013 01:00:00 PM,48,-122,19,25,44
3398,FremontBridge,02/21/2013 02:00:00 PM,48,-122,29,28,57
3399,FremontBridge,02/21/2013 03:00:00 PM,48,-122,41,32,73
3400,FremontBridge,02/21/2013 04:00:00 PM,48,-122,92,46,138
3401,FremontBridge,02/21/2013 05:00:00 PM,48,-122,208,102,310
3402,FremontBridge,02/21/2013 06:00:00 PM,48,-122,129,84,213
3403,FremontBridge,02/21/2013 07:00:00 PM,48,-122,58,35,93
3404,FremontBridge,02/21/2013 08:00:00 PM,48,-122,35,24,59
3405,FremontBridge,02/21/2013 09:00:00 PM,48,-122,16,8,24
3406,FremontBridge,02/21/2013 10:00:00 PM,48,-122,17,18,35
3407,FremontBridge,02/21/2013 11:00:00 PM,48,-122,5,7,12
3408,FremontBridge,02/22/2013 12:00:00 AM,48,-122,4,2,6
3409,FremontBridge,02/22/2013 01:00:00 AM,48,-122,3,0,3
3410,FremontBridge,02/22/2013 02:00:00 AM,48,-122,1,3,4
3411,FremontBridge,02/22/2013 03:00:00 AM,48,-122,1,1,2
3412,FremontBridge,02/22/2013 04:00:00 AM,48,-122,2,3,5
3413,FremontBridge,02/22/2013 05:00:00 AM,48,-122,6,10,16
3414,FremontBridge,02/22/2013 06:00:00 AM,48,-122,30,50,80
3415,FremontBridge,02/22/2013 07:00:00 AM,48,-122,31,100,131
3416,FremontBridge,02/22/2013 08:00:00 AM,48,-122,68,138,206
3417,FremontBridge,02/22/2013 09:00:00 AM,48,-122,34,68,102
3418,FremontBridge,02/22/2013 10:00:00 AM,48,-122,14,21,35
3419,FremontBridge,02/22/2013 11:00:00 AM,48,-122,5,15,20
3420,FremontBridge,02/22/2013 12:00:00 PM,48,-122,18,11,29
3421,FremontBridge,02/22/2013 01:00:00 PM,48,-122,17,12,29
3422,FremontBridge,02/22/2013 02:00:00 PM,48,-122,25,15,40
3423,FremontBridge,02/22/2013 03:00:00 PM,48,-122,31,27,58
3424,FremontBridge,02/22/2013 04:00:00 PM,48,-122,74,43,117
3425,FremontBridge,02/22/2013 05:00:00 PM,48,-122,140,64,204
3426,FremontBridge,02/22/2013 06:00:00 PM,48,-122,89,39,128
3427,FremontBridge,02/22/2013 07:00:00 PM,48,-122,44,22,66
3428,FremontBridge,02/22/2013 08:00:00 PM,48,-122,19,6,25
3429,FremontBridge,02/22/2013 09:00:00 PM,48,-122,15,6,21
3430,FremontBridge,02/22/2013 10:00:00 PM,48,-122,8,6,14
3431,FremontBridge,02/22/2013 11:00:00 PM,48,-122,11,8,19
3432,FremontBridge,02/23/2013 12:00:00 AM,48,-122,7,3,10
3433,FremontBridge,02/23/2013 01:00:00 AM,48,-122,2,1,3
3434,FremontBridge,02/23/2013 02:00:00 AM,48,-122,2,0,2
3435,FremontBridge,02/23/2013 03:00:00 AM,48,-122,2,5,7
3436,FremontBridge,02/23/2013 04:00:00 AM,48,-122,1,0,1
3437,FremontBridge,02/23/2013 05:00:00 AM,48,-122,0,4,4
3438,FremontBridge,02/23/2013 06:00:00 AM,48,-122,12,4,16
3439,FremontBridge,02/23/2013 07:00:00 AM,48,-122,13,17,30
3440,FremontBridge,02/23/2013 08:00:00 AM,48,-122,28,14,42
3441,FremontBridge,02/23/2013 09:00:00 AM,48,-122,29,18,47
3442,FremontBridge,02/23/2013 10:00:00 AM,48,-122,29,32,61
3443,FremontBridge,02/23/2013 11:00:00 AM,48,-122,36,55,91
3444,FremontBridge,02/23/2013 12:00:00 PM,48,-122,63,51,114
3445,FremontBridge,02/23/2013 01:00:00 PM,48,-122,43,58,101
3446,FremontBridge,02/23/2013 02:00:00 PM,48,-122,55,74,129
3447,FremontBridge,02/23/2013 03:00:00 PM,48,-122,47,70,117
3448,FremontBridge,02/23/2013 04:00:00 PM,48,-122,38,62,100
3449,FremontBridge,02/23/2013 05:00:00 PM,48,-122,31,40,71
3450,FremontBridge,02/23/2013 06:00:00 PM,48,-122,24,31,55
3451,FremontBridge,02/23/2013 07:00:00 PM,48,-122,17,19,36
3452,FremontBridge,02/23/2013 08:00:00 PM,48,-122,22,12,34
3453,FremontBridge,02/23/2013 09:00:00 PM,48,-122,12,15,27
3454,FremontBridge,02/23/2013 10:00:00 PM,48,-122,7,6,13
3455,FremontBridge,02/23/2013 11:00:00 PM,48,-122,3,12,15
3456,FremontBridge,02/24/2013 12:00:00 AM,48,-122,10,12,22
3457,FremontBridge,02/24/2013 01:00:00 AM,48,-122,2,2,4
3458,FremontBridge,02/24/2013 02:00:00 AM,48,-122,1,3,4
3459,FremontBridge,02/24/2013 03:00:00 AM,48,-122,3,1,4
3460,FremontBridge,02/24/2013 04:00:00 AM,48,-122,4,2,6
3461,FremontBridge,02/24/2013 05:00:00 AM,48,-122,0,2,2
3462,FremontBridge,02/24/2013 06:00:00 AM,48,-122,5,17,22
3463,FremontBridge,02/24/2013 07:00:00 AM,48,-122,14,64,78
3464,FremontBridge,02/24/2013 08:00:00 AM,48,-122,24,77,101
3465,FremontBridge,02/24/2013 09:00:00 AM,48,-122,26,32,58
3466,FremontBridge,02/24/2013 10:00:00 AM,48,-122,19,47,66
3467,FremontBridge,02/24/2013 11:00:00 AM,48,-122,33,60,93
3468,FremontBridge,02/24/2013 12:00:00 PM,48,-122,37,44,81
3469,FremontBridge,02/24/2013 01:00:00 PM,48,-122,65,33,98
3470,FremontBridge,02/24/2013 02:00:00 PM,48,-122,64,46,110
3471,FremontBridge,02/24/2013 03:00:00 PM,48,-122,41,51,92
3472,FremontBridge,02/24/2013 04:00:00 PM,48,-122,54,33,87
3473,FremontBridge,02/24/2013 05:00:00 PM,48,-122,54,27,81
3474,FremontBridge,02/24/2013 06:00:00 PM,48,-122,10,16,26
3475,FremontBridge,02/24/2013 07:00:00 PM,48,-122,23,9,32
3476,FremontBridge,02/24/2013 08:00:00 PM,48,-122,8,9,17
3477,FremontBridge,02/24/2013 09:00:00 PM,48,-122,6,7,13
3478,FremontBridge,02/24/2013 10:00:00 PM,48,-122,10,6,16
3479,FremontBridge,02/24/2013 11:00:00 PM,48,-122,4,5,9
3480,FremontBridge,02/25/2013 12:00:00 AM,48,-122,2,5,7
3481,FremontBridge,02/25/2013 01:00:00 AM,48,-122,0,3,3
3482,FremontBridge,02/25/2013 02:00:00 AM,48,-122,1,0,1
3483,FremontBridge,02/25/2013 03:00:00 AM,48,-122,0,0,0
3484,FremontBridge,02/25/2013 04:00:00 AM,48,-122,2,3,5
3485,FremontBridge,02/25/2013 05:00:00 AM,48,-122,4,18,22
3486,FremontBridge,02/25/2013 06:00:00 AM,48,-122,26,57,83
3487,FremontBridge,02/25/2013 07:00:00 AM,48,-122,54,135,189
3488,FremontBridge,02/25/2013 08:00:00 AM,48,-122,95,172,267
3489,FremontBridge,02/25/2013 09:00:00 AM,48,-122,53,89,142
3490,FremontBridge,02/25/2013 10:00:00 AM,48,-122,22,34,56
3491,FremontBridge,02/25/2013 11:00:00 AM,48,-122,21,24,45
3492,FremontBridge,02/25/2013 12:00:00 PM,48,-122,23,27,50
3493,FremontBridge,02/25/2013 01:00:00 PM,48,-122,19,32,51
3494,FremontBridge,02/25/2013 02:00:00 PM,48,-122,42,39,81
3495,FremontBridge,02/25/2013 03:00:00 PM,48,-122,48,63,111
3496,FremontBridge,02/25/2013 04:00:00 PM,48,-122,95,81,176
3497,FremontBridge,02/25/2013 05:00:00 PM,48,-122,220,132,352
3498,FremontBridge,02/25/2013 06:00:00 PM,48,-122,159,73,232
3499,FremontBridge,02/25/2013 07:00:00 PM,48,-122,64,36,100
3500,FremontBridge,02/25/2013 08:00:00 PM,48,-122,23,23,46
3501,FremontBridge,02/25/2013 09:00:00 PM,48,-122,19,16,35
3502,FremontBridge,02/25/2013 10:00:00 PM,48,-122,12,9,21
3503,FremontBridge,02/25/2013 11:00:00 PM,48,-122,5,6,11
3504,FremontBridge,02/26/2013 12:00:00 AM,48,-122,4,4,8
3505,FremontBridge,02/26/2013 01:00:00 AM,48,-122,2,2,4
3506,FremontBridge,02/26/2013 02:00:00 AM,48,-122,0,3,3
3507,FremontBridge,02/26/2013 03:00:00 AM,48,-122,2,3,5
3508,FremontBridge,02/26/2013 04:00:00 AM,48,-122,1,4,5
3509,FremontBridge,02/26/2013 05:00:00 AM,48,-122,10,18,28
3510,FremontBridge,02/26/2013 06:00:00 AM,48,-122,27,75,102
3511,FremontBridge,02/26/2013 07:00:00 AM,48,-122,67,168,235
3512,FremontBridge,02/26/2013 08:00:00 AM,48,-122,130,237,367
3513,FremontBridge,02/26/2013 09:00:00 AM,48,-122,81,134,215
3514,FremontBridge,02/26/2013 10:00:00 AM,48,-122,26,50,76
3515,FremontBridge,02/26/2013 11:00:00 AM,48,-122,23,34,57
3516,FremontBridge,02/26/2013 12:00:00 PM,48,-122,18,25,43
3517,FremontBridge,02/26/2013 01:00:00 PM,48,-122,34,44,78
3518,FremontBridge,02/26/2013 02:00:00 PM,48,-122,37,31,68
3519,FremontBridge,02/26/2013 03:00:00 PM,48,-122,55,38,93
3520,FremontBridge,02/26/2013 04:00:00 PM,48,-122,131,66,197
3521,FremontBridge,02/26/2013 05:00:00 PM,48,-122,267,128,395
3522,FremontBridge,02/26/2013 06:00:00 PM,48,-122,176,94,270
3523,FremontBridge,02/26/2013 07:00:00 PM,48,-122,82,35,117
3524,FremontBridge,02/26/2013 08:00:00 PM,48,-122,34,25,59
3525,FremontBridge,02/26/2013 09:00:00 PM,48,-122,20,10,30
3526,FremontBridge,02/26/2013 10:00:00 PM,48,-122,7,17,24
3527,FremontBridge,02/26/2013 11:00:00 PM,48,-122,10,8,18
3528,FremontBridge,02/27/2013 12:00:00 AM,48,-122,5,1,6
3529,FremontBridge,02/27/2013 01:00:00 AM,48,-122,0,3,3
3530,FremontBridge,02/27/2013 02:00:00 AM,48,-122,0,2,2
3531,FremontBridge,02/27/2013 03:00:00 AM,48,-122,1,2,3
3532,FremontBridge,02/27/2013 04:00:00 AM,48,-122,2,7,9
3533,FremontBridge,02/27/2013 05:00:00 AM,48,-122,6,17,23
3534,FremontBridge,02/27/2013 06:00:00 AM,48,-122,32,91,123
3535,FremontBridge,02/27/2013 07:00:00 AM,48,-122,80,160,240
3536,FremontBridge,02/27/2013 08:00:00 AM,48,-122,105,213,318
3537,FremontBridge,02/27/2013 09:00:00 AM,48,-122,79,121,200
3538,FremontBridge,02/27/2013 10:00:00 AM,48,-122,35,49,84
3539,FremontBridge,02/27/2013 11:00:00 AM,48,-122,18,38,56
3540,FremontBridge,02/27/2013 12:00:00 PM,48,-122,24,43,67
3541,FremontBridge,02/27/2013 01:00:00 PM,48,-122,33,28,61
3542,FremontBridge,02/27/2013 02:00:00 PM,48,-122,21,36,57
3543,FremontBridge,02/27/2013 03:00:00 PM,48,-122,56,39,95
3544,FremontBridge,02/27/2013 04:00:00 PM,48,-122,102,67,169
3545,FremontBridge,02/27/2013 05:00:00 PM,48,-122,250,110,360
3546,FremontBridge,02/27/2013 06:00:00 PM,48,-122,180,70,250
3547,FremontBridge,02/27/2013 07:00:00 PM,48,-122,67,29,96
3548,FremontBridge,02/27/2013 08:00:00 PM,48,-122,32,13,45
3549,FremontBridge,02/27/2013 09:00:00 PM,48,-122,21,13,34
3550,FremontBridge,02/27/2013 10:00:00 PM,48,-122,14,6,20
3551,FremontBridge,02/27/2013 11:00:00 PM,48,-122,8,5,13
3552,FremontBridge,02/28/2013 12:00:00 AM,48,-122,4,3,7
3553,FremontBridge,02/28/2013 01:00:00 AM,48,-122,2,2,4
3554,FremontBridge,02/28/2013 02:00:00 AM,48,-122,2,1,3
3555,FremontBridge,02/28/2013 03:00:00 AM,48,-122,1,0,1
3556,FremontBridge,02/28/2013 04:00:00 AM,48,-122,1,3,4
3557,FremontBridge,02/28/2013 05:00:00 AM,48,-122,6,15,21
3558,FremontBridge,02/28/2013 06:00:00 AM,48,-122,20,52,72
3559,FremontBridge,02/28/2013 07:00:00 AM,48,-122,47,119,166
3560,FremontBridge,02/28/2013 08:00:00 AM,48,-122,74,159,233
3561,FremontBridge,02/28/2013 09:00:00 AM,48,-122,50,93,143
3562,FremontBridge,02/28/2013 10:00:00 AM,48,-122,22,30,52
3563,FremontBridge,02/28/2013 11:00:00 AM,48,-122,24,16,40
3564,FremontBridge,02/28/2013 12:00:00 PM,48,-122,17,26,43
3565,FremontBridge,02/28/2013 01:00:00 PM,48,-122,18,19,37
3566,FremontBridge,02/28/2013 02:00:00 PM,48,-122,25,19,44
3567,FremontBridge,02/28/2013 03:00:00 PM,48,-122,39,26,65
3568,FremontBridge,02/28/2013 04:00:00 PM,48,-122,77,41,118
3569,FremontBridge,02/28/2013 05:00:00 PM,48,-122,198,91,289
3570,FremontBridge,02/28/2013 06:00:00 PM,48,-122,141,81,222
3571,FremontBridge,02/28/2013 07:00:00 PM,48,-122,42,24,66
3572,FremontBridge,02/28/2013 08:00:00 PM,48,-122,33,19,52
3573,FremontBridge,02/28/2013 09:00:00 PM,48,-122,24,21,45
3574,FremontBridge,02/28/2013 10:00:00 PM,48,-122,11,10,21
3575,FremontBridge,02/28/2013 11:00:00 PM,48,-122,7,4,11
3576,FremontBridge,03/01/2013 12:00:00 AM,48,-122,3,2,5
3577,FremontBridge,03/01/2013 01:00:00 AM,48,-122,2,2,4
3578,FremontBridge,03/01/2013 02:00:00 AM,48,-122,0,0,0
3579,FremontBridge,03/01/2013 03:00:00 AM,48,-122,1,2,3
3580,FremontBridge,03/01/2013 04:00:00 AM,48,-122,1,1,2
3581,FremontBridge,03/01/2013 05:00:00 AM,48,-122,10,9,19
3582,FremontBridge,03/01/2013 06:00:00 AM,48,-122,30,61,91
3583,FremontBridge,03/01/2013 07:00:00 AM,48,-122,38,109,147
3584,FremontBridge,03/01/2013 08:00:00 AM,48,-122,72,163,235
3585,FremontBridge,03/01/2013 09:00:00 AM,48,-122,54,77,131
3586,FremontBridge,03/01/2013 10:00:00 AM,48,-122,19,37,56
3587,FremontBridge,03/01/2013 11:00:00 AM,48,-122,22,18,40
3588,FremontBridge,03/01/2013 12:00:00 PM,48,-122,26,32,58
3589,FremontBridge,03/01/2013 01:00:00 PM,48,-122,26,36,62
3590,FremontBridge,03/01/2013 02:00:00 PM,48,-122,41,40,81
3591,FremontBridge,03/01/2013 03:00:00 PM,48,-122,54,47,101
3592,FremontBridge,03/01/2013 04:00:00 PM,48,-122,102,68,170
3593,FremontBridge,03/01/2013 05:00:00 PM,48,-122,189,90,279
3594,FremontBridge,03/01/2013 06:00:00 PM,48,-122,103,50,153
3595,FremontBridge,03/01/2013 07:00:00 PM,48,-122,58,33,91
3596,FremontBridge,03/01/2013 08:00:00 PM,48,-122,15,24,39
3597,FremontBridge,03/01/2013 09:00:00 PM,48,-122,24,10,34
3598,FremontBridge,03/01/2013 10:00:00 PM,48,-122,10,7,17
3599,FremontBridge,03/01/2013 11:00:00 PM,48,-122,21,6,27
3600,FremontBridge,03/02/2013 12:00:00 AM,48,-122,10,10,20
3601,FremontBridge,03/02/2013 01:00:00 AM,48,-122,3,3,6
3602,FremontBridge,03/02/2013 02:00:00 AM,48,-122,4,5,9
3603,FremontBridge,03/02/2013 03:00:00 AM,48,-122,2,5,7
3604,FremontBridge,03/02/2013 04:00:00 AM,48,-122,1,2,3
3605,FremontBridge,03/02/2013 05:00:00 AM,48,-122,0,1,1
3606,FremontBridge,03/02/2013 06:00:00 AM,48,-122,6,7,13
3607,FremontBridge,03/02/2013 07:00:00 AM,48,-122,17,15,32
3608,FremontBridge,03/02/2013 08:00:00 AM,48,-122,23,37,60
3609,FremontBridge,03/02/2013 09:00:00 AM,48,-122,44,45,89
3610,FremontBridge,03/02/2013 10:00:00 AM,48,-122,49,44,93
3611,FremontBridge,03/02/2013 11:00:00 AM,48,-122,54,66,120
3612,FremontBridge,03/02/2013 12:00:00 PM,48,-122,48,87,135
3613,FremontBridge,03/02/2013 01:00:00 PM,48,-122,53,80,133
3614,FremontBridge,03/02/2013 02:00:00 PM,48,-122,56,62,118
3615,FremontBridge,03/02/2013 03:00:00 PM,48,-122,37,50,87
3616,FremontBridge,03/02/2013 04:00:00 PM,48,-122,42,39,81
3617,FremontBridge,03/02/2013 05:00:00 PM,48,-122,45,34,79
3618,FremontBridge,03/02/2013 06:00:00 PM,48,-122,24,22,46
3619,FremontBridge,03/02/2013 07:00:00 PM,48,-122,13,12,25
3620,FremontBridge,03/02/2013 08:00:00 PM,48,-122,14,8,22
3621,FremontBridge,03/02/2013 09:00:00 PM,48,-122,6,12,18
3622,FremontBridge,03/02/2013 10:00:00 PM,48,-122,17,6,23
3623,FremontBridge,03/02/2013 11:00:00 PM,48,-122,8,5,13
3624,FremontBridge,03/03/2013 12:00:00 AM,48,-122,10,5,15
3625,FremontBridge,03/03/2013 01:00:00 AM,48,-122,2,7,9
3626,FremontBridge,03/03/2013 02:00:00 AM,48,-122,1,1,2
3627,FremontBridge,03/03/2013 03:00:00 AM,48,-122,2,1,3
3628,FremontBridge,03/03/2013 04:00:00 AM,48,-122,1,1,2
3629,FremontBridge,03/03/2013 05:00:00 AM,48,-122,3,3,6
3630,FremontBridge,03/03/2013 06:00:00 AM,48,-122,7,4,11
3631,FremontBridge,03/03/2013 07:00:00 AM,48,-122,6,16,22
3632,FremontBridge,03/03/2013 08:00:00 AM,48,-122,31,32,63
3633,FremontBridge,03/03/2013 09:00:00 AM,48,-122,28,49,77
3634,FremontBridge,03/03/2013 10:00:00 AM,48,-122,51,91,142
3635,FremontBridge,03/03/2013 11:00:00 AM,48,-122,70,91,161
3636,FremontBridge,03/03/2013 12:00:00 PM,48,-122,76,94,170
3637,FremontBridge,03/03/2013 01:00:00 PM,48,-122,91,147,238
3638,FremontBridge,03/03/2013 02:00:00 PM,48,-122,90,121,211
3639,FremontBridge,03/03/2013 03:00:00 PM,48,-122,67,91,158
3640,FremontBridge,03/03/2013 04:00:00 PM,48,-122,51,92,143
3641,FremontBridge,03/03/2013 05:00:00 PM,48,-122,36,69,105
3642,FremontBridge,03/03/2013 06:00:00 PM,48,-122,30,33,63
3643,FremontBridge,03/03/2013 07:00:00 PM,48,-122,17,18,35
3644,FremontBridge,03/03/2013 08:00:00 PM,48,-122,6,9,15
3645,FremontBridge,03/03/2013 09:00:00 PM,48,-122,6,2,8
3646,FremontBridge,03/03/2013 10:00:00 PM,48,-122,12,8,20
3647,FremontBridge,03/03/2013 11:00:00 PM,48,-122,7,4,11
3648,FremontBridge,03/04/2013 12:00:00 AM,48,-122,2,4,6
3649,FremontBridge,03/04/2013 01:00:00 AM,48,-122,1,1,2
3650,FremontBridge,03/04/2013 02:00:00 AM,48,-122,0,1,1
3651,FremontBridge,03/04/2013 03:00:00 AM,48,-122,1,0,1
3652,FremontBridge,03/04/2013 04:00:00 AM,48,-122,2,4,6
3653,FremontBridge,03/04/2013 05:00:00 AM,48,-122,4,20,24
3654,FremontBridge,03/04/2013 06:00:00 AM,48,-122,32,74,106
3655,FremontBridge,03/04/2013 07:00:00 AM,48,-122,71,188,259
3656,FremontBridge,03/04/2013 08:00:00 AM,48,-122,114,288,402
3657,FremontBridge,03/04/2013 09:00:00 AM,48,-122,74,131,205
3658,FremontBridge,03/04/2013 10:00:00 AM,48,-122,24,41,65
3659,FremontBridge,03/04/2013 11:00:00 AM,48,-122,27,46,73
3660,FremontBridge,03/04/2013 12:00:00 PM,48,-122,33,45,78
3661,FremontBridge,03/04/2013 01:00:00 PM,48,-122,52,44,96
3662,FremontBridge,03/04/2013 02:00:00 PM,48,-122,31,44,75
3663,FremontBridge,03/04/2013 03:00:00 PM,48,-122,69,72,141
3664,FremontBridge,03/04/2013 04:00:00 PM,48,-122,113,99,212
3665,FremontBridge,03/04/2013 05:00:00 PM,48,-122,322,164,486
3666,FremontBridge,03/04/2013 06:00:00 PM,48,-122,207,96,303
3667,FremontBridge,03/04/2013 07:00:00 PM,48,-122,61,43,104
3668,FremontBridge,03/04/2013 08:00:00 PM,48,-122,37,22,59
3669,FremontBridge,03/04/2013 09:00:00 PM,48,-122,23,13,36
3670,FremontBridge,03/04/2013 10:00:00 PM,48,-122,19,15,34
3671,FremontBridge,03/04/2013 11:00:00 PM,48,-122,8,9,17
3672,FremontBridge,03/05/2013 12:00:00 AM,48,-122,2,3,5
3673,FremontBridge,03/05/2013 01:00:00 AM,48,-122,3,2,5
3674,FremontBridge,03/05/2013 02:00:00 AM,48,-122,1,2,3
3675,FremontBridge,03/05/2013 03:00:00 AM,48,-122,2,0,2
3676,FremontBridge,03/05/2013 04:00:00 AM,48,-122,2,3,5
3677,FremontBridge,03/05/2013 05:00:00 AM,48,-122,7,16,23
3678,FremontBridge,03/05/2013 06:00:00 AM,48,-122,39,73,112
3679,FremontBridge,03/05/2013 07:00:00 AM,48,-122,69,188,257
3680,FremontBridge,03/05/2013 08:00:00 AM,48,-122,112,245,357
3681,FremontBridge,03/05/2013 09:00:00 AM,48,-122,65,106,171
3682,FremontBridge,03/05/2013 10:00:00 AM,48,-122,27,38,65
3683,FremontBridge,03/05/2013 11:00:00 AM,48,-122,25,30,55
3684,FremontBridge,03/05/2013 12:00:00 PM,48,-122,16,28,44
3685,FremontBridge,03/05/2013 01:00:00 PM,48,-122,27,32,59
3686,FremontBridge,03/05/2013 02:00:00 PM,48,-122,38,25,63
3687,FremontBridge,03/05/2013 03:00:00 PM,48,-122,57,43,100
3688,FremontBridge,03/05/2013 04:00:00 PM,48,-122,110,68,178
3689,FremontBridge,03/05/2013 05:00:00 PM,48,-122,292,105,397
3690,FremontBridge,03/05/2013 06:00:00 PM,48,-122,154,87,241
3691,FremontBridge,03/05/2013 07:00:00 PM,48,-122,69,40,109
3692,FremontBridge,03/05/2013 08:00:00 PM,48,-122,40,30,70
3693,FremontBridge,03/05/2013 09:00:00 PM,48,-122,19,20,39
3694,FremontBridge,03/05/2013 10:00:00 PM,48,-122,10,13,23
3695,FremontBridge,03/05/2013 11:00:00 PM,48,-122,7,8,15
3696,FremontBridge,03/06/2013 12:00:00 AM,48,-122,2,2,4
3697,FremontBridge,03/06/2013 01:00:00 AM,48,-122,1,3,4
3698,FremontBridge,03/06/2013 02:00:00 AM,48,-122,0,2,2
3699,FremontBridge,03/06/2013 03:00:00 AM,48,-122,1,0,1
3700,FremontBridge,03/06/2013 04:00:00 AM,48,-122,3,4,7
3701,FremontBridge,03/06/2013 05:00:00 AM,48,-122,4,25,29
3702,FremontBridge,03/06/2013 06:00:00 AM,48,-122,35,80,115
3703,FremontBridge,03/06/2013 07:00:00 AM,48,-122,66,185,251
3704,FremontBridge,03/06/2013 08:00:00 AM,48,-122,99,222,321
3705,FremontBridge,03/06/2013 09:00:00 AM,48,-122,99,115,214
3706,FremontBridge,03/06/2013 10:00:00 AM,48,-122,20,29,49
3707,FremontBridge,03/06/2013 11:00:00 AM,48,-122,13,24,37
3708,FremontBridge,03/06/2013 12:00:00 PM,48,-122,16,17,33
3709,FremontBridge,03/06/2013 01:00:00 PM,48,-122,19,14,33
3710,FremontBridge,03/06/2013 02:00:00 PM,48,-122,22,13,35
3711,FremontBridge,03/06/2013 03:00:00 PM,48,-122,33,33,66
3712,FremontBridge,03/06/2013 04:00:00 PM,48,-122,81,48,129
3713,FremontBridge,03/06/2013 05:00:00 PM,48,-122,236,91,327
3714,FremontBridge,03/06/2013 06:00:00 PM,48,-122,131,71,202
3715,FremontBridge,03/06/2013 07:00:00 PM,48,-122,60,30,90
3716,FremontBridge,03/06/2013 08:00:00 PM,48,-122,20,12,32
3717,FremontBridge,03/06/2013 09:00:00 PM,48,-122,20,17,37
3718,FremontBridge,03/06/2013 10:00:00 PM,48,-122,9,7,16
3719,FremontBridge,03/06/2013 11:00:00 PM,48,-122,2,5,7
3720,FremontBridge,03/07/2013 12:00:00 AM,48,-122,3,2,5
3721,FremontBridge,03/07/2013 01:00:00 AM,48,-122,0,2,2
3722,FremontBridge,03/07/2013 02:00:00 AM,48,-122,2,1,3
3723,FremontBridge,03/07/2013 03:00:00 AM,48,-122,0,1,1
3724,FremontBridge,03/07/2013 04:00:00 AM,48,-122,1,3,4
3725,FremontBridge,03/07/2013 05:00:00 AM,48,-122,5,16,21
3726,FremontBridge,03/07/2013 06:00:00 AM,48,-122,27,54,81
3727,FremontBridge,03/07/2013 07:00:00 AM,48,-122,67,126,193
3728,FremontBridge,03/07/2013 08:00:00 AM,48,-122,68,168,236
3729,FremontBridge,03/07/2013 09:00:00 AM,48,-122,66,81,147
3730,FremontBridge,03/07/2013 10:00:00 AM,48,-122,26,48,74
3731,FremontBridge,03/07/2013 11:00:00 AM,48,-122,28,40,68
3732,FremontBridge,03/07/2013 12:00:00 PM,48,-122,19,23,42
3733,FremontBridge,03/07/2013 01:00:00 PM,48,-122,30,42,72
3734,FremontBridge,03/07/2013 02:00:00 PM,48,-122,35,32,67
3735,FremontBridge,03/07/2013 03:00:00 PM,48,-122,48,48,96
3736,FremontBridge,03/07/2013 04:00:00 PM,48,-122,108,89,197
3737,FremontBridge,03/07/2013 05:00:00 PM,48,-122,219,94,313
3738,FremontBridge,03/07/2013 06:00:00 PM,48,-122,132,85,217
3739,FremontBridge,03/07/2013 07:00:00 PM,48,-122,82,62,144
3740,FremontBridge,03/07/2013 08:00:00 PM,48,-122,43,19,62
3741,FremontBridge,03/07/2013 09:00:00 PM,48,-122,29,20,49
3742,FremontBridge,03/07/2013 10:00:00 PM,48,-122,28,6,34
3743,FremontBridge,03/07/2013 11:00:00 PM,48,-122,16,6,22
3744,FremontBridge,03/08/2013 12:00:00 AM,48,-122,3,4,7
3745,FremontBridge,03/08/2013 01:00:00 AM,48,-122,5,2,7
3746,FremontBridge,03/08/2013 02:00:00 AM,48,-122,1,0,1
3747,FremontBridge,03/08/2013 03:00:00 AM,48,-122,1,0,1
3748,FremontBridge,03/08/2013 04:00:00 AM,48,-122,1,1,2
3749,FremontBridge,03/08/2013 05:00:00 AM,48,-122,5,16,21
3750,FremontBridge,03/08/2013 06:00:00 AM,48,-122,33,73,106
3751,FremontBridge,03/08/2013 07:00:00 AM,48,-122,69,168,237
3752,FremontBridge,03/08/2013 08:00:00 AM,48,-122,99,239,338
3753,FremontBridge,03/08/2013 09:00:00 AM,48,-122,73,116,189
3754,FremontBridge,03/08/2013 10:00:00 AM,48,-122,35,53,88
3755,FremontBridge,03/08/2013 11:00:00 AM,48,-122,47,35,82
3756,FremontBridge,03/08/2013 12:00:00 PM,48,-122,26,51,77
3757,FremontBridge,03/08/2013 01:00:00 PM,48,-122,60,53,113
3758,FremontBridge,03/08/2013 02:00:00 PM,48,-122,72,51,123
3759,FremontBridge,03/08/2013 03:00:00 PM,48,-122,87,90,177
3760,FremontBridge,03/08/2013 04:00:00 PM,48,-122,166,112,278
3761,FremontBridge,03/08/2013 05:00:00 PM,48,-122,273,157,430
3762,FremontBridge,03/08/2013 06:00:00 PM,48,-122,155,91,246
3763,FremontBridge,03/08/2013 07:00:00 PM,48,-122,52,41,93
3764,FremontBridge,03/08/2013 08:00:00 PM,48,-122,25,18,43
3765,FremontBridge,03/08/2013 09:00:00 PM,48,-122,16,15,31
3766,FremontBridge,03/08/2013 10:00:00 PM,48,-122,18,12,30
3767,FremontBridge,03/08/2013 11:00:00 PM,48,-122,8,11,19
3768,FremontBridge,03/09/2013 12:00:00 AM,48,-122,12,10,22
3769,FremontBridge,03/09/2013 01:00:00 AM,48,-122,5,1,6
3770,FremontBridge,03/09/2013 02:00:00 AM,48,-122,5,4,9
3771,FremontBridge,03/09/2013 03:00:00 AM,48,-122,3,2,5
3772,FremontBridge,03/09/2013 04:00:00 AM,48,-122,1,1,2
3773,FremontBridge,03/09/2013 05:00:00 AM,48,-122,5,5,10
3774,FremontBridge,03/09/2013 06:00:00 AM,48,-122,9,9,18
3775,FremontBridge,03/09/2013 07:00:00 AM,48,-122,14,26,40
3776,FremontBridge,03/09/2013 08:00:00 AM,48,-122,31,62,93
3777,FremontBridge,03/09/2013 09:00:00 AM,48,-122,39,67,106
3778,FremontBridge,03/09/2013 10:00:00 AM,48,-122,46,97,143
3779,FremontBridge,03/09/2013 11:00:00 AM,48,-122,77,131,208
3780,FremontBridge,03/09/2013 12:00:00 PM,48,-122,69,105,174
3781,FremontBridge,03/09/2013 01:00:00 PM,48,-122,108,142,250
3782,FremontBridge,03/09/2013 02:00:00 PM,48,-122,120,136,256
3783,FremontBridge,03/09/2013 03:00:00 PM,48,-122,142,154,296
3784,FremontBridge,03/09/2013 04:00:00 PM,48,-122,127,150,277
3785,FremontBridge,03/09/2013 05:00:00 PM,48,-122,77,98,175
3786,FremontBridge,03/09/2013 06:00:00 PM,48,-122,80,80,160
3787,FremontBridge,03/09/2013 07:00:00 PM,48,-122,35,31,66
3788,FremontBridge,03/09/2013 08:00:00 PM,48,-122,11,26,37
3789,FremontBridge,03/09/2013 09:00:00 PM,48,-122,15,18,33
3790,FremontBridge,03/09/2013 10:00:00 PM,48,-122,15,7,22
3791,FremontBridge,03/09/2013 11:00:00 PM,48,-122,12,10,22
3792,FremontBridge,03/10/2013 12:00:00 AM,48,-122,9,2,11
3793,FremontBridge,03/10/2013 01:00:00 AM,48,-122,10,8,18
3794,FremontBridge,03/10/2013 02:00:00 AM,48,-122,0,0,0
3795,FremontBridge,03/10/2013 03:00:00 AM,48,-122,9,2,11
3796,FremontBridge,03/10/2013 04:00:00 AM,48,-122,0,0,0
3797,FremontBridge,03/10/2013 05:00:00 AM,48,-122,1,1,2
3798,FremontBridge,03/10/2013 06:00:00 AM,48,-122,5,1,6
3799,FremontBridge,03/10/2013 07:00:00 AM,48,-122,8,10,18
3800,FremontBridge,03/10/2013 08:00:00 AM,48,-122,14,20,34
3801,FremontBridge,03/10/2013 09:00:00 AM,48,-122,25,38,63
3802,FremontBridge,03/10/2013 10:00:00 AM,48,-122,21,67,88
3803,FremontBridge,03/10/2013 11:00:00 AM,48,-122,22,43,65
3804,FremontBridge,03/10/2013 12:00:00 PM,48,-122,40,60,100
3805,FremontBridge,03/10/2013 01:00:00 PM,48,-122,49,56,105
3806,FremontBridge,03/10/2013 02:00:00 PM,48,-122,39,65,104
3807,FremontBridge,03/10/2013 03:00:00 PM,48,-122,48,45,93
3808,FremontBridge,03/10/2013 04:00:00 PM,48,-122,56,66,122
3809,FremontBridge,03/10/2013 05:00:00 PM,48,-122,30,38,68
3810,FremontBridge,03/10/2013 06:00:00 PM,48,-122,31,27,58
3811,FremontBridge,03/10/2013 07:00:00 PM,48,-122,7,10,17
3812,FremontBridge,03/10/2013 08:00:00 PM,48,-122,7,8,15
3813,FremontBridge,03/10/2013 09:00:00 PM,48,-122,5,7,12
3814,FremontBridge,03/10/2013 10:00:00 PM,48,-122,9,16,25
3815,FremontBridge,03/10/2013 11:00:00 PM,48,-122,7,4,11
3816,FremontBridge,03/11/2013 12:00:00 AM,48,-122,3,7,10
3817,FremontBridge,03/11/2013 01:00:00 AM,48,-122,3,3,6
3818,FremontBridge,03/11/2013 02:00:00 AM,48,-122,0,1,1
3819,FremontBridge,03/11/2013 03:00:00 AM,48,-122,2,1,3
3820,FremontBridge,03/11/2013 04:00:00 AM,48,-122,4,4,8
3821,FremontBridge,03/11/2013 05:00:00 AM,48,-122,6,20,26
3822,FremontBridge,03/11/2013 06:00:00 AM,48,-122,31,72,103
3823,FremontBridge,03/11/2013 07:00:00 AM,48,-122,47,138,185
3824,FremontBridge,03/11/2013 08:00:00 AM,48,-122,103,216,319
3825,FremontBridge,03/11/2013 09:00:00 AM,48,-122,72,115,187
3826,FremontBridge,03/11/2013 10:00:00 AM,48,-122,28,47,75
3827,FremontBridge,03/11/2013 11:00:00 AM,48,-122,21,30,51
3828,FremontBridge,03/11/2013 12:00:00 PM,48,-122,23,33,56
3829,FremontBridge,03/11/2013 01:00:00 PM,48,-122,28,36,64
3830,FremontBridge,03/11/2013 02:00:00 PM,48,-122,29,36,65
3831,FremontBridge,03/11/2013 03:00:00 PM,48,-122,53,33,86
3832,FremontBridge,03/11/2013 04:00:00 PM,48,-122,113,83,196
3833,FremontBridge,03/11/2013 05:00:00 PM,48,-122,236,102,338
3834,FremontBridge,03/11/2013 06:00:00 PM,48,-122,167,80,247
3835,FremontBridge,03/11/2013 07:00:00 PM,48,-122,52,42,94
3836,FremontBridge,03/11/2013 08:00:00 PM,48,-122,39,14,53
3837,FremontBridge,03/11/2013 09:00:00 PM,48,-122,13,13,26
3838,FremontBridge,03/11/2013 10:00:00 PM,48,-122,19,11,30
3839,FremontBridge,03/11/2013 11:00:00 PM,48,-122,14,7,21
3840,FremontBridge,03/12/2013 12:00:00 AM,48,-122,4,5,9
3841,FremontBridge,03/12/2013 01:00:00 AM,48,-122,2,0,2
3842,FremontBridge,03/12/2013 02:00:00 AM,48,-122,3,1,4
3843,FremontBridge,03/12/2013 03:00:00 AM,48,-122,0,0,0
3844,FremontBridge,03/12/2013 04:00:00 AM,48,-122,2,4,6
3845,FremontBridge,03/12/2013 05:00:00 AM,48,-122,5,17,22
3846,FremontBridge,03/12/2013 06:00:00 AM,48,-122,29,69,98
3847,FremontBridge,03/12/2013 07:00:00 AM,48,-122,53,146,199
3848,FremontBridge,03/12/2013 08:00:00 AM,48,-122,92,171,263
3849,FremontBridge,03/12/2013 09:00:00 AM,48,-122,53,104,157
3850,FremontBridge,03/12/2013 10:00:00 AM,48,-122,24,45,69
3851,FremontBridge,03/12/2013 11:00:00 AM,48,-122,23,26,49
3852,FremontBridge,03/12/2013 12:00:00 PM,48,-122,20,25,45
3853,FremontBridge,03/12/2013 01:00:00 PM,48,-122,27,27,54
3854,FremontBridge,03/12/2013 02:00:00 PM,48,-122,34,28,62
3855,FremontBridge,03/12/2013 03:00:00 PM,48,-122,53,33,86
3856,FremontBridge,03/12/2013 04:00:00 PM,48,-122,78,56,134
3857,FremontBridge,03/12/2013 05:00:00 PM,48,-122,201,82,283
3858,FremontBridge,03/12/2013 06:00:00 PM,48,-122,146,69,215
3859,FremontBridge,03/12/2013 07:00:00 PM,48,-122,60,42,102
3860,FremontBridge,03/12/2013 08:00:00 PM,48,-122,28,18,46
3861,FremontBridge,03/12/2013 09:00:00 PM,48,-122,32,10,42
3862,FremontBridge,03/12/2013 10:00:00 PM,48,-122,11,8,19
3863,FremontBridge,03/12/2013 11:00:00 PM,48,-122,6,8,14
3864,FremontBridge,03/13/2013 12:00:00 AM,48,-122,4,1,5
3865,FremontBridge,03/13/2013 01:00:00 AM,48,-122,0,1,1
3866,FremontBridge,03/13/2013 02:00:00 AM,48,-122,0,1,1
3867,FremontBridge,03/13/2013 03:00:00 AM,48,-122,1,2,3
3868,FremontBridge,03/13/2013 04:00:00 AM,48,-122,2,4,6
3869,FremontBridge,03/13/2013 05:00:00 AM,48,-122,5,12,17
3870,FremontBridge,03/13/2013 06:00:00 AM,48,-122,27,51,78
3871,FremontBridge,03/13/2013 07:00:00 AM,48,-122,55,127,182
3872,FremontBridge,03/13/2013 08:00:00 AM,48,-122,89,193,282
3873,FremontBridge,03/13/2013 09:00:00 AM,48,-122,74,115,189
3874,FremontBridge,03/13/2013 10:00:00 AM,48,-122,19,46,65
3875,FremontBridge,03/13/2013 11:00:00 AM,48,-122,17,18,35
3876,FremontBridge,03/13/2013 12:00:00 PM,48,-122,13,13,26
3877,FremontBridge,03/13/2013 01:00:00 PM,48,-122,16,24,40
3878,FremontBridge,03/13/2013 02:00:00 PM,48,-122,20,14,34
3879,FremontBridge,03/13/2013 03:00:00 PM,48,-122,25,21,46
3880,FremontBridge,03/13/2013 04:00:00 PM,48,-122,77,51,128
3881,FremontBridge,03/13/2013 05:00:00 PM,48,-122,215,84,299
3882,FremontBridge,03/13/2013 06:00:00 PM,48,-122,146,70,216
3883,FremontBridge,03/13/2013 07:00:00 PM,48,-122,89,34,123
3884,FremontBridge,03/13/2013 08:00:00 PM,48,-122,21,21,42
3885,FremontBridge,03/13/2013 09:00:00 PM,48,-122,27,7,34
3886,FremontBridge,03/13/2013 10:00:00 PM,48,-122,13,16,29
3887,FremontBridge,03/13/2013 11:00:00 PM,48,-122,4,9,13
3888,FremontBridge,03/14/2013 12:00:00 AM,48,-122,2,2,4
3889,FremontBridge,03/14/2013 01:00:00 AM,48,-122,1,2,3
3890,FremontBridge,03/14/2013 02:00:00 AM,48,-122,3,0,3
3891,FremontBridge,03/14/2013 03:00:00 AM,48,-122,1,1,2
3892,FremontBridge,03/14/2013 04:00:00 AM,48,-122,1,4,5
3893,FremontBridge,03/14/2013 05:00:00 AM,48,-122,7,19,26
3894,FremontBridge,03/14/2013 06:00:00 AM,48,-122,24,61,85
3895,FremontBridge,03/14/2013 07:00:00 AM,48,-122,63,145,208
3896,FremontBridge,03/14/2013 08:00:00 AM,48,-122,98,207,305
3897,FremontBridge,03/14/2013 09:00:00 AM,48,-122,51,132,183
3898,FremontBridge,03/14/2013 10:00:00 AM,48,-122,29,49,78
3899,FremontBridge,03/14/2013 11:00:00 AM,48,-122,14,33,47
3900,FremontBridge,03/14/2013 12:00:00 PM,48,-122,28,31,59
3901,FremontBridge,03/14/2013 01:00:00 PM,48,-122,37,26,63
3902,FremontBridge,03/14/2013 02:00:00 PM,48,-122,36,39,75
3903,FremontBridge,03/14/2013 03:00:00 PM,48,-122,39,38,77
3904,FremontBridge,03/14/2013 04:00:00 PM,48,-122,91,70,161
3905,FremontBridge,03/14/2013 05:00:00 PM,48,-122,235,106,341
3906,FremontBridge,03/14/2013 06:00:00 PM,48,-122,164,85,249
3907,FremontBridge,03/14/2013 07:00:00 PM,48,-122,66,41,107
3908,FremontBridge,03/14/2013 08:00:00 PM,48,-122,34,22,56
3909,FremontBridge,03/14/2013 09:00:00 PM,48,-122,20,11,31
3910,FremontBridge,03/14/2013 10:00:00 PM,48,-122,15,8,23
3911,FremontBridge,03/14/2013 11:00:00 PM,48,-122,4,7,11
3912,FremontBridge,03/15/2013 12:00:00 AM,48,-122,6,6,12
3913,FremontBridge,03/15/2013 01:00:00 AM,48,-122,5,4,9
3914,FremontBridge,03/15/2013 02:00:00 AM,48,-122,0,4,4
3915,FremontBridge,03/15/2013 03:00:00 AM,48,-122,1,2,3
3916,FremontBridge,03/15/2013 04:00:00 AM,48,-122,1,2,3
3917,FremontBridge,03/15/2013 05:00:00 AM,48,-122,8,9,17
3918,FremontBridge,03/15/2013 06:00:00 AM,48,-122,22,64,86
3919,FremontBridge,03/15/2013 07:00:00 AM,48,-122,50,122,172
3920,FremontBridge,03/15/2013 08:00:00 AM,48,-122,92,185,277
3921,FremontBridge,03/15/2013 09:00:00 AM,48,-122,71,114,185
3922,FremontBridge,03/15/2013 10:00:00 AM,48,-122,27,51,78
3923,FremontBridge,03/15/2013 11:00:00 AM,48,-122,29,47,76
3924,FremontBridge,03/15/2013 12:00:00 PM,48,-122,28,41,69
3925,FremontBridge,03/15/2013 01:00:00 PM,48,-122,44,44,88
3926,FremontBridge,03/15/2013 02:00:00 PM,48,-122,40,54,94
3927,FremontBridge,03/15/2013 03:00:00 PM,48,-122,51,55,106
3928,FremontBridge,03/15/2013 04:00:00 PM,48,-122,125,90,215
3929,FremontBridge,03/15/2013 05:00:00 PM,48,-122,253,112,365
3930,FremontBridge,03/15/2013 06:00:00 PM,48,-122,171,82,253
3931,FremontBridge,03/15/2013 07:00:00 PM,48,-122,66,34,100
3932,FremontBridge,03/15/2013 08:00:00 PM,48,-122,37,20,57
3933,FremontBridge,03/15/2013 09:00:00 PM,48,-122,24,13,37
3934,FremontBridge,03/15/2013 10:00:00 PM,48,-122,19,7,26
3935,FremontBridge,03/15/2013 11:00:00 PM,48,-122,13,10,23
3936,FremontBridge,03/16/2013 12:00:00 AM,48,-122,8,7,15
3937,FremontBridge,03/16/2013 01:00:00 AM,48,-122,8,2,10
3938,FremontBridge,03/16/2013 02:00:00 AM,48,-122,8,3,11
3939,FremontBridge,03/16/2013 03:00:00 AM,48,-122,3,2,5
3940,FremontBridge,03/16/2013 04:00:00 AM,48,-122,1,2,3
3941,FremontBridge,03/16/2013 05:00:00 AM,48,-122,4,5,9
3942,FremontBridge,03/16/2013 06:00:00 AM,48,-122,9,10,19
3943,FremontBridge,03/16/2013 07:00:00 AM,48,-122,22,15,37
3944,FremontBridge,03/16/2013 08:00:00 AM,48,-122,24,40,64
3945,FremontBridge,03/16/2013 09:00:00 AM,48,-122,35,49,84
3946,FremontBridge,03/16/2013 10:00:00 AM,48,-122,35,47,82
3947,FremontBridge,03/16/2013 11:00:00 AM,48,-122,36,49,85
3948,FremontBridge,03/16/2013 12:00:00 PM,48,-122,30,60,90
3949,FremontBridge,03/16/2013 01:00:00 PM,48,-122,25,53,78
3950,FremontBridge,03/16/2013 02:00:00 PM,48,-122,30,41,71
3951,FremontBridge,03/16/2013 03:00:00 PM,48,-122,39,41,80
3952,FremontBridge,03/16/2013 04:00:00 PM,48,-122,32,51,83
3953,FremontBridge,03/16/2013 05:00:00 PM,48,-122,29,36,65
3954,FremontBridge,03/16/2013 06:00:00 PM,48,-122,34,22,56
3955,FremontBridge,03/16/2013 07:00:00 PM,48,-122,12,22,34
3956,FremontBridge,03/16/2013 08:00:00 PM,48,-122,19,9,28
3957,FremontBridge,03/16/2013 09:00:00 PM,48,-122,8,13,21
3958,FremontBridge,03/16/2013 10:00:00 PM,48,-122,10,9,19
3959,FremontBridge,03/16/2013 11:00:00 PM,48,-122,7,7,14
3960,FremontBridge,03/17/2013 12:00:00 AM,48,-122,5,3,8
3961,FremontBridge,03/17/2013 01:00:00 AM,48,-122,4,4,8
3962,FremontBridge,03/17/2013 02:00:00 AM,48,-122,2,4,6
3963,FremontBridge,03/17/2013 03:00:00 AM,48,-122,1,3,4
3964,FremontBridge,03/17/2013 04:00:00 AM,48,-122,1,3,4
3965,FremontBridge,03/17/2013 05:00:00 AM,48,-122,0,1,1
3966,FremontBridge,03/17/2013 06:00:00 AM,48,-122,7,5,12
3967,FremontBridge,03/17/2013 07:00:00 AM,48,-122,6,22,28
3968,FremontBridge,03/17/2013 08:00:00 AM,48,-122,12,24,36
3969,FremontBridge,03/17/2013 09:00:00 AM,48,-122,40,51,91
3970,FremontBridge,03/17/2013 10:00:00 AM,48,-122,39,63,102
3971,FremontBridge,03/17/2013 11:00:00 AM,48,-122,60,75,135
3972,FremontBridge,03/17/2013 12:00:00 PM,48,-122,60,79,139
3973,FremontBridge,03/17/2013 01:00:00 PM,48,-122,69,74,143
3974,FremontBridge,03/17/2013 02:00:00 PM,48,-122,56,101,157
3975,FremontBridge,03/17/2013 03:00:00 PM,48,-122,57,90,147
3976,FremontBridge,03/17/2013 04:00:00 PM,48,-122,51,51,102
3977,FremontBridge,03/17/2013 05:00:00 PM,48,-122,20,26,46
3978,FremontBridge,03/17/2013 06:00:00 PM,48,-122,19,32,51
3979,FremontBridge,03/17/2013 07:00:00 PM,48,-122,11,12,23
3980,FremontBridge,03/17/2013 08:00:00 PM,48,-122,12,9,21
3981,FremontBridge,03/17/2013 09:00:00 PM,48,-122,3,6,9
3982,FremontBridge,03/17/2013 10:00:00 PM,48,-122,8,3,11
3983,FremontBridge,03/17/2013 11:00:00 PM,48,-122,7,4,11
3984,FremontBridge,03/18/2013 12:00:00 AM,48,-122,3,3,6
3985,FremontBridge,03/18/2013 01:00:00 AM,48,-122,3,1,4
3986,FremontBridge,03/18/2013 02:00:00 AM,48,-122,1,3,4
3987,FremontBridge,03/18/2013 03:00:00 AM,48,-122,1,0,1
3988,FremontBridge,03/18/2013 04:00:00 AM,48,-122,2,4,6
3989,FremontBridge,03/18/2013 05:00:00 AM,48,-122,7,16,23
3990,FremontBridge,03/18/2013 06:00:00 AM,48,-122,30,68,98
3991,FremontBridge,03/18/2013 07:00:00 AM,48,-122,55,155,210
3992,FremontBridge,03/18/2013 08:00:00 AM,48,-122,107,198,305
3993,FremontBridge,03/18/2013 09:00:00 AM,48,-122,71,107,178
3994,FremontBridge,03/18/2013 10:00:00 AM,48,-122,20,44,64
3995,FremontBridge,03/18/2013 11:00:00 AM,48,-122,27,48,75
3996,FremontBridge,03/18/2013 12:00:00 PM,48,-122,23,37,60
3997,FremontBridge,03/18/2013 01:00:00 PM,48,-122,34,41,75
3998,FremontBridge,03/18/2013 02:00:00 PM,48,-122,46,35,81
3999,FremontBridge,03/18/2013 03:00:00 PM,48,-122,57,49,106
4000,FremontBridge,03/18/2013 04:00:00 PM,48,-122,97,70,167
4001,FremontBridge,03/18/2013 05:00:00 PM,48,-122,268,124,392
4002,FremontBridge,03/18/2013 06:00:00 PM,48,-122,179,93,272
4003,FremontBridge,03/18/2013 07:00:00 PM,48,-122,87,32,119
4004,FremontBridge,03/18/2013 08:00:00 PM,48,-122,32,18,50
4005,FremontBridge,03/18/2013 09:00:00 PM,48,-122,19,21,40
4006,FremontBridge,03/18/2013 10:00:00 PM,48,-122,24,8,32
4007,FremontBridge,03/18/2013 11:00:00 PM,48,-122,7,6,13
4008,FremontBridge,03/19/2013 12:00:00 AM,48,-122,7,4,11
4009,FremontBridge,03/19/2013 01:00:00 AM,48,-122,3,2,5
4010,FremontBridge,03/19/2013 02:00:00 AM,48,-122,0,4,4
4011,FremontBridge,03/19/2013 03:00:00 AM,48,-122,1,0,1
4012,FremontBridge,03/19/2013 04:00:00 AM,48,-122,1,2,3
4013,FremontBridge,03/19/2013 05:00:00 AM,48,-122,6,15,21
4014,FremontBridge,03/19/2013 06:00:00 AM,48,-122,26,81,107
4015,FremontBridge,03/19/2013 07:00:00 AM,48,-122,63,172,235
4016,FremontBridge,03/19/2013 08:00:00 AM,48,-122,106,241,347
4017,FremontBridge,03/19/2013 09:00:00 AM,48,-122,71,124,195
4018,FremontBridge,03/19/2013 10:00:00 AM,48,-122,22,54,76
4019,FremontBridge,03/19/2013 11:00:00 AM,48,-122,26,30,56
4020,FremontBridge,03/19/2013 12:00:00 PM,48,-122,31,47,78
4021,FremontBridge,03/19/2013 01:00:00 PM,48,-122,29,35,64
4022,FremontBridge,03/19/2013 02:00:00 PM,48,-122,40,32,72
4023,FremontBridge,03/19/2013 03:00:00 PM,48,-122,54,35,89
4024,FremontBridge,03/19/2013 04:00:00 PM,48,-122,108,58,166
4025,FremontBridge,03/19/2013 05:00:00 PM,48,-122,222,104,326
4026,FremontBridge,03/19/2013 06:00:00 PM,48,-122,175,77,252
4027,FremontBridge,03/19/2013 07:00:00 PM,48,-122,69,35,104
4028,FremontBridge,03/19/2013 08:00:00 PM,48,-122,31,17,48
4029,FremontBridge,03/19/2013 09:00:00 PM,48,-122,14,12,26
4030,FremontBridge,03/19/2013 10:00:00 PM,48,-122,10,8,18
4031,FremontBridge,03/19/2013 11:00:00 PM,48,-122,5,3,8
4032,FremontBridge,03/20/2013 12:00:00 AM,48,-122,4,1,5
4033,FremontBridge,03/20/2013 01:00:00 AM,48,-122,0,3,3
4034,FremontBridge,03/20/2013 02:00:00 AM,48,-122,0,1,1
4035,FremontBridge,03/20/2013 03:00:00 AM,48,-122,1,0,1
4036,FremontBridge,03/20/2013 04:00:00 AM,48,-122,2,4,6
4037,FremontBridge,03/20/2013 05:00:00 AM,48,-122,4,6,10
4038,FremontBridge,03/20/2013 06:00:00 AM,48,-122,14,29,43
4039,FremontBridge,03/20/2013 07:00:00 AM,48,-122,34,79,113
4040,FremontBridge,03/20/2013 08:00:00 AM,48,-122,58,123,181
4041,FremontBridge,03/20/2013 09:00:00 AM,48,-122,38,86,124
4042,FremontBridge,03/20/2013 10:00:00 AM,48,-122,11,27,38
4043,FremontBridge,03/20/2013 11:00:00 AM,48,-122,19,21,40
4044,FremontBridge,03/20/2013 12:00:00 PM,48,-122,11,17,28
4045,FremontBridge,03/20/2013 01:00:00 PM,48,-122,13,13,26
4046,FremontBridge,03/20/2013 02:00:00 PM,48,-122,23,18,41
4047,FremontBridge,03/20/2013 03:00:00 PM,48,-122,35,32,67
4048,FremontBridge,03/20/2013 04:00:00 PM,48,-122,66,50,116
4049,FremontBridge,03/20/2013 05:00:00 PM,48,-122,149,101,250
4050,FremontBridge,03/20/2013 06:00:00 PM,48,-122,120,67,187
4051,FremontBridge,03/20/2013 07:00:00 PM,48,-122,70,30,100
4052,FremontBridge,03/20/2013 08:00:00 PM,48,-122,25,28,53
4053,FremontBridge,03/20/2013 09:00:00 PM,48,-122,21,16,37
4054,FremontBridge,03/20/2013 10:00:00 PM,48,-122,17,10,27
4055,FremontBridge,03/20/2013 11:00:00 PM,48,-122,5,5,10
4056,FremontBridge,03/21/2013 12:00:00 AM,48,-122,0,2,2
4057,FremontBridge,03/21/2013 01:00:00 AM,48,-122,2,3,5
4058,FremontBridge,03/21/2013 02:00:00 AM,48,-122,1,2,3
4059,FremontBridge,03/21/2013 03:00:00 AM,48,-122,2,0,2
4060,FremontBridge,03/21/2013 04:00:00 AM,48,-122,2,3,5
4061,FremontBridge,03/21/2013 05:00:00 AM,48,-122,3,12,15
4062,FremontBridge,03/21/2013 06:00:00 AM,48,-122,22,57,79
4063,FremontBridge,03/21/2013 07:00:00 AM,48,-122,50,123,173
4064,FremontBridge,03/21/2013 08:00:00 AM,48,-122,94,172,266
4065,FremontBridge,03/21/2013 09:00:00 AM,48,-122,48,95,143
4066,FremontBridge,03/21/2013 10:00:00 AM,48,-122,53,53,106
4067,FremontBridge,03/21/2013 11:00:00 AM,48,-122,33,37,70
4068,FremontBridge,03/21/2013 12:00:00 PM,48,-122,16,35,51
4069,FremontBridge,03/21/2013 01:00:00 PM,48,-122,31,32,63
4070,FremontBridge,03/21/2013 02:00:00 PM,48,-122,26,39,65
4071,FremontBridge,03/21/2013 03:00:00 PM,48,-122,47,33,80
4072,FremontBridge,03/21/2013 04:00:00 PM,48,-122,66,46,112
4073,FremontBridge,03/21/2013 05:00:00 PM,48,-122,186,87,273
4074,FremontBridge,03/21/2013 06:00:00 PM,48,-122,151,61,212
4075,FremontBridge,03/21/2013 07:00:00 PM,48,-122,60,24,84
4076,FremontBridge,03/21/2013 08:00:00 PM,48,-122,24,21,45
4077,FremontBridge,03/21/2013 09:00:00 PM,48,-122,16,13,29
4078,FremontBridge,03/21/2013 10:00:00 PM,48,-122,16,7,23
4079,FremontBridge,03/21/2013 11:00:00 PM,48,-122,12,6,18
4080,FremontBridge,03/22/2013 12:00:00 AM,48,-122,4,2,6
4081,FremontBridge,03/22/2013 01:00:00 AM,48,-122,3,0,3
4082,FremontBridge,03/22/2013 02:00:00 AM,48,-122,4,3,7
4083,FremontBridge,03/22/2013 03:00:00 AM,48,-122,1,1,2
4084,FremontBridge,03/22/2013 04:00:00 AM,48,-122,0,5,5
4085,FremontBridge,03/22/2013 05:00:00 AM,48,-122,12,11,23
4086,FremontBridge,03/22/2013 06:00:00 AM,48,-122,26,61,87
4087,FremontBridge,03/22/2013 07:00:00 AM,48,-122,47,101,148
4088,FremontBridge,03/22/2013 08:00:00 AM,48,-122,61,170,231
4089,FremontBridge,03/22/2013 09:00:00 AM,48,-122,38,80,118
4090,FremontBridge,03/22/2013 10:00:00 AM,48,-122,23,29,52
4091,FremontBridge,03/22/2013 11:00:00 AM,48,-122,15,24,39
4092,FremontBridge,03/22/2013 12:00:00 PM,48,-122,18,22,40
4093,FremontBridge,03/22/2013 01:00:00 PM,48,-122,36,31,67
4094,FremontBridge,03/22/2013 02:00:00 PM,48,-122,42,29,71
4095,FremontBridge,03/22/2013 03:00:00 PM,48,-122,47,52,99
4096,FremontBridge,03/22/2013 04:00:00 PM,48,-122,97,77,174
4097,FremontBridge,03/22/2013 05:00:00 PM,48,-122,190,76,266
4098,FremontBridge,03/22/2013 06:00:00 PM,48,-122,118,70,188
4099,FremontBridge,03/22/2013 07:00:00 PM,48,-122,57,38,95
4100,FremontBridge,03/22/2013 08:00:00 PM,48,-122,29,18,47
4101,FremontBridge,03/22/2013 09:00:00 PM,48,-122,33,14,47
4102,FremontBridge,03/22/2013 10:00:00 PM,48,-122,23,7,30
4103,FremontBridge,03/22/2013 11:00:00 PM,48,-122,10,7,17
4104,FremontBridge,03/23/2013 12:00:00 AM,48,-122,5,24,29
4105,FremontBridge,03/23/2013 01:00:00 AM,48,-122,3,2,5
4106,FremontBridge,03/23/2013 02:00:00 AM,48,-122,4,8,12
4107,FremontBridge,03/23/2013 03:00:00 AM,48,-122,3,3,6
4108,FremontBridge,03/23/2013 04:00:00 AM,48,-122,3,1,4
4109,FremontBridge,03/23/2013 05:00:00 AM,48,-122,2,3,5
4110,FremontBridge,03/23/2013 06:00:00 AM,48,-122,7,10,17
4111,FremontBridge,03/23/2013 07:00:00 AM,48,-122,16,22,38
4112,FremontBridge,03/23/2013 08:00:00 AM,48,-122,33,25,58
4113,FremontBridge,03/23/2013 09:00:00 AM,48,-122,27,39,66
4114,FremontBridge,03/23/2013 10:00:00 AM,48,-122,37,68,105
4115,FremontBridge,03/23/2013 11:00:00 AM,48,-122,53,59,112
4116,FremontBridge,03/23/2013 12:00:00 PM,48,-122,38,82,120
4117,FremontBridge,03/23/2013 01:00:00 PM,48,-122,85,77,162
4118,FremontBridge,03/23/2013 02:00:00 PM,48,-122,94,109,203
4119,FremontBridge,03/23/2013 03:00:00 PM,48,-122,88,114,202
4120,FremontBridge,03/23/2013 04:00:00 PM,48,-122,73,91,164
4121,FremontBridge,03/23/2013 05:00:00 PM,48,-122,73,82,155
4122,FremontBridge,03/23/2013 06:00:00 PM,48,-122,48,60,108
4123,FremontBridge,03/23/2013 07:00:00 PM,48,-122,21,35,56
4124,FremontBridge,03/23/2013 08:00:00 PM,48,-122,26,24,50
4125,FremontBridge,03/23/2013 09:00:00 PM,48,-122,13,11,24
4126,FremontBridge,03/23/2013 10:00:00 PM,48,-122,14,15,29
4127,FremontBridge,03/23/2013 11:00:00 PM,48,-122,15,7,22
4128,FremontBridge,03/24/2013 12:00:00 AM,48,-122,8,4,12
4129,FremontBridge,03/24/2013 01:00:00 AM,48,-122,0,7,7
4130,FremontBridge,03/24/2013 02:00:00 AM,48,-122,5,1,6
4131,FremontBridge,03/24/2013 03:00:00 AM,48,-122,1,3,4
4132,FremontBridge,03/24/2013 04:00:00 AM,48,-122,2,0,2
4133,FremontBridge,03/24/2013 05:00:00 AM,48,-122,1,2,3
4134,FremontBridge,03/24/2013 06:00:00 AM,48,-122,6,3,9
4135,FremontBridge,03/24/2013 07:00:00 AM,48,-122,9,11,20
4136,FremontBridge,03/24/2013 08:00:00 AM,48,-122,17,26,43
4137,FremontBridge,03/24/2013 09:00:00 AM,48,-122,31,35,66
4138,FremontBridge,03/24/2013 10:00:00 AM,48,-122,38,53,91
4139,FremontBridge,03/24/2013 11:00:00 AM,48,-122,42,61,103
4140,FremontBridge,03/24/2013 12:00:00 PM,48,-122,68,60,128
4141,FremontBridge,03/24/2013 01:00:00 PM,48,-122,61,66,127
4142,FremontBridge,03/24/2013 02:00:00 PM,48,-122,74,75,149
4143,FremontBridge,03/24/2013 03:00:00 PM,48,-122,46,70,116
4144,FremontBridge,03/24/2013 04:00:00 PM,48,-122,69,103,172
4145,FremontBridge,03/24/2013 05:00:00 PM,48,-122,52,61,113
4146,FremontBridge,03/24/2013 06:00:00 PM,48,-122,33,49,82
4147,FremontBridge,03/24/2013 07:00:00 PM,48,-122,18,27,45
4148,FremontBridge,03/24/2013 08:00:00 PM,48,-122,19,20,39
4149,FremontBridge,03/24/2013 09:00:00 PM,48,-122,4,8,12
4150,FremontBridge,03/24/2013 10:00:00 PM,48,-122,7,6,13
4151,FremontBridge,03/24/2013 11:00:00 PM,48,-122,8,15,23
4152,FremontBridge,03/25/2013 12:00:00 AM,48,-122,5,3,8
4153,FremontBridge,03/25/2013 01:00:00 AM,48,-122,0,2,2
4154,FremontBridge,03/25/2013 02:00:00 AM,48,-122,0,1,1
4155,FremontBridge,03/25/2013 03:00:00 AM,48,-122,2,1,3
4156,FremontBridge,03/25/2013 04:00:00 AM,48,-122,3,5,8
4157,FremontBridge,03/25/2013 05:00:00 AM,48,-122,10,13,23
4158,FremontBridge,03/25/2013 06:00:00 AM,48,-122,35,82,117
4159,FremontBridge,03/25/2013 07:00:00 AM,48,-122,73,194,267
4160,FremontBridge,03/25/2013 08:00:00 AM,48,-122,108,271,379
4161,FremontBridge,03/25/2013 09:00:00 AM,48,-122,92,140,232
4162,FremontBridge,03/25/2013 10:00:00 AM,48,-122,38,48,86
4163,FremontBridge,03/25/2013 11:00:00 AM,48,-122,29,37,66
4164,FremontBridge,03/25/2013 12:00:00 PM,48,-122,42,58,100
4165,FremontBridge,03/25/2013 01:00:00 PM,48,-122,46,60,106
4166,FremontBridge,03/25/2013 02:00:00 PM,48,-122,65,70,135
4167,FremontBridge,03/25/2013 03:00:00 PM,48,-122,86,85,171
4168,FremontBridge,03/25/2013 04:00:00 PM,48,-122,141,135,276
4169,FremontBridge,03/25/2013 05:00:00 PM,48,-122,333,150,483
4170,FremontBridge,03/25/2013 06:00:00 PM,48,-122,230,125,355
4171,FremontBridge,03/25/2013 07:00:00 PM,48,-122,114,66,180
4172,FremontBridge,03/25/2013 08:00:00 PM,48,-122,50,23,73
4173,FremontBridge,03/25/2013 09:00:00 PM,48,-122,26,14,40
4174,FremontBridge,03/25/2013 10:00:00 PM,48,-122,22,13,35
4175,FremontBridge,03/25/2013 11:00:00 PM,48,-122,10,3,13
4176,FremontBridge,03/26/2013 12:00:00 AM,48,-122,7,6,13
4177,FremontBridge,03/26/2013 01:00:00 AM,48,-122,3,2,5
4178,FremontBridge,03/26/2013 02:00:00 AM,48,-122,0,2,2
4179,FremontBridge,03/26/2013 03:00:00 AM,48,-122,2,0,2
4180,FremontBridge,03/26/2013 04:00:00 AM,48,-122,3,5,8
4181,FremontBridge,03/26/2013 05:00:00 AM,48,-122,8,16,24
4182,FremontBridge,03/26/2013 06:00:00 AM,48,-122,37,87,124
4183,FremontBridge,03/26/2013 07:00:00 AM,48,-122,80,210,290
4184,FremontBridge,03/26/2013 08:00:00 AM,48,-122,115,297,412
4185,FremontBridge,03/26/2013 09:00:00 AM,48,-122,71,135,206
4186,FremontBridge,03/26/2013 10:00:00 AM,48,-122,28,46,74
4187,FremontBridge,03/26/2013 11:00:00 AM,48,-122,25,39,64
4188,FremontBridge,03/26/2013 12:00:00 PM,48,-122,20,37,57
4189,FremontBridge,03/26/2013 01:00:00 PM,48,-122,32,49,81
4190,FremontBridge,03/26/2013 02:00:00 PM,48,-122,45,36,81
4191,FremontBridge,03/26/2013 03:00:00 PM,48,-122,76,63,139
4192,FremontBridge,03/26/2013 04:00:00 PM,48,-122,122,97,219
4193,FremontBridge,03/26/2013 05:00:00 PM,48,-122,348,155,503
4194,FremontBridge,03/26/2013 06:00:00 PM,48,-122,227,132,359
4195,FremontBridge,03/26/2013 07:00:00 PM,48,-122,100,74,174
4196,FremontBridge,03/26/2013 08:00:00 PM,48,-122,44,33,77
4197,FremontBridge,03/26/2013 09:00:00 PM,48,-122,30,26,56
4198,FremontBridge,03/26/2013 10:00:00 PM,48,-122,17,9,26
4199,FremontBridge,03/26/2013 11:00:00 PM,48,-122,12,7,19
4200,FremontBridge,03/27/2013 12:00:00 AM,48,-122,4,8,12
4201,FremontBridge,03/27/2013 01:00:00 AM,48,-122,4,1,5
4202,FremontBridge,03/27/2013 02:00:00 AM,48,-122,1,3,4
4203,FremontBridge,03/27/2013 03:00:00 AM,48,-122,2,0,2
4204,FremontBridge,03/27/2013 04:00:00 AM,48,-122,2,8,10
4205,FremontBridge,03/27/2013 05:00:00 AM,48,-122,9,21,30
4206,FremontBridge,03/27/2013 06:00:00 AM,48,-122,26,84,110
4207,FremontBridge,03/27/2013 07:00:00 AM,48,-122,73,207,280
4208,FremontBridge,03/27/2013 08:00:00 AM,48,-122,103,238,341
4209,FremontBridge,03/27/2013 09:00:00 AM,48,-122,75,137,212
4210,FremontBridge,03/27/2013 10:00:00 AM,48,-122,43,54,97
4211,FremontBridge,03/27/2013 11:00:00 AM,48,-122,29,38,67
4212,FremontBridge,03/27/2013 12:00:00 PM,48,-122,35,37,72
4213,FremontBridge,03/27/2013 01:00:00 PM,48,-122,35,40,75
4214,FremontBridge,03/27/2013 02:00:00 PM,48,-122,48,39,87
4215,FremontBridge,03/27/2013 03:00:00 PM,48,-122,54,51,105
4216,FremontBridge,03/27/2013 04:00:00 PM,48,-122,102,65,167
4217,FremontBridge,03/27/2013 05:00:00 PM,48,-122,248,109,357
4218,FremontBridge,03/27/2013 06:00:00 PM,48,-122,189,100,289
4219,FremontBridge,03/27/2013 07:00:00 PM,48,-122,85,51,136
4220,FremontBridge,03/27/2013 08:00:00 PM,48,-122,54,27,81
4221,FremontBridge,03/27/2013 09:00:00 PM,48,-122,20,17,37
4222,FremontBridge,03/27/2013 10:00:00 PM,48,-122,17,13,30
4223,FremontBridge,03/27/2013 11:00:00 PM,48,-122,6,5,11
4224,FremontBridge,03/28/2013 12:00:00 AM,48,-122,4,6,10
4225,FremontBridge,03/28/2013 01:00:00 AM,48,-122,0,3,3
4226,FremontBridge,03/28/2013 02:00:00 AM,48,-122,3,0,3
4227,FremontBridge,03/28/2013 03:00:00 AM,48,-122,2,1,3
4228,FremontBridge,03/28/2013 04:00:00 AM,48,-122,0,9,9
4229,FremontBridge,03/28/2013 05:00:00 AM,48,-122,5,16,21
4230,FremontBridge,03/28/2013 06:00:00 AM,48,-122,30,54,84
4231,FremontBridge,03/28/2013 07:00:00 AM,48,-122,61,146,207
4232,FremontBridge,03/28/2013 08:00:00 AM,48,-122,94,209,303
4233,FremontBridge,03/28/2013 09:00:00 AM,48,-122,64,125,189
4234,FremontBridge,03/28/2013 10:00:00 AM,48,-122,37,41,78
4235,FremontBridge,03/28/2013 11:00:00 AM,48,-122,30,33,63
4236,FremontBridge,03/28/2013 12:00:00 PM,48,-122,22,49,71
4237,FremontBridge,03/28/2013 01:00:00 PM,48,-122,32,38,70
4238,FremontBridge,03/28/2013 02:00:00 PM,48,-122,43,37,80
4239,FremontBridge,03/28/2013 03:00:00 PM,48,-122,73,79,152
4240,FremontBridge,03/28/2013 04:00:00 PM,48,-122,109,127,236
4241,FremontBridge,03/28/2013 05:00:00 PM,48,-122,298,122,420
4242,FremontBridge,03/28/2013 06:00:00 PM,48,-122,208,129,337
4243,FremontBridge,03/28/2013 07:00:00 PM,48,-122,86,70,156
4244,FremontBridge,03/28/2013 08:00:00 PM,48,-122,52,38,90
4245,FremontBridge,03/28/2013 09:00:00 PM,48,-122,24,19,43
4246,FremontBridge,03/28/2013 10:00:00 PM,48,-122,30,25,55
4247,FremontBridge,03/28/2013 11:00:00 PM,48,-122,15,8,23
4248,FremontBridge,03/29/2013 12:00:00 AM,48,-122,8,6,14
4249,FremontBridge,03/29/2013 01:00:00 AM,48,-122,1,3,4
4250,FremontBridge,03/29/2013 02:00:00 AM,48,-122,2,1,3
4251,FremontBridge,03/29/2013 03:00:00 AM,48,-122,0,0,0
4252,FremontBridge,03/29/2013 04:00:00 AM,48,-122,1,1,2
4253,FremontBridge,03/29/2013 05:00:00 AM,48,-122,6,14,20
4254,FremontBridge,03/29/2013 06:00:00 AM,48,-122,37,73,110
4255,FremontBridge,03/29/2013 07:00:00 AM,48,-122,78,165,243
4256,FremontBridge,03/29/2013 08:00:00 AM,48,-122,93,256,349
4257,FremontBridge,03/29/2013 09:00:00 AM,48,-122,77,144,221
4258,FremontBridge,03/29/2013 10:00:00 AM,48,-122,49,80,129
4259,FremontBridge,03/29/2013 11:00:00 AM,48,-122,38,53,91
4260,FremontBridge,03/29/2013 12:00:00 PM,48,-122,55,60,115
4261,FremontBridge,03/29/2013 01:00:00 PM,48,-122,69,68,137
4262,FremontBridge,03/29/2013 02:00:00 PM,48,-122,73,95,168
4263,FremontBridge,03/29/2013 03:00:00 PM,48,-122,89,96,185
4264,FremontBridge,03/29/2013 04:00:00 PM,48,-122,176,126,302
4265,FremontBridge,03/29/2013 05:00:00 PM,48,-122,283,173,456
4266,FremontBridge,03/29/2013 06:00:00 PM,48,-122,182,138,320
4267,FremontBridge,03/29/2013 07:00:00 PM,48,-122,88,50,138
4268,FremontBridge,03/29/2013 08:00:00 PM,48,-122,42,34,76
4269,FremontBridge,03/29/2013 09:00:00 PM,48,-122,29,16,45
4270,FremontBridge,03/29/2013 10:00:00 PM,48,-122,28,19,47
4271,FremontBridge,03/29/2013 11:00:00 PM,48,-122,22,10,32
4272,FremontBridge,03/30/2013 12:00:00 AM,48,-122,9,12,21
4273,FremontBridge,03/30/2013 01:00:00 AM,48,-122,3,7,10
4274,FremontBridge,03/30/2013 02:00:00 AM,48,-122,3,5,8
4275,FremontBridge,03/30/2013 03:00:00 AM,48,-122,2,2,4
4276,FremontBridge,03/30/2013 04:00:00 AM,48,-122,1,0,1
4277,FremontBridge,03/30/2013 05:00:00 AM,48,-122,2,4,6
4278,FremontBridge,03/30/2013 06:00:00 AM,48,-122,8,11,19
4279,FremontBridge,03/30/2013 07:00:00 AM,48,-122,23,18,41
4280,FremontBridge,03/30/2013 08:00:00 AM,48,-122,28,56,84
4281,FremontBridge,03/30/2013 09:00:00 AM,48,-122,50,70,120
4282,FremontBridge,03/30/2013 10:00:00 AM,48,-122,86,82,168
4283,FremontBridge,03/30/2013 11:00:00 AM,48,-122,64,109,173
4284,FremontBridge,03/30/2013 12:00:00 PM,48,-122,101,149,250
4285,FremontBridge,03/30/2013 01:00:00 PM,48,-122,106,122,228
4286,FremontBridge,03/30/2013 02:00:00 PM,48,-122,129,140,269
4287,FremontBridge,03/30/2013 03:00:00 PM,48,-122,98,146,244
4288,FremontBridge,03/30/2013 04:00:00 PM,48,-122,87,132,219
4289,FremontBridge,03/30/2013 05:00:00 PM,48,-122,118,120,238
4290,FremontBridge,03/30/2013 06:00:00 PM,48,-122,86,72,158
4291,FremontBridge,03/30/2013 07:00:00 PM,48,-122,43,46,89
4292,FremontBridge,03/30/2013 08:00:00 PM,48,-122,24,28,52
4293,FremontBridge,03/30/2013 09:00:00 PM,48,-122,16,12,28
4294,FremontBridge,03/30/2013 10:00:00 PM,48,-122,23,17,40
4295,FremontBridge,03/30/2013 11:00:00 PM,48,-122,22,5,27
4296,FremontBridge,03/31/2013 12:00:00 AM,48,-122,5,14,19
4297,FremontBridge,03/31/2013 01:00:00 AM,48,-122,9,2,11
4298,FremontBridge,03/31/2013 02:00:00 AM,48,-122,7,4,11
4299,FremontBridge,03/31/2013 03:00:00 AM,48,-122,1,3,4
4300,FremontBridge,03/31/2013 04:00:00 AM,48,-122,4,3,7
4301,FremontBridge,03/31/2013 05:00:00 AM,48,-122,0,1,1
4302,FremontBridge,03/31/2013 06:00:00 AM,48,-122,7,5,12
4303,FremontBridge,03/31/2013 07:00:00 AM,48,-122,13,13,26
4304,FremontBridge,03/31/2013 08:00:00 AM,48,-122,19,25,44
4305,FremontBridge,03/31/2013 09:00:00 AM,48,-122,56,51,107
4306,FremontBridge,03/31/2013 10:00:00 AM,48,-122,67,96,163
4307,FremontBridge,03/31/2013 11:00:00 AM,48,-122,92,93,185
4308,FremontBridge,03/31/2013 12:00:00 PM,48,-122,97,99,196
4309,FremontBridge,03/31/2013 01:00:00 PM,48,-122,128,154,282
4310,FremontBridge,03/31/2013 02:00:00 PM,48,-122,101,148,249
4311,FremontBridge,03/31/2013 03:00:00 PM,48,-122,123,128,251
4312,FremontBridge,03/31/2013 04:00:00 PM,48,-122,104,113,217
4313,FremontBridge,03/31/2013 05:00:00 PM,48,-122,101,103,204
4314,FremontBridge,03/31/2013 06:00:00 PM,48,-122,69,101,170
4315,FremontBridge,03/31/2013 07:00:00 PM,48,-122,43,46,89
4316,FremontBridge,03/31/2013 08:00:00 PM,48,-122,12,37,49
4317,FremontBridge,03/31/2013 09:00:00 PM,48,-122,16,21,37
4318,FremontBridge,03/31/2013 10:00:00 PM,48,-122,7,11,18
4319,FremontBridge,03/31/2013 11:00:00 PM,48,-122,7,4,11
4320,FremontBridge,04/01/2013 12:00:00 AM,48,-122,2,4,6
4321,FremontBridge,04/01/2013 01:00:00 AM,48,-122,2,0,2
4322,FremontBridge,04/01/2013 02:00:00 AM,48,-122,2,1,3
4323,FremontBridge,04/01/2013 03:00:00 AM,48,-122,1,0,1
4324,FremontBridge,04/01/2013 04:00:00 AM,48,-122,3,3,6
4325,FremontBridge,04/01/2013 05:00:00 AM,48,-122,7,21,28
4326,FremontBridge,04/01/2013 06:00:00 AM,48,-122,30,92,122
4327,FremontBridge,04/01/2013 07:00:00 AM,48,-122,102,243,345
4328,FremontBridge,04/01/2013 08:00:00 AM,48,-122,136,297,433
4329,FremontBridge,04/01/2013 09:00:00 AM,48,-122,74,167,241
4330,FremontBridge,04/01/2013 10:00:00 AM,48,-122,34,49,83
4331,FremontBridge,04/01/2013 11:00:00 AM,48,-122,30,34,64
4332,FremontBridge,04/01/2013 12:00:00 PM,48,-122,31,37,68
4333,FremontBridge,04/01/2013 01:00:00 PM,48,-122,39,46,85
4334,FremontBridge,04/01/2013 02:00:00 PM,48,-122,44,44,88
4335,FremontBridge,04/01/2013 03:00:00 PM,48,-122,58,70,128
4336,FremontBridge,04/01/2013 04:00:00 PM,48,-122,139,109,248
4337,FremontBridge,04/01/2013 05:00:00 PM,48,-122,394,163,557
4338,FremontBridge,04/01/2013 06:00:00 PM,48,-122,249,132,381
4339,FremontBridge,04/01/2013 07:00:00 PM,48,-122,112,70,182
4340,FremontBridge,04/01/2013 08:00:00 PM,48,-122,52,39,91
4341,FremontBridge,04/01/2013 09:00:00 PM,48,-122,17,23,40
4342,FremontBridge,04/01/2013 10:00:00 PM,48,-122,16,5,21
4343,FremontBridge,04/01/2013 11:00:00 PM,48,-122,20,5,25
4344,FremontBridge,04/02/2013 12:00:00 AM,48,-122,3,7,10
4345,FremontBridge,04/02/2013 01:00:00 AM,48,-122,3,2,5
4346,FremontBridge,04/02/2013 02:00:00 AM,48,-122,2,2,4
4347,FremontBridge,04/02/2013 03:00:00 AM,48,-122,1,0,1
4348,FremontBridge,04/02/2013 04:00:00 AM,48,-122,2,1,3
4349,FremontBridge,04/02/2013 05:00:00 AM,48,-122,11,25,36
4350,FremontBridge,04/02/2013 06:00:00 AM,48,-122,40,83,123
4351,FremontBridge,04/02/2013 07:00:00 AM,48,-122,81,231,312
4352,FremontBridge,04/02/2013 08:00:00 AM,48,-122,125,339,464
4353,FremontBridge,04/02/2013 09:00:00 AM,48,-122,111,151,262
4354,FremontBridge,04/02/2013 10:00:00 AM,48,-122,35,46,81
4355,FremontBridge,04/02/2013 11:00:00 AM,48,-122,30,40,70
4356,FremontBridge,04/02/2013 12:00:00 PM,48,-122,31,34,65
4357,FremontBridge,04/02/2013 01:00:00 PM,48,-122,34,56,90
4358,FremontBridge,04/02/2013 02:00:00 PM,48,-122,69,49,118
4359,FremontBridge,04/02/2013 03:00:00 PM,48,-122,68,58,126
4360,FremontBridge,04/02/2013 04:00:00 PM,48,-122,141,100,241
4361,FremontBridge,04/02/2013 05:00:00 PM,48,-122,360,171,531
4362,FremontBridge,04/02/2013 06:00:00 PM,48,-122,255,144,399
4363,FremontBridge,04/02/2013 07:00:00 PM,48,-122,91,65,156
4364,FremontBridge,04/02/2013 08:00:00 PM,48,-122,49,26,75
4365,FremontBridge,04/02/2013 09:00:00 PM,48,-122,36,31,67
4366,FremontBridge,04/02/2013 10:00:00 PM,48,-122,16,16,32
4367,FremontBridge,04/02/2013 11:00:00 PM,48,-122,8,8,16
4368,FremontBridge,04/03/2013 12:00:00 AM,48,-122,7,6,13
4369,FremontBridge,04/03/2013 01:00:00 AM,48,-122,2,7,9
4370,FremontBridge,04/03/2013 02:00:00 AM,48,-122,1,2,3
4371,FremontBridge,04/03/2013 03:00:00 AM,48,-122,2,1,3
4372,FremontBridge,04/03/2013 04:00:00 AM,48,-122,2,7,9
4373,FremontBridge,04/03/2013 05:00:00 AM,48,-122,9,15,24
4374,FremontBridge,04/03/2013 06:00:00 AM,48,-122,32,76,108
4375,FremontBridge,04/03/2013 07:00:00 AM,48,-122,97,236,333
4376,FremontBridge,04/03/2013 08:00:00 AM,48,-122,135,294,429
4377,FremontBridge,04/03/2013 09:00:00 AM,48,-122,88,142,230
4378,FremontBridge,04/03/2013 10:00:00 AM,48,-122,42,66,108
4379,FremontBridge,04/03/2013 11:00:00 AM,48,-122,45,58,103
4380,FremontBridge,04/03/2013 12:00:00 PM,48,-122,54,59,113
4381,FremontBridge,04/03/2013 01:00:00 PM,48,-122,47,58,105
4382,FremontBridge,04/03/2013 02:00:00 PM,48,-122,56,52,108
4383,FremontBridge,04/03/2013 03:00:00 PM,48,-122,66,66,132
4384,FremontBridge,04/03/2013 04:00:00 PM,48,-122,173,115,288
4385,FremontBridge,04/03/2013 05:00:00 PM,48,-122,369,158,527
4386,FremontBridge,04/03/2013 06:00:00 PM,48,-122,263,149,412
4387,FremontBridge,04/03/2013 07:00:00 PM,48,-122,124,86,210
4388,FremontBridge,04/03/2013 08:00:00 PM,48,-122,61,36,97
4389,FremontBridge,04/03/2013 09:00:00 PM,48,-122,40,25,65
4390,FremontBridge,04/03/2013 10:00:00 PM,48,-122,20,15,35
4391,FremontBridge,04/03/2013 11:00:00 PM,48,-122,12,10,22
4392,FremontBridge,04/04/2013 12:00:00 AM,48,-122,5,5,10
4393,FremontBridge,04/04/2013 01:00:00 AM,48,-122,3,2,5
4394,FremontBridge,04/04/2013 02:00:00 AM,48,-122,6,2,8
4395,FremontBridge,04/04/2013 03:00:00 AM,48,-122,2,0,2
4396,FremontBridge,04/04/2013 04:00:00 AM,48,-122,1,3,4
4397,FremontBridge,04/04/2013 05:00:00 AM,48,-122,9,21,30
4398,FremontBridge,04/04/2013 06:00:00 AM,48,-122,31,73,104
4399,FremontBridge,04/04/2013 07:00:00 AM,48,-122,66,154,220
4400,FremontBridge,04/04/2013 08:00:00 AM,48,-122,90,210,300
4401,FremontBridge,04/04/2013 09:00:00 AM,48,-122,66,93,159
4402,FremontBridge,04/04/2013 10:00:00 AM,48,-122,28,58,86
4403,FremontBridge,04/04/2013 11:00:00 AM,48,-122,21,32,53
4404,FremontBridge,04/04/2013 12:00:00 PM,48,-122,15,20,35
4405,FremontBridge,04/04/2013 01:00:00 PM,48,-122,20,20,40
4406,FremontBridge,04/04/2013 02:00:00 PM,48,-122,38,19,57
4407,FremontBridge,04/04/2013 03:00:00 PM,48,-122,37,22,59
4408,FremontBridge,04/04/2013 04:00:00 PM,48,-122,82,49,131
4409,FremontBridge,04/04/2013 05:00:00 PM,48,-122,186,79,265
4410,FremontBridge,04/04/2013 06:00:00 PM,48,-122,161,93,254
4411,FremontBridge,04/04/2013 07:00:00 PM,48,-122,56,20,76
4412,FremontBridge,04/04/2013 08:00:00 PM,48,-122,23,13,36
4413,FremontBridge,04/04/2013 09:00:00 PM,48,-122,26,10,36
4414,FremontBridge,04/04/2013 10:00:00 PM,48,-122,10,8,18
4415,FremontBridge,04/04/2013 11:00:00 PM,48,-122,9,10,19
4416,FremontBridge,04/05/2013 12:00:00 AM,48,-122,1,5,6
4417,FremontBridge,04/05/2013 01:00:00 AM,48,-122,2,1,3
4418,FremontBridge,04/05/2013 02:00:00 AM,48,-122,1,2,3
4419,FremontBridge,04/05/2013 03:00:00 AM,48,-122,0,0,0
4420,FremontBridge,04/05/2013 04:00:00 AM,48,-122,1,1,2
4421,FremontBridge,04/05/2013 05:00:00 AM,48,-122,8,7,15
4422,FremontBridge,04/05/2013 06:00:00 AM,48,-122,22,43,65
4423,FremontBridge,04/05/2013 07:00:00 AM,48,-122,53,95,148
4424,FremontBridge,04/05/2013 08:00:00 AM,48,-122,84,189,273
4425,FremontBridge,04/05/2013 09:00:00 AM,48,-122,41,99,140
4426,FremontBridge,04/05/2013 10:00:00 AM,48,-122,41,32,73
4427,FremontBridge,04/05/2013 11:00:00 AM,48,-122,21,38,59
4428,FremontBridge,04/05/2013 12:00:00 PM,48,-122,29,42,71
4429,FremontBridge,04/05/2013 01:00:00 PM,48,-122,22,31,53
4430,FremontBridge,04/05/2013 02:00:00 PM,48,-122,39,33,72
4431,FremontBridge,04/05/2013 03:00:00 PM,48,-122,46,38,84
4432,FremontBridge,04/05/2013 04:00:00 PM,48,-122,93,63,156
4433,FremontBridge,04/05/2013 05:00:00 PM,48,-122,213,76,289
4434,FremontBridge,04/05/2013 06:00:00 PM,48,-122,106,55,161
4435,FremontBridge,04/05/2013 07:00:00 PM,48,-122,36,33,69
4436,FremontBridge,04/05/2013 08:00:00 PM,48,-122,27,7,34
4437,FremontBridge,04/05/2013 09:00:00 PM,48,-122,17,10,27
4438,FremontBridge,04/05/2013 10:00:00 PM,48,-122,14,6,20
4439,FremontBridge,04/05/2013 11:00:00 PM,48,-122,11,8,19
4440,FremontBridge,04/06/2013 12:00:00 AM,48,-122,5,3,8
4441,FremontBridge,04/06/2013 01:00:00 AM,48,-122,1,2,3
4442,FremontBridge,04/06/2013 02:00:00 AM,48,-122,1,2,3
4443,FremontBridge,04/06/2013 03:00:00 AM,48,-122,0,3,3
4444,FremontBridge,04/06/2013 04:00:00 AM,48,-122,1,1,2
4445,FremontBridge,04/06/2013 05:00:00 AM,48,-122,1,3,4
4446,FremontBridge,04/06/2013 06:00:00 AM,48,-122,9,9,18
4447,FremontBridge,04/06/2013 07:00:00 AM,48,-122,7,13,20
4448,FremontBridge,04/06/2013 08:00:00 AM,48,-122,28,29,57
4449,FremontBridge,04/06/2013 09:00:00 AM,48,-122,27,36,63
4450,FremontBridge,04/06/2013 10:00:00 AM,48,-122,39,64,103
4451,FremontBridge,04/06/2013 11:00:00 AM,48,-122,37,51,88
4452,FremontBridge,04/06/2013 12:00:00 PM,48,-122,26,38,64
4453,FremontBridge,04/06/2013 01:00:00 PM,48,-122,9,12,21
4454,FremontBridge,04/06/2013 02:00:00 PM,48,-122,25,18,43
4455,FremontBridge,04/06/2013 03:00:00 PM,48,-122,28,21,49
4456,FremontBridge,04/06/2013 04:00:00 PM,48,-122,35,33,68
4457,FremontBridge,04/06/2013 05:00:00 PM,48,-122,17,24,41
4458,FremontBridge,04/06/2013 06:00:00 PM,48,-122,16,22,38
4459,FremontBridge,04/06/2013 07:00:00 PM,48,-122,12,19,31
4460,FremontBridge,04/06/2013 08:00:00 PM,48,-122,11,10,21
4461,FremontBridge,04/06/2013 09:00:00 PM,48,-122,13,7,20
4462,FremontBridge,04/06/2013 10:00:00 PM,48,-122,8,5,13
4463,FremontBridge,04/06/2013 11:00:00 PM,48,-122,4,4,8
4464,FremontBridge,04/07/2013 12:00:00 AM,48,-122,2,2,4
4465,FremontBridge,04/07/2013 01:00:00 AM,48,-122,3,4,7
4466,FremontBridge,04/07/2013 02:00:00 AM,48,-122,3,1,4
4467,FremontBridge,04/07/2013 03:00:00 AM,48,-122,4,1,5
4468,FremontBridge,04/07/2013 04:00:00 AM,48,-122,3,0,3
4469,FremontBridge,04/07/2013 05:00:00 AM,48,-122,0,2,2
4470,FremontBridge,04/07/2013 06:00:00 AM,48,-122,4,2,6
4471,FremontBridge,04/07/2013 07:00:00 AM,48,-122,3,5,8
4472,FremontBridge,04/07/2013 08:00:00 AM,48,-122,13,12,25
4473,FremontBridge,04/07/2013 09:00:00 AM,48,-122,7,63,70
4474,FremontBridge,04/07/2013 10:00:00 AM,48,-122,44,19,63
4475,FremontBridge,04/07/2013 11:00:00 AM,48,-122,13,21,34
4476,FremontBridge,04/07/2013 12:00:00 PM,48,-122,16,28,44
4477,FremontBridge,04/07/2013 01:00:00 PM,48,-122,18,16,34
4478,FremontBridge,04/07/2013 02:00:00 PM,48,-122,20,21,41
4479,FremontBridge,04/07/2013 03:00:00 PM,48,-122,21,20,41
4480,FremontBridge,04/07/2013 04:00:00 PM,48,-122,19,25,44
4481,FremontBridge,04/07/2013 05:00:00 PM,48,-122,18,23,41
4482,FremontBridge,04/07/2013 06:00:00 PM,48,-122,19,11,30
4483,FremontBridge,04/07/2013 07:00:00 PM,48,-122,13,15,28
4484,FremontBridge,04/07/2013 08:00:00 PM,48,-122,8,5,13
4485,FremontBridge,04/07/2013 09:00:00 PM,48,-122,4,7,11
4486,FremontBridge,04/07/2013 10:00:00 PM,48,-122,4,9,13
4487,FremontBridge,04/07/2013 11:00:00 PM,48,-122,4,2,6
4488,FremontBridge,04/08/2013 12:00:00 AM,48,-122,1,3,4
4489,FremontBridge,04/08/2013 01:00:00 AM,48,-122,1,1,2
4490,FremontBridge,04/08/2013 02:00:00 AM,48,-122,0,3,3
4491,FremontBridge,04/08/2013 03:00:00 AM,48,-122,0,0,0
4492,FremontBridge,04/08/2013 04:00:00 AM,48,-122,2,5,7
4493,FremontBridge,04/08/2013 05:00:00 AM,48,-122,3,14,17
4494,FremontBridge,04/08/2013 06:00:00 AM,48,-122,25,72,97
4495,FremontBridge,04/08/2013 07:00:00 AM,48,-122,62,171,233
4496,FremontBridge,04/08/2013 08:00:00 AM,48,-122,112,233,345
4497,FremontBridge,04/08/2013 09:00:00 AM,48,-122,62,125,187
4498,FremontBridge,04/08/2013 10:00:00 AM,48,-122,31,57,88
4499,FremontBridge,04/08/2013 11:00:00 AM,48,-122,27,38,65
4500,FremontBridge,04/08/2013 12:00:00 PM,48,-122,44,32,76
4501,FremontBridge,04/08/2013 01:00:00 PM,48,-122,34,46,80
4502,FremontBridge,04/08/2013 02:00:00 PM,48,-122,53,45,98
4503,FremontBridge,04/08/2013 03:00:00 PM,48,-122,63,50,113
4504,FremontBridge,04/08/2013 04:00:00 PM,48,-122,110,89,199
4505,FremontBridge,04/08/2013 05:00:00 PM,48,-122,312,135,447
4506,FremontBridge,04/08/2013 06:00:00 PM,48,-122,212,96,308
4507,FremontBridge,04/08/2013 07:00:00 PM,48,-122,103,53,156
4508,FremontBridge,04/08/2013 08:00:00 PM,48,-122,36,29,65
4509,FremontBridge,04/08/2013 09:00:00 PM,48,-122,27,22,49
4510,FremontBridge,04/08/2013 10:00:00 PM,48,-122,17,9,26
4511,FremontBridge,04/08/2013 11:00:00 PM,48,-122,18,6,24
4512,FremontBridge,04/09/2013 12:00:00 AM,48,-122,7,7,14
4513,FremontBridge,04/09/2013 01:00:00 AM,48,-122,3,2,5
4514,FremontBridge,04/09/2013 02:00:00 AM,48,-122,1,1,2
4515,FremontBridge,04/09/2013 03:00:00 AM,48,-122,0,3,3
4516,FremontBridge,04/09/2013 04:00:00 AM,48,-122,2,5,7
4517,FremontBridge,04/09/2013 05:00:00 AM,48,-122,6,16,22
4518,FremontBridge,04/09/2013 06:00:00 AM,48,-122,43,82,125
4519,FremontBridge,04/09/2013 07:00:00 AM,48,-122,83,238,321
4520,FremontBridge,04/09/2013 08:00:00 AM,48,-122,98,257,355
4521,FremontBridge,04/09/2013 09:00:00 AM,48,-122,79,139,218
4522,FremontBridge,04/09/2013 10:00:00 AM,48,-122,35,72,107
4523,FremontBridge,04/09/2013 11:00:00 AM,48,-122,28,34,62
4524,FremontBridge,04/09/2013 12:00:00 PM,48,-122,27,22,49
4525,FremontBridge,04/09/2013 01:00:00 PM,48,-122,26,39,65
4526,FremontBridge,04/09/2013 02:00:00 PM,48,-122,40,41,81
4527,FremontBridge,04/09/2013 03:00:00 PM,48,-122,56,58,114
4528,FremontBridge,04/09/2013 04:00:00 PM,48,-122,142,90,232
4529,FremontBridge,04/09/2013 05:00:00 PM,48,-122,348,126,474
4530,FremontBridge,04/09/2013 06:00:00 PM,48,-122,213,122,335
4531,FremontBridge,04/09/2013 07:00:00 PM,48,-122,71,72,143
4532,FremontBridge,04/09/2013 08:00:00 PM,48,-122,37,30,67
4533,FremontBridge,04/09/2013 09:00:00 PM,48,-122,33,20,53
4534,FremontBridge,04/09/2013 10:00:00 PM,48,-122,10,21,31
4535,FremontBridge,04/09/2013 11:00:00 PM,48,-122,8,7,15
4536,FremontBridge,04/10/2013 12:00:00 AM,48,-122,6,5,11
4537,FremontBridge,04/10/2013 01:00:00 AM,48,-122,3,1,4
4538,FremontBridge,04/10/2013 02:00:00 AM,48,-122,1,2,3
4539,FremontBridge,04/10/2013 03:00:00 AM,48,-122,1,0,1
4540,FremontBridge,04/10/2013 04:00:00 AM,48,-122,1,8,9
4541,FremontBridge,04/10/2013 05:00:00 AM,48,-122,11,21,32
4542,FremontBridge,04/10/2013 06:00:00 AM,48,-122,37,68,105
4543,FremontBridge,04/10/2013 07:00:00 AM,48,-122,63,131,194
4544,FremontBridge,04/10/2013 08:00:00 AM,48,-122,83,169,252
4545,FremontBridge,04/10/2013 09:00:00 AM,48,-122,36,81,117
4546,FremontBridge,04/10/2013 10:00:00 AM,48,-122,14,35,49
4547,FremontBridge,04/10/2013 11:00:00 AM,48,-122,18,9,27
4548,FremontBridge,04/10/2013 12:00:00 PM,48,-122,22,28,50
4549,FremontBridge,04/10/2013 01:00:00 PM,48,-122,25,40,65
4550,FremontBridge,04/10/2013 02:00:00 PM,48,-122,40,32,72
4551,FremontBridge,04/10/2013 03:00:00 PM,48,-122,41,47,88
4552,FremontBridge,04/10/2013 04:00:00 PM,48,-122,98,66,164
4553,FremontBridge,04/10/2013 05:00:00 PM,48,-122,219,93,312
4554,FremontBridge,04/10/2013 06:00:00 PM,48,-122,165,107,272
4555,FremontBridge,04/10/2013 07:00:00 PM,48,-122,72,48,120
4556,FremontBridge,04/10/2013 08:00:00 PM,48,-122,48,23,71
4557,FremontBridge,04/10/2013 09:00:00 PM,48,-122,23,25,48
4558,FremontBridge,04/10/2013 10:00:00 PM,48,-122,14,13,27
4559,FremontBridge,04/10/2013 11:00:00 PM,48,-122,13,7,20
4560,FremontBridge,04/11/2013 12:00:00 AM,48,-122,3,26,29
4561,FremontBridge,04/11/2013 01:00:00 AM,48,-122,10,4,14
4562,FremontBridge,04/11/2013 02:00:00 AM,48,-122,1,3,4
4563,FremontBridge,04/11/2013 03:00:00 AM,48,-122,4,0,4
4564,FremontBridge,04/11/2013 04:00:00 AM,48,-122,0,3,3
4565,FremontBridge,04/11/2013 05:00:00 AM,48,-122,9,23,32
4566,FremontBridge,04/11/2013 06:00:00 AM,48,-122,33,83,116
4567,FremontBridge,04/11/2013 07:00:00 AM,48,-122,69,162,231
4568,FremontBridge,04/11/2013 08:00:00 AM,48,-122,109,251,360
4569,FremontBridge,04/11/2013 09:00:00 AM,48,-122,45,98,143
4570,FremontBridge,04/11/2013 10:00:00 AM,48,-122,27,32,59
4571,FremontBridge,04/11/2013 11:00:00 AM,48,-122,17,36,53
4572,FremontBridge,04/11/2013 12:00:00 PM,48,-122,17,29,46
4573,FremontBridge,04/11/2013 01:00:00 PM,48,-122,30,31,61
4574,FremontBridge,04/11/2013 02:00:00 PM,48,-122,31,32,63
4575,FremontBridge,04/11/2013 03:00:00 PM,48,-122,36,54,90
4576,FremontBridge,04/11/2013 04:00:00 PM,48,-122,119,83,202
4577,FremontBridge,04/11/2013 05:00:00 PM,48,-122,264,115,379
4578,FremontBridge,04/11/2013 06:00:00 PM,48,-122,208,94,302
4579,FremontBridge,04/11/2013 07:00:00 PM,48,-122,73,51,124
4580,FremontBridge,04/11/2013 08:00:00 PM,48,-122,54,35,89
4581,FremontBridge,04/11/2013 09:00:00 PM,48,-122,22,14,36
4582,FremontBridge,04/11/2013 10:00:00 PM,48,-122,23,15,38
4583,FremontBridge,04/11/2013 11:00:00 PM,48,-122,11,10,21
4584,FremontBridge,04/12/2013 12:00:00 AM,48,-122,1,2,3
4585,FremontBridge,04/12/2013 01:00:00 AM,48,-122,4,11,15
4586,FremontBridge,04/12/2013 02:00:00 AM,48,-122,2,1,3
4587,FremontBridge,04/12/2013 03:00:00 AM,48,-122,0,0,0
4588,FremontBridge,04/12/2013 04:00:00 AM,48,-122,1,2,3
4589,FremontBridge,04/12/2013 05:00:00 AM,48,-122,7,14,21
4590,FremontBridge,04/12/2013 06:00:00 AM,48,-122,33,62,95
4591,FremontBridge,04/12/2013 07:00:00 AM,48,-122,62,161,223
4592,FremontBridge,04/12/2013 08:00:00 AM,48,-122,90,221,311
4593,FremontBridge,04/12/2013 09:00:00 AM,48,-122,64,118,182
4594,FremontBridge,04/12/2013 10:00:00 AM,48,-122,32,58,90
4595,FremontBridge,04/12/2013 11:00:00 AM,48,-122,30,46,76
4596,FremontBridge,04/12/2013 12:00:00 PM,48,-122,29,37,66
4597,FremontBridge,04/12/2013 01:00:00 PM,48,-122,37,33,70
4598,FremontBridge,04/12/2013 02:00:00 PM,48,-122,29,25,54
4599,FremontBridge,04/12/2013 03:00:00 PM,48,-122,36,22,58
4600,FremontBridge,04/12/2013 04:00:00 PM,48,-122,113,44,157
4601,FremontBridge,04/12/2013 05:00:00 PM,48,-122,199,78,277
4602,FremontBridge,04/12/2013 06:00:00 PM,48,-122,136,56,192
4603,FremontBridge,04/12/2013 07:00:00 PM,48,-122,39,21,60
4604,FremontBridge,04/12/2013 08:00:00 PM,48,-122,28,8,36
4605,FremontBridge,04/12/2013 09:00:00 PM,48,-122,9,7,16
4606,FremontBridge,04/12/2013 10:00:00 PM,48,-122,8,8,16
4607,FremontBridge,04/12/2013 11:00:00 PM,48,-122,9,12,21
4608,FremontBridge,04/13/2013 12:00:00 AM,48,-122,5,4,9
4609,FremontBridge,04/13/2013 01:00:00 AM,48,-122,6,1,7
4610,FremontBridge,04/13/2013 02:00:00 AM,48,-122,1,1,2
4611,FremontBridge,04/13/2013 03:00:00 AM,48,-122,0,3,3
4612,FremontBridge,04/13/2013 04:00:00 AM,48,-122,1,0,1
4613,FremontBridge,04/13/2013 05:00:00 AM,48,-122,0,6,6
4614,FremontBridge,04/13/2013 06:00:00 AM,48,-122,5,7,12
4615,FremontBridge,04/13/2013 07:00:00 AM,48,-122,11,13,24
4616,FremontBridge,04/13/2013 08:00:00 AM,48,-122,27,30,57
4617,FremontBridge,04/13/2013 09:00:00 AM,48,-122,28,36,64
4618,FremontBridge,04/13/2013 10:00:00 AM,48,-122,22,46,68
4619,FremontBridge,04/13/2013 11:00:00 AM,48,-122,34,52,86
4620,FremontBridge,04/13/2013 12:00:00 PM,48,-122,31,62,93
4621,FremontBridge,04/13/2013 01:00:00 PM,48,-122,26,45,71
4622,FremontBridge,04/13/2013 02:00:00 PM,48,-122,30,43,73
4623,FremontBridge,04/13/2013 03:00:00 PM,48,-122,31,48,79
4624,FremontBridge,04/13/2013 04:00:00 PM,48,-122,25,23,48
4625,FremontBridge,04/13/2013 05:00:00 PM,48,-122,18,19,37
4626,FremontBridge,04/13/2013 06:00:00 PM,48,-122,25,14,39
4627,FremontBridge,04/13/2013 07:00:00 PM,48,-122,6,8,14
4628,FremontBridge,04/13/2013 08:00:00 PM,48,-122,8,7,15
4629,FremontBridge,04/13/2013 09:00:00 PM,48,-122,6,6,12
4630,FremontBridge,04/13/2013 10:00:00 PM,48,-122,9,7,16
4631,FremontBridge,04/13/2013 11:00:00 PM,48,-122,5,5,10
4632,FremontBridge,04/14/2013 12:00:00 AM,48,-122,4,3,7
4633,FremontBridge,04/14/2013 01:00:00 AM,48,-122,0,2,2
4634,FremontBridge,04/14/2013 02:00:00 AM,48,-122,3,2,5
4635,FremontBridge,04/14/2013 03:00:00 AM,48,-122,2,1,3
4636,FremontBridge,04/14/2013 04:00:00 AM,48,-122,2,1,3
4637,FremontBridge,04/14/2013 05:00:00 AM,48,-122,0,2,2
4638,FremontBridge,04/14/2013 06:00:00 AM,48,-122,3,1,4
4639,FremontBridge,04/14/2013 07:00:00 AM,48,-122,7,11,18
4640,FremontBridge,04/14/2013 08:00:00 AM,48,-122,20,7,27
4641,FremontBridge,04/14/2013 09:00:00 AM,48,-122,22,42,64
4642,FremontBridge,04/14/2013 10:00:00 AM,48,-122,39,39,78
4643,FremontBridge,04/14/2013 11:00:00 AM,48,-122,48,61,109
4644,FremontBridge,04/14/2013 12:00:00 PM,48,-122,71,73,144
4645,FremontBridge,04/14/2013 01:00:00 PM,48,-122,60,83,143
4646,FremontBridge,04/14/2013 02:00:00 PM,48,-122,75,83,158
4647,FremontBridge,04/14/2013 03:00:00 PM,48,-122,80,81,161
4648,FremontBridge,04/14/2013 04:00:00 PM,48,-122,60,91,151
4649,FremontBridge,04/14/2013 05:00:00 PM,48,-122,61,76,137
4650,FremontBridge,04/14/2013 06:00:00 PM,48,-122,46,58,104
4651,FremontBridge,04/14/2013 07:00:00 PM,48,-122,19,45,64
4652,FremontBridge,04/14/2013 08:00:00 PM,48,-122,6,28,34
4653,FremontBridge,04/14/2013 09:00:00 PM,48,-122,9,14,23
4654,FremontBridge,04/14/2013 10:00:00 PM,48,-122,10,4,14
4655,FremontBridge,04/14/2013 11:00:00 PM,48,-122,5,4,9
4656,FremontBridge,04/15/2013 12:00:00 AM,48,-122,2,6,8
4657,FremontBridge,04/15/2013 01:00:00 AM,48,-122,1,3,4
4658,FremontBridge,04/15/2013 02:00:00 AM,48,-122,0,1,1
4659,FremontBridge,04/15/2013 03:00:00 AM,48,-122,0,2,2
4660,FremontBridge,04/15/2013 04:00:00 AM,48,-122,1,6,7
4661,FremontBridge,04/15/2013 05:00:00 AM,48,-122,5,23,28
4662,FremontBridge,04/15/2013 06:00:00 AM,48,-122,31,88,119
4663,FremontBridge,04/15/2013 07:00:00 AM,48,-122,66,158,224
4664,FremontBridge,04/15/2013 08:00:00 AM,48,-122,88,219,307
4665,FremontBridge,04/15/2013 09:00:00 AM,48,-122,78,126,204
4666,FremontBridge,04/15/2013 10:00:00 AM,48,-122,33,57,90
4667,FremontBridge,04/15/2013 11:00:00 AM,48,-122,23,47,70
4668,FremontBridge,04/15/2013 12:00:00 PM,48,-122,21,49,70
4669,FremontBridge,04/15/2013 01:00:00 PM,48,-122,31,38,69
4670,FremontBridge,04/15/2013 02:00:00 PM,48,-122,49,48,97
4671,FremontBridge,04/15/2013 03:00:00 PM,48,-122,50,63,113
4672,FremontBridge,04/15/2013 04:00:00 PM,48,-122,118,99,217
4673,FremontBridge,04/15/2013 05:00:00 PM,48,-122,267,143,410
4674,FremontBridge,04/15/2013 06:00:00 PM,48,-122,234,138,372
4675,FremontBridge,04/15/2013 07:00:00 PM,48,-122,72,55,127
4676,FremontBridge,04/15/2013 08:00:00 PM,48,-122,40,27,67
4677,FremontBridge,04/15/2013 09:00:00 PM,48,-122,22,17,39
4678,FremontBridge,04/15/2013 10:00:00 PM,48,-122,14,14,28
4679,FremontBridge,04/15/2013 11:00:00 PM,48,-122,8,6,14
4680,FremontBridge,04/16/2013 12:00:00 AM,48,-122,8,4,12
4681,FremontBridge,04/16/2013 01:00:00 AM,48,-122,2,1,3
4682,FremontBridge,04/16/2013 02:00:00 AM,48,-122,0,1,1
4683,FremontBridge,04/16/2013 03:00:00 AM,48,-122,0,0,0
4684,FremontBridge,04/16/2013 04:00:00 AM,48,-122,1,5,6
4685,FremontBridge,04/16/2013 05:00:00 AM,48,-122,6,21,27
4686,FremontBridge,04/16/2013 06:00:00 AM,48,-122,42,87,129
4687,FremontBridge,04/16/2013 07:00:00 AM,48,-122,83,215,298
4688,FremontBridge,04/16/2013 08:00:00 AM,48,-122,117,235,352
4689,FremontBridge,04/16/2013 09:00:00 AM,48,-122,87,124,211
4690,FremontBridge,04/16/2013 10:00:00 AM,48,-122,29,42,71
4691,FremontBridge,04/16/2013 11:00:00 AM,48,-122,28,53,81
4692,FremontBridge,04/16/2013 12:00:00 PM,48,-122,31,43,74
4693,FremontBridge,04/16/2013 01:00:00 PM,48,-122,35,47,82
4694,FremontBridge,04/16/2013 02:00:00 PM,48,-122,55,58,113
4695,FremontBridge,04/16/2013 03:00:00 PM,48,-122,78,72,150
4696,FremontBridge,04/16/2013 04:00:00 PM,48,-122,147,87,234
4697,FremontBridge,04/16/2013 05:00:00 PM,48,-122,280,130,410
4698,FremontBridge,04/16/2013 06:00:00 PM,48,-122,247,130,377
4699,FremontBridge,04/16/2013 07:00:00 PM,48,-122,96,100,196
4700,FremontBridge,04/16/2013 08:00:00 PM,48,-122,60,44,104
4701,FremontBridge,04/16/2013 09:00:00 PM,48,-122,40,34,74
4702,FremontBridge,04/16/2013 10:00:00 PM,48,-122,17,23,40
4703,FremontBridge,04/16/2013 11:00:00 PM,48,-122,21,10,31
4704,FremontBridge,04/17/2013 12:00:00 AM,48,-122,6,5,11
4705,FremontBridge,04/17/2013 01:00:00 AM,48,-122,3,2,5
4706,FremontBridge,04/17/2013 02:00:00 AM,48,-122,3,1,4
4707,FremontBridge,04/17/2013 03:00:00 AM,48,-122,1,1,2
4708,FremontBridge,04/17/2013 04:00:00 AM,48,-122,2,5,7
4709,FremontBridge,04/17/2013 05:00:00 AM,48,-122,7,22,29
4710,FremontBridge,04/17/2013 06:00:00 AM,48,-122,38,85,123
4711,FremontBridge,04/17/2013 07:00:00 AM,48,-122,89,185,274
4712,FremontBridge,04/17/2013 08:00:00 AM,48,-122,104,253,357
4713,FremontBridge,04/17/2013 09:00:00 AM,48,-122,83,124,207
4714,FremontBridge,04/17/2013 10:00:00 AM,48,-122,37,54,91
4715,FremontBridge,04/17/2013 11:00:00 AM,48,-122,47,46,93
4716,FremontBridge,04/17/2013 12:00:00 PM,48,-122,36,43,79
4717,FremontBridge,04/17/2013 01:00:00 PM,48,-122,55,47,102
4718,FremontBridge,04/17/2013 02:00:00 PM,48,-122,47,58,105
4719,FremontBridge,04/17/2013 03:00:00 PM,48,-122,60,72,132
4720,FremontBridge,04/17/2013 04:00:00 PM,48,-122,124,91,215
4721,FremontBridge,04/17/2013 05:00:00 PM,48,-122,285,135,420
4722,FremontBridge,04/17/2013 06:00:00 PM,48,-122,183,141,324
4723,FremontBridge,04/17/2013 07:00:00 PM,48,-122,106,93,199
4724,FremontBridge,04/17/2013 08:00:00 PM,48,-122,52,27,79
4725,FremontBridge,04/17/2013 09:00:00 PM,48,-122,21,16,37
4726,FremontBridge,04/17/2013 10:00:00 PM,48,-122,16,13,29
4727,FremontBridge,04/17/2013 11:00:00 PM,48,-122,11,4,15
4728,FremontBridge,04/18/2013 12:00:00 AM,48,-122,2,4,6
4729,FremontBridge,04/18/2013 01:00:00 AM,48,-122,4,2,6
4730,FremontBridge,04/18/2013 02:00:00 AM,48,-122,1,2,3
4731,FremontBridge,04/18/2013 03:00:00 AM,48,-122,0,3,3
4732,FremontBridge,04/18/2013 04:00:00 AM,48,-122,3,1,4
4733,FremontBridge,04/18/2013 05:00:00 AM,48,-122,10,13,23
4734,FremontBridge,04/18/2013 06:00:00 AM,48,-122,44,59,103
4735,FremontBridge,04/18/2013 07:00:00 AM,48,-122,48,140,188
4736,FremontBridge,04/18/2013 08:00:00 AM,48,-122,79,193,272
4737,FremontBridge,04/18/2013 09:00:00 AM,48,-122,71,101,172
4738,FremontBridge,04/18/2013 10:00:00 AM,48,-122,41,53,94
4739,FremontBridge,04/18/2013 11:00:00 AM,48,-122,29,30,59
4740,FremontBridge,04/18/2013 12:00:00 PM,48,-122,28,39,67
4741,FremontBridge,04/18/2013 01:00:00 PM,48,-122,22,34,56
4742,FremontBridge,04/18/2013 02:00:00 PM,48,-122,29,22,51
4743,FremontBridge,04/18/2013 03:00:00 PM,48,-122,35,36,71
4744,FremontBridge,04/18/2013 04:00:00 PM,48,-122,86,44,130
4745,FremontBridge,04/18/2013 05:00:00 PM,48,-122,163,89,252
4746,FremontBridge,04/18/2013 06:00:00 PM,48,-122,137,79,216
4747,FremontBridge,04/18/2013 07:00:00 PM,48,-122,58,31,89
4748,FremontBridge,04/18/2013 08:00:00 PM,48,-122,17,25,42
4749,FremontBridge,04/18/2013 09:00:00 PM,48,-122,21,9,30
4750,FremontBridge,04/18/2013 10:00:00 PM,48,-122,19,4,23
4751,FremontBridge,04/18/2013 11:00:00 PM,48,-122,6,6,12
4752,FremontBridge,04/19/2013 12:00:00 AM,48,-122,6,5,11
4753,FremontBridge,04/19/2013 01:00:00 AM,48,-122,3,1,4
4754,FremontBridge,04/19/2013 02:00:00 AM,48,-122,4,1,5
4755,FremontBridge,04/19/2013 03:00:00 AM,48,-122,0,0,0
4756,FremontBridge,04/19/2013 04:00:00 AM,48,-122,3,2,5
4757,FremontBridge,04/19/2013 05:00:00 AM,48,-122,4,10,14
4758,FremontBridge,04/19/2013 06:00:00 AM,48,-122,27,53,80
4759,FremontBridge,04/19/2013 07:00:00 AM,48,-122,38,100,138
4760,FremontBridge,04/19/2013 08:00:00 AM,48,-122,56,141,197
4761,FremontBridge,04/19/2013 09:00:00 AM,48,-122,54,72,126
4762,FremontBridge,04/19/2013 10:00:00 AM,48,-122,17,26,43
4763,FremontBridge,04/19/2013 11:00:00 AM,48,-122,13,9,22
4764,FremontBridge,04/19/2013 12:00:00 PM,48,-122,10,13,23
4765,FremontBridge,04/19/2013 01:00:00 PM,48,-122,16,24,40
4766,FremontBridge,04/19/2013 02:00:00 PM,48,-122,15,14,29
4767,FremontBridge,04/19/2013 03:00:00 PM,48,-122,32,16,48
4768,FremontBridge,04/19/2013 04:00:00 PM,48,-122,73,50,123
4769,FremontBridge,04/19/2013 05:00:00 PM,48,-122,140,53,193
4770,FremontBridge,04/19/2013 06:00:00 PM,48,-122,90,47,137
4771,FremontBridge,04/19/2013 07:00:00 PM,48,-122,41,24,65
4772,FremontBridge,04/19/2013 08:00:00 PM,48,-122,18,10,28
4773,FremontBridge,04/19/2013 09:00:00 PM,48,-122,12,7,19
4774,FremontBridge,04/19/2013 10:00:00 PM,48,-122,10,13,23
4775,FremontBridge,04/19/2013 11:00:00 PM,48,-122,3,9,12
4776,FremontBridge,04/20/2013 12:00:00 AM,48,-122,2,4,6
4777,FremontBridge,04/20/2013 01:00:00 AM,48,-122,5,4,9
4778,FremontBridge,04/20/2013 02:00:00 AM,48,-122,1,5,6
4779,FremontBridge,04/20/2013 03:00:00 AM,48,-122,1,2,3
4780,FremontBridge,04/20/2013 04:00:00 AM,48,-122,3,0,3
4781,FremontBridge,04/20/2013 05:00:00 AM,48,-122,2,5,7
4782,FremontBridge,04/20/2013 06:00:00 AM,48,-122,9,4,13
4783,FremontBridge,04/20/2013 07:00:00 AM,48,-122,9,18,27
4784,FremontBridge,04/20/2013 08:00:00 AM,48,-122,16,26,42
4785,FremontBridge,04/20/2013 09:00:00 AM,48,-122,37,41,78
4786,FremontBridge,04/20/2013 10:00:00 AM,48,-122,34,48,82
4787,FremontBridge,04/20/2013 11:00:00 AM,48,-122,37,53,90
4788,FremontBridge,04/20/2013 12:00:00 PM,48,-122,36,50,86
4789,FremontBridge,04/20/2013 01:00:00 PM,48,-122,44,59,103
4790,FremontBridge,04/20/2013 02:00:00 PM,48,-122,48,78,126
4791,FremontBridge,04/20/2013 03:00:00 PM,48,-122,40,60,100
4792,FremontBridge,04/20/2013 04:00:00 PM,48,-122,27,42,69
4793,FremontBridge,04/20/2013 05:00:00 PM,48,-122,42,24,66
4794,FremontBridge,04/20/2013 06:00:00 PM,48,-122,16,24,40
4795,FremontBridge,04/20/2013 07:00:00 PM,48,-122,5,13,18
4796,FremontBridge,04/20/2013 08:00:00 PM,48,-122,13,9,22
4797,FremontBridge,04/20/2013 09:00:00 PM,48,-122,2,1,3
4798,FremontBridge,04/20/2013 10:00:00 PM,48,-122,7,11,18
4799,FremontBridge,04/20/2013 11:00:00 PM,48,-122,9,6,15
4800,FremontBridge,04/21/2013 12:00:00 AM,48,-122,3,3,6
4801,FremontBridge,04/21/2013 01:00:00 AM,48,-122,5,1,6
4802,FremontBridge,04/21/2013 02:00:00 AM,48,-122,4,1,5
4803,FremontBridge,04/21/2013 03:00:00 AM,48,-122,1,2,3
4804,FremontBridge,04/21/2013 04:00:00 AM,48,-122,1,0,1
4805,FremontBridge,04/21/2013 05:00:00 AM,48,-122,2,4,6
4806,FremontBridge,04/21/2013 06:00:00 AM,48,-122,6,3,9
4807,FremontBridge,04/21/2013 07:00:00 AM,48,-122,8,7,15
4808,FremontBridge,04/21/2013 08:00:00 AM,48,-122,10,26,36
4809,FremontBridge,04/21/2013 09:00:00 AM,48,-122,14,17,31
4810,FremontBridge,04/21/2013 10:00:00 AM,48,-122,24,31,55
4811,FremontBridge,04/21/2013 11:00:00 AM,48,-122,28,47,75
4812,FremontBridge,04/21/2013 12:00:00 PM,48,-122,20,43,63
4813,FremontBridge,04/21/2013 01:00:00 PM,48,-122,26,34,60
4814,FremontBridge,04/21/2013 02:00:00 PM,48,-122,34,42,76
4815,FremontBridge,04/21/2013 03:00:00 PM,48,-122,38,48,86
4816,FremontBridge,04/21/2013 04:00:00 PM,48,-122,51,61,112
4817,FremontBridge,04/21/2013 05:00:00 PM,48,-122,47,54,101
4818,FremontBridge,04/21/2013 06:00:00 PM,48,-122,31,50,81
4819,FremontBridge,04/21/2013 07:00:00 PM,48,-122,24,37,61
4820,FremontBridge,04/21/2013 08:00:00 PM,48,-122,12,19,31
4821,FremontBridge,04/21/2013 09:00:00 PM,48,-122,6,7,13
4822,FremontBridge,04/21/2013 10:00:00 PM,48,-122,8,17,25
4823,FremontBridge,04/21/2013 11:00:00 PM,48,-122,6,5,11
4824,FremontBridge,04/22/2013 12:00:00 AM,48,-122,7,5,12
4825,FremontBridge,04/22/2013 01:00:00 AM,48,-122,2,2,4
4826,FremontBridge,04/22/2013 02:00:00 AM,48,-122,2,1,3
4827,FremontBridge,04/22/2013 03:00:00 AM,48,-122,1,0,1
4828,FremontBridge,04/22/2013 04:00:00 AM,48,-122,1,5,6
4829,FremontBridge,04/22/2013 05:00:00 AM,48,-122,7,21,28
4830,FremontBridge,04/22/2013 06:00:00 AM,48,-122,35,108,143
4831,FremontBridge,04/22/2013 07:00:00 AM,48,-122,78,256,334
4832,FremontBridge,04/22/2013 08:00:00 AM,48,-122,128,306,434
4833,FremontBridge,04/22/2013 09:00:00 AM,48,-122,84,184,268
4834,FremontBridge,04/22/2013 10:00:00 AM,48,-122,44,63,107
4835,FremontBridge,04/22/2013 11:00:00 AM,48,-122,33,56,89
4836,FremontBridge,04/22/2013 12:00:00 PM,48,-122,48,54,102
4837,FremontBridge,04/22/2013 01:00:00 PM,48,-122,48,57,105
4838,FremontBridge,04/22/2013 02:00:00 PM,48,-122,63,57,120
4839,FremontBridge,04/22/2013 03:00:00 PM,48,-122,80,97,177
4840,FremontBridge,04/22/2013 04:00:00 PM,48,-122,159,131,290
4841,FremontBridge,04/22/2013 05:00:00 PM,48,-122,395,200,595
4842,FremontBridge,04/22/2013 06:00:00 PM,48,-122,277,132,409
4843,FremontBridge,04/22/2013 07:00:00 PM,48,-122,116,94,210
4844,FremontBridge,04/22/2013 08:00:00 PM,48,-122,45,38,83
4845,FremontBridge,04/22/2013 09:00:00 PM,48,-122,38,25,63
4846,FremontBridge,04/22/2013 10:00:00 PM,48,-122,9,17,26
4847,FremontBridge,04/22/2013 11:00:00 PM,48,-122,13,11,24
4848,FremontBridge,04/23/2013 12:00:00 AM,48,-122,9,2,11
4849,FremontBridge,04/23/2013 01:00:00 AM,48,-122,2,1,3
4850,FremontBridge,04/23/2013 02:00:00 AM,48,-122,2,3,5
4851,FremontBridge,04/23/2013 03:00:00 AM,48,-122,0,0,0
4852,FremontBridge,04/23/2013 04:00:00 AM,48,-122,3,3,6
4853,FremontBridge,04/23/2013 05:00:00 AM,48,-122,10,26,36
4854,FremontBridge,04/23/2013 06:00:00 AM,48,-122,50,124,174
4855,FremontBridge,04/23/2013 07:00:00 AM,48,-122,103,265,368
4856,FremontBridge,04/23/2013 08:00:00 AM,48,-122,142,349,491
4857,FremontBridge,04/23/2013 09:00:00 AM,48,-122,94,148,242
4858,FremontBridge,04/23/2013 10:00:00 AM,48,-122,50,69,119
4859,FremontBridge,04/23/2013 11:00:00 AM,48,-122,40,50,90
4860,FremontBridge,04/23/2013 12:00:00 PM,48,-122,25,36,61
4861,FremontBridge,04/23/2013 01:00:00 PM,48,-122,44,66,110
4862,FremontBridge,04/23/2013 02:00:00 PM,48,-122,63,82,145
4863,FremontBridge,04/23/2013 03:00:00 PM,48,-122,103,81,184
4864,FremontBridge,04/23/2013 04:00:00 PM,48,-122,195,129,324
4865,FremontBridge,04/23/2013 05:00:00 PM,48,-122,397,193,590
4866,FremontBridge,04/23/2013 06:00:00 PM,48,-122,311,181,492
4867,FremontBridge,04/23/2013 07:00:00 PM,48,-122,153,96,249
4868,FremontBridge,04/23/2013 08:00:00 PM,48,-122,60,39,99
4869,FremontBridge,04/23/2013 09:00:00 PM,48,-122,38,31,69
4870,FremontBridge,04/23/2013 10:00:00 PM,48,-122,32,14,46
4871,FremontBridge,04/23/2013 11:00:00 PM,48,-122,13,15,28
4872,FremontBridge,04/24/2013 12:00:00 AM,48,-122,4,3,7
4873,FremontBridge,04/24/2013 01:00:00 AM,48,-122,3,4,7
4874,FremontBridge,04/24/2013 02:00:00 AM,48,-122,2,2,4
4875,FremontBridge,04/24/2013 03:00:00 AM,48,-122,0,0,0
4876,FremontBridge,04/24/2013 04:00:00 AM,48,-122,3,4,7
4877,FremontBridge,04/24/2013 05:00:00 AM,48,-122,9,24,33
4878,FremontBridge,04/24/2013 06:00:00 AM,48,-122,49,107,156
4879,FremontBridge,04/24/2013 07:00:00 AM,48,-122,112,283,395
4880,FremontBridge,04/24/2013 08:00:00 AM,48,-122,183,347,530
4881,FremontBridge,04/24/2013 09:00:00 AM,48,-122,98,198,296
4882,FremontBridge,04/24/2013 10:00:00 AM,48,-122,50,71,121
4883,FremontBridge,04/24/2013 11:00:00 AM,48,-122,49,60,109
4884,FremontBridge,04/24/2013 12:00:00 PM,48,-122,62,65,127
4885,FremontBridge,04/24/2013 01:00:00 PM,48,-122,62,61,123
4886,FremontBridge,04/24/2013 02:00:00 PM,48,-122,67,75,142
4887,FremontBridge,04/24/2013 03:00:00 PM,48,-122,114,100,214
4888,FremontBridge,04/24/2013 04:00:00 PM,48,-122,225,164,389
4889,FremontBridge,04/24/2013 05:00:00 PM,48,-122,435,253,688
4890,FremontBridge,04/24/2013 06:00:00 PM,48,-122,312,203,515
4891,FremontBridge,04/24/2013 07:00:00 PM,48,-122,155,125,280
4892,FremontBridge,04/24/2013 08:00:00 PM,48,-122,77,64,141
4893,FremontBridge,04/24/2013 09:00:00 PM,48,-122,46,40,86
4894,FremontBridge,04/24/2013 10:00:00 PM,48,-122,22,24,46
4895,FremontBridge,04/24/2013 11:00:00 PM,48,-122,24,10,34
4896,FremontBridge,04/25/2013 12:00:00 AM,48,-122,3,5,8
4897,FremontBridge,04/25/2013 01:00:00 AM,48,-122,5,8,13
4898,FremontBridge,04/25/2013 02:00:00 AM,48,-122,1,4,5
4899,FremontBridge,04/25/2013 03:00:00 AM,48,-122,1,0,1
4900,FremontBridge,04/25/2013 04:00:00 AM,48,-122,1,7,8
4901,FremontBridge,04/25/2013 05:00:00 AM,48,-122,10,19,29
4902,FremontBridge,04/25/2013 06:00:00 AM,48,-122,46,106,152
4903,FremontBridge,04/25/2013 07:00:00 AM,48,-122,90,267,357
4904,FremontBridge,04/25/2013 08:00:00 AM,48,-122,137,340,477
4905,FremontBridge,04/25/2013 09:00:00 AM,48,-122,111,168,279
4906,FremontBridge,04/25/2013 10:00:00 AM,48,-122,47,78,125
4907,FremontBridge,04/25/2013 11:00:00 AM,48,-122,54,69,123
4908,FremontBridge,04/25/2013 12:00:00 PM,48,-122,42,54,96
4909,FremontBridge,04/25/2013 01:00:00 PM,48,-122,59,74,133
4910,FremontBridge,04/25/2013 02:00:00 PM,48,-122,80,79,159
4911,FremontBridge,04/25/2013 03:00:00 PM,48,-122,113,101,214
4912,FremontBridge,04/25/2013 04:00:00 PM,48,-122,193,142,335
4913,FremontBridge,04/25/2013 05:00:00 PM,48,-122,416,202,618
4914,FremontBridge,04/25/2013 06:00:00 PM,48,-122,252,186,438
4915,FremontBridge,04/25/2013 07:00:00 PM,48,-122,142,128,270
4916,FremontBridge,04/25/2013 08:00:00 PM,48,-122,77,71,148
4917,FremontBridge,04/25/2013 09:00:00 PM,48,-122,48,34,82
4918,FremontBridge,04/25/2013 10:00:00 PM,48,-122,31,25,56
4919,FremontBridge,04/25/2013 11:00:00 PM,48,-122,22,18,40
4920,FremontBridge,04/26/2013 12:00:00 AM,48,-122,6,13,19
4921,FremontBridge,04/26/2013 01:00:00 AM,48,-122,6,5,11
4922,FremontBridge,04/26/2013 02:00:00 AM,48,-122,0,9,9
4923,FremontBridge,04/26/2013 03:00:00 AM,48,-122,0,2,2
4924,FremontBridge,04/26/2013 04:00:00 AM,48,-122,2,3,5
4925,FremontBridge,04/26/2013 05:00:00 AM,48,-122,13,16,29
4926,FremontBridge,04/26/2013 06:00:00 AM,48,-122,53,91,144
4927,FremontBridge,04/26/2013 07:00:00 AM,48,-122,77,191,268
4928,FremontBridge,04/26/2013 08:00:00 AM,48,-122,119,299,418
4929,FremontBridge,04/26/2013 09:00:00 AM,48,-122,87,174,261
4930,FremontBridge,04/26/2013 10:00:00 AM,48,-122,38,59,97
4931,FremontBridge,04/26/2013 11:00:00 AM,48,-122,43,61,104
4932,FremontBridge,04/26/2013 12:00:00 PM,48,-122,47,43,90
4933,FremontBridge,04/26/2013 01:00:00 PM,48,-122,68,56,124
4934,FremontBridge,04/26/2013 02:00:00 PM,48,-122,96,87,183
4935,FremontBridge,04/26/2013 03:00:00 PM,48,-122,104,82,186
4936,FremontBridge,04/26/2013 04:00:00 PM,48,-122,171,132,303
4937,FremontBridge,04/26/2013 05:00:00 PM,48,-122,312,154,466
4938,FremontBridge,04/26/2013 06:00:00 PM,48,-122,212,141,353
4939,FremontBridge,04/26/2013 07:00:00 PM,48,-122,95,69,164
4940,FremontBridge,04/26/2013 08:00:00 PM,48,-122,59,37,96
4941,FremontBridge,04/26/2013 09:00:00 PM,48,-122,20,24,44
4942,FremontBridge,04/26/2013 10:00:00 PM,48,-122,26,19,45
4943,FremontBridge,04/26/2013 11:00:00 PM,48,-122,19,17,36
4944,FremontBridge,04/27/2013 12:00:00 AM,48,-122,14,18,32
4945,FremontBridge,04/27/2013 01:00:00 AM,48,-122,7,13,20
4946,FremontBridge,04/27/2013 02:00:00 AM,48,-122,3,2,5
4947,FremontBridge,04/27/2013 03:00:00 AM,48,-122,3,1,4
4948,FremontBridge,04/27/2013 04:00:00 AM,48,-122,1,0,1
4949,FremontBridge,04/27/2013 05:00:00 AM,48,-122,2,5,7
4950,FremontBridge,04/27/2013 06:00:00 AM,48,-122,10,11,21
4951,FremontBridge,04/27/2013 07:00:00 AM,48,-122,18,19,37
4952,FremontBridge,04/27/2013 08:00:00 AM,48,-122,27,38,65
4953,FremontBridge,04/27/2013 09:00:00 AM,48,-122,45,43,88
4954,FremontBridge,04/27/2013 10:00:00 AM,48,-122,37,53,90
4955,FremontBridge,04/27/2013 11:00:00 AM,48,-122,27,47,74
4956,FremontBridge,04/27/2013 12:00:00 PM,48,-122,45,69,114
4957,FremontBridge,04/27/2013 01:00:00 PM,48,-122,29,66,95
4958,FremontBridge,04/27/2013 02:00:00 PM,48,-122,63,42,105
4959,FremontBridge,04/27/2013 03:00:00 PM,48,-122,38,52,90
4960,FremontBridge,04/27/2013 04:00:00 PM,48,-122,54,19,73
4961,FremontBridge,04/27/2013 05:00:00 PM,48,-122,41,33,74
4962,FremontBridge,04/27/2013 06:00:00 PM,48,-122,21,43,64
4963,FremontBridge,04/27/2013 07:00:00 PM,48,-122,21,26,47
4964,FremontBridge,04/27/2013 08:00:00 PM,48,-122,13,23,36
4965,FremontBridge,04/27/2013 09:00:00 PM,48,-122,16,16,32
4966,FremontBridge,04/27/2013 10:00:00 PM,48,-122,3,13,16
4967,FremontBridge,04/27/2013 11:00:00 PM,48,-122,13,11,24
4968,FremontBridge,04/28/2013 12:00:00 AM,48,-122,8,10,18
4969,FremontBridge,04/28/2013 01:00:00 AM,48,-122,5,6,11
4970,FremontBridge,04/28/2013 02:00:00 AM,48,-122,5,2,7
4971,FremontBridge,04/28/2013 03:00:00 AM,48,-122,5,0,5
4972,FremontBridge,04/28/2013 04:00:00 AM,48,-122,2,1,3
4973,FremontBridge,04/28/2013 05:00:00 AM,48,-122,4,2,6
4974,FremontBridge,04/28/2013 06:00:00 AM,48,-122,6,3,9
4975,FremontBridge,04/28/2013 07:00:00 AM,48,-122,9,8,17
4976,FremontBridge,04/28/2013 08:00:00 AM,48,-122,17,22,39
4977,FremontBridge,04/28/2013 09:00:00 AM,48,-122,26,41,67
4978,FremontBridge,04/28/2013 10:00:00 AM,48,-122,31,38,69
4979,FremontBridge,04/28/2013 11:00:00 AM,48,-122,42,48,90
4980,FremontBridge,04/28/2013 12:00:00 PM,48,-122,18,58,76
4981,FremontBridge,04/28/2013 01:00:00 PM,48,-122,49,77,126
4982,FremontBridge,04/28/2013 02:00:00 PM,48,-122,67,72,139
4983,FremontBridge,04/28/2013 03:00:00 PM,48,-122,59,71,130
4984,FremontBridge,04/28/2013 04:00:00 PM,48,-122,49,62,111
4985,FremontBridge,04/28/2013 05:00:00 PM,48,-122,31,55,86
4986,FremontBridge,04/28/2013 06:00:00 PM,48,-122,36,32,68
4987,FremontBridge,04/28/2013 07:00:00 PM,48,-122,12,26,38
4988,FremontBridge,04/28/2013 08:00:00 PM,48,-122,16,6,22
4989,FremontBridge,04/28/2013 09:00:00 PM,48,-122,9,12,21
4990,FremontBridge,04/28/2013 10:00:00 PM,48,-122,15,7,22
4991,FremontBridge,04/28/2013 11:00:00 PM,48,-122,5,5,10
4992,FremontBridge,04/29/2013 12:00:00 AM,48,-122,5,3,8
4993,FremontBridge,04/29/2013 01:00:00 AM,48,-122,2,0,2
4994,FremontBridge,04/29/2013 02:00:00 AM,48,-122,2,1,3
4995,FremontBridge,04/29/2013 03:00:00 AM,48,-122,0,1,1
4996,FremontBridge,04/29/2013 04:00:00 AM,48,-122,1,3,4
4997,FremontBridge,04/29/2013 05:00:00 AM,48,-122,6,25,31
4998,FremontBridge,04/29/2013 06:00:00 AM,48,-122,27,63,90
4999,FremontBridge,04/29/2013 07:00:00 AM,48,-122,66,186,252
5000,FremontBridge,04/29/2013 08:00:00 AM,48,-122,107,236,343
5001,FremontBridge,04/29/2013 09:00:00 AM,48,-122,72,146,218
5002,FremontBridge,04/29/2013 10:00:00 AM,48,-122,38,53,91
5003,FremontBridge,04/29/2013 11:00:00 AM,48,-122,34,47,81
5004,FremontBridge,04/29/2013 12:00:00 PM,48,-122,27,32,59
5005,FremontBridge,04/29/2013 01:00:00 PM,48,-122,37,42,79
5006,FremontBridge,04/29/2013 02:00:00 PM,48,-122,34,30,64
5007,FremontBridge,04/29/2013 03:00:00 PM,48,-122,52,51,103
5008,FremontBridge,04/29/2013 04:00:00 PM,48,-122,111,96,207
5009,FremontBridge,04/29/2013 05:00:00 PM,48,-122,290,148,438
5010,FremontBridge,04/29/2013 06:00:00 PM,48,-122,224,108,332
5011,FremontBridge,04/29/2013 07:00:00 PM,48,-122,82,49,131
5012,FremontBridge,04/29/2013 08:00:00 PM,48,-122,48,26,74
5013,FremontBridge,04/29/2013 09:00:00 PM,48,-122,27,17,44
5014,FremontBridge,04/29/2013 10:00:00 PM,48,-122,19,11,30
5015,FremontBridge,04/29/2013 11:00:00 PM,48,-122,6,2,8
5016,FremontBridge,04/30/2013 12:00:00 AM,48,-122,3,5,8
5017,FremontBridge,04/30/2013 01:00:00 AM,48,-122,5,1,6
5018,FremontBridge,04/30/2013 02:00:00 AM,48,-122,1,1,2
5019,FremontBridge,04/30/2013 03:00:00 AM,48,-122,0,1,1
5020,FremontBridge,04/30/2013 04:00:00 AM,48,-122,2,2,4
5021,FremontBridge,04/30/2013 05:00:00 AM,48,-122,6,17,23
5022,FremontBridge,04/30/2013 06:00:00 AM,48,-122,39,90,129
5023,FremontBridge,04/30/2013 07:00:00 AM,48,-122,117,250,367
5024,FremontBridge,04/30/2013 08:00:00 AM,48,-122,139,329,468
5025,FremontBridge,04/30/2013 09:00:00 AM,48,-122,83,136,219
5026,FremontBridge,04/30/2013 10:00:00 AM,48,-122,39,67,106
5027,FremontBridge,04/30/2013 11:00:00 AM,48,-122,28,39,67
5028,FremontBridge,04/30/2013 12:00:00 PM,48,-122,35,38,73
5029,FremontBridge,04/30/2013 01:00:00 PM,48,-122,39,42,81
5030,FremontBridge,04/30/2013 02:00:00 PM,48,-122,59,45,104
5031,FremontBridge,04/30/2013 03:00:00 PM,48,-122,70,68,138
5032,FremontBridge,04/30/2013 04:00:00 PM,48,-122,143,124,267
5033,FremontBridge,04/30/2013 05:00:00 PM,48,-122,357,172,529
5034,FremontBridge,04/30/2013 06:00:00 PM,48,-122,237,147,384
5035,FremontBridge,04/30/2013 07:00:00 PM,48,-122,128,90,218
5036,FremontBridge,04/30/2013 08:00:00 PM,48,-122,54,41,95
5037,FremontBridge,04/30/2013 09:00:00 PM,48,-122,35,31,66
5038,FremontBridge,04/30/2013 10:00:00 PM,48,-122,16,16,32
5039,FremontBridge,04/30/2013 11:00:00 PM,48,-122,10,5,15
5040,FremontBridge,05/01/2013 12:00:00 AM,48,-122,7,8,15
5041,FremontBridge,05/01/2013 01:00:00 AM,48,-122,3,6,9
5042,FremontBridge,05/01/2013 02:00:00 AM,48,-122,5,4,9
5043,FremontBridge,05/01/2013 03:00:00 AM,48,-122,0,6,6
5044,FremontBridge,05/01/2013 04:00:00 AM,48,-122,3,4,7
5045,FremontBridge,05/01/2013 05:00:00 AM,48,-122,13,28,41
5046,FremontBridge,05/01/2013 06:00:00 AM,48,-122,53,147,200
5047,FremontBridge,05/01/2013 07:00:00 AM,48,-122,115,356,471
5048,FremontBridge,05/01/2013 08:00:00 AM,48,-122,176,446,622
5049,FremontBridge,05/01/2013 09:00:00 AM,48,-122,112,244,356
5050,FremontBridge,05/01/2013 10:00:00 AM,48,-122,75,74,149
5051,FremontBridge,05/01/2013 11:00:00 AM,48,-122,42,77,119
5052,FremontBridge,05/01/2013 12:00:00 PM,48,-122,38,57,95
5053,FremontBridge,05/01/2013 01:00:00 PM,48,-122,57,65,122
5054,FremontBridge,05/01/2013 02:00:00 PM,48,-122,64,72,136
5055,FremontBridge,05/01/2013 03:00:00 PM,48,-122,131,85,216
5056,FremontBridge,05/01/2013 04:00:00 PM,48,-122,215,146,361
5057,FremontBridge,05/01/2013 05:00:00 PM,48,-122,542,261,803
5058,FremontBridge,05/01/2013 06:00:00 PM,48,-122,409,257,666
5059,FremontBridge,05/01/2013 07:00:00 PM,48,-122,151,120,271
5060,FremontBridge,05/01/2013 08:00:00 PM,48,-122,94,75,169
5061,FremontBridge,05/01/2013 09:00:00 PM,48,-122,46,46,92
5062,FremontBridge,05/01/2013 10:00:00 PM,48,-122,30,16,46
5063,FremontBridge,05/01/2013 11:00:00 PM,48,-122,21,15,36
5064,FremontBridge,05/02/2013 12:00:00 AM,48,-122,9,11,20
5065,FremontBridge,05/02/2013 01:00:00 AM,48,-122,1,3,4
5066,FremontBridge,05/02/2013 02:00:00 AM,48,-122,4,2,6
5067,FremontBridge,05/02/2013 03:00:00 AM,48,-122,0,2,2
5068,FremontBridge,05/02/2013 04:00:00 AM,48,-122,2,4,6
5069,FremontBridge,05/02/2013 05:00:00 AM,48,-122,15,31,46
5070,FremontBridge,05/02/2013 06:00:00 AM,48,-122,63,197,260
5071,FremontBridge,05/02/2013 07:00:00 AM,48,-122,117,391,508
5072,FremontBridge,05/02/2013 08:00:00 AM,48,-122,170,433,603
5073,FremontBridge,05/02/2013 09:00:00 AM,48,-122,169,196,365
5074,FremontBridge,05/02/2013 10:00:00 AM,48,-122,70,82,152
5075,FremontBridge,05/02/2013 11:00:00 AM,48,-122,93,87,180
5076,FremontBridge,05/02/2013 12:00:00 PM,48,-122,48,73,121
5077,FremontBridge,05/02/2013 01:00:00 PM,48,-122,64,81,145
5078,FremontBridge,05/02/2013 02:00:00 PM,48,-122,67,72,139
5079,FremontBridge,05/02/2013 03:00:00 PM,48,-122,98,83,181
5080,FremontBridge,05/02/2013 04:00:00 PM,48,-122,214,126,340
5081,FremontBridge,05/02/2013 05:00:00 PM,48,-122,501,233,734
5082,FremontBridge,05/02/2013 06:00:00 PM,48,-122,336,197,533
5083,FremontBridge,05/02/2013 07:00:00 PM,48,-122,153,90,243
5084,FremontBridge,05/02/2013 08:00:00 PM,48,-122,60,47,107
5085,FremontBridge,05/02/2013 09:00:00 PM,48,-122,36,55,91
5086,FremontBridge,05/02/2013 10:00:00 PM,48,-122,29,22,51
5087,FremontBridge,05/02/2013 11:00:00 PM,48,-122,23,17,40
5088,FremontBridge,05/03/2013 12:00:00 AM,48,-122,10,7,17
5089,FremontBridge,05/03/2013 01:00:00 AM,48,-122,5,11,16
5090,FremontBridge,05/03/2013 02:00:00 AM,48,-122,3,1,4
5091,FremontBridge,05/03/2013 03:00:00 AM,48,-122,1,0,1
5092,FremontBridge,05/03/2013 04:00:00 AM,48,-122,2,3,5
5093,FremontBridge,05/03/2013 05:00:00 AM,48,-122,11,26,37
5094,FremontBridge,05/03/2013 06:00:00 AM,48,-122,56,120,176
5095,FremontBridge,05/03/2013 07:00:00 AM,48,-122,104,314,418
5096,FremontBridge,05/03/2013 08:00:00 AM,48,-122,157,362,519
5097,FremontBridge,05/03/2013 09:00:00 AM,48,-122,117,216,333
5098,FremontBridge,05/03/2013 10:00:00 AM,48,-122,62,98,160
5099,FremontBridge,05/03/2013 11:00:00 AM,48,-122,37,60,97
5100,FremontBridge,05/03/2013 12:00:00 PM,48,-122,70,62,132
5101,FremontBridge,05/03/2013 01:00:00 PM,48,-122,70,64,134
5102,FremontBridge,05/03/2013 02:00:00 PM,48,-122,75,71,146
5103,FremontBridge,05/03/2013 03:00:00 PM,48,-122,122,130,252
5104,FremontBridge,05/03/2013 04:00:00 PM,48,-122,275,157,432
5105,FremontBridge,05/03/2013 05:00:00 PM,48,-122,467,201,668
5106,FremontBridge,05/03/2013 06:00:00 PM,48,-122,260,153,413
5107,FremontBridge,05/03/2013 07:00:00 PM,48,-122,152,91,243
5108,FremontBridge,05/03/2013 08:00:00 PM,48,-122,59,44,103
5109,FremontBridge,05/03/2013 09:00:00 PM,48,-122,46,53,99
5110,FremontBridge,05/03/2013 10:00:00 PM,48,-122,38,25,63
5111,FremontBridge,05/03/2013 11:00:00 PM,48,-122,24,28,52
5112,FremontBridge,05/04/2013 12:00:00 AM,48,-122,19,7,26
5113,FremontBridge,05/04/2013 01:00:00 AM,48,-122,7,6,13
5114,FremontBridge,05/04/2013 02:00:00 AM,48,-122,8,4,12
5115,FremontBridge,05/04/2013 03:00:00 AM,48,-122,3,4,7
5116,FremontBridge,05/04/2013 04:00:00 AM,48,-122,0,1,1
5117,FremontBridge,05/04/2013 05:00:00 AM,48,-122,4,7,11
5118,FremontBridge,05/04/2013 06:00:00 AM,48,-122,12,17,29
5119,FremontBridge,05/04/2013 07:00:00 AM,48,-122,39,42,81
5120,FremontBridge,05/04/2013 08:00:00 AM,48,-122,51,65,116
5121,FremontBridge,05/04/2013 09:00:00 AM,48,-122,90,96,186
5122,FremontBridge,05/04/2013 10:00:00 AM,48,-122,76,134,210
5123,FremontBridge,05/04/2013 11:00:00 AM,48,-122,102,145,247
5124,FremontBridge,05/04/2013 12:00:00 PM,48,-122,93,124,217
5125,FremontBridge,05/04/2013 01:00:00 PM,48,-122,134,169,303
5126,FremontBridge,05/04/2013 02:00:00 PM,48,-122,132,138,270
5127,FremontBridge,05/04/2013 03:00:00 PM,48,-122,109,140,249
5128,FremontBridge,05/04/2013 04:00:00 PM,48,-122,109,144,253
5129,FremontBridge,05/04/2013 05:00:00 PM,48,-122,85,120,205
5130,FremontBridge,05/04/2013 06:00:00 PM,48,-122,47,116,163
5131,FremontBridge,05/04/2013 07:00:00 PM,48,-122,38,61,99
5132,FremontBridge,05/04/2013 08:00:00 PM,48,-122,30,52,82
5133,FremontBridge,05/04/2013 09:00:00 PM,48,-122,29,36,65
5134,FremontBridge,05/04/2013 10:00:00 PM,48,-122,19,29,48
5135,FremontBridge,05/04/2013 11:00:00 PM,48,-122,10,9,19
5136,FremontBridge,05/05/2013 12:00:00 AM,48,-122,11,12,23
5137,FremontBridge,05/05/2013 01:00:00 AM,48,-122,11,10,21
5138,FremontBridge,05/05/2013 02:00:00 AM,48,-122,7,10,17
5139,FremontBridge,05/05/2013 03:00:00 AM,48,-122,1,1,2
5140,FremontBridge,05/05/2013 04:00:00 AM,48,-122,1,3,4
5141,FremontBridge,05/05/2013 05:00:00 AM,48,-122,6,4,10
5142,FremontBridge,05/05/2013 06:00:00 AM,48,-122,7,14,21
5143,FremontBridge,05/05/2013 07:00:00 AM,48,-122,21,11,32
5144,FremontBridge,05/05/2013 08:00:00 AM,48,-122,32,55,87
5145,FremontBridge,05/05/2013 09:00:00 AM,48,-122,74,107,181
5146,FremontBridge,05/05/2013 10:00:00 AM,48,-122,75,109,184
5147,FremontBridge,05/05/2013 11:00:00 AM,48,-122,102,124,226
5148,FremontBridge,05/05/2013 12:00:00 PM,48,-122,124,137,261
5149,FremontBridge,05/05/2013 01:00:00 PM,48,-122,178,172,350
5150,FremontBridge,05/05/2013 02:00:00 PM,48,-122,144,167,311
5151,FremontBridge,05/05/2013 03:00:00 PM,48,-122,155,160,315
5152,FremontBridge,05/05/2013 04:00:00 PM,48,-122,101,151,252
5153,FremontBridge,05/05/2013 05:00:00 PM,48,-122,108,113,221
5154,FremontBridge,05/05/2013 06:00:00 PM,48,-122,69,94,163
5155,FremontBridge,05/05/2013 07:00:00 PM,48,-122,43,76,119
5156,FremontBridge,05/05/2013 08:00:00 PM,48,-122,28,71,99
5157,FremontBridge,05/05/2013 09:00:00 PM,48,-122,14,27,41
5158,FremontBridge,05/05/2013 10:00:00 PM,48,-122,19,24,43
5159,FremontBridge,05/05/2013 11:00:00 PM,48,-122,14,6,20
5160,FremontBridge,05/06/2013 12:00:00 AM,48,-122,8,4,12
5161,FremontBridge,05/06/2013 01:00:00 AM,48,-122,1,0,1
5162,FremontBridge,05/06/2013 02:00:00 AM,48,-122,2,2,4
5163,FremontBridge,05/06/2013 03:00:00 AM,48,-122,2,0,2
5164,FremontBridge,05/06/2013 04:00:00 AM,48,-122,2,3,5
5165,FremontBridge,05/06/2013 05:00:00 AM,48,-122,13,28,41
5166,FremontBridge,05/06/2013 06:00:00 AM,48,-122,64,151,215
5167,FremontBridge,05/06/2013 07:00:00 AM,48,-122,116,401,517
5168,FremontBridge,05/06/2013 08:00:00 AM,48,-122,202,448,650
5169,FremontBridge,05/06/2013 09:00:00 AM,48,-122,107,239,346
5170,FremontBridge,05/06/2013 10:00:00 AM,48,-122,55,64,119
5171,FremontBridge,05/06/2013 11:00:00 AM,48,-122,51,68,119
5172,FremontBridge,05/06/2013 12:00:00 PM,48,-122,39,62,101
5173,FremontBridge,05/06/2013 01:00:00 PM,48,-122,80,85,165
5174,FremontBridge,05/06/2013 02:00:00 PM,48,-122,68,86,154
5175,FremontBridge,05/06/2013 03:00:00 PM,48,-122,107,96,203
5176,FremontBridge,05/06/2013 04:00:00 PM,48,-122,256,169,425
5177,FremontBridge,05/06/2013 05:00:00 PM,48,-122,593,223,816
5178,FremontBridge,05/06/2013 06:00:00 PM,48,-122,343,173,516
5179,FremontBridge,05/06/2013 07:00:00 PM,48,-122,183,136,319
5180,FremontBridge,05/06/2013 08:00:00 PM,48,-122,66,64,130
5181,FremontBridge,05/06/2013 09:00:00 PM,48,-122,73,48,121
5182,FremontBridge,05/06/2013 10:00:00 PM,48,-122,27,37,64
5183,FremontBridge,05/06/2013 11:00:00 PM,48,-122,14,7,21
5184,FremontBridge,05/07/2013 12:00:00 AM,48,-122,9,5,14
5185,FremontBridge,05/07/2013 01:00:00 AM,48,-122,3,2,5
5186,FremontBridge,05/07/2013 02:00:00 AM,48,-122,0,2,2
5187,FremontBridge,05/07/2013 03:00:00 AM,48,-122,0,1,1
5188,FremontBridge,05/07/2013 04:00:00 AM,48,-122,2,3,5
5189,FremontBridge,05/07/2013 05:00:00 AM,48,-122,16,38,54
5190,FremontBridge,05/07/2013 06:00:00 AM,48,-122,75,172,247
5191,FremontBridge,05/07/2013 07:00:00 AM,48,-122,126,398,524
5192,FremontBridge,05/07/2013 08:00:00 AM,48,-122,198,468,666
5193,FremontBridge,05/07/2013 09:00:00 AM,48,-122,135,213,348
5194,FremontBridge,05/07/2013 10:00:00 AM,48,-122,41,85,126
5195,FremontBridge,05/07/2013 11:00:00 AM,48,-122,24,35,59
5196,FremontBridge,05/07/2013 12:00:00 PM,48,-122,40,58,98
5197,FremontBridge,05/07/2013 01:00:00 PM,48,-122,52,57,109
5198,FremontBridge,05/07/2013 02:00:00 PM,48,-122,61,75,136
5199,FremontBridge,05/07/2013 03:00:00 PM,48,-122,98,106,204
5200,FremontBridge,05/07/2013 04:00:00 PM,48,-122,249,163,412
5201,FremontBridge,05/07/2013 05:00:00 PM,48,-122,584,247,831
5202,FremontBridge,05/07/2013 06:00:00 PM,48,-122,372,213,585
5203,FremontBridge,05/07/2013 07:00:00 PM,48,-122,181,133,314
5204,FremontBridge,05/07/2013 08:00:00 PM,48,-122,92,76,168
5205,FremontBridge,05/07/2013 09:00:00 PM,48,-122,50,52,102
5206,FremontBridge,05/07/2013 10:00:00 PM,48,-122,28,31,59
5207,FremontBridge,05/07/2013 11:00:00 PM,48,-122,14,20,34
5208,FremontBridge,05/08/2013 12:00:00 AM,48,-122,6,8,14
5209,FremontBridge,05/08/2013 01:00:00 AM,48,-122,5,3,8
5210,FremontBridge,05/08/2013 02:00:00 AM,48,-122,4,1,5
5211,FremontBridge,05/08/2013 03:00:00 AM,48,-122,3,1,4
5212,FremontBridge,05/08/2013 04:00:00 AM,48,-122,3,3,6
5213,FremontBridge,05/08/2013 05:00:00 AM,48,-122,14,40,54
5214,FremontBridge,05/08/2013 06:00:00 AM,48,-122,69,147,216
5215,FremontBridge,05/08/2013 07:00:00 AM,48,-122,126,377,503
5216,FremontBridge,05/08/2013 08:00:00 AM,48,-122,186,460,646
5217,FremontBridge,05/08/2013 09:00:00 AM,48,-122,121,246,367
5218,FremontBridge,05/08/2013 10:00:00 AM,48,-122,50,80,130
5219,FremontBridge,05/08/2013 11:00:00 AM,48,-122,35,58,93
5220,FremontBridge,05/08/2013 12:00:00 PM,48,-122,44,54,98
5221,FremontBridge,05/08/2013 01:00:00 PM,48,-122,54,54,108
5222,FremontBridge,05/08/2013 02:00:00 PM,48,-122,75,67,142
5223,FremontBridge,05/08/2013 03:00:00 PM,48,-122,109,84,193
5224,FremontBridge,05/08/2013 04:00:00 PM,48,-122,217,150,367
5225,FremontBridge,05/08/2013 05:00:00 PM,48,-122,527,230,757
5226,FremontBridge,05/08/2013 06:00:00 PM,48,-122,355,187,542
5227,FremontBridge,05/08/2013 07:00:00 PM,48,-122,196,145,341
5228,FremontBridge,05/08/2013 08:00:00 PM,48,-122,111,78,189
5229,FremontBridge,05/08/2013 09:00:00 PM,48,-122,61,44,105
5230,FremontBridge,05/08/2013 10:00:00 PM,48,-122,25,20,45
5231,FremontBridge,05/08/2013 11:00:00 PM,48,-122,18,21,39
5232,FremontBridge,05/09/2013 12:00:00 AM,48,-122,5,5,10
5233,FremontBridge,05/09/2013 01:00:00 AM,48,-122,11,6,17
5234,FremontBridge,05/09/2013 02:00:00 AM,48,-122,2,5,7
5235,FremontBridge,05/09/2013 03:00:00 AM,48,-122,4,0,4
5236,FremontBridge,05/09/2013 04:00:00 AM,48,-122,4,2,6
5237,FremontBridge,05/09/2013 05:00:00 AM,48,-122,18,33,51
5238,FremontBridge,05/09/2013 06:00:00 AM,48,-122,56,150,206
5239,FremontBridge,05/09/2013 07:00:00 AM,48,-122,121,375,496
5240,FremontBridge,05/09/2013 08:00:00 AM,48,-122,161,409,570
5241,FremontBridge,05/09/2013 09:00:00 AM,48,-122,99,199,298
5242,FremontBridge,05/09/2013 10:00:00 AM,48,-122,38,91,129
5243,FremontBridge,05/09/2013 11:00:00 AM,48,-122,39,48,87
5244,FremontBridge,05/09/2013 12:00:00 PM,48,-122,52,45,97
5245,FremontBridge,05/09/2013 01:00:00 PM,48,-122,67,53,120
5246,FremontBridge,05/09/2013 02:00:00 PM,48,-122,66,65,131
5247,FremontBridge,05/09/2013 03:00:00 PM,48,-122,114,81,195
5248,FremontBridge,05/09/2013 04:00:00 PM,48,-122,232,113,345
5249,FremontBridge,05/09/2013 05:00:00 PM,48,-122,511,240,751
5250,FremontBridge,05/09/2013 06:00:00 PM,48,-122,338,173,511
5251,FremontBridge,05/09/2013 07:00:00 PM,48,-122,148,134,282
5252,FremontBridge,05/09/2013 08:00:00 PM,48,-122,87,58,145
5253,FremontBridge,05/09/2013 09:00:00 PM,48,-122,60,39,99
5254,FremontBridge,05/09/2013 10:00:00 PM,48,-122,30,21,51
5255,FremontBridge,05/09/2013 11:00:00 PM,48,-122,22,33,55
5256,FremontBridge,05/10/2013 12:00:00 AM,48,-122,12,12,24
5257,FremontBridge,05/10/2013 01:00:00 AM,48,-122,0,2,2
5258,FremontBridge,05/10/2013 02:00:00 AM,48,-122,1,3,4
5259,FremontBridge,05/10/2013 03:00:00 AM,48,-122,0,0,0
5260,FremontBridge,05/10/2013 04:00:00 AM,48,-122,2,5,7
5261,FremontBridge,05/10/2013 05:00:00 AM,48,-122,13,38,51
5262,FremontBridge,05/10/2013 06:00:00 AM,48,-122,57,168,225
5263,FremontBridge,05/10/2013 07:00:00 AM,48,-122,126,355,481
5264,FremontBridge,05/10/2013 08:00:00 AM,48,-122,166,476,642
5265,FremontBridge,05/10/2013 09:00:00 AM,48,-122,118,201,319
5266,FremontBridge,05/10/2013 10:00:00 AM,48,-122,55,102,157
5267,FremontBridge,05/10/2013 11:00:00 AM,48,-122,48,83,131
5268,FremontBridge,05/10/2013 12:00:00 PM,48,-122,70,74,144
5269,FremontBridge,05/10/2013 01:00:00 PM,48,-122,71,75,146
5270,FremontBridge,05/10/2013 02:00:00 PM,48,-122,81,104,185
5271,FremontBridge,05/10/2013 03:00:00 PM,48,-122,141,95,236
5272,FremontBridge,05/10/2013 04:00:00 PM,48,-122,256,177,433
5273,FremontBridge,05/10/2013 05:00:00 PM,48,-122,480,212,692
5274,FremontBridge,05/10/2013 06:00:00 PM,48,-122,275,172,447
5275,FremontBridge,05/10/2013 07:00:00 PM,48,-122,143,82,225
5276,FremontBridge,05/10/2013 08:00:00 PM,48,-122,70,48,118
5277,FremontBridge,05/10/2013 09:00:00 PM,48,-122,51,38,89
5278,FremontBridge,05/10/2013 10:00:00 PM,48,-122,24,32,56
5279,FremontBridge,05/10/2013 11:00:00 PM,48,-122,20,32,52
5280,FremontBridge,05/11/2013 12:00:00 AM,48,-122,21,11,32
5281,FremontBridge,05/11/2013 01:00:00 AM,48,-122,9,6,15
5282,FremontBridge,05/11/2013 02:00:00 AM,48,-122,3,6,9
5283,FremontBridge,05/11/2013 03:00:00 AM,48,-122,1,4,5
5284,FremontBridge,05/11/2013 04:00:00 AM,48,-122,3,0,3
5285,FremontBridge,05/11/2013 05:00:00 AM,48,-122,2,9,11
5286,FremontBridge,05/11/2013 06:00:00 AM,48,-122,17,17,34
5287,FremontBridge,05/11/2013 07:00:00 AM,48,-122,27,29,56
5288,FremontBridge,05/11/2013 08:00:00 AM,48,-122,39,52,91
5289,FremontBridge,05/11/2013 09:00:00 AM,48,-122,72,82,154
5290,FremontBridge,05/11/2013 10:00:00 AM,48,-122,77,109,186
5291,FremontBridge,05/11/2013 11:00:00 AM,48,-122,98,97,195
5292,FremontBridge,05/11/2013 12:00:00 PM,48,-122,73,127,200
5293,FremontBridge,05/11/2013 01:00:00 PM,48,-122,79,129,208
5294,FremontBridge,05/11/2013 02:00:00 PM,48,-122,85,98,183
5295,FremontBridge,05/11/2013 03:00:00 PM,48,-122,113,131,244
5296,FremontBridge,05/11/2013 04:00:00 PM,48,-122,87,136,223
5297,FremontBridge,05/11/2013 05:00:00 PM,48,-122,96,107,203
5298,FremontBridge,05/11/2013 06:00:00 PM,48,-122,58,79,137
5299,FremontBridge,05/11/2013 07:00:00 PM,48,-122,44,57,101
5300,FremontBridge,05/11/2013 08:00:00 PM,48,-122,35,40,75
5301,FremontBridge,05/11/2013 09:00:00 PM,48,-122,20,24,44
5302,FremontBridge,05/11/2013 10:00:00 PM,48,-122,18,24,42
5303,FremontBridge,05/11/2013 11:00:00 PM,48,-122,16,14,30
5304,FremontBridge,05/12/2013 12:00:00 AM,48,-122,16,13,29
5305,FremontBridge,05/12/2013 01:00:00 AM,48,-122,6,5,11
5306,FremontBridge,05/12/2013 02:00:00 AM,48,-122,12,4,16
5307,FremontBridge,05/12/2013 03:00:00 AM,48,-122,3,2,5
5308,FremontBridge,05/12/2013 04:00:00 AM,48,-122,3,1,4
5309,FremontBridge,05/12/2013 05:00:00 AM,48,-122,3,4,7
5310,FremontBridge,05/12/2013 06:00:00 AM,48,-122,4,2,6
5311,FremontBridge,05/12/2013 07:00:00 AM,48,-122,5,9,14
5312,FremontBridge,05/12/2013 08:00:00 AM,48,-122,23,30,53
5313,FremontBridge,05/12/2013 09:00:00 AM,48,-122,26,27,53
5314,FremontBridge,05/12/2013 10:00:00 AM,48,-122,19,32,51
5315,FremontBridge,05/12/2013 11:00:00 AM,48,-122,47,52,99
5316,FremontBridge,05/12/2013 12:00:00 PM,48,-122,26,47,73
5317,FremontBridge,05/12/2013 01:00:00 PM,48,-122,50,56,106
5318,FremontBridge,05/12/2013 02:00:00 PM,48,-122,40,63,103
5319,FremontBridge,05/12/2013 03:00:00 PM,48,-122,59,83,142
5320,FremontBridge,05/12/2013 04:00:00 PM,48,-122,43,66,109
5321,FremontBridge,05/12/2013 05:00:00 PM,48,-122,48,67,115
5322,FremontBridge,05/12/2013 06:00:00 PM,48,-122,43,54,97
5323,FremontBridge,05/12/2013 07:00:00 PM,48,-122,26,33,59
5324,FremontBridge,05/12/2013 08:00:00 PM,48,-122,22,19,41
5325,FremontBridge,05/12/2013 09:00:00 PM,48,-122,16,12,28
5326,FremontBridge,05/12/2013 10:00:00 PM,48,-122,10,12,22
5327,FremontBridge,05/12/2013 11:00:00 PM,48,-122,7,13,20
5328,FremontBridge,05/13/2013 12:00:00 AM,48,-122,4,5,9
5329,FremontBridge,05/13/2013 01:00:00 AM,48,-122,2,3,5
5330,FremontBridge,05/13/2013 02:00:00 AM,48,-122,1,1,2
5331,FremontBridge,05/13/2013 03:00:00 AM,48,-122,3,0,3
5332,FremontBridge,05/13/2013 04:00:00 AM,48,-122,2,3,5
5333,FremontBridge,05/13/2013 05:00:00 AM,48,-122,16,27,43
5334,FremontBridge,05/13/2013 06:00:00 AM,48,-122,54,131,185
5335,FremontBridge,05/13/2013 07:00:00 AM,48,-122,97,275,372
5336,FremontBridge,05/13/2013 08:00:00 AM,48,-122,130,380,510
5337,FremontBridge,05/13/2013 09:00:00 AM,48,-122,95,158,253
5338,FremontBridge,05/13/2013 10:00:00 AM,48,-122,49,67,116
5339,FremontBridge,05/13/2013 11:00:00 AM,48,-122,26,43,69
5340,FremontBridge,05/13/2013 12:00:00 PM,48,-122,26,38,64
5341,FremontBridge,05/13/2013 01:00:00 PM,48,-122,32,41,73
5342,FremontBridge,05/13/2013 02:00:00 PM,48,-122,30,26,56
5343,FremontBridge,05/13/2013 03:00:00 PM,48,-122,54,34,88
5344,FremontBridge,05/13/2013 04:00:00 PM,48,-122,141,84,225
5345,FremontBridge,05/13/2013 05:00:00 PM,48,-122,381,129,510
5346,FremontBridge,05/13/2013 06:00:00 PM,48,-122,279,111,390
5347,FremontBridge,05/13/2013 07:00:00 PM,48,-122,113,62,175
5348,FremontBridge,05/13/2013 08:00:00 PM,48,-122,60,43,103
5349,FremontBridge,05/13/2013 09:00:00 PM,48,-122,21,29,50
5350,FremontBridge,05/13/2013 10:00:00 PM,48,-122,23,15,38
5351,FremontBridge,05/13/2013 11:00:00 PM,48,-122,15,8,23
5352,FremontBridge,05/14/2013 12:00:00 AM,48,-122,16,7,23
5353,FremontBridge,05/14/2013 01:00:00 AM,48,-122,4,1,5
5354,FremontBridge,05/14/2013 02:00:00 AM,48,-122,1,1,2
5355,FremontBridge,05/14/2013 03:00:00 AM,48,-122,0,0,0
5356,FremontBridge,05/14/2013 04:00:00 AM,48,-122,2,4,6
5357,FremontBridge,05/14/2013 05:00:00 AM,48,-122,12,31,43
5358,FremontBridge,05/14/2013 06:00:00 AM,48,-122,66,143,209
5359,FremontBridge,05/14/2013 07:00:00 AM,48,-122,124,344,468
5360,FremontBridge,05/14/2013 08:00:00 AM,48,-122,155,434,589
5361,FremontBridge,05/14/2013 09:00:00 AM,48,-122,109,177,286
5362,FremontBridge,05/14/2013 10:00:00 AM,48,-122,35,78,113
5363,FremontBridge,05/14/2013 11:00:00 AM,48,-122,33,38,71
5364,FremontBridge,05/14/2013 12:00:00 PM,48,-122,39,53,92
5365,FremontBridge,05/14/2013 01:00:00 PM,48,-122,40,57,97
5366,FremontBridge,05/14/2013 02:00:00 PM,48,-122,73,68,141
5367,FremontBridge,05/14/2013 03:00:00 PM,48,-122,107,81,188
5368,FremontBridge,05/14/2013 04:00:00 PM,48,-122,209,138,347
5369,FremontBridge,05/14/2013 05:00:00 PM,48,-122,504,201,705
5370,FremontBridge,05/14/2013 06:00:00 PM,48,-122,354,212,566
5371,FremontBridge,05/14/2013 07:00:00 PM,48,-122,173,126,299
5372,FremontBridge,05/14/2013 08:00:00 PM,48,-122,72,64,136
5373,FremontBridge,05/14/2013 09:00:00 PM,48,-122,51,53,104
5374,FremontBridge,05/14/2013 10:00:00 PM,48,-122,37,23,60
5375,FremontBridge,05/14/2013 11:00:00 PM,48,-122,14,11,25
5376,FremontBridge,05/15/2013 12:00:00 AM,48,-122,11,10,21
5377,FremontBridge,05/15/2013 01:00:00 AM,48,-122,4,2,6
5378,FremontBridge,05/15/2013 02:00:00 AM,48,-122,1,6,7
5379,FremontBridge,05/15/2013 03:00:00 AM,48,-122,3,2,5
5380,FremontBridge,05/15/2013 04:00:00 AM,48,-122,1,3,4
5381,FremontBridge,05/15/2013 05:00:00 AM,48,-122,11,25,36
5382,FremontBridge,05/15/2013 06:00:00 AM,48,-122,54,144,198
5383,FremontBridge,05/15/2013 07:00:00 AM,48,-122,109,308,417
5384,FremontBridge,05/15/2013 08:00:00 AM,48,-122,166,395,561
5385,FremontBridge,05/15/2013 09:00:00 AM,48,-122,88,197,285
5386,FremontBridge,05/15/2013 10:00:00 AM,48,-122,55,80,135
5387,FremontBridge,05/15/2013 11:00:00 AM,48,-122,41,70,111
5388,FremontBridge,05/15/2013 12:00:00 PM,48,-122,43,53,96
5389,FremontBridge,05/15/2013 01:00:00 PM,48,-122,52,58,110
5390,FremontBridge,05/15/2013 02:00:00 PM,48,-122,57,56,113
5391,FremontBridge,05/15/2013 03:00:00 PM,48,-122,80,69,149
5392,FremontBridge,05/15/2013 04:00:00 PM,48,-122,180,84,264
5393,FremontBridge,05/15/2013 05:00:00 PM,48,-122,442,165,607
5394,FremontBridge,05/15/2013 06:00:00 PM,48,-122,267,107,374
5395,FremontBridge,05/15/2013 07:00:00 PM,48,-122,107,59,166
5396,FremontBridge,05/15/2013 08:00:00 PM,48,-122,78,27,105
5397,FremontBridge,05/15/2013 09:00:00 PM,48,-122,31,28,59
5398,FremontBridge,05/15/2013 10:00:00 PM,48,-122,21,22,43
5399,FremontBridge,05/15/2013 11:00:00 PM,48,-122,10,14,24
5400,FremontBridge,05/16/2013 12:00:00 AM,48,-122,3,2,5
5401,FremontBridge,05/16/2013 01:00:00 AM,48,-122,1,2,3
5402,FremontBridge,05/16/2013 02:00:00 AM,48,-122,7,0,7
5403,FremontBridge,05/16/2013 03:00:00 AM,48,-122,2,0,2
5404,FremontBridge,05/16/2013 04:00:00 AM,48,-122,0,3,3
5405,FremontBridge,05/16/2013 05:00:00 AM,48,-122,13,27,40
5406,FremontBridge,05/16/2013 06:00:00 AM,48,-122,58,125,183
5407,FremontBridge,05/16/2013 07:00:00 AM,48,-122,101,274,375
5408,FremontBridge,05/16/2013 08:00:00 AM,48,-122,161,380,541
5409,FremontBridge,05/16/2013 09:00:00 AM,48,-122,128,183,311
5410,FremontBridge,05/16/2013 10:00:00 AM,48,-122,43,75,118
5411,FremontBridge,05/16/2013 11:00:00 AM,48,-122,45,46,91
5412,FremontBridge,05/16/2013 12:00:00 PM,48,-122,41,50,91
5413,FremontBridge,05/16/2013 01:00:00 PM,48,-122,39,55,94
5414,FremontBridge,05/16/2013 02:00:00 PM,48,-122,76,69,145
5415,FremontBridge,05/16/2013 03:00:00 PM,48,-122,95,82,177
5416,FremontBridge,05/16/2013 04:00:00 PM,48,-122,192,123,315
5417,FremontBridge,05/16/2013 05:00:00 PM,48,-122,483,214,697
5418,FremontBridge,05/16/2013 06:00:00 PM,48,-122,312,164,476
5419,FremontBridge,05/16/2013 07:00:00 PM,48,-122,147,123,270
5420,FremontBridge,05/16/2013 08:00:00 PM,48,-122,74,72,146
5421,FremontBridge,05/16/2013 09:00:00 PM,48,-122,56,39,95
5422,FremontBridge,05/16/2013 10:00:00 PM,48,-122,23,23,46
5423,FremontBridge,05/16/2013 11:00:00 PM,48,-122,17,26,43
5424,FremontBridge,05/17/2013 12:00:00 AM,48,-122,9,11,20
5425,FremontBridge,05/17/2013 01:00:00 AM,48,-122,6,1,7
5426,FremontBridge,05/17/2013 02:00:00 AM,48,-122,2,7,9
5427,FremontBridge,05/17/2013 03:00:00 AM,48,-122,2,2,4
5428,FremontBridge,05/17/2013 04:00:00 AM,48,-122,1,7,8
5429,FremontBridge,05/17/2013 05:00:00 AM,48,-122,15,53,68
5430,FremontBridge,05/17/2013 06:00:00 AM,48,-122,66,236,302
5431,FremontBridge,05/17/2013 07:00:00 AM,48,-122,115,626,741
5432,FremontBridge,05/17/2013 08:00:00 AM,48,-122,148,553,701
5433,FremontBridge,05/17/2013 09:00:00 AM,48,-122,87,251,338
5434,FremontBridge,05/17/2013 10:00:00 AM,48,-122,47,79,126
5435,FremontBridge,05/17/2013 11:00:00 AM,48,-122,44,50,94
5436,FremontBridge,05/17/2013 12:00:00 PM,48,-122,45,40,85
5437,FremontBridge,05/17/2013 01:00:00 PM,48,-122,35,66,101
5438,FremontBridge,05/17/2013 02:00:00 PM,48,-122,61,63,124
5439,FremontBridge,05/17/2013 03:00:00 PM,48,-122,121,76,197
5440,FremontBridge,05/17/2013 04:00:00 PM,48,-122,250,126,376
5441,FremontBridge,05/17/2013 05:00:00 PM,48,-122,461,176,637
5442,FremontBridge,05/17/2013 06:00:00 PM,48,-122,289,121,410
5443,FremontBridge,05/17/2013 07:00:00 PM,48,-122,101,67,168
5444,FremontBridge,05/17/2013 08:00:00 PM,48,-122,66,42,108
5445,FremontBridge,05/17/2013 09:00:00 PM,48,-122,38,40,78
5446,FremontBridge,05/17/2013 10:00:00 PM,48,-122,24,27,51
5447,FremontBridge,05/17/2013 11:00:00 PM,48,-122,15,15,30
5448,FremontBridge,05/18/2013 12:00:00 AM,48,-122,18,16,34
5449,FremontBridge,05/18/2013 01:00:00 AM,48,-122,7,7,14
5450,FremontBridge,05/18/2013 02:00:00 AM,48,-122,3,5,8
5451,FremontBridge,05/18/2013 03:00:00 AM,48,-122,3,3,6
5452,FremontBridge,05/18/2013 04:00:00 AM,48,-122,2,2,4
5453,FremontBridge,05/18/2013 05:00:00 AM,48,-122,5,10,15
5454,FremontBridge,05/18/2013 06:00:00 AM,48,-122,13,22,35
5455,FremontBridge,05/18/2013 07:00:00 AM,48,-122,28,25,53
5456,FremontBridge,05/18/2013 08:00:00 AM,48,-122,39,40,79
5457,FremontBridge,05/18/2013 09:00:00 AM,48,-122,63,63,126
5458,FremontBridge,05/18/2013 10:00:00 AM,48,-122,55,68,123
5459,FremontBridge,05/18/2013 11:00:00 AM,48,-122,54,73,127
5460,FremontBridge,05/18/2013 12:00:00 PM,48,-122,52,70,122
5461,FremontBridge,05/18/2013 01:00:00 PM,48,-122,51,93,144
5462,FremontBridge,05/18/2013 02:00:00 PM,48,-122,62,70,132
5463,FremontBridge,05/18/2013 03:00:00 PM,48,-122,54,72,126
5464,FremontBridge,05/18/2013 04:00:00 PM,48,-122,44,65,109
5465,FremontBridge,05/18/2013 05:00:00 PM,48,-122,66,57,123
5466,FremontBridge,05/18/2013 06:00:00 PM,48,-122,52,74,126
5467,FremontBridge,05/18/2013 07:00:00 PM,48,-122,36,55,91
5468,FremontBridge,05/18/2013 08:00:00 PM,48,-122,30,36,66
5469,FremontBridge,05/18/2013 09:00:00 PM,48,-122,24,32,56
5470,FremontBridge,05/18/2013 10:00:00 PM,48,-122,33,24,57
5471,FremontBridge,05/18/2013 11:00:00 PM,48,-122,20,18,38
5472,FremontBridge,05/19/2013 12:00:00 AM,48,-122,14,19,33
5473,FremontBridge,05/19/2013 01:00:00 AM,48,-122,7,14,21
5474,FremontBridge,05/19/2013 02:00:00 AM,48,-122,4,2,6
5475,FremontBridge,05/19/2013 03:00:00 AM,48,-122,3,4,7
5476,FremontBridge,05/19/2013 04:00:00 AM,48,-122,4,1,5
5477,FremontBridge,05/19/2013 05:00:00 AM,48,-122,3,6,9
5478,FremontBridge,05/19/2013 06:00:00 AM,48,-122,9,6,15
5479,FremontBridge,05/19/2013 07:00:00 AM,48,-122,26,19,45
5480,FremontBridge,05/19/2013 08:00:00 AM,48,-122,40,45,85
5481,FremontBridge,05/19/2013 09:00:00 AM,48,-122,52,57,109
5482,FremontBridge,05/19/2013 10:00:00 AM,48,-122,55,82,137
5483,FremontBridge,05/19/2013 11:00:00 AM,48,-122,56,108,164
5484,FremontBridge,05/19/2013 12:00:00 PM,48,-122,67,88,155
5485,FremontBridge,05/19/2013 01:00:00 PM,48,-122,91,119,210
5486,FremontBridge,05/19/2013 02:00:00 PM,48,-122,90,114,204
5487,FremontBridge,05/19/2013 03:00:00 PM,48,-122,93,110,203
5488,FremontBridge,05/19/2013 04:00:00 PM,48,-122,77,97,174
5489,FremontBridge,05/19/2013 05:00:00 PM,48,-122,62,80,142
5490,FremontBridge,05/19/2013 06:00:00 PM,48,-122,58,82,140
5491,FremontBridge,05/19/2013 07:00:00 PM,48,-122,61,52,113
5492,FremontBridge,05/19/2013 08:00:00 PM,48,-122,29,32,61
5493,FremontBridge,05/19/2013 09:00:00 PM,48,-122,26,24,50
5494,FremontBridge,05/19/2013 10:00:00 PM,48,-122,12,14,26
5495,FremontBridge,05/19/2013 11:00:00 PM,48,-122,11,11,22
5496,FremontBridge,05/20/2013 12:00:00 AM,48,-122,6,6,12
5497,FremontBridge,05/20/2013 01:00:00 AM,48,-122,2,1,3
5498,FremontBridge,05/20/2013 02:00:00 AM,48,-122,3,2,5
5499,FremontBridge,05/20/2013 03:00:00 AM,48,-122,3,2,5
5500,FremontBridge,05/20/2013 04:00:00 AM,48,-122,4,0,4
5501,FremontBridge,05/20/2013 05:00:00 AM,48,-122,15,41,56
5502,FremontBridge,05/20/2013 06:00:00 AM,48,-122,51,147,198
5503,FremontBridge,05/20/2013 07:00:00 AM,48,-122,132,369,501
5504,FremontBridge,05/20/2013 08:00:00 AM,48,-122,158,432,590
5505,FremontBridge,05/20/2013 09:00:00 AM,48,-122,113,216,329
5506,FremontBridge,05/20/2013 10:00:00 AM,48,-122,46,69,115
5507,FremontBridge,05/20/2013 11:00:00 AM,48,-122,32,53,85
5508,FremontBridge,05/20/2013 12:00:00 PM,48,-122,28,65,93
5509,FremontBridge,05/20/2013 01:00:00 PM,48,-122,50,54,104
5510,FremontBridge,05/20/2013 02:00:00 PM,48,-122,70,87,157
5511,FremontBridge,05/20/2013 03:00:00 PM,48,-122,108,104,212
5512,FremontBridge,05/20/2013 04:00:00 PM,48,-122,226,158,384
5513,FremontBridge,05/20/2013 05:00:00 PM,48,-122,551,213,764
5514,FremontBridge,05/20/2013 06:00:00 PM,48,-122,360,163,523
5515,FremontBridge,05/20/2013 07:00:00 PM,48,-122,140,105,245
5516,FremontBridge,05/20/2013 08:00:00 PM,48,-122,70,47,117
5517,FremontBridge,05/20/2013 09:00:00 PM,48,-122,43,39,82
5518,FremontBridge,05/20/2013 10:00:00 PM,48,-122,19,20,39
5519,FremontBridge,05/20/2013 11:00:00 PM,48,-122,17,9,26
5520,FremontBridge,05/21/2013 12:00:00 AM,48,-122,7,12,19
5521,FremontBridge,05/21/2013 01:00:00 AM,48,-122,4,2,6
5522,FremontBridge,05/21/2013 02:00:00 AM,48,-122,0,1,1
5523,FremontBridge,05/21/2013 03:00:00 AM,48,-122,0,1,1
5524,FremontBridge,05/21/2013 04:00:00 AM,48,-122,2,2,4
5525,FremontBridge,05/21/2013 05:00:00 AM,48,-122,5,19,24
5526,FremontBridge,05/21/2013 06:00:00 AM,48,-122,28,66,94
5527,FremontBridge,05/21/2013 07:00:00 AM,48,-122,59,205,264
5528,FremontBridge,05/21/2013 08:00:00 AM,48,-122,98,249,347
5529,FremontBridge,05/21/2013 09:00:00 AM,48,-122,79,134,213
5530,FremontBridge,05/21/2013 10:00:00 AM,48,-122,25,40,65
5531,FremontBridge,05/21/2013 11:00:00 AM,48,-122,13,21,34
5532,FremontBridge,05/21/2013 12:00:00 PM,48,-122,22,32,54
5533,FremontBridge,05/21/2013 01:00:00 PM,48,-122,27,38,65
5534,FremontBridge,05/21/2013 02:00:00 PM,48,-122,39,32,71
5535,FremontBridge,05/21/2013 03:00:00 PM,48,-122,51,36,87
5536,FremontBridge,05/21/2013 04:00:00 PM,48,-122,108,67,175
5537,FremontBridge,05/21/2013 05:00:00 PM,48,-122,281,129,410
5538,FremontBridge,05/21/2013 06:00:00 PM,48,-122,199,70,269
5539,FremontBridge,05/21/2013 07:00:00 PM,48,-122,75,34,109
5540,FremontBridge,05/21/2013 08:00:00 PM,48,-122,48,27,75
5541,FremontBridge,05/21/2013 09:00:00 PM,48,-122,28,27,55
5542,FremontBridge,05/21/2013 10:00:00 PM,48,-122,13,5,18
5543,FremontBridge,05/21/2013 11:00:00 PM,48,-122,6,15,21
5544,FremontBridge,05/22/2013 12:00:00 AM,48,-122,3,0,3
5545,FremontBridge,05/22/2013 01:00:00 AM,48,-122,3,0,3
5546,FremontBridge,05/22/2013 02:00:00 AM,48,-122,1,2,3
5547,FremontBridge,05/22/2013 03:00:00 AM,48,-122,0,1,1
5548,FremontBridge,05/22/2013 04:00:00 AM,48,-122,2,0,2
5549,FremontBridge,05/22/2013 05:00:00 AM,48,-122,5,27,32
5550,FremontBridge,05/22/2013 06:00:00 AM,48,-122,37,99,136
5551,FremontBridge,05/22/2013 07:00:00 AM,48,-122,81,239,320
5552,FremontBridge,05/22/2013 08:00:00 AM,48,-122,94,266,360
5553,FremontBridge,05/22/2013 09:00:00 AM,48,-122,78,151,229
5554,FremontBridge,05/22/2013 10:00:00 AM,48,-122,39,46,85
5555,FremontBridge,05/22/2013 11:00:00 AM,48,-122,17,26,43
5556,FremontBridge,05/22/2013 12:00:00 PM,48,-122,12,25,37
5557,FremontBridge,05/22/2013 01:00:00 PM,48,-122,28,16,44
5558,FremontBridge,05/22/2013 02:00:00 PM,48,-122,38,24,62
5559,FremontBridge,05/22/2013 03:00:00 PM,48,-122,45,46,91
5560,FremontBridge,05/22/2013 04:00:00 PM,48,-122,127,71,198
5561,FremontBridge,05/22/2013 05:00:00 PM,48,-122,320,159,479
5562,FremontBridge,05/22/2013 06:00:00 PM,48,-122,231,114,345
5563,FremontBridge,05/22/2013 07:00:00 PM,48,-122,100,55,155
5564,FremontBridge,05/22/2013 08:00:00 PM,48,-122,58,39,97
5565,FremontBridge,05/22/2013 09:00:00 PM,48,-122,35,32,67
5566,FremontBridge,05/22/2013 10:00:00 PM,48,-122,26,17,43
5567,FremontBridge,05/22/2013 11:00:00 PM,48,-122,13,12,25
5568,FremontBridge,05/23/2013 12:00:00 AM,48,-122,4,2,6
5569,FremontBridge,05/23/2013 01:00:00 AM,48,-122,5,5,10
5570,FremontBridge,05/23/2013 02:00:00 AM,48,-122,1,2,3
5571,FremontBridge,05/23/2013 03:00:00 AM,48,-122,0,1,1
5572,FremontBridge,05/23/2013 04:00:00 AM,48,-122,2,0,2
5573,FremontBridge,05/23/2013 05:00:00 AM,48,-122,11,19,30
5574,FremontBridge,05/23/2013 06:00:00 AM,48,-122,26,90,116
5575,FremontBridge,05/23/2013 07:00:00 AM,48,-122,64,210,274
5576,FremontBridge,05/23/2013 08:00:00 AM,48,-122,127,303,430
5577,FremontBridge,05/23/2013 09:00:00 AM,48,-122,88,145,233
5578,FremontBridge,05/23/2013 10:00:00 AM,48,-122,35,78,113
5579,FremontBridge,05/23/2013 11:00:00 AM,48,-122,31,51,82
5580,FremontBridge,05/23/2013 12:00:00 PM,48,-122,42,57,99
5581,FremontBridge,05/23/2013 01:00:00 PM,48,-122,45,30,75
5582,FremontBridge,05/23/2013 02:00:00 PM,48,-122,44,44,88
5583,FremontBridge,05/23/2013 03:00:00 PM,48,-122,58,42,100
5584,FremontBridge,05/23/2013 04:00:00 PM,48,-122,134,70,204
5585,FremontBridge,05/23/2013 05:00:00 PM,48,-122,296,125,421
5586,FremontBridge,05/23/2013 06:00:00 PM,48,-122,234,120,354
5587,FremontBridge,05/23/2013 07:00:00 PM,48,-122,110,65,175
5588,FremontBridge,05/23/2013 08:00:00 PM,48,-122,59,36,95
5589,FremontBridge,05/23/2013 09:00:00 PM,48,-122,24,22,46
5590,FremontBridge,05/23/2013 10:00:00 PM,48,-122,17,24,41
5591,FremontBridge,05/23/2013 11:00:00 PM,48,-122,16,9,25
5592,FremontBridge,05/24/2013 12:00:00 AM,48,-122,8,4,12
5593,FremontBridge,05/24/2013 01:00:00 AM,48,-122,2,1,3
5594,FremontBridge,05/24/2013 02:00:00 AM,48,-122,1,2,3
5595,FremontBridge,05/24/2013 03:00:00 AM,48,-122,2,3,5
5596,FremontBridge,05/24/2013 04:00:00 AM,48,-122,1,3,4
5597,FremontBridge,05/24/2013 05:00:00 AM,48,-122,11,15,26
5598,FremontBridge,05/24/2013 06:00:00 AM,48,-122,36,107,143
5599,FremontBridge,05/24/2013 07:00:00 AM,48,-122,75,213,288
5600,FremontBridge,05/24/2013 08:00:00 AM,48,-122,98,289,387
5601,FremontBridge,05/24/2013 09:00:00 AM,48,-122,84,130,214
5602,FremontBridge,05/24/2013 10:00:00 AM,48,-122,78,59,137
5603,FremontBridge,05/24/2013 11:00:00 AM,48,-122,32,52,84
5604,FremontBridge,05/24/2013 12:00:00 PM,48,-122,58,54,112
5605,FremontBridge,05/24/2013 01:00:00 PM,48,-122,58,73,131
5606,FremontBridge,05/24/2013 02:00:00 PM,48,-122,75,57,132
5607,FremontBridge,05/24/2013 03:00:00 PM,48,-122,117,97,214
5608,FremontBridge,05/24/2013 04:00:00 PM,48,-122,213,137,350
5609,FremontBridge,05/24/2013 05:00:00 PM,48,-122,267,166,433
5610,FremontBridge,05/24/2013 06:00:00 PM,48,-122,198,119,317
5611,FremontBridge,05/24/2013 07:00:00 PM,48,-122,82,64,146
5612,FremontBridge,05/24/2013 08:00:00 PM,48,-122,46,36,82
5613,FremontBridge,05/24/2013 09:00:00 PM,48,-122,42,19,61
5614,FremontBridge,05/24/2013 10:00:00 PM,48,-122,35,21,56
5615,FremontBridge,05/24/2013 11:00:00 PM,48,-122,22,11,33
5616,FremontBridge,05/25/2013 12:00:00 AM,48,-122,14,8,22
5617,FremontBridge,05/25/2013 01:00:00 AM,48,-122,10,5,15
5618,FremontBridge,05/25/2013 02:00:00 AM,48,-122,4,5,9
5619,FremontBridge,05/25/2013 03:00:00 AM,48,-122,3,3,6
5620,FremontBridge,05/25/2013 04:00:00 AM,48,-122,2,1,3
5621,FremontBridge,05/25/2013 05:00:00 AM,48,-122,5,4,9
5622,FremontBridge,05/25/2013 06:00:00 AM,48,-122,9,12,21
5623,FremontBridge,05/25/2013 07:00:00 AM,48,-122,20,30,50
5624,FremontBridge,05/25/2013 08:00:00 AM,48,-122,29,49,78
5625,FremontBridge,05/25/2013 09:00:00 AM,48,-122,30,68,98
5626,FremontBridge,05/25/2013 10:00:00 AM,48,-122,33,75,108
5627,FremontBridge,05/25/2013 11:00:00 AM,48,-122,64,62,126
5628,FremontBridge,05/25/2013 12:00:00 PM,48,-122,53,63,116
5629,FremontBridge,05/25/2013 01:00:00 PM,48,-122,66,79,145
5630,FremontBridge,05/25/2013 02:00:00 PM,48,-122,70,74,144
5631,FremontBridge,05/25/2013 03:00:00 PM,48,-122,85,117,202
5632,FremontBridge,05/25/2013 04:00:00 PM,48,-122,67,74,141
5633,FremontBridge,05/25/2013 05:00:00 PM,48,-122,65,63,128
5634,FremontBridge,05/25/2013 06:00:00 PM,48,-122,52,51,103
5635,FremontBridge,05/25/2013 07:00:00 PM,48,-122,41,38,79
5636,FremontBridge,05/25/2013 08:00:00 PM,48,-122,32,23,55
5637,FremontBridge,05/25/2013 09:00:00 PM,48,-122,24,14,38
5638,FremontBridge,05/25/2013 10:00:00 PM,48,-122,31,10,41
5639,FremontBridge,05/25/2013 11:00:00 PM,48,-122,19,10,29
5640,FremontBridge,05/26/2013 12:00:00 AM,48,-122,9,5,14
5641,FremontBridge,05/26/2013 01:00:00 AM,48,-122,1,4,5
5642,FremontBridge,05/26/2013 02:00:00 AM,48,-122,4,1,5
5643,FremontBridge,05/26/2013 03:00:00 AM,48,-122,3,2,5
5644,FremontBridge,05/26/2013 04:00:00 AM,48,-122,2,2,4
5645,FremontBridge,05/26/2013 05:00:00 AM,48,-122,0,5,5
5646,FremontBridge,05/26/2013 06:00:00 AM,48,-122,6,5,11
5647,FremontBridge,05/26/2013 07:00:00 AM,48,-122,6,11,17
5648,FremontBridge,05/26/2013 08:00:00 AM,48,-122,10,7,17
5649,FremontBridge,05/26/2013 09:00:00 AM,48,-122,9,25,34
5650,FremontBridge,05/26/2013 10:00:00 AM,48,-122,11,42,53
5651,FremontBridge,05/26/2013 11:00:00 AM,48,-122,20,38,58
5652,FremontBridge,05/26/2013 12:00:00 PM,48,-122,45,47,92
5653,FremontBridge,05/26/2013 01:00:00 PM,48,-122,40,51,91
5654,FremontBridge,05/26/2013 02:00:00 PM,48,-122,37,54,91
5655,FremontBridge,05/26/2013 03:00:00 PM,48,-122,46,75,121
5656,FremontBridge,05/26/2013 04:00:00 PM,48,-122,52,85,137
5657,FremontBridge,05/26/2013 05:00:00 PM,48,-122,48,64,112
5658,FremontBridge,05/26/2013 06:00:00 PM,48,-122,51,44,95
5659,FremontBridge,05/26/2013 07:00:00 PM,48,-122,46,36,82
5660,FremontBridge,05/26/2013 08:00:00 PM,48,-122,23,30,53
5661,FremontBridge,05/26/2013 09:00:00 PM,48,-122,24,9,33
5662,FremontBridge,05/26/2013 10:00:00 PM,48,-122,17,14,31
5663,FremontBridge,05/26/2013 11:00:00 PM,48,-122,16,9,25
5664,FremontBridge,05/27/2013 12:00:00 AM,48,-122,5,10,15
5665,FremontBridge,05/27/2013 01:00:00 AM,48,-122,5,7,12
5666,FremontBridge,05/27/2013 02:00:00 AM,48,-122,2,2,4
5667,FremontBridge,05/27/2013 03:00:00 AM,48,-122,1,1,2
5668,FremontBridge,05/27/2013 04:00:00 AM,48,-122,1,1,2
5669,FremontBridge,05/27/2013 05:00:00 AM,48,-122,6,6,12
5670,FremontBridge,05/27/2013 06:00:00 AM,48,-122,11,6,17
5671,FremontBridge,05/27/2013 07:00:00 AM,48,-122,19,23,42
5672,FremontBridge,05/27/2013 08:00:00 AM,48,-122,26,39,65
5673,FremontBridge,05/27/2013 09:00:00 AM,48,-122,22,35,57
5674,FremontBridge,05/27/2013 10:00:00 AM,48,-122,27,38,65
5675,FremontBridge,05/27/2013 11:00:00 AM,48,-122,18,32,50
5676,FremontBridge,05/27/2013 12:00:00 PM,48,-122,29,29,58
5677,FremontBridge,05/27/2013 01:00:00 PM,48,-122,23,20,43
5678,FremontBridge,05/27/2013 02:00:00 PM,48,-122,26,22,48
5679,FremontBridge,05/27/2013 03:00:00 PM,48,-122,31,21,52
5680,FremontBridge,05/27/2013 04:00:00 PM,48,-122,28,16,44
5681,FremontBridge,05/27/2013 05:00:00 PM,48,-122,19,19,38
5682,FremontBridge,05/27/2013 06:00:00 PM,48,-122,20,18,38
5683,FremontBridge,05/27/2013 07:00:00 PM,48,-122,17,7,24
5684,FremontBridge,05/27/2013 08:00:00 PM,48,-122,19,12,31
5685,FremontBridge,05/27/2013 09:00:00 PM,48,-122,13,10,23
5686,FremontBridge,05/27/2013 10:00:00 PM,48,-122,10,8,18
5687,FremontBridge,05/27/2013 11:00:00 PM,48,-122,6,3,9
5688,FremontBridge,05/28/2013 12:00:00 AM,48,-122,6,3,9
5689,FremontBridge,05/28/2013 01:00:00 AM,48,-122,1,3,4
5690,FremontBridge,05/28/2013 02:00:00 AM,48,-122,0,7,7
5691,FremontBridge,05/28/2013 03:00:00 AM,48,-122,0,2,2
5692,FremontBridge,05/28/2013 04:00:00 AM,48,-122,2,2,4
5693,FremontBridge,05/28/2013 05:00:00 AM,48,-122,6,23,29
5694,FremontBridge,05/28/2013 06:00:00 AM,48,-122,36,106,142
5695,FremontBridge,05/28/2013 07:00:00 AM,48,-122,95,252,347
5696,FremontBridge,05/28/2013 08:00:00 AM,48,-122,125,337,462
5697,FremontBridge,05/28/2013 09:00:00 AM,48,-122,86,163,249
5698,FremontBridge,05/28/2013 10:00:00 AM,48,-122,35,67,102
5699,FremontBridge,05/28/2013 11:00:00 AM,48,-122,31,48,79
5700,FremontBridge,05/28/2013 12:00:00 PM,48,-122,21,42,63
5701,FremontBridge,05/28/2013 01:00:00 PM,48,-122,52,45,97
5702,FremontBridge,05/28/2013 02:00:00 PM,48,-122,41,46,87
5703,FremontBridge,05/28/2013 03:00:00 PM,48,-122,66,48,114
5704,FremontBridge,05/28/2013 04:00:00 PM,48,-122,141,89,230
5705,FremontBridge,05/28/2013 05:00:00 PM,48,-122,392,152,544
5706,FremontBridge,05/28/2013 06:00:00 PM,48,-122,264,146,410
5707,FremontBridge,05/28/2013 07:00:00 PM,48,-122,107,62,169
5708,FremontBridge,05/28/2013 08:00:00 PM,48,-122,51,44,95
5709,FremontBridge,05/28/2013 09:00:00 PM,48,-122,26,33,59
5710,FremontBridge,05/28/2013 10:00:00 PM,48,-122,23,18,41
5711,FremontBridge,05/28/2013 11:00:00 PM,48,-122,8,6,14
5712,FremontBridge,05/29/2013 12:00:00 AM,48,-122,8,4,12
5713,FremontBridge,05/29/2013 01:00:00 AM,48,-122,2,1,3
5714,FremontBridge,05/29/2013 02:00:00 AM,48,-122,1,2,3
5715,FremontBridge,05/29/2013 03:00:00 AM,48,-122,0,0,0
5716,FremontBridge,05/29/2013 04:00:00 AM,48,-122,2,3,5
5717,FremontBridge,05/29/2013 05:00:00 AM,48,-122,2,22,24
5718,FremontBridge,05/29/2013 06:00:00 AM,48,-122,39,80,119
5719,FremontBridge,05/29/2013 07:00:00 AM,48,-122,63,214,277
5720,FremontBridge,05/29/2013 08:00:00 AM,48,-122,108,299,407
5721,FremontBridge,05/29/2013 09:00:00 AM,48,-122,76,194,270
5722,FremontBridge,05/29/2013 10:00:00 AM,48,-122,39,59,98
5723,FremontBridge,05/29/2013 11:00:00 AM,48,-122,41,44,85
5724,FremontBridge,05/29/2013 12:00:00 PM,48,-122,27,39,66
5725,FremontBridge,05/29/2013 01:00:00 PM,48,-122,37,28,65
5726,FremontBridge,05/29/2013 02:00:00 PM,48,-122,47,43,90
5727,FremontBridge,05/29/2013 03:00:00 PM,48,-122,76,62,138
5728,FremontBridge,05/29/2013 04:00:00 PM,48,-122,136,88,224
5729,FremontBridge,05/29/2013 05:00:00 PM,48,-122,294,150,444
5730,FremontBridge,05/29/2013 06:00:00 PM,48,-122,270,144,414
5731,FremontBridge,05/29/2013 07:00:00 PM,48,-122,139,47,186
5732,FremontBridge,05/29/2013 08:00:00 PM,48,-122,47,33,80
5733,FremontBridge,05/29/2013 09:00:00 PM,48,-122,33,39,72
5734,FremontBridge,05/29/2013 10:00:00 PM,48,-122,21,16,37
5735,FremontBridge,05/29/2013 11:00:00 PM,48,-122,11,7,18
5736,FremontBridge,05/30/2013 12:00:00 AM,48,-122,8,3,11
5737,FremontBridge,05/30/2013 01:00:00 AM,48,-122,2,4,6
5738,FremontBridge,05/30/2013 02:00:00 AM,48,-122,1,2,3
5739,FremontBridge,05/30/2013 03:00:00 AM,48,-122,0,3,3
5740,FremontBridge,05/30/2013 04:00:00 AM,48,-122,4,4,8
5741,FremontBridge,05/30/2013 05:00:00 AM,48,-122,13,29,42
5742,FremontBridge,05/30/2013 06:00:00 AM,48,-122,50,120,170
5743,FremontBridge,05/30/2013 07:00:00 AM,48,-122,92,283,375
5744,FremontBridge,05/30/2013 08:00:00 AM,48,-122,145,370,515
5745,FremontBridge,05/30/2013 09:00:00 AM,48,-122,92,184,276
5746,FremontBridge,05/30/2013 10:00:00 AM,48,-122,49,93,142
5747,FremontBridge,05/30/2013 11:00:00 AM,48,-122,34,53,87
5748,FremontBridge,05/30/2013 12:00:00 PM,48,-122,43,47,90
5749,FremontBridge,05/30/2013 01:00:00 PM,48,-122,52,43,95
5750,FremontBridge,05/30/2013 02:00:00 PM,48,-122,51,57,108
5751,FremontBridge,05/30/2013 03:00:00 PM,48,-122,73,59,132
5752,FremontBridge,05/30/2013 04:00:00 PM,48,-122,166,103,269
5753,FremontBridge,05/30/2013 05:00:00 PM,48,-122,425,182,607
5754,FremontBridge,05/30/2013 06:00:00 PM,48,-122,335,167,502
5755,FremontBridge,05/30/2013 07:00:00 PM,48,-122,135,85,220
5756,FremontBridge,05/30/2013 08:00:00 PM,48,-122,74,50,124
5757,FremontBridge,05/30/2013 09:00:00 PM,48,-122,50,34,84
5758,FremontBridge,05/30/2013 10:00:00 PM,48,-122,30,27,57
5759,FremontBridge,05/30/2013 11:00:00 PM,48,-122,17,20,37
5760,FremontBridge,05/31/2013 12:00:00 AM,48,-122,3,15,18
5761,FremontBridge,05/31/2013 01:00:00 AM,48,-122,7,5,12
5762,FremontBridge,05/31/2013 02:00:00 AM,48,-122,2,2,4
5763,FremontBridge,05/31/2013 03:00:00 AM,48,-122,0,3,3
5764,FremontBridge,05/31/2013 04:00:00 AM,48,-122,1,1,2
5765,FremontBridge,05/31/2013 05:00:00 AM,48,-122,9,24,33
5766,FremontBridge,05/31/2013 06:00:00 AM,48,-122,44,125,169
5767,FremontBridge,05/31/2013 07:00:00 AM,48,-122,103,286,389
5768,FremontBridge,05/31/2013 08:00:00 AM,48,-122,139,401,540
5769,FremontBridge,05/31/2013 09:00:00 AM,48,-122,108,197,305
5770,FremontBridge,05/31/2013 10:00:00 AM,48,-122,63,87,150
5771,FremontBridge,05/31/2013 11:00:00 AM,48,-122,55,67,122
5772,FremontBridge,05/31/2013 12:00:00 PM,48,-122,48,58,106
5773,FremontBridge,05/31/2013 01:00:00 PM,48,-122,71,67,138
5774,FremontBridge,05/31/2013 02:00:00 PM,48,-122,74,68,142
5775,FremontBridge,05/31/2013 03:00:00 PM,48,-122,114,102,216
5776,FremontBridge,05/31/2013 04:00:00 PM,48,-122,238,144,382
5777,FremontBridge,05/31/2013 05:00:00 PM,48,-122,486,203,689
5778,FremontBridge,05/31/2013 06:00:00 PM,48,-122,259,159,418
5779,FremontBridge,05/31/2013 07:00:00 PM,48,-122,122,117,239
5780,FremontBridge,05/31/2013 08:00:00 PM,48,-122,92,65,157
5781,FremontBridge,05/31/2013 09:00:00 PM,48,-122,41,43,84
5782,FremontBridge,05/31/2013 10:00:00 PM,48,-122,20,39,59
5783,FremontBridge,05/31/2013 11:00:00 PM,48,-122,20,18,38
5784,FremontBridge,06/01/2013 12:00:00 AM,48,-122,18,14,32
5785,FremontBridge,06/01/2013 01:00:00 AM,48,-122,11,11,22
5786,FremontBridge,06/01/2013 02:00:00 AM,48,-122,3,3,6
5787,FremontBridge,06/01/2013 03:00:00 AM,48,-122,2,5,7
5788,FremontBridge,06/01/2013 04:00:00 AM,48,-122,1,7,8
5789,FremontBridge,06/01/2013 05:00:00 AM,48,-122,5,8,13
5790,FremontBridge,06/01/2013 06:00:00 AM,48,-122,12,17,29
5791,FremontBridge,06/01/2013 07:00:00 AM,48,-122,25,28,53
5792,FremontBridge,06/01/2013 08:00:00 AM,48,-122,32,54,86
5793,FremontBridge,06/01/2013 09:00:00 AM,48,-122,64,71,135
5794,FremontBridge,06/01/2013 10:00:00 AM,48,-122,56,74,130
5795,FremontBridge,06/01/2013 11:00:00 AM,48,-122,64,87,151
5796,FremontBridge,06/01/2013 12:00:00 PM,48,-122,62,110,172
5797,FremontBridge,06/01/2013 01:00:00 PM,48,-122,80,114,194
5798,FremontBridge,06/01/2013 02:00:00 PM,48,-122,86,114,200
5799,FremontBridge,06/01/2013 03:00:00 PM,48,-122,111,133,244
5800,FremontBridge,06/01/2013 04:00:00 PM,48,-122,74,97,171
5801,FremontBridge,06/01/2013 05:00:00 PM,48,-122,93,110,203
5802,FremontBridge,06/01/2013 06:00:00 PM,48,-122,43,74,117
5803,FremontBridge,06/01/2013 07:00:00 PM,48,-122,44,59,103
5804,FremontBridge,06/01/2013 08:00:00 PM,48,-122,20,27,47
5805,FremontBridge,06/01/2013 09:00:00 PM,48,-122,13,18,31
5806,FremontBridge,06/01/2013 10:00:00 PM,48,-122,33,20,53
5807,FremontBridge,06/01/2013 11:00:00 PM,48,-122,20,13,33
5808,FremontBridge,06/02/2013 12:00:00 AM,48,-122,9,14,23
5809,FremontBridge,06/02/2013 01:00:00 AM,48,-122,9,13,22
5810,FremontBridge,06/02/2013 02:00:00 AM,48,-122,9,4,13
5811,FremontBridge,06/02/2013 03:00:00 AM,48,-122,0,2,2
5812,FremontBridge,06/02/2013 04:00:00 AM,48,-122,2,6,8
5813,FremontBridge,06/02/2013 05:00:00 AM,48,-122,1,6,7
5814,FremontBridge,06/02/2013 06:00:00 AM,48,-122,4,7,11
5815,FremontBridge,06/02/2013 07:00:00 AM,48,-122,9,18,27
5816,FremontBridge,06/02/2013 08:00:00 AM,48,-122,22,54,76
5817,FremontBridge,06/02/2013 09:00:00 AM,48,-122,43,85,128
5818,FremontBridge,06/02/2013 10:00:00 AM,48,-122,69,97,166
5819,FremontBridge,06/02/2013 11:00:00 AM,48,-122,79,134,213
5820,FremontBridge,06/02/2013 12:00:00 PM,48,-122,114,149,263
5821,FremontBridge,06/02/2013 01:00:00 PM,48,-122,93,131,224
5822,FremontBridge,06/02/2013 02:00:00 PM,48,-122,125,167,292
5823,FremontBridge,06/02/2013 03:00:00 PM,48,-122,118,129,247
5824,FremontBridge,06/02/2013 04:00:00 PM,48,-122,105,128,233
5825,FremontBridge,06/02/2013 05:00:00 PM,48,-122,83,118,201
5826,FremontBridge,06/02/2013 06:00:00 PM,48,-122,87,113,200
5827,FremontBridge,06/02/2013 07:00:00 PM,48,-122,39,59,98
5828,FremontBridge,06/02/2013 08:00:00 PM,48,-122,32,58,90
5829,FremontBridge,06/02/2013 09:00:00 PM,48,-122,18,46,64
5830,FremontBridge,06/02/2013 10:00:00 PM,48,-122,17,19,36
5831,FremontBridge,06/02/2013 11:00:00 PM,48,-122,21,11,32
5832,FremontBridge,06/03/2013 12:00:00 AM,48,-122,13,10,23
5833,FremontBridge,06/03/2013 01:00:00 AM,48,-122,5,4,9
5834,FremontBridge,06/03/2013 02:00:00 AM,48,-122,1,2,3
5835,FremontBridge,06/03/2013 03:00:00 AM,48,-122,0,3,3
5836,FremontBridge,06/03/2013 04:00:00 AM,48,-122,2,3,5
5837,FremontBridge,06/03/2013 05:00:00 AM,48,-122,13,25,38
5838,FremontBridge,06/03/2013 06:00:00 AM,48,-122,51,125,176
5839,FremontBridge,06/03/2013 07:00:00 AM,48,-122,106,303,409
5840,FremontBridge,06/03/2013 08:00:00 AM,48,-122,167,353,520
5841,FremontBridge,06/03/2013 09:00:00 AM,48,-122,91,176,267
5842,FremontBridge,06/03/2013 10:00:00 AM,48,-122,51,60,111
5843,FremontBridge,06/03/2013 11:00:00 AM,48,-122,29,52,81
5844,FremontBridge,06/03/2013 12:00:00 PM,48,-122,43,44,87
5845,FremontBridge,06/03/2013 01:00:00 PM,48,-122,43,56,99
5846,FremontBridge,06/03/2013 02:00:00 PM,48,-122,53,67,120
5847,FremontBridge,06/03/2013 03:00:00 PM,48,-122,104,83,187
5848,FremontBridge,06/03/2013 04:00:00 PM,48,-122,200,125,325
5849,FremontBridge,06/03/2013 05:00:00 PM,48,-122,457,213,670
5850,FremontBridge,06/03/2013 06:00:00 PM,48,-122,348,212,560
5851,FremontBridge,06/03/2013 07:00:00 PM,48,-122,153,96,249
5852,FremontBridge,06/03/2013 08:00:00 PM,48,-122,74,70,144
5853,FremontBridge,06/03/2013 09:00:00 PM,48,-122,48,74,122
5854,FremontBridge,06/03/2013 10:00:00 PM,48,-122,35,24,59
5855,FremontBridge,06/03/2013 11:00:00 PM,48,-122,19,6,25
5856,FremontBridge,06/04/2013 12:00:00 AM,48,-122,7,2,9
5857,FremontBridge,06/04/2013 01:00:00 AM,48,-122,5,3,8
5858,FremontBridge,06/04/2013 02:00:00 AM,48,-122,0,2,2
5859,FremontBridge,06/04/2013 03:00:00 AM,48,-122,1,1,2
5860,FremontBridge,06/04/2013 04:00:00 AM,48,-122,3,5,8
5861,FremontBridge,06/04/2013 05:00:00 AM,48,-122,12,36,48
5862,FremontBridge,06/04/2013 06:00:00 AM,48,-122,60,145,205
5863,FremontBridge,06/04/2013 07:00:00 AM,48,-122,138,360,498
5864,FremontBridge,06/04/2013 08:00:00 AM,48,-122,173,428,601
5865,FremontBridge,06/04/2013 09:00:00 AM,48,-122,99,244,343
5866,FremontBridge,06/04/2013 10:00:00 AM,48,-122,64,71,135
5867,FremontBridge,06/04/2013 11:00:00 AM,48,-122,39,67,106
5868,FremontBridge,06/04/2013 12:00:00 PM,48,-122,61,79,140
5869,FremontBridge,06/04/2013 01:00:00 PM,48,-122,62,79,141
5870,FremontBridge,06/04/2013 02:00:00 PM,48,-122,80,54,134
5871,FremontBridge,06/04/2013 03:00:00 PM,48,-122,95,90,185
5872,FremontBridge,06/04/2013 04:00:00 PM,48,-122,236,146,382
5873,FremontBridge,06/04/2013 05:00:00 PM,48,-122,532,238,770
5874,FremontBridge,06/04/2013 06:00:00 PM,48,-122,400,232,632
5875,FremontBridge,06/04/2013 07:00:00 PM,48,-122,175,148,323
5876,FremontBridge,06/04/2013 08:00:00 PM,48,-122,98,92,190
5877,FremontBridge,06/04/2013 09:00:00 PM,48,-122,71,83,154
5878,FremontBridge,06/04/2013 10:00:00 PM,48,-122,35,34,69
5879,FremontBridge,06/04/2013 11:00:00 PM,48,-122,20,16,36
5880,FremontBridge,06/05/2013 12:00:00 AM,48,-122,11,11,22
5881,FremontBridge,06/05/2013 01:00:00 AM,48,-122,5,5,10
5882,FremontBridge,06/05/2013 02:00:00 AM,48,-122,3,8,11
5883,FremontBridge,06/05/2013 03:00:00 AM,48,-122,1,3,4
5884,FremontBridge,06/05/2013 04:00:00 AM,48,-122,1,10,11
5885,FremontBridge,06/05/2013 05:00:00 AM,48,-122,15,31,46
5886,FremontBridge,06/05/2013 06:00:00 AM,48,-122,60,148,208
5887,FremontBridge,06/05/2013 07:00:00 AM,48,-122,123,322,445
5888,FremontBridge,06/05/2013 08:00:00 AM,48,-122,190,389,579
5889,FremontBridge,06/05/2013 09:00:00 AM,48,-122,131,245,376
5890,FremontBridge,06/05/2013 10:00:00 AM,48,-122,67,88,155
5891,FremontBridge,06/05/2013 11:00:00 AM,48,-122,58,61,119
5892,FremontBridge,06/05/2013 12:00:00 PM,48,-122,61,71,132
5893,FremontBridge,06/05/2013 01:00:00 PM,48,-122,68,60,128
5894,FremontBridge,06/05/2013 02:00:00 PM,48,-122,82,85,167
5895,FremontBridge,06/05/2013 03:00:00 PM,48,-122,110,103,213
5896,FremontBridge,06/05/2013 04:00:00 PM,48,-122,222,144,366
5897,FremontBridge,06/05/2013 05:00:00 PM,48,-122,498,255,753
5898,FremontBridge,06/05/2013 06:00:00 PM,48,-122,364,215,579
5899,FremontBridge,06/05/2013 07:00:00 PM,48,-122,181,120,301
5900,FremontBridge,06/05/2013 08:00:00 PM,48,-122,113,76,189
5901,FremontBridge,06/05/2013 09:00:00 PM,48,-122,51,53,104
5902,FremontBridge,06/05/2013 10:00:00 PM,48,-122,30,56,86
5903,FremontBridge,06/05/2013 11:00:00 PM,48,-122,21,13,34
5904,FremontBridge,06/06/2013 12:00:00 AM,48,-122,5,6,11
5905,FremontBridge,06/06/2013 01:00:00 AM,48,-122,4,6,10
5906,FremontBridge,06/06/2013 02:00:00 AM,48,-122,2,7,9
5907,FremontBridge,06/06/2013 03:00:00 AM,48,-122,1,1,2
5908,FremontBridge,06/06/2013 04:00:00 AM,48,-122,2,5,7
5909,FremontBridge,06/06/2013 05:00:00 AM,48,-122,12,38,50
5910,FremontBridge,06/06/2013 06:00:00 AM,48,-122,62,122,184
5911,FremontBridge,06/06/2013 07:00:00 AM,48,-122,129,295,424
5912,FremontBridge,06/06/2013 08:00:00 AM,48,-122,194,384,578
5913,FremontBridge,06/06/2013 09:00:00 AM,48,-122,113,213,326
5914,FremontBridge,06/06/2013 10:00:00 AM,48,-122,62,78,140
5915,FremontBridge,06/06/2013 11:00:00 AM,48,-122,40,63,103
5916,FremontBridge,06/06/2013 12:00:00 PM,48,-122,47,69,116
5917,FremontBridge,06/06/2013 01:00:00 PM,48,-122,84,74,158
5918,FremontBridge,06/06/2013 02:00:00 PM,48,-122,74,63,137
5919,FremontBridge,06/06/2013 03:00:00 PM,48,-122,80,75,155
5920,FremontBridge,06/06/2013 04:00:00 PM,48,-122,231,136,367
5921,FremontBridge,06/06/2013 05:00:00 PM,48,-122,468,214,682
5922,FremontBridge,06/06/2013 06:00:00 PM,48,-122,310,184,494
5923,FremontBridge,06/06/2013 07:00:00 PM,48,-122,177,120,297
5924,FremontBridge,06/06/2013 08:00:00 PM,48,-122,83,62,145
5925,FremontBridge,06/06/2013 09:00:00 PM,48,-122,44,51,95
5926,FremontBridge,06/06/2013 10:00:00 PM,48,-122,31,75,106
5927,FremontBridge,06/06/2013 11:00:00 PM,48,-122,35,8,43
5928,FremontBridge,06/07/2013 12:00:00 AM,48,-122,8,7,15
5929,FremontBridge,06/07/2013 01:00:00 AM,48,-122,5,2,7
5930,FremontBridge,06/07/2013 02:00:00 AM,48,-122,1,3,4
5931,FremontBridge,06/07/2013 03:00:00 AM,48,-122,3,0,3
5932,FremontBridge,06/07/2013 04:00:00 AM,48,-122,2,4,6
5933,FremontBridge,06/07/2013 05:00:00 AM,48,-122,11,26,37
5934,FremontBridge,06/07/2013 06:00:00 AM,48,-122,49,109,158
5935,FremontBridge,06/07/2013 07:00:00 AM,48,-122,93,232,325
5936,FremontBridge,06/07/2013 08:00:00 AM,48,-122,152,345,497
5937,FremontBridge,06/07/2013 09:00:00 AM,48,-122,86,194,280
5938,FremontBridge,06/07/2013 10:00:00 AM,48,-122,54,66,120
5939,FremontBridge,06/07/2013 11:00:00 AM,48,-122,45,53,98
5940,FremontBridge,06/07/2013 12:00:00 PM,48,-122,51,59,110
5941,FremontBridge,06/07/2013 01:00:00 PM,48,-122,60,56,116
5942,FremontBridge,06/07/2013 02:00:00 PM,48,-122,67,65,132
5943,FremontBridge,06/07/2013 03:00:00 PM,48,-122,64,59,123
5944,FremontBridge,06/07/2013 04:00:00 PM,48,-122,200,127,327
5945,FremontBridge,06/07/2013 05:00:00 PM,48,-122,295,128,423
5946,FremontBridge,06/07/2013 06:00:00 PM,48,-122,280,170,450
5947,FremontBridge,06/07/2013 07:00:00 PM,48,-122,94,62,156
5948,FremontBridge,06/07/2013 08:00:00 PM,48,-122,76,37,113
5949,FremontBridge,06/07/2013 09:00:00 PM,48,-122,46,37,83
5950,FremontBridge,06/07/2013 10:00:00 PM,48,-122,24,21,45
5951,FremontBridge,06/07/2013 11:00:00 PM,48,-122,26,22,48
5952,FremontBridge,06/08/2013 12:00:00 AM,48,-122,24,7,31
5953,FremontBridge,06/08/2013 01:00:00 AM,48,-122,11,8,19
5954,FremontBridge,06/08/2013 02:00:00 AM,48,-122,3,4,7
5955,FremontBridge,06/08/2013 03:00:00 AM,48,-122,0,5,5
5956,FremontBridge,06/08/2013 04:00:00 AM,48,-122,2,1,3
5957,FremontBridge,06/08/2013 05:00:00 AM,48,-122,2,3,5
5958,FremontBridge,06/08/2013 06:00:00 AM,48,-122,14,10,24
5959,FremontBridge,06/08/2013 07:00:00 AM,48,-122,15,27,42
5960,FremontBridge,06/08/2013 08:00:00 AM,48,-122,33,51,84
5961,FremontBridge,06/08/2013 09:00:00 AM,48,-122,44,71,115
5962,FremontBridge,06/08/2013 10:00:00 AM,48,-122,59,75,134
5963,FremontBridge,06/08/2013 11:00:00 AM,48,-122,61,79,140
5964,FremontBridge,06/08/2013 12:00:00 PM,48,-122,69,62,131
5965,FremontBridge,06/08/2013 01:00:00 PM,48,-122,98,88,186
5966,FremontBridge,06/08/2013 02:00:00 PM,48,-122,79,98,177
5967,FremontBridge,06/08/2013 03:00:00 PM,48,-122,66,113,179
5968,FremontBridge,06/08/2013 04:00:00 PM,48,-122,84,91,175
5969,FremontBridge,06/08/2013 05:00:00 PM,48,-122,95,89,184
5970,FremontBridge,06/08/2013 06:00:00 PM,48,-122,79,83,162
5971,FremontBridge,06/08/2013 07:00:00 PM,48,-122,44,78,122
5972,FremontBridge,06/08/2013 08:00:00 PM,48,-122,27,35,62
5973,FremontBridge,06/08/2013 09:00:00 PM,48,-122,26,39,65
5974,FremontBridge,06/08/2013 10:00:00 PM,48,-122,39,36,75
5975,FremontBridge,06/08/2013 11:00:00 PM,48,-122,31,21,52
5976,FremontBridge,06/09/2013 12:00:00 AM,48,-122,14,12,26
5977,FremontBridge,06/09/2013 01:00:00 AM,48,-122,7,3,10
5978,FremontBridge,06/09/2013 02:00:00 AM,48,-122,3,6,9
5979,FremontBridge,06/09/2013 03:00:00 AM,48,-122,2,4,6
5980,FremontBridge,06/09/2013 04:00:00 AM,48,-122,3,2,5
5981,FremontBridge,06/09/2013 05:00:00 AM,48,-122,1,4,5
5982,FremontBridge,06/09/2013 06:00:00 AM,48,-122,9,9,18
5983,FremontBridge,06/09/2013 07:00:00 AM,48,-122,11,14,25
5984,FremontBridge,06/09/2013 08:00:00 AM,48,-122,39,40,79
5985,FremontBridge,06/09/2013 09:00:00 AM,48,-122,43,50,93
5986,FremontBridge,06/09/2013 10:00:00 AM,48,-122,47,104,151
5987,FremontBridge,06/09/2013 11:00:00 AM,48,-122,54,85,139
5988,FremontBridge,06/09/2013 12:00:00 PM,48,-122,68,75,143
5989,FremontBridge,06/09/2013 01:00:00 PM,48,-122,110,118,228
5990,FremontBridge,06/09/2013 02:00:00 PM,48,-122,80,100,180
5991,FremontBridge,06/09/2013 03:00:00 PM,48,-122,89,144,233
5992,FremontBridge,06/09/2013 04:00:00 PM,48,-122,88,121,209
5993,FremontBridge,06/09/2013 05:00:00 PM,48,-122,77,98,175
5994,FremontBridge,06/09/2013 06:00:00 PM,48,-122,51,63,114
5995,FremontBridge,06/09/2013 07:00:00 PM,48,-122,45,50,95
5996,FremontBridge,06/09/2013 08:00:00 PM,48,-122,18,35,53
5997,FremontBridge,06/09/2013 09:00:00 PM,48,-122,13,18,31
5998,FremontBridge,06/09/2013 10:00:00 PM,48,-122,14,14,28
5999,FremontBridge,06/09/2013 11:00:00 PM,48,-122,12,14,26
6000,FremontBridge,06/10/2013 12:00:00 AM,48,-122,7,2,9
6001,FremontBridge,06/10/2013 01:00:00 AM,48,-122,1,5,6
6002,FremontBridge,06/10/2013 02:00:00 AM,48,-122,2,3,5
6003,FremontBridge,06/10/2013 03:00:00 AM,48,-122,3,0,3
6004,FremontBridge,06/10/2013 04:00:00 AM,48,-122,4,4,8
6005,FremontBridge,06/10/2013 05:00:00 AM,48,-122,21,31,52
6006,FremontBridge,06/10/2013 06:00:00 AM,48,-122,54,112,166
6007,FremontBridge,06/10/2013 07:00:00 AM,48,-122,112,299,411
6008,FremontBridge,06/10/2013 08:00:00 AM,48,-122,168,389,557
6009,FremontBridge,06/10/2013 09:00:00 AM,48,-122,95,196,291
6010,FremontBridge,06/10/2013 10:00:00 AM,48,-122,43,71,114
6011,FremontBridge,06/10/2013 11:00:00 AM,48,-122,33,50,83
6012,FremontBridge,06/10/2013 12:00:00 PM,48,-122,58,45,103
6013,FremontBridge,06/10/2013 01:00:00 PM,48,-122,61,78,139
6014,FremontBridge,06/10/2013 02:00:00 PM,48,-122,56,58,114
6015,FremontBridge,06/10/2013 03:00:00 PM,48,-122,115,75,190
6016,FremontBridge,06/10/2013 04:00:00 PM,48,-122,206,147,353
6017,FremontBridge,06/10/2013 05:00:00 PM,48,-122,465,189,654
6018,FremontBridge,06/10/2013 06:00:00 PM,48,-122,353,192,545
6019,FremontBridge,06/10/2013 07:00:00 PM,48,-122,147,88,235
6020,FremontBridge,06/10/2013 08:00:00 PM,48,-122,63,73,136
6021,FremontBridge,06/10/2013 09:00:00 PM,48,-122,38,60,98
6022,FremontBridge,06/10/2013 10:00:00 PM,48,-122,31,30,61
6023,FremontBridge,06/10/2013 11:00:00 PM,48,-122,18,18,36
6024,FremontBridge,06/11/2013 12:00:00 AM,48,-122,11,3,14
6025,FremontBridge,06/11/2013 01:00:00 AM,48,-122,2,2,4
6026,FremontBridge,06/11/2013 02:00:00 AM,48,-122,6,5,11
6027,FremontBridge,06/11/2013 03:00:00 AM,48,-122,1,3,4
6028,FremontBridge,06/11/2013 04:00:00 AM,48,-122,6,6,12
6029,FremontBridge,06/11/2013 05:00:00 AM,48,-122,11,32,43
6030,FremontBridge,06/11/2013 06:00:00 AM,48,-122,47,102,149
6031,FremontBridge,06/11/2013 07:00:00 AM,48,-122,108,276,384
6032,FremontBridge,06/11/2013 08:00:00 AM,48,-122,152,333,485
6033,FremontBridge,06/11/2013 09:00:00 AM,48,-122,86,186,272
6034,FremontBridge,06/11/2013 10:00:00 AM,48,-122,50,75,125
6035,FremontBridge,06/11/2013 11:00:00 AM,48,-122,25,32,57
6036,FremontBridge,06/11/2013 12:00:00 PM,48,-122,29,37,66
6037,FremontBridge,06/11/2013 01:00:00 PM,48,-122,35,32,67
6038,FremontBridge,06/11/2013 02:00:00 PM,48,-122,32,33,65
6039,FremontBridge,06/11/2013 03:00:00 PM,48,-122,80,55,135
6040,FremontBridge,06/11/2013 04:00:00 PM,48,-122,172,107,279
6041,FremontBridge,06/11/2013 05:00:00 PM,48,-122,376,185,561
6042,FremontBridge,06/11/2013 06:00:00 PM,48,-122,272,151,423
6043,FremontBridge,06/11/2013 07:00:00 PM,48,-122,132,84,216
6044,FremontBridge,06/11/2013 08:00:00 PM,48,-122,61,57,118
6045,FremontBridge,06/11/2013 09:00:00 PM,48,-122,44,58,102
6046,FremontBridge,06/11/2013 10:00:00 PM,48,-122,40,18,58
6047,FremontBridge,06/11/2013 11:00:00 PM,48,-122,17,11,28
6048,FremontBridge,06/12/2013 12:00:00 AM,48,-122,8,5,13
6049,FremontBridge,06/12/2013 01:00:00 AM,48,-122,1,3,4
6050,FremontBridge,06/12/2013 02:00:00 AM,48,-122,0,5,5
6051,FremontBridge,06/12/2013 03:00:00 AM,48,-122,2,2,4
6052,FremontBridge,06/12/2013 04:00:00 AM,48,-122,3,3,6
6053,FremontBridge,06/12/2013 05:00:00 AM,48,-122,10,23,33
6054,FremontBridge,06/12/2013 06:00:00 AM,48,-122,39,102,141
6055,FremontBridge,06/12/2013 07:00:00 AM,48,-122,93,257,350
6056,FremontBridge,06/12/2013 08:00:00 AM,48,-122,141,317,458
6057,FremontBridge,06/12/2013 09:00:00 AM,48,-122,112,187,299
6058,FremontBridge,06/12/2013 10:00:00 AM,48,-122,54,76,130
6059,FremontBridge,06/12/2013 11:00:00 AM,48,-122,63,60,123
6060,FremontBridge,06/12/2013 12:00:00 PM,48,-122,46,58,104
6061,FremontBridge,06/12/2013 01:00:00 PM,48,-122,51,61,112
6062,FremontBridge,06/12/2013 02:00:00 PM,48,-122,54,54,108
6063,FremontBridge,06/12/2013 03:00:00 PM,48,-122,90,79,169
6064,FremontBridge,06/12/2013 04:00:00 PM,48,-122,182,116,298
6065,FremontBridge,06/12/2013 05:00:00 PM,48,-122,396,205,601
6066,FremontBridge,06/12/2013 06:00:00 PM,48,-122,317,197,514
6067,FremontBridge,06/12/2013 07:00:00 PM,48,-122,132,87,219
6068,FremontBridge,06/12/2013 08:00:00 PM,48,-122,82,54,136
6069,FremontBridge,06/12/2013 09:00:00 PM,48,-122,49,49,98
6070,FremontBridge,06/12/2013 10:00:00 PM,48,-122,22,28,50
6071,FremontBridge,06/12/2013 11:00:00 PM,48,-122,20,10,30
6072,FremontBridge,06/13/2013 12:00:00 AM,48,-122,6,11,17
6073,FremontBridge,06/13/2013 01:00:00 AM,48,-122,1,4,5
6074,FremontBridge,06/13/2013 02:00:00 AM,48,-122,5,5,10
6075,FremontBridge,06/13/2013 03:00:00 AM,48,-122,2,0,2
6076,FremontBridge,06/13/2013 04:00:00 AM,48,-122,3,5,8
6077,FremontBridge,06/13/2013 05:00:00 AM,48,-122,10,26,36
6078,FremontBridge,06/13/2013 06:00:00 AM,48,-122,49,84,133
6079,FremontBridge,06/13/2013 07:00:00 AM,48,-122,84,259,343
6080,FremontBridge,06/13/2013 08:00:00 AM,48,-122,151,334,485
6081,FremontBridge,06/13/2013 09:00:00 AM,48,-122,100,168,268
6082,FremontBridge,06/13/2013 10:00:00 AM,48,-122,50,73,123
6083,FremontBridge,06/13/2013 11:00:00 AM,48,-122,43,50,93
6084,FremontBridge,06/13/2013 12:00:00 PM,48,-122,34,44,78
6085,FremontBridge,06/13/2013 01:00:00 PM,48,-122,62,56,118
6086,FremontBridge,06/13/2013 02:00:00 PM,48,-122,56,66,122
6087,FremontBridge,06/13/2013 03:00:00 PM,48,-122,78,58,136
6088,FremontBridge,06/13/2013 04:00:00 PM,48,-122,173,106,279
6089,FremontBridge,06/13/2013 05:00:00 PM,48,-122,395,193,588
6090,FremontBridge,06/13/2013 06:00:00 PM,48,-122,277,211,488
6091,FremontBridge,06/13/2013 07:00:00 PM,48,-122,127,103,230
6092,FremontBridge,06/13/2013 08:00:00 PM,48,-122,87,60,147
6093,FremontBridge,06/13/2013 09:00:00 PM,48,-122,52,51,103
6094,FremontBridge,06/13/2013 10:00:00 PM,48,-122,39,32,71
6095,FremontBridge,06/13/2013 11:00:00 PM,48,-122,20,12,32
6096,FremontBridge,06/14/2013 12:00:00 AM,48,-122,11,5,16
6097,FremontBridge,06/14/2013 01:00:00 AM,48,-122,7,7,14
6098,FremontBridge,06/14/2013 02:00:00 AM,48,-122,0,1,1
6099,FremontBridge,06/14/2013 03:00:00 AM,48,-122,1,5,6
6100,FremontBridge,06/14/2013 04:00:00 AM,48,-122,13,20,33
6101,FremontBridge,06/14/2013 05:00:00 AM,48,-122,51,103,154
6102,FremontBridge,06/14/2013 06:00:00 AM,48,-122,89,225,314
6103,FremontBridge,06/14/2013 07:00:00 AM,48,-122,112,305,417
6104,FremontBridge,06/14/2013 08:00:00 AM,48,-122,94,160,254
6105,FremontBridge,06/14/2013 09:00:00 AM,48,-122,,,
6106,FremontBridge,06/14/2013 10:00:00 AM,48,-122,,,
6107,FremontBridge,06/14/2013 11:00:00 AM,48,-122,15,28,43
6108,FremontBridge,06/14/2013 12:00:00 PM,48,-122,35,50,85
6109,FremontBridge,06/14/2013 01:00:00 PM,48,-122,69,39,108
6110,FremontBridge,06/14/2013 02:00:00 PM,48,-122,69,44,113
6111,FremontBridge,06/14/2013 03:00:00 PM,48,-122,108,73,181
6112,FremontBridge,06/14/2013 04:00:00 PM,48,-122,174,122,296
6113,FremontBridge,06/14/2013 05:00:00 PM,48,-122,356,160,516
6114,FremontBridge,06/14/2013 06:00:00 PM,48,-122,222,120,342
6115,FremontBridge,06/14/2013 07:00:00 PM,48,-122,84,64,148
6116,FremontBridge,06/14/2013 08:00:00 PM,48,-122,66,72,138
6117,FremontBridge,06/14/2013 09:00:00 PM,48,-122,27,41,68
6118,FremontBridge,06/14/2013 10:00:00 PM,48,-122,16,31,47
6119,FremontBridge,06/14/2013 11:00:00 PM,48,-122,13,15,28
6120,FremontBridge,06/15/2013 12:00:00 AM,48,-122,11,5,16
6121,FremontBridge,06/15/2013 01:00:00 AM,48,-122,5,9,14
6122,FremontBridge,06/15/2013 02:00:00 AM,48,-122,2,7,9
6123,FremontBridge,06/15/2013 03:00:00 AM,48,-122,2,2,4
6124,FremontBridge,06/15/2013 04:00:00 AM,48,-122,3,2,5
6125,FremontBridge,06/15/2013 05:00:00 AM,48,-122,5,9,14
6126,FremontBridge,06/15/2013 06:00:00 AM,48,-122,24,24,48
6127,FremontBridge,06/15/2013 07:00:00 AM,48,-122,28,41,69
6128,FremontBridge,06/15/2013 08:00:00 AM,48,-122,47,51,98
6129,FremontBridge,06/15/2013 09:00:00 AM,48,-122,84,99,183
6130,FremontBridge,06/15/2013 10:00:00 AM,48,-122,61,110,171
6131,FremontBridge,06/15/2013 11:00:00 AM,48,-122,75,129,204
6132,FremontBridge,06/15/2013 12:00:00 PM,48,-122,88,106,194
6133,FremontBridge,06/15/2013 01:00:00 PM,48,-122,116,103,219
6134,FremontBridge,06/15/2013 02:00:00 PM,48,-122,98,122,220
6135,FremontBridge,06/15/2013 03:00:00 PM,48,-122,103,118,221
6136,FremontBridge,06/15/2013 04:00:00 PM,48,-122,98,104,202
6137,FremontBridge,06/15/2013 05:00:00 PM,48,-122,64,124,188
6138,FremontBridge,06/15/2013 06:00:00 PM,48,-122,56,85,141
6139,FremontBridge,06/15/2013 07:00:00 PM,48,-122,51,66,117
6140,FremontBridge,06/15/2013 08:00:00 PM,48,-122,30,49,79
6141,FremontBridge,06/15/2013 09:00:00 PM,48,-122,27,30,57
6142,FremontBridge,06/15/2013 10:00:00 PM,48,-122,25,20,45
6143,FremontBridge,06/15/2013 11:00:00 PM,48,-122,17,21,38
6144,FremontBridge,06/16/2013 12:00:00 AM,48,-122,13,15,28
6145,FremontBridge,06/16/2013 01:00:00 AM,48,-122,14,7,21
6146,FremontBridge,06/16/2013 02:00:00 AM,48,-122,3,8,11
6147,FremontBridge,06/16/2013 03:00:00 AM,48,-122,7,4,11
6148,FremontBridge,06/16/2013 04:00:00 AM,48,-122,2,3,5
6149,FremontBridge,06/16/2013 05:00:00 AM,48,-122,0,5,5
6150,FremontBridge,06/16/2013 06:00:00 AM,48,-122,13,9,22
6151,FremontBridge,06/16/2013 07:00:00 AM,48,-122,20,35,55
6152,FremontBridge,06/16/2013 08:00:00 AM,48,-122,24,44,68
6153,FremontBridge,06/16/2013 09:00:00 AM,48,-122,48,71,119
6154,FremontBridge,06/16/2013 10:00:00 AM,48,-122,58,79,137
6155,FremontBridge,06/16/2013 11:00:00 AM,48,-122,83,103,186
6156,FremontBridge,06/16/2013 12:00:00 PM,48,-122,94,139,233
6157,FremontBridge,06/16/2013 01:00:00 PM,48,-122,85,113,198
6158,FremontBridge,06/16/2013 02:00:00 PM,48,-122,80,134,214
6159,FremontBridge,06/16/2013 03:00:00 PM,48,-122,110,108,218
6160,FremontBridge,06/16/2013 04:00:00 PM,48,-122,74,120,194
6161,FremontBridge,06/16/2013 05:00:00 PM,48,-122,85,89,174
6162,FremontBridge,06/16/2013 06:00:00 PM,48,-122,52,75,127
6163,FremontBridge,06/16/2013 07:00:00 PM,48,-122,26,59,85
6164,FremontBridge,06/16/2013 08:00:00 PM,48,-122,35,45,80
6165,FremontBridge,06/16/2013 09:00:00 PM,48,-122,23,21,44
6166,FremontBridge,06/16/2013 10:00:00 PM,48,-122,22,22,44
6167,FremontBridge,06/16/2013 11:00:00 PM,48,-122,15,8,23
6168,FremontBridge,06/17/2013 12:00:00 AM,48,-122,11,5,16
6169,FremontBridge,06/17/2013 01:00:00 AM,48,-122,4,1,5
6170,FremontBridge,06/17/2013 02:00:00 AM,48,-122,2,2,4
6171,FremontBridge,06/17/2013 03:00:00 AM,48,-122,1,0,1
6172,FremontBridge,06/17/2013 04:00:00 AM,48,-122,2,5,7
6173,FremontBridge,06/17/2013 05:00:00 AM,48,-122,12,25,37
6174,FremontBridge,06/17/2013 06:00:00 AM,48,-122,49,111,160
6175,FremontBridge,06/17/2013 07:00:00 AM,48,-122,96,257,353
6176,FremontBridge,06/17/2013 08:00:00 AM,48,-122,153,361,514
6177,FremontBridge,06/17/2013 09:00:00 AM,48,-122,118,172,290
6178,FremontBridge,06/17/2013 10:00:00 AM,48,-122,54,78,132
6179,FremontBridge,06/17/2013 11:00:00 AM,48,-122,34,73,107
6180,FremontBridge,06/17/2013 12:00:00 PM,48,-122,51,77,128
6181,FremontBridge,06/17/2013 01:00:00 PM,48,-122,54,54,108
6182,FremontBridge,06/17/2013 02:00:00 PM,48,-122,49,65,114
6183,FremontBridge,06/17/2013 03:00:00 PM,48,-122,89,79,168
6184,FremontBridge,06/17/2013 04:00:00 PM,48,-122,200,124,324
6185,FremontBridge,06/17/2013 05:00:00 PM,48,-122,456,179,635
6186,FremontBridge,06/17/2013 06:00:00 PM,48,-122,313,213,526
6187,FremontBridge,06/17/2013 07:00:00 PM,48,-122,160,97,257
6188,FremontBridge,06/17/2013 08:00:00 PM,48,-122,102,89,191
6189,FremontBridge,06/17/2013 09:00:00 PM,48,-122,45,56,101
6190,FremontBridge,06/17/2013 10:00:00 PM,48,-122,32,19,51
6191,FremontBridge,06/17/2013 11:00:00 PM,48,-122,12,11,23
6192,FremontBridge,06/18/2013 12:00:00 AM,48,-122,8,10,18
6193,FremontBridge,06/18/2013 01:00:00 AM,48,-122,7,2,9
6194,FremontBridge,06/18/2013 02:00:00 AM,48,-122,1,6,7
6195,FremontBridge,06/18/2013 03:00:00 AM,48,-122,0,2,2
6196,FremontBridge,06/18/2013 04:00:00 AM,48,-122,3,2,5
6197,FremontBridge,06/18/2013 05:00:00 AM,48,-122,13,31,44
6198,FremontBridge,06/18/2013 06:00:00 AM,48,-122,58,113,171
6199,FremontBridge,06/18/2013 07:00:00 AM,48,-122,123,311,434
6200,FremontBridge,06/18/2013 08:00:00 AM,48,-122,160,377,537
6201,FremontBridge,06/18/2013 09:00:00 AM,48,-122,115,196,311
6202,FremontBridge,06/18/2013 10:00:00 AM,48,-122,56,62,118
6203,FremontBridge,06/18/2013 11:00:00 AM,48,-122,56,61,117
6204,FremontBridge,06/18/2013 12:00:00 PM,48,-122,52,61,113
6205,FremontBridge,06/18/2013 01:00:00 PM,48,-122,55,54,109
6206,FremontBridge,06/18/2013 02:00:00 PM,48,-122,56,87,143
6207,FremontBridge,06/18/2013 03:00:00 PM,48,-122,100,82,182
6208,FremontBridge,06/18/2013 04:00:00 PM,48,-122,207,129,336
6209,FremontBridge,06/18/2013 05:00:00 PM,48,-122,459,229,688
6210,FremontBridge,06/18/2013 06:00:00 PM,48,-122,355,176,531
6211,FremontBridge,06/18/2013 07:00:00 PM,48,-122,149,110,259
6212,FremontBridge,06/18/2013 08:00:00 PM,48,-122,84,75,159
6213,FremontBridge,06/18/2013 09:00:00 PM,48,-122,62,50,112
6214,FremontBridge,06/18/2013 10:00:00 PM,48,-122,63,26,89
6215,FremontBridge,06/18/2013 11:00:00 PM,48,-122,18,14,32
6216,FremontBridge,06/19/2013 12:00:00 AM,48,-122,14,8,22
6217,FremontBridge,06/19/2013 01:00:00 AM,48,-122,2,1,3
6218,FremontBridge,06/19/2013 02:00:00 AM,48,-122,0,4,4
6219,FremontBridge,06/19/2013 03:00:00 AM,48,-122,3,1,4
6220,FremontBridge,06/19/2013 04:00:00 AM,48,-122,2,2,4
6221,FremontBridge,06/19/2013 05:00:00 AM,48,-122,13,28,41
6222,FremontBridge,06/19/2013 06:00:00 AM,48,-122,53,80,133
6223,FremontBridge,06/19/2013 07:00:00 AM,48,-122,83,262,345
6224,FremontBridge,06/19/2013 08:00:00 AM,48,-122,142,316,458
6225,FremontBridge,06/19/2013 09:00:00 AM,48,-122,85,177,262
6226,FremontBridge,06/19/2013 10:00:00 AM,48,-122,47,76,123
6227,FremontBridge,06/19/2013 11:00:00 AM,48,-122,43,56,99
6228,FremontBridge,06/19/2013 12:00:00 PM,48,-122,41,55,96
6229,FremontBridge,06/19/2013 01:00:00 PM,48,-122,51,51,102
6230,FremontBridge,06/19/2013 02:00:00 PM,48,-122,62,58,120
6231,FremontBridge,06/19/2013 03:00:00 PM,48,-122,101,59,160
6232,FremontBridge,06/19/2013 04:00:00 PM,48,-122,166,100,266
6233,FremontBridge,06/19/2013 05:00:00 PM,48,-122,365,164,529
6234,FremontBridge,06/19/2013 06:00:00 PM,48,-122,272,152,424
6235,FremontBridge,06/19/2013 07:00:00 PM,48,-122,108,93,201
6236,FremontBridge,06/19/2013 08:00:00 PM,48,-122,60,48,108
6237,FremontBridge,06/19/2013 09:00:00 PM,48,-122,49,32,81
6238,FremontBridge,06/19/2013 10:00:00 PM,48,-122,22,20,42
6239,FremontBridge,06/19/2013 11:00:00 PM,48,-122,18,10,28
6240,FremontBridge,06/20/2013 12:00:00 AM,48,-122,8,4,12
6241,FremontBridge,06/20/2013 01:00:00 AM,48,-122,2,0,2
6242,FremontBridge,06/20/2013 02:00:00 AM,48,-122,5,3,8
6243,FremontBridge,06/20/2013 03:00:00 AM,48,-122,0,2,2
6244,FremontBridge,06/20/2013 04:00:00 AM,48,-122,2,4,6
6245,FremontBridge,06/20/2013 05:00:00 AM,48,-122,11,22,33
6246,FremontBridge,06/20/2013 06:00:00 AM,48,-122,38,73,111
6247,FremontBridge,06/20/2013 07:00:00 AM,48,-122,74,190,264
6248,FremontBridge,06/20/2013 08:00:00 AM,48,-122,121,253,374
6249,FremontBridge,06/20/2013 09:00:00 AM,48,-122,78,131,209
6250,FremontBridge,06/20/2013 10:00:00 AM,48,-122,38,49,87
6251,FremontBridge,06/20/2013 11:00:00 AM,48,-122,31,39,70
6252,FremontBridge,06/20/2013 12:00:00 PM,48,-122,24,32,56
6253,FremontBridge,06/20/2013 01:00:00 PM,48,-122,24,20,44
6254,FremontBridge,06/20/2013 02:00:00 PM,48,-122,26,34,60
6255,FremontBridge,06/20/2013 03:00:00 PM,48,-122,44,44,88
6256,FremontBridge,06/20/2013 04:00:00 PM,48,-122,101,39,140
6257,FremontBridge,06/20/2013 05:00:00 PM,48,-122,269,88,357
6258,FremontBridge,06/20/2013 06:00:00 PM,48,-122,185,88,273
6259,FremontBridge,06/20/2013 07:00:00 PM,48,-122,72,49,121
6260,FremontBridge,06/20/2013 08:00:00 PM,48,-122,60,17,77
6261,FremontBridge,06/20/2013 09:00:00 PM,48,-122,20,19,39
6262,FremontBridge,06/20/2013 10:00:00 PM,48,-122,10,11,21
6263,FremontBridge,06/20/2013 11:00:00 PM,48,-122,7,10,17
6264,FremontBridge,06/21/2013 12:00:00 AM,48,-122,9,16,25
6265,FremontBridge,06/21/2013 01:00:00 AM,48,-122,0,1,1
6266,FremontBridge,06/21/2013 02:00:00 AM,48,-122,2,0,2
6267,FremontBridge,06/21/2013 03:00:00 AM,48,-122,3,0,3
6268,FremontBridge,06/21/2013 04:00:00 AM,48,-122,0,1,1
6269,FremontBridge,06/21/2013 05:00:00 AM,48,-122,4,15,19
6270,FremontBridge,06/21/2013 06:00:00 AM,48,-122,30,67,97
6271,FremontBridge,06/21/2013 07:00:00 AM,48,-122,62,148,210
6272,FremontBridge,06/21/2013 08:00:00 AM,48,-122,96,223,319
6273,FremontBridge,06/21/2013 09:00:00 AM,48,-122,73,141,214
6274,FremontBridge,06/21/2013 10:00:00 AM,48,-122,45,70,115
6275,FremontBridge,06/21/2013 11:00:00 AM,48,-122,39,43,82
6276,FremontBridge,06/21/2013 12:00:00 PM,48,-122,41,41,82
6277,FremontBridge,06/21/2013 01:00:00 PM,48,-122,58,72,130
6278,FremontBridge,06/21/2013 02:00:00 PM,48,-122,56,54,110
6279,FremontBridge,06/21/2013 03:00:00 PM,48,-122,98,56,154
6280,FremontBridge,06/21/2013 04:00:00 PM,48,-122,172,91,263
6281,FremontBridge,06/21/2013 05:00:00 PM,48,-122,287,137,424
6282,FremontBridge,06/21/2013 06:00:00 PM,48,-122,189,107,296
6283,FremontBridge,06/21/2013 07:00:00 PM,48,-122,93,77,170
6284,FremontBridge,06/21/2013 08:00:00 PM,48,-122,41,63,104
6285,FremontBridge,06/21/2013 09:00:00 PM,48,-122,45,49,94
6286,FremontBridge,06/21/2013 10:00:00 PM,48,-122,21,36,57
6287,FremontBridge,06/21/2013 11:00:00 PM,48,-122,18,20,38
6288,FremontBridge,06/22/2013 12:00:00 AM,48,-122,18,13,31
6289,FremontBridge,06/22/2013 01:00:00 AM,48,-122,10,9,19
6290,FremontBridge,06/22/2013 02:00:00 AM,48,-122,6,4,10
6291,FremontBridge,06/22/2013 03:00:00 AM,48,-122,4,5,9
6292,FremontBridge,06/22/2013 04:00:00 AM,48,-122,2,3,5
6293,FremontBridge,06/22/2013 05:00:00 AM,48,-122,3,10,13
6294,FremontBridge,06/22/2013 06:00:00 AM,48,-122,15,31,46
6295,FremontBridge,06/22/2013 07:00:00 AM,48,-122,38,38,76
6296,FremontBridge,06/22/2013 08:00:00 AM,48,-122,49,68,117
6297,FremontBridge,06/22/2013 09:00:00 AM,48,-122,85,90,175
6298,FremontBridge,06/22/2013 10:00:00 AM,48,-122,109,121,230
6299,FremontBridge,06/22/2013 11:00:00 AM,48,-122,114,118,232
6300,FremontBridge,06/22/2013 12:00:00 PM,48,-122,172,141,313
6301,FremontBridge,06/22/2013 01:00:00 PM,48,-122,180,137,317
6302,FremontBridge,06/22/2013 02:00:00 PM,48,-122,164,105,269
6303,FremontBridge,06/22/2013 03:00:00 PM,48,-122,37,39,76
6304,FremontBridge,06/22/2013 04:00:00 PM,48,-122,32,29,61
6305,FremontBridge,06/22/2013 05:00:00 PM,48,-122,118,62,180
6306,FremontBridge,06/22/2013 06:00:00 PM,48,-122,124,116,240
6307,FremontBridge,06/22/2013 07:00:00 PM,48,-122,91,94,185
6308,FremontBridge,06/22/2013 08:00:00 PM,48,-122,116,73,189
6309,FremontBridge,06/22/2013 09:00:00 PM,48,-122,65,94,159
6310,FremontBridge,06/22/2013 10:00:00 PM,48,-122,38,72,110
6311,FremontBridge,06/22/2013 11:00:00 PM,48,-122,27,54,81
6312,FremontBridge,06/23/2013 12:00:00 AM,48,-122,30,20,50
6313,FremontBridge,06/23/2013 01:00:00 AM,48,-122,9,26,35
6314,FremontBridge,06/23/2013 02:00:00 AM,48,-122,20,8,28
6315,FremontBridge,06/23/2013 03:00:00 AM,48,-122,4,3,7
6316,FremontBridge,06/23/2013 04:00:00 AM,48,-122,10,9,19
6317,FremontBridge,06/23/2013 05:00:00 AM,48,-122,2,8,10
6318,FremontBridge,06/23/2013 06:00:00 AM,48,-122,10,25,35
6319,FremontBridge,06/23/2013 07:00:00 AM,48,-122,10,15,25
6320,FremontBridge,06/23/2013 08:00:00 AM,48,-122,20,27,47
6321,FremontBridge,06/23/2013 09:00:00 AM,48,-122,46,65,111
6322,FremontBridge,06/23/2013 10:00:00 AM,48,-122,51,89,140
6323,FremontBridge,06/23/2013 11:00:00 AM,48,-122,56,67,123
6324,FremontBridge,06/23/2013 12:00:00 PM,48,-122,41,73,114
6325,FremontBridge,06/23/2013 01:00:00 PM,48,-122,85,69,154
6326,FremontBridge,06/23/2013 02:00:00 PM,48,-122,54,66,120
6327,FremontBridge,06/23/2013 03:00:00 PM,48,-122,45,71,116
6328,FremontBridge,06/23/2013 04:00:00 PM,48,-122,58,78,136
6329,FremontBridge,06/23/2013 05:00:00 PM,48,-122,57,57,114
6330,FremontBridge,06/23/2013 06:00:00 PM,48,-122,51,71,122
6331,FremontBridge,06/23/2013 07:00:00 PM,48,-122,22,30,52
6332,FremontBridge,06/23/2013 08:00:00 PM,48,-122,21,16,37
6333,FremontBridge,06/23/2013 09:00:00 PM,48,-122,13,9,22
6334,FremontBridge,06/23/2013 10:00:00 PM,48,-122,10,10,20
6335,FremontBridge,06/23/2013 11:00:00 PM,48,-122,7,0,7
6336,FremontBridge,06/24/2013 12:00:00 AM,48,-122,2,4,6
6337,FremontBridge,06/24/2013 01:00:00 AM,48,-122,0,0,0
6338,FremontBridge,06/24/2013 02:00:00 AM,48,-122,0,2,2
6339,FremontBridge,06/24/2013 03:00:00 AM,48,-122,1,2,3
6340,FremontBridge,06/24/2013 04:00:00 AM,48,-122,1,6,7
6341,FremontBridge,06/24/2013 05:00:00 AM,48,-122,5,28,33
6342,FremontBridge,06/24/2013 06:00:00 AM,48,-122,23,56,79
6343,FremontBridge,06/24/2013 07:00:00 AM,48,-122,45,132,177
6344,FremontBridge,06/24/2013 08:00:00 AM,48,-122,84,160,244
6345,FremontBridge,06/24/2013 09:00:00 AM,48,-122,62,118,180
6346,FremontBridge,06/24/2013 10:00:00 AM,48,-122,25,44,69
6347,FremontBridge,06/24/2013 11:00:00 AM,48,-122,25,23,48
6348,FremontBridge,06/24/2013 12:00:00 PM,48,-122,31,50,81
6349,FremontBridge,06/24/2013 01:00:00 PM,48,-122,25,38,63
6350,FremontBridge,06/24/2013 02:00:00 PM,48,-122,30,43,73
6351,FremontBridge,06/24/2013 03:00:00 PM,48,-122,61,36,97
6352,FremontBridge,06/24/2013 04:00:00 PM,48,-122,114,63,177
6353,FremontBridge,06/24/2013 05:00:00 PM,48,-122,250,116,366
6354,FremontBridge,06/24/2013 06:00:00 PM,48,-122,183,123,306
6355,FremontBridge,06/24/2013 07:00:00 PM,48,-122,120,87,207
6356,FremontBridge,06/24/2013 08:00:00 PM,48,-122,47,57,104
6357,FremontBridge,06/24/2013 09:00:00 PM,48,-122,25,32,57
6358,FremontBridge,06/24/2013 10:00:00 PM,48,-122,21,20,41
6359,FremontBridge,06/24/2013 11:00:00 PM,48,-122,5,7,12
6360,FremontBridge,06/25/2013 12:00:00 AM,48,-122,7,4,11
6361,FremontBridge,06/25/2013 01:00:00 AM,48,-122,5,3,8
6362,FremontBridge,06/25/2013 02:00:00 AM,48,-122,2,5,7
6363,FremontBridge,06/25/2013 03:00:00 AM,48,-122,0,0,0
6364,FremontBridge,06/25/2013 04:00:00 AM,48,-122,3,3,6
6365,FremontBridge,06/25/2013 05:00:00 AM,48,-122,8,18,26
6366,FremontBridge,06/25/2013 06:00:00 AM,48,-122,34,84,118
6367,FremontBridge,06/25/2013 07:00:00 AM,48,-122,52,168,220
6368,FremontBridge,06/25/2013 08:00:00 AM,48,-122,85,178,263
6369,FremontBridge,06/25/2013 09:00:00 AM,48,-122,78,131,209
6370,FremontBridge,06/25/2013 10:00:00 AM,48,-122,51,59,110
6371,FremontBridge,06/25/2013 11:00:00 AM,48,-122,37,56,93
6372,FremontBridge,06/25/2013 12:00:00 PM,48,-122,22,49,71
6373,FremontBridge,06/25/2013 01:00:00 PM,48,-122,37,63,100
6374,FremontBridge,06/25/2013 02:00:00 PM,48,-122,43,64,107
6375,FremontBridge,06/25/2013 03:00:00 PM,48,-122,71,73,144
6376,FremontBridge,06/25/2013 04:00:00 PM,48,-122,144,88,232
6377,FremontBridge,06/25/2013 05:00:00 PM,48,-122,303,121,424
6378,FremontBridge,06/25/2013 06:00:00 PM,48,-122,171,76,247
6379,FremontBridge,06/25/2013 07:00:00 PM,48,-122,70,54,124
6380,FremontBridge,06/25/2013 08:00:00 PM,48,-122,33,15,48
6381,FremontBridge,06/25/2013 09:00:00 PM,48,-122,22,25,47
6382,FremontBridge,06/25/2013 10:00:00 PM,48,-122,10,8,18
6383,FremontBridge,06/25/2013 11:00:00 PM,48,-122,8,8,16
6384,FremontBridge,06/26/2013 12:00:00 AM,48,-122,8,3,11
6385,FremontBridge,06/26/2013 01:00:00 AM,48,-122,3,1,4
6386,FremontBridge,06/26/2013 02:00:00 AM,48,-122,2,2,4
6387,FremontBridge,06/26/2013 03:00:00 AM,48,-122,0,0,0
6388,FremontBridge,06/26/2013 04:00:00 AM,48,-122,4,3,7
6389,FremontBridge,06/26/2013 05:00:00 AM,48,-122,6,15,21
6390,FremontBridge,06/26/2013 06:00:00 AM,48,-122,36,68,104
6391,FremontBridge,06/26/2013 07:00:00 AM,48,-122,55,183,238
6392,FremontBridge,06/26/2013 08:00:00 AM,48,-122,109,217,326
6393,FremontBridge,06/26/2013 09:00:00 AM,48,-122,95,129,224
6394,FremontBridge,06/26/2013 10:00:00 AM,48,-122,32,57,89
6395,FremontBridge,06/26/2013 11:00:00 AM,48,-122,47,37,84
6396,FremontBridge,06/26/2013 12:00:00 PM,48,-122,32,41,73
6397,FremontBridge,06/26/2013 01:00:00 PM,48,-122,32,32,64
6398,FremontBridge,06/26/2013 02:00:00 PM,48,-122,25,29,54
6399,FremontBridge,06/26/2013 03:00:00 PM,48,-122,61,54,115
6400,FremontBridge,06/26/2013 04:00:00 PM,48,-122,145,70,215
6401,FremontBridge,06/26/2013 05:00:00 PM,48,-122,286,136,422
6402,FremontBridge,06/26/2013 06:00:00 PM,48,-122,226,124,350
6403,FremontBridge,06/26/2013 07:00:00 PM,48,-122,125,78,203
6404,FremontBridge,06/26/2013 08:00:00 PM,48,-122,63,68,131
6405,FremontBridge,06/26/2013 09:00:00 PM,48,-122,49,36,85
6406,FremontBridge,06/26/2013 10:00:00 PM,48,-122,20,40,60
6407,FremontBridge,06/26/2013 11:00:00 PM,48,-122,13,7,20
6408,FremontBridge,06/27/2013 12:00:00 AM,48,-122,6,13,19
6409,FremontBridge,06/27/2013 01:00:00 AM,48,-122,4,4,8
6410,FremontBridge,06/27/2013 02:00:00 AM,48,-122,5,7,12
6411,FremontBridge,06/27/2013 03:00:00 AM,48,-122,0,1,1
6412,FremontBridge,06/27/2013 04:00:00 AM,48,-122,2,2,4
6413,FremontBridge,06/27/2013 05:00:00 AM,48,-122,12,19,31
6414,FremontBridge,06/27/2013 06:00:00 AM,48,-122,29,71,100
6415,FremontBridge,06/27/2013 07:00:00 AM,48,-122,60,183,243
6416,FremontBridge,06/27/2013 08:00:00 AM,48,-122,106,235,341
6417,FremontBridge,06/27/2013 09:00:00 AM,48,-122,77,132,209
6418,FremontBridge,06/27/2013 10:00:00 AM,48,-122,22,43,65
6419,FremontBridge,06/27/2013 11:00:00 AM,48,-122,20,34,54
6420,FremontBridge,06/27/2013 12:00:00 PM,48,-122,33,43,76
6421,FremontBridge,06/27/2013 01:00:00 PM,48,-122,22,49,71
6422,FremontBridge,06/27/2013 02:00:00 PM,48,-122,40,53,93
6423,FremontBridge,06/27/2013 03:00:00 PM,48,-122,82,64,146
6424,FremontBridge,06/27/2013 04:00:00 PM,48,-122,160,89,249
6425,FremontBridge,06/27/2013 05:00:00 PM,48,-122,325,130,455
6426,FremontBridge,06/27/2013 06:00:00 PM,48,-122,218,131,349
6427,FremontBridge,06/27/2013 07:00:00 PM,48,-122,83,78,161
6428,FremontBridge,06/27/2013 08:00:00 PM,48,-122,51,51,102
6429,FremontBridge,06/27/2013 09:00:00 PM,48,-122,35,34,69
6430,FremontBridge,06/27/2013 10:00:00 PM,48,-122,21,26,47
6431,FremontBridge,06/27/2013 11:00:00 PM,48,-122,16,7,23
6432,FremontBridge,06/28/2013 12:00:00 AM,48,-122,9,13,22
6433,FremontBridge,06/28/2013 01:00:00 AM,48,-122,5,1,6
6434,FremontBridge,06/28/2013 02:00:00 AM,48,-122,2,2,4
6435,FremontBridge,06/28/2013 03:00:00 AM,48,-122,0,1,1
6436,FremontBridge,06/28/2013 04:00:00 AM,48,-122,1,1,2
6437,FremontBridge,06/28/2013 05:00:00 AM,48,-122,12,18,30
6438,FremontBridge,06/28/2013 06:00:00 AM,48,-122,49,108,157
6439,FremontBridge,06/28/2013 07:00:00 AM,48,-122,102,247,349
6440,FremontBridge,06/28/2013 08:00:00 AM,48,-122,128,347,475
6441,FremontBridge,06/28/2013 09:00:00 AM,48,-122,100,168,268
6442,FremontBridge,06/28/2013 10:00:00 AM,48,-122,71,97,168
6443,FremontBridge,06/28/2013 11:00:00 AM,48,-122,43,69,112
6444,FremontBridge,06/28/2013 12:00:00 PM,48,-122,66,85,151
6445,FremontBridge,06/28/2013 01:00:00 PM,48,-122,52,80,132
6446,FremontBridge,06/28/2013 02:00:00 PM,48,-122,83,73,156
6447,FremontBridge,06/28/2013 03:00:00 PM,48,-122,129,110,239
6448,FremontBridge,06/28/2013 04:00:00 PM,48,-122,244,113,357
6449,FremontBridge,06/28/2013 05:00:00 PM,48,-122,393,195,588
6450,FremontBridge,06/28/2013 06:00:00 PM,48,-122,217,128,345
6451,FremontBridge,06/28/2013 07:00:00 PM,48,-122,146,93,239
6452,FremontBridge,06/28/2013 08:00:00 PM,48,-122,72,55,127
6453,FremontBridge,06/28/2013 09:00:00 PM,48,-122,42,45,87
6454,FremontBridge,06/28/2013 10:00:00 PM,48,-122,20,31,51
6455,FremontBridge,06/28/2013 11:00:00 PM,48,-122,18,15,33
6456,FremontBridge,06/29/2013 12:00:00 AM,48,-122,21,10,31
6457,FremontBridge,06/29/2013 01:00:00 AM,48,-122,6,8,14
6458,FremontBridge,06/29/2013 02:00:00 AM,48,-122,8,8,16
6459,FremontBridge,06/29/2013 03:00:00 AM,48,-122,1,9,10
6460,FremontBridge,06/29/2013 04:00:00 AM,48,-122,3,3,6
6461,FremontBridge,06/29/2013 05:00:00 AM,48,-122,5,13,18
6462,FremontBridge,06/29/2013 06:00:00 AM,48,-122,30,22,52
6463,FremontBridge,06/29/2013 07:00:00 AM,48,-122,43,46,89
6464,FremontBridge,06/29/2013 08:00:00 AM,48,-122,57,61,118
6465,FremontBridge,06/29/2013 09:00:00 AM,48,-122,71,86,157
6466,FremontBridge,06/29/2013 10:00:00 AM,48,-122,102,100,202
6467,FremontBridge,06/29/2013 11:00:00 AM,48,-122,87,135,222
6468,FremontBridge,06/29/2013 12:00:00 PM,48,-122,104,88,192
6469,FremontBridge,06/29/2013 01:00:00 PM,48,-122,87,121,208
6470,FremontBridge,06/29/2013 02:00:00 PM,48,-122,94,144,238
6471,FremontBridge,06/29/2013 03:00:00 PM,48,-122,111,96,207
6472,FremontBridge,06/29/2013 04:00:00 PM,48,-122,83,104,187
6473,FremontBridge,06/29/2013 05:00:00 PM,48,-122,85,96,181
6474,FremontBridge,06/29/2013 06:00:00 PM,48,-122,85,73,158
6475,FremontBridge,06/29/2013 07:00:00 PM,48,-122,65,78,143
6476,FremontBridge,06/29/2013 08:00:00 PM,48,-122,47,55,102
6477,FremontBridge,06/29/2013 09:00:00 PM,48,-122,45,43,88
6478,FremontBridge,06/29/2013 10:00:00 PM,48,-122,31,20,51
6479,FremontBridge,06/29/2013 11:00:00 PM,48,-122,21,21,42
6480,FremontBridge,06/30/2013 12:00:00 AM,48,-122,14,11,25
6481,FremontBridge,06/30/2013 01:00:00 AM,48,-122,7,5,12
6482,FremontBridge,06/30/2013 02:00:00 AM,48,-122,11,5,16
6483,FremontBridge,06/30/2013 03:00:00 AM,48,-122,4,1,5
6484,FremontBridge,06/30/2013 04:00:00 AM,48,-122,4,5,9
6485,FremontBridge,06/30/2013 05:00:00 AM,48,-122,4,9,13
6486,FremontBridge,06/30/2013 06:00:00 AM,48,-122,15,14,29
6487,FremontBridge,06/30/2013 07:00:00 AM,48,-122,27,25,52
6488,FremontBridge,06/30/2013 08:00:00 AM,48,-122,37,48,85
6489,FremontBridge,06/30/2013 09:00:00 AM,48,-122,58,93,151
6490,FremontBridge,06/30/2013 10:00:00 AM,48,-122,86,150,236
6491,FremontBridge,06/30/2013 11:00:00 AM,48,-122,100,179,279
6492,FremontBridge,06/30/2013 12:00:00 PM,48,-122,96,112,208
6493,FremontBridge,06/30/2013 01:00:00 PM,48,-122,115,141,256
6494,FremontBridge,06/30/2013 02:00:00 PM,48,-122,133,118,251
6495,FremontBridge,06/30/2013 03:00:00 PM,48,-122,121,112,233
6496,FremontBridge,06/30/2013 04:00:00 PM,48,-122,97,108,205
6497,FremontBridge,06/30/2013 05:00:00 PM,48,-122,79,69,148
6498,FremontBridge,06/30/2013 06:00:00 PM,48,-122,75,82,157
6499,FremontBridge,06/30/2013 07:00:00 PM,48,-122,52,69,121
6500,FremontBridge,06/30/2013 08:00:00 PM,48,-122,46,51,97
6501,FremontBridge,06/30/2013 09:00:00 PM,48,-122,37,52,89
6502,FremontBridge,06/30/2013 10:00:00 PM,48,-122,27,17,44
6503,FremontBridge,06/30/2013 11:00:00 PM,48,-122,13,12,25
6504,FremontBridge,07/01/2013 12:00:00 AM,48,-122,9,7,16
6505,FremontBridge,07/01/2013 01:00:00 AM,48,-122,7,2,9
6506,FremontBridge,07/01/2013 02:00:00 AM,48,-122,0,3,3
6507,FremontBridge,07/01/2013 03:00:00 AM,48,-122,2,0,2
6508,FremontBridge,07/01/2013 04:00:00 AM,48,-122,3,7,10
6509,FremontBridge,07/01/2013 05:00:00 AM,48,-122,11,30,41
6510,FremontBridge,07/01/2013 06:00:00 AM,48,-122,56,117,173
6511,FremontBridge,07/01/2013 07:00:00 AM,48,-122,119,294,413
6512,FremontBridge,07/01/2013 08:00:00 AM,48,-122,162,369,531
6513,FremontBridge,07/01/2013 09:00:00 AM,48,-122,96,186,282
6514,FremontBridge,07/01/2013 10:00:00 AM,48,-122,61,99,160
6515,FremontBridge,07/01/2013 11:00:00 AM,48,-122,50,59,109
6516,FremontBridge,07/01/2013 12:00:00 PM,48,-122,41,68,109
6517,FremontBridge,07/01/2013 01:00:00 PM,48,-122,56,51,107
6518,FremontBridge,07/01/2013 02:00:00 PM,48,-122,42,60,102
6519,FremontBridge,07/01/2013 03:00:00 PM,48,-122,74,67,141
6520,FremontBridge,07/01/2013 04:00:00 PM,48,-122,188,119,307
6521,FremontBridge,07/01/2013 05:00:00 PM,48,-122,442,168,610
6522,FremontBridge,07/01/2013 06:00:00 PM,48,-122,310,164,474
6523,FremontBridge,07/01/2013 07:00:00 PM,48,-122,148,113,261
6524,FremontBridge,07/01/2013 08:00:00 PM,48,-122,70,77,147
6525,FremontBridge,07/01/2013 09:00:00 PM,48,-122,49,60,109
6526,FremontBridge,07/01/2013 10:00:00 PM,48,-122,29,38,67
6527,FremontBridge,07/01/2013 11:00:00 PM,48,-122,16,8,24
6528,FremontBridge,07/02/2013 12:00:00 AM,48,-122,11,4,15
6529,FremontBridge,07/02/2013 01:00:00 AM,48,-122,9,2,11
6530,FremontBridge,07/02/2013 02:00:00 AM,48,-122,5,2,7
6531,FremontBridge,07/02/2013 03:00:00 AM,48,-122,1,0,1
6532,FremontBridge,07/02/2013 04:00:00 AM,48,-122,4,8,12
6533,FremontBridge,07/02/2013 05:00:00 AM,48,-122,12,33,45
6534,FremontBridge,07/02/2013 06:00:00 AM,48,-122,60,123,183
6535,FremontBridge,07/02/2013 07:00:00 AM,48,-122,96,348,444
6536,FremontBridge,07/02/2013 08:00:00 AM,48,-122,172,424,596
6537,FremontBridge,07/02/2013 09:00:00 AM,48,-122,115,180,295
6538,FremontBridge,07/02/2013 10:00:00 AM,48,-122,52,84,136
6539,FremontBridge,07/02/2013 11:00:00 AM,48,-122,46,70,116
6540,FremontBridge,07/02/2013 12:00:00 PM,48,-122,61,68,129
6541,FremontBridge,07/02/2013 01:00:00 PM,48,-122,78,61,139
6542,FremontBridge,07/02/2013 02:00:00 PM,48,-122,75,61,136
6543,FremontBridge,07/02/2013 03:00:00 PM,48,-122,99,71,170
6544,FremontBridge,07/02/2013 04:00:00 PM,48,-122,209,123,332
6545,FremontBridge,07/02/2013 05:00:00 PM,48,-122,488,184,672
6546,FremontBridge,07/02/2013 06:00:00 PM,48,-122,336,218,554
6547,FremontBridge,07/02/2013 07:00:00 PM,48,-122,164,111,275
6548,FremontBridge,07/02/2013 08:00:00 PM,48,-122,96,86,182
6549,FremontBridge,07/02/2013 09:00:00 PM,48,-122,61,74,135
6550,FremontBridge,07/02/2013 10:00:00 PM,48,-122,27,44,71
6551,FremontBridge,07/02/2013 11:00:00 PM,48,-122,18,22,40
6552,FremontBridge,07/03/2013 12:00:00 AM,48,-122,10,10,20
6553,FremontBridge,07/03/2013 01:00:00 AM,48,-122,6,2,8
6554,FremontBridge,07/03/2013 02:00:00 AM,48,-122,2,3,5
6555,FremontBridge,07/03/2013 03:00:00 AM,48,-122,2,0,2
6556,FremontBridge,07/03/2013 04:00:00 AM,48,-122,4,6,10
6557,FremontBridge,07/03/2013 05:00:00 AM,48,-122,9,24,33
6558,FremontBridge,07/03/2013 06:00:00 AM,48,-122,56,108,164
6559,FremontBridge,07/03/2013 07:00:00 AM,48,-122,99,267,366
6560,FremontBridge,07/03/2013 08:00:00 AM,48,-122,161,358,519
6561,FremontBridge,07/03/2013 09:00:00 AM,48,-122,132,199,331
6562,FremontBridge,07/03/2013 10:00:00 AM,48,-122,61,82,143
6563,FremontBridge,07/03/2013 11:00:00 AM,48,-122,39,51,90
6564,FremontBridge,07/03/2013 12:00:00 PM,48,-122,50,54,104
6565,FremontBridge,07/03/2013 01:00:00 PM,48,-122,54,58,112
6566,FremontBridge,07/03/2013 02:00:00 PM,48,-122,79,83,162
6567,FremontBridge,07/03/2013 03:00:00 PM,48,-122,140,95,235
6568,FremontBridge,07/03/2013 04:00:00 PM,48,-122,259,135,394
6569,FremontBridge,07/03/2013 05:00:00 PM,48,-122,401,179,580
6570,FremontBridge,07/03/2013 06:00:00 PM,48,-122,241,163,404
6571,FremontBridge,07/03/2013 07:00:00 PM,48,-122,113,77,190
6572,FremontBridge,07/03/2013 08:00:00 PM,48,-122,70,73,143
6573,FremontBridge,07/03/2013 09:00:00 PM,48,-122,55,52,107
6574,FremontBridge,07/03/2013 10:00:00 PM,48,-122,36,50,86
6575,FremontBridge,07/03/2013 11:00:00 PM,48,-122,27,20,47
6576,FremontBridge,07/04/2013 12:00:00 AM,48,-122,14,9,23
6577,FremontBridge,07/04/2013 01:00:00 AM,48,-122,8,6,14
6578,FremontBridge,07/04/2013 02:00:00 AM,48,-122,7,54,61
6579,FremontBridge,07/04/2013 03:00:00 AM,48,-122,5,1,6
6580,FremontBridge,07/04/2013 04:00:00 AM,48,-122,1,3,4
6581,FremontBridge,07/04/2013 05:00:00 AM,48,-122,3,14,17
6582,FremontBridge,07/04/2013 06:00:00 AM,48,-122,13,19,32
6583,FremontBridge,07/04/2013 07:00:00 AM,48,-122,17,42,59
6584,FremontBridge,07/04/2013 08:00:00 AM,48,-122,66,42,108
6585,FremontBridge,07/04/2013 09:00:00 AM,48,-122,76,61,137
6586,FremontBridge,07/04/2013 10:00:00 AM,48,-122,67,104,171
6587,FremontBridge,07/04/2013 11:00:00 AM,48,-122,102,96,198
6588,FremontBridge,07/04/2013 12:00:00 PM,48,-122,91,100,191
6589,FremontBridge,07/04/2013 01:00:00 PM,48,-122,123,113,236
6590,FremontBridge,07/04/2013 02:00:00 PM,48,-122,135,137,272
6591,FremontBridge,07/04/2013 03:00:00 PM,48,-122,155,124,279
6592,FremontBridge,07/04/2013 04:00:00 PM,48,-122,141,125,266
6593,FremontBridge,07/04/2013 05:00:00 PM,48,-122,148,138,286
6594,FremontBridge,07/04/2013 06:00:00 PM,48,-122,145,102,247
6595,FremontBridge,07/04/2013 07:00:00 PM,48,-122,109,133,242
6596,FremontBridge,07/04/2013 08:00:00 PM,48,-122,118,106,224
6597,FremontBridge,07/04/2013 09:00:00 PM,48,-122,78,108,186
6598,FremontBridge,07/04/2013 10:00:00 PM,48,-122,41,57,98
6599,FremontBridge,07/04/2013 11:00:00 PM,48,-122,248,144,392
6600,FremontBridge,07/05/2013 12:00:00 AM,48,-122,81,43,124
6601,FremontBridge,07/05/2013 01:00:00 AM,48,-122,23,12,35
6602,FremontBridge,07/05/2013 02:00:00 AM,48,-122,9,3,12
6603,FremontBridge,07/05/2013 03:00:00 AM,48,-122,2,1,3
6604,FremontBridge,07/05/2013 04:00:00 AM,48,-122,2,6,8
6605,FremontBridge,07/05/2013 05:00:00 AM,48,-122,8,9,17
6606,FremontBridge,07/05/2013 06:00:00 AM,48,-122,31,43,74
6607,FremontBridge,07/05/2013 07:00:00 AM,48,-122,62,127,189
6608,FremontBridge,07/05/2013 08:00:00 AM,48,-122,70,129,199
6609,FremontBridge,07/05/2013 09:00:00 AM,48,-122,72,124,196
6610,FremontBridge,07/05/2013 10:00:00 AM,48,-122,58,85,143
6611,FremontBridge,07/05/2013 11:00:00 AM,48,-122,70,72,142
6612,FremontBridge,07/05/2013 12:00:00 PM,48,-122,61,108,169
6613,FremontBridge,07/05/2013 01:00:00 PM,48,-122,68,86,154
6614,FremontBridge,07/05/2013 02:00:00 PM,48,-122,113,84,197
6615,FremontBridge,07/05/2013 03:00:00 PM,48,-122,103,79,182
6616,FremontBridge,07/05/2013 04:00:00 PM,48,-122,156,109,265
6617,FremontBridge,07/05/2013 05:00:00 PM,48,-122,196,105,301
6618,FremontBridge,07/05/2013 06:00:00 PM,48,-122,129,109,238
6619,FremontBridge,07/05/2013 07:00:00 PM,48,-122,107,75,182
6620,FremontBridge,07/05/2013 08:00:00 PM,48,-122,47,43,90
6621,FremontBridge,07/05/2013 09:00:00 PM,48,-122,28,40,68
6622,FremontBridge,07/05/2013 10:00:00 PM,48,-122,36,28,64
6623,FremontBridge,07/05/2013 11:00:00 PM,48,-122,18,18,36
6624,FremontBridge,07/06/2013 12:00:00 AM,48,-122,12,19,31
6625,FremontBridge,07/06/2013 01:00:00 AM,48,-122,3,6,9
6626,FremontBridge,07/06/2013 02:00:00 AM,48,-122,1,4,5
6627,FremontBridge,07/06/2013 03:00:00 AM,48,-122,5,4,9
6628,FremontBridge,07/06/2013 04:00:00 AM,48,-122,2,6,8
6629,FremontBridge,07/06/2013 05:00:00 AM,48,-122,4,11,15
6630,FremontBridge,07/06/2013 06:00:00 AM,48,-122,23,16,39
6631,FremontBridge,07/06/2013 07:00:00 AM,48,-122,32,40,72
6632,FremontBridge,07/06/2013 08:00:00 AM,48,-122,52,63,115
6633,FremontBridge,07/06/2013 09:00:00 AM,48,-122,68,93,161
6634,FremontBridge,07/06/2013 10:00:00 AM,48,-122,75,87,162
6635,FremontBridge,07/06/2013 11:00:00 AM,48,-122,80,123,203
6636,FremontBridge,07/06/2013 12:00:00 PM,48,-122,85,125,210
6637,FremontBridge,07/06/2013 01:00:00 PM,48,-122,105,131,236
6638,FremontBridge,07/06/2013 02:00:00 PM,48,-122,109,148,257
6639,FremontBridge,07/06/2013 03:00:00 PM,48,-122,105,111,216
6640,FremontBridge,07/06/2013 04:00:00 PM,48,-122,111,135,246
6641,FremontBridge,07/06/2013 05:00:00 PM,48,-122,112,133,245
6642,FremontBridge,07/06/2013 06:00:00 PM,48,-122,83,95,178
6643,FremontBridge,07/06/2013 07:00:00 PM,48,-122,54,57,111
6644,FremontBridge,07/06/2013 08:00:00 PM,48,-122,61,59,120
6645,FremontBridge,07/06/2013 09:00:00 PM,48,-122,45,39,84
6646,FremontBridge,07/06/2013 10:00:00 PM,48,-122,48,39,87
6647,FremontBridge,07/06/2013 11:00:00 PM,48,-122,71,32,103
6648,FremontBridge,07/07/2013 12:00:00 AM,48,-122,19,30,49
6649,FremontBridge,07/07/2013 01:00:00 AM,48,-122,10,9,19
6650,FremontBridge,07/07/2013 02:00:00 AM,48,-122,6,4,10
6651,FremontBridge,07/07/2013 03:00:00 AM,48,-122,1,2,3
6652,FremontBridge,07/07/2013 04:00:00 AM,48,-122,3,3,6
6653,FremontBridge,07/07/2013 05:00:00 AM,48,-122,4,7,11
6654,FremontBridge,07/07/2013 06:00:00 AM,48,-122,12,10,22
6655,FremontBridge,07/07/2013 07:00:00 AM,48,-122,18,26,44
6656,FremontBridge,07/07/2013 08:00:00 AM,48,-122,44,32,76
6657,FremontBridge,07/07/2013 09:00:00 AM,48,-122,37,73,110
6658,FremontBridge,07/07/2013 10:00:00 AM,48,-122,67,75,142
6659,FremontBridge,07/07/2013 11:00:00 AM,48,-122,70,108,178
6660,FremontBridge,07/07/2013 12:00:00 PM,48,-122,99,100,199
6661,FremontBridge,07/07/2013 01:00:00 PM,48,-122,124,114,238
6662,FremontBridge,07/07/2013 02:00:00 PM,48,-122,115,134,249
6663,FremontBridge,07/07/2013 03:00:00 PM,48,-122,101,155,256
6664,FremontBridge,07/07/2013 04:00:00 PM,48,-122,112,122,234
6665,FremontBridge,07/07/2013 05:00:00 PM,48,-122,111,107,218
6666,FremontBridge,07/07/2013 06:00:00 PM,48,-122,74,94,168
6667,FremontBridge,07/07/2013 07:00:00 PM,48,-122,63,72,135
6668,FremontBridge,07/07/2013 08:00:00 PM,48,-122,31,68,99
6669,FremontBridge,07/07/2013 09:00:00 PM,48,-122,29,37,66
6670,FremontBridge,07/07/2013 10:00:00 PM,48,-122,20,22,42
6671,FremontBridge,07/07/2013 11:00:00 PM,48,-122,11,10,21
6672,FremontBridge,07/08/2013 12:00:00 AM,48,-122,18,5,23
6673,FremontBridge,07/08/2013 01:00:00 AM,48,-122,10,1,11
6674,FremontBridge,07/08/2013 02:00:00 AM,48,-122,3,1,4
6675,FremontBridge,07/08/2013 03:00:00 AM,48,-122,3,1,4
6676,FremontBridge,07/08/2013 04:00:00 AM,48,-122,3,6,9
6677,FremontBridge,07/08/2013 05:00:00 AM,48,-122,11,28,39
6678,FremontBridge,07/08/2013 06:00:00 AM,48,-122,52,115,167
6679,FremontBridge,07/08/2013 07:00:00 AM,48,-122,103,320,423
6680,FremontBridge,07/08/2013 08:00:00 AM,48,-122,153,340,493
6681,FremontBridge,07/08/2013 09:00:00 AM,48,-122,110,214,324
6682,FremontBridge,07/08/2013 10:00:00 AM,48,-122,33,75,108
6683,FremontBridge,07/08/2013 11:00:00 AM,48,-122,42,45,87
6684,FremontBridge,07/08/2013 12:00:00 PM,48,-122,48,50,98
6685,FremontBridge,07/08/2013 01:00:00 PM,48,-122,61,76,137
6686,FremontBridge,07/08/2013 02:00:00 PM,48,-122,68,66,134
6687,FremontBridge,07/08/2013 03:00:00 PM,48,-122,100,70,170
6688,FremontBridge,07/08/2013 04:00:00 PM,48,-122,201,125,326
6689,FremontBridge,07/08/2013 05:00:00 PM,48,-122,475,187,662
6690,FremontBridge,07/08/2013 06:00:00 PM,48,-122,339,184,523
6691,FremontBridge,07/08/2013 07:00:00 PM,48,-122,166,105,271
6692,FremontBridge,07/08/2013 08:00:00 PM,48,-122,83,82,165
6693,FremontBridge,07/08/2013 09:00:00 PM,48,-122,40,47,87
6694,FremontBridge,07/08/2013 10:00:00 PM,48,-122,25,27,52
6695,FremontBridge,07/08/2013 11:00:00 PM,48,-122,20,10,30
6696,FremontBridge,07/09/2013 12:00:00 AM,48,-122,13,9,22
6697,FremontBridge,07/09/2013 01:00:00 AM,48,-122,7,2,9
6698,FremontBridge,07/09/2013 02:00:00 AM,48,-122,3,3,6
6699,FremontBridge,07/09/2013 03:00:00 AM,48,-122,0,1,1
6700,FremontBridge,07/09/2013 04:00:00 AM,48,-122,3,6,9
6701,FremontBridge,07/09/2013 05:00:00 AM,48,-122,10,31,41
6702,FremontBridge,07/09/2013 06:00:00 AM,48,-122,69,136,205
6703,FremontBridge,07/09/2013 07:00:00 AM,48,-122,110,342,452
6704,FremontBridge,07/09/2013 08:00:00 AM,48,-122,154,419,573
6705,FremontBridge,07/09/2013 09:00:00 AM,48,-122,117,202,319
6706,FremontBridge,07/09/2013 10:00:00 AM,48,-122,57,96,153
6707,FremontBridge,07/09/2013 11:00:00 AM,48,-122,60,70,130
6708,FremontBridge,07/09/2013 12:00:00 PM,48,-122,49,65,114
6709,FremontBridge,07/09/2013 01:00:00 PM,48,-122,74,76,150
6710,FremontBridge,07/09/2013 02:00:00 PM,48,-122,62,72,134
6711,FremontBridge,07/09/2013 03:00:00 PM,48,-122,76,75,151
6712,FremontBridge,07/09/2013 04:00:00 PM,48,-122,220,122,342
6713,FremontBridge,07/09/2013 05:00:00 PM,48,-122,497,216,713
6714,FremontBridge,07/09/2013 06:00:00 PM,48,-122,373,175,548
6715,FremontBridge,07/09/2013 07:00:00 PM,48,-122,197,107,304
6716,FremontBridge,07/09/2013 08:00:00 PM,48,-122,102,83,185
6717,FremontBridge,07/09/2013 09:00:00 PM,48,-122,72,60,132
6718,FremontBridge,07/09/2013 10:00:00 PM,48,-122,44,37,81
6719,FremontBridge,07/09/2013 11:00:00 PM,48,-122,22,20,42
6720,FremontBridge,07/10/2013 12:00:00 AM,48,-122,21,9,30
6721,FremontBridge,07/10/2013 01:00:00 AM,48,-122,6,3,9
6722,FremontBridge,07/10/2013 02:00:00 AM,48,-122,5,5,10
6723,FremontBridge,07/10/2013 03:00:00 AM,48,-122,3,3,6
6724,FremontBridge,07/10/2013 04:00:00 AM,48,-122,2,5,7
6725,FremontBridge,07/10/2013 05:00:00 AM,48,-122,13,37,50
6726,FremontBridge,07/10/2013 06:00:00 AM,48,-122,58,127,185
6727,FremontBridge,07/10/2013 07:00:00 AM,48,-122,102,300,402
6728,FremontBridge,07/10/2013 08:00:00 AM,48,-122,162,384,546
6729,FremontBridge,07/10/2013 09:00:00 AM,48,-122,135,215,350
6730,FremontBridge,07/10/2013 10:00:00 AM,48,-122,53,80,133
6731,FremontBridge,07/10/2013 11:00:00 AM,48,-122,49,48,97
6732,FremontBridge,07/10/2013 12:00:00 PM,48,-122,42,79,121
6733,FremontBridge,07/10/2013 01:00:00 PM,48,-122,79,60,139
6734,FremontBridge,07/10/2013 02:00:00 PM,48,-122,61,70,131
6735,FremontBridge,07/10/2013 03:00:00 PM,48,-122,92,90,182
6736,FremontBridge,07/10/2013 04:00:00 PM,48,-122,218,124,342
6737,FremontBridge,07/10/2013 05:00:00 PM,48,-122,488,204,692
6738,FremontBridge,07/10/2013 06:00:00 PM,48,-122,346,168,514
6739,FremontBridge,07/10/2013 07:00:00 PM,48,-122,186,126,312
6740,FremontBridge,07/10/2013 08:00:00 PM,48,-122,82,73,155
6741,FremontBridge,07/10/2013 09:00:00 PM,48,-122,49,56,105
6742,FremontBridge,07/10/2013 10:00:00 PM,48,-122,33,22,55
6743,FremontBridge,07/10/2013 11:00:00 PM,48,-122,18,16,34
6744,FremontBridge,07/11/2013 12:00:00 AM,48,-122,9,12,21
6745,FremontBridge,07/11/2013 01:00:00 AM,48,-122,5,6,11
6746,FremontBridge,07/11/2013 02:00:00 AM,48,-122,4,2,6
6747,FremontBridge,07/11/2013 03:00:00 AM,48,-122,0,0,0
6748,FremontBridge,07/11/2013 04:00:00 AM,48,-122,4,3,7
6749,FremontBridge,07/11/2013 05:00:00 AM,48,-122,11,25,36
6750,FremontBridge,07/11/2013 06:00:00 AM,48,-122,48,102,150
6751,FremontBridge,07/11/2013 07:00:00 AM,48,-122,93,240,333
6752,FremontBridge,07/11/2013 08:00:00 AM,48,-122,167,316,483
6753,FremontBridge,07/11/2013 09:00:00 AM,48,-122,100,192,292
6754,FremontBridge,07/11/2013 10:00:00 AM,48,-122,51,81,132
6755,FremontBridge,07/11/2013 11:00:00 AM,48,-122,50,57,107
6756,FremontBridge,07/11/2013 12:00:00 PM,48,-122,55,82,137
6757,FremontBridge,07/11/2013 01:00:00 PM,48,-122,56,59,115
6758,FremontBridge,07/11/2013 02:00:00 PM,48,-122,68,70,138
6759,FremontBridge,07/11/2013 03:00:00 PM,48,-122,66,93,159
6760,FremontBridge,07/11/2013 04:00:00 PM,48,-122,190,133,323
6761,FremontBridge,07/11/2013 05:00:00 PM,48,-122,410,177,587
6762,FremontBridge,07/11/2013 06:00:00 PM,48,-122,309,157,466
6763,FremontBridge,07/11/2013 07:00:00 PM,48,-122,145,94,239
6764,FremontBridge,07/11/2013 08:00:00 PM,48,-122,88,75,163
6765,FremontBridge,07/11/2013 09:00:00 PM,48,-122,45,44,89
6766,FremontBridge,07/11/2013 10:00:00 PM,48,-122,29,31,60
6767,FremontBridge,07/11/2013 11:00:00 PM,48,-122,32,14,46
6768,FremontBridge,07/12/2013 12:00:00 AM,48,-122,7,8,15
6769,FremontBridge,07/12/2013 01:00:00 AM,48,-122,6,7,13
6770,FremontBridge,07/12/2013 02:00:00 AM,48,-122,5,3,8
6771,FremontBridge,07/12/2013 03:00:00 AM,48,-122,2,1,3
6772,FremontBridge,07/12/2013 04:00:00 AM,48,-122,2,2,4
6773,FremontBridge,07/12/2013 05:00:00 AM,48,-122,7,23,30
6774,FremontBridge,07/12/2013 06:00:00 AM,48,-122,46,92,138
6775,FremontBridge,07/12/2013 07:00:00 AM,48,-122,108,208,316
6776,FremontBridge,07/12/2013 08:00:00 AM,48,-122,133,305,438
6777,FremontBridge,07/12/2013 09:00:00 AM,48,-122,107,176,283
6778,FremontBridge,07/12/2013 10:00:00 AM,48,-122,86,81,167
6779,FremontBridge,07/12/2013 11:00:00 AM,48,-122,33,50,83
6780,FremontBridge,07/12/2013 12:00:00 PM,48,-122,53,57,110
6781,FremontBridge,07/12/2013 01:00:00 PM,48,-122,40,59,99
6782,FremontBridge,07/12/2013 02:00:00 PM,48,-122,73,71,144
6783,FremontBridge,07/12/2013 03:00:00 PM,48,-122,114,76,190
6784,FremontBridge,07/12/2013 04:00:00 PM,48,-122,200,110,310
6785,FremontBridge,07/12/2013 05:00:00 PM,48,-122,351,169,520
6786,FremontBridge,07/12/2013 06:00:00 PM,48,-122,205,123,328
6787,FremontBridge,07/12/2013 07:00:00 PM,48,-122,101,79,180
6788,FremontBridge,07/12/2013 08:00:00 PM,48,-122,74,51,125
6789,FremontBridge,07/12/2013 09:00:00 PM,48,-122,42,46,88
6790,FremontBridge,07/12/2013 10:00:00 PM,48,-122,43,21,64
6791,FremontBridge,07/12/2013 11:00:00 PM,48,-122,20,20,40
6792,FremontBridge,07/13/2013 12:00:00 AM,48,-122,10,15,25
6793,FremontBridge,07/13/2013 01:00:00 AM,48,-122,6,7,13
6794,FremontBridge,07/13/2013 02:00:00 AM,48,-122,13,2,15
6795,FremontBridge,07/13/2013 03:00:00 AM,48,-122,7,8,15
6796,FremontBridge,07/13/2013 04:00:00 AM,48,-122,30,14,44
6797,FremontBridge,07/13/2013 05:00:00 AM,48,-122,36,17,53
6798,FremontBridge,07/13/2013 06:00:00 AM,48,-122,46,24,70
6799,FremontBridge,07/13/2013 07:00:00 AM,48,-122,23,34,57
6800,FremontBridge,07/13/2013 08:00:00 AM,48,-122,40,62,102
6801,FremontBridge,07/13/2013 09:00:00 AM,48,-122,71,90,161
6802,FremontBridge,07/13/2013 10:00:00 AM,48,-122,76,102,178
6803,FremontBridge,07/13/2013 11:00:00 AM,48,-122,83,98,181
6804,FremontBridge,07/13/2013 12:00:00 PM,48,-122,93,114,207
6805,FremontBridge,07/13/2013 01:00:00 PM,48,-122,90,131,221
6806,FremontBridge,07/13/2013 02:00:00 PM,48,-122,110,114,224
6807,FremontBridge,07/13/2013 03:00:00 PM,48,-122,116,120,236
6808,FremontBridge,07/13/2013 04:00:00 PM,48,-122,76,103,179
6809,FremontBridge,07/13/2013 05:00:00 PM,48,-122,78,84,162
6810,FremontBridge,07/13/2013 06:00:00 PM,48,-122,69,100,169
6811,FremontBridge,07/13/2013 07:00:00 PM,48,-122,47,42,89
6812,FremontBridge,07/13/2013 08:00:00 PM,48,-122,55,44,99
6813,FremontBridge,07/13/2013 09:00:00 PM,48,-122,42,34,76
6814,FremontBridge,07/13/2013 10:00:00 PM,48,-122,40,30,70
6815,FremontBridge,07/13/2013 11:00:00 PM,48,-122,31,21,52
6816,FremontBridge,07/14/2013 12:00:00 AM,48,-122,31,11,42
6817,FremontBridge,07/14/2013 01:00:00 AM,48,-122,11,7,18
6818,FremontBridge,07/14/2013 02:00:00 AM,48,-122,11,3,14
6819,FremontBridge,07/14/2013 03:00:00 AM,48,-122,2,3,5
6820,FremontBridge,07/14/2013 04:00:00 AM,48,-122,2,2,4
6821,FremontBridge,07/14/2013 05:00:00 AM,48,-122,2,9,11
6822,FremontBridge,07/14/2013 06:00:00 AM,48,-122,7,11,18
6823,FremontBridge,07/14/2013 07:00:00 AM,48,-122,22,31,53
6824,FremontBridge,07/14/2013 08:00:00 AM,48,-122,29,39,68
6825,FremontBridge,07/14/2013 09:00:00 AM,48,-122,47,84,131
6826,FremontBridge,07/14/2013 10:00:00 AM,48,-122,82,106,188
6827,FremontBridge,07/14/2013 11:00:00 AM,48,-122,87,101,188
6828,FremontBridge,07/14/2013 12:00:00 PM,48,-122,93,111,204
6829,FremontBridge,07/14/2013 01:00:00 PM,48,-122,110,132,242
6830,FremontBridge,07/14/2013 02:00:00 PM,48,-122,122,108,230
6831,FremontBridge,07/14/2013 03:00:00 PM,48,-122,111,137,248
6832,FremontBridge,07/14/2013 04:00:00 PM,48,-122,100,122,222
6833,FremontBridge,07/14/2013 05:00:00 PM,48,-122,93,126,219
6834,FremontBridge,07/14/2013 06:00:00 PM,48,-122,53,108,161
6835,FremontBridge,07/14/2013 07:00:00 PM,48,-122,56,80,136
6836,FremontBridge,07/14/2013 08:00:00 PM,48,-122,48,81,129
6837,FremontBridge,07/14/2013 09:00:00 PM,48,-122,30,29,59
6838,FremontBridge,07/14/2013 10:00:00 PM,48,-122,20,18,38
6839,FremontBridge,07/14/2013 11:00:00 PM,48,-122,7,5,12
6840,FremontBridge,07/15/2013 12:00:00 AM,48,-122,10,3,13
6841,FremontBridge,07/15/2013 01:00:00 AM,48,-122,1,2,3
6842,FremontBridge,07/15/2013 02:00:00 AM,48,-122,4,1,5
6843,FremontBridge,07/15/2013 03:00:00 AM,48,-122,2,3,5
6844,FremontBridge,07/15/2013 04:00:00 AM,48,-122,2,5,7
6845,FremontBridge,07/15/2013 05:00:00 AM,48,-122,10,30,40
6846,FremontBridge,07/15/2013 06:00:00 AM,48,-122,55,97,152
6847,FremontBridge,07/15/2013 07:00:00 AM,48,-122,106,276,382
6848,FremontBridge,07/15/2013 08:00:00 AM,48,-122,166,371,537
6849,FremontBridge,07/15/2013 09:00:00 AM,48,-122,129,199,328
6850,FremontBridge,07/15/2013 10:00:00 AM,48,-122,65,89,154
6851,FremontBridge,07/15/2013 11:00:00 AM,48,-122,46,64,110
6852,FremontBridge,07/15/2013 12:00:00 PM,48,-122,50,66,116
6853,FremontBridge,07/15/2013 01:00:00 PM,48,-122,60,67,127
6854,FremontBridge,07/15/2013 02:00:00 PM,48,-122,67,66,133
6855,FremontBridge,07/15/2013 03:00:00 PM,48,-122,83,92,175
6856,FremontBridge,07/15/2013 04:00:00 PM,48,-122,196,104,300
6857,FremontBridge,07/15/2013 05:00:00 PM,48,-122,453,196,649
6858,FremontBridge,07/15/2013 06:00:00 PM,48,-122,345,191,536
6859,FremontBridge,07/15/2013 07:00:00 PM,48,-122,164,113,277
6860,FremontBridge,07/15/2013 08:00:00 PM,48,-122,84,76,160
6861,FremontBridge,07/15/2013 09:00:00 PM,48,-122,48,58,106
6862,FremontBridge,07/15/2013 10:00:00 PM,48,-122,49,24,73
6863,FremontBridge,07/15/2013 11:00:00 PM,48,-122,16,14,30
6864,FremontBridge,07/16/2013 12:00:00 AM,48,-122,5,5,10
6865,FremontBridge,07/16/2013 01:00:00 AM,48,-122,3,2,5
6866,FremontBridge,07/16/2013 02:00:00 AM,48,-122,2,0,2
6867,FremontBridge,07/16/2013 03:00:00 AM,48,-122,1,3,4
6868,FremontBridge,07/16/2013 04:00:00 AM,48,-122,4,9,13
6869,FremontBridge,07/16/2013 05:00:00 AM,48,-122,12,42,54
6870,FremontBridge,07/16/2013 06:00:00 AM,48,-122,66,113,179
6871,FremontBridge,07/16/2013 07:00:00 AM,48,-122,110,332,442
6872,FremontBridge,07/16/2013 08:00:00 AM,48,-122,193,420,613
6873,FremontBridge,07/16/2013 09:00:00 AM,48,-122,130,191,321
6874,FremontBridge,07/16/2013 10:00:00 AM,48,-122,73,96,169
6875,FremontBridge,07/16/2013 11:00:00 AM,48,-122,46,43,89
6876,FremontBridge,07/16/2013 12:00:00 PM,48,-122,51,61,112
6877,FremontBridge,07/16/2013 01:00:00 PM,48,-122,80,63,143
6878,FremontBridge,07/16/2013 02:00:00 PM,48,-122,59,64,123
6879,FremontBridge,07/16/2013 03:00:00 PM,48,-122,93,87,180
6880,FremontBridge,07/16/2013 04:00:00 PM,48,-122,216,107,323
6881,FremontBridge,07/16/2013 05:00:00 PM,48,-122,481,222,703
6882,FremontBridge,07/16/2013 06:00:00 PM,48,-122,311,177,488
6883,FremontBridge,07/16/2013 07:00:00 PM,48,-122,157,110,267
6884,FremontBridge,07/16/2013 08:00:00 PM,48,-122,85,70,155
6885,FremontBridge,07/16/2013 09:00:00 PM,48,-122,51,55,106
6886,FremontBridge,07/16/2013 10:00:00 PM,48,-122,34,28,62
6887,FremontBridge,07/16/2013 11:00:00 PM,48,-122,16,14,30
6888,FremontBridge,07/17/2013 12:00:00 AM,48,-122,6,6,12
6889,FremontBridge,07/17/2013 01:00:00 AM,48,-122,2,0,2
6890,FremontBridge,07/17/2013 02:00:00 AM,48,-122,2,9,11
6891,FremontBridge,07/17/2013 03:00:00 AM,48,-122,0,2,2
6892,FremontBridge,07/17/2013 04:00:00 AM,48,-122,1,8,9
6893,FremontBridge,07/17/2013 05:00:00 AM,48,-122,7,24,31
6894,FremontBridge,07/17/2013 06:00:00 AM,48,-122,54,108,162
6895,FremontBridge,07/17/2013 07:00:00 AM,48,-122,102,260,362
6896,FremontBridge,07/17/2013 08:00:00 AM,48,-122,163,360,523
6897,FremontBridge,07/17/2013 09:00:00 AM,48,-122,115,204,319
6898,FremontBridge,07/17/2013 10:00:00 AM,48,-122,53,74,127
6899,FremontBridge,07/17/2013 11:00:00 AM,48,-122,38,55,93
6900,FremontBridge,07/17/2013 12:00:00 PM,48,-122,41,65,106
6901,FremontBridge,07/17/2013 01:00:00 PM,48,-122,69,52,121
6902,FremontBridge,07/17/2013 02:00:00 PM,48,-122,61,44,105
6903,FremontBridge,07/17/2013 03:00:00 PM,48,-122,91,88,179
6904,FremontBridge,07/17/2013 04:00:00 PM,48,-122,178,110,288
6905,FremontBridge,07/17/2013 05:00:00 PM,48,-122,412,180,592
6906,FremontBridge,07/17/2013 06:00:00 PM,48,-122,313,161,474
6907,FremontBridge,07/17/2013 07:00:00 PM,48,-122,164,120,284
6908,FremontBridge,07/17/2013 08:00:00 PM,48,-122,85,68,153
6909,FremontBridge,07/17/2013 09:00:00 PM,48,-122,49,55,104
6910,FremontBridge,07/17/2013 10:00:00 PM,48,-122,32,33,65
6911,FremontBridge,07/17/2013 11:00:00 PM,48,-122,31,16,47
6912,FremontBridge,07/18/2013 12:00:00 AM,48,-122,6,10,16
6913,FremontBridge,07/18/2013 01:00:00 AM,48,-122,2,6,8
6914,FremontBridge,07/18/2013 02:00:00 AM,48,-122,3,0,3
6915,FremontBridge,07/18/2013 03:00:00 AM,48,-122,2,1,3
6916,FremontBridge,07/18/2013 04:00:00 AM,48,-122,3,4,7
6917,FremontBridge,07/18/2013 05:00:00 AM,48,-122,12,21,33
6918,FremontBridge,07/18/2013 06:00:00 AM,48,-122,49,113,162
6919,FremontBridge,07/18/2013 07:00:00 AM,48,-122,108,284,392
6920,FremontBridge,07/18/2013 08:00:00 AM,48,-122,174,336,510
6921,FremontBridge,07/18/2013 09:00:00 AM,48,-122,120,213,333
6922,FremontBridge,07/18/2013 10:00:00 AM,48,-122,57,71,128
6923,FremontBridge,07/18/2013 11:00:00 AM,48,-122,36,64,100
6924,FremontBridge,07/18/2013 12:00:00 PM,48,-122,44,66,110
6925,FremontBridge,07/18/2013 01:00:00 PM,48,-122,67,72,139
6926,FremontBridge,07/18/2013 02:00:00 PM,48,-122,68,73,141
6927,FremontBridge,07/18/2013 03:00:00 PM,48,-122,97,84,181
6928,FremontBridge,07/18/2013 04:00:00 PM,48,-122,185,121,306
6929,FremontBridge,07/18/2013 05:00:00 PM,48,-122,429,194,623
6930,FremontBridge,07/18/2013 06:00:00 PM,48,-122,288,187,475
6931,FremontBridge,07/18/2013 07:00:00 PM,48,-122,146,140,286
6932,FremontBridge,07/18/2013 08:00:00 PM,48,-122,109,84,193
6933,FremontBridge,07/18/2013 09:00:00 PM,48,-122,50,63,113
6934,FremontBridge,07/18/2013 10:00:00 PM,48,-122,36,35,71
6935,FremontBridge,07/18/2013 11:00:00 PM,48,-122,32,21,53
6936,FremontBridge,07/19/2013 12:00:00 AM,48,-122,12,12,24
6937,FremontBridge,07/19/2013 01:00:00 AM,48,-122,7,7,14
6938,FremontBridge,07/19/2013 02:00:00 AM,48,-122,4,2,6
6939,FremontBridge,07/19/2013 03:00:00 AM,48,-122,0,3,3
6940,FremontBridge,07/19/2013 04:00:00 AM,48,-122,3,6,9
6941,FremontBridge,07/19/2013 05:00:00 AM,48,-122,10,18,28
6942,FremontBridge,07/19/2013 06:00:00 AM,48,-122,60,87,147
6943,FremontBridge,07/19/2013 07:00:00 AM,48,-122,92,223,315
6944,FremontBridge,07/19/2013 08:00:00 AM,48,-122,151,312,463
6945,FremontBridge,07/19/2013 09:00:00 AM,48,-122,89,161,250
6946,FremontBridge,07/19/2013 10:00:00 AM,48,-122,64,102,166
6947,FremontBridge,07/19/2013 11:00:00 AM,48,-122,51,54,105
6948,FremontBridge,07/19/2013 12:00:00 PM,48,-122,70,63,133
6949,FremontBridge,07/19/2013 01:00:00 PM,48,-122,49,78,127
6950,FremontBridge,07/19/2013 02:00:00 PM,48,-122,74,75,149
6951,FremontBridge,07/19/2013 03:00:00 PM,48,-122,140,97,237
6952,FremontBridge,07/19/2013 04:00:00 PM,48,-122,177,135,312
6953,FremontBridge,07/19/2013 05:00:00 PM,48,-122,325,195,520
6954,FremontBridge,07/19/2013 06:00:00 PM,48,-122,222,135,357
6955,FremontBridge,07/19/2013 07:00:00 PM,48,-122,128,70,198
6956,FremontBridge,07/19/2013 08:00:00 PM,48,-122,85,43,128
6957,FremontBridge,07/19/2013 09:00:00 PM,48,-122,52,63,115
6958,FremontBridge,07/19/2013 10:00:00 PM,48,-122,45,21,66
6959,FremontBridge,07/19/2013 11:00:00 PM,48,-122,23,20,43
6960,FremontBridge,07/20/2013 12:00:00 AM,48,-122,14,15,29
6961,FremontBridge,07/20/2013 01:00:00 AM,48,-122,9,7,16
6962,FremontBridge,07/20/2013 02:00:00 AM,48,-122,5,6,11
6963,FremontBridge,07/20/2013 03:00:00 AM,48,-122,5,2,7
6964,FremontBridge,07/20/2013 04:00:00 AM,48,-122,3,6,9
6965,FremontBridge,07/20/2013 05:00:00 AM,48,-122,2,13,15
6966,FremontBridge,07/20/2013 06:00:00 AM,48,-122,16,22,38
6967,FremontBridge,07/20/2013 07:00:00 AM,48,-122,40,35,75
6968,FremontBridge,07/20/2013 08:00:00 AM,48,-122,38,55,93
6969,FremontBridge,07/20/2013 09:00:00 AM,48,-122,69,87,156
6970,FremontBridge,07/20/2013 10:00:00 AM,48,-122,39,76,115
6971,FremontBridge,07/20/2013 11:00:00 AM,48,-122,65,95,160
6972,FremontBridge,07/20/2013 12:00:00 PM,48,-122,56,132,188
6973,FremontBridge,07/20/2013 01:00:00 PM,48,-122,83,117,200
6974,FremontBridge,07/20/2013 02:00:00 PM,48,-122,89,111,200
6975,FremontBridge,07/20/2013 03:00:00 PM,48,-122,119,110,229
6976,FremontBridge,07/20/2013 04:00:00 PM,48,-122,123,110,233
6977,FremontBridge,07/20/2013 05:00:00 PM,48,-122,95,104,199
6978,FremontBridge,07/20/2013 06:00:00 PM,48,-122,75,87,162
6979,FremontBridge,07/20/2013 07:00:00 PM,48,-122,65,57,122
6980,FremontBridge,07/20/2013 08:00:00 PM,48,-122,36,41,77
6981,FremontBridge,07/20/2013 09:00:00 PM,48,-122,29,45,74
6982,FremontBridge,07/20/2013 10:00:00 PM,48,-122,32,17,49
6983,FremontBridge,07/20/2013 11:00:00 PM,48,-122,26,28,54
6984,FremontBridge,07/21/2013 12:00:00 AM,48,-122,20,7,27
6985,FremontBridge,07/21/2013 01:00:00 AM,48,-122,16,8,24
6986,FremontBridge,07/21/2013 02:00:00 AM,48,-122,7,2,9
6987,FremontBridge,07/21/2013 03:00:00 AM,48,-122,2,7,9
6988,FremontBridge,07/21/2013 04:00:00 AM,48,-122,4,5,9
6989,FremontBridge,07/21/2013 05:00:00 AM,48,-122,6,7,13
6990,FremontBridge,07/21/2013 06:00:00 AM,48,-122,5,7,12
6991,FremontBridge,07/21/2013 07:00:00 AM,48,-122,17,23,40
6992,FremontBridge,07/21/2013 08:00:00 AM,48,-122,39,29,68
6993,FremontBridge,07/21/2013 09:00:00 AM,48,-122,34,57,91
6994,FremontBridge,07/21/2013 10:00:00 AM,48,-122,44,73,117
6995,FremontBridge,07/21/2013 11:00:00 AM,48,-122,50,72,122
6996,FremontBridge,07/21/2013 12:00:00 PM,48,-122,88,98,186
6997,FremontBridge,07/21/2013 01:00:00 PM,48,-122,86,108,194
6998,FremontBridge,07/21/2013 02:00:00 PM,48,-122,127,147,274
6999,FremontBridge,07/21/2013 03:00:00 PM,48,-122,115,124,239
7000,FremontBridge,07/21/2013 04:00:00 PM,48,-122,104,136,240
7001,FremontBridge,07/21/2013 05:00:00 PM,48,-122,124,104,228
7002,FremontBridge,07/21/2013 06:00:00 PM,48,-122,77,107,184
7003,FremontBridge,07/21/2013 07:00:00 PM,48,-122,52,57,109
7004,FremontBridge,07/21/2013 08:00:00 PM,48,-122,34,50,84
7005,FremontBridge,07/21/2013 09:00:00 PM,48,-122,51,24,75
7006,FremontBridge,07/21/2013 10:00:00 PM,48,-122,14,21,35
7007,FremontBridge,07/21/2013 11:00:00 PM,48,-122,16,20,36
7008,FremontBridge,07/22/2013 12:00:00 AM,48,-122,6,8,14
7009,FremontBridge,07/22/2013 01:00:00 AM,48,-122,2,1,3
7010,FremontBridge,07/22/2013 02:00:00 AM,48,-122,3,1,4
7011,FremontBridge,07/22/2013 03:00:00 AM,48,-122,2,1,3
7012,FremontBridge,07/22/2013 04:00:00 AM,48,-122,2,7,9
7013,FremontBridge,07/22/2013 05:00:00 AM,48,-122,15,23,38
7014,FremontBridge,07/22/2013 06:00:00 AM,48,-122,46,107,153
7015,FremontBridge,07/22/2013 07:00:00 AM,48,-122,89,253,342
7016,FremontBridge,07/22/2013 08:00:00 AM,48,-122,143,319,462
7017,FremontBridge,07/22/2013 09:00:00 AM,48,-122,115,214,329
7018,FremontBridge,07/22/2013 10:00:00 AM,48,-122,75,78,153
7019,FremontBridge,07/22/2013 11:00:00 AM,48,-122,36,48,84
7020,FremontBridge,07/22/2013 12:00:00 PM,48,-122,47,55,102
7021,FremontBridge,07/22/2013 01:00:00 PM,48,-122,63,59,122
7022,FremontBridge,07/22/2013 02:00:00 PM,48,-122,57,68,125
7023,FremontBridge,07/22/2013 03:00:00 PM,48,-122,91,90,181
7024,FremontBridge,07/22/2013 04:00:00 PM,48,-122,189,106,295
7025,FremontBridge,07/22/2013 05:00:00 PM,48,-122,434,199,633
7026,FremontBridge,07/22/2013 06:00:00 PM,48,-122,314,168,482
7027,FremontBridge,07/22/2013 07:00:00 PM,48,-122,174,116,290
7028,FremontBridge,07/22/2013 08:00:00 PM,48,-122,92,75,167
7029,FremontBridge,07/22/2013 09:00:00 PM,48,-122,54,42,96
7030,FremontBridge,07/22/2013 10:00:00 PM,48,-122,33,25,58
7031,FremontBridge,07/22/2013 11:00:00 PM,48,-122,19,10,29
7032,FremontBridge,07/23/2013 12:00:00 AM,48,-122,13,6,19
7033,FremontBridge,07/23/2013 01:00:00 AM,48,-122,1,7,8
7034,FremontBridge,07/23/2013 02:00:00 AM,48,-122,1,4,5
7035,FremontBridge,07/23/2013 03:00:00 AM,48,-122,0,4,4
7036,FremontBridge,07/23/2013 04:00:00 AM,48,-122,3,6,9
7037,FremontBridge,07/23/2013 05:00:00 AM,48,-122,14,28,42
7038,FremontBridge,07/23/2013 06:00:00 AM,48,-122,52,107,159
7039,FremontBridge,07/23/2013 07:00:00 AM,48,-122,103,312,415
7040,FremontBridge,07/23/2013 08:00:00 AM,48,-122,166,390,556
7041,FremontBridge,07/23/2013 09:00:00 AM,48,-122,125,232,357
7042,FremontBridge,07/23/2013 10:00:00 AM,48,-122,75,100,175
7043,FremontBridge,07/23/2013 11:00:00 AM,48,-122,45,71,116
7044,FremontBridge,07/23/2013 12:00:00 PM,48,-122,55,74,129
7045,FremontBridge,07/23/2013 01:00:00 PM,48,-122,61,65,126
7046,FremontBridge,07/23/2013 02:00:00 PM,48,-122,60,61,121
7047,FremontBridge,07/23/2013 03:00:00 PM,48,-122,88,79,167
7048,FremontBridge,07/23/2013 04:00:00 PM,48,-122,212,108,320
7049,FremontBridge,07/23/2013 05:00:00 PM,48,-122,434,190,624
7050,FremontBridge,07/23/2013 06:00:00 PM,48,-122,388,197,585
7051,FremontBridge,07/23/2013 07:00:00 PM,48,-122,172,109,281
7052,FremontBridge,07/23/2013 08:00:00 PM,48,-122,89,93,182
7053,FremontBridge,07/23/2013 09:00:00 PM,48,-122,52,53,105
7054,FremontBridge,07/23/2013 10:00:00 PM,48,-122,41,17,58
7055,FremontBridge,07/23/2013 11:00:00 PM,48,-122,28,13,41
7056,FremontBridge,07/24/2013 12:00:00 AM,48,-122,13,5,18
7057,FremontBridge,07/24/2013 01:00:00 AM,48,-122,5,2,7
7058,FremontBridge,07/24/2013 02:00:00 AM,48,-122,0,5,5
7059,FremontBridge,07/24/2013 03:00:00 AM,48,-122,0,3,3
7060,FremontBridge,07/24/2013 04:00:00 AM,48,-122,2,5,7
7061,FremontBridge,07/24/2013 05:00:00 AM,48,-122,6,34,40
7062,FremontBridge,07/24/2013 06:00:00 AM,48,-122,54,118,172
7063,FremontBridge,07/24/2013 07:00:00 AM,48,-122,108,290,398
7064,FremontBridge,07/24/2013 08:00:00 AM,48,-122,198,380,578
7065,FremontBridge,07/24/2013 09:00:00 AM,48,-122,119,229,348
7066,FremontBridge,07/24/2013 10:00:00 AM,48,-122,87,78,165
7067,FremontBridge,07/24/2013 11:00:00 AM,48,-122,46,72,118
7068,FremontBridge,07/24/2013 12:00:00 PM,48,-122,72,52,124
7069,FremontBridge,07/24/2013 01:00:00 PM,48,-122,65,70,135
7070,FremontBridge,07/24/2013 02:00:00 PM,48,-122,67,57,124
7071,FremontBridge,07/24/2013 03:00:00 PM,48,-122,101,90,191
7072,FremontBridge,07/24/2013 04:00:00 PM,48,-122,203,114,317
7073,FremontBridge,07/24/2013 05:00:00 PM,48,-122,483,214,697
7074,FremontBridge,07/24/2013 06:00:00 PM,48,-122,350,178,528
7075,FremontBridge,07/24/2013 07:00:00 PM,48,-122,182,145,327
7076,FremontBridge,07/24/2013 08:00:00 PM,48,-122,101,81,182
7077,FremontBridge,07/24/2013 09:00:00 PM,48,-122,57,56,113
7078,FremontBridge,07/24/2013 10:00:00 PM,48,-122,30,37,67
7079,FremontBridge,07/24/2013 11:00:00 PM,48,-122,14,16,30
7080,FremontBridge,07/25/2013 12:00:00 AM,48,-122,12,7,19
7081,FremontBridge,07/25/2013 01:00:00 AM,48,-122,26,4,30
7082,FremontBridge,07/25/2013 02:00:00 AM,48,-122,1,2,3
7083,FremontBridge,07/25/2013 03:00:00 AM,48,-122,0,5,5
7084,FremontBridge,07/25/2013 04:00:00 AM,48,-122,0,5,5
7085,FremontBridge,07/25/2013 05:00:00 AM,48,-122,10,24,34
7086,FremontBridge,07/25/2013 06:00:00 AM,48,-122,52,95,147
7087,FremontBridge,07/25/2013 07:00:00 AM,48,-122,106,301,407
7088,FremontBridge,07/25/2013 08:00:00 AM,48,-122,182,350,532
7089,FremontBridge,07/25/2013 09:00:00 AM,48,-122,122,209,331
7090,FremontBridge,07/25/2013 10:00:00 AM,48,-122,64,97,161
7091,FremontBridge,07/25/2013 11:00:00 AM,48,-122,49,54,103
7092,FremontBridge,07/25/2013 12:00:00 PM,48,-122,64,52,116
7093,FremontBridge,07/25/2013 01:00:00 PM,48,-122,60,77,137
7094,FremontBridge,07/25/2013 02:00:00 PM,48,-122,58,75,133
7095,FremontBridge,07/25/2013 03:00:00 PM,48,-122,101,57,158
7096,FremontBridge,07/25/2013 04:00:00 PM,48,-122,183,115,298
7097,FremontBridge,07/25/2013 05:00:00 PM,48,-122,445,171,616
7098,FremontBridge,07/25/2013 06:00:00 PM,48,-122,345,202,547
7099,FremontBridge,07/25/2013 07:00:00 PM,48,-122,139,147,286
7100,FremontBridge,07/25/2013 08:00:00 PM,48,-122,90,100,190
7101,FremontBridge,07/25/2013 09:00:00 PM,48,-122,58,56,114
7102,FremontBridge,07/25/2013 10:00:00 PM,48,-122,35,30,65
7103,FremontBridge,07/25/2013 11:00:00 PM,48,-122,25,11,36
7104,FremontBridge,07/26/2013 12:00:00 AM,48,-122,16,9,25
7105,FremontBridge,07/26/2013 01:00:00 AM,48,-122,9,8,17
7106,FremontBridge,07/26/2013 02:00:00 AM,48,-122,5,2,7
7107,FremontBridge,07/26/2013 03:00:00 AM,48,-122,1,3,4
7108,FremontBridge,07/26/2013 04:00:00 AM,48,-122,1,3,4
7109,FremontBridge,07/26/2013 05:00:00 AM,48,-122,10,28,38
7110,FremontBridge,07/26/2013 06:00:00 AM,48,-122,38,88,126
7111,FremontBridge,07/26/2013 07:00:00 AM,48,-122,96,220,316
7112,FremontBridge,07/26/2013 08:00:00 AM,48,-122,147,307,454
7113,FremontBridge,07/26/2013 09:00:00 AM,48,-122,127,168,295
7114,FremontBridge,07/26/2013 10:00:00 AM,48,-122,56,99,155
7115,FremontBridge,07/26/2013 11:00:00 AM,48,-122,72,68,140
7116,FremontBridge,07/26/2013 12:00:00 PM,48,-122,49,63,112
7117,FremontBridge,07/26/2013 01:00:00 PM,48,-122,63,86,149
7118,FremontBridge,07/26/2013 02:00:00 PM,48,-122,77,58,135
7119,FremontBridge,07/26/2013 03:00:00 PM,48,-122,102,92,194
7120,FremontBridge,07/26/2013 04:00:00 PM,48,-122,225,124,349
7121,FremontBridge,07/26/2013 05:00:00 PM,48,-122,390,144,534
7122,FremontBridge,07/26/2013 06:00:00 PM,48,-122,191,152,343
7123,FremontBridge,07/26/2013 07:00:00 PM,48,-122,112,127,239
7124,FremontBridge,07/26/2013 08:00:00 PM,48,-122,70,50,120
7125,FremontBridge,07/26/2013 09:00:00 PM,48,-122,46,43,89
7126,FremontBridge,07/26/2013 10:00:00 PM,48,-122,23,22,45
7127,FremontBridge,07/26/2013 11:00:00 PM,48,-122,38,35,73
7128,FremontBridge,07/27/2013 12:00:00 AM,48,-122,16,14,30
7129,FremontBridge,07/27/2013 01:00:00 AM,48,-122,9,3,12
7130,FremontBridge,07/27/2013 02:00:00 AM,48,-122,6,6,12
7131,FremontBridge,07/27/2013 03:00:00 AM,48,-122,7,3,10
7132,FremontBridge,07/27/2013 04:00:00 AM,48,-122,4,3,7
7133,FremontBridge,07/27/2013 05:00:00 AM,48,-122,3,12,15
7134,FremontBridge,07/27/2013 06:00:00 AM,48,-122,17,15,32
7135,FremontBridge,07/27/2013 07:00:00 AM,48,-122,27,24,51
7136,FremontBridge,07/27/2013 08:00:00 AM,48,-122,41,61,102
7137,FremontBridge,07/27/2013 09:00:00 AM,48,-122,67,62,129
7138,FremontBridge,07/27/2013 10:00:00 AM,48,-122,74,87,161
7139,FremontBridge,07/27/2013 11:00:00 AM,48,-122,83,137,220
7140,FremontBridge,07/27/2013 12:00:00 PM,48,-122,77,110,187
7141,FremontBridge,07/27/2013 01:00:00 PM,48,-122,81,108,189
7142,FremontBridge,07/27/2013 02:00:00 PM,48,-122,110,100,210
7143,FremontBridge,07/27/2013 03:00:00 PM,48,-122,98,90,188
7144,FremontBridge,07/27/2013 04:00:00 PM,48,-122,86,100,186
7145,FremontBridge,07/27/2013 05:00:00 PM,48,-122,120,108,228
7146,FremontBridge,07/27/2013 06:00:00 PM,48,-122,74,59,133
7147,FremontBridge,07/27/2013 07:00:00 PM,48,-122,54,74,128
7148,FremontBridge,07/27/2013 08:00:00 PM,48,-122,64,55,119
7149,FremontBridge,07/27/2013 09:00:00 PM,48,-122,40,38,78
7150,FremontBridge,07/27/2013 10:00:00 PM,48,-122,28,13,41
7151,FremontBridge,07/27/2013 11:00:00 PM,48,-122,26,7,33
7152,FremontBridge,07/28/2013 12:00:00 AM,48,-122,24,9,33
7153,FremontBridge,07/28/2013 01:00:00 AM,48,-122,8,5,13
7154,FremontBridge,07/28/2013 02:00:00 AM,48,-122,11,2,13
7155,FremontBridge,07/28/2013 03:00:00 AM,48,-122,3,2,5
7156,FremontBridge,07/28/2013 04:00:00 AM,48,-122,1,0,1
7157,FremontBridge,07/28/2013 05:00:00 AM,48,-122,5,11,16
7158,FremontBridge,07/28/2013 06:00:00 AM,48,-122,10,8,18
7159,FremontBridge,07/28/2013 07:00:00 AM,48,-122,19,15,34
7160,FremontBridge,07/28/2013 08:00:00 AM,48,-122,35,28,63
7161,FremontBridge,07/28/2013 09:00:00 AM,48,-122,54,38,92
7162,FremontBridge,07/28/2013 10:00:00 AM,48,-122,54,116,170
7163,FremontBridge,07/28/2013 11:00:00 AM,48,-122,38,46,84
7164,FremontBridge,07/28/2013 12:00:00 PM,48,-122,58,74,132
7165,FremontBridge,07/28/2013 01:00:00 PM,48,-122,54,71,125
7166,FremontBridge,07/28/2013 02:00:00 PM,48,-122,95,108,203
7167,FremontBridge,07/28/2013 03:00:00 PM,48,-122,74,118,192
7168,FremontBridge,07/28/2013 04:00:00 PM,48,-122,70,104,174
7169,FremontBridge,07/28/2013 05:00:00 PM,48,-122,72,89,161
7170,FremontBridge,07/28/2013 06:00:00 PM,48,-122,49,101,150
7171,FremontBridge,07/28/2013 07:00:00 PM,48,-122,51,43,94
7172,FremontBridge,07/28/2013 08:00:00 PM,48,-122,32,33,65
7173,FremontBridge,07/28/2013 09:00:00 PM,48,-122,24,28,52
7174,FremontBridge,07/28/2013 10:00:00 PM,48,-122,38,23,61
7175,FremontBridge,07/28/2013 11:00:00 PM,48,-122,23,6,29
7176,FremontBridge,07/29/2013 12:00:00 AM,48,-122,8,6,14
7177,FremontBridge,07/29/2013 01:00:00 AM,48,-122,7,3,10
7178,FremontBridge,07/29/2013 02:00:00 AM,48,-122,6,4,10
7179,FremontBridge,07/29/2013 03:00:00 AM,48,-122,1,0,1
7180,FremontBridge,07/29/2013 04:00:00 AM,48,-122,1,8,9
7181,FremontBridge,07/29/2013 05:00:00 AM,48,-122,10,24,34
7182,FremontBridge,07/29/2013 06:00:00 AM,48,-122,49,93,142
7183,FremontBridge,07/29/2013 07:00:00 AM,48,-122,92,252,344
7184,FremontBridge,07/29/2013 08:00:00 AM,48,-122,154,335,489
7185,FremontBridge,07/29/2013 09:00:00 AM,48,-122,131,197,328
7186,FremontBridge,07/29/2013 10:00:00 AM,48,-122,42,72,114
7187,FremontBridge,07/29/2013 11:00:00 AM,48,-122,43,62,105
7188,FremontBridge,07/29/2013 12:00:00 PM,48,-122,42,48,90
7189,FremontBridge,07/29/2013 01:00:00 PM,48,-122,59,56,115
7190,FremontBridge,07/29/2013 02:00:00 PM,48,-122,73,52,125
7191,FremontBridge,07/29/2013 03:00:00 PM,48,-122,78,78,156
7192,FremontBridge,07/29/2013 04:00:00 PM,48,-122,181,118,299
7193,FremontBridge,07/29/2013 05:00:00 PM,48,-122,440,196,636
7194,FremontBridge,07/29/2013 06:00:00 PM,48,-122,312,178,490
7195,FremontBridge,07/29/2013 07:00:00 PM,48,-122,147,129,276
7196,FremontBridge,07/29/2013 08:00:00 PM,48,-122,78,60,138
7197,FremontBridge,07/29/2013 09:00:00 PM,48,-122,48,43,91
7198,FremontBridge,07/29/2013 10:00:00 PM,48,-122,22,21,43
7199,FremontBridge,07/29/2013 11:00:00 PM,48,-122,16,13,29
7200,FremontBridge,07/30/2013 12:00:00 AM,48,-122,14,6,20
7201,FremontBridge,07/30/2013 01:00:00 AM,48,-122,1,2,3
7202,FremontBridge,07/30/2013 02:00:00 AM,48,-122,0,1,1
7203,FremontBridge,07/30/2013 03:00:00 AM,48,-122,3,2,5
7204,FremontBridge,07/30/2013 04:00:00 AM,48,-122,3,8,11
7205,FremontBridge,07/30/2013 05:00:00 AM,48,-122,10,30,40
7206,FremontBridge,07/30/2013 06:00:00 AM,48,-122,63,102,165
7207,FremontBridge,07/30/2013 07:00:00 AM,48,-122,113,284,397
7208,FremontBridge,07/30/2013 08:00:00 AM,48,-122,175,373,548
7209,FremontBridge,07/30/2013 09:00:00 AM,48,-122,125,193,318
7210,FremontBridge,07/30/2013 10:00:00 AM,48,-122,73,73,146
7211,FremontBridge,07/30/2013 11:00:00 AM,48,-122,40,65,105
7212,FremontBridge,07/30/2013 12:00:00 PM,48,-122,43,53,96
7213,FremontBridge,07/30/2013 01:00:00 PM,48,-122,57,75,132
7214,FremontBridge,07/30/2013 02:00:00 PM,48,-122,72,55,127
7215,FremontBridge,07/30/2013 03:00:00 PM,48,-122,91,101,192
7216,FremontBridge,07/30/2013 04:00:00 PM,48,-122,214,118,332
7217,FremontBridge,07/30/2013 05:00:00 PM,48,-122,504,200,704
7218,FremontBridge,07/30/2013 06:00:00 PM,48,-122,351,176,527
7219,FremontBridge,07/30/2013 07:00:00 PM,48,-122,156,133,289
7220,FremontBridge,07/30/2013 08:00:00 PM,48,-122,91,83,174
7221,FremontBridge,07/30/2013 09:00:00 PM,48,-122,51,47,98
7222,FremontBridge,07/30/2013 10:00:00 PM,48,-122,38,33,71
7223,FremontBridge,07/30/2013 11:00:00 PM,48,-122,26,13,39
7224,FremontBridge,07/31/2013 12:00:00 AM,48,-122,5,13,18
7225,FremontBridge,07/31/2013 01:00:00 AM,48,-122,3,3,6
7226,FremontBridge,07/31/2013 02:00:00 AM,48,-122,5,3,8
7227,FremontBridge,07/31/2013 03:00:00 AM,48,-122,2,1,3
7228,FremontBridge,07/31/2013 04:00:00 AM,48,-122,1,5,6
7229,FremontBridge,07/31/2013 05:00:00 AM,48,-122,10,31,41
7230,FremontBridge,07/31/2013 06:00:00 AM,48,-122,51,113,164
7231,FremontBridge,07/31/2013 07:00:00 AM,48,-122,83,294,377
7232,FremontBridge,07/31/2013 08:00:00 AM,48,-122,158,322,480
7233,FremontBridge,07/31/2013 09:00:00 AM,48,-122,125,194,319
7234,FremontBridge,07/31/2013 10:00:00 AM,48,-122,65,66,131
7235,FremontBridge,07/31/2013 11:00:00 AM,48,-122,40,53,93
7236,FremontBridge,07/31/2013 12:00:00 PM,48,-122,55,43,98
7237,FremontBridge,07/31/2013 01:00:00 PM,48,-122,38,63,101
7238,FremontBridge,07/31/2013 02:00:00 PM,48,-122,71,61,132
7239,FremontBridge,07/31/2013 03:00:00 PM,48,-122,79,68,147
7240,FremontBridge,07/31/2013 04:00:00 PM,48,-122,176,115,291
7241,FremontBridge,07/31/2013 05:00:00 PM,48,-122,428,215,643
7242,FremontBridge,07/31/2013 06:00:00 PM,48,-122,307,158,465
7243,FremontBridge,07/31/2013 07:00:00 PM,48,-122,157,115,272
7244,FremontBridge,07/31/2013 08:00:00 PM,48,-122,74,63,137
7245,FremontBridge,07/31/2013 09:00:00 PM,48,-122,51,55,106
7246,FremontBridge,07/31/2013 10:00:00 PM,48,-122,24,22,46
7247,FremontBridge,07/31/2013 11:00:00 PM,48,-122,24,14,38
7248,FremontBridge,08/01/2013 12:00:00 AM,48,-122,8,10,18
7249,FremontBridge,08/01/2013 01:00:00 AM,48,-122,7,2,9
7250,FremontBridge,08/01/2013 02:00:00 AM,48,-122,6,4,10
7251,FremontBridge,08/01/2013 03:00:00 AM,48,-122,0,4,4
7252,FremontBridge,08/01/2013 04:00:00 AM,48,-122,0,5,5
7253,FremontBridge,08/01/2013 05:00:00 AM,48,-122,8,30,38
7254,FremontBridge,08/01/2013 06:00:00 AM,48,-122,49,80,129
7255,FremontBridge,08/01/2013 07:00:00 AM,48,-122,76,225,301
7256,FremontBridge,08/01/2013 08:00:00 AM,48,-122,138,326,464
7257,FremontBridge,08/01/2013 09:00:00 AM,48,-122,111,189,300
7258,FremontBridge,08/01/2013 10:00:00 AM,48,-122,48,88,136
7259,FremontBridge,08/01/2013 11:00:00 AM,48,-122,47,57,104
7260,FremontBridge,08/01/2013 12:00:00 PM,48,-122,41,56,97
7261,FremontBridge,08/01/2013 01:00:00 PM,48,-122,55,56,111
7262,FremontBridge,08/01/2013 02:00:00 PM,48,-122,56,55,111
7263,FremontBridge,08/01/2013 03:00:00 PM,48,-122,83,68,151
7264,FremontBridge,08/01/2013 04:00:00 PM,48,-122,156,89,245
7265,FremontBridge,08/01/2013 05:00:00 PM,48,-122,389,174,563
7266,FremontBridge,08/01/2013 06:00:00 PM,48,-122,240,163,403
7267,FremontBridge,08/01/2013 07:00:00 PM,48,-122,124,83,207
7268,FremontBridge,08/01/2013 08:00:00 PM,48,-122,77,58,135
7269,FremontBridge,08/01/2013 09:00:00 PM,48,-122,53,43,96
7270,FremontBridge,08/01/2013 10:00:00 PM,48,-122,31,21,52
7271,FremontBridge,08/01/2013 11:00:00 PM,48,-122,19,11,30
7272,FremontBridge,08/02/2013 12:00:00 AM,48,-122,10,1,11
7273,FremontBridge,08/02/2013 01:00:00 AM,48,-122,5,5,10
7274,FremontBridge,08/02/2013 02:00:00 AM,48,-122,8,5,13
7275,FremontBridge,08/02/2013 03:00:00 AM,48,-122,2,0,2
7276,FremontBridge,08/02/2013 04:00:00 AM,48,-122,4,6,10
7277,FremontBridge,08/02/2013 05:00:00 AM,48,-122,9,15,24
7278,FremontBridge,08/02/2013 06:00:00 AM,48,-122,31,78,109
7279,FremontBridge,08/02/2013 07:00:00 AM,48,-122,73,177,250
7280,FremontBridge,08/02/2013 08:00:00 AM,48,-122,113,239,352
7281,FremontBridge,08/02/2013 09:00:00 AM,48,-122,108,150,258
7282,FremontBridge,08/02/2013 10:00:00 AM,48,-122,52,75,127
7283,FremontBridge,08/02/2013 11:00:00 AM,48,-122,33,43,76
7284,FremontBridge,08/02/2013 12:00:00 PM,48,-122,29,28,57
7285,FremontBridge,08/02/2013 01:00:00 PM,48,-122,29,38,67
7286,FremontBridge,08/02/2013 02:00:00 PM,48,-122,42,22,64
7287,FremontBridge,08/02/2013 03:00:00 PM,48,-122,51,40,91
7288,FremontBridge,08/02/2013 04:00:00 PM,48,-122,121,66,187
7289,FremontBridge,08/02/2013 05:00:00 PM,48,-122,245,134,379
7290,FremontBridge,08/02/2013 06:00:00 PM,48,-122,147,102,249
7291,FremontBridge,08/02/2013 07:00:00 PM,48,-122,71,30,101
7292,FremontBridge,08/02/2013 08:00:00 PM,48,-122,34,20,54
7293,FremontBridge,08/02/2013 09:00:00 PM,48,-122,24,19,43
7294,FremontBridge,08/02/2013 10:00:00 PM,48,-122,14,8,22
7295,FremontBridge,08/02/2013 11:00:00 PM,48,-122,14,9,23
7296,FremontBridge,08/03/2013 12:00:00 AM,48,-122,17,3,20
7297,FremontBridge,08/03/2013 01:00:00 AM,48,-122,13,5,18
7298,FremontBridge,08/03/2013 02:00:00 AM,48,-122,10,2,12
7299,FremontBridge,08/03/2013 03:00:00 AM,48,-122,10,0,10
7300,FremontBridge,08/03/2013 04:00:00 AM,48,-122,1,1,2
7301,FremontBridge,08/03/2013 05:00:00 AM,48,-122,6,8,14
7302,FremontBridge,08/03/2013 06:00:00 AM,48,-122,11,13,24
7303,FremontBridge,08/03/2013 07:00:00 AM,48,-122,19,27,46
7304,FremontBridge,08/03/2013 08:00:00 AM,48,-122,30,46,76
7305,FremontBridge,08/03/2013 09:00:00 AM,48,-122,58,50,108
7306,FremontBridge,08/03/2013 10:00:00 AM,48,-122,52,62,114
7307,FremontBridge,08/03/2013 11:00:00 AM,48,-122,53,87,140
7308,FremontBridge,08/03/2013 12:00:00 PM,48,-122,56,120,176
7309,FremontBridge,08/03/2013 01:00:00 PM,48,-122,72,96,168
7310,FremontBridge,08/03/2013 02:00:00 PM,48,-122,81,102,183
7311,FremontBridge,08/03/2013 03:00:00 PM,48,-122,109,109,218
7312,FremontBridge,08/03/2013 04:00:00 PM,48,-122,91,105,196
7313,FremontBridge,08/03/2013 05:00:00 PM,48,-122,77,116,193
7314,FremontBridge,08/03/2013 06:00:00 PM,48,-122,67,94,161
7315,FremontBridge,08/03/2013 07:00:00 PM,48,-122,57,63,120
7316,FremontBridge,08/03/2013 08:00:00 PM,48,-122,37,48,85
7317,FremontBridge,08/03/2013 09:00:00 PM,48,-122,35,42,77
7318,FremontBridge,08/03/2013 10:00:00 PM,48,-122,34,19,53
7319,FremontBridge,08/03/2013 11:00:00 PM,48,-122,23,20,43
7320,FremontBridge,08/04/2013 12:00:00 AM,48,-122,13,12,25
7321,FremontBridge,08/04/2013 01:00:00 AM,48,-122,11,8,19
7322,FremontBridge,08/04/2013 02:00:00 AM,48,-122,9,2,11
7323,FremontBridge,08/04/2013 03:00:00 AM,48,-122,1,2,3
7324,FremontBridge,08/04/2013 04:00:00 AM,48,-122,2,9,11
7325,FremontBridge,08/04/2013 05:00:00 AM,48,-122,0,5,5
7326,FremontBridge,08/04/2013 06:00:00 AM,48,-122,8,10,18
7327,FremontBridge,08/04/2013 07:00:00 AM,48,-122,25,25,50
7328,FremontBridge,08/04/2013 08:00:00 AM,48,-122,21,52,73
7329,FremontBridge,08/04/2013 09:00:00 AM,48,-122,43,62,105
7330,FremontBridge,08/04/2013 10:00:00 AM,48,-122,87,64,151
7331,FremontBridge,08/04/2013 11:00:00 AM,48,-122,90,96,186
7332,FremontBridge,08/04/2013 12:00:00 PM,48,-122,78,99,177
7333,FremontBridge,08/04/2013 01:00:00 PM,48,-122,110,134,244
7334,FremontBridge,08/04/2013 02:00:00 PM,48,-122,111,117,228
7335,FremontBridge,08/04/2013 03:00:00 PM,48,-122,98,118,216
7336,FremontBridge,08/04/2013 04:00:00 PM,48,-122,86,112,198
7337,FremontBridge,08/04/2013 05:00:00 PM,48,-122,95,112,207
7338,FremontBridge,08/04/2013 06:00:00 PM,48,-122,59,88,147
7339,FremontBridge,08/04/2013 07:00:00 PM,48,-122,56,74,130
7340,FremontBridge,08/04/2013 08:00:00 PM,48,-122,45,73,118
7341,FremontBridge,08/04/2013 09:00:00 PM,48,-122,36,32,68
7342,FremontBridge,08/04/2013 10:00:00 PM,48,-122,21,24,45
7343,FremontBridge,08/04/2013 11:00:00 PM,48,-122,23,8,31
7344,FremontBridge,08/05/2013 12:00:00 AM,48,-122,8,14,22
7345,FremontBridge,08/05/2013 01:00:00 AM,48,-122,4,2,6
7346,FremontBridge,08/05/2013 02:00:00 AM,48,-122,4,0,4
7347,FremontBridge,08/05/2013 03:00:00 AM,48,-122,3,0,3
7348,FremontBridge,08/05/2013 04:00:00 AM,48,-122,3,4,7
7349,FremontBridge,08/05/2013 05:00:00 AM,48,-122,11,30,41
7350,FremontBridge,08/05/2013 06:00:00 AM,48,-122,48,108,156
7351,FremontBridge,08/05/2013 07:00:00 AM,48,-122,98,237,335
7352,FremontBridge,08/05/2013 08:00:00 AM,48,-122,155,367,522
7353,FremontBridge,08/05/2013 09:00:00 AM,48,-122,124,198,322
7354,FremontBridge,08/05/2013 10:00:00 AM,48,-122,57,98,155
7355,FremontBridge,08/05/2013 11:00:00 AM,48,-122,39,53,92
7356,FremontBridge,08/05/2013 12:00:00 PM,48,-122,59,43,102
7357,FremontBridge,08/05/2013 01:00:00 PM,48,-122,59,73,132
7358,FremontBridge,08/05/2013 02:00:00 PM,48,-122,80,62,142
7359,FremontBridge,08/05/2013 03:00:00 PM,48,-122,105,77,182
7360,FremontBridge,08/05/2013 04:00:00 PM,48,-122,186,154,340
7361,FremontBridge,08/05/2013 05:00:00 PM,48,-122,427,206,633
7362,FremontBridge,08/05/2013 06:00:00 PM,48,-122,352,167,519
7363,FremontBridge,08/05/2013 07:00:00 PM,48,-122,137,126,263
7364,FremontBridge,08/05/2013 08:00:00 PM,48,-122,83,82,165
7365,FremontBridge,08/05/2013 09:00:00 PM,48,-122,37,56,93
7366,FremontBridge,08/05/2013 10:00:00 PM,48,-122,35,19,54
7367,FremontBridge,08/05/2013 11:00:00 PM,48,-122,14,8,22
7368,FremontBridge,08/06/2013 12:00:00 AM,48,-122,9,7,16
7369,FremontBridge,08/06/2013 01:00:00 AM,48,-122,5,3,8
7370,FremontBridge,08/06/2013 02:00:00 AM,48,-122,2,3,5
7371,FremontBridge,08/06/2013 03:00:00 AM,48,-122,3,0,3
7372,FremontBridge,08/06/2013 04:00:00 AM,48,-122,2,7,9
7373,FremontBridge,08/06/2013 05:00:00 AM,48,-122,10,29,39
7374,FremontBridge,08/06/2013 06:00:00 AM,48,-122,55,120,175
7375,FremontBridge,08/06/2013 07:00:00 AM,48,-122,88,302,390
7376,FremontBridge,08/06/2013 08:00:00 AM,48,-122,185,417,602
7377,FremontBridge,08/06/2013 09:00:00 AM,48,-122,112,217,329
7378,FremontBridge,08/06/2013 10:00:00 AM,48,-122,53,89,142
7379,FremontBridge,08/06/2013 11:00:00 AM,48,-122,44,60,104
7380,FremontBridge,08/06/2013 12:00:00 PM,48,-122,56,53,109
7381,FremontBridge,08/06/2013 01:00:00 PM,48,-122,68,80,148
7382,FremontBridge,08/06/2013 02:00:00 PM,48,-122,74,54,128
7383,FremontBridge,08/06/2013 03:00:00 PM,48,-122,88,76,164
7384,FremontBridge,08/06/2013 04:00:00 PM,48,-122,216,127,343
7385,FremontBridge,08/06/2013 05:00:00 PM,48,-122,517,221,738
7386,FremontBridge,08/06/2013 06:00:00 PM,48,-122,326,199,525
7387,FremontBridge,08/06/2013 07:00:00 PM,48,-122,181,112,293
7388,FremontBridge,08/06/2013 08:00:00 PM,48,-122,64,84,148
7389,FremontBridge,08/06/2013 09:00:00 PM,48,-122,52,52,104
7390,FremontBridge,08/06/2013 10:00:00 PM,48,-122,30,21,51
7391,FremontBridge,08/06/2013 11:00:00 PM,48,-122,17,12,29
7392,FremontBridge,08/07/2013 12:00:00 AM,48,-122,13,9,22
7393,FremontBridge,08/07/2013 01:00:00 AM,48,-122,1,3,4
7394,FremontBridge,08/07/2013 02:00:00 AM,48,-122,2,33,35
7395,FremontBridge,08/07/2013 03:00:00 AM,48,-122,0,2,2
7396,FremontBridge,08/07/2013 04:00:00 AM,48,-122,3,11,14
7397,FremontBridge,08/07/2013 05:00:00 AM,48,-122,8,21,29
7398,FremontBridge,08/07/2013 06:00:00 AM,48,-122,59,112,171
7399,FremontBridge,08/07/2013 07:00:00 AM,48,-122,91,274,365
7400,FremontBridge,08/07/2013 08:00:00 AM,48,-122,162,377,539
7401,FremontBridge,08/07/2013 09:00:00 AM,48,-122,131,213,344
7402,FremontBridge,08/07/2013 10:00:00 AM,48,-122,65,74,139
7403,FremontBridge,08/07/2013 11:00:00 AM,48,-122,49,59,108
7404,FremontBridge,08/07/2013 12:00:00 PM,48,-122,55,63,118
7405,FremontBridge,08/07/2013 01:00:00 PM,48,-122,68,61,129
7406,FremontBridge,08/07/2013 02:00:00 PM,48,-122,51,65,116
7407,FremontBridge,08/07/2013 03:00:00 PM,48,-122,81,96,177
7408,FremontBridge,08/07/2013 04:00:00 PM,48,-122,206,118,324
7409,FremontBridge,08/07/2013 05:00:00 PM,48,-122,473,198,671
7410,FremontBridge,08/07/2013 06:00:00 PM,48,-122,335,177,512
7411,FremontBridge,08/07/2013 07:00:00 PM,48,-122,195,117,312
7412,FremontBridge,08/07/2013 08:00:00 PM,48,-122,108,91,199
7413,FremontBridge,08/07/2013 09:00:00 PM,48,-122,54,68,122
7414,FremontBridge,08/07/2013 10:00:00 PM,48,-122,32,28,60
7415,FremontBridge,08/07/2013 11:00:00 PM,48,-122,24,20,44
7416,FremontBridge,08/08/2013 12:00:00 AM,48,-122,10,7,17
7417,FremontBridge,08/08/2013 01:00:00 AM,48,-122,4,7,11
7418,FremontBridge,08/08/2013 02:00:00 AM,48,-122,3,3,6
7419,FremontBridge,08/08/2013 03:00:00 AM,48,-122,4,2,6
7420,FremontBridge,08/08/2013 04:00:00 AM,48,-122,0,4,4
7421,FremontBridge,08/08/2013 05:00:00 AM,48,-122,8,34,42
7422,FremontBridge,08/08/2013 06:00:00 AM,48,-122,47,119,166
7423,FremontBridge,08/08/2013 07:00:00 AM,48,-122,105,248,353
7424,FremontBridge,08/08/2013 08:00:00 AM,48,-122,145,343,488
7425,FremontBridge,08/08/2013 09:00:00 AM,48,-122,100,195,295
7426,FremontBridge,08/08/2013 10:00:00 AM,48,-122,64,80,144
7427,FremontBridge,08/08/2013 11:00:00 AM,48,-122,47,45,92
7428,FremontBridge,08/08/2013 12:00:00 PM,48,-122,52,70,122
7429,FremontBridge,08/08/2013 01:00:00 PM,48,-122,55,59,114
7430,FremontBridge,08/08/2013 02:00:00 PM,48,-122,63,75,138
7431,FremontBridge,08/08/2013 03:00:00 PM,48,-122,77,70,147
7432,FremontBridge,08/08/2013 04:00:00 PM,48,-122,200,129,329
7433,FremontBridge,08/08/2013 05:00:00 PM,48,-122,413,179,592
7434,FremontBridge,08/08/2013 06:00:00 PM,48,-122,334,166,500
7435,FremontBridge,08/08/2013 07:00:00 PM,48,-122,167,124,291
7436,FremontBridge,08/08/2013 08:00:00 PM,48,-122,99,84,183
7437,FremontBridge,08/08/2013 09:00:00 PM,48,-122,36,59,95
7438,FremontBridge,08/08/2013 10:00:00 PM,48,-122,44,38,82
7439,FremontBridge,08/08/2013 11:00:00 PM,48,-122,23,35,58
7440,FremontBridge,08/09/2013 12:00:00 AM,48,-122,6,10,16
7441,FremontBridge,08/09/2013 01:00:00 AM,48,-122,7,11,18
7442,FremontBridge,08/09/2013 02:00:00 AM,48,-122,3,10,13
7443,FremontBridge,08/09/2013 03:00:00 AM,48,-122,1,2,3
7444,FremontBridge,08/09/2013 04:00:00 AM,48,-122,0,5,5
7445,FremontBridge,08/09/2013 05:00:00 AM,48,-122,5,23,28
7446,FremontBridge,08/09/2013 06:00:00 AM,48,-122,39,96,135
7447,FremontBridge,08/09/2013 07:00:00 AM,48,-122,75,191,266
7448,FremontBridge,08/09/2013 08:00:00 AM,48,-122,134,307,441
7449,FremontBridge,08/09/2013 09:00:00 AM,48,-122,113,171,284
7450,FremontBridge,08/09/2013 10:00:00 AM,48,-122,64,77,141
7451,FremontBridge,08/09/2013 11:00:00 AM,48,-122,54,59,113
7452,FremontBridge,08/09/2013 12:00:00 PM,48,-122,74,67,141
7453,FremontBridge,08/09/2013 01:00:00 PM,48,-122,63,63,126
7454,FremontBridge,08/09/2013 02:00:00 PM,48,-122,87,67,154
7455,FremontBridge,08/09/2013 03:00:00 PM,48,-122,119,85,204
7456,FremontBridge,08/09/2013 04:00:00 PM,48,-122,203,113,316
7457,FremontBridge,08/09/2013 05:00:00 PM,48,-122,367,177,544
7458,FremontBridge,08/09/2013 06:00:00 PM,48,-122,207,149,356
7459,FremontBridge,08/09/2013 07:00:00 PM,48,-122,108,91,199
7460,FremontBridge,08/09/2013 08:00:00 PM,48,-122,80,56,136
7461,FremontBridge,08/09/2013 09:00:00 PM,48,-122,45,35,80
7462,FremontBridge,08/09/2013 10:00:00 PM,48,-122,36,31,67
7463,FremontBridge,08/09/2013 11:00:00 PM,48,-122,34,13,47
7464,FremontBridge,08/10/2013 12:00:00 AM,48,-122,20,16,36
7465,FremontBridge,08/10/2013 01:00:00 AM,48,-122,10,17,27
7466,FremontBridge,08/10/2013 02:00:00 AM,48,-122,4,4,8
7467,FremontBridge,08/10/2013 03:00:00 AM,48,-122,1,2,3
7468,FremontBridge,08/10/2013 04:00:00 AM,48,-122,2,2,4
7469,FremontBridge,08/10/2013 05:00:00 AM,48,-122,3,7,10
7470,FremontBridge,08/10/2013 06:00:00 AM,48,-122,19,16,35
7471,FremontBridge,08/10/2013 07:00:00 AM,48,-122,19,22,41
7472,FremontBridge,08/10/2013 08:00:00 AM,48,-122,35,40,75
7473,FremontBridge,08/10/2013 09:00:00 AM,48,-122,45,48,93
7474,FremontBridge,08/10/2013 10:00:00 AM,48,-122,55,77,132
7475,FremontBridge,08/10/2013 11:00:00 AM,48,-122,43,69,112
7476,FremontBridge,08/10/2013 12:00:00 PM,48,-122,55,72,127
7477,FremontBridge,08/10/2013 01:00:00 PM,48,-122,70,70,140
7478,FremontBridge,08/10/2013 02:00:00 PM,48,-122,72,84,156
7479,FremontBridge,08/10/2013 03:00:00 PM,48,-122,103,91,194
7480,FremontBridge,08/10/2013 04:00:00 PM,48,-122,80,89,169
7481,FremontBridge,08/10/2013 05:00:00 PM,48,-122,61,90,151
7482,FremontBridge,08/10/2013 06:00:00 PM,48,-122,63,57,120
7483,FremontBridge,08/10/2013 07:00:00 PM,48,-122,47,39,86
7484,FremontBridge,08/10/2013 08:00:00 PM,48,-122,37,28,65
7485,FremontBridge,08/10/2013 09:00:00 PM,48,-122,20,17,37
7486,FremontBridge,08/10/2013 10:00:00 PM,48,-122,30,13,43
7487,FremontBridge,08/10/2013 11:00:00 PM,48,-122,18,15,33
7488,FremontBridge,08/11/2013 12:00:00 AM,48,-122,15,12,27
7489,FremontBridge,08/11/2013 01:00:00 AM,48,-122,8,5,13
7490,FremontBridge,08/11/2013 02:00:00 AM,48,-122,6,3,9
7491,FremontBridge,08/11/2013 03:00:00 AM,48,-122,0,0,0
7492,FremontBridge,08/11/2013 04:00:00 AM,48,-122,1,3,4
7493,FremontBridge,08/11/2013 05:00:00 AM,48,-122,0,6,6
7494,FremontBridge,08/11/2013 06:00:00 AM,48,-122,8,9,17
7495,FremontBridge,08/11/2013 07:00:00 AM,48,-122,12,30,42
7496,FremontBridge,08/11/2013 08:00:00 AM,48,-122,29,42,71
7497,FremontBridge,08/11/2013 09:00:00 AM,48,-122,54,83,137
7498,FremontBridge,08/11/2013 10:00:00 AM,48,-122,90,71,161
7499,FremontBridge,08/11/2013 11:00:00 AM,48,-122,75,120,195
7500,FremontBridge,08/11/2013 12:00:00 PM,48,-122,97,116,213
7501,FremontBridge,08/11/2013 01:00:00 PM,48,-122,68,110,178
7502,FremontBridge,08/11/2013 02:00:00 PM,48,-122,93,98,191
7503,FremontBridge,08/11/2013 03:00:00 PM,48,-122,99,116,215
7504,FremontBridge,08/11/2013 04:00:00 PM,48,-122,87,129,216
7505,FremontBridge,08/11/2013 05:00:00 PM,48,-122,83,101,184
7506,FremontBridge,08/11/2013 06:00:00 PM,48,-122,57,87,144
7507,FremontBridge,08/11/2013 07:00:00 PM,48,-122,73,44,117
7508,FremontBridge,08/11/2013 08:00:00 PM,48,-122,33,41,74
7509,FremontBridge,08/11/2013 09:00:00 PM,48,-122,30,23,53
7510,FremontBridge,08/11/2013 10:00:00 PM,48,-122,17,18,35
7511,FremontBridge,08/11/2013 11:00:00 PM,48,-122,11,2,13
7512,FremontBridge,08/12/2013 12:00:00 AM,48,-122,5,7,12
7513,FremontBridge,08/12/2013 01:00:00 AM,48,-122,4,5,9
7514,FremontBridge,08/12/2013 02:00:00 AM,48,-122,2,2,4
7515,FremontBridge,08/12/2013 03:00:00 AM,48,-122,0,0,0
7516,FremontBridge,08/12/2013 04:00:00 AM,48,-122,2,11,13
7517,FremontBridge,08/12/2013 05:00:00 AM,48,-122,6,24,30
7518,FremontBridge,08/12/2013 06:00:00 AM,48,-122,47,102,149
7519,FremontBridge,08/12/2013 07:00:00 AM,48,-122,90,255,345
7520,FremontBridge,08/12/2013 08:00:00 AM,48,-122,140,348,488
7521,FremontBridge,08/12/2013 09:00:00 AM,48,-122,107,208,315
7522,FremontBridge,08/12/2013 10:00:00 AM,48,-122,50,64,114
7523,FremontBridge,08/12/2013 11:00:00 AM,48,-122,45,48,93
7524,FremontBridge,08/12/2013 12:00:00 PM,48,-122,70,44,114
7525,FremontBridge,08/12/2013 01:00:00 PM,48,-122,44,52,96
7526,FremontBridge,08/12/2013 02:00:00 PM,48,-122,61,65,126
7527,FremontBridge,08/12/2013 03:00:00 PM,48,-122,74,92,166
7528,FremontBridge,08/12/2013 04:00:00 PM,48,-122,198,124,322
7529,FremontBridge,08/12/2013 05:00:00 PM,48,-122,419,184,603
7530,FremontBridge,08/12/2013 06:00:00 PM,48,-122,306,174,480
7531,FremontBridge,08/12/2013 07:00:00 PM,48,-122,164,86,250
7532,FremontBridge,08/12/2013 08:00:00 PM,48,-122,66,68,134
7533,FremontBridge,08/12/2013 09:00:00 PM,48,-122,47,38,85
7534,FremontBridge,08/12/2013 10:00:00 PM,48,-122,25,23,48
7535,FremontBridge,08/12/2013 11:00:00 PM,48,-122,17,15,32
7536,FremontBridge,08/13/2013 12:00:00 AM,48,-122,10,6,16
7537,FremontBridge,08/13/2013 01:00:00 AM,48,-122,6,2,8
7538,FremontBridge,08/13/2013 02:00:00 AM,48,-122,3,2,5
7539,FremontBridge,08/13/2013 03:00:00 AM,48,-122,0,0,0
7540,FremontBridge,08/13/2013 04:00:00 AM,48,-122,3,5,8
7541,FremontBridge,08/13/2013 05:00:00 AM,48,-122,10,20,30
7542,FremontBridge,08/13/2013 06:00:00 AM,48,-122,42,125,167
7543,FremontBridge,08/13/2013 07:00:00 AM,48,-122,104,303,407
7544,FremontBridge,08/13/2013 08:00:00 AM,48,-122,160,354,514
7545,FremontBridge,08/13/2013 09:00:00 AM,48,-122,134,191,325
7546,FremontBridge,08/13/2013 10:00:00 AM,48,-122,68,86,154
7547,FremontBridge,08/13/2013 11:00:00 AM,48,-122,44,66,110
7548,FremontBridge,08/13/2013 12:00:00 PM,48,-122,46,66,112
7549,FremontBridge,08/13/2013 01:00:00 PM,48,-122,57,53,110
7550,FremontBridge,08/13/2013 02:00:00 PM,48,-122,65,61,126
7551,FremontBridge,08/13/2013 03:00:00 PM,48,-122,90,94,184
7552,FremontBridge,08/13/2013 04:00:00 PM,48,-122,216,121,337
7553,FremontBridge,08/13/2013 05:00:00 PM,48,-122,483,196,679
7554,FremontBridge,08/13/2013 06:00:00 PM,48,-122,339,161,500
7555,FremontBridge,08/13/2013 07:00:00 PM,48,-122,170,126,296
7556,FremontBridge,08/13/2013 08:00:00 PM,48,-122,90,101,191
7557,FremontBridge,08/13/2013 09:00:00 PM,48,-122,47,50,97
7558,FremontBridge,08/13/2013 10:00:00 PM,48,-122,35,25,60
7559,FremontBridge,08/13/2013 11:00:00 PM,48,-122,18,15,33
7560,FremontBridge,08/14/2013 12:00:00 AM,48,-122,6,7,13
7561,FremontBridge,08/14/2013 01:00:00 AM,48,-122,4,3,7
7562,FremontBridge,08/14/2013 02:00:00 AM,48,-122,0,2,2
7563,FremontBridge,08/14/2013 03:00:00 AM,48,-122,0,0,0
7564,FremontBridge,08/14/2013 04:00:00 AM,48,-122,1,3,4
7565,FremontBridge,08/14/2013 05:00:00 AM,48,-122,9,29,38
7566,FremontBridge,08/14/2013 06:00:00 AM,48,-122,47,100,147
7567,FremontBridge,08/14/2013 07:00:00 AM,48,-122,96,272,368
7568,FremontBridge,08/14/2013 08:00:00 AM,48,-122,155,390,545
7569,FremontBridge,08/14/2013 09:00:00 AM,48,-122,130,220,350
7570,FremontBridge,08/14/2013 10:00:00 AM,48,-122,73,74,147
7571,FremontBridge,08/14/2013 11:00:00 AM,48,-122,49,75,124
7572,FremontBridge,08/14/2013 12:00:00 PM,48,-122,60,56,116
7573,FremontBridge,08/14/2013 01:00:00 PM,48,-122,65,51,116
7574,FremontBridge,08/14/2013 02:00:00 PM,48,-122,63,72,135
7575,FremontBridge,08/14/2013 03:00:00 PM,48,-122,97,83,180
7576,FremontBridge,08/14/2013 04:00:00 PM,48,-122,161,121,282
7577,FremontBridge,08/14/2013 05:00:00 PM,48,-122,436,198,634
7578,FremontBridge,08/14/2013 06:00:00 PM,48,-122,314,157,471
7579,FremontBridge,08/14/2013 07:00:00 PM,48,-122,131,119,250
7580,FremontBridge,08/14/2013 08:00:00 PM,48,-122,78,55,133
7581,FremontBridge,08/14/2013 09:00:00 PM,48,-122,26,26,52
7582,FremontBridge,08/14/2013 10:00:00 PM,48,-122,21,16,37
7583,FremontBridge,08/14/2013 11:00:00 PM,48,-122,15,5,20
7584,FremontBridge,08/15/2013 12:00:00 AM,48,-122,6,13,19
7585,FremontBridge,08/15/2013 01:00:00 AM,48,-122,4,5,9
7586,FremontBridge,08/15/2013 02:00:00 AM,48,-122,5,3,8
7587,FremontBridge,08/15/2013 03:00:00 AM,48,-122,2,2,4
7588,FremontBridge,08/15/2013 04:00:00 AM,48,-122,0,4,4
7589,FremontBridge,08/15/2013 05:00:00 AM,48,-122,8,26,34
7590,FremontBridge,08/15/2013 06:00:00 AM,48,-122,45,88,133
7591,FremontBridge,08/15/2013 07:00:00 AM,48,-122,80,207,287
7592,FremontBridge,08/15/2013 08:00:00 AM,48,-122,136,316,452
7593,FremontBridge,08/15/2013 09:00:00 AM,48,-122,88,181,269
7594,FremontBridge,08/15/2013 10:00:00 AM,48,-122,54,75,129
7595,FremontBridge,08/15/2013 11:00:00 AM,48,-122,34,56,90
7596,FremontBridge,08/15/2013 12:00:00 PM,48,-122,33,40,73
7597,FremontBridge,08/15/2013 01:00:00 PM,48,-122,36,35,71
7598,FremontBridge,08/15/2013 02:00:00 PM,48,-122,48,40,88
7599,FremontBridge,08/15/2013 03:00:00 PM,48,-122,47,50,97
7600,FremontBridge,08/15/2013 04:00:00 PM,48,-122,137,78,215
7601,FremontBridge,08/15/2013 05:00:00 PM,48,-122,363,122,485
7602,FremontBridge,08/15/2013 06:00:00 PM,48,-122,250,143,393
7603,FremontBridge,08/15/2013 07:00:00 PM,48,-122,135,64,199
7604,FremontBridge,08/15/2013 08:00:00 PM,48,-122,73,61,134
7605,FremontBridge,08/15/2013 09:00:00 PM,48,-122,28,37,65
7606,FremontBridge,08/15/2013 10:00:00 PM,48,-122,18,23,41
7607,FremontBridge,08/15/2013 11:00:00 PM,48,-122,15,20,35
7608,FremontBridge,08/16/2013 12:00:00 AM,48,-122,13,8,21
7609,FremontBridge,08/16/2013 01:00:00 AM,48,-122,6,4,10
7610,FremontBridge,08/16/2013 02:00:00 AM,48,-122,7,1,8
7611,FremontBridge,08/16/2013 03:00:00 AM,48,-122,3,2,5
7612,FremontBridge,08/16/2013 04:00:00 AM,48,-122,0,5,5
7613,FremontBridge,08/16/2013 05:00:00 AM,48,-122,13,10,23
7614,FremontBridge,08/16/2013 06:00:00 AM,48,-122,52,85,137
7615,FremontBridge,08/16/2013 07:00:00 AM,48,-122,75,194,269
7616,FremontBridge,08/16/2013 08:00:00 AM,48,-122,132,289,421
7617,FremontBridge,08/16/2013 09:00:00 AM,48,-122,102,180,282
7618,FremontBridge,08/16/2013 10:00:00 AM,48,-122,72,70,142
7619,FremontBridge,08/16/2013 11:00:00 AM,48,-122,43,59,102
7620,FremontBridge,08/16/2013 12:00:00 PM,48,-122,59,61,120
7621,FremontBridge,08/16/2013 01:00:00 PM,48,-122,76,60,136
7622,FremontBridge,08/16/2013 02:00:00 PM,48,-122,60,82,142
7623,FremontBridge,08/16/2013 03:00:00 PM,48,-122,111,87,198
7624,FremontBridge,08/16/2013 04:00:00 PM,48,-122,191,119,310
7625,FremontBridge,08/16/2013 05:00:00 PM,48,-122,368,182,550
7626,FremontBridge,08/16/2013 06:00:00 PM,48,-122,242,168,410
7627,FremontBridge,08/16/2013 07:00:00 PM,48,-122,118,91,209
7628,FremontBridge,08/16/2013 08:00:00 PM,48,-122,84,59,143
7629,FremontBridge,08/16/2013 09:00:00 PM,48,-122,48,32,80
7630,FremontBridge,08/16/2013 10:00:00 PM,48,-122,28,18,46
7631,FremontBridge,08/16/2013 11:00:00 PM,48,-122,30,20,50
7632,FremontBridge,08/17/2013 12:00:00 AM,48,-122,16,12,28
7633,FremontBridge,08/17/2013 01:00:00 AM,48,-122,19,12,31
7634,FremontBridge,08/17/2013 02:00:00 AM,48,-122,7,9,16
7635,FremontBridge,08/17/2013 03:00:00 AM,48,-122,4,1,5
7636,FremontBridge,08/17/2013 04:00:00 AM,48,-122,5,3,8
7637,FremontBridge,08/17/2013 05:00:00 AM,48,-122,11,7,18
7638,FremontBridge,08/17/2013 06:00:00 AM,48,-122,29,21,50
7639,FremontBridge,08/17/2013 07:00:00 AM,48,-122,16,29,45
7640,FremontBridge,08/17/2013 08:00:00 AM,48,-122,48,41,89
7641,FremontBridge,08/17/2013 09:00:00 AM,48,-122,81,53,134
7642,FremontBridge,08/17/2013 10:00:00 AM,48,-122,52,92,144
7643,FremontBridge,08/17/2013 11:00:00 AM,48,-122,62,90,152
7644,FremontBridge,08/17/2013 12:00:00 PM,48,-122,76,89,165
7645,FremontBridge,08/17/2013 01:00:00 PM,48,-122,81,78,159
7646,FremontBridge,08/17/2013 02:00:00 PM,48,-122,82,87,169
7647,FremontBridge,08/17/2013 03:00:00 PM,48,-122,78,109,187
7648,FremontBridge,08/17/2013 04:00:00 PM,48,-122,91,106,197
7649,FremontBridge,08/17/2013 05:00:00 PM,48,-122,72,80,152
7650,FremontBridge,08/17/2013 06:00:00 PM,48,-122,67,64,131
7651,FremontBridge,08/17/2013 07:00:00 PM,48,-122,52,52,104
7652,FremontBridge,08/17/2013 08:00:00 PM,48,-122,50,53,103
7653,FremontBridge,08/17/2013 09:00:00 PM,48,-122,33,15,48
7654,FremontBridge,08/17/2013 10:00:00 PM,48,-122,33,26,59
7655,FremontBridge,08/17/2013 11:00:00 PM,48,-122,12,13,25
7656,FremontBridge,08/18/2013 12:00:00 AM,48,-122,11,10,21
7657,FremontBridge,08/18/2013 01:00:00 AM,48,-122,6,10,16
7658,FremontBridge,08/18/2013 02:00:00 AM,48,-122,5,1,6
7659,FremontBridge,08/18/2013 03:00:00 AM,48,-122,1,3,4
7660,FremontBridge,08/18/2013 04:00:00 AM,48,-122,4,2,6
7661,FremontBridge,08/18/2013 05:00:00 AM,48,-122,1,12,13
7662,FremontBridge,08/18/2013 06:00:00 AM,48,-122,11,13,24
7663,FremontBridge,08/18/2013 07:00:00 AM,48,-122,21,24,45
7664,FremontBridge,08/18/2013 08:00:00 AM,48,-122,20,45,65
7665,FremontBridge,08/18/2013 09:00:00 AM,48,-122,46,53,99
7666,FremontBridge,08/18/2013 10:00:00 AM,48,-122,81,103,184
7667,FremontBridge,08/18/2013 11:00:00 AM,48,-122,67,80,147
7668,FremontBridge,08/18/2013 12:00:00 PM,48,-122,92,125,217
7669,FremontBridge,08/18/2013 01:00:00 PM,48,-122,76,106,182
7670,FremontBridge,08/18/2013 02:00:00 PM,48,-122,111,131,242
7671,FremontBridge,08/18/2013 03:00:00 PM,48,-122,81,123,204
7672,FremontBridge,08/18/2013 04:00:00 PM,48,-122,99,112,211
7673,FremontBridge,08/18/2013 05:00:00 PM,48,-122,100,91,191
7674,FremontBridge,08/18/2013 06:00:00 PM,48,-122,60,98,158
7675,FremontBridge,08/18/2013 07:00:00 PM,48,-122,62,53,115
7676,FremontBridge,08/18/2013 08:00:00 PM,48,-122,30,28,58
7677,FremontBridge,08/18/2013 09:00:00 PM,48,-122,20,20,40
7678,FremontBridge,08/18/2013 10:00:00 PM,48,-122,17,15,32
7679,FremontBridge,08/18/2013 11:00:00 PM,48,-122,15,6,21
7680,FremontBridge,08/19/2013 12:00:00 AM,48,-122,16,7,23
7681,FremontBridge,08/19/2013 01:00:00 AM,48,-122,3,3,6
7682,FremontBridge,08/19/2013 02:00:00 AM,48,-122,3,2,5
7683,FremontBridge,08/19/2013 03:00:00 AM,48,-122,0,0,0
7684,FremontBridge,08/19/2013 04:00:00 AM,48,-122,3,3,6
7685,FremontBridge,08/19/2013 05:00:00 AM,48,-122,9,24,33
7686,FremontBridge,08/19/2013 06:00:00 AM,48,-122,42,101,143
7687,FremontBridge,08/19/2013 07:00:00 AM,48,-122,92,274,366
7688,FremontBridge,08/19/2013 08:00:00 AM,48,-122,152,342,494
7689,FremontBridge,08/19/2013 09:00:00 AM,48,-122,100,189,289
7690,FremontBridge,08/19/2013 10:00:00 AM,48,-122,54,89,143
7691,FremontBridge,08/19/2013 11:00:00 AM,48,-122,38,39,77
7692,FremontBridge,08/19/2013 12:00:00 PM,48,-122,52,46,98
7693,FremontBridge,08/19/2013 01:00:00 PM,48,-122,64,69,133
7694,FremontBridge,08/19/2013 02:00:00 PM,48,-122,77,72,149
7695,FremontBridge,08/19/2013 03:00:00 PM,48,-122,86,71,157
7696,FremontBridge,08/19/2013 04:00:00 PM,48,-122,174,116,290
7697,FremontBridge,08/19/2013 05:00:00 PM,48,-122,471,172,643
7698,FremontBridge,08/19/2013 06:00:00 PM,48,-122,380,171,551
7699,FremontBridge,08/19/2013 07:00:00 PM,48,-122,129,99,228
7700,FremontBridge,08/19/2013 08:00:00 PM,48,-122,67,54,121
7701,FremontBridge,08/19/2013 09:00:00 PM,48,-122,46,33,79
7702,FremontBridge,08/19/2013 10:00:00 PM,48,-122,29,24,53
7703,FremontBridge,08/19/2013 11:00:00 PM,48,-122,18,12,30
7704,FremontBridge,08/20/2013 12:00:00 AM,48,-122,6,7,13
7705,FremontBridge,08/20/2013 01:00:00 AM,48,-122,9,1,10
7706,FremontBridge,08/20/2013 02:00:00 AM,48,-122,7,4,11
7707,FremontBridge,08/20/2013 03:00:00 AM,48,-122,1,1,2
7708,FremontBridge,08/20/2013 04:00:00 AM,48,-122,2,7,9
7709,FremontBridge,08/20/2013 05:00:00 AM,48,-122,5,23,28
7710,FremontBridge,08/20/2013 06:00:00 AM,48,-122,46,105,151
7711,FremontBridge,08/20/2013 07:00:00 AM,48,-122,120,262,382
7712,FremontBridge,08/20/2013 08:00:00 AM,48,-122,167,398,565
7713,FremontBridge,08/20/2013 09:00:00 AM,48,-122,115,175,290
7714,FremontBridge,08/20/2013 10:00:00 AM,48,-122,79,75,154
7715,FremontBridge,08/20/2013 11:00:00 AM,48,-122,38,57,95
7716,FremontBridge,08/20/2013 12:00:00 PM,48,-122,52,61,113
7717,FremontBridge,08/20/2013 01:00:00 PM,48,-122,63,68,131
7718,FremontBridge,08/20/2013 02:00:00 PM,48,-122,58,50,108
7719,FremontBridge,08/20/2013 03:00:00 PM,48,-122,82,72,154
7720,FremontBridge,08/20/2013 04:00:00 PM,48,-122,190,113,303
7721,FremontBridge,08/20/2013 05:00:00 PM,48,-122,462,180,642
7722,FremontBridge,08/20/2013 06:00:00 PM,48,-122,387,226,613
7723,FremontBridge,08/20/2013 07:00:00 PM,48,-122,169,132,301
7724,FremontBridge,08/20/2013 08:00:00 PM,48,-122,98,94,192
7725,FremontBridge,08/20/2013 09:00:00 PM,48,-122,102,41,143
7726,FremontBridge,08/20/2013 10:00:00 PM,48,-122,41,29,70
7727,FremontBridge,08/20/2013 11:00:00 PM,48,-122,30,14,44
7728,FremontBridge,08/21/2013 12:00:00 AM,48,-122,11,12,23
7729,FremontBridge,08/21/2013 01:00:00 AM,48,-122,1,4,5
7730,FremontBridge,08/21/2013 02:00:00 AM,48,-122,5,9,14
7731,FremontBridge,08/21/2013 03:00:00 AM,48,-122,1,3,4
7732,FremontBridge,08/21/2013 04:00:00 AM,48,-122,2,3,5
7733,FremontBridge,08/21/2013 05:00:00 AM,48,-122,5,32,37
7734,FremontBridge,08/21/2013 06:00:00 AM,48,-122,47,105,152
7735,FremontBridge,08/21/2013 07:00:00 AM,48,-122,109,259,368
7736,FremontBridge,08/21/2013 08:00:00 AM,48,-122,151,380,531
7737,FremontBridge,08/21/2013 09:00:00 AM,48,-122,102,209,311
7738,FremontBridge,08/21/2013 10:00:00 AM,48,-122,73,79,152
7739,FremontBridge,08/21/2013 11:00:00 AM,48,-122,46,60,106
7740,FremontBridge,08/21/2013 12:00:00 PM,48,-122,50,73,123
7741,FremontBridge,08/21/2013 01:00:00 PM,48,-122,79,64,143
7742,FremontBridge,08/21/2013 02:00:00 PM,48,-122,77,57,134
7743,FremontBridge,08/21/2013 03:00:00 PM,48,-122,104,67,171
7744,FremontBridge,08/21/2013 04:00:00 PM,48,-122,198,128,326
7745,FremontBridge,08/21/2013 05:00:00 PM,48,-122,430,175,605
7746,FremontBridge,08/21/2013 06:00:00 PM,48,-122,367,190,557
7747,FremontBridge,08/21/2013 07:00:00 PM,48,-122,161,107,268
7748,FremontBridge,08/21/2013 08:00:00 PM,48,-122,84,72,156
7749,FremontBridge,08/21/2013 09:00:00 PM,48,-122,72,42,114
7750,FremontBridge,08/21/2013 10:00:00 PM,48,-122,28,20,48
7751,FremontBridge,08/21/2013 11:00:00 PM,48,-122,20,19,39
7752,FremontBridge,08/22/2013 12:00:00 AM,48,-122,16,8,24
7753,FremontBridge,08/22/2013 01:00:00 AM,48,-122,2,8,10
7754,FremontBridge,08/22/2013 02:00:00 AM,48,-122,4,3,7
7755,FremontBridge,08/22/2013 03:00:00 AM,48,-122,1,2,3
7756,FremontBridge,08/22/2013 04:00:00 AM,48,-122,4,6,10
7757,FremontBridge,08/22/2013 05:00:00 AM,48,-122,13,20,33
7758,FremontBridge,08/22/2013 06:00:00 AM,48,-122,35,99,134
7759,FremontBridge,08/22/2013 07:00:00 AM,48,-122,100,254,354
7760,FremontBridge,08/22/2013 08:00:00 AM,48,-122,143,328,471
7761,FremontBridge,08/22/2013 09:00:00 AM,48,-122,102,207,309
7762,FremontBridge,08/22/2013 10:00:00 AM,48,-122,52,103,155
7763,FremontBridge,08/22/2013 11:00:00 AM,48,-122,49,79,128
7764,FremontBridge,08/22/2013 12:00:00 PM,48,-122,40,70,110
7765,FremontBridge,08/22/2013 01:00:00 PM,48,-122,62,71,133
7766,FremontBridge,08/22/2013 02:00:00 PM,48,-122,59,67,126
7767,FremontBridge,08/22/2013 03:00:00 PM,48,-122,92,57,149
7768,FremontBridge,08/22/2013 04:00:00 PM,48,-122,205,111,316
7769,FremontBridge,08/22/2013 05:00:00 PM,48,-122,429,182,611
7770,FremontBridge,08/22/2013 06:00:00 PM,48,-122,309,173,482
7771,FremontBridge,08/22/2013 07:00:00 PM,48,-122,158,99,257
7772,FremontBridge,08/22/2013 08:00:00 PM,48,-122,82,72,154
7773,FremontBridge,08/22/2013 09:00:00 PM,48,-122,40,54,94
7774,FremontBridge,08/22/2013 10:00:00 PM,48,-122,16,34,50
7775,FremontBridge,08/22/2013 11:00:00 PM,48,-122,29,21,50
7776,FremontBridge,08/23/2013 12:00:00 AM,48,-122,7,14,21
7777,FremontBridge,08/23/2013 01:00:00 AM,48,-122,9,4,13
7778,FremontBridge,08/23/2013 02:00:00 AM,48,-122,5,0,5
7779,FremontBridge,08/23/2013 03:00:00 AM,48,-122,1,4,5
7780,FremontBridge,08/23/2013 04:00:00 AM,48,-122,0,7,7
7781,FremontBridge,08/23/2013 05:00:00 AM,48,-122,11,13,24
7782,FremontBridge,08/23/2013 06:00:00 AM,48,-122,46,78,124
7783,FremontBridge,08/23/2013 07:00:00 AM,48,-122,65,192,257
7784,FremontBridge,08/23/2013 08:00:00 AM,48,-122,120,279,399
7785,FremontBridge,08/23/2013 09:00:00 AM,48,-122,90,169,259
7786,FremontBridge,08/23/2013 10:00:00 AM,48,-122,74,79,153
7787,FremontBridge,08/23/2013 11:00:00 AM,48,-122,52,72,124
7788,FremontBridge,08/23/2013 12:00:00 PM,48,-122,48,50,98
7789,FremontBridge,08/23/2013 01:00:00 PM,48,-122,56,66,122
7790,FremontBridge,08/23/2013 02:00:00 PM,48,-122,68,62,130
7791,FremontBridge,08/23/2013 03:00:00 PM,48,-122,105,77,182
7792,FremontBridge,08/23/2013 04:00:00 PM,48,-122,176,94,270
7793,FremontBridge,08/23/2013 05:00:00 PM,48,-122,331,153,484
7794,FremontBridge,08/23/2013 06:00:00 PM,48,-122,207,124,331
7795,FremontBridge,08/23/2013 07:00:00 PM,48,-122,95,85,180
7796,FremontBridge,08/23/2013 08:00:00 PM,48,-122,60,39,99
7797,FremontBridge,08/23/2013 09:00:00 PM,48,-122,42,26,68
7798,FremontBridge,08/23/2013 10:00:00 PM,48,-122,28,18,46
7799,FremontBridge,08/23/2013 11:00:00 PM,48,-122,25,20,45
7800,FremontBridge,08/24/2013 12:00:00 AM,48,-122,18,16,34
7801,FremontBridge,08/24/2013 01:00:00 AM,48,-122,16,6,22
7802,FremontBridge,08/24/2013 02:00:00 AM,48,-122,8,8,16
7803,FremontBridge,08/24/2013 03:00:00 AM,48,-122,2,5,7
7804,FremontBridge,08/24/2013 04:00:00 AM,48,-122,1,7,8
7805,FremontBridge,08/24/2013 05:00:00 AM,48,-122,1,7,8
7806,FremontBridge,08/24/2013 06:00:00 AM,48,-122,21,10,31
7807,FremontBridge,08/24/2013 07:00:00 AM,48,-122,28,32,60
7808,FremontBridge,08/24/2013 08:00:00 AM,48,-122,32,47,79
7809,FremontBridge,08/24/2013 09:00:00 AM,48,-122,58,67,125
7810,FremontBridge,08/24/2013 10:00:00 AM,48,-122,52,69,121
7811,FremontBridge,08/24/2013 11:00:00 AM,48,-122,55,70,125
7812,FremontBridge,08/24/2013 12:00:00 PM,48,-122,52,63,115
7813,FremontBridge,08/24/2013 01:00:00 PM,48,-122,92,98,190
7814,FremontBridge,08/24/2013 02:00:00 PM,48,-122,85,91,176
7815,FremontBridge,08/24/2013 03:00:00 PM,48,-122,83,93,176
7816,FremontBridge,08/24/2013 04:00:00 PM,48,-122,95,97,192
7817,FremontBridge,08/24/2013 05:00:00 PM,48,-122,80,69,149
7818,FremontBridge,08/24/2013 06:00:00 PM,48,-122,50,80,130
7819,FremontBridge,08/24/2013 07:00:00 PM,48,-122,38,43,81
7820,FremontBridge,08/24/2013 08:00:00 PM,48,-122,29,46,75
7821,FremontBridge,08/24/2013 09:00:00 PM,48,-122,19,17,36
7822,FremontBridge,08/24/2013 10:00:00 PM,48,-122,32,9,41
7823,FremontBridge,08/24/2013 11:00:00 PM,48,-122,22,11,33
7824,FremontBridge,08/25/2013 12:00:00 AM,48,-122,16,10,26
7825,FremontBridge,08/25/2013 01:00:00 AM,48,-122,9,4,13
7826,FremontBridge,08/25/2013 02:00:00 AM,48,-122,4,4,8
7827,FremontBridge,08/25/2013 03:00:00 AM,48,-122,4,4,8
7828,FremontBridge,08/25/2013 04:00:00 AM,48,-122,3,4,7
7829,FremontBridge,08/25/2013 05:00:00 AM,48,-122,3,8,11
7830,FremontBridge,08/25/2013 06:00:00 AM,48,-122,8,6,14
7831,FremontBridge,08/25/2013 07:00:00 AM,48,-122,11,9,20
7832,FremontBridge,08/25/2013 08:00:00 AM,48,-122,24,28,52
7833,FremontBridge,08/25/2013 09:00:00 AM,48,-122,39,59,98
7834,FremontBridge,08/25/2013 10:00:00 AM,48,-122,81,92,173
7835,FremontBridge,08/25/2013 11:00:00 AM,48,-122,86,78,164
7836,FremontBridge,08/25/2013 12:00:00 PM,48,-122,118,101,219
7837,FremontBridge,08/25/2013 01:00:00 PM,48,-122,90,132,222
7838,FremontBridge,08/25/2013 02:00:00 PM,48,-122,90,135,225
7839,FremontBridge,08/25/2013 03:00:00 PM,48,-122,76,119,195
7840,FremontBridge,08/25/2013 04:00:00 PM,48,-122,89,106,195
7841,FremontBridge,08/25/2013 05:00:00 PM,48,-122,44,75,119
7842,FremontBridge,08/25/2013 06:00:00 PM,48,-122,50,49,99
7843,FremontBridge,08/25/2013 07:00:00 PM,48,-122,23,24,47
7844,FremontBridge,08/25/2013 08:00:00 PM,48,-122,25,27,52
7845,FremontBridge,08/25/2013 09:00:00 PM,48,-122,23,8,31
7846,FremontBridge,08/25/2013 10:00:00 PM,48,-122,38,7,45
7847,FremontBridge,08/25/2013 11:00:00 PM,48,-122,14,2,16
7848,FremontBridge,08/26/2013 12:00:00 AM,48,-122,9,10,19
7849,FremontBridge,08/26/2013 01:00:00 AM,48,-122,4,3,7
7850,FremontBridge,08/26/2013 02:00:00 AM,48,-122,3,2,5
7851,FremontBridge,08/26/2013 03:00:00 AM,48,-122,3,0,3
7852,FremontBridge,08/26/2013 04:00:00 AM,48,-122,2,6,8
7853,FremontBridge,08/26/2013 05:00:00 AM,48,-122,10,24,34
7854,FremontBridge,08/26/2013 06:00:00 AM,48,-122,44,101,145
7855,FremontBridge,08/26/2013 07:00:00 AM,48,-122,81,212,293
7856,FremontBridge,08/26/2013 08:00:00 AM,48,-122,125,283,408
7857,FremontBridge,08/26/2013 09:00:00 AM,48,-122,102,165,267
7858,FremontBridge,08/26/2013 10:00:00 AM,48,-122,41,81,122
7859,FremontBridge,08/26/2013 11:00:00 AM,48,-122,42,40,82
7860,FremontBridge,08/26/2013 12:00:00 PM,48,-122,41,31,72
7861,FremontBridge,08/26/2013 01:00:00 PM,48,-122,42,54,96
7862,FremontBridge,08/26/2013 02:00:00 PM,48,-122,61,59,120
7863,FremontBridge,08/26/2013 03:00:00 PM,48,-122,79,73,152
7864,FremontBridge,08/26/2013 04:00:00 PM,48,-122,148,108,256
7865,FremontBridge,08/26/2013 05:00:00 PM,48,-122,332,150,482
7866,FremontBridge,08/26/2013 06:00:00 PM,48,-122,243,93,336
7867,FremontBridge,08/26/2013 07:00:00 PM,48,-122,84,60,144
7868,FremontBridge,08/26/2013 08:00:00 PM,48,-122,52,28,80
7869,FremontBridge,08/26/2013 09:00:00 PM,48,-122,29,27,56
7870,FremontBridge,08/26/2013 10:00:00 PM,48,-122,17,16,33
7871,FremontBridge,08/26/2013 11:00:00 PM,48,-122,13,7,20
7872,FremontBridge,08/27/2013 12:00:00 AM,48,-122,7,8,15
7873,FremontBridge,08/27/2013 01:00:00 AM,48,-122,1,8,9
7874,FremontBridge,08/27/2013 02:00:00 AM,48,-122,1,3,4
7875,FremontBridge,08/27/2013 03:00:00 AM,48,-122,3,0,3
7876,FremontBridge,08/27/2013 04:00:00 AM,48,-122,1,6,7
7877,FremontBridge,08/27/2013 05:00:00 AM,48,-122,6,23,29
7878,FremontBridge,08/27/2013 06:00:00 AM,48,-122,47,87,134
7879,FremontBridge,08/27/2013 07:00:00 AM,48,-122,98,237,335
7880,FremontBridge,08/27/2013 08:00:00 AM,48,-122,156,350,506
7881,FremontBridge,08/27/2013 09:00:00 AM,48,-122,109,195,304
7882,FremontBridge,08/27/2013 10:00:00 AM,48,-122,49,68,117
7883,FremontBridge,08/27/2013 11:00:00 AM,48,-122,52,45,97
7884,FremontBridge,08/27/2013 12:00:00 PM,48,-122,49,62,111
7885,FremontBridge,08/27/2013 01:00:00 PM,48,-122,50,71,121
7886,FremontBridge,08/27/2013 02:00:00 PM,48,-122,48,65,113
7887,FremontBridge,08/27/2013 03:00:00 PM,48,-122,73,82,155
7888,FremontBridge,08/27/2013 04:00:00 PM,48,-122,167,125,292
7889,FremontBridge,08/27/2013 05:00:00 PM,48,-122,407,158,565
7890,FremontBridge,08/27/2013 06:00:00 PM,48,-122,337,168,505
7891,FremontBridge,08/27/2013 07:00:00 PM,48,-122,142,78,220
7892,FremontBridge,08/27/2013 08:00:00 PM,48,-122,63,52,115
7893,FremontBridge,08/27/2013 09:00:00 PM,48,-122,33,34,67
7894,FremontBridge,08/27/2013 10:00:00 PM,48,-122,18,25,43
7895,FremontBridge,08/27/2013 11:00:00 PM,48,-122,12,13,25
7896,FremontBridge,08/28/2013 12:00:00 AM,48,-122,8,7,15
7897,FremontBridge,08/28/2013 01:00:00 AM,48,-122,2,4,6
7898,FremontBridge,08/28/2013 02:00:00 AM,48,-122,5,3,8
7899,FremontBridge,08/28/2013 03:00:00 AM,48,-122,1,3,4
7900,FremontBridge,08/28/2013 04:00:00 AM,48,-122,1,4,5
7901,FremontBridge,08/28/2013 05:00:00 AM,48,-122,9,15,24
7902,FremontBridge,08/28/2013 06:00:00 AM,48,-122,31,62,93
7903,FremontBridge,08/28/2013 07:00:00 AM,48,-122,70,201,271
7904,FremontBridge,08/28/2013 08:00:00 AM,48,-122,131,265,396
7905,FremontBridge,08/28/2013 09:00:00 AM,48,-122,88,173,261
7906,FremontBridge,08/28/2013 10:00:00 AM,48,-122,57,65,122
7907,FremontBridge,08/28/2013 11:00:00 AM,48,-122,49,49,98
7908,FremontBridge,08/28/2013 12:00:00 PM,48,-122,56,78,134
7909,FremontBridge,08/28/2013 01:00:00 PM,48,-122,49,54,103
7910,FremontBridge,08/28/2013 02:00:00 PM,48,-122,60,54,114
7911,FremontBridge,08/28/2013 03:00:00 PM,48,-122,72,66,138
7912,FremontBridge,08/28/2013 04:00:00 PM,48,-122,138,94,232
7913,FremontBridge,08/28/2013 05:00:00 PM,48,-122,325,169,494
7914,FremontBridge,08/28/2013 06:00:00 PM,48,-122,283,144,427
7915,FremontBridge,08/28/2013 07:00:00 PM,48,-122,143,98,241
7916,FremontBridge,08/28/2013 08:00:00 PM,48,-122,78,55,133
7917,FremontBridge,08/28/2013 09:00:00 PM,48,-122,34,53,87
7918,FremontBridge,08/28/2013 10:00:00 PM,48,-122,22,20,42
7919,FremontBridge,08/28/2013 11:00:00 PM,48,-122,21,15,36
7920,FremontBridge,08/29/2013 12:00:00 AM,48,-122,8,12,20
7921,FremontBridge,08/29/2013 01:00:00 AM,48,-122,8,8,16
7922,FremontBridge,08/29/2013 02:00:00 AM,48,-122,3,7,10
7923,FremontBridge,08/29/2013 03:00:00 AM,48,-122,2,1,3
7924,FremontBridge,08/29/2013 04:00:00 AM,48,-122,3,3,6
7925,FremontBridge,08/29/2013 05:00:00 AM,48,-122,7,16,23
7926,FremontBridge,08/29/2013 06:00:00 AM,48,-122,27,61,88
7927,FremontBridge,08/29/2013 07:00:00 AM,48,-122,58,183,241
7928,FremontBridge,08/29/2013 08:00:00 AM,48,-122,108,250,358
7929,FremontBridge,08/29/2013 09:00:00 AM,48,-122,71,119,190
7930,FremontBridge,08/29/2013 10:00:00 AM,48,-122,32,55,87
7931,FremontBridge,08/29/2013 11:00:00 AM,48,-122,26,21,47
7932,FremontBridge,08/29/2013 12:00:00 PM,48,-122,15,28,43
7933,FremontBridge,08/29/2013 01:00:00 PM,48,-122,27,26,53
7934,FremontBridge,08/29/2013 02:00:00 PM,48,-122,25,34,59
7935,FremontBridge,08/29/2013 03:00:00 PM,48,-122,45,48,93
7936,FremontBridge,08/29/2013 04:00:00 PM,48,-122,101,63,164
7937,FremontBridge,08/29/2013 05:00:00 PM,48,-122,246,101,347
7938,FremontBridge,08/29/2013 06:00:00 PM,48,-122,160,91,251
7939,FremontBridge,08/29/2013 07:00:00 PM,48,-122,78,39,117
7940,FremontBridge,08/29/2013 08:00:00 PM,48,-122,43,27,70
7941,FremontBridge,08/29/2013 09:00:00 PM,48,-122,26,14,40
7942,FremontBridge,08/29/2013 10:00:00 PM,48,-122,12,8,20
7943,FremontBridge,08/29/2013 11:00:00 PM,48,-122,14,15,29
7944,FremontBridge,08/30/2013 12:00:00 AM,48,-122,5,1,6
7945,FremontBridge,08/30/2013 01:00:00 AM,48,-122,5,2,7
7946,FremontBridge,08/30/2013 02:00:00 AM,48,-122,1,1,2
7947,FremontBridge,08/30/2013 03:00:00 AM,48,-122,3,0,3
7948,FremontBridge,08/30/2013 04:00:00 AM,48,-122,0,4,4
7949,FremontBridge,08/30/2013 05:00:00 AM,48,-122,9,13,22
7950,FremontBridge,08/30/2013 06:00:00 AM,48,-122,33,73,106
7951,FremontBridge,08/30/2013 07:00:00 AM,48,-122,69,196,265
7952,FremontBridge,08/30/2013 08:00:00 AM,48,-122,109,253,362
7953,FremontBridge,08/30/2013 09:00:00 AM,48,-122,98,144,242
7954,FremontBridge,08/30/2013 10:00:00 AM,48,-122,55,79,134
7955,FremontBridge,08/30/2013 11:00:00 AM,48,-122,44,72,116
7956,FremontBridge,08/30/2013 12:00:00 PM,48,-122,56,65,121
7957,FremontBridge,08/30/2013 01:00:00 PM,48,-122,61,71,132
7958,FremontBridge,08/30/2013 02:00:00 PM,48,-122,68,61,129
7959,FremontBridge,08/30/2013 03:00:00 PM,48,-122,122,80,202
7960,FremontBridge,08/30/2013 04:00:00 PM,48,-122,208,134,342
7961,FremontBridge,08/30/2013 05:00:00 PM,48,-122,283,153,436
7962,FremontBridge,08/30/2013 06:00:00 PM,48,-122,191,130,321
7963,FremontBridge,08/30/2013 07:00:00 PM,48,-122,112,73,185
7964,FremontBridge,08/30/2013 08:00:00 PM,48,-122,51,51,102
7965,FremontBridge,08/30/2013 09:00:00 PM,48,-122,41,29,70
7966,FremontBridge,08/30/2013 10:00:00 PM,48,-122,23,20,43
7967,FremontBridge,08/30/2013 11:00:00 PM,48,-122,15,9,24
7968,FremontBridge,08/31/2013 12:00:00 AM,48,-122,15,9,24
7969,FremontBridge,08/31/2013 01:00:00 AM,48,-122,5,6,11
7970,FremontBridge,08/31/2013 02:00:00 AM,48,-122,11,5,16
7971,FremontBridge,08/31/2013 03:00:00 AM,48,-122,5,5,10
7972,FremontBridge,08/31/2013 04:00:00 AM,48,-122,1,3,4
7973,FremontBridge,08/31/2013 05:00:00 AM,48,-122,1,7,8
7974,FremontBridge,08/31/2013 06:00:00 AM,48,-122,13,19,32
7975,FremontBridge,08/31/2013 07:00:00 AM,48,-122,25,31,56
7976,FremontBridge,08/31/2013 08:00:00 AM,48,-122,30,53,83
7977,FremontBridge,08/31/2013 09:00:00 AM,48,-122,57,71,128
7978,FremontBridge,08/31/2013 10:00:00 AM,48,-122,77,101,178
7979,FremontBridge,08/31/2013 11:00:00 AM,48,-122,70,103,173
7980,FremontBridge,08/31/2013 12:00:00 PM,48,-122,79,100,179
7981,FremontBridge,08/31/2013 01:00:00 PM,48,-122,98,97,195
7982,FremontBridge,08/31/2013 02:00:00 PM,48,-122,83,105,188
7983,FremontBridge,08/31/2013 03:00:00 PM,48,-122,86,96,182
7984,FremontBridge,08/31/2013 04:00:00 PM,48,-122,102,87,189
7985,FremontBridge,08/31/2013 05:00:00 PM,48,-122,75,82,157
7986,FremontBridge,08/31/2013 06:00:00 PM,48,-122,63,70,133
7987,FremontBridge,08/31/2013 07:00:00 PM,48,-122,45,56,101
7988,FremontBridge,08/31/2013 08:00:00 PM,48,-122,33,37,70
7989,FremontBridge,08/31/2013 09:00:00 PM,48,-122,45,22,67
7990,FremontBridge,08/31/2013 10:00:00 PM,48,-122,31,28,59
7991,FremontBridge,08/31/2013 11:00:00 PM,48,-122,38,11,49
7992,FremontBridge,09/01/2013 12:00:00 AM,48,-122,25,16,41
7993,FremontBridge,09/01/2013 01:00:00 AM,48,-122,4,10,14
7994,FremontBridge,09/01/2013 02:00:00 AM,48,-122,6,12,18
7995,FremontBridge,09/01/2013 03:00:00 AM,48,-122,5,4,9
7996,FremontBridge,09/01/2013 04:00:00 AM,48,-122,0,3,3
7997,FremontBridge,09/01/2013 05:00:00 AM,48,-122,3,6,9
7998,FremontBridge,09/01/2013 06:00:00 AM,48,-122,8,11,19
7999,FremontBridge,09/01/2013 07:00:00 AM,48,-122,13,24,37
8000,FremontBridge,09/01/2013 08:00:00 AM,48,-122,30,44,74
8001,FremontBridge,09/01/2013 09:00:00 AM,48,-122,28,34,62
8002,FremontBridge,09/01/2013 10:00:00 AM,48,-122,63,65,128
8003,FremontBridge,09/01/2013 11:00:00 AM,48,-122,71,103,174
8004,FremontBridge,09/01/2013 12:00:00 PM,48,-122,88,100,188
8005,FremontBridge,09/01/2013 01:00:00 PM,48,-122,84,134,218
8006,FremontBridge,09/01/2013 02:00:00 PM,48,-122,98,132,230
8007,FremontBridge,09/01/2013 03:00:00 PM,48,-122,85,144,229
8008,FremontBridge,09/01/2013 04:00:00 PM,48,-122,81,106,187
8009,FremontBridge,09/01/2013 05:00:00 PM,48,-122,77,75,152
8010,FremontBridge,09/01/2013 06:00:00 PM,48,-122,56,74,130
8011,FremontBridge,09/01/2013 07:00:00 PM,48,-122,70,67,137
8012,FremontBridge,09/01/2013 08:00:00 PM,48,-122,29,29,58
8013,FremontBridge,09/01/2013 09:00:00 PM,48,-122,30,25,55
8014,FremontBridge,09/01/2013 10:00:00 PM,48,-122,40,9,49
8015,FremontBridge,09/01/2013 11:00:00 PM,48,-122,31,36,67
8016,FremontBridge,09/02/2013 12:00:00 AM,48,-122,23,15,38
8017,FremontBridge,09/02/2013 01:00:00 AM,48,-122,13,5,18
8018,FremontBridge,09/02/2013 02:00:00 AM,48,-122,2,5,7
8019,FremontBridge,09/02/2013 03:00:00 AM,48,-122,2,2,4
8020,FremontBridge,09/02/2013 04:00:00 AM,48,-122,3,4,7
8021,FremontBridge,09/02/2013 05:00:00 AM,48,-122,1,4,5
8022,FremontBridge,09/02/2013 06:00:00 AM,48,-122,6,9,15
8023,FremontBridge,09/02/2013 07:00:00 AM,48,-122,20,35,55
8024,FremontBridge,09/02/2013 08:00:00 AM,48,-122,21,48,69
8025,FremontBridge,09/02/2013 09:00:00 AM,48,-122,53,63,116
8026,FremontBridge,09/02/2013 10:00:00 AM,48,-122,57,95,152
8027,FremontBridge,09/02/2013 11:00:00 AM,48,-122,76,81,157
8028,FremontBridge,09/02/2013 12:00:00 PM,48,-122,97,101,198
8029,FremontBridge,09/02/2013 01:00:00 PM,48,-122,74,124,198
8030,FremontBridge,09/02/2013 02:00:00 PM,48,-122,92,134,226
8031,FremontBridge,09/02/2013 03:00:00 PM,48,-122,86,107,193
8032,FremontBridge,09/02/2013 04:00:00 PM,48,-122,90,113,203
8033,FremontBridge,09/02/2013 05:00:00 PM,48,-122,88,89,177
8034,FremontBridge,09/02/2013 06:00:00 PM,48,-122,71,74,145
8035,FremontBridge,09/02/2013 07:00:00 PM,48,-122,56,71,127
8036,FremontBridge,09/02/2013 08:00:00 PM,48,-122,34,42,76
8037,FremontBridge,09/02/2013 09:00:00 PM,48,-122,24,20,44
8038,FremontBridge,09/02/2013 10:00:00 PM,48,-122,32,15,47
8039,FremontBridge,09/02/2013 11:00:00 PM,48,-122,26,22,48
8040,FremontBridge,09/03/2013 12:00:00 AM,48,-122,8,11,19
8041,FremontBridge,09/03/2013 01:00:00 AM,48,-122,4,3,7
8042,FremontBridge,09/03/2013 02:00:00 AM,48,-122,4,2,6
8043,FremontBridge,09/03/2013 03:00:00 AM,48,-122,0,1,1
8044,FremontBridge,09/03/2013 04:00:00 AM,48,-122,4,4,8
8045,FremontBridge,09/03/2013 05:00:00 AM,48,-122,4,21,25
8046,FremontBridge,09/03/2013 06:00:00 AM,48,-122,30,56,86
8047,FremontBridge,09/03/2013 07:00:00 AM,48,-122,48,164,212
8048,FremontBridge,09/03/2013 08:00:00 AM,48,-122,127,263,390
8049,FremontBridge,09/03/2013 09:00:00 AM,48,-122,78,142,220
8050,FremontBridge,09/03/2013 10:00:00 AM,48,-122,40,45,85
8051,FremontBridge,09/03/2013 11:00:00 AM,48,-122,39,35,74
8052,FremontBridge,09/03/2013 12:00:00 PM,48,-122,38,42,80
8053,FremontBridge,09/03/2013 01:00:00 PM,48,-122,37,31,68
8054,FremontBridge,09/03/2013 02:00:00 PM,48,-122,27,31,58
8055,FremontBridge,09/03/2013 03:00:00 PM,48,-122,51,41,92
8056,FremontBridge,09/03/2013 04:00:00 PM,48,-122,102,81,183
8057,FremontBridge,09/03/2013 05:00:00 PM,48,-122,312,139,451
8058,FremontBridge,09/03/2013 06:00:00 PM,48,-122,242,143,385
8059,FremontBridge,09/03/2013 07:00:00 PM,48,-122,133,90,223
8060,FremontBridge,09/03/2013 08:00:00 PM,48,-122,61,60,121
8061,FremontBridge,09/03/2013 09:00:00 PM,48,-122,27,29,56
8062,FremontBridge,09/03/2013 10:00:00 PM,48,-122,26,30,56
8063,FremontBridge,09/03/2013 11:00:00 PM,48,-122,14,11,25
8064,FremontBridge,09/04/2013 12:00:00 AM,48,-122,13,7,20
8065,FremontBridge,09/04/2013 01:00:00 AM,48,-122,6,5,11
8066,FremontBridge,09/04/2013 02:00:00 AM,48,-122,2,3,5
8067,FremontBridge,09/04/2013 03:00:00 AM,48,-122,0,3,3
8068,FremontBridge,09/04/2013 04:00:00 AM,48,-122,1,7,8
8069,FremontBridge,09/04/2013 05:00:00 AM,48,-122,7,22,29
8070,FremontBridge,09/04/2013 06:00:00 AM,48,-122,43,91,134
8071,FremontBridge,09/04/2013 07:00:00 AM,48,-122,77,254,331
8072,FremontBridge,09/04/2013 08:00:00 AM,48,-122,152,341,493
8073,FremontBridge,09/04/2013 09:00:00 AM,48,-122,116,200,316
8074,FremontBridge,09/04/2013 10:00:00 AM,48,-122,63,87,150
8075,FremontBridge,09/04/2013 11:00:00 AM,48,-122,41,45,86
8076,FremontBridge,09/04/2013 12:00:00 PM,48,-122,48,43,91
8077,FremontBridge,09/04/2013 01:00:00 PM,48,-122,46,45,91
8078,FremontBridge,09/04/2013 02:00:00 PM,48,-122,54,64,118
8079,FremontBridge,09/04/2013 03:00:00 PM,48,-122,62,63,125
8080,FremontBridge,09/04/2013 04:00:00 PM,48,-122,164,92,256
8081,FremontBridge,09/04/2013 05:00:00 PM,48,-122,402,175,577
8082,FremontBridge,09/04/2013 06:00:00 PM,48,-122,322,154,476
8083,FremontBridge,09/04/2013 07:00:00 PM,48,-122,143,94,237
8084,FremontBridge,09/04/2013 08:00:00 PM,48,-122,68,41,109
8085,FremontBridge,09/04/2013 09:00:00 PM,48,-122,55,28,83
8086,FremontBridge,09/04/2013 10:00:00 PM,48,-122,28,18,46
8087,FremontBridge,09/04/2013 11:00:00 PM,48,-122,24,11,35
8088,FremontBridge,09/05/2013 12:00:00 AM,48,-122,4,9,13
8089,FremontBridge,09/05/2013 01:00:00 AM,48,-122,8,4,12
8090,FremontBridge,09/05/2013 02:00:00 AM,48,-122,3,6,9
8091,FremontBridge,09/05/2013 03:00:00 AM,48,-122,1,5,6
8092,FremontBridge,09/05/2013 04:00:00 AM,48,-122,1,6,7
8093,FremontBridge,09/05/2013 05:00:00 AM,48,-122,9,14,23
8094,FremontBridge,09/05/2013 06:00:00 AM,48,-122,33,87,120
8095,FremontBridge,09/05/2013 07:00:00 AM,48,-122,52,140,192
8096,FremontBridge,09/05/2013 08:00:00 AM,48,-122,69,162,231
8097,FremontBridge,09/05/2013 09:00:00 AM,48,-122,51,79,130
8098,FremontBridge,09/05/2013 10:00:00 AM,48,-122,32,41,73
8099,FremontBridge,09/05/2013 11:00:00 AM,48,-122,22,23,45
8100,FremontBridge,09/05/2013 12:00:00 PM,48,-122,33,22,55
8101,FremontBridge,09/05/2013 01:00:00 PM,48,-122,30,32,62
8102,FremontBridge,09/05/2013 02:00:00 PM,48,-122,34,50,84
8103,FremontBridge,09/05/2013 03:00:00 PM,48,-122,44,61,105
8104,FremontBridge,09/05/2013 04:00:00 PM,48,-122,94,66,160
8105,FremontBridge,09/05/2013 05:00:00 PM,48,-122,240,113,353
8106,FremontBridge,09/05/2013 06:00:00 PM,48,-122,130,99,229
8107,FremontBridge,09/05/2013 07:00:00 PM,48,-122,92,79,171
8108,FremontBridge,09/05/2013 08:00:00 PM,48,-122,31,31,62
8109,FremontBridge,09/05/2013 09:00:00 PM,48,-122,24,24,48
8110,FremontBridge,09/05/2013 10:00:00 PM,48,-122,24,10,34
8111,FremontBridge,09/05/2013 11:00:00 PM,48,-122,9,15,24
8112,FremontBridge,09/06/2013 12:00:00 AM,48,-122,7,5,12
8113,FremontBridge,09/06/2013 01:00:00 AM,48,-122,1,3,4
8114,FremontBridge,09/06/2013 02:00:00 AM,48,-122,1,5,6
8115,FremontBridge,09/06/2013 03:00:00 AM,48,-122,0,2,2
8116,FremontBridge,09/06/2013 04:00:00 AM,48,-122,3,5,8
8117,FremontBridge,09/06/2013 05:00:00 AM,48,-122,6,20,26
8118,FremontBridge,09/06/2013 06:00:00 AM,48,-122,27,59,86
8119,FremontBridge,09/06/2013 07:00:00 AM,48,-122,47,128,175
8120,FremontBridge,09/06/2013 08:00:00 AM,48,-122,70,193,263
8121,FremontBridge,09/06/2013 09:00:00 AM,48,-122,58,109,167
8122,FremontBridge,09/06/2013 10:00:00 AM,48,-122,29,43,72
8123,FremontBridge,09/06/2013 11:00:00 AM,48,-122,15,22,37
8124,FremontBridge,09/06/2013 12:00:00 PM,48,-122,26,24,50
8125,FremontBridge,09/06/2013 01:00:00 PM,48,-122,31,34,65
8126,FremontBridge,09/06/2013 02:00:00 PM,48,-122,28,22,50
8127,FremontBridge,09/06/2013 03:00:00 PM,48,-122,55,50,105
8128,FremontBridge,09/06/2013 04:00:00 PM,48,-122,105,76,181
8129,FremontBridge,09/06/2013 05:00:00 PM,48,-122,215,123,338
8130,FremontBridge,09/06/2013 06:00:00 PM,48,-122,167,105,272
8131,FremontBridge,09/06/2013 07:00:00 PM,48,-122,77,54,131
8132,FremontBridge,09/06/2013 08:00:00 PM,48,-122,41,32,73
8133,FremontBridge,09/06/2013 09:00:00 PM,48,-122,30,15,45
8134,FremontBridge,09/06/2013 10:00:00 PM,48,-122,24,5,29
8135,FremontBridge,09/06/2013 11:00:00 PM,48,-122,15,11,26
8136,FremontBridge,09/07/2013 12:00:00 AM,48,-122,11,12,23
8137,FremontBridge,09/07/2013 01:00:00 AM,48,-122,10,10,20
8138,FremontBridge,09/07/2013 02:00:00 AM,48,-122,4,2,6
8139,FremontBridge,09/07/2013 03:00:00 AM,48,-122,2,3,5
8140,FremontBridge,09/07/2013 04:00:00 AM,48,-122,3,4,7
8141,FremontBridge,09/07/2013 05:00:00 AM,48,-122,3,10,13
8142,FremontBridge,09/07/2013 06:00:00 AM,48,-122,10,15,25
8143,FremontBridge,09/07/2013 07:00:00 AM,48,-122,14,24,38
8144,FremontBridge,09/07/2013 08:00:00 AM,48,-122,28,34,62
8145,FremontBridge,09/07/2013 09:00:00 AM,48,-122,48,63,111
8146,FremontBridge,09/07/2013 10:00:00 AM,48,-122,39,60,99
8147,FremontBridge,09/07/2013 11:00:00 AM,48,-122,46,71,117
8148,FremontBridge,09/07/2013 12:00:00 PM,48,-122,43,57,100
8149,FremontBridge,09/07/2013 01:00:00 PM,48,-122,71,68,139
8150,FremontBridge,09/07/2013 02:00:00 PM,48,-122,68,94,162
8151,FremontBridge,09/07/2013 03:00:00 PM,48,-122,73,88,161
8152,FremontBridge,09/07/2013 04:00:00 PM,48,-122,80,85,165
8153,FremontBridge,09/07/2013 05:00:00 PM,48,-122,75,98,173
8154,FremontBridge,09/07/2013 06:00:00 PM,48,-122,65,96,161
8155,FremontBridge,09/07/2013 07:00:00 PM,48,-122,38,48,86
8156,FremontBridge,09/07/2013 08:00:00 PM,48,-122,36,33,69
8157,FremontBridge,09/07/2013 09:00:00 PM,48,-122,34,19,53
8158,FremontBridge,09/07/2013 10:00:00 PM,48,-122,42,8,50
8159,FremontBridge,09/07/2013 11:00:00 PM,48,-122,24,11,35
8160,FremontBridge,09/08/2013 12:00:00 AM,48,-122,20,12,32
8161,FremontBridge,09/08/2013 01:00:00 AM,48,-122,13,5,18
8162,FremontBridge,09/08/2013 02:00:00 AM,48,-122,4,4,8
8163,FremontBridge,09/08/2013 03:00:00 AM,48,-122,1,6,7
8164,FremontBridge,09/08/2013 04:00:00 AM,48,-122,1,5,6
8165,FremontBridge,09/08/2013 05:00:00 AM,48,-122,5,7,12
8166,FremontBridge,09/08/2013 06:00:00 AM,48,-122,5,14,19
8167,FremontBridge,09/08/2013 07:00:00 AM,48,-122,14,27,41
8168,FremontBridge,09/08/2013 08:00:00 AM,48,-122,34,27,61
8169,FremontBridge,09/08/2013 09:00:00 AM,48,-122,70,47,117
8170,FremontBridge,09/08/2013 10:00:00 AM,48,-122,64,89,153
8171,FremontBridge,09/08/2013 11:00:00 AM,48,-122,74,81,155
8172,FremontBridge,09/08/2013 12:00:00 PM,48,-122,69,85,154
8173,FremontBridge,09/08/2013 01:00:00 PM,48,-122,87,149,236
8174,FremontBridge,09/08/2013 02:00:00 PM,48,-122,102,114,216
8175,FremontBridge,09/08/2013 03:00:00 PM,48,-122,89,186,275
8176,FremontBridge,09/08/2013 04:00:00 PM,48,-122,118,90,208
8177,FremontBridge,09/08/2013 05:00:00 PM,48,-122,100,107,207
8178,FremontBridge,09/08/2013 06:00:00 PM,48,-122,62,94,156
8179,FremontBridge,09/08/2013 07:00:00 PM,48,-122,42,68,110
8180,FremontBridge,09/08/2013 08:00:00 PM,48,-122,24,40,64
8181,FremontBridge,09/08/2013 09:00:00 PM,48,-122,17,15,32
8182,FremontBridge,09/08/2013 10:00:00 PM,48,-122,17,8,25
8183,FremontBridge,09/08/2013 11:00:00 PM,48,-122,11,8,19
8184,FremontBridge,09/09/2013 12:00:00 AM,48,-122,7,7,14
8185,FremontBridge,09/09/2013 01:00:00 AM,48,-122,7,1,8
8186,FremontBridge,09/09/2013 02:00:00 AM,48,-122,1,2,3
8187,FremontBridge,09/09/2013 03:00:00 AM,48,-122,1,1,2
8188,FremontBridge,09/09/2013 04:00:00 AM,48,-122,1,4,5
8189,FremontBridge,09/09/2013 05:00:00 AM,48,-122,9,26,35
8190,FremontBridge,09/09/2013 06:00:00 AM,48,-122,44,95,139
8191,FremontBridge,09/09/2013 07:00:00 AM,48,-122,87,257,344
8192,FremontBridge,09/09/2013 08:00:00 AM,48,-122,140,343,483
8193,FremontBridge,09/09/2013 09:00:00 AM,48,-122,127,184,311
8194,FremontBridge,09/09/2013 10:00:00 AM,48,-122,49,65,114
8195,FremontBridge,09/09/2013 11:00:00 AM,48,-122,33,45,78
8196,FremontBridge,09/09/2013 12:00:00 PM,48,-122,42,42,84
8197,FremontBridge,09/09/2013 01:00:00 PM,48,-122,56,56,112
8198,FremontBridge,09/09/2013 02:00:00 PM,48,-122,66,55,121
8199,FremontBridge,09/09/2013 03:00:00 PM,48,-122,81,76,157
8200,FremontBridge,09/09/2013 04:00:00 PM,48,-122,174,125,299
8201,FremontBridge,09/09/2013 05:00:00 PM,48,-122,437,169,606
8202,FremontBridge,09/09/2013 06:00:00 PM,48,-122,338,151,489
8203,FremontBridge,09/09/2013 07:00:00 PM,48,-122,150,89,239
8204,FremontBridge,09/09/2013 08:00:00 PM,48,-122,70,52,122
8205,FremontBridge,09/09/2013 09:00:00 PM,48,-122,29,27,56
8206,FremontBridge,09/09/2013 10:00:00 PM,48,-122,26,25,51
8207,FremontBridge,09/09/2013 11:00:00 PM,48,-122,11,10,21
8208,FremontBridge,09/10/2013 12:00:00 AM,48,-122,21,14,35
8209,FremontBridge,09/10/2013 01:00:00 AM,48,-122,1,3,4
8210,FremontBridge,09/10/2013 02:00:00 AM,48,-122,4,4,8
8211,FremontBridge,09/10/2013 03:00:00 AM,48,-122,0,5,5
8212,FremontBridge,09/10/2013 04:00:00 AM,48,-122,2,6,8
8213,FremontBridge,09/10/2013 05:00:00 AM,48,-122,5,25,30
8214,FremontBridge,09/10/2013 06:00:00 AM,48,-122,36,93,129
8215,FremontBridge,09/10/2013 07:00:00 AM,48,-122,99,299,398
8216,FremontBridge,09/10/2013 08:00:00 AM,48,-122,171,380,551
8217,FremontBridge,09/10/2013 09:00:00 AM,48,-122,101,193,294
8218,FremontBridge,09/10/2013 10:00:00 AM,48,-122,71,69,140
8219,FremontBridge,09/10/2013 11:00:00 AM,48,-122,35,58,93
8220,FremontBridge,09/10/2013 12:00:00 PM,48,-122,51,59,110
8221,FremontBridge,09/10/2013 01:00:00 PM,48,-122,53,49,102
8222,FremontBridge,09/10/2013 02:00:00 PM,48,-122,68,59,127
8223,FremontBridge,09/10/2013 03:00:00 PM,48,-122,85,79,164
8224,FremontBridge,09/10/2013 04:00:00 PM,48,-122,183,104,287
8225,FremontBridge,09/10/2013 05:00:00 PM,48,-122,479,206,685
8226,FremontBridge,09/10/2013 06:00:00 PM,48,-122,360,188,548
8227,FremontBridge,09/10/2013 07:00:00 PM,48,-122,161,103,264
8228,FremontBridge,09/10/2013 08:00:00 PM,48,-122,63,48,111
8229,FremontBridge,09/10/2013 09:00:00 PM,48,-122,36,29,65
8230,FremontBridge,09/10/2013 10:00:00 PM,48,-122,25,19,44
8231,FremontBridge,09/10/2013 11:00:00 PM,48,-122,23,20,43
8232,FremontBridge,09/11/2013 12:00:00 AM,48,-122,10,10,20
8233,FremontBridge,09/11/2013 01:00:00 AM,48,-122,3,0,3
8234,FremontBridge,09/11/2013 02:00:00 AM,48,-122,3,5,8
8235,FremontBridge,09/11/2013 03:00:00 AM,48,-122,1,4,5
8236,FremontBridge,09/11/2013 04:00:00 AM,48,-122,3,5,8
8237,FremontBridge,09/11/2013 05:00:00 AM,48,-122,9,33,42
8238,FremontBridge,09/11/2013 06:00:00 AM,48,-122,40,96,136
8239,FremontBridge,09/11/2013 07:00:00 AM,48,-122,118,279,397
8240,FremontBridge,09/11/2013 08:00:00 AM,48,-122,157,405,562
8241,FremontBridge,09/11/2013 09:00:00 AM,48,-122,152,206,358
8242,FremontBridge,09/11/2013 10:00:00 AM,48,-122,52,76,128
8243,FremontBridge,09/11/2013 11:00:00 AM,48,-122,46,64,110
8244,FremontBridge,09/11/2013 12:00:00 PM,48,-122,61,56,117
8245,FremontBridge,09/11/2013 01:00:00 PM,48,-122,66,72,138
8246,FremontBridge,09/11/2013 02:00:00 PM,48,-122,74,73,147
8247,FremontBridge,09/11/2013 03:00:00 PM,48,-122,80,80,160
8248,FremontBridge,09/11/2013 04:00:00 PM,48,-122,183,121,304
8249,FremontBridge,09/11/2013 05:00:00 PM,48,-122,460,185,645
8250,FremontBridge,09/11/2013 06:00:00 PM,48,-122,312,199,511
8251,FremontBridge,09/11/2013 07:00:00 PM,48,-122,164,122,286
8252,FremontBridge,09/11/2013 08:00:00 PM,48,-122,71,67,138
8253,FremontBridge,09/11/2013 09:00:00 PM,48,-122,46,39,85
8254,FremontBridge,09/11/2013 10:00:00 PM,48,-122,37,38,75
8255,FremontBridge,09/11/2013 11:00:00 PM,48,-122,13,15,28
8256,FremontBridge,09/12/2013 12:00:00 AM,48,-122,11,5,16
8257,FremontBridge,09/12/2013 01:00:00 AM,48,-122,2,8,10
8258,FremontBridge,09/12/2013 02:00:00 AM,48,-122,2,4,6
8259,FremontBridge,09/12/2013 03:00:00 AM,48,-122,1,0,1
8260,FremontBridge,09/12/2013 04:00:00 AM,48,-122,1,2,3
8261,FremontBridge,09/12/2013 05:00:00 AM,48,-122,10,23,33
8262,FremontBridge,09/12/2013 06:00:00 AM,48,-122,45,99,144
8263,FremontBridge,09/12/2013 07:00:00 AM,48,-122,95,272,367
8264,FremontBridge,09/12/2013 08:00:00 AM,48,-122,156,346,502
8265,FremontBridge,09/12/2013 09:00:00 AM,48,-122,110,217,327
8266,FremontBridge,09/12/2013 10:00:00 AM,48,-122,57,61,118
8267,FremontBridge,09/12/2013 11:00:00 AM,48,-122,34,62,96
8268,FremontBridge,09/12/2013 12:00:00 PM,48,-122,44,56,100
8269,FremontBridge,09/12/2013 01:00:00 PM,48,-122,52,60,112
8270,FremontBridge,09/12/2013 02:00:00 PM,48,-122,48,61,109
8271,FremontBridge,09/12/2013 03:00:00 PM,48,-122,78,74,152
8272,FremontBridge,09/12/2013 04:00:00 PM,48,-122,164,123,287
8273,FremontBridge,09/12/2013 05:00:00 PM,48,-122,429,189,618
8274,FremontBridge,09/12/2013 06:00:00 PM,48,-122,325,174,499
8275,FremontBridge,09/12/2013 07:00:00 PM,48,-122,159,101,260
8276,FremontBridge,09/12/2013 08:00:00 PM,48,-122,62,56,118
8277,FremontBridge,09/12/2013 09:00:00 PM,48,-122,40,47,87
8278,FremontBridge,09/12/2013 10:00:00 PM,48,-122,28,15,43
8279,FremontBridge,09/12/2013 11:00:00 PM,48,-122,22,15,37
8280,FremontBridge,09/13/2013 12:00:00 AM,48,-122,7,11,18
8281,FremontBridge,09/13/2013 01:00:00 AM,48,-122,1,4,5
8282,FremontBridge,09/13/2013 02:00:00 AM,48,-122,4,6,10
8283,FremontBridge,09/13/2013 03:00:00 AM,48,-122,1,1,2
8284,FremontBridge,09/13/2013 04:00:00 AM,48,-122,3,1,4
8285,FremontBridge,09/13/2013 05:00:00 AM,48,-122,6,30,36
8286,FremontBridge,09/13/2013 06:00:00 AM,48,-122,36,70,106
8287,FremontBridge,09/13/2013 07:00:00 AM,48,-122,86,202,288
8288,FremontBridge,09/13/2013 08:00:00 AM,48,-122,120,268,388
8289,FremontBridge,09/13/2013 09:00:00 AM,48,-122,98,174,272
8290,FremontBridge,09/13/2013 10:00:00 AM,48,-122,54,74,128
8291,FremontBridge,09/13/2013 11:00:00 AM,48,-122,37,48,85
8292,FremontBridge,09/13/2013 12:00:00 PM,48,-122,45,37,82
8293,FremontBridge,09/13/2013 01:00:00 PM,48,-122,52,54,106
8294,FremontBridge,09/13/2013 02:00:00 PM,48,-122,51,55,106
8295,FremontBridge,09/13/2013 03:00:00 PM,48,-122,102,58,160
8296,FremontBridge,09/13/2013 04:00:00 PM,48,-122,184,95,279
8297,FremontBridge,09/13/2013 05:00:00 PM,48,-122,303,166,469
8298,FremontBridge,09/13/2013 06:00:00 PM,48,-122,221,120,341
8299,FremontBridge,09/13/2013 07:00:00 PM,48,-122,91,56,147
8300,FremontBridge,09/13/2013 08:00:00 PM,48,-122,53,23,76
8301,FremontBridge,09/13/2013 09:00:00 PM,48,-122,22,19,41
8302,FremontBridge,09/13/2013 10:00:00 PM,48,-122,36,16,52
8303,FremontBridge,09/13/2013 11:00:00 PM,48,-122,16,15,31
8304,FremontBridge,09/14/2013 12:00:00 AM,48,-122,11,7,18
8305,FremontBridge,09/14/2013 01:00:00 AM,48,-122,6,2,8
8306,FremontBridge,09/14/2013 02:00:00 AM,48,-122,7,2,9
8307,FremontBridge,09/14/2013 03:00:00 AM,48,-122,4,4,8
8308,FremontBridge,09/14/2013 04:00:00 AM,48,-122,3,5,8
8309,FremontBridge,09/14/2013 05:00:00 AM,48,-122,3,7,10
8310,FremontBridge,09/14/2013 06:00:00 AM,48,-122,6,12,18
8311,FremontBridge,09/14/2013 07:00:00 AM,48,-122,23,10,33
8312,FremontBridge,09/14/2013 08:00:00 AM,48,-122,38,50,88
8313,FremontBridge,09/14/2013 09:00:00 AM,48,-122,60,72,132
8314,FremontBridge,09/14/2013 10:00:00 AM,48,-122,35,46,81
8315,FremontBridge,09/14/2013 11:00:00 AM,48,-122,46,86,132
8316,FremontBridge,09/14/2013 12:00:00 PM,48,-122,64,72,136
8317,FremontBridge,09/14/2013 01:00:00 PM,48,-122,70,73,143
8318,FremontBridge,09/14/2013 02:00:00 PM,48,-122,82,88,170
8319,FremontBridge,09/14/2013 03:00:00 PM,48,-122,64,61,125
8320,FremontBridge,09/14/2013 04:00:00 PM,48,-122,60,75,135
8321,FremontBridge,09/14/2013 05:00:00 PM,48,-122,70,88,158
8322,FremontBridge,09/14/2013 06:00:00 PM,48,-122,67,81,148
8323,FremontBridge,09/14/2013 07:00:00 PM,48,-122,40,56,96
8324,FremontBridge,09/14/2013 08:00:00 PM,48,-122,34,35,69
8325,FremontBridge,09/14/2013 09:00:00 PM,48,-122,23,30,53
8326,FremontBridge,09/14/2013 10:00:00 PM,48,-122,15,15,30
8327,FremontBridge,09/14/2013 11:00:00 PM,48,-122,19,5,24
8328,FremontBridge,09/15/2013 12:00:00 AM,48,-122,8,12,20
8329,FremontBridge,09/15/2013 01:00:00 AM,48,-122,4,7,11
8330,FremontBridge,09/15/2013 02:00:00 AM,48,-122,5,6,11
8331,FremontBridge,09/15/2013 03:00:00 AM,48,-122,1,4,5
8332,FremontBridge,09/15/2013 04:00:00 AM,48,-122,1,4,5
8333,FremontBridge,09/15/2013 05:00:00 AM,48,-122,2,7,9
8334,FremontBridge,09/15/2013 06:00:00 AM,48,-122,7,11,18
8335,FremontBridge,09/15/2013 07:00:00 AM,48,-122,25,17,42
8336,FremontBridge,09/15/2013 08:00:00 AM,48,-122,27,32,59
8337,FremontBridge,09/15/2013 09:00:00 AM,48,-122,37,33,70
8338,FremontBridge,09/15/2013 10:00:00 AM,48,-122,26,46,72
8339,FremontBridge,09/15/2013 11:00:00 AM,48,-122,37,40,77
8340,FremontBridge,09/15/2013 12:00:00 PM,48,-122,26,48,74
8341,FremontBridge,09/15/2013 01:00:00 PM,48,-122,36,60,96
8342,FremontBridge,09/15/2013 02:00:00 PM,48,-122,46,54,100
8343,FremontBridge,09/15/2013 03:00:00 PM,48,-122,40,61,101
8344,FremontBridge,09/15/2013 04:00:00 PM,48,-122,36,39,75
8345,FremontBridge,09/15/2013 05:00:00 PM,48,-122,26,25,51
8346,FremontBridge,09/15/2013 06:00:00 PM,48,-122,18,16,34
8347,FremontBridge,09/15/2013 07:00:00 PM,48,-122,13,14,27
8348,FremontBridge,09/15/2013 08:00:00 PM,48,-122,13,7,20
8349,FremontBridge,09/15/2013 09:00:00 PM,48,-122,6,5,11
8350,FremontBridge,09/15/2013 10:00:00 PM,48,-122,19,2,21
8351,FremontBridge,09/15/2013 11:00:00 PM,48,-122,4,11,15
8352,FremontBridge,09/16/2013 12:00:00 AM,48,-122,4,6,10
8353,FremontBridge,09/16/2013 01:00:00 AM,48,-122,4,0,4
8354,FremontBridge,09/16/2013 02:00:00 AM,48,-122,1,3,4
8355,FremontBridge,09/16/2013 03:00:00 AM,48,-122,2,0,2
8356,FremontBridge,09/16/2013 04:00:00 AM,48,-122,2,3,5
8357,FremontBridge,09/16/2013 05:00:00 AM,48,-122,4,26,30
8358,FremontBridge,09/16/2013 06:00:00 AM,48,-122,34,66,100
8359,FremontBridge,09/16/2013 07:00:00 AM,48,-122,83,192,275
8360,FremontBridge,09/16/2013 08:00:00 AM,48,-122,133,291,424
8361,FremontBridge,09/16/2013 09:00:00 AM,48,-122,81,189,270
8362,FremontBridge,09/16/2013 10:00:00 AM,48,-122,40,62,102
8363,FremontBridge,09/16/2013 11:00:00 AM,48,-122,31,43,74
8364,FremontBridge,09/16/2013 12:00:00 PM,48,-122,41,32,73
8365,FremontBridge,09/16/2013 01:00:00 PM,48,-122,30,45,75
8366,FremontBridge,09/16/2013 02:00:00 PM,48,-122,39,31,70
8367,FremontBridge,09/16/2013 03:00:00 PM,48,-122,71,53,124
8368,FremontBridge,09/16/2013 04:00:00 PM,48,-122,122,91,213
8369,FremontBridge,09/16/2013 05:00:00 PM,48,-122,371,121,492
8370,FremontBridge,09/16/2013 06:00:00 PM,48,-122,278,122,400
8371,FremontBridge,09/16/2013 07:00:00 PM,48,-122,102,66,168
8372,FremontBridge,09/16/2013 08:00:00 PM,48,-122,32,28,60
8373,FremontBridge,09/16/2013 09:00:00 PM,48,-122,22,24,46
8374,FremontBridge,09/16/2013 10:00:00 PM,48,-122,14,14,28
8375,FremontBridge,09/16/2013 11:00:00 PM,48,-122,13,3,16
8376,FremontBridge,09/17/2013 12:00:00 AM,48,-122,5,5,10
8377,FremontBridge,09/17/2013 01:00:00 AM,48,-122,2,2,4
8378,FremontBridge,09/17/2013 02:00:00 AM,48,-122,0,4,4
8379,FremontBridge,09/17/2013 03:00:00 AM,48,-122,0,2,2
8380,FremontBridge,09/17/2013 04:00:00 AM,48,-122,2,5,7
8381,FremontBridge,09/17/2013 05:00:00 AM,48,-122,8,29,37
8382,FremontBridge,09/17/2013 06:00:00 AM,48,-122,32,79,111
8383,FremontBridge,09/17/2013 07:00:00 AM,48,-122,96,230,326
8384,FremontBridge,09/17/2013 08:00:00 AM,48,-122,144,321,465
8385,FremontBridge,09/17/2013 09:00:00 AM,48,-122,118,157,275
8386,FremontBridge,09/17/2013 10:00:00 AM,48,-122,50,65,115
8387,FremontBridge,09/17/2013 11:00:00 AM,48,-122,33,52,85
8388,FremontBridge,09/17/2013 12:00:00 PM,48,-122,35,45,80
8389,FremontBridge,09/17/2013 01:00:00 PM,48,-122,53,48,101
8390,FremontBridge,09/17/2013 02:00:00 PM,48,-122,49,42,91
8391,FremontBridge,09/17/2013 03:00:00 PM,48,-122,66,54,120
8392,FremontBridge,09/17/2013 04:00:00 PM,48,-122,137,77,214
8393,FremontBridge,09/17/2013 05:00:00 PM,48,-122,325,146,471
8394,FremontBridge,09/17/2013 06:00:00 PM,48,-122,247,134,381
8395,FremontBridge,09/17/2013 07:00:00 PM,48,-122,111,69,180
8396,FremontBridge,09/17/2013 08:00:00 PM,48,-122,46,47,93
8397,FremontBridge,09/17/2013 09:00:00 PM,48,-122,29,19,48
8398,FremontBridge,09/17/2013 10:00:00 PM,48,-122,14,15,29
8399,FremontBridge,09/17/2013 11:00:00 PM,48,-122,23,12,35
8400,FremontBridge,09/18/2013 12:00:00 AM,48,-122,6,4,10
8401,FremontBridge,09/18/2013 01:00:00 AM,48,-122,2,2,4
8402,FremontBridge,09/18/2013 02:00:00 AM,48,-122,3,5,8
8403,FremontBridge,09/18/2013 03:00:00 AM,48,-122,0,1,1
8404,FremontBridge,09/18/2013 04:00:00 AM,48,-122,3,3,6
8405,FremontBridge,09/18/2013 05:00:00 AM,48,-122,8,32,40
8406,FremontBridge,09/18/2013 06:00:00 AM,48,-122,30,81,111
8407,FremontBridge,09/18/2013 07:00:00 AM,48,-122,87,221,308
8408,FremontBridge,09/18/2013 08:00:00 AM,48,-122,151,362,513
8409,FremontBridge,09/18/2013 09:00:00 AM,48,-122,102,188,290
8410,FremontBridge,09/18/2013 10:00:00 AM,48,-122,52,80,132
8411,FremontBridge,09/18/2013 11:00:00 AM,48,-122,43,58,101
8412,FremontBridge,09/18/2013 12:00:00 PM,48,-122,62,76,138
8413,FremontBridge,09/18/2013 01:00:00 PM,48,-122,58,63,121
8414,FremontBridge,09/18/2013 02:00:00 PM,48,-122,64,58,122
8415,FremontBridge,09/18/2013 03:00:00 PM,48,-122,84,63,147
8416,FremontBridge,09/18/2013 04:00:00 PM,48,-122,178,112,290
8417,FremontBridge,09/18/2013 05:00:00 PM,48,-122,384,198,582
8418,FremontBridge,09/18/2013 06:00:00 PM,48,-122,315,178,493
8419,FremontBridge,09/18/2013 07:00:00 PM,48,-122,131,108,239
8420,FremontBridge,09/18/2013 08:00:00 PM,48,-122,60,42,102
8421,FremontBridge,09/18/2013 09:00:00 PM,48,-122,27,40,67
8422,FremontBridge,09/18/2013 10:00:00 PM,48,-122,28,22,50
8423,FremontBridge,09/18/2013 11:00:00 PM,48,-122,22,12,34
8424,FremontBridge,09/19/2013 12:00:00 AM,48,-122,6,7,13
8425,FremontBridge,09/19/2013 01:00:00 AM,48,-122,2,1,3
8426,FremontBridge,09/19/2013 02:00:00 AM,48,-122,5,11,16
8427,FremontBridge,09/19/2013 03:00:00 AM,48,-122,0,0,0
8428,FremontBridge,09/19/2013 04:00:00 AM,48,-122,1,4,5
8429,FremontBridge,09/19/2013 05:00:00 AM,48,-122,11,32,43
8430,FremontBridge,09/19/2013 06:00:00 AM,48,-122,32,77,109
8431,FremontBridge,09/19/2013 07:00:00 AM,48,-122,92,253,345
8432,FremontBridge,09/19/2013 08:00:00 AM,48,-122,157,371,528
8433,FremontBridge,09/19/2013 09:00:00 AM,48,-122,86,215,301
8434,FremontBridge,09/19/2013 10:00:00 AM,48,-122,4,112,116
8435,FremontBridge,09/19/2013 11:00:00 AM,48,-122,1,111,112
8436,FremontBridge,09/19/2013 12:00:00 PM,48,-122,53,63,116
8437,FremontBridge,09/19/2013 01:00:00 PM,48,-122,54,62,116
8438,FremontBridge,09/19/2013 02:00:00 PM,48,-122,73,63,136
8439,FremontBridge,09/19/2013 03:00:00 PM,48,-122,100,95,195
8440,FremontBridge,09/19/2013 04:00:00 PM,48,-122,161,120,281
8441,FremontBridge,09/19/2013 05:00:00 PM,48,-122,422,199,621
8442,FremontBridge,09/19/2013 06:00:00 PM,48,-122,295,185,480
8443,FremontBridge,09/19/2013 07:00:00 PM,48,-122,129,118,247
8444,FremontBridge,09/19/2013 08:00:00 PM,48,-122,97,55,152
8445,FremontBridge,09/19/2013 09:00:00 PM,48,-122,34,52,86
8446,FremontBridge,09/19/2013 10:00:00 PM,48,-122,27,28,55
8447,FremontBridge,09/19/2013 11:00:00 PM,48,-122,28,14,42
8448,FremontBridge,09/20/2013 12:00:00 AM,48,-122,10,12,22
8449,FremontBridge,09/20/2013 01:00:00 AM,48,-122,4,5,9
8450,FremontBridge,09/20/2013 02:00:00 AM,48,-122,3,5,8
8451,FremontBridge,09/20/2013 03:00:00 AM,48,-122,3,2,5
8452,FremontBridge,09/20/2013 04:00:00 AM,48,-122,3,5,8
8453,FremontBridge,09/20/2013 05:00:00 AM,48,-122,9,20,29
8454,FremontBridge,09/20/2013 06:00:00 AM,48,-122,32,75,107
8455,FremontBridge,09/20/2013 07:00:00 AM,48,-122,87,183,270
8456,FremontBridge,09/20/2013 08:00:00 AM,48,-122,147,313,460
8457,FremontBridge,09/20/2013 09:00:00 AM,48,-122,99,174,273
8458,FremontBridge,09/20/2013 10:00:00 AM,48,-122,65,92,157
8459,FremontBridge,09/20/2013 11:00:00 AM,48,-122,39,52,91
8460,FremontBridge,09/20/2013 12:00:00 PM,48,-122,50,47,97
8461,FremontBridge,09/20/2013 01:00:00 PM,48,-122,53,57,110
8462,FremontBridge,09/20/2013 02:00:00 PM,48,-122,65,63,128
8463,FremontBridge,09/20/2013 03:00:00 PM,48,-122,86,86,172
8464,FremontBridge,09/20/2013 04:00:00 PM,48,-122,184,125,309
8465,FremontBridge,09/20/2013 05:00:00 PM,48,-122,355,132,487
8466,FremontBridge,09/20/2013 06:00:00 PM,48,-122,219,118,337
8467,FremontBridge,09/20/2013 07:00:00 PM,48,-122,65,48,113
8468,FremontBridge,09/20/2013 08:00:00 PM,48,-122,26,25,51
8469,FremontBridge,09/20/2013 09:00:00 PM,48,-122,23,17,40
8470,FremontBridge,09/20/2013 10:00:00 PM,48,-122,10,18,28
8471,FremontBridge,09/20/2013 11:00:00 PM,48,-122,13,10,23
8472,FremontBridge,09/21/2013 12:00:00 AM,48,-122,6,8,14
8473,FremontBridge,09/21/2013 01:00:00 AM,48,-122,7,8,15
8474,FremontBridge,09/21/2013 02:00:00 AM,48,-122,3,11,14
8475,FremontBridge,09/21/2013 03:00:00 AM,48,-122,1,2,3
8476,FremontBridge,09/21/2013 04:00:00 AM,48,-122,5,1,6
8477,FremontBridge,09/21/2013 05:00:00 AM,48,-122,3,7,10
8478,FremontBridge,09/21/2013 06:00:00 AM,48,-122,11,19,30
8479,FremontBridge,09/21/2013 07:00:00 AM,48,-122,8,18,26
8480,FremontBridge,09/21/2013 08:00:00 AM,48,-122,38,36,74
8481,FremontBridge,09/21/2013 09:00:00 AM,48,-122,44,49,93
8482,FremontBridge,09/21/2013 10:00:00 AM,48,-122,39,61,100
8483,FremontBridge,09/21/2013 11:00:00 AM,48,-122,68,66,134
8484,FremontBridge,09/21/2013 12:00:00 PM,48,-122,66,63,129
8485,FremontBridge,09/21/2013 01:00:00 PM,48,-122,64,69,133
8486,FremontBridge,09/21/2013 02:00:00 PM,48,-122,84,100,184
8487,FremontBridge,09/21/2013 03:00:00 PM,48,-122,92,127,219
8488,FremontBridge,09/21/2013 04:00:00 PM,48,-122,75,127,202
8489,FremontBridge,09/21/2013 05:00:00 PM,48,-122,69,116,185
8490,FremontBridge,09/21/2013 06:00:00 PM,48,-122,70,58,128
8491,FremontBridge,09/21/2013 07:00:00 PM,48,-122,42,50,92
8492,FremontBridge,09/21/2013 08:00:00 PM,48,-122,25,24,49
8493,FremontBridge,09/21/2013 09:00:00 PM,48,-122,20,17,37
8494,FremontBridge,09/21/2013 10:00:00 PM,48,-122,11,20,31
8495,FremontBridge,09/21/2013 11:00:00 PM,48,-122,7,17,24
8496,FremontBridge,09/22/2013 12:00:00 AM,48,-122,10,11,21
8497,FremontBridge,09/22/2013 01:00:00 AM,48,-122,5,5,10
8498,FremontBridge,09/22/2013 02:00:00 AM,48,-122,4,4,8
8499,FremontBridge,09/22/2013 03:00:00 AM,48,-122,2,3,5
8500,FremontBridge,09/22/2013 04:00:00 AM,48,-122,1,5,6
8501,FremontBridge,09/22/2013 05:00:00 AM,48,-122,4,3,7
8502,FremontBridge,09/22/2013 06:00:00 AM,48,-122,7,10,17
8503,FremontBridge,09/22/2013 07:00:00 AM,48,-122,8,11,19
8504,FremontBridge,09/22/2013 08:00:00 AM,48,-122,20,21,41
8505,FremontBridge,09/22/2013 09:00:00 AM,48,-122,30,34,64
8506,FremontBridge,09/22/2013 10:00:00 AM,48,-122,45,41,86
8507,FremontBridge,09/22/2013 11:00:00 AM,48,-122,28,43,71
8508,FremontBridge,09/22/2013 12:00:00 PM,48,-122,19,35,54
8509,FremontBridge,09/22/2013 01:00:00 PM,48,-122,14,15,29
8510,FremontBridge,09/22/2013 02:00:00 PM,48,-122,18,16,34
8511,FremontBridge,09/22/2013 03:00:00 PM,48,-122,12,13,25
8512,FremontBridge,09/22/2013 04:00:00 PM,48,-122,41,29,70
8513,FremontBridge,09/22/2013 05:00:00 PM,48,-122,26,28,54
8514,FremontBridge,09/22/2013 06:00:00 PM,48,-122,30,30,60
8515,FremontBridge,09/22/2013 07:00:00 PM,48,-122,17,17,34
8516,FremontBridge,09/22/2013 08:00:00 PM,48,-122,22,22,44
8517,FremontBridge,09/22/2013 09:00:00 PM,48,-122,6,8,14
8518,FremontBridge,09/22/2013 10:00:00 PM,48,-122,8,8,16
8519,FremontBridge,09/22/2013 11:00:00 PM,48,-122,4,3,7
8520,FremontBridge,09/23/2013 12:00:00 AM,48,-122,4,6,10
8521,FremontBridge,09/23/2013 01:00:00 AM,48,-122,1,0,1
8522,FremontBridge,09/23/2013 02:00:00 AM,48,-122,2,1,3
8523,FremontBridge,09/23/2013 03:00:00 AM,48,-122,0,0,0
8524,FremontBridge,09/23/2013 04:00:00 AM,48,-122,3,1,4
8525,FremontBridge,09/23/2013 05:00:00 AM,48,-122,6,19,25
8526,FremontBridge,09/23/2013 06:00:00 AM,48,-122,27,60,87
8527,FremontBridge,09/23/2013 07:00:00 AM,48,-122,58,149,207
8528,FremontBridge,09/23/2013 08:00:00 AM,48,-122,92,194,286
8529,FremontBridge,09/23/2013 09:00:00 AM,48,-122,58,106,164
8530,FremontBridge,09/23/2013 10:00:00 AM,48,-122,19,45,64
8531,FremontBridge,09/23/2013 11:00:00 AM,48,-122,15,22,37
8532,FremontBridge,09/23/2013 12:00:00 PM,48,-122,27,26,53
8533,FremontBridge,09/23/2013 01:00:00 PM,48,-122,34,38,72
8534,FremontBridge,09/23/2013 02:00:00 PM,48,-122,42,37,79
8535,FremontBridge,09/23/2013 03:00:00 PM,48,-122,37,41,78
8536,FremontBridge,09/23/2013 04:00:00 PM,48,-122,91,60,151
8537,FremontBridge,09/23/2013 05:00:00 PM,48,-122,263,131,394
8538,FremontBridge,09/23/2013 06:00:00 PM,48,-122,162,110,272
8539,FremontBridge,09/23/2013 07:00:00 PM,48,-122,65,48,113
8540,FremontBridge,09/23/2013 08:00:00 PM,48,-122,34,26,60
8541,FremontBridge,09/23/2013 09:00:00 PM,48,-122,21,26,47
8542,FremontBridge,09/23/2013 10:00:00 PM,48,-122,17,14,31
8543,FremontBridge,09/23/2013 11:00:00 PM,48,-122,12,7,19
8544,FremontBridge,09/24/2013 12:00:00 AM,48,-122,4,9,13
8545,FremontBridge,09/24/2013 01:00:00 AM,48,-122,0,3,3
8546,FremontBridge,09/24/2013 02:00:00 AM,48,-122,0,0,0
8547,FremontBridge,09/24/2013 03:00:00 AM,48,-122,0,2,2
8548,FremontBridge,09/24/2013 04:00:00 AM,48,-122,3,3,6
8549,FremontBridge,09/24/2013 05:00:00 AM,48,-122,7,27,34
8550,FremontBridge,09/24/2013 06:00:00 AM,48,-122,33,75,108
8551,FremontBridge,09/24/2013 07:00:00 AM,48,-122,64,209,273
8552,FremontBridge,09/24/2013 08:00:00 AM,48,-122,144,285,429
8553,FremontBridge,09/24/2013 09:00:00 AM,48,-122,99,172,271
8554,FremontBridge,09/24/2013 10:00:00 AM,48,-122,43,62,105
8555,FremontBridge,09/24/2013 11:00:00 AM,48,-122,32,45,77
8556,FremontBridge,09/24/2013 12:00:00 PM,48,-122,61,48,109
8557,FremontBridge,09/24/2013 01:00:00 PM,48,-122,41,60,101
8558,FremontBridge,09/24/2013 02:00:00 PM,48,-122,53,52,105
8559,FremontBridge,09/24/2013 03:00:00 PM,48,-122,80,62,142
8560,FremontBridge,09/24/2013 04:00:00 PM,48,-122,120,102,222
8561,FremontBridge,09/24/2013 05:00:00 PM,48,-122,333,173,506
8562,FremontBridge,09/24/2013 06:00:00 PM,48,-122,234,115,349
8563,FremontBridge,09/24/2013 07:00:00 PM,48,-122,104,73,177
8564,FremontBridge,09/24/2013 08:00:00 PM,48,-122,36,28,64
8565,FremontBridge,09/24/2013 09:00:00 PM,48,-122,32,19,51
8566,FremontBridge,09/24/2013 10:00:00 PM,48,-122,20,14,34
8567,FremontBridge,09/24/2013 11:00:00 PM,48,-122,13,12,25
8568,FremontBridge,09/25/2013 12:00:00 AM,48,-122,1,4,5
8569,FremontBridge,09/25/2013 01:00:00 AM,48,-122,2,1,3
8570,FremontBridge,09/25/2013 02:00:00 AM,48,-122,0,2,2
8571,FremontBridge,09/25/2013 03:00:00 AM,48,-122,0,1,1
8572,FremontBridge,09/25/2013 04:00:00 AM,48,-122,1,6,7
8573,FremontBridge,09/25/2013 05:00:00 AM,48,-122,4,22,26
8574,FremontBridge,09/25/2013 06:00:00 AM,48,-122,21,62,83
8575,FremontBridge,09/25/2013 07:00:00 AM,48,-122,68,181,249
8576,FremontBridge,09/25/2013 08:00:00 AM,48,-122,156,275,431
8577,FremontBridge,09/25/2013 09:00:00 AM,48,-122,95,175,270
8578,FremontBridge,09/25/2013 10:00:00 AM,48,-122,43,57,100
8579,FremontBridge,09/25/2013 11:00:00 AM,48,-122,29,25,54
8580,FremontBridge,09/25/2013 12:00:00 PM,48,-122,37,38,75
8581,FremontBridge,09/25/2013 01:00:00 PM,48,-122,45,41,86
8582,FremontBridge,09/25/2013 02:00:00 PM,48,-122,33,44,77
8583,FremontBridge,09/25/2013 03:00:00 PM,48,-122,59,44,103
8584,FremontBridge,09/25/2013 04:00:00 PM,48,-122,119,104,223
8585,FremontBridge,09/25/2013 05:00:00 PM,48,-122,358,166,524
8586,FremontBridge,09/25/2013 06:00:00 PM,48,-122,258,173,431
8587,FremontBridge,09/25/2013 07:00:00 PM,48,-122,94,76,170
8588,FremontBridge,09/25/2013 08:00:00 PM,48,-122,52,23,75
8589,FremontBridge,09/25/2013 09:00:00 PM,48,-122,26,25,51
8590,FremontBridge,09/25/2013 10:00:00 PM,48,-122,26,14,40
8591,FremontBridge,09/25/2013 11:00:00 PM,48,-122,8,8,16
8592,FremontBridge,09/26/2013 12:00:00 AM,48,-122,5,1,6
8593,FremontBridge,09/26/2013 01:00:00 AM,48,-122,3,2,5
8594,FremontBridge,09/26/2013 02:00:00 AM,48,-122,3,4,7
8595,FremontBridge,09/26/2013 03:00:00 AM,48,-122,0,1,1
8596,FremontBridge,09/26/2013 04:00:00 AM,48,-122,1,3,4
8597,FremontBridge,09/26/2013 05:00:00 AM,48,-122,5,23,28
8598,FremontBridge,09/26/2013 06:00:00 AM,48,-122,33,85,118
8599,FremontBridge,09/26/2013 07:00:00 AM,48,-122,73,226,299
8600,FremontBridge,09/26/2013 08:00:00 AM,48,-122,137,340,477
8601,FremontBridge,09/26/2013 09:00:00 AM,48,-122,121,198,319
8602,FremontBridge,09/26/2013 10:00:00 AM,48,-122,41,60,101
8603,FremontBridge,09/26/2013 11:00:00 AM,48,-122,31,57,88
8604,FremontBridge,09/26/2013 12:00:00 PM,48,-122,37,43,80
8605,FremontBridge,09/26/2013 01:00:00 PM,48,-122,47,51,98
8606,FremontBridge,09/26/2013 02:00:00 PM,48,-122,50,55,105
8607,FremontBridge,09/26/2013 03:00:00 PM,48,-122,85,91,176
8608,FremontBridge,09/26/2013 04:00:00 PM,48,-122,173,109,282
8609,FremontBridge,09/26/2013 05:00:00 PM,48,-122,384,182,566
8610,FremontBridge,09/26/2013 06:00:00 PM,48,-122,272,159,431
8611,FremontBridge,09/26/2013 07:00:00 PM,48,-122,115,76,191
8612,FremontBridge,09/26/2013 08:00:00 PM,48,-122,41,52,93
8613,FremontBridge,09/26/2013 09:00:00 PM,48,-122,35,36,71
8614,FremontBridge,09/26/2013 10:00:00 PM,48,-122,27,13,40
8615,FremontBridge,09/26/2013 11:00:00 PM,48,-122,20,7,27
8616,FremontBridge,09/27/2013 12:00:00 AM,48,-122,9,2,11
8617,FremontBridge,09/27/2013 01:00:00 AM,48,-122,9,1,10
8618,FremontBridge,09/27/2013 02:00:00 AM,48,-122,4,4,8
8619,FremontBridge,09/27/2013 03:00:00 AM,48,-122,4,1,5
8620,FremontBridge,09/27/2013 04:00:00 AM,48,-122,2,4,6
8621,FremontBridge,09/27/2013 05:00:00 AM,48,-122,7,14,21
8622,FremontBridge,09/27/2013 06:00:00 AM,48,-122,38,58,96
8623,FremontBridge,09/27/2013 07:00:00 AM,48,-122,52,132,184
8624,FremontBridge,09/27/2013 08:00:00 AM,48,-122,72,214,286
8625,FremontBridge,09/27/2013 09:00:00 AM,48,-122,67,102,169
8626,FremontBridge,09/27/2013 10:00:00 AM,48,-122,37,50,87
8627,FremontBridge,09/27/2013 11:00:00 AM,48,-122,28,34,62
8628,FremontBridge,09/27/2013 12:00:00 PM,48,-122,22,29,51
8629,FremontBridge,09/27/2013 01:00:00 PM,48,-122,23,39,62
8630,FremontBridge,09/27/2013 02:00:00 PM,48,-122,27,49,76
8631,FremontBridge,09/27/2013 03:00:00 PM,48,-122,54,38,92
8632,FremontBridge,09/27/2013 04:00:00 PM,48,-122,122,64,186
8633,FremontBridge,09/27/2013 05:00:00 PM,48,-122,206,109,315
8634,FremontBridge,09/27/2013 06:00:00 PM,48,-122,136,72,208
8635,FremontBridge,09/27/2013 07:00:00 PM,48,-122,50,36,86
8636,FremontBridge,09/27/2013 08:00:00 PM,48,-122,27,15,42
8637,FremontBridge,09/27/2013 09:00:00 PM,48,-122,16,14,30
8638,FremontBridge,09/27/2013 10:00:00 PM,48,-122,20,14,34
8639,FremontBridge,09/27/2013 11:00:00 PM,48,-122,10,12,22
8640,FremontBridge,09/28/2013 12:00:00 AM,48,-122,8,6,14
8641,FremontBridge,09/28/2013 01:00:00 AM,48,-122,5,1,6
8642,FremontBridge,09/28/2013 02:00:00 AM,48,-122,3,9,12
8643,FremontBridge,09/28/2013 03:00:00 AM,48,-122,3,1,4
8644,FremontBridge,09/28/2013 04:00:00 AM,48,-122,2,3,5
8645,FremontBridge,09/28/2013 05:00:00 AM,48,-122,1,2,3
8646,FremontBridge,09/28/2013 06:00:00 AM,48,-122,8,5,13
8647,FremontBridge,09/28/2013 07:00:00 AM,48,-122,5,9,14
8648,FremontBridge,09/28/2013 08:00:00 AM,48,-122,11,29,40
8649,FremontBridge,09/28/2013 09:00:00 AM,48,-122,16,23,39
8650,FremontBridge,09/28/2013 10:00:00 AM,48,-122,10,29,39
8651,FremontBridge,09/28/2013 11:00:00 AM,48,-122,18,19,37
8652,FremontBridge,09/28/2013 12:00:00 PM,48,-122,10,15,25
8653,FremontBridge,09/28/2013 01:00:00 PM,48,-122,11,13,24
8654,FremontBridge,09/28/2013 02:00:00 PM,48,-122,16,19,35
8655,FremontBridge,09/28/2013 03:00:00 PM,48,-122,13,21,34
8656,FremontBridge,09/28/2013 04:00:00 PM,48,-122,13,15,28
8657,FremontBridge,09/28/2013 05:00:00 PM,48,-122,11,13,24
8658,FremontBridge,09/28/2013 06:00:00 PM,48,-122,7,6,13
8659,FremontBridge,09/28/2013 07:00:00 PM,48,-122,11,12,23
8660,FremontBridge,09/28/2013 08:00:00 PM,48,-122,9,9,18
8661,FremontBridge,09/28/2013 09:00:00 PM,48,-122,4,7,11
8662,FremontBridge,09/28/2013 10:00:00 PM,48,-122,4,3,7
8663,FremontBridge,09/28/2013 11:00:00 PM,48,-122,5,4,9
8664,FremontBridge,09/29/2013 12:00:00 AM,48,-122,3,4,7
8665,FremontBridge,09/29/2013 01:00:00 AM,48,-122,3,5,8
8666,FremontBridge,09/29/2013 02:00:00 AM,48,-122,1,1,2
8667,FremontBridge,09/29/2013 03:00:00 AM,48,-122,2,2,4
8668,FremontBridge,09/29/2013 04:00:00 AM,48,-122,1,3,4
8669,FremontBridge,09/29/2013 05:00:00 AM,48,-122,3,2,5
8670,FremontBridge,09/29/2013 06:00:00 AM,48,-122,3,4,7
8671,FremontBridge,09/29/2013 07:00:00 AM,48,-122,7,4,11
8672,FremontBridge,09/29/2013 08:00:00 AM,48,-122,9,10,19
8673,FremontBridge,09/29/2013 09:00:00 AM,48,-122,20,12,32
8674,FremontBridge,09/29/2013 10:00:00 AM,48,-122,22,26,48
8675,FremontBridge,09/29/2013 11:00:00 AM,48,-122,15,22,37
8676,FremontBridge,09/29/2013 12:00:00 PM,48,-122,14,24,38
8677,FremontBridge,09/29/2013 01:00:00 PM,48,-122,19,17,36
8678,FremontBridge,09/29/2013 02:00:00 PM,48,-122,18,20,38
8679,FremontBridge,09/29/2013 03:00:00 PM,48,-122,19,18,37
8680,FremontBridge,09/29/2013 04:00:00 PM,48,-122,13,27,40
8681,FremontBridge,09/29/2013 05:00:00 PM,48,-122,12,19,31
8682,FremontBridge,09/29/2013 06:00:00 PM,48,-122,15,11,26
8683,FremontBridge,09/29/2013 07:00:00 PM,48,-122,13,5,18
8684,FremontBridge,09/29/2013 08:00:00 PM,48,-122,10,7,17
8685,FremontBridge,09/29/2013 09:00:00 PM,48,-122,5,5,10
8686,FremontBridge,09/29/2013 10:00:00 PM,48,-122,6,0,6
8687,FremontBridge,09/29/2013 11:00:00 PM,48,-122,4,5,9
8688,FremontBridge,09/30/2013 12:00:00 AM,48,-122,2,2,4
8689,FremontBridge,09/30/2013 01:00:00 AM,48,-122,0,4,4
8690,FremontBridge,09/30/2013 02:00:00 AM,48,-122,0,1,1
8691,FremontBridge,09/30/2013 03:00:00 AM,48,-122,1,0,1
8692,FremontBridge,09/30/2013 04:00:00 AM,48,-122,2,4,6
8693,FremontBridge,09/30/2013 05:00:00 AM,48,-122,4,19,23
8694,FremontBridge,09/30/2013 06:00:00 AM,48,-122,26,65,91
8695,FremontBridge,09/30/2013 07:00:00 AM,48,-122,45,127,172
8696,FremontBridge,09/30/2013 08:00:00 AM,48,-122,95,222,317
8697,FremontBridge,09/30/2013 09:00:00 AM,48,-122,86,139,225
8698,FremontBridge,09/30/2013 10:00:00 AM,48,-122,23,41,64
8699,FremontBridge,09/30/2013 11:00:00 AM,48,-122,21,29,50
8700,FremontBridge,09/30/2013 12:00:00 PM,48,-122,14,16,30
8701,FremontBridge,09/30/2013 01:00:00 PM,48,-122,22,33,55
8702,FremontBridge,09/30/2013 02:00:00 PM,48,-122,33,32,65
8703,FremontBridge,09/30/2013 03:00:00 PM,48,-122,45,43,88
8704,FremontBridge,09/30/2013 04:00:00 PM,48,-122,86,79,165
8705,FremontBridge,09/30/2013 05:00:00 PM,48,-122,244,128,372
8706,FremontBridge,09/30/2013 06:00:00 PM,48,-122,193,76,269
8707,FremontBridge,09/30/2013 07:00:00 PM,48,-122,74,46,120
8708,FremontBridge,09/30/2013 08:00:00 PM,48,-122,25,21,46
8709,FremontBridge,09/30/2013 09:00:00 PM,48,-122,22,14,36
8710,FremontBridge,09/30/2013 10:00:00 PM,48,-122,21,12,33
8711,FremontBridge,09/30/2013 11:00:00 PM,48,-122,10,12,22
8712,FremontBridge,10/01/2013 12:00:00 AM,48,-122,4,5,9
8713,FremontBridge,10/01/2013 01:00:00 AM,48,-122,3,0,3
8714,FremontBridge,10/01/2013 02:00:00 AM,48,-122,2,4,6
8715,FremontBridge,10/01/2013 03:00:00 AM,48,-122,0,0,0
8716,FremontBridge,10/01/2013 04:00:00 AM,48,-122,2,3,5
8717,FremontBridge,10/01/2013 05:00:00 AM,48,-122,6,18,24
8718,FremontBridge,10/01/2013 06:00:00 AM,48,-122,26,61,87
8719,FremontBridge,10/01/2013 07:00:00 AM,48,-122,75,189,264
8720,FremontBridge,10/01/2013 08:00:00 AM,48,-122,116,271,387
8721,FremontBridge,10/01/2013 09:00:00 AM,48,-122,74,131,205
8722,FremontBridge,10/01/2013 10:00:00 AM,48,-122,27,53,80
8723,FremontBridge,10/01/2013 11:00:00 AM,48,-122,34,40,74
8724,FremontBridge,10/01/2013 12:00:00 PM,48,-122,32,47,79
8725,FremontBridge,10/01/2013 01:00:00 PM,48,-122,32,35,67
8726,FremontBridge,10/01/2013 02:00:00 PM,48,-122,45,41,86
8727,FremontBridge,10/01/2013 03:00:00 PM,48,-122,58,61,119
8728,FremontBridge,10/01/2013 04:00:00 PM,48,-122,96,91,187
8729,FremontBridge,10/01/2013 05:00:00 PM,48,-122,268,143,411
8730,FremontBridge,10/01/2013 06:00:00 PM,48,-122,220,111,331
8731,FremontBridge,10/01/2013 07:00:00 PM,48,-122,86,46,132
8732,FremontBridge,10/01/2013 08:00:00 PM,48,-122,44,22,66
8733,FremontBridge,10/01/2013 09:00:00 PM,48,-122,28,22,50
8734,FremontBridge,10/01/2013 10:00:00 PM,48,-122,19,10,29
8735,FremontBridge,10/01/2013 11:00:00 PM,48,-122,20,9,29
8736,FremontBridge,10/02/2013 12:00:00 AM,48,-122,4,8,12
8737,FremontBridge,10/02/2013 01:00:00 AM,48,-122,6,2,8
8738,FremontBridge,10/02/2013 02:00:00 AM,48,-122,1,1,2
8739,FremontBridge,10/02/2013 03:00:00 AM,48,-122,0,0,0
8740,FremontBridge,10/02/2013 04:00:00 AM,48,-122,2,6,8
8741,FremontBridge,10/02/2013 05:00:00 AM,48,-122,7,15,22
8742,FremontBridge,10/02/2013 06:00:00 AM,48,-122,27,50,77
8743,FremontBridge,10/02/2013 07:00:00 AM,48,-122,64,142,206
8744,FremontBridge,10/02/2013 08:00:00 AM,48,-122,104,230,334
8745,FremontBridge,10/02/2013 09:00:00 AM,48,-122,76,163,239
8746,FremontBridge,10/02/2013 10:00:00 AM,48,-122,34,43,77
8747,FremontBridge,10/02/2013 11:00:00 AM,48,-122,22,21,43
8748,FremontBridge,10/02/2013 12:00:00 PM,48,-122,17,27,44
8749,FremontBridge,10/02/2013 01:00:00 PM,48,-122,14,25,39
8750,FremontBridge,10/02/2013 02:00:00 PM,48,-122,22,26,48
8751,FremontBridge,10/02/2013 03:00:00 PM,48,-122,47,51,98
8752,FremontBridge,10/02/2013 04:00:00 PM,48,-122,99,59,158
8753,FremontBridge,10/02/2013 05:00:00 PM,48,-122,254,141,395
8754,FremontBridge,10/02/2013 06:00:00 PM,48,-122,202,129,331
8755,FremontBridge,10/02/2013 07:00:00 PM,48,-122,80,48,128
8756,FremontBridge,10/02/2013 08:00:00 PM,48,-122,34,24,58
8757,FremontBridge,10/02/2013 09:00:00 PM,48,-122,21,15,36
8758,FremontBridge,10/02/2013 10:00:00 PM,48,-122,22,9,31
8759,FremontBridge,10/02/2013 11:00:00 PM,48,-122,10,8,18
8760,FremontBridge,10/03/2013 12:00:00 AM,48,-122,2,3,5
8761,FremontBridge,10/03/2013 01:00:00 AM,48,-122,1,2,3
8762,FremontBridge,10/03/2013 02:00:00 AM,48,-122,4,4,8
8763,FremontBridge,10/03/2013 03:00:00 AM,48,-122,3,1,4
8764,FremontBridge,10/03/2013 04:00:00 AM,48,-122,1,5,6
8765,FremontBridge,10/03/2013 05:00:00 AM,48,-122,8,18,26
8766,FremontBridge,10/03/2013 06:00:00 AM,48,-122,36,74,110
8767,FremontBridge,10/03/2013 07:00:00 AM,48,-122,79,204,283
8768,FremontBridge,10/03/2013 08:00:00 AM,48,-122,113,278,391
8769,FremontBridge,10/03/2013 09:00:00 AM,48,-122,108,175,283
8770,FremontBridge,10/03/2013 10:00:00 AM,48,-122,51,68,119
8771,FremontBridge,10/03/2013 11:00:00 AM,48,-122,31,42,73
8772,FremontBridge,10/03/2013 12:00:00 PM,48,-122,35,42,77
8773,FremontBridge,10/03/2013 01:00:00 PM,48,-122,45,46,91
8774,FremontBridge,10/03/2013 02:00:00 PM,48,-122,44,38,82
8775,FremontBridge,10/03/2013 03:00:00 PM,48,-122,75,73,148
8776,FremontBridge,10/03/2013 04:00:00 PM,48,-122,129,101,230
8777,FremontBridge,10/03/2013 05:00:00 PM,48,-122,352,172,524
8778,FremontBridge,10/03/2013 06:00:00 PM,48,-122,255,143,398
8779,FremontBridge,10/03/2013 07:00:00 PM,48,-122,103,87,190
8780,FremontBridge,10/03/2013 08:00:00 PM,48,-122,44,42,86
8781,FremontBridge,10/03/2013 09:00:00 PM,48,-122,32,30,62
8782,FremontBridge,10/03/2013 10:00:00 PM,48,-122,15,14,29
8783,FremontBridge,10/03/2013 11:00:00 PM,48,-122,15,8,23
8784,FremontBridge,10/04/2013 12:00:00 AM,48,-122,5,6,11
8785,FremontBridge,10/04/2013 01:00:00 AM,48,-122,12,4,16
8786,FremontBridge,10/04/2013 02:00:00 AM,48,-122,3,2,5
8787,FremontBridge,10/04/2013 03:00:00 AM,48,-122,0,2,2
8788,FremontBridge,10/04/2013 04:00:00 AM,48,-122,1,2,3
8789,FremontBridge,10/04/2013 05:00:00 AM,48,-122,2,17,19
8790,FremontBridge,10/04/2013 06:00:00 AM,48,-122,33,78,111
8791,FremontBridge,10/04/2013 07:00:00 AM,48,-122,73,154,227
8792,FremontBridge,10/04/2013 08:00:00 AM,48,-122,112,290,402
8793,FremontBridge,10/04/2013 09:00:00 AM,48,-122,103,167,270
8794,FremontBridge,10/04/2013 10:00:00 AM,48,-122,44,72,116
8795,FremontBridge,10/04/2013 11:00:00 AM,48,-122,26,45,71
8796,FremontBridge,10/04/2013 12:00:00 PM,48,-122,38,56,94
8797,FremontBridge,10/04/2013 01:00:00 PM,48,-122,66,51,117
8798,FremontBridge,10/04/2013 02:00:00 PM,48,-122,60,64,124
8799,FremontBridge,10/04/2013 03:00:00 PM,48,-122,87,77,164
8800,FremontBridge,10/04/2013 04:00:00 PM,48,-122,145,117,262
8801,FremontBridge,10/04/2013 05:00:00 PM,48,-122,343,182,525
8802,FremontBridge,10/04/2013 06:00:00 PM,48,-122,197,148,345
8803,FremontBridge,10/04/2013 07:00:00 PM,48,-122,90,67,157
8804,FremontBridge,10/04/2013 08:00:00 PM,48,-122,39,27,66
8805,FremontBridge,10/04/2013 09:00:00 PM,48,-122,25,25,50
8806,FremontBridge,10/04/2013 10:00:00 PM,48,-122,17,18,35
8807,FremontBridge,10/04/2013 11:00:00 PM,48,-122,14,8,22
8808,FremontBridge,10/05/2013 12:00:00 AM,48,-122,20,12,32
8809,FremontBridge,10/05/2013 01:00:00 AM,48,-122,4,2,6
8810,FremontBridge,10/05/2013 02:00:00 AM,48,-122,7,2,9
8811,FremontBridge,10/05/2013 03:00:00 AM,48,-122,4,2,6
8812,FremontBridge,10/05/2013 04:00:00 AM,48,-122,2,4,6
8813,FremontBridge,10/05/2013 05:00:00 AM,48,-122,4,9,13
8814,FremontBridge,10/05/2013 06:00:00 AM,48,-122,9,19,28
8815,FremontBridge,10/05/2013 07:00:00 AM,48,-122,12,24,36
8816,FremontBridge,10/05/2013 08:00:00 AM,48,-122,31,57,88
8817,FremontBridge,10/05/2013 09:00:00 AM,48,-122,52,58,110
8818,FremontBridge,10/05/2013 10:00:00 AM,48,-122,48,60,108
8819,FremontBridge,10/05/2013 11:00:00 AM,48,-122,60,95,155
8820,FremontBridge,10/05/2013 12:00:00 PM,48,-122,79,104,183
8821,FremontBridge,10/05/2013 01:00:00 PM,48,-122,93,136,229
8822,FremontBridge,10/05/2013 02:00:00 PM,48,-122,96,125,221
8823,FremontBridge,10/05/2013 03:00:00 PM,48,-122,109,121,230
8824,FremontBridge,10/05/2013 04:00:00 PM,48,-122,67,108,175
8825,FremontBridge,10/05/2013 05:00:00 PM,48,-122,80,116,196
8826,FremontBridge,10/05/2013 06:00:00 PM,48,-122,46,72,118
8827,FremontBridge,10/05/2013 07:00:00 PM,48,-122,43,31,74
8828,FremontBridge,10/05/2013 08:00:00 PM,48,-122,25,17,42
8829,FremontBridge,10/05/2013 09:00:00 PM,48,-122,16,12,28
8830,FremontBridge,10/05/2013 10:00:00 PM,48,-122,18,13,31
8831,FremontBridge,10/05/2013 11:00:00 PM,48,-122,17,12,29
8832,FremontBridge,10/06/2013 12:00:00 AM,48,-122,12,6,18
8833,FremontBridge,10/06/2013 01:00:00 AM,48,-122,2,8,10
8834,FremontBridge,10/06/2013 02:00:00 AM,48,-122,6,6,12
8835,FremontBridge,10/06/2013 03:00:00 AM,48,-122,3,6,9
8836,FremontBridge,10/06/2013 04:00:00 AM,48,-122,0,1,1
8837,FremontBridge,10/06/2013 05:00:00 AM,48,-122,4,5,9
8838,FremontBridge,10/06/2013 06:00:00 AM,48,-122,6,9,15
8839,FremontBridge,10/06/2013 07:00:00 AM,48,-122,11,15,26
8840,FremontBridge,10/06/2013 08:00:00 AM,48,-122,20,31,51
8841,FremontBridge,10/06/2013 09:00:00 AM,48,-122,31,69,100
8842,FremontBridge,10/06/2013 10:00:00 AM,48,-122,68,64,132
8843,FremontBridge,10/06/2013 11:00:00 AM,48,-122,71,68,139
8844,FremontBridge,10/06/2013 12:00:00 PM,48,-122,63,77,140
8845,FremontBridge,10/06/2013 01:00:00 PM,48,-122,76,117,193
8846,FremontBridge,10/06/2013 02:00:00 PM,48,-122,120,120,240
8847,FremontBridge,10/06/2013 03:00:00 PM,48,-122,132,166,298
8848,FremontBridge,10/06/2013 04:00:00 PM,48,-122,94,161,255
8849,FremontBridge,10/06/2013 05:00:00 PM,48,-122,82,131,213
8850,FremontBridge,10/06/2013 06:00:00 PM,48,-122,57,74,131
8851,FremontBridge,10/06/2013 07:00:00 PM,48,-122,30,31,61
8852,FremontBridge,10/06/2013 08:00:00 PM,48,-122,26,26,52
8853,FremontBridge,10/06/2013 09:00:00 PM,48,-122,11,9,20
8854,FremontBridge,10/06/2013 10:00:00 PM,48,-122,12,9,21
8855,FremontBridge,10/06/2013 11:00:00 PM,48,-122,17,7,24
8856,FremontBridge,10/07/2013 12:00:00 AM,48,-122,6,3,9
8857,FremontBridge,10/07/2013 01:00:00 AM,48,-122,0,2,2
8858,FremontBridge,10/07/2013 02:00:00 AM,48,-122,2,2,4
8859,FremontBridge,10/07/2013 03:00:00 AM,48,-122,1,0,1
8860,FremontBridge,10/07/2013 04:00:00 AM,48,-122,2,4,6
8861,FremontBridge,10/07/2013 05:00:00 AM,48,-122,6,17,23
8862,FremontBridge,10/07/2013 06:00:00 AM,48,-122,37,73,110
8863,FremontBridge,10/07/2013 07:00:00 AM,48,-122,61,191,252
8864,FremontBridge,10/07/2013 08:00:00 AM,48,-122,137,252,389
8865,FremontBridge,10/07/2013 09:00:00 AM,48,-122,111,163,274
8866,FremontBridge,10/07/2013 10:00:00 AM,48,-122,46,65,111
8867,FremontBridge,10/07/2013 11:00:00 AM,48,-122,29,29,58
8868,FremontBridge,10/07/2013 12:00:00 PM,48,-122,32,22,54
8869,FremontBridge,10/07/2013 01:00:00 PM,48,-122,30,33,63
8870,FremontBridge,10/07/2013 02:00:00 PM,48,-122,41,40,81
8871,FremontBridge,10/07/2013 03:00:00 PM,48,-122,62,49,111
8872,FremontBridge,10/07/2013 04:00:00 PM,48,-122,127,82,209
8873,FremontBridge,10/07/2013 05:00:00 PM,48,-122,334,167,501
8874,FremontBridge,10/07/2013 06:00:00 PM,48,-122,239,130,369
8875,FremontBridge,10/07/2013 07:00:00 PM,48,-122,87,50,137
8876,FremontBridge,10/07/2013 08:00:00 PM,48,-122,42,29,71
8877,FremontBridge,10/07/2013 09:00:00 PM,48,-122,30,27,57
8878,FremontBridge,10/07/2013 10:00:00 PM,48,-122,13,16,29
8879,FremontBridge,10/07/2013 11:00:00 PM,48,-122,12,7,19
8880,FremontBridge,10/08/2013 12:00:00 AM,48,-122,7,8,15
8881,FremontBridge,10/08/2013 01:00:00 AM,48,-122,2,1,3
8882,FremontBridge,10/08/2013 02:00:00 AM,48,-122,1,4,5
8883,FremontBridge,10/08/2013 03:00:00 AM,48,-122,0,1,1
8884,FremontBridge,10/08/2013 04:00:00 AM,48,-122,4,5,9
8885,FremontBridge,10/08/2013 05:00:00 AM,48,-122,4,24,28
8886,FremontBridge,10/08/2013 06:00:00 AM,48,-122,37,80,117
8887,FremontBridge,10/08/2013 07:00:00 AM,48,-122,80,209,289
8888,FremontBridge,10/08/2013 08:00:00 AM,48,-122,136,281,417
8889,FremontBridge,10/08/2013 09:00:00 AM,48,-122,92,146,238
8890,FremontBridge,10/08/2013 10:00:00 AM,48,-122,43,61,104
8891,FremontBridge,10/08/2013 11:00:00 AM,48,-122,18,29,47
8892,FremontBridge,10/08/2013 12:00:00 PM,48,-122,25,38,63
8893,FremontBridge,10/08/2013 01:00:00 PM,48,-122,29,26,55
8894,FremontBridge,10/08/2013 02:00:00 PM,48,-122,31,33,64
8895,FremontBridge,10/08/2013 03:00:00 PM,48,-122,49,45,94
8896,FremontBridge,10/08/2013 04:00:00 PM,48,-122,109,91,200
8897,FremontBridge,10/08/2013 05:00:00 PM,48,-122,307,139,446
8898,FremontBridge,10/08/2013 06:00:00 PM,48,-122,245,120,365
8899,FremontBridge,10/08/2013 07:00:00 PM,48,-122,106,62,168
8900,FremontBridge,10/08/2013 08:00:00 PM,48,-122,32,36,68
8901,FremontBridge,10/08/2013 09:00:00 PM,48,-122,28,24,52
8902,FremontBridge,10/08/2013 10:00:00 PM,48,-122,13,13,26
8903,FremontBridge,10/08/2013 11:00:00 PM,48,-122,8,8,16
8904,FremontBridge,10/09/2013 12:00:00 AM,48,-122,5,5,10
8905,FremontBridge,10/09/2013 01:00:00 AM,48,-122,0,5,5
8906,FremontBridge,10/09/2013 02:00:00 AM,48,-122,1,2,3
8907,FremontBridge,10/09/2013 03:00:00 AM,48,-122,1,0,1
8908,FremontBridge,10/09/2013 04:00:00 AM,48,-122,2,3,5
8909,FremontBridge,10/09/2013 05:00:00 AM,48,-122,9,20,29
8910,FremontBridge,10/09/2013 06:00:00 AM,48,-122,33,83,116
8911,FremontBridge,10/09/2013 07:00:00 AM,48,-122,83,205,288
8912,FremontBridge,10/09/2013 08:00:00 AM,48,-122,141,336,477
8913,FremontBridge,10/09/2013 09:00:00 AM,48,-122,136,203,339
8914,FremontBridge,10/09/2013 10:00:00 AM,48,-122,51,75,126
8915,FremontBridge,10/09/2013 11:00:00 AM,48,-122,42,47,89
8916,FremontBridge,10/09/2013 12:00:00 PM,48,-122,49,65,114
8917,FremontBridge,10/09/2013 01:00:00 PM,48,-122,45,45,90
8918,FremontBridge,10/09/2013 02:00:00 PM,48,-122,51,53,104
8919,FremontBridge,10/09/2013 03:00:00 PM,48,-122,71,67,138
8920,FremontBridge,10/09/2013 04:00:00 PM,48,-122,156,123,279
8921,FremontBridge,10/09/2013 05:00:00 PM,48,-122,373,200,573
8922,FremontBridge,10/09/2013 06:00:00 PM,48,-122,273,154,427
8923,FremontBridge,10/09/2013 07:00:00 PM,48,-122,86,69,155
8924,FremontBridge,10/09/2013 08:00:00 PM,48,-122,49,29,78
8925,FremontBridge,10/09/2013 09:00:00 PM,48,-122,51,29,80
8926,FremontBridge,10/09/2013 10:00:00 PM,48,-122,30,12,42
8927,FremontBridge,10/09/2013 11:00:00 PM,48,-122,10,9,19
8928,FremontBridge,10/10/2013 12:00:00 AM,48,-122,8,3,11
8929,FremontBridge,10/10/2013 01:00:00 AM,48,-122,5,1,6
8930,FremontBridge,10/10/2013 02:00:00 AM,48,-122,2,3,5
8931,FremontBridge,10/10/2013 03:00:00 AM,48,-122,1,0,1
8932,FremontBridge,10/10/2013 04:00:00 AM,48,-122,0,4,4
8933,FremontBridge,10/10/2013 05:00:00 AM,48,-122,6,19,25
8934,FremontBridge,10/10/2013 06:00:00 AM,48,-122,39,77,116
8935,FremontBridge,10/10/2013 07:00:00 AM,48,-122,76,199,275
8936,FremontBridge,10/10/2013 08:00:00 AM,48,-122,110,292,402
8937,FremontBridge,10/10/2013 09:00:00 AM,48,-122,104,179,283
8938,FremontBridge,10/10/2013 10:00:00 AM,48,-122,46,77,123
8939,FremontBridge,10/10/2013 11:00:00 AM,48,-122,33,49,82
8940,FremontBridge,10/10/2013 12:00:00 PM,48,-122,31,50,81
8941,FremontBridge,10/10/2013 01:00:00 PM,48,-122,57,51,108
8942,FremontBridge,10/10/2013 02:00:00 PM,48,-122,46,59,105
8943,FremontBridge,10/10/2013 03:00:00 PM,48,-122,64,91,155
8944,FremontBridge,10/10/2013 04:00:00 PM,48,-122,116,80,196
8945,FremontBridge,10/10/2013 05:00:00 PM,48,-122,324,153,477
8946,FremontBridge,10/10/2013 06:00:00 PM,48,-122,244,127,371
8947,FremontBridge,10/10/2013 07:00:00 PM,48,-122,90,68,158
8948,FremontBridge,10/10/2013 08:00:00 PM,48,-122,46,30,76
8949,FremontBridge,10/10/2013 09:00:00 PM,48,-122,28,21,49
8950,FremontBridge,10/10/2013 10:00:00 PM,48,-122,24,16,40
8951,FremontBridge,10/10/2013 11:00:00 PM,48,-122,13,10,23
8952,FremontBridge,10/11/2013 12:00:00 AM,48,-122,11,10,21
8953,FremontBridge,10/11/2013 01:00:00 AM,48,-122,1,5,6
8954,FremontBridge,10/11/2013 02:00:00 AM,48,-122,3,4,7
8955,FremontBridge,10/11/2013 03:00:00 AM,48,-122,0,2,2
8956,FremontBridge,10/11/2013 04:00:00 AM,48,-122,1,5,6
8957,FremontBridge,10/11/2013 05:00:00 AM,48,-122,3,14,17
8958,FremontBridge,10/11/2013 06:00:00 AM,48,-122,26,68,94
8959,FremontBridge,10/11/2013 07:00:00 AM,48,-122,49,135,184
8960,FremontBridge,10/11/2013 08:00:00 AM,48,-122,97,207,304
8961,FremontBridge,10/11/2013 09:00:00 AM,48,-122,70,139,209
8962,FremontBridge,10/11/2013 10:00:00 AM,48,-122,43,41,84
8963,FremontBridge,10/11/2013 11:00:00 AM,48,-122,12,28,40
8964,FremontBridge,10/11/2013 12:00:00 PM,48,-122,32,33,65
8965,FremontBridge,10/11/2013 01:00:00 PM,48,-122,24,30,54
8966,FremontBridge,10/11/2013 02:00:00 PM,48,-122,40,44,84
8967,FremontBridge,10/11/2013 03:00:00 PM,48,-122,40,47,87
8968,FremontBridge,10/11/2013 04:00:00 PM,48,-122,138,88,226
8969,FremontBridge,10/11/2013 05:00:00 PM,48,-122,212,118,330
8970,FremontBridge,10/11/2013 06:00:00 PM,48,-122,159,86,245
8971,FremontBridge,10/11/2013 07:00:00 PM,48,-122,72,43,115
8972,FremontBridge,10/11/2013 08:00:00 PM,48,-122,29,25,54
8973,FremontBridge,10/11/2013 09:00:00 PM,48,-122,10,12,22
8974,FremontBridge,10/11/2013 10:00:00 PM,48,-122,25,23,48
8975,FremontBridge,10/11/2013 11:00:00 PM,48,-122,21,9,30
8976,FremontBridge,10/12/2013 12:00:00 AM,48,-122,7,8,15
8977,FremontBridge,10/12/2013 01:00:00 AM,48,-122,3,5,8
8978,FremontBridge,10/12/2013 02:00:00 AM,48,-122,9,5,14
8979,FremontBridge,10/12/2013 03:00:00 AM,48,-122,2,1,3
8980,FremontBridge,10/12/2013 04:00:00 AM,48,-122,1,2,3
8981,FremontBridge,10/12/2013 05:00:00 AM,48,-122,2,3,5
8982,FremontBridge,10/12/2013 06:00:00 AM,48,-122,7,14,21
8983,FremontBridge,10/12/2013 07:00:00 AM,48,-122,11,12,23
8984,FremontBridge,10/12/2013 08:00:00 AM,48,-122,16,28,44
8985,FremontBridge,10/12/2013 09:00:00 AM,48,-122,35,34,69
8986,FremontBridge,10/12/2013 10:00:00 AM,48,-122,34,28,62
8987,FremontBridge,10/12/2013 11:00:00 AM,48,-122,38,53,91
8988,FremontBridge,10/12/2013 12:00:00 PM,48,-122,50,63,113
8989,FremontBridge,10/12/2013 01:00:00 PM,48,-122,34,43,77
8990,FremontBridge,10/12/2013 02:00:00 PM,48,-122,40,37,77
8991,FremontBridge,10/12/2013 03:00:00 PM,48,-122,61,55,116
8992,FremontBridge,10/12/2013 04:00:00 PM,48,-122,68,62,130
8993,FremontBridge,10/12/2013 05:00:00 PM,48,-122,50,69,119
8994,FremontBridge,10/12/2013 06:00:00 PM,48,-122,48,48,96
8995,FremontBridge,10/12/2013 07:00:00 PM,48,-122,29,28,57
8996,FremontBridge,10/12/2013 08:00:00 PM,48,-122,11,18,29
8997,FremontBridge,10/12/2013 09:00:00 PM,48,-122,15,19,34
8998,FremontBridge,10/12/2013 10:00:00 PM,48,-122,23,17,40
8999,FremontBridge,10/12/2013 11:00:00 PM,48,-122,8,20,28
9000,FremontBridge,10/13/2013 12:00:00 AM,48,-122,10,7,17
9001,FremontBridge,10/13/2013 01:00:00 AM,48,-122,5,3,8
9002,FremontBridge,10/13/2013 02:00:00 AM,48,-122,5,2,7
9003,FremontBridge,10/13/2013 03:00:00 AM,48,-122,2,1,3
9004,FremontBridge,10/13/2013 04:00:00 AM,48,-122,2,3,5
9005,FremontBridge,10/13/2013 05:00:00 AM,48,-122,3,2,5
9006,FremontBridge,10/13/2013 06:00:00 AM,48,-122,3,5,8
9007,FremontBridge,10/13/2013 07:00:00 AM,48,-122,8,11,19
9008,FremontBridge,10/13/2013 08:00:00 AM,48,-122,28,42,70
9009,FremontBridge,10/13/2013 09:00:00 AM,48,-122,29,31,60
9010,FremontBridge,10/13/2013 10:00:00 AM,48,-122,43,42,85
9011,FremontBridge,10/13/2013 11:00:00 AM,48,-122,55,68,123
9012,FremontBridge,10/13/2013 12:00:00 PM,48,-122,43,67,110
9013,FremontBridge,10/13/2013 01:00:00 PM,48,-122,47,64,111
9014,FremontBridge,10/13/2013 02:00:00 PM,48,-122,82,89,171
9015,FremontBridge,10/13/2013 03:00:00 PM,48,-122,69,123,192
9016,FremontBridge,10/13/2013 04:00:00 PM,48,-122,77,86,163
9017,FremontBridge,10/13/2013 05:00:00 PM,48,-122,59,65,124
9018,FremontBridge,10/13/2013 06:00:00 PM,48,-122,46,47,93
9019,FremontBridge,10/13/2013 07:00:00 PM,48,-122,20,29,49
9020,FremontBridge,10/13/2013 08:00:00 PM,48,-122,19,10,29
9021,FremontBridge,10/13/2013 09:00:00 PM,48,-122,14,9,23
9022,FremontBridge,10/13/2013 10:00:00 PM,48,-122,15,10,25
9023,FremontBridge,10/13/2013 11:00:00 PM,48,-122,12,3,15
9024,FremontBridge,10/14/2013 12:00:00 AM,48,-122,7,6,13
9025,FremontBridge,10/14/2013 01:00:00 AM,48,-122,1,1,2
9026,FremontBridge,10/14/2013 02:00:00 AM,48,-122,0,7,7
9027,FremontBridge,10/14/2013 03:00:00 AM,48,-122,0,2,2
9028,FremontBridge,10/14/2013 04:00:00 AM,48,-122,2,4,6
9029,FremontBridge,10/14/2013 05:00:00 AM,48,-122,7,22,29
9030,FremontBridge,10/14/2013 06:00:00 AM,48,-122,27,82,109
9031,FremontBridge,10/14/2013 07:00:00 AM,48,-122,80,189,269
9032,FremontBridge,10/14/2013 08:00:00 AM,48,-122,125,304,429
9033,FremontBridge,10/14/2013 09:00:00 AM,48,-122,108,210,318
9034,FremontBridge,10/14/2013 10:00:00 AM,48,-122,45,60,105
9035,FremontBridge,10/14/2013 11:00:00 AM,48,-122,30,41,71
9036,FremontBridge,10/14/2013 12:00:00 PM,48,-122,43,49,92
9037,FremontBridge,10/14/2013 01:00:00 PM,48,-122,59,40,99
9038,FremontBridge,10/14/2013 02:00:00 PM,48,-122,62,70,132
9039,FremontBridge,10/14/2013 03:00:00 PM,48,-122,68,84,152
9040,FremontBridge,10/14/2013 04:00:00 PM,48,-122,130,111,241
9041,FremontBridge,10/14/2013 05:00:00 PM,48,-122,354,208,562
9042,FremontBridge,10/14/2013 06:00:00 PM,48,-122,250,150,400
9043,FremontBridge,10/14/2013 07:00:00 PM,48,-122,102,57,159
9044,FremontBridge,10/14/2013 08:00:00 PM,48,-122,48,43,91
9045,FremontBridge,10/14/2013 09:00:00 PM,48,-122,26,25,51
9046,FremontBridge,10/14/2013 10:00:00 PM,48,-122,31,13,44
9047,FremontBridge,10/14/2013 11:00:00 PM,48,-122,13,9,22
9048,FremontBridge,10/15/2013 12:00:00 AM,48,-122,9,6,15
9049,FremontBridge,10/15/2013 01:00:00 AM,48,-122,3,2,5
9050,FremontBridge,10/15/2013 02:00:00 AM,48,-122,3,5,8
9051,FremontBridge,10/15/2013 03:00:00 AM,48,-122,3,1,4
9052,FremontBridge,10/15/2013 04:00:00 AM,48,-122,4,4,8
9053,FremontBridge,10/15/2013 05:00:00 AM,48,-122,7,24,31
9054,FremontBridge,10/15/2013 06:00:00 AM,48,-122,44,78,122
9055,FremontBridge,10/15/2013 07:00:00 AM,48,-122,82,224,306
9056,FremontBridge,10/15/2013 08:00:00 AM,48,-122,146,301,447
9057,FremontBridge,10/15/2013 09:00:00 AM,48,-122,102,185,287
9058,FremontBridge,10/15/2013 10:00:00 AM,48,-122,51,70,121
9059,FremontBridge,10/15/2013 11:00:00 AM,48,-122,36,50,86
9060,FremontBridge,10/15/2013 12:00:00 PM,48,-122,41,49,90
9061,FremontBridge,10/15/2013 01:00:00 PM,48,-122,50,43,93
9062,FremontBridge,10/15/2013 02:00:00 PM,48,-122,56,66,122
9063,FremontBridge,10/15/2013 03:00:00 PM,48,-122,78,64,142
9064,FremontBridge,10/15/2013 04:00:00 PM,48,-122,125,100,225
9065,FremontBridge,10/15/2013 05:00:00 PM,48,-122,349,182,531
9066,FremontBridge,10/15/2013 06:00:00 PM,48,-122,268,162,430
9067,FremontBridge,10/15/2013 07:00:00 PM,48,-122,114,70,184
9068,FremontBridge,10/15/2013 08:00:00 PM,48,-122,50,36,86
9069,FremontBridge,10/15/2013 09:00:00 PM,48,-122,40,28,68
9070,FremontBridge,10/15/2013 10:00:00 PM,48,-122,16,16,32
9071,FremontBridge,10/15/2013 11:00:00 PM,48,-122,10,11,21
9072,FremontBridge,10/16/2013 12:00:00 AM,48,-122,3,3,6
9073,FremontBridge,10/16/2013 01:00:00 AM,48,-122,1,6,7
9074,FremontBridge,10/16/2013 02:00:00 AM,48,-122,3,3,6
9075,FremontBridge,10/16/2013 03:00:00 AM,48,-122,1,1,2
9076,FremontBridge,10/16/2013 04:00:00 AM,48,-122,5,7,12
9077,FremontBridge,10/16/2013 05:00:00 AM,48,-122,6,16,22
9078,FremontBridge,10/16/2013 06:00:00 AM,48,-122,30,83,113
9079,FremontBridge,10/16/2013 07:00:00 AM,48,-122,77,224,301
9080,FremontBridge,10/16/2013 08:00:00 AM,48,-122,137,297,434
9081,FremontBridge,10/16/2013 09:00:00 AM,48,-122,92,191,283
9082,FremontBridge,10/16/2013 10:00:00 AM,48,-122,45,79,124
9083,FremontBridge,10/16/2013 11:00:00 AM,48,-122,33,59,92
9084,FremontBridge,10/16/2013 12:00:00 PM,48,-122,31,50,81
9085,FremontBridge,10/16/2013 01:00:00 PM,48,-122,42,36,78
9086,FremontBridge,10/16/2013 02:00:00 PM,48,-122,50,48,98
9087,FremontBridge,10/16/2013 03:00:00 PM,48,-122,72,64,136
9088,FremontBridge,10/16/2013 04:00:00 PM,48,-122,136,96,232
9089,FremontBridge,10/16/2013 05:00:00 PM,48,-122,340,180,520
9090,FremontBridge,10/16/2013 06:00:00 PM,48,-122,264,176,440
9091,FremontBridge,10/16/2013 07:00:00 PM,48,-122,110,60,170
9092,FremontBridge,10/16/2013 08:00:00 PM,48,-122,55,22,77
9093,FremontBridge,10/16/2013 09:00:00 PM,48,-122,30,17,47
9094,FremontBridge,10/16/2013 10:00:00 PM,48,-122,19,19,38
9095,FremontBridge,10/16/2013 11:00:00 PM,48,-122,15,6,21
9096,FremontBridge,10/17/2013 12:00:00 AM,48,-122,13,5,18
9097,FremontBridge,10/17/2013 01:00:00 AM,48,-122,2,0,2
9098,FremontBridge,10/17/2013 02:00:00 AM,48,-122,2,2,4
9099,FremontBridge,10/17/2013 03:00:00 AM,48,-122,0,2,2
9100,FremontBridge,10/17/2013 04:00:00 AM,48,-122,0,4,4
9101,FremontBridge,10/17/2013 05:00:00 AM,48,-122,3,17,20
9102,FremontBridge,10/17/2013 06:00:00 AM,48,-122,33,88,121
9103,FremontBridge,10/17/2013 07:00:00 AM,48,-122,70,202,272
9104,FremontBridge,10/17/2013 08:00:00 AM,48,-122,118,297,415
9105,FremontBridge,10/17/2013 09:00:00 AM,48,-122,96,184,280
9106,FremontBridge,10/17/2013 10:00:00 AM,48,-122,54,69,123
9107,FremontBridge,10/17/2013 11:00:00 AM,48,-122,26,44,70
9108,FremontBridge,10/17/2013 12:00:00 PM,48,-122,41,50,91
9109,FremontBridge,10/17/2013 01:00:00 PM,48,-122,35,45,80
9110,FremontBridge,10/17/2013 02:00:00 PM,48,-122,31,38,69
9111,FremontBridge,10/17/2013 03:00:00 PM,48,-122,74,62,136
9112,FremontBridge,10/17/2013 04:00:00 PM,48,-122,153,100,253
9113,FremontBridge,10/17/2013 05:00:00 PM,48,-122,344,185,529
9114,FremontBridge,10/17/2013 06:00:00 PM,48,-122,238,122,360
9115,FremontBridge,10/17/2013 07:00:00 PM,48,-122,82,63,145
9116,FremontBridge,10/17/2013 08:00:00 PM,48,-122,38,80,118
9117,FremontBridge,10/17/2013 09:00:00 PM,48,-122,33,30,63
9118,FremontBridge,10/17/2013 10:00:00 PM,48,-122,28,20,48
9119,FremontBridge,10/17/2013 11:00:00 PM,48,-122,15,13,28
9120,FremontBridge,10/18/2013 12:00:00 AM,48,-122,16,6,22
9121,FremontBridge,10/18/2013 01:00:00 AM,48,-122,6,4,10
9122,FremontBridge,10/18/2013 02:00:00 AM,48,-122,2,4,6
9123,FremontBridge,10/18/2013 03:00:00 AM,48,-122,0,2,2
9124,FremontBridge,10/18/2013 04:00:00 AM,48,-122,1,5,6
9125,FremontBridge,10/18/2013 05:00:00 AM,48,-122,7,19,26
9126,FremontBridge,10/18/2013 06:00:00 AM,48,-122,33,68,101
9127,FremontBridge,10/18/2013 07:00:00 AM,48,-122,58,170,228
9128,FremontBridge,10/18/2013 08:00:00 AM,48,-122,102,259,361
9129,FremontBridge,10/18/2013 09:00:00 AM,48,-122,90,174,264
9130,FremontBridge,10/18/2013 10:00:00 AM,48,-122,61,65,126
9131,FremontBridge,10/18/2013 11:00:00 AM,48,-122,23,41,64
9132,FremontBridge,10/18/2013 12:00:00 PM,48,-122,39,42,81
9133,FremontBridge,10/18/2013 01:00:00 PM,48,-122,37,49,86
9134,FremontBridge,10/18/2013 02:00:00 PM,48,-122,47,56,103
9135,FremontBridge,10/18/2013 03:00:00 PM,48,-122,63,64,127
9136,FremontBridge,10/18/2013 04:00:00 PM,48,-122,174,109,283
9137,FremontBridge,10/18/2013 05:00:00 PM,48,-122,298,164,462
9138,FremontBridge,10/18/2013 06:00:00 PM,48,-122,221,110,331
9139,FremontBridge,10/18/2013 07:00:00 PM,48,-122,63,58,121
9140,FremontBridge,10/18/2013 08:00:00 PM,48,-122,34,27,61
9141,FremontBridge,10/18/2013 09:00:00 PM,48,-122,14,12,26
9142,FremontBridge,10/18/2013 10:00:00 PM,48,-122,6,14,20
9143,FremontBridge,10/18/2013 11:00:00 PM,48,-122,17,16,33
9144,FremontBridge,10/19/2013 12:00:00 AM,48,-122,11,8,19
9145,FremontBridge,10/19/2013 01:00:00 AM,48,-122,3,6,9
9146,FremontBridge,10/19/2013 02:00:00 AM,48,-122,2,4,6
9147,FremontBridge,10/19/2013 03:00:00 AM,48,-122,0,3,3
9148,FremontBridge,10/19/2013 04:00:00 AM,48,-122,3,2,5
9149,FremontBridge,10/19/2013 05:00:00 AM,48,-122,1,6,7
9150,FremontBridge,10/19/2013 06:00:00 AM,48,-122,12,11,23
9151,FremontBridge,10/19/2013 07:00:00 AM,48,-122,8,18,26
9152,FremontBridge,10/19/2013 08:00:00 AM,48,-122,15,36,51
9153,FremontBridge,10/19/2013 09:00:00 AM,48,-122,31,52,83
9154,FremontBridge,10/19/2013 10:00:00 AM,48,-122,42,47,89
9155,FremontBridge,10/19/2013 11:00:00 AM,48,-122,27,43,70
9156,FremontBridge,10/19/2013 12:00:00 PM,48,-122,32,39,71
9157,FremontBridge,10/19/2013 01:00:00 PM,48,-122,38,47,85
9158,FremontBridge,10/19/2013 02:00:00 PM,48,-122,55,33,88
9159,FremontBridge,10/19/2013 03:00:00 PM,48,-122,51,65,116
9160,FremontBridge,10/19/2013 04:00:00 PM,48,-122,36,49,85
9161,FremontBridge,10/19/2013 05:00:00 PM,48,-122,36,53,89
9162,FremontBridge,10/19/2013 06:00:00 PM,48,-122,36,29,65
9163,FremontBridge,10/19/2013 07:00:00 PM,48,-122,21,25,46
9164,FremontBridge,10/19/2013 08:00:00 PM,48,-122,14,20,34
9165,FremontBridge,10/19/2013 09:00:00 PM,48,-122,6,12,18
9166,FremontBridge,10/19/2013 10:00:00 PM,48,-122,14,11,25
9167,FremontBridge,10/19/2013 11:00:00 PM,48,-122,16,5,21
9168,FremontBridge,10/20/2013 12:00:00 AM,48,-122,12,9,21
9169,FremontBridge,10/20/2013 01:00:00 AM,48,-122,8,5,13
9170,FremontBridge,10/20/2013 02:00:00 AM,48,-122,7,6,13
9171,FremontBridge,10/20/2013 03:00:00 AM,48,-122,9,1,10
9172,FremontBridge,10/20/2013 04:00:00 AM,48,-122,4,2,6
9173,FremontBridge,10/20/2013 05:00:00 AM,48,-122,4,4,8
9174,FremontBridge,10/20/2013 06:00:00 AM,48,-122,4,7,11
9175,FremontBridge,10/20/2013 07:00:00 AM,48,-122,13,11,24
9176,FremontBridge,10/20/2013 08:00:00 AM,48,-122,25,14,39
9177,FremontBridge,10/20/2013 09:00:00 AM,48,-122,21,20,41
9178,FremontBridge,10/20/2013 10:00:00 AM,48,-122,33,46,79
9179,FremontBridge,10/20/2013 11:00:00 AM,48,-122,25,38,63
9180,FremontBridge,10/20/2013 12:00:00 PM,48,-122,33,53,86
9181,FremontBridge,10/20/2013 01:00:00 PM,48,-122,36,48,84
9182,FremontBridge,10/20/2013 02:00:00 PM,48,-122,62,64,126
9183,FremontBridge,10/20/2013 03:00:00 PM,48,-122,62,71,133
9184,FremontBridge,10/20/2013 04:00:00 PM,48,-122,41,46,87
9185,FremontBridge,10/20/2013 05:00:00 PM,48,-122,54,48,102
9186,FremontBridge,10/20/2013 06:00:00 PM,48,-122,17,22,39
9187,FremontBridge,10/20/2013 07:00:00 PM,48,-122,17,16,33
9188,FremontBridge,10/20/2013 08:00:00 PM,48,-122,17,11,28
9189,FremontBridge,10/20/2013 09:00:00 PM,48,-122,8,13,21
9190,FremontBridge,10/20/2013 10:00:00 PM,48,-122,14,11,25
9191,FremontBridge,10/20/2013 11:00:00 PM,48,-122,10,10,20
9192,FremontBridge,10/21/2013 12:00:00 AM,48,-122,8,7,15
9193,FremontBridge,10/21/2013 01:00:00 AM,48,-122,2,3,5
9194,FremontBridge,10/21/2013 02:00:00 AM,48,-122,0,6,6
9195,FremontBridge,10/21/2013 03:00:00 AM,48,-122,0,1,1
9196,FremontBridge,10/21/2013 04:00:00 AM,48,-122,2,4,6
9197,FremontBridge,10/21/2013 05:00:00 AM,48,-122,5,17,22
9198,FremontBridge,10/21/2013 06:00:00 AM,48,-122,31,79,110
9199,FremontBridge,10/21/2013 07:00:00 AM,48,-122,67,208,275
9200,FremontBridge,10/21/2013 08:00:00 AM,48,-122,121,282,403
9201,FremontBridge,10/21/2013 09:00:00 AM,48,-122,102,163,265
9202,FremontBridge,10/21/2013 10:00:00 AM,48,-122,47,63,110
9203,FremontBridge,10/21/2013 11:00:00 AM,48,-122,22,48,70
9204,FremontBridge,10/21/2013 12:00:00 PM,48,-122,36,40,76
9205,FremontBridge,10/21/2013 01:00:00 PM,48,-122,30,35,65
9206,FremontBridge,10/21/2013 02:00:00 PM,48,-122,39,36,75
9207,FremontBridge,10/21/2013 03:00:00 PM,48,-122,79,56,135
9208,FremontBridge,10/21/2013 04:00:00 PM,48,-122,120,87,207
9209,FremontBridge,10/21/2013 05:00:00 PM,48,-122,323,151,474
9210,FremontBridge,10/21/2013 06:00:00 PM,48,-122,253,121,374
9211,FremontBridge,10/21/2013 07:00:00 PM,48,-122,83,54,137
9212,FremontBridge,10/21/2013 08:00:00 PM,48,-122,44,32,76
9213,FremontBridge,10/21/2013 09:00:00 PM,48,-122,26,23,49
9214,FremontBridge,10/21/2013 10:00:00 PM,48,-122,18,8,26
9215,FremontBridge,10/21/2013 11:00:00 PM,48,-122,16,8,24
9216,FremontBridge,10/22/2013 12:00:00 AM,48,-122,2,5,7
9217,FremontBridge,10/22/2013 01:00:00 AM,48,-122,7,3,10
9218,FremontBridge,10/22/2013 02:00:00 AM,48,-122,0,4,4
9219,FremontBridge,10/22/2013 03:00:00 AM,48,-122,1,3,4
9220,FremontBridge,10/22/2013 04:00:00 AM,48,-122,2,1,3
9221,FremontBridge,10/22/2013 05:00:00 AM,48,-122,3,19,22
9222,FremontBridge,10/22/2013 06:00:00 AM,48,-122,28,76,104
9223,FremontBridge,10/22/2013 07:00:00 AM,48,-122,73,227,300
9224,FremontBridge,10/22/2013 08:00:00 AM,48,-122,129,307,436
9225,FremontBridge,10/22/2013 09:00:00 AM,48,-122,116,154,270
9226,FremontBridge,10/22/2013 10:00:00 AM,48,-122,80,1,81
9227,FremontBridge,10/22/2013 11:00:00 AM,48,-122,73,0,73
9228,FremontBridge,10/22/2013 12:00:00 PM,48,-122,73,2,75
9229,FremontBridge,10/22/2013 01:00:00 PM,48,-122,64,3,67
9230,FremontBridge,10/22/2013 02:00:00 PM,48,-122,53,37,90
9231,FremontBridge,10/22/2013 03:00:00 PM,48,-122,67,69,136
9232,FremontBridge,10/22/2013 04:00:00 PM,48,-122,130,83,213
9233,FremontBridge,10/22/2013 05:00:00 PM,48,-122,366,164,530
9234,FremontBridge,10/22/2013 06:00:00 PM,48,-122,246,130,376
9235,FremontBridge,10/22/2013 07:00:00 PM,48,-122,82,65,147
9236,FremontBridge,10/22/2013 08:00:00 PM,48,-122,59,37,96
9237,FremontBridge,10/22/2013 09:00:00 PM,48,-122,33,24,57
9238,FremontBridge,10/22/2013 10:00:00 PM,48,-122,16,18,34
9239,FremontBridge,10/22/2013 11:00:00 PM,48,-122,17,10,27
9240,FremontBridge,10/23/2013 12:00:00 AM,48,-122,4,5,9
9241,FremontBridge,10/23/2013 01:00:00 AM,48,-122,1,3,4
9242,FremontBridge,10/23/2013 02:00:00 AM,48,-122,1,1,2
9243,FremontBridge,10/23/2013 03:00:00 AM,48,-122,1,0,1
9244,FremontBridge,10/23/2013 04:00:00 AM,48,-122,1,2,3
9245,FremontBridge,10/23/2013 05:00:00 AM,48,-122,8,15,23
9246,FremontBridge,10/23/2013 06:00:00 AM,48,-122,21,77,98
9247,FremontBridge,10/23/2013 07:00:00 AM,48,-122,63,185,248
9248,FremontBridge,10/23/2013 08:00:00 AM,48,-122,135,287,422
9249,FremontBridge,10/23/2013 09:00:00 AM,48,-122,112,177,289
9250,FremontBridge,10/23/2013 10:00:00 AM,48,-122,47,56,103
9251,FremontBridge,10/23/2013 11:00:00 AM,48,-122,53,5,58
9252,FremontBridge,10/23/2013 12:00:00 PM,48,-122,60,0,60
9253,FremontBridge,10/23/2013 01:00:00 PM,48,-122,59,2,61
9254,FremontBridge,10/23/2013 02:00:00 PM,48,-122,50,29,79
9255,FremontBridge,10/23/2013 03:00:00 PM,48,-122,66,57,123
9256,FremontBridge,10/23/2013 04:00:00 PM,48,-122,130,109,239
9257,FremontBridge,10/23/2013 05:00:00 PM,48,-122,337,175,512
9258,FremontBridge,10/23/2013 06:00:00 PM,48,-122,244,147,391
9259,FremontBridge,10/23/2013 07:00:00 PM,48,-122,94,48,142
9260,FremontBridge,10/23/2013 08:00:00 PM,48,-122,45,26,71
9261,FremontBridge,10/23/2013 09:00:00 PM,48,-122,41,23,64
9262,FremontBridge,10/23/2013 10:00:00 PM,48,-122,27,25,52
9263,FremontBridge,10/23/2013 11:00:00 PM,48,-122,22,8,30
9264,FremontBridge,10/24/2013 12:00:00 AM,48,-122,3,8,11
9265,FremontBridge,10/24/2013 01:00:00 AM,48,-122,2,1,3
9266,FremontBridge,10/24/2013 02:00:00 AM,48,-122,2,0,2
9267,FremontBridge,10/24/2013 03:00:00 AM,48,-122,2,2,4
9268,FremontBridge,10/24/2013 04:00:00 AM,48,-122,1,3,4
9269,FremontBridge,10/24/2013 05:00:00 AM,48,-122,4,18,22
9270,FremontBridge,10/24/2013 06:00:00 AM,48,-122,25,77,102
9271,FremontBridge,10/24/2013 07:00:00 AM,48,-122,74,183,257
9272,FremontBridge,10/24/2013 08:00:00 AM,48,-122,130,277,407
9273,FremontBridge,10/24/2013 09:00:00 AM,48,-122,58,204,262
9274,FremontBridge,10/24/2013 10:00:00 AM,48,-122,1,79,80
9275,FremontBridge,10/24/2013 11:00:00 AM,48,-122,1,68,69
9276,FremontBridge,10/24/2013 12:00:00 PM,48,-122,15,66,81
9277,FremontBridge,10/24/2013 01:00:00 PM,48,-122,42,39,81
9278,FremontBridge,10/24/2013 02:00:00 PM,48,-122,32,33,65
9279,FremontBridge,10/24/2013 03:00:00 PM,48,-122,63,57,120
9280,FremontBridge,10/24/2013 04:00:00 PM,48,-122,113,104,217
9281,FremontBridge,10/24/2013 05:00:00 PM,48,-122,328,151,479
9282,FremontBridge,10/24/2013 06:00:00 PM,48,-122,232,127,359
9283,FremontBridge,10/24/2013 07:00:00 PM,48,-122,86,48,134
9284,FremontBridge,10/24/2013 08:00:00 PM,48,-122,58,30,88
9285,FremontBridge,10/24/2013 09:00:00 PM,48,-122,40,23,63
9286,FremontBridge,10/24/2013 10:00:00 PM,48,-122,67,12,79
9287,FremontBridge,10/24/2013 11:00:00 PM,48,-122,12,14,26
9288,FremontBridge,10/25/2013 12:00:00 AM,48,-122,11,5,16
9289,FremontBridge,10/25/2013 01:00:00 AM,48,-122,5,3,8
9290,FremontBridge,10/25/2013 02:00:00 AM,48,-122,2,3,5
9291,FremontBridge,10/25/2013 03:00:00 AM,48,-122,0,1,1
9292,FremontBridge,10/25/2013 04:00:00 AM,48,-122,1,1,2
9293,FremontBridge,10/25/2013 05:00:00 AM,48,-122,7,13,20
9294,FremontBridge,10/25/2013 06:00:00 AM,48,-122,19,62,81
9295,FremontBridge,10/25/2013 07:00:00 AM,48,-122,73,155,228
9296,FremontBridge,10/25/2013 08:00:00 AM,48,-122,100,209,309
9297,FremontBridge,10/25/2013 09:00:00 AM,48,-122,72,151,223
9298,FremontBridge,10/25/2013 10:00:00 AM,48,-122,36,51,87
9299,FremontBridge,10/25/2013 11:00:00 AM,48,-122,19,41,60
9300,FremontBridge,10/25/2013 12:00:00 PM,48,-122,31,37,68
9301,FremontBridge,10/25/2013 01:00:00 PM,48,-122,26,38,64
9302,FremontBridge,10/25/2013 02:00:00 PM,48,-122,22,34,56
9303,FremontBridge,10/25/2013 03:00:00 PM,48,-122,57,66,123
9304,FremontBridge,10/25/2013 04:00:00 PM,48,-122,117,61,178
9305,FremontBridge,10/25/2013 05:00:00 PM,48,-122,261,130,391
9306,FremontBridge,10/25/2013 06:00:00 PM,48,-122,171,78,249
9307,FremontBridge,10/25/2013 07:00:00 PM,48,-122,75,48,123
9308,FremontBridge,10/25/2013 08:00:00 PM,48,-122,32,25,57
9309,FremontBridge,10/25/2013 09:00:00 PM,48,-122,14,22,36
9310,FremontBridge,10/25/2013 10:00:00 PM,48,-122,16,8,24
9311,FremontBridge,10/25/2013 11:00:00 PM,48,-122,16,10,26
9312,FremontBridge,10/26/2013 12:00:00 AM,48,-122,7,8,15
9313,FremontBridge,10/26/2013 01:00:00 AM,48,-122,7,5,12
9314,FremontBridge,10/26/2013 02:00:00 AM,48,-122,3,10,13
9315,FremontBridge,10/26/2013 03:00:00 AM,48,-122,2,0,2
9316,FremontBridge,10/26/2013 04:00:00 AM,48,-122,4,4,8
9317,FremontBridge,10/26/2013 05:00:00 AM,48,-122,0,5,5
9318,FremontBridge,10/26/2013 06:00:00 AM,48,-122,7,11,18
9319,FremontBridge,10/26/2013 07:00:00 AM,48,-122,6,11,17
9320,FremontBridge,10/26/2013 08:00:00 AM,48,-122,28,30,58
9321,FremontBridge,10/26/2013 09:00:00 AM,48,-122,25,33,58
9322,FremontBridge,10/26/2013 10:00:00 AM,48,-122,37,59,96
9323,FremontBridge,10/26/2013 11:00:00 AM,48,-122,44,49,93
9324,FremontBridge,10/26/2013 12:00:00 PM,48,-122,47,56,103
9325,FremontBridge,10/26/2013 01:00:00 PM,48,-122,59,80,139
9326,FremontBridge,10/26/2013 02:00:00 PM,48,-122,50,61,111
9327,FremontBridge,10/26/2013 03:00:00 PM,48,-122,55,54,109
9328,FremontBridge,10/26/2013 04:00:00 PM,48,-122,51,30,81
9329,FremontBridge,10/26/2013 05:00:00 PM,48,-122,46,51,97
9330,FremontBridge,10/26/2013 06:00:00 PM,48,-122,73,91,164
9331,FremontBridge,10/26/2013 07:00:00 PM,48,-122,24,18,42
9332,FremontBridge,10/26/2013 08:00:00 PM,48,-122,14,26,40
9333,FremontBridge,10/26/2013 09:00:00 PM,48,-122,20,17,37
9334,FremontBridge,10/26/2013 10:00:00 PM,48,-122,13,6,19
9335,FremontBridge,10/26/2013 11:00:00 PM,48,-122,18,12,30
9336,FremontBridge,10/27/2013 12:00:00 AM,48,-122,12,7,19
9337,FremontBridge,10/27/2013 01:00:00 AM,48,-122,8,8,16
9338,FremontBridge,10/27/2013 02:00:00 AM,48,-122,3,3,6
9339,FremontBridge,10/27/2013 03:00:00 AM,48,-122,3,4,7
9340,FremontBridge,10/27/2013 04:00:00 AM,48,-122,1,4,5
9341,FremontBridge,10/27/2013 05:00:00 AM,48,-122,1,6,7
9342,FremontBridge,10/27/2013 06:00:00 AM,48,-122,3,6,9
9343,FremontBridge,10/27/2013 07:00:00 AM,48,-122,3,8,11
9344,FremontBridge,10/27/2013 08:00:00 AM,48,-122,3,11,14
9345,FremontBridge,10/27/2013 09:00:00 AM,48,-122,20,25,45
9346,FremontBridge,10/27/2013 10:00:00 AM,48,-122,17,22,39
9347,FremontBridge,10/27/2013 11:00:00 AM,48,-122,12,13,25
9348,FremontBridge,10/27/2013 12:00:00 PM,48,-122,15,19,34
9349,FremontBridge,10/27/2013 01:00:00 PM,48,-122,34,27,61
9350,FremontBridge,10/27/2013 02:00:00 PM,48,-122,27,26,53
9351,FremontBridge,10/27/2013 03:00:00 PM,48,-122,44,48,92
9352,FremontBridge,10/27/2013 04:00:00 PM,48,-122,30,53,83
9353,FremontBridge,10/27/2013 05:00:00 PM,48,-122,42,59,101
9354,FremontBridge,10/27/2013 06:00:00 PM,48,-122,18,22,40
9355,FremontBridge,10/27/2013 07:00:00 PM,48,-122,17,16,33
9356,FremontBridge,10/27/2013 08:00:00 PM,48,-122,18,8,26
9357,FremontBridge,10/27/2013 09:00:00 PM,48,-122,14,10,24
9358,FremontBridge,10/27/2013 10:00:00 PM,48,-122,8,5,13
9359,FremontBridge,10/27/2013 11:00:00 PM,48,-122,9,6,15
9360,FremontBridge,10/28/2013 12:00:00 AM,48,-122,1,3,4
9361,FremontBridge,10/28/2013 01:00:00 AM,48,-122,1,2,3
9362,FremontBridge,10/28/2013 02:00:00 AM,48,-122,0,1,1
9363,FremontBridge,10/28/2013 03:00:00 AM,48,-122,1,1,2
9364,FremontBridge,10/28/2013 04:00:00 AM,48,-122,3,1,4
9365,FremontBridge,10/28/2013 05:00:00 AM,48,-122,6,19,25
9366,FremontBridge,10/28/2013 06:00:00 AM,48,-122,31,78,109
9367,FremontBridge,10/28/2013 07:00:00 AM,48,-122,85,200,285
9368,FremontBridge,10/28/2013 08:00:00 AM,48,-122,113,310,423
9369,FremontBridge,10/28/2013 09:00:00 AM,48,-122,124,178,302
9370,FremontBridge,10/28/2013 10:00:00 AM,48,-122,32,90,122
9371,FremontBridge,10/28/2013 11:00:00 AM,48,-122,26,37,63
9372,FremontBridge,10/28/2013 12:00:00 PM,48,-122,31,50,81
9373,FremontBridge,10/28/2013 01:00:00 PM,48,-122,43,43,86
9374,FremontBridge,10/28/2013 02:00:00 PM,48,-122,45,51,96
9375,FremontBridge,10/28/2013 03:00:00 PM,48,-122,92,68,160
9376,FremontBridge,10/28/2013 04:00:00 PM,48,-122,159,109,268
9377,FremontBridge,10/28/2013 05:00:00 PM,48,-122,407,180,587
9378,FremontBridge,10/28/2013 06:00:00 PM,48,-122,253,125,378
9379,FremontBridge,10/28/2013 07:00:00 PM,48,-122,85,52,137
9380,FremontBridge,10/28/2013 08:00:00 PM,48,-122,42,30,72
9381,FremontBridge,10/28/2013 09:00:00 PM,48,-122,34,33,67
9382,FremontBridge,10/28/2013 10:00:00 PM,48,-122,15,8,23
9383,FremontBridge,10/28/2013 11:00:00 PM,48,-122,20,10,30
9384,FremontBridge,10/29/2013 12:00:00 AM,48,-122,4,8,12
9385,FremontBridge,10/29/2013 01:00:00 AM,48,-122,4,5,9
9386,FremontBridge,10/29/2013 02:00:00 AM,48,-122,1,4,5
9387,FremontBridge,10/29/2013 03:00:00 AM,48,-122,0,1,1
9388,FremontBridge,10/29/2013 04:00:00 AM,48,-122,2,3,5
9389,FremontBridge,10/29/2013 05:00:00 AM,48,-122,6,20,26
9390,FremontBridge,10/29/2013 06:00:00 AM,48,-122,37,73,110
9391,FremontBridge,10/29/2013 07:00:00 AM,48,-122,72,212,284
9392,FremontBridge,10/29/2013 08:00:00 AM,48,-122,130,314,444
9393,FremontBridge,10/29/2013 09:00:00 AM,48,-122,22,246,268
9394,FremontBridge,10/29/2013 10:00:00 AM,48,-122,30,103,133
9395,FremontBridge,10/29/2013 11:00:00 AM,48,-122,5,80,85
9396,FremontBridge,10/29/2013 12:00:00 PM,48,-122,18,75,93
9397,FremontBridge,10/29/2013 01:00:00 PM,48,-122,18,98,116
9398,FremontBridge,10/29/2013 02:00:00 PM,48,-122,52,71,123
9399,FremontBridge,10/29/2013 03:00:00 PM,48,-122,70,64,134
9400,FremontBridge,10/29/2013 04:00:00 PM,48,-122,159,103,262
9401,FremontBridge,10/29/2013 05:00:00 PM,48,-122,367,150,517
9402,FremontBridge,10/29/2013 06:00:00 PM,48,-122,224,120,344
9403,FremontBridge,10/29/2013 07:00:00 PM,48,-122,85,67,152
9404,FremontBridge,10/29/2013 08:00:00 PM,48,-122,64,31,95
9405,FremontBridge,10/29/2013 09:00:00 PM,48,-122,40,24,64
9406,FremontBridge,10/29/2013 10:00:00 PM,48,-122,15,13,28
9407,FremontBridge,10/29/2013 11:00:00 PM,48,-122,21,21,42
9408,FremontBridge,10/30/2013 12:00:00 AM,48,-122,2,2,4
9409,FremontBridge,10/30/2013 01:00:00 AM,48,-122,5,4,9
9410,FremontBridge,10/30/2013 02:00:00 AM,48,-122,3,1,4
9411,FremontBridge,10/30/2013 03:00:00 AM,48,-122,2,0,2
9412,FremontBridge,10/30/2013 04:00:00 AM,48,-122,3,2,5
9413,FremontBridge,10/30/2013 05:00:00 AM,48,-122,5,23,28
9414,FremontBridge,10/30/2013 06:00:00 AM,48,-122,32,71,103
9415,FremontBridge,10/30/2013 07:00:00 AM,48,-122,60,192,252
9416,FremontBridge,10/30/2013 08:00:00 AM,48,-122,128,279,407
9417,FremontBridge,10/30/2013 09:00:00 AM,48,-122,95,166,261
9418,FremontBridge,10/30/2013 10:00:00 AM,48,-122,47,60,107
9419,FremontBridge,10/30/2013 11:00:00 AM,48,-122,35,38,73
9420,FremontBridge,10/30/2013 12:00:00 PM,48,-122,28,44,72
9421,FremontBridge,10/30/2013 01:00:00 PM,48,-122,44,35,79
9422,FremontBridge,10/30/2013 02:00:00 PM,48,-122,21,35,56
9423,FremontBridge,10/30/2013 03:00:00 PM,48,-122,66,56,122
9424,FremontBridge,10/30/2013 04:00:00 PM,48,-122,132,73,205
9425,FremontBridge,10/30/2013 05:00:00 PM,48,-122,312,142,454
9426,FremontBridge,10/30/2013 06:00:00 PM,48,-122,214,140,354
9427,FremontBridge,10/30/2013 07:00:00 PM,48,-122,97,60,157
9428,FremontBridge,10/30/2013 08:00:00 PM,48,-122,44,39,83
9429,FremontBridge,10/30/2013 09:00:00 PM,48,-122,38,16,54
9430,FremontBridge,10/30/2013 10:00:00 PM,48,-122,29,15,44
9431,FremontBridge,10/30/2013 11:00:00 PM,48,-122,12,7,19
9432,FremontBridge,10/31/2013 12:00:00 AM,48,-122,5,8,13
9433,FremontBridge,10/31/2013 01:00:00 AM,48,-122,7,2,9
9434,FremontBridge,10/31/2013 02:00:00 AM,48,-122,1,2,3
9435,FremontBridge,10/31/2013 03:00:00 AM,48,-122,0,2,2
9436,FremontBridge,10/31/2013 04:00:00 AM,48,-122,3,5,8
9437,FremontBridge,10/31/2013 05:00:00 AM,48,-122,6,15,21
9438,FremontBridge,10/31/2013 06:00:00 AM,48,-122,31,65,96
9439,FremontBridge,10/31/2013 07:00:00 AM,48,-122,54,164,218
9440,FremontBridge,10/31/2013 08:00:00 AM,48,-122,103,222,325
9441,FremontBridge,10/31/2013 09:00:00 AM,48,-122,85,157,242
9442,FremontBridge,10/31/2013 10:00:00 AM,48,-122,42,55,97
9443,FremontBridge,10/31/2013 11:00:00 AM,48,-122,32,39,71
9444,FremontBridge,10/31/2013 12:00:00 PM,48,-122,32,32,64
9445,FremontBridge,10/31/2013 01:00:00 PM,48,-122,34,36,70
9446,FremontBridge,10/31/2013 02:00:00 PM,48,-122,41,39,80
9447,FremontBridge,10/31/2013 03:00:00 PM,48,-122,56,59,115
9448,FremontBridge,10/31/2013 04:00:00 PM,48,-122,143,79,222
9449,FremontBridge,10/31/2013 05:00:00 PM,48,-122,282,116,398
9450,FremontBridge,10/31/2013 06:00:00 PM,48,-122,158,88,246
9451,FremontBridge,10/31/2013 07:00:00 PM,48,-122,70,48,118
9452,FremontBridge,10/31/2013 08:00:00 PM,48,-122,30,27,57
9453,FremontBridge,10/31/2013 09:00:00 PM,48,-122,22,14,36
9454,FremontBridge,10/31/2013 10:00:00 PM,48,-122,17,20,37
9455,FremontBridge,10/31/2013 11:00:00 PM,48,-122,12,13,25
9456,FremontBridge,11/01/2013 12:00:00 AM,48,-122,9,17,26
9457,FremontBridge,11/01/2013 01:00:00 AM,48,-122,7,21,28
9458,FremontBridge,11/01/2013 02:00:00 AM,48,-122,4,5,9
9459,FremontBridge,11/01/2013 03:00:00 AM,48,-122,4,0,4
9460,FremontBridge,11/01/2013 04:00:00 AM,48,-122,4,7,11
9461,FremontBridge,11/01/2013 05:00:00 AM,48,-122,5,16,21
9462,FremontBridge,11/01/2013 06:00:00 AM,48,-122,27,72,99
9463,FremontBridge,11/01/2013 07:00:00 AM,48,-122,53,158,211
9464,FremontBridge,11/01/2013 08:00:00 AM,48,-122,100,242,342
9465,FremontBridge,11/01/2013 09:00:00 AM,48,-122,78,169,247
9466,FremontBridge,11/01/2013 10:00:00 AM,48,-122,48,62,110
9467,FremontBridge,11/01/2013 11:00:00 AM,48,-122,27,35,62
9468,FremontBridge,11/01/2013 12:00:00 PM,48,-122,46,44,90
9469,FremontBridge,11/01/2013 01:00:00 PM,48,-122,54,58,112
9470,FremontBridge,11/01/2013 02:00:00 PM,48,-122,66,45,111
9471,FremontBridge,11/01/2013 03:00:00 PM,48,-122,49,61,110
9472,FremontBridge,11/01/2013 04:00:00 PM,48,-122,147,88,235
9473,FremontBridge,11/01/2013 05:00:00 PM,48,-122,307,146,453
9474,FremontBridge,11/01/2013 06:00:00 PM,48,-122,184,87,271
9475,FremontBridge,11/01/2013 07:00:00 PM,48,-122,65,48,113
9476,FremontBridge,11/01/2013 08:00:00 PM,48,-122,27,23,50
9477,FremontBridge,11/01/2013 09:00:00 PM,48,-122,18,13,31
9478,FremontBridge,11/01/2013 10:00:00 PM,48,-122,18,27,45
9479,FremontBridge,11/01/2013 11:00:00 PM,48,-122,8,13,21
9480,FremontBridge,11/02/2013 12:00:00 AM,48,-122,12,5,17
9481,FremontBridge,11/02/2013 01:00:00 AM,48,-122,4,5,9
9482,FremontBridge,11/02/2013 02:00:00 AM,48,-122,3,5,8
9483,FremontBridge,11/02/2013 03:00:00 AM,48,-122,0,3,3
9484,FremontBridge,11/02/2013 04:00:00 AM,48,-122,4,4,8
9485,FremontBridge,11/02/2013 05:00:00 AM,48,-122,3,6,9
9486,FremontBridge,11/02/2013 06:00:00 AM,48,-122,7,4,11
9487,FremontBridge,11/02/2013 07:00:00 AM,48,-122,6,8,14
9488,FremontBridge,11/02/2013 08:00:00 AM,48,-122,17,11,28
9489,FremontBridge,11/02/2013 09:00:00 AM,48,-122,17,18,35
9490,FremontBridge,11/02/2013 10:00:00 AM,48,-122,12,21,33
9491,FremontBridge,11/02/2013 11:00:00 AM,48,-122,9,20,29
9492,FremontBridge,11/02/2013 12:00:00 PM,48,-122,18,35,53
9493,FremontBridge,11/02/2013 01:00:00 PM,48,-122,20,22,42
9494,FremontBridge,11/02/2013 02:00:00 PM,48,-122,26,12,38
9495,FremontBridge,11/02/2013 03:00:00 PM,48,-122,17,24,41
9496,FremontBridge,11/02/2013 04:00:00 PM,48,-122,29,34,63
9497,FremontBridge,11/02/2013 05:00:00 PM,48,-122,24,31,55
9498,FremontBridge,11/02/2013 06:00:00 PM,48,-122,20,28,48
9499,FremontBridge,11/02/2013 07:00:00 PM,48,-122,16,13,29
9500,FremontBridge,11/02/2013 08:00:00 PM,48,-122,16,9,25
9501,FremontBridge,11/02/2013 09:00:00 PM,48,-122,8,10,18
9502,FremontBridge,11/02/2013 10:00:00 PM,48,-122,24,10,34
9503,FremontBridge,11/02/2013 11:00:00 PM,48,-122,14,6,20
9504,FremontBridge,11/03/2013 12:00:00 AM,48,-122,11,4,15
9505,FremontBridge,11/03/2013 01:00:00 AM,48,-122,2,1,3
9506,FremontBridge,11/03/2013 02:00:00 AM,48,-122,0,1,1
9507,FremontBridge,11/03/2013 03:00:00 AM,48,-122,1,1,2
9508,FremontBridge,11/03/2013 04:00:00 AM,48,-122,1,0,1
9509,FremontBridge,11/03/2013 05:00:00 AM,48,-122,3,2,5
9510,FremontBridge,11/03/2013 06:00:00 AM,48,-122,5,5,10
9511,FremontBridge,11/03/2013 07:00:00 AM,48,-122,8,20,28
9512,FremontBridge,11/03/2013 08:00:00 AM,48,-122,23,27,50
9513,FremontBridge,11/03/2013 09:00:00 AM,48,-122,38,48,86
9514,FremontBridge,11/03/2013 10:00:00 AM,48,-122,35,62,97
9515,FremontBridge,11/03/2013 11:00:00 AM,48,-122,75,50,125
9516,FremontBridge,11/03/2013 12:00:00 PM,48,-122,60,72,132
9517,FremontBridge,11/03/2013 01:00:00 PM,48,-122,60,77,137
9518,FremontBridge,11/03/2013 02:00:00 PM,48,-122,53,115,168
9519,FremontBridge,11/03/2013 03:00:00 PM,48,-122,55,58,113
9520,FremontBridge,11/03/2013 04:00:00 PM,48,-122,45,68,113
9521,FremontBridge,11/03/2013 05:00:00 PM,48,-122,54,41,95
9522,FremontBridge,11/03/2013 06:00:00 PM,48,-122,23,19,42
9523,FremontBridge,11/03/2013 07:00:00 PM,48,-122,17,9,26
9524,FremontBridge,11/03/2013 08:00:00 PM,48,-122,11,11,22
9525,FremontBridge,11/03/2013 09:00:00 PM,48,-122,9,11,20
9526,FremontBridge,11/03/2013 10:00:00 PM,48,-122,14,3,17
9527,FremontBridge,11/03/2013 11:00:00 PM,48,-122,10,3,13
9528,FremontBridge,11/04/2013 12:00:00 AM,48,-122,7,3,10
9529,FremontBridge,11/04/2013 01:00:00 AM,48,-122,0,4,4
9530,FremontBridge,11/04/2013 02:00:00 AM,48,-122,0,2,2
9531,FremontBridge,11/04/2013 03:00:00 AM,48,-122,1,2,3
9532,FremontBridge,11/04/2013 04:00:00 AM,48,-122,2,4,6
9533,FremontBridge,11/04/2013 05:00:00 AM,48,-122,5,18,23
9534,FremontBridge,11/04/2013 06:00:00 AM,48,-122,38,77,115
9535,FremontBridge,11/04/2013 07:00:00 AM,48,-122,81,236,317
9536,FremontBridge,11/04/2013 08:00:00 AM,48,-122,138,286,424
9537,FremontBridge,11/04/2013 09:00:00 AM,48,-122,91,142,233
9538,FremontBridge,11/04/2013 10:00:00 AM,48,-122,34,62,96
9539,FremontBridge,11/04/2013 11:00:00 AM,48,-122,36,48,84
9540,FremontBridge,11/04/2013 12:00:00 PM,48,-122,39,45,84
9541,FremontBridge,11/04/2013 01:00:00 PM,48,-122,29,48,77
9542,FremontBridge,11/04/2013 02:00:00 PM,48,-122,45,52,97
9543,FremontBridge,11/04/2013 03:00:00 PM,48,-122,71,52,123
9544,FremontBridge,11/04/2013 04:00:00 PM,48,-122,146,91,237
9545,FremontBridge,11/04/2013 05:00:00 PM,48,-122,362,137,499
9546,FremontBridge,11/04/2013 06:00:00 PM,48,-122,206,107,313
9547,FremontBridge,11/04/2013 07:00:00 PM,48,-122,80,56,136
9548,FremontBridge,11/04/2013 08:00:00 PM,48,-122,39,23,62
9549,FremontBridge,11/04/2013 09:00:00 PM,48,-122,32,33,65
9550,FremontBridge,11/04/2013 10:00:00 PM,48,-122,18,11,29
9551,FremontBridge,11/04/2013 11:00:00 PM,48,-122,14,5,19
9552,FremontBridge,11/05/2013 12:00:00 AM,48,-122,2,6,8
9553,FremontBridge,11/05/2013 01:00:00 AM,48,-122,2,1,3
9554,FremontBridge,11/05/2013 02:00:00 AM,48,-122,0,4,4
9555,FremontBridge,11/05/2013 03:00:00 AM,48,-122,0,1,1
9556,FremontBridge,11/05/2013 04:00:00 AM,48,-122,2,2,4
9557,FremontBridge,11/05/2013 05:00:00 AM,48,-122,5,17,22
9558,FremontBridge,11/05/2013 06:00:00 AM,48,-122,31,66,97
9559,FremontBridge,11/05/2013 07:00:00 AM,48,-122,78,205,283
9560,FremontBridge,11/05/2013 08:00:00 AM,48,-122,126,250,376
9561,FremontBridge,11/05/2013 09:00:00 AM,48,-122,88,141,229
9562,FremontBridge,11/05/2013 10:00:00 AM,48,-122,45,66,111
9563,FremontBridge,11/05/2013 11:00:00 AM,48,-122,26,41,67
9564,FremontBridge,11/05/2013 12:00:00 PM,48,-122,26,43,69
9565,FremontBridge,11/05/2013 01:00:00 PM,48,-122,25,34,59
9566,FremontBridge,11/05/2013 02:00:00 PM,48,-122,42,47,89
9567,FremontBridge,11/05/2013 03:00:00 PM,48,-122,61,54,115
9568,FremontBridge,11/05/2013 04:00:00 PM,48,-122,132,76,208
9569,FremontBridge,11/05/2013 05:00:00 PM,48,-122,303,116,419
9570,FremontBridge,11/05/2013 06:00:00 PM,48,-122,210,107,317
9571,FremontBridge,11/05/2013 07:00:00 PM,48,-122,96,55,151
9572,FremontBridge,11/05/2013 08:00:00 PM,48,-122,39,32,71
9573,FremontBridge,11/05/2013 09:00:00 PM,48,-122,17,27,44
9574,FremontBridge,11/05/2013 10:00:00 PM,48,-122,12,11,23
9575,FremontBridge,11/05/2013 11:00:00 PM,48,-122,9,10,19
9576,FremontBridge,11/06/2013 12:00:00 AM,48,-122,10,4,14
9577,FremontBridge,11/06/2013 01:00:00 AM,48,-122,1,1,2
9578,FremontBridge,11/06/2013 02:00:00 AM,48,-122,1,3,4
9579,FremontBridge,11/06/2013 03:00:00 AM,48,-122,1,1,2
9580,FremontBridge,11/06/2013 04:00:00 AM,48,-122,5,3,8
9581,FremontBridge,11/06/2013 05:00:00 AM,48,-122,6,18,24
9582,FremontBridge,11/06/2013 06:00:00 AM,48,-122,27,70,97
9583,FremontBridge,11/06/2013 07:00:00 AM,48,-122,62,204,266
9584,FremontBridge,11/06/2013 08:00:00 AM,48,-122,131,278,409
9585,FremontBridge,11/06/2013 09:00:00 AM,48,-122,101,166,267
9586,FremontBridge,11/06/2013 10:00:00 AM,48,-122,51,59,110
9587,FremontBridge,11/06/2013 11:00:00 AM,48,-122,27,26,53
9588,FremontBridge,11/06/2013 12:00:00 PM,48,-122,37,54,91
9589,FremontBridge,11/06/2013 01:00:00 PM,48,-122,38,49,87
9590,FremontBridge,11/06/2013 02:00:00 PM,48,-122,44,44,88
9591,FremontBridge,11/06/2013 03:00:00 PM,48,-122,56,49,105
9592,FremontBridge,11/06/2013 04:00:00 PM,48,-122,111,82,193
9593,FremontBridge,11/06/2013 05:00:00 PM,48,-122,322,142,464
9594,FremontBridge,11/06/2013 06:00:00 PM,48,-122,227,108,335
9595,FremontBridge,11/06/2013 07:00:00 PM,48,-122,69,46,115
9596,FremontBridge,11/06/2013 08:00:00 PM,48,-122,44,22,66
9597,FremontBridge,11/06/2013 09:00:00 PM,48,-122,33,20,53
9598,FremontBridge,11/06/2013 10:00:00 PM,48,-122,23,17,40
9599,FremontBridge,11/06/2013 11:00:00 PM,48,-122,18,7,25
9600,FremontBridge,11/07/2013 12:00:00 AM,48,-122,1,4,5
9601,FremontBridge,11/07/2013 01:00:00 AM,48,-122,5,1,6
9602,FremontBridge,11/07/2013 02:00:00 AM,48,-122,0,0,0
9603,FremontBridge,11/07/2013 03:00:00 AM,48,-122,0,3,3
9604,FremontBridge,11/07/2013 04:00:00 AM,48,-122,4,1,5
9605,FremontBridge,11/07/2013 05:00:00 AM,48,-122,5,13,18
9606,FremontBridge,11/07/2013 06:00:00 AM,48,-122,16,39,55
9607,FremontBridge,11/07/2013 07:00:00 AM,48,-122,48,112,160
9608,FremontBridge,11/07/2013 08:00:00 AM,48,-122,96,155,251
9609,FremontBridge,11/07/2013 09:00:00 AM,48,-122,50,104,154
9610,FremontBridge,11/07/2013 10:00:00 AM,48,-122,22,24,46
9611,FremontBridge,11/07/2013 11:00:00 AM,48,-122,23,24,47
9612,FremontBridge,11/07/2013 12:00:00 PM,48,-122,22,30,52
9613,FremontBridge,11/07/2013 01:00:00 PM,48,-122,14,21,35
9614,FremontBridge,11/07/2013 02:00:00 PM,48,-122,23,24,47
9615,FremontBridge,11/07/2013 03:00:00 PM,48,-122,29,28,57
9616,FremontBridge,11/07/2013 04:00:00 PM,48,-122,68,51,119
9617,FremontBridge,11/07/2013 05:00:00 PM,48,-122,163,81,244
9618,FremontBridge,11/07/2013 06:00:00 PM,48,-122,135,50,185
9619,FremontBridge,11/07/2013 07:00:00 PM,48,-122,62,36,98
9620,FremontBridge,11/07/2013 08:00:00 PM,48,-122,34,17,51
9621,FremontBridge,11/07/2013 09:00:00 PM,48,-122,11,12,23
9622,FremontBridge,11/07/2013 10:00:00 PM,48,-122,11,18,29
9623,FremontBridge,11/07/2013 11:00:00 PM,48,-122,14,5,19
9624,FremontBridge,11/08/2013 12:00:00 AM,48,-122,3,7,10
9625,FremontBridge,11/08/2013 01:00:00 AM,48,-122,2,1,3
9626,FremontBridge,11/08/2013 02:00:00 AM,48,-122,4,0,4
9627,FremontBridge,11/08/2013 03:00:00 AM,48,-122,1,0,1
9628,FremontBridge,11/08/2013 04:00:00 AM,48,-122,5,3,8
9629,FremontBridge,11/08/2013 05:00:00 AM,48,-122,3,10,13
9630,FremontBridge,11/08/2013 06:00:00 AM,48,-122,36,54,90
9631,FremontBridge,11/08/2013 07:00:00 AM,48,-122,56,148,204
9632,FremontBridge,11/08/2013 08:00:00 AM,48,-122,98,242,340
9633,FremontBridge,11/08/2013 09:00:00 AM,48,-122,89,160,249
9634,FremontBridge,11/08/2013 10:00:00 AM,48,-122,47,65,112
9635,FremontBridge,11/08/2013 11:00:00 AM,48,-122,26,43,69
9636,FremontBridge,11/08/2013 12:00:00 PM,48,-122,32,48,80
9637,FremontBridge,11/08/2013 01:00:00 PM,48,-122,46,55,101
9638,FremontBridge,11/08/2013 02:00:00 PM,48,-122,42,69,111
9639,FremontBridge,11/08/2013 03:00:00 PM,48,-122,55,62,117
9640,FremontBridge,11/08/2013 04:00:00 PM,48,-122,144,94,238
9641,FremontBridge,11/08/2013 05:00:00 PM,48,-122,301,113,414
9642,FremontBridge,11/08/2013 06:00:00 PM,48,-122,141,82,223
9643,FremontBridge,11/08/2013 07:00:00 PM,48,-122,67,38,105
9644,FremontBridge,11/08/2013 08:00:00 PM,48,-122,37,18,55
9645,FremontBridge,11/08/2013 09:00:00 PM,48,-122,14,15,29
9646,FremontBridge,11/08/2013 10:00:00 PM,48,-122,11,20,31
9647,FremontBridge,11/08/2013 11:00:00 PM,48,-122,11,14,25
9648,FremontBridge,11/09/2013 12:00:00 AM,48,-122,6,6,12
9649,FremontBridge,11/09/2013 01:00:00 AM,48,-122,2,7,9
9650,FremontBridge,11/09/2013 02:00:00 AM,48,-122,6,8,14
9651,FremontBridge,11/09/2013 03:00:00 AM,48,-122,1,2,3
9652,FremontBridge,11/09/2013 04:00:00 AM,48,-122,0,0,0
9653,FremontBridge,11/09/2013 05:00:00 AM,48,-122,2,5,7
9654,FremontBridge,11/09/2013 06:00:00 AM,48,-122,7,8,15
9655,FremontBridge,11/09/2013 07:00:00 AM,48,-122,8,11,19
9656,FremontBridge,11/09/2013 08:00:00 AM,48,-122,26,28,54
9657,FremontBridge,11/09/2013 09:00:00 AM,48,-122,39,43,82
9658,FremontBridge,11/09/2013 10:00:00 AM,48,-122,41,64,105
9659,FremontBridge,11/09/2013 11:00:00 AM,48,-122,54,63,117
9660,FremontBridge,11/09/2013 12:00:00 PM,48,-122,33,73,106
9661,FremontBridge,11/09/2013 01:00:00 PM,48,-122,65,72,137
9662,FremontBridge,11/09/2013 02:00:00 PM,48,-122,47,57,104
9663,FremontBridge,11/09/2013 03:00:00 PM,48,-122,48,57,105
9664,FremontBridge,11/09/2013 04:00:00 PM,48,-122,41,58,99
9665,FremontBridge,11/09/2013 05:00:00 PM,48,-122,28,28,56
9666,FremontBridge,11/09/2013 06:00:00 PM,48,-122,22,12,34
9667,FremontBridge,11/09/2013 07:00:00 PM,48,-122,12,12,24
9668,FremontBridge,11/09/2013 08:00:00 PM,48,-122,15,13,28
9669,FremontBridge,11/09/2013 09:00:00 PM,48,-122,27,7,34
9670,FremontBridge,11/09/2013 10:00:00 PM,48,-122,10,5,15
9671,FremontBridge,11/09/2013 11:00:00 PM,48,-122,9,5,14
9672,FremontBridge,11/10/2013 12:00:00 AM,48,-122,9,10,19
9673,FremontBridge,11/10/2013 01:00:00 AM,48,-122,7,2,9
9674,FremontBridge,11/10/2013 02:00:00 AM,48,-122,3,4,7
9675,FremontBridge,11/10/2013 03:00:00 AM,48,-122,0,4,4
9676,FremontBridge,11/10/2013 04:00:00 AM,48,-122,1,0,1
9677,FremontBridge,11/10/2013 05:00:00 AM,48,-122,2,2,4
9678,FremontBridge,11/10/2013 06:00:00 AM,48,-122,7,4,11
9679,FremontBridge,11/10/2013 07:00:00 AM,48,-122,5,14,19
9680,FremontBridge,11/10/2013 08:00:00 AM,48,-122,14,18,32
9681,FremontBridge,11/10/2013 09:00:00 AM,48,-122,40,24,64
9682,FremontBridge,11/10/2013 10:00:00 AM,48,-122,39,34,73
9683,FremontBridge,11/10/2013 11:00:00 AM,48,-122,33,31,64
9684,FremontBridge,11/10/2013 12:00:00 PM,48,-122,39,46,85
9685,FremontBridge,11/10/2013 01:00:00 PM,48,-122,41,46,87
9686,FremontBridge,11/10/2013 02:00:00 PM,48,-122,41,57,98
9687,FremontBridge,11/10/2013 03:00:00 PM,48,-122,58,50,108
9688,FremontBridge,11/10/2013 04:00:00 PM,48,-122,43,46,89
9689,FremontBridge,11/10/2013 05:00:00 PM,48,-122,33,42,75
9690,FremontBridge,11/10/2013 06:00:00 PM,48,-122,11,22,33
9691,FremontBridge,11/10/2013 07:00:00 PM,48,-122,14,11,25
9692,FremontBridge,11/10/2013 08:00:00 PM,48,-122,13,15,28
9693,FremontBridge,11/10/2013 09:00:00 PM,48,-122,10,13,23
9694,FremontBridge,11/10/2013 10:00:00 PM,48,-122,10,6,16
9695,FremontBridge,11/10/2013 11:00:00 PM,48,-122,12,4,16
9696,FremontBridge,11/11/2013 12:00:00 AM,48,-122,2,4,6
9697,FremontBridge,11/11/2013 01:00:00 AM,48,-122,3,1,4
9698,FremontBridge,11/11/2013 02:00:00 AM,48,-122,1,2,3
9699,FremontBridge,11/11/2013 03:00:00 AM,48,-122,0,1,1
9700,FremontBridge,11/11/2013 04:00:00 AM,48,-122,3,3,6
9701,FremontBridge,11/11/2013 05:00:00 AM,48,-122,4,13,17
9702,FremontBridge,11/11/2013 06:00:00 AM,48,-122,29,53,82
9703,FremontBridge,11/11/2013 07:00:00 AM,48,-122,54,149,203
9704,FremontBridge,11/11/2013 08:00:00 AM,48,-122,83,217,300
9705,FremontBridge,11/11/2013 09:00:00 AM,48,-122,86,141,227
9706,FremontBridge,11/11/2013 10:00:00 AM,48,-122,42,57,99
9707,FremontBridge,11/11/2013 11:00:00 AM,48,-122,38,48,86
9708,FremontBridge,11/11/2013 12:00:00 PM,48,-122,45,49,94
9709,FremontBridge,11/11/2013 01:00:00 PM,48,-122,53,50,103
9710,FremontBridge,11/11/2013 02:00:00 PM,48,-122,60,66,126
9711,FremontBridge,11/11/2013 03:00:00 PM,48,-122,60,73,133
9712,FremontBridge,11/11/2013 04:00:00 PM,48,-122,131,92,223
9713,FremontBridge,11/11/2013 05:00:00 PM,48,-122,272,104,376
9714,FremontBridge,11/11/2013 06:00:00 PM,48,-122,205,80,285
9715,FremontBridge,11/11/2013 07:00:00 PM,48,-122,81,36,117
9716,FremontBridge,11/11/2013 08:00:00 PM,48,-122,44,19,63
9717,FremontBridge,11/11/2013 09:00:00 PM,48,-122,41,14,55
9718,FremontBridge,11/11/2013 10:00:00 PM,48,-122,14,18,32
9719,FremontBridge,11/11/2013 11:00:00 PM,48,-122,12,8,20
9720,FremontBridge,11/12/2013 12:00:00 AM,48,-122,8,5,13
9721,FremontBridge,11/12/2013 01:00:00 AM,48,-122,0,6,6
9722,FremontBridge,11/12/2013 02:00:00 AM,48,-122,0,2,2
9723,FremontBridge,11/12/2013 03:00:00 AM,48,-122,0,2,2
9724,FremontBridge,11/12/2013 04:00:00 AM,48,-122,4,2,6
9725,FremontBridge,11/12/2013 05:00:00 AM,48,-122,3,16,19
9726,FremontBridge,11/12/2013 06:00:00 AM,48,-122,28,63,91
9727,FremontBridge,11/12/2013 07:00:00 AM,48,-122,53,134,187
9728,FremontBridge,11/12/2013 08:00:00 AM,48,-122,93,212,305
9729,FremontBridge,11/12/2013 09:00:00 AM,48,-122,100,151,251
9730,FremontBridge,11/12/2013 10:00:00 AM,48,-122,39,46,85
9731,FremontBridge,11/12/2013 11:00:00 AM,48,-122,24,32,56
9732,FremontBridge,11/12/2013 12:00:00 PM,48,-122,31,29,60
9733,FremontBridge,11/12/2013 01:00:00 PM,48,-122,23,32,55
9734,FremontBridge,11/12/2013 02:00:00 PM,48,-122,32,34,66
9735,FremontBridge,11/12/2013 03:00:00 PM,48,-122,51,55,106
9736,FremontBridge,11/12/2013 04:00:00 PM,48,-122,108,68,176
9737,FremontBridge,11/12/2013 05:00:00 PM,48,-122,228,125,353
9738,FremontBridge,11/12/2013 06:00:00 PM,48,-122,178,89,267
9739,FremontBridge,11/12/2013 07:00:00 PM,48,-122,79,47,126
9740,FremontBridge,11/12/2013 08:00:00 PM,48,-122,46,31,77
9741,FremontBridge,11/12/2013 09:00:00 PM,48,-122,31,17,48
9742,FremontBridge,11/12/2013 10:00:00 PM,48,-122,23,18,41
9743,FremontBridge,11/12/2013 11:00:00 PM,48,-122,6,12,18
9744,FremontBridge,11/13/2013 12:00:00 AM,48,-122,5,2,7
9745,FremontBridge,11/13/2013 01:00:00 AM,48,-122,4,3,7
9746,FremontBridge,11/13/2013 02:00:00 AM,48,-122,2,3,5
9747,FremontBridge,11/13/2013 03:00:00 AM,48,-122,0,2,2
9748,FremontBridge,11/13/2013 04:00:00 AM,48,-122,5,5,10
9749,FremontBridge,11/13/2013 05:00:00 AM,48,-122,7,25,32
9750,FremontBridge,11/13/2013 06:00:00 AM,48,-122,35,66,101
9751,FremontBridge,11/13/2013 07:00:00 AM,48,-122,71,192,263
9752,FremontBridge,11/13/2013 08:00:00 AM,48,-122,133,283,416
9753,FremontBridge,11/13/2013 09:00:00 AM,48,-122,88,193,281
9754,FremontBridge,11/13/2013 10:00:00 AM,48,-122,63,69,132
9755,FremontBridge,11/13/2013 11:00:00 AM,48,-122,40,32,72
9756,FremontBridge,11/13/2013 12:00:00 PM,48,-122,28,52,80
9757,FremontBridge,11/13/2013 01:00:00 PM,48,-122,35,42,77
9758,FremontBridge,11/13/2013 02:00:00 PM,48,-122,42,37,79
9759,FremontBridge,11/13/2013 03:00:00 PM,48,-122,58,64,122
9760,FremontBridge,11/13/2013 04:00:00 PM,48,-122,134,95,229
9761,FremontBridge,11/13/2013 05:00:00 PM,48,-122,305,140,445
9762,FremontBridge,11/13/2013 06:00:00 PM,48,-122,229,113,342
9763,FremontBridge,11/13/2013 07:00:00 PM,48,-122,97,47,144
9764,FremontBridge,11/13/2013 08:00:00 PM,48,-122,44,44,88
9765,FremontBridge,11/13/2013 09:00:00 PM,48,-122,32,34,66
9766,FremontBridge,11/13/2013 10:00:00 PM,48,-122,21,25,46
9767,FremontBridge,11/13/2013 11:00:00 PM,48,-122,11,10,21
9768,FremontBridge,11/14/2013 12:00:00 AM,48,-122,5,4,9
9769,FremontBridge,11/14/2013 01:00:00 AM,48,-122,2,4,6
9770,FremontBridge,11/14/2013 02:00:00 AM,48,-122,2,4,6
9771,FremontBridge,11/14/2013 03:00:00 AM,48,-122,0,1,1
9772,FremontBridge,11/14/2013 04:00:00 AM,48,-122,3,2,5
9773,FremontBridge,11/14/2013 05:00:00 AM,48,-122,6,15,21
9774,FremontBridge,11/14/2013 06:00:00 AM,48,-122,31,69,100
9775,FremontBridge,11/14/2013 07:00:00 AM,48,-122,72,175,247
9776,FremontBridge,11/14/2013 08:00:00 AM,48,-122,104,264,368
9777,FremontBridge,11/14/2013 09:00:00 AM,48,-122,77,158,235
9778,FremontBridge,11/14/2013 10:00:00 AM,48,-122,52,50,102
9779,FremontBridge,11/14/2013 11:00:00 AM,48,-122,36,28,64
9780,FremontBridge,11/14/2013 12:00:00 PM,48,-122,19,43,62
9781,FremontBridge,11/14/2013 01:00:00 PM,48,-122,33,34,67
9782,FremontBridge,11/14/2013 02:00:00 PM,48,-122,27,26,53
9783,FremontBridge,11/14/2013 03:00:00 PM,48,-122,50,44,94
9784,FremontBridge,11/14/2013 04:00:00 PM,48,-122,116,73,189
9785,FremontBridge,11/14/2013 05:00:00 PM,48,-122,244,127,371
9786,FremontBridge,11/14/2013 06:00:00 PM,48,-122,199,79,278
9787,FremontBridge,11/14/2013 07:00:00 PM,48,-122,83,48,131
9788,FremontBridge,11/14/2013 08:00:00 PM,48,-122,47,27,74
9789,FremontBridge,11/14/2013 09:00:00 PM,48,-122,28,17,45
9790,FremontBridge,11/14/2013 10:00:00 PM,48,-122,27,14,41
9791,FremontBridge,11/14/2013 11:00:00 PM,48,-122,10,12,22
9792,FremontBridge,11/15/2013 12:00:00 AM,48,-122,5,2,7
9793,FremontBridge,11/15/2013 01:00:00 AM,48,-122,4,3,7
9794,FremontBridge,11/15/2013 02:00:00 AM,48,-122,2,3,5
9795,FremontBridge,11/15/2013 03:00:00 AM,48,-122,0,1,1
9796,FremontBridge,11/15/2013 04:00:00 AM,48,-122,2,3,5
9797,FremontBridge,11/15/2013 05:00:00 AM,48,-122,3,14,17
9798,FremontBridge,11/15/2013 06:00:00 AM,48,-122,33,48,81
9799,FremontBridge,11/15/2013 07:00:00 AM,48,-122,52,143,195
9800,FremontBridge,11/15/2013 08:00:00 AM,48,-122,93,190,283
9801,FremontBridge,11/15/2013 09:00:00 AM,48,-122,79,140,219
9802,FremontBridge,11/15/2013 10:00:00 AM,48,-122,32,60,92
9803,FremontBridge,11/15/2013 11:00:00 AM,48,-122,23,33,56
9804,FremontBridge,11/15/2013 12:00:00 PM,48,-122,19,20,39
9805,FremontBridge,11/15/2013 01:00:00 PM,48,-122,20,25,45
9806,FremontBridge,11/15/2013 02:00:00 PM,48,-122,15,27,42
9807,FremontBridge,11/15/2013 03:00:00 PM,48,-122,57,41,98
9808,FremontBridge,11/15/2013 04:00:00 PM,48,-122,110,56,166
9809,FremontBridge,11/15/2013 05:00:00 PM,48,-122,220,89,309
9810,FremontBridge,11/15/2013 06:00:00 PM,48,-122,138,51,189
9811,FremontBridge,11/15/2013 07:00:00 PM,48,-122,62,30,92
9812,FremontBridge,11/15/2013 08:00:00 PM,48,-122,30,22,52
9813,FremontBridge,11/15/2013 09:00:00 PM,48,-122,12,14,26
9814,FremontBridge,11/15/2013 10:00:00 PM,48,-122,14,8,22
9815,FremontBridge,11/15/2013 11:00:00 PM,48,-122,9,6,15
9816,FremontBridge,11/16/2013 12:00:00 AM,48,-122,8,5,13
9817,FremontBridge,11/16/2013 01:00:00 AM,48,-122,3,3,6
9818,FremontBridge,11/16/2013 02:00:00 AM,48,-122,5,2,7
9819,FremontBridge,11/16/2013 03:00:00 AM,48,-122,0,0,0
9820,FremontBridge,11/16/2013 04:00:00 AM,48,-122,1,2,3
9821,FremontBridge,11/16/2013 05:00:00 AM,48,-122,4,1,5
9822,FremontBridge,11/16/2013 06:00:00 AM,48,-122,4,10,14
9823,FremontBridge,11/16/2013 07:00:00 AM,48,-122,6,10,16
9824,FremontBridge,11/16/2013 08:00:00 AM,48,-122,16,26,42
9825,FremontBridge,11/16/2013 09:00:00 AM,48,-122,38,34,72
9826,FremontBridge,11/16/2013 10:00:00 AM,48,-122,24,50,74
9827,FremontBridge,11/16/2013 11:00:00 AM,48,-122,59,55,114
9828,FremontBridge,11/16/2013 12:00:00 PM,48,-122,46,96,142
9829,FremontBridge,11/16/2013 01:00:00 PM,48,-122,50,56,106
9830,FremontBridge,11/16/2013 02:00:00 PM,48,-122,34,57,91
9831,FremontBridge,11/16/2013 03:00:00 PM,48,-122,48,42,90
9832,FremontBridge,11/16/2013 04:00:00 PM,48,-122,47,46,93
9833,FremontBridge,11/16/2013 05:00:00 PM,48,-122,33,40,73
9834,FremontBridge,11/16/2013 06:00:00 PM,48,-122,22,19,41
9835,FremontBridge,11/16/2013 07:00:00 PM,48,-122,12,24,36
9836,FremontBridge,11/16/2013 08:00:00 PM,48,-122,20,8,28
9837,FremontBridge,11/16/2013 09:00:00 PM,48,-122,15,9,24
9838,FremontBridge,11/16/2013 10:00:00 PM,48,-122,10,6,16
9839,FremontBridge,11/16/2013 11:00:00 PM,48,-122,11,4,15
9840,FremontBridge,11/17/2013 12:00:00 AM,48,-122,7,7,14
9841,FremontBridge,11/17/2013 01:00:00 AM,48,-122,2,4,6
9842,FremontBridge,11/17/2013 02:00:00 AM,48,-122,1,1,2
9843,FremontBridge,11/17/2013 03:00:00 AM,48,-122,1,5,6
9844,FremontBridge,11/17/2013 04:00:00 AM,48,-122,4,1,5
9845,FremontBridge,11/17/2013 05:00:00 AM,48,-122,3,1,4
9846,FremontBridge,11/17/2013 06:00:00 AM,48,-122,6,2,8
9847,FremontBridge,11/17/2013 07:00:00 AM,48,-122,5,11,16
9848,FremontBridge,11/17/2013 08:00:00 AM,48,-122,20,16,36
9849,FremontBridge,11/17/2013 09:00:00 AM,48,-122,27,38,65
9850,FremontBridge,11/17/2013 10:00:00 AM,48,-122,25,43,68
9851,FremontBridge,11/17/2013 11:00:00 AM,48,-122,43,49,92
9852,FremontBridge,11/17/2013 12:00:00 PM,48,-122,36,52,88
9853,FremontBridge,11/17/2013 01:00:00 PM,48,-122,45,37,82
9854,FremontBridge,11/17/2013 02:00:00 PM,48,-122,28,60,88
9855,FremontBridge,11/17/2013 03:00:00 PM,48,-122,36,52,88
9856,FremontBridge,11/17/2013 04:00:00 PM,48,-122,26,30,56
9857,FremontBridge,11/17/2013 05:00:00 PM,48,-122,32,36,68
9858,FremontBridge,11/17/2013 06:00:00 PM,48,-122,23,26,49
9859,FremontBridge,11/17/2013 07:00:00 PM,48,-122,20,31,51
9860,FremontBridge,11/17/2013 08:00:00 PM,48,-122,13,13,26
9861,FremontBridge,11/17/2013 09:00:00 PM,48,-122,8,14,22
9862,FremontBridge,11/17/2013 10:00:00 PM,48,-122,10,4,14
9863,FremontBridge,11/17/2013 11:00:00 PM,48,-122,6,6,12
9864,FremontBridge,11/18/2013 12:00:00 AM,48,-122,4,4,8
9865,FremontBridge,11/18/2013 01:00:00 AM,48,-122,1,2,3
9866,FremontBridge,11/18/2013 02:00:00 AM,48,-122,0,1,1
9867,FremontBridge,11/18/2013 03:00:00 AM,48,-122,0,2,2
9868,FremontBridge,11/18/2013 04:00:00 AM,48,-122,1,1,2
9869,FremontBridge,11/18/2013 05:00:00 AM,48,-122,9,16,25
9870,FremontBridge,11/18/2013 06:00:00 AM,48,-122,25,55,80
9871,FremontBridge,11/18/2013 07:00:00 AM,48,-122,61,167,228
9872,FremontBridge,11/18/2013 08:00:00 AM,48,-122,103,236,339
9873,FremontBridge,11/18/2013 09:00:00 AM,48,-122,81,147,228
9874,FremontBridge,11/18/2013 10:00:00 AM,48,-122,26,43,69
9875,FremontBridge,11/18/2013 11:00:00 AM,48,-122,17,31,48
9876,FremontBridge,11/18/2013 12:00:00 PM,48,-122,12,15,27
9877,FremontBridge,11/18/2013 01:00:00 PM,48,-122,23,16,39
9878,FremontBridge,11/18/2013 02:00:00 PM,48,-122,24,17,41
9879,FremontBridge,11/18/2013 03:00:00 PM,48,-122,35,29,64
9880,FremontBridge,11/18/2013 04:00:00 PM,48,-122,90,47,137
9881,FremontBridge,11/18/2013 05:00:00 PM,48,-122,234,87,321
9882,FremontBridge,11/18/2013 06:00:00 PM,48,-122,169,72,241
9883,FremontBridge,11/18/2013 07:00:00 PM,48,-122,72,31,103
9884,FremontBridge,11/18/2013 08:00:00 PM,48,-122,28,21,49
9885,FremontBridge,11/18/2013 09:00:00 PM,48,-122,16,11,27
9886,FremontBridge,11/18/2013 10:00:00 PM,48,-122,11,8,19
9887,FremontBridge,11/18/2013 11:00:00 PM,48,-122,4,7,11
9888,FremontBridge,11/19/2013 12:00:00 AM,48,-122,6,3,9
9889,FremontBridge,11/19/2013 01:00:00 AM,48,-122,3,2,5
9890,FremontBridge,11/19/2013 02:00:00 AM,48,-122,1,4,5
9891,FremontBridge,11/19/2013 03:00:00 AM,48,-122,0,1,1
9892,FremontBridge,11/19/2013 04:00:00 AM,48,-122,2,2,4
9893,FremontBridge,11/19/2013 05:00:00 AM,48,-122,3,17,20
9894,FremontBridge,11/19/2013 06:00:00 AM,48,-122,27,51,78
9895,FremontBridge,11/19/2013 07:00:00 AM,48,-122,59,161,220
9896,FremontBridge,11/19/2013 08:00:00 AM,48,-122,91,228,319
9897,FremontBridge,11/19/2013 09:00:00 AM,48,-122,70,124,194
9898,FremontBridge,11/19/2013 10:00:00 AM,48,-122,37,55,92
9899,FremontBridge,11/19/2013 11:00:00 AM,48,-122,14,32,46
9900,FremontBridge,11/19/2013 12:00:00 PM,48,-122,20,30,50
9901,FremontBridge,11/19/2013 01:00:00 PM,48,-122,23,22,45
9902,FremontBridge,11/19/2013 02:00:00 PM,48,-122,30,36,66
9903,FremontBridge,11/19/2013 03:00:00 PM,48,-122,49,47,96
9904,FremontBridge,11/19/2013 04:00:00 PM,48,-122,86,62,148
9905,FremontBridge,11/19/2013 05:00:00 PM,48,-122,252,105,357
9906,FremontBridge,11/19/2013 06:00:00 PM,48,-122,200,75,275
9907,FremontBridge,11/19/2013 07:00:00 PM,48,-122,78,26,104
9908,FremontBridge,11/19/2013 08:00:00 PM,48,-122,42,43,85
9909,FremontBridge,11/19/2013 09:00:00 PM,48,-122,21,23,44
9910,FremontBridge,11/19/2013 10:00:00 PM,48,-122,18,10,28
9911,FremontBridge,11/19/2013 11:00:00 PM,48,-122,11,7,18
9912,FremontBridge,11/20/2013 12:00:00 AM,48,-122,2,4,6
9913,FremontBridge,11/20/2013 01:00:00 AM,48,-122,2,2,4
9914,FremontBridge,11/20/2013 02:00:00 AM,48,-122,2,2,4
9915,FremontBridge,11/20/2013 03:00:00 AM,48,-122,0,4,4
9916,FremontBridge,11/20/2013 04:00:00 AM,48,-122,2,2,4
9917,FremontBridge,11/20/2013 05:00:00 AM,48,-122,5,19,24
9918,FremontBridge,11/20/2013 06:00:00 AM,48,-122,22,56,78
9919,FremontBridge,11/20/2013 07:00:00 AM,48,-122,70,161,231
9920,FremontBridge,11/20/2013 08:00:00 AM,48,-122,112,262,374
9921,FremontBridge,11/20/2013 09:00:00 AM,48,-122,114,178,292
9922,FremontBridge,11/20/2013 10:00:00 AM,48,-122,37,44,81
9923,FremontBridge,11/20/2013 11:00:00 AM,48,-122,34,53,87
9924,FremontBridge,11/20/2013 12:00:00 PM,48,-122,31,41,72
9925,FremontBridge,11/20/2013 01:00:00 PM,48,-122,41,50,91
9926,FremontBridge,11/20/2013 02:00:00 PM,48,-122,48,45,93
9927,FremontBridge,11/20/2013 03:00:00 PM,48,-122,61,68,129
9928,FremontBridge,11/20/2013 04:00:00 PM,48,-122,127,93,220
9929,FremontBridge,11/20/2013 05:00:00 PM,48,-122,285,121,406
9930,FremontBridge,11/20/2013 06:00:00 PM,48,-122,206,117,323
9931,FremontBridge,11/20/2013 07:00:00 PM,48,-122,88,42,130
9932,FremontBridge,11/20/2013 08:00:00 PM,48,-122,41,17,58
9933,FremontBridge,11/20/2013 09:00:00 PM,48,-122,32,24,56
9934,FremontBridge,11/20/2013 10:00:00 PM,48,-122,18,14,32
9935,FremontBridge,11/20/2013 11:00:00 PM,48,-122,9,26,35
9936,FremontBridge,11/21/2013 12:00:00 AM,48,-122,7,6,13
9937,FremontBridge,11/21/2013 01:00:00 AM,48,-122,2,1,3
9938,FremontBridge,11/21/2013 02:00:00 AM,48,-122,0,3,3
9939,FremontBridge,11/21/2013 03:00:00 AM,48,-122,1,3,4
9940,FremontBridge,11/21/2013 04:00:00 AM,48,-122,11,1,12
9941,FremontBridge,11/21/2013 05:00:00 AM,48,-122,3,20,23
9942,FremontBridge,11/21/2013 06:00:00 AM,48,-122,17,49,66
9943,FremontBridge,11/21/2013 07:00:00 AM,48,-122,60,151,211
9944,FremontBridge,11/21/2013 08:00:00 AM,48,-122,97,245,342
9945,FremontBridge,11/21/2013 09:00:00 AM,48,-122,81,145,226
9946,FremontBridge,11/21/2013 10:00:00 AM,48,-122,40,63,103
9947,FremontBridge,11/21/2013 11:00:00 AM,48,-122,37,39,76
9948,FremontBridge,11/21/2013 12:00:00 PM,48,-122,43,35,78
9949,FremontBridge,11/21/2013 01:00:00 PM,48,-122,32,47,79
9950,FremontBridge,11/21/2013 02:00:00 PM,48,-122,38,49,87
9951,FremontBridge,11/21/2013 03:00:00 PM,48,-122,66,54,120
9952,FremontBridge,11/21/2013 04:00:00 PM,48,-122,106,74,180
9953,FremontBridge,11/21/2013 05:00:00 PM,48,-122,210,93,303
9954,FremontBridge,11/21/2013 06:00:00 PM,48,-122,199,84,283
9955,FremontBridge,11/21/2013 07:00:00 PM,48,-122,91,41,132
9956,FremontBridge,11/21/2013 08:00:00 PM,48,-122,46,23,69
9957,FremontBridge,11/21/2013 09:00:00 PM,48,-122,16,19,35
9958,FremontBridge,11/21/2013 10:00:00 PM,48,-122,20,9,29
9959,FremontBridge,11/21/2013 11:00:00 PM,48,-122,7,21,28
9960,FremontBridge,11/22/2013 12:00:00 AM,48,-122,10,6,16
9961,FremontBridge,11/22/2013 01:00:00 AM,48,-122,4,2,6
9962,FremontBridge,11/22/2013 02:00:00 AM,48,-122,1,4,5
9963,FremontBridge,11/22/2013 03:00:00 AM,48,-122,0,3,3
9964,FremontBridge,11/22/2013 04:00:00 AM,48,-122,2,2,4
9965,FremontBridge,11/22/2013 05:00:00 AM,48,-122,2,13,15
9966,FremontBridge,11/22/2013 06:00:00 AM,48,-122,19,44,63
9967,FremontBridge,11/22/2013 07:00:00 AM,48,-122,54,139,193
9968,FremontBridge,11/22/2013 08:00:00 AM,48,-122,80,208,288
9969,FremontBridge,11/22/2013 09:00:00 AM,48,-122,68,152,220
9970,FremontBridge,11/22/2013 10:00:00 AM,48,-122,35,55,90
9971,FremontBridge,11/22/2013 11:00:00 AM,48,-122,26,31,57
9972,FremontBridge,11/22/2013 12:00:00 PM,48,-122,38,48,86
9973,FremontBridge,11/22/2013 01:00:00 PM,48,-122,30,46,76
9974,FremontBridge,11/22/2013 02:00:00 PM,48,-122,33,54,87
9975,FremontBridge,11/22/2013 03:00:00 PM,48,-122,80,65,145
9976,FremontBridge,11/22/2013 04:00:00 PM,48,-122,114,87,201
9977,FremontBridge,11/22/2013 05:00:00 PM,48,-122,221,90,311
9978,FremontBridge,11/22/2013 06:00:00 PM,48,-122,153,66,219
9979,FremontBridge,11/22/2013 07:00:00 PM,48,-122,56,64,120
9980,FremontBridge,11/22/2013 08:00:00 PM,48,-122,26,13,39
9981,FremontBridge,11/22/2013 09:00:00 PM,48,-122,15,15,30
9982,FremontBridge,11/22/2013 10:00:00 PM,48,-122,13,15,28
9983,FremontBridge,11/22/2013 11:00:00 PM,48,-122,14,14,28
9984,FremontBridge,11/23/2013 12:00:00 AM,48,-122,15,6,21
9985,FremontBridge,11/23/2013 01:00:00 AM,48,-122,1,2,3
9986,FremontBridge,11/23/2013 02:00:00 AM,48,-122,5,6,11
9987,FremontBridge,11/23/2013 03:00:00 AM,48,-122,1,3,4
9988,FremontBridge,11/23/2013 04:00:00 AM,48,-122,2,1,3
9989,FremontBridge,11/23/2013 05:00:00 AM,48,-122,5,4,9
9990,FremontBridge,11/23/2013 06:00:00 AM,48,-122,6,10,16
9991,FremontBridge,11/23/2013 07:00:00 AM,48,-122,9,12,21
9992,FremontBridge,11/23/2013 08:00:00 AM,48,-122,21,20,41
9993,FremontBridge,11/23/2013 09:00:00 AM,48,-122,26,30,56
9994,FremontBridge,11/23/2013 10:00:00 AM,48,-122,48,43,91
9995,FremontBridge,11/23/2013 11:00:00 AM,48,-122,32,119,151
9996,FremontBridge,11/23/2013 12:00:00 PM,48,-122,39,62,101
9997,FremontBridge,11/23/2013 01:00:00 PM,48,-122,47,87,134
9998,FremontBridge,11/23/2013 02:00:00 PM,48,-122,64,71,135
9999,FremontBridge,11/23/2013 03:00:00 PM,48,-122,47,59,106
10000,FremontBridge,11/23/2013 04:00:00 PM,48,-122,37,48,85
10001,FremontBridge,11/23/2013 05:00:00 PM,48,-122,32,28,60
10002,FremontBridge,11/23/2013 06:00:00 PM,48,-122,20,19,39
10003,FremontBridge,11/23/2013 07:00:00 PM,48,-122,16,17,33
10004,FremontBridge,11/23/2013 08:00:00 PM,48,-122,13,18,31
10005,FremontBridge,11/23/2013 09:00:00 PM,48,-122,12,12,24
10006,FremontBridge,11/23/2013 10:00:00 PM,48,-122,11,5,16
10007,FremontBridge,11/23/2013 11:00:00 PM,48,-122,15,4,19
10008,FremontBridge,11/24/2013 12:00:00 AM,48,-122,2,8,10
10009,FremontBridge,11/24/2013 01:00:00 AM,48,-122,5,1,6
10010,FremontBridge,11/24/2013 02:00:00 AM,48,-122,1,4,5
10011,FremontBridge,11/24/2013 03:00:00 AM,48,-122,2,2,4
10012,FremontBridge,11/24/2013 04:00:00 AM,48,-122,2,2,4
10013,FremontBridge,11/24/2013 05:00:00 AM,48,-122,0,4,4
10014,FremontBridge,11/24/2013 06:00:00 AM,48,-122,2,1,3
10015,FremontBridge,11/24/2013 07:00:00 AM,48,-122,9,6,15
10016,FremontBridge,11/24/2013 08:00:00 AM,48,-122,12,23,35
10017,FremontBridge,11/24/2013 09:00:00 AM,48,-122,20,30,50
10018,FremontBridge,11/24/2013 10:00:00 AM,48,-122,36,44,80
10019,FremontBridge,11/24/2013 11:00:00 AM,48,-122,31,61,92
10020,FremontBridge,11/24/2013 12:00:00 PM,48,-122,42,62,104
10021,FremontBridge,11/24/2013 01:00:00 PM,48,-122,55,73,128
10022,FremontBridge,11/24/2013 02:00:00 PM,48,-122,55,80,135
10023,FremontBridge,11/24/2013 03:00:00 PM,48,-122,55,94,149
10024,FremontBridge,11/24/2013 04:00:00 PM,48,-122,54,63,117
10025,FremontBridge,11/24/2013 05:00:00 PM,48,-122,41,27,68
10026,FremontBridge,11/24/2013 06:00:00 PM,48,-122,14,26,40
10027,FremontBridge,11/24/2013 07:00:00 PM,48,-122,15,6,21
10028,FremontBridge,11/24/2013 08:00:00 PM,48,-122,20,16,36
10029,FremontBridge,11/24/2013 09:00:00 PM,48,-122,5,4,9
10030,FremontBridge,11/24/2013 10:00:00 PM,48,-122,12,5,17
10031,FremontBridge,11/24/2013 11:00:00 PM,48,-122,7,2,9
10032,FremontBridge,11/25/2013 12:00:00 AM,48,-122,3,5,8
10033,FremontBridge,11/25/2013 01:00:00 AM,48,-122,1,4,5
10034,FremontBridge,11/25/2013 02:00:00 AM,48,-122,1,3,4
10035,FremontBridge,11/25/2013 03:00:00 AM,48,-122,1,1,2
10036,FremontBridge,11/25/2013 04:00:00 AM,48,-122,4,4,8
10037,FremontBridge,11/25/2013 05:00:00 AM,48,-122,8,28,36
10038,FremontBridge,11/25/2013 06:00:00 AM,48,-122,28,57,85
10039,FremontBridge,11/25/2013 07:00:00 AM,48,-122,54,182,236
10040,FremontBridge,11/25/2013 08:00:00 AM,48,-122,103,239,342
10041,FremontBridge,11/25/2013 09:00:00 AM,48,-122,76,143,219
10042,FremontBridge,11/25/2013 10:00:00 AM,48,-122,33,62,95
10043,FremontBridge,11/25/2013 11:00:00 AM,48,-122,27,34,61
10044,FremontBridge,11/25/2013 12:00:00 PM,48,-122,26,42,68
10045,FremontBridge,11/25/2013 01:00:00 PM,48,-122,45,33,78
10046,FremontBridge,11/25/2013 02:00:00 PM,48,-122,40,39,79
10047,FremontBridge,11/25/2013 03:00:00 PM,48,-122,51,66,117
10048,FremontBridge,11/25/2013 04:00:00 PM,48,-122,123,70,193
10049,FremontBridge,11/25/2013 05:00:00 PM,48,-122,278,120,398
10050,FremontBridge,11/25/2013 06:00:00 PM,48,-122,206,108,314
10051,FremontBridge,11/25/2013 07:00:00 PM,48,-122,71,38,109
10052,FremontBridge,11/25/2013 08:00:00 PM,48,-122,43,24,67
10053,FremontBridge,11/25/2013 09:00:00 PM,48,-122,17,17,34
10054,FremontBridge,11/25/2013 10:00:00 PM,48,-122,21,12,33
10055,FremontBridge,11/25/2013 11:00:00 PM,48,-122,14,4,18
10056,FremontBridge,11/26/2013 12:00:00 AM,48,-122,4,6,10
10057,FremontBridge,11/26/2013 01:00:00 AM,48,-122,3,2,5
10058,FremontBridge,11/26/2013 02:00:00 AM,48,-122,0,2,2
10059,FremontBridge,11/26/2013 03:00:00 AM,48,-122,0,0,0
10060,FremontBridge,11/26/2013 04:00:00 AM,48,-122,4,2,6
10061,FremontBridge,11/26/2013 05:00:00 AM,48,-122,6,17,23
10062,FremontBridge,11/26/2013 06:00:00 AM,48,-122,28,59,87
10063,FremontBridge,11/26/2013 07:00:00 AM,48,-122,58,167,225
10064,FremontBridge,11/26/2013 08:00:00 AM,48,-122,93,253,346
10065,FremontBridge,11/26/2013 09:00:00 AM,48,-122,85,125,210
10066,FremontBridge,11/26/2013 10:00:00 AM,48,-122,32,55,87
10067,FremontBridge,11/26/2013 11:00:00 AM,48,-122,38,27,65
10068,FremontBridge,11/26/2013 12:00:00 PM,48,-122,24,59,83
10069,FremontBridge,11/26/2013 01:00:00 PM,48,-122,40,37,77
10070,FremontBridge,11/26/2013 02:00:00 PM,48,-122,39,59,98
10071,FremontBridge,11/26/2013 03:00:00 PM,48,-122,70,56,126
10072,FremontBridge,11/26/2013 04:00:00 PM,48,-122,118,80,198
10073,FremontBridge,11/26/2013 05:00:00 PM,48,-122,244,100,344
10074,FremontBridge,11/26/2013 06:00:00 PM,48,-122,168,102,270
10075,FremontBridge,11/26/2013 07:00:00 PM,48,-122,82,44,126
10076,FremontBridge,11/26/2013 08:00:00 PM,48,-122,41,27,68
10077,FremontBridge,11/26/2013 09:00:00 PM,48,-122,18,12,30
10078,FremontBridge,11/26/2013 10:00:00 PM,48,-122,21,18,39
10079,FremontBridge,11/26/2013 11:00:00 PM,48,-122,8,8,16
10080,FremontBridge,11/27/2013 12:00:00 AM,48,-122,2,4,6
10081,FremontBridge,11/27/2013 01:00:00 AM,48,-122,3,3,6
10082,FremontBridge,11/27/2013 02:00:00 AM,48,-122,2,2,4
10083,FremontBridge,11/27/2013 03:00:00 AM,48,-122,3,1,4
10084,FremontBridge,11/27/2013 04:00:00 AM,48,-122,2,4,6
10085,FremontBridge,11/27/2013 05:00:00 AM,48,-122,4,12,16
10086,FremontBridge,11/27/2013 06:00:00 AM,48,-122,18,61,79
10087,FremontBridge,11/27/2013 07:00:00 AM,48,-122,53,130,183
10088,FremontBridge,11/27/2013 08:00:00 AM,48,-122,86,188,274
10089,FremontBridge,11/27/2013 09:00:00 AM,48,-122,53,135,188
10090,FremontBridge,11/27/2013 10:00:00 AM,48,-122,46,55,101
10091,FremontBridge,11/27/2013 11:00:00 AM,48,-122,31,38,69
10092,FremontBridge,11/27/2013 12:00:00 PM,48,-122,26,49,75
10093,FremontBridge,11/27/2013 01:00:00 PM,48,-122,45,44,89
10094,FremontBridge,11/27/2013 02:00:00 PM,48,-122,84,62,146
10095,FremontBridge,11/27/2013 03:00:00 PM,48,-122,114,78,192
10096,FremontBridge,11/27/2013 04:00:00 PM,48,-122,157,81,238
10097,FremontBridge,11/27/2013 05:00:00 PM,48,-122,161,64,225
10098,FremontBridge,11/27/2013 06:00:00 PM,48,-122,88,70,158
10099,FremontBridge,11/27/2013 07:00:00 PM,48,-122,44,43,87
10100,FremontBridge,11/27/2013 08:00:00 PM,48,-122,29,13,42
10101,FremontBridge,11/27/2013 09:00:00 PM,48,-122,13,15,28
10102,FremontBridge,11/27/2013 10:00:00 PM,48,-122,14,9,23
10103,FremontBridge,11/27/2013 11:00:00 PM,48,-122,4,8,12
10104,FremontBridge,11/28/2013 12:00:00 AM,48,-122,6,6,12
10105,FremontBridge,11/28/2013 01:00:00 AM,48,-122,3,3,6
10106,FremontBridge,11/28/2013 02:00:00 AM,48,-122,2,2,4
10107,FremontBridge,11/28/2013 03:00:00 AM,48,-122,2,0,2
10108,FremontBridge,11/28/2013 04:00:00 AM,48,-122,1,3,4
10109,FremontBridge,11/28/2013 05:00:00 AM,48,-122,1,2,3
10110,FremontBridge,11/28/2013 06:00:00 AM,48,-122,2,3,5
10111,FremontBridge,11/28/2013 07:00:00 AM,48,-122,12,10,22
10112,FremontBridge,11/28/2013 08:00:00 AM,48,-122,9,11,20
10113,FremontBridge,11/28/2013 09:00:00 AM,48,-122,28,17,45
10114,FremontBridge,11/28/2013 10:00:00 AM,48,-122,32,25,57
10115,FremontBridge,11/28/2013 11:00:00 AM,48,-122,26,33,59
10116,FremontBridge,11/28/2013 12:00:00 PM,48,-122,39,29,68
10117,FremontBridge,11/28/2013 01:00:00 PM,48,-122,31,43,74
10118,FremontBridge,11/28/2013 02:00:00 PM,48,-122,21,37,58
10119,FremontBridge,11/28/2013 03:00:00 PM,48,-122,16,29,45
10120,FremontBridge,11/28/2013 04:00:00 PM,48,-122,9,17,26
10121,FremontBridge,11/28/2013 05:00:00 PM,48,-122,5,10,15
10122,FremontBridge,11/28/2013 06:00:00 PM,48,-122,4,7,11
10123,FremontBridge,11/28/2013 07:00:00 PM,48,-122,7,3,10
10124,FremontBridge,11/28/2013 08:00:00 PM,48,-122,4,7,11
10125,FremontBridge,11/28/2013 09:00:00 PM,48,-122,4,4,8
10126,FremontBridge,11/28/2013 10:00:00 PM,48,-122,4,4,8
10127,FremontBridge,11/28/2013 11:00:00 PM,48,-122,3,6,9
10128,FremontBridge,11/29/2013 12:00:00 AM,48,-122,9,2,11
10129,FremontBridge,11/29/2013 01:00:00 AM,48,-122,0,9,9
10130,FremontBridge,11/29/2013 02:00:00 AM,48,-122,3,2,5
10131,FremontBridge,11/29/2013 03:00:00 AM,48,-122,0,2,2
10132,FremontBridge,11/29/2013 04:00:00 AM,48,-122,2,3,5
10133,FremontBridge,11/29/2013 05:00:00 AM,48,-122,1,6,7
10134,FremontBridge,11/29/2013 06:00:00 AM,48,-122,10,18,28
10135,FremontBridge,11/29/2013 07:00:00 AM,48,-122,14,22,36
10136,FremontBridge,11/29/2013 08:00:00 AM,48,-122,13,18,31
10137,FremontBridge,11/29/2013 09:00:00 AM,48,-122,17,37,54
10138,FremontBridge,11/29/2013 10:00:00 AM,48,-122,32,35,67
10139,FremontBridge,11/29/2013 11:00:00 AM,48,-122,30,46,76
10140,FremontBridge,11/29/2013 12:00:00 PM,48,-122,42,44,86
10141,FremontBridge,11/29/2013 01:00:00 PM,48,-122,39,34,73
10142,FremontBridge,11/29/2013 02:00:00 PM,48,-122,32,49,81
10143,FremontBridge,11/29/2013 03:00:00 PM,48,-122,44,28,72
10144,FremontBridge,11/29/2013 04:00:00 PM,48,-122,41,62,103
10145,FremontBridge,11/29/2013 05:00:00 PM,48,-122,50,31,81
10146,FremontBridge,11/29/2013 06:00:00 PM,48,-122,40,24,64
10147,FremontBridge,11/29/2013 07:00:00 PM,48,-122,28,17,45
10148,FremontBridge,11/29/2013 08:00:00 PM,48,-122,10,10,20
10149,FremontBridge,11/29/2013 09:00:00 PM,48,-122,6,12,18
10150,FremontBridge,11/29/2013 10:00:00 PM,48,-122,7,5,12
10151,FremontBridge,11/29/2013 11:00:00 PM,48,-122,11,7,18
10152,FremontBridge,11/30/2013 12:00:00 AM,48,-122,4,2,6
10153,FremontBridge,11/30/2013 01:00:00 AM,48,-122,2,1,3
10154,FremontBridge,11/30/2013 02:00:00 AM,48,-122,1,1,2
10155,FremontBridge,11/30/2013 03:00:00 AM,48,-122,0,3,3
10156,FremontBridge,11/30/2013 04:00:00 AM,48,-122,2,1,3
10157,FremontBridge,11/30/2013 05:00:00 AM,48,-122,1,4,5
10158,FremontBridge,11/30/2013 06:00:00 AM,48,-122,7,6,13
10159,FremontBridge,11/30/2013 07:00:00 AM,48,-122,3,9,12
10160,FremontBridge,11/30/2013 08:00:00 AM,48,-122,24,29,53
10161,FremontBridge,11/30/2013 09:00:00 AM,48,-122,25,35,60
10162,FremontBridge,11/30/2013 10:00:00 AM,48,-122,20,37,57
10163,FremontBridge,11/30/2013 11:00:00 AM,48,-122,40,39,79
10164,FremontBridge,11/30/2013 12:00:00 PM,48,-122,28,41,69
10165,FremontBridge,11/30/2013 01:00:00 PM,48,-122,56,52,108
10166,FremontBridge,11/30/2013 02:00:00 PM,48,-122,35,46,81
10167,FremontBridge,11/30/2013 03:00:00 PM,48,-122,36,36,72
10168,FremontBridge,11/30/2013 04:00:00 PM,48,-122,34,27,61
10169,FremontBridge,11/30/2013 05:00:00 PM,48,-122,30,21,51
10170,FremontBridge,11/30/2013 06:00:00 PM,48,-122,13,16,29
10171,FremontBridge,11/30/2013 07:00:00 PM,48,-122,16,9,25
10172,FremontBridge,11/30/2013 08:00:00 PM,48,-122,17,10,27
10173,FremontBridge,11/30/2013 09:00:00 PM,48,-122,11,6,17
10174,FremontBridge,11/30/2013 10:00:00 PM,48,-122,8,3,11
10175,FremontBridge,11/30/2013 11:00:00 PM,48,-122,10,8,18
10176,FremontBridge,12/01/2013 12:00:00 AM,48,-122,8,4,12
10177,FremontBridge,12/01/2013 01:00:00 AM,48,-122,4,3,7
10178,FremontBridge,12/01/2013 02:00:00 AM,48,-122,4,1,5
10179,FremontBridge,12/01/2013 03:00:00 AM,48,-122,0,1,1
10180,FremontBridge,12/01/2013 04:00:00 AM,48,-122,2,1,3
10181,FremontBridge,12/01/2013 05:00:00 AM,48,-122,0,2,2
10182,FremontBridge,12/01/2013 06:00:00 AM,48,-122,2,6,8
10183,FremontBridge,12/01/2013 07:00:00 AM,48,-122,6,14,20
10184,FremontBridge,12/01/2013 08:00:00 AM,48,-122,16,12,28
10185,FremontBridge,12/01/2013 09:00:00 AM,48,-122,15,18,33
10186,FremontBridge,12/01/2013 10:00:00 AM,48,-122,24,29,53
10187,FremontBridge,12/01/2013 11:00:00 AM,48,-122,29,28,57
10188,FremontBridge,12/01/2013 12:00:00 PM,48,-122,35,34,69
10189,FremontBridge,12/01/2013 01:00:00 PM,48,-122,18,43,61
10190,FremontBridge,12/01/2013 02:00:00 PM,48,-122,27,41,68
10191,FremontBridge,12/01/2013 03:00:00 PM,48,-122,30,30,60
10192,FremontBridge,12/01/2013 04:00:00 PM,48,-122,13,43,56
10193,FremontBridge,12/01/2013 05:00:00 PM,48,-122,14,26,40
10194,FremontBridge,12/01/2013 06:00:00 PM,48,-122,9,10,19
10195,FremontBridge,12/01/2013 07:00:00 PM,48,-122,9,11,20
10196,FremontBridge,12/01/2013 08:00:00 PM,48,-122,6,10,16
10197,FremontBridge,12/01/2013 09:00:00 PM,48,-122,2,8,10
10198,FremontBridge,12/01/2013 10:00:00 PM,48,-122,15,5,20
10199,FremontBridge,12/01/2013 11:00:00 PM,48,-122,10,3,13
10200,FremontBridge,12/02/2013 12:00:00 AM,48,-122,2,7,9
10201,FremontBridge,12/02/2013 01:00:00 AM,48,-122,0,2,2
10202,FremontBridge,12/02/2013 02:00:00 AM,48,-122,1,1,2
10203,FremontBridge,12/02/2013 03:00:00 AM,48,-122,0,4,4
10204,FremontBridge,12/02/2013 04:00:00 AM,48,-122,2,2,4
10205,FremontBridge,12/02/2013 05:00:00 AM,48,-122,6,22,28
10206,FremontBridge,12/02/2013 06:00:00 AM,48,-122,23,50,73
10207,FremontBridge,12/02/2013 07:00:00 AM,48,-122,55,163,218
10208,FremontBridge,12/02/2013 08:00:00 AM,48,-122,97,211,308
10209,FremontBridge,12/02/2013 09:00:00 AM,48,-122,67,142,209
10210,FremontBridge,12/02/2013 10:00:00 AM,48,-122,24,41,65
10211,FremontBridge,12/02/2013 11:00:00 AM,48,-122,38,32,70
10212,FremontBridge,12/02/2013 12:00:00 PM,48,-122,32,41,73
10213,FremontBridge,12/02/2013 01:00:00 PM,48,-122,27,35,62
10214,FremontBridge,12/02/2013 02:00:00 PM,48,-122,40,42,82
10215,FremontBridge,12/02/2013 03:00:00 PM,48,-122,47,57,104
10216,FremontBridge,12/02/2013 04:00:00 PM,48,-122,107,74,181
10217,FremontBridge,12/02/2013 05:00:00 PM,48,-122,240,98,338
10218,FremontBridge,12/02/2013 06:00:00 PM,48,-122,154,92,246
10219,FremontBridge,12/02/2013 07:00:00 PM,48,-122,54,33,87
10220,FremontBridge,12/02/2013 08:00:00 PM,48,-122,30,19,49
10221,FremontBridge,12/02/2013 09:00:00 PM,48,-122,21,17,38
10222,FremontBridge,12/02/2013 10:00:00 PM,48,-122,11,10,21
10223,FremontBridge,12/02/2013 11:00:00 PM,48,-122,6,4,10
10224,FremontBridge,12/03/2013 12:00:00 AM,48,-122,5,6,11
10225,FremontBridge,12/03/2013 01:00:00 AM,48,-122,2,1,3
10226,FremontBridge,12/03/2013 02:00:00 AM,48,-122,1,2,3
10227,FremontBridge,12/03/2013 03:00:00 AM,48,-122,0,3,3
10228,FremontBridge,12/03/2013 04:00:00 AM,48,-122,2,3,5
10229,FremontBridge,12/03/2013 05:00:00 AM,48,-122,3,16,19
10230,FremontBridge,12/03/2013 06:00:00 AM,48,-122,25,45,70
10231,FremontBridge,12/03/2013 07:00:00 AM,48,-122,60,130,190
10232,FremontBridge,12/03/2013 08:00:00 AM,48,-122,92,217,309
10233,FremontBridge,12/03/2013 09:00:00 AM,48,-122,85,134,219
10234,FremontBridge,12/03/2013 10:00:00 AM,48,-122,32,52,84
10235,FremontBridge,12/03/2013 11:00:00 AM,48,-122,36,27,63
10236,FremontBridge,12/03/2013 12:00:00 PM,48,-122,18,36,54
10237,FremontBridge,12/03/2013 01:00:00 PM,48,-122,24,33,57
10238,FremontBridge,12/03/2013 02:00:00 PM,48,-122,34,37,71
10239,FremontBridge,12/03/2013 03:00:00 PM,48,-122,41,42,83
10240,FremontBridge,12/03/2013 04:00:00 PM,48,-122,92,63,155
10241,FremontBridge,12/03/2013 05:00:00 PM,48,-122,205,91,296
10242,FremontBridge,12/03/2013 06:00:00 PM,48,-122,167,82,249
10243,FremontBridge,12/03/2013 07:00:00 PM,48,-122,70,44,114
10244,FremontBridge,12/03/2013 08:00:00 PM,48,-122,28,19,47
10245,FremontBridge,12/03/2013 09:00:00 PM,48,-122,33,15,48
10246,FremontBridge,12/03/2013 10:00:00 PM,48,-122,21,17,38
10247,FremontBridge,12/03/2013 11:00:00 PM,48,-122,10,10,20
10248,FremontBridge,12/04/2013 12:00:00 AM,48,-122,10,4,14
10249,FremontBridge,12/04/2013 01:00:00 AM,48,-122,1,0,1
10250,FremontBridge,12/04/2013 02:00:00 AM,48,-122,1,3,4
10251,FremontBridge,12/04/2013 03:00:00 AM,48,-122,0,1,1
10252,FremontBridge,12/04/2013 04:00:00 AM,48,-122,2,3,5
10253,FremontBridge,12/04/2013 05:00:00 AM,48,-122,8,14,22
10254,FremontBridge,12/04/2013 06:00:00 AM,48,-122,10,50,60
10255,FremontBridge,12/04/2013 07:00:00 AM,48,-122,36,120,156
10256,FremontBridge,12/04/2013 08:00:00 AM,48,-122,89,201,290
10257,FremontBridge,12/04/2013 09:00:00 AM,48,-122,60,146,206
10258,FremontBridge,12/04/2013 10:00:00 AM,48,-122,41,44,85
10259,FremontBridge,12/04/2013 11:00:00 AM,48,-122,24,37,61
10260,FremontBridge,12/04/2013 12:00:00 PM,48,-122,23,33,56
10261,FremontBridge,12/04/2013 01:00:00 PM,48,-122,22,31,53
10262,FremontBridge,12/04/2013 02:00:00 PM,48,-122,20,39,59
10263,FremontBridge,12/04/2013 03:00:00 PM,48,-122,35,50,85
10264,FremontBridge,12/04/2013 04:00:00 PM,48,-122,84,54,138
10265,FremontBridge,12/04/2013 05:00:00 PM,48,-122,208,93,301
10266,FremontBridge,12/04/2013 06:00:00 PM,48,-122,174,87,261
10267,FremontBridge,12/04/2013 07:00:00 PM,48,-122,52,30,82
10268,FremontBridge,12/04/2013 08:00:00 PM,48,-122,27,20,47
10269,FremontBridge,12/04/2013 09:00:00 PM,48,-122,25,17,42
10270,FremontBridge,12/04/2013 10:00:00 PM,48,-122,14,9,23
10271,FremontBridge,12/04/2013 11:00:00 PM,48,-122,13,13,26
10272,FremontBridge,12/05/2013 12:00:00 AM,48,-122,6,4,10
10273,FremontBridge,12/05/2013 01:00:00 AM,48,-122,1,1,2
10274,FremontBridge,12/05/2013 02:00:00 AM,48,-122,1,1,2
10275,FremontBridge,12/05/2013 03:00:00 AM,48,-122,1,2,3
10276,FremontBridge,12/05/2013 04:00:00 AM,48,-122,2,2,4
10277,FremontBridge,12/05/2013 05:00:00 AM,48,-122,2,16,18
10278,FremontBridge,12/05/2013 06:00:00 AM,48,-122,16,43,59
10279,FremontBridge,12/05/2013 07:00:00 AM,48,-122,58,113,171
10280,FremontBridge,12/05/2013 08:00:00 AM,48,-122,90,177,267
10281,FremontBridge,12/05/2013 09:00:00 AM,48,-122,65,123,188
10282,FremontBridge,12/05/2013 10:00:00 AM,48,-122,39,45,84
10283,FremontBridge,12/05/2013 11:00:00 AM,48,-122,13,25,38
10284,FremontBridge,12/05/2013 12:00:00 PM,48,-122,24,22,46
10285,FremontBridge,12/05/2013 01:00:00 PM,48,-122,27,28,55
10286,FremontBridge,12/05/2013 02:00:00 PM,48,-122,20,29,49
10287,FremontBridge,12/05/2013 03:00:00 PM,48,-122,44,42,86
10288,FremontBridge,12/05/2013 04:00:00 PM,48,-122,74,56,130
10289,FremontBridge,12/05/2013 05:00:00 PM,48,-122,178,90,268
10290,FremontBridge,12/05/2013 06:00:00 PM,48,-122,136,86,222
10291,FremontBridge,12/05/2013 07:00:00 PM,48,-122,66,37,103
10292,FremontBridge,12/05/2013 08:00:00 PM,48,-122,38,17,55
10293,FremontBridge,12/05/2013 09:00:00 PM,48,-122,20,13,33
10294,FremontBridge,12/05/2013 10:00:00 PM,48,-122,18,6,24
10295,FremontBridge,12/05/2013 11:00:00 PM,48,-122,11,10,21
10296,FremontBridge,12/06/2013 12:00:00 AM,48,-122,6,3,9
10297,FremontBridge,12/06/2013 01:00:00 AM,48,-122,9,5,14
10298,FremontBridge,12/06/2013 02:00:00 AM,48,-122,4,0,4
10299,FremontBridge,12/06/2013 03:00:00 AM,48,-122,2,2,4
10300,FremontBridge,12/06/2013 04:00:00 AM,48,-122,2,3,5
10301,FremontBridge,12/06/2013 05:00:00 AM,48,-122,1,10,11
10302,FremontBridge,12/06/2013 06:00:00 AM,48,-122,18,30,48
10303,FremontBridge,12/06/2013 07:00:00 AM,48,-122,36,88,124
10304,FremontBridge,12/06/2013 08:00:00 AM,48,-122,59,161,220
10305,FremontBridge,12/06/2013 09:00:00 AM,48,-122,53,105,158
10306,FremontBridge,12/06/2013 10:00:00 AM,48,-122,45,45,90
10307,FremontBridge,12/06/2013 11:00:00 AM,48,-122,25,44,69
10308,FremontBridge,12/06/2013 12:00:00 PM,48,-122,19,28,47
10309,FremontBridge,12/06/2013 01:00:00 PM,48,-122,25,21,46
10310,FremontBridge,12/06/2013 02:00:00 PM,48,-122,41,38,79
10311,FremontBridge,12/06/2013 03:00:00 PM,48,-122,40,34,74
10312,FremontBridge,12/06/2013 04:00:00 PM,48,-122,85,49,134
10313,FremontBridge,12/06/2013 05:00:00 PM,48,-122,143,82,225
10314,FremontBridge,12/06/2013 06:00:00 PM,48,-122,112,50,162
10315,FremontBridge,12/06/2013 07:00:00 PM,48,-122,38,19,57
10316,FremontBridge,12/06/2013 08:00:00 PM,48,-122,30,14,44
10317,FremontBridge,12/06/2013 09:00:00 PM,48,-122,12,8,20
10318,FremontBridge,12/06/2013 10:00:00 PM,48,-122,18,11,29
10319,FremontBridge,12/06/2013 11:00:00 PM,48,-122,10,11,21
10320,FremontBridge,12/07/2013 12:00:00 AM,48,-122,5,3,8
10321,FremontBridge,12/07/2013 01:00:00 AM,48,-122,4,7,11
10322,FremontBridge,12/07/2013 02:00:00 AM,48,-122,3,2,5
10323,FremontBridge,12/07/2013 03:00:00 AM,48,-122,3,1,4
10324,FremontBridge,12/07/2013 04:00:00 AM,48,-122,1,0,1
10325,FremontBridge,12/07/2013 05:00:00 AM,48,-122,1,3,4
10326,FremontBridge,12/07/2013 06:00:00 AM,48,-122,5,5,10
10327,FremontBridge,12/07/2013 07:00:00 AM,48,-122,7,13,20
10328,FremontBridge,12/07/2013 08:00:00 AM,48,-122,5,13,18
10329,FremontBridge,12/07/2013 09:00:00 AM,48,-122,21,21,42
10330,FremontBridge,12/07/2013 10:00:00 AM,48,-122,17,15,32
10331,FremontBridge,12/07/2013 11:00:00 AM,48,-122,14,24,38
10332,FremontBridge,12/07/2013 12:00:00 PM,48,-122,33,34,67
10333,FremontBridge,12/07/2013 01:00:00 PM,48,-122,21,42,63
10334,FremontBridge,12/07/2013 02:00:00 PM,48,-122,25,34,59
10335,FremontBridge,12/07/2013 03:00:00 PM,48,-122,26,29,55
10336,FremontBridge,12/07/2013 04:00:00 PM,48,-122,25,18,43
10337,FremontBridge,12/07/2013 05:00:00 PM,48,-122,11,14,25
10338,FremontBridge,12/07/2013 06:00:00 PM,48,-122,10,8,18
10339,FremontBridge,12/07/2013 07:00:00 PM,48,-122,7,7,14
10340,FremontBridge,12/07/2013 08:00:00 PM,48,-122,9,9,18
10341,FremontBridge,12/07/2013 09:00:00 PM,48,-122,6,9,15
10342,FremontBridge,12/07/2013 10:00:00 PM,48,-122,6,7,13
10343,FremontBridge,12/07/2013 11:00:00 PM,48,-122,5,3,8
10344,FremontBridge,12/08/2013 12:00:00 AM,48,-122,3,3,6
10345,FremontBridge,12/08/2013 01:00:00 AM,48,-122,4,0,4
10346,FremontBridge,12/08/2013 02:00:00 AM,48,-122,1,0,1
10347,FremontBridge,12/08/2013 03:00:00 AM,48,-122,1,1,2
10348,FremontBridge,12/08/2013 04:00:00 AM,48,-122,1,0,1
10349,FremontBridge,12/08/2013 05:00:00 AM,48,-122,3,2,5
10350,FremontBridge,12/08/2013 06:00:00 AM,48,-122,2,1,3
10351,FremontBridge,12/08/2013 07:00:00 AM,48,-122,4,5,9
10352,FremontBridge,12/08/2013 08:00:00 AM,48,-122,5,8,13
10353,FremontBridge,12/08/2013 09:00:00 AM,48,-122,9,7,16
10354,FremontBridge,12/08/2013 10:00:00 AM,48,-122,14,21,35
10355,FremontBridge,12/08/2013 11:00:00 AM,48,-122,14,15,29
10356,FremontBridge,12/08/2013 12:00:00 PM,48,-122,15,22,37
10357,FremontBridge,12/08/2013 01:00:00 PM,48,-122,16,40,56
10358,FremontBridge,12/08/2013 02:00:00 PM,48,-122,27,25,52
10359,FremontBridge,12/08/2013 03:00:00 PM,48,-122,24,24,48
10360,FremontBridge,12/08/2013 04:00:00 PM,48,-122,14,18,32
10361,FremontBridge,12/08/2013 05:00:00 PM,48,-122,21,10,31
10362,FremontBridge,12/08/2013 06:00:00 PM,48,-122,10,12,22
10363,FremontBridge,12/08/2013 07:00:00 PM,48,-122,14,8,22
10364,FremontBridge,12/08/2013 08:00:00 PM,48,-122,6,8,14
10365,FremontBridge,12/08/2013 09:00:00 PM,48,-122,8,6,14
10366,FremontBridge,12/08/2013 10:00:00 PM,48,-122,8,4,12
10367,FremontBridge,12/08/2013 11:00:00 PM,48,-122,6,3,9
10368,FremontBridge,12/09/2013 12:00:00 AM,48,-122,5,2,7
10369,FremontBridge,12/09/2013 01:00:00 AM,48,-122,2,2,4
10370,FremontBridge,12/09/2013 02:00:00 AM,48,-122,0,1,1
10371,FremontBridge,12/09/2013 03:00:00 AM,48,-122,1,0,1
10372,FremontBridge,12/09/2013 04:00:00 AM,48,-122,3,2,5
10373,FremontBridge,12/09/2013 05:00:00 AM,48,-122,1,10,11
10374,FremontBridge,12/09/2013 06:00:00 AM,48,-122,20,47,67
10375,FremontBridge,12/09/2013 07:00:00 AM,48,-122,46,108,154
10376,FremontBridge,12/09/2013 08:00:00 AM,48,-122,58,198,256
10377,FremontBridge,12/09/2013 09:00:00 AM,48,-122,74,113,187
10378,FremontBridge,12/09/2013 10:00:00 AM,48,-122,19,43,62
10379,FremontBridge,12/09/2013 11:00:00 AM,48,-122,17,29,46
10380,FremontBridge,12/09/2013 12:00:00 PM,48,-122,32,22,54
10381,FremontBridge,12/09/2013 01:00:00 PM,48,-122,16,16,32
10382,FremontBridge,12/09/2013 02:00:00 PM,48,-122,36,20,56
10383,FremontBridge,12/09/2013 03:00:00 PM,48,-122,28,28,56
10384,FremontBridge,12/09/2013 04:00:00 PM,48,-122,78,44,122
10385,FremontBridge,12/09/2013 05:00:00 PM,48,-122,188,83,271
10386,FremontBridge,12/09/2013 06:00:00 PM,48,-122,129,74,203
10387,FremontBridge,12/09/2013 07:00:00 PM,48,-122,72,26,98
10388,FremontBridge,12/09/2013 08:00:00 PM,48,-122,31,16,47
10389,FremontBridge,12/09/2013 09:00:00 PM,48,-122,14,10,24
10390,FremontBridge,12/09/2013 10:00:00 PM,48,-122,12,7,19
10391,FremontBridge,12/09/2013 11:00:00 PM,48,-122,5,5,10
10392,FremontBridge,12/10/2013 12:00:00 AM,48,-122,6,3,9
10393,FremontBridge,12/10/2013 01:00:00 AM,48,-122,0,2,2
10394,FremontBridge,12/10/2013 02:00:00 AM,48,-122,2,4,6
10395,FremontBridge,12/10/2013 03:00:00 AM,48,-122,2,1,3
10396,FremontBridge,12/10/2013 04:00:00 AM,48,-122,2,0,2
10397,FremontBridge,12/10/2013 05:00:00 AM,48,-122,4,12,16
10398,FremontBridge,12/10/2013 06:00:00 AM,48,-122,20,31,51
10399,FremontBridge,12/10/2013 07:00:00 AM,48,-122,41,122,163
10400,FremontBridge,12/10/2013 08:00:00 AM,48,-122,76,196,272
10401,FremontBridge,12/10/2013 09:00:00 AM,48,-122,56,120,176
10402,FremontBridge,12/10/2013 10:00:00 AM,48,-122,31,46,77
10403,FremontBridge,12/10/2013 11:00:00 AM,48,-122,23,26,49
10404,FremontBridge,12/10/2013 12:00:00 PM,48,-122,20,34,54
10405,FremontBridge,12/10/2013 01:00:00 PM,48,-122,24,29,53
10406,FremontBridge,12/10/2013 02:00:00 PM,48,-122,22,35,57
10407,FremontBridge,12/10/2013 03:00:00 PM,48,-122,41,31,72
10408,FremontBridge,12/10/2013 04:00:00 PM,48,-122,74,52,126
10409,FremontBridge,12/10/2013 05:00:00 PM,48,-122,166,68,234
10410,FremontBridge,12/10/2013 06:00:00 PM,48,-122,153,81,234
10411,FremontBridge,12/10/2013 07:00:00 PM,48,-122,64,29,93
10412,FremontBridge,12/10/2013 08:00:00 PM,48,-122,36,15,51
10413,FremontBridge,12/10/2013 09:00:00 PM,48,-122,17,15,32
10414,FremontBridge,12/10/2013 10:00:00 PM,48,-122,8,9,17
10415,FremontBridge,12/10/2013 11:00:00 PM,48,-122,15,6,21
10416,FremontBridge,12/11/2013 12:00:00 AM,48,-122,4,4,8
10417,FremontBridge,12/11/2013 01:00:00 AM,48,-122,4,6,10
10418,FremontBridge,12/11/2013 02:00:00 AM,48,-122,2,5,7
10419,FremontBridge,12/11/2013 03:00:00 AM,48,-122,2,0,2
10420,FremontBridge,12/11/2013 04:00:00 AM,48,-122,3,4,7
10421,FremontBridge,12/11/2013 05:00:00 AM,48,-122,7,10,17
10422,FremontBridge,12/11/2013 06:00:00 AM,48,-122,18,57,75
10423,FremontBridge,12/11/2013 07:00:00 AM,48,-122,55,121,176
10424,FremontBridge,12/11/2013 08:00:00 AM,48,-122,76,234,310
10425,FremontBridge,12/11/2013 09:00:00 AM,48,-122,90,129,219
10426,FremontBridge,12/11/2013 10:00:00 AM,48,-122,29,42,71
10427,FremontBridge,12/11/2013 11:00:00 AM,48,-122,23,24,47
10428,FremontBridge,12/11/2013 12:00:00 PM,48,-122,19,28,47
10429,FremontBridge,12/11/2013 01:00:00 PM,48,-122,26,23,49
10430,FremontBridge,12/11/2013 02:00:00 PM,48,-122,28,41,69
10431,FremontBridge,12/11/2013 03:00:00 PM,48,-122,32,52,84
10432,FremontBridge,12/11/2013 04:00:00 PM,48,-122,97,60,157
10433,FremontBridge,12/11/2013 05:00:00 PM,48,-122,195,85,280
10434,FremontBridge,12/11/2013 06:00:00 PM,48,-122,176,85,261
10435,FremontBridge,12/11/2013 07:00:00 PM,48,-122,74,38,112
10436,FremontBridge,12/11/2013 08:00:00 PM,48,-122,35,13,48
10437,FremontBridge,12/11/2013 09:00:00 PM,48,-122,23,16,39
10438,FremontBridge,12/11/2013 10:00:00 PM,48,-122,15,9,24
10439,FremontBridge,12/11/2013 11:00:00 PM,48,-122,9,8,17
10440,FremontBridge,12/12/2013 12:00:00 AM,48,-122,5,5,10
10441,FremontBridge,12/12/2013 01:00:00 AM,48,-122,3,1,4
10442,FremontBridge,12/12/2013 02:00:00 AM,48,-122,1,2,3
10443,FremontBridge,12/12/2013 03:00:00 AM,48,-122,2,0,2
10444,FremontBridge,12/12/2013 04:00:00 AM,48,-122,1,2,3
10445,FremontBridge,12/12/2013 05:00:00 AM,48,-122,3,21,24
10446,FremontBridge,12/12/2013 06:00:00 AM,48,-122,21,53,74
10447,FremontBridge,12/12/2013 07:00:00 AM,48,-122,55,109,164
10448,FremontBridge,12/12/2013 08:00:00 AM,48,-122,72,201,273
10449,FremontBridge,12/12/2013 09:00:00 AM,48,-122,80,125,205
10450,FremontBridge,12/12/2013 10:00:00 AM,48,-122,34,58,92
10451,FremontBridge,12/12/2013 11:00:00 AM,48,-122,22,29,51
10452,FremontBridge,12/12/2013 12:00:00 PM,48,-122,22,30,52
10453,FremontBridge,12/12/2013 01:00:00 PM,48,-122,35,24,59
10454,FremontBridge,12/12/2013 02:00:00 PM,48,-122,10,15,25
10455,FremontBridge,12/12/2013 03:00:00 PM,48,-122,31,32,63
10456,FremontBridge,12/12/2013 04:00:00 PM,48,-122,59,51,110
10457,FremontBridge,12/12/2013 05:00:00 PM,48,-122,188,66,254
10458,FremontBridge,12/12/2013 06:00:00 PM,48,-122,134,67,201
10459,FremontBridge,12/12/2013 07:00:00 PM,48,-122,90,46,136
10460,FremontBridge,12/12/2013 08:00:00 PM,48,-122,35,15,50
10461,FremontBridge,12/12/2013 09:00:00 PM,48,-122,20,15,35
10462,FremontBridge,12/12/2013 10:00:00 PM,48,-122,14,12,26
10463,FremontBridge,12/12/2013 11:00:00 PM,48,-122,9,9,18
10464,FremontBridge,12/13/2013 12:00:00 AM,48,-122,13,4,17
10465,FremontBridge,12/13/2013 01:00:00 AM,48,-122,6,0,6
10466,FremontBridge,12/13/2013 02:00:00 AM,48,-122,2,2,4
10467,FremontBridge,12/13/2013 03:00:00 AM,48,-122,2,1,3
10468,FremontBridge,12/13/2013 04:00:00 AM,48,-122,2,4,6
10469,FremontBridge,12/13/2013 05:00:00 AM,48,-122,6,15,21
10470,FremontBridge,12/13/2013 06:00:00 AM,48,-122,19,37,56
10471,FremontBridge,12/13/2013 07:00:00 AM,48,-122,53,97,150
10472,FremontBridge,12/13/2013 08:00:00 AM,48,-122,63,166,229
10473,FremontBridge,12/13/2013 09:00:00 AM,48,-122,54,110,164
10474,FremontBridge,12/13/2013 10:00:00 AM,48,-122,20,34,54
10475,FremontBridge,12/13/2013 11:00:00 AM,48,-122,21,25,46
10476,FremontBridge,12/13/2013 12:00:00 PM,48,-122,29,25,54
10477,FremontBridge,12/13/2013 01:00:00 PM,48,-122,18,30,48
10478,FremontBridge,12/13/2013 02:00:00 PM,48,-122,20,34,54
10479,FremontBridge,12/13/2013 03:00:00 PM,48,-122,44,38,82
10480,FremontBridge,12/13/2013 04:00:00 PM,48,-122,86,64,150
10481,FremontBridge,12/13/2013 05:00:00 PM,48,-122,168,67,235
10482,FremontBridge,12/13/2013 06:00:00 PM,48,-122,129,50,179
10483,FremontBridge,12/13/2013 07:00:00 PM,48,-122,63,25,88
10484,FremontBridge,12/13/2013 08:00:00 PM,48,-122,34,17,51
10485,FremontBridge,12/13/2013 09:00:00 PM,48,-122,16,16,32
10486,FremontBridge,12/13/2013 10:00:00 PM,48,-122,11,5,16
10487,FremontBridge,12/13/2013 11:00:00 PM,48,-122,12,12,24
10488,FremontBridge,12/14/2013 12:00:00 AM,48,-122,8,11,19
10489,FremontBridge,12/14/2013 01:00:00 AM,48,-122,6,5,11
10490,FremontBridge,12/14/2013 02:00:00 AM,48,-122,3,3,6
10491,FremontBridge,12/14/2013 03:00:00 AM,48,-122,0,1,1
10492,FremontBridge,12/14/2013 04:00:00 AM,48,-122,3,1,4
10493,FremontBridge,12/14/2013 05:00:00 AM,48,-122,0,2,2
10494,FremontBridge,12/14/2013 06:00:00 AM,48,-122,7,3,10
10495,FremontBridge,12/14/2013 07:00:00 AM,48,-122,6,11,17
10496,FremontBridge,12/14/2013 08:00:00 AM,48,-122,16,20,36
10497,FremontBridge,12/14/2013 09:00:00 AM,48,-122,29,34,63
10498,FremontBridge,12/14/2013 10:00:00 AM,48,-122,35,61,96
10499,FremontBridge,12/14/2013 11:00:00 AM,48,-122,26,33,59
10500,FremontBridge,12/14/2013 12:00:00 PM,48,-122,23,43,66
10501,FremontBridge,12/14/2013 01:00:00 PM,48,-122,35,41,76
10502,FremontBridge,12/14/2013 02:00:00 PM,48,-122,44,42,86
10503,FremontBridge,12/14/2013 03:00:00 PM,48,-122,33,56,89
10504,FremontBridge,12/14/2013 04:00:00 PM,48,-122,31,27,58
10505,FremontBridge,12/14/2013 05:00:00 PM,48,-122,24,23,47
10506,FremontBridge,12/14/2013 06:00:00 PM,48,-122,11,23,34
10507,FremontBridge,12/14/2013 07:00:00 PM,48,-122,9,11,20
10508,FremontBridge,12/14/2013 08:00:00 PM,48,-122,14,13,27
10509,FremontBridge,12/14/2013 09:00:00 PM,48,-122,16,7,23
10510,FremontBridge,12/14/2013 10:00:00 PM,48,-122,7,10,17
10511,FremontBridge,12/14/2013 11:00:00 PM,48,-122,7,10,17
10512,FremontBridge,12/15/2013 12:00:00 AM,48,-122,11,8,19
10513,FremontBridge,12/15/2013 01:00:00 AM,48,-122,6,2,8
10514,FremontBridge,12/15/2013 02:00:00 AM,48,-122,8,3,11
10515,FremontBridge,12/15/2013 03:00:00 AM,48,-122,3,1,4
10516,FremontBridge,12/15/2013 04:00:00 AM,48,-122,1,1,2
10517,FremontBridge,12/15/2013 05:00:00 AM,48,-122,0,5,5
10518,FremontBridge,12/15/2013 06:00:00 AM,48,-122,4,4,8
10519,FremontBridge,12/15/2013 07:00:00 AM,48,-122,2,5,7
10520,FremontBridge,12/15/2013 08:00:00 AM,48,-122,5,23,28
10521,FremontBridge,12/15/2013 09:00:00 AM,48,-122,21,36,57
10522,FremontBridge,12/15/2013 10:00:00 AM,48,-122,22,31,53
10523,FremontBridge,12/15/2013 11:00:00 AM,48,-122,18,35,53
10524,FremontBridge,12/15/2013 12:00:00 PM,48,-122,25,35,60
10525,FremontBridge,12/15/2013 01:00:00 PM,48,-122,32,48,80
10526,FremontBridge,12/15/2013 02:00:00 PM,48,-122,27,50,77
10527,FremontBridge,12/15/2013 03:00:00 PM,48,-122,33,56,89
10528,FremontBridge,12/15/2013 04:00:00 PM,48,-122,27,24,51
10529,FremontBridge,12/15/2013 05:00:00 PM,48,-122,12,25,37
10530,FremontBridge,12/15/2013 06:00:00 PM,48,-122,15,11,26
10531,FremontBridge,12/15/2013 07:00:00 PM,48,-122,13,11,24
10532,FremontBridge,12/15/2013 08:00:00 PM,48,-122,9,7,16
10533,FremontBridge,12/15/2013 09:00:00 PM,48,-122,7,4,11
10534,FremontBridge,12/15/2013 10:00:00 PM,48,-122,8,5,13
10535,FremontBridge,12/15/2013 11:00:00 PM,48,-122,10,6,16
10536,FremontBridge,12/16/2013 12:00:00 AM,48,-122,2,4,6
10537,FremontBridge,12/16/2013 01:00:00 AM,48,-122,0,3,3
10538,FremontBridge,12/16/2013 02:00:00 AM,48,-122,1,2,3
10539,FremontBridge,12/16/2013 03:00:00 AM,48,-122,3,4,7
10540,FremontBridge,12/16/2013 04:00:00 AM,48,-122,4,3,7
10541,FremontBridge,12/16/2013 05:00:00 AM,48,-122,8,20,28
10542,FremontBridge,12/16/2013 06:00:00 AM,48,-122,29,63,92
10543,FremontBridge,12/16/2013 07:00:00 AM,48,-122,56,154,210
10544,FremontBridge,12/16/2013 08:00:00 AM,48,-122,82,262,344
10545,FremontBridge,12/16/2013 09:00:00 AM,48,-122,91,126,217
10546,FremontBridge,12/16/2013 10:00:00 AM,48,-122,31,55,86
10547,FremontBridge,12/16/2013 11:00:00 AM,48,-122,27,31,58
10548,FremontBridge,12/16/2013 12:00:00 PM,48,-122,31,35,66
10549,FremontBridge,12/16/2013 01:00:00 PM,48,-122,30,37,67
10550,FremontBridge,12/16/2013 02:00:00 PM,48,-122,42,54,96
10551,FremontBridge,12/16/2013 03:00:00 PM,48,-122,64,68,132
10552,FremontBridge,12/16/2013 04:00:00 PM,48,-122,91,87,178
10553,FremontBridge,12/16/2013 05:00:00 PM,48,-122,241,109,350
10554,FremontBridge,12/16/2013 06:00:00 PM,48,-122,196,71,267
10555,FremontBridge,12/16/2013 07:00:00 PM,48,-122,92,42,134
10556,FremontBridge,12/16/2013 08:00:00 PM,48,-122,40,21,61
10557,FremontBridge,12/16/2013 09:00:00 PM,48,-122,26,24,50
10558,FremontBridge,12/16/2013 10:00:00 PM,48,-122,15,8,23
10559,FremontBridge,12/16/2013 11:00:00 PM,48,-122,10,5,15
10560,FremontBridge,12/17/2013 12:00:00 AM,48,-122,6,6,12
10561,FremontBridge,12/17/2013 01:00:00 AM,48,-122,3,2,5
10562,FremontBridge,12/17/2013 02:00:00 AM,48,-122,2,3,5
10563,FremontBridge,12/17/2013 03:00:00 AM,48,-122,0,2,2
10564,FremontBridge,12/17/2013 04:00:00 AM,48,-122,3,4,7
10565,FremontBridge,12/17/2013 05:00:00 AM,48,-122,3,20,23
10566,FremontBridge,12/17/2013 06:00:00 AM,48,-122,24,47,71
10567,FremontBridge,12/17/2013 07:00:00 AM,48,-122,58,149,207
10568,FremontBridge,12/17/2013 08:00:00 AM,48,-122,109,233,342
10569,FremontBridge,12/17/2013 09:00:00 AM,48,-122,80,137,217
10570,FremontBridge,12/17/2013 10:00:00 AM,48,-122,26,41,67
10571,FremontBridge,12/17/2013 11:00:00 AM,48,-122,22,17,39
10572,FremontBridge,12/17/2013 12:00:00 PM,48,-122,14,28,42
10573,FremontBridge,12/17/2013 01:00:00 PM,48,-122,19,28,47
10574,FremontBridge,12/17/2013 02:00:00 PM,48,-122,30,33,63
10575,FremontBridge,12/17/2013 03:00:00 PM,48,-122,34,41,75
10576,FremontBridge,12/17/2013 04:00:00 PM,48,-122,100,57,157
10577,FremontBridge,12/17/2013 05:00:00 PM,48,-122,215,99,314
10578,FremontBridge,12/17/2013 06:00:00 PM,48,-122,193,89,282
10579,FremontBridge,12/17/2013 07:00:00 PM,48,-122,88,46,134
10580,FremontBridge,12/17/2013 08:00:00 PM,48,-122,19,18,37
10581,FremontBridge,12/17/2013 09:00:00 PM,48,-122,21,20,41
10582,FremontBridge,12/17/2013 10:00:00 PM,48,-122,9,13,22
10583,FremontBridge,12/17/2013 11:00:00 PM,48,-122,16,5,21
10584,FremontBridge,12/18/2013 12:00:00 AM,48,-122,1,4,5
10585,FremontBridge,12/18/2013 01:00:00 AM,48,-122,1,1,2
10586,FremontBridge,12/18/2013 02:00:00 AM,48,-122,2,4,6
10587,FremontBridge,12/18/2013 03:00:00 AM,48,-122,0,1,1
10588,FremontBridge,12/18/2013 04:00:00 AM,48,-122,0,5,5
10589,FremontBridge,12/18/2013 05:00:00 AM,48,-122,6,18,24
10590,FremontBridge,12/18/2013 06:00:00 AM,48,-122,22,59,81
10591,FremontBridge,12/18/2013 07:00:00 AM,48,-122,50,128,178
10592,FremontBridge,12/18/2013 08:00:00 AM,48,-122,94,220,314
10593,FremontBridge,12/18/2013 09:00:00 AM,48,-122,67,126,193
10594,FremontBridge,12/18/2013 10:00:00 AM,48,-122,34,53,87
10595,FremontBridge,12/18/2013 11:00:00 AM,48,-122,27,16,43
10596,FremontBridge,12/18/2013 12:00:00 PM,48,-122,18,31,49
10597,FremontBridge,12/18/2013 01:00:00 PM,48,-122,28,32,60
10598,FremontBridge,12/18/2013 02:00:00 PM,48,-122,26,36,62
10599,FremontBridge,12/18/2013 03:00:00 PM,48,-122,44,41,85
10600,FremontBridge,12/18/2013 04:00:00 PM,48,-122,94,56,150
10601,FremontBridge,12/18/2013 05:00:00 PM,48,-122,210,96,306
10602,FremontBridge,12/18/2013 06:00:00 PM,48,-122,197,71,268
10603,FremontBridge,12/18/2013 07:00:00 PM,48,-122,77,30,107
10604,FremontBridge,12/18/2013 08:00:00 PM,48,-122,55,15,70
10605,FremontBridge,12/18/2013 09:00:00 PM,48,-122,20,12,32
10606,FremontBridge,12/18/2013 10:00:00 PM,48,-122,14,13,27
10607,FremontBridge,12/18/2013 11:00:00 PM,48,-122,5,11,16
10608,FremontBridge,12/19/2013 12:00:00 AM,48,-122,2,3,5
10609,FremontBridge,12/19/2013 01:00:00 AM,48,-122,5,1,6
10610,FremontBridge,12/19/2013 02:00:00 AM,48,-122,1,2,3
10611,FremontBridge,12/19/2013 03:00:00 AM,48,-122,1,1,2
10612,FremontBridge,12/19/2013 04:00:00 AM,48,-122,0,1,1
10613,FremontBridge,12/19/2013 05:00:00 AM,48,-122,4,18,22
10614,FremontBridge,12/19/2013 06:00:00 AM,48,-122,19,54,73
10615,FremontBridge,12/19/2013 07:00:00 AM,48,-122,48,121,169
10616,FremontBridge,12/19/2013 08:00:00 AM,48,-122,88,196,284
10617,FremontBridge,12/19/2013 09:00:00 AM,48,-122,61,132,193
10618,FremontBridge,12/19/2013 10:00:00 AM,48,-122,35,55,90
10619,FremontBridge,12/19/2013 11:00:00 AM,48,-122,21,27,48
10620,FremontBridge,12/19/2013 12:00:00 PM,48,-122,16,30,46
10621,FremontBridge,12/19/2013 01:00:00 PM,48,-122,32,32,64
10622,FremontBridge,12/19/2013 02:00:00 PM,48,-122,25,36,61
10623,FremontBridge,12/19/2013 03:00:00 PM,48,-122,43,51,94
10624,FremontBridge,12/19/2013 04:00:00 PM,48,-122,77,54,131
10625,FremontBridge,12/19/2013 05:00:00 PM,48,-122,207,86,293
10626,FremontBridge,12/19/2013 06:00:00 PM,48,-122,179,74,253
10627,FremontBridge,12/19/2013 07:00:00 PM,48,-122,77,31,108
10628,FremontBridge,12/19/2013 08:00:00 PM,48,-122,28,21,49
10629,FremontBridge,12/19/2013 09:00:00 PM,48,-122,24,20,44
10630,FremontBridge,12/19/2013 10:00:00 PM,48,-122,9,7,16
10631,FremontBridge,12/19/2013 11:00:00 PM,48,-122,10,10,20
10632,FremontBridge,12/20/2013 12:00:00 AM,48,-122,7,5,12
10633,FremontBridge,12/20/2013 01:00:00 AM,48,-122,7,1,8
10634,FremontBridge,12/20/2013 02:00:00 AM,48,-122,2,2,4
10635,FremontBridge,12/20/2013 03:00:00 AM,48,-122,1,0,1
10636,FremontBridge,12/20/2013 04:00:00 AM,48,-122,0,2,2
10637,FremontBridge,12/20/2013 05:00:00 AM,48,-122,2,11,13
10638,FremontBridge,12/20/2013 06:00:00 AM,48,-122,6,12,18
10639,FremontBridge,12/20/2013 07:00:00 AM,48,-122,16,20,36
10640,FremontBridge,12/20/2013 08:00:00 AM,48,-122,23,44,67
10641,FremontBridge,12/20/2013 09:00:00 AM,48,-122,26,38,64
10642,FremontBridge,12/20/2013 10:00:00 AM,48,-122,12,31,43
10643,FremontBridge,12/20/2013 11:00:00 AM,48,-122,7,20,27
10644,FremontBridge,12/20/2013 12:00:00 PM,48,-122,13,11,24
10645,FremontBridge,12/20/2013 01:00:00 PM,48,-122,10,17,27
10646,FremontBridge,12/20/2013 02:00:00 PM,48,-122,15,10,25
10647,FremontBridge,12/20/2013 03:00:00 PM,48,-122,20,23,43
10648,FremontBridge,12/20/2013 04:00:00 PM,48,-122,46,27,73
10649,FremontBridge,12/20/2013 05:00:00 PM,48,-122,54,30,84
10650,FremontBridge,12/20/2013 06:00:00 PM,48,-122,41,21,62
10651,FremontBridge,12/20/2013 07:00:00 PM,48,-122,23,12,35
10652,FremontBridge,12/20/2013 08:00:00 PM,48,-122,19,14,33
10653,FremontBridge,12/20/2013 09:00:00 PM,48,-122,10,5,15
10654,FremontBridge,12/20/2013 10:00:00 PM,48,-122,4,11,15
10655,FremontBridge,12/20/2013 11:00:00 PM,48,-122,6,2,8
10656,FremontBridge,12/21/2013 12:00:00 AM,48,-122,2,3,5
10657,FremontBridge,12/21/2013 01:00:00 AM,48,-122,2,0,2
10658,FremontBridge,12/21/2013 02:00:00 AM,48,-122,2,4,6
10659,FremontBridge,12/21/2013 03:00:00 AM,48,-122,3,0,3
10660,FremontBridge,12/21/2013 04:00:00 AM,48,-122,3,1,4
10661,FremontBridge,12/21/2013 05:00:00 AM,48,-122,0,3,3
10662,FremontBridge,12/21/2013 06:00:00 AM,48,-122,6,5,11
10663,FremontBridge,12/21/2013 07:00:00 AM,48,-122,6,13,19
10664,FremontBridge,12/21/2013 08:00:00 AM,48,-122,10,15,25
10665,FremontBridge,12/21/2013 09:00:00 AM,48,-122,16,28,44
10666,FremontBridge,12/21/2013 10:00:00 AM,48,-122,11,26,37
10667,FremontBridge,12/21/2013 11:00:00 AM,48,-122,10,22,32
10668,FremontBridge,12/21/2013 12:00:00 PM,48,-122,13,17,30
10669,FremontBridge,12/21/2013 01:00:00 PM,48,-122,18,30,48
10670,FremontBridge,12/21/2013 02:00:00 PM,48,-122,13,31,44
10671,FremontBridge,12/21/2013 03:00:00 PM,48,-122,17,31,48
10672,FremontBridge,12/21/2013 04:00:00 PM,48,-122,17,21,38
10673,FremontBridge,12/21/2013 05:00:00 PM,48,-122,11,17,28
10674,FremontBridge,12/21/2013 06:00:00 PM,48,-122,12,7,19
10675,FremontBridge,12/21/2013 07:00:00 PM,48,-122,13,12,25
10676,FremontBridge,12/21/2013 08:00:00 PM,48,-122,12,6,18
10677,FremontBridge,12/21/2013 09:00:00 PM,48,-122,5,6,11
10678,FremontBridge,12/21/2013 10:00:00 PM,48,-122,5,4,9
10679,FremontBridge,12/21/2013 11:00:00 PM,48,-122,3,8,11
10680,FremontBridge,12/22/2013 12:00:00 AM,48,-122,4,1,5
10681,FremontBridge,12/22/2013 01:00:00 AM,48,-122,5,5,10
10682,FremontBridge,12/22/2013 02:00:00 AM,48,-122,3,3,6
10683,FremontBridge,12/22/2013 03:00:00 AM,48,-122,1,1,2
10684,FremontBridge,12/22/2013 04:00:00 AM,48,-122,2,1,3
10685,FremontBridge,12/22/2013 05:00:00 AM,48,-122,1,5,6
10686,FremontBridge,12/22/2013 06:00:00 AM,48,-122,5,1,6
10687,FremontBridge,12/22/2013 07:00:00 AM,48,-122,2,7,9
10688,FremontBridge,12/22/2013 08:00:00 AM,48,-122,5,18,23
10689,FremontBridge,12/22/2013 09:00:00 AM,48,-122,13,12,25
10690,FremontBridge,12/22/2013 10:00:00 AM,48,-122,10,19,29
10691,FremontBridge,12/22/2013 11:00:00 AM,48,-122,18,18,36
10692,FremontBridge,12/22/2013 12:00:00 PM,48,-122,15,23,38
10693,FremontBridge,12/22/2013 01:00:00 PM,48,-122,16,16,32
10694,FremontBridge,12/22/2013 02:00:00 PM,48,-122,12,21,33
10695,FremontBridge,12/22/2013 03:00:00 PM,48,-122,15,13,28
10696,FremontBridge,12/22/2013 04:00:00 PM,48,-122,9,7,16
10697,FremontBridge,12/22/2013 05:00:00 PM,48,-122,12,10,22
10698,FremontBridge,12/22/2013 06:00:00 PM,48,-122,9,5,14
10699,FremontBridge,12/22/2013 07:00:00 PM,48,-122,4,6,10
10700,FremontBridge,12/22/2013 08:00:00 PM,48,-122,7,3,10
10701,FremontBridge,12/22/2013 09:00:00 PM,48,-122,13,4,17
10702,FremontBridge,12/22/2013 10:00:00 PM,48,-122,4,4,8
10703,FremontBridge,12/22/2013 11:00:00 PM,48,-122,7,5,12
10704,FremontBridge,12/23/2013 12:00:00 AM,48,-122,2,10,12
10705,FremontBridge,12/23/2013 01:00:00 AM,48,-122,0,3,3
10706,FremontBridge,12/23/2013 02:00:00 AM,48,-122,1,0,1
10707,FremontBridge,12/23/2013 03:00:00 AM,48,-122,0,1,1
10708,FremontBridge,12/23/2013 04:00:00 AM,48,-122,2,2,4
10709,FremontBridge,12/23/2013 05:00:00 AM,48,-122,5,12,17
10710,FremontBridge,12/23/2013 06:00:00 AM,48,-122,22,31,53
10711,FremontBridge,12/23/2013 07:00:00 AM,48,-122,23,75,98
10712,FremontBridge,12/23/2013 08:00:00 AM,48,-122,47,103,150
10713,FremontBridge,12/23/2013 09:00:00 AM,48,-122,29,69,98
10714,FremontBridge,12/23/2013 10:00:00 AM,48,-122,28,36,64
10715,FremontBridge,12/23/2013 11:00:00 AM,48,-122,28,24,52
10716,FremontBridge,12/23/2013 12:00:00 PM,48,-122,25,23,48
10717,FremontBridge,12/23/2013 01:00:00 PM,48,-122,24,29,53
10718,FremontBridge,12/23/2013 02:00:00 PM,48,-122,33,31,64
10719,FremontBridge,12/23/2013 03:00:00 PM,48,-122,52,42,94
10720,FremontBridge,12/23/2013 04:00:00 PM,48,-122,88,60,148
10721,FremontBridge,12/23/2013 05:00:00 PM,48,-122,142,55,197
10722,FremontBridge,12/23/2013 06:00:00 PM,48,-122,66,29,95
10723,FremontBridge,12/23/2013 07:00:00 PM,48,-122,35,28,63
10724,FremontBridge,12/23/2013 08:00:00 PM,48,-122,26,18,44
10725,FremontBridge,12/23/2013 09:00:00 PM,48,-122,12,12,24
10726,FremontBridge,12/23/2013 10:00:00 PM,48,-122,11,12,23
10727,FremontBridge,12/23/2013 11:00:00 PM,48,-122,7,4,11
10728,FremontBridge,12/24/2013 12:00:00 AM,48,-122,6,2,8
10729,FremontBridge,12/24/2013 01:00:00 AM,48,-122,4,1,5
10730,FremontBridge,12/24/2013 02:00:00 AM,48,-122,2,0,2
10731,FremontBridge,12/24/2013 03:00:00 AM,48,-122,0,1,1
10732,FremontBridge,12/24/2013 04:00:00 AM,48,-122,3,3,6
10733,FremontBridge,12/24/2013 05:00:00 AM,48,-122,3,9,12
10734,FremontBridge,12/24/2013 06:00:00 AM,48,-122,10,25,35
10735,FremontBridge,12/24/2013 07:00:00 AM,48,-122,21,61,82
10736,FremontBridge,12/24/2013 08:00:00 AM,48,-122,33,62,95
10737,FremontBridge,12/24/2013 09:00:00 AM,48,-122,34,46,80
10738,FremontBridge,12/24/2013 10:00:00 AM,48,-122,19,41,60
10739,FremontBridge,12/24/2013 11:00:00 AM,48,-122,20,32,52
10740,FremontBridge,12/24/2013 12:00:00 PM,48,-122,39,50,89
10741,FremontBridge,12/24/2013 01:00:00 PM,48,-122,42,45,87
10742,FremontBridge,12/24/2013 02:00:00 PM,48,-122,57,64,121
10743,FremontBridge,12/24/2013 03:00:00 PM,48,-122,73,55,128
10744,FremontBridge,12/24/2013 04:00:00 PM,48,-122,42,49,91
10745,FremontBridge,12/24/2013 05:00:00 PM,48,-122,31,21,52
10746,FremontBridge,12/24/2013 06:00:00 PM,48,-122,16,9,25
10747,FremontBridge,12/24/2013 07:00:00 PM,48,-122,10,9,19
10748,FremontBridge,12/24/2013 08:00:00 PM,48,-122,7,5,12
10749,FremontBridge,12/24/2013 09:00:00 PM,48,-122,1,3,4
10750,FremontBridge,12/24/2013 10:00:00 PM,48,-122,5,9,14
10751,FremontBridge,12/24/2013 11:00:00 PM,48,-122,1,1,2
10752,FremontBridge,12/25/2013 12:00:00 AM,48,-122,2,5,7
10753,FremontBridge,12/25/2013 01:00:00 AM,48,-122,1,3,4
10754,FremontBridge,12/25/2013 02:00:00 AM,48,-122,0,0,0
10755,FremontBridge,12/25/2013 03:00:00 AM,48,-122,0,0,0
10756,FremontBridge,12/25/2013 04:00:00 AM,48,-122,1,0,1
10757,FremontBridge,12/25/2013 05:00:00 AM,48,-122,1,2,3
10758,FremontBridge,12/25/2013 06:00:00 AM,48,-122,1,2,3
10759,FremontBridge,12/25/2013 07:00:00 AM,48,-122,2,0,2
10760,FremontBridge,12/25/2013 08:00:00 AM,48,-122,4,2,6
10761,FremontBridge,12/25/2013 09:00:00 AM,48,-122,4,7,11
10762,FremontBridge,12/25/2013 10:00:00 AM,48,-122,8,5,13
10763,FremontBridge,12/25/2013 11:00:00 AM,48,-122,10,21,31
10764,FremontBridge,12/25/2013 12:00:00 PM,48,-122,4,15,19
10765,FremontBridge,12/25/2013 01:00:00 PM,48,-122,21,27,48
10766,FremontBridge,12/25/2013 02:00:00 PM,48,-122,29,47,76
10767,FremontBridge,12/25/2013 03:00:00 PM,48,-122,18,34,52
10768,FremontBridge,12/25/2013 04:00:00 PM,48,-122,17,16,33
10769,FremontBridge,12/25/2013 05:00:00 PM,48,-122,5,8,13
10770,FremontBridge,12/25/2013 06:00:00 PM,48,-122,2,6,8
10771,FremontBridge,12/25/2013 07:00:00 PM,48,-122,8,9,17
10772,FremontBridge,12/25/2013 08:00:00 PM,48,-122,5,3,8
10773,FremontBridge,12/25/2013 09:00:00 PM,48,-122,3,4,7
10774,FremontBridge,12/25/2013 10:00:00 PM,48,-122,2,2,4
10775,FremontBridge,12/25/2013 11:00:00 PM,48,-122,2,3,5
10776,FremontBridge,12/26/2013 12:00:00 AM,48,-122,1,1,2
10777,FremontBridge,12/26/2013 01:00:00 AM,48,-122,0,0,0
10778,FremontBridge,12/26/2013 02:00:00 AM,48,-122,0,0,0
10779,FremontBridge,12/26/2013 03:00:00 AM,48,-122,1,0,1
10780,FremontBridge,12/26/2013 04:00:00 AM,48,-122,2,0,2
10781,FremontBridge,12/26/2013 05:00:00 AM,48,-122,2,12,14
10782,FremontBridge,12/26/2013 06:00:00 AM,48,-122,11,20,31
10783,FremontBridge,12/26/2013 07:00:00 AM,48,-122,31,46,77
10784,FremontBridge,12/26/2013 08:00:00 AM,48,-122,40,78,118
10785,FremontBridge,12/26/2013 09:00:00 AM,48,-122,36,47,83
10786,FremontBridge,12/26/2013 10:00:00 AM,48,-122,19,44,63
10787,FremontBridge,12/26/2013 11:00:00 AM,48,-122,17,29,46
10788,FremontBridge,12/26/2013 12:00:00 PM,48,-122,30,32,62
10789,FremontBridge,12/26/2013 01:00:00 PM,48,-122,22,39,61
10790,FremontBridge,12/26/2013 02:00:00 PM,48,-122,42,36,78
10791,FremontBridge,12/26/2013 03:00:00 PM,48,-122,44,43,87
10792,FremontBridge,12/26/2013 04:00:00 PM,48,-122,60,51,111
10793,FremontBridge,12/26/2013 05:00:00 PM,48,-122,88,59,147
10794,FremontBridge,12/26/2013 06:00:00 PM,48,-122,58,29,87
10795,FremontBridge,12/26/2013 07:00:00 PM,48,-122,33,18,51
10796,FremontBridge,12/26/2013 08:00:00 PM,48,-122,18,9,27
10797,FremontBridge,12/26/2013 09:00:00 PM,48,-122,10,5,15
10798,FremontBridge,12/26/2013 10:00:00 PM,48,-122,14,6,20
10799,FremontBridge,12/26/2013 11:00:00 PM,48,-122,4,3,7
10800,FremontBridge,12/27/2013 12:00:00 AM,48,-122,3,2,5
10801,FremontBridge,12/27/2013 01:00:00 AM,48,-122,3,4,7
10802,FremontBridge,12/27/2013 02:00:00 AM,48,-122,1,2,3
10803,FremontBridge,12/27/2013 03:00:00 AM,48,-122,1,1,2
10804,FremontBridge,12/27/2013 04:00:00 AM,48,-122,2,1,3
10805,FremontBridge,12/27/2013 05:00:00 AM,48,-122,2,8,10
10806,FremontBridge,12/27/2013 06:00:00 AM,48,-122,16,28,44
10807,FremontBridge,12/27/2013 07:00:00 AM,48,-122,19,56,75
10808,FremontBridge,12/27/2013 08:00:00 AM,48,-122,27,82,109
10809,FremontBridge,12/27/2013 09:00:00 AM,48,-122,36,52,88
10810,FremontBridge,12/27/2013 10:00:00 AM,48,-122,35,46,81
10811,FremontBridge,12/27/2013 11:00:00 AM,48,-122,13,21,34
10812,FremontBridge,12/27/2013 12:00:00 PM,48,-122,18,23,41
10813,FremontBridge,12/27/2013 01:00:00 PM,48,-122,23,26,49
10814,FremontBridge,12/27/2013 02:00:00 PM,48,-122,22,25,47
10815,FremontBridge,12/27/2013 03:00:00 PM,48,-122,33,30,63
10816,FremontBridge,12/27/2013 04:00:00 PM,48,-122,57,44,101
10817,FremontBridge,12/27/2013 05:00:00 PM,48,-122,87,40,127
10818,FremontBridge,12/27/2013 06:00:00 PM,48,-122,48,25,73
10819,FremontBridge,12/27/2013 07:00:00 PM,48,-122,24,14,38
10820,FremontBridge,12/27/2013 08:00:00 PM,48,-122,16,12,28
10821,FremontBridge,12/27/2013 09:00:00 PM,48,-122,10,4,14
10822,FremontBridge,12/27/2013 10:00:00 PM,48,-122,8,5,13
10823,FremontBridge,12/27/2013 11:00:00 PM,48,-122,6,5,11
10824,FremontBridge,12/28/2013 12:00:00 AM,48,-122,1,5,6
10825,FremontBridge,12/28/2013 01:00:00 AM,48,-122,3,1,4
10826,FremontBridge,12/28/2013 02:00:00 AM,48,-122,1,2,3
10827,FremontBridge,12/28/2013 03:00:00 AM,48,-122,2,2,4
10828,FremontBridge,12/28/2013 04:00:00 AM,48,-122,0,1,1
10829,FremontBridge,12/28/2013 05:00:00 AM,48,-122,2,1,3
10830,FremontBridge,12/28/2013 06:00:00 AM,48,-122,8,7,15
10831,FremontBridge,12/28/2013 07:00:00 AM,48,-122,4,7,11
10832,FremontBridge,12/28/2013 08:00:00 AM,48,-122,9,15,24
10833,FremontBridge,12/28/2013 09:00:00 AM,48,-122,22,21,43
10834,FremontBridge,12/28/2013 10:00:00 AM,48,-122,19,30,49
10835,FremontBridge,12/28/2013 11:00:00 AM,48,-122,33,42,75
10836,FremontBridge,12/28/2013 12:00:00 PM,48,-122,44,29,73
10837,FremontBridge,12/28/2013 01:00:00 PM,48,-122,37,49,86
10838,FremontBridge,12/28/2013 02:00:00 PM,48,-122,43,47,90
10839,FremontBridge,12/28/2013 03:00:00 PM,48,-122,32,60,92
10840,FremontBridge,12/28/2013 04:00:00 PM,48,-122,45,74,119
10841,FremontBridge,12/28/2013 05:00:00 PM,48,-122,20,26,46
10842,FremontBridge,12/28/2013 06:00:00 PM,48,-122,14,17,31
10843,FremontBridge,12/28/2013 07:00:00 PM,48,-122,12,16,28
10844,FremontBridge,12/28/2013 08:00:00 PM,48,-122,17,11,28
10845,FremontBridge,12/28/2013 09:00:00 PM,48,-122,10,6,16
10846,FremontBridge,12/28/2013 10:00:00 PM,48,-122,8,3,11
10847,FremontBridge,12/28/2013 11:00:00 PM,48,-122,6,11,17
10848,FremontBridge,12/29/2013 12:00:00 AM,48,-122,3,6,9
10849,FremontBridge,12/29/2013 01:00:00 AM,48,-122,1,3,4
10850,FremontBridge,12/29/2013 02:00:00 AM,48,-122,4,3,7
10851,FremontBridge,12/29/2013 03:00:00 AM,48,-122,2,5,7
10852,FremontBridge,12/29/2013 04:00:00 AM,48,-122,1,2,3
10853,FremontBridge,12/29/2013 05:00:00 AM,48,-122,1,2,3
10854,FremontBridge,12/29/2013 06:00:00 AM,48,-122,3,5,8
10855,FremontBridge,12/29/2013 07:00:00 AM,48,-122,3,7,10
10856,FremontBridge,12/29/2013 08:00:00 AM,48,-122,11,10,21
10857,FremontBridge,12/29/2013 09:00:00 AM,48,-122,14,22,36
10858,FremontBridge,12/29/2013 10:00:00 AM,48,-122,16,32,48
10859,FremontBridge,12/29/2013 11:00:00 AM,48,-122,26,42,68
10860,FremontBridge,12/29/2013 12:00:00 PM,48,-122,32,35,67
10861,FremontBridge,12/29/2013 01:00:00 PM,48,-122,30,36,66
10862,FremontBridge,12/29/2013 02:00:00 PM,48,-122,30,43,73
10863,FremontBridge,12/29/2013 03:00:00 PM,48,-122,32,25,57
10864,FremontBridge,12/29/2013 04:00:00 PM,48,-122,15,29,44
10865,FremontBridge,12/29/2013 05:00:00 PM,48,-122,27,24,51
10866,FremontBridge,12/29/2013 06:00:00 PM,48,-122,15,20,35
10867,FremontBridge,12/29/2013 07:00:00 PM,48,-122,5,11,16
10868,FremontBridge,12/29/2013 08:00:00 PM,48,-122,8,8,16
10869,FremontBridge,12/29/2013 09:00:00 PM,48,-122,4,2,6
10870,FremontBridge,12/29/2013 10:00:00 PM,48,-122,7,7,14
10871,FremontBridge,12/29/2013 11:00:00 PM,48,-122,6,9,15
10872,FremontBridge,12/30/2013 12:00:00 AM,48,-122,0,4,4
10873,FremontBridge,12/30/2013 01:00:00 AM,48,-122,4,4,8
10874,FremontBridge,12/30/2013 02:00:00 AM,48,-122,2,0,2
10875,FremontBridge,12/30/2013 03:00:00 AM,48,-122,1,1,2
10876,FremontBridge,12/30/2013 04:00:00 AM,48,-122,3,1,4
10877,FremontBridge,12/30/2013 05:00:00 AM,48,-122,2,17,19
10878,FremontBridge,12/30/2013 06:00:00 AM,48,-122,23,49,72
10879,FremontBridge,12/30/2013 07:00:00 AM,48,-122,43,94,137
10880,FremontBridge,12/30/2013 08:00:00 AM,48,-122,66,142,208
10881,FremontBridge,12/30/2013 09:00:00 AM,48,-122,52,90,142
10882,FremontBridge,12/30/2013 10:00:00 AM,48,-122,18,44,62
10883,FremontBridge,12/30/2013 11:00:00 AM,48,-122,23,31,54
10884,FremontBridge,12/30/2013 12:00:00 PM,48,-122,16,39,55
10885,FremontBridge,12/30/2013 01:00:00 PM,48,-122,48,26,74
10886,FremontBridge,12/30/2013 02:00:00 PM,48,-122,26,22,48
10887,FremontBridge,12/30/2013 03:00:00 PM,48,-122,55,44,99
10888,FremontBridge,12/30/2013 04:00:00 PM,48,-122,91,59,150
10889,FremontBridge,12/30/2013 05:00:00 PM,48,-122,190,68,258
10890,FremontBridge,12/30/2013 06:00:00 PM,48,-122,102,44,146
10891,FremontBridge,12/30/2013 07:00:00 PM,48,-122,39,25,64
10892,FremontBridge,12/30/2013 08:00:00 PM,48,-122,17,26,43
10893,FremontBridge,12/30/2013 09:00:00 PM,48,-122,12,12,24
10894,FremontBridge,12/30/2013 10:00:00 PM,48,-122,9,14,23
10895,FremontBridge,12/30/2013 11:00:00 PM,48,-122,15,9,24
10896,FremontBridge,12/31/2013 12:00:00 AM,48,-122,4,8,12
10897,FremontBridge,12/31/2013 01:00:00 AM,48,-122,4,2,6
10898,FremontBridge,12/31/2013 02:00:00 AM,48,-122,0,1,1
10899,FremontBridge,12/31/2013 03:00:00 AM,48,-122,0,1,1
10900,FremontBridge,12/31/2013 04:00:00 AM,48,-122,3,1,4
10901,FremontBridge,12/31/2013 05:00:00 AM,48,-122,3,12,15
10902,FremontBridge,12/31/2013 06:00:00 AM,48,-122,27,33,60
10903,FremontBridge,12/31/2013 07:00:00 AM,48,-122,39,68,107
10904,FremontBridge,12/31/2013 08:00:00 AM,48,-122,49,111,160
10905,FremontBridge,12/31/2013 09:00:00 AM,48,-122,50,77,127
10906,FremontBridge,12/31/2013 10:00:00 AM,48,-122,29,28,57
10907,FremontBridge,12/31/2013 11:00:00 AM,48,-122,22,25,47
10908,FremontBridge,12/31/2013 12:00:00 PM,48,-122,19,30,49
10909,FremontBridge,12/31/2013 01:00:00 PM,48,-122,26,28,54
10910,FremontBridge,12/31/2013 02:00:00 PM,48,-122,45,27,72
10911,FremontBridge,12/31/2013 03:00:00 PM,48,-122,64,60,124
10912,FremontBridge,12/31/2013 04:00:00 PM,48,-122,114,52,166
10913,FremontBridge,12/31/2013 05:00:00 PM,48,-122,117,55,172
10914,FremontBridge,12/31/2013 06:00:00 PM,48,-122,39,25,64
10915,FremontBridge,12/31/2013 07:00:00 PM,48,-122,17,21,38
10916,FremontBridge,12/31/2013 08:00:00 PM,48,-122,23,13,36
10917,FremontBridge,12/31/2013 09:00:00 PM,48,-122,6,5,11
10918,FremontBridge,12/31/2013 10:00:00 PM,48,-122,4,10,14
10919,FremontBridge,12/31/2013 11:00:00 PM,48,-122,5,17,22
10920,FremontBridge,01/01/2014 12:00:00 AM,48,-122,18,5,23
10921,FremontBridge,01/01/2014 01:00:00 AM,48,-122,19,8,27
10922,FremontBridge,01/01/2014 02:00:00 AM,48,-122,12,7,19
10923,FremontBridge,01/01/2014 03:00:00 AM,48,-122,8,5,13
10924,FremontBridge,01/01/2014 04:00:00 AM,48,-122,3,3,6
10925,FremontBridge,01/01/2014 05:00:00 AM,48,-122,2,4,6
10926,FremontBridge,01/01/2014 06:00:00 AM,48,-122,1,1,2
10927,FremontBridge,01/01/2014 07:00:00 AM,48,-122,3,6,9
10928,FremontBridge,01/01/2014 08:00:00 AM,48,-122,8,14,22
10929,FremontBridge,01/01/2014 09:00:00 AM,48,-122,13,14,27
10930,FremontBridge,01/01/2014 10:00:00 AM,48,-122,15,32,47
10931,FremontBridge,01/01/2014 11:00:00 AM,48,-122,37,37,74
10932,FremontBridge,01/01/2014 12:00:00 PM,48,-122,41,49,90
10933,FremontBridge,01/01/2014 01:00:00 PM,48,-122,32,71,103
10934,FremontBridge,01/01/2014 02:00:00 PM,48,-122,58,82,140
10935,FremontBridge,01/01/2014 03:00:00 PM,48,-122,35,42,77
10936,FremontBridge,01/01/2014 04:00:00 PM,48,-122,46,59,105
10937,FremontBridge,01/01/2014 05:00:00 PM,48,-122,22,15,37
10938,FremontBridge,01/01/2014 06:00:00 PM,48,-122,10,10,20
10939,FremontBridge,01/01/2014 07:00:00 PM,48,-122,9,11,20
10940,FremontBridge,01/01/2014 08:00:00 PM,48,-122,7,7,14
10941,FremontBridge,01/01/2014 09:00:00 PM,48,-122,6,3,9
10942,FremontBridge,01/01/2014 10:00:00 PM,48,-122,6,9,15
10943,FremontBridge,01/01/2014 11:00:00 PM,48,-122,5,4,9
10944,FremontBridge,01/02/2014 12:00:00 AM,48,-122,1,2,3
10945,FremontBridge,01/02/2014 01:00:00 AM,48,-122,1,2,3
10946,FremontBridge,01/02/2014 02:00:00 AM,48,-122,0,0,0
10947,FremontBridge,01/02/2014 03:00:00 AM,48,-122,2,2,4
10948,FremontBridge,01/02/2014 04:00:00 AM,48,-122,1,1,2
10949,FremontBridge,01/02/2014 05:00:00 AM,48,-122,3,17,20
10950,FremontBridge,01/02/2014 06:00:00 AM,48,-122,18,56,74
10951,FremontBridge,01/02/2014 07:00:00 AM,48,-122,39,126,165
10952,FremontBridge,01/02/2014 08:00:00 AM,48,-122,82,166,248
10953,FremontBridge,01/02/2014 09:00:00 AM,48,-122,64,118,182
10954,FremontBridge,01/02/2014 10:00:00 AM,48,-122,27,48,75
10955,FremontBridge,01/02/2014 11:00:00 AM,48,-122,31,29,60
10956,FremontBridge,01/02/2014 12:00:00 PM,48,-122,33,41,74
10957,FremontBridge,01/02/2014 01:00:00 PM,48,-122,22,29,51
10958,FremontBridge,01/02/2014 02:00:00 PM,48,-122,32,21,53
10959,FremontBridge,01/02/2014 03:00:00 PM,48,-122,37,30,67
10960,FremontBridge,01/02/2014 04:00:00 PM,48,-122,89,56,145
10961,FremontBridge,01/02/2014 05:00:00 PM,48,-122,211,70,281
10962,FremontBridge,01/02/2014 06:00:00 PM,48,-122,147,58,205
10963,FremontBridge,01/02/2014 07:00:00 PM,48,-122,44,32,76
10964,FremontBridge,01/02/2014 08:00:00 PM,48,-122,32,12,44
10965,FremontBridge,01/02/2014 09:00:00 PM,48,-122,5,7,12
10966,FremontBridge,01/02/2014 10:00:00 PM,48,-122,6,2,8
10967,FremontBridge,01/02/2014 11:00:00 PM,48,-122,7,6,13
10968,FremontBridge,01/03/2014 12:00:00 AM,48,-122,6,4,10
10969,FremontBridge,01/03/2014 01:00:00 AM,48,-122,3,2,5
10970,FremontBridge,01/03/2014 02:00:00 AM,48,-122,0,1,1
10971,FremontBridge,01/03/2014 03:00:00 AM,48,-122,1,0,1
10972,FremontBridge,01/03/2014 04:00:00 AM,48,-122,2,4,6
10973,FremontBridge,01/03/2014 05:00:00 AM,48,-122,4,11,15
10974,FremontBridge,01/03/2014 06:00:00 AM,48,-122,18,46,64
10975,FremontBridge,01/03/2014 07:00:00 AM,48,-122,43,126,169
10976,FremontBridge,01/03/2014 08:00:00 AM,48,-122,57,174,231
10977,FremontBridge,01/03/2014 09:00:00 AM,48,-122,66,126,192
10978,FremontBridge,01/03/2014 10:00:00 AM,48,-122,36,49,85
10979,FremontBridge,01/03/2014 11:00:00 AM,48,-122,32,33,65
10980,FremontBridge,01/03/2014 12:00:00 PM,48,-122,27,45,72
10981,FremontBridge,01/03/2014 01:00:00 PM,48,-122,29,57,86
10982,FremontBridge,01/03/2014 02:00:00 PM,48,-122,36,59,95
10983,FremontBridge,01/03/2014 03:00:00 PM,48,-122,46,63,109
10984,FremontBridge,01/03/2014 04:00:00 PM,48,-122,129,64,193
10985,FremontBridge,01/03/2014 05:00:00 PM,48,-122,202,80,282
10986,FremontBridge,01/03/2014 06:00:00 PM,48,-122,117,58,175
10987,FremontBridge,01/03/2014 07:00:00 PM,48,-122,44,33,77
10988,FremontBridge,01/03/2014 08:00:00 PM,48,-122,20,10,30
10989,FremontBridge,01/03/2014 09:00:00 PM,48,-122,18,14,32
10990,FremontBridge,01/03/2014 10:00:00 PM,48,-122,6,14,20
10991,FremontBridge,01/03/2014 11:00:00 PM,48,-122,6,6,12
10992,FremontBridge,01/04/2014 12:00:00 AM,48,-122,5,4,9
10993,FremontBridge,01/04/2014 01:00:00 AM,48,-122,3,5,8
10994,FremontBridge,01/04/2014 02:00:00 AM,48,-122,2,0,2
10995,FremontBridge,01/04/2014 03:00:00 AM,48,-122,0,0,0
10996,FremontBridge,01/04/2014 04:00:00 AM,48,-122,4,1,5
10997,FremontBridge,01/04/2014 05:00:00 AM,48,-122,0,2,2
10998,FremontBridge,01/04/2014 06:00:00 AM,48,-122,2,9,11
10999,FremontBridge,01/04/2014 07:00:00 AM,48,-122,3,5,8
11000,FremontBridge,01/04/2014 08:00:00 AM,48,-122,22,19,41
11001,FremontBridge,01/04/2014 09:00:00 AM,48,-122,25,35,60
11002,FremontBridge,01/04/2014 10:00:00 AM,48,-122,24,39,63
11003,FremontBridge,01/04/2014 11:00:00 AM,48,-122,35,56,91
11004,FremontBridge,01/04/2014 12:00:00 PM,48,-122,52,73,125
11005,FremontBridge,01/04/2014 01:00:00 PM,48,-122,75,76,151
11006,FremontBridge,01/04/2014 02:00:00 PM,48,-122,61,102,163
11007,FremontBridge,01/04/2014 03:00:00 PM,48,-122,53,80,133
11008,FremontBridge,01/04/2014 04:00:00 PM,48,-122,43,49,92
11009,FremontBridge,01/04/2014 05:00:00 PM,48,-122,35,32,67
11010,FremontBridge,01/04/2014 06:00:00 PM,48,-122,13,19,32
11011,FremontBridge,01/04/2014 07:00:00 PM,48,-122,16,20,36
11012,FremontBridge,01/04/2014 08:00:00 PM,48,-122,14,12,26
11013,FremontBridge,01/04/2014 09:00:00 PM,48,-122,12,8,20
11014,FremontBridge,01/04/2014 10:00:00 PM,48,-122,7,4,11
11015,FremontBridge,01/04/2014 11:00:00 PM,48,-122,9,7,16
11016,FremontBridge,01/05/2014 12:00:00 AM,48,-122,4,8,12
11017,FremontBridge,01/05/2014 01:00:00 AM,48,-122,1,3,4
11018,FremontBridge,01/05/2014 02:00:00 AM,48,-122,4,1,5
11019,FremontBridge,01/05/2014 03:00:00 AM,48,-122,0,3,3
11020,FremontBridge,01/05/2014 04:00:00 AM,48,-122,4,3,7
11021,FremontBridge,01/05/2014 05:00:00 AM,48,-122,0,6,6
11022,FremontBridge,01/05/2014 06:00:00 AM,48,-122,2,3,5
11023,FremontBridge,01/05/2014 07:00:00 AM,48,-122,3,7,10
11024,FremontBridge,01/05/2014 08:00:00 AM,48,-122,21,21,42
11025,FremontBridge,01/05/2014 09:00:00 AM,48,-122,16,27,43
11026,FremontBridge,01/05/2014 10:00:00 AM,48,-122,24,45,69
11027,FremontBridge,01/05/2014 11:00:00 AM,48,-122,36,41,77
11028,FremontBridge,01/05/2014 12:00:00 PM,48,-122,41,98,139
11029,FremontBridge,01/05/2014 01:00:00 PM,48,-122,57,72,129
11030,FremontBridge,01/05/2014 02:00:00 PM,48,-122,77,93,170
11031,FremontBridge,01/05/2014 03:00:00 PM,48,-122,61,92,153
11032,FremontBridge,01/05/2014 04:00:00 PM,48,-122,42,62,104
11033,FremontBridge,01/05/2014 05:00:00 PM,48,-122,24,30,54
11034,FremontBridge,01/05/2014 06:00:00 PM,48,-122,20,20,40
11035,FremontBridge,01/05/2014 07:00:00 PM,48,-122,15,11,26
11036,FremontBridge,01/05/2014 08:00:00 PM,48,-122,5,7,12
11037,FremontBridge,01/05/2014 09:00:00 PM,48,-122,8,6,14
11038,FremontBridge,01/05/2014 10:00:00 PM,48,-122,12,2,14
11039,FremontBridge,01/05/2014 11:00:00 PM,48,-122,9,4,13
11040,FremontBridge,01/06/2014 12:00:00 AM,48,-122,5,2,7
11041,FremontBridge,01/06/2014 01:00:00 AM,48,-122,1,2,3
11042,FremontBridge,01/06/2014 02:00:00 AM,48,-122,0,3,3
11043,FremontBridge,01/06/2014 03:00:00 AM,48,-122,3,0,3
11044,FremontBridge,01/06/2014 04:00:00 AM,48,-122,1,1,2
11045,FremontBridge,01/06/2014 05:00:00 AM,48,-122,6,20,26
11046,FremontBridge,01/06/2014 06:00:00 AM,48,-122,30,51,81
11047,FremontBridge,01/06/2014 07:00:00 AM,48,-122,55,146,201
11048,FremontBridge,01/06/2014 08:00:00 AM,48,-122,86,220,306
11049,FremontBridge,01/06/2014 09:00:00 AM,48,-122,89,143,232
11050,FremontBridge,01/06/2014 10:00:00 AM,48,-122,32,60,92
11051,FremontBridge,01/06/2014 11:00:00 AM,48,-122,22,35,57
11052,FremontBridge,01/06/2014 12:00:00 PM,48,-122,35,23,58
11053,FremontBridge,01/06/2014 01:00:00 PM,48,-122,22,31,53
11054,FremontBridge,01/06/2014 02:00:00 PM,48,-122,40,41,81
11055,FremontBridge,01/06/2014 03:00:00 PM,48,-122,39,43,82
11056,FremontBridge,01/06/2014 04:00:00 PM,48,-122,97,75,172
11057,FremontBridge,01/06/2014 05:00:00 PM,48,-122,258,100,358
11058,FremontBridge,01/06/2014 06:00:00 PM,48,-122,183,75,258
11059,FremontBridge,01/06/2014 07:00:00 PM,48,-122,66,39,105
11060,FremontBridge,01/06/2014 08:00:00 PM,48,-122,37,17,54
11061,FremontBridge,01/06/2014 09:00:00 PM,48,-122,21,11,32
11062,FremontBridge,01/06/2014 10:00:00 PM,48,-122,11,11,22
11063,FremontBridge,01/06/2014 11:00:00 PM,48,-122,10,6,16
11064,FremontBridge,01/07/2014 12:00:00 AM,48,-122,2,4,6
11065,FremontBridge,01/07/2014 01:00:00 AM,48,-122,2,1,3
11066,FremontBridge,01/07/2014 02:00:00 AM,48,-122,1,3,4
11067,FremontBridge,01/07/2014 03:00:00 AM,48,-122,1,0,1
11068,FremontBridge,01/07/2014 04:00:00 AM,48,-122,3,2,5
11069,FremontBridge,01/07/2014 05:00:00 AM,48,-122,5,16,21
11070,FremontBridge,01/07/2014 06:00:00 AM,48,-122,30,57,87
11071,FremontBridge,01/07/2014 07:00:00 AM,48,-122,55,140,195
11072,FremontBridge,01/07/2014 08:00:00 AM,48,-122,93,228,321
11073,FremontBridge,01/07/2014 09:00:00 AM,48,-122,60,142,202
11074,FremontBridge,01/07/2014 10:00:00 AM,48,-122,28,51,79
11075,FremontBridge,01/07/2014 11:00:00 AM,48,-122,17,18,35
11076,FremontBridge,01/07/2014 12:00:00 PM,48,-122,12,20,32
11077,FremontBridge,01/07/2014 01:00:00 PM,48,-122,17,24,41
11078,FremontBridge,01/07/2014 02:00:00 PM,48,-122,25,29,54
11079,FremontBridge,01/07/2014 03:00:00 PM,48,-122,39,32,71
11080,FremontBridge,01/07/2014 04:00:00 PM,48,-122,82,52,134
11081,FremontBridge,01/07/2014 05:00:00 PM,48,-122,233,90,323
11082,FremontBridge,01/07/2014 06:00:00 PM,48,-122,175,88,263
11083,FremontBridge,01/07/2014 07:00:00 PM,48,-122,68,31,99
11084,FremontBridge,01/07/2014 08:00:00 PM,48,-122,27,17,44
11085,FremontBridge,01/07/2014 09:00:00 PM,48,-122,17,12,29
11086,FremontBridge,01/07/2014 10:00:00 PM,48,-122,12,9,21
11087,FremontBridge,01/07/2014 11:00:00 PM,48,-122,7,5,12
11088,FremontBridge,01/08/2014 12:00:00 AM,48,-122,3,4,7
11089,FremontBridge,01/08/2014 01:00:00 AM,48,-122,2,1,3
11090,FremontBridge,01/08/2014 02:00:00 AM,48,-122,0,1,1
11091,FremontBridge,01/08/2014 03:00:00 AM,48,-122,2,1,3
11092,FremontBridge,01/08/2014 04:00:00 AM,48,-122,1,4,5
11093,FremontBridge,01/08/2014 05:00:00 AM,48,-122,5,15,20
11094,FremontBridge,01/08/2014 06:00:00 AM,48,-122,17,46,63
11095,FremontBridge,01/08/2014 07:00:00 AM,48,-122,62,130,192
11096,FremontBridge,01/08/2014 08:00:00 AM,48,-122,88,241,329
11097,FremontBridge,01/08/2014 09:00:00 AM,48,-122,82,141,223
11098,FremontBridge,01/08/2014 10:00:00 AM,48,-122,31,44,75
11099,FremontBridge,01/08/2014 11:00:00 AM,48,-122,20,23,43
11100,FremontBridge,01/08/2014 12:00:00 PM,48,-122,15,15,30
11101,FremontBridge,01/08/2014 01:00:00 PM,48,-122,17,19,36
11102,FremontBridge,01/08/2014 02:00:00 PM,48,-122,12,19,31
11103,FremontBridge,01/08/2014 03:00:00 PM,48,-122,27,28,55
11104,FremontBridge,01/08/2014 04:00:00 PM,48,-122,72,39,111
11105,FremontBridge,01/08/2014 05:00:00 PM,48,-122,182,73,255
11106,FremontBridge,01/08/2014 06:00:00 PM,48,-122,176,71,247
11107,FremontBridge,01/08/2014 07:00:00 PM,48,-122,62,29,91
11108,FremontBridge,01/08/2014 08:00:00 PM,48,-122,35,27,62
11109,FremontBridge,01/08/2014 09:00:00 PM,48,-122,18,9,27
11110,FremontBridge,01/08/2014 10:00:00 PM,48,-122,14,7,21
11111,FremontBridge,01/08/2014 11:00:00 PM,48,-122,7,11,18
11112,FremontBridge,01/09/2014 12:00:00 AM,48,-122,3,3,6
11113,FremontBridge,01/09/2014 01:00:00 AM,48,-122,2,2,4
11114,FremontBridge,01/09/2014 02:00:00 AM,48,-122,1,1,2
11115,FremontBridge,01/09/2014 03:00:00 AM,48,-122,1,2,3
11116,FremontBridge,01/09/2014 04:00:00 AM,48,-122,2,1,3
11117,FremontBridge,01/09/2014 05:00:00 AM,48,-122,5,11,16
11118,FremontBridge,01/09/2014 06:00:00 AM,48,-122,21,47,68
11119,FremontBridge,01/09/2014 07:00:00 AM,48,-122,54,129,183
11120,FremontBridge,01/09/2014 08:00:00 AM,48,-122,98,208,306
11121,FremontBridge,01/09/2014 09:00:00 AM,48,-122,74,120,194
11122,FremontBridge,01/09/2014 10:00:00 AM,48,-122,31,58,89
11123,FremontBridge,01/09/2014 11:00:00 AM,48,-122,33,31,64
11124,FremontBridge,01/09/2014 12:00:00 PM,48,-122,16,15,31
11125,FremontBridge,01/09/2014 01:00:00 PM,48,-122,10,17,27
11126,FremontBridge,01/09/2014 02:00:00 PM,48,-122,25,32,57
11127,FremontBridge,01/09/2014 03:00:00 PM,48,-122,31,42,73
11128,FremontBridge,01/09/2014 04:00:00 PM,48,-122,94,46,140
11129,FremontBridge,01/09/2014 05:00:00 PM,48,-122,209,84,293
11130,FremontBridge,01/09/2014 06:00:00 PM,48,-122,170,83,253
11131,FremontBridge,01/09/2014 07:00:00 PM,48,-122,82,44,126
11132,FremontBridge,01/09/2014 08:00:00 PM,48,-122,85,18,103
11133,FremontBridge,01/09/2014 09:00:00 PM,48,-122,21,15,36
11134,FremontBridge,01/09/2014 10:00:00 PM,48,-122,17,10,27
11135,FremontBridge,01/09/2014 11:00:00 PM,48,-122,8,8,16
11136,FremontBridge,01/10/2014 12:00:00 AM,48,-122,5,3,8
11137,FremontBridge,01/10/2014 01:00:00 AM,48,-122,2,8,10
11138,FremontBridge,01/10/2014 02:00:00 AM,48,-122,1,1,2
11139,FremontBridge,01/10/2014 03:00:00 AM,48,-122,2,1,3
11140,FremontBridge,01/10/2014 04:00:00 AM,48,-122,3,2,5
11141,FremontBridge,01/10/2014 05:00:00 AM,48,-122,5,9,14
11142,FremontBridge,01/10/2014 06:00:00 AM,48,-122,22,46,68
11143,FremontBridge,01/10/2014 07:00:00 AM,48,-122,43,104,147
11144,FremontBridge,01/10/2014 08:00:00 AM,48,-122,56,197,253
11145,FremontBridge,01/10/2014 09:00:00 AM,48,-122,66,111,177
11146,FremontBridge,01/10/2014 10:00:00 AM,48,-122,31,55,86
11147,FremontBridge,01/10/2014 11:00:00 AM,48,-122,20,23,43
11148,FremontBridge,01/10/2014 12:00:00 PM,48,-122,15,30,45
11149,FremontBridge,01/10/2014 01:00:00 PM,48,-122,26,26,52
11150,FremontBridge,01/10/2014 02:00:00 PM,48,-122,26,40,66
11151,FremontBridge,01/10/2014 03:00:00 PM,48,-122,36,52,88
11152,FremontBridge,01/10/2014 04:00:00 PM,48,-122,75,55,130
11153,FremontBridge,01/10/2014 05:00:00 PM,48,-122,163,79,242
11154,FremontBridge,01/10/2014 06:00:00 PM,48,-122,124,68,192
11155,FremontBridge,01/10/2014 07:00:00 PM,48,-122,46,18,64
11156,FremontBridge,01/10/2014 08:00:00 PM,48,-122,22,14,36
11157,FremontBridge,01/10/2014 09:00:00 PM,48,-122,11,6,17
11158,FremontBridge,01/10/2014 10:00:00 PM,48,-122,6,8,14
11159,FremontBridge,01/10/2014 11:00:00 PM,48,-122,10,8,18
11160,FremontBridge,01/11/2014 12:00:00 AM,48,-122,5,5,10
11161,FremontBridge,01/11/2014 01:00:00 AM,48,-122,1,3,4
11162,FremontBridge,01/11/2014 02:00:00 AM,48,-122,2,1,3
11163,FremontBridge,01/11/2014 03:00:00 AM,48,-122,2,1,3
11164,FremontBridge,01/11/2014 04:00:00 AM,48,-122,0,0,0
11165,FremontBridge,01/11/2014 05:00:00 AM,48,-122,1,3,4
11166,FremontBridge,01/11/2014 06:00:00 AM,48,-122,6,4,10
11167,FremontBridge,01/11/2014 07:00:00 AM,48,-122,7,7,14
11168,FremontBridge,01/11/2014 08:00:00 AM,48,-122,12,21,33
11169,FremontBridge,01/11/2014 09:00:00 AM,48,-122,22,28,50
11170,FremontBridge,01/11/2014 10:00:00 AM,48,-122,27,30,57
11171,FremontBridge,01/11/2014 11:00:00 AM,48,-122,8,19,27
11172,FremontBridge,01/11/2014 12:00:00 PM,48,-122,8,13,21
11173,FremontBridge,01/11/2014 01:00:00 PM,48,-122,14,15,29
11174,FremontBridge,01/11/2014 02:00:00 PM,48,-122,6,12,18
11175,FremontBridge,01/11/2014 03:00:00 PM,48,-122,4,9,13
11176,FremontBridge,01/11/2014 04:00:00 PM,48,-122,11,10,21
11177,FremontBridge,01/11/2014 05:00:00 PM,48,-122,9,9,18
11178,FremontBridge,01/11/2014 06:00:00 PM,48,-122,15,17,32
11179,FremontBridge,01/11/2014 07:00:00 PM,48,-122,7,10,17
11180,FremontBridge,01/11/2014 08:00:00 PM,48,-122,5,7,12
11181,FremontBridge,01/11/2014 09:00:00 PM,48,-122,6,4,10
11182,FremontBridge,01/11/2014 10:00:00 PM,48,-122,8,3,11
11183,FremontBridge,01/11/2014 11:00:00 PM,48,-122,2,4,6
11184,FremontBridge,01/12/2014 12:00:00 AM,48,-122,6,5,11
11185,FremontBridge,01/12/2014 01:00:00 AM,48,-122,1,4,5
11186,FremontBridge,01/12/2014 02:00:00 AM,48,-122,0,2,2
11187,FremontBridge,01/12/2014 03:00:00 AM,48,-122,3,1,4
11188,FremontBridge,01/12/2014 04:00:00 AM,48,-122,0,3,3
11189,FremontBridge,01/12/2014 05:00:00 AM,48,-122,2,4,6
11190,FremontBridge,01/12/2014 06:00:00 AM,48,-122,8,2,10
11191,FremontBridge,01/12/2014 07:00:00 AM,48,-122,1,1,2
11192,FremontBridge,01/12/2014 08:00:00 AM,48,-122,10,11,21
11193,FremontBridge,01/12/2014 09:00:00 AM,48,-122,12,21,33
11194,FremontBridge,01/12/2014 10:00:00 AM,48,-122,17,24,41
11195,FremontBridge,01/12/2014 11:00:00 AM,48,-122,22,20,42
11196,FremontBridge,01/12/2014 12:00:00 PM,48,-122,30,34,64
11197,FremontBridge,01/12/2014 01:00:00 PM,48,-122,26,30,56
11198,FremontBridge,01/12/2014 02:00:00 PM,48,-122,28,40,68
11199,FremontBridge,01/12/2014 03:00:00 PM,48,-122,35,30,65
11200,FremontBridge,01/12/2014 04:00:00 PM,48,-122,22,40,62
11201,FremontBridge,01/12/2014 05:00:00 PM,48,-122,15,22,37
11202,FremontBridge,01/12/2014 06:00:00 PM,48,-122,11,25,36
11203,FremontBridge,01/12/2014 07:00:00 PM,48,-122,7,28,35
11204,FremontBridge,01/12/2014 08:00:00 PM,48,-122,7,9,16
11205,FremontBridge,01/12/2014 09:00:00 PM,48,-122,10,6,16
11206,FremontBridge,01/12/2014 10:00:00 PM,48,-122,6,3,9
11207,FremontBridge,01/12/2014 11:00:00 PM,48,-122,6,5,11
11208,FremontBridge,01/13/2014 12:00:00 AM,48,-122,5,3,8
11209,FremontBridge,01/13/2014 01:00:00 AM,48,-122,0,4,4
11210,FremontBridge,01/13/2014 02:00:00 AM,48,-122,1,1,2
11211,FremontBridge,01/13/2014 03:00:00 AM,48,-122,1,3,4
11212,FremontBridge,01/13/2014 04:00:00 AM,48,-122,2,2,4
11213,FremontBridge,01/13/2014 05:00:00 AM,48,-122,4,12,16
11214,FremontBridge,01/13/2014 06:00:00 AM,48,-122,29,55,84
11215,FremontBridge,01/13/2014 07:00:00 AM,48,-122,60,142,202
11216,FremontBridge,01/13/2014 08:00:00 AM,48,-122,85,274,359
11217,FremontBridge,01/13/2014 09:00:00 AM,48,-122,83,151,234
11218,FremontBridge,01/13/2014 10:00:00 AM,48,-122,41,54,95
11219,FremontBridge,01/13/2014 11:00:00 AM,48,-122,30,33,63
11220,FremontBridge,01/13/2014 12:00:00 PM,48,-122,18,35,53
11221,FremontBridge,01/13/2014 01:00:00 PM,48,-122,39,29,68
11222,FremontBridge,01/13/2014 02:00:00 PM,48,-122,30,37,67
11223,FremontBridge,01/13/2014 03:00:00 PM,48,-122,44,47,91
11224,FremontBridge,01/13/2014 04:00:00 PM,48,-122,87,78,165
11225,FremontBridge,01/13/2014 05:00:00 PM,48,-122,275,103,378
11226,FremontBridge,01/13/2014 06:00:00 PM,48,-122,219,98,317
11227,FremontBridge,01/13/2014 07:00:00 PM,48,-122,83,42,125
11228,FremontBridge,01/13/2014 08:00:00 PM,48,-122,51,31,82
11229,FremontBridge,01/13/2014 09:00:00 PM,48,-122,39,18,57
11230,FremontBridge,01/13/2014 10:00:00 PM,48,-122,14,13,27
11231,FremontBridge,01/13/2014 11:00:00 PM,48,-122,11,14,25
11232,FremontBridge,01/14/2014 12:00:00 AM,48,-122,5,9,14
11233,FremontBridge,01/14/2014 01:00:00 AM,48,-122,1,0,1
11234,FremontBridge,01/14/2014 02:00:00 AM,48,-122,1,0,1
11235,FremontBridge,01/14/2014 03:00:00 AM,48,-122,0,1,1
11236,FremontBridge,01/14/2014 04:00:00 AM,48,-122,3,8,11
11237,FremontBridge,01/14/2014 05:00:00 AM,48,-122,11,13,24
11238,FremontBridge,01/14/2014 06:00:00 AM,48,-122,27,72,99
11239,FremontBridge,01/14/2014 07:00:00 AM,48,-122,74,180,254
11240,FremontBridge,01/14/2014 08:00:00 AM,48,-122,110,275,385
11241,FremontBridge,01/14/2014 09:00:00 AM,48,-122,115,175,290
11242,FremontBridge,01/14/2014 10:00:00 AM,48,-122,37,68,105
11243,FremontBridge,01/14/2014 11:00:00 AM,48,-122,26,29,55
11244,FremontBridge,01/14/2014 12:00:00 PM,48,-122,29,38,67
11245,FremontBridge,01/14/2014 01:00:00 PM,48,-122,38,37,75
11246,FremontBridge,01/14/2014 02:00:00 PM,48,-122,36,40,76
11247,FremontBridge,01/14/2014 03:00:00 PM,48,-122,50,57,107
11248,FremontBridge,01/14/2014 04:00:00 PM,48,-122,115,84,199
11249,FremontBridge,01/14/2014 05:00:00 PM,48,-122,303,102,405
11250,FremontBridge,01/14/2014 06:00:00 PM,48,-122,215,104,319
11251,FremontBridge,01/14/2014 07:00:00 PM,48,-122,81,61,142
11252,FremontBridge,01/14/2014 08:00:00 PM,48,-122,37,28,65
11253,FremontBridge,01/14/2014 09:00:00 PM,48,-122,43,17,60
11254,FremontBridge,01/14/2014 10:00:00 PM,48,-122,21,15,36
11255,FremontBridge,01/14/2014 11:00:00 PM,48,-122,11,6,17
11256,FremontBridge,01/15/2014 12:00:00 AM,48,-122,0,7,7
11257,FremontBridge,01/15/2014 01:00:00 AM,48,-122,2,2,4
11258,FremontBridge,01/15/2014 02:00:00 AM,48,-122,0,2,2
11259,FremontBridge,01/15/2014 03:00:00 AM,48,-122,1,1,2
11260,FremontBridge,01/15/2014 04:00:00 AM,48,-122,5,3,8
11261,FremontBridge,01/15/2014 05:00:00 AM,48,-122,8,10,18
11262,FremontBridge,01/15/2014 06:00:00 AM,48,-122,23,73,96
11263,FremontBridge,01/15/2014 07:00:00 AM,48,-122,62,164,226
11264,FremontBridge,01/15/2014 08:00:00 AM,48,-122,110,261,371
11265,FremontBridge,01/15/2014 09:00:00 AM,48,-122,86,158,244
11266,FremontBridge,01/15/2014 10:00:00 AM,48,-122,44,52,96
11267,FremontBridge,01/15/2014 11:00:00 AM,48,-122,26,40,66
11268,FremontBridge,01/15/2014 12:00:00 PM,48,-122,45,43,88
11269,FremontBridge,01/15/2014 01:00:00 PM,48,-122,39,37,76
11270,FremontBridge,01/15/2014 02:00:00 PM,48,-122,41,52,93
11271,FremontBridge,01/15/2014 03:00:00 PM,48,-122,44,51,95
11272,FremontBridge,01/15/2014 04:00:00 PM,48,-122,119,73,192
11273,FremontBridge,01/15/2014 05:00:00 PM,48,-122,254,111,365
11274,FremontBridge,01/15/2014 06:00:00 PM,48,-122,224,137,361
11275,FremontBridge,01/15/2014 07:00:00 PM,48,-122,104,49,153
11276,FremontBridge,01/15/2014 08:00:00 PM,48,-122,60,26,86
11277,FremontBridge,01/15/2014 09:00:00 PM,48,-122,32,28,60
11278,FremontBridge,01/15/2014 10:00:00 PM,48,-122,32,17,49
11279,FremontBridge,01/15/2014 11:00:00 PM,48,-122,11,3,14
11280,FremontBridge,01/16/2014 12:00:00 AM,48,-122,8,5,13
11281,FremontBridge,01/16/2014 01:00:00 AM,48,-122,4,3,7
11282,FremontBridge,01/16/2014 02:00:00 AM,48,-122,2,3,5
11283,FremontBridge,01/16/2014 03:00:00 AM,48,-122,1,1,2
11284,FremontBridge,01/16/2014 04:00:00 AM,48,-122,1,1,2
11285,FremontBridge,01/16/2014 05:00:00 AM,48,-122,7,17,24
11286,FremontBridge,01/16/2014 06:00:00 AM,48,-122,30,72,102
11287,FremontBridge,01/16/2014 07:00:00 AM,48,-122,65,161,226
11288,FremontBridge,01/16/2014 08:00:00 AM,48,-122,113,269,382
11289,FremontBridge,01/16/2014 09:00:00 AM,48,-122,80,154,234
11290,FremontBridge,01/16/2014 10:00:00 AM,48,-122,56,60,116
11291,FremontBridge,01/16/2014 11:00:00 AM,48,-122,29,30,59
11292,FremontBridge,01/16/2014 12:00:00 PM,48,-122,32,40,72
11293,FremontBridge,01/16/2014 01:00:00 PM,48,-122,23,37,60
11294,FremontBridge,01/16/2014 02:00:00 PM,48,-122,41,41,82
11295,FremontBridge,01/16/2014 03:00:00 PM,48,-122,40,57,97
11296,FremontBridge,01/16/2014 04:00:00 PM,48,-122,109,61,170
11297,FremontBridge,01/16/2014 05:00:00 PM,48,-122,244,113,357
11298,FremontBridge,01/16/2014 06:00:00 PM,48,-122,206,99,305
11299,FremontBridge,01/16/2014 07:00:00 PM,48,-122,99,48,147
11300,FremontBridge,01/16/2014 08:00:00 PM,48,-122,44,28,72
11301,FremontBridge,01/16/2014 09:00:00 PM,48,-122,28,28,56
11302,FremontBridge,01/16/2014 10:00:00 PM,48,-122,19,16,35
11303,FremontBridge,01/16/2014 11:00:00 PM,48,-122,9,7,16
11304,FremontBridge,01/17/2014 12:00:00 AM,48,-122,9,1,10
11305,FremontBridge,01/17/2014 01:00:00 AM,48,-122,3,3,6
11306,FremontBridge,01/17/2014 02:00:00 AM,48,-122,3,2,5
11307,FremontBridge,01/17/2014 03:00:00 AM,48,-122,2,1,3
11308,FremontBridge,01/17/2014 04:00:00 AM,48,-122,2,1,3
11309,FremontBridge,01/17/2014 05:00:00 AM,48,-122,7,13,20
11310,FremontBridge,01/17/2014 06:00:00 AM,48,-122,26,50,76
11311,FremontBridge,01/17/2014 07:00:00 AM,48,-122,59,135,194
11312,FremontBridge,01/17/2014 08:00:00 AM,48,-122,84,249,333
11313,FremontBridge,01/17/2014 09:00:00 AM,48,-122,71,140,211
11314,FremontBridge,01/17/2014 10:00:00 AM,48,-122,33,70,103
11315,FremontBridge,01/17/2014 11:00:00 AM,48,-122,22,37,59
11316,FremontBridge,01/17/2014 12:00:00 PM,48,-122,31,35,66
11317,FremontBridge,01/17/2014 01:00:00 PM,48,-122,27,43,70
11318,FremontBridge,01/17/2014 02:00:00 PM,48,-122,36,37,73
11319,FremontBridge,01/17/2014 03:00:00 PM,48,-122,50,52,102
11320,FremontBridge,01/17/2014 04:00:00 PM,48,-122,113,86,199
11321,FremontBridge,01/17/2014 05:00:00 PM,48,-122,231,106,337
11322,FremontBridge,01/17/2014 06:00:00 PM,48,-122,137,71,208
11323,FremontBridge,01/17/2014 07:00:00 PM,48,-122,80,26,106
11324,FremontBridge,01/17/2014 08:00:00 PM,48,-122,24,17,41
11325,FremontBridge,01/17/2014 09:00:00 PM,48,-122,17,20,37
11326,FremontBridge,01/17/2014 10:00:00 PM,48,-122,14,12,26
11327,FremontBridge,01/17/2014 11:00:00 PM,48,-122,11,11,22
11328,FremontBridge,01/18/2014 12:00:00 AM,48,-122,9,6,15
11329,FremontBridge,01/18/2014 01:00:00 AM,48,-122,3,8,11
11330,FremontBridge,01/18/2014 02:00:00 AM,48,-122,1,4,5
11331,FremontBridge,01/18/2014 03:00:00 AM,48,-122,4,2,6
11332,FremontBridge,01/18/2014 04:00:00 AM,48,-122,5,0,5
11333,FremontBridge,01/18/2014 05:00:00 AM,48,-122,1,5,6
11334,FremontBridge,01/18/2014 06:00:00 AM,48,-122,10,7,17
11335,FremontBridge,01/18/2014 07:00:00 AM,48,-122,8,10,18
11336,FremontBridge,01/18/2014 08:00:00 AM,48,-122,21,37,58
11337,FremontBridge,01/18/2014 09:00:00 AM,48,-122,30,31,61
11338,FremontBridge,01/18/2014 10:00:00 AM,48,-122,31,46,77
11339,FremontBridge,01/18/2014 11:00:00 AM,48,-122,31,44,75
11340,FremontBridge,01/18/2014 12:00:00 PM,48,-122,31,62,93
11341,FremontBridge,01/18/2014 01:00:00 PM,48,-122,37,79,116
11342,FremontBridge,01/18/2014 02:00:00 PM,48,-122,44,60,104
11343,FremontBridge,01/18/2014 03:00:00 PM,48,-122,51,73,124
11344,FremontBridge,01/18/2014 04:00:00 PM,48,-122,62,55,117
11345,FremontBridge,01/18/2014 05:00:00 PM,48,-122,32,30,62
11346,FremontBridge,01/18/2014 06:00:00 PM,48,-122,23,32,55
11347,FremontBridge,01/18/2014 07:00:00 PM,48,-122,16,15,31
11348,FremontBridge,01/18/2014 08:00:00 PM,48,-122,13,7,20
11349,FremontBridge,01/18/2014 09:00:00 PM,48,-122,12,14,26
11350,FremontBridge,01/18/2014 10:00:00 PM,48,-122,7,7,14
11351,FremontBridge,01/18/2014 11:00:00 PM,48,-122,9,10,19
11352,FremontBridge,01/19/2014 12:00:00 AM,48,-122,8,6,14
11353,FremontBridge,01/19/2014 01:00:00 AM,48,-122,6,2,8
11354,FremontBridge,01/19/2014 02:00:00 AM,48,-122,1,2,3
11355,FremontBridge,01/19/2014 03:00:00 AM,48,-122,1,1,2
11356,FremontBridge,01/19/2014 04:00:00 AM,48,-122,0,0,0
11357,FremontBridge,01/19/2014 05:00:00 AM,48,-122,2,4,6
11358,FremontBridge,01/19/2014 06:00:00 AM,48,-122,6,3,9
11359,FremontBridge,01/19/2014 07:00:00 AM,48,-122,6,3,9
11360,FremontBridge,01/19/2014 08:00:00 AM,48,-122,13,21,34
11361,FremontBridge,01/19/2014 09:00:00 AM,48,-122,18,35,53
11362,FremontBridge,01/19/2014 10:00:00 AM,48,-122,29,40,69
11363,FremontBridge,01/19/2014 11:00:00 AM,48,-122,31,33,64
11364,FremontBridge,01/19/2014 12:00:00 PM,48,-122,43,54,97
11365,FremontBridge,01/19/2014 01:00:00 PM,48,-122,46,47,93
11366,FremontBridge,01/19/2014 02:00:00 PM,48,-122,17,52,69
11367,FremontBridge,01/19/2014 03:00:00 PM,48,-122,29,42,71
11368,FremontBridge,01/19/2014 04:00:00 PM,48,-122,15,20,35
11369,FremontBridge,01/19/2014 05:00:00 PM,48,-122,21,13,34
11370,FremontBridge,01/19/2014 06:00:00 PM,48,-122,12,10,22
11371,FremontBridge,01/19/2014 07:00:00 PM,48,-122,18,17,35
11372,FremontBridge,01/19/2014 08:00:00 PM,48,-122,21,16,37
11373,FremontBridge,01/19/2014 09:00:00 PM,48,-122,17,11,28
11374,FremontBridge,01/19/2014 10:00:00 PM,48,-122,8,5,13
11375,FremontBridge,01/19/2014 11:00:00 PM,48,-122,10,7,17
11376,FremontBridge,01/20/2014 12:00:00 AM,48,-122,4,4,8
11377,FremontBridge,01/20/2014 01:00:00 AM,48,-122,1,4,5
11378,FremontBridge,01/20/2014 02:00:00 AM,48,-122,1,1,2
11379,FremontBridge,01/20/2014 03:00:00 AM,48,-122,1,0,1
11380,FremontBridge,01/20/2014 04:00:00 AM,48,-122,1,1,2
11381,FremontBridge,01/20/2014 05:00:00 AM,48,-122,3,10,13
11382,FremontBridge,01/20/2014 06:00:00 AM,48,-122,17,26,43
11383,FremontBridge,01/20/2014 07:00:00 AM,48,-122,45,89,134
11384,FremontBridge,01/20/2014 08:00:00 AM,48,-122,50,107,157
11385,FremontBridge,01/20/2014 09:00:00 AM,48,-122,54,85,139
11386,FremontBridge,01/20/2014 10:00:00 AM,48,-122,31,46,77
11387,FremontBridge,01/20/2014 11:00:00 AM,48,-122,39,32,71
11388,FremontBridge,01/20/2014 12:00:00 PM,48,-122,31,55,86
11389,FremontBridge,01/20/2014 01:00:00 PM,48,-122,41,69,110
11390,FremontBridge,01/20/2014 02:00:00 PM,48,-122,73,65,138
11391,FremontBridge,01/20/2014 03:00:00 PM,48,-122,55,85,140
11392,FremontBridge,01/20/2014 04:00:00 PM,48,-122,96,71,167
11393,FremontBridge,01/20/2014 05:00:00 PM,48,-122,142,68,210
11394,FremontBridge,01/20/2014 06:00:00 PM,48,-122,107,52,159
11395,FremontBridge,01/20/2014 07:00:00 PM,48,-122,65,33,98
11396,FremontBridge,01/20/2014 08:00:00 PM,48,-122,24,20,44
11397,FremontBridge,01/20/2014 09:00:00 PM,48,-122,18,14,32
11398,FremontBridge,01/20/2014 10:00:00 PM,48,-122,14,10,24
11399,FremontBridge,01/20/2014 11:00:00 PM,48,-122,12,2,14
11400,FremontBridge,01/21/2014 12:00:00 AM,48,-122,3,5,8
11401,FremontBridge,01/21/2014 01:00:00 AM,48,-122,2,2,4
11402,FremontBridge,01/21/2014 02:00:00 AM,48,-122,1,1,2
11403,FremontBridge,01/21/2014 03:00:00 AM,48,-122,2,0,2
11404,FremontBridge,01/21/2014 04:00:00 AM,48,-122,2,3,5
11405,FremontBridge,01/21/2014 05:00:00 AM,48,-122,5,13,18
11406,FremontBridge,01/21/2014 06:00:00 AM,48,-122,32,69,101
11407,FremontBridge,01/21/2014 07:00:00 AM,48,-122,64,154,218
11408,FremontBridge,01/21/2014 08:00:00 AM,48,-122,104,272,376
11409,FremontBridge,01/21/2014 09:00:00 AM,48,-122,87,135,222
11410,FremontBridge,01/21/2014 10:00:00 AM,48,-122,42,72,114
11411,FremontBridge,01/21/2014 11:00:00 AM,48,-122,31,33,64
11412,FremontBridge,01/21/2014 12:00:00 PM,48,-122,35,41,76
11413,FremontBridge,01/21/2014 01:00:00 PM,48,-122,25,25,50
11414,FremontBridge,01/21/2014 02:00:00 PM,48,-122,34,29,63
11415,FremontBridge,01/21/2014 03:00:00 PM,48,-122,57,53,110
11416,FremontBridge,01/21/2014 04:00:00 PM,48,-122,116,76,192
11417,FremontBridge,01/21/2014 05:00:00 PM,48,-122,269,139,408
11418,FremontBridge,01/21/2014 06:00:00 PM,48,-122,222,113,335
11419,FremontBridge,01/21/2014 07:00:00 PM,48,-122,114,48,162
11420,FremontBridge,01/21/2014 08:00:00 PM,48,-122,24,31,55
11421,FremontBridge,01/21/2014 09:00:00 PM,48,-122,31,15,46
11422,FremontBridge,01/21/2014 10:00:00 PM,48,-122,16,17,33
11423,FremontBridge,01/21/2014 11:00:00 PM,48,-122,10,6,16
11424,FremontBridge,01/22/2014 12:00:00 AM,48,-122,6,7,13
11425,FremontBridge,01/22/2014 01:00:00 AM,48,-122,1,5,6
11426,FremontBridge,01/22/2014 02:00:00 AM,48,-122,2,1,3
11427,FremontBridge,01/22/2014 03:00:00 AM,48,-122,2,1,3
11428,FremontBridge,01/22/2014 04:00:00 AM,48,-122,4,2,6
11429,FremontBridge,01/22/2014 05:00:00 AM,48,-122,5,15,20
11430,FremontBridge,01/22/2014 06:00:00 AM,48,-122,24,64,88
11431,FremontBridge,01/22/2014 07:00:00 AM,48,-122,65,168,233
11432,FremontBridge,01/22/2014 08:00:00 AM,48,-122,107,268,375
11433,FremontBridge,01/22/2014 09:00:00 AM,48,-122,90,163,253
11434,FremontBridge,01/22/2014 10:00:00 AM,48,-122,45,60,105
11435,FremontBridge,01/22/2014 11:00:00 AM,48,-122,24,32,56
11436,FremontBridge,01/22/2014 12:00:00 PM,48,-122,27,36,63
11437,FremontBridge,01/22/2014 01:00:00 PM,48,-122,33,40,73
11438,FremontBridge,01/22/2014 02:00:00 PM,48,-122,31,43,74
11439,FremontBridge,01/22/2014 03:00:00 PM,48,-122,51,51,102
11440,FremontBridge,01/22/2014 04:00:00 PM,48,-122,109,79,188
11441,FremontBridge,01/22/2014 05:00:00 PM,48,-122,266,132,398
11442,FremontBridge,01/22/2014 06:00:00 PM,48,-122,230,98,328
11443,FremontBridge,01/22/2014 07:00:00 PM,48,-122,90,53,143
11444,FremontBridge,01/22/2014 08:00:00 PM,48,-122,43,25,68
11445,FremontBridge,01/22/2014 09:00:00 PM,48,-122,30,19,49
11446,FremontBridge,01/22/2014 10:00:00 PM,48,-122,16,16,32
11447,FremontBridge,01/22/2014 11:00:00 PM,48,-122,10,3,13
11448,FremontBridge,01/23/2014 12:00:00 AM,48,-122,1,4,5
11449,FremontBridge,01/23/2014 01:00:00 AM,48,-122,2,2,4
11450,FremontBridge,01/23/2014 02:00:00 AM,48,-122,4,2,6
11451,FremontBridge,01/23/2014 03:00:00 AM,48,-122,2,1,3
11452,FremontBridge,01/23/2014 04:00:00 AM,48,-122,2,1,3
11453,FremontBridge,01/23/2014 05:00:00 AM,48,-122,2,24,26
11454,FremontBridge,01/23/2014 06:00:00 AM,48,-122,28,62,90
11455,FremontBridge,01/23/2014 07:00:00 AM,48,-122,67,156,223
11456,FremontBridge,01/23/2014 08:00:00 AM,48,-122,122,244,366
11457,FremontBridge,01/23/2014 09:00:00 AM,48,-122,86,147,233
11458,FremontBridge,01/23/2014 10:00:00 AM,48,-122,39,64,103
11459,FremontBridge,01/23/2014 11:00:00 AM,48,-122,34,35,69
11460,FremontBridge,01/23/2014 12:00:00 PM,48,-122,23,50,73
11461,FremontBridge,01/23/2014 01:00:00 PM,48,-122,34,35,69
11462,FremontBridge,01/23/2014 02:00:00 PM,48,-122,42,39,81
11463,FremontBridge,01/23/2014 03:00:00 PM,48,-122,66,61,127
11464,FremontBridge,01/23/2014 04:00:00 PM,48,-122,121,70,191
11465,FremontBridge,01/23/2014 05:00:00 PM,48,-122,258,113,371
11466,FremontBridge,01/23/2014 06:00:00 PM,48,-122,182,105,287
11467,FremontBridge,01/23/2014 07:00:00 PM,48,-122,86,45,131
11468,FremontBridge,01/23/2014 08:00:00 PM,48,-122,48,39,87
11469,FremontBridge,01/23/2014 09:00:00 PM,48,-122,20,16,36
11470,FremontBridge,01/23/2014 10:00:00 PM,48,-122,21,23,44
11471,FremontBridge,01/23/2014 11:00:00 PM,48,-122,12,9,21
11472,FremontBridge,01/24/2014 12:00:00 AM,48,-122,9,10,19
11473,FremontBridge,01/24/2014 01:00:00 AM,48,-122,6,2,8
11474,FremontBridge,01/24/2014 02:00:00 AM,48,-122,2,2,4
11475,FremontBridge,01/24/2014 03:00:00 AM,48,-122,1,1,2
11476,FremontBridge,01/24/2014 04:00:00 AM,48,-122,3,5,8
11477,FremontBridge,01/24/2014 05:00:00 AM,48,-122,3,17,20
11478,FremontBridge,01/24/2014 06:00:00 AM,48,-122,27,48,75
11479,FremontBridge,01/24/2014 07:00:00 AM,48,-122,54,138,192
11480,FremontBridge,01/24/2014 08:00:00 AM,48,-122,87,227,314
11481,FremontBridge,01/24/2014 09:00:00 AM,48,-122,71,150,221
11482,FremontBridge,01/24/2014 10:00:00 AM,48,-122,42,84,126
11483,FremontBridge,01/24/2014 11:00:00 AM,48,-122,26,53,79
11484,FremontBridge,01/24/2014 12:00:00 PM,48,-122,30,52,82
11485,FremontBridge,01/24/2014 01:00:00 PM,48,-122,41,50,91
11486,FremontBridge,01/24/2014 02:00:00 PM,48,-122,49,61,110
11487,FremontBridge,01/24/2014 03:00:00 PM,48,-122,77,69,146
11488,FremontBridge,01/24/2014 04:00:00 PM,48,-122,111,90,201
11489,FremontBridge,01/24/2014 05:00:00 PM,48,-122,242,94,336
11490,FremontBridge,01/24/2014 06:00:00 PM,48,-122,161,63,224
11491,FremontBridge,01/24/2014 07:00:00 PM,48,-122,55,35,90
11492,FremontBridge,01/24/2014 08:00:00 PM,48,-122,37,22,59
11493,FremontBridge,01/24/2014 09:00:00 PM,48,-122,26,17,43
11494,FremontBridge,01/24/2014 10:00:00 PM,48,-122,12,25,37
11495,FremontBridge,01/24/2014 11:00:00 PM,48,-122,16,18,34
11496,FremontBridge,01/25/2014 12:00:00 AM,48,-122,10,8,18
11497,FremontBridge,01/25/2014 01:00:00 AM,48,-122,4,6,10
11498,FremontBridge,01/25/2014 02:00:00 AM,48,-122,2,4,6
11499,FremontBridge,01/25/2014 03:00:00 AM,48,-122,2,0,2
11500,FremontBridge,01/25/2014 04:00:00 AM,48,-122,1,2,3
11501,FremontBridge,01/25/2014 05:00:00 AM,48,-122,3,1,4
11502,FremontBridge,01/25/2014 06:00:00 AM,48,-122,7,5,12
11503,FremontBridge,01/25/2014 07:00:00 AM,48,-122,10,11,21
11504,FremontBridge,01/25/2014 08:00:00 AM,48,-122,21,21,42
11505,FremontBridge,01/25/2014 09:00:00 AM,48,-122,26,45,71
11506,FremontBridge,01/25/2014 10:00:00 AM,48,-122,24,38,62
11507,FremontBridge,01/25/2014 11:00:00 AM,48,-122,40,54,94
11508,FremontBridge,01/25/2014 12:00:00 PM,48,-122,68,67,135
11509,FremontBridge,01/25/2014 01:00:00 PM,48,-122,53,84,137
11510,FremontBridge,01/25/2014 02:00:00 PM,48,-122,71,94,165
11511,FremontBridge,01/25/2014 03:00:00 PM,48,-122,104,127,231
11512,FremontBridge,01/25/2014 04:00:00 PM,48,-122,67,97,164
11513,FremontBridge,01/25/2014 05:00:00 PM,48,-122,39,41,80
11514,FremontBridge,01/25/2014 06:00:00 PM,48,-122,29,39,68
11515,FremontBridge,01/25/2014 07:00:00 PM,48,-122,16,14,30
11516,FremontBridge,01/25/2014 08:00:00 PM,48,-122,21,10,31
11517,FremontBridge,01/25/2014 09:00:00 PM,48,-122,5,9,14
11518,FremontBridge,01/25/2014 10:00:00 PM,48,-122,8,16,24
11519,FremontBridge,01/25/2014 11:00:00 PM,48,-122,10,7,17
11520,FremontBridge,01/26/2014 12:00:00 AM,48,-122,9,10,19
11521,FremontBridge,01/26/2014 01:00:00 AM,48,-122,6,2,8
11522,FremontBridge,01/26/2014 02:00:00 AM,48,-122,3,3,6
11523,FremontBridge,01/26/2014 03:00:00 AM,48,-122,3,5,8
11524,FremontBridge,01/26/2014 04:00:00 AM,48,-122,1,2,3
11525,FremontBridge,01/26/2014 05:00:00 AM,48,-122,1,4,5
11526,FremontBridge,01/26/2014 06:00:00 AM,48,-122,8,6,14
11527,FremontBridge,01/26/2014 07:00:00 AM,48,-122,3,5,8
11528,FremontBridge,01/26/2014 08:00:00 AM,48,-122,9,26,35
11529,FremontBridge,01/26/2014 09:00:00 AM,48,-122,24,20,44
11530,FremontBridge,01/26/2014 10:00:00 AM,48,-122,17,56,73
11531,FremontBridge,01/26/2014 11:00:00 AM,48,-122,39,49,88
11532,FremontBridge,01/26/2014 12:00:00 PM,48,-122,55,68,123
11533,FremontBridge,01/26/2014 01:00:00 PM,48,-122,76,85,161
11534,FremontBridge,01/26/2014 02:00:00 PM,48,-122,180,116,296
11535,FremontBridge,01/26/2014 03:00:00 PM,48,-122,92,80,172
11536,FremontBridge,01/26/2014 04:00:00 PM,48,-122,57,74,131
11537,FremontBridge,01/26/2014 05:00:00 PM,48,-122,47,63,110
11538,FremontBridge,01/26/2014 06:00:00 PM,48,-122,18,26,44
11539,FremontBridge,01/26/2014 07:00:00 PM,48,-122,5,19,24
11540,FremontBridge,01/26/2014 08:00:00 PM,48,-122,9,11,20
11541,FremontBridge,01/26/2014 09:00:00 PM,48,-122,10,9,19
11542,FremontBridge,01/26/2014 10:00:00 PM,48,-122,3,6,9
11543,FremontBridge,01/26/2014 11:00:00 PM,48,-122,6,3,9
11544,FremontBridge,01/27/2014 12:00:00 AM,48,-122,6,2,8
11545,FremontBridge,01/27/2014 01:00:00 AM,48,-122,0,4,4
11546,FremontBridge,01/27/2014 02:00:00 AM,48,-122,1,2,3
11547,FremontBridge,01/27/2014 03:00:00 AM,48,-122,1,0,1
11548,FremontBridge,01/27/2014 04:00:00 AM,48,-122,0,1,1
11549,FremontBridge,01/27/2014 05:00:00 AM,48,-122,7,11,18
11550,FremontBridge,01/27/2014 06:00:00 AM,48,-122,33,61,94
11551,FremontBridge,01/27/2014 07:00:00 AM,48,-122,65,153,218
11552,FremontBridge,01/27/2014 08:00:00 AM,48,-122,103,254,357
11553,FremontBridge,01/27/2014 09:00:00 AM,48,-122,77,147,224
11554,FremontBridge,01/27/2014 10:00:00 AM,48,-122,35,48,83
11555,FremontBridge,01/27/2014 11:00:00 AM,48,-122,18,41,59
11556,FremontBridge,01/27/2014 12:00:00 PM,48,-122,19,34,53
11557,FremontBridge,01/27/2014 01:00:00 PM,48,-122,28,35,63
11558,FremontBridge,01/27/2014 02:00:00 PM,48,-122,39,35,74
11559,FremontBridge,01/27/2014 03:00:00 PM,48,-122,37,59,96
11560,FremontBridge,01/27/2014 04:00:00 PM,48,-122,112,68,180
11561,FremontBridge,01/27/2014 05:00:00 PM,48,-122,286,114,400
11562,FremontBridge,01/27/2014 06:00:00 PM,48,-122,204,90,294
11563,FremontBridge,01/27/2014 07:00:00 PM,48,-122,82,40,122
11564,FremontBridge,01/27/2014 08:00:00 PM,48,-122,42,19,61
11565,FremontBridge,01/27/2014 09:00:00 PM,48,-122,25,14,39
11566,FremontBridge,01/27/2014 10:00:00 PM,48,-122,13,14,27
11567,FremontBridge,01/27/2014 11:00:00 PM,48,-122,11,9,20
11568,FremontBridge,01/28/2014 12:00:00 AM,48,-122,4,4,8
11569,FremontBridge,01/28/2014 01:00:00 AM,48,-122,2,1,3
11570,FremontBridge,01/28/2014 02:00:00 AM,48,-122,2,2,4
11571,FremontBridge,01/28/2014 03:00:00 AM,48,-122,0,0,0
11572,FremontBridge,01/28/2014 04:00:00 AM,48,-122,0,4,4
11573,FremontBridge,01/28/2014 05:00:00 AM,48,-122,5,14,19
11574,FremontBridge,01/28/2014 06:00:00 AM,48,-122,26,67,93
11575,FremontBridge,01/28/2014 07:00:00 AM,48,-122,71,155,226
11576,FremontBridge,01/28/2014 08:00:00 AM,48,-122,108,246,354
11577,FremontBridge,01/28/2014 09:00:00 AM,48,-122,79,158,237
11578,FremontBridge,01/28/2014 10:00:00 AM,48,-122,32,48,80
11579,FremontBridge,01/28/2014 11:00:00 AM,48,-122,15,33,48
11580,FremontBridge,01/28/2014 12:00:00 PM,48,-122,23,38,61
11581,FremontBridge,01/28/2014 01:00:00 PM,48,-122,25,23,48
11582,FremontBridge,01/28/2014 02:00:00 PM,48,-122,28,27,55
11583,FremontBridge,01/28/2014 03:00:00 PM,48,-122,53,50,103
11584,FremontBridge,01/28/2014 04:00:00 PM,48,-122,101,61,162
11585,FremontBridge,01/28/2014 05:00:00 PM,48,-122,278,113,391
11586,FremontBridge,01/28/2014 06:00:00 PM,48,-122,184,93,277
11587,FremontBridge,01/28/2014 07:00:00 PM,48,-122,93,54,147
11588,FremontBridge,01/28/2014 08:00:00 PM,48,-122,36,27,63
11589,FremontBridge,01/28/2014 09:00:00 PM,48,-122,23,17,40
11590,FremontBridge,01/28/2014 10:00:00 PM,48,-122,18,13,31
11591,FremontBridge,01/28/2014 11:00:00 PM,48,-122,6,6,12
11592,FremontBridge,01/29/2014 12:00:00 AM,48,-122,2,4,6
11593,FremontBridge,01/29/2014 01:00:00 AM,48,-122,2,1,3
11594,FremontBridge,01/29/2014 02:00:00 AM,48,-122,0,1,1
11595,FremontBridge,01/29/2014 03:00:00 AM,48,-122,0,0,0
11596,FremontBridge,01/29/2014 04:00:00 AM,48,-122,1,2,3
11597,FremontBridge,01/29/2014 05:00:00 AM,48,-122,4,15,19
11598,FremontBridge,01/29/2014 06:00:00 AM,48,-122,11,50,61
11599,FremontBridge,01/29/2014 07:00:00 AM,48,-122,48,129,177
11600,FremontBridge,01/29/2014 08:00:00 AM,48,-122,71,206,277
11601,FremontBridge,01/29/2014 09:00:00 AM,48,-122,71,131,202
11602,FremontBridge,01/29/2014 10:00:00 AM,48,-122,27,44,71
11603,FremontBridge,01/29/2014 11:00:00 AM,48,-122,12,24,36
11604,FremontBridge,01/29/2014 12:00:00 PM,48,-122,25,13,38
11605,FremontBridge,01/29/2014 01:00:00 PM,48,-122,15,18,33
11606,FremontBridge,01/29/2014 02:00:00 PM,48,-122,29,12,41
11607,FremontBridge,01/29/2014 03:00:00 PM,48,-122,30,30,60
11608,FremontBridge,01/29/2014 04:00:00 PM,48,-122,74,52,126
11609,FremontBridge,01/29/2014 05:00:00 PM,48,-122,187,84,271
11610,FremontBridge,01/29/2014 06:00:00 PM,48,-122,159,72,231
11611,FremontBridge,01/29/2014 07:00:00 PM,48,-122,66,55,121
11612,FremontBridge,01/29/2014 08:00:00 PM,48,-122,34,14,48
11613,FremontBridge,01/29/2014 09:00:00 PM,48,-122,12,19,31
11614,FremontBridge,01/29/2014 10:00:00 PM,48,-122,14,12,26
11615,FremontBridge,01/29/2014 11:00:00 PM,48,-122,7,10,17
11616,FremontBridge,01/30/2014 12:00:00 AM,48,-122,4,2,6
11617,FremontBridge,01/30/2014 01:00:00 AM,48,-122,2,1,3
11618,FremontBridge,01/30/2014 02:00:00 AM,48,-122,2,2,4
11619,FremontBridge,01/30/2014 03:00:00 AM,48,-122,0,1,1
11620,FremontBridge,01/30/2014 04:00:00 AM,48,-122,2,5,7
11621,FremontBridge,01/30/2014 05:00:00 AM,48,-122,1,18,19
11622,FremontBridge,01/30/2014 06:00:00 AM,48,-122,24,57,81
11623,FremontBridge,01/30/2014 07:00:00 AM,48,-122,54,128,182
11624,FremontBridge,01/30/2014 08:00:00 AM,48,-122,95,215,310
11625,FremontBridge,01/30/2014 09:00:00 AM,48,-122,77,140,217
11626,FremontBridge,01/30/2014 10:00:00 AM,48,-122,42,53,95
11627,FremontBridge,01/30/2014 11:00:00 AM,48,-122,32,34,66
11628,FremontBridge,01/30/2014 12:00:00 PM,48,-122,24,28,52
11629,FremontBridge,01/30/2014 01:00:00 PM,48,-122,21,25,46
11630,FremontBridge,01/30/2014 02:00:00 PM,48,-122,24,31,55
11631,FremontBridge,01/30/2014 03:00:00 PM,48,-122,41,52,93
11632,FremontBridge,01/30/2014 04:00:00 PM,48,-122,103,58,161
11633,FremontBridge,01/30/2014 05:00:00 PM,48,-122,223,84,307
11634,FremontBridge,01/30/2014 06:00:00 PM,48,-122,178,74,252
11635,FremontBridge,01/30/2014 07:00:00 PM,48,-122,84,40,124
11636,FremontBridge,01/30/2014 08:00:00 PM,48,-122,38,22,60
11637,FremontBridge,01/30/2014 09:00:00 PM,48,-122,26,22,48
11638,FremontBridge,01/30/2014 10:00:00 PM,48,-122,20,10,30
11639,FremontBridge,01/30/2014 11:00:00 PM,48,-122,8,2,10
11640,FremontBridge,01/31/2014 12:00:00 AM,48,-122,5,3,8
11641,FremontBridge,01/31/2014 01:00:00 AM,48,-122,8,2,10
11642,FremontBridge,01/31/2014 02:00:00 AM,48,-122,0,2,2
11643,FremontBridge,01/31/2014 03:00:00 AM,48,-122,3,2,5
11644,FremontBridge,01/31/2014 04:00:00 AM,48,-122,1,2,3
11645,FremontBridge,01/31/2014 05:00:00 AM,48,-122,2,15,17
11646,FremontBridge,01/31/2014 06:00:00 AM,48,-122,21,39,60
11647,FremontBridge,01/31/2014 07:00:00 AM,48,-122,45,114,159
11648,FremontBridge,01/31/2014 08:00:00 AM,48,-122,73,179,252
11649,FremontBridge,01/31/2014 09:00:00 AM,48,-122,52,114,166
11650,FremontBridge,01/31/2014 10:00:00 AM,48,-122,48,45,93
11651,FremontBridge,01/31/2014 11:00:00 AM,48,-122,28,33,61
11652,FremontBridge,01/31/2014 12:00:00 PM,48,-122,27,42,69
11653,FremontBridge,01/31/2014 01:00:00 PM,48,-122,24,38,62
11654,FremontBridge,01/31/2014 02:00:00 PM,48,-122,39,46,85
11655,FremontBridge,01/31/2014 03:00:00 PM,48,-122,43,48,91
11656,FremontBridge,01/31/2014 04:00:00 PM,48,-122,96,61,157
11657,FremontBridge,01/31/2014 05:00:00 PM,48,-122,189,97,286
11658,FremontBridge,01/31/2014 06:00:00 PM,48,-122,139,77,216
11659,FremontBridge,01/31/2014 07:00:00 PM,48,-122,62,31,93
11660,FremontBridge,01/31/2014 08:00:00 PM,48,-122,37,17,54
11661,FremontBridge,01/31/2014 09:00:00 PM,48,-122,23,13,36
11662,FremontBridge,01/31/2014 10:00:00 PM,48,-122,14,16,30
11663,FremontBridge,01/31/2014 11:00:00 PM,48,-122,8,12,20
11664,FremontBridge,02/01/2014 12:00:00 AM,48,-122,16,5,21
11665,FremontBridge,02/01/2014 01:00:00 AM,48,-122,6,8,14
11666,FremontBridge,02/01/2014 02:00:00 AM,48,-122,3,1,4
11667,FremontBridge,02/01/2014 03:00:00 AM,48,-122,1,1,2
11668,FremontBridge,02/01/2014 04:00:00 AM,48,-122,1,0,1
11669,FremontBridge,02/01/2014 05:00:00 AM,48,-122,1,5,6
11670,FremontBridge,02/01/2014 06:00:00 AM,48,-122,6,5,11
11671,FremontBridge,02/01/2014 07:00:00 AM,48,-122,11,15,26
11672,FremontBridge,02/01/2014 08:00:00 AM,48,-122,18,42,60
11673,FremontBridge,02/01/2014 09:00:00 AM,48,-122,33,38,71
11674,FremontBridge,02/01/2014 10:00:00 AM,48,-122,35,56,91
11675,FremontBridge,02/01/2014 11:00:00 AM,48,-122,41,40,81
11676,FremontBridge,02/01/2014 12:00:00 PM,48,-122,41,70,111
11677,FremontBridge,02/01/2014 01:00:00 PM,48,-122,43,43,86
11678,FremontBridge,02/01/2014 02:00:00 PM,48,-122,53,69,122
11679,FremontBridge,02/01/2014 03:00:00 PM,48,-122,41,70,111
11680,FremontBridge,02/01/2014 04:00:00 PM,48,-122,46,64,110
11681,FremontBridge,02/01/2014 05:00:00 PM,48,-122,26,26,52
11682,FremontBridge,02/01/2014 06:00:00 PM,48,-122,16,31,47
11683,FremontBridge,02/01/2014 07:00:00 PM,48,-122,14,21,35
11684,FremontBridge,02/01/2014 08:00:00 PM,48,-122,12,9,21
11685,FremontBridge,02/01/2014 09:00:00 PM,48,-122,8,10,18
11686,FremontBridge,02/01/2014 10:00:00 PM,48,-122,6,10,16
11687,FremontBridge,02/01/2014 11:00:00 PM,48,-122,6,11,17
11688,FremontBridge,02/02/2014 12:00:00 AM,48,-122,10,9,19
11689,FremontBridge,02/02/2014 01:00:00 AM,48,-122,6,2,8
11690,FremontBridge,02/02/2014 02:00:00 AM,48,-122,5,0,5
11691,FremontBridge,02/02/2014 03:00:00 AM,48,-122,4,1,5
11692,FremontBridge,02/02/2014 04:00:00 AM,48,-122,4,2,6
11693,FremontBridge,02/02/2014 05:00:00 AM,48,-122,1,2,3
11694,FremontBridge,02/02/2014 06:00:00 AM,48,-122,4,5,9
11695,FremontBridge,02/02/2014 07:00:00 AM,48,-122,4,7,11
11696,FremontBridge,02/02/2014 08:00:00 AM,48,-122,17,20,37
11697,FremontBridge,02/02/2014 09:00:00 AM,48,-122,14,22,36
11698,FremontBridge,02/02/2014 10:00:00 AM,48,-122,28,65,93
11699,FremontBridge,02/02/2014 11:00:00 AM,48,-122,47,61,108
11700,FremontBridge,02/02/2014 12:00:00 PM,48,-122,46,75,121
11701,FremontBridge,02/02/2014 01:00:00 PM,48,-122,78,78,156
11702,FremontBridge,02/02/2014 02:00:00 PM,48,-122,63,72,135
11703,FremontBridge,02/02/2014 03:00:00 PM,48,-122,26,51,77
11704,FremontBridge,02/02/2014 04:00:00 PM,48,-122,28,19,47
11705,FremontBridge,02/02/2014 05:00:00 PM,48,-122,19,22,41
11706,FremontBridge,02/02/2014 06:00:00 PM,48,-122,7,16,23
11707,FremontBridge,02/02/2014 07:00:00 PM,48,-122,15,26,41
11708,FremontBridge,02/02/2014 08:00:00 PM,48,-122,20,24,44
11709,FremontBridge,02/02/2014 09:00:00 PM,48,-122,17,12,29
11710,FremontBridge,02/02/2014 10:00:00 PM,48,-122,18,6,24
11711,FremontBridge,02/02/2014 11:00:00 PM,48,-122,14,3,17
11712,FremontBridge,02/03/2014 12:00:00 AM,48,-122,2,3,5
11713,FremontBridge,02/03/2014 01:00:00 AM,48,-122,0,1,1
11714,FremontBridge,02/03/2014 02:00:00 AM,48,-122,0,1,1
11715,FremontBridge,02/03/2014 03:00:00 AM,48,-122,2,0,2
11716,FremontBridge,02/03/2014 04:00:00 AM,48,-122,3,3,6
11717,FremontBridge,02/03/2014 05:00:00 AM,48,-122,7,13,20
11718,FremontBridge,02/03/2014 06:00:00 AM,48,-122,24,42,66
11719,FremontBridge,02/03/2014 07:00:00 AM,48,-122,53,143,196
11720,FremontBridge,02/03/2014 08:00:00 AM,48,-122,74,235,309
11721,FremontBridge,02/03/2014 09:00:00 AM,48,-122,80,136,216
11722,FremontBridge,02/03/2014 10:00:00 AM,48,-122,46,45,91
11723,FremontBridge,02/03/2014 11:00:00 AM,48,-122,24,33,57
11724,FremontBridge,02/03/2014 12:00:00 PM,48,-122,22,28,50
11725,FremontBridge,02/03/2014 01:00:00 PM,48,-122,21,31,52
11726,FremontBridge,02/03/2014 02:00:00 PM,48,-122,29,43,72
11727,FremontBridge,02/03/2014 03:00:00 PM,48,-122,43,46,89
11728,FremontBridge,02/03/2014 04:00:00 PM,48,-122,111,75,186
11729,FremontBridge,02/03/2014 05:00:00 PM,48,-122,270,100,370
11730,FremontBridge,02/03/2014 06:00:00 PM,48,-122,178,82,260
11731,FremontBridge,02/03/2014 07:00:00 PM,48,-122,84,29,113
11732,FremontBridge,02/03/2014 08:00:00 PM,48,-122,33,20,53
11733,FremontBridge,02/03/2014 09:00:00 PM,48,-122,23,15,38
11734,FremontBridge,02/03/2014 10:00:00 PM,48,-122,16,8,24
11735,FremontBridge,02/03/2014 11:00:00 PM,48,-122,7,6,13
11736,FremontBridge,02/04/2014 12:00:00 AM,48,-122,2,2,4
11737,FremontBridge,02/04/2014 01:00:00 AM,48,-122,0,2,2
11738,FremontBridge,02/04/2014 02:00:00 AM,48,-122,0,1,1
11739,FremontBridge,02/04/2014 03:00:00 AM,48,-122,0,2,2
11740,FremontBridge,02/04/2014 04:00:00 AM,48,-122,0,4,4
11741,FremontBridge,02/04/2014 05:00:00 AM,48,-122,7,15,22
11742,FremontBridge,02/04/2014 06:00:00 AM,48,-122,28,50,78
11743,FremontBridge,02/04/2014 07:00:00 AM,48,-122,49,151,200
11744,FremontBridge,02/04/2014 08:00:00 AM,48,-122,94,218,312
11745,FremontBridge,02/04/2014 09:00:00 AM,48,-122,62,114,176
11746,FremontBridge,02/04/2014 10:00:00 AM,48,-122,34,40,74
11747,FremontBridge,02/04/2014 11:00:00 AM,48,-122,24,18,42
11748,FremontBridge,02/04/2014 12:00:00 PM,48,-122,20,32,52
11749,FremontBridge,02/04/2014 01:00:00 PM,48,-122,21,25,46
11750,FremontBridge,02/04/2014 02:00:00 PM,48,-122,27,34,61
11751,FremontBridge,02/04/2014 03:00:00 PM,48,-122,33,28,61
11752,FremontBridge,02/04/2014 04:00:00 PM,48,-122,84,59,143
11753,FremontBridge,02/04/2014 05:00:00 PM,48,-122,218,76,294
11754,FremontBridge,02/04/2014 06:00:00 PM,48,-122,189,77,266
11755,FremontBridge,02/04/2014 07:00:00 PM,48,-122,91,39,130
11756,FremontBridge,02/04/2014 08:00:00 PM,48,-122,22,16,38
11757,FremontBridge,02/04/2014 09:00:00 PM,48,-122,23,22,45
11758,FremontBridge,02/04/2014 10:00:00 PM,48,-122,12,11,23
11759,FremontBridge,02/04/2014 11:00:00 PM,48,-122,9,6,15
11760,FremontBridge,02/05/2014 12:00:00 AM,48,-122,5,4,9
11761,FremontBridge,02/05/2014 01:00:00 AM,48,-122,1,1,2
11762,FremontBridge,02/05/2014 02:00:00 AM,48,-122,1,0,1
11763,FremontBridge,02/05/2014 03:00:00 AM,48,-122,0,2,2
11764,FremontBridge,02/05/2014 04:00:00 AM,48,-122,2,1,3
11765,FremontBridge,02/05/2014 05:00:00 AM,48,-122,2,11,13
11766,FremontBridge,02/05/2014 06:00:00 AM,48,-122,17,38,55
11767,FremontBridge,02/05/2014 07:00:00 AM,48,-122,44,139,183
11768,FremontBridge,02/05/2014 08:00:00 AM,48,-122,88,229,317
11769,FremontBridge,02/05/2014 09:00:00 AM,48,-122,92,156,248
11770,FremontBridge,02/05/2014 10:00:00 AM,48,-122,74,171,245
11771,FremontBridge,02/05/2014 11:00:00 AM,48,-122,33,81,114
11772,FremontBridge,02/05/2014 12:00:00 PM,48,-122,55,45,100
11773,FremontBridge,02/05/2014 01:00:00 PM,48,-122,127,30,157
11774,FremontBridge,02/05/2014 02:00:00 PM,48,-122,72,27,99
11775,FremontBridge,02/05/2014 03:00:00 PM,48,-122,83,37,120
11776,FremontBridge,02/05/2014 04:00:00 PM,48,-122,105,56,161
11777,FremontBridge,02/05/2014 05:00:00 PM,48,-122,237,70,307
11778,FremontBridge,02/05/2014 06:00:00 PM,48,-122,152,74,226
11779,FremontBridge,02/05/2014 07:00:00 PM,48,-122,66,43,109
11780,FremontBridge,02/05/2014 08:00:00 PM,48,-122,39,17,56
11781,FremontBridge,02/05/2014 09:00:00 PM,48,-122,15,11,26
11782,FremontBridge,02/05/2014 10:00:00 PM,48,-122,10,6,16
11783,FremontBridge,02/05/2014 11:00:00 PM,48,-122,11,8,19
11784,FremontBridge,02/06/2014 12:00:00 AM,48,-122,2,3,5
11785,FremontBridge,02/06/2014 01:00:00 AM,48,-122,2,1,3
11786,FremontBridge,02/06/2014 02:00:00 AM,48,-122,0,0,0
11787,FremontBridge,02/06/2014 03:00:00 AM,48,-122,0,2,2
11788,FremontBridge,02/06/2014 04:00:00 AM,48,-122,1,1,2
11789,FremontBridge,02/06/2014 05:00:00 AM,48,-122,3,12,15
11790,FremontBridge,02/06/2014 06:00:00 AM,48,-122,19,33,52
11791,FremontBridge,02/06/2014 07:00:00 AM,48,-122,27,90,117
11792,FremontBridge,02/06/2014 08:00:00 AM,48,-122,66,163,229
11793,FremontBridge,02/06/2014 09:00:00 AM,48,-122,54,110,164
11794,FremontBridge,02/06/2014 10:00:00 AM,48,-122,29,40,69
11795,FremontBridge,02/06/2014 11:00:00 AM,48,-122,26,28,54
11796,FremontBridge,02/06/2014 12:00:00 PM,48,-122,17,27,44
11797,FremontBridge,02/06/2014 01:00:00 PM,48,-122,19,21,40
11798,FremontBridge,02/06/2014 02:00:00 PM,48,-122,17,24,41
11799,FremontBridge,02/06/2014 03:00:00 PM,48,-122,32,26,58
11800,FremontBridge,02/06/2014 04:00:00 PM,48,-122,63,39,102
11801,FremontBridge,02/06/2014 05:00:00 PM,48,-122,141,58,199
11802,FremontBridge,02/06/2014 06:00:00 PM,48,-122,113,59,172
11803,FremontBridge,02/06/2014 07:00:00 PM,48,-122,51,33,84
11804,FremontBridge,02/06/2014 08:00:00 PM,48,-122,30,15,45
11805,FremontBridge,02/06/2014 09:00:00 PM,48,-122,19,9,28
11806,FremontBridge,02/06/2014 10:00:00 PM,48,-122,11,5,16
11807,FremontBridge,02/06/2014 11:00:00 PM,48,-122,13,8,21
11808,FremontBridge,02/07/2014 12:00:00 AM,48,-122,4,3,7
11809,FremontBridge,02/07/2014 01:00:00 AM,48,-122,4,2,6
11810,FremontBridge,02/07/2014 02:00:00 AM,48,-122,1,0,1
11811,FremontBridge,02/07/2014 03:00:00 AM,48,-122,0,1,1
11812,FremontBridge,02/07/2014 04:00:00 AM,48,-122,2,2,4
11813,FremontBridge,02/07/2014 05:00:00 AM,48,-122,4,8,12
11814,FremontBridge,02/07/2014 06:00:00 AM,48,-122,16,30,46
11815,FremontBridge,02/07/2014 07:00:00 AM,48,-122,30,80,110
11816,FremontBridge,02/07/2014 08:00:00 AM,48,-122,52,142,194
11817,FremontBridge,02/07/2014 09:00:00 AM,48,-122,46,104,150
11818,FremontBridge,02/07/2014 10:00:00 AM,48,-122,32,39,71
11819,FremontBridge,02/07/2014 11:00:00 AM,48,-122,23,22,45
11820,FremontBridge,02/07/2014 12:00:00 PM,48,-122,27,27,54
11821,FremontBridge,02/07/2014 01:00:00 PM,48,-122,15,20,35
11822,FremontBridge,02/07/2014 02:00:00 PM,48,-122,28,39,67
11823,FremontBridge,02/07/2014 03:00:00 PM,48,-122,46,33,79
11824,FremontBridge,02/07/2014 04:00:00 PM,48,-122,68,56,124
11825,FremontBridge,02/07/2014 05:00:00 PM,48,-122,132,88,220
11826,FremontBridge,02/07/2014 06:00:00 PM,48,-122,106,48,154
11827,FremontBridge,02/07/2014 07:00:00 PM,48,-122,52,22,74
11828,FremontBridge,02/07/2014 08:00:00 PM,48,-122,30,15,45
11829,FremontBridge,02/07/2014 09:00:00 PM,48,-122,13,15,28
11830,FremontBridge,02/07/2014 10:00:00 PM,48,-122,9,12,21
11831,FremontBridge,02/07/2014 11:00:00 PM,48,-122,10,14,24
11832,FremontBridge,02/08/2014 12:00:00 AM,48,-122,31,3,34
11833,FremontBridge,02/08/2014 01:00:00 AM,48,-122,3,4,7
11834,FremontBridge,02/08/2014 02:00:00 AM,48,-122,2,0,2
11835,FremontBridge,02/08/2014 03:00:00 AM,48,-122,3,1,4
11836,FremontBridge,02/08/2014 04:00:00 AM,48,-122,0,0,0
11837,FremontBridge,02/08/2014 05:00:00 AM,48,-122,4,2,6
11838,FremontBridge,02/08/2014 06:00:00 AM,48,-122,6,5,11
11839,FremontBridge,02/08/2014 07:00:00 AM,48,-122,5,6,11
11840,FremontBridge,02/08/2014 08:00:00 AM,48,-122,13,13,26
11841,FremontBridge,02/08/2014 09:00:00 AM,48,-122,14,30,44
11842,FremontBridge,02/08/2014 10:00:00 AM,48,-122,23,44,67
11843,FremontBridge,02/08/2014 11:00:00 AM,48,-122,23,38,61
11844,FremontBridge,02/08/2014 12:00:00 PM,48,-122,27,49,76
11845,FremontBridge,02/08/2014 01:00:00 PM,48,-122,29,46,75
11846,FremontBridge,02/08/2014 02:00:00 PM,48,-122,30,60,90
11847,FremontBridge,02/08/2014 03:00:00 PM,48,-122,31,38,69
11848,FremontBridge,02/08/2014 04:00:00 PM,48,-122,40,33,73
11849,FremontBridge,02/08/2014 05:00:00 PM,48,-122,23,26,49
11850,FremontBridge,02/08/2014 06:00:00 PM,48,-122,14,20,34
11851,FremontBridge,02/08/2014 07:00:00 PM,48,-122,8,5,13
11852,FremontBridge,02/08/2014 08:00:00 PM,48,-122,14,5,19
11853,FremontBridge,02/08/2014 09:00:00 PM,48,-122,3,7,10
11854,FremontBridge,02/08/2014 10:00:00 PM,48,-122,6,2,8
11855,FremontBridge,02/08/2014 11:00:00 PM,48,-122,3,3,6
11856,FremontBridge,02/09/2014 12:00:00 AM,48,-122,4,1,5
11857,FremontBridge,02/09/2014 01:00:00 AM,48,-122,0,0,0
11858,FremontBridge,02/09/2014 02:00:00 AM,48,-122,2,2,4
11859,FremontBridge,02/09/2014 03:00:00 AM,48,-122,1,0,1
11860,FremontBridge,02/09/2014 04:00:00 AM,48,-122,0,0,0
11861,FremontBridge,02/09/2014 05:00:00 AM,48,-122,0,0,0
11862,FremontBridge,02/09/2014 06:00:00 AM,48,-122,1,2,3
11863,FremontBridge,02/09/2014 07:00:00 AM,48,-122,1,3,4
11864,FremontBridge,02/09/2014 08:00:00 AM,48,-122,4,5,9
11865,FremontBridge,02/09/2014 09:00:00 AM,48,-122,7,5,12
11866,FremontBridge,02/09/2014 10:00:00 AM,48,-122,10,11,21
11867,FremontBridge,02/09/2014 11:00:00 AM,48,-122,10,6,16
11868,FremontBridge,02/09/2014 12:00:00 PM,48,-122,9,9,18
11869,FremontBridge,02/09/2014 01:00:00 PM,48,-122,8,8,16
11870,FremontBridge,02/09/2014 02:00:00 PM,48,-122,7,10,17
11871,FremontBridge,02/09/2014 03:00:00 PM,48,-122,8,9,17
11872,FremontBridge,02/09/2014 04:00:00 PM,48,-122,10,9,19
11873,FremontBridge,02/09/2014 05:00:00 PM,48,-122,7,4,11
11874,FremontBridge,02/09/2014 06:00:00 PM,48,-122,8,4,12
11875,FremontBridge,02/09/2014 07:00:00 PM,48,-122,4,4,8
11876,FremontBridge,02/09/2014 08:00:00 PM,48,-122,0,5,5
11877,FremontBridge,02/09/2014 09:00:00 PM,48,-122,6,3,9
11878,FremontBridge,02/09/2014 10:00:00 PM,48,-122,7,0,7
11879,FremontBridge,02/09/2014 11:00:00 PM,48,-122,2,5,7
11880,FremontBridge,02/10/2014 12:00:00 AM,48,-122,2,3,5
11881,FremontBridge,02/10/2014 01:00:00 AM,48,-122,0,0,0
11882,FremontBridge,02/10/2014 02:00:00 AM,48,-122,1,0,1
11883,FremontBridge,02/10/2014 03:00:00 AM,48,-122,0,1,1
11884,FremontBridge,02/10/2014 04:00:00 AM,48,-122,1,2,3
11885,FremontBridge,02/10/2014 05:00:00 AM,48,-122,4,7,11
11886,FremontBridge,02/10/2014 06:00:00 AM,48,-122,16,37,53
11887,FremontBridge,02/10/2014 07:00:00 AM,48,-122,35,66,101
11888,FremontBridge,02/10/2014 08:00:00 AM,48,-122,47,133,180
11889,FremontBridge,02/10/2014 09:00:00 AM,48,-122,55,96,151
11890,FremontBridge,02/10/2014 10:00:00 AM,48,-122,22,31,53
11891,FremontBridge,02/10/2014 11:00:00 AM,48,-122,14,33,47
11892,FremontBridge,02/10/2014 12:00:00 PM,48,-122,22,27,49
11893,FremontBridge,02/10/2014 01:00:00 PM,48,-122,18,24,42
11894,FremontBridge,02/10/2014 02:00:00 PM,48,-122,20,15,35
11895,FremontBridge,02/10/2014 03:00:00 PM,48,-122,24,26,50
11896,FremontBridge,02/10/2014 04:00:00 PM,48,-122,58,42,100
11897,FremontBridge,02/10/2014 05:00:00 PM,48,-122,147,65,212
11898,FremontBridge,02/10/2014 06:00:00 PM,48,-122,112,53,165
11899,FremontBridge,02/10/2014 07:00:00 PM,48,-122,43,29,72
11900,FremontBridge,02/10/2014 08:00:00 PM,48,-122,30,14,44
11901,FremontBridge,02/10/2014 09:00:00 PM,48,-122,11,12,23
11902,FremontBridge,02/10/2014 10:00:00 PM,48,-122,11,3,14
11903,FremontBridge,02/10/2014 11:00:00 PM,48,-122,8,8,16
11904,FremontBridge,02/11/2014 12:00:00 AM,48,-122,5,2,7
11905,FremontBridge,02/11/2014 01:00:00 AM,48,-122,0,1,1
11906,FremontBridge,02/11/2014 02:00:00 AM,48,-122,0,1,1
11907,FremontBridge,02/11/2014 03:00:00 AM,48,-122,0,3,3
11908,FremontBridge,02/11/2014 04:00:00 AM,48,-122,1,1,2
11909,FremontBridge,02/11/2014 05:00:00 AM,48,-122,6,14,20
11910,FremontBridge,02/11/2014 06:00:00 AM,48,-122,30,55,85
11911,FremontBridge,02/11/2014 07:00:00 AM,48,-122,61,135,196
11912,FremontBridge,02/11/2014 08:00:00 AM,48,-122,79,225,304
11913,FremontBridge,02/11/2014 09:00:00 AM,48,-122,84,123,207
11914,FremontBridge,02/11/2014 10:00:00 AM,48,-122,31,58,89
11915,FremontBridge,02/11/2014 11:00:00 AM,48,-122,20,32,52
11916,FremontBridge,02/11/2014 12:00:00 PM,48,-122,36,20,56
11917,FremontBridge,02/11/2014 01:00:00 PM,48,-122,31,32,63
11918,FremontBridge,02/11/2014 02:00:00 PM,48,-122,32,36,68
11919,FremontBridge,02/11/2014 03:00:00 PM,48,-122,46,31,77
11920,FremontBridge,02/11/2014 04:00:00 PM,48,-122,74,45,119
11921,FremontBridge,02/11/2014 05:00:00 PM,48,-122,197,74,271
11922,FremontBridge,02/11/2014 06:00:00 PM,48,-122,137,75,212
11923,FremontBridge,02/11/2014 07:00:00 PM,48,-122,67,22,89
11924,FremontBridge,02/11/2014 08:00:00 PM,48,-122,29,24,53
11925,FremontBridge,02/11/2014 09:00:00 PM,48,-122,16,8,24
11926,FremontBridge,02/11/2014 10:00:00 PM,48,-122,8,8,16
11927,FremontBridge,02/11/2014 11:00:00 PM,48,-122,3,6,9
11928,FremontBridge,02/12/2014 12:00:00 AM,48,-122,6,2,8
11929,FremontBridge,02/12/2014 01:00:00 AM,48,-122,1,2,3
11930,FremontBridge,02/12/2014 02:00:00 AM,48,-122,0,1,1
11931,FremontBridge,02/12/2014 03:00:00 AM,48,-122,0,1,1
11932,FremontBridge,02/12/2014 04:00:00 AM,48,-122,2,5,7
11933,FremontBridge,02/12/2014 05:00:00 AM,48,-122,3,7,10
11934,FremontBridge,02/12/2014 06:00:00 AM,48,-122,20,46,66
11935,FremontBridge,02/12/2014 07:00:00 AM,48,-122,40,97,137
11936,FremontBridge,02/12/2014 08:00:00 AM,48,-122,85,182,267
11937,FremontBridge,02/12/2014 09:00:00 AM,48,-122,58,129,187
11938,FremontBridge,02/12/2014 10:00:00 AM,48,-122,41,44,85
11939,FremontBridge,02/12/2014 11:00:00 AM,48,-122,23,36,59
11940,FremontBridge,02/12/2014 12:00:00 PM,48,-122,29,40,69
11941,FremontBridge,02/12/2014 01:00:00 PM,48,-122,33,38,71
11942,FremontBridge,02/12/2014 02:00:00 PM,48,-122,29,28,57
11943,FremontBridge,02/12/2014 03:00:00 PM,48,-122,64,58,122
11944,FremontBridge,02/12/2014 04:00:00 PM,48,-122,96,60,156
11945,FremontBridge,02/12/2014 05:00:00 PM,48,-122,203,92,295
11946,FremontBridge,02/12/2014 06:00:00 PM,48,-122,192,83,275
11947,FremontBridge,02/12/2014 07:00:00 PM,48,-122,74,45,119
11948,FremontBridge,02/12/2014 08:00:00 PM,48,-122,34,25,59
11949,FremontBridge,02/12/2014 09:00:00 PM,48,-122,23,21,44
11950,FremontBridge,02/12/2014 10:00:00 PM,48,-122,15,7,22
11951,FremontBridge,02/12/2014 11:00:00 PM,48,-122,12,7,19
11952,FremontBridge,02/13/2014 12:00:00 AM,48,-122,3,4,7
11953,FremontBridge,02/13/2014 01:00:00 AM,48,-122,3,2,5
11954,FremontBridge,02/13/2014 02:00:00 AM,48,-122,2,0,2
11955,FremontBridge,02/13/2014 03:00:00 AM,48,-122,0,1,1
11956,FremontBridge,02/13/2014 04:00:00 AM,48,-122,1,1,2
11957,FremontBridge,02/13/2014 05:00:00 AM,48,-122,4,19,23
11958,FremontBridge,02/13/2014 06:00:00 AM,48,-122,34,57,91
11959,FremontBridge,02/13/2014 07:00:00 AM,48,-122,47,144,191
11960,FremontBridge,02/13/2014 08:00:00 AM,48,-122,94,227,321
11961,FremontBridge,02/13/2014 09:00:00 AM,48,-122,77,130,207
11962,FremontBridge,02/13/2014 10:00:00 AM,48,-122,33,57,90
11963,FremontBridge,02/13/2014 11:00:00 AM,48,-122,30,45,75
11964,FremontBridge,02/13/2014 12:00:00 PM,48,-122,22,41,63
11965,FremontBridge,02/13/2014 01:00:00 PM,48,-122,27,41,68
11966,FremontBridge,02/13/2014 02:00:00 PM,48,-122,36,25,61
11967,FremontBridge,02/13/2014 03:00:00 PM,48,-122,55,44,99
11968,FremontBridge,02/13/2014 04:00:00 PM,48,-122,102,72,174
11969,FremontBridge,02/13/2014 05:00:00 PM,48,-122,230,110,340
11970,FremontBridge,02/13/2014 06:00:00 PM,48,-122,193,95,288
11971,FremontBridge,02/13/2014 07:00:00 PM,48,-122,68,44,112
11972,FremontBridge,02/13/2014 08:00:00 PM,48,-122,44,24,68
11973,FremontBridge,02/13/2014 09:00:00 PM,48,-122,33,11,44
11974,FremontBridge,02/13/2014 10:00:00 PM,48,-122,21,12,33
11975,FremontBridge,02/13/2014 11:00:00 PM,48,-122,19,5,24
11976,FremontBridge,02/14/2014 12:00:00 AM,48,-122,7,4,11
11977,FremontBridge,02/14/2014 01:00:00 AM,48,-122,6,0,6
11978,FremontBridge,02/14/2014 02:00:00 AM,48,-122,2,1,3
11979,FremontBridge,02/14/2014 03:00:00 AM,48,-122,1,2,3
11980,FremontBridge,02/14/2014 04:00:00 AM,48,-122,3,2,5
11981,FremontBridge,02/14/2014 05:00:00 AM,48,-122,3,5,8
11982,FremontBridge,02/14/2014 06:00:00 AM,48,-122,17,45,62
11983,FremontBridge,02/14/2014 07:00:00 AM,48,-122,46,109,155
11984,FremontBridge,02/14/2014 08:00:00 AM,48,-122,75,169,244
11985,FremontBridge,02/14/2014 09:00:00 AM,48,-122,55,100,155
11986,FremontBridge,02/14/2014 10:00:00 AM,48,-122,25,30,55
11987,FremontBridge,02/14/2014 11:00:00 AM,48,-122,16,21,37
11988,FremontBridge,02/14/2014 12:00:00 PM,48,-122,15,28,43
11989,FremontBridge,02/14/2014 01:00:00 PM,48,-122,18,30,48
11990,FremontBridge,02/14/2014 02:00:00 PM,48,-122,31,26,57
11991,FremontBridge,02/14/2014 03:00:00 PM,48,-122,49,53,102
11992,FremontBridge,02/14/2014 04:00:00 PM,48,-122,86,52,138
11993,FremontBridge,02/14/2014 05:00:00 PM,48,-122,182,84,266
11994,FremontBridge,02/14/2014 06:00:00 PM,48,-122,131,68,199
11995,FremontBridge,02/14/2014 07:00:00 PM,48,-122,51,28,79
11996,FremontBridge,02/14/2014 08:00:00 PM,48,-122,27,16,43
11997,FremontBridge,02/14/2014 09:00:00 PM,48,-122,13,14,27
11998,FremontBridge,02/14/2014 10:00:00 PM,48,-122,13,11,24
11999,FremontBridge,02/14/2014 11:00:00 PM,48,-122,8,8,16
12000,FremontBridge,02/15/2014 12:00:00 AM,48,-122,15,4,19
12001,FremontBridge,02/15/2014 01:00:00 AM,48,-122,2,3,5
12002,FremontBridge,02/15/2014 02:00:00 AM,48,-122,4,3,7
12003,FremontBridge,02/15/2014 03:00:00 AM,48,-122,2,0,2
12004,FremontBridge,02/15/2014 04:00:00 AM,48,-122,5,1,6
12005,FremontBridge,02/15/2014 05:00:00 AM,48,-122,1,1,2
12006,FremontBridge,02/15/2014 06:00:00 AM,48,-122,7,9,16
12007,FremontBridge,02/15/2014 07:00:00 AM,48,-122,7,6,13
12008,FremontBridge,02/15/2014 08:00:00 AM,48,-122,18,29,47
12009,FremontBridge,02/15/2014 09:00:00 AM,48,-122,31,36,67
12010,FremontBridge,02/15/2014 10:00:00 AM,48,-122,24,38,62
12011,FremontBridge,02/15/2014 11:00:00 AM,48,-122,33,41,74
12012,FremontBridge,02/15/2014 12:00:00 PM,48,-122,37,47,84
12013,FremontBridge,02/15/2014 01:00:00 PM,48,-122,29,39,68
12014,FremontBridge,02/15/2014 02:00:00 PM,48,-122,13,19,32
12015,FremontBridge,02/15/2014 03:00:00 PM,48,-122,13,10,23
12016,FremontBridge,02/15/2014 04:00:00 PM,48,-122,16,20,36
12017,FremontBridge,02/15/2014 05:00:00 PM,48,-122,6,10,16
12018,FremontBridge,02/15/2014 06:00:00 PM,48,-122,8,11,19
12019,FremontBridge,02/15/2014 07:00:00 PM,48,-122,8,9,17
12020,FremontBridge,02/15/2014 08:00:00 PM,48,-122,4,11,15
12021,FremontBridge,02/15/2014 09:00:00 PM,48,-122,5,3,8
12022,FremontBridge,02/15/2014 10:00:00 PM,48,-122,2,7,9
12023,FremontBridge,02/15/2014 11:00:00 PM,48,-122,4,7,11
12024,FremontBridge,02/16/2014 12:00:00 AM,48,-122,5,10,15
12025,FremontBridge,02/16/2014 01:00:00 AM,48,-122,0,2,2
12026,FremontBridge,02/16/2014 02:00:00 AM,48,-122,0,2,2
12027,FremontBridge,02/16/2014 03:00:00 AM,48,-122,2,0,2
12028,FremontBridge,02/16/2014 04:00:00 AM,48,-122,1,2,3
12029,FremontBridge,02/16/2014 05:00:00 AM,48,-122,1,0,1
12030,FremontBridge,02/16/2014 06:00:00 AM,48,-122,4,5,9
12031,FremontBridge,02/16/2014 07:00:00 AM,48,-122,1,2,3
12032,FremontBridge,02/16/2014 08:00:00 AM,48,-122,12,12,24
12033,FremontBridge,02/16/2014 09:00:00 AM,48,-122,20,38,58
12034,FremontBridge,02/16/2014 10:00:00 AM,48,-122,25,37,62
12035,FremontBridge,02/16/2014 11:00:00 AM,48,-122,27,31,58
12036,FremontBridge,02/16/2014 12:00:00 PM,48,-122,27,19,46
12037,FremontBridge,02/16/2014 01:00:00 PM,48,-122,16,24,40
12038,FremontBridge,02/16/2014 02:00:00 PM,48,-122,14,27,41
12039,FremontBridge,02/16/2014 03:00:00 PM,48,-122,12,23,35
12040,FremontBridge,02/16/2014 04:00:00 PM,48,-122,12,12,24
12041,FremontBridge,02/16/2014 05:00:00 PM,48,-122,6,6,12
12042,FremontBridge,02/16/2014 06:00:00 PM,48,-122,4,8,12
12043,FremontBridge,02/16/2014 07:00:00 PM,48,-122,8,3,11
12044,FremontBridge,02/16/2014 08:00:00 PM,48,-122,6,6,12
12045,FremontBridge,02/16/2014 09:00:00 PM,48,-122,3,3,6
12046,FremontBridge,02/16/2014 10:00:00 PM,48,-122,2,0,2
12047,FremontBridge,02/16/2014 11:00:00 PM,48,-122,3,2,5
12048,FremontBridge,02/17/2014 12:00:00 AM,48,-122,2,2,4
12049,FremontBridge,02/17/2014 01:00:00 AM,48,-122,0,0,0
12050,FremontBridge,02/17/2014 02:00:00 AM,48,-122,1,1,2
12051,FremontBridge,02/17/2014 03:00:00 AM,48,-122,0,2,2
12052,FremontBridge,02/17/2014 04:00:00 AM,48,-122,1,1,2
12053,FremontBridge,02/17/2014 05:00:00 AM,48,-122,1,3,4
12054,FremontBridge,02/17/2014 06:00:00 AM,48,-122,17,8,25
12055,FremontBridge,02/17/2014 07:00:00 AM,48,-122,23,29,52
12056,FremontBridge,02/17/2014 08:00:00 AM,48,-122,25,68,93
12057,FremontBridge,02/17/2014 09:00:00 AM,48,-122,40,47,87
12058,FremontBridge,02/17/2014 10:00:00 AM,48,-122,21,19,40
12059,FremontBridge,02/17/2014 11:00:00 AM,48,-122,12,29,41
12060,FremontBridge,02/17/2014 12:00:00 PM,48,-122,17,21,38
12061,FremontBridge,02/17/2014 01:00:00 PM,48,-122,18,27,45
12062,FremontBridge,02/17/2014 02:00:00 PM,48,-122,34,34,68
12063,FremontBridge,02/17/2014 03:00:00 PM,48,-122,28,31,59
12064,FremontBridge,02/17/2014 04:00:00 PM,48,-122,57,47,104
12065,FremontBridge,02/17/2014 05:00:00 PM,48,-122,86,33,119
12066,FremontBridge,02/17/2014 06:00:00 PM,48,-122,77,36,113
12067,FremontBridge,02/17/2014 07:00:00 PM,48,-122,35,19,54
12068,FremontBridge,02/17/2014 08:00:00 PM,48,-122,9,14,23
12069,FremontBridge,02/17/2014 09:00:00 PM,48,-122,17,11,28
12070,FremontBridge,02/17/2014 10:00:00 PM,48,-122,8,7,15
12071,FremontBridge,02/17/2014 11:00:00 PM,48,-122,4,6,10
12072,FremontBridge,02/18/2014 12:00:00 AM,48,-122,3,1,4
12073,FremontBridge,02/18/2014 01:00:00 AM,48,-122,0,0,0
12074,FremontBridge,02/18/2014 02:00:00 AM,48,-122,2,2,4
12075,FremontBridge,02/18/2014 03:00:00 AM,48,-122,1,0,1
12076,FremontBridge,02/18/2014 04:00:00 AM,48,-122,2,2,4
12077,FremontBridge,02/18/2014 05:00:00 AM,48,-122,2,8,10
12078,FremontBridge,02/18/2014 06:00:00 AM,48,-122,23,44,67
12079,FremontBridge,02/18/2014 07:00:00 AM,48,-122,46,94,140
12080,FremontBridge,02/18/2014 08:00:00 AM,48,-122,63,166,229
12081,FremontBridge,02/18/2014 09:00:00 AM,48,-122,56,98,154
12082,FremontBridge,02/18/2014 10:00:00 AM,48,-122,14,32,46
12083,FremontBridge,02/18/2014 11:00:00 AM,48,-122,11,9,20
12084,FremontBridge,02/18/2014 12:00:00 PM,48,-122,14,11,25
12085,FremontBridge,02/18/2014 01:00:00 PM,48,-122,6,13,19
12086,FremontBridge,02/18/2014 02:00:00 PM,48,-122,13,14,27
12087,FremontBridge,02/18/2014 03:00:00 PM,48,-122,37,15,52
12088,FremontBridge,02/18/2014 04:00:00 PM,48,-122,59,32,91
12089,FremontBridge,02/18/2014 05:00:00 PM,48,-122,166,80,246
12090,FremontBridge,02/18/2014 06:00:00 PM,48,-122,150,65,215
12091,FremontBridge,02/18/2014 07:00:00 PM,48,-122,50,24,74
12092,FremontBridge,02/18/2014 08:00:00 PM,48,-122,22,14,36
12093,FremontBridge,02/18/2014 09:00:00 PM,48,-122,15,10,25
12094,FremontBridge,02/18/2014 10:00:00 PM,48,-122,16,9,25
12095,FremontBridge,02/18/2014 11:00:00 PM,48,-122,5,6,11
12096,FremontBridge,02/19/2014 12:00:00 AM,48,-122,3,2,5
12097,FremontBridge,02/19/2014 01:00:00 AM,48,-122,0,1,1
12098,FremontBridge,02/19/2014 02:00:00 AM,48,-122,1,1,2
12099,FremontBridge,02/19/2014 03:00:00 AM,48,-122,0,2,2
12100,FremontBridge,02/19/2014 04:00:00 AM,48,-122,0,2,2
12101,FremontBridge,02/19/2014 05:00:00 AM,48,-122,7,11,18
12102,FremontBridge,02/19/2014 06:00:00 AM,48,-122,21,48,69
12103,FremontBridge,02/19/2014 07:00:00 AM,48,-122,38,132,170
12104,FremontBridge,02/19/2014 08:00:00 AM,48,-122,84,189,273
12105,FremontBridge,02/19/2014 09:00:00 AM,48,-122,73,132,205
12106,FremontBridge,02/19/2014 10:00:00 AM,48,-122,43,47,90
12107,FremontBridge,02/19/2014 11:00:00 AM,48,-122,19,33,52
12108,FremontBridge,02/19/2014 12:00:00 PM,48,-122,31,37,68
12109,FremontBridge,02/19/2014 01:00:00 PM,48,-122,37,44,81
12110,FremontBridge,02/19/2014 02:00:00 PM,48,-122,30,29,59
12111,FremontBridge,02/19/2014 03:00:00 PM,48,-122,60,45,105
12112,FremontBridge,02/19/2014 04:00:00 PM,48,-122,94,63,157
12113,FremontBridge,02/19/2014 05:00:00 PM,48,-122,220,89,309
12114,FremontBridge,02/19/2014 06:00:00 PM,48,-122,146,76,222
12115,FremontBridge,02/19/2014 07:00:00 PM,48,-122,83,46,129
12116,FremontBridge,02/19/2014 08:00:00 PM,48,-122,41,29,70
12117,FremontBridge,02/19/2014 09:00:00 PM,48,-122,20,16,36
12118,FremontBridge,02/19/2014 10:00:00 PM,48,-122,18,14,32
12119,FremontBridge,02/19/2014 11:00:00 PM,48,-122,6,4,10
12120,FremontBridge,02/20/2014 12:00:00 AM,48,-122,0,2,2
12121,FremontBridge,02/20/2014 01:00:00 AM,48,-122,3,1,4
12122,FremontBridge,02/20/2014 02:00:00 AM,48,-122,0,2,2
12123,FremontBridge,02/20/2014 03:00:00 AM,48,-122,0,1,1
12124,FremontBridge,02/20/2014 04:00:00 AM,48,-122,2,3,5
12125,FremontBridge,02/20/2014 05:00:00 AM,48,-122,3,11,14
12126,FremontBridge,02/20/2014 06:00:00 AM,48,-122,24,45,69
12127,FremontBridge,02/20/2014 07:00:00 AM,48,-122,51,133,184
12128,FremontBridge,02/20/2014 08:00:00 AM,48,-122,110,188,298
12129,FremontBridge,02/20/2014 09:00:00 AM,48,-122,74,113,187
12130,FremontBridge,02/20/2014 10:00:00 AM,48,-122,34,51,85
12131,FremontBridge,02/20/2014 11:00:00 AM,48,-122,23,24,47
12132,FremontBridge,02/20/2014 12:00:00 PM,48,-122,24,31,55
12133,FremontBridge,02/20/2014 01:00:00 PM,48,-122,32,47,79
12134,FremontBridge,02/20/2014 02:00:00 PM,48,-122,33,43,76
12135,FremontBridge,02/20/2014 03:00:00 PM,48,-122,50,53,103
12136,FremontBridge,02/20/2014 04:00:00 PM,48,-122,110,67,177
12137,FremontBridge,02/20/2014 05:00:00 PM,48,-122,205,100,305
12138,FremontBridge,02/20/2014 06:00:00 PM,48,-122,145,88,233
12139,FremontBridge,02/20/2014 07:00:00 PM,48,-122,80,52,132
12140,FremontBridge,02/20/2014 08:00:00 PM,48,-122,34,21,55
12141,FremontBridge,02/20/2014 09:00:00 PM,48,-122,30,21,51
12142,FremontBridge,02/20/2014 10:00:00 PM,48,-122,13,15,28
12143,FremontBridge,02/20/2014 11:00:00 PM,48,-122,14,8,22
12144,FremontBridge,02/21/2014 12:00:00 AM,48,-122,6,4,10
12145,FremontBridge,02/21/2014 01:00:00 AM,48,-122,2,3,5
12146,FremontBridge,02/21/2014 02:00:00 AM,48,-122,1,1,2
12147,FremontBridge,02/21/2014 03:00:00 AM,48,-122,2,1,3
12148,FremontBridge,02/21/2014 04:00:00 AM,48,-122,3,2,5
12149,FremontBridge,02/21/2014 05:00:00 AM,48,-122,5,9,14
12150,FremontBridge,02/21/2014 06:00:00 AM,48,-122,19,45,64
12151,FremontBridge,02/21/2014 07:00:00 AM,48,-122,53,122,175
12152,FremontBridge,02/21/2014 08:00:00 AM,48,-122,85,190,275
12153,FremontBridge,02/21/2014 09:00:00 AM,48,-122,68,111,179
12154,FremontBridge,02/21/2014 10:00:00 AM,48,-122,35,49,84
12155,FremontBridge,02/21/2014 11:00:00 AM,48,-122,26,27,53
12156,FremontBridge,02/21/2014 12:00:00 PM,48,-122,24,27,51
12157,FremontBridge,02/21/2014 01:00:00 PM,48,-122,34,27,61
12158,FremontBridge,02/21/2014 02:00:00 PM,48,-122,27,22,49
12159,FremontBridge,02/21/2014 03:00:00 PM,48,-122,46,35,81
12160,FremontBridge,02/21/2014 04:00:00 PM,48,-122,88,45,133
12161,FremontBridge,02/21/2014 05:00:00 PM,48,-122,178,84,262
12162,FremontBridge,02/21/2014 06:00:00 PM,48,-122,128,59,187
12163,FremontBridge,02/21/2014 07:00:00 PM,48,-122,72,31,103
12164,FremontBridge,02/21/2014 08:00:00 PM,48,-122,24,9,33
12165,FremontBridge,02/21/2014 09:00:00 PM,48,-122,13,2,15
12166,FremontBridge,02/21/2014 10:00:00 PM,48,-122,9,15,24
12167,FremontBridge,02/21/2014 11:00:00 PM,48,-122,12,9,21
12168,FremontBridge,02/22/2014 12:00:00 AM,48,-122,3,7,10
12169,FremontBridge,02/22/2014 01:00:00 AM,48,-122,6,7,13
12170,FremontBridge,02/22/2014 02:00:00 AM,48,-122,2,4,6
12171,FremontBridge,02/22/2014 03:00:00 AM,48,-122,2,3,5
12172,FremontBridge,02/22/2014 04:00:00 AM,48,-122,1,0,1
12173,FremontBridge,02/22/2014 05:00:00 AM,48,-122,1,2,3
12174,FremontBridge,02/22/2014 06:00:00 AM,48,-122,6,9,15
12175,FremontBridge,02/22/2014 07:00:00 AM,48,-122,9,8,17
12176,FremontBridge,02/22/2014 08:00:00 AM,48,-122,15,24,39
12177,FremontBridge,02/22/2014 09:00:00 AM,48,-122,24,17,41
12178,FremontBridge,02/22/2014 10:00:00 AM,48,-122,9,23,32
12179,FremontBridge,02/22/2014 11:00:00 AM,48,-122,13,29,42
12180,FremontBridge,02/22/2014 12:00:00 PM,48,-122,18,16,34
12181,FremontBridge,02/22/2014 01:00:00 PM,48,-122,16,25,41
12182,FremontBridge,02/22/2014 02:00:00 PM,48,-122,18,29,47
12183,FremontBridge,02/22/2014 03:00:00 PM,48,-122,27,30,57
12184,FremontBridge,02/22/2014 04:00:00 PM,48,-122,27,32,59
12185,FremontBridge,02/22/2014 05:00:00 PM,48,-122,19,18,37
12186,FremontBridge,02/22/2014 06:00:00 PM,48,-122,16,20,36
12187,FremontBridge,02/22/2014 07:00:00 PM,48,-122,10,8,18
12188,FremontBridge,02/22/2014 08:00:00 PM,48,-122,11,3,14
12189,FremontBridge,02/22/2014 09:00:00 PM,48,-122,11,8,19
12190,FremontBridge,02/22/2014 10:00:00 PM,48,-122,9,13,22
12191,FremontBridge,02/22/2014 11:00:00 PM,48,-122,8,8,16
12192,FremontBridge,02/23/2014 12:00:00 AM,48,-122,6,3,9
12193,FremontBridge,02/23/2014 01:00:00 AM,48,-122,1,4,5
12194,FremontBridge,02/23/2014 02:00:00 AM,48,-122,6,2,8
12195,FremontBridge,02/23/2014 03:00:00 AM,48,-122,2,0,2
12196,FremontBridge,02/23/2014 04:00:00 AM,48,-122,1,1,2
12197,FremontBridge,02/23/2014 05:00:00 AM,48,-122,2,2,4
12198,FremontBridge,02/23/2014 06:00:00 AM,48,-122,5,14,19
12199,FremontBridge,02/23/2014 07:00:00 AM,48,-122,5,39,44
12200,FremontBridge,02/23/2014 08:00:00 AM,48,-122,13,42,55
12201,FremontBridge,02/23/2014 09:00:00 AM,48,-122,16,32,48
12202,FremontBridge,02/23/2014 10:00:00 AM,48,-122,25,42,67
12203,FremontBridge,02/23/2014 11:00:00 AM,48,-122,18,24,42
12204,FremontBridge,02/23/2014 12:00:00 PM,48,-122,35,38,73
12205,FremontBridge,02/23/2014 01:00:00 PM,48,-122,41,24,65
12206,FremontBridge,02/23/2014 02:00:00 PM,48,-122,40,29,69
12207,FremontBridge,02/23/2014 03:00:00 PM,48,-122,22,21,43
12208,FremontBridge,02/23/2014 04:00:00 PM,48,-122,21,10,31
12209,FremontBridge,02/23/2014 05:00:00 PM,48,-122,12,16,28
12210,FremontBridge,02/23/2014 06:00:00 PM,48,-122,5,5,10
12211,FremontBridge,02/23/2014 07:00:00 PM,48,-122,6,7,13
12212,FremontBridge,02/23/2014 08:00:00 PM,48,-122,9,8,17
12213,FremontBridge,02/23/2014 09:00:00 PM,48,-122,7,5,12
12214,FremontBridge,02/23/2014 10:00:00 PM,48,-122,6,6,12
12215,FremontBridge,02/23/2014 11:00:00 PM,48,-122,6,7,13
12216,FremontBridge,02/24/2014 12:00:00 AM,48,-122,2,2,4
12217,FremontBridge,02/24/2014 01:00:00 AM,48,-122,0,0,0
12218,FremontBridge,02/24/2014 02:00:00 AM,48,-122,1,0,1
12219,FremontBridge,02/24/2014 03:00:00 AM,48,-122,0,1,1
12220,FremontBridge,02/24/2014 04:00:00 AM,48,-122,1,2,3
12221,FremontBridge,02/24/2014 05:00:00 AM,48,-122,3,14,17
12222,FremontBridge,02/24/2014 06:00:00 AM,48,-122,27,45,72
12223,FremontBridge,02/24/2014 07:00:00 AM,48,-122,40,120,160
12224,FremontBridge,02/24/2014 08:00:00 AM,48,-122,57,183,240
12225,FremontBridge,02/24/2014 09:00:00 AM,48,-122,60,86,146
12226,FremontBridge,02/24/2014 10:00:00 AM,48,-122,21,23,44
12227,FremontBridge,02/24/2014 11:00:00 AM,48,-122,9,19,28
12228,FremontBridge,02/24/2014 12:00:00 PM,48,-122,9,10,19
12229,FremontBridge,02/24/2014 01:00:00 PM,48,-122,9,16,25
12230,FremontBridge,02/24/2014 02:00:00 PM,48,-122,17,15,32
12231,FremontBridge,02/24/2014 03:00:00 PM,48,-122,27,26,53
12232,FremontBridge,02/24/2014 04:00:00 PM,48,-122,64,31,95
12233,FremontBridge,02/24/2014 05:00:00 PM,48,-122,170,72,242
12234,FremontBridge,02/24/2014 06:00:00 PM,48,-122,124,67,191
12235,FremontBridge,02/24/2014 07:00:00 PM,48,-122,58,32,90
12236,FremontBridge,02/24/2014 08:00:00 PM,48,-122,28,15,43
12237,FremontBridge,02/24/2014 09:00:00 PM,48,-122,9,10,19
12238,FremontBridge,02/24/2014 10:00:00 PM,48,-122,11,11,22
12239,FremontBridge,02/24/2014 11:00:00 PM,48,-122,6,4,10
12240,FremontBridge,02/25/2014 12:00:00 AM,48,-122,2,4,6
12241,FremontBridge,02/25/2014 01:00:00 AM,48,-122,0,0,0
12242,FremontBridge,02/25/2014 02:00:00 AM,48,-122,0,2,2
12243,FremontBridge,02/25/2014 03:00:00 AM,48,-122,0,1,1
12244,FremontBridge,02/25/2014 04:00:00 AM,48,-122,1,1,2
12245,FremontBridge,02/25/2014 05:00:00 AM,48,-122,5,19,24
12246,FremontBridge,02/25/2014 06:00:00 AM,48,-122,27,46,73
12247,FremontBridge,02/25/2014 07:00:00 AM,48,-122,62,167,229
12248,FremontBridge,02/25/2014 08:00:00 AM,48,-122,111,256,367
12249,FremontBridge,02/25/2014 09:00:00 AM,48,-122,77,139,216
12250,FremontBridge,02/25/2014 10:00:00 AM,48,-122,28,59,87
12251,FremontBridge,02/25/2014 11:00:00 AM,48,-122,32,19,51
12252,FremontBridge,02/25/2014 12:00:00 PM,48,-122,29,37,66
12253,FremontBridge,02/25/2014 01:00:00 PM,48,-122,30,32,62
12254,FremontBridge,02/25/2014 02:00:00 PM,48,-122,40,32,72
12255,FremontBridge,02/25/2014 03:00:00 PM,48,-122,64,64,128
12256,FremontBridge,02/25/2014 04:00:00 PM,48,-122,101,75,176
12257,FremontBridge,02/25/2014 05:00:00 PM,48,-122,262,134,396
12258,FremontBridge,02/25/2014 06:00:00 PM,48,-122,198,115,313
12259,FremontBridge,02/25/2014 07:00:00 PM,48,-122,79,56,135
12260,FremontBridge,02/25/2014 08:00:00 PM,48,-122,41,27,68
12261,FremontBridge,02/25/2014 09:00:00 PM,48,-122,21,22,43
12262,FremontBridge,02/25/2014 10:00:00 PM,48,-122,21,9,30
12263,FremontBridge,02/25/2014 11:00:00 PM,48,-122,11,5,16
12264,FremontBridge,02/26/2014 12:00:00 AM,48,-122,3,2,5
12265,FremontBridge,02/26/2014 01:00:00 AM,48,-122,0,1,1
12266,FremontBridge,02/26/2014 02:00:00 AM,48,-122,4,2,6
12267,FremontBridge,02/26/2014 03:00:00 AM,48,-122,2,1,3
12268,FremontBridge,02/26/2014 04:00:00 AM,48,-122,1,3,4
12269,FremontBridge,02/26/2014 05:00:00 AM,48,-122,6,11,17
12270,FremontBridge,02/26/2014 06:00:00 AM,48,-122,21,58,79
12271,FremontBridge,02/26/2014 07:00:00 AM,48,-122,66,184,250
12272,FremontBridge,02/26/2014 08:00:00 AM,48,-122,124,251,375
12273,FremontBridge,02/26/2014 09:00:00 AM,48,-122,104,159,263
12274,FremontBridge,02/26/2014 10:00:00 AM,48,-122,32,58,90
12275,FremontBridge,02/26/2014 11:00:00 AM,48,-122,34,43,77
12276,FremontBridge,02/26/2014 12:00:00 PM,48,-122,48,62,110
12277,FremontBridge,02/26/2014 01:00:00 PM,48,-122,53,47,100
12278,FremontBridge,02/26/2014 02:00:00 PM,48,-122,47,51,98
12279,FremontBridge,02/26/2014 03:00:00 PM,48,-122,60,80,140
12280,FremontBridge,02/26/2014 04:00:00 PM,48,-122,124,99,223
12281,FremontBridge,02/26/2014 05:00:00 PM,48,-122,294,157,451
12282,FremontBridge,02/26/2014 06:00:00 PM,48,-122,204,115,319
12283,FremontBridge,02/26/2014 07:00:00 PM,48,-122,101,52,153
12284,FremontBridge,02/26/2014 08:00:00 PM,48,-122,57,26,83
12285,FremontBridge,02/26/2014 09:00:00 PM,48,-122,31,18,49
12286,FremontBridge,02/26/2014 10:00:00 PM,48,-122,18,22,40
12287,FremontBridge,02/26/2014 11:00:00 PM,48,-122,16,8,24
12288,FremontBridge,02/27/2014 12:00:00 AM,48,-122,4,7,11
12289,FremontBridge,02/27/2014 01:00:00 AM,48,-122,4,1,5
12290,FremontBridge,02/27/2014 02:00:00 AM,48,-122,1,0,1
12291,FremontBridge,02/27/2014 03:00:00 AM,48,-122,0,3,3
12292,FremontBridge,02/27/2014 04:00:00 AM,48,-122,1,2,3
12293,FremontBridge,02/27/2014 05:00:00 AM,48,-122,5,21,26
12294,FremontBridge,02/27/2014 06:00:00 AM,48,-122,24,67,91
12295,FremontBridge,02/27/2014 07:00:00 AM,48,-122,61,170,231
12296,FremontBridge,02/27/2014 08:00:00 AM,48,-122,101,246,347
12297,FremontBridge,02/27/2014 09:00:00 AM,48,-122,79,137,216
12298,FremontBridge,02/27/2014 10:00:00 AM,48,-122,42,71,113
12299,FremontBridge,02/27/2014 11:00:00 AM,48,-122,37,39,76
12300,FremontBridge,02/27/2014 12:00:00 PM,48,-122,30,60,90
12301,FremontBridge,02/27/2014 01:00:00 PM,48,-122,36,55,91
12302,FremontBridge,02/27/2014 02:00:00 PM,48,-122,44,41,85
12303,FremontBridge,02/27/2014 03:00:00 PM,48,-122,70,57,127
12304,FremontBridge,02/27/2014 04:00:00 PM,48,-122,102,98,200
12305,FremontBridge,02/27/2014 05:00:00 PM,48,-122,237,118,355
12306,FremontBridge,02/27/2014 06:00:00 PM,48,-122,198,102,300
12307,FremontBridge,02/27/2014 07:00:00 PM,48,-122,92,52,144
12308,FremontBridge,02/27/2014 08:00:00 PM,48,-122,47,28,75
12309,FremontBridge,02/27/2014 09:00:00 PM,48,-122,29,27,56
12310,FremontBridge,02/27/2014 10:00:00 PM,48,-122,19,12,31
12311,FremontBridge,02/27/2014 11:00:00 PM,48,-122,14,30,44
12312,FremontBridge,02/28/2014 12:00:00 AM,48,-122,8,13,21
12313,FremontBridge,02/28/2014 01:00:00 AM,48,-122,3,2,5
12314,FremontBridge,02/28/2014 02:00:00 AM,48,-122,3,4,7
12315,FremontBridge,02/28/2014 03:00:00 AM,48,-122,1,0,1
12316,FremontBridge,02/28/2014 04:00:00 AM,48,-122,1,6,7
12317,FremontBridge,02/28/2014 05:00:00 AM,48,-122,1,15,16
12318,FremontBridge,02/28/2014 06:00:00 AM,48,-122,31,47,78
12319,FremontBridge,02/28/2014 07:00:00 AM,48,-122,49,138,187
12320,FremontBridge,02/28/2014 08:00:00 AM,48,-122,96,258,354
12321,FremontBridge,02/28/2014 09:00:00 AM,48,-122,89,156,245
12322,FremontBridge,02/28/2014 10:00:00 AM,48,-122,53,60,113
12323,FremontBridge,02/28/2014 11:00:00 AM,48,-122,39,62,101
12324,FremontBridge,02/28/2014 12:00:00 PM,48,-122,55,54,109
12325,FremontBridge,02/28/2014 01:00:00 PM,48,-122,50,51,101
12326,FremontBridge,02/28/2014 02:00:00 PM,48,-122,59,60,119
12327,FremontBridge,02/28/2014 03:00:00 PM,48,-122,70,79,149
12328,FremontBridge,02/28/2014 04:00:00 PM,48,-122,133,104,237
12329,FremontBridge,02/28/2014 05:00:00 PM,48,-122,252,143,395
12330,FremontBridge,02/28/2014 06:00:00 PM,48,-122,203,111,314
12331,FremontBridge,02/28/2014 07:00:00 PM,48,-122,63,45,108
12332,FremontBridge,02/28/2014 08:00:00 PM,48,-122,47,18,65
12333,FremontBridge,02/28/2014 09:00:00 PM,48,-122,20,15,35
12334,FremontBridge,02/28/2014 10:00:00 PM,48,-122,17,17,34
12335,FremontBridge,02/28/2014 11:00:00 PM,48,-122,18,10,28
12336,FremontBridge,03/01/2014 12:00:00 AM,48,-122,11,10,21
12337,FremontBridge,03/01/2014 01:00:00 AM,48,-122,4,2,6
12338,FremontBridge,03/01/2014 02:00:00 AM,48,-122,2,0,2
12339,FremontBridge,03/01/2014 03:00:00 AM,48,-122,1,0,1
12340,FremontBridge,03/01/2014 04:00:00 AM,48,-122,0,1,1
12341,FremontBridge,03/01/2014 05:00:00 AM,48,-122,0,3,3
12342,FremontBridge,03/01/2014 06:00:00 AM,48,-122,9,4,13
12343,FremontBridge,03/01/2014 07:00:00 AM,48,-122,3,13,16
12344,FremontBridge,03/01/2014 08:00:00 AM,48,-122,24,34,58
12345,FremontBridge,03/01/2014 09:00:00 AM,48,-122,30,56,86
12346,FremontBridge,03/01/2014 10:00:00 AM,48,-122,26,85,111
12347,FremontBridge,03/01/2014 11:00:00 AM,48,-122,31,83,114
12348,FremontBridge,03/01/2014 12:00:00 PM,48,-122,40,59,99
12349,FremontBridge,03/01/2014 01:00:00 PM,48,-122,13,44,57
12350,FremontBridge,03/01/2014 02:00:00 PM,48,-122,40,43,83
12351,FremontBridge,03/01/2014 03:00:00 PM,48,-122,22,34,56
12352,FremontBridge,03/01/2014 04:00:00 PM,48,-122,37,35,72
12353,FremontBridge,03/01/2014 05:00:00 PM,48,-122,15,26,41
12354,FremontBridge,03/01/2014 06:00:00 PM,48,-122,22,21,43
12355,FremontBridge,03/01/2014 07:00:00 PM,48,-122,25,7,32
12356,FremontBridge,03/01/2014 08:00:00 PM,48,-122,20,3,23
12357,FremontBridge,03/01/2014 09:00:00 PM,48,-122,14,3,17
12358,FremontBridge,03/01/2014 10:00:00 PM,48,-122,9,10,19
12359,FremontBridge,03/01/2014 11:00:00 PM,48,-122,3,12,15
12360,FremontBridge,03/02/2014 12:00:00 AM,48,-122,3,5,8
12361,FremontBridge,03/02/2014 01:00:00 AM,48,-122,1,1,2
12362,FremontBridge,03/02/2014 02:00:00 AM,48,-122,4,1,5
12363,FremontBridge,03/02/2014 03:00:00 AM,48,-122,2,1,3
12364,FremontBridge,03/02/2014 04:00:00 AM,48,-122,0,1,1
12365,FremontBridge,03/02/2014 05:00:00 AM,48,-122,1,2,3
12366,FremontBridge,03/02/2014 06:00:00 AM,48,-122,5,7,12
12367,FremontBridge,03/02/2014 07:00:00 AM,48,-122,5,3,8
12368,FremontBridge,03/02/2014 08:00:00 AM,48,-122,10,9,19
12369,FremontBridge,03/02/2014 09:00:00 AM,48,-122,25,29,54
12370,FremontBridge,03/02/2014 10:00:00 AM,48,-122,16,41,57
12371,FremontBridge,03/02/2014 11:00:00 AM,48,-122,14,27,41
12372,FremontBridge,03/02/2014 12:00:00 PM,48,-122,8,26,34
12373,FremontBridge,03/02/2014 01:00:00 PM,48,-122,22,6,28
12374,FremontBridge,03/02/2014 02:00:00 PM,48,-122,4,19,23
12375,FremontBridge,03/02/2014 03:00:00 PM,48,-122,14,20,34
12376,FremontBridge,03/02/2014 04:00:00 PM,48,-122,17,16,33
12377,FremontBridge,03/02/2014 05:00:00 PM,48,-122,11,11,22
12378,FremontBridge,03/02/2014 06:00:00 PM,48,-122,7,6,13
12379,FremontBridge,03/02/2014 07:00:00 PM,48,-122,5,4,9
12380,FremontBridge,03/02/2014 08:00:00 PM,48,-122,5,5,10
12381,FremontBridge,03/02/2014 09:00:00 PM,48,-122,2,1,3
12382,FremontBridge,03/02/2014 10:00:00 PM,48,-122,4,1,5
12383,FremontBridge,03/02/2014 11:00:00 PM,48,-122,2,2,4
12384,FremontBridge,03/03/2014 12:00:00 AM,48,-122,1,1,2
12385,FremontBridge,03/03/2014 01:00:00 AM,48,-122,0,0,0
12386,FremontBridge,03/03/2014 02:00:00 AM,48,-122,0,0,0
12387,FremontBridge,03/03/2014 03:00:00 AM,48,-122,0,2,2
12388,FremontBridge,03/03/2014 04:00:00 AM,48,-122,1,1,2
12389,FremontBridge,03/03/2014 05:00:00 AM,48,-122,2,13,15
12390,FremontBridge,03/03/2014 06:00:00 AM,48,-122,20,41,61
12391,FremontBridge,03/03/2014 07:00:00 AM,48,-122,48,104,152
12392,FremontBridge,03/03/2014 08:00:00 AM,48,-122,66,139,205
12393,FremontBridge,03/03/2014 09:00:00 AM,48,-122,36,94,130
12394,FremontBridge,03/03/2014 10:00:00 AM,48,-122,23,32,55
12395,FremontBridge,03/03/2014 11:00:00 AM,48,-122,9,12,21
12396,FremontBridge,03/03/2014 12:00:00 PM,48,-122,8,21,29
12397,FremontBridge,03/03/2014 01:00:00 PM,48,-122,22,28,50
12398,FremontBridge,03/03/2014 02:00:00 PM,48,-122,32,25,57
12399,FremontBridge,03/03/2014 03:00:00 PM,48,-122,29,44,73
12400,FremontBridge,03/03/2014 04:00:00 PM,48,-122,75,62,137
12401,FremontBridge,03/03/2014 05:00:00 PM,48,-122,164,99,263
12402,FremontBridge,03/03/2014 06:00:00 PM,48,-122,145,93,238
12403,FremontBridge,03/03/2014 07:00:00 PM,48,-122,63,42,105
12404,FremontBridge,03/03/2014 08:00:00 PM,48,-122,29,17,46
12405,FremontBridge,03/03/2014 09:00:00 PM,48,-122,14,12,26
12406,FremontBridge,03/03/2014 10:00:00 PM,48,-122,19,16,35
12407,FremontBridge,03/03/2014 11:00:00 PM,48,-122,11,5,16
12408,FremontBridge,03/04/2014 12:00:00 AM,48,-122,2,2,4
12409,FremontBridge,03/04/2014 01:00:00 AM,48,-122,0,2,2
12410,FremontBridge,03/04/2014 02:00:00 AM,48,-122,1,2,3
12411,FremontBridge,03/04/2014 03:00:00 AM,48,-122,0,2,2
12412,FremontBridge,03/04/2014 04:00:00 AM,48,-122,2,0,2
12413,FremontBridge,03/04/2014 05:00:00 AM,48,-122,5,16,21
12414,FremontBridge,03/04/2014 06:00:00 AM,48,-122,26,55,81
12415,FremontBridge,03/04/2014 07:00:00 AM,48,-122,54,137,191
12416,FremontBridge,03/04/2014 08:00:00 AM,48,-122,99,240,339
12417,FremontBridge,03/04/2014 09:00:00 AM,48,-122,69,117,186
12418,FremontBridge,03/04/2014 10:00:00 AM,48,-122,18,42,60
12419,FremontBridge,03/04/2014 11:00:00 AM,48,-122,16,28,44
12420,FremontBridge,03/04/2014 12:00:00 PM,48,-122,19,35,54
12421,FremontBridge,03/04/2014 01:00:00 PM,48,-122,18,21,39
12422,FremontBridge,03/04/2014 02:00:00 PM,48,-122,24,30,54
12423,FremontBridge,03/04/2014 03:00:00 PM,48,-122,45,35,80
12424,FremontBridge,03/04/2014 04:00:00 PM,48,-122,80,59,139
12425,FremontBridge,03/04/2014 05:00:00 PM,48,-122,235,91,326
12426,FremontBridge,03/04/2014 06:00:00 PM,48,-122,157,78,235
12427,FremontBridge,03/04/2014 07:00:00 PM,48,-122,60,31,91
12428,FremontBridge,03/04/2014 08:00:00 PM,48,-122,32,11,43
12429,FremontBridge,03/04/2014 09:00:00 PM,48,-122,16,10,26
12430,FremontBridge,03/04/2014 10:00:00 PM,48,-122,10,4,14
12431,FremontBridge,03/04/2014 11:00:00 PM,48,-122,10,7,17
12432,FremontBridge,03/05/2014 12:00:00 AM,48,-122,7,2,9
12433,FremontBridge,03/05/2014 01:00:00 AM,48,-122,1,2,3
12434,FremontBridge,03/05/2014 02:00:00 AM,48,-122,2,3,5
12435,FremontBridge,03/05/2014 03:00:00 AM,48,-122,1,2,3
12436,FremontBridge,03/05/2014 04:00:00 AM,48,-122,2,2,4
12437,FremontBridge,03/05/2014 05:00:00 AM,48,-122,2,6,8
12438,FremontBridge,03/05/2014 06:00:00 AM,48,-122,14,39,53
12439,FremontBridge,03/05/2014 07:00:00 AM,48,-122,42,99,141
12440,FremontBridge,03/05/2014 08:00:00 AM,48,-122,77,182,259
12441,FremontBridge,03/05/2014 09:00:00 AM,48,-122,65,123,188
12442,FremontBridge,03/05/2014 10:00:00 AM,48,-122,27,36,63
12443,FremontBridge,03/05/2014 11:00:00 AM,48,-122,30,36,66
12444,FremontBridge,03/05/2014 12:00:00 PM,48,-122,20,42,62
12445,FremontBridge,03/05/2014 01:00:00 PM,48,-122,27,44,71
12446,FremontBridge,03/05/2014 02:00:00 PM,48,-122,39,41,80
12447,FremontBridge,03/05/2014 03:00:00 PM,48,-122,34,30,64
12448,FremontBridge,03/05/2014 04:00:00 PM,48,-122,71,46,117
12449,FremontBridge,03/05/2014 05:00:00 PM,48,-122,173,84,257
12450,FremontBridge,03/05/2014 06:00:00 PM,48,-122,151,60,211
12451,FremontBridge,03/05/2014 07:00:00 PM,48,-122,62,25,87
12452,FremontBridge,03/05/2014 08:00:00 PM,48,-122,31,15,46
12453,FremontBridge,03/05/2014 09:00:00 PM,48,-122,13,14,27
12454,FremontBridge,03/05/2014 10:00:00 PM,48,-122,18,11,29
12455,FremontBridge,03/05/2014 11:00:00 PM,48,-122,11,10,21
12456,FremontBridge,03/06/2014 12:00:00 AM,48,-122,2,3,5
12457,FremontBridge,03/06/2014 01:00:00 AM,48,-122,1,1,2
12458,FremontBridge,03/06/2014 02:00:00 AM,48,-122,1,1,2
12459,FremontBridge,03/06/2014 03:00:00 AM,48,-122,0,1,1
12460,FremontBridge,03/06/2014 04:00:00 AM,48,-122,0,5,5
12461,FremontBridge,03/06/2014 05:00:00 AM,48,-122,2,12,14
12462,FremontBridge,03/06/2014 06:00:00 AM,48,-122,18,38,56
12463,FremontBridge,03/06/2014 07:00:00 AM,48,-122,47,95,142
12464,FremontBridge,03/06/2014 08:00:00 AM,48,-122,67,178,245
12465,FremontBridge,03/06/2014 09:00:00 AM,48,-122,53,100,153
12466,FremontBridge,03/06/2014 10:00:00 AM,48,-122,28,59,87
12467,FremontBridge,03/06/2014 11:00:00 AM,48,-122,19,27,46
12468,FremontBridge,03/06/2014 12:00:00 PM,48,-122,19,22,41
12469,FremontBridge,03/06/2014 01:00:00 PM,48,-122,19,20,39
12470,FremontBridge,03/06/2014 02:00:00 PM,48,-122,25,18,43
12471,FremontBridge,03/06/2014 03:00:00 PM,48,-122,40,41,81
12472,FremontBridge,03/06/2014 04:00:00 PM,48,-122,73,53,126
12473,FremontBridge,03/06/2014 05:00:00 PM,48,-122,179,75,254
12474,FremontBridge,03/06/2014 06:00:00 PM,48,-122,124,76,200
12475,FremontBridge,03/06/2014 07:00:00 PM,48,-122,73,44,117
12476,FremontBridge,03/06/2014 08:00:00 PM,48,-122,36,17,53
12477,FremontBridge,03/06/2014 09:00:00 PM,48,-122,17,17,34
12478,FremontBridge,03/06/2014 10:00:00 PM,48,-122,18,10,28
12479,FremontBridge,03/06/2014 11:00:00 PM,48,-122,19,8,27
12480,FremontBridge,03/07/2014 12:00:00 AM,48,-122,4,9,13
12481,FremontBridge,03/07/2014 01:00:00 AM,48,-122,3,4,7
12482,FremontBridge,03/07/2014 02:00:00 AM,48,-122,1,0,1
12483,FremontBridge,03/07/2014 03:00:00 AM,48,-122,3,1,4
12484,FremontBridge,03/07/2014 04:00:00 AM,48,-122,0,4,4
12485,FremontBridge,03/07/2014 05:00:00 AM,48,-122,6,13,19
12486,FremontBridge,03/07/2014 06:00:00 AM,48,-122,34,55,89
12487,FremontBridge,03/07/2014 07:00:00 AM,48,-122,53,120,173
12488,FremontBridge,03/07/2014 08:00:00 AM,48,-122,88,244,332
12489,FremontBridge,03/07/2014 09:00:00 AM,48,-122,74,136,210
12490,FremontBridge,03/07/2014 10:00:00 AM,48,-122,34,55,89
12491,FremontBridge,03/07/2014 11:00:00 AM,48,-122,25,38,63
12492,FremontBridge,03/07/2014 12:00:00 PM,48,-122,39,35,74
12493,FremontBridge,03/07/2014 01:00:00 PM,48,-122,44,57,101
12494,FremontBridge,03/07/2014 02:00:00 PM,48,-122,58,47,105
12495,FremontBridge,03/07/2014 03:00:00 PM,48,-122,78,69,147
12496,FremontBridge,03/07/2014 04:00:00 PM,48,-122,127,93,220
12497,FremontBridge,03/07/2014 05:00:00 PM,48,-122,256,114,370
12498,FremontBridge,03/07/2014 06:00:00 PM,48,-122,162,96,258
12499,FremontBridge,03/07/2014 07:00:00 PM,48,-122,57,55,112
12500,FremontBridge,03/07/2014 08:00:00 PM,48,-122,37,23,60
12501,FremontBridge,03/07/2014 09:00:00 PM,48,-122,28,14,42
12502,FremontBridge,03/07/2014 10:00:00 PM,48,-122,22,14,36
12503,FremontBridge,03/07/2014 11:00:00 PM,48,-122,16,15,31
12504,FremontBridge,03/08/2014 12:00:00 AM,48,-122,12,10,22
12505,FremontBridge,03/08/2014 01:00:00 AM,48,-122,7,10,17
12506,FremontBridge,03/08/2014 02:00:00 AM,48,-122,5,1,6
12507,FremontBridge,03/08/2014 03:00:00 AM,48,-122,1,1,2
12508,FremontBridge,03/08/2014 04:00:00 AM,48,-122,3,0,3
12509,FremontBridge,03/08/2014 05:00:00 AM,48,-122,1,3,4
12510,FremontBridge,03/08/2014 06:00:00 AM,48,-122,9,11,20
12511,FremontBridge,03/08/2014 07:00:00 AM,48,-122,19,12,31
12512,FremontBridge,03/08/2014 08:00:00 AM,48,-122,41,37,78
12513,FremontBridge,03/08/2014 09:00:00 AM,48,-122,39,52,91
12514,FremontBridge,03/08/2014 10:00:00 AM,48,-122,39,60,99
12515,FremontBridge,03/08/2014 11:00:00 AM,48,-122,30,49,79
12516,FremontBridge,03/08/2014 12:00:00 PM,48,-122,27,24,51
12517,FremontBridge,03/08/2014 01:00:00 PM,48,-122,19,16,35
12518,FremontBridge,03/08/2014 02:00:00 PM,48,-122,21,14,35
12519,FremontBridge,03/08/2014 03:00:00 PM,48,-122,12,17,29
12520,FremontBridge,03/08/2014 04:00:00 PM,48,-122,15,11,26
12521,FremontBridge,03/08/2014 05:00:00 PM,48,-122,8,14,22
12522,FremontBridge,03/08/2014 06:00:00 PM,48,-122,9,12,21
12523,FremontBridge,03/08/2014 07:00:00 PM,48,-122,7,5,12
12524,FremontBridge,03/08/2014 08:00:00 PM,48,-122,12,7,19
12525,FremontBridge,03/08/2014 09:00:00 PM,48,-122,3,5,8
12526,FremontBridge,03/08/2014 10:00:00 PM,48,-122,3,3,6
12527,FremontBridge,03/08/2014 11:00:00 PM,48,-122,4,6,10
12528,FremontBridge,03/09/2014 12:00:00 AM,48,-122,5,1,6
12529,FremontBridge,03/09/2014 01:00:00 AM,48,-122,0,0,0
12530,FremontBridge,03/09/2014 02:00:00 AM,48,-122,,,
12531,FremontBridge,03/09/2014 03:00:00 AM,48,-122,0,0,0
12532,FremontBridge,03/09/2014 04:00:00 AM,48,-122,2,2,4
12533,FremontBridge,03/09/2014 05:00:00 AM,48,-122,2,1,3
12534,FremontBridge,03/09/2014 06:00:00 AM,48,-122,1,3,4
12535,FremontBridge,03/09/2014 07:00:00 AM,48,-122,3,4,7
12536,FremontBridge,03/09/2014 08:00:00 AM,48,-122,6,9,15
12537,FremontBridge,03/09/2014 09:00:00 AM,48,-122,11,20,31
12538,FremontBridge,03/09/2014 10:00:00 AM,48,-122,8,29,37
12539,FremontBridge,03/09/2014 11:00:00 AM,48,-122,33,18,51
12540,FremontBridge,03/09/2014 12:00:00 PM,48,-122,28,40,68
12541,FremontBridge,03/09/2014 01:00:00 PM,48,-122,41,60,101
12542,FremontBridge,03/09/2014 02:00:00 PM,48,-122,62,83,145
12543,FremontBridge,03/09/2014 03:00:00 PM,48,-122,80,106,186
12544,FremontBridge,03/09/2014 04:00:00 PM,48,-122,74,97,171
12545,FremontBridge,03/09/2014 05:00:00 PM,48,-122,63,73,136
12546,FremontBridge,03/09/2014 06:00:00 PM,48,-122,28,50,78
12547,FremontBridge,03/09/2014 07:00:00 PM,48,-122,12,24,36
12548,FremontBridge,03/09/2014 08:00:00 PM,48,-122,16,15,31
12549,FremontBridge,03/09/2014 09:00:00 PM,48,-122,6,9,15
12550,FremontBridge,03/09/2014 10:00:00 PM,48,-122,11,1,12
12551,FremontBridge,03/09/2014 11:00:00 PM,48,-122,2,3,5
12552,FremontBridge,03/10/2014 12:00:00 AM,48,-122,4,3,7
12553,FremontBridge,03/10/2014 01:00:00 AM,48,-122,1,1,2
12554,FremontBridge,03/10/2014 02:00:00 AM,48,-122,0,0,0
12555,FremontBridge,03/10/2014 03:00:00 AM,48,-122,1,1,2
12556,FremontBridge,03/10/2014 04:00:00 AM,48,-122,1,0,1
12557,FremontBridge,03/10/2014 05:00:00 AM,48,-122,3,10,13
12558,FremontBridge,03/10/2014 06:00:00 AM,48,-122,20,48,68
12559,FremontBridge,03/10/2014 07:00:00 AM,48,-122,56,137,193
12560,FremontBridge,03/10/2014 08:00:00 AM,48,-122,84,195,279
12561,FremontBridge,03/10/2014 09:00:00 AM,48,-122,83,137,220
12562,FremontBridge,03/10/2014 10:00:00 AM,48,-122,40,63,103
12563,FremontBridge,03/10/2014 11:00:00 AM,48,-122,19,26,45
12564,FremontBridge,03/10/2014 12:00:00 PM,48,-122,24,26,50
12565,FremontBridge,03/10/2014 01:00:00 PM,48,-122,16,21,37
12566,FremontBridge,03/10/2014 02:00:00 PM,48,-122,28,24,52
12567,FremontBridge,03/10/2014 03:00:00 PM,48,-122,41,32,73
12568,FremontBridge,03/10/2014 04:00:00 PM,48,-122,85,58,143
12569,FremontBridge,03/10/2014 05:00:00 PM,48,-122,235,90,325
12570,FremontBridge,03/10/2014 06:00:00 PM,48,-122,184,101,285
12571,FremontBridge,03/10/2014 07:00:00 PM,48,-122,80,36,116
12572,FremontBridge,03/10/2014 08:00:00 PM,48,-122,30,25,55
12573,FremontBridge,03/10/2014 09:00:00 PM,48,-122,19,19,38
12574,FremontBridge,03/10/2014 10:00:00 PM,48,-122,13,8,21
12575,FremontBridge,03/10/2014 11:00:00 PM,48,-122,11,6,17
12576,FremontBridge,03/11/2014 12:00:00 AM,48,-122,2,3,5
12577,FremontBridge,03/11/2014 01:00:00 AM,48,-122,2,1,3
12578,FremontBridge,03/11/2014 02:00:00 AM,48,-122,0,1,1
12579,FremontBridge,03/11/2014 03:00:00 AM,48,-122,0,0,0
12580,FremontBridge,03/11/2014 04:00:00 AM,48,-122,1,2,3
12581,FremontBridge,03/11/2014 05:00:00 AM,48,-122,4,16,20
12582,FremontBridge,03/11/2014 06:00:00 AM,48,-122,31,68,99
12583,FremontBridge,03/11/2014 07:00:00 AM,48,-122,73,193,266
12584,FremontBridge,03/11/2014 08:00:00 AM,48,-122,119,298,417
12585,FremontBridge,03/11/2014 09:00:00 AM,48,-122,108,201,309
12586,FremontBridge,03/11/2014 10:00:00 AM,48,-122,37,72,109
12587,FremontBridge,03/11/2014 11:00:00 AM,48,-122,24,35,59
12588,FremontBridge,03/11/2014 12:00:00 PM,48,-122,41,66,107
12589,FremontBridge,03/11/2014 01:00:00 PM,48,-122,40,52,92
12590,FremontBridge,03/11/2014 02:00:00 PM,48,-122,40,60,100
12591,FremontBridge,03/11/2014 03:00:00 PM,48,-122,77,82,159
12592,FremontBridge,03/11/2014 04:00:00 PM,48,-122,156,98,254
12593,FremontBridge,03/11/2014 05:00:00 PM,48,-122,348,159,507
12594,FremontBridge,03/11/2014 06:00:00 PM,48,-122,310,164,474
12595,FremontBridge,03/11/2014 07:00:00 PM,48,-122,117,96,213
12596,FremontBridge,03/11/2014 08:00:00 PM,48,-122,60,47,107
12597,FremontBridge,03/11/2014 09:00:00 PM,48,-122,35,21,56
12598,FremontBridge,03/11/2014 10:00:00 PM,48,-122,22,16,38
12599,FremontBridge,03/11/2014 11:00:00 PM,48,-122,10,8,18
12600,FremontBridge,03/12/2014 12:00:00 AM,48,-122,4,4,8
12601,FremontBridge,03/12/2014 01:00:00 AM,48,-122,2,1,3
12602,FremontBridge,03/12/2014 02:00:00 AM,48,-122,1,3,4
12603,FremontBridge,03/12/2014 03:00:00 AM,48,-122,1,0,1
12604,FremontBridge,03/12/2014 04:00:00 AM,48,-122,3,0,3
12605,FremontBridge,03/12/2014 05:00:00 AM,48,-122,7,16,23
12606,FremontBridge,03/12/2014 06:00:00 AM,48,-122,29,66,95
12607,FremontBridge,03/12/2014 07:00:00 AM,48,-122,61,193,254
12608,FremontBridge,03/12/2014 08:00:00 AM,48,-122,122,303,425
12609,FremontBridge,03/12/2014 09:00:00 AM,48,-122,116,222,338
12610,FremontBridge,03/12/2014 10:00:00 AM,48,-122,61,70,131
12611,FremontBridge,03/12/2014 11:00:00 AM,48,-122,32,56,88
12612,FremontBridge,03/12/2014 12:00:00 PM,48,-122,38,58,96
12613,FremontBridge,03/12/2014 01:00:00 PM,48,-122,53,63,116
12614,FremontBridge,03/12/2014 02:00:00 PM,48,-122,60,67,127
12615,FremontBridge,03/12/2014 03:00:00 PM,48,-122,77,80,157
12616,FremontBridge,03/12/2014 04:00:00 PM,48,-122,137,114,251
12617,FremontBridge,03/12/2014 05:00:00 PM,48,-122,383,179,562
12618,FremontBridge,03/12/2014 06:00:00 PM,48,-122,292,184,476
12619,FremontBridge,03/12/2014 07:00:00 PM,48,-122,135,109,244
12620,FremontBridge,03/12/2014 08:00:00 PM,48,-122,70,58,128
12621,FremontBridge,03/12/2014 09:00:00 PM,48,-122,36,27,63
12622,FremontBridge,03/12/2014 10:00:00 PM,48,-122,27,29,56
12623,FremontBridge,03/12/2014 11:00:00 PM,48,-122,6,10,16
12624,FremontBridge,03/13/2014 12:00:00 AM,48,-122,3,7,10
12625,FremontBridge,03/13/2014 01:00:00 AM,48,-122,2,0,2
12626,FremontBridge,03/13/2014 02:00:00 AM,48,-122,3,3,6
12627,FremontBridge,03/13/2014 03:00:00 AM,48,-122,0,1,1
12628,FremontBridge,03/13/2014 04:00:00 AM,48,-122,3,6,9
12629,FremontBridge,03/13/2014 05:00:00 AM,48,-122,5,20,25
12630,FremontBridge,03/13/2014 06:00:00 AM,48,-122,31,63,94
12631,FremontBridge,03/13/2014 07:00:00 AM,48,-122,75,178,253
12632,FremontBridge,03/13/2014 08:00:00 AM,48,-122,120,303,423
12633,FremontBridge,03/13/2014 09:00:00 AM,48,-122,105,182,287
12634,FremontBridge,03/13/2014 10:00:00 AM,48,-122,55,50,105
12635,FremontBridge,03/13/2014 11:00:00 AM,48,-122,35,50,85
12636,FremontBridge,03/13/2014 12:00:00 PM,48,-122,35,69,104
12637,FremontBridge,03/13/2014 01:00:00 PM,48,-122,53,48,101
12638,FremontBridge,03/13/2014 02:00:00 PM,48,-122,46,52,98
12639,FremontBridge,03/13/2014 03:00:00 PM,48,-122,76,81,157
12640,FremontBridge,03/13/2014 04:00:00 PM,48,-122,159,96,255
12641,FremontBridge,03/13/2014 05:00:00 PM,48,-122,287,144,431
12642,FremontBridge,03/13/2014 06:00:00 PM,48,-122,306,173,479
12643,FremontBridge,03/13/2014 07:00:00 PM,48,-122,92,92,184
12644,FremontBridge,03/13/2014 08:00:00 PM,48,-122,55,30,85
12645,FremontBridge,03/13/2014 09:00:00 PM,48,-122,42,23,65
12646,FremontBridge,03/13/2014 10:00:00 PM,48,-122,19,14,33
12647,FremontBridge,03/13/2014 11:00:00 PM,48,-122,12,9,21
12648,FremontBridge,03/14/2014 12:00:00 AM,48,-122,4,1,5
12649,FremontBridge,03/14/2014 01:00:00 AM,48,-122,8,2,10
12650,FremontBridge,03/14/2014 02:00:00 AM,48,-122,2,1,3
12651,FremontBridge,03/14/2014 03:00:00 AM,48,-122,2,2,4
12652,FremontBridge,03/14/2014 04:00:00 AM,48,-122,2,2,4
12653,FremontBridge,03/14/2014 05:00:00 AM,48,-122,5,16,21
12654,FremontBridge,03/14/2014 06:00:00 AM,48,-122,25,49,74
12655,FremontBridge,03/14/2014 07:00:00 AM,48,-122,41,88,129
12656,FremontBridge,03/14/2014 08:00:00 AM,48,-122,79,191,270
12657,FremontBridge,03/14/2014 09:00:00 AM,48,-122,64,125,189
12658,FremontBridge,03/14/2014 10:00:00 AM,48,-122,33,50,83
12659,FremontBridge,03/14/2014 11:00:00 AM,48,-122,15,40,55
12660,FremontBridge,03/14/2014 12:00:00 PM,48,-122,26,33,59
12661,FremontBridge,03/14/2014 01:00:00 PM,48,-122,40,40,80
12662,FremontBridge,03/14/2014 02:00:00 PM,48,-122,41,48,89
12663,FremontBridge,03/14/2014 03:00:00 PM,48,-122,54,63,117
12664,FremontBridge,03/14/2014 04:00:00 PM,48,-122,97,70,167
12665,FremontBridge,03/14/2014 05:00:00 PM,48,-122,218,113,331
12666,FremontBridge,03/14/2014 06:00:00 PM,48,-122,144,88,232
12667,FremontBridge,03/14/2014 07:00:00 PM,48,-122,94,56,150
12668,FremontBridge,03/14/2014 08:00:00 PM,48,-122,45,15,60
12669,FremontBridge,03/14/2014 09:00:00 PM,48,-122,18,13,31
12670,FremontBridge,03/14/2014 10:00:00 PM,48,-122,14,11,25
12671,FremontBridge,03/14/2014 11:00:00 PM,48,-122,16,12,28
12672,FremontBridge,03/15/2014 12:00:00 AM,48,-122,6,5,11
12673,FremontBridge,03/15/2014 01:00:00 AM,48,-122,6,5,11
12674,FremontBridge,03/15/2014 02:00:00 AM,48,-122,5,4,9
12675,FremontBridge,03/15/2014 03:00:00 AM,48,-122,3,1,4
12676,FremontBridge,03/15/2014 04:00:00 AM,48,-122,1,1,2
12677,FremontBridge,03/15/2014 05:00:00 AM,48,-122,2,3,5
12678,FremontBridge,03/15/2014 06:00:00 AM,48,-122,9,7,16
12679,FremontBridge,03/15/2014 07:00:00 AM,48,-122,15,14,29
12680,FremontBridge,03/15/2014 08:00:00 AM,48,-122,20,29,49
12681,FremontBridge,03/15/2014 09:00:00 AM,48,-122,33,47,80
12682,FremontBridge,03/15/2014 10:00:00 AM,48,-122,39,57,96
12683,FremontBridge,03/15/2014 11:00:00 AM,48,-122,38,53,91
12684,FremontBridge,03/15/2014 12:00:00 PM,48,-122,39,47,86
12685,FremontBridge,03/15/2014 01:00:00 PM,48,-122,37,53,90
12686,FremontBridge,03/15/2014 02:00:00 PM,48,-122,57,72,129
12687,FremontBridge,03/15/2014 03:00:00 PM,48,-122,55,42,97
12688,FremontBridge,03/15/2014 04:00:00 PM,48,-122,62,64,126
12689,FremontBridge,03/15/2014 05:00:00 PM,48,-122,39,54,93
12690,FremontBridge,03/15/2014 06:00:00 PM,48,-122,27,30,57
12691,FremontBridge,03/15/2014 07:00:00 PM,48,-122,13,15,28
12692,FremontBridge,03/15/2014 08:00:00 PM,48,-122,17,10,27
12693,FremontBridge,03/15/2014 09:00:00 PM,48,-122,7,5,12
12694,FremontBridge,03/15/2014 10:00:00 PM,48,-122,6,7,13
12695,FremontBridge,03/15/2014 11:00:00 PM,48,-122,7,9,16
12696,FremontBridge,03/16/2014 12:00:00 AM,48,-122,9,5,14
12697,FremontBridge,03/16/2014 01:00:00 AM,48,-122,4,4,8
12698,FremontBridge,03/16/2014 02:00:00 AM,48,-122,3,2,5
12699,FremontBridge,03/16/2014 03:00:00 AM,48,-122,1,1,2
12700,FremontBridge,03/16/2014 04:00:00 AM,48,-122,0,1,1
12701,FremontBridge,03/16/2014 05:00:00 AM,48,-122,2,4,6
12702,FremontBridge,03/16/2014 06:00:00 AM,48,-122,4,4,8
12703,FremontBridge,03/16/2014 07:00:00 AM,48,-122,6,6,12
12704,FremontBridge,03/16/2014 08:00:00 AM,48,-122,6,8,14
12705,FremontBridge,03/16/2014 09:00:00 AM,48,-122,8,16,24
12706,FremontBridge,03/16/2014 10:00:00 AM,48,-122,11,17,28
12707,FremontBridge,03/16/2014 11:00:00 AM,48,-122,10,16,26
12708,FremontBridge,03/16/2014 12:00:00 PM,48,-122,10,17,27
12709,FremontBridge,03/16/2014 01:00:00 PM,48,-122,14,17,31
12710,FremontBridge,03/16/2014 02:00:00 PM,48,-122,3,11,14
12711,FremontBridge,03/16/2014 03:00:00 PM,48,-122,13,17,30
12712,FremontBridge,03/16/2014 04:00:00 PM,48,-122,17,28,45
12713,FremontBridge,03/16/2014 05:00:00 PM,48,-122,14,13,27
12714,FremontBridge,03/16/2014 06:00:00 PM,48,-122,4,10,14
12715,FremontBridge,03/16/2014 07:00:00 PM,48,-122,3,4,7
12716,FremontBridge,03/16/2014 08:00:00 PM,48,-122,12,4,16
12717,FremontBridge,03/16/2014 09:00:00 PM,48,-122,0,7,7
12718,FremontBridge,03/16/2014 10:00:00 PM,48,-122,5,1,6
12719,FremontBridge,03/16/2014 11:00:00 PM,48,-122,1,2,3
12720,FremontBridge,03/17/2014 12:00:00 AM,48,-122,4,0,4
12721,FremontBridge,03/17/2014 01:00:00 AM,48,-122,2,3,5
12722,FremontBridge,03/17/2014 02:00:00 AM,48,-122,0,1,1
12723,FremontBridge,03/17/2014 03:00:00 AM,48,-122,0,3,3
12724,FremontBridge,03/17/2014 04:00:00 AM,48,-122,1,2,3
12725,FremontBridge,03/17/2014 05:00:00 AM,48,-122,3,14,17
12726,FremontBridge,03/17/2014 06:00:00 AM,48,-122,32,52,84
12727,FremontBridge,03/17/2014 07:00:00 AM,48,-122,48,150,198
12728,FremontBridge,03/17/2014 08:00:00 AM,48,-122,110,267,377
12729,FremontBridge,03/17/2014 09:00:00 AM,48,-122,88,181,269
12730,FremontBridge,03/17/2014 10:00:00 AM,48,-122,46,66,112
12731,FremontBridge,03/17/2014 11:00:00 AM,48,-122,42,52,94
12732,FremontBridge,03/17/2014 12:00:00 PM,48,-122,41,51,92
12733,FremontBridge,03/17/2014 01:00:00 PM,48,-122,52,47,99
12734,FremontBridge,03/17/2014 02:00:00 PM,48,-122,41,39,80
12735,FremontBridge,03/17/2014 03:00:00 PM,48,-122,62,54,116
12736,FremontBridge,03/17/2014 04:00:00 PM,48,-122,116,55,171
12737,FremontBridge,03/17/2014 05:00:00 PM,48,-122,288,116,404
12738,FremontBridge,03/17/2014 06:00:00 PM,48,-122,253,127,380
12739,FremontBridge,03/17/2014 07:00:00 PM,48,-122,88,48,136
12740,FremontBridge,03/17/2014 08:00:00 PM,48,-122,42,30,72
12741,FremontBridge,03/17/2014 09:00:00 PM,48,-122,25,15,40
12742,FremontBridge,03/17/2014 10:00:00 PM,48,-122,18,12,30
12743,FremontBridge,03/17/2014 11:00:00 PM,48,-122,12,10,22
12744,FremontBridge,03/18/2014 12:00:00 AM,48,-122,4,2,6
12745,FremontBridge,03/18/2014 01:00:00 AM,48,-122,2,6,8
12746,FremontBridge,03/18/2014 02:00:00 AM,48,-122,1,1,2
12747,FremontBridge,03/18/2014 03:00:00 AM,48,-122,1,0,1
12748,FremontBridge,03/18/2014 04:00:00 AM,48,-122,1,4,5
12749,FremontBridge,03/18/2014 05:00:00 AM,48,-122,4,15,19
12750,FremontBridge,03/18/2014 06:00:00 AM,48,-122,31,81,112
12751,FremontBridge,03/18/2014 07:00:00 AM,48,-122,72,160,232
12752,FremontBridge,03/18/2014 08:00:00 AM,48,-122,118,273,391
12753,FremontBridge,03/18/2014 09:00:00 AM,48,-122,90,155,245
12754,FremontBridge,03/18/2014 10:00:00 AM,48,-122,43,85,128
12755,FremontBridge,03/18/2014 11:00:00 AM,48,-122,23,27,50
12756,FremontBridge,03/18/2014 12:00:00 PM,48,-122,29,34,63
12757,FremontBridge,03/18/2014 01:00:00 PM,48,-122,24,33,57
12758,FremontBridge,03/18/2014 02:00:00 PM,48,-122,32,48,80
12759,FremontBridge,03/18/2014 03:00:00 PM,48,-122,69,45,114
12760,FremontBridge,03/18/2014 04:00:00 PM,48,-122,92,80,172
12761,FremontBridge,03/18/2014 05:00:00 PM,48,-122,270,113,383
12762,FremontBridge,03/18/2014 06:00:00 PM,48,-122,266,122,388
12763,FremontBridge,03/18/2014 07:00:00 PM,48,-122,117,61,178
12764,FremontBridge,03/18/2014 08:00:00 PM,48,-122,48,23,71
12765,FremontBridge,03/18/2014 09:00:00 PM,48,-122,17,26,43
12766,FremontBridge,03/18/2014 10:00:00 PM,48,-122,20,16,36
12767,FremontBridge,03/18/2014 11:00:00 PM,48,-122,9,9,18
12768,FremontBridge,03/19/2014 12:00:00 AM,48,-122,1,5,6
12769,FremontBridge,03/19/2014 01:00:00 AM,48,-122,6,0,6
12770,FremontBridge,03/19/2014 02:00:00 AM,48,-122,0,2,2
12771,FremontBridge,03/19/2014 03:00:00 AM,48,-122,1,1,2
12772,FremontBridge,03/19/2014 04:00:00 AM,48,-122,1,3,4
12773,FremontBridge,03/19/2014 05:00:00 AM,48,-122,2,12,14
12774,FremontBridge,03/19/2014 06:00:00 AM,48,-122,24,57,81
12775,FremontBridge,03/19/2014 07:00:00 AM,48,-122,49,122,171
12776,FremontBridge,03/19/2014 08:00:00 AM,48,-122,88,205,293
12777,FremontBridge,03/19/2014 09:00:00 AM,48,-122,89,137,226
12778,FremontBridge,03/19/2014 10:00:00 AM,48,-122,39,59,98
12779,FremontBridge,03/19/2014 11:00:00 AM,48,-122,20,35,55
12780,FremontBridge,03/19/2014 12:00:00 PM,48,-122,26,31,57
12781,FremontBridge,03/19/2014 01:00:00 PM,48,-122,20,26,46
12782,FremontBridge,03/19/2014 02:00:00 PM,48,-122,26,29,55
12783,FremontBridge,03/19/2014 03:00:00 PM,48,-122,38,34,72
12784,FremontBridge,03/19/2014 04:00:00 PM,48,-122,80,54,134
12785,FremontBridge,03/19/2014 05:00:00 PM,48,-122,202,108,310
12786,FremontBridge,03/19/2014 06:00:00 PM,48,-122,217,85,302
12787,FremontBridge,03/19/2014 07:00:00 PM,48,-122,76,50,126
12788,FremontBridge,03/19/2014 08:00:00 PM,48,-122,37,19,56
12789,FremontBridge,03/19/2014 09:00:00 PM,48,-122,20,18,38
12790,FremontBridge,03/19/2014 10:00:00 PM,48,-122,14,7,21
12791,FremontBridge,03/19/2014 11:00:00 PM,48,-122,7,10,17
12792,FremontBridge,03/20/2014 12:00:00 AM,48,-122,1,0,1
12793,FremontBridge,03/20/2014 01:00:00 AM,48,-122,1,2,3
12794,FremontBridge,03/20/2014 02:00:00 AM,48,-122,0,0,0
12795,FremontBridge,03/20/2014 03:00:00 AM,48,-122,0,2,2
12796,FremontBridge,03/20/2014 04:00:00 AM,48,-122,2,3,5
12797,FremontBridge,03/20/2014 05:00:00 AM,48,-122,7,12,19
12798,FremontBridge,03/20/2014 06:00:00 AM,48,-122,24,56,80
12799,FremontBridge,03/20/2014 07:00:00 AM,48,-122,55,150,205
12800,FremontBridge,03/20/2014 08:00:00 AM,48,-122,81,225,306
12801,FremontBridge,03/20/2014 09:00:00 AM,48,-122,81,160,241
12802,FremontBridge,03/20/2014 10:00:00 AM,48,-122,33,68,101
12803,FremontBridge,03/20/2014 11:00:00 AM,48,-122,28,42,70
12804,FremontBridge,03/20/2014 12:00:00 PM,48,-122,24,33,57
12805,FremontBridge,03/20/2014 01:00:00 PM,48,-122,27,39,66
12806,FremontBridge,03/20/2014 02:00:00 PM,48,-122,41,63,104
12807,FremontBridge,03/20/2014 03:00:00 PM,48,-122,64,73,137
12808,FremontBridge,03/20/2014 04:00:00 PM,48,-122,86,104,190
12809,FremontBridge,03/20/2014 05:00:00 PM,48,-122,267,133,400
12810,FremontBridge,03/20/2014 06:00:00 PM,48,-122,212,127,339
12811,FremontBridge,03/20/2014 07:00:00 PM,48,-122,105,60,165
12812,FremontBridge,03/20/2014 08:00:00 PM,48,-122,44,38,82
12813,FremontBridge,03/20/2014 09:00:00 PM,48,-122,32,19,51
12814,FremontBridge,03/20/2014 10:00:00 PM,48,-122,25,15,40
12815,FremontBridge,03/20/2014 11:00:00 PM,48,-122,14,13,27
12816,FremontBridge,03/21/2014 12:00:00 AM,48,-122,5,11,16
12817,FremontBridge,03/21/2014 01:00:00 AM,48,-122,4,3,7
12818,FremontBridge,03/21/2014 02:00:00 AM,48,-122,3,1,4
12819,FremontBridge,03/21/2014 03:00:00 AM,48,-122,2,2,4
12820,FremontBridge,03/21/2014 04:00:00 AM,48,-122,3,3,6
12821,FremontBridge,03/21/2014 05:00:00 AM,48,-122,5,10,15
12822,FremontBridge,03/21/2014 06:00:00 AM,48,-122,23,47,70
12823,FremontBridge,03/21/2014 07:00:00 AM,48,-122,64,138,202
12824,FremontBridge,03/21/2014 08:00:00 AM,48,-122,87,253,340
12825,FremontBridge,03/21/2014 09:00:00 AM,48,-122,87,142,229
12826,FremontBridge,03/21/2014 10:00:00 AM,48,-122,46,64,110
12827,FremontBridge,03/21/2014 11:00:00 AM,48,-122,23,39,62
12828,FremontBridge,03/21/2014 12:00:00 PM,48,-122,23,48,71
12829,FremontBridge,03/21/2014 01:00:00 PM,48,-122,53,45,98
12830,FremontBridge,03/21/2014 02:00:00 PM,48,-122,52,64,116
12831,FremontBridge,03/21/2014 03:00:00 PM,48,-122,77,62,139
12832,FremontBridge,03/21/2014 04:00:00 PM,48,-122,128,79,207
12833,FremontBridge,03/21/2014 05:00:00 PM,48,-122,261,128,389
12834,FremontBridge,03/21/2014 06:00:00 PM,48,-122,180,103,283
12835,FremontBridge,03/21/2014 07:00:00 PM,48,-122,87,47,134
12836,FremontBridge,03/21/2014 08:00:00 PM,48,-122,43,27,70
12837,FremontBridge,03/21/2014 09:00:00 PM,48,-122,15,10,25
12838,FremontBridge,03/21/2014 10:00:00 PM,48,-122,15,9,24
12839,FremontBridge,03/21/2014 11:00:00 PM,48,-122,21,10,31
12840,FremontBridge,03/22/2014 12:00:00 AM,48,-122,11,5,16
12841,FremontBridge,03/22/2014 01:00:00 AM,48,-122,4,5,9
12842,FremontBridge,03/22/2014 02:00:00 AM,48,-122,1,3,4
12843,FremontBridge,03/22/2014 03:00:00 AM,48,-122,1,2,3
12844,FremontBridge,03/22/2014 04:00:00 AM,48,-122,0,1,1
12845,FremontBridge,03/22/2014 05:00:00 AM,48,-122,5,2,7
12846,FremontBridge,03/22/2014 06:00:00 AM,48,-122,5,9,14
12847,FremontBridge,03/22/2014 07:00:00 AM,48,-122,22,23,45
12848,FremontBridge,03/22/2014 08:00:00 AM,48,-122,38,21,59
12849,FremontBridge,03/22/2014 09:00:00 AM,48,-122,45,44,89
12850,FremontBridge,03/22/2014 10:00:00 AM,48,-122,35,77,112
12851,FremontBridge,03/22/2014 11:00:00 AM,48,-122,57,90,147
12852,FremontBridge,03/22/2014 12:00:00 PM,48,-122,78,78,156
12853,FremontBridge,03/22/2014 01:00:00 PM,48,-122,52,73,125
12854,FremontBridge,03/22/2014 02:00:00 PM,48,-122,59,78,137
12855,FremontBridge,03/22/2014 03:00:00 PM,48,-122,59,67,126
12856,FremontBridge,03/22/2014 04:00:00 PM,48,-122,69,64,133
12857,FremontBridge,03/22/2014 05:00:00 PM,48,-122,57,43,100
12858,FremontBridge,03/22/2014 06:00:00 PM,48,-122,37,46,83
12859,FremontBridge,03/22/2014 07:00:00 PM,48,-122,25,28,53
12860,FremontBridge,03/22/2014 08:00:00 PM,48,-122,21,13,34
12861,FremontBridge,03/22/2014 09:00:00 PM,48,-122,14,5,19
12862,FremontBridge,03/22/2014 10:00:00 PM,48,-122,11,7,18
12863,FremontBridge,03/22/2014 11:00:00 PM,48,-122,4,10,14
12864,FremontBridge,03/23/2014 12:00:00 AM,48,-122,7,6,13
12865,FremontBridge,03/23/2014 01:00:00 AM,48,-122,4,2,6
12866,FremontBridge,03/23/2014 02:00:00 AM,48,-122,4,1,5
12867,FremontBridge,03/23/2014 03:00:00 AM,48,-122,3,1,4
12868,FremontBridge,03/23/2014 04:00:00 AM,48,-122,2,0,2
12869,FremontBridge,03/23/2014 05:00:00 AM,48,-122,3,2,5
12870,FremontBridge,03/23/2014 06:00:00 AM,48,-122,6,2,8
12871,FremontBridge,03/23/2014 07:00:00 AM,48,-122,9,14,23
12872,FremontBridge,03/23/2014 08:00:00 AM,48,-122,26,28,54
12873,FremontBridge,03/23/2014 09:00:00 AM,48,-122,29,43,72
12874,FremontBridge,03/23/2014 10:00:00 AM,48,-122,43,47,90
12875,FremontBridge,03/23/2014 11:00:00 AM,48,-122,59,88,147
12876,FremontBridge,03/23/2014 12:00:00 PM,48,-122,97,123,220
12877,FremontBridge,03/23/2014 01:00:00 PM,48,-122,81,123,204
12878,FremontBridge,03/23/2014 02:00:00 PM,48,-122,84,107,191
12879,FremontBridge,03/23/2014 03:00:00 PM,48,-122,119,140,259
12880,FremontBridge,03/23/2014 04:00:00 PM,48,-122,100,132,232
12881,FremontBridge,03/23/2014 05:00:00 PM,48,-122,95,83,178
12882,FremontBridge,03/23/2014 06:00:00 PM,48,-122,45,61,106
12883,FremontBridge,03/23/2014 07:00:00 PM,48,-122,24,37,61
12884,FremontBridge,03/23/2014 08:00:00 PM,48,-122,19,12,31
12885,FremontBridge,03/23/2014 09:00:00 PM,48,-122,11,8,19
12886,FremontBridge,03/23/2014 10:00:00 PM,48,-122,10,9,19
12887,FremontBridge,03/23/2014 11:00:00 PM,48,-122,8,6,14
12888,FremontBridge,03/24/2014 12:00:00 AM,48,-122,12,3,15
12889,FremontBridge,03/24/2014 01:00:00 AM,48,-122,1,2,3
12890,FremontBridge,03/24/2014 02:00:00 AM,48,-122,0,0,0
12891,FremontBridge,03/24/2014 03:00:00 AM,48,-122,0,1,1
12892,FremontBridge,03/24/2014 04:00:00 AM,48,-122,3,3,6
12893,FremontBridge,03/24/2014 05:00:00 AM,48,-122,9,14,23
12894,FremontBridge,03/24/2014 06:00:00 AM,48,-122,40,64,104
12895,FremontBridge,03/24/2014 07:00:00 AM,48,-122,59,199,258
12896,FremontBridge,03/24/2014 08:00:00 AM,48,-122,152,333,485
12897,FremontBridge,03/24/2014 09:00:00 AM,48,-122,111,188,299
12898,FremontBridge,03/24/2014 10:00:00 AM,48,-122,46,75,121
12899,FremontBridge,03/24/2014 11:00:00 AM,48,-122,43,48,91
12900,FremontBridge,03/24/2014 12:00:00 PM,48,-122,42,64,106
12901,FremontBridge,03/24/2014 01:00:00 PM,48,-122,46,66,112
12902,FremontBridge,03/24/2014 02:00:00 PM,48,-122,52,56,108
12903,FremontBridge,03/24/2014 03:00:00 PM,48,-122,69,79,148
12904,FremontBridge,03/24/2014 04:00:00 PM,48,-122,146,115,261
12905,FremontBridge,03/24/2014 05:00:00 PM,48,-122,399,186,585
12906,FremontBridge,03/24/2014 06:00:00 PM,48,-122,310,166,476
12907,FremontBridge,03/24/2014 07:00:00 PM,48,-122,136,91,227
12908,FremontBridge,03/24/2014 08:00:00 PM,48,-122,37,38,75
12909,FremontBridge,03/24/2014 09:00:00 PM,48,-122,36,19,55
12910,FremontBridge,03/24/2014 10:00:00 PM,48,-122,25,18,43
12911,FremontBridge,03/24/2014 11:00:00 PM,48,-122,19,15,34
12912,FremontBridge,03/25/2014 12:00:00 AM,48,-122,5,5,10
12913,FremontBridge,03/25/2014 01:00:00 AM,48,-122,8,3,11
12914,FremontBridge,03/25/2014 02:00:00 AM,48,-122,3,3,6
12915,FremontBridge,03/25/2014 03:00:00 AM,48,-122,1,0,1
12916,FremontBridge,03/25/2014 04:00:00 AM,48,-122,3,3,6
12917,FremontBridge,03/25/2014 05:00:00 AM,48,-122,6,15,21
12918,FremontBridge,03/25/2014 06:00:00 AM,48,-122,32,57,89
12919,FremontBridge,03/25/2014 07:00:00 AM,48,-122,67,155,222
12920,FremontBridge,03/25/2014 08:00:00 AM,48,-122,91,207,298
12921,FremontBridge,03/25/2014 09:00:00 AM,48,-122,68,122,190
12922,FremontBridge,03/25/2014 10:00:00 AM,48,-122,31,49,80
12923,FremontBridge,03/25/2014 11:00:00 AM,48,-122,20,17,37
12924,FremontBridge,03/25/2014 12:00:00 PM,48,-122,20,14,34
12925,FremontBridge,03/25/2014 01:00:00 PM,48,-122,16,18,34
12926,FremontBridge,03/25/2014 02:00:00 PM,48,-122,27,15,42
12927,FremontBridge,03/25/2014 03:00:00 PM,48,-122,44,27,71
12928,FremontBridge,03/25/2014 04:00:00 PM,48,-122,75,41,116
12929,FremontBridge,03/25/2014 05:00:00 PM,48,-122,224,103,327
12930,FremontBridge,03/25/2014 06:00:00 PM,48,-122,172,91,263
12931,FremontBridge,03/25/2014 07:00:00 PM,48,-122,62,31,93
12932,FremontBridge,03/25/2014 08:00:00 PM,48,-122,39,21,60
12933,FremontBridge,03/25/2014 09:00:00 PM,48,-122,20,14,34
12934,FremontBridge,03/25/2014 10:00:00 PM,48,-122,10,11,21
12935,FremontBridge,03/25/2014 11:00:00 PM,48,-122,12,9,21
12936,FremontBridge,03/26/2014 12:00:00 AM,48,-122,7,2,9
12937,FremontBridge,03/26/2014 01:00:00 AM,48,-122,2,5,7
12938,FremontBridge,03/26/2014 02:00:00 AM,48,-122,2,1,3
12939,FremontBridge,03/26/2014 03:00:00 AM,48,-122,2,1,3
12940,FremontBridge,03/26/2014 04:00:00 AM,48,-122,1,1,2
12941,FremontBridge,03/26/2014 05:00:00 AM,48,-122,6,11,17
12942,FremontBridge,03/26/2014 06:00:00 AM,48,-122,18,57,75
12943,FremontBridge,03/26/2014 07:00:00 AM,48,-122,61,153,214
12944,FremontBridge,03/26/2014 08:00:00 AM,48,-122,109,249,358
12945,FremontBridge,03/26/2014 09:00:00 AM,48,-122,89,150,239
12946,FremontBridge,03/26/2014 10:00:00 AM,48,-122,29,51,80
12947,FremontBridge,03/26/2014 11:00:00 AM,48,-122,20,27,47
12948,FremontBridge,03/26/2014 12:00:00 PM,48,-122,28,17,45
12949,FremontBridge,03/26/2014 01:00:00 PM,48,-122,23,37,60
12950,FremontBridge,03/26/2014 02:00:00 PM,48,-122,33,32,65
12951,FremontBridge,03/26/2014 03:00:00 PM,48,-122,48,40,88
12952,FremontBridge,03/26/2014 04:00:00 PM,48,-122,78,60,138
12953,FremontBridge,03/26/2014 05:00:00 PM,48,-122,255,77,332
12954,FremontBridge,03/26/2014 06:00:00 PM,48,-122,205,86,291
12955,FremontBridge,03/26/2014 07:00:00 PM,48,-122,80,48,128
12956,FremontBridge,03/26/2014 08:00:00 PM,48,-122,40,18,58
12957,FremontBridge,03/26/2014 09:00:00 PM,48,-122,14,13,27
12958,FremontBridge,03/26/2014 10:00:00 PM,48,-122,17,11,28
12959,FremontBridge,03/26/2014 11:00:00 PM,48,-122,12,20,32
12960,FremontBridge,03/27/2014 12:00:00 AM,48,-122,5,4,9
12961,FremontBridge,03/27/2014 01:00:00 AM,48,-122,7,1,8
12962,FremontBridge,03/27/2014 02:00:00 AM,48,-122,1,2,3
12963,FremontBridge,03/27/2014 03:00:00 AM,48,-122,2,2,4
12964,FremontBridge,03/27/2014 04:00:00 AM,48,-122,2,3,5
12965,FremontBridge,03/27/2014 05:00:00 AM,48,-122,4,20,24
12966,FremontBridge,03/27/2014 06:00:00 AM,48,-122,19,54,73
12967,FremontBridge,03/27/2014 07:00:00 AM,48,-122,38,142,180
12968,FremontBridge,03/27/2014 08:00:00 AM,48,-122,74,240,314
12969,FremontBridge,03/27/2014 09:00:00 AM,48,-122,69,111,180
12970,FremontBridge,03/27/2014 10:00:00 AM,48,-122,27,48,75
12971,FremontBridge,03/27/2014 11:00:00 AM,48,-122,22,31,53
12972,FremontBridge,03/27/2014 12:00:00 PM,48,-122,23,21,44
12973,FremontBridge,03/27/2014 01:00:00 PM,48,-122,25,32,57
12974,FremontBridge,03/27/2014 02:00:00 PM,48,-122,37,44,81
12975,FremontBridge,03/27/2014 03:00:00 PM,48,-122,25,35,60
12976,FremontBridge,03/27/2014 04:00:00 PM,48,-122,113,66,179
12977,FremontBridge,03/27/2014 05:00:00 PM,48,-122,228,138,366
12978,FremontBridge,03/27/2014 06:00:00 PM,48,-122,183,99,282
12979,FremontBridge,03/27/2014 07:00:00 PM,48,-122,95,57,152
12980,FremontBridge,03/27/2014 08:00:00 PM,48,-122,46,39,85
12981,FremontBridge,03/27/2014 09:00:00 PM,48,-122,26,23,49
12982,FremontBridge,03/27/2014 10:00:00 PM,48,-122,30,16,46
12983,FremontBridge,03/27/2014 11:00:00 PM,48,-122,17,11,28
12984,FremontBridge,03/28/2014 12:00:00 AM,48,-122,8,3,11
12985,FremontBridge,03/28/2014 01:00:00 AM,48,-122,8,4,12
12986,FremontBridge,03/28/2014 02:00:00 AM,48,-122,4,1,5
12987,FremontBridge,03/28/2014 03:00:00 AM,48,-122,3,2,5
12988,FremontBridge,03/28/2014 04:00:00 AM,48,-122,4,2,6
12989,FremontBridge,03/28/2014 05:00:00 AM,48,-122,7,13,20
12990,FremontBridge,03/28/2014 06:00:00 AM,48,-122,23,47,70
12991,FremontBridge,03/28/2014 07:00:00 AM,48,-122,33,96,129
12992,FremontBridge,03/28/2014 08:00:00 AM,48,-122,47,123,170
12993,FremontBridge,03/28/2014 09:00:00 AM,48,-122,64,95,159
12994,FremontBridge,03/28/2014 10:00:00 AM,48,-122,14,37,51
12995,FremontBridge,03/28/2014 11:00:00 AM,48,-122,14,24,38
12996,FremontBridge,03/28/2014 12:00:00 PM,48,-122,14,15,29
12997,FremontBridge,03/28/2014 01:00:00 PM,48,-122,15,22,37
12998,FremontBridge,03/28/2014 02:00:00 PM,48,-122,22,17,39
12999,FremontBridge,03/28/2014 03:00:00 PM,48,-122,30,23,53
13000,FremontBridge,03/28/2014 04:00:00 PM,48,-122,69,45,114
13001,FremontBridge,03/28/2014 05:00:00 PM,48,-122,147,75,222
13002,FremontBridge,03/28/2014 06:00:00 PM,48,-122,109,54,163
13003,FremontBridge,03/28/2014 07:00:00 PM,48,-122,51,34,85
13004,FremontBridge,03/28/2014 08:00:00 PM,48,-122,26,22,48
13005,FremontBridge,03/28/2014 09:00:00 PM,48,-122,12,8,20
13006,FremontBridge,03/28/2014 10:00:00 PM,48,-122,13,10,23
13007,FremontBridge,03/28/2014 11:00:00 PM,48,-122,9,7,16
13008,FremontBridge,03/29/2014 12:00:00 AM,48,-122,4,7,11
13009,FremontBridge,03/29/2014 01:00:00 AM,48,-122,6,1,7
13010,FremontBridge,03/29/2014 02:00:00 AM,48,-122,1,1,2
13011,FremontBridge,03/29/2014 03:00:00 AM,48,-122,1,1,2
13012,FremontBridge,03/29/2014 04:00:00 AM,48,-122,2,0,2
13013,FremontBridge,03/29/2014 05:00:00 AM,48,-122,4,3,7
13014,FremontBridge,03/29/2014 06:00:00 AM,48,-122,6,10,16
13015,FremontBridge,03/29/2014 07:00:00 AM,48,-122,3,6,9
13016,FremontBridge,03/29/2014 08:00:00 AM,48,-122,11,14,25
13017,FremontBridge,03/29/2014 09:00:00 AM,48,-122,14,17,31
13018,FremontBridge,03/29/2014 10:00:00 AM,48,-122,12,19,31
13019,FremontBridge,03/29/2014 11:00:00 AM,48,-122,21,23,44
13020,FremontBridge,03/29/2014 12:00:00 PM,48,-122,21,35,56
13021,FremontBridge,03/29/2014 01:00:00 PM,48,-122,32,18,50
13022,FremontBridge,03/29/2014 02:00:00 PM,48,-122,20,26,46
13023,FremontBridge,03/29/2014 03:00:00 PM,48,-122,22,29,51
13024,FremontBridge,03/29/2014 04:00:00 PM,48,-122,22,24,46
13025,FremontBridge,03/29/2014 05:00:00 PM,48,-122,9,25,34
13026,FremontBridge,03/29/2014 06:00:00 PM,48,-122,12,12,24
13027,FremontBridge,03/29/2014 07:00:00 PM,48,-122,7,12,19
13028,FremontBridge,03/29/2014 08:00:00 PM,48,-122,11,7,18
13029,FremontBridge,03/29/2014 09:00:00 PM,48,-122,10,4,14
13030,FremontBridge,03/29/2014 10:00:00 PM,48,-122,4,7,11
13031,FremontBridge,03/29/2014 11:00:00 PM,48,-122,3,12,15
13032,FremontBridge,03/30/2014 12:00:00 AM,48,-122,1,6,7
13033,FremontBridge,03/30/2014 01:00:00 AM,48,-122,4,1,5
13034,FremontBridge,03/30/2014 02:00:00 AM,48,-122,1,2,3
13035,FremontBridge,03/30/2014 03:00:00 AM,48,-122,1,0,1
13036,FremontBridge,03/30/2014 04:00:00 AM,48,-122,2,2,4
13037,FremontBridge,03/30/2014 05:00:00 AM,48,-122,3,2,5
13038,FremontBridge,03/30/2014 06:00:00 AM,48,-122,2,5,7
13039,FremontBridge,03/30/2014 07:00:00 AM,48,-122,9,9,18
13040,FremontBridge,03/30/2014 08:00:00 AM,48,-122,16,25,41
13041,FremontBridge,03/30/2014 09:00:00 AM,48,-122,21,31,52
13042,FremontBridge,03/30/2014 10:00:00 AM,48,-122,20,45,65
13043,FremontBridge,03/30/2014 11:00:00 AM,48,-122,32,49,81
13044,FremontBridge,03/30/2014 12:00:00 PM,48,-122,29,73,102
13045,FremontBridge,03/30/2014 01:00:00 PM,48,-122,45,83,128
13046,FremontBridge,03/30/2014 02:00:00 PM,48,-122,65,84,149
13047,FremontBridge,03/30/2014 03:00:00 PM,48,-122,67,97,164
13048,FremontBridge,03/30/2014 04:00:00 PM,48,-122,96,102,198
13049,FremontBridge,03/30/2014 05:00:00 PM,48,-122,40,67,107
13050,FremontBridge,03/30/2014 06:00:00 PM,48,-122,37,40,77
13051,FremontBridge,03/30/2014 07:00:00 PM,48,-122,12,23,35
13052,FremontBridge,03/30/2014 08:00:00 PM,48,-122,15,14,29
13053,FremontBridge,03/30/2014 09:00:00 PM,48,-122,7,7,14
13054,FremontBridge,03/30/2014 10:00:00 PM,48,-122,10,7,17
13055,FremontBridge,03/30/2014 11:00:00 PM,48,-122,7,4,11
13056,FremontBridge,03/31/2014 12:00:00 AM,48,-122,3,2,5
13057,FremontBridge,03/31/2014 01:00:00 AM,48,-122,2,1,3
13058,FremontBridge,03/31/2014 02:00:00 AM,48,-122,1,2,3
13059,FremontBridge,03/31/2014 03:00:00 AM,48,-122,1,1,2
13060,FremontBridge,03/31/2014 04:00:00 AM,48,-122,2,2,4
13061,FremontBridge,03/31/2014 05:00:00 AM,48,-122,5,15,20
13062,FremontBridge,03/31/2014 06:00:00 AM,48,-122,34,65,99
13063,FremontBridge,03/31/2014 07:00:00 AM,48,-122,79,197,276
13064,FremontBridge,03/31/2014 08:00:00 AM,48,-122,150,319,469
13065,FremontBridge,03/31/2014 09:00:00 AM,48,-122,103,193,296
13066,FremontBridge,03/31/2014 10:00:00 AM,48,-122,40,57,97
13067,FremontBridge,03/31/2014 11:00:00 AM,48,-122,31,45,76
13068,FremontBridge,03/31/2014 12:00:00 PM,48,-122,52,47,99
13069,FremontBridge,03/31/2014 01:00:00 PM,48,-122,47,53,100
13070,FremontBridge,03/31/2014 02:00:00 PM,48,-122,61,39,100
13071,FremontBridge,03/31/2014 03:00:00 PM,48,-122,77,52,129
13072,FremontBridge,03/31/2014 04:00:00 PM,48,-122,152,94,246
13073,FremontBridge,03/31/2014 05:00:00 PM,48,-122,359,200,559
13074,FremontBridge,03/31/2014 06:00:00 PM,48,-122,282,145,427
13075,FremontBridge,03/31/2014 07:00:00 PM,48,-122,131,98,229
13076,FremontBridge,03/31/2014 08:00:00 PM,48,-122,58,38,96
13077,FremontBridge,03/31/2014 09:00:00 PM,48,-122,25,25,50
13078,FremontBridge,03/31/2014 10:00:00 PM,48,-122,17,12,29
13079,FremontBridge,03/31/2014 11:00:00 PM,48,-122,12,10,22
13080,FremontBridge,04/01/2014 12:00:00 AM,48,-122,13,5,18
13081,FremontBridge,04/01/2014 01:00:00 AM,48,-122,3,0,3
13082,FremontBridge,04/01/2014 02:00:00 AM,48,-122,8,0,8
13083,FremontBridge,04/01/2014 03:00:00 AM,48,-122,0,1,1
13084,FremontBridge,04/01/2014 04:00:00 AM,48,-122,1,1,2
13085,FremontBridge,04/01/2014 05:00:00 AM,48,-122,9,14,23
13086,FremontBridge,04/01/2014 06:00:00 AM,48,-122,30,92,122
13087,FremontBridge,04/01/2014 07:00:00 AM,48,-122,85,245,330
13088,FremontBridge,04/01/2014 08:00:00 AM,48,-122,134,344,478
13089,FremontBridge,04/01/2014 09:00:00 AM,48,-122,100,194,294
13090,FremontBridge,04/01/2014 10:00:00 AM,48,-122,56,62,118
13091,FremontBridge,04/01/2014 11:00:00 AM,48,-122,32,48,80
13092,FremontBridge,04/01/2014 12:00:00 PM,48,-122,27,41,68
13093,FremontBridge,04/01/2014 01:00:00 PM,48,-122,41,48,89
13094,FremontBridge,04/01/2014 02:00:00 PM,48,-122,51,54,105
13095,FremontBridge,04/01/2014 03:00:00 PM,48,-122,90,80,170
13096,FremontBridge,04/01/2014 04:00:00 PM,48,-122,168,93,261
13097,FremontBridge,04/01/2014 05:00:00 PM,48,-122,395,206,601
13098,FremontBridge,04/01/2014 06:00:00 PM,48,-122,330,179,509
13099,FremontBridge,04/01/2014 07:00:00 PM,48,-122,142,99,241
13100,FremontBridge,04/01/2014 08:00:00 PM,48,-122,65,59,124
13101,FremontBridge,04/01/2014 09:00:00 PM,48,-122,35,35,70
13102,FremontBridge,04/01/2014 10:00:00 PM,48,-122,24,18,42
13103,FremontBridge,04/01/2014 11:00:00 PM,48,-122,16,18,34
13104,FremontBridge,04/02/2014 12:00:00 AM,48,-122,3,5,8
13105,FremontBridge,04/02/2014 01:00:00 AM,48,-122,3,8,11
13106,FremontBridge,04/02/2014 02:00:00 AM,48,-122,2,1,3
13107,FremontBridge,04/02/2014 03:00:00 AM,48,-122,0,2,2
13108,FremontBridge,04/02/2014 04:00:00 AM,48,-122,2,5,7
13109,FremontBridge,04/02/2014 05:00:00 AM,48,-122,7,18,25
13110,FremontBridge,04/02/2014 06:00:00 AM,48,-122,26,86,112
13111,FremontBridge,04/02/2014 07:00:00 AM,48,-122,83,223,306
13112,FremontBridge,04/02/2014 08:00:00 AM,48,-122,132,342,474
13113,FremontBridge,04/02/2014 09:00:00 AM,48,-122,96,199,295
13114,FremontBridge,04/02/2014 10:00:00 AM,48,-122,53,75,128
13115,FremontBridge,04/02/2014 11:00:00 AM,48,-122,26,40,66
13116,FremontBridge,04/02/2014 12:00:00 PM,48,-122,48,43,91
13117,FremontBridge,04/02/2014 01:00:00 PM,48,-122,43,57,100
13118,FremontBridge,04/02/2014 02:00:00 PM,48,-122,53,60,113
13119,FremontBridge,04/02/2014 03:00:00 PM,48,-122,68,70,138
13120,FremontBridge,04/02/2014 04:00:00 PM,48,-122,159,100,259
13121,FremontBridge,04/02/2014 05:00:00 PM,48,-122,373,203,576
13122,FremontBridge,04/02/2014 06:00:00 PM,48,-122,287,187,474
13123,FremontBridge,04/02/2014 07:00:00 PM,48,-122,117,85,202
13124,FremontBridge,04/02/2014 08:00:00 PM,48,-122,66,67,133
13125,FremontBridge,04/02/2014 09:00:00 PM,48,-122,43,38,81
13126,FremontBridge,04/02/2014 10:00:00 PM,48,-122,31,20,51
13127,FremontBridge,04/02/2014 11:00:00 PM,48,-122,4,13,17
13128,FremontBridge,04/03/2014 12:00:00 AM,48,-122,14,8,22
13129,FremontBridge,04/03/2014 01:00:00 AM,48,-122,4,3,7
13130,FremontBridge,04/03/2014 02:00:00 AM,48,-122,1,1,2
13131,FremontBridge,04/03/2014 03:00:00 AM,48,-122,1,1,2
13132,FremontBridge,04/03/2014 04:00:00 AM,48,-122,1,1,2
13133,FremontBridge,04/03/2014 05:00:00 AM,48,-122,8,10,18
13134,FremontBridge,04/03/2014 06:00:00 AM,48,-122,21,66,87
13135,FremontBridge,04/03/2014 07:00:00 AM,48,-122,74,189,263
13136,FremontBridge,04/03/2014 08:00:00 AM,48,-122,111,233,344
13137,FremontBridge,04/03/2014 09:00:00 AM,48,-122,94,166,260
13138,FremontBridge,04/03/2014 10:00:00 AM,48,-122,54,64,118
13139,FremontBridge,04/03/2014 11:00:00 AM,48,-122,37,50,87
13140,FremontBridge,04/03/2014 12:00:00 PM,48,-122,33,43,76
13141,FremontBridge,04/03/2014 01:00:00 PM,48,-122,32,39,71
13142,FremontBridge,04/03/2014 02:00:00 PM,48,-122,34,43,77
13143,FremontBridge,04/03/2014 03:00:00 PM,48,-122,34,44,78
13144,FremontBridge,04/03/2014 04:00:00 PM,48,-122,119,66,185
13145,FremontBridge,04/03/2014 05:00:00 PM,48,-122,214,81,295
13146,FremontBridge,04/03/2014 06:00:00 PM,48,-122,217,87,304
13147,FremontBridge,04/03/2014 07:00:00 PM,48,-122,95,58,153
13148,FremontBridge,04/03/2014 08:00:00 PM,48,-122,37,30,67
13149,FremontBridge,04/03/2014 09:00:00 PM,48,-122,33,21,54
13150,FremontBridge,04/03/2014 10:00:00 PM,48,-122,19,11,30
13151,FremontBridge,04/03/2014 11:00:00 PM,48,-122,10,11,21
13152,FremontBridge,04/04/2014 12:00:00 AM,48,-122,5,3,8
13153,FremontBridge,04/04/2014 01:00:00 AM,48,-122,2,2,4
13154,FremontBridge,04/04/2014 02:00:00 AM,48,-122,1,2,3
13155,FremontBridge,04/04/2014 03:00:00 AM,48,-122,1,2,3
13156,FremontBridge,04/04/2014 04:00:00 AM,48,-122,4,1,5
13157,FremontBridge,04/04/2014 05:00:00 AM,48,-122,7,11,18
13158,FremontBridge,04/04/2014 06:00:00 AM,48,-122,22,51,73
13159,FremontBridge,04/04/2014 07:00:00 AM,48,-122,56,143,199
13160,FremontBridge,04/04/2014 08:00:00 AM,48,-122,99,257,356
13161,FremontBridge,04/04/2014 09:00:00 AM,48,-122,99,159,258
13162,FremontBridge,04/04/2014 10:00:00 AM,48,-122,49,55,104
13163,FremontBridge,04/04/2014 11:00:00 AM,48,-122,34,47,81
13164,FremontBridge,04/04/2014 12:00:00 PM,48,-122,38,35,73
13165,FremontBridge,04/04/2014 01:00:00 PM,48,-122,36,40,76
13166,FremontBridge,04/04/2014 02:00:00 PM,48,-122,54,54,108
13167,FremontBridge,04/04/2014 03:00:00 PM,48,-122,78,61,139
13168,FremontBridge,04/04/2014 04:00:00 PM,48,-122,119,91,210
13169,FremontBridge,04/04/2014 05:00:00 PM,48,-122,286,128,414
13170,FremontBridge,04/04/2014 06:00:00 PM,48,-122,190,117,307
13171,FremontBridge,04/04/2014 07:00:00 PM,48,-122,103,73,176
13172,FremontBridge,04/04/2014 08:00:00 PM,48,-122,46,32,78
13173,FremontBridge,04/04/2014 09:00:00 PM,48,-122,27,23,50
13174,FremontBridge,04/04/2014 10:00:00 PM,48,-122,27,15,42
13175,FremontBridge,04/04/2014 11:00:00 PM,48,-122,19,13,32
13176,FremontBridge,04/05/2014 12:00:00 AM,48,-122,8,11,19
13177,FremontBridge,04/05/2014 01:00:00 AM,48,-122,4,7,11
13178,FremontBridge,04/05/2014 02:00:00 AM,48,-122,7,7,14
13179,FremontBridge,04/05/2014 03:00:00 AM,48,-122,5,1,6
13180,FremontBridge,04/05/2014 04:00:00 AM,48,-122,0,1,1
13181,FremontBridge,04/05/2014 05:00:00 AM,48,-122,2,6,8
13182,FremontBridge,04/05/2014 06:00:00 AM,48,-122,8,13,21
13183,FremontBridge,04/05/2014 07:00:00 AM,48,-122,10,8,18
13184,FremontBridge,04/05/2014 08:00:00 AM,48,-122,24,34,58
13185,FremontBridge,04/05/2014 09:00:00 AM,48,-122,51,44,95
13186,FremontBridge,04/05/2014 10:00:00 AM,48,-122,56,84,140
13187,FremontBridge,04/05/2014 11:00:00 AM,48,-122,39,46,85
13188,FremontBridge,04/05/2014 12:00:00 PM,48,-122,37,46,83
13189,FremontBridge,04/05/2014 01:00:00 PM,48,-122,35,47,82
13190,FremontBridge,04/05/2014 02:00:00 PM,48,-122,36,45,81
13191,FremontBridge,04/05/2014 03:00:00 PM,48,-122,32,44,76
13192,FremontBridge,04/05/2014 04:00:00 PM,48,-122,30,26,56
13193,FremontBridge,04/05/2014 05:00:00 PM,48,-122,25,19,44
13194,FremontBridge,04/05/2014 06:00:00 PM,48,-122,17,20,37
13195,FremontBridge,04/05/2014 07:00:00 PM,48,-122,18,23,41
13196,FremontBridge,04/05/2014 08:00:00 PM,48,-122,10,14,24
13197,FremontBridge,04/05/2014 09:00:00 PM,48,-122,7,8,15
13198,FremontBridge,04/05/2014 10:00:00 PM,48,-122,7,6,13
13199,FremontBridge,04/05/2014 11:00:00 PM,48,-122,7,9,16
13200,FremontBridge,04/06/2014 12:00:00 AM,48,-122,3,4,7
13201,FremontBridge,04/06/2014 01:00:00 AM,48,-122,4,4,8
13202,FremontBridge,04/06/2014 02:00:00 AM,48,-122,1,1,2
13203,FremontBridge,04/06/2014 03:00:00 AM,48,-122,4,1,5
13204,FremontBridge,04/06/2014 04:00:00 AM,48,-122,1,3,4
13205,FremontBridge,04/06/2014 05:00:00 AM,48,-122,4,4,8
13206,FremontBridge,04/06/2014 06:00:00 AM,48,-122,5,7,12
13207,FremontBridge,04/06/2014 07:00:00 AM,48,-122,7,19,26
13208,FremontBridge,04/06/2014 08:00:00 AM,48,-122,15,36,51
13209,FremontBridge,04/06/2014 09:00:00 AM,48,-122,35,38,73
13210,FremontBridge,04/06/2014 10:00:00 AM,48,-122,35,65,100
13211,FremontBridge,04/06/2014 11:00:00 AM,48,-122,53,60,113
13212,FremontBridge,04/06/2014 12:00:00 PM,48,-122,72,86,158
13213,FremontBridge,04/06/2014 01:00:00 PM,48,-122,80,87,167
13214,FremontBridge,04/06/2014 02:00:00 PM,48,-122,65,129,194
13215,FremontBridge,04/06/2014 03:00:00 PM,48,-122,59,112,171
13216,FremontBridge,04/06/2014 04:00:00 PM,48,-122,60,68,128
13217,FremontBridge,04/06/2014 05:00:00 PM,48,-122,48,56,104
13218,FremontBridge,04/06/2014 06:00:00 PM,48,-122,40,53,93
13219,FremontBridge,04/06/2014 07:00:00 PM,48,-122,26,24,50
13220,FremontBridge,04/06/2014 08:00:00 PM,48,-122,9,18,27
13221,FremontBridge,04/06/2014 09:00:00 PM,48,-122,14,8,22
13222,FremontBridge,04/06/2014 10:00:00 PM,48,-122,6,7,13
13223,FremontBridge,04/06/2014 11:00:00 PM,48,-122,1,6,7
13224,FremontBridge,04/07/2014 12:00:00 AM,48,-122,8,3,11
13225,FremontBridge,04/07/2014 01:00:00 AM,48,-122,2,1,3
13226,FremontBridge,04/07/2014 02:00:00 AM,48,-122,0,1,1
13227,FremontBridge,04/07/2014 03:00:00 AM,48,-122,2,2,4
13228,FremontBridge,04/07/2014 04:00:00 AM,48,-122,0,3,3
13229,FremontBridge,04/07/2014 05:00:00 AM,48,-122,10,22,32
13230,FremontBridge,04/07/2014 06:00:00 AM,48,-122,36,73,109
13231,FremontBridge,04/07/2014 07:00:00 AM,48,-122,79,251,330
13232,FremontBridge,04/07/2014 08:00:00 AM,48,-122,164,342,506
13233,FremontBridge,04/07/2014 09:00:00 AM,48,-122,116,235,351
13234,FremontBridge,04/07/2014 10:00:00 AM,48,-122,54,75,129
13235,FremontBridge,04/07/2014 11:00:00 AM,48,-122,49,71,120
13236,FremontBridge,04/07/2014 12:00:00 PM,48,-122,38,73,111
13237,FremontBridge,04/07/2014 01:00:00 PM,48,-122,60,62,122
13238,FremontBridge,04/07/2014 02:00:00 PM,48,-122,74,71,145
13239,FremontBridge,04/07/2014 03:00:00 PM,48,-122,104,95,199
13240,FremontBridge,04/07/2014 04:00:00 PM,48,-122,205,140,345
13241,FremontBridge,04/07/2014 05:00:00 PM,48,-122,473,232,705
13242,FremontBridge,04/07/2014 06:00:00 PM,48,-122,380,211,591
13243,FremontBridge,04/07/2014 07:00:00 PM,48,-122,129,105,234
13244,FremontBridge,04/07/2014 08:00:00 PM,48,-122,61,64,125
13245,FremontBridge,04/07/2014 09:00:00 PM,48,-122,37,45,82
13246,FremontBridge,04/07/2014 10:00:00 PM,48,-122,24,16,40
13247,FremontBridge,04/07/2014 11:00:00 PM,48,-122,6,15,21
13248,FremontBridge,04/08/2014 12:00:00 AM,48,-122,8,7,15
13249,FremontBridge,04/08/2014 01:00:00 AM,48,-122,5,2,7
13250,FremontBridge,04/08/2014 02:00:00 AM,48,-122,1,1,2
13251,FremontBridge,04/08/2014 03:00:00 AM,48,-122,1,3,4
13252,FremontBridge,04/08/2014 04:00:00 AM,48,-122,1,1,2
13253,FremontBridge,04/08/2014 05:00:00 AM,48,-122,8,19,27
13254,FremontBridge,04/08/2014 06:00:00 AM,48,-122,26,61,87
13255,FremontBridge,04/08/2014 07:00:00 AM,48,-122,94,212,306
13256,FremontBridge,04/08/2014 08:00:00 AM,48,-122,128,323,451
13257,FremontBridge,04/08/2014 09:00:00 AM,48,-122,117,188,305
13258,FremontBridge,04/08/2014 10:00:00 AM,48,-122,50,62,112
13259,FremontBridge,04/08/2014 11:00:00 AM,48,-122,19,49,68
13260,FremontBridge,04/08/2014 12:00:00 PM,48,-122,28,42,70
13261,FremontBridge,04/08/2014 01:00:00 PM,48,-122,35,38,73
13262,FremontBridge,04/08/2014 02:00:00 PM,48,-122,36,31,67
13263,FremontBridge,04/08/2014 03:00:00 PM,48,-122,53,48,101
13264,FremontBridge,04/08/2014 04:00:00 PM,48,-122,103,54,157
13265,FremontBridge,04/08/2014 05:00:00 PM,48,-122,244,97,341
13266,FremontBridge,04/08/2014 06:00:00 PM,48,-122,213,83,296
13267,FremontBridge,04/08/2014 07:00:00 PM,48,-122,91,45,136
13268,FremontBridge,04/08/2014 08:00:00 PM,48,-122,40,31,71
13269,FremontBridge,04/08/2014 09:00:00 PM,48,-122,42,23,65
13270,FremontBridge,04/08/2014 10:00:00 PM,48,-122,15,11,26
13271,FremontBridge,04/08/2014 11:00:00 PM,48,-122,7,10,17
13272,FremontBridge,04/09/2014 12:00:00 AM,48,-122,6,1,7
13273,FremontBridge,04/09/2014 01:00:00 AM,48,-122,5,3,8
13274,FremontBridge,04/09/2014 02:00:00 AM,48,-122,0,1,1
13275,FremontBridge,04/09/2014 03:00:00 AM,48,-122,1,2,3
13276,FremontBridge,04/09/2014 04:00:00 AM,48,-122,2,4,6
13277,FremontBridge,04/09/2014 05:00:00 AM,48,-122,8,18,26
13278,FremontBridge,04/09/2014 06:00:00 AM,48,-122,26,87,113
13279,FremontBridge,04/09/2014 07:00:00 AM,48,-122,83,206,289
13280,FremontBridge,04/09/2014 08:00:00 AM,48,-122,144,328,472
13281,FremontBridge,04/09/2014 09:00:00 AM,48,-122,110,193,303
13282,FremontBridge,04/09/2014 10:00:00 AM,48,-122,61,102,163
13283,FremontBridge,04/09/2014 11:00:00 AM,48,-122,41,56,97
13284,FremontBridge,04/09/2014 12:00:00 PM,48,-122,39,57,96
13285,FremontBridge,04/09/2014 01:00:00 PM,48,-122,53,60,113
13286,FremontBridge,04/09/2014 02:00:00 PM,48,-122,35,56,91
13287,FremontBridge,04/09/2014 03:00:00 PM,48,-122,90,72,162
13288,FremontBridge,04/09/2014 04:00:00 PM,48,-122,159,111,270
13289,FremontBridge,04/09/2014 05:00:00 PM,48,-122,419,164,583
13290,FremontBridge,04/09/2014 06:00:00 PM,48,-122,334,178,512
13291,FremontBridge,04/09/2014 07:00:00 PM,48,-122,165,101,266
13292,FremontBridge,04/09/2014 08:00:00 PM,48,-122,64,52,116
13293,FremontBridge,04/09/2014 09:00:00 PM,48,-122,31,38,69
13294,FremontBridge,04/09/2014 10:00:00 PM,48,-122,22,19,41
13295,FremontBridge,04/09/2014 11:00:00 PM,48,-122,16,5,21
13296,FremontBridge,04/10/2014 12:00:00 AM,48,-122,10,8,18
13297,FremontBridge,04/10/2014 01:00:00 AM,48,-122,8,3,11
13298,FremontBridge,04/10/2014 02:00:00 AM,48,-122,3,2,5
13299,FremontBridge,04/10/2014 03:00:00 AM,48,-122,1,1,2
13300,FremontBridge,04/10/2014 04:00:00 AM,48,-122,1,1,2
13301,FremontBridge,04/10/2014 05:00:00 AM,48,-122,11,18,29
13302,FremontBridge,04/10/2014 06:00:00 AM,48,-122,33,69,102
13303,FremontBridge,04/10/2014 07:00:00 AM,48,-122,69,232,301
13304,FremontBridge,04/10/2014 08:00:00 AM,48,-122,150,352,502
13305,FremontBridge,04/10/2014 09:00:00 AM,48,-122,129,220,349
13306,FremontBridge,04/10/2014 10:00:00 AM,48,-122,54,96,150
13307,FremontBridge,04/10/2014 11:00:00 AM,48,-122,42,71,113
13308,FremontBridge,04/10/2014 12:00:00 PM,48,-122,78,73,151
13309,FremontBridge,04/10/2014 01:00:00 PM,48,-122,51,58,109
13310,FremontBridge,04/10/2014 02:00:00 PM,48,-122,61,66,127
13311,FremontBridge,04/10/2014 03:00:00 PM,48,-122,82,80,162
13312,FremontBridge,04/10/2014 04:00:00 PM,48,-122,160,101,261
13313,FremontBridge,04/10/2014 05:00:00 PM,48,-122,339,163,502
13314,FremontBridge,04/10/2014 06:00:00 PM,48,-122,317,200,517
13315,FremontBridge,04/10/2014 07:00:00 PM,48,-122,150,103,253
13316,FremontBridge,04/10/2014 08:00:00 PM,48,-122,62,56,118
13317,FremontBridge,04/10/2014 09:00:00 PM,48,-122,44,31,75
13318,FremontBridge,04/10/2014 10:00:00 PM,48,-122,29,14,43
13319,FremontBridge,04/10/2014 11:00:00 PM,48,-122,23,15,38
13320,FremontBridge,04/11/2014 12:00:00 AM,48,-122,13,5,18
13321,FremontBridge,04/11/2014 01:00:00 AM,48,-122,6,4,10
13322,FremontBridge,04/11/2014 02:00:00 AM,48,-122,5,3,8
13323,FremontBridge,04/11/2014 03:00:00 AM,48,-122,3,2,5
13324,FremontBridge,04/11/2014 04:00:00 AM,48,-122,1,4,5
13325,FremontBridge,04/11/2014 05:00:00 AM,48,-122,11,19,30
13326,FremontBridge,04/11/2014 06:00:00 AM,48,-122,28,56,84
13327,FremontBridge,04/11/2014 07:00:00 AM,48,-122,68,194,262
13328,FremontBridge,04/11/2014 08:00:00 AM,48,-122,119,319,438
13329,FremontBridge,04/11/2014 09:00:00 AM,48,-122,97,177,274
13330,FremontBridge,04/11/2014 10:00:00 AM,48,-122,63,70,133
13331,FremontBridge,04/11/2014 11:00:00 AM,48,-122,44,58,102
13332,FremontBridge,04/11/2014 12:00:00 PM,48,-122,40,54,94
13333,FremontBridge,04/11/2014 01:00:00 PM,48,-122,45,58,103
13334,FremontBridge,04/11/2014 02:00:00 PM,48,-122,62,58,120
13335,FremontBridge,04/11/2014 03:00:00 PM,48,-122,88,84,172
13336,FremontBridge,04/11/2014 04:00:00 PM,48,-122,186,111,297
13337,FremontBridge,04/11/2014 05:00:00 PM,48,-122,336,188,524
13338,FremontBridge,04/11/2014 06:00:00 PM,48,-122,250,145,395
13339,FremontBridge,04/11/2014 07:00:00 PM,48,-122,114,73,187
13340,FremontBridge,04/11/2014 08:00:00 PM,48,-122,42,31,73
13341,FremontBridge,04/11/2014 09:00:00 PM,48,-122,21,17,38
13342,FremontBridge,04/11/2014 10:00:00 PM,48,-122,24,14,38
13343,FremontBridge,04/11/2014 11:00:00 PM,48,-122,14,11,25
13344,FremontBridge,04/12/2014 12:00:00 AM,48,-122,9,6,15
13345,FremontBridge,04/12/2014 01:00:00 AM,48,-122,5,8,13
13346,FremontBridge,04/12/2014 02:00:00 AM,48,-122,7,6,13
13347,FremontBridge,04/12/2014 03:00:00 AM,48,-122,2,2,4
13348,FremontBridge,04/12/2014 04:00:00 AM,48,-122,1,0,1
13349,FremontBridge,04/12/2014 05:00:00 AM,48,-122,1,5,6
13350,FremontBridge,04/12/2014 06:00:00 AM,48,-122,11,4,15
13351,FremontBridge,04/12/2014 07:00:00 AM,48,-122,18,27,45
13352,FremontBridge,04/12/2014 08:00:00 AM,48,-122,37,52,89
13353,FremontBridge,04/12/2014 09:00:00 AM,48,-122,67,54,121
13354,FremontBridge,04/12/2014 10:00:00 AM,48,-122,72,91,163
13355,FremontBridge,04/12/2014 11:00:00 AM,48,-122,59,62,121
13356,FremontBridge,04/12/2014 12:00:00 PM,48,-122,60,100,160
13357,FremontBridge,04/12/2014 01:00:00 PM,48,-122,84,121,205
13358,FremontBridge,04/12/2014 02:00:00 PM,48,-122,90,93,183
13359,FremontBridge,04/12/2014 03:00:00 PM,48,-122,100,104,204
13360,FremontBridge,04/12/2014 04:00:00 PM,48,-122,88,98,186
13361,FremontBridge,04/12/2014 05:00:00 PM,48,-122,86,103,189
13362,FremontBridge,04/12/2014 06:00:00 PM,48,-122,77,69,146
13363,FremontBridge,04/12/2014 07:00:00 PM,48,-122,56,63,119
13364,FremontBridge,04/12/2014 08:00:00 PM,48,-122,19,29,48
13365,FremontBridge,04/12/2014 09:00:00 PM,48,-122,21,21,42
13366,FremontBridge,04/12/2014 10:00:00 PM,48,-122,28,32,60
13367,FremontBridge,04/12/2014 11:00:00 PM,48,-122,17,20,37
13368,FremontBridge,04/13/2014 12:00:00 AM,48,-122,8,11,19
13369,FremontBridge,04/13/2014 01:00:00 AM,48,-122,9,5,14
13370,FremontBridge,04/13/2014 02:00:00 AM,48,-122,6,8,14
13371,FremontBridge,04/13/2014 03:00:00 AM,48,-122,3,4,7
13372,FremontBridge,04/13/2014 04:00:00 AM,48,-122,2,0,2
13373,FremontBridge,04/13/2014 05:00:00 AM,48,-122,2,3,5
13374,FremontBridge,04/13/2014 06:00:00 AM,48,-122,8,5,13
13375,FremontBridge,04/13/2014 07:00:00 AM,48,-122,10,14,24
13376,FremontBridge,04/13/2014 08:00:00 AM,48,-122,30,36,66
13377,FremontBridge,04/13/2014 09:00:00 AM,48,-122,60,63,123
13378,FremontBridge,04/13/2014 10:00:00 AM,48,-122,57,100,157
13379,FremontBridge,04/13/2014 11:00:00 AM,48,-122,67,113,180
13380,FremontBridge,04/13/2014 12:00:00 PM,48,-122,95,128,223
13381,FremontBridge,04/13/2014 01:00:00 PM,48,-122,132,131,263
13382,FremontBridge,04/13/2014 02:00:00 PM,48,-122,139,165,304
13383,FremontBridge,04/13/2014 03:00:00 PM,48,-122,123,198,321
13384,FremontBridge,04/13/2014 04:00:00 PM,48,-122,123,156,279
13385,FremontBridge,04/13/2014 05:00:00 PM,48,-122,91,130,221
13386,FremontBridge,04/13/2014 06:00:00 PM,48,-122,82,82,164
13387,FremontBridge,04/13/2014 07:00:00 PM,48,-122,46,55,101
13388,FremontBridge,04/13/2014 08:00:00 PM,48,-122,30,36,66
13389,FremontBridge,04/13/2014 09:00:00 PM,48,-122,16,26,42
13390,FremontBridge,04/13/2014 10:00:00 PM,48,-122,17,6,23
13391,FremontBridge,04/13/2014 11:00:00 PM,48,-122,5,11,16
13392,FremontBridge,04/14/2014 12:00:00 AM,48,-122,9,2,11
13393,FremontBridge,04/14/2014 01:00:00 AM,48,-122,2,3,5
13394,FremontBridge,04/14/2014 02:00:00 AM,48,-122,3,0,3
13395,FremontBridge,04/14/2014 03:00:00 AM,48,-122,0,2,2
13396,FremontBridge,04/14/2014 04:00:00 AM,48,-122,0,3,3
13397,FremontBridge,04/14/2014 05:00:00 AM,48,-122,11,22,33
13398,FremontBridge,04/14/2014 06:00:00 AM,48,-122,36,73,109
13399,FremontBridge,04/14/2014 07:00:00 AM,48,-122,69,257,326
13400,FremontBridge,04/14/2014 08:00:00 AM,48,-122,160,358,518
13401,FremontBridge,04/14/2014 09:00:00 AM,48,-122,108,197,305
13402,FremontBridge,04/14/2014 10:00:00 AM,48,-122,56,82,138
13403,FremontBridge,04/14/2014 11:00:00 AM,48,-122,40,72,112
13404,FremontBridge,04/14/2014 12:00:00 PM,48,-122,57,57,114
13405,FremontBridge,04/14/2014 01:00:00 PM,48,-122,58,54,112
13406,FremontBridge,04/14/2014 02:00:00 PM,48,-122,62,73,135
13407,FremontBridge,04/14/2014 03:00:00 PM,48,-122,89,84,173
13408,FremontBridge,04/14/2014 04:00:00 PM,48,-122,183,106,289
13409,FremontBridge,04/14/2014 05:00:00 PM,48,-122,411,190,601
13410,FremontBridge,04/14/2014 06:00:00 PM,48,-122,338,209,547
13411,FremontBridge,04/14/2014 07:00:00 PM,48,-122,133,115,248
13412,FremontBridge,04/14/2014 08:00:00 PM,48,-122,52,44,96
13413,FremontBridge,04/14/2014 09:00:00 PM,48,-122,48,27,75
13414,FremontBridge,04/14/2014 10:00:00 PM,48,-122,21,8,29
13415,FremontBridge,04/14/2014 11:00:00 PM,48,-122,11,11,22
13416,FremontBridge,04/15/2014 12:00:00 AM,48,-122,8,6,14
13417,FremontBridge,04/15/2014 01:00:00 AM,48,-122,1,2,3
13418,FremontBridge,04/15/2014 02:00:00 AM,48,-122,0,5,5
13419,FremontBridge,04/15/2014 03:00:00 AM,48,-122,2,2,4
13420,FremontBridge,04/15/2014 04:00:00 AM,48,-122,0,4,4
13421,FremontBridge,04/15/2014 05:00:00 AM,48,-122,15,14,29
13422,FremontBridge,04/15/2014 06:00:00 AM,48,-122,26,64,90
13423,FremontBridge,04/15/2014 07:00:00 AM,48,-122,58,211,269
13424,FremontBridge,04/15/2014 08:00:00 AM,48,-122,128,302,430
13425,FremontBridge,04/15/2014 09:00:00 AM,48,-122,97,196,293
13426,FremontBridge,04/15/2014 10:00:00 AM,48,-122,61,56,117
13427,FremontBridge,04/15/2014 11:00:00 AM,48,-122,52,39,91
13428,FremontBridge,04/15/2014 12:00:00 PM,48,-122,37,51,88
13429,FremontBridge,04/15/2014 01:00:00 PM,48,-122,36,52,88
13430,FremontBridge,04/15/2014 02:00:00 PM,48,-122,42,52,94
13431,FremontBridge,04/15/2014 03:00:00 PM,48,-122,64,62,126
13432,FremontBridge,04/15/2014 04:00:00 PM,48,-122,115,78,193
13433,FremontBridge,04/15/2014 05:00:00 PM,48,-122,318,137,455
13434,FremontBridge,04/15/2014 06:00:00 PM,48,-122,257,136,393
13435,FremontBridge,04/15/2014 07:00:00 PM,48,-122,114,82,196
13436,FremontBridge,04/15/2014 08:00:00 PM,48,-122,59,41,100
13437,FremontBridge,04/15/2014 09:00:00 PM,48,-122,27,39,66
13438,FremontBridge,04/15/2014 10:00:00 PM,48,-122,19,12,31
13439,FremontBridge,04/15/2014 11:00:00 PM,48,-122,13,14,27
13440,FremontBridge,04/16/2014 12:00:00 AM,48,-122,5,8,13
13441,FremontBridge,04/16/2014 01:00:00 AM,48,-122,1,2,3
13442,FremontBridge,04/16/2014 02:00:00 AM,48,-122,3,4,7
13443,FremontBridge,04/16/2014 03:00:00 AM,48,-122,0,2,2
13444,FremontBridge,04/16/2014 04:00:00 AM,48,-122,3,0,3
13445,FremontBridge,04/16/2014 05:00:00 AM,48,-122,8,13,21
13446,FremontBridge,04/16/2014 06:00:00 AM,48,-122,21,46,67
13447,FremontBridge,04/16/2014 07:00:00 AM,48,-122,66,152,218
13448,FremontBridge,04/16/2014 08:00:00 AM,48,-122,83,206,289
13449,FremontBridge,04/16/2014 09:00:00 AM,48,-122,79,125,204
13450,FremontBridge,04/16/2014 10:00:00 AM,48,-122,29,49,78
13451,FremontBridge,04/16/2014 11:00:00 AM,48,-122,27,21,48
13452,FremontBridge,04/16/2014 12:00:00 PM,48,-122,22,25,47
13453,FremontBridge,04/16/2014 01:00:00 PM,48,-122,22,35,57
13454,FremontBridge,04/16/2014 02:00:00 PM,48,-122,31,27,58
13455,FremontBridge,04/16/2014 03:00:00 PM,48,-122,38,28,66
13456,FremontBridge,04/16/2014 04:00:00 PM,48,-122,66,44,110
13457,FremontBridge,04/16/2014 05:00:00 PM,48,-122,223,98,321
13458,FremontBridge,04/16/2014 06:00:00 PM,48,-122,182,78,260
13459,FremontBridge,04/16/2014 07:00:00 PM,48,-122,61,63,124
13460,FremontBridge,04/16/2014 08:00:00 PM,48,-122,46,5,51
13461,FremontBridge,04/16/2014 09:00:00 PM,48,-122,32,18,50
13462,FremontBridge,04/16/2014 10:00:00 PM,48,-122,10,12,22
13463,FremontBridge,04/16/2014 11:00:00 PM,48,-122,7,7,14
13464,FremontBridge,04/17/2014 12:00:00 AM,48,-122,2,2,4
13465,FremontBridge,04/17/2014 01:00:00 AM,48,-122,2,3,5
13466,FremontBridge,04/17/2014 02:00:00 AM,48,-122,0,0,0
13467,FremontBridge,04/17/2014 03:00:00 AM,48,-122,0,1,1
13468,FremontBridge,04/17/2014 04:00:00 AM,48,-122,0,1,1
13469,FremontBridge,04/17/2014 05:00:00 AM,48,-122,6,11,17
13470,FremontBridge,04/17/2014 06:00:00 AM,48,-122,22,42,64
13471,FremontBridge,04/17/2014 07:00:00 AM,48,-122,59,135,194
13472,FremontBridge,04/17/2014 08:00:00 AM,48,-122,66,178,244
13473,FremontBridge,04/17/2014 09:00:00 AM,48,-122,64,98,162
13474,FremontBridge,04/17/2014 10:00:00 AM,48,-122,24,46,70
13475,FremontBridge,04/17/2014 11:00:00 AM,48,-122,12,18,30
13476,FremontBridge,04/17/2014 12:00:00 PM,48,-122,22,22,44
13477,FremontBridge,04/17/2014 01:00:00 PM,48,-122,19,16,35
13478,FremontBridge,04/17/2014 02:00:00 PM,48,-122,26,18,44
13479,FremontBridge,04/17/2014 03:00:00 PM,48,-122,27,29,56
13480,FremontBridge,04/17/2014 04:00:00 PM,48,-122,56,39,95
13481,FremontBridge,04/17/2014 05:00:00 PM,48,-122,166,71,237
13482,FremontBridge,04/17/2014 06:00:00 PM,48,-122,151,60,211
13483,FremontBridge,04/17/2014 07:00:00 PM,48,-122,70,43,113
13484,FremontBridge,04/17/2014 08:00:00 PM,48,-122,40,18,58
13485,FremontBridge,04/17/2014 09:00:00 PM,48,-122,19,12,31
13486,FremontBridge,04/17/2014 10:00:00 PM,48,-122,7,14,21
13487,FremontBridge,04/17/2014 11:00:00 PM,48,-122,7,6,13
13488,FremontBridge,04/18/2014 12:00:00 AM,48,-122,3,1,4
13489,FremontBridge,04/18/2014 01:00:00 AM,48,-122,2,1,3
13490,FremontBridge,04/18/2014 02:00:00 AM,48,-122,1,1,2
13491,FremontBridge,04/18/2014 03:00:00 AM,48,-122,2,0,2
13492,FremontBridge,04/18/2014 04:00:00 AM,48,-122,2,1,3
13493,FremontBridge,04/18/2014 05:00:00 AM,48,-122,8,12,20
13494,FremontBridge,04/18/2014 06:00:00 AM,48,-122,26,41,67
13495,FremontBridge,04/18/2014 07:00:00 AM,48,-122,57,148,205
13496,FremontBridge,04/18/2014 08:00:00 AM,48,-122,112,241,353
13497,FremontBridge,04/18/2014 09:00:00 AM,48,-122,105,142,247
13498,FremontBridge,04/18/2014 10:00:00 AM,48,-122,46,69,115
13499,FremontBridge,04/18/2014 11:00:00 AM,48,-122,39,66,105
13500,FremontBridge,04/18/2014 12:00:00 PM,48,-122,50,49,99
13501,FremontBridge,04/18/2014 01:00:00 PM,48,-122,46,61,107
13502,FremontBridge,04/18/2014 02:00:00 PM,48,-122,72,54,126
13503,FremontBridge,04/18/2014 03:00:00 PM,48,-122,69,57,126
13504,FremontBridge,04/18/2014 04:00:00 PM,48,-122,135,88,223
13505,FremontBridge,04/18/2014 05:00:00 PM,48,-122,270,123,393
13506,FremontBridge,04/18/2014 06:00:00 PM,48,-122,221,129,350
13507,FremontBridge,04/18/2014 07:00:00 PM,48,-122,97,91,188
13508,FremontBridge,04/18/2014 08:00:00 PM,48,-122,45,53,98
13509,FremontBridge,04/18/2014 09:00:00 PM,48,-122,27,12,39
13510,FremontBridge,04/18/2014 10:00:00 PM,48,-122,16,16,32
13511,FremontBridge,04/18/2014 11:00:00 PM,48,-122,17,6,23
13512,FremontBridge,04/19/2014 12:00:00 AM,48,-122,6,12,18
13513,FremontBridge,04/19/2014 01:00:00 AM,48,-122,5,11,16
13514,FremontBridge,04/19/2014 02:00:00 AM,48,-122,3,3,6
13515,FremontBridge,04/19/2014 03:00:00 AM,48,-122,3,2,5
13516,FremontBridge,04/19/2014 04:00:00 AM,48,-122,0,1,1
13517,FremontBridge,04/19/2014 05:00:00 AM,48,-122,3,3,6
13518,FremontBridge,04/19/2014 06:00:00 AM,48,-122,10,5,15
13519,FremontBridge,04/19/2014 07:00:00 AM,48,-122,25,23,48
13520,FremontBridge,04/19/2014 08:00:00 AM,48,-122,22,36,58
13521,FremontBridge,04/19/2014 09:00:00 AM,48,-122,52,54,106
13522,FremontBridge,04/19/2014 10:00:00 AM,48,-122,39,77,116
13523,FremontBridge,04/19/2014 11:00:00 AM,48,-122,41,61,102
13524,FremontBridge,04/19/2014 12:00:00 PM,48,-122,19,33,52
13525,FremontBridge,04/19/2014 01:00:00 PM,48,-122,32,15,47
13526,FremontBridge,04/19/2014 02:00:00 PM,48,-122,21,11,32
13527,FremontBridge,04/19/2014 03:00:00 PM,48,-122,15,14,29
13528,FremontBridge,04/19/2014 04:00:00 PM,48,-122,27,20,47
13529,FremontBridge,04/19/2014 05:00:00 PM,48,-122,12,17,29
13530,FremontBridge,04/19/2014 06:00:00 PM,48,-122,19,31,50
13531,FremontBridge,04/19/2014 07:00:00 PM,48,-122,20,12,32
13532,FremontBridge,04/19/2014 08:00:00 PM,48,-122,17,19,36
13533,FremontBridge,04/19/2014 09:00:00 PM,48,-122,11,14,25
13534,FremontBridge,04/19/2014 10:00:00 PM,48,-122,11,6,17
13535,FremontBridge,04/19/2014 11:00:00 PM,48,-122,4,9,13
13536,FremontBridge,04/20/2014 12:00:00 AM,48,-122,8,7,15
13537,FremontBridge,04/20/2014 01:00:00 AM,48,-122,5,1,6
13538,FremontBridge,04/20/2014 02:00:00 AM,48,-122,2,2,4
13539,FremontBridge,04/20/2014 03:00:00 AM,48,-122,6,0,6
13540,FremontBridge,04/20/2014 04:00:00 AM,48,-122,1,3,4
13541,FremontBridge,04/20/2014 05:00:00 AM,48,-122,1,5,6
13542,FremontBridge,04/20/2014 06:00:00 AM,48,-122,8,12,20
13543,FremontBridge,04/20/2014 07:00:00 AM,48,-122,10,11,21
13544,FremontBridge,04/20/2014 08:00:00 AM,48,-122,19,19,38
13545,FremontBridge,04/20/2014 09:00:00 AM,48,-122,29,41,70
13546,FremontBridge,04/20/2014 10:00:00 AM,48,-122,40,41,81
13547,FremontBridge,04/20/2014 11:00:00 AM,48,-122,69,60,129
13548,FremontBridge,04/20/2014 12:00:00 PM,48,-122,60,82,142
13549,FremontBridge,04/20/2014 01:00:00 PM,48,-122,107,94,201
13550,FremontBridge,04/20/2014 02:00:00 PM,48,-122,89,97,186
13551,FremontBridge,04/20/2014 03:00:00 PM,48,-122,92,102,194
13552,FremontBridge,04/20/2014 04:00:00 PM,48,-122,79,104,183
13553,FremontBridge,04/20/2014 05:00:00 PM,48,-122,56,71,127
13554,FremontBridge,04/20/2014 06:00:00 PM,48,-122,48,63,111
13555,FremontBridge,04/20/2014 07:00:00 PM,48,-122,37,47,84
13556,FremontBridge,04/20/2014 08:00:00 PM,48,-122,24,20,44
13557,FremontBridge,04/20/2014 09:00:00 PM,48,-122,15,9,24
13558,FremontBridge,04/20/2014 10:00:00 PM,48,-122,13,5,18
13559,FremontBridge,04/20/2014 11:00:00 PM,48,-122,8,12,20
13560,FremontBridge,04/21/2014 12:00:00 AM,48,-122,2,4,6
13561,FremontBridge,04/21/2014 01:00:00 AM,48,-122,1,5,6
13562,FremontBridge,04/21/2014 02:00:00 AM,48,-122,3,1,4
13563,FremontBridge,04/21/2014 03:00:00 AM,48,-122,0,2,2
13564,FremontBridge,04/21/2014 04:00:00 AM,48,-122,1,3,4
13565,FremontBridge,04/21/2014 05:00:00 AM,48,-122,16,17,33
13566,FremontBridge,04/21/2014 06:00:00 AM,48,-122,36,60,96
13567,FremontBridge,04/21/2014 07:00:00 AM,48,-122,70,215,285
13568,FremontBridge,04/21/2014 08:00:00 AM,48,-122,114,341,455
13569,FremontBridge,04/21/2014 09:00:00 AM,48,-122,121,188,309
13570,FremontBridge,04/21/2014 10:00:00 AM,48,-122,45,73,118
13571,FremontBridge,04/21/2014 11:00:00 AM,48,-122,30,57,87
13572,FremontBridge,04/21/2014 12:00:00 PM,48,-122,40,55,95
13573,FremontBridge,04/21/2014 01:00:00 PM,48,-122,48,51,99
13574,FremontBridge,04/21/2014 02:00:00 PM,48,-122,50,51,101
13575,FremontBridge,04/21/2014 03:00:00 PM,48,-122,78,60,138
13576,FremontBridge,04/21/2014 04:00:00 PM,48,-122,147,107,254
13577,FremontBridge,04/21/2014 05:00:00 PM,48,-122,366,165,531
13578,FremontBridge,04/21/2014 06:00:00 PM,48,-122,294,146,440
13579,FremontBridge,04/21/2014 07:00:00 PM,48,-122,107,71,178
13580,FremontBridge,04/21/2014 08:00:00 PM,48,-122,44,24,68
13581,FremontBridge,04/21/2014 09:00:00 PM,48,-122,22,22,44
13582,FremontBridge,04/21/2014 10:00:00 PM,48,-122,14,17,31
13583,FremontBridge,04/21/2014 11:00:00 PM,48,-122,12,5,17
13584,FremontBridge,04/22/2014 12:00:00 AM,48,-122,2,1,3
13585,FremontBridge,04/22/2014 01:00:00 AM,48,-122,2,0,2
13586,FremontBridge,04/22/2014 02:00:00 AM,48,-122,0,3,3
13587,FremontBridge,04/22/2014 03:00:00 AM,48,-122,0,1,1
13588,FremontBridge,04/22/2014 04:00:00 AM,48,-122,1,1,2
13589,FremontBridge,04/22/2014 05:00:00 AM,48,-122,6,11,17
13590,FremontBridge,04/22/2014 06:00:00 AM,48,-122,39,32,71
13591,FremontBridge,04/22/2014 07:00:00 AM,48,-122,28,128,156
13592,FremontBridge,04/22/2014 08:00:00 AM,48,-122,26,194,220
13593,FremontBridge,04/22/2014 09:00:00 AM,48,-122,73,128,201
13594,FremontBridge,04/22/2014 10:00:00 AM,48,-122,45,61,106
13595,FremontBridge,04/22/2014 11:00:00 AM,48,-122,80,25,105
13596,FremontBridge,04/22/2014 12:00:00 PM,48,-122,28,89,117
13597,FremontBridge,04/22/2014 01:00:00 PM,48,-122,37,42,79
13598,FremontBridge,04/22/2014 02:00:00 PM,48,-122,43,35,78
13599,FremontBridge,04/22/2014 03:00:00 PM,48,-122,51,53,104
13600,FremontBridge,04/22/2014 04:00:00 PM,48,-122,93,66,159
13601,FremontBridge,04/22/2014 05:00:00 PM,48,-122,224,119,343
13602,FremontBridge,04/22/2014 06:00:00 PM,48,-122,213,125,338
13603,FremontBridge,04/22/2014 07:00:00 PM,48,-122,91,69,160
13604,FremontBridge,04/22/2014 08:00:00 PM,48,-122,45,28,73
13605,FremontBridge,04/22/2014 09:00:00 PM,48,-122,23,17,40
13606,FremontBridge,04/22/2014 10:00:00 PM,48,-122,13,10,23
13607,FremontBridge,04/22/2014 11:00:00 PM,48,-122,10,12,22
13608,FremontBridge,04/23/2014 12:00:00 AM,48,-122,1,1,2
13609,FremontBridge,04/23/2014 01:00:00 AM,48,-122,50,2,52
13610,FremontBridge,04/23/2014 02:00:00 AM,48,-122,22,0,22
13611,FremontBridge,04/23/2014 03:00:00 AM,48,-122,20,1,21
13612,FremontBridge,04/23/2014 04:00:00 AM,48,-122,19,2,21
13613,FremontBridge,04/23/2014 05:00:00 AM,48,-122,35,17,52
13614,FremontBridge,04/23/2014 06:00:00 AM,48,-122,32,48,80
13615,FremontBridge,04/23/2014 07:00:00 AM,48,-122,22,191,213
13616,FremontBridge,04/23/2014 08:00:00 AM,48,-122,25,327,352
13617,FremontBridge,04/23/2014 09:00:00 AM,48,-122,101,178,279
13618,FremontBridge,04/23/2014 10:00:00 AM,48,-122,54,72,126
13619,FremontBridge,04/23/2014 11:00:00 AM,48,-122,40,47,87
13620,FremontBridge,04/23/2014 12:00:00 PM,48,-122,19,47,66
13621,FremontBridge,04/23/2014 01:00:00 PM,48,-122,31,46,77
13622,FremontBridge,04/23/2014 02:00:00 PM,48,-122,32,40,72
13623,FremontBridge,04/23/2014 03:00:00 PM,48,-122,54,59,113
13624,FremontBridge,04/23/2014 04:00:00 PM,48,-122,114,64,178
13625,FremontBridge,04/23/2014 05:00:00 PM,48,-122,294,121,415
13626,FremontBridge,04/23/2014 06:00:00 PM,48,-122,203,107,310
13627,FremontBridge,04/23/2014 07:00:00 PM,48,-122,111,46,157
13628,FremontBridge,04/23/2014 08:00:00 PM,48,-122,43,17,60
13629,FremontBridge,04/23/2014 09:00:00 PM,48,-122,22,13,35
13630,FremontBridge,04/23/2014 10:00:00 PM,48,-122,16,15,31
13631,FremontBridge,04/23/2014 11:00:00 PM,48,-122,7,4,11
13632,FremontBridge,04/24/2014 12:00:00 AM,48,-122,3,3,6
13633,FremontBridge,04/24/2014 01:00:00 AM,48,-122,1,2,3
13634,FremontBridge,04/24/2014 02:00:00 AM,48,-122,0,2,2
13635,FremontBridge,04/24/2014 03:00:00 AM,48,-122,0,1,1
13636,FremontBridge,04/24/2014 04:00:00 AM,48,-122,2,3,5
13637,FremontBridge,04/24/2014 05:00:00 AM,48,-122,8,10,18
13638,FremontBridge,04/24/2014 06:00:00 AM,48,-122,27,45,72
13639,FremontBridge,04/24/2014 07:00:00 AM,48,-122,61,151,212
13640,FremontBridge,04/24/2014 08:00:00 AM,48,-122,97,237,334
13641,FremontBridge,04/24/2014 09:00:00 AM,48,-122,69,156,225
13642,FremontBridge,04/24/2014 10:00:00 AM,48,-122,38,66,104
13643,FremontBridge,04/24/2014 11:00:00 AM,48,-122,28,31,59
13644,FremontBridge,04/24/2014 12:00:00 PM,48,-122,22,27,49
13645,FremontBridge,04/24/2014 01:00:00 PM,48,-122,21,14,35
13646,FremontBridge,04/24/2014 02:00:00 PM,48,-122,27,30,57
13647,FremontBridge,04/24/2014 03:00:00 PM,48,-122,38,42,80
13648,FremontBridge,04/24/2014 04:00:00 PM,48,-122,85,67,152
13649,FremontBridge,04/24/2014 05:00:00 PM,48,-122,270,107,377
13650,FremontBridge,04/24/2014 06:00:00 PM,48,-122,202,119,321
13651,FremontBridge,04/24/2014 07:00:00 PM,48,-122,124,72,196
13652,FremontBridge,04/24/2014 08:00:00 PM,48,-122,48,34,82
13653,FremontBridge,04/24/2014 09:00:00 PM,48,-122,34,18,52
13654,FremontBridge,04/24/2014 10:00:00 PM,48,-122,26,22,48
13655,FremontBridge,04/24/2014 11:00:00 PM,48,-122,10,11,21
13656,FremontBridge,04/25/2014 12:00:00 AM,48,-122,6,1,7
13657,FremontBridge,04/25/2014 01:00:00 AM,48,-122,3,3,6
13658,FremontBridge,04/25/2014 02:00:00 AM,48,-122,2,1,3
13659,FremontBridge,04/25/2014 03:00:00 AM,48,-122,0,1,1
13660,FremontBridge,04/25/2014 04:00:00 AM,48,-122,38,1,39
13661,FremontBridge,04/25/2014 05:00:00 AM,48,-122,39,15,54
13662,FremontBridge,04/25/2014 06:00:00 AM,48,-122,15,64,79
13663,FremontBridge,04/25/2014 07:00:00 AM,48,-122,20,162,182
13664,FremontBridge,04/25/2014 08:00:00 AM,48,-122,61,294,355
13665,FremontBridge,04/25/2014 09:00:00 AM,48,-122,101,167,268
13666,FremontBridge,04/25/2014 10:00:00 AM,48,-122,53,84,137
13667,FremontBridge,04/25/2014 11:00:00 AM,48,-122,27,70,97
13668,FremontBridge,04/25/2014 12:00:00 PM,48,-122,62,65,127
13669,FremontBridge,04/25/2014 01:00:00 PM,48,-122,61,52,113
13670,FremontBridge,04/25/2014 02:00:00 PM,48,-122,56,60,116
13671,FremontBridge,04/25/2014 03:00:00 PM,48,-122,84,71,155
13672,FremontBridge,04/25/2014 04:00:00 PM,48,-122,150,113,263
13673,FremontBridge,04/25/2014 05:00:00 PM,48,-122,297,163,460
13674,FremontBridge,04/25/2014 06:00:00 PM,48,-122,228,135,363
13675,FremontBridge,04/25/2014 07:00:00 PM,48,-122,92,67,159
13676,FremontBridge,04/25/2014 08:00:00 PM,48,-122,47,39,86
13677,FremontBridge,04/25/2014 09:00:00 PM,48,-122,30,26,56
13678,FremontBridge,04/25/2014 10:00:00 PM,48,-122,17,13,30
13679,FremontBridge,04/25/2014 11:00:00 PM,48,-122,17,21,38
13680,FremontBridge,04/26/2014 12:00:00 AM,48,-122,10,7,17
13681,FremontBridge,04/26/2014 01:00:00 AM,48,-122,6,4,10
13682,FremontBridge,04/26/2014 02:00:00 AM,48,-122,4,4,8
13683,FremontBridge,04/26/2014 03:00:00 AM,48,-122,2,1,3
13684,FremontBridge,04/26/2014 04:00:00 AM,48,-122,2,2,4
13685,FremontBridge,04/26/2014 05:00:00 AM,48,-122,47,3,50
13686,FremontBridge,04/26/2014 06:00:00 AM,48,-122,47,10,57
13687,FremontBridge,04/26/2014 07:00:00 AM,48,-122,53,21,74
13688,FremontBridge,04/26/2014 08:00:00 AM,48,-122,67,42,109
13689,FremontBridge,04/26/2014 09:00:00 AM,48,-122,45,72,117
13690,FremontBridge,04/26/2014 10:00:00 AM,48,-122,74,95,169
13691,FremontBridge,04/26/2014 11:00:00 AM,48,-122,68,87,155
13692,FremontBridge,04/26/2014 12:00:00 PM,48,-122,88,119,207
13693,FremontBridge,04/26/2014 01:00:00 PM,48,-122,67,79,146
13694,FremontBridge,04/26/2014 02:00:00 PM,48,-122,67,82,149
13695,FremontBridge,04/26/2014 03:00:00 PM,48,-122,88,84,172
13696,FremontBridge,04/26/2014 04:00:00 PM,48,-122,89,104,193
13697,FremontBridge,04/26/2014 05:00:00 PM,48,-122,68,88,156
13698,FremontBridge,04/26/2014 06:00:00 PM,48,-122,52,66,118
13699,FremontBridge,04/26/2014 07:00:00 PM,48,-122,22,29,51
13700,FremontBridge,04/26/2014 08:00:00 PM,48,-122,13,21,34
13701,FremontBridge,04/26/2014 09:00:00 PM,48,-122,10,13,23
13702,FremontBridge,04/26/2014 10:00:00 PM,48,-122,11,7,18
13703,FremontBridge,04/26/2014 11:00:00 PM,48,-122,1,8,9
13704,FremontBridge,04/27/2014 12:00:00 AM,48,-122,7,4,11
13705,FremontBridge,04/27/2014 01:00:00 AM,48,-122,5,4,9
13706,FremontBridge,04/27/2014 02:00:00 AM,48,-122,1,1,2
13707,FremontBridge,04/27/2014 03:00:00 AM,48,-122,0,0,0
13708,FremontBridge,04/27/2014 04:00:00 AM,48,-122,58,0,58
13709,FremontBridge,04/27/2014 05:00:00 AM,48,-122,34,3,37
13710,FremontBridge,04/27/2014 06:00:00 AM,48,-122,27,7,34
13711,FremontBridge,04/27/2014 07:00:00 AM,48,-122,61,2,63
13712,FremontBridge,04/27/2014 08:00:00 AM,48,-122,37,25,62
13713,FremontBridge,04/27/2014 09:00:00 AM,48,-122,32,49,81
13714,FremontBridge,04/27/2014 10:00:00 AM,48,-122,35,42,77
13715,FremontBridge,04/27/2014 11:00:00 AM,48,-122,39,46,85
13716,FremontBridge,04/27/2014 12:00:00 PM,48,-122,49,51,100
13717,FremontBridge,04/27/2014 01:00:00 PM,48,-122,47,57,104
13718,FremontBridge,04/27/2014 02:00:00 PM,48,-122,50,69,119
13719,FremontBridge,04/27/2014 03:00:00 PM,48,-122,60,58,118
13720,FremontBridge,04/27/2014 04:00:00 PM,48,-122,49,81,130
13721,FremontBridge,04/27/2014 05:00:00 PM,48,-122,49,63,112
13722,FremontBridge,04/27/2014 06:00:00 PM,48,-122,31,47,78
13723,FremontBridge,04/27/2014 07:00:00 PM,48,-122,16,24,40
13724,FremontBridge,04/27/2014 08:00:00 PM,48,-122,17,17,34
13725,FremontBridge,04/27/2014 09:00:00 PM,48,-122,10,11,21
13726,FremontBridge,04/27/2014 10:00:00 PM,48,-122,12,8,20
13727,FremontBridge,04/27/2014 11:00:00 PM,48,-122,0,7,7
13728,FremontBridge,04/28/2014 12:00:00 AM,48,-122,5,1,6
13729,FremontBridge,04/28/2014 01:00:00 AM,48,-122,1,2,3
13730,FremontBridge,04/28/2014 02:00:00 AM,48,-122,0,0,0
13731,FremontBridge,04/28/2014 03:00:00 AM,48,-122,0,2,2
13732,FremontBridge,04/28/2014 04:00:00 AM,48,-122,70,3,73
13733,FremontBridge,04/28/2014 05:00:00 AM,48,-122,35,19,54
13734,FremontBridge,04/28/2014 06:00:00 AM,48,-122,23,71,94
13735,FremontBridge,04/28/2014 07:00:00 AM,48,-122,16,255,271
13736,FremontBridge,04/28/2014 08:00:00 AM,48,-122,47,356,403
13737,FremontBridge,04/28/2014 09:00:00 AM,48,-122,103,191,294
13738,FremontBridge,04/28/2014 10:00:00 AM,48,-122,39,58,97
13739,FremontBridge,04/28/2014 11:00:00 AM,48,-122,29,57,86
13740,FremontBridge,04/28/2014 12:00:00 PM,48,-122,38,38,76
13741,FremontBridge,04/28/2014 01:00:00 PM,48,-122,47,49,96
13742,FremontBridge,04/28/2014 02:00:00 PM,48,-122,66,52,118
13743,FremontBridge,04/28/2014 03:00:00 PM,48,-122,86,77,163
13744,FremontBridge,04/28/2014 04:00:00 PM,48,-122,161,107,268
13745,FremontBridge,04/28/2014 05:00:00 PM,48,-122,413,168,581
13746,FremontBridge,04/28/2014 06:00:00 PM,48,-122,339,205,544
13747,FremontBridge,04/28/2014 07:00:00 PM,48,-122,162,119,281
13748,FremontBridge,04/28/2014 08:00:00 PM,48,-122,70,59,129
13749,FremontBridge,04/28/2014 09:00:00 PM,48,-122,30,23,53
13750,FremontBridge,04/28/2014 10:00:00 PM,48,-122,19,26,45
13751,FremontBridge,04/28/2014 11:00:00 PM,48,-122,9,12,21
13752,FremontBridge,04/29/2014 12:00:00 AM,48,-122,13,3,16
13753,FremontBridge,04/29/2014 01:00:00 AM,48,-122,2,1,3
13754,FremontBridge,04/29/2014 02:00:00 AM,48,-122,1,3,4
13755,FremontBridge,04/29/2014 03:00:00 AM,48,-122,0,0,0
13756,FremontBridge,04/29/2014 04:00:00 AM,48,-122,2,4,6
13757,FremontBridge,04/29/2014 05:00:00 AM,48,-122,14,28,42
13758,FremontBridge,04/29/2014 06:00:00 AM,48,-122,38,103,141
13759,FremontBridge,04/29/2014 07:00:00 AM,48,-122,113,296,409
13760,FremontBridge,04/29/2014 08:00:00 AM,48,-122,174,421,595
13761,FremontBridge,04/29/2014 09:00:00 AM,48,-122,123,222,345
13762,FremontBridge,04/29/2014 10:00:00 AM,48,-122,61,89,150
13763,FremontBridge,04/29/2014 11:00:00 AM,48,-122,51,58,109
13764,FremontBridge,04/29/2014 12:00:00 PM,48,-122,51,66,117
13765,FremontBridge,04/29/2014 01:00:00 PM,48,-122,43,81,124
13766,FremontBridge,04/29/2014 02:00:00 PM,48,-122,73,81,154
13767,FremontBridge,04/29/2014 03:00:00 PM,48,-122,95,85,180
13768,FremontBridge,04/29/2014 04:00:00 PM,48,-122,203,123,326
13769,FremontBridge,04/29/2014 05:00:00 PM,48,-122,496,207,703
13770,FremontBridge,04/29/2014 06:00:00 PM,48,-122,408,261,669
13771,FremontBridge,04/29/2014 07:00:00 PM,48,-122,187,153,340
13772,FremontBridge,04/29/2014 08:00:00 PM,48,-122,103,94,197
13773,FremontBridge,04/29/2014 09:00:00 PM,48,-122,43,47,90
13774,FremontBridge,04/29/2014 10:00:00 PM,48,-122,21,25,46
13775,FremontBridge,04/29/2014 11:00:00 PM,48,-122,16,21,37
13776,FremontBridge,04/30/2014 12:00:00 AM,48,-122,11,7,18
13777,FremontBridge,04/30/2014 01:00:00 AM,48,-122,4,5,9
13778,FremontBridge,04/30/2014 02:00:00 AM,48,-122,2,4,6
13779,FremontBridge,04/30/2014 03:00:00 AM,48,-122,0,2,2
13780,FremontBridge,04/30/2014 04:00:00 AM,48,-122,4,3,7
13781,FremontBridge,04/30/2014 05:00:00 AM,48,-122,12,24,36
13782,FremontBridge,04/30/2014 06:00:00 AM,48,-122,47,91,138
13783,FremontBridge,04/30/2014 07:00:00 AM,48,-122,106,312,418
13784,FremontBridge,04/30/2014 08:00:00 AM,48,-122,174,470,644
13785,FremontBridge,04/30/2014 09:00:00 AM,48,-122,143,248,391
13786,FremontBridge,04/30/2014 10:00:00 AM,48,-122,54,104,158
13787,FremontBridge,04/30/2014 11:00:00 AM,48,-122,56,77,133
13788,FremontBridge,04/30/2014 12:00:00 PM,48,-122,66,72,138
13789,FremontBridge,04/30/2014 01:00:00 PM,48,-122,71,80,151
13790,FremontBridge,04/30/2014 02:00:00 PM,48,-122,55,92,147
13791,FremontBridge,04/30/2014 03:00:00 PM,48,-122,115,100,215
13792,FremontBridge,04/30/2014 04:00:00 PM,48,-122,244,152,396
13793,FremontBridge,04/30/2014 05:00:00 PM,48,-122,527,215,742
13794,FremontBridge,04/30/2014 06:00:00 PM,48,-122,396,256,652
13795,FremontBridge,04/30/2014 07:00:00 PM,48,-122,181,151,332
13796,FremontBridge,04/30/2014 08:00:00 PM,48,-122,97,118,215
13797,FremontBridge,04/30/2014 09:00:00 PM,48,-122,52,51,103
13798,FremontBridge,04/30/2014 10:00:00 PM,48,-122,45,35,80
13799,FremontBridge,04/30/2014 11:00:00 PM,48,-122,17,19,36
13800,FremontBridge,05/01/2014 12:00:00 AM,48,-122,3,16,19
13801,FremontBridge,05/01/2014 01:00:00 AM,48,-122,5,4,9
13802,FremontBridge,05/01/2014 02:00:00 AM,48,-122,2,5,7
13803,FremontBridge,05/01/2014 03:00:00 AM,48,-122,2,3,5
13804,FremontBridge,05/01/2014 04:00:00 AM,48,-122,2,7,9
13805,FremontBridge,05/01/2014 05:00:00 AM,48,-122,13,29,42
13806,FremontBridge,05/01/2014 06:00:00 AM,48,-122,53,131,184
13807,FremontBridge,05/01/2014 07:00:00 AM,48,-122,150,420,570
13808,FremontBridge,05/01/2014 08:00:00 AM,48,-122,209,513,722
13809,FremontBridge,05/01/2014 09:00:00 AM,48,-122,127,294,421
13810,FremontBridge,05/01/2014 10:00:00 AM,48,-122,74,115,189
13811,FremontBridge,05/01/2014 11:00:00 AM,48,-122,47,76,123
13812,FremontBridge,05/01/2014 12:00:00 PM,48,-122,73,91,164
13813,FremontBridge,05/01/2014 01:00:00 PM,48,-122,91,81,172
13814,FremontBridge,05/01/2014 02:00:00 PM,48,-122,104,90,194
13815,FremontBridge,05/01/2014 03:00:00 PM,48,-122,150,106,256
13816,FremontBridge,05/01/2014 04:00:00 PM,48,-122,298,180,478
13817,FremontBridge,05/01/2014 05:00:00 PM,48,-122,580,250,830
13818,FremontBridge,05/01/2014 06:00:00 PM,48,-122,415,246,661
13819,FremontBridge,05/01/2014 07:00:00 PM,48,-122,226,160,386
13820,FremontBridge,05/01/2014 08:00:00 PM,48,-122,111,103,214
13821,FremontBridge,05/01/2014 09:00:00 PM,48,-122,71,67,138
13822,FremontBridge,05/01/2014 10:00:00 PM,48,-122,46,50,96
13823,FremontBridge,05/01/2014 11:00:00 PM,48,-122,22,26,48
13824,FremontBridge,05/02/2014 12:00:00 AM,48,-122,13,8,21
13825,FremontBridge,05/02/2014 01:00:00 AM,48,-122,6,7,13
13826,FremontBridge,05/02/2014 02:00:00 AM,48,-122,4,6,10
13827,FremontBridge,05/02/2014 03:00:00 AM,48,-122,1,4,5
13828,FremontBridge,05/02/2014 04:00:00 AM,48,-122,5,3,8
13829,FremontBridge,05/02/2014 05:00:00 AM,48,-122,17,19,36
13830,FremontBridge,05/02/2014 06:00:00 AM,48,-122,45,112,157
13831,FremontBridge,05/02/2014 07:00:00 AM,48,-122,132,318,450
13832,FremontBridge,05/02/2014 08:00:00 AM,48,-122,161,460,621
13833,FremontBridge,05/02/2014 09:00:00 AM,48,-122,139,268,407
13834,FremontBridge,05/02/2014 10:00:00 AM,48,-122,63,107,170
13835,FremontBridge,05/02/2014 11:00:00 AM,48,-122,64,89,153
13836,FremontBridge,05/02/2014 12:00:00 PM,48,-122,55,66,121
13837,FremontBridge,05/02/2014 01:00:00 PM,48,-122,73,72,145
13838,FremontBridge,05/02/2014 02:00:00 PM,48,-122,81,111,192
13839,FremontBridge,05/02/2014 03:00:00 PM,48,-122,141,96,237
13840,FremontBridge,05/02/2014 04:00:00 PM,48,-122,274,153,427
13841,FremontBridge,05/02/2014 05:00:00 PM,48,-122,491,190,681
13842,FremontBridge,05/02/2014 06:00:00 PM,48,-122,240,136,376
13843,FremontBridge,05/02/2014 07:00:00 PM,48,-122,94,67,161
13844,FremontBridge,05/02/2014 08:00:00 PM,48,-122,52,31,83
13845,FremontBridge,05/02/2014 09:00:00 PM,48,-122,24,31,55
13846,FremontBridge,05/02/2014 10:00:00 PM,48,-122,17,20,37
13847,FremontBridge,05/02/2014 11:00:00 PM,48,-122,14,28,42
13848,FremontBridge,05/03/2014 12:00:00 AM,48,-122,12,7,19
13849,FremontBridge,05/03/2014 01:00:00 AM,48,-122,6,8,14
13850,FremontBridge,05/03/2014 02:00:00 AM,48,-122,3,2,5
13851,FremontBridge,05/03/2014 03:00:00 AM,48,-122,0,2,2
13852,FremontBridge,05/03/2014 04:00:00 AM,48,-122,0,0,0
13853,FremontBridge,05/03/2014 05:00:00 AM,48,-122,5,7,12
13854,FremontBridge,05/03/2014 06:00:00 AM,48,-122,12,11,23
13855,FremontBridge,05/03/2014 07:00:00 AM,48,-122,15,42,57
13856,FremontBridge,05/03/2014 08:00:00 AM,48,-122,47,52,99
13857,FremontBridge,05/03/2014 09:00:00 AM,48,-122,49,65,114
13858,FremontBridge,05/03/2014 10:00:00 AM,48,-122,55,58,113
13859,FremontBridge,05/03/2014 11:00:00 AM,48,-122,60,58,118
13860,FremontBridge,05/03/2014 12:00:00 PM,48,-122,50,70,120
13861,FremontBridge,05/03/2014 01:00:00 PM,48,-122,46,49,95
13862,FremontBridge,05/03/2014 02:00:00 PM,48,-122,18,51,69
13863,FremontBridge,05/03/2014 03:00:00 PM,48,-122,35,37,72
13864,FremontBridge,05/03/2014 04:00:00 PM,48,-122,40,44,84
13865,FremontBridge,05/03/2014 05:00:00 PM,48,-122,21,17,38
13866,FremontBridge,05/03/2014 06:00:00 PM,48,-122,17,10,27
13867,FremontBridge,05/03/2014 07:00:00 PM,48,-122,9,6,15
13868,FremontBridge,05/03/2014 08:00:00 PM,48,-122,14,8,22
13869,FremontBridge,05/03/2014 09:00:00 PM,48,-122,7,5,12
13870,FremontBridge,05/03/2014 10:00:00 PM,48,-122,5,11,16
13871,FremontBridge,05/03/2014 11:00:00 PM,48,-122,5,6,11
13872,FremontBridge,05/04/2014 12:00:00 AM,48,-122,1,1,2
13873,FremontBridge,05/04/2014 01:00:00 AM,48,-122,4,4,8
13874,FremontBridge,05/04/2014 02:00:00 AM,48,-122,3,0,3
13875,FremontBridge,05/04/2014 03:00:00 AM,48,-122,0,0,0
13876,FremontBridge,05/04/2014 04:00:00 AM,48,-122,1,1,2
13877,FremontBridge,05/04/2014 05:00:00 AM,48,-122,2,3,5
13878,FremontBridge,05/04/2014 06:00:00 AM,48,-122,5,6,11
13879,FremontBridge,05/04/2014 07:00:00 AM,48,-122,8,15,23
13880,FremontBridge,05/04/2014 08:00:00 AM,48,-122,9,25,34
13881,FremontBridge,05/04/2014 09:00:00 AM,48,-122,13,21,34
13882,FremontBridge,05/04/2014 10:00:00 AM,48,-122,17,13,30
13883,FremontBridge,05/04/2014 11:00:00 AM,48,-122,15,29,44
13884,FremontBridge,05/04/2014 12:00:00 PM,48,-122,48,27,75
13885,FremontBridge,05/04/2014 01:00:00 PM,48,-122,22,30,52
13886,FremontBridge,05/04/2014 02:00:00 PM,48,-122,25,26,51
13887,FremontBridge,05/04/2014 03:00:00 PM,48,-122,32,36,68
13888,FremontBridge,05/04/2014 04:00:00 PM,48,-122,13,28,41
13889,FremontBridge,05/04/2014 05:00:00 PM,48,-122,17,16,33
13890,FremontBridge,05/04/2014 06:00:00 PM,48,-122,18,10,28
13891,FremontBridge,05/04/2014 07:00:00 PM,48,-122,8,10,18
13892,FremontBridge,05/04/2014 08:00:00 PM,48,-122,14,13,27
13893,FremontBridge,05/04/2014 09:00:00 PM,48,-122,9,6,15
13894,FremontBridge,05/04/2014 10:00:00 PM,48,-122,3,8,11
13895,FremontBridge,05/04/2014 11:00:00 PM,48,-122,2,3,5
13896,FremontBridge,05/05/2014 12:00:00 AM,48,-122,3,4,7
13897,FremontBridge,05/05/2014 01:00:00 AM,48,-122,1,1,2
13898,FremontBridge,05/05/2014 02:00:00 AM,48,-122,0,1,1
13899,FremontBridge,05/05/2014 03:00:00 AM,48,-122,1,1,2
13900,FremontBridge,05/05/2014 04:00:00 AM,48,-122,1,4,5
13901,FremontBridge,05/05/2014 05:00:00 AM,48,-122,11,26,37
13902,FremontBridge,05/05/2014 06:00:00 AM,48,-122,41,98,139
13903,FremontBridge,05/05/2014 07:00:00 AM,48,-122,88,298,386
13904,FremontBridge,05/05/2014 08:00:00 AM,48,-122,127,326,453
13905,FremontBridge,05/05/2014 09:00:00 AM,48,-122,84,148,232
13906,FremontBridge,05/05/2014 10:00:00 AM,48,-122,32,59,91
13907,FremontBridge,05/05/2014 11:00:00 AM,48,-122,15,32,47
13908,FremontBridge,05/05/2014 12:00:00 PM,48,-122,22,32,54
13909,FremontBridge,05/05/2014 01:00:00 PM,48,-122,34,40,74
13910,FremontBridge,05/05/2014 02:00:00 PM,48,-122,31,39,70
13911,FremontBridge,05/05/2014 03:00:00 PM,48,-122,55,51,106
13912,FremontBridge,05/05/2014 04:00:00 PM,48,-122,160,79,239
13913,FremontBridge,05/05/2014 05:00:00 PM,48,-122,394,160,554
13914,FremontBridge,05/05/2014 06:00:00 PM,48,-122,265,134,399
13915,FremontBridge,05/05/2014 07:00:00 PM,48,-122,105,66,171
13916,FremontBridge,05/05/2014 08:00:00 PM,48,-122,58,55,113
13917,FremontBridge,05/05/2014 09:00:00 PM,48,-122,27,26,53
13918,FremontBridge,05/05/2014 10:00:00 PM,48,-122,23,26,49
13919,FremontBridge,05/05/2014 11:00:00 PM,48,-122,5,12,17
13920,FremontBridge,05/06/2014 12:00:00 AM,48,-122,6,4,10
13921,FremontBridge,05/06/2014 01:00:00 AM,48,-122,1,3,4
13922,FremontBridge,05/06/2014 02:00:00 AM,48,-122,2,3,5
13923,FremontBridge,05/06/2014 03:00:00 AM,48,-122,0,3,3
13924,FremontBridge,05/06/2014 04:00:00 AM,48,-122,4,5,9
13925,FremontBridge,05/06/2014 05:00:00 AM,48,-122,20,36,56
13926,FremontBridge,05/06/2014 06:00:00 AM,48,-122,82,228,310
13927,FremontBridge,05/06/2014 07:00:00 AM,48,-122,112,419,531
13928,FremontBridge,05/06/2014 08:00:00 AM,48,-122,175,405,580
13929,FremontBridge,05/06/2014 09:00:00 AM,48,-122,42,169,211
13930,FremontBridge,05/06/2014 10:00:00 AM,48,-122,68,81,149
13931,FremontBridge,05/06/2014 11:00:00 AM,48,-122,55,47,102
13932,FremontBridge,05/06/2014 12:00:00 PM,48,-122,50,48,98
13933,FremontBridge,05/06/2014 01:00:00 PM,48,-122,52,52,104
13934,FremontBridge,05/06/2014 02:00:00 PM,48,-122,46,68,114
13935,FremontBridge,05/06/2014 03:00:00 PM,48,-122,69,73,142
13936,FremontBridge,05/06/2014 04:00:00 PM,48,-122,225,129,354
13937,FremontBridge,05/06/2014 05:00:00 PM,48,-122,557,242,799
13938,FremontBridge,05/06/2014 06:00:00 PM,48,-122,347,192,539
13939,FremontBridge,05/06/2014 07:00:00 PM,48,-122,131,89,220
13940,FremontBridge,05/06/2014 08:00:00 PM,48,-122,76,58,134
13941,FremontBridge,05/06/2014 09:00:00 PM,48,-122,54,40,94
13942,FremontBridge,05/06/2014 10:00:00 PM,48,-122,23,15,38
13943,FremontBridge,05/06/2014 11:00:00 PM,48,-122,18,12,30
13944,FremontBridge,05/07/2014 12:00:00 AM,48,-122,8,2,10
13945,FremontBridge,05/07/2014 01:00:00 AM,48,-122,3,4,7
13946,FremontBridge,05/07/2014 02:00:00 AM,48,-122,1,4,5
13947,FremontBridge,05/07/2014 03:00:00 AM,48,-122,0,4,4
13948,FremontBridge,05/07/2014 04:00:00 AM,48,-122,4,6,10
13949,FremontBridge,05/07/2014 05:00:00 AM,48,-122,19,36,55
13950,FremontBridge,05/07/2014 06:00:00 AM,48,-122,56,153,209
13951,FremontBridge,05/07/2014 07:00:00 AM,48,-122,141,452,593
13952,FremontBridge,05/07/2014 08:00:00 AM,48,-122,205,511,716
13953,FremontBridge,05/07/2014 09:00:00 AM,48,-122,140,222,362
13954,FremontBridge,05/07/2014 10:00:00 AM,48,-122,48,102,150
13955,FremontBridge,05/07/2014 11:00:00 AM,48,-122,53,56,109
13956,FremontBridge,05/07/2014 12:00:00 PM,48,-122,53,73,126
13957,FremontBridge,05/07/2014 01:00:00 PM,48,-122,77,71,148
13958,FremontBridge,05/07/2014 02:00:00 PM,48,-122,70,72,142
13959,FremontBridge,05/07/2014 03:00:00 PM,48,-122,95,100,195
13960,FremontBridge,05/07/2014 04:00:00 PM,48,-122,250,184,434
13961,FremontBridge,05/07/2014 05:00:00 PM,48,-122,573,285,858
13962,FremontBridge,05/07/2014 06:00:00 PM,48,-122,384,252,636
13963,FremontBridge,05/07/2014 07:00:00 PM,48,-122,168,104,272
13964,FremontBridge,05/07/2014 08:00:00 PM,48,-122,90,71,161
13965,FremontBridge,05/07/2014 09:00:00 PM,48,-122,88,53,141
13966,FremontBridge,05/07/2014 10:00:00 PM,48,-122,38,37,75
13967,FremontBridge,05/07/2014 11:00:00 PM,48,-122,23,14,37
13968,FremontBridge,05/08/2014 12:00:00 AM,48,-122,11,5,16
13969,FremontBridge,05/08/2014 01:00:00 AM,48,-122,4,1,5
13970,FremontBridge,05/08/2014 02:00:00 AM,48,-122,3,2,5
13971,FremontBridge,05/08/2014 03:00:00 AM,48,-122,1,3,4
13972,FremontBridge,05/08/2014 04:00:00 AM,48,-122,4,3,7
13973,FremontBridge,05/08/2014 05:00:00 AM,48,-122,11,22,33
13974,FremontBridge,05/08/2014 06:00:00 AM,48,-122,45,147,192
13975,FremontBridge,05/08/2014 07:00:00 AM,48,-122,102,325,427
13976,FremontBridge,05/08/2014 08:00:00 AM,48,-122,164,325,489
13977,FremontBridge,05/08/2014 09:00:00 AM,48,-122,108,186,294
13978,FremontBridge,05/08/2014 10:00:00 AM,48,-122,42,72,114
13979,FremontBridge,05/08/2014 11:00:00 AM,48,-122,49,42,91
13980,FremontBridge,05/08/2014 12:00:00 PM,48,-122,32,36,68
13981,FremontBridge,05/08/2014 01:00:00 PM,48,-122,39,28,67
13982,FremontBridge,05/08/2014 02:00:00 PM,48,-122,29,21,50
13983,FremontBridge,05/08/2014 03:00:00 PM,48,-122,52,48,100
13984,FremontBridge,05/08/2014 04:00:00 PM,48,-122,144,57,201
13985,FremontBridge,05/08/2014 05:00:00 PM,48,-122,302,123,425
13986,FremontBridge,05/08/2014 06:00:00 PM,48,-122,228,95,323
13987,FremontBridge,05/08/2014 07:00:00 PM,48,-122,113,47,160
13988,FremontBridge,05/08/2014 08:00:00 PM,48,-122,56,23,79
13989,FremontBridge,05/08/2014 09:00:00 PM,48,-122,17,16,33
13990,FremontBridge,05/08/2014 10:00:00 PM,48,-122,12,16,28
13991,FremontBridge,05/08/2014 11:00:00 PM,48,-122,9,10,19
13992,FremontBridge,05/09/2014 12:00:00 AM,48,-122,4,4,8
13993,FremontBridge,05/09/2014 01:00:00 AM,48,-122,2,3,5
13994,FremontBridge,05/09/2014 02:00:00 AM,48,-122,0,4,4
13995,FremontBridge,05/09/2014 03:00:00 AM,48,-122,0,2,2
13996,FremontBridge,05/09/2014 04:00:00 AM,48,-122,4,3,7
13997,FremontBridge,05/09/2014 05:00:00 AM,48,-122,12,17,29
13998,FremontBridge,05/09/2014 06:00:00 AM,48,-122,28,96,124
13999,FremontBridge,05/09/2014 07:00:00 AM,48,-122,84,253,337
14000,FremontBridge,05/09/2014 08:00:00 AM,48,-122,114,313,427
14001,FremontBridge,05/09/2014 09:00:00 AM,48,-122,77,134,211
14002,FremontBridge,05/09/2014 10:00:00 AM,48,-122,39,64,103
14003,FremontBridge,05/09/2014 11:00:00 AM,48,-122,33,58,91
14004,FremontBridge,05/09/2014 12:00:00 PM,48,-122,24,43,67
14005,FremontBridge,05/09/2014 01:00:00 PM,48,-122,44,18,62
14006,FremontBridge,05/09/2014 02:00:00 PM,48,-122,53,33,86
14007,FremontBridge,05/09/2014 03:00:00 PM,48,-122,82,59,141
14008,FremontBridge,05/09/2014 04:00:00 PM,48,-122,194,88,282
14009,FremontBridge,05/09/2014 05:00:00 PM,48,-122,332,142,474
14010,FremontBridge,05/09/2014 06:00:00 PM,48,-122,176,101,277
14011,FremontBridge,05/09/2014 07:00:00 PM,48,-122,71,57,128
14012,FremontBridge,05/09/2014 08:00:00 PM,48,-122,52,16,68
14013,FremontBridge,05/09/2014 09:00:00 PM,48,-122,16,15,31
14014,FremontBridge,05/09/2014 10:00:00 PM,48,-122,21,15,36
14015,FremontBridge,05/09/2014 11:00:00 PM,48,-122,18,18,36
14016,FremontBridge,05/10/2014 12:00:00 AM,48,-122,10,12,22
14017,FremontBridge,05/10/2014 01:00:00 AM,48,-122,9,6,15
14018,FremontBridge,05/10/2014 02:00:00 AM,48,-122,12,3,15
14019,FremontBridge,05/10/2014 03:00:00 AM,48,-122,0,1,1
14020,FremontBridge,05/10/2014 04:00:00 AM,48,-122,3,1,4
14021,FremontBridge,05/10/2014 05:00:00 AM,48,-122,6,3,9
14022,FremontBridge,05/10/2014 06:00:00 AM,48,-122,10,9,19
14023,FremontBridge,05/10/2014 07:00:00 AM,48,-122,18,26,44
14024,FremontBridge,05/10/2014 08:00:00 AM,48,-122,33,42,75
14025,FremontBridge,05/10/2014 09:00:00 AM,48,-122,43,101,144
14026,FremontBridge,05/10/2014 10:00:00 AM,48,-122,43,66,109
14027,FremontBridge,05/10/2014 11:00:00 AM,48,-122,64,65,129
14028,FremontBridge,05/10/2014 12:00:00 PM,48,-122,66,109,175
14029,FremontBridge,05/10/2014 01:00:00 PM,48,-122,67,86,153
14030,FremontBridge,05/10/2014 02:00:00 PM,48,-122,64,61,125
14031,FremontBridge,05/10/2014 03:00:00 PM,48,-122,57,61,118
14032,FremontBridge,05/10/2014 04:00:00 PM,48,-122,64,67,131
14033,FremontBridge,05/10/2014 05:00:00 PM,48,-122,34,72,106
14034,FremontBridge,05/10/2014 06:00:00 PM,48,-122,40,50,90
14035,FremontBridge,05/10/2014 07:00:00 PM,48,-122,43,48,91
14036,FremontBridge,05/10/2014 08:00:00 PM,48,-122,16,34,50
14037,FremontBridge,05/10/2014 09:00:00 PM,48,-122,15,18,33
14038,FremontBridge,05/10/2014 10:00:00 PM,48,-122,24,15,39
14039,FremontBridge,05/10/2014 11:00:00 PM,48,-122,17,11,28
14040,FremontBridge,05/11/2014 12:00:00 AM,48,-122,13,11,24
14041,FremontBridge,05/11/2014 01:00:00 AM,48,-122,7,1,8
14042,FremontBridge,05/11/2014 02:00:00 AM,48,-122,4,3,7
14043,FremontBridge,05/11/2014 03:00:00 AM,48,-122,0,0,0
14044,FremontBridge,05/11/2014 04:00:00 AM,48,-122,1,1,2
14045,FremontBridge,05/11/2014 05:00:00 AM,48,-122,4,5,9
14046,FremontBridge,05/11/2014 06:00:00 AM,48,-122,12,15,27
14047,FremontBridge,05/11/2014 07:00:00 AM,48,-122,15,23,38
14048,FremontBridge,05/11/2014 08:00:00 AM,48,-122,42,52,94
14049,FremontBridge,05/11/2014 09:00:00 AM,48,-122,54,59,113
14050,FremontBridge,05/11/2014 10:00:00 AM,48,-122,68,88,156
14051,FremontBridge,05/11/2014 11:00:00 AM,48,-122,62,100,162
14052,FremontBridge,05/11/2014 12:00:00 PM,48,-122,69,128,197
14053,FremontBridge,05/11/2014 01:00:00 PM,48,-122,88,131,219
14054,FremontBridge,05/11/2014 02:00:00 PM,48,-122,128,103,231
14055,FremontBridge,05/11/2014 03:00:00 PM,48,-122,109,129,238
14056,FremontBridge,05/11/2014 04:00:00 PM,48,-122,102,113,215
14057,FremontBridge,05/11/2014 05:00:00 PM,48,-122,89,105,194
14058,FremontBridge,05/11/2014 06:00:00 PM,48,-122,77,89,166
14059,FremontBridge,05/11/2014 07:00:00 PM,48,-122,47,71,118
14060,FremontBridge,05/11/2014 08:00:00 PM,48,-122,21,31,52
14061,FremontBridge,05/11/2014 09:00:00 PM,48,-122,31,24,55
14062,FremontBridge,05/11/2014 10:00:00 PM,48,-122,24,13,37
14063,FremontBridge,05/11/2014 11:00:00 PM,48,-122,9,5,14
14064,FremontBridge,05/12/2014 12:00:00 AM,48,-122,4,4,8
14065,FremontBridge,05/12/2014 01:00:00 AM,48,-122,0,2,2
14066,FremontBridge,05/12/2014 02:00:00 AM,48,-122,0,4,4
14067,FremontBridge,05/12/2014 03:00:00 AM,48,-122,0,4,4
14068,FremontBridge,05/12/2014 04:00:00 AM,48,-122,3,1,4
14069,FremontBridge,05/12/2014 05:00:00 AM,48,-122,21,44,65
14070,FremontBridge,05/12/2014 06:00:00 AM,48,-122,64,164,228
14071,FremontBridge,05/12/2014 07:00:00 AM,48,-122,139,442,581
14072,FremontBridge,05/12/2014 08:00:00 AM,48,-122,192,485,677
14073,FremontBridge,05/12/2014 09:00:00 AM,48,-122,127,192,319
14074,FremontBridge,05/12/2014 10:00:00 AM,48,-122,57,74,131
14075,FremontBridge,05/12/2014 11:00:00 AM,48,-122,61,77,138
14076,FremontBridge,05/12/2014 12:00:00 PM,48,-122,63,76,139
14077,FremontBridge,05/12/2014 01:00:00 PM,48,-122,71,78,149
14078,FremontBridge,05/12/2014 02:00:00 PM,48,-122,91,56,147
14079,FremontBridge,05/12/2014 03:00:00 PM,48,-122,103,85,188
14080,FremontBridge,05/12/2014 04:00:00 PM,48,-122,315,160,475
14081,FremontBridge,05/12/2014 05:00:00 PM,48,-122,587,289,876
14082,FremontBridge,05/12/2014 06:00:00 PM,48,-122,430,244,674
14083,FremontBridge,05/12/2014 07:00:00 PM,48,-122,191,115,306
14084,FremontBridge,05/12/2014 08:00:00 PM,48,-122,88,69,157
14085,FremontBridge,05/12/2014 09:00:00 PM,48,-122,57,36,93
14086,FremontBridge,05/12/2014 10:00:00 PM,48,-122,27,17,44
14087,FremontBridge,05/12/2014 11:00:00 PM,48,-122,14,9,23
14088,FremontBridge,05/13/2014 12:00:00 AM,48,-122,14,11,25
14089,FremontBridge,05/13/2014 01:00:00 AM,48,-122,5,1,6
14090,FremontBridge,05/13/2014 02:00:00 AM,48,-122,1,4,5
14091,FremontBridge,05/13/2014 03:00:00 AM,48,-122,1,2,3
14092,FremontBridge,05/13/2014 04:00:00 AM,48,-122,3,6,9
14093,FremontBridge,05/13/2014 05:00:00 AM,48,-122,21,37,58
14094,FremontBridge,05/13/2014 06:00:00 AM,48,-122,84,198,282
14095,FremontBridge,05/13/2014 07:00:00 AM,48,-122,172,526,698
14096,FremontBridge,05/13/2014 08:00:00 AM,48,-122,220,499,719
14097,FremontBridge,05/13/2014 09:00:00 AM,48,-122,157,216,373
14098,FremontBridge,05/13/2014 10:00:00 AM,48,-122,47,96,143
14099,FremontBridge,05/13/2014 11:00:00 AM,48,-122,55,81,136
14100,FremontBridge,05/13/2014 12:00:00 PM,48,-122,59,68,127
14101,FremontBridge,05/13/2014 01:00:00 PM,48,-122,65,71,136
14102,FremontBridge,05/13/2014 02:00:00 PM,48,-122,73,112,185
14103,FremontBridge,05/13/2014 03:00:00 PM,48,-122,128,100,228
14104,FremontBridge,05/13/2014 04:00:00 PM,48,-122,310,170,480
14105,FremontBridge,05/13/2014 05:00:00 PM,48,-122,654,271,925
14106,FremontBridge,05/13/2014 06:00:00 PM,48,-122,485,250,735
14107,FremontBridge,05/13/2014 07:00:00 PM,48,-122,205,132,337
14108,FremontBridge,05/13/2014 08:00:00 PM,48,-122,125,121,246
14109,FremontBridge,05/13/2014 09:00:00 PM,48,-122,63,57,120
14110,FremontBridge,05/13/2014 10:00:00 PM,48,-122,42,26,68
14111,FremontBridge,05/13/2014 11:00:00 PM,48,-122,19,25,44
14112,FremontBridge,05/14/2014 12:00:00 AM,48,-122,8,9,17
14113,FremontBridge,05/14/2014 01:00:00 AM,48,-122,2,5,7
14114,FremontBridge,05/14/2014 02:00:00 AM,48,-122,1,2,3
14115,FremontBridge,05/14/2014 03:00:00 AM,48,-122,2,2,4
14116,FremontBridge,05/14/2014 04:00:00 AM,48,-122,5,4,9
14117,FremontBridge,05/14/2014 05:00:00 AM,48,-122,19,48,67
14118,FremontBridge,05/14/2014 06:00:00 AM,48,-122,80,192,272
14119,FremontBridge,05/14/2014 07:00:00 AM,48,-122,145,474,619
14120,FremontBridge,05/14/2014 08:00:00 AM,48,-122,201,491,692
14121,FremontBridge,05/14/2014 09:00:00 AM,48,-122,144,196,340
14122,FremontBridge,05/14/2014 10:00:00 AM,48,-122,74,90,164
14123,FremontBridge,05/14/2014 11:00:00 AM,48,-122,50,81,131
14124,FremontBridge,05/14/2014 12:00:00 PM,48,-122,53,81,134
14125,FremontBridge,05/14/2014 01:00:00 PM,48,-122,71,71,142
14126,FremontBridge,05/14/2014 02:00:00 PM,48,-122,69,92,161
14127,FremontBridge,05/14/2014 03:00:00 PM,48,-122,118,102,220
14128,FremontBridge,05/14/2014 04:00:00 PM,48,-122,320,190,510
14129,FremontBridge,05/14/2014 05:00:00 PM,48,-122,635,288,923
14130,FremontBridge,05/14/2014 06:00:00 PM,48,-122,412,271,683
14131,FremontBridge,05/14/2014 07:00:00 PM,48,-122,192,138,330
14132,FremontBridge,05/14/2014 08:00:00 PM,48,-122,116,106,222
14133,FremontBridge,05/14/2014 09:00:00 PM,48,-122,89,64,153
14134,FremontBridge,05/14/2014 10:00:00 PM,48,-122,32,25,57
14135,FremontBridge,05/14/2014 11:00:00 PM,48,-122,14,13,27
14136,FremontBridge,05/15/2014 12:00:00 AM,48,-122,7,11,18
14137,FremontBridge,05/15/2014 01:00:00 AM,48,-122,4,3,7
14138,FremontBridge,05/15/2014 02:00:00 AM,48,-122,7,2,9
14139,FremontBridge,05/15/2014 03:00:00 AM,48,-122,2,7,9
14140,FremontBridge,05/15/2014 04:00:00 AM,48,-122,2,5,7
14141,FremontBridge,05/15/2014 05:00:00 AM,48,-122,19,34,53
14142,FremontBridge,05/15/2014 06:00:00 AM,48,-122,65,176,241
14143,FremontBridge,05/15/2014 07:00:00 AM,48,-122,137,463,600
14144,FremontBridge,05/15/2014 08:00:00 AM,48,-122,224,457,681
14145,FremontBridge,05/15/2014 09:00:00 AM,48,-122,123,215,338
14146,FremontBridge,05/15/2014 10:00:00 AM,48,-122,59,93,152
14147,FremontBridge,05/15/2014 11:00:00 AM,48,-122,60,73,133
14148,FremontBridge,05/15/2014 12:00:00 PM,48,-122,64,56,120
14149,FremontBridge,05/15/2014 01:00:00 PM,48,-122,57,58,115
14150,FremontBridge,05/15/2014 02:00:00 PM,48,-122,56,84,140
14151,FremontBridge,05/15/2014 03:00:00 PM,48,-122,153,100,253
14152,FremontBridge,05/15/2014 04:00:00 PM,48,-122,256,127,383
14153,FremontBridge,05/15/2014 05:00:00 PM,48,-122,574,210,784
14154,FremontBridge,05/15/2014 06:00:00 PM,48,-122,406,195,601
14155,FremontBridge,05/15/2014 07:00:00 PM,48,-122,170,100,270
14156,FremontBridge,05/15/2014 08:00:00 PM,48,-122,104,86,190
14157,FremontBridge,05/15/2014 09:00:00 PM,48,-122,61,56,117
14158,FremontBridge,05/15/2014 10:00:00 PM,48,-122,18,29,47
14159,FremontBridge,05/15/2014 11:00:00 PM,48,-122,15,17,32
14160,FremontBridge,05/16/2014 12:00:00 AM,48,-122,9,15,24
14161,FremontBridge,05/16/2014 01:00:00 AM,48,-122,7,6,13
14162,FremontBridge,05/16/2014 02:00:00 AM,48,-122,1,7,8
14163,FremontBridge,05/16/2014 03:00:00 AM,48,-122,1,2,3
14164,FremontBridge,05/16/2014 04:00:00 AM,48,-122,8,3,11
14165,FremontBridge,05/16/2014 05:00:00 AM,48,-122,19,51,70
14166,FremontBridge,05/16/2014 06:00:00 AM,48,-122,71,262,333
14167,FremontBridge,05/16/2014 07:00:00 AM,48,-122,143,698,841
14168,FremontBridge,05/16/2014 08:00:00 AM,48,-122,189,690,879
14169,FremontBridge,05/16/2014 09:00:00 AM,48,-122,155,234,389
14170,FremontBridge,05/16/2014 10:00:00 AM,48,-122,58,92,150
14171,FremontBridge,05/16/2014 11:00:00 AM,48,-122,53,48,101
14172,FremontBridge,05/16/2014 12:00:00 PM,48,-122,58,64,122
14173,FremontBridge,05/16/2014 01:00:00 PM,48,-122,87,63,150
14174,FremontBridge,05/16/2014 02:00:00 PM,48,-122,88,74,162
14175,FremontBridge,05/16/2014 03:00:00 PM,48,-122,140,105,245
14176,FremontBridge,05/16/2014 04:00:00 PM,48,-122,308,149,457
14177,FremontBridge,05/16/2014 05:00:00 PM,48,-122,564,231,795
14178,FremontBridge,05/16/2014 06:00:00 PM,48,-122,358,155,513
14179,FremontBridge,05/16/2014 07:00:00 PM,48,-122,125,89,214
14180,FremontBridge,05/16/2014 08:00:00 PM,48,-122,68,39,107
14181,FremontBridge,05/16/2014 09:00:00 PM,48,-122,41,30,71
14182,FremontBridge,05/16/2014 10:00:00 PM,48,-122,27,22,49
14183,FremontBridge,05/16/2014 11:00:00 PM,48,-122,21,14,35
14184,FremontBridge,05/17/2014 12:00:00 AM,48,-122,9,10,19
14185,FremontBridge,05/17/2014 01:00:00 AM,48,-122,5,3,8
14186,FremontBridge,05/17/2014 02:00:00 AM,48,-122,9,2,11
14187,FremontBridge,05/17/2014 03:00:00 AM,48,-122,4,3,7
14188,FremontBridge,05/17/2014 04:00:00 AM,48,-122,1,2,3
14189,FremontBridge,05/17/2014 05:00:00 AM,48,-122,7,5,12
14190,FremontBridge,05/17/2014 06:00:00 AM,48,-122,12,12,24
14191,FremontBridge,05/17/2014 07:00:00 AM,48,-122,25,41,66
14192,FremontBridge,05/17/2014 08:00:00 AM,48,-122,37,36,73
14193,FremontBridge,05/17/2014 09:00:00 AM,48,-122,55,45,100
14194,FremontBridge,05/17/2014 10:00:00 AM,48,-122,56,82,138
14195,FremontBridge,05/17/2014 11:00:00 AM,48,-122,81,100,181
14196,FremontBridge,05/17/2014 12:00:00 PM,48,-122,62,105,167
14197,FremontBridge,05/17/2014 01:00:00 PM,48,-122,82,100,182
14198,FremontBridge,05/17/2014 02:00:00 PM,48,-122,90,89,179
14199,FremontBridge,05/17/2014 03:00:00 PM,48,-122,79,84,163
14200,FremontBridge,05/17/2014 04:00:00 PM,48,-122,75,86,161
14201,FremontBridge,05/17/2014 05:00:00 PM,48,-122,63,83,146
14202,FremontBridge,05/17/2014 06:00:00 PM,48,-122,38,69,107
14203,FremontBridge,05/17/2014 07:00:00 PM,48,-122,35,59,94
14204,FremontBridge,05/17/2014 08:00:00 PM,48,-122,27,45,72
14205,FremontBridge,05/17/2014 09:00:00 PM,48,-122,33,24,57
14206,FremontBridge,05/17/2014 10:00:00 PM,48,-122,23,18,41
14207,FremontBridge,05/17/2014 11:00:00 PM,48,-122,17,13,30
14208,FremontBridge,05/18/2014 12:00:00 AM,48,-122,13,4,17
14209,FremontBridge,05/18/2014 01:00:00 AM,48,-122,13,7,20
14210,FremontBridge,05/18/2014 02:00:00 AM,48,-122,7,4,11
14211,FremontBridge,05/18/2014 03:00:00 AM,48,-122,1,1,2
14212,FremontBridge,05/18/2014 04:00:00 AM,48,-122,2,0,2
14213,FremontBridge,05/18/2014 05:00:00 AM,48,-122,4,9,13
14214,FremontBridge,05/18/2014 06:00:00 AM,48,-122,8,8,16
14215,FremontBridge,05/18/2014 07:00:00 AM,48,-122,16,28,44
14216,FremontBridge,05/18/2014 08:00:00 AM,48,-122,21,51,72
14217,FremontBridge,05/18/2014 09:00:00 AM,48,-122,44,57,101
14218,FremontBridge,05/18/2014 10:00:00 AM,48,-122,53,75,128
14219,FremontBridge,05/18/2014 11:00:00 AM,48,-122,67,88,155
14220,FremontBridge,05/18/2014 12:00:00 PM,48,-122,80,89,169
14221,FremontBridge,05/18/2014 01:00:00 PM,48,-122,82,119,201
14222,FremontBridge,05/18/2014 02:00:00 PM,48,-122,111,113,224
14223,FremontBridge,05/18/2014 03:00:00 PM,48,-122,95,148,243
14224,FremontBridge,05/18/2014 04:00:00 PM,48,-122,70,91,161
14225,FremontBridge,05/18/2014 05:00:00 PM,48,-122,52,69,121
14226,FremontBridge,05/18/2014 06:00:00 PM,48,-122,44,62,106
14227,FremontBridge,05/18/2014 07:00:00 PM,48,-122,21,25,46
14228,FremontBridge,05/18/2014 08:00:00 PM,48,-122,14,13,27
14229,FremontBridge,05/18/2014 09:00:00 PM,48,-122,14,12,26
14230,FremontBridge,05/18/2014 10:00:00 PM,48,-122,10,7,17
14231,FremontBridge,05/18/2014 11:00:00 PM,48,-122,6,9,15
14232,FremontBridge,05/19/2014 12:00:00 AM,48,-122,3,4,7
14233,FremontBridge,05/19/2014 01:00:00 AM,48,-122,1,3,4
14234,FremontBridge,05/19/2014 02:00:00 AM,48,-122,4,4,8
14235,FremontBridge,05/19/2014 03:00:00 AM,48,-122,0,1,1
14236,FremontBridge,05/19/2014 04:00:00 AM,48,-122,3,9,12
14237,FremontBridge,05/19/2014 05:00:00 AM,48,-122,22,35,57
14238,FremontBridge,05/19/2014 06:00:00 AM,48,-122,57,140,197
14239,FremontBridge,05/19/2014 07:00:00 AM,48,-122,110,373,483
14240,FremontBridge,05/19/2014 08:00:00 AM,48,-122,174,432,606
14241,FremontBridge,05/19/2014 09:00:00 AM,48,-122,121,171,292
14242,FremontBridge,05/19/2014 10:00:00 AM,48,-122,48,83,131
14243,FremontBridge,05/19/2014 11:00:00 AM,48,-122,58,61,119
14244,FremontBridge,05/19/2014 12:00:00 PM,48,-122,41,54,95
14245,FremontBridge,05/19/2014 01:00:00 PM,48,-122,57,62,119
14246,FremontBridge,05/19/2014 02:00:00 PM,48,-122,58,55,113
14247,FremontBridge,05/19/2014 03:00:00 PM,48,-122,94,80,174
14248,FremontBridge,05/19/2014 04:00:00 PM,48,-122,229,144,373
14249,FremontBridge,05/19/2014 05:00:00 PM,48,-122,524,221,745
14250,FremontBridge,05/19/2014 06:00:00 PM,48,-122,382,219,601
14251,FremontBridge,05/19/2014 07:00:00 PM,48,-122,161,96,257
14252,FremontBridge,05/19/2014 08:00:00 PM,48,-122,83,68,151
14253,FremontBridge,05/19/2014 09:00:00 PM,48,-122,49,38,87
14254,FremontBridge,05/19/2014 10:00:00 PM,48,-122,23,16,39
14255,FremontBridge,05/19/2014 11:00:00 PM,48,-122,20,11,31
14256,FremontBridge,05/20/2014 12:00:00 AM,48,-122,9,8,17
14257,FremontBridge,05/20/2014 01:00:00 AM,48,-122,4,1,5
14258,FremontBridge,05/20/2014 02:00:00 AM,48,-122,2,4,6
14259,FremontBridge,05/20/2014 03:00:00 AM,48,-122,2,4,6
14260,FremontBridge,05/20/2014 04:00:00 AM,48,-122,2,8,10
14261,FremontBridge,05/20/2014 05:00:00 AM,48,-122,20,57,77
14262,FremontBridge,05/20/2014 06:00:00 AM,48,-122,72,174,246
14263,FremontBridge,05/20/2014 07:00:00 AM,48,-122,153,488,641
14264,FremontBridge,05/20/2014 08:00:00 AM,48,-122,224,472,696
14265,FremontBridge,05/20/2014 09:00:00 AM,48,-122,154,214,368
14266,FremontBridge,05/20/2014 10:00:00 AM,48,-122,55,95,150
14267,FremontBridge,05/20/2014 11:00:00 AM,48,-122,64,72,136
14268,FremontBridge,05/20/2014 12:00:00 PM,48,-122,69,60,129
14269,FremontBridge,05/20/2014 01:00:00 PM,48,-122,68,85,153
14270,FremontBridge,05/20/2014 02:00:00 PM,48,-122,85,79,164
14271,FremontBridge,05/20/2014 03:00:00 PM,48,-122,113,96,209
14272,FremontBridge,05/20/2014 04:00:00 PM,48,-122,278,147,425
14273,FremontBridge,05/20/2014 05:00:00 PM,48,-122,667,279,946
14274,FremontBridge,05/20/2014 06:00:00 PM,48,-122,379,208,587
14275,FremontBridge,05/20/2014 07:00:00 PM,48,-122,183,127,310
14276,FremontBridge,05/20/2014 08:00:00 PM,48,-122,114,67,181
14277,FremontBridge,05/20/2014 09:00:00 PM,48,-122,62,47,109
14278,FremontBridge,05/20/2014 10:00:00 PM,48,-122,38,34,72
14279,FremontBridge,05/20/2014 11:00:00 PM,48,-122,18,17,35
14280,FremontBridge,05/21/2014 12:00:00 AM,48,-122,10,6,16
14281,FremontBridge,05/21/2014 01:00:00 AM,48,-122,5,6,11
14282,FremontBridge,05/21/2014 02:00:00 AM,48,-122,0,0,0
14283,FremontBridge,05/21/2014 03:00:00 AM,48,-122,1,3,4
14284,FremontBridge,05/21/2014 04:00:00 AM,48,-122,6,4,10
14285,FremontBridge,05/21/2014 05:00:00 AM,48,-122,16,47,63
14286,FremontBridge,05/21/2014 06:00:00 AM,48,-122,77,177,254
14287,FremontBridge,05/21/2014 07:00:00 AM,48,-122,146,453,599
14288,FremontBridge,05/21/2014 08:00:00 AM,48,-122,198,432,630
14289,FremontBridge,05/21/2014 09:00:00 AM,48,-122,140,199,339
14290,FremontBridge,05/21/2014 10:00:00 AM,48,-122,61,61,122
14291,FremontBridge,05/21/2014 11:00:00 AM,48,-122,33,50,83
14292,FremontBridge,05/21/2014 12:00:00 PM,48,-122,49,57,106
14293,FremontBridge,05/21/2014 01:00:00 PM,48,-122,49,82,131
14294,FremontBridge,05/21/2014 02:00:00 PM,48,-122,62,58,120
14295,FremontBridge,05/21/2014 03:00:00 PM,48,-122,110,96,206
14296,FremontBridge,05/21/2014 04:00:00 PM,48,-122,267,141,408
14297,FremontBridge,05/21/2014 05:00:00 PM,48,-122,585,251,836
14298,FremontBridge,05/21/2014 06:00:00 PM,48,-122,378,205,583
14299,FremontBridge,05/21/2014 07:00:00 PM,48,-122,178,140,318
14300,FremontBridge,05/21/2014 08:00:00 PM,48,-122,92,79,171
14301,FremontBridge,05/21/2014 09:00:00 PM,48,-122,56,60,116
14302,FremontBridge,05/21/2014 10:00:00 PM,48,-122,22,41,63
14303,FremontBridge,05/21/2014 11:00:00 PM,48,-122,22,18,40
14304,FremontBridge,05/22/2014 12:00:00 AM,48,-122,8,9,17
14305,FremontBridge,05/22/2014 01:00:00 AM,48,-122,2,3,5
14306,FremontBridge,05/22/2014 02:00:00 AM,48,-122,1,3,4
14307,FremontBridge,05/22/2014 03:00:00 AM,48,-122,2,0,2
14308,FremontBridge,05/22/2014 04:00:00 AM,48,-122,3,6,9
14309,FremontBridge,05/22/2014 05:00:00 AM,48,-122,18,35,53
14310,FremontBridge,05/22/2014 06:00:00 AM,48,-122,54,171,225
14311,FremontBridge,05/22/2014 07:00:00 AM,48,-122,140,419,559
14312,FremontBridge,05/22/2014 08:00:00 AM,48,-122,189,451,640
14313,FremontBridge,05/22/2014 09:00:00 AM,48,-122,123,178,301
14314,FremontBridge,05/22/2014 10:00:00 AM,48,-122,44,75,119
14315,FremontBridge,05/22/2014 11:00:00 AM,48,-122,53,53,106
14316,FremontBridge,05/22/2014 12:00:00 PM,48,-122,80,64,144
14317,FremontBridge,05/22/2014 01:00:00 PM,48,-122,58,84,142
14318,FremontBridge,05/22/2014 02:00:00 PM,48,-122,69,83,152
14319,FremontBridge,05/22/2014 03:00:00 PM,48,-122,130,76,206
14320,FremontBridge,05/22/2014 04:00:00 PM,48,-122,236,160,396
14321,FremontBridge,05/22/2014 05:00:00 PM,48,-122,516,200,716
14322,FremontBridge,05/22/2014 06:00:00 PM,48,-122,347,188,535
14323,FremontBridge,05/22/2014 07:00:00 PM,48,-122,165,90,255
14324,FremontBridge,05/22/2014 08:00:00 PM,48,-122,87,57,144
14325,FremontBridge,05/22/2014 09:00:00 PM,48,-122,64,44,108
14326,FremontBridge,05/22/2014 10:00:00 PM,48,-122,25,19,44
14327,FremontBridge,05/22/2014 11:00:00 PM,48,-122,23,5,28
14328,FremontBridge,05/23/2014 12:00:00 AM,48,-122,7,3,10
14329,FremontBridge,05/23/2014 01:00:00 AM,48,-122,6,2,8
14330,FremontBridge,05/23/2014 02:00:00 AM,48,-122,0,0,0
14331,FremontBridge,05/23/2014 03:00:00 AM,48,-122,1,0,1
14332,FremontBridge,05/23/2014 04:00:00 AM,48,-122,3,3,6
14333,FremontBridge,05/23/2014 05:00:00 AM,48,-122,15,24,39
14334,FremontBridge,05/23/2014 06:00:00 AM,48,-122,42,106,148
14335,FremontBridge,05/23/2014 07:00:00 AM,48,-122,59,206,265
14336,FremontBridge,05/23/2014 08:00:00 AM,48,-122,84,210,294
14337,FremontBridge,05/23/2014 09:00:00 AM,48,-122,64,88,152
14338,FremontBridge,05/23/2014 10:00:00 AM,48,-122,21,48,69
14339,FremontBridge,05/23/2014 11:00:00 AM,48,-122,23,23,46
14340,FremontBridge,05/23/2014 12:00:00 PM,48,-122,23,36,59
14341,FremontBridge,05/23/2014 01:00:00 PM,48,-122,38,23,61
14342,FremontBridge,05/23/2014 02:00:00 PM,48,-122,66,44,110
14343,FremontBridge,05/23/2014 03:00:00 PM,48,-122,86,57,143
14344,FremontBridge,05/23/2014 04:00:00 PM,48,-122,148,79,227
14345,FremontBridge,05/23/2014 05:00:00 PM,48,-122,253,113,366
14346,FremontBridge,05/23/2014 06:00:00 PM,48,-122,145,102,247
14347,FremontBridge,05/23/2014 07:00:00 PM,48,-122,63,56,119
14348,FremontBridge,05/23/2014 08:00:00 PM,48,-122,48,27,75
14349,FremontBridge,05/23/2014 09:00:00 PM,48,-122,17,29,46
14350,FremontBridge,05/23/2014 10:00:00 PM,48,-122,22,23,45
14351,FremontBridge,05/23/2014 11:00:00 PM,48,-122,14,6,20
14352,FremontBridge,05/24/2014 12:00:00 AM,48,-122,7,10,17
14353,FremontBridge,05/24/2014 01:00:00 AM,48,-122,6,7,13
14354,FremontBridge,05/24/2014 02:00:00 AM,48,-122,2,2,4
14355,FremontBridge,05/24/2014 03:00:00 AM,48,-122,0,1,1
14356,FremontBridge,05/24/2014 04:00:00 AM,48,-122,1,3,4
14357,FremontBridge,05/24/2014 05:00:00 AM,48,-122,3,3,6
14358,FremontBridge,05/24/2014 06:00:00 AM,48,-122,11,19,30
14359,FremontBridge,05/24/2014 07:00:00 AM,48,-122,20,30,50
14360,FremontBridge,05/24/2014 08:00:00 AM,48,-122,38,50,88
14361,FremontBridge,05/24/2014 09:00:00 AM,48,-122,67,49,116
14362,FremontBridge,05/24/2014 10:00:00 AM,48,-122,41,64,105
14363,FremontBridge,05/24/2014 11:00:00 AM,48,-122,104,81,185
14364,FremontBridge,05/24/2014 12:00:00 PM,48,-122,77,95,172
14365,FremontBridge,05/24/2014 01:00:00 PM,48,-122,99,108,207
14366,FremontBridge,05/24/2014 02:00:00 PM,48,-122,72,105,177
14367,FremontBridge,05/24/2014 03:00:00 PM,48,-122,104,97,201
14368,FremontBridge,05/24/2014 04:00:00 PM,48,-122,92,113,205
14369,FremontBridge,05/24/2014 05:00:00 PM,48,-122,67,97,164
14370,FremontBridge,05/24/2014 06:00:00 PM,48,-122,43,72,115
14371,FremontBridge,05/24/2014 07:00:00 PM,48,-122,50,37,87
14372,FremontBridge,05/24/2014 08:00:00 PM,48,-122,42,37,79
14373,FremontBridge,05/24/2014 09:00:00 PM,48,-122,36,19,55
14374,FremontBridge,05/24/2014 10:00:00 PM,48,-122,32,15,47
14375,FremontBridge,05/24/2014 11:00:00 PM,48,-122,17,10,27
14376,FremontBridge,05/25/2014 12:00:00 AM,48,-122,11,11,22
14377,FremontBridge,05/25/2014 01:00:00 AM,48,-122,3,5,8
14378,FremontBridge,05/25/2014 02:00:00 AM,48,-122,5,5,10
14379,FremontBridge,05/25/2014 03:00:00 AM,48,-122,1,2,3
14380,FremontBridge,05/25/2014 04:00:00 AM,48,-122,3,5,8
14381,FremontBridge,05/25/2014 05:00:00 AM,48,-122,3,4,7
14382,FremontBridge,05/25/2014 06:00:00 AM,48,-122,5,8,13
14383,FremontBridge,05/25/2014 07:00:00 AM,48,-122,17,21,38
14384,FremontBridge,05/25/2014 08:00:00 AM,48,-122,29,38,67
14385,FremontBridge,05/25/2014 09:00:00 AM,48,-122,41,44,85
14386,FremontBridge,05/25/2014 10:00:00 AM,48,-122,37,66,103
14387,FremontBridge,05/25/2014 11:00:00 AM,48,-122,74,93,167
14388,FremontBridge,05/25/2014 12:00:00 PM,48,-122,59,91,150
14389,FremontBridge,05/25/2014 01:00:00 PM,48,-122,47,51,98
14390,FremontBridge,05/25/2014 02:00:00 PM,48,-122,34,62,96
14391,FremontBridge,05/25/2014 03:00:00 PM,48,-122,49,49,98
14392,FremontBridge,05/25/2014 04:00:00 PM,48,-122,35,36,71
14393,FremontBridge,05/25/2014 05:00:00 PM,48,-122,28,27,55
14394,FremontBridge,05/25/2014 06:00:00 PM,48,-122,14,17,31
14395,FremontBridge,05/25/2014 07:00:00 PM,48,-122,27,14,41
14396,FremontBridge,05/25/2014 08:00:00 PM,48,-122,17,9,26
14397,FremontBridge,05/25/2014 09:00:00 PM,48,-122,14,7,21
14398,FremontBridge,05/25/2014 10:00:00 PM,48,-122,5,3,8
14399,FremontBridge,05/25/2014 11:00:00 PM,48,-122,6,2,8
14400,FremontBridge,05/26/2014 12:00:00 AM,48,-122,2,5,7
14401,FremontBridge,05/26/2014 01:00:00 AM,48,-122,4,1,5
14402,FremontBridge,05/26/2014 02:00:00 AM,48,-122,2,0,2
14403,FremontBridge,05/26/2014 03:00:00 AM,48,-122,0,1,1
14404,FremontBridge,05/26/2014 04:00:00 AM,48,-122,2,2,4
14405,FremontBridge,05/26/2014 05:00:00 AM,48,-122,10,3,13
14406,FremontBridge,05/26/2014 06:00:00 AM,48,-122,9,5,14
14407,FremontBridge,05/26/2014 07:00:00 AM,48,-122,11,23,34
14408,FremontBridge,05/26/2014 08:00:00 AM,48,-122,25,31,56
14409,FremontBridge,05/26/2014 09:00:00 AM,48,-122,38,44,82
14410,FremontBridge,05/26/2014 10:00:00 AM,48,-122,44,53,97
14411,FremontBridge,05/26/2014 11:00:00 AM,48,-122,70,124,194
14412,FremontBridge,05/26/2014 12:00:00 PM,48,-122,102,149,251
14413,FremontBridge,05/26/2014 01:00:00 PM,48,-122,95,140,235
14414,FremontBridge,05/26/2014 02:00:00 PM,48,-122,111,158,269
14415,FremontBridge,05/26/2014 03:00:00 PM,48,-122,83,113,196
14416,FremontBridge,05/26/2014 04:00:00 PM,48,-122,114,101,215
14417,FremontBridge,05/26/2014 05:00:00 PM,48,-122,77,102,179
14418,FremontBridge,05/26/2014 06:00:00 PM,48,-122,65,72,137
14419,FremontBridge,05/26/2014 07:00:00 PM,48,-122,50,43,93
14420,FremontBridge,05/26/2014 08:00:00 PM,48,-122,42,42,84
14421,FremontBridge,05/26/2014 09:00:00 PM,48,-122,53,25,78
14422,FremontBridge,05/26/2014 10:00:00 PM,48,-122,11,15,26
14423,FremontBridge,05/26/2014 11:00:00 PM,48,-122,9,8,17
14424,FremontBridge,05/27/2014 12:00:00 AM,48,-122,3,6,9
14425,FremontBridge,05/27/2014 01:00:00 AM,48,-122,1,5,6
14426,FremontBridge,05/27/2014 02:00:00 AM,48,-122,1,1,2
14427,FremontBridge,05/27/2014 03:00:00 AM,48,-122,1,2,3
14428,FremontBridge,05/27/2014 04:00:00 AM,48,-122,4,9,13
14429,FremontBridge,05/27/2014 05:00:00 AM,48,-122,19,42,61
14430,FremontBridge,05/27/2014 06:00:00 AM,48,-122,57,158,215
14431,FremontBridge,05/27/2014 07:00:00 AM,48,-122,129,406,535
14432,FremontBridge,05/27/2014 08:00:00 AM,48,-122,186,471,657
14433,FremontBridge,05/27/2014 09:00:00 AM,48,-122,140,190,330
14434,FremontBridge,05/27/2014 10:00:00 AM,48,-122,63,90,153
14435,FremontBridge,05/27/2014 11:00:00 AM,48,-122,39,63,102
14436,FremontBridge,05/27/2014 12:00:00 PM,48,-122,54,63,117
14437,FremontBridge,05/27/2014 01:00:00 PM,48,-122,61,51,112
14438,FremontBridge,05/27/2014 02:00:00 PM,48,-122,68,76,144
14439,FremontBridge,05/27/2014 03:00:00 PM,48,-122,84,90,174
14440,FremontBridge,05/27/2014 04:00:00 PM,48,-122,236,151,387
14441,FremontBridge,05/27/2014 05:00:00 PM,48,-122,567,232,799
14442,FremontBridge,05/27/2014 06:00:00 PM,48,-122,385,203,588
14443,FremontBridge,05/27/2014 07:00:00 PM,48,-122,172,135,307
14444,FremontBridge,05/27/2014 08:00:00 PM,48,-122,102,57,159
14445,FremontBridge,05/27/2014 09:00:00 PM,48,-122,46,35,81
14446,FremontBridge,05/27/2014 10:00:00 PM,48,-122,39,17,56
14447,FremontBridge,05/27/2014 11:00:00 PM,48,-122,13,9,22
14448,FremontBridge,05/28/2014 12:00:00 AM,48,-122,6,3,9
14449,FremontBridge,05/28/2014 01:00:00 AM,48,-122,3,2,5
14450,FremontBridge,05/28/2014 02:00:00 AM,48,-122,2,2,4
14451,FremontBridge,05/28/2014 03:00:00 AM,48,-122,1,1,2
14452,FremontBridge,05/28/2014 04:00:00 AM,48,-122,1,4,5
14453,FremontBridge,05/28/2014 05:00:00 AM,48,-122,13,29,42
14454,FremontBridge,05/28/2014 06:00:00 AM,48,-122,60,123,183
14455,FremontBridge,05/28/2014 07:00:00 AM,48,-122,101,335,436
14456,FremontBridge,05/28/2014 08:00:00 AM,48,-122,170,383,553
14457,FremontBridge,05/28/2014 09:00:00 AM,48,-122,102,189,291
14458,FremontBridge,05/28/2014 10:00:00 AM,48,-122,52,85,137
14459,FremontBridge,05/28/2014 11:00:00 AM,48,-122,38,56,94
14460,FremontBridge,05/28/2014 12:00:00 PM,48,-122,45,51,96
14461,FremontBridge,05/28/2014 01:00:00 PM,48,-122,40,64,104
14462,FremontBridge,05/28/2014 02:00:00 PM,48,-122,70,77,147
14463,FremontBridge,05/28/2014 03:00:00 PM,48,-122,73,58,131
14464,FremontBridge,05/28/2014 04:00:00 PM,48,-122,211,117,328
14465,FremontBridge,05/28/2014 05:00:00 PM,48,-122,428,169,597
14466,FremontBridge,05/28/2014 06:00:00 PM,48,-122,269,145,414
14467,FremontBridge,05/28/2014 07:00:00 PM,48,-122,128,78,206
14468,FremontBridge,05/28/2014 08:00:00 PM,48,-122,53,52,105
14469,FremontBridge,05/28/2014 09:00:00 PM,48,-122,30,32,62
14470,FremontBridge,05/28/2014 10:00:00 PM,48,-122,19,18,37
14471,FremontBridge,05/28/2014 11:00:00 PM,48,-122,15,5,20
14472,FremontBridge,05/29/2014 12:00:00 AM,48,-122,1,1,2
14473,FremontBridge,05/29/2014 01:00:00 AM,48,-122,3,1,4
14474,FremontBridge,05/29/2014 02:00:00 AM,48,-122,2,1,3
14475,FremontBridge,05/29/2014 03:00:00 AM,48,-122,0,4,4
14476,FremontBridge,05/29/2014 04:00:00 AM,48,-122,4,5,9
14477,FremontBridge,05/29/2014 05:00:00 AM,48,-122,17,31,48
14478,FremontBridge,05/29/2014 06:00:00 AM,48,-122,50,144,194
14479,FremontBridge,05/29/2014 07:00:00 AM,48,-122,118,360,478
14480,FremontBridge,05/29/2014 08:00:00 AM,48,-122,166,407,573
14481,FremontBridge,05/29/2014 09:00:00 AM,48,-122,143,198,341
14482,FremontBridge,05/29/2014 10:00:00 AM,48,-122,49,79,128
14483,FremontBridge,05/29/2014 11:00:00 AM,48,-122,40,60,100
14484,FremontBridge,05/29/2014 12:00:00 PM,48,-122,55,58,113
14485,FremontBridge,05/29/2014 01:00:00 PM,48,-122,51,53,104
14486,FremontBridge,05/29/2014 02:00:00 PM,48,-122,62,52,114
14487,FremontBridge,05/29/2014 03:00:00 PM,48,-122,83,78,161
14488,FremontBridge,05/29/2014 04:00:00 PM,48,-122,231,135,366
14489,FremontBridge,05/29/2014 05:00:00 PM,48,-122,534,186,720
14490,FremontBridge,05/29/2014 06:00:00 PM,48,-122,354,192,546
14491,FremontBridge,05/29/2014 07:00:00 PM,48,-122,147,110,257
14492,FremontBridge,05/29/2014 08:00:00 PM,48,-122,81,80,161
14493,FremontBridge,05/29/2014 09:00:00 PM,48,-122,46,33,79
14494,FremontBridge,05/29/2014 10:00:00 PM,48,-122,30,21,51
14495,FremontBridge,05/29/2014 11:00:00 PM,48,-122,20,11,31
14496,FremontBridge,05/30/2014 12:00:00 AM,48,-122,16,19,35
14497,FremontBridge,05/30/2014 01:00:00 AM,48,-122,3,4,7
14498,FremontBridge,05/30/2014 02:00:00 AM,48,-122,1,5,6
14499,FremontBridge,05/30/2014 03:00:00 AM,48,-122,4,5,9
14500,FremontBridge,05/30/2014 04:00:00 AM,48,-122,7,5,12
14501,FremontBridge,05/30/2014 05:00:00 AM,48,-122,14,38,52
14502,FremontBridge,05/30/2014 06:00:00 AM,48,-122,72,126,198
14503,FremontBridge,05/30/2014 07:00:00 AM,48,-122,127,377,504
14504,FremontBridge,05/30/2014 08:00:00 AM,48,-122,188,434,622
14505,FremontBridge,05/30/2014 09:00:00 AM,48,-122,122,178,300
14506,FremontBridge,05/30/2014 10:00:00 AM,48,-122,52,73,125
14507,FremontBridge,05/30/2014 11:00:00 AM,48,-122,52,63,115
14508,FremontBridge,05/30/2014 12:00:00 PM,48,-122,58,67,125
14509,FremontBridge,05/30/2014 01:00:00 PM,48,-122,67,71,138
14510,FremontBridge,05/30/2014 02:00:00 PM,48,-122,93,91,184
14511,FremontBridge,05/30/2014 03:00:00 PM,48,-122,151,106,257
14512,FremontBridge,05/30/2014 04:00:00 PM,48,-122,279,137,416
14513,FremontBridge,05/30/2014 05:00:00 PM,48,-122,482,223,705
14514,FremontBridge,05/30/2014 06:00:00 PM,48,-122,314,170,484
14515,FremontBridge,05/30/2014 07:00:00 PM,48,-122,154,88,242
14516,FremontBridge,05/30/2014 08:00:00 PM,48,-122,67,59,126
14517,FremontBridge,05/30/2014 09:00:00 PM,48,-122,40,55,95
14518,FremontBridge,05/30/2014 10:00:00 PM,48,-122,42,24,66
14519,FremontBridge,05/30/2014 11:00:00 PM,48,-122,27,19,46
14520,FremontBridge,05/31/2014 12:00:00 AM,48,-122,18,9,27
14521,FremontBridge,05/31/2014 01:00:00 AM,48,-122,5,6,11
14522,FremontBridge,05/31/2014 02:00:00 AM,48,-122,2,8,10
14523,FremontBridge,05/31/2014 03:00:00 AM,48,-122,1,3,4
14524,FremontBridge,05/31/2014 04:00:00 AM,48,-122,1,3,4
14525,FremontBridge,05/31/2014 05:00:00 AM,48,-122,2,7,9
14526,FremontBridge,05/31/2014 06:00:00 AM,48,-122,12,19,31
14527,FremontBridge,05/31/2014 07:00:00 AM,48,-122,38,55,93
14528,FremontBridge,05/31/2014 08:00:00 AM,48,-122,49,60,109
14529,FremontBridge,05/31/2014 09:00:00 AM,48,-122,71,75,146
14530,FremontBridge,05/31/2014 10:00:00 AM,48,-122,79,124,203
14531,FremontBridge,05/31/2014 11:00:00 AM,48,-122,64,142,206
14532,FremontBridge,05/31/2014 12:00:00 PM,48,-122,108,150,258
14533,FremontBridge,05/31/2014 01:00:00 PM,48,-122,92,138,230
14534,FremontBridge,05/31/2014 02:00:00 PM,48,-122,126,126,252
14535,FremontBridge,05/31/2014 03:00:00 PM,48,-122,128,138,266
14536,FremontBridge,05/31/2014 04:00:00 PM,48,-122,120,147,267
14537,FremontBridge,05/31/2014 05:00:00 PM,48,-122,100,96,196
14538,FremontBridge,05/31/2014 06:00:00 PM,48,-122,81,99,180
14539,FremontBridge,05/31/2014 07:00:00 PM,48,-122,69,65,134
14540,FremontBridge,05/31/2014 08:00:00 PM,48,-122,43,61,104
14541,FremontBridge,05/31/2014 09:00:00 PM,48,-122,27,27,54
14542,FremontBridge,05/31/2014 10:00:00 PM,48,-122,15,25,40
14543,FremontBridge,05/31/2014 11:00:00 PM,48,-122,27,26,53
14544,FremontBridge,06/01/2014 12:00:00 AM,48,-122,17,5,22
14545,FremontBridge,06/01/2014 01:00:00 AM,48,-122,9,7,16
14546,FremontBridge,06/01/2014 02:00:00 AM,48,-122,5,14,19
14547,FremontBridge,06/01/2014 03:00:00 AM,48,-122,0,3,3
14548,FremontBridge,06/01/2014 04:00:00 AM,48,-122,3,1,4
14549,FremontBridge,06/01/2014 05:00:00 AM,48,-122,3,4,7
14550,FremontBridge,06/01/2014 06:00:00 AM,48,-122,8,18,26
14551,FremontBridge,06/01/2014 07:00:00 AM,48,-122,19,28,47
14552,FremontBridge,06/01/2014 08:00:00 AM,48,-122,33,45,78
14553,FremontBridge,06/01/2014 09:00:00 AM,48,-122,50,79,129
14554,FremontBridge,06/01/2014 10:00:00 AM,48,-122,66,76,142
14555,FremontBridge,06/01/2014 11:00:00 AM,48,-122,81,110,191
14556,FremontBridge,06/01/2014 12:00:00 PM,48,-122,101,116,217
14557,FremontBridge,06/01/2014 01:00:00 PM,48,-122,113,115,228
14558,FremontBridge,06/01/2014 02:00:00 PM,48,-122,98,161,259
14559,FremontBridge,06/01/2014 03:00:00 PM,48,-122,104,144,248
14560,FremontBridge,06/01/2014 04:00:00 PM,48,-122,136,145,281
14561,FremontBridge,06/01/2014 05:00:00 PM,48,-122,81,88,169
14562,FremontBridge,06/01/2014 06:00:00 PM,48,-122,89,94,183
14563,FremontBridge,06/01/2014 07:00:00 PM,48,-122,49,92,141
14564,FremontBridge,06/01/2014 08:00:00 PM,48,-122,44,50,94
14565,FremontBridge,06/01/2014 09:00:00 PM,48,-122,29,24,53
14566,FremontBridge,06/01/2014 10:00:00 PM,48,-122,19,10,29
14567,FremontBridge,06/01/2014 11:00:00 PM,48,-122,6,9,15
14568,FremontBridge,06/02/2014 12:00:00 AM,48,-122,6,0,6
14569,FremontBridge,06/02/2014 01:00:00 AM,48,-122,4,1,5
14570,FremontBridge,06/02/2014 02:00:00 AM,48,-122,0,1,1
14571,FremontBridge,06/02/2014 03:00:00 AM,48,-122,2,3,5
14572,FremontBridge,06/02/2014 04:00:00 AM,48,-122,5,5,10
14573,FremontBridge,06/02/2014 05:00:00 AM,48,-122,23,38,61
14574,FremontBridge,06/02/2014 06:00:00 AM,48,-122,55,145,200
14575,FremontBridge,06/02/2014 07:00:00 AM,48,-122,109,352,461
14576,FremontBridge,06/02/2014 08:00:00 AM,48,-122,189,454,643
14577,FremontBridge,06/02/2014 09:00:00 AM,48,-122,137,197,334
14578,FremontBridge,06/02/2014 10:00:00 AM,48,-122,44,79,123
14579,FremontBridge,06/02/2014 11:00:00 AM,48,-122,54,55,109
14580,FremontBridge,06/02/2014 12:00:00 PM,48,-122,56,52,108
14581,FremontBridge,06/02/2014 01:00:00 PM,48,-122,72,67,139
14582,FremontBridge,06/02/2014 02:00:00 PM,48,-122,83,72,155
14583,FremontBridge,06/02/2014 03:00:00 PM,48,-122,92,87,179
14584,FremontBridge,06/02/2014 04:00:00 PM,48,-122,251,130,381
14585,FremontBridge,06/02/2014 05:00:00 PM,48,-122,543,231,774
14586,FremontBridge,06/02/2014 06:00:00 PM,48,-122,380,212,592
14587,FremontBridge,06/02/2014 07:00:00 PM,48,-122,189,103,292
14588,FremontBridge,06/02/2014 08:00:00 PM,48,-122,94,74,168
14589,FremontBridge,06/02/2014 09:00:00 PM,48,-122,52,33,85
14590,FremontBridge,06/02/2014 10:00:00 PM,48,-122,26,22,48
14591,FremontBridge,06/02/2014 11:00:00 PM,48,-122,21,14,35
14592,FremontBridge,06/03/2014 12:00:00 AM,48,-122,7,7,14
14593,FremontBridge,06/03/2014 01:00:00 AM,48,-122,3,4,7
14594,FremontBridge,06/03/2014 02:00:00 AM,48,-122,0,1,1
14595,FremontBridge,06/03/2014 03:00:00 AM,48,-122,1,2,3
14596,FremontBridge,06/03/2014 04:00:00 AM,48,-122,6,5,11
14597,FremontBridge,06/03/2014 05:00:00 AM,48,-122,16,39,55
14598,FremontBridge,06/03/2014 06:00:00 AM,48,-122,68,140,208
14599,FremontBridge,06/03/2014 07:00:00 AM,48,-122,110,376,486
14600,FremontBridge,06/03/2014 08:00:00 AM,48,-122,183,423,606
14601,FremontBridge,06/03/2014 09:00:00 AM,48,-122,136,193,329
14602,FremontBridge,06/03/2014 10:00:00 AM,48,-122,47,65,112
14603,FremontBridge,06/03/2014 11:00:00 AM,48,-122,55,54,109
14604,FremontBridge,06/03/2014 12:00:00 PM,48,-122,48,74,122
14605,FremontBridge,06/03/2014 01:00:00 PM,48,-122,46,46,92
14606,FremontBridge,06/03/2014 02:00:00 PM,48,-122,59,64,123
14607,FremontBridge,06/03/2014 03:00:00 PM,48,-122,83,73,156
14608,FremontBridge,06/03/2014 04:00:00 PM,48,-122,211,134,345
14609,FremontBridge,06/03/2014 05:00:00 PM,48,-122,503,198,701
14610,FremontBridge,06/03/2014 06:00:00 PM,48,-122,381,199,580
14611,FremontBridge,06/03/2014 07:00:00 PM,48,-122,152,117,269
14612,FremontBridge,06/03/2014 08:00:00 PM,48,-122,85,59,144
14613,FremontBridge,06/03/2014 09:00:00 PM,48,-122,51,51,102
14614,FremontBridge,06/03/2014 10:00:00 PM,48,-122,29,35,64
14615,FremontBridge,06/03/2014 11:00:00 PM,48,-122,19,12,31
14616,FremontBridge,06/04/2014 12:00:00 AM,48,-122,9,12,21
14617,FremontBridge,06/04/2014 01:00:00 AM,48,-122,6,1,7
14618,FremontBridge,06/04/2014 02:00:00 AM,48,-122,2,3,5
14619,FremontBridge,06/04/2014 03:00:00 AM,48,-122,2,3,5
14620,FremontBridge,06/04/2014 04:00:00 AM,48,-122,6,6,12
14621,FremontBridge,06/04/2014 05:00:00 AM,48,-122,13,37,50
14622,FremontBridge,06/04/2014 06:00:00 AM,48,-122,68,127,195
14623,FremontBridge,06/04/2014 07:00:00 AM,48,-122,103,379,482
14624,FremontBridge,06/04/2014 08:00:00 AM,48,-122,190,435,625
14625,FremontBridge,06/04/2014 09:00:00 AM,48,-122,120,193,313
14626,FremontBridge,06/04/2014 10:00:00 AM,48,-122,54,70,124
14627,FremontBridge,06/04/2014 11:00:00 AM,48,-122,50,54,104
14628,FremontBridge,06/04/2014 12:00:00 PM,48,-122,62,66,128
14629,FremontBridge,06/04/2014 01:00:00 PM,48,-122,69,70,139
14630,FremontBridge,06/04/2014 02:00:00 PM,48,-122,60,53,113
14631,FremontBridge,06/04/2014 03:00:00 PM,48,-122,106,87,193
14632,FremontBridge,06/04/2014 04:00:00 PM,48,-122,251,129,380
14633,FremontBridge,06/04/2014 05:00:00 PM,48,-122,501,242,743
14634,FremontBridge,06/04/2014 06:00:00 PM,48,-122,362,193,555
14635,FremontBridge,06/04/2014 07:00:00 PM,48,-122,179,123,302
14636,FremontBridge,06/04/2014 08:00:00 PM,48,-122,103,68,171
14637,FremontBridge,06/04/2014 09:00:00 PM,48,-122,40,59,99
14638,FremontBridge,06/04/2014 10:00:00 PM,48,-122,27,39,66
14639,FremontBridge,06/04/2014 11:00:00 PM,48,-122,17,14,31
14640,FremontBridge,06/05/2014 12:00:00 AM,48,-122,8,11,19
14641,FremontBridge,06/05/2014 01:00:00 AM,48,-122,4,3,7
14642,FremontBridge,06/05/2014 02:00:00 AM,48,-122,1,9,10
14643,FremontBridge,06/05/2014 03:00:00 AM,48,-122,1,3,4
14644,FremontBridge,06/05/2014 04:00:00 AM,48,-122,6,7,13
14645,FremontBridge,06/05/2014 05:00:00 AM,48,-122,14,35,49
14646,FremontBridge,06/05/2014 06:00:00 AM,48,-122,57,131,188
14647,FremontBridge,06/05/2014 07:00:00 AM,48,-122,108,386,494
14648,FremontBridge,06/05/2014 08:00:00 AM,48,-122,199,409,608
14649,FremontBridge,06/05/2014 09:00:00 AM,48,-122,123,176,299
14650,FremontBridge,06/05/2014 10:00:00 AM,48,-122,63,76,139
14651,FremontBridge,06/05/2014 11:00:00 AM,48,-122,37,57,94
14652,FremontBridge,06/05/2014 12:00:00 PM,48,-122,61,58,119
14653,FremontBridge,06/05/2014 01:00:00 PM,48,-122,66,80,146
14654,FremontBridge,06/05/2014 02:00:00 PM,48,-122,68,77,145
14655,FremontBridge,06/05/2014 03:00:00 PM,48,-122,109,87,196
14656,FremontBridge,06/05/2014 04:00:00 PM,48,-122,199,109,308
14657,FremontBridge,06/05/2014 05:00:00 PM,48,-122,479,170,649
14658,FremontBridge,06/05/2014 06:00:00 PM,48,-122,352,167,519
14659,FremontBridge,06/05/2014 07:00:00 PM,48,-122,170,108,278
14660,FremontBridge,06/05/2014 08:00:00 PM,48,-122,96,74,170
14661,FremontBridge,06/05/2014 09:00:00 PM,48,-122,68,48,116
14662,FremontBridge,06/05/2014 10:00:00 PM,48,-122,39,30,69
14663,FremontBridge,06/05/2014 11:00:00 PM,48,-122,25,11,36
14664,FremontBridge,06/06/2014 12:00:00 AM,48,-122,10,12,22
14665,FremontBridge,06/06/2014 01:00:00 AM,48,-122,9,8,17
14666,FremontBridge,06/06/2014 02:00:00 AM,48,-122,5,1,6
14667,FremontBridge,06/06/2014 03:00:00 AM,48,-122,2,5,7
14668,FremontBridge,06/06/2014 04:00:00 AM,48,-122,4,9,13
14669,FremontBridge,06/06/2014 05:00:00 AM,48,-122,14,26,40
14670,FremontBridge,06/06/2014 06:00:00 AM,48,-122,49,118,167
14671,FremontBridge,06/06/2014 07:00:00 AM,48,-122,110,273,383
14672,FremontBridge,06/06/2014 08:00:00 AM,48,-122,144,388,532
14673,FremontBridge,06/06/2014 09:00:00 AM,48,-122,108,178,286
14674,FremontBridge,06/06/2014 10:00:00 AM,48,-122,58,74,132
14675,FremontBridge,06/06/2014 11:00:00 AM,48,-122,58,68,126
14676,FremontBridge,06/06/2014 12:00:00 PM,48,-122,68,75,143
14677,FremontBridge,06/06/2014 01:00:00 PM,48,-122,82,78,160
14678,FremontBridge,06/06/2014 02:00:00 PM,48,-122,90,96,186
14679,FremontBridge,06/06/2014 03:00:00 PM,48,-122,121,102,223
14680,FremontBridge,06/06/2014 04:00:00 PM,48,-122,246,124,370
14681,FremontBridge,06/06/2014 05:00:00 PM,48,-122,452,173,625
14682,FremontBridge,06/06/2014 06:00:00 PM,48,-122,235,150,385
14683,FremontBridge,06/06/2014 07:00:00 PM,48,-122,152,100,252
14684,FremontBridge,06/06/2014 08:00:00 PM,48,-122,65,60,125
14685,FremontBridge,06/06/2014 09:00:00 PM,48,-122,46,38,84
14686,FremontBridge,06/06/2014 10:00:00 PM,48,-122,37,28,65
14687,FremontBridge,06/06/2014 11:00:00 PM,48,-122,17,16,33
14688,FremontBridge,06/07/2014 12:00:00 AM,48,-122,13,7,20
14689,FremontBridge,06/07/2014 01:00:00 AM,48,-122,9,10,19
14690,FremontBridge,06/07/2014 02:00:00 AM,48,-122,8,6,14
14691,FremontBridge,06/07/2014 03:00:00 AM,48,-122,2,2,4
14692,FremontBridge,06/07/2014 04:00:00 AM,48,-122,0,2,2
14693,FremontBridge,06/07/2014 05:00:00 AM,48,-122,5,7,12
14694,FremontBridge,06/07/2014 06:00:00 AM,48,-122,17,17,34
14695,FremontBridge,06/07/2014 07:00:00 AM,48,-122,39,59,98
14696,FremontBridge,06/07/2014 08:00:00 AM,48,-122,58,52,110
14697,FremontBridge,06/07/2014 09:00:00 AM,48,-122,71,79,150
14698,FremontBridge,06/07/2014 10:00:00 AM,48,-122,74,95,169
14699,FremontBridge,06/07/2014 11:00:00 AM,48,-122,103,127,230
14700,FremontBridge,06/07/2014 12:00:00 PM,48,-122,81,121,202
14701,FremontBridge,06/07/2014 01:00:00 PM,48,-122,127,161,288
14702,FremontBridge,06/07/2014 02:00:00 PM,48,-122,98,154,252
14703,FremontBridge,06/07/2014 03:00:00 PM,48,-122,124,123,247
14704,FremontBridge,06/07/2014 04:00:00 PM,48,-122,122,121,243
14705,FremontBridge,06/07/2014 05:00:00 PM,48,-122,79,108,187
14706,FremontBridge,06/07/2014 06:00:00 PM,48,-122,73,87,160
14707,FremontBridge,06/07/2014 07:00:00 PM,48,-122,53,68,121
14708,FremontBridge,06/07/2014 08:00:00 PM,48,-122,38,51,89
14709,FremontBridge,06/07/2014 09:00:00 PM,48,-122,49,33,82
14710,FremontBridge,06/07/2014 10:00:00 PM,48,-122,17,20,37
14711,FremontBridge,06/07/2014 11:00:00 PM,48,-122,18,19,37
14712,FremontBridge,06/08/2014 12:00:00 AM,48,-122,28,8,36
14713,FremontBridge,06/08/2014 01:00:00 AM,48,-122,8,4,12
14714,FremontBridge,06/08/2014 02:00:00 AM,48,-122,11,4,15
14715,FremontBridge,06/08/2014 03:00:00 AM,48,-122,1,2,3
14716,FremontBridge,06/08/2014 04:00:00 AM,48,-122,3,2,5
14717,FremontBridge,06/08/2014 05:00:00 AM,48,-122,3,10,13
14718,FremontBridge,06/08/2014 06:00:00 AM,48,-122,11,18,29
14719,FremontBridge,06/08/2014 07:00:00 AM,48,-122,22,29,51
14720,FremontBridge,06/08/2014 08:00:00 AM,48,-122,47,63,110
14721,FremontBridge,06/08/2014 09:00:00 AM,48,-122,330,83,413
14722,FremontBridge,06/08/2014 10:00:00 AM,48,-122,269,89,358
14723,FremontBridge,06/08/2014 11:00:00 AM,48,-122,77,124,201
14724,FremontBridge,06/08/2014 12:00:00 PM,48,-122,91,305,396
14725,FremontBridge,06/08/2014 01:00:00 PM,48,-122,120,312,432
14726,FremontBridge,06/08/2014 02:00:00 PM,48,-122,122,174,296
14727,FremontBridge,06/08/2014 03:00:00 PM,48,-122,116,160,276
14728,FremontBridge,06/08/2014 04:00:00 PM,48,-122,107,149,256
14729,FremontBridge,06/08/2014 05:00:00 PM,48,-122,96,102,198
14730,FremontBridge,06/08/2014 06:00:00 PM,48,-122,64,104,168
14731,FremontBridge,06/08/2014 07:00:00 PM,48,-122,42,58,100
14732,FremontBridge,06/08/2014 08:00:00 PM,48,-122,37,43,80
14733,FremontBridge,06/08/2014 09:00:00 PM,48,-122,14,32,46
14734,FremontBridge,06/08/2014 10:00:00 PM,48,-122,14,17,31
14735,FremontBridge,06/08/2014 11:00:00 PM,48,-122,14,8,22
14736,FremontBridge,06/09/2014 12:00:00 AM,48,-122,10,5,15
14737,FremontBridge,06/09/2014 01:00:00 AM,48,-122,5,4,9
14738,FremontBridge,06/09/2014 02:00:00 AM,48,-122,2,2,4
14739,FremontBridge,06/09/2014 03:00:00 AM,48,-122,1,3,4
14740,FremontBridge,06/09/2014 04:00:00 AM,48,-122,5,8,13
14741,FremontBridge,06/09/2014 05:00:00 AM,48,-122,14,22,36
14742,FremontBridge,06/09/2014 06:00:00 AM,48,-122,48,127,175
14743,FremontBridge,06/09/2014 07:00:00 AM,48,-122,106,301,407
14744,FremontBridge,06/09/2014 08:00:00 AM,48,-122,192,400,592
14745,FremontBridge,06/09/2014 09:00:00 AM,48,-122,101,192,293
14746,FremontBridge,06/09/2014 10:00:00 AM,48,-122,49,60,109
14747,FremontBridge,06/09/2014 11:00:00 AM,48,-122,45,52,97
14748,FremontBridge,06/09/2014 12:00:00 PM,48,-122,40,43,83
14749,FremontBridge,06/09/2014 01:00:00 PM,48,-122,52,49,101
14750,FremontBridge,06/09/2014 02:00:00 PM,48,-122,56,50,106
14751,FremontBridge,06/09/2014 03:00:00 PM,48,-122,80,75,155
14752,FremontBridge,06/09/2014 04:00:00 PM,48,-122,184,123,307
14753,FremontBridge,06/09/2014 05:00:00 PM,48,-122,483,180,663
14754,FremontBridge,06/09/2014 06:00:00 PM,48,-122,349,151,500
14755,FremontBridge,06/09/2014 07:00:00 PM,48,-122,126,89,215
14756,FremontBridge,06/09/2014 08:00:00 PM,48,-122,64,46,110
14757,FremontBridge,06/09/2014 09:00:00 PM,48,-122,28,28,56
14758,FremontBridge,06/09/2014 10:00:00 PM,48,-122,26,20,46
14759,FremontBridge,06/09/2014 11:00:00 PM,48,-122,22,10,32
14760,FremontBridge,06/10/2014 12:00:00 AM,48,-122,7,5,12
14761,FremontBridge,06/10/2014 01:00:00 AM,48,-122,5,2,7
14762,FremontBridge,06/10/2014 02:00:00 AM,48,-122,3,5,8
14763,FremontBridge,06/10/2014 03:00:00 AM,48,-122,0,3,3
14764,FremontBridge,06/10/2014 04:00:00 AM,48,-122,6,8,14
14765,FremontBridge,06/10/2014 05:00:00 AM,48,-122,16,31,47
14766,FremontBridge,06/10/2014 06:00:00 AM,48,-122,59,142,201
14767,FremontBridge,06/10/2014 07:00:00 AM,48,-122,116,337,453
14768,FremontBridge,06/10/2014 08:00:00 AM,48,-122,175,425,600
14769,FremontBridge,06/10/2014 09:00:00 AM,48,-122,143,176,319
14770,FremontBridge,06/10/2014 10:00:00 AM,48,-122,55,70,125
14771,FremontBridge,06/10/2014 11:00:00 AM,48,-122,49,47,96
14772,FremontBridge,06/10/2014 12:00:00 PM,48,-122,51,56,107
14773,FremontBridge,06/10/2014 01:00:00 PM,48,-122,40,59,99
14774,FremontBridge,06/10/2014 02:00:00 PM,48,-122,75,65,140
14775,FremontBridge,06/10/2014 03:00:00 PM,48,-122,87,77,164
14776,FremontBridge,06/10/2014 04:00:00 PM,48,-122,227,120,347
14777,FremontBridge,06/10/2014 05:00:00 PM,48,-122,446,199,645
14778,FremontBridge,06/10/2014 06:00:00 PM,48,-122,358,167,525
14779,FremontBridge,06/10/2014 07:00:00 PM,48,-122,156,115,271
14780,FremontBridge,06/10/2014 08:00:00 PM,48,-122,92,65,157
14781,FremontBridge,06/10/2014 09:00:00 PM,48,-122,49,37,86
14782,FremontBridge,06/10/2014 10:00:00 PM,48,-122,41,29,70
14783,FremontBridge,06/10/2014 11:00:00 PM,48,-122,21,13,34
14784,FremontBridge,06/11/2014 12:00:00 AM,48,-122,16,10,26
14785,FremontBridge,06/11/2014 01:00:00 AM,48,-122,4,2,6
14786,FremontBridge,06/11/2014 02:00:00 AM,48,-122,2,1,3
14787,FremontBridge,06/11/2014 03:00:00 AM,48,-122,2,3,5
14788,FremontBridge,06/11/2014 04:00:00 AM,48,-122,5,8,13
14789,FremontBridge,06/11/2014 05:00:00 AM,48,-122,24,31,55
14790,FremontBridge,06/11/2014 06:00:00 AM,48,-122,60,162,222
14791,FremontBridge,06/11/2014 07:00:00 AM,48,-122,133,373,506
14792,FremontBridge,06/11/2014 08:00:00 AM,48,-122,185,446,631
14793,FremontBridge,06/11/2014 09:00:00 AM,48,-122,130,205,335
14794,FremontBridge,06/11/2014 10:00:00 AM,48,-122,68,79,147
14795,FremontBridge,06/11/2014 11:00:00 AM,48,-122,60,61,121
14796,FremontBridge,06/11/2014 12:00:00 PM,48,-122,60,63,123
14797,FremontBridge,06/11/2014 01:00:00 PM,48,-122,69,78,147
14798,FremontBridge,06/11/2014 02:00:00 PM,48,-122,77,90,167
14799,FremontBridge,06/11/2014 03:00:00 PM,48,-122,115,112,227
14800,FremontBridge,06/11/2014 04:00:00 PM,48,-122,231,154,385
14801,FremontBridge,06/11/2014 05:00:00 PM,48,-122,565,238,803
14802,FremontBridge,06/11/2014 06:00:00 PM,48,-122,397,222,619
14803,FremontBridge,06/11/2014 07:00:00 PM,48,-122,155,142,297
14804,FremontBridge,06/11/2014 08:00:00 PM,48,-122,88,85,173
14805,FremontBridge,06/11/2014 09:00:00 PM,48,-122,41,48,89
14806,FremontBridge,06/11/2014 10:00:00 PM,48,-122,38,32,70
14807,FremontBridge,06/11/2014 11:00:00 PM,48,-122,17,9,26
14808,FremontBridge,06/12/2014 12:00:00 AM,48,-122,13,13,26
14809,FremontBridge,06/12/2014 01:00:00 AM,48,-122,5,4,9
14810,FremontBridge,06/12/2014 02:00:00 AM,48,-122,1,4,5
14811,FremontBridge,06/12/2014 03:00:00 AM,48,-122,3,2,5
14812,FremontBridge,06/12/2014 04:00:00 AM,48,-122,8,9,17
14813,FremontBridge,06/12/2014 05:00:00 AM,48,-122,24,25,49
14814,FremontBridge,06/12/2014 06:00:00 AM,48,-122,53,125,178
14815,FremontBridge,06/12/2014 07:00:00 AM,48,-122,103,320,423
14816,FremontBridge,06/12/2014 08:00:00 AM,48,-122,143,372,515
14817,FremontBridge,06/12/2014 09:00:00 AM,48,-122,91,193,284
14818,FremontBridge,06/12/2014 10:00:00 AM,48,-122,53,69,122
14819,FremontBridge,06/12/2014 11:00:00 AM,48,-122,39,48,87
14820,FremontBridge,06/12/2014 12:00:00 PM,48,-122,50,62,112
14821,FremontBridge,06/12/2014 01:00:00 PM,48,-122,46,68,114
14822,FremontBridge,06/12/2014 02:00:00 PM,48,-122,68,59,127
14823,FremontBridge,06/12/2014 03:00:00 PM,48,-122,85,81,166
14824,FremontBridge,06/12/2014 04:00:00 PM,48,-122,181,109,290
14825,FremontBridge,06/12/2014 05:00:00 PM,48,-122,437,197,634
14826,FremontBridge,06/12/2014 06:00:00 PM,48,-122,298,146,444
14827,FremontBridge,06/12/2014 07:00:00 PM,48,-122,133,82,215
14828,FremontBridge,06/12/2014 08:00:00 PM,48,-122,64,54,118
14829,FremontBridge,06/12/2014 09:00:00 PM,48,-122,37,35,72
14830,FremontBridge,06/12/2014 10:00:00 PM,48,-122,21,11,32
14831,FremontBridge,06/12/2014 11:00:00 PM,48,-122,23,10,33
14832,FremontBridge,06/13/2014 12:00:00 AM,48,-122,11,4,15
14833,FremontBridge,06/13/2014 01:00:00 AM,48,-122,2,5,7
14834,FremontBridge,06/13/2014 02:00:00 AM,48,-122,4,2,6
14835,FremontBridge,06/13/2014 03:00:00 AM,48,-122,5,2,7
14836,FremontBridge,06/13/2014 04:00:00 AM,48,-122,6,6,12
14837,FremontBridge,06/13/2014 05:00:00 AM,48,-122,8,19,27
14838,FremontBridge,06/13/2014 06:00:00 AM,48,-122,23,62,85
14839,FremontBridge,06/13/2014 07:00:00 AM,48,-122,55,150,205
14840,FremontBridge,06/13/2014 08:00:00 AM,48,-122,81,216,297
14841,FremontBridge,06/13/2014 09:00:00 AM,48,-122,62,109,171
14842,FremontBridge,06/13/2014 10:00:00 AM,48,-122,39,43,82
14843,FremontBridge,06/13/2014 11:00:00 AM,48,-122,22,37,59
14844,FremontBridge,06/13/2014 12:00:00 PM,48,-122,28,25,53
14845,FremontBridge,06/13/2014 01:00:00 PM,48,-122,32,31,63
14846,FremontBridge,06/13/2014 02:00:00 PM,48,-122,45,30,75
14847,FremontBridge,06/13/2014 03:00:00 PM,48,-122,61,55,116
14848,FremontBridge,06/13/2014 04:00:00 PM,48,-122,126,69,195
14849,FremontBridge,06/13/2014 05:00:00 PM,48,-122,223,101,324
14850,FremontBridge,06/13/2014 06:00:00 PM,48,-122,138,56,194
14851,FremontBridge,06/13/2014 07:00:00 PM,48,-122,71,36,107
14852,FremontBridge,06/13/2014 08:00:00 PM,48,-122,41,28,69
14853,FremontBridge,06/13/2014 09:00:00 PM,48,-122,24,15,39
14854,FremontBridge,06/13/2014 10:00:00 PM,48,-122,12,14,26
14855,FremontBridge,06/13/2014 11:00:00 PM,48,-122,16,16,32
14856,FremontBridge,06/14/2014 12:00:00 AM,48,-122,15,8,23
14857,FremontBridge,06/14/2014 01:00:00 AM,48,-122,8,12,20
14858,FremontBridge,06/14/2014 02:00:00 AM,48,-122,4,2,6
14859,FremontBridge,06/14/2014 03:00:00 AM,48,-122,2,4,6
14860,FremontBridge,06/14/2014 04:00:00 AM,48,-122,2,8,10
14861,FremontBridge,06/14/2014 05:00:00 AM,48,-122,3,4,7
14862,FremontBridge,06/14/2014 06:00:00 AM,48,-122,15,13,28
14863,FremontBridge,06/14/2014 07:00:00 AM,48,-122,28,30,58
14864,FremontBridge,06/14/2014 08:00:00 AM,48,-122,34,42,76
14865,FremontBridge,06/14/2014 09:00:00 AM,48,-122,61,65,126
14866,FremontBridge,06/14/2014 10:00:00 AM,48,-122,51,55,106
14867,FremontBridge,06/14/2014 11:00:00 AM,48,-122,39,86,125
14868,FremontBridge,06/14/2014 12:00:00 PM,48,-122,75,61,136
14869,FremontBridge,06/14/2014 01:00:00 PM,48,-122,52,72,124
14870,FremontBridge,06/14/2014 02:00:00 PM,48,-122,79,83,162
14871,FremontBridge,06/14/2014 03:00:00 PM,48,-122,53,74,127
14872,FremontBridge,06/14/2014 04:00:00 PM,48,-122,62,78,140
14873,FremontBridge,06/14/2014 05:00:00 PM,48,-122,52,83,135
14874,FremontBridge,06/14/2014 06:00:00 PM,48,-122,56,64,120
14875,FremontBridge,06/14/2014 07:00:00 PM,48,-122,33,46,79
14876,FremontBridge,06/14/2014 08:00:00 PM,48,-122,37,24,61
14877,FremontBridge,06/14/2014 09:00:00 PM,48,-122,16,12,28
14878,FremontBridge,06/14/2014 10:00:00 PM,48,-122,27,16,43
14879,FremontBridge,06/14/2014 11:00:00 PM,48,-122,14,13,27
14880,FremontBridge,06/15/2014 12:00:00 AM,48,-122,7,4,11
14881,FremontBridge,06/15/2014 01:00:00 AM,48,-122,6,3,9
14882,FremontBridge,06/15/2014 02:00:00 AM,48,-122,4,1,5
14883,FremontBridge,06/15/2014 03:00:00 AM,48,-122,1,2,3
14884,FremontBridge,06/15/2014 04:00:00 AM,48,-122,2,1,3
14885,FremontBridge,06/15/2014 05:00:00 AM,48,-122,3,2,5
14886,FremontBridge,06/15/2014 06:00:00 AM,48,-122,6,6,12
14887,FremontBridge,06/15/2014 07:00:00 AM,48,-122,7,12,19
14888,FremontBridge,06/15/2014 08:00:00 AM,48,-122,14,28,42
14889,FremontBridge,06/15/2014 09:00:00 AM,48,-122,18,52,70
14890,FremontBridge,06/15/2014 10:00:00 AM,48,-122,45,42,87
14891,FremontBridge,06/15/2014 11:00:00 AM,48,-122,43,75,118
14892,FremontBridge,06/15/2014 12:00:00 PM,48,-122,51,82,133
14893,FremontBridge,06/15/2014 01:00:00 PM,48,-122,49,80,129
14894,FremontBridge,06/15/2014 02:00:00 PM,48,-122,55,81,136
14895,FremontBridge,06/15/2014 03:00:00 PM,48,-122,53,66,119
14896,FremontBridge,06/15/2014 04:00:00 PM,48,-122,69,55,124
14897,FremontBridge,06/15/2014 05:00:00 PM,48,-122,41,49,90
14898,FremontBridge,06/15/2014 06:00:00 PM,48,-122,20,42,62
14899,FremontBridge,06/15/2014 07:00:00 PM,48,-122,21,13,34
14900,FremontBridge,06/15/2014 08:00:00 PM,48,-122,8,9,17
14901,FremontBridge,06/15/2014 09:00:00 PM,48,-122,10,5,15
14902,FremontBridge,06/15/2014 10:00:00 PM,48,-122,10,5,15
14903,FremontBridge,06/15/2014 11:00:00 PM,48,-122,4,5,9
14904,FremontBridge,06/16/2014 12:00:00 AM,48,-122,1,3,4
14905,FremontBridge,06/16/2014 01:00:00 AM,48,-122,5,2,7
14906,FremontBridge,06/16/2014 02:00:00 AM,48,-122,0,2,2
14907,FremontBridge,06/16/2014 03:00:00 AM,48,-122,2,2,4
14908,FremontBridge,06/16/2014 04:00:00 AM,48,-122,6,6,12
14909,FremontBridge,06/16/2014 05:00:00 AM,48,-122,15,25,40
14910,FremontBridge,06/16/2014 06:00:00 AM,48,-122,55,90,145
14911,FremontBridge,06/16/2014 07:00:00 AM,48,-122,85,248,333
14912,FremontBridge,06/16/2014 08:00:00 AM,48,-122,140,308,448
14913,FremontBridge,06/16/2014 09:00:00 AM,48,-122,69,92,161
14914,FremontBridge,06/16/2014 10:00:00 AM,48,-122,26,33,59
14915,FremontBridge,06/16/2014 11:00:00 AM,48,-122,25,61,86
14916,FremontBridge,06/16/2014 12:00:00 PM,48,-122,30,32,62
14917,FremontBridge,06/16/2014 01:00:00 PM,48,-122,42,39,81
14918,FremontBridge,06/16/2014 02:00:00 PM,48,-122,54,56,110
14919,FremontBridge,06/16/2014 03:00:00 PM,48,-122,75,58,133
14920,FremontBridge,06/16/2014 04:00:00 PM,48,-122,134,87,221
14921,FremontBridge,06/16/2014 05:00:00 PM,48,-122,354,184,538
14922,FremontBridge,06/16/2014 06:00:00 PM,48,-122,247,130,377
14923,FremontBridge,06/16/2014 07:00:00 PM,48,-122,148,95,243
14924,FremontBridge,06/16/2014 08:00:00 PM,48,-122,68,60,128
14925,FremontBridge,06/16/2014 09:00:00 PM,48,-122,49,36,85
14926,FremontBridge,06/16/2014 10:00:00 PM,48,-122,22,34,56
14927,FremontBridge,06/16/2014 11:00:00 PM,48,-122,20,6,26
14928,FremontBridge,06/17/2014 12:00:00 AM,48,-122,14,2,16
14929,FremontBridge,06/17/2014 01:00:00 AM,48,-122,1,5,6
14930,FremontBridge,06/17/2014 02:00:00 AM,48,-122,1,0,1
14931,FremontBridge,06/17/2014 03:00:00 AM,48,-122,1,4,5
14932,FremontBridge,06/17/2014 04:00:00 AM,48,-122,4,2,6
14933,FremontBridge,06/17/2014 05:00:00 AM,48,-122,12,30,42
14934,FremontBridge,06/17/2014 06:00:00 AM,48,-122,56,114,170
14935,FremontBridge,06/17/2014 07:00:00 AM,48,-122,102,336,438
14936,FremontBridge,06/17/2014 08:00:00 AM,48,-122,161,390,551
14937,FremontBridge,06/17/2014 09:00:00 AM,48,-122,119,166,285
14938,FremontBridge,06/17/2014 10:00:00 AM,48,-122,57,67,124
14939,FremontBridge,06/17/2014 11:00:00 AM,48,-122,47,53,100
14940,FremontBridge,06/17/2014 12:00:00 PM,48,-122,28,42,70
14941,FremontBridge,06/17/2014 01:00:00 PM,48,-122,51,46,97
14942,FremontBridge,06/17/2014 02:00:00 PM,48,-122,53,53,106
14943,FremontBridge,06/17/2014 03:00:00 PM,48,-122,69,71,140
14944,FremontBridge,06/17/2014 04:00:00 PM,48,-122,185,101,286
14945,FremontBridge,06/17/2014 05:00:00 PM,48,-122,448,191,639
14946,FremontBridge,06/17/2014 06:00:00 PM,48,-122,294,154,448
14947,FremontBridge,06/17/2014 07:00:00 PM,48,-122,154,118,272
14948,FremontBridge,06/17/2014 08:00:00 PM,48,-122,90,63,153
14949,FremontBridge,06/17/2014 09:00:00 PM,48,-122,42,30,72
14950,FremontBridge,06/17/2014 10:00:00 PM,48,-122,26,22,48
14951,FremontBridge,06/17/2014 11:00:00 PM,48,-122,17,15,32
14952,FremontBridge,06/18/2014 12:00:00 AM,48,-122,5,10,15
14953,FremontBridge,06/18/2014 01:00:00 AM,48,-122,4,1,5
14954,FremontBridge,06/18/2014 02:00:00 AM,48,-122,0,5,5
14955,FremontBridge,06/18/2014 03:00:00 AM,48,-122,2,3,5
14956,FremontBridge,06/18/2014 04:00:00 AM,48,-122,5,3,8
14957,FremontBridge,06/18/2014 05:00:00 AM,48,-122,17,41,58
14958,FremontBridge,06/18/2014 06:00:00 AM,48,-122,57,141,198
14959,FremontBridge,06/18/2014 07:00:00 AM,48,-122,120,322,442
14960,FremontBridge,06/18/2014 08:00:00 AM,48,-122,185,434,619
14961,FremontBridge,06/18/2014 09:00:00 AM,48,-122,111,173,284
14962,FremontBridge,06/18/2014 10:00:00 AM,48,-122,48,67,115
14963,FremontBridge,06/18/2014 11:00:00 AM,48,-122,39,65,104
14964,FremontBridge,06/18/2014 12:00:00 PM,48,-122,53,55,108
14965,FremontBridge,06/18/2014 01:00:00 PM,48,-122,46,55,101
14966,FremontBridge,06/18/2014 02:00:00 PM,48,-122,49,61,110
14967,FremontBridge,06/18/2014 03:00:00 PM,48,-122,92,79,171
14968,FremontBridge,06/18/2014 04:00:00 PM,48,-122,237,152,389
14969,FremontBridge,06/18/2014 05:00:00 PM,48,-122,500,217,717
14970,FremontBridge,06/18/2014 06:00:00 PM,48,-122,349,186,535
14971,FremontBridge,06/18/2014 07:00:00 PM,48,-122,174,117,291
14972,FremontBridge,06/18/2014 08:00:00 PM,48,-122,77,78,155
14973,FremontBridge,06/18/2014 09:00:00 PM,48,-122,53,68,121
14974,FremontBridge,06/18/2014 10:00:00 PM,48,-122,32,29,61
14975,FremontBridge,06/18/2014 11:00:00 PM,48,-122,15,18,33
14976,FremontBridge,06/19/2014 12:00:00 AM,48,-122,5,5,10
14977,FremontBridge,06/19/2014 01:00:00 AM,48,-122,10,2,12
14978,FremontBridge,06/19/2014 02:00:00 AM,48,-122,1,5,6
14979,FremontBridge,06/19/2014 03:00:00 AM,48,-122,1,4,5
14980,FremontBridge,06/19/2014 04:00:00 AM,48,-122,3,8,11
14981,FremontBridge,06/19/2014 05:00:00 AM,48,-122,17,25,42
14982,FremontBridge,06/19/2014 06:00:00 AM,48,-122,56,136,192
14983,FremontBridge,06/19/2014 07:00:00 AM,48,-122,111,341,452
14984,FremontBridge,06/19/2014 08:00:00 AM,48,-122,160,374,534
14985,FremontBridge,06/19/2014 09:00:00 AM,48,-122,110,172,282
14986,FremontBridge,06/19/2014 10:00:00 AM,48,-122,47,80,127
14987,FremontBridge,06/19/2014 11:00:00 AM,48,-122,46,73,119
14988,FremontBridge,06/19/2014 12:00:00 PM,48,-122,53,52,105
14989,FremontBridge,06/19/2014 01:00:00 PM,48,-122,69,60,129
14990,FremontBridge,06/19/2014 02:00:00 PM,48,-122,64,70,134
14991,FremontBridge,06/19/2014 03:00:00 PM,48,-122,98,98,196
14992,FremontBridge,06/19/2014 04:00:00 PM,48,-122,199,149,348
14993,FremontBridge,06/19/2014 05:00:00 PM,48,-122,487,204,691
14994,FremontBridge,06/19/2014 06:00:00 PM,48,-122,312,170,482
14995,FremontBridge,06/19/2014 07:00:00 PM,48,-122,151,96,247
14996,FremontBridge,06/19/2014 08:00:00 PM,48,-122,81,61,142
14997,FremontBridge,06/19/2014 09:00:00 PM,48,-122,43,26,69
14998,FremontBridge,06/19/2014 10:00:00 PM,48,-122,28,27,55
14999,FremontBridge,06/19/2014 11:00:00 PM,48,-122,12,10,22
15000,FremontBridge,06/20/2014 12:00:00 AM,48,-122,10,3,13
15001,FremontBridge,06/20/2014 01:00:00 AM,48,-122,4,3,7
15002,FremontBridge,06/20/2014 02:00:00 AM,48,-122,0,3,3
15003,FremontBridge,06/20/2014 03:00:00 AM,48,-122,1,0,1
15004,FremontBridge,06/20/2014 04:00:00 AM,48,-122,3,5,8
15005,FremontBridge,06/20/2014 05:00:00 AM,48,-122,5,22,27
15006,FremontBridge,06/20/2014 06:00:00 AM,48,-122,43,108,151
15007,FremontBridge,06/20/2014 07:00:00 AM,48,-122,112,247,359
15008,FremontBridge,06/20/2014 08:00:00 AM,48,-122,133,297,430
15009,FremontBridge,06/20/2014 09:00:00 AM,48,-122,103,149,252
15010,FremontBridge,06/20/2014 10:00:00 AM,48,-122,40,68,108
15011,FremontBridge,06/20/2014 11:00:00 AM,48,-122,40,56,96
15012,FremontBridge,06/20/2014 12:00:00 PM,48,-122,35,68,103
15013,FremontBridge,06/20/2014 01:00:00 PM,48,-122,72,62,134
15014,FremontBridge,06/20/2014 02:00:00 PM,48,-122,60,69,129
15015,FremontBridge,06/20/2014 03:00:00 PM,48,-122,93,81,174
15016,FremontBridge,06/20/2014 04:00:00 PM,48,-122,204,118,322
15017,FremontBridge,06/20/2014 05:00:00 PM,48,-122,382,178,560
15018,FremontBridge,06/20/2014 06:00:00 PM,48,-122,243,99,342
15019,FremontBridge,06/20/2014 07:00:00 PM,48,-122,138,85,223
15020,FremontBridge,06/20/2014 08:00:00 PM,48,-122,77,61,138
15021,FremontBridge,06/20/2014 09:00:00 PM,48,-122,36,41,77
15022,FremontBridge,06/20/2014 10:00:00 PM,48,-122,28,38,66
15023,FremontBridge,06/20/2014 11:00:00 PM,48,-122,26,41,67
15024,FremontBridge,06/21/2014 12:00:00 AM,48,-122,17,10,27
15025,FremontBridge,06/21/2014 01:00:00 AM,48,-122,17,6,23
15026,FremontBridge,06/21/2014 02:00:00 AM,48,-122,5,10,15
15027,FremontBridge,06/21/2014 03:00:00 AM,48,-122,2,1,3
15028,FremontBridge,06/21/2014 04:00:00 AM,48,-122,7,4,11
15029,FremontBridge,06/21/2014 05:00:00 AM,48,-122,4,16,20
15030,FremontBridge,06/21/2014 06:00:00 AM,48,-122,19,34,53
15031,FremontBridge,06/21/2014 07:00:00 AM,48,-122,29,41,70
15032,FremontBridge,06/21/2014 08:00:00 AM,48,-122,51,94,145
15033,FremontBridge,06/21/2014 09:00:00 AM,48,-122,82,96,178
15034,FremontBridge,06/21/2014 10:00:00 AM,48,-122,99,126,225
15035,FremontBridge,06/21/2014 11:00:00 AM,48,-122,142,125,267
15036,FremontBridge,06/21/2014 12:00:00 PM,48,-122,187,103,290
15037,FremontBridge,06/21/2014 01:00:00 PM,48,-122,174,85,259
15038,FremontBridge,06/21/2014 02:00:00 PM,48,-122,139,84,223
15039,FremontBridge,06/21/2014 03:00:00 PM,48,-122,46,35,81
15040,FremontBridge,06/21/2014 04:00:00 PM,48,-122,62,30,92
15041,FremontBridge,06/21/2014 05:00:00 PM,48,-122,109,78,187
15042,FremontBridge,06/21/2014 06:00:00 PM,48,-122,125,152,277
15043,FremontBridge,06/21/2014 07:00:00 PM,48,-122,117,120,237
15044,FremontBridge,06/21/2014 08:00:00 PM,48,-122,102,75,177
15045,FremontBridge,06/21/2014 09:00:00 PM,48,-122,67,84,151
15046,FremontBridge,06/21/2014 10:00:00 PM,48,-122,52,53,105
15047,FremontBridge,06/21/2014 11:00:00 PM,48,-122,40,48,88
15048,FremontBridge,06/22/2014 12:00:00 AM,48,-122,6,24,30
15049,FremontBridge,06/22/2014 01:00:00 AM,48,-122,6,19,25
15050,FremontBridge,06/22/2014 02:00:00 AM,48,-122,1,8,9
15051,FremontBridge,06/22/2014 03:00:00 AM,48,-122,3,4,7
15052,FremontBridge,06/22/2014 04:00:00 AM,48,-122,3,1,4
15053,FremontBridge,06/22/2014 05:00:00 AM,48,-122,5,12,17
15054,FremontBridge,06/22/2014 06:00:00 AM,48,-122,13,11,24
15055,FremontBridge,06/22/2014 07:00:00 AM,48,-122,26,50,76
15056,FremontBridge,06/22/2014 08:00:00 AM,48,-122,42,45,87
15057,FremontBridge,06/22/2014 09:00:00 AM,48,-122,64,93,157
15058,FremontBridge,06/22/2014 10:00:00 AM,48,-122,57,59,116
15059,FremontBridge,06/22/2014 11:00:00 AM,48,-122,91,115,206
15060,FremontBridge,06/22/2014 12:00:00 PM,48,-122,138,133,271
15061,FremontBridge,06/22/2014 01:00:00 PM,48,-122,171,130,301
15062,FremontBridge,06/22/2014 02:00:00 PM,48,-122,144,127,271
15063,FremontBridge,06/22/2014 03:00:00 PM,48,-122,99,113,212
15064,FremontBridge,06/22/2014 04:00:00 PM,48,-122,77,117,194
15065,FremontBridge,06/22/2014 05:00:00 PM,48,-122,83,105,188
15066,FremontBridge,06/22/2014 06:00:00 PM,48,-122,82,97,179
15067,FremontBridge,06/22/2014 07:00:00 PM,48,-122,89,52,141
15068,FremontBridge,06/22/2014 08:00:00 PM,48,-122,51,34,85
15069,FremontBridge,06/22/2014 09:00:00 PM,48,-122,28,47,75
15070,FremontBridge,06/22/2014 10:00:00 PM,48,-122,14,10,24
15071,FremontBridge,06/22/2014 11:00:00 PM,48,-122,10,5,15
15072,FremontBridge,06/23/2014 12:00:00 AM,48,-122,6,4,10
15073,FremontBridge,06/23/2014 01:00:00 AM,48,-122,4,3,7
15074,FremontBridge,06/23/2014 02:00:00 AM,48,-122,2,4,6
15075,FremontBridge,06/23/2014 03:00:00 AM,48,-122,3,3,6
15076,FremontBridge,06/23/2014 04:00:00 AM,48,-122,3,7,10
15077,FremontBridge,06/23/2014 05:00:00 AM,48,-122,17,30,47
15078,FremontBridge,06/23/2014 06:00:00 AM,48,-122,54,120,174
15079,FremontBridge,06/23/2014 07:00:00 AM,48,-122,112,321,433
15080,FremontBridge,06/23/2014 08:00:00 AM,48,-122,188,404,592
15081,FremontBridge,06/23/2014 09:00:00 AM,48,-122,160,184,344
15082,FremontBridge,06/23/2014 10:00:00 AM,48,-122,68,76,144
15083,FremontBridge,06/23/2014 11:00:00 AM,48,-122,63,62,125
15084,FremontBridge,06/23/2014 12:00:00 PM,48,-122,52,71,123
15085,FremontBridge,06/23/2014 01:00:00 PM,48,-122,50,67,117
15086,FremontBridge,06/23/2014 02:00:00 PM,48,-122,61,67,128
15087,FremontBridge,06/23/2014 03:00:00 PM,48,-122,86,89,175
15088,FremontBridge,06/23/2014 04:00:00 PM,48,-122,218,138,356
15089,FremontBridge,06/23/2014 05:00:00 PM,48,-122,510,206,716
15090,FremontBridge,06/23/2014 06:00:00 PM,48,-122,341,149,490
15091,FremontBridge,06/23/2014 07:00:00 PM,48,-122,119,109,228
15092,FremontBridge,06/23/2014 08:00:00 PM,48,-122,63,45,108
15093,FremontBridge,06/23/2014 09:00:00 PM,48,-122,46,25,71
15094,FremontBridge,06/23/2014 10:00:00 PM,48,-122,26,17,43
15095,FremontBridge,06/23/2014 11:00:00 PM,48,-122,14,10,24
15096,FremontBridge,06/24/2014 12:00:00 AM,48,-122,14,4,18
15097,FremontBridge,06/24/2014 01:00:00 AM,48,-122,4,1,5
15098,FremontBridge,06/24/2014 02:00:00 AM,48,-122,0,3,3
15099,FremontBridge,06/24/2014 03:00:00 AM,48,-122,3,1,4
15100,FremontBridge,06/24/2014 04:00:00 AM,48,-122,3,7,10
15101,FremontBridge,06/24/2014 05:00:00 AM,48,-122,21,27,48
15102,FremontBridge,06/24/2014 06:00:00 AM,48,-122,49,110,159
15103,FremontBridge,06/24/2014 07:00:00 AM,48,-122,101,306,407
15104,FremontBridge,06/24/2014 08:00:00 AM,48,-122,163,362,525
15105,FremontBridge,06/24/2014 09:00:00 AM,48,-122,124,156,280
15106,FremontBridge,06/24/2014 10:00:00 AM,48,-122,43,64,107
15107,FremontBridge,06/24/2014 11:00:00 AM,48,-122,38,58,96
15108,FremontBridge,06/24/2014 12:00:00 PM,48,-122,46,48,94
15109,FremontBridge,06/24/2014 01:00:00 PM,48,-122,60,54,114
15110,FremontBridge,06/24/2014 02:00:00 PM,48,-122,52,64,116
15111,FremontBridge,06/24/2014 03:00:00 PM,48,-122,84,85,169
15112,FremontBridge,06/24/2014 04:00:00 PM,48,-122,205,137,342
15113,FremontBridge,06/24/2014 05:00:00 PM,48,-122,441,201,642
15114,FremontBridge,06/24/2014 06:00:00 PM,48,-122,313,210,523
15115,FremontBridge,06/24/2014 07:00:00 PM,48,-122,171,123,294
15116,FremontBridge,06/24/2014 08:00:00 PM,48,-122,93,88,181
15117,FremontBridge,06/24/2014 09:00:00 PM,48,-122,41,49,90
15118,FremontBridge,06/24/2014 10:00:00 PM,48,-122,42,34,76
15119,FremontBridge,06/24/2014 11:00:00 PM,48,-122,25,14,39
15120,FremontBridge,06/25/2014 12:00:00 AM,48,-122,10,9,19
15121,FremontBridge,06/25/2014 01:00:00 AM,48,-122,7,4,11
15122,FremontBridge,06/25/2014 02:00:00 AM,48,-122,4,3,7
15123,FremontBridge,06/25/2014 03:00:00 AM,48,-122,6,3,9
15124,FremontBridge,06/25/2014 04:00:00 AM,48,-122,7,1,8
15125,FremontBridge,06/25/2014 05:00:00 AM,48,-122,17,28,45
15126,FremontBridge,06/25/2014 06:00:00 AM,48,-122,59,119,178
15127,FremontBridge,06/25/2014 07:00:00 AM,48,-122,125,332,457
15128,FremontBridge,06/25/2014 08:00:00 AM,48,-122,174,378,552
15129,FremontBridge,06/25/2014 09:00:00 AM,48,-122,123,159,282
15130,FremontBridge,06/25/2014 10:00:00 AM,48,-122,54,87,141
15131,FremontBridge,06/25/2014 11:00:00 AM,48,-122,36,48,84
15132,FremontBridge,06/25/2014 12:00:00 PM,48,-122,67,59,126
15133,FremontBridge,06/25/2014 01:00:00 PM,48,-122,54,57,111
15134,FremontBridge,06/25/2014 02:00:00 PM,48,-122,68,57,125
15135,FremontBridge,06/25/2014 03:00:00 PM,48,-122,97,70,167
15136,FremontBridge,06/25/2014 04:00:00 PM,48,-122,225,127,352
15137,FremontBridge,06/25/2014 05:00:00 PM,48,-122,507,200,707
15138,FremontBridge,06/25/2014 06:00:00 PM,48,-122,349,180,529
15139,FremontBridge,06/25/2014 07:00:00 PM,48,-122,163,101,264
15140,FremontBridge,06/25/2014 08:00:00 PM,48,-122,82,70,152
15141,FremontBridge,06/25/2014 09:00:00 PM,48,-122,52,48,100
15142,FremontBridge,06/25/2014 10:00:00 PM,48,-122,39,28,67
15143,FremontBridge,06/25/2014 11:00:00 PM,48,-122,19,20,39
15144,FremontBridge,06/26/2014 12:00:00 AM,48,-122,13,13,26
15145,FremontBridge,06/26/2014 01:00:00 AM,48,-122,6,2,8
15146,FremontBridge,06/26/2014 02:00:00 AM,48,-122,7,3,10
15147,FremontBridge,06/26/2014 03:00:00 AM,48,-122,2,3,5
15148,FremontBridge,06/26/2014 04:00:00 AM,48,-122,2,6,8
15149,FremontBridge,06/26/2014 05:00:00 AM,48,-122,16,35,51
15150,FremontBridge,06/26/2014 06:00:00 AM,48,-122,46,116,162
15151,FremontBridge,06/26/2014 07:00:00 AM,48,-122,90,264,354
15152,FremontBridge,06/26/2014 08:00:00 AM,48,-122,175,340,515
15153,FremontBridge,06/26/2014 09:00:00 AM,48,-122,82,135,217
15154,FremontBridge,06/26/2014 10:00:00 AM,48,-122,47,63,110
15155,FremontBridge,06/26/2014 11:00:00 AM,48,-122,62,74,136
15156,FremontBridge,06/26/2014 12:00:00 PM,48,-122,58,68,126
15157,FremontBridge,06/26/2014 01:00:00 PM,48,-122,47,62,109
15158,FremontBridge,06/26/2014 02:00:00 PM,48,-122,66,50,116
15159,FremontBridge,06/26/2014 03:00:00 PM,48,-122,81,76,157
15160,FremontBridge,06/26/2014 04:00:00 PM,48,-122,159,126,285
15161,FremontBridge,06/26/2014 05:00:00 PM,48,-122,373,151,524
15162,FremontBridge,06/26/2014 06:00:00 PM,48,-122,293,144,437
15163,FremontBridge,06/26/2014 07:00:00 PM,48,-122,122,99,221
15164,FremontBridge,06/26/2014 08:00:00 PM,48,-122,77,38,115
15165,FremontBridge,06/26/2014 09:00:00 PM,48,-122,49,49,98
15166,FremontBridge,06/26/2014 10:00:00 PM,48,-122,20,22,42
15167,FremontBridge,06/26/2014 11:00:00 PM,48,-122,16,9,25
15168,FremontBridge,06/27/2014 12:00:00 AM,48,-122,13,7,20
15169,FremontBridge,06/27/2014 01:00:00 AM,48,-122,10,4,14
15170,FremontBridge,06/27/2014 02:00:00 AM,48,-122,3,2,5
15171,FremontBridge,06/27/2014 03:00:00 AM,48,-122,5,0,5
15172,FremontBridge,06/27/2014 04:00:00 AM,48,-122,5,3,8
15173,FremontBridge,06/27/2014 05:00:00 AM,48,-122,8,23,31
15174,FremontBridge,06/27/2014 06:00:00 AM,48,-122,40,79,119
15175,FremontBridge,06/27/2014 07:00:00 AM,48,-122,65,180,245
15176,FremontBridge,06/27/2014 08:00:00 AM,48,-122,109,255,364
15177,FremontBridge,06/27/2014 09:00:00 AM,48,-122,79,118,197
15178,FremontBridge,06/27/2014 10:00:00 AM,48,-122,39,56,95
15179,FremontBridge,06/27/2014 11:00:00 AM,48,-122,25,46,71
15180,FremontBridge,06/27/2014 12:00:00 PM,48,-122,28,31,59
15181,FremontBridge,06/27/2014 01:00:00 PM,48,-122,27,38,65
15182,FremontBridge,06/27/2014 02:00:00 PM,48,-122,46,50,96
15183,FremontBridge,06/27/2014 03:00:00 PM,48,-122,68,58,126
15184,FremontBridge,06/27/2014 04:00:00 PM,48,-122,163,109,272
15185,FremontBridge,06/27/2014 05:00:00 PM,48,-122,274,151,425
15186,FremontBridge,06/27/2014 06:00:00 PM,48,-122,190,90,280
15187,FremontBridge,06/27/2014 07:00:00 PM,48,-122,101,60,161
15188,FremontBridge,06/27/2014 08:00:00 PM,48,-122,42,30,72
15189,FremontBridge,06/27/2014 09:00:00 PM,48,-122,30,30,60
15190,FremontBridge,06/27/2014 10:00:00 PM,48,-122,27,21,48
15191,FremontBridge,06/27/2014 11:00:00 PM,48,-122,18,15,33
15192,FremontBridge,06/28/2014 12:00:00 AM,48,-122,6,4,10
15193,FremontBridge,06/28/2014 01:00:00 AM,48,-122,6,10,16
15194,FremontBridge,06/28/2014 02:00:00 AM,48,-122,6,3,9
15195,FremontBridge,06/28/2014 03:00:00 AM,48,-122,0,2,2
15196,FremontBridge,06/28/2014 04:00:00 AM,48,-122,1,3,4
15197,FremontBridge,06/28/2014 05:00:00 AM,48,-122,4,5,9
15198,FremontBridge,06/28/2014 06:00:00 AM,48,-122,22,18,40
15199,FremontBridge,06/28/2014 07:00:00 AM,48,-122,27,35,62
15200,FremontBridge,06/28/2014 08:00:00 AM,48,-122,33,44,77
15201,FremontBridge,06/28/2014 09:00:00 AM,48,-122,49,59,108
15202,FremontBridge,06/28/2014 10:00:00 AM,48,-122,77,61,138
15203,FremontBridge,06/28/2014 11:00:00 AM,48,-122,56,50,106
15204,FremontBridge,06/28/2014 12:00:00 PM,48,-122,66,88,154
15205,FremontBridge,06/28/2014 01:00:00 PM,48,-122,61,70,131
15206,FremontBridge,06/28/2014 02:00:00 PM,48,-122,60,56,116
15207,FremontBridge,06/28/2014 03:00:00 PM,48,-122,53,73,126
15208,FremontBridge,06/28/2014 04:00:00 PM,48,-122,53,70,123
15209,FremontBridge,06/28/2014 05:00:00 PM,48,-122,79,70,149
15210,FremontBridge,06/28/2014 06:00:00 PM,48,-122,61,62,123
15211,FremontBridge,06/28/2014 07:00:00 PM,48,-122,38,52,90
15212,FremontBridge,06/28/2014 08:00:00 PM,48,-122,39,34,73
15213,FremontBridge,06/28/2014 09:00:00 PM,48,-122,34,22,56
15214,FremontBridge,06/28/2014 10:00:00 PM,48,-122,11,15,26
15215,FremontBridge,06/28/2014 11:00:00 PM,48,-122,15,17,32
15216,FremontBridge,06/29/2014 12:00:00 AM,48,-122,12,12,24
15217,FremontBridge,06/29/2014 01:00:00 AM,48,-122,2,4,6
15218,FremontBridge,06/29/2014 02:00:00 AM,48,-122,3,12,15
15219,FremontBridge,06/29/2014 03:00:00 AM,48,-122,0,3,3
15220,FremontBridge,06/29/2014 04:00:00 AM,48,-122,2,4,6
15221,FremontBridge,06/29/2014 05:00:00 AM,48,-122,4,6,10
15222,FremontBridge,06/29/2014 06:00:00 AM,48,-122,13,10,23
15223,FremontBridge,06/29/2014 07:00:00 AM,48,-122,24,32,56
15224,FremontBridge,06/29/2014 08:00:00 AM,48,-122,40,49,89
15225,FremontBridge,06/29/2014 09:00:00 AM,48,-122,40,54,94
15226,FremontBridge,06/29/2014 10:00:00 AM,48,-122,62,95,157
15227,FremontBridge,06/29/2014 11:00:00 AM,48,-122,78,120,198
15228,FremontBridge,06/29/2014 12:00:00 PM,48,-122,74,118,192
15229,FremontBridge,06/29/2014 01:00:00 PM,48,-122,86,111,197
15230,FremontBridge,06/29/2014 02:00:00 PM,48,-122,83,108,191
15231,FremontBridge,06/29/2014 03:00:00 PM,48,-122,124,103,227
15232,FremontBridge,06/29/2014 04:00:00 PM,48,-122,93,104,197
15233,FremontBridge,06/29/2014 05:00:00 PM,48,-122,93,110,203
15234,FremontBridge,06/29/2014 06:00:00 PM,48,-122,85,80,165
15235,FremontBridge,06/29/2014 07:00:00 PM,48,-122,56,44,100
15236,FremontBridge,06/29/2014 08:00:00 PM,48,-122,29,43,72
15237,FremontBridge,06/29/2014 09:00:00 PM,48,-122,28,16,44
15238,FremontBridge,06/29/2014 10:00:00 PM,48,-122,9,17,26
15239,FremontBridge,06/29/2014 11:00:00 PM,48,-122,10,7,17
15240,FremontBridge,06/30/2014 12:00:00 AM,48,-122,6,6,12
15241,FremontBridge,06/30/2014 01:00:00 AM,48,-122,2,2,4
15242,FremontBridge,06/30/2014 02:00:00 AM,48,-122,4,0,4
15243,FremontBridge,06/30/2014 03:00:00 AM,48,-122,4,2,6
15244,FremontBridge,06/30/2014 04:00:00 AM,48,-122,8,7,15
15245,FremontBridge,06/30/2014 05:00:00 AM,48,-122,17,39,56
15246,FremontBridge,06/30/2014 06:00:00 AM,48,-122,58,125,183
15247,FremontBridge,06/30/2014 07:00:00 AM,48,-122,108,309,417
15248,FremontBridge,06/30/2014 08:00:00 AM,48,-122,188,421,609
15249,FremontBridge,06/30/2014 09:00:00 AM,48,-122,124,171,295
15250,FremontBridge,06/30/2014 10:00:00 AM,48,-122,50,75,125
15251,FremontBridge,06/30/2014 11:00:00 AM,48,-122,43,69,112
15252,FremontBridge,06/30/2014 12:00:00 PM,48,-122,46,67,113
15253,FremontBridge,06/30/2014 01:00:00 PM,48,-122,66,65,131
15254,FremontBridge,06/30/2014 02:00:00 PM,48,-122,64,73,137
15255,FremontBridge,06/30/2014 03:00:00 PM,48,-122,115,80,195
15256,FremontBridge,06/30/2014 04:00:00 PM,48,-122,233,145,378
15257,FremontBridge,06/30/2014 05:00:00 PM,48,-122,527,217,744
15258,FremontBridge,06/30/2014 06:00:00 PM,48,-122,360,230,590
15259,FremontBridge,06/30/2014 07:00:00 PM,48,-122,191,142,333
15260,FremontBridge,06/30/2014 08:00:00 PM,48,-122,92,73,165
15261,FremontBridge,06/30/2014 09:00:00 PM,48,-122,48,44,92
15262,FremontBridge,06/30/2014 10:00:00 PM,48,-122,30,28,58
15263,FremontBridge,06/30/2014 11:00:00 PM,48,-122,15,13,28
15264,FremontBridge,07/01/2014 12:00:00 AM,48,-122,12,5,17
15265,FremontBridge,07/01/2014 01:00:00 AM,48,-122,3,4,7
15266,FremontBridge,07/01/2014 02:00:00 AM,48,-122,3,1,4
15267,FremontBridge,07/01/2014 03:00:00 AM,48,-122,2,2,4
15268,FremontBridge,07/01/2014 04:00:00 AM,48,-122,3,11,14
15269,FremontBridge,07/01/2014 05:00:00 AM,48,-122,23,38,61
15270,FremontBridge,07/01/2014 06:00:00 AM,48,-122,69,158,227
15271,FremontBridge,07/01/2014 07:00:00 AM,48,-122,131,394,525
15272,FremontBridge,07/01/2014 08:00:00 AM,48,-122,187,421,608
15273,FremontBridge,07/01/2014 09:00:00 AM,48,-122,115,188,303
15274,FremontBridge,07/01/2014 10:00:00 AM,48,-122,64,84,148
15275,FremontBridge,07/01/2014 11:00:00 AM,48,-122,61,58,119
15276,FremontBridge,07/01/2014 12:00:00 PM,48,-122,75,72,147
15277,FremontBridge,07/01/2014 01:00:00 PM,48,-122,64,81,145
15278,FremontBridge,07/01/2014 02:00:00 PM,48,-122,66,46,112
15279,FremontBridge,07/01/2014 03:00:00 PM,48,-122,91,91,182
15280,FremontBridge,07/01/2014 04:00:00 PM,48,-122,242,160,402
15281,FremontBridge,07/01/2014 05:00:00 PM,48,-122,489,247,736
15282,FremontBridge,07/01/2014 06:00:00 PM,48,-122,393,200,593
15283,FremontBridge,07/01/2014 07:00:00 PM,48,-122,191,150,341
15284,FremontBridge,07/01/2014 08:00:00 PM,48,-122,92,87,179
15285,FremontBridge,07/01/2014 09:00:00 PM,48,-122,58,87,145
15286,FremontBridge,07/01/2014 10:00:00 PM,48,-122,45,41,86
15287,FremontBridge,07/01/2014 11:00:00 PM,48,-122,22,20,42
15288,FremontBridge,07/02/2014 12:00:00 AM,48,-122,14,10,24
15289,FremontBridge,07/02/2014 01:00:00 AM,48,-122,11,6,17
15290,FremontBridge,07/02/2014 02:00:00 AM,48,-122,3,2,5
15291,FremontBridge,07/02/2014 03:00:00 AM,48,-122,2,2,4
15292,FremontBridge,07/02/2014 04:00:00 AM,48,-122,1,5,6
15293,FremontBridge,07/02/2014 05:00:00 AM,48,-122,25,37,62
15294,FremontBridge,07/02/2014 06:00:00 AM,48,-122,51,140,191
15295,FremontBridge,07/02/2014 07:00:00 AM,48,-122,122,302,424
15296,FremontBridge,07/02/2014 08:00:00 AM,48,-122,196,422,618
15297,FremontBridge,07/02/2014 09:00:00 AM,48,-122,138,178,316
15298,FremontBridge,07/02/2014 10:00:00 AM,48,-122,58,90,148
15299,FremontBridge,07/02/2014 11:00:00 AM,48,-122,37,42,79
15300,FremontBridge,07/02/2014 12:00:00 PM,48,-122,47,63,110
15301,FremontBridge,07/02/2014 01:00:00 PM,48,-122,61,62,123
15302,FremontBridge,07/02/2014 02:00:00 PM,48,-122,78,56,134
15303,FremontBridge,07/02/2014 03:00:00 PM,48,-122,82,84,166
15304,FremontBridge,07/02/2014 04:00:00 PM,48,-122,230,145,375
15305,FremontBridge,07/02/2014 05:00:00 PM,48,-122,495,196,691
15306,FremontBridge,07/02/2014 06:00:00 PM,48,-122,373,187,560
15307,FremontBridge,07/02/2014 07:00:00 PM,48,-122,166,103,269
15308,FremontBridge,07/02/2014 08:00:00 PM,48,-122,121,79,200
15309,FremontBridge,07/02/2014 09:00:00 PM,48,-122,61,61,122
15310,FremontBridge,07/02/2014 10:00:00 PM,48,-122,31,22,53
15311,FremontBridge,07/02/2014 11:00:00 PM,48,-122,26,19,45
15312,FremontBridge,07/03/2014 12:00:00 AM,48,-122,16,11,27
15313,FremontBridge,07/03/2014 01:00:00 AM,48,-122,5,3,8
15314,FremontBridge,07/03/2014 02:00:00 AM,48,-122,2,0,2
15315,FremontBridge,07/03/2014 03:00:00 AM,48,-122,3,2,5
15316,FremontBridge,07/03/2014 04:00:00 AM,48,-122,1,3,4
15317,FremontBridge,07/03/2014 05:00:00 AM,48,-122,21,27,48
15318,FremontBridge,07/03/2014 06:00:00 AM,48,-122,42,93,135
15319,FremontBridge,07/03/2014 07:00:00 AM,48,-122,110,247,357
15320,FremontBridge,07/03/2014 08:00:00 AM,48,-122,142,313,455
15321,FremontBridge,07/03/2014 09:00:00 AM,48,-122,91,142,233
15322,FremontBridge,07/03/2014 10:00:00 AM,48,-122,67,71,138
15323,FremontBridge,07/03/2014 11:00:00 AM,48,-122,46,40,86
15324,FremontBridge,07/03/2014 12:00:00 PM,48,-122,61,66,127
15325,FremontBridge,07/03/2014 01:00:00 PM,48,-122,54,78,132
15326,FremontBridge,07/03/2014 02:00:00 PM,48,-122,97,51,148
15327,FremontBridge,07/03/2014 03:00:00 PM,48,-122,104,110,214
15328,FremontBridge,07/03/2014 04:00:00 PM,48,-122,255,127,382
15329,FremontBridge,07/03/2014 05:00:00 PM,48,-122,333,158,491
15330,FremontBridge,07/03/2014 06:00:00 PM,48,-122,191,130,321
15331,FremontBridge,07/03/2014 07:00:00 PM,48,-122,81,72,153
15332,FremontBridge,07/03/2014 08:00:00 PM,48,-122,78,62,140
15333,FremontBridge,07/03/2014 09:00:00 PM,48,-122,38,24,62
15334,FremontBridge,07/03/2014 10:00:00 PM,48,-122,29,23,52
15335,FremontBridge,07/03/2014 11:00:00 PM,48,-122,28,11,39
15336,FremontBridge,07/04/2014 12:00:00 AM,48,-122,15,5,20
15337,FremontBridge,07/04/2014 01:00:00 AM,48,-122,8,7,15
15338,FremontBridge,07/04/2014 02:00:00 AM,48,-122,2,4,6
15339,FremontBridge,07/04/2014 03:00:00 AM,48,-122,5,1,6
15340,FremontBridge,07/04/2014 04:00:00 AM,48,-122,4,5,9
15341,FremontBridge,07/04/2014 05:00:00 AM,48,-122,7,13,20
15342,FremontBridge,07/04/2014 06:00:00 AM,48,-122,12,15,27
15343,FremontBridge,07/04/2014 07:00:00 AM,48,-122,23,38,61
15344,FremontBridge,07/04/2014 08:00:00 AM,48,-122,60,66,126
15345,FremontBridge,07/04/2014 09:00:00 AM,48,-122,76,79,155
15346,FremontBridge,07/04/2014 10:00:00 AM,48,-122,94,83,177
15347,FremontBridge,07/04/2014 11:00:00 AM,48,-122,97,111,208
15348,FremontBridge,07/04/2014 12:00:00 PM,48,-122,125,115,240
15349,FremontBridge,07/04/2014 01:00:00 PM,48,-122,138,106,244
15350,FremontBridge,07/04/2014 02:00:00 PM,48,-122,104,110,214
15351,FremontBridge,07/04/2014 03:00:00 PM,48,-122,152,130,282
15352,FremontBridge,07/04/2014 04:00:00 PM,48,-122,143,147,290
15353,FremontBridge,07/04/2014 05:00:00 PM,48,-122,129,107,236
15354,FremontBridge,07/04/2014 06:00:00 PM,48,-122,95,96,191
15355,FremontBridge,07/04/2014 07:00:00 PM,48,-122,77,72,149
15356,FremontBridge,07/04/2014 08:00:00 PM,48,-122,72,59,131
15357,FremontBridge,07/04/2014 09:00:00 PM,48,-122,70,57,127
15358,FremontBridge,07/04/2014 10:00:00 PM,48,-122,32,43,75
15359,FremontBridge,07/04/2014 11:00:00 PM,48,-122,199,76,275
15360,FremontBridge,07/05/2014 12:00:00 AM,48,-122,49,24,73
15361,FremontBridge,07/05/2014 01:00:00 AM,48,-122,20,14,34
15362,FremontBridge,07/05/2014 02:00:00 AM,48,-122,3,9,12
15363,FremontBridge,07/05/2014 03:00:00 AM,48,-122,2,0,2
15364,FremontBridge,07/05/2014 04:00:00 AM,48,-122,3,4,7
15365,FremontBridge,07/05/2014 05:00:00 AM,48,-122,3,6,9
15366,FremontBridge,07/05/2014 06:00:00 AM,48,-122,7,12,19
15367,FremontBridge,07/05/2014 07:00:00 AM,48,-122,21,38,59
15368,FremontBridge,07/05/2014 08:00:00 AM,48,-122,34,42,76
15369,FremontBridge,07/05/2014 09:00:00 AM,48,-122,49,49,98
15370,FremontBridge,07/05/2014 10:00:00 AM,48,-122,65,77,142
15371,FremontBridge,07/05/2014 11:00:00 AM,48,-122,61,94,155
15372,FremontBridge,07/05/2014 12:00:00 PM,48,-122,87,82,169
15373,FremontBridge,07/05/2014 01:00:00 PM,48,-122,82,85,167
15374,FremontBridge,07/05/2014 02:00:00 PM,48,-122,59,67,126
15375,FremontBridge,07/05/2014 03:00:00 PM,48,-122,51,69,120
15376,FremontBridge,07/05/2014 04:00:00 PM,48,-122,67,82,149
15377,FremontBridge,07/05/2014 05:00:00 PM,48,-122,72,79,151
15378,FremontBridge,07/05/2014 06:00:00 PM,48,-122,79,59,138
15379,FremontBridge,07/05/2014 07:00:00 PM,48,-122,55,40,95
15380,FremontBridge,07/05/2014 08:00:00 PM,48,-122,41,31,72
15381,FremontBridge,07/05/2014 09:00:00 PM,48,-122,32,12,44
15382,FremontBridge,07/05/2014 10:00:00 PM,48,-122,12,22,34
15383,FremontBridge,07/05/2014 11:00:00 PM,48,-122,18,7,25
15384,FremontBridge,07/06/2014 12:00:00 AM,48,-122,9,10,19
15385,FremontBridge,07/06/2014 01:00:00 AM,48,-122,4,7,11
15386,FremontBridge,07/06/2014 02:00:00 AM,48,-122,3,1,4
15387,FremontBridge,07/06/2014 03:00:00 AM,48,-122,2,3,5
15388,FremontBridge,07/06/2014 04:00:00 AM,48,-122,1,1,2
15389,FremontBridge,07/06/2014 05:00:00 AM,48,-122,3,4,7
15390,FremontBridge,07/06/2014 06:00:00 AM,48,-122,10,5,15
15391,FremontBridge,07/06/2014 07:00:00 AM,48,-122,14,19,33
15392,FremontBridge,07/06/2014 08:00:00 AM,48,-122,29,84,113
15393,FremontBridge,07/06/2014 09:00:00 AM,48,-122,54,71,125
15394,FremontBridge,07/06/2014 10:00:00 AM,48,-122,83,68,151
15395,FremontBridge,07/06/2014 11:00:00 AM,48,-122,86,129,215
15396,FremontBridge,07/06/2014 12:00:00 PM,48,-122,116,133,249
15397,FremontBridge,07/06/2014 01:00:00 PM,48,-122,154,148,302
15398,FremontBridge,07/06/2014 02:00:00 PM,48,-122,136,170,306
15399,FremontBridge,07/06/2014 03:00:00 PM,48,-122,118,173,291
15400,FremontBridge,07/06/2014 04:00:00 PM,48,-122,91,142,233
15401,FremontBridge,07/06/2014 05:00:00 PM,48,-122,108,120,228
15402,FremontBridge,07/06/2014 06:00:00 PM,48,-122,87,83,170
15403,FremontBridge,07/06/2014 07:00:00 PM,48,-122,89,64,153
15404,FremontBridge,07/06/2014 08:00:00 PM,48,-122,42,73,115
15405,FremontBridge,07/06/2014 09:00:00 PM,48,-122,33,33,66
15406,FremontBridge,07/06/2014 10:00:00 PM,48,-122,23,25,48
15407,FremontBridge,07/06/2014 11:00:00 PM,48,-122,10,11,21
15408,FremontBridge,07/07/2014 12:00:00 AM,48,-122,9,4,13
15409,FremontBridge,07/07/2014 01:00:00 AM,48,-122,4,2,6
15410,FremontBridge,07/07/2014 02:00:00 AM,48,-122,2,4,6
15411,FremontBridge,07/07/2014 03:00:00 AM,48,-122,3,3,6
15412,FremontBridge,07/07/2014 04:00:00 AM,48,-122,8,8,16
15413,FremontBridge,07/07/2014 05:00:00 AM,48,-122,16,28,44
15414,FremontBridge,07/07/2014 06:00:00 AM,48,-122,57,104,161
15415,FremontBridge,07/07/2014 07:00:00 AM,48,-122,109,355,464
15416,FremontBridge,07/07/2014 08:00:00 AM,48,-122,164,367,531
15417,FremontBridge,07/07/2014 09:00:00 AM,48,-122,109,176,285
15418,FremontBridge,07/07/2014 10:00:00 AM,48,-122,55,73,128
15419,FremontBridge,07/07/2014 11:00:00 AM,48,-122,40,55,95
15420,FremontBridge,07/07/2014 12:00:00 PM,48,-122,51,56,107
15421,FremontBridge,07/07/2014 01:00:00 PM,48,-122,67,67,134
15422,FremontBridge,07/07/2014 02:00:00 PM,48,-122,62,74,136
15423,FremontBridge,07/07/2014 03:00:00 PM,48,-122,108,89,197
15424,FremontBridge,07/07/2014 04:00:00 PM,48,-122,187,128,315
15425,FremontBridge,07/07/2014 05:00:00 PM,48,-122,477,191,668
15426,FremontBridge,07/07/2014 06:00:00 PM,48,-122,317,177,494
15427,FremontBridge,07/07/2014 07:00:00 PM,48,-122,177,122,299
15428,FremontBridge,07/07/2014 08:00:00 PM,48,-122,89,63,152
15429,FremontBridge,07/07/2014 09:00:00 PM,48,-122,36,68,104
15430,FremontBridge,07/07/2014 10:00:00 PM,48,-122,39,25,64
15431,FremontBridge,07/07/2014 11:00:00 PM,48,-122,16,15,31
15432,FremontBridge,07/08/2014 12:00:00 AM,48,-122,16,11,27
15433,FremontBridge,07/08/2014 01:00:00 AM,48,-122,3,4,7
15434,FremontBridge,07/08/2014 02:00:00 AM,48,-122,5,3,8
15435,FremontBridge,07/08/2014 03:00:00 AM,48,-122,1,2,3
15436,FremontBridge,07/08/2014 04:00:00 AM,48,-122,5,8,13
15437,FremontBridge,07/08/2014 05:00:00 AM,48,-122,21,37,58
15438,FremontBridge,07/08/2014 06:00:00 AM,48,-122,73,160,233
15439,FremontBridge,07/08/2014 07:00:00 AM,48,-122,131,375,506
15440,FremontBridge,07/08/2014 08:00:00 AM,48,-122,165,429,594
15441,FremontBridge,07/08/2014 09:00:00 AM,48,-122,124,171,295
15442,FremontBridge,07/08/2014 10:00:00 AM,48,-122,76,105,181
15443,FremontBridge,07/08/2014 11:00:00 AM,48,-122,50,81,131
15444,FremontBridge,07/08/2014 12:00:00 PM,48,-122,70,85,155
15445,FremontBridge,07/08/2014 01:00:00 PM,48,-122,59,70,129
15446,FremontBridge,07/08/2014 02:00:00 PM,48,-122,65,49,114
15447,FremontBridge,07/08/2014 03:00:00 PM,48,-122,124,96,220
15448,FremontBridge,07/08/2014 04:00:00 PM,48,-122,231,160,391
15449,FremontBridge,07/08/2014 05:00:00 PM,48,-122,553,242,795
15450,FremontBridge,07/08/2014 06:00:00 PM,48,-122,395,179,574
15451,FremontBridge,07/08/2014 07:00:00 PM,48,-122,179,121,300
15452,FremontBridge,07/08/2014 08:00:00 PM,48,-122,124,85,209
15453,FremontBridge,07/08/2014 09:00:00 PM,48,-122,78,85,163
15454,FremontBridge,07/08/2014 10:00:00 PM,48,-122,43,28,71
15455,FremontBridge,07/08/2014 11:00:00 PM,48,-122,15,23,38
15456,FremontBridge,07/09/2014 12:00:00 AM,48,-122,12,5,17
15457,FremontBridge,07/09/2014 01:00:00 AM,48,-122,9,5,14
15458,FremontBridge,07/09/2014 02:00:00 AM,48,-122,1,4,5
15459,FremontBridge,07/09/2014 03:00:00 AM,48,-122,2,3,5
15460,FremontBridge,07/09/2014 04:00:00 AM,48,-122,8,5,13
15461,FremontBridge,07/09/2014 05:00:00 AM,48,-122,24,32,56
15462,FremontBridge,07/09/2014 06:00:00 AM,48,-122,68,160,228
15463,FremontBridge,07/09/2014 07:00:00 AM,48,-122,131,373,504
15464,FremontBridge,07/09/2014 08:00:00 AM,48,-122,181,452,633
15465,FremontBridge,07/09/2014 09:00:00 AM,48,-122,118,202,320
15466,FremontBridge,07/09/2014 10:00:00 AM,48,-122,57,88,145
15467,FremontBridge,07/09/2014 11:00:00 AM,48,-122,53,88,141
15468,FremontBridge,07/09/2014 12:00:00 PM,48,-122,61,69,130
15469,FremontBridge,07/09/2014 01:00:00 PM,48,-122,73,56,129
15470,FremontBridge,07/09/2014 02:00:00 PM,48,-122,58,60,118
15471,FremontBridge,07/09/2014 03:00:00 PM,48,-122,91,92,183
15472,FremontBridge,07/09/2014 04:00:00 PM,48,-122,258,152,410
15473,FremontBridge,07/09/2014 05:00:00 PM,48,-122,519,219,738
15474,FremontBridge,07/09/2014 06:00:00 PM,48,-122,408,200,608
15475,FremontBridge,07/09/2014 07:00:00 PM,48,-122,181,131,312
15476,FremontBridge,07/09/2014 08:00:00 PM,48,-122,111,81,192
15477,FremontBridge,07/09/2014 09:00:00 PM,48,-122,69,68,137
15478,FremontBridge,07/09/2014 10:00:00 PM,48,-122,29,33,62
15479,FremontBridge,07/09/2014 11:00:00 PM,48,-122,22,13,35
15480,FremontBridge,07/10/2014 12:00:00 AM,48,-122,8,11,19
15481,FremontBridge,07/10/2014 01:00:00 AM,48,-122,8,1,9
15482,FremontBridge,07/10/2014 02:00:00 AM,48,-122,1,5,6
15483,FremontBridge,07/10/2014 03:00:00 AM,48,-122,3,3,6
15484,FremontBridge,07/10/2014 04:00:00 AM,48,-122,1,8,9
15485,FremontBridge,07/10/2014 05:00:00 AM,48,-122,17,32,49
15486,FremontBridge,07/10/2014 06:00:00 AM,48,-122,56,144,200
15487,FremontBridge,07/10/2014 07:00:00 AM,48,-122,112,343,455
15488,FremontBridge,07/10/2014 08:00:00 AM,48,-122,195,426,621
15489,FremontBridge,07/10/2014 09:00:00 AM,48,-122,100,186,286
15490,FremontBridge,07/10/2014 10:00:00 AM,48,-122,60,63,123
15491,FremontBridge,07/10/2014 11:00:00 AM,48,-122,42,74,116
15492,FremontBridge,07/10/2014 12:00:00 PM,48,-122,60,64,124
15493,FremontBridge,07/10/2014 01:00:00 PM,48,-122,50,54,104
15494,FremontBridge,07/10/2014 02:00:00 PM,48,-122,69,68,137
15495,FremontBridge,07/10/2014 03:00:00 PM,48,-122,92,90,182
15496,FremontBridge,07/10/2014 04:00:00 PM,48,-122,212,134,346
15497,FremontBridge,07/10/2014 05:00:00 PM,48,-122,453,248,701
15498,FremontBridge,07/10/2014 06:00:00 PM,48,-122,327,187,514
15499,FremontBridge,07/10/2014 07:00:00 PM,48,-122,205,133,338
15500,FremontBridge,07/10/2014 08:00:00 PM,48,-122,109,94,203
15501,FremontBridge,07/10/2014 09:00:00 PM,48,-122,77,66,143
15502,FremontBridge,07/10/2014 10:00:00 PM,48,-122,36,29,65
15503,FremontBridge,07/10/2014 11:00:00 PM,48,-122,29,15,44
15504,FremontBridge,07/11/2014 12:00:00 AM,48,-122,12,19,31
15505,FremontBridge,07/11/2014 01:00:00 AM,48,-122,4,22,26
15506,FremontBridge,07/11/2014 02:00:00 AM,48,-122,7,5,12
15507,FremontBridge,07/11/2014 03:00:00 AM,48,-122,1,1,2
15508,FremontBridge,07/11/2014 04:00:00 AM,48,-122,8,7,15
15509,FremontBridge,07/11/2014 05:00:00 AM,48,-122,12,23,35
15510,FremontBridge,07/11/2014 06:00:00 AM,48,-122,39,104,143
15511,FremontBridge,07/11/2014 07:00:00 AM,48,-122,95,281,376
15512,FremontBridge,07/11/2014 08:00:00 AM,48,-122,172,342,514
15513,FremontBridge,07/11/2014 09:00:00 AM,48,-122,105,203,308
15514,FremontBridge,07/11/2014 10:00:00 AM,48,-122,66,84,150
15515,FremontBridge,07/11/2014 11:00:00 AM,48,-122,64,84,148
15516,FremontBridge,07/11/2014 12:00:00 PM,48,-122,46,69,115
15517,FremontBridge,07/11/2014 01:00:00 PM,48,-122,47,72,119
15518,FremontBridge,07/11/2014 02:00:00 PM,48,-122,72,70,142
15519,FremontBridge,07/11/2014 03:00:00 PM,48,-122,108,85,193
15520,FremontBridge,07/11/2014 04:00:00 PM,48,-122,241,130,371
15521,FremontBridge,07/11/2014 05:00:00 PM,48,-122,414,198,612
15522,FremontBridge,07/11/2014 06:00:00 PM,48,-122,220,126,346
15523,FremontBridge,07/11/2014 07:00:00 PM,48,-122,104,74,178
15524,FremontBridge,07/11/2014 08:00:00 PM,48,-122,52,60,112
15525,FremontBridge,07/11/2014 09:00:00 PM,48,-122,41,66,107
15526,FremontBridge,07/11/2014 10:00:00 PM,48,-122,38,35,73
15527,FremontBridge,07/11/2014 11:00:00 PM,48,-122,14,26,40
15528,FremontBridge,07/12/2014 12:00:00 AM,48,-122,15,9,24
15529,FremontBridge,07/12/2014 01:00:00 AM,48,-122,13,8,21
15530,FremontBridge,07/12/2014 02:00:00 AM,48,-122,6,5,11
15531,FremontBridge,07/12/2014 03:00:00 AM,48,-122,5,1,6
15532,FremontBridge,07/12/2014 04:00:00 AM,48,-122,36,14,50
15533,FremontBridge,07/12/2014 05:00:00 AM,48,-122,40,17,57
15534,FremontBridge,07/12/2014 06:00:00 AM,48,-122,36,21,57
15535,FremontBridge,07/12/2014 07:00:00 AM,48,-122,37,57,94
15536,FremontBridge,07/12/2014 08:00:00 AM,48,-122,47,67,114
15537,FremontBridge,07/12/2014 09:00:00 AM,48,-122,78,74,152
15538,FremontBridge,07/12/2014 10:00:00 AM,48,-122,82,116,198
15539,FremontBridge,07/12/2014 11:00:00 AM,48,-122,69,93,162
15540,FremontBridge,07/12/2014 12:00:00 PM,48,-122,89,80,169
15541,FremontBridge,07/12/2014 01:00:00 PM,48,-122,76,94,170
15542,FremontBridge,07/12/2014 02:00:00 PM,48,-122,53,89,142
15543,FremontBridge,07/12/2014 03:00:00 PM,48,-122,117,98,215
15544,FremontBridge,07/12/2014 04:00:00 PM,48,-122,74,68,142
15545,FremontBridge,07/12/2014 05:00:00 PM,48,-122,80,66,146
15546,FremontBridge,07/12/2014 06:00:00 PM,48,-122,55,54,109
15547,FremontBridge,07/12/2014 07:00:00 PM,48,-122,71,42,113
15548,FremontBridge,07/12/2014 08:00:00 PM,48,-122,74,65,139
15549,FremontBridge,07/12/2014 09:00:00 PM,48,-122,36,40,76
15550,FremontBridge,07/12/2014 10:00:00 PM,48,-122,15,31,46
15551,FremontBridge,07/12/2014 11:00:00 PM,48,-122,32,35,67
15552,FremontBridge,07/13/2014 12:00:00 AM,48,-122,13,16,29
15553,FremontBridge,07/13/2014 01:00:00 AM,48,-122,11,12,23
15554,FremontBridge,07/13/2014 02:00:00 AM,48,-122,2,9,11
15555,FremontBridge,07/13/2014 03:00:00 AM,48,-122,1,3,4
15556,FremontBridge,07/13/2014 04:00:00 AM,48,-122,2,2,4
15557,FremontBridge,07/13/2014 05:00:00 AM,48,-122,4,5,9
15558,FremontBridge,07/13/2014 06:00:00 AM,48,-122,14,14,28
15559,FremontBridge,07/13/2014 07:00:00 AM,48,-122,23,41,64
15560,FremontBridge,07/13/2014 08:00:00 AM,48,-122,43,71,114
15561,FremontBridge,07/13/2014 09:00:00 AM,48,-122,66,80,146
15562,FremontBridge,07/13/2014 10:00:00 AM,48,-122,79,98,177
15563,FremontBridge,07/13/2014 11:00:00 AM,48,-122,93,104,197
15564,FremontBridge,07/13/2014 12:00:00 PM,48,-122,73,119,192
15565,FremontBridge,07/13/2014 01:00:00 PM,48,-122,49,63,112
15566,FremontBridge,07/13/2014 02:00:00 PM,48,-122,62,74,136
15567,FremontBridge,07/13/2014 03:00:00 PM,48,-122,81,113,194
15568,FremontBridge,07/13/2014 04:00:00 PM,48,-122,89,80,169
15569,FremontBridge,07/13/2014 05:00:00 PM,48,-122,77,84,161
15570,FremontBridge,07/13/2014 06:00:00 PM,48,-122,62,64,126
15571,FremontBridge,07/13/2014 07:00:00 PM,48,-122,51,95,146
15572,FremontBridge,07/13/2014 08:00:00 PM,48,-122,37,47,84
15573,FremontBridge,07/13/2014 09:00:00 PM,48,-122,30,28,58
15574,FremontBridge,07/13/2014 10:00:00 PM,48,-122,61,25,86
15575,FremontBridge,07/13/2014 11:00:00 PM,48,-122,11,17,28
15576,FremontBridge,07/14/2014 12:00:00 AM,48,-122,7,4,11
15577,FremontBridge,07/14/2014 01:00:00 AM,48,-122,4,3,7
15578,FremontBridge,07/14/2014 02:00:00 AM,48,-122,0,1,1
15579,FremontBridge,07/14/2014 03:00:00 AM,48,-122,3,4,7
15580,FremontBridge,07/14/2014 04:00:00 AM,48,-122,5,2,7
15581,FremontBridge,07/14/2014 05:00:00 AM,48,-122,19,30,49
15582,FremontBridge,07/14/2014 06:00:00 AM,48,-122,50,112,162
15583,FremontBridge,07/14/2014 07:00:00 AM,48,-122,120,315,435
15584,FremontBridge,07/14/2014 08:00:00 AM,48,-122,157,393,550
15585,FremontBridge,07/14/2014 09:00:00 AM,48,-122,117,195,312
15586,FremontBridge,07/14/2014 10:00:00 AM,48,-122,59,75,134
15587,FremontBridge,07/14/2014 11:00:00 AM,48,-122,45,59,104
15588,FremontBridge,07/14/2014 12:00:00 PM,48,-122,39,43,82
15589,FremontBridge,07/14/2014 01:00:00 PM,48,-122,33,76,109
15590,FremontBridge,07/14/2014 02:00:00 PM,48,-122,71,57,128
15591,FremontBridge,07/14/2014 03:00:00 PM,48,-122,76,73,149
15592,FremontBridge,07/14/2014 04:00:00 PM,48,-122,224,119,343
15593,FremontBridge,07/14/2014 05:00:00 PM,48,-122,460,198,658
15594,FremontBridge,07/14/2014 06:00:00 PM,48,-122,357,205,562
15595,FremontBridge,07/14/2014 07:00:00 PM,48,-122,153,91,244
15596,FremontBridge,07/14/2014 08:00:00 PM,48,-122,106,94,200
15597,FremontBridge,07/14/2014 09:00:00 PM,48,-122,55,41,96
15598,FremontBridge,07/14/2014 10:00:00 PM,48,-122,25,20,45
15599,FremontBridge,07/14/2014 11:00:00 PM,48,-122,10,6,16
15600,FremontBridge,07/15/2014 12:00:00 AM,48,-122,12,4,16
15601,FremontBridge,07/15/2014 01:00:00 AM,48,-122,3,4,7
15602,FremontBridge,07/15/2014 02:00:00 AM,48,-122,1,3,4
15603,FremontBridge,07/15/2014 03:00:00 AM,48,-122,1,3,4
15604,FremontBridge,07/15/2014 04:00:00 AM,48,-122,2,7,9
15605,FremontBridge,07/15/2014 05:00:00 AM,48,-122,17,36,53
15606,FremontBridge,07/15/2014 06:00:00 AM,48,-122,62,137,199
15607,FremontBridge,07/15/2014 07:00:00 AM,48,-122,123,378,501
15608,FremontBridge,07/15/2014 08:00:00 AM,48,-122,208,416,624
15609,FremontBridge,07/15/2014 09:00:00 AM,48,-122,112,204,316
15610,FremontBridge,07/15/2014 10:00:00 AM,48,-122,73,73,146
15611,FremontBridge,07/15/2014 11:00:00 AM,48,-122,40,57,97
15612,FremontBridge,07/15/2014 12:00:00 PM,48,-122,49,95,144
15613,FremontBridge,07/15/2014 01:00:00 PM,48,-122,49,48,97
15614,FremontBridge,07/15/2014 02:00:00 PM,48,-122,50,42,92
15615,FremontBridge,07/15/2014 03:00:00 PM,48,-122,74,77,151
15616,FremontBridge,07/15/2014 04:00:00 PM,48,-122,243,136,379
15617,FremontBridge,07/15/2014 05:00:00 PM,48,-122,513,219,732
15618,FremontBridge,07/15/2014 06:00:00 PM,48,-122,405,193,598
15619,FremontBridge,07/15/2014 07:00:00 PM,48,-122,200,139,339
15620,FremontBridge,07/15/2014 08:00:00 PM,48,-122,113,90,203
15621,FremontBridge,07/15/2014 09:00:00 PM,48,-122,58,60,118
15622,FremontBridge,07/15/2014 10:00:00 PM,48,-122,39,44,83
15623,FremontBridge,07/15/2014 11:00:00 PM,48,-122,18,11,29
15624,FremontBridge,07/16/2014 12:00:00 AM,48,-122,5,7,12
15625,FremontBridge,07/16/2014 01:00:00 AM,48,-122,7,10,17
15626,FremontBridge,07/16/2014 02:00:00 AM,48,-122,1,2,3
15627,FremontBridge,07/16/2014 03:00:00 AM,48,-122,1,3,4
15628,FremontBridge,07/16/2014 04:00:00 AM,48,-122,3,7,10
15629,FremontBridge,07/16/2014 05:00:00 AM,48,-122,16,42,58
15630,FremontBridge,07/16/2014 06:00:00 AM,48,-122,71,143,214
15631,FremontBridge,07/16/2014 07:00:00 AM,48,-122,135,372,507
15632,FremontBridge,07/16/2014 08:00:00 AM,48,-122,181,408,589
15633,FremontBridge,07/16/2014 09:00:00 AM,48,-122,114,188,302
15634,FremontBridge,07/16/2014 10:00:00 AM,48,-122,67,109,176
15635,FremontBridge,07/16/2014 11:00:00 AM,48,-122,44,65,109
15636,FremontBridge,07/16/2014 12:00:00 PM,48,-122,79,66,145
15637,FremontBridge,07/16/2014 01:00:00 PM,48,-122,64,78,142
15638,FremontBridge,07/16/2014 02:00:00 PM,48,-122,81,60,141
15639,FremontBridge,07/16/2014 03:00:00 PM,48,-122,118,74,192
15640,FremontBridge,07/16/2014 04:00:00 PM,48,-122,226,133,359
15641,FremontBridge,07/16/2014 05:00:00 PM,48,-122,515,191,706
15642,FremontBridge,07/16/2014 06:00:00 PM,48,-122,367,213,580
15643,FremontBridge,07/16/2014 07:00:00 PM,48,-122,166,119,285
15644,FremontBridge,07/16/2014 08:00:00 PM,48,-122,142,97,239
15645,FremontBridge,07/16/2014 09:00:00 PM,48,-122,75,58,133
15646,FremontBridge,07/16/2014 10:00:00 PM,48,-122,28,22,50
15647,FremontBridge,07/16/2014 11:00:00 PM,48,-122,21,15,36
15648,FremontBridge,07/17/2014 12:00:00 AM,48,-122,14,18,32
15649,FremontBridge,07/17/2014 01:00:00 AM,48,-122,3,6,9
15650,FremontBridge,07/17/2014 02:00:00 AM,48,-122,1,5,6
15651,FremontBridge,07/17/2014 03:00:00 AM,48,-122,1,1,2
15652,FremontBridge,07/17/2014 04:00:00 AM,48,-122,2,7,9
15653,FremontBridge,07/17/2014 05:00:00 AM,48,-122,17,28,45
15654,FremontBridge,07/17/2014 06:00:00 AM,48,-122,42,102,144
15655,FremontBridge,07/17/2014 07:00:00 AM,48,-122,106,318,424
15656,FremontBridge,07/17/2014 08:00:00 AM,48,-122,178,365,543
15657,FremontBridge,07/17/2014 09:00:00 AM,48,-122,105,193,298
15658,FremontBridge,07/17/2014 10:00:00 AM,48,-122,50,80,130
15659,FremontBridge,07/17/2014 11:00:00 AM,48,-122,51,71,122
15660,FremontBridge,07/17/2014 12:00:00 PM,48,-122,52,59,111
15661,FremontBridge,07/17/2014 01:00:00 PM,48,-122,59,51,110
15662,FremontBridge,07/17/2014 02:00:00 PM,48,-122,61,71,132
15663,FremontBridge,07/17/2014 03:00:00 PM,48,-122,81,62,143
15664,FremontBridge,07/17/2014 04:00:00 PM,48,-122,225,122,347
15665,FremontBridge,07/17/2014 05:00:00 PM,48,-122,477,205,682
15666,FremontBridge,07/17/2014 06:00:00 PM,48,-122,277,177,454
15667,FremontBridge,07/17/2014 07:00:00 PM,48,-122,176,144,320
15668,FremontBridge,07/17/2014 08:00:00 PM,48,-122,94,103,197
15669,FremontBridge,07/17/2014 09:00:00 PM,48,-122,81,59,140
15670,FremontBridge,07/17/2014 10:00:00 PM,48,-122,36,45,81
15671,FremontBridge,07/17/2014 11:00:00 PM,48,-122,36,18,54
15672,FremontBridge,07/18/2014 12:00:00 AM,48,-122,8,14,22
15673,FremontBridge,07/18/2014 01:00:00 AM,48,-122,4,4,8
15674,FremontBridge,07/18/2014 02:00:00 AM,48,-122,3,2,5
15675,FremontBridge,07/18/2014 03:00:00 AM,48,-122,1,3,4
15676,FremontBridge,07/18/2014 04:00:00 AM,48,-122,5,8,13
15677,FremontBridge,07/18/2014 05:00:00 AM,48,-122,13,22,35
15678,FremontBridge,07/18/2014 06:00:00 AM,48,-122,55,97,152
15679,FremontBridge,07/18/2014 07:00:00 AM,48,-122,87,262,349
15680,FremontBridge,07/18/2014 08:00:00 AM,48,-122,147,328,475
15681,FremontBridge,07/18/2014 09:00:00 AM,48,-122,93,180,273
15682,FremontBridge,07/18/2014 10:00:00 AM,48,-122,48,88,136
15683,FremontBridge,07/18/2014 11:00:00 AM,48,-122,60,48,108
15684,FremontBridge,07/18/2014 12:00:00 PM,48,-122,62,83,145
15685,FremontBridge,07/18/2014 01:00:00 PM,48,-122,71,55,126
15686,FremontBridge,07/18/2014 02:00:00 PM,48,-122,62,80,142
15687,FremontBridge,07/18/2014 03:00:00 PM,48,-122,118,102,220
15688,FremontBridge,07/18/2014 04:00:00 PM,48,-122,250,133,383
15689,FremontBridge,07/18/2014 05:00:00 PM,48,-122,423,212,635
15690,FremontBridge,07/18/2014 06:00:00 PM,48,-122,263,176,439
15691,FremontBridge,07/18/2014 07:00:00 PM,48,-122,124,78,202
15692,FremontBridge,07/18/2014 08:00:00 PM,48,-122,70,42,112
15693,FremontBridge,07/18/2014 09:00:00 PM,48,-122,26,44,70
15694,FremontBridge,07/18/2014 10:00:00 PM,48,-122,27,25,52
15695,FremontBridge,07/18/2014 11:00:00 PM,48,-122,16,13,29
15696,FremontBridge,07/19/2014 12:00:00 AM,48,-122,17,17,34
15697,FremontBridge,07/19/2014 01:00:00 AM,48,-122,13,6,19
15698,FremontBridge,07/19/2014 02:00:00 AM,48,-122,5,4,9
15699,FremontBridge,07/19/2014 03:00:00 AM,48,-122,0,0,0
15700,FremontBridge,07/19/2014 04:00:00 AM,48,-122,2,1,3
15701,FremontBridge,07/19/2014 05:00:00 AM,48,-122,4,6,10
15702,FremontBridge,07/19/2014 06:00:00 AM,48,-122,12,13,25
15703,FremontBridge,07/19/2014 07:00:00 AM,48,-122,24,32,56
15704,FremontBridge,07/19/2014 08:00:00 AM,48,-122,45,50,95
15705,FremontBridge,07/19/2014 09:00:00 AM,48,-122,69,60,129
15706,FremontBridge,07/19/2014 10:00:00 AM,48,-122,64,63,127
15707,FremontBridge,07/19/2014 11:00:00 AM,48,-122,50,79,129
15708,FremontBridge,07/19/2014 12:00:00 PM,48,-122,84,109,193
15709,FremontBridge,07/19/2014 01:00:00 PM,48,-122,103,78,181
15710,FremontBridge,07/19/2014 02:00:00 PM,48,-122,77,87,164
15711,FremontBridge,07/19/2014 03:00:00 PM,48,-122,119,87,206
15712,FremontBridge,07/19/2014 04:00:00 PM,48,-122,90,91,181
15713,FremontBridge,07/19/2014 05:00:00 PM,48,-122,70,75,145
15714,FremontBridge,07/19/2014 06:00:00 PM,48,-122,72,78,150
15715,FremontBridge,07/19/2014 07:00:00 PM,48,-122,53,36,89
15716,FremontBridge,07/19/2014 08:00:00 PM,48,-122,32,23,55
15717,FremontBridge,07/19/2014 09:00:00 PM,48,-122,27,26,53
15718,FremontBridge,07/19/2014 10:00:00 PM,48,-122,12,21,33
15719,FremontBridge,07/19/2014 11:00:00 PM,48,-122,17,17,34
15720,FremontBridge,07/20/2014 12:00:00 AM,48,-122,13,8,21
15721,FremontBridge,07/20/2014 01:00:00 AM,48,-122,7,7,14
15722,FremontBridge,07/20/2014 02:00:00 AM,48,-122,3,4,7
15723,FremontBridge,07/20/2014 03:00:00 AM,48,-122,1,4,5
15724,FremontBridge,07/20/2014 04:00:00 AM,48,-122,2,3,5
15725,FremontBridge,07/20/2014 05:00:00 AM,48,-122,1,3,4
15726,FremontBridge,07/20/2014 06:00:00 AM,48,-122,4,8,12
15727,FremontBridge,07/20/2014 07:00:00 AM,48,-122,11,19,30
15728,FremontBridge,07/20/2014 08:00:00 AM,48,-122,19,34,53
15729,FremontBridge,07/20/2014 09:00:00 AM,48,-122,34,34,68
15730,FremontBridge,07/20/2014 10:00:00 AM,48,-122,36,60,96
15731,FremontBridge,07/20/2014 11:00:00 AM,48,-122,39,63,102
15732,FremontBridge,07/20/2014 12:00:00 PM,48,-122,47,61,108
15733,FremontBridge,07/20/2014 01:00:00 PM,48,-122,67,105,172
15734,FremontBridge,07/20/2014 02:00:00 PM,48,-122,61,92,153
15735,FremontBridge,07/20/2014 03:00:00 PM,48,-122,97,77,174
15736,FremontBridge,07/20/2014 04:00:00 PM,48,-122,87,84,171
15737,FremontBridge,07/20/2014 05:00:00 PM,48,-122,40,39,79
15738,FremontBridge,07/20/2014 06:00:00 PM,48,-122,36,38,74
15739,FremontBridge,07/20/2014 07:00:00 PM,48,-122,47,24,71
15740,FremontBridge,07/20/2014 08:00:00 PM,48,-122,24,16,40
15741,FremontBridge,07/20/2014 09:00:00 PM,48,-122,22,17,39
15742,FremontBridge,07/20/2014 10:00:00 PM,48,-122,12,7,19
15743,FremontBridge,07/20/2014 11:00:00 PM,48,-122,16,2,18
15744,FremontBridge,07/21/2014 12:00:00 AM,48,-122,6,4,10
15745,FremontBridge,07/21/2014 01:00:00 AM,48,-122,0,1,1
15746,FremontBridge,07/21/2014 02:00:00 AM,48,-122,1,2,3
15747,FremontBridge,07/21/2014 03:00:00 AM,48,-122,2,5,7
15748,FremontBridge,07/21/2014 04:00:00 AM,48,-122,4,9,13
15749,FremontBridge,07/21/2014 05:00:00 AM,48,-122,11,34,45
15750,FremontBridge,07/21/2014 06:00:00 AM,48,-122,54,110,164
15751,FremontBridge,07/21/2014 07:00:00 AM,48,-122,119,303,422
15752,FremontBridge,07/21/2014 08:00:00 AM,48,-122,174,354,528
15753,FremontBridge,07/21/2014 09:00:00 AM,48,-122,111,192,303
15754,FremontBridge,07/21/2014 10:00:00 AM,48,-122,51,85,136
15755,FremontBridge,07/21/2014 11:00:00 AM,48,-122,49,48,97
15756,FremontBridge,07/21/2014 12:00:00 PM,48,-122,59,83,142
15757,FremontBridge,07/21/2014 01:00:00 PM,48,-122,51,42,93
15758,FremontBridge,07/21/2014 02:00:00 PM,48,-122,78,65,143
15759,FremontBridge,07/21/2014 03:00:00 PM,48,-122,92,84,176
15760,FremontBridge,07/21/2014 04:00:00 PM,48,-122,208,164,372
15761,FremontBridge,07/21/2014 05:00:00 PM,48,-122,490,225,715
15762,FremontBridge,07/21/2014 06:00:00 PM,48,-122,297,195,492
15763,FremontBridge,07/21/2014 07:00:00 PM,48,-122,179,124,303
15764,FremontBridge,07/21/2014 08:00:00 PM,48,-122,109,91,200
15765,FremontBridge,07/21/2014 09:00:00 PM,48,-122,50,28,78
15766,FremontBridge,07/21/2014 10:00:00 PM,48,-122,31,26,57
15767,FremontBridge,07/21/2014 11:00:00 PM,48,-122,14,11,25
15768,FremontBridge,07/22/2014 12:00:00 AM,48,-122,6,2,8
15769,FremontBridge,07/22/2014 01:00:00 AM,48,-122,0,4,4
15770,FremontBridge,07/22/2014 02:00:00 AM,48,-122,3,6,9
15771,FremontBridge,07/22/2014 03:00:00 AM,48,-122,2,1,3
15772,FremontBridge,07/22/2014 04:00:00 AM,48,-122,7,4,11
15773,FremontBridge,07/22/2014 05:00:00 AM,48,-122,15,47,62
15774,FremontBridge,07/22/2014 06:00:00 AM,48,-122,68,150,218
15775,FremontBridge,07/22/2014 07:00:00 AM,48,-122,137,405,542
15776,FremontBridge,07/22/2014 08:00:00 AM,48,-122,194,400,594
15777,FremontBridge,07/22/2014 09:00:00 AM,48,-122,113,200,313
15778,FremontBridge,07/22/2014 10:00:00 AM,48,-122,48,87,135
15779,FremontBridge,07/22/2014 11:00:00 AM,48,-122,52,55,107
15780,FremontBridge,07/22/2014 12:00:00 PM,48,-122,48,62,110
15781,FremontBridge,07/22/2014 01:00:00 PM,48,-122,59,49,108
15782,FremontBridge,07/22/2014 02:00:00 PM,48,-122,47,50,97
15783,FremontBridge,07/22/2014 03:00:00 PM,48,-122,100,86,186
15784,FremontBridge,07/22/2014 04:00:00 PM,48,-122,227,117,344
15785,FremontBridge,07/22/2014 05:00:00 PM,48,-122,491,211,702
15786,FremontBridge,07/22/2014 06:00:00 PM,48,-122,349,213,562
15787,FremontBridge,07/22/2014 07:00:00 PM,48,-122,179,120,299
15788,FremontBridge,07/22/2014 08:00:00 PM,48,-122,116,67,183
15789,FremontBridge,07/22/2014 09:00:00 PM,48,-122,45,41,86
15790,FremontBridge,07/22/2014 10:00:00 PM,48,-122,38,29,67
15791,FremontBridge,07/22/2014 11:00:00 PM,48,-122,18,10,28
15792,FremontBridge,07/23/2014 12:00:00 AM,48,-122,10,8,18
15793,FremontBridge,07/23/2014 01:00:00 AM,48,-122,2,3,5
15794,FremontBridge,07/23/2014 02:00:00 AM,48,-122,2,2,4
15795,FremontBridge,07/23/2014 03:00:00 AM,48,-122,2,1,3
15796,FremontBridge,07/23/2014 04:00:00 AM,48,-122,1,3,4
15797,FremontBridge,07/23/2014 05:00:00 AM,48,-122,8,30,38
15798,FremontBridge,07/23/2014 06:00:00 AM,48,-122,32,64,96
15799,FremontBridge,07/23/2014 07:00:00 AM,48,-122,53,144,197
15800,FremontBridge,07/23/2014 08:00:00 AM,48,-122,84,191,275
15801,FremontBridge,07/23/2014 09:00:00 AM,48,-122,54,86,140
15802,FremontBridge,07/23/2014 10:00:00 AM,48,-122,28,32,60
15803,FremontBridge,07/23/2014 11:00:00 AM,48,-122,19,19,38
15804,FremontBridge,07/23/2014 12:00:00 PM,48,-122,14,8,22
15805,FremontBridge,07/23/2014 01:00:00 PM,48,-122,16,22,38
15806,FremontBridge,07/23/2014 02:00:00 PM,48,-122,19,20,39
15807,FremontBridge,07/23/2014 03:00:00 PM,48,-122,26,16,42
15808,FremontBridge,07/23/2014 04:00:00 PM,48,-122,95,46,141
15809,FremontBridge,07/23/2014 05:00:00 PM,48,-122,192,88,280
15810,FremontBridge,07/23/2014 06:00:00 PM,48,-122,160,89,249
15811,FremontBridge,07/23/2014 07:00:00 PM,48,-122,79,43,122
15812,FremontBridge,07/23/2014 08:00:00 PM,48,-122,49,35,84
15813,FremontBridge,07/23/2014 09:00:00 PM,48,-122,25,20,45
15814,FremontBridge,07/23/2014 10:00:00 PM,48,-122,15,17,32
15815,FremontBridge,07/23/2014 11:00:00 PM,48,-122,11,6,17
15816,FremontBridge,07/24/2014 12:00:00 AM,48,-122,5,9,14
15817,FremontBridge,07/24/2014 01:00:00 AM,48,-122,1,7,8
15818,FremontBridge,07/24/2014 02:00:00 AM,48,-122,3,1,4
15819,FremontBridge,07/24/2014 03:00:00 AM,48,-122,1,1,2
15820,FremontBridge,07/24/2014 04:00:00 AM,48,-122,3,4,7
15821,FremontBridge,07/24/2014 05:00:00 AM,48,-122,9,29,38
15822,FremontBridge,07/24/2014 06:00:00 AM,48,-122,32,80,112
15823,FremontBridge,07/24/2014 07:00:00 AM,48,-122,68,214,282
15824,FremontBridge,07/24/2014 08:00:00 AM,48,-122,121,253,374
15825,FremontBridge,07/24/2014 09:00:00 AM,48,-122,80,151,231
15826,FremontBridge,07/24/2014 10:00:00 AM,48,-122,35,48,83
15827,FremontBridge,07/24/2014 11:00:00 AM,48,-122,34,36,70
15828,FremontBridge,07/24/2014 12:00:00 PM,48,-122,42,48,90
15829,FremontBridge,07/24/2014 01:00:00 PM,48,-122,39,41,80
15830,FremontBridge,07/24/2014 02:00:00 PM,48,-122,37,37,74
15831,FremontBridge,07/24/2014 03:00:00 PM,48,-122,74,42,116
15832,FremontBridge,07/24/2014 04:00:00 PM,48,-122,118,74,192
15833,FremontBridge,07/24/2014 05:00:00 PM,48,-122,327,134,461
15834,FremontBridge,07/24/2014 06:00:00 PM,48,-122,212,134,346
15835,FremontBridge,07/24/2014 07:00:00 PM,48,-122,126,81,207
15836,FremontBridge,07/24/2014 08:00:00 PM,48,-122,50,49,99
15837,FremontBridge,07/24/2014 09:00:00 PM,48,-122,38,14,52
15838,FremontBridge,07/24/2014 10:00:00 PM,48,-122,19,20,39
15839,FremontBridge,07/24/2014 11:00:00 PM,48,-122,12,9,21
15840,FremontBridge,07/25/2014 12:00:00 AM,48,-122,8,7,15
15841,FremontBridge,07/25/2014 01:00:00 AM,48,-122,2,4,6
15842,FremontBridge,07/25/2014 02:00:00 AM,48,-122,4,7,11
15843,FremontBridge,07/25/2014 03:00:00 AM,48,-122,1,1,2
15844,FremontBridge,07/25/2014 04:00:00 AM,48,-122,6,4,10
15845,FremontBridge,07/25/2014 05:00:00 AM,48,-122,15,28,43
15846,FremontBridge,07/25/2014 06:00:00 AM,48,-122,32,81,113
15847,FremontBridge,07/25/2014 07:00:00 AM,48,-122,90,218,308
15848,FremontBridge,07/25/2014 08:00:00 AM,48,-122,147,354,501
15849,FremontBridge,07/25/2014 09:00:00 AM,48,-122,91,170,261
15850,FremontBridge,07/25/2014 10:00:00 AM,48,-122,50,88,138
15851,FremontBridge,07/25/2014 11:00:00 AM,48,-122,43,73,116
15852,FremontBridge,07/25/2014 12:00:00 PM,48,-122,76,110,186
15853,FremontBridge,07/25/2014 01:00:00 PM,48,-122,81,84,165
15854,FremontBridge,07/25/2014 02:00:00 PM,48,-122,88,80,168
15855,FremontBridge,07/25/2014 03:00:00 PM,48,-122,89,79,168
15856,FremontBridge,07/25/2014 04:00:00 PM,48,-122,213,154,367
15857,FremontBridge,07/25/2014 05:00:00 PM,48,-122,384,178,562
15858,FremontBridge,07/25/2014 06:00:00 PM,48,-122,251,154,405
15859,FremontBridge,07/25/2014 07:00:00 PM,48,-122,124,76,200
15860,FremontBridge,07/25/2014 08:00:00 PM,48,-122,88,42,130
15861,FremontBridge,07/25/2014 09:00:00 PM,48,-122,36,60,96
15862,FremontBridge,07/25/2014 10:00:00 PM,48,-122,20,30,50
15863,FremontBridge,07/25/2014 11:00:00 PM,48,-122,33,18,51
15864,FremontBridge,07/26/2014 12:00:00 AM,48,-122,15,12,27
15865,FremontBridge,07/26/2014 01:00:00 AM,48,-122,8,10,18
15866,FremontBridge,07/26/2014 02:00:00 AM,48,-122,7,9,16
15867,FremontBridge,07/26/2014 03:00:00 AM,48,-122,0,5,5
15868,FremontBridge,07/26/2014 04:00:00 AM,48,-122,3,2,5
15869,FremontBridge,07/26/2014 05:00:00 AM,48,-122,3,12,15
15870,FremontBridge,07/26/2014 06:00:00 AM,48,-122,18,19,37
15871,FremontBridge,07/26/2014 07:00:00 AM,48,-122,40,34,74
15872,FremontBridge,07/26/2014 08:00:00 AM,48,-122,54,65,119
15873,FremontBridge,07/26/2014 09:00:00 AM,48,-122,80,70,150
15874,FremontBridge,07/26/2014 10:00:00 AM,48,-122,65,77,142
15875,FremontBridge,07/26/2014 11:00:00 AM,48,-122,111,124,235
15876,FremontBridge,07/26/2014 12:00:00 PM,48,-122,95,152,247
15877,FremontBridge,07/26/2014 01:00:00 PM,48,-122,56,136,192
15878,FremontBridge,07/26/2014 02:00:00 PM,48,-122,109,130,239
15879,FremontBridge,07/26/2014 03:00:00 PM,48,-122,113,139,252
15880,FremontBridge,07/26/2014 04:00:00 PM,48,-122,87,105,192
15881,FremontBridge,07/26/2014 05:00:00 PM,48,-122,101,118,219
15882,FremontBridge,07/26/2014 06:00:00 PM,48,-122,68,86,154
15883,FremontBridge,07/26/2014 07:00:00 PM,48,-122,62,79,141
15884,FremontBridge,07/26/2014 08:00:00 PM,48,-122,41,48,89
15885,FremontBridge,07/26/2014 09:00:00 PM,48,-122,32,26,58
15886,FremontBridge,07/26/2014 10:00:00 PM,48,-122,32,12,44
15887,FremontBridge,07/26/2014 11:00:00 PM,48,-122,22,18,40
15888,FremontBridge,07/27/2014 12:00:00 AM,48,-122,22,13,35
15889,FremontBridge,07/27/2014 01:00:00 AM,48,-122,7,10,17
15890,FremontBridge,07/27/2014 02:00:00 AM,48,-122,6,4,10
15891,FremontBridge,07/27/2014 03:00:00 AM,48,-122,2,4,6
15892,FremontBridge,07/27/2014 04:00:00 AM,48,-122,3,4,7
15893,FremontBridge,07/27/2014 05:00:00 AM,48,-122,1,6,7
15894,FremontBridge,07/27/2014 06:00:00 AM,48,-122,11,7,18
15895,FremontBridge,07/27/2014 07:00:00 AM,48,-122,21,20,41
15896,FremontBridge,07/27/2014 08:00:00 AM,48,-122,39,57,96
15897,FremontBridge,07/27/2014 09:00:00 AM,48,-122,67,63,130
15898,FremontBridge,07/27/2014 10:00:00 AM,48,-122,102,75,177
15899,FremontBridge,07/27/2014 11:00:00 AM,48,-122,97,114,211
15900,FremontBridge,07/27/2014 12:00:00 PM,48,-122,95,138,233
15901,FremontBridge,07/27/2014 01:00:00 PM,48,-122,104,127,231
15902,FremontBridge,07/27/2014 02:00:00 PM,48,-122,117,145,262
15903,FremontBridge,07/27/2014 03:00:00 PM,48,-122,100,138,238
15904,FremontBridge,07/27/2014 04:00:00 PM,48,-122,119,109,228
15905,FremontBridge,07/27/2014 05:00:00 PM,48,-122,79,115,194
15906,FremontBridge,07/27/2014 06:00:00 PM,48,-122,68,89,157
15907,FremontBridge,07/27/2014 07:00:00 PM,48,-122,53,77,130
15908,FremontBridge,07/27/2014 08:00:00 PM,48,-122,37,44,81
15909,FremontBridge,07/27/2014 09:00:00 PM,48,-122,32,41,73
15910,FremontBridge,07/27/2014 10:00:00 PM,48,-122,15,16,31
15911,FremontBridge,07/27/2014 11:00:00 PM,48,-122,11,3,14
15912,FremontBridge,07/28/2014 12:00:00 AM,48,-122,6,3,9
15913,FremontBridge,07/28/2014 01:00:00 AM,48,-122,5,9,14
15914,FremontBridge,07/28/2014 02:00:00 AM,48,-122,1,5,6
15915,FremontBridge,07/28/2014 03:00:00 AM,48,-122,1,4,5
15916,FremontBridge,07/28/2014 04:00:00 AM,48,-122,4,9,13
15917,FremontBridge,07/28/2014 05:00:00 AM,48,-122,23,42,65
15918,FremontBridge,07/28/2014 06:00:00 AM,48,-122,65,105,170
15919,FremontBridge,07/28/2014 07:00:00 AM,48,-122,121,334,455
15920,FremontBridge,07/28/2014 08:00:00 AM,48,-122,198,431,629
15921,FremontBridge,07/28/2014 09:00:00 AM,48,-122,100,184,284
15922,FremontBridge,07/28/2014 10:00:00 AM,48,-122,79,92,171
15923,FremontBridge,07/28/2014 11:00:00 AM,48,-122,61,77,138
15924,FremontBridge,07/28/2014 12:00:00 PM,48,-122,41,64,105
15925,FremontBridge,07/28/2014 01:00:00 PM,48,-122,62,42,104
15926,FremontBridge,07/28/2014 02:00:00 PM,48,-122,60,75,135
15927,FremontBridge,07/28/2014 03:00:00 PM,48,-122,86,90,176
15928,FremontBridge,07/28/2014 04:00:00 PM,48,-122,203,143,346
15929,FremontBridge,07/28/2014 05:00:00 PM,48,-122,469,210,679
15930,FremontBridge,07/28/2014 06:00:00 PM,48,-122,349,228,577
15931,FremontBridge,07/28/2014 07:00:00 PM,48,-122,184,109,293
15932,FremontBridge,07/28/2014 08:00:00 PM,48,-122,112,91,203
15933,FremontBridge,07/28/2014 09:00:00 PM,48,-122,76,43,119
15934,FremontBridge,07/28/2014 10:00:00 PM,48,-122,43,26,69
15935,FremontBridge,07/28/2014 11:00:00 PM,48,-122,16,15,31
15936,FremontBridge,07/29/2014 12:00:00 AM,48,-122,10,7,17
15937,FremontBridge,07/29/2014 01:00:00 AM,48,-122,6,3,9
15938,FremontBridge,07/29/2014 02:00:00 AM,48,-122,0,4,4
15939,FremontBridge,07/29/2014 03:00:00 AM,48,-122,2,0,2
15940,FremontBridge,07/29/2014 04:00:00 AM,48,-122,4,7,11
15941,FremontBridge,07/29/2014 05:00:00 AM,48,-122,19,39,58
15942,FremontBridge,07/29/2014 06:00:00 AM,48,-122,71,143,214
15943,FremontBridge,07/29/2014 07:00:00 AM,48,-122,150,382,532
15944,FremontBridge,07/29/2014 08:00:00 AM,48,-122,200,470,670
15945,FremontBridge,07/29/2014 09:00:00 AM,48,-122,136,202,338
15946,FremontBridge,07/29/2014 10:00:00 AM,48,-122,62,96,158
15947,FremontBridge,07/29/2014 11:00:00 AM,48,-122,57,60,117
15948,FremontBridge,07/29/2014 12:00:00 PM,48,-122,66,77,143
15949,FremontBridge,07/29/2014 01:00:00 PM,48,-122,74,60,134
15950,FremontBridge,07/29/2014 02:00:00 PM,48,-122,71,47,118
15951,FremontBridge,07/29/2014 03:00:00 PM,48,-122,103,65,168
15952,FremontBridge,07/29/2014 04:00:00 PM,48,-122,232,138,370
15953,FremontBridge,07/29/2014 05:00:00 PM,48,-122,571,230,801
15954,FremontBridge,07/29/2014 06:00:00 PM,48,-122,377,209,586
15955,FremontBridge,07/29/2014 07:00:00 PM,48,-122,177,156,333
15956,FremontBridge,07/29/2014 08:00:00 PM,48,-122,116,75,191
15957,FremontBridge,07/29/2014 09:00:00 PM,48,-122,77,78,155
15958,FremontBridge,07/29/2014 10:00:00 PM,48,-122,37,37,74
15959,FremontBridge,07/29/2014 11:00:00 PM,48,-122,24,21,45
15960,FremontBridge,07/30/2014 12:00:00 AM,48,-122,11,2,13
15961,FremontBridge,07/30/2014 01:00:00 AM,48,-122,2,8,10
15962,FremontBridge,07/30/2014 02:00:00 AM,48,-122,7,2,9
15963,FremontBridge,07/30/2014 03:00:00 AM,48,-122,2,1,3
15964,FremontBridge,07/30/2014 04:00:00 AM,48,-122,1,5,6
15965,FremontBridge,07/30/2014 05:00:00 AM,48,-122,16,38,54
15966,FremontBridge,07/30/2014 06:00:00 AM,48,-122,66,145,211
15967,FremontBridge,07/30/2014 07:00:00 AM,48,-122,132,350,482
15968,FremontBridge,07/30/2014 08:00:00 AM,48,-122,213,419,632
15969,FremontBridge,07/30/2014 09:00:00 AM,48,-122,132,205,337
15970,FremontBridge,07/30/2014 10:00:00 AM,48,-122,57,109,166
15971,FremontBridge,07/30/2014 11:00:00 AM,48,-122,50,68,118
15972,FremontBridge,07/30/2014 12:00:00 PM,48,-122,60,46,106
15973,FremontBridge,07/30/2014 01:00:00 PM,48,-122,83,54,137
15974,FremontBridge,07/30/2014 02:00:00 PM,48,-122,76,53,129
15975,FremontBridge,07/30/2014 03:00:00 PM,48,-122,111,88,199
15976,FremontBridge,07/30/2014 04:00:00 PM,48,-122,233,149,382
15977,FremontBridge,07/30/2014 05:00:00 PM,48,-122,528,227,755
15978,FremontBridge,07/30/2014 06:00:00 PM,48,-122,378,205,583
15979,FremontBridge,07/30/2014 07:00:00 PM,48,-122,174,105,279
15980,FremontBridge,07/30/2014 08:00:00 PM,48,-122,118,91,209
15981,FremontBridge,07/30/2014 09:00:00 PM,48,-122,58,68,126
15982,FremontBridge,07/30/2014 10:00:00 PM,48,-122,41,32,73
15983,FremontBridge,07/30/2014 11:00:00 PM,48,-122,25,15,40
15984,FremontBridge,07/31/2014 12:00:00 AM,48,-122,7,8,15
15985,FremontBridge,07/31/2014 01:00:00 AM,48,-122,3,7,10
15986,FremontBridge,07/31/2014 02:00:00 AM,48,-122,4,2,6
15987,FremontBridge,07/31/2014 03:00:00 AM,48,-122,3,1,4
15988,FremontBridge,07/31/2014 04:00:00 AM,48,-122,3,9,12
15989,FremontBridge,07/31/2014 05:00:00 AM,48,-122,13,29,42
15990,FremontBridge,07/31/2014 06:00:00 AM,48,-122,68,106,174
15991,FremontBridge,07/31/2014 07:00:00 AM,48,-122,114,369,483
15992,FremontBridge,07/31/2014 08:00:00 AM,48,-122,197,415,612
15993,FremontBridge,07/31/2014 09:00:00 AM,48,-122,122,192,314
15994,FremontBridge,07/31/2014 10:00:00 AM,48,-122,76,94,170
15995,FremontBridge,07/31/2014 11:00:00 AM,48,-122,46,70,116
15996,FremontBridge,07/31/2014 12:00:00 PM,48,-122,69,64,133
15997,FremontBridge,07/31/2014 01:00:00 PM,48,-122,66,55,121
15998,FremontBridge,07/31/2014 02:00:00 PM,48,-122,70,63,133
15999,FremontBridge,07/31/2014 03:00:00 PM,48,-122,96,84,180
16000,FremontBridge,07/31/2014 04:00:00 PM,48,-122,223,130,353
16001,FremontBridge,07/31/2014 05:00:00 PM,48,-122,466,204,670
16002,FremontBridge,07/31/2014 06:00:00 PM,48,-122,377,167,544
16003,FremontBridge,07/31/2014 07:00:00 PM,48,-122,184,105,289
16004,FremontBridge,07/31/2014 08:00:00 PM,48,-122,108,81,189
16005,FremontBridge,07/31/2014 09:00:00 PM,48,-122,51,72,123
16006,FremontBridge,07/31/2014 10:00:00 PM,48,-122,39,63,102
16007,FremontBridge,07/31/2014 11:00:00 PM,48,-122,25,15,40
16008,FremontBridge,08/01/2014 12:00:00 AM,48,-122,14,11,25
16009,FremontBridge,08/01/2014 01:00:00 AM,48,-122,5,3,8
16010,FremontBridge,08/01/2014 02:00:00 AM,48,-122,7,1,8
16011,FremontBridge,08/01/2014 03:00:00 AM,48,-122,1,2,3
16012,FremontBridge,08/01/2014 04:00:00 AM,48,-122,5,6,11
16013,FremontBridge,08/01/2014 05:00:00 AM,48,-122,17,24,41
16014,FremontBridge,08/01/2014 06:00:00 AM,48,-122,43,101,144
16015,FremontBridge,08/01/2014 07:00:00 AM,48,-122,97,241,338
16016,FremontBridge,08/01/2014 08:00:00 AM,48,-122,156,355,511
16017,FremontBridge,08/01/2014 09:00:00 AM,48,-122,114,192,306
16018,FremontBridge,08/01/2014 10:00:00 AM,48,-122,61,86,147
16019,FremontBridge,08/01/2014 11:00:00 AM,48,-122,69,69,138
16020,FremontBridge,08/01/2014 12:00:00 PM,48,-122,66,56,122
16021,FremontBridge,08/01/2014 01:00:00 PM,48,-122,73,58,131
16022,FremontBridge,08/01/2014 02:00:00 PM,48,-122,80,66,146
16023,FremontBridge,08/01/2014 03:00:00 PM,48,-122,101,89,190
16024,FremontBridge,08/01/2014 04:00:00 PM,48,-122,248,125,373
16025,FremontBridge,08/01/2014 05:00:00 PM,48,-122,336,201,537
16026,FremontBridge,08/01/2014 06:00:00 PM,48,-122,234,139,373
16027,FremontBridge,08/01/2014 07:00:00 PM,48,-122,109,93,202
16028,FremontBridge,08/01/2014 08:00:00 PM,48,-122,81,62,143
16029,FremontBridge,08/01/2014 09:00:00 PM,48,-122,50,37,87
16030,FremontBridge,08/01/2014 10:00:00 PM,48,-122,51,26,77
16031,FremontBridge,08/01/2014 11:00:00 PM,48,-122,36,9,45
16032,FremontBridge,08/02/2014 12:00:00 AM,48,-122,16,7,23
16033,FremontBridge,08/02/2014 01:00:00 AM,48,-122,41,6,47
16034,FremontBridge,08/02/2014 02:00:00 AM,48,-122,5,7,12
16035,FremontBridge,08/02/2014 03:00:00 AM,48,-122,3,3,6
16036,FremontBridge,08/02/2014 04:00:00 AM,48,-122,2,1,3
16037,FremontBridge,08/02/2014 05:00:00 AM,48,-122,7,5,12
16038,FremontBridge,08/02/2014 06:00:00 AM,48,-122,24,18,42
16039,FremontBridge,08/02/2014 07:00:00 AM,48,-122,27,44,71
16040,FremontBridge,08/02/2014 08:00:00 AM,48,-122,70,72,142
16041,FremontBridge,08/02/2014 09:00:00 AM,48,-122,57,81,138
16042,FremontBridge,08/02/2014 10:00:00 AM,48,-122,38,60,98
16043,FremontBridge,08/02/2014 11:00:00 AM,48,-122,53,76,129
16044,FremontBridge,08/02/2014 12:00:00 PM,48,-122,66,90,156
16045,FremontBridge,08/02/2014 01:00:00 PM,48,-122,66,85,151
16046,FremontBridge,08/02/2014 02:00:00 PM,48,-122,61,95,156
16047,FremontBridge,08/02/2014 03:00:00 PM,48,-122,79,87,166
16048,FremontBridge,08/02/2014 04:00:00 PM,48,-122,79,87,166
16049,FremontBridge,08/02/2014 05:00:00 PM,48,-122,52,60,112
16050,FremontBridge,08/02/2014 06:00:00 PM,48,-122,72,76,148
16051,FremontBridge,08/02/2014 07:00:00 PM,48,-122,57,63,120
16052,FremontBridge,08/02/2014 08:00:00 PM,48,-122,43,41,84
16053,FremontBridge,08/02/2014 09:00:00 PM,48,-122,15,26,41
16054,FremontBridge,08/02/2014 10:00:00 PM,48,-122,25,24,49
16055,FremontBridge,08/02/2014 11:00:00 PM,48,-122,16,22,38
16056,FremontBridge,08/03/2014 12:00:00 AM,48,-122,12,8,20
16057,FremontBridge,08/03/2014 01:00:00 AM,48,-122,6,2,8
16058,FremontBridge,08/03/2014 02:00:00 AM,48,-122,6,2,8
16059,FremontBridge,08/03/2014 03:00:00 AM,48,-122,1,3,4
16060,FremontBridge,08/03/2014 04:00:00 AM,48,-122,4,3,7
16061,FremontBridge,08/03/2014 05:00:00 AM,48,-122,5,2,7
16062,FremontBridge,08/03/2014 06:00:00 AM,48,-122,13,11,24
16063,FremontBridge,08/03/2014 07:00:00 AM,48,-122,25,28,53
16064,FremontBridge,08/03/2014 08:00:00 AM,48,-122,47,53,100
16065,FremontBridge,08/03/2014 09:00:00 AM,48,-122,66,81,147
16066,FremontBridge,08/03/2014 10:00:00 AM,48,-122,102,95,197
16067,FremontBridge,08/03/2014 11:00:00 AM,48,-122,76,121,197
16068,FremontBridge,08/03/2014 12:00:00 PM,48,-122,122,127,249
16069,FremontBridge,08/03/2014 01:00:00 PM,48,-122,84,128,212
16070,FremontBridge,08/03/2014 02:00:00 PM,48,-122,91,127,218
16071,FremontBridge,08/03/2014 03:00:00 PM,48,-122,106,117,223
16072,FremontBridge,08/03/2014 04:00:00 PM,48,-122,111,99,210
16073,FremontBridge,08/03/2014 05:00:00 PM,48,-122,92,101,193
16074,FremontBridge,08/03/2014 06:00:00 PM,48,-122,76,83,159
16075,FremontBridge,08/03/2014 07:00:00 PM,48,-122,53,47,100
16076,FremontBridge,08/03/2014 08:00:00 PM,48,-122,28,42,70
16077,FremontBridge,08/03/2014 09:00:00 PM,48,-122,30,22,52
16078,FremontBridge,08/03/2014 10:00:00 PM,48,-122,20,22,42
16079,FremontBridge,08/03/2014 11:00:00 PM,48,-122,11,6,17
16080,FremontBridge,08/04/2014 12:00:00 AM,48,-122,10,7,17
16081,FremontBridge,08/04/2014 01:00:00 AM,48,-122,5,4,9
16082,FremontBridge,08/04/2014 02:00:00 AM,48,-122,3,1,4
16083,FremontBridge,08/04/2014 03:00:00 AM,48,-122,3,3,6
16084,FremontBridge,08/04/2014 04:00:00 AM,48,-122,3,7,10
16085,FremontBridge,08/04/2014 05:00:00 AM,48,-122,24,28,52
16086,FremontBridge,08/04/2014 06:00:00 AM,48,-122,54,111,165
16087,FremontBridge,08/04/2014 07:00:00 AM,48,-122,124,315,439
16088,FremontBridge,08/04/2014 08:00:00 AM,48,-122,185,421,606
16089,FremontBridge,08/04/2014 09:00:00 AM,48,-122,122,204,326
16090,FremontBridge,08/04/2014 10:00:00 AM,48,-122,60,79,139
16091,FremontBridge,08/04/2014 11:00:00 AM,48,-122,41,47,88
16092,FremontBridge,08/04/2014 12:00:00 PM,48,-122,42,54,96
16093,FremontBridge,08/04/2014 01:00:00 PM,48,-122,46,61,107
16094,FremontBridge,08/04/2014 02:00:00 PM,48,-122,56,90,146
16095,FremontBridge,08/04/2014 03:00:00 PM,48,-122,98,80,178
16096,FremontBridge,08/04/2014 04:00:00 PM,48,-122,226,131,357
16097,FremontBridge,08/04/2014 05:00:00 PM,48,-122,539,209,748
16098,FremontBridge,08/04/2014 06:00:00 PM,48,-122,350,181,531
16099,FremontBridge,08/04/2014 07:00:00 PM,48,-122,182,121,303
16100,FremontBridge,08/04/2014 08:00:00 PM,48,-122,97,59,156
16101,FremontBridge,08/04/2014 09:00:00 PM,48,-122,50,49,99
16102,FremontBridge,08/04/2014 10:00:00 PM,48,-122,41,26,67
16103,FremontBridge,08/04/2014 11:00:00 PM,48,-122,30,11,41
16104,FremontBridge,08/05/2014 12:00:00 AM,48,-122,16,8,24
16105,FremontBridge,08/05/2014 01:00:00 AM,48,-122,3,4,7
16106,FremontBridge,08/05/2014 02:00:00 AM,48,-122,1,2,3
16107,FremontBridge,08/05/2014 03:00:00 AM,48,-122,4,2,6
16108,FremontBridge,08/05/2014 04:00:00 AM,48,-122,5,1,6
16109,FremontBridge,08/05/2014 05:00:00 AM,48,-122,17,38,55
16110,FremontBridge,08/05/2014 06:00:00 AM,48,-122,61,125,186
16111,FremontBridge,08/05/2014 07:00:00 AM,48,-122,119,344,463
16112,FremontBridge,08/05/2014 08:00:00 AM,48,-122,197,440,637
16113,FremontBridge,08/05/2014 09:00:00 AM,48,-122,129,179,308
16114,FremontBridge,08/05/2014 10:00:00 AM,48,-122,63,57,120
16115,FremontBridge,08/05/2014 11:00:00 AM,48,-122,69,69,138
16116,FremontBridge,08/05/2014 12:00:00 PM,48,-122,61,60,121
16117,FremontBridge,08/05/2014 01:00:00 PM,48,-122,59,65,124
16118,FremontBridge,08/05/2014 02:00:00 PM,48,-122,58,72,130
16119,FremontBridge,08/05/2014 03:00:00 PM,48,-122,89,81,170
16120,FremontBridge,08/05/2014 04:00:00 PM,48,-122,237,141,378
16121,FremontBridge,08/05/2014 05:00:00 PM,48,-122,533,210,743
16122,FremontBridge,08/05/2014 06:00:00 PM,48,-122,297,196,493
16123,FremontBridge,08/05/2014 07:00:00 PM,48,-122,220,112,332
16124,FremontBridge,08/05/2014 08:00:00 PM,48,-122,91,86,177
16125,FremontBridge,08/05/2014 09:00:00 PM,48,-122,45,50,95
16126,FremontBridge,08/05/2014 10:00:00 PM,48,-122,30,27,57
16127,FremontBridge,08/05/2014 11:00:00 PM,48,-122,23,23,46
16128,FremontBridge,08/06/2014 12:00:00 AM,48,-122,18,15,33
16129,FremontBridge,08/06/2014 01:00:00 AM,48,-122,7,4,11
16130,FremontBridge,08/06/2014 02:00:00 AM,48,-122,3,0,3
16131,FremontBridge,08/06/2014 03:00:00 AM,48,-122,3,2,5
16132,FremontBridge,08/06/2014 04:00:00 AM,48,-122,7,7,14
16133,FremontBridge,08/06/2014 05:00:00 AM,48,-122,17,24,41
16134,FremontBridge,08/06/2014 06:00:00 AM,48,-122,61,116,177
16135,FremontBridge,08/06/2014 07:00:00 AM,48,-122,116,302,418
16136,FremontBridge,08/06/2014 08:00:00 AM,48,-122,187,392,579
16137,FremontBridge,08/06/2014 09:00:00 AM,48,-122,116,204,320
16138,FremontBridge,08/06/2014 10:00:00 AM,48,-122,52,79,131
16139,FremontBridge,08/06/2014 11:00:00 AM,48,-122,61,64,125
16140,FremontBridge,08/06/2014 12:00:00 PM,48,-122,50,77,127
16141,FremontBridge,08/06/2014 01:00:00 PM,48,-122,77,57,134
16142,FremontBridge,08/06/2014 02:00:00 PM,48,-122,78,62,140
16143,FremontBridge,08/06/2014 03:00:00 PM,48,-122,103,85,188
16144,FremontBridge,08/06/2014 04:00:00 PM,48,-122,223,159,382
16145,FremontBridge,08/06/2014 05:00:00 PM,48,-122,499,228,727
16146,FremontBridge,08/06/2014 06:00:00 PM,48,-122,361,184,545
16147,FremontBridge,08/06/2014 07:00:00 PM,48,-122,163,132,295
16148,FremontBridge,08/06/2014 08:00:00 PM,48,-122,96,64,160
16149,FremontBridge,08/06/2014 09:00:00 PM,48,-122,54,63,117
16150,FremontBridge,08/06/2014 10:00:00 PM,48,-122,38,29,67
16151,FremontBridge,08/06/2014 11:00:00 PM,48,-122,21,18,39
16152,FremontBridge,08/07/2014 12:00:00 AM,48,-122,10,11,21
16153,FremontBridge,08/07/2014 01:00:00 AM,48,-122,1,3,4
16154,FremontBridge,08/07/2014 02:00:00 AM,48,-122,3,2,5
16155,FremontBridge,08/07/2014 03:00:00 AM,48,-122,4,2,6
16156,FremontBridge,08/07/2014 04:00:00 AM,48,-122,6,5,11
16157,FremontBridge,08/07/2014 05:00:00 AM,48,-122,16,37,53
16158,FremontBridge,08/07/2014 06:00:00 AM,48,-122,55,101,156
16159,FremontBridge,08/07/2014 07:00:00 AM,48,-122,110,305,415
16160,FremontBridge,08/07/2014 08:00:00 AM,48,-122,183,410,593
16161,FremontBridge,08/07/2014 09:00:00 AM,48,-122,124,199,323
16162,FremontBridge,08/07/2014 10:00:00 AM,48,-122,56,76,132
16163,FremontBridge,08/07/2014 11:00:00 AM,48,-122,44,30,74
16164,FremontBridge,08/07/2014 12:00:00 PM,48,-122,61,47,108
16165,FremontBridge,08/07/2014 01:00:00 PM,48,-122,56,41,97
16166,FremontBridge,08/07/2014 02:00:00 PM,48,-122,65,53,118
16167,FremontBridge,08/07/2014 03:00:00 PM,48,-122,101,93,194
16168,FremontBridge,08/07/2014 04:00:00 PM,48,-122,213,124,337
16169,FremontBridge,08/07/2014 05:00:00 PM,48,-122,472,225,697
16170,FremontBridge,08/07/2014 06:00:00 PM,48,-122,320,219,539
16171,FremontBridge,08/07/2014 07:00:00 PM,48,-122,167,108,275
16172,FremontBridge,08/07/2014 08:00:00 PM,48,-122,95,88,183
16173,FremontBridge,08/07/2014 09:00:00 PM,48,-122,63,37,100
16174,FremontBridge,08/07/2014 10:00:00 PM,48,-122,32,31,63
16175,FremontBridge,08/07/2014 11:00:00 PM,48,-122,35,14,49
16176,FremontBridge,08/08/2014 12:00:00 AM,48,-122,16,9,25
16177,FremontBridge,08/08/2014 01:00:00 AM,48,-122,6,5,11
16178,FremontBridge,08/08/2014 02:00:00 AM,48,-122,1,3,4
16179,FremontBridge,08/08/2014 03:00:00 AM,48,-122,6,0,6
16180,FremontBridge,08/08/2014 04:00:00 AM,48,-122,5,3,8
16181,FremontBridge,08/08/2014 05:00:00 AM,48,-122,16,27,43
16182,FremontBridge,08/08/2014 06:00:00 AM,48,-122,52,85,137
16183,FremontBridge,08/08/2014 07:00:00 AM,48,-122,102,193,295
16184,FremontBridge,08/08/2014 08:00:00 AM,48,-122,145,255,400
16185,FremontBridge,08/08/2014 09:00:00 AM,48,-122,105,154,259
16186,FremontBridge,08/08/2014 10:00:00 AM,48,-122,63,44,107
16187,FremontBridge,08/08/2014 11:00:00 AM,48,-122,63,43,106
16188,FremontBridge,08/08/2014 12:00:00 PM,48,-122,64,69,133
16189,FremontBridge,08/08/2014 01:00:00 PM,48,-122,75,84,159
16190,FremontBridge,08/08/2014 02:00:00 PM,48,-122,95,61,156
16191,FremontBridge,08/08/2014 03:00:00 PM,48,-122,101,100,201
16192,FremontBridge,08/08/2014 04:00:00 PM,48,-122,210,148,358
16193,FremontBridge,08/08/2014 05:00:00 PM,48,-122,397,189,586
16194,FremontBridge,08/08/2014 06:00:00 PM,48,-122,232,174,406
16195,FremontBridge,08/08/2014 07:00:00 PM,48,-122,109,100,209
16196,FremontBridge,08/08/2014 08:00:00 PM,48,-122,66,67,133
16197,FremontBridge,08/08/2014 09:00:00 PM,48,-122,45,48,93
16198,FremontBridge,08/08/2014 10:00:00 PM,48,-122,46,21,67
16199,FremontBridge,08/08/2014 11:00:00 PM,48,-122,35,19,54
16200,FremontBridge,08/09/2014 12:00:00 AM,48,-122,19,6,25
16201,FremontBridge,08/09/2014 01:00:00 AM,48,-122,8,10,18
16202,FremontBridge,08/09/2014 02:00:00 AM,48,-122,8,2,10
16203,FremontBridge,08/09/2014 03:00:00 AM,48,-122,1,5,6
16204,FremontBridge,08/09/2014 04:00:00 AM,48,-122,4,0,4
16205,FremontBridge,08/09/2014 05:00:00 AM,48,-122,6,5,11
16206,FremontBridge,08/09/2014 06:00:00 AM,48,-122,14,15,29
16207,FremontBridge,08/09/2014 07:00:00 AM,48,-122,28,29,57
16208,FremontBridge,08/09/2014 08:00:00 AM,48,-122,52,71,123
16209,FremontBridge,08/09/2014 09:00:00 AM,48,-122,60,114,174
16210,FremontBridge,08/09/2014 10:00:00 AM,48,-122,69,97,166
16211,FremontBridge,08/09/2014 11:00:00 AM,48,-122,79,101,180
16212,FremontBridge,08/09/2014 12:00:00 PM,48,-122,98,97,195
16213,FremontBridge,08/09/2014 01:00:00 PM,48,-122,103,111,214
16214,FremontBridge,08/09/2014 02:00:00 PM,48,-122,108,102,210
16215,FremontBridge,08/09/2014 03:00:00 PM,48,-122,85,114,199
16216,FremontBridge,08/09/2014 04:00:00 PM,48,-122,92,93,185
16217,FremontBridge,08/09/2014 05:00:00 PM,48,-122,59,80,139
16218,FremontBridge,08/09/2014 06:00:00 PM,48,-122,72,83,155
16219,FremontBridge,08/09/2014 07:00:00 PM,48,-122,71,46,117
16220,FremontBridge,08/09/2014 08:00:00 PM,48,-122,43,43,86
16221,FremontBridge,08/09/2014 09:00:00 PM,48,-122,21,33,54
16222,FremontBridge,08/09/2014 10:00:00 PM,48,-122,25,18,43
16223,FremontBridge,08/09/2014 11:00:00 PM,48,-122,15,14,29
16224,FremontBridge,08/10/2014 12:00:00 AM,48,-122,18,7,25
16225,FremontBridge,08/10/2014 01:00:00 AM,48,-122,8,10,18
16226,FremontBridge,08/10/2014 02:00:00 AM,48,-122,5,1,6
16227,FremontBridge,08/10/2014 03:00:00 AM,48,-122,1,5,6
16228,FremontBridge,08/10/2014 04:00:00 AM,48,-122,3,2,5
16229,FremontBridge,08/10/2014 05:00:00 AM,48,-122,4,2,6
16230,FremontBridge,08/10/2014 06:00:00 AM,48,-122,15,16,31
16231,FremontBridge,08/10/2014 07:00:00 AM,48,-122,27,40,67
16232,FremontBridge,08/10/2014 08:00:00 AM,48,-122,59,50,109
16233,FremontBridge,08/10/2014 09:00:00 AM,48,-122,75,64,139
16234,FremontBridge,08/10/2014 10:00:00 AM,48,-122,72,102,174
16235,FremontBridge,08/10/2014 11:00:00 AM,48,-122,72,103,175
16236,FremontBridge,08/10/2014 12:00:00 PM,48,-122,84,100,184
16237,FremontBridge,08/10/2014 01:00:00 PM,48,-122,98,134,232
16238,FremontBridge,08/10/2014 02:00:00 PM,48,-122,92,123,215
16239,FremontBridge,08/10/2014 03:00:00 PM,48,-122,101,107,208
16240,FremontBridge,08/10/2014 04:00:00 PM,48,-122,95,99,194
16241,FremontBridge,08/10/2014 05:00:00 PM,48,-122,78,76,154
16242,FremontBridge,08/10/2014 06:00:00 PM,48,-122,59,90,149
16243,FremontBridge,08/10/2014 07:00:00 PM,48,-122,85,67,152
16244,FremontBridge,08/10/2014 08:00:00 PM,48,-122,42,93,135
16245,FremontBridge,08/10/2014 09:00:00 PM,48,-122,34,47,81
16246,FremontBridge,08/10/2014 10:00:00 PM,48,-122,30,25,55
16247,FremontBridge,08/10/2014 11:00:00 PM,48,-122,13,17,30
16248,FremontBridge,08/11/2014 12:00:00 AM,48,-122,9,5,14
16249,FremontBridge,08/11/2014 01:00:00 AM,48,-122,8,8,16
16250,FremontBridge,08/11/2014 02:00:00 AM,48,-122,0,1,1
16251,FremontBridge,08/11/2014 03:00:00 AM,48,-122,4,2,6
16252,FremontBridge,08/11/2014 04:00:00 AM,48,-122,4,5,9
16253,FremontBridge,08/11/2014 05:00:00 AM,48,-122,19,33,52
16254,FremontBridge,08/11/2014 06:00:00 AM,48,-122,53,107,160
16255,FremontBridge,08/11/2014 07:00:00 AM,48,-122,103,312,415
16256,FremontBridge,08/11/2014 08:00:00 AM,48,-122,188,414,602
16257,FremontBridge,08/11/2014 09:00:00 AM,48,-122,97,179,276
16258,FremontBridge,08/11/2014 10:00:00 AM,48,-122,59,80,139
16259,FremontBridge,08/11/2014 11:00:00 AM,48,-122,45,59,104
16260,FremontBridge,08/11/2014 12:00:00 PM,48,-122,53,50,103
16261,FremontBridge,08/11/2014 01:00:00 PM,48,-122,57,49,106
16262,FremontBridge,08/11/2014 02:00:00 PM,48,-122,61,66,127
16263,FremontBridge,08/11/2014 03:00:00 PM,48,-122,108,57,165
16264,FremontBridge,08/11/2014 04:00:00 PM,48,-122,213,99,312
16265,FremontBridge,08/11/2014 05:00:00 PM,48,-122,463,158,621
16266,FremontBridge,08/11/2014 06:00:00 PM,48,-122,320,190,510
16267,FremontBridge,08/11/2014 07:00:00 PM,48,-122,133,100,233
16268,FremontBridge,08/11/2014 08:00:00 PM,48,-122,127,73,200
16269,FremontBridge,08/11/2014 09:00:00 PM,48,-122,36,32,68
16270,FremontBridge,08/11/2014 10:00:00 PM,48,-122,37,14,51
16271,FremontBridge,08/11/2014 11:00:00 PM,48,-122,18,17,35
16272,FremontBridge,08/12/2014 12:00:00 AM,48,-122,8,5,13
16273,FremontBridge,08/12/2014 01:00:00 AM,48,-122,2,2,4
16274,FremontBridge,08/12/2014 02:00:00 AM,48,-122,2,5,7
16275,FremontBridge,08/12/2014 03:00:00 AM,48,-122,3,1,4
16276,FremontBridge,08/12/2014 04:00:00 AM,48,-122,4,6,10
16277,FremontBridge,08/12/2014 05:00:00 AM,48,-122,9,30,39
16278,FremontBridge,08/12/2014 06:00:00 AM,48,-122,49,105,154
16279,FremontBridge,08/12/2014 07:00:00 AM,48,-122,98,316,414
16280,FremontBridge,08/12/2014 08:00:00 AM,48,-122,153,327,480
16281,FremontBridge,08/12/2014 09:00:00 AM,48,-122,107,150,257
16282,FremontBridge,08/12/2014 10:00:00 AM,48,-122,41,51,92
16283,FremontBridge,08/12/2014 11:00:00 AM,48,-122,34,46,80
16284,FremontBridge,08/12/2014 12:00:00 PM,48,-122,30,33,63
16285,FremontBridge,08/12/2014 01:00:00 PM,48,-122,41,48,89
16286,FremontBridge,08/12/2014 02:00:00 PM,48,-122,49,46,95
16287,FremontBridge,08/12/2014 03:00:00 PM,48,-122,70,64,134
16288,FremontBridge,08/12/2014 04:00:00 PM,48,-122,211,111,322
16289,FremontBridge,08/12/2014 05:00:00 PM,48,-122,394,186,580
16290,FremontBridge,08/12/2014 06:00:00 PM,48,-122,301,159,460
16291,FremontBridge,08/12/2014 07:00:00 PM,48,-122,132,97,229
16292,FremontBridge,08/12/2014 08:00:00 PM,48,-122,69,47,116
16293,FremontBridge,08/12/2014 09:00:00 PM,48,-122,32,25,57
16294,FremontBridge,08/12/2014 10:00:00 PM,48,-122,25,15,40
16295,FremontBridge,08/12/2014 11:00:00 PM,48,-122,14,14,28
16296,FremontBridge,08/13/2014 12:00:00 AM,48,-122,8,6,14
16297,FremontBridge,08/13/2014 01:00:00 AM,48,-122,3,2,5
16298,FremontBridge,08/13/2014 02:00:00 AM,48,-122,1,0,1
16299,FremontBridge,08/13/2014 03:00:00 AM,48,-122,3,5,8
16300,FremontBridge,08/13/2014 04:00:00 AM,48,-122,1,0,1
16301,FremontBridge,08/13/2014 05:00:00 AM,48,-122,5,21,26
16302,FremontBridge,08/13/2014 06:00:00 AM,48,-122,38,65,103
16303,FremontBridge,08/13/2014 07:00:00 AM,48,-122,85,192,277
16304,FremontBridge,08/13/2014 08:00:00 AM,48,-122,135,299,434
16305,FremontBridge,08/13/2014 09:00:00 AM,48,-122,90,135,225
16306,FremontBridge,08/13/2014 10:00:00 AM,48,-122,47,52,99
16307,FremontBridge,08/13/2014 11:00:00 AM,48,-122,27,48,75
16308,FremontBridge,08/13/2014 12:00:00 PM,48,-122,30,41,71
16309,FremontBridge,08/13/2014 01:00:00 PM,48,-122,33,49,82
16310,FremontBridge,08/13/2014 02:00:00 PM,48,-122,46,39,85
16311,FremontBridge,08/13/2014 03:00:00 PM,48,-122,73,60,133
16312,FremontBridge,08/13/2014 04:00:00 PM,48,-122,155,103,258
16313,FremontBridge,08/13/2014 05:00:00 PM,48,-122,352,147,499
16314,FremontBridge,08/13/2014 06:00:00 PM,48,-122,277,153,430
16315,FremontBridge,08/13/2014 07:00:00 PM,48,-122,114,76,190
16316,FremontBridge,08/13/2014 08:00:00 PM,48,-122,77,52,129
16317,FremontBridge,08/13/2014 09:00:00 PM,48,-122,36,33,69
16318,FremontBridge,08/13/2014 10:00:00 PM,48,-122,26,30,56
16319,FremontBridge,08/13/2014 11:00:00 PM,48,-122,11,5,16
16320,FremontBridge,08/14/2014 12:00:00 AM,48,-122,8,7,15
16321,FremontBridge,08/14/2014 01:00:00 AM,48,-122,6,3,9
16322,FremontBridge,08/14/2014 02:00:00 AM,48,-122,3,3,6
16323,FremontBridge,08/14/2014 03:00:00 AM,48,-122,3,1,4
16324,FremontBridge,08/14/2014 04:00:00 AM,48,-122,2,6,8
16325,FremontBridge,08/14/2014 05:00:00 AM,48,-122,13,23,36
16326,FremontBridge,08/14/2014 06:00:00 AM,48,-122,53,105,158
16327,FremontBridge,08/14/2014 07:00:00 AM,48,-122,108,273,381
16328,FremontBridge,08/14/2014 08:00:00 AM,48,-122,157,359,516
16329,FremontBridge,08/14/2014 09:00:00 AM,48,-122,114,196,310
16330,FremontBridge,08/14/2014 10:00:00 AM,48,-122,60,67,127
16331,FremontBridge,08/14/2014 11:00:00 AM,48,-122,37,45,82
16332,FremontBridge,08/14/2014 12:00:00 PM,48,-122,64,56,120
16333,FremontBridge,08/14/2014 01:00:00 PM,48,-122,57,56,113
16334,FremontBridge,08/14/2014 02:00:00 PM,48,-122,60,54,114
16335,FremontBridge,08/14/2014 03:00:00 PM,48,-122,84,65,149
16336,FremontBridge,08/14/2014 04:00:00 PM,48,-122,152,99,251
16337,FremontBridge,08/14/2014 05:00:00 PM,48,-122,420,177,597
16338,FremontBridge,08/14/2014 06:00:00 PM,48,-122,303,176,479
16339,FremontBridge,08/14/2014 07:00:00 PM,48,-122,140,89,229
16340,FremontBridge,08/14/2014 08:00:00 PM,48,-122,82,64,146
16341,FremontBridge,08/14/2014 09:00:00 PM,48,-122,48,36,84
16342,FremontBridge,08/14/2014 10:00:00 PM,48,-122,31,33,64
16343,FremontBridge,08/14/2014 11:00:00 PM,48,-122,15,16,31
16344,FremontBridge,08/15/2014 12:00:00 AM,48,-122,12,4,16
16345,FremontBridge,08/15/2014 01:00:00 AM,48,-122,7,4,11
16346,FremontBridge,08/15/2014 02:00:00 AM,48,-122,4,2,6
16347,FremontBridge,08/15/2014 03:00:00 AM,48,-122,3,0,3
16348,FremontBridge,08/15/2014 04:00:00 AM,48,-122,8,5,13
16349,FremontBridge,08/15/2014 05:00:00 AM,48,-122,21,31,52
16350,FremontBridge,08/15/2014 06:00:00 AM,48,-122,54,87,141
16351,FremontBridge,08/15/2014 07:00:00 AM,48,-122,88,202,290
16352,FremontBridge,08/15/2014 08:00:00 AM,48,-122,118,254,372
16353,FremontBridge,08/15/2014 09:00:00 AM,48,-122,78,105,183
16354,FremontBridge,08/15/2014 10:00:00 AM,48,-122,36,53,89
16355,FremontBridge,08/15/2014 11:00:00 AM,48,-122,25,45,70
16356,FremontBridge,08/15/2014 12:00:00 PM,48,-122,47,40,87
16357,FremontBridge,08/15/2014 01:00:00 PM,48,-122,52,41,93
16358,FremontBridge,08/15/2014 02:00:00 PM,48,-122,52,50,102
16359,FremontBridge,08/15/2014 03:00:00 PM,48,-122,95,71,166
16360,FremontBridge,08/15/2014 04:00:00 PM,48,-122,183,93,276
16361,FremontBridge,08/15/2014 05:00:00 PM,48,-122,326,154,480
16362,FremontBridge,08/15/2014 06:00:00 PM,48,-122,209,109,318
16363,FremontBridge,08/15/2014 07:00:00 PM,48,-122,80,58,138
16364,FremontBridge,08/15/2014 08:00:00 PM,48,-122,56,30,86
16365,FremontBridge,08/15/2014 09:00:00 PM,48,-122,32,17,49
16366,FremontBridge,08/15/2014 10:00:00 PM,48,-122,20,23,43
16367,FremontBridge,08/15/2014 11:00:00 PM,48,-122,26,12,38
16368,FremontBridge,08/16/2014 12:00:00 AM,48,-122,10,10,20
16369,FremontBridge,08/16/2014 01:00:00 AM,48,-122,7,3,10
16370,FremontBridge,08/16/2014 02:00:00 AM,48,-122,6,8,14
16371,FremontBridge,08/16/2014 03:00:00 AM,48,-122,2,9,11
16372,FremontBridge,08/16/2014 04:00:00 AM,48,-122,4,1,5
16373,FremontBridge,08/16/2014 05:00:00 AM,48,-122,7,6,13
16374,FremontBridge,08/16/2014 06:00:00 AM,48,-122,27,14,41
16375,FremontBridge,08/16/2014 07:00:00 AM,48,-122,31,30,61
16376,FremontBridge,08/16/2014 08:00:00 AM,48,-122,51,45,96
16377,FremontBridge,08/16/2014 09:00:00 AM,48,-122,66,82,148
16378,FremontBridge,08/16/2014 10:00:00 AM,48,-122,60,90,150
16379,FremontBridge,08/16/2014 11:00:00 AM,48,-122,96,94,190
16380,FremontBridge,08/16/2014 12:00:00 PM,48,-122,72,100,172
16381,FremontBridge,08/16/2014 01:00:00 PM,48,-122,84,113,197
16382,FremontBridge,08/16/2014 02:00:00 PM,48,-122,98,112,210
16383,FremontBridge,08/16/2014 03:00:00 PM,48,-122,98,123,221
16384,FremontBridge,08/16/2014 04:00:00 PM,48,-122,93,113,206
16385,FremontBridge,08/16/2014 05:00:00 PM,48,-122,95,77,172
16386,FremontBridge,08/16/2014 06:00:00 PM,48,-122,96,58,154
16387,FremontBridge,08/16/2014 07:00:00 PM,48,-122,66,52,118
16388,FremontBridge,08/16/2014 08:00:00 PM,48,-122,43,39,82
16389,FremontBridge,08/16/2014 09:00:00 PM,48,-122,24,12,36
16390,FremontBridge,08/16/2014 10:00:00 PM,48,-122,21,18,39
16391,FremontBridge,08/16/2014 11:00:00 PM,48,-122,9,9,18
16392,FremontBridge,08/17/2014 12:00:00 AM,48,-122,19,8,27
16393,FremontBridge,08/17/2014 01:00:00 AM,48,-122,9,3,12
16394,FremontBridge,08/17/2014 02:00:00 AM,48,-122,7,1,8
16395,FremontBridge,08/17/2014 03:00:00 AM,48,-122,1,3,4
16396,FremontBridge,08/17/2014 04:00:00 AM,48,-122,6,1,7
16397,FremontBridge,08/17/2014 05:00:00 AM,48,-122,3,4,7
16398,FremontBridge,08/17/2014 06:00:00 AM,48,-122,6,12,18
16399,FremontBridge,08/17/2014 07:00:00 AM,48,-122,26,20,46
16400,FremontBridge,08/17/2014 08:00:00 AM,48,-122,40,37,77
16401,FremontBridge,08/17/2014 09:00:00 AM,48,-122,64,49,113
16402,FremontBridge,08/17/2014 10:00:00 AM,48,-122,52,74,126
16403,FremontBridge,08/17/2014 11:00:00 AM,48,-122,85,111,196
16404,FremontBridge,08/17/2014 12:00:00 PM,48,-122,106,123,229
16405,FremontBridge,08/17/2014 01:00:00 PM,48,-122,87,129,216
16406,FremontBridge,08/17/2014 02:00:00 PM,48,-122,123,131,254
16407,FremontBridge,08/17/2014 03:00:00 PM,48,-122,93,143,236
16408,FremontBridge,08/17/2014 04:00:00 PM,48,-122,120,97,217
16409,FremontBridge,08/17/2014 05:00:00 PM,48,-122,91,116,207
16410,FremontBridge,08/17/2014 06:00:00 PM,48,-122,57,82,139
16411,FremontBridge,08/17/2014 07:00:00 PM,48,-122,57,42,99
16412,FremontBridge,08/17/2014 08:00:00 PM,48,-122,46,61,107
16413,FremontBridge,08/17/2014 09:00:00 PM,48,-122,29,20,49
16414,FremontBridge,08/17/2014 10:00:00 PM,48,-122,14,12,26
16415,FremontBridge,08/17/2014 11:00:00 PM,48,-122,12,14,26
16416,FremontBridge,08/18/2014 12:00:00 AM,48,-122,9,3,12
16417,FremontBridge,08/18/2014 01:00:00 AM,48,-122,1,4,5
16418,FremontBridge,08/18/2014 02:00:00 AM,48,-122,4,0,4
16419,FremontBridge,08/18/2014 03:00:00 AM,48,-122,3,2,5
16420,FremontBridge,08/18/2014 04:00:00 AM,48,-122,2,7,9
16421,FremontBridge,08/18/2014 05:00:00 AM,48,-122,15,25,40
16422,FremontBridge,08/18/2014 06:00:00 AM,48,-122,57,113,170
16423,FremontBridge,08/18/2014 07:00:00 AM,48,-122,130,331,461
16424,FremontBridge,08/18/2014 08:00:00 AM,48,-122,180,407,587
16425,FremontBridge,08/18/2014 09:00:00 AM,48,-122,248,201,449
16426,FremontBridge,08/18/2014 10:00:00 AM,48,-122,53,75,128
16427,FremontBridge,08/18/2014 11:00:00 AM,48,-122,59,46,105
16428,FremontBridge,08/18/2014 12:00:00 PM,48,-122,37,63,100
16429,FremontBridge,08/18/2014 01:00:00 PM,48,-122,76,60,136
16430,FremontBridge,08/18/2014 02:00:00 PM,48,-122,79,68,147
16431,FremontBridge,08/18/2014 03:00:00 PM,48,-122,92,80,172
16432,FremontBridge,08/18/2014 04:00:00 PM,48,-122,191,115,306
16433,FremontBridge,08/18/2014 05:00:00 PM,48,-122,515,201,716
16434,FremontBridge,08/18/2014 06:00:00 PM,48,-122,343,193,536
16435,FremontBridge,08/18/2014 07:00:00 PM,48,-122,160,97,257
16436,FremontBridge,08/18/2014 08:00:00 PM,48,-122,86,64,150
16437,FremontBridge,08/18/2014 09:00:00 PM,48,-122,39,32,71
16438,FremontBridge,08/18/2014 10:00:00 PM,48,-122,28,18,46
16439,FremontBridge,08/18/2014 11:00:00 PM,48,-122,15,9,24
16440,FremontBridge,08/19/2014 12:00:00 AM,48,-122,13,13,26
16441,FremontBridge,08/19/2014 01:00:00 AM,48,-122,3,4,7
16442,FremontBridge,08/19/2014 02:00:00 AM,48,-122,2,2,4
16443,FremontBridge,08/19/2014 03:00:00 AM,48,-122,3,4,7
16444,FremontBridge,08/19/2014 04:00:00 AM,48,-122,3,5,8
16445,FremontBridge,08/19/2014 05:00:00 AM,48,-122,12,32,44
16446,FremontBridge,08/19/2014 06:00:00 AM,48,-122,62,185,247
16447,FremontBridge,08/19/2014 07:00:00 AM,48,-122,131,341,472
16448,FremontBridge,08/19/2014 08:00:00 AM,48,-122,200,412,612
16449,FremontBridge,08/19/2014 09:00:00 AM,48,-122,143,200,343
16450,FremontBridge,08/19/2014 10:00:00 AM,48,-122,70,80,150
16451,FremontBridge,08/19/2014 11:00:00 AM,48,-122,61,82,143
16452,FremontBridge,08/19/2014 12:00:00 PM,48,-122,68,60,128
16453,FremontBridge,08/19/2014 01:00:00 PM,48,-122,62,62,124
16454,FremontBridge,08/19/2014 02:00:00 PM,48,-122,72,50,122
16455,FremontBridge,08/19/2014 03:00:00 PM,48,-122,107,87,194
16456,FremontBridge,08/19/2014 04:00:00 PM,48,-122,225,132,357
16457,FremontBridge,08/19/2014 05:00:00 PM,48,-122,520,229,749
16458,FremontBridge,08/19/2014 06:00:00 PM,48,-122,365,200,565
16459,FremontBridge,08/19/2014 07:00:00 PM,48,-122,172,122,294
16460,FremontBridge,08/19/2014 08:00:00 PM,48,-122,98,52,150
16461,FremontBridge,08/19/2014 09:00:00 PM,48,-122,55,47,102
16462,FremontBridge,08/19/2014 10:00:00 PM,48,-122,28,23,51
16463,FremontBridge,08/19/2014 11:00:00 PM,48,-122,24,11,35
16464,FremontBridge,08/20/2014 12:00:00 AM,48,-122,6,11,17
16465,FremontBridge,08/20/2014 01:00:00 AM,48,-122,8,3,11
16466,FremontBridge,08/20/2014 02:00:00 AM,48,-122,2,4,6
16467,FremontBridge,08/20/2014 03:00:00 AM,48,-122,3,2,5
16468,FremontBridge,08/20/2014 04:00:00 AM,48,-122,4,6,10
16469,FremontBridge,08/20/2014 05:00:00 AM,48,-122,12,27,39
16470,FremontBridge,08/20/2014 06:00:00 AM,48,-122,59,111,170
16471,FremontBridge,08/20/2014 07:00:00 AM,48,-122,134,329,463
16472,FremontBridge,08/20/2014 08:00:00 AM,48,-122,162,350,512
16473,FremontBridge,08/20/2014 09:00:00 AM,48,-122,134,177,311
16474,FremontBridge,08/20/2014 10:00:00 AM,48,-122,55,60,115
16475,FremontBridge,08/20/2014 11:00:00 AM,48,-122,39,63,102
16476,FremontBridge,08/20/2014 12:00:00 PM,48,-122,50,44,94
16477,FremontBridge,08/20/2014 01:00:00 PM,48,-122,48,42,90
16478,FremontBridge,08/20/2014 02:00:00 PM,48,-122,61,57,118
16479,FremontBridge,08/20/2014 03:00:00 PM,48,-122,102,80,182
16480,FremontBridge,08/20/2014 04:00:00 PM,48,-122,220,134,354
16481,FremontBridge,08/20/2014 05:00:00 PM,48,-122,456,190,646
16482,FremontBridge,08/20/2014 06:00:00 PM,48,-122,200,120,320
16483,FremontBridge,08/20/2014 07:00:00 PM,48,-122,135,106,241
16484,FremontBridge,08/20/2014 08:00:00 PM,48,-122,101,63,164
16485,FremontBridge,08/20/2014 09:00:00 PM,48,-122,77,48,125
16486,FremontBridge,08/20/2014 10:00:00 PM,48,-122,44,22,66
16487,FremontBridge,08/20/2014 11:00:00 PM,48,-122,16,12,28
16488,FremontBridge,08/21/2014 12:00:00 AM,48,-122,5,5,10
16489,FremontBridge,08/21/2014 01:00:00 AM,48,-122,0,2,2
16490,FremontBridge,08/21/2014 02:00:00 AM,48,-122,2,6,8
16491,FremontBridge,08/21/2014 03:00:00 AM,48,-122,2,3,5
16492,FremontBridge,08/21/2014 04:00:00 AM,48,-122,4,8,12
16493,FremontBridge,08/21/2014 05:00:00 AM,48,-122,12,18,30
16494,FremontBridge,08/21/2014 06:00:00 AM,48,-122,50,102,152
16495,FremontBridge,08/21/2014 07:00:00 AM,48,-122,115,303,418
16496,FremontBridge,08/21/2014 08:00:00 AM,48,-122,170,359,529
16497,FremontBridge,08/21/2014 09:00:00 AM,48,-122,116,177,293
16498,FremontBridge,08/21/2014 10:00:00 AM,48,-122,60,77,137
16499,FremontBridge,08/21/2014 11:00:00 AM,48,-122,45,52,97
16500,FremontBridge,08/21/2014 12:00:00 PM,48,-122,32,49,81
16501,FremontBridge,08/21/2014 01:00:00 PM,48,-122,62,49,111
16502,FremontBridge,08/21/2014 02:00:00 PM,48,-122,74,61,135
16503,FremontBridge,08/21/2014 03:00:00 PM,48,-122,108,74,182
16504,FremontBridge,08/21/2014 04:00:00 PM,48,-122,191,119,310
16505,FremontBridge,08/21/2014 05:00:00 PM,48,-122,420,197,617
16506,FremontBridge,08/21/2014 06:00:00 PM,48,-122,337,223,560
16507,FremontBridge,08/21/2014 07:00:00 PM,48,-122,155,131,286
16508,FremontBridge,08/21/2014 08:00:00 PM,48,-122,99,85,184
16509,FremontBridge,08/21/2014 09:00:00 PM,48,-122,46,32,78
16510,FremontBridge,08/21/2014 10:00:00 PM,48,-122,27,28,55
16511,FremontBridge,08/21/2014 11:00:00 PM,48,-122,16,16,32
16512,FremontBridge,08/22/2014 12:00:00 AM,48,-122,8,7,15
16513,FremontBridge,08/22/2014 01:00:00 AM,48,-122,3,4,7
16514,FremontBridge,08/22/2014 02:00:00 AM,48,-122,11,2,13
16515,FremontBridge,08/22/2014 03:00:00 AM,48,-122,3,0,3
16516,FremontBridge,08/22/2014 04:00:00 AM,48,-122,2,8,10
16517,FremontBridge,08/22/2014 05:00:00 AM,48,-122,15,18,33
16518,FremontBridge,08/22/2014 06:00:00 AM,48,-122,41,91,132
16519,FremontBridge,08/22/2014 07:00:00 AM,48,-122,99,256,355
16520,FremontBridge,08/22/2014 08:00:00 AM,48,-122,155,308,463
16521,FremontBridge,08/22/2014 09:00:00 AM,48,-122,133,168,301
16522,FremontBridge,08/22/2014 10:00:00 AM,48,-122,58,71,129
16523,FremontBridge,08/22/2014 11:00:00 AM,48,-122,51,50,101
16524,FremontBridge,08/22/2014 12:00:00 PM,48,-122,63,70,133
16525,FremontBridge,08/22/2014 01:00:00 PM,48,-122,77,67,144
16526,FremontBridge,08/22/2014 02:00:00 PM,48,-122,71,67,138
16527,FremontBridge,08/22/2014 03:00:00 PM,48,-122,92,93,185
16528,FremontBridge,08/22/2014 04:00:00 PM,48,-122,220,117,337
16529,FremontBridge,08/22/2014 05:00:00 PM,48,-122,363,171,534
16530,FremontBridge,08/22/2014 06:00:00 PM,48,-122,240,140,380
16531,FremontBridge,08/22/2014 07:00:00 PM,48,-122,94,70,164
16532,FremontBridge,08/22/2014 08:00:00 PM,48,-122,73,32,105
16533,FremontBridge,08/22/2014 09:00:00 PM,48,-122,34,23,57
16534,FremontBridge,08/22/2014 10:00:00 PM,48,-122,37,27,64
16535,FremontBridge,08/22/2014 11:00:00 PM,48,-122,19,13,32
16536,FremontBridge,08/23/2014 12:00:00 AM,48,-122,22,9,31
16537,FremontBridge,08/23/2014 01:00:00 AM,48,-122,13,8,21
16538,FremontBridge,08/23/2014 02:00:00 AM,48,-122,4,9,13
16539,FremontBridge,08/23/2014 03:00:00 AM,48,-122,2,1,3
16540,FremontBridge,08/23/2014 04:00:00 AM,48,-122,2,2,4
16541,FremontBridge,08/23/2014 05:00:00 AM,48,-122,7,8,15
16542,FremontBridge,08/23/2014 06:00:00 AM,48,-122,13,13,26
16543,FremontBridge,08/23/2014 07:00:00 AM,48,-122,25,36,61
16544,FremontBridge,08/23/2014 08:00:00 AM,48,-122,44,63,107
16545,FremontBridge,08/23/2014 09:00:00 AM,48,-122,53,79,132
16546,FremontBridge,08/23/2014 10:00:00 AM,48,-122,61,178,239
16547,FremontBridge,08/23/2014 11:00:00 AM,48,-122,66,77,143
16548,FremontBridge,08/23/2014 12:00:00 PM,48,-122,78,123,201
16549,FremontBridge,08/23/2014 01:00:00 PM,48,-122,111,86,197
16550,FremontBridge,08/23/2014 02:00:00 PM,48,-122,101,84,185
16551,FremontBridge,08/23/2014 03:00:00 PM,48,-122,108,94,202
16552,FremontBridge,08/23/2014 04:00:00 PM,48,-122,111,109,220
16553,FremontBridge,08/23/2014 05:00:00 PM,48,-122,63,103,166
16554,FremontBridge,08/23/2014 06:00:00 PM,48,-122,90,83,173
16555,FremontBridge,08/23/2014 07:00:00 PM,48,-122,50,57,107
16556,FremontBridge,08/23/2014 08:00:00 PM,48,-122,40,36,76
16557,FremontBridge,08/23/2014 09:00:00 PM,48,-122,36,20,56
16558,FremontBridge,08/23/2014 10:00:00 PM,48,-122,10,10,20
16559,FremontBridge,08/23/2014 11:00:00 PM,48,-122,17,15,32
16560,FremontBridge,08/24/2014 12:00:00 AM,48,-122,14,4,18
16561,FremontBridge,08/24/2014 01:00:00 AM,48,-122,10,10,20
16562,FremontBridge,08/24/2014 02:00:00 AM,48,-122,2,8,10
16563,FremontBridge,08/24/2014 03:00:00 AM,48,-122,2,6,8
16564,FremontBridge,08/24/2014 04:00:00 AM,48,-122,1,4,5
16565,FremontBridge,08/24/2014 05:00:00 AM,48,-122,4,10,14
16566,FremontBridge,08/24/2014 06:00:00 AM,48,-122,12,9,21
16567,FremontBridge,08/24/2014 07:00:00 AM,48,-122,18,24,42
16568,FremontBridge,08/24/2014 08:00:00 AM,48,-122,37,47,84
16569,FremontBridge,08/24/2014 09:00:00 AM,48,-122,48,61,109
16570,FremontBridge,08/24/2014 10:00:00 AM,48,-122,86,104,190
16571,FremontBridge,08/24/2014 11:00:00 AM,48,-122,78,110,188
16572,FremontBridge,08/24/2014 12:00:00 PM,48,-122,100,92,192
16573,FremontBridge,08/24/2014 01:00:00 PM,48,-122,96,115,211
16574,FremontBridge,08/24/2014 02:00:00 PM,48,-122,92,105,197
16575,FremontBridge,08/24/2014 03:00:00 PM,48,-122,93,103,196
16576,FremontBridge,08/24/2014 04:00:00 PM,48,-122,123,129,252
16577,FremontBridge,08/24/2014 05:00:00 PM,48,-122,88,88,176
16578,FremontBridge,08/24/2014 06:00:00 PM,48,-122,88,89,177
16579,FremontBridge,08/24/2014 07:00:00 PM,48,-122,57,71,128
16580,FremontBridge,08/24/2014 08:00:00 PM,48,-122,39,38,77
16581,FremontBridge,08/24/2014 09:00:00 PM,48,-122,19,34,53
16582,FremontBridge,08/24/2014 10:00:00 PM,48,-122,23,14,37
16583,FremontBridge,08/24/2014 11:00:00 PM,48,-122,8,6,14
16584,FremontBridge,08/25/2014 12:00:00 AM,48,-122,6,3,9
16585,FremontBridge,08/25/2014 01:00:00 AM,48,-122,5,2,7
16586,FremontBridge,08/25/2014 02:00:00 AM,48,-122,5,1,6
16587,FremontBridge,08/25/2014 03:00:00 AM,48,-122,2,2,4
16588,FremontBridge,08/25/2014 04:00:00 AM,48,-122,2,5,7
16589,FremontBridge,08/25/2014 05:00:00 AM,48,-122,21,35,56
16590,FremontBridge,08/25/2014 06:00:00 AM,48,-122,63,124,187
16591,FremontBridge,08/25/2014 07:00:00 AM,48,-122,113,377,490
16592,FremontBridge,08/25/2014 08:00:00 AM,48,-122,167,519,686
16593,FremontBridge,08/25/2014 09:00:00 AM,48,-122,137,229,366
16594,FremontBridge,08/25/2014 10:00:00 AM,48,-122,58,63,121
16595,FremontBridge,08/25/2014 11:00:00 AM,48,-122,41,73,114
16596,FremontBridge,08/25/2014 12:00:00 PM,48,-122,44,55,99
16597,FremontBridge,08/25/2014 01:00:00 PM,48,-122,70,61,131
16598,FremontBridge,08/25/2014 02:00:00 PM,48,-122,73,54,127
16599,FremontBridge,08/25/2014 03:00:00 PM,48,-122,101,78,179
16600,FremontBridge,08/25/2014 04:00:00 PM,48,-122,226,130,356
16601,FremontBridge,08/25/2014 05:00:00 PM,48,-122,577,192,769
16602,FremontBridge,08/25/2014 06:00:00 PM,48,-122,423,214,637
16603,FremontBridge,08/25/2014 07:00:00 PM,48,-122,195,129,324
16604,FremontBridge,08/25/2014 08:00:00 PM,48,-122,86,60,146
16605,FremontBridge,08/25/2014 09:00:00 PM,48,-122,39,34,73
16606,FremontBridge,08/25/2014 10:00:00 PM,48,-122,33,25,58
16607,FremontBridge,08/25/2014 11:00:00 PM,48,-122,17,14,31
16608,FremontBridge,08/26/2014 12:00:00 AM,48,-122,14,4,18
16609,FremontBridge,08/26/2014 01:00:00 AM,48,-122,4,2,6
16610,FremontBridge,08/26/2014 02:00:00 AM,48,-122,5,5,10
16611,FremontBridge,08/26/2014 03:00:00 AM,48,-122,1,2,3
16612,FremontBridge,08/26/2014 04:00:00 AM,48,-122,5,8,13
16613,FremontBridge,08/26/2014 05:00:00 AM,48,-122,13,33,46
16614,FremontBridge,08/26/2014 06:00:00 AM,48,-122,58,152,210
16615,FremontBridge,08/26/2014 07:00:00 AM,48,-122,124,471,595
16616,FremontBridge,08/26/2014 08:00:00 AM,48,-122,226,532,758
16617,FremontBridge,08/26/2014 09:00:00 AM,48,-122,133,230,363
16618,FremontBridge,08/26/2014 10:00:00 AM,48,-122,81,82,163
16619,FremontBridge,08/26/2014 11:00:00 AM,48,-122,49,59,108
16620,FremontBridge,08/26/2014 12:00:00 PM,48,-122,72,71,143
16621,FremontBridge,08/26/2014 01:00:00 PM,48,-122,72,54,126
16622,FremontBridge,08/26/2014 02:00:00 PM,48,-122,55,56,111
16623,FremontBridge,08/26/2014 03:00:00 PM,48,-122,116,78,194
16624,FremontBridge,08/26/2014 04:00:00 PM,48,-122,273,135,408
16625,FremontBridge,08/26/2014 05:00:00 PM,48,-122,639,238,877
16626,FremontBridge,08/26/2014 06:00:00 PM,48,-122,427,202,629
16627,FremontBridge,08/26/2014 07:00:00 PM,48,-122,242,127,369
16628,FremontBridge,08/26/2014 08:00:00 PM,48,-122,101,92,193
16629,FremontBridge,08/26/2014 09:00:00 PM,48,-122,54,41,95
16630,FremontBridge,08/26/2014 10:00:00 PM,48,-122,33,39,72
16631,FremontBridge,08/26/2014 11:00:00 PM,48,-122,27,14,41
16632,FremontBridge,08/27/2014 12:00:00 AM,48,-122,14,8,22
16633,FremontBridge,08/27/2014 01:00:00 AM,48,-122,3,6,9
16634,FremontBridge,08/27/2014 02:00:00 AM,48,-122,3,2,5
16635,FremontBridge,08/27/2014 03:00:00 AM,48,-122,5,3,8
16636,FremontBridge,08/27/2014 04:00:00 AM,48,-122,2,14,16
16637,FremontBridge,08/27/2014 05:00:00 AM,48,-122,15,25,40
16638,FremontBridge,08/27/2014 06:00:00 AM,48,-122,53,125,178
16639,FremontBridge,08/27/2014 07:00:00 AM,48,-122,127,384,511
16640,FremontBridge,08/27/2014 08:00:00 AM,48,-122,200,477,677
16641,FremontBridge,08/27/2014 09:00:00 AM,48,-122,128,198,326
16642,FremontBridge,08/27/2014 10:00:00 AM,48,-122,55,63,118
16643,FremontBridge,08/27/2014 11:00:00 AM,48,-122,68,79,147
16644,FremontBridge,08/27/2014 12:00:00 PM,48,-122,57,53,110
16645,FremontBridge,08/27/2014 01:00:00 PM,48,-122,46,47,93
16646,FremontBridge,08/27/2014 02:00:00 PM,48,-122,91,57,148
16647,FremontBridge,08/27/2014 03:00:00 PM,48,-122,98,75,173
16648,FremontBridge,08/27/2014 04:00:00 PM,48,-122,244,150,394
16649,FremontBridge,08/27/2014 05:00:00 PM,48,-122,531,212,743
16650,FremontBridge,08/27/2014 06:00:00 PM,48,-122,381,229,610
16651,FremontBridge,08/27/2014 07:00:00 PM,48,-122,202,124,326
16652,FremontBridge,08/27/2014 08:00:00 PM,48,-122,114,69,183
16653,FremontBridge,08/27/2014 09:00:00 PM,48,-122,48,57,105
16654,FremontBridge,08/27/2014 10:00:00 PM,48,-122,36,26,62
16655,FremontBridge,08/27/2014 11:00:00 PM,48,-122,24,18,42
16656,FremontBridge,08/28/2014 12:00:00 AM,48,-122,10,10,20
16657,FremontBridge,08/28/2014 01:00:00 AM,48,-122,3,7,10
16658,FremontBridge,08/28/2014 02:00:00 AM,48,-122,2,1,3
16659,FremontBridge,08/28/2014 03:00:00 AM,48,-122,3,4,7
16660,FremontBridge,08/28/2014 04:00:00 AM,48,-122,5,8,13
16661,FremontBridge,08/28/2014 05:00:00 AM,48,-122,11,29,40
16662,FremontBridge,08/28/2014 06:00:00 AM,48,-122,63,109,172
16663,FremontBridge,08/28/2014 07:00:00 AM,48,-122,112,314,426
16664,FremontBridge,08/28/2014 08:00:00 AM,48,-122,158,403,561
16665,FremontBridge,08/28/2014 09:00:00 AM,48,-122,128,211,339
16666,FremontBridge,08/28/2014 10:00:00 AM,48,-122,52,60,112
16667,FremontBridge,08/28/2014 11:00:00 AM,48,-122,60,62,122
16668,FremontBridge,08/28/2014 12:00:00 PM,48,-122,55,55,110
16669,FremontBridge,08/28/2014 01:00:00 PM,48,-122,48,49,97
16670,FremontBridge,08/28/2014 02:00:00 PM,48,-122,58,55,113
16671,FremontBridge,08/28/2014 03:00:00 PM,48,-122,75,83,158
16672,FremontBridge,08/28/2014 04:00:00 PM,48,-122,221,125,346
16673,FremontBridge,08/28/2014 05:00:00 PM,48,-122,453,208,661
16674,FremontBridge,08/28/2014 06:00:00 PM,48,-122,325,184,509
16675,FremontBridge,08/28/2014 07:00:00 PM,48,-122,166,86,252
16676,FremontBridge,08/28/2014 08:00:00 PM,48,-122,91,62,153
16677,FremontBridge,08/28/2014 09:00:00 PM,48,-122,60,38,98
16678,FremontBridge,08/28/2014 10:00:00 PM,48,-122,26,23,49
16679,FremontBridge,08/28/2014 11:00:00 PM,48,-122,16,22,38
16680,FremontBridge,08/29/2014 12:00:00 AM,48,-122,8,4,12
16681,FremontBridge,08/29/2014 01:00:00 AM,48,-122,5,2,7
16682,FremontBridge,08/29/2014 02:00:00 AM,48,-122,1,3,4
16683,FremontBridge,08/29/2014 03:00:00 AM,48,-122,4,1,5
16684,FremontBridge,08/29/2014 04:00:00 AM,48,-122,6,6,12
16685,FremontBridge,08/29/2014 05:00:00 AM,48,-122,15,15,30
16686,FremontBridge,08/29/2014 06:00:00 AM,48,-122,35,70,105
16687,FremontBridge,08/29/2014 07:00:00 AM,48,-122,85,203,288
16688,FremontBridge,08/29/2014 08:00:00 AM,48,-122,129,285,414
16689,FremontBridge,08/29/2014 09:00:00 AM,48,-122,93,146,239
16690,FremontBridge,08/29/2014 10:00:00 AM,48,-122,46,73,119
16691,FremontBridge,08/29/2014 11:00:00 AM,48,-122,54,39,93
16692,FremontBridge,08/29/2014 12:00:00 PM,48,-122,35,48,83
16693,FremontBridge,08/29/2014 01:00:00 PM,48,-122,58,49,107
16694,FremontBridge,08/29/2014 02:00:00 PM,48,-122,59,55,114
16695,FremontBridge,08/29/2014 03:00:00 PM,48,-122,94,62,156
16696,FremontBridge,08/29/2014 04:00:00 PM,48,-122,202,103,305
16697,FremontBridge,08/29/2014 05:00:00 PM,48,-122,284,130,414
16698,FremontBridge,08/29/2014 06:00:00 PM,48,-122,214,102,316
16699,FremontBridge,08/29/2014 07:00:00 PM,48,-122,82,72,154
16700,FremontBridge,08/29/2014 08:00:00 PM,48,-122,58,36,94
16701,FremontBridge,08/29/2014 09:00:00 PM,48,-122,24,22,46
16702,FremontBridge,08/29/2014 10:00:00 PM,48,-122,27,11,38
16703,FremontBridge,08/29/2014 11:00:00 PM,48,-122,24,9,33
16704,FremontBridge,08/30/2014 12:00:00 AM,48,-122,7,9,16
16705,FremontBridge,08/30/2014 01:00:00 AM,48,-122,7,4,11
16706,FremontBridge,08/30/2014 02:00:00 AM,48,-122,1,4,5
16707,FremontBridge,08/30/2014 03:00:00 AM,48,-122,2,4,6
16708,FremontBridge,08/30/2014 04:00:00 AM,48,-122,1,1,2
16709,FremontBridge,08/30/2014 05:00:00 AM,48,-122,4,2,6
16710,FremontBridge,08/30/2014 06:00:00 AM,48,-122,8,12,20
16711,FremontBridge,08/30/2014 07:00:00 AM,48,-122,15,20,35
16712,FremontBridge,08/30/2014 08:00:00 AM,48,-122,20,26,46
16713,FremontBridge,08/30/2014 09:00:00 AM,48,-122,21,33,54
16714,FremontBridge,08/30/2014 10:00:00 AM,48,-122,17,16,33
16715,FremontBridge,08/30/2014 11:00:00 AM,48,-122,20,19,39
16716,FremontBridge,08/30/2014 12:00:00 PM,48,-122,20,38,58
16717,FremontBridge,08/30/2014 01:00:00 PM,48,-122,25,28,53
16718,FremontBridge,08/30/2014 02:00:00 PM,48,-122,21,33,54
16719,FremontBridge,08/30/2014 03:00:00 PM,48,-122,26,26,52
16720,FremontBridge,08/30/2014 04:00:00 PM,48,-122,37,40,77
16721,FremontBridge,08/30/2014 05:00:00 PM,48,-122,31,42,73
16722,FremontBridge,08/30/2014 06:00:00 PM,48,-122,39,24,63
16723,FremontBridge,08/30/2014 07:00:00 PM,48,-122,17,27,44
16724,FremontBridge,08/30/2014 08:00:00 PM,48,-122,17,11,28
16725,FremontBridge,08/30/2014 09:00:00 PM,48,-122,15,17,32
16726,FremontBridge,08/30/2014 10:00:00 PM,48,-122,16,15,31
16727,FremontBridge,08/30/2014 11:00:00 PM,48,-122,16,5,21
16728,FremontBridge,08/31/2014 12:00:00 AM,48,-122,4,2,6
16729,FremontBridge,08/31/2014 01:00:00 AM,48,-122,3,2,5
16730,FremontBridge,08/31/2014 02:00:00 AM,48,-122,3,0,3
16731,FremontBridge,08/31/2014 03:00:00 AM,48,-122,0,2,2
16732,FremontBridge,08/31/2014 04:00:00 AM,48,-122,3,4,7
16733,FremontBridge,08/31/2014 05:00:00 AM,48,-122,4,6,10
16734,FremontBridge,08/31/2014 06:00:00 AM,48,-122,3,7,10
16735,FremontBridge,08/31/2014 07:00:00 AM,48,-122,15,8,23
16736,FremontBridge,08/31/2014 08:00:00 AM,48,-122,16,28,44
16737,FremontBridge,08/31/2014 09:00:00 AM,48,-122,35,45,80
16738,FremontBridge,08/31/2014 10:00:00 AM,48,-122,39,56,95
16739,FremontBridge,08/31/2014 11:00:00 AM,48,-122,51,66,117
16740,FremontBridge,08/31/2014 12:00:00 PM,48,-122,80,99,179
16741,FremontBridge,08/31/2014 01:00:00 PM,48,-122,74,81,155
16742,FremontBridge,08/31/2014 02:00:00 PM,48,-122,68,99,167
16743,FremontBridge,08/31/2014 03:00:00 PM,48,-122,98,104,202
16744,FremontBridge,08/31/2014 04:00:00 PM,48,-122,68,93,161
16745,FremontBridge,08/31/2014 05:00:00 PM,48,-122,71,79,150
16746,FremontBridge,08/31/2014 06:00:00 PM,48,-122,64,53,117
16747,FremontBridge,08/31/2014 07:00:00 PM,48,-122,57,47,104
16748,FremontBridge,08/31/2014 08:00:00 PM,48,-122,23,32,55
16749,FremontBridge,08/31/2014 09:00:00 PM,48,-122,30,13,43
16750,FremontBridge,08/31/2014 10:00:00 PM,48,-122,30,14,44
16751,FremontBridge,08/31/2014 11:00:00 PM,48,-122,30,11,41
16752,FremontBridge,09/01/2014 12:00:00 AM,48,-122,22,4,26
16753,FremontBridge,09/01/2014 01:00:00 AM,48,-122,2,2,4
16754,FremontBridge,09/01/2014 02:00:00 AM,48,-122,4,5,9
16755,FremontBridge,09/01/2014 03:00:00 AM,48,-122,1,1,2
16756,FremontBridge,09/01/2014 04:00:00 AM,48,-122,3,2,5
16757,FremontBridge,09/01/2014 05:00:00 AM,48,-122,4,4,8
16758,FremontBridge,09/01/2014 06:00:00 AM,48,-122,7,7,14
16759,FremontBridge,09/01/2014 07:00:00 AM,48,-122,14,22,36
16760,FremontBridge,09/01/2014 08:00:00 AM,48,-122,31,35,66
16761,FremontBridge,09/01/2014 09:00:00 AM,48,-122,54,60,114
16762,FremontBridge,09/01/2014 10:00:00 AM,48,-122,32,53,85
16763,FremontBridge,09/01/2014 11:00:00 AM,48,-122,71,89,160
16764,FremontBridge,09/01/2014 12:00:00 PM,48,-122,82,115,197
16765,FremontBridge,09/01/2014 01:00:00 PM,48,-122,112,139,251
16766,FremontBridge,09/01/2014 02:00:00 PM,48,-122,98,131,229
16767,FremontBridge,09/01/2014 03:00:00 PM,48,-122,117,142,259
16768,FremontBridge,09/01/2014 04:00:00 PM,48,-122,109,133,242
16769,FremontBridge,09/01/2014 05:00:00 PM,48,-122,107,116,223
16770,FremontBridge,09/01/2014 06:00:00 PM,48,-122,67,66,133
16771,FremontBridge,09/01/2014 07:00:00 PM,48,-122,46,55,101
16772,FremontBridge,09/01/2014 08:00:00 PM,48,-122,42,33,75
16773,FremontBridge,09/01/2014 09:00:00 PM,48,-122,27,22,49
16774,FremontBridge,09/01/2014 10:00:00 PM,48,-122,26,13,39
16775,FremontBridge,09/01/2014 11:00:00 PM,48,-122,22,7,29
16776,FremontBridge,09/02/2014 12:00:00 AM,48,-122,11,7,18
16777,FremontBridge,09/02/2014 01:00:00 AM,48,-122,6,1,7
16778,FremontBridge,09/02/2014 02:00:00 AM,48,-122,0,2,2
16779,FremontBridge,09/02/2014 03:00:00 AM,48,-122,0,4,4
16780,FremontBridge,09/02/2014 04:00:00 AM,48,-122,6,6,12
16781,FremontBridge,09/02/2014 05:00:00 AM,48,-122,13,28,41
16782,FremontBridge,09/02/2014 06:00:00 AM,48,-122,42,91,133
16783,FremontBridge,09/02/2014 07:00:00 AM,48,-122,84,282,366
16784,FremontBridge,09/02/2014 08:00:00 AM,48,-122,136,376,512
16785,FremontBridge,09/02/2014 09:00:00 AM,48,-122,96,162,258
16786,FremontBridge,09/02/2014 10:00:00 AM,48,-122,48,65,113
16787,FremontBridge,09/02/2014 11:00:00 AM,48,-122,41,46,87
16788,FremontBridge,09/02/2014 12:00:00 PM,48,-122,35,47,82
16789,FremontBridge,09/02/2014 01:00:00 PM,48,-122,47,40,87
16790,FremontBridge,09/02/2014 02:00:00 PM,48,-122,68,35,103
16791,FremontBridge,09/02/2014 03:00:00 PM,48,-122,74,56,130
16792,FremontBridge,09/02/2014 04:00:00 PM,48,-122,161,110,271
16793,FremontBridge,09/02/2014 05:00:00 PM,48,-122,370,163,533
16794,FremontBridge,09/02/2014 06:00:00 PM,48,-122,250,165,415
16795,FremontBridge,09/02/2014 07:00:00 PM,48,-122,104,57,161
16796,FremontBridge,09/02/2014 08:00:00 PM,48,-122,57,35,92
16797,FremontBridge,09/02/2014 09:00:00 PM,48,-122,19,11,30
16798,FremontBridge,09/02/2014 10:00:00 PM,48,-122,13,12,25
16799,FremontBridge,09/02/2014 11:00:00 PM,48,-122,8,3,11
16800,FremontBridge,09/03/2014 12:00:00 AM,48,-122,2,5,7
16801,FremontBridge,09/03/2014 01:00:00 AM,48,-122,2,1,3
16802,FremontBridge,09/03/2014 02:00:00 AM,48,-122,1,1,2
16803,FremontBridge,09/03/2014 03:00:00 AM,48,-122,5,1,6
16804,FremontBridge,09/03/2014 04:00:00 AM,48,-122,4,5,9
16805,FremontBridge,09/03/2014 05:00:00 AM,48,-122,7,25,32
16806,FremontBridge,09/03/2014 06:00:00 AM,48,-122,48,105,153
16807,FremontBridge,09/03/2014 07:00:00 AM,48,-122,99,307,406
16808,FremontBridge,09/03/2014 08:00:00 AM,48,-122,146,389,535
16809,FremontBridge,09/03/2014 09:00:00 AM,48,-122,19,232,251
16810,FremontBridge,09/03/2014 10:00:00 AM,48,-122,9,128,137
16811,FremontBridge,09/03/2014 11:00:00 AM,48,-122,78,0,78
16812,FremontBridge,09/03/2014 12:00:00 PM,48,-122,69,3,72
16813,FremontBridge,09/03/2014 01:00:00 PM,48,-122,44,52,96
16814,FremontBridge,09/03/2014 02:00:00 PM,48,-122,62,66,128
16815,FremontBridge,09/03/2014 03:00:00 PM,48,-122,84,84,168
16816,FremontBridge,09/03/2014 04:00:00 PM,48,-122,184,116,300
16817,FremontBridge,09/03/2014 05:00:00 PM,48,-122,459,176,635
16818,FremontBridge,09/03/2014 06:00:00 PM,48,-122,343,211,554
16819,FremontBridge,09/03/2014 07:00:00 PM,48,-122,161,115,276
16820,FremontBridge,09/03/2014 08:00:00 PM,48,-122,69,74,143
16821,FremontBridge,09/03/2014 09:00:00 PM,48,-122,36,30,66
16822,FremontBridge,09/03/2014 10:00:00 PM,48,-122,17,35,52
16823,FremontBridge,09/03/2014 11:00:00 PM,48,-122,9,3,12
16824,FremontBridge,09/04/2014 12:00:00 AM,48,-122,17,7,24
16825,FremontBridge,09/04/2014 01:00:00 AM,48,-122,6,4,10
16826,FremontBridge,09/04/2014 02:00:00 AM,48,-122,6,4,10
16827,FremontBridge,09/04/2014 03:00:00 AM,48,-122,3,1,4
16828,FremontBridge,09/04/2014 04:00:00 AM,48,-122,2,10,12
16829,FremontBridge,09/04/2014 05:00:00 AM,48,-122,15,34,49
16830,FremontBridge,09/04/2014 06:00:00 AM,48,-122,40,120,160
16831,FremontBridge,09/04/2014 07:00:00 AM,48,-122,134,414,548
16832,FremontBridge,09/04/2014 08:00:00 AM,48,-122,170,475,645
16833,FremontBridge,09/04/2014 09:00:00 AM,48,-122,130,205,335
16834,FremontBridge,09/04/2014 10:00:00 AM,48,-122,50,76,126
16835,FremontBridge,09/04/2014 11:00:00 AM,48,-122,55,60,115
16836,FremontBridge,09/04/2014 12:00:00 PM,48,-122,63,72,135
16837,FremontBridge,09/04/2014 01:00:00 PM,48,-122,70,68,138
16838,FremontBridge,09/04/2014 02:00:00 PM,48,-122,87,77,164
16839,FremontBridge,09/04/2014 03:00:00 PM,48,-122,125,100,225
16840,FremontBridge,09/04/2014 04:00:00 PM,48,-122,286,152,438
16841,FremontBridge,09/04/2014 05:00:00 PM,48,-122,538,240,778
16842,FremontBridge,09/04/2014 06:00:00 PM,48,-122,324,146,470
16843,FremontBridge,09/04/2014 07:00:00 PM,48,-122,146,81,227
16844,FremontBridge,09/04/2014 08:00:00 PM,48,-122,60,63,123
16845,FremontBridge,09/04/2014 09:00:00 PM,48,-122,68,31,99
16846,FremontBridge,09/04/2014 10:00:00 PM,48,-122,49,25,74
16847,FremontBridge,09/04/2014 11:00:00 PM,48,-122,18,13,31
16848,FremontBridge,09/05/2014 12:00:00 AM,48,-122,13,10,23
16849,FremontBridge,09/05/2014 01:00:00 AM,48,-122,2,3,5
16850,FremontBridge,09/05/2014 02:00:00 AM,48,-122,1,5,6
16851,FremontBridge,09/05/2014 03:00:00 AM,48,-122,2,4,6
16852,FremontBridge,09/05/2014 04:00:00 AM,48,-122,5,13,18
16853,FremontBridge,09/05/2014 05:00:00 AM,48,-122,8,19,27
16854,FremontBridge,09/05/2014 06:00:00 AM,48,-122,52,91,143
16855,FremontBridge,09/05/2014 07:00:00 AM,48,-122,95,266,361
16856,FremontBridge,09/05/2014 08:00:00 AM,48,-122,149,410,559
16857,FremontBridge,09/05/2014 09:00:00 AM,48,-122,119,152,271
16858,FremontBridge,09/05/2014 10:00:00 AM,48,-122,70,71,141
16859,FremontBridge,09/05/2014 11:00:00 AM,48,-122,43,68,111
16860,FremontBridge,09/05/2014 12:00:00 PM,48,-122,50,58,108
16861,FremontBridge,09/05/2014 01:00:00 PM,48,-122,70,59,129
16862,FremontBridge,09/05/2014 02:00:00 PM,48,-122,88,76,164
16863,FremontBridge,09/05/2014 03:00:00 PM,48,-122,132,108,240
16864,FremontBridge,09/05/2014 04:00:00 PM,48,-122,225,147,372
16865,FremontBridge,09/05/2014 05:00:00 PM,48,-122,405,187,592
16866,FremontBridge,09/05/2014 06:00:00 PM,48,-122,259,173,432
16867,FremontBridge,09/05/2014 07:00:00 PM,48,-122,141,98,239
16868,FremontBridge,09/05/2014 08:00:00 PM,48,-122,73,39,112
16869,FremontBridge,09/05/2014 09:00:00 PM,48,-122,19,34,53
16870,FremontBridge,09/05/2014 10:00:00 PM,48,-122,28,20,48
16871,FremontBridge,09/05/2014 11:00:00 PM,48,-122,16,11,27
16872,FremontBridge,09/06/2014 12:00:00 AM,48,-122,4,4,8
16873,FremontBridge,09/06/2014 01:00:00 AM,48,-122,14,0,14
16874,FremontBridge,09/06/2014 02:00:00 AM,48,-122,1,1,2
16875,FremontBridge,09/06/2014 03:00:00 AM,48,-122,0,0,0
16876,FremontBridge,09/06/2014 04:00:00 AM,48,-122,0,0,0
16877,FremontBridge,09/06/2014 05:00:00 AM,48,-122,15,2,17
16878,FremontBridge,09/06/2014 06:00:00 AM,48,-122,13,7,20
16879,FremontBridge,09/06/2014 07:00:00 AM,48,-122,36,37,73
16880,FremontBridge,09/06/2014 08:00:00 AM,48,-122,37,62,99
16881,FremontBridge,09/06/2014 09:00:00 AM,48,-122,46,78,124
16882,FremontBridge,09/06/2014 10:00:00 AM,48,-122,77,72,149
16883,FremontBridge,09/06/2014 11:00:00 AM,48,-122,112,91,203
16884,FremontBridge,09/06/2014 12:00:00 PM,48,-122,79,115,194
16885,FremontBridge,09/06/2014 01:00:00 PM,48,-122,95,102,197
16886,FremontBridge,09/06/2014 02:00:00 PM,48,-122,86,104,190
16887,FremontBridge,09/06/2014 03:00:00 PM,48,-122,96,115,211
16888,FremontBridge,09/06/2014 04:00:00 PM,48,-122,116,113,229
16889,FremontBridge,09/06/2014 05:00:00 PM,48,-122,70,121,191
16890,FremontBridge,09/06/2014 06:00:00 PM,48,-122,67,72,139
16891,FremontBridge,09/06/2014 07:00:00 PM,48,-122,69,56,125
16892,FremontBridge,09/06/2014 08:00:00 PM,48,-122,24,27,51
16893,FremontBridge,09/06/2014 09:00:00 PM,48,-122,28,39,67
16894,FremontBridge,09/06/2014 10:00:00 PM,48,-122,14,43,57
16895,FremontBridge,09/06/2014 11:00:00 PM,48,-122,34,6,40
16896,FremontBridge,09/07/2014 12:00:00 AM,48,-122,3,7,10
16897,FremontBridge,09/07/2014 01:00:00 AM,48,-122,0,0,0
16898,FremontBridge,09/07/2014 02:00:00 AM,48,-122,3,0,3
16899,FremontBridge,09/07/2014 03:00:00 AM,48,-122,1,2,3
16900,FremontBridge,09/07/2014 04:00:00 AM,48,-122,0,0,0
16901,FremontBridge,09/07/2014 05:00:00 AM,48,-122,1,3,4
16902,FremontBridge,09/07/2014 06:00:00 AM,48,-122,7,8,15
16903,FremontBridge,09/07/2014 07:00:00 AM,48,-122,25,18,43
16904,FremontBridge,09/07/2014 08:00:00 AM,48,-122,34,43,77
16905,FremontBridge,09/07/2014 09:00:00 AM,48,-122,64,68,132
16906,FremontBridge,09/07/2014 10:00:00 AM,48,-122,72,59,131
16907,FremontBridge,09/07/2014 11:00:00 AM,48,-122,53,114,167
16908,FremontBridge,09/07/2014 12:00:00 PM,48,-122,86,119,205
16909,FremontBridge,09/07/2014 01:00:00 PM,48,-122,117,109,226
16910,FremontBridge,09/07/2014 02:00:00 PM,48,-122,84,119,203
16911,FremontBridge,09/07/2014 03:00:00 PM,48,-122,85,104,189
16912,FremontBridge,09/07/2014 04:00:00 PM,48,-122,98,107,205
16913,FremontBridge,09/07/2014 05:00:00 PM,48,-122,78,94,172
16914,FremontBridge,09/07/2014 06:00:00 PM,48,-122,61,68,129
16915,FremontBridge,09/07/2014 07:00:00 PM,48,-122,44,73,117
16916,FremontBridge,09/07/2014 08:00:00 PM,48,-122,43,48,91
16917,FremontBridge,09/07/2014 09:00:00 PM,48,-122,20,17,37
16918,FremontBridge,09/07/2014 10:00:00 PM,48,-122,17,13,30
16919,FremontBridge,09/07/2014 11:00:00 PM,48,-122,14,11,25
16920,FremontBridge,09/08/2014 12:00:00 AM,48,-122,9,2,11
16921,FremontBridge,09/08/2014 01:00:00 AM,48,-122,1,4,5
16922,FremontBridge,09/08/2014 02:00:00 AM,48,-122,0,1,1
16923,FremontBridge,09/08/2014 03:00:00 AM,48,-122,2,4,6
16924,FremontBridge,09/08/2014 04:00:00 AM,48,-122,4,10,14
16925,FremontBridge,09/08/2014 05:00:00 AM,48,-122,12,35,47
16926,FremontBridge,09/08/2014 06:00:00 AM,48,-122,54,96,150
16927,FremontBridge,09/08/2014 07:00:00 AM,48,-122,113,310,423
16928,FremontBridge,09/08/2014 08:00:00 AM,48,-122,183,386,569
16929,FremontBridge,09/08/2014 09:00:00 AM,48,-122,24,238,262
16930,FremontBridge,09/08/2014 10:00:00 AM,48,-122,0,102,102
16931,FremontBridge,09/08/2014 11:00:00 AM,48,-122,0,86,86
16932,FremontBridge,09/08/2014 12:00:00 PM,48,-122,0,62,62
16933,FremontBridge,09/08/2014 01:00:00 PM,48,-122,0,58,58
16934,FremontBridge,09/08/2014 02:00:00 PM,48,-122,10,80,90
16935,FremontBridge,09/08/2014 03:00:00 PM,48,-122,71,54,125
16936,FremontBridge,09/08/2014 04:00:00 PM,48,-122,192,121,313
16937,FremontBridge,09/08/2014 05:00:00 PM,48,-122,464,201,665
16938,FremontBridge,09/08/2014 06:00:00 PM,48,-122,301,145,446
16939,FremontBridge,09/08/2014 07:00:00 PM,48,-122,116,67,183
16940,FremontBridge,09/08/2014 08:00:00 PM,48,-122,45,38,83
16941,FremontBridge,09/08/2014 09:00:00 PM,48,-122,25,26,51
16942,FremontBridge,09/08/2014 10:00:00 PM,48,-122,23,17,40
16943,FremontBridge,09/08/2014 11:00:00 PM,48,-122,9,8,17
16944,FremontBridge,09/09/2014 12:00:00 AM,48,-122,4,4,8
16945,FremontBridge,09/09/2014 01:00:00 AM,48,-122,4,4,8
16946,FremontBridge,09/09/2014 02:00:00 AM,48,-122,1,4,5
16947,FremontBridge,09/09/2014 03:00:00 AM,48,-122,3,3,6
16948,FremontBridge,09/09/2014 04:00:00 AM,48,-122,2,9,11
16949,FremontBridge,09/09/2014 05:00:00 AM,48,-122,17,27,44
16950,FremontBridge,09/09/2014 06:00:00 AM,48,-122,43,100,143
16951,FremontBridge,09/09/2014 07:00:00 AM,48,-122,115,311,426
16952,FremontBridge,09/09/2014 08:00:00 AM,48,-122,163,409,572
16953,FremontBridge,09/09/2014 09:00:00 AM,48,-122,13,225,238
16954,FremontBridge,09/09/2014 10:00:00 AM,48,-122,0,94,94
16955,FremontBridge,09/09/2014 11:00:00 AM,48,-122,0,72,72
16956,FremontBridge,09/09/2014 12:00:00 PM,48,-122,1,54,55
16957,FremontBridge,09/09/2014 01:00:00 PM,48,-122,0,66,66
16958,FremontBridge,09/09/2014 02:00:00 PM,48,-122,0,85,85
16959,FremontBridge,09/09/2014 03:00:00 PM,48,-122,72,97,169
16960,FremontBridge,09/09/2014 04:00:00 PM,48,-122,199,115,314
16961,FremontBridge,09/09/2014 05:00:00 PM,48,-122,445,196,641
16962,FremontBridge,09/09/2014 06:00:00 PM,48,-122,314,199,513
16963,FremontBridge,09/09/2014 07:00:00 PM,48,-122,145,92,237
16964,FremontBridge,09/09/2014 08:00:00 PM,48,-122,66,53,119
16965,FremontBridge,09/09/2014 09:00:00 PM,48,-122,48,30,78
16966,FremontBridge,09/09/2014 10:00:00 PM,48,-122,29,24,53
16967,FremontBridge,09/09/2014 11:00:00 PM,48,-122,22,9,31
16968,FremontBridge,09/10/2014 12:00:00 AM,48,-122,8,8,16
16969,FremontBridge,09/10/2014 01:00:00 AM,48,-122,6,3,9
16970,FremontBridge,09/10/2014 02:00:00 AM,48,-122,3,12,15
16971,FremontBridge,09/10/2014 03:00:00 AM,48,-122,2,5,7
16972,FremontBridge,09/10/2014 04:00:00 AM,48,-122,5,4,9
16973,FremontBridge,09/10/2014 05:00:00 AM,48,-122,12,30,42
16974,FremontBridge,09/10/2014 06:00:00 AM,48,-122,51,90,141
16975,FremontBridge,09/10/2014 07:00:00 AM,48,-122,113,292,405
16976,FremontBridge,09/10/2014 08:00:00 AM,48,-122,177,411,588
16977,FremontBridge,09/10/2014 09:00:00 AM,48,-122,170,32,202
16978,FremontBridge,09/10/2014 10:00:00 AM,48,-122,100,4,104
16979,FremontBridge,09/10/2014 11:00:00 AM,48,-122,62,0,62
16980,FremontBridge,09/10/2014 12:00:00 PM,48,-122,83,0,83
16981,FremontBridge,09/10/2014 01:00:00 PM,48,-122,68,1,69
16982,FremontBridge,09/10/2014 02:00:00 PM,48,-122,86,2,88
16983,FremontBridge,09/10/2014 03:00:00 PM,48,-122,100,84,184
16984,FremontBridge,09/10/2014 04:00:00 PM,48,-122,188,120,308
16985,FremontBridge,09/10/2014 05:00:00 PM,48,-122,454,204,658
16986,FremontBridge,09/10/2014 06:00:00 PM,48,-122,306,204,510
16987,FremontBridge,09/10/2014 07:00:00 PM,48,-122,176,85,261
16988,FremontBridge,09/10/2014 08:00:00 PM,48,-122,57,45,102
16989,FremontBridge,09/10/2014 09:00:00 PM,48,-122,36,26,62
16990,FremontBridge,09/10/2014 10:00:00 PM,48,-122,40,21,61
16991,FremontBridge,09/10/2014 11:00:00 PM,48,-122,17,12,29
16992,FremontBridge,09/11/2014 12:00:00 AM,48,-122,10,5,15
16993,FremontBridge,09/11/2014 01:00:00 AM,48,-122,2,3,5
16994,FremontBridge,09/11/2014 02:00:00 AM,48,-122,0,3,3
16995,FremontBridge,09/11/2014 03:00:00 AM,48,-122,4,2,6
16996,FremontBridge,09/11/2014 04:00:00 AM,48,-122,2,5,7
16997,FremontBridge,09/11/2014 05:00:00 AM,48,-122,15,23,38
16998,FremontBridge,09/11/2014 06:00:00 AM,48,-122,48,89,137
16999,FremontBridge,09/11/2014 07:00:00 AM,48,-122,119,267,386
17000,FremontBridge,09/11/2014 08:00:00 AM,48,-122,169,427,596
17001,FremontBridge,09/11/2014 09:00:00 AM,48,-122,196,36,232
17002,FremontBridge,09/11/2014 10:00:00 AM,48,-122,87,1,88
17003,FremontBridge,09/11/2014 11:00:00 AM,48,-122,66,6,72
17004,FremontBridge,09/11/2014 12:00:00 PM,48,-122,43,52,95
17005,FremontBridge,09/11/2014 01:00:00 PM,48,-122,7,91,98
17006,FremontBridge,09/11/2014 02:00:00 PM,48,-122,0,100,100
17007,FremontBridge,09/11/2014 03:00:00 PM,48,-122,70,86,156
17008,FremontBridge,09/11/2014 04:00:00 PM,48,-122,210,129,339
17009,FremontBridge,09/11/2014 05:00:00 PM,48,-122,465,198,663
17010,FremontBridge,09/11/2014 06:00:00 PM,48,-122,332,163,495
17011,FremontBridge,09/11/2014 07:00:00 PM,48,-122,122,96,218
17012,FremontBridge,09/11/2014 08:00:00 PM,48,-122,68,63,131
17013,FremontBridge,09/11/2014 09:00:00 PM,48,-122,47,28,75
17014,FremontBridge,09/11/2014 10:00:00 PM,48,-122,29,25,54
17015,FremontBridge,09/11/2014 11:00:00 PM,48,-122,15,18,33
17016,FremontBridge,09/12/2014 12:00:00 AM,48,-122,4,6,10
17017,FremontBridge,09/12/2014 01:00:00 AM,48,-122,5,4,9
17018,FremontBridge,09/12/2014 02:00:00 AM,48,-122,4,3,7
17019,FremontBridge,09/12/2014 03:00:00 AM,48,-122,3,1,4
17020,FremontBridge,09/12/2014 04:00:00 AM,48,-122,4,6,10
17021,FremontBridge,09/12/2014 05:00:00 AM,48,-122,19,21,40
17022,FremontBridge,09/12/2014 06:00:00 AM,48,-122,32,78,110
17023,FremontBridge,09/12/2014 07:00:00 AM,48,-122,102,269,371
17024,FremontBridge,09/12/2014 08:00:00 AM,48,-122,161,359,520
17025,FremontBridge,09/12/2014 09:00:00 AM,48,-122,117,182,299
17026,FremontBridge,09/12/2014 10:00:00 AM,48,-122,61,77,138
17027,FremontBridge,09/12/2014 11:00:00 AM,48,-122,48,61,109
17028,FremontBridge,09/12/2014 12:00:00 PM,48,-122,48,60,108
17029,FremontBridge,09/12/2014 01:00:00 PM,48,-122,61,82,143
17030,FremontBridge,09/12/2014 02:00:00 PM,48,-122,55,69,124
17031,FremontBridge,09/12/2014 03:00:00 PM,48,-122,90,72,162
17032,FremontBridge,09/12/2014 04:00:00 PM,48,-122,213,136,349
17033,FremontBridge,09/12/2014 05:00:00 PM,48,-122,388,169,557
17034,FremontBridge,09/12/2014 06:00:00 PM,48,-122,220,159,379
17035,FremontBridge,09/12/2014 07:00:00 PM,48,-122,107,71,178
17036,FremontBridge,09/12/2014 08:00:00 PM,48,-122,53,36,89
17037,FremontBridge,09/12/2014 09:00:00 PM,48,-122,34,18,52
17038,FremontBridge,09/12/2014 10:00:00 PM,48,-122,47,29,76
17039,FremontBridge,09/12/2014 11:00:00 PM,48,-122,41,18,59
17040,FremontBridge,09/13/2014 12:00:00 AM,48,-122,15,3,18
17041,FremontBridge,09/13/2014 01:00:00 AM,48,-122,86,0,86
17042,FremontBridge,09/13/2014 02:00:00 AM,48,-122,7,0,7
17043,FremontBridge,09/13/2014 03:00:00 AM,48,-122,1,0,1
17044,FremontBridge,09/13/2014 04:00:00 AM,48,-122,5,0,5
17045,FremontBridge,09/13/2014 05:00:00 AM,48,-122,15,0,15
17046,FremontBridge,09/13/2014 06:00:00 AM,48,-122,9,5,14
17047,FremontBridge,09/13/2014 07:00:00 AM,48,-122,29,28,57
17048,FremontBridge,09/13/2014 08:00:00 AM,48,-122,57,38,95
17049,FremontBridge,09/13/2014 09:00:00 AM,48,-122,55,77,132
17050,FremontBridge,09/13/2014 10:00:00 AM,48,-122,73,78,151
17051,FremontBridge,09/13/2014 11:00:00 AM,48,-122,85,78,163
17052,FremontBridge,09/13/2014 12:00:00 PM,48,-122,90,128,218
17053,FremontBridge,09/13/2014 01:00:00 PM,48,-122,78,96,174
17054,FremontBridge,09/13/2014 02:00:00 PM,48,-122,73,83,156
17055,FremontBridge,09/13/2014 03:00:00 PM,48,-122,92,135,227
17056,FremontBridge,09/13/2014 04:00:00 PM,48,-122,95,124,219
17057,FremontBridge,09/13/2014 05:00:00 PM,48,-122,132,115,247
17058,FremontBridge,09/13/2014 06:00:00 PM,48,-122,57,81,138
17059,FremontBridge,09/13/2014 07:00:00 PM,48,-122,34,39,73
17060,FremontBridge,09/13/2014 08:00:00 PM,48,-122,25,40,65
17061,FremontBridge,09/13/2014 09:00:00 PM,48,-122,18,16,34
17062,FremontBridge,09/13/2014 10:00:00 PM,48,-122,29,15,44
17063,FremontBridge,09/13/2014 11:00:00 PM,48,-122,17,11,28
17064,FremontBridge,09/14/2014 12:00:00 AM,48,-122,22,6,28
17065,FremontBridge,09/14/2014 01:00:00 AM,48,-122,12,0,12
17066,FremontBridge,09/14/2014 02:00:00 AM,48,-122,8,0,8
17067,FremontBridge,09/14/2014 03:00:00 AM,48,-122,4,0,4
17068,FremontBridge,09/14/2014 04:00:00 AM,48,-122,3,0,3
17069,FremontBridge,09/14/2014 05:00:00 AM,48,-122,0,0,0
17070,FremontBridge,09/14/2014 06:00:00 AM,48,-122,10,9,19
17071,FremontBridge,09/14/2014 07:00:00 AM,48,-122,18,22,40
17072,FremontBridge,09/14/2014 08:00:00 AM,48,-122,21,47,68
17073,FremontBridge,09/14/2014 09:00:00 AM,48,-122,56,61,117
17074,FremontBridge,09/14/2014 10:00:00 AM,48,-122,65,64,129
17075,FremontBridge,09/14/2014 11:00:00 AM,48,-122,80,99,179
17076,FremontBridge,09/14/2014 12:00:00 PM,48,-122,96,107,203
17077,FremontBridge,09/14/2014 01:00:00 PM,48,-122,126,102,228
17078,FremontBridge,09/14/2014 02:00:00 PM,48,-122,80,80,160
17079,FremontBridge,09/14/2014 03:00:00 PM,48,-122,72,131,203
17080,FremontBridge,09/14/2014 04:00:00 PM,48,-122,116,101,217
17081,FremontBridge,09/14/2014 05:00:00 PM,48,-122,79,96,175
17082,FremontBridge,09/14/2014 06:00:00 PM,48,-122,55,89,144
17083,FremontBridge,09/14/2014 07:00:00 PM,48,-122,47,61,108
17084,FremontBridge,09/14/2014 08:00:00 PM,48,-122,28,29,57
17085,FremontBridge,09/14/2014 09:00:00 PM,48,-122,19,18,37
17086,FremontBridge,09/14/2014 10:00:00 PM,48,-122,12,12,24
17087,FremontBridge,09/14/2014 11:00:00 PM,48,-122,10,8,18
17088,FremontBridge,09/15/2014 12:00:00 AM,48,-122,4,5,9
17089,FremontBridge,09/15/2014 01:00:00 AM,48,-122,1,2,3
17090,FremontBridge,09/15/2014 02:00:00 AM,48,-122,0,3,3
17091,FremontBridge,09/15/2014 03:00:00 AM,48,-122,5,2,7
17092,FremontBridge,09/15/2014 04:00:00 AM,48,-122,2,6,8
17093,FremontBridge,09/15/2014 05:00:00 AM,48,-122,9,32,41
17094,FremontBridge,09/15/2014 06:00:00 AM,48,-122,43,89,132
17095,FremontBridge,09/15/2014 07:00:00 AM,48,-122,124,342,466
17096,FremontBridge,09/15/2014 08:00:00 AM,48,-122,184,450,634
17097,FremontBridge,09/15/2014 09:00:00 AM,48,-122,12,302,314
17098,FremontBridge,09/15/2014 10:00:00 AM,48,-122,0,120,120
17099,FremontBridge,09/15/2014 11:00:00 AM,48,-122,0,107,107
17100,FremontBridge,09/15/2014 12:00:00 PM,48,-122,0,87,87
17101,FremontBridge,09/15/2014 01:00:00 PM,48,-122,0,99,99
17102,FremontBridge,09/15/2014 02:00:00 PM,48,-122,15,81,96
17103,FremontBridge,09/15/2014 03:00:00 PM,48,-122,89,97,186
17104,FremontBridge,09/15/2014 04:00:00 PM,48,-122,211,142,353
17105,FremontBridge,09/15/2014 05:00:00 PM,48,-122,489,238,727
17106,FremontBridge,09/15/2014 06:00:00 PM,48,-122,359,204,563
17107,FremontBridge,09/15/2014 07:00:00 PM,48,-122,141,109,250
17108,FremontBridge,09/15/2014 08:00:00 PM,48,-122,65,30,95
17109,FremontBridge,09/15/2014 09:00:00 PM,48,-122,42,37,79
17110,FremontBridge,09/15/2014 10:00:00 PM,48,-122,27,16,43
17111,FremontBridge,09/15/2014 11:00:00 PM,48,-122,14,14,28
17112,FremontBridge,09/16/2014 12:00:00 AM,48,-122,5,9,14
17113,FremontBridge,09/16/2014 01:00:00 AM,48,-122,7,3,10
17114,FremontBridge,09/16/2014 02:00:00 AM,48,-122,2,6,8
17115,FremontBridge,09/16/2014 03:00:00 AM,48,-122,2,2,4
17116,FremontBridge,09/16/2014 04:00:00 AM,48,-122,2,7,9
17117,FremontBridge,09/16/2014 05:00:00 AM,48,-122,14,24,38
17118,FremontBridge,09/16/2014 06:00:00 AM,48,-122,45,115,160
17119,FremontBridge,09/16/2014 07:00:00 AM,48,-122,123,340,463
17120,FremontBridge,09/16/2014 08:00:00 AM,48,-122,174,413,587
17121,FremontBridge,09/16/2014 09:00:00 AM,48,-122,3,287,290
17122,FremontBridge,09/16/2014 10:00:00 AM,48,-122,0,111,111
17123,FremontBridge,09/16/2014 11:00:00 AM,48,-122,7,95,102
17124,FremontBridge,09/16/2014 12:00:00 PM,48,-122,72,3,75
17125,FremontBridge,09/16/2014 01:00:00 PM,48,-122,86,0,86
17126,FremontBridge,09/16/2014 02:00:00 PM,48,-122,112,20,132
17127,FremontBridge,09/16/2014 03:00:00 PM,48,-122,91,66,157
17128,FremontBridge,09/16/2014 04:00:00 PM,48,-122,209,146,355
17129,FremontBridge,09/16/2014 05:00:00 PM,48,-122,474,204,678
17130,FremontBridge,09/16/2014 06:00:00 PM,48,-122,370,176,546
17131,FremontBridge,09/16/2014 07:00:00 PM,48,-122,145,106,251
17132,FremontBridge,09/16/2014 08:00:00 PM,48,-122,71,49,120
17133,FremontBridge,09/16/2014 09:00:00 PM,48,-122,42,39,81
17134,FremontBridge,09/16/2014 10:00:00 PM,48,-122,21,18,39
17135,FremontBridge,09/16/2014 11:00:00 PM,48,-122,14,8,22
17136,FremontBridge,09/17/2014 12:00:00 AM,48,-122,5,7,12
17137,FremontBridge,09/17/2014 01:00:00 AM,48,-122,3,1,4
17138,FremontBridge,09/17/2014 02:00:00 AM,48,-122,0,2,2
17139,FremontBridge,09/17/2014 03:00:00 AM,48,-122,4,3,7
17140,FremontBridge,09/17/2014 04:00:00 AM,48,-122,3,4,7
17141,FremontBridge,09/17/2014 05:00:00 AM,48,-122,9,29,38
17142,FremontBridge,09/17/2014 06:00:00 AM,48,-122,52,95,147
17143,FremontBridge,09/17/2014 07:00:00 AM,48,-122,117,302,419
17144,FremontBridge,09/17/2014 08:00:00 AM,48,-122,142,414,556
17145,FremontBridge,09/17/2014 09:00:00 AM,48,-122,13,222,235
17146,FremontBridge,09/17/2014 10:00:00 AM,48,-122,1,82,83
17147,FremontBridge,09/17/2014 11:00:00 AM,48,-122,49,21,70
17148,FremontBridge,09/17/2014 12:00:00 PM,48,-122,61,0,61
17149,FremontBridge,09/17/2014 01:00:00 PM,48,-122,60,0,60
17150,FremontBridge,09/17/2014 02:00:00 PM,48,-122,89,32,121
17151,FremontBridge,09/17/2014 03:00:00 PM,48,-122,77,61,138
17152,FremontBridge,09/17/2014 04:00:00 PM,48,-122,187,106,293
17153,FremontBridge,09/17/2014 05:00:00 PM,48,-122,441,178,619
17154,FremontBridge,09/17/2014 06:00:00 PM,48,-122,288,154,442
17155,FremontBridge,09/17/2014 07:00:00 PM,48,-122,121,60,181
17156,FremontBridge,09/17/2014 08:00:00 PM,48,-122,63,30,93
17157,FremontBridge,09/17/2014 09:00:00 PM,48,-122,41,26,67
17158,FremontBridge,09/17/2014 10:00:00 PM,48,-122,25,23,48
17159,FremontBridge,09/17/2014 11:00:00 PM,48,-122,13,9,22
17160,FremontBridge,09/18/2014 12:00:00 AM,48,-122,5,0,5
17161,FremontBridge,09/18/2014 01:00:00 AM,48,-122,3,6,9
17162,FremontBridge,09/18/2014 02:00:00 AM,48,-122,0,5,5
17163,FremontBridge,09/18/2014 03:00:00 AM,48,-122,4,2,6
17164,FremontBridge,09/18/2014 04:00:00 AM,48,-122,4,5,9
17165,FremontBridge,09/18/2014 05:00:00 AM,48,-122,11,18,29
17166,FremontBridge,09/18/2014 06:00:00 AM,48,-122,39,84,123
17167,FremontBridge,09/18/2014 07:00:00 AM,48,-122,88,225,313
17168,FremontBridge,09/18/2014 08:00:00 AM,48,-122,127,308,435
17169,FremontBridge,09/18/2014 09:00:00 AM,48,-122,76,164,240
17170,FremontBridge,09/18/2014 10:00:00 AM,48,-122,42,55,97
17171,FremontBridge,09/18/2014 11:00:00 AM,48,-122,31,32,63
17172,FremontBridge,09/18/2014 12:00:00 PM,48,-122,33,41,74
17173,FremontBridge,09/18/2014 01:00:00 PM,48,-122,44,50,94
17174,FremontBridge,09/18/2014 02:00:00 PM,48,-122,53,41,94
17175,FremontBridge,09/18/2014 03:00:00 PM,48,-122,69,61,130
17176,FremontBridge,09/18/2014 04:00:00 PM,48,-122,163,79,242
17177,FremontBridge,09/18/2014 05:00:00 PM,48,-122,377,169,546
17178,FremontBridge,09/18/2014 06:00:00 PM,48,-122,244,138,382
17179,FremontBridge,09/18/2014 07:00:00 PM,48,-122,104,57,161
17180,FremontBridge,09/18/2014 08:00:00 PM,48,-122,55,33,88
17181,FremontBridge,09/18/2014 09:00:00 PM,48,-122,43,19,62
17182,FremontBridge,09/18/2014 10:00:00 PM,48,-122,26,16,42
17183,FremontBridge,09/18/2014 11:00:00 PM,48,-122,15,8,23
17184,FremontBridge,09/19/2014 12:00:00 AM,48,-122,11,10,21
17185,FremontBridge,09/19/2014 01:00:00 AM,48,-122,4,4,8
17186,FremontBridge,09/19/2014 02:00:00 AM,48,-122,1,2,3
17187,FremontBridge,09/19/2014 03:00:00 AM,48,-122,2,6,8
17188,FremontBridge,09/19/2014 04:00:00 AM,48,-122,6,5,11
17189,FremontBridge,09/19/2014 05:00:00 AM,48,-122,11,24,35
17190,FremontBridge,09/19/2014 06:00:00 AM,48,-122,38,73,111
17191,FremontBridge,09/19/2014 07:00:00 AM,48,-122,107,253,360
17192,FremontBridge,09/19/2014 08:00:00 AM,48,-122,155,322,477
17193,FremontBridge,09/19/2014 09:00:00 AM,48,-122,83,169,252
17194,FremontBridge,09/19/2014 10:00:00 AM,48,-122,49,88,137
17195,FremontBridge,09/19/2014 11:00:00 AM,48,-122,35,58,93
17196,FremontBridge,09/19/2014 12:00:00 PM,48,-122,50,48,98
17197,FremontBridge,09/19/2014 01:00:00 PM,48,-122,54,53,107
17198,FremontBridge,09/19/2014 02:00:00 PM,48,-122,73,75,148
17199,FremontBridge,09/19/2014 03:00:00 PM,48,-122,107,87,194
17200,FremontBridge,09/19/2014 04:00:00 PM,48,-122,212,134,346
17201,FremontBridge,09/19/2014 05:00:00 PM,48,-122,367,178,545
17202,FremontBridge,09/19/2014 06:00:00 PM,48,-122,224,126,350
17203,FremontBridge,09/19/2014 07:00:00 PM,48,-122,130,87,217
17204,FremontBridge,09/19/2014 08:00:00 PM,48,-122,46,32,78
17205,FremontBridge,09/19/2014 09:00:00 PM,48,-122,29,19,48
17206,FremontBridge,09/19/2014 10:00:00 PM,48,-122,30,28,58
17207,FremontBridge,09/19/2014 11:00:00 PM,48,-122,17,12,29
17208,FremontBridge,09/20/2014 12:00:00 AM,48,-122,13,16,29
17209,FremontBridge,09/20/2014 01:00:00 AM,48,-122,7,3,10
17210,FremontBridge,09/20/2014 02:00:00 AM,48,-122,7,4,11
17211,FremontBridge,09/20/2014 03:00:00 AM,48,-122,1,4,5
17212,FremontBridge,09/20/2014 04:00:00 AM,48,-122,0,0,0
17213,FremontBridge,09/20/2014 05:00:00 AM,48,-122,6,8,14
17214,FremontBridge,09/20/2014 06:00:00 AM,48,-122,8,7,15
17215,FremontBridge,09/20/2014 07:00:00 AM,48,-122,23,26,49
17216,FremontBridge,09/20/2014 08:00:00 AM,48,-122,39,43,82
17217,FremontBridge,09/20/2014 09:00:00 AM,48,-122,38,61,99
17218,FremontBridge,09/20/2014 10:00:00 AM,48,-122,50,56,106
17219,FremontBridge,09/20/2014 11:00:00 AM,48,-122,59,83,142
17220,FremontBridge,09/20/2014 12:00:00 PM,48,-122,89,99,188
17221,FremontBridge,09/20/2014 01:00:00 PM,48,-122,99,91,190
17222,FremontBridge,09/20/2014 02:00:00 PM,48,-122,99,78,177
17223,FremontBridge,09/20/2014 03:00:00 PM,48,-122,98,98,196
17224,FremontBridge,09/20/2014 04:00:00 PM,48,-122,86,104,190
17225,FremontBridge,09/20/2014 05:00:00 PM,48,-122,97,129,226
17226,FremontBridge,09/20/2014 06:00:00 PM,48,-122,92,93,185
17227,FremontBridge,09/20/2014 07:00:00 PM,48,-122,55,54,109
17228,FremontBridge,09/20/2014 08:00:00 PM,48,-122,42,28,70
17229,FremontBridge,09/20/2014 09:00:00 PM,48,-122,25,30,55
17230,FremontBridge,09/20/2014 10:00:00 PM,48,-122,27,26,53
17231,FremontBridge,09/20/2014 11:00:00 PM,48,-122,11,13,24
17232,FremontBridge,09/21/2014 12:00:00 AM,48,-122,14,11,25
17233,FremontBridge,09/21/2014 01:00:00 AM,48,-122,8,4,12
17234,FremontBridge,09/21/2014 02:00:00 AM,48,-122,6,7,13
17235,FremontBridge,09/21/2014 03:00:00 AM,48,-122,2,3,5
17236,FremontBridge,09/21/2014 04:00:00 AM,48,-122,1,0,1
17237,FremontBridge,09/21/2014 05:00:00 AM,48,-122,1,3,4
17238,FremontBridge,09/21/2014 06:00:00 AM,48,-122,10,6,16
17239,FremontBridge,09/21/2014 07:00:00 AM,48,-122,19,25,44
17240,FremontBridge,09/21/2014 08:00:00 AM,48,-122,34,49,83
17241,FremontBridge,09/21/2014 09:00:00 AM,48,-122,59,60,119
17242,FremontBridge,09/21/2014 10:00:00 AM,48,-122,68,73,141
17243,FremontBridge,09/21/2014 11:00:00 AM,48,-122,100,114,214
17244,FremontBridge,09/21/2014 12:00:00 PM,48,-122,92,137,229
17245,FremontBridge,09/21/2014 01:00:00 PM,48,-122,84,109,193
17246,FremontBridge,09/21/2014 02:00:00 PM,48,-122,96,103,199
17247,FremontBridge,09/21/2014 03:00:00 PM,48,-122,69,94,163
17248,FremontBridge,09/21/2014 04:00:00 PM,48,-122,91,98,189
17249,FremontBridge,09/21/2014 05:00:00 PM,48,-122,94,91,185
17250,FremontBridge,09/21/2014 06:00:00 PM,48,-122,85,75,160
17251,FremontBridge,09/21/2014 07:00:00 PM,48,-122,37,42,79
17252,FremontBridge,09/21/2014 08:00:00 PM,48,-122,33,19,52
17253,FremontBridge,09/21/2014 09:00:00 PM,48,-122,26,19,45
17254,FremontBridge,09/21/2014 10:00:00 PM,48,-122,15,17,32
17255,FremontBridge,09/21/2014 11:00:00 PM,48,-122,8,6,14
17256,FremontBridge,09/22/2014 12:00:00 AM,48,-122,8,2,10
17257,FremontBridge,09/22/2014 01:00:00 AM,48,-122,0,1,1
17258,FremontBridge,09/22/2014 02:00:00 AM,48,-122,3,1,4
17259,FremontBridge,09/22/2014 03:00:00 AM,48,-122,3,2,5
17260,FremontBridge,09/22/2014 04:00:00 AM,48,-122,5,7,12
17261,FremontBridge,09/22/2014 05:00:00 AM,48,-122,16,28,44
17262,FremontBridge,09/22/2014 06:00:00 AM,48,-122,43,85,128
17263,FremontBridge,09/22/2014 07:00:00 AM,48,-122,118,281,399
17264,FremontBridge,09/22/2014 08:00:00 AM,48,-122,176,361,537
17265,FremontBridge,09/22/2014 09:00:00 AM,48,-122,23,238,261
17266,FremontBridge,09/22/2014 10:00:00 AM,48,-122,4,89,93
17267,FremontBridge,09/22/2014 11:00:00 AM,48,-122,6,88,94
17268,FremontBridge,09/22/2014 12:00:00 PM,48,-122,1,52,53
17269,FremontBridge,09/22/2014 01:00:00 PM,48,-122,2,69,71
17270,FremontBridge,09/22/2014 02:00:00 PM,48,-122,21,72,93
17271,FremontBridge,09/22/2014 03:00:00 PM,48,-122,67,75,142
17272,FremontBridge,09/22/2014 04:00:00 PM,48,-122,174,113,287
17273,FremontBridge,09/22/2014 05:00:00 PM,48,-122,458,201,659
17274,FremontBridge,09/22/2014 06:00:00 PM,48,-122,305,175,480
17275,FremontBridge,09/22/2014 07:00:00 PM,48,-122,123,72,195
17276,FremontBridge,09/22/2014 08:00:00 PM,48,-122,58,43,101
17277,FremontBridge,09/22/2014 09:00:00 PM,48,-122,29,27,56
17278,FremontBridge,09/22/2014 10:00:00 PM,48,-122,12,22,34
17279,FremontBridge,09/22/2014 11:00:00 PM,48,-122,15,12,27
17280,FremontBridge,09/23/2014 12:00:00 AM,48,-122,8,13,21
17281,FremontBridge,09/23/2014 01:00:00 AM,48,-122,3,3,6
17282,FremontBridge,09/23/2014 02:00:00 AM,48,-122,1,3,4
17283,FremontBridge,09/23/2014 03:00:00 AM,48,-122,3,1,4
17284,FremontBridge,09/23/2014 04:00:00 AM,48,-122,2,4,6
17285,FremontBridge,09/23/2014 05:00:00 AM,48,-122,8,24,32
17286,FremontBridge,09/23/2014 06:00:00 AM,48,-122,41,109,150
17287,FremontBridge,09/23/2014 07:00:00 AM,48,-122,113,285,398
17288,FremontBridge,09/23/2014 08:00:00 AM,48,-122,170,375,545
17289,FremontBridge,09/23/2014 09:00:00 AM,48,-122,27,237,264
17290,FremontBridge,09/23/2014 10:00:00 AM,48,-122,2,96,98
17291,FremontBridge,09/23/2014 11:00:00 AM,48,-122,0,75,75
17292,FremontBridge,09/23/2014 12:00:00 PM,48,-122,3,57,60
17293,FremontBridge,09/23/2014 01:00:00 PM,48,-122,21,49,70
17294,FremontBridge,09/23/2014 02:00:00 PM,48,-122,42,26,68
17295,FremontBridge,09/23/2014 03:00:00 PM,48,-122,72,54,126
17296,FremontBridge,09/23/2014 04:00:00 PM,48,-122,150,89,239
17297,FremontBridge,09/23/2014 05:00:00 PM,48,-122,411,140,551
17298,FremontBridge,09/23/2014 06:00:00 PM,48,-122,261,121,382
17299,FremontBridge,09/23/2014 07:00:00 PM,48,-122,92,57,149
17300,FremontBridge,09/23/2014 08:00:00 PM,48,-122,37,17,54
17301,FremontBridge,09/23/2014 09:00:00 PM,48,-122,27,14,41
17302,FremontBridge,09/23/2014 10:00:00 PM,48,-122,15,43,58
17303,FremontBridge,09/23/2014 11:00:00 PM,48,-122,6,9,15
17304,FremontBridge,09/24/2014 12:00:00 AM,48,-122,5,4,9
17305,FremontBridge,09/24/2014 01:00:00 AM,48,-122,1,1,2
17306,FremontBridge,09/24/2014 02:00:00 AM,48,-122,0,1,1
17307,FremontBridge,09/24/2014 03:00:00 AM,48,-122,1,1,2
17308,FremontBridge,09/24/2014 04:00:00 AM,48,-122,1,2,3
17309,FremontBridge,09/24/2014 05:00:00 AM,48,-122,7,12,19
17310,FremontBridge,09/24/2014 06:00:00 AM,48,-122,29,57,86
17311,FremontBridge,09/24/2014 07:00:00 AM,48,-122,55,154,209
17312,FremontBridge,09/24/2014 08:00:00 AM,48,-122,85,193,278
17313,FremontBridge,09/24/2014 09:00:00 AM,48,-122,47,102,149
17314,FremontBridge,09/24/2014 10:00:00 AM,48,-122,21,35,56
17315,FremontBridge,09/24/2014 11:00:00 AM,48,-122,13,21,34
17316,FremontBridge,09/24/2014 12:00:00 PM,48,-122,18,20,38
17317,FremontBridge,09/24/2014 01:00:00 PM,48,-122,29,32,61
17318,FremontBridge,09/24/2014 02:00:00 PM,48,-122,23,34,57
17319,FremontBridge,09/24/2014 03:00:00 PM,48,-122,51,48,99
17320,FremontBridge,09/24/2014 04:00:00 PM,48,-122,87,65,152
17321,FremontBridge,09/24/2014 05:00:00 PM,48,-122,246,116,362
17322,FremontBridge,09/24/2014 06:00:00 PM,48,-122,170,98,268
17323,FremontBridge,09/24/2014 07:00:00 PM,48,-122,70,49,119
17324,FremontBridge,09/24/2014 08:00:00 PM,48,-122,40,24,64
17325,FremontBridge,09/24/2014 09:00:00 PM,48,-122,16,24,40
17326,FremontBridge,09/24/2014 10:00:00 PM,48,-122,21,11,32
17327,FremontBridge,09/24/2014 11:00:00 PM,48,-122,13,13,26
17328,FremontBridge,09/25/2014 12:00:00 AM,48,-122,0,5,5
17329,FremontBridge,09/25/2014 01:00:00 AM,48,-122,6,2,8
17330,FremontBridge,09/25/2014 02:00:00 AM,48,-122,2,2,4
17331,FremontBridge,09/25/2014 03:00:00 AM,48,-122,3,6,9
17332,FremontBridge,09/25/2014 04:00:00 AM,48,-122,4,5,9
17333,FremontBridge,09/25/2014 05:00:00 AM,48,-122,5,18,23
17334,FremontBridge,09/25/2014 06:00:00 AM,48,-122,31,63,94
17335,FremontBridge,09/25/2014 07:00:00 AM,48,-122,73,195,268
17336,FremontBridge,09/25/2014 08:00:00 AM,48,-122,140,279,419
17337,FremontBridge,09/25/2014 09:00:00 AM,48,-122,78,139,217
17338,FremontBridge,09/25/2014 10:00:00 AM,48,-122,32,64,96
17339,FremontBridge,09/25/2014 11:00:00 AM,48,-122,23,20,43
17340,FremontBridge,09/25/2014 12:00:00 PM,48,-122,21,24,45
17341,FremontBridge,09/25/2014 01:00:00 PM,48,-122,37,30,67
17342,FremontBridge,09/25/2014 02:00:00 PM,48,-122,39,52,91
17343,FremontBridge,09/25/2014 03:00:00 PM,48,-122,68,67,135
17344,FremontBridge,09/25/2014 04:00:00 PM,48,-122,160,108,268
17345,FremontBridge,09/25/2014 05:00:00 PM,48,-122,323,156,479
17346,FremontBridge,09/25/2014 06:00:00 PM,48,-122,221,133,354
17347,FremontBridge,09/25/2014 07:00:00 PM,48,-122,92,57,149
17348,FremontBridge,09/25/2014 08:00:00 PM,48,-122,41,32,73
17349,FremontBridge,09/25/2014 09:00:00 PM,48,-122,23,24,47
17350,FremontBridge,09/25/2014 10:00:00 PM,48,-122,21,13,34
17351,FremontBridge,09/25/2014 11:00:00 PM,48,-122,15,10,25
17352,FremontBridge,09/26/2014 12:00:00 AM,48,-122,7,3,10
17353,FremontBridge,09/26/2014 01:00:00 AM,48,-122,4,3,7
17354,FremontBridge,09/26/2014 02:00:00 AM,48,-122,4,1,5
17355,FremontBridge,09/26/2014 03:00:00 AM,48,-122,1,0,1
17356,FremontBridge,09/26/2014 04:00:00 AM,48,-122,3,4,7
17357,FremontBridge,09/26/2014 05:00:00 AM,48,-122,7,20,27
17358,FremontBridge,09/26/2014 06:00:00 AM,48,-122,19,39,58
17359,FremontBridge,09/26/2014 07:00:00 AM,48,-122,48,141,189
17360,FremontBridge,09/26/2014 08:00:00 AM,48,-122,90,287,377
17361,FremontBridge,09/26/2014 09:00:00 AM,48,-122,56,112,168
17362,FremontBridge,09/26/2014 10:00:00 AM,48,-122,36,39,75
17363,FremontBridge,09/26/2014 11:00:00 AM,48,-122,27,32,59
17364,FremontBridge,09/26/2014 12:00:00 PM,48,-122,30,37,67
17365,FremontBridge,09/26/2014 01:00:00 PM,48,-122,31,38,69
17366,FremontBridge,09/26/2014 02:00:00 PM,48,-122,56,58,114
17367,FremontBridge,09/26/2014 03:00:00 PM,48,-122,70,71,141
17368,FremontBridge,09/26/2014 04:00:00 PM,48,-122,150,92,242
17369,FremontBridge,09/26/2014 05:00:00 PM,48,-122,239,127,366
17370,FremontBridge,09/26/2014 06:00:00 PM,48,-122,143,126,269
17371,FremontBridge,09/26/2014 07:00:00 PM,48,-122,64,44,108
17372,FremontBridge,09/26/2014 08:00:00 PM,48,-122,39,21,60
17373,FremontBridge,09/26/2014 09:00:00 PM,48,-122,21,14,35
17374,FremontBridge,09/26/2014 10:00:00 PM,48,-122,10,18,28
17375,FremontBridge,09/26/2014 11:00:00 PM,48,-122,20,9,29
17376,FremontBridge,09/27/2014 12:00:00 AM,48,-122,11,11,22
17377,FremontBridge,09/27/2014 01:00:00 AM,48,-122,7,8,15
17378,FremontBridge,09/27/2014 02:00:00 AM,48,-122,6,6,12
17379,FremontBridge,09/27/2014 03:00:00 AM,48,-122,3,2,5
17380,FremontBridge,09/27/2014 04:00:00 AM,48,-122,1,1,2
17381,FremontBridge,09/27/2014 05:00:00 AM,48,-122,3,5,8
17382,FremontBridge,09/27/2014 06:00:00 AM,48,-122,12,11,23
17383,FremontBridge,09/27/2014 07:00:00 AM,48,-122,19,25,44
17384,FremontBridge,09/27/2014 08:00:00 AM,48,-122,28,50,78
17385,FremontBridge,09/27/2014 09:00:00 AM,48,-122,48,84,132
17386,FremontBridge,09/27/2014 10:00:00 AM,48,-122,62,88,150
17387,FremontBridge,09/27/2014 11:00:00 AM,48,-122,81,103,184
17388,FremontBridge,09/27/2014 12:00:00 PM,48,-122,99,134,233
17389,FremontBridge,09/27/2014 01:00:00 PM,48,-122,102,97,199
17390,FremontBridge,09/27/2014 02:00:00 PM,48,-122,81,103,184
17391,FremontBridge,09/27/2014 03:00:00 PM,48,-122,107,110,217
17392,FremontBridge,09/27/2014 04:00:00 PM,48,-122,110,106,216
17393,FremontBridge,09/27/2014 05:00:00 PM,48,-122,104,117,221
17394,FremontBridge,09/27/2014 06:00:00 PM,48,-122,65,85,150
17395,FremontBridge,09/27/2014 07:00:00 PM,48,-122,42,45,87
17396,FremontBridge,09/27/2014 08:00:00 PM,48,-122,24,29,53
17397,FremontBridge,09/27/2014 09:00:00 PM,48,-122,16,17,33
17398,FremontBridge,09/27/2014 10:00:00 PM,48,-122,20,13,33
17399,FremontBridge,09/27/2014 11:00:00 PM,48,-122,15,9,24
17400,FremontBridge,09/28/2014 12:00:00 AM,48,-122,10,8,18
17401,FremontBridge,09/28/2014 01:00:00 AM,48,-122,5,5,10
17402,FremontBridge,09/28/2014 02:00:00 AM,48,-122,6,7,13
17403,FremontBridge,09/28/2014 03:00:00 AM,48,-122,1,6,7
17404,FremontBridge,09/28/2014 04:00:00 AM,48,-122,1,3,4
17405,FremontBridge,09/28/2014 05:00:00 AM,48,-122,2,2,4
17406,FremontBridge,09/28/2014 06:00:00 AM,48,-122,9,9,18
17407,FremontBridge,09/28/2014 07:00:00 AM,48,-122,13,25,38
17408,FremontBridge,09/28/2014 08:00:00 AM,48,-122,30,35,65
17409,FremontBridge,09/28/2014 09:00:00 AM,48,-122,47,44,91
17410,FremontBridge,09/28/2014 10:00:00 AM,48,-122,44,79,123
17411,FremontBridge,09/28/2014 11:00:00 AM,48,-122,56,69,125
17412,FremontBridge,09/28/2014 12:00:00 PM,48,-122,93,85,178
17413,FremontBridge,09/28/2014 01:00:00 PM,48,-122,61,82,143
17414,FremontBridge,09/28/2014 02:00:00 PM,48,-122,49,99,148
17415,FremontBridge,09/28/2014 03:00:00 PM,48,-122,66,97,163
17416,FremontBridge,09/28/2014 04:00:00 PM,48,-122,88,90,178
17417,FremontBridge,09/28/2014 05:00:00 PM,48,-122,83,101,184
17418,FremontBridge,09/28/2014 06:00:00 PM,48,-122,59,69,128
17419,FremontBridge,09/28/2014 07:00:00 PM,48,-122,39,32,71
17420,FremontBridge,09/28/2014 08:00:00 PM,48,-122,23,18,41
17421,FremontBridge,09/28/2014 09:00:00 PM,48,-122,13,12,25
17422,FremontBridge,09/28/2014 10:00:00 PM,48,-122,16,8,24
17423,FremontBridge,09/28/2014 11:00:00 PM,48,-122,11,8,19
17424,FremontBridge,09/29/2014 12:00:00 AM,48,-122,3,1,4
17425,FremontBridge,09/29/2014 01:00:00 AM,48,-122,1,2,3
17426,FremontBridge,09/29/2014 02:00:00 AM,48,-122,1,2,3
17427,FremontBridge,09/29/2014 03:00:00 AM,48,-122,2,3,5
17428,FremontBridge,09/29/2014 04:00:00 AM,48,-122,4,7,11
17429,FremontBridge,09/29/2014 05:00:00 AM,48,-122,8,24,32
17430,FremontBridge,09/29/2014 06:00:00 AM,48,-122,39,80,119
17431,FremontBridge,09/29/2014 07:00:00 AM,48,-122,85,239,324
17432,FremontBridge,09/29/2014 08:00:00 AM,48,-122,152,337,489
17433,FremontBridge,09/29/2014 09:00:00 AM,48,-122,86,154,240
17434,FremontBridge,09/29/2014 10:00:00 AM,48,-122,39,61,100
17435,FremontBridge,09/29/2014 11:00:00 AM,48,-122,31,29,60
17436,FremontBridge,09/29/2014 12:00:00 PM,48,-122,29,29,58
17437,FremontBridge,09/29/2014 01:00:00 PM,48,-122,40,39,79
17438,FremontBridge,09/29/2014 02:00:00 PM,48,-122,35,44,79
17439,FremontBridge,09/29/2014 03:00:00 PM,48,-122,51,55,106
17440,FremontBridge,09/29/2014 04:00:00 PM,48,-122,142,102,244
17441,FremontBridge,09/29/2014 05:00:00 PM,48,-122,351,158,509
17442,FremontBridge,09/29/2014 06:00:00 PM,48,-122,203,97,300
17443,FremontBridge,09/29/2014 07:00:00 PM,48,-122,93,51,144
17444,FremontBridge,09/29/2014 08:00:00 PM,48,-122,38,18,56
17445,FremontBridge,09/29/2014 09:00:00 PM,48,-122,26,13,39
17446,FremontBridge,09/29/2014 10:00:00 PM,48,-122,9,8,17
17447,FremontBridge,09/29/2014 11:00:00 PM,48,-122,6,8,14
17448,FremontBridge,09/30/2014 12:00:00 AM,48,-122,2,2,4
17449,FremontBridge,09/30/2014 01:00:00 AM,48,-122,2,2,4
17450,FremontBridge,09/30/2014 02:00:00 AM,48,-122,0,5,5
17451,FremontBridge,09/30/2014 03:00:00 AM,48,-122,1,1,2
17452,FremontBridge,09/30/2014 04:00:00 AM,48,-122,2,3,5
17453,FremontBridge,09/30/2014 05:00:00 AM,48,-122,10,20,30
17454,FremontBridge,09/30/2014 06:00:00 AM,48,-122,35,74,109
17455,FremontBridge,09/30/2014 07:00:00 AM,48,-122,106,250,356
17456,FremontBridge,09/30/2014 08:00:00 AM,48,-122,161,354,515
17457,FremontBridge,09/30/2014 09:00:00 AM,48,-122,21,221,242
17458,FremontBridge,09/30/2014 10:00:00 AM,48,-122,0,115,115
17459,FremontBridge,09/30/2014 11:00:00 AM,48,-122,0,79,79
17460,FremontBridge,09/30/2014 12:00:00 PM,48,-122,0,75,75
17461,FremontBridge,09/30/2014 01:00:00 PM,48,-122,0,86,86
17462,FremontBridge,09/30/2014 02:00:00 PM,48,-122,14,75,89
17463,FremontBridge,09/30/2014 03:00:00 PM,48,-122,73,85,158
17464,FremontBridge,09/30/2014 04:00:00 PM,48,-122,165,90,255
17465,FremontBridge,09/30/2014 05:00:00 PM,48,-122,379,191,570
17466,FremontBridge,09/30/2014 06:00:00 PM,48,-122,292,151,443
17467,FremontBridge,09/30/2014 07:00:00 PM,48,-122,106,96,202
17468,FremontBridge,09/30/2014 08:00:00 PM,48,-122,64,31,95
17469,FremontBridge,09/30/2014 09:00:00 PM,48,-122,48,21,69
17470,FremontBridge,09/30/2014 10:00:00 PM,48,-122,21,13,34
17471,FremontBridge,09/30/2014 11:00:00 PM,48,-122,11,9,20
17472,FremontBridge,10/01/2014 12:00:00 AM,48,-122,6,5,11
17473,FremontBridge,10/01/2014 01:00:00 AM,48,-122,2,4,6
17474,FremontBridge,10/01/2014 02:00:00 AM,48,-122,4,0,4
17475,FremontBridge,10/01/2014 03:00:00 AM,48,-122,3,1,4
17476,FremontBridge,10/01/2014 04:00:00 AM,48,-122,3,7,10
17477,FremontBridge,10/01/2014 05:00:00 AM,48,-122,14,23,37
17478,FremontBridge,10/01/2014 06:00:00 AM,48,-122,39,93,132
17479,FremontBridge,10/01/2014 07:00:00 AM,48,-122,108,283,391
17480,FremontBridge,10/01/2014 08:00:00 AM,48,-122,170,380,550
17481,FremontBridge,10/01/2014 09:00:00 AM,48,-122,17,218,235
17482,FremontBridge,10/01/2014 10:00:00 AM,48,-122,0,109,109
17483,FremontBridge,10/01/2014 11:00:00 AM,48,-122,0,77,77
17484,FremontBridge,10/01/2014 12:00:00 PM,48,-122,1,70,71
17485,FremontBridge,10/01/2014 01:00:00 PM,48,-122,0,71,71
17486,FremontBridge,10/01/2014 02:00:00 PM,48,-122,35,75,110
17487,FremontBridge,10/01/2014 03:00:00 PM,48,-122,84,82,166
17488,FremontBridge,10/01/2014 04:00:00 PM,48,-122,203,123,326
17489,FremontBridge,10/01/2014 05:00:00 PM,48,-122,439,200,639
17490,FremontBridge,10/01/2014 06:00:00 PM,48,-122,309,169,478
17491,FremontBridge,10/01/2014 07:00:00 PM,48,-122,107,78,185
17492,FremontBridge,10/01/2014 08:00:00 PM,48,-122,49,45,94
17493,FremontBridge,10/01/2014 09:00:00 PM,48,-122,36,24,60
17494,FremontBridge,10/01/2014 10:00:00 PM,48,-122,22,27,49
17495,FremontBridge,10/01/2014 11:00:00 PM,48,-122,12,10,22
17496,FremontBridge,10/02/2014 12:00:00 AM,48,-122,8,13,21
17497,FremontBridge,10/02/2014 01:00:00 AM,48,-122,1,0,1
17498,FremontBridge,10/02/2014 02:00:00 AM,48,-122,3,2,5
17499,FremontBridge,10/02/2014 03:00:00 AM,48,-122,0,3,3
17500,FremontBridge,10/02/2014 04:00:00 AM,48,-122,3,5,8
17501,FremontBridge,10/02/2014 05:00:00 AM,48,-122,10,23,33
17502,FremontBridge,10/02/2014 06:00:00 AM,48,-122,37,71,108
17503,FremontBridge,10/02/2014 07:00:00 AM,48,-122,110,284,394
17504,FremontBridge,10/02/2014 08:00:00 AM,48,-122,180,397,577
17505,FremontBridge,10/02/2014 09:00:00 AM,48,-122,23,236,259
17506,FremontBridge,10/02/2014 10:00:00 AM,48,-122,0,112,112
17507,FremontBridge,10/02/2014 11:00:00 AM,48,-122,1,93,94
17508,FremontBridge,10/02/2014 12:00:00 PM,48,-122,0,101,101
17509,FremontBridge,10/02/2014 01:00:00 PM,48,-122,0,77,77
17510,FremontBridge,10/02/2014 02:00:00 PM,48,-122,9,92,101
17511,FremontBridge,10/02/2014 03:00:00 PM,48,-122,91,73,164
17512,FremontBridge,10/02/2014 04:00:00 PM,48,-122,181,119,300
17513,FremontBridge,10/02/2014 05:00:00 PM,48,-122,423,188,611
17514,FremontBridge,10/02/2014 06:00:00 PM,48,-122,287,170,457
17515,FremontBridge,10/02/2014 07:00:00 PM,48,-122,138,79,217
17516,FremontBridge,10/02/2014 08:00:00 PM,48,-122,69,37,106
17517,FremontBridge,10/02/2014 09:00:00 PM,48,-122,50,25,75
17518,FremontBridge,10/02/2014 10:00:00 PM,48,-122,20,19,39
17519,FremontBridge,10/02/2014 11:00:00 PM,48,-122,20,13,33
17520,FremontBridge,10/03/2014 12:00:00 AM,48,-122,3,9,12
17521,FremontBridge,10/03/2014 01:00:00 AM,48,-122,9,7,16
17522,FremontBridge,10/03/2014 02:00:00 AM,48,-122,6,2,8
17523,FremontBridge,10/03/2014 03:00:00 AM,48,-122,0,3,3
17524,FremontBridge,10/03/2014 04:00:00 AM,48,-122,2,5,7
17525,FremontBridge,10/03/2014 05:00:00 AM,48,-122,8,23,31
17526,FremontBridge,10/03/2014 06:00:00 AM,48,-122,42,78,120
17527,FremontBridge,10/03/2014 07:00:00 AM,48,-122,87,249,336
17528,FremontBridge,10/03/2014 08:00:00 AM,48,-122,146,334,480
17529,FremontBridge,10/03/2014 09:00:00 AM,48,-122,23,230,253
17530,FremontBridge,10/03/2014 10:00:00 AM,48,-122,0,114,114
17531,FremontBridge,10/03/2014 11:00:00 AM,48,-122,1,83,84
17532,FremontBridge,10/03/2014 12:00:00 PM,48,-122,1,96,97
17533,FremontBridge,10/03/2014 01:00:00 PM,48,-122,0,94,94
17534,FremontBridge,10/03/2014 02:00:00 PM,48,-122,14,134,148
17535,FremontBridge,10/03/2014 03:00:00 PM,48,-122,99,92,191
17536,FremontBridge,10/03/2014 04:00:00 PM,48,-122,212,144,356
17537,FremontBridge,10/03/2014 05:00:00 PM,48,-122,381,184,565
17538,FremontBridge,10/03/2014 06:00:00 PM,48,-122,258,151,409
17539,FremontBridge,10/03/2014 07:00:00 PM,48,-122,91,75,166
17540,FremontBridge,10/03/2014 08:00:00 PM,48,-122,43,43,86
17541,FremontBridge,10/03/2014 09:00:00 PM,48,-122,30,18,48
17542,FremontBridge,10/03/2014 10:00:00 PM,48,-122,25,29,54
17543,FremontBridge,10/03/2014 11:00:00 PM,48,-122,10,21,31
17544,FremontBridge,10/04/2014 12:00:00 AM,48,-122,14,14,28
17545,FremontBridge,10/04/2014 01:00:00 AM,48,-122,5,7,12
17546,FremontBridge,10/04/2014 02:00:00 AM,48,-122,4,2,6
17547,FremontBridge,10/04/2014 03:00:00 AM,48,-122,2,3,5
17548,FremontBridge,10/04/2014 04:00:00 AM,48,-122,2,3,5
17549,FremontBridge,10/04/2014 05:00:00 AM,48,-122,2,4,6
17550,FremontBridge,10/04/2014 06:00:00 AM,48,-122,10,10,20
17551,FremontBridge,10/04/2014 07:00:00 AM,48,-122,23,26,49
17552,FremontBridge,10/04/2014 08:00:00 AM,48,-122,39,44,83
17553,FremontBridge,10/04/2014 09:00:00 AM,48,-122,46,82,128
17554,FremontBridge,10/04/2014 10:00:00 AM,48,-122,49,70,119
17555,FremontBridge,10/04/2014 11:00:00 AM,48,-122,69,94,163
17556,FremontBridge,10/04/2014 12:00:00 PM,48,-122,53,110,163
17557,FremontBridge,10/04/2014 01:00:00 PM,48,-122,85,107,192
17558,FremontBridge,10/04/2014 02:00:00 PM,48,-122,90,88,178
17559,FremontBridge,10/04/2014 03:00:00 PM,48,-122,74,87,161
17560,FremontBridge,10/04/2014 04:00:00 PM,48,-122,79,84,163
17561,FremontBridge,10/04/2014 05:00:00 PM,48,-122,65,88,153
17562,FremontBridge,10/04/2014 06:00:00 PM,48,-122,60,49,109
17563,FremontBridge,10/04/2014 07:00:00 PM,48,-122,31,33,64
17564,FremontBridge,10/04/2014 08:00:00 PM,48,-122,31,18,49
17565,FremontBridge,10/04/2014 09:00:00 PM,48,-122,19,12,31
17566,FremontBridge,10/04/2014 10:00:00 PM,48,-122,15,12,27
17567,FremontBridge,10/04/2014 11:00:00 PM,48,-122,13,13,26
17568,FremontBridge,10/05/2014 12:00:00 AM,48,-122,12,7,19
17569,FremontBridge,10/05/2014 01:00:00 AM,48,-122,7,3,10
17570,FremontBridge,10/05/2014 02:00:00 AM,48,-122,5,3,8
17571,FremontBridge,10/05/2014 03:00:00 AM,48,-122,0,0,0
17572,FremontBridge,10/05/2014 04:00:00 AM,48,-122,4,1,5
17573,FremontBridge,10/05/2014 05:00:00 AM,48,-122,5,5,10
17574,FremontBridge,10/05/2014 06:00:00 AM,48,-122,7,7,14
17575,FremontBridge,10/05/2014 07:00:00 AM,48,-122,17,18,35
17576,FremontBridge,10/05/2014 08:00:00 AM,48,-122,38,52,90
17577,FremontBridge,10/05/2014 09:00:00 AM,48,-122,44,73,117
17578,FremontBridge,10/05/2014 10:00:00 AM,48,-122,71,75,146
17579,FremontBridge,10/05/2014 11:00:00 AM,48,-122,72,96,168
17580,FremontBridge,10/05/2014 12:00:00 PM,48,-122,98,116,214
17581,FremontBridge,10/05/2014 01:00:00 PM,48,-122,83,118,201
17582,FremontBridge,10/05/2014 02:00:00 PM,48,-122,85,121,206
17583,FremontBridge,10/05/2014 03:00:00 PM,48,-122,104,124,228
17584,FremontBridge,10/05/2014 04:00:00 PM,48,-122,89,156,245
17585,FremontBridge,10/05/2014 05:00:00 PM,48,-122,89,83,172
17586,FremontBridge,10/05/2014 06:00:00 PM,48,-122,41,69,110
17587,FremontBridge,10/05/2014 07:00:00 PM,48,-122,30,29,59
17588,FremontBridge,10/05/2014 08:00:00 PM,48,-122,21,22,43
17589,FremontBridge,10/05/2014 09:00:00 PM,48,-122,14,13,27
17590,FremontBridge,10/05/2014 10:00:00 PM,48,-122,10,14,24
17591,FremontBridge,10/05/2014 11:00:00 PM,48,-122,4,7,11
17592,FremontBridge,10/06/2014 12:00:00 AM,48,-122,5,4,9
17593,FremontBridge,10/06/2014 01:00:00 AM,48,-122,1,4,5
17594,FremontBridge,10/06/2014 02:00:00 AM,48,-122,0,0,0
17595,FremontBridge,10/06/2014 03:00:00 AM,48,-122,2,5,7
17596,FremontBridge,10/06/2014 04:00:00 AM,48,-122,6,4,10
17597,FremontBridge,10/06/2014 05:00:00 AM,48,-122,13,24,37
17598,FremontBridge,10/06/2014 06:00:00 AM,48,-122,46,88,134
17599,FremontBridge,10/06/2014 07:00:00 AM,48,-122,108,292,400
17600,FremontBridge,10/06/2014 08:00:00 AM,48,-122,201,392,593
17601,FremontBridge,10/06/2014 09:00:00 AM,48,-122,10,257,267
17602,FremontBridge,10/06/2014 10:00:00 AM,48,-122,0,105,105
17603,FremontBridge,10/06/2014 11:00:00 AM,48,-122,0,94,94
17604,FremontBridge,10/06/2014 12:00:00 PM,48,-122,0,78,78
17605,FremontBridge,10/06/2014 01:00:00 PM,48,-122,0,80,80
17606,FremontBridge,10/06/2014 02:00:00 PM,48,-122,23,80,103
17607,FremontBridge,10/06/2014 03:00:00 PM,48,-122,96,74,170
17608,FremontBridge,10/06/2014 04:00:00 PM,48,-122,217,144,361
17609,FremontBridge,10/06/2014 05:00:00 PM,48,-122,512,221,733
17610,FremontBridge,10/06/2014 06:00:00 PM,48,-122,274,153,427
17611,FremontBridge,10/06/2014 07:00:00 PM,48,-122,123,79,202
17612,FremontBridge,10/06/2014 08:00:00 PM,48,-122,59,34,93
17613,FremontBridge,10/06/2014 09:00:00 PM,48,-122,60,36,96
17614,FremontBridge,10/06/2014 10:00:00 PM,48,-122,18,18,36
17615,FremontBridge,10/06/2014 11:00:00 PM,48,-122,19,15,34
17616,FremontBridge,10/07/2014 12:00:00 AM,48,-122,8,7,15
17617,FremontBridge,10/07/2014 01:00:00 AM,48,-122,3,4,7
17618,FremontBridge,10/07/2014 02:00:00 AM,48,-122,0,4,4
17619,FremontBridge,10/07/2014 03:00:00 AM,48,-122,2,1,3
17620,FremontBridge,10/07/2014 04:00:00 AM,48,-122,3,4,7
17621,FremontBridge,10/07/2014 05:00:00 AM,48,-122,19,25,44
17622,FremontBridge,10/07/2014 06:00:00 AM,48,-122,40,96,136
17623,FremontBridge,10/07/2014 07:00:00 AM,48,-122,101,315,416
17624,FremontBridge,10/07/2014 08:00:00 AM,48,-122,172,408,580
17625,FremontBridge,10/07/2014 09:00:00 AM,48,-122,21,216,237
17626,FremontBridge,10/07/2014 10:00:00 AM,48,-122,2,108,110
17627,FremontBridge,10/07/2014 11:00:00 AM,48,-122,1,83,84
17628,FremontBridge,10/07/2014 12:00:00 PM,48,-122,3,77,80
17629,FremontBridge,10/07/2014 01:00:00 PM,48,-122,2,71,73
17630,FremontBridge,10/07/2014 02:00:00 PM,48,-122,19,80,99
17631,FremontBridge,10/07/2014 03:00:00 PM,48,-122,78,64,142
17632,FremontBridge,10/07/2014 04:00:00 PM,48,-122,176,113,289
17633,FremontBridge,10/07/2014 05:00:00 PM,48,-122,426,213,639
17634,FremontBridge,10/07/2014 06:00:00 PM,48,-122,319,143,462
17635,FremontBridge,10/07/2014 07:00:00 PM,48,-122,142,87,229
17636,FremontBridge,10/07/2014 08:00:00 PM,48,-122,48,32,80
17637,FremontBridge,10/07/2014 09:00:00 PM,48,-122,35,30,65
17638,FremontBridge,10/07/2014 10:00:00 PM,48,-122,18,18,36
17639,FremontBridge,10/07/2014 11:00:00 PM,48,-122,15,12,27
17640,FremontBridge,10/08/2014 12:00:00 AM,48,-122,1,7,8
17641,FremontBridge,10/08/2014 01:00:00 AM,48,-122,4,1,5
17642,FremontBridge,10/08/2014 02:00:00 AM,48,-122,3,7,10
17643,FremontBridge,10/08/2014 03:00:00 AM,48,-122,1,3,4
17644,FremontBridge,10/08/2014 04:00:00 AM,48,-122,7,5,12
17645,FremontBridge,10/08/2014 05:00:00 AM,48,-122,11,22,33
17646,FremontBridge,10/08/2014 06:00:00 AM,48,-122,44,95,139
17647,FremontBridge,10/08/2014 07:00:00 AM,48,-122,94,292,386
17648,FremontBridge,10/08/2014 08:00:00 AM,48,-122,164,420,584
17649,FremontBridge,10/08/2014 09:00:00 AM,48,-122,28,219,247
17650,FremontBridge,10/08/2014 10:00:00 AM,48,-122,0,82,82
17651,FremontBridge,10/08/2014 11:00:00 AM,48,-122,4,57,61
17652,FremontBridge,10/08/2014 12:00:00 PM,48,-122,5,63,68
17653,FremontBridge,10/08/2014 01:00:00 PM,48,-122,2,75,77
17654,FremontBridge,10/08/2014 02:00:00 PM,48,-122,15,96,111
17655,FremontBridge,10/08/2014 03:00:00 PM,48,-122,79,68,147
17656,FremontBridge,10/08/2014 04:00:00 PM,48,-122,181,126,307
17657,FremontBridge,10/08/2014 05:00:00 PM,48,-122,431,195,626
17658,FremontBridge,10/08/2014 06:00:00 PM,48,-122,306,184,490
17659,FremontBridge,10/08/2014 07:00:00 PM,48,-122,105,62,167
17660,FremontBridge,10/08/2014 08:00:00 PM,48,-122,66,21,87
17661,FremontBridge,10/08/2014 09:00:00 PM,48,-122,48,23,71
17662,FremontBridge,10/08/2014 10:00:00 PM,48,-122,14,24,38
17663,FremontBridge,10/08/2014 11:00:00 PM,48,-122,9,11,20
17664,FremontBridge,10/09/2014 12:00:00 AM,48,-122,6,9,15
17665,FremontBridge,10/09/2014 01:00:00 AM,48,-122,7,1,8
17666,FremontBridge,10/09/2014 02:00:00 AM,48,-122,0,3,3
17667,FremontBridge,10/09/2014 03:00:00 AM,48,-122,0,0,0
17668,FremontBridge,10/09/2014 04:00:00 AM,48,-122,2,9,11
17669,FremontBridge,10/09/2014 05:00:00 AM,48,-122,15,24,39
17670,FremontBridge,10/09/2014 06:00:00 AM,48,-122,49,77,126
17671,FremontBridge,10/09/2014 07:00:00 AM,48,-122,104,273,377
17672,FremontBridge,10/09/2014 08:00:00 AM,48,-122,165,361,526
17673,FremontBridge,10/09/2014 09:00:00 AM,48,-122,17,239,256
17674,FremontBridge,10/09/2014 10:00:00 AM,48,-122,1,89,90
17675,FremontBridge,10/09/2014 11:00:00 AM,48,-122,1,85,86
17676,FremontBridge,10/09/2014 12:00:00 PM,48,-122,3,79,82
17677,FremontBridge,10/09/2014 01:00:00 PM,48,-122,0,91,91
17678,FremontBridge,10/09/2014 02:00:00 PM,48,-122,3,72,75
17679,FremontBridge,10/09/2014 03:00:00 PM,48,-122,74,68,142
17680,FremontBridge,10/09/2014 04:00:00 PM,48,-122,164,113,277
17681,FremontBridge,10/09/2014 05:00:00 PM,48,-122,388,188,576
17682,FremontBridge,10/09/2014 06:00:00 PM,48,-122,303,167,470
17683,FremontBridge,10/09/2014 07:00:00 PM,48,-122,109,60,169
17684,FremontBridge,10/09/2014 08:00:00 PM,48,-122,73,34,107
17685,FremontBridge,10/09/2014 09:00:00 PM,48,-122,31,27,58
17686,FremontBridge,10/09/2014 10:00:00 PM,48,-122,29,23,52
17687,FremontBridge,10/09/2014 11:00:00 PM,48,-122,13,14,27
17688,FremontBridge,10/10/2014 12:00:00 AM,48,-122,14,18,32
17689,FremontBridge,10/10/2014 01:00:00 AM,48,-122,1,6,7
17690,FremontBridge,10/10/2014 02:00:00 AM,48,-122,5,6,11
17691,FremontBridge,10/10/2014 03:00:00 AM,48,-122,2,2,4
17692,FremontBridge,10/10/2014 04:00:00 AM,48,-122,1,5,6
17693,FremontBridge,10/10/2014 05:00:00 AM,48,-122,11,19,30
17694,FremontBridge,10/10/2014 06:00:00 AM,48,-122,31,60,91
17695,FremontBridge,10/10/2014 07:00:00 AM,48,-122,81,197,278
17696,FremontBridge,10/10/2014 08:00:00 AM,48,-122,121,320,441
17697,FremontBridge,10/10/2014 09:00:00 AM,48,-122,24,172,196
17698,FremontBridge,10/10/2014 10:00:00 AM,48,-122,4,84,88
17699,FremontBridge,10/10/2014 11:00:00 AM,48,-122,2,72,74
17700,FremontBridge,10/10/2014 12:00:00 PM,48,-122,3,56,59
17701,FremontBridge,10/10/2014 01:00:00 PM,48,-122,3,73,76
17702,FremontBridge,10/10/2014 02:00:00 PM,48,-122,7,82,89
17703,FremontBridge,10/10/2014 03:00:00 PM,48,-122,67,67,134
17704,FremontBridge,10/10/2014 04:00:00 PM,48,-122,159,106,265
17705,FremontBridge,10/10/2014 05:00:00 PM,48,-122,302,164,466
17706,FremontBridge,10/10/2014 06:00:00 PM,48,-122,171,123,294
17707,FremontBridge,10/10/2014 07:00:00 PM,48,-122,89,40,129
17708,FremontBridge,10/10/2014 08:00:00 PM,48,-122,38,21,59
17709,FremontBridge,10/10/2014 09:00:00 PM,48,-122,26,14,40
17710,FremontBridge,10/10/2014 10:00:00 PM,48,-122,39,14,53
17711,FremontBridge,10/10/2014 11:00:00 PM,48,-122,14,21,35
17712,FremontBridge,10/11/2014 12:00:00 AM,48,-122,11,3,14
17713,FremontBridge,10/11/2014 01:00:00 AM,48,-122,10,5,15
17714,FremontBridge,10/11/2014 02:00:00 AM,48,-122,2,5,7
17715,FremontBridge,10/11/2014 03:00:00 AM,48,-122,0,3,3
17716,FremontBridge,10/11/2014 04:00:00 AM,48,-122,1,4,5
17717,FremontBridge,10/11/2014 05:00:00 AM,48,-122,3,9,12
17718,FremontBridge,10/11/2014 06:00:00 AM,48,-122,8,10,18
17719,FremontBridge,10/11/2014 07:00:00 AM,48,-122,8,18,26
17720,FremontBridge,10/11/2014 08:00:00 AM,48,-122,28,53,81
17721,FremontBridge,10/11/2014 09:00:00 AM,48,-122,28,63,91
17722,FremontBridge,10/11/2014 10:00:00 AM,48,-122,34,34,68
17723,FremontBridge,10/11/2014 11:00:00 AM,48,-122,31,53,84
17724,FremontBridge,10/11/2014 12:00:00 PM,48,-122,27,51,78
17725,FremontBridge,10/11/2014 01:00:00 PM,48,-122,35,27,62
17726,FremontBridge,10/11/2014 02:00:00 PM,48,-122,35,47,82
17727,FremontBridge,10/11/2014 03:00:00 PM,48,-122,47,52,99
17728,FremontBridge,10/11/2014 04:00:00 PM,48,-122,33,59,92
17729,FremontBridge,10/11/2014 05:00:00 PM,48,-122,44,58,102
17730,FremontBridge,10/11/2014 06:00:00 PM,48,-122,23,35,58
17731,FremontBridge,10/11/2014 07:00:00 PM,48,-122,23,18,41
17732,FremontBridge,10/11/2014 08:00:00 PM,48,-122,16,10,26
17733,FremontBridge,10/11/2014 09:00:00 PM,48,-122,14,16,30
17734,FremontBridge,10/11/2014 10:00:00 PM,48,-122,11,9,20
17735,FremontBridge,10/11/2014 11:00:00 PM,48,-122,11,6,17
17736,FremontBridge,10/12/2014 12:00:00 AM,48,-122,15,7,22
17737,FremontBridge,10/12/2014 01:00:00 AM,48,-122,5,0,5
17738,FremontBridge,10/12/2014 02:00:00 AM,48,-122,3,8,11
17739,FremontBridge,10/12/2014 03:00:00 AM,48,-122,0,4,4
17740,FremontBridge,10/12/2014 04:00:00 AM,48,-122,3,4,7
17741,FremontBridge,10/12/2014 05:00:00 AM,48,-122,1,2,3
17742,FremontBridge,10/12/2014 06:00:00 AM,48,-122,4,4,8
17743,FremontBridge,10/12/2014 07:00:00 AM,48,-122,6,16,22
17744,FremontBridge,10/12/2014 08:00:00 AM,48,-122,33,34,67
17745,FremontBridge,10/12/2014 09:00:00 AM,48,-122,59,78,137
17746,FremontBridge,10/12/2014 10:00:00 AM,48,-122,56,78,134
17747,FremontBridge,10/12/2014 11:00:00 AM,48,-122,45,95,140
17748,FremontBridge,10/12/2014 12:00:00 PM,48,-122,72,80,152
17749,FremontBridge,10/12/2014 01:00:00 PM,48,-122,46,86,132
17750,FremontBridge,10/12/2014 02:00:00 PM,48,-122,71,65,136
17751,FremontBridge,10/12/2014 03:00:00 PM,48,-122,67,67,134
17752,FremontBridge,10/12/2014 04:00:00 PM,48,-122,62,65,127
17753,FremontBridge,10/12/2014 05:00:00 PM,48,-122,52,65,117
17754,FremontBridge,10/12/2014 06:00:00 PM,48,-122,32,39,71
17755,FremontBridge,10/12/2014 07:00:00 PM,48,-122,29,15,44
17756,FremontBridge,10/12/2014 08:00:00 PM,48,-122,23,7,30
17757,FremontBridge,10/12/2014 09:00:00 PM,48,-122,8,6,14
17758,FremontBridge,10/12/2014 10:00:00 PM,48,-122,17,9,26
17759,FremontBridge,10/12/2014 11:00:00 PM,48,-122,11,5,16
17760,FremontBridge,10/13/2014 12:00:00 AM,48,-122,5,8,13
17761,FremontBridge,10/13/2014 01:00:00 AM,48,-122,1,2,3
17762,FremontBridge,10/13/2014 02:00:00 AM,48,-122,4,0,4
17763,FremontBridge,10/13/2014 03:00:00 AM,48,-122,1,3,4
17764,FremontBridge,10/13/2014 04:00:00 AM,48,-122,4,5,9
17765,FremontBridge,10/13/2014 05:00:00 AM,48,-122,14,23,37
17766,FremontBridge,10/13/2014 06:00:00 AM,48,-122,43,72,115
17767,FremontBridge,10/13/2014 07:00:00 AM,48,-122,81,246,327
17768,FremontBridge,10/13/2014 08:00:00 AM,48,-122,154,344,498
17769,FremontBridge,10/13/2014 09:00:00 AM,48,-122,21,234,255
17770,FremontBridge,10/13/2014 10:00:00 AM,48,-122,0,108,108
17771,FremontBridge,10/13/2014 11:00:00 AM,48,-122,3,79,82
17772,FremontBridge,10/13/2014 12:00:00 PM,48,-122,0,91,91
17773,FremontBridge,10/13/2014 01:00:00 PM,48,-122,4,77,81
17774,FremontBridge,10/13/2014 02:00:00 PM,48,-122,7,110,117
17775,FremontBridge,10/13/2014 03:00:00 PM,48,-122,57,69,126
17776,FremontBridge,10/13/2014 04:00:00 PM,48,-122,188,115,303
17777,FremontBridge,10/13/2014 05:00:00 PM,48,-122,380,156,536
17778,FremontBridge,10/13/2014 06:00:00 PM,48,-122,248,116,364
17779,FremontBridge,10/13/2014 07:00:00 PM,48,-122,83,52,135
17780,FremontBridge,10/13/2014 08:00:00 PM,48,-122,47,22,69
17781,FremontBridge,10/13/2014 09:00:00 PM,48,-122,24,15,39
17782,FremontBridge,10/13/2014 10:00:00 PM,48,-122,13,13,26
17783,FremontBridge,10/13/2014 11:00:00 PM,48,-122,6,7,13
17784,FremontBridge,10/14/2014 12:00:00 AM,48,-122,4,2,6
17785,FremontBridge,10/14/2014 01:00:00 AM,48,-122,0,3,3
17786,FremontBridge,10/14/2014 02:00:00 AM,48,-122,1,1,2
17787,FremontBridge,10/14/2014 03:00:00 AM,48,-122,1,1,2
17788,FremontBridge,10/14/2014 04:00:00 AM,48,-122,1,5,6
17789,FremontBridge,10/14/2014 05:00:00 AM,48,-122,7,19,26
17790,FremontBridge,10/14/2014 06:00:00 AM,48,-122,37,77,114
17791,FremontBridge,10/14/2014 07:00:00 AM,48,-122,82,231,313
17792,FremontBridge,10/14/2014 08:00:00 AM,48,-122,154,328,482
17793,FremontBridge,10/14/2014 09:00:00 AM,48,-122,77,158,235
17794,FremontBridge,10/14/2014 10:00:00 AM,48,-122,25,62,87
17795,FremontBridge,10/14/2014 11:00:00 AM,48,-122,23,44,67
17796,FremontBridge,10/14/2014 12:00:00 PM,48,-122,23,40,63
17797,FremontBridge,10/14/2014 01:00:00 PM,48,-122,34,44,78
17798,FremontBridge,10/14/2014 02:00:00 PM,48,-122,34,46,80
17799,FremontBridge,10/14/2014 03:00:00 PM,48,-122,74,56,130
17800,FremontBridge,10/14/2014 04:00:00 PM,48,-122,138,93,231
17801,FremontBridge,10/14/2014 05:00:00 PM,48,-122,365,156,521
17802,FremontBridge,10/14/2014 06:00:00 PM,48,-122,257,157,414
17803,FremontBridge,10/14/2014 07:00:00 PM,48,-122,107,52,159
17804,FremontBridge,10/14/2014 08:00:00 PM,48,-122,38,23,61
17805,FremontBridge,10/14/2014 09:00:00 PM,48,-122,38,27,65
17806,FremontBridge,10/14/2014 10:00:00 PM,48,-122,14,16,30
17807,FremontBridge,10/14/2014 11:00:00 PM,48,-122,16,6,22
17808,FremontBridge,10/15/2014 12:00:00 AM,48,-122,4,5,9
17809,FremontBridge,10/15/2014 01:00:00 AM,48,-122,5,3,8
17810,FremontBridge,10/15/2014 02:00:00 AM,48,-122,3,2,5
17811,FremontBridge,10/15/2014 03:00:00 AM,48,-122,2,2,4
17812,FremontBridge,10/15/2014 04:00:00 AM,48,-122,2,6,8
17813,FremontBridge,10/15/2014 05:00:00 AM,48,-122,11,23,34
17814,FremontBridge,10/15/2014 06:00:00 AM,48,-122,28,69,97
17815,FremontBridge,10/15/2014 07:00:00 AM,48,-122,87,208,295
17816,FremontBridge,10/15/2014 08:00:00 AM,48,-122,99,237,336
17817,FremontBridge,10/15/2014 09:00:00 AM,48,-122,26,139,165
17818,FremontBridge,10/15/2014 10:00:00 AM,48,-122,0,76,76
17819,FremontBridge,10/15/2014 11:00:00 AM,48,-122,2,50,52
17820,FremontBridge,10/15/2014 12:00:00 PM,48,-122,0,33,33
17821,FremontBridge,10/15/2014 01:00:00 PM,48,-122,2,41,43
17822,FremontBridge,10/15/2014 02:00:00 PM,48,-122,25,33,58
17823,FremontBridge,10/15/2014 03:00:00 PM,48,-122,46,35,81
17824,FremontBridge,10/15/2014 04:00:00 PM,48,-122,125,75,200
17825,FremontBridge,10/15/2014 05:00:00 PM,48,-122,300,126,426
17826,FremontBridge,10/15/2014 06:00:00 PM,48,-122,191,128,319
17827,FremontBridge,10/15/2014 07:00:00 PM,48,-122,88,42,130
17828,FremontBridge,10/15/2014 08:00:00 PM,48,-122,45,18,63
17829,FremontBridge,10/15/2014 09:00:00 PM,48,-122,29,31,60
17830,FremontBridge,10/15/2014 10:00:00 PM,48,-122,10,25,35
17831,FremontBridge,10/15/2014 11:00:00 PM,48,-122,10,8,18
17832,FremontBridge,10/16/2014 12:00:00 AM,48,-122,9,5,14
17833,FremontBridge,10/16/2014 01:00:00 AM,48,-122,3,1,4
17834,FremontBridge,10/16/2014 02:00:00 AM,48,-122,0,3,3
17835,FremontBridge,10/16/2014 03:00:00 AM,48,-122,0,1,1
17836,FremontBridge,10/16/2014 04:00:00 AM,48,-122,1,6,7
17837,FremontBridge,10/16/2014 05:00:00 AM,48,-122,12,20,32
17838,FremontBridge,10/16/2014 06:00:00 AM,48,-122,41,82,123
17839,FremontBridge,10/16/2014 07:00:00 AM,48,-122,79,233,312
17840,FremontBridge,10/16/2014 08:00:00 AM,48,-122,152,358,510
17841,FremontBridge,10/16/2014 09:00:00 AM,48,-122,19,260,279
17842,FremontBridge,10/16/2014 10:00:00 AM,48,-122,1,98,99
17843,FremontBridge,10/16/2014 11:00:00 AM,48,-122,2,67,69
17844,FremontBridge,10/16/2014 12:00:00 PM,48,-122,1,64,65
17845,FremontBridge,10/16/2014 01:00:00 PM,48,-122,1,70,71
17846,FremontBridge,10/16/2014 02:00:00 PM,48,-122,10,103,113
17847,FremontBridge,10/16/2014 03:00:00 PM,48,-122,103,80,183
17848,FremontBridge,10/16/2014 04:00:00 PM,48,-122,180,119,299
17849,FremontBridge,10/16/2014 05:00:00 PM,48,-122,386,199,585
17850,FremontBridge,10/16/2014 06:00:00 PM,48,-122,279,184,463
17851,FremontBridge,10/16/2014 07:00:00 PM,48,-122,101,70,171
17852,FremontBridge,10/16/2014 08:00:00 PM,48,-122,55,37,92
17853,FremontBridge,10/16/2014 09:00:00 PM,48,-122,40,32,72
17854,FremontBridge,10/16/2014 10:00:00 PM,48,-122,18,22,40
17855,FremontBridge,10/16/2014 11:00:00 PM,48,-122,10,12,22
17856,FremontBridge,10/17/2014 12:00:00 AM,48,-122,7,11,18
17857,FremontBridge,10/17/2014 01:00:00 AM,48,-122,3,7,10
17858,FremontBridge,10/17/2014 02:00:00 AM,48,-122,2,2,4
17859,FremontBridge,10/17/2014 03:00:00 AM,48,-122,0,1,1
17860,FremontBridge,10/17/2014 04:00:00 AM,48,-122,5,4,9
17861,FremontBridge,10/17/2014 05:00:00 AM,48,-122,6,18,24
17862,FremontBridge,10/17/2014 06:00:00 AM,48,-122,24,62,86
17863,FremontBridge,10/17/2014 07:00:00 AM,48,-122,56,138,194
17864,FremontBridge,10/17/2014 08:00:00 AM,48,-122,96,257,353
17865,FremontBridge,10/17/2014 09:00:00 AM,48,-122,27,159,186
17866,FremontBridge,10/17/2014 10:00:00 AM,48,-122,3,76,79
17867,FremontBridge,10/17/2014 11:00:00 AM,48,-122,4,57,61
17868,FremontBridge,10/17/2014 12:00:00 PM,48,-122,7,29,36
17869,FremontBridge,10/17/2014 01:00:00 PM,48,-122,24,28,52
17870,FremontBridge,10/17/2014 02:00:00 PM,48,-122,22,28,50
17871,FremontBridge,10/17/2014 03:00:00 PM,48,-122,36,26,62
17872,FremontBridge,10/17/2014 04:00:00 PM,48,-122,129,58,187
17873,FremontBridge,10/17/2014 05:00:00 PM,48,-122,235,103,338
17874,FremontBridge,10/17/2014 06:00:00 PM,48,-122,167,91,258
17875,FremontBridge,10/17/2014 07:00:00 PM,48,-122,57,31,88
17876,FremontBridge,10/17/2014 08:00:00 PM,48,-122,19,22,41
17877,FremontBridge,10/17/2014 09:00:00 PM,48,-122,16,14,30
17878,FremontBridge,10/17/2014 10:00:00 PM,48,-122,16,7,23
17879,FremontBridge,10/17/2014 11:00:00 PM,48,-122,12,7,19
17880,FremontBridge,10/18/2014 12:00:00 AM,48,-122,6,2,8
17881,FremontBridge,10/18/2014 01:00:00 AM,48,-122,5,7,12
17882,FremontBridge,10/18/2014 02:00:00 AM,48,-122,3,2,5
17883,FremontBridge,10/18/2014 03:00:00 AM,48,-122,0,2,2
17884,FremontBridge,10/18/2014 04:00:00 AM,48,-122,0,0,0
17885,FremontBridge,10/18/2014 05:00:00 AM,48,-122,1,5,6
17886,FremontBridge,10/18/2014 06:00:00 AM,48,-122,7,12,19
17887,FremontBridge,10/18/2014 07:00:00 AM,48,-122,10,21,31
17888,FremontBridge,10/18/2014 08:00:00 AM,48,-122,24,29,53
17889,FremontBridge,10/18/2014 09:00:00 AM,48,-122,35,68,103
17890,FremontBridge,10/18/2014 10:00:00 AM,48,-122,17,51,68
17891,FremontBridge,10/18/2014 11:00:00 AM,48,-122,37,52,89
17892,FremontBridge,10/18/2014 12:00:00 PM,48,-122,38,58,96
17893,FremontBridge,10/18/2014 01:00:00 PM,48,-122,55,77,132
17894,FremontBridge,10/18/2014 02:00:00 PM,48,-122,58,50,108
17895,FremontBridge,10/18/2014 03:00:00 PM,48,-122,48,68,116
17896,FremontBridge,10/18/2014 04:00:00 PM,48,-122,48,72,120
17897,FremontBridge,10/18/2014 05:00:00 PM,48,-122,43,65,108
17898,FremontBridge,10/18/2014 06:00:00 PM,48,-122,44,51,95
17899,FremontBridge,10/18/2014 07:00:00 PM,48,-122,37,41,78
17900,FremontBridge,10/18/2014 08:00:00 PM,48,-122,15,20,35
17901,FremontBridge,10/18/2014 09:00:00 PM,48,-122,20,19,39
17902,FremontBridge,10/18/2014 10:00:00 PM,48,-122,17,16,33
17903,FremontBridge,10/18/2014 11:00:00 PM,48,-122,15,7,22
17904,FremontBridge,10/19/2014 12:00:00 AM,48,-122,24,8,32
17905,FremontBridge,10/19/2014 01:00:00 AM,48,-122,3,6,9
17906,FremontBridge,10/19/2014 02:00:00 AM,48,-122,11,8,19
17907,FremontBridge,10/19/2014 03:00:00 AM,48,-122,4,1,5
17908,FremontBridge,10/19/2014 04:00:00 AM,48,-122,1,2,3
17909,FremontBridge,10/19/2014 05:00:00 AM,48,-122,0,0,0
17910,FremontBridge,10/19/2014 06:00:00 AM,48,-122,10,11,21
17911,FremontBridge,10/19/2014 07:00:00 AM,48,-122,4,18,22
17912,FremontBridge,10/19/2014 08:00:00 AM,48,-122,31,36,67
17913,FremontBridge,10/19/2014 09:00:00 AM,48,-122,53,59,112
17914,FremontBridge,10/19/2014 10:00:00 AM,48,-122,36,84,120
17915,FremontBridge,10/19/2014 11:00:00 AM,48,-122,69,87,156
17916,FremontBridge,10/19/2014 12:00:00 PM,48,-122,77,127,204
17917,FremontBridge,10/19/2014 01:00:00 PM,48,-122,104,115,219
17918,FremontBridge,10/19/2014 02:00:00 PM,48,-122,142,149,291
17919,FremontBridge,10/19/2014 03:00:00 PM,48,-122,106,160,266
17920,FremontBridge,10/19/2014 04:00:00 PM,48,-122,93,129,222
17921,FremontBridge,10/19/2014 05:00:00 PM,48,-122,101,121,222
17922,FremontBridge,10/19/2014 06:00:00 PM,48,-122,57,57,114
17923,FremontBridge,10/19/2014 07:00:00 PM,48,-122,18,25,43
17924,FremontBridge,10/19/2014 08:00:00 PM,48,-122,15,23,38
17925,FremontBridge,10/19/2014 09:00:00 PM,48,-122,16,11,27
17926,FremontBridge,10/19/2014 10:00:00 PM,48,-122,11,9,20
17927,FremontBridge,10/19/2014 11:00:00 PM,48,-122,8,8,16
17928,FremontBridge,10/20/2014 12:00:00 AM,48,-122,5,8,13
17929,FremontBridge,10/20/2014 01:00:00 AM,48,-122,4,4,8
17930,FremontBridge,10/20/2014 02:00:00 AM,48,-122,2,3,5
17931,FremontBridge,10/20/2014 03:00:00 AM,48,-122,0,2,2
17932,FremontBridge,10/20/2014 04:00:00 AM,48,-122,2,3,5
17933,FremontBridge,10/20/2014 05:00:00 AM,48,-122,9,20,29
17934,FremontBridge,10/20/2014 06:00:00 AM,48,-122,35,74,109
17935,FremontBridge,10/20/2014 07:00:00 AM,48,-122,78,208,286
17936,FremontBridge,10/20/2014 08:00:00 AM,48,-122,122,291,413
17937,FremontBridge,10/20/2014 09:00:00 AM,48,-122,69,154,223
17938,FremontBridge,10/20/2014 10:00:00 AM,48,-122,66,17,83
17939,FremontBridge,10/20/2014 11:00:00 AM,48,-122,45,0,45
17940,FremontBridge,10/20/2014 12:00:00 PM,48,-122,37,0,37
17941,FremontBridge,10/20/2014 01:00:00 PM,48,-122,48,0,48
17942,FremontBridge,10/20/2014 02:00:00 PM,48,-122,66,18,84
17943,FremontBridge,10/20/2014 03:00:00 PM,48,-122,53,53,106
17944,FremontBridge,10/20/2014 04:00:00 PM,48,-122,144,91,235
17945,FremontBridge,10/20/2014 05:00:00 PM,48,-122,314,146,460
17946,FremontBridge,10/20/2014 06:00:00 PM,48,-122,253,121,374
17947,FremontBridge,10/20/2014 07:00:00 PM,48,-122,86,43,129
17948,FremontBridge,10/20/2014 08:00:00 PM,48,-122,62,20,82
17949,FremontBridge,10/20/2014 09:00:00 PM,48,-122,23,27,50
17950,FremontBridge,10/20/2014 10:00:00 PM,48,-122,14,8,22
17951,FremontBridge,10/20/2014 11:00:00 PM,48,-122,7,3,10
17952,FremontBridge,10/21/2014 12:00:00 AM,48,-122,4,3,7
17953,FremontBridge,10/21/2014 01:00:00 AM,48,-122,2,5,7
17954,FremontBridge,10/21/2014 02:00:00 AM,48,-122,0,1,1
17955,FremontBridge,10/21/2014 03:00:00 AM,48,-122,0,2,2
17956,FremontBridge,10/21/2014 04:00:00 AM,48,-122,2,6,8
17957,FremontBridge,10/21/2014 05:00:00 AM,48,-122,7,21,28
17958,FremontBridge,10/21/2014 06:00:00 AM,48,-122,34,89,123
17959,FremontBridge,10/21/2014 07:00:00 AM,48,-122,70,185,255
17960,FremontBridge,10/21/2014 08:00:00 AM,48,-122,155,312,467
17961,FremontBridge,10/21/2014 09:00:00 AM,48,-122,84,168,252
17962,FremontBridge,10/21/2014 10:00:00 AM,48,-122,74,7,81
17963,FremontBridge,10/21/2014 11:00:00 AM,48,-122,66,0,66
17964,FremontBridge,10/21/2014 12:00:00 PM,48,-122,59,0,59
17965,FremontBridge,10/21/2014 01:00:00 PM,48,-122,70,0,70
17966,FremontBridge,10/21/2014 02:00:00 PM,48,-122,66,6,72
17967,FremontBridge,10/21/2014 03:00:00 PM,48,-122,63,56,119
17968,FremontBridge,10/21/2014 04:00:00 PM,48,-122,133,88,221
17969,FremontBridge,10/21/2014 05:00:00 PM,48,-122,335,147,482
17970,FremontBridge,10/21/2014 06:00:00 PM,48,-122,227,126,353
17971,FremontBridge,10/21/2014 07:00:00 PM,48,-122,79,45,124
17972,FremontBridge,10/21/2014 08:00:00 PM,48,-122,48,26,74
17973,FremontBridge,10/21/2014 09:00:00 PM,48,-122,29,21,50
17974,FremontBridge,10/21/2014 10:00:00 PM,48,-122,13,9,22
17975,FremontBridge,10/21/2014 11:00:00 PM,48,-122,13,8,21
17976,FremontBridge,10/22/2014 12:00:00 AM,48,-122,4,6,10
17977,FremontBridge,10/22/2014 01:00:00 AM,48,-122,5,3,8
17978,FremontBridge,10/22/2014 02:00:00 AM,48,-122,2,2,4
17979,FremontBridge,10/22/2014 03:00:00 AM,48,-122,1,1,2
17980,FremontBridge,10/22/2014 04:00:00 AM,48,-122,2,3,5
17981,FremontBridge,10/22/2014 05:00:00 AM,48,-122,8,18,26
17982,FremontBridge,10/22/2014 06:00:00 AM,48,-122,19,52,71
17983,FremontBridge,10/22/2014 07:00:00 AM,48,-122,59,140,199
17984,FremontBridge,10/22/2014 08:00:00 AM,48,-122,103,264,367
17985,FremontBridge,10/22/2014 09:00:00 AM,48,-122,66,148,214
17986,FremontBridge,10/22/2014 10:00:00 AM,48,-122,14,34,48
17987,FremontBridge,10/22/2014 11:00:00 AM,48,-122,23,24,47
17988,FremontBridge,10/22/2014 12:00:00 PM,48,-122,10,11,21
17989,FremontBridge,10/22/2014 01:00:00 PM,48,-122,13,20,33
17990,FremontBridge,10/22/2014 02:00:00 PM,48,-122,18,23,41
17991,FremontBridge,10/22/2014 03:00:00 PM,48,-122,28,22,50
17992,FremontBridge,10/22/2014 04:00:00 PM,48,-122,64,55,119
17993,FremontBridge,10/22/2014 05:00:00 PM,48,-122,224,108,332
17994,FremontBridge,10/22/2014 06:00:00 PM,48,-122,173,87,260
17995,FremontBridge,10/22/2014 07:00:00 PM,48,-122,68,45,113
17996,FremontBridge,10/22/2014 08:00:00 PM,48,-122,34,14,48
17997,FremontBridge,10/22/2014 09:00:00 PM,48,-122,16,20,36
17998,FremontBridge,10/22/2014 10:00:00 PM,48,-122,13,6,19
17999,FremontBridge,10/22/2014 11:00:00 PM,48,-122,7,7,14
18000,FremontBridge,10/23/2014 12:00:00 AM,48,-122,3,6,9
18001,FremontBridge,10/23/2014 01:00:00 AM,48,-122,3,0,3
18002,FremontBridge,10/23/2014 02:00:00 AM,48,-122,1,4,5
18003,FremontBridge,10/23/2014 03:00:00 AM,48,-122,2,2,4
18004,FremontBridge,10/23/2014 04:00:00 AM,48,-122,4,9,13
18005,FremontBridge,10/23/2014 05:00:00 AM,48,-122,7,16,23
18006,FremontBridge,10/23/2014 06:00:00 AM,48,-122,37,69,106
18007,FremontBridge,10/23/2014 07:00:00 AM,48,-122,60,149,209
18008,FremontBridge,10/23/2014 08:00:00 AM,48,-122,115,223,338
18009,FremontBridge,10/23/2014 09:00:00 AM,48,-122,65,123,188
18010,FremontBridge,10/23/2014 10:00:00 AM,48,-122,26,34,60
18011,FremontBridge,10/23/2014 11:00:00 AM,48,-122,27,36,63
18012,FremontBridge,10/23/2014 12:00:00 PM,48,-122,23,35,58
18013,FremontBridge,10/23/2014 01:00:00 PM,48,-122,31,23,54
18014,FremontBridge,10/23/2014 02:00:00 PM,48,-122,28,24,52
18015,FremontBridge,10/23/2014 03:00:00 PM,48,-122,48,51,99
18016,FremontBridge,10/23/2014 04:00:00 PM,48,-122,67,49,116
18017,FremontBridge,10/23/2014 05:00:00 PM,48,-122,268,116,384
18018,FremontBridge,10/23/2014 06:00:00 PM,48,-122,183,117,300
18019,FremontBridge,10/23/2014 07:00:00 PM,48,-122,77,38,115
18020,FremontBridge,10/23/2014 08:00:00 PM,48,-122,58,25,83
18021,FremontBridge,10/23/2014 09:00:00 PM,48,-122,30,20,50
18022,FremontBridge,10/23/2014 10:00:00 PM,48,-122,15,14,29
18023,FremontBridge,10/23/2014 11:00:00 PM,48,-122,11,9,20
18024,FremontBridge,10/24/2014 12:00:00 AM,48,-122,7,19,26
18025,FremontBridge,10/24/2014 01:00:00 AM,48,-122,1,6,7
18026,FremontBridge,10/24/2014 02:00:00 AM,48,-122,3,2,5
18027,FremontBridge,10/24/2014 03:00:00 AM,48,-122,2,2,4
18028,FremontBridge,10/24/2014 04:00:00 AM,48,-122,4,5,9
18029,FremontBridge,10/24/2014 05:00:00 AM,48,-122,8,15,23
18030,FremontBridge,10/24/2014 06:00:00 AM,48,-122,31,60,91
18031,FremontBridge,10/24/2014 07:00:00 AM,48,-122,57,189,246
18032,FremontBridge,10/24/2014 08:00:00 AM,48,-122,119,294,413
18033,FremontBridge,10/24/2014 09:00:00 AM,48,-122,88,153,241
18034,FremontBridge,10/24/2014 10:00:00 AM,48,-122,91,12,103
18035,FremontBridge,10/24/2014 11:00:00 AM,48,-122,61,1,62
18036,FremontBridge,10/24/2014 12:00:00 PM,48,-122,73,0,73
18037,FremontBridge,10/24/2014 01:00:00 PM,48,-122,69,1,70
18038,FremontBridge,10/24/2014 02:00:00 PM,48,-122,81,0,81
18039,FremontBridge,10/24/2014 03:00:00 PM,48,-122,83,50,133
18040,FremontBridge,10/24/2014 04:00:00 PM,48,-122,151,83,234
18041,FremontBridge,10/24/2014 05:00:00 PM,48,-122,292,129,421
18042,FremontBridge,10/24/2014 06:00:00 PM,48,-122,207,95,302
18043,FremontBridge,10/24/2014 07:00:00 PM,48,-122,68,42,110
18044,FremontBridge,10/24/2014 08:00:00 PM,48,-122,32,21,53
18045,FremontBridge,10/24/2014 09:00:00 PM,48,-122,21,11,32
18046,FremontBridge,10/24/2014 10:00:00 PM,48,-122,12,6,18
18047,FremontBridge,10/24/2014 11:00:00 PM,48,-122,9,12,21
18048,FremontBridge,10/25/2014 12:00:00 AM,48,-122,8,11,19
18049,FremontBridge,10/25/2014 01:00:00 AM,48,-122,3,4,7
18050,FremontBridge,10/25/2014 02:00:00 AM,48,-122,7,7,14
18051,FremontBridge,10/25/2014 03:00:00 AM,48,-122,2,5,7
18052,FremontBridge,10/25/2014 04:00:00 AM,48,-122,0,3,3
18053,FremontBridge,10/25/2014 05:00:00 AM,48,-122,2,3,5
18054,FremontBridge,10/25/2014 06:00:00 AM,48,-122,6,4,10
18055,FremontBridge,10/25/2014 07:00:00 AM,48,-122,9,6,15
18056,FremontBridge,10/25/2014 08:00:00 AM,48,-122,21,28,49
18057,FremontBridge,10/25/2014 09:00:00 AM,48,-122,21,20,41
18058,FremontBridge,10/25/2014 10:00:00 AM,48,-122,33,45,78
18059,FremontBridge,10/25/2014 11:00:00 AM,48,-122,37,41,78
18060,FremontBridge,10/25/2014 12:00:00 PM,48,-122,32,36,68
18061,FremontBridge,10/25/2014 01:00:00 PM,48,-122,26,34,60
18062,FremontBridge,10/25/2014 02:00:00 PM,48,-122,27,16,43
18063,FremontBridge,10/25/2014 03:00:00 PM,48,-122,33,24,57
18064,FremontBridge,10/25/2014 04:00:00 PM,48,-122,28,22,50
18065,FremontBridge,10/25/2014 05:00:00 PM,48,-122,24,18,42
18066,FremontBridge,10/25/2014 06:00:00 PM,48,-122,18,22,40
18067,FremontBridge,10/25/2014 07:00:00 PM,48,-122,7,4,11
18068,FremontBridge,10/25/2014 08:00:00 PM,48,-122,4,1,5
18069,FremontBridge,10/25/2014 09:00:00 PM,48,-122,7,4,11
18070,FremontBridge,10/25/2014 10:00:00 PM,48,-122,7,2,9
18071,FremontBridge,10/25/2014 11:00:00 PM,48,-122,6,12,18
18072,FremontBridge,10/26/2014 12:00:00 AM,48,-122,5,3,8
18073,FremontBridge,10/26/2014 01:00:00 AM,48,-122,0,3,3
18074,FremontBridge,10/26/2014 02:00:00 AM,48,-122,3,2,5
18075,FremontBridge,10/26/2014 03:00:00 AM,48,-122,0,1,1
18076,FremontBridge,10/26/2014 04:00:00 AM,48,-122,0,4,4
18077,FremontBridge,10/26/2014 05:00:00 AM,48,-122,4,1,5
18078,FremontBridge,10/26/2014 06:00:00 AM,48,-122,4,6,10
18079,FremontBridge,10/26/2014 07:00:00 AM,48,-122,7,8,15
18080,FremontBridge,10/26/2014 08:00:00 AM,48,-122,13,22,35
18081,FremontBridge,10/26/2014 09:00:00 AM,48,-122,33,38,71
18082,FremontBridge,10/26/2014 10:00:00 AM,48,-122,21,58,79
18083,FremontBridge,10/26/2014 11:00:00 AM,48,-122,27,37,64
18084,FremontBridge,10/26/2014 12:00:00 PM,48,-122,24,32,56
18085,FremontBridge,10/26/2014 01:00:00 PM,48,-122,43,37,80
18086,FremontBridge,10/26/2014 02:00:00 PM,48,-122,36,41,77
18087,FremontBridge,10/26/2014 03:00:00 PM,48,-122,23,38,61
18088,FremontBridge,10/26/2014 04:00:00 PM,48,-122,30,58,88
18089,FremontBridge,10/26/2014 05:00:00 PM,48,-122,30,46,76
18090,FremontBridge,10/26/2014 06:00:00 PM,48,-122,36,29,65
18091,FremontBridge,10/26/2014 07:00:00 PM,48,-122,26,19,45
18092,FremontBridge,10/26/2014 08:00:00 PM,48,-122,12,8,20
18093,FremontBridge,10/26/2014 09:00:00 PM,48,-122,19,4,23
18094,FremontBridge,10/26/2014 10:00:00 PM,48,-122,6,7,13
18095,FremontBridge,10/26/2014 11:00:00 PM,48,-122,7,5,12
18096,FremontBridge,10/27/2014 12:00:00 AM,48,-122,1,5,6
18097,FremontBridge,10/27/2014 01:00:00 AM,48,-122,1,1,2
18098,FremontBridge,10/27/2014 02:00:00 AM,48,-122,2,3,5
18099,FremontBridge,10/27/2014 03:00:00 AM,48,-122,3,2,5
18100,FremontBridge,10/27/2014 04:00:00 AM,48,-122,3,5,8
18101,FremontBridge,10/27/2014 05:00:00 AM,48,-122,15,30,45
18102,FremontBridge,10/27/2014 06:00:00 AM,48,-122,42,75,117
18103,FremontBridge,10/27/2014 07:00:00 AM,48,-122,79,228,307
18104,FremontBridge,10/27/2014 08:00:00 AM,48,-122,156,314,470
18105,FremontBridge,10/27/2014 09:00:00 AM,48,-122,107,194,301
18106,FremontBridge,10/27/2014 10:00:00 AM,48,-122,76,0,76
18107,FremontBridge,10/27/2014 11:00:00 AM,48,-122,69,0,69
18108,FremontBridge,10/27/2014 12:00:00 PM,48,-122,73,1,74
18109,FremontBridge,10/27/2014 01:00:00 PM,48,-122,92,1,93
18110,FremontBridge,10/27/2014 02:00:00 PM,48,-122,85,9,94
18111,FremontBridge,10/27/2014 03:00:00 PM,48,-122,80,64,144
18112,FremontBridge,10/27/2014 04:00:00 PM,48,-122,147,109,256
18113,FremontBridge,10/27/2014 05:00:00 PM,48,-122,350,162,512
18114,FremontBridge,10/27/2014 06:00:00 PM,48,-122,285,145,430
18115,FremontBridge,10/27/2014 07:00:00 PM,48,-122,99,53,152
18116,FremontBridge,10/27/2014 08:00:00 PM,48,-122,54,17,71
18117,FremontBridge,10/27/2014 09:00:00 PM,48,-122,33,18,51
18118,FremontBridge,10/27/2014 10:00:00 PM,48,-122,16,10,26
18119,FremontBridge,10/27/2014 11:00:00 PM,48,-122,9,7,16
18120,FremontBridge,10/28/2014 12:00:00 AM,48,-122,2,7,9
18121,FremontBridge,10/28/2014 01:00:00 AM,48,-122,1,1,2
18122,FremontBridge,10/28/2014 02:00:00 AM,48,-122,0,1,1
18123,FremontBridge,10/28/2014 03:00:00 AM,48,-122,0,0,0
18124,FremontBridge,10/28/2014 04:00:00 AM,48,-122,2,2,4
18125,FremontBridge,10/28/2014 05:00:00 AM,48,-122,7,17,24
18126,FremontBridge,10/28/2014 06:00:00 AM,48,-122,28,68,96
18127,FremontBridge,10/28/2014 07:00:00 AM,48,-122,72,164,236
18128,FremontBridge,10/28/2014 08:00:00 AM,48,-122,117,236,353
18129,FremontBridge,10/28/2014 09:00:00 AM,48,-122,65,132,197
18130,FremontBridge,10/28/2014 10:00:00 AM,48,-122,13,33,46
18131,FremontBridge,10/28/2014 11:00:00 AM,48,-122,10,11,21
18132,FremontBridge,10/28/2014 12:00:00 PM,48,-122,14,20,34
18133,FremontBridge,10/28/2014 01:00:00 PM,48,-122,20,23,43
18134,FremontBridge,10/28/2014 02:00:00 PM,48,-122,30,27,57
18135,FremontBridge,10/28/2014 03:00:00 PM,48,-122,51,31,82
18136,FremontBridge,10/28/2014 04:00:00 PM,48,-122,95,51,146
18137,FremontBridge,10/28/2014 05:00:00 PM,48,-122,261,122,383
18138,FremontBridge,10/28/2014 06:00:00 PM,48,-122,185,109,294
18139,FremontBridge,10/28/2014 07:00:00 PM,48,-122,73,34,107
18140,FremontBridge,10/28/2014 08:00:00 PM,48,-122,37,22,59
18141,FremontBridge,10/28/2014 09:00:00 PM,48,-122,20,11,31
18142,FremontBridge,10/28/2014 10:00:00 PM,48,-122,8,18,26
18143,FremontBridge,10/28/2014 11:00:00 PM,48,-122,7,3,10
18144,FremontBridge,10/29/2014 12:00:00 AM,48,-122,5,2,7
18145,FremontBridge,10/29/2014 01:00:00 AM,48,-122,2,2,4
18146,FremontBridge,10/29/2014 02:00:00 AM,48,-122,0,1,1
18147,FremontBridge,10/29/2014 03:00:00 AM,48,-122,0,1,1
18148,FremontBridge,10/29/2014 04:00:00 AM,48,-122,1,4,5
18149,FremontBridge,10/29/2014 05:00:00 AM,48,-122,5,26,31
18150,FremontBridge,10/29/2014 06:00:00 AM,48,-122,29,62,91
18151,FremontBridge,10/29/2014 07:00:00 AM,48,-122,86,223,309
18152,FremontBridge,10/29/2014 08:00:00 AM,48,-122,150,322,472
18153,FremontBridge,10/29/2014 09:00:00 AM,48,-122,93,188,281
18154,FremontBridge,10/29/2014 10:00:00 AM,48,-122,92,14,106
18155,FremontBridge,10/29/2014 11:00:00 AM,48,-122,74,2,76
18156,FremontBridge,10/29/2014 12:00:00 PM,48,-122,71,2,73
18157,FremontBridge,10/29/2014 01:00:00 PM,48,-122,85,2,87
18158,FremontBridge,10/29/2014 02:00:00 PM,48,-122,116,2,118
18159,FremontBridge,10/29/2014 03:00:00 PM,48,-122,84,56,140
18160,FremontBridge,10/29/2014 04:00:00 PM,48,-122,166,121,287
18161,FremontBridge,10/29/2014 05:00:00 PM,48,-122,385,177,562
18162,FremontBridge,10/29/2014 06:00:00 PM,48,-122,246,142,388
18163,FremontBridge,10/29/2014 07:00:00 PM,48,-122,82,56,138
18164,FremontBridge,10/29/2014 08:00:00 PM,48,-122,45,34,79
18165,FremontBridge,10/29/2014 09:00:00 PM,48,-122,44,26,70
18166,FremontBridge,10/29/2014 10:00:00 PM,48,-122,30,17,47
18167,FremontBridge,10/29/2014 11:00:00 PM,48,-122,14,9,23
18168,FremontBridge,10/30/2014 12:00:00 AM,48,-122,6,2,8
18169,FremontBridge,10/30/2014 01:00:00 AM,48,-122,3,4,7
18170,FremontBridge,10/30/2014 02:00:00 AM,48,-122,4,2,6
18171,FremontBridge,10/30/2014 03:00:00 AM,48,-122,1,1,2
18172,FremontBridge,10/30/2014 04:00:00 AM,48,-122,2,4,6
18173,FremontBridge,10/30/2014 05:00:00 AM,48,-122,5,22,27
18174,FremontBridge,10/30/2014 06:00:00 AM,48,-122,26,69,95
18175,FremontBridge,10/30/2014 07:00:00 AM,48,-122,71,191,262
18176,FremontBridge,10/30/2014 08:00:00 AM,48,-122,130,270,400
18177,FremontBridge,10/30/2014 09:00:00 AM,48,-122,79,147,226
18178,FremontBridge,10/30/2014 10:00:00 AM,48,-122,28,39,67
18179,FremontBridge,10/30/2014 11:00:00 AM,48,-122,31,33,64
18180,FremontBridge,10/30/2014 12:00:00 PM,48,-122,13,25,38
18181,FremontBridge,10/30/2014 01:00:00 PM,48,-122,16,21,37
18182,FremontBridge,10/30/2014 02:00:00 PM,48,-122,19,27,46
18183,FremontBridge,10/30/2014 03:00:00 PM,48,-122,41,33,74
18184,FremontBridge,10/30/2014 04:00:00 PM,48,-122,108,52,160
18185,FremontBridge,10/30/2014 05:00:00 PM,48,-122,244,112,356
18186,FremontBridge,10/30/2014 06:00:00 PM,48,-122,181,96,277
18187,FremontBridge,10/30/2014 07:00:00 PM,48,-122,69,33,102
18188,FremontBridge,10/30/2014 08:00:00 PM,48,-122,40,19,59
18189,FremontBridge,10/30/2014 09:00:00 PM,48,-122,19,12,31
18190,FremontBridge,10/30/2014 10:00:00 PM,48,-122,17,6,23
18191,FremontBridge,10/30/2014 11:00:00 PM,48,-122,13,6,19
18192,FremontBridge,10/31/2014 12:00:00 AM,48,-122,3,6,9
18193,FremontBridge,10/31/2014 01:00:00 AM,48,-122,2,0,2
18194,FremontBridge,10/31/2014 02:00:00 AM,48,-122,1,2,3
18195,FremontBridge,10/31/2014 03:00:00 AM,48,-122,1,2,3
18196,FremontBridge,10/31/2014 04:00:00 AM,48,-122,1,3,4
18197,FremontBridge,10/31/2014 05:00:00 AM,48,-122,7,22,29
18198,FremontBridge,10/31/2014 06:00:00 AM,48,-122,18,57,75
18199,FremontBridge,10/31/2014 07:00:00 AM,48,-122,52,128,180
18200,FremontBridge,10/31/2014 08:00:00 AM,48,-122,66,203,269
18201,FremontBridge,10/31/2014 09:00:00 AM,48,-122,42,94,136
18202,FremontBridge,10/31/2014 10:00:00 AM,48,-122,18,34,52
18203,FremontBridge,10/31/2014 11:00:00 AM,48,-122,14,22,36
18204,FremontBridge,10/31/2014 12:00:00 PM,48,-122,17,16,33
18205,FremontBridge,10/31/2014 01:00:00 PM,48,-122,16,25,41
18206,FremontBridge,10/31/2014 02:00:00 PM,48,-122,25,27,52
18207,FremontBridge,10/31/2014 03:00:00 PM,48,-122,76,44,120
18208,FremontBridge,10/31/2014 04:00:00 PM,48,-122,134,81,215
18209,FremontBridge,10/31/2014 05:00:00 PM,48,-122,228,100,328
18210,FremontBridge,10/31/2014 06:00:00 PM,48,-122,106,75,181
18211,FremontBridge,10/31/2014 07:00:00 PM,48,-122,44,21,65
18212,FremontBridge,10/31/2014 08:00:00 PM,48,-122,22,9,31
18213,FremontBridge,10/31/2014 09:00:00 PM,48,-122,20,12,32
18214,FremontBridge,10/31/2014 10:00:00 PM,48,-122,13,11,24
18215,FremontBridge,10/31/2014 11:00:00 PM,48,-122,6,12,18
18216,FremontBridge,11/01/2014 12:00:00 AM,48,-122,7,6,13
18217,FremontBridge,11/01/2014 01:00:00 AM,48,-122,8,5,13
18218,FremontBridge,11/01/2014 02:00:00 AM,48,-122,7,4,11
18219,FremontBridge,11/01/2014 03:00:00 AM,48,-122,3,3,6
18220,FremontBridge,11/01/2014 04:00:00 AM,48,-122,2,2,4
18221,FremontBridge,11/01/2014 05:00:00 AM,48,-122,3,2,5
18222,FremontBridge,11/01/2014 06:00:00 AM,48,-122,5,9,14
18223,FremontBridge,11/01/2014 07:00:00 AM,48,-122,7,12,19
18224,FremontBridge,11/01/2014 08:00:00 AM,48,-122,31,16,47
18225,FremontBridge,11/01/2014 09:00:00 AM,48,-122,35,43,78
18226,FremontBridge,11/01/2014 10:00:00 AM,48,-122,35,78,113
18227,FremontBridge,11/01/2014 11:00:00 AM,48,-122,38,49,87
18228,FremontBridge,11/01/2014 12:00:00 PM,48,-122,31,59,90
18229,FremontBridge,11/01/2014 01:00:00 PM,48,-122,52,74,126
18230,FremontBridge,11/01/2014 02:00:00 PM,48,-122,68,71,139
18231,FremontBridge,11/01/2014 03:00:00 PM,48,-122,53,73,126
18232,FremontBridge,11/01/2014 04:00:00 PM,48,-122,51,53,104
18233,FremontBridge,11/01/2014 05:00:00 PM,48,-122,36,54,90
18234,FremontBridge,11/01/2014 06:00:00 PM,48,-122,31,42,73
18235,FremontBridge,11/01/2014 07:00:00 PM,48,-122,21,15,36
18236,FremontBridge,11/01/2014 08:00:00 PM,48,-122,26,8,34
18237,FremontBridge,11/01/2014 09:00:00 PM,48,-122,16,9,25
18238,FremontBridge,11/01/2014 10:00:00 PM,48,-122,9,14,23
18239,FremontBridge,11/01/2014 11:00:00 PM,48,-122,6,12,18
18240,FremontBridge,11/02/2014 12:00:00 AM,48,-122,8,5,13
18241,FremontBridge,11/02/2014 01:00:00 AM,48,-122,8,6,14
18242,FremontBridge,11/02/2014 02:00:00 AM,48,-122,2,0,2
18243,FremontBridge,11/02/2014 03:00:00 AM,48,-122,0,0,0
18244,FremontBridge,11/02/2014 04:00:00 AM,48,-122,1,5,6
18245,FremontBridge,11/02/2014 05:00:00 AM,48,-122,3,1,4
18246,FremontBridge,11/02/2014 06:00:00 AM,48,-122,5,10,15
18247,FremontBridge,11/02/2014 07:00:00 AM,48,-122,13,18,31
18248,FremontBridge,11/02/2014 08:00:00 AM,48,-122,25,35,60
18249,FremontBridge,11/02/2014 09:00:00 AM,48,-122,49,46,95
18250,FremontBridge,11/02/2014 10:00:00 AM,48,-122,38,68,106
18251,FremontBridge,11/02/2014 11:00:00 AM,48,-122,54,82,136
18252,FremontBridge,11/02/2014 12:00:00 PM,48,-122,54,89,143
18253,FremontBridge,11/02/2014 01:00:00 PM,48,-122,58,63,121
18254,FremontBridge,11/02/2014 02:00:00 PM,48,-122,29,40,69
18255,FremontBridge,11/02/2014 03:00:00 PM,48,-122,15,25,40
18256,FremontBridge,11/02/2014 04:00:00 PM,48,-122,24,25,49
18257,FremontBridge,11/02/2014 05:00:00 PM,48,-122,34,16,50
18258,FremontBridge,11/02/2014 06:00:00 PM,48,-122,14,24,38
18259,FremontBridge,11/02/2014 07:00:00 PM,48,-122,10,8,18
18260,FremontBridge,11/02/2014 08:00:00 PM,48,-122,12,10,22
18261,FremontBridge,11/02/2014 09:00:00 PM,48,-122,4,4,8
18262,FremontBridge,11/02/2014 10:00:00 PM,48,-122,13,5,18
18263,FremontBridge,11/02/2014 11:00:00 PM,48,-122,8,6,14
18264,FremontBridge,11/03/2014 12:00:00 AM,48,-122,1,1,2
18265,FremontBridge,11/03/2014 01:00:00 AM,48,-122,1,5,6
18266,FremontBridge,11/03/2014 02:00:00 AM,48,-122,1,1,2
18267,FremontBridge,11/03/2014 03:00:00 AM,48,-122,0,0,0
18268,FremontBridge,11/03/2014 04:00:00 AM,48,-122,3,5,8
18269,FremontBridge,11/03/2014 05:00:00 AM,48,-122,12,24,36
18270,FremontBridge,11/03/2014 06:00:00 AM,48,-122,37,80,117
18271,FremontBridge,11/03/2014 07:00:00 AM,48,-122,94,234,328
18272,FremontBridge,11/03/2014 08:00:00 AM,48,-122,128,281,409
18273,FremontBridge,11/03/2014 09:00:00 AM,48,-122,51,109,160
18274,FremontBridge,11/03/2014 10:00:00 AM,48,-122,24,39,63
18275,FremontBridge,11/03/2014 11:00:00 AM,48,-122,17,25,42
18276,FremontBridge,11/03/2014 12:00:00 PM,48,-122,32,15,47
18277,FremontBridge,11/03/2014 01:00:00 PM,48,-122,22,21,43
18278,FremontBridge,11/03/2014 02:00:00 PM,48,-122,24,40,64
18279,FremontBridge,11/03/2014 03:00:00 PM,48,-122,42,36,78
18280,FremontBridge,11/03/2014 04:00:00 PM,48,-122,89,67,156
18281,FremontBridge,11/03/2014 05:00:00 PM,48,-122,285,141,426
18282,FremontBridge,11/03/2014 06:00:00 PM,48,-122,202,90,292
18283,FremontBridge,11/03/2014 07:00:00 PM,48,-122,75,40,115
18284,FremontBridge,11/03/2014 08:00:00 PM,48,-122,41,10,51
18285,FremontBridge,11/03/2014 09:00:00 PM,48,-122,21,5,26
18286,FremontBridge,11/03/2014 10:00:00 PM,48,-122,12,8,20
18287,FremontBridge,11/03/2014 11:00:00 PM,48,-122,5,7,12
18288,FremontBridge,11/04/2014 12:00:00 AM,48,-122,3,4,7
18289,FremontBridge,11/04/2014 01:00:00 AM,48,-122,1,3,4
18290,FremontBridge,11/04/2014 02:00:00 AM,48,-122,1,0,1
18291,FremontBridge,11/04/2014 03:00:00 AM,48,-122,1,3,4
18292,FremontBridge,11/04/2014 04:00:00 AM,48,-122,7,3,10
18293,FremontBridge,11/04/2014 05:00:00 AM,48,-122,6,26,32
18294,FremontBridge,11/04/2014 06:00:00 AM,48,-122,26,68,94
18295,FremontBridge,11/04/2014 07:00:00 AM,48,-122,86,208,294
18296,FremontBridge,11/04/2014 08:00:00 AM,48,-122,133,311,444
18297,FremontBridge,11/04/2014 09:00:00 AM,48,-122,80,128,208
18298,FremontBridge,11/04/2014 10:00:00 AM,48,-122,30,36,66
18299,FremontBridge,11/04/2014 11:00:00 AM,48,-122,24,29,53
18300,FremontBridge,11/04/2014 12:00:00 PM,48,-122,39,27,66
18301,FremontBridge,11/04/2014 01:00:00 PM,48,-122,27,33,60
18302,FremontBridge,11/04/2014 02:00:00 PM,48,-122,28,29,57
18303,FremontBridge,11/04/2014 03:00:00 PM,48,-122,58,34,92
18304,FremontBridge,11/04/2014 04:00:00 PM,48,-122,116,73,189
18305,FremontBridge,11/04/2014 05:00:00 PM,48,-122,296,154,450
18306,FremontBridge,11/04/2014 06:00:00 PM,48,-122,208,120,328
18307,FremontBridge,11/04/2014 07:00:00 PM,48,-122,100,60,160
18308,FremontBridge,11/04/2014 08:00:00 PM,48,-122,33,28,61
18309,FremontBridge,11/04/2014 09:00:00 PM,48,-122,34,19,53
18310,FremontBridge,11/04/2014 10:00:00 PM,48,-122,16,16,32
18311,FremontBridge,11/04/2014 11:00:00 PM,48,-122,12,13,25
18312,FremontBridge,11/05/2014 12:00:00 AM,48,-122,3,1,4
18313,FremontBridge,11/05/2014 01:00:00 AM,48,-122,1,1,2
18314,FremontBridge,11/05/2014 02:00:00 AM,48,-122,2,1,3
18315,FremontBridge,11/05/2014 03:00:00 AM,48,-122,3,6,9
18316,FremontBridge,11/05/2014 04:00:00 AM,48,-122,1,1,2
18317,FremontBridge,11/05/2014 05:00:00 AM,48,-122,6,26,32
18318,FremontBridge,11/05/2014 06:00:00 AM,48,-122,44,84,128
18319,FremontBridge,11/05/2014 07:00:00 AM,48,-122,77,242,319
18320,FremontBridge,11/05/2014 08:00:00 AM,48,-122,135,261,396
18321,FremontBridge,11/05/2014 09:00:00 AM,48,-122,99,112,211
18322,FremontBridge,11/05/2014 10:00:00 AM,48,-122,73,12,85
18323,FremontBridge,11/05/2014 11:00:00 AM,48,-122,68,1,69
18324,FremontBridge,11/05/2014 12:00:00 PM,48,-122,65,0,65
18325,FremontBridge,11/05/2014 01:00:00 PM,48,-122,67,0,67
18326,FremontBridge,11/05/2014 02:00:00 PM,48,-122,61,8,69
18327,FremontBridge,11/05/2014 03:00:00 PM,48,-122,64,37,101
18328,FremontBridge,11/05/2014 04:00:00 PM,48,-122,115,81,196
18329,FremontBridge,11/05/2014 05:00:00 PM,48,-122,279,125,404
18330,FremontBridge,11/05/2014 06:00:00 PM,48,-122,213,104,317
18331,FremontBridge,11/05/2014 07:00:00 PM,48,-122,87,57,144
18332,FremontBridge,11/05/2014 08:00:00 PM,48,-122,42,28,70
18333,FremontBridge,11/05/2014 09:00:00 PM,48,-122,24,10,34
18334,FremontBridge,11/05/2014 10:00:00 PM,48,-122,14,12,26
18335,FremontBridge,11/05/2014 11:00:00 PM,48,-122,10,9,19
18336,FremontBridge,11/06/2014 12:00:00 AM,48,-122,7,5,12
18337,FremontBridge,11/06/2014 01:00:00 AM,48,-122,1,5,6
18338,FremontBridge,11/06/2014 02:00:00 AM,48,-122,1,2,3
18339,FremontBridge,11/06/2014 03:00:00 AM,48,-122,1,3,4
18340,FremontBridge,11/06/2014 04:00:00 AM,48,-122,1,4,5
18341,FremontBridge,11/06/2014 05:00:00 AM,48,-122,9,22,31
18342,FremontBridge,11/06/2014 06:00:00 AM,48,-122,24,63,87
18343,FremontBridge,11/06/2014 07:00:00 AM,48,-122,78,183,261
18344,FremontBridge,11/06/2014 08:00:00 AM,48,-122,82,194,276
18345,FremontBridge,11/06/2014 09:00:00 AM,48,-122,55,106,161
18346,FremontBridge,11/06/2014 10:00:00 AM,48,-122,27,53,80
18347,FremontBridge,11/06/2014 11:00:00 AM,48,-122,25,29,54
18348,FremontBridge,11/06/2014 12:00:00 PM,48,-122,27,28,55
18349,FremontBridge,11/06/2014 01:00:00 PM,48,-122,26,23,49
18350,FremontBridge,11/06/2014 02:00:00 PM,48,-122,23,32,55
18351,FremontBridge,11/06/2014 03:00:00 PM,48,-122,44,53,97
18352,FremontBridge,11/06/2014 04:00:00 PM,48,-122,97,65,162
18353,FremontBridge,11/06/2014 05:00:00 PM,48,-122,234,112,346
18354,FremontBridge,11/06/2014 06:00:00 PM,48,-122,162,73,235
18355,FremontBridge,11/06/2014 07:00:00 PM,48,-122,85,51,136
18356,FremontBridge,11/06/2014 08:00:00 PM,48,-122,27,22,49
18357,FremontBridge,11/06/2014 09:00:00 PM,48,-122,28,8,36
18358,FremontBridge,11/06/2014 10:00:00 PM,48,-122,15,6,21
18359,FremontBridge,11/06/2014 11:00:00 PM,48,-122,16,11,27
18360,FremontBridge,11/07/2014 12:00:00 AM,48,-122,8,5,13
18361,FremontBridge,11/07/2014 01:00:00 AM,48,-122,2,3,5
18362,FremontBridge,11/07/2014 02:00:00 AM,48,-122,2,2,4
18363,FremontBridge,11/07/2014 03:00:00 AM,48,-122,1,2,3
18364,FremontBridge,11/07/2014 04:00:00 AM,48,-122,3,3,6
18365,FremontBridge,11/07/2014 05:00:00 AM,48,-122,6,26,32
18366,FremontBridge,11/07/2014 06:00:00 AM,48,-122,33,60,93
18367,FremontBridge,11/07/2014 07:00:00 AM,48,-122,66,212,278
18368,FremontBridge,11/07/2014 08:00:00 AM,48,-122,145,236,381
18369,FremontBridge,11/07/2014 09:00:00 AM,48,-122,87,160,247
18370,FremontBridge,11/07/2014 10:00:00 AM,48,-122,120,29,149
18371,FremontBridge,11/07/2014 11:00:00 AM,48,-122,77,13,90
18372,FremontBridge,11/07/2014 12:00:00 PM,48,-122,83,13,96
18373,FremontBridge,11/07/2014 01:00:00 PM,48,-122,110,14,124
18374,FremontBridge,11/07/2014 02:00:00 PM,48,-122,127,19,146
18375,FremontBridge,11/07/2014 03:00:00 PM,48,-122,88,47,135
18376,FremontBridge,11/07/2014 04:00:00 PM,48,-122,173,100,273
18377,FremontBridge,11/07/2014 05:00:00 PM,48,-122,329,131,460
18378,FremontBridge,11/07/2014 06:00:00 PM,48,-122,197,81,278
18379,FremontBridge,11/07/2014 07:00:00 PM,48,-122,81,37,118
18380,FremontBridge,11/07/2014 08:00:00 PM,48,-122,43,17,60
18381,FremontBridge,11/07/2014 09:00:00 PM,48,-122,17,16,33
18382,FremontBridge,11/07/2014 10:00:00 PM,48,-122,18,10,28
18383,FremontBridge,11/07/2014 11:00:00 PM,48,-122,10,16,26
18384,FremontBridge,11/08/2014 12:00:00 AM,48,-122,7,7,14
18385,FremontBridge,11/08/2014 01:00:00 AM,48,-122,3,5,8
18386,FremontBridge,11/08/2014 02:00:00 AM,48,-122,3,3,6
18387,FremontBridge,11/08/2014 03:00:00 AM,48,-122,5,2,7
18388,FremontBridge,11/08/2014 04:00:00 AM,48,-122,0,3,3
18389,FremontBridge,11/08/2014 05:00:00 AM,48,-122,4,2,6
18390,FremontBridge,11/08/2014 06:00:00 AM,48,-122,8,5,13
18391,FremontBridge,11/08/2014 07:00:00 AM,48,-122,29,12,41
18392,FremontBridge,11/08/2014 08:00:00 AM,48,-122,58,23,81
18393,FremontBridge,11/08/2014 09:00:00 AM,48,-122,71,39,110
18394,FremontBridge,11/08/2014 10:00:00 AM,48,-122,78,48,126
18395,FremontBridge,11/08/2014 11:00:00 AM,48,-122,114,60,174
18396,FremontBridge,11/08/2014 12:00:00 PM,48,-122,128,55,183
18397,FremontBridge,11/08/2014 01:00:00 PM,48,-122,177,61,238
18398,FremontBridge,11/08/2014 02:00:00 PM,48,-122,187,60,247
18399,FremontBridge,11/08/2014 03:00:00 PM,48,-122,84,69,153
18400,FremontBridge,11/08/2014 04:00:00 PM,48,-122,78,51,129
18401,FremontBridge,11/08/2014 05:00:00 PM,48,-122,55,40,95
18402,FremontBridge,11/08/2014 06:00:00 PM,48,-122,39,18,57
18403,FremontBridge,11/08/2014 07:00:00 PM,48,-122,20,15,35
18404,FremontBridge,11/08/2014 08:00:00 PM,48,-122,43,5,48
18405,FremontBridge,11/08/2014 09:00:00 PM,48,-122,17,8,25
18406,FremontBridge,11/08/2014 10:00:00 PM,48,-122,19,9,28
18407,FremontBridge,11/08/2014 11:00:00 PM,48,-122,19,8,27
18408,FremontBridge,11/09/2014 12:00:00 AM,48,-122,17,5,22
18409,FremontBridge,11/09/2014 01:00:00 AM,48,-122,2,4,6
18410,FremontBridge,11/09/2014 02:00:00 AM,48,-122,3,3,6
18411,FremontBridge,11/09/2014 03:00:00 AM,48,-122,1,3,4
18412,FremontBridge,11/09/2014 04:00:00 AM,48,-122,2,1,3
18413,FremontBridge,11/09/2014 05:00:00 AM,48,-122,4,2,6
18414,FremontBridge,11/09/2014 06:00:00 AM,48,-122,5,5,10
18415,FremontBridge,11/09/2014 07:00:00 AM,48,-122,3,9,12
18416,FremontBridge,11/09/2014 08:00:00 AM,48,-122,15,14,29
18417,FremontBridge,11/09/2014 09:00:00 AM,48,-122,21,34,55
18418,FremontBridge,11/09/2014 10:00:00 AM,48,-122,30,30,60
18419,FremontBridge,11/09/2014 11:00:00 AM,48,-122,24,40,64
18420,FremontBridge,11/09/2014 12:00:00 PM,48,-122,28,45,73
18421,FremontBridge,11/09/2014 01:00:00 PM,48,-122,25,52,77
18422,FremontBridge,11/09/2014 02:00:00 PM,48,-122,21,51,72
18423,FremontBridge,11/09/2014 03:00:00 PM,48,-122,19,38,57
18424,FremontBridge,11/09/2014 04:00:00 PM,48,-122,24,27,51
18425,FremontBridge,11/09/2014 05:00:00 PM,48,-122,19,23,42
18426,FremontBridge,11/09/2014 06:00:00 PM,48,-122,10,22,32
18427,FremontBridge,11/09/2014 07:00:00 PM,48,-122,16,9,25
18428,FremontBridge,11/09/2014 08:00:00 PM,48,-122,8,7,15
18429,FremontBridge,11/09/2014 09:00:00 PM,48,-122,3,6,9
18430,FremontBridge,11/09/2014 10:00:00 PM,48,-122,3,8,11
18431,FremontBridge,11/09/2014 11:00:00 PM,48,-122,5,6,11
18432,FremontBridge,11/10/2014 12:00:00 AM,48,-122,1,6,7
18433,FremontBridge,11/10/2014 01:00:00 AM,48,-122,0,4,4
18434,FremontBridge,11/10/2014 02:00:00 AM,48,-122,4,1,5
18435,FremontBridge,11/10/2014 03:00:00 AM,48,-122,0,3,3
18436,FremontBridge,11/10/2014 04:00:00 AM,48,-122,1,5,6
18437,FremontBridge,11/10/2014 05:00:00 AM,48,-122,12,20,32
18438,FremontBridge,11/10/2014 06:00:00 AM,48,-122,36,72,108
18439,FremontBridge,11/10/2014 07:00:00 AM,48,-122,70,250,320
18440,FremontBridge,11/10/2014 08:00:00 AM,48,-122,141,336,477
18441,FremontBridge,11/10/2014 09:00:00 AM,48,-122,95,155,250
18442,FremontBridge,11/10/2014 10:00:00 AM,48,-122,87,39,126
18443,FremontBridge,11/10/2014 11:00:00 AM,48,-122,81,14,95
18444,FremontBridge,11/10/2014 12:00:00 PM,48,-122,65,15,80
18445,FremontBridge,11/10/2014 01:00:00 PM,48,-122,95,17,112
18446,FremontBridge,11/10/2014 02:00:00 PM,48,-122,82,29,111
18447,FremontBridge,11/10/2014 03:00:00 PM,48,-122,79,43,122
18448,FremontBridge,11/10/2014 04:00:00 PM,48,-122,177,98,275
18449,FremontBridge,11/10/2014 05:00:00 PM,48,-122,328,154,482
18450,FremontBridge,11/10/2014 06:00:00 PM,48,-122,232,96,328
18451,FremontBridge,11/10/2014 07:00:00 PM,48,-122,77,53,130
18452,FremontBridge,11/10/2014 08:00:00 PM,48,-122,36,26,62
18453,FremontBridge,11/10/2014 09:00:00 PM,48,-122,41,12,53
18454,FremontBridge,11/10/2014 10:00:00 PM,48,-122,33,16,49
18455,FremontBridge,11/10/2014 11:00:00 PM,48,-122,8,9,17
18456,FremontBridge,11/11/2014 12:00:00 AM,48,-122,12,4,16
18457,FremontBridge,11/11/2014 01:00:00 AM,48,-122,2,3,5
18458,FremontBridge,11/11/2014 02:00:00 AM,48,-122,9,1,10
18459,FremontBridge,11/11/2014 03:00:00 AM,48,-122,1,2,3
18460,FremontBridge,11/11/2014 04:00:00 AM,48,-122,1,4,5
18461,FremontBridge,11/11/2014 05:00:00 AM,48,-122,5,17,22
18462,FremontBridge,11/11/2014 06:00:00 AM,48,-122,26,61,87
18463,FremontBridge,11/11/2014 07:00:00 AM,48,-122,65,201,266
18464,FremontBridge,11/11/2014 08:00:00 AM,48,-122,106,248,354
18465,FremontBridge,11/11/2014 09:00:00 AM,48,-122,82,127,209
18466,FremontBridge,11/11/2014 10:00:00 AM,48,-122,80,34,114
18467,FremontBridge,11/11/2014 11:00:00 AM,48,-122,76,17,93
18468,FremontBridge,11/11/2014 12:00:00 PM,48,-122,105,15,120
18469,FremontBridge,11/11/2014 01:00:00 PM,48,-122,68,24,92
18470,FremontBridge,11/11/2014 02:00:00 PM,48,-122,110,20,130
18471,FremontBridge,11/11/2014 03:00:00 PM,48,-122,68,49,117
18472,FremontBridge,11/11/2014 04:00:00 PM,48,-122,133,84,217
18473,FremontBridge,11/11/2014 05:00:00 PM,48,-122,242,128,370
18474,FremontBridge,11/11/2014 06:00:00 PM,48,-122,210,86,296
18475,FremontBridge,11/11/2014 07:00:00 PM,48,-122,76,45,121
18476,FremontBridge,11/11/2014 08:00:00 PM,48,-122,42,18,60
18477,FremontBridge,11/11/2014 09:00:00 PM,48,-122,28,14,42
18478,FremontBridge,11/11/2014 10:00:00 PM,48,-122,18,10,28
18479,FremontBridge,11/11/2014 11:00:00 PM,48,-122,8,6,14
18480,FremontBridge,11/12/2014 12:00:00 AM,48,-122,4,3,7
18481,FremontBridge,11/12/2014 01:00:00 AM,48,-122,4,2,6
18482,FremontBridge,11/12/2014 02:00:00 AM,48,-122,2,1,3
18483,FremontBridge,11/12/2014 03:00:00 AM,48,-122,0,2,2
18484,FremontBridge,11/12/2014 04:00:00 AM,48,-122,1,6,7
18485,FremontBridge,11/12/2014 05:00:00 AM,48,-122,6,18,24
18486,FremontBridge,11/12/2014 06:00:00 AM,48,-122,25,66,91
18487,FremontBridge,11/12/2014 07:00:00 AM,48,-122,70,180,250
18488,FremontBridge,11/12/2014 08:00:00 AM,48,-122,132,271,403
18489,FremontBridge,11/12/2014 09:00:00 AM,48,-122,78,146,224
18490,FremontBridge,11/12/2014 10:00:00 AM,48,-122,75,29,104
18491,FremontBridge,11/12/2014 11:00:00 AM,48,-122,54,12,66
18492,FremontBridge,11/12/2014 12:00:00 PM,48,-122,58,10,68
18493,FremontBridge,11/12/2014 01:00:00 PM,48,-122,60,11,71
18494,FremontBridge,11/12/2014 02:00:00 PM,48,-122,76,19,95
18495,FremontBridge,11/12/2014 03:00:00 PM,48,-122,50,46,96
18496,FremontBridge,11/12/2014 04:00:00 PM,48,-122,113,91,204
18497,FremontBridge,11/12/2014 05:00:00 PM,48,-122,271,126,397
18498,FremontBridge,11/12/2014 06:00:00 PM,48,-122,221,106,327
18499,FremontBridge,11/12/2014 07:00:00 PM,48,-122,88,48,136
18500,FremontBridge,11/12/2014 08:00:00 PM,48,-122,38,32,70
18501,FremontBridge,11/12/2014 09:00:00 PM,48,-122,29,14,43
18502,FremontBridge,11/12/2014 10:00:00 PM,48,-122,16,13,29
18503,FremontBridge,11/12/2014 11:00:00 PM,48,-122,13,6,19
18504,FremontBridge,11/13/2014 12:00:00 AM,48,-122,4,4,8
18505,FremontBridge,11/13/2014 01:00:00 AM,48,-122,1,2,3
18506,FremontBridge,11/13/2014 02:00:00 AM,48,-122,2,1,3
18507,FremontBridge,11/13/2014 03:00:00 AM,48,-122,1,2,3
18508,FremontBridge,11/13/2014 04:00:00 AM,48,-122,2,4,6
18509,FremontBridge,11/13/2014 05:00:00 AM,48,-122,7,23,30
18510,FremontBridge,11/13/2014 06:00:00 AM,48,-122,23,59,82
18511,FremontBridge,11/13/2014 07:00:00 AM,48,-122,72,195,267
18512,FremontBridge,11/13/2014 08:00:00 AM,48,-122,107,281,388
18513,FremontBridge,11/13/2014 09:00:00 AM,48,-122,74,149,223
18514,FremontBridge,11/13/2014 10:00:00 AM,48,-122,80,28,108
18515,FremontBridge,11/13/2014 11:00:00 AM,48,-122,44,9,53
18516,FremontBridge,11/13/2014 12:00:00 PM,48,-122,54,10,64
18517,FremontBridge,11/13/2014 01:00:00 PM,48,-122,49,15,64
18518,FremontBridge,11/13/2014 02:00:00 PM,48,-122,76,18,94
18519,FremontBridge,11/13/2014 03:00:00 PM,48,-122,61,43,104
18520,FremontBridge,11/13/2014 04:00:00 PM,48,-122,127,71,198
18521,FremontBridge,11/13/2014 05:00:00 PM,48,-122,228,129,357
18522,FremontBridge,11/13/2014 06:00:00 PM,48,-122,178,90,268
18523,FremontBridge,11/13/2014 07:00:00 PM,48,-122,84,59,143
18524,FremontBridge,11/13/2014 08:00:00 PM,48,-122,36,21,57
18525,FremontBridge,11/13/2014 09:00:00 PM,48,-122,34,13,47
18526,FremontBridge,11/13/2014 10:00:00 PM,48,-122,17,9,26
18527,FremontBridge,11/13/2014 11:00:00 PM,48,-122,11,9,20
18528,FremontBridge,11/14/2014 12:00:00 AM,48,-122,6,6,12
18529,FremontBridge,11/14/2014 01:00:00 AM,48,-122,2,3,5
18530,FremontBridge,11/14/2014 02:00:00 AM,48,-122,1,2,3
18531,FremontBridge,11/14/2014 03:00:00 AM,48,-122,2,1,3
18532,FremontBridge,11/14/2014 04:00:00 AM,48,-122,0,5,5
18533,FremontBridge,11/14/2014 05:00:00 AM,48,-122,10,17,27
18534,FremontBridge,11/14/2014 06:00:00 AM,48,-122,32,48,80
18535,FremontBridge,11/14/2014 07:00:00 AM,48,-122,51,151,202
18536,FremontBridge,11/14/2014 08:00:00 AM,48,-122,96,223,319
18537,FremontBridge,11/14/2014 09:00:00 AM,48,-122,26,178,204
18538,FremontBridge,11/14/2014 10:00:00 AM,48,-122,2,91,93
18539,FremontBridge,11/14/2014 11:00:00 AM,48,-122,3,24,27
18540,FremontBridge,11/14/2014 12:00:00 PM,48,-122,3,24,27
18541,FremontBridge,11/14/2014 01:00:00 PM,48,-122,7,26,33
18542,FremontBridge,11/14/2014 02:00:00 PM,48,-122,4,47,51
18543,FremontBridge,11/14/2014 03:00:00 PM,48,-122,63,37,100
18544,FremontBridge,11/14/2014 04:00:00 PM,48,-122,122,78,200
18545,FremontBridge,11/14/2014 05:00:00 PM,48,-122,247,104,351
18546,FremontBridge,11/14/2014 06:00:00 PM,48,-122,155,66,221
18547,FremontBridge,11/14/2014 07:00:00 PM,48,-122,48,35,83
18548,FremontBridge,11/14/2014 08:00:00 PM,48,-122,35,14,49
18549,FremontBridge,11/14/2014 09:00:00 PM,48,-122,22,8,30
18550,FremontBridge,11/14/2014 10:00:00 PM,48,-122,19,8,27
18551,FremontBridge,11/14/2014 11:00:00 PM,48,-122,15,10,25
18552,FremontBridge,11/15/2014 12:00:00 AM,48,-122,6,4,10
18553,FremontBridge,11/15/2014 01:00:00 AM,48,-122,5,4,9
18554,FremontBridge,11/15/2014 02:00:00 AM,48,-122,5,4,9
18555,FremontBridge,11/15/2014 03:00:00 AM,48,-122,1,0,1
18556,FremontBridge,11/15/2014 04:00:00 AM,48,-122,0,1,1
18557,FremontBridge,11/15/2014 05:00:00 AM,48,-122,1,1,2
18558,FremontBridge,11/15/2014 06:00:00 AM,48,-122,11,8,19
18559,FremontBridge,11/15/2014 07:00:00 AM,48,-122,6,9,15
18560,FremontBridge,11/15/2014 08:00:00 AM,48,-122,23,26,49
18561,FremontBridge,11/15/2014 09:00:00 AM,48,-122,23,34,57
18562,FremontBridge,11/15/2014 10:00:00 AM,48,-122,26,53,79
18563,FremontBridge,11/15/2014 11:00:00 AM,48,-122,32,39,71
18564,FremontBridge,11/15/2014 12:00:00 PM,48,-122,41,55,96
18565,FremontBridge,11/15/2014 01:00:00 PM,48,-122,53,66,119
18566,FremontBridge,11/15/2014 02:00:00 PM,48,-122,54,61,115
18567,FremontBridge,11/15/2014 03:00:00 PM,48,-122,55,59,114
18568,FremontBridge,11/15/2014 04:00:00 PM,48,-122,36,76,112
18569,FremontBridge,11/15/2014 05:00:00 PM,48,-122,35,34,69
18570,FremontBridge,11/15/2014 06:00:00 PM,48,-122,32,27,59
18571,FremontBridge,11/15/2014 07:00:00 PM,48,-122,15,3,18
18572,FremontBridge,11/15/2014 08:00:00 PM,48,-122,10,4,14
18573,FremontBridge,11/15/2014 09:00:00 PM,48,-122,8,6,14
18574,FremontBridge,11/15/2014 10:00:00 PM,48,-122,7,8,15
18575,FremontBridge,11/15/2014 11:00:00 PM,48,-122,8,8,16
18576,FremontBridge,11/16/2014 12:00:00 AM,48,-122,8,3,11
18577,FremontBridge,11/16/2014 01:00:00 AM,48,-122,1,2,3
18578,FremontBridge,11/16/2014 02:00:00 AM,48,-122,0,3,3
18579,FremontBridge,11/16/2014 03:00:00 AM,48,-122,0,0,0
18580,FremontBridge,11/16/2014 04:00:00 AM,48,-122,2,2,4
18581,FremontBridge,11/16/2014 05:00:00 AM,48,-122,1,0,1
18582,FremontBridge,11/16/2014 06:00:00 AM,48,-122,6,2,8
18583,FremontBridge,11/16/2014 07:00:00 AM,48,-122,4,7,11
18584,FremontBridge,11/16/2014 08:00:00 AM,48,-122,17,11,28
18585,FremontBridge,11/16/2014 09:00:00 AM,48,-122,25,42,67
18586,FremontBridge,11/16/2014 10:00:00 AM,48,-122,25,27,52
18587,FremontBridge,11/16/2014 11:00:00 AM,48,-122,30,41,71
18588,FremontBridge,11/16/2014 12:00:00 PM,48,-122,47,50,97
18589,FremontBridge,11/16/2014 01:00:00 PM,48,-122,72,78,150
18590,FremontBridge,11/16/2014 02:00:00 PM,48,-122,46,70,116
18591,FremontBridge,11/16/2014 03:00:00 PM,48,-122,57,70,127
18592,FremontBridge,11/16/2014 04:00:00 PM,48,-122,39,55,94
18593,FremontBridge,11/16/2014 05:00:00 PM,48,-122,27,30,57
18594,FremontBridge,11/16/2014 06:00:00 PM,48,-122,29,15,44
18595,FremontBridge,11/16/2014 07:00:00 PM,48,-122,10,4,14
18596,FremontBridge,11/16/2014 08:00:00 PM,48,-122,11,7,18
18597,FremontBridge,11/16/2014 09:00:00 PM,48,-122,6,2,8
18598,FremontBridge,11/16/2014 10:00:00 PM,48,-122,6,5,11
18599,FremontBridge,11/16/2014 11:00:00 PM,48,-122,5,4,9
18600,FremontBridge,11/17/2014 12:00:00 AM,48,-122,3,3,6
18601,FremontBridge,11/17/2014 01:00:00 AM,48,-122,2,1,3
18602,FremontBridge,11/17/2014 02:00:00 AM,48,-122,0,1,1
18603,FremontBridge,11/17/2014 03:00:00 AM,48,-122,0,2,2
18604,FremontBridge,11/17/2014 04:00:00 AM,48,-122,1,5,6
18605,FremontBridge,11/17/2014 05:00:00 AM,48,-122,11,18,29
18606,FremontBridge,11/17/2014 06:00:00 AM,48,-122,35,54,89
18607,FremontBridge,11/17/2014 07:00:00 AM,48,-122,61,213,274
18608,FremontBridge,11/17/2014 08:00:00 AM,48,-122,122,301,423
18609,FremontBridge,11/17/2014 09:00:00 AM,48,-122,26,180,206
18610,FremontBridge,11/17/2014 10:00:00 AM,48,-122,9,76,85
18611,FremontBridge,11/17/2014 11:00:00 AM,48,-122,3,47,50
18612,FremontBridge,11/17/2014 12:00:00 PM,48,-122,7,53,60
18613,FremontBridge,11/17/2014 01:00:00 PM,48,-122,4,62,66
18614,FremontBridge,11/17/2014 02:00:00 PM,48,-122,4,66,70
18615,FremontBridge,11/17/2014 03:00:00 PM,48,-122,47,46,93
18616,FremontBridge,11/17/2014 04:00:00 PM,48,-122,125,86,211
18617,FremontBridge,11/17/2014 05:00:00 PM,48,-122,301,129,430
18618,FremontBridge,11/17/2014 06:00:00 PM,48,-122,238,95,333
18619,FremontBridge,11/17/2014 07:00:00 PM,48,-122,90,40,130
18620,FremontBridge,11/17/2014 08:00:00 PM,48,-122,36,17,53
18621,FremontBridge,11/17/2014 09:00:00 PM,48,-122,22,12,34
18622,FremontBridge,11/17/2014 10:00:00 PM,48,-122,17,14,31
18623,FremontBridge,11/17/2014 11:00:00 PM,48,-122,10,3,13
18624,FremontBridge,11/18/2014 12:00:00 AM,48,-122,1,3,4
18625,FremontBridge,11/18/2014 01:00:00 AM,48,-122,0,2,2
18626,FremontBridge,11/18/2014 02:00:00 AM,48,-122,2,2,4
18627,FremontBridge,11/18/2014 03:00:00 AM,48,-122,0,1,1
18628,FremontBridge,11/18/2014 04:00:00 AM,48,-122,1,6,7
18629,FremontBridge,11/18/2014 05:00:00 AM,48,-122,8,18,26
18630,FremontBridge,11/18/2014 06:00:00 AM,48,-122,25,70,95
18631,FremontBridge,11/18/2014 07:00:00 AM,48,-122,79,215,294
18632,FremontBridge,11/18/2014 08:00:00 AM,48,-122,121,298,419
18633,FremontBridge,11/18/2014 09:00:00 AM,48,-122,29,182,211
18634,FremontBridge,11/18/2014 10:00:00 AM,48,-122,9,73,82
18635,FremontBridge,11/18/2014 11:00:00 AM,48,-122,5,52,57
18636,FremontBridge,11/18/2014 12:00:00 PM,48,-122,44,12,56
18637,FremontBridge,11/18/2014 01:00:00 PM,48,-122,63,0,63
18638,FremontBridge,11/18/2014 02:00:00 PM,48,-122,64,2,66
18639,FremontBridge,11/18/2014 03:00:00 PM,48,-122,73,47,120
18640,FremontBridge,11/18/2014 04:00:00 PM,48,-122,134,84,218
18641,FremontBridge,11/18/2014 05:00:00 PM,48,-122,293,129,422
18642,FremontBridge,11/18/2014 06:00:00 PM,48,-122,266,102,368
18643,FremontBridge,11/18/2014 07:00:00 PM,48,-122,99,52,151
18644,FremontBridge,11/18/2014 08:00:00 PM,48,-122,45,19,64
18645,FremontBridge,11/18/2014 09:00:00 PM,48,-122,35,19,54
18646,FremontBridge,11/18/2014 10:00:00 PM,48,-122,19,7,26
18647,FremontBridge,11/18/2014 11:00:00 PM,48,-122,14,9,23
18648,FremontBridge,11/19/2014 12:00:00 AM,48,-122,2,3,5
18649,FremontBridge,11/19/2014 01:00:00 AM,48,-122,0,5,5
18650,FremontBridge,11/19/2014 02:00:00 AM,48,-122,0,2,2
18651,FremontBridge,11/19/2014 03:00:00 AM,48,-122,0,1,1
18652,FremontBridge,11/19/2014 04:00:00 AM,48,-122,3,2,5
18653,FremontBridge,11/19/2014 05:00:00 AM,48,-122,9,24,33
18654,FremontBridge,11/19/2014 06:00:00 AM,48,-122,29,54,83
18655,FremontBridge,11/19/2014 07:00:00 AM,48,-122,79,213,292
18656,FremontBridge,11/19/2014 08:00:00 AM,48,-122,139,293,432
18657,FremontBridge,11/19/2014 09:00:00 AM,48,-122,83,146,229
18658,FremontBridge,11/19/2014 10:00:00 AM,48,-122,69,13,82
18659,FremontBridge,11/19/2014 11:00:00 AM,48,-122,52,0,52
18660,FremontBridge,11/19/2014 12:00:00 PM,48,-122,49,0,49
18661,FremontBridge,11/19/2014 01:00:00 PM,48,-122,56,0,56
18662,FremontBridge,11/19/2014 02:00:00 PM,48,-122,81,5,86
18663,FremontBridge,11/19/2014 03:00:00 PM,48,-122,54,45,99
18664,FremontBridge,11/19/2014 04:00:00 PM,48,-122,108,93,201
18665,FremontBridge,11/19/2014 05:00:00 PM,48,-122,293,136,429
18666,FremontBridge,11/19/2014 06:00:00 PM,48,-122,244,104,348
18667,FremontBridge,11/19/2014 07:00:00 PM,48,-122,106,49,155
18668,FremontBridge,11/19/2014 08:00:00 PM,48,-122,56,26,82
18669,FremontBridge,11/19/2014 09:00:00 PM,48,-122,36,28,64
18670,FremontBridge,11/19/2014 10:00:00 PM,48,-122,17,12,29
18671,FremontBridge,11/19/2014 11:00:00 PM,48,-122,10,6,16
18672,FremontBridge,11/20/2014 12:00:00 AM,48,-122,7,8,15
18673,FremontBridge,11/20/2014 01:00:00 AM,48,-122,0,2,2
18674,FremontBridge,11/20/2014 02:00:00 AM,48,-122,1,1,2
18675,FremontBridge,11/20/2014 03:00:00 AM,48,-122,0,1,1
18676,FremontBridge,11/20/2014 04:00:00 AM,48,-122,2,2,4
18677,FremontBridge,11/20/2014 05:00:00 AM,48,-122,7,17,24
18678,FremontBridge,11/20/2014 06:00:00 AM,48,-122,32,70,102
18679,FremontBridge,11/20/2014 07:00:00 AM,48,-122,64,189,253
18680,FremontBridge,11/20/2014 08:00:00 AM,48,-122,128,287,415
18681,FremontBridge,11/20/2014 09:00:00 AM,48,-122,81,157,238
18682,FremontBridge,11/20/2014 10:00:00 AM,48,-122,93,8,101
18683,FremontBridge,11/20/2014 11:00:00 AM,48,-122,53,1,54
18684,FremontBridge,11/20/2014 12:00:00 PM,48,-122,44,3,47
18685,FremontBridge,11/20/2014 01:00:00 PM,48,-122,47,1,48
18686,FremontBridge,11/20/2014 02:00:00 PM,48,-122,57,14,71
18687,FremontBridge,11/20/2014 03:00:00 PM,48,-122,60,51,111
18688,FremontBridge,11/20/2014 04:00:00 PM,48,-122,109,70,179
18689,FremontBridge,11/20/2014 05:00:00 PM,48,-122,261,125,386
18690,FremontBridge,11/20/2014 06:00:00 PM,48,-122,208,87,295
18691,FremontBridge,11/20/2014 07:00:00 PM,48,-122,99,46,145
18692,FremontBridge,11/20/2014 08:00:00 PM,48,-122,96,29,125
18693,FremontBridge,11/20/2014 09:00:00 PM,48,-122,31,13,44
18694,FremontBridge,11/20/2014 10:00:00 PM,48,-122,21,16,37
18695,FremontBridge,11/20/2014 11:00:00 PM,48,-122,16,10,26
18696,FremontBridge,11/21/2014 12:00:00 AM,48,-122,6,4,10
18697,FremontBridge,11/21/2014 01:00:00 AM,48,-122,0,0,0
18698,FremontBridge,11/21/2014 02:00:00 AM,48,-122,4,4,8
18699,FremontBridge,11/21/2014 03:00:00 AM,48,-122,1,1,2
18700,FremontBridge,11/21/2014 04:00:00 AM,48,-122,1,6,7
18701,FremontBridge,11/21/2014 05:00:00 AM,48,-122,2,24,26
18702,FremontBridge,11/21/2014 06:00:00 AM,48,-122,26,52,78
18703,FremontBridge,11/21/2014 07:00:00 AM,48,-122,57,139,196
18704,FremontBridge,11/21/2014 08:00:00 AM,48,-122,90,177,267
18705,FremontBridge,11/21/2014 09:00:00 AM,48,-122,54,112,166
18706,FremontBridge,11/21/2014 10:00:00 AM,48,-122,30,36,66
18707,FremontBridge,11/21/2014 11:00:00 AM,48,-122,13,22,35
18708,FremontBridge,11/21/2014 12:00:00 PM,48,-122,16,12,28
18709,FremontBridge,11/21/2014 01:00:00 PM,48,-122,17,16,33
18710,FremontBridge,11/21/2014 02:00:00 PM,48,-122,19,16,35
18711,FremontBridge,11/21/2014 03:00:00 PM,48,-122,25,14,39
18712,FremontBridge,11/21/2014 04:00:00 PM,48,-122,81,47,128
18713,FremontBridge,11/21/2014 05:00:00 PM,48,-122,186,87,273
18714,FremontBridge,11/21/2014 06:00:00 PM,48,-122,123,58,181
18715,FremontBridge,11/21/2014 07:00:00 PM,48,-122,49,27,76
18716,FremontBridge,11/21/2014 08:00:00 PM,48,-122,27,7,34
18717,FremontBridge,11/21/2014 09:00:00 PM,48,-122,18,14,32
18718,FremontBridge,11/21/2014 10:00:00 PM,48,-122,9,16,25
18719,FremontBridge,11/21/2014 11:00:00 PM,48,-122,5,8,13
18720,FremontBridge,11/22/2014 12:00:00 AM,48,-122,5,2,7
18721,FremontBridge,11/22/2014 01:00:00 AM,48,-122,6,2,8
18722,FremontBridge,11/22/2014 02:00:00 AM,48,-122,2,3,5
18723,FremontBridge,11/22/2014 03:00:00 AM,48,-122,2,0,2
18724,FremontBridge,11/22/2014 04:00:00 AM,48,-122,2,0,2
18725,FremontBridge,11/22/2014 05:00:00 AM,48,-122,3,4,7
18726,FremontBridge,11/22/2014 06:00:00 AM,48,-122,8,3,11
18727,FremontBridge,11/22/2014 07:00:00 AM,48,-122,8,10,18
18728,FremontBridge,11/22/2014 08:00:00 AM,48,-122,17,27,44
18729,FremontBridge,11/22/2014 09:00:00 AM,48,-122,31,33,64
18730,FremontBridge,11/22/2014 10:00:00 AM,48,-122,47,38,85
18731,FremontBridge,11/22/2014 11:00:00 AM,48,-122,35,59,94
18732,FremontBridge,11/22/2014 12:00:00 PM,48,-122,31,45,76
18733,FremontBridge,11/22/2014 01:00:00 PM,48,-122,40,44,84
18734,FremontBridge,11/22/2014 02:00:00 PM,48,-122,48,49,97
18735,FremontBridge,11/22/2014 03:00:00 PM,48,-122,50,66,116
18736,FremontBridge,11/22/2014 04:00:00 PM,48,-122,48,49,97
18737,FremontBridge,11/22/2014 05:00:00 PM,48,-122,29,33,62
18738,FremontBridge,11/22/2014 06:00:00 PM,48,-122,37,23,60
18739,FremontBridge,11/22/2014 07:00:00 PM,48,-122,14,20,34
18740,FremontBridge,11/22/2014 08:00:00 PM,48,-122,11,12,23
18741,FremontBridge,11/22/2014 09:00:00 PM,48,-122,14,7,21
18742,FremontBridge,11/22/2014 10:00:00 PM,48,-122,10,11,21
18743,FremontBridge,11/22/2014 11:00:00 PM,48,-122,6,10,16
18744,FremontBridge,11/23/2014 12:00:00 AM,48,-122,9,3,12
18745,FremontBridge,11/23/2014 01:00:00 AM,48,-122,3,3,6
18746,FremontBridge,11/23/2014 02:00:00 AM,48,-122,1,7,8
18747,FremontBridge,11/23/2014 03:00:00 AM,48,-122,1,2,3
18748,FremontBridge,11/23/2014 04:00:00 AM,48,-122,1,2,3
18749,FremontBridge,11/23/2014 05:00:00 AM,48,-122,2,1,3
18750,FremontBridge,11/23/2014 06:00:00 AM,48,-122,2,4,6
18751,FremontBridge,11/23/2014 07:00:00 AM,48,-122,3,5,8
18752,FremontBridge,11/23/2014 08:00:00 AM,48,-122,14,6,20
18753,FremontBridge,11/23/2014 09:00:00 AM,48,-122,10,29,39
18754,FremontBridge,11/23/2014 10:00:00 AM,48,-122,13,18,31
18755,FremontBridge,11/23/2014 11:00:00 AM,48,-122,25,35,60
18756,FremontBridge,11/23/2014 12:00:00 PM,48,-122,23,40,63
18757,FremontBridge,11/23/2014 01:00:00 PM,48,-122,37,43,80
18758,FremontBridge,11/23/2014 02:00:00 PM,48,-122,45,50,95
18759,FremontBridge,11/23/2014 03:00:00 PM,48,-122,43,53,96
18760,FremontBridge,11/23/2014 04:00:00 PM,48,-122,39,42,81
18761,FremontBridge,11/23/2014 05:00:00 PM,48,-122,29,29,58
18762,FremontBridge,11/23/2014 06:00:00 PM,48,-122,21,14,35
18763,FremontBridge,11/23/2014 07:00:00 PM,48,-122,12,14,26
18764,FremontBridge,11/23/2014 08:00:00 PM,48,-122,13,10,23
18765,FremontBridge,11/23/2014 09:00:00 PM,48,-122,7,3,10
18766,FremontBridge,11/23/2014 10:00:00 PM,48,-122,7,5,12
18767,FremontBridge,11/23/2014 11:00:00 PM,48,-122,2,7,9
18768,FremontBridge,11/24/2014 12:00:00 AM,48,-122,2,0,2
18769,FremontBridge,11/24/2014 01:00:00 AM,48,-122,1,1,2
18770,FremontBridge,11/24/2014 02:00:00 AM,48,-122,1,1,2
18771,FremontBridge,11/24/2014 03:00:00 AM,48,-122,0,2,2
18772,FremontBridge,11/24/2014 04:00:00 AM,48,-122,2,6,8
18773,FremontBridge,11/24/2014 05:00:00 AM,48,-122,9,17,26
18774,FremontBridge,11/24/2014 06:00:00 AM,48,-122,29,66,95
18775,FremontBridge,11/24/2014 07:00:00 AM,48,-122,64,196,260
18776,FremontBridge,11/24/2014 08:00:00 AM,48,-122,129,278,407
18777,FremontBridge,11/24/2014 09:00:00 AM,48,-122,18,155,173
18778,FremontBridge,11/24/2014 10:00:00 AM,48,-122,1,72,73
18779,FremontBridge,11/24/2014 11:00:00 AM,48,-122,0,49,49
18780,FremontBridge,11/24/2014 12:00:00 PM,48,-122,0,39,39
18781,FremontBridge,11/24/2014 01:00:00 PM,48,-122,0,47,47
18782,FremontBridge,11/24/2014 02:00:00 PM,48,-122,4,45,49
18783,FremontBridge,11/24/2014 03:00:00 PM,48,-122,42,36,78
18784,FremontBridge,11/24/2014 04:00:00 PM,48,-122,101,76,177
18785,FremontBridge,11/24/2014 05:00:00 PM,48,-122,273,117,390
18786,FremontBridge,11/24/2014 06:00:00 PM,48,-122,218,69,287
18787,FremontBridge,11/24/2014 07:00:00 PM,48,-122,77,40,117
18788,FremontBridge,11/24/2014 08:00:00 PM,48,-122,37,19,56
18789,FremontBridge,11/24/2014 09:00:00 PM,48,-122,23,17,40
18790,FremontBridge,11/24/2014 10:00:00 PM,48,-122,12,14,26
18791,FremontBridge,11/24/2014 11:00:00 PM,48,-122,8,5,13
18792,FremontBridge,11/25/2014 12:00:00 AM,48,-122,2,6,8
18793,FremontBridge,11/25/2014 01:00:00 AM,48,-122,1,0,1
18794,FremontBridge,11/25/2014 02:00:00 AM,48,-122,1,4,5
18795,FremontBridge,11/25/2014 03:00:00 AM,48,-122,1,1,2
18796,FremontBridge,11/25/2014 04:00:00 AM,48,-122,2,6,8
18797,FremontBridge,11/25/2014 05:00:00 AM,48,-122,7,15,22
18798,FremontBridge,11/25/2014 06:00:00 AM,48,-122,24,50,74
18799,FremontBridge,11/25/2014 07:00:00 AM,48,-122,43,152,195
18800,FremontBridge,11/25/2014 08:00:00 AM,48,-122,90,200,290
18801,FremontBridge,11/25/2014 09:00:00 AM,48,-122,19,134,153
18802,FremontBridge,11/25/2014 10:00:00 AM,48,-122,1,68,69
18803,FremontBridge,11/25/2014 11:00:00 AM,48,-122,1,33,34
18804,FremontBridge,11/25/2014 12:00:00 PM,48,-122,0,30,30
18805,FremontBridge,11/25/2014 01:00:00 PM,48,-122,20,27,47
18806,FremontBridge,11/25/2014 02:00:00 PM,48,-122,34,26,60
18807,FremontBridge,11/25/2014 03:00:00 PM,48,-122,38,19,57
18808,FremontBridge,11/25/2014 04:00:00 PM,48,-122,83,62,145
18809,FremontBridge,11/25/2014 05:00:00 PM,48,-122,200,83,283
18810,FremontBridge,11/25/2014 06:00:00 PM,48,-122,169,70,239
18811,FremontBridge,11/25/2014 07:00:00 PM,48,-122,74,42,116
18812,FremontBridge,11/25/2014 08:00:00 PM,48,-122,28,22,50
18813,FremontBridge,11/25/2014 09:00:00 PM,48,-122,15,12,27
18814,FremontBridge,11/25/2014 10:00:00 PM,48,-122,9,10,19
18815,FremontBridge,11/25/2014 11:00:00 PM,48,-122,11,6,17
18816,FremontBridge,11/26/2014 12:00:00 AM,48,-122,6,4,10
18817,FremontBridge,11/26/2014 01:00:00 AM,48,-122,1,2,3
18818,FremontBridge,11/26/2014 02:00:00 AM,48,-122,0,0,0
18819,FremontBridge,11/26/2014 03:00:00 AM,48,-122,1,0,1
18820,FremontBridge,11/26/2014 04:00:00 AM,48,-122,0,2,2
18821,FremontBridge,11/26/2014 05:00:00 AM,48,-122,3,22,25
18822,FremontBridge,11/26/2014 06:00:00 AM,48,-122,20,37,57
18823,FremontBridge,11/26/2014 07:00:00 AM,48,-122,49,130,179
18824,FremontBridge,11/26/2014 08:00:00 AM,48,-122,101,191,292
18825,FremontBridge,11/26/2014 09:00:00 AM,48,-122,80,113,193
18826,FremontBridge,11/26/2014 10:00:00 AM,48,-122,29,62,91
18827,FremontBridge,11/26/2014 11:00:00 AM,48,-122,25,40,65
18828,FremontBridge,11/26/2014 12:00:00 PM,48,-122,36,51,87
18829,FremontBridge,11/26/2014 01:00:00 PM,48,-122,61,59,120
18830,FremontBridge,11/26/2014 02:00:00 PM,48,-122,59,58,117
18831,FremontBridge,11/26/2014 03:00:00 PM,48,-122,113,71,184
18832,FremontBridge,11/26/2014 04:00:00 PM,48,-122,141,89,230
18833,FremontBridge,11/26/2014 05:00:00 PM,48,-122,153,92,245
18834,FremontBridge,11/26/2014 06:00:00 PM,48,-122,97,63,160
18835,FremontBridge,11/26/2014 07:00:00 PM,48,-122,33,26,59
18836,FremontBridge,11/26/2014 08:00:00 PM,48,-122,37,21,58
18837,FremontBridge,11/26/2014 09:00:00 PM,48,-122,11,14,25
18838,FremontBridge,11/26/2014 10:00:00 PM,48,-122,10,5,15
18839,FremontBridge,11/26/2014 11:00:00 PM,48,-122,11,10,21
18840,FremontBridge,11/27/2014 12:00:00 AM,48,-122,6,4,10
18841,FremontBridge,11/27/2014 01:00:00 AM,48,-122,1,2,3
18842,FremontBridge,11/27/2014 02:00:00 AM,48,-122,1,1,2
18843,FremontBridge,11/27/2014 03:00:00 AM,48,-122,0,2,2
18844,FremontBridge,11/27/2014 04:00:00 AM,48,-122,0,1,1
18845,FremontBridge,11/27/2014 05:00:00 AM,48,-122,1,1,2
18846,FremontBridge,11/27/2014 06:00:00 AM,48,-122,2,12,14
18847,FremontBridge,11/27/2014 07:00:00 AM,48,-122,3,6,9
18848,FremontBridge,11/27/2014 08:00:00 AM,48,-122,10,20,30
18849,FremontBridge,11/27/2014 09:00:00 AM,48,-122,21,19,40
18850,FremontBridge,11/27/2014 10:00:00 AM,48,-122,18,30,48
18851,FremontBridge,11/27/2014 11:00:00 AM,48,-122,28,45,73
18852,FremontBridge,11/27/2014 12:00:00 PM,48,-122,25,36,61
18853,FremontBridge,11/27/2014 01:00:00 PM,48,-122,16,43,59
18854,FremontBridge,11/27/2014 02:00:00 PM,48,-122,8,15,23
18855,FremontBridge,11/27/2014 03:00:00 PM,48,-122,13,17,30
18856,FremontBridge,11/27/2014 04:00:00 PM,48,-122,7,10,17
18857,FremontBridge,11/27/2014 05:00:00 PM,48,-122,10,1,11
18858,FremontBridge,11/27/2014 06:00:00 PM,48,-122,4,0,4
18859,FremontBridge,11/27/2014 07:00:00 PM,48,-122,2,3,5
18860,FremontBridge,11/27/2014 08:00:00 PM,48,-122,4,9,13
18861,FremontBridge,11/27/2014 09:00:00 PM,48,-122,10,9,19
18862,FremontBridge,11/27/2014 10:00:00 PM,48,-122,4,5,9
18863,FremontBridge,11/27/2014 11:00:00 PM,48,-122,11,4,15
18864,FremontBridge,11/28/2014 12:00:00 AM,48,-122,1,7,8
18865,FremontBridge,11/28/2014 01:00:00 AM,48,-122,0,0,0
18866,FremontBridge,11/28/2014 02:00:00 AM,48,-122,0,2,2
18867,FremontBridge,11/28/2014 03:00:00 AM,48,-122,4,1,5
18868,FremontBridge,11/28/2014 04:00:00 AM,48,-122,4,9,13
18869,FremontBridge,11/28/2014 05:00:00 AM,48,-122,3,5,8
18870,FremontBridge,11/28/2014 06:00:00 AM,48,-122,7,6,13
18871,FremontBridge,11/28/2014 07:00:00 AM,48,-122,5,12,17
18872,FremontBridge,11/28/2014 08:00:00 AM,48,-122,7,19,26
18873,FremontBridge,11/28/2014 09:00:00 AM,48,-122,7,12,19
18874,FremontBridge,11/28/2014 10:00:00 AM,48,-122,6,6,12
18875,FremontBridge,11/28/2014 11:00:00 AM,48,-122,6,3,9
18876,FremontBridge,11/28/2014 12:00:00 PM,48,-122,3,12,15
18877,FremontBridge,11/28/2014 01:00:00 PM,48,-122,7,12,19
18878,FremontBridge,11/28/2014 02:00:00 PM,48,-122,12,13,25
18879,FremontBridge,11/28/2014 03:00:00 PM,48,-122,11,5,16
18880,FremontBridge,11/28/2014 04:00:00 PM,48,-122,16,9,25
18881,FremontBridge,11/28/2014 05:00:00 PM,48,-122,10,10,20
18882,FremontBridge,11/28/2014 06:00:00 PM,48,-122,8,7,15
18883,FremontBridge,11/28/2014 07:00:00 PM,48,-122,10,7,17
18884,FremontBridge,11/28/2014 08:00:00 PM,48,-122,10,4,14
18885,FremontBridge,11/28/2014 09:00:00 PM,48,-122,3,3,6
18886,FremontBridge,11/28/2014 10:00:00 PM,48,-122,6,3,9
18887,FremontBridge,11/28/2014 11:00:00 PM,48,-122,7,4,11
18888,FremontBridge,11/29/2014 12:00:00 AM,48,-122,3,2,5
18889,FremontBridge,11/29/2014 01:00:00 AM,48,-122,0,2,2
18890,FremontBridge,11/29/2014 02:00:00 AM,48,-122,2,2,4
18891,FremontBridge,11/29/2014 03:00:00 AM,48,-122,0,1,1
18892,FremontBridge,11/29/2014 04:00:00 AM,48,-122,1,0,1
18893,FremontBridge,11/29/2014 05:00:00 AM,48,-122,2,3,5
18894,FremontBridge,11/29/2014 06:00:00 AM,48,-122,4,3,7
18895,FremontBridge,11/29/2014 07:00:00 AM,48,-122,4,4,8
18896,FremontBridge,11/29/2014 08:00:00 AM,48,-122,13,6,19
18897,FremontBridge,11/29/2014 09:00:00 AM,48,-122,8,25,33
18898,FremontBridge,11/29/2014 10:00:00 AM,48,-122,9,11,20
18899,FremontBridge,11/29/2014 11:00:00 AM,48,-122,8,10,18
18900,FremontBridge,11/29/2014 12:00:00 PM,48,-122,16,10,26
18901,FremontBridge,11/29/2014 01:00:00 PM,48,-122,10,19,29
18902,FremontBridge,11/29/2014 02:00:00 PM,48,-122,15,14,29
18903,FremontBridge,11/29/2014 03:00:00 PM,48,-122,15,11,26
18904,FremontBridge,11/29/2014 04:00:00 PM,48,-122,14,10,24
18905,FremontBridge,11/29/2014 05:00:00 PM,48,-122,11,12,23
18906,FremontBridge,11/29/2014 06:00:00 PM,48,-122,6,8,14
18907,FremontBridge,11/29/2014 07:00:00 PM,48,-122,11,3,14
18908,FremontBridge,11/29/2014 08:00:00 PM,48,-122,11,5,16
18909,FremontBridge,11/29/2014 09:00:00 PM,48,-122,5,3,8
18910,FremontBridge,11/29/2014 10:00:00 PM,48,-122,5,4,9
18911,FremontBridge,11/29/2014 11:00:00 PM,48,-122,3,1,4
18912,FremontBridge,11/30/2014 12:00:00 AM,48,-122,5,1,6
18913,FremontBridge,11/30/2014 01:00:00 AM,48,-122,1,0,1
18914,FremontBridge,11/30/2014 02:00:00 AM,48,-122,3,1,4
18915,FremontBridge,11/30/2014 03:00:00 AM,48,-122,0,1,1
18916,FremontBridge,11/30/2014 04:00:00 AM,48,-122,1,1,2
18917,FremontBridge,11/30/2014 05:00:00 AM,48,-122,2,1,3
18918,FremontBridge,11/30/2014 06:00:00 AM,48,-122,1,2,3
18919,FremontBridge,11/30/2014 07:00:00 AM,48,-122,2,3,5
18920,FremontBridge,11/30/2014 08:00:00 AM,48,-122,12,12,24
18921,FremontBridge,11/30/2014 09:00:00 AM,48,-122,12,15,27
18922,FremontBridge,11/30/2014 10:00:00 AM,48,-122,18,10,28
18923,FremontBridge,11/30/2014 11:00:00 AM,48,-122,10,18,28
18924,FremontBridge,11/30/2014 12:00:00 PM,48,-122,21,17,38
18925,FremontBridge,11/30/2014 01:00:00 PM,48,-122,25,29,54
18926,FremontBridge,11/30/2014 02:00:00 PM,48,-122,24,37,61
18927,FremontBridge,11/30/2014 03:00:00 PM,48,-122,19,21,40
18928,FremontBridge,11/30/2014 04:00:00 PM,48,-122,25,27,52
18929,FremontBridge,11/30/2014 05:00:00 PM,48,-122,17,18,35
18930,FremontBridge,11/30/2014 06:00:00 PM,48,-122,13,11,24
18931,FremontBridge,11/30/2014 07:00:00 PM,48,-122,5,5,10
18932,FremontBridge,11/30/2014 08:00:00 PM,48,-122,8,3,11
18933,FremontBridge,11/30/2014 09:00:00 PM,48,-122,13,3,16
18934,FremontBridge,11/30/2014 10:00:00 PM,48,-122,8,5,13
18935,FremontBridge,11/30/2014 11:00:00 PM,48,-122,5,2,7
18936,FremontBridge,12/01/2014 12:00:00 AM,48,-122,1,4,5
18937,FremontBridge,12/01/2014 01:00:00 AM,48,-122,0,0,0
18938,FremontBridge,12/01/2014 02:00:00 AM,48,-122,1,2,3
18939,FremontBridge,12/01/2014 03:00:00 AM,48,-122,1,1,2
18940,FremontBridge,12/01/2014 04:00:00 AM,48,-122,1,0,1
18941,FremontBridge,12/01/2014 05:00:00 AM,48,-122,4,20,24
18942,FremontBridge,12/01/2014 06:00:00 AM,48,-122,21,32,53
18943,FremontBridge,12/01/2014 07:00:00 AM,48,-122,32,144,176
18944,FremontBridge,12/01/2014 08:00:00 AM,48,-122,74,213,287
18945,FremontBridge,12/01/2014 09:00:00 AM,48,-122,50,110,160
18946,FremontBridge,12/01/2014 10:00:00 AM,48,-122,23,37,60
18947,FremontBridge,12/01/2014 11:00:00 AM,48,-122,23,24,47
18948,FremontBridge,12/01/2014 12:00:00 PM,48,-122,17,19,36
18949,FremontBridge,12/01/2014 01:00:00 PM,48,-122,26,13,39
18950,FremontBridge,12/01/2014 02:00:00 PM,48,-122,26,26,52
18951,FremontBridge,12/01/2014 03:00:00 PM,48,-122,38,26,64
18952,FremontBridge,12/01/2014 04:00:00 PM,48,-122,66,44,110
18953,FremontBridge,12/01/2014 05:00:00 PM,48,-122,195,83,278
18954,FremontBridge,12/01/2014 06:00:00 PM,48,-122,148,69,217
18955,FremontBridge,12/01/2014 07:00:00 PM,48,-122,55,35,90
18956,FremontBridge,12/01/2014 08:00:00 PM,48,-122,26,23,49
18957,FremontBridge,12/01/2014 09:00:00 PM,48,-122,16,9,25
18958,FremontBridge,12/01/2014 10:00:00 PM,48,-122,8,7,15
18959,FremontBridge,12/01/2014 11:00:00 PM,48,-122,13,3,16
18960,FremontBridge,12/02/2014 12:00:00 AM,48,-122,1,3,4
18961,FremontBridge,12/02/2014 01:00:00 AM,48,-122,3,2,5
18962,FremontBridge,12/02/2014 02:00:00 AM,48,-122,0,1,1
18963,FremontBridge,12/02/2014 03:00:00 AM,48,-122,3,3,6
18964,FremontBridge,12/02/2014 04:00:00 AM,48,-122,1,1,2
18965,FremontBridge,12/02/2014 05:00:00 AM,48,-122,6,20,26
18966,FremontBridge,12/02/2014 06:00:00 AM,48,-122,28,55,83
18967,FremontBridge,12/02/2014 07:00:00 AM,48,-122,58,149,207
18968,FremontBridge,12/02/2014 08:00:00 AM,48,-122,108,232,340
18969,FremontBridge,12/02/2014 09:00:00 AM,48,-122,13,149,162
18970,FremontBridge,12/02/2014 10:00:00 AM,48,-122,16,47,63
18971,FremontBridge,12/02/2014 11:00:00 AM,48,-122,29,0,29
18972,FremontBridge,12/02/2014 12:00:00 PM,48,-122,58,0,58
18973,FremontBridge,12/02/2014 01:00:00 PM,48,-122,45,0,45
18974,FremontBridge,12/02/2014 02:00:00 PM,48,-122,55,3,58
18975,FremontBridge,12/02/2014 03:00:00 PM,48,-122,49,31,80
18976,FremontBridge,12/02/2014 04:00:00 PM,48,-122,90,73,163
18977,FremontBridge,12/02/2014 05:00:00 PM,48,-122,213,91,304
18978,FremontBridge,12/02/2014 06:00:00 PM,48,-122,182,80,262
18979,FremontBridge,12/02/2014 07:00:00 PM,48,-122,74,39,113
18980,FremontBridge,12/02/2014 08:00:00 PM,48,-122,36,22,58
18981,FremontBridge,12/02/2014 09:00:00 PM,48,-122,18,21,39
18982,FremontBridge,12/02/2014 10:00:00 PM,48,-122,7,12,19
18983,FremontBridge,12/02/2014 11:00:00 PM,48,-122,9,3,12
18984,FremontBridge,12/03/2014 12:00:00 AM,48,-122,3,1,4
18985,FremontBridge,12/03/2014 01:00:00 AM,48,-122,1,2,3
18986,FremontBridge,12/03/2014 02:00:00 AM,48,-122,0,2,2
18987,FremontBridge,12/03/2014 03:00:00 AM,48,-122,1,2,3
18988,FremontBridge,12/03/2014 04:00:00 AM,48,-122,0,3,3
18989,FremontBridge,12/03/2014 05:00:00 AM,48,-122,2,21,23
18990,FremontBridge,12/03/2014 06:00:00 AM,48,-122,21,40,61
18991,FremontBridge,12/03/2014 07:00:00 AM,48,-122,61,162,223
18992,FremontBridge,12/03/2014 08:00:00 AM,48,-122,110,236,346
18993,FremontBridge,12/03/2014 09:00:00 AM,48,-122,69,140,209
18994,FremontBridge,12/03/2014 10:00:00 AM,48,-122,61,9,70
18995,FremontBridge,12/03/2014 11:00:00 AM,48,-122,46,0,46
18996,FremontBridge,12/03/2014 12:00:00 PM,48,-122,54,0,54
18997,FremontBridge,12/03/2014 01:00:00 PM,48,-122,37,0,37
18998,FremontBridge,12/03/2014 02:00:00 PM,48,-122,67,2,69
18999,FremontBridge,12/03/2014 03:00:00 PM,48,-122,59,22,81
19000,FremontBridge,12/03/2014 04:00:00 PM,48,-122,81,66,147
19001,FremontBridge,12/03/2014 05:00:00 PM,48,-122,230,119,349
19002,FremontBridge,12/03/2014 06:00:00 PM,48,-122,196,84,280
19003,FremontBridge,12/03/2014 07:00:00 PM,48,-122,80,43,123
19004,FremontBridge,12/03/2014 08:00:00 PM,48,-122,47,21,68
19005,FremontBridge,12/03/2014 09:00:00 PM,48,-122,23,26,49
19006,FremontBridge,12/03/2014 10:00:00 PM,48,-122,14,11,25
19007,FremontBridge,12/03/2014 11:00:00 PM,48,-122,12,7,19
19008,FremontBridge,12/04/2014 12:00:00 AM,48,-122,6,4,10
19009,FremontBridge,12/04/2014 01:00:00 AM,48,-122,1,2,3
19010,FremontBridge,12/04/2014 02:00:00 AM,48,-122,0,3,3
19011,FremontBridge,12/04/2014 03:00:00 AM,48,-122,2,1,3
19012,FremontBridge,12/04/2014 04:00:00 AM,48,-122,3,0,3
19013,FremontBridge,12/04/2014 05:00:00 AM,48,-122,4,19,23
19014,FremontBridge,12/04/2014 06:00:00 AM,48,-122,22,58,80
19015,FremontBridge,12/04/2014 07:00:00 AM,48,-122,62,150,212
19016,FremontBridge,12/04/2014 08:00:00 AM,48,-122,105,234,339
19017,FremontBridge,12/04/2014 09:00:00 AM,48,-122,56,136,192
19018,FremontBridge,12/04/2014 10:00:00 AM,48,-122,50,13,63
19019,FremontBridge,12/04/2014 11:00:00 AM,48,-122,35,0,35
19020,FremontBridge,12/04/2014 12:00:00 PM,48,-122,33,0,33
19021,FremontBridge,12/04/2014 01:00:00 PM,48,-122,44,0,44
19022,FremontBridge,12/04/2014 02:00:00 PM,48,-122,51,0,51
19023,FremontBridge,12/04/2014 03:00:00 PM,48,-122,43,29,72
19024,FremontBridge,12/04/2014 04:00:00 PM,48,-122,77,60,137
19025,FremontBridge,12/04/2014 05:00:00 PM,48,-122,205,95,300
19026,FremontBridge,12/04/2014 06:00:00 PM,48,-122,172,67,239
19027,FremontBridge,12/04/2014 07:00:00 PM,48,-122,79,41,120
19028,FremontBridge,12/04/2014 08:00:00 PM,48,-122,43,17,60
19029,FremontBridge,12/04/2014 09:00:00 PM,48,-122,31,13,44
19030,FremontBridge,12/04/2014 10:00:00 PM,48,-122,13,6,19
19031,FremontBridge,12/04/2014 11:00:00 PM,48,-122,8,3,11
19032,FremontBridge,12/05/2014 12:00:00 AM,48,-122,6,2,8
19033,FremontBridge,12/05/2014 01:00:00 AM,48,-122,0,2,2
19034,FremontBridge,12/05/2014 02:00:00 AM,48,-122,0,1,1
19035,FremontBridge,12/05/2014 03:00:00 AM,48,-122,1,3,4
19036,FremontBridge,12/05/2014 04:00:00 AM,48,-122,0,3,3
19037,FremontBridge,12/05/2014 05:00:00 AM,48,-122,4,17,21
19038,FremontBridge,12/05/2014 06:00:00 AM,48,-122,25,45,70
19039,FremontBridge,12/05/2014 07:00:00 AM,48,-122,46,117,163
19040,FremontBridge,12/05/2014 08:00:00 AM,48,-122,106,174,280
19041,FremontBridge,12/05/2014 09:00:00 AM,48,-122,60,117,177
19042,FremontBridge,12/05/2014 10:00:00 AM,48,-122,28,33,61
19043,FremontBridge,12/05/2014 11:00:00 AM,48,-122,25,29,54
19044,FremontBridge,12/05/2014 12:00:00 PM,48,-122,14,26,40
19045,FremontBridge,12/05/2014 01:00:00 PM,48,-122,29,20,49
19046,FremontBridge,12/05/2014 02:00:00 PM,48,-122,26,27,53
19047,FremontBridge,12/05/2014 03:00:00 PM,48,-122,39,38,77
19048,FremontBridge,12/05/2014 04:00:00 PM,48,-122,88,64,152
19049,FremontBridge,12/05/2014 05:00:00 PM,48,-122,193,81,274
19050,FremontBridge,12/05/2014 06:00:00 PM,48,-122,153,57,210
19051,FremontBridge,12/05/2014 07:00:00 PM,48,-122,63,41,104
19052,FremontBridge,12/05/2014 08:00:00 PM,48,-122,26,15,41
19053,FremontBridge,12/05/2014 09:00:00 PM,48,-122,20,8,28
19054,FremontBridge,12/05/2014 10:00:00 PM,48,-122,20,19,39
19055,FremontBridge,12/05/2014 11:00:00 PM,48,-122,12,5,17
19056,FremontBridge,12/06/2014 12:00:00 AM,48,-122,11,6,17
19057,FremontBridge,12/06/2014 01:00:00 AM,48,-122,8,3,11
19058,FremontBridge,12/06/2014 02:00:00 AM,48,-122,4,4,8
19059,FremontBridge,12/06/2014 03:00:00 AM,48,-122,0,0,0
19060,FremontBridge,12/06/2014 04:00:00 AM,48,-122,2,2,4
19061,FremontBridge,12/06/2014 05:00:00 AM,48,-122,1,5,6
19062,FremontBridge,12/06/2014 06:00:00 AM,48,-122,9,4,13
19063,FremontBridge,12/06/2014 07:00:00 AM,48,-122,9,13,22
19064,FremontBridge,12/06/2014 08:00:00 AM,48,-122,15,29,44
19065,FremontBridge,12/06/2014 09:00:00 AM,48,-122,36,39,75
19066,FremontBridge,12/06/2014 10:00:00 AM,48,-122,29,34,63
19067,FremontBridge,12/06/2014 11:00:00 AM,48,-122,26,32,58
19068,FremontBridge,12/06/2014 12:00:00 PM,48,-122,31,46,77
19069,FremontBridge,12/06/2014 01:00:00 PM,48,-122,32,41,73
19070,FremontBridge,12/06/2014 02:00:00 PM,48,-122,30,51,81
19071,FremontBridge,12/06/2014 03:00:00 PM,48,-122,43,43,86
19072,FremontBridge,12/06/2014 04:00:00 PM,48,-122,42,29,71
19073,FremontBridge,12/06/2014 05:00:00 PM,48,-122,22,34,56
19074,FremontBridge,12/06/2014 06:00:00 PM,48,-122,19,15,34
19075,FremontBridge,12/06/2014 07:00:00 PM,48,-122,10,14,24
19076,FremontBridge,12/06/2014 08:00:00 PM,48,-122,13,14,27
19077,FremontBridge,12/06/2014 09:00:00 PM,48,-122,13,3,16
19078,FremontBridge,12/06/2014 10:00:00 PM,48,-122,8,6,14
19079,FremontBridge,12/06/2014 11:00:00 PM,48,-122,11,11,22
19080,FremontBridge,12/07/2014 12:00:00 AM,48,-122,2,6,8
19081,FremontBridge,12/07/2014 01:00:00 AM,48,-122,3,6,9
19082,FremontBridge,12/07/2014 02:00:00 AM,48,-122,6,0,6
19083,FremontBridge,12/07/2014 03:00:00 AM,48,-122,2,4,6
19084,FremontBridge,12/07/2014 04:00:00 AM,48,-122,1,1,2
19085,FremontBridge,12/07/2014 05:00:00 AM,48,-122,3,3,6
19086,FremontBridge,12/07/2014 06:00:00 AM,48,-122,4,2,6
19087,FremontBridge,12/07/2014 07:00:00 AM,48,-122,3,7,10
19088,FremontBridge,12/07/2014 08:00:00 AM,48,-122,21,36,57
19089,FremontBridge,12/07/2014 09:00:00 AM,48,-122,29,41,70
19090,FremontBridge,12/07/2014 10:00:00 AM,48,-122,62,73,135
19091,FremontBridge,12/07/2014 11:00:00 AM,48,-122,44,61,105
19092,FremontBridge,12/07/2014 12:00:00 PM,48,-122,75,55,130
19093,FremontBridge,12/07/2014 01:00:00 PM,48,-122,54,64,118
19094,FremontBridge,12/07/2014 02:00:00 PM,48,-122,36,65,101
19095,FremontBridge,12/07/2014 03:00:00 PM,48,-122,61,64,125
19096,FremontBridge,12/07/2014 04:00:00 PM,48,-122,51,39,90
19097,FremontBridge,12/07/2014 05:00:00 PM,48,-122,27,41,68
19098,FremontBridge,12/07/2014 06:00:00 PM,48,-122,26,16,42
19099,FremontBridge,12/07/2014 07:00:00 PM,48,-122,17,14,31
19100,FremontBridge,12/07/2014 08:00:00 PM,48,-122,11,10,21
19101,FremontBridge,12/07/2014 09:00:00 PM,48,-122,13,2,15
19102,FremontBridge,12/07/2014 10:00:00 PM,48,-122,8,9,17
19103,FremontBridge,12/07/2014 11:00:00 PM,48,-122,7,9,16
19104,FremontBridge,12/08/2014 12:00:00 AM,48,-122,2,2,4
19105,FremontBridge,12/08/2014 01:00:00 AM,48,-122,1,1,2
19106,FremontBridge,12/08/2014 02:00:00 AM,48,-122,0,3,3
19107,FremontBridge,12/08/2014 03:00:00 AM,48,-122,2,0,2
19108,FremontBridge,12/08/2014 04:00:00 AM,48,-122,0,2,2
19109,FremontBridge,12/08/2014 05:00:00 AM,48,-122,11,22,33
19110,FremontBridge,12/08/2014 06:00:00 AM,48,-122,38,64,102
19111,FremontBridge,12/08/2014 07:00:00 AM,48,-122,58,227,285
19112,FremontBridge,12/08/2014 08:00:00 AM,48,-122,115,275,390
19113,FremontBridge,12/08/2014 09:00:00 AM,48,-122,168,25,193
19114,FremontBridge,12/08/2014 10:00:00 AM,48,-122,65,0,65
19115,FremontBridge,12/08/2014 11:00:00 AM,48,-122,55,1,56
19116,FremontBridge,12/08/2014 12:00:00 PM,48,-122,41,3,44
19117,FremontBridge,12/08/2014 01:00:00 PM,48,-122,47,2,49
19118,FremontBridge,12/08/2014 02:00:00 PM,48,-122,55,11,66
19119,FremontBridge,12/08/2014 03:00:00 PM,48,-122,40,38,78
19120,FremontBridge,12/08/2014 04:00:00 PM,48,-122,96,65,161
19121,FremontBridge,12/08/2014 05:00:00 PM,48,-122,268,112,380
19122,FremontBridge,12/08/2014 06:00:00 PM,48,-122,219,84,303
19123,FremontBridge,12/08/2014 07:00:00 PM,48,-122,51,35,86
19124,FremontBridge,12/08/2014 08:00:00 PM,48,-122,27,16,43
19125,FremontBridge,12/08/2014 09:00:00 PM,48,-122,13,6,19
19126,FremontBridge,12/08/2014 10:00:00 PM,48,-122,12,4,16
19127,FremontBridge,12/08/2014 11:00:00 PM,48,-122,6,1,7
19128,FremontBridge,12/09/2014 12:00:00 AM,48,-122,0,3,3
19129,FremontBridge,12/09/2014 01:00:00 AM,48,-122,0,3,3
19130,FremontBridge,12/09/2014 02:00:00 AM,48,-122,0,2,2
19131,FremontBridge,12/09/2014 03:00:00 AM,48,-122,3,2,5
19132,FremontBridge,12/09/2014 04:00:00 AM,48,-122,0,1,1
19133,FremontBridge,12/09/2014 05:00:00 AM,48,-122,6,22,28
19134,FremontBridge,12/09/2014 06:00:00 AM,48,-122,26,59,85
19135,FremontBridge,12/09/2014 07:00:00 AM,48,-122,71,156,227
19136,FremontBridge,12/09/2014 08:00:00 AM,48,-122,110,217,327
19137,FremontBridge,12/09/2014 09:00:00 AM,48,-122,5,115,120
19138,FremontBridge,12/09/2014 10:00:00 AM,48,-122,0,48,48
19139,FremontBridge,12/09/2014 11:00:00 AM,48,-122,0,43,43
19140,FremontBridge,12/09/2014 12:00:00 PM,48,-122,0,28,28
19141,FremontBridge,12/09/2014 01:00:00 PM,48,-122,0,35,35
19142,FremontBridge,12/09/2014 02:00:00 PM,48,-122,0,51,51
19143,FremontBridge,12/09/2014 03:00:00 PM,48,-122,44,44,88
19144,FremontBridge,12/09/2014 04:00:00 PM,48,-122,95,87,182
19145,FremontBridge,12/09/2014 05:00:00 PM,48,-122,224,103,327
19146,FremontBridge,12/09/2014 06:00:00 PM,48,-122,185,95,280
19147,FremontBridge,12/09/2014 07:00:00 PM,48,-122,72,41,113
19148,FremontBridge,12/09/2014 08:00:00 PM,48,-122,35,23,58
19149,FremontBridge,12/09/2014 09:00:00 PM,48,-122,22,11,33
19150,FremontBridge,12/09/2014 10:00:00 PM,48,-122,13,8,21
19151,FremontBridge,12/09/2014 11:00:00 PM,48,-122,8,3,11
19152,FremontBridge,12/10/2014 12:00:00 AM,48,-122,2,3,5
19153,FremontBridge,12/10/2014 01:00:00 AM,48,-122,3,2,5
19154,FremontBridge,12/10/2014 02:00:00 AM,48,-122,0,3,3
19155,FremontBridge,12/10/2014 03:00:00 AM,48,-122,1,1,2
19156,FremontBridge,12/10/2014 04:00:00 AM,48,-122,1,1,2
19157,FremontBridge,12/10/2014 05:00:00 AM,48,-122,3,12,15
19158,FremontBridge,12/10/2014 06:00:00 AM,48,-122,28,52,80
19159,FremontBridge,12/10/2014 07:00:00 AM,48,-122,42,157,199
19160,FremontBridge,12/10/2014 08:00:00 AM,48,-122,0,298,298
19161,FremontBridge,12/10/2014 09:00:00 AM,48,-122,0,155,155
19162,FremontBridge,12/10/2014 10:00:00 AM,48,-122,0,75,75
19163,FremontBridge,12/10/2014 11:00:00 AM,48,-122,0,34,34
19164,FremontBridge,12/10/2014 12:00:00 PM,48,-122,0,37,37
19165,FremontBridge,12/10/2014 01:00:00 PM,48,-122,8,29,37
19166,FremontBridge,12/10/2014 02:00:00 PM,48,-122,13,18,31
19167,FremontBridge,12/10/2014 03:00:00 PM,48,-122,28,31,59
19168,FremontBridge,12/10/2014 04:00:00 PM,48,-122,93,43,136
19169,FremontBridge,12/10/2014 05:00:00 PM,48,-122,192,105,297
19170,FremontBridge,12/10/2014 06:00:00 PM,48,-122,174,67,241
19171,FremontBridge,12/10/2014 07:00:00 PM,48,-122,71,29,100
19172,FremontBridge,12/10/2014 08:00:00 PM,48,-122,42,25,67
19173,FremontBridge,12/10/2014 09:00:00 PM,48,-122,24,16,40
19174,FremontBridge,12/10/2014 10:00:00 PM,48,-122,9,9,18
19175,FremontBridge,12/10/2014 11:00:00 PM,48,-122,15,6,21
19176,FremontBridge,12/11/2014 12:00:00 AM,48,-122,5,2,7
19177,FremontBridge,12/11/2014 01:00:00 AM,48,-122,2,1,3
19178,FremontBridge,12/11/2014 02:00:00 AM,48,-122,2,2,4
19179,FremontBridge,12/11/2014 03:00:00 AM,48,-122,1,0,1
19180,FremontBridge,12/11/2014 04:00:00 AM,48,-122,1,3,4
19181,FremontBridge,12/11/2014 05:00:00 AM,48,-122,7,14,21
19182,FremontBridge,12/11/2014 06:00:00 AM,48,-122,17,47,64
19183,FremontBridge,12/11/2014 07:00:00 AM,48,-122,104,37,141
19184,FremontBridge,12/11/2014 08:00:00 AM,48,-122,194,0,194
19185,FremontBridge,12/11/2014 09:00:00 AM,48,-122,110,0,110
19186,FremontBridge,12/11/2014 10:00:00 AM,48,-122,55,0,55
19187,FremontBridge,12/11/2014 11:00:00 AM,48,-122,33,0,33
19188,FremontBridge,12/11/2014 12:00:00 PM,48,-122,18,0,18
19189,FremontBridge,12/11/2014 01:00:00 PM,48,-122,33,2,35
19190,FremontBridge,12/11/2014 02:00:00 PM,48,-122,22,20,42
19191,FremontBridge,12/11/2014 03:00:00 PM,48,-122,43,33,76
19192,FremontBridge,12/11/2014 04:00:00 PM,48,-122,82,64,146
19193,FremontBridge,12/11/2014 05:00:00 PM,48,-122,193,70,263
19194,FremontBridge,12/11/2014 06:00:00 PM,48,-122,150,58,208
19195,FremontBridge,12/11/2014 07:00:00 PM,48,-122,58,34,92
19196,FremontBridge,12/11/2014 08:00:00 PM,48,-122,20,9,29
19197,FremontBridge,12/11/2014 09:00:00 PM,48,-122,26,12,38
19198,FremontBridge,12/11/2014 10:00:00 PM,48,-122,11,11,22
19199,FremontBridge,12/11/2014 11:00:00 PM,48,-122,12,3,15
19200,FremontBridge,12/12/2014 12:00:00 AM,48,-122,3,1,4
19201,FremontBridge,12/12/2014 01:00:00 AM,48,-122,1,2,3
19202,FremontBridge,12/12/2014 02:00:00 AM,48,-122,3,0,3
19203,FremontBridge,12/12/2014 03:00:00 AM,48,-122,1,1,2
19204,FremontBridge,12/12/2014 04:00:00 AM,48,-122,1,3,4
19205,FremontBridge,12/12/2014 05:00:00 AM,48,-122,5,13,18
19206,FremontBridge,12/12/2014 06:00:00 AM,48,-122,30,44,74
19207,FremontBridge,12/12/2014 07:00:00 AM,48,-122,63,126,189
19208,FremontBridge,12/12/2014 08:00:00 AM,48,-122,98,221,319
19209,FremontBridge,12/12/2014 09:00:00 AM,48,-122,7,148,155
19210,FremontBridge,12/12/2014 10:00:00 AM,48,-122,0,66,66
19211,FremontBridge,12/12/2014 11:00:00 AM,48,-122,24,51,75
19212,FremontBridge,12/12/2014 12:00:00 PM,48,-122,31,29,60
19213,FremontBridge,12/12/2014 01:00:00 PM,48,-122,39,35,74
19214,FremontBridge,12/12/2014 02:00:00 PM,48,-122,41,50,91
19215,FremontBridge,12/12/2014 03:00:00 PM,48,-122,66,51,117
19216,FremontBridge,12/12/2014 04:00:00 PM,48,-122,127,73,200
19217,FremontBridge,12/12/2014 05:00:00 PM,48,-122,269,96,365
19218,FremontBridge,12/12/2014 06:00:00 PM,48,-122,148,75,223
19219,FremontBridge,12/12/2014 07:00:00 PM,48,-122,68,26,94
19220,FremontBridge,12/12/2014 08:00:00 PM,48,-122,45,26,71
19221,FremontBridge,12/12/2014 09:00:00 PM,48,-122,18,23,41
19222,FremontBridge,12/12/2014 10:00:00 PM,48,-122,12,15,27
19223,FremontBridge,12/12/2014 11:00:00 PM,48,-122,20,6,26
19224,FremontBridge,12/13/2014 12:00:00 AM,48,-122,11,2,13
19225,FremontBridge,12/13/2014 01:00:00 AM,48,-122,2,3,5
19226,FremontBridge,12/13/2014 02:00:00 AM,48,-122,3,6,9
19227,FremontBridge,12/13/2014 03:00:00 AM,48,-122,4,2,6
19228,FremontBridge,12/13/2014 04:00:00 AM,48,-122,2,0,2
19229,FremontBridge,12/13/2014 05:00:00 AM,48,-122,1,5,6
19230,FremontBridge,12/13/2014 06:00:00 AM,48,-122,7,9,16
19231,FremontBridge,12/13/2014 07:00:00 AM,48,-122,12,12,24
19232,FremontBridge,12/13/2014 08:00:00 AM,48,-122,28,22,50
19233,FremontBridge,12/13/2014 09:00:00 AM,48,-122,33,27,60
19234,FremontBridge,12/13/2014 10:00:00 AM,48,-122,34,51,85
19235,FremontBridge,12/13/2014 11:00:00 AM,48,-122,43,65,108
19236,FremontBridge,12/13/2014 12:00:00 PM,48,-122,41,69,110
19237,FremontBridge,12/13/2014 01:00:00 PM,48,-122,46,58,104
19238,FremontBridge,12/13/2014 02:00:00 PM,48,-122,70,76,146
19239,FremontBridge,12/13/2014 03:00:00 PM,48,-122,72,93,165
19240,FremontBridge,12/13/2014 04:00:00 PM,48,-122,51,46,97
19241,FremontBridge,12/13/2014 05:00:00 PM,48,-122,13,32,45
19242,FremontBridge,12/13/2014 06:00:00 PM,48,-122,19,24,43
19243,FremontBridge,12/13/2014 07:00:00 PM,48,-122,14,8,22
19244,FremontBridge,12/13/2014 08:00:00 PM,48,-122,13,7,20
19245,FremontBridge,12/13/2014 09:00:00 PM,48,-122,22,6,28
19246,FremontBridge,12/13/2014 10:00:00 PM,48,-122,7,9,16
19247,FremontBridge,12/13/2014 11:00:00 PM,48,-122,14,9,23
19248,FremontBridge,12/14/2014 12:00:00 AM,48,-122,10,6,16
19249,FremontBridge,12/14/2014 01:00:00 AM,48,-122,4,9,13
19250,FremontBridge,12/14/2014 02:00:00 AM,48,-122,5,1,6
19251,FremontBridge,12/14/2014 03:00:00 AM,48,-122,2,1,3
19252,FremontBridge,12/14/2014 04:00:00 AM,48,-122,1,2,3
19253,FremontBridge,12/14/2014 05:00:00 AM,48,-122,1,2,3
19254,FremontBridge,12/14/2014 06:00:00 AM,48,-122,8,2,10
19255,FremontBridge,12/14/2014 07:00:00 AM,48,-122,3,8,11
19256,FremontBridge,12/14/2014 08:00:00 AM,48,-122,22,25,47
19257,FremontBridge,12/14/2014 09:00:00 AM,48,-122,35,48,83
19258,FremontBridge,12/14/2014 10:00:00 AM,48,-122,34,58,92
19259,FremontBridge,12/14/2014 11:00:00 AM,48,-122,43,66,109
19260,FremontBridge,12/14/2014 12:00:00 PM,48,-122,41,84,125
19261,FremontBridge,12/14/2014 01:00:00 PM,48,-122,85,73,158
19262,FremontBridge,12/14/2014 02:00:00 PM,48,-122,48,86,134
19263,FremontBridge,12/14/2014 03:00:00 PM,48,-122,53,55,108
19264,FremontBridge,12/14/2014 04:00:00 PM,48,-122,49,58,107
19265,FremontBridge,12/14/2014 05:00:00 PM,48,-122,31,29,60
19266,FremontBridge,12/14/2014 06:00:00 PM,48,-122,22,21,43
19267,FremontBridge,12/14/2014 07:00:00 PM,48,-122,22,15,37
19268,FremontBridge,12/14/2014 08:00:00 PM,48,-122,15,9,24
19269,FremontBridge,12/14/2014 09:00:00 PM,48,-122,12,8,20
19270,FremontBridge,12/14/2014 10:00:00 PM,48,-122,3,8,11
19271,FremontBridge,12/14/2014 11:00:00 PM,48,-122,6,3,9
19272,FremontBridge,12/15/2014 12:00:00 AM,48,-122,2,2,4
19273,FremontBridge,12/15/2014 01:00:00 AM,48,-122,2,0,2
19274,FremontBridge,12/15/2014 02:00:00 AM,48,-122,0,1,1
19275,FremontBridge,12/15/2014 03:00:00 AM,48,-122,1,3,4
19276,FremontBridge,12/15/2014 04:00:00 AM,48,-122,0,2,2
19277,FremontBridge,12/15/2014 05:00:00 AM,48,-122,7,28,35
19278,FremontBridge,12/15/2014 06:00:00 AM,48,-122,33,66,99
19279,FremontBridge,12/15/2014 07:00:00 AM,48,-122,151,26,177
19280,FremontBridge,12/15/2014 08:00:00 AM,48,-122,242,0,242
19281,FremontBridge,12/15/2014 09:00:00 AM,48,-122,155,0,155
19282,FremontBridge,12/15/2014 10:00:00 AM,48,-122,53,0,53
19283,FremontBridge,12/15/2014 11:00:00 AM,48,-122,54,2,56
19284,FremontBridge,12/15/2014 12:00:00 PM,48,-122,43,1,44
19285,FremontBridge,12/15/2014 01:00:00 PM,48,-122,56,0,56
19286,FremontBridge,12/15/2014 02:00:00 PM,48,-122,59,2,61
19287,FremontBridge,12/15/2014 03:00:00 PM,48,-122,65,54,119
19288,FremontBridge,12/15/2014 04:00:00 PM,48,-122,123,77,200
19289,FremontBridge,12/15/2014 05:00:00 PM,48,-122,278,114,392
19290,FremontBridge,12/15/2014 06:00:00 PM,48,-122,235,75,310
19291,FremontBridge,12/15/2014 07:00:00 PM,48,-122,82,43,125
19292,FremontBridge,12/15/2014 08:00:00 PM,48,-122,44,15,59
19293,FremontBridge,12/15/2014 09:00:00 PM,48,-122,28,21,49
19294,FremontBridge,12/15/2014 10:00:00 PM,48,-122,14,9,23
19295,FremontBridge,12/15/2014 11:00:00 PM,48,-122,8,7,15
19296,FremontBridge,12/16/2014 12:00:00 AM,48,-122,7,3,10
19297,FremontBridge,12/16/2014 01:00:00 AM,48,-122,3,1,4
19298,FremontBridge,12/16/2014 02:00:00 AM,48,-122,2,1,3
19299,FremontBridge,12/16/2014 03:00:00 AM,48,-122,4,3,7
19300,FremontBridge,12/16/2014 04:00:00 AM,48,-122,0,4,4
19301,FremontBridge,12/16/2014 05:00:00 AM,48,-122,3,21,24
19302,FremontBridge,12/16/2014 06:00:00 AM,48,-122,28,65,93
19303,FremontBridge,12/16/2014 07:00:00 AM,48,-122,15,220,235
19304,FremontBridge,12/16/2014 08:00:00 AM,48,-122,0,319,319
19305,FremontBridge,12/16/2014 09:00:00 AM,48,-122,1,169,170
19306,FremontBridge,12/16/2014 10:00:00 AM,48,-122,0,64,64
19307,FremontBridge,12/16/2014 11:00:00 AM,48,-122,0,63,63
19308,FremontBridge,12/16/2014 12:00:00 PM,48,-122,2,60,62
19309,FremontBridge,12/16/2014 01:00:00 PM,48,-122,50,0,50
19310,FremontBridge,12/16/2014 02:00:00 PM,48,-122,62,5,67
19311,FremontBridge,12/16/2014 03:00:00 PM,48,-122,60,51,111
19312,FremontBridge,12/16/2014 04:00:00 PM,48,-122,111,72,183
19313,FremontBridge,12/16/2014 05:00:00 PM,48,-122,259,106,365
19314,FremontBridge,12/16/2014 06:00:00 PM,48,-122,230,99,329
19315,FremontBridge,12/16/2014 07:00:00 PM,48,-122,78,49,127
19316,FremontBridge,12/16/2014 08:00:00 PM,48,-122,39,23,62
19317,FremontBridge,12/16/2014 09:00:00 PM,48,-122,20,10,30
19318,FremontBridge,12/16/2014 10:00:00 PM,48,-122,15,8,23
19319,FremontBridge,12/16/2014 11:00:00 PM,48,-122,15,4,19
19320,FremontBridge,12/17/2014 12:00:00 AM,48,-122,3,4,7
19321,FremontBridge,12/17/2014 01:00:00 AM,48,-122,2,3,5
19322,FremontBridge,12/17/2014 02:00:00 AM,48,-122,1,2,3
19323,FremontBridge,12/17/2014 03:00:00 AM,48,-122,1,2,3
19324,FremontBridge,12/17/2014 04:00:00 AM,48,-122,1,4,5
19325,FremontBridge,12/17/2014 05:00:00 AM,48,-122,3,20,23
19326,FremontBridge,12/17/2014 06:00:00 AM,48,-122,17,54,71
19327,FremontBridge,12/17/2014 07:00:00 AM,48,-122,143,25,168
19328,FremontBridge,12/17/2014 08:00:00 AM,48,-122,240,6,246
19329,FremontBridge,12/17/2014 09:00:00 AM,48,-122,135,0,135
19330,FremontBridge,12/17/2014 10:00:00 AM,48,-122,58,1,59
19331,FremontBridge,12/17/2014 11:00:00 AM,48,-122,38,0,38
19332,FremontBridge,12/17/2014 12:00:00 PM,48,-122,2,31,33
19333,FremontBridge,12/17/2014 01:00:00 PM,48,-122,0,36,36
19334,FremontBridge,12/17/2014 02:00:00 PM,48,-122,7,44,51
19335,FremontBridge,12/17/2014 03:00:00 PM,48,-122,44,36,80
19336,FremontBridge,12/17/2014 04:00:00 PM,48,-122,92,54,146
19337,FremontBridge,12/17/2014 05:00:00 PM,48,-122,226,93,319
19338,FremontBridge,12/17/2014 06:00:00 PM,48,-122,211,78,289
19339,FremontBridge,12/17/2014 07:00:00 PM,48,-122,78,44,122
19340,FremontBridge,12/17/2014 08:00:00 PM,48,-122,43,18,61
19341,FremontBridge,12/17/2014 09:00:00 PM,48,-122,15,17,32
19342,FremontBridge,12/17/2014 10:00:00 PM,48,-122,13,9,22
19343,FremontBridge,12/17/2014 11:00:00 PM,48,-122,19,6,25
19344,FremontBridge,12/18/2014 12:00:00 AM,48,-122,7,2,9
19345,FremontBridge,12/18/2014 01:00:00 AM,48,-122,2,2,4
19346,FremontBridge,12/18/2014 02:00:00 AM,48,-122,1,2,3
19347,FremontBridge,12/18/2014 03:00:00 AM,48,-122,2,0,2
19348,FremontBridge,12/18/2014 04:00:00 AM,48,-122,2,2,4
19349,FremontBridge,12/18/2014 05:00:00 AM,48,-122,5,18,23
19350,FremontBridge,12/18/2014 06:00:00 AM,48,-122,20,58,78
19351,FremontBridge,12/18/2014 07:00:00 AM,48,-122,11,165,176
19352,FremontBridge,12/18/2014 08:00:00 AM,48,-122,3,305,308
19353,FremontBridge,12/18/2014 09:00:00 AM,48,-122,0,143,143
19354,FremontBridge,12/18/2014 10:00:00 AM,48,-122,0,76,76
19355,FremontBridge,12/18/2014 11:00:00 AM,48,-122,0,39,39
19356,FremontBridge,12/18/2014 12:00:00 PM,48,-122,3,38,41
19357,FremontBridge,12/18/2014 01:00:00 PM,48,-122,0,50,50
19358,FremontBridge,12/18/2014 02:00:00 PM,48,-122,5,39,44
19359,FremontBridge,12/18/2014 03:00:00 PM,48,-122,34,32,66
19360,FremontBridge,12/18/2014 04:00:00 PM,48,-122,88,49,137
19361,FremontBridge,12/18/2014 05:00:00 PM,48,-122,204,84,288
19362,FremontBridge,12/18/2014 06:00:00 PM,48,-122,175,63,238
19363,FremontBridge,12/18/2014 07:00:00 PM,48,-122,66,35,101
19364,FremontBridge,12/18/2014 08:00:00 PM,48,-122,38,11,49
19365,FremontBridge,12/18/2014 09:00:00 PM,48,-122,25,9,34
19366,FremontBridge,12/18/2014 10:00:00 PM,48,-122,12,5,17
19367,FremontBridge,12/18/2014 11:00:00 PM,48,-122,9,2,11
19368,FremontBridge,12/19/2014 12:00:00 AM,48,-122,5,2,7
19369,FremontBridge,12/19/2014 01:00:00 AM,48,-122,3,0,3
19370,FremontBridge,12/19/2014 02:00:00 AM,48,-122,0,1,1
19371,FremontBridge,12/19/2014 03:00:00 AM,48,-122,0,1,1
19372,FremontBridge,12/19/2014 04:00:00 AM,48,-122,0,4,4
19373,FremontBridge,12/19/2014 05:00:00 AM,48,-122,4,10,14
19374,FremontBridge,12/19/2014 06:00:00 AM,48,-122,20,46,66
19375,FremontBridge,12/19/2014 07:00:00 AM,48,-122,44,95,139
19376,FremontBridge,12/19/2014 08:00:00 AM,48,-122,79,144,223
19377,FremontBridge,12/19/2014 09:00:00 AM,48,-122,61,129,190
19378,FremontBridge,12/19/2014 10:00:00 AM,48,-122,20,50,70
19379,FremontBridge,12/19/2014 11:00:00 AM,48,-122,31,38,69
19380,FremontBridge,12/19/2014 12:00:00 PM,48,-122,32,38,70
19381,FremontBridge,12/19/2014 01:00:00 PM,48,-122,34,40,74
19382,FremontBridge,12/19/2014 02:00:00 PM,48,-122,38,28,66
19383,FremontBridge,12/19/2014 03:00:00 PM,48,-122,47,42,89
19384,FremontBridge,12/19/2014 04:00:00 PM,48,-122,117,61,178
19385,FremontBridge,12/19/2014 05:00:00 PM,48,-122,153,85,238
19386,FremontBridge,12/19/2014 06:00:00 PM,48,-122,104,63,167
19387,FremontBridge,12/19/2014 07:00:00 PM,48,-122,57,27,84
19388,FremontBridge,12/19/2014 08:00:00 PM,48,-122,25,23,48
19389,FremontBridge,12/19/2014 09:00:00 PM,48,-122,23,9,32
19390,FremontBridge,12/19/2014 10:00:00 PM,48,-122,10,11,21
19391,FremontBridge,12/19/2014 11:00:00 PM,48,-122,10,6,16
19392,FremontBridge,12/20/2014 12:00:00 AM,48,-122,9,5,14
19393,FremontBridge,12/20/2014 01:00:00 AM,48,-122,6,6,12
19394,FremontBridge,12/20/2014 02:00:00 AM,48,-122,1,5,6
19395,FremontBridge,12/20/2014 03:00:00 AM,48,-122,2,0,2
19396,FremontBridge,12/20/2014 04:00:00 AM,48,-122,0,1,1
19397,FremontBridge,12/20/2014 05:00:00 AM,48,-122,2,4,6
19398,FremontBridge,12/20/2014 06:00:00 AM,48,-122,7,5,12
19399,FremontBridge,12/20/2014 07:00:00 AM,48,-122,5,7,12
19400,FremontBridge,12/20/2014 08:00:00 AM,48,-122,11,18,29
19401,FremontBridge,12/20/2014 09:00:00 AM,48,-122,8,6,14
19402,FremontBridge,12/20/2014 10:00:00 AM,48,-122,15,16,31
19403,FremontBridge,12/20/2014 11:00:00 AM,48,-122,9,12,21
19404,FremontBridge,12/20/2014 12:00:00 PM,48,-122,17,12,29
19405,FremontBridge,12/20/2014 01:00:00 PM,48,-122,14,17,31
19406,FremontBridge,12/20/2014 02:00:00 PM,48,-122,13,18,31
19407,FremontBridge,12/20/2014 03:00:00 PM,48,-122,10,15,25
19408,FremontBridge,12/20/2014 04:00:00 PM,48,-122,14,23,37
19409,FremontBridge,12/20/2014 05:00:00 PM,48,-122,11,10,21
19410,FremontBridge,12/20/2014 06:00:00 PM,48,-122,11,14,25
19411,FremontBridge,12/20/2014 07:00:00 PM,48,-122,5,4,9
19412,FremontBridge,12/20/2014 08:00:00 PM,48,-122,6,11,17
19413,FremontBridge,12/20/2014 09:00:00 PM,48,-122,3,3,6
19414,FremontBridge,12/20/2014 10:00:00 PM,48,-122,5,2,7
19415,FremontBridge,12/20/2014 11:00:00 PM,48,-122,4,2,6
19416,FremontBridge,12/21/2014 12:00:00 AM,48,-122,7,7,14
19417,FremontBridge,12/21/2014 01:00:00 AM,48,-122,7,1,8
19418,FremontBridge,12/21/2014 02:00:00 AM,48,-122,10,2,12
19419,FremontBridge,12/21/2014 03:00:00 AM,48,-122,1,4,5
19420,FremontBridge,12/21/2014 04:00:00 AM,48,-122,1,3,4
19421,FremontBridge,12/21/2014 05:00:00 AM,48,-122,1,3,4
19422,FremontBridge,12/21/2014 06:00:00 AM,48,-122,7,2,9
19423,FremontBridge,12/21/2014 07:00:00 AM,48,-122,7,8,15
19424,FremontBridge,12/21/2014 08:00:00 AM,48,-122,11,18,29
19425,FremontBridge,12/21/2014 09:00:00 AM,48,-122,20,30,50
19426,FremontBridge,12/21/2014 10:00:00 AM,48,-122,27,31,58
19427,FremontBridge,12/21/2014 11:00:00 AM,48,-122,28,50,78
19428,FremontBridge,12/21/2014 12:00:00 PM,48,-122,40,39,79
19429,FremontBridge,12/21/2014 01:00:00 PM,48,-122,38,55,93
19430,FremontBridge,12/21/2014 02:00:00 PM,48,-122,21,50,71
19431,FremontBridge,12/21/2014 03:00:00 PM,48,-122,44,51,95
19432,FremontBridge,12/21/2014 04:00:00 PM,48,-122,31,23,54
19433,FremontBridge,12/21/2014 05:00:00 PM,48,-122,34,18,52
19434,FremontBridge,12/21/2014 06:00:00 PM,48,-122,13,18,31
19435,FremontBridge,12/21/2014 07:00:00 PM,48,-122,9,7,16
19436,FremontBridge,12/21/2014 08:00:00 PM,48,-122,3,8,11
19437,FremontBridge,12/21/2014 09:00:00 PM,48,-122,6,10,16
19438,FremontBridge,12/21/2014 10:00:00 PM,48,-122,16,9,25
19439,FremontBridge,12/21/2014 11:00:00 PM,48,-122,8,7,15
19440,FremontBridge,12/22/2014 12:00:00 AM,48,-122,4,4,8
19441,FremontBridge,12/22/2014 01:00:00 AM,48,-122,1,0,1
19442,FremontBridge,12/22/2014 02:00:00 AM,48,-122,1,2,3
19443,FremontBridge,12/22/2014 03:00:00 AM,48,-122,0,3,3
19444,FremontBridge,12/22/2014 04:00:00 AM,48,-122,0,3,3
19445,FremontBridge,12/22/2014 05:00:00 AM,48,-122,8,21,29
19446,FremontBridge,12/22/2014 06:00:00 AM,48,-122,29,47,76
19447,FremontBridge,12/22/2014 07:00:00 AM,48,-122,59,145,204
19448,FremontBridge,12/22/2014 08:00:00 AM,48,-122,88,211,299
19449,FremontBridge,12/22/2014 09:00:00 AM,48,-122,51,112,163
19450,FremontBridge,12/22/2014 10:00:00 AM,48,-122,34,47,81
19451,FremontBridge,12/22/2014 11:00:00 AM,48,-122,40,46,86
19452,FremontBridge,12/22/2014 12:00:00 PM,48,-122,20,29,49
19453,FremontBridge,12/22/2014 01:00:00 PM,48,-122,31,38,69
19454,FremontBridge,12/22/2014 02:00:00 PM,48,-122,46,58,104
19455,FremontBridge,12/22/2014 03:00:00 PM,48,-122,61,52,113
19456,FremontBridge,12/22/2014 04:00:00 PM,48,-122,126,56,182
19457,FremontBridge,12/22/2014 05:00:00 PM,48,-122,243,103,346
19458,FremontBridge,12/22/2014 06:00:00 PM,48,-122,160,59,219
19459,FremontBridge,12/22/2014 07:00:00 PM,48,-122,64,36,100
19460,FremontBridge,12/22/2014 08:00:00 PM,48,-122,21,18,39
19461,FremontBridge,12/22/2014 09:00:00 PM,48,-122,18,17,35
19462,FremontBridge,12/22/2014 10:00:00 PM,48,-122,12,16,28
19463,FremontBridge,12/22/2014 11:00:00 PM,48,-122,7,9,16
19464,FremontBridge,12/23/2014 12:00:00 AM,48,-122,10,3,13
19465,FremontBridge,12/23/2014 01:00:00 AM,48,-122,5,3,8
19466,FremontBridge,12/23/2014 02:00:00 AM,48,-122,1,4,5
19467,FremontBridge,12/23/2014 03:00:00 AM,48,-122,0,2,2
19468,FremontBridge,12/23/2014 04:00:00 AM,48,-122,1,3,4
19469,FremontBridge,12/23/2014 05:00:00 AM,48,-122,4,15,19
19470,FremontBridge,12/23/2014 06:00:00 AM,48,-122,13,40,53
19471,FremontBridge,12/23/2014 07:00:00 AM,48,-122,46,101,147
19472,FremontBridge,12/23/2014 08:00:00 AM,48,-122,50,143,193
19473,FremontBridge,12/23/2014 09:00:00 AM,48,-122,45,72,117
19474,FremontBridge,12/23/2014 10:00:00 AM,48,-122,36,36,72
19475,FremontBridge,12/23/2014 11:00:00 AM,48,-122,20,26,46
19476,FremontBridge,12/23/2014 12:00:00 PM,48,-122,28,35,63
19477,FremontBridge,12/23/2014 01:00:00 PM,48,-122,19,47,66
19478,FremontBridge,12/23/2014 02:00:00 PM,48,-122,30,23,53
19479,FremontBridge,12/23/2014 03:00:00 PM,48,-122,45,24,69
19480,FremontBridge,12/23/2014 04:00:00 PM,48,-122,72,37,109
19481,FremontBridge,12/23/2014 05:00:00 PM,48,-122,124,43,167
19482,FremontBridge,12/23/2014 06:00:00 PM,48,-122,67,39,106
19483,FremontBridge,12/23/2014 07:00:00 PM,48,-122,20,11,31
19484,FremontBridge,12/23/2014 08:00:00 PM,48,-122,21,3,24
19485,FremontBridge,12/23/2014 09:00:00 PM,48,-122,4,4,8
19486,FremontBridge,12/23/2014 10:00:00 PM,48,-122,6,6,12
19487,FremontBridge,12/23/2014 11:00:00 PM,48,-122,3,10,13
19488,FremontBridge,12/24/2014 12:00:00 AM,48,-122,4,1,5
19489,FremontBridge,12/24/2014 01:00:00 AM,48,-122,2,4,6
19490,FremontBridge,12/24/2014 02:00:00 AM,48,-122,0,1,1
19491,FremontBridge,12/24/2014 03:00:00 AM,48,-122,3,1,4
19492,FremontBridge,12/24/2014 04:00:00 AM,48,-122,0,2,2
19493,FremontBridge,12/24/2014 05:00:00 AM,48,-122,0,6,6
19494,FremontBridge,12/24/2014 06:00:00 AM,48,-122,8,19,27
19495,FremontBridge,12/24/2014 07:00:00 AM,48,-122,15,46,61
19496,FremontBridge,12/24/2014 08:00:00 AM,48,-122,26,51,77
19497,FremontBridge,12/24/2014 09:00:00 AM,48,-122,22,40,62
19498,FremontBridge,12/24/2014 10:00:00 AM,48,-122,14,30,44
19499,FremontBridge,12/24/2014 11:00:00 AM,48,-122,26,24,50
19500,FremontBridge,12/24/2014 12:00:00 PM,48,-122,30,29,59
19501,FremontBridge,12/24/2014 01:00:00 PM,48,-122,33,30,63
19502,FremontBridge,12/24/2014 02:00:00 PM,48,-122,44,26,70
19503,FremontBridge,12/24/2014 03:00:00 PM,48,-122,56,49,105
19504,FremontBridge,12/24/2014 04:00:00 PM,48,-122,40,32,72
19505,FremontBridge,12/24/2014 05:00:00 PM,48,-122,28,17,45
19506,FremontBridge,12/24/2014 06:00:00 PM,48,-122,10,6,16
19507,FremontBridge,12/24/2014 07:00:00 PM,48,-122,9,3,12
19508,FremontBridge,12/24/2014 08:00:00 PM,48,-122,5,3,8
19509,FremontBridge,12/24/2014 09:00:00 PM,48,-122,4,2,6
19510,FremontBridge,12/24/2014 10:00:00 PM,48,-122,2,5,7
19511,FremontBridge,12/24/2014 11:00:00 PM,48,-122,2,3,5
19512,FremontBridge,12/25/2014 12:00:00 AM,48,-122,1,0,1
19513,FremontBridge,12/25/2014 01:00:00 AM,48,-122,2,1,3
19514,FremontBridge,12/25/2014 02:00:00 AM,48,-122,1,0,1
19515,FremontBridge,12/25/2014 03:00:00 AM,48,-122,0,0,0
19516,FremontBridge,12/25/2014 04:00:00 AM,48,-122,1,0,1
19517,FremontBridge,12/25/2014 05:00:00 AM,48,-122,0,3,3
19518,FremontBridge,12/25/2014 06:00:00 AM,48,-122,2,2,4
19519,FremontBridge,12/25/2014 07:00:00 AM,48,-122,3,1,4
19520,FremontBridge,12/25/2014 08:00:00 AM,48,-122,5,2,7
19521,FremontBridge,12/25/2014 09:00:00 AM,48,-122,4,16,20
19522,FremontBridge,12/25/2014 10:00:00 AM,48,-122,8,23,31
19523,FremontBridge,12/25/2014 11:00:00 AM,48,-122,13,14,27
19524,FremontBridge,12/25/2014 12:00:00 PM,48,-122,10,24,34
19525,FremontBridge,12/25/2014 01:00:00 PM,48,-122,32,45,77
19526,FremontBridge,12/25/2014 02:00:00 PM,48,-122,38,36,74
19527,FremontBridge,12/25/2014 03:00:00 PM,48,-122,23,41,64
19528,FremontBridge,12/25/2014 04:00:00 PM,48,-122,15,11,26
19529,FremontBridge,12/25/2014 05:00:00 PM,48,-122,7,5,12
19530,FremontBridge,12/25/2014 06:00:00 PM,48,-122,9,4,13
19531,FremontBridge,12/25/2014 07:00:00 PM,48,-122,7,11,18
19532,FremontBridge,12/25/2014 08:00:00 PM,48,-122,6,2,8
19533,FremontBridge,12/25/2014 09:00:00 PM,48,-122,3,2,5
19534,FremontBridge,12/25/2014 10:00:00 PM,48,-122,6,5,11
19535,FremontBridge,12/25/2014 11:00:00 PM,48,-122,2,5,7
19536,FremontBridge,12/26/2014 12:00:00 AM,48,-122,2,4,6
19537,FremontBridge,12/26/2014 01:00:00 AM,48,-122,1,3,4
19538,FremontBridge,12/26/2014 02:00:00 AM,48,-122,0,1,1
19539,FremontBridge,12/26/2014 03:00:00 AM,48,-122,0,1,1
19540,FremontBridge,12/26/2014 04:00:00 AM,48,-122,1,0,1
19541,FremontBridge,12/26/2014 05:00:00 AM,48,-122,4,7,11
19542,FremontBridge,12/26/2014 06:00:00 AM,48,-122,11,10,21
19543,FremontBridge,12/26/2014 07:00:00 AM,48,-122,19,31,50
19544,FremontBridge,12/26/2014 08:00:00 AM,48,-122,20,32,52
19545,FremontBridge,12/26/2014 09:00:00 AM,48,-122,31,45,76
19546,FremontBridge,12/26/2014 10:00:00 AM,48,-122,20,31,51
19547,FremontBridge,12/26/2014 11:00:00 AM,48,-122,18,30,48
19548,FremontBridge,12/26/2014 12:00:00 PM,48,-122,35,38,73
19549,FremontBridge,12/26/2014 01:00:00 PM,48,-122,41,47,88
19550,FremontBridge,12/26/2014 02:00:00 PM,48,-122,58,47,105
19551,FremontBridge,12/26/2014 03:00:00 PM,48,-122,69,43,112
19552,FremontBridge,12/26/2014 04:00:00 PM,48,-122,55,47,102
19553,FremontBridge,12/26/2014 05:00:00 PM,48,-122,47,26,73
19554,FremontBridge,12/26/2014 06:00:00 PM,48,-122,37,12,49
19555,FremontBridge,12/26/2014 07:00:00 PM,48,-122,11,14,25
19556,FremontBridge,12/26/2014 08:00:00 PM,48,-122,6,2,8
19557,FremontBridge,12/26/2014 09:00:00 PM,48,-122,12,5,17
19558,FremontBridge,12/26/2014 10:00:00 PM,48,-122,9,6,15
19559,FremontBridge,12/26/2014 11:00:00 PM,48,-122,7,3,10
19560,FremontBridge,12/27/2014 12:00:00 AM,48,-122,6,1,7
19561,FremontBridge,12/27/2014 01:00:00 AM,48,-122,1,4,5
19562,FremontBridge,12/27/2014 02:00:00 AM,48,-122,0,2,2
19563,FremontBridge,12/27/2014 03:00:00 AM,48,-122,0,1,1
19564,FremontBridge,12/27/2014 04:00:00 AM,48,-122,0,0,0
19565,FremontBridge,12/27/2014 05:00:00 AM,48,-122,3,2,5
19566,FremontBridge,12/27/2014 06:00:00 AM,48,-122,8,11,19
19567,FremontBridge,12/27/2014 07:00:00 AM,48,-122,2,5,7
19568,FremontBridge,12/27/2014 08:00:00 AM,48,-122,17,12,29
19569,FremontBridge,12/27/2014 09:00:00 AM,48,-122,12,10,22
19570,FremontBridge,12/27/2014 10:00:00 AM,48,-122,12,28,40
19571,FremontBridge,12/27/2014 11:00:00 AM,48,-122,13,19,32
19572,FremontBridge,12/27/2014 12:00:00 PM,48,-122,40,34,74
19573,FremontBridge,12/27/2014 01:00:00 PM,48,-122,24,28,52
19574,FremontBridge,12/27/2014 02:00:00 PM,48,-122,16,36,52
19575,FremontBridge,12/27/2014 03:00:00 PM,48,-122,18,17,35
19576,FremontBridge,12/27/2014 04:00:00 PM,48,-122,19,12,31
19577,FremontBridge,12/27/2014 05:00:00 PM,48,-122,20,20,40
19578,FremontBridge,12/27/2014 06:00:00 PM,48,-122,12,9,21
19579,FremontBridge,12/27/2014 07:00:00 PM,48,-122,9,6,15
19580,FremontBridge,12/27/2014 08:00:00 PM,48,-122,6,10,16
19581,FremontBridge,12/27/2014 09:00:00 PM,48,-122,10,8,18
19582,FremontBridge,12/27/2014 10:00:00 PM,48,-122,7,2,9
19583,FremontBridge,12/27/2014 11:00:00 PM,48,-122,7,4,11
19584,FremontBridge,12/28/2014 12:00:00 AM,48,-122,5,1,6
19585,FremontBridge,12/28/2014 01:00:00 AM,48,-122,1,2,3
19586,FremontBridge,12/28/2014 02:00:00 AM,48,-122,0,0,0
19587,FremontBridge,12/28/2014 03:00:00 AM,48,-122,1,0,1
19588,FremontBridge,12/28/2014 04:00:00 AM,48,-122,0,2,2
19589,FremontBridge,12/28/2014 05:00:00 AM,48,-122,5,1,6
19590,FremontBridge,12/28/2014 06:00:00 AM,48,-122,5,0,5
19591,FremontBridge,12/28/2014 07:00:00 AM,48,-122,2,7,9
19592,FremontBridge,12/28/2014 08:00:00 AM,48,-122,7,19,26
19593,FremontBridge,12/28/2014 09:00:00 AM,48,-122,24,32,56
19594,FremontBridge,12/28/2014 10:00:00 AM,48,-122,21,54,75
19595,FremontBridge,12/28/2014 11:00:00 AM,48,-122,39,38,77
19596,FremontBridge,12/28/2014 12:00:00 PM,48,-122,35,38,73
19597,FremontBridge,12/28/2014 01:00:00 PM,48,-122,32,38,70
19598,FremontBridge,12/28/2014 02:00:00 PM,48,-122,16,27,43
19599,FremontBridge,12/28/2014 03:00:00 PM,48,-122,18,21,39
19600,FremontBridge,12/28/2014 04:00:00 PM,48,-122,18,18,36
19601,FremontBridge,12/28/2014 05:00:00 PM,48,-122,21,14,35
19602,FremontBridge,12/28/2014 06:00:00 PM,48,-122,11,13,24
19603,FremontBridge,12/28/2014 07:00:00 PM,48,-122,6,11,17
19604,FremontBridge,12/28/2014 08:00:00 PM,48,-122,7,4,11
19605,FremontBridge,12/28/2014 09:00:00 PM,48,-122,5,6,11
19606,FremontBridge,12/28/2014 10:00:00 PM,48,-122,9,3,12
19607,FremontBridge,12/28/2014 11:00:00 PM,48,-122,4,3,7
19608,FremontBridge,12/29/2014 12:00:00 AM,48,-122,3,1,4
19609,FremontBridge,12/29/2014 01:00:00 AM,48,-122,0,0,0
19610,FremontBridge,12/29/2014 02:00:00 AM,48,-122,0,1,1
19611,FremontBridge,12/29/2014 03:00:00 AM,48,-122,1,0,1
19612,FremontBridge,12/29/2014 04:00:00 AM,48,-122,2,5,7
19613,FremontBridge,12/29/2014 05:00:00 AM,48,-122,9,11,20
19614,FremontBridge,12/29/2014 06:00:00 AM,48,-122,23,31,54
19615,FremontBridge,12/29/2014 07:00:00 AM,48,-122,36,108,144
19616,FremontBridge,12/29/2014 08:00:00 AM,48,-122,57,148,205
19617,FremontBridge,12/29/2014 09:00:00 AM,48,-122,42,95,137
19618,FremontBridge,12/29/2014 10:00:00 AM,48,-122,23,34,57
19619,FremontBridge,12/29/2014 11:00:00 AM,48,-122,21,27,48
19620,FremontBridge,12/29/2014 12:00:00 PM,48,-122,28,29,57
19621,FremontBridge,12/29/2014 01:00:00 PM,48,-122,33,31,64
19622,FremontBridge,12/29/2014 02:00:00 PM,48,-122,28,35,63
19623,FremontBridge,12/29/2014 03:00:00 PM,48,-122,64,33,97
19624,FremontBridge,12/29/2014 04:00:00 PM,48,-122,76,58,134
19625,FremontBridge,12/29/2014 05:00:00 PM,48,-122,189,74,263
19626,FremontBridge,12/29/2014 06:00:00 PM,48,-122,108,52,160
19627,FremontBridge,12/29/2014 07:00:00 PM,48,-122,31,16,47
19628,FremontBridge,12/29/2014 08:00:00 PM,48,-122,21,17,38
19629,FremontBridge,12/29/2014 09:00:00 PM,48,-122,13,3,16
19630,FremontBridge,12/29/2014 10:00:00 PM,48,-122,8,6,14
19631,FremontBridge,12/29/2014 11:00:00 PM,48,-122,4,6,10
19632,FremontBridge,12/30/2014 12:00:00 AM,48,-122,3,5,8
19633,FremontBridge,12/30/2014 01:00:00 AM,48,-122,3,1,4
19634,FremontBridge,12/30/2014 02:00:00 AM,48,-122,1,0,1
19635,FremontBridge,12/30/2014 03:00:00 AM,48,-122,2,1,3
19636,FremontBridge,12/30/2014 04:00:00 AM,48,-122,1,1,2
19637,FremontBridge,12/30/2014 05:00:00 AM,48,-122,7,4,11
19638,FremontBridge,12/30/2014 06:00:00 AM,48,-122,16,30,46
19639,FremontBridge,12/30/2014 07:00:00 AM,48,-122,22,92,114
19640,FremontBridge,12/30/2014 08:00:00 AM,48,-122,52,142,194
19641,FremontBridge,12/30/2014 09:00:00 AM,48,-122,42,78,120
19642,FremontBridge,12/30/2014 10:00:00 AM,48,-122,26,34,60
19643,FremontBridge,12/30/2014 11:00:00 AM,48,-122,19,24,43
19644,FremontBridge,12/30/2014 12:00:00 PM,48,-122,16,23,39
19645,FremontBridge,12/30/2014 01:00:00 PM,48,-122,32,34,66
19646,FremontBridge,12/30/2014 02:00:00 PM,48,-122,35,45,80
19647,FremontBridge,12/30/2014 03:00:00 PM,48,-122,46,30,76
19648,FremontBridge,12/30/2014 04:00:00 PM,48,-122,78,44,122
19649,FremontBridge,12/30/2014 05:00:00 PM,48,-122,154,76,230
19650,FremontBridge,12/30/2014 06:00:00 PM,48,-122,109,46,155
19651,FremontBridge,12/30/2014 07:00:00 PM,48,-122,41,21,62
19652,FremontBridge,12/30/2014 08:00:00 PM,48,-122,16,8,24
19653,FremontBridge,12/30/2014 09:00:00 PM,48,-122,13,8,21
19654,FremontBridge,12/30/2014 10:00:00 PM,48,-122,6,8,14
19655,FremontBridge,12/30/2014 11:00:00 PM,48,-122,4,1,5
19656,FremontBridge,12/31/2014 12:00:00 AM,48,-122,5,3,8
19657,FremontBridge,12/31/2014 01:00:00 AM,48,-122,1,1,2
19658,FremontBridge,12/31/2014 02:00:00 AM,48,-122,1,2,3
19659,FremontBridge,12/31/2014 03:00:00 AM,48,-122,0,0,0
19660,FremontBridge,12/31/2014 04:00:00 AM,48,-122,2,2,4
19661,FremontBridge,12/31/2014 05:00:00 AM,48,-122,3,13,16
19662,FremontBridge,12/31/2014 06:00:00 AM,48,-122,15,21,36
19663,FremontBridge,12/31/2014 07:00:00 AM,48,-122,30,51,81
19664,FremontBridge,12/31/2014 08:00:00 AM,48,-122,43,106,149
19665,FremontBridge,12/31/2014 09:00:00 AM,48,-122,47,66,113
19666,FremontBridge,12/31/2014 10:00:00 AM,48,-122,17,29,46
19667,FremontBridge,12/31/2014 11:00:00 AM,48,-122,16,32,48
19668,FremontBridge,12/31/2014 12:00:00 PM,48,-122,26,32,58
19669,FremontBridge,12/31/2014 01:00:00 PM,48,-122,36,55,91
19670,FremontBridge,12/31/2014 02:00:00 PM,48,-122,55,47,102
19671,FremontBridge,12/31/2014 03:00:00 PM,48,-122,73,68,141
19672,FremontBridge,12/31/2014 04:00:00 PM,48,-122,75,58,133
19673,FremontBridge,12/31/2014 05:00:00 PM,48,-122,82,40,122
19674,FremontBridge,12/31/2014 06:00:00 PM,48,-122,35,26,61
19675,FremontBridge,12/31/2014 07:00:00 PM,48,-122,20,18,38
19676,FremontBridge,12/31/2014 08:00:00 PM,48,-122,8,12,20
19677,FremontBridge,12/31/2014 09:00:00 PM,48,-122,8,9,17
19678,FremontBridge,12/31/2014 10:00:00 PM,48,-122,9,10,19
19679,FremontBridge,12/31/2014 11:00:00 PM,48,-122,11,12,23
19680,FremontBridge,01/01/2015 12:00:00 AM,48,-122,9,4,13
19681,FremontBridge,01/01/2015 01:00:00 AM,48,-122,23,4,27
19682,FremontBridge,01/01/2015 02:00:00 AM,48,-122,14,5,19
19683,FremontBridge,01/01/2015 03:00:00 AM,48,-122,6,0,6
19684,FremontBridge,01/01/2015 04:00:00 AM,48,-122,3,2,5
19685,FremontBridge,01/01/2015 05:00:00 AM,48,-122,5,4,9
19686,FremontBridge,01/01/2015 06:00:00 AM,48,-122,0,4,4
19687,FremontBridge,01/01/2015 07:00:00 AM,48,-122,0,4,4
19688,FremontBridge,01/01/2015 08:00:00 AM,48,-122,3,5,8
19689,FremontBridge,01/01/2015 09:00:00 AM,48,-122,11,12,23
19690,FremontBridge,01/01/2015 10:00:00 AM,48,-122,7,23,30
19691,FremontBridge,01/01/2015 11:00:00 AM,48,-122,20,26,46
19692,FremontBridge,01/01/2015 12:00:00 PM,48,-122,25,33,58
19693,FremontBridge,01/01/2015 01:00:00 PM,48,-122,23,65,88
19694,FremontBridge,01/01/2015 02:00:00 PM,48,-122,53,66,119
19695,FremontBridge,01/01/2015 03:00:00 PM,48,-122,27,45,72
19696,FremontBridge,01/01/2015 04:00:00 PM,48,-122,34,44,78
19697,FremontBridge,01/01/2015 05:00:00 PM,48,-122,16,13,29
19698,FremontBridge,01/01/2015 06:00:00 PM,48,-122,11,10,21
19699,FremontBridge,01/01/2015 07:00:00 PM,48,-122,11,8,19
19700,FremontBridge,01/01/2015 08:00:00 PM,48,-122,8,5,13
19701,FremontBridge,01/01/2015 09:00:00 PM,48,-122,5,7,12
19702,FremontBridge,01/01/2015 10:00:00 PM,48,-122,4,1,5
19703,FremontBridge,01/01/2015 11:00:00 PM,48,-122,3,0,3
19704,FremontBridge,01/02/2015 12:00:00 AM,48,-122,2,2,4
19705,FremontBridge,01/02/2015 01:00:00 AM,48,-122,1,2,3
19706,FremontBridge,01/02/2015 02:00:00 AM,48,-122,0,0,0
19707,FremontBridge,01/02/2015 03:00:00 AM,48,-122,1,2,3
19708,FremontBridge,01/02/2015 04:00:00 AM,48,-122,1,1,2
19709,FremontBridge,01/02/2015 05:00:00 AM,48,-122,3,14,17
19710,FremontBridge,01/02/2015 06:00:00 AM,48,-122,10,26,36
19711,FremontBridge,01/02/2015 07:00:00 AM,48,-122,23,73,96
19712,FremontBridge,01/02/2015 08:00:00 AM,48,-122,42,93,135
19713,FremontBridge,01/02/2015 09:00:00 AM,48,-122,36,84,120
19714,FremontBridge,01/02/2015 10:00:00 AM,48,-122,23,44,67
19715,FremontBridge,01/02/2015 11:00:00 AM,48,-122,17,33,50
19716,FremontBridge,01/02/2015 12:00:00 PM,48,-122,33,25,58
19717,FremontBridge,01/02/2015 01:00:00 PM,48,-122,25,31,56
19718,FremontBridge,01/02/2015 02:00:00 PM,48,-122,33,18,51
19719,FremontBridge,01/02/2015 03:00:00 PM,48,-122,39,36,75
19720,FremontBridge,01/02/2015 04:00:00 PM,48,-122,78,52,130
19721,FremontBridge,01/02/2015 05:00:00 PM,48,-122,96,40,136
19722,FremontBridge,01/02/2015 06:00:00 PM,48,-122,55,21,76
19723,FremontBridge,01/02/2015 07:00:00 PM,48,-122,21,17,38
19724,FremontBridge,01/02/2015 08:00:00 PM,48,-122,16,8,24
19725,FremontBridge,01/02/2015 09:00:00 PM,48,-122,5,13,18
19726,FremontBridge,01/02/2015 10:00:00 PM,48,-122,4,7,11
19727,FremontBridge,01/02/2015 11:00:00 PM,48,-122,7,1,8
19728,FremontBridge,01/03/2015 12:00:00 AM,48,-122,4,5,9
19729,FremontBridge,01/03/2015 01:00:00 AM,48,-122,4,4,8
19730,FremontBridge,01/03/2015 02:00:00 AM,48,-122,1,0,1
19731,FremontBridge,01/03/2015 03:00:00 AM,48,-122,2,2,4
19732,FremontBridge,01/03/2015 04:00:00 AM,48,-122,1,3,4
19733,FremontBridge,01/03/2015 05:00:00 AM,48,-122,2,6,8
19734,FremontBridge,01/03/2015 06:00:00 AM,48,-122,5,7,12
19735,FremontBridge,01/03/2015 07:00:00 AM,48,-122,7,7,14
19736,FremontBridge,01/03/2015 08:00:00 AM,48,-122,18,18,36
19737,FremontBridge,01/03/2015 09:00:00 AM,48,-122,19,14,33
19738,FremontBridge,01/03/2015 10:00:00 AM,48,-122,17,26,43
19739,FremontBridge,01/03/2015 11:00:00 AM,48,-122,31,34,65
19740,FremontBridge,01/03/2015 12:00:00 PM,48,-122,30,41,71
19741,FremontBridge,01/03/2015 01:00:00 PM,48,-122,51,59,110
19742,FremontBridge,01/03/2015 02:00:00 PM,48,-122,36,55,91
19743,FremontBridge,01/03/2015 03:00:00 PM,48,-122,30,51,81
19744,FremontBridge,01/03/2015 04:00:00 PM,48,-122,38,42,80
19745,FremontBridge,01/03/2015 05:00:00 PM,48,-122,17,25,42
19746,FremontBridge,01/03/2015 06:00:00 PM,48,-122,16,22,38
19747,FremontBridge,01/03/2015 07:00:00 PM,48,-122,8,11,19
19748,FremontBridge,01/03/2015 08:00:00 PM,48,-122,6,4,10
19749,FremontBridge,01/03/2015 09:00:00 PM,48,-122,7,10,17
19750,FremontBridge,01/03/2015 10:00:00 PM,48,-122,10,2,12
19751,FremontBridge,01/03/2015 11:00:00 PM,48,-122,5,4,9
19752,FremontBridge,01/04/2015 12:00:00 AM,48,-122,4,2,6
19753,FremontBridge,01/04/2015 01:00:00 AM,48,-122,3,5,8
19754,FremontBridge,01/04/2015 02:00:00 AM,48,-122,3,1,4
19755,FremontBridge,01/04/2015 03:00:00 AM,48,-122,1,1,2
19756,FremontBridge,01/04/2015 04:00:00 AM,48,-122,0,1,1
19757,FremontBridge,01/04/2015 05:00:00 AM,48,-122,2,1,3
19758,FremontBridge,01/04/2015 06:00:00 AM,48,-122,3,1,4
19759,FremontBridge,01/04/2015 07:00:00 AM,48,-122,5,4,9
19760,FremontBridge,01/04/2015 08:00:00 AM,48,-122,8,10,18
19761,FremontBridge,01/04/2015 09:00:00 AM,48,-122,8,10,18
19762,FremontBridge,01/04/2015 10:00:00 AM,48,-122,10,18,28
19763,FremontBridge,01/04/2015 11:00:00 AM,48,-122,10,10,20
19764,FremontBridge,01/04/2015 12:00:00 PM,48,-122,16,17,33
19765,FremontBridge,01/04/2015 01:00:00 PM,48,-122,15,16,31
19766,FremontBridge,01/04/2015 02:00:00 PM,48,-122,14,13,27
19767,FremontBridge,01/04/2015 03:00:00 PM,48,-122,21,12,33
19768,FremontBridge,01/04/2015 04:00:00 PM,48,-122,19,9,28
19769,FremontBridge,01/04/2015 05:00:00 PM,48,-122,5,10,15
19770,FremontBridge,01/04/2015 06:00:00 PM,48,-122,11,14,25
19771,FremontBridge,01/04/2015 07:00:00 PM,48,-122,5,3,8
19772,FremontBridge,01/04/2015 08:00:00 PM,48,-122,4,2,6
19773,FremontBridge,01/04/2015 09:00:00 PM,48,-122,1,2,3
19774,FremontBridge,01/04/2015 10:00:00 PM,48,-122,5,3,8
19775,FremontBridge,01/04/2015 11:00:00 PM,48,-122,1,0,1
19776,FremontBridge,01/05/2015 12:00:00 AM,48,-122,1,1,2
19777,FremontBridge,01/05/2015 01:00:00 AM,48,-122,0,0,0
19778,FremontBridge,01/05/2015 02:00:00 AM,48,-122,0,0,0
19779,FremontBridge,01/05/2015 03:00:00 AM,48,-122,1,6,7
19780,FremontBridge,01/05/2015 04:00:00 AM,48,-122,1,3,4
19781,FremontBridge,01/05/2015 05:00:00 AM,48,-122,9,20,29
19782,FremontBridge,01/05/2015 06:00:00 AM,48,-122,34,48,82
19783,FremontBridge,01/05/2015 07:00:00 AM,48,-122,25,154,179
19784,FremontBridge,01/05/2015 08:00:00 AM,48,-122,1,256,257
19785,FremontBridge,01/05/2015 09:00:00 AM,48,-122,0,146,146
19786,FremontBridge,01/05/2015 10:00:00 AM,48,-122,0,51,51
19787,FremontBridge,01/05/2015 11:00:00 AM,48,-122,0,27,27
19788,FremontBridge,01/05/2015 12:00:00 PM,48,-122,1,27,28
19789,FremontBridge,01/05/2015 01:00:00 PM,48,-122,0,36,36
19790,FremontBridge,01/05/2015 02:00:00 PM,48,-122,2,31,33
19791,FremontBridge,01/05/2015 03:00:00 PM,48,-122,29,32,61
19792,FremontBridge,01/05/2015 04:00:00 PM,48,-122,75,63,138
19793,FremontBridge,01/05/2015 05:00:00 PM,48,-122,221,99,320
19794,FremontBridge,01/05/2015 06:00:00 PM,48,-122,179,71,250
19795,FremontBridge,01/05/2015 07:00:00 PM,48,-122,54,36,90
19796,FremontBridge,01/05/2015 08:00:00 PM,48,-122,27,17,44
19797,FremontBridge,01/05/2015 09:00:00 PM,48,-122,11,7,18
19798,FremontBridge,01/05/2015 10:00:00 PM,48,-122,4,7,11
19799,FremontBridge,01/05/2015 11:00:00 PM,48,-122,3,7,10
19800,FremontBridge,01/06/2015 12:00:00 AM,48,-122,1,1,2
19801,FremontBridge,01/06/2015 01:00:00 AM,48,-122,3,2,5
19802,FremontBridge,01/06/2015 02:00:00 AM,48,-122,0,1,1
19803,FremontBridge,01/06/2015 03:00:00 AM,48,-122,3,4,7
19804,FremontBridge,01/06/2015 04:00:00 AM,48,-122,3,2,5
19805,FremontBridge,01/06/2015 05:00:00 AM,48,-122,11,23,34
19806,FremontBridge,01/06/2015 06:00:00 AM,48,-122,30,72,102
19807,FremontBridge,01/06/2015 07:00:00 AM,48,-122,11,234,245
19808,FremontBridge,01/06/2015 08:00:00 AM,48,-122,0,368,368
19809,FremontBridge,01/06/2015 09:00:00 AM,48,-122,1,206,207
19810,FremontBridge,01/06/2015 10:00:00 AM,48,-122,1,105,106
19811,FremontBridge,01/06/2015 11:00:00 AM,48,-122,0,44,44
19812,FremontBridge,01/06/2015 12:00:00 PM,48,-122,0,64,64
19813,FremontBridge,01/06/2015 01:00:00 PM,48,-122,0,49,49
19814,FremontBridge,01/06/2015 02:00:00 PM,48,-122,0,62,62
19815,FremontBridge,01/06/2015 03:00:00 PM,48,-122,76,51,127
19816,FremontBridge,01/06/2015 04:00:00 PM,48,-122,137,91,228
19817,FremontBridge,01/06/2015 05:00:00 PM,48,-122,287,133,420
19818,FremontBridge,01/06/2015 06:00:00 PM,48,-122,245,109,354
19819,FremontBridge,01/06/2015 07:00:00 PM,48,-122,100,52,152
19820,FremontBridge,01/06/2015 08:00:00 PM,48,-122,41,23,64
19821,FremontBridge,01/06/2015 09:00:00 PM,48,-122,24,19,43
19822,FremontBridge,01/06/2015 10:00:00 PM,48,-122,15,12,27
19823,FremontBridge,01/06/2015 11:00:00 PM,48,-122,5,4,9
19824,FremontBridge,01/07/2015 12:00:00 AM,48,-122,4,5,9
19825,FremontBridge,01/07/2015 01:00:00 AM,48,-122,1,4,5
19826,FremontBridge,01/07/2015 02:00:00 AM,48,-122,0,6,6
19827,FremontBridge,01/07/2015 03:00:00 AM,48,-122,2,1,3
19828,FremontBridge,01/07/2015 04:00:00 AM,48,-122,1,3,4
19829,FremontBridge,01/07/2015 05:00:00 AM,48,-122,6,20,26
19830,FremontBridge,01/07/2015 06:00:00 AM,48,-122,30,76,106
19831,FremontBridge,01/07/2015 07:00:00 AM,48,-122,13,228,241
19832,FremontBridge,01/07/2015 08:00:00 AM,48,-122,0,376,376
19833,FremontBridge,01/07/2015 09:00:00 AM,48,-122,0,254,254
19834,FremontBridge,01/07/2015 10:00:00 AM,48,-122,0,73,73
19835,FremontBridge,01/07/2015 11:00:00 AM,48,-122,0,52,52
19836,FremontBridge,01/07/2015 12:00:00 PM,48,-122,1,60,61
19837,FremontBridge,01/07/2015 01:00:00 PM,48,-122,0,60,60
19838,FremontBridge,01/07/2015 02:00:00 PM,48,-122,2,71,73
19839,FremontBridge,01/07/2015 03:00:00 PM,48,-122,55,47,102
19840,FremontBridge,01/07/2015 04:00:00 PM,48,-122,100,88,188
19841,FremontBridge,01/07/2015 05:00:00 PM,48,-122,346,135,481
19842,FremontBridge,01/07/2015 06:00:00 PM,48,-122,244,130,374
19843,FremontBridge,01/07/2015 07:00:00 PM,48,-122,95,58,153
19844,FremontBridge,01/07/2015 08:00:00 PM,48,-122,50,24,74
19845,FremontBridge,01/07/2015 09:00:00 PM,48,-122,35,21,56
19846,FremontBridge,01/07/2015 10:00:00 PM,48,-122,15,15,30
19847,FremontBridge,01/07/2015 11:00:00 PM,48,-122,8,10,18
19848,FremontBridge,01/08/2015 12:00:00 AM,48,-122,3,2,5
19849,FremontBridge,01/08/2015 01:00:00 AM,48,-122,3,0,3
19850,FremontBridge,01/08/2015 02:00:00 AM,48,-122,0,2,2
19851,FremontBridge,01/08/2015 03:00:00 AM,48,-122,2,2,4
19852,FremontBridge,01/08/2015 04:00:00 AM,48,-122,1,6,7
19853,FremontBridge,01/08/2015 05:00:00 AM,48,-122,8,24,32
19854,FremontBridge,01/08/2015 06:00:00 AM,48,-122,34,78,112
19855,FremontBridge,01/08/2015 07:00:00 AM,48,-122,7,185,192
19856,FremontBridge,01/08/2015 08:00:00 AM,48,-122,0,341,341
19857,FremontBridge,01/08/2015 09:00:00 AM,48,-122,1,178,179
19858,FremontBridge,01/08/2015 10:00:00 AM,48,-122,0,73,73
19859,FremontBridge,01/08/2015 11:00:00 AM,48,-122,2,42,44
19860,FremontBridge,01/08/2015 12:00:00 PM,48,-122,0,63,63
19861,FremontBridge,01/08/2015 01:00:00 PM,48,-122,0,75,75
19862,FremontBridge,01/08/2015 02:00:00 PM,48,-122,16,59,75
19863,FremontBridge,01/08/2015 03:00:00 PM,48,-122,65,63,128
19864,FremontBridge,01/08/2015 04:00:00 PM,48,-122,110,72,182
19865,FremontBridge,01/08/2015 05:00:00 PM,48,-122,277,125,402
19866,FremontBridge,01/08/2015 06:00:00 PM,48,-122,215,105,320
19867,FremontBridge,01/08/2015 07:00:00 PM,48,-122,101,64,165
19868,FremontBridge,01/08/2015 08:00:00 PM,48,-122,43,24,67
19869,FremontBridge,01/08/2015 09:00:00 PM,48,-122,27,29,56
19870,FremontBridge,01/08/2015 10:00:00 PM,48,-122,20,21,41
19871,FremontBridge,01/08/2015 11:00:00 PM,48,-122,24,18,42
19872,FremontBridge,01/09/2015 12:00:00 AM,48,-122,12,15,27
19873,FremontBridge,01/09/2015 01:00:00 AM,48,-122,0,16,16
19874,FremontBridge,01/09/2015 02:00:00 AM,48,-122,1,0,1
19875,FremontBridge,01/09/2015 03:00:00 AM,48,-122,1,1,2
19876,FremontBridge,01/09/2015 04:00:00 AM,48,-122,2,7,9
19877,FremontBridge,01/09/2015 05:00:00 AM,48,-122,8,15,23
19878,FremontBridge,01/09/2015 06:00:00 AM,48,-122,29,58,87
19879,FremontBridge,01/09/2015 07:00:00 AM,48,-122,59,159,218
19880,FremontBridge,01/09/2015 08:00:00 AM,48,-122,83,262,345
19881,FremontBridge,01/09/2015 09:00:00 AM,48,-122,75,149,224
19882,FremontBridge,01/09/2015 10:00:00 AM,48,-122,27,66,93
19883,FremontBridge,01/09/2015 11:00:00 AM,48,-122,17,30,47
19884,FremontBridge,01/09/2015 12:00:00 PM,48,-122,28,31,59
19885,FremontBridge,01/09/2015 01:00:00 PM,48,-122,27,29,56
19886,FremontBridge,01/09/2015 02:00:00 PM,48,-122,33,50,83
19887,FremontBridge,01/09/2015 03:00:00 PM,48,-122,56,45,101
19888,FremontBridge,01/09/2015 04:00:00 PM,48,-122,126,97,223
19889,FremontBridge,01/09/2015 05:00:00 PM,48,-122,272,101,373
19890,FremontBridge,01/09/2015 06:00:00 PM,48,-122,173,91,264
19891,FremontBridge,01/09/2015 07:00:00 PM,48,-122,67,39,106
19892,FremontBridge,01/09/2015 08:00:00 PM,48,-122,28,18,46
19893,FremontBridge,01/09/2015 09:00:00 PM,48,-122,23,15,38
19894,FremontBridge,01/09/2015 10:00:00 PM,48,-122,13,22,35
19895,FremontBridge,01/09/2015 11:00:00 PM,48,-122,4,10,14
19896,FremontBridge,01/10/2015 12:00:00 AM,48,-122,1,3,4
19897,FremontBridge,01/10/2015 01:00:00 AM,48,-122,1,2,3
19898,FremontBridge,01/10/2015 02:00:00 AM,48,-122,5,0,5
19899,FremontBridge,01/10/2015 03:00:00 AM,48,-122,0,0,0
19900,FremontBridge,01/10/2015 04:00:00 AM,48,-122,0,0,0
19901,FremontBridge,01/10/2015 05:00:00 AM,48,-122,3,5,8
19902,FremontBridge,01/10/2015 06:00:00 AM,48,-122,11,5,16
19903,FremontBridge,01/10/2015 07:00:00 AM,48,-122,5,7,12
19904,FremontBridge,01/10/2015 08:00:00 AM,48,-122,27,24,51
19905,FremontBridge,01/10/2015 09:00:00 AM,48,-122,19,33,52
19906,FremontBridge,01/10/2015 10:00:00 AM,48,-122,14,37,51
19907,FremontBridge,01/10/2015 11:00:00 AM,48,-122,31,22,53
19908,FremontBridge,01/10/2015 12:00:00 PM,48,-122,43,39,82
19909,FremontBridge,01/10/2015 01:00:00 PM,48,-122,40,20,60
19910,FremontBridge,01/10/2015 02:00:00 PM,48,-122,29,47,76
19911,FremontBridge,01/10/2015 03:00:00 PM,48,-122,24,21,45
19912,FremontBridge,01/10/2015 04:00:00 PM,48,-122,32,31,63
19913,FremontBridge,01/10/2015 05:00:00 PM,48,-122,24,20,44
19914,FremontBridge,01/10/2015 06:00:00 PM,48,-122,12,18,30
19915,FremontBridge,01/10/2015 07:00:00 PM,48,-122,11,17,28
19916,FremontBridge,01/10/2015 08:00:00 PM,48,-122,18,10,28
19917,FremontBridge,01/10/2015 09:00:00 PM,48,-122,15,14,29
19918,FremontBridge,01/10/2015 10:00:00 PM,48,-122,11,7,18
19919,FremontBridge,01/10/2015 11:00:00 PM,48,-122,6,7,13
19920,FremontBridge,01/11/2015 12:00:00 AM,48,-122,1,0,1
19921,FremontBridge,01/11/2015 01:00:00 AM,48,-122,2,1,3
19922,FremontBridge,01/11/2015 02:00:00 AM,48,-122,1,3,4
19923,FremontBridge,01/11/2015 03:00:00 AM,48,-122,0,5,5
19924,FremontBridge,01/11/2015 04:00:00 AM,48,-122,0,2,2
19925,FremontBridge,01/11/2015 05:00:00 AM,48,-122,3,0,3
19926,FremontBridge,01/11/2015 06:00:00 AM,48,-122,5,2,7
19927,FremontBridge,01/11/2015 07:00:00 AM,48,-122,5,9,14
19928,FremontBridge,01/11/2015 08:00:00 AM,48,-122,11,20,31
19929,FremontBridge,01/11/2015 09:00:00 AM,48,-122,24,30,54
19930,FremontBridge,01/11/2015 10:00:00 AM,48,-122,22,29,51
19931,FremontBridge,01/11/2015 11:00:00 AM,48,-122,27,36,63
19932,FremontBridge,01/11/2015 12:00:00 PM,48,-122,36,46,82
19933,FremontBridge,01/11/2015 01:00:00 PM,48,-122,33,52,85
19934,FremontBridge,01/11/2015 02:00:00 PM,48,-122,38,54,92
19935,FremontBridge,01/11/2015 03:00:00 PM,48,-122,32,53,85
19936,FremontBridge,01/11/2015 04:00:00 PM,48,-122,41,31,72
19937,FremontBridge,01/11/2015 05:00:00 PM,48,-122,26,24,50
19938,FremontBridge,01/11/2015 06:00:00 PM,48,-122,21,16,37
19939,FremontBridge,01/11/2015 07:00:00 PM,48,-122,9,15,24
19940,FremontBridge,01/11/2015 08:00:00 PM,48,-122,11,7,18
19941,FremontBridge,01/11/2015 09:00:00 PM,48,-122,5,6,11
19942,FremontBridge,01/11/2015 10:00:00 PM,48,-122,6,4,10
19943,FremontBridge,01/11/2015 11:00:00 PM,48,-122,3,3,6
19944,FremontBridge,01/12/2015 12:00:00 AM,48,-122,2,4,6
19945,FremontBridge,01/12/2015 01:00:00 AM,48,-122,0,1,1
19946,FremontBridge,01/12/2015 02:00:00 AM,48,-122,0,1,1
19947,FremontBridge,01/12/2015 03:00:00 AM,48,-122,2,5,7
19948,FremontBridge,01/12/2015 04:00:00 AM,48,-122,0,2,2
19949,FremontBridge,01/12/2015 05:00:00 AM,48,-122,7,25,32
19950,FremontBridge,01/12/2015 06:00:00 AM,48,-122,37,68,105
19951,FremontBridge,01/12/2015 07:00:00 AM,48,-122,13,221,234
19952,FremontBridge,01/12/2015 08:00:00 AM,48,-122,0,367,367
19953,FremontBridge,01/12/2015 09:00:00 AM,48,-122,1,192,193
19954,FremontBridge,01/12/2015 10:00:00 AM,48,-122,0,76,76
19955,FremontBridge,01/12/2015 11:00:00 AM,48,-122,0,51,51
19956,FremontBridge,01/12/2015 12:00:00 PM,48,-122,0,52,52
19957,FremontBridge,01/12/2015 01:00:00 PM,48,-122,1,69,70
19958,FremontBridge,01/12/2015 02:00:00 PM,48,-122,0,82,82
19959,FremontBridge,01/12/2015 03:00:00 PM,48,-122,64,50,114
19960,FremontBridge,01/12/2015 04:00:00 PM,48,-122,131,93,224
19961,FremontBridge,01/12/2015 05:00:00 PM,48,-122,306,117,423
19962,FremontBridge,01/12/2015 06:00:00 PM,48,-122,218,118,336
19963,FremontBridge,01/12/2015 07:00:00 PM,48,-122,91,43,134
19964,FremontBridge,01/12/2015 08:00:00 PM,48,-122,35,23,58
19965,FremontBridge,01/12/2015 09:00:00 PM,48,-122,41,15,56
19966,FremontBridge,01/12/2015 10:00:00 PM,48,-122,12,13,25
19967,FremontBridge,01/12/2015 11:00:00 PM,48,-122,11,10,21
19968,FremontBridge,01/13/2015 12:00:00 AM,48,-122,2,3,5
19969,FremontBridge,01/13/2015 01:00:00 AM,48,-122,2,5,7
19970,FremontBridge,01/13/2015 02:00:00 AM,48,-122,2,1,3
19971,FremontBridge,01/13/2015 03:00:00 AM,48,-122,3,3,6
19972,FremontBridge,01/13/2015 04:00:00 AM,48,-122,1,1,2
19973,FremontBridge,01/13/2015 05:00:00 AM,48,-122,10,25,35
19974,FremontBridge,01/13/2015 06:00:00 AM,48,-122,39,80,119
19975,FremontBridge,01/13/2015 07:00:00 AM,48,-122,7,223,230
19976,FremontBridge,01/13/2015 08:00:00 AM,48,-122,0,374,374
19977,FremontBridge,01/13/2015 09:00:00 AM,48,-122,0,197,197
19978,FremontBridge,01/13/2015 10:00:00 AM,48,-122,0,89,89
19979,FremontBridge,01/13/2015 11:00:00 AM,48,-122,0,64,64
19980,FremontBridge,01/13/2015 12:00:00 PM,48,-122,0,71,71
19981,FremontBridge,01/13/2015 01:00:00 PM,48,-122,0,55,55
19982,FremontBridge,01/13/2015 02:00:00 PM,48,-122,2,78,80
19983,FremontBridge,01/13/2015 03:00:00 PM,48,-122,55,66,121
19984,FremontBridge,01/13/2015 04:00:00 PM,48,-122,127,92,219
19985,FremontBridge,01/13/2015 05:00:00 PM,48,-122,289,138,427
19986,FremontBridge,01/13/2015 06:00:00 PM,48,-122,258,98,356
19987,FremontBridge,01/13/2015 07:00:00 PM,48,-122,109,55,164
19988,FremontBridge,01/13/2015 08:00:00 PM,48,-122,52,13,65
19989,FremontBridge,01/13/2015 09:00:00 PM,48,-122,31,19,50
19990,FremontBridge,01/13/2015 10:00:00 PM,48,-122,14,2,16
19991,FremontBridge,01/13/2015 11:00:00 PM,48,-122,6,5,11
19992,FremontBridge,01/14/2015 12:00:00 AM,48,-122,4,3,7
19993,FremontBridge,01/14/2015 01:00:00 AM,48,-122,2,3,5
19994,FremontBridge,01/14/2015 02:00:00 AM,48,-122,1,1,2
19995,FremontBridge,01/14/2015 03:00:00 AM,48,-122,3,2,5
19996,FremontBridge,01/14/2015 04:00:00 AM,48,-122,3,5,8
19997,FremontBridge,01/14/2015 05:00:00 AM,48,-122,6,26,32
19998,FremontBridge,01/14/2015 06:00:00 AM,48,-122,37,64,101
19999,FremontBridge,01/14/2015 07:00:00 AM,48,-122,13,209,222
20000,FremontBridge,01/14/2015 08:00:00 AM,48,-122,1,325,326
20001,FremontBridge,01/14/2015 09:00:00 AM,48,-122,1,166,167
20002,FremontBridge,01/14/2015 10:00:00 AM,48,-122,0,79,79
20003,FremontBridge,01/14/2015 11:00:00 AM,48,-122,0,50,50
20004,FremontBridge,01/14/2015 12:00:00 PM,48,-122,0,53,53
20005,FremontBridge,01/14/2015 01:00:00 PM,48,-122,0,67,67
20006,FremontBridge,01/14/2015 02:00:00 PM,48,-122,12,69,81
20007,FremontBridge,01/14/2015 03:00:00 PM,48,-122,52,75,127
20008,FremontBridge,01/14/2015 04:00:00 PM,48,-122,122,89,211
20009,FremontBridge,01/14/2015 05:00:00 PM,48,-122,315,132,447
20010,FremontBridge,01/14/2015 06:00:00 PM,48,-122,225,82,307
20011,FremontBridge,01/14/2015 07:00:00 PM,48,-122,102,47,149
20012,FremontBridge,01/14/2015 08:00:00 PM,48,-122,50,28,78
20013,FremontBridge,01/14/2015 09:00:00 PM,48,-122,35,24,59
20014,FremontBridge,01/14/2015 10:00:00 PM,48,-122,9,12,21
20015,FremontBridge,01/14/2015 11:00:00 PM,48,-122,13,6,19
20016,FremontBridge,01/15/2015 12:00:00 AM,48,-122,5,2,7
20017,FremontBridge,01/15/2015 01:00:00 AM,48,-122,0,2,2
20018,FremontBridge,01/15/2015 02:00:00 AM,48,-122,2,0,2
20019,FremontBridge,01/15/2015 03:00:00 AM,48,-122,1,2,3
20020,FremontBridge,01/15/2015 04:00:00 AM,48,-122,2,3,5
20021,FremontBridge,01/15/2015 05:00:00 AM,48,-122,4,17,21
20022,FremontBridge,01/15/2015 06:00:00 AM,48,-122,33,53,86
20023,FremontBridge,01/15/2015 07:00:00 AM,48,-122,11,152,163
20024,FremontBridge,01/15/2015 08:00:00 AM,48,-122,1,283,284
20025,FremontBridge,01/15/2015 09:00:00 AM,48,-122,0,132,132
20026,FremontBridge,01/15/2015 10:00:00 AM,48,-122,0,64,64
20027,FremontBridge,01/15/2015 11:00:00 AM,48,-122,0,46,46
20028,FremontBridge,01/15/2015 12:00:00 PM,48,-122,0,41,41
20029,FremontBridge,01/15/2015 01:00:00 PM,48,-122,0,39,39
20030,FremontBridge,01/15/2015 02:00:00 PM,48,-122,2,32,34
20031,FremontBridge,01/15/2015 03:00:00 PM,48,-122,33,33,66
20032,FremontBridge,01/15/2015 04:00:00 PM,48,-122,85,59,144
20033,FremontBridge,01/15/2015 05:00:00 PM,48,-122,226,87,313
20034,FremontBridge,01/15/2015 06:00:00 PM,48,-122,138,100,238
20035,FremontBridge,01/15/2015 07:00:00 PM,48,-122,73,25,98
20036,FremontBridge,01/15/2015 08:00:00 PM,48,-122,36,14,50
20037,FremontBridge,01/15/2015 09:00:00 PM,48,-122,17,21,38
20038,FremontBridge,01/15/2015 10:00:00 PM,48,-122,13,2,15
20039,FremontBridge,01/15/2015 11:00:00 PM,48,-122,3,4,7
20040,FremontBridge,01/16/2015 12:00:00 AM,48,-122,4,1,5
20041,FremontBridge,01/16/2015 01:00:00 AM,48,-122,1,3,4
20042,FremontBridge,01/16/2015 02:00:00 AM,48,-122,0,3,3
20043,FremontBridge,01/16/2015 03:00:00 AM,48,-122,1,1,2
20044,FremontBridge,01/16/2015 04:00:00 AM,48,-122,2,2,4
20045,FremontBridge,01/16/2015 05:00:00 AM,48,-122,3,16,19
20046,FremontBridge,01/16/2015 06:00:00 AM,48,-122,22,52,74
20047,FremontBridge,01/16/2015 07:00:00 AM,48,-122,12,129,141
20048,FremontBridge,01/16/2015 08:00:00 AM,48,-122,2,228,230
20049,FremontBridge,01/16/2015 09:00:00 AM,48,-122,0,161,161
20050,FremontBridge,01/16/2015 10:00:00 AM,48,-122,0,61,61
20051,FremontBridge,01/16/2015 11:00:00 AM,48,-122,0,57,57
20052,FremontBridge,01/16/2015 12:00:00 PM,48,-122,4,52,56
20053,FremontBridge,01/16/2015 01:00:00 PM,48,-122,25,51,76
20054,FremontBridge,01/16/2015 02:00:00 PM,48,-122,38,50,88
20055,FremontBridge,01/16/2015 03:00:00 PM,48,-122,73,63,136
20056,FremontBridge,01/16/2015 04:00:00 PM,48,-122,117,102,219
20057,FremontBridge,01/16/2015 05:00:00 PM,48,-122,245,90,335
20058,FremontBridge,01/16/2015 06:00:00 PM,48,-122,156,83,239
20059,FremontBridge,01/16/2015 07:00:00 PM,48,-122,58,43,101
20060,FremontBridge,01/16/2015 08:00:00 PM,48,-122,37,19,56
20061,FremontBridge,01/16/2015 09:00:00 PM,48,-122,15,17,32
20062,FremontBridge,01/16/2015 10:00:00 PM,48,-122,13,12,25
20063,FremontBridge,01/16/2015 11:00:00 PM,48,-122,8,10,18
20064,FremontBridge,01/17/2015 12:00:00 AM,48,-122,13,4,17
20065,FremontBridge,01/17/2015 01:00:00 AM,48,-122,2,7,9
20066,FremontBridge,01/17/2015 02:00:00 AM,48,-122,3,3,6
20067,FremontBridge,01/17/2015 03:00:00 AM,48,-122,1,2,3
20068,FremontBridge,01/17/2015 04:00:00 AM,48,-122,2,1,3
20069,FremontBridge,01/17/2015 05:00:00 AM,48,-122,2,1,3
20070,FremontBridge,01/17/2015 06:00:00 AM,48,-122,6,8,14
20071,FremontBridge,01/17/2015 07:00:00 AM,48,-122,5,7,12
20072,FremontBridge,01/17/2015 08:00:00 AM,48,-122,17,17,34
20073,FremontBridge,01/17/2015 09:00:00 AM,48,-122,18,31,49
20074,FremontBridge,01/17/2015 10:00:00 AM,48,-122,16,29,45
20075,FremontBridge,01/17/2015 11:00:00 AM,48,-122,22,33,55
20076,FremontBridge,01/17/2015 12:00:00 PM,48,-122,27,25,52
20077,FremontBridge,01/17/2015 01:00:00 PM,48,-122,21,36,57
20078,FremontBridge,01/17/2015 02:00:00 PM,48,-122,18,27,45
20079,FremontBridge,01/17/2015 03:00:00 PM,48,-122,17,27,44
20080,FremontBridge,01/17/2015 04:00:00 PM,48,-122,18,25,43
20081,FremontBridge,01/17/2015 05:00:00 PM,48,-122,22,13,35
20082,FremontBridge,01/17/2015 06:00:00 PM,48,-122,13,7,20
20083,FremontBridge,01/17/2015 07:00:00 PM,48,-122,7,5,12
20084,FremontBridge,01/17/2015 08:00:00 PM,48,-122,6,2,8
20085,FremontBridge,01/17/2015 09:00:00 PM,48,-122,9,5,14
20086,FremontBridge,01/17/2015 10:00:00 PM,48,-122,4,1,5
20087,FremontBridge,01/17/2015 11:00:00 PM,48,-122,5,2,7
20088,FremontBridge,01/18/2015 12:00:00 AM,48,-122,5,4,9
20089,FremontBridge,01/18/2015 01:00:00 AM,48,-122,3,0,3
20090,FremontBridge,01/18/2015 02:00:00 AM,48,-122,3,4,7
20091,FremontBridge,01/18/2015 03:00:00 AM,48,-122,0,1,1
20092,FremontBridge,01/18/2015 04:00:00 AM,48,-122,0,2,2
20093,FremontBridge,01/18/2015 05:00:00 AM,48,-122,2,3,5
20094,FremontBridge,01/18/2015 06:00:00 AM,48,-122,3,2,5
20095,FremontBridge,01/18/2015 07:00:00 AM,48,-122,4,7,11
20096,FremontBridge,01/18/2015 08:00:00 AM,48,-122,10,14,24
20097,FremontBridge,01/18/2015 09:00:00 AM,48,-122,7,24,31
20098,FremontBridge,01/18/2015 10:00:00 AM,48,-122,9,17,26
20099,FremontBridge,01/18/2015 11:00:00 AM,48,-122,15,25,40
20100,FremontBridge,01/18/2015 12:00:00 PM,48,-122,20,19,39
20101,FremontBridge,01/18/2015 01:00:00 PM,48,-122,15,13,28
20102,FremontBridge,01/18/2015 02:00:00 PM,48,-122,11,19,30
20103,FremontBridge,01/18/2015 03:00:00 PM,48,-122,13,10,23
20104,FremontBridge,01/18/2015 04:00:00 PM,48,-122,17,30,47
20105,FremontBridge,01/18/2015 05:00:00 PM,48,-122,27,26,53
20106,FremontBridge,01/18/2015 06:00:00 PM,48,-122,9,13,22
20107,FremontBridge,01/18/2015 07:00:00 PM,48,-122,18,6,24
20108,FremontBridge,01/18/2015 08:00:00 PM,48,-122,10,3,13
20109,FremontBridge,01/18/2015 09:00:00 PM,48,-122,11,3,14
20110,FremontBridge,01/18/2015 10:00:00 PM,48,-122,5,1,6
20111,FremontBridge,01/18/2015 11:00:00 PM,48,-122,5,3,8
20112,FremontBridge,01/19/2015 12:00:00 AM,48,-122,3,3,6
20113,FremontBridge,01/19/2015 01:00:00 AM,48,-122,1,1,2
20114,FremontBridge,01/19/2015 02:00:00 AM,48,-122,1,1,2
20115,FremontBridge,01/19/2015 03:00:00 AM,48,-122,1,3,4
20116,FremontBridge,01/19/2015 04:00:00 AM,48,-122,1,2,3
20117,FremontBridge,01/19/2015 05:00:00 AM,48,-122,6,16,22
20118,FremontBridge,01/19/2015 06:00:00 AM,48,-122,20,38,58
20119,FremontBridge,01/19/2015 07:00:00 AM,48,-122,26,92,118
20120,FremontBridge,01/19/2015 08:00:00 AM,48,-122,59,161,220
20121,FremontBridge,01/19/2015 09:00:00 AM,48,-122,52,118,170
20122,FremontBridge,01/19/2015 10:00:00 AM,48,-122,27,54,81
20123,FremontBridge,01/19/2015 11:00:00 AM,48,-122,27,66,93
20124,FremontBridge,01/19/2015 12:00:00 PM,48,-122,35,40,75
20125,FremontBridge,01/19/2015 01:00:00 PM,48,-122,34,55,89
20126,FremontBridge,01/19/2015 02:00:00 PM,48,-122,49,62,111
20127,FremontBridge,01/19/2015 03:00:00 PM,48,-122,74,68,142
20128,FremontBridge,01/19/2015 04:00:00 PM,48,-122,95,73,168
20129,FremontBridge,01/19/2015 05:00:00 PM,48,-122,173,73,246
20130,FremontBridge,01/19/2015 06:00:00 PM,48,-122,137,50,187
20131,FremontBridge,01/19/2015 07:00:00 PM,48,-122,54,29,83
20132,FremontBridge,01/19/2015 08:00:00 PM,48,-122,33,18,51
20133,FremontBridge,01/19/2015 09:00:00 PM,48,-122,11,15,26
20134,FremontBridge,01/19/2015 10:00:00 PM,48,-122,7,4,11
20135,FremontBridge,01/19/2015 11:00:00 PM,48,-122,7,7,14
20136,FremontBridge,01/20/2015 12:00:00 AM,48,-122,8,3,11
20137,FremontBridge,01/20/2015 01:00:00 AM,48,-122,2,0,2
20138,FremontBridge,01/20/2015 02:00:00 AM,48,-122,3,0,3
20139,FremontBridge,01/20/2015 03:00:00 AM,48,-122,1,1,2
20140,FremontBridge,01/20/2015 04:00:00 AM,48,-122,2,4,6
20141,FremontBridge,01/20/2015 05:00:00 AM,48,-122,12,25,37
20142,FremontBridge,01/20/2015 06:00:00 AM,48,-122,38,61,99
20143,FremontBridge,01/20/2015 07:00:00 AM,48,-122,11,243,254
20144,FremontBridge,01/20/2015 08:00:00 AM,48,-122,70,317,387
20145,FremontBridge,01/20/2015 09:00:00 AM,48,-122,79,170,249
20146,FremontBridge,01/20/2015 10:00:00 AM,48,-122,28,71,99
20147,FremontBridge,01/20/2015 11:00:00 AM,48,-122,27,39,66
20148,FremontBridge,01/20/2015 12:00:00 PM,48,-122,32,44,76
20149,FremontBridge,01/20/2015 01:00:00 PM,48,-122,34,55,89
20150,FremontBridge,01/20/2015 02:00:00 PM,48,-122,51,52,103
20151,FremontBridge,01/20/2015 03:00:00 PM,48,-122,77,60,137
20152,FremontBridge,01/20/2015 04:00:00 PM,48,-122,128,95,223
20153,FremontBridge,01/20/2015 05:00:00 PM,48,-122,311,133,444
20154,FremontBridge,01/20/2015 06:00:00 PM,48,-122,255,112,367
20155,FremontBridge,01/20/2015 07:00:00 PM,48,-122,93,53,146
20156,FremontBridge,01/20/2015 08:00:00 PM,48,-122,34,16,50
20157,FremontBridge,01/20/2015 09:00:00 PM,48,-122,19,20,39
20158,FremontBridge,01/20/2015 10:00:00 PM,48,-122,11,10,21
20159,FremontBridge,01/20/2015 11:00:00 PM,48,-122,13,4,17
20160,FremontBridge,01/21/2015 12:00:00 AM,48,-122,6,8,14
20161,FremontBridge,01/21/2015 01:00:00 AM,48,-122,1,0,1
20162,FremontBridge,01/21/2015 02:00:00 AM,48,-122,1,2,3
20163,FremontBridge,01/21/2015 03:00:00 AM,48,-122,0,2,2
20164,FremontBridge,01/21/2015 04:00:00 AM,48,-122,1,4,5
20165,FremontBridge,01/21/2015 05:00:00 AM,48,-122,8,21,29
20166,FremontBridge,01/21/2015 06:00:00 AM,48,-122,34,72,106
20167,FremontBridge,01/21/2015 07:00:00 AM,48,-122,13,192,205
20168,FremontBridge,01/21/2015 08:00:00 AM,48,-122,1,335,336
20169,FremontBridge,01/21/2015 09:00:00 AM,48,-122,0,191,191
20170,FremontBridge,01/21/2015 10:00:00 AM,48,-122,0,72,72
20171,FremontBridge,01/21/2015 11:00:00 AM,48,-122,0,43,43
20172,FremontBridge,01/21/2015 12:00:00 PM,48,-122,1,55,56
20173,FremontBridge,01/21/2015 01:00:00 PM,48,-122,0,61,61
20174,FremontBridge,01/21/2015 02:00:00 PM,48,-122,6,76,82
20175,FremontBridge,01/21/2015 03:00:00 PM,48,-122,41,51,92
20176,FremontBridge,01/21/2015 04:00:00 PM,48,-122,134,90,224
20177,FremontBridge,01/21/2015 05:00:00 PM,48,-122,278,99,377
20178,FremontBridge,01/21/2015 06:00:00 PM,48,-122,242,118,360
20179,FremontBridge,01/21/2015 07:00:00 PM,48,-122,94,46,140
20180,FremontBridge,01/21/2015 08:00:00 PM,48,-122,35,24,59
20181,FremontBridge,01/21/2015 09:00:00 PM,48,-122,31,22,53
20182,FremontBridge,01/21/2015 10:00:00 PM,48,-122,15,15,30
20183,FremontBridge,01/21/2015 11:00:00 PM,48,-122,8,3,11
20184,FremontBridge,01/22/2015 12:00:00 AM,48,-122,9,3,12
20185,FremontBridge,01/22/2015 01:00:00 AM,48,-122,1,0,1
20186,FremontBridge,01/22/2015 02:00:00 AM,48,-122,3,0,3
20187,FremontBridge,01/22/2015 03:00:00 AM,48,-122,2,1,3
20188,FremontBridge,01/22/2015 04:00:00 AM,48,-122,1,4,5
20189,FremontBridge,01/22/2015 05:00:00 AM,48,-122,5,18,23
20190,FremontBridge,01/22/2015 06:00:00 AM,48,-122,34,60,94
20191,FremontBridge,01/22/2015 07:00:00 AM,48,-122,5,184,189
20192,FremontBridge,01/22/2015 08:00:00 AM,48,-122,0,301,301
20193,FremontBridge,01/22/2015 09:00:00 AM,48,-122,0,149,149
20194,FremontBridge,01/22/2015 10:00:00 AM,48,-122,1,59,60
20195,FremontBridge,01/22/2015 11:00:00 AM,48,-122,0,37,37
20196,FremontBridge,01/22/2015 12:00:00 PM,48,-122,0,45,45
20197,FremontBridge,01/22/2015 01:00:00 PM,48,-122,0,38,38
20198,FremontBridge,01/22/2015 02:00:00 PM,48,-122,25,46,71
20199,FremontBridge,01/22/2015 03:00:00 PM,48,-122,35,41,76
20200,FremontBridge,01/22/2015 04:00:00 PM,48,-122,107,58,165
20201,FremontBridge,01/22/2015 05:00:00 PM,48,-122,226,112,338
20202,FremontBridge,01/22/2015 06:00:00 PM,48,-122,191,99,290
20203,FremontBridge,01/22/2015 07:00:00 PM,48,-122,84,41,125
20204,FremontBridge,01/22/2015 08:00:00 PM,48,-122,35,21,56
20205,FremontBridge,01/22/2015 09:00:00 PM,48,-122,20,19,39
20206,FremontBridge,01/22/2015 10:00:00 PM,48,-122,20,24,44
20207,FremontBridge,01/22/2015 11:00:00 PM,48,-122,11,8,19
20208,FremontBridge,01/23/2015 12:00:00 AM,48,-122,7,7,14
20209,FremontBridge,01/23/2015 01:00:00 AM,48,-122,6,1,7
20210,FremontBridge,01/23/2015 02:00:00 AM,48,-122,1,0,1
20211,FremontBridge,01/23/2015 03:00:00 AM,48,-122,1,2,3
20212,FremontBridge,01/23/2015 04:00:00 AM,48,-122,2,4,6
20213,FremontBridge,01/23/2015 05:00:00 AM,48,-122,15,18,33
20214,FremontBridge,01/23/2015 06:00:00 AM,48,-122,20,55,75
20215,FremontBridge,01/23/2015 07:00:00 AM,48,-122,5,137,142
20216,FremontBridge,01/23/2015 08:00:00 AM,48,-122,4,222,226
20217,FremontBridge,01/23/2015 09:00:00 AM,48,-122,0,151,151
20218,FremontBridge,01/23/2015 10:00:00 AM,48,-122,3,59,62
20219,FremontBridge,01/23/2015 11:00:00 AM,48,-122,0,29,29
20220,FremontBridge,01/23/2015 12:00:00 PM,48,-122,0,36,36
20221,FremontBridge,01/23/2015 01:00:00 PM,48,-122,0,35,35
20222,FremontBridge,01/23/2015 02:00:00 PM,48,-122,18,39,57
20223,FremontBridge,01/23/2015 03:00:00 PM,48,-122,38,34,72
20224,FremontBridge,01/23/2015 04:00:00 PM,48,-122,81,56,137
20225,FremontBridge,01/23/2015 05:00:00 PM,48,-122,203,107,310
20226,FremontBridge,01/23/2015 06:00:00 PM,48,-122,139,60,199
20227,FremontBridge,01/23/2015 07:00:00 PM,48,-122,54,31,85
20228,FremontBridge,01/23/2015 08:00:00 PM,48,-122,26,10,36
20229,FremontBridge,01/23/2015 09:00:00 PM,48,-122,13,7,20
20230,FremontBridge,01/23/2015 10:00:00 PM,48,-122,17,7,24
20231,FremontBridge,01/23/2015 11:00:00 PM,48,-122,10,7,17
20232,FremontBridge,01/24/2015 12:00:00 AM,48,-122,8,6,14
20233,FremontBridge,01/24/2015 01:00:00 AM,48,-122,2,3,5
20234,FremontBridge,01/24/2015 02:00:00 AM,48,-122,1,3,4
20235,FremontBridge,01/24/2015 03:00:00 AM,48,-122,1,2,3
20236,FremontBridge,01/24/2015 04:00:00 AM,48,-122,1,1,2
20237,FremontBridge,01/24/2015 05:00:00 AM,48,-122,4,2,6
20238,FremontBridge,01/24/2015 06:00:00 AM,48,-122,9,7,16
20239,FremontBridge,01/24/2015 07:00:00 AM,48,-122,6,10,16
20240,FremontBridge,01/24/2015 08:00:00 AM,48,-122,25,26,51
20241,FremontBridge,01/24/2015 09:00:00 AM,48,-122,14,30,44
20242,FremontBridge,01/24/2015 10:00:00 AM,48,-122,24,50,74
20243,FremontBridge,01/24/2015 11:00:00 AM,48,-122,37,51,88
20244,FremontBridge,01/24/2015 12:00:00 PM,48,-122,50,58,108
20245,FremontBridge,01/24/2015 01:00:00 PM,48,-122,42,64,106
20246,FremontBridge,01/24/2015 02:00:00 PM,48,-122,45,67,112
20247,FremontBridge,01/24/2015 03:00:00 PM,48,-122,40,72,112
20248,FremontBridge,01/24/2015 04:00:00 PM,48,-122,62,53,115
20249,FremontBridge,01/24/2015 05:00:00 PM,48,-122,31,48,79
20250,FremontBridge,01/24/2015 06:00:00 PM,48,-122,28,29,57
20251,FremontBridge,01/24/2015 07:00:00 PM,48,-122,21,26,47
20252,FremontBridge,01/24/2015 08:00:00 PM,48,-122,11,15,26
20253,FremontBridge,01/24/2015 09:00:00 PM,48,-122,18,9,27
20254,FremontBridge,01/24/2015 10:00:00 PM,48,-122,17,13,30
20255,FremontBridge,01/24/2015 11:00:00 PM,48,-122,14,7,21
20256,FremontBridge,01/25/2015 12:00:00 AM,48,-122,14,8,22
20257,FremontBridge,01/25/2015 01:00:00 AM,48,-122,2,9,11
20258,FremontBridge,01/25/2015 02:00:00 AM,48,-122,0,2,2
20259,FremontBridge,01/25/2015 03:00:00 AM,48,-122,0,0,0
20260,FremontBridge,01/25/2015 04:00:00 AM,48,-122,2,3,5
20261,FremontBridge,01/25/2015 05:00:00 AM,48,-122,3,2,5
20262,FremontBridge,01/25/2015 06:00:00 AM,48,-122,2,4,6
20263,FremontBridge,01/25/2015 07:00:00 AM,48,-122,10,5,15
20264,FremontBridge,01/25/2015 08:00:00 AM,48,-122,17,53,70
20265,FremontBridge,01/25/2015 09:00:00 AM,48,-122,37,30,67
20266,FremontBridge,01/25/2015 10:00:00 AM,48,-122,44,83,127
20267,FremontBridge,01/25/2015 11:00:00 AM,48,-122,60,117,177
20268,FremontBridge,01/25/2015 12:00:00 PM,48,-122,83,136,219
20269,FremontBridge,01/25/2015 01:00:00 PM,48,-122,112,160,272
20270,FremontBridge,01/25/2015 02:00:00 PM,48,-122,119,214,333
20271,FremontBridge,01/25/2015 03:00:00 PM,48,-122,133,135,268
20272,FremontBridge,01/25/2015 04:00:00 PM,48,-122,96,121,217
20273,FremontBridge,01/25/2015 05:00:00 PM,48,-122,75,97,172
20274,FremontBridge,01/25/2015 06:00:00 PM,48,-122,32,28,60
20275,FremontBridge,01/25/2015 07:00:00 PM,48,-122,15,19,34
20276,FremontBridge,01/25/2015 08:00:00 PM,48,-122,10,13,23
20277,FremontBridge,01/25/2015 09:00:00 PM,48,-122,7,10,17
20278,FremontBridge,01/25/2015 10:00:00 PM,48,-122,9,8,17
20279,FremontBridge,01/25/2015 11:00:00 PM,48,-122,11,5,16
20280,FremontBridge,01/26/2015 12:00:00 AM,48,-122,5,5,10
20281,FremontBridge,01/26/2015 01:00:00 AM,48,-122,0,0,0
20282,FremontBridge,01/26/2015 02:00:00 AM,48,-122,2,1,3
20283,FremontBridge,01/26/2015 03:00:00 AM,48,-122,1,3,4
20284,FremontBridge,01/26/2015 04:00:00 AM,48,-122,2,6,8
20285,FremontBridge,01/26/2015 05:00:00 AM,48,-122,11,24,35
20286,FremontBridge,01/26/2015 06:00:00 AM,48,-122,35,79,114
20287,FremontBridge,01/26/2015 07:00:00 AM,48,-122,8,231,239
20288,FremontBridge,01/26/2015 08:00:00 AM,48,-122,0,394,394
20289,FremontBridge,01/26/2015 09:00:00 AM,48,-122,0,230,230
20290,FremontBridge,01/26/2015 10:00:00 AM,48,-122,0,95,95
20291,FremontBridge,01/26/2015 11:00:00 AM,48,-122,0,69,69
20292,FremontBridge,01/26/2015 12:00:00 PM,48,-122,0,59,59
20293,FremontBridge,01/26/2015 01:00:00 PM,48,-122,0,92,92
20294,FremontBridge,01/26/2015 02:00:00 PM,48,-122,0,93,93
20295,FremontBridge,01/26/2015 03:00:00 PM,48,-122,78,98,176
20296,FremontBridge,01/26/2015 04:00:00 PM,48,-122,152,141,293
20297,FremontBridge,01/26/2015 05:00:00 PM,48,-122,362,153,515
20298,FremontBridge,01/26/2015 06:00:00 PM,48,-122,247,131,378
20299,FremontBridge,01/26/2015 07:00:00 PM,48,-122,103,60,163
20300,FremontBridge,01/26/2015 08:00:00 PM,48,-122,49,31,80
20301,FremontBridge,01/26/2015 09:00:00 PM,48,-122,34,23,57
20302,FremontBridge,01/26/2015 10:00:00 PM,48,-122,18,17,35
20303,FremontBridge,01/26/2015 11:00:00 PM,48,-122,14,3,17
20304,FremontBridge,01/27/2015 12:00:00 AM,48,-122,6,1,7
20305,FremontBridge,01/27/2015 01:00:00 AM,48,-122,1,3,4
20306,FremontBridge,01/27/2015 02:00:00 AM,48,-122,0,5,5
20307,FremontBridge,01/27/2015 03:00:00 AM,48,-122,0,1,1
20308,FremontBridge,01/27/2015 04:00:00 AM,48,-122,2,4,6
20309,FremontBridge,01/27/2015 05:00:00 AM,48,-122,10,25,35
20310,FremontBridge,01/27/2015 06:00:00 AM,48,-122,44,68,112
20311,FremontBridge,01/27/2015 07:00:00 AM,48,-122,10,229,239
20312,FremontBridge,01/27/2015 08:00:00 AM,48,-122,0,361,361
20313,FremontBridge,01/27/2015 09:00:00 AM,48,-122,0,202,202
20314,FremontBridge,01/27/2015 10:00:00 AM,48,-122,0,62,62
20315,FremontBridge,01/27/2015 11:00:00 AM,48,-122,0,40,40
20316,FremontBridge,01/27/2015 12:00:00 PM,48,-122,0,54,54
20317,FremontBridge,01/27/2015 01:00:00 PM,48,-122,10,29,39
20318,FremontBridge,01/27/2015 02:00:00 PM,48,-122,38,36,74
20319,FremontBridge,01/27/2015 03:00:00 PM,48,-122,54,52,106
20320,FremontBridge,01/27/2015 04:00:00 PM,48,-122,132,76,208
20321,FremontBridge,01/27/2015 05:00:00 PM,48,-122,277,126,403
20322,FremontBridge,01/27/2015 06:00:00 PM,48,-122,232,90,322
20323,FremontBridge,01/27/2015 07:00:00 PM,48,-122,89,45,134
20324,FremontBridge,01/27/2015 08:00:00 PM,48,-122,47,21,68
20325,FremontBridge,01/27/2015 09:00:00 PM,48,-122,21,17,38
20326,FremontBridge,01/27/2015 10:00:00 PM,48,-122,16,6,22
20327,FremontBridge,01/27/2015 11:00:00 PM,48,-122,13,8,21
20328,FremontBridge,01/28/2015 12:00:00 AM,48,-122,6,4,10
20329,FremontBridge,01/28/2015 01:00:00 AM,48,-122,4,1,5
20330,FremontBridge,01/28/2015 02:00:00 AM,48,-122,1,2,3
20331,FremontBridge,01/28/2015 03:00:00 AM,48,-122,0,1,1
20332,FremontBridge,01/28/2015 04:00:00 AM,48,-122,2,1,3
20333,FremontBridge,01/28/2015 05:00:00 AM,48,-122,5,23,28
20334,FremontBridge,01/28/2015 06:00:00 AM,48,-122,31,63,94
20335,FremontBridge,01/28/2015 07:00:00 AM,48,-122,51,217,268
20336,FremontBridge,01/28/2015 08:00:00 AM,48,-122,97,320,417
20337,FremontBridge,01/28/2015 09:00:00 AM,48,-122,74,172,246
20338,FremontBridge,01/28/2015 10:00:00 AM,48,-122,29,66,95
20339,FremontBridge,01/28/2015 11:00:00 AM,48,-122,24,38,62
20340,FremontBridge,01/28/2015 12:00:00 PM,48,-122,26,39,65
20341,FremontBridge,01/28/2015 01:00:00 PM,48,-122,36,44,80
20342,FremontBridge,01/28/2015 02:00:00 PM,48,-122,54,50,104
20343,FremontBridge,01/28/2015 03:00:00 PM,48,-122,54,53,107
20344,FremontBridge,01/28/2015 04:00:00 PM,48,-122,124,95,219
20345,FremontBridge,01/28/2015 05:00:00 PM,48,-122,348,156,504
20346,FremontBridge,01/28/2015 06:00:00 PM,48,-122,232,103,335
20347,FremontBridge,01/28/2015 07:00:00 PM,48,-122,90,54,144
20348,FremontBridge,01/28/2015 08:00:00 PM,48,-122,43,29,72
20349,FremontBridge,01/28/2015 09:00:00 PM,48,-122,32,19,51
20350,FremontBridge,01/28/2015 10:00:00 PM,48,-122,14,18,32
20351,FremontBridge,01/28/2015 11:00:00 PM,48,-122,14,4,18
20352,FremontBridge,01/29/2015 12:00:00 AM,48,-122,5,1,6
20353,FremontBridge,01/29/2015 01:00:00 AM,48,-122,2,3,5
20354,FremontBridge,01/29/2015 02:00:00 AM,48,-122,1,2,3
20355,FremontBridge,01/29/2015 03:00:00 AM,48,-122,0,1,1
20356,FremontBridge,01/29/2015 04:00:00 AM,48,-122,2,3,5
20357,FremontBridge,01/29/2015 05:00:00 AM,48,-122,11,25,36
20358,FremontBridge,01/29/2015 06:00:00 AM,48,-122,28,62,90
20359,FremontBridge,01/29/2015 07:00:00 AM,48,-122,62,201,263
20360,FremontBridge,01/29/2015 08:00:00 AM,48,-122,119,323,442
20361,FremontBridge,01/29/2015 09:00:00 AM,48,-122,78,173,251
20362,FremontBridge,01/29/2015 10:00:00 AM,48,-122,28,72,100
20363,FremontBridge,01/29/2015 11:00:00 AM,48,-122,25,51,76
20364,FremontBridge,01/29/2015 12:00:00 PM,48,-122,27,35,62
20365,FremontBridge,01/29/2015 01:00:00 PM,48,-122,47,51,98
20366,FremontBridge,01/29/2015 02:00:00 PM,48,-122,54,48,102
20367,FremontBridge,01/29/2015 03:00:00 PM,48,-122,61,66,127
20368,FremontBridge,01/29/2015 04:00:00 PM,48,-122,156,95,251
20369,FremontBridge,01/29/2015 05:00:00 PM,48,-122,325,143,468
20370,FremontBridge,01/29/2015 06:00:00 PM,48,-122,232,119,351
20371,FremontBridge,01/29/2015 07:00:00 PM,48,-122,91,47,138
20372,FremontBridge,01/29/2015 08:00:00 PM,48,-122,50,22,72
20373,FremontBridge,01/29/2015 09:00:00 PM,48,-122,26,26,52
20374,FremontBridge,01/29/2015 10:00:00 PM,48,-122,12,17,29
20375,FremontBridge,01/29/2015 11:00:00 PM,48,-122,12,21,33
20376,FremontBridge,01/30/2015 12:00:00 AM,48,-122,7,4,11
20377,FremontBridge,01/30/2015 01:00:00 AM,48,-122,3,7,10
20378,FremontBridge,01/30/2015 02:00:00 AM,48,-122,4,6,10
20379,FremontBridge,01/30/2015 03:00:00 AM,48,-122,1,2,3
20380,FremontBridge,01/30/2015 04:00:00 AM,48,-122,3,1,4
20381,FremontBridge,01/30/2015 05:00:00 AM,48,-122,7,19,26
20382,FremontBridge,01/30/2015 06:00:00 AM,48,-122,27,59,86
20383,FremontBridge,01/30/2015 07:00:00 AM,48,-122,59,179,238
20384,FremontBridge,01/30/2015 08:00:00 AM,48,-122,85,254,339
20385,FremontBridge,01/30/2015 09:00:00 AM,48,-122,84,133,217
20386,FremontBridge,01/30/2015 10:00:00 AM,48,-122,31,59,90
20387,FremontBridge,01/30/2015 11:00:00 AM,48,-122,19,47,66
20388,FremontBridge,01/30/2015 12:00:00 PM,48,-122,33,47,80
20389,FremontBridge,01/30/2015 01:00:00 PM,48,-122,40,43,83
20390,FremontBridge,01/30/2015 02:00:00 PM,48,-122,57,55,112
20391,FremontBridge,01/30/2015 03:00:00 PM,48,-122,83,72,155
20392,FremontBridge,01/30/2015 04:00:00 PM,48,-122,148,97,245
20393,FremontBridge,01/30/2015 05:00:00 PM,48,-122,240,102,342
20394,FremontBridge,01/30/2015 06:00:00 PM,48,-122,196,91,287
20395,FremontBridge,01/30/2015 07:00:00 PM,48,-122,55,32,87
20396,FremontBridge,01/30/2015 08:00:00 PM,48,-122,29,18,47
20397,FremontBridge,01/30/2015 09:00:00 PM,48,-122,18,12,30
20398,FremontBridge,01/30/2015 10:00:00 PM,48,-122,11,11,22
20399,FremontBridge,01/30/2015 11:00:00 PM,48,-122,9,13,22
20400,FremontBridge,01/31/2015 12:00:00 AM,48,-122,9,8,17
20401,FremontBridge,01/31/2015 01:00:00 AM,48,-122,1,2,3
20402,FremontBridge,01/31/2015 02:00:00 AM,48,-122,2,2,4
20403,FremontBridge,01/31/2015 03:00:00 AM,48,-122,0,2,2
20404,FremontBridge,01/31/2015 04:00:00 AM,48,-122,1,2,3
20405,FremontBridge,01/31/2015 05:00:00 AM,48,-122,2,0,2
20406,FremontBridge,01/31/2015 06:00:00 AM,48,-122,10,5,15
20407,FremontBridge,01/31/2015 07:00:00 AM,48,-122,8,11,19
20408,FremontBridge,01/31/2015 08:00:00 AM,48,-122,19,28,47
20409,FremontBridge,01/31/2015 09:00:00 AM,48,-122,38,46,84
20410,FremontBridge,01/31/2015 10:00:00 AM,48,-122,28,44,72
20411,FremontBridge,01/31/2015 11:00:00 AM,48,-122,35,46,81
20412,FremontBridge,01/31/2015 12:00:00 PM,48,-122,48,65,113
20413,FremontBridge,01/31/2015 01:00:00 PM,48,-122,67,81,148
20414,FremontBridge,01/31/2015 02:00:00 PM,48,-122,66,69,135
20415,FremontBridge,01/31/2015 03:00:00 PM,48,-122,58,68,126
20416,FremontBridge,01/31/2015 04:00:00 PM,48,-122,61,76,137
20417,FremontBridge,01/31/2015 05:00:00 PM,48,-122,42,39,81
20418,FremontBridge,01/31/2015 06:00:00 PM,48,-122,20,26,46
20419,FremontBridge,01/31/2015 07:00:00 PM,48,-122,8,10,18
20420,FremontBridge,01/31/2015 08:00:00 PM,48,-122,17,8,25
20421,FremontBridge,01/31/2015 09:00:00 PM,48,-122,13,8,21
20422,FremontBridge,01/31/2015 10:00:00 PM,48,-122,14,6,20
20423,FremontBridge,01/31/2015 11:00:00 PM,48,-122,6,11,17
20424,FremontBridge,02/01/2015 12:00:00 AM,48,-122,9,9,18
20425,FremontBridge,02/01/2015 01:00:00 AM,48,-122,5,1,6
20426,FremontBridge,02/01/2015 02:00:00 AM,48,-122,1,0,1
20427,FremontBridge,02/01/2015 03:00:00 AM,48,-122,0,0,0
20428,FremontBridge,02/01/2015 04:00:00 AM,48,-122,2,1,3
20429,FremontBridge,02/01/2015 05:00:00 AM,48,-122,1,1,2
20430,FremontBridge,02/01/2015 06:00:00 AM,48,-122,2,3,5
20431,FremontBridge,02/01/2015 07:00:00 AM,48,-122,6,16,22
20432,FremontBridge,02/01/2015 08:00:00 AM,48,-122,14,18,32
20433,FremontBridge,02/01/2015 09:00:00 AM,48,-122,30,40,70
20434,FremontBridge,02/01/2015 10:00:00 AM,48,-122,28,36,64
20435,FremontBridge,02/01/2015 11:00:00 AM,48,-122,23,43,66
20436,FremontBridge,02/01/2015 12:00:00 PM,48,-122,45,44,89
20437,FremontBridge,02/01/2015 01:00:00 PM,48,-122,19,37,56
20438,FremontBridge,02/01/2015 02:00:00 PM,48,-122,26,47,73
20439,FremontBridge,02/01/2015 03:00:00 PM,48,-122,24,23,47
20440,FremontBridge,02/01/2015 04:00:00 PM,48,-122,13,10,23
20441,FremontBridge,02/01/2015 05:00:00 PM,48,-122,5,11,16
20442,FremontBridge,02/01/2015 06:00:00 PM,48,-122,10,4,14
20443,FremontBridge,02/01/2015 07:00:00 PM,48,-122,18,15,33
20444,FremontBridge,02/01/2015 08:00:00 PM,48,-122,20,17,37
20445,FremontBridge,02/01/2015 09:00:00 PM,48,-122,6,10,16
20446,FremontBridge,02/01/2015 10:00:00 PM,48,-122,9,2,11
20447,FremontBridge,02/01/2015 11:00:00 PM,48,-122,2,2,4
20448,FremontBridge,02/02/2015 12:00:00 AM,48,-122,2,3,5
20449,FremontBridge,02/02/2015 01:00:00 AM,48,-122,2,0,2
20450,FremontBridge,02/02/2015 02:00:00 AM,48,-122,2,2,4
20451,FremontBridge,02/02/2015 03:00:00 AM,48,-122,1,0,1
20452,FremontBridge,02/02/2015 04:00:00 AM,48,-122,3,2,5
20453,FremontBridge,02/02/2015 05:00:00 AM,48,-122,7,23,30
20454,FremontBridge,02/02/2015 06:00:00 AM,48,-122,33,62,95
20455,FremontBridge,02/02/2015 07:00:00 AM,48,-122,13,172,185
20456,FremontBridge,02/02/2015 08:00:00 AM,48,-122,1,256,257
20457,FremontBridge,02/02/2015 09:00:00 AM,48,-122,0,121,121
20458,FremontBridge,02/02/2015 10:00:00 AM,48,-122,0,77,77
20459,FremontBridge,02/02/2015 11:00:00 AM,48,-122,0,26,26
20460,FremontBridge,02/02/2015 12:00:00 PM,48,-122,9,15,24
20461,FremontBridge,02/02/2015 01:00:00 PM,48,-122,27,23,50
20462,FremontBridge,02/02/2015 02:00:00 PM,48,-122,28,24,52
20463,FremontBridge,02/02/2015 03:00:00 PM,48,-122,43,39,82
20464,FremontBridge,02/02/2015 04:00:00 PM,48,-122,95,72,167
20465,FremontBridge,02/02/2015 05:00:00 PM,48,-122,205,91,296
20466,FremontBridge,02/02/2015 06:00:00 PM,48,-122,164,77,241
20467,FremontBridge,02/02/2015 07:00:00 PM,48,-122,56,34,90
20468,FremontBridge,02/02/2015 08:00:00 PM,48,-122,25,19,44
20469,FremontBridge,02/02/2015 09:00:00 PM,48,-122,20,6,26
20470,FremontBridge,02/02/2015 10:00:00 PM,48,-122,7,4,11
20471,FremontBridge,02/02/2015 11:00:00 PM,48,-122,8,5,13
20472,FremontBridge,02/03/2015 12:00:00 AM,48,-122,4,2,6
20473,FremontBridge,02/03/2015 01:00:00 AM,48,-122,4,2,6
20474,FremontBridge,02/03/2015 02:00:00 AM,48,-122,2,1,3
20475,FremontBridge,02/03/2015 03:00:00 AM,48,-122,2,2,4
20476,FremontBridge,02/03/2015 04:00:00 AM,48,-122,2,1,3
20477,FremontBridge,02/03/2015 05:00:00 AM,48,-122,12,22,34
20478,FremontBridge,02/03/2015 06:00:00 AM,48,-122,33,70,103
20479,FremontBridge,02/03/2015 07:00:00 AM,48,-122,13,181,194
20480,FremontBridge,02/03/2015 08:00:00 AM,48,-122,0,312,312
20481,FremontBridge,02/03/2015 09:00:00 AM,48,-122,1,160,161
20482,FremontBridge,02/03/2015 10:00:00 AM,48,-122,0,58,58
20483,FremontBridge,02/03/2015 11:00:00 AM,48,-122,0,55,55
20484,FremontBridge,02/03/2015 12:00:00 PM,48,-122,0,48,48
20485,FremontBridge,02/03/2015 01:00:00 PM,48,-122,0,37,37
20486,FremontBridge,02/03/2015 02:00:00 PM,48,-122,0,44,44
20487,FremontBridge,02/03/2015 03:00:00 PM,48,-122,34,41,75
20488,FremontBridge,02/03/2015 04:00:00 PM,48,-122,107,65,172
20489,FremontBridge,02/03/2015 05:00:00 PM,48,-122,255,111,366
20490,FremontBridge,02/03/2015 06:00:00 PM,48,-122,261,101,362
20491,FremontBridge,02/03/2015 07:00:00 PM,48,-122,82,43,125
20492,FremontBridge,02/03/2015 08:00:00 PM,48,-122,46,23,69
20493,FremontBridge,02/03/2015 09:00:00 PM,48,-122,26,24,50
20494,FremontBridge,02/03/2015 10:00:00 PM,48,-122,13,12,25
20495,FremontBridge,02/03/2015 11:00:00 PM,48,-122,15,7,22
20496,FremontBridge,02/04/2015 12:00:00 AM,48,-122,5,2,7
20497,FremontBridge,02/04/2015 01:00:00 AM,48,-122,2,4,6
20498,FremontBridge,02/04/2015 02:00:00 AM,48,-122,0,0,0
20499,FremontBridge,02/04/2015 03:00:00 AM,48,-122,1,0,1
20500,FremontBridge,02/04/2015 04:00:00 AM,48,-122,1,5,6
20501,FremontBridge,02/04/2015 05:00:00 AM,48,-122,13,25,38
20502,FremontBridge,02/04/2015 06:00:00 AM,48,-122,28,66,94
20503,FremontBridge,02/04/2015 07:00:00 AM,48,-122,12,183,195
20504,FremontBridge,02/04/2015 08:00:00 AM,48,-122,0,280,280
20505,FremontBridge,02/04/2015 09:00:00 AM,48,-122,0,179,179
20506,FremontBridge,02/04/2015 10:00:00 AM,48,-122,0,60,60
20507,FremontBridge,02/04/2015 11:00:00 AM,48,-122,0,41,41
20508,FremontBridge,02/04/2015 12:00:00 PM,48,-122,0,54,54
20509,FremontBridge,02/04/2015 01:00:00 PM,48,-122,0,57,57
20510,FremontBridge,02/04/2015 02:00:00 PM,48,-122,2,61,63
20511,FremontBridge,02/04/2015 03:00:00 PM,48,-122,38,54,92
20512,FremontBridge,02/04/2015 04:00:00 PM,48,-122,98,66,164
20513,FremontBridge,02/04/2015 05:00:00 PM,48,-122,277,116,393
20514,FremontBridge,02/04/2015 06:00:00 PM,48,-122,191,74,265
20515,FremontBridge,02/04/2015 07:00:00 PM,48,-122,80,32,112
20516,FremontBridge,02/04/2015 08:00:00 PM,48,-122,43,26,69
20517,FremontBridge,02/04/2015 09:00:00 PM,48,-122,21,21,42
20518,FremontBridge,02/04/2015 10:00:00 PM,48,-122,8,9,17
20519,FremontBridge,02/04/2015 11:00:00 PM,48,-122,7,9,16
20520,FremontBridge,02/05/2015 12:00:00 AM,48,-122,2,2,4
20521,FremontBridge,02/05/2015 01:00:00 AM,48,-122,1,4,5
20522,FremontBridge,02/05/2015 02:00:00 AM,48,-122,1,0,1
20523,FremontBridge,02/05/2015 03:00:00 AM,48,-122,2,1,3
20524,FremontBridge,02/05/2015 04:00:00 AM,48,-122,1,3,4
20525,FremontBridge,02/05/2015 05:00:00 AM,48,-122,5,17,22
20526,FremontBridge,02/05/2015 06:00:00 AM,48,-122,24,39,63
20527,FremontBridge,02/05/2015 07:00:00 AM,48,-122,6,129,135
20528,FremontBridge,02/05/2015 08:00:00 AM,48,-122,0,223,223
20529,FremontBridge,02/05/2015 09:00:00 AM,48,-122,0,145,145
20530,FremontBridge,02/05/2015 10:00:00 AM,48,-122,0,39,39
20531,FremontBridge,02/05/2015 11:00:00 AM,48,-122,0,35,35
20532,FremontBridge,02/05/2015 12:00:00 PM,48,-122,0,38,38
20533,FremontBridge,02/05/2015 01:00:00 PM,48,-122,0,27,27
20534,FremontBridge,02/05/2015 02:00:00 PM,48,-122,14,29,43
20535,FremontBridge,02/05/2015 03:00:00 PM,48,-122,30,25,55
20536,FremontBridge,02/05/2015 04:00:00 PM,48,-122,74,56,130
20537,FremontBridge,02/05/2015 05:00:00 PM,48,-122,166,87,253
20538,FremontBridge,02/05/2015 06:00:00 PM,48,-122,146,73,219
20539,FremontBridge,02/05/2015 07:00:00 PM,48,-122,80,32,112
20540,FremontBridge,02/05/2015 08:00:00 PM,48,-122,33,22,55
20541,FremontBridge,02/05/2015 09:00:00 PM,48,-122,24,15,39
20542,FremontBridge,02/05/2015 10:00:00 PM,48,-122,10,8,18
20543,FremontBridge,02/05/2015 11:00:00 PM,48,-122,9,17,26
20544,FremontBridge,02/06/2015 12:00:00 AM,48,-122,3,2,5
20545,FremontBridge,02/06/2015 01:00:00 AM,48,-122,0,1,1
20546,FremontBridge,02/06/2015 02:00:00 AM,48,-122,0,1,1
20547,FremontBridge,02/06/2015 03:00:00 AM,48,-122,2,1,3
20548,FremontBridge,02/06/2015 04:00:00 AM,48,-122,3,2,5
20549,FremontBridge,02/06/2015 05:00:00 AM,48,-122,8,13,21
20550,FremontBridge,02/06/2015 06:00:00 AM,48,-122,24,38,62
20551,FremontBridge,02/06/2015 07:00:00 AM,48,-122,9,102,111
20552,FremontBridge,02/06/2015 08:00:00 AM,48,-122,0,212,212
20553,FremontBridge,02/06/2015 09:00:00 AM,48,-122,3,118,121
20554,FremontBridge,02/06/2015 10:00:00 AM,48,-122,0,52,52
20555,FremontBridge,02/06/2015 11:00:00 AM,48,-122,0,29,29
20556,FremontBridge,02/06/2015 12:00:00 PM,48,-122,1,14,15
20557,FremontBridge,02/06/2015 01:00:00 PM,48,-122,12,26,38
20558,FremontBridge,02/06/2015 02:00:00 PM,48,-122,20,29,49
20559,FremontBridge,02/06/2015 03:00:00 PM,48,-122,26,28,54
20560,FremontBridge,02/06/2015 04:00:00 PM,48,-122,83,51,134
20561,FremontBridge,02/06/2015 05:00:00 PM,48,-122,208,90,298
20562,FremontBridge,02/06/2015 06:00:00 PM,48,-122,134,71,205
20563,FremontBridge,02/06/2015 07:00:00 PM,48,-122,59,25,84
20564,FremontBridge,02/06/2015 08:00:00 PM,48,-122,20,11,31
20565,FremontBridge,02/06/2015 09:00:00 PM,48,-122,18,15,33
20566,FremontBridge,02/06/2015 10:00:00 PM,48,-122,13,9,22
20567,FremontBridge,02/06/2015 11:00:00 PM,48,-122,11,14,25
20568,FremontBridge,02/07/2015 12:00:00 AM,48,-122,7,6,13
20569,FremontBridge,02/07/2015 01:00:00 AM,48,-122,4,4,8
20570,FremontBridge,02/07/2015 02:00:00 AM,48,-122,3,4,7
20571,FremontBridge,02/07/2015 03:00:00 AM,48,-122,2,3,5
20572,FremontBridge,02/07/2015 04:00:00 AM,48,-122,1,0,1
20573,FremontBridge,02/07/2015 05:00:00 AM,48,-122,2,8,10
20574,FremontBridge,02/07/2015 06:00:00 AM,48,-122,11,5,16
20575,FremontBridge,02/07/2015 07:00:00 AM,48,-122,10,8,18
20576,FremontBridge,02/07/2015 08:00:00 AM,48,-122,10,18,28
20577,FremontBridge,02/07/2015 09:00:00 AM,48,-122,15,11,26
20578,FremontBridge,02/07/2015 10:00:00 AM,48,-122,9,23,32
20579,FremontBridge,02/07/2015 11:00:00 AM,48,-122,19,34,53
20580,FremontBridge,02/07/2015 12:00:00 PM,48,-122,21,27,48
20581,FremontBridge,02/07/2015 01:00:00 PM,48,-122,13,26,39
20582,FremontBridge,02/07/2015 02:00:00 PM,48,-122,34,46,80
20583,FremontBridge,02/07/2015 03:00:00 PM,48,-122,25,37,62
20584,FremontBridge,02/07/2015 04:00:00 PM,48,-122,23,19,42
20585,FremontBridge,02/07/2015 05:00:00 PM,48,-122,20,12,32
20586,FremontBridge,02/07/2015 06:00:00 PM,48,-122,20,20,40
20587,FremontBridge,02/07/2015 07:00:00 PM,48,-122,10,9,19
20588,FremontBridge,02/07/2015 08:00:00 PM,48,-122,13,3,16
20589,FremontBridge,02/07/2015 09:00:00 PM,48,-122,5,6,11
20590,FremontBridge,02/07/2015 10:00:00 PM,48,-122,4,3,7
20591,FremontBridge,02/07/2015 11:00:00 PM,48,-122,9,7,16
20592,FremontBridge,02/08/2015 12:00:00 AM,48,-122,2,0,2
20593,FremontBridge,02/08/2015 01:00:00 AM,48,-122,1,2,3
20594,FremontBridge,02/08/2015 02:00:00 AM,48,-122,2,1,3
20595,FremontBridge,02/08/2015 03:00:00 AM,48,-122,0,2,2
20596,FremontBridge,02/08/2015 04:00:00 AM,48,-122,1,2,3
20597,FremontBridge,02/08/2015 05:00:00 AM,48,-122,2,1,3
20598,FremontBridge,02/08/2015 06:00:00 AM,48,-122,6,6,12
20599,FremontBridge,02/08/2015 07:00:00 AM,48,-122,7,7,14
20600,FremontBridge,02/08/2015 08:00:00 AM,48,-122,15,44,59
20601,FremontBridge,02/08/2015 09:00:00 AM,48,-122,35,70,105
20602,FremontBridge,02/08/2015 10:00:00 AM,48,-122,65,71,136
20603,FremontBridge,02/08/2015 11:00:00 AM,48,-122,68,90,158
20604,FremontBridge,02/08/2015 12:00:00 PM,48,-122,86,95,181
20605,FremontBridge,02/08/2015 01:00:00 PM,48,-122,82,98,180
20606,FremontBridge,02/08/2015 02:00:00 PM,48,-122,81,101,182
20607,FremontBridge,02/08/2015 03:00:00 PM,48,-122,74,69,143
20608,FremontBridge,02/08/2015 04:00:00 PM,48,-122,51,69,120
20609,FremontBridge,02/08/2015 05:00:00 PM,48,-122,39,50,89
20610,FremontBridge,02/08/2015 06:00:00 PM,48,-122,16,20,36
20611,FremontBridge,02/08/2015 07:00:00 PM,48,-122,16,17,33
20612,FremontBridge,02/08/2015 08:00:00 PM,48,-122,14,11,25
20613,FremontBridge,02/08/2015 09:00:00 PM,48,-122,11,4,15
20614,FremontBridge,02/08/2015 10:00:00 PM,48,-122,5,4,9
20615,FremontBridge,02/08/2015 11:00:00 PM,48,-122,3,6,9
20616,FremontBridge,02/09/2015 12:00:00 AM,48,-122,0,1,1
20617,FremontBridge,02/09/2015 01:00:00 AM,48,-122,2,2,4
20618,FremontBridge,02/09/2015 02:00:00 AM,48,-122,1,0,1
20619,FremontBridge,02/09/2015 03:00:00 AM,48,-122,1,1,2
20620,FremontBridge,02/09/2015 04:00:00 AM,48,-122,6,5,11
20621,FremontBridge,02/09/2015 05:00:00 AM,48,-122,13,17,30
20622,FremontBridge,02/09/2015 06:00:00 AM,48,-122,39,63,102
20623,FremontBridge,02/09/2015 07:00:00 AM,48,-122,82,127,209
20624,FremontBridge,02/09/2015 08:00:00 AM,48,-122,232,1,233
20625,FremontBridge,02/09/2015 09:00:00 AM,48,-122,128,1,129
20626,FremontBridge,02/09/2015 10:00:00 AM,48,-122,53,2,55
20627,FremontBridge,02/09/2015 11:00:00 AM,48,-122,38,0,38
20628,FremontBridge,02/09/2015 12:00:00 PM,48,-122,28,0,28
20629,FremontBridge,02/09/2015 01:00:00 PM,48,-122,28,0,28
20630,FremontBridge,02/09/2015 02:00:00 PM,48,-122,31,21,52
20631,FremontBridge,02/09/2015 03:00:00 PM,48,-122,50,44,94
20632,FremontBridge,02/09/2015 04:00:00 PM,48,-122,108,74,182
20633,FremontBridge,02/09/2015 05:00:00 PM,48,-122,278,104,382
20634,FremontBridge,02/09/2015 06:00:00 PM,48,-122,200,98,298
20635,FremontBridge,02/09/2015 07:00:00 PM,48,-122,72,31,103
20636,FremontBridge,02/09/2015 08:00:00 PM,48,-122,44,18,62
20637,FremontBridge,02/09/2015 09:00:00 PM,48,-122,19,8,27
20638,FremontBridge,02/09/2015 10:00:00 PM,48,-122,8,9,17
20639,FremontBridge,02/09/2015 11:00:00 PM,48,-122,12,4,16
20640,FremontBridge,02/10/2015 12:00:00 AM,48,-122,5,2,7
20641,FremontBridge,02/10/2015 01:00:00 AM,48,-122,2,4,6
20642,FremontBridge,02/10/2015 02:00:00 AM,48,-122,1,1,2
20643,FremontBridge,02/10/2015 03:00:00 AM,48,-122,1,1,2
20644,FremontBridge,02/10/2015 04:00:00 AM,48,-122,4,1,5
20645,FremontBridge,02/10/2015 05:00:00 AM,48,-122,9,26,35
20646,FremontBridge,02/10/2015 06:00:00 AM,48,-122,31,66,97
20647,FremontBridge,02/10/2015 07:00:00 AM,48,-122,0,190,190
20648,FremontBridge,02/10/2015 08:00:00 AM,48,-122,109,210,319
20649,FremontBridge,02/10/2015 09:00:00 AM,48,-122,137,1,138
20650,FremontBridge,02/10/2015 10:00:00 AM,48,-122,66,0,66
20651,FremontBridge,02/10/2015 11:00:00 AM,48,-122,28,27,55
20652,FremontBridge,02/10/2015 12:00:00 PM,48,-122,0,45,45
20653,FremontBridge,02/10/2015 01:00:00 PM,48,-122,14,63,77
20654,FremontBridge,02/10/2015 02:00:00 PM,48,-122,41,48,89
20655,FremontBridge,02/10/2015 03:00:00 PM,48,-122,65,38,103
20656,FremontBridge,02/10/2015 04:00:00 PM,48,-122,126,95,221
20657,FremontBridge,02/10/2015 05:00:00 PM,48,-122,275,120,395
20658,FremontBridge,02/10/2015 06:00:00 PM,48,-122,219,113,332
20659,FremontBridge,02/10/2015 07:00:00 PM,48,-122,113,48,161
20660,FremontBridge,02/10/2015 08:00:00 PM,48,-122,35,36,71
20661,FremontBridge,02/10/2015 09:00:00 PM,48,-122,28,23,51
20662,FremontBridge,02/10/2015 10:00:00 PM,48,-122,15,6,21
20663,FremontBridge,02/10/2015 11:00:00 PM,48,-122,16,12,28
20664,FremontBridge,02/11/2015 12:00:00 AM,48,-122,9,3,12
20665,FremontBridge,02/11/2015 01:00:00 AM,48,-122,0,2,2
20666,FremontBridge,02/11/2015 02:00:00 AM,48,-122,1,2,3
20667,FremontBridge,02/11/2015 03:00:00 AM,48,-122,1,1,2
20668,FremontBridge,02/11/2015 04:00:00 AM,48,-122,3,1,4
20669,FremontBridge,02/11/2015 05:00:00 AM,48,-122,8,20,28
20670,FremontBridge,02/11/2015 06:00:00 AM,48,-122,42,72,114
20671,FremontBridge,02/11/2015 07:00:00 AM,48,-122,8,208,216
20672,FremontBridge,02/11/2015 08:00:00 AM,48,-122,0,363,363
20673,FremontBridge,02/11/2015 09:00:00 AM,48,-122,0,172,172
20674,FremontBridge,02/11/2015 10:00:00 AM,48,-122,0,79,79
20675,FremontBridge,02/11/2015 11:00:00 AM,48,-122,0,66,66
20676,FremontBridge,02/11/2015 12:00:00 PM,48,-122,0,64,64
20677,FremontBridge,02/11/2015 01:00:00 PM,48,-122,0,66,66
20678,FremontBridge,02/11/2015 02:00:00 PM,48,-122,24,49,73
20679,FremontBridge,02/11/2015 03:00:00 PM,48,-122,41,61,102
20680,FremontBridge,02/11/2015 04:00:00 PM,48,-122,136,89,225
20681,FremontBridge,02/11/2015 05:00:00 PM,48,-122,351,157,508
20682,FremontBridge,02/11/2015 06:00:00 PM,48,-122,253,97,350
20683,FremontBridge,02/11/2015 07:00:00 PM,48,-122,115,51,166
20684,FremontBridge,02/11/2015 08:00:00 PM,48,-122,54,30,84
20685,FremontBridge,02/11/2015 09:00:00 PM,48,-122,32,19,51
20686,FremontBridge,02/11/2015 10:00:00 PM,48,-122,21,15,36
20687,FremontBridge,02/11/2015 11:00:00 PM,48,-122,15,7,22
20688,FremontBridge,02/12/2015 12:00:00 AM,48,-122,8,2,10
20689,FremontBridge,02/12/2015 01:00:00 AM,48,-122,1,1,2
20690,FremontBridge,02/12/2015 02:00:00 AM,48,-122,5,1,6
20691,FremontBridge,02/12/2015 03:00:00 AM,48,-122,3,1,4
20692,FremontBridge,02/12/2015 04:00:00 AM,48,-122,2,5,7
20693,FremontBridge,02/12/2015 05:00:00 AM,48,-122,10,17,27
20694,FremontBridge,02/12/2015 06:00:00 AM,48,-122,37,48,85
20695,FremontBridge,02/12/2015 07:00:00 AM,48,-122,2,196,198
20696,FremontBridge,02/12/2015 08:00:00 AM,48,-122,1,342,343
20697,FremontBridge,02/12/2015 09:00:00 AM,48,-122,3,234,237
20698,FremontBridge,02/12/2015 10:00:00 AM,48,-122,0,76,76
20699,FremontBridge,02/12/2015 11:00:00 AM,48,-122,3,68,71
20700,FremontBridge,02/12/2015 12:00:00 PM,48,-122,3,41,44
20701,FremontBridge,02/12/2015 01:00:00 PM,48,-122,1,59,60
20702,FremontBridge,02/12/2015 02:00:00 PM,48,-122,13,52,65
20703,FremontBridge,02/12/2015 03:00:00 PM,48,-122,73,56,129
20704,FremontBridge,02/12/2015 04:00:00 PM,48,-122,127,94,221
20705,FremontBridge,02/12/2015 05:00:00 PM,48,-122,276,151,427
20706,FremontBridge,02/12/2015 06:00:00 PM,48,-122,220,96,316
20707,FremontBridge,02/12/2015 07:00:00 PM,48,-122,115,60,175
20708,FremontBridge,02/12/2015 08:00:00 PM,48,-122,58,26,84
20709,FremontBridge,02/12/2015 09:00:00 PM,48,-122,20,24,44
20710,FremontBridge,02/12/2015 10:00:00 PM,48,-122,18,23,41
20711,FremontBridge,02/12/2015 11:00:00 PM,48,-122,19,6,25
20712,FremontBridge,02/13/2015 12:00:00 AM,48,-122,7,4,11
20713,FremontBridge,02/13/2015 01:00:00 AM,48,-122,2,1,3
20714,FremontBridge,02/13/2015 02:00:00 AM,48,-122,0,1,1
20715,FremontBridge,02/13/2015 03:00:00 AM,48,-122,3,1,4
20716,FremontBridge,02/13/2015 04:00:00 AM,48,-122,1,3,4
20717,FremontBridge,02/13/2015 05:00:00 AM,48,-122,7,16,23
20718,FremontBridge,02/13/2015 06:00:00 AM,48,-122,33,52,85
20719,FremontBridge,02/13/2015 07:00:00 AM,48,-122,10,173,183
20720,FremontBridge,02/13/2015 08:00:00 AM,48,-122,0,284,284
20721,FremontBridge,02/13/2015 09:00:00 AM,48,-122,0,180,180
20722,FremontBridge,02/13/2015 10:00:00 AM,48,-122,0,80,80
20723,FremontBridge,02/13/2015 11:00:00 AM,48,-122,0,65,65
20724,FremontBridge,02/13/2015 12:00:00 PM,48,-122,0,60,60
20725,FremontBridge,02/13/2015 01:00:00 PM,48,-122,0,67,67
20726,FremontBridge,02/13/2015 02:00:00 PM,48,-122,12,65,77
20727,FremontBridge,02/13/2015 03:00:00 PM,48,-122,92,75,167
20728,FremontBridge,02/13/2015 04:00:00 PM,48,-122,128,97,225
20729,FremontBridge,02/13/2015 05:00:00 PM,48,-122,268,132,400
20730,FremontBridge,02/13/2015 06:00:00 PM,48,-122,178,97,275
20731,FremontBridge,02/13/2015 07:00:00 PM,48,-122,71,47,118
20732,FremontBridge,02/13/2015 08:00:00 PM,48,-122,27,24,51
20733,FremontBridge,02/13/2015 09:00:00 PM,48,-122,24,19,43
20734,FremontBridge,02/13/2015 10:00:00 PM,48,-122,10,16,26
20735,FremontBridge,02/13/2015 11:00:00 PM,48,-122,19,8,27
20736,FremontBridge,02/14/2015 12:00:00 AM,48,-122,8,7,15
20737,FremontBridge,02/14/2015 01:00:00 AM,48,-122,11,1,12
20738,FremontBridge,02/14/2015 02:00:00 AM,48,-122,2,3,5
20739,FremontBridge,02/14/2015 03:00:00 AM,48,-122,3,6,9
20740,FremontBridge,02/14/2015 04:00:00 AM,48,-122,4,1,5
20741,FremontBridge,02/14/2015 05:00:00 AM,48,-122,2,7,9
20742,FremontBridge,02/14/2015 06:00:00 AM,48,-122,8,6,14
20743,FremontBridge,02/14/2015 07:00:00 AM,48,-122,5,13,18
20744,FremontBridge,02/14/2015 08:00:00 AM,48,-122,24,35,59
20745,FremontBridge,02/14/2015 09:00:00 AM,48,-122,25,50,75
20746,FremontBridge,02/14/2015 10:00:00 AM,48,-122,38,58,96
20747,FremontBridge,02/14/2015 11:00:00 AM,48,-122,43,67,110
20748,FremontBridge,02/14/2015 12:00:00 PM,48,-122,54,46,100
20749,FremontBridge,02/14/2015 01:00:00 PM,48,-122,56,93,149
20750,FremontBridge,02/14/2015 02:00:00 PM,48,-122,78,85,163
20751,FremontBridge,02/14/2015 03:00:00 PM,48,-122,76,95,171
20752,FremontBridge,02/14/2015 04:00:00 PM,48,-122,77,73,150
20753,FremontBridge,02/14/2015 05:00:00 PM,48,-122,56,68,124
20754,FremontBridge,02/14/2015 06:00:00 PM,48,-122,34,30,64
20755,FremontBridge,02/14/2015 07:00:00 PM,48,-122,22,18,40
20756,FremontBridge,02/14/2015 08:00:00 PM,48,-122,16,13,29
20757,FremontBridge,02/14/2015 09:00:00 PM,48,-122,12,6,18
20758,FremontBridge,02/14/2015 10:00:00 PM,48,-122,10,8,18
20759,FremontBridge,02/14/2015 11:00:00 PM,48,-122,7,5,12
20760,FremontBridge,02/15/2015 12:00:00 AM,48,-122,9,5,14
20761,FremontBridge,02/15/2015 01:00:00 AM,48,-122,2,3,5
20762,FremontBridge,02/15/2015 02:00:00 AM,48,-122,2,6,8
20763,FremontBridge,02/15/2015 03:00:00 AM,48,-122,1,2,3
20764,FremontBridge,02/15/2015 04:00:00 AM,48,-122,1,0,1
20765,FremontBridge,02/15/2015 05:00:00 AM,48,-122,0,1,1
20766,FremontBridge,02/15/2015 06:00:00 AM,48,-122,5,5,10
20767,FremontBridge,02/15/2015 07:00:00 AM,48,-122,5,8,13
20768,FremontBridge,02/15/2015 08:00:00 AM,48,-122,27,32,59
20769,FremontBridge,02/15/2015 09:00:00 AM,48,-122,39,46,85
20770,FremontBridge,02/15/2015 10:00:00 AM,48,-122,45,70,115
20771,FremontBridge,02/15/2015 11:00:00 AM,48,-122,62,90,152
20772,FremontBridge,02/15/2015 12:00:00 PM,48,-122,86,124,210
20773,FremontBridge,02/15/2015 01:00:00 PM,48,-122,67,134,201
20774,FremontBridge,02/15/2015 02:00:00 PM,48,-122,145,112,257
20775,FremontBridge,02/15/2015 03:00:00 PM,48,-122,116,115,231
20776,FremontBridge,02/15/2015 04:00:00 PM,48,-122,79,102,181
20777,FremontBridge,02/15/2015 05:00:00 PM,48,-122,56,67,123
20778,FremontBridge,02/15/2015 06:00:00 PM,48,-122,33,32,65
20779,FremontBridge,02/15/2015 07:00:00 PM,48,-122,15,19,34
20780,FremontBridge,02/15/2015 08:00:00 PM,48,-122,16,17,33
20781,FremontBridge,02/15/2015 09:00:00 PM,48,-122,5,4,9
20782,FremontBridge,02/15/2015 10:00:00 PM,48,-122,7,6,13
20783,FremontBridge,02/15/2015 11:00:00 PM,48,-122,12,1,13
20784,FremontBridge,02/16/2015 12:00:00 AM,48,-122,8,3,11
20785,FremontBridge,02/16/2015 01:00:00 AM,48,-122,4,1,5
20786,FremontBridge,02/16/2015 02:00:00 AM,48,-122,2,1,3
20787,FremontBridge,02/16/2015 03:00:00 AM,48,-122,1,0,1
20788,FremontBridge,02/16/2015 04:00:00 AM,48,-122,1,4,5
20789,FremontBridge,02/16/2015 05:00:00 AM,48,-122,7,15,22
20790,FremontBridge,02/16/2015 06:00:00 AM,48,-122,17,33,50
20791,FremontBridge,02/16/2015 07:00:00 AM,48,-122,23,82,105
20792,FremontBridge,02/16/2015 08:00:00 AM,48,-122,53,137,190
20793,FremontBridge,02/16/2015 09:00:00 AM,48,-122,57,104,161
20794,FremontBridge,02/16/2015 10:00:00 AM,48,-122,41,75,116
20795,FremontBridge,02/16/2015 11:00:00 AM,48,-122,54,59,113
20796,FremontBridge,02/16/2015 12:00:00 PM,48,-122,41,51,92
20797,FremontBridge,02/16/2015 01:00:00 PM,48,-122,61,105,166
20798,FremontBridge,02/16/2015 02:00:00 PM,48,-122,72,113,185
20799,FremontBridge,02/16/2015 03:00:00 PM,48,-122,76,72,148
20800,FremontBridge,02/16/2015 04:00:00 PM,48,-122,108,96,204
20801,FremontBridge,02/16/2015 05:00:00 PM,48,-122,166,88,254
20802,FremontBridge,02/16/2015 06:00:00 PM,48,-122,123,85,208
20803,FremontBridge,02/16/2015 07:00:00 PM,48,-122,47,24,71
20804,FremontBridge,02/16/2015 08:00:00 PM,48,-122,28,13,41
20805,FremontBridge,02/16/2015 09:00:00 PM,48,-122,21,11,32
20806,FremontBridge,02/16/2015 10:00:00 PM,48,-122,12,4,16
20807,FremontBridge,02/16/2015 11:00:00 PM,48,-122,8,4,12
20808,FremontBridge,02/17/2015 12:00:00 AM,48,-122,8,1,9
20809,FremontBridge,02/17/2015 01:00:00 AM,48,-122,1,0,1
20810,FremontBridge,02/17/2015 02:00:00 AM,48,-122,3,1,4
20811,FremontBridge,02/17/2015 03:00:00 AM,48,-122,0,0,0
20812,FremontBridge,02/17/2015 04:00:00 AM,48,-122,3,5,8
20813,FremontBridge,02/17/2015 05:00:00 AM,48,-122,7,24,31
20814,FremontBridge,02/17/2015 06:00:00 AM,48,-122,22,64,86
20815,FremontBridge,02/17/2015 07:00:00 AM,48,-122,1,194,195
20816,FremontBridge,02/17/2015 08:00:00 AM,48,-122,0,340,340
20817,FremontBridge,02/17/2015 09:00:00 AM,48,-122,0,187,187
20818,FremontBridge,02/17/2015 10:00:00 AM,48,-122,0,91,91
20819,FremontBridge,02/17/2015 11:00:00 AM,48,-122,0,72,72
20820,FremontBridge,02/17/2015 12:00:00 PM,48,-122,0,77,77
20821,FremontBridge,02/17/2015 01:00:00 PM,48,-122,0,95,95
20822,FremontBridge,02/17/2015 02:00:00 PM,48,-122,31,79,110
20823,FremontBridge,02/17/2015 03:00:00 PM,48,-122,81,73,154
20824,FremontBridge,02/17/2015 04:00:00 PM,48,-122,163,115,278
20825,FremontBridge,02/17/2015 05:00:00 PM,48,-122,288,164,452
20826,FremontBridge,02/17/2015 06:00:00 PM,48,-122,262,136,398
20827,FremontBridge,02/17/2015 07:00:00 PM,48,-122,88,63,151
20828,FremontBridge,02/17/2015 08:00:00 PM,48,-122,43,24,67
20829,FremontBridge,02/17/2015 09:00:00 PM,48,-122,30,20,50
20830,FremontBridge,02/17/2015 10:00:00 PM,48,-122,22,9,31
20831,FremontBridge,02/17/2015 11:00:00 PM,48,-122,27,5,32
20832,FremontBridge,02/18/2015 12:00:00 AM,48,-122,3,3,6
20833,FremontBridge,02/18/2015 01:00:00 AM,48,-122,3,2,5
20834,FremontBridge,02/18/2015 02:00:00 AM,48,-122,0,2,2
20835,FremontBridge,02/18/2015 03:00:00 AM,48,-122,0,1,1
20836,FremontBridge,02/18/2015 04:00:00 AM,48,-122,2,3,5
20837,FremontBridge,02/18/2015 05:00:00 AM,48,-122,9,24,33
20838,FremontBridge,02/18/2015 06:00:00 AM,48,-122,32,83,115
20839,FremontBridge,02/18/2015 07:00:00 AM,48,-122,11,200,211
20840,FremontBridge,02/18/2015 08:00:00 AM,48,-122,0,336,336
20841,FremontBridge,02/18/2015 09:00:00 AM,48,-122,1,175,176
20842,FremontBridge,02/18/2015 10:00:00 AM,48,-122,0,84,84
20843,FremontBridge,02/18/2015 11:00:00 AM,48,-122,0,58,58
20844,FremontBridge,02/18/2015 12:00:00 PM,48,-122,0,47,47
20845,FremontBridge,02/18/2015 01:00:00 PM,48,-122,2,152,154
20846,FremontBridge,02/18/2015 02:00:00 PM,48,-122,8,111,119
20847,FremontBridge,02/18/2015 03:00:00 PM,48,-122,53,55,108
20848,FremontBridge,02/18/2015 04:00:00 PM,48,-122,129,92,221
20849,FremontBridge,02/18/2015 05:00:00 PM,48,-122,330,170,500
20850,FremontBridge,02/18/2015 06:00:00 PM,48,-122,261,113,374
20851,FremontBridge,02/18/2015 07:00:00 PM,48,-122,110,49,159
20852,FremontBridge,02/18/2015 08:00:00 PM,48,-122,43,36,79
20853,FremontBridge,02/18/2015 09:00:00 PM,48,-122,32,27,59
20854,FremontBridge,02/18/2015 10:00:00 PM,48,-122,34,24,58
20855,FremontBridge,02/18/2015 11:00:00 PM,48,-122,10,7,17
20856,FremontBridge,02/19/2015 12:00:00 AM,48,-122,2,2,4
20857,FremontBridge,02/19/2015 01:00:00 AM,48,-122,0,3,3
20858,FremontBridge,02/19/2015 02:00:00 AM,48,-122,5,1,6
20859,FremontBridge,02/19/2015 03:00:00 AM,48,-122,1,2,3
20860,FremontBridge,02/19/2015 04:00:00 AM,48,-122,2,7,9
20861,FremontBridge,02/19/2015 05:00:00 AM,48,-122,8,17,25
20862,FremontBridge,02/19/2015 06:00:00 AM,48,-122,33,64,97
20863,FremontBridge,02/19/2015 07:00:00 AM,48,-122,8,167,175
20864,FremontBridge,02/19/2015 08:00:00 AM,48,-122,0,290,290
20865,FremontBridge,02/19/2015 09:00:00 AM,48,-122,0,159,159
20866,FremontBridge,02/19/2015 10:00:00 AM,48,-122,1,80,81
20867,FremontBridge,02/19/2015 11:00:00 AM,48,-122,0,49,49
20868,FremontBridge,02/19/2015 12:00:00 PM,48,-122,0,29,29
20869,FremontBridge,02/19/2015 01:00:00 PM,48,-122,1,31,32
20870,FremontBridge,02/19/2015 02:00:00 PM,48,-122,7,39,46
20871,FremontBridge,02/19/2015 03:00:00 PM,48,-122,43,34,77
20872,FremontBridge,02/19/2015 04:00:00 PM,48,-122,96,70,166
20873,FremontBridge,02/19/2015 05:00:00 PM,48,-122,261,114,375
20874,FremontBridge,02/19/2015 06:00:00 PM,48,-122,205,101,306
20875,FremontBridge,02/19/2015 07:00:00 PM,48,-122,85,44,129
20876,FremontBridge,02/19/2015 08:00:00 PM,48,-122,41,22,63
20877,FremontBridge,02/19/2015 09:00:00 PM,48,-122,25,20,45
20878,FremontBridge,02/19/2015 10:00:00 PM,48,-122,20,15,35
20879,FremontBridge,02/19/2015 11:00:00 PM,48,-122,11,6,17
20880,FremontBridge,02/20/2015 12:00:00 AM,48,-122,6,8,14
20881,FremontBridge,02/20/2015 01:00:00 AM,48,-122,8,0,8
20882,FremontBridge,02/20/2015 02:00:00 AM,48,-122,1,0,1
20883,FremontBridge,02/20/2015 03:00:00 AM,48,-122,0,0,0
20884,FremontBridge,02/20/2015 04:00:00 AM,48,-122,2,3,5
20885,FremontBridge,02/20/2015 05:00:00 AM,48,-122,5,14,19
20886,FremontBridge,02/20/2015 06:00:00 AM,48,-122,24,57,81
20887,FremontBridge,02/20/2015 07:00:00 AM,48,-122,99,29,128
20888,FremontBridge,02/20/2015 08:00:00 AM,48,-122,198,1,199
20889,FremontBridge,02/20/2015 09:00:00 AM,48,-122,141,0,141
20890,FremontBridge,02/20/2015 10:00:00 AM,48,-122,70,0,70
20891,FremontBridge,02/20/2015 11:00:00 AM,48,-122,39,0,39
20892,FremontBridge,02/20/2015 12:00:00 PM,48,-122,45,2,47
20893,FremontBridge,02/20/2015 01:00:00 PM,48,-122,60,0,60
20894,FremontBridge,02/20/2015 02:00:00 PM,48,-122,41,29,70
20895,FremontBridge,02/20/2015 03:00:00 PM,48,-122,55,56,111
20896,FremontBridge,02/20/2015 04:00:00 PM,48,-122,113,70,183
20897,FremontBridge,02/20/2015 05:00:00 PM,48,-122,266,109,375
20898,FremontBridge,02/20/2015 06:00:00 PM,48,-122,165,76,241
20899,FremontBridge,02/20/2015 07:00:00 PM,48,-122,62,40,102
20900,FremontBridge,02/20/2015 08:00:00 PM,48,-122,26,17,43
20901,FremontBridge,02/20/2015 09:00:00 PM,48,-122,17,7,24
20902,FremontBridge,02/20/2015 10:00:00 PM,48,-122,19,9,28
20903,FremontBridge,02/20/2015 11:00:00 PM,48,-122,16,12,28
20904,FremontBridge,02/21/2015 12:00:00 AM,48,-122,13,7,20
20905,FremontBridge,02/21/2015 01:00:00 AM,48,-122,7,3,10
20906,FremontBridge,02/21/2015 02:00:00 AM,48,-122,0,6,6
20907,FremontBridge,02/21/2015 03:00:00 AM,48,-122,2,1,3
20908,FremontBridge,02/21/2015 04:00:00 AM,48,-122,0,2,2
20909,FremontBridge,02/21/2015 05:00:00 AM,48,-122,2,2,4
20910,FremontBridge,02/21/2015 06:00:00 AM,48,-122,12,10,22
20911,FremontBridge,02/21/2015 07:00:00 AM,48,-122,16,5,21
20912,FremontBridge,02/21/2015 08:00:00 AM,48,-122,23,43,66
20913,FremontBridge,02/21/2015 09:00:00 AM,48,-122,27,43,70
20914,FremontBridge,02/21/2015 10:00:00 AM,48,-122,39,69,108
20915,FremontBridge,02/21/2015 11:00:00 AM,48,-122,57,76,133
20916,FremontBridge,02/21/2015 12:00:00 PM,48,-122,52,100,152
20917,FremontBridge,02/21/2015 01:00:00 PM,48,-122,64,104,168
20918,FremontBridge,02/21/2015 02:00:00 PM,48,-122,73,103,176
20919,FremontBridge,02/21/2015 03:00:00 PM,48,-122,111,86,197
20920,FremontBridge,02/21/2015 04:00:00 PM,48,-122,91,69,160
20921,FremontBridge,02/21/2015 05:00:00 PM,48,-122,50,71,121
20922,FremontBridge,02/21/2015 06:00:00 PM,48,-122,45,41,86
20923,FremontBridge,02/21/2015 07:00:00 PM,48,-122,25,19,44
20924,FremontBridge,02/21/2015 08:00:00 PM,48,-122,16,20,36
20925,FremontBridge,02/21/2015 09:00:00 PM,48,-122,11,8,19
20926,FremontBridge,02/21/2015 10:00:00 PM,48,-122,10,4,14
20927,FremontBridge,02/21/2015 11:00:00 PM,48,-122,7,6,13
20928,FremontBridge,02/22/2015 12:00:00 AM,48,-122,9,6,15
20929,FremontBridge,02/22/2015 01:00:00 AM,48,-122,0,3,3
20930,FremontBridge,02/22/2015 02:00:00 AM,48,-122,2,4,6
20931,FremontBridge,02/22/2015 03:00:00 AM,48,-122,0,0,0
20932,FremontBridge,02/22/2015 04:00:00 AM,48,-122,1,3,4
20933,FremontBridge,02/22/2015 05:00:00 AM,48,-122,1,1,2
20934,FremontBridge,02/22/2015 06:00:00 AM,48,-122,9,16,25
20935,FremontBridge,02/22/2015 07:00:00 AM,48,-122,14,69,83
20936,FremontBridge,02/22/2015 08:00:00 AM,48,-122,24,71,95
20937,FremontBridge,02/22/2015 09:00:00 AM,48,-122,41,56,97
20938,FremontBridge,02/22/2015 10:00:00 AM,48,-122,54,47,101
20939,FremontBridge,02/22/2015 11:00:00 AM,48,-122,67,93,160
20940,FremontBridge,02/22/2015 12:00:00 PM,48,-122,74,121,195
20941,FremontBridge,02/22/2015 01:00:00 PM,48,-122,78,89,167
20942,FremontBridge,02/22/2015 02:00:00 PM,48,-122,106,106,212
20943,FremontBridge,02/22/2015 03:00:00 PM,48,-122,108,89,197
20944,FremontBridge,02/22/2015 04:00:00 PM,48,-122,86,66,152
20945,FremontBridge,02/22/2015 05:00:00 PM,48,-122,66,68,134
20946,FremontBridge,02/22/2015 06:00:00 PM,48,-122,48,45,93
20947,FremontBridge,02/22/2015 07:00:00 PM,48,-122,20,9,29
20948,FremontBridge,02/22/2015 08:00:00 PM,48,-122,12,7,19
20949,FremontBridge,02/22/2015 09:00:00 PM,48,-122,9,5,14
20950,FremontBridge,02/22/2015 10:00:00 PM,48,-122,6,4,10
20951,FremontBridge,02/22/2015 11:00:00 PM,48,-122,5,2,7
20952,FremontBridge,02/23/2015 12:00:00 AM,48,-122,1,2,3
20953,FremontBridge,02/23/2015 01:00:00 AM,48,-122,2,1,3
20954,FremontBridge,02/23/2015 02:00:00 AM,48,-122,1,1,2
20955,FremontBridge,02/23/2015 03:00:00 AM,48,-122,2,1,3
20956,FremontBridge,02/23/2015 04:00:00 AM,48,-122,2,5,7
20957,FremontBridge,02/23/2015 05:00:00 AM,48,-122,7,25,32
20958,FremontBridge,02/23/2015 06:00:00 AM,48,-122,33,65,98
20959,FremontBridge,02/23/2015 07:00:00 AM,48,-122,6,220,226
20960,FremontBridge,02/23/2015 08:00:00 AM,48,-122,1,347,348
20961,FremontBridge,02/23/2015 09:00:00 AM,48,-122,0,194,194
20962,FremontBridge,02/23/2015 10:00:00 AM,48,-122,0,80,80
20963,FremontBridge,02/23/2015 11:00:00 AM,48,-122,0,72,72
20964,FremontBridge,02/23/2015 12:00:00 PM,48,-122,0,55,55
20965,FremontBridge,02/23/2015 01:00:00 PM,48,-122,0,66,66
20966,FremontBridge,02/23/2015 02:00:00 PM,48,-122,0,79,79
20967,FremontBridge,02/23/2015 03:00:00 PM,48,-122,69,66,135
20968,FremontBridge,02/23/2015 04:00:00 PM,48,-122,155,107,262
20969,FremontBridge,02/23/2015 05:00:00 PM,48,-122,350,162,512
20970,FremontBridge,02/23/2015 06:00:00 PM,48,-122,255,107,362
20971,FremontBridge,02/23/2015 07:00:00 PM,48,-122,114,59,173
20972,FremontBridge,02/23/2015 08:00:00 PM,48,-122,59,24,83
20973,FremontBridge,02/23/2015 09:00:00 PM,48,-122,21,20,41
20974,FremontBridge,02/23/2015 10:00:00 PM,48,-122,16,10,26
20975,FremontBridge,02/23/2015 11:00:00 PM,48,-122,12,7,19
20976,FremontBridge,02/24/2015 12:00:00 AM,48,-122,6,2,8
20977,FremontBridge,02/24/2015 01:00:00 AM,48,-122,2,3,5
20978,FremontBridge,02/24/2015 02:00:00 AM,48,-122,3,3,6
20979,FremontBridge,02/24/2015 03:00:00 AM,48,-122,3,0,3
20980,FremontBridge,02/24/2015 04:00:00 AM,48,-122,2,2,4
20981,FremontBridge,02/24/2015 05:00:00 AM,48,-122,12,23,35
20982,FremontBridge,02/24/2015 06:00:00 AM,48,-122,32,73,105
20983,FremontBridge,02/24/2015 07:00:00 AM,48,-122,9,236,245
20984,FremontBridge,02/24/2015 08:00:00 AM,48,-122,0,418,418
20985,FremontBridge,02/24/2015 09:00:00 AM,48,-122,0,188,188
20986,FremontBridge,02/24/2015 10:00:00 AM,48,-122,0,75,75
20987,FremontBridge,02/24/2015 11:00:00 AM,48,-122,5,69,74
20988,FremontBridge,02/24/2015 12:00:00 PM,48,-122,79,0,79
20989,FremontBridge,02/24/2015 01:00:00 PM,48,-122,90,0,90
20990,FremontBridge,02/24/2015 02:00:00 PM,48,-122,88,17,105
20991,FremontBridge,02/24/2015 03:00:00 PM,48,-122,77,54,131
20992,FremontBridge,02/24/2015 04:00:00 PM,48,-122,153,108,261
20993,FremontBridge,02/24/2015 05:00:00 PM,48,-122,376,162,538
20994,FremontBridge,02/24/2015 06:00:00 PM,48,-122,235,126,361
20995,FremontBridge,02/24/2015 07:00:00 PM,48,-122,101,52,153
20996,FremontBridge,02/24/2015 08:00:00 PM,48,-122,36,37,73
20997,FremontBridge,02/24/2015 09:00:00 PM,48,-122,30,24,54
20998,FremontBridge,02/24/2015 10:00:00 PM,48,-122,19,14,33
20999,FremontBridge,02/24/2015 11:00:00 PM,48,-122,15,7,22
21000,FremontBridge,02/25/2015 12:00:00 AM,48,-122,9,2,11
21001,FremontBridge,02/25/2015 01:00:00 AM,48,-122,1,3,4
21002,FremontBridge,02/25/2015 02:00:00 AM,48,-122,2,2,4
21003,FremontBridge,02/25/2015 03:00:00 AM,48,-122,0,0,0
21004,FremontBridge,02/25/2015 04:00:00 AM,48,-122,1,6,7
21005,FremontBridge,02/25/2015 05:00:00 AM,48,-122,10,24,34
21006,FremontBridge,02/25/2015 06:00:00 AM,48,-122,40,68,108
21007,FremontBridge,02/25/2015 07:00:00 AM,48,-122,10,180,190
21008,FremontBridge,02/25/2015 08:00:00 AM,48,-122,0,349,349
21009,FremontBridge,02/25/2015 09:00:00 AM,48,-122,0,193,193
21010,FremontBridge,02/25/2015 10:00:00 AM,48,-122,1,64,65
21011,FremontBridge,02/25/2015 11:00:00 AM,48,-122,1,47,48
21012,FremontBridge,02/25/2015 12:00:00 PM,48,-122,0,43,43
21013,FremontBridge,02/25/2015 01:00:00 PM,48,-122,3,37,40
21014,FremontBridge,02/25/2015 02:00:00 PM,48,-122,0,47,47
21015,FremontBridge,02/25/2015 03:00:00 PM,48,-122,23,73,96
21016,FremontBridge,02/25/2015 04:00:00 PM,48,-122,107,60,167
21017,FremontBridge,02/25/2015 05:00:00 PM,48,-122,268,124,392
21018,FremontBridge,02/25/2015 06:00:00 PM,48,-122,215,101,316
21019,FremontBridge,02/25/2015 07:00:00 PM,48,-122,76,43,119
21020,FremontBridge,02/25/2015 08:00:00 PM,48,-122,44,26,70
21021,FremontBridge,02/25/2015 09:00:00 PM,48,-122,29,23,52
21022,FremontBridge,02/25/2015 10:00:00 PM,48,-122,15,8,23
21023,FremontBridge,02/25/2015 11:00:00 PM,48,-122,14,4,18
21024,FremontBridge,02/26/2015 12:00:00 AM,48,-122,2,5,7
21025,FremontBridge,02/26/2015 01:00:00 AM,48,-122,1,2,3
21026,FremontBridge,02/26/2015 02:00:00 AM,48,-122,1,0,1
21027,FremontBridge,02/26/2015 03:00:00 AM,48,-122,2,1,3
21028,FremontBridge,02/26/2015 04:00:00 AM,48,-122,2,5,7
21029,FremontBridge,02/26/2015 05:00:00 AM,48,-122,9,12,21
21030,FremontBridge,02/26/2015 06:00:00 AM,48,-122,23,60,83
21031,FremontBridge,02/26/2015 07:00:00 AM,48,-122,13,185,198
21032,FremontBridge,02/26/2015 08:00:00 AM,48,-122,0,285,285
21033,FremontBridge,02/26/2015 09:00:00 AM,48,-122,0,171,171
21034,FremontBridge,02/26/2015 10:00:00 AM,48,-122,0,69,69
21035,FremontBridge,02/26/2015 11:00:00 AM,48,-122,0,42,42
21036,FremontBridge,02/26/2015 12:00:00 PM,48,-122,0,50,50
21037,FremontBridge,02/26/2015 01:00:00 PM,48,-122,0,48,48
21038,FremontBridge,02/26/2015 02:00:00 PM,48,-122,8,50,58
21039,FremontBridge,02/26/2015 03:00:00 PM,48,-122,39,37,76
21040,FremontBridge,02/26/2015 04:00:00 PM,48,-122,109,63,172
21041,FremontBridge,02/26/2015 05:00:00 PM,48,-122,238,121,359
21042,FremontBridge,02/26/2015 06:00:00 PM,48,-122,212,102,314
21043,FremontBridge,02/26/2015 07:00:00 PM,48,-122,98,37,135
21044,FremontBridge,02/26/2015 08:00:00 PM,48,-122,40,24,64
21045,FremontBridge,02/26/2015 09:00:00 PM,48,-122,25,21,46
21046,FremontBridge,02/26/2015 10:00:00 PM,48,-122,21,8,29
21047,FremontBridge,02/26/2015 11:00:00 PM,48,-122,11,4,15
21048,FremontBridge,02/27/2015 12:00:00 AM,48,-122,4,1,5
21049,FremontBridge,02/27/2015 01:00:00 AM,48,-122,1,1,2
21050,FremontBridge,02/27/2015 02:00:00 AM,48,-122,0,2,2
21051,FremontBridge,02/27/2015 03:00:00 AM,48,-122,1,0,1
21052,FremontBridge,02/27/2015 04:00:00 AM,48,-122,1,2,3
21053,FremontBridge,02/27/2015 05:00:00 AM,48,-122,11,12,23
21054,FremontBridge,02/27/2015 06:00:00 AM,48,-122,19,64,83
21055,FremontBridge,02/27/2015 07:00:00 AM,48,-122,84,19,103
21056,FremontBridge,02/27/2015 08:00:00 AM,48,-122,165,2,167
21057,FremontBridge,02/27/2015 09:00:00 AM,48,-122,113,3,116
21058,FremontBridge,02/27/2015 10:00:00 AM,48,-122,65,0,65
21059,FremontBridge,02/27/2015 11:00:00 AM,48,-122,28,0,28
21060,FremontBridge,02/27/2015 12:00:00 PM,48,-122,36,0,36
21061,FremontBridge,02/27/2015 01:00:00 PM,48,-122,32,0,32
21062,FremontBridge,02/27/2015 02:00:00 PM,48,-122,40,25,65
21063,FremontBridge,02/27/2015 03:00:00 PM,48,-122,46,30,76
21064,FremontBridge,02/27/2015 04:00:00 PM,48,-122,96,70,166
21065,FremontBridge,02/27/2015 05:00:00 PM,48,-122,196,104,300
21066,FremontBridge,02/27/2015 06:00:00 PM,48,-122,151,82,233
21067,FremontBridge,02/27/2015 07:00:00 PM,48,-122,64,35,99
21068,FremontBridge,02/27/2015 08:00:00 PM,48,-122,28,11,39
21069,FremontBridge,02/27/2015 09:00:00 PM,48,-122,17,33,50
21070,FremontBridge,02/27/2015 10:00:00 PM,48,-122,11,14,25
21071,FremontBridge,02/27/2015 11:00:00 PM,48,-122,10,9,19
21072,FremontBridge,02/28/2015 12:00:00 AM,48,-122,10,13,23
21073,FremontBridge,02/28/2015 01:00:00 AM,48,-122,7,5,12
21074,FremontBridge,02/28/2015 02:00:00 AM,48,-122,1,2,3
21075,FremontBridge,02/28/2015 03:00:00 AM,48,-122,1,2,3
21076,FremontBridge,02/28/2015 04:00:00 AM,48,-122,1,0,1
21077,FremontBridge,02/28/2015 05:00:00 AM,48,-122,2,2,4
21078,FremontBridge,02/28/2015 06:00:00 AM,48,-122,12,8,20
21079,FremontBridge,02/28/2015 07:00:00 AM,48,-122,19,18,37
21080,FremontBridge,02/28/2015 08:00:00 AM,48,-122,35,39,74
21081,FremontBridge,02/28/2015 09:00:00 AM,48,-122,50,61,111
21082,FremontBridge,02/28/2015 10:00:00 AM,48,-122,61,74,135
21083,FremontBridge,02/28/2015 11:00:00 AM,48,-122,58,109,167
21084,FremontBridge,02/28/2015 12:00:00 PM,48,-122,90,92,182
21085,FremontBridge,02/28/2015 01:00:00 PM,48,-122,102,113,215
21086,FremontBridge,02/28/2015 02:00:00 PM,48,-122,101,134,235
21087,FremontBridge,02/28/2015 03:00:00 PM,48,-122,102,113,215
21088,FremontBridge,02/28/2015 04:00:00 PM,48,-122,80,107,187
21089,FremontBridge,02/28/2015 05:00:00 PM,48,-122,69,67,136
21090,FremontBridge,02/28/2015 06:00:00 PM,48,-122,49,47,96
21091,FremontBridge,02/28/2015 07:00:00 PM,48,-122,27,23,50
21092,FremontBridge,02/28/2015 08:00:00 PM,48,-122,21,23,44
21093,FremontBridge,02/28/2015 09:00:00 PM,48,-122,5,14,19
21094,FremontBridge,02/28/2015 10:00:00 PM,48,-122,9,15,24
21095,FremontBridge,02/28/2015 11:00:00 PM,48,-122,17,8,25
21096,FremontBridge,03/01/2015 12:00:00 AM,48,-122,16,21,37
21097,FremontBridge,03/01/2015 01:00:00 AM,48,-122,2,2,4
21098,FremontBridge,03/01/2015 02:00:00 AM,48,-122,4,5,9
21099,FremontBridge,03/01/2015 03:00:00 AM,48,-122,0,2,2
21100,FremontBridge,03/01/2015 04:00:00 AM,48,-122,1,0,1
21101,FremontBridge,03/01/2015 05:00:00 AM,48,-122,1,0,1
21102,FremontBridge,03/01/2015 06:00:00 AM,48,-122,8,4,12
21103,FremontBridge,03/01/2015 07:00:00 AM,48,-122,6,7,13
21104,FremontBridge,03/01/2015 08:00:00 AM,48,-122,21,41,62
21105,FremontBridge,03/01/2015 09:00:00 AM,48,-122,45,88,133
21106,FremontBridge,03/01/2015 10:00:00 AM,48,-122,49,115,164
21107,FremontBridge,03/01/2015 11:00:00 AM,48,-122,83,105,188
21108,FremontBridge,03/01/2015 12:00:00 PM,48,-122,86,103,189
21109,FremontBridge,03/01/2015 01:00:00 PM,48,-122,105,100,205
21110,FremontBridge,03/01/2015 02:00:00 PM,48,-122,71,91,162
21111,FremontBridge,03/01/2015 03:00:00 PM,48,-122,76,96,172
21112,FremontBridge,03/01/2015 04:00:00 PM,48,-122,79,72,151
21113,FremontBridge,03/01/2015 05:00:00 PM,48,-122,43,71,114
21114,FremontBridge,03/01/2015 06:00:00 PM,48,-122,20,36,56
21115,FremontBridge,03/01/2015 07:00:00 PM,48,-122,13,23,36
21116,FremontBridge,03/01/2015 08:00:00 PM,48,-122,14,5,19
21117,FremontBridge,03/01/2015 09:00:00 PM,48,-122,10,7,17
21118,FremontBridge,03/01/2015 10:00:00 PM,48,-122,11,4,15
21119,FremontBridge,03/01/2015 11:00:00 PM,48,-122,5,5,10
21120,FremontBridge,03/02/2015 12:00:00 AM,48,-122,3,4,7
21121,FremontBridge,03/02/2015 01:00:00 AM,48,-122,3,1,4
21122,FremontBridge,03/02/2015 02:00:00 AM,48,-122,0,3,3
21123,FremontBridge,03/02/2015 03:00:00 AM,48,-122,2,2,4
21124,FremontBridge,03/02/2015 04:00:00 AM,48,-122,2,2,4
21125,FremontBridge,03/02/2015 05:00:00 AM,48,-122,13,26,39
21126,FremontBridge,03/02/2015 06:00:00 AM,48,-122,46,75,121
21127,FremontBridge,03/02/2015 07:00:00 AM,48,-122,109,31,140
21128,FremontBridge,03/02/2015 08:00:00 AM,48,-122,231,2,233
21129,FremontBridge,03/02/2015 09:00:00 AM,48,-122,151,1,152
21130,FremontBridge,03/02/2015 10:00:00 AM,48,-122,91,0,91
21131,FremontBridge,03/02/2015 11:00:00 AM,48,-122,56,0,56
21132,FremontBridge,03/02/2015 12:00:00 PM,48,-122,42,1,43
21133,FremontBridge,03/02/2015 01:00:00 PM,48,-122,58,0,58
21134,FremontBridge,03/02/2015 02:00:00 PM,48,-122,60,8,68
21135,FremontBridge,03/02/2015 03:00:00 PM,48,-122,59,60,119
21136,FremontBridge,03/02/2015 04:00:00 PM,48,-122,147,88,235
21137,FremontBridge,03/02/2015 05:00:00 PM,48,-122,339,159,498
21138,FremontBridge,03/02/2015 06:00:00 PM,48,-122,272,114,386
21139,FremontBridge,03/02/2015 07:00:00 PM,48,-122,100,55,155
21140,FremontBridge,03/02/2015 08:00:00 PM,48,-122,49,23,72
21141,FremontBridge,03/02/2015 09:00:00 PM,48,-122,27,15,42
21142,FremontBridge,03/02/2015 10:00:00 PM,48,-122,15,8,23
21143,FremontBridge,03/02/2015 11:00:00 PM,48,-122,11,10,21
21144,FremontBridge,03/03/2015 12:00:00 AM,48,-122,1,11,12
21145,FremontBridge,03/03/2015 01:00:00 AM,48,-122,0,7,7
21146,FremontBridge,03/03/2015 02:00:00 AM,48,-122,2,4,6
21147,FremontBridge,03/03/2015 03:00:00 AM,48,-122,2,0,2
21148,FremontBridge,03/03/2015 04:00:00 AM,48,-122,1,3,4
21149,FremontBridge,03/03/2015 05:00:00 AM,48,-122,11,30,41
21150,FremontBridge,03/03/2015 06:00:00 AM,48,-122,31,68,99
21151,FremontBridge,03/03/2015 07:00:00 AM,48,-122,14,224,238
21152,FremontBridge,03/03/2015 08:00:00 AM,48,-122,0,372,372
21153,FremontBridge,03/03/2015 09:00:00 AM,48,-122,0,196,196
21154,FremontBridge,03/03/2015 10:00:00 AM,48,-122,0,86,86
21155,FremontBridge,03/03/2015 11:00:00 AM,48,-122,0,66,66
21156,FremontBridge,03/03/2015 12:00:00 PM,48,-122,0,61,61
21157,FremontBridge,03/03/2015 01:00:00 PM,48,-122,0,72,72
21158,FremontBridge,03/03/2015 02:00:00 PM,48,-122,34,65,99
21159,FremontBridge,03/03/2015 03:00:00 PM,48,-122,57,65,122
21160,FremontBridge,03/03/2015 04:00:00 PM,48,-122,140,100,240
21161,FremontBridge,03/03/2015 05:00:00 PM,48,-122,372,147,519
21162,FremontBridge,03/03/2015 06:00:00 PM,48,-122,250,130,380
21163,FremontBridge,03/03/2015 07:00:00 PM,48,-122,89,75,164
21164,FremontBridge,03/03/2015 08:00:00 PM,48,-122,42,26,68
21165,FremontBridge,03/03/2015 09:00:00 PM,48,-122,26,20,46
21166,FremontBridge,03/03/2015 10:00:00 PM,48,-122,16,11,27
21167,FremontBridge,03/03/2015 11:00:00 PM,48,-122,13,5,18
21168,FremontBridge,03/04/2015 12:00:00 AM,48,-122,5,7,12
21169,FremontBridge,03/04/2015 01:00:00 AM,48,-122,2,1,3
21170,FremontBridge,03/04/2015 02:00:00 AM,48,-122,3,2,5
21171,FremontBridge,03/04/2015 03:00:00 AM,48,-122,3,1,4
21172,FremontBridge,03/04/2015 04:00:00 AM,48,-122,0,3,3
21173,FremontBridge,03/04/2015 05:00:00 AM,48,-122,11,23,34
21174,FremontBridge,03/04/2015 06:00:00 AM,48,-122,34,65,99
21175,FremontBridge,03/04/2015 07:00:00 AM,48,-122,6,188,194
21176,FremontBridge,03/04/2015 08:00:00 AM,48,-122,0,335,335
21177,FremontBridge,03/04/2015 09:00:00 AM,48,-122,13,188,201
21178,FremontBridge,03/04/2015 10:00:00 AM,48,-122,73,4,77
21179,FremontBridge,03/04/2015 11:00:00 AM,48,-122,59,2,61
21180,FremontBridge,03/04/2015 12:00:00 PM,48,-122,53,1,54
21181,FremontBridge,03/04/2015 01:00:00 PM,48,-122,58,1,59
21182,FremontBridge,03/04/2015 02:00:00 PM,48,-122,79,35,114
21183,FremontBridge,03/04/2015 03:00:00 PM,48,-122,81,42,123
21184,FremontBridge,03/04/2015 04:00:00 PM,48,-122,143,96,239
21185,FremontBridge,03/04/2015 05:00:00 PM,48,-122,314,165,479
21186,FremontBridge,03/04/2015 06:00:00 PM,48,-122,263,133,396
21187,FremontBridge,03/04/2015 07:00:00 PM,48,-122,93,51,144
21188,FremontBridge,03/04/2015 08:00:00 PM,48,-122,56,28,84
21189,FremontBridge,03/04/2015 09:00:00 PM,48,-122,21,33,54
21190,FremontBridge,03/04/2015 10:00:00 PM,48,-122,16,19,35
21191,FremontBridge,03/04/2015 11:00:00 PM,48,-122,12,8,20
21192,FremontBridge,03/05/2015 12:00:00 AM,48,-122,5,2,7
21193,FremontBridge,03/05/2015 01:00:00 AM,48,-122,1,3,4
21194,FremontBridge,03/05/2015 02:00:00 AM,48,-122,2,1,3
21195,FremontBridge,03/05/2015 03:00:00 AM,48,-122,1,3,4
21196,FremontBridge,03/05/2015 04:00:00 AM,48,-122,1,4,5
21197,FremontBridge,03/05/2015 05:00:00 AM,48,-122,12,20,32
21198,FremontBridge,03/05/2015 06:00:00 AM,48,-122,28,60,88
21199,FremontBridge,03/05/2015 07:00:00 AM,48,-122,15,184,199
21200,FremontBridge,03/05/2015 08:00:00 AM,48,-122,0,317,317
21201,FremontBridge,03/05/2015 09:00:00 AM,48,-122,0,170,170
21202,FremontBridge,03/05/2015 10:00:00 AM,48,-122,0,85,85
21203,FremontBridge,03/05/2015 11:00:00 AM,48,-122,0,61,61
21204,FremontBridge,03/05/2015 12:00:00 PM,48,-122,2,67,69
21205,FremontBridge,03/05/2015 01:00:00 PM,48,-122,0,74,74
21206,FremontBridge,03/05/2015 02:00:00 PM,48,-122,37,43,80
21207,FremontBridge,03/05/2015 03:00:00 PM,48,-122,65,58,123
21208,FremontBridge,03/05/2015 04:00:00 PM,48,-122,150,111,261
21209,FremontBridge,03/05/2015 05:00:00 PM,48,-122,327,151,478
21210,FremontBridge,03/05/2015 06:00:00 PM,48,-122,213,113,326
21211,FremontBridge,03/05/2015 07:00:00 PM,48,-122,77,56,133
21212,FremontBridge,03/05/2015 08:00:00 PM,48,-122,43,36,79
21213,FremontBridge,03/05/2015 09:00:00 PM,48,-122,58,28,86
21214,FremontBridge,03/05/2015 10:00:00 PM,48,-122,25,19,44
21215,FremontBridge,03/05/2015 11:00:00 PM,48,-122,15,6,21
21216,FremontBridge,03/06/2015 12:00:00 AM,48,-122,8,10,18
21217,FremontBridge,03/06/2015 01:00:00 AM,48,-122,1,3,4
21218,FremontBridge,03/06/2015 02:00:00 AM,48,-122,1,4,5
21219,FremontBridge,03/06/2015 03:00:00 AM,48,-122,4,3,7
21220,FremontBridge,03/06/2015 04:00:00 AM,48,-122,4,1,5
21221,FremontBridge,03/06/2015 05:00:00 AM,48,-122,4,18,22
21222,FremontBridge,03/06/2015 06:00:00 AM,48,-122,40,66,106
21223,FremontBridge,03/06/2015 07:00:00 AM,48,-122,7,151,158
21224,FremontBridge,03/06/2015 08:00:00 AM,48,-122,0,305,305
21225,FremontBridge,03/06/2015 09:00:00 AM,48,-122,0,170,170
21226,FremontBridge,03/06/2015 10:00:00 AM,48,-122,0,80,80
21227,FremontBridge,03/06/2015 11:00:00 AM,48,-122,0,63,63
21228,FremontBridge,03/06/2015 12:00:00 PM,48,-122,0,72,72
21229,FremontBridge,03/06/2015 01:00:00 PM,48,-122,0,165,165
21230,FremontBridge,03/06/2015 02:00:00 PM,48,-122,19,76,95
21231,FremontBridge,03/06/2015 03:00:00 PM,48,-122,97,79,176
21232,FremontBridge,03/06/2015 04:00:00 PM,48,-122,157,115,272
21233,FremontBridge,03/06/2015 05:00:00 PM,48,-122,327,155,482
21234,FremontBridge,03/06/2015 06:00:00 PM,48,-122,198,106,304
21235,FremontBridge,03/06/2015 07:00:00 PM,48,-122,76,43,119
21236,FremontBridge,03/06/2015 08:00:00 PM,48,-122,44,34,78
21237,FremontBridge,03/06/2015 09:00:00 PM,48,-122,19,18,37
21238,FremontBridge,03/06/2015 10:00:00 PM,48,-122,16,15,31
21239,FremontBridge,03/06/2015 11:00:00 PM,48,-122,14,14,28
21240,FremontBridge,03/07/2015 12:00:00 AM,48,-122,16,5,21
21241,FremontBridge,03/07/2015 01:00:00 AM,48,-122,6,0,6
21242,FremontBridge,03/07/2015 02:00:00 AM,48,-122,3,8,11
21243,FremontBridge,03/07/2015 03:00:00 AM,48,-122,0,0,0
21244,FremontBridge,03/07/2015 04:00:00 AM,48,-122,2,1,3
21245,FremontBridge,03/07/2015 05:00:00 AM,48,-122,4,3,7
21246,FremontBridge,03/07/2015 06:00:00 AM,48,-122,15,8,23
21247,FremontBridge,03/07/2015 07:00:00 AM,48,-122,18,17,35
21248,FremontBridge,03/07/2015 08:00:00 AM,48,-122,49,46,95
21249,FremontBridge,03/07/2015 09:00:00 AM,48,-122,54,58,112
21250,FremontBridge,03/07/2015 10:00:00 AM,48,-122,71,101,172
21251,FremontBridge,03/07/2015 11:00:00 AM,48,-122,49,108,157
21252,FremontBridge,03/07/2015 12:00:00 PM,48,-122,76,93,169
21253,FremontBridge,03/07/2015 01:00:00 PM,48,-122,154,123,277
21254,FremontBridge,03/07/2015 02:00:00 PM,48,-122,124,112,236
21255,FremontBridge,03/07/2015 03:00:00 PM,48,-122,117,135,252
21256,FremontBridge,03/07/2015 04:00:00 PM,48,-122,106,136,242
21257,FremontBridge,03/07/2015 05:00:00 PM,48,-122,59,109,168
21258,FremontBridge,03/07/2015 06:00:00 PM,48,-122,54,69,123
21259,FremontBridge,03/07/2015 07:00:00 PM,48,-122,29,30,59
21260,FremontBridge,03/07/2015 08:00:00 PM,48,-122,21,23,44
21261,FremontBridge,03/07/2015 09:00:00 PM,48,-122,14,12,26
21262,FremontBridge,03/07/2015 10:00:00 PM,48,-122,8,16,24
21263,FremontBridge,03/07/2015 11:00:00 PM,48,-122,9,10,19
21264,FremontBridge,03/08/2015 12:00:00 AM,48,-122,15,7,22
21265,FremontBridge,03/08/2015 01:00:00 AM,48,-122,1,2,3
21266,FremontBridge,03/08/2015 02:00:00 AM,48,-122,,,
21267,FremontBridge,03/08/2015 03:00:00 AM,48,-122,2,5,7
21268,FremontBridge,03/08/2015 04:00:00 AM,48,-122,2,1,3
21269,FremontBridge,03/08/2015 05:00:00 AM,48,-122,1,4,5
21270,FremontBridge,03/08/2015 06:00:00 AM,48,-122,9,4,13
21271,FremontBridge,03/08/2015 07:00:00 AM,48,-122,10,11,21
21272,FremontBridge,03/08/2015 08:00:00 AM,48,-122,14,21,35
21273,FremontBridge,03/08/2015 09:00:00 AM,48,-122,33,14,47
21274,FremontBridge,03/08/2015 10:00:00 AM,48,-122,54,61,115
21275,FremontBridge,03/08/2015 11:00:00 AM,48,-122,68,87,155
21276,FremontBridge,03/08/2015 12:00:00 PM,48,-122,83,87,170
21277,FremontBridge,03/08/2015 01:00:00 PM,48,-122,64,114,178
21278,FremontBridge,03/08/2015 02:00:00 PM,48,-122,145,148,293
21279,FremontBridge,03/08/2015 03:00:00 PM,48,-122,132,136,268
21280,FremontBridge,03/08/2015 04:00:00 PM,48,-122,106,149,255
21281,FremontBridge,03/08/2015 05:00:00 PM,48,-122,76,149,225
21282,FremontBridge,03/08/2015 06:00:00 PM,48,-122,60,62,122
21283,FremontBridge,03/08/2015 07:00:00 PM,48,-122,25,18,43
21284,FremontBridge,03/08/2015 08:00:00 PM,48,-122,19,20,39
21285,FremontBridge,03/08/2015 09:00:00 PM,48,-122,35,18,53
21286,FremontBridge,03/08/2015 10:00:00 PM,48,-122,9,12,21
21287,FremontBridge,03/08/2015 11:00:00 PM,48,-122,6,7,13
21288,FremontBridge,03/09/2015 12:00:00 AM,48,-122,3,2,5
21289,FremontBridge,03/09/2015 01:00:00 AM,48,-122,3,2,5
21290,FremontBridge,03/09/2015 02:00:00 AM,48,-122,1,2,3
21291,FremontBridge,03/09/2015 03:00:00 AM,48,-122,2,3,5
21292,FremontBridge,03/09/2015 04:00:00 AM,48,-122,1,3,4
21293,FremontBridge,03/09/2015 05:00:00 AM,48,-122,10,25,35
21294,FremontBridge,03/09/2015 06:00:00 AM,48,-122,40,69,109
21295,FremontBridge,03/09/2015 07:00:00 AM,48,-122,113,23,136
21296,FremontBridge,03/09/2015 08:00:00 AM,48,-122,233,1,234
21297,FremontBridge,03/09/2015 09:00:00 AM,48,-122,172,2,174
21298,FremontBridge,03/09/2015 10:00:00 AM,48,-122,81,1,82
21299,FremontBridge,03/09/2015 11:00:00 AM,48,-122,65,0,65
21300,FremontBridge,03/09/2015 12:00:00 PM,48,-122,61,0,61
21301,FremontBridge,03/09/2015 01:00:00 PM,48,-122,87,0,87
21302,FremontBridge,03/09/2015 02:00:00 PM,48,-122,55,26,81
21303,FremontBridge,03/09/2015 03:00:00 PM,48,-122,73,64,137
21304,FremontBridge,03/09/2015 04:00:00 PM,48,-122,151,106,257
21305,FremontBridge,03/09/2015 05:00:00 PM,48,-122,328,170,498
21306,FremontBridge,03/09/2015 06:00:00 PM,48,-122,340,138,478
21307,FremontBridge,03/09/2015 07:00:00 PM,48,-122,99,84,183
21308,FremontBridge,03/09/2015 08:00:00 PM,48,-122,64,33,97
21309,FremontBridge,03/09/2015 09:00:00 PM,48,-122,34,20,54
21310,FremontBridge,03/09/2015 10:00:00 PM,48,-122,15,5,20
21311,FremontBridge,03/09/2015 11:00:00 PM,48,-122,16,7,23
21312,FremontBridge,03/10/2015 12:00:00 AM,48,-122,8,3,11
21313,FremontBridge,03/10/2015 01:00:00 AM,48,-122,2,1,3
21314,FremontBridge,03/10/2015 02:00:00 AM,48,-122,1,2,3
21315,FremontBridge,03/10/2015 03:00:00 AM,48,-122,3,0,3
21316,FremontBridge,03/10/2015 04:00:00 AM,48,-122,4,1,5
21317,FremontBridge,03/10/2015 05:00:00 AM,48,-122,12,24,36
21318,FremontBridge,03/10/2015 06:00:00 AM,48,-122,41,69,110
21319,FremontBridge,03/10/2015 07:00:00 AM,48,-122,115,29,144
21320,FremontBridge,03/10/2015 08:00:00 AM,48,-122,264,3,267
21321,FremontBridge,03/10/2015 09:00:00 AM,48,-122,174,0,174
21322,FremontBridge,03/10/2015 10:00:00 AM,48,-122,67,0,67
21323,FremontBridge,03/10/2015 11:00:00 AM,48,-122,56,0,56
21324,FremontBridge,03/10/2015 12:00:00 PM,48,-122,54,0,54
21325,FremontBridge,03/10/2015 01:00:00 PM,48,-122,62,0,62
21326,FremontBridge,03/10/2015 02:00:00 PM,48,-122,95,29,124
21327,FremontBridge,03/10/2015 03:00:00 PM,48,-122,64,46,110
21328,FremontBridge,03/10/2015 04:00:00 PM,48,-122,138,99,237
21329,FremontBridge,03/10/2015 05:00:00 PM,48,-122,362,161,523
21330,FremontBridge,03/10/2015 06:00:00 PM,48,-122,316,164,480
21331,FremontBridge,03/10/2015 07:00:00 PM,48,-122,126,69,195
21332,FremontBridge,03/10/2015 08:00:00 PM,48,-122,55,30,85
21333,FremontBridge,03/10/2015 09:00:00 PM,48,-122,32,18,50
21334,FremontBridge,03/10/2015 10:00:00 PM,48,-122,16,18,34
21335,FremontBridge,03/10/2015 11:00:00 PM,48,-122,18,4,22
21336,FremontBridge,03/11/2015 12:00:00 AM,48,-122,1,4,5
21337,FremontBridge,03/11/2015 01:00:00 AM,48,-122,2,2,4
21338,FremontBridge,03/11/2015 02:00:00 AM,48,-122,1,1,2
21339,FremontBridge,03/11/2015 03:00:00 AM,48,-122,2,2,4
21340,FremontBridge,03/11/2015 04:00:00 AM,48,-122,4,1,5
21341,FremontBridge,03/11/2015 05:00:00 AM,48,-122,9,26,35
21342,FremontBridge,03/11/2015 06:00:00 AM,48,-122,30,52,82
21343,FremontBridge,03/11/2015 07:00:00 AM,48,-122,108,35,143
21344,FremontBridge,03/11/2015 08:00:00 AM,48,-122,209,4,213
21345,FremontBridge,03/11/2015 09:00:00 AM,48,-122,130,1,131
21346,FremontBridge,03/11/2015 10:00:00 AM,48,-122,58,1,59
21347,FremontBridge,03/11/2015 11:00:00 AM,48,-122,45,0,45
21348,FremontBridge,03/11/2015 12:00:00 PM,48,-122,38,0,38
21349,FremontBridge,03/11/2015 01:00:00 PM,48,-122,38,0,38
21350,FremontBridge,03/11/2015 02:00:00 PM,48,-122,34,14,48
21351,FremontBridge,03/11/2015 03:00:00 PM,48,-122,41,42,83
21352,FremontBridge,03/11/2015 04:00:00 PM,48,-122,91,75,166
21353,FremontBridge,03/11/2015 05:00:00 PM,48,-122,270,109,379
21354,FremontBridge,03/11/2015 06:00:00 PM,48,-122,208,92,300
21355,FremontBridge,03/11/2015 07:00:00 PM,48,-122,85,49,134
21356,FremontBridge,03/11/2015 08:00:00 PM,48,-122,39,18,57
21357,FremontBridge,03/11/2015 09:00:00 PM,48,-122,21,22,43
21358,FremontBridge,03/11/2015 10:00:00 PM,48,-122,6,13,19
21359,FremontBridge,03/11/2015 11:00:00 PM,48,-122,9,8,17
21360,FremontBridge,03/12/2015 12:00:00 AM,48,-122,3,4,7
21361,FremontBridge,03/12/2015 01:00:00 AM,48,-122,2,3,5
21362,FremontBridge,03/12/2015 02:00:00 AM,48,-122,4,2,6
21363,FremontBridge,03/12/2015 03:00:00 AM,48,-122,2,0,2
21364,FremontBridge,03/12/2015 04:00:00 AM,48,-122,4,5,9
21365,FremontBridge,03/12/2015 05:00:00 AM,48,-122,8,20,28
21366,FremontBridge,03/12/2015 06:00:00 AM,48,-122,33,71,104
21367,FremontBridge,03/12/2015 07:00:00 AM,48,-122,10,133,143
21368,FremontBridge,03/12/2015 08:00:00 AM,48,-122,200,68,268
21369,FremontBridge,03/12/2015 09:00:00 AM,48,-122,170,1,171
21370,FremontBridge,03/12/2015 10:00:00 AM,48,-122,61,2,63
21371,FremontBridge,03/12/2015 11:00:00 AM,48,-122,62,1,63
21372,FremontBridge,03/12/2015 12:00:00 PM,48,-122,64,0,64
21373,FremontBridge,03/12/2015 01:00:00 PM,48,-122,63,0,63
21374,FremontBridge,03/12/2015 02:00:00 PM,48,-122,71,23,94
21375,FremontBridge,03/12/2015 03:00:00 PM,48,-122,72,72,144
21376,FremontBridge,03/12/2015 04:00:00 PM,48,-122,138,96,234
21377,FremontBridge,03/12/2015 05:00:00 PM,48,-122,356,210,566
21378,FremontBridge,03/12/2015 06:00:00 PM,48,-122,293,164,457
21379,FremontBridge,03/12/2015 07:00:00 PM,48,-122,108,97,205
21380,FremontBridge,03/12/2015 08:00:00 PM,48,-122,57,42,99
21381,FremontBridge,03/12/2015 09:00:00 PM,48,-122,29,27,56
21382,FremontBridge,03/12/2015 10:00:00 PM,48,-122,18,16,34
21383,FremontBridge,03/12/2015 11:00:00 PM,48,-122,21,8,29
21384,FremontBridge,03/13/2015 12:00:00 AM,48,-122,8,6,14
21385,FremontBridge,03/13/2015 01:00:00 AM,48,-122,6,2,8
21386,FremontBridge,03/13/2015 02:00:00 AM,48,-122,4,1,5
21387,FremontBridge,03/13/2015 03:00:00 AM,48,-122,3,1,4
21388,FremontBridge,03/13/2015 04:00:00 AM,48,-122,5,3,8
21389,FremontBridge,03/13/2015 05:00:00 AM,48,-122,13,22,35
21390,FremontBridge,03/13/2015 06:00:00 AM,48,-122,29,69,98
21391,FremontBridge,03/13/2015 07:00:00 AM,48,-122,7,174,181
21392,FremontBridge,03/13/2015 08:00:00 AM,48,-122,0,306,306
21393,FremontBridge,03/13/2015 09:00:00 AM,48,-122,0,183,183
21394,FremontBridge,03/13/2015 10:00:00 AM,48,-122,0,102,102
21395,FremontBridge,03/13/2015 11:00:00 AM,48,-122,0,70,70
21396,FremontBridge,03/13/2015 12:00:00 PM,48,-122,0,63,63
21397,FremontBridge,03/13/2015 01:00:00 PM,48,-122,0,84,84
21398,FremontBridge,03/13/2015 02:00:00 PM,48,-122,38,85,123
21399,FremontBridge,03/13/2015 03:00:00 PM,48,-122,98,82,180
21400,FremontBridge,03/13/2015 04:00:00 PM,48,-122,161,121,282
21401,FremontBridge,03/13/2015 05:00:00 PM,48,-122,339,159,498
21402,FremontBridge,03/13/2015 06:00:00 PM,48,-122,228,149,377
21403,FremontBridge,03/13/2015 07:00:00 PM,48,-122,97,60,157
21404,FremontBridge,03/13/2015 08:00:00 PM,48,-122,40,32,72
21405,FremontBridge,03/13/2015 09:00:00 PM,48,-122,24,28,52
21406,FremontBridge,03/13/2015 10:00:00 PM,48,-122,19,18,37
21407,FremontBridge,03/13/2015 11:00:00 PM,48,-122,11,19,30
21408,FremontBridge,03/14/2015 12:00:00 AM,48,-122,9,10,19
21409,FremontBridge,03/14/2015 01:00:00 AM,48,-122,7,2,9
21410,FremontBridge,03/14/2015 02:00:00 AM,48,-122,4,3,7
21411,FremontBridge,03/14/2015 03:00:00 AM,48,-122,1,0,1
21412,FremontBridge,03/14/2015 04:00:00 AM,48,-122,2,0,2
21413,FremontBridge,03/14/2015 05:00:00 AM,48,-122,1,1,2
21414,FremontBridge,03/14/2015 06:00:00 AM,48,-122,4,7,11
21415,FremontBridge,03/14/2015 07:00:00 AM,48,-122,7,5,12
21416,FremontBridge,03/14/2015 08:00:00 AM,48,-122,11,20,31
21417,FremontBridge,03/14/2015 09:00:00 AM,48,-122,21,21,42
21418,FremontBridge,03/14/2015 10:00:00 AM,48,-122,11,22,33
21419,FremontBridge,03/14/2015 11:00:00 AM,48,-122,23,18,41
21420,FremontBridge,03/14/2015 12:00:00 PM,48,-122,28,27,55
21421,FremontBridge,03/14/2015 01:00:00 PM,48,-122,23,39,62
21422,FremontBridge,03/14/2015 02:00:00 PM,48,-122,46,42,88
21423,FremontBridge,03/14/2015 03:00:00 PM,48,-122,37,48,85
21424,FremontBridge,03/14/2015 04:00:00 PM,48,-122,40,56,96
21425,FremontBridge,03/14/2015 05:00:00 PM,48,-122,40,46,86
21426,FremontBridge,03/14/2015 06:00:00 PM,48,-122,25,37,62
21427,FremontBridge,03/14/2015 07:00:00 PM,48,-122,16,16,32
21428,FremontBridge,03/14/2015 08:00:00 PM,48,-122,7,12,19
21429,FremontBridge,03/14/2015 09:00:00 PM,48,-122,20,19,39
21430,FremontBridge,03/14/2015 10:00:00 PM,48,-122,8,10,18
21431,FremontBridge,03/14/2015 11:00:00 PM,48,-122,11,12,23
21432,FremontBridge,03/15/2015 12:00:00 AM,48,-122,3,4,7
21433,FremontBridge,03/15/2015 01:00:00 AM,48,-122,6,0,6
21434,FremontBridge,03/15/2015 02:00:00 AM,48,-122,4,2,6
21435,FremontBridge,03/15/2015 03:00:00 AM,48,-122,2,1,3
21436,FremontBridge,03/15/2015 04:00:00 AM,48,-122,0,0,0
21437,FremontBridge,03/15/2015 05:00:00 AM,48,-122,2,2,4
21438,FremontBridge,03/15/2015 06:00:00 AM,48,-122,3,4,7
21439,FremontBridge,03/15/2015 07:00:00 AM,48,-122,2,4,6
21440,FremontBridge,03/15/2015 08:00:00 AM,48,-122,7,11,18
21441,FremontBridge,03/15/2015 09:00:00 AM,48,-122,8,11,19
21442,FremontBridge,03/15/2015 10:00:00 AM,48,-122,4,8,12
21443,FremontBridge,03/15/2015 11:00:00 AM,48,-122,6,8,14
21444,FremontBridge,03/15/2015 12:00:00 PM,48,-122,8,9,17
21445,FremontBridge,03/15/2015 01:00:00 PM,48,-122,3,10,13
21446,FremontBridge,03/15/2015 02:00:00 PM,48,-122,6,5,11
21447,FremontBridge,03/15/2015 03:00:00 PM,48,-122,3,13,16
21448,FremontBridge,03/15/2015 04:00:00 PM,48,-122,12,5,17
21449,FremontBridge,03/15/2015 05:00:00 PM,48,-122,8,10,18
21450,FremontBridge,03/15/2015 06:00:00 PM,48,-122,6,7,13
21451,FremontBridge,03/15/2015 07:00:00 PM,48,-122,6,6,12
21452,FremontBridge,03/15/2015 08:00:00 PM,48,-122,3,4,7
21453,FremontBridge,03/15/2015 09:00:00 PM,48,-122,0,2,2
21454,FremontBridge,03/15/2015 10:00:00 PM,48,-122,2,3,5
21455,FremontBridge,03/15/2015 11:00:00 PM,48,-122,3,3,6
21456,FremontBridge,03/16/2015 12:00:00 AM,48,-122,0,0,0
21457,FremontBridge,03/16/2015 01:00:00 AM,48,-122,0,2,2
21458,FremontBridge,03/16/2015 02:00:00 AM,48,-122,1,1,2
21459,FremontBridge,03/16/2015 03:00:00 AM,48,-122,1,0,1
21460,FremontBridge,03/16/2015 04:00:00 AM,48,-122,2,2,4
21461,FremontBridge,03/16/2015 05:00:00 AM,48,-122,11,22,33
21462,FremontBridge,03/16/2015 06:00:00 AM,48,-122,30,51,81
21463,FremontBridge,03/16/2015 07:00:00 AM,48,-122,125,35,160
21464,FremontBridge,03/16/2015 08:00:00 AM,48,-122,226,2,228
21465,FremontBridge,03/16/2015 09:00:00 AM,48,-122,168,0,168
21466,FremontBridge,03/16/2015 10:00:00 AM,48,-122,54,0,54
21467,FremontBridge,03/16/2015 11:00:00 AM,48,-122,63,0,63
21468,FremontBridge,03/16/2015 12:00:00 PM,48,-122,55,0,55
21469,FremontBridge,03/16/2015 01:00:00 PM,48,-122,59,0,59
21470,FremontBridge,03/16/2015 02:00:00 PM,48,-122,94,0,94
21471,FremontBridge,03/16/2015 03:00:00 PM,48,-122,82,32,114
21472,FremontBridge,03/16/2015 04:00:00 PM,48,-122,133,85,218
21473,FremontBridge,03/16/2015 05:00:00 PM,48,-122,359,175,534
21474,FremontBridge,03/16/2015 06:00:00 PM,48,-122,294,141,435
21475,FremontBridge,03/16/2015 07:00:00 PM,48,-122,105,55,160
21476,FremontBridge,03/16/2015 08:00:00 PM,48,-122,42,28,70
21477,FremontBridge,03/16/2015 09:00:00 PM,48,-122,29,17,46
21478,FremontBridge,03/16/2015 10:00:00 PM,48,-122,13,9,22
21479,FremontBridge,03/16/2015 11:00:00 PM,48,-122,10,11,21
21480,FremontBridge,03/17/2015 12:00:00 AM,48,-122,8,2,10
21481,FremontBridge,03/17/2015 01:00:00 AM,48,-122,1,5,6
21482,FremontBridge,03/17/2015 02:00:00 AM,48,-122,1,1,2
21483,FremontBridge,03/17/2015 03:00:00 AM,48,-122,2,1,3
21484,FremontBridge,03/17/2015 04:00:00 AM,48,-122,3,5,8
21485,FremontBridge,03/17/2015 05:00:00 AM,48,-122,10,23,33
21486,FremontBridge,03/17/2015 06:00:00 AM,48,-122,23,54,77
21487,FremontBridge,03/17/2015 07:00:00 AM,48,-122,109,45,154
21488,FremontBridge,03/17/2015 08:00:00 AM,48,-122,218,0,218
21489,FremontBridge,03/17/2015 09:00:00 AM,48,-122,102,0,102
21490,FremontBridge,03/17/2015 10:00:00 AM,48,-122,69,0,69
21491,FremontBridge,03/17/2015 11:00:00 AM,48,-122,34,0,34
21492,FremontBridge,03/17/2015 12:00:00 PM,48,-122,54,0,54
21493,FremontBridge,03/17/2015 01:00:00 PM,48,-122,57,0,57
21494,FremontBridge,03/17/2015 02:00:00 PM,48,-122,70,11,81
21495,FremontBridge,03/17/2015 03:00:00 PM,48,-122,75,43,118
21496,FremontBridge,03/17/2015 04:00:00 PM,48,-122,126,90,216
21497,FremontBridge,03/17/2015 05:00:00 PM,48,-122,292,128,420
21498,FremontBridge,03/17/2015 06:00:00 PM,48,-122,220,135,355
21499,FremontBridge,03/17/2015 07:00:00 PM,48,-122,79,50,129
21500,FremontBridge,03/17/2015 08:00:00 PM,48,-122,41,19,60
21501,FremontBridge,03/17/2015 09:00:00 PM,48,-122,24,22,46
21502,FremontBridge,03/17/2015 10:00:00 PM,48,-122,16,12,28
21503,FremontBridge,03/17/2015 11:00:00 PM,48,-122,8,11,19
21504,FremontBridge,03/18/2015 12:00:00 AM,48,-122,8,10,18
21505,FremontBridge,03/18/2015 01:00:00 AM,48,-122,4,2,6
21506,FremontBridge,03/18/2015 02:00:00 AM,48,-122,2,3,5
21507,FremontBridge,03/18/2015 03:00:00 AM,48,-122,1,1,2
21508,FremontBridge,03/18/2015 04:00:00 AM,48,-122,5,4,9
21509,FremontBridge,03/18/2015 05:00:00 AM,48,-122,11,28,39
21510,FremontBridge,03/18/2015 06:00:00 AM,48,-122,33,56,89
21511,FremontBridge,03/18/2015 07:00:00 AM,48,-122,127,28,155
21512,FremontBridge,03/18/2015 08:00:00 AM,48,-122,226,2,228
21513,FremontBridge,03/18/2015 09:00:00 AM,48,-122,155,0,155
21514,FremontBridge,03/18/2015 10:00:00 AM,48,-122,76,0,76
21515,FremontBridge,03/18/2015 11:00:00 AM,48,-122,48,0,48
21516,FremontBridge,03/18/2015 12:00:00 PM,48,-122,42,0,42
21517,FremontBridge,03/18/2015 01:00:00 PM,48,-122,70,0,70
21518,FremontBridge,03/18/2015 02:00:00 PM,48,-122,59,14,73
21519,FremontBridge,03/18/2015 03:00:00 PM,48,-122,84,54,138
21520,FremontBridge,03/18/2015 04:00:00 PM,48,-122,141,104,245
21521,FremontBridge,03/18/2015 05:00:00 PM,48,-122,381,205,586
21522,FremontBridge,03/18/2015 06:00:00 PM,48,-122,306,155,461
21523,FremontBridge,03/18/2015 07:00:00 PM,48,-122,120,88,208
21524,FremontBridge,03/18/2015 08:00:00 PM,48,-122,60,31,91
21525,FremontBridge,03/18/2015 09:00:00 PM,48,-122,35,34,69
21526,FremontBridge,03/18/2015 10:00:00 PM,48,-122,18,19,37
21527,FremontBridge,03/18/2015 11:00:00 PM,48,-122,15,8,23
21528,FremontBridge,03/19/2015 12:00:00 AM,48,-122,7,9,16
21529,FremontBridge,03/19/2015 01:00:00 AM,48,-122,1,5,6
21530,FremontBridge,03/19/2015 02:00:00 AM,48,-122,2,4,6
21531,FremontBridge,03/19/2015 03:00:00 AM,48,-122,3,1,4
21532,FremontBridge,03/19/2015 04:00:00 AM,48,-122,3,6,9
21533,FremontBridge,03/19/2015 05:00:00 AM,48,-122,10,22,32
21534,FremontBridge,03/19/2015 06:00:00 AM,48,-122,32,72,104
21535,FremontBridge,03/19/2015 07:00:00 AM,48,-122,19,190,209
21536,FremontBridge,03/19/2015 08:00:00 AM,48,-122,0,310,310
21537,FremontBridge,03/19/2015 09:00:00 AM,48,-122,0,178,178
21538,FremontBridge,03/19/2015 10:00:00 AM,48,-122,0,101,101
21539,FremontBridge,03/19/2015 11:00:00 AM,48,-122,0,76,76
21540,FremontBridge,03/19/2015 12:00:00 PM,48,-122,0,53,53
21541,FremontBridge,03/19/2015 01:00:00 PM,48,-122,0,61,61
21542,FremontBridge,03/19/2015 02:00:00 PM,48,-122,5,71,76
21543,FremontBridge,03/19/2015 03:00:00 PM,48,-122,71,57,128
21544,FremontBridge,03/19/2015 04:00:00 PM,48,-122,130,67,197
21545,FremontBridge,03/19/2015 05:00:00 PM,48,-122,334,136,470
21546,FremontBridge,03/19/2015 06:00:00 PM,48,-122,236,105,341
21547,FremontBridge,03/19/2015 07:00:00 PM,48,-122,108,54,162
21548,FremontBridge,03/19/2015 08:00:00 PM,48,-122,50,24,74
21549,FremontBridge,03/19/2015 09:00:00 PM,48,-122,28,18,46
21550,FremontBridge,03/19/2015 10:00:00 PM,48,-122,12,12,24
21551,FremontBridge,03/19/2015 11:00:00 PM,48,-122,9,18,27
21552,FremontBridge,03/20/2015 12:00:00 AM,48,-122,9,5,14
21553,FremontBridge,03/20/2015 01:00:00 AM,48,-122,1,5,6
21554,FremontBridge,03/20/2015 02:00:00 AM,48,-122,1,3,4
21555,FremontBridge,03/20/2015 03:00:00 AM,48,-122,3,1,4
21556,FremontBridge,03/20/2015 04:00:00 AM,48,-122,3,5,8
21557,FremontBridge,03/20/2015 05:00:00 AM,48,-122,8,15,23
21558,FremontBridge,03/20/2015 06:00:00 AM,48,-122,29,50,79
21559,FremontBridge,03/20/2015 07:00:00 AM,48,-122,10,155,165
21560,FremontBridge,03/20/2015 08:00:00 AM,48,-122,0,216,216
21561,FremontBridge,03/20/2015 09:00:00 AM,48,-122,0,133,133
21562,FremontBridge,03/20/2015 10:00:00 AM,48,-122,0,94,94
21563,FremontBridge,03/20/2015 11:00:00 AM,48,-122,3,58,61
21564,FremontBridge,03/20/2015 12:00:00 PM,48,-122,11,60,71
21565,FremontBridge,03/20/2015 01:00:00 PM,48,-122,27,33,60
21566,FremontBridge,03/20/2015 02:00:00 PM,48,-122,32,30,62
21567,FremontBridge,03/20/2015 03:00:00 PM,48,-122,39,38,77
21568,FremontBridge,03/20/2015 04:00:00 PM,48,-122,123,53,176
21569,FremontBridge,03/20/2015 05:00:00 PM,48,-122,245,112,357
21570,FremontBridge,03/20/2015 06:00:00 PM,48,-122,139,66,205
21571,FremontBridge,03/20/2015 07:00:00 PM,48,-122,55,31,86
21572,FremontBridge,03/20/2015 08:00:00 PM,48,-122,28,19,47
21573,FremontBridge,03/20/2015 09:00:00 PM,48,-122,14,16,30
21574,FremontBridge,03/20/2015 10:00:00 PM,48,-122,7,4,11
21575,FremontBridge,03/20/2015 11:00:00 PM,48,-122,16,9,25
21576,FremontBridge,03/21/2015 12:00:00 AM,48,-122,4,3,7
21577,FremontBridge,03/21/2015 01:00:00 AM,48,-122,4,3,7
21578,FremontBridge,03/21/2015 02:00:00 AM,48,-122,1,1,2
21579,FremontBridge,03/21/2015 03:00:00 AM,48,-122,2,2,4
21580,FremontBridge,03/21/2015 04:00:00 AM,48,-122,1,3,4
21581,FremontBridge,03/21/2015 05:00:00 AM,48,-122,1,3,4
21582,FremontBridge,03/21/2015 06:00:00 AM,48,-122,8,8,16
21583,FremontBridge,03/21/2015 07:00:00 AM,48,-122,13,12,25
21584,FremontBridge,03/21/2015 08:00:00 AM,48,-122,18,25,43
21585,FremontBridge,03/21/2015 09:00:00 AM,48,-122,22,44,66
21586,FremontBridge,03/21/2015 10:00:00 AM,48,-122,38,39,77
21587,FremontBridge,03/21/2015 11:00:00 AM,48,-122,33,61,94
21588,FremontBridge,03/21/2015 12:00:00 PM,48,-122,48,45,93
21589,FremontBridge,03/21/2015 01:00:00 PM,48,-122,69,40,109
21590,FremontBridge,03/21/2015 02:00:00 PM,48,-122,57,57,114
21591,FremontBridge,03/21/2015 03:00:00 PM,48,-122,62,82,144
21592,FremontBridge,03/21/2015 04:00:00 PM,48,-122,55,61,116
21593,FremontBridge,03/21/2015 05:00:00 PM,48,-122,76,73,149
21594,FremontBridge,03/21/2015 06:00:00 PM,48,-122,53,60,113
21595,FremontBridge,03/21/2015 07:00:00 PM,48,-122,29,41,70
21596,FremontBridge,03/21/2015 08:00:00 PM,48,-122,28,24,52
21597,FremontBridge,03/21/2015 09:00:00 PM,48,-122,10,10,20
21598,FremontBridge,03/21/2015 10:00:00 PM,48,-122,9,13,22
21599,FremontBridge,03/21/2015 11:00:00 PM,48,-122,13,15,28
21600,FremontBridge,03/22/2015 12:00:00 AM,48,-122,11,1,12
21601,FremontBridge,03/22/2015 01:00:00 AM,48,-122,7,4,11
21602,FremontBridge,03/22/2015 02:00:00 AM,48,-122,2,3,5
21603,FremontBridge,03/22/2015 03:00:00 AM,48,-122,2,2,4
21604,FremontBridge,03/22/2015 04:00:00 AM,48,-122,0,2,2
21605,FremontBridge,03/22/2015 05:00:00 AM,48,-122,6,0,6
21606,FremontBridge,03/22/2015 06:00:00 AM,48,-122,5,8,13
21607,FremontBridge,03/22/2015 07:00:00 AM,48,-122,9,15,24
21608,FremontBridge,03/22/2015 08:00:00 AM,48,-122,37,33,70
21609,FremontBridge,03/22/2015 09:00:00 AM,48,-122,45,42,87
21610,FremontBridge,03/22/2015 10:00:00 AM,48,-122,47,65,112
21611,FremontBridge,03/22/2015 11:00:00 AM,48,-122,42,77,119
21612,FremontBridge,03/22/2015 12:00:00 PM,48,-122,50,77,127
21613,FremontBridge,03/22/2015 01:00:00 PM,48,-122,25,73,98
21614,FremontBridge,03/22/2015 02:00:00 PM,48,-122,19,37,56
21615,FremontBridge,03/22/2015 03:00:00 PM,48,-122,26,35,61
21616,FremontBridge,03/22/2015 04:00:00 PM,48,-122,21,28,49
21617,FremontBridge,03/22/2015 05:00:00 PM,48,-122,34,21,55
21618,FremontBridge,03/22/2015 06:00:00 PM,48,-122,27,23,50
21619,FremontBridge,03/22/2015 07:00:00 PM,48,-122,20,19,39
21620,FremontBridge,03/22/2015 08:00:00 PM,48,-122,8,9,17
21621,FremontBridge,03/22/2015 09:00:00 PM,48,-122,12,6,18
21622,FremontBridge,03/22/2015 10:00:00 PM,48,-122,10,4,14
21623,FremontBridge,03/22/2015 11:00:00 PM,48,-122,4,4,8
21624,FremontBridge,03/23/2015 12:00:00 AM,48,-122,6,3,9
21625,FremontBridge,03/23/2015 01:00:00 AM,48,-122,1,0,1
21626,FremontBridge,03/23/2015 02:00:00 AM,48,-122,1,1,2
21627,FremontBridge,03/23/2015 03:00:00 AM,48,-122,1,0,1
21628,FremontBridge,03/23/2015 04:00:00 AM,48,-122,2,3,5
21629,FremontBridge,03/23/2015 05:00:00 AM,48,-122,12,20,32
21630,FremontBridge,03/23/2015 06:00:00 AM,48,-122,28,67,95
21631,FremontBridge,03/23/2015 07:00:00 AM,48,-122,8,121,129
21632,FremontBridge,03/23/2015 08:00:00 AM,48,-122,0,260,260
21633,FremontBridge,03/23/2015 09:00:00 AM,48,-122,0,156,156
21634,FremontBridge,03/23/2015 10:00:00 AM,48,-122,1,55,56
21635,FremontBridge,03/23/2015 11:00:00 AM,48,-122,0,35,35
21636,FremontBridge,03/23/2015 12:00:00 PM,48,-122,11,21,32
21637,FremontBridge,03/23/2015 01:00:00 PM,48,-122,25,20,45
21638,FremontBridge,03/23/2015 02:00:00 PM,48,-122,22,24,46
21639,FremontBridge,03/23/2015 03:00:00 PM,48,-122,41,24,65
21640,FremontBridge,03/23/2015 04:00:00 PM,48,-122,90,64,154
21641,FremontBridge,03/23/2015 05:00:00 PM,48,-122,263,100,363
21642,FremontBridge,03/23/2015 06:00:00 PM,48,-122,223,95,318
21643,FremontBridge,03/23/2015 07:00:00 PM,48,-122,80,28,108
21644,FremontBridge,03/23/2015 08:00:00 PM,48,-122,41,19,60
21645,FremontBridge,03/23/2015 09:00:00 PM,48,-122,11,8,19
21646,FremontBridge,03/23/2015 10:00:00 PM,48,-122,13,10,23
21647,FremontBridge,03/23/2015 11:00:00 PM,48,-122,9,6,15
21648,FremontBridge,03/24/2015 12:00:00 AM,48,-122,3,4,7
21649,FremontBridge,03/24/2015 01:00:00 AM,48,-122,0,1,1
21650,FremontBridge,03/24/2015 02:00:00 AM,48,-122,3,1,4
21651,FremontBridge,03/24/2015 03:00:00 AM,48,-122,1,0,1
21652,FremontBridge,03/24/2015 04:00:00 AM,48,-122,3,5,8
21653,FremontBridge,03/24/2015 05:00:00 AM,48,-122,4,18,22
21654,FremontBridge,03/24/2015 06:00:00 AM,48,-122,27,50,77
21655,FremontBridge,03/24/2015 07:00:00 AM,48,-122,7,139,146
21656,FremontBridge,03/24/2015 08:00:00 AM,48,-122,3,261,264
21657,FremontBridge,03/24/2015 09:00:00 AM,48,-122,3,143,146
21658,FremontBridge,03/24/2015 10:00:00 AM,48,-122,0,65,65
21659,FremontBridge,03/24/2015 11:00:00 AM,48,-122,0,47,47
21660,FremontBridge,03/24/2015 12:00:00 PM,48,-122,3,44,47
21661,FremontBridge,03/24/2015 01:00:00 PM,48,-122,0,47,47
21662,FremontBridge,03/24/2015 02:00:00 PM,48,-122,22,54,76
21663,FremontBridge,03/24/2015 03:00:00 PM,48,-122,49,54,103
21664,FremontBridge,03/24/2015 04:00:00 PM,48,-122,86,70,156
21665,FremontBridge,03/24/2015 05:00:00 PM,48,-122,265,120,385
21666,FremontBridge,03/24/2015 06:00:00 PM,48,-122,205,115,320
21667,FremontBridge,03/24/2015 07:00:00 PM,48,-122,71,73,144
21668,FremontBridge,03/24/2015 08:00:00 PM,48,-122,51,37,88
21669,FremontBridge,03/24/2015 09:00:00 PM,48,-122,28,12,40
21670,FremontBridge,03/24/2015 10:00:00 PM,48,-122,24,10,34
21671,FremontBridge,03/24/2015 11:00:00 PM,48,-122,15,7,22
21672,FremontBridge,03/25/2015 12:00:00 AM,48,-122,11,1,12
21673,FremontBridge,03/25/2015 01:00:00 AM,48,-122,1,4,5
21674,FremontBridge,03/25/2015 02:00:00 AM,48,-122,1,1,2
21675,FremontBridge,03/25/2015 03:00:00 AM,48,-122,1,0,1
21676,FremontBridge,03/25/2015 04:00:00 AM,48,-122,2,3,5
21677,FremontBridge,03/25/2015 05:00:00 AM,48,-122,5,20,25
21678,FremontBridge,03/25/2015 06:00:00 AM,48,-122,25,55,80
21679,FremontBridge,03/25/2015 07:00:00 AM,48,-122,13,135,148
21680,FremontBridge,03/25/2015 08:00:00 AM,48,-122,1,258,259
21681,FremontBridge,03/25/2015 09:00:00 AM,48,-122,0,161,161
21682,FremontBridge,03/25/2015 10:00:00 AM,48,-122,0,54,54
21683,FremontBridge,03/25/2015 11:00:00 AM,48,-122,0,35,35
21684,FremontBridge,03/25/2015 12:00:00 PM,48,-122,0,32,32
21685,FremontBridge,03/25/2015 01:00:00 PM,48,-122,1,39,40
21686,FremontBridge,03/25/2015 02:00:00 PM,48,-122,20,16,36
21687,FremontBridge,03/25/2015 03:00:00 PM,48,-122,38,30,68
21688,FremontBridge,03/25/2015 04:00:00 PM,48,-122,91,61,152
21689,FremontBridge,03/25/2015 05:00:00 PM,48,-122,243,101,344
21690,FremontBridge,03/25/2015 06:00:00 PM,48,-122,190,105,295
21691,FremontBridge,03/25/2015 07:00:00 PM,48,-122,84,41,125
21692,FremontBridge,03/25/2015 08:00:00 PM,48,-122,47,27,74
21693,FremontBridge,03/25/2015 09:00:00 PM,48,-122,18,21,39
21694,FremontBridge,03/25/2015 10:00:00 PM,48,-122,18,16,34
21695,FremontBridge,03/25/2015 11:00:00 PM,48,-122,5,9,14
21696,FremontBridge,03/26/2015 12:00:00 AM,48,-122,5,1,6
21697,FremontBridge,03/26/2015 01:00:00 AM,48,-122,3,2,5
21698,FremontBridge,03/26/2015 02:00:00 AM,48,-122,1,4,5
21699,FremontBridge,03/26/2015 03:00:00 AM,48,-122,4,2,6
21700,FremontBridge,03/26/2015 04:00:00 AM,48,-122,3,4,7
21701,FremontBridge,03/26/2015 05:00:00 AM,48,-122,8,25,33
21702,FremontBridge,03/26/2015 06:00:00 AM,48,-122,34,69,103
21703,FremontBridge,03/26/2015 07:00:00 AM,48,-122,15,209,224
21704,FremontBridge,03/26/2015 08:00:00 AM,48,-122,0,353,353
21705,FremontBridge,03/26/2015 09:00:00 AM,48,-122,0,187,187
21706,FremontBridge,03/26/2015 10:00:00 AM,48,-122,8,92,100
21707,FremontBridge,03/26/2015 11:00:00 AM,48,-122,1,80,81
21708,FremontBridge,03/26/2015 12:00:00 PM,48,-122,14,61,75
21709,FremontBridge,03/26/2015 01:00:00 PM,48,-122,44,71,115
21710,FremontBridge,03/26/2015 02:00:00 PM,48,-122,72,81,153
21711,FremontBridge,03/26/2015 03:00:00 PM,48,-122,84,87,171
21712,FremontBridge,03/26/2015 04:00:00 PM,48,-122,168,147,315
21713,FremontBridge,03/26/2015 05:00:00 PM,48,-122,405,189,594
21714,FremontBridge,03/26/2015 06:00:00 PM,48,-122,258,183,441
21715,FremontBridge,03/26/2015 07:00:00 PM,48,-122,150,103,253
21716,FremontBridge,03/26/2015 08:00:00 PM,48,-122,86,40,126
21717,FremontBridge,03/26/2015 09:00:00 PM,48,-122,27,36,63
21718,FremontBridge,03/26/2015 10:00:00 PM,48,-122,25,20,45
21719,FremontBridge,03/26/2015 11:00:00 PM,48,-122,22,13,35
21720,FremontBridge,03/27/2015 12:00:00 AM,48,-122,11,6,17
21721,FremontBridge,03/27/2015 01:00:00 AM,48,-122,3,3,6
21722,FremontBridge,03/27/2015 02:00:00 AM,48,-122,4,4,8
21723,FremontBridge,03/27/2015 03:00:00 AM,48,-122,3,0,3
21724,FremontBridge,03/27/2015 04:00:00 AM,48,-122,2,2,4
21725,FremontBridge,03/27/2015 05:00:00 AM,48,-122,14,23,37
21726,FremontBridge,03/27/2015 06:00:00 AM,48,-122,26,65,91
21727,FremontBridge,03/27/2015 07:00:00 AM,48,-122,14,171,185
21728,FremontBridge,03/27/2015 08:00:00 AM,48,-122,0,308,308
21729,FremontBridge,03/27/2015 09:00:00 AM,48,-122,1,192,193
21730,FremontBridge,03/27/2015 10:00:00 AM,48,-122,0,91,91
21731,FremontBridge,03/27/2015 11:00:00 AM,48,-122,4,83,87
21732,FremontBridge,03/27/2015 12:00:00 PM,48,-122,75,2,77
21733,FremontBridge,03/27/2015 01:00:00 PM,48,-122,71,0,71
21734,FremontBridge,03/27/2015 02:00:00 PM,48,-122,104,38,142
21735,FremontBridge,03/27/2015 03:00:00 PM,48,-122,103,77,180
21736,FremontBridge,03/27/2015 04:00:00 PM,48,-122,188,132,320
21737,FremontBridge,03/27/2015 05:00:00 PM,48,-122,324,166,490
21738,FremontBridge,03/27/2015 06:00:00 PM,48,-122,229,135,364
21739,FremontBridge,03/27/2015 07:00:00 PM,48,-122,107,65,172
21740,FremontBridge,03/27/2015 08:00:00 PM,48,-122,49,35,84
21741,FremontBridge,03/27/2015 09:00:00 PM,48,-122,24,15,39
21742,FremontBridge,03/27/2015 10:00:00 PM,48,-122,13,15,28
21743,FremontBridge,03/27/2015 11:00:00 PM,48,-122,12,6,18
21744,FremontBridge,03/28/2015 12:00:00 AM,48,-122,7,6,13
21745,FremontBridge,03/28/2015 01:00:00 AM,48,-122,5,6,11
21746,FremontBridge,03/28/2015 02:00:00 AM,48,-122,0,4,4
21747,FremontBridge,03/28/2015 03:00:00 AM,48,-122,1,1,2
21748,FremontBridge,03/28/2015 04:00:00 AM,48,-122,0,1,1
21749,FremontBridge,03/28/2015 05:00:00 AM,48,-122,1,3,4
21750,FremontBridge,03/28/2015 06:00:00 AM,48,-122,7,8,15
21751,FremontBridge,03/28/2015 07:00:00 AM,48,-122,23,16,39
21752,FremontBridge,03/28/2015 08:00:00 AM,48,-122,27,48,75
21753,FremontBridge,03/28/2015 09:00:00 AM,48,-122,54,47,101
21754,FremontBridge,03/28/2015 10:00:00 AM,48,-122,61,64,125
21755,FremontBridge,03/28/2015 11:00:00 AM,48,-122,64,65,129
21756,FremontBridge,03/28/2015 12:00:00 PM,48,-122,73,80,153
21757,FremontBridge,03/28/2015 01:00:00 PM,48,-122,71,106,177
21758,FremontBridge,03/28/2015 02:00:00 PM,48,-122,78,99,177
21759,FremontBridge,03/28/2015 03:00:00 PM,48,-122,90,84,174
21760,FremontBridge,03/28/2015 04:00:00 PM,48,-122,66,102,168
21761,FremontBridge,03/28/2015 05:00:00 PM,48,-122,60,92,152
21762,FremontBridge,03/28/2015 06:00:00 PM,48,-122,46,51,97
21763,FremontBridge,03/28/2015 07:00:00 PM,48,-122,26,34,60
21764,FremontBridge,03/28/2015 08:00:00 PM,48,-122,18,29,47
21765,FremontBridge,03/28/2015 09:00:00 PM,48,-122,12,17,29
21766,FremontBridge,03/28/2015 10:00:00 PM,48,-122,16,10,26
21767,FremontBridge,03/28/2015 11:00:00 PM,48,-122,4,13,17
21768,FremontBridge,03/29/2015 12:00:00 AM,48,-122,0,2,2
21769,FremontBridge,03/29/2015 01:00:00 AM,48,-122,0,2,2
21770,FremontBridge,03/29/2015 02:00:00 AM,48,-122,4,2,6
21771,FremontBridge,03/29/2015 03:00:00 AM,48,-122,3,0,3
21772,FremontBridge,03/29/2015 04:00:00 AM,48,-122,4,1,5
21773,FremontBridge,03/29/2015 05:00:00 AM,48,-122,2,0,2
21774,FremontBridge,03/29/2015 06:00:00 AM,48,-122,4,4,8
21775,FremontBridge,03/29/2015 07:00:00 AM,48,-122,9,9,18
21776,FremontBridge,03/29/2015 08:00:00 AM,48,-122,22,30,52
21777,FremontBridge,03/29/2015 09:00:00 AM,48,-122,35,52,87
21778,FremontBridge,03/29/2015 10:00:00 AM,48,-122,34,63,97
21779,FremontBridge,03/29/2015 11:00:00 AM,48,-122,50,66,116
21780,FremontBridge,03/29/2015 12:00:00 PM,48,-122,52,84,136
21781,FremontBridge,03/29/2015 01:00:00 PM,48,-122,36,82,118
21782,FremontBridge,03/29/2015 02:00:00 PM,48,-122,61,74,135
21783,FremontBridge,03/29/2015 03:00:00 PM,48,-122,48,65,113
21784,FremontBridge,03/29/2015 04:00:00 PM,48,-122,48,90,138
21785,FremontBridge,03/29/2015 05:00:00 PM,48,-122,44,57,101
21786,FremontBridge,03/29/2015 06:00:00 PM,48,-122,45,67,112
21787,FremontBridge,03/29/2015 07:00:00 PM,48,-122,21,29,50
21788,FremontBridge,03/29/2015 08:00:00 PM,48,-122,21,32,53
21789,FremontBridge,03/29/2015 09:00:00 PM,48,-122,7,11,18
21790,FremontBridge,03/29/2015 10:00:00 PM,48,-122,12,13,25
21791,FremontBridge,03/29/2015 11:00:00 PM,48,-122,4,7,11
21792,FremontBridge,03/30/2015 12:00:00 AM,48,-122,5,6,11
21793,FremontBridge,03/30/2015 01:00:00 AM,48,-122,3,1,4
21794,FremontBridge,03/30/2015 02:00:00 AM,48,-122,1,3,4
21795,FremontBridge,03/30/2015 03:00:00 AM,48,-122,2,1,3
21796,FremontBridge,03/30/2015 04:00:00 AM,48,-122,2,4,6
21797,FremontBridge,03/30/2015 05:00:00 AM,48,-122,16,30,46
21798,FremontBridge,03/30/2015 06:00:00 AM,48,-122,36,87,123
21799,FremontBridge,03/30/2015 07:00:00 AM,48,-122,16,209,225
21800,FremontBridge,03/30/2015 08:00:00 AM,48,-122,0,352,352
21801,FremontBridge,03/30/2015 09:00:00 AM,48,-122,0,177,177
21802,FremontBridge,03/30/2015 10:00:00 AM,48,-122,0,87,87
21803,FremontBridge,03/30/2015 11:00:00 AM,48,-122,0,65,65
21804,FremontBridge,03/30/2015 12:00:00 PM,48,-122,0,61,61
21805,FremontBridge,03/30/2015 01:00:00 PM,48,-122,0,82,82
21806,FremontBridge,03/30/2015 02:00:00 PM,48,-122,18,68,86
21807,FremontBridge,03/30/2015 03:00:00 PM,48,-122,74,95,169
21808,FremontBridge,03/30/2015 04:00:00 PM,48,-122,166,118,284
21809,FremontBridge,03/30/2015 05:00:00 PM,48,-122,422,206,628
21810,FremontBridge,03/30/2015 06:00:00 PM,48,-122,313,164,477
21811,FremontBridge,03/30/2015 07:00:00 PM,48,-122,129,92,221
21812,FremontBridge,03/30/2015 08:00:00 PM,48,-122,56,51,107
21813,FremontBridge,03/30/2015 09:00:00 PM,48,-122,35,27,62
21814,FremontBridge,03/30/2015 10:00:00 PM,48,-122,17,20,37
21815,FremontBridge,03/30/2015 11:00:00 PM,48,-122,14,8,22
21816,FremontBridge,03/31/2015 12:00:00 AM,48,-122,7,2,9
21817,FremontBridge,03/31/2015 01:00:00 AM,48,-122,1,2,3
21818,FremontBridge,03/31/2015 02:00:00 AM,48,-122,1,4,5
21819,FremontBridge,03/31/2015 03:00:00 AM,48,-122,3,1,4
21820,FremontBridge,03/31/2015 04:00:00 AM,48,-122,3,1,4
21821,FremontBridge,03/31/2015 05:00:00 AM,48,-122,9,27,36
21822,FremontBridge,03/31/2015 06:00:00 AM,48,-122,29,65,94
21823,FremontBridge,03/31/2015 07:00:00 AM,48,-122,103,25,128
21824,FremontBridge,03/31/2015 08:00:00 AM,48,-122,248,2,250
21825,FremontBridge,03/31/2015 09:00:00 AM,48,-122,125,5,130
21826,FremontBridge,03/31/2015 10:00:00 AM,48,-122,38,0,38
21827,FremontBridge,03/31/2015 11:00:00 AM,48,-122,39,1,40
21828,FremontBridge,03/31/2015 12:00:00 PM,48,-122,38,0,38
21829,FremontBridge,03/31/2015 01:00:00 PM,48,-122,34,1,35
21830,FremontBridge,03/31/2015 02:00:00 PM,48,-122,71,26,97
21831,FremontBridge,03/31/2015 03:00:00 PM,48,-122,56,44,100
21832,FremontBridge,03/31/2015 04:00:00 PM,48,-122,89,70,159
21833,FremontBridge,03/31/2015 05:00:00 PM,48,-122,219,103,322
21834,FremontBridge,03/31/2015 06:00:00 PM,48,-122,208,96,304
21835,FremontBridge,03/31/2015 07:00:00 PM,48,-122,75,39,114
21836,FremontBridge,03/31/2015 08:00:00 PM,48,-122,36,23,59
21837,FremontBridge,03/31/2015 09:00:00 PM,48,-122,13,12,25
21838,FremontBridge,03/31/2015 10:00:00 PM,48,-122,5,7,12
21839,FremontBridge,03/31/2015 11:00:00 PM,48,-122,9,7,16
21840,FremontBridge,04/01/2015 12:00:00 AM,48,-122,0,3,3
21841,FremontBridge,04/01/2015 01:00:00 AM,48,-122,1,0,1
21842,FremontBridge,04/01/2015 02:00:00 AM,48,-122,0,3,3
21843,FremontBridge,04/01/2015 03:00:00 AM,48,-122,0,2,2
21844,FremontBridge,04/01/2015 04:00:00 AM,48,-122,2,2,4
21845,FremontBridge,04/01/2015 05:00:00 AM,48,-122,7,23,30
21846,FremontBridge,04/01/2015 06:00:00 AM,48,-122,25,55,80
21847,FremontBridge,04/01/2015 07:00:00 AM,48,-122,91,40,131
21848,FremontBridge,04/01/2015 08:00:00 AM,48,-122,202,3,205
21849,FremontBridge,04/01/2015 09:00:00 AM,48,-122,150,0,150
21850,FremontBridge,04/01/2015 10:00:00 AM,48,-122,74,0,74
21851,FremontBridge,04/01/2015 11:00:00 AM,48,-122,56,1,57
21852,FremontBridge,04/01/2015 12:00:00 PM,48,-122,61,0,61
21853,FremontBridge,04/01/2015 01:00:00 PM,48,-122,63,0,63
21854,FremontBridge,04/01/2015 02:00:00 PM,48,-122,47,29,76
21855,FremontBridge,04/01/2015 03:00:00 PM,48,-122,50,62,112
21856,FremontBridge,04/01/2015 04:00:00 PM,48,-122,124,100,224
21857,FremontBridge,04/01/2015 05:00:00 PM,48,-122,298,150,448
21858,FremontBridge,04/01/2015 06:00:00 PM,48,-122,259,143,402
21859,FremontBridge,04/01/2015 07:00:00 PM,48,-122,87,44,131
21860,FremontBridge,04/01/2015 08:00:00 PM,48,-122,46,27,73
21861,FremontBridge,04/01/2015 09:00:00 PM,48,-122,27,22,49
21862,FremontBridge,04/01/2015 10:00:00 PM,48,-122,15,13,28
21863,FremontBridge,04/01/2015 11:00:00 PM,48,-122,12,8,20
21864,FremontBridge,04/02/2015 12:00:00 AM,48,-122,5,1,6
21865,FremontBridge,04/02/2015 01:00:00 AM,48,-122,1,4,5
21866,FremontBridge,04/02/2015 02:00:00 AM,48,-122,0,1,1
21867,FremontBridge,04/02/2015 03:00:00 AM,48,-122,3,1,4
21868,FremontBridge,04/02/2015 04:00:00 AM,48,-122,2,3,5
21869,FremontBridge,04/02/2015 05:00:00 AM,48,-122,4,28,32
21870,FremontBridge,04/02/2015 06:00:00 AM,48,-122,26,72,98
21871,FremontBridge,04/02/2015 07:00:00 AM,48,-122,8,171,179
21872,FremontBridge,04/02/2015 08:00:00 AM,48,-122,0,302,302
21873,FremontBridge,04/02/2015 09:00:00 AM,48,-122,0,191,191
21874,FremontBridge,04/02/2015 10:00:00 AM,48,-122,0,73,73
21875,FremontBridge,04/02/2015 11:00:00 AM,48,-122,0,49,49
21876,FremontBridge,04/02/2015 12:00:00 PM,48,-122,0,54,54
21877,FremontBridge,04/02/2015 01:00:00 PM,48,-122,0,62,62
21878,FremontBridge,04/02/2015 02:00:00 PM,48,-122,21,58,79
21879,FremontBridge,04/02/2015 03:00:00 PM,48,-122,60,54,114
21880,FremontBridge,04/02/2015 04:00:00 PM,48,-122,147,109,256
21881,FremontBridge,04/02/2015 05:00:00 PM,48,-122,294,183,477
21882,FremontBridge,04/02/2015 06:00:00 PM,48,-122,260,151,411
21883,FremontBridge,04/02/2015 07:00:00 PM,48,-122,103,87,190
21884,FremontBridge,04/02/2015 08:00:00 PM,48,-122,76,35,111
21885,FremontBridge,04/02/2015 09:00:00 PM,48,-122,32,36,68
21886,FremontBridge,04/02/2015 10:00:00 PM,48,-122,17,14,31
21887,FremontBridge,04/02/2015 11:00:00 PM,48,-122,14,16,30
21888,FremontBridge,04/03/2015 12:00:00 AM,48,-122,12,9,21
21889,FremontBridge,04/03/2015 01:00:00 AM,48,-122,2,7,9
21890,FremontBridge,04/03/2015 02:00:00 AM,48,-122,3,8,11
21891,FremontBridge,04/03/2015 03:00:00 AM,48,-122,1,3,4
21892,FremontBridge,04/03/2015 04:00:00 AM,48,-122,3,1,4
21893,FremontBridge,04/03/2015 05:00:00 AM,48,-122,6,20,26
21894,FremontBridge,04/03/2015 06:00:00 AM,48,-122,28,48,76
21895,FremontBridge,04/03/2015 07:00:00 AM,48,-122,54,185,239
21896,FremontBridge,04/03/2015 08:00:00 AM,48,-122,77,257,334
21897,FremontBridge,04/03/2015 09:00:00 AM,48,-122,73,140,213
21898,FremontBridge,04/03/2015 10:00:00 AM,48,-122,67,83,150
21899,FremontBridge,04/03/2015 11:00:00 AM,48,-122,28,46,74
21900,FremontBridge,04/03/2015 12:00:00 PM,48,-122,30,39,69
21901,FremontBridge,04/03/2015 01:00:00 PM,48,-122,27,25,52
21902,FremontBridge,04/03/2015 02:00:00 PM,48,-122,25,28,53
21903,FremontBridge,04/03/2015 03:00:00 PM,48,-122,61,42,103
21904,FremontBridge,04/03/2015 04:00:00 PM,48,-122,144,64,208
21905,FremontBridge,04/03/2015 05:00:00 PM,48,-122,291,108,399
21906,FremontBridge,04/03/2015 06:00:00 PM,48,-122,162,112,274
21907,FremontBridge,04/03/2015 07:00:00 PM,48,-122,75,42,117
21908,FremontBridge,04/03/2015 08:00:00 PM,48,-122,50,23,73
21909,FremontBridge,04/03/2015 09:00:00 PM,48,-122,34,12,46
21910,FremontBridge,04/03/2015 10:00:00 PM,48,-122,15,14,29
21911,FremontBridge,04/03/2015 11:00:00 PM,48,-122,12,15,27
21912,FremontBridge,04/04/2015 12:00:00 AM,48,-122,6,7,13
21913,FremontBridge,04/04/2015 01:00:00 AM,48,-122,0,2,2
21914,FremontBridge,04/04/2015 02:00:00 AM,48,-122,2,5,7
21915,FremontBridge,04/04/2015 03:00:00 AM,48,-122,2,0,2
21916,FremontBridge,04/04/2015 04:00:00 AM,48,-122,1,3,4
21917,FremontBridge,04/04/2015 05:00:00 AM,48,-122,3,6,9
21918,FremontBridge,04/04/2015 06:00:00 AM,48,-122,9,11,20
21919,FremontBridge,04/04/2015 07:00:00 AM,48,-122,15,21,36
21920,FremontBridge,04/04/2015 08:00:00 AM,48,-122,36,43,79
21921,FremontBridge,04/04/2015 09:00:00 AM,48,-122,45,58,103
21922,FremontBridge,04/04/2015 10:00:00 AM,48,-122,34,76,110
21923,FremontBridge,04/04/2015 11:00:00 AM,48,-122,59,76,135
21924,FremontBridge,04/04/2015 12:00:00 PM,48,-122,73,139,212
21925,FremontBridge,04/04/2015 01:00:00 PM,48,-122,88,102,190
21926,FremontBridge,04/04/2015 02:00:00 PM,48,-122,81,83,164
21927,FremontBridge,04/04/2015 03:00:00 PM,48,-122,62,110,172
21928,FremontBridge,04/04/2015 04:00:00 PM,48,-122,86,89,175
21929,FremontBridge,04/04/2015 05:00:00 PM,48,-122,88,92,180
21930,FremontBridge,04/04/2015 06:00:00 PM,48,-122,71,79,150
21931,FremontBridge,04/04/2015 07:00:00 PM,48,-122,29,41,70
21932,FremontBridge,04/04/2015 08:00:00 PM,48,-122,25,42,67
21933,FremontBridge,04/04/2015 09:00:00 PM,48,-122,18,23,41
21934,FremontBridge,04/04/2015 10:00:00 PM,48,-122,15,13,28
21935,FremontBridge,04/04/2015 11:00:00 PM,48,-122,10,8,18
21936,FremontBridge,04/05/2015 12:00:00 AM,48,-122,15,8,23
21937,FremontBridge,04/05/2015 01:00:00 AM,48,-122,10,2,12
21938,FremontBridge,04/05/2015 02:00:00 AM,48,-122,2,2,4
21939,FremontBridge,04/05/2015 03:00:00 AM,48,-122,0,2,2
21940,FremontBridge,04/05/2015 04:00:00 AM,48,-122,0,3,3
21941,FremontBridge,04/05/2015 05:00:00 AM,48,-122,3,5,8
21942,FremontBridge,04/05/2015 06:00:00 AM,48,-122,9,7,16
21943,FremontBridge,04/05/2015 07:00:00 AM,48,-122,14,7,21
21944,FremontBridge,04/05/2015 08:00:00 AM,48,-122,18,20,38
21945,FremontBridge,04/05/2015 09:00:00 AM,48,-122,47,45,92
21946,FremontBridge,04/05/2015 10:00:00 AM,48,-122,54,77,131
21947,FremontBridge,04/05/2015 11:00:00 AM,48,-122,48,80,128
21948,FremontBridge,04/05/2015 12:00:00 PM,48,-122,84,70,154
21949,FremontBridge,04/05/2015 01:00:00 PM,48,-122,62,89,151
21950,FremontBridge,04/05/2015 02:00:00 PM,48,-122,83,128,211
21951,FremontBridge,04/05/2015 03:00:00 PM,48,-122,76,101,177
21952,FremontBridge,04/05/2015 04:00:00 PM,48,-122,63,87,150
21953,FremontBridge,04/05/2015 05:00:00 PM,48,-122,61,86,147
21954,FremontBridge,04/05/2015 06:00:00 PM,48,-122,64,46,110
21955,FremontBridge,04/05/2015 07:00:00 PM,48,-122,37,33,70
21956,FremontBridge,04/05/2015 08:00:00 PM,48,-122,25,19,44
21957,FremontBridge,04/05/2015 09:00:00 PM,48,-122,6,6,12
21958,FremontBridge,04/05/2015 10:00:00 PM,48,-122,8,8,16
21959,FremontBridge,04/05/2015 11:00:00 PM,48,-122,6,3,9
21960,FremontBridge,04/06/2015 12:00:00 AM,48,-122,6,8,14
21961,FremontBridge,04/06/2015 01:00:00 AM,48,-122,2,0,2
21962,FremontBridge,04/06/2015 02:00:00 AM,48,-122,2,2,4
21963,FremontBridge,04/06/2015 03:00:00 AM,48,-122,0,3,3
21964,FremontBridge,04/06/2015 04:00:00 AM,48,-122,2,4,6
21965,FremontBridge,04/06/2015 05:00:00 AM,48,-122,9,32,41
21966,FremontBridge,04/06/2015 06:00:00 AM,48,-122,44,64,108
21967,FremontBridge,04/06/2015 07:00:00 AM,48,-122,17,186,203
21968,FremontBridge,04/06/2015 08:00:00 AM,48,-122,0,342,342
21969,FremontBridge,04/06/2015 09:00:00 AM,48,-122,0,171,171
21970,FremontBridge,04/06/2015 10:00:00 AM,48,-122,1,66,67
21971,FremontBridge,04/06/2015 11:00:00 AM,48,-122,0,49,49
21972,FremontBridge,04/06/2015 12:00:00 PM,48,-122,0,57,57
21973,FremontBridge,04/06/2015 01:00:00 PM,48,-122,0,82,82
21974,FremontBridge,04/06/2015 02:00:00 PM,48,-122,22,51,73
21975,FremontBridge,04/06/2015 03:00:00 PM,48,-122,64,53,117
21976,FremontBridge,04/06/2015 04:00:00 PM,48,-122,154,99,253
21977,FremontBridge,04/06/2015 05:00:00 PM,48,-122,420,164,584
21978,FremontBridge,04/06/2015 06:00:00 PM,48,-122,245,143,388
21979,FremontBridge,04/06/2015 07:00:00 PM,48,-122,118,70,188
21980,FremontBridge,04/06/2015 08:00:00 PM,48,-122,52,36,88
21981,FremontBridge,04/06/2015 09:00:00 PM,48,-122,28,27,55
21982,FremontBridge,04/06/2015 10:00:00 PM,48,-122,18,17,35
21983,FremontBridge,04/06/2015 11:00:00 PM,48,-122,20,5,25
21984,FremontBridge,04/07/2015 12:00:00 AM,48,-122,5,9,14
21985,FremontBridge,04/07/2015 01:00:00 AM,48,-122,2,1,3
21986,FremontBridge,04/07/2015 02:00:00 AM,48,-122,2,1,3
21987,FremontBridge,04/07/2015 03:00:00 AM,48,-122,0,2,2
21988,FremontBridge,04/07/2015 04:00:00 AM,48,-122,2,3,5
21989,FremontBridge,04/07/2015 05:00:00 AM,48,-122,13,27,40
21990,FremontBridge,04/07/2015 06:00:00 AM,48,-122,28,75,103
21991,FremontBridge,04/07/2015 07:00:00 AM,48,-122,22,206,228
21992,FremontBridge,04/07/2015 08:00:00 AM,48,-122,0,383,383
21993,FremontBridge,04/07/2015 09:00:00 AM,48,-122,0,179,179
21994,FremontBridge,04/07/2015 10:00:00 AM,48,-122,1,94,95
21995,FremontBridge,04/07/2015 11:00:00 AM,48,-122,0,49,49
21996,FremontBridge,04/07/2015 12:00:00 PM,48,-122,0,42,42
21997,FremontBridge,04/07/2015 01:00:00 PM,48,-122,0,34,34
21998,FremontBridge,04/07/2015 02:00:00 PM,48,-122,32,42,74
21999,FremontBridge,04/07/2015 03:00:00 PM,48,-122,54,67,121
22000,FremontBridge,04/07/2015 04:00:00 PM,48,-122,169,85,254
22001,FremontBridge,04/07/2015 05:00:00 PM,48,-122,371,175,546
22002,FremontBridge,04/07/2015 06:00:00 PM,48,-122,292,149,441
22003,FremontBridge,04/07/2015 07:00:00 PM,48,-122,120,79,199
22004,FremontBridge,04/07/2015 08:00:00 PM,48,-122,68,50,118
22005,FremontBridge,04/07/2015 09:00:00 PM,48,-122,34,25,59
22006,FremontBridge,04/07/2015 10:00:00 PM,48,-122,14,10,24
22007,FremontBridge,04/07/2015 11:00:00 PM,48,-122,19,13,32
22008,FremontBridge,04/08/2015 12:00:00 AM,48,-122,7,5,12
22009,FremontBridge,04/08/2015 01:00:00 AM,48,-122,5,2,7
22010,FremontBridge,04/08/2015 02:00:00 AM,48,-122,0,2,2
22011,FremontBridge,04/08/2015 03:00:00 AM,48,-122,0,4,4
22012,FremontBridge,04/08/2015 04:00:00 AM,48,-122,2,3,5
22013,FremontBridge,04/08/2015 05:00:00 AM,48,-122,9,26,35
22014,FremontBridge,04/08/2015 06:00:00 AM,48,-122,44,79,123
22015,FremontBridge,04/08/2015 07:00:00 AM,48,-122,10,209,219
22016,FremontBridge,04/08/2015 08:00:00 AM,48,-122,0,367,367
22017,FremontBridge,04/08/2015 09:00:00 AM,48,-122,2,208,210
22018,FremontBridge,04/08/2015 10:00:00 AM,48,-122,0,97,97
22019,FremontBridge,04/08/2015 11:00:00 AM,48,-122,0,60,60
22020,FremontBridge,04/08/2015 12:00:00 PM,48,-122,0,79,79
22021,FremontBridge,04/08/2015 01:00:00 PM,48,-122,0,83,83
22022,FremontBridge,04/08/2015 02:00:00 PM,48,-122,33,59,92
22023,FremontBridge,04/08/2015 03:00:00 PM,48,-122,73,62,135
22024,FremontBridge,04/08/2015 04:00:00 PM,48,-122,125,121,246
22025,FremontBridge,04/08/2015 05:00:00 PM,48,-122,402,178,580
22026,FremontBridge,04/08/2015 06:00:00 PM,48,-122,312,193,505
22027,FremontBridge,04/08/2015 07:00:00 PM,48,-122,104,93,197
22028,FremontBridge,04/08/2015 08:00:00 PM,48,-122,59,68,127
22029,FremontBridge,04/08/2015 09:00:00 PM,48,-122,32,41,73
22030,FremontBridge,04/08/2015 10:00:00 PM,48,-122,28,27,55
22031,FremontBridge,04/08/2015 11:00:00 PM,48,-122,27,11,38
22032,FremontBridge,04/09/2015 12:00:00 AM,48,-122,10,6,16
22033,FremontBridge,04/09/2015 01:00:00 AM,48,-122,2,4,6
22034,FremontBridge,04/09/2015 02:00:00 AM,48,-122,1,3,4
22035,FremontBridge,04/09/2015 03:00:00 AM,48,-122,3,2,5
22036,FremontBridge,04/09/2015 04:00:00 AM,48,-122,3,4,7
22037,FremontBridge,04/09/2015 05:00:00 AM,48,-122,15,25,40
22038,FremontBridge,04/09/2015 06:00:00 AM,48,-122,48,70,118
22039,FremontBridge,04/09/2015 07:00:00 AM,48,-122,14,212,226
22040,FremontBridge,04/09/2015 08:00:00 AM,48,-122,0,334,334
22041,FremontBridge,04/09/2015 09:00:00 AM,48,-122,2,207,209
22042,FremontBridge,04/09/2015 10:00:00 AM,48,-122,31,64,95
22043,FremontBridge,04/09/2015 11:00:00 AM,48,-122,70,3,73
22044,FremontBridge,04/09/2015 12:00:00 PM,48,-122,103,1,104
22045,FremontBridge,04/09/2015 01:00:00 PM,48,-122,108,0,108
22046,FremontBridge,04/09/2015 02:00:00 PM,48,-122,90,38,128
22047,FremontBridge,04/09/2015 03:00:00 PM,48,-122,101,66,167
22048,FremontBridge,04/09/2015 04:00:00 PM,48,-122,185,146,331
22049,FremontBridge,04/09/2015 05:00:00 PM,48,-122,427,199,626
22050,FremontBridge,04/09/2015 06:00:00 PM,48,-122,314,228,542
22051,FremontBridge,04/09/2015 07:00:00 PM,48,-122,126,126,252
22052,FremontBridge,04/09/2015 08:00:00 PM,48,-122,66,71,137
22053,FremontBridge,04/09/2015 09:00:00 PM,48,-122,38,36,74
22054,FremontBridge,04/09/2015 10:00:00 PM,48,-122,17,21,38
22055,FremontBridge,04/09/2015 11:00:00 PM,48,-122,23,7,30
22056,FremontBridge,04/10/2015 12:00:00 AM,48,-122,3,10,13
22057,FremontBridge,04/10/2015 01:00:00 AM,48,-122,7,7,14
22058,FremontBridge,04/10/2015 02:00:00 AM,48,-122,2,2,4
22059,FremontBridge,04/10/2015 03:00:00 AM,48,-122,2,2,4
22060,FremontBridge,04/10/2015 04:00:00 AM,48,-122,2,4,6
22061,FremontBridge,04/10/2015 05:00:00 AM,48,-122,10,24,34
22062,FremontBridge,04/10/2015 06:00:00 AM,48,-122,32,59,91
22063,FremontBridge,04/10/2015 07:00:00 AM,48,-122,92,27,119
22064,FremontBridge,04/10/2015 08:00:00 AM,48,-122,168,0,168
22065,FremontBridge,04/10/2015 09:00:00 AM,48,-122,135,0,135
22066,FremontBridge,04/10/2015 10:00:00 AM,48,-122,111,2,113
22067,FremontBridge,04/10/2015 11:00:00 AM,48,-122,89,0,89
22068,FremontBridge,04/10/2015 12:00:00 PM,48,-122,63,1,64
22069,FremontBridge,04/10/2015 01:00:00 PM,48,-122,54,14,68
22070,FremontBridge,04/10/2015 02:00:00 PM,48,-122,47,51,98
22071,FremontBridge,04/10/2015 03:00:00 PM,48,-122,90,56,146
22072,FremontBridge,04/10/2015 04:00:00 PM,48,-122,168,93,261
22073,FremontBridge,04/10/2015 05:00:00 PM,48,-122,248,106,354
22074,FremontBridge,04/10/2015 06:00:00 PM,48,-122,166,99,265
22075,FremontBridge,04/10/2015 07:00:00 PM,48,-122,61,25,86
22076,FremontBridge,04/10/2015 08:00:00 PM,48,-122,22,17,39
22077,FremontBridge,04/10/2015 09:00:00 PM,48,-122,6,15,21
22078,FremontBridge,04/10/2015 10:00:00 PM,48,-122,10,6,16
22079,FremontBridge,04/10/2015 11:00:00 PM,48,-122,6,5,11
22080,FremontBridge,04/11/2015 12:00:00 AM,48,-122,5,3,8
22081,FremontBridge,04/11/2015 01:00:00 AM,48,-122,0,5,5
22082,FremontBridge,04/11/2015 02:00:00 AM,48,-122,2,3,5
22083,FremontBridge,04/11/2015 03:00:00 AM,48,-122,1,0,1
22084,FremontBridge,04/11/2015 04:00:00 AM,48,-122,0,0,0
22085,FremontBridge,04/11/2015 05:00:00 AM,48,-122,1,4,5
22086,FremontBridge,04/11/2015 06:00:00 AM,48,-122,5,6,11
22087,FremontBridge,04/11/2015 07:00:00 AM,48,-122,6,19,25
22088,FremontBridge,04/11/2015 08:00:00 AM,48,-122,21,27,48
22089,FremontBridge,04/11/2015 09:00:00 AM,48,-122,32,34,66
22090,FremontBridge,04/11/2015 10:00:00 AM,48,-122,32,61,93
22091,FremontBridge,04/11/2015 11:00:00 AM,48,-122,47,53,100
22092,FremontBridge,04/11/2015 12:00:00 PM,48,-122,56,78,134
22093,FremontBridge,04/11/2015 01:00:00 PM,48,-122,61,58,119
22094,FremontBridge,04/11/2015 02:00:00 PM,48,-122,54,71,125
22095,FremontBridge,04/11/2015 03:00:00 PM,48,-122,56,86,142
22096,FremontBridge,04/11/2015 04:00:00 PM,48,-122,42,32,74
22097,FremontBridge,04/11/2015 05:00:00 PM,48,-122,40,35,75
22098,FremontBridge,04/11/2015 06:00:00 PM,48,-122,24,44,68
22099,FremontBridge,04/11/2015 07:00:00 PM,48,-122,32,44,76
22100,FremontBridge,04/11/2015 08:00:00 PM,48,-122,13,20,33
22101,FremontBridge,04/11/2015 09:00:00 PM,48,-122,10,10,20
22102,FremontBridge,04/11/2015 10:00:00 PM,48,-122,9,5,14
22103,FremontBridge,04/11/2015 11:00:00 PM,48,-122,8,9,17
22104,FremontBridge,04/12/2015 12:00:00 AM,48,-122,5,4,9
22105,FremontBridge,04/12/2015 01:00:00 AM,48,-122,4,4,8
22106,FremontBridge,04/12/2015 02:00:00 AM,48,-122,2,1,3
22107,FremontBridge,04/12/2015 03:00:00 AM,48,-122,3,0,3
22108,FremontBridge,04/12/2015 04:00:00 AM,48,-122,2,2,4
22109,FremontBridge,04/12/2015 05:00:00 AM,48,-122,0,1,1
22110,FremontBridge,04/12/2015 06:00:00 AM,48,-122,7,5,12
22111,FremontBridge,04/12/2015 07:00:00 AM,48,-122,6,10,16
22112,FremontBridge,04/12/2015 08:00:00 AM,48,-122,19,31,50
22113,FremontBridge,04/12/2015 09:00:00 AM,48,-122,36,100,136
22114,FremontBridge,04/12/2015 10:00:00 AM,48,-122,47,87,134
22115,FremontBridge,04/12/2015 11:00:00 AM,48,-122,74,93,167
22116,FremontBridge,04/12/2015 12:00:00 PM,48,-122,64,86,150
22117,FremontBridge,04/12/2015 01:00:00 PM,48,-122,78,123,201
22118,FremontBridge,04/12/2015 02:00:00 PM,48,-122,63,87,150
22119,FremontBridge,04/12/2015 03:00:00 PM,48,-122,81,89,170
22120,FremontBridge,04/12/2015 04:00:00 PM,48,-122,60,56,116
22121,FremontBridge,04/12/2015 05:00:00 PM,48,-122,52,60,112
22122,FremontBridge,04/12/2015 06:00:00 PM,48,-122,65,49,114
22123,FremontBridge,04/12/2015 07:00:00 PM,48,-122,26,36,62
22124,FremontBridge,04/12/2015 08:00:00 PM,48,-122,17,14,31
22125,FremontBridge,04/12/2015 09:00:00 PM,48,-122,9,10,19
22126,FremontBridge,04/12/2015 10:00:00 PM,48,-122,6,8,14
22127,FremontBridge,04/12/2015 11:00:00 PM,48,-122,11,8,19
22128,FremontBridge,04/13/2015 12:00:00 AM,48,-122,8,5,13
22129,FremontBridge,04/13/2015 01:00:00 AM,48,-122,1,2,3
22130,FremontBridge,04/13/2015 02:00:00 AM,48,-122,0,3,3
22131,FremontBridge,04/13/2015 03:00:00 AM,48,-122,0,1,1
22132,FremontBridge,04/13/2015 04:00:00 AM,48,-122,1,4,5
22133,FremontBridge,04/13/2015 05:00:00 AM,48,-122,4,23,27
22134,FremontBridge,04/13/2015 06:00:00 AM,48,-122,27,48,75
22135,FremontBridge,04/13/2015 07:00:00 AM,48,-122,50,164,214
22136,FremontBridge,04/13/2015 08:00:00 AM,48,-122,81,256,337
22137,FremontBridge,04/13/2015 09:00:00 AM,48,-122,84,165,249
22138,FremontBridge,04/13/2015 10:00:00 AM,48,-122,28,60,88
22139,FremontBridge,04/13/2015 11:00:00 AM,48,-122,29,47,76
22140,FremontBridge,04/13/2015 12:00:00 PM,48,-122,30,35,65
22141,FremontBridge,04/13/2015 01:00:00 PM,48,-122,23,25,48
22142,FremontBridge,04/13/2015 02:00:00 PM,48,-122,17,14,31
22143,FremontBridge,04/13/2015 03:00:00 PM,48,-122,34,19,53
22144,FremontBridge,04/13/2015 04:00:00 PM,48,-122,85,55,140
22145,FremontBridge,04/13/2015 05:00:00 PM,48,-122,209,100,309
22146,FremontBridge,04/13/2015 06:00:00 PM,48,-122,168,70,238
22147,FremontBridge,04/13/2015 07:00:00 PM,48,-122,63,28,91
22148,FremontBridge,04/13/2015 08:00:00 PM,48,-122,25,14,39
22149,FremontBridge,04/13/2015 09:00:00 PM,48,-122,14,12,26
22150,FremontBridge,04/13/2015 10:00:00 PM,48,-122,5,6,11
22151,FremontBridge,04/13/2015 11:00:00 PM,48,-122,7,9,16
22152,FremontBridge,04/14/2015 12:00:00 AM,48,-122,6,3,9
22153,FremontBridge,04/14/2015 01:00:00 AM,48,-122,1,0,1
22154,FremontBridge,04/14/2015 02:00:00 AM,48,-122,1,2,3
22155,FremontBridge,04/14/2015 03:00:00 AM,48,-122,1,1,2
22156,FremontBridge,04/14/2015 04:00:00 AM,48,-122,2,2,4
22157,FremontBridge,04/14/2015 05:00:00 AM,48,-122,6,18,24
22158,FremontBridge,04/14/2015 06:00:00 AM,48,-122,20,48,68
22159,FremontBridge,04/14/2015 07:00:00 AM,48,-122,71,161,232
22160,FremontBridge,04/14/2015 08:00:00 AM,48,-122,63,244,307
22161,FremontBridge,04/14/2015 09:00:00 AM,48,-122,76,146,222
22162,FremontBridge,04/14/2015 10:00:00 AM,48,-122,35,56,91
22163,FremontBridge,04/14/2015 11:00:00 AM,48,-122,28,28,56
22164,FremontBridge,04/14/2015 12:00:00 PM,48,-122,26,32,58
22165,FremontBridge,04/14/2015 01:00:00 PM,48,-122,43,33,76
22166,FremontBridge,04/14/2015 02:00:00 PM,48,-122,45,48,93
22167,FremontBridge,04/14/2015 03:00:00 PM,48,-122,53,40,93
22168,FremontBridge,04/14/2015 04:00:00 PM,48,-122,96,57,153
22169,FremontBridge,04/14/2015 05:00:00 PM,48,-122,220,97,317
22170,FremontBridge,04/14/2015 06:00:00 PM,48,-122,200,108,308
22171,FremontBridge,04/14/2015 07:00:00 PM,48,-122,83,50,133
22172,FremontBridge,04/14/2015 08:00:00 PM,48,-122,52,25,77
22173,FremontBridge,04/14/2015 09:00:00 PM,48,-122,32,14,46
22174,FremontBridge,04/14/2015 10:00:00 PM,48,-122,12,17,29
22175,FremontBridge,04/14/2015 11:00:00 PM,48,-122,10,12,22
22176,FremontBridge,04/15/2015 12:00:00 AM,48,-122,6,3,9
22177,FremontBridge,04/15/2015 01:00:00 AM,48,-122,3,4,7
22178,FremontBridge,04/15/2015 02:00:00 AM,48,-122,1,2,3
22179,FremontBridge,04/15/2015 03:00:00 AM,48,-122,4,1,5
22180,FremontBridge,04/15/2015 04:00:00 AM,48,-122,1,3,4
22181,FremontBridge,04/15/2015 05:00:00 AM,48,-122,10,27,37
22182,FremontBridge,04/15/2015 06:00:00 AM,48,-122,37,73,110
22183,FremontBridge,04/15/2015 07:00:00 AM,48,-122,65,232,297
22184,FremontBridge,04/15/2015 08:00:00 AM,48,-122,117,326,443
22185,FremontBridge,04/15/2015 09:00:00 AM,48,-122,109,184,293
22186,FremontBridge,04/15/2015 10:00:00 AM,48,-122,47,68,115
22187,FremontBridge,04/15/2015 11:00:00 AM,48,-122,41,37,78
22188,FremontBridge,04/15/2015 12:00:00 PM,48,-122,46,49,95
22189,FremontBridge,04/15/2015 01:00:00 PM,48,-122,44,54,98
22190,FremontBridge,04/15/2015 02:00:00 PM,48,-122,45,61,106
22191,FremontBridge,04/15/2015 03:00:00 PM,48,-122,76,66,142
22192,FremontBridge,04/15/2015 04:00:00 PM,48,-122,156,121,277
22193,FremontBridge,04/15/2015 05:00:00 PM,48,-122,388,195,583
22194,FremontBridge,04/15/2015 06:00:00 PM,48,-122,314,185,499
22195,FremontBridge,04/15/2015 07:00:00 PM,48,-122,128,93,221
22196,FremontBridge,04/15/2015 08:00:00 PM,48,-122,72,59,131
22197,FremontBridge,04/15/2015 09:00:00 PM,48,-122,43,21,64
22198,FremontBridge,04/15/2015 10:00:00 PM,48,-122,21,27,48
22199,FremontBridge,04/15/2015 11:00:00 PM,48,-122,15,17,32
22200,FremontBridge,04/16/2015 12:00:00 AM,48,-122,7,7,14
22201,FremontBridge,04/16/2015 01:00:00 AM,48,-122,8,1,9
22202,FremontBridge,04/16/2015 02:00:00 AM,48,-122,0,1,1
22203,FremontBridge,04/16/2015 03:00:00 AM,48,-122,2,5,7
22204,FremontBridge,04/16/2015 04:00:00 AM,48,-122,2,4,6
22205,FremontBridge,04/16/2015 05:00:00 AM,48,-122,17,21,38
22206,FremontBridge,04/16/2015 06:00:00 AM,48,-122,37,74,111
22207,FremontBridge,04/16/2015 07:00:00 AM,48,-122,63,245,308
22208,FremontBridge,04/16/2015 08:00:00 AM,48,-122,146,356,502
22209,FremontBridge,04/16/2015 09:00:00 AM,48,-122,119,200,319
22210,FremontBridge,04/16/2015 10:00:00 AM,48,-122,49,79,128
22211,FremontBridge,04/16/2015 11:00:00 AM,48,-122,40,56,96
22212,FremontBridge,04/16/2015 12:00:00 PM,48,-122,61,76,137
22213,FremontBridge,04/16/2015 01:00:00 PM,48,-122,52,48,100
22214,FremontBridge,04/16/2015 02:00:00 PM,48,-122,47,65,112
22215,FremontBridge,04/16/2015 03:00:00 PM,48,-122,82,81,163
22216,FremontBridge,04/16/2015 04:00:00 PM,48,-122,185,121,306
22217,FremontBridge,04/16/2015 05:00:00 PM,48,-122,392,194,586
22218,FremontBridge,04/16/2015 06:00:00 PM,48,-122,290,171,461
22219,FremontBridge,04/16/2015 07:00:00 PM,48,-122,154,110,264
22220,FremontBridge,04/16/2015 08:00:00 PM,48,-122,74,83,157
22221,FremontBridge,04/16/2015 09:00:00 PM,48,-122,41,43,84
22222,FremontBridge,04/16/2015 10:00:00 PM,48,-122,31,29,60
22223,FremontBridge,04/16/2015 11:00:00 PM,48,-122,23,10,33
22224,FremontBridge,04/17/2015 12:00:00 AM,48,-122,12,11,23
22225,FremontBridge,04/17/2015 01:00:00 AM,48,-122,3,7,10
22226,FremontBridge,04/17/2015 02:00:00 AM,48,-122,2,2,4
22227,FremontBridge,04/17/2015 03:00:00 AM,48,-122,5,4,9
22228,FremontBridge,04/17/2015 04:00:00 AM,48,-122,4,1,5
22229,FremontBridge,04/17/2015 05:00:00 AM,48,-122,11,16,27
22230,FremontBridge,04/17/2015 06:00:00 AM,48,-122,34,66,100
22231,FremontBridge,04/17/2015 07:00:00 AM,48,-122,69,228,297
22232,FremontBridge,04/17/2015 08:00:00 AM,48,-122,119,312,431
22233,FremontBridge,04/17/2015 09:00:00 AM,48,-122,106,171,277
22234,FremontBridge,04/17/2015 10:00:00 AM,48,-122,50,68,118
22235,FremontBridge,04/17/2015 11:00:00 AM,48,-122,42,41,83
22236,FremontBridge,04/17/2015 12:00:00 PM,48,-122,53,43,96
22237,FremontBridge,04/17/2015 01:00:00 PM,48,-122,38,81,119
22238,FremontBridge,04/17/2015 02:00:00 PM,48,-122,49,56,105
22239,FremontBridge,04/17/2015 03:00:00 PM,48,-122,78,91,169
22240,FremontBridge,04/17/2015 04:00:00 PM,48,-122,158,122,280
22241,FremontBridge,04/17/2015 05:00:00 PM,48,-122,348,160,508
22242,FremontBridge,04/17/2015 06:00:00 PM,48,-122,234,156,390
22243,FremontBridge,04/17/2015 07:00:00 PM,48,-122,107,78,185
22244,FremontBridge,04/17/2015 08:00:00 PM,48,-122,45,42,87
22245,FremontBridge,04/17/2015 09:00:00 PM,48,-122,27,15,42
22246,FremontBridge,04/17/2015 10:00:00 PM,48,-122,23,27,50
22247,FremontBridge,04/17/2015 11:00:00 PM,48,-122,22,17,39
22248,FremontBridge,04/18/2015 12:00:00 AM,48,-122,18,6,24
22249,FremontBridge,04/18/2015 01:00:00 AM,48,-122,4,7,11
22250,FremontBridge,04/18/2015 02:00:00 AM,48,-122,3,5,8
22251,FremontBridge,04/18/2015 03:00:00 AM,48,-122,1,0,1
22252,FremontBridge,04/18/2015 04:00:00 AM,48,-122,2,2,4
22253,FremontBridge,04/18/2015 05:00:00 AM,48,-122,2,4,6
22254,FremontBridge,04/18/2015 06:00:00 AM,48,-122,11,17,28
22255,FremontBridge,04/18/2015 07:00:00 AM,48,-122,20,26,46
22256,FremontBridge,04/18/2015 08:00:00 AM,48,-122,39,35,74
22257,FremontBridge,04/18/2015 09:00:00 AM,48,-122,50,79,129
22258,FremontBridge,04/18/2015 10:00:00 AM,48,-122,66,101,167
22259,FremontBridge,04/18/2015 11:00:00 AM,48,-122,61,81,142
22260,FremontBridge,04/18/2015 12:00:00 PM,48,-122,92,102,194
22261,FremontBridge,04/18/2015 01:00:00 PM,48,-122,91,117,208
22262,FremontBridge,04/18/2015 02:00:00 PM,48,-122,117,149,266
22263,FremontBridge,04/18/2015 03:00:00 PM,48,-122,94,133,227
22264,FremontBridge,04/18/2015 04:00:00 PM,48,-122,81,128,209
22265,FremontBridge,04/18/2015 05:00:00 PM,48,-122,88,109,197
22266,FremontBridge,04/18/2015 06:00:00 PM,48,-122,90,79,169
22267,FremontBridge,04/18/2015 07:00:00 PM,48,-122,49,68,117
22268,FremontBridge,04/18/2015 08:00:00 PM,48,-122,29,24,53
22269,FremontBridge,04/18/2015 09:00:00 PM,48,-122,26,17,43
22270,FremontBridge,04/18/2015 10:00:00 PM,48,-122,24,22,46
22271,FremontBridge,04/18/2015 11:00:00 PM,48,-122,15,17,32
22272,FremontBridge,04/19/2015 12:00:00 AM,48,-122,21,16,37
22273,FremontBridge,04/19/2015 01:00:00 AM,48,-122,9,2,11
22274,FremontBridge,04/19/2015 02:00:00 AM,48,-122,1,1,2
22275,FremontBridge,04/19/2015 03:00:00 AM,48,-122,6,138,144
22276,FremontBridge,04/19/2015 04:00:00 AM,48,-122,2,2,4
22277,FremontBridge,04/19/2015 05:00:00 AM,48,-122,4,3,7
22278,FremontBridge,04/19/2015 06:00:00 AM,48,-122,7,8,15
22279,FremontBridge,04/19/2015 07:00:00 AM,48,-122,15,15,30
22280,FremontBridge,04/19/2015 08:00:00 AM,48,-122,41,43,84
22281,FremontBridge,04/19/2015 09:00:00 AM,48,-122,62,51,113
22282,FremontBridge,04/19/2015 10:00:00 AM,48,-122,85,84,169
22283,FremontBridge,04/19/2015 11:00:00 AM,48,-122,110,142,252
22284,FremontBridge,04/19/2015 12:00:00 PM,48,-122,101,114,215
22285,FremontBridge,04/19/2015 01:00:00 PM,48,-122,154,140,294
22286,FremontBridge,04/19/2015 02:00:00 PM,48,-122,131,164,295
22287,FremontBridge,04/19/2015 03:00:00 PM,48,-122,118,153,271
22288,FremontBridge,04/19/2015 04:00:00 PM,48,-122,92,163,255
22289,FremontBridge,04/19/2015 05:00:00 PM,48,-122,98,95,193
22290,FremontBridge,04/19/2015 06:00:00 PM,48,-122,86,73,159
22291,FremontBridge,04/19/2015 07:00:00 PM,48,-122,54,52,106
22292,FremontBridge,04/19/2015 08:00:00 PM,48,-122,25,26,51
22293,FremontBridge,04/19/2015 09:00:00 PM,48,-122,15,19,34
22294,FremontBridge,04/19/2015 10:00:00 PM,48,-122,10,9,19
22295,FremontBridge,04/19/2015 11:00:00 PM,48,-122,9,6,15
22296,FremontBridge,04/20/2015 12:00:00 AM,48,-122,2,8,10
22297,FremontBridge,04/20/2015 01:00:00 AM,48,-122,2,5,7
22298,FremontBridge,04/20/2015 02:00:00 AM,48,-122,1,3,4
22299,FremontBridge,04/20/2015 03:00:00 AM,48,-122,1,3,4
22300,FremontBridge,04/20/2015 04:00:00 AM,48,-122,4,5,9
22301,FremontBridge,04/20/2015 05:00:00 AM,48,-122,14,26,40
22302,FremontBridge,04/20/2015 06:00:00 AM,48,-122,48,89,137
22303,FremontBridge,04/20/2015 07:00:00 AM,48,-122,107,291,398
22304,FremontBridge,04/20/2015 08:00:00 AM,48,-122,149,440,589
22305,FremontBridge,04/20/2015 09:00:00 AM,48,-122,104,215,319
22306,FremontBridge,04/20/2015 10:00:00 AM,48,-122,63,73,136
22307,FremontBridge,04/20/2015 11:00:00 AM,48,-122,44,55,99
22308,FremontBridge,04/20/2015 12:00:00 PM,48,-122,51,70,121
22309,FremontBridge,04/20/2015 01:00:00 PM,48,-122,72,68,140
22310,FremontBridge,04/20/2015 02:00:00 PM,48,-122,63,75,138
22311,FremontBridge,04/20/2015 03:00:00 PM,48,-122,104,83,187
22312,FremontBridge,04/20/2015 04:00:00 PM,48,-122,183,143,326
22313,FremontBridge,04/20/2015 05:00:00 PM,48,-122,525,214,739
22314,FremontBridge,04/20/2015 06:00:00 PM,48,-122,350,221,571
22315,FremontBridge,04/20/2015 07:00:00 PM,48,-122,174,106,280
22316,FremontBridge,04/20/2015 08:00:00 PM,48,-122,72,70,142
22317,FremontBridge,04/20/2015 09:00:00 PM,48,-122,38,35,73
22318,FremontBridge,04/20/2015 10:00:00 PM,48,-122,20,23,43
22319,FremontBridge,04/20/2015 11:00:00 PM,48,-122,23,21,44
22320,FremontBridge,04/21/2015 12:00:00 AM,48,-122,7,4,11
22321,FremontBridge,04/21/2015 01:00:00 AM,48,-122,3,0,3
22322,FremontBridge,04/21/2015 02:00:00 AM,48,-122,5,5,10
22323,FremontBridge,04/21/2015 03:00:00 AM,48,-122,2,3,5
22324,FremontBridge,04/21/2015 04:00:00 AM,48,-122,2,5,7
22325,FremontBridge,04/21/2015 05:00:00 AM,48,-122,13,31,44
22326,FremontBridge,04/21/2015 06:00:00 AM,48,-122,44,90,134
22327,FremontBridge,04/21/2015 07:00:00 AM,48,-122,88,300,388
22328,FremontBridge,04/21/2015 08:00:00 AM,48,-122,172,389,561
22329,FremontBridge,04/21/2015 09:00:00 AM,48,-122,132,207,339
22330,FremontBridge,04/21/2015 10:00:00 AM,48,-122,51,65,116
22331,FremontBridge,04/21/2015 11:00:00 AM,48,-122,,,
22332,FremontBridge,04/21/2015 12:00:00 PM,48,-122,,,
22333,FremontBridge,04/21/2015 01:00:00 PM,48,-122,30,24,54
22334,FremontBridge,04/21/2015 02:00:00 PM,48,-122,40,44,84
22335,FremontBridge,04/21/2015 03:00:00 PM,48,-122,76,63,139
22336,FremontBridge,04/21/2015 04:00:00 PM,48,-122,197,112,309
22337,FremontBridge,04/21/2015 05:00:00 PM,48,-122,379,153,532
22338,FremontBridge,04/21/2015 06:00:00 PM,48,-122,184,78,262
22339,FremontBridge,04/21/2015 07:00:00 PM,48,-122,86,51,137
22340,FremontBridge,04/21/2015 08:00:00 PM,48,-122,40,14,54
22341,FremontBridge,04/21/2015 09:00:00 PM,48,-122,14,12,26
22342,FremontBridge,04/21/2015 10:00:00 PM,48,-122,8,6,14
22343,FremontBridge,04/21/2015 11:00:00 PM,48,-122,9,5,14
22344,FremontBridge,04/22/2015 12:00:00 AM,48,-122,4,2,6
22345,FremontBridge,04/22/2015 01:00:00 AM,48,-122,2,2,4
22346,FremontBridge,04/22/2015 02:00:00 AM,48,-122,1,1,2
22347,FremontBridge,04/22/2015 03:00:00 AM,48,-122,4,2,6
22348,FremontBridge,04/22/2015 04:00:00 AM,48,-122,2,4,6
22349,FremontBridge,04/22/2015 05:00:00 AM,48,-122,16,16,32
22350,FremontBridge,04/22/2015 06:00:00 AM,48,-122,46,77,123
22351,FremontBridge,04/22/2015 07:00:00 AM,48,-122,67,229,296
22352,FremontBridge,04/22/2015 08:00:00 AM,48,-122,133,322,455
22353,FremontBridge,04/22/2015 09:00:00 AM,48,-122,84,132,216
22354,FremontBridge,04/22/2015 10:00:00 AM,48,-122,36,44,80
22355,FremontBridge,04/22/2015 11:00:00 AM,48,-122,61,100,161
22356,FremontBridge,04/22/2015 12:00:00 PM,48,-122,39,42,81
22357,FremontBridge,04/22/2015 01:00:00 PM,48,-122,32,41,73
22358,FremontBridge,04/22/2015 02:00:00 PM,48,-122,41,49,90
22359,FremontBridge,04/22/2015 03:00:00 PM,48,-122,62,63,125
22360,FremontBridge,04/22/2015 04:00:00 PM,48,-122,144,101,245
22361,FremontBridge,04/22/2015 05:00:00 PM,48,-122,353,163,516
22362,FremontBridge,04/22/2015 06:00:00 PM,48,-122,272,165,437
22363,FremontBridge,04/22/2015 07:00:00 PM,48,-122,99,69,168
22364,FremontBridge,04/22/2015 08:00:00 PM,48,-122,60,49,109
22365,FremontBridge,04/22/2015 09:00:00 PM,48,-122,34,29,63
22366,FremontBridge,04/22/2015 10:00:00 PM,48,-122,18,13,31
22367,FremontBridge,04/22/2015 11:00:00 PM,48,-122,17,9,26
22368,FremontBridge,04/23/2015 12:00:00 AM,48,-122,8,7,15
22369,FremontBridge,04/23/2015 01:00:00 AM,48,-122,0,1,1
22370,FremontBridge,04/23/2015 02:00:00 AM,48,-122,1,3,4
22371,FremontBridge,04/23/2015 03:00:00 AM,48,-122,4,2,6
22372,FremontBridge,04/23/2015 04:00:00 AM,48,-122,1,7,8
22373,FremontBridge,04/23/2015 05:00:00 AM,48,-122,9,17,26
22374,FremontBridge,04/23/2015 06:00:00 AM,48,-122,45,92,137
22375,FremontBridge,04/23/2015 07:00:00 AM,48,-122,76,224,300
22376,FremontBridge,04/23/2015 08:00:00 AM,48,-122,124,255,379
22377,FremontBridge,04/23/2015 09:00:00 AM,48,-122,76,114,190
22378,FremontBridge,04/23/2015 10:00:00 AM,48,-122,38,46,84
22379,FremontBridge,04/23/2015 11:00:00 AM,48,-122,14,24,38
22380,FremontBridge,04/23/2015 12:00:00 PM,48,-122,33,32,65
22381,FremontBridge,04/23/2015 01:00:00 PM,48,-122,16,22,38
22382,FremontBridge,04/23/2015 02:00:00 PM,48,-122,31,21,52
22383,FremontBridge,04/23/2015 03:00:00 PM,48,-122,42,32,74
22384,FremontBridge,04/23/2015 04:00:00 PM,48,-122,99,60,159
22385,FremontBridge,04/23/2015 05:00:00 PM,48,-122,244,116,360
22386,FremontBridge,04/23/2015 06:00:00 PM,48,-122,186,69,255
22387,FremontBridge,04/23/2015 07:00:00 PM,48,-122,83,41,124
22388,FremontBridge,04/23/2015 08:00:00 PM,48,-122,38,24,62
22389,FremontBridge,04/23/2015 09:00:00 PM,48,-122,28,19,47
22390,FremontBridge,04/23/2015 10:00:00 PM,48,-122,8,13,21
22391,FremontBridge,04/23/2015 11:00:00 PM,48,-122,7,6,13
22392,FremontBridge,04/24/2015 12:00:00 AM,48,-122,5,0,5
22393,FremontBridge,04/24/2015 01:00:00 AM,48,-122,4,3,7
22394,FremontBridge,04/24/2015 02:00:00 AM,48,-122,0,0,0
22395,FremontBridge,04/24/2015 03:00:00 AM,48,-122,4,1,5
22396,FremontBridge,04/24/2015 04:00:00 AM,48,-122,2,3,5
22397,FremontBridge,04/24/2015 05:00:00 AM,48,-122,5,18,23
22398,FremontBridge,04/24/2015 06:00:00 AM,48,-122,28,70,98
22399,FremontBridge,04/24/2015 07:00:00 AM,48,-122,51,181,232
22400,FremontBridge,04/24/2015 08:00:00 AM,48,-122,98,251,349
22401,FremontBridge,04/24/2015 09:00:00 AM,48,-122,59,107,166
22402,FremontBridge,04/24/2015 10:00:00 AM,48,-122,27,33,60
22403,FremontBridge,04/24/2015 11:00:00 AM,48,-122,25,25,50
22404,FremontBridge,04/24/2015 12:00:00 PM,48,-122,26,26,52
22405,FremontBridge,04/24/2015 01:00:00 PM,48,-122,28,42,70
22406,FremontBridge,04/24/2015 02:00:00 PM,48,-122,38,42,80
22407,FremontBridge,04/24/2015 03:00:00 PM,48,-122,77,42,119
22408,FremontBridge,04/24/2015 04:00:00 PM,48,-122,115,65,180
22409,FremontBridge,04/24/2015 05:00:00 PM,48,-122,244,95,339
22410,FremontBridge,04/24/2015 06:00:00 PM,48,-122,123,75,198
22411,FremontBridge,04/24/2015 07:00:00 PM,48,-122,80,36,116
22412,FremontBridge,04/24/2015 08:00:00 PM,48,-122,33,20,53
22413,FremontBridge,04/24/2015 09:00:00 PM,48,-122,20,8,28
22414,FremontBridge,04/24/2015 10:00:00 PM,48,-122,13,9,22
22415,FremontBridge,04/24/2015 11:00:00 PM,48,-122,13,6,19
22416,FremontBridge,04/25/2015 12:00:00 AM,48,-122,5,8,13
22417,FremontBridge,04/25/2015 01:00:00 AM,48,-122,5,4,9
22418,FremontBridge,04/25/2015 02:00:00 AM,48,-122,3,4,7
22419,FremontBridge,04/25/2015 03:00:00 AM,48,-122,4,2,6
22420,FremontBridge,04/25/2015 04:00:00 AM,48,-122,0,3,3
22421,FremontBridge,04/25/2015 05:00:00 AM,48,-122,3,7,10
22422,FremontBridge,04/25/2015 06:00:00 AM,48,-122,10,8,18
22423,FremontBridge,04/25/2015 07:00:00 AM,48,-122,19,19,38
22424,FremontBridge,04/25/2015 08:00:00 AM,48,-122,33,33,66
22425,FremontBridge,04/25/2015 09:00:00 AM,48,-122,35,45,80
22426,FremontBridge,04/25/2015 10:00:00 AM,48,-122,46,59,105
22427,FremontBridge,04/25/2015 11:00:00 AM,48,-122,58,55,113
22428,FremontBridge,04/25/2015 12:00:00 PM,48,-122,66,88,154
22429,FremontBridge,04/25/2015 01:00:00 PM,48,-122,64,78,142
22430,FremontBridge,04/25/2015 02:00:00 PM,48,-122,64,95,159
22431,FremontBridge,04/25/2015 03:00:00 PM,48,-122,70,67,137
22432,FremontBridge,04/25/2015 04:00:00 PM,48,-122,59,76,135
22433,FremontBridge,04/25/2015 05:00:00 PM,48,-122,56,91,147
22434,FremontBridge,04/25/2015 06:00:00 PM,48,-122,41,58,99
22435,FremontBridge,04/25/2015 07:00:00 PM,48,-122,36,21,57
22436,FremontBridge,04/25/2015 08:00:00 PM,48,-122,22,19,41
22437,FremontBridge,04/25/2015 09:00:00 PM,48,-122,14,11,25
22438,FremontBridge,04/25/2015 10:00:00 PM,48,-122,9,10,19
22439,FremontBridge,04/25/2015 11:00:00 PM,48,-122,18,15,33
22440,FremontBridge,04/26/2015 12:00:00 AM,48,-122,10,5,15
22441,FremontBridge,04/26/2015 01:00:00 AM,48,-122,3,6,9
22442,FremontBridge,04/26/2015 02:00:00 AM,48,-122,0,3,3
22443,FremontBridge,04/26/2015 03:00:00 AM,48,-122,2,1,3
22444,FremontBridge,04/26/2015 04:00:00 AM,48,-122,2,1,3
22445,FremontBridge,04/26/2015 05:00:00 AM,48,-122,0,2,2
22446,FremontBridge,04/26/2015 06:00:00 AM,48,-122,6,8,14
22447,FremontBridge,04/26/2015 07:00:00 AM,48,-122,15,18,33
22448,FremontBridge,04/26/2015 08:00:00 AM,48,-122,28,29,57
22449,FremontBridge,04/26/2015 09:00:00 AM,48,-122,44,41,85
22450,FremontBridge,04/26/2015 10:00:00 AM,48,-122,42,61,103
22451,FremontBridge,04/26/2015 11:00:00 AM,48,-122,68,68,136
22452,FremontBridge,04/26/2015 12:00:00 PM,48,-122,71,80,151
22453,FremontBridge,04/26/2015 01:00:00 PM,48,-122,60,83,143
22454,FremontBridge,04/26/2015 02:00:00 PM,48,-122,52,78,130
22455,FremontBridge,04/26/2015 03:00:00 PM,48,-122,67,84,151
22456,FremontBridge,04/26/2015 04:00:00 PM,48,-122,60,87,147
22457,FremontBridge,04/26/2015 05:00:00 PM,48,-122,65,98,163
22458,FremontBridge,04/26/2015 06:00:00 PM,48,-122,33,38,71
22459,FremontBridge,04/26/2015 07:00:00 PM,48,-122,23,17,40
22460,FremontBridge,04/26/2015 08:00:00 PM,48,-122,14,16,30
22461,FremontBridge,04/26/2015 09:00:00 PM,48,-122,35,10,45
22462,FremontBridge,04/26/2015 10:00:00 PM,48,-122,6,6,12
22463,FremontBridge,04/26/2015 11:00:00 PM,48,-122,17,3,20
22464,FremontBridge,04/27/2015 12:00:00 AM,48,-122,0,4,4
22465,FremontBridge,04/27/2015 01:00:00 AM,48,-122,2,0,2
22466,FremontBridge,04/27/2015 02:00:00 AM,48,-122,2,1,3
22467,FremontBridge,04/27/2015 03:00:00 AM,48,-122,0,5,5
22468,FremontBridge,04/27/2015 04:00:00 AM,48,-122,2,7,9
22469,FremontBridge,04/27/2015 05:00:00 AM,48,-122,14,30,44
22470,FremontBridge,04/27/2015 06:00:00 AM,48,-122,40,126,166
22471,FremontBridge,04/27/2015 07:00:00 AM,48,-122,63,274,337
22472,FremontBridge,04/27/2015 08:00:00 AM,48,-122,153,334,487
22473,FremontBridge,04/27/2015 09:00:00 AM,48,-122,87,153,240
22474,FremontBridge,04/27/2015 10:00:00 AM,48,-122,34,48,82
22475,FremontBridge,04/27/2015 11:00:00 AM,48,-122,30,48,78
22476,FremontBridge,04/27/2015 12:00:00 PM,48,-122,63,42,105
22477,FremontBridge,04/27/2015 01:00:00 PM,48,-122,53,51,104
22478,FremontBridge,04/27/2015 02:00:00 PM,48,-122,48,64,112
22479,FremontBridge,04/27/2015 03:00:00 PM,48,-122,94,84,178
22480,FremontBridge,04/27/2015 04:00:00 PM,48,-122,230,140,370
22481,FremontBridge,04/27/2015 05:00:00 PM,48,-122,504,222,726
22482,FremontBridge,04/27/2015 06:00:00 PM,48,-122,316,190,506
22483,FremontBridge,04/27/2015 07:00:00 PM,48,-122,135,139,274
22484,FremontBridge,04/27/2015 08:00:00 PM,48,-122,72,93,165
22485,FremontBridge,04/27/2015 09:00:00 PM,48,-122,32,31,63
22486,FremontBridge,04/27/2015 10:00:00 PM,48,-122,27,29,56
22487,FremontBridge,04/27/2015 11:00:00 PM,48,-122,14,10,24
22488,FremontBridge,04/28/2015 12:00:00 AM,48,-122,6,2,8
22489,FremontBridge,04/28/2015 01:00:00 AM,48,-122,1,1,2
22490,FremontBridge,04/28/2015 02:00:00 AM,48,-122,1,3,4
22491,FremontBridge,04/28/2015 03:00:00 AM,48,-122,1,10,11
22492,FremontBridge,04/28/2015 04:00:00 AM,48,-122,3,3,6
22493,FremontBridge,04/28/2015 05:00:00 AM,48,-122,14,29,43
22494,FremontBridge,04/28/2015 06:00:00 AM,48,-122,45,93,138
22495,FremontBridge,04/28/2015 07:00:00 AM,48,-122,79,255,334
22496,FremontBridge,04/28/2015 08:00:00 AM,48,-122,142,314,456
22497,FremontBridge,04/28/2015 09:00:00 AM,48,-122,63,112,175
22498,FremontBridge,04/28/2015 10:00:00 AM,48,-122,33,46,79
22499,FremontBridge,04/28/2015 11:00:00 AM,48,-122,29,38,67
22500,FremontBridge,04/28/2015 12:00:00 PM,48,-122,23,31,54
22501,FremontBridge,04/28/2015 01:00:00 PM,48,-122,34,19,53
22502,FremontBridge,04/28/2015 02:00:00 PM,48,-122,25,24,49
22503,FremontBridge,04/28/2015 03:00:00 PM,48,-122,56,37,93
22504,FremontBridge,04/28/2015 04:00:00 PM,48,-122,149,73,222
22505,FremontBridge,04/28/2015 05:00:00 PM,48,-122,270,118,388
22506,FremontBridge,04/28/2015 06:00:00 PM,48,-122,200,96,296
22507,FremontBridge,04/28/2015 07:00:00 PM,48,-122,75,36,111
22508,FremontBridge,04/28/2015 08:00:00 PM,48,-122,44,28,72
22509,FremontBridge,04/28/2015 09:00:00 PM,48,-122,22,19,41
22510,FremontBridge,04/28/2015 10:00:00 PM,48,-122,15,13,28
22511,FremontBridge,04/28/2015 11:00:00 PM,48,-122,10,5,15
22512,FremontBridge,04/29/2015 12:00:00 AM,48,-122,2,2,4
22513,FremontBridge,04/29/2015 01:00:00 AM,48,-122,0,4,4
22514,FremontBridge,04/29/2015 02:00:00 AM,48,-122,1,2,3
22515,FremontBridge,04/29/2015 03:00:00 AM,48,-122,1,4,5
22516,FremontBridge,04/29/2015 04:00:00 AM,48,-122,2,5,7
22517,FremontBridge,04/29/2015 05:00:00 AM,48,-122,13,26,39
22518,FremontBridge,04/29/2015 06:00:00 AM,48,-122,48,75,123
22519,FremontBridge,04/29/2015 07:00:00 AM,48,-122,87,259,346
22520,FremontBridge,04/29/2015 08:00:00 AM,48,-122,149,295,444
22521,FremontBridge,04/29/2015 09:00:00 AM,48,-122,83,129,212
22522,FremontBridge,04/29/2015 10:00:00 AM,48,-122,39,57,96
22523,FremontBridge,04/29/2015 11:00:00 AM,48,-122,36,32,68
22524,FremontBridge,04/29/2015 12:00:00 PM,48,-122,30,56,86
22525,FremontBridge,04/29/2015 01:00:00 PM,48,-122,49,57,106
22526,FremontBridge,04/29/2015 02:00:00 PM,48,-122,46,36,82
22527,FremontBridge,04/29/2015 03:00:00 PM,48,-122,63,50,113
22528,FremontBridge,04/29/2015 04:00:00 PM,48,-122,171,91,262
22529,FremontBridge,04/29/2015 05:00:00 PM,48,-122,390,201,591
22530,FremontBridge,04/29/2015 06:00:00 PM,48,-122,239,146,385
22531,FremontBridge,04/29/2015 07:00:00 PM,48,-122,140,74,214
22532,FremontBridge,04/29/2015 08:00:00 PM,48,-122,71,48,119
22533,FremontBridge,04/29/2015 09:00:00 PM,48,-122,40,30,70
22534,FremontBridge,04/29/2015 10:00:00 PM,48,-122,18,18,36
22535,FremontBridge,04/29/2015 11:00:00 PM,48,-122,10,12,22
22536,FremontBridge,04/30/2015 12:00:00 AM,48,-122,1,6,7
22537,FremontBridge,04/30/2015 01:00:00 AM,48,-122,1,4,5
22538,FremontBridge,04/30/2015 02:00:00 AM,48,-122,0,2,2
22539,FremontBridge,04/30/2015 03:00:00 AM,48,-122,2,4,6
22540,FremontBridge,04/30/2015 04:00:00 AM,48,-122,6,5,11
22541,FremontBridge,04/30/2015 05:00:00 AM,48,-122,14,25,39
22542,FremontBridge,04/30/2015 06:00:00 AM,48,-122,58,94,152
22543,FremontBridge,04/30/2015 07:00:00 AM,48,-122,86,263,349
22544,FremontBridge,04/30/2015 08:00:00 AM,48,-122,156,319,475
22545,FremontBridge,04/30/2015 09:00:00 AM,48,-122,101,139,240
22546,FremontBridge,04/30/2015 10:00:00 AM,48,-122,34,53,87
22547,FremontBridge,04/30/2015 11:00:00 AM,48,-122,35,56,91
22548,FremontBridge,04/30/2015 12:00:00 PM,48,-122,28,42,70
22549,FremontBridge,04/30/2015 01:00:00 PM,48,-122,41,45,86
22550,FremontBridge,04/30/2015 02:00:00 PM,48,-122,49,47,96
22551,FremontBridge,04/30/2015 03:00:00 PM,48,-122,97,68,165
22552,FremontBridge,04/30/2015 04:00:00 PM,48,-122,176,123,299
22553,FremontBridge,04/30/2015 05:00:00 PM,48,-122,417,193,610
22554,FremontBridge,04/30/2015 06:00:00 PM,48,-122,264,134,398
22555,FremontBridge,04/30/2015 07:00:00 PM,48,-122,104,77,181
22556,FremontBridge,04/30/2015 08:00:00 PM,48,-122,63,47,110
22557,FremontBridge,04/30/2015 09:00:00 PM,48,-122,34,21,55
22558,FremontBridge,04/30/2015 10:00:00 PM,48,-122,28,21,49
22559,FremontBridge,04/30/2015 11:00:00 PM,48,-122,19,6,25
22560,FremontBridge,05/01/2015 12:00:00 AM,48,-122,14,5,19
22561,FremontBridge,05/01/2015 01:00:00 AM,48,-122,3,1,4
22562,FremontBridge,05/01/2015 02:00:00 AM,48,-122,6,1,7
22563,FremontBridge,05/01/2015 03:00:00 AM,48,-122,2,3,5
22564,FremontBridge,05/01/2015 04:00:00 AM,48,-122,0,8,8
22565,FremontBridge,05/01/2015 05:00:00 AM,48,-122,15,29,44
22566,FremontBridge,05/01/2015 06:00:00 AM,48,-122,54,110,164
22567,FremontBridge,05/01/2015 07:00:00 AM,48,-122,94,390,484
22568,FremontBridge,05/01/2015 08:00:00 AM,48,-122,164,399,563
22569,FremontBridge,05/01/2015 09:00:00 AM,48,-122,100,151,251
22570,FremontBridge,05/01/2015 10:00:00 AM,48,-122,46,67,113
22571,FremontBridge,05/01/2015 11:00:00 AM,48,-122,47,49,96
22572,FremontBridge,05/01/2015 12:00:00 PM,48,-122,47,57,104
22573,FremontBridge,05/01/2015 01:00:00 PM,48,-122,66,57,123
22574,FremontBridge,05/01/2015 02:00:00 PM,48,-122,85,73,158
22575,FremontBridge,05/01/2015 03:00:00 PM,48,-122,183,89,272
22576,FremontBridge,05/01/2015 04:00:00 PM,48,-122,326,149,475
22577,FremontBridge,05/01/2015 05:00:00 PM,48,-122,418,211,629
22578,FremontBridge,05/01/2015 06:00:00 PM,48,-122,206,126,332
22579,FremontBridge,05/01/2015 07:00:00 PM,48,-122,95,80,175
22580,FremontBridge,05/01/2015 08:00:00 PM,48,-122,43,42,85
22581,FremontBridge,05/01/2015 09:00:00 PM,48,-122,30,18,48
22582,FremontBridge,05/01/2015 10:00:00 PM,48,-122,13,19,32
22583,FremontBridge,05/01/2015 11:00:00 PM,48,-122,22,11,33
22584,FremontBridge,05/02/2015 12:00:00 AM,48,-122,7,9,16
22585,FremontBridge,05/02/2015 01:00:00 AM,48,-122,7,4,11
22586,FremontBridge,05/02/2015 02:00:00 AM,48,-122,3,1,4
22587,FremontBridge,05/02/2015 03:00:00 AM,48,-122,2,2,4
22588,FremontBridge,05/02/2015 04:00:00 AM,48,-122,2,2,4
22589,FremontBridge,05/02/2015 05:00:00 AM,48,-122,3,8,11
22590,FremontBridge,05/02/2015 06:00:00 AM,48,-122,15,18,33
22591,FremontBridge,05/02/2015 07:00:00 AM,48,-122,29,40,69
22592,FremontBridge,05/02/2015 08:00:00 AM,48,-122,44,53,97
22593,FremontBridge,05/02/2015 09:00:00 AM,48,-122,62,95,157
22594,FremontBridge,05/02/2015 10:00:00 AM,48,-122,59,78,137
22595,FremontBridge,05/02/2015 11:00:00 AM,48,-122,74,78,152
22596,FremontBridge,05/02/2015 12:00:00 PM,48,-122,78,127,205
22597,FremontBridge,05/02/2015 01:00:00 PM,48,-122,79,103,182
22598,FremontBridge,05/02/2015 02:00:00 PM,48,-122,93,92,185
22599,FremontBridge,05/02/2015 03:00:00 PM,48,-122,103,100,203
22600,FremontBridge,05/02/2015 04:00:00 PM,48,-122,88,98,186
22601,FremontBridge,05/02/2015 05:00:00 PM,48,-122,95,83,178
22602,FremontBridge,05/02/2015 06:00:00 PM,48,-122,50,93,143
22603,FremontBridge,05/02/2015 07:00:00 PM,48,-122,36,41,77
22604,FremontBridge,05/02/2015 08:00:00 PM,48,-122,31,37,68
22605,FremontBridge,05/02/2015 09:00:00 PM,48,-122,13,8,21
22606,FremontBridge,05/02/2015 10:00:00 PM,48,-122,14,27,41
22607,FremontBridge,05/02/2015 11:00:00 PM,48,-122,19,12,31
22608,FremontBridge,05/03/2015 12:00:00 AM,48,-122,11,10,21
22609,FremontBridge,05/03/2015 01:00:00 AM,48,-122,6,2,8
22610,FremontBridge,05/03/2015 02:00:00 AM,48,-122,4,1,5
22611,FremontBridge,05/03/2015 03:00:00 AM,48,-122,3,1,4
22612,FremontBridge,05/03/2015 04:00:00 AM,48,-122,0,2,2
22613,FremontBridge,05/03/2015 05:00:00 AM,48,-122,4,5,9
22614,FremontBridge,05/03/2015 06:00:00 AM,48,-122,14,9,23
22615,FremontBridge,05/03/2015 07:00:00 AM,48,-122,20,32,52
22616,FremontBridge,05/03/2015 08:00:00 AM,48,-122,32,34,66
22617,FremontBridge,05/03/2015 09:00:00 AM,48,-122,37,72,109
22618,FremontBridge,05/03/2015 10:00:00 AM,48,-122,84,108,192
22619,FremontBridge,05/03/2015 11:00:00 AM,48,-122,91,83,174
22620,FremontBridge,05/03/2015 12:00:00 PM,48,-122,96,100,196
22621,FremontBridge,05/03/2015 01:00:00 PM,48,-122,83,138,221
22622,FremontBridge,05/03/2015 02:00:00 PM,48,-122,88,127,215
22623,FremontBridge,05/03/2015 03:00:00 PM,48,-122,91,131,222
22624,FremontBridge,05/03/2015 04:00:00 PM,48,-122,98,114,212
22625,FremontBridge,05/03/2015 05:00:00 PM,48,-122,67,113,180
22626,FremontBridge,05/03/2015 06:00:00 PM,48,-122,51,78,129
22627,FremontBridge,05/03/2015 07:00:00 PM,48,-122,36,42,78
22628,FremontBridge,05/03/2015 08:00:00 PM,48,-122,25,25,50
22629,FremontBridge,05/03/2015 09:00:00 PM,48,-122,8,20,28
22630,FremontBridge,05/03/2015 10:00:00 PM,48,-122,17,10,27
22631,FremontBridge,05/03/2015 11:00:00 PM,48,-122,12,0,12
22632,FremontBridge,05/04/2015 12:00:00 AM,48,-122,4,8,12
22633,FremontBridge,05/04/2015 01:00:00 AM,48,-122,2,3,5
22634,FremontBridge,05/04/2015 02:00:00 AM,48,-122,0,3,3
22635,FremontBridge,05/04/2015 03:00:00 AM,48,-122,2,2,4
22636,FremontBridge,05/04/2015 04:00:00 AM,48,-122,3,8,11
22637,FremontBridge,05/04/2015 05:00:00 AM,48,-122,17,34,51
22638,FremontBridge,05/04/2015 06:00:00 AM,48,-122,73,139,212
22639,FremontBridge,05/04/2015 07:00:00 AM,48,-122,106,403,509
22640,FremontBridge,05/04/2015 08:00:00 AM,48,-122,196,461,657
22641,FremontBridge,05/04/2015 09:00:00 AM,48,-122,101,173,274
22642,FremontBridge,05/04/2015 10:00:00 AM,48,-122,38,73,111
22643,FremontBridge,05/04/2015 11:00:00 AM,48,-122,45,35,80
22644,FremontBridge,05/04/2015 12:00:00 PM,48,-122,52,40,92
22645,FremontBridge,05/04/2015 01:00:00 PM,48,-122,32,58,90
22646,FremontBridge,05/04/2015 02:00:00 PM,48,-122,56,61,117
22647,FremontBridge,05/04/2015 03:00:00 PM,48,-122,90,75,165
22648,FremontBridge,05/04/2015 04:00:00 PM,48,-122,263,138,401
22649,FremontBridge,05/04/2015 05:00:00 PM,48,-122,571,208,779
22650,FremontBridge,05/04/2015 06:00:00 PM,48,-122,351,163,514
22651,FremontBridge,05/04/2015 07:00:00 PM,48,-122,131,86,217
22652,FremontBridge,05/04/2015 08:00:00 PM,48,-122,45,48,93
22653,FremontBridge,05/04/2015 09:00:00 PM,48,-122,48,23,71
22654,FremontBridge,05/04/2015 10:00:00 PM,48,-122,19,16,35
22655,FremontBridge,05/04/2015 11:00:00 PM,48,-122,9,8,17
22656,FremontBridge,05/05/2015 12:00:00 AM,48,-122,4,2,6
22657,FremontBridge,05/05/2015 01:00:00 AM,48,-122,1,4,5
22658,FremontBridge,05/05/2015 02:00:00 AM,48,-122,1,1,2
22659,FremontBridge,05/05/2015 03:00:00 AM,48,-122,1,2,3
22660,FremontBridge,05/05/2015 04:00:00 AM,48,-122,2,4,6
22661,FremontBridge,05/05/2015 05:00:00 AM,48,-122,10,26,36
22662,FremontBridge,05/05/2015 06:00:00 AM,48,-122,27,73,100
22663,FremontBridge,05/05/2015 07:00:00 AM,48,-122,84,245,329
22664,FremontBridge,05/05/2015 08:00:00 AM,48,-122,142,312,454
22665,FremontBridge,05/05/2015 09:00:00 AM,48,-122,72,122,194
22666,FremontBridge,05/05/2015 10:00:00 AM,48,-122,30,54,84
22667,FremontBridge,05/05/2015 11:00:00 AM,48,-122,20,30,50
22668,FremontBridge,05/05/2015 12:00:00 PM,48,-122,24,29,53
22669,FremontBridge,05/05/2015 01:00:00 PM,48,-122,22,20,42
22670,FremontBridge,05/05/2015 02:00:00 PM,48,-122,26,22,48
22671,FremontBridge,05/05/2015 03:00:00 PM,48,-122,41,40,81
22672,FremontBridge,05/05/2015 04:00:00 PM,48,-122,129,56,185
22673,FremontBridge,05/05/2015 05:00:00 PM,48,-122,322,136,458
22674,FremontBridge,05/05/2015 06:00:00 PM,48,-122,177,67,244
22675,FremontBridge,05/05/2015 07:00:00 PM,48,-122,67,25,92
22676,FremontBridge,05/05/2015 08:00:00 PM,48,-122,37,23,60
22677,FremontBridge,05/05/2015 09:00:00 PM,48,-122,21,15,36
22678,FremontBridge,05/05/2015 10:00:00 PM,48,-122,15,13,28
22679,FremontBridge,05/05/2015 11:00:00 PM,48,-122,7,2,9
22680,FremontBridge,05/06/2015 12:00:00 AM,48,-122,4,2,6
22681,FremontBridge,05/06/2015 01:00:00 AM,48,-122,3,6,9
22682,FremontBridge,05/06/2015 02:00:00 AM,48,-122,0,1,1
22683,FremontBridge,05/06/2015 03:00:00 AM,48,-122,2,2,4
22684,FremontBridge,05/06/2015 04:00:00 AM,48,-122,4,8,12
22685,FremontBridge,05/06/2015 05:00:00 AM,48,-122,17,24,41
22686,FremontBridge,05/06/2015 06:00:00 AM,48,-122,53,115,168
22687,FremontBridge,05/06/2015 07:00:00 AM,48,-122,102,396,498
22688,FremontBridge,05/06/2015 08:00:00 AM,48,-122,168,424,592
22689,FremontBridge,05/06/2015 09:00:00 AM,48,-122,103,150,253
22690,FremontBridge,05/06/2015 10:00:00 AM,48,-122,46,66,112
22691,FremontBridge,05/06/2015 11:00:00 AM,48,-122,30,42,72
22692,FremontBridge,05/06/2015 12:00:00 PM,48,-122,25,45,70
22693,FremontBridge,05/06/2015 01:00:00 PM,48,-122,38,52,90
22694,FremontBridge,05/06/2015 02:00:00 PM,48,-122,54,45,99
22695,FremontBridge,05/06/2015 03:00:00 PM,48,-122,95,73,168
22696,FremontBridge,05/06/2015 04:00:00 PM,48,-122,198,134,332
22697,FremontBridge,05/06/2015 05:00:00 PM,48,-122,464,220,684
22698,FremontBridge,05/06/2015 06:00:00 PM,48,-122,327,175,502
22699,FremontBridge,05/06/2015 07:00:00 PM,48,-122,148,76,224
22700,FremontBridge,05/06/2015 08:00:00 PM,48,-122,90,56,146
22701,FremontBridge,05/06/2015 09:00:00 PM,48,-122,43,23,66
22702,FremontBridge,05/06/2015 10:00:00 PM,48,-122,21,26,47
22703,FremontBridge,05/06/2015 11:00:00 PM,48,-122,20,15,35
22704,FremontBridge,05/07/2015 12:00:00 AM,48,-122,10,9,19
22705,FremontBridge,05/07/2015 01:00:00 AM,48,-122,5,5,10
22706,FremontBridge,05/07/2015 02:00:00 AM,48,-122,0,1,1
22707,FremontBridge,05/07/2015 03:00:00 AM,48,-122,2,3,5
22708,FremontBridge,05/07/2015 04:00:00 AM,48,-122,2,10,12
22709,FremontBridge,05/07/2015 05:00:00 AM,48,-122,23,24,47
22710,FremontBridge,05/07/2015 06:00:00 AM,48,-122,80,222,302
22711,FremontBridge,05/07/2015 07:00:00 AM,48,-122,126,404,530
22712,FremontBridge,05/07/2015 08:00:00 AM,48,-122,185,430,615
22713,FremontBridge,05/07/2015 09:00:00 AM,48,-122,116,195,311
22714,FremontBridge,05/07/2015 10:00:00 AM,48,-122,47,90,137
22715,FremontBridge,05/07/2015 11:00:00 AM,48,-122,50,48,98
22716,FremontBridge,05/07/2015 12:00:00 PM,48,-122,56,63,119
22717,FremontBridge,05/07/2015 01:00:00 PM,48,-122,50,73,123
22718,FremontBridge,05/07/2015 02:00:00 PM,48,-122,69,52,121
22719,FremontBridge,05/07/2015 03:00:00 PM,48,-122,104,84,188
22720,FremontBridge,05/07/2015 04:00:00 PM,48,-122,239,144,383
22721,FremontBridge,05/07/2015 05:00:00 PM,48,-122,556,252,808
22722,FremontBridge,05/07/2015 06:00:00 PM,48,-122,332,157,489
22723,FremontBridge,05/07/2015 07:00:00 PM,48,-122,138,109,247
22724,FremontBridge,05/07/2015 08:00:00 PM,48,-122,95,67,162
22725,FremontBridge,05/07/2015 09:00:00 PM,48,-122,50,42,92
22726,FremontBridge,05/07/2015 10:00:00 PM,48,-122,35,28,63
22727,FremontBridge,05/07/2015 11:00:00 PM,48,-122,21,13,34
22728,FremontBridge,05/08/2015 12:00:00 AM,48,-122,11,8,19
22729,FremontBridge,05/08/2015 01:00:00 AM,48,-122,3,1,4
22730,FremontBridge,05/08/2015 02:00:00 AM,48,-122,3,1,4
22731,FremontBridge,05/08/2015 03:00:00 AM,48,-122,4,6,10
22732,FremontBridge,05/08/2015 04:00:00 AM,48,-122,4,6,10
22733,FremontBridge,05/08/2015 05:00:00 AM,48,-122,22,26,48
22734,FremontBridge,05/08/2015 06:00:00 AM,48,-122,58,134,192
22735,FremontBridge,05/08/2015 07:00:00 AM,48,-122,117,366,483
22736,FremontBridge,05/08/2015 08:00:00 AM,48,-122,155,446,601
22737,FremontBridge,05/08/2015 09:00:00 AM,48,-122,104,154,258
22738,FremontBridge,05/08/2015 10:00:00 AM,48,-122,50,70,120
22739,FremontBridge,05/08/2015 11:00:00 AM,48,-122,46,58,104
22740,FremontBridge,05/08/2015 12:00:00 PM,48,-122,51,54,105
22741,FremontBridge,05/08/2015 01:00:00 PM,48,-122,55,56,111
22742,FremontBridge,05/08/2015 02:00:00 PM,48,-122,96,73,169
22743,FremontBridge,05/08/2015 03:00:00 PM,48,-122,143,88,231
22744,FremontBridge,05/08/2015 04:00:00 PM,48,-122,323,152,475
22745,FremontBridge,05/08/2015 05:00:00 PM,48,-122,487,211,698
22746,FremontBridge,05/08/2015 06:00:00 PM,48,-122,212,139,351
22747,FremontBridge,05/08/2015 07:00:00 PM,48,-122,113,76,189
22748,FremontBridge,05/08/2015 08:00:00 PM,48,-122,57,62,119
22749,FremontBridge,05/08/2015 09:00:00 PM,48,-122,32,25,57
22750,FremontBridge,05/08/2015 10:00:00 PM,48,-122,32,27,59
22751,FremontBridge,05/08/2015 11:00:00 PM,48,-122,26,9,35
22752,FremontBridge,05/09/2015 12:00:00 AM,48,-122,18,6,24
22753,FremontBridge,05/09/2015 01:00:00 AM,48,-122,4,3,7
22754,FremontBridge,05/09/2015 02:00:00 AM,48,-122,4,4,8
22755,FremontBridge,05/09/2015 03:00:00 AM,48,-122,2,1,3
22756,FremontBridge,05/09/2015 04:00:00 AM,48,-122,1,2,3
22757,FremontBridge,05/09/2015 05:00:00 AM,48,-122,2,9,11
22758,FremontBridge,05/09/2015 06:00:00 AM,48,-122,8,14,22
22759,FremontBridge,05/09/2015 07:00:00 AM,48,-122,36,33,69
22760,FremontBridge,05/09/2015 08:00:00 AM,48,-122,43,62,105
22761,FremontBridge,05/09/2015 09:00:00 AM,48,-122,56,71,127
22762,FremontBridge,05/09/2015 10:00:00 AM,48,-122,59,80,139
22763,FremontBridge,05/09/2015 11:00:00 AM,48,-122,101,95,196
22764,FremontBridge,05/09/2015 12:00:00 PM,48,-122,99,127,226
22765,FremontBridge,05/09/2015 01:00:00 PM,48,-122,88,126,214
22766,FremontBridge,05/09/2015 02:00:00 PM,48,-122,96,103,199
22767,FremontBridge,05/09/2015 03:00:00 PM,48,-122,185,131,316
22768,FremontBridge,05/09/2015 04:00:00 PM,48,-122,177,160,337
22769,FremontBridge,05/09/2015 05:00:00 PM,48,-122,90,150,240
22770,FremontBridge,05/09/2015 06:00:00 PM,48,-122,84,92,176
22771,FremontBridge,05/09/2015 07:00:00 PM,48,-122,47,63,110
22772,FremontBridge,05/09/2015 08:00:00 PM,48,-122,44,40,84
22773,FremontBridge,05/09/2015 09:00:00 PM,48,-122,31,18,49
22774,FremontBridge,05/09/2015 10:00:00 PM,48,-122,24,29,53
22775,FremontBridge,05/09/2015 11:00:00 PM,48,-122,19,16,35
22776,FremontBridge,05/10/2015 12:00:00 AM,48,-122,16,15,31
22777,FremontBridge,05/10/2015 01:00:00 AM,48,-122,5,1,6
22778,FremontBridge,05/10/2015 02:00:00 AM,48,-122,0,3,3
22779,FremontBridge,05/10/2015 03:00:00 AM,48,-122,3,1,4
22780,FremontBridge,05/10/2015 04:00:00 AM,48,-122,1,1,2
22781,FremontBridge,05/10/2015 05:00:00 AM,48,-122,4,2,6
22782,FremontBridge,05/10/2015 06:00:00 AM,48,-122,4,8,12
22783,FremontBridge,05/10/2015 07:00:00 AM,48,-122,24,18,42
22784,FremontBridge,05/10/2015 08:00:00 AM,48,-122,40,35,75
22785,FremontBridge,05/10/2015 09:00:00 AM,48,-122,38,67,105
22786,FremontBridge,05/10/2015 10:00:00 AM,48,-122,48,80,128
22787,FremontBridge,05/10/2015 11:00:00 AM,48,-122,92,102,194
22788,FremontBridge,05/10/2015 12:00:00 PM,48,-122,74,90,164
22789,FremontBridge,05/10/2015 01:00:00 PM,48,-122,78,109,187
22790,FremontBridge,05/10/2015 02:00:00 PM,48,-122,76,108,184
22791,FremontBridge,05/10/2015 03:00:00 PM,48,-122,85,117,202
22792,FremontBridge,05/10/2015 04:00:00 PM,48,-122,66,91,157
22793,FremontBridge,05/10/2015 05:00:00 PM,48,-122,74,88,162
22794,FremontBridge,05/10/2015 06:00:00 PM,48,-122,48,52,100
22795,FremontBridge,05/10/2015 07:00:00 PM,48,-122,31,49,80
22796,FremontBridge,05/10/2015 08:00:00 PM,48,-122,16,21,37
22797,FremontBridge,05/10/2015 09:00:00 PM,48,-122,27,13,40
22798,FremontBridge,05/10/2015 10:00:00 PM,48,-122,16,6,22
22799,FremontBridge,05/10/2015 11:00:00 PM,48,-122,10,5,15
22800,FremontBridge,05/11/2015 12:00:00 AM,48,-122,4,3,7
22801,FremontBridge,05/11/2015 01:00:00 AM,48,-122,2,2,4
22802,FremontBridge,05/11/2015 02:00:00 AM,48,-122,1,2,3
22803,FremontBridge,05/11/2015 03:00:00 AM,48,-122,0,1,1
22804,FremontBridge,05/11/2015 04:00:00 AM,48,-122,2,9,11
22805,FremontBridge,05/11/2015 05:00:00 AM,48,-122,20,23,43
22806,FremontBridge,05/11/2015 06:00:00 AM,48,-122,51,110,161
22807,FremontBridge,05/11/2015 07:00:00 AM,48,-122,105,359,464
22808,FremontBridge,05/11/2015 08:00:00 AM,48,-122,150,415,565
22809,FremontBridge,05/11/2015 09:00:00 AM,48,-122,91,151,242
22810,FremontBridge,05/11/2015 10:00:00 AM,48,-122,41,62,103
22811,FremontBridge,05/11/2015 11:00:00 AM,48,-122,21,51,72
22812,FremontBridge,05/11/2015 12:00:00 PM,48,-122,28,28,56
22813,FremontBridge,05/11/2015 01:00:00 PM,48,-122,25,40,65
22814,FremontBridge,05/11/2015 02:00:00 PM,48,-122,45,49,94
22815,FremontBridge,05/11/2015 03:00:00 PM,48,-122,72,41,113
22816,FremontBridge,05/11/2015 04:00:00 PM,48,-122,182,91,273
22817,FremontBridge,05/11/2015 05:00:00 PM,48,-122,496,154,650
22818,FremontBridge,05/11/2015 06:00:00 PM,48,-122,261,127,388
22819,FremontBridge,05/11/2015 07:00:00 PM,48,-122,123,58,181
22820,FremontBridge,05/11/2015 08:00:00 PM,48,-122,45,34,79
22821,FremontBridge,05/11/2015 09:00:00 PM,48,-122,30,25,55
22822,FremontBridge,05/11/2015 10:00:00 PM,48,-122,19,11,30
22823,FremontBridge,05/11/2015 11:00:00 PM,48,-122,13,3,16
22824,FremontBridge,05/12/2015 12:00:00 AM,48,-122,6,3,9
22825,FremontBridge,05/12/2015 01:00:00 AM,48,-122,6,1,7
22826,FremontBridge,05/12/2015 02:00:00 AM,48,-122,1,0,1
22827,FremontBridge,05/12/2015 03:00:00 AM,48,-122,3,3,6
22828,FremontBridge,05/12/2015 04:00:00 AM,48,-122,7,5,12
22829,FremontBridge,05/12/2015 05:00:00 AM,48,-122,13,35,48
22830,FremontBridge,05/12/2015 06:00:00 AM,48,-122,54,120,174
22831,FremontBridge,05/12/2015 07:00:00 AM,48,-122,126,341,467
22832,FremontBridge,05/12/2015 08:00:00 AM,48,-122,145,330,475
22833,FremontBridge,05/12/2015 09:00:00 AM,48,-122,86,145,231
22834,FremontBridge,05/12/2015 10:00:00 AM,48,-122,35,59,94
22835,FremontBridge,05/12/2015 11:00:00 AM,48,-122,28,47,75
22836,FremontBridge,05/12/2015 12:00:00 PM,48,-122,33,42,75
22837,FremontBridge,05/12/2015 01:00:00 PM,48,-122,30,39,69
22838,FremontBridge,05/12/2015 02:00:00 PM,48,-122,39,39,78
22839,FremontBridge,05/12/2015 03:00:00 PM,48,-122,69,36,105
22840,FremontBridge,05/12/2015 04:00:00 PM,48,-122,209,91,300
22841,FremontBridge,05/12/2015 05:00:00 PM,48,-122,442,151,593
22842,FremontBridge,05/12/2015 06:00:00 PM,48,-122,295,121,416
22843,FremontBridge,05/12/2015 07:00:00 PM,48,-122,126,81,207
22844,FremontBridge,05/12/2015 08:00:00 PM,48,-122,63,38,101
22845,FremontBridge,05/12/2015 09:00:00 PM,48,-122,32,29,61
22846,FremontBridge,05/12/2015 10:00:00 PM,48,-122,19,13,32
22847,FremontBridge,05/12/2015 11:00:00 PM,48,-122,9,8,17
22848,FremontBridge,05/13/2015 12:00:00 AM,48,-122,6,6,12
22849,FremontBridge,05/13/2015 01:00:00 AM,48,-122,2,2,4
22850,FremontBridge,05/13/2015 02:00:00 AM,48,-122,0,3,3
22851,FremontBridge,05/13/2015 03:00:00 AM,48,-122,1,1,2
22852,FremontBridge,05/13/2015 04:00:00 AM,48,-122,3,6,9
22853,FremontBridge,05/13/2015 05:00:00 AM,48,-122,15,20,35
22854,FremontBridge,05/13/2015 06:00:00 AM,48,-122,35,77,112
22855,FremontBridge,05/13/2015 07:00:00 AM,48,-122,91,258,349
22856,FremontBridge,05/13/2015 08:00:00 AM,48,-122,120,291,411
22857,FremontBridge,05/13/2015 09:00:00 AM,48,-122,72,134,206
22858,FremontBridge,05/13/2015 10:00:00 AM,48,-122,27,52,79
22859,FremontBridge,05/13/2015 11:00:00 AM,48,-122,28,36,64
22860,FremontBridge,05/13/2015 12:00:00 PM,48,-122,27,36,63
22861,FremontBridge,05/13/2015 01:00:00 PM,48,-122,13,19,32
22862,FremontBridge,05/13/2015 02:00:00 PM,48,-122,26,24,50
22863,FremontBridge,05/13/2015 03:00:00 PM,48,-122,35,27,62
22864,FremontBridge,05/13/2015 04:00:00 PM,48,-122,136,80,216
22865,FremontBridge,05/13/2015 05:00:00 PM,48,-122,291,116,407
22866,FremontBridge,05/13/2015 06:00:00 PM,48,-122,208,95,303
22867,FremontBridge,05/13/2015 07:00:00 PM,48,-122,98,38,136
22868,FremontBridge,05/13/2015 08:00:00 PM,48,-122,47,24,71
22869,FremontBridge,05/13/2015 09:00:00 PM,48,-122,25,10,35
22870,FremontBridge,05/13/2015 10:00:00 PM,48,-122,25,8,33
22871,FremontBridge,05/13/2015 11:00:00 PM,48,-122,10,3,13
22872,FremontBridge,05/14/2015 12:00:00 AM,48,-122,3,3,6
22873,FremontBridge,05/14/2015 01:00:00 AM,48,-122,0,2,2
22874,FremontBridge,05/14/2015 02:00:00 AM,48,-122,1,1,2
22875,FremontBridge,05/14/2015 03:00:00 AM,48,-122,3,2,5
22876,FremontBridge,05/14/2015 04:00:00 AM,48,-122,5,9,14
22877,FremontBridge,05/14/2015 05:00:00 AM,48,-122,12,20,32
22878,FremontBridge,05/14/2015 06:00:00 AM,48,-122,55,120,175
22879,FremontBridge,05/14/2015 07:00:00 AM,48,-122,90,306,396
22880,FremontBridge,05/14/2015 08:00:00 AM,48,-122,154,321,475
22881,FremontBridge,05/14/2015 09:00:00 AM,48,-122,104,151,255
22882,FremontBridge,05/14/2015 10:00:00 AM,48,-122,34,53,87
22883,FremontBridge,05/14/2015 11:00:00 AM,48,-122,26,31,57
22884,FremontBridge,05/14/2015 12:00:00 PM,48,-122,34,33,67
22885,FremontBridge,05/14/2015 01:00:00 PM,48,-122,38,35,73
22886,FremontBridge,05/14/2015 02:00:00 PM,48,-122,42,55,97
22887,FremontBridge,05/14/2015 03:00:00 PM,48,-122,66,61,127
22888,FremontBridge,05/14/2015 04:00:00 PM,48,-122,214,138,352
22889,FremontBridge,05/14/2015 05:00:00 PM,48,-122,428,181,609
22890,FremontBridge,05/14/2015 06:00:00 PM,48,-122,283,168,451
22891,FremontBridge,05/14/2015 07:00:00 PM,48,-122,119,89,208
22892,FremontBridge,05/14/2015 08:00:00 PM,48,-122,65,61,126
22893,FremontBridge,05/14/2015 09:00:00 PM,48,-122,44,47,91
22894,FremontBridge,05/14/2015 10:00:00 PM,48,-122,37,33,70
22895,FremontBridge,05/14/2015 11:00:00 PM,48,-122,21,13,34
22896,FremontBridge,05/15/2015 12:00:00 AM,48,-122,7,9,16
22897,FremontBridge,05/15/2015 01:00:00 AM,48,-122,5,3,8
22898,FremontBridge,05/15/2015 02:00:00 AM,48,-122,0,1,1
22899,FremontBridge,05/15/2015 03:00:00 AM,48,-122,3,4,7
22900,FremontBridge,05/15/2015 04:00:00 AM,48,-122,3,11,14
22901,FremontBridge,05/15/2015 05:00:00 AM,48,-122,23,36,59
22902,FremontBridge,05/15/2015 06:00:00 AM,48,-122,86,192,278
22903,FremontBridge,05/15/2015 07:00:00 AM,48,-122,124,556,680
22904,FremontBridge,05/15/2015 08:00:00 AM,48,-122,183,584,767
22905,FremontBridge,05/15/2015 09:00:00 AM,48,-122,75,243,318
22906,FremontBridge,05/15/2015 10:00:00 AM,48,-122,21,97,118
22907,FremontBridge,05/15/2015 11:00:00 AM,48,-122,71,8,79
22908,FremontBridge,05/15/2015 12:00:00 PM,48,-122,51,65,116
22909,FremontBridge,05/15/2015 01:00:00 PM,48,-122,52,63,115
22910,FremontBridge,05/15/2015 02:00:00 PM,48,-122,68,97,165
22911,FremontBridge,05/15/2015 03:00:00 PM,48,-122,145,91,236
22912,FremontBridge,05/15/2015 04:00:00 PM,48,-122,295,179,474
22913,FremontBridge,05/15/2015 05:00:00 PM,48,-122,480,215,695
22914,FremontBridge,05/15/2015 06:00:00 PM,48,-122,301,150,451
22915,FremontBridge,05/15/2015 07:00:00 PM,48,-122,99,91,190
22916,FremontBridge,05/15/2015 08:00:00 PM,48,-122,53,45,98
22917,FremontBridge,05/15/2015 09:00:00 PM,48,-122,46,29,75
22918,FremontBridge,05/15/2015 10:00:00 PM,48,-122,27,27,54
22919,FremontBridge,05/15/2015 11:00:00 PM,48,-122,20,19,39
22920,FremontBridge,05/16/2015 12:00:00 AM,48,-122,11,8,19
22921,FremontBridge,05/16/2015 01:00:00 AM,48,-122,2,10,12
22922,FremontBridge,05/16/2015 02:00:00 AM,48,-122,1,2,3
22923,FremontBridge,05/16/2015 03:00:00 AM,48,-122,3,1,4
22924,FremontBridge,05/16/2015 04:00:00 AM,48,-122,0,3,3
22925,FremontBridge,05/16/2015 05:00:00 AM,48,-122,5,15,20
22926,FremontBridge,05/16/2015 06:00:00 AM,48,-122,11,19,30
22927,FremontBridge,05/16/2015 07:00:00 AM,48,-122,29,49,78
22928,FremontBridge,05/16/2015 08:00:00 AM,48,-122,43,54,97
22929,FremontBridge,05/16/2015 09:00:00 AM,48,-122,47,44,91
22930,FremontBridge,05/16/2015 10:00:00 AM,48,-122,40,54,94
22931,FremontBridge,05/16/2015 11:00:00 AM,48,-122,76,98,174
22932,FremontBridge,05/16/2015 12:00:00 PM,48,-122,39,80,119
22933,FremontBridge,05/16/2015 01:00:00 PM,48,-122,62,55,117
22934,FremontBridge,05/16/2015 02:00:00 PM,48,-122,75,57,132
22935,FremontBridge,05/16/2015 03:00:00 PM,48,-122,57,77,134
22936,FremontBridge,05/16/2015 04:00:00 PM,48,-122,54,62,116
22937,FremontBridge,05/16/2015 05:00:00 PM,48,-122,64,64,128
22938,FremontBridge,05/16/2015 06:00:00 PM,48,-122,48,48,96
22939,FremontBridge,05/16/2015 07:00:00 PM,48,-122,33,31,64
22940,FremontBridge,05/16/2015 08:00:00 PM,48,-122,18,16,34
22941,FremontBridge,05/16/2015 09:00:00 PM,48,-122,18,20,38
22942,FremontBridge,05/16/2015 10:00:00 PM,48,-122,17,9,26
22943,FremontBridge,05/16/2015 11:00:00 PM,48,-122,14,12,26
22944,FremontBridge,05/17/2015 12:00:00 AM,48,-122,10,3,13
22945,FremontBridge,05/17/2015 01:00:00 AM,48,-122,5,3,8
22946,FremontBridge,05/17/2015 02:00:00 AM,48,-122,4,1,5
22947,FremontBridge,05/17/2015 03:00:00 AM,48,-122,2,6,8
22948,FremontBridge,05/17/2015 04:00:00 AM,48,-122,1,0,1
22949,FremontBridge,05/17/2015 05:00:00 AM,48,-122,3,5,8
22950,FremontBridge,05/17/2015 06:00:00 AM,48,-122,6,11,17
22951,FremontBridge,05/17/2015 07:00:00 AM,48,-122,13,15,28
22952,FremontBridge,05/17/2015 08:00:00 AM,48,-122,29,43,72
22953,FremontBridge,05/17/2015 09:00:00 AM,48,-122,51,52,103
22954,FremontBridge,05/17/2015 10:00:00 AM,48,-122,55,87,142
22955,FremontBridge,05/17/2015 11:00:00 AM,48,-122,49,81,130
22956,FremontBridge,05/17/2015 12:00:00 PM,48,-122,67,84,151
22957,FremontBridge,05/17/2015 01:00:00 PM,48,-122,73,107,180
22958,FremontBridge,05/17/2015 02:00:00 PM,48,-122,85,102,187
22959,FremontBridge,05/17/2015 03:00:00 PM,48,-122,91,103,194
22960,FremontBridge,05/17/2015 04:00:00 PM,48,-122,76,98,174
22961,FremontBridge,05/17/2015 05:00:00 PM,48,-122,86,91,177
22962,FremontBridge,05/17/2015 06:00:00 PM,48,-122,64,72,136
22963,FremontBridge,05/17/2015 07:00:00 PM,48,-122,40,58,98
22964,FremontBridge,05/17/2015 08:00:00 PM,48,-122,64,28,92
22965,FremontBridge,05/17/2015 09:00:00 PM,48,-122,15,22,37
22966,FremontBridge,05/17/2015 10:00:00 PM,48,-122,14,14,28
22967,FremontBridge,05/17/2015 11:00:00 PM,48,-122,13,9,22
22968,FremontBridge,05/18/2015 12:00:00 AM,48,-122,6,5,11
22969,FremontBridge,05/18/2015 01:00:00 AM,48,-122,3,2,5
22970,FremontBridge,05/18/2015 02:00:00 AM,48,-122,2,3,5
22971,FremontBridge,05/18/2015 03:00:00 AM,48,-122,0,1,1
22972,FremontBridge,05/18/2015 04:00:00 AM,48,-122,3,7,10
22973,FremontBridge,05/18/2015 05:00:00 AM,48,-122,15,31,46
22974,FremontBridge,05/18/2015 06:00:00 AM,48,-122,71,134,205
22975,FremontBridge,05/18/2015 07:00:00 AM,48,-122,115,391,506
22976,FremontBridge,05/18/2015 08:00:00 AM,48,-122,176,425,601
22977,FremontBridge,05/18/2015 09:00:00 AM,48,-122,116,173,289
22978,FremontBridge,05/18/2015 10:00:00 AM,48,-122,57,69,126
22979,FremontBridge,05/18/2015 11:00:00 AM,48,-122,45,58,103
22980,FremontBridge,05/18/2015 12:00:00 PM,48,-122,52,64,116
22981,FremontBridge,05/18/2015 01:00:00 PM,48,-122,66,64,130
22982,FremontBridge,05/18/2015 02:00:00 PM,48,-122,69,78,147
22983,FremontBridge,05/18/2015 03:00:00 PM,48,-122,96,91,187
22984,FremontBridge,05/18/2015 04:00:00 PM,48,-122,266,147,413
22985,FremontBridge,05/18/2015 05:00:00 PM,48,-122,553,238,791
22986,FremontBridge,05/18/2015 06:00:00 PM,48,-122,394,188,582
22987,FremontBridge,05/18/2015 07:00:00 PM,48,-122,150,104,254
22988,FremontBridge,05/18/2015 08:00:00 PM,48,-122,77,81,158
22989,FremontBridge,05/18/2015 09:00:00 PM,48,-122,48,39,87
22990,FremontBridge,05/18/2015 10:00:00 PM,48,-122,45,7,52
22991,FremontBridge,05/18/2015 11:00:00 PM,48,-122,10,10,20
22992,FremontBridge,05/19/2015 12:00:00 AM,48,-122,8,3,11
22993,FremontBridge,05/19/2015 01:00:00 AM,48,-122,4,4,8
22994,FremontBridge,05/19/2015 02:00:00 AM,48,-122,4,2,6
22995,FremontBridge,05/19/2015 03:00:00 AM,48,-122,2,3,5
22996,FremontBridge,05/19/2015 04:00:00 AM,48,-122,3,8,11
22997,FremontBridge,05/19/2015 05:00:00 AM,48,-122,21,34,55
22998,FremontBridge,05/19/2015 06:00:00 AM,48,-122,79,153,232
22999,FremontBridge,05/19/2015 07:00:00 AM,48,-122,131,405,536
23000,FremontBridge,05/19/2015 08:00:00 AM,48,-122,211,413,624
23001,FremontBridge,05/19/2015 09:00:00 AM,48,-122,119,167,286
23002,FremontBridge,05/19/2015 10:00:00 AM,48,-122,55,81,136
23003,FremontBridge,05/19/2015 11:00:00 AM,48,-122,36,52,88
23004,FremontBridge,05/19/2015 12:00:00 PM,48,-122,47,53,100
23005,FremontBridge,05/19/2015 01:00:00 PM,48,-122,58,49,107
23006,FremontBridge,05/19/2015 02:00:00 PM,48,-122,59,56,115
23007,FremontBridge,05/19/2015 03:00:00 PM,48,-122,113,68,181
23008,FremontBridge,05/19/2015 04:00:00 PM,48,-122,258,167,425
23009,FremontBridge,05/19/2015 05:00:00 PM,48,-122,561,239,800
23010,FremontBridge,05/19/2015 06:00:00 PM,48,-122,343,194,537
23011,FremontBridge,05/19/2015 07:00:00 PM,48,-122,151,107,258
23012,FremontBridge,05/19/2015 08:00:00 PM,48,-122,76,89,165
23013,FremontBridge,05/19/2015 09:00:00 PM,48,-122,48,43,91
23014,FremontBridge,05/19/2015 10:00:00 PM,48,-122,39,27,66
23015,FremontBridge,05/19/2015 11:00:00 PM,48,-122,18,11,29
23016,FremontBridge,05/20/2015 12:00:00 AM,48,-122,6,8,14
23017,FremontBridge,05/20/2015 01:00:00 AM,48,-122,6,2,8
23018,FremontBridge,05/20/2015 02:00:00 AM,48,-122,0,0,0
23019,FremontBridge,05/20/2015 03:00:00 AM,48,-122,2,7,9
23020,FremontBridge,05/20/2015 04:00:00 AM,48,-122,5,7,12
23021,FremontBridge,05/20/2015 05:00:00 AM,48,-122,17,27,44
23022,FremontBridge,05/20/2015 06:00:00 AM,48,-122,70,144,214
23023,FremontBridge,05/20/2015 07:00:00 AM,48,-122,135,368,503
23024,FremontBridge,05/20/2015 08:00:00 AM,48,-122,186,419,605
23025,FremontBridge,05/20/2015 09:00:00 AM,48,-122,104,135,239
23026,FremontBridge,05/20/2015 10:00:00 AM,48,-122,47,77,124
23027,FremontBridge,05/20/2015 11:00:00 AM,48,-122,27,64,91
23028,FremontBridge,05/20/2015 12:00:00 PM,48,-122,48,51,99
23029,FremontBridge,05/20/2015 01:00:00 PM,48,-122,42,55,97
23030,FremontBridge,05/20/2015 02:00:00 PM,48,-122,52,58,110
23031,FremontBridge,05/20/2015 03:00:00 PM,48,-122,95,76,171
23032,FremontBridge,05/20/2015 04:00:00 PM,48,-122,228,123,351
23033,FremontBridge,05/20/2015 05:00:00 PM,48,-122,546,226,772
23034,FremontBridge,05/20/2015 06:00:00 PM,48,-122,325,199,524
23035,FremontBridge,05/20/2015 07:00:00 PM,48,-122,157,107,264
23036,FremontBridge,05/20/2015 08:00:00 PM,48,-122,69,79,148
23037,FremontBridge,05/20/2015 09:00:00 PM,48,-122,54,32,86
23038,FremontBridge,05/20/2015 10:00:00 PM,48,-122,38,23,61
23039,FremontBridge,05/20/2015 11:00:00 PM,48,-122,28,6,34
23040,FremontBridge,05/21/2015 12:00:00 AM,48,-122,5,18,23
23041,FremontBridge,05/21/2015 01:00:00 AM,48,-122,1,4,5
23042,FremontBridge,05/21/2015 02:00:00 AM,48,-122,5,4,9
23043,FremontBridge,05/21/2015 03:00:00 AM,48,-122,2,2,4
23044,FremontBridge,05/21/2015 04:00:00 AM,48,-122,8,6,14
23045,FremontBridge,05/21/2015 05:00:00 AM,48,-122,24,31,55
23046,FremontBridge,05/21/2015 06:00:00 AM,48,-122,59,131,190
23047,FremontBridge,05/21/2015 07:00:00 AM,48,-122,135,351,486
23048,FremontBridge,05/21/2015 08:00:00 AM,48,-122,206,433,639
23049,FremontBridge,05/21/2015 09:00:00 AM,48,-122,106,203,309
23050,FremontBridge,05/21/2015 10:00:00 AM,48,-122,50,68,118
23051,FremontBridge,05/21/2015 11:00:00 AM,48,-122,42,67,109
23052,FremontBridge,05/21/2015 12:00:00 PM,48,-122,44,70,114
23053,FremontBridge,05/21/2015 01:00:00 PM,48,-122,61,59,120
23054,FremontBridge,05/21/2015 02:00:00 PM,48,-122,68,77,145
23055,FremontBridge,05/21/2015 03:00:00 PM,48,-122,98,69,167
23056,FremontBridge,05/21/2015 04:00:00 PM,48,-122,278,131,409
23057,FremontBridge,05/21/2015 05:00:00 PM,48,-122,507,210,717
23058,FremontBridge,05/21/2015 06:00:00 PM,48,-122,311,186,497
23059,FremontBridge,05/21/2015 07:00:00 PM,48,-122,144,127,271
23060,FremontBridge,05/21/2015 08:00:00 PM,48,-122,98,72,170
23061,FremontBridge,05/21/2015 09:00:00 PM,48,-122,43,44,87
23062,FremontBridge,05/21/2015 10:00:00 PM,48,-122,25,32,57
23063,FremontBridge,05/21/2015 11:00:00 PM,48,-122,33,20,53
23064,FremontBridge,05/22/2015 12:00:00 AM,48,-122,13,6,19
23065,FremontBridge,05/22/2015 01:00:00 AM,48,-122,4,4,8
23066,FremontBridge,05/22/2015 02:00:00 AM,48,-122,3,1,4
23067,FremontBridge,05/22/2015 03:00:00 AM,48,-122,3,3,6
23068,FremontBridge,05/22/2015 04:00:00 AM,48,-122,2,7,9
23069,FremontBridge,05/22/2015 05:00:00 AM,48,-122,17,23,40
23070,FremontBridge,05/22/2015 06:00:00 AM,48,-122,45,99,144
23071,FremontBridge,05/22/2015 07:00:00 AM,48,-122,91,276,367
23072,FremontBridge,05/22/2015 08:00:00 AM,48,-122,144,350,494
23073,FremontBridge,05/22/2015 09:00:00 AM,48,-122,83,145,228
23074,FremontBridge,05/22/2015 10:00:00 AM,48,-122,47,68,115
23075,FremontBridge,05/22/2015 11:00:00 AM,48,-122,41,57,98
23076,FremontBridge,05/22/2015 12:00:00 PM,48,-122,56,49,105
23077,FremontBridge,05/22/2015 01:00:00 PM,48,-122,56,65,121
23078,FremontBridge,05/22/2015 02:00:00 PM,48,-122,104,56,160
23079,FremontBridge,05/22/2015 03:00:00 PM,48,-122,155,74,229
23080,FremontBridge,05/22/2015 04:00:00 PM,48,-122,231,135,366
23081,FremontBridge,05/22/2015 05:00:00 PM,48,-122,348,173,521
23082,FremontBridge,05/22/2015 06:00:00 PM,48,-122,172,90,262
23083,FremontBridge,05/22/2015 07:00:00 PM,48,-122,77,80,157
23084,FremontBridge,05/22/2015 08:00:00 PM,48,-122,60,30,90
23085,FremontBridge,05/22/2015 09:00:00 PM,48,-122,37,20,57
23086,FremontBridge,05/22/2015 10:00:00 PM,48,-122,29,18,47
23087,FremontBridge,05/22/2015 11:00:00 PM,48,-122,15,6,21
23088,FremontBridge,05/23/2015 12:00:00 AM,48,-122,9,6,15
23089,FremontBridge,05/23/2015 01:00:00 AM,48,-122,9,0,9
23090,FremontBridge,05/23/2015 02:00:00 AM,48,-122,0,3,3
23091,FremontBridge,05/23/2015 03:00:00 AM,48,-122,2,2,4
23092,FremontBridge,05/23/2015 04:00:00 AM,48,-122,1,2,3
23093,FremontBridge,05/23/2015 05:00:00 AM,48,-122,5,5,10
23094,FremontBridge,05/23/2015 06:00:00 AM,48,-122,11,9,20
23095,FremontBridge,05/23/2015 07:00:00 AM,48,-122,20,13,33
23096,FremontBridge,05/23/2015 08:00:00 AM,48,-122,34,35,69
23097,FremontBridge,05/23/2015 09:00:00 AM,48,-122,23,39,62
23098,FremontBridge,05/23/2015 10:00:00 AM,48,-122,44,63,107
23099,FremontBridge,05/23/2015 11:00:00 AM,48,-122,49,72,121
23100,FremontBridge,05/23/2015 12:00:00 PM,48,-122,52,87,139
23101,FremontBridge,05/23/2015 01:00:00 PM,48,-122,61,61,122
23102,FremontBridge,05/23/2015 02:00:00 PM,48,-122,59,88,147
23103,FremontBridge,05/23/2015 03:00:00 PM,48,-122,44,57,101
23104,FremontBridge,05/23/2015 04:00:00 PM,48,-122,62,60,122
23105,FremontBridge,05/23/2015 05:00:00 PM,48,-122,71,71,142
23106,FremontBridge,05/23/2015 06:00:00 PM,48,-122,43,57,100
23107,FremontBridge,05/23/2015 07:00:00 PM,48,-122,36,26,62
23108,FremontBridge,05/23/2015 08:00:00 PM,48,-122,40,17,57
23109,FremontBridge,05/23/2015 09:00:00 PM,48,-122,48,12,60
23110,FremontBridge,05/23/2015 10:00:00 PM,48,-122,35,12,47
23111,FremontBridge,05/23/2015 11:00:00 PM,48,-122,18,7,25
23112,FremontBridge,05/24/2015 12:00:00 AM,48,-122,12,1,13
23113,FremontBridge,05/24/2015 01:00:00 AM,48,-122,4,3,7
23114,FremontBridge,05/24/2015 02:00:00 AM,48,-122,4,5,9
23115,FremontBridge,05/24/2015 03:00:00 AM,48,-122,1,2,3
23116,FremontBridge,05/24/2015 04:00:00 AM,48,-122,2,1,3
23117,FremontBridge,05/24/2015 05:00:00 AM,48,-122,2,1,3
23118,FremontBridge,05/24/2015 06:00:00 AM,48,-122,11,6,17
23119,FremontBridge,05/24/2015 07:00:00 AM,48,-122,7,10,17
23120,FremontBridge,05/24/2015 08:00:00 AM,48,-122,24,40,64
23121,FremontBridge,05/24/2015 09:00:00 AM,48,-122,38,41,79
23122,FremontBridge,05/24/2015 10:00:00 AM,48,-122,58,65,123
23123,FremontBridge,05/24/2015 11:00:00 AM,48,-122,68,69,137
23124,FremontBridge,05/24/2015 12:00:00 PM,48,-122,59,86,145
23125,FremontBridge,05/24/2015 01:00:00 PM,48,-122,53,79,132
23126,FremontBridge,05/24/2015 02:00:00 PM,48,-122,71,113,184
23127,FremontBridge,05/24/2015 03:00:00 PM,48,-122,79,85,164
23128,FremontBridge,05/24/2015 04:00:00 PM,48,-122,64,104,168
23129,FremontBridge,05/24/2015 05:00:00 PM,48,-122,57,92,149
23130,FremontBridge,05/24/2015 06:00:00 PM,48,-122,67,59,126
23131,FremontBridge,05/24/2015 07:00:00 PM,48,-122,43,34,77
23132,FremontBridge,05/24/2015 08:00:00 PM,48,-122,32,21,53
23133,FremontBridge,05/24/2015 09:00:00 PM,48,-122,24,14,38
23134,FremontBridge,05/24/2015 10:00:00 PM,48,-122,37,10,47
23135,FremontBridge,05/24/2015 11:00:00 PM,48,-122,10,8,18
23136,FremontBridge,05/25/2015 12:00:00 AM,48,-122,5,5,10
23137,FremontBridge,05/25/2015 01:00:00 AM,48,-122,3,3,6
23138,FremontBridge,05/25/2015 02:00:00 AM,48,-122,1,0,1
23139,FremontBridge,05/25/2015 03:00:00 AM,48,-122,0,1,1
23140,FremontBridge,05/25/2015 04:00:00 AM,48,-122,1,1,2
23141,FremontBridge,05/25/2015 05:00:00 AM,48,-122,6,11,17
23142,FremontBridge,05/25/2015 06:00:00 AM,48,-122,11,17,28
23143,FremontBridge,05/25/2015 07:00:00 AM,48,-122,11,19,30
23144,FremontBridge,05/25/2015 08:00:00 AM,48,-122,31,38,69
23145,FremontBridge,05/25/2015 09:00:00 AM,48,-122,39,55,94
23146,FremontBridge,05/25/2015 10:00:00 AM,48,-122,54,58,112
23147,FremontBridge,05/25/2015 11:00:00 AM,48,-122,63,93,156
23148,FremontBridge,05/25/2015 12:00:00 PM,48,-122,69,73,142
23149,FremontBridge,05/25/2015 01:00:00 PM,48,-122,57,85,142
23150,FremontBridge,05/25/2015 02:00:00 PM,48,-122,80,89,169
23151,FremontBridge,05/25/2015 03:00:00 PM,48,-122,54,102,156
23152,FremontBridge,05/25/2015 04:00:00 PM,48,-122,90,76,166
23153,FremontBridge,05/25/2015 05:00:00 PM,48,-122,79,61,140
23154,FremontBridge,05/25/2015 06:00:00 PM,48,-122,41,52,93
23155,FremontBridge,05/25/2015 07:00:00 PM,48,-122,34,29,63
23156,FremontBridge,05/25/2015 08:00:00 PM,48,-122,22,30,52
23157,FremontBridge,05/25/2015 09:00:00 PM,48,-122,29,14,43
23158,FremontBridge,05/25/2015 10:00:00 PM,48,-122,15,14,29
23159,FremontBridge,05/25/2015 11:00:00 PM,48,-122,12,4,16
23160,FremontBridge,05/26/2015 12:00:00 AM,48,-122,3,2,5
23161,FremontBridge,05/26/2015 01:00:00 AM,48,-122,3,2,5
23162,FremontBridge,05/26/2015 02:00:00 AM,48,-122,2,0,2
23163,FremontBridge,05/26/2015 03:00:00 AM,48,-122,2,5,7
23164,FremontBridge,05/26/2015 04:00:00 AM,48,-122,3,4,7
23165,FremontBridge,05/26/2015 05:00:00 AM,48,-122,25,22,47
23166,FremontBridge,05/26/2015 06:00:00 AM,48,-122,58,131,189
23167,FremontBridge,05/26/2015 07:00:00 AM,48,-122,122,343,465
23168,FremontBridge,05/26/2015 08:00:00 AM,48,-122,177,397,574
23169,FremontBridge,05/26/2015 09:00:00 AM,48,-122,114,156,270
23170,FremontBridge,05/26/2015 10:00:00 AM,48,-122,42,59,101
23171,FremontBridge,05/26/2015 11:00:00 AM,48,-122,28,48,76
23172,FremontBridge,05/26/2015 12:00:00 PM,48,-122,32,47,79
23173,FremontBridge,05/26/2015 01:00:00 PM,48,-122,42,45,87
23174,FremontBridge,05/26/2015 02:00:00 PM,48,-122,58,74,132
23175,FremontBridge,05/26/2015 03:00:00 PM,48,-122,97,79,176
23176,FremontBridge,05/26/2015 04:00:00 PM,48,-122,201,136,337
23177,FremontBridge,05/26/2015 05:00:00 PM,48,-122,516,199,715
23178,FremontBridge,05/26/2015 06:00:00 PM,48,-122,321,158,479
23179,FremontBridge,05/26/2015 07:00:00 PM,48,-122,144,79,223
23180,FremontBridge,05/26/2015 08:00:00 PM,48,-122,85,42,127
23181,FremontBridge,05/26/2015 09:00:00 PM,48,-122,50,33,83
23182,FremontBridge,05/26/2015 10:00:00 PM,48,-122,20,21,41
23183,FremontBridge,05/26/2015 11:00:00 PM,48,-122,19,8,27
23184,FremontBridge,05/27/2015 12:00:00 AM,48,-122,5,3,8
23185,FremontBridge,05/27/2015 01:00:00 AM,48,-122,4,3,7
23186,FremontBridge,05/27/2015 02:00:00 AM,48,-122,0,2,2
23187,FremontBridge,05/27/2015 03:00:00 AM,48,-122,0,5,5
23188,FremontBridge,05/27/2015 04:00:00 AM,48,-122,3,7,10
23189,FremontBridge,05/27/2015 05:00:00 AM,48,-122,20,28,48
23190,FremontBridge,05/27/2015 06:00:00 AM,48,-122,69,155,224
23191,FremontBridge,05/27/2015 07:00:00 AM,48,-122,129,380,509
23192,FremontBridge,05/27/2015 08:00:00 AM,48,-122,194,429,623
23193,FremontBridge,05/27/2015 09:00:00 AM,48,-122,101,182,283
23194,FremontBridge,05/27/2015 10:00:00 AM,48,-122,45,71,116
23195,FremontBridge,05/27/2015 11:00:00 AM,48,-122,41,44,85
23196,FremontBridge,05/27/2015 12:00:00 PM,48,-122,57,52,109
23197,FremontBridge,05/27/2015 01:00:00 PM,48,-122,45,85,130
23198,FremontBridge,05/27/2015 02:00:00 PM,48,-122,55,63,118
23199,FremontBridge,05/27/2015 03:00:00 PM,48,-122,101,63,164
23200,FremontBridge,05/27/2015 04:00:00 PM,48,-122,269,156,425
23201,FremontBridge,05/27/2015 05:00:00 PM,48,-122,527,235,762
23202,FremontBridge,05/27/2015 06:00:00 PM,48,-122,308,195,503
23203,FremontBridge,05/27/2015 07:00:00 PM,48,-122,154,110,264
23204,FremontBridge,05/27/2015 08:00:00 PM,48,-122,74,67,141
23205,FremontBridge,05/27/2015 09:00:00 PM,48,-122,84,48,132
23206,FremontBridge,05/27/2015 10:00:00 PM,48,-122,37,20,57
23207,FremontBridge,05/27/2015 11:00:00 PM,48,-122,24,22,46
23208,FremontBridge,05/28/2015 12:00:00 AM,48,-122,11,5,16
23209,FremontBridge,05/28/2015 01:00:00 AM,48,-122,3,4,7
23210,FremontBridge,05/28/2015 02:00:00 AM,48,-122,3,1,4
23211,FremontBridge,05/28/2015 03:00:00 AM,48,-122,1,3,4
23212,FremontBridge,05/28/2015 04:00:00 AM,48,-122,4,7,11
23213,FremontBridge,05/28/2015 05:00:00 AM,48,-122,29,33,62
23214,FremontBridge,05/28/2015 06:00:00 AM,48,-122,69,162,231
23215,FremontBridge,05/28/2015 07:00:00 AM,48,-122,150,409,559
23216,FremontBridge,05/28/2015 08:00:00 AM,48,-122,211,423,634
23217,FremontBridge,05/28/2015 09:00:00 AM,48,-122,107,182,289
23218,FremontBridge,05/28/2015 10:00:00 AM,48,-122,54,78,132
23219,FremontBridge,05/28/2015 11:00:00 AM,48,-122,50,48,98
23220,FremontBridge,05/28/2015 12:00:00 PM,48,-122,61,64,125
23221,FremontBridge,05/28/2015 01:00:00 PM,48,-122,63,60,123
23222,FremontBridge,05/28/2015 02:00:00 PM,48,-122,78,76,154
23223,FremontBridge,05/28/2015 03:00:00 PM,48,-122,108,94,202
23224,FremontBridge,05/28/2015 04:00:00 PM,48,-122,273,165,438
23225,FremontBridge,05/28/2015 05:00:00 PM,48,-122,550,226,776
23226,FremontBridge,05/28/2015 06:00:00 PM,48,-122,362,221,583
23227,FremontBridge,05/28/2015 07:00:00 PM,48,-122,167,135,302
23228,FremontBridge,05/28/2015 08:00:00 PM,48,-122,93,98,191
23229,FremontBridge,05/28/2015 09:00:00 PM,48,-122,46,50,96
23230,FremontBridge,05/28/2015 10:00:00 PM,48,-122,37,28,65
23231,FremontBridge,05/28/2015 11:00:00 PM,48,-122,30,10,40
23232,FremontBridge,05/29/2015 12:00:00 AM,48,-122,12,6,18
23233,FremontBridge,05/29/2015 01:00:00 AM,48,-122,5,0,5
23234,FremontBridge,05/29/2015 02:00:00 AM,48,-122,2,4,6
23235,FremontBridge,05/29/2015 03:00:00 AM,48,-122,3,2,5
23236,FremontBridge,05/29/2015 04:00:00 AM,48,-122,4,10,14
23237,FremontBridge,05/29/2015 05:00:00 AM,48,-122,22,24,46
23238,FremontBridge,05/29/2015 06:00:00 AM,48,-122,44,136,180
23239,FremontBridge,05/29/2015 07:00:00 AM,48,-122,134,348,482
23240,FremontBridge,05/29/2015 08:00:00 AM,48,-122,189,395,584
23241,FremontBridge,05/29/2015 09:00:00 AM,48,-122,91,161,252
23242,FremontBridge,05/29/2015 10:00:00 AM,48,-122,62,71,133
23243,FremontBridge,05/29/2015 11:00:00 AM,48,-122,59,65,124
23244,FremontBridge,05/29/2015 12:00:00 PM,48,-122,54,48,102
23245,FremontBridge,05/29/2015 01:00:00 PM,48,-122,55,56,111
23246,FremontBridge,05/29/2015 02:00:00 PM,48,-122,82,68,150
23247,FremontBridge,05/29/2015 03:00:00 PM,48,-122,118,89,207
23248,FremontBridge,05/29/2015 04:00:00 PM,48,-122,287,147,434
23249,FremontBridge,05/29/2015 05:00:00 PM,48,-122,517,234,751
23250,FremontBridge,05/29/2015 06:00:00 PM,48,-122,249,165,414
23251,FremontBridge,05/29/2015 07:00:00 PM,48,-122,142,94,236
23252,FremontBridge,05/29/2015 08:00:00 PM,48,-122,56,54,110
23253,FremontBridge,05/29/2015 09:00:00 PM,48,-122,37,50,87
23254,FremontBridge,05/29/2015 10:00:00 PM,48,-122,23,29,52
23255,FremontBridge,05/29/2015 11:00:00 PM,48,-122,28,17,45
23256,FremontBridge,05/30/2015 12:00:00 AM,48,-122,18,8,26
23257,FremontBridge,05/30/2015 01:00:00 AM,48,-122,8,10,18
23258,FremontBridge,05/30/2015 02:00:00 AM,48,-122,6,5,11
23259,FremontBridge,05/30/2015 03:00:00 AM,48,-122,5,2,7
23260,FremontBridge,05/30/2015 04:00:00 AM,48,-122,3,6,9
23261,FremontBridge,05/30/2015 05:00:00 AM,48,-122,7,9,16
23262,FremontBridge,05/30/2015 06:00:00 AM,48,-122,15,15,30
23263,FremontBridge,05/30/2015 07:00:00 AM,48,-122,27,23,50
23264,FremontBridge,05/30/2015 08:00:00 AM,48,-122,28,50,78
23265,FremontBridge,05/30/2015 09:00:00 AM,48,-122,45,86,131
23266,FremontBridge,05/30/2015 10:00:00 AM,48,-122,75,62,137
23267,FremontBridge,05/30/2015 11:00:00 AM,48,-122,70,80,150
23268,FremontBridge,05/30/2015 12:00:00 PM,48,-122,66,95,161
23269,FremontBridge,05/30/2015 01:00:00 PM,48,-122,106,102,208
23270,FremontBridge,05/30/2015 02:00:00 PM,48,-122,100,100,200
23271,FremontBridge,05/30/2015 03:00:00 PM,48,-122,91,117,208
23272,FremontBridge,05/30/2015 04:00:00 PM,48,-122,73,108,181
23273,FremontBridge,05/30/2015 05:00:00 PM,48,-122,78,91,169
23274,FremontBridge,05/30/2015 06:00:00 PM,48,-122,77,111,188
23275,FremontBridge,05/30/2015 07:00:00 PM,48,-122,49,66,115
23276,FremontBridge,05/30/2015 08:00:00 PM,48,-122,39,31,70
23277,FremontBridge,05/30/2015 09:00:00 PM,48,-122,37,22,59
23278,FremontBridge,05/30/2015 10:00:00 PM,48,-122,23,14,37
23279,FremontBridge,05/30/2015 11:00:00 PM,48,-122,24,25,49
23280,FremontBridge,05/31/2015 12:00:00 AM,48,-122,17,12,29
23281,FremontBridge,05/31/2015 01:00:00 AM,48,-122,9,11,20
23282,FremontBridge,05/31/2015 02:00:00 AM,48,-122,2,4,6
23283,FremontBridge,05/31/2015 03:00:00 AM,48,-122,5,0,5
23284,FremontBridge,05/31/2015 04:00:00 AM,48,-122,3,1,4
23285,FremontBridge,05/31/2015 05:00:00 AM,48,-122,3,7,10
23286,FremontBridge,05/31/2015 06:00:00 AM,48,-122,16,16,32
23287,FremontBridge,05/31/2015 07:00:00 AM,48,-122,20,27,47
23288,FremontBridge,05/31/2015 08:00:00 AM,48,-122,34,36,70
23289,FremontBridge,05/31/2015 09:00:00 AM,48,-122,74,64,138
23290,FremontBridge,05/31/2015 10:00:00 AM,48,-122,78,87,165
23291,FremontBridge,05/31/2015 11:00:00 AM,48,-122,81,120,201
23292,FremontBridge,05/31/2015 12:00:00 PM,48,-122,99,114,213
23293,FremontBridge,05/31/2015 01:00:00 PM,48,-122,72,102,174
23294,FremontBridge,05/31/2015 02:00:00 PM,48,-122,82,117,199
23295,FremontBridge,05/31/2015 03:00:00 PM,48,-122,81,90,171
23296,FremontBridge,05/31/2015 04:00:00 PM,48,-122,117,94,211
23297,FremontBridge,05/31/2015 05:00:00 PM,48,-122,66,94,160
23298,FremontBridge,05/31/2015 06:00:00 PM,48,-122,61,53,114
23299,FremontBridge,05/31/2015 07:00:00 PM,48,-122,39,68,107
23300,FremontBridge,05/31/2015 08:00:00 PM,48,-122,66,28,94
23301,FremontBridge,05/31/2015 09:00:00 PM,48,-122,18,18,36
23302,FremontBridge,05/31/2015 10:00:00 PM,48,-122,16,7,23
23303,FremontBridge,05/31/2015 11:00:00 PM,48,-122,12,10,22
23304,FremontBridge,06/01/2015 12:00:00 AM,48,-122,7,7,14
23305,FremontBridge,06/01/2015 01:00:00 AM,48,-122,4,2,6
23306,FremontBridge,06/01/2015 02:00:00 AM,48,-122,0,3,3
23307,FremontBridge,06/01/2015 03:00:00 AM,48,-122,2,2,4
23308,FremontBridge,06/01/2015 04:00:00 AM,48,-122,4,7,11
23309,FremontBridge,06/01/2015 05:00:00 AM,48,-122,15,32,47
23310,FremontBridge,06/01/2015 06:00:00 AM,48,-122,48,106,154
23311,FremontBridge,06/01/2015 07:00:00 AM,48,-122,105,271,376
23312,FremontBridge,06/01/2015 08:00:00 AM,48,-122,132,318,450
23313,FremontBridge,06/01/2015 09:00:00 AM,48,-122,60,106,166
23314,FremontBridge,06/01/2015 10:00:00 AM,48,-122,15,29,44
23315,FremontBridge,06/01/2015 11:00:00 AM,48,-122,12,20,32
23316,FremontBridge,06/01/2015 12:00:00 PM,48,-122,18,16,34
23317,FremontBridge,06/01/2015 01:00:00 PM,48,-122,15,23,38
23318,FremontBridge,06/01/2015 02:00:00 PM,48,-122,46,26,72
23319,FremontBridge,06/01/2015 03:00:00 PM,48,-122,72,41,113
23320,FremontBridge,06/01/2015 04:00:00 PM,48,-122,149,83,232
23321,FremontBridge,06/01/2015 05:00:00 PM,48,-122,387,139,526
23322,FremontBridge,06/01/2015 06:00:00 PM,48,-122,190,155,345
23323,FremontBridge,06/01/2015 07:00:00 PM,48,-122,83,52,135
23324,FremontBridge,06/01/2015 08:00:00 PM,48,-122,56,34,90
23325,FremontBridge,06/01/2015 09:00:00 PM,48,-122,22,21,43
23326,FremontBridge,06/01/2015 10:00:00 PM,48,-122,27,11,38
23327,FremontBridge,06/01/2015 11:00:00 PM,48,-122,5,11,16
23328,FremontBridge,06/02/2015 12:00:00 AM,48,-122,7,3,10
23329,FremontBridge,06/02/2015 01:00:00 AM,48,-122,1,1,2
23330,FremontBridge,06/02/2015 02:00:00 AM,48,-122,1,2,3
23331,FremontBridge,06/02/2015 03:00:00 AM,48,-122,4,2,6
23332,FremontBridge,06/02/2015 04:00:00 AM,48,-122,1,7,8
23333,FremontBridge,06/02/2015 05:00:00 AM,48,-122,26,26,52
23334,FremontBridge,06/02/2015 06:00:00 AM,48,-122,37,83,120
23335,FremontBridge,06/02/2015 07:00:00 AM,48,-122,91,234,325
23336,FremontBridge,06/02/2015 08:00:00 AM,48,-122,167,313,480
23337,FremontBridge,06/02/2015 09:00:00 AM,48,-122,79,133,212
23338,FremontBridge,06/02/2015 10:00:00 AM,48,-122,29,50,79
23339,FremontBridge,06/02/2015 11:00:00 AM,48,-122,33,26,59
23340,FremontBridge,06/02/2015 12:00:00 PM,48,-122,27,35,62
23341,FremontBridge,06/02/2015 01:00:00 PM,48,-122,31,26,57
23342,FremontBridge,06/02/2015 02:00:00 PM,48,-122,47,34,81
23343,FremontBridge,06/02/2015 03:00:00 PM,48,-122,65,47,112
23344,FremontBridge,06/02/2015 04:00:00 PM,48,-122,134,103,237
23345,FremontBridge,06/02/2015 05:00:00 PM,48,-122,348,127,475
23346,FremontBridge,06/02/2015 06:00:00 PM,48,-122,245,113,358
23347,FremontBridge,06/02/2015 07:00:00 PM,48,-122,111,45,156
23348,FremontBridge,06/02/2015 08:00:00 PM,48,-122,33,34,67
23349,FremontBridge,06/02/2015 09:00:00 PM,48,-122,34,24,58
23350,FremontBridge,06/02/2015 10:00:00 PM,48,-122,25,13,38
23351,FremontBridge,06/02/2015 11:00:00 PM,48,-122,15,6,21
23352,FremontBridge,06/03/2015 12:00:00 AM,48,-122,10,4,14
23353,FremontBridge,06/03/2015 01:00:00 AM,48,-122,1,3,4
23354,FremontBridge,06/03/2015 02:00:00 AM,48,-122,2,2,4
23355,FremontBridge,06/03/2015 03:00:00 AM,48,-122,2,2,4
23356,FremontBridge,06/03/2015 04:00:00 AM,48,-122,1,3,4
23357,FremontBridge,06/03/2015 05:00:00 AM,48,-122,19,35,54
23358,FremontBridge,06/03/2015 06:00:00 AM,48,-122,52,98,150
23359,FremontBridge,06/03/2015 07:00:00 AM,48,-122,98,262,360
23360,FremontBridge,06/03/2015 08:00:00 AM,48,-122,138,322,460
23361,FremontBridge,06/03/2015 09:00:00 AM,48,-122,84,111,195
23362,FremontBridge,06/03/2015 10:00:00 AM,48,-122,34,49,83
23363,FremontBridge,06/03/2015 11:00:00 AM,48,-122,30,41,71
23364,FremontBridge,06/03/2015 12:00:00 PM,48,-122,35,45,80
23365,FremontBridge,06/03/2015 01:00:00 PM,48,-122,26,27,53
23366,FremontBridge,06/03/2015 02:00:00 PM,48,-122,37,45,82
23367,FremontBridge,06/03/2015 03:00:00 PM,48,-122,85,55,140
23368,FremontBridge,06/03/2015 04:00:00 PM,48,-122,179,134,313
23369,FremontBridge,06/03/2015 05:00:00 PM,48,-122,433,181,614
23370,FremontBridge,06/03/2015 06:00:00 PM,48,-122,252,170,422
23371,FremontBridge,06/03/2015 07:00:00 PM,48,-122,140,103,243
23372,FremontBridge,06/03/2015 08:00:00 PM,48,-122,66,60,126
23373,FremontBridge,06/03/2015 09:00:00 PM,48,-122,52,36,88
23374,FremontBridge,06/03/2015 10:00:00 PM,48,-122,30,28,58
23375,FremontBridge,06/03/2015 11:00:00 PM,48,-122,25,11,36
23376,FremontBridge,06/04/2015 12:00:00 AM,48,-122,7,12,19
23377,FremontBridge,06/04/2015 01:00:00 AM,48,-122,3,3,6
23378,FremontBridge,06/04/2015 02:00:00 AM,48,-122,2,4,6
23379,FremontBridge,06/04/2015 03:00:00 AM,48,-122,1,4,5
23380,FremontBridge,06/04/2015 04:00:00 AM,48,-122,3,4,7
23381,FremontBridge,06/04/2015 05:00:00 AM,48,-122,26,30,56
23382,FremontBridge,06/04/2015 06:00:00 AM,48,-122,43,141,184
23383,FremontBridge,06/04/2015 07:00:00 AM,48,-122,131,340,471
23384,FremontBridge,06/04/2015 08:00:00 AM,48,-122,193,405,598
23385,FremontBridge,06/04/2015 09:00:00 AM,48,-122,108,179,287
23386,FremontBridge,06/04/2015 10:00:00 AM,48,-122,54,67,121
23387,FremontBridge,06/04/2015 11:00:00 AM,48,-122,41,56,97
23388,FremontBridge,06/04/2015 12:00:00 PM,48,-122,44,63,107
23389,FremontBridge,06/04/2015 01:00:00 PM,48,-122,53,52,105
23390,FremontBridge,06/04/2015 02:00:00 PM,48,-122,59,60,119
23391,FremontBridge,06/04/2015 03:00:00 PM,48,-122,118,76,194
23392,FremontBridge,06/04/2015 04:00:00 PM,48,-122,232,128,360
23393,FremontBridge,06/04/2015 05:00:00 PM,48,-122,472,246,718
23394,FremontBridge,06/04/2015 06:00:00 PM,48,-122,353,174,527
23395,FremontBridge,06/04/2015 07:00:00 PM,48,-122,154,104,258
23396,FremontBridge,06/04/2015 08:00:00 PM,48,-122,109,77,186
23397,FremontBridge,06/04/2015 09:00:00 PM,48,-122,60,52,112
23398,FremontBridge,06/04/2015 10:00:00 PM,48,-122,32,38,70
23399,FremontBridge,06/04/2015 11:00:00 PM,48,-122,15,9,24
23400,FremontBridge,06/05/2015 12:00:00 AM,48,-122,12,8,20
23401,FremontBridge,06/05/2015 01:00:00 AM,48,-122,8,9,17
23402,FremontBridge,06/05/2015 02:00:00 AM,48,-122,3,2,5
23403,FremontBridge,06/05/2015 03:00:00 AM,48,-122,3,6,9
23404,FremontBridge,06/05/2015 04:00:00 AM,48,-122,2,6,8
23405,FremontBridge,06/05/2015 05:00:00 AM,48,-122,18,32,50
23406,FremontBridge,06/05/2015 06:00:00 AM,48,-122,53,106,159
23407,FremontBridge,06/05/2015 07:00:00 AM,48,-122,134,298,432
23408,FremontBridge,06/05/2015 08:00:00 AM,48,-122,169,385,554
23409,FremontBridge,06/05/2015 09:00:00 AM,48,-122,107,169,276
23410,FremontBridge,06/05/2015 10:00:00 AM,48,-122,71,67,138
23411,FremontBridge,06/05/2015 11:00:00 AM,48,-122,64,56,120
23412,FremontBridge,06/05/2015 12:00:00 PM,48,-122,66,55,121
23413,FremontBridge,06/05/2015 01:00:00 PM,48,-122,65,78,143
23414,FremontBridge,06/05/2015 02:00:00 PM,48,-122,58,78,136
23415,FremontBridge,06/05/2015 03:00:00 PM,48,-122,151,99,250
23416,FremontBridge,06/05/2015 04:00:00 PM,48,-122,270,159,429
23417,FremontBridge,06/05/2015 05:00:00 PM,48,-122,474,191,665
23418,FremontBridge,06/05/2015 06:00:00 PM,48,-122,219,118,337
23419,FremontBridge,06/05/2015 07:00:00 PM,48,-122,116,76,192
23420,FremontBridge,06/05/2015 08:00:00 PM,48,-122,64,48,112
23421,FremontBridge,06/05/2015 09:00:00 PM,48,-122,40,31,71
23422,FremontBridge,06/05/2015 10:00:00 PM,48,-122,28,19,47
23423,FremontBridge,06/05/2015 11:00:00 PM,48,-122,23,19,42
23424,FremontBridge,06/06/2015 12:00:00 AM,48,-122,8,7,15
23425,FremontBridge,06/06/2015 01:00:00 AM,48,-122,7,2,9
23426,FremontBridge,06/06/2015 02:00:00 AM,48,-122,5,3,8
23427,FremontBridge,06/06/2015 03:00:00 AM,48,-122,3,5,8
23428,FremontBridge,06/06/2015 04:00:00 AM,48,-122,1,4,5
23429,FremontBridge,06/06/2015 05:00:00 AM,48,-122,6,6,12
23430,FremontBridge,06/06/2015 06:00:00 AM,48,-122,25,12,37
23431,FremontBridge,06/06/2015 07:00:00 AM,48,-122,35,36,71
23432,FremontBridge,06/06/2015 08:00:00 AM,48,-122,55,64,119
23433,FremontBridge,06/06/2015 09:00:00 AM,48,-122,70,91,161
23434,FremontBridge,06/06/2015 10:00:00 AM,48,-122,82,94,176
23435,FremontBridge,06/06/2015 11:00:00 AM,48,-122,114,95,209
23436,FremontBridge,06/06/2015 12:00:00 PM,48,-122,107,80,187
23437,FremontBridge,06/06/2015 01:00:00 PM,48,-122,113,115,228
23438,FremontBridge,06/06/2015 02:00:00 PM,48,-122,109,117,226
23439,FremontBridge,06/06/2015 03:00:00 PM,48,-122,88,117,205
23440,FremontBridge,06/06/2015 04:00:00 PM,48,-122,80,89,169
23441,FremontBridge,06/06/2015 05:00:00 PM,48,-122,71,74,145
23442,FremontBridge,06/06/2015 06:00:00 PM,48,-122,79,77,156
23443,FremontBridge,06/06/2015 07:00:00 PM,48,-122,51,44,95
23444,FremontBridge,06/06/2015 08:00:00 PM,48,-122,40,46,86
23445,FremontBridge,06/06/2015 09:00:00 PM,48,-122,26,32,58
23446,FremontBridge,06/06/2015 10:00:00 PM,48,-122,17,30,47
23447,FremontBridge,06/06/2015 11:00:00 PM,48,-122,15,28,43
23448,FremontBridge,06/07/2015 12:00:00 AM,48,-122,18,15,33
23449,FremontBridge,06/07/2015 01:00:00 AM,48,-122,8,9,17
23450,FremontBridge,06/07/2015 02:00:00 AM,48,-122,4,6,10
23451,FremontBridge,06/07/2015 03:00:00 AM,48,-122,2,6,8
23452,FremontBridge,06/07/2015 04:00:00 AM,48,-122,4,2,6
23453,FremontBridge,06/07/2015 05:00:00 AM,48,-122,2,5,7
23454,FremontBridge,06/07/2015 06:00:00 AM,48,-122,12,12,24
23455,FremontBridge,06/07/2015 07:00:00 AM,48,-122,30,33,63
23456,FremontBridge,06/07/2015 08:00:00 AM,48,-122,52,61,113
23457,FremontBridge,06/07/2015 09:00:00 AM,48,-122,79,95,174
23458,FremontBridge,06/07/2015 10:00:00 AM,48,-122,79,74,153
23459,FremontBridge,06/07/2015 11:00:00 AM,48,-122,100,123,223
23460,FremontBridge,06/07/2015 12:00:00 PM,48,-122,93,145,238
23461,FremontBridge,06/07/2015 01:00:00 PM,48,-122,100,85,185
23462,FremontBridge,06/07/2015 02:00:00 PM,48,-122,114,135,249
23463,FremontBridge,06/07/2015 03:00:00 PM,48,-122,90,110,200
23464,FremontBridge,06/07/2015 04:00:00 PM,48,-122,83,112,195
23465,FremontBridge,06/07/2015 05:00:00 PM,48,-122,78,97,175
23466,FremontBridge,06/07/2015 06:00:00 PM,48,-122,67,68,135
23467,FremontBridge,06/07/2015 07:00:00 PM,48,-122,38,42,80
23468,FremontBridge,06/07/2015 08:00:00 PM,48,-122,49,53,102
23469,FremontBridge,06/07/2015 09:00:00 PM,48,-122,21,20,41
23470,FremontBridge,06/07/2015 10:00:00 PM,48,-122,16,20,36
23471,FremontBridge,06/07/2015 11:00:00 PM,48,-122,11,9,20
23472,FremontBridge,06/08/2015 12:00:00 AM,48,-122,10,3,13
23473,FremontBridge,06/08/2015 01:00:00 AM,48,-122,2,1,3
23474,FremontBridge,06/08/2015 02:00:00 AM,48,-122,3,1,4
23475,FremontBridge,06/08/2015 03:00:00 AM,48,-122,0,3,3
23476,FremontBridge,06/08/2015 04:00:00 AM,48,-122,3,7,10
23477,FremontBridge,06/08/2015 05:00:00 AM,48,-122,24,31,55
23478,FremontBridge,06/08/2015 06:00:00 AM,48,-122,54,127,181
23479,FremontBridge,06/08/2015 07:00:00 AM,48,-122,125,332,457
23480,FremontBridge,06/08/2015 08:00:00 AM,48,-122,195,406,601
23481,FremontBridge,06/08/2015 09:00:00 AM,48,-122,115,188,303
23482,FremontBridge,06/08/2015 10:00:00 AM,48,-122,53,57,110
23483,FremontBridge,06/08/2015 11:00:00 AM,48,-122,42,65,107
23484,FremontBridge,06/08/2015 12:00:00 PM,48,-122,47,46,93
23485,FremontBridge,06/08/2015 01:00:00 PM,48,-122,49,55,104
23486,FremontBridge,06/08/2015 02:00:00 PM,48,-122,66,50,116
23487,FremontBridge,06/08/2015 03:00:00 PM,48,-122,102,70,172
23488,FremontBridge,06/08/2015 04:00:00 PM,48,-122,219,138,357
23489,FremontBridge,06/08/2015 05:00:00 PM,48,-122,524,188,712
23490,FremontBridge,06/08/2015 06:00:00 PM,48,-122,309,175,484
23491,FremontBridge,06/08/2015 07:00:00 PM,48,-122,154,101,255
23492,FremontBridge,06/08/2015 08:00:00 PM,48,-122,91,54,145
23493,FremontBridge,06/08/2015 09:00:00 PM,48,-122,49,58,107
23494,FremontBridge,06/08/2015 10:00:00 PM,48,-122,29,28,57
23495,FremontBridge,06/08/2015 11:00:00 PM,48,-122,15,11,26
23496,FremontBridge,06/09/2015 12:00:00 AM,48,-122,5,1,6
23497,FremontBridge,06/09/2015 01:00:00 AM,48,-122,9,5,14
23498,FremontBridge,06/09/2015 02:00:00 AM,48,-122,4,1,5
23499,FremontBridge,06/09/2015 03:00:00 AM,48,-122,0,5,5
23500,FremontBridge,06/09/2015 04:00:00 AM,48,-122,8,7,15
23501,FremontBridge,06/09/2015 05:00:00 AM,48,-122,25,35,60
23502,FremontBridge,06/09/2015 06:00:00 AM,48,-122,58,144,202
23503,FremontBridge,06/09/2015 07:00:00 AM,48,-122,130,385,515
23504,FremontBridge,06/09/2015 08:00:00 AM,48,-122,225,449,674
23505,FremontBridge,06/09/2015 09:00:00 AM,48,-122,116,171,287
23506,FremontBridge,06/09/2015 10:00:00 AM,48,-122,47,64,111
23507,FremontBridge,06/09/2015 11:00:00 AM,48,-122,46,54,100
23508,FremontBridge,06/09/2015 12:00:00 PM,48,-122,51,65,116
23509,FremontBridge,06/09/2015 01:00:00 PM,48,-122,52,57,109
23510,FremontBridge,06/09/2015 02:00:00 PM,48,-122,63,55,118
23511,FremontBridge,06/09/2015 03:00:00 PM,48,-122,110,97,207
23512,FremontBridge,06/09/2015 04:00:00 PM,48,-122,275,142,417
23513,FremontBridge,06/09/2015 05:00:00 PM,48,-122,535,251,786
23514,FremontBridge,06/09/2015 06:00:00 PM,48,-122,377,172,549
23515,FremontBridge,06/09/2015 07:00:00 PM,48,-122,160,119,279
23516,FremontBridge,06/09/2015 08:00:00 PM,48,-122,106,85,191
23517,FremontBridge,06/09/2015 09:00:00 PM,48,-122,54,44,98
23518,FremontBridge,06/09/2015 10:00:00 PM,48,-122,23,22,45
23519,FremontBridge,06/09/2015 11:00:00 PM,48,-122,17,9,26
23520,FremontBridge,06/10/2015 12:00:00 AM,48,-122,10,7,17
23521,FremontBridge,06/10/2015 01:00:00 AM,48,-122,3,2,5
23522,FremontBridge,06/10/2015 02:00:00 AM,48,-122,4,6,10
23523,FremontBridge,06/10/2015 03:00:00 AM,48,-122,2,1,3
23524,FremontBridge,06/10/2015 04:00:00 AM,48,-122,8,5,13
23525,FremontBridge,06/10/2015 05:00:00 AM,48,-122,24,42,66
23526,FremontBridge,06/10/2015 06:00:00 AM,48,-122,58,138,196
23527,FremontBridge,06/10/2015 07:00:00 AM,48,-122,150,367,517
23528,FremontBridge,06/10/2015 08:00:00 AM,48,-122,205,439,644
23529,FremontBridge,06/10/2015 09:00:00 AM,48,-122,120,164,284
23530,FremontBridge,06/10/2015 10:00:00 AM,48,-122,65,81,146
23531,FremontBridge,06/10/2015 11:00:00 AM,48,-122,61,49,110
23532,FremontBridge,06/10/2015 12:00:00 PM,48,-122,58,54,112
23533,FremontBridge,06/10/2015 01:00:00 PM,48,-122,43,72,115
23534,FremontBridge,06/10/2015 02:00:00 PM,48,-122,54,63,117
23535,FremontBridge,06/10/2015 03:00:00 PM,48,-122,92,70,162
23536,FremontBridge,06/10/2015 04:00:00 PM,48,-122,243,149,392
23537,FremontBridge,06/10/2015 05:00:00 PM,48,-122,561,232,793
23538,FremontBridge,06/10/2015 06:00:00 PM,48,-122,332,210,542
23539,FremontBridge,06/10/2015 07:00:00 PM,48,-122,173,137,310
23540,FremontBridge,06/10/2015 08:00:00 PM,48,-122,92,82,174
23541,FremontBridge,06/10/2015 09:00:00 PM,48,-122,77,59,136
23542,FremontBridge,06/10/2015 10:00:00 PM,48,-122,30,33,63
23543,FremontBridge,06/10/2015 11:00:00 PM,48,-122,35,15,50
23544,FremontBridge,06/11/2015 12:00:00 AM,48,-122,17,4,21
23545,FremontBridge,06/11/2015 01:00:00 AM,48,-122,7,2,9
23546,FremontBridge,06/11/2015 02:00:00 AM,48,-122,1,4,5
23547,FremontBridge,06/11/2015 03:00:00 AM,48,-122,3,5,8
23548,FremontBridge,06/11/2015 04:00:00 AM,48,-122,4,4,8
23549,FremontBridge,06/11/2015 05:00:00 AM,48,-122,21,41,62
23550,FremontBridge,06/11/2015 06:00:00 AM,48,-122,63,132,195
23551,FremontBridge,06/11/2015 07:00:00 AM,48,-122,145,330,475
23552,FremontBridge,06/11/2015 08:00:00 AM,48,-122,194,389,583
23553,FremontBridge,06/11/2015 09:00:00 AM,48,-122,119,196,315
23554,FremontBridge,06/11/2015 10:00:00 AM,48,-122,54,90,144
23555,FremontBridge,06/11/2015 11:00:00 AM,48,-122,46,56,102
23556,FremontBridge,06/11/2015 12:00:00 PM,48,-122,59,51,110
23557,FremontBridge,06/11/2015 01:00:00 PM,48,-122,57,58,115
23558,FremontBridge,06/11/2015 02:00:00 PM,48,-122,54,62,116
23559,FremontBridge,06/11/2015 03:00:00 PM,48,-122,118,90,208
23560,FremontBridge,06/11/2015 04:00:00 PM,48,-122,237,115,352
23561,FremontBridge,06/11/2015 05:00:00 PM,48,-122,480,184,664
23562,FremontBridge,06/11/2015 06:00:00 PM,48,-122,343,211,554
23563,FremontBridge,06/11/2015 07:00:00 PM,48,-122,165,115,280
23564,FremontBridge,06/11/2015 08:00:00 PM,48,-122,98,81,179
23565,FremontBridge,06/11/2015 09:00:00 PM,48,-122,61,58,119
23566,FremontBridge,06/11/2015 10:00:00 PM,48,-122,33,33,66
23567,FremontBridge,06/11/2015 11:00:00 PM,48,-122,22,7,29
23568,FremontBridge,06/12/2015 12:00:00 AM,48,-122,11,11,22
23569,FremontBridge,06/12/2015 01:00:00 AM,48,-122,5,1,6
23570,FremontBridge,06/12/2015 02:00:00 AM,48,-122,2,2,4
23571,FremontBridge,06/12/2015 03:00:00 AM,48,-122,5,2,7
23572,FremontBridge,06/12/2015 04:00:00 AM,48,-122,4,2,6
23573,FremontBridge,06/12/2015 05:00:00 AM,48,-122,19,25,44
23574,FremontBridge,06/12/2015 06:00:00 AM,48,-122,41,96,137
23575,FremontBridge,06/12/2015 07:00:00 AM,48,-122,97,262,359
23576,FremontBridge,06/12/2015 08:00:00 AM,48,-122,129,326,455
23577,FremontBridge,06/12/2015 09:00:00 AM,48,-122,98,169,267
23578,FremontBridge,06/12/2015 10:00:00 AM,48,-122,70,73,143
23579,FremontBridge,06/12/2015 11:00:00 AM,48,-122,31,42,73
23580,FremontBridge,06/12/2015 12:00:00 PM,48,-122,48,49,97
23581,FremontBridge,06/12/2015 01:00:00 PM,48,-122,58,56,114
23582,FremontBridge,06/12/2015 02:00:00 PM,48,-122,62,64,126
23583,FremontBridge,06/12/2015 03:00:00 PM,48,-122,97,75,172
23584,FremontBridge,06/12/2015 04:00:00 PM,48,-122,218,139,357
23585,FremontBridge,06/12/2015 05:00:00 PM,48,-122,388,177,565
23586,FremontBridge,06/12/2015 06:00:00 PM,48,-122,185,121,306
23587,FremontBridge,06/12/2015 07:00:00 PM,48,-122,119,96,215
23588,FremontBridge,06/12/2015 08:00:00 PM,48,-122,63,49,112
23589,FremontBridge,06/12/2015 09:00:00 PM,48,-122,37,38,75
23590,FremontBridge,06/12/2015 10:00:00 PM,48,-122,31,25,56
23591,FremontBridge,06/12/2015 11:00:00 PM,48,-122,30,21,51
23592,FremontBridge,06/13/2015 12:00:00 AM,48,-122,14,13,27
23593,FremontBridge,06/13/2015 01:00:00 AM,48,-122,5,6,11
23594,FremontBridge,06/13/2015 02:00:00 AM,48,-122,1,4,5
23595,FremontBridge,06/13/2015 03:00:00 AM,48,-122,6,2,8
23596,FremontBridge,06/13/2015 04:00:00 AM,48,-122,1,2,3
23597,FremontBridge,06/13/2015 05:00:00 AM,48,-122,8,8,16
23598,FremontBridge,06/13/2015 06:00:00 AM,48,-122,33,29,62
23599,FremontBridge,06/13/2015 07:00:00 AM,48,-122,30,45,75
23600,FremontBridge,06/13/2015 08:00:00 AM,48,-122,55,80,135
23601,FremontBridge,06/13/2015 09:00:00 AM,48,-122,73,96,169
23602,FremontBridge,06/13/2015 10:00:00 AM,48,-122,83,99,182
23603,FremontBridge,06/13/2015 11:00:00 AM,48,-122,100,99,199
23604,FremontBridge,06/13/2015 12:00:00 PM,48,-122,96,89,185
23605,FremontBridge,06/13/2015 01:00:00 PM,48,-122,93,115,208
23606,FremontBridge,06/13/2015 02:00:00 PM,48,-122,108,119,227
23607,FremontBridge,06/13/2015 03:00:00 PM,48,-122,93,112,205
23608,FremontBridge,06/13/2015 04:00:00 PM,48,-122,117,109,226
23609,FremontBridge,06/13/2015 05:00:00 PM,48,-122,85,134,219
23610,FremontBridge,06/13/2015 06:00:00 PM,48,-122,64,86,150
23611,FremontBridge,06/13/2015 07:00:00 PM,48,-122,66,49,115
23612,FremontBridge,06/13/2015 08:00:00 PM,48,-122,43,46,89
23613,FremontBridge,06/13/2015 09:00:00 PM,48,-122,47,35,82
23614,FremontBridge,06/13/2015 10:00:00 PM,48,-122,26,27,53
23615,FremontBridge,06/13/2015 11:00:00 PM,48,-122,17,20,37
23616,FremontBridge,06/14/2015 12:00:00 AM,48,-122,18,14,32
23617,FremontBridge,06/14/2015 01:00:00 AM,48,-122,7,12,19
23618,FremontBridge,06/14/2015 02:00:00 AM,48,-122,5,10,15
23619,FremontBridge,06/14/2015 03:00:00 AM,48,-122,3,0,3
23620,FremontBridge,06/14/2015 04:00:00 AM,48,-122,2,1,3
23621,FremontBridge,06/14/2015 05:00:00 AM,48,-122,6,8,14
23622,FremontBridge,06/14/2015 06:00:00 AM,48,-122,15,9,24
23623,FremontBridge,06/14/2015 07:00:00 AM,48,-122,20,30,50
23624,FremontBridge,06/14/2015 08:00:00 AM,48,-122,33,94,127
23625,FremontBridge,06/14/2015 09:00:00 AM,48,-122,66,84,150
23626,FremontBridge,06/14/2015 10:00:00 AM,48,-122,77,118,195
23627,FremontBridge,06/14/2015 11:00:00 AM,48,-122,74,122,196
23628,FremontBridge,06/14/2015 12:00:00 PM,48,-122,93,113,206
23629,FremontBridge,06/14/2015 01:00:00 PM,48,-122,104,119,223
23630,FremontBridge,06/14/2015 02:00:00 PM,48,-122,104,129,233
23631,FremontBridge,06/14/2015 03:00:00 PM,48,-122,104,125,229
23632,FremontBridge,06/14/2015 04:00:00 PM,48,-122,104,123,227
23633,FremontBridge,06/14/2015 05:00:00 PM,48,-122,90,105,195
23634,FremontBridge,06/14/2015 06:00:00 PM,48,-122,54,57,111
23635,FremontBridge,06/14/2015 07:00:00 PM,48,-122,46,44,90
23636,FremontBridge,06/14/2015 08:00:00 PM,48,-122,39,32,71
23637,FremontBridge,06/14/2015 09:00:00 PM,48,-122,25,55,80
23638,FremontBridge,06/14/2015 10:00:00 PM,48,-122,26,18,44
23639,FremontBridge,06/14/2015 11:00:00 PM,48,-122,11,8,19
23640,FremontBridge,06/15/2015 12:00:00 AM,48,-122,8,3,11
23641,FremontBridge,06/15/2015 01:00:00 AM,48,-122,3,2,5
23642,FremontBridge,06/15/2015 02:00:00 AM,48,-122,5,0,5
23643,FremontBridge,06/15/2015 03:00:00 AM,48,-122,2,6,8
23644,FremontBridge,06/15/2015 04:00:00 AM,48,-122,1,5,6
23645,FremontBridge,06/15/2015 05:00:00 AM,48,-122,17,26,43
23646,FremontBridge,06/15/2015 06:00:00 AM,48,-122,55,126,181
23647,FremontBridge,06/15/2015 07:00:00 AM,48,-122,128,335,463
23648,FremontBridge,06/15/2015 08:00:00 AM,48,-122,194,434,628
23649,FremontBridge,06/15/2015 09:00:00 AM,48,-122,103,149,252
23650,FremontBridge,06/15/2015 10:00:00 AM,48,-122,56,77,133
23651,FremontBridge,06/15/2015 11:00:00 AM,48,-122,37,57,94
23652,FremontBridge,06/15/2015 12:00:00 PM,48,-122,49,61,110
23653,FremontBridge,06/15/2015 01:00:00 PM,48,-122,65,65,130
23654,FremontBridge,06/15/2015 02:00:00 PM,48,-122,72,59,131
23655,FremontBridge,06/15/2015 03:00:00 PM,48,-122,91,69,160
23656,FremontBridge,06/15/2015 04:00:00 PM,48,-122,238,153,391
23657,FremontBridge,06/15/2015 05:00:00 PM,48,-122,552,231,783
23658,FremontBridge,06/15/2015 06:00:00 PM,48,-122,320,161,481
23659,FremontBridge,06/15/2015 07:00:00 PM,48,-122,134,113,247
23660,FremontBridge,06/15/2015 08:00:00 PM,48,-122,96,58,154
23661,FremontBridge,06/15/2015 09:00:00 PM,48,-122,52,45,97
23662,FremontBridge,06/15/2015 10:00:00 PM,48,-122,27,18,45
23663,FremontBridge,06/15/2015 11:00:00 PM,48,-122,10,13,23
23664,FremontBridge,06/16/2015 12:00:00 AM,48,-122,11,6,17
23665,FremontBridge,06/16/2015 01:00:00 AM,48,-122,1,2,3
23666,FremontBridge,06/16/2015 02:00:00 AM,48,-122,5,1,6
23667,FremontBridge,06/16/2015 03:00:00 AM,48,-122,3,3,6
23668,FremontBridge,06/16/2015 04:00:00 AM,48,-122,2,3,5
23669,FremontBridge,06/16/2015 05:00:00 AM,48,-122,22,35,57
23670,FremontBridge,06/16/2015 06:00:00 AM,48,-122,64,133,197
23671,FremontBridge,06/16/2015 07:00:00 AM,48,-122,135,380,515
23672,FremontBridge,06/16/2015 08:00:00 AM,48,-122,194,392,586
23673,FremontBridge,06/16/2015 09:00:00 AM,48,-122,121,149,270
23674,FremontBridge,06/16/2015 10:00:00 AM,48,-122,48,58,106
23675,FremontBridge,06/16/2015 11:00:00 AM,48,-122,40,64,104
23676,FremontBridge,06/16/2015 12:00:00 PM,48,-122,53,40,93
23677,FremontBridge,06/16/2015 01:00:00 PM,48,-122,54,46,100
23678,FremontBridge,06/16/2015 02:00:00 PM,48,-122,59,48,107
23679,FremontBridge,06/16/2015 03:00:00 PM,48,-122,113,76,189
23680,FremontBridge,06/16/2015 04:00:00 PM,48,-122,258,124,382
23681,FremontBridge,06/16/2015 05:00:00 PM,48,-122,526,215,741
23682,FremontBridge,06/16/2015 06:00:00 PM,48,-122,336,165,501
23683,FremontBridge,06/16/2015 07:00:00 PM,48,-122,145,111,256
23684,FremontBridge,06/16/2015 08:00:00 PM,48,-122,97,59,156
23685,FremontBridge,06/16/2015 09:00:00 PM,48,-122,48,34,82
23686,FremontBridge,06/16/2015 10:00:00 PM,48,-122,30,15,45
23687,FremontBridge,06/16/2015 11:00:00 PM,48,-122,16,11,27
23688,FremontBridge,06/17/2015 12:00:00 AM,48,-122,6,7,13
23689,FremontBridge,06/17/2015 01:00:00 AM,48,-122,5,4,9
23690,FremontBridge,06/17/2015 02:00:00 AM,48,-122,2,2,4
23691,FremontBridge,06/17/2015 03:00:00 AM,48,-122,3,3,6
23692,FremontBridge,06/17/2015 04:00:00 AM,48,-122,2,4,6
23693,FremontBridge,06/17/2015 05:00:00 AM,48,-122,25,29,54
23694,FremontBridge,06/17/2015 06:00:00 AM,48,-122,67,126,193
23695,FremontBridge,06/17/2015 07:00:00 AM,48,-122,144,341,485
23696,FremontBridge,06/17/2015 08:00:00 AM,48,-122,198,399,597
23697,FremontBridge,06/17/2015 09:00:00 AM,48,-122,97,168,265
23698,FremontBridge,06/17/2015 10:00:00 AM,48,-122,63,74,137
23699,FremontBridge,06/17/2015 11:00:00 AM,48,-122,41,47,88
23700,FremontBridge,06/17/2015 12:00:00 PM,48,-122,45,74,119
23701,FremontBridge,06/17/2015 01:00:00 PM,48,-122,56,57,113
23702,FremontBridge,06/17/2015 02:00:00 PM,48,-122,56,56,112
23703,FremontBridge,06/17/2015 03:00:00 PM,48,-122,100,79,179
23704,FremontBridge,06/17/2015 04:00:00 PM,48,-122,229,139,368
23705,FremontBridge,06/17/2015 05:00:00 PM,48,-122,529,210,739
23706,FremontBridge,06/17/2015 06:00:00 PM,48,-122,378,189,567
23707,FremontBridge,06/17/2015 07:00:00 PM,48,-122,156,98,254
23708,FremontBridge,06/17/2015 08:00:00 PM,48,-122,108,89,197
23709,FremontBridge,06/17/2015 09:00:00 PM,48,-122,45,44,89
23710,FremontBridge,06/17/2015 10:00:00 PM,48,-122,40,35,75
23711,FremontBridge,06/17/2015 11:00:00 PM,48,-122,21,21,42
23712,FremontBridge,06/18/2015 12:00:00 AM,48,-122,12,9,21
23713,FremontBridge,06/18/2015 01:00:00 AM,48,-122,2,0,2
23714,FremontBridge,06/18/2015 02:00:00 AM,48,-122,4,2,6
23715,FremontBridge,06/18/2015 03:00:00 AM,48,-122,6,4,10
23716,FremontBridge,06/18/2015 04:00:00 AM,48,-122,8,6,14
23717,FremontBridge,06/18/2015 05:00:00 AM,48,-122,21,36,57
23718,FremontBridge,06/18/2015 06:00:00 AM,48,-122,55,122,177
23719,FremontBridge,06/18/2015 07:00:00 AM,48,-122,128,341,469
23720,FremontBridge,06/18/2015 08:00:00 AM,48,-122,194,354,548
23721,FremontBridge,06/18/2015 09:00:00 AM,48,-122,102,188,290
23722,FremontBridge,06/18/2015 10:00:00 AM,48,-122,57,61,118
23723,FremontBridge,06/18/2015 11:00:00 AM,48,-122,49,51,100
23724,FremontBridge,06/18/2015 12:00:00 PM,48,-122,44,48,92
23725,FremontBridge,06/18/2015 01:00:00 PM,48,-122,54,55,109
23726,FremontBridge,06/18/2015 02:00:00 PM,48,-122,51,59,110
23727,FremontBridge,06/18/2015 03:00:00 PM,48,-122,96,70,166
23728,FremontBridge,06/18/2015 04:00:00 PM,48,-122,215,127,342
23729,FremontBridge,06/18/2015 05:00:00 PM,48,-122,473,226,699
23730,FremontBridge,06/18/2015 06:00:00 PM,48,-122,304,173,477
23731,FremontBridge,06/18/2015 07:00:00 PM,48,-122,135,89,224
23732,FremontBridge,06/18/2015 08:00:00 PM,48,-122,44,61,105
23733,FremontBridge,06/18/2015 09:00:00 PM,48,-122,41,40,81
23734,FremontBridge,06/18/2015 10:00:00 PM,48,-122,26,17,43
23735,FremontBridge,06/18/2015 11:00:00 PM,48,-122,15,9,24
23736,FremontBridge,06/19/2015 12:00:00 AM,48,-122,18,8,26
23737,FremontBridge,06/19/2015 01:00:00 AM,48,-122,2,7,9
23738,FremontBridge,06/19/2015 02:00:00 AM,48,-122,1,2,3
23739,FremontBridge,06/19/2015 03:00:00 AM,48,-122,1,1,2
23740,FremontBridge,06/19/2015 04:00:00 AM,48,-122,4,6,10
23741,FremontBridge,06/19/2015 05:00:00 AM,48,-122,13,19,32
23742,FremontBridge,06/19/2015 06:00:00 AM,48,-122,36,85,121
23743,FremontBridge,06/19/2015 07:00:00 AM,48,-122,82,221,303
23744,FremontBridge,06/19/2015 08:00:00 AM,48,-122,114,277,391
23745,FremontBridge,06/19/2015 09:00:00 AM,48,-122,98,127,225
23746,FremontBridge,06/19/2015 10:00:00 AM,48,-122,59,66,125
23747,FremontBridge,06/19/2015 11:00:00 AM,48,-122,33,37,70
23748,FremontBridge,06/19/2015 12:00:00 PM,48,-122,49,55,104
23749,FremontBridge,06/19/2015 01:00:00 PM,48,-122,45,55,100
23750,FremontBridge,06/19/2015 02:00:00 PM,48,-122,80,62,142
23751,FremontBridge,06/19/2015 03:00:00 PM,48,-122,88,83,171
23752,FremontBridge,06/19/2015 04:00:00 PM,48,-122,213,119,332
23753,FremontBridge,06/19/2015 05:00:00 PM,48,-122,342,136,478
23754,FremontBridge,06/19/2015 06:00:00 PM,48,-122,216,104,320
23755,FremontBridge,06/19/2015 07:00:00 PM,48,-122,99,65,164
23756,FremontBridge,06/19/2015 08:00:00 PM,48,-122,66,50,116
23757,FremontBridge,06/19/2015 09:00:00 PM,48,-122,31,38,69
23758,FremontBridge,06/19/2015 10:00:00 PM,48,-122,24,32,56
23759,FremontBridge,06/19/2015 11:00:00 PM,48,-122,20,28,48
23760,FremontBridge,06/20/2015 12:00:00 AM,48,-122,17,17,34
23761,FremontBridge,06/20/2015 01:00:00 AM,48,-122,8,4,12
23762,FremontBridge,06/20/2015 02:00:00 AM,48,-122,2,3,5
23763,FremontBridge,06/20/2015 03:00:00 AM,48,-122,7,4,11
23764,FremontBridge,06/20/2015 04:00:00 AM,48,-122,3,3,6
23765,FremontBridge,06/20/2015 05:00:00 AM,48,-122,6,6,12
23766,FremontBridge,06/20/2015 06:00:00 AM,48,-122,21,21,42
23767,FremontBridge,06/20/2015 07:00:00 AM,48,-122,29,51,80
23768,FremontBridge,06/20/2015 08:00:00 AM,48,-122,61,57,118
23769,FremontBridge,06/20/2015 09:00:00 AM,48,-122,54,74,128
23770,FremontBridge,06/20/2015 10:00:00 AM,48,-122,96,95,191
23771,FremontBridge,06/20/2015 11:00:00 AM,48,-122,128,96,224
23772,FremontBridge,06/20/2015 12:00:00 PM,48,-122,143,117,260
23773,FremontBridge,06/20/2015 01:00:00 PM,48,-122,149,92,241
23774,FremontBridge,06/20/2015 02:00:00 PM,48,-122,21,28,49
23775,FremontBridge,06/20/2015 03:00:00 PM,48,-122,20,21,41
23776,FremontBridge,06/20/2015 04:00:00 PM,48,-122,28,20,48
23777,FremontBridge,06/20/2015 05:00:00 PM,48,-122,73,53,126
23778,FremontBridge,06/20/2015 06:00:00 PM,48,-122,82,80,162
23779,FremontBridge,06/20/2015 07:00:00 PM,48,-122,64,88,152
23780,FremontBridge,06/20/2015 08:00:00 PM,48,-122,55,80,135
23781,FremontBridge,06/20/2015 09:00:00 PM,48,-122,36,67,103
23782,FremontBridge,06/20/2015 10:00:00 PM,48,-122,27,43,70
23783,FremontBridge,06/20/2015 11:00:00 PM,48,-122,28,45,73
23784,FremontBridge,06/21/2015 12:00:00 AM,48,-122,13,25,38
23785,FremontBridge,06/21/2015 01:00:00 AM,48,-122,8,13,21
23786,FremontBridge,06/21/2015 02:00:00 AM,48,-122,3,6,9
23787,FremontBridge,06/21/2015 03:00:00 AM,48,-122,0,8,8
23788,FremontBridge,06/21/2015 04:00:00 AM,48,-122,2,4,6
23789,FremontBridge,06/21/2015 05:00:00 AM,48,-122,3,2,5
23790,FremontBridge,06/21/2015 06:00:00 AM,48,-122,11,15,26
23791,FremontBridge,06/21/2015 07:00:00 AM,48,-122,16,24,40
23792,FremontBridge,06/21/2015 08:00:00 AM,48,-122,43,57,100
23793,FremontBridge,06/21/2015 09:00:00 AM,48,-122,50,50,100
23794,FremontBridge,06/21/2015 10:00:00 AM,48,-122,59,56,115
23795,FremontBridge,06/21/2015 11:00:00 AM,48,-122,57,101,158
23796,FremontBridge,06/21/2015 12:00:00 PM,48,-122,78,86,164
23797,FremontBridge,06/21/2015 01:00:00 PM,48,-122,90,91,181
23798,FremontBridge,06/21/2015 02:00:00 PM,48,-122,111,109,220
23799,FremontBridge,06/21/2015 03:00:00 PM,48,-122,98,85,183
23800,FremontBridge,06/21/2015 04:00:00 PM,48,-122,93,100,193
23801,FremontBridge,06/21/2015 05:00:00 PM,48,-122,68,64,132
23802,FremontBridge,06/21/2015 06:00:00 PM,48,-122,68,91,159
23803,FremontBridge,06/21/2015 07:00:00 PM,48,-122,46,67,113
23804,FremontBridge,06/21/2015 08:00:00 PM,48,-122,40,47,87
23805,FremontBridge,06/21/2015 09:00:00 PM,48,-122,19,27,46
23806,FremontBridge,06/21/2015 10:00:00 PM,48,-122,16,30,46
23807,FremontBridge,06/21/2015 11:00:00 PM,48,-122,9,11,20
23808,FremontBridge,06/22/2015 12:00:00 AM,48,-122,8,4,12
23809,FremontBridge,06/22/2015 01:00:00 AM,48,-122,6,2,8
23810,FremontBridge,06/22/2015 02:00:00 AM,48,-122,2,2,4
23811,FremontBridge,06/22/2015 03:00:00 AM,48,-122,1,3,4
23812,FremontBridge,06/22/2015 04:00:00 AM,48,-122,2,5,7
23813,FremontBridge,06/22/2015 05:00:00 AM,48,-122,19,29,48
23814,FremontBridge,06/22/2015 06:00:00 AM,48,-122,53,107,160
23815,FremontBridge,06/22/2015 07:00:00 AM,48,-122,106,312,418
23816,FremontBridge,06/22/2015 08:00:00 AM,48,-122,201,392,593
23817,FremontBridge,06/22/2015 09:00:00 AM,48,-122,123,177,300
23818,FremontBridge,06/22/2015 10:00:00 AM,48,-122,49,91,140
23819,FremontBridge,06/22/2015 11:00:00 AM,48,-122,36,63,99
23820,FremontBridge,06/22/2015 12:00:00 PM,48,-122,53,53,106
23821,FremontBridge,06/22/2015 01:00:00 PM,48,-122,45,62,107
23822,FremontBridge,06/22/2015 02:00:00 PM,48,-122,64,54,118
23823,FremontBridge,06/22/2015 03:00:00 PM,48,-122,89,79,168
23824,FremontBridge,06/22/2015 04:00:00 PM,48,-122,244,142,386
23825,FremontBridge,06/22/2015 05:00:00 PM,48,-122,519,205,724
23826,FremontBridge,06/22/2015 06:00:00 PM,48,-122,284,202,486
23827,FremontBridge,06/22/2015 07:00:00 PM,48,-122,142,103,245
23828,FremontBridge,06/22/2015 08:00:00 PM,48,-122,88,62,150
23829,FremontBridge,06/22/2015 09:00:00 PM,48,-122,44,53,97
23830,FremontBridge,06/22/2015 10:00:00 PM,48,-122,29,18,47
23831,FremontBridge,06/22/2015 11:00:00 PM,48,-122,15,14,29
23832,FremontBridge,06/23/2015 12:00:00 AM,48,-122,8,7,15
23833,FremontBridge,06/23/2015 01:00:00 AM,48,-122,3,7,10
23834,FremontBridge,06/23/2015 02:00:00 AM,48,-122,3,1,4
23835,FremontBridge,06/23/2015 03:00:00 AM,48,-122,5,2,7
23836,FremontBridge,06/23/2015 04:00:00 AM,48,-122,9,6,15
23837,FremontBridge,06/23/2015 05:00:00 AM,48,-122,20,40,60
23838,FremontBridge,06/23/2015 06:00:00 AM,48,-122,66,139,205
23839,FremontBridge,06/23/2015 07:00:00 AM,48,-122,133,383,516
23840,FremontBridge,06/23/2015 08:00:00 AM,48,-122,219,401,620
23841,FremontBridge,06/23/2015 09:00:00 AM,48,-122,109,192,301
23842,FremontBridge,06/23/2015 10:00:00 AM,48,-122,66,78,144
23843,FremontBridge,06/23/2015 11:00:00 AM,48,-122,47,61,108
23844,FremontBridge,06/23/2015 12:00:00 PM,48,-122,57,59,116
23845,FremontBridge,06/23/2015 01:00:00 PM,48,-122,51,69,120
23846,FremontBridge,06/23/2015 02:00:00 PM,48,-122,60,62,122
23847,FremontBridge,06/23/2015 03:00:00 PM,48,-122,112,91,203
23848,FremontBridge,06/23/2015 04:00:00 PM,48,-122,246,161,407
23849,FremontBridge,06/23/2015 05:00:00 PM,48,-122,549,244,793
23850,FremontBridge,06/23/2015 06:00:00 PM,48,-122,340,211,551
23851,FremontBridge,06/23/2015 07:00:00 PM,48,-122,159,119,278
23852,FremontBridge,06/23/2015 08:00:00 PM,48,-122,123,80,203
23853,FremontBridge,06/23/2015 09:00:00 PM,48,-122,62,43,105
23854,FremontBridge,06/23/2015 10:00:00 PM,48,-122,36,29,65
23855,FremontBridge,06/23/2015 11:00:00 PM,48,-122,14,16,30
23856,FremontBridge,06/24/2015 12:00:00 AM,48,-122,12,10,22
23857,FremontBridge,06/24/2015 01:00:00 AM,48,-122,4,6,10
23858,FremontBridge,06/24/2015 02:00:00 AM,48,-122,1,2,3
23859,FremontBridge,06/24/2015 03:00:00 AM,48,-122,1,1,2
23860,FremontBridge,06/24/2015 04:00:00 AM,48,-122,6,6,12
23861,FremontBridge,06/24/2015 05:00:00 AM,48,-122,23,33,56
23862,FremontBridge,06/24/2015 06:00:00 AM,48,-122,51,143,194
23863,FremontBridge,06/24/2015 07:00:00 AM,48,-122,151,345,496
23864,FremontBridge,06/24/2015 08:00:00 AM,48,-122,201,445,646
23865,FremontBridge,06/24/2015 09:00:00 AM,48,-122,120,193,313
23866,FremontBridge,06/24/2015 10:00:00 AM,48,-122,52,78,130
23867,FremontBridge,06/24/2015 11:00:00 AM,48,-122,46,46,92
23868,FremontBridge,06/24/2015 12:00:00 PM,48,-122,38,72,110
23869,FremontBridge,06/24/2015 01:00:00 PM,48,-122,46,59,105
23870,FremontBridge,06/24/2015 02:00:00 PM,48,-122,57,52,109
23871,FremontBridge,06/24/2015 03:00:00 PM,48,-122,76,67,143
23872,FremontBridge,06/24/2015 04:00:00 PM,48,-122,254,119,373
23873,FremontBridge,06/24/2015 05:00:00 PM,48,-122,514,241,755
23874,FremontBridge,06/24/2015 06:00:00 PM,48,-122,353,182,535
23875,FremontBridge,06/24/2015 07:00:00 PM,48,-122,148,112,260
23876,FremontBridge,06/24/2015 08:00:00 PM,48,-122,66,84,150
23877,FremontBridge,06/24/2015 09:00:00 PM,48,-122,57,53,110
23878,FremontBridge,06/24/2015 10:00:00 PM,48,-122,43,29,72
23879,FremontBridge,06/24/2015 11:00:00 PM,48,-122,12,15,27
23880,FremontBridge,06/25/2015 12:00:00 AM,48,-122,12,6,18
23881,FremontBridge,06/25/2015 01:00:00 AM,48,-122,6,3,9
23882,FremontBridge,06/25/2015 02:00:00 AM,48,-122,0,1,1
23883,FremontBridge,06/25/2015 03:00:00 AM,48,-122,5,4,9
23884,FremontBridge,06/25/2015 04:00:00 AM,48,-122,2,4,6
23885,FremontBridge,06/25/2015 05:00:00 AM,48,-122,22,43,65
23886,FremontBridge,06/25/2015 06:00:00 AM,48,-122,59,121,180
23887,FremontBridge,06/25/2015 07:00:00 AM,48,-122,120,354,474
23888,FremontBridge,06/25/2015 08:00:00 AM,48,-122,194,408,602
23889,FremontBridge,06/25/2015 09:00:00 AM,48,-122,108,148,256
23890,FremontBridge,06/25/2015 10:00:00 AM,48,-122,58,77,135
23891,FremontBridge,06/25/2015 11:00:00 AM,48,-122,47,84,131
23892,FremontBridge,06/25/2015 12:00:00 PM,48,-122,56,47,103
23893,FremontBridge,06/25/2015 01:00:00 PM,48,-122,47,63,110
23894,FremontBridge,06/25/2015 02:00:00 PM,48,-122,67,53,120
23895,FremontBridge,06/25/2015 03:00:00 PM,48,-122,92,89,181
23896,FremontBridge,06/25/2015 04:00:00 PM,48,-122,242,147,389
23897,FremontBridge,06/25/2015 05:00:00 PM,48,-122,516,212,728
23898,FremontBridge,06/25/2015 06:00:00 PM,48,-122,337,175,512
23899,FremontBridge,06/25/2015 07:00:00 PM,48,-122,167,109,276
23900,FremontBridge,06/25/2015 08:00:00 PM,48,-122,88,74,162
23901,FremontBridge,06/25/2015 09:00:00 PM,48,-122,57,54,111
23902,FremontBridge,06/25/2015 10:00:00 PM,48,-122,30,44,74
23903,FremontBridge,06/25/2015 11:00:00 PM,48,-122,31,26,57
23904,FremontBridge,06/26/2015 12:00:00 AM,48,-122,10,8,18
23905,FremontBridge,06/26/2015 01:00:00 AM,48,-122,6,6,12
23906,FremontBridge,06/26/2015 02:00:00 AM,48,-122,3,2,5
23907,FremontBridge,06/26/2015 03:00:00 AM,48,-122,3,3,6
23908,FremontBridge,06/26/2015 04:00:00 AM,48,-122,2,3,5
23909,FremontBridge,06/26/2015 05:00:00 AM,48,-122,17,19,36
23910,FremontBridge,06/26/2015 06:00:00 AM,48,-122,47,113,160
23911,FremontBridge,06/26/2015 07:00:00 AM,48,-122,104,303,407
23912,FremontBridge,06/26/2015 08:00:00 AM,48,-122,168,327,495
23913,FremontBridge,06/26/2015 09:00:00 AM,48,-122,101,154,255
23914,FremontBridge,06/26/2015 10:00:00 AM,48,-122,50,74,124
23915,FremontBridge,06/26/2015 11:00:00 AM,48,-122,44,58,102
23916,FremontBridge,06/26/2015 12:00:00 PM,48,-122,46,52,98
23917,FremontBridge,06/26/2015 01:00:00 PM,48,-122,50,57,107
23918,FremontBridge,06/26/2015 02:00:00 PM,48,-122,70,62,132
23919,FremontBridge,06/26/2015 03:00:00 PM,48,-122,131,97,228
23920,FremontBridge,06/26/2015 04:00:00 PM,48,-122,221,121,342
23921,FremontBridge,06/26/2015 05:00:00 PM,48,-122,392,149,541
23922,FremontBridge,06/26/2015 06:00:00 PM,48,-122,224,116,340
23923,FremontBridge,06/26/2015 07:00:00 PM,48,-122,94,83,177
23924,FremontBridge,06/26/2015 08:00:00 PM,48,-122,56,39,95
23925,FremontBridge,06/26/2015 09:00:00 PM,48,-122,39,45,84
23926,FremontBridge,06/26/2015 10:00:00 PM,48,-122,35,17,52
23927,FremontBridge,06/26/2015 11:00:00 PM,48,-122,27,21,48
23928,FremontBridge,06/27/2015 12:00:00 AM,48,-122,17,17,34
23929,FremontBridge,06/27/2015 01:00:00 AM,48,-122,12,13,25
23930,FremontBridge,06/27/2015 02:00:00 AM,48,-122,5,5,10
23931,FremontBridge,06/27/2015 03:00:00 AM,48,-122,2,3,5
23932,FremontBridge,06/27/2015 04:00:00 AM,48,-122,6,0,6
23933,FremontBridge,06/27/2015 05:00:00 AM,48,-122,8,7,15
23934,FremontBridge,06/27/2015 06:00:00 AM,48,-122,32,23,55
23935,FremontBridge,06/27/2015 07:00:00 AM,48,-122,41,47,88
23936,FremontBridge,06/27/2015 08:00:00 AM,48,-122,42,92,134
23937,FremontBridge,06/27/2015 09:00:00 AM,48,-122,74,98,172
23938,FremontBridge,06/27/2015 10:00:00 AM,48,-122,90,78,168
23939,FremontBridge,06/27/2015 11:00:00 AM,48,-122,72,86,158
23940,FremontBridge,06/27/2015 12:00:00 PM,48,-122,89,92,181
23941,FremontBridge,06/27/2015 01:00:00 PM,48,-122,66,94,160
23942,FremontBridge,06/27/2015 02:00:00 PM,48,-122,60,73,133
23943,FremontBridge,06/27/2015 03:00:00 PM,48,-122,77,73,150
23944,FremontBridge,06/27/2015 04:00:00 PM,48,-122,72,64,136
23945,FremontBridge,06/27/2015 05:00:00 PM,48,-122,69,52,121
23946,FremontBridge,06/27/2015 06:00:00 PM,48,-122,66,61,127
23947,FremontBridge,06/27/2015 07:00:00 PM,48,-122,43,45,88
23948,FremontBridge,06/27/2015 08:00:00 PM,48,-122,36,45,81
23949,FremontBridge,06/27/2015 09:00:00 PM,48,-122,16,46,62
23950,FremontBridge,06/27/2015 10:00:00 PM,48,-122,32,27,59
23951,FremontBridge,06/27/2015 11:00:00 PM,48,-122,20,22,42
23952,FremontBridge,06/28/2015 12:00:00 AM,48,-122,11,9,20
23953,FremontBridge,06/28/2015 01:00:00 AM,48,-122,6,7,13
23954,FremontBridge,06/28/2015 02:00:00 AM,48,-122,3,3,6
23955,FremontBridge,06/28/2015 03:00:00 AM,48,-122,4,3,7
23956,FremontBridge,06/28/2015 04:00:00 AM,48,-122,3,2,5
23957,FremontBridge,06/28/2015 05:00:00 AM,48,-122,3,6,9
23958,FremontBridge,06/28/2015 06:00:00 AM,48,-122,19,18,37
23959,FremontBridge,06/28/2015 07:00:00 AM,48,-122,34,34,68
23960,FremontBridge,06/28/2015 08:00:00 AM,48,-122,41,45,86
23961,FremontBridge,06/28/2015 09:00:00 AM,48,-122,65,63,128
23962,FremontBridge,06/28/2015 10:00:00 AM,48,-122,57,125,182
23963,FremontBridge,06/28/2015 11:00:00 AM,48,-122,65,110,175
23964,FremontBridge,06/28/2015 12:00:00 PM,48,-122,53,85,138
23965,FremontBridge,06/28/2015 01:00:00 PM,48,-122,65,83,148
23966,FremontBridge,06/28/2015 02:00:00 PM,48,-122,110,72,182
23967,FremontBridge,06/28/2015 03:00:00 PM,48,-122,91,76,167
23968,FremontBridge,06/28/2015 04:00:00 PM,48,-122,107,80,187
23969,FremontBridge,06/28/2015 05:00:00 PM,48,-122,80,70,150
23970,FremontBridge,06/28/2015 06:00:00 PM,48,-122,53,52,105
23971,FremontBridge,06/28/2015 07:00:00 PM,48,-122,31,62,93
23972,FremontBridge,06/28/2015 08:00:00 PM,48,-122,51,41,92
23973,FremontBridge,06/28/2015 09:00:00 PM,48,-122,27,23,50
23974,FremontBridge,06/28/2015 10:00:00 PM,48,-122,10,16,26
23975,FremontBridge,06/28/2015 11:00:00 PM,48,-122,22,5,27
23976,FremontBridge,06/29/2015 12:00:00 AM,48,-122,9,9,18
23977,FremontBridge,06/29/2015 01:00:00 AM,48,-122,6,2,8
23978,FremontBridge,06/29/2015 02:00:00 AM,48,-122,1,1,2
23979,FremontBridge,06/29/2015 03:00:00 AM,48,-122,1,1,2
23980,FremontBridge,06/29/2015 04:00:00 AM,48,-122,1,7,8
23981,FremontBridge,06/29/2015 05:00:00 AM,48,-122,15,34,49
23982,FremontBridge,06/29/2015 06:00:00 AM,48,-122,53,121,174
23983,FremontBridge,06/29/2015 07:00:00 AM,48,-122,125,297,422
23984,FremontBridge,06/29/2015 08:00:00 AM,48,-122,186,386,572
23985,FremontBridge,06/29/2015 09:00:00 AM,48,-122,93,157,250
23986,FremontBridge,06/29/2015 10:00:00 AM,48,-122,28,64,92
23987,FremontBridge,06/29/2015 11:00:00 AM,48,-122,47,58,105
23988,FremontBridge,06/29/2015 12:00:00 PM,48,-122,30,55,85
23989,FremontBridge,06/29/2015 01:00:00 PM,48,-122,45,47,92
23990,FremontBridge,06/29/2015 02:00:00 PM,48,-122,38,50,88
23991,FremontBridge,06/29/2015 03:00:00 PM,48,-122,76,68,144
23992,FremontBridge,06/29/2015 04:00:00 PM,48,-122,217,130,347
23993,FremontBridge,06/29/2015 05:00:00 PM,48,-122,479,192,671
23994,FremontBridge,06/29/2015 06:00:00 PM,48,-122,281,164,445
23995,FremontBridge,06/29/2015 07:00:00 PM,48,-122,135,130,265
23996,FremontBridge,06/29/2015 08:00:00 PM,48,-122,81,72,153
23997,FremontBridge,06/29/2015 09:00:00 PM,48,-122,45,64,109
23998,FremontBridge,06/29/2015 10:00:00 PM,48,-122,28,24,52
23999,FremontBridge,06/29/2015 11:00:00 PM,48,-122,13,15,28
24000,FremontBridge,06/30/2015 12:00:00 AM,48,-122,9,8,17
24001,FremontBridge,06/30/2015 01:00:00 AM,48,-122,4,6,10
24002,FremontBridge,06/30/2015 02:00:00 AM,48,-122,5,1,6
24003,FremontBridge,06/30/2015 03:00:00 AM,48,-122,6,3,9
24004,FremontBridge,06/30/2015 04:00:00 AM,48,-122,1,4,5
24005,FremontBridge,06/30/2015 05:00:00 AM,48,-122,14,36,50
24006,FremontBridge,06/30/2015 06:00:00 AM,48,-122,69,147,216
24007,FremontBridge,06/30/2015 07:00:00 AM,48,-122,126,334,460
24008,FremontBridge,06/30/2015 08:00:00 AM,48,-122,173,390,563
24009,FremontBridge,06/30/2015 09:00:00 AM,48,-122,115,200,315
24010,FremontBridge,06/30/2015 10:00:00 AM,48,-122,55,75,130
24011,FremontBridge,06/30/2015 11:00:00 AM,48,-122,55,55,110
24012,FremontBridge,06/30/2015 12:00:00 PM,48,-122,58,65,123
24013,FremontBridge,06/30/2015 01:00:00 PM,48,-122,40,50,90
24014,FremontBridge,06/30/2015 02:00:00 PM,48,-122,53,64,117
24015,FremontBridge,06/30/2015 03:00:00 PM,48,-122,109,73,182
24016,FremontBridge,06/30/2015 04:00:00 PM,48,-122,237,151,388
24017,FremontBridge,06/30/2015 05:00:00 PM,48,-122,469,181,650
24018,FremontBridge,06/30/2015 06:00:00 PM,48,-122,379,184,563
24019,FremontBridge,06/30/2015 07:00:00 PM,48,-122,168,114,282
24020,FremontBridge,06/30/2015 08:00:00 PM,48,-122,95,67,162
24021,FremontBridge,06/30/2015 09:00:00 PM,48,-122,62,42,104
24022,FremontBridge,06/30/2015 10:00:00 PM,48,-122,38,31,69
24023,FremontBridge,06/30/2015 11:00:00 PM,48,-122,16,18,34
24024,FremontBridge,07/01/2015 12:00:00 AM,48,-122,7,7,14
24025,FremontBridge,07/01/2015 01:00:00 AM,48,-122,4,5,9
24026,FremontBridge,07/01/2015 02:00:00 AM,48,-122,7,2,9
24027,FremontBridge,07/01/2015 03:00:00 AM,48,-122,7,4,11
24028,FremontBridge,07/01/2015 04:00:00 AM,48,-122,4,9,13
24029,FremontBridge,07/01/2015 05:00:00 AM,48,-122,19,33,52
24030,FremontBridge,07/01/2015 06:00:00 AM,48,-122,69,132,201
24031,FremontBridge,07/01/2015 07:00:00 AM,48,-122,148,371,519
24032,FremontBridge,07/01/2015 08:00:00 AM,48,-122,201,390,591
24033,FremontBridge,07/01/2015 09:00:00 AM,48,-122,101,160,261
24034,FremontBridge,07/01/2015 10:00:00 AM,48,-122,50,83,133
24035,FremontBridge,07/01/2015 11:00:00 AM,48,-122,42,60,102
24036,FremontBridge,07/01/2015 12:00:00 PM,48,-122,59,56,115
24037,FremontBridge,07/01/2015 01:00:00 PM,48,-122,48,57,105
24038,FremontBridge,07/01/2015 02:00:00 PM,48,-122,61,76,137
24039,FremontBridge,07/01/2015 03:00:00 PM,48,-122,85,75,160
24040,FremontBridge,07/01/2015 04:00:00 PM,48,-122,215,121,336
24041,FremontBridge,07/01/2015 05:00:00 PM,48,-122,508,212,720
24042,FremontBridge,07/01/2015 06:00:00 PM,48,-122,329,163,492
24043,FremontBridge,07/01/2015 07:00:00 PM,48,-122,168,114,282
24044,FremontBridge,07/01/2015 08:00:00 PM,48,-122,99,76,175
24045,FremontBridge,07/01/2015 09:00:00 PM,48,-122,61,48,109
24046,FremontBridge,07/01/2015 10:00:00 PM,48,-122,24,35,59
24047,FremontBridge,07/01/2015 11:00:00 PM,48,-122,23,23,46
24048,FremontBridge,07/02/2015 12:00:00 AM,48,-122,9,5,14
24049,FremontBridge,07/02/2015 01:00:00 AM,48,-122,4,5,9
24050,FremontBridge,07/02/2015 02:00:00 AM,48,-122,5,2,7
24051,FremontBridge,07/02/2015 03:00:00 AM,48,-122,3,2,5
24052,FremontBridge,07/02/2015 04:00:00 AM,48,-122,3,7,10
24053,FremontBridge,07/02/2015 05:00:00 AM,48,-122,26,27,53
24054,FremontBridge,07/02/2015 06:00:00 AM,48,-122,52,111,163
24055,FremontBridge,07/02/2015 07:00:00 AM,48,-122,123,273,396
24056,FremontBridge,07/02/2015 08:00:00 AM,48,-122,170,380,550
24057,FremontBridge,07/02/2015 09:00:00 AM,48,-122,99,152,251
24058,FremontBridge,07/02/2015 10:00:00 AM,48,-122,51,75,126
24059,FremontBridge,07/02/2015 11:00:00 AM,48,-122,39,50,89
24060,FremontBridge,07/02/2015 12:00:00 PM,48,-122,45,59,104
24061,FremontBridge,07/02/2015 01:00:00 PM,48,-122,48,47,95
24062,FremontBridge,07/02/2015 02:00:00 PM,48,-122,76,53,129
24063,FremontBridge,07/02/2015 03:00:00 PM,48,-122,116,75,191
24064,FremontBridge,07/02/2015 04:00:00 PM,48,-122,221,135,356
24065,FremontBridge,07/02/2015 05:00:00 PM,48,-122,365,159,524
24066,FremontBridge,07/02/2015 06:00:00 PM,48,-122,232,129,361
24067,FremontBridge,07/02/2015 07:00:00 PM,48,-122,108,71,179
24068,FremontBridge,07/02/2015 08:00:00 PM,48,-122,63,49,112
24069,FremontBridge,07/02/2015 09:00:00 PM,48,-122,52,55,107
24070,FremontBridge,07/02/2015 10:00:00 PM,48,-122,39,34,73
24071,FremontBridge,07/02/2015 11:00:00 PM,48,-122,18,15,33
24072,FremontBridge,07/03/2015 12:00:00 AM,48,-122,24,12,36
24073,FremontBridge,07/03/2015 01:00:00 AM,48,-122,9,10,19
24074,FremontBridge,07/03/2015 02:00:00 AM,48,-122,4,2,6
24075,FremontBridge,07/03/2015 03:00:00 AM,48,-122,3,3,6
24076,FremontBridge,07/03/2015 04:00:00 AM,48,-122,3,4,7
24077,FremontBridge,07/03/2015 05:00:00 AM,48,-122,8,11,19
24078,FremontBridge,07/03/2015 06:00:00 AM,48,-122,21,23,44
24079,FremontBridge,07/03/2015 07:00:00 AM,48,-122,35,55,90
24080,FremontBridge,07/03/2015 08:00:00 AM,48,-122,64,74,138
24081,FremontBridge,07/03/2015 09:00:00 AM,48,-122,68,89,157
24082,FremontBridge,07/03/2015 10:00:00 AM,48,-122,66,87,153
24083,FremontBridge,07/03/2015 11:00:00 AM,48,-122,72,104,176
24084,FremontBridge,07/03/2015 12:00:00 PM,48,-122,86,100,186
24085,FremontBridge,07/03/2015 01:00:00 PM,48,-122,85,113,198
24086,FremontBridge,07/03/2015 02:00:00 PM,48,-122,74,59,133
24087,FremontBridge,07/03/2015 03:00:00 PM,48,-122,56,77,133
24088,FremontBridge,07/03/2015 04:00:00 PM,48,-122,90,87,177
24089,FremontBridge,07/03/2015 05:00:00 PM,48,-122,67,79,146
24090,FremontBridge,07/03/2015 06:00:00 PM,48,-122,72,68,140
24091,FremontBridge,07/03/2015 07:00:00 PM,48,-122,58,49,107
24092,FremontBridge,07/03/2015 08:00:00 PM,48,-122,44,40,84
24093,FremontBridge,07/03/2015 09:00:00 PM,48,-122,24,25,49
24094,FremontBridge,07/03/2015 10:00:00 PM,48,-122,34,35,69
24095,FremontBridge,07/03/2015 11:00:00 PM,48,-122,23,17,40
24096,FremontBridge,07/04/2015 12:00:00 AM,48,-122,10,12,22
24097,FremontBridge,07/04/2015 01:00:00 AM,48,-122,10,4,14
24098,FremontBridge,07/04/2015 02:00:00 AM,48,-122,2,2,4
24099,FremontBridge,07/04/2015 03:00:00 AM,48,-122,2,3,5
24100,FremontBridge,07/04/2015 04:00:00 AM,48,-122,0,3,3
24101,FremontBridge,07/04/2015 05:00:00 AM,48,-122,5,7,12
24102,FremontBridge,07/04/2015 06:00:00 AM,48,-122,16,23,39
24103,FremontBridge,07/04/2015 07:00:00 AM,48,-122,36,37,73
24104,FremontBridge,07/04/2015 08:00:00 AM,48,-122,61,75,136
24105,FremontBridge,07/04/2015 09:00:00 AM,48,-122,75,74,149
24106,FremontBridge,07/04/2015 10:00:00 AM,48,-122,65,77,142
24107,FremontBridge,07/04/2015 11:00:00 AM,48,-122,56,79,135
24108,FremontBridge,07/04/2015 12:00:00 PM,48,-122,103,91,194
24109,FremontBridge,07/04/2015 01:00:00 PM,48,-122,70,84,154
24110,FremontBridge,07/04/2015 02:00:00 PM,48,-122,71,87,158
24111,FremontBridge,07/04/2015 03:00:00 PM,48,-122,82,83,165
24112,FremontBridge,07/04/2015 04:00:00 PM,48,-122,88,64,152
24113,FremontBridge,07/04/2015 05:00:00 PM,48,-122,68,60,128
24114,FremontBridge,07/04/2015 06:00:00 PM,48,-122,51,75,126
24115,FremontBridge,07/04/2015 07:00:00 PM,48,-122,62,52,114
24116,FremontBridge,07/04/2015 08:00:00 PM,48,-122,58,62,120
24117,FremontBridge,07/04/2015 09:00:00 PM,48,-122,61,71,132
24118,FremontBridge,07/04/2015 10:00:00 PM,48,-122,43,48,91
24119,FremontBridge,07/04/2015 11:00:00 PM,48,-122,101,74,175
24120,FremontBridge,07/05/2015 12:00:00 AM,48,-122,62,30,92
24121,FremontBridge,07/05/2015 01:00:00 AM,48,-122,15,15,30
24122,FremontBridge,07/05/2015 02:00:00 AM,48,-122,8,5,13
24123,FremontBridge,07/05/2015 03:00:00 AM,48,-122,1,0,1
24124,FremontBridge,07/05/2015 04:00:00 AM,48,-122,2,4,6
24125,FremontBridge,07/05/2015 05:00:00 AM,48,-122,5,5,10
24126,FremontBridge,07/05/2015 06:00:00 AM,48,-122,10,12,22
24127,FremontBridge,07/05/2015 07:00:00 AM,48,-122,26,44,70
24128,FremontBridge,07/05/2015 08:00:00 AM,48,-122,37,38,75
24129,FremontBridge,07/05/2015 09:00:00 AM,48,-122,52,51,103
24130,FremontBridge,07/05/2015 10:00:00 AM,48,-122,69,64,133
24131,FremontBridge,07/05/2015 11:00:00 AM,48,-122,68,95,163
24132,FremontBridge,07/05/2015 12:00:00 PM,48,-122,54,80,134
24133,FremontBridge,07/05/2015 01:00:00 PM,48,-122,71,82,153
24134,FremontBridge,07/05/2015 02:00:00 PM,48,-122,68,66,134
24135,FremontBridge,07/05/2015 03:00:00 PM,48,-122,65,92,157
24136,FremontBridge,07/05/2015 04:00:00 PM,48,-122,80,57,137
24137,FremontBridge,07/05/2015 05:00:00 PM,48,-122,39,48,87
24138,FremontBridge,07/05/2015 06:00:00 PM,48,-122,52,67,119
24139,FremontBridge,07/05/2015 07:00:00 PM,48,-122,55,52,107
24140,FremontBridge,07/05/2015 08:00:00 PM,48,-122,26,47,73
24141,FremontBridge,07/05/2015 09:00:00 PM,48,-122,22,31,53
24142,FremontBridge,07/05/2015 10:00:00 PM,48,-122,16,15,31
24143,FremontBridge,07/05/2015 11:00:00 PM,48,-122,8,8,16
24144,FremontBridge,07/06/2015 12:00:00 AM,48,-122,8,8,16
24145,FremontBridge,07/06/2015 01:00:00 AM,48,-122,3,4,7
24146,FremontBridge,07/06/2015 02:00:00 AM,48,-122,2,5,7
24147,FremontBridge,07/06/2015 03:00:00 AM,48,-122,2,4,6
24148,FremontBridge,07/06/2015 04:00:00 AM,48,-122,3,6,9
24149,FremontBridge,07/06/2015 05:00:00 AM,48,-122,12,22,34
24150,FremontBridge,07/06/2015 06:00:00 AM,48,-122,60,117,177
24151,FremontBridge,07/06/2015 07:00:00 AM,48,-122,116,288,404
24152,FremontBridge,07/06/2015 08:00:00 AM,48,-122,167,368,535
24153,FremontBridge,07/06/2015 09:00:00 AM,48,-122,104,148,252
24154,FremontBridge,07/06/2015 10:00:00 AM,48,-122,52,58,110
24155,FremontBridge,07/06/2015 11:00:00 AM,48,-122,38,61,99
24156,FremontBridge,07/06/2015 12:00:00 PM,48,-122,57,49,106
24157,FremontBridge,07/06/2015 01:00:00 PM,48,-122,54,47,101
24158,FremontBridge,07/06/2015 02:00:00 PM,48,-122,62,60,122
24159,FremontBridge,07/06/2015 03:00:00 PM,48,-122,84,54,138
24160,FremontBridge,07/06/2015 04:00:00 PM,48,-122,163,118,281
24161,FremontBridge,07/06/2015 05:00:00 PM,48,-122,471,180,651
24162,FremontBridge,07/06/2015 06:00:00 PM,48,-122,327,158,485
24163,FremontBridge,07/06/2015 07:00:00 PM,48,-122,120,98,218
24164,FremontBridge,07/06/2015 08:00:00 PM,48,-122,84,71,155
24165,FremontBridge,07/06/2015 09:00:00 PM,48,-122,42,46,88
24166,FremontBridge,07/06/2015 10:00:00 PM,48,-122,26,20,46
24167,FremontBridge,07/06/2015 11:00:00 PM,48,-122,10,9,19
24168,FremontBridge,07/07/2015 12:00:00 AM,48,-122,10,9,19
24169,FremontBridge,07/07/2015 01:00:00 AM,48,-122,2,3,5
24170,FremontBridge,07/07/2015 02:00:00 AM,48,-122,2,8,10
24171,FremontBridge,07/07/2015 03:00:00 AM,48,-122,4,3,7
24172,FremontBridge,07/07/2015 04:00:00 AM,48,-122,5,4,9
24173,FremontBridge,07/07/2015 05:00:00 AM,48,-122,24,33,57
24174,FremontBridge,07/07/2015 06:00:00 AM,48,-122,66,113,179
24175,FremontBridge,07/07/2015 07:00:00 AM,48,-122,138,364,502
24176,FremontBridge,07/07/2015 08:00:00 AM,48,-122,204,403,607
24177,FremontBridge,07/07/2015 09:00:00 AM,48,-122,98,176,274
24178,FremontBridge,07/07/2015 10:00:00 AM,48,-122,60,92,152
24179,FremontBridge,07/07/2015 11:00:00 AM,48,-122,55,55,110
24180,FremontBridge,07/07/2015 12:00:00 PM,48,-122,64,64,128
24181,FremontBridge,07/07/2015 01:00:00 PM,48,-122,55,52,107
24182,FremontBridge,07/07/2015 02:00:00 PM,48,-122,59,68,127
24183,FremontBridge,07/07/2015 03:00:00 PM,48,-122,96,69,165
24184,FremontBridge,07/07/2015 04:00:00 PM,48,-122,209,148,357
24185,FremontBridge,07/07/2015 05:00:00 PM,48,-122,526,194,720
24186,FremontBridge,07/07/2015 06:00:00 PM,48,-122,301,197,498
24187,FremontBridge,07/07/2015 07:00:00 PM,48,-122,157,106,263
24188,FremontBridge,07/07/2015 08:00:00 PM,48,-122,87,67,154
24189,FremontBridge,07/07/2015 09:00:00 PM,48,-122,46,48,94
24190,FremontBridge,07/07/2015 10:00:00 PM,48,-122,34,27,61
24191,FremontBridge,07/07/2015 11:00:00 PM,48,-122,19,11,30
24192,FremontBridge,07/08/2015 12:00:00 AM,48,-122,11,9,20
24193,FremontBridge,07/08/2015 01:00:00 AM,48,-122,5,10,15
24194,FremontBridge,07/08/2015 02:00:00 AM,48,-122,1,7,8
24195,FremontBridge,07/08/2015 03:00:00 AM,48,-122,1,3,4
24196,FremontBridge,07/08/2015 04:00:00 AM,48,-122,3,5,8
24197,FremontBridge,07/08/2015 05:00:00 AM,48,-122,18,32,50
24198,FremontBridge,07/08/2015 06:00:00 AM,48,-122,52,145,197
24199,FremontBridge,07/08/2015 07:00:00 AM,48,-122,153,334,487
24200,FremontBridge,07/08/2015 08:00:00 AM,48,-122,210,373,583
24201,FremontBridge,07/08/2015 09:00:00 AM,48,-122,108,174,282
24202,FremontBridge,07/08/2015 10:00:00 AM,48,-122,59,83,142
24203,FremontBridge,07/08/2015 11:00:00 AM,48,-122,48,58,106
24204,FremontBridge,07/08/2015 12:00:00 PM,48,-122,51,71,122
24205,FremontBridge,07/08/2015 01:00:00 PM,48,-122,46,73,119
24206,FremontBridge,07/08/2015 02:00:00 PM,48,-122,49,64,113
24207,FremontBridge,07/08/2015 03:00:00 PM,48,-122,77,71,148
24208,FremontBridge,07/08/2015 04:00:00 PM,48,-122,256,143,399
24209,FremontBridge,07/08/2015 05:00:00 PM,48,-122,508,218,726
24210,FremontBridge,07/08/2015 06:00:00 PM,48,-122,326,201,527
24211,FremontBridge,07/08/2015 07:00:00 PM,48,-122,174,132,306
24212,FremontBridge,07/08/2015 08:00:00 PM,48,-122,91,100,191
24213,FremontBridge,07/08/2015 09:00:00 PM,48,-122,60,55,115
24214,FremontBridge,07/08/2015 10:00:00 PM,48,-122,36,29,65
24215,FremontBridge,07/08/2015 11:00:00 PM,48,-122,15,13,28
24216,FremontBridge,07/09/2015 12:00:00 AM,48,-122,13,13,26
24217,FremontBridge,07/09/2015 01:00:00 AM,48,-122,3,3,6
24218,FremontBridge,07/09/2015 02:00:00 AM,48,-122,2,3,5
24219,FremontBridge,07/09/2015 03:00:00 AM,48,-122,3,2,5
24220,FremontBridge,07/09/2015 04:00:00 AM,48,-122,8,2,10
24221,FremontBridge,07/09/2015 05:00:00 AM,48,-122,32,20,52
24222,FremontBridge,07/09/2015 06:00:00 AM,48,-122,51,140,191
24223,FremontBridge,07/09/2015 07:00:00 AM,48,-122,138,334,472
24224,FremontBridge,07/09/2015 08:00:00 AM,48,-122,217,376,593
24225,FremontBridge,07/09/2015 09:00:00 AM,48,-122,102,157,259
24226,FremontBridge,07/09/2015 10:00:00 AM,48,-122,40,78,118
24227,FremontBridge,07/09/2015 11:00:00 AM,48,-122,55,51,106
24228,FremontBridge,07/09/2015 12:00:00 PM,48,-122,41,58,99
24229,FremontBridge,07/09/2015 01:00:00 PM,48,-122,48,62,110
24230,FremontBridge,07/09/2015 02:00:00 PM,48,-122,62,51,113
24231,FremontBridge,07/09/2015 03:00:00 PM,48,-122,78,75,153
24232,FremontBridge,07/09/2015 04:00:00 PM,48,-122,221,129,350
24233,FremontBridge,07/09/2015 05:00:00 PM,48,-122,472,204,676
24234,FremontBridge,07/09/2015 06:00:00 PM,48,-122,306,173,479
24235,FremontBridge,07/09/2015 07:00:00 PM,48,-122,168,112,280
24236,FremontBridge,07/09/2015 08:00:00 PM,48,-122,88,85,173
24237,FremontBridge,07/09/2015 09:00:00 PM,48,-122,48,51,99
24238,FremontBridge,07/09/2015 10:00:00 PM,48,-122,40,25,65
24239,FremontBridge,07/09/2015 11:00:00 PM,48,-122,22,17,39
24240,FremontBridge,07/10/2015 12:00:00 AM,48,-122,5,6,11
24241,FremontBridge,07/10/2015 01:00:00 AM,48,-122,8,5,13
24242,FremontBridge,07/10/2015 02:00:00 AM,48,-122,6,2,8
24243,FremontBridge,07/10/2015 03:00:00 AM,48,-122,3,2,5
24244,FremontBridge,07/10/2015 04:00:00 AM,48,-122,6,6,12
24245,FremontBridge,07/10/2015 05:00:00 AM,48,-122,17,32,49
24246,FremontBridge,07/10/2015 06:00:00 AM,48,-122,50,89,139
24247,FremontBridge,07/10/2015 07:00:00 AM,48,-122,108,249,357
24248,FremontBridge,07/10/2015 08:00:00 AM,48,-122,166,343,509
24249,FremontBridge,07/10/2015 09:00:00 AM,48,-122,106,154,260
24250,FremontBridge,07/10/2015 10:00:00 AM,48,-122,49,72,121
24251,FremontBridge,07/10/2015 11:00:00 AM,48,-122,50,48,98
24252,FremontBridge,07/10/2015 12:00:00 PM,48,-122,45,50,95
24253,FremontBridge,07/10/2015 01:00:00 PM,48,-122,58,62,120
24254,FremontBridge,07/10/2015 02:00:00 PM,48,-122,73,59,132
24255,FremontBridge,07/10/2015 03:00:00 PM,48,-122,85,103,188
24256,FremontBridge,07/10/2015 04:00:00 PM,48,-122,223,144,367
24257,FremontBridge,07/10/2015 05:00:00 PM,48,-122,382,154,536
24258,FremontBridge,07/10/2015 06:00:00 PM,48,-122,221,119,340
24259,FremontBridge,07/10/2015 07:00:00 PM,48,-122,118,66,184
24260,FremontBridge,07/10/2015 08:00:00 PM,48,-122,40,43,83
24261,FremontBridge,07/10/2015 09:00:00 PM,48,-122,27,32,59
24262,FremontBridge,07/10/2015 10:00:00 PM,48,-122,23,24,47
24263,FremontBridge,07/10/2015 11:00:00 PM,48,-122,27,12,39
24264,FremontBridge,07/11/2015 12:00:00 AM,48,-122,15,12,27
24265,FremontBridge,07/11/2015 01:00:00 AM,48,-122,6,7,13
24266,FremontBridge,07/11/2015 02:00:00 AM,48,-122,6,7,13
24267,FremontBridge,07/11/2015 03:00:00 AM,48,-122,6,2,8
24268,FremontBridge,07/11/2015 04:00:00 AM,48,-122,36,15,51
24269,FremontBridge,07/11/2015 05:00:00 AM,48,-122,54,13,67
24270,FremontBridge,07/11/2015 06:00:00 AM,48,-122,34,22,56
24271,FremontBridge,07/11/2015 07:00:00 AM,48,-122,32,33,65
24272,FremontBridge,07/11/2015 08:00:00 AM,48,-122,37,50,87
24273,FremontBridge,07/11/2015 09:00:00 AM,48,-122,41,77,118
24274,FremontBridge,07/11/2015 10:00:00 AM,48,-122,64,62,126
24275,FremontBridge,07/11/2015 11:00:00 AM,48,-122,69,66,135
24276,FremontBridge,07/11/2015 12:00:00 PM,48,-122,70,90,160
24277,FremontBridge,07/11/2015 01:00:00 PM,48,-122,66,84,150
24278,FremontBridge,07/11/2015 02:00:00 PM,48,-122,63,68,131
24279,FremontBridge,07/11/2015 03:00:00 PM,48,-122,74,94,168
24280,FremontBridge,07/11/2015 04:00:00 PM,48,-122,56,91,147
24281,FremontBridge,07/11/2015 05:00:00 PM,48,-122,63,81,144
24282,FremontBridge,07/11/2015 06:00:00 PM,48,-122,41,62,103
24283,FremontBridge,07/11/2015 07:00:00 PM,48,-122,36,39,75
24284,FremontBridge,07/11/2015 08:00:00 PM,48,-122,36,29,65
24285,FremontBridge,07/11/2015 09:00:00 PM,48,-122,27,37,64
24286,FremontBridge,07/11/2015 10:00:00 PM,48,-122,34,16,50
24287,FremontBridge,07/11/2015 11:00:00 PM,48,-122,19,11,30
24288,FremontBridge,07/12/2015 12:00:00 AM,48,-122,11,14,25
24289,FremontBridge,07/12/2015 01:00:00 AM,48,-122,9,8,17
24290,FremontBridge,07/12/2015 02:00:00 AM,48,-122,10,4,14
24291,FremontBridge,07/12/2015 03:00:00 AM,48,-122,2,1,3
24292,FremontBridge,07/12/2015 04:00:00 AM,48,-122,5,2,7
24293,FremontBridge,07/12/2015 05:00:00 AM,48,-122,4,5,9
24294,FremontBridge,07/12/2015 06:00:00 AM,48,-122,7,6,13
24295,FremontBridge,07/12/2015 07:00:00 AM,48,-122,16,21,37
24296,FremontBridge,07/12/2015 08:00:00 AM,48,-122,21,45,66
24297,FremontBridge,07/12/2015 09:00:00 AM,48,-122,41,46,87
24298,FremontBridge,07/12/2015 10:00:00 AM,48,-122,45,59,104
24299,FremontBridge,07/12/2015 11:00:00 AM,48,-122,79,79,158
24300,FremontBridge,07/12/2015 12:00:00 PM,48,-122,84,91,175
24301,FremontBridge,07/12/2015 01:00:00 PM,48,-122,72,97,169
24302,FremontBridge,07/12/2015 02:00:00 PM,48,-122,104,108,212
24303,FremontBridge,07/12/2015 03:00:00 PM,48,-122,76,116,192
24304,FremontBridge,07/12/2015 04:00:00 PM,48,-122,84,102,186
24305,FremontBridge,07/12/2015 05:00:00 PM,48,-122,83,94,177
24306,FremontBridge,07/12/2015 06:00:00 PM,48,-122,59,66,125
24307,FremontBridge,07/12/2015 07:00:00 PM,48,-122,45,49,94
24308,FremontBridge,07/12/2015 08:00:00 PM,48,-122,36,33,69
24309,FremontBridge,07/12/2015 09:00:00 PM,48,-122,22,30,52
24310,FremontBridge,07/12/2015 10:00:00 PM,48,-122,15,8,23
24311,FremontBridge,07/12/2015 11:00:00 PM,48,-122,11,12,23
24312,FremontBridge,07/13/2015 12:00:00 AM,48,-122,7,4,11
24313,FremontBridge,07/13/2015 01:00:00 AM,48,-122,1,1,2
24314,FremontBridge,07/13/2015 02:00:00 AM,48,-122,5,0,5
24315,FremontBridge,07/13/2015 03:00:00 AM,48,-122,4,1,5
24316,FremontBridge,07/13/2015 04:00:00 AM,48,-122,1,5,6
24317,FremontBridge,07/13/2015 05:00:00 AM,48,-122,11,32,43
24318,FremontBridge,07/13/2015 06:00:00 AM,48,-122,55,102,157
24319,FremontBridge,07/13/2015 07:00:00 AM,48,-122,114,284,398
24320,FremontBridge,07/13/2015 08:00:00 AM,48,-122,164,362,526
24321,FremontBridge,07/13/2015 09:00:00 AM,48,-122,106,139,245
24322,FremontBridge,07/13/2015 10:00:00 AM,48,-122,42,50,92
24323,FremontBridge,07/13/2015 11:00:00 AM,48,-122,51,47,98
24324,FremontBridge,07/13/2015 12:00:00 PM,48,-122,41,49,90
24325,FremontBridge,07/13/2015 01:00:00 PM,48,-122,41,49,90
24326,FremontBridge,07/13/2015 02:00:00 PM,48,-122,43,56,99
24327,FremontBridge,07/13/2015 03:00:00 PM,48,-122,99,73,172
24328,FremontBridge,07/13/2015 04:00:00 PM,48,-122,198,136,334
24329,FremontBridge,07/13/2015 05:00:00 PM,48,-122,452,182,634
24330,FremontBridge,07/13/2015 06:00:00 PM,48,-122,347,171,518
24331,FremontBridge,07/13/2015 07:00:00 PM,48,-122,135,81,216
24332,FremontBridge,07/13/2015 08:00:00 PM,48,-122,92,62,154
24333,FremontBridge,07/13/2015 09:00:00 PM,48,-122,54,42,96
24334,FremontBridge,07/13/2015 10:00:00 PM,48,-122,25,35,60
24335,FremontBridge,07/13/2015 11:00:00 PM,48,-122,8,10,18
24336,FremontBridge,07/14/2015 12:00:00 AM,48,-122,13,3,16
24337,FremontBridge,07/14/2015 01:00:00 AM,48,-122,4,5,9
24338,FremontBridge,07/14/2015 02:00:00 AM,48,-122,4,1,5
24339,FremontBridge,07/14/2015 03:00:00 AM,48,-122,1,3,4
24340,FremontBridge,07/14/2015 04:00:00 AM,48,-122,4,7,11
24341,FremontBridge,07/14/2015 05:00:00 AM,48,-122,17,28,45
24342,FremontBridge,07/14/2015 06:00:00 AM,48,-122,63,146,209
24343,FremontBridge,07/14/2015 07:00:00 AM,48,-122,146,390,536
24344,FremontBridge,07/14/2015 08:00:00 AM,48,-122,190,448,638
24345,FremontBridge,07/14/2015 09:00:00 AM,48,-122,132,160,292
24346,FremontBridge,07/14/2015 10:00:00 AM,48,-122,73,0,73
24347,FremontBridge,07/14/2015 11:00:00 AM,48,-122,63,23,86
24348,FremontBridge,07/14/2015 12:00:00 PM,48,-122,50,55,105
24349,FremontBridge,07/14/2015 01:00:00 PM,48,-122,49,73,122
24350,FremontBridge,07/14/2015 02:00:00 PM,48,-122,57,62,119
24351,FremontBridge,07/14/2015 03:00:00 PM,48,-122,82,85,167
24352,FremontBridge,07/14/2015 04:00:00 PM,48,-122,228,160,388
24353,FremontBridge,07/14/2015 05:00:00 PM,48,-122,527,233,760
24354,FremontBridge,07/14/2015 06:00:00 PM,48,-122,340,172,512
24355,FremontBridge,07/14/2015 07:00:00 PM,48,-122,186,121,307
24356,FremontBridge,07/14/2015 08:00:00 PM,48,-122,115,73,188
24357,FremontBridge,07/14/2015 09:00:00 PM,48,-122,57,56,113
24358,FremontBridge,07/14/2015 10:00:00 PM,48,-122,31,25,56
24359,FremontBridge,07/14/2015 11:00:00 PM,48,-122,14,20,34
24360,FremontBridge,07/15/2015 12:00:00 AM,48,-122,5,3,8
24361,FremontBridge,07/15/2015 01:00:00 AM,48,-122,5,5,10
24362,FremontBridge,07/15/2015 02:00:00 AM,48,-122,6,2,8
24363,FremontBridge,07/15/2015 03:00:00 AM,48,-122,2,4,6
24364,FremontBridge,07/15/2015 04:00:00 AM,48,-122,6,6,12
24365,FremontBridge,07/15/2015 05:00:00 AM,48,-122,23,27,50
24366,FremontBridge,07/15/2015 06:00:00 AM,48,-122,53,147,200
24367,FremontBridge,07/15/2015 07:00:00 AM,48,-122,154,354,508
24368,FremontBridge,07/15/2015 08:00:00 AM,48,-122,220,397,617
24369,FremontBridge,07/15/2015 09:00:00 AM,48,-122,113,175,288
24370,FremontBridge,07/15/2015 10:00:00 AM,48,-122,66,63,129
24371,FremontBridge,07/15/2015 11:00:00 AM,48,-122,47,64,111
24372,FremontBridge,07/15/2015 12:00:00 PM,48,-122,40,44,84
24373,FremontBridge,07/15/2015 01:00:00 PM,48,-122,53,44,97
24374,FremontBridge,07/15/2015 02:00:00 PM,48,-122,75,48,123
24375,FremontBridge,07/15/2015 03:00:00 PM,48,-122,88,87,175
24376,FremontBridge,07/15/2015 04:00:00 PM,48,-122,206,149,355
24377,FremontBridge,07/15/2015 05:00:00 PM,48,-122,553,220,773
24378,FremontBridge,07/15/2015 06:00:00 PM,48,-122,336,170,506
24379,FremontBridge,07/15/2015 07:00:00 PM,48,-122,165,104,269
24380,FremontBridge,07/15/2015 08:00:00 PM,48,-122,104,72,176
24381,FremontBridge,07/15/2015 09:00:00 PM,48,-122,50,31,81
24382,FremontBridge,07/15/2015 10:00:00 PM,48,-122,34,35,69
24383,FremontBridge,07/15/2015 11:00:00 PM,48,-122,22,9,31
24384,FremontBridge,07/16/2015 12:00:00 AM,48,-122,8,11,19
24385,FremontBridge,07/16/2015 01:00:00 AM,48,-122,9,5,14
24386,FremontBridge,07/16/2015 02:00:00 AM,48,-122,4,5,9
24387,FremontBridge,07/16/2015 03:00:00 AM,48,-122,2,5,7
24388,FremontBridge,07/16/2015 04:00:00 AM,48,-122,4,7,11
24389,FremontBridge,07/16/2015 05:00:00 AM,48,-122,13,26,39
24390,FremontBridge,07/16/2015 06:00:00 AM,48,-122,58,139,197
24391,FremontBridge,07/16/2015 07:00:00 AM,48,-122,119,310,429
24392,FremontBridge,07/16/2015 08:00:00 AM,48,-122,177,394,571
24393,FremontBridge,07/16/2015 09:00:00 AM,48,-122,103,172,275
24394,FremontBridge,07/16/2015 10:00:00 AM,48,-122,49,71,120
24395,FremontBridge,07/16/2015 11:00:00 AM,48,-122,47,64,111
24396,FremontBridge,07/16/2015 12:00:00 PM,48,-122,50,41,91
24397,FremontBridge,07/16/2015 01:00:00 PM,48,-122,69,42,111
24398,FremontBridge,07/16/2015 02:00:00 PM,48,-122,60,51,111
24399,FremontBridge,07/16/2015 03:00:00 PM,48,-122,85,59,144
24400,FremontBridge,07/16/2015 04:00:00 PM,48,-122,241,136,377
24401,FremontBridge,07/16/2015 05:00:00 PM,48,-122,515,190,705
24402,FremontBridge,07/16/2015 06:00:00 PM,48,-122,299,147,446
24403,FremontBridge,07/16/2015 07:00:00 PM,48,-122,148,107,255
24404,FremontBridge,07/16/2015 08:00:00 PM,48,-122,85,88,173
24405,FremontBridge,07/16/2015 09:00:00 PM,48,-122,58,49,107
24406,FremontBridge,07/16/2015 10:00:00 PM,48,-122,27,30,57
24407,FremontBridge,07/16/2015 11:00:00 PM,48,-122,32,13,45
24408,FremontBridge,07/17/2015 12:00:00 AM,48,-122,13,13,26
24409,FremontBridge,07/17/2015 01:00:00 AM,48,-122,6,7,13
24410,FremontBridge,07/17/2015 02:00:00 AM,48,-122,0,2,2
24411,FremontBridge,07/17/2015 03:00:00 AM,48,-122,7,4,11
24412,FremontBridge,07/17/2015 04:00:00 AM,48,-122,4,5,9
24413,FremontBridge,07/17/2015 05:00:00 AM,48,-122,13,27,40
24414,FremontBridge,07/17/2015 06:00:00 AM,48,-122,49,106,155
24415,FremontBridge,07/17/2015 07:00:00 AM,48,-122,104,248,352
24416,FremontBridge,07/17/2015 08:00:00 AM,48,-122,148,322,470
24417,FremontBridge,07/17/2015 09:00:00 AM,48,-122,122,157,279
24418,FremontBridge,07/17/2015 10:00:00 AM,48,-122,58,83,141
24419,FremontBridge,07/17/2015 11:00:00 AM,48,-122,46,47,93
24420,FremontBridge,07/17/2015 12:00:00 PM,48,-122,52,47,99
24421,FremontBridge,07/17/2015 01:00:00 PM,48,-122,57,60,117
24422,FremontBridge,07/17/2015 02:00:00 PM,48,-122,67,65,132
24423,FremontBridge,07/17/2015 03:00:00 PM,48,-122,97,72,169
24424,FremontBridge,07/17/2015 04:00:00 PM,48,-122,231,145,376
24425,FremontBridge,07/17/2015 05:00:00 PM,48,-122,376,172,548
24426,FremontBridge,07/17/2015 06:00:00 PM,48,-122,230,113,343
24427,FremontBridge,07/17/2015 07:00:00 PM,48,-122,98,75,173
24428,FremontBridge,07/17/2015 08:00:00 PM,48,-122,66,32,98
24429,FremontBridge,07/17/2015 09:00:00 PM,48,-122,37,30,67
24430,FremontBridge,07/17/2015 10:00:00 PM,48,-122,28,28,56
24431,FremontBridge,07/17/2015 11:00:00 PM,48,-122,27,17,44
24432,FremontBridge,07/18/2015 12:00:00 AM,48,-122,12,9,21
24433,FremontBridge,07/18/2015 01:00:00 AM,48,-122,8,1,9
24434,FremontBridge,07/18/2015 02:00:00 AM,48,-122,5,5,10
24435,FremontBridge,07/18/2015 03:00:00 AM,48,-122,5,3,8
24436,FremontBridge,07/18/2015 04:00:00 AM,48,-122,10,1,11
24437,FremontBridge,07/18/2015 05:00:00 AM,48,-122,5,5,10
24438,FremontBridge,07/18/2015 06:00:00 AM,48,-122,17,12,29
24439,FremontBridge,07/18/2015 07:00:00 AM,48,-122,34,21,55
24440,FremontBridge,07/18/2015 08:00:00 AM,48,-122,50,52,102
24441,FremontBridge,07/18/2015 09:00:00 AM,48,-122,54,81,135
24442,FremontBridge,07/18/2015 10:00:00 AM,48,-122,83,80,163
24443,FremontBridge,07/18/2015 11:00:00 AM,48,-122,68,67,135
24444,FremontBridge,07/18/2015 12:00:00 PM,48,-122,79,107,186
24445,FremontBridge,07/18/2015 01:00:00 PM,48,-122,99,94,193
24446,FremontBridge,07/18/2015 02:00:00 PM,48,-122,87,89,176
24447,FremontBridge,07/18/2015 03:00:00 PM,48,-122,84,104,188
24448,FremontBridge,07/18/2015 04:00:00 PM,48,-122,77,83,160
24449,FremontBridge,07/18/2015 05:00:00 PM,48,-122,70,67,137
24450,FremontBridge,07/18/2015 06:00:00 PM,48,-122,73,64,137
24451,FremontBridge,07/18/2015 07:00:00 PM,48,-122,44,44,88
24452,FremontBridge,07/18/2015 08:00:00 PM,48,-122,40,35,75
24453,FremontBridge,07/18/2015 09:00:00 PM,48,-122,41,36,77
24454,FremontBridge,07/18/2015 10:00:00 PM,48,-122,22,34,56
24455,FremontBridge,07/18/2015 11:00:00 PM,48,-122,21,13,34
24456,FremontBridge,07/19/2015 12:00:00 AM,48,-122,22,8,30
24457,FremontBridge,07/19/2015 01:00:00 AM,48,-122,5,5,10
24458,FremontBridge,07/19/2015 02:00:00 AM,48,-122,4,1,5
24459,FremontBridge,07/19/2015 03:00:00 AM,48,-122,0,6,6
24460,FremontBridge,07/19/2015 04:00:00 AM,48,-122,1,3,4
24461,FremontBridge,07/19/2015 05:00:00 AM,48,-122,6,9,15
24462,FremontBridge,07/19/2015 06:00:00 AM,48,-122,15,6,21
24463,FremontBridge,07/19/2015 07:00:00 AM,48,-122,24,28,52
24464,FremontBridge,07/19/2015 08:00:00 AM,48,-122,54,63,117
24465,FremontBridge,07/19/2015 09:00:00 AM,48,-122,65,81,146
24466,FremontBridge,07/19/2015 10:00:00 AM,48,-122,67,69,136
24467,FremontBridge,07/19/2015 11:00:00 AM,48,-122,80,112,192
24468,FremontBridge,07/19/2015 12:00:00 PM,48,-122,80,74,154
24469,FremontBridge,07/19/2015 01:00:00 PM,48,-122,90,94,184
24470,FremontBridge,07/19/2015 02:00:00 PM,48,-122,69,91,160
24471,FremontBridge,07/19/2015 03:00:00 PM,48,-122,60,80,140
24472,FremontBridge,07/19/2015 04:00:00 PM,48,-122,55,59,114
24473,FremontBridge,07/19/2015 05:00:00 PM,48,-122,52,52,104
24474,FremontBridge,07/19/2015 06:00:00 PM,48,-122,50,44,94
24475,FremontBridge,07/19/2015 07:00:00 PM,48,-122,57,46,103
24476,FremontBridge,07/19/2015 08:00:00 PM,48,-122,26,38,64
24477,FremontBridge,07/19/2015 09:00:00 PM,48,-122,23,26,49
24478,FremontBridge,07/19/2015 10:00:00 PM,48,-122,25,12,37
24479,FremontBridge,07/19/2015 11:00:00 PM,48,-122,16,10,26
24480,FremontBridge,07/20/2015 12:00:00 AM,48,-122,8,1,9
24481,FremontBridge,07/20/2015 01:00:00 AM,48,-122,7,3,10
24482,FremontBridge,07/20/2015 02:00:00 AM,48,-122,3,4,7
24483,FremontBridge,07/20/2015 03:00:00 AM,48,-122,2,3,5
24484,FremontBridge,07/20/2015 04:00:00 AM,48,-122,3,6,9
24485,FremontBridge,07/20/2015 05:00:00 AM,48,-122,18,24,42
24486,FremontBridge,07/20/2015 06:00:00 AM,48,-122,59,103,162
24487,FremontBridge,07/20/2015 07:00:00 AM,48,-122,121,302,423
24488,FremontBridge,07/20/2015 08:00:00 AM,48,-122,180,383,563
24489,FremontBridge,07/20/2015 09:00:00 AM,48,-122,118,159,277
24490,FremontBridge,07/20/2015 10:00:00 AM,48,-122,51,74,125
24491,FremontBridge,07/20/2015 11:00:00 AM,48,-122,37,40,77
24492,FremontBridge,07/20/2015 12:00:00 PM,48,-122,49,39,88
24493,FremontBridge,07/20/2015 01:00:00 PM,48,-122,51,52,103
24494,FremontBridge,07/20/2015 02:00:00 PM,48,-122,61,61,122
24495,FremontBridge,07/20/2015 03:00:00 PM,48,-122,87,57,144
24496,FremontBridge,07/20/2015 04:00:00 PM,48,-122,206,129,335
24497,FremontBridge,07/20/2015 05:00:00 PM,48,-122,473,181,654
24498,FremontBridge,07/20/2015 06:00:00 PM,48,-122,336,161,497
24499,FremontBridge,07/20/2015 07:00:00 PM,48,-122,163,93,256
24500,FremontBridge,07/20/2015 08:00:00 PM,48,-122,89,68,157
24501,FremontBridge,07/20/2015 09:00:00 PM,48,-122,39,43,82
24502,FremontBridge,07/20/2015 10:00:00 PM,48,-122,16,23,39
24503,FremontBridge,07/20/2015 11:00:00 PM,48,-122,19,8,27
24504,FremontBridge,07/21/2015 12:00:00 AM,48,-122,10,7,17
24505,FremontBridge,07/21/2015 01:00:00 AM,48,-122,9,3,12
24506,FremontBridge,07/21/2015 02:00:00 AM,48,-122,2,1,3
24507,FremontBridge,07/21/2015 03:00:00 AM,48,-122,4,1,5
24508,FremontBridge,07/21/2015 04:00:00 AM,48,-122,5,4,9
24509,FremontBridge,07/21/2015 05:00:00 AM,48,-122,23,38,61
24510,FremontBridge,07/21/2015 06:00:00 AM,48,-122,53,118,171
24511,FremontBridge,07/21/2015 07:00:00 AM,48,-122,125,367,492
24512,FremontBridge,07/21/2015 08:00:00 AM,48,-122,189,366,555
24513,FremontBridge,07/21/2015 09:00:00 AM,48,-122,123,174,297
24514,FremontBridge,07/21/2015 10:00:00 AM,48,-122,53,45,98
24515,FremontBridge,07/21/2015 11:00:00 AM,48,-122,48,46,94
24516,FremontBridge,07/21/2015 12:00:00 PM,48,-122,44,42,86
24517,FremontBridge,07/21/2015 01:00:00 PM,48,-122,41,60,101
24518,FremontBridge,07/21/2015 02:00:00 PM,48,-122,54,44,98
24519,FremontBridge,07/21/2015 03:00:00 PM,48,-122,90,71,161
24520,FremontBridge,07/21/2015 04:00:00 PM,48,-122,212,123,335
24521,FremontBridge,07/21/2015 05:00:00 PM,48,-122,487,168,655
24522,FremontBridge,07/21/2015 06:00:00 PM,48,-122,302,168,470
24523,FremontBridge,07/21/2015 07:00:00 PM,48,-122,144,110,254
24524,FremontBridge,07/21/2015 08:00:00 PM,48,-122,58,66,124
24525,FremontBridge,07/21/2015 09:00:00 PM,48,-122,57,43,100
24526,FremontBridge,07/21/2015 10:00:00 PM,48,-122,18,23,41
24527,FremontBridge,07/21/2015 11:00:00 PM,48,-122,15,14,29
24528,FremontBridge,07/22/2015 12:00:00 AM,48,-122,6,7,13
24529,FremontBridge,07/22/2015 01:00:00 AM,48,-122,4,2,6
24530,FremontBridge,07/22/2015 02:00:00 AM,48,-122,1,2,3
24531,FremontBridge,07/22/2015 03:00:00 AM,48,-122,0,1,1
24532,FremontBridge,07/22/2015 04:00:00 AM,48,-122,6,9,15
24533,FremontBridge,07/22/2015 05:00:00 AM,48,-122,16,19,35
24534,FremontBridge,07/22/2015 06:00:00 AM,48,-122,57,117,174
24535,FremontBridge,07/22/2015 07:00:00 AM,48,-122,152,331,483
24536,FremontBridge,07/22/2015 08:00:00 AM,48,-122,210,383,593
24537,FremontBridge,07/22/2015 09:00:00 AM,48,-122,138,189,327
24538,FremontBridge,07/22/2015 10:00:00 AM,48,-122,60,83,143
24539,FremontBridge,07/22/2015 11:00:00 AM,48,-122,62,48,110
24540,FremontBridge,07/22/2015 12:00:00 PM,48,-122,55,53,108
24541,FremontBridge,07/22/2015 01:00:00 PM,48,-122,51,43,94
24542,FremontBridge,07/22/2015 02:00:00 PM,48,-122,95,62,157
24543,FremontBridge,07/22/2015 03:00:00 PM,48,-122,111,81,192
24544,FremontBridge,07/22/2015 04:00:00 PM,48,-122,269,143,412
24545,FremontBridge,07/22/2015 05:00:00 PM,48,-122,462,213,675
24546,FremontBridge,07/22/2015 06:00:00 PM,48,-122,335,174,509
24547,FremontBridge,07/22/2015 07:00:00 PM,48,-122,170,126,296
24548,FremontBridge,07/22/2015 08:00:00 PM,48,-122,77,49,126
24549,FremontBridge,07/22/2015 09:00:00 PM,48,-122,60,38,98
24550,FremontBridge,07/22/2015 10:00:00 PM,48,-122,23,22,45
24551,FremontBridge,07/22/2015 11:00:00 PM,48,-122,23,10,33
24552,FremontBridge,07/23/2015 12:00:00 AM,48,-122,12,10,22
24553,FremontBridge,07/23/2015 01:00:00 AM,48,-122,4,2,6
24554,FremontBridge,07/23/2015 02:00:00 AM,48,-122,3,0,3
24555,FremontBridge,07/23/2015 03:00:00 AM,48,-122,1,2,3
24556,FremontBridge,07/23/2015 04:00:00 AM,48,-122,7,6,13
24557,FremontBridge,07/23/2015 05:00:00 AM,48,-122,14,24,38
24558,FremontBridge,07/23/2015 06:00:00 AM,48,-122,58,117,175
24559,FremontBridge,07/23/2015 07:00:00 AM,48,-122,139,290,429
24560,FremontBridge,07/23/2015 08:00:00 AM,48,-122,186,362,548
24561,FremontBridge,07/23/2015 09:00:00 AM,48,-122,120,167,287
24562,FremontBridge,07/23/2015 10:00:00 AM,48,-122,50,77,127
24563,FremontBridge,07/23/2015 11:00:00 AM,48,-122,59,52,111
24564,FremontBridge,07/23/2015 12:00:00 PM,48,-122,56,44,100
24565,FremontBridge,07/23/2015 01:00:00 PM,48,-122,61,61,122
24566,FremontBridge,07/23/2015 02:00:00 PM,48,-122,73,43,116
24567,FremontBridge,07/23/2015 03:00:00 PM,48,-122,103,95,198
24568,FremontBridge,07/23/2015 04:00:00 PM,48,-122,194,143,337
24569,FremontBridge,07/23/2015 05:00:00 PM,48,-122,469,218,687
24570,FremontBridge,07/23/2015 06:00:00 PM,48,-122,291,179,470
24571,FremontBridge,07/23/2015 07:00:00 PM,48,-122,149,99,248
24572,FremontBridge,07/23/2015 08:00:00 PM,48,-122,77,69,146
24573,FremontBridge,07/23/2015 09:00:00 PM,48,-122,51,37,88
24574,FremontBridge,07/23/2015 10:00:00 PM,48,-122,20,27,47
24575,FremontBridge,07/23/2015 11:00:00 PM,48,-122,28,10,38
24576,FremontBridge,07/24/2015 12:00:00 AM,48,-122,15,7,22
24577,FremontBridge,07/24/2015 01:00:00 AM,48,-122,4,4,8
24578,FremontBridge,07/24/2015 02:00:00 AM,48,-122,2,1,3
24579,FremontBridge,07/24/2015 03:00:00 AM,48,-122,2,1,3
24580,FremontBridge,07/24/2015 04:00:00 AM,48,-122,5,6,11
24581,FremontBridge,07/24/2015 05:00:00 AM,48,-122,14,22,36
24582,FremontBridge,07/24/2015 06:00:00 AM,48,-122,49,76,125
24583,FremontBridge,07/24/2015 07:00:00 AM,48,-122,99,243,342
24584,FremontBridge,07/24/2015 08:00:00 AM,48,-122,146,295,441
24585,FremontBridge,07/24/2015 09:00:00 AM,48,-122,97,127,224
24586,FremontBridge,07/24/2015 10:00:00 AM,48,-122,43,66,109
24587,FremontBridge,07/24/2015 11:00:00 AM,48,-122,28,29,57
24588,FremontBridge,07/24/2015 12:00:00 PM,48,-122,34,41,75
24589,FremontBridge,07/24/2015 01:00:00 PM,48,-122,49,40,89
24590,FremontBridge,07/24/2015 02:00:00 PM,48,-122,58,56,114
24591,FremontBridge,07/24/2015 03:00:00 PM,48,-122,94,68,162
24592,FremontBridge,07/24/2015 04:00:00 PM,48,-122,190,127,317
24593,FremontBridge,07/24/2015 05:00:00 PM,48,-122,378,126,504
24594,FremontBridge,07/24/2015 06:00:00 PM,48,-122,185,95,280
24595,FremontBridge,07/24/2015 07:00:00 PM,48,-122,99,43,142
24596,FremontBridge,07/24/2015 08:00:00 PM,48,-122,62,56,118
24597,FremontBridge,07/24/2015 09:00:00 PM,48,-122,35,29,64
24598,FremontBridge,07/24/2015 10:00:00 PM,48,-122,246,76,322
24599,FremontBridge,07/24/2015 11:00:00 PM,48,-122,30,30,60
24600,FremontBridge,07/25/2015 12:00:00 AM,48,-122,15,8,23
24601,FremontBridge,07/25/2015 01:00:00 AM,48,-122,4,11,15
24602,FremontBridge,07/25/2015 02:00:00 AM,48,-122,1,9,10
24603,FremontBridge,07/25/2015 03:00:00 AM,48,-122,0,3,3
24604,FremontBridge,07/25/2015 04:00:00 AM,48,-122,4,0,4
24605,FremontBridge,07/25/2015 05:00:00 AM,48,-122,6,3,9
24606,FremontBridge,07/25/2015 06:00:00 AM,48,-122,10,13,23
24607,FremontBridge,07/25/2015 07:00:00 AM,48,-122,13,34,47
24608,FremontBridge,07/25/2015 08:00:00 AM,48,-122,23,25,48
24609,FremontBridge,07/25/2015 09:00:00 AM,48,-122,25,29,54
24610,FremontBridge,07/25/2015 10:00:00 AM,48,-122,25,27,52
24611,FremontBridge,07/25/2015 11:00:00 AM,48,-122,35,35,70
24612,FremontBridge,07/25/2015 12:00:00 PM,48,-122,67,64,131
24613,FremontBridge,07/25/2015 01:00:00 PM,48,-122,47,68,115
24614,FremontBridge,07/25/2015 02:00:00 PM,48,-122,55,71,126
24615,FremontBridge,07/25/2015 03:00:00 PM,48,-122,56,68,124
24616,FremontBridge,07/25/2015 04:00:00 PM,48,-122,60,51,111
24617,FremontBridge,07/25/2015 05:00:00 PM,48,-122,56,54,110
24618,FremontBridge,07/25/2015 06:00:00 PM,48,-122,34,54,88
24619,FremontBridge,07/25/2015 07:00:00 PM,48,-122,40,39,79
24620,FremontBridge,07/25/2015 08:00:00 PM,48,-122,31,31,62
24621,FremontBridge,07/25/2015 09:00:00 PM,48,-122,16,11,27
24622,FremontBridge,07/25/2015 10:00:00 PM,48,-122,15,12,27
24623,FremontBridge,07/25/2015 11:00:00 PM,48,-122,15,11,26
24624,FremontBridge,07/26/2015 12:00:00 AM,48,-122,13,6,19
24625,FremontBridge,07/26/2015 01:00:00 AM,48,-122,6,3,9
24626,FremontBridge,07/26/2015 02:00:00 AM,48,-122,5,5,10
24627,FremontBridge,07/26/2015 03:00:00 AM,48,-122,2,2,4
24628,FremontBridge,07/26/2015 04:00:00 AM,48,-122,1,2,3
24629,FremontBridge,07/26/2015 05:00:00 AM,48,-122,5,4,9
24630,FremontBridge,07/26/2015 06:00:00 AM,48,-122,13,12,25
24631,FremontBridge,07/26/2015 07:00:00 AM,48,-122,18,20,38
24632,FremontBridge,07/26/2015 08:00:00 AM,48,-122,22,23,45
24633,FremontBridge,07/26/2015 09:00:00 AM,48,-122,35,47,82
24634,FremontBridge,07/26/2015 10:00:00 AM,48,-122,49,55,104
24635,FremontBridge,07/26/2015 11:00:00 AM,48,-122,76,71,147
24636,FremontBridge,07/26/2015 12:00:00 PM,48,-122,67,62,129
24637,FremontBridge,07/26/2015 01:00:00 PM,48,-122,43,78,121
24638,FremontBridge,07/26/2015 02:00:00 PM,48,-122,63,109,172
24639,FremontBridge,07/26/2015 03:00:00 PM,48,-122,77,92,169
24640,FremontBridge,07/26/2015 04:00:00 PM,48,-122,44,58,102
24641,FremontBridge,07/26/2015 05:00:00 PM,48,-122,26,28,54
24642,FremontBridge,07/26/2015 06:00:00 PM,48,-122,46,35,81
24643,FremontBridge,07/26/2015 07:00:00 PM,48,-122,19,24,43
24644,FremontBridge,07/26/2015 08:00:00 PM,48,-122,19,12,31
24645,FremontBridge,07/26/2015 09:00:00 PM,48,-122,6,11,17
24646,FremontBridge,07/26/2015 10:00:00 PM,48,-122,17,6,23
24647,FremontBridge,07/26/2015 11:00:00 PM,48,-122,10,5,15
24648,FremontBridge,07/27/2015 12:00:00 AM,48,-122,6,4,10
24649,FremontBridge,07/27/2015 01:00:00 AM,48,-122,4,0,4
24650,FremontBridge,07/27/2015 02:00:00 AM,48,-122,1,2,3
24651,FremontBridge,07/27/2015 03:00:00 AM,48,-122,0,4,4
24652,FremontBridge,07/27/2015 04:00:00 AM,48,-122,1,3,4
24653,FremontBridge,07/27/2015 05:00:00 AM,48,-122,13,22,35
24654,FremontBridge,07/27/2015 06:00:00 AM,48,-122,45,98,143
24655,FremontBridge,07/27/2015 07:00:00 AM,48,-122,129,296,425
24656,FremontBridge,07/27/2015 08:00:00 AM,48,-122,169,351,520
24657,FremontBridge,07/27/2015 09:00:00 AM,48,-122,109,155,264
24658,FremontBridge,07/27/2015 10:00:00 AM,48,-122,45,61,106
24659,FremontBridge,07/27/2015 11:00:00 AM,48,-122,36,52,88
24660,FremontBridge,07/27/2015 12:00:00 PM,48,-122,38,51,89
24661,FremontBridge,07/27/2015 01:00:00 PM,48,-122,43,52,95
24662,FremontBridge,07/27/2015 02:00:00 PM,48,-122,64,52,116
24663,FremontBridge,07/27/2015 03:00:00 PM,48,-122,101,74,175
24664,FremontBridge,07/27/2015 04:00:00 PM,48,-122,227,122,349
24665,FremontBridge,07/27/2015 05:00:00 PM,48,-122,506,199,705
24666,FremontBridge,07/27/2015 06:00:00 PM,48,-122,327,143,470
24667,FremontBridge,07/27/2015 07:00:00 PM,48,-122,126,93,219
24668,FremontBridge,07/27/2015 08:00:00 PM,48,-122,76,56,132
24669,FremontBridge,07/27/2015 09:00:00 PM,48,-122,46,35,81
24670,FremontBridge,07/27/2015 10:00:00 PM,48,-122,22,11,33
24671,FremontBridge,07/27/2015 11:00:00 PM,48,-122,15,17,32
24672,FremontBridge,07/28/2015 12:00:00 AM,48,-122,7,6,13
24673,FremontBridge,07/28/2015 01:00:00 AM,48,-122,7,3,10
24674,FremontBridge,07/28/2015 02:00:00 AM,48,-122,1,2,3
24675,FremontBridge,07/28/2015 03:00:00 AM,48,-122,5,3,8
24676,FremontBridge,07/28/2015 04:00:00 AM,48,-122,3,8,11
24677,FremontBridge,07/28/2015 05:00:00 AM,48,-122,19,31,50
24678,FremontBridge,07/28/2015 06:00:00 AM,48,-122,60,123,183
24679,FremontBridge,07/28/2015 07:00:00 AM,48,-122,145,335,480
24680,FremontBridge,07/28/2015 08:00:00 AM,48,-122,224,392,616
24681,FremontBridge,07/28/2015 09:00:00 AM,48,-122,122,184,306
24682,FremontBridge,07/28/2015 10:00:00 AM,48,-122,66,74,140
24683,FremontBridge,07/28/2015 11:00:00 AM,48,-122,43,50,93
24684,FremontBridge,07/28/2015 12:00:00 PM,48,-122,54,45,99
24685,FremontBridge,07/28/2015 01:00:00 PM,48,-122,65,57,122
24686,FremontBridge,07/28/2015 02:00:00 PM,48,-122,72,73,145
24687,FremontBridge,07/28/2015 03:00:00 PM,48,-122,109,72,181
24688,FremontBridge,07/28/2015 04:00:00 PM,48,-122,232,122,354
24689,FremontBridge,07/28/2015 05:00:00 PM,48,-122,517,219,736
24690,FremontBridge,07/28/2015 06:00:00 PM,48,-122,318,174,492
24691,FremontBridge,07/28/2015 07:00:00 PM,48,-122,167,139,306
24692,FremontBridge,07/28/2015 08:00:00 PM,48,-122,89,79,168
24693,FremontBridge,07/28/2015 09:00:00 PM,48,-122,50,39,89
24694,FremontBridge,07/28/2015 10:00:00 PM,48,-122,44,31,75
24695,FremontBridge,07/28/2015 11:00:00 PM,48,-122,22,13,35
24696,FremontBridge,07/29/2015 12:00:00 AM,48,-122,6,5,11
24697,FremontBridge,07/29/2015 01:00:00 AM,48,-122,3,2,5
24698,FremontBridge,07/29/2015 02:00:00 AM,48,-122,4,1,5
24699,FremontBridge,07/29/2015 03:00:00 AM,48,-122,1,2,3
24700,FremontBridge,07/29/2015 04:00:00 AM,48,-122,2,8,10
24701,FremontBridge,07/29/2015 05:00:00 AM,48,-122,16,31,47
24702,FremontBridge,07/29/2015 06:00:00 AM,48,-122,70,127,197
24703,FremontBridge,07/29/2015 07:00:00 AM,48,-122,144,338,482
24704,FremontBridge,07/29/2015 08:00:00 AM,48,-122,231,392,623
24705,FremontBridge,07/29/2015 09:00:00 AM,48,-122,113,191,304
24706,FremontBridge,07/29/2015 10:00:00 AM,48,-122,74,69,143
24707,FremontBridge,07/29/2015 11:00:00 AM,48,-122,52,63,115
24708,FremontBridge,07/29/2015 12:00:00 PM,48,-122,54,48,102
24709,FremontBridge,07/29/2015 01:00:00 PM,48,-122,62,58,120
24710,FremontBridge,07/29/2015 02:00:00 PM,48,-122,47,70,117
24711,FremontBridge,07/29/2015 03:00:00 PM,48,-122,76,76,152
24712,FremontBridge,07/29/2015 04:00:00 PM,48,-122,264,143,407
24713,FremontBridge,07/29/2015 05:00:00 PM,48,-122,490,196,686
24714,FremontBridge,07/29/2015 06:00:00 PM,48,-122,348,183,531
24715,FremontBridge,07/29/2015 07:00:00 PM,48,-122,181,96,277
24716,FremontBridge,07/29/2015 08:00:00 PM,48,-122,98,64,162
24717,FremontBridge,07/29/2015 09:00:00 PM,48,-122,55,63,118
24718,FremontBridge,07/29/2015 10:00:00 PM,48,-122,36,36,72
24719,FremontBridge,07/29/2015 11:00:00 PM,48,-122,30,15,45
24720,FremontBridge,07/30/2015 12:00:00 AM,48,-122,10,8,18
24721,FremontBridge,07/30/2015 01:00:00 AM,48,-122,5,5,10
24722,FremontBridge,07/30/2015 02:00:00 AM,48,-122,2,5,7
24723,FremontBridge,07/30/2015 03:00:00 AM,48,-122,3,0,3
24724,FremontBridge,07/30/2015 04:00:00 AM,48,-122,5,5,10
24725,FremontBridge,07/30/2015 05:00:00 AM,48,-122,22,20,42
24726,FremontBridge,07/30/2015 06:00:00 AM,48,-122,59,107,166
24727,FremontBridge,07/30/2015 07:00:00 AM,48,-122,145,271,416
24728,FremontBridge,07/30/2015 08:00:00 AM,48,-122,208,397,605
24729,FremontBridge,07/30/2015 09:00:00 AM,48,-122,112,193,305
24730,FremontBridge,07/30/2015 10:00:00 AM,48,-122,58,72,130
24731,FremontBridge,07/30/2015 11:00:00 AM,48,-122,51,59,110
24732,FremontBridge,07/30/2015 12:00:00 PM,48,-122,39,43,82
24733,FremontBridge,07/30/2015 01:00:00 PM,48,-122,46,55,101
24734,FremontBridge,07/30/2015 02:00:00 PM,48,-122,65,46,111
24735,FremontBridge,07/30/2015 03:00:00 PM,48,-122,70,72,142
24736,FremontBridge,07/30/2015 04:00:00 PM,48,-122,204,127,331
24737,FremontBridge,07/30/2015 05:00:00 PM,48,-122,458,184,642
24738,FremontBridge,07/30/2015 06:00:00 PM,48,-122,311,165,476
24739,FremontBridge,07/30/2015 07:00:00 PM,48,-122,158,120,278
24740,FremontBridge,07/30/2015 08:00:00 PM,48,-122,99,57,156
24741,FremontBridge,07/30/2015 09:00:00 PM,48,-122,64,54,118
24742,FremontBridge,07/30/2015 10:00:00 PM,48,-122,31,44,75
24743,FremontBridge,07/30/2015 11:00:00 PM,48,-122,23,22,45
24744,FremontBridge,07/31/2015 12:00:00 AM,48,-122,13,11,24
24745,FremontBridge,07/31/2015 01:00:00 AM,48,-122,10,5,15
24746,FremontBridge,07/31/2015 02:00:00 AM,48,-122,6,1,7
24747,FremontBridge,07/31/2015 03:00:00 AM,48,-122,0,2,2
24748,FremontBridge,07/31/2015 04:00:00 AM,48,-122,5,4,9
24749,FremontBridge,07/31/2015 05:00:00 AM,48,-122,16,25,41
24750,FremontBridge,07/31/2015 06:00:00 AM,48,-122,44,95,139
24751,FremontBridge,07/31/2015 07:00:00 AM,48,-122,119,244,363
24752,FremontBridge,07/31/2015 08:00:00 AM,48,-122,189,315,504
24753,FremontBridge,07/31/2015 09:00:00 AM,48,-122,93,166,259
24754,FremontBridge,07/31/2015 10:00:00 AM,48,-122,62,62,124
24755,FremontBridge,07/31/2015 11:00:00 AM,48,-122,54,67,121
24756,FremontBridge,07/31/2015 12:00:00 PM,48,-122,53,54,107
24757,FremontBridge,07/31/2015 01:00:00 PM,48,-122,47,57,104
24758,FremontBridge,07/31/2015 02:00:00 PM,48,-122,69,49,118
24759,FremontBridge,07/31/2015 03:00:00 PM,48,-122,98,84,182
24760,FremontBridge,07/31/2015 04:00:00 PM,48,-122,218,132,350
24761,FremontBridge,07/31/2015 05:00:00 PM,48,-122,362,171,533
24762,FremontBridge,07/31/2015 06:00:00 PM,48,-122,207,115,322
24763,FremontBridge,07/31/2015 07:00:00 PM,48,-122,103,88,191
24764,FremontBridge,07/31/2015 08:00:00 PM,48,-122,87,43,130
24765,FremontBridge,07/31/2015 09:00:00 PM,48,-122,64,45,109
24766,FremontBridge,07/31/2015 10:00:00 PM,48,-122,41,32,73
24767,FremontBridge,07/31/2015 11:00:00 PM,48,-122,22,38,60
24768,FremontBridge,08/01/2015 12:00:00 AM,48,-122,19,21,40
24769,FremontBridge,08/01/2015 01:00:00 AM,48,-122,6,8,14
24770,FremontBridge,08/01/2015 02:00:00 AM,48,-122,5,5,10
24771,FremontBridge,08/01/2015 03:00:00 AM,48,-122,7,0,7
24772,FremontBridge,08/01/2015 04:00:00 AM,48,-122,2,2,4
24773,FremontBridge,08/01/2015 05:00:00 AM,48,-122,5,7,12
24774,FremontBridge,08/01/2015 06:00:00 AM,48,-122,14,11,25
24775,FremontBridge,08/01/2015 07:00:00 AM,48,-122,39,42,81
24776,FremontBridge,08/01/2015 08:00:00 AM,48,-122,48,64,112
24777,FremontBridge,08/01/2015 09:00:00 AM,48,-122,69,77,146
24778,FremontBridge,08/01/2015 10:00:00 AM,48,-122,69,94,163
24779,FremontBridge,08/01/2015 11:00:00 AM,48,-122,90,104,194
24780,FremontBridge,08/01/2015 12:00:00 PM,48,-122,85,76,161
24781,FremontBridge,08/01/2015 01:00:00 PM,48,-122,85,79,164
24782,FremontBridge,08/01/2015 02:00:00 PM,48,-122,82,85,167
24783,FremontBridge,08/01/2015 03:00:00 PM,48,-122,76,101,177
24784,FremontBridge,08/01/2015 04:00:00 PM,48,-122,73,81,154
24785,FremontBridge,08/01/2015 05:00:00 PM,48,-122,57,77,134
24786,FremontBridge,08/01/2015 06:00:00 PM,48,-122,61,68,129
24787,FremontBridge,08/01/2015 07:00:00 PM,48,-122,51,39,90
24788,FremontBridge,08/01/2015 08:00:00 PM,48,-122,25,28,53
24789,FremontBridge,08/01/2015 09:00:00 PM,48,-122,41,33,74
24790,FremontBridge,08/01/2015 10:00:00 PM,48,-122,31,28,59
24791,FremontBridge,08/01/2015 11:00:00 PM,48,-122,26,23,49
24792,FremontBridge,08/02/2015 12:00:00 AM,48,-122,20,6,26
24793,FremontBridge,08/02/2015 01:00:00 AM,48,-122,9,8,17
24794,FremontBridge,08/02/2015 02:00:00 AM,48,-122,6,3,9
24795,FremontBridge,08/02/2015 03:00:00 AM,48,-122,1,2,3
24796,FremontBridge,08/02/2015 04:00:00 AM,48,-122,5,1,6
24797,FremontBridge,08/02/2015 05:00:00 AM,48,-122,5,1,6
24798,FremontBridge,08/02/2015 06:00:00 AM,48,-122,15,14,29
24799,FremontBridge,08/02/2015 07:00:00 AM,48,-122,29,28,57
24800,FremontBridge,08/02/2015 08:00:00 AM,48,-122,38,41,79
24801,FremontBridge,08/02/2015 09:00:00 AM,48,-122,55,70,125
24802,FremontBridge,08/02/2015 10:00:00 AM,48,-122,42,67,109
24803,FremontBridge,08/02/2015 11:00:00 AM,48,-122,60,89,149
24804,FremontBridge,08/02/2015 12:00:00 PM,48,-122,83,88,171
24805,FremontBridge,08/02/2015 01:00:00 PM,48,-122,74,84,158
24806,FremontBridge,08/02/2015 02:00:00 PM,48,-122,59,66,125
24807,FremontBridge,08/02/2015 03:00:00 PM,48,-122,100,83,183
24808,FremontBridge,08/02/2015 04:00:00 PM,48,-122,75,82,157
24809,FremontBridge,08/02/2015 05:00:00 PM,48,-122,70,58,128
24810,FremontBridge,08/02/2015 06:00:00 PM,48,-122,55,51,106
24811,FremontBridge,08/02/2015 07:00:00 PM,48,-122,35,41,76
24812,FremontBridge,08/02/2015 08:00:00 PM,48,-122,37,35,72
24813,FremontBridge,08/02/2015 09:00:00 PM,48,-122,22,16,38
24814,FremontBridge,08/02/2015 10:00:00 PM,48,-122,20,14,34
24815,FremontBridge,08/02/2015 11:00:00 PM,48,-122,15,5,20
24816,FremontBridge,08/03/2015 12:00:00 AM,48,-122,3,3,6
24817,FremontBridge,08/03/2015 01:00:00 AM,48,-122,3,2,5
24818,FremontBridge,08/03/2015 02:00:00 AM,48,-122,0,2,2
24819,FremontBridge,08/03/2015 03:00:00 AM,48,-122,2,2,4
24820,FremontBridge,08/03/2015 04:00:00 AM,48,-122,1,9,10
24821,FremontBridge,08/03/2015 05:00:00 AM,48,-122,13,36,49
24822,FremontBridge,08/03/2015 06:00:00 AM,48,-122,58,114,172
24823,FremontBridge,08/03/2015 07:00:00 AM,48,-122,119,289,408
24824,FremontBridge,08/03/2015 08:00:00 AM,48,-122,203,403,606
24825,FremontBridge,08/03/2015 09:00:00 AM,48,-122,105,188,293
24826,FremontBridge,08/03/2015 10:00:00 AM,48,-122,46,52,98
24827,FremontBridge,08/03/2015 11:00:00 AM,48,-122,33,55,88
24828,FremontBridge,08/03/2015 12:00:00 PM,48,-122,42,39,81
24829,FremontBridge,08/03/2015 01:00:00 PM,48,-122,54,45,99
24830,FremontBridge,08/03/2015 02:00:00 PM,48,-122,56,57,113
24831,FremontBridge,08/03/2015 03:00:00 PM,48,-122,76,65,141
24832,FremontBridge,08/03/2015 04:00:00 PM,48,-122,228,122,350
24833,FremontBridge,08/03/2015 05:00:00 PM,48,-122,518,174,692
24834,FremontBridge,08/03/2015 06:00:00 PM,48,-122,303,189,492
24835,FremontBridge,08/03/2015 07:00:00 PM,48,-122,141,84,225
24836,FremontBridge,08/03/2015 08:00:00 PM,48,-122,87,61,148
24837,FremontBridge,08/03/2015 09:00:00 PM,48,-122,41,40,81
24838,FremontBridge,08/03/2015 10:00:00 PM,48,-122,30,26,56
24839,FremontBridge,08/03/2015 11:00:00 PM,48,-122,13,11,24
24840,FremontBridge,08/04/2015 12:00:00 AM,48,-122,7,7,14
24841,FremontBridge,08/04/2015 01:00:00 AM,48,-122,6,6,12
24842,FremontBridge,08/04/2015 02:00:00 AM,48,-122,3,1,4
24843,FremontBridge,08/04/2015 03:00:00 AM,48,-122,1,1,2
24844,FremontBridge,08/04/2015 04:00:00 AM,48,-122,7,4,11
24845,FremontBridge,08/04/2015 05:00:00 AM,48,-122,23,33,56
24846,FremontBridge,08/04/2015 06:00:00 AM,48,-122,51,126,177
24847,FremontBridge,08/04/2015 07:00:00 AM,48,-122,140,333,473
24848,FremontBridge,08/04/2015 08:00:00 AM,48,-122,219,404,623
24849,FremontBridge,08/04/2015 09:00:00 AM,48,-122,111,200,311
24850,FremontBridge,08/04/2015 10:00:00 AM,48,-122,60,72,132
24851,FremontBridge,08/04/2015 11:00:00 AM,48,-122,45,46,91
24852,FremontBridge,08/04/2015 12:00:00 PM,48,-122,41,59,100
24853,FremontBridge,08/04/2015 01:00:00 PM,48,-122,43,46,89
24854,FremontBridge,08/04/2015 02:00:00 PM,48,-122,69,52,121
24855,FremontBridge,08/04/2015 03:00:00 PM,48,-122,89,79,168
24856,FremontBridge,08/04/2015 04:00:00 PM,48,-122,271,126,397
24857,FremontBridge,08/04/2015 05:00:00 PM,48,-122,564,227,791
24858,FremontBridge,08/04/2015 06:00:00 PM,48,-122,297,191,488
24859,FremontBridge,08/04/2015 07:00:00 PM,48,-122,142,111,253
24860,FremontBridge,08/04/2015 08:00:00 PM,48,-122,93,86,179
24861,FremontBridge,08/04/2015 09:00:00 PM,48,-122,37,43,80
24862,FremontBridge,08/04/2015 10:00:00 PM,48,-122,34,17,51
24863,FremontBridge,08/04/2015 11:00:00 PM,48,-122,19,13,32
24864,FremontBridge,08/05/2015 12:00:00 AM,48,-122,4,6,10
24865,FremontBridge,08/05/2015 01:00:00 AM,48,-122,1,2,3
24866,FremontBridge,08/05/2015 02:00:00 AM,48,-122,3,2,5
24867,FremontBridge,08/05/2015 03:00:00 AM,48,-122,5,3,8
24868,FremontBridge,08/05/2015 04:00:00 AM,48,-122,1,7,8
24869,FremontBridge,08/05/2015 05:00:00 AM,48,-122,26,32,58
24870,FremontBridge,08/05/2015 06:00:00 AM,48,-122,62,117,179
24871,FremontBridge,08/05/2015 07:00:00 AM,48,-122,128,322,450
24872,FremontBridge,08/05/2015 08:00:00 AM,48,-122,199,336,535
24873,FremontBridge,08/05/2015 09:00:00 AM,48,-122,112,158,270
24874,FremontBridge,08/05/2015 10:00:00 AM,48,-122,47,55,102
24875,FremontBridge,08/05/2015 11:00:00 AM,48,-122,44,49,93
24876,FremontBridge,08/05/2015 12:00:00 PM,48,-122,42,47,89
24877,FremontBridge,08/05/2015 01:00:00 PM,48,-122,39,38,77
24878,FremontBridge,08/05/2015 02:00:00 PM,48,-122,60,44,104
24879,FremontBridge,08/05/2015 03:00:00 PM,48,-122,87,67,154
24880,FremontBridge,08/05/2015 04:00:00 PM,48,-122,242,134,376
24881,FremontBridge,08/05/2015 05:00:00 PM,48,-122,501,175,676
24882,FremontBridge,08/05/2015 06:00:00 PM,48,-122,285,177,462
24883,FremontBridge,08/05/2015 07:00:00 PM,48,-122,113,80,193
24884,FremontBridge,08/05/2015 08:00:00 PM,48,-122,71,54,125
24885,FremontBridge,08/05/2015 09:00:00 PM,48,-122,30,30,60
24886,FremontBridge,08/05/2015 10:00:00 PM,48,-122,18,22,40
24887,FremontBridge,08/05/2015 11:00:00 PM,48,-122,17,14,31
24888,FremontBridge,08/06/2015 12:00:00 AM,48,-122,18,5,23
24889,FremontBridge,08/06/2015 01:00:00 AM,48,-122,1,3,4
24890,FremontBridge,08/06/2015 02:00:00 AM,48,-122,2,1,3
24891,FremontBridge,08/06/2015 03:00:00 AM,48,-122,3,2,5
24892,FremontBridge,08/06/2015 04:00:00 AM,48,-122,4,4,8
24893,FremontBridge,08/06/2015 05:00:00 AM,48,-122,13,22,35
24894,FremontBridge,08/06/2015 06:00:00 AM,48,-122,58,96,154
24895,FremontBridge,08/06/2015 07:00:00 AM,48,-122,219,269,488
24896,FremontBridge,08/06/2015 08:00:00 AM,48,-122,190,363,553
24897,FremontBridge,08/06/2015 09:00:00 AM,48,-122,109,163,272
24898,FremontBridge,08/06/2015 10:00:00 AM,48,-122,63,59,122
24899,FremontBridge,08/06/2015 11:00:00 AM,48,-122,43,46,89
24900,FremontBridge,08/06/2015 12:00:00 PM,48,-122,40,56,96
24901,FremontBridge,08/06/2015 01:00:00 PM,48,-122,50,69,119
24902,FremontBridge,08/06/2015 02:00:00 PM,48,-122,53,52,105
24903,FremontBridge,08/06/2015 03:00:00 PM,48,-122,92,75,167
24904,FremontBridge,08/06/2015 04:00:00 PM,48,-122,215,121,336
24905,FremontBridge,08/06/2015 05:00:00 PM,48,-122,430,200,630
24906,FremontBridge,08/06/2015 06:00:00 PM,48,-122,309,181,490
24907,FremontBridge,08/06/2015 07:00:00 PM,48,-122,135,108,243
24908,FremontBridge,08/06/2015 08:00:00 PM,48,-122,75,88,163
24909,FremontBridge,08/06/2015 09:00:00 PM,48,-122,39,57,96
24910,FremontBridge,08/06/2015 10:00:00 PM,48,-122,32,32,64
24911,FremontBridge,08/06/2015 11:00:00 PM,48,-122,12,18,30
24912,FremontBridge,08/07/2015 12:00:00 AM,48,-122,18,7,25
24913,FremontBridge,08/07/2015 01:00:00 AM,48,-122,6,5,11
24914,FremontBridge,08/07/2015 02:00:00 AM,48,-122,4,0,4
24915,FremontBridge,08/07/2015 03:00:00 AM,48,-122,1,3,4
24916,FremontBridge,08/07/2015 04:00:00 AM,48,-122,2,5,7
24917,FremontBridge,08/07/2015 05:00:00 AM,48,-122,17,17,34
24918,FremontBridge,08/07/2015 06:00:00 AM,48,-122,49,105,154
24919,FremontBridge,08/07/2015 07:00:00 AM,48,-122,111,253,364
24920,FremontBridge,08/07/2015 08:00:00 AM,48,-122,155,298,453
24921,FremontBridge,08/07/2015 09:00:00 AM,48,-122,107,140,247
24922,FremontBridge,08/07/2015 10:00:00 AM,48,-122,76,67,143
24923,FremontBridge,08/07/2015 11:00:00 AM,48,-122,52,61,113
24924,FremontBridge,08/07/2015 12:00:00 PM,48,-122,61,57,118
24925,FremontBridge,08/07/2015 01:00:00 PM,48,-122,63,75,138
24926,FremontBridge,08/07/2015 02:00:00 PM,48,-122,75,68,143
24927,FremontBridge,08/07/2015 03:00:00 PM,48,-122,120,99,219
24928,FremontBridge,08/07/2015 04:00:00 PM,48,-122,263,142,405
24929,FremontBridge,08/07/2015 05:00:00 PM,48,-122,375,207,582
24930,FremontBridge,08/07/2015 06:00:00 PM,48,-122,225,165,390
24931,FremontBridge,08/07/2015 07:00:00 PM,48,-122,121,91,212
24932,FremontBridge,08/07/2015 08:00:00 PM,48,-122,92,53,145
24933,FremontBridge,08/07/2015 09:00:00 PM,48,-122,36,38,74
24934,FremontBridge,08/07/2015 10:00:00 PM,48,-122,39,30,69
24935,FremontBridge,08/07/2015 11:00:00 PM,48,-122,32,14,46
24936,FremontBridge,08/08/2015 12:00:00 AM,48,-122,27,8,35
24937,FremontBridge,08/08/2015 01:00:00 AM,48,-122,18,11,29
24938,FremontBridge,08/08/2015 02:00:00 AM,48,-122,14,3,17
24939,FremontBridge,08/08/2015 03:00:00 AM,48,-122,5,2,7
24940,FremontBridge,08/08/2015 04:00:00 AM,48,-122,5,1,6
24941,FremontBridge,08/08/2015 05:00:00 AM,48,-122,4,8,12
24942,FremontBridge,08/08/2015 06:00:00 AM,48,-122,16,14,30
24943,FremontBridge,08/08/2015 07:00:00 AM,48,-122,37,30,67
24944,FremontBridge,08/08/2015 08:00:00 AM,48,-122,35,50,85
24945,FremontBridge,08/08/2015 09:00:00 AM,48,-122,63,64,127
24946,FremontBridge,08/08/2015 10:00:00 AM,48,-122,68,74,142
24947,FremontBridge,08/08/2015 11:00:00 AM,48,-122,54,84,138
24948,FremontBridge,08/08/2015 12:00:00 PM,48,-122,75,81,156
24949,FremontBridge,08/08/2015 01:00:00 PM,48,-122,68,89,157
24950,FremontBridge,08/08/2015 02:00:00 PM,48,-122,95,98,193
24951,FremontBridge,08/08/2015 03:00:00 PM,48,-122,88,75,163
24952,FremontBridge,08/08/2015 04:00:00 PM,48,-122,71,75,146
24953,FremontBridge,08/08/2015 05:00:00 PM,48,-122,79,69,148
24954,FremontBridge,08/08/2015 06:00:00 PM,48,-122,63,46,109
24955,FremontBridge,08/08/2015 07:00:00 PM,48,-122,26,40,66
24956,FremontBridge,08/08/2015 08:00:00 PM,48,-122,28,31,59
24957,FremontBridge,08/08/2015 09:00:00 PM,48,-122,15,39,54
24958,FremontBridge,08/08/2015 10:00:00 PM,48,-122,15,16,31
24959,FremontBridge,08/08/2015 11:00:00 PM,48,-122,19,18,37
24960,FremontBridge,08/09/2015 12:00:00 AM,48,-122,15,9,24
24961,FremontBridge,08/09/2015 01:00:00 AM,48,-122,9,9,18
24962,FremontBridge,08/09/2015 02:00:00 AM,48,-122,4,1,5
24963,FremontBridge,08/09/2015 03:00:00 AM,48,-122,1,2,3
24964,FremontBridge,08/09/2015 04:00:00 AM,48,-122,1,2,3
24965,FremontBridge,08/09/2015 05:00:00 AM,48,-122,1,11,12
24966,FremontBridge,08/09/2015 06:00:00 AM,48,-122,15,18,33
24967,FremontBridge,08/09/2015 07:00:00 AM,48,-122,20,40,60
24968,FremontBridge,08/09/2015 08:00:00 AM,48,-122,34,54,88
24969,FremontBridge,08/09/2015 09:00:00 AM,48,-122,60,56,116
24970,FremontBridge,08/09/2015 10:00:00 AM,48,-122,57,79,136
24971,FremontBridge,08/09/2015 11:00:00 AM,48,-122,206,83,289
24972,FremontBridge,08/09/2015 12:00:00 PM,48,-122,381,95,476
24973,FremontBridge,08/09/2015 01:00:00 PM,48,-122,328,122,450
24974,FremontBridge,08/09/2015 02:00:00 PM,48,-122,174,104,278
24975,FremontBridge,08/09/2015 03:00:00 PM,48,-122,110,101,211
24976,FremontBridge,08/09/2015 04:00:00 PM,48,-122,83,127,210
24977,FremontBridge,08/09/2015 05:00:00 PM,48,-122,77,97,174
24978,FremontBridge,08/09/2015 06:00:00 PM,48,-122,63,54,117
24979,FremontBridge,08/09/2015 07:00:00 PM,48,-122,34,52,86
24980,FremontBridge,08/09/2015 08:00:00 PM,48,-122,28,29,57
24981,FremontBridge,08/09/2015 09:00:00 PM,48,-122,23,32,55
24982,FremontBridge,08/09/2015 10:00:00 PM,48,-122,18,11,29
24983,FremontBridge,08/09/2015 11:00:00 PM,48,-122,8,7,15
24984,FremontBridge,08/10/2015 12:00:00 AM,48,-122,10,1,11
24985,FremontBridge,08/10/2015 01:00:00 AM,48,-122,5,2,7
24986,FremontBridge,08/10/2015 02:00:00 AM,48,-122,3,2,5
24987,FremontBridge,08/10/2015 03:00:00 AM,48,-122,1,2,3
24988,FremontBridge,08/10/2015 04:00:00 AM,48,-122,8,5,13
24989,FremontBridge,08/10/2015 05:00:00 AM,48,-122,19,24,43
24990,FremontBridge,08/10/2015 06:00:00 AM,48,-122,58,114,172
24991,FremontBridge,08/10/2015 07:00:00 AM,48,-122,124,272,396
24992,FremontBridge,08/10/2015 08:00:00 AM,48,-122,148,304,452
24993,FremontBridge,08/10/2015 09:00:00 AM,48,-122,114,146,260
24994,FremontBridge,08/10/2015 10:00:00 AM,48,-122,55,62,117
24995,FremontBridge,08/10/2015 11:00:00 AM,48,-122,41,37,78
24996,FremontBridge,08/10/2015 12:00:00 PM,48,-122,43,60,103
24997,FremontBridge,08/10/2015 01:00:00 PM,48,-122,53,52,105
24998,FremontBridge,08/10/2015 02:00:00 PM,48,-122,48,47,95
24999,FremontBridge,08/10/2015 03:00:00 PM,48,-122,83,54,137
25000,FremontBridge,08/10/2015 04:00:00 PM,48,-122,197,121,318
25001,FremontBridge,08/10/2015 05:00:00 PM,48,-122,442,179,621
25002,FremontBridge,08/10/2015 06:00:00 PM,48,-122,279,167,446
25003,FremontBridge,08/10/2015 07:00:00 PM,48,-122,121,91,212
25004,FremontBridge,08/10/2015 08:00:00 PM,48,-122,83,73,156
25005,FremontBridge,08/10/2015 09:00:00 PM,48,-122,46,35,81
25006,FremontBridge,08/10/2015 10:00:00 PM,48,-122,17,26,43
25007,FremontBridge,08/10/2015 11:00:00 PM,48,-122,9,15,24
25008,FremontBridge,08/11/2015 12:00:00 AM,48,-122,9,6,15
25009,FremontBridge,08/11/2015 01:00:00 AM,48,-122,5,2,7
25010,FremontBridge,08/11/2015 02:00:00 AM,48,-122,0,1,1
25011,FremontBridge,08/11/2015 03:00:00 AM,48,-122,2,1,3
25012,FremontBridge,08/11/2015 04:00:00 AM,48,-122,7,6,13
25013,FremontBridge,08/11/2015 05:00:00 AM,48,-122,24,30,54
25014,FremontBridge,08/11/2015 06:00:00 AM,48,-122,50,95,145
25015,FremontBridge,08/11/2015 07:00:00 AM,48,-122,133,322,455
25016,FremontBridge,08/11/2015 08:00:00 AM,48,-122,206,422,628
25017,FremontBridge,08/11/2015 09:00:00 AM,48,-122,111,171,282
25018,FremontBridge,08/11/2015 10:00:00 AM,48,-122,44,79,123
25019,FremontBridge,08/11/2015 11:00:00 AM,48,-122,58,53,111
25020,FremontBridge,08/11/2015 12:00:00 PM,48,-122,51,57,108
25021,FremontBridge,08/11/2015 01:00:00 PM,48,-122,58,68,126
25022,FremontBridge,08/11/2015 02:00:00 PM,48,-122,52,65,117
25023,FremontBridge,08/11/2015 03:00:00 PM,48,-122,96,61,157
25024,FremontBridge,08/11/2015 04:00:00 PM,48,-122,208,110,318
25025,FremontBridge,08/11/2015 05:00:00 PM,48,-122,515,227,742
25026,FremontBridge,08/11/2015 06:00:00 PM,48,-122,355,178,533
25027,FremontBridge,08/11/2015 07:00:00 PM,48,-122,155,101,256
25028,FremontBridge,08/11/2015 08:00:00 PM,48,-122,80,71,151
25029,FremontBridge,08/11/2015 09:00:00 PM,48,-122,50,41,91
25030,FremontBridge,08/11/2015 10:00:00 PM,48,-122,27,25,52
25031,FremontBridge,08/11/2015 11:00:00 PM,48,-122,23,19,42
25032,FremontBridge,08/12/2015 12:00:00 AM,48,-122,8,5,13
25033,FremontBridge,08/12/2015 01:00:00 AM,48,-122,5,5,10
25034,FremontBridge,08/12/2015 02:00:00 AM,48,-122,0,5,5
25035,FremontBridge,08/12/2015 03:00:00 AM,48,-122,1,1,2
25036,FremontBridge,08/12/2015 04:00:00 AM,48,-122,3,9,12
25037,FremontBridge,08/12/2015 05:00:00 AM,48,-122,19,39,58
25038,FremontBridge,08/12/2015 06:00:00 AM,48,-122,48,113,161
25039,FremontBridge,08/12/2015 07:00:00 AM,48,-122,155,322,477
25040,FremontBridge,08/12/2015 08:00:00 AM,48,-122,199,382,581
25041,FremontBridge,08/12/2015 09:00:00 AM,48,-122,114,205,319
25042,FremontBridge,08/12/2015 10:00:00 AM,48,-122,55,63,118
25043,FremontBridge,08/12/2015 11:00:00 AM,48,-122,48,63,111
25044,FremontBridge,08/12/2015 12:00:00 PM,48,-122,37,43,80
25045,FremontBridge,08/12/2015 01:00:00 PM,48,-122,46,42,88
25046,FremontBridge,08/12/2015 02:00:00 PM,48,-122,54,48,102
25047,FremontBridge,08/12/2015 03:00:00 PM,48,-122,71,56,127
25048,FremontBridge,08/12/2015 04:00:00 PM,48,-122,264,134,398
25049,FremontBridge,08/12/2015 05:00:00 PM,48,-122,494,216,710
25050,FremontBridge,08/12/2015 06:00:00 PM,48,-122,304,151,455
25051,FremontBridge,08/12/2015 07:00:00 PM,48,-122,153,93,246
25052,FremontBridge,08/12/2015 08:00:00 PM,48,-122,93,64,157
25053,FremontBridge,08/12/2015 09:00:00 PM,48,-122,50,44,94
25054,FremontBridge,08/12/2015 10:00:00 PM,48,-122,27,19,46
25055,FremontBridge,08/12/2015 11:00:00 PM,48,-122,12,21,33
25056,FremontBridge,08/13/2015 12:00:00 AM,48,-122,8,9,17
25057,FremontBridge,08/13/2015 01:00:00 AM,48,-122,2,5,7
25058,FremontBridge,08/13/2015 02:00:00 AM,48,-122,0,5,5
25059,FremontBridge,08/13/2015 03:00:00 AM,48,-122,2,1,3
25060,FremontBridge,08/13/2015 04:00:00 AM,48,-122,5,5,10
25061,FremontBridge,08/13/2015 05:00:00 AM,48,-122,16,21,37
25062,FremontBridge,08/13/2015 06:00:00 AM,48,-122,54,108,162
25063,FremontBridge,08/13/2015 07:00:00 AM,48,-122,134,300,434
25064,FremontBridge,08/13/2015 08:00:00 AM,48,-122,221,392,613
25065,FremontBridge,08/13/2015 09:00:00 AM,48,-122,107,155,262
25066,FremontBridge,08/13/2015 10:00:00 AM,48,-122,66,77,143
25067,FremontBridge,08/13/2015 11:00:00 AM,48,-122,42,47,89
25068,FremontBridge,08/13/2015 12:00:00 PM,48,-122,45,58,103
25069,FremontBridge,08/13/2015 01:00:00 PM,48,-122,58,75,133
25070,FremontBridge,08/13/2015 02:00:00 PM,48,-122,72,59,131
25071,FremontBridge,08/13/2015 03:00:00 PM,48,-122,86,89,175
25072,FremontBridge,08/13/2015 04:00:00 PM,48,-122,242,115,357
25073,FremontBridge,08/13/2015 05:00:00 PM,48,-122,495,180,675
25074,FremontBridge,08/13/2015 06:00:00 PM,48,-122,299,175,474
25075,FremontBridge,08/13/2015 07:00:00 PM,48,-122,138,93,231
25076,FremontBridge,08/13/2015 08:00:00 PM,48,-122,104,69,173
25077,FremontBridge,08/13/2015 09:00:00 PM,48,-122,37,49,86
25078,FremontBridge,08/13/2015 10:00:00 PM,48,-122,42,34,76
25079,FremontBridge,08/13/2015 11:00:00 PM,48,-122,20,12,32
25080,FremontBridge,08/14/2015 12:00:00 AM,48,-122,8,9,17
25081,FremontBridge,08/14/2015 01:00:00 AM,48,-122,6,3,9
25082,FremontBridge,08/14/2015 02:00:00 AM,48,-122,0,3,3
25083,FremontBridge,08/14/2015 03:00:00 AM,48,-122,2,0,2
25084,FremontBridge,08/14/2015 04:00:00 AM,48,-122,7,5,12
25085,FremontBridge,08/14/2015 05:00:00 AM,48,-122,19,19,38
25086,FremontBridge,08/14/2015 06:00:00 AM,48,-122,37,68,105
25087,FremontBridge,08/14/2015 07:00:00 AM,48,-122,81,159,240
25088,FremontBridge,08/14/2015 08:00:00 AM,48,-122,103,241,344
25089,FremontBridge,08/14/2015 09:00:00 AM,48,-122,78,127,205
25090,FremontBridge,08/14/2015 10:00:00 AM,48,-122,55,43,98
25091,FremontBridge,08/14/2015 11:00:00 AM,48,-122,29,30,59
25092,FremontBridge,08/14/2015 12:00:00 PM,48,-122,39,26,65
25093,FremontBridge,08/14/2015 01:00:00 PM,48,-122,17,22,39
25094,FremontBridge,08/14/2015 02:00:00 PM,48,-122,19,19,38
25095,FremontBridge,08/14/2015 03:00:00 PM,48,-122,53,19,72
25096,FremontBridge,08/14/2015 04:00:00 PM,48,-122,90,43,133
25097,FremontBridge,08/14/2015 05:00:00 PM,48,-122,199,84,283
25098,FremontBridge,08/14/2015 06:00:00 PM,48,-122,99,45,144
25099,FremontBridge,08/14/2015 07:00:00 PM,48,-122,40,23,63
25100,FremontBridge,08/14/2015 08:00:00 PM,48,-122,20,13,33
25101,FremontBridge,08/14/2015 09:00:00 PM,48,-122,14,12,26
25102,FremontBridge,08/14/2015 10:00:00 PM,48,-122,12,8,20
25103,FremontBridge,08/14/2015 11:00:00 PM,48,-122,10,4,14
25104,FremontBridge,08/15/2015 12:00:00 AM,48,-122,13,4,17
25105,FremontBridge,08/15/2015 01:00:00 AM,48,-122,5,1,6
25106,FremontBridge,08/15/2015 02:00:00 AM,48,-122,4,2,6
25107,FremontBridge,08/15/2015 03:00:00 AM,48,-122,0,4,4
25108,FremontBridge,08/15/2015 04:00:00 AM,48,-122,3,2,5
25109,FremontBridge,08/15/2015 05:00:00 AM,48,-122,6,11,17
25110,FremontBridge,08/15/2015 06:00:00 AM,48,-122,25,9,34
25111,FremontBridge,08/15/2015 07:00:00 AM,48,-122,15,16,31
25112,FremontBridge,08/15/2015 08:00:00 AM,48,-122,38,41,79
25113,FremontBridge,08/15/2015 09:00:00 AM,48,-122,35,32,67
25114,FremontBridge,08/15/2015 10:00:00 AM,48,-122,61,51,112
25115,FremontBridge,08/15/2015 11:00:00 AM,48,-122,54,60,114
25116,FremontBridge,08/15/2015 12:00:00 PM,48,-122,50,63,113
25117,FremontBridge,08/15/2015 01:00:00 PM,48,-122,74,74,148
25118,FremontBridge,08/15/2015 02:00:00 PM,48,-122,85,78,163
25119,FremontBridge,08/15/2015 03:00:00 PM,48,-122,63,90,153
25120,FremontBridge,08/15/2015 04:00:00 PM,48,-122,70,65,135
25121,FremontBridge,08/15/2015 05:00:00 PM,48,-122,82,84,166
25122,FremontBridge,08/15/2015 06:00:00 PM,48,-122,51,54,105
25123,FremontBridge,08/15/2015 07:00:00 PM,48,-122,42,28,70
25124,FremontBridge,08/15/2015 08:00:00 PM,48,-122,28,22,50
25125,FremontBridge,08/15/2015 09:00:00 PM,48,-122,35,14,49
25126,FremontBridge,08/15/2015 10:00:00 PM,48,-122,19,15,34
25127,FremontBridge,08/15/2015 11:00:00 PM,48,-122,14,10,24
25128,FremontBridge,08/16/2015 12:00:00 AM,48,-122,9,11,20
25129,FremontBridge,08/16/2015 01:00:00 AM,48,-122,9,5,14
25130,FremontBridge,08/16/2015 02:00:00 AM,48,-122,5,3,8
25131,FremontBridge,08/16/2015 03:00:00 AM,48,-122,3,0,3
25132,FremontBridge,08/16/2015 04:00:00 AM,48,-122,1,7,8
25133,FremontBridge,08/16/2015 05:00:00 AM,48,-122,3,3,6
25134,FremontBridge,08/16/2015 06:00:00 AM,48,-122,6,6,12
25135,FremontBridge,08/16/2015 07:00:00 AM,48,-122,15,8,23
25136,FremontBridge,08/16/2015 08:00:00 AM,48,-122,35,36,71
25137,FremontBridge,08/16/2015 09:00:00 AM,48,-122,65,49,114
25138,FremontBridge,08/16/2015 10:00:00 AM,48,-122,65,85,150
25139,FremontBridge,08/16/2015 11:00:00 AM,48,-122,78,105,183
25140,FremontBridge,08/16/2015 12:00:00 PM,48,-122,92,110,202
25141,FremontBridge,08/16/2015 01:00:00 PM,48,-122,100,153,253
25142,FremontBridge,08/16/2015 02:00:00 PM,48,-122,89,115,204
25143,FremontBridge,08/16/2015 03:00:00 PM,48,-122,111,114,225
25144,FremontBridge,08/16/2015 04:00:00 PM,48,-122,140,105,245
25145,FremontBridge,08/16/2015 05:00:00 PM,48,-122,94,82,176
25146,FremontBridge,08/16/2015 06:00:00 PM,48,-122,65,74,139
25147,FremontBridge,08/16/2015 07:00:00 PM,48,-122,52,62,114
25148,FremontBridge,08/16/2015 08:00:00 PM,48,-122,32,31,63
25149,FremontBridge,08/16/2015 09:00:00 PM,48,-122,26,30,56
25150,FremontBridge,08/16/2015 10:00:00 PM,48,-122,17,13,30
25151,FremontBridge,08/16/2015 11:00:00 PM,48,-122,8,6,14
25152,FremontBridge,08/17/2015 12:00:00 AM,48,-122,12,6,18
25153,FremontBridge,08/17/2015 01:00:00 AM,48,-122,4,0,4
25154,FremontBridge,08/17/2015 02:00:00 AM,48,-122,3,1,4
25155,FremontBridge,08/17/2015 03:00:00 AM,48,-122,0,6,6
25156,FremontBridge,08/17/2015 04:00:00 AM,48,-122,5,6,11
25157,FremontBridge,08/17/2015 05:00:00 AM,48,-122,14,34,48
25158,FremontBridge,08/17/2015 06:00:00 AM,48,-122,44,118,162
25159,FremontBridge,08/17/2015 07:00:00 AM,48,-122,132,320,452
25160,FremontBridge,08/17/2015 08:00:00 AM,48,-122,161,369,530
25161,FremontBridge,08/17/2015 09:00:00 AM,48,-122,114,161,275
25162,FremontBridge,08/17/2015 10:00:00 AM,48,-122,49,82,131
25163,FremontBridge,08/17/2015 11:00:00 AM,48,-122,55,56,111
25164,FremontBridge,08/17/2015 12:00:00 PM,48,-122,46,59,105
25165,FremontBridge,08/17/2015 01:00:00 PM,48,-122,50,52,102
25166,FremontBridge,08/17/2015 02:00:00 PM,48,-122,69,53,122
25167,FremontBridge,08/17/2015 03:00:00 PM,48,-122,86,59,145
25168,FremontBridge,08/17/2015 04:00:00 PM,48,-122,216,127,343
25169,FremontBridge,08/17/2015 05:00:00 PM,48,-122,524,209,733
25170,FremontBridge,08/17/2015 06:00:00 PM,48,-122,316,164,480
25171,FremontBridge,08/17/2015 07:00:00 PM,48,-122,136,102,238
25172,FremontBridge,08/17/2015 08:00:00 PM,48,-122,71,74,145
25173,FremontBridge,08/17/2015 09:00:00 PM,48,-122,36,40,76
25174,FremontBridge,08/17/2015 10:00:00 PM,48,-122,18,23,41
25175,FremontBridge,08/17/2015 11:00:00 PM,48,-122,12,25,37
25176,FremontBridge,08/18/2015 12:00:00 AM,48,-122,12,5,17
25177,FremontBridge,08/18/2015 01:00:00 AM,48,-122,1,2,3
25178,FremontBridge,08/18/2015 02:00:00 AM,48,-122,4,3,7
25179,FremontBridge,08/18/2015 03:00:00 AM,48,-122,0,3,3
25180,FremontBridge,08/18/2015 04:00:00 AM,48,-122,7,8,15
25181,FremontBridge,08/18/2015 05:00:00 AM,48,-122,18,28,46
25182,FremontBridge,08/18/2015 06:00:00 AM,48,-122,52,100,152
25183,FremontBridge,08/18/2015 07:00:00 AM,48,-122,134,323,457
25184,FremontBridge,08/18/2015 08:00:00 AM,48,-122,208,406,614
25185,FremontBridge,08/18/2015 09:00:00 AM,48,-122,127,165,292
25186,FremontBridge,08/18/2015 10:00:00 AM,48,-122,56,70,126
25187,FremontBridge,08/18/2015 11:00:00 AM,48,-122,46,59,105
25188,FremontBridge,08/18/2015 12:00:00 PM,48,-122,42,44,86
25189,FremontBridge,08/18/2015 01:00:00 PM,48,-122,45,53,98
25190,FremontBridge,08/18/2015 02:00:00 PM,48,-122,62,49,111
25191,FremontBridge,08/18/2015 03:00:00 PM,48,-122,100,66,166
25192,FremontBridge,08/18/2015 04:00:00 PM,48,-122,229,130,359
25193,FremontBridge,08/18/2015 05:00:00 PM,48,-122,486,218,704
25194,FremontBridge,08/18/2015 06:00:00 PM,48,-122,353,174,527
25195,FremontBridge,08/18/2015 07:00:00 PM,48,-122,150,119,269
25196,FremontBridge,08/18/2015 08:00:00 PM,48,-122,97,64,161
25197,FremontBridge,08/18/2015 09:00:00 PM,48,-122,49,52,101
25198,FremontBridge,08/18/2015 10:00:00 PM,48,-122,34,30,64
25199,FremontBridge,08/18/2015 11:00:00 PM,48,-122,13,12,25
25200,FremontBridge,08/19/2015 12:00:00 AM,48,-122,10,9,19
25201,FremontBridge,08/19/2015 01:00:00 AM,48,-122,5,7,12
25202,FremontBridge,08/19/2015 02:00:00 AM,48,-122,3,1,4
25203,FremontBridge,08/19/2015 03:00:00 AM,48,-122,1,1,2
25204,FremontBridge,08/19/2015 04:00:00 AM,48,-122,3,6,9
25205,FremontBridge,08/19/2015 05:00:00 AM,48,-122,20,29,49
25206,FremontBridge,08/19/2015 06:00:00 AM,48,-122,62,118,180
25207,FremontBridge,08/19/2015 07:00:00 AM,48,-122,148,337,485
25208,FremontBridge,08/19/2015 08:00:00 AM,48,-122,189,377,566
25209,FremontBridge,08/19/2015 09:00:00 AM,48,-122,110,186,296
25210,FremontBridge,08/19/2015 10:00:00 AM,48,-122,59,82,141
25211,FremontBridge,08/19/2015 11:00:00 AM,48,-122,51,53,104
25212,FremontBridge,08/19/2015 12:00:00 PM,48,-122,63,46,109
25213,FremontBridge,08/19/2015 01:00:00 PM,48,-122,59,58,117
25214,FremontBridge,08/19/2015 02:00:00 PM,48,-122,45,61,106
25215,FremontBridge,08/19/2015 03:00:00 PM,48,-122,123,82,205
25216,FremontBridge,08/19/2015 04:00:00 PM,48,-122,221,124,345
25217,FremontBridge,08/19/2015 05:00:00 PM,48,-122,468,192,660
25218,FremontBridge,08/19/2015 06:00:00 PM,48,-122,332,165,497
25219,FremontBridge,08/19/2015 07:00:00 PM,48,-122,183,96,279
25220,FremontBridge,08/19/2015 08:00:00 PM,48,-122,88,53,141
25221,FremontBridge,08/19/2015 09:00:00 PM,48,-122,67,50,117
25222,FremontBridge,08/19/2015 10:00:00 PM,48,-122,31,31,62
25223,FremontBridge,08/19/2015 11:00:00 PM,48,-122,22,21,43
25224,FremontBridge,08/20/2015 12:00:00 AM,48,-122,7,4,11
25225,FremontBridge,08/20/2015 01:00:00 AM,48,-122,4,1,5
25226,FremontBridge,08/20/2015 02:00:00 AM,48,-122,1,5,6
25227,FremontBridge,08/20/2015 03:00:00 AM,48,-122,0,0,0
25228,FremontBridge,08/20/2015 04:00:00 AM,48,-122,2,7,9
25229,FremontBridge,08/20/2015 05:00:00 AM,48,-122,12,24,36
25230,FremontBridge,08/20/2015 06:00:00 AM,48,-122,54,101,155
25231,FremontBridge,08/20/2015 07:00:00 AM,48,-122,136,254,390
25232,FremontBridge,08/20/2015 08:00:00 AM,48,-122,188,313,501
25233,FremontBridge,08/20/2015 09:00:00 AM,48,-122,106,161,267
25234,FremontBridge,08/20/2015 10:00:00 AM,48,-122,48,62,110
25235,FremontBridge,08/20/2015 11:00:00 AM,48,-122,30,46,76
25236,FremontBridge,08/20/2015 12:00:00 PM,48,-122,38,38,76
25237,FremontBridge,08/20/2015 01:00:00 PM,48,-122,53,57,110
25238,FremontBridge,08/20/2015 02:00:00 PM,48,-122,53,39,92
25239,FremontBridge,08/20/2015 03:00:00 PM,48,-122,77,52,129
25240,FremontBridge,08/20/2015 04:00:00 PM,48,-122,194,107,301
25241,FremontBridge,08/20/2015 05:00:00 PM,48,-122,418,166,584
25242,FremontBridge,08/20/2015 06:00:00 PM,48,-122,277,169,446
25243,FremontBridge,08/20/2015 07:00:00 PM,48,-122,155,99,254
25244,FremontBridge,08/20/2015 08:00:00 PM,48,-122,74,57,131
25245,FremontBridge,08/20/2015 09:00:00 PM,48,-122,44,38,82
25246,FremontBridge,08/20/2015 10:00:00 PM,48,-122,26,23,49
25247,FremontBridge,08/20/2015 11:00:00 PM,48,-122,16,10,26
25248,FremontBridge,08/21/2015 12:00:00 AM,48,-122,12,4,16
25249,FremontBridge,08/21/2015 01:00:00 AM,48,-122,4,1,5
25250,FremontBridge,08/21/2015 02:00:00 AM,48,-122,1,4,5
25251,FremontBridge,08/21/2015 03:00:00 AM,48,-122,0,1,1
25252,FremontBridge,08/21/2015 04:00:00 AM,48,-122,4,5,9
25253,FremontBridge,08/21/2015 05:00:00 AM,48,-122,9,18,27
25254,FremontBridge,08/21/2015 06:00:00 AM,48,-122,37,81,118
25255,FremontBridge,08/21/2015 07:00:00 AM,48,-122,106,235,341
25256,FremontBridge,08/21/2015 08:00:00 AM,48,-122,149,297,446
25257,FremontBridge,08/21/2015 09:00:00 AM,48,-122,91,173,264
25258,FremontBridge,08/21/2015 10:00:00 AM,48,-122,36,55,91
25259,FremontBridge,08/21/2015 11:00:00 AM,48,-122,56,50,106
25260,FremontBridge,08/21/2015 12:00:00 PM,48,-122,56,43,99
25261,FremontBridge,08/21/2015 01:00:00 PM,48,-122,59,61,120
25262,FremontBridge,08/21/2015 02:00:00 PM,48,-122,69,61,130
25263,FremontBridge,08/21/2015 03:00:00 PM,48,-122,112,88,200
25264,FremontBridge,08/21/2015 04:00:00 PM,48,-122,215,122,337
25265,FremontBridge,08/21/2015 05:00:00 PM,48,-122,362,171,533
25266,FremontBridge,08/21/2015 06:00:00 PM,48,-122,192,120,312
25267,FremontBridge,08/21/2015 07:00:00 PM,48,-122,93,73,166
25268,FremontBridge,08/21/2015 08:00:00 PM,48,-122,52,52,104
25269,FremontBridge,08/21/2015 09:00:00 PM,48,-122,30,30,60
25270,FremontBridge,08/21/2015 10:00:00 PM,48,-122,32,33,65
25271,FremontBridge,08/21/2015 11:00:00 PM,48,-122,32,19,51
25272,FremontBridge,08/22/2015 12:00:00 AM,48,-122,13,5,18
25273,FremontBridge,08/22/2015 01:00:00 AM,48,-122,10,14,24
25274,FremontBridge,08/22/2015 02:00:00 AM,48,-122,5,5,10
25275,FremontBridge,08/22/2015 03:00:00 AM,48,-122,2,5,7
25276,FremontBridge,08/22/2015 04:00:00 AM,48,-122,2,2,4
25277,FremontBridge,08/22/2015 05:00:00 AM,48,-122,2,7,9
25278,FremontBridge,08/22/2015 06:00:00 AM,48,-122,13,16,29
25279,FremontBridge,08/22/2015 07:00:00 AM,48,-122,30,35,65
25280,FremontBridge,08/22/2015 08:00:00 AM,48,-122,32,38,70
25281,FremontBridge,08/22/2015 09:00:00 AM,48,-122,60,87,147
25282,FremontBridge,08/22/2015 10:00:00 AM,48,-122,42,148,190
25283,FremontBridge,08/22/2015 11:00:00 AM,48,-122,67,89,156
25284,FremontBridge,08/22/2015 12:00:00 PM,48,-122,69,79,148
25285,FremontBridge,08/22/2015 01:00:00 PM,48,-122,99,78,177
25286,FremontBridge,08/22/2015 02:00:00 PM,48,-122,89,83,172
25287,FremontBridge,08/22/2015 03:00:00 PM,48,-122,84,86,170
25288,FremontBridge,08/22/2015 04:00:00 PM,48,-122,77,83,160
25289,FremontBridge,08/22/2015 05:00:00 PM,48,-122,85,63,148
25290,FremontBridge,08/22/2015 06:00:00 PM,48,-122,54,63,117
25291,FremontBridge,08/22/2015 07:00:00 PM,48,-122,42,43,85
25292,FremontBridge,08/22/2015 08:00:00 PM,48,-122,37,27,64
25293,FremontBridge,08/22/2015 09:00:00 PM,48,-122,22,32,54
25294,FremontBridge,08/22/2015 10:00:00 PM,48,-122,19,20,39
25295,FremontBridge,08/22/2015 11:00:00 PM,48,-122,19,8,27
25296,FremontBridge,08/23/2015 12:00:00 AM,48,-122,15,12,27
25297,FremontBridge,08/23/2015 01:00:00 AM,48,-122,5,3,8
25298,FremontBridge,08/23/2015 02:00:00 AM,48,-122,5,8,13
25299,FremontBridge,08/23/2015 03:00:00 AM,48,-122,2,4,6
25300,FremontBridge,08/23/2015 04:00:00 AM,48,-122,2,3,5
25301,FremontBridge,08/23/2015 05:00:00 AM,48,-122,1,5,6
25302,FremontBridge,08/23/2015 06:00:00 AM,48,-122,11,7,18
25303,FremontBridge,08/23/2015 07:00:00 AM,48,-122,16,24,40
25304,FremontBridge,08/23/2015 08:00:00 AM,48,-122,32,45,77
25305,FremontBridge,08/23/2015 09:00:00 AM,48,-122,46,63,109
25306,FremontBridge,08/23/2015 10:00:00 AM,48,-122,63,60,123
25307,FremontBridge,08/23/2015 11:00:00 AM,48,-122,60,103,163
25308,FremontBridge,08/23/2015 12:00:00 PM,48,-122,112,85,197
25309,FremontBridge,08/23/2015 01:00:00 PM,48,-122,85,106,191
25310,FremontBridge,08/23/2015 02:00:00 PM,48,-122,69,90,159
25311,FremontBridge,08/23/2015 03:00:00 PM,48,-122,57,98,155
25312,FremontBridge,08/23/2015 04:00:00 PM,48,-122,75,80,155
25313,FremontBridge,08/23/2015 05:00:00 PM,48,-122,81,92,173
25314,FremontBridge,08/23/2015 06:00:00 PM,48,-122,69,63,132
25315,FremontBridge,08/23/2015 07:00:00 PM,48,-122,37,34,71
25316,FremontBridge,08/23/2015 08:00:00 PM,48,-122,50,35,85
25317,FremontBridge,08/23/2015 09:00:00 PM,48,-122,16,23,39
25318,FremontBridge,08/23/2015 10:00:00 PM,48,-122,25,19,44
25319,FremontBridge,08/23/2015 11:00:00 PM,48,-122,9,11,20
25320,FremontBridge,08/24/2015 12:00:00 AM,48,-122,11,2,13
25321,FremontBridge,08/24/2015 01:00:00 AM,48,-122,7,3,10
25322,FremontBridge,08/24/2015 02:00:00 AM,48,-122,2,2,4
25323,FremontBridge,08/24/2015 03:00:00 AM,48,-122,0,2,2
25324,FremontBridge,08/24/2015 04:00:00 AM,48,-122,3,7,10
25325,FremontBridge,08/24/2015 05:00:00 AM,48,-122,15,29,44
25326,FremontBridge,08/24/2015 06:00:00 AM,48,-122,47,95,142
25327,FremontBridge,08/24/2015 07:00:00 AM,48,-122,129,318,447
25328,FremontBridge,08/24/2015 08:00:00 AM,48,-122,180,354,534
25329,FremontBridge,08/24/2015 09:00:00 AM,48,-122,113,153,266
25330,FremontBridge,08/24/2015 10:00:00 AM,48,-122,53,52,105
25331,FremontBridge,08/24/2015 11:00:00 AM,48,-122,46,52,98
25332,FremontBridge,08/24/2015 12:00:00 PM,48,-122,53,49,102
25333,FremontBridge,08/24/2015 01:00:00 PM,48,-122,64,42,106
25334,FremontBridge,08/24/2015 02:00:00 PM,48,-122,46,66,112
25335,FremontBridge,08/24/2015 03:00:00 PM,48,-122,96,71,167
25336,FremontBridge,08/24/2015 04:00:00 PM,48,-122,205,134,339
25337,FremontBridge,08/24/2015 05:00:00 PM,48,-122,460,169,629
25338,FremontBridge,08/24/2015 06:00:00 PM,48,-122,296,167,463
25339,FremontBridge,08/24/2015 07:00:00 PM,48,-122,120,96,216
25340,FremontBridge,08/24/2015 08:00:00 PM,48,-122,72,59,131
25341,FremontBridge,08/24/2015 09:00:00 PM,48,-122,36,24,60
25342,FremontBridge,08/24/2015 10:00:00 PM,48,-122,20,18,38
25343,FremontBridge,08/24/2015 11:00:00 PM,48,-122,19,15,34
25344,FremontBridge,08/25/2015 12:00:00 AM,48,-122,11,6,17
25345,FremontBridge,08/25/2015 01:00:00 AM,48,-122,2,3,5
25346,FremontBridge,08/25/2015 02:00:00 AM,48,-122,6,2,8
25347,FremontBridge,08/25/2015 03:00:00 AM,48,-122,5,0,5
25348,FremontBridge,08/25/2015 04:00:00 AM,48,-122,0,8,8
25349,FremontBridge,08/25/2015 05:00:00 AM,48,-122,21,32,53
25350,FremontBridge,08/25/2015 06:00:00 AM,48,-122,47,108,155
25351,FremontBridge,08/25/2015 07:00:00 AM,48,-122,128,331,459
25352,FremontBridge,08/25/2015 08:00:00 AM,48,-122,212,403,615
25353,FremontBridge,08/25/2015 09:00:00 AM,48,-122,118,161,279
25354,FremontBridge,08/25/2015 10:00:00 AM,48,-122,62,112,174
25355,FremontBridge,08/25/2015 11:00:00 AM,48,-122,48,50,98
25356,FremontBridge,08/25/2015 12:00:00 PM,48,-122,49,42,91
25357,FremontBridge,08/25/2015 01:00:00 PM,48,-122,54,55,109
25358,FremontBridge,08/25/2015 02:00:00 PM,48,-122,66,57,123
25359,FremontBridge,08/25/2015 03:00:00 PM,48,-122,89,71,160
25360,FremontBridge,08/25/2015 04:00:00 PM,48,-122,229,144,373
25361,FremontBridge,08/25/2015 05:00:00 PM,48,-122,499,215,714
25362,FremontBridge,08/25/2015 06:00:00 PM,48,-122,302,195,497
25363,FremontBridge,08/25/2015 07:00:00 PM,48,-122,146,116,262
25364,FremontBridge,08/25/2015 08:00:00 PM,48,-122,75,55,130
25365,FremontBridge,08/25/2015 09:00:00 PM,48,-122,30,35,65
25366,FremontBridge,08/25/2015 10:00:00 PM,48,-122,27,15,42
25367,FremontBridge,08/25/2015 11:00:00 PM,48,-122,19,12,31
25368,FremontBridge,08/26/2015 12:00:00 AM,48,-122,11,7,18
25369,FremontBridge,08/26/2015 01:00:00 AM,48,-122,2,5,7
25370,FremontBridge,08/26/2015 02:00:00 AM,48,-122,4,5,9
25371,FremontBridge,08/26/2015 03:00:00 AM,48,-122,1,1,2
25372,FremontBridge,08/26/2015 04:00:00 AM,48,-122,4,11,15
25373,FremontBridge,08/26/2015 05:00:00 AM,48,-122,19,30,49
25374,FremontBridge,08/26/2015 06:00:00 AM,48,-122,57,110,167
25375,FremontBridge,08/26/2015 07:00:00 AM,48,-122,130,306,436
25376,FremontBridge,08/26/2015 08:00:00 AM,48,-122,201,354,555
25377,FremontBridge,08/26/2015 09:00:00 AM,48,-122,109,174,283
25378,FremontBridge,08/26/2015 10:00:00 AM,48,-122,60,60,120
25379,FremontBridge,08/26/2015 11:00:00 AM,48,-122,43,58,101
25380,FremontBridge,08/26/2015 12:00:00 PM,48,-122,44,44,88
25381,FremontBridge,08/26/2015 01:00:00 PM,48,-122,57,46,103
25382,FremontBridge,08/26/2015 02:00:00 PM,48,-122,71,47,118
25383,FremontBridge,08/26/2015 03:00:00 PM,48,-122,81,58,139
25384,FremontBridge,08/26/2015 04:00:00 PM,48,-122,227,148,375
25385,FremontBridge,08/26/2015 05:00:00 PM,48,-122,513,206,719
25386,FremontBridge,08/26/2015 06:00:00 PM,48,-122,328,181,509
25387,FremontBridge,08/26/2015 07:00:00 PM,48,-122,121,90,211
25388,FremontBridge,08/26/2015 08:00:00 PM,48,-122,73,65,138
25389,FremontBridge,08/26/2015 09:00:00 PM,48,-122,49,48,97
25390,FremontBridge,08/26/2015 10:00:00 PM,48,-122,16,25,41
25391,FremontBridge,08/26/2015 11:00:00 PM,48,-122,14,17,31
25392,FremontBridge,08/27/2015 12:00:00 AM,48,-122,9,9,18
25393,FremontBridge,08/27/2015 01:00:00 AM,48,-122,2,2,4
25394,FremontBridge,08/27/2015 02:00:00 AM,48,-122,2,2,4
25395,FremontBridge,08/27/2015 03:00:00 AM,48,-122,2,1,3
25396,FremontBridge,08/27/2015 04:00:00 AM,48,-122,2,2,4
25397,FremontBridge,08/27/2015 05:00:00 AM,48,-122,14,35,49
25398,FremontBridge,08/27/2015 06:00:00 AM,48,-122,39,104,143
25399,FremontBridge,08/27/2015 07:00:00 AM,48,-122,129,287,416
25400,FremontBridge,08/27/2015 08:00:00 AM,48,-122,204,383,587
25401,FremontBridge,08/27/2015 09:00:00 AM,48,-122,104,174,278
25402,FremontBridge,08/27/2015 10:00:00 AM,48,-122,53,78,131
25403,FremontBridge,08/27/2015 11:00:00 AM,48,-122,39,56,95
25404,FremontBridge,08/27/2015 12:00:00 PM,48,-122,58,49,107
25405,FremontBridge,08/27/2015 01:00:00 PM,48,-122,62,75,137
25406,FremontBridge,08/27/2015 02:00:00 PM,48,-122,77,46,123
25407,FremontBridge,08/27/2015 03:00:00 PM,48,-122,86,64,150
25408,FremontBridge,08/27/2015 04:00:00 PM,48,-122,230,123,353
25409,FremontBridge,08/27/2015 05:00:00 PM,48,-122,449,222,671
25410,FremontBridge,08/27/2015 06:00:00 PM,48,-122,317,173,490
25411,FremontBridge,08/27/2015 07:00:00 PM,48,-122,134,86,220
25412,FremontBridge,08/27/2015 08:00:00 PM,48,-122,89,72,161
25413,FremontBridge,08/27/2015 09:00:00 PM,48,-122,45,48,93
25414,FremontBridge,08/27/2015 10:00:00 PM,48,-122,19,30,49
25415,FremontBridge,08/27/2015 11:00:00 PM,48,-122,22,28,50
25416,FremontBridge,08/28/2015 12:00:00 AM,48,-122,10,8,18
25417,FremontBridge,08/28/2015 01:00:00 AM,48,-122,1,3,4
25418,FremontBridge,08/28/2015 02:00:00 AM,48,-122,1,1,2
25419,FremontBridge,08/28/2015 03:00:00 AM,48,-122,2,2,4
25420,FremontBridge,08/28/2015 04:00:00 AM,48,-122,4,7,11
25421,FremontBridge,08/28/2015 05:00:00 AM,48,-122,10,19,29
25422,FremontBridge,08/28/2015 06:00:00 AM,48,-122,22,63,85
25423,FremontBridge,08/28/2015 07:00:00 AM,48,-122,70,151,221
25424,FremontBridge,08/28/2015 08:00:00 AM,48,-122,112,239,351
25425,FremontBridge,08/28/2015 09:00:00 AM,48,-122,83,101,184
25426,FremontBridge,08/28/2015 10:00:00 AM,48,-122,48,46,94
25427,FremontBridge,08/28/2015 11:00:00 AM,48,-122,28,47,75
25428,FremontBridge,08/28/2015 12:00:00 PM,48,-122,57,33,90
25429,FremontBridge,08/28/2015 01:00:00 PM,48,-122,35,38,73
25430,FremontBridge,08/28/2015 02:00:00 PM,48,-122,45,48,93
25431,FremontBridge,08/28/2015 03:00:00 PM,48,-122,83,59,142
25432,FremontBridge,08/28/2015 04:00:00 PM,48,-122,158,98,256
25433,FremontBridge,08/28/2015 05:00:00 PM,48,-122,276,133,409
25434,FremontBridge,08/28/2015 06:00:00 PM,48,-122,140,84,224
25435,FremontBridge,08/28/2015 07:00:00 PM,48,-122,72,33,105
25436,FremontBridge,08/28/2015 08:00:00 PM,48,-122,44,37,81
25437,FremontBridge,08/28/2015 09:00:00 PM,48,-122,22,24,46
25438,FremontBridge,08/28/2015 10:00:00 PM,48,-122,16,9,25
25439,FremontBridge,08/28/2015 11:00:00 PM,48,-122,14,17,31
25440,FremontBridge,08/29/2015 12:00:00 AM,48,-122,15,6,21
25441,FremontBridge,08/29/2015 01:00:00 AM,48,-122,9,6,15
25442,FremontBridge,08/29/2015 02:00:00 AM,48,-122,3,9,12
25443,FremontBridge,08/29/2015 03:00:00 AM,48,-122,1,2,3
25444,FremontBridge,08/29/2015 04:00:00 AM,48,-122,4,2,6
25445,FremontBridge,08/29/2015 05:00:00 AM,48,-122,0,2,2
25446,FremontBridge,08/29/2015 06:00:00 AM,48,-122,4,4,8
25447,FremontBridge,08/29/2015 07:00:00 AM,48,-122,6,7,13
25448,FremontBridge,08/29/2015 08:00:00 AM,48,-122,13,14,27
25449,FremontBridge,08/29/2015 09:00:00 AM,48,-122,13,22,35
25450,FremontBridge,08/29/2015 10:00:00 AM,48,-122,21,31,52
25451,FremontBridge,08/29/2015 11:00:00 AM,48,-122,22,23,45
25452,FremontBridge,08/29/2015 12:00:00 PM,48,-122,17,19,36
25453,FremontBridge,08/29/2015 01:00:00 PM,48,-122,28,25,53
25454,FremontBridge,08/29/2015 02:00:00 PM,48,-122,25,38,63
25455,FremontBridge,08/29/2015 03:00:00 PM,48,-122,28,32,60
25456,FremontBridge,08/29/2015 04:00:00 PM,48,-122,38,34,72
25457,FremontBridge,08/29/2015 05:00:00 PM,48,-122,29,25,54
25458,FremontBridge,08/29/2015 06:00:00 PM,48,-122,26,20,46
25459,FremontBridge,08/29/2015 07:00:00 PM,48,-122,8,20,28
25460,FremontBridge,08/29/2015 08:00:00 PM,48,-122,12,8,20
25461,FremontBridge,08/29/2015 09:00:00 PM,48,-122,3,8,11
25462,FremontBridge,08/29/2015 10:00:00 PM,48,-122,4,1,5
25463,FremontBridge,08/29/2015 11:00:00 PM,48,-122,5,7,12
25464,FremontBridge,08/30/2015 12:00:00 AM,48,-122,3,1,4
25465,FremontBridge,08/30/2015 01:00:00 AM,48,-122,1,3,4
25466,FremontBridge,08/30/2015 02:00:00 AM,48,-122,0,0,0
25467,FremontBridge,08/30/2015 03:00:00 AM,48,-122,1,2,3
25468,FremontBridge,08/30/2015 04:00:00 AM,48,-122,2,2,4
25469,FremontBridge,08/30/2015 05:00:00 AM,48,-122,3,1,4
25470,FremontBridge,08/30/2015 06:00:00 AM,48,-122,2,3,5
25471,FremontBridge,08/30/2015 07:00:00 AM,48,-122,2,4,6
25472,FremontBridge,08/30/2015 08:00:00 AM,48,-122,8,16,24
25473,FremontBridge,08/30/2015 09:00:00 AM,48,-122,13,19,32
25474,FremontBridge,08/30/2015 10:00:00 AM,48,-122,16,27,43
25475,FremontBridge,08/30/2015 11:00:00 AM,48,-122,41,57,98
25476,FremontBridge,08/30/2015 12:00:00 PM,48,-122,43,80,123
25477,FremontBridge,08/30/2015 01:00:00 PM,48,-122,44,84,128
25478,FremontBridge,08/30/2015 02:00:00 PM,48,-122,57,63,120
25479,FremontBridge,08/30/2015 03:00:00 PM,48,-122,44,65,109
25480,FremontBridge,08/30/2015 04:00:00 PM,48,-122,72,57,129
25481,FremontBridge,08/30/2015 05:00:00 PM,48,-122,52,51,103
25482,FremontBridge,08/30/2015 06:00:00 PM,48,-122,47,41,88
25483,FremontBridge,08/30/2015 07:00:00 PM,48,-122,30,40,70
25484,FremontBridge,08/30/2015 08:00:00 PM,48,-122,39,23,62
25485,FremontBridge,08/30/2015 09:00:00 PM,48,-122,5,15,20
25486,FremontBridge,08/30/2015 10:00:00 PM,48,-122,7,11,18
25487,FremontBridge,08/30/2015 11:00:00 PM,48,-122,9,7,16
25488,FremontBridge,08/31/2015 12:00:00 AM,48,-122,7,3,10
25489,FremontBridge,08/31/2015 01:00:00 AM,48,-122,3,2,5
25490,FremontBridge,08/31/2015 02:00:00 AM,48,-122,2,1,3
25491,FremontBridge,08/31/2015 03:00:00 AM,48,-122,1,3,4
25492,FremontBridge,08/31/2015 04:00:00 AM,48,-122,5,2,7
25493,FremontBridge,08/31/2015 05:00:00 AM,48,-122,11,15,26
25494,FremontBridge,08/31/2015 06:00:00 AM,48,-122,51,71,122
25495,FremontBridge,08/31/2015 07:00:00 AM,48,-122,109,200,309
25496,FremontBridge,08/31/2015 08:00:00 AM,48,-122,150,270,420
25497,FremontBridge,08/31/2015 09:00:00 AM,48,-122,84,109,193
25498,FremontBridge,08/31/2015 10:00:00 AM,48,-122,26,53,79
25499,FremontBridge,08/31/2015 11:00:00 AM,48,-122,20,28,48
25500,FremontBridge,08/31/2015 12:00:00 PM,48,-122,26,28,54
25501,FremontBridge,08/31/2015 01:00:00 PM,48,-122,32,25,57
25502,FremontBridge,08/31/2015 02:00:00 PM,48,-122,43,33,76
25503,FremontBridge,08/31/2015 03:00:00 PM,48,-122,51,29,80
25504,FremontBridge,08/31/2015 04:00:00 PM,48,-122,139,77,216
25505,FremontBridge,08/31/2015 05:00:00 PM,48,-122,350,130,480
25506,FremontBridge,08/31/2015 06:00:00 PM,48,-122,210,101,311
25507,FremontBridge,08/31/2015 07:00:00 PM,48,-122,112,59,171
25508,FremontBridge,08/31/2015 08:00:00 PM,48,-122,24,33,57
25509,FremontBridge,08/31/2015 09:00:00 PM,48,-122,24,22,46
25510,FremontBridge,08/31/2015 10:00:00 PM,48,-122,22,9,31
25511,FremontBridge,08/31/2015 11:00:00 PM,48,-122,11,7,18
25512,FremontBridge,09/01/2015 12:00:00 AM,48,-122,2,6,8
25513,FremontBridge,09/01/2015 01:00:00 AM,48,-122,1,1,2
25514,FremontBridge,09/01/2015 02:00:00 AM,48,-122,3,1,4
25515,FremontBridge,09/01/2015 03:00:00 AM,48,-122,3,1,4
25516,FremontBridge,09/01/2015 04:00:00 AM,48,-122,2,3,5
25517,FremontBridge,09/01/2015 05:00:00 AM,48,-122,17,23,40
25518,FremontBridge,09/01/2015 06:00:00 AM,48,-122,39,88,127
25519,FremontBridge,09/01/2015 07:00:00 AM,48,-122,103,227,330
25520,FremontBridge,09/01/2015 08:00:00 AM,48,-122,142,273,415
25521,FremontBridge,09/01/2015 09:00:00 AM,48,-122,60,115,175
25522,FremontBridge,09/01/2015 10:00:00 AM,48,-122,28,36,64
25523,FremontBridge,09/01/2015 11:00:00 AM,48,-122,18,25,43
25524,FremontBridge,09/01/2015 12:00:00 PM,48,-122,30,45,75
25525,FremontBridge,09/01/2015 01:00:00 PM,48,-122,42,22,64
25526,FremontBridge,09/01/2015 02:00:00 PM,48,-122,33,43,76
25527,FremontBridge,09/01/2015 03:00:00 PM,48,-122,50,35,85
25528,FremontBridge,09/01/2015 04:00:00 PM,48,-122,133,85,218
25529,FremontBridge,09/01/2015 05:00:00 PM,48,-122,378,142,520
25530,FremontBridge,09/01/2015 06:00:00 PM,48,-122,214,106,320
25531,FremontBridge,09/01/2015 07:00:00 PM,48,-122,102,46,148
25532,FremontBridge,09/01/2015 08:00:00 PM,48,-122,36,27,63
25533,FremontBridge,09/01/2015 09:00:00 PM,48,-122,20,17,37
25534,FremontBridge,09/01/2015 10:00:00 PM,48,-122,18,17,35
25535,FremontBridge,09/01/2015 11:00:00 PM,48,-122,9,9,18
25536,FremontBridge,09/02/2015 12:00:00 AM,48,-122,6,7,13
25537,FremontBridge,09/02/2015 01:00:00 AM,48,-122,3,0,3
25538,FremontBridge,09/02/2015 02:00:00 AM,48,-122,2,3,5
25539,FremontBridge,09/02/2015 03:00:00 AM,48,-122,1,3,4
25540,FremontBridge,09/02/2015 04:00:00 AM,48,-122,3,9,12
25541,FremontBridge,09/02/2015 05:00:00 AM,48,-122,15,25,40
25542,FremontBridge,09/02/2015 06:00:00 AM,48,-122,51,104,155
25543,FremontBridge,09/02/2015 07:00:00 AM,48,-122,127,242,369
25544,FremontBridge,09/02/2015 08:00:00 AM,48,-122,173,303,476
25545,FremontBridge,09/02/2015 09:00:00 AM,48,-122,94,155,249
25546,FremontBridge,09/02/2015 10:00:00 AM,48,-122,41,51,92
25547,FremontBridge,09/02/2015 11:00:00 AM,48,-122,33,30,63
25548,FremontBridge,09/02/2015 12:00:00 PM,48,-122,35,48,83
25549,FremontBridge,09/02/2015 01:00:00 PM,48,-122,46,42,88
25550,FremontBridge,09/02/2015 02:00:00 PM,48,-122,38,53,91
25551,FremontBridge,09/02/2015 03:00:00 PM,48,-122,80,56,136
25552,FremontBridge,09/02/2015 04:00:00 PM,48,-122,193,129,322
25553,FremontBridge,09/02/2015 05:00:00 PM,48,-122,416,191,607
25554,FremontBridge,09/02/2015 06:00:00 PM,48,-122,266,133,399
25555,FremontBridge,09/02/2015 07:00:00 PM,48,-122,117,76,193
25556,FremontBridge,09/02/2015 08:00:00 PM,48,-122,69,39,108
25557,FremontBridge,09/02/2015 09:00:00 PM,48,-122,25,23,48
25558,FremontBridge,09/02/2015 10:00:00 PM,48,-122,18,12,30
25559,FremontBridge,09/02/2015 11:00:00 PM,48,-122,15,11,26
25560,FremontBridge,09/03/2015 12:00:00 AM,48,-122,4,4,8
25561,FremontBridge,09/03/2015 01:00:00 AM,48,-122,3,6,9
25562,FremontBridge,09/03/2015 02:00:00 AM,48,-122,2,0,2
25563,FremontBridge,09/03/2015 03:00:00 AM,48,-122,1,2,3
25564,FremontBridge,09/03/2015 04:00:00 AM,48,-122,5,2,7
25565,FremontBridge,09/03/2015 05:00:00 AM,48,-122,16,18,34
25566,FremontBridge,09/03/2015 06:00:00 AM,48,-122,40,89,129
25567,FremontBridge,09/03/2015 07:00:00 AM,48,-122,109,218,327
25568,FremontBridge,09/03/2015 08:00:00 AM,48,-122,138,253,391
25569,FremontBridge,09/03/2015 09:00:00 AM,48,-122,81,136,217
25570,FremontBridge,09/03/2015 10:00:00 AM,48,-122,39,53,92
25571,FremontBridge,09/03/2015 11:00:00 AM,48,-122,38,48,86
25572,FremontBridge,09/03/2015 12:00:00 PM,48,-122,39,35,74
25573,FremontBridge,09/03/2015 01:00:00 PM,48,-122,41,31,72
25574,FremontBridge,09/03/2015 02:00:00 PM,48,-122,47,44,91
25575,FremontBridge,09/03/2015 03:00:00 PM,48,-122,94,48,142
25576,FremontBridge,09/03/2015 04:00:00 PM,48,-122,168,118,286
25577,FremontBridge,09/03/2015 05:00:00 PM,48,-122,309,151,460
25578,FremontBridge,09/03/2015 06:00:00 PM,48,-122,210,120,330
25579,FremontBridge,09/03/2015 07:00:00 PM,48,-122,98,69,167
25580,FremontBridge,09/03/2015 08:00:00 PM,48,-122,74,38,112
25581,FremontBridge,09/03/2015 09:00:00 PM,48,-122,26,19,45
25582,FremontBridge,09/03/2015 10:00:00 PM,48,-122,27,18,45
25583,FremontBridge,09/03/2015 11:00:00 PM,48,-122,18,12,30
25584,FremontBridge,09/04/2015 12:00:00 AM,48,-122,3,8,11
25585,FremontBridge,09/04/2015 01:00:00 AM,48,-122,2,2,4
25586,FremontBridge,09/04/2015 02:00:00 AM,48,-122,2,1,3
25587,FremontBridge,09/04/2015 03:00:00 AM,48,-122,2,3,5
25588,FremontBridge,09/04/2015 04:00:00 AM,48,-122,2,3,5
25589,FremontBridge,09/04/2015 05:00:00 AM,48,-122,13,24,37
25590,FremontBridge,09/04/2015 06:00:00 AM,48,-122,28,80,108
25591,FremontBridge,09/04/2015 07:00:00 AM,48,-122,82,219,301
25592,FremontBridge,09/04/2015 08:00:00 AM,48,-122,134,235,369
25593,FremontBridge,09/04/2015 09:00:00 AM,48,-122,90,121,211
25594,FremontBridge,09/04/2015 10:00:00 AM,48,-122,29,50,79
25595,FremontBridge,09/04/2015 11:00:00 AM,48,-122,38,30,68
25596,FremontBridge,09/04/2015 12:00:00 PM,48,-122,36,30,66
25597,FremontBridge,09/04/2015 01:00:00 PM,48,-122,34,37,71
25598,FremontBridge,09/04/2015 02:00:00 PM,48,-122,68,58,126
25599,FremontBridge,09/04/2015 03:00:00 PM,48,-122,136,60,196
25600,FremontBridge,09/04/2015 04:00:00 PM,48,-122,181,101,282
25601,FremontBridge,09/04/2015 05:00:00 PM,48,-122,275,138,413
25602,FremontBridge,09/04/2015 06:00:00 PM,48,-122,187,105,292
25603,FremontBridge,09/04/2015 07:00:00 PM,48,-122,74,56,130
25604,FremontBridge,09/04/2015 08:00:00 PM,48,-122,51,27,78
25605,FremontBridge,09/04/2015 09:00:00 PM,48,-122,17,18,35
25606,FremontBridge,09/04/2015 10:00:00 PM,48,-122,13,14,27
25607,FremontBridge,09/04/2015 11:00:00 PM,48,-122,15,5,20
25608,FremontBridge,09/05/2015 12:00:00 AM,48,-122,12,8,20
25609,FremontBridge,09/05/2015 01:00:00 AM,48,-122,6,5,11
25610,FremontBridge,09/05/2015 02:00:00 AM,48,-122,3,3,6
25611,FremontBridge,09/05/2015 03:00:00 AM,48,-122,0,3,3
25612,FremontBridge,09/05/2015 04:00:00 AM,48,-122,2,1,3
25613,FremontBridge,09/05/2015 05:00:00 AM,48,-122,2,9,11
25614,FremontBridge,09/05/2015 06:00:00 AM,48,-122,8,15,23
25615,FremontBridge,09/05/2015 07:00:00 AM,48,-122,19,17,36
25616,FremontBridge,09/05/2015 08:00:00 AM,48,-122,36,33,69
25617,FremontBridge,09/05/2015 09:00:00 AM,48,-122,55,62,117
25618,FremontBridge,09/05/2015 10:00:00 AM,48,-122,41,61,102
25619,FremontBridge,09/05/2015 11:00:00 AM,48,-122,75,74,149
25620,FremontBridge,09/05/2015 12:00:00 PM,48,-122,69,88,157
25621,FremontBridge,09/05/2015 01:00:00 PM,48,-122,71,101,172
25622,FremontBridge,09/05/2015 02:00:00 PM,48,-122,66,81,147
25623,FremontBridge,09/05/2015 03:00:00 PM,48,-122,98,99,197
25624,FremontBridge,09/05/2015 04:00:00 PM,48,-122,61,80,141
25625,FremontBridge,09/05/2015 05:00:00 PM,48,-122,29,22,51
25626,FremontBridge,09/05/2015 06:00:00 PM,48,-122,28,20,48
25627,FremontBridge,09/05/2015 07:00:00 PM,48,-122,18,20,38
25628,FremontBridge,09/05/2015 08:00:00 PM,48,-122,17,8,25
25629,FremontBridge,09/05/2015 09:00:00 PM,48,-122,21,8,29
25630,FremontBridge,09/05/2015 10:00:00 PM,48,-122,11,5,16
25631,FremontBridge,09/05/2015 11:00:00 PM,48,-122,22,3,25
25632,FremontBridge,09/06/2015 12:00:00 AM,48,-122,10,2,12
25633,FremontBridge,09/06/2015 01:00:00 AM,48,-122,5,6,11
25634,FremontBridge,09/06/2015 02:00:00 AM,48,-122,3,1,4
25635,FremontBridge,09/06/2015 03:00:00 AM,48,-122,2,0,2
25636,FremontBridge,09/06/2015 04:00:00 AM,48,-122,1,2,3
25637,FremontBridge,09/06/2015 05:00:00 AM,48,-122,0,3,3
25638,FremontBridge,09/06/2015 06:00:00 AM,48,-122,4,5,9
25639,FremontBridge,09/06/2015 07:00:00 AM,48,-122,4,6,10
25640,FremontBridge,09/06/2015 08:00:00 AM,48,-122,12,11,23
25641,FremontBridge,09/06/2015 09:00:00 AM,48,-122,18,19,37
25642,FremontBridge,09/06/2015 10:00:00 AM,48,-122,27,34,61
25643,FremontBridge,09/06/2015 11:00:00 AM,48,-122,25,29,54
25644,FremontBridge,09/06/2015 12:00:00 PM,48,-122,43,50,93
25645,FremontBridge,09/06/2015 01:00:00 PM,48,-122,25,40,65
25646,FremontBridge,09/06/2015 02:00:00 PM,48,-122,27,47,74
25647,FremontBridge,09/06/2015 03:00:00 PM,48,-122,48,33,81
25648,FremontBridge,09/06/2015 04:00:00 PM,48,-122,39,48,87
25649,FremontBridge,09/06/2015 05:00:00 PM,48,-122,31,28,59
25650,FremontBridge,09/06/2015 06:00:00 PM,48,-122,28,38,66
25651,FremontBridge,09/06/2015 07:00:00 PM,48,-122,20,26,46
25652,FremontBridge,09/06/2015 08:00:00 PM,48,-122,16,8,24
25653,FremontBridge,09/06/2015 09:00:00 PM,48,-122,13,13,26
25654,FremontBridge,09/06/2015 10:00:00 PM,48,-122,14,11,25
25655,FremontBridge,09/06/2015 11:00:00 PM,48,-122,10,6,16
25656,FremontBridge,09/07/2015 12:00:00 AM,48,-122,4,2,6
25657,FremontBridge,09/07/2015 01:00:00 AM,48,-122,3,2,5
25658,FremontBridge,09/07/2015 02:00:00 AM,48,-122,4,0,4
25659,FremontBridge,09/07/2015 03:00:00 AM,48,-122,1,1,2
25660,FremontBridge,09/07/2015 04:00:00 AM,48,-122,1,2,3
25661,FremontBridge,09/07/2015 05:00:00 AM,48,-122,2,9,11
25662,FremontBridge,09/07/2015 06:00:00 AM,48,-122,14,9,23
25663,FremontBridge,09/07/2015 07:00:00 AM,48,-122,12,20,32
25664,FremontBridge,09/07/2015 08:00:00 AM,48,-122,26,32,58
25665,FremontBridge,09/07/2015 09:00:00 AM,48,-122,42,37,79
25666,FremontBridge,09/07/2015 10:00:00 AM,48,-122,48,44,92
25667,FremontBridge,09/07/2015 11:00:00 AM,48,-122,59,92,151
25668,FremontBridge,09/07/2015 12:00:00 PM,48,-122,60,93,153
25669,FremontBridge,09/07/2015 01:00:00 PM,48,-122,82,99,181
25670,FremontBridge,09/07/2015 02:00:00 PM,48,-122,94,104,198
25671,FremontBridge,09/07/2015 03:00:00 PM,48,-122,96,123,219
25672,FremontBridge,09/07/2015 04:00:00 PM,48,-122,101,134,235
25673,FremontBridge,09/07/2015 05:00:00 PM,48,-122,69,101,170
25674,FremontBridge,09/07/2015 06:00:00 PM,48,-122,55,69,124
25675,FremontBridge,09/07/2015 07:00:00 PM,48,-122,40,59,99
25676,FremontBridge,09/07/2015 08:00:00 PM,48,-122,22,32,54
25677,FremontBridge,09/07/2015 09:00:00 PM,48,-122,33,23,56
25678,FremontBridge,09/07/2015 10:00:00 PM,48,-122,23,14,37
25679,FremontBridge,09/07/2015 11:00:00 PM,48,-122,7,6,13
25680,FremontBridge,09/08/2015 12:00:00 AM,48,-122,10,2,12
25681,FremontBridge,09/08/2015 01:00:00 AM,48,-122,2,3,5
25682,FremontBridge,09/08/2015 02:00:00 AM,48,-122,3,1,4
25683,FremontBridge,09/08/2015 03:00:00 AM,48,-122,2,4,6
25684,FremontBridge,09/08/2015 04:00:00 AM,48,-122,4,4,8
25685,FremontBridge,09/08/2015 05:00:00 AM,48,-122,15,29,44
25686,FremontBridge,09/08/2015 06:00:00 AM,48,-122,55,113,168
25687,FremontBridge,09/08/2015 07:00:00 AM,48,-122,139,271,410
25688,FremontBridge,09/08/2015 08:00:00 AM,48,-122,178,304,482
25689,FremontBridge,09/08/2015 09:00:00 AM,48,-122,88,144,232
25690,FremontBridge,09/08/2015 10:00:00 AM,48,-122,46,48,94
25691,FremontBridge,09/08/2015 11:00:00 AM,48,-122,41,35,76
25692,FremontBridge,09/08/2015 12:00:00 PM,48,-122,28,49,77
25693,FremontBridge,09/08/2015 01:00:00 PM,48,-122,33,44,77
25694,FremontBridge,09/08/2015 02:00:00 PM,48,-122,58,52,110
25695,FremontBridge,09/08/2015 03:00:00 PM,48,-122,76,68,144
25696,FremontBridge,09/08/2015 04:00:00 PM,48,-122,178,105,283
25697,FremontBridge,09/08/2015 05:00:00 PM,48,-122,451,151,602
25698,FremontBridge,09/08/2015 06:00:00 PM,48,-122,302,144,446
25699,FremontBridge,09/08/2015 07:00:00 PM,48,-122,112,75,187
25700,FremontBridge,09/08/2015 08:00:00 PM,48,-122,50,39,89
25701,FremontBridge,09/08/2015 09:00:00 PM,48,-122,29,29,58
25702,FremontBridge,09/08/2015 10:00:00 PM,48,-122,20,11,31
25703,FremontBridge,09/08/2015 11:00:00 PM,48,-122,12,8,20
25704,FremontBridge,09/09/2015 12:00:00 AM,48,-122,5,4,9
25705,FremontBridge,09/09/2015 01:00:00 AM,48,-122,4,2,6
25706,FremontBridge,09/09/2015 02:00:00 AM,48,-122,4,1,5
25707,FremontBridge,09/09/2015 03:00:00 AM,48,-122,0,2,2
25708,FremontBridge,09/09/2015 04:00:00 AM,48,-122,6,7,13
25709,FremontBridge,09/09/2015 05:00:00 AM,48,-122,16,26,42
25710,FremontBridge,09/09/2015 06:00:00 AM,48,-122,56,119,175
25711,FremontBridge,09/09/2015 07:00:00 AM,48,-122,140,313,453
25712,FremontBridge,09/09/2015 08:00:00 AM,48,-122,188,376,564
25713,FremontBridge,09/09/2015 09:00:00 AM,48,-122,124,160,284
25714,FremontBridge,09/09/2015 10:00:00 AM,48,-122,48,61,109
25715,FremontBridge,09/09/2015 11:00:00 AM,48,-122,44,56,100
25716,FremontBridge,09/09/2015 12:00:00 PM,48,-122,60,50,110
25717,FremontBridge,09/09/2015 01:00:00 PM,48,-122,50,41,91
25718,FremontBridge,09/09/2015 02:00:00 PM,48,-122,52,44,96
25719,FremontBridge,09/09/2015 03:00:00 PM,48,-122,97,72,169
25720,FremontBridge,09/09/2015 04:00:00 PM,48,-122,210,120,330
25721,FremontBridge,09/09/2015 05:00:00 PM,48,-122,501,218,719
25722,FremontBridge,09/09/2015 06:00:00 PM,48,-122,316,178,494
25723,FremontBridge,09/09/2015 07:00:00 PM,48,-122,158,100,258
25724,FremontBridge,09/09/2015 08:00:00 PM,48,-122,61,41,102
25725,FremontBridge,09/09/2015 09:00:00 PM,48,-122,52,37,89
25726,FremontBridge,09/09/2015 10:00:00 PM,48,-122,34,28,62
25727,FremontBridge,09/09/2015 11:00:00 PM,48,-122,17,14,31
25728,FremontBridge,09/10/2015 12:00:00 AM,48,-122,8,6,14
25729,FremontBridge,09/10/2015 01:00:00 AM,48,-122,1,5,6
25730,FremontBridge,09/10/2015 02:00:00 AM,48,-122,2,1,3
25731,FremontBridge,09/10/2015 03:00:00 AM,48,-122,2,4,6
25732,FremontBridge,09/10/2015 04:00:00 AM,48,-122,2,5,7
25733,FremontBridge,09/10/2015 05:00:00 AM,48,-122,12,21,33
25734,FremontBridge,09/10/2015 06:00:00 AM,48,-122,54,123,177
25735,FremontBridge,09/10/2015 07:00:00 AM,48,-122,133,280,413
25736,FremontBridge,09/10/2015 08:00:00 AM,48,-122,191,348,539
25737,FremontBridge,09/10/2015 09:00:00 AM,48,-122,109,146,255
25738,FremontBridge,09/10/2015 10:00:00 AM,48,-122,44,69,113
25739,FremontBridge,09/10/2015 11:00:00 AM,48,-122,53,46,99
25740,FremontBridge,09/10/2015 12:00:00 PM,48,-122,54,51,105
25741,FremontBridge,09/10/2015 01:00:00 PM,48,-122,50,59,109
25742,FremontBridge,09/10/2015 02:00:00 PM,48,-122,64,53,117
25743,FremontBridge,09/10/2015 03:00:00 PM,48,-122,76,78,154
25744,FremontBridge,09/10/2015 04:00:00 PM,48,-122,209,121,330
25745,FremontBridge,09/10/2015 05:00:00 PM,48,-122,427,191,618
25746,FremontBridge,09/10/2015 06:00:00 PM,48,-122,277,151,428
25747,FremontBridge,09/10/2015 07:00:00 PM,48,-122,149,91,240
25748,FremontBridge,09/10/2015 08:00:00 PM,48,-122,63,44,107
25749,FremontBridge,09/10/2015 09:00:00 PM,48,-122,49,41,90
25750,FremontBridge,09/10/2015 10:00:00 PM,48,-122,20,19,39
25751,FremontBridge,09/10/2015 11:00:00 PM,48,-122,20,8,28
25752,FremontBridge,09/11/2015 12:00:00 AM,48,-122,5,8,13
25753,FremontBridge,09/11/2015 01:00:00 AM,48,-122,2,1,3
25754,FremontBridge,09/11/2015 02:00:00 AM,48,-122,4,0,4
25755,FremontBridge,09/11/2015 03:00:00 AM,48,-122,1,3,4
25756,FremontBridge,09/11/2015 04:00:00 AM,48,-122,2,3,5
25757,FremontBridge,09/11/2015 05:00:00 AM,48,-122,11,27,38
25758,FremontBridge,09/11/2015 06:00:00 AM,48,-122,39,79,118
25759,FremontBridge,09/11/2015 07:00:00 AM,48,-122,117,262,379
25760,FremontBridge,09/11/2015 08:00:00 AM,48,-122,149,347,496
25761,FremontBridge,09/11/2015 09:00:00 AM,48,-122,118,168,286
25762,FremontBridge,09/11/2015 10:00:00 AM,48,-122,51,72,123
25763,FremontBridge,09/11/2015 11:00:00 AM,48,-122,61,52,113
25764,FremontBridge,09/11/2015 12:00:00 PM,48,-122,47,43,90
25765,FremontBridge,09/11/2015 01:00:00 PM,48,-122,43,47,90
25766,FremontBridge,09/11/2015 02:00:00 PM,48,-122,74,58,132
25767,FremontBridge,09/11/2015 03:00:00 PM,48,-122,87,74,161
25768,FremontBridge,09/11/2015 04:00:00 PM,48,-122,223,128,351
25769,FremontBridge,09/11/2015 05:00:00 PM,48,-122,404,186,590
25770,FremontBridge,09/11/2015 06:00:00 PM,48,-122,226,134,360
25771,FremontBridge,09/11/2015 07:00:00 PM,48,-122,102,68,170
25772,FremontBridge,09/11/2015 08:00:00 PM,48,-122,53,48,101
25773,FremontBridge,09/11/2015 09:00:00 PM,48,-122,31,23,54
25774,FremontBridge,09/11/2015 10:00:00 PM,48,-122,21,15,36
25775,FremontBridge,09/11/2015 11:00:00 PM,48,-122,27,17,44
25776,FremontBridge,09/12/2015 12:00:00 AM,48,-122,11,7,18
25777,FremontBridge,09/12/2015 01:00:00 AM,48,-122,5,3,8
25778,FremontBridge,09/12/2015 02:00:00 AM,48,-122,5,5,10
25779,FremontBridge,09/12/2015 03:00:00 AM,48,-122,3,2,5
25780,FremontBridge,09/12/2015 04:00:00 AM,48,-122,3,3,6
25781,FremontBridge,09/12/2015 05:00:00 AM,48,-122,7,6,13
25782,FremontBridge,09/12/2015 06:00:00 AM,48,-122,8,5,13
25783,FremontBridge,09/12/2015 07:00:00 AM,48,-122,33,28,61
25784,FremontBridge,09/12/2015 08:00:00 AM,48,-122,51,37,88
25785,FremontBridge,09/12/2015 09:00:00 AM,48,-122,64,73,137
25786,FremontBridge,09/12/2015 10:00:00 AM,48,-122,46,71,117
25787,FremontBridge,09/12/2015 11:00:00 AM,48,-122,77,99,176
25788,FremontBridge,09/12/2015 12:00:00 PM,48,-122,86,102,188
25789,FremontBridge,09/12/2015 01:00:00 PM,48,-122,67,120,187
25790,FremontBridge,09/12/2015 02:00:00 PM,48,-122,99,131,230
25791,FremontBridge,09/12/2015 03:00:00 PM,48,-122,88,117,205
25792,FremontBridge,09/12/2015 04:00:00 PM,48,-122,82,73,155
25793,FremontBridge,09/12/2015 05:00:00 PM,48,-122,99,84,183
25794,FremontBridge,09/12/2015 06:00:00 PM,48,-122,56,83,139
25795,FremontBridge,09/12/2015 07:00:00 PM,48,-122,34,61,95
25796,FremontBridge,09/12/2015 08:00:00 PM,48,-122,32,30,62
25797,FremontBridge,09/12/2015 09:00:00 PM,48,-122,30,22,52
25798,FremontBridge,09/12/2015 10:00:00 PM,48,-122,15,11,26
25799,FremontBridge,09/12/2015 11:00:00 PM,48,-122,12,5,17
25800,FremontBridge,09/13/2015 12:00:00 AM,48,-122,9,8,17
25801,FremontBridge,09/13/2015 01:00:00 AM,48,-122,4,2,6
25802,FremontBridge,09/13/2015 02:00:00 AM,48,-122,10,3,13
25803,FremontBridge,09/13/2015 03:00:00 AM,48,-122,1,2,3
25804,FremontBridge,09/13/2015 04:00:00 AM,48,-122,0,2,2
25805,FremontBridge,09/13/2015 05:00:00 AM,48,-122,3,4,7
25806,FremontBridge,09/13/2015 06:00:00 AM,48,-122,8,13,21
25807,FremontBridge,09/13/2015 07:00:00 AM,48,-122,13,8,21
25808,FremontBridge,09/13/2015 08:00:00 AM,48,-122,29,27,56
25809,FremontBridge,09/13/2015 09:00:00 AM,48,-122,184,41,225
25810,FremontBridge,09/13/2015 10:00:00 AM,48,-122,62,33,95
25811,FremontBridge,09/13/2015 11:00:00 AM,48,-122,28,24,52
25812,FremontBridge,09/13/2015 12:00:00 PM,48,-122,23,92,115
25813,FremontBridge,09/13/2015 01:00:00 PM,48,-122,23,80,103
25814,FremontBridge,09/13/2015 02:00:00 PM,48,-122,53,60,113
25815,FremontBridge,09/13/2015 03:00:00 PM,48,-122,46,63,109
25816,FremontBridge,09/13/2015 04:00:00 PM,48,-122,53,49,102
25817,FremontBridge,09/13/2015 05:00:00 PM,48,-122,32,50,82
25818,FremontBridge,09/13/2015 06:00:00 PM,48,-122,36,43,79
25819,FremontBridge,09/13/2015 07:00:00 PM,48,-122,22,21,43
25820,FremontBridge,09/13/2015 08:00:00 PM,48,-122,20,8,28
25821,FremontBridge,09/13/2015 09:00:00 PM,48,-122,11,6,17
25822,FremontBridge,09/13/2015 10:00:00 PM,48,-122,6,6,12
25823,FremontBridge,09/13/2015 11:00:00 PM,48,-122,3,3,6
25824,FremontBridge,09/14/2015 12:00:00 AM,48,-122,2,6,8
25825,FremontBridge,09/14/2015 01:00:00 AM,48,-122,3,0,3
25826,FremontBridge,09/14/2015 02:00:00 AM,48,-122,1,2,3
25827,FremontBridge,09/14/2015 03:00:00 AM,48,-122,2,2,4
25828,FremontBridge,09/14/2015 04:00:00 AM,48,-122,0,6,6
25829,FremontBridge,09/14/2015 05:00:00 AM,48,-122,9,21,30
25830,FremontBridge,09/14/2015 06:00:00 AM,48,-122,38,102,140
25831,FremontBridge,09/14/2015 07:00:00 AM,48,-122,123,250,373
25832,FremontBridge,09/14/2015 08:00:00 AM,48,-122,154,317,471
25833,FremontBridge,09/14/2015 09:00:00 AM,48,-122,85,141,226
25834,FremontBridge,09/14/2015 10:00:00 AM,48,-122,46,53,99
25835,FremontBridge,09/14/2015 11:00:00 AM,48,-122,26,27,53
25836,FremontBridge,09/14/2015 12:00:00 PM,48,-122,23,25,48
25837,FremontBridge,09/14/2015 01:00:00 PM,48,-122,27,37,64
25838,FremontBridge,09/14/2015 02:00:00 PM,48,-122,45,41,86
25839,FremontBridge,09/14/2015 03:00:00 PM,48,-122,86,54,140
25840,FremontBridge,09/14/2015 04:00:00 PM,48,-122,164,111,275
25841,FremontBridge,09/14/2015 05:00:00 PM,48,-122,414,164,578
25842,FremontBridge,09/14/2015 06:00:00 PM,48,-122,229,122,351
25843,FremontBridge,09/14/2015 07:00:00 PM,48,-122,101,61,162
25844,FremontBridge,09/14/2015 08:00:00 PM,48,-122,47,34,81
25845,FremontBridge,09/14/2015 09:00:00 PM,48,-122,21,19,40
25846,FremontBridge,09/14/2015 10:00:00 PM,48,-122,14,12,26
25847,FremontBridge,09/14/2015 11:00:00 PM,48,-122,9,8,17
25848,FremontBridge,09/15/2015 12:00:00 AM,48,-122,9,4,13
25849,FremontBridge,09/15/2015 01:00:00 AM,48,-122,1,4,5
25850,FremontBridge,09/15/2015 02:00:00 AM,48,-122,2,1,3
25851,FremontBridge,09/15/2015 03:00:00 AM,48,-122,3,2,5
25852,FremontBridge,09/15/2015 04:00:00 AM,48,-122,2,7,9
25853,FremontBridge,09/15/2015 05:00:00 AM,48,-122,21,18,39
25854,FremontBridge,09/15/2015 06:00:00 AM,48,-122,48,100,148
25855,FremontBridge,09/15/2015 07:00:00 AM,48,-122,115,272,387
25856,FremontBridge,09/15/2015 08:00:00 AM,48,-122,170,341,511
25857,FremontBridge,09/15/2015 09:00:00 AM,48,-122,99,144,243
25858,FremontBridge,09/15/2015 10:00:00 AM,48,-122,35,60,95
25859,FremontBridge,09/15/2015 11:00:00 AM,48,-122,41,46,87
25860,FremontBridge,09/15/2015 12:00:00 PM,48,-122,33,37,70
25861,FremontBridge,09/15/2015 01:00:00 PM,48,-122,41,59,100
25862,FremontBridge,09/15/2015 02:00:00 PM,48,-122,51,55,106
25863,FremontBridge,09/15/2015 03:00:00 PM,48,-122,81,55,136
25864,FremontBridge,09/15/2015 04:00:00 PM,48,-122,198,130,328
25865,FremontBridge,09/15/2015 05:00:00 PM,48,-122,413,162,575
25866,FremontBridge,09/15/2015 06:00:00 PM,48,-122,253,130,383
25867,FremontBridge,09/15/2015 07:00:00 PM,48,-122,111,71,182
25868,FremontBridge,09/15/2015 08:00:00 PM,48,-122,52,37,89
25869,FremontBridge,09/15/2015 09:00:00 PM,48,-122,43,33,76
25870,FremontBridge,09/15/2015 10:00:00 PM,48,-122,29,13,42
25871,FremontBridge,09/15/2015 11:00:00 PM,48,-122,11,14,25
25872,FremontBridge,09/16/2015 12:00:00 AM,48,-122,5,6,11
25873,FremontBridge,09/16/2015 01:00:00 AM,48,-122,0,1,1
25874,FremontBridge,09/16/2015 02:00:00 AM,48,-122,1,2,3
25875,FremontBridge,09/16/2015 03:00:00 AM,48,-122,0,2,2
25876,FremontBridge,09/16/2015 04:00:00 AM,48,-122,5,3,8
25877,FremontBridge,09/16/2015 05:00:00 AM,48,-122,13,22,35
25878,FremontBridge,09/16/2015 06:00:00 AM,48,-122,43,92,135
25879,FremontBridge,09/16/2015 07:00:00 AM,48,-122,123,252,375
25880,FremontBridge,09/16/2015 08:00:00 AM,48,-122,178,344,522
25881,FremontBridge,09/16/2015 09:00:00 AM,48,-122,92,155,247
25882,FremontBridge,09/16/2015 10:00:00 AM,48,-122,44,54,98
25883,FremontBridge,09/16/2015 11:00:00 AM,48,-122,38,62,100
25884,FremontBridge,09/16/2015 12:00:00 PM,48,-122,54,50,104
25885,FremontBridge,09/16/2015 01:00:00 PM,48,-122,56,59,115
25886,FremontBridge,09/16/2015 02:00:00 PM,48,-122,61,45,106
25887,FremontBridge,09/16/2015 03:00:00 PM,48,-122,77,59,136
25888,FremontBridge,09/16/2015 04:00:00 PM,48,-122,205,134,339
25889,FremontBridge,09/16/2015 05:00:00 PM,48,-122,423,160,583
25890,FremontBridge,09/16/2015 06:00:00 PM,48,-122,274,133,407
25891,FremontBridge,09/16/2015 07:00:00 PM,48,-122,112,55,167
25892,FremontBridge,09/16/2015 08:00:00 PM,48,-122,69,48,117
25893,FremontBridge,09/16/2015 09:00:00 PM,48,-122,33,23,56
25894,FremontBridge,09/16/2015 10:00:00 PM,48,-122,30,9,39
25895,FremontBridge,09/16/2015 11:00:00 PM,48,-122,13,12,25
25896,FremontBridge,09/17/2015 12:00:00 AM,48,-122,7,4,11
25897,FremontBridge,09/17/2015 01:00:00 AM,48,-122,6,3,9
25898,FremontBridge,09/17/2015 02:00:00 AM,48,-122,1,1,2
25899,FremontBridge,09/17/2015 03:00:00 AM,48,-122,0,3,3
25900,FremontBridge,09/17/2015 04:00:00 AM,48,-122,6,4,10
25901,FremontBridge,09/17/2015 05:00:00 AM,48,-122,10,24,34
25902,FremontBridge,09/17/2015 06:00:00 AM,48,-122,35,71,106
25903,FremontBridge,09/17/2015 07:00:00 AM,48,-122,95,212,307
25904,FremontBridge,09/17/2015 08:00:00 AM,48,-122,138,231,369
25905,FremontBridge,09/17/2015 09:00:00 AM,48,-122,74,116,190
25906,FremontBridge,09/17/2015 10:00:00 AM,48,-122,43,53,96
25907,FremontBridge,09/17/2015 11:00:00 AM,48,-122,16,25,41
25908,FremontBridge,09/17/2015 12:00:00 PM,48,-122,18,22,40
25909,FremontBridge,09/17/2015 01:00:00 PM,48,-122,34,30,64
25910,FremontBridge,09/17/2015 02:00:00 PM,48,-122,34,25,59
25911,FremontBridge,09/17/2015 03:00:00 PM,48,-122,56,34,90
25912,FremontBridge,09/17/2015 04:00:00 PM,48,-122,105,56,161
25913,FremontBridge,09/17/2015 05:00:00 PM,48,-122,307,91,398
25914,FremontBridge,09/17/2015 06:00:00 PM,48,-122,159,69,228
25915,FremontBridge,09/17/2015 07:00:00 PM,48,-122,83,37,120
25916,FremontBridge,09/17/2015 08:00:00 PM,48,-122,26,21,47
25917,FremontBridge,09/17/2015 09:00:00 PM,48,-122,19,16,35
25918,FremontBridge,09/17/2015 10:00:00 PM,48,-122,13,7,20
25919,FremontBridge,09/17/2015 11:00:00 PM,48,-122,8,5,13
25920,FremontBridge,09/18/2015 12:00:00 AM,48,-122,12,8,20
25921,FremontBridge,09/18/2015 01:00:00 AM,48,-122,1,0,1
25922,FremontBridge,09/18/2015 02:00:00 AM,48,-122,2,0,2
25923,FremontBridge,09/18/2015 03:00:00 AM,48,-122,0,4,4
25924,FremontBridge,09/18/2015 04:00:00 AM,48,-122,3,6,9
25925,FremontBridge,09/18/2015 05:00:00 AM,48,-122,9,25,34
25926,FremontBridge,09/18/2015 06:00:00 AM,48,-122,32,78,110
25927,FremontBridge,09/18/2015 07:00:00 AM,48,-122,89,219,308
25928,FremontBridge,09/18/2015 08:00:00 AM,48,-122,134,236,370
25929,FremontBridge,09/18/2015 09:00:00 AM,48,-122,91,133,224
25930,FremontBridge,09/18/2015 10:00:00 AM,48,-122,36,51,87
25931,FremontBridge,09/18/2015 11:00:00 AM,48,-122,42,40,82
25932,FremontBridge,09/18/2015 12:00:00 PM,48,-122,46,49,95
25933,FremontBridge,09/18/2015 01:00:00 PM,48,-122,50,26,76
25934,FremontBridge,09/18/2015 02:00:00 PM,48,-122,54,61,115
25935,FremontBridge,09/18/2015 03:00:00 PM,48,-122,78,60,138
25936,FremontBridge,09/18/2015 04:00:00 PM,48,-122,169,113,282
25937,FremontBridge,09/18/2015 05:00:00 PM,48,-122,337,163,500
25938,FremontBridge,09/18/2015 06:00:00 PM,48,-122,173,79,252
25939,FremontBridge,09/18/2015 07:00:00 PM,48,-122,91,44,135
25940,FremontBridge,09/18/2015 08:00:00 PM,48,-122,28,17,45
25941,FremontBridge,09/18/2015 09:00:00 PM,48,-122,22,14,36
25942,FremontBridge,09/18/2015 10:00:00 PM,48,-122,21,20,41
25943,FremontBridge,09/18/2015 11:00:00 PM,48,-122,19,15,34
25944,FremontBridge,09/19/2015 12:00:00 AM,48,-122,13,5,18
25945,FremontBridge,09/19/2015 01:00:00 AM,48,-122,2,5,7
25946,FremontBridge,09/19/2015 02:00:00 AM,48,-122,11,7,18
25947,FremontBridge,09/19/2015 03:00:00 AM,48,-122,1,0,1
25948,FremontBridge,09/19/2015 04:00:00 AM,48,-122,1,3,4
25949,FremontBridge,09/19/2015 05:00:00 AM,48,-122,4,10,14
25950,FremontBridge,09/19/2015 06:00:00 AM,48,-122,10,14,24
25951,FremontBridge,09/19/2015 07:00:00 AM,48,-122,22,24,46
25952,FremontBridge,09/19/2015 08:00:00 AM,48,-122,36,30,66
25953,FremontBridge,09/19/2015 09:00:00 AM,48,-122,40,52,92
25954,FremontBridge,09/19/2015 10:00:00 AM,48,-122,52,65,117
25955,FremontBridge,09/19/2015 11:00:00 AM,48,-122,67,67,134
25956,FremontBridge,09/19/2015 12:00:00 PM,48,-122,75,62,137
25957,FremontBridge,09/19/2015 01:00:00 PM,48,-122,57,78,135
25958,FremontBridge,09/19/2015 02:00:00 PM,48,-122,59,87,146
25959,FremontBridge,09/19/2015 03:00:00 PM,48,-122,86,89,175
25960,FremontBridge,09/19/2015 04:00:00 PM,48,-122,84,97,181
25961,FremontBridge,09/19/2015 05:00:00 PM,48,-122,69,87,156
25962,FremontBridge,09/19/2015 06:00:00 PM,48,-122,68,71,139
25963,FremontBridge,09/19/2015 07:00:00 PM,48,-122,32,48,80
25964,FremontBridge,09/19/2015 08:00:00 PM,48,-122,22,26,48
25965,FremontBridge,09/19/2015 09:00:00 PM,48,-122,20,22,42
25966,FremontBridge,09/19/2015 10:00:00 PM,48,-122,10,17,27
25967,FremontBridge,09/19/2015 11:00:00 PM,48,-122,12,15,27
25968,FremontBridge,09/20/2015 12:00:00 AM,48,-122,8,12,20
25969,FremontBridge,09/20/2015 01:00:00 AM,48,-122,6,8,14
25970,FremontBridge,09/20/2015 02:00:00 AM,48,-122,5,5,10
25971,FremontBridge,09/20/2015 03:00:00 AM,48,-122,1,3,4
25972,FremontBridge,09/20/2015 04:00:00 AM,48,-122,1,3,4
25973,FremontBridge,09/20/2015 05:00:00 AM,48,-122,1,5,6
25974,FremontBridge,09/20/2015 06:00:00 AM,48,-122,5,11,16
25975,FremontBridge,09/20/2015 07:00:00 AM,48,-122,5,9,14
25976,FremontBridge,09/20/2015 08:00:00 AM,48,-122,21,29,50
25977,FremontBridge,09/20/2015 09:00:00 AM,48,-122,31,44,75
25978,FremontBridge,09/20/2015 10:00:00 AM,48,-122,31,65,96
25979,FremontBridge,09/20/2015 11:00:00 AM,48,-122,61,52,113
25980,FremontBridge,09/20/2015 12:00:00 PM,48,-122,48,44,92
25981,FremontBridge,09/20/2015 01:00:00 PM,48,-122,69,63,132
25982,FremontBridge,09/20/2015 02:00:00 PM,48,-122,61,84,145
25983,FremontBridge,09/20/2015 03:00:00 PM,48,-122,60,71,131
25984,FremontBridge,09/20/2015 04:00:00 PM,48,-122,49,63,112
25985,FremontBridge,09/20/2015 05:00:00 PM,48,-122,47,49,96
25986,FremontBridge,09/20/2015 06:00:00 PM,48,-122,34,38,72
25987,FremontBridge,09/20/2015 07:00:00 PM,48,-122,16,22,38
25988,FremontBridge,09/20/2015 08:00:00 PM,48,-122,10,9,19
25989,FremontBridge,09/20/2015 09:00:00 PM,48,-122,8,9,17
25990,FremontBridge,09/20/2015 10:00:00 PM,48,-122,8,8,16
25991,FremontBridge,09/20/2015 11:00:00 PM,48,-122,5,6,11
25992,FremontBridge,09/21/2015 12:00:00 AM,48,-122,2,1,3
25993,FremontBridge,09/21/2015 01:00:00 AM,48,-122,2,1,3
25994,FremontBridge,09/21/2015 02:00:00 AM,48,-122,0,0,0
25995,FremontBridge,09/21/2015 03:00:00 AM,48,-122,0,4,4
25996,FremontBridge,09/21/2015 04:00:00 AM,48,-122,3,6,9
25997,FremontBridge,09/21/2015 05:00:00 AM,48,-122,17,28,45
25998,FremontBridge,09/21/2015 06:00:00 AM,48,-122,45,92,137
25999,FremontBridge,09/21/2015 07:00:00 AM,48,-122,127,260,387
26000,FremontBridge,09/21/2015 08:00:00 AM,48,-122,195,338,533
26001,FremontBridge,09/21/2015 09:00:00 AM,48,-122,89,159,248
26002,FremontBridge,09/21/2015 10:00:00 AM,48,-122,36,56,92
26003,FremontBridge,09/21/2015 11:00:00 AM,48,-122,37,54,91
26004,FremontBridge,09/21/2015 12:00:00 PM,48,-122,50,54,104
26005,FremontBridge,09/21/2015 01:00:00 PM,48,-122,57,39,96
26006,FremontBridge,09/21/2015 02:00:00 PM,48,-122,61,52,113
26007,FremontBridge,09/21/2015 03:00:00 PM,48,-122,99,67,166
26008,FremontBridge,09/21/2015 04:00:00 PM,48,-122,196,113,309
26009,FremontBridge,09/21/2015 05:00:00 PM,48,-122,465,190,655
26010,FremontBridge,09/21/2015 06:00:00 PM,48,-122,286,161,447
26011,FremontBridge,09/21/2015 07:00:00 PM,48,-122,111,59,170
26012,FremontBridge,09/21/2015 08:00:00 PM,48,-122,48,42,90
26013,FremontBridge,09/21/2015 09:00:00 PM,48,-122,30,21,51
26014,FremontBridge,09/21/2015 10:00:00 PM,48,-122,15,18,33
26015,FremontBridge,09/21/2015 11:00:00 PM,48,-122,10,9,19
26016,FremontBridge,09/22/2015 12:00:00 AM,48,-122,3,7,10
26017,FremontBridge,09/22/2015 01:00:00 AM,48,-122,7,2,9
26018,FremontBridge,09/22/2015 02:00:00 AM,48,-122,1,1,2
26019,FremontBridge,09/22/2015 03:00:00 AM,48,-122,3,5,8
26020,FremontBridge,09/22/2015 04:00:00 AM,48,-122,4,2,6
26021,FremontBridge,09/22/2015 05:00:00 AM,48,-122,24,27,51
26022,FremontBridge,09/22/2015 06:00:00 AM,48,-122,60,97,157
26023,FremontBridge,09/22/2015 07:00:00 AM,48,-122,134,365,499
26024,FremontBridge,09/22/2015 08:00:00 AM,48,-122,210,420,630
26025,FremontBridge,09/22/2015 09:00:00 AM,48,-122,124,210,334
26026,FremontBridge,09/22/2015 10:00:00 AM,48,-122,59,69,128
26027,FremontBridge,09/22/2015 11:00:00 AM,48,-122,38,50,88
26028,FremontBridge,09/22/2015 12:00:00 PM,48,-122,44,71,115
26029,FremontBridge,09/22/2015 01:00:00 PM,48,-122,55,45,100
26030,FremontBridge,09/22/2015 02:00:00 PM,48,-122,81,60,141
26031,FremontBridge,09/22/2015 03:00:00 PM,48,-122,96,67,163
26032,FremontBridge,09/22/2015 04:00:00 PM,48,-122,244,126,370
26033,FremontBridge,09/22/2015 05:00:00 PM,48,-122,541,239,780
26034,FremontBridge,09/22/2015 06:00:00 PM,48,-122,327,154,481
26035,FremontBridge,09/22/2015 07:00:00 PM,48,-122,162,81,243
26036,FremontBridge,09/22/2015 08:00:00 PM,48,-122,71,36,107
26037,FremontBridge,09/22/2015 09:00:00 PM,48,-122,34,24,58
26038,FremontBridge,09/22/2015 10:00:00 PM,48,-122,26,17,43
26039,FremontBridge,09/22/2015 11:00:00 PM,48,-122,13,15,28
26040,FremontBridge,09/23/2015 12:00:00 AM,48,-122,7,7,14
26041,FremontBridge,09/23/2015 01:00:00 AM,48,-122,1,5,6
26042,FremontBridge,09/23/2015 02:00:00 AM,48,-122,1,2,3
26043,FremontBridge,09/23/2015 03:00:00 AM,48,-122,0,3,3
26044,FremontBridge,09/23/2015 04:00:00 AM,48,-122,5,12,17
26045,FremontBridge,09/23/2015 05:00:00 AM,48,-122,11,29,40
26046,FremontBridge,09/23/2015 06:00:00 AM,48,-122,60,97,157
26047,FremontBridge,09/23/2015 07:00:00 AM,48,-122,145,341,486
26048,FremontBridge,09/23/2015 08:00:00 AM,48,-122,201,424,625
26049,FremontBridge,09/23/2015 09:00:00 AM,48,-122,110,210,320
26050,FremontBridge,09/23/2015 10:00:00 AM,48,-122,58,58,116
26051,FremontBridge,09/23/2015 11:00:00 AM,48,-122,47,47,94
26052,FremontBridge,09/23/2015 12:00:00 PM,48,-122,52,69,121
26053,FremontBridge,09/23/2015 01:00:00 PM,48,-122,53,60,113
26054,FremontBridge,09/23/2015 02:00:00 PM,48,-122,65,78,143
26055,FremontBridge,09/23/2015 03:00:00 PM,48,-122,92,83,175
26056,FremontBridge,09/23/2015 04:00:00 PM,48,-122,249,149,398
26057,FremontBridge,09/23/2015 05:00:00 PM,48,-122,531,250,781
26058,FremontBridge,09/23/2015 06:00:00 PM,48,-122,306,154,460
26059,FremontBridge,09/23/2015 07:00:00 PM,48,-122,137,69,206
26060,FremontBridge,09/23/2015 08:00:00 PM,48,-122,66,43,109
26061,FremontBridge,09/23/2015 09:00:00 PM,48,-122,58,34,92
26062,FremontBridge,09/23/2015 10:00:00 PM,48,-122,26,31,57
26063,FremontBridge,09/23/2015 11:00:00 PM,48,-122,11,15,26
26064,FremontBridge,09/24/2015 12:00:00 AM,48,-122,5,10,15
26065,FremontBridge,09/24/2015 01:00:00 AM,48,-122,4,4,8
26066,FremontBridge,09/24/2015 02:00:00 AM,48,-122,2,1,3
26067,FremontBridge,09/24/2015 03:00:00 AM,48,-122,0,2,2
26068,FremontBridge,09/24/2015 04:00:00 AM,48,-122,7,7,14
26069,FremontBridge,09/24/2015 05:00:00 AM,48,-122,15,24,39
26070,FremontBridge,09/24/2015 06:00:00 AM,48,-122,47,115,162
26071,FremontBridge,09/24/2015 07:00:00 AM,48,-122,117,253,370
26072,FremontBridge,09/24/2015 08:00:00 AM,48,-122,180,386,566
26073,FremontBridge,09/24/2015 09:00:00 AM,48,-122,106,203,309
26074,FremontBridge,09/24/2015 10:00:00 AM,48,-122,51,71,122
26075,FremontBridge,09/24/2015 11:00:00 AM,48,-122,40,54,94
26076,FremontBridge,09/24/2015 12:00:00 PM,48,-122,53,73,126
26077,FremontBridge,09/24/2015 01:00:00 PM,48,-122,65,69,134
26078,FremontBridge,09/24/2015 02:00:00 PM,48,-122,85,60,145
26079,FremontBridge,09/24/2015 03:00:00 PM,48,-122,100,69,169
26080,FremontBridge,09/24/2015 04:00:00 PM,48,-122,234,134,368
26081,FremontBridge,09/24/2015 05:00:00 PM,48,-122,463,207,670
26082,FremontBridge,09/24/2015 06:00:00 PM,48,-122,361,167,528
26083,FremontBridge,09/24/2015 07:00:00 PM,48,-122,142,76,218
26084,FremontBridge,09/24/2015 08:00:00 PM,48,-122,63,36,99
26085,FremontBridge,09/24/2015 09:00:00 PM,48,-122,45,31,76
26086,FremontBridge,09/24/2015 10:00:00 PM,48,-122,34,24,58
26087,FremontBridge,09/24/2015 11:00:00 PM,48,-122,16,10,26
26088,FremontBridge,09/25/2015 12:00:00 AM,48,-122,8,10,18
26089,FremontBridge,09/25/2015 01:00:00 AM,48,-122,5,2,7
26090,FremontBridge,09/25/2015 02:00:00 AM,48,-122,1,0,1
26091,FremontBridge,09/25/2015 03:00:00 AM,48,-122,0,3,3
26092,FremontBridge,09/25/2015 04:00:00 AM,48,-122,4,5,9
26093,FremontBridge,09/25/2015 05:00:00 AM,48,-122,13,26,39
26094,FremontBridge,09/25/2015 06:00:00 AM,48,-122,28,80,108
26095,FremontBridge,09/25/2015 07:00:00 AM,48,-122,83,204,287
26096,FremontBridge,09/25/2015 08:00:00 AM,48,-122,112,236,348
26097,FremontBridge,09/25/2015 09:00:00 AM,48,-122,89,119,208
26098,FremontBridge,09/25/2015 10:00:00 AM,48,-122,35,45,80
26099,FremontBridge,09/25/2015 11:00:00 AM,48,-122,33,28,61
26100,FremontBridge,09/25/2015 12:00:00 PM,48,-122,35,35,70
26101,FremontBridge,09/25/2015 01:00:00 PM,48,-122,35,29,64
26102,FremontBridge,09/25/2015 02:00:00 PM,48,-122,56,38,94
26103,FremontBridge,09/25/2015 03:00:00 PM,48,-122,73,46,119
26104,FremontBridge,09/25/2015 04:00:00 PM,48,-122,140,72,212
26105,FremontBridge,09/25/2015 05:00:00 PM,48,-122,305,127,432
26106,FremontBridge,09/25/2015 06:00:00 PM,48,-122,173,84,257
26107,FremontBridge,09/25/2015 07:00:00 PM,48,-122,63,47,110
26108,FremontBridge,09/25/2015 08:00:00 PM,48,-122,34,27,61
26109,FremontBridge,09/25/2015 09:00:00 PM,48,-122,23,23,46
26110,FremontBridge,09/25/2015 10:00:00 PM,48,-122,13,17,30
26111,FremontBridge,09/25/2015 11:00:00 PM,48,-122,9,11,20
26112,FremontBridge,09/26/2015 12:00:00 AM,48,-122,9,8,17
26113,FremontBridge,09/26/2015 01:00:00 AM,48,-122,3,3,6
26114,FremontBridge,09/26/2015 02:00:00 AM,48,-122,5,4,9
26115,FremontBridge,09/26/2015 03:00:00 AM,48,-122,3,1,4
26116,FremontBridge,09/26/2015 04:00:00 AM,48,-122,4,1,5
26117,FremontBridge,09/26/2015 05:00:00 AM,48,-122,6,6,12
26118,FremontBridge,09/26/2015 06:00:00 AM,48,-122,7,9,16
26119,FremontBridge,09/26/2015 07:00:00 AM,48,-122,26,20,46
26120,FremontBridge,09/26/2015 08:00:00 AM,48,-122,33,37,70
26121,FremontBridge,09/26/2015 09:00:00 AM,48,-122,48,59,107
26122,FremontBridge,09/26/2015 10:00:00 AM,48,-122,61,68,129
26123,FremontBridge,09/26/2015 11:00:00 AM,48,-122,70,75,145
26124,FremontBridge,09/26/2015 12:00:00 PM,48,-122,67,101,168
26125,FremontBridge,09/26/2015 01:00:00 PM,48,-122,71,54,125
26126,FremontBridge,09/26/2015 02:00:00 PM,48,-122,89,63,152
26127,FremontBridge,09/26/2015 03:00:00 PM,48,-122,70,95,165
26128,FremontBridge,09/26/2015 04:00:00 PM,48,-122,50,77,127
26129,FremontBridge,09/26/2015 05:00:00 PM,48,-122,80,65,145
26130,FremontBridge,09/26/2015 06:00:00 PM,48,-122,66,70,136
26131,FremontBridge,09/26/2015 07:00:00 PM,48,-122,38,41,79
26132,FremontBridge,09/26/2015 08:00:00 PM,48,-122,23,12,35
26133,FremontBridge,09/26/2015 09:00:00 PM,48,-122,19,14,33
26134,FremontBridge,09/26/2015 10:00:00 PM,48,-122,10,8,18
26135,FremontBridge,09/26/2015 11:00:00 PM,48,-122,11,8,19
26136,FremontBridge,09/27/2015 12:00:00 AM,48,-122,4,4,8
26137,FremontBridge,09/27/2015 01:00:00 AM,48,-122,8,4,12
26138,FremontBridge,09/27/2015 02:00:00 AM,48,-122,1,2,3
26139,FremontBridge,09/27/2015 03:00:00 AM,48,-122,2,4,6
26140,FremontBridge,09/27/2015 04:00:00 AM,48,-122,4,3,7
26141,FremontBridge,09/27/2015 05:00:00 AM,48,-122,3,11,14
26142,FremontBridge,09/27/2015 06:00:00 AM,48,-122,12,12,24
26143,FremontBridge,09/27/2015 07:00:00 AM,48,-122,12,21,33
26144,FremontBridge,09/27/2015 08:00:00 AM,48,-122,31,36,67
26145,FremontBridge,09/27/2015 09:00:00 AM,48,-122,30,51,81
26146,FremontBridge,09/27/2015 10:00:00 AM,48,-122,37,50,87
26147,FremontBridge,09/27/2015 11:00:00 AM,48,-122,57,76,133
26148,FremontBridge,09/27/2015 12:00:00 PM,48,-122,50,88,138
26149,FremontBridge,09/27/2015 01:00:00 PM,48,-122,87,90,177
26150,FremontBridge,09/27/2015 02:00:00 PM,48,-122,83,78,161
26151,FremontBridge,09/27/2015 03:00:00 PM,48,-122,57,76,133
26152,FremontBridge,09/27/2015 04:00:00 PM,48,-122,49,79,128
26153,FremontBridge,09/27/2015 05:00:00 PM,48,-122,54,83,137
26154,FremontBridge,09/27/2015 06:00:00 PM,48,-122,39,54,93
26155,FremontBridge,09/27/2015 07:00:00 PM,48,-122,17,29,46
26156,FremontBridge,09/27/2015 08:00:00 PM,48,-122,12,16,28
26157,FremontBridge,09/27/2015 09:00:00 PM,48,-122,6,16,22
26158,FremontBridge,09/27/2015 10:00:00 PM,48,-122,8,6,14
26159,FremontBridge,09/27/2015 11:00:00 PM,48,-122,13,6,19
26160,FremontBridge,09/28/2015 12:00:00 AM,48,-122,4,2,6
26161,FremontBridge,09/28/2015 01:00:00 AM,48,-122,3,1,4
26162,FremontBridge,09/28/2015 02:00:00 AM,48,-122,0,1,1
26163,FremontBridge,09/28/2015 03:00:00 AM,48,-122,1,2,3
26164,FremontBridge,09/28/2015 04:00:00 AM,48,-122,3,9,12
26165,FremontBridge,09/28/2015 05:00:00 AM,48,-122,15,24,39
26166,FremontBridge,09/28/2015 06:00:00 AM,48,-122,37,97,134
26167,FremontBridge,09/28/2015 07:00:00 AM,48,-122,124,290,414
26168,FremontBridge,09/28/2015 08:00:00 AM,48,-122,162,373,535
26169,FremontBridge,09/28/2015 09:00:00 AM,48,-122,107,177,284
26170,FremontBridge,09/28/2015 10:00:00 AM,48,-122,39,62,101
26171,FremontBridge,09/28/2015 11:00:00 AM,48,-122,39,37,76
26172,FremontBridge,09/28/2015 12:00:00 PM,48,-122,27,49,76
26173,FremontBridge,09/28/2015 01:00:00 PM,48,-122,57,52,109
26174,FremontBridge,09/28/2015 02:00:00 PM,48,-122,52,57,109
26175,FremontBridge,09/28/2015 03:00:00 PM,48,-122,78,66,144
26176,FremontBridge,09/28/2015 04:00:00 PM,48,-122,176,129,305
26177,FremontBridge,09/28/2015 05:00:00 PM,48,-122,490,191,681
26178,FremontBridge,09/28/2015 06:00:00 PM,48,-122,328,152,480
26179,FremontBridge,09/28/2015 07:00:00 PM,48,-122,98,52,150
26180,FremontBridge,09/28/2015 08:00:00 PM,48,-122,63,41,104
26181,FremontBridge,09/28/2015 09:00:00 PM,48,-122,26,21,47
26182,FremontBridge,09/28/2015 10:00:00 PM,48,-122,15,13,28
26183,FremontBridge,09/28/2015 11:00:00 PM,48,-122,11,9,20
26184,FremontBridge,09/29/2015 12:00:00 AM,48,-122,9,7,16
26185,FremontBridge,09/29/2015 01:00:00 AM,48,-122,1,3,4
26186,FremontBridge,09/29/2015 02:00:00 AM,48,-122,5,1,6
26187,FremontBridge,09/29/2015 03:00:00 AM,48,-122,0,1,1
26188,FremontBridge,09/29/2015 04:00:00 AM,48,-122,4,8,12
26189,FremontBridge,09/29/2015 05:00:00 AM,48,-122,21,24,45
26190,FremontBridge,09/29/2015 06:00:00 AM,48,-122,41,117,158
26191,FremontBridge,09/29/2015 07:00:00 AM,48,-122,128,319,447
26192,FremontBridge,09/29/2015 08:00:00 AM,48,-122,191,426,617
26193,FremontBridge,09/29/2015 09:00:00 AM,48,-122,117,178,295
26194,FremontBridge,09/29/2015 10:00:00 AM,48,-122,49,67,116
26195,FremontBridge,09/29/2015 11:00:00 AM,48,-122,48,45,93
26196,FremontBridge,09/29/2015 12:00:00 PM,48,-122,57,56,113
26197,FremontBridge,09/29/2015 01:00:00 PM,48,-122,63,58,121
26198,FremontBridge,09/29/2015 02:00:00 PM,48,-122,80,67,147
26199,FremontBridge,09/29/2015 03:00:00 PM,48,-122,87,70,157
26200,FremontBridge,09/29/2015 04:00:00 PM,48,-122,233,149,382
26201,FremontBridge,09/29/2015 05:00:00 PM,48,-122,517,171,688
26202,FremontBridge,09/29/2015 06:00:00 PM,48,-122,343,158,501
26203,FremontBridge,09/29/2015 07:00:00 PM,48,-122,106,84,190
26204,FremontBridge,09/29/2015 08:00:00 PM,48,-122,62,30,92
26205,FremontBridge,09/29/2015 09:00:00 PM,48,-122,36,37,73
26206,FremontBridge,09/29/2015 10:00:00 PM,48,-122,31,13,44
26207,FremontBridge,09/29/2015 11:00:00 PM,48,-122,10,8,18
26208,FremontBridge,09/30/2015 12:00:00 AM,48,-122,5,9,14
26209,FremontBridge,09/30/2015 01:00:00 AM,48,-122,2,7,9
26210,FremontBridge,09/30/2015 02:00:00 AM,48,-122,2,4,6
26211,FremontBridge,09/30/2015 03:00:00 AM,48,-122,1,3,4
26212,FremontBridge,09/30/2015 04:00:00 AM,48,-122,5,7,12
26213,FremontBridge,09/30/2015 05:00:00 AM,48,-122,15,30,45
26214,FremontBridge,09/30/2015 06:00:00 AM,48,-122,57,92,149
26215,FremontBridge,09/30/2015 07:00:00 AM,48,-122,126,291,417
26216,FremontBridge,09/30/2015 08:00:00 AM,48,-122,202,402,604
26217,FremontBridge,09/30/2015 09:00:00 AM,48,-122,100,167,267
26218,FremontBridge,09/30/2015 10:00:00 AM,48,-122,46,65,111
26219,FremontBridge,09/30/2015 11:00:00 AM,48,-122,27,36,63
26220,FremontBridge,09/30/2015 12:00:00 PM,48,-122,50,48,98
26221,FremontBridge,09/30/2015 01:00:00 PM,48,-122,45,51,96
26222,FremontBridge,09/30/2015 02:00:00 PM,48,-122,55,48,103
26223,FremontBridge,09/30/2015 03:00:00 PM,48,-122,84,66,150
26224,FremontBridge,09/30/2015 04:00:00 PM,48,-122,219,144,363
26225,FremontBridge,09/30/2015 05:00:00 PM,48,-122,476,189,665
26226,FremontBridge,09/30/2015 06:00:00 PM,48,-122,270,139,409
26227,FremontBridge,09/30/2015 07:00:00 PM,48,-122,132,84,216
26228,FremontBridge,09/30/2015 08:00:00 PM,48,-122,60,42,102
26229,FremontBridge,09/30/2015 09:00:00 PM,48,-122,51,34,85
26230,FremontBridge,09/30/2015 10:00:00 PM,48,-122,23,21,44
26231,FremontBridge,09/30/2015 11:00:00 PM,48,-122,10,13,23
26232,FremontBridge,10/01/2015 12:00:00 AM,48,-122,8,7,15
26233,FremontBridge,10/01/2015 01:00:00 AM,48,-122,1,2,3
26234,FremontBridge,10/01/2015 02:00:00 AM,48,-122,1,3,4
26235,FremontBridge,10/01/2015 03:00:00 AM,48,-122,1,1,2
26236,FremontBridge,10/01/2015 04:00:00 AM,48,-122,5,5,10
26237,FremontBridge,10/01/2015 05:00:00 AM,48,-122,16,26,42
26238,FremontBridge,10/01/2015 06:00:00 AM,48,-122,42,100,142
26239,FremontBridge,10/01/2015 07:00:00 AM,48,-122,123,255,378
26240,FremontBridge,10/01/2015 08:00:00 AM,48,-122,160,378,538
26241,FremontBridge,10/01/2015 09:00:00 AM,48,-122,110,187,297
26242,FremontBridge,10/01/2015 10:00:00 AM,48,-122,64,72,136
26243,FremontBridge,10/01/2015 11:00:00 AM,48,-122,49,53,102
26244,FremontBridge,10/01/2015 12:00:00 PM,48,-122,51,56,107
26245,FremontBridge,10/01/2015 01:00:00 PM,48,-122,55,55,110
26246,FremontBridge,10/01/2015 02:00:00 PM,48,-122,66,63,129
26247,FremontBridge,10/01/2015 03:00:00 PM,48,-122,103,73,176
26248,FremontBridge,10/01/2015 04:00:00 PM,48,-122,187,158,345
26249,FremontBridge,10/01/2015 05:00:00 PM,48,-122,479,201,680
26250,FremontBridge,10/01/2015 06:00:00 PM,48,-122,298,140,438
26251,FremontBridge,10/01/2015 07:00:00 PM,48,-122,127,69,196
26252,FremontBridge,10/01/2015 08:00:00 PM,48,-122,56,43,99
26253,FremontBridge,10/01/2015 09:00:00 PM,48,-122,33,41,74
26254,FremontBridge,10/01/2015 10:00:00 PM,48,-122,30,13,43
26255,FremontBridge,10/01/2015 11:00:00 PM,48,-122,14,21,35
26256,FremontBridge,10/02/2015 12:00:00 AM,48,-122,6,7,13
26257,FremontBridge,10/02/2015 01:00:00 AM,48,-122,5,4,9
26258,FremontBridge,10/02/2015 02:00:00 AM,48,-122,1,1,2
26259,FremontBridge,10/02/2015 03:00:00 AM,48,-122,2,0,2
26260,FremontBridge,10/02/2015 04:00:00 AM,48,-122,4,6,10
26261,FremontBridge,10/02/2015 05:00:00 AM,48,-122,11,18,29
26262,FremontBridge,10/02/2015 06:00:00 AM,48,-122,31,61,92
26263,FremontBridge,10/02/2015 07:00:00 AM,48,-122,99,201,300
26264,FremontBridge,10/02/2015 08:00:00 AM,48,-122,142,272,414
26265,FremontBridge,10/02/2015 09:00:00 AM,48,-122,87,153,240
26266,FremontBridge,10/02/2015 10:00:00 AM,48,-122,43,54,97
26267,FremontBridge,10/02/2015 11:00:00 AM,48,-122,33,52,85
26268,FremontBridge,10/02/2015 12:00:00 PM,48,-122,45,37,82
26269,FremontBridge,10/02/2015 01:00:00 PM,48,-122,43,54,97
26270,FremontBridge,10/02/2015 02:00:00 PM,48,-122,43,48,91
26271,FremontBridge,10/02/2015 03:00:00 PM,48,-122,102,50,152
26272,FremontBridge,10/02/2015 04:00:00 PM,48,-122,182,73,255
26273,FremontBridge,10/02/2015 05:00:00 PM,48,-122,337,149,486
26274,FremontBridge,10/02/2015 06:00:00 PM,48,-122,151,125,276
26275,FremontBridge,10/02/2015 07:00:00 PM,48,-122,79,46,125
26276,FremontBridge,10/02/2015 08:00:00 PM,48,-122,31,25,56
26277,FremontBridge,10/02/2015 09:00:00 PM,48,-122,20,12,32
26278,FremontBridge,10/02/2015 10:00:00 PM,48,-122,27,13,40
26279,FremontBridge,10/02/2015 11:00:00 PM,48,-122,16,16,32
26280,FremontBridge,10/03/2015 12:00:00 AM,48,-122,15,10,25
26281,FremontBridge,10/03/2015 01:00:00 AM,48,-122,9,5,14
26282,FremontBridge,10/03/2015 02:00:00 AM,48,-122,2,3,5
26283,FremontBridge,10/03/2015 03:00:00 AM,48,-122,2,3,5
26284,FremontBridge,10/03/2015 04:00:00 AM,48,-122,5,0,5
26285,FremontBridge,10/03/2015 05:00:00 AM,48,-122,4,5,9
26286,FremontBridge,10/03/2015 06:00:00 AM,48,-122,9,11,20
26287,FremontBridge,10/03/2015 07:00:00 AM,48,-122,14,23,37
26288,FremontBridge,10/03/2015 08:00:00 AM,48,-122,27,29,56
26289,FremontBridge,10/03/2015 09:00:00 AM,48,-122,35,43,78
26290,FremontBridge,10/03/2015 10:00:00 AM,48,-122,42,48,90
26291,FremontBridge,10/03/2015 11:00:00 AM,48,-122,61,71,132
26292,FremontBridge,10/03/2015 12:00:00 PM,48,-122,66,81,147
26293,FremontBridge,10/03/2015 01:00:00 PM,48,-122,81,81,162
26294,FremontBridge,10/03/2015 02:00:00 PM,48,-122,78,80,158
26295,FremontBridge,10/03/2015 03:00:00 PM,48,-122,94,96,190
26296,FremontBridge,10/03/2015 04:00:00 PM,48,-122,62,83,145
26297,FremontBridge,10/03/2015 05:00:00 PM,48,-122,63,62,125
26298,FremontBridge,10/03/2015 06:00:00 PM,48,-122,64,81,145
26299,FremontBridge,10/03/2015 07:00:00 PM,48,-122,31,46,77
26300,FremontBridge,10/03/2015 08:00:00 PM,48,-122,24,15,39
26301,FremontBridge,10/03/2015 09:00:00 PM,48,-122,13,10,23
26302,FremontBridge,10/03/2015 10:00:00 PM,48,-122,18,15,33
26303,FremontBridge,10/03/2015 11:00:00 PM,48,-122,9,10,19
26304,FremontBridge,10/04/2015 12:00:00 AM,48,-122,11,7,18
26305,FremontBridge,10/04/2015 01:00:00 AM,48,-122,9,5,14
26306,FremontBridge,10/04/2015 02:00:00 AM,48,-122,1,6,7
26307,FremontBridge,10/04/2015 03:00:00 AM,48,-122,2,2,4
26308,FremontBridge,10/04/2015 04:00:00 AM,48,-122,3,1,4
26309,FremontBridge,10/04/2015 05:00:00 AM,48,-122,3,3,6
26310,FremontBridge,10/04/2015 06:00:00 AM,48,-122,5,7,12
26311,FremontBridge,10/04/2015 07:00:00 AM,48,-122,7,23,30
26312,FremontBridge,10/04/2015 08:00:00 AM,48,-122,29,47,76
26313,FremontBridge,10/04/2015 09:00:00 AM,48,-122,57,68,125
26314,FremontBridge,10/04/2015 10:00:00 AM,48,-122,66,81,147
26315,FremontBridge,10/04/2015 11:00:00 AM,48,-122,66,88,154
26316,FremontBridge,10/04/2015 12:00:00 PM,48,-122,69,101,170
26317,FremontBridge,10/04/2015 01:00:00 PM,48,-122,90,105,195
26318,FremontBridge,10/04/2015 02:00:00 PM,48,-122,92,106,198
26319,FremontBridge,10/04/2015 03:00:00 PM,48,-122,94,111,205
26320,FremontBridge,10/04/2015 04:00:00 PM,48,-122,74,105,179
26321,FremontBridge,10/04/2015 05:00:00 PM,48,-122,73,97,170
26322,FremontBridge,10/04/2015 06:00:00 PM,48,-122,36,56,92
26323,FremontBridge,10/04/2015 07:00:00 PM,48,-122,17,26,43
26324,FremontBridge,10/04/2015 08:00:00 PM,48,-122,13,16,29
26325,FremontBridge,10/04/2015 09:00:00 PM,48,-122,36,22,58
26326,FremontBridge,10/04/2015 10:00:00 PM,48,-122,13,13,26
26327,FremontBridge,10/04/2015 11:00:00 PM,48,-122,9,4,13
26328,FremontBridge,10/05/2015 12:00:00 AM,48,-122,5,7,12
26329,FremontBridge,10/05/2015 01:00:00 AM,48,-122,2,1,3
26330,FremontBridge,10/05/2015 02:00:00 AM,48,-122,1,1,2
26331,FremontBridge,10/05/2015 03:00:00 AM,48,-122,1,2,3
26332,FremontBridge,10/05/2015 04:00:00 AM,48,-122,3,7,10
26333,FremontBridge,10/05/2015 05:00:00 AM,48,-122,11,27,38
26334,FremontBridge,10/05/2015 06:00:00 AM,48,-122,46,89,135
26335,FremontBridge,10/05/2015 07:00:00 AM,48,-122,122,298,420
26336,FremontBridge,10/05/2015 08:00:00 AM,48,-122,190,398,588
26337,FremontBridge,10/05/2015 09:00:00 AM,48,-122,118,167,285
26338,FremontBridge,10/05/2015 10:00:00 AM,48,-122,51,58,109
26339,FremontBridge,10/05/2015 11:00:00 AM,48,-122,53,50,103
26340,FremontBridge,10/05/2015 12:00:00 PM,48,-122,48,44,92
26341,FremontBridge,10/05/2015 01:00:00 PM,48,-122,44,49,93
26342,FremontBridge,10/05/2015 02:00:00 PM,48,-122,57,63,120
26343,FremontBridge,10/05/2015 03:00:00 PM,48,-122,121,89,210
26344,FremontBridge,10/05/2015 04:00:00 PM,48,-122,236,115,351
26345,FremontBridge,10/05/2015 05:00:00 PM,48,-122,499,215,714
26346,FremontBridge,10/05/2015 06:00:00 PM,48,-122,255,133,388
26347,FremontBridge,10/05/2015 07:00:00 PM,48,-122,84,67,151
26348,FremontBridge,10/05/2015 08:00:00 PM,48,-122,53,54,107
26349,FremontBridge,10/05/2015 09:00:00 PM,48,-122,35,31,66
26350,FremontBridge,10/05/2015 10:00:00 PM,48,-122,21,11,32
26351,FremontBridge,10/05/2015 11:00:00 PM,48,-122,11,10,21
26352,FremontBridge,10/06/2015 12:00:00 AM,48,-122,7,7,14
26353,FremontBridge,10/06/2015 01:00:00 AM,48,-122,7,3,10
26354,FremontBridge,10/06/2015 02:00:00 AM,48,-122,1,1,2
26355,FremontBridge,10/06/2015 03:00:00 AM,48,-122,0,4,4
26356,FremontBridge,10/06/2015 04:00:00 AM,48,-122,6,4,10
26357,FremontBridge,10/06/2015 05:00:00 AM,48,-122,16,34,50
26358,FremontBridge,10/06/2015 06:00:00 AM,48,-122,47,94,141
26359,FremontBridge,10/06/2015 07:00:00 AM,48,-122,152,305,457
26360,FremontBridge,10/06/2015 08:00:00 AM,48,-122,187,385,572
26361,FremontBridge,10/06/2015 09:00:00 AM,48,-122,104,165,269
26362,FremontBridge,10/06/2015 10:00:00 AM,48,-122,58,67,125
26363,FremontBridge,10/06/2015 11:00:00 AM,48,-122,32,56,88
26364,FremontBridge,10/06/2015 12:00:00 PM,48,-122,41,49,90
26365,FremontBridge,10/06/2015 01:00:00 PM,48,-122,43,42,85
26366,FremontBridge,10/06/2015 02:00:00 PM,48,-122,59,40,99
26367,FremontBridge,10/06/2015 03:00:00 PM,48,-122,73,68,141
26368,FremontBridge,10/06/2015 04:00:00 PM,48,-122,218,122,340
26369,FremontBridge,10/06/2015 05:00:00 PM,48,-122,444,168,612
26370,FremontBridge,10/06/2015 06:00:00 PM,48,-122,267,148,415
26371,FremontBridge,10/06/2015 07:00:00 PM,48,-122,99,60,159
26372,FremontBridge,10/06/2015 08:00:00 PM,48,-122,50,36,86
26373,FremontBridge,10/06/2015 09:00:00 PM,48,-122,38,23,61
26374,FremontBridge,10/06/2015 10:00:00 PM,48,-122,22,11,33
26375,FremontBridge,10/06/2015 11:00:00 PM,48,-122,12,10,22
26376,FremontBridge,10/07/2015 12:00:00 AM,48,-122,4,7,11
26377,FremontBridge,10/07/2015 01:00:00 AM,48,-122,2,1,3
26378,FremontBridge,10/07/2015 02:00:00 AM,48,-122,1,3,4
26379,FremontBridge,10/07/2015 03:00:00 AM,48,-122,1,4,5
26380,FremontBridge,10/07/2015 04:00:00 AM,48,-122,5,2,7
26381,FremontBridge,10/07/2015 05:00:00 AM,48,-122,13,21,34
26382,FremontBridge,10/07/2015 06:00:00 AM,48,-122,41,65,106
26383,FremontBridge,10/07/2015 07:00:00 AM,48,-122,71,196,267
26384,FremontBridge,10/07/2015 08:00:00 AM,48,-122,121,235,356
26385,FremontBridge,10/07/2015 09:00:00 AM,48,-122,56,121,177
26386,FremontBridge,10/07/2015 10:00:00 AM,48,-122,21,36,57
26387,FremontBridge,10/07/2015 11:00:00 AM,48,-122,17,20,37
26388,FremontBridge,10/07/2015 12:00:00 PM,48,-122,17,16,33
26389,FremontBridge,10/07/2015 01:00:00 PM,48,-122,24,23,47
26390,FremontBridge,10/07/2015 02:00:00 PM,48,-122,34,22,56
26391,FremontBridge,10/07/2015 03:00:00 PM,48,-122,52,26,78
26392,FremontBridge,10/07/2015 04:00:00 PM,48,-122,116,50,166
26393,FremontBridge,10/07/2015 05:00:00 PM,48,-122,302,107,409
26394,FremontBridge,10/07/2015 06:00:00 PM,48,-122,169,84,253
26395,FremontBridge,10/07/2015 07:00:00 PM,48,-122,69,38,107
26396,FremontBridge,10/07/2015 08:00:00 PM,48,-122,42,27,69
26397,FremontBridge,10/07/2015 09:00:00 PM,48,-122,21,10,31
26398,FremontBridge,10/07/2015 10:00:00 PM,48,-122,22,8,30
26399,FremontBridge,10/07/2015 11:00:00 PM,48,-122,7,9,16
26400,FremontBridge,10/08/2015 12:00:00 AM,48,-122,4,10,14
26401,FremontBridge,10/08/2015 01:00:00 AM,48,-122,2,3,5
26402,FremontBridge,10/08/2015 02:00:00 AM,48,-122,3,2,5
26403,FremontBridge,10/08/2015 03:00:00 AM,48,-122,2,2,4
26404,FremontBridge,10/08/2015 04:00:00 AM,48,-122,5,7,12
26405,FremontBridge,10/08/2015 05:00:00 AM,48,-122,15,23,38
26406,FremontBridge,10/08/2015 06:00:00 AM,48,-122,43,87,130
26407,FremontBridge,10/08/2015 07:00:00 AM,48,-122,100,264,364
26408,FremontBridge,10/08/2015 08:00:00 AM,48,-122,180,327,507
26409,FremontBridge,10/08/2015 09:00:00 AM,48,-122,100,168,268
26410,FremontBridge,10/08/2015 10:00:00 AM,48,-122,54,58,112
26411,FremontBridge,10/08/2015 11:00:00 AM,48,-122,46,47,93
26412,FremontBridge,10/08/2015 12:00:00 PM,48,-122,54,34,88
26413,FremontBridge,10/08/2015 01:00:00 PM,48,-122,37,42,79
26414,FremontBridge,10/08/2015 02:00:00 PM,48,-122,55,44,99
26415,FremontBridge,10/08/2015 03:00:00 PM,48,-122,87,80,167
26416,FremontBridge,10/08/2015 04:00:00 PM,48,-122,166,98,264
26417,FremontBridge,10/08/2015 05:00:00 PM,48,-122,392,185,577
26418,FremontBridge,10/08/2015 06:00:00 PM,48,-122,247,148,395
26419,FremontBridge,10/08/2015 07:00:00 PM,48,-122,91,53,144
26420,FremontBridge,10/08/2015 08:00:00 PM,48,-122,56,42,98
26421,FremontBridge,10/08/2015 09:00:00 PM,48,-122,40,23,63
26422,FremontBridge,10/08/2015 10:00:00 PM,48,-122,25,6,31
26423,FremontBridge,10/08/2015 11:00:00 PM,48,-122,15,16,31
26424,FremontBridge,10/09/2015 12:00:00 AM,48,-122,17,7,24
26425,FremontBridge,10/09/2015 01:00:00 AM,48,-122,8,3,11
26426,FremontBridge,10/09/2015 02:00:00 AM,48,-122,4,0,4
26427,FremontBridge,10/09/2015 03:00:00 AM,48,-122,5,0,5
26428,FremontBridge,10/09/2015 04:00:00 AM,48,-122,3,1,4
26429,FremontBridge,10/09/2015 05:00:00 AM,48,-122,15,23,38
26430,FremontBridge,10/09/2015 06:00:00 AM,48,-122,32,78,110
26431,FremontBridge,10/09/2015 07:00:00 AM,48,-122,98,201,299
26432,FremontBridge,10/09/2015 08:00:00 AM,48,-122,130,297,427
26433,FremontBridge,10/09/2015 09:00:00 AM,48,-122,83,138,221
26434,FremontBridge,10/09/2015 10:00:00 AM,48,-122,46,60,106
26435,FremontBridge,10/09/2015 11:00:00 AM,48,-122,40,40,80
26436,FremontBridge,10/09/2015 12:00:00 PM,48,-122,37,43,80
26437,FremontBridge,10/09/2015 01:00:00 PM,48,-122,50,43,93
26438,FremontBridge,10/09/2015 02:00:00 PM,48,-122,55,39,94
26439,FremontBridge,10/09/2015 03:00:00 PM,48,-122,99,63,162
26440,FremontBridge,10/09/2015 04:00:00 PM,48,-122,168,97,265
26441,FremontBridge,10/09/2015 05:00:00 PM,48,-122,372,157,529
26442,FremontBridge,10/09/2015 06:00:00 PM,48,-122,185,90,275
26443,FremontBridge,10/09/2015 07:00:00 PM,48,-122,67,51,118
26444,FremontBridge,10/09/2015 08:00:00 PM,48,-122,38,22,60
26445,FremontBridge,10/09/2015 09:00:00 PM,48,-122,20,26,46
26446,FremontBridge,10/09/2015 10:00:00 PM,48,-122,22,13,35
26447,FremontBridge,10/09/2015 11:00:00 PM,48,-122,22,11,33
26448,FremontBridge,10/10/2015 12:00:00 AM,48,-122,10,10,20
26449,FremontBridge,10/10/2015 01:00:00 AM,48,-122,8,7,15
26450,FremontBridge,10/10/2015 02:00:00 AM,48,-122,6,1,7
26451,FremontBridge,10/10/2015 03:00:00 AM,48,-122,2,3,5
26452,FremontBridge,10/10/2015 04:00:00 AM,48,-122,2,1,3
26453,FremontBridge,10/10/2015 05:00:00 AM,48,-122,6,5,11
26454,FremontBridge,10/10/2015 06:00:00 AM,48,-122,5,6,11
26455,FremontBridge,10/10/2015 07:00:00 AM,48,-122,2,11,13
26456,FremontBridge,10/10/2015 08:00:00 AM,48,-122,16,21,37
26457,FremontBridge,10/10/2015 09:00:00 AM,48,-122,12,27,39
26458,FremontBridge,10/10/2015 10:00:00 AM,48,-122,15,15,30
26459,FremontBridge,10/10/2015 11:00:00 AM,48,-122,8,16,24
26460,FremontBridge,10/10/2015 12:00:00 PM,48,-122,14,13,27
26461,FremontBridge,10/10/2015 01:00:00 PM,48,-122,10,22,32
26462,FremontBridge,10/10/2015 02:00:00 PM,48,-122,10,13,23
26463,FremontBridge,10/10/2015 03:00:00 PM,48,-122,17,18,35
26464,FremontBridge,10/10/2015 04:00:00 PM,48,-122,20,19,39
26465,FremontBridge,10/10/2015 05:00:00 PM,48,-122,21,21,42
26466,FremontBridge,10/10/2015 06:00:00 PM,48,-122,15,18,33
26467,FremontBridge,10/10/2015 07:00:00 PM,48,-122,6,11,17
26468,FremontBridge,10/10/2015 08:00:00 PM,48,-122,6,6,12
26469,FremontBridge,10/10/2015 09:00:00 PM,48,-122,7,18,25
26470,FremontBridge,10/10/2015 10:00:00 PM,48,-122,9,5,14
26471,FremontBridge,10/10/2015 11:00:00 PM,48,-122,11,14,25
26472,FremontBridge,10/11/2015 12:00:00 AM,48,-122,3,12,15
26473,FremontBridge,10/11/2015 01:00:00 AM,48,-122,7,1,8
26474,FremontBridge,10/11/2015 02:00:00 AM,48,-122,0,1,1
26475,FremontBridge,10/11/2015 03:00:00 AM,48,-122,1,0,1
26476,FremontBridge,10/11/2015 04:00:00 AM,48,-122,2,2,4
26477,FremontBridge,10/11/2015 05:00:00 AM,48,-122,2,4,6
26478,FremontBridge,10/11/2015 06:00:00 AM,48,-122,3,12,15
26479,FremontBridge,10/11/2015 07:00:00 AM,48,-122,6,14,20
26480,FremontBridge,10/11/2015 08:00:00 AM,48,-122,21,17,38
26481,FremontBridge,10/11/2015 09:00:00 AM,48,-122,35,36,71
26482,FremontBridge,10/11/2015 10:00:00 AM,48,-122,27,37,64
26483,FremontBridge,10/11/2015 11:00:00 AM,48,-122,68,57,125
26484,FremontBridge,10/11/2015 12:00:00 PM,48,-122,60,58,118
26485,FremontBridge,10/11/2015 01:00:00 PM,48,-122,73,57,130
26486,FremontBridge,10/11/2015 02:00:00 PM,48,-122,76,107,183
26487,FremontBridge,10/11/2015 03:00:00 PM,48,-122,84,102,186
26488,FremontBridge,10/11/2015 04:00:00 PM,48,-122,51,79,130
26489,FremontBridge,10/11/2015 05:00:00 PM,48,-122,50,64,114
26490,FremontBridge,10/11/2015 06:00:00 PM,48,-122,33,54,87
26491,FremontBridge,10/11/2015 07:00:00 PM,48,-122,19,27,46
26492,FremontBridge,10/11/2015 08:00:00 PM,48,-122,15,17,32
26493,FremontBridge,10/11/2015 09:00:00 PM,48,-122,5,11,16
26494,FremontBridge,10/11/2015 10:00:00 PM,48,-122,12,10,22
26495,FremontBridge,10/11/2015 11:00:00 PM,48,-122,10,6,16
26496,FremontBridge,10/12/2015 12:00:00 AM,48,-122,4,5,9
26497,FremontBridge,10/12/2015 01:00:00 AM,48,-122,2,4,6
26498,FremontBridge,10/12/2015 02:00:00 AM,48,-122,1,3,4
26499,FremontBridge,10/12/2015 03:00:00 AM,48,-122,0,3,3
26500,FremontBridge,10/12/2015 04:00:00 AM,48,-122,4,2,6
26501,FremontBridge,10/12/2015 05:00:00 AM,48,-122,16,27,43
26502,FremontBridge,10/12/2015 06:00:00 AM,48,-122,50,90,140
26503,FremontBridge,10/12/2015 07:00:00 AM,48,-122,119,258,377
26504,FremontBridge,10/12/2015 08:00:00 AM,48,-122,160,344,504
26505,FremontBridge,10/12/2015 09:00:00 AM,48,-122,103,166,269
26506,FremontBridge,10/12/2015 10:00:00 AM,48,-122,49,64,113
26507,FremontBridge,10/12/2015 11:00:00 AM,48,-122,36,38,74
26508,FremontBridge,10/12/2015 12:00:00 PM,48,-122,29,32,61
26509,FremontBridge,10/12/2015 01:00:00 PM,48,-122,40,49,89
26510,FremontBridge,10/12/2015 02:00:00 PM,48,-122,49,50,99
26511,FremontBridge,10/12/2015 03:00:00 PM,48,-122,85,57,142
26512,FremontBridge,10/12/2015 04:00:00 PM,48,-122,159,90,249
26513,FremontBridge,10/12/2015 05:00:00 PM,48,-122,428,153,581
26514,FremontBridge,10/12/2015 06:00:00 PM,48,-122,267,124,391
26515,FremontBridge,10/12/2015 07:00:00 PM,48,-122,72,53,125
26516,FremontBridge,10/12/2015 08:00:00 PM,48,-122,38,26,64
26517,FremontBridge,10/12/2015 09:00:00 PM,48,-122,22,14,36
26518,FremontBridge,10/12/2015 10:00:00 PM,48,-122,10,8,18
26519,FremontBridge,10/12/2015 11:00:00 PM,48,-122,11,4,15
26520,FremontBridge,10/13/2015 12:00:00 AM,48,-122,5,4,9
26521,FremontBridge,10/13/2015 01:00:00 AM,48,-122,1,2,3
26522,FremontBridge,10/13/2015 02:00:00 AM,48,-122,1,2,3
26523,FremontBridge,10/13/2015 03:00:00 AM,48,-122,1,2,3
26524,FremontBridge,10/13/2015 04:00:00 AM,48,-122,1,4,5
26525,FremontBridge,10/13/2015 05:00:00 AM,48,-122,19,23,42
26526,FremontBridge,10/13/2015 06:00:00 AM,48,-122,43,86,129
26527,FremontBridge,10/13/2015 07:00:00 AM,48,-122,107,256,363
26528,FremontBridge,10/13/2015 08:00:00 AM,48,-122,166,356,522
26529,FremontBridge,10/13/2015 09:00:00 AM,48,-122,88,141,229
26530,FremontBridge,10/13/2015 10:00:00 AM,48,-122,38,56,94
26531,FremontBridge,10/13/2015 11:00:00 AM,48,-122,29,32,61
26532,FremontBridge,10/13/2015 12:00:00 PM,48,-122,37,37,74
26533,FremontBridge,10/13/2015 01:00:00 PM,48,-122,34,41,75
26534,FremontBridge,10/13/2015 02:00:00 PM,48,-122,49,52,101
26535,FremontBridge,10/13/2015 03:00:00 PM,48,-122,79,68,147
26536,FremontBridge,10/13/2015 04:00:00 PM,48,-122,189,119,308
26537,FremontBridge,10/13/2015 05:00:00 PM,48,-122,410,159,569
26538,FremontBridge,10/13/2015 06:00:00 PM,48,-122,233,142,375
26539,FremontBridge,10/13/2015 07:00:00 PM,48,-122,99,55,154
26540,FremontBridge,10/13/2015 08:00:00 PM,48,-122,50,35,85
26541,FremontBridge,10/13/2015 09:00:00 PM,48,-122,28,28,56
26542,FremontBridge,10/13/2015 10:00:00 PM,48,-122,24,15,39
26543,FremontBridge,10/13/2015 11:00:00 PM,48,-122,8,6,14
26544,FremontBridge,10/14/2015 12:00:00 AM,48,-122,3,10,13
26545,FremontBridge,10/14/2015 01:00:00 AM,48,-122,0,5,5
26546,FremontBridge,10/14/2015 02:00:00 AM,48,-122,1,2,3
26547,FremontBridge,10/14/2015 03:00:00 AM,48,-122,0,5,5
26548,FremontBridge,10/14/2015 04:00:00 AM,48,-122,6,8,14
26549,FremontBridge,10/14/2015 05:00:00 AM,48,-122,17,31,48
26550,FremontBridge,10/14/2015 06:00:00 AM,48,-122,49,96,145
26551,FremontBridge,10/14/2015 07:00:00 AM,48,-122,117,280,397
26552,FremontBridge,10/14/2015 08:00:00 AM,48,-122,151,345,496
26553,FremontBridge,10/14/2015 09:00:00 AM,48,-122,92,152,244
26554,FremontBridge,10/14/2015 10:00:00 AM,48,-122,55,56,111
26555,FremontBridge,10/14/2015 11:00:00 AM,48,-122,46,36,82
26556,FremontBridge,10/14/2015 12:00:00 PM,48,-122,32,39,71
26557,FremontBridge,10/14/2015 01:00:00 PM,48,-122,39,32,71
26558,FremontBridge,10/14/2015 02:00:00 PM,48,-122,52,39,91
26559,FremontBridge,10/14/2015 03:00:00 PM,48,-122,82,68,150
26560,FremontBridge,10/14/2015 04:00:00 PM,48,-122,177,117,294
26561,FremontBridge,10/14/2015 05:00:00 PM,48,-122,445,189,634
26562,FremontBridge,10/14/2015 06:00:00 PM,48,-122,270,124,394
26563,FremontBridge,10/14/2015 07:00:00 PM,48,-122,93,45,138
26564,FremontBridge,10/14/2015 08:00:00 PM,48,-122,50,38,88
26565,FremontBridge,10/14/2015 09:00:00 PM,48,-122,31,21,52
26566,FremontBridge,10/14/2015 10:00:00 PM,48,-122,22,22,44
26567,FremontBridge,10/14/2015 11:00:00 PM,48,-122,8,8,16
26568,FremontBridge,10/15/2015 12:00:00 AM,48,-122,6,9,15
26569,FremontBridge,10/15/2015 01:00:00 AM,48,-122,2,3,5
26570,FremontBridge,10/15/2015 02:00:00 AM,48,-122,0,1,1
26571,FremontBridge,10/15/2015 03:00:00 AM,48,-122,1,8,9
26572,FremontBridge,10/15/2015 04:00:00 AM,48,-122,7,4,11
26573,FremontBridge,10/15/2015 05:00:00 AM,48,-122,13,27,40
26574,FremontBridge,10/15/2015 06:00:00 AM,48,-122,45,105,150
26575,FremontBridge,10/15/2015 07:00:00 AM,48,-122,117,239,356
26576,FremontBridge,10/15/2015 08:00:00 AM,48,-122,170,352,522
26577,FremontBridge,10/15/2015 09:00:00 AM,48,-122,111,176,287
26578,FremontBridge,10/15/2015 10:00:00 AM,48,-122,61,70,131
26579,FremontBridge,10/15/2015 11:00:00 AM,48,-122,43,44,87
26580,FremontBridge,10/15/2015 12:00:00 PM,48,-122,47,43,90
26581,FremontBridge,10/15/2015 01:00:00 PM,48,-122,41,59,100
26582,FremontBridge,10/15/2015 02:00:00 PM,48,-122,67,59,126
26583,FremontBridge,10/15/2015 03:00:00 PM,48,-122,100,77,177
26584,FremontBridge,10/15/2015 04:00:00 PM,48,-122,195,118,313
26585,FremontBridge,10/15/2015 05:00:00 PM,48,-122,443,169,612
26586,FremontBridge,10/15/2015 06:00:00 PM,48,-122,241,137,378
26587,FremontBridge,10/15/2015 07:00:00 PM,48,-122,91,53,144
26588,FremontBridge,10/15/2015 08:00:00 PM,48,-122,57,36,93
26589,FremontBridge,10/15/2015 09:00:00 PM,48,-122,24,34,58
26590,FremontBridge,10/15/2015 10:00:00 PM,48,-122,22,17,39
26591,FremontBridge,10/15/2015 11:00:00 PM,48,-122,17,12,29
26592,FremontBridge,10/16/2015 12:00:00 AM,48,-122,7,10,17
26593,FremontBridge,10/16/2015 01:00:00 AM,48,-122,1,1,2
26594,FremontBridge,10/16/2015 02:00:00 AM,48,-122,1,2,3
26595,FremontBridge,10/16/2015 03:00:00 AM,48,-122,0,3,3
26596,FremontBridge,10/16/2015 04:00:00 AM,48,-122,4,2,6
26597,FremontBridge,10/16/2015 05:00:00 AM,48,-122,12,25,37
26598,FremontBridge,10/16/2015 06:00:00 AM,48,-122,36,77,113
26599,FremontBridge,10/16/2015 07:00:00 AM,48,-122,91,212,303
26600,FremontBridge,10/16/2015 08:00:00 AM,48,-122,139,349,488
26601,FremontBridge,10/16/2015 09:00:00 AM,48,-122,88,157,245
26602,FremontBridge,10/16/2015 10:00:00 AM,48,-122,51,73,124
26603,FremontBridge,10/16/2015 11:00:00 AM,48,-122,49,48,97
26604,FremontBridge,10/16/2015 12:00:00 PM,48,-122,38,73,111
26605,FremontBridge,10/16/2015 01:00:00 PM,48,-122,55,58,113
26606,FremontBridge,10/16/2015 02:00:00 PM,48,-122,71,63,134
26607,FremontBridge,10/16/2015 03:00:00 PM,48,-122,101,113,214
26608,FremontBridge,10/16/2015 04:00:00 PM,48,-122,221,105,326
26609,FremontBridge,10/16/2015 05:00:00 PM,48,-122,388,184,572
26610,FremontBridge,10/16/2015 06:00:00 PM,48,-122,200,92,292
26611,FremontBridge,10/16/2015 07:00:00 PM,48,-122,65,42,107
26612,FremontBridge,10/16/2015 08:00:00 PM,48,-122,32,20,52
26613,FremontBridge,10/16/2015 09:00:00 PM,48,-122,28,26,54
26614,FremontBridge,10/16/2015 10:00:00 PM,48,-122,18,11,29
26615,FremontBridge,10/16/2015 11:00:00 PM,48,-122,13,10,23
26616,FremontBridge,10/17/2015 12:00:00 AM,48,-122,26,13,39
26617,FremontBridge,10/17/2015 01:00:00 AM,48,-122,6,4,10
26618,FremontBridge,10/17/2015 02:00:00 AM,48,-122,5,4,9
26619,FremontBridge,10/17/2015 03:00:00 AM,48,-122,2,0,2
26620,FremontBridge,10/17/2015 04:00:00 AM,48,-122,1,3,4
26621,FremontBridge,10/17/2015 05:00:00 AM,48,-122,2,3,5
26622,FremontBridge,10/17/2015 06:00:00 AM,48,-122,5,6,11
26623,FremontBridge,10/17/2015 07:00:00 AM,48,-122,16,33,49
26624,FremontBridge,10/17/2015 08:00:00 AM,48,-122,30,27,57
26625,FremontBridge,10/17/2015 09:00:00 AM,48,-122,25,42,67
26626,FremontBridge,10/17/2015 10:00:00 AM,48,-122,35,50,85
26627,FremontBridge,10/17/2015 11:00:00 AM,48,-122,38,60,98
26628,FremontBridge,10/17/2015 12:00:00 PM,48,-122,50,64,114
26629,FremontBridge,10/17/2015 01:00:00 PM,48,-122,68,67,135
26630,FremontBridge,10/17/2015 02:00:00 PM,48,-122,49,66,115
26631,FremontBridge,10/17/2015 03:00:00 PM,48,-122,54,46,100
26632,FremontBridge,10/17/2015 04:00:00 PM,48,-122,56,78,134
26633,FremontBridge,10/17/2015 05:00:00 PM,48,-122,41,45,86
26634,FremontBridge,10/17/2015 06:00:00 PM,48,-122,33,34,67
26635,FremontBridge,10/17/2015 07:00:00 PM,48,-122,14,14,28
26636,FremontBridge,10/17/2015 08:00:00 PM,48,-122,18,9,27
26637,FremontBridge,10/17/2015 09:00:00 PM,48,-122,15,6,21
26638,FremontBridge,10/17/2015 10:00:00 PM,48,-122,20,22,42
26639,FremontBridge,10/17/2015 11:00:00 PM,48,-122,19,21,40
26640,FremontBridge,10/18/2015 12:00:00 AM,48,-122,11,10,21
26641,FremontBridge,10/18/2015 01:00:00 AM,48,-122,5,4,9
26642,FremontBridge,10/18/2015 02:00:00 AM,48,-122,4,2,6
26643,FremontBridge,10/18/2015 03:00:00 AM,48,-122,1,4,5
26644,FremontBridge,10/18/2015 04:00:00 AM,48,-122,3,1,4
26645,FremontBridge,10/18/2015 05:00:00 AM,48,-122,3,3,6
26646,FremontBridge,10/18/2015 06:00:00 AM,48,-122,7,4,11
26647,FremontBridge,10/18/2015 07:00:00 AM,48,-122,7,15,22
26648,FremontBridge,10/18/2015 08:00:00 AM,48,-122,13,10,23
26649,FremontBridge,10/18/2015 09:00:00 AM,48,-122,25,27,52
26650,FremontBridge,10/18/2015 10:00:00 AM,48,-122,30,32,62
26651,FremontBridge,10/18/2015 11:00:00 AM,48,-122,41,32,73
26652,FremontBridge,10/18/2015 12:00:00 PM,48,-122,30,50,80
26653,FremontBridge,10/18/2015 01:00:00 PM,48,-122,29,28,57
26654,FremontBridge,10/18/2015 02:00:00 PM,48,-122,35,31,66
26655,FremontBridge,10/18/2015 03:00:00 PM,48,-122,27,28,55
26656,FremontBridge,10/18/2015 04:00:00 PM,48,-122,29,35,64
26657,FremontBridge,10/18/2015 05:00:00 PM,48,-122,35,35,70
26658,FremontBridge,10/18/2015 06:00:00 PM,48,-122,18,27,45
26659,FremontBridge,10/18/2015 07:00:00 PM,48,-122,15,19,34
26660,FremontBridge,10/18/2015 08:00:00 PM,48,-122,11,9,20
26661,FremontBridge,10/18/2015 09:00:00 PM,48,-122,7,10,17
26662,FremontBridge,10/18/2015 10:00:00 PM,48,-122,11,12,23
26663,FremontBridge,10/18/2015 11:00:00 PM,48,-122,9,3,12
26664,FremontBridge,10/19/2015 12:00:00 AM,48,-122,6,1,7
26665,FremontBridge,10/19/2015 01:00:00 AM,48,-122,3,2,5
26666,FremontBridge,10/19/2015 02:00:00 AM,48,-122,0,3,3
26667,FremontBridge,10/19/2015 03:00:00 AM,48,-122,1,3,4
26668,FremontBridge,10/19/2015 04:00:00 AM,48,-122,2,4,6
26669,FremontBridge,10/19/2015 05:00:00 AM,48,-122,13,26,39
26670,FremontBridge,10/19/2015 06:00:00 AM,48,-122,33,73,106
26671,FremontBridge,10/19/2015 07:00:00 AM,48,-122,99,226,325
26672,FremontBridge,10/19/2015 08:00:00 AM,48,-122,154,297,451
26673,FremontBridge,10/19/2015 09:00:00 AM,48,-122,85,143,228
26674,FremontBridge,10/19/2015 10:00:00 AM,48,-122,35,51,86
26675,FremontBridge,10/19/2015 11:00:00 AM,48,-122,29,43,72
26676,FremontBridge,10/19/2015 12:00:00 PM,48,-122,23,33,56
26677,FremontBridge,10/19/2015 01:00:00 PM,48,-122,42,32,74
26678,FremontBridge,10/19/2015 02:00:00 PM,48,-122,37,42,79
26679,FremontBridge,10/19/2015 03:00:00 PM,48,-122,77,48,125
26680,FremontBridge,10/19/2015 04:00:00 PM,48,-122,127,95,222
26681,FremontBridge,10/19/2015 05:00:00 PM,48,-122,391,129,520
26682,FremontBridge,10/19/2015 06:00:00 PM,48,-122,222,89,311
26683,FremontBridge,10/19/2015 07:00:00 PM,48,-122,80,51,131
26684,FremontBridge,10/19/2015 08:00:00 PM,48,-122,37,33,70
26685,FremontBridge,10/19/2015 09:00:00 PM,48,-122,35,20,55
26686,FremontBridge,10/19/2015 10:00:00 PM,48,-122,16,9,25
26687,FremontBridge,10/19/2015 11:00:00 PM,48,-122,11,10,21
26688,FremontBridge,10/20/2015 12:00:00 AM,48,-122,5,4,9
26689,FremontBridge,10/20/2015 01:00:00 AM,48,-122,4,3,7
26690,FremontBridge,10/20/2015 02:00:00 AM,48,-122,2,2,4
26691,FremontBridge,10/20/2015 03:00:00 AM,48,-122,1,5,6
26692,FremontBridge,10/20/2015 04:00:00 AM,48,-122,1,3,4
26693,FremontBridge,10/20/2015 05:00:00 AM,48,-122,21,25,46
26694,FremontBridge,10/20/2015 06:00:00 AM,48,-122,47,101,148
26695,FremontBridge,10/20/2015 07:00:00 AM,48,-122,107,320,427
26696,FremontBridge,10/20/2015 08:00:00 AM,48,-122,148,370,518
26697,FremontBridge,10/20/2015 09:00:00 AM,48,-122,110,147,257
26698,FremontBridge,10/20/2015 10:00:00 AM,48,-122,50,57,107
26699,FremontBridge,10/20/2015 11:00:00 AM,48,-122,44,35,79
26700,FremontBridge,10/20/2015 12:00:00 PM,48,-122,37,52,89
26701,FremontBridge,10/20/2015 01:00:00 PM,48,-122,37,43,80
26702,FremontBridge,10/20/2015 02:00:00 PM,48,-122,62,60,122
26703,FremontBridge,10/20/2015 03:00:00 PM,48,-122,82,61,143
26704,FremontBridge,10/20/2015 04:00:00 PM,48,-122,194,105,299
26705,FremontBridge,10/20/2015 05:00:00 PM,48,-122,471,208,679
26706,FremontBridge,10/20/2015 06:00:00 PM,48,-122,297,111,408
26707,FremontBridge,10/20/2015 07:00:00 PM,48,-122,97,62,159
26708,FremontBridge,10/20/2015 08:00:00 PM,48,-122,43,33,76
26709,FremontBridge,10/20/2015 09:00:00 PM,48,-122,32,32,64
26710,FremontBridge,10/20/2015 10:00:00 PM,48,-122,20,16,36
26711,FremontBridge,10/20/2015 11:00:00 PM,48,-122,12,16,28
26712,FremontBridge,10/21/2015 12:00:00 AM,48,-122,5,6,11
26713,FremontBridge,10/21/2015 01:00:00 AM,48,-122,0,2,2
26714,FremontBridge,10/21/2015 02:00:00 AM,48,-122,2,1,3
26715,FremontBridge,10/21/2015 03:00:00 AM,48,-122,2,1,3
26716,FremontBridge,10/21/2015 04:00:00 AM,48,-122,6,2,8
26717,FremontBridge,10/21/2015 05:00:00 AM,48,-122,13,26,39
26718,FremontBridge,10/21/2015 06:00:00 AM,48,-122,43,89,132
26719,FremontBridge,10/21/2015 07:00:00 AM,48,-122,109,272,381
26720,FremontBridge,10/21/2015 08:00:00 AM,48,-122,160,341,501
26721,FremontBridge,10/21/2015 09:00:00 AM,48,-122,102,162,264
26722,FremontBridge,10/21/2015 10:00:00 AM,48,-122,49,52,101
26723,FremontBridge,10/21/2015 11:00:00 AM,48,-122,39,42,81
26724,FremontBridge,10/21/2015 12:00:00 PM,48,-122,35,37,72
26725,FremontBridge,10/21/2015 01:00:00 PM,48,-122,68,43,111
26726,FremontBridge,10/21/2015 02:00:00 PM,48,-122,65,52,117
26727,FremontBridge,10/21/2015 03:00:00 PM,48,-122,72,59,131
26728,FremontBridge,10/21/2015 04:00:00 PM,48,-122,167,108,275
26729,FremontBridge,10/21/2015 05:00:00 PM,48,-122,422,154,576
26730,FremontBridge,10/21/2015 06:00:00 PM,48,-122,218,117,335
26731,FremontBridge,10/21/2015 07:00:00 PM,48,-122,84,52,136
26732,FremontBridge,10/21/2015 08:00:00 PM,48,-122,45,41,86
26733,FremontBridge,10/21/2015 09:00:00 PM,48,-122,39,27,66
26734,FremontBridge,10/21/2015 10:00:00 PM,48,-122,24,14,38
26735,FremontBridge,10/21/2015 11:00:00 PM,48,-122,12,11,23
26736,FremontBridge,10/22/2015 12:00:00 AM,48,-122,6,16,22
26737,FremontBridge,10/22/2015 01:00:00 AM,48,-122,5,0,5
26738,FremontBridge,10/22/2015 02:00:00 AM,48,-122,1,3,4
26739,FremontBridge,10/22/2015 03:00:00 AM,48,-122,0,5,5
26740,FremontBridge,10/22/2015 04:00:00 AM,48,-122,7,5,12
26741,FremontBridge,10/22/2015 05:00:00 AM,48,-122,18,24,42
26742,FremontBridge,10/22/2015 06:00:00 AM,48,-122,35,85,120
26743,FremontBridge,10/22/2015 07:00:00 AM,48,-122,106,290,396
26744,FremontBridge,10/22/2015 08:00:00 AM,48,-122,158,349,507
26745,FremontBridge,10/22/2015 09:00:00 AM,48,-122,105,170,275
26746,FremontBridge,10/22/2015 10:00:00 AM,48,-122,51,59,110
26747,FremontBridge,10/22/2015 11:00:00 AM,48,-122,39,54,93
26748,FremontBridge,10/22/2015 12:00:00 PM,48,-122,43,30,73
26749,FremontBridge,10/22/2015 01:00:00 PM,48,-122,55,57,112
26750,FremontBridge,10/22/2015 02:00:00 PM,48,-122,68,40,108
26751,FremontBridge,10/22/2015 03:00:00 PM,48,-122,80,60,140
26752,FremontBridge,10/22/2015 04:00:00 PM,48,-122,197,120,317
26753,FremontBridge,10/22/2015 05:00:00 PM,48,-122,437,172,609
26754,FremontBridge,10/22/2015 06:00:00 PM,48,-122,232,105,337
26755,FremontBridge,10/22/2015 07:00:00 PM,48,-122,80,43,123
26756,FremontBridge,10/22/2015 08:00:00 PM,48,-122,55,25,80
26757,FremontBridge,10/22/2015 09:00:00 PM,48,-122,32,22,54
26758,FremontBridge,10/22/2015 10:00:00 PM,48,-122,20,19,39
26759,FremontBridge,10/22/2015 11:00:00 PM,48,-122,10,13,23
26760,FremontBridge,10/23/2015 12:00:00 AM,48,-122,4,5,9
26761,FremontBridge,10/23/2015 01:00:00 AM,48,-122,5,2,7
26762,FremontBridge,10/23/2015 02:00:00 AM,48,-122,1,7,8
26763,FremontBridge,10/23/2015 03:00:00 AM,48,-122,0,2,2
26764,FremontBridge,10/23/2015 04:00:00 AM,48,-122,3,2,5
26765,FremontBridge,10/23/2015 05:00:00 AM,48,-122,12,18,30
26766,FremontBridge,10/23/2015 06:00:00 AM,48,-122,39,69,108
26767,FremontBridge,10/23/2015 07:00:00 AM,48,-122,95,226,321
26768,FremontBridge,10/23/2015 08:00:00 AM,48,-122,134,293,427
26769,FremontBridge,10/23/2015 09:00:00 AM,48,-122,100,142,242
26770,FremontBridge,10/23/2015 10:00:00 AM,48,-122,41,55,96
26771,FremontBridge,10/23/2015 11:00:00 AM,48,-122,37,47,84
26772,FremontBridge,10/23/2015 12:00:00 PM,48,-122,34,49,83
26773,FremontBridge,10/23/2015 01:00:00 PM,48,-122,45,36,81
26774,FremontBridge,10/23/2015 02:00:00 PM,48,-122,57,53,110
26775,FremontBridge,10/23/2015 03:00:00 PM,48,-122,88,44,132
26776,FremontBridge,10/23/2015 04:00:00 PM,48,-122,193,100,293
26777,FremontBridge,10/23/2015 05:00:00 PM,48,-122,353,144,497
26778,FremontBridge,10/23/2015 06:00:00 PM,48,-122,187,94,281
26779,FremontBridge,10/23/2015 07:00:00 PM,48,-122,71,45,116
26780,FremontBridge,10/23/2015 08:00:00 PM,48,-122,26,24,50
26781,FremontBridge,10/23/2015 09:00:00 PM,48,-122,23,9,32
26782,FremontBridge,10/23/2015 10:00:00 PM,48,-122,19,15,34
26783,FremontBridge,10/23/2015 11:00:00 PM,48,-122,23,16,39
26784,FremontBridge,10/24/2015 12:00:00 AM,48,-122,8,7,15
26785,FremontBridge,10/24/2015 01:00:00 AM,48,-122,11,3,14
26786,FremontBridge,10/24/2015 02:00:00 AM,48,-122,3,3,6
26787,FremontBridge,10/24/2015 03:00:00 AM,48,-122,1,0,1
26788,FremontBridge,10/24/2015 04:00:00 AM,48,-122,3,3,6
26789,FremontBridge,10/24/2015 05:00:00 AM,48,-122,5,7,12
26790,FremontBridge,10/24/2015 06:00:00 AM,48,-122,12,7,19
26791,FremontBridge,10/24/2015 07:00:00 AM,48,-122,17,16,33
26792,FremontBridge,10/24/2015 08:00:00 AM,48,-122,35,29,64
26793,FremontBridge,10/24/2015 09:00:00 AM,48,-122,28,60,88
26794,FremontBridge,10/24/2015 10:00:00 AM,48,-122,34,47,81
26795,FremontBridge,10/24/2015 11:00:00 AM,48,-122,35,59,94
26796,FremontBridge,10/24/2015 12:00:00 PM,48,-122,45,47,92
26797,FremontBridge,10/24/2015 01:00:00 PM,48,-122,35,38,73
26798,FremontBridge,10/24/2015 02:00:00 PM,48,-122,37,45,82
26799,FremontBridge,10/24/2015 03:00:00 PM,48,-122,54,46,100
26800,FremontBridge,10/24/2015 04:00:00 PM,48,-122,58,67,125
26801,FremontBridge,10/24/2015 05:00:00 PM,48,-122,35,47,82
26802,FremontBridge,10/24/2015 06:00:00 PM,48,-122,30,37,67
26803,FremontBridge,10/24/2015 07:00:00 PM,48,-122,13,24,37
26804,FremontBridge,10/24/2015 08:00:00 PM,48,-122,16,13,29
26805,FremontBridge,10/24/2015 09:00:00 PM,48,-122,14,7,21
26806,FremontBridge,10/24/2015 10:00:00 PM,48,-122,11,14,25
26807,FremontBridge,10/24/2015 11:00:00 PM,48,-122,16,6,22
26808,FremontBridge,10/25/2015 12:00:00 AM,48,-122,6,4,10
26809,FremontBridge,10/25/2015 01:00:00 AM,48,-122,3,6,9
26810,FremontBridge,10/25/2015 02:00:00 AM,48,-122,3,1,4
26811,FremontBridge,10/25/2015 03:00:00 AM,48,-122,0,1,1
26812,FremontBridge,10/25/2015 04:00:00 AM,48,-122,2,1,3
26813,FremontBridge,10/25/2015 05:00:00 AM,48,-122,4,2,6
26814,FremontBridge,10/25/2015 06:00:00 AM,48,-122,2,11,13
26815,FremontBridge,10/25/2015 07:00:00 AM,48,-122,8,10,18
26816,FremontBridge,10/25/2015 08:00:00 AM,48,-122,18,24,42
26817,FremontBridge,10/25/2015 09:00:00 AM,48,-122,20,30,50
26818,FremontBridge,10/25/2015 10:00:00 AM,48,-122,27,34,61
26819,FremontBridge,10/25/2015 11:00:00 AM,48,-122,42,36,78
26820,FremontBridge,10/25/2015 12:00:00 PM,48,-122,46,49,95
26821,FremontBridge,10/25/2015 01:00:00 PM,48,-122,43,53,96
26822,FremontBridge,10/25/2015 02:00:00 PM,48,-122,58,66,124
26823,FremontBridge,10/25/2015 03:00:00 PM,48,-122,43,56,99
26824,FremontBridge,10/25/2015 04:00:00 PM,48,-122,23,32,55
26825,FremontBridge,10/25/2015 05:00:00 PM,48,-122,18,19,37
26826,FremontBridge,10/25/2015 06:00:00 PM,48,-122,23,18,41
26827,FremontBridge,10/25/2015 07:00:00 PM,48,-122,11,16,27
26828,FremontBridge,10/25/2015 08:00:00 PM,48,-122,2,12,14
26829,FremontBridge,10/25/2015 09:00:00 PM,48,-122,1,2,3
26830,FremontBridge,10/25/2015 10:00:00 PM,48,-122,6,4,10
26831,FremontBridge,10/25/2015 11:00:00 PM,48,-122,4,2,6
26832,FremontBridge,10/26/2015 12:00:00 AM,48,-122,2,3,5
26833,FremontBridge,10/26/2015 01:00:00 AM,48,-122,2,0,2
26834,FremontBridge,10/26/2015 02:00:00 AM,48,-122,0,1,1
26835,FremontBridge,10/26/2015 03:00:00 AM,48,-122,0,2,2
26836,FremontBridge,10/26/2015 04:00:00 AM,48,-122,1,2,3
26837,FremontBridge,10/26/2015 05:00:00 AM,48,-122,14,17,31
26838,FremontBridge,10/26/2015 06:00:00 AM,48,-122,38,72,110
26839,FremontBridge,10/26/2015 07:00:00 AM,48,-122,72,189,261
26840,FremontBridge,10/26/2015 08:00:00 AM,48,-122,107,242,349
26841,FremontBridge,10/26/2015 09:00:00 AM,48,-122,80,128,208
26842,FremontBridge,10/26/2015 10:00:00 AM,48,-122,23,26,49
26843,FremontBridge,10/26/2015 11:00:00 AM,48,-122,19,25,44
26844,FremontBridge,10/26/2015 12:00:00 PM,48,-122,19,16,35
26845,FremontBridge,10/26/2015 01:00:00 PM,48,-122,21,22,43
26846,FremontBridge,10/26/2015 02:00:00 PM,48,-122,31,28,59
26847,FremontBridge,10/26/2015 03:00:00 PM,48,-122,39,40,79
26848,FremontBridge,10/26/2015 04:00:00 PM,48,-122,115,73,188
26849,FremontBridge,10/26/2015 05:00:00 PM,48,-122,313,125,438
26850,FremontBridge,10/26/2015 06:00:00 PM,48,-122,176,66,242
26851,FremontBridge,10/26/2015 07:00:00 PM,48,-122,60,31,91
26852,FremontBridge,10/26/2015 08:00:00 PM,48,-122,32,16,48
26853,FremontBridge,10/26/2015 09:00:00 PM,48,-122,23,11,34
26854,FremontBridge,10/26/2015 10:00:00 PM,48,-122,17,8,25
26855,FremontBridge,10/26/2015 11:00:00 PM,48,-122,8,10,18
26856,FremontBridge,10/27/2015 12:00:00 AM,48,-122,8,2,10
26857,FremontBridge,10/27/2015 01:00:00 AM,48,-122,1,1,2
26858,FremontBridge,10/27/2015 02:00:00 AM,48,-122,2,2,4
26859,FremontBridge,10/27/2015 03:00:00 AM,48,-122,0,0,0
26860,FremontBridge,10/27/2015 04:00:00 AM,48,-122,4,4,8
26861,FremontBridge,10/27/2015 05:00:00 AM,48,-122,20,26,46
26862,FremontBridge,10/27/2015 06:00:00 AM,48,-122,45,98,143
26863,FremontBridge,10/27/2015 07:00:00 AM,48,-122,114,281,395
26864,FremontBridge,10/27/2015 08:00:00 AM,48,-122,197,351,548
26865,FremontBridge,10/27/2015 09:00:00 AM,48,-122,101,179,280
26866,FremontBridge,10/27/2015 10:00:00 AM,48,-122,38,59,97
26867,FremontBridge,10/27/2015 11:00:00 AM,48,-122,42,57,99
26868,FremontBridge,10/27/2015 12:00:00 PM,48,-122,45,36,81
26869,FremontBridge,10/27/2015 01:00:00 PM,48,-122,54,52,106
26870,FremontBridge,10/27/2015 02:00:00 PM,48,-122,57,61,118
26871,FremontBridge,10/27/2015 03:00:00 PM,48,-122,77,69,146
26872,FremontBridge,10/27/2015 04:00:00 PM,48,-122,189,124,313
26873,FremontBridge,10/27/2015 05:00:00 PM,48,-122,458,168,626
26874,FremontBridge,10/27/2015 06:00:00 PM,48,-122,258,114,372
26875,FremontBridge,10/27/2015 07:00:00 PM,48,-122,97,58,155
26876,FremontBridge,10/27/2015 08:00:00 PM,48,-122,44,29,73
26877,FremontBridge,10/27/2015 09:00:00 PM,48,-122,33,33,66
26878,FremontBridge,10/27/2015 10:00:00 PM,48,-122,28,11,39
26879,FremontBridge,10/27/2015 11:00:00 PM,48,-122,17,11,28
26880,FremontBridge,10/28/2015 12:00:00 AM,48,-122,4,8,12
26881,FremontBridge,10/28/2015 01:00:00 AM,48,-122,2,3,5
26882,FremontBridge,10/28/2015 02:00:00 AM,48,-122,2,1,3
26883,FremontBridge,10/28/2015 03:00:00 AM,48,-122,0,2,2
26884,FremontBridge,10/28/2015 04:00:00 AM,48,-122,4,3,7
26885,FremontBridge,10/28/2015 05:00:00 AM,48,-122,15,24,39
26886,FremontBridge,10/28/2015 06:00:00 AM,48,-122,48,78,126
26887,FremontBridge,10/28/2015 07:00:00 AM,48,-122,84,207,291
26888,FremontBridge,10/28/2015 08:00:00 AM,48,-122,117,250,367
26889,FremontBridge,10/28/2015 09:00:00 AM,48,-122,68,130,198
26890,FremontBridge,10/28/2015 10:00:00 AM,48,-122,28,44,72
26891,FremontBridge,10/28/2015 11:00:00 AM,48,-122,18,17,35
26892,FremontBridge,10/28/2015 12:00:00 PM,48,-122,35,25,60
26893,FremontBridge,10/28/2015 01:00:00 PM,48,-122,21,26,47
26894,FremontBridge,10/28/2015 02:00:00 PM,48,-122,23,23,46
26895,FremontBridge,10/28/2015 03:00:00 PM,48,-122,47,40,87
26896,FremontBridge,10/28/2015 04:00:00 PM,48,-122,117,76,193
26897,FremontBridge,10/28/2015 05:00:00 PM,48,-122,309,132,441
26898,FremontBridge,10/28/2015 06:00:00 PM,48,-122,194,84,278
26899,FremontBridge,10/28/2015 07:00:00 PM,48,-122,73,37,110
26900,FremontBridge,10/28/2015 08:00:00 PM,48,-122,33,14,47
26901,FremontBridge,10/28/2015 09:00:00 PM,48,-122,29,23,52
26902,FremontBridge,10/28/2015 10:00:00 PM,48,-122,28,15,43
26903,FremontBridge,10/28/2015 11:00:00 PM,48,-122,6,7,13
26904,FremontBridge,10/29/2015 12:00:00 AM,48,-122,3,2,5
26905,FremontBridge,10/29/2015 01:00:00 AM,48,-122,3,3,6
26906,FremontBridge,10/29/2015 02:00:00 AM,48,-122,0,0,0
26907,FremontBridge,10/29/2015 03:00:00 AM,48,-122,0,2,2
26908,FremontBridge,10/29/2015 04:00:00 AM,48,-122,4,2,6
26909,FremontBridge,10/29/2015 05:00:00 AM,48,-122,13,17,30
26910,FremontBridge,10/29/2015 06:00:00 AM,48,-122,43,80,123
26911,FremontBridge,10/29/2015 07:00:00 AM,48,-122,102,234,336
26912,FremontBridge,10/29/2015 08:00:00 AM,48,-122,145,298,443
26913,FremontBridge,10/29/2015 09:00:00 AM,48,-122,87,133,220
26914,FremontBridge,10/29/2015 10:00:00 AM,48,-122,44,54,98
26915,FremontBridge,10/29/2015 11:00:00 AM,48,-122,34,38,72
26916,FremontBridge,10/29/2015 12:00:00 PM,48,-122,33,33,66
26917,FremontBridge,10/29/2015 01:00:00 PM,48,-122,34,39,73
26918,FremontBridge,10/29/2015 02:00:00 PM,48,-122,49,31,80
26919,FremontBridge,10/29/2015 03:00:00 PM,48,-122,66,48,114
26920,FremontBridge,10/29/2015 04:00:00 PM,48,-122,170,82,252
26921,FremontBridge,10/29/2015 05:00:00 PM,48,-122,341,155,496
26922,FremontBridge,10/29/2015 06:00:00 PM,48,-122,214,91,305
26923,FremontBridge,10/29/2015 07:00:00 PM,48,-122,73,46,119
26924,FremontBridge,10/29/2015 08:00:00 PM,48,-122,39,29,68
26925,FremontBridge,10/29/2015 09:00:00 PM,48,-122,22,18,40
26926,FremontBridge,10/29/2015 10:00:00 PM,48,-122,15,15,30
26927,FremontBridge,10/29/2015 11:00:00 PM,48,-122,17,6,23
26928,FremontBridge,10/30/2015 12:00:00 AM,48,-122,0,4,4
26929,FremontBridge,10/30/2015 01:00:00 AM,48,-122,3,3,6
26930,FremontBridge,10/30/2015 02:00:00 AM,48,-122,4,4,8
26931,FremontBridge,10/30/2015 03:00:00 AM,48,-122,0,1,1
26932,FremontBridge,10/30/2015 04:00:00 AM,48,-122,4,2,6
26933,FremontBridge,10/30/2015 05:00:00 AM,48,-122,14,15,29
26934,FremontBridge,10/30/2015 06:00:00 AM,48,-122,28,55,83
26935,FremontBridge,10/30/2015 07:00:00 AM,48,-122,41,152,193
26936,FremontBridge,10/30/2015 08:00:00 AM,48,-122,80,185,265
26937,FremontBridge,10/30/2015 09:00:00 AM,48,-122,64,89,153
26938,FremontBridge,10/30/2015 10:00:00 AM,48,-122,35,43,78
26939,FremontBridge,10/30/2015 11:00:00 AM,48,-122,34,28,62
26940,FremontBridge,10/30/2015 12:00:00 PM,48,-122,23,24,47
26941,FremontBridge,10/30/2015 01:00:00 PM,48,-122,27,38,65
26942,FremontBridge,10/30/2015 02:00:00 PM,48,-122,23,40,63
26943,FremontBridge,10/30/2015 03:00:00 PM,48,-122,53,44,97
26944,FremontBridge,10/30/2015 04:00:00 PM,48,-122,126,48,174
26945,FremontBridge,10/30/2015 05:00:00 PM,48,-122,220,102,322
26946,FremontBridge,10/30/2015 06:00:00 PM,48,-122,115,43,158
26947,FremontBridge,10/30/2015 07:00:00 PM,48,-122,39,24,63
26948,FremontBridge,10/30/2015 08:00:00 PM,48,-122,29,18,47
26949,FremontBridge,10/30/2015 09:00:00 PM,48,-122,15,17,32
26950,FremontBridge,10/30/2015 10:00:00 PM,48,-122,9,12,21
26951,FremontBridge,10/30/2015 11:00:00 PM,48,-122,5,8,13
26952,FremontBridge,10/31/2015 12:00:00 AM,48,-122,5,6,11
26953,FremontBridge,10/31/2015 01:00:00 AM,48,-122,3,3,6
26954,FremontBridge,10/31/2015 02:00:00 AM,48,-122,2,9,11
26955,FremontBridge,10/31/2015 03:00:00 AM,48,-122,0,1,1
26956,FremontBridge,10/31/2015 04:00:00 AM,48,-122,1,0,1
26957,FremontBridge,10/31/2015 05:00:00 AM,48,-122,3,6,9
26958,FremontBridge,10/31/2015 06:00:00 AM,48,-122,4,5,9
26959,FremontBridge,10/31/2015 07:00:00 AM,48,-122,4,8,12
26960,FremontBridge,10/31/2015 08:00:00 AM,48,-122,13,14,27
26961,FremontBridge,10/31/2015 09:00:00 AM,48,-122,10,13,23
26962,FremontBridge,10/31/2015 10:00:00 AM,48,-122,14,18,32
26963,FremontBridge,10/31/2015 11:00:00 AM,48,-122,10,12,22
26964,FremontBridge,10/31/2015 12:00:00 PM,48,-122,20,21,41
26965,FremontBridge,10/31/2015 01:00:00 PM,48,-122,16,19,35
26966,FremontBridge,10/31/2015 02:00:00 PM,48,-122,22,18,40
26967,FremontBridge,10/31/2015 03:00:00 PM,48,-122,23,20,43
26968,FremontBridge,10/31/2015 04:00:00 PM,48,-122,21,21,42
26969,FremontBridge,10/31/2015 05:00:00 PM,48,-122,16,16,32
26970,FremontBridge,10/31/2015 06:00:00 PM,48,-122,13,14,27
26971,FremontBridge,10/31/2015 07:00:00 PM,48,-122,8,11,19
26972,FremontBridge,10/31/2015 08:00:00 PM,48,-122,6,8,14
26973,FremontBridge,10/31/2015 09:00:00 PM,48,-122,8,6,14
26974,FremontBridge,10/31/2015 10:00:00 PM,48,-122,10,7,17
26975,FremontBridge,10/31/2015 11:00:00 PM,48,-122,2,4,6
26976,FremontBridge,11/01/2015 12:00:00 AM,48,-122,5,3,8
26977,FremontBridge,11/01/2015 01:00:00 AM,48,-122,3,8,11
26978,FremontBridge,11/01/2015 02:00:00 AM,48,-122,0,1,1
26979,FremontBridge,11/01/2015 03:00:00 AM,48,-122,1,3,4
26980,FremontBridge,11/01/2015 04:00:00 AM,48,-122,3,0,3
26981,FremontBridge,11/01/2015 05:00:00 AM,48,-122,2,2,4
26982,FremontBridge,11/01/2015 06:00:00 AM,48,-122,5,2,7
26983,FremontBridge,11/01/2015 07:00:00 AM,48,-122,5,10,15
26984,FremontBridge,11/01/2015 08:00:00 AM,48,-122,22,25,47
26985,FremontBridge,11/01/2015 09:00:00 AM,48,-122,13,30,43
26986,FremontBridge,11/01/2015 10:00:00 AM,48,-122,19,19,38
26987,FremontBridge,11/01/2015 11:00:00 AM,48,-122,18,17,35
26988,FremontBridge,11/01/2015 12:00:00 PM,48,-122,19,17,36
26989,FremontBridge,11/01/2015 01:00:00 PM,48,-122,20,17,37
26990,FremontBridge,11/01/2015 02:00:00 PM,48,-122,24,15,39
26991,FremontBridge,11/01/2015 03:00:00 PM,48,-122,11,18,29
26992,FremontBridge,11/01/2015 04:00:00 PM,48,-122,28,15,43
26993,FremontBridge,11/01/2015 05:00:00 PM,48,-122,18,31,49
26994,FremontBridge,11/01/2015 06:00:00 PM,48,-122,13,11,24
26995,FremontBridge,11/01/2015 07:00:00 PM,48,-122,3,6,9
26996,FremontBridge,11/01/2015 08:00:00 PM,48,-122,6,6,12
26997,FremontBridge,11/01/2015 09:00:00 PM,48,-122,9,2,11
26998,FremontBridge,11/01/2015 10:00:00 PM,48,-122,3,5,8
26999,FremontBridge,11/01/2015 11:00:00 PM,48,-122,5,4,9
27000,FremontBridge,11/02/2015 12:00:00 AM,48,-122,5,2,7
27001,FremontBridge,11/02/2015 01:00:00 AM,48,-122,1,0,1
27002,FremontBridge,11/02/2015 02:00:00 AM,48,-122,1,0,1
27003,FremontBridge,11/02/2015 03:00:00 AM,48,-122,2,2,4
27004,FremontBridge,11/02/2015 04:00:00 AM,48,-122,2,2,4
27005,FremontBridge,11/02/2015 05:00:00 AM,48,-122,12,28,40
27006,FremontBridge,11/02/2015 06:00:00 AM,48,-122,43,86,129
27007,FremontBridge,11/02/2015 07:00:00 AM,48,-122,105,254,359
27008,FremontBridge,11/02/2015 08:00:00 AM,48,-122,145,330,475
27009,FremontBridge,11/02/2015 09:00:00 AM,48,-122,89,117,206
27010,FremontBridge,11/02/2015 10:00:00 AM,48,-122,35,39,74
27011,FremontBridge,11/02/2015 11:00:00 AM,48,-122,14,24,38
27012,FremontBridge,11/02/2015 12:00:00 PM,48,-122,31,30,61
27013,FremontBridge,11/02/2015 01:00:00 PM,48,-122,33,24,57
27014,FremontBridge,11/02/2015 02:00:00 PM,48,-122,34,32,66
27015,FremontBridge,11/02/2015 03:00:00 PM,48,-122,65,48,113
27016,FremontBridge,11/02/2015 04:00:00 PM,48,-122,162,107,269
27017,FremontBridge,11/02/2015 05:00:00 PM,48,-122,399,149,548
27018,FremontBridge,11/02/2015 06:00:00 PM,48,-122,231,102,333
27019,FremontBridge,11/02/2015 07:00:00 PM,48,-122,65,34,99
27020,FremontBridge,11/02/2015 08:00:00 PM,48,-122,29,27,56
27021,FremontBridge,11/02/2015 09:00:00 PM,48,-122,28,19,47
27022,FremontBridge,11/02/2015 10:00:00 PM,48,-122,17,11,28
27023,FremontBridge,11/02/2015 11:00:00 PM,48,-122,4,5,9
27024,FremontBridge,11/03/2015 12:00:00 AM,48,-122,1,9,10
27025,FremontBridge,11/03/2015 01:00:00 AM,48,-122,1,1,2
27026,FremontBridge,11/03/2015 02:00:00 AM,48,-122,3,0,3
27027,FremontBridge,11/03/2015 03:00:00 AM,48,-122,1,3,4
27028,FremontBridge,11/03/2015 04:00:00 AM,48,-122,2,3,5
27029,FremontBridge,11/03/2015 05:00:00 AM,48,-122,14,35,49
27030,FremontBridge,11/03/2015 06:00:00 AM,48,-122,49,99,148
27031,FremontBridge,11/03/2015 07:00:00 AM,48,-122,122,289,411
27032,FremontBridge,11/03/2015 08:00:00 AM,48,-122,159,333,492
27033,FremontBridge,11/03/2015 09:00:00 AM,48,-122,90,126,216
27034,FremontBridge,11/03/2015 10:00:00 AM,48,-122,33,50,83
27035,FremontBridge,11/03/2015 11:00:00 AM,48,-122,19,43,62
27036,FremontBridge,11/03/2015 12:00:00 PM,48,-122,27,30,57
27037,FremontBridge,11/03/2015 01:00:00 PM,48,-122,34,36,70
27038,FremontBridge,11/03/2015 02:00:00 PM,48,-122,44,36,80
27039,FremontBridge,11/03/2015 03:00:00 PM,48,-122,85,48,133
27040,FremontBridge,11/03/2015 04:00:00 PM,48,-122,180,116,296
27041,FremontBridge,11/03/2015 05:00:00 PM,48,-122,434,128,562
27042,FremontBridge,11/03/2015 06:00:00 PM,48,-122,218,100,318
27043,FremontBridge,11/03/2015 07:00:00 PM,48,-122,85,46,131
27044,FremontBridge,11/03/2015 08:00:00 PM,48,-122,38,31,69
27045,FremontBridge,11/03/2015 09:00:00 PM,48,-122,35,23,58
27046,FremontBridge,11/03/2015 10:00:00 PM,48,-122,13,10,23
27047,FremontBridge,11/03/2015 11:00:00 PM,48,-122,11,11,22
27048,FremontBridge,11/04/2015 12:00:00 AM,48,-122,3,1,4
27049,FremontBridge,11/04/2015 01:00:00 AM,48,-122,0,4,4
27050,FremontBridge,11/04/2015 02:00:00 AM,48,-122,2,1,3
27051,FremontBridge,11/04/2015 03:00:00 AM,48,-122,1,3,4
27052,FremontBridge,11/04/2015 04:00:00 AM,48,-122,2,4,6
27053,FremontBridge,11/04/2015 05:00:00 AM,48,-122,9,31,40
27054,FremontBridge,11/04/2015 06:00:00 AM,48,-122,59,93,152
27055,FremontBridge,11/04/2015 07:00:00 AM,48,-122,122,298,420
27056,FremontBridge,11/04/2015 08:00:00 AM,48,-122,154,324,478
27057,FremontBridge,11/04/2015 09:00:00 AM,48,-122,85,156,241
27058,FremontBridge,11/04/2015 10:00:00 AM,48,-122,45,57,102
27059,FremontBridge,11/04/2015 11:00:00 AM,48,-122,28,37,65
27060,FremontBridge,11/04/2015 12:00:00 PM,48,-122,46,33,79
27061,FremontBridge,11/04/2015 01:00:00 PM,48,-122,38,45,83
27062,FremontBridge,11/04/2015 02:00:00 PM,48,-122,45,50,95
27063,FremontBridge,11/04/2015 03:00:00 PM,48,-122,79,54,133
27064,FremontBridge,11/04/2015 04:00:00 PM,48,-122,169,110,279
27065,FremontBridge,11/04/2015 05:00:00 PM,48,-122,404,159,563
27066,FremontBridge,11/04/2015 06:00:00 PM,48,-122,223,120,343
27067,FremontBridge,11/04/2015 07:00:00 PM,48,-122,84,44,128
27068,FremontBridge,11/04/2015 08:00:00 PM,48,-122,59,41,100
27069,FremontBridge,11/04/2015 09:00:00 PM,48,-122,30,21,51
27070,FremontBridge,11/04/2015 10:00:00 PM,48,-122,23,18,41
27071,FremontBridge,11/04/2015 11:00:00 PM,48,-122,8,10,18
27072,FremontBridge,11/05/2015 12:00:00 AM,48,-122,4,4,8
27073,FremontBridge,11/05/2015 01:00:00 AM,48,-122,1,5,6
27074,FremontBridge,11/05/2015 02:00:00 AM,48,-122,1,0,1
27075,FremontBridge,11/05/2015 03:00:00 AM,48,-122,1,2,3
27076,FremontBridge,11/05/2015 04:00:00 AM,48,-122,2,2,4
27077,FremontBridge,11/05/2015 05:00:00 AM,48,-122,16,20,36
27078,FremontBridge,11/05/2015 06:00:00 AM,48,-122,35,76,111
27079,FremontBridge,11/05/2015 07:00:00 AM,48,-122,94,241,335
27080,FremontBridge,11/05/2015 08:00:00 AM,48,-122,147,309,456
27081,FremontBridge,11/05/2015 09:00:00 AM,48,-122,73,126,199
27082,FremontBridge,11/05/2015 10:00:00 AM,48,-122,33,61,94
27083,FremontBridge,11/05/2015 11:00:00 AM,48,-122,23,34,57
27084,FremontBridge,11/05/2015 12:00:00 PM,48,-122,27,22,49
27085,FremontBridge,11/05/2015 01:00:00 PM,48,-122,31,27,58
27086,FremontBridge,11/05/2015 02:00:00 PM,48,-122,43,29,72
27087,FremontBridge,11/05/2015 03:00:00 PM,48,-122,73,52,125
27088,FremontBridge,11/05/2015 04:00:00 PM,48,-122,155,104,259
27089,FremontBridge,11/05/2015 05:00:00 PM,48,-122,344,140,484
27090,FremontBridge,11/05/2015 06:00:00 PM,48,-122,183,89,272
27091,FremontBridge,11/05/2015 07:00:00 PM,48,-122,81,36,117
27092,FremontBridge,11/05/2015 08:00:00 PM,48,-122,45,28,73
27093,FremontBridge,11/05/2015 09:00:00 PM,48,-122,36,18,54
27094,FremontBridge,11/05/2015 10:00:00 PM,48,-122,26,14,40
27095,FremontBridge,11/05/2015 11:00:00 PM,48,-122,8,6,14
27096,FremontBridge,11/06/2015 12:00:00 AM,48,-122,6,1,7
27097,FremontBridge,11/06/2015 01:00:00 AM,48,-122,5,3,8
27098,FremontBridge,11/06/2015 02:00:00 AM,48,-122,1,1,2
27099,FremontBridge,11/06/2015 03:00:00 AM,48,-122,1,2,3
27100,FremontBridge,11/06/2015 04:00:00 AM,48,-122,2,5,7
27101,FremontBridge,11/06/2015 05:00:00 AM,48,-122,10,20,30
27102,FremontBridge,11/06/2015 06:00:00 AM,48,-122,33,68,101
27103,FremontBridge,11/06/2015 07:00:00 AM,48,-122,74,196,270
27104,FremontBridge,11/06/2015 08:00:00 AM,48,-122,102,238,340
27105,FremontBridge,11/06/2015 09:00:00 AM,48,-122,75,105,180
27106,FremontBridge,11/06/2015 10:00:00 AM,48,-122,30,46,76
27107,FremontBridge,11/06/2015 11:00:00 AM,48,-122,34,34,68
27108,FremontBridge,11/06/2015 12:00:00 PM,48,-122,27,34,61
27109,FremontBridge,11/06/2015 01:00:00 PM,48,-122,45,28,73
27110,FremontBridge,11/06/2015 02:00:00 PM,48,-122,67,37,104
27111,FremontBridge,11/06/2015 03:00:00 PM,48,-122,76,45,121
27112,FremontBridge,11/06/2015 04:00:00 PM,48,-122,173,69,242
27113,FremontBridge,11/06/2015 05:00:00 PM,48,-122,234,120,354
27114,FremontBridge,11/06/2015 06:00:00 PM,48,-122,143,64,207
27115,FremontBridge,11/06/2015 07:00:00 PM,48,-122,73,47,120
27116,FremontBridge,11/06/2015 08:00:00 PM,48,-122,27,14,41
27117,FremontBridge,11/06/2015 09:00:00 PM,48,-122,18,13,31
27118,FremontBridge,11/06/2015 10:00:00 PM,48,-122,18,14,32
27119,FremontBridge,11/06/2015 11:00:00 PM,48,-122,12,9,21
27120,FremontBridge,11/07/2015 12:00:00 AM,48,-122,6,7,13
27121,FremontBridge,11/07/2015 01:00:00 AM,48,-122,10,8,18
27122,FremontBridge,11/07/2015 02:00:00 AM,48,-122,1,2,3
27123,FremontBridge,11/07/2015 03:00:00 AM,48,-122,1,2,3
27124,FremontBridge,11/07/2015 04:00:00 AM,48,-122,3,0,3
27125,FremontBridge,11/07/2015 05:00:00 AM,48,-122,2,3,5
27126,FremontBridge,11/07/2015 06:00:00 AM,48,-122,8,1,9
27127,FremontBridge,11/07/2015 07:00:00 AM,48,-122,8,14,22
27128,FremontBridge,11/07/2015 08:00:00 AM,48,-122,13,18,31
27129,FremontBridge,11/07/2015 09:00:00 AM,48,-122,12,15,27
27130,FremontBridge,11/07/2015 10:00:00 AM,48,-122,16,20,36
27131,FremontBridge,11/07/2015 11:00:00 AM,48,-122,18,13,31
27132,FremontBridge,11/07/2015 12:00:00 PM,48,-122,18,24,42
27133,FremontBridge,11/07/2015 01:00:00 PM,48,-122,21,19,40
27134,FremontBridge,11/07/2015 02:00:00 PM,48,-122,15,17,32
27135,FremontBridge,11/07/2015 03:00:00 PM,48,-122,19,11,30
27136,FremontBridge,11/07/2015 04:00:00 PM,48,-122,27,17,44
27137,FremontBridge,11/07/2015 05:00:00 PM,48,-122,13,17,30
27138,FremontBridge,11/07/2015 06:00:00 PM,48,-122,12,12,24
27139,FremontBridge,11/07/2015 07:00:00 PM,48,-122,4,13,17
27140,FremontBridge,11/07/2015 08:00:00 PM,48,-122,9,10,19
27141,FremontBridge,11/07/2015 09:00:00 PM,48,-122,13,2,15
27142,FremontBridge,11/07/2015 10:00:00 PM,48,-122,6,12,18
27143,FremontBridge,11/07/2015 11:00:00 PM,48,-122,10,3,13
27144,FremontBridge,11/08/2015 12:00:00 AM,48,-122,3,3,6
27145,FremontBridge,11/08/2015 01:00:00 AM,48,-122,6,4,10
27146,FremontBridge,11/08/2015 02:00:00 AM,48,-122,0,0,0
27147,FremontBridge,11/08/2015 03:00:00 AM,48,-122,2,6,8
27148,FremontBridge,11/08/2015 04:00:00 AM,48,-122,0,0,0
27149,FremontBridge,11/08/2015 05:00:00 AM,48,-122,2,2,4
27150,FremontBridge,11/08/2015 06:00:00 AM,48,-122,3,2,5
27151,FremontBridge,11/08/2015 07:00:00 AM,48,-122,8,11,19
27152,FremontBridge,11/08/2015 08:00:00 AM,48,-122,19,20,39
27153,FremontBridge,11/08/2015 09:00:00 AM,48,-122,19,21,40
27154,FremontBridge,11/08/2015 10:00:00 AM,48,-122,16,29,45
27155,FremontBridge,11/08/2015 11:00:00 AM,48,-122,17,18,35
27156,FremontBridge,11/08/2015 12:00:00 PM,48,-122,15,23,38
27157,FremontBridge,11/08/2015 01:00:00 PM,48,-122,22,22,44
27158,FremontBridge,11/08/2015 02:00:00 PM,48,-122,30,34,64
27159,FremontBridge,11/08/2015 03:00:00 PM,48,-122,29,49,78
27160,FremontBridge,11/08/2015 04:00:00 PM,48,-122,61,49,110
27161,FremontBridge,11/08/2015 05:00:00 PM,48,-122,21,28,49
27162,FremontBridge,11/08/2015 06:00:00 PM,48,-122,8,15,23
27163,FremontBridge,11/08/2015 07:00:00 PM,48,-122,11,10,21
27164,FremontBridge,11/08/2015 08:00:00 PM,48,-122,8,5,13
27165,FremontBridge,11/08/2015 09:00:00 PM,48,-122,6,6,12
27166,FremontBridge,11/08/2015 10:00:00 PM,48,-122,4,2,6
27167,FremontBridge,11/08/2015 11:00:00 PM,48,-122,8,4,12
27168,FremontBridge,11/09/2015 12:00:00 AM,48,-122,2,1,3
27169,FremontBridge,11/09/2015 01:00:00 AM,48,-122,3,1,4
27170,FremontBridge,11/09/2015 02:00:00 AM,48,-122,1,1,2
27171,FremontBridge,11/09/2015 03:00:00 AM,48,-122,2,2,4
27172,FremontBridge,11/09/2015 04:00:00 AM,48,-122,0,5,5
27173,FremontBridge,11/09/2015 05:00:00 AM,48,-122,12,17,29
27174,FremontBridge,11/09/2015 06:00:00 AM,48,-122,40,69,109
27175,FremontBridge,11/09/2015 07:00:00 AM,48,-122,76,184,260
27176,FremontBridge,11/09/2015 08:00:00 AM,48,-122,103,217,320
27177,FremontBridge,11/09/2015 09:00:00 AM,48,-122,55,82,137
27178,FremontBridge,11/09/2015 10:00:00 AM,48,-122,33,34,67
27179,FremontBridge,11/09/2015 11:00:00 AM,48,-122,15,19,34
27180,FremontBridge,11/09/2015 12:00:00 PM,48,-122,19,26,45
27181,FremontBridge,11/09/2015 01:00:00 PM,48,-122,23,27,50
27182,FremontBridge,11/09/2015 02:00:00 PM,48,-122,31,15,46
27183,FremontBridge,11/09/2015 03:00:00 PM,48,-122,61,36,97
27184,FremontBridge,11/09/2015 04:00:00 PM,48,-122,155,67,222
27185,FremontBridge,11/09/2015 05:00:00 PM,48,-122,279,115,394
27186,FremontBridge,11/09/2015 06:00:00 PM,48,-122,168,89,257
27187,FremontBridge,11/09/2015 07:00:00 PM,48,-122,60,37,97
27188,FremontBridge,11/09/2015 08:00:00 PM,48,-122,35,20,55
27189,FremontBridge,11/09/2015 09:00:00 PM,48,-122,23,14,37
27190,FremontBridge,11/09/2015 10:00:00 PM,48,-122,7,11,18
27191,FremontBridge,11/09/2015 11:00:00 PM,48,-122,5,2,7
27192,FremontBridge,11/10/2015 12:00:00 AM,48,-122,3,4,7
27193,FremontBridge,11/10/2015 01:00:00 AM,48,-122,0,0,0
27194,FremontBridge,11/10/2015 02:00:00 AM,48,-122,2,0,2
27195,FremontBridge,11/10/2015 03:00:00 AM,48,-122,2,2,4
27196,FremontBridge,11/10/2015 04:00:00 AM,48,-122,1,5,6
27197,FremontBridge,11/10/2015 05:00:00 AM,48,-122,15,20,35
27198,FremontBridge,11/10/2015 06:00:00 AM,48,-122,51,78,129
27199,FremontBridge,11/10/2015 07:00:00 AM,48,-122,101,312,413
27200,FremontBridge,11/10/2015 08:00:00 AM,48,-122,161,340,501
27201,FremontBridge,11/10/2015 09:00:00 AM,48,-122,98,143,241
27202,FremontBridge,11/10/2015 10:00:00 AM,48,-122,42,46,88
27203,FremontBridge,11/10/2015 11:00:00 AM,48,-122,33,43,76
27204,FremontBridge,11/10/2015 12:00:00 PM,48,-122,43,46,89
27205,FremontBridge,11/10/2015 01:00:00 PM,48,-122,40,39,79
27206,FremontBridge,11/10/2015 02:00:00 PM,48,-122,45,33,78
27207,FremontBridge,11/10/2015 03:00:00 PM,48,-122,75,43,118
27208,FremontBridge,11/10/2015 04:00:00 PM,48,-122,195,103,298
27209,FremontBridge,11/10/2015 05:00:00 PM,48,-122,435,133,568
27210,FremontBridge,11/10/2015 06:00:00 PM,48,-122,221,97,318
27211,FremontBridge,11/10/2015 07:00:00 PM,48,-122,77,55,132
27212,FremontBridge,11/10/2015 08:00:00 PM,48,-122,54,22,76
27213,FremontBridge,11/10/2015 09:00:00 PM,48,-122,26,26,52
27214,FremontBridge,11/10/2015 10:00:00 PM,48,-122,20,13,33
27215,FremontBridge,11/10/2015 11:00:00 PM,48,-122,9,5,14
27216,FremontBridge,11/11/2015 12:00:00 AM,48,-122,4,2,6
27217,FremontBridge,11/11/2015 01:00:00 AM,48,-122,2,1,3
27218,FremontBridge,11/11/2015 02:00:00 AM,48,-122,3,0,3
27219,FremontBridge,11/11/2015 03:00:00 AM,48,-122,0,3,3
27220,FremontBridge,11/11/2015 04:00:00 AM,48,-122,4,2,6
27221,FremontBridge,11/11/2015 05:00:00 AM,48,-122,5,12,17
27222,FremontBridge,11/11/2015 06:00:00 AM,48,-122,37,47,84
27223,FremontBridge,11/11/2015 07:00:00 AM,48,-122,68,177,245
27224,FremontBridge,11/11/2015 08:00:00 AM,48,-122,115,228,343
27225,FremontBridge,11/11/2015 09:00:00 AM,48,-122,73,117,190
27226,FremontBridge,11/11/2015 10:00:00 AM,48,-122,30,51,81
27227,FremontBridge,11/11/2015 11:00:00 AM,48,-122,33,47,80
27228,FremontBridge,11/11/2015 12:00:00 PM,48,-122,49,46,95
27229,FremontBridge,11/11/2015 01:00:00 PM,48,-122,41,52,93
27230,FremontBridge,11/11/2015 02:00:00 PM,48,-122,62,41,103
27231,FremontBridge,11/11/2015 03:00:00 PM,48,-122,80,54,134
27232,FremontBridge,11/11/2015 04:00:00 PM,48,-122,128,83,211
27233,FremontBridge,11/11/2015 05:00:00 PM,48,-122,293,105,398
27234,FremontBridge,11/11/2015 06:00:00 PM,48,-122,160,98,258
27235,FremontBridge,11/11/2015 07:00:00 PM,48,-122,73,27,100
27236,FremontBridge,11/11/2015 08:00:00 PM,48,-122,47,20,67
27237,FremontBridge,11/11/2015 09:00:00 PM,48,-122,39,19,58
27238,FremontBridge,11/11/2015 10:00:00 PM,48,-122,19,17,36
27239,FremontBridge,11/11/2015 11:00:00 PM,48,-122,6,9,15
27240,FremontBridge,11/12/2015 12:00:00 AM,48,-122,2,2,4
27241,FremontBridge,11/12/2015 01:00:00 AM,48,-122,3,2,5
27242,FremontBridge,11/12/2015 02:00:00 AM,48,-122,0,1,1
27243,FremontBridge,11/12/2015 03:00:00 AM,48,-122,2,2,4
27244,FremontBridge,11/12/2015 04:00:00 AM,48,-122,4,1,5
27245,FremontBridge,11/12/2015 05:00:00 AM,48,-122,15,27,42
27246,FremontBridge,11/12/2015 06:00:00 AM,48,-122,40,75,115
27247,FremontBridge,11/12/2015 07:00:00 AM,48,-122,91,227,318
27248,FremontBridge,11/12/2015 08:00:00 AM,48,-122,144,283,427
27249,FremontBridge,11/12/2015 09:00:00 AM,48,-122,65,121,186
27250,FremontBridge,11/12/2015 10:00:00 AM,48,-122,40,46,86
27251,FremontBridge,11/12/2015 11:00:00 AM,48,-122,21,39,60
27252,FremontBridge,11/12/2015 12:00:00 PM,48,-122,26,19,45
27253,FremontBridge,11/12/2015 01:00:00 PM,48,-122,28,20,48
27254,FremontBridge,11/12/2015 02:00:00 PM,48,-122,27,27,54
27255,FremontBridge,11/12/2015 03:00:00 PM,48,-122,67,41,108
27256,FremontBridge,11/12/2015 04:00:00 PM,48,-122,126,63,189
27257,FremontBridge,11/12/2015 05:00:00 PM,48,-122,307,96,403
27258,FremontBridge,11/12/2015 06:00:00 PM,48,-122,169,72,241
27259,FremontBridge,11/12/2015 07:00:00 PM,48,-122,76,38,114
27260,FremontBridge,11/12/2015 08:00:00 PM,48,-122,20,17,37
27261,FremontBridge,11/12/2015 09:00:00 PM,48,-122,19,34,53
27262,FremontBridge,11/12/2015 10:00:00 PM,48,-122,11,8,19
27263,FremontBridge,11/12/2015 11:00:00 PM,48,-122,7,4,11
27264,FremontBridge,11/13/2015 12:00:00 AM,48,-122,3,3,6
27265,FremontBridge,11/13/2015 01:00:00 AM,48,-122,1,1,2
27266,FremontBridge,11/13/2015 02:00:00 AM,48,-122,1,1,2
27267,FremontBridge,11/13/2015 03:00:00 AM,48,-122,0,1,1
27268,FremontBridge,11/13/2015 04:00:00 AM,48,-122,2,2,4
27269,FremontBridge,11/13/2015 05:00:00 AM,48,-122,11,10,21
27270,FremontBridge,11/13/2015 06:00:00 AM,48,-122,12,34,46
27271,FremontBridge,11/13/2015 07:00:00 AM,48,-122,52,119,171
27272,FremontBridge,11/13/2015 08:00:00 AM,48,-122,77,157,234
27273,FremontBridge,11/13/2015 09:00:00 AM,48,-122,43,90,133
27274,FremontBridge,11/13/2015 10:00:00 AM,48,-122,20,37,57
27275,FremontBridge,11/13/2015 11:00:00 AM,48,-122,17,23,40
27276,FremontBridge,11/13/2015 12:00:00 PM,48,-122,16,15,31
27277,FremontBridge,11/13/2015 01:00:00 PM,48,-122,17,18,35
27278,FremontBridge,11/13/2015 02:00:00 PM,48,-122,20,16,36
27279,FremontBridge,11/13/2015 03:00:00 PM,48,-122,48,30,78
27280,FremontBridge,11/13/2015 04:00:00 PM,48,-122,86,49,135
27281,FremontBridge,11/13/2015 05:00:00 PM,48,-122,193,78,271
27282,FremontBridge,11/13/2015 06:00:00 PM,48,-122,125,46,171
27283,FremontBridge,11/13/2015 07:00:00 PM,48,-122,42,16,58
27284,FremontBridge,11/13/2015 08:00:00 PM,48,-122,18,14,32
27285,FremontBridge,11/13/2015 09:00:00 PM,48,-122,11,7,18
27286,FremontBridge,11/13/2015 10:00:00 PM,48,-122,12,12,24
27287,FremontBridge,11/13/2015 11:00:00 PM,48,-122,6,0,6
27288,FremontBridge,11/14/2015 12:00:00 AM,48,-122,4,2,6
27289,FremontBridge,11/14/2015 01:00:00 AM,48,-122,5,1,6
27290,FremontBridge,11/14/2015 02:00:00 AM,48,-122,1,1,2
27291,FremontBridge,11/14/2015 03:00:00 AM,48,-122,1,0,1
27292,FremontBridge,11/14/2015 04:00:00 AM,48,-122,2,0,2
27293,FremontBridge,11/14/2015 05:00:00 AM,48,-122,1,4,5
27294,FremontBridge,11/14/2015 06:00:00 AM,48,-122,5,3,8
27295,FremontBridge,11/14/2015 07:00:00 AM,48,-122,9,10,19
27296,FremontBridge,11/14/2015 08:00:00 AM,48,-122,9,17,26
27297,FremontBridge,11/14/2015 09:00:00 AM,48,-122,13,10,23
27298,FremontBridge,11/14/2015 10:00:00 AM,48,-122,7,13,20
27299,FremontBridge,11/14/2015 11:00:00 AM,48,-122,18,27,45
27300,FremontBridge,11/14/2015 12:00:00 PM,48,-122,18,27,45
27301,FremontBridge,11/14/2015 01:00:00 PM,48,-122,15,16,31
27302,FremontBridge,11/14/2015 02:00:00 PM,48,-122,14,12,26
27303,FremontBridge,11/14/2015 03:00:00 PM,48,-122,14,12,26
27304,FremontBridge,11/14/2015 04:00:00 PM,48,-122,13,11,24
27305,FremontBridge,11/14/2015 05:00:00 PM,48,-122,8,11,19
27306,FremontBridge,11/14/2015 06:00:00 PM,48,-122,9,10,19
27307,FremontBridge,11/14/2015 07:00:00 PM,48,-122,8,9,17
27308,FremontBridge,11/14/2015 08:00:00 PM,48,-122,5,3,8
27309,FremontBridge,11/14/2015 09:00:00 PM,48,-122,6,2,8
27310,FremontBridge,11/14/2015 10:00:00 PM,48,-122,2,3,5
27311,FremontBridge,11/14/2015 11:00:00 PM,48,-122,11,3,14
27312,FremontBridge,11/15/2015 12:00:00 AM,48,-122,3,2,5
27313,FremontBridge,11/15/2015 01:00:00 AM,48,-122,2,4,6
27314,FremontBridge,11/15/2015 02:00:00 AM,48,-122,0,0,0
27315,FremontBridge,11/15/2015 03:00:00 AM,48,-122,1,0,1
27316,FremontBridge,11/15/2015 04:00:00 AM,48,-122,1,0,1
27317,FremontBridge,11/15/2015 05:00:00 AM,48,-122,1,2,3
27318,FremontBridge,11/15/2015 06:00:00 AM,48,-122,3,6,9
27319,FremontBridge,11/15/2015 07:00:00 AM,48,-122,2,6,8
27320,FremontBridge,11/15/2015 08:00:00 AM,48,-122,7,12,19
27321,FremontBridge,11/15/2015 09:00:00 AM,48,-122,13,16,29
27322,FremontBridge,11/15/2015 10:00:00 AM,48,-122,21,17,38
27323,FremontBridge,11/15/2015 11:00:00 AM,48,-122,20,42,62
27324,FremontBridge,11/15/2015 12:00:00 PM,48,-122,40,44,84
27325,FremontBridge,11/15/2015 01:00:00 PM,48,-122,37,71,108
27326,FremontBridge,11/15/2015 02:00:00 PM,48,-122,48,51,99
27327,FremontBridge,11/15/2015 03:00:00 PM,48,-122,50,61,111
27328,FremontBridge,11/15/2015 04:00:00 PM,48,-122,37,55,92
27329,FremontBridge,11/15/2015 05:00:00 PM,48,-122,28,25,53
27330,FremontBridge,11/15/2015 06:00:00 PM,48,-122,19,14,33
27331,FremontBridge,11/15/2015 07:00:00 PM,48,-122,5,9,14
27332,FremontBridge,11/15/2015 08:00:00 PM,48,-122,7,7,14
27333,FremontBridge,11/15/2015 09:00:00 PM,48,-122,4,5,9
27334,FremontBridge,11/15/2015 10:00:00 PM,48,-122,13,8,21
27335,FremontBridge,11/15/2015 11:00:00 PM,48,-122,8,6,14
27336,FremontBridge,11/16/2015 12:00:00 AM,48,-122,4,4,8
27337,FremontBridge,11/16/2015 01:00:00 AM,48,-122,0,1,1
27338,FremontBridge,11/16/2015 02:00:00 AM,48,-122,1,2,3
27339,FremontBridge,11/16/2015 03:00:00 AM,48,-122,0,1,1
27340,FremontBridge,11/16/2015 04:00:00 AM,48,-122,2,2,4
27341,FremontBridge,11/16/2015 05:00:00 AM,48,-122,12,13,25
27342,FremontBridge,11/16/2015 06:00:00 AM,48,-122,36,67,103
27343,FremontBridge,11/16/2015 07:00:00 AM,48,-122,91,216,307
27344,FremontBridge,11/16/2015 08:00:00 AM,48,-122,139,255,394
27345,FremontBridge,11/16/2015 09:00:00 AM,48,-122,75,137,212
27346,FremontBridge,11/16/2015 10:00:00 AM,48,-122,24,32,56
27347,FremontBridge,11/16/2015 11:00:00 AM,48,-122,22,33,55
27348,FremontBridge,11/16/2015 12:00:00 PM,48,-122,12,14,26
27349,FremontBridge,11/16/2015 01:00:00 PM,48,-122,21,19,40
27350,FremontBridge,11/16/2015 02:00:00 PM,48,-122,26,15,41
27351,FremontBridge,11/16/2015 03:00:00 PM,48,-122,48,27,75
27352,FremontBridge,11/16/2015 04:00:00 PM,48,-122,113,78,191
27353,FremontBridge,11/16/2015 05:00:00 PM,48,-122,301,108,409
27354,FremontBridge,11/16/2015 06:00:00 PM,48,-122,182,72,254
27355,FremontBridge,11/16/2015 07:00:00 PM,48,-122,67,23,90
27356,FremontBridge,11/16/2015 08:00:00 PM,48,-122,28,17,45
27357,FremontBridge,11/16/2015 09:00:00 PM,48,-122,22,14,36
27358,FremontBridge,11/16/2015 10:00:00 PM,48,-122,12,7,19
27359,FremontBridge,11/16/2015 11:00:00 PM,48,-122,4,4,8
27360,FremontBridge,11/17/2015 12:00:00 AM,48,-122,0,3,3
27361,FremontBridge,11/17/2015 01:00:00 AM,48,-122,3,3,6
27362,FremontBridge,11/17/2015 02:00:00 AM,48,-122,2,2,4
27363,FremontBridge,11/17/2015 03:00:00 AM,48,-122,0,3,3
27364,FremontBridge,11/17/2015 04:00:00 AM,48,-122,2,4,6
27365,FremontBridge,11/17/2015 05:00:00 AM,48,-122,8,18,26
27366,FremontBridge,11/17/2015 06:00:00 AM,48,-122,18,46,64
27367,FremontBridge,11/17/2015 07:00:00 AM,48,-122,69,165,234
27368,FremontBridge,11/17/2015 08:00:00 AM,48,-122,92,211,303
27369,FremontBridge,11/17/2015 09:00:00 AM,48,-122,46,85,131
27370,FremontBridge,11/17/2015 10:00:00 AM,48,-122,23,22,45
27371,FremontBridge,11/17/2015 11:00:00 AM,48,-122,3,15,18
27372,FremontBridge,11/17/2015 12:00:00 PM,48,-122,16,11,27
27373,FremontBridge,11/17/2015 01:00:00 PM,48,-122,16,16,32
27374,FremontBridge,11/17/2015 02:00:00 PM,48,-122,20,14,34
27375,FremontBridge,11/17/2015 03:00:00 PM,48,-122,31,17,48
27376,FremontBridge,11/17/2015 04:00:00 PM,48,-122,101,60,161
27377,FremontBridge,11/17/2015 05:00:00 PM,48,-122,226,82,308
27378,FremontBridge,11/17/2015 06:00:00 PM,48,-122,130,59,189
27379,FremontBridge,11/17/2015 07:00:00 PM,48,-122,52,18,70
27380,FremontBridge,11/17/2015 08:00:00 PM,48,-122,24,9,33
27381,FremontBridge,11/17/2015 09:00:00 PM,48,-122,12,9,21
27382,FremontBridge,11/17/2015 10:00:00 PM,48,-122,6,7,13
27383,FremontBridge,11/17/2015 11:00:00 PM,48,-122,5,4,9
27384,FremontBridge,11/18/2015 12:00:00 AM,48,-122,4,3,7
27385,FremontBridge,11/18/2015 01:00:00 AM,48,-122,3,1,4
27386,FremontBridge,11/18/2015 02:00:00 AM,48,-122,0,1,1
27387,FremontBridge,11/18/2015 03:00:00 AM,48,-122,1,2,3
27388,FremontBridge,11/18/2015 04:00:00 AM,48,-122,4,4,8
27389,FremontBridge,11/18/2015 05:00:00 AM,48,-122,8,27,35
27390,FremontBridge,11/18/2015 06:00:00 AM,48,-122,46,67,113
27391,FremontBridge,11/18/2015 07:00:00 AM,48,-122,85,237,322
27392,FremontBridge,11/18/2015 08:00:00 AM,48,-122,144,306,450
27393,FremontBridge,11/18/2015 09:00:00 AM,48,-122,76,136,212
27394,FremontBridge,11/18/2015 10:00:00 AM,48,-122,40,53,93
27395,FremontBridge,11/18/2015 11:00:00 AM,48,-122,25,28,53
27396,FremontBridge,11/18/2015 12:00:00 PM,48,-122,35,29,64
27397,FremontBridge,11/18/2015 01:00:00 PM,48,-122,42,42,84
27398,FremontBridge,11/18/2015 02:00:00 PM,48,-122,38,35,73
27399,FremontBridge,11/18/2015 03:00:00 PM,48,-122,61,53,114
27400,FremontBridge,11/18/2015 04:00:00 PM,48,-122,156,84,240
27401,FremontBridge,11/18/2015 05:00:00 PM,48,-122,329,138,467
27402,FremontBridge,11/18/2015 06:00:00 PM,48,-122,223,90,313
27403,FremontBridge,11/18/2015 07:00:00 PM,48,-122,79,37,116
27404,FremontBridge,11/18/2015 08:00:00 PM,48,-122,59,22,81
27405,FremontBridge,11/18/2015 09:00:00 PM,48,-122,20,21,41
27406,FremontBridge,11/18/2015 10:00:00 PM,48,-122,10,12,22
27407,FremontBridge,11/18/2015 11:00:00 PM,48,-122,8,3,11
27408,FremontBridge,11/19/2015 12:00:00 AM,48,-122,2,7,9
27409,FremontBridge,11/19/2015 01:00:00 AM,48,-122,1,3,4
27410,FremontBridge,11/19/2015 02:00:00 AM,48,-122,1,0,1
27411,FremontBridge,11/19/2015 03:00:00 AM,48,-122,0,2,2
27412,FremontBridge,11/19/2015 04:00:00 AM,48,-122,4,3,7
27413,FremontBridge,11/19/2015 05:00:00 AM,48,-122,9,25,34
27414,FremontBridge,11/19/2015 06:00:00 AM,48,-122,29,74,103
27415,FremontBridge,11/19/2015 07:00:00 AM,48,-122,76,231,307
27416,FremontBridge,11/19/2015 08:00:00 AM,48,-122,146,291,437
27417,FremontBridge,11/19/2015 09:00:00 AM,48,-122,98,120,218
27418,FremontBridge,11/19/2015 10:00:00 AM,48,-122,34,66,100
27419,FremontBridge,11/19/2015 11:00:00 AM,48,-122,30,41,71
27420,FremontBridge,11/19/2015 12:00:00 PM,48,-122,34,27,61
27421,FremontBridge,11/19/2015 01:00:00 PM,48,-122,28,39,67
27422,FremontBridge,11/19/2015 02:00:00 PM,48,-122,44,39,83
27423,FremontBridge,11/19/2015 03:00:00 PM,48,-122,73,50,123
27424,FremontBridge,11/19/2015 04:00:00 PM,48,-122,144,93,237
27425,FremontBridge,11/19/2015 05:00:00 PM,48,-122,322,99,421
27426,FremontBridge,11/19/2015 06:00:00 PM,48,-122,215,98,313
27427,FremontBridge,11/19/2015 07:00:00 PM,48,-122,96,48,144
27428,FremontBridge,11/19/2015 08:00:00 PM,48,-122,49,26,75
27429,FremontBridge,11/19/2015 09:00:00 PM,48,-122,46,17,63
27430,FremontBridge,11/19/2015 10:00:00 PM,48,-122,21,11,32
27431,FremontBridge,11/19/2015 11:00:00 PM,48,-122,15,10,25
27432,FremontBridge,11/20/2015 12:00:00 AM,48,-122,5,5,10
27433,FremontBridge,11/20/2015 01:00:00 AM,48,-122,4,3,7
27434,FremontBridge,11/20/2015 02:00:00 AM,48,-122,0,1,1
27435,FremontBridge,11/20/2015 03:00:00 AM,48,-122,0,1,1
27436,FremontBridge,11/20/2015 04:00:00 AM,48,-122,4,5,9
27437,FremontBridge,11/20/2015 05:00:00 AM,48,-122,16,18,34
27438,FremontBridge,11/20/2015 06:00:00 AM,48,-122,28,58,86
27439,FremontBridge,11/20/2015 07:00:00 AM,48,-122,68,170,238
27440,FremontBridge,11/20/2015 08:00:00 AM,48,-122,116,252,368
27441,FremontBridge,11/20/2015 09:00:00 AM,48,-122,83,142,225
27442,FremontBridge,11/20/2015 10:00:00 AM,48,-122,37,36,73
27443,FremontBridge,11/20/2015 11:00:00 AM,48,-122,29,28,57
27444,FremontBridge,11/20/2015 12:00:00 PM,48,-122,33,41,74
27445,FremontBridge,11/20/2015 01:00:00 PM,48,-122,39,36,75
27446,FremontBridge,11/20/2015 02:00:00 PM,48,-122,51,37,88
27447,FremontBridge,11/20/2015 03:00:00 PM,48,-122,61,52,113
27448,FremontBridge,11/20/2015 04:00:00 PM,48,-122,164,69,233
27449,FremontBridge,11/20/2015 05:00:00 PM,48,-122,257,116,373
27450,FremontBridge,11/20/2015 06:00:00 PM,48,-122,154,69,223
27451,FremontBridge,11/20/2015 07:00:00 PM,48,-122,67,35,102
27452,FremontBridge,11/20/2015 08:00:00 PM,48,-122,32,13,45
27453,FremontBridge,11/20/2015 09:00:00 PM,48,-122,24,9,33
27454,FremontBridge,11/20/2015 10:00:00 PM,48,-122,13,13,26
27455,FremontBridge,11/20/2015 11:00:00 PM,48,-122,18,8,26
27456,FremontBridge,11/21/2015 12:00:00 AM,48,-122,2,8,10
27457,FremontBridge,11/21/2015 01:00:00 AM,48,-122,1,4,5
27458,FremontBridge,11/21/2015 02:00:00 AM,48,-122,0,0,0
27459,FremontBridge,11/21/2015 03:00:00 AM,48,-122,1,0,1
27460,FremontBridge,11/21/2015 04:00:00 AM,48,-122,3,1,4
27461,FremontBridge,11/21/2015 05:00:00 AM,48,-122,5,1,6
27462,FremontBridge,11/21/2015 06:00:00 AM,48,-122,4,9,13
27463,FremontBridge,11/21/2015 07:00:00 AM,48,-122,12,13,25
27464,FremontBridge,11/21/2015 08:00:00 AM,48,-122,21,28,49
27465,FremontBridge,11/21/2015 09:00:00 AM,48,-122,23,26,49
27466,FremontBridge,11/21/2015 10:00:00 AM,48,-122,42,40,82
27467,FremontBridge,11/21/2015 11:00:00 AM,48,-122,44,69,113
27468,FremontBridge,11/21/2015 12:00:00 PM,48,-122,71,73,144
27469,FremontBridge,11/21/2015 01:00:00 PM,48,-122,40,79,119
27470,FremontBridge,11/21/2015 02:00:00 PM,48,-122,55,62,117
27471,FremontBridge,11/21/2015 03:00:00 PM,48,-122,46,65,111
27472,FremontBridge,11/21/2015 04:00:00 PM,48,-122,29,49,78
27473,FremontBridge,11/21/2015 05:00:00 PM,48,-122,26,23,49
27474,FremontBridge,11/21/2015 06:00:00 PM,48,-122,17,20,37
27475,FremontBridge,11/21/2015 07:00:00 PM,48,-122,17,15,32
27476,FremontBridge,11/21/2015 08:00:00 PM,48,-122,11,6,17
27477,FremontBridge,11/21/2015 09:00:00 PM,48,-122,11,12,23
27478,FremontBridge,11/21/2015 10:00:00 PM,48,-122,18,6,24
27479,FremontBridge,11/21/2015 11:00:00 PM,48,-122,3,8,11
27480,FremontBridge,11/22/2015 12:00:00 AM,48,-122,6,5,11
27481,FremontBridge,11/22/2015 01:00:00 AM,48,-122,1,2,3
27482,FremontBridge,11/22/2015 02:00:00 AM,48,-122,2,3,5
27483,FremontBridge,11/22/2015 03:00:00 AM,48,-122,1,1,2
27484,FremontBridge,11/22/2015 04:00:00 AM,48,-122,0,1,1
27485,FremontBridge,11/22/2015 05:00:00 AM,48,-122,1,1,2
27486,FremontBridge,11/22/2015 06:00:00 AM,48,-122,3,2,5
27487,FremontBridge,11/22/2015 07:00:00 AM,48,-122,5,10,15
27488,FremontBridge,11/22/2015 08:00:00 AM,48,-122,17,22,39
27489,FremontBridge,11/22/2015 09:00:00 AM,48,-122,35,29,64
27490,FremontBridge,11/22/2015 10:00:00 AM,48,-122,29,35,64
27491,FremontBridge,11/22/2015 11:00:00 AM,48,-122,33,52,85
27492,FremontBridge,11/22/2015 12:00:00 PM,48,-122,44,48,92
27493,FremontBridge,11/22/2015 01:00:00 PM,48,-122,41,56,97
27494,FremontBridge,11/22/2015 02:00:00 PM,48,-122,60,70,130
27495,FremontBridge,11/22/2015 03:00:00 PM,48,-122,42,81,123
27496,FremontBridge,11/22/2015 04:00:00 PM,48,-122,31,36,67
27497,FremontBridge,11/22/2015 05:00:00 PM,48,-122,24,33,57
27498,FremontBridge,11/22/2015 06:00:00 PM,48,-122,17,21,38
27499,FremontBridge,11/22/2015 07:00:00 PM,48,-122,13,7,20
27500,FremontBridge,11/22/2015 08:00:00 PM,48,-122,10,3,13
27501,FremontBridge,11/22/2015 09:00:00 PM,48,-122,3,2,5
27502,FremontBridge,11/22/2015 10:00:00 PM,48,-122,6,3,9
27503,FremontBridge,11/22/2015 11:00:00 PM,48,-122,9,2,11
27504,FremontBridge,11/23/2015 12:00:00 AM,48,-122,2,1,3
27505,FremontBridge,11/23/2015 01:00:00 AM,48,-122,0,1,1
27506,FremontBridge,11/23/2015 02:00:00 AM,48,-122,1,0,1
27507,FremontBridge,11/23/2015 03:00:00 AM,48,-122,1,3,4
27508,FremontBridge,11/23/2015 04:00:00 AM,48,-122,5,0,5
27509,FremontBridge,11/23/2015 05:00:00 AM,48,-122,9,19,28
27510,FremontBridge,11/23/2015 06:00:00 AM,48,-122,35,64,99
27511,FremontBridge,11/23/2015 07:00:00 AM,48,-122,83,211,294
27512,FremontBridge,11/23/2015 08:00:00 AM,48,-122,111,222,333
27513,FremontBridge,11/23/2015 09:00:00 AM,48,-122,72,127,199
27514,FremontBridge,11/23/2015 10:00:00 AM,48,-122,33,28,61
27515,FremontBridge,11/23/2015 11:00:00 AM,48,-122,23,40,63
27516,FremontBridge,11/23/2015 12:00:00 PM,48,-122,27,30,57
27517,FremontBridge,11/23/2015 01:00:00 PM,48,-122,16,26,42
27518,FremontBridge,11/23/2015 02:00:00 PM,48,-122,32,16,48
27519,FremontBridge,11/23/2015 03:00:00 PM,48,-122,48,34,82
27520,FremontBridge,11/23/2015 04:00:00 PM,48,-122,129,61,190
27521,FremontBridge,11/23/2015 05:00:00 PM,48,-122,286,89,375
27522,FremontBridge,11/23/2015 06:00:00 PM,48,-122,161,60,221
27523,FremontBridge,11/23/2015 07:00:00 PM,48,-122,64,29,93
27524,FremontBridge,11/23/2015 08:00:00 PM,48,-122,26,13,39
27525,FremontBridge,11/23/2015 09:00:00 PM,48,-122,8,9,17
27526,FremontBridge,11/23/2015 10:00:00 PM,48,-122,9,9,18
27527,FremontBridge,11/23/2015 11:00:00 PM,48,-122,1,4,5
27528,FremontBridge,11/24/2015 12:00:00 AM,48,-122,2,2,4
27529,FremontBridge,11/24/2015 01:00:00 AM,48,-122,2,2,4
27530,FremontBridge,11/24/2015 02:00:00 AM,48,-122,1,1,2
27531,FremontBridge,11/24/2015 03:00:00 AM,48,-122,2,0,2
27532,FremontBridge,11/24/2015 04:00:00 AM,48,-122,2,3,5
27533,FremontBridge,11/24/2015 05:00:00 AM,48,-122,11,12,23
27534,FremontBridge,11/24/2015 06:00:00 AM,48,-122,27,47,74
27535,FremontBridge,11/24/2015 07:00:00 AM,48,-122,59,132,191
27536,FremontBridge,11/24/2015 08:00:00 AM,48,-122,83,192,275
27537,FremontBridge,11/24/2015 09:00:00 AM,48,-122,54,99,153
27538,FremontBridge,11/24/2015 10:00:00 AM,48,-122,32,36,68
27539,FremontBridge,11/24/2015 11:00:00 AM,48,-122,26,18,44
27540,FremontBridge,11/24/2015 12:00:00 PM,48,-122,31,17,48
27541,FremontBridge,11/24/2015 01:00:00 PM,48,-122,22,23,45
27542,FremontBridge,11/24/2015 02:00:00 PM,48,-122,29,22,51
27543,FremontBridge,11/24/2015 03:00:00 PM,48,-122,60,33,93
27544,FremontBridge,11/24/2015 04:00:00 PM,48,-122,109,57,166
27545,FremontBridge,11/24/2015 05:00:00 PM,48,-122,229,94,323
27546,FremontBridge,11/24/2015 06:00:00 PM,48,-122,165,53,218
27547,FremontBridge,11/24/2015 07:00:00 PM,48,-122,55,22,77
27548,FremontBridge,11/24/2015 08:00:00 PM,48,-122,25,10,35
27549,FremontBridge,11/24/2015 09:00:00 PM,48,-122,9,15,24
27550,FremontBridge,11/24/2015 10:00:00 PM,48,-122,8,12,20
27551,FremontBridge,11/24/2015 11:00:00 PM,48,-122,4,3,7
27552,FremontBridge,11/25/2015 12:00:00 AM,48,-122,3,3,6
27553,FremontBridge,11/25/2015 01:00:00 AM,48,-122,0,1,1
27554,FremontBridge,11/25/2015 02:00:00 AM,48,-122,3,2,5
27555,FremontBridge,11/25/2015 03:00:00 AM,48,-122,1,1,2
27556,FremontBridge,11/25/2015 04:00:00 AM,48,-122,6,0,6
27557,FremontBridge,11/25/2015 05:00:00 AM,48,-122,8,14,22
27558,FremontBridge,11/25/2015 06:00:00 AM,48,-122,32,46,78
27559,FremontBridge,11/25/2015 07:00:00 AM,48,-122,57,153,210
27560,FremontBridge,11/25/2015 08:00:00 AM,48,-122,84,187,271
27561,FremontBridge,11/25/2015 09:00:00 AM,48,-122,61,91,152
27562,FremontBridge,11/25/2015 10:00:00 AM,48,-122,26,35,61
27563,FremontBridge,11/25/2015 11:00:00 AM,48,-122,32,28,60
27564,FremontBridge,11/25/2015 12:00:00 PM,48,-122,27,30,57
27565,FremontBridge,11/25/2015 01:00:00 PM,48,-122,44,32,76
27566,FremontBridge,11/25/2015 02:00:00 PM,48,-122,65,42,107
27567,FremontBridge,11/25/2015 03:00:00 PM,48,-122,112,72,184
27568,FremontBridge,11/25/2015 04:00:00 PM,48,-122,156,70,226
27569,FremontBridge,11/25/2015 05:00:00 PM,48,-122,167,79,246
27570,FremontBridge,11/25/2015 06:00:00 PM,48,-122,93,34,127
27571,FremontBridge,11/25/2015 07:00:00 PM,48,-122,24,22,46
27572,FremontBridge,11/25/2015 08:00:00 PM,48,-122,23,8,31
27573,FremontBridge,11/25/2015 09:00:00 PM,48,-122,11,10,21
27574,FremontBridge,11/25/2015 10:00:00 PM,48,-122,2,7,9
27575,FremontBridge,11/25/2015 11:00:00 PM,48,-122,7,5,12
27576,FremontBridge,11/26/2015 12:00:00 AM,48,-122,4,3,7
27577,FremontBridge,11/26/2015 01:00:00 AM,48,-122,3,4,7
27578,FremontBridge,11/26/2015 02:00:00 AM,48,-122,0,3,3
27579,FremontBridge,11/26/2015 03:00:00 AM,48,-122,1,1,2
27580,FremontBridge,11/26/2015 04:00:00 AM,48,-122,1,0,1
27581,FremontBridge,11/26/2015 05:00:00 AM,48,-122,2,2,4
27582,FremontBridge,11/26/2015 06:00:00 AM,48,-122,2,5,7
27583,FremontBridge,11/26/2015 07:00:00 AM,48,-122,4,6,10
27584,FremontBridge,11/26/2015 08:00:00 AM,48,-122,8,5,13
27585,FremontBridge,11/26/2015 09:00:00 AM,48,-122,12,12,24
27586,FremontBridge,11/26/2015 10:00:00 AM,48,-122,16,22,38
27587,FremontBridge,11/26/2015 11:00:00 AM,48,-122,20,33,53
27588,FremontBridge,11/26/2015 12:00:00 PM,48,-122,34,46,80
27589,FremontBridge,11/26/2015 01:00:00 PM,48,-122,33,28,61
27590,FremontBridge,11/26/2015 02:00:00 PM,48,-122,31,34,65
27591,FremontBridge,11/26/2015 03:00:00 PM,48,-122,12,14,26
27592,FremontBridge,11/26/2015 04:00:00 PM,48,-122,7,14,21
27593,FremontBridge,11/26/2015 05:00:00 PM,48,-122,2,5,7
27594,FremontBridge,11/26/2015 06:00:00 PM,48,-122,4,5,9
27595,FremontBridge,11/26/2015 07:00:00 PM,48,-122,5,4,9
27596,FremontBridge,11/26/2015 08:00:00 PM,48,-122,7,1,8
27597,FremontBridge,11/26/2015 09:00:00 PM,48,-122,60,5,65
27598,FremontBridge,11/26/2015 10:00:00 PM,48,-122,2,2,4
27599,FremontBridge,11/26/2015 11:00:00 PM,48,-122,3,5,8
27600,FremontBridge,11/27/2015 12:00:00 AM,48,-122,5,4,9
27601,FremontBridge,11/27/2015 01:00:00 AM,48,-122,1,3,4
27602,FremontBridge,11/27/2015 02:00:00 AM,48,-122,0,3,3
27603,FremontBridge,11/27/2015 03:00:00 AM,48,-122,1,0,1
27604,FremontBridge,11/27/2015 04:00:00 AM,48,-122,2,2,4
27605,FremontBridge,11/27/2015 05:00:00 AM,48,-122,2,7,9
27606,FremontBridge,11/27/2015 06:00:00 AM,48,-122,7,9,16
27607,FremontBridge,11/27/2015 07:00:00 AM,48,-122,7,13,20
27608,FremontBridge,11/27/2015 08:00:00 AM,48,-122,12,15,27
27609,FremontBridge,11/27/2015 09:00:00 AM,48,-122,23,35,58
27610,FremontBridge,11/27/2015 10:00:00 AM,48,-122,37,28,65
27611,FremontBridge,11/27/2015 11:00:00 AM,48,-122,28,69,97
27612,FremontBridge,11/27/2015 12:00:00 PM,48,-122,38,28,66
27613,FremontBridge,11/27/2015 01:00:00 PM,48,-122,31,32,63
27614,FremontBridge,11/27/2015 02:00:00 PM,48,-122,47,52,99
27615,FremontBridge,11/27/2015 03:00:00 PM,48,-122,47,45,92
27616,FremontBridge,11/27/2015 04:00:00 PM,48,-122,32,46,78
27617,FremontBridge,11/27/2015 05:00:00 PM,48,-122,22,20,42
27618,FremontBridge,11/27/2015 06:00:00 PM,48,-122,30,19,49
27619,FremontBridge,11/27/2015 07:00:00 PM,48,-122,14,9,23
27620,FremontBridge,11/27/2015 08:00:00 PM,48,-122,18,7,25
27621,FremontBridge,11/27/2015 09:00:00 PM,48,-122,4,3,7
27622,FremontBridge,11/27/2015 10:00:00 PM,48,-122,8,10,18
27623,FremontBridge,11/27/2015 11:00:00 PM,48,-122,5,2,7
27624,FremontBridge,11/28/2015 12:00:00 AM,48,-122,3,2,5
27625,FremontBridge,11/28/2015 01:00:00 AM,48,-122,5,0,5
27626,FremontBridge,11/28/2015 02:00:00 AM,48,-122,1,0,1
27627,FremontBridge,11/28/2015 03:00:00 AM,48,-122,0,4,4
27628,FremontBridge,11/28/2015 04:00:00 AM,48,-122,2,3,5
27629,FremontBridge,11/28/2015 05:00:00 AM,48,-122,1,4,5
27630,FremontBridge,11/28/2015 06:00:00 AM,48,-122,2,2,4
27631,FremontBridge,11/28/2015 07:00:00 AM,48,-122,8,7,15
27632,FremontBridge,11/28/2015 08:00:00 AM,48,-122,14,12,26
27633,FremontBridge,11/28/2015 09:00:00 AM,48,-122,11,23,34
27634,FremontBridge,11/28/2015 10:00:00 AM,48,-122,21,32,53
27635,FremontBridge,11/28/2015 11:00:00 AM,48,-122,29,35,64
27636,FremontBridge,11/28/2015 12:00:00 PM,48,-122,19,57,76
27637,FremontBridge,11/28/2015 01:00:00 PM,48,-122,40,53,93
27638,FremontBridge,11/28/2015 02:00:00 PM,48,-122,40,59,99
27639,FremontBridge,11/28/2015 03:00:00 PM,48,-122,51,55,106
27640,FremontBridge,11/28/2015 04:00:00 PM,48,-122,39,35,74
27641,FremontBridge,11/28/2015 05:00:00 PM,48,-122,23,14,37
27642,FremontBridge,11/28/2015 06:00:00 PM,48,-122,17,9,26
27643,FremontBridge,11/28/2015 07:00:00 PM,48,-122,13,8,21
27644,FremontBridge,11/28/2015 08:00:00 PM,48,-122,9,3,12
27645,FremontBridge,11/28/2015 09:00:00 PM,48,-122,3,10,13
27646,FremontBridge,11/28/2015 10:00:00 PM,48,-122,3,8,11
27647,FremontBridge,11/28/2015 11:00:00 PM,48,-122,5,4,9
27648,FremontBridge,11/29/2015 12:00:00 AM,48,-122,2,2,4
27649,FremontBridge,11/29/2015 01:00:00 AM,48,-122,4,0,4
27650,FremontBridge,11/29/2015 02:00:00 AM,48,-122,1,1,2
27651,FremontBridge,11/29/2015 03:00:00 AM,48,-122,1,1,2
27652,FremontBridge,11/29/2015 04:00:00 AM,48,-122,0,0,0
27653,FremontBridge,11/29/2015 05:00:00 AM,48,-122,1,2,3
27654,FremontBridge,11/29/2015 06:00:00 AM,48,-122,1,1,2
27655,FremontBridge,11/29/2015 07:00:00 AM,48,-122,7,4,11
27656,FremontBridge,11/29/2015 08:00:00 AM,48,-122,4,10,14
27657,FremontBridge,11/29/2015 09:00:00 AM,48,-122,12,13,25
27658,FremontBridge,11/29/2015 10:00:00 AM,48,-122,17,24,41
27659,FremontBridge,11/29/2015 11:00:00 AM,48,-122,36,32,68
27660,FremontBridge,11/29/2015 12:00:00 PM,48,-122,35,29,64
27661,FremontBridge,11/29/2015 01:00:00 PM,48,-122,41,33,74
27662,FremontBridge,11/29/2015 02:00:00 PM,48,-122,30,33,63
27663,FremontBridge,11/29/2015 03:00:00 PM,48,-122,30,33,63
27664,FremontBridge,11/29/2015 04:00:00 PM,48,-122,17,24,41
27665,FremontBridge,11/29/2015 05:00:00 PM,48,-122,31,13,44
27666,FremontBridge,11/29/2015 06:00:00 PM,48,-122,13,12,25
27667,FremontBridge,11/29/2015 07:00:00 PM,48,-122,7,7,14
27668,FremontBridge,11/29/2015 08:00:00 PM,48,-122,9,5,14
27669,FremontBridge,11/29/2015 09:00:00 PM,48,-122,7,6,13
27670,FremontBridge,11/29/2015 10:00:00 PM,48,-122,5,3,8
27671,FremontBridge,11/29/2015 11:00:00 PM,48,-122,1,5,6
27672,FremontBridge,11/30/2015 12:00:00 AM,48,-122,2,0,2
27673,FremontBridge,11/30/2015 01:00:00 AM,48,-122,3,0,3
27674,FremontBridge,11/30/2015 02:00:00 AM,48,-122,1,0,1
27675,FremontBridge,11/30/2015 03:00:00 AM,48,-122,2,3,5
27676,FremontBridge,11/30/2015 04:00:00 AM,48,-122,1,2,3
27677,FremontBridge,11/30/2015 05:00:00 AM,48,-122,12,20,32
27678,FremontBridge,11/30/2015 06:00:00 AM,48,-122,34,45,79
27679,FremontBridge,11/30/2015 07:00:00 AM,48,-122,63,201,264
27680,FremontBridge,11/30/2015 08:00:00 AM,48,-122,121,251,372
27681,FremontBridge,11/30/2015 09:00:00 AM,48,-122,69,115,184
27682,FremontBridge,11/30/2015 10:00:00 AM,48,-122,16,36,52
27683,FremontBridge,11/30/2015 11:00:00 AM,48,-122,21,36,57
27684,FremontBridge,11/30/2015 12:00:00 PM,48,-122,17,31,48
27685,FremontBridge,11/30/2015 01:00:00 PM,48,-122,39,26,65
27686,FremontBridge,11/30/2015 02:00:00 PM,48,-122,36,34,70
27687,FremontBridge,11/30/2015 03:00:00 PM,48,-122,47,36,83
27688,FremontBridge,11/30/2015 04:00:00 PM,48,-122,115,70,185
27689,FremontBridge,11/30/2015 05:00:00 PM,48,-122,277,102,379
27690,FremontBridge,11/30/2015 06:00:00 PM,48,-122,210,69,279
27691,FremontBridge,11/30/2015 07:00:00 PM,48,-122,60,22,82
27692,FremontBridge,11/30/2015 08:00:00 PM,48,-122,26,21,47
27693,FremontBridge,11/30/2015 09:00:00 PM,48,-122,13,6,19
27694,FremontBridge,11/30/2015 10:00:00 PM,48,-122,9,4,13
27695,FremontBridge,11/30/2015 11:00:00 PM,48,-122,3,2,5
27696,FremontBridge,12/01/2015 12:00:00 AM,48,-122,4,4,8
27697,FremontBridge,12/01/2015 01:00:00 AM,48,-122,0,2,2
27698,FremontBridge,12/01/2015 02:00:00 AM,48,-122,1,1,2
27699,FremontBridge,12/01/2015 03:00:00 AM,48,-122,0,3,3
27700,FremontBridge,12/01/2015 04:00:00 AM,48,-122,3,2,5
27701,FremontBridge,12/01/2015 05:00:00 AM,48,-122,15,21,36
27702,FremontBridge,12/01/2015 06:00:00 AM,48,-122,30,66,96
27703,FremontBridge,12/01/2015 07:00:00 AM,48,-122,85,225,310
27704,FremontBridge,12/01/2015 08:00:00 AM,48,-122,111,294,405
27705,FremontBridge,12/01/2015 09:00:00 AM,48,-122,81,127,208
27706,FremontBridge,12/01/2015 10:00:00 AM,48,-122,34,42,76
27707,FremontBridge,12/01/2015 11:00:00 AM,48,-122,34,27,61
27708,FremontBridge,12/01/2015 12:00:00 PM,48,-122,28,20,48
27709,FremontBridge,12/01/2015 01:00:00 PM,48,-122,32,31,63
27710,FremontBridge,12/01/2015 02:00:00 PM,48,-122,37,27,64
27711,FremontBridge,12/01/2015 03:00:00 PM,48,-122,68,42,110
27712,FremontBridge,12/01/2015 04:00:00 PM,48,-122,148,83,231
27713,FremontBridge,12/01/2015 05:00:00 PM,48,-122,310,109,419
27714,FremontBridge,12/01/2015 06:00:00 PM,48,-122,181,73,254
27715,FremontBridge,12/01/2015 07:00:00 PM,48,-122,68,35,103
27716,FremontBridge,12/01/2015 08:00:00 PM,48,-122,39,11,50
27717,FremontBridge,12/01/2015 09:00:00 PM,48,-122,20,5,25
27718,FremontBridge,12/01/2015 10:00:00 PM,48,-122,6,7,13
27719,FremontBridge,12/01/2015 11:00:00 PM,48,-122,4,2,6
27720,FremontBridge,12/02/2015 12:00:00 AM,48,-122,4,1,5
27721,FremontBridge,12/02/2015 01:00:00 AM,48,-122,0,1,1
27722,FremontBridge,12/02/2015 02:00:00 AM,48,-122,2,1,3
27723,FremontBridge,12/02/2015 03:00:00 AM,48,-122,1,5,6
27724,FremontBridge,12/02/2015 04:00:00 AM,48,-122,1,7,8
27725,FremontBridge,12/02/2015 05:00:00 AM,48,-122,8,21,29
27726,FremontBridge,12/02/2015 06:00:00 AM,48,-122,39,77,116
27727,FremontBridge,12/02/2015 07:00:00 AM,48,-122,76,198,274
27728,FremontBridge,12/02/2015 08:00:00 AM,48,-122,128,230,358
27729,FremontBridge,12/02/2015 09:00:00 AM,48,-122,65,111,176
27730,FremontBridge,12/02/2015 10:00:00 AM,48,-122,23,57,80
27731,FremontBridge,12/02/2015 11:00:00 AM,48,-122,29,22,51
27732,FremontBridge,12/02/2015 12:00:00 PM,48,-122,24,26,50
27733,FremontBridge,12/02/2015 01:00:00 PM,48,-122,21,26,47
27734,FremontBridge,12/02/2015 02:00:00 PM,48,-122,37,33,70
27735,FremontBridge,12/02/2015 03:00:00 PM,48,-122,59,32,91
27736,FremontBridge,12/02/2015 04:00:00 PM,48,-122,115,81,196
27737,FremontBridge,12/02/2015 05:00:00 PM,48,-122,316,103,419
27738,FremontBridge,12/02/2015 06:00:00 PM,48,-122,189,83,272
27739,FremontBridge,12/02/2015 07:00:00 PM,48,-122,71,27,98
27740,FremontBridge,12/02/2015 08:00:00 PM,48,-122,50,22,72
27741,FremontBridge,12/02/2015 09:00:00 PM,48,-122,32,18,50
27742,FremontBridge,12/02/2015 10:00:00 PM,48,-122,13,10,23
27743,FremontBridge,12/02/2015 11:00:00 PM,48,-122,12,8,20
27744,FremontBridge,12/03/2015 12:00:00 AM,48,-122,0,5,5
27745,FremontBridge,12/03/2015 01:00:00 AM,48,-122,3,1,4
27746,FremontBridge,12/03/2015 02:00:00 AM,48,-122,0,0,0
27747,FremontBridge,12/03/2015 03:00:00 AM,48,-122,0,1,1
27748,FremontBridge,12/03/2015 04:00:00 AM,48,-122,1,1,2
27749,FremontBridge,12/03/2015 05:00:00 AM,48,-122,11,13,24
27750,FremontBridge,12/03/2015 06:00:00 AM,48,-122,34,51,85
27751,FremontBridge,12/03/2015 07:00:00 AM,48,-122,49,129,178
27752,FremontBridge,12/03/2015 08:00:00 AM,48,-122,88,200,288
27753,FremontBridge,12/03/2015 09:00:00 AM,48,-122,72,86,158
27754,FremontBridge,12/03/2015 10:00:00 AM,48,-122,32,49,81
27755,FremontBridge,12/03/2015 11:00:00 AM,48,-122,18,27,45
27756,FremontBridge,12/03/2015 12:00:00 PM,48,-122,16,17,33
27757,FremontBridge,12/03/2015 01:00:00 PM,48,-122,26,23,49
27758,FremontBridge,12/03/2015 02:00:00 PM,48,-122,25,25,50
27759,FremontBridge,12/03/2015 03:00:00 PM,48,-122,52,30,82
27760,FremontBridge,12/03/2015 04:00:00 PM,48,-122,93,59,152
27761,FremontBridge,12/03/2015 05:00:00 PM,48,-122,196,74,270
27762,FremontBridge,12/03/2015 06:00:00 PM,48,-122,124,66,190
27763,FremontBridge,12/03/2015 07:00:00 PM,48,-122,62,24,86
27764,FremontBridge,12/03/2015 08:00:00 PM,48,-122,33,14,47
27765,FremontBridge,12/03/2015 09:00:00 PM,48,-122,24,8,32
27766,FremontBridge,12/03/2015 10:00:00 PM,48,-122,5,2,7
27767,FremontBridge,12/03/2015 11:00:00 PM,48,-122,10,5,15
27768,FremontBridge,12/04/2015 12:00:00 AM,48,-122,6,1,7
27769,FremontBridge,12/04/2015 01:00:00 AM,48,-122,2,0,2
27770,FremontBridge,12/04/2015 02:00:00 AM,48,-122,1,1,2
27771,FremontBridge,12/04/2015 03:00:00 AM,48,-122,1,2,3
27772,FremontBridge,12/04/2015 04:00:00 AM,48,-122,3,2,5
27773,FremontBridge,12/04/2015 05:00:00 AM,48,-122,8,14,22
27774,FremontBridge,12/04/2015 06:00:00 AM,48,-122,27,49,76
27775,FremontBridge,12/04/2015 07:00:00 AM,48,-122,63,158,221
27776,FremontBridge,12/04/2015 08:00:00 AM,48,-122,109,210,319
27777,FremontBridge,12/04/2015 09:00:00 AM,48,-122,83,122,205
27778,FremontBridge,12/04/2015 10:00:00 AM,48,-122,28,42,70
27779,FremontBridge,12/04/2015 11:00:00 AM,48,-122,24,31,55
27780,FremontBridge,12/04/2015 12:00:00 PM,48,-122,24,36,60
27781,FremontBridge,12/04/2015 01:00:00 PM,48,-122,28,34,62
27782,FremontBridge,12/04/2015 02:00:00 PM,48,-122,40,45,85
27783,FremontBridge,12/04/2015 03:00:00 PM,48,-122,66,53,119
27784,FremontBridge,12/04/2015 04:00:00 PM,48,-122,142,74,216
27785,FremontBridge,12/04/2015 05:00:00 PM,48,-122,234,103,337
27786,FremontBridge,12/04/2015 06:00:00 PM,48,-122,126,65,191
27787,FremontBridge,12/04/2015 07:00:00 PM,48,-122,56,27,83
27788,FremontBridge,12/04/2015 08:00:00 PM,48,-122,29,13,42
27789,FremontBridge,12/04/2015 09:00:00 PM,48,-122,27,11,38
27790,FremontBridge,12/04/2015 10:00:00 PM,48,-122,14,9,23
27791,FremontBridge,12/04/2015 11:00:00 PM,48,-122,14,11,25
27792,FremontBridge,12/05/2015 12:00:00 AM,48,-122,12,7,19
27793,FremontBridge,12/05/2015 01:00:00 AM,48,-122,4,6,10
27794,FremontBridge,12/05/2015 02:00:00 AM,48,-122,1,2,3
27795,FremontBridge,12/05/2015 03:00:00 AM,48,-122,3,0,3
27796,FremontBridge,12/05/2015 04:00:00 AM,48,-122,2,3,5
27797,FremontBridge,12/05/2015 05:00:00 AM,48,-122,1,4,5
27798,FremontBridge,12/05/2015 06:00:00 AM,48,-122,3,12,15
27799,FremontBridge,12/05/2015 07:00:00 AM,48,-122,9,9,18
27800,FremontBridge,12/05/2015 08:00:00 AM,48,-122,24,24,48
27801,FremontBridge,12/05/2015 09:00:00 AM,48,-122,7,21,28
27802,FremontBridge,12/05/2015 10:00:00 AM,48,-122,8,17,25
27803,FremontBridge,12/05/2015 11:00:00 AM,48,-122,11,18,29
27804,FremontBridge,12/05/2015 12:00:00 PM,48,-122,12,11,23
27805,FremontBridge,12/05/2015 01:00:00 PM,48,-122,11,13,24
27806,FremontBridge,12/05/2015 02:00:00 PM,48,-122,11,11,22
27807,FremontBridge,12/05/2015 03:00:00 PM,48,-122,7,8,15
27808,FremontBridge,12/05/2015 04:00:00 PM,48,-122,16,5,21
27809,FremontBridge,12/05/2015 05:00:00 PM,48,-122,7,18,25
27810,FremontBridge,12/05/2015 06:00:00 PM,48,-122,14,9,23
27811,FremontBridge,12/05/2015 07:00:00 PM,48,-122,3,7,10
27812,FremontBridge,12/05/2015 08:00:00 PM,48,-122,4,7,11
27813,FremontBridge,12/05/2015 09:00:00 PM,48,-122,9,3,12
27814,FremontBridge,12/05/2015 10:00:00 PM,48,-122,3,5,8
27815,FremontBridge,12/05/2015 11:00:00 PM,48,-122,5,1,6
27816,FremontBridge,12/06/2015 12:00:00 AM,48,-122,0,1,1
27817,FremontBridge,12/06/2015 01:00:00 AM,48,-122,2,2,4
27818,FremontBridge,12/06/2015 02:00:00 AM,48,-122,0,1,1
27819,FremontBridge,12/06/2015 03:00:00 AM,48,-122,1,0,1
27820,FremontBridge,12/06/2015 04:00:00 AM,48,-122,0,0,0
27821,FremontBridge,12/06/2015 05:00:00 AM,48,-122,2,0,2
27822,FremontBridge,12/06/2015 06:00:00 AM,48,-122,2,4,6
27823,FremontBridge,12/06/2015 07:00:00 AM,48,-122,3,1,4
27824,FremontBridge,12/06/2015 08:00:00 AM,48,-122,7,9,16
27825,FremontBridge,12/06/2015 09:00:00 AM,48,-122,18,16,34
27826,FremontBridge,12/06/2015 10:00:00 AM,48,-122,10,12,22
27827,FremontBridge,12/06/2015 11:00:00 AM,48,-122,16,12,28
27828,FremontBridge,12/06/2015 12:00:00 PM,48,-122,24,31,55
27829,FremontBridge,12/06/2015 01:00:00 PM,48,-122,34,27,61
27830,FremontBridge,12/06/2015 02:00:00 PM,48,-122,32,41,73
27831,FremontBridge,12/06/2015 03:00:00 PM,48,-122,35,29,64
27832,FremontBridge,12/06/2015 04:00:00 PM,48,-122,8,17,25
27833,FremontBridge,12/06/2015 05:00:00 PM,48,-122,15,7,22
27834,FremontBridge,12/06/2015 06:00:00 PM,48,-122,11,8,19
27835,FremontBridge,12/06/2015 07:00:00 PM,48,-122,8,5,13
27836,FremontBridge,12/06/2015 08:00:00 PM,48,-122,10,4,14
27837,FremontBridge,12/06/2015 09:00:00 PM,48,-122,3,2,5
27838,FremontBridge,12/06/2015 10:00:00 PM,48,-122,1,4,5
27839,FremontBridge,12/06/2015 11:00:00 PM,48,-122,2,3,5
27840,FremontBridge,12/07/2015 12:00:00 AM,48,-122,1,2,3
27841,FremontBridge,12/07/2015 01:00:00 AM,48,-122,1,1,2
27842,FremontBridge,12/07/2015 02:00:00 AM,48,-122,2,1,3
27843,FremontBridge,12/07/2015 03:00:00 AM,48,-122,0,2,2
27844,FremontBridge,12/07/2015 04:00:00 AM,48,-122,1,4,5
27845,FremontBridge,12/07/2015 05:00:00 AM,48,-122,9,26,35
27846,FremontBridge,12/07/2015 06:00:00 AM,48,-122,38,50,88
27847,FremontBridge,12/07/2015 07:00:00 AM,48,-122,53,199,252
27848,FremontBridge,12/07/2015 08:00:00 AM,48,-122,107,235,342
27849,FremontBridge,12/07/2015 09:00:00 AM,48,-122,62,115,177
27850,FremontBridge,12/07/2015 10:00:00 AM,48,-122,12,34,46
27851,FremontBridge,12/07/2015 11:00:00 AM,48,-122,10,7,17
27852,FremontBridge,12/07/2015 12:00:00 PM,48,-122,11,11,22
27853,FremontBridge,12/07/2015 01:00:00 PM,48,-122,14,4,18
27854,FremontBridge,12/07/2015 02:00:00 PM,48,-122,14,15,29
27855,FremontBridge,12/07/2015 03:00:00 PM,48,-122,44,26,70
27856,FremontBridge,12/07/2015 04:00:00 PM,48,-122,90,52,142
27857,FremontBridge,12/07/2015 05:00:00 PM,48,-122,274,96,370
27858,FremontBridge,12/07/2015 06:00:00 PM,48,-122,171,74,245
27859,FremontBridge,12/07/2015 07:00:00 PM,48,-122,55,23,78
27860,FremontBridge,12/07/2015 08:00:00 PM,48,-122,25,14,39
27861,FremontBridge,12/07/2015 09:00:00 PM,48,-122,14,10,24
27862,FremontBridge,12/07/2015 10:00:00 PM,48,-122,17,11,28
27863,FremontBridge,12/07/2015 11:00:00 PM,48,-122,3,1,4
27864,FremontBridge,12/08/2015 12:00:00 AM,48,-122,2,1,3
27865,FremontBridge,12/08/2015 01:00:00 AM,48,-122,3,0,3
27866,FremontBridge,12/08/2015 02:00:00 AM,48,-122,2,1,3
27867,FremontBridge,12/08/2015 03:00:00 AM,48,-122,0,4,4
27868,FremontBridge,12/08/2015 04:00:00 AM,48,-122,1,3,4
27869,FremontBridge,12/08/2015 05:00:00 AM,48,-122,6,15,21
27870,FremontBridge,12/08/2015 06:00:00 AM,48,-122,23,50,73
27871,FremontBridge,12/08/2015 07:00:00 AM,48,-122,57,137,194
27872,FremontBridge,12/08/2015 08:00:00 AM,48,-122,99,208,307
27873,FremontBridge,12/08/2015 09:00:00 AM,48,-122,62,99,161
27874,FremontBridge,12/08/2015 10:00:00 AM,48,-122,18,25,43
27875,FremontBridge,12/08/2015 11:00:00 AM,48,-122,14,15,29
27876,FremontBridge,12/08/2015 12:00:00 PM,48,-122,14,9,23
27877,FremontBridge,12/08/2015 01:00:00 PM,48,-122,9,11,20
27878,FremontBridge,12/08/2015 02:00:00 PM,48,-122,16,16,32
27879,FremontBridge,12/08/2015 03:00:00 PM,48,-122,37,30,67
27880,FremontBridge,12/08/2015 04:00:00 PM,48,-122,68,42,110
27881,FremontBridge,12/08/2015 05:00:00 PM,48,-122,221,77,298
27882,FremontBridge,12/08/2015 06:00:00 PM,48,-122,141,55,196
27883,FremontBridge,12/08/2015 07:00:00 PM,48,-122,52,33,85
27884,FremontBridge,12/08/2015 08:00:00 PM,48,-122,21,14,35
27885,FremontBridge,12/08/2015 09:00:00 PM,48,-122,15,6,21
27886,FremontBridge,12/08/2015 10:00:00 PM,48,-122,10,3,13
27887,FremontBridge,12/08/2015 11:00:00 PM,48,-122,10,1,11
27888,FremontBridge,12/09/2015 12:00:00 AM,48,-122,1,3,4
27889,FremontBridge,12/09/2015 01:00:00 AM,48,-122,0,0,0
27890,FremontBridge,12/09/2015 02:00:00 AM,48,-122,1,0,1
27891,FremontBridge,12/09/2015 03:00:00 AM,48,-122,0,4,4
27892,FremontBridge,12/09/2015 04:00:00 AM,48,-122,2,2,4
27893,FremontBridge,12/09/2015 05:00:00 AM,48,-122,10,15,25
27894,FremontBridge,12/09/2015 06:00:00 AM,48,-122,23,43,66
27895,FremontBridge,12/09/2015 07:00:00 AM,48,-122,58,142,200
27896,FremontBridge,12/09/2015 08:00:00 AM,48,-122,97,205,302
27897,FremontBridge,12/09/2015 09:00:00 AM,48,-122,73,117,190
27898,FremontBridge,12/09/2015 10:00:00 AM,48,-122,32,48,80
27899,FremontBridge,12/09/2015 11:00:00 AM,48,-122,25,26,51
27900,FremontBridge,12/09/2015 12:00:00 PM,48,-122,20,25,45
27901,FremontBridge,12/09/2015 01:00:00 PM,48,-122,26,28,54
27902,FremontBridge,12/09/2015 02:00:00 PM,48,-122,44,38,82
27903,FremontBridge,12/09/2015 03:00:00 PM,48,-122,48,56,104
27904,FremontBridge,12/09/2015 04:00:00 PM,48,-122,99,68,167
27905,FremontBridge,12/09/2015 05:00:00 PM,48,-122,264,100,364
27906,FremontBridge,12/09/2015 06:00:00 PM,48,-122,156,82,238
27907,FremontBridge,12/09/2015 07:00:00 PM,48,-122,68,28,96
27908,FremontBridge,12/09/2015 08:00:00 PM,48,-122,29,21,50
27909,FremontBridge,12/09/2015 09:00:00 PM,48,-122,27,14,41
27910,FremontBridge,12/09/2015 10:00:00 PM,48,-122,18,8,26
27911,FremontBridge,12/09/2015 11:00:00 PM,48,-122,14,12,26
27912,FremontBridge,12/10/2015 12:00:00 AM,48,-122,3,0,3
27913,FremontBridge,12/10/2015 01:00:00 AM,48,-122,2,3,5
27914,FremontBridge,12/10/2015 02:00:00 AM,48,-122,2,0,2
27915,FremontBridge,12/10/2015 03:00:00 AM,48,-122,1,2,3
27916,FremontBridge,12/10/2015 04:00:00 AM,48,-122,1,4,5
27917,FremontBridge,12/10/2015 05:00:00 AM,48,-122,9,14,23
27918,FremontBridge,12/10/2015 06:00:00 AM,48,-122,28,53,81
27919,FremontBridge,12/10/2015 07:00:00 AM,48,-122,70,169,239
27920,FremontBridge,12/10/2015 08:00:00 AM,48,-122,103,214,317
27921,FremontBridge,12/10/2015 09:00:00 AM,48,-122,59,72,131
27922,FremontBridge,12/10/2015 10:00:00 AM,48,-122,19,34,53
27923,FremontBridge,12/10/2015 11:00:00 AM,48,-122,7,12,19
27924,FremontBridge,12/10/2015 12:00:00 PM,48,-122,5,8,13
27925,FremontBridge,12/10/2015 01:00:00 PM,48,-122,11,10,21
27926,FremontBridge,12/10/2015 02:00:00 PM,48,-122,25,10,35
27927,FremontBridge,12/10/2015 03:00:00 PM,48,-122,32,30,62
27928,FremontBridge,12/10/2015 04:00:00 PM,48,-122,99,56,155
27929,FremontBridge,12/10/2015 05:00:00 PM,48,-122,216,71,287
27930,FremontBridge,12/10/2015 06:00:00 PM,48,-122,135,59,194
27931,FremontBridge,12/10/2015 07:00:00 PM,48,-122,57,20,77
27932,FremontBridge,12/10/2015 08:00:00 PM,48,-122,32,17,49
27933,FremontBridge,12/10/2015 09:00:00 PM,48,-122,23,9,32
27934,FremontBridge,12/10/2015 10:00:00 PM,48,-122,10,10,20
27935,FremontBridge,12/10/2015 11:00:00 PM,48,-122,11,4,15
27936,FremontBridge,12/11/2015 12:00:00 AM,48,-122,5,2,7
27937,FremontBridge,12/11/2015 01:00:00 AM,48,-122,1,1,2
27938,FremontBridge,12/11/2015 02:00:00 AM,48,-122,2,1,3
27939,FremontBridge,12/11/2015 03:00:00 AM,48,-122,0,1,1
27940,FremontBridge,12/11/2015 04:00:00 AM,48,-122,5,2,7
27941,FremontBridge,12/11/2015 05:00:00 AM,48,-122,7,15,22
27942,FremontBridge,12/11/2015 06:00:00 AM,48,-122,20,46,66
27943,FremontBridge,12/11/2015 07:00:00 AM,48,-122,50,157,207
27944,FremontBridge,12/11/2015 08:00:00 AM,48,-122,111,183,294
27945,FremontBridge,12/11/2015 09:00:00 AM,48,-122,65,109,174
27946,FremontBridge,12/11/2015 10:00:00 AM,48,-122,31,42,73
27947,FremontBridge,12/11/2015 11:00:00 AM,48,-122,26,35,61
27948,FremontBridge,12/11/2015 12:00:00 PM,48,-122,36,27,63
27949,FremontBridge,12/11/2015 01:00:00 PM,48,-122,25,22,47
27950,FremontBridge,12/11/2015 02:00:00 PM,48,-122,30,45,75
27951,FremontBridge,12/11/2015 03:00:00 PM,48,-122,61,45,106
27952,FremontBridge,12/11/2015 04:00:00 PM,48,-122,121,68,189
27953,FremontBridge,12/11/2015 05:00:00 PM,48,-122,235,86,321
27954,FremontBridge,12/11/2015 06:00:00 PM,48,-122,116,43,159
27955,FremontBridge,12/11/2015 07:00:00 PM,48,-122,47,21,68
27956,FremontBridge,12/11/2015 08:00:00 PM,48,-122,30,11,41
27957,FremontBridge,12/11/2015 09:00:00 PM,48,-122,17,13,30
27958,FremontBridge,12/11/2015 10:00:00 PM,48,-122,15,10,25
27959,FremontBridge,12/11/2015 11:00:00 PM,48,-122,9,7,16
27960,FremontBridge,12/12/2015 12:00:00 AM,48,-122,7,6,13
27961,FremontBridge,12/12/2015 01:00:00 AM,48,-122,7,3,10
27962,FremontBridge,12/12/2015 02:00:00 AM,48,-122,4,4,8
27963,FremontBridge,12/12/2015 03:00:00 AM,48,-122,1,0,1
27964,FremontBridge,12/12/2015 04:00:00 AM,48,-122,2,3,5
27965,FremontBridge,12/12/2015 05:00:00 AM,48,-122,5,7,12
27966,FremontBridge,12/12/2015 06:00:00 AM,48,-122,8,7,15
27967,FremontBridge,12/12/2015 07:00:00 AM,48,-122,12,6,18
27968,FremontBridge,12/12/2015 08:00:00 AM,48,-122,14,18,32
27969,FremontBridge,12/12/2015 09:00:00 AM,48,-122,12,15,27
27970,FremontBridge,12/12/2015 10:00:00 AM,48,-122,16,25,41
27971,FremontBridge,12/12/2015 11:00:00 AM,48,-122,13,17,30
27972,FremontBridge,12/12/2015 12:00:00 PM,48,-122,13,13,26
27973,FremontBridge,12/12/2015 01:00:00 PM,48,-122,10,9,19
27974,FremontBridge,12/12/2015 02:00:00 PM,48,-122,11,14,25
27975,FremontBridge,12/12/2015 03:00:00 PM,48,-122,15,15,30
27976,FremontBridge,12/12/2015 04:00:00 PM,48,-122,24,12,36
27977,FremontBridge,12/12/2015 05:00:00 PM,48,-122,10,14,24
27978,FremontBridge,12/12/2015 06:00:00 PM,48,-122,14,13,27
27979,FremontBridge,12/12/2015 07:00:00 PM,48,-122,7,6,13
27980,FremontBridge,12/12/2015 08:00:00 PM,48,-122,9,3,12
27981,FremontBridge,12/12/2015 09:00:00 PM,48,-122,3,4,7
27982,FremontBridge,12/12/2015 10:00:00 PM,48,-122,2,8,10
27983,FremontBridge,12/12/2015 11:00:00 PM,48,-122,3,3,6
27984,FremontBridge,12/13/2015 12:00:00 AM,48,-122,4,5,9
27985,FremontBridge,12/13/2015 01:00:00 AM,48,-122,0,1,1
27986,FremontBridge,12/13/2015 02:00:00 AM,48,-122,0,4,4
27987,FremontBridge,12/13/2015 03:00:00 AM,48,-122,1,3,4
27988,FremontBridge,12/13/2015 04:00:00 AM,48,-122,0,1,1
27989,FremontBridge,12/13/2015 05:00:00 AM,48,-122,5,4,9
27990,FremontBridge,12/13/2015 06:00:00 AM,48,-122,4,2,6
27991,FremontBridge,12/13/2015 07:00:00 AM,48,-122,6,7,13
27992,FremontBridge,12/13/2015 08:00:00 AM,48,-122,11,11,22
27993,FremontBridge,12/13/2015 09:00:00 AM,48,-122,20,18,38
27994,FremontBridge,12/13/2015 10:00:00 AM,48,-122,16,18,34
27995,FremontBridge,12/13/2015 11:00:00 AM,48,-122,10,18,28
27996,FremontBridge,12/13/2015 12:00:00 PM,48,-122,27,25,52
27997,FremontBridge,12/13/2015 01:00:00 PM,48,-122,16,26,42
27998,FremontBridge,12/13/2015 02:00:00 PM,48,-122,21,34,55
27999,FremontBridge,12/13/2015 03:00:00 PM,48,-122,31,31,62
28000,FremontBridge,12/13/2015 04:00:00 PM,48,-122,12,11,23
28001,FremontBridge,12/13/2015 05:00:00 PM,48,-122,17,8,25
28002,FremontBridge,12/13/2015 06:00:00 PM,48,-122,10,9,19
28003,FremontBridge,12/13/2015 07:00:00 PM,48,-122,9,5,14
28004,FremontBridge,12/13/2015 08:00:00 PM,48,-122,2,6,8
28005,FremontBridge,12/13/2015 09:00:00 PM,48,-122,1,3,4
28006,FremontBridge,12/13/2015 10:00:00 PM,48,-122,6,3,9
28007,FremontBridge,12/13/2015 11:00:00 PM,48,-122,5,3,8
28008,FremontBridge,12/14/2015 12:00:00 AM,48,-122,3,2,5
28009,FremontBridge,12/14/2015 01:00:00 AM,48,-122,1,1,2
28010,FremontBridge,12/14/2015 02:00:00 AM,48,-122,2,1,3
28011,FremontBridge,12/14/2015 03:00:00 AM,48,-122,0,2,2
28012,FremontBridge,12/14/2015 04:00:00 AM,48,-122,3,8,11
28013,FremontBridge,12/14/2015 05:00:00 AM,48,-122,13,19,32
28014,FremontBridge,12/14/2015 06:00:00 AM,48,-122,33,55,88
28015,FremontBridge,12/14/2015 07:00:00 AM,48,-122,79,209,288
28016,FremontBridge,12/14/2015 08:00:00 AM,48,-122,129,277,406
28017,FremontBridge,12/14/2015 09:00:00 AM,48,-122,68,104,172
28018,FremontBridge,12/14/2015 10:00:00 AM,48,-122,32,40,72
28019,FremontBridge,12/14/2015 11:00:00 AM,48,-122,12,40,52
28020,FremontBridge,12/14/2015 12:00:00 PM,48,-122,30,28,58
28021,FremontBridge,12/14/2015 01:00:00 PM,48,-122,26,32,58
28022,FremontBridge,12/14/2015 02:00:00 PM,48,-122,30,24,54
28023,FremontBridge,12/14/2015 03:00:00 PM,48,-122,54,51,105
28024,FremontBridge,12/14/2015 04:00:00 PM,48,-122,119,72,191
28025,FremontBridge,12/14/2015 05:00:00 PM,48,-122,300,103,403
28026,FremontBridge,12/14/2015 06:00:00 PM,48,-122,197,93,290
28027,FremontBridge,12/14/2015 07:00:00 PM,48,-122,68,34,102
28028,FremontBridge,12/14/2015 08:00:00 PM,48,-122,30,18,48
28029,FremontBridge,12/14/2015 09:00:00 PM,48,-122,28,14,42
28030,FremontBridge,12/14/2015 10:00:00 PM,48,-122,12,11,23
28031,FremontBridge,12/14/2015 11:00:00 PM,48,-122,9,5,14
28032,FremontBridge,12/15/2015 12:00:00 AM,48,-122,4,5,9
28033,FremontBridge,12/15/2015 01:00:00 AM,48,-122,1,1,2
28034,FremontBridge,12/15/2015 02:00:00 AM,48,-122,3,0,3
28035,FremontBridge,12/15/2015 03:00:00 AM,48,-122,2,3,5
28036,FremontBridge,12/15/2015 04:00:00 AM,48,-122,3,3,6
28037,FremontBridge,12/15/2015 05:00:00 AM,48,-122,10,21,31
28038,FremontBridge,12/15/2015 06:00:00 AM,48,-122,41,61,102
28039,FremontBridge,12/15/2015 07:00:00 AM,48,-122,71,208,279
28040,FremontBridge,12/15/2015 08:00:00 AM,48,-122,119,238,357
28041,FremontBridge,12/15/2015 09:00:00 AM,48,-122,66,133,199
28042,FremontBridge,12/15/2015 10:00:00 AM,48,-122,27,41,68
28043,FremontBridge,12/15/2015 11:00:00 AM,48,-122,20,31,51
28044,FremontBridge,12/15/2015 12:00:00 PM,48,-122,22,33,55
28045,FremontBridge,12/15/2015 01:00:00 PM,48,-122,30,23,53
28046,FremontBridge,12/15/2015 02:00:00 PM,48,-122,30,25,55
28047,FremontBridge,12/15/2015 03:00:00 PM,48,-122,52,46,98
28048,FremontBridge,12/15/2015 04:00:00 PM,48,-122,129,66,195
28049,FremontBridge,12/15/2015 05:00:00 PM,48,-122,289,95,384
28050,FremontBridge,12/15/2015 06:00:00 PM,48,-122,182,83,265
28051,FremontBridge,12/15/2015 07:00:00 PM,48,-122,63,31,94
28052,FremontBridge,12/15/2015 08:00:00 PM,48,-122,33,22,55
28053,FremontBridge,12/15/2015 09:00:00 PM,48,-122,21,8,29
28054,FremontBridge,12/15/2015 10:00:00 PM,48,-122,12,9,21
28055,FremontBridge,12/15/2015 11:00:00 PM,48,-122,9,5,14
28056,FremontBridge,12/16/2015 12:00:00 AM,48,-122,3,7,10
28057,FremontBridge,12/16/2015 01:00:00 AM,48,-122,1,0,1
28058,FremontBridge,12/16/2015 02:00:00 AM,48,-122,1,1,2
28059,FremontBridge,12/16/2015 03:00:00 AM,48,-122,0,2,2
28060,FremontBridge,12/16/2015 04:00:00 AM,48,-122,3,4,7
28061,FremontBridge,12/16/2015 05:00:00 AM,48,-122,7,22,29
28062,FremontBridge,12/16/2015 06:00:00 AM,48,-122,35,66,101
28063,FremontBridge,12/16/2015 07:00:00 AM,48,-122,69,175,244
28064,FremontBridge,12/16/2015 08:00:00 AM,48,-122,123,226,349
28065,FremontBridge,12/16/2015 09:00:00 AM,48,-122,69,124,193
28066,FremontBridge,12/16/2015 10:00:00 AM,48,-122,30,55,85
28067,FremontBridge,12/16/2015 11:00:00 AM,48,-122,22,30,52
28068,FremontBridge,12/16/2015 12:00:00 PM,48,-122,30,24,54
28069,FremontBridge,12/16/2015 01:00:00 PM,48,-122,30,30,60
28070,FremontBridge,12/16/2015 02:00:00 PM,48,-122,40,26,66
28071,FremontBridge,12/16/2015 03:00:00 PM,48,-122,57,48,105
28072,FremontBridge,12/16/2015 04:00:00 PM,48,-122,93,74,167
28073,FremontBridge,12/16/2015 05:00:00 PM,48,-122,285,122,407
28074,FremontBridge,12/16/2015 06:00:00 PM,48,-122,173,84,257
28075,FremontBridge,12/16/2015 07:00:00 PM,48,-122,64,39,103
28076,FremontBridge,12/16/2015 08:00:00 PM,48,-122,37,19,56
28077,FremontBridge,12/16/2015 09:00:00 PM,48,-122,29,12,41
28078,FremontBridge,12/16/2015 10:00:00 PM,48,-122,15,8,23
28079,FremontBridge,12/16/2015 11:00:00 PM,48,-122,12,10,22
28080,FremontBridge,12/17/2015 12:00:00 AM,48,-122,4,4,8
28081,FremontBridge,12/17/2015 01:00:00 AM,48,-122,1,3,4
28082,FremontBridge,12/17/2015 02:00:00 AM,48,-122,1,2,3
28083,FremontBridge,12/17/2015 03:00:00 AM,48,-122,0,2,2
28084,FremontBridge,12/17/2015 04:00:00 AM,48,-122,2,2,4
28085,FremontBridge,12/17/2015 05:00:00 AM,48,-122,8,14,22
28086,FremontBridge,12/17/2015 06:00:00 AM,48,-122,25,55,80
28087,FremontBridge,12/17/2015 07:00:00 AM,48,-122,48,154,202
28088,FremontBridge,12/17/2015 08:00:00 AM,48,-122,85,158,243
28089,FremontBridge,12/17/2015 09:00:00 AM,48,-122,60,90,150
28090,FremontBridge,12/17/2015 10:00:00 AM,48,-122,19,30,49
28091,FremontBridge,12/17/2015 11:00:00 AM,48,-122,6,14,20
28092,FremontBridge,12/17/2015 12:00:00 PM,48,-122,11,11,22
28093,FremontBridge,12/17/2015 01:00:00 PM,48,-122,18,9,27
28094,FremontBridge,12/17/2015 02:00:00 PM,48,-122,18,13,31
28095,FremontBridge,12/17/2015 03:00:00 PM,48,-122,36,23,59
28096,FremontBridge,12/17/2015 04:00:00 PM,48,-122,67,51,118
28097,FremontBridge,12/17/2015 05:00:00 PM,48,-122,170,87,257
28098,FremontBridge,12/17/2015 06:00:00 PM,48,-122,120,48,168
28099,FremontBridge,12/17/2015 07:00:00 PM,48,-122,57,21,78
28100,FremontBridge,12/17/2015 08:00:00 PM,48,-122,50,18,68
28101,FremontBridge,12/17/2015 09:00:00 PM,48,-122,12,5,17
28102,FremontBridge,12/17/2015 10:00:00 PM,48,-122,13,4,17
28103,FremontBridge,12/17/2015 11:00:00 PM,48,-122,6,3,9
28104,FremontBridge,12/18/2015 12:00:00 AM,48,-122,1,2,3
28105,FremontBridge,12/18/2015 01:00:00 AM,48,-122,0,4,4
28106,FremontBridge,12/18/2015 02:00:00 AM,48,-122,0,1,1
28107,FremontBridge,12/18/2015 03:00:00 AM,48,-122,0,0,0
28108,FremontBridge,12/18/2015 04:00:00 AM,48,-122,2,1,3
28109,FremontBridge,12/18/2015 05:00:00 AM,48,-122,7,9,16
28110,FremontBridge,12/18/2015 06:00:00 AM,48,-122,15,44,59
28111,FremontBridge,12/18/2015 07:00:00 AM,48,-122,42,127,169
28112,FremontBridge,12/18/2015 08:00:00 AM,48,-122,79,167,246
28113,FremontBridge,12/18/2015 09:00:00 AM,48,-122,52,92,144
28114,FremontBridge,12/18/2015 10:00:00 AM,48,-122,28,37,65
28115,FremontBridge,12/18/2015 11:00:00 AM,48,-122,17,28,45
28116,FremontBridge,12/18/2015 12:00:00 PM,48,-122,26,24,50
28117,FremontBridge,12/18/2015 01:00:00 PM,48,-122,28,15,43
28118,FremontBridge,12/18/2015 02:00:00 PM,48,-122,26,33,59
28119,FremontBridge,12/18/2015 03:00:00 PM,48,-122,57,40,97
28120,FremontBridge,12/18/2015 04:00:00 PM,48,-122,97,62,159
28121,FremontBridge,12/18/2015 05:00:00 PM,48,-122,206,70,276
28122,FremontBridge,12/18/2015 06:00:00 PM,48,-122,89,44,133
28123,FremontBridge,12/18/2015 07:00:00 PM,48,-122,48,12,60
28124,FremontBridge,12/18/2015 08:00:00 PM,48,-122,17,8,25
28125,FremontBridge,12/18/2015 09:00:00 PM,48,-122,17,7,24
28126,FremontBridge,12/18/2015 10:00:00 PM,48,-122,7,10,17
28127,FremontBridge,12/18/2015 11:00:00 PM,48,-122,5,5,10
28128,FremontBridge,12/19/2015 12:00:00 AM,48,-122,4,3,7
28129,FremontBridge,12/19/2015 01:00:00 AM,48,-122,4,3,7
28130,FremontBridge,12/19/2015 02:00:00 AM,48,-122,1,0,1
28131,FremontBridge,12/19/2015 03:00:00 AM,48,-122,0,0,0
28132,FremontBridge,12/19/2015 04:00:00 AM,48,-122,0,0,0
28133,FremontBridge,12/19/2015 05:00:00 AM,48,-122,6,4,10
28134,FremontBridge,12/19/2015 06:00:00 AM,48,-122,6,4,10
28135,FremontBridge,12/19/2015 07:00:00 AM,48,-122,7,14,21
28136,FremontBridge,12/19/2015 08:00:00 AM,48,-122,16,19,35
28137,FremontBridge,12/19/2015 09:00:00 AM,48,-122,18,34,52
28138,FremontBridge,12/19/2015 10:00:00 AM,48,-122,19,37,56
28139,FremontBridge,12/19/2015 11:00:00 AM,48,-122,34,51,85
28140,FremontBridge,12/19/2015 12:00:00 PM,48,-122,36,50,86
28141,FremontBridge,12/19/2015 01:00:00 PM,48,-122,44,36,80
28142,FremontBridge,12/19/2015 02:00:00 PM,48,-122,37,58,95
28143,FremontBridge,12/19/2015 03:00:00 PM,48,-122,37,36,73
28144,FremontBridge,12/19/2015 04:00:00 PM,48,-122,21,25,46
28145,FremontBridge,12/19/2015 05:00:00 PM,48,-122,15,23,38
28146,FremontBridge,12/19/2015 06:00:00 PM,48,-122,15,16,31
28147,FremontBridge,12/19/2015 07:00:00 PM,48,-122,6,3,9
28148,FremontBridge,12/19/2015 08:00:00 PM,48,-122,9,7,16
28149,FremontBridge,12/19/2015 09:00:00 PM,48,-122,8,7,15
28150,FremontBridge,12/19/2015 10:00:00 PM,48,-122,9,8,17
28151,FremontBridge,12/19/2015 11:00:00 PM,48,-122,14,4,18
28152,FremontBridge,12/20/2015 12:00:00 AM,48,-122,2,2,4
28153,FremontBridge,12/20/2015 01:00:00 AM,48,-122,2,4,6
28154,FremontBridge,12/20/2015 02:00:00 AM,48,-122,0,0,0
28155,FremontBridge,12/20/2015 03:00:00 AM,48,-122,0,2,2
28156,FremontBridge,12/20/2015 04:00:00 AM,48,-122,2,2,4
28157,FremontBridge,12/20/2015 05:00:00 AM,48,-122,2,2,4
28158,FremontBridge,12/20/2015 06:00:00 AM,48,-122,6,0,6
28159,FremontBridge,12/20/2015 07:00:00 AM,48,-122,2,4,6
28160,FremontBridge,12/20/2015 08:00:00 AM,48,-122,9,18,27
28161,FremontBridge,12/20/2015 09:00:00 AM,48,-122,8,11,19
28162,FremontBridge,12/20/2015 10:00:00 AM,48,-122,26,16,42
28163,FremontBridge,12/20/2015 11:00:00 AM,48,-122,26,33,59
28164,FremontBridge,12/20/2015 12:00:00 PM,48,-122,18,28,46
28165,FremontBridge,12/20/2015 01:00:00 PM,48,-122,16,32,48
28166,FremontBridge,12/20/2015 02:00:00 PM,48,-122,22,30,52
28167,FremontBridge,12/20/2015 03:00:00 PM,48,-122,24,17,41
28168,FremontBridge,12/20/2015 04:00:00 PM,48,-122,18,22,40
28169,FremontBridge,12/20/2015 05:00:00 PM,48,-122,16,16,32
28170,FremontBridge,12/20/2015 06:00:00 PM,48,-122,14,7,21
28171,FremontBridge,12/20/2015 07:00:00 PM,48,-122,7,1,8
28172,FremontBridge,12/20/2015 08:00:00 PM,48,-122,9,13,22
28173,FremontBridge,12/20/2015 09:00:00 PM,48,-122,5,6,11
28174,FremontBridge,12/20/2015 10:00:00 PM,48,-122,1,4,5
28175,FremontBridge,12/20/2015 11:00:00 PM,48,-122,4,3,7
28176,FremontBridge,12/21/2015 12:00:00 AM,48,-122,3,2,5
28177,FremontBridge,12/21/2015 01:00:00 AM,48,-122,0,0,0
28178,FremontBridge,12/21/2015 02:00:00 AM,48,-122,1,0,1
28179,FremontBridge,12/21/2015 03:00:00 AM,48,-122,3,1,4
28180,FremontBridge,12/21/2015 04:00:00 AM,48,-122,1,3,4
28181,FremontBridge,12/21/2015 05:00:00 AM,48,-122,5,11,16
28182,FremontBridge,12/21/2015 06:00:00 AM,48,-122,33,41,74
28183,FremontBridge,12/21/2015 07:00:00 AM,48,-122,41,126,167
28184,FremontBridge,12/21/2015 08:00:00 AM,48,-122,71,130,201
28185,FremontBridge,12/21/2015 09:00:00 AM,48,-122,37,52,89
28186,FremontBridge,12/21/2015 10:00:00 AM,48,-122,11,19,30
28187,FremontBridge,12/21/2015 11:00:00 AM,48,-122,4,8,12
28188,FremontBridge,12/21/2015 12:00:00 PM,48,-122,9,10,19
28189,FremontBridge,12/21/2015 01:00:00 PM,48,-122,10,9,19
28190,FremontBridge,12/21/2015 02:00:00 PM,48,-122,19,6,25
28191,FremontBridge,12/21/2015 03:00:00 PM,48,-122,27,11,38
28192,FremontBridge,12/21/2015 04:00:00 PM,48,-122,56,41,97
28193,FremontBridge,12/21/2015 05:00:00 PM,48,-122,167,60,227
28194,FremontBridge,12/21/2015 06:00:00 PM,48,-122,107,38,145
28195,FremontBridge,12/21/2015 07:00:00 PM,48,-122,28,24,52
28196,FremontBridge,12/21/2015 08:00:00 PM,48,-122,11,8,19
28197,FremontBridge,12/21/2015 09:00:00 PM,48,-122,7,6,13
28198,FremontBridge,12/21/2015 10:00:00 PM,48,-122,6,8,14
28199,FremontBridge,12/21/2015 11:00:00 PM,48,-122,2,2,4
28200,FremontBridge,12/22/2015 12:00:00 AM,48,-122,1,0,1
28201,FremontBridge,12/22/2015 01:00:00 AM,48,-122,2,2,4
28202,FremontBridge,12/22/2015 02:00:00 AM,48,-122,0,2,2
28203,FremontBridge,12/22/2015 03:00:00 AM,48,-122,0,3,3
28204,FremontBridge,12/22/2015 04:00:00 AM,48,-122,1,1,2
28205,FremontBridge,12/22/2015 05:00:00 AM,48,-122,8,13,21
28206,FremontBridge,12/22/2015 06:00:00 AM,48,-122,30,44,74
28207,FremontBridge,12/22/2015 07:00:00 AM,48,-122,51,126,177
28208,FremontBridge,12/22/2015 08:00:00 AM,48,-122,72,147,219
28209,FremontBridge,12/22/2015 09:00:00 AM,48,-122,40,95,135
28210,FremontBridge,12/22/2015 10:00:00 AM,48,-122,25,37,62
28211,FremontBridge,12/22/2015 11:00:00 AM,48,-122,20,19,39
28212,FremontBridge,12/22/2015 12:00:00 PM,48,-122,28,23,51
28213,FremontBridge,12/22/2015 01:00:00 PM,48,-122,18,21,39
28214,FremontBridge,12/22/2015 02:00:00 PM,48,-122,34,20,54
28215,FremontBridge,12/22/2015 03:00:00 PM,48,-122,47,33,80
28216,FremontBridge,12/22/2015 04:00:00 PM,48,-122,112,46,158
28217,FremontBridge,12/22/2015 05:00:00 PM,48,-122,180,69,249
28218,FremontBridge,12/22/2015 06:00:00 PM,48,-122,114,34,148
28219,FremontBridge,12/22/2015 07:00:00 PM,48,-122,34,20,54
28220,FremontBridge,12/22/2015 08:00:00 PM,48,-122,18,6,24
28221,FremontBridge,12/22/2015 09:00:00 PM,48,-122,9,9,18
28222,FremontBridge,12/22/2015 10:00:00 PM,48,-122,6,6,12
28223,FremontBridge,12/22/2015 11:00:00 PM,48,-122,8,1,9
28224,FremontBridge,12/23/2015 12:00:00 AM,48,-122,0,3,3
28225,FremontBridge,12/23/2015 01:00:00 AM,48,-122,1,3,4
28226,FremontBridge,12/23/2015 02:00:00 AM,48,-122,0,0,0
28227,FremontBridge,12/23/2015 03:00:00 AM,48,-122,0,1,1
28228,FremontBridge,12/23/2015 04:00:00 AM,48,-122,3,0,3
28229,FremontBridge,12/23/2015 05:00:00 AM,48,-122,8,19,27
28230,FremontBridge,12/23/2015 06:00:00 AM,48,-122,21,38,59
28231,FremontBridge,12/23/2015 07:00:00 AM,48,-122,38,83,121
28232,FremontBridge,12/23/2015 08:00:00 AM,48,-122,49,100,149
28233,FremontBridge,12/23/2015 09:00:00 AM,48,-122,34,66,100
28234,FremontBridge,12/23/2015 10:00:00 AM,48,-122,17,20,37
28235,FremontBridge,12/23/2015 11:00:00 AM,48,-122,11,26,37
28236,FremontBridge,12/23/2015 12:00:00 PM,48,-122,22,24,46
28237,FremontBridge,12/23/2015 01:00:00 PM,48,-122,18,23,41
28238,FremontBridge,12/23/2015 02:00:00 PM,48,-122,38,20,58
28239,FremontBridge,12/23/2015 03:00:00 PM,48,-122,47,30,77
28240,FremontBridge,12/23/2015 04:00:00 PM,48,-122,93,38,131
28241,FremontBridge,12/23/2015 05:00:00 PM,48,-122,119,40,159
28242,FremontBridge,12/23/2015 06:00:00 PM,48,-122,41,28,69
28243,FremontBridge,12/23/2015 07:00:00 PM,48,-122,29,12,41
28244,FremontBridge,12/23/2015 08:00:00 PM,48,-122,14,9,23
28245,FremontBridge,12/23/2015 09:00:00 PM,48,-122,6,7,13
28246,FremontBridge,12/23/2015 10:00:00 PM,48,-122,4,4,8
28247,FremontBridge,12/23/2015 11:00:00 PM,48,-122,4,8,12
28248,FremontBridge,12/24/2015 12:00:00 AM,48,-122,5,1,6
28249,FremontBridge,12/24/2015 01:00:00 AM,48,-122,2,1,3
28250,FremontBridge,12/24/2015 02:00:00 AM,48,-122,1,0,1
28251,FremontBridge,12/24/2015 03:00:00 AM,48,-122,1,0,1
28252,FremontBridge,12/24/2015 04:00:00 AM,48,-122,2,0,2
28253,FremontBridge,12/24/2015 05:00:00 AM,48,-122,2,4,6
28254,FremontBridge,12/24/2015 06:00:00 AM,48,-122,5,17,22
28255,FremontBridge,12/24/2015 07:00:00 AM,48,-122,23,29,52
28256,FremontBridge,12/24/2015 08:00:00 AM,48,-122,17,37,54
28257,FremontBridge,12/24/2015 09:00:00 AM,48,-122,19,27,46
28258,FremontBridge,12/24/2015 10:00:00 AM,48,-122,9,19,28
28259,FremontBridge,12/24/2015 11:00:00 AM,48,-122,20,16,36
28260,FremontBridge,12/24/2015 12:00:00 PM,48,-122,22,26,48
28261,FremontBridge,12/24/2015 01:00:00 PM,48,-122,33,29,62
28262,FremontBridge,12/24/2015 02:00:00 PM,48,-122,30,35,65
28263,FremontBridge,12/24/2015 03:00:00 PM,48,-122,34,26,60
28264,FremontBridge,12/24/2015 04:00:00 PM,48,-122,22,8,30
28265,FremontBridge,12/24/2015 05:00:00 PM,48,-122,17,8,25
28266,FremontBridge,12/24/2015 06:00:00 PM,48,-122,10,8,18
28267,FremontBridge,12/24/2015 07:00:00 PM,48,-122,5,5,10
28268,FremontBridge,12/24/2015 08:00:00 PM,48,-122,5,1,6
28269,FremontBridge,12/24/2015 09:00:00 PM,48,-122,0,4,4
28270,FremontBridge,12/24/2015 10:00:00 PM,48,-122,2,3,5
28271,FremontBridge,12/24/2015 11:00:00 PM,48,-122,0,2,2
28272,FremontBridge,12/25/2015 12:00:00 AM,48,-122,1,0,1
28273,FremontBridge,12/25/2015 01:00:00 AM,48,-122,3,0,3
28274,FremontBridge,12/25/2015 02:00:00 AM,48,-122,4,0,4
28275,FremontBridge,12/25/2015 03:00:00 AM,48,-122,0,0,0
28276,FremontBridge,12/25/2015 04:00:00 AM,48,-122,1,0,1
28277,FremontBridge,12/25/2015 05:00:00 AM,48,-122,0,1,1
28278,FremontBridge,12/25/2015 06:00:00 AM,48,-122,1,0,1
28279,FremontBridge,12/25/2015 07:00:00 AM,48,-122,2,4,6
28280,FremontBridge,12/25/2015 08:00:00 AM,48,-122,4,0,4
28281,FremontBridge,12/25/2015 09:00:00 AM,48,-122,0,4,4
28282,FremontBridge,12/25/2015 10:00:00 AM,48,-122,6,5,11
28283,FremontBridge,12/25/2015 11:00:00 AM,48,-122,2,21,23
28284,FremontBridge,12/25/2015 12:00:00 PM,48,-122,13,13,26
28285,FremontBridge,12/25/2015 01:00:00 PM,48,-122,13,11,24
28286,FremontBridge,12/25/2015 02:00:00 PM,48,-122,19,26,45
28287,FremontBridge,12/25/2015 03:00:00 PM,48,-122,17,26,43
28288,FremontBridge,12/25/2015 04:00:00 PM,48,-122,10,10,20
28289,FremontBridge,12/25/2015 05:00:00 PM,48,-122,1,10,11
28290,FremontBridge,12/25/2015 06:00:00 PM,48,-122,3,5,8
28291,FremontBridge,12/25/2015 07:00:00 PM,48,-122,7,3,10
28292,FremontBridge,12/25/2015 08:00:00 PM,48,-122,2,4,6
28293,FremontBridge,12/25/2015 09:00:00 PM,48,-122,2,4,6
28294,FremontBridge,12/25/2015 10:00:00 PM,48,-122,3,1,4
28295,FremontBridge,12/25/2015 11:00:00 PM,48,-122,0,2,2
28296,FremontBridge,12/26/2015 12:00:00 AM,48,-122,1,1,2
28297,FremontBridge,12/26/2015 01:00:00 AM,48,-122,0,0,0
28298,FremontBridge,12/26/2015 02:00:00 AM,48,-122,0,0,0
28299,FremontBridge,12/26/2015 03:00:00 AM,48,-122,0,0,0
28300,FremontBridge,12/26/2015 04:00:00 AM,48,-122,1,0,1
28301,FremontBridge,12/26/2015 05:00:00 AM,48,-122,2,8,10
28302,FremontBridge,12/26/2015 06:00:00 AM,48,-122,3,3,6
28303,FremontBridge,12/26/2015 07:00:00 AM,48,-122,5,4,9
28304,FremontBridge,12/26/2015 08:00:00 AM,48,-122,3,8,11
28305,FremontBridge,12/26/2015 09:00:00 AM,48,-122,13,6,19
28306,FremontBridge,12/26/2015 10:00:00 AM,48,-122,13,29,42
28307,FremontBridge,12/26/2015 11:00:00 AM,48,-122,16,30,46
28308,FremontBridge,12/26/2015 12:00:00 PM,48,-122,21,22,43
28309,FremontBridge,12/26/2015 01:00:00 PM,48,-122,24,26,50
28310,FremontBridge,12/26/2015 02:00:00 PM,48,-122,30,25,55
28311,FremontBridge,12/26/2015 03:00:00 PM,48,-122,27,26,53
28312,FremontBridge,12/26/2015 04:00:00 PM,48,-122,18,19,37
28313,FremontBridge,12/26/2015 05:00:00 PM,48,-122,18,15,33
28314,FremontBridge,12/26/2015 06:00:00 PM,48,-122,13,8,21
28315,FremontBridge,12/26/2015 07:00:00 PM,48,-122,3,4,7
28316,FremontBridge,12/26/2015 08:00:00 PM,48,-122,12,4,16
28317,FremontBridge,12/26/2015 09:00:00 PM,48,-122,8,6,14
28318,FremontBridge,12/26/2015 10:00:00 PM,48,-122,3,4,7
28319,FremontBridge,12/26/2015 11:00:00 PM,48,-122,4,2,6
28320,FremontBridge,12/27/2015 12:00:00 AM,48,-122,3,2,5
28321,FremontBridge,12/27/2015 01:00:00 AM,48,-122,4,1,5
28322,FremontBridge,12/27/2015 02:00:00 AM,48,-122,0,2,2
28323,FremontBridge,12/27/2015 03:00:00 AM,48,-122,1,1,2
28324,FremontBridge,12/27/2015 04:00:00 AM,48,-122,1,0,1
28325,FremontBridge,12/27/2015 05:00:00 AM,48,-122,2,1,3
28326,FremontBridge,12/27/2015 06:00:00 AM,48,-122,4,5,9
28327,FremontBridge,12/27/2015 07:00:00 AM,48,-122,2,3,5
28328,FremontBridge,12/27/2015 08:00:00 AM,48,-122,7,7,14
28329,FremontBridge,12/27/2015 09:00:00 AM,48,-122,12,4,16
28330,FremontBridge,12/27/2015 10:00:00 AM,48,-122,8,12,20
28331,FremontBridge,12/27/2015 11:00:00 AM,48,-122,3,15,18
28332,FremontBridge,12/27/2015 12:00:00 PM,48,-122,7,5,12
28333,FremontBridge,12/27/2015 01:00:00 PM,48,-122,7,7,14
28334,FremontBridge,12/27/2015 02:00:00 PM,48,-122,7,9,16
28335,FremontBridge,12/27/2015 03:00:00 PM,48,-122,6,5,11
28336,FremontBridge,12/27/2015 04:00:00 PM,48,-122,9,5,14
28337,FremontBridge,12/27/2015 05:00:00 PM,48,-122,4,1,5
28338,FremontBridge,12/27/2015 06:00:00 PM,48,-122,2,3,5
28339,FremontBridge,12/27/2015 07:00:00 PM,48,-122,4,2,6
28340,FremontBridge,12/27/2015 08:00:00 PM,48,-122,1,1,2
28341,FremontBridge,12/27/2015 09:00:00 PM,48,-122,4,1,5
28342,FremontBridge,12/27/2015 10:00:00 PM,48,-122,3,4,7
28343,FremontBridge,12/27/2015 11:00:00 PM,48,-122,1,4,5
28344,FremontBridge,12/28/2015 12:00:00 AM,48,-122,3,1,4
28345,FremontBridge,12/28/2015 01:00:00 AM,48,-122,0,0,0
28346,FremontBridge,12/28/2015 02:00:00 AM,48,-122,1,0,1
28347,FremontBridge,12/28/2015 03:00:00 AM,48,-122,0,1,1
28348,FremontBridge,12/28/2015 04:00:00 AM,48,-122,1,2,3
28349,FremontBridge,12/28/2015 05:00:00 AM,48,-122,6,6,12
28350,FremontBridge,12/28/2015 06:00:00 AM,48,-122,17,30,47
28351,FremontBridge,12/28/2015 07:00:00 AM,48,-122,30,88,118
28352,FremontBridge,12/28/2015 08:00:00 AM,48,-122,47,111,158
28353,FremontBridge,12/28/2015 09:00:00 AM,48,-122,29,56,85
28354,FremontBridge,12/28/2015 10:00:00 AM,48,-122,24,19,43
28355,FremontBridge,12/28/2015 11:00:00 AM,48,-122,8,24,32
28356,FremontBridge,12/28/2015 12:00:00 PM,48,-122,15,14,29
28357,FremontBridge,12/28/2015 01:00:00 PM,48,-122,22,21,43
28358,FremontBridge,12/28/2015 02:00:00 PM,48,-122,27,14,41
28359,FremontBridge,12/28/2015 03:00:00 PM,48,-122,49,33,82
28360,FremontBridge,12/28/2015 04:00:00 PM,48,-122,75,40,115
28361,FremontBridge,12/28/2015 05:00:00 PM,48,-122,139,69,208
28362,FremontBridge,12/28/2015 06:00:00 PM,48,-122,61,32,93
28363,FremontBridge,12/28/2015 07:00:00 PM,48,-122,22,8,30
28364,FremontBridge,12/28/2015 08:00:00 PM,48,-122,17,7,24
28365,FremontBridge,12/28/2015 09:00:00 PM,48,-122,3,2,5
28366,FremontBridge,12/28/2015 10:00:00 PM,48,-122,8,5,13
28367,FremontBridge,12/28/2015 11:00:00 PM,48,-122,8,11,19
28368,FremontBridge,12/29/2015 12:00:00 AM,48,-122,2,1,3
28369,FremontBridge,12/29/2015 01:00:00 AM,48,-122,0,0,0
28370,FremontBridge,12/29/2015 02:00:00 AM,48,-122,1,0,1
28371,FremontBridge,12/29/2015 03:00:00 AM,48,-122,0,0,0
28372,FremontBridge,12/29/2015 04:00:00 AM,48,-122,3,3,6
28373,FremontBridge,12/29/2015 05:00:00 AM,48,-122,3,9,12
28374,FremontBridge,12/29/2015 06:00:00 AM,48,-122,23,29,52
28375,FremontBridge,12/29/2015 07:00:00 AM,48,-122,33,101,134
28376,FremontBridge,12/29/2015 08:00:00 AM,48,-122,64,135,199
28377,FremontBridge,12/29/2015 09:00:00 AM,48,-122,43,65,108
28378,FremontBridge,12/29/2015 10:00:00 AM,48,-122,41,31,72
28379,FremontBridge,12/29/2015 11:00:00 AM,48,-122,19,23,42
28380,FremontBridge,12/29/2015 12:00:00 PM,48,-122,21,24,45
28381,FremontBridge,12/29/2015 01:00:00 PM,48,-122,34,40,74
28382,FremontBridge,12/29/2015 02:00:00 PM,48,-122,30,33,63
28383,FremontBridge,12/29/2015 03:00:00 PM,48,-122,47,34,81
28384,FremontBridge,12/29/2015 04:00:00 PM,48,-122,92,57,149
28385,FremontBridge,12/29/2015 05:00:00 PM,48,-122,145,59,204
28386,FremontBridge,12/29/2015 06:00:00 PM,48,-122,91,50,141
28387,FremontBridge,12/29/2015 07:00:00 PM,48,-122,31,18,49
28388,FremontBridge,12/29/2015 08:00:00 PM,48,-122,12,17,29
28389,FremontBridge,12/29/2015 09:00:00 PM,48,-122,14,4,18
28390,FremontBridge,12/29/2015 10:00:00 PM,48,-122,9,7,16
28391,FremontBridge,12/29/2015 11:00:00 PM,48,-122,6,4,10
28392,FremontBridge,12/30/2015 12:00:00 AM,48,-122,5,2,7
28393,FremontBridge,12/30/2015 01:00:00 AM,48,-122,0,2,2
28394,FremontBridge,12/30/2015 02:00:00 AM,48,-122,0,0,0
28395,FremontBridge,12/30/2015 03:00:00 AM,48,-122,0,0,0
28396,FremontBridge,12/30/2015 04:00:00 AM,48,-122,2,3,5
28397,FremontBridge,12/30/2015 05:00:00 AM,48,-122,4,17,21
28398,FremontBridge,12/30/2015 06:00:00 AM,48,-122,17,25,42
28399,FremontBridge,12/30/2015 07:00:00 AM,48,-122,33,101,134
28400,FremontBridge,12/30/2015 08:00:00 AM,48,-122,53,113,166
28401,FremontBridge,12/30/2015 09:00:00 AM,48,-122,33,65,98
28402,FremontBridge,12/30/2015 10:00:00 AM,48,-122,31,33,64
28403,FremontBridge,12/30/2015 11:00:00 AM,48,-122,22,24,46
28404,FremontBridge,12/30/2015 12:00:00 PM,48,-122,19,34,53
28405,FremontBridge,12/30/2015 01:00:00 PM,48,-122,33,33,66
28406,FremontBridge,12/30/2015 02:00:00 PM,48,-122,47,37,84
28407,FremontBridge,12/30/2015 03:00:00 PM,48,-122,45,47,92
28408,FremontBridge,12/30/2015 04:00:00 PM,48,-122,80,70,150
28409,FremontBridge,12/30/2015 05:00:00 PM,48,-122,146,66,212
28410,FremontBridge,12/30/2015 06:00:00 PM,48,-122,81,26,107
28411,FremontBridge,12/30/2015 07:00:00 PM,48,-122,34,7,41
28412,FremontBridge,12/30/2015 08:00:00 PM,48,-122,20,9,29
28413,FremontBridge,12/30/2015 09:00:00 PM,48,-122,10,4,14
28414,FremontBridge,12/30/2015 10:00:00 PM,48,-122,4,5,9
28415,FremontBridge,12/30/2015 11:00:00 PM,48,-122,10,8,18
28416,FremontBridge,12/31/2015 12:00:00 AM,48,-122,2,3,5
28417,FremontBridge,12/31/2015 01:00:00 AM,48,-122,2,1,3
28418,FremontBridge,12/31/2015 02:00:00 AM,48,-122,1,1,2
28419,FremontBridge,12/31/2015 03:00:00 AM,48,-122,0,0,0
28420,FremontBridge,12/31/2015 04:00:00 AM,48,-122,2,3,5
28421,FremontBridge,12/31/2015 05:00:00 AM,48,-122,4,12,16
28422,FremontBridge,12/31/2015 06:00:00 AM,48,-122,16,17,33
28423,FremontBridge,12/31/2015 07:00:00 AM,48,-122,25,49,74
28424,FremontBridge,12/31/2015 08:00:00 AM,48,-122,32,68,100
28425,FremontBridge,12/31/2015 09:00:00 AM,48,-122,27,38,65
28426,FremontBridge,12/31/2015 10:00:00 AM,48,-122,22,21,43
28427,FremontBridge,12/31/2015 11:00:00 AM,48,-122,18,28,46
28428,FremontBridge,12/31/2015 12:00:00 PM,48,-122,27,41,68
28429,FremontBridge,12/31/2015 01:00:00 PM,48,-122,32,48,80
28430,FremontBridge,12/31/2015 02:00:00 PM,48,-122,64,41,105
28431,FremontBridge,12/31/2015 03:00:00 PM,48,-122,64,46,110
28432,FremontBridge,12/31/2015 04:00:00 PM,48,-122,61,48,109
28433,FremontBridge,12/31/2015 05:00:00 PM,48,-122,58,23,81
28434,FremontBridge,12/31/2015 06:00:00 PM,48,-122,30,14,44
28435,FremontBridge,12/31/2015 07:00:00 PM,48,-122,13,10,23
28436,FremontBridge,12/31/2015 08:00:00 PM,48,-122,10,2,12
28437,FremontBridge,12/31/2015 09:00:00 PM,48,-122,8,8,16
28438,FremontBridge,12/31/2015 10:00:00 PM,48,-122,5,7,12
28439,FremontBridge,12/31/2015 11:00:00 PM,48,-122,6,7,13
28440,FremontBridge,01/01/2016 12:00:00 AM,48,-122,9,9,18
28441,FremontBridge,01/01/2016 01:00:00 AM,48,-122,12,3,15
28442,FremontBridge,01/01/2016 02:00:00 AM,48,-122,5,6,11
28443,FremontBridge,01/01/2016 03:00:00 AM,48,-122,6,1,7
28444,FremontBridge,01/01/2016 04:00:00 AM,48,-122,2,0,2
28445,FremontBridge,01/01/2016 05:00:00 AM,48,-122,2,4,6
28446,FremontBridge,01/01/2016 06:00:00 AM,48,-122,1,2,3
28447,FremontBridge,01/01/2016 07:00:00 AM,48,-122,2,1,3
28448,FremontBridge,01/01/2016 08:00:00 AM,48,-122,9,2,11
28449,FremontBridge,01/01/2016 09:00:00 AM,48,-122,9,10,19
28450,FremontBridge,01/01/2016 10:00:00 AM,48,-122,14,10,24
28451,FremontBridge,01/01/2016 11:00:00 AM,48,-122,9,14,23
28452,FremontBridge,01/01/2016 12:00:00 PM,48,-122,20,31,51
28453,FremontBridge,01/01/2016 01:00:00 PM,48,-122,23,55,78
28454,FremontBridge,01/01/2016 02:00:00 PM,48,-122,27,57,84
28455,FremontBridge,01/01/2016 03:00:00 PM,48,-122,29,36,65
28456,FremontBridge,01/01/2016 04:00:00 PM,48,-122,27,30,57
28457,FremontBridge,01/01/2016 05:00:00 PM,48,-122,12,14,26
28458,FremontBridge,01/01/2016 06:00:00 PM,48,-122,3,8,11
28459,FremontBridge,01/01/2016 07:00:00 PM,48,-122,6,6,12
28460,FremontBridge,01/01/2016 08:00:00 PM,48,-122,7,5,12
28461,FremontBridge,01/01/2016 09:00:00 PM,48,-122,3,6,9
28462,FremontBridge,01/01/2016 10:00:00 PM,48,-122,8,3,11
28463,FremontBridge,01/01/2016 11:00:00 PM,48,-122,1,3,4
28464,FremontBridge,01/02/2016 12:00:00 AM,48,-122,1,2,3
28465,FremontBridge,01/02/2016 01:00:00 AM,48,-122,0,0,0
28466,FremontBridge,01/02/2016 02:00:00 AM,48,-122,0,1,1
28467,FremontBridge,01/02/2016 03:00:00 AM,48,-122,0,0,0
28468,FremontBridge,01/02/2016 04:00:00 AM,48,-122,2,1,3
28469,FremontBridge,01/02/2016 05:00:00 AM,48,-122,1,1,2
28470,FremontBridge,01/02/2016 06:00:00 AM,48,-122,4,2,6
28471,FremontBridge,01/02/2016 07:00:00 AM,48,-122,5,6,11
28472,FremontBridge,01/02/2016 08:00:00 AM,48,-122,10,12,22
28473,FremontBridge,01/02/2016 09:00:00 AM,48,-122,15,18,33
28474,FremontBridge,01/02/2016 10:00:00 AM,48,-122,18,27,45
28475,FremontBridge,01/02/2016 11:00:00 AM,48,-122,16,48,64
28476,FremontBridge,01/02/2016 12:00:00 PM,48,-122,37,26,63
28477,FremontBridge,01/02/2016 01:00:00 PM,48,-122,37,63,100
28478,FremontBridge,01/02/2016 02:00:00 PM,48,-122,41,60,101
28479,FremontBridge,01/02/2016 03:00:00 PM,48,-122,48,48,96
28480,FremontBridge,01/02/2016 04:00:00 PM,48,-122,24,35,59
28481,FremontBridge,01/02/2016 05:00:00 PM,48,-122,16,17,33
28482,FremontBridge,01/02/2016 06:00:00 PM,48,-122,23,7,30
28483,FremontBridge,01/02/2016 07:00:00 PM,48,-122,12,8,20
28484,FremontBridge,01/02/2016 08:00:00 PM,48,-122,6,5,11
28485,FremontBridge,01/02/2016 09:00:00 PM,48,-122,9,0,9
28486,FremontBridge,01/02/2016 10:00:00 PM,48,-122,8,6,14
28487,FremontBridge,01/02/2016 11:00:00 PM,48,-122,4,3,7
28488,FremontBridge,01/03/2016 12:00:00 AM,48,-122,0,2,2
28489,FremontBridge,01/03/2016 01:00:00 AM,48,-122,2,2,4
28490,FremontBridge,01/03/2016 02:00:00 AM,48,-122,1,3,4
28491,FremontBridge,01/03/2016 03:00:00 AM,48,-122,1,0,1
28492,FremontBridge,01/03/2016 04:00:00 AM,48,-122,0,0,0
28493,FremontBridge,01/03/2016 05:00:00 AM,48,-122,2,4,6
28494,FremontBridge,01/03/2016 06:00:00 AM,48,-122,5,1,6
28495,FremontBridge,01/03/2016 07:00:00 AM,48,-122,7,4,11
28496,FremontBridge,01/03/2016 08:00:00 AM,48,-122,10,10,20
28497,FremontBridge,01/03/2016 09:00:00 AM,48,-122,19,19,38
28498,FremontBridge,01/03/2016 10:00:00 AM,48,-122,22,25,47
28499,FremontBridge,01/03/2016 11:00:00 AM,48,-122,26,34,60
28500,FremontBridge,01/03/2016 12:00:00 PM,48,-122,22,21,43
28501,FremontBridge,01/03/2016 01:00:00 PM,48,-122,24,27,51
28502,FremontBridge,01/03/2016 02:00:00 PM,48,-122,10,19,29
28503,FremontBridge,01/03/2016 03:00:00 PM,48,-122,18,16,34
28504,FremontBridge,01/03/2016 04:00:00 PM,48,-122,14,14,28
28505,FremontBridge,01/03/2016 05:00:00 PM,48,-122,7,9,16
28506,FremontBridge,01/03/2016 06:00:00 PM,48,-122,5,7,12
28507,FremontBridge,01/03/2016 07:00:00 PM,48,-122,6,4,10
28508,FremontBridge,01/03/2016 08:00:00 PM,48,-122,6,5,11
28509,FremontBridge,01/03/2016 09:00:00 PM,48,-122,3,2,5
28510,FremontBridge,01/03/2016 10:00:00 PM,48,-122,1,2,3
28511,FremontBridge,01/03/2016 11:00:00 PM,48,-122,2,1,3
28512,FremontBridge,01/04/2016 12:00:00 AM,48,-122,0,0,0
28513,FremontBridge,01/04/2016 01:00:00 AM,48,-122,0,1,1
28514,FremontBridge,01/04/2016 02:00:00 AM,48,-122,0,0,0
28515,FremontBridge,01/04/2016 03:00:00 AM,48,-122,1,2,3
28516,FremontBridge,01/04/2016 04:00:00 AM,48,-122,3,2,5
28517,FremontBridge,01/04/2016 05:00:00 AM,48,-122,8,12,20
28518,FremontBridge,01/04/2016 06:00:00 AM,48,-122,29,42,71
28519,FremontBridge,01/04/2016 07:00:00 AM,48,-122,49,146,195
28520,FremontBridge,01/04/2016 08:00:00 AM,48,-122,101,194,295
28521,FremontBridge,01/04/2016 09:00:00 AM,48,-122,53,94,147
28522,FremontBridge,01/04/2016 10:00:00 AM,48,-122,26,28,54
28523,FremontBridge,01/04/2016 11:00:00 AM,48,-122,13,11,24
28524,FremontBridge,01/04/2016 12:00:00 PM,48,-122,12,9,21
28525,FremontBridge,01/04/2016 01:00:00 PM,48,-122,16,17,33
28526,FremontBridge,01/04/2016 02:00:00 PM,48,-122,26,15,41
28527,FremontBridge,01/04/2016 03:00:00 PM,48,-122,39,19,58
28528,FremontBridge,01/04/2016 04:00:00 PM,48,-122,94,54,148
28529,FremontBridge,01/04/2016 05:00:00 PM,48,-122,225,96,321
28530,FremontBridge,01/04/2016 06:00:00 PM,48,-122,155,69,224
28531,FremontBridge,01/04/2016 07:00:00 PM,48,-122,44,21,65
28532,FremontBridge,01/04/2016 08:00:00 PM,48,-122,24,13,37
28533,FremontBridge,01/04/2016 09:00:00 PM,48,-122,7,9,16
28534,FremontBridge,01/04/2016 10:00:00 PM,48,-122,8,5,13
28535,FremontBridge,01/04/2016 11:00:00 PM,48,-122,8,1,9
28536,FremontBridge,01/05/2016 12:00:00 AM,48,-122,0,4,4
28537,FremontBridge,01/05/2016 01:00:00 AM,48,-122,0,1,1
28538,FremontBridge,01/05/2016 02:00:00 AM,48,-122,0,1,1
28539,FremontBridge,01/05/2016 03:00:00 AM,48,-122,0,0,0
28540,FremontBridge,01/05/2016 04:00:00 AM,48,-122,3,3,6
28541,FremontBridge,01/05/2016 05:00:00 AM,48,-122,9,17,26
28542,FremontBridge,01/05/2016 06:00:00 AM,48,-122,27,58,85
28543,FremontBridge,01/05/2016 07:00:00 AM,48,-122,67,181,248
28544,FremontBridge,01/05/2016 08:00:00 AM,48,-122,93,207,300
28545,FremontBridge,01/05/2016 09:00:00 AM,48,-122,57,103,160
28546,FremontBridge,01/05/2016 10:00:00 AM,48,-122,36,36,72
28547,FremontBridge,01/05/2016 11:00:00 AM,48,-122,19,14,33
28548,FremontBridge,01/05/2016 12:00:00 PM,48,-122,15,15,30
28549,FremontBridge,01/05/2016 01:00:00 PM,48,-122,16,20,36
28550,FremontBridge,01/05/2016 02:00:00 PM,48,-122,33,12,45
28551,FremontBridge,01/05/2016 03:00:00 PM,48,-122,59,23,82
28552,FremontBridge,01/05/2016 04:00:00 PM,48,-122,124,55,179
28553,FremontBridge,01/05/2016 05:00:00 PM,48,-122,265,101,366
28554,FremontBridge,01/05/2016 06:00:00 PM,48,-122,165,64,229
28555,FremontBridge,01/05/2016 07:00:00 PM,48,-122,60,27,87
28556,FremontBridge,01/05/2016 08:00:00 PM,48,-122,24,13,37
28557,FremontBridge,01/05/2016 09:00:00 PM,48,-122,19,9,28
28558,FremontBridge,01/05/2016 10:00:00 PM,48,-122,9,7,16
28559,FremontBridge,01/05/2016 11:00:00 PM,48,-122,4,3,7
28560,FremontBridge,01/06/2016 12:00:00 AM,48,-122,1,4,5
28561,FremontBridge,01/06/2016 01:00:00 AM,48,-122,1,1,2
28562,FremontBridge,01/06/2016 02:00:00 AM,48,-122,1,1,2
28563,FremontBridge,01/06/2016 03:00:00 AM,48,-122,2,2,4
28564,FremontBridge,01/06/2016 04:00:00 AM,48,-122,2,5,7
28565,FremontBridge,01/06/2016 05:00:00 AM,48,-122,12,19,31
28566,FremontBridge,01/06/2016 06:00:00 AM,48,-122,32,67,99
28567,FremontBridge,01/06/2016 07:00:00 AM,48,-122,80,220,300
28568,FremontBridge,01/06/2016 08:00:00 AM,48,-122,118,256,374
28569,FremontBridge,01/06/2016 09:00:00 AM,48,-122,87,146,233
28570,FremontBridge,01/06/2016 10:00:00 AM,48,-122,33,38,71
28571,FremontBridge,01/06/2016 11:00:00 AM,48,-122,29,33,62
28572,FremontBridge,01/06/2016 12:00:00 PM,48,-122,27,44,71
28573,FremontBridge,01/06/2016 01:00:00 PM,48,-122,34,32,66
28574,FremontBridge,01/06/2016 02:00:00 PM,48,-122,39,31,70
28575,FremontBridge,01/06/2016 03:00:00 PM,48,-122,54,43,97
28576,FremontBridge,01/06/2016 04:00:00 PM,48,-122,155,85,240
28577,FremontBridge,01/06/2016 05:00:00 PM,48,-122,299,129,428
28578,FremontBridge,01/06/2016 06:00:00 PM,48,-122,165,105,270
28579,FremontBridge,01/06/2016 07:00:00 PM,48,-122,96,24,120
28580,FremontBridge,01/06/2016 08:00:00 PM,48,-122,28,26,54
28581,FremontBridge,01/06/2016 09:00:00 PM,48,-122,24,11,35
28582,FremontBridge,01/06/2016 10:00:00 PM,48,-122,20,15,35
28583,FremontBridge,01/06/2016 11:00:00 PM,48,-122,5,3,8
28584,FremontBridge,01/07/2016 12:00:00 AM,48,-122,3,7,10
28585,FremontBridge,01/07/2016 01:00:00 AM,48,-122,2,1,3
28586,FremontBridge,01/07/2016 02:00:00 AM,48,-122,0,0,0
28587,FremontBridge,01/07/2016 03:00:00 AM,48,-122,0,1,1
28588,FremontBridge,01/07/2016 04:00:00 AM,48,-122,2,3,5
28589,FremontBridge,01/07/2016 05:00:00 AM,48,-122,11,18,29
28590,FremontBridge,01/07/2016 06:00:00 AM,48,-122,31,82,113
28591,FremontBridge,01/07/2016 07:00:00 AM,48,-122,71,200,271
28592,FremontBridge,01/07/2016 08:00:00 AM,48,-122,112,261,373
28593,FremontBridge,01/07/2016 09:00:00 AM,48,-122,78,130,208
28594,FremontBridge,01/07/2016 10:00:00 AM,48,-122,23,46,69
28595,FremontBridge,01/07/2016 11:00:00 AM,48,-122,16,19,35
28596,FremontBridge,01/07/2016 12:00:00 PM,48,-122,31,23,54
28597,FremontBridge,01/07/2016 01:00:00 PM,48,-122,21,19,40
28598,FremontBridge,01/07/2016 02:00:00 PM,48,-122,27,33,60
28599,FremontBridge,01/07/2016 03:00:00 PM,48,-122,63,49,112
28600,FremontBridge,01/07/2016 04:00:00 PM,48,-122,121,57,178
28601,FremontBridge,01/07/2016 05:00:00 PM,48,-122,300,120,420
28602,FremontBridge,01/07/2016 06:00:00 PM,48,-122,172,106,278
28603,FremontBridge,01/07/2016 07:00:00 PM,48,-122,125,45,170
28604,FremontBridge,01/07/2016 08:00:00 PM,48,-122,44,17,61
28605,FremontBridge,01/07/2016 09:00:00 PM,48,-122,22,13,35
28606,FremontBridge,01/07/2016 10:00:00 PM,48,-122,19,10,29
28607,FremontBridge,01/07/2016 11:00:00 PM,48,-122,8,20,28
28608,FremontBridge,01/08/2016 12:00:00 AM,48,-122,4,8,12
28609,FremontBridge,01/08/2016 01:00:00 AM,48,-122,0,9,9
28610,FremontBridge,01/08/2016 02:00:00 AM,48,-122,0,2,2
28611,FremontBridge,01/08/2016 03:00:00 AM,48,-122,0,0,0
28612,FremontBridge,01/08/2016 04:00:00 AM,48,-122,3,2,5
28613,FremontBridge,01/08/2016 05:00:00 AM,48,-122,13,20,33
28614,FremontBridge,01/08/2016 06:00:00 AM,48,-122,27,52,79
28615,FremontBridge,01/08/2016 07:00:00 AM,48,-122,70,194,264
28616,FremontBridge,01/08/2016 08:00:00 AM,48,-122,107,222,329
28617,FremontBridge,01/08/2016 09:00:00 AM,48,-122,84,100,184
28618,FremontBridge,01/08/2016 10:00:00 AM,48,-122,20,44,64
28619,FremontBridge,01/08/2016 11:00:00 AM,48,-122,31,26,57
28620,FremontBridge,01/08/2016 12:00:00 PM,48,-122,31,30,61
28621,FremontBridge,01/08/2016 01:00:00 PM,48,-122,35,32,67
28622,FremontBridge,01/08/2016 02:00:00 PM,48,-122,42,42,84
28623,FremontBridge,01/08/2016 03:00:00 PM,48,-122,67,56,123
28624,FremontBridge,01/08/2016 04:00:00 PM,48,-122,133,94,227
28625,FremontBridge,01/08/2016 05:00:00 PM,48,-122,258,96,354
28626,FremontBridge,01/08/2016 06:00:00 PM,48,-122,149,78,227
28627,FremontBridge,01/08/2016 07:00:00 PM,48,-122,48,31,79
28628,FremontBridge,01/08/2016 08:00:00 PM,48,-122,31,18,49
28629,FremontBridge,01/08/2016 09:00:00 PM,48,-122,14,14,28
28630,FremontBridge,01/08/2016 10:00:00 PM,48,-122,10,14,24
28631,FremontBridge,01/08/2016 11:00:00 PM,48,-122,12,11,23
28632,FremontBridge,01/09/2016 12:00:00 AM,48,-122,4,4,8
28633,FremontBridge,01/09/2016 01:00:00 AM,48,-122,6,1,7
28634,FremontBridge,01/09/2016 02:00:00 AM,48,-122,3,3,6
28635,FremontBridge,01/09/2016 03:00:00 AM,48,-122,0,1,1
28636,FremontBridge,01/09/2016 04:00:00 AM,48,-122,1,0,1
28637,FremontBridge,01/09/2016 05:00:00 AM,48,-122,6,7,13
28638,FremontBridge,01/09/2016 06:00:00 AM,48,-122,5,4,9
28639,FremontBridge,01/09/2016 07:00:00 AM,48,-122,8,10,18
28640,FremontBridge,01/09/2016 08:00:00 AM,48,-122,20,21,41
28641,FremontBridge,01/09/2016 09:00:00 AM,48,-122,25,23,48
28642,FremontBridge,01/09/2016 10:00:00 AM,48,-122,20,54,74
28643,FremontBridge,01/09/2016 11:00:00 AM,48,-122,31,35,66
28644,FremontBridge,01/09/2016 12:00:00 PM,48,-122,50,63,113
28645,FremontBridge,01/09/2016 01:00:00 PM,48,-122,50,54,104
28646,FremontBridge,01/09/2016 02:00:00 PM,48,-122,37,60,97
28647,FremontBridge,01/09/2016 03:00:00 PM,48,-122,42,65,107
28648,FremontBridge,01/09/2016 04:00:00 PM,48,-122,30,40,70
28649,FremontBridge,01/09/2016 05:00:00 PM,48,-122,36,19,55
28650,FremontBridge,01/09/2016 06:00:00 PM,48,-122,15,12,27
28651,FremontBridge,01/09/2016 07:00:00 PM,48,-122,21,14,35
28652,FremontBridge,01/09/2016 08:00:00 PM,48,-122,11,5,16
28653,FremontBridge,01/09/2016 09:00:00 PM,48,-122,11,6,17
28654,FremontBridge,01/09/2016 10:00:00 PM,48,-122,6,11,17
28655,FremontBridge,01/09/2016 11:00:00 PM,48,-122,5,5,10
28656,FremontBridge,01/10/2016 12:00:00 AM,48,-122,5,1,6
28657,FremontBridge,01/10/2016 01:00:00 AM,48,-122,4,0,4
28658,FremontBridge,01/10/2016 02:00:00 AM,48,-122,1,2,3
28659,FremontBridge,01/10/2016 03:00:00 AM,48,-122,1,1,2
28660,FremontBridge,01/10/2016 04:00:00 AM,48,-122,0,0,0
28661,FremontBridge,01/10/2016 05:00:00 AM,48,-122,3,3,6
28662,FremontBridge,01/10/2016 06:00:00 AM,48,-122,3,3,6
28663,FremontBridge,01/10/2016 07:00:00 AM,48,-122,5,13,18
28664,FremontBridge,01/10/2016 08:00:00 AM,48,-122,6,17,23
28665,FremontBridge,01/10/2016 09:00:00 AM,48,-122,31,27,58
28666,FremontBridge,01/10/2016 10:00:00 AM,48,-122,20,40,60
28667,FremontBridge,01/10/2016 11:00:00 AM,48,-122,31,32,63
28668,FremontBridge,01/10/2016 12:00:00 PM,48,-122,37,40,77
28669,FremontBridge,01/10/2016 01:00:00 PM,48,-122,55,70,125
28670,FremontBridge,01/10/2016 02:00:00 PM,48,-122,63,103,166
28671,FremontBridge,01/10/2016 03:00:00 PM,48,-122,51,84,135
28672,FremontBridge,01/10/2016 04:00:00 PM,48,-122,50,60,110
28673,FremontBridge,01/10/2016 05:00:00 PM,48,-122,21,25,46
28674,FremontBridge,01/10/2016 06:00:00 PM,48,-122,9,15,24
28675,FremontBridge,01/10/2016 07:00:00 PM,48,-122,12,7,19
28676,FremontBridge,01/10/2016 08:00:00 PM,48,-122,8,6,14
28677,FremontBridge,01/10/2016 09:00:00 PM,48,-122,5,6,11
28678,FremontBridge,01/10/2016 10:00:00 PM,48,-122,7,5,12
28679,FremontBridge,01/10/2016 11:00:00 PM,48,-122,3,2,5
28680,FremontBridge,01/11/2016 12:00:00 AM,48,-122,3,0,3
28681,FremontBridge,01/11/2016 01:00:00 AM,48,-122,4,0,4
28682,FremontBridge,01/11/2016 02:00:00 AM,48,-122,0,0,0
28683,FremontBridge,01/11/2016 03:00:00 AM,48,-122,0,2,2
28684,FremontBridge,01/11/2016 04:00:00 AM,48,-122,3,6,9
28685,FremontBridge,01/11/2016 05:00:00 AM,48,-122,14,13,27
28686,FremontBridge,01/11/2016 06:00:00 AM,48,-122,27,63,90
28687,FremontBridge,01/11/2016 07:00:00 AM,48,-122,65,219,284
28688,FremontBridge,01/11/2016 08:00:00 AM,48,-122,114,225,339
28689,FremontBridge,01/11/2016 09:00:00 AM,48,-122,51,100,151
28690,FremontBridge,01/11/2016 10:00:00 AM,48,-122,29,31,60
28691,FremontBridge,01/11/2016 11:00:00 AM,48,-122,8,23,31
28692,FremontBridge,01/11/2016 12:00:00 PM,48,-122,12,15,27
28693,FremontBridge,01/11/2016 01:00:00 PM,48,-122,19,11,30
28694,FremontBridge,01/11/2016 02:00:00 PM,48,-122,23,21,44
28695,FremontBridge,01/11/2016 03:00:00 PM,48,-122,41,28,69
28696,FremontBridge,01/11/2016 04:00:00 PM,48,-122,114,63,177
28697,FremontBridge,01/11/2016 05:00:00 PM,48,-122,277,92,369
28698,FremontBridge,01/11/2016 06:00:00 PM,48,-122,175,72,247
28699,FremontBridge,01/11/2016 07:00:00 PM,48,-122,63,30,93
28700,FremontBridge,01/11/2016 08:00:00 PM,48,-122,31,15,46
28701,FremontBridge,01/11/2016 09:00:00 PM,48,-122,18,7,25
28702,FremontBridge,01/11/2016 10:00:00 PM,48,-122,7,10,17
28703,FremontBridge,01/11/2016 11:00:00 PM,48,-122,6,4,10
28704,FremontBridge,01/12/2016 12:00:00 AM,48,-122,1,1,2
28705,FremontBridge,01/12/2016 01:00:00 AM,48,-122,1,0,1
28706,FremontBridge,01/12/2016 02:00:00 AM,48,-122,1,0,1
28707,FremontBridge,01/12/2016 03:00:00 AM,48,-122,0,1,1
28708,FremontBridge,01/12/2016 04:00:00 AM,48,-122,3,2,5
28709,FremontBridge,01/12/2016 05:00:00 AM,48,-122,8,18,26
28710,FremontBridge,01/12/2016 06:00:00 AM,48,-122,33,57,90
28711,FremontBridge,01/12/2016 07:00:00 AM,48,-122,68,186,254
28712,FremontBridge,01/12/2016 08:00:00 AM,48,-122,87,226,313
28713,FremontBridge,01/12/2016 09:00:00 AM,48,-122,63,106,169
28714,FremontBridge,01/12/2016 10:00:00 AM,48,-122,28,28,56
28715,FremontBridge,01/12/2016 11:00:00 AM,48,-122,15,21,36
28716,FremontBridge,01/12/2016 12:00:00 PM,48,-122,18,16,34
28717,FremontBridge,01/12/2016 01:00:00 PM,48,-122,10,15,25
28718,FremontBridge,01/12/2016 02:00:00 PM,48,-122,33,12,45
28719,FremontBridge,01/12/2016 03:00:00 PM,48,-122,44,29,73
28720,FremontBridge,01/12/2016 04:00:00 PM,48,-122,101,56,157
28721,FremontBridge,01/12/2016 05:00:00 PM,48,-122,250,88,338
28722,FremontBridge,01/12/2016 06:00:00 PM,48,-122,160,46,206
28723,FremontBridge,01/12/2016 07:00:00 PM,48,-122,53,21,74
28724,FremontBridge,01/12/2016 08:00:00 PM,48,-122,23,11,34
28725,FremontBridge,01/12/2016 09:00:00 PM,48,-122,10,10,20
28726,FremontBridge,01/12/2016 10:00:00 PM,48,-122,6,10,16
28727,FremontBridge,01/12/2016 11:00:00 PM,48,-122,1,1,2
28728,FremontBridge,01/13/2016 12:00:00 AM,48,-122,1,2,3
28729,FremontBridge,01/13/2016 01:00:00 AM,48,-122,2,3,5
28730,FremontBridge,01/13/2016 02:00:00 AM,48,-122,1,0,1
28731,FremontBridge,01/13/2016 03:00:00 AM,48,-122,0,1,1
28732,FremontBridge,01/13/2016 04:00:00 AM,48,-122,2,1,3
28733,FremontBridge,01/13/2016 05:00:00 AM,48,-122,11,21,32
28734,FremontBridge,01/13/2016 06:00:00 AM,48,-122,29,63,92
28735,FremontBridge,01/13/2016 07:00:00 AM,48,-122,56,138,194
28736,FremontBridge,01/13/2016 08:00:00 AM,48,-122,82,156,238
28737,FremontBridge,01/13/2016 09:00:00 AM,48,-122,48,76,124
28738,FremontBridge,01/13/2016 10:00:00 AM,48,-122,22,27,49
28739,FremontBridge,01/13/2016 11:00:00 AM,48,-122,18,22,40
28740,FremontBridge,01/13/2016 12:00:00 PM,48,-122,11,17,28
28741,FremontBridge,01/13/2016 01:00:00 PM,48,-122,12,18,30
28742,FremontBridge,01/13/2016 02:00:00 PM,48,-122,29,13,42
28743,FremontBridge,01/13/2016 03:00:00 PM,48,-122,55,34,89
28744,FremontBridge,01/13/2016 04:00:00 PM,48,-122,89,51,140
28745,FremontBridge,01/13/2016 05:00:00 PM,48,-122,219,114,333
28746,FremontBridge,01/13/2016 06:00:00 PM,48,-122,150,53,203
28747,FremontBridge,01/13/2016 07:00:00 PM,48,-122,44,19,63
28748,FremontBridge,01/13/2016 08:00:00 PM,48,-122,36,8,44
28749,FremontBridge,01/13/2016 09:00:00 PM,48,-122,18,7,25
28750,FremontBridge,01/13/2016 10:00:00 PM,48,-122,13,9,22
28751,FremontBridge,01/13/2016 11:00:00 PM,48,-122,2,3,5
28752,FremontBridge,01/14/2016 12:00:00 AM,48,-122,1,2,3
28753,FremontBridge,01/14/2016 01:00:00 AM,48,-122,2,2,4
28754,FremontBridge,01/14/2016 02:00:00 AM,48,-122,0,1,1
28755,FremontBridge,01/14/2016 03:00:00 AM,48,-122,0,1,1
28756,FremontBridge,01/14/2016 04:00:00 AM,48,-122,2,2,4
28757,FremontBridge,01/14/2016 05:00:00 AM,48,-122,11,16,27
28758,FremontBridge,01/14/2016 06:00:00 AM,48,-122,32,70,102
28759,FremontBridge,01/14/2016 07:00:00 AM,48,-122,74,194,268
28760,FremontBridge,01/14/2016 08:00:00 AM,48,-122,111,261,372
28761,FremontBridge,01/14/2016 09:00:00 AM,48,-122,66,113,179
28762,FremontBridge,01/14/2016 10:00:00 AM,48,-122,43,62,105
28763,FremontBridge,01/14/2016 11:00:00 AM,48,-122,13,30,43
28764,FremontBridge,01/14/2016 12:00:00 PM,48,-122,30,39,69
28765,FremontBridge,01/14/2016 01:00:00 PM,48,-122,38,34,72
28766,FremontBridge,01/14/2016 02:00:00 PM,48,-122,46,30,76
28767,FremontBridge,01/14/2016 03:00:00 PM,48,-122,65,53,118
28768,FremontBridge,01/14/2016 04:00:00 PM,48,-122,141,70,211
28769,FremontBridge,01/14/2016 05:00:00 PM,48,-122,275,129,404
28770,FremontBridge,01/14/2016 06:00:00 PM,48,-122,183,102,285
28771,FremontBridge,01/14/2016 07:00:00 PM,48,-122,70,38,108
28772,FremontBridge,01/14/2016 08:00:00 PM,48,-122,43,22,65
28773,FremontBridge,01/14/2016 09:00:00 PM,48,-122,29,29,58
28774,FremontBridge,01/14/2016 10:00:00 PM,48,-122,21,6,27
28775,FremontBridge,01/14/2016 11:00:00 PM,48,-122,11,10,21
28776,FremontBridge,01/15/2016 12:00:00 AM,48,-122,6,5,11
28777,FremontBridge,01/15/2016 01:00:00 AM,48,-122,1,0,1
28778,FremontBridge,01/15/2016 02:00:00 AM,48,-122,0,1,1
28779,FremontBridge,01/15/2016 03:00:00 AM,48,-122,0,2,2
28780,FremontBridge,01/15/2016 04:00:00 AM,48,-122,3,0,3
28781,FremontBridge,01/15/2016 05:00:00 AM,48,-122,8,15,23
28782,FremontBridge,01/15/2016 06:00:00 AM,48,-122,29,50,79
28783,FremontBridge,01/15/2016 07:00:00 AM,48,-122,53,154,207
28784,FremontBridge,01/15/2016 08:00:00 AM,48,-122,88,189,277
28785,FremontBridge,01/15/2016 09:00:00 AM,48,-122,65,117,182
28786,FremontBridge,01/15/2016 10:00:00 AM,48,-122,27,27,54
28787,FremontBridge,01/15/2016 11:00:00 AM,48,-122,19,13,32
28788,FremontBridge,01/15/2016 12:00:00 PM,48,-122,17,17,34
28789,FremontBridge,01/15/2016 01:00:00 PM,48,-122,23,23,46
28790,FremontBridge,01/15/2016 02:00:00 PM,48,-122,41,19,60
28791,FremontBridge,01/15/2016 03:00:00 PM,48,-122,48,37,85
28792,FremontBridge,01/15/2016 04:00:00 PM,48,-122,102,65,167
28793,FremontBridge,01/15/2016 05:00:00 PM,48,-122,221,91,312
28794,FremontBridge,01/15/2016 06:00:00 PM,48,-122,125,53,178
28795,FremontBridge,01/15/2016 07:00:00 PM,48,-122,47,31,78
28796,FremontBridge,01/15/2016 08:00:00 PM,48,-122,23,11,34
28797,FremontBridge,01/15/2016 09:00:00 PM,48,-122,7,8,15
28798,FremontBridge,01/15/2016 10:00:00 PM,48,-122,7,10,17
28799,FremontBridge,01/15/2016 11:00:00 PM,48,-122,11,3,14
28800,FremontBridge,01/16/2016 12:00:00 AM,48,-122,5,2,7
28801,FremontBridge,01/16/2016 01:00:00 AM,48,-122,3,2,5
28802,FremontBridge,01/16/2016 02:00:00 AM,48,-122,0,1,1
28803,FremontBridge,01/16/2016 03:00:00 AM,48,-122,0,0,0
28804,FremontBridge,01/16/2016 04:00:00 AM,48,-122,1,1,2
28805,FremontBridge,01/16/2016 05:00:00 AM,48,-122,5,4,9
28806,FremontBridge,01/16/2016 06:00:00 AM,48,-122,5,6,11
28807,FremontBridge,01/16/2016 07:00:00 AM,48,-122,7,7,14
28808,FremontBridge,01/16/2016 08:00:00 AM,48,-122,13,10,23
28809,FremontBridge,01/16/2016 09:00:00 AM,48,-122,12,6,18
28810,FremontBridge,01/16/2016 10:00:00 AM,48,-122,13,20,33
28811,FremontBridge,01/16/2016 11:00:00 AM,48,-122,27,31,58
28812,FremontBridge,01/16/2016 12:00:00 PM,48,-122,26,37,63
28813,FremontBridge,01/16/2016 01:00:00 PM,48,-122,27,46,73
28814,FremontBridge,01/16/2016 02:00:00 PM,48,-122,32,26,58
28815,FremontBridge,01/16/2016 03:00:00 PM,48,-122,15,19,34
28816,FremontBridge,01/16/2016 04:00:00 PM,48,-122,19,14,33
28817,FremontBridge,01/16/2016 05:00:00 PM,48,-122,13,15,28
28818,FremontBridge,01/16/2016 06:00:00 PM,48,-122,10,7,17
28819,FremontBridge,01/16/2016 07:00:00 PM,48,-122,14,8,22
28820,FremontBridge,01/16/2016 08:00:00 PM,48,-122,9,6,15
28821,FremontBridge,01/16/2016 09:00:00 PM,48,-122,11,6,17
28822,FremontBridge,01/16/2016 10:00:00 PM,48,-122,6,9,15
28823,FremontBridge,01/16/2016 11:00:00 PM,48,-122,11,7,18
28824,FremontBridge,01/17/2016 12:00:00 AM,48,-122,9,1,10
28825,FremontBridge,01/17/2016 01:00:00 AM,48,-122,1,6,7
28826,FremontBridge,01/17/2016 02:00:00 AM,48,-122,0,0,0
28827,FremontBridge,01/17/2016 03:00:00 AM,48,-122,1,0,1
28828,FremontBridge,01/17/2016 04:00:00 AM,48,-122,1,0,1
28829,FremontBridge,01/17/2016 05:00:00 AM,48,-122,2,2,4
28830,FremontBridge,01/17/2016 06:00:00 AM,48,-122,3,2,5
28831,FremontBridge,01/17/2016 07:00:00 AM,48,-122,4,3,7
28832,FremontBridge,01/17/2016 08:00:00 AM,48,-122,12,12,24
28833,FremontBridge,01/17/2016 09:00:00 AM,48,-122,7,8,15
28834,FremontBridge,01/17/2016 10:00:00 AM,48,-122,10,11,21
28835,FremontBridge,01/17/2016 11:00:00 AM,48,-122,10,9,19
28836,FremontBridge,01/17/2016 12:00:00 PM,48,-122,16,20,36
28837,FremontBridge,01/17/2016 01:00:00 PM,48,-122,16,13,29
28838,FremontBridge,01/17/2016 02:00:00 PM,48,-122,19,18,37
28839,FremontBridge,01/17/2016 03:00:00 PM,48,-122,16,24,40
28840,FremontBridge,01/17/2016 04:00:00 PM,48,-122,12,24,36
28841,FremontBridge,01/17/2016 05:00:00 PM,48,-122,24,10,34
28842,FremontBridge,01/17/2016 06:00:00 PM,48,-122,8,3,11
28843,FremontBridge,01/17/2016 07:00:00 PM,48,-122,14,4,18
28844,FremontBridge,01/17/2016 08:00:00 PM,48,-122,5,7,12
28845,FremontBridge,01/17/2016 09:00:00 PM,48,-122,12,3,15
28846,FremontBridge,01/17/2016 10:00:00 PM,48,-122,10,2,12
28847,FremontBridge,01/17/2016 11:00:00 PM,48,-122,4,4,8
28848,FremontBridge,01/18/2016 12:00:00 AM,48,-122,2,0,2
28849,FremontBridge,01/18/2016 01:00:00 AM,48,-122,0,0,0
28850,FremontBridge,01/18/2016 02:00:00 AM,48,-122,0,0,0
28851,FremontBridge,01/18/2016 03:00:00 AM,48,-122,1,0,1
28852,FremontBridge,01/18/2016 04:00:00 AM,48,-122,2,2,4
28853,FremontBridge,01/18/2016 05:00:00 AM,48,-122,6,10,16
28854,FremontBridge,01/18/2016 06:00:00 AM,48,-122,19,34,53
28855,FremontBridge,01/18/2016 07:00:00 AM,48,-122,44,88,132
28856,FremontBridge,01/18/2016 08:00:00 AM,48,-122,56,125,181
28857,FremontBridge,01/18/2016 09:00:00 AM,48,-122,45,83,128
28858,FremontBridge,01/18/2016 10:00:00 AM,48,-122,33,33,66
28859,FremontBridge,01/18/2016 11:00:00 AM,48,-122,27,38,65
28860,FremontBridge,01/18/2016 12:00:00 PM,48,-122,29,44,73
28861,FremontBridge,01/18/2016 01:00:00 PM,48,-122,45,47,92
28862,FremontBridge,01/18/2016 02:00:00 PM,48,-122,50,78,128
28863,FremontBridge,01/18/2016 03:00:00 PM,48,-122,59,49,108
28864,FremontBridge,01/18/2016 04:00:00 PM,48,-122,75,50,125
28865,FremontBridge,01/18/2016 05:00:00 PM,48,-122,160,73,233
28866,FremontBridge,01/18/2016 06:00:00 PM,48,-122,115,55,170
28867,FremontBridge,01/18/2016 07:00:00 PM,48,-122,38,18,56
28868,FremontBridge,01/18/2016 08:00:00 PM,48,-122,19,25,44
28869,FremontBridge,01/18/2016 09:00:00 PM,48,-122,7,5,12
28870,FremontBridge,01/18/2016 10:00:00 PM,48,-122,7,6,13
28871,FremontBridge,01/18/2016 11:00:00 PM,48,-122,5,1,6
28872,FremontBridge,01/19/2016 12:00:00 AM,48,-122,1,4,5
28873,FremontBridge,01/19/2016 01:00:00 AM,48,-122,0,0,0
28874,FremontBridge,01/19/2016 02:00:00 AM,48,-122,2,0,2
28875,FremontBridge,01/19/2016 03:00:00 AM,48,-122,0,1,1
28876,FremontBridge,01/19/2016 04:00:00 AM,48,-122,3,1,4
28877,FremontBridge,01/19/2016 05:00:00 AM,48,-122,9,30,39
28878,FremontBridge,01/19/2016 06:00:00 AM,48,-122,35,68,103
28879,FremontBridge,01/19/2016 07:00:00 AM,48,-122,76,212,288
28880,FremontBridge,01/19/2016 08:00:00 AM,48,-122,148,267,415
28881,FremontBridge,01/19/2016 09:00:00 AM,48,-122,74,125,199
28882,FremontBridge,01/19/2016 10:00:00 AM,48,-122,26,27,53
28883,FremontBridge,01/19/2016 11:00:00 AM,48,-122,28,36,64
28884,FremontBridge,01/19/2016 12:00:00 PM,48,-122,25,17,42
28885,FremontBridge,01/19/2016 01:00:00 PM,48,-122,16,17,33
28886,FremontBridge,01/19/2016 02:00:00 PM,48,-122,30,18,48
28887,FremontBridge,01/19/2016 03:00:00 PM,48,-122,41,30,71
28888,FremontBridge,01/19/2016 04:00:00 PM,48,-122,110,60,170
28889,FremontBridge,01/19/2016 05:00:00 PM,48,-122,273,89,362
28890,FremontBridge,01/19/2016 06:00:00 PM,48,-122,183,68,251
28891,FremontBridge,01/19/2016 07:00:00 PM,48,-122,83,31,114
28892,FremontBridge,01/19/2016 08:00:00 PM,48,-122,30,14,44
28893,FremontBridge,01/19/2016 09:00:00 PM,48,-122,20,9,29
28894,FremontBridge,01/19/2016 10:00:00 PM,48,-122,10,5,15
28895,FremontBridge,01/19/2016 11:00:00 PM,48,-122,6,1,7
28896,FremontBridge,01/20/2016 12:00:00 AM,48,-122,2,4,6
28897,FremontBridge,01/20/2016 01:00:00 AM,48,-122,1,3,4
28898,FremontBridge,01/20/2016 02:00:00 AM,48,-122,2,0,2
28899,FremontBridge,01/20/2016 03:00:00 AM,48,-122,0,0,0
28900,FremontBridge,01/20/2016 04:00:00 AM,48,-122,2,7,9
28901,FremontBridge,01/20/2016 05:00:00 AM,48,-122,11,18,29
28902,FremontBridge,01/20/2016 06:00:00 AM,48,-122,34,62,96
28903,FremontBridge,01/20/2016 07:00:00 AM,48,-122,82,194,276
28904,FremontBridge,01/20/2016 08:00:00 AM,48,-122,112,257,369
28905,FremontBridge,01/20/2016 09:00:00 AM,48,-122,73,140,213
28906,FremontBridge,01/20/2016 10:00:00 AM,48,-122,30,40,70
28907,FremontBridge,01/20/2016 11:00:00 AM,48,-122,21,22,43
28908,FremontBridge,01/20/2016 12:00:00 PM,48,-122,22,25,47
28909,FremontBridge,01/20/2016 01:00:00 PM,48,-122,25,23,48
28910,FremontBridge,01/20/2016 02:00:00 PM,48,-122,48,32,80
28911,FremontBridge,01/20/2016 03:00:00 PM,48,-122,62,38,100
28912,FremontBridge,01/20/2016 04:00:00 PM,48,-122,151,85,236
28913,FremontBridge,01/20/2016 05:00:00 PM,48,-122,306,106,412
28914,FremontBridge,01/20/2016 06:00:00 PM,48,-122,205,88,293
28915,FremontBridge,01/20/2016 07:00:00 PM,48,-122,87,37,124
28916,FremontBridge,01/20/2016 08:00:00 PM,48,-122,39,21,60
28917,FremontBridge,01/20/2016 09:00:00 PM,48,-122,23,20,43
28918,FremontBridge,01/20/2016 10:00:00 PM,48,-122,13,6,19
28919,FremontBridge,01/20/2016 11:00:00 PM,48,-122,4,5,9
28920,FremontBridge,01/21/2016 12:00:00 AM,48,-122,2,3,5
28921,FremontBridge,01/21/2016 01:00:00 AM,48,-122,0,0,0
28922,FremontBridge,01/21/2016 02:00:00 AM,48,-122,0,0,0
28923,FremontBridge,01/21/2016 03:00:00 AM,48,-122,0,1,1
28924,FremontBridge,01/21/2016 04:00:00 AM,48,-122,2,2,4
28925,FremontBridge,01/21/2016 05:00:00 AM,48,-122,9,11,20
28926,FremontBridge,01/21/2016 06:00:00 AM,48,-122,23,51,74
28927,FremontBridge,01/21/2016 07:00:00 AM,48,-122,40,141,181
28928,FremontBridge,01/21/2016 08:00:00 AM,48,-122,72,131,203
28929,FremontBridge,01/21/2016 09:00:00 AM,48,-122,34,70,104
28930,FremontBridge,01/21/2016 10:00:00 AM,48,-122,18,20,38
28931,FremontBridge,01/21/2016 11:00:00 AM,48,-122,4,13,17
28932,FremontBridge,01/21/2016 12:00:00 PM,48,-122,6,6,12
28933,FremontBridge,01/21/2016 01:00:00 PM,48,-122,7,8,15
28934,FremontBridge,01/21/2016 02:00:00 PM,48,-122,18,12,30
28935,FremontBridge,01/21/2016 03:00:00 PM,48,-122,25,11,36
28936,FremontBridge,01/21/2016 04:00:00 PM,48,-122,63,33,96
28937,FremontBridge,01/21/2016 05:00:00 PM,48,-122,168,67,235
28938,FremontBridge,01/21/2016 06:00:00 PM,48,-122,114,51,165
28939,FremontBridge,01/21/2016 07:00:00 PM,48,-122,36,13,49
28940,FremontBridge,01/21/2016 08:00:00 PM,48,-122,28,14,42
28941,FremontBridge,01/21/2016 09:00:00 PM,48,-122,16,6,22
28942,FremontBridge,01/21/2016 10:00:00 PM,48,-122,6,10,16
28943,FremontBridge,01/21/2016 11:00:00 PM,48,-122,3,0,3
28944,FremontBridge,01/22/2016 12:00:00 AM,48,-122,7,4,11
28945,FremontBridge,01/22/2016 01:00:00 AM,48,-122,2,0,2
28946,FremontBridge,01/22/2016 02:00:00 AM,48,-122,0,0,0
28947,FremontBridge,01/22/2016 03:00:00 AM,48,-122,1,1,2
28948,FremontBridge,01/22/2016 04:00:00 AM,48,-122,3,1,4
28949,FremontBridge,01/22/2016 05:00:00 AM,48,-122,6,11,17
28950,FremontBridge,01/22/2016 06:00:00 AM,48,-122,20,36,56
28951,FremontBridge,01/22/2016 07:00:00 AM,48,-122,49,136,185
28952,FremontBridge,01/22/2016 08:00:00 AM,48,-122,100,206,306
28953,FremontBridge,01/22/2016 09:00:00 AM,48,-122,64,104,168
28954,FremontBridge,01/22/2016 10:00:00 AM,48,-122,30,35,65
28955,FremontBridge,01/22/2016 11:00:00 AM,48,-122,23,30,53
28956,FremontBridge,01/22/2016 12:00:00 PM,48,-122,33,39,72
28957,FremontBridge,01/22/2016 01:00:00 PM,48,-122,25,27,52
28958,FremontBridge,01/22/2016 02:00:00 PM,48,-122,52,39,91
28959,FremontBridge,01/22/2016 03:00:00 PM,48,-122,52,57,109
28960,FremontBridge,01/22/2016 04:00:00 PM,48,-122,127,85,212
28961,FremontBridge,01/22/2016 05:00:00 PM,48,-122,235,98,333
28962,FremontBridge,01/22/2016 06:00:00 PM,48,-122,149,58,207
28963,FremontBridge,01/22/2016 07:00:00 PM,48,-122,57,35,92
28964,FremontBridge,01/22/2016 08:00:00 PM,48,-122,22,22,44
28965,FremontBridge,01/22/2016 09:00:00 PM,48,-122,19,12,31
28966,FremontBridge,01/22/2016 10:00:00 PM,48,-122,16,9,25
28967,FremontBridge,01/22/2016 11:00:00 PM,48,-122,13,10,23
28968,FremontBridge,01/23/2016 12:00:00 AM,48,-122,4,5,9
28969,FremontBridge,01/23/2016 01:00:00 AM,48,-122,5,6,11
28970,FremontBridge,01/23/2016 02:00:00 AM,48,-122,6,1,7
28971,FremontBridge,01/23/2016 03:00:00 AM,48,-122,0,1,1
28972,FremontBridge,01/23/2016 04:00:00 AM,48,-122,3,0,3
28973,FremontBridge,01/23/2016 05:00:00 AM,48,-122,3,3,6
28974,FremontBridge,01/23/2016 06:00:00 AM,48,-122,4,0,4
28975,FremontBridge,01/23/2016 07:00:00 AM,48,-122,4,9,13
28976,FremontBridge,01/23/2016 08:00:00 AM,48,-122,13,10,23
28977,FremontBridge,01/23/2016 09:00:00 AM,48,-122,15,14,29
28978,FremontBridge,01/23/2016 10:00:00 AM,48,-122,14,13,27
28979,FremontBridge,01/23/2016 11:00:00 AM,48,-122,13,17,30
28980,FremontBridge,01/23/2016 12:00:00 PM,48,-122,14,15,29
28981,FremontBridge,01/23/2016 01:00:00 PM,48,-122,17,9,26
28982,FremontBridge,01/23/2016 02:00:00 PM,48,-122,21,13,34
28983,FremontBridge,01/23/2016 03:00:00 PM,48,-122,15,19,34
28984,FremontBridge,01/23/2016 04:00:00 PM,48,-122,7,11,18
28985,FremontBridge,01/23/2016 05:00:00 PM,48,-122,15,15,30
28986,FremontBridge,01/23/2016 06:00:00 PM,48,-122,19,9,28
28987,FremontBridge,01/23/2016 07:00:00 PM,48,-122,8,4,12
28988,FremontBridge,01/23/2016 08:00:00 PM,48,-122,5,5,10
28989,FremontBridge,01/23/2016 09:00:00 PM,48,-122,8,5,13
28990,FremontBridge,01/23/2016 10:00:00 PM,48,-122,3,11,14
28991,FremontBridge,01/23/2016 11:00:00 PM,48,-122,5,2,7
28992,FremontBridge,01/24/2016 12:00:00 AM,48,-122,1,3,4
28993,FremontBridge,01/24/2016 01:00:00 AM,48,-122,2,2,4
28994,FremontBridge,01/24/2016 02:00:00 AM,48,-122,1,2,3
28995,FremontBridge,01/24/2016 03:00:00 AM,48,-122,1,0,1
28996,FremontBridge,01/24/2016 04:00:00 AM,48,-122,0,1,1
28997,FremontBridge,01/24/2016 05:00:00 AM,48,-122,2,3,5
28998,FremontBridge,01/24/2016 06:00:00 AM,48,-122,3,5,8
28999,FremontBridge,01/24/2016 07:00:00 AM,48,-122,4,9,13
29000,FremontBridge,01/24/2016 08:00:00 AM,48,-122,10,25,35
29001,FremontBridge,01/24/2016 09:00:00 AM,48,-122,18,27,45
29002,FremontBridge,01/24/2016 10:00:00 AM,48,-122,26,39,65
29003,FremontBridge,01/24/2016 11:00:00 AM,48,-122,63,65,128
29004,FremontBridge,01/24/2016 12:00:00 PM,48,-122,49,74,123
29005,FremontBridge,01/24/2016 01:00:00 PM,48,-122,46,77,123
29006,FremontBridge,01/24/2016 02:00:00 PM,48,-122,52,81,133
29007,FremontBridge,01/24/2016 03:00:00 PM,48,-122,49,49,98
29008,FremontBridge,01/24/2016 04:00:00 PM,48,-122,54,54,108
29009,FremontBridge,01/24/2016 05:00:00 PM,48,-122,28,35,63
29010,FremontBridge,01/24/2016 06:00:00 PM,48,-122,12,26,38
29011,FremontBridge,01/24/2016 07:00:00 PM,48,-122,4,7,11
29012,FremontBridge,01/24/2016 08:00:00 PM,48,-122,7,9,16
29013,FremontBridge,01/24/2016 09:00:00 PM,48,-122,6,4,10
29014,FremontBridge,01/24/2016 10:00:00 PM,48,-122,4,4,8
29015,FremontBridge,01/24/2016 11:00:00 PM,48,-122,5,4,9
29016,FremontBridge,01/25/2016 12:00:00 AM,48,-122,1,2,3
29017,FremontBridge,01/25/2016 01:00:00 AM,48,-122,1,0,1
29018,FremontBridge,01/25/2016 02:00:00 AM,48,-122,2,0,2
29019,FremontBridge,01/25/2016 03:00:00 AM,48,-122,1,1,2
29020,FremontBridge,01/25/2016 04:00:00 AM,48,-122,2,3,5
29021,FremontBridge,01/25/2016 05:00:00 AM,48,-122,9,21,30
29022,FremontBridge,01/25/2016 06:00:00 AM,48,-122,32,87,119
29023,FremontBridge,01/25/2016 07:00:00 AM,48,-122,81,248,329
29024,FremontBridge,01/25/2016 08:00:00 AM,48,-122,137,292,429
29025,FremontBridge,01/25/2016 09:00:00 AM,48,-122,76,138,214
29026,FremontBridge,01/25/2016 10:00:00 AM,48,-122,42,44,86
29027,FremontBridge,01/25/2016 11:00:00 AM,48,-122,38,49,87
29028,FremontBridge,01/25/2016 12:00:00 PM,48,-122,16,34,50
29029,FremontBridge,01/25/2016 01:00:00 PM,48,-122,32,42,74
29030,FremontBridge,01/25/2016 02:00:00 PM,48,-122,49,37,86
29031,FremontBridge,01/25/2016 03:00:00 PM,48,-122,76,65,141
29032,FremontBridge,01/25/2016 04:00:00 PM,48,-122,162,83,245
29033,FremontBridge,01/25/2016 05:00:00 PM,48,-122,358,143,501
29034,FremontBridge,01/25/2016 06:00:00 PM,48,-122,191,121,312
29035,FremontBridge,01/25/2016 07:00:00 PM,48,-122,88,44,132
29036,FremontBridge,01/25/2016 08:00:00 PM,48,-122,30,20,50
29037,FremontBridge,01/25/2016 09:00:00 PM,48,-122,13,15,28
29038,FremontBridge,01/25/2016 10:00:00 PM,48,-122,13,15,28
29039,FremontBridge,01/25/2016 11:00:00 PM,48,-122,7,7,14
29040,FremontBridge,01/26/2016 12:00:00 AM,48,-122,1,2,3
29041,FremontBridge,01/26/2016 01:00:00 AM,48,-122,3,1,4
29042,FremontBridge,01/26/2016 02:00:00 AM,48,-122,2,0,2
29043,FremontBridge,01/26/2016 03:00:00 AM,48,-122,1,1,2
29044,FremontBridge,01/26/2016 04:00:00 AM,48,-122,1,2,3
29045,FremontBridge,01/26/2016 05:00:00 AM,48,-122,14,12,26
29046,FremontBridge,01/26/2016 06:00:00 AM,48,-122,28,71,99
29047,FremontBridge,01/26/2016 07:00:00 AM,48,-122,77,190,267
29048,FremontBridge,01/26/2016 08:00:00 AM,48,-122,107,233,340
29049,FremontBridge,01/26/2016 09:00:00 AM,48,-122,55,90,145
29050,FremontBridge,01/26/2016 10:00:00 AM,48,-122,25,30,55
29051,FremontBridge,01/26/2016 11:00:00 AM,48,-122,17,13,30
29052,FremontBridge,01/26/2016 12:00:00 PM,48,-122,20,14,34
29053,FremontBridge,01/26/2016 01:00:00 PM,48,-122,12,21,33
29054,FremontBridge,01/26/2016 02:00:00 PM,48,-122,30,17,47
29055,FremontBridge,01/26/2016 03:00:00 PM,48,-122,43,36,79
29056,FremontBridge,01/26/2016 04:00:00 PM,48,-122,115,47,162
29057,FremontBridge,01/26/2016 05:00:00 PM,48,-122,271,97,368
29058,FremontBridge,01/26/2016 06:00:00 PM,48,-122,174,80,254
29059,FremontBridge,01/26/2016 07:00:00 PM,48,-122,62,33,95
29060,FremontBridge,01/26/2016 08:00:00 PM,48,-122,40,25,65
29061,FremontBridge,01/26/2016 09:00:00 PM,48,-122,15,16,31
29062,FremontBridge,01/26/2016 10:00:00 PM,48,-122,7,7,14
29063,FremontBridge,01/26/2016 11:00:00 PM,48,-122,6,4,10
29064,FremontBridge,01/27/2016 12:00:00 AM,48,-122,1,3,4
29065,FremontBridge,01/27/2016 01:00:00 AM,48,-122,1,1,2
29066,FremontBridge,01/27/2016 02:00:00 AM,48,-122,2,0,2
29067,FremontBridge,01/27/2016 03:00:00 AM,48,-122,0,2,2
29068,FremontBridge,01/27/2016 04:00:00 AM,48,-122,3,0,3
29069,FremontBridge,01/27/2016 05:00:00 AM,48,-122,10,20,30
29070,FremontBridge,01/27/2016 06:00:00 AM,48,-122,38,64,102
29071,FremontBridge,01/27/2016 07:00:00 AM,48,-122,65,218,283
29072,FremontBridge,01/27/2016 08:00:00 AM,48,-122,111,251,362
29073,FremontBridge,01/27/2016 09:00:00 AM,48,-122,70,124,194
29074,FremontBridge,01/27/2016 10:00:00 AM,48,-122,30,46,76
29075,FremontBridge,01/27/2016 11:00:00 AM,48,-122,25,23,48
29076,FremontBridge,01/27/2016 12:00:00 PM,48,-122,20,30,50
29077,FremontBridge,01/27/2016 01:00:00 PM,48,-122,22,31,53
29078,FremontBridge,01/27/2016 02:00:00 PM,48,-122,28,31,59
29079,FremontBridge,01/27/2016 03:00:00 PM,48,-122,47,41,88
29080,FremontBridge,01/27/2016 04:00:00 PM,48,-122,138,53,191
29081,FremontBridge,01/27/2016 05:00:00 PM,48,-122,280,90,370
29082,FremontBridge,01/27/2016 06:00:00 PM,48,-122,173,53,226
29083,FremontBridge,01/27/2016 07:00:00 PM,48,-122,65,30,95
29084,FremontBridge,01/27/2016 08:00:00 PM,48,-122,34,14,48
29085,FremontBridge,01/27/2016 09:00:00 PM,48,-122,26,18,44
29086,FremontBridge,01/27/2016 10:00:00 PM,48,-122,10,3,13
29087,FremontBridge,01/27/2016 11:00:00 PM,48,-122,4,1,5
29088,FremontBridge,01/28/2016 12:00:00 AM,48,-122,0,3,3
29089,FremontBridge,01/28/2016 01:00:00 AM,48,-122,2,1,3
29090,FremontBridge,01/28/2016 02:00:00 AM,48,-122,0,2,2
29091,FremontBridge,01/28/2016 03:00:00 AM,48,-122,0,1,1
29092,FremontBridge,01/28/2016 04:00:00 AM,48,-122,1,2,3
29093,FremontBridge,01/28/2016 05:00:00 AM,48,-122,11,12,23
29094,FremontBridge,01/28/2016 06:00:00 AM,48,-122,16,61,77
29095,FremontBridge,01/28/2016 07:00:00 AM,48,-122,62,147,209
29096,FremontBridge,01/28/2016 08:00:00 AM,48,-122,98,169,267
29097,FremontBridge,01/28/2016 09:00:00 AM,48,-122,59,101,160
29098,FremontBridge,01/28/2016 10:00:00 AM,48,-122,29,29,58
29099,FremontBridge,01/28/2016 11:00:00 AM,48,-122,15,19,34
29100,FremontBridge,01/28/2016 12:00:00 PM,48,-122,15,8,23
29101,FremontBridge,01/28/2016 01:00:00 PM,48,-122,25,16,41
29102,FremontBridge,01/28/2016 02:00:00 PM,48,-122,44,19,63
29103,FremontBridge,01/28/2016 03:00:00 PM,48,-122,48,38,86
29104,FremontBridge,01/28/2016 04:00:00 PM,48,-122,113,61,174
29105,FremontBridge,01/28/2016 05:00:00 PM,48,-122,266,122,388
29106,FremontBridge,01/28/2016 06:00:00 PM,48,-122,148,61,209
29107,FremontBridge,01/28/2016 07:00:00 PM,48,-122,79,35,114
29108,FremontBridge,01/28/2016 08:00:00 PM,48,-122,38,34,72
29109,FremontBridge,01/28/2016 09:00:00 PM,48,-122,23,8,31
29110,FremontBridge,01/28/2016 10:00:00 PM,48,-122,18,15,33
29111,FremontBridge,01/28/2016 11:00:00 PM,48,-122,8,11,19
29112,FremontBridge,01/29/2016 12:00:00 AM,48,-122,4,4,8
29113,FremontBridge,01/29/2016 01:00:00 AM,48,-122,1,2,3
29114,FremontBridge,01/29/2016 02:00:00 AM,48,-122,0,0,0
29115,FremontBridge,01/29/2016 03:00:00 AM,48,-122,1,0,1
29116,FremontBridge,01/29/2016 04:00:00 AM,48,-122,3,1,4
29117,FremontBridge,01/29/2016 05:00:00 AM,48,-122,12,19,31
29118,FremontBridge,01/29/2016 06:00:00 AM,48,-122,20,64,84
29119,FremontBridge,01/29/2016 07:00:00 AM,48,-122,68,166,234
29120,FremontBridge,01/29/2016 08:00:00 AM,48,-122,89,176,265
29121,FremontBridge,01/29/2016 09:00:00 AM,48,-122,54,97,151
29122,FremontBridge,01/29/2016 10:00:00 AM,48,-122,30,20,50
29123,FremontBridge,01/29/2016 11:00:00 AM,48,-122,18,15,33
29124,FremontBridge,01/29/2016 12:00:00 PM,48,-122,16,19,35
29125,FremontBridge,01/29/2016 01:00:00 PM,48,-122,20,26,46
29126,FremontBridge,01/29/2016 02:00:00 PM,48,-122,34,21,55
29127,FremontBridge,01/29/2016 03:00:00 PM,48,-122,54,52,106
29128,FremontBridge,01/29/2016 04:00:00 PM,48,-122,116,80,196
29129,FremontBridge,01/29/2016 05:00:00 PM,48,-122,237,93,330
29130,FremontBridge,01/29/2016 06:00:00 PM,48,-122,120,63,183
29131,FremontBridge,01/29/2016 07:00:00 PM,48,-122,49,27,76
29132,FremontBridge,01/29/2016 08:00:00 PM,48,-122,20,18,38
29133,FremontBridge,01/29/2016 09:00:00 PM,48,-122,11,7,18
29134,FremontBridge,01/29/2016 10:00:00 PM,48,-122,15,8,23
29135,FremontBridge,01/29/2016 11:00:00 PM,48,-122,12,7,19
29136,FremontBridge,01/30/2016 12:00:00 AM,48,-122,3,6,9
29137,FremontBridge,01/30/2016 01:00:00 AM,48,-122,0,1,1
29138,FremontBridge,01/30/2016 02:00:00 AM,48,-122,1,4,5
29139,FremontBridge,01/30/2016 03:00:00 AM,48,-122,1,0,1
29140,FremontBridge,01/30/2016 04:00:00 AM,48,-122,3,2,5
29141,FremontBridge,01/30/2016 05:00:00 AM,48,-122,7,6,13
29142,FremontBridge,01/30/2016 06:00:00 AM,48,-122,7,8,15
29143,FremontBridge,01/30/2016 07:00:00 AM,48,-122,16,13,29
29144,FremontBridge,01/30/2016 08:00:00 AM,48,-122,27,19,46
29145,FremontBridge,01/30/2016 09:00:00 AM,48,-122,30,44,74
29146,FremontBridge,01/30/2016 10:00:00 AM,48,-122,43,41,84
29147,FremontBridge,01/30/2016 11:00:00 AM,48,-122,35,40,75
29148,FremontBridge,01/30/2016 12:00:00 PM,48,-122,36,53,89
29149,FremontBridge,01/30/2016 01:00:00 PM,48,-122,40,52,92
29150,FremontBridge,01/30/2016 02:00:00 PM,48,-122,36,68,104
29151,FremontBridge,01/30/2016 03:00:00 PM,48,-122,52,49,101
29152,FremontBridge,01/30/2016 04:00:00 PM,48,-122,38,54,92
29153,FremontBridge,01/30/2016 05:00:00 PM,48,-122,23,29,52
29154,FremontBridge,01/30/2016 06:00:00 PM,48,-122,24,18,42
29155,FremontBridge,01/30/2016 07:00:00 PM,48,-122,15,15,30
29156,FremontBridge,01/30/2016 08:00:00 PM,48,-122,8,6,14
29157,FremontBridge,01/30/2016 09:00:00 PM,48,-122,8,5,13
29158,FremontBridge,01/30/2016 10:00:00 PM,48,-122,12,9,21
29159,FremontBridge,01/30/2016 11:00:00 PM,48,-122,4,16,20
29160,FremontBridge,01/31/2016 12:00:00 AM,48,-122,4,1,5
29161,FremontBridge,01/31/2016 01:00:00 AM,48,-122,2,2,4
29162,FremontBridge,01/31/2016 02:00:00 AM,48,-122,0,2,2
29163,FremontBridge,01/31/2016 03:00:00 AM,48,-122,3,0,3
29164,FremontBridge,01/31/2016 04:00:00 AM,48,-122,0,0,0
29165,FremontBridge,01/31/2016 05:00:00 AM,48,-122,2,4,6
29166,FremontBridge,01/31/2016 06:00:00 AM,48,-122,3,3,6
29167,FremontBridge,01/31/2016 07:00:00 AM,48,-122,8,4,12
29168,FremontBridge,01/31/2016 08:00:00 AM,48,-122,16,14,30
29169,FremontBridge,01/31/2016 09:00:00 AM,48,-122,31,34,65
29170,FremontBridge,01/31/2016 10:00:00 AM,48,-122,26,48,74
29171,FremontBridge,01/31/2016 11:00:00 AM,48,-122,47,42,89
29172,FremontBridge,01/31/2016 12:00:00 PM,48,-122,36,44,80
29173,FremontBridge,01/31/2016 01:00:00 PM,48,-122,40,52,92
29174,FremontBridge,01/31/2016 02:00:00 PM,48,-122,34,39,73
29175,FremontBridge,01/31/2016 03:00:00 PM,48,-122,30,36,66
29176,FremontBridge,01/31/2016 04:00:00 PM,48,-122,37,26,63
29177,FremontBridge,01/31/2016 05:00:00 PM,48,-122,16,22,38
29178,FremontBridge,01/31/2016 06:00:00 PM,48,-122,25,25,50
29179,FremontBridge,01/31/2016 07:00:00 PM,48,-122,10,11,21
29180,FremontBridge,01/31/2016 08:00:00 PM,48,-122,3,12,15
29181,FremontBridge,01/31/2016 09:00:00 PM,48,-122,4,6,10
29182,FremontBridge,01/31/2016 10:00:00 PM,48,-122,2,3,5
29183,FremontBridge,01/31/2016 11:00:00 PM,48,-122,5,1,6
29184,FremontBridge,02/01/2016 12:00:00 AM,48,-122,5,1,6
29185,FremontBridge,02/01/2016 01:00:00 AM,48,-122,2,0,2
29186,FremontBridge,02/01/2016 02:00:00 AM,48,-122,2,0,2
29187,FremontBridge,02/01/2016 03:00:00 AM,48,-122,0,0,0
29188,FremontBridge,02/01/2016 04:00:00 AM,48,-122,0,4,4
29189,FremontBridge,02/01/2016 05:00:00 AM,48,-122,11,19,30
29190,FremontBridge,02/01/2016 06:00:00 AM,48,-122,40,86,126
29191,FremontBridge,02/01/2016 07:00:00 AM,48,-122,80,241,321
29192,FremontBridge,02/01/2016 08:00:00 AM,48,-122,123,269,392
29193,FremontBridge,02/01/2016 09:00:00 AM,48,-122,72,124,196
29194,FremontBridge,02/01/2016 10:00:00 AM,48,-122,48,46,94
29195,FremontBridge,02/01/2016 11:00:00 AM,48,-122,22,38,60
29196,FremontBridge,02/01/2016 12:00:00 PM,48,-122,21,18,39
29197,FremontBridge,02/01/2016 01:00:00 PM,48,-122,23,43,66
29198,FremontBridge,02/01/2016 02:00:00 PM,48,-122,55,23,78
29199,FremontBridge,02/01/2016 03:00:00 PM,48,-122,47,40,87
29200,FremontBridge,02/01/2016 04:00:00 PM,48,-122,140,82,222
29201,FremontBridge,02/01/2016 05:00:00 PM,48,-122,364,112,476
29202,FremontBridge,02/01/2016 06:00:00 PM,48,-122,205,81,286
29203,FremontBridge,02/01/2016 07:00:00 PM,48,-122,88,44,132
29204,FremontBridge,02/01/2016 08:00:00 PM,48,-122,36,22,58
29205,FremontBridge,02/01/2016 09:00:00 PM,48,-122,12,10,22
29206,FremontBridge,02/01/2016 10:00:00 PM,48,-122,8,13,21
29207,FremontBridge,02/01/2016 11:00:00 PM,48,-122,2,5,7
29208,FremontBridge,02/02/2016 12:00:00 AM,48,-122,1,1,2
29209,FremontBridge,02/02/2016 01:00:00 AM,48,-122,1,0,1
29210,FremontBridge,02/02/2016 02:00:00 AM,48,-122,1,0,1
29211,FremontBridge,02/02/2016 03:00:00 AM,48,-122,0,3,3
29212,FremontBridge,02/02/2016 04:00:00 AM,48,-122,3,4,7
29213,FremontBridge,02/02/2016 05:00:00 AM,48,-122,16,22,38
29214,FremontBridge,02/02/2016 06:00:00 AM,48,-122,35,80,115
29215,FremontBridge,02/02/2016 07:00:00 AM,48,-122,95,274,369
29216,FremontBridge,02/02/2016 08:00:00 AM,48,-122,146,286,432
29217,FremontBridge,02/02/2016 09:00:00 AM,48,-122,78,156,234
29218,FremontBridge,02/02/2016 10:00:00 AM,48,-122,38,44,82
29219,FremontBridge,02/02/2016 11:00:00 AM,48,-122,25,38,63
29220,FremontBridge,02/02/2016 12:00:00 PM,48,-122,41,43,84
29221,FremontBridge,02/02/2016 01:00:00 PM,48,-122,36,48,84
29222,FremontBridge,02/02/2016 02:00:00 PM,48,-122,43,41,84
29223,FremontBridge,02/02/2016 03:00:00 PM,48,-122,91,49,140
29224,FremontBridge,02/02/2016 04:00:00 PM,48,-122,165,94,259
29225,FremontBridge,02/02/2016 05:00:00 PM,48,-122,396,117,513
29226,FremontBridge,02/02/2016 06:00:00 PM,48,-122,224,100,324
29227,FremontBridge,02/02/2016 07:00:00 PM,48,-122,82,51,133
29228,FremontBridge,02/02/2016 08:00:00 PM,48,-122,40,30,70
29229,FremontBridge,02/02/2016 09:00:00 PM,48,-122,27,16,43
29230,FremontBridge,02/02/2016 10:00:00 PM,48,-122,24,16,40
29231,FremontBridge,02/02/2016 11:00:00 PM,48,-122,9,4,13
29232,FremontBridge,02/03/2016 12:00:00 AM,48,-122,1,4,5
29233,FremontBridge,02/03/2016 01:00:00 AM,48,-122,1,2,3
29234,FremontBridge,02/03/2016 02:00:00 AM,48,-122,2,0,2
29235,FremontBridge,02/03/2016 03:00:00 AM,48,-122,1,1,2
29236,FremontBridge,02/03/2016 04:00:00 AM,48,-122,1,4,5
29237,FremontBridge,02/03/2016 05:00:00 AM,48,-122,12,19,31
29238,FremontBridge,02/03/2016 06:00:00 AM,48,-122,38,77,115
29239,FremontBridge,02/03/2016 07:00:00 AM,48,-122,78,212,290
29240,FremontBridge,02/03/2016 08:00:00 AM,48,-122,122,244,366
29241,FremontBridge,02/03/2016 09:00:00 AM,48,-122,74,128,202
29242,FremontBridge,02/03/2016 10:00:00 AM,48,-122,25,48,73
29243,FremontBridge,02/03/2016 11:00:00 AM,48,-122,21,30,51
29244,FremontBridge,02/03/2016 12:00:00 PM,48,-122,13,23,36
29245,FremontBridge,02/03/2016 01:00:00 PM,48,-122,26,14,40
29246,FremontBridge,02/03/2016 02:00:00 PM,48,-122,31,15,46
29247,FremontBridge,02/03/2016 03:00:00 PM,48,-122,45,28,73
29248,FremontBridge,02/03/2016 04:00:00 PM,48,-122,107,54,161
29249,FremontBridge,02/03/2016 05:00:00 PM,48,-122,281,97,378
29250,FremontBridge,02/03/2016 06:00:00 PM,48,-122,166,50,216
29251,FremontBridge,02/03/2016 07:00:00 PM,48,-122,65,27,92
29252,FremontBridge,02/03/2016 08:00:00 PM,48,-122,34,15,49
29253,FremontBridge,02/03/2016 09:00:00 PM,48,-122,18,11,29
29254,FremontBridge,02/03/2016 10:00:00 PM,48,-122,16,2,18
29255,FremontBridge,02/03/2016 11:00:00 PM,48,-122,3,1,4
29256,FremontBridge,02/04/2016 12:00:00 AM,48,-122,1,6,7
29257,FremontBridge,02/04/2016 01:00:00 AM,48,-122,2,0,2
29258,FremontBridge,02/04/2016 02:00:00 AM,48,-122,0,0,0
29259,FremontBridge,02/04/2016 03:00:00 AM,48,-122,1,1,2
29260,FremontBridge,02/04/2016 04:00:00 AM,48,-122,1,4,5
29261,FremontBridge,02/04/2016 05:00:00 AM,48,-122,13,17,30
29262,FremontBridge,02/04/2016 06:00:00 AM,48,-122,40,84,124
29263,FremontBridge,02/04/2016 07:00:00 AM,48,-122,70,172,242
29264,FremontBridge,02/04/2016 08:00:00 AM,48,-122,108,226,334
29265,FremontBridge,02/04/2016 09:00:00 AM,48,-122,68,124,192
29266,FremontBridge,02/04/2016 10:00:00 AM,48,-122,23,39,62
29267,FremontBridge,02/04/2016 11:00:00 AM,48,-122,19,17,36
29268,FremontBridge,02/04/2016 12:00:00 PM,48,-122,16,25,41
29269,FremontBridge,02/04/2016 01:00:00 PM,48,-122,23,23,46
29270,FremontBridge,02/04/2016 02:00:00 PM,48,-122,32,23,55
29271,FremontBridge,02/04/2016 03:00:00 PM,48,-122,49,39,88
29272,FremontBridge,02/04/2016 04:00:00 PM,48,-122,133,55,188
29273,FremontBridge,02/04/2016 05:00:00 PM,48,-122,260,110,370
29274,FremontBridge,02/04/2016 06:00:00 PM,48,-122,168,79,247
29275,FremontBridge,02/04/2016 07:00:00 PM,48,-122,75,31,106
29276,FremontBridge,02/04/2016 08:00:00 PM,48,-122,38,16,54
29277,FremontBridge,02/04/2016 09:00:00 PM,48,-122,34,9,43
29278,FremontBridge,02/04/2016 10:00:00 PM,48,-122,20,14,34
29279,FremontBridge,02/04/2016 11:00:00 PM,48,-122,5,8,13
29280,FremontBridge,02/05/2016 12:00:00 AM,48,-122,2,5,7
29281,FremontBridge,02/05/2016 01:00:00 AM,48,-122,1,3,4
29282,FremontBridge,02/05/2016 02:00:00 AM,48,-122,1,1,2
29283,FremontBridge,02/05/2016 03:00:00 AM,48,-122,2,0,2
29284,FremontBridge,02/05/2016 04:00:00 AM,48,-122,3,2,5
29285,FremontBridge,02/05/2016 05:00:00 AM,48,-122,13,15,28
29286,FremontBridge,02/05/2016 06:00:00 AM,48,-122,28,71,99
29287,FremontBridge,02/05/2016 07:00:00 AM,48,-122,73,172,245
29288,FremontBridge,02/05/2016 08:00:00 AM,48,-122,112,208,320
29289,FremontBridge,02/05/2016 09:00:00 AM,48,-122,70,121,191
29290,FremontBridge,02/05/2016 10:00:00 AM,48,-122,28,48,76
29291,FremontBridge,02/05/2016 11:00:00 AM,48,-122,25,34,59
29292,FremontBridge,02/05/2016 12:00:00 PM,48,-122,22,41,63
29293,FremontBridge,02/05/2016 01:00:00 PM,48,-122,32,29,61
29294,FremontBridge,02/05/2016 02:00:00 PM,48,-122,37,25,62
29295,FremontBridge,02/05/2016 03:00:00 PM,48,-122,52,37,89
29296,FremontBridge,02/05/2016 04:00:00 PM,48,-122,106,54,160
29297,FremontBridge,02/05/2016 05:00:00 PM,48,-122,220,73,293
29298,FremontBridge,02/05/2016 06:00:00 PM,48,-122,131,47,178
29299,FremontBridge,02/05/2016 07:00:00 PM,48,-122,51,28,79
29300,FremontBridge,02/05/2016 08:00:00 PM,48,-122,20,11,31
29301,FremontBridge,02/05/2016 09:00:00 PM,48,-122,12,6,18
29302,FremontBridge,02/05/2016 10:00:00 PM,48,-122,11,11,22
29303,FremontBridge,02/05/2016 11:00:00 PM,48,-122,4,3,7
29304,FremontBridge,02/06/2016 12:00:00 AM,48,-122,4,5,9
29305,FremontBridge,02/06/2016 01:00:00 AM,48,-122,2,4,6
29306,FremontBridge,02/06/2016 02:00:00 AM,48,-122,0,3,3
29307,FremontBridge,02/06/2016 03:00:00 AM,48,-122,0,0,0
29308,FremontBridge,02/06/2016 04:00:00 AM,48,-122,1,1,2
29309,FremontBridge,02/06/2016 05:00:00 AM,48,-122,5,6,11
29310,FremontBridge,02/06/2016 06:00:00 AM,48,-122,8,4,12
29311,FremontBridge,02/06/2016 07:00:00 AM,48,-122,13,13,26
29312,FremontBridge,02/06/2016 08:00:00 AM,48,-122,16,27,43
29313,FremontBridge,02/06/2016 09:00:00 AM,48,-122,11,35,46
29314,FremontBridge,02/06/2016 10:00:00 AM,48,-122,20,33,53
29315,FremontBridge,02/06/2016 11:00:00 AM,48,-122,42,31,73
29316,FremontBridge,02/06/2016 12:00:00 PM,48,-122,23,45,68
29317,FremontBridge,02/06/2016 01:00:00 PM,48,-122,31,56,87
29318,FremontBridge,02/06/2016 02:00:00 PM,48,-122,40,41,81
29319,FremontBridge,02/06/2016 03:00:00 PM,48,-122,40,40,80
29320,FremontBridge,02/06/2016 04:00:00 PM,48,-122,34,40,74
29321,FremontBridge,02/06/2016 05:00:00 PM,48,-122,27,29,56
29322,FremontBridge,02/06/2016 06:00:00 PM,48,-122,26,21,47
29323,FremontBridge,02/06/2016 07:00:00 PM,48,-122,14,15,29
29324,FremontBridge,02/06/2016 08:00:00 PM,48,-122,13,11,24
29325,FremontBridge,02/06/2016 09:00:00 PM,48,-122,11,5,16
29326,FremontBridge,02/06/2016 10:00:00 PM,48,-122,13,6,19
29327,FremontBridge,02/06/2016 11:00:00 PM,48,-122,9,10,19
29328,FremontBridge,02/07/2016 12:00:00 AM,48,-122,5,7,12
29329,FremontBridge,02/07/2016 01:00:00 AM,48,-122,5,3,8
29330,FremontBridge,02/07/2016 02:00:00 AM,48,-122,0,2,2
29331,FremontBridge,02/07/2016 03:00:00 AM,48,-122,2,2,4
29332,FremontBridge,02/07/2016 04:00:00 AM,48,-122,1,1,2
29333,FremontBridge,02/07/2016 05:00:00 AM,48,-122,0,5,5
29334,FremontBridge,02/07/2016 06:00:00 AM,48,-122,6,1,7
29335,FremontBridge,02/07/2016 07:00:00 AM,48,-122,8,12,20
29336,FremontBridge,02/07/2016 08:00:00 AM,48,-122,13,19,32
29337,FremontBridge,02/07/2016 09:00:00 AM,48,-122,33,31,64
29338,FremontBridge,02/07/2016 10:00:00 AM,48,-122,36,44,80
29339,FremontBridge,02/07/2016 11:00:00 AM,48,-122,44,45,89
29340,FremontBridge,02/07/2016 12:00:00 PM,48,-122,64,64,128
29341,FremontBridge,02/07/2016 01:00:00 PM,48,-122,49,70,119
29342,FremontBridge,02/07/2016 02:00:00 PM,48,-122,64,69,133
29343,FremontBridge,02/07/2016 03:00:00 PM,48,-122,48,43,91
29344,FremontBridge,02/07/2016 04:00:00 PM,48,-122,25,23,48
29345,FremontBridge,02/07/2016 05:00:00 PM,48,-122,21,24,45
29346,FremontBridge,02/07/2016 06:00:00 PM,48,-122,18,15,33
29347,FremontBridge,02/07/2016 07:00:00 PM,48,-122,13,17,30
29348,FremontBridge,02/07/2016 08:00:00 PM,48,-122,14,10,24
29349,FremontBridge,02/07/2016 09:00:00 PM,48,-122,4,8,12
29350,FremontBridge,02/07/2016 10:00:00 PM,48,-122,8,5,13
29351,FremontBridge,02/07/2016 11:00:00 PM,48,-122,5,4,9
29352,FremontBridge,02/08/2016 12:00:00 AM,48,-122,3,1,4
29353,FremontBridge,02/08/2016 01:00:00 AM,48,-122,0,0,0
29354,FremontBridge,02/08/2016 02:00:00 AM,48,-122,1,3,4
29355,FremontBridge,02/08/2016 03:00:00 AM,48,-122,0,2,2
29356,FremontBridge,02/08/2016 04:00:00 AM,48,-122,1,1,2
29357,FremontBridge,02/08/2016 05:00:00 AM,48,-122,12,27,39
29358,FremontBridge,02/08/2016 06:00:00 AM,48,-122,38,83,121
29359,FremontBridge,02/08/2016 07:00:00 AM,48,-122,100,232,332
29360,FremontBridge,02/08/2016 08:00:00 AM,48,-122,139,315,454
29361,FremontBridge,02/08/2016 09:00:00 AM,48,-122,64,172,236
29362,FremontBridge,02/08/2016 10:00:00 AM,48,-122,35,33,68
29363,FremontBridge,02/08/2016 11:00:00 AM,48,-122,27,35,62
29364,FremontBridge,02/08/2016 12:00:00 PM,48,-122,33,39,72
29365,FremontBridge,02/08/2016 01:00:00 PM,48,-122,49,40,89
29366,FremontBridge,02/08/2016 02:00:00 PM,48,-122,60,47,107
29367,FremontBridge,02/08/2016 03:00:00 PM,48,-122,84,69,153
29368,FremontBridge,02/08/2016 04:00:00 PM,48,-122,155,117,272
29369,FremontBridge,02/08/2016 05:00:00 PM,48,-122,384,151,535
29370,FremontBridge,02/08/2016 06:00:00 PM,48,-122,242,92,334
29371,FremontBridge,02/08/2016 07:00:00 PM,48,-122,99,44,143
29372,FremontBridge,02/08/2016 08:00:00 PM,48,-122,49,18,67
29373,FremontBridge,02/08/2016 09:00:00 PM,48,-122,17,11,28
29374,FremontBridge,02/08/2016 10:00:00 PM,48,-122,16,11,27
29375,FremontBridge,02/08/2016 11:00:00 PM,48,-122,5,4,9
29376,FremontBridge,02/09/2016 12:00:00 AM,48,-122,6,4,10
29377,FremontBridge,02/09/2016 01:00:00 AM,48,-122,5,0,5
29378,FremontBridge,02/09/2016 02:00:00 AM,48,-122,2,2,4
29379,FremontBridge,02/09/2016 03:00:00 AM,48,-122,0,1,1
29380,FremontBridge,02/09/2016 04:00:00 AM,48,-122,3,3,6
29381,FremontBridge,02/09/2016 05:00:00 AM,48,-122,7,26,33
29382,FremontBridge,02/09/2016 06:00:00 AM,48,-122,41,92,133
29383,FremontBridge,02/09/2016 07:00:00 AM,48,-122,108,266,374
29384,FremontBridge,02/09/2016 08:00:00 AM,48,-122,160,342,502
29385,FremontBridge,02/09/2016 09:00:00 AM,48,-122,69,159,228
29386,FremontBridge,02/09/2016 10:00:00 AM,48,-122,40,40,80
29387,FremontBridge,02/09/2016 11:00:00 AM,48,-122,30,26,56
29388,FremontBridge,02/09/2016 12:00:00 PM,48,-122,42,48,90
29389,FremontBridge,02/09/2016 01:00:00 PM,48,-122,48,45,93
29390,FremontBridge,02/09/2016 02:00:00 PM,48,-122,74,41,115
29391,FremontBridge,02/09/2016 03:00:00 PM,48,-122,83,75,158
29392,FremontBridge,02/09/2016 04:00:00 PM,48,-122,210,131,341
29393,FremontBridge,02/09/2016 05:00:00 PM,48,-122,422,176,598
29394,FremontBridge,02/09/2016 06:00:00 PM,48,-122,223,109,332
29395,FremontBridge,02/09/2016 07:00:00 PM,48,-122,97,44,141
29396,FremontBridge,02/09/2016 08:00:00 PM,48,-122,49,30,79
29397,FremontBridge,02/09/2016 09:00:00 PM,48,-122,20,21,41
29398,FremontBridge,02/09/2016 10:00:00 PM,48,-122,14,6,20
29399,FremontBridge,02/09/2016 11:00:00 PM,48,-122,9,6,15
29400,FremontBridge,02/10/2016 12:00:00 AM,48,-122,3,2,5
29401,FremontBridge,02/10/2016 01:00:00 AM,48,-122,2,2,4
29402,FremontBridge,02/10/2016 02:00:00 AM,48,-122,4,1,5
29403,FremontBridge,02/10/2016 03:00:00 AM,48,-122,1,1,2
29404,FremontBridge,02/10/2016 04:00:00 AM,48,-122,2,4,6
29405,FremontBridge,02/10/2016 05:00:00 AM,48,-122,11,19,30
29406,FremontBridge,02/10/2016 06:00:00 AM,48,-122,42,88,130
29407,FremontBridge,02/10/2016 07:00:00 AM,48,-122,87,226,313
29408,FremontBridge,02/10/2016 08:00:00 AM,48,-122,129,290,419
29409,FremontBridge,02/10/2016 09:00:00 AM,48,-122,80,117,197
29410,FremontBridge,02/10/2016 10:00:00 AM,48,-122,29,45,74
29411,FremontBridge,02/10/2016 11:00:00 AM,48,-122,10,19,29
29412,FremontBridge,02/10/2016 12:00:00 PM,48,-122,13,13,26
29413,FremontBridge,02/10/2016 01:00:00 PM,48,-122,15,19,34
29414,FremontBridge,02/10/2016 02:00:00 PM,48,-122,30,27,57
29415,FremontBridge,02/10/2016 03:00:00 PM,48,-122,46,31,77
29416,FremontBridge,02/10/2016 04:00:00 PM,48,-122,110,64,174
29417,FremontBridge,02/10/2016 05:00:00 PM,48,-122,306,116,422
29418,FremontBridge,02/10/2016 06:00:00 PM,48,-122,191,84,275
29419,FremontBridge,02/10/2016 07:00:00 PM,48,-122,72,26,98
29420,FremontBridge,02/10/2016 08:00:00 PM,48,-122,31,16,47
29421,FremontBridge,02/10/2016 09:00:00 PM,48,-122,21,16,37
29422,FremontBridge,02/10/2016 10:00:00 PM,48,-122,12,10,22
29423,FremontBridge,02/10/2016 11:00:00 PM,48,-122,5,7,12
29424,FremontBridge,02/11/2016 12:00:00 AM,48,-122,2,5,7
29425,FremontBridge,02/11/2016 01:00:00 AM,48,-122,2,2,4
29426,FremontBridge,02/11/2016 02:00:00 AM,48,-122,3,2,5
29427,FremontBridge,02/11/2016 03:00:00 AM,48,-122,3,1,4
29428,FremontBridge,02/11/2016 04:00:00 AM,48,-122,6,3,9
29429,FremontBridge,02/11/2016 05:00:00 AM,48,-122,16,14,30
29430,FremontBridge,02/11/2016 06:00:00 AM,48,-122,39,67,106
29431,FremontBridge,02/11/2016 07:00:00 AM,48,-122,84,206,290
29432,FremontBridge,02/11/2016 08:00:00 AM,48,-122,101,239,340
29433,FremontBridge,02/11/2016 09:00:00 AM,48,-122,62,108,170
29434,FremontBridge,02/11/2016 10:00:00 AM,48,-122,31,25,56
29435,FremontBridge,02/11/2016 11:00:00 AM,48,-122,24,18,42
29436,FremontBridge,02/11/2016 12:00:00 PM,48,-122,30,16,46
29437,FremontBridge,02/11/2016 01:00:00 PM,48,-122,19,25,44
29438,FremontBridge,02/11/2016 02:00:00 PM,48,-122,32,21,53
29439,FremontBridge,02/11/2016 03:00:00 PM,48,-122,49,34,83
29440,FremontBridge,02/11/2016 04:00:00 PM,48,-122,97,62,159
29441,FremontBridge,02/11/2016 05:00:00 PM,48,-122,247,101,348
29442,FremontBridge,02/11/2016 06:00:00 PM,48,-122,172,66,238
29443,FremontBridge,02/11/2016 07:00:00 PM,48,-122,68,32,100
29444,FremontBridge,02/11/2016 08:00:00 PM,48,-122,39,10,49
29445,FremontBridge,02/11/2016 09:00:00 PM,48,-122,25,8,33
29446,FremontBridge,02/11/2016 10:00:00 PM,48,-122,14,9,23
29447,FremontBridge,02/11/2016 11:00:00 PM,48,-122,7,7,14
29448,FremontBridge,02/12/2016 12:00:00 AM,48,-122,4,1,5
29449,FremontBridge,02/12/2016 01:00:00 AM,48,-122,1,0,1
29450,FremontBridge,02/12/2016 02:00:00 AM,48,-122,3,2,5
29451,FremontBridge,02/12/2016 03:00:00 AM,48,-122,0,0,0
29452,FremontBridge,02/12/2016 04:00:00 AM,48,-122,5,2,7
29453,FremontBridge,02/12/2016 05:00:00 AM,48,-122,7,19,26
29454,FremontBridge,02/12/2016 06:00:00 AM,48,-122,26,50,76
29455,FremontBridge,02/12/2016 07:00:00 AM,48,-122,62,151,213
29456,FremontBridge,02/12/2016 08:00:00 AM,48,-122,101,196,297
29457,FremontBridge,02/12/2016 09:00:00 AM,48,-122,41,64,105
29458,FremontBridge,02/12/2016 10:00:00 AM,48,-122,12,23,35
29459,FremontBridge,02/12/2016 11:00:00 AM,48,-122,15,3,18
29460,FremontBridge,02/12/2016 12:00:00 PM,48,-122,24,17,41
29461,FremontBridge,02/12/2016 01:00:00 PM,48,-122,23,26,49
29462,FremontBridge,02/12/2016 02:00:00 PM,48,-122,41,31,72
29463,FremontBridge,02/12/2016 03:00:00 PM,48,-122,56,46,102
29464,FremontBridge,02/12/2016 04:00:00 PM,48,-122,130,67,197
29465,FremontBridge,02/12/2016 05:00:00 PM,48,-122,225,98,323
29466,FremontBridge,02/12/2016 06:00:00 PM,48,-122,112,53,165
29467,FremontBridge,02/12/2016 07:00:00 PM,48,-122,53,31,84
29468,FremontBridge,02/12/2016 08:00:00 PM,48,-122,20,20,40
29469,FremontBridge,02/12/2016 09:00:00 PM,48,-122,14,9,23
29470,FremontBridge,02/12/2016 10:00:00 PM,48,-122,8,11,19
29471,FremontBridge,02/12/2016 11:00:00 PM,48,-122,8,9,17
29472,FremontBridge,02/13/2016 12:00:00 AM,48,-122,8,6,14
29473,FremontBridge,02/13/2016 01:00:00 AM,48,-122,4,2,6
29474,FremontBridge,02/13/2016 02:00:00 AM,48,-122,1,2,3
29475,FremontBridge,02/13/2016 03:00:00 AM,48,-122,0,0,0
29476,FremontBridge,02/13/2016 04:00:00 AM,48,-122,1,0,1
29477,FremontBridge,02/13/2016 05:00:00 AM,48,-122,5,7,12
29478,FremontBridge,02/13/2016 06:00:00 AM,48,-122,6,5,11
29479,FremontBridge,02/13/2016 07:00:00 AM,48,-122,8,15,23
29480,FremontBridge,02/13/2016 08:00:00 AM,48,-122,29,29,58
29481,FremontBridge,02/13/2016 09:00:00 AM,48,-122,25,22,47
29482,FremontBridge,02/13/2016 10:00:00 AM,48,-122,42,53,95
29483,FremontBridge,02/13/2016 11:00:00 AM,48,-122,26,39,65
29484,FremontBridge,02/13/2016 12:00:00 PM,48,-122,34,38,72
29485,FremontBridge,02/13/2016 01:00:00 PM,48,-122,18,20,38
29486,FremontBridge,02/13/2016 02:00:00 PM,48,-122,22,24,46
29487,FremontBridge,02/13/2016 03:00:00 PM,48,-122,12,20,32
29488,FremontBridge,02/13/2016 04:00:00 PM,48,-122,8,18,26
29489,FremontBridge,02/13/2016 05:00:00 PM,48,-122,18,8,26
29490,FremontBridge,02/13/2016 06:00:00 PM,48,-122,11,11,22
29491,FremontBridge,02/13/2016 07:00:00 PM,48,-122,7,4,11
29492,FremontBridge,02/13/2016 08:00:00 PM,48,-122,13,9,22
29493,FremontBridge,02/13/2016 09:00:00 PM,48,-122,8,7,15
29494,FremontBridge,02/13/2016 10:00:00 PM,48,-122,7,5,12
29495,FremontBridge,02/13/2016 11:00:00 PM,48,-122,7,9,16
29496,FremontBridge,02/14/2016 12:00:00 AM,48,-122,2,1,3
29497,FremontBridge,02/14/2016 01:00:00 AM,48,-122,2,1,3
29498,FremontBridge,02/14/2016 02:00:00 AM,48,-122,1,1,2
29499,FremontBridge,02/14/2016 03:00:00 AM,48,-122,0,0,0
29500,FremontBridge,02/14/2016 04:00:00 AM,48,-122,0,1,1
29501,FremontBridge,02/14/2016 05:00:00 AM,48,-122,3,4,7
29502,FremontBridge,02/14/2016 06:00:00 AM,48,-122,4,3,7
29503,FremontBridge,02/14/2016 07:00:00 AM,48,-122,6,7,13
29504,FremontBridge,02/14/2016 08:00:00 AM,48,-122,9,17,26
29505,FremontBridge,02/14/2016 09:00:00 AM,48,-122,4,20,24
29506,FremontBridge,02/14/2016 10:00:00 AM,48,-122,17,24,41
29507,FremontBridge,02/14/2016 11:00:00 AM,48,-122,30,29,59
29508,FremontBridge,02/14/2016 12:00:00 PM,48,-122,35,25,60
29509,FremontBridge,02/14/2016 01:00:00 PM,48,-122,29,25,54
29510,FremontBridge,02/14/2016 02:00:00 PM,48,-122,44,26,70
29511,FremontBridge,02/14/2016 03:00:00 PM,48,-122,31,30,61
29512,FremontBridge,02/14/2016 04:00:00 PM,48,-122,35,17,52
29513,FremontBridge,02/14/2016 05:00:00 PM,48,-122,14,15,29
29514,FremontBridge,02/14/2016 06:00:00 PM,48,-122,14,16,30
29515,FremontBridge,02/14/2016 07:00:00 PM,48,-122,8,10,18
29516,FremontBridge,02/14/2016 08:00:00 PM,48,-122,14,5,19
29517,FremontBridge,02/14/2016 09:00:00 PM,48,-122,7,6,13
29518,FremontBridge,02/14/2016 10:00:00 PM,48,-122,8,3,11
29519,FremontBridge,02/14/2016 11:00:00 PM,48,-122,2,1,3
29520,FremontBridge,02/15/2016 12:00:00 AM,48,-122,3,3,6
29521,FremontBridge,02/15/2016 01:00:00 AM,48,-122,0,1,1
29522,FremontBridge,02/15/2016 02:00:00 AM,48,-122,1,1,2
29523,FremontBridge,02/15/2016 03:00:00 AM,48,-122,1,1,2
29524,FremontBridge,02/15/2016 04:00:00 AM,48,-122,0,3,3
29525,FremontBridge,02/15/2016 05:00:00 AM,48,-122,3,8,11
29526,FremontBridge,02/15/2016 06:00:00 AM,48,-122,15,25,40
29527,FremontBridge,02/15/2016 07:00:00 AM,48,-122,28,57,85
29528,FremontBridge,02/15/2016 08:00:00 AM,48,-122,42,96,138
29529,FremontBridge,02/15/2016 09:00:00 AM,48,-122,39,47,86
29530,FremontBridge,02/15/2016 10:00:00 AM,48,-122,14,21,35
29531,FremontBridge,02/15/2016 11:00:00 AM,48,-122,16,13,29
29532,FremontBridge,02/15/2016 12:00:00 PM,48,-122,17,10,27
29533,FremontBridge,02/15/2016 01:00:00 PM,48,-122,15,12,27
29534,FremontBridge,02/15/2016 02:00:00 PM,48,-122,21,16,37
29535,FremontBridge,02/15/2016 03:00:00 PM,48,-122,26,19,45
29536,FremontBridge,02/15/2016 04:00:00 PM,48,-122,52,21,73
29537,FremontBridge,02/15/2016 05:00:00 PM,48,-122,100,31,131
29538,FremontBridge,02/15/2016 06:00:00 PM,48,-122,70,26,96
29539,FremontBridge,02/15/2016 07:00:00 PM,48,-122,34,15,49
29540,FremontBridge,02/15/2016 08:00:00 PM,48,-122,11,12,23
29541,FremontBridge,02/15/2016 09:00:00 PM,48,-122,9,7,16
29542,FremontBridge,02/15/2016 10:00:00 PM,48,-122,8,4,12
29543,FremontBridge,02/15/2016 11:00:00 PM,48,-122,1,2,3
29544,FremontBridge,02/16/2016 12:00:00 AM,48,-122,1,3,4
29545,FremontBridge,02/16/2016 01:00:00 AM,48,-122,2,0,2
29546,FremontBridge,02/16/2016 02:00:00 AM,48,-122,4,1,5
29547,FremontBridge,02/16/2016 03:00:00 AM,48,-122,1,1,2
29548,FremontBridge,02/16/2016 04:00:00 AM,48,-122,2,3,5
29549,FremontBridge,02/16/2016 05:00:00 AM,48,-122,13,13,26
29550,FremontBridge,02/16/2016 06:00:00 AM,48,-122,31,62,93
29551,FremontBridge,02/16/2016 07:00:00 AM,48,-122,78,170,248
29552,FremontBridge,02/16/2016 08:00:00 AM,48,-122,120,225,345
29553,FremontBridge,02/16/2016 09:00:00 AM,48,-122,61,111,172
29554,FremontBridge,02/16/2016 10:00:00 AM,48,-122,28,53,81
29555,FremontBridge,02/16/2016 11:00:00 AM,48,-122,34,24,58
29556,FremontBridge,02/16/2016 12:00:00 PM,48,-122,21,29,50
29557,FremontBridge,02/16/2016 01:00:00 PM,48,-122,34,39,73
29558,FremontBridge,02/16/2016 02:00:00 PM,48,-122,36,30,66
29559,FremontBridge,02/16/2016 03:00:00 PM,48,-122,44,52,96
29560,FremontBridge,02/16/2016 04:00:00 PM,48,-122,124,69,193
29561,FremontBridge,02/16/2016 05:00:00 PM,48,-122,281,106,387
29562,FremontBridge,02/16/2016 06:00:00 PM,48,-122,202,95,297
29563,FremontBridge,02/16/2016 07:00:00 PM,48,-122,91,40,131
29564,FremontBridge,02/16/2016 08:00:00 PM,48,-122,41,22,63
29565,FremontBridge,02/16/2016 09:00:00 PM,48,-122,24,19,43
29566,FremontBridge,02/16/2016 10:00:00 PM,48,-122,12,7,19
29567,FremontBridge,02/16/2016 11:00:00 PM,48,-122,4,6,10
29568,FremontBridge,02/17/2016 12:00:00 AM,48,-122,3,2,5
29569,FremontBridge,02/17/2016 01:00:00 AM,48,-122,1,1,2
29570,FremontBridge,02/17/2016 02:00:00 AM,48,-122,0,0,0
29571,FremontBridge,02/17/2016 03:00:00 AM,48,-122,1,1,2
29572,FremontBridge,02/17/2016 04:00:00 AM,48,-122,2,4,6
29573,FremontBridge,02/17/2016 05:00:00 AM,48,-122,7,21,28
29574,FremontBridge,02/17/2016 06:00:00 AM,48,-122,30,69,99
29575,FremontBridge,02/17/2016 07:00:00 AM,48,-122,95,220,315
29576,FremontBridge,02/17/2016 08:00:00 AM,48,-122,120,241,361
29577,FremontBridge,02/17/2016 09:00:00 AM,48,-122,70,137,207
29578,FremontBridge,02/17/2016 10:00:00 AM,48,-122,26,52,78
29579,FremontBridge,02/17/2016 11:00:00 AM,48,-122,27,24,51
29580,FremontBridge,02/17/2016 12:00:00 PM,48,-122,22,36,58
29581,FremontBridge,02/17/2016 01:00:00 PM,48,-122,27,25,52
29582,FremontBridge,02/17/2016 02:00:00 PM,48,-122,26,27,53
29583,FremontBridge,02/17/2016 03:00:00 PM,48,-122,44,29,73
29584,FremontBridge,02/17/2016 04:00:00 PM,48,-122,103,61,164
29585,FremontBridge,02/17/2016 05:00:00 PM,48,-122,314,96,410
29586,FremontBridge,02/17/2016 06:00:00 PM,48,-122,178,92,270
29587,FremontBridge,02/17/2016 07:00:00 PM,48,-122,71,31,102
29588,FremontBridge,02/17/2016 08:00:00 PM,48,-122,39,17,56
29589,FremontBridge,02/17/2016 09:00:00 PM,48,-122,12,16,28
29590,FremontBridge,02/17/2016 10:00:00 PM,48,-122,6,7,13
29591,FremontBridge,02/17/2016 11:00:00 PM,48,-122,5,4,9
29592,FremontBridge,02/18/2016 12:00:00 AM,48,-122,2,6,8
29593,FremontBridge,02/18/2016 01:00:00 AM,48,-122,1,0,1
29594,FremontBridge,02/18/2016 02:00:00 AM,48,-122,2,0,2
29595,FremontBridge,02/18/2016 03:00:00 AM,48,-122,1,1,2
29596,FremontBridge,02/18/2016 04:00:00 AM,48,-122,2,2,4
29597,FremontBridge,02/18/2016 05:00:00 AM,48,-122,10,15,25
29598,FremontBridge,02/18/2016 06:00:00 AM,48,-122,33,68,101
29599,FremontBridge,02/18/2016 07:00:00 AM,48,-122,86,175,261
29600,FremontBridge,02/18/2016 08:00:00 AM,48,-122,95,211,306
29601,FremontBridge,02/18/2016 09:00:00 AM,48,-122,73,116,189
29602,FremontBridge,02/18/2016 10:00:00 AM,48,-122,30,48,78
29603,FremontBridge,02/18/2016 11:00:00 AM,48,-122,18,20,38
29604,FremontBridge,02/18/2016 12:00:00 PM,48,-122,21,19,40
29605,FremontBridge,02/18/2016 01:00:00 PM,48,-122,31,23,54
29606,FremontBridge,02/18/2016 02:00:00 PM,48,-122,33,27,60
29607,FremontBridge,02/18/2016 03:00:00 PM,48,-122,46,37,83
29608,FremontBridge,02/18/2016 04:00:00 PM,48,-122,134,49,183
29609,FremontBridge,02/18/2016 05:00:00 PM,48,-122,262,127,389
29610,FremontBridge,02/18/2016 06:00:00 PM,48,-122,168,95,263
29611,FremontBridge,02/18/2016 07:00:00 PM,48,-122,76,34,110
29612,FremontBridge,02/18/2016 08:00:00 PM,48,-122,44,19,63
29613,FremontBridge,02/18/2016 09:00:00 PM,48,-122,20,13,33
29614,FremontBridge,02/18/2016 10:00:00 PM,48,-122,18,8,26
29615,FremontBridge,02/18/2016 11:00:00 PM,48,-122,10,4,14
29616,FremontBridge,02/19/2016 12:00:00 AM,48,-122,10,2,12
29617,FremontBridge,02/19/2016 01:00:00 AM,48,-122,3,2,5
29618,FremontBridge,02/19/2016 02:00:00 AM,48,-122,4,0,4
29619,FremontBridge,02/19/2016 03:00:00 AM,48,-122,1,0,1
29620,FremontBridge,02/19/2016 04:00:00 AM,48,-122,3,3,6
29621,FremontBridge,02/19/2016 05:00:00 AM,48,-122,11,15,26
29622,FremontBridge,02/19/2016 06:00:00 AM,48,-122,25,50,75
29623,FremontBridge,02/19/2016 07:00:00 AM,48,-122,65,134,199
29624,FremontBridge,02/19/2016 08:00:00 AM,48,-122,79,158,237
29625,FremontBridge,02/19/2016 09:00:00 AM,48,-122,48,61,109
29626,FremontBridge,02/19/2016 10:00:00 AM,48,-122,17,27,44
29627,FremontBridge,02/19/2016 11:00:00 AM,48,-122,14,9,23
29628,FremontBridge,02/19/2016 12:00:00 PM,48,-122,15,17,32
29629,FremontBridge,02/19/2016 01:00:00 PM,48,-122,10,12,22
29630,FremontBridge,02/19/2016 02:00:00 PM,48,-122,30,12,42
29631,FremontBridge,02/19/2016 03:00:00 PM,48,-122,38,32,70
29632,FremontBridge,02/19/2016 04:00:00 PM,48,-122,77,44,121
29633,FremontBridge,02/19/2016 05:00:00 PM,48,-122,176,69,245
29634,FremontBridge,02/19/2016 06:00:00 PM,48,-122,92,43,135
29635,FremontBridge,02/19/2016 07:00:00 PM,48,-122,53,25,78
29636,FremontBridge,02/19/2016 08:00:00 PM,48,-122,20,13,33
29637,FremontBridge,02/19/2016 09:00:00 PM,48,-122,16,11,27
29638,FremontBridge,02/19/2016 10:00:00 PM,48,-122,5,9,14
29639,FremontBridge,02/19/2016 11:00:00 PM,48,-122,3,4,7
29640,FremontBridge,02/20/2016 12:00:00 AM,48,-122,4,0,4
29641,FremontBridge,02/20/2016 01:00:00 AM,48,-122,3,1,4
29642,FremontBridge,02/20/2016 02:00:00 AM,48,-122,3,2,5
29643,FremontBridge,02/20/2016 03:00:00 AM,48,-122,1,2,3
29644,FremontBridge,02/20/2016 04:00:00 AM,48,-122,2,2,4
29645,FremontBridge,02/20/2016 05:00:00 AM,48,-122,2,7,9
29646,FremontBridge,02/20/2016 06:00:00 AM,48,-122,4,7,11
29647,FremontBridge,02/20/2016 07:00:00 AM,48,-122,19,18,37
29648,FremontBridge,02/20/2016 08:00:00 AM,48,-122,26,36,62
29649,FremontBridge,02/20/2016 09:00:00 AM,48,-122,47,61,108
29650,FremontBridge,02/20/2016 10:00:00 AM,48,-122,50,61,111
29651,FremontBridge,02/20/2016 11:00:00 AM,48,-122,64,71,135
29652,FremontBridge,02/20/2016 12:00:00 PM,48,-122,67,103,170
29653,FremontBridge,02/20/2016 01:00:00 PM,48,-122,137,86,223
29654,FremontBridge,02/20/2016 02:00:00 PM,48,-122,66,121,187
29655,FremontBridge,02/20/2016 03:00:00 PM,48,-122,64,83,147
29656,FremontBridge,02/20/2016 04:00:00 PM,48,-122,72,96,168
29657,FremontBridge,02/20/2016 05:00:00 PM,48,-122,46,66,112
29658,FremontBridge,02/20/2016 06:00:00 PM,48,-122,32,49,81
29659,FremontBridge,02/20/2016 07:00:00 PM,48,-122,12,11,23
29660,FremontBridge,02/20/2016 08:00:00 PM,48,-122,19,16,35
29661,FremontBridge,02/20/2016 09:00:00 PM,48,-122,8,7,15
29662,FremontBridge,02/20/2016 10:00:00 PM,48,-122,10,10,20
29663,FremontBridge,02/20/2016 11:00:00 PM,48,-122,5,13,18
29664,FremontBridge,02/21/2016 12:00:00 AM,48,-122,6,7,13
29665,FremontBridge,02/21/2016 01:00:00 AM,48,-122,4,5,9
29666,FremontBridge,02/21/2016 02:00:00 AM,48,-122,0,1,1
29667,FremontBridge,02/21/2016 03:00:00 AM,48,-122,1,1,2
29668,FremontBridge,02/21/2016 04:00:00 AM,48,-122,1,3,4
29669,FremontBridge,02/21/2016 05:00:00 AM,48,-122,0,3,3
29670,FremontBridge,02/21/2016 06:00:00 AM,48,-122,1,1,2
29671,FremontBridge,02/21/2016 07:00:00 AM,48,-122,4,10,14
29672,FremontBridge,02/21/2016 08:00:00 AM,48,-122,14,32,46
29673,FremontBridge,02/21/2016 09:00:00 AM,48,-122,24,30,54
29674,FremontBridge,02/21/2016 10:00:00 AM,48,-122,24,28,52
29675,FremontBridge,02/21/2016 11:00:00 AM,48,-122,32,44,76
29676,FremontBridge,02/21/2016 12:00:00 PM,48,-122,13,25,38
29677,FremontBridge,02/21/2016 01:00:00 PM,48,-122,12,11,23
29678,FremontBridge,02/21/2016 02:00:00 PM,48,-122,30,27,57
29679,FremontBridge,02/21/2016 03:00:00 PM,48,-122,22,35,57
29680,FremontBridge,02/21/2016 04:00:00 PM,48,-122,40,27,67
29681,FremontBridge,02/21/2016 05:00:00 PM,48,-122,28,16,44
29682,FremontBridge,02/21/2016 06:00:00 PM,48,-122,17,11,28
29683,FremontBridge,02/21/2016 07:00:00 PM,48,-122,9,9,18
29684,FremontBridge,02/21/2016 08:00:00 PM,48,-122,24,4,28
29685,FremontBridge,02/21/2016 09:00:00 PM,48,-122,9,11,20
29686,FremontBridge,02/21/2016 10:00:00 PM,48,-122,9,3,12
29687,FremontBridge,02/21/2016 11:00:00 PM,48,-122,2,1,3
29688,FremontBridge,02/22/2016 12:00:00 AM,48,-122,6,1,7
29689,FremontBridge,02/22/2016 01:00:00 AM,48,-122,0,1,1
29690,FremontBridge,02/22/2016 02:00:00 AM,48,-122,1,1,2
29691,FremontBridge,02/22/2016 03:00:00 AM,48,-122,0,1,1
29692,FremontBridge,02/22/2016 04:00:00 AM,48,-122,1,3,4
29693,FremontBridge,02/22/2016 05:00:00 AM,48,-122,9,24,33
29694,FremontBridge,02/22/2016 06:00:00 AM,48,-122,42,67,109
29695,FremontBridge,02/22/2016 07:00:00 AM,48,-122,86,235,321
29696,FremontBridge,02/22/2016 08:00:00 AM,48,-122,134,272,406
29697,FremontBridge,02/22/2016 09:00:00 AM,48,-122,84,132,216
29698,FremontBridge,02/22/2016 10:00:00 AM,48,-122,35,32,67
29699,FremontBridge,02/22/2016 11:00:00 AM,48,-122,23,30,53
29700,FremontBridge,02/22/2016 12:00:00 PM,48,-122,17,14,31
29701,FremontBridge,02/22/2016 01:00:00 PM,48,-122,23,29,52
29702,FremontBridge,02/22/2016 02:00:00 PM,48,-122,37,32,69
29703,FremontBridge,02/22/2016 03:00:00 PM,48,-122,66,47,113
29704,FremontBridge,02/22/2016 04:00:00 PM,48,-122,137,87,224
29705,FremontBridge,02/22/2016 05:00:00 PM,48,-122,389,125,514
29706,FremontBridge,02/22/2016 06:00:00 PM,48,-122,220,81,301
29707,FremontBridge,02/22/2016 07:00:00 PM,48,-122,69,47,116
29708,FremontBridge,02/22/2016 08:00:00 PM,48,-122,51,18,69
29709,FremontBridge,02/22/2016 09:00:00 PM,48,-122,22,15,37
29710,FremontBridge,02/22/2016 10:00:00 PM,48,-122,7,9,16
29711,FremontBridge,02/22/2016 11:00:00 PM,48,-122,2,5,7
29712,FremontBridge,02/23/2016 12:00:00 AM,48,-122,3,6,9
29713,FremontBridge,02/23/2016 01:00:00 AM,48,-122,1,0,1
29714,FremontBridge,02/23/2016 02:00:00 AM,48,-122,1,2,3
29715,FremontBridge,02/23/2016 03:00:00 AM,48,-122,1,1,2
29716,FremontBridge,02/23/2016 04:00:00 AM,48,-122,4,4,8
29717,FremontBridge,02/23/2016 05:00:00 AM,48,-122,12,31,43
29718,FremontBridge,02/23/2016 06:00:00 AM,48,-122,44,79,123
29719,FremontBridge,02/23/2016 07:00:00 AM,48,-122,92,292,384
29720,FremontBridge,02/23/2016 08:00:00 AM,48,-122,127,315,442
29721,FremontBridge,02/23/2016 09:00:00 AM,48,-122,91,135,226
29722,FremontBridge,02/23/2016 10:00:00 AM,48,-122,46,56,102
29723,FremontBridge,02/23/2016 11:00:00 AM,48,-122,39,49,88
29724,FremontBridge,02/23/2016 12:00:00 PM,48,-122,35,34,69
29725,FremontBridge,02/23/2016 01:00:00 PM,48,-122,37,43,80
29726,FremontBridge,02/23/2016 02:00:00 PM,48,-122,60,53,113
29727,FremontBridge,02/23/2016 03:00:00 PM,48,-122,72,62,134
29728,FremontBridge,02/23/2016 04:00:00 PM,48,-122,175,111,286
29729,FremontBridge,02/23/2016 05:00:00 PM,48,-122,402,147,549
29730,FremontBridge,02/23/2016 06:00:00 PM,48,-122,222,99,321
29731,FremontBridge,02/23/2016 07:00:00 PM,48,-122,80,37,117
29732,FremontBridge,02/23/2016 08:00:00 PM,48,-122,53,33,86
29733,FremontBridge,02/23/2016 09:00:00 PM,48,-122,35,16,51
29734,FremontBridge,02/23/2016 10:00:00 PM,48,-122,20,15,35
29735,FremontBridge,02/23/2016 11:00:00 PM,48,-122,8,6,14
29736,FremontBridge,02/24/2016 12:00:00 AM,48,-122,6,3,9
29737,FremontBridge,02/24/2016 01:00:00 AM,48,-122,0,1,1
29738,FremontBridge,02/24/2016 02:00:00 AM,48,-122,0,0,0
29739,FremontBridge,02/24/2016 03:00:00 AM,48,-122,0,1,1
29740,FremontBridge,02/24/2016 04:00:00 AM,48,-122,3,8,11
29741,FremontBridge,02/24/2016 05:00:00 AM,48,-122,10,26,36
29742,FremontBridge,02/24/2016 06:00:00 AM,48,-122,48,91,139
29743,FremontBridge,02/24/2016 07:00:00 AM,48,-122,94,217,311
29744,FremontBridge,02/24/2016 08:00:00 AM,48,-122,131,300,431
29745,FremontBridge,02/24/2016 09:00:00 AM,48,-122,74,136,210
29746,FremontBridge,02/24/2016 10:00:00 AM,48,-122,47,61,108
29747,FremontBridge,02/24/2016 11:00:00 AM,48,-122,25,39,64
29748,FremontBridge,02/24/2016 12:00:00 PM,48,-122,29,29,58
29749,FremontBridge,02/24/2016 01:00:00 PM,48,-122,41,27,68
29750,FremontBridge,02/24/2016 02:00:00 PM,48,-122,32,22,54
29751,FremontBridge,02/24/2016 03:00:00 PM,48,-122,71,43,114
29752,FremontBridge,02/24/2016 04:00:00 PM,48,-122,162,92,254
29753,FremontBridge,02/24/2016 05:00:00 PM,48,-122,377,145,522
29754,FremontBridge,02/24/2016 06:00:00 PM,48,-122,201,103,304
29755,FremontBridge,02/24/2016 07:00:00 PM,48,-122,91,39,130
29756,FremontBridge,02/24/2016 08:00:00 PM,48,-122,45,22,67
29757,FremontBridge,02/24/2016 09:00:00 PM,48,-122,26,19,45
29758,FremontBridge,02/24/2016 10:00:00 PM,48,-122,15,15,30
29759,FremontBridge,02/24/2016 11:00:00 PM,48,-122,9,6,15
29760,FremontBridge,02/25/2016 12:00:00 AM,48,-122,3,3,6
29761,FremontBridge,02/25/2016 01:00:00 AM,48,-122,0,1,1
29762,FremontBridge,02/25/2016 02:00:00 AM,48,-122,2,0,2
29763,FremontBridge,02/25/2016 03:00:00 AM,48,-122,0,2,2
29764,FremontBridge,02/25/2016 04:00:00 AM,48,-122,2,6,8
29765,FremontBridge,02/25/2016 05:00:00 AM,48,-122,15,22,37
29766,FremontBridge,02/25/2016 06:00:00 AM,48,-122,51,81,132
29767,FremontBridge,02/25/2016 07:00:00 AM,48,-122,96,256,352
29768,FremontBridge,02/25/2016 08:00:00 AM,48,-122,132,338,470
29769,FremontBridge,02/25/2016 09:00:00 AM,48,-122,81,133,214
29770,FremontBridge,02/25/2016 10:00:00 AM,48,-122,46,70,116
29771,FremontBridge,02/25/2016 11:00:00 AM,48,-122,31,33,64
29772,FremontBridge,02/25/2016 12:00:00 PM,48,-122,39,39,78
29773,FremontBridge,02/25/2016 01:00:00 PM,48,-122,54,45,99
29774,FremontBridge,02/25/2016 02:00:00 PM,48,-122,53,42,95
29775,FremontBridge,02/25/2016 03:00:00 PM,48,-122,77,65,142
29776,FremontBridge,02/25/2016 04:00:00 PM,48,-122,196,90,286
29777,FremontBridge,02/25/2016 05:00:00 PM,48,-122,401,159,560
29778,FremontBridge,02/25/2016 06:00:00 PM,48,-122,207,120,327
29779,FremontBridge,02/25/2016 07:00:00 PM,48,-122,91,46,137
29780,FremontBridge,02/25/2016 08:00:00 PM,48,-122,50,39,89
29781,FremontBridge,02/25/2016 09:00:00 PM,48,-122,23,20,43
29782,FremontBridge,02/25/2016 10:00:00 PM,48,-122,27,14,41
29783,FremontBridge,02/25/2016 11:00:00 PM,48,-122,7,14,21
29784,FremontBridge,02/26/2016 12:00:00 AM,48,-122,4,6,10
29785,FremontBridge,02/26/2016 01:00:00 AM,48,-122,1,5,6
29786,FremontBridge,02/26/2016 02:00:00 AM,48,-122,1,1,2
29787,FremontBridge,02/26/2016 03:00:00 AM,48,-122,0,0,0
29788,FremontBridge,02/26/2016 04:00:00 AM,48,-122,1,4,5
29789,FremontBridge,02/26/2016 05:00:00 AM,48,-122,10,19,29
29790,FremontBridge,02/26/2016 06:00:00 AM,48,-122,28,60,88
29791,FremontBridge,02/26/2016 07:00:00 AM,48,-122,84,194,278
29792,FremontBridge,02/26/2016 08:00:00 AM,48,-122,124,242,366
29793,FremontBridge,02/26/2016 09:00:00 AM,48,-122,67,122,189
29794,FremontBridge,02/26/2016 10:00:00 AM,48,-122,53,59,112
29795,FremontBridge,02/26/2016 11:00:00 AM,48,-122,43,40,83
29796,FremontBridge,02/26/2016 12:00:00 PM,48,-122,43,38,81
29797,FremontBridge,02/26/2016 01:00:00 PM,48,-122,38,30,68
29798,FremontBridge,02/26/2016 02:00:00 PM,48,-122,51,34,85
29799,FremontBridge,02/26/2016 03:00:00 PM,48,-122,64,52,116
29800,FremontBridge,02/26/2016 04:00:00 PM,48,-122,132,69,201
29801,FremontBridge,02/26/2016 05:00:00 PM,48,-122,241,90,331
29802,FremontBridge,02/26/2016 06:00:00 PM,48,-122,124,51,175
29803,FremontBridge,02/26/2016 07:00:00 PM,48,-122,51,28,79
29804,FremontBridge,02/26/2016 08:00:00 PM,48,-122,20,9,29
29805,FremontBridge,02/26/2016 09:00:00 PM,48,-122,12,15,27
29806,FremontBridge,02/26/2016 10:00:00 PM,48,-122,9,12,21
29807,FremontBridge,02/26/2016 11:00:00 PM,48,-122,8,6,14
29808,FremontBridge,02/27/2016 12:00:00 AM,48,-122,2,4,6
29809,FremontBridge,02/27/2016 01:00:00 AM,48,-122,0,3,3
29810,FremontBridge,02/27/2016 02:00:00 AM,48,-122,0,0,0
29811,FremontBridge,02/27/2016 03:00:00 AM,48,-122,0,2,2
29812,FremontBridge,02/27/2016 04:00:00 AM,48,-122,3,2,5
29813,FremontBridge,02/27/2016 05:00:00 AM,48,-122,1,6,7
29814,FremontBridge,02/27/2016 06:00:00 AM,48,-122,1,4,5
29815,FremontBridge,02/27/2016 07:00:00 AM,48,-122,14,19,33
29816,FremontBridge,02/27/2016 08:00:00 AM,48,-122,23,25,48
29817,FremontBridge,02/27/2016 09:00:00 AM,48,-122,25,22,47
29818,FremontBridge,02/27/2016 10:00:00 AM,48,-122,34,38,72
29819,FremontBridge,02/27/2016 11:00:00 AM,48,-122,41,60,101
29820,FremontBridge,02/27/2016 12:00:00 PM,48,-122,70,47,117
29821,FremontBridge,02/27/2016 01:00:00 PM,48,-122,52,55,107
29822,FremontBridge,02/27/2016 02:00:00 PM,48,-122,44,69,113
29823,FremontBridge,02/27/2016 03:00:00 PM,48,-122,53,92,145
29824,FremontBridge,02/27/2016 04:00:00 PM,48,-122,68,70,138
29825,FremontBridge,02/27/2016 05:00:00 PM,48,-122,56,63,119
29826,FremontBridge,02/27/2016 06:00:00 PM,48,-122,27,29,56
29827,FremontBridge,02/27/2016 07:00:00 PM,48,-122,23,17,40
29828,FremontBridge,02/27/2016 08:00:00 PM,48,-122,21,17,38
29829,FremontBridge,02/27/2016 09:00:00 PM,48,-122,11,4,15
29830,FremontBridge,02/27/2016 10:00:00 PM,48,-122,11,12,23
29831,FremontBridge,02/27/2016 11:00:00 PM,48,-122,7,10,17
29832,FremontBridge,02/28/2016 12:00:00 AM,48,-122,2,11,13
29833,FremontBridge,02/28/2016 01:00:00 AM,48,-122,7,7,14
29834,FremontBridge,02/28/2016 02:00:00 AM,48,-122,2,3,5
29835,FremontBridge,02/28/2016 03:00:00 AM,48,-122,0,1,1
29836,FremontBridge,02/28/2016 04:00:00 AM,48,-122,2,0,2
29837,FremontBridge,02/28/2016 05:00:00 AM,48,-122,2,5,7
29838,FremontBridge,02/28/2016 06:00:00 AM,48,-122,6,19,25
29839,FremontBridge,02/28/2016 07:00:00 AM,48,-122,6,51,57
29840,FremontBridge,02/28/2016 08:00:00 AM,48,-122,15,39,54
29841,FremontBridge,02/28/2016 09:00:00 AM,48,-122,6,31,37
29842,FremontBridge,02/28/2016 10:00:00 AM,48,-122,9,20,29
29843,FremontBridge,02/28/2016 11:00:00 AM,48,-122,16,30,46
29844,FremontBridge,02/28/2016 12:00:00 PM,48,-122,22,24,46
29845,FremontBridge,02/28/2016 01:00:00 PM,48,-122,25,22,47
29846,FremontBridge,02/28/2016 02:00:00 PM,48,-122,36,20,56
29847,FremontBridge,02/28/2016 03:00:00 PM,48,-122,34,21,55
29848,FremontBridge,02/28/2016 04:00:00 PM,48,-122,32,21,53
29849,FremontBridge,02/28/2016 05:00:00 PM,48,-122,21,13,34
29850,FremontBridge,02/28/2016 06:00:00 PM,48,-122,13,16,29
29851,FremontBridge,02/28/2016 07:00:00 PM,48,-122,5,7,12
29852,FremontBridge,02/28/2016 08:00:00 PM,48,-122,6,5,11
29853,FremontBridge,02/28/2016 09:00:00 PM,48,-122,3,12,15
29854,FremontBridge,02/28/2016 10:00:00 PM,48,-122,4,5,9
29855,FremontBridge,02/28/2016 11:00:00 PM,48,-122,3,4,7
29856,FremontBridge,02/29/2016 12:00:00 AM,48,-122,2,2,4
29857,FremontBridge,02/29/2016 01:00:00 AM,48,-122,0,0,0
29858,FremontBridge,02/29/2016 02:00:00 AM,48,-122,0,0,0
29859,FremontBridge,02/29/2016 03:00:00 AM,48,-122,0,1,1
29860,FremontBridge,02/29/2016 04:00:00 AM,48,-122,1,3,4
29861,FremontBridge,02/29/2016 05:00:00 AM,48,-122,6,24,30
29862,FremontBridge,02/29/2016 06:00:00 AM,48,-122,32,77,109
29863,FremontBridge,02/29/2016 07:00:00 AM,48,-122,74,189,263
29864,FremontBridge,02/29/2016 08:00:00 AM,48,-122,117,235,352
29865,FremontBridge,02/29/2016 09:00:00 AM,48,-122,82,97,179
29866,FremontBridge,02/29/2016 10:00:00 AM,48,-122,24,39,63
29867,FremontBridge,02/29/2016 11:00:00 AM,48,-122,29,29,58
29868,FremontBridge,02/29/2016 12:00:00 PM,48,-122,32,33,65
29869,FremontBridge,02/29/2016 01:00:00 PM,48,-122,27,37,64
29870,FremontBridge,02/29/2016 02:00:00 PM,48,-122,48,30,78
29871,FremontBridge,02/29/2016 03:00:00 PM,48,-122,62,33,95
29872,FremontBridge,02/29/2016 04:00:00 PM,48,-122,145,72,217
29873,FremontBridge,02/29/2016 05:00:00 PM,48,-122,316,130,446
29874,FremontBridge,02/29/2016 06:00:00 PM,48,-122,191,85,276
29875,FremontBridge,02/29/2016 07:00:00 PM,48,-122,63,46,109
29876,FremontBridge,02/29/2016 08:00:00 PM,48,-122,32,25,57
29877,FremontBridge,02/29/2016 09:00:00 PM,48,-122,16,16,32
29878,FremontBridge,02/29/2016 10:00:00 PM,48,-122,10,5,15
29879,FremontBridge,02/29/2016 11:00:00 PM,48,-122,9,3,12
29880,FremontBridge,03/01/2016 12:00:00 AM,48,-122,1,3,4
29881,FremontBridge,03/01/2016 01:00:00 AM,48,-122,0,0,0
29882,FremontBridge,03/01/2016 02:00:00 AM,48,-122,1,2,3
29883,FremontBridge,03/01/2016 03:00:00 AM,48,-122,0,0,0
29884,FremontBridge,03/01/2016 04:00:00 AM,48,-122,3,6,9
29885,FremontBridge,03/01/2016 05:00:00 AM,48,-122,7,17,24
29886,FremontBridge,03/01/2016 06:00:00 AM,48,-122,21,55,76
29887,FremontBridge,03/01/2016 07:00:00 AM,48,-122,72,146,218
29888,FremontBridge,03/01/2016 08:00:00 AM,48,-122,108,224,332
29889,FremontBridge,03/01/2016 09:00:00 AM,48,-122,51,93,144
29890,FremontBridge,03/01/2016 10:00:00 AM,48,-122,22,21,43
29891,FremontBridge,03/01/2016 11:00:00 AM,48,-122,10,12,22
29892,FremontBridge,03/01/2016 12:00:00 PM,48,-122,11,16,27
29893,FremontBridge,03/01/2016 01:00:00 PM,48,-122,15,11,26
29894,FremontBridge,03/01/2016 02:00:00 PM,48,-122,18,12,30
29895,FremontBridge,03/01/2016 03:00:00 PM,48,-122,32,25,57
29896,FremontBridge,03/01/2016 04:00:00 PM,48,-122,98,37,135
29897,FremontBridge,03/01/2016 05:00:00 PM,48,-122,247,92,339
29898,FremontBridge,03/01/2016 06:00:00 PM,48,-122,169,62,231
29899,FremontBridge,03/01/2016 07:00:00 PM,48,-122,48,22,70
29900,FremontBridge,03/01/2016 08:00:00 PM,48,-122,20,11,31
29901,FremontBridge,03/01/2016 09:00:00 PM,48,-122,8,9,17
29902,FremontBridge,03/01/2016 10:00:00 PM,48,-122,5,8,13
29903,FremontBridge,03/01/2016 11:00:00 PM,48,-122,5,3,8
29904,FremontBridge,03/02/2016 12:00:00 AM,48,-122,0,0,0
29905,FremontBridge,03/02/2016 01:00:00 AM,48,-122,0,1,1
29906,FremontBridge,03/02/2016 02:00:00 AM,48,-122,0,2,2
29907,FremontBridge,03/02/2016 03:00:00 AM,48,-122,0,1,1
29908,FremontBridge,03/02/2016 04:00:00 AM,48,-122,1,3,4
29909,FremontBridge,03/02/2016 05:00:00 AM,48,-122,13,24,37
29910,FremontBridge,03/02/2016 06:00:00 AM,48,-122,41,72,113
29911,FremontBridge,03/02/2016 07:00:00 AM,48,-122,81,190,271
29912,FremontBridge,03/02/2016 08:00:00 AM,48,-122,121,270,391
29913,FremontBridge,03/02/2016 09:00:00 AM,48,-122,70,134,204
29914,FremontBridge,03/02/2016 10:00:00 AM,48,-122,34,34,68
29915,FremontBridge,03/02/2016 11:00:00 AM,48,-122,30,25,55
29916,FremontBridge,03/02/2016 12:00:00 PM,48,-122,28,36,64
29917,FremontBridge,03/02/2016 01:00:00 PM,48,-122,32,27,59
29918,FremontBridge,03/02/2016 02:00:00 PM,48,-122,35,36,71
29919,FremontBridge,03/02/2016 03:00:00 PM,48,-122,58,41,99
29920,FremontBridge,03/02/2016 04:00:00 PM,48,-122,136,77,213
29921,FremontBridge,03/02/2016 05:00:00 PM,48,-122,305,121,426
29922,FremontBridge,03/02/2016 06:00:00 PM,48,-122,161,71,232
29923,FremontBridge,03/02/2016 07:00:00 PM,48,-122,74,33,107
29924,FremontBridge,03/02/2016 08:00:00 PM,48,-122,36,28,64
29925,FremontBridge,03/02/2016 09:00:00 PM,48,-122,10,13,23
29926,FremontBridge,03/02/2016 10:00:00 PM,48,-122,10,10,20
29927,FremontBridge,03/02/2016 11:00:00 PM,48,-122,3,4,7
29928,FremontBridge,03/03/2016 12:00:00 AM,48,-122,1,7,8
29929,FremontBridge,03/03/2016 01:00:00 AM,48,-122,1,5,6
29930,FremontBridge,03/03/2016 02:00:00 AM,48,-122,1,1,2
29931,FremontBridge,03/03/2016 03:00:00 AM,48,-122,0,0,0
29932,FremontBridge,03/03/2016 04:00:00 AM,48,-122,5,5,10
29933,FremontBridge,03/03/2016 05:00:00 AM,48,-122,11,23,34
29934,FremontBridge,03/03/2016 06:00:00 AM,48,-122,43,68,111
29935,FremontBridge,03/03/2016 07:00:00 AM,48,-122,75,191,266
29936,FremontBridge,03/03/2016 08:00:00 AM,48,-122,117,256,373
29937,FremontBridge,03/03/2016 09:00:00 AM,48,-122,64,131,195
29938,FremontBridge,03/03/2016 10:00:00 AM,48,-122,32,33,65
29939,FremontBridge,03/03/2016 11:00:00 AM,48,-122,23,28,51
29940,FremontBridge,03/03/2016 12:00:00 PM,48,-122,20,18,38
29941,FremontBridge,03/03/2016 01:00:00 PM,48,-122,29,15,44
29942,FremontBridge,03/03/2016 02:00:00 PM,48,-122,28,22,50
29943,FremontBridge,03/03/2016 03:00:00 PM,48,-122,48,31,79
29944,FremontBridge,03/03/2016 04:00:00 PM,48,-122,130,68,198
29945,FremontBridge,03/03/2016 05:00:00 PM,48,-122,300,122,422
29946,FremontBridge,03/03/2016 06:00:00 PM,48,-122,185,84,269
29947,FremontBridge,03/03/2016 07:00:00 PM,48,-122,91,34,125
29948,FremontBridge,03/03/2016 08:00:00 PM,48,-122,44,26,70
29949,FremontBridge,03/03/2016 09:00:00 PM,48,-122,23,14,37
29950,FremontBridge,03/03/2016 10:00:00 PM,48,-122,14,13,27
29951,FremontBridge,03/03/2016 11:00:00 PM,48,-122,7,8,15
29952,FremontBridge,03/04/2016 12:00:00 AM,48,-122,4,4,8
29953,FremontBridge,03/04/2016 01:00:00 AM,48,-122,1,1,2
29954,FremontBridge,03/04/2016 02:00:00 AM,48,-122,4,2,6
29955,FremontBridge,03/04/2016 03:00:00 AM,48,-122,0,1,1
29956,FremontBridge,03/04/2016 04:00:00 AM,48,-122,8,2,10
29957,FremontBridge,03/04/2016 05:00:00 AM,48,-122,10,21,31
29958,FremontBridge,03/04/2016 06:00:00 AM,48,-122,28,57,85
29959,FremontBridge,03/04/2016 07:00:00 AM,48,-122,94,195,289
29960,FremontBridge,03/04/2016 08:00:00 AM,48,-122,115,247,362
29961,FremontBridge,03/04/2016 09:00:00 AM,48,-122,75,124,199
29962,FremontBridge,03/04/2016 10:00:00 AM,48,-122,39,38,77
29963,FremontBridge,03/04/2016 11:00:00 AM,48,-122,31,27,58
29964,FremontBridge,03/04/2016 12:00:00 PM,48,-122,31,33,64
29965,FremontBridge,03/04/2016 01:00:00 PM,48,-122,27,24,51
29966,FremontBridge,03/04/2016 02:00:00 PM,48,-122,33,28,61
29967,FremontBridge,03/04/2016 03:00:00 PM,48,-122,54,27,81
29968,FremontBridge,03/04/2016 04:00:00 PM,48,-122,115,58,173
29969,FremontBridge,03/04/2016 05:00:00 PM,48,-122,255,76,331
29970,FremontBridge,03/04/2016 06:00:00 PM,48,-122,120,64,184
29971,FremontBridge,03/04/2016 07:00:00 PM,48,-122,50,28,78
29972,FremontBridge,03/04/2016 08:00:00 PM,48,-122,32,11,43
29973,FremontBridge,03/04/2016 09:00:00 PM,48,-122,16,9,25
29974,FremontBridge,03/04/2016 10:00:00 PM,48,-122,7,14,21
29975,FremontBridge,03/04/2016 11:00:00 PM,48,-122,11,4,15
29976,FremontBridge,03/05/2016 12:00:00 AM,48,-122,7,5,12
29977,FremontBridge,03/05/2016 01:00:00 AM,48,-122,4,1,5
29978,FremontBridge,03/05/2016 02:00:00 AM,48,-122,1,1,2
29979,FremontBridge,03/05/2016 03:00:00 AM,48,-122,1,1,2
29980,FremontBridge,03/05/2016 04:00:00 AM,48,-122,3,1,4
29981,FremontBridge,03/05/2016 05:00:00 AM,48,-122,4,3,7
29982,FremontBridge,03/05/2016 06:00:00 AM,48,-122,4,2,6
29983,FremontBridge,03/05/2016 07:00:00 AM,48,-122,11,17,28
29984,FremontBridge,03/05/2016 08:00:00 AM,48,-122,34,39,73
29985,FremontBridge,03/05/2016 09:00:00 AM,48,-122,51,58,109
29986,FremontBridge,03/05/2016 10:00:00 AM,48,-122,47,77,124
29987,FremontBridge,03/05/2016 11:00:00 AM,48,-122,72,84,156
29988,FremontBridge,03/05/2016 12:00:00 PM,48,-122,86,86,172
29989,FremontBridge,03/05/2016 01:00:00 PM,48,-122,79,102,181
29990,FremontBridge,03/05/2016 02:00:00 PM,48,-122,109,121,230
29991,FremontBridge,03/05/2016 03:00:00 PM,48,-122,91,96,187
29992,FremontBridge,03/05/2016 04:00:00 PM,48,-122,72,63,135
29993,FremontBridge,03/05/2016 05:00:00 PM,48,-122,47,47,94
29994,FremontBridge,03/05/2016 06:00:00 PM,48,-122,31,35,66
29995,FremontBridge,03/05/2016 07:00:00 PM,48,-122,18,12,30
29996,FremontBridge,03/05/2016 08:00:00 PM,48,-122,10,13,23
29997,FremontBridge,03/05/2016 09:00:00 PM,48,-122,10,7,17
29998,FremontBridge,03/05/2016 10:00:00 PM,48,-122,11,6,17
29999,FremontBridge,03/05/2016 11:00:00 PM,48,-122,13,7,20
30000,FremontBridge,03/06/2016 12:00:00 AM,48,-122,8,2,10
30001,FremontBridge,03/06/2016 01:00:00 AM,48,-122,2,3,5
30002,FremontBridge,03/06/2016 02:00:00 AM,48,-122,2,2,4
30003,FremontBridge,03/06/2016 03:00:00 AM,48,-122,1,0,1
30004,FremontBridge,03/06/2016 04:00:00 AM,48,-122,3,2,5
30005,FremontBridge,03/06/2016 05:00:00 AM,48,-122,1,1,2
30006,FremontBridge,03/06/2016 06:00:00 AM,48,-122,6,12,18
30007,FremontBridge,03/06/2016 07:00:00 AM,48,-122,8,9,17
30008,FremontBridge,03/06/2016 08:00:00 AM,48,-122,14,23,37
30009,FremontBridge,03/06/2016 09:00:00 AM,48,-122,17,25,42
30010,FremontBridge,03/06/2016 10:00:00 AM,48,-122,21,32,53
30011,FremontBridge,03/06/2016 11:00:00 AM,48,-122,24,32,56
30012,FremontBridge,03/06/2016 12:00:00 PM,48,-122,20,19,39
30013,FremontBridge,03/06/2016 01:00:00 PM,48,-122,18,24,42
30014,FremontBridge,03/06/2016 02:00:00 PM,48,-122,26,57,83
30015,FremontBridge,03/06/2016 03:00:00 PM,48,-122,27,30,57
30016,FremontBridge,03/06/2016 04:00:00 PM,48,-122,33,29,62
30017,FremontBridge,03/06/2016 05:00:00 PM,48,-122,18,35,53
30018,FremontBridge,03/06/2016 06:00:00 PM,48,-122,14,18,32
30019,FremontBridge,03/06/2016 07:00:00 PM,48,-122,13,6,19
30020,FremontBridge,03/06/2016 08:00:00 PM,48,-122,8,10,18
30021,FremontBridge,03/06/2016 09:00:00 PM,48,-122,5,7,12
30022,FremontBridge,03/06/2016 10:00:00 PM,48,-122,6,4,10
30023,FremontBridge,03/06/2016 11:00:00 PM,48,-122,3,2,5
30024,FremontBridge,03/07/2016 12:00:00 AM,48,-122,2,0,2
30025,FremontBridge,03/07/2016 01:00:00 AM,48,-122,2,0,2
30026,FremontBridge,03/07/2016 02:00:00 AM,48,-122,2,0,2
30027,FremontBridge,03/07/2016 03:00:00 AM,48,-122,1,1,2
30028,FremontBridge,03/07/2016 04:00:00 AM,48,-122,3,4,7
30029,FremontBridge,03/07/2016 05:00:00 AM,48,-122,8,16,24
30030,FremontBridge,03/07/2016 06:00:00 AM,48,-122,39,68,107
30031,FremontBridge,03/07/2016 07:00:00 AM,48,-122,66,146,212
30032,FremontBridge,03/07/2016 08:00:00 AM,48,-122,79,196,275
30033,FremontBridge,03/07/2016 09:00:00 AM,48,-122,48,85,133
30034,FremontBridge,03/07/2016 10:00:00 AM,48,-122,18,12,30
30035,FremontBridge,03/07/2016 11:00:00 AM,48,-122,10,16,26
30036,FremontBridge,03/07/2016 12:00:00 PM,48,-122,17,15,32
30037,FremontBridge,03/07/2016 01:00:00 PM,48,-122,23,16,39
30038,FremontBridge,03/07/2016 02:00:00 PM,48,-122,26,29,55
30039,FremontBridge,03/07/2016 03:00:00 PM,48,-122,46,26,72
30040,FremontBridge,03/07/2016 04:00:00 PM,48,-122,115,62,177
30041,FremontBridge,03/07/2016 05:00:00 PM,48,-122,266,109,375
30042,FremontBridge,03/07/2016 06:00:00 PM,48,-122,153,69,222
30043,FremontBridge,03/07/2016 07:00:00 PM,48,-122,71,34,105
30044,FremontBridge,03/07/2016 08:00:00 PM,48,-122,31,27,58
30045,FremontBridge,03/07/2016 09:00:00 PM,48,-122,17,11,28
30046,FremontBridge,03/07/2016 10:00:00 PM,48,-122,11,13,24
30047,FremontBridge,03/07/2016 11:00:00 PM,48,-122,2,11,13
30048,FremontBridge,03/08/2016 12:00:00 AM,48,-122,3,1,4
30049,FremontBridge,03/08/2016 01:00:00 AM,48,-122,2,2,4
30050,FremontBridge,03/08/2016 02:00:00 AM,48,-122,1,1,2
30051,FremontBridge,03/08/2016 03:00:00 AM,48,-122,0,0,0
30052,FremontBridge,03/08/2016 04:00:00 AM,48,-122,4,4,8
30053,FremontBridge,03/08/2016 05:00:00 AM,48,-122,11,19,30
30054,FremontBridge,03/08/2016 06:00:00 AM,48,-122,46,83,129
30055,FremontBridge,03/08/2016 07:00:00 AM,48,-122,91,240,331
30056,FremontBridge,03/08/2016 08:00:00 AM,48,-122,142,301,443
30057,FremontBridge,03/08/2016 09:00:00 AM,48,-122,75,127,202
30058,FremontBridge,03/08/2016 10:00:00 AM,48,-122,45,33,78
30059,FremontBridge,03/08/2016 11:00:00 AM,48,-122,30,39,69
30060,FremontBridge,03/08/2016 12:00:00 PM,48,-122,34,24,58
30061,FremontBridge,03/08/2016 01:00:00 PM,48,-122,36,45,81
30062,FremontBridge,03/08/2016 02:00:00 PM,48,-122,37,32,69
30063,FremontBridge,03/08/2016 03:00:00 PM,48,-122,56,26,82
30064,FremontBridge,03/08/2016 04:00:00 PM,48,-122,150,87,237
30065,FremontBridge,03/08/2016 05:00:00 PM,48,-122,340,143,483
30066,FremontBridge,03/08/2016 06:00:00 PM,48,-122,203,109,312
30067,FremontBridge,03/08/2016 07:00:00 PM,48,-122,100,36,136
30068,FremontBridge,03/08/2016 08:00:00 PM,48,-122,41,29,70
30069,FremontBridge,03/08/2016 09:00:00 PM,48,-122,16,20,36
30070,FremontBridge,03/08/2016 10:00:00 PM,48,-122,14,9,23
30071,FremontBridge,03/08/2016 11:00:00 PM,48,-122,7,7,14
30072,FremontBridge,03/09/2016 12:00:00 AM,48,-122,1,1,2
30073,FremontBridge,03/09/2016 01:00:00 AM,48,-122,3,1,4
30074,FremontBridge,03/09/2016 02:00:00 AM,48,-122,1,0,1
30075,FremontBridge,03/09/2016 03:00:00 AM,48,-122,1,1,2
30076,FremontBridge,03/09/2016 04:00:00 AM,48,-122,3,3,6
30077,FremontBridge,03/09/2016 05:00:00 AM,48,-122,13,19,32
30078,FremontBridge,03/09/2016 06:00:00 AM,48,-122,48,70,118
30079,FremontBridge,03/09/2016 07:00:00 AM,48,-122,71,181,252
30080,FremontBridge,03/09/2016 08:00:00 AM,48,-122,100,235,335
30081,FremontBridge,03/09/2016 09:00:00 AM,48,-122,62,115,177
30082,FremontBridge,03/09/2016 10:00:00 AM,48,-122,26,37,63
30083,FremontBridge,03/09/2016 11:00:00 AM,48,-122,22,24,46
30084,FremontBridge,03/09/2016 12:00:00 PM,48,-122,26,15,41
30085,FremontBridge,03/09/2016 01:00:00 PM,48,-122,11,18,29
30086,FremontBridge,03/09/2016 02:00:00 PM,48,-122,18,19,37
30087,FremontBridge,03/09/2016 03:00:00 PM,48,-122,38,14,52
30088,FremontBridge,03/09/2016 04:00:00 PM,48,-122,92,47,139
30089,FremontBridge,03/09/2016 05:00:00 PM,48,-122,231,80,311
30090,FremontBridge,03/09/2016 06:00:00 PM,48,-122,164,41,205
30091,FremontBridge,03/09/2016 07:00:00 PM,48,-122,58,26,84
30092,FremontBridge,03/09/2016 08:00:00 PM,48,-122,33,17,50
30093,FremontBridge,03/09/2016 09:00:00 PM,48,-122,13,5,18
30094,FremontBridge,03/09/2016 10:00:00 PM,48,-122,7,7,14
30095,FremontBridge,03/09/2016 11:00:00 PM,48,-122,5,1,6
30096,FremontBridge,03/10/2016 12:00:00 AM,48,-122,0,3,3
30097,FremontBridge,03/10/2016 01:00:00 AM,48,-122,0,1,1
30098,FremontBridge,03/10/2016 02:00:00 AM,48,-122,2,2,4
30099,FremontBridge,03/10/2016 03:00:00 AM,48,-122,1,1,2
30100,FremontBridge,03/10/2016 04:00:00 AM,48,-122,4,3,7
30101,FremontBridge,03/10/2016 05:00:00 AM,48,-122,10,15,25
30102,FremontBridge,03/10/2016 06:00:00 AM,48,-122,31,45,76
30103,FremontBridge,03/10/2016 07:00:00 AM,48,-122,67,136,203
30104,FremontBridge,03/10/2016 08:00:00 AM,48,-122,75,181,256
30105,FremontBridge,03/10/2016 09:00:00 AM,48,-122,57,89,146
30106,FremontBridge,03/10/2016 10:00:00 AM,48,-122,27,38,65
30107,FremontBridge,03/10/2016 11:00:00 AM,48,-122,19,32,51
30108,FremontBridge,03/10/2016 12:00:00 PM,48,-122,23,19,42
30109,FremontBridge,03/10/2016 01:00:00 PM,48,-122,22,22,44
30110,FremontBridge,03/10/2016 02:00:00 PM,48,-122,32,15,47
30111,FremontBridge,03/10/2016 03:00:00 PM,48,-122,55,27,82
30112,FremontBridge,03/10/2016 04:00:00 PM,48,-122,92,60,152
30113,FremontBridge,03/10/2016 05:00:00 PM,48,-122,262,106,368
30114,FremontBridge,03/10/2016 06:00:00 PM,48,-122,140,74,214
30115,FremontBridge,03/10/2016 07:00:00 PM,48,-122,68,38,106
30116,FremontBridge,03/10/2016 08:00:00 PM,48,-122,41,16,57
30117,FremontBridge,03/10/2016 09:00:00 PM,48,-122,31,24,55
30118,FremontBridge,03/10/2016 10:00:00 PM,48,-122,17,8,25
30119,FremontBridge,03/10/2016 11:00:00 PM,48,-122,4,7,11
30120,FremontBridge,03/11/2016 12:00:00 AM,48,-122,2,5,7
30121,FremontBridge,03/11/2016 01:00:00 AM,48,-122,2,3,5
30122,FremontBridge,03/11/2016 02:00:00 AM,48,-122,3,1,4
30123,FremontBridge,03/11/2016 03:00:00 AM,48,-122,0,2,2
30124,FremontBridge,03/11/2016 04:00:00 AM,48,-122,5,2,7
30125,FremontBridge,03/11/2016 05:00:00 AM,48,-122,12,23,35
30126,FremontBridge,03/11/2016 06:00:00 AM,48,-122,28,47,75
30127,FremontBridge,03/11/2016 07:00:00 AM,48,-122,75,180,255
30128,FremontBridge,03/11/2016 08:00:00 AM,48,-122,110,254,364
30129,FremontBridge,03/11/2016 09:00:00 AM,48,-122,72,115,187
30130,FremontBridge,03/11/2016 10:00:00 AM,48,-122,28,51,79
30131,FremontBridge,03/11/2016 11:00:00 AM,48,-122,28,33,61
30132,FremontBridge,03/11/2016 12:00:00 PM,48,-122,40,57,97
30133,FremontBridge,03/11/2016 01:00:00 PM,48,-122,27,28,55
30134,FremontBridge,03/11/2016 02:00:00 PM,48,-122,22,17,39
30135,FremontBridge,03/11/2016 03:00:00 PM,48,-122,47,31,78
30136,FremontBridge,03/11/2016 04:00:00 PM,48,-122,119,61,180
30137,FremontBridge,03/11/2016 05:00:00 PM,48,-122,256,81,337
30138,FremontBridge,03/11/2016 06:00:00 PM,48,-122,116,57,173
30139,FremontBridge,03/11/2016 07:00:00 PM,48,-122,57,30,87
30140,FremontBridge,03/11/2016 08:00:00 PM,48,-122,27,15,42
30141,FremontBridge,03/11/2016 09:00:00 PM,48,-122,18,10,28
30142,FremontBridge,03/11/2016 10:00:00 PM,48,-122,12,7,19
30143,FremontBridge,03/11/2016 11:00:00 PM,48,-122,6,4,10
30144,FremontBridge,03/12/2016 12:00:00 AM,48,-122,3,3,6
30145,FremontBridge,03/12/2016 01:00:00 AM,48,-122,2,0,2
30146,FremontBridge,03/12/2016 02:00:00 AM,48,-122,3,2,5
30147,FremontBridge,03/12/2016 03:00:00 AM,48,-122,0,0,0
30148,FremontBridge,03/12/2016 04:00:00 AM,48,-122,5,1,6
30149,FremontBridge,03/12/2016 05:00:00 AM,48,-122,3,7,10
30150,FremontBridge,03/12/2016 06:00:00 AM,48,-122,2,5,7
30151,FremontBridge,03/12/2016 07:00:00 AM,48,-122,10,11,21
30152,FremontBridge,03/12/2016 08:00:00 AM,48,-122,11,13,24
30153,FremontBridge,03/12/2016 09:00:00 AM,48,-122,13,8,21
30154,FremontBridge,03/12/2016 10:00:00 AM,48,-122,37,25,62
30155,FremontBridge,03/12/2016 11:00:00 AM,48,-122,30,43,73
30156,FremontBridge,03/12/2016 12:00:00 PM,48,-122,40,48,88
30157,FremontBridge,03/12/2016 01:00:00 PM,48,-122,29,35,64
30158,FremontBridge,03/12/2016 02:00:00 PM,48,-122,24,39,63
30159,FremontBridge,03/12/2016 03:00:00 PM,48,-122,28,33,61
30160,FremontBridge,03/12/2016 04:00:00 PM,48,-122,30,30,60
30161,FremontBridge,03/12/2016 05:00:00 PM,48,-122,13,13,26
30162,FremontBridge,03/12/2016 06:00:00 PM,48,-122,12,13,25
30163,FremontBridge,03/12/2016 07:00:00 PM,48,-122,11,7,18
30164,FremontBridge,03/12/2016 08:00:00 PM,48,-122,8,13,21
30165,FremontBridge,03/12/2016 09:00:00 PM,48,-122,6,5,11
30166,FremontBridge,03/12/2016 10:00:00 PM,48,-122,5,10,15
30167,FremontBridge,03/12/2016 11:00:00 PM,48,-122,4,3,7
30168,FremontBridge,03/13/2016 12:00:00 AM,48,-122,2,2,4
30169,FremontBridge,03/13/2016 01:00:00 AM,48,-122,1,3,4
30170,FremontBridge,03/13/2016 02:00:00 AM,48,-122,,,
30171,FremontBridge,03/13/2016 03:00:00 AM,48,-122,0,1,1
30172,FremontBridge,03/13/2016 04:00:00 AM,48,-122,0,0,0
30173,FremontBridge,03/13/2016 05:00:00 AM,48,-122,2,0,2
30174,FremontBridge,03/13/2016 06:00:00 AM,48,-122,2,3,5
30175,FremontBridge,03/13/2016 07:00:00 AM,48,-122,4,4,8
30176,FremontBridge,03/13/2016 08:00:00 AM,48,-122,10,11,21
30177,FremontBridge,03/13/2016 09:00:00 AM,48,-122,14,9,23
30178,FremontBridge,03/13/2016 10:00:00 AM,48,-122,9,7,16
30179,FremontBridge,03/13/2016 11:00:00 AM,48,-122,10,6,16
30180,FremontBridge,03/13/2016 12:00:00 PM,48,-122,12,7,19
30181,FremontBridge,03/13/2016 01:00:00 PM,48,-122,8,21,29
30182,FremontBridge,03/13/2016 02:00:00 PM,48,-122,15,13,28
30183,FremontBridge,03/13/2016 03:00:00 PM,48,-122,19,17,36
30184,FremontBridge,03/13/2016 04:00:00 PM,48,-122,12,12,24
30185,FremontBridge,03/13/2016 05:00:00 PM,48,-122,8,14,22
30186,FremontBridge,03/13/2016 06:00:00 PM,48,-122,16,14,30
30187,FremontBridge,03/13/2016 07:00:00 PM,48,-122,5,6,11
30188,FremontBridge,03/13/2016 08:00:00 PM,48,-122,4,9,13
30189,FremontBridge,03/13/2016 09:00:00 PM,48,-122,7,2,9
30190,FremontBridge,03/13/2016 10:00:00 PM,48,-122,3,7,10
30191,FremontBridge,03/13/2016 11:00:00 PM,48,-122,1,2,3
30192,FremontBridge,03/14/2016 12:00:00 AM,48,-122,2,0,2
30193,FremontBridge,03/14/2016 01:00:00 AM,48,-122,1,1,2
30194,FremontBridge,03/14/2016 02:00:00 AM,48,-122,2,0,2
30195,FremontBridge,03/14/2016 03:00:00 AM,48,-122,0,1,1
30196,FremontBridge,03/14/2016 04:00:00 AM,48,-122,2,4,6
30197,FremontBridge,03/14/2016 05:00:00 AM,48,-122,7,16,23
30198,FremontBridge,03/14/2016 06:00:00 AM,48,-122,30,56,86
30199,FremontBridge,03/14/2016 07:00:00 AM,48,-122,57,161,218
30200,FremontBridge,03/14/2016 08:00:00 AM,48,-122,98,226,324
30201,FremontBridge,03/14/2016 09:00:00 AM,48,-122,68,113,181
30202,FremontBridge,03/14/2016 10:00:00 AM,48,-122,27,26,53
30203,FremontBridge,03/14/2016 11:00:00 AM,48,-122,21,20,41
30204,FremontBridge,03/14/2016 12:00:00 PM,48,-122,18,22,40
30205,FremontBridge,03/14/2016 01:00:00 PM,48,-122,19,26,45
30206,FremontBridge,03/14/2016 02:00:00 PM,48,-122,31,27,58
30207,FremontBridge,03/14/2016 03:00:00 PM,48,-122,55,48,103
30208,FremontBridge,03/14/2016 04:00:00 PM,48,-122,83,62,145
30209,FremontBridge,03/14/2016 05:00:00 PM,48,-122,264,89,353
30210,FremontBridge,03/14/2016 06:00:00 PM,48,-122,175,95,270
30211,FremontBridge,03/14/2016 07:00:00 PM,48,-122,79,20,99
30212,FremontBridge,03/14/2016 08:00:00 PM,48,-122,31,25,56
30213,FremontBridge,03/14/2016 09:00:00 PM,48,-122,13,5,18
30214,FremontBridge,03/14/2016 10:00:00 PM,48,-122,5,6,11
30215,FremontBridge,03/14/2016 11:00:00 PM,48,-122,5,5,10
30216,FremontBridge,03/15/2016 12:00:00 AM,48,-122,3,1,4
30217,FremontBridge,03/15/2016 01:00:00 AM,48,-122,1,0,1
30218,FremontBridge,03/15/2016 02:00:00 AM,48,-122,3,0,3
30219,FremontBridge,03/15/2016 03:00:00 AM,48,-122,0,0,0
30220,FremontBridge,03/15/2016 04:00:00 AM,48,-122,1,2,3
30221,FremontBridge,03/15/2016 05:00:00 AM,48,-122,12,18,30
30222,FremontBridge,03/15/2016 06:00:00 AM,48,-122,36,80,116
30223,FremontBridge,03/15/2016 07:00:00 AM,48,-122,57,195,252
30224,FremontBridge,03/15/2016 08:00:00 AM,48,-122,114,240,354
30225,FremontBridge,03/15/2016 09:00:00 AM,48,-122,60,133,193
30226,FremontBridge,03/15/2016 10:00:00 AM,48,-122,43,33,76
30227,FremontBridge,03/15/2016 11:00:00 AM,48,-122,28,32,60
30228,FremontBridge,03/15/2016 12:00:00 PM,48,-122,19,15,34
30229,FremontBridge,03/15/2016 01:00:00 PM,48,-122,25,25,50
30230,FremontBridge,03/15/2016 02:00:00 PM,48,-122,31,25,56
30231,FremontBridge,03/15/2016 03:00:00 PM,48,-122,55,49,104
30232,FremontBridge,03/15/2016 04:00:00 PM,48,-122,107,72,179
30233,FremontBridge,03/15/2016 05:00:00 PM,48,-122,311,123,434
30234,FremontBridge,03/15/2016 06:00:00 PM,48,-122,223,90,313
30235,FremontBridge,03/15/2016 07:00:00 PM,48,-122,82,45,127
30236,FremontBridge,03/15/2016 08:00:00 PM,48,-122,41,23,64
30237,FremontBridge,03/15/2016 09:00:00 PM,48,-122,17,24,41
30238,FremontBridge,03/15/2016 10:00:00 PM,48,-122,10,20,30
30239,FremontBridge,03/15/2016 11:00:00 PM,48,-122,9,6,15
30240,FremontBridge,03/16/2016 12:00:00 AM,48,-122,6,6,12
30241,FremontBridge,03/16/2016 01:00:00 AM,48,-122,4,0,4
30242,FremontBridge,03/16/2016 02:00:00 AM,48,-122,3,2,5
30243,FremontBridge,03/16/2016 03:00:00 AM,48,-122,0,1,1
30244,FremontBridge,03/16/2016 04:00:00 AM,48,-122,2,2,4
30245,FremontBridge,03/16/2016 05:00:00 AM,48,-122,10,21,31
30246,FremontBridge,03/16/2016 06:00:00 AM,48,-122,36,68,104
30247,FremontBridge,03/16/2016 07:00:00 AM,48,-122,82,222,304
30248,FremontBridge,03/16/2016 08:00:00 AM,48,-122,132,311,443
30249,FremontBridge,03/16/2016 09:00:00 AM,48,-122,95,139,234
30250,FremontBridge,03/16/2016 10:00:00 AM,48,-122,47,63,110
30251,FremontBridge,03/16/2016 11:00:00 AM,48,-122,31,32,63
30252,FremontBridge,03/16/2016 12:00:00 PM,48,-122,33,31,64
30253,FremontBridge,03/16/2016 01:00:00 PM,48,-122,40,38,78
30254,FremontBridge,03/16/2016 02:00:00 PM,48,-122,39,29,68
30255,FremontBridge,03/16/2016 03:00:00 PM,48,-122,58,51,109
30256,FremontBridge,03/16/2016 04:00:00 PM,48,-122,160,83,243
30257,FremontBridge,03/16/2016 05:00:00 PM,48,-122,365,149,514
30258,FremontBridge,03/16/2016 06:00:00 PM,48,-122,264,136,400
30259,FremontBridge,03/16/2016 07:00:00 PM,48,-122,92,56,148
30260,FremontBridge,03/16/2016 08:00:00 PM,48,-122,60,32,92
30261,FremontBridge,03/16/2016 09:00:00 PM,48,-122,22,26,48
30262,FremontBridge,03/16/2016 10:00:00 PM,48,-122,16,14,30
30263,FremontBridge,03/16/2016 11:00:00 PM,48,-122,1,4,5
30264,FremontBridge,03/17/2016 12:00:00 AM,48,-122,3,4,7
30265,FremontBridge,03/17/2016 01:00:00 AM,48,-122,2,0,2
30266,FremontBridge,03/17/2016 02:00:00 AM,48,-122,1,0,1
30267,FremontBridge,03/17/2016 03:00:00 AM,48,-122,0,1,1
30268,FremontBridge,03/17/2016 04:00:00 AM,48,-122,2,0,2
30269,FremontBridge,03/17/2016 05:00:00 AM,48,-122,13,16,29
30270,FremontBridge,03/17/2016 06:00:00 AM,48,-122,43,84,127
30271,FremontBridge,03/17/2016 07:00:00 AM,48,-122,79,212,291
30272,FremontBridge,03/17/2016 08:00:00 AM,48,-122,123,304,427
30273,FremontBridge,03/17/2016 09:00:00 AM,48,-122,87,149,236
30274,FremontBridge,03/17/2016 10:00:00 AM,48,-122,53,52,105
30275,FremontBridge,03/17/2016 11:00:00 AM,48,-122,32,32,64
30276,FremontBridge,03/17/2016 12:00:00 PM,48,-122,48,45,93
30277,FremontBridge,03/17/2016 01:00:00 PM,48,-122,42,40,82
30278,FremontBridge,03/17/2016 02:00:00 PM,48,-122,56,48,104
30279,FremontBridge,03/17/2016 03:00:00 PM,48,-122,68,79,147
30280,FremontBridge,03/17/2016 04:00:00 PM,48,-122,152,92,244
30281,FremontBridge,03/17/2016 05:00:00 PM,48,-122,359,167,526
30282,FremontBridge,03/17/2016 06:00:00 PM,48,-122,250,143,393
30283,FremontBridge,03/17/2016 07:00:00 PM,48,-122,95,62,157
30284,FremontBridge,03/17/2016 08:00:00 PM,48,-122,56,27,83
30285,FremontBridge,03/17/2016 09:00:00 PM,48,-122,27,23,50
30286,FremontBridge,03/17/2016 10:00:00 PM,48,-122,22,24,46
30287,FremontBridge,03/17/2016 11:00:00 PM,48,-122,14,17,31
30288,FremontBridge,03/18/2016 12:00:00 AM,48,-122,5,6,11
30289,FremontBridge,03/18/2016 01:00:00 AM,48,-122,4,1,5
30290,FremontBridge,03/18/2016 02:00:00 AM,48,-122,0,0,0
30291,FremontBridge,03/18/2016 03:00:00 AM,48,-122,0,0,0
30292,FremontBridge,03/18/2016 04:00:00 AM,48,-122,5,2,7
30293,FremontBridge,03/18/2016 05:00:00 AM,48,-122,13,17,30
30294,FremontBridge,03/18/2016 06:00:00 AM,48,-122,23,62,85
30295,FremontBridge,03/18/2016 07:00:00 AM,48,-122,69,180,249
30296,FremontBridge,03/18/2016 08:00:00 AM,48,-122,104,255,359
30297,FremontBridge,03/18/2016 09:00:00 AM,48,-122,87,132,219
30298,FremontBridge,03/18/2016 10:00:00 AM,48,-122,58,59,117
30299,FremontBridge,03/18/2016 11:00:00 AM,48,-122,29,41,70
30300,FremontBridge,03/18/2016 12:00:00 PM,48,-122,42,54,96
30301,FremontBridge,03/18/2016 01:00:00 PM,48,-122,37,47,84
30302,FremontBridge,03/18/2016 02:00:00 PM,48,-122,67,48,115
30303,FremontBridge,03/18/2016 03:00:00 PM,48,-122,95,66,161
30304,FremontBridge,03/18/2016 04:00:00 PM,48,-122,162,90,252
30305,FremontBridge,03/18/2016 05:00:00 PM,48,-122,276,135,411
30306,FremontBridge,03/18/2016 06:00:00 PM,48,-122,195,97,292
30307,FremontBridge,03/18/2016 07:00:00 PM,48,-122,74,32,106
30308,FremontBridge,03/18/2016 08:00:00 PM,48,-122,35,28,63
30309,FremontBridge,03/18/2016 09:00:00 PM,48,-122,22,15,37
30310,FremontBridge,03/18/2016 10:00:00 PM,48,-122,16,13,29
30311,FremontBridge,03/18/2016 11:00:00 PM,48,-122,5,8,13
30312,FremontBridge,03/19/2016 12:00:00 AM,48,-122,6,7,13
30313,FremontBridge,03/19/2016 01:00:00 AM,48,-122,5,2,7
30314,FremontBridge,03/19/2016 02:00:00 AM,48,-122,4,2,6
30315,FremontBridge,03/19/2016 03:00:00 AM,48,-122,1,2,3
30316,FremontBridge,03/19/2016 04:00:00 AM,48,-122,3,0,3
30317,FremontBridge,03/19/2016 05:00:00 AM,48,-122,6,2,8
30318,FremontBridge,03/19/2016 06:00:00 AM,48,-122,7,8,15
30319,FremontBridge,03/19/2016 07:00:00 AM,48,-122,16,20,36
30320,FremontBridge,03/19/2016 08:00:00 AM,48,-122,32,25,57
30321,FremontBridge,03/19/2016 09:00:00 AM,48,-122,48,53,101
30322,FremontBridge,03/19/2016 10:00:00 AM,48,-122,52,88,140
30323,FremontBridge,03/19/2016 11:00:00 AM,48,-122,50,70,120
30324,FremontBridge,03/19/2016 12:00:00 PM,48,-122,40,60,100
30325,FremontBridge,03/19/2016 01:00:00 PM,48,-122,82,71,153
30326,FremontBridge,03/19/2016 02:00:00 PM,48,-122,45,76,121
30327,FremontBridge,03/19/2016 03:00:00 PM,48,-122,66,66,132
30328,FremontBridge,03/19/2016 04:00:00 PM,48,-122,44,79,123
30329,FremontBridge,03/19/2016 05:00:00 PM,48,-122,58,65,123
30330,FremontBridge,03/19/2016 06:00:00 PM,48,-122,36,37,73
30331,FremontBridge,03/19/2016 07:00:00 PM,48,-122,33,18,51
30332,FremontBridge,03/19/2016 08:00:00 PM,48,-122,14,19,33
30333,FremontBridge,03/19/2016 09:00:00 PM,48,-122,14,24,38
30334,FremontBridge,03/19/2016 10:00:00 PM,48,-122,5,19,24
30335,FremontBridge,03/19/2016 11:00:00 PM,48,-122,12,2,14
30336,FremontBridge,03/20/2016 12:00:00 AM,48,-122,2,3,5
30337,FremontBridge,03/20/2016 01:00:00 AM,48,-122,3,3,6
30338,FremontBridge,03/20/2016 02:00:00 AM,48,-122,1,2,3
30339,FremontBridge,03/20/2016 03:00:00 AM,48,-122,0,0,0
30340,FremontBridge,03/20/2016 04:00:00 AM,48,-122,0,2,2
30341,FremontBridge,03/20/2016 05:00:00 AM,48,-122,1,4,5
30342,FremontBridge,03/20/2016 06:00:00 AM,48,-122,1,3,4
30343,FremontBridge,03/20/2016 07:00:00 AM,48,-122,7,6,13
30344,FremontBridge,03/20/2016 08:00:00 AM,48,-122,13,19,32
30345,FremontBridge,03/20/2016 09:00:00 AM,48,-122,25,28,53
30346,FremontBridge,03/20/2016 10:00:00 AM,48,-122,26,29,55
30347,FremontBridge,03/20/2016 11:00:00 AM,48,-122,21,38,59
30348,FremontBridge,03/20/2016 12:00:00 PM,48,-122,7,25,32
30349,FremontBridge,03/20/2016 01:00:00 PM,48,-122,18,19,37
30350,FremontBridge,03/20/2016 02:00:00 PM,48,-122,19,23,42
30351,FremontBridge,03/20/2016 03:00:00 PM,48,-122,28,18,46
30352,FremontBridge,03/20/2016 04:00:00 PM,48,-122,22,10,32
30353,FremontBridge,03/20/2016 05:00:00 PM,48,-122,21,14,35
30354,FremontBridge,03/20/2016 06:00:00 PM,48,-122,13,6,19
30355,FremontBridge,03/20/2016 07:00:00 PM,48,-122,16,4,20
30356,FremontBridge,03/20/2016 08:00:00 PM,48,-122,13,6,19
30357,FremontBridge,03/20/2016 09:00:00 PM,48,-122,3,8,11
30358,FremontBridge,03/20/2016 10:00:00 PM,48,-122,3,4,7
30359,FremontBridge,03/20/2016 11:00:00 PM,48,-122,1,3,4
30360,FremontBridge,03/21/2016 12:00:00 AM,48,-122,1,1,2
30361,FremontBridge,03/21/2016 01:00:00 AM,48,-122,2,3,5
30362,FremontBridge,03/21/2016 02:00:00 AM,48,-122,0,1,1
30363,FremontBridge,03/21/2016 03:00:00 AM,48,-122,0,0,0
30364,FremontBridge,03/21/2016 04:00:00 AM,48,-122,2,1,3
30365,FremontBridge,03/21/2016 05:00:00 AM,48,-122,8,13,21
30366,FremontBridge,03/21/2016 06:00:00 AM,48,-122,39,66,105
30367,FremontBridge,03/21/2016 07:00:00 AM,48,-122,67,166,233
30368,FremontBridge,03/21/2016 08:00:00 AM,48,-122,97,218,315
30369,FremontBridge,03/21/2016 09:00:00 AM,48,-122,59,92,151
30370,FremontBridge,03/21/2016 10:00:00 AM,48,-122,18,25,43
30371,FremontBridge,03/21/2016 11:00:00 AM,48,-122,13,13,26
30372,FremontBridge,03/21/2016 12:00:00 PM,48,-122,10,19,29
30373,FremontBridge,03/21/2016 01:00:00 PM,48,-122,19,20,39
30374,FremontBridge,03/21/2016 02:00:00 PM,48,-122,23,13,36
30375,FremontBridge,03/21/2016 03:00:00 PM,48,-122,40,27,67
30376,FremontBridge,03/21/2016 04:00:00 PM,48,-122,96,42,138
30377,FremontBridge,03/21/2016 05:00:00 PM,48,-122,289,102,391
30378,FremontBridge,03/21/2016 06:00:00 PM,48,-122,200,68,268
30379,FremontBridge,03/21/2016 07:00:00 PM,48,-122,62,25,87
30380,FremontBridge,03/21/2016 08:00:00 PM,48,-122,22,20,42
30381,FremontBridge,03/21/2016 09:00:00 PM,48,-122,16,6,22
30382,FremontBridge,03/21/2016 10:00:00 PM,48,-122,13,5,18
30383,FremontBridge,03/21/2016 11:00:00 PM,48,-122,5,1,6
30384,FremontBridge,03/22/2016 12:00:00 AM,48,-122,1,1,2
30385,FremontBridge,03/22/2016 01:00:00 AM,48,-122,1,0,1
30386,FremontBridge,03/22/2016 02:00:00 AM,48,-122,0,1,1
30387,FremontBridge,03/22/2016 03:00:00 AM,48,-122,0,3,3
30388,FremontBridge,03/22/2016 04:00:00 AM,48,-122,2,3,5
30389,FremontBridge,03/22/2016 05:00:00 AM,48,-122,12,19,31
30390,FremontBridge,03/22/2016 06:00:00 AM,48,-122,42,70,112
30391,FremontBridge,03/22/2016 07:00:00 AM,48,-122,90,208,298
30392,FremontBridge,03/22/2016 08:00:00 AM,48,-122,107,259,366
30393,FremontBridge,03/22/2016 09:00:00 AM,48,-122,68,115,183
30394,FremontBridge,03/22/2016 10:00:00 AM,48,-122,33,34,67
30395,FremontBridge,03/22/2016 11:00:00 AM,48,-122,16,27,43
30396,FremontBridge,03/22/2016 12:00:00 PM,48,-122,33,30,63
30397,FremontBridge,03/22/2016 01:00:00 PM,48,-122,36,31,67
30398,FremontBridge,03/22/2016 02:00:00 PM,48,-122,43,31,74
30399,FremontBridge,03/22/2016 03:00:00 PM,48,-122,59,43,102
30400,FremontBridge,03/22/2016 04:00:00 PM,48,-122,142,79,221
30401,FremontBridge,03/22/2016 05:00:00 PM,48,-122,300,119,419
30402,FremontBridge,03/22/2016 06:00:00 PM,48,-122,202,98,300
30403,FremontBridge,03/22/2016 07:00:00 PM,48,-122,81,33,114
30404,FremontBridge,03/22/2016 08:00:00 PM,48,-122,44,30,74
30405,FremontBridge,03/22/2016 09:00:00 PM,48,-122,19,17,36
30406,FremontBridge,03/22/2016 10:00:00 PM,48,-122,11,9,20
30407,FremontBridge,03/22/2016 11:00:00 PM,48,-122,7,2,9
30408,FremontBridge,03/23/2016 12:00:00 AM,48,-122,3,3,6
30409,FremontBridge,03/23/2016 01:00:00 AM,48,-122,2,1,3
30410,FremontBridge,03/23/2016 02:00:00 AM,48,-122,2,1,3
30411,FremontBridge,03/23/2016 03:00:00 AM,48,-122,3,1,4
30412,FremontBridge,03/23/2016 04:00:00 AM,48,-122,1,3,4
30413,FremontBridge,03/23/2016 05:00:00 AM,48,-122,9,19,28
30414,FremontBridge,03/23/2016 06:00:00 AM,48,-122,36,68,104
30415,FremontBridge,03/23/2016 07:00:00 AM,48,-122,73,177,250
30416,FremontBridge,03/23/2016 08:00:00 AM,48,-122,112,238,350
30417,FremontBridge,03/23/2016 09:00:00 AM,48,-122,87,122,209
30418,FremontBridge,03/23/2016 10:00:00 AM,48,-122,30,42,72
30419,FremontBridge,03/23/2016 11:00:00 AM,48,-122,27,20,47
30420,FremontBridge,03/23/2016 12:00:00 PM,48,-122,13,20,33
30421,FremontBridge,03/23/2016 01:00:00 PM,48,-122,26,16,42
30422,FremontBridge,03/23/2016 02:00:00 PM,48,-122,16,20,36
30423,FremontBridge,03/23/2016 03:00:00 PM,48,-122,56,28,84
30424,FremontBridge,03/23/2016 04:00:00 PM,48,-122,109,59,168
30425,FremontBridge,03/23/2016 05:00:00 PM,48,-122,291,110,401
30426,FremontBridge,03/23/2016 06:00:00 PM,48,-122,224,63,287
30427,FremontBridge,03/23/2016 07:00:00 PM,48,-122,79,29,108
30428,FremontBridge,03/23/2016 08:00:00 PM,48,-122,35,18,53
30429,FremontBridge,03/23/2016 09:00:00 PM,48,-122,12,10,22
30430,FremontBridge,03/23/2016 10:00:00 PM,48,-122,6,7,13
30431,FremontBridge,03/23/2016 11:00:00 PM,48,-122,4,5,9
30432,FremontBridge,03/24/2016 12:00:00 AM,48,-122,5,2,7
30433,FremontBridge,03/24/2016 01:00:00 AM,48,-122,1,1,2
30434,FremontBridge,03/24/2016 02:00:00 AM,48,-122,1,1,2
30435,FremontBridge,03/24/2016 03:00:00 AM,48,-122,0,1,1
30436,FremontBridge,03/24/2016 04:00:00 AM,48,-122,1,2,3
30437,FremontBridge,03/24/2016 05:00:00 AM,48,-122,8,17,25
30438,FremontBridge,03/24/2016 06:00:00 AM,48,-122,30,83,113
30439,FremontBridge,03/24/2016 07:00:00 AM,48,-122,70,180,250
30440,FremontBridge,03/24/2016 08:00:00 AM,48,-122,126,259,385
30441,FremontBridge,03/24/2016 09:00:00 AM,48,-122,68,117,185
30442,FremontBridge,03/24/2016 10:00:00 AM,48,-122,43,61,104
30443,FremontBridge,03/24/2016 11:00:00 AM,48,-122,23,41,64
30444,FremontBridge,03/24/2016 12:00:00 PM,48,-122,35,39,74
30445,FremontBridge,03/24/2016 01:00:00 PM,48,-122,28,31,59
30446,FremontBridge,03/24/2016 02:00:00 PM,48,-122,36,29,65
30447,FremontBridge,03/24/2016 03:00:00 PM,48,-122,56,53,109
30448,FremontBridge,03/24/2016 04:00:00 PM,48,-122,141,78,219
30449,FremontBridge,03/24/2016 05:00:00 PM,48,-122,303,140,443
30450,FremontBridge,03/24/2016 06:00:00 PM,48,-122,187,103,290
30451,FremontBridge,03/24/2016 07:00:00 PM,48,-122,76,46,122
30452,FremontBridge,03/24/2016 08:00:00 PM,48,-122,54,25,79
30453,FremontBridge,03/24/2016 09:00:00 PM,48,-122,22,8,30
30454,FremontBridge,03/24/2016 10:00:00 PM,48,-122,12,15,27
30455,FremontBridge,03/24/2016 11:00:00 PM,48,-122,3,8,11
30456,FremontBridge,03/25/2016 12:00:00 AM,48,-122,9,2,11
30457,FremontBridge,03/25/2016 01:00:00 AM,48,-122,2,2,4
30458,FremontBridge,03/25/2016 02:00:00 AM,48,-122,2,0,2
30459,FremontBridge,03/25/2016 03:00:00 AM,48,-122,0,1,1
30460,FremontBridge,03/25/2016 04:00:00 AM,48,-122,2,5,7
30461,FremontBridge,03/25/2016 05:00:00 AM,48,-122,12,17,29
30462,FremontBridge,03/25/2016 06:00:00 AM,48,-122,30,65,95
30463,FremontBridge,03/25/2016 07:00:00 AM,48,-122,65,183,248
30464,FremontBridge,03/25/2016 08:00:00 AM,48,-122,135,226,361
30465,FremontBridge,03/25/2016 09:00:00 AM,48,-122,64,127,191
30466,FremontBridge,03/25/2016 10:00:00 AM,48,-122,46,50,96
30467,FremontBridge,03/25/2016 11:00:00 AM,48,-122,22,30,52
30468,FremontBridge,03/25/2016 12:00:00 PM,48,-122,44,35,79
30469,FremontBridge,03/25/2016 01:00:00 PM,48,-122,37,38,75
30470,FremontBridge,03/25/2016 02:00:00 PM,48,-122,58,50,108
30471,FremontBridge,03/25/2016 03:00:00 PM,48,-122,84,60,144
30472,FremontBridge,03/25/2016 04:00:00 PM,48,-122,147,87,234
30473,FremontBridge,03/25/2016 05:00:00 PM,48,-122,312,112,424
30474,FremontBridge,03/25/2016 06:00:00 PM,48,-122,161,96,257
30475,FremontBridge,03/25/2016 07:00:00 PM,48,-122,82,46,128
30476,FremontBridge,03/25/2016 08:00:00 PM,48,-122,31,16,47
30477,FremontBridge,03/25/2016 09:00:00 PM,48,-122,42,12,54
30478,FremontBridge,03/25/2016 10:00:00 PM,48,-122,14,14,28
30479,FremontBridge,03/25/2016 11:00:00 PM,48,-122,10,6,16
30480,FremontBridge,03/26/2016 12:00:00 AM,48,-122,4,5,9
30481,FremontBridge,03/26/2016 01:00:00 AM,48,-122,3,1,4
30482,FremontBridge,03/26/2016 02:00:00 AM,48,-122,7,5,12
30483,FremontBridge,03/26/2016 03:00:00 AM,48,-122,2,0,2
30484,FremontBridge,03/26/2016 04:00:00 AM,48,-122,3,0,3
30485,FremontBridge,03/26/2016 05:00:00 AM,48,-122,4,4,8
30486,FremontBridge,03/26/2016 06:00:00 AM,48,-122,9,9,18
30487,FremontBridge,03/26/2016 07:00:00 AM,48,-122,16,20,36
30488,FremontBridge,03/26/2016 08:00:00 AM,48,-122,23,22,45
30489,FremontBridge,03/26/2016 09:00:00 AM,48,-122,44,43,87
30490,FremontBridge,03/26/2016 10:00:00 AM,48,-122,41,43,84
30491,FremontBridge,03/26/2016 11:00:00 AM,48,-122,44,96,140
30492,FremontBridge,03/26/2016 12:00:00 PM,48,-122,101,86,187
30493,FremontBridge,03/26/2016 01:00:00 PM,48,-122,102,119,221
30494,FremontBridge,03/26/2016 02:00:00 PM,48,-122,113,110,223
30495,FremontBridge,03/26/2016 03:00:00 PM,48,-122,91,95,186
30496,FremontBridge,03/26/2016 04:00:00 PM,48,-122,73,78,151
30497,FremontBridge,03/26/2016 05:00:00 PM,48,-122,59,61,120
30498,FremontBridge,03/26/2016 06:00:00 PM,48,-122,65,48,113
30499,FremontBridge,03/26/2016 07:00:00 PM,48,-122,28,45,73
30500,FremontBridge,03/26/2016 08:00:00 PM,48,-122,15,14,29
30501,FremontBridge,03/26/2016 09:00:00 PM,48,-122,9,9,18
30502,FremontBridge,03/26/2016 10:00:00 PM,48,-122,9,8,17
30503,FremontBridge,03/26/2016 11:00:00 PM,48,-122,13,6,19
30504,FremontBridge,03/27/2016 12:00:00 AM,48,-122,4,4,8
30505,FremontBridge,03/27/2016 01:00:00 AM,48,-122,5,3,8
30506,FremontBridge,03/27/2016 02:00:00 AM,48,-122,3,2,5
30507,FremontBridge,03/27/2016 03:00:00 AM,48,-122,2,1,3
30508,FremontBridge,03/27/2016 04:00:00 AM,48,-122,1,1,2
30509,FremontBridge,03/27/2016 05:00:00 AM,48,-122,0,1,1
30510,FremontBridge,03/27/2016 06:00:00 AM,48,-122,4,2,6
30511,FremontBridge,03/27/2016 07:00:00 AM,48,-122,3,5,8
30512,FremontBridge,03/27/2016 08:00:00 AM,48,-122,13,17,30
30513,FremontBridge,03/27/2016 09:00:00 AM,48,-122,11,23,34
30514,FremontBridge,03/27/2016 10:00:00 AM,48,-122,18,15,33
30515,FremontBridge,03/27/2016 11:00:00 AM,48,-122,10,20,30
30516,FremontBridge,03/27/2016 12:00:00 PM,48,-122,7,18,25
30517,FremontBridge,03/27/2016 01:00:00 PM,48,-122,16,19,35
30518,FremontBridge,03/27/2016 02:00:00 PM,48,-122,23,25,48
30519,FremontBridge,03/27/2016 03:00:00 PM,48,-122,15,24,39
30520,FremontBridge,03/27/2016 04:00:00 PM,48,-122,23,17,40
30521,FremontBridge,03/27/2016 05:00:00 PM,48,-122,15,9,24
30522,FremontBridge,03/27/2016 06:00:00 PM,48,-122,11,8,19
30523,FremontBridge,03/27/2016 07:00:00 PM,48,-122,10,5,15
30524,FremontBridge,03/27/2016 08:00:00 PM,48,-122,5,5,10
30525,FremontBridge,03/27/2016 09:00:00 PM,48,-122,5,7,12
30526,FremontBridge,03/27/2016 10:00:00 PM,48,-122,5,4,9
30527,FremontBridge,03/27/2016 11:00:00 PM,48,-122,1,1,2
30528,FremontBridge,03/28/2016 12:00:00 AM,48,-122,2,0,2
30529,FremontBridge,03/28/2016 01:00:00 AM,48,-122,0,1,1
30530,FremontBridge,03/28/2016 02:00:00 AM,48,-122,2,0,2
30531,FremontBridge,03/28/2016 03:00:00 AM,48,-122,0,1,1
30532,FremontBridge,03/28/2016 04:00:00 AM,48,-122,2,5,7
30533,FremontBridge,03/28/2016 05:00:00 AM,48,-122,11,24,35
30534,FremontBridge,03/28/2016 06:00:00 AM,48,-122,44,87,131
30535,FremontBridge,03/28/2016 07:00:00 AM,48,-122,88,242,330
30536,FremontBridge,03/28/2016 08:00:00 AM,48,-122,149,339,488
30537,FremontBridge,03/28/2016 09:00:00 AM,48,-122,81,135,216
30538,FremontBridge,03/28/2016 10:00:00 AM,48,-122,35,31,66
30539,FremontBridge,03/28/2016 11:00:00 AM,48,-122,18,24,42
30540,FremontBridge,03/28/2016 12:00:00 PM,48,-122,16,26,42
30541,FremontBridge,03/28/2016 01:00:00 PM,48,-122,33,22,55
30542,FremontBridge,03/28/2016 02:00:00 PM,48,-122,28,28,56
30543,FremontBridge,03/28/2016 03:00:00 PM,48,-122,58,43,101
30544,FremontBridge,03/28/2016 04:00:00 PM,48,-122,157,85,242
30545,FremontBridge,03/28/2016 05:00:00 PM,48,-122,396,145,541
30546,FremontBridge,03/28/2016 06:00:00 PM,48,-122,255,135,390
30547,FremontBridge,03/28/2016 07:00:00 PM,48,-122,121,77,198
30548,FremontBridge,03/28/2016 08:00:00 PM,48,-122,48,31,79
30549,FremontBridge,03/28/2016 09:00:00 PM,48,-122,31,20,51
30550,FremontBridge,03/28/2016 10:00:00 PM,48,-122,11,13,24
30551,FremontBridge,03/28/2016 11:00:00 PM,48,-122,7,4,11
30552,FremontBridge,03/29/2016 12:00:00 AM,48,-122,4,2,6
30553,FremontBridge,03/29/2016 01:00:00 AM,48,-122,3,2,5
30554,FremontBridge,03/29/2016 02:00:00 AM,48,-122,0,2,2
30555,FremontBridge,03/29/2016 03:00:00 AM,48,-122,2,0,2
30556,FremontBridge,03/29/2016 04:00:00 AM,48,-122,5,3,8
30557,FremontBridge,03/29/2016 05:00:00 AM,48,-122,13,23,36
30558,FremontBridge,03/29/2016 06:00:00 AM,48,-122,52,100,152
30559,FremontBridge,03/29/2016 07:00:00 AM,48,-122,109,286,395
30560,FremontBridge,03/29/2016 08:00:00 AM,48,-122,172,372,544
30561,FremontBridge,03/29/2016 09:00:00 AM,48,-122,117,156,273
30562,FremontBridge,03/29/2016 10:00:00 AM,48,-122,57,52,109
30563,FremontBridge,03/29/2016 11:00:00 AM,48,-122,34,47,81
30564,FremontBridge,03/29/2016 12:00:00 PM,48,-122,47,53,100
30565,FremontBridge,03/29/2016 01:00:00 PM,48,-122,36,58,94
30566,FremontBridge,03/29/2016 02:00:00 PM,48,-122,44,45,89
30567,FremontBridge,03/29/2016 03:00:00 PM,48,-122,89,86,175
30568,FremontBridge,03/29/2016 04:00:00 PM,48,-122,204,119,323
30569,FremontBridge,03/29/2016 05:00:00 PM,48,-122,455,194,649
30570,FremontBridge,03/29/2016 06:00:00 PM,48,-122,300,147,447
30571,FremontBridge,03/29/2016 07:00:00 PM,48,-122,123,101,224
30572,FremontBridge,03/29/2016 08:00:00 PM,48,-122,72,36,108
30573,FremontBridge,03/29/2016 09:00:00 PM,48,-122,36,25,61
30574,FremontBridge,03/29/2016 10:00:00 PM,48,-122,20,11,31
30575,FremontBridge,03/29/2016 11:00:00 PM,48,-122,8,4,12
30576,FremontBridge,03/30/2016 12:00:00 AM,48,-122,2,5,7
30577,FremontBridge,03/30/2016 01:00:00 AM,48,-122,3,1,4
30578,FremontBridge,03/30/2016 02:00:00 AM,48,-122,3,3,6
30579,FremontBridge,03/30/2016 03:00:00 AM,48,-122,1,2,3
30580,FremontBridge,03/30/2016 04:00:00 AM,48,-122,2,6,8
30581,FremontBridge,03/30/2016 05:00:00 AM,48,-122,14,24,38
30582,FremontBridge,03/30/2016 06:00:00 AM,48,-122,49,102,151
30583,FremontBridge,03/30/2016 07:00:00 AM,48,-122,117,315,432
30584,FremontBridge,03/30/2016 08:00:00 AM,48,-122,153,365,518
30585,FremontBridge,03/30/2016 09:00:00 AM,48,-122,125,172,297
30586,FremontBridge,03/30/2016 10:00:00 AM,48,-122,43,60,103
30587,FremontBridge,03/30/2016 11:00:00 AM,48,-122,57,64,121
30588,FremontBridge,03/30/2016 12:00:00 PM,48,-122,46,51,97
30589,FremontBridge,03/30/2016 01:00:00 PM,48,-122,46,49,95
30590,FremontBridge,03/30/2016 02:00:00 PM,48,-122,59,55,114
30591,FremontBridge,03/30/2016 03:00:00 PM,48,-122,91,79,170
30592,FremontBridge,03/30/2016 04:00:00 PM,48,-122,229,124,353
30593,FremontBridge,03/30/2016 05:00:00 PM,48,-122,464,262,726
30594,FremontBridge,03/30/2016 06:00:00 PM,48,-122,337,193,530
30595,FremontBridge,03/30/2016 07:00:00 PM,48,-122,155,94,249
30596,FremontBridge,03/30/2016 08:00:00 PM,48,-122,61,59,120
30597,FremontBridge,03/30/2016 09:00:00 PM,48,-122,44,42,86
30598,FremontBridge,03/30/2016 10:00:00 PM,48,-122,27,19,46
30599,FremontBridge,03/30/2016 11:00:00 PM,48,-122,15,12,27
30600,FremontBridge,03/31/2016 12:00:00 AM,48,-122,9,5,14
30601,FremontBridge,03/31/2016 01:00:00 AM,48,-122,1,2,3
30602,FremontBridge,03/31/2016 02:00:00 AM,48,-122,1,0,1
30603,FremontBridge,03/31/2016 03:00:00 AM,48,-122,1,1,2
30604,FremontBridge,03/31/2016 04:00:00 AM,48,-122,3,3,6
30605,FremontBridge,03/31/2016 05:00:00 AM,48,-122,10,30,40
30606,FremontBridge,03/31/2016 06:00:00 AM,48,-122,44,95,139
30607,FremontBridge,03/31/2016 07:00:00 AM,48,-122,115,323,438
30608,FremontBridge,03/31/2016 08:00:00 AM,48,-122,168,359,527
30609,FremontBridge,03/31/2016 09:00:00 AM,48,-122,124,174,298
30610,FremontBridge,03/31/2016 10:00:00 AM,48,-122,68,76,144
30611,FremontBridge,03/31/2016 11:00:00 AM,48,-122,36,61,97
30612,FremontBridge,03/31/2016 12:00:00 PM,48,-122,50,64,114
30613,FremontBridge,03/31/2016 01:00:00 PM,48,-122,52,53,105
30614,FremontBridge,03/31/2016 02:00:00 PM,48,-122,62,63,125
30615,FremontBridge,03/31/2016 03:00:00 PM,48,-122,86,84,170
30616,FremontBridge,03/31/2016 04:00:00 PM,48,-122,249,120,369
30617,FremontBridge,03/31/2016 05:00:00 PM,48,-122,460,198,658
30618,FremontBridge,03/31/2016 06:00:00 PM,48,-122,306,180,486
30619,FremontBridge,03/31/2016 07:00:00 PM,48,-122,123,102,225
30620,FremontBridge,03/31/2016 08:00:00 PM,48,-122,56,49,105
30621,FremontBridge,03/31/2016 09:00:00 PM,48,-122,34,31,65
30622,FremontBridge,03/31/2016 10:00:00 PM,48,-122,20,21,41
30623,FremontBridge,03/31/2016 11:00:00 PM,48,-122,16,10,26
30624,FremontBridge,04/01/2016 12:00:00 AM,48,-122,7,6,13
30625,FremontBridge,04/01/2016 01:00:00 AM,48,-122,3,5,8
30626,FremontBridge,04/01/2016 02:00:00 AM,48,-122,2,4,6
30627,FremontBridge,04/01/2016 03:00:00 AM,48,-122,3,2,5
30628,FremontBridge,04/01/2016 04:00:00 AM,48,-122,2,0,2
30629,FremontBridge,04/01/2016 05:00:00 AM,48,-122,13,22,35
30630,FremontBridge,04/01/2016 06:00:00 AM,48,-122,43,94,137
30631,FremontBridge,04/01/2016 07:00:00 AM,48,-122,106,256,362
30632,FremontBridge,04/01/2016 08:00:00 AM,48,-122,153,346,499
30633,FremontBridge,04/01/2016 09:00:00 AM,48,-122,93,150,243
30634,FremontBridge,04/01/2016 10:00:00 AM,48,-122,63,77,140
30635,FremontBridge,04/01/2016 11:00:00 AM,48,-122,44,54,98
30636,FremontBridge,04/01/2016 12:00:00 PM,48,-122,58,72,130
30637,FremontBridge,04/01/2016 01:00:00 PM,48,-122,68,49,117
30638,FremontBridge,04/01/2016 02:00:00 PM,48,-122,90,83,173
30639,FremontBridge,04/01/2016 03:00:00 PM,48,-122,114,96,210
30640,FremontBridge,04/01/2016 04:00:00 PM,48,-122,273,158,431
30641,FremontBridge,04/01/2016 05:00:00 PM,48,-122,424,178,602
30642,FremontBridge,04/01/2016 06:00:00 PM,48,-122,203,113,316
30643,FremontBridge,04/01/2016 07:00:00 PM,48,-122,107,74,181
30644,FremontBridge,04/01/2016 08:00:00 PM,48,-122,52,28,80
30645,FremontBridge,04/01/2016 09:00:00 PM,48,-122,29,22,51
30646,FremontBridge,04/01/2016 10:00:00 PM,48,-122,15,22,37
30647,FremontBridge,04/01/2016 11:00:00 PM,48,-122,23,17,40
30648,FremontBridge,04/02/2016 12:00:00 AM,48,-122,12,11,23
30649,FremontBridge,04/02/2016 01:00:00 AM,48,-122,4,7,11
30650,FremontBridge,04/02/2016 02:00:00 AM,48,-122,3,2,5
30651,FremontBridge,04/02/2016 03:00:00 AM,48,-122,1,0,1
30652,FremontBridge,04/02/2016 04:00:00 AM,48,-122,1,1,2
30653,FremontBridge,04/02/2016 05:00:00 AM,48,-122,3,5,8
30654,FremontBridge,04/02/2016 06:00:00 AM,48,-122,17,13,30
30655,FremontBridge,04/02/2016 07:00:00 AM,48,-122,18,16,34
30656,FremontBridge,04/02/2016 08:00:00 AM,48,-122,25,36,61
30657,FremontBridge,04/02/2016 09:00:00 AM,48,-122,45,50,95
30658,FremontBridge,04/02/2016 10:00:00 AM,48,-122,59,56,115
30659,FremontBridge,04/02/2016 11:00:00 AM,48,-122,75,58,133
30660,FremontBridge,04/02/2016 12:00:00 PM,48,-122,73,99,172
30661,FremontBridge,04/02/2016 01:00:00 PM,48,-122,68,91,159
30662,FremontBridge,04/02/2016 02:00:00 PM,48,-122,77,97,174
30663,FremontBridge,04/02/2016 03:00:00 PM,48,-122,121,118,239
30664,FremontBridge,04/02/2016 04:00:00 PM,48,-122,77,91,168
30665,FremontBridge,04/02/2016 05:00:00 PM,48,-122,93,76,169
30666,FremontBridge,04/02/2016 06:00:00 PM,48,-122,48,87,135
30667,FremontBridge,04/02/2016 07:00:00 PM,48,-122,49,30,79
30668,FremontBridge,04/02/2016 08:00:00 PM,48,-122,33,29,62
30669,FremontBridge,04/02/2016 09:00:00 PM,48,-122,17,22,39
30670,FremontBridge,04/02/2016 10:00:00 PM,48,-122,15,12,27
30671,FremontBridge,04/02/2016 11:00:00 PM,48,-122,20,7,27
30672,FremontBridge,04/03/2016 12:00:00 AM,48,-122,9,7,16
30673,FremontBridge,04/03/2016 01:00:00 AM,48,-122,2,3,5
30674,FremontBridge,04/03/2016 02:00:00 AM,48,-122,4,3,7
30675,FremontBridge,04/03/2016 03:00:00 AM,48,-122,2,2,4
30676,FremontBridge,04/03/2016 04:00:00 AM,48,-122,1,1,2
30677,FremontBridge,04/03/2016 05:00:00 AM,48,-122,8,3,11
30678,FremontBridge,04/03/2016 06:00:00 AM,48,-122,67,26,93
30679,FremontBridge,04/03/2016 07:00:00 AM,48,-122,69,32,101
30680,FremontBridge,04/03/2016 08:00:00 AM,48,-122,22,40,62
30681,FremontBridge,04/03/2016 09:00:00 AM,48,-122,42,69,111
30682,FremontBridge,04/03/2016 10:00:00 AM,48,-122,64,121,185
30683,FremontBridge,04/03/2016 11:00:00 AM,48,-122,71,112,183
30684,FremontBridge,04/03/2016 12:00:00 PM,48,-122,58,113,171
30685,FremontBridge,04/03/2016 01:00:00 PM,48,-122,106,125,231
30686,FremontBridge,04/03/2016 02:00:00 PM,48,-122,82,96,178
30687,FremontBridge,04/03/2016 03:00:00 PM,48,-122,99,102,201
30688,FremontBridge,04/03/2016 04:00:00 PM,48,-122,77,96,173
30689,FremontBridge,04/03/2016 05:00:00 PM,48,-122,72,81,153
30690,FremontBridge,04/03/2016 06:00:00 PM,48,-122,39,51,90
30691,FremontBridge,04/03/2016 07:00:00 PM,48,-122,31,32,63
30692,FremontBridge,04/03/2016 08:00:00 PM,48,-122,26,26,52
30693,FremontBridge,04/03/2016 09:00:00 PM,48,-122,8,9,17
30694,FremontBridge,04/03/2016 10:00:00 PM,48,-122,10,4,14
30695,FremontBridge,04/03/2016 11:00:00 PM,48,-122,0,4,4
30696,FremontBridge,04/04/2016 12:00:00 AM,48,-122,0,1,1
30697,FremontBridge,04/04/2016 01:00:00 AM,48,-122,1,0,1
30698,FremontBridge,04/04/2016 02:00:00 AM,48,-122,1,0,1
30699,FremontBridge,04/04/2016 03:00:00 AM,48,-122,0,0,0
30700,FremontBridge,04/04/2016 04:00:00 AM,48,-122,1,3,4
30701,FremontBridge,04/04/2016 05:00:00 AM,48,-122,8,22,30
30702,FremontBridge,04/04/2016 06:00:00 AM,48,-122,42,68,110
30703,FremontBridge,04/04/2016 07:00:00 AM,48,-122,79,221,300
30704,FremontBridge,04/04/2016 08:00:00 AM,48,-122,127,312,439
30705,FremontBridge,04/04/2016 09:00:00 AM,48,-122,84,132,216
30706,FremontBridge,04/04/2016 10:00:00 AM,48,-122,51,47,98
30707,FremontBridge,04/04/2016 11:00:00 AM,48,-122,25,24,49
30708,FremontBridge,04/04/2016 12:00:00 PM,48,-122,23,34,57
30709,FremontBridge,04/04/2016 01:00:00 PM,48,-122,21,31,52
30710,FremontBridge,04/04/2016 02:00:00 PM,48,-122,29,26,55
30711,FremontBridge,04/04/2016 03:00:00 PM,48,-122,46,35,81
30712,FremontBridge,04/04/2016 04:00:00 PM,48,-122,133,66,199
30713,FremontBridge,04/04/2016 05:00:00 PM,48,-122,366,131,497
30714,FremontBridge,04/04/2016 06:00:00 PM,48,-122,195,109,304
30715,FremontBridge,04/04/2016 07:00:00 PM,48,-122,101,51,152
30716,FremontBridge,04/04/2016 08:00:00 PM,48,-122,37,33,70
30717,FremontBridge,04/04/2016 09:00:00 PM,48,-122,26,20,46
30718,FremontBridge,04/04/2016 10:00:00 PM,48,-122,13,18,31
30719,FremontBridge,04/04/2016 11:00:00 PM,48,-122,8,3,11
30720,FremontBridge,04/05/2016 12:00:00 AM,48,-122,3,3,6
30721,FremontBridge,04/05/2016 01:00:00 AM,48,-122,3,1,4
30722,FremontBridge,04/05/2016 02:00:00 AM,48,-122,1,2,3
30723,FremontBridge,04/05/2016 03:00:00 AM,48,-122,1,0,1
30724,FremontBridge,04/05/2016 04:00:00 AM,48,-122,3,5,8
30725,FremontBridge,04/05/2016 05:00:00 AM,48,-122,12,30,42
30726,FremontBridge,04/05/2016 06:00:00 AM,48,-122,42,95,137
30727,FremontBridge,04/05/2016 07:00:00 AM,48,-122,118,295,413
30728,FremontBridge,04/05/2016 08:00:00 AM,48,-122,159,368,527
30729,FremontBridge,04/05/2016 09:00:00 AM,48,-122,107,150,257
30730,FremontBridge,04/05/2016 10:00:00 AM,48,-122,40,56,96
30731,FremontBridge,04/05/2016 11:00:00 AM,48,-122,35,42,77
30732,FremontBridge,04/05/2016 12:00:00 PM,48,-122,33,34,67
30733,FremontBridge,04/05/2016 01:00:00 PM,48,-122,33,28,61
30734,FremontBridge,04/05/2016 02:00:00 PM,48,-122,45,38,83
30735,FremontBridge,04/05/2016 03:00:00 PM,48,-122,66,56,122
30736,FremontBridge,04/05/2016 04:00:00 PM,48,-122,187,104,291
30737,FremontBridge,04/05/2016 05:00:00 PM,48,-122,433,167,600
30738,FremontBridge,04/05/2016 06:00:00 PM,48,-122,260,126,386
30739,FremontBridge,04/05/2016 07:00:00 PM,48,-122,123,69,192
30740,FremontBridge,04/05/2016 08:00:00 PM,48,-122,63,31,94
30741,FremontBridge,04/05/2016 09:00:00 PM,48,-122,18,24,42
30742,FremontBridge,04/05/2016 10:00:00 PM,48,-122,16,7,23
30743,FremontBridge,04/05/2016 11:00:00 PM,48,-122,6,6,12
30744,FremontBridge,04/06/2016 12:00:00 AM,48,-122,6,0,6
30745,FremontBridge,04/06/2016 01:00:00 AM,48,-122,4,2,6
30746,FremontBridge,04/06/2016 02:00:00 AM,48,-122,3,0,3
30747,FremontBridge,04/06/2016 03:00:00 AM,48,-122,1,1,2
30748,FremontBridge,04/06/2016 04:00:00 AM,48,-122,4,5,9
30749,FremontBridge,04/06/2016 05:00:00 AM,48,-122,13,29,42
30750,FremontBridge,04/06/2016 06:00:00 AM,48,-122,36,100,136
30751,FremontBridge,04/06/2016 07:00:00 AM,48,-122,127,330,457
30752,FremontBridge,04/06/2016 08:00:00 AM,48,-122,161,380,541
30753,FremontBridge,04/06/2016 09:00:00 AM,48,-122,114,141,255
30754,FremontBridge,04/06/2016 10:00:00 AM,48,-122,66,77,143
30755,FremontBridge,04/06/2016 11:00:00 AM,48,-122,38,49,87
30756,FremontBridge,04/06/2016 12:00:00 PM,48,-122,48,57,105
30757,FremontBridge,04/06/2016 01:00:00 PM,48,-122,41,36,77
30758,FremontBridge,04/06/2016 02:00:00 PM,48,-122,51,59,110
30759,FremontBridge,04/06/2016 03:00:00 PM,48,-122,99,83,182
30760,FremontBridge,04/06/2016 04:00:00 PM,48,-122,224,143,367
30761,FremontBridge,04/06/2016 05:00:00 PM,48,-122,502,228,730
30762,FremontBridge,04/06/2016 06:00:00 PM,48,-122,323,180,503
30763,FremontBridge,04/06/2016 07:00:00 PM,48,-122,145,80,225
30764,FremontBridge,04/06/2016 08:00:00 PM,48,-122,60,51,111
30765,FremontBridge,04/06/2016 09:00:00 PM,48,-122,28,38,66
30766,FremontBridge,04/06/2016 10:00:00 PM,48,-122,14,18,32
30767,FremontBridge,04/06/2016 11:00:00 PM,48,-122,12,13,25
30768,FremontBridge,04/07/2016 12:00:00 AM,48,-122,4,3,7
30769,FremontBridge,04/07/2016 01:00:00 AM,48,-122,3,3,6
30770,FremontBridge,04/07/2016 02:00:00 AM,48,-122,1,1,2
30771,FremontBridge,04/07/2016 03:00:00 AM,48,-122,1,1,2
30772,FremontBridge,04/07/2016 04:00:00 AM,48,-122,4,4,8
30773,FremontBridge,04/07/2016 05:00:00 AM,48,-122,16,32,48
30774,FremontBridge,04/07/2016 06:00:00 AM,48,-122,48,123,171
30775,FremontBridge,04/07/2016 07:00:00 AM,48,-122,114,332,446
30776,FremontBridge,04/07/2016 08:00:00 AM,48,-122,168,413,581
30777,FremontBridge,04/07/2016 09:00:00 AM,48,-122,109,153,262
30778,FremontBridge,04/07/2016 10:00:00 AM,48,-122,58,70,128
30779,FremontBridge,04/07/2016 11:00:00 AM,48,-122,56,65,121
30780,FremontBridge,04/07/2016 12:00:00 PM,48,-122,56,68,124
30781,FremontBridge,04/07/2016 01:00:00 PM,48,-122,54,65,119
30782,FremontBridge,04/07/2016 02:00:00 PM,48,-122,69,70,139
30783,FremontBridge,04/07/2016 03:00:00 PM,48,-122,115,93,208
30784,FremontBridge,04/07/2016 04:00:00 PM,48,-122,287,157,444
30785,FremontBridge,04/07/2016 05:00:00 PM,48,-122,500,224,724
30786,FremontBridge,04/07/2016 06:00:00 PM,48,-122,320,184,504
30787,FremontBridge,04/07/2016 07:00:00 PM,48,-122,163,93,256
30788,FremontBridge,04/07/2016 08:00:00 PM,48,-122,71,56,127
30789,FremontBridge,04/07/2016 09:00:00 PM,48,-122,42,38,80
30790,FremontBridge,04/07/2016 10:00:00 PM,48,-122,20,21,41
30791,FremontBridge,04/07/2016 11:00:00 PM,48,-122,19,16,35
30792,FremontBridge,04/08/2016 12:00:00 AM,48,-122,7,11,18
30793,FremontBridge,04/08/2016 01:00:00 AM,48,-122,6,1,7
30794,FremontBridge,04/08/2016 02:00:00 AM,48,-122,0,5,5
30795,FremontBridge,04/08/2016 03:00:00 AM,48,-122,0,1,1
30796,FremontBridge,04/08/2016 04:00:00 AM,48,-122,5,5,10
30797,FremontBridge,04/08/2016 05:00:00 AM,48,-122,10,34,44
30798,FremontBridge,04/08/2016 06:00:00 AM,48,-122,38,91,129
30799,FremontBridge,04/08/2016 07:00:00 AM,48,-122,112,265,377
30800,FremontBridge,04/08/2016 08:00:00 AM,48,-122,148,335,483
30801,FremontBridge,04/08/2016 09:00:00 AM,48,-122,123,175,298
30802,FremontBridge,04/08/2016 10:00:00 AM,48,-122,65,71,136
30803,FremontBridge,04/08/2016 11:00:00 AM,48,-122,44,52,96
30804,FremontBridge,04/08/2016 12:00:00 PM,48,-122,52,55,107
30805,FremontBridge,04/08/2016 01:00:00 PM,48,-122,60,53,113
30806,FremontBridge,04/08/2016 02:00:00 PM,48,-122,59,66,125
30807,FremontBridge,04/08/2016 03:00:00 PM,48,-122,110,74,184
30808,FremontBridge,04/08/2016 04:00:00 PM,48,-122,242,133,375
30809,FremontBridge,04/08/2016 05:00:00 PM,48,-122,435,187,622
30810,FremontBridge,04/08/2016 06:00:00 PM,48,-122,223,121,344
30811,FremontBridge,04/08/2016 07:00:00 PM,48,-122,101,71,172
30812,FremontBridge,04/08/2016 08:00:00 PM,48,-122,58,59,117
30813,FremontBridge,04/08/2016 09:00:00 PM,48,-122,29,26,55
30814,FremontBridge,04/08/2016 10:00:00 PM,48,-122,23,13,36
30815,FremontBridge,04/08/2016 11:00:00 PM,48,-122,12,17,29
30816,FremontBridge,04/09/2016 12:00:00 AM,48,-122,15,8,23
30817,FremontBridge,04/09/2016 01:00:00 AM,48,-122,11,7,18
30818,FremontBridge,04/09/2016 02:00:00 AM,48,-122,2,5,7
30819,FremontBridge,04/09/2016 03:00:00 AM,48,-122,0,1,1
30820,FremontBridge,04/09/2016 04:00:00 AM,48,-122,4,0,4
30821,FremontBridge,04/09/2016 05:00:00 AM,48,-122,3,5,8
30822,FremontBridge,04/09/2016 06:00:00 AM,48,-122,8,9,17
30823,FremontBridge,04/09/2016 07:00:00 AM,48,-122,32,27,59
30824,FremontBridge,04/09/2016 08:00:00 AM,48,-122,47,50,97
30825,FremontBridge,04/09/2016 09:00:00 AM,48,-122,56,73,129
30826,FremontBridge,04/09/2016 10:00:00 AM,48,-122,73,66,139
30827,FremontBridge,04/09/2016 11:00:00 AM,48,-122,68,78,146
30828,FremontBridge,04/09/2016 12:00:00 PM,48,-122,87,131,218
30829,FremontBridge,04/09/2016 01:00:00 PM,48,-122,101,109,210
30830,FremontBridge,04/09/2016 02:00:00 PM,48,-122,97,118,215
30831,FremontBridge,04/09/2016 03:00:00 PM,48,-122,87,128,215
30832,FremontBridge,04/09/2016 04:00:00 PM,48,-122,92,147,239
30833,FremontBridge,04/09/2016 05:00:00 PM,48,-122,94,83,177
30834,FremontBridge,04/09/2016 06:00:00 PM,48,-122,68,82,150
30835,FremontBridge,04/09/2016 07:00:00 PM,48,-122,46,60,106
30836,FremontBridge,04/09/2016 08:00:00 PM,48,-122,27,24,51
30837,FremontBridge,04/09/2016 09:00:00 PM,48,-122,26,34,60
30838,FremontBridge,04/09/2016 10:00:00 PM,48,-122,17,13,30
30839,FremontBridge,04/09/2016 11:00:00 PM,48,-122,16,12,28
30840,FremontBridge,04/10/2016 12:00:00 AM,48,-122,15,10,25
30841,FremontBridge,04/10/2016 01:00:00 AM,48,-122,8,5,13
30842,FremontBridge,04/10/2016 02:00:00 AM,48,-122,9,1,10
30843,FremontBridge,04/10/2016 03:00:00 AM,48,-122,2,0,2
30844,FremontBridge,04/10/2016 04:00:00 AM,48,-122,2,1,3
30845,FremontBridge,04/10/2016 05:00:00 AM,48,-122,2,5,7
30846,FremontBridge,04/10/2016 06:00:00 AM,48,-122,5,3,8
30847,FremontBridge,04/10/2016 07:00:00 AM,48,-122,12,16,28
30848,FremontBridge,04/10/2016 08:00:00 AM,48,-122,28,27,55
30849,FremontBridge,04/10/2016 09:00:00 AM,48,-122,43,39,82
30850,FremontBridge,04/10/2016 10:00:00 AM,48,-122,49,54,103
30851,FremontBridge,04/10/2016 11:00:00 AM,48,-122,82,74,156
30852,FremontBridge,04/10/2016 12:00:00 PM,48,-122,56,90,146
30853,FremontBridge,04/10/2016 01:00:00 PM,48,-122,73,77,150
30854,FremontBridge,04/10/2016 02:00:00 PM,48,-122,64,83,147
30855,FremontBridge,04/10/2016 03:00:00 PM,48,-122,57,79,136
30856,FremontBridge,04/10/2016 04:00:00 PM,48,-122,73,72,145
30857,FremontBridge,04/10/2016 05:00:00 PM,48,-122,67,80,147
30858,FremontBridge,04/10/2016 06:00:00 PM,48,-122,54,49,103
30859,FremontBridge,04/10/2016 07:00:00 PM,48,-122,33,31,64
30860,FremontBridge,04/10/2016 08:00:00 PM,48,-122,9,18,27
30861,FremontBridge,04/10/2016 09:00:00 PM,48,-122,8,11,19
30862,FremontBridge,04/10/2016 10:00:00 PM,48,-122,11,11,22
30863,FremontBridge,04/10/2016 11:00:00 PM,48,-122,3,2,5
30864,FremontBridge,04/11/2016 12:00:00 AM,48,-122,4,0,4
30865,FremontBridge,04/11/2016 01:00:00 AM,48,-122,2,1,3
30866,FremontBridge,04/11/2016 02:00:00 AM,48,-122,2,1,3
30867,FremontBridge,04/11/2016 03:00:00 AM,48,-122,0,1,1
30868,FremontBridge,04/11/2016 04:00:00 AM,48,-122,1,2,3
30869,FremontBridge,04/11/2016 05:00:00 AM,48,-122,10,25,35
30870,FremontBridge,04/11/2016 06:00:00 AM,48,-122,37,79,116
30871,FremontBridge,04/11/2016 07:00:00 AM,48,-122,102,233,335
30872,FremontBridge,04/11/2016 08:00:00 AM,48,-122,173,307,480
30873,FremontBridge,04/11/2016 09:00:00 AM,48,-122,106,158,264
30874,FremontBridge,04/11/2016 10:00:00 AM,48,-122,44,47,91
30875,FremontBridge,04/11/2016 11:00:00 AM,48,-122,30,28,58
30876,FremontBridge,04/11/2016 12:00:00 PM,48,-122,20,40,60
30877,FremontBridge,04/11/2016 01:00:00 PM,48,-122,38,26,64
30878,FremontBridge,04/11/2016 02:00:00 PM,48,-122,34,49,83
30879,FremontBridge,04/11/2016 03:00:00 PM,48,-122,68,59,127
30880,FremontBridge,04/11/2016 04:00:00 PM,48,-122,160,100,260
30881,FremontBridge,04/11/2016 05:00:00 PM,48,-122,385,158,543
30882,FremontBridge,04/11/2016 06:00:00 PM,48,-122,254,109,363
30883,FremontBridge,04/11/2016 07:00:00 PM,48,-122,89,73,162
30884,FremontBridge,04/11/2016 08:00:00 PM,48,-122,59,22,81
30885,FremontBridge,04/11/2016 09:00:00 PM,48,-122,25,13,38
30886,FremontBridge,04/11/2016 10:00:00 PM,48,-122,17,13,30
30887,FremontBridge,04/11/2016 11:00:00 PM,48,-122,11,10,21
30888,FremontBridge,04/12/2016 12:00:00 AM,48,-122,5,3,8
30889,FremontBridge,04/12/2016 01:00:00 AM,48,-122,1,2,3
30890,FremontBridge,04/12/2016 02:00:00 AM,48,-122,0,3,3
30891,FremontBridge,04/12/2016 03:00:00 AM,48,-122,1,1,2
30892,FremontBridge,04/12/2016 04:00:00 AM,48,-122,4,3,7
30893,FremontBridge,04/12/2016 05:00:00 AM,48,-122,8,26,34
30894,FremontBridge,04/12/2016 06:00:00 AM,48,-122,40,72,112
30895,FremontBridge,04/12/2016 07:00:00 AM,48,-122,96,192,288
30896,FremontBridge,04/12/2016 08:00:00 AM,48,-122,120,282,402
30897,FremontBridge,04/12/2016 09:00:00 AM,48,-122,94,125,219
30898,FremontBridge,04/12/2016 10:00:00 AM,48,-122,41,57,98
30899,FremontBridge,04/12/2016 11:00:00 AM,48,-122,33,35,68
30900,FremontBridge,04/12/2016 12:00:00 PM,48,-122,29,46,75
30901,FremontBridge,04/12/2016 01:00:00 PM,48,-122,28,36,64
30902,FremontBridge,04/12/2016 02:00:00 PM,48,-122,40,17,57
30903,FremontBridge,04/12/2016 03:00:00 PM,48,-122,45,43,88
30904,FremontBridge,04/12/2016 04:00:00 PM,48,-122,93,50,143
30905,FremontBridge,04/12/2016 05:00:00 PM,48,-122,237,88,325
30906,FremontBridge,04/12/2016 06:00:00 PM,48,-122,200,75,275
30907,FremontBridge,04/12/2016 07:00:00 PM,48,-122,82,30,112
30908,FremontBridge,04/12/2016 08:00:00 PM,48,-122,44,21,65
30909,FremontBridge,04/12/2016 09:00:00 PM,48,-122,17,15,32
30910,FremontBridge,04/12/2016 10:00:00 PM,48,-122,10,7,17
30911,FremontBridge,04/12/2016 11:00:00 PM,48,-122,4,2,6
30912,FremontBridge,04/13/2016 12:00:00 AM,48,-122,2,3,5
30913,FremontBridge,04/13/2016 01:00:00 AM,48,-122,1,3,4
30914,FremontBridge,04/13/2016 02:00:00 AM,48,-122,0,1,1
30915,FremontBridge,04/13/2016 03:00:00 AM,48,-122,0,1,1
30916,FremontBridge,04/13/2016 04:00:00 AM,48,-122,1,2,3
30917,FremontBridge,04/13/2016 05:00:00 AM,48,-122,8,18,26
30918,FremontBridge,04/13/2016 06:00:00 AM,48,-122,44,68,112
30919,FremontBridge,04/13/2016 07:00:00 AM,48,-122,82,189,271
30920,FremontBridge,04/13/2016 08:00:00 AM,48,-122,106,263,369
30921,FremontBridge,04/13/2016 09:00:00 AM,48,-122,91,121,212
30922,FremontBridge,04/13/2016 10:00:00 AM,48,-122,35,43,78
30923,FremontBridge,04/13/2016 11:00:00 AM,48,-122,37,37,74
30924,FremontBridge,04/13/2016 12:00:00 PM,48,-122,29,37,66
30925,FremontBridge,04/13/2016 01:00:00 PM,48,-122,37,40,77
30926,FremontBridge,04/13/2016 02:00:00 PM,48,-122,30,33,63
30927,FremontBridge,04/13/2016 03:00:00 PM,48,-122,60,39,99
30928,FremontBridge,04/13/2016 04:00:00 PM,48,-122,151,78,229
30929,FremontBridge,04/13/2016 05:00:00 PM,48,-122,369,136,505
30930,FremontBridge,04/13/2016 06:00:00 PM,48,-122,229,130,359
30931,FremontBridge,04/13/2016 07:00:00 PM,48,-122,114,62,176
30932,FremontBridge,04/13/2016 08:00:00 PM,48,-122,61,45,106
30933,FremontBridge,04/13/2016 09:00:00 PM,48,-122,37,23,60
30934,FremontBridge,04/13/2016 10:00:00 PM,48,-122,18,8,26
30935,FremontBridge,04/13/2016 11:00:00 PM,48,-122,9,7,16
30936,FremontBridge,04/14/2016 12:00:00 AM,48,-122,7,3,10
30937,FremontBridge,04/14/2016 01:00:00 AM,48,-122,2,1,3
30938,FremontBridge,04/14/2016 02:00:00 AM,48,-122,2,1,3
30939,FremontBridge,04/14/2016 03:00:00 AM,48,-122,0,0,0
30940,FremontBridge,04/14/2016 04:00:00 AM,48,-122,1,2,3
30941,FremontBridge,04/14/2016 05:00:00 AM,48,-122,11,22,33
30942,FremontBridge,04/14/2016 06:00:00 AM,48,-122,33,76,109
30943,FremontBridge,04/14/2016 07:00:00 AM,48,-122,84,221,305
30944,FremontBridge,04/14/2016 08:00:00 AM,48,-122,120,305,425
30945,FremontBridge,04/14/2016 09:00:00 AM,48,-122,91,136,227
30946,FremontBridge,04/14/2016 10:00:00 AM,48,-122,41,59,100
30947,FremontBridge,04/14/2016 11:00:00 AM,48,-122,42,35,77
30948,FremontBridge,04/14/2016 12:00:00 PM,48,-122,37,39,76
30949,FremontBridge,04/14/2016 01:00:00 PM,48,-122,39,42,81
30950,FremontBridge,04/14/2016 02:00:00 PM,48,-122,41,46,87
30951,FremontBridge,04/14/2016 03:00:00 PM,48,-122,77,73,150
30952,FremontBridge,04/14/2016 04:00:00 PM,48,-122,183,92,275
30953,FremontBridge,04/14/2016 05:00:00 PM,48,-122,365,166,531
30954,FremontBridge,04/14/2016 06:00:00 PM,48,-122,221,154,375
30955,FremontBridge,04/14/2016 07:00:00 PM,48,-122,108,61,169
30956,FremontBridge,04/14/2016 08:00:00 PM,48,-122,60,38,98
30957,FremontBridge,04/14/2016 09:00:00 PM,48,-122,29,23,52
30958,FremontBridge,04/14/2016 10:00:00 PM,48,-122,18,10,28
30959,FremontBridge,04/14/2016 11:00:00 PM,48,-122,7,17,24
30960,FremontBridge,04/15/2016 12:00:00 AM,48,-122,4,5,9
30961,FremontBridge,04/15/2016 01:00:00 AM,48,-122,5,2,7
30962,FremontBridge,04/15/2016 02:00:00 AM,48,-122,2,1,3
30963,FremontBridge,04/15/2016 03:00:00 AM,48,-122,0,0,0
30964,FremontBridge,04/15/2016 04:00:00 AM,48,-122,3,3,6
30965,FremontBridge,04/15/2016 05:00:00 AM,48,-122,10,24,34
30966,FremontBridge,04/15/2016 06:00:00 AM,48,-122,31,71,102
30967,FremontBridge,04/15/2016 07:00:00 AM,48,-122,90,191,281
30968,FremontBridge,04/15/2016 08:00:00 AM,48,-122,119,242,361
30969,FremontBridge,04/15/2016 09:00:00 AM,48,-122,79,138,217
30970,FremontBridge,04/15/2016 10:00:00 AM,48,-122,41,60,101
30971,FremontBridge,04/15/2016 11:00:00 AM,48,-122,52,44,96
30972,FremontBridge,04/15/2016 12:00:00 PM,48,-122,35,43,78
30973,FremontBridge,04/15/2016 01:00:00 PM,48,-122,40,39,79
30974,FremontBridge,04/15/2016 02:00:00 PM,48,-122,57,41,98
30975,FremontBridge,04/15/2016 03:00:00 PM,48,-122,83,68,151
30976,FremontBridge,04/15/2016 04:00:00 PM,48,-122,160,95,255
30977,FremontBridge,04/15/2016 05:00:00 PM,48,-122,313,125,438
30978,FremontBridge,04/15/2016 06:00:00 PM,48,-122,167,76,243
30979,FremontBridge,04/15/2016 07:00:00 PM,48,-122,89,58,147
30980,FremontBridge,04/15/2016 08:00:00 PM,48,-122,34,26,60
30981,FremontBridge,04/15/2016 09:00:00 PM,48,-122,21,25,46
30982,FremontBridge,04/15/2016 10:00:00 PM,48,-122,14,16,30
30983,FremontBridge,04/15/2016 11:00:00 PM,48,-122,17,9,26
30984,FremontBridge,04/16/2016 12:00:00 AM,48,-122,3,10,13
30985,FremontBridge,04/16/2016 01:00:00 AM,48,-122,3,3,6
30986,FremontBridge,04/16/2016 02:00:00 AM,48,-122,0,2,2
30987,FremontBridge,04/16/2016 03:00:00 AM,48,-122,2,0,2
30988,FremontBridge,04/16/2016 04:00:00 AM,48,-122,4,0,4
30989,FremontBridge,04/16/2016 05:00:00 AM,48,-122,7,10,17
30990,FremontBridge,04/16/2016 06:00:00 AM,48,-122,4,12,16
30991,FremontBridge,04/16/2016 07:00:00 AM,48,-122,27,22,49
30992,FremontBridge,04/16/2016 08:00:00 AM,48,-122,52,59,111
30993,FremontBridge,04/16/2016 09:00:00 AM,48,-122,60,49,109
30994,FremontBridge,04/16/2016 10:00:00 AM,48,-122,66,88,154
30995,FremontBridge,04/16/2016 11:00:00 AM,48,-122,95,112,207
30996,FremontBridge,04/16/2016 12:00:00 PM,48,-122,87,126,213
30997,FremontBridge,04/16/2016 01:00:00 PM,48,-122,81,114,195
30998,FremontBridge,04/16/2016 02:00:00 PM,48,-122,88,121,209
30999,FremontBridge,04/16/2016 03:00:00 PM,48,-122,88,119,207
31000,FremontBridge,04/16/2016 04:00:00 PM,48,-122,90,85,175
31001,FremontBridge,04/16/2016 05:00:00 PM,48,-122,80,92,172
31002,FremontBridge,04/16/2016 06:00:00 PM,48,-122,77,84,161
31003,FremontBridge,04/16/2016 07:00:00 PM,48,-122,50,36,86
31004,FremontBridge,04/16/2016 08:00:00 PM,48,-122,33,34,67
31005,FremontBridge,04/16/2016 09:00:00 PM,48,-122,35,21,56
31006,FremontBridge,04/16/2016 10:00:00 PM,48,-122,24,14,38
31007,FremontBridge,04/16/2016 11:00:00 PM,48,-122,8,4,12
31008,FremontBridge,04/17/2016 12:00:00 AM,48,-122,12,5,17
31009,FremontBridge,04/17/2016 01:00:00 AM,48,-122,4,4,8
31010,FremontBridge,04/17/2016 02:00:00 AM,48,-122,4,6,10
31011,FremontBridge,04/17/2016 03:00:00 AM,48,-122,2,3,5
31012,FremontBridge,04/17/2016 04:00:00 AM,48,-122,2,0,2
31013,FremontBridge,04/17/2016 05:00:00 AM,48,-122,4,3,7
31014,FremontBridge,04/17/2016 06:00:00 AM,48,-122,4,7,11
31015,FremontBridge,04/17/2016 07:00:00 AM,48,-122,16,21,37
31016,FremontBridge,04/17/2016 08:00:00 AM,48,-122,26,50,76
31017,FremontBridge,04/17/2016 09:00:00 AM,48,-122,53,49,102
31018,FremontBridge,04/17/2016 10:00:00 AM,48,-122,66,54,120
31019,FremontBridge,04/17/2016 11:00:00 AM,48,-122,102,115,217
31020,FremontBridge,04/17/2016 12:00:00 PM,48,-122,91,83,174
31021,FremontBridge,04/17/2016 01:00:00 PM,48,-122,114,155,269
31022,FremontBridge,04/17/2016 02:00:00 PM,48,-122,107,124,231
31023,FremontBridge,04/17/2016 03:00:00 PM,48,-122,84,116,200
31024,FremontBridge,04/17/2016 04:00:00 PM,48,-122,91,112,203
31025,FremontBridge,04/17/2016 05:00:00 PM,48,-122,96,76,172
31026,FremontBridge,04/17/2016 06:00:00 PM,48,-122,63,78,141
31027,FremontBridge,04/17/2016 07:00:00 PM,48,-122,27,56,83
31028,FremontBridge,04/17/2016 08:00:00 PM,48,-122,32,40,72
31029,FremontBridge,04/17/2016 09:00:00 PM,48,-122,13,19,32
31030,FremontBridge,04/17/2016 10:00:00 PM,48,-122,9,8,17
31031,FremontBridge,04/17/2016 11:00:00 PM,48,-122,8,9,17
31032,FremontBridge,04/18/2016 12:00:00 AM,48,-122,9,0,9
31033,FremontBridge,04/18/2016 01:00:00 AM,48,-122,4,1,5
31034,FremontBridge,04/18/2016 02:00:00 AM,48,-122,4,0,4
31035,FremontBridge,04/18/2016 03:00:00 AM,48,-122,0,1,1
31036,FremontBridge,04/18/2016 04:00:00 AM,48,-122,1,4,5
31037,FremontBridge,04/18/2016 05:00:00 AM,48,-122,16,22,38
31038,FremontBridge,04/18/2016 06:00:00 AM,48,-122,56,113,169
31039,FremontBridge,04/18/2016 07:00:00 AM,48,-122,133,363,496
31040,FremontBridge,04/18/2016 08:00:00 AM,48,-122,185,447,632
31041,FremontBridge,04/18/2016 09:00:00 AM,48,-122,101,170,271
31042,FremontBridge,04/18/2016 10:00:00 AM,48,-122,60,75,135
31043,FremontBridge,04/18/2016 11:00:00 AM,48,-122,47,48,95
31044,FremontBridge,04/18/2016 12:00:00 PM,48,-122,53,50,103
31045,FremontBridge,04/18/2016 01:00:00 PM,48,-122,70,40,110
31046,FremontBridge,04/18/2016 02:00:00 PM,48,-122,55,63,118
31047,FremontBridge,04/18/2016 03:00:00 PM,48,-122,87,95,182
31048,FremontBridge,04/18/2016 04:00:00 PM,48,-122,240,131,371
31049,FremontBridge,04/18/2016 05:00:00 PM,48,-122,593,220,813
31050,FremontBridge,04/18/2016 06:00:00 PM,48,-122,385,209,594
31051,FremontBridge,04/18/2016 07:00:00 PM,48,-122,176,89,265
31052,FremontBridge,04/18/2016 08:00:00 PM,48,-122,64,71,135
31053,FremontBridge,04/18/2016 09:00:00 PM,48,-122,41,23,64
31054,FremontBridge,04/18/2016 10:00:00 PM,48,-122,19,29,48
31055,FremontBridge,04/18/2016 11:00:00 PM,48,-122,8,7,15
31056,FremontBridge,04/19/2016 12:00:00 AM,48,-122,8,2,10
31057,FremontBridge,04/19/2016 01:00:00 AM,48,-122,3,2,5
31058,FremontBridge,04/19/2016 02:00:00 AM,48,-122,3,1,4
31059,FremontBridge,04/19/2016 03:00:00 AM,48,-122,3,0,3
31060,FremontBridge,04/19/2016 04:00:00 AM,48,-122,4,4,8
31061,FremontBridge,04/19/2016 05:00:00 AM,48,-122,17,32,49
31062,FremontBridge,04/19/2016 06:00:00 AM,48,-122,55,124,179
31063,FremontBridge,04/19/2016 07:00:00 AM,48,-122,143,396,539
31064,FremontBridge,04/19/2016 08:00:00 AM,48,-122,201,455,656
31065,FremontBridge,04/19/2016 09:00:00 AM,48,-122,129,188,317
31066,FremontBridge,04/19/2016 10:00:00 AM,48,-122,45,83,128
31067,FremontBridge,04/19/2016 11:00:00 AM,48,-122,40,58,98
31068,FremontBridge,04/19/2016 12:00:00 PM,48,-122,61,53,114
31069,FremontBridge,04/19/2016 01:00:00 PM,48,-122,60,52,112
31070,FremontBridge,04/19/2016 02:00:00 PM,48,-122,73,59,132
31071,FremontBridge,04/19/2016 03:00:00 PM,48,-122,106,100,206
31072,FremontBridge,04/19/2016 04:00:00 PM,48,-122,256,126,382
31073,FremontBridge,04/19/2016 05:00:00 PM,48,-122,568,248,816
31074,FremontBridge,04/19/2016 06:00:00 PM,48,-122,343,180,523
31075,FremontBridge,04/19/2016 07:00:00 PM,48,-122,137,114,251
31076,FremontBridge,04/19/2016 08:00:00 PM,48,-122,98,85,183
31077,FremontBridge,04/19/2016 09:00:00 PM,48,-122,44,46,90
31078,FremontBridge,04/19/2016 10:00:00 PM,48,-122,31,14,45
31079,FremontBridge,04/19/2016 11:00:00 PM,48,-122,14,13,27
31080,FremontBridge,04/20/2016 12:00:00 AM,48,-122,7,2,9
31081,FremontBridge,04/20/2016 01:00:00 AM,48,-122,3,5,8
31082,FremontBridge,04/20/2016 02:00:00 AM,48,-122,3,2,5
31083,FremontBridge,04/20/2016 03:00:00 AM,48,-122,1,3,4
31084,FremontBridge,04/20/2016 04:00:00 AM,48,-122,4,5,9
31085,FremontBridge,04/20/2016 05:00:00 AM,48,-122,15,38,53
31086,FremontBridge,04/20/2016 06:00:00 AM,48,-122,70,202,272
31087,FremontBridge,04/20/2016 07:00:00 AM,48,-122,143,343,486
31088,FremontBridge,04/20/2016 08:00:00 AM,48,-122,205,396,601
31089,FremontBridge,04/20/2016 09:00:00 AM,48,-122,143,184,327
31090,FremontBridge,04/20/2016 10:00:00 AM,48,-122,60,61,121
31091,FremontBridge,04/20/2016 11:00:00 AM,48,-122,48,51,99
31092,FremontBridge,04/20/2016 12:00:00 PM,48,-122,58,54,112
31093,FremontBridge,04/20/2016 01:00:00 PM,48,-122,54,49,103
31094,FremontBridge,04/20/2016 02:00:00 PM,48,-122,64,72,136
31095,FremontBridge,04/20/2016 03:00:00 PM,48,-122,99,82,181
31096,FremontBridge,04/20/2016 04:00:00 PM,48,-122,250,128,378
31097,FremontBridge,04/20/2016 05:00:00 PM,48,-122,524,259,783
31098,FremontBridge,04/20/2016 06:00:00 PM,48,-122,323,189,512
31099,FremontBridge,04/20/2016 07:00:00 PM,48,-122,156,115,271
31100,FremontBridge,04/20/2016 08:00:00 PM,48,-122,77,75,152
31101,FremontBridge,04/20/2016 09:00:00 PM,48,-122,41,44,85
31102,FremontBridge,04/20/2016 10:00:00 PM,48,-122,34,23,57
31103,FremontBridge,04/20/2016 11:00:00 PM,48,-122,13,9,22
31104,FremontBridge,04/21/2016 12:00:00 AM,48,-122,8,6,14
31105,FremontBridge,04/21/2016 01:00:00 AM,48,-122,4,1,5
31106,FremontBridge,04/21/2016 02:00:00 AM,48,-122,3,1,4
31107,FremontBridge,04/21/2016 03:00:00 AM,48,-122,0,0,0
31108,FremontBridge,04/21/2016 04:00:00 AM,48,-122,2,5,7
31109,FremontBridge,04/21/2016 05:00:00 AM,48,-122,19,28,47
31110,FremontBridge,04/21/2016 06:00:00 AM,48,-122,50,96,146
31111,FremontBridge,04/21/2016 07:00:00 AM,48,-122,141,352,493
31112,FremontBridge,04/21/2016 08:00:00 AM,48,-122,165,387,552
31113,FremontBridge,04/21/2016 09:00:00 AM,48,-122,112,172,284
31114,FremontBridge,04/21/2016 10:00:00 AM,48,-122,45,68,113
31115,FremontBridge,04/21/2016 11:00:00 AM,48,-122,39,53,92
31116,FremontBridge,04/21/2016 12:00:00 PM,48,-122,39,49,88
31117,FremontBridge,04/21/2016 01:00:00 PM,48,-122,44,50,94
31118,FremontBridge,04/21/2016 02:00:00 PM,48,-122,56,58,114
31119,FremontBridge,04/21/2016 03:00:00 PM,48,-122,107,73,180
31120,FremontBridge,04/21/2016 04:00:00 PM,48,-122,223,133,356
31121,FremontBridge,04/21/2016 05:00:00 PM,48,-122,461,226,687
31122,FremontBridge,04/21/2016 06:00:00 PM,48,-122,319,179,498
31123,FremontBridge,04/21/2016 07:00:00 PM,48,-122,124,92,216
31124,FremontBridge,04/21/2016 08:00:00 PM,48,-122,75,49,124
31125,FremontBridge,04/21/2016 09:00:00 PM,48,-122,41,38,79
31126,FremontBridge,04/21/2016 10:00:00 PM,48,-122,30,27,57
31127,FremontBridge,04/21/2016 11:00:00 PM,48,-122,10,16,26
31128,FremontBridge,04/22/2016 12:00:00 AM,48,-122,7,11,18
31129,FremontBridge,04/22/2016 01:00:00 AM,48,-122,2,7,9
31130,FremontBridge,04/22/2016 02:00:00 AM,48,-122,2,0,2
31131,FremontBridge,04/22/2016 03:00:00 AM,48,-122,2,0,2
31132,FremontBridge,04/22/2016 04:00:00 AM,48,-122,4,3,7
31133,FremontBridge,04/22/2016 05:00:00 AM,48,-122,13,18,31
31134,FremontBridge,04/22/2016 06:00:00 AM,48,-122,36,74,110
31135,FremontBridge,04/22/2016 07:00:00 AM,48,-122,81,211,292
31136,FremontBridge,04/22/2016 08:00:00 AM,48,-122,118,290,408
31137,FremontBridge,04/22/2016 09:00:00 AM,48,-122,72,135,207
31138,FremontBridge,04/22/2016 10:00:00 AM,48,-122,57,57,114
31139,FremontBridge,04/22/2016 11:00:00 AM,48,-122,31,35,66
31140,FremontBridge,04/22/2016 12:00:00 PM,48,-122,36,28,64
31141,FremontBridge,04/22/2016 01:00:00 PM,48,-122,30,35,65
31142,FremontBridge,04/22/2016 02:00:00 PM,48,-122,41,36,77
31143,FremontBridge,04/22/2016 03:00:00 PM,48,-122,71,49,120
31144,FremontBridge,04/22/2016 04:00:00 PM,48,-122,150,72,222
31145,FremontBridge,04/22/2016 05:00:00 PM,48,-122,286,125,411
31146,FremontBridge,04/22/2016 06:00:00 PM,48,-122,152,84,236
31147,FremontBridge,04/22/2016 07:00:00 PM,48,-122,82,43,125
31148,FremontBridge,04/22/2016 08:00:00 PM,48,-122,31,17,48
31149,FremontBridge,04/22/2016 09:00:00 PM,48,-122,24,23,47
31150,FremontBridge,04/22/2016 10:00:00 PM,48,-122,13,8,21
31151,FremontBridge,04/22/2016 11:00:00 PM,48,-122,10,6,16
31152,FremontBridge,04/23/2016 12:00:00 AM,48,-122,5,12,17
31153,FremontBridge,04/23/2016 01:00:00 AM,48,-122,1,0,1
31154,FremontBridge,04/23/2016 02:00:00 AM,48,-122,3,3,6
31155,FremontBridge,04/23/2016 03:00:00 AM,48,-122,4,1,5
31156,FremontBridge,04/23/2016 04:00:00 AM,48,-122,2,0,2
31157,FremontBridge,04/23/2016 05:00:00 AM,48,-122,2,6,8
31158,FremontBridge,04/23/2016 06:00:00 AM,48,-122,6,2,8
31159,FremontBridge,04/23/2016 07:00:00 AM,48,-122,16,21,37
31160,FremontBridge,04/23/2016 08:00:00 AM,48,-122,42,39,81
31161,FremontBridge,04/23/2016 09:00:00 AM,48,-122,44,122,166
31162,FremontBridge,04/23/2016 10:00:00 AM,48,-122,50,85,135
31163,FremontBridge,04/23/2016 11:00:00 AM,48,-122,44,75,119
31164,FremontBridge,04/23/2016 12:00:00 PM,48,-122,65,81,146
31165,FremontBridge,04/23/2016 01:00:00 PM,48,-122,81,88,169
31166,FremontBridge,04/23/2016 02:00:00 PM,48,-122,62,92,154
31167,FremontBridge,04/23/2016 03:00:00 PM,48,-122,76,67,143
31168,FremontBridge,04/23/2016 04:00:00 PM,48,-122,64,71,135
31169,FremontBridge,04/23/2016 05:00:00 PM,48,-122,48,60,108
31170,FremontBridge,04/23/2016 06:00:00 PM,48,-122,45,26,71
31171,FremontBridge,04/23/2016 07:00:00 PM,48,-122,21,33,54
31172,FremontBridge,04/23/2016 08:00:00 PM,48,-122,21,18,39
31173,FremontBridge,04/23/2016 09:00:00 PM,48,-122,11,8,19
31174,FremontBridge,04/23/2016 10:00:00 PM,48,-122,8,15,23
31175,FremontBridge,04/23/2016 11:00:00 PM,48,-122,15,10,25
31176,FremontBridge,04/24/2016 12:00:00 AM,48,-122,2,6,8
31177,FremontBridge,04/24/2016 01:00:00 AM,48,-122,4,2,6
31178,FremontBridge,04/24/2016 02:00:00 AM,48,-122,2,3,5
31179,FremontBridge,04/24/2016 03:00:00 AM,48,-122,0,0,0
31180,FremontBridge,04/24/2016 04:00:00 AM,48,-122,5,0,5
31181,FremontBridge,04/24/2016 05:00:00 AM,48,-122,1,1,2
31182,FremontBridge,04/24/2016 06:00:00 AM,48,-122,7,4,11
31183,FremontBridge,04/24/2016 07:00:00 AM,48,-122,7,15,22
31184,FremontBridge,04/24/2016 08:00:00 AM,48,-122,19,20,39
31185,FremontBridge,04/24/2016 09:00:00 AM,48,-122,15,13,28
31186,FremontBridge,04/24/2016 10:00:00 AM,48,-122,8,10,18
31187,FremontBridge,04/24/2016 11:00:00 AM,48,-122,11,15,26
31188,FremontBridge,04/24/2016 12:00:00 PM,48,-122,12,10,22
31189,FremontBridge,04/24/2016 01:00:00 PM,48,-122,9,12,21
31190,FremontBridge,04/24/2016 02:00:00 PM,48,-122,14,25,39
31191,FremontBridge,04/24/2016 03:00:00 PM,48,-122,21,17,38
31192,FremontBridge,04/24/2016 04:00:00 PM,48,-122,13,25,38
31193,FremontBridge,04/24/2016 05:00:00 PM,48,-122,20,26,46
31194,FremontBridge,04/24/2016 06:00:00 PM,48,-122,13,18,31
31195,FremontBridge,04/24/2016 07:00:00 PM,48,-122,10,6,16
31196,FremontBridge,04/24/2016 08:00:00 PM,48,-122,7,9,16
31197,FremontBridge,04/24/2016 09:00:00 PM,48,-122,6,2,8
31198,FremontBridge,04/24/2016 10:00:00 PM,48,-122,6,7,13
31199,FremontBridge,04/24/2016 11:00:00 PM,48,-122,2,3,5
31200,FremontBridge,04/25/2016 12:00:00 AM,48,-122,3,2,5
31201,FremontBridge,04/25/2016 01:00:00 AM,48,-122,1,0,1
31202,FremontBridge,04/25/2016 02:00:00 AM,48,-122,1,0,1
31203,FremontBridge,04/25/2016 03:00:00 AM,48,-122,0,0,0
31204,FremontBridge,04/25/2016 04:00:00 AM,48,-122,2,5,7
31205,FremontBridge,04/25/2016 05:00:00 AM,48,-122,11,25,36
31206,FremontBridge,04/25/2016 06:00:00 AM,48,-122,35,74,109
31207,FremontBridge,04/25/2016 07:00:00 AM,48,-122,83,184,267
31208,FremontBridge,04/25/2016 08:00:00 AM,48,-122,120,275,395
31209,FremontBridge,04/25/2016 09:00:00 AM,48,-122,77,157,234
31210,FremontBridge,04/25/2016 10:00:00 AM,48,-122,36,45,81
31211,FremontBridge,04/25/2016 11:00:00 AM,48,-122,20,20,40
31212,FremontBridge,04/25/2016 12:00:00 PM,48,-122,22,39,61
31213,FremontBridge,04/25/2016 01:00:00 PM,48,-122,29,40,69
31214,FremontBridge,04/25/2016 02:00:00 PM,48,-122,35,28,63
31215,FremontBridge,04/25/2016 03:00:00 PM,48,-122,67,68,135
31216,FremontBridge,04/25/2016 04:00:00 PM,48,-122,139,90,229
31217,FremontBridge,04/25/2016 05:00:00 PM,48,-122,350,166,516
31218,FremontBridge,04/25/2016 06:00:00 PM,48,-122,217,138,355
31219,FremontBridge,04/25/2016 07:00:00 PM,48,-122,91,70,161
31220,FremontBridge,04/25/2016 08:00:00 PM,48,-122,39,35,74
31221,FremontBridge,04/25/2016 09:00:00 PM,48,-122,17,14,31
31222,FremontBridge,04/25/2016 10:00:00 PM,48,-122,14,19,33
31223,FremontBridge,04/25/2016 11:00:00 PM,48,-122,11,15,26
31224,FremontBridge,04/26/2016 12:00:00 AM,48,-122,5,6,11
31225,FremontBridge,04/26/2016 01:00:00 AM,48,-122,4,1,5
31226,FremontBridge,04/26/2016 02:00:00 AM,48,-122,1,3,4
31227,FremontBridge,04/26/2016 03:00:00 AM,48,-122,1,2,3
31228,FremontBridge,04/26/2016 04:00:00 AM,48,-122,3,5,8
31229,FremontBridge,04/26/2016 05:00:00 AM,48,-122,10,26,36
31230,FremontBridge,04/26/2016 06:00:00 AM,48,-122,53,114,167
31231,FremontBridge,04/26/2016 07:00:00 AM,48,-122,127,317,444
31232,FremontBridge,04/26/2016 08:00:00 AM,48,-122,175,396,571
31233,FremontBridge,04/26/2016 09:00:00 AM,48,-122,106,162,268
31234,FremontBridge,04/26/2016 10:00:00 AM,48,-122,54,61,115
31235,FremontBridge,04/26/2016 11:00:00 AM,48,-122,42,41,83
31236,FremontBridge,04/26/2016 12:00:00 PM,48,-122,43,49,92
31237,FremontBridge,04/26/2016 01:00:00 PM,48,-122,35,37,72
31238,FremontBridge,04/26/2016 02:00:00 PM,48,-122,56,53,109
31239,FremontBridge,04/26/2016 03:00:00 PM,48,-122,83,75,158
31240,FremontBridge,04/26/2016 04:00:00 PM,48,-122,212,112,324
31241,FremontBridge,04/26/2016 05:00:00 PM,48,-122,508,195,703
31242,FremontBridge,04/26/2016 06:00:00 PM,48,-122,328,148,476
31243,FremontBridge,04/26/2016 07:00:00 PM,48,-122,141,86,227
31244,FremontBridge,04/26/2016 08:00:00 PM,48,-122,70,49,119
31245,FremontBridge,04/26/2016 09:00:00 PM,48,-122,32,24,56
31246,FremontBridge,04/26/2016 10:00:00 PM,48,-122,26,23,49
31247,FremontBridge,04/26/2016 11:00:00 PM,48,-122,10,8,18
31248,FremontBridge,04/27/2016 12:00:00 AM,48,-122,6,4,10
31249,FremontBridge,04/27/2016 01:00:00 AM,48,-122,1,2,3
31250,FremontBridge,04/27/2016 02:00:00 AM,48,-122,1,3,4
31251,FremontBridge,04/27/2016 03:00:00 AM,48,-122,0,1,1
31252,FremontBridge,04/27/2016 04:00:00 AM,48,-122,2,8,10
31253,FremontBridge,04/27/2016 05:00:00 AM,48,-122,12,25,37
31254,FremontBridge,04/27/2016 06:00:00 AM,48,-122,56,112,168
31255,FremontBridge,04/27/2016 07:00:00 AM,48,-122,114,278,392
31256,FremontBridge,04/27/2016 08:00:00 AM,48,-122,186,351,537
31257,FremontBridge,04/27/2016 09:00:00 AM,48,-122,98,158,256
31258,FremontBridge,04/27/2016 10:00:00 AM,48,-122,33,77,110
31259,FremontBridge,04/27/2016 11:00:00 AM,48,-122,39,43,82
31260,FremontBridge,04/27/2016 12:00:00 PM,48,-122,39,31,70
31261,FremontBridge,04/27/2016 01:00:00 PM,48,-122,41,40,81
31262,FremontBridge,04/27/2016 02:00:00 PM,48,-122,56,43,99
31263,FremontBridge,04/27/2016 03:00:00 PM,48,-122,66,61,127
31264,FremontBridge,04/27/2016 04:00:00 PM,48,-122,196,114,310
31265,FremontBridge,04/27/2016 05:00:00 PM,48,-122,406,193,599
31266,FremontBridge,04/27/2016 06:00:00 PM,48,-122,291,175,466
31267,FremontBridge,04/27/2016 07:00:00 PM,48,-122,119,74,193
31268,FremontBridge,04/27/2016 08:00:00 PM,48,-122,63,46,109
31269,FremontBridge,04/27/2016 09:00:00 PM,48,-122,43,28,71
31270,FremontBridge,04/27/2016 10:00:00 PM,48,-122,20,19,39
31271,FremontBridge,04/27/2016 11:00:00 PM,48,-122,6,13,19
31272,FremontBridge,04/28/2016 12:00:00 AM,48,-122,3,13,16
31273,FremontBridge,04/28/2016 01:00:00 AM,48,-122,1,3,4
31274,FremontBridge,04/28/2016 02:00:00 AM,48,-122,3,1,4
31275,FremontBridge,04/28/2016 03:00:00 AM,48,-122,0,2,2
31276,FremontBridge,04/28/2016 04:00:00 AM,48,-122,4,4,8
31277,FremontBridge,04/28/2016 05:00:00 AM,48,-122,12,21,33
31278,FremontBridge,04/28/2016 06:00:00 AM,48,-122,53,106,159
31279,FremontBridge,04/28/2016 07:00:00 AM,48,-122,113,291,404
31280,FremontBridge,04/28/2016 08:00:00 AM,48,-122,161,365,526
31281,FremontBridge,04/28/2016 09:00:00 AM,48,-122,107,154,261
31282,FremontBridge,04/28/2016 10:00:00 AM,48,-122,49,80,129
31283,FremontBridge,04/28/2016 11:00:00 AM,48,-122,48,34,82
31284,FremontBridge,04/28/2016 12:00:00 PM,48,-122,48,33,81
31285,FremontBridge,04/28/2016 01:00:00 PM,48,-122,39,45,84
31286,FremontBridge,04/28/2016 02:00:00 PM,48,-122,66,43,109
31287,FremontBridge,04/28/2016 03:00:00 PM,48,-122,83,62,145
31288,FremontBridge,04/28/2016 04:00:00 PM,48,-122,220,118,338
31289,FremontBridge,04/28/2016 05:00:00 PM,48,-122,464,173,637
31290,FremontBridge,04/28/2016 06:00:00 PM,48,-122,283,143,426
31291,FremontBridge,04/28/2016 07:00:00 PM,48,-122,139,65,204
31292,FremontBridge,04/28/2016 08:00:00 PM,48,-122,60,35,95
31293,FremontBridge,04/28/2016 09:00:00 PM,48,-122,33,28,61
31294,FremontBridge,04/28/2016 10:00:00 PM,48,-122,18,15,33
31295,FremontBridge,04/28/2016 11:00:00 PM,48,-122,14,15,29
31296,FremontBridge,04/29/2016 12:00:00 AM,48,-122,11,5,16
31297,FremontBridge,04/29/2016 01:00:00 AM,48,-122,1,4,5
31298,FremontBridge,04/29/2016 02:00:00 AM,48,-122,1,1,2
31299,FremontBridge,04/29/2016 03:00:00 AM,48,-122,3,0,3
31300,FremontBridge,04/29/2016 04:00:00 AM,48,-122,4,4,8
31301,FremontBridge,04/29/2016 05:00:00 AM,48,-122,12,21,33
31302,FremontBridge,04/29/2016 06:00:00 AM,48,-122,35,89,124
31303,FremontBridge,04/29/2016 07:00:00 AM,48,-122,82,225,307
31304,FremontBridge,04/29/2016 08:00:00 AM,48,-122,124,246,370
31305,FremontBridge,04/29/2016 09:00:00 AM,48,-122,81,128,209
31306,FremontBridge,04/29/2016 10:00:00 AM,48,-122,42,40,82
31307,FremontBridge,04/29/2016 11:00:00 AM,48,-122,26,33,59
31308,FremontBridge,04/29/2016 12:00:00 PM,48,-122,22,28,50
31309,FremontBridge,04/29/2016 01:00:00 PM,48,-122,38,22,60
31310,FremontBridge,04/29/2016 02:00:00 PM,48,-122,36,38,74
31311,FremontBridge,04/29/2016 03:00:00 PM,48,-122,85,76,161
31312,FremontBridge,04/29/2016 04:00:00 PM,48,-122,179,89,268
31313,FremontBridge,04/29/2016 05:00:00 PM,48,-122,349,144,493
31314,FremontBridge,04/29/2016 06:00:00 PM,48,-122,185,91,276
31315,FremontBridge,04/29/2016 07:00:00 PM,48,-122,86,59,145
31316,FremontBridge,04/29/2016 08:00:00 PM,48,-122,39,38,77
31317,FremontBridge,04/29/2016 09:00:00 PM,48,-122,25,26,51
31318,FremontBridge,04/29/2016 10:00:00 PM,48,-122,31,12,43
31319,FremontBridge,04/29/2016 11:00:00 PM,48,-122,17,8,25
31320,FremontBridge,04/30/2016 12:00:00 AM,48,-122,7,6,13
31321,FremontBridge,04/30/2016 01:00:00 AM,48,-122,4,4,8
31322,FremontBridge,04/30/2016 02:00:00 AM,48,-122,4,4,8
31323,FremontBridge,04/30/2016 03:00:00 AM,48,-122,2,1,3
31324,FremontBridge,04/30/2016 04:00:00 AM,48,-122,2,0,2
31325,FremontBridge,04/30/2016 05:00:00 AM,48,-122,4,8,12
31326,FremontBridge,04/30/2016 06:00:00 AM,48,-122,9,7,16
31327,FremontBridge,04/30/2016 07:00:00 AM,48,-122,32,24,56
31328,FremontBridge,04/30/2016 08:00:00 AM,48,-122,51,42,93
31329,FremontBridge,04/30/2016 09:00:00 AM,48,-122,57,61,118
31330,FremontBridge,04/30/2016 10:00:00 AM,48,-122,53,86,139
31331,FremontBridge,04/30/2016 11:00:00 AM,48,-122,83,108,191
31332,FremontBridge,04/30/2016 12:00:00 PM,48,-122,77,117,194
31333,FremontBridge,04/30/2016 01:00:00 PM,48,-122,80,88,168
31334,FremontBridge,04/30/2016 02:00:00 PM,48,-122,98,102,200
31335,FremontBridge,04/30/2016 03:00:00 PM,48,-122,113,105,218
31336,FremontBridge,04/30/2016 04:00:00 PM,48,-122,96,112,208
31337,FremontBridge,04/30/2016 05:00:00 PM,48,-122,106,98,204
31338,FremontBridge,04/30/2016 06:00:00 PM,48,-122,67,77,144
31339,FremontBridge,04/30/2016 07:00:00 PM,48,-122,51,51,102
31340,FremontBridge,04/30/2016 08:00:00 PM,48,-122,27,27,54
31341,FremontBridge,04/30/2016 09:00:00 PM,48,-122,16,27,43
31342,FremontBridge,04/30/2016 10:00:00 PM,48,-122,12,12,24
31343,FremontBridge,04/30/2016 11:00:00 PM,48,-122,17,10,27
31344,FremontBridge,05/01/2016 12:00:00 AM,48,-122,11,8,19
31345,FremontBridge,05/01/2016 01:00:00 AM,48,-122,4,12,16
31346,FremontBridge,05/01/2016 02:00:00 AM,48,-122,2,3,5
31347,FremontBridge,05/01/2016 03:00:00 AM,48,-122,6,0,6
31348,FremontBridge,05/01/2016 04:00:00 AM,48,-122,1,1,2
31349,FremontBridge,05/01/2016 05:00:00 AM,48,-122,2,6,8
31350,FremontBridge,05/01/2016 06:00:00 AM,48,-122,7,9,16
31351,FremontBridge,05/01/2016 07:00:00 AM,48,-122,16,24,40
31352,FremontBridge,05/01/2016 08:00:00 AM,48,-122,38,47,85
31353,FremontBridge,05/01/2016 09:00:00 AM,48,-122,50,62,112
31354,FremontBridge,05/01/2016 10:00:00 AM,48,-122,82,125,207
31355,FremontBridge,05/01/2016 11:00:00 AM,48,-122,99,95,194
31356,FremontBridge,05/01/2016 12:00:00 PM,48,-122,94,132,226
31357,FremontBridge,05/01/2016 01:00:00 PM,48,-122,133,125,258
31358,FremontBridge,05/01/2016 02:00:00 PM,48,-122,138,111,249
31359,FremontBridge,05/01/2016 03:00:00 PM,48,-122,101,128,229
31360,FremontBridge,05/01/2016 04:00:00 PM,48,-122,108,135,243
31361,FremontBridge,05/01/2016 05:00:00 PM,48,-122,89,96,185
31362,FremontBridge,05/01/2016 06:00:00 PM,48,-122,68,65,133
31363,FremontBridge,05/01/2016 07:00:00 PM,48,-122,43,53,96
31364,FremontBridge,05/01/2016 08:00:00 PM,48,-122,27,40,67
31365,FremontBridge,05/01/2016 09:00:00 PM,48,-122,18,21,39
31366,FremontBridge,05/01/2016 10:00:00 PM,48,-122,18,20,38
31367,FremontBridge,05/01/2016 11:00:00 PM,48,-122,10,5,15
31368,FremontBridge,05/02/2016 12:00:00 AM,48,-122,8,5,13
31369,FremontBridge,05/02/2016 01:00:00 AM,48,-122,6,0,6
31370,FremontBridge,05/02/2016 02:00:00 AM,48,-122,4,2,6
31371,FremontBridge,05/02/2016 03:00:00 AM,48,-122,1,2,3
31372,FremontBridge,05/02/2016 04:00:00 AM,48,-122,4,7,11
31373,FremontBridge,05/02/2016 05:00:00 AM,48,-122,21,38,59
31374,FremontBridge,05/02/2016 06:00:00 AM,48,-122,62,165,227
31375,FremontBridge,05/02/2016 07:00:00 AM,48,-122,161,461,622
31376,FremontBridge,05/02/2016 08:00:00 AM,48,-122,259,560,819
31377,FremontBridge,05/02/2016 09:00:00 AM,48,-122,145,232,377
31378,FremontBridge,05/02/2016 10:00:00 AM,48,-122,67,79,146
31379,FremontBridge,05/02/2016 11:00:00 AM,48,-122,62,50,112
31380,FremontBridge,05/02/2016 12:00:00 PM,48,-122,48,54,102
31381,FremontBridge,05/02/2016 01:00:00 PM,48,-122,79,53,132
31382,FremontBridge,05/02/2016 02:00:00 PM,48,-122,71,64,135
31383,FremontBridge,05/02/2016 03:00:00 PM,48,-122,120,103,223
31384,FremontBridge,05/02/2016 04:00:00 PM,48,-122,311,159,470
31385,FremontBridge,05/02/2016 05:00:00 PM,48,-122,691,261,952
31386,FremontBridge,05/02/2016 06:00:00 PM,48,-122,406,203,609
31387,FremontBridge,05/02/2016 07:00:00 PM,48,-122,172,120,292
31388,FremontBridge,05/02/2016 08:00:00 PM,48,-122,86,84,170
31389,FremontBridge,05/02/2016 09:00:00 PM,48,-122,42,35,77
31390,FremontBridge,05/02/2016 10:00:00 PM,48,-122,36,23,59
31391,FremontBridge,05/02/2016 11:00:00 PM,48,-122,16,18,34
31392,FremontBridge,05/03/2016 12:00:00 AM,48,-122,15,2,17
31393,FremontBridge,05/03/2016 01:00:00 AM,48,-122,2,4,6
31394,FremontBridge,05/03/2016 02:00:00 AM,48,-122,2,0,2
31395,FremontBridge,05/03/2016 03:00:00 AM,48,-122,2,2,4
31396,FremontBridge,05/03/2016 04:00:00 AM,48,-122,6,6,12
31397,FremontBridge,05/03/2016 05:00:00 AM,48,-122,13,50,63
31398,FremontBridge,05/03/2016 06:00:00 AM,48,-122,81,173,254
31399,FremontBridge,05/03/2016 07:00:00 AM,48,-122,153,453,606
31400,FremontBridge,05/03/2016 08:00:00 AM,48,-122,210,521,731
31401,FremontBridge,05/03/2016 09:00:00 AM,48,-122,139,186,325
31402,FremontBridge,05/03/2016 10:00:00 AM,48,-122,73,94,167
31403,FremontBridge,05/03/2016 11:00:00 AM,48,-122,36,50,86
31404,FremontBridge,05/03/2016 12:00:00 PM,48,-122,72,56,128
31405,FremontBridge,05/03/2016 01:00:00 PM,48,-122,44,61,105
31406,FremontBridge,05/03/2016 02:00:00 PM,48,-122,75,57,132
31407,FremontBridge,05/03/2016 03:00:00 PM,48,-122,114,90,204
31408,FremontBridge,05/03/2016 04:00:00 PM,48,-122,277,142,419
31409,FremontBridge,05/03/2016 05:00:00 PM,48,-122,666,255,921
31410,FremontBridge,05/03/2016 06:00:00 PM,48,-122,401,191,592
31411,FremontBridge,05/03/2016 07:00:00 PM,48,-122,193,95,288
31412,FremontBridge,05/03/2016 08:00:00 PM,48,-122,66,50,116
31413,FremontBridge,05/03/2016 09:00:00 PM,48,-122,41,32,73
31414,FremontBridge,05/03/2016 10:00:00 PM,48,-122,26,16,42
31415,FremontBridge,05/03/2016 11:00:00 PM,48,-122,7,13,20
31416,FremontBridge,05/04/2016 12:00:00 AM,48,-122,14,6,20
31417,FremontBridge,05/04/2016 01:00:00 AM,48,-122,4,3,7
31418,FremontBridge,05/04/2016 02:00:00 AM,48,-122,2,2,4
31419,FremontBridge,05/04/2016 03:00:00 AM,48,-122,1,2,3
31420,FremontBridge,05/04/2016 04:00:00 AM,48,-122,6,4,10
31421,FremontBridge,05/04/2016 05:00:00 AM,48,-122,20,45,65
31422,FremontBridge,05/04/2016 06:00:00 AM,48,-122,58,150,208
31423,FremontBridge,05/04/2016 07:00:00 AM,48,-122,119,323,442
31424,FremontBridge,05/04/2016 08:00:00 AM,48,-122,161,391,552
31425,FremontBridge,05/04/2016 09:00:00 AM,48,-122,113,182,295
31426,FremontBridge,05/04/2016 10:00:00 AM,48,-122,43,70,113
31427,FremontBridge,05/04/2016 11:00:00 AM,48,-122,26,37,63
31428,FremontBridge,05/04/2016 12:00:00 PM,48,-122,25,39,64
31429,FremontBridge,05/04/2016 01:00:00 PM,48,-122,40,43,83
31430,FremontBridge,05/04/2016 02:00:00 PM,48,-122,41,48,89
31431,FremontBridge,05/04/2016 03:00:00 PM,48,-122,79,55,134
31432,FremontBridge,05/04/2016 04:00:00 PM,48,-122,212,98,310
31433,FremontBridge,05/04/2016 05:00:00 PM,48,-122,517,201,718
31434,FremontBridge,05/04/2016 06:00:00 PM,48,-122,307,137,444
31435,FremontBridge,05/04/2016 07:00:00 PM,48,-122,139,91,230
31436,FremontBridge,05/04/2016 08:00:00 PM,48,-122,73,46,119
31437,FremontBridge,05/04/2016 09:00:00 PM,48,-122,28,29,57
31438,FremontBridge,05/04/2016 10:00:00 PM,48,-122,22,16,38
31439,FremontBridge,05/04/2016 11:00:00 PM,48,-122,16,5,21
31440,FremontBridge,05/05/2016 12:00:00 AM,48,-122,3,7,10
31441,FremontBridge,05/05/2016 01:00:00 AM,48,-122,0,0,0
31442,FremontBridge,05/05/2016 02:00:00 AM,48,-122,3,0,3
31443,FremontBridge,05/05/2016 03:00:00 AM,48,-122,1,4,5
31444,FremontBridge,05/05/2016 04:00:00 AM,48,-122,1,9,10
31445,FremontBridge,05/05/2016 05:00:00 AM,48,-122,13,33,46
31446,FremontBridge,05/05/2016 06:00:00 AM,48,-122,62,146,208
31447,FremontBridge,05/05/2016 07:00:00 AM,48,-122,164,388,552
31448,FremontBridge,05/05/2016 08:00:00 AM,48,-122,221,458,679
31449,FremontBridge,05/05/2016 09:00:00 AM,48,-122,134,213,347
31450,FremontBridge,05/05/2016 10:00:00 AM,48,-122,71,91,162
31451,FremontBridge,05/05/2016 11:00:00 AM,48,-122,39,58,97
31452,FremontBridge,05/05/2016 12:00:00 PM,48,-122,42,60,102
31453,FremontBridge,05/05/2016 01:00:00 PM,48,-122,52,57,109
31454,FremontBridge,05/05/2016 02:00:00 PM,48,-122,57,46,103
31455,FremontBridge,05/05/2016 03:00:00 PM,48,-122,100,89,189
31456,FremontBridge,05/05/2016 04:00:00 PM,48,-122,261,142,403
31457,FremontBridge,05/05/2016 05:00:00 PM,48,-122,556,223,779
31458,FremontBridge,05/05/2016 06:00:00 PM,48,-122,359,166,525
31459,FremontBridge,05/05/2016 07:00:00 PM,48,-122,163,102,265
31460,FremontBridge,05/05/2016 08:00:00 PM,48,-122,92,74,166
31461,FremontBridge,05/05/2016 09:00:00 PM,48,-122,71,40,111
31462,FremontBridge,05/05/2016 10:00:00 PM,48,-122,36,19,55
31463,FremontBridge,05/05/2016 11:00:00 PM,48,-122,22,10,32
31464,FremontBridge,05/06/2016 12:00:00 AM,48,-122,9,12,21
31465,FremontBridge,05/06/2016 01:00:00 AM,48,-122,3,6,9
31466,FremontBridge,05/06/2016 02:00:00 AM,48,-122,2,2,4
31467,FremontBridge,05/06/2016 03:00:00 AM,48,-122,1,0,1
31468,FremontBridge,05/06/2016 04:00:00 AM,48,-122,7,6,13
31469,FremontBridge,05/06/2016 05:00:00 AM,48,-122,15,38,53
31470,FremontBridge,05/06/2016 06:00:00 AM,48,-122,67,125,192
31471,FremontBridge,05/06/2016 07:00:00 AM,48,-122,143,390,533
31472,FremontBridge,05/06/2016 08:00:00 AM,48,-122,171,421,592
31473,FremontBridge,05/06/2016 09:00:00 AM,48,-122,117,198,315
31474,FremontBridge,05/06/2016 10:00:00 AM,48,-122,54,77,131
31475,FremontBridge,05/06/2016 11:00:00 AM,48,-122,40,75,115
31476,FremontBridge,05/06/2016 12:00:00 PM,48,-122,71,60,131
31477,FremontBridge,05/06/2016 01:00:00 PM,48,-122,49,75,124
31478,FremontBridge,05/06/2016 02:00:00 PM,48,-122,90,70,160
31479,FremontBridge,05/06/2016 03:00:00 PM,48,-122,121,103,224
31480,FremontBridge,05/06/2016 04:00:00 PM,48,-122,330,149,479
31481,FremontBridge,05/06/2016 05:00:00 PM,48,-122,472,208,680
31482,FremontBridge,05/06/2016 06:00:00 PM,48,-122,256,158,414
31483,FremontBridge,05/06/2016 07:00:00 PM,48,-122,120,106,226
31484,FremontBridge,05/06/2016 08:00:00 PM,48,-122,63,55,118
31485,FremontBridge,05/06/2016 09:00:00 PM,48,-122,36,36,72
31486,FremontBridge,05/06/2016 10:00:00 PM,48,-122,44,24,68
31487,FremontBridge,05/06/2016 11:00:00 PM,48,-122,31,11,42
31488,FremontBridge,05/07/2016 12:00:00 AM,48,-122,17,9,26
31489,FremontBridge,05/07/2016 01:00:00 AM,48,-122,8,8,16
31490,FremontBridge,05/07/2016 02:00:00 AM,48,-122,7,5,12
31491,FremontBridge,05/07/2016 03:00:00 AM,48,-122,1,0,1
31492,FremontBridge,05/07/2016 04:00:00 AM,48,-122,3,1,4
31493,FremontBridge,05/07/2016 05:00:00 AM,48,-122,6,7,13
31494,FremontBridge,05/07/2016 06:00:00 AM,48,-122,16,15,31
31495,FremontBridge,05/07/2016 07:00:00 AM,48,-122,34,44,78
31496,FremontBridge,05/07/2016 08:00:00 AM,48,-122,59,50,109
31497,FremontBridge,05/07/2016 09:00:00 AM,48,-122,69,97,166
31498,FremontBridge,05/07/2016 10:00:00 AM,48,-122,79,113,192
31499,FremontBridge,05/07/2016 11:00:00 AM,48,-122,88,120,208
31500,FremontBridge,05/07/2016 12:00:00 PM,48,-122,138,180,318
31501,FremontBridge,05/07/2016 01:00:00 PM,48,-122,90,151,241
31502,FremontBridge,05/07/2016 02:00:00 PM,48,-122,97,154,251
31503,FremontBridge,05/07/2016 03:00:00 PM,48,-122,94,125,219
31504,FremontBridge,05/07/2016 04:00:00 PM,48,-122,76,107,183
31505,FremontBridge,05/07/2016 05:00:00 PM,48,-122,78,94,172
31506,FremontBridge,05/07/2016 06:00:00 PM,48,-122,88,86,174
31507,FremontBridge,05/07/2016 07:00:00 PM,48,-122,64,51,115
31508,FremontBridge,05/07/2016 08:00:00 PM,48,-122,27,43,70
31509,FremontBridge,05/07/2016 09:00:00 PM,48,-122,50,42,92
31510,FremontBridge,05/07/2016 10:00:00 PM,48,-122,24,25,49
31511,FremontBridge,05/07/2016 11:00:00 PM,48,-122,21,9,30
31512,FremontBridge,05/08/2016 12:00:00 AM,48,-122,8,9,17
31513,FremontBridge,05/08/2016 01:00:00 AM,48,-122,11,1,12
31514,FremontBridge,05/08/2016 02:00:00 AM,48,-122,8,5,13
31515,FremontBridge,05/08/2016 03:00:00 AM,48,-122,0,1,1
31516,FremontBridge,05/08/2016 04:00:00 AM,48,-122,0,2,2
31517,FremontBridge,05/08/2016 05:00:00 AM,48,-122,4,5,9
31518,FremontBridge,05/08/2016 06:00:00 AM,48,-122,3,2,5
31519,FremontBridge,05/08/2016 07:00:00 AM,48,-122,8,8,16
31520,FremontBridge,05/08/2016 08:00:00 AM,48,-122,7,16,23
31521,FremontBridge,05/08/2016 09:00:00 AM,48,-122,26,25,51
31522,FremontBridge,05/08/2016 10:00:00 AM,48,-122,18,34,52
31523,FremontBridge,05/08/2016 11:00:00 AM,48,-122,44,48,92
31524,FremontBridge,05/08/2016 12:00:00 PM,48,-122,35,66,101
31525,FremontBridge,05/08/2016 01:00:00 PM,48,-122,43,58,101
31526,FremontBridge,05/08/2016 02:00:00 PM,48,-122,53,56,109
31527,FremontBridge,05/08/2016 03:00:00 PM,48,-122,38,59,97
31528,FremontBridge,05/08/2016 04:00:00 PM,48,-122,64,69,133
31529,FremontBridge,05/08/2016 05:00:00 PM,48,-122,55,74,129
31530,FremontBridge,05/08/2016 06:00:00 PM,48,-122,42,39,81
31531,FremontBridge,05/08/2016 07:00:00 PM,48,-122,30,22,52
31532,FremontBridge,05/08/2016 08:00:00 PM,48,-122,8,27,35
31533,FremontBridge,05/08/2016 09:00:00 PM,48,-122,13,13,26
31534,FremontBridge,05/08/2016 10:00:00 PM,48,-122,12,6,18
31535,FremontBridge,05/08/2016 11:00:00 PM,48,-122,0,3,3
31536,FremontBridge,05/09/2016 12:00:00 AM,48,-122,3,3,6
31537,FremontBridge,05/09/2016 01:00:00 AM,48,-122,1,2,3
31538,FremontBridge,05/09/2016 02:00:00 AM,48,-122,7,0,7
31539,FremontBridge,05/09/2016 03:00:00 AM,48,-122,2,2,4
31540,FremontBridge,05/09/2016 04:00:00 AM,48,-122,2,4,6
31541,FremontBridge,05/09/2016 05:00:00 AM,48,-122,20,33,53
31542,FremontBridge,05/09/2016 06:00:00 AM,48,-122,65,125,190
31543,FremontBridge,05/09/2016 07:00:00 AM,48,-122,142,392,534
31544,FremontBridge,05/09/2016 08:00:00 AM,48,-122,211,458,669
31545,FremontBridge,05/09/2016 09:00:00 AM,48,-122,122,208,330
31546,FremontBridge,05/09/2016 10:00:00 AM,48,-122,34,67,101
31547,FremontBridge,05/09/2016 11:00:00 AM,48,-122,35,47,82
31548,FremontBridge,05/09/2016 12:00:00 PM,48,-122,46,52,98
31549,FremontBridge,05/09/2016 01:00:00 PM,48,-122,47,56,103
31550,FremontBridge,05/09/2016 02:00:00 PM,48,-122,54,63,117
31551,FremontBridge,05/09/2016 03:00:00 PM,48,-122,99,97,196
31552,FremontBridge,05/09/2016 04:00:00 PM,48,-122,245,124,369
31553,FremontBridge,05/09/2016 05:00:00 PM,48,-122,629,235,864
31554,FremontBridge,05/09/2016 06:00:00 PM,48,-122,382,178,560
31555,FremontBridge,05/09/2016 07:00:00 PM,48,-122,152,106,258
31556,FremontBridge,05/09/2016 08:00:00 PM,48,-122,101,57,158
31557,FremontBridge,05/09/2016 09:00:00 PM,48,-122,43,24,67
31558,FremontBridge,05/09/2016 10:00:00 PM,48,-122,20,24,44
31559,FremontBridge,05/09/2016 11:00:00 PM,48,-122,23,10,33
31560,FremontBridge,05/10/2016 12:00:00 AM,48,-122,7,4,11
31561,FremontBridge,05/10/2016 01:00:00 AM,48,-122,4,3,7
31562,FremontBridge,05/10/2016 02:00:00 AM,48,-122,2,3,5
31563,FremontBridge,05/10/2016 03:00:00 AM,48,-122,3,2,5
31564,FremontBridge,05/10/2016 04:00:00 AM,48,-122,5,7,12
31565,FremontBridge,05/10/2016 05:00:00 AM,48,-122,17,42,59
31566,FremontBridge,05/10/2016 06:00:00 AM,48,-122,75,184,259
31567,FremontBridge,05/10/2016 07:00:00 AM,48,-122,164,465,629
31568,FremontBridge,05/10/2016 08:00:00 AM,48,-122,233,533,766
31569,FremontBridge,05/10/2016 09:00:00 AM,48,-122,131,207,338
31570,FremontBridge,05/10/2016 10:00:00 AM,48,-122,57,73,130
31571,FremontBridge,05/10/2016 11:00:00 AM,48,-122,34,49,83
31572,FremontBridge,05/10/2016 12:00:00 PM,48,-122,55,55,110
31573,FremontBridge,05/10/2016 01:00:00 PM,48,-122,67,65,132
31574,FremontBridge,05/10/2016 02:00:00 PM,48,-122,55,63,118
31575,FremontBridge,05/10/2016 03:00:00 PM,48,-122,122,96,218
31576,FremontBridge,05/10/2016 04:00:00 PM,48,-122,286,144,430
31577,FremontBridge,05/10/2016 05:00:00 PM,48,-122,717,240,957
31578,FremontBridge,05/10/2016 06:00:00 PM,48,-122,362,235,597
31579,FremontBridge,05/10/2016 07:00:00 PM,48,-122,180,143,323
31580,FremontBridge,05/10/2016 08:00:00 PM,48,-122,99,90,189
31581,FremontBridge,05/10/2016 09:00:00 PM,48,-122,47,39,86
31582,FremontBridge,05/10/2016 10:00:00 PM,48,-122,34,21,55
31583,FremontBridge,05/10/2016 11:00:00 PM,48,-122,12,18,30
31584,FremontBridge,05/11/2016 12:00:00 AM,48,-122,11,10,21
31585,FremontBridge,05/11/2016 01:00:00 AM,48,-122,1,5,6
31586,FremontBridge,05/11/2016 02:00:00 AM,48,-122,4,1,5
31587,FremontBridge,05/11/2016 03:00:00 AM,48,-122,1,3,4
31588,FremontBridge,05/11/2016 04:00:00 AM,48,-122,3,9,12
31589,FremontBridge,05/11/2016 05:00:00 AM,48,-122,15,30,45
31590,FremontBridge,05/11/2016 06:00:00 AM,48,-122,74,170,244
31591,FremontBridge,05/11/2016 07:00:00 AM,48,-122,165,435,600
31592,FremontBridge,05/11/2016 08:00:00 AM,48,-122,251,490,741
31593,FremontBridge,05/11/2016 09:00:00 AM,48,-122,128,213,341
31594,FremontBridge,05/11/2016 10:00:00 AM,48,-122,61,104,165
31595,FremontBridge,05/11/2016 11:00:00 AM,48,-122,49,52,101
31596,FremontBridge,05/11/2016 12:00:00 PM,48,-122,62,58,120
31597,FremontBridge,05/11/2016 01:00:00 PM,48,-122,75,59,134
31598,FremontBridge,05/11/2016 02:00:00 PM,48,-122,75,67,142
31599,FremontBridge,05/11/2016 03:00:00 PM,48,-122,128,100,228
31600,FremontBridge,05/11/2016 04:00:00 PM,48,-122,282,139,421
31601,FremontBridge,05/11/2016 05:00:00 PM,48,-122,617,256,873
31602,FremontBridge,05/11/2016 06:00:00 PM,48,-122,365,228,593
31603,FremontBridge,05/11/2016 07:00:00 PM,48,-122,199,108,307
31604,FremontBridge,05/11/2016 08:00:00 PM,48,-122,101,82,183
31605,FremontBridge,05/11/2016 09:00:00 PM,48,-122,52,51,103
31606,FremontBridge,05/11/2016 10:00:00 PM,48,-122,39,30,69
31607,FremontBridge,05/11/2016 11:00:00 PM,48,-122,19,17,36
31608,FremontBridge,05/12/2016 12:00:00 AM,48,-122,9,5,14
31609,FremontBridge,05/12/2016 01:00:00 AM,48,-122,2,2,4
31610,FremontBridge,05/12/2016 02:00:00 AM,48,-122,2,0,2
31611,FremontBridge,05/12/2016 03:00:00 AM,48,-122,1,0,1
31612,FremontBridge,05/12/2016 04:00:00 AM,48,-122,2,8,10
31613,FremontBridge,05/12/2016 05:00:00 AM,48,-122,14,36,50
31614,FremontBridge,05/12/2016 06:00:00 AM,48,-122,77,150,227
31615,FremontBridge,05/12/2016 07:00:00 AM,48,-122,163,402,565
31616,FremontBridge,05/12/2016 08:00:00 AM,48,-122,212,462,674
31617,FremontBridge,05/12/2016 09:00:00 AM,48,-122,132,195,327
31618,FremontBridge,05/12/2016 10:00:00 AM,48,-122,52,82,134
31619,FremontBridge,05/12/2016 11:00:00 AM,48,-122,47,60,107
31620,FremontBridge,05/12/2016 12:00:00 PM,48,-122,50,56,106
31621,FremontBridge,05/12/2016 01:00:00 PM,48,-122,64,59,123
31622,FremontBridge,05/12/2016 02:00:00 PM,48,-122,85,62,147
31623,FremontBridge,05/12/2016 03:00:00 PM,48,-122,108,86,194
31624,FremontBridge,05/12/2016 04:00:00 PM,48,-122,284,140,424
31625,FremontBridge,05/12/2016 05:00:00 PM,48,-122,589,210,799
31626,FremontBridge,05/12/2016 06:00:00 PM,48,-122,345,190,535
31627,FremontBridge,05/12/2016 07:00:00 PM,48,-122,177,148,325
31628,FremontBridge,05/12/2016 08:00:00 PM,48,-122,109,72,181
31629,FremontBridge,05/12/2016 09:00:00 PM,48,-122,54,51,105
31630,FremontBridge,05/12/2016 10:00:00 PM,48,-122,38,32,70
31631,FremontBridge,05/12/2016 11:00:00 PM,48,-122,19,16,35
31632,FremontBridge,05/13/2016 12:00:00 AM,48,-122,18,4,22
31633,FremontBridge,05/13/2016 01:00:00 AM,48,-122,4,8,12
31634,FremontBridge,05/13/2016 02:00:00 AM,48,-122,10,1,11
31635,FremontBridge,05/13/2016 03:00:00 AM,48,-122,2,2,4
31636,FremontBridge,05/13/2016 04:00:00 AM,48,-122,5,4,9
31637,FremontBridge,05/13/2016 05:00:00 AM,48,-122,18,28,46
31638,FremontBridge,05/13/2016 06:00:00 AM,48,-122,60,134,194
31639,FremontBridge,05/13/2016 07:00:00 AM,48,-122,152,354,506
31640,FremontBridge,05/13/2016 08:00:00 AM,48,-122,185,433,618
31641,FremontBridge,05/13/2016 09:00:00 AM,48,-122,155,207,362
31642,FremontBridge,05/13/2016 10:00:00 AM,48,-122,75,86,161
31643,FremontBridge,05/13/2016 11:00:00 AM,48,-122,52,69,121
31644,FremontBridge,05/13/2016 12:00:00 PM,48,-122,56,53,109
31645,FremontBridge,05/13/2016 01:00:00 PM,48,-122,76,65,141
31646,FremontBridge,05/13/2016 02:00:00 PM,48,-122,82,66,148
31647,FremontBridge,05/13/2016 03:00:00 PM,48,-122,171,108,279
31648,FremontBridge,05/13/2016 04:00:00 PM,48,-122,308,157,465
31649,FremontBridge,05/13/2016 05:00:00 PM,48,-122,556,223,779
31650,FremontBridge,05/13/2016 06:00:00 PM,48,-122,263,169,432
31651,FremontBridge,05/13/2016 07:00:00 PM,48,-122,127,86,213
31652,FremontBridge,05/13/2016 08:00:00 PM,48,-122,64,72,136
31653,FremontBridge,05/13/2016 09:00:00 PM,48,-122,30,40,70
31654,FremontBridge,05/13/2016 10:00:00 PM,48,-122,39,33,72
31655,FremontBridge,05/13/2016 11:00:00 PM,48,-122,32,23,55
31656,FremontBridge,05/14/2016 12:00:00 AM,48,-122,6,8,14
31657,FremontBridge,05/14/2016 01:00:00 AM,48,-122,15,6,21
31658,FremontBridge,05/14/2016 02:00:00 AM,48,-122,6,7,13
31659,FremontBridge,05/14/2016 03:00:00 AM,48,-122,3,0,3
31660,FremontBridge,05/14/2016 04:00:00 AM,48,-122,2,2,4
31661,FremontBridge,05/14/2016 05:00:00 AM,48,-122,5,13,18
31662,FremontBridge,05/14/2016 06:00:00 AM,48,-122,17,17,34
31663,FremontBridge,05/14/2016 07:00:00 AM,48,-122,30,25,55
31664,FremontBridge,05/14/2016 08:00:00 AM,48,-122,40,53,93
31665,FremontBridge,05/14/2016 09:00:00 AM,48,-122,48,84,132
31666,FremontBridge,05/14/2016 10:00:00 AM,48,-122,65,81,146
31667,FremontBridge,05/14/2016 11:00:00 AM,48,-122,66,67,133
31668,FremontBridge,05/14/2016 12:00:00 PM,48,-122,48,72,120
31669,FremontBridge,05/14/2016 01:00:00 PM,48,-122,32,54,86
31670,FremontBridge,05/14/2016 02:00:00 PM,48,-122,88,98,186
31671,FremontBridge,05/14/2016 03:00:00 PM,48,-122,96,75,171
31672,FremontBridge,05/14/2016 04:00:00 PM,48,-122,36,55,91
31673,FremontBridge,05/14/2016 05:00:00 PM,48,-122,30,28,58
31674,FremontBridge,05/14/2016 06:00:00 PM,48,-122,46,25,71
31675,FremontBridge,05/14/2016 07:00:00 PM,48,-122,16,31,47
31676,FremontBridge,05/14/2016 08:00:00 PM,48,-122,13,18,31
31677,FremontBridge,05/14/2016 09:00:00 PM,48,-122,19,8,27
31678,FremontBridge,05/14/2016 10:00:00 PM,48,-122,12,10,22
31679,FremontBridge,05/14/2016 11:00:00 PM,48,-122,8,13,21
31680,FremontBridge,05/15/2016 12:00:00 AM,48,-122,6,4,10
31681,FremontBridge,05/15/2016 01:00:00 AM,48,-122,2,3,5
31682,FremontBridge,05/15/2016 02:00:00 AM,48,-122,3,0,3
31683,FremontBridge,05/15/2016 03:00:00 AM,48,-122,1,2,3
31684,FremontBridge,05/15/2016 04:00:00 AM,48,-122,0,0,0
31685,FremontBridge,05/15/2016 05:00:00 AM,48,-122,1,3,4
31686,FremontBridge,05/15/2016 06:00:00 AM,48,-122,3,11,14
31687,FremontBridge,05/15/2016 07:00:00 AM,48,-122,19,15,34
31688,FremontBridge,05/15/2016 08:00:00 AM,48,-122,12,22,34
31689,FremontBridge,05/15/2016 09:00:00 AM,48,-122,37,34,71
31690,FremontBridge,05/15/2016 10:00:00 AM,48,-122,27,32,59
31691,FremontBridge,05/15/2016 11:00:00 AM,48,-122,32,46,78
31692,FremontBridge,05/15/2016 12:00:00 PM,48,-122,33,73,106
31693,FremontBridge,05/15/2016 01:00:00 PM,48,-122,47,53,100
31694,FremontBridge,05/15/2016 02:00:00 PM,48,-122,45,46,91
31695,FremontBridge,05/15/2016 03:00:00 PM,48,-122,51,38,89
31696,FremontBridge,05/15/2016 04:00:00 PM,48,-122,60,47,107
31697,FremontBridge,05/15/2016 05:00:00 PM,48,-122,36,40,76
31698,FremontBridge,05/15/2016 06:00:00 PM,48,-122,31,21,52
31699,FremontBridge,05/15/2016 07:00:00 PM,48,-122,18,17,35
31700,FremontBridge,05/15/2016 08:00:00 PM,48,-122,4,15,19
31701,FremontBridge,05/15/2016 09:00:00 PM,48,-122,9,8,17
31702,FremontBridge,05/15/2016 10:00:00 PM,48,-122,14,6,20
31703,FremontBridge,05/15/2016 11:00:00 PM,48,-122,7,6,13
31704,FremontBridge,05/16/2016 12:00:00 AM,48,-122,2,1,3
31705,FremontBridge,05/16/2016 01:00:00 AM,48,-122,0,2,2
31706,FremontBridge,05/16/2016 02:00:00 AM,48,-122,2,0,2
31707,FremontBridge,05/16/2016 03:00:00 AM,48,-122,1,2,3
31708,FremontBridge,05/16/2016 04:00:00 AM,48,-122,3,2,5
31709,FremontBridge,05/16/2016 05:00:00 AM,48,-122,15,28,43
31710,FremontBridge,05/16/2016 06:00:00 AM,48,-122,52,110,162
31711,FremontBridge,05/16/2016 07:00:00 AM,48,-122,130,304,434
31712,FremontBridge,05/16/2016 08:00:00 AM,48,-122,179,384,563
31713,FremontBridge,05/16/2016 09:00:00 AM,48,-122,99,162,261
31714,FremontBridge,05/16/2016 10:00:00 AM,48,-122,42,58,100
31715,FremontBridge,05/16/2016 11:00:00 AM,48,-122,38,33,71
31716,FremontBridge,05/16/2016 12:00:00 PM,48,-122,23,27,50
31717,FremontBridge,05/16/2016 01:00:00 PM,48,-122,31,25,56
31718,FremontBridge,05/16/2016 02:00:00 PM,48,-122,36,37,73
31719,FremontBridge,05/16/2016 03:00:00 PM,48,-122,84,63,147
31720,FremontBridge,05/16/2016 04:00:00 PM,48,-122,203,102,305
31721,FremontBridge,05/16/2016 05:00:00 PM,48,-122,518,160,678
31722,FremontBridge,05/16/2016 06:00:00 PM,48,-122,283,144,427
31723,FremontBridge,05/16/2016 07:00:00 PM,48,-122,145,59,204
31724,FremontBridge,05/16/2016 08:00:00 PM,48,-122,62,34,96
31725,FremontBridge,05/16/2016 09:00:00 PM,48,-122,44,30,74
31726,FremontBridge,05/16/2016 10:00:00 PM,48,-122,13,17,30
31727,FremontBridge,05/16/2016 11:00:00 PM,48,-122,7,7,14
31728,FremontBridge,05/17/2016 12:00:00 AM,48,-122,5,5,10
31729,FremontBridge,05/17/2016 01:00:00 AM,48,-122,5,1,6
31730,FremontBridge,05/17/2016 02:00:00 AM,48,-122,1,1,2
31731,FremontBridge,05/17/2016 03:00:00 AM,48,-122,1,2,3
31732,FremontBridge,05/17/2016 04:00:00 AM,48,-122,4,4,8
31733,FremontBridge,05/17/2016 05:00:00 AM,48,-122,14,42,56
31734,FremontBridge,05/17/2016 06:00:00 AM,48,-122,72,144,216
31735,FremontBridge,05/17/2016 07:00:00 AM,48,-122,148,415,563
31736,FremontBridge,05/17/2016 08:00:00 AM,48,-122,237,462,699
31737,FremontBridge,05/17/2016 09:00:00 AM,48,-122,123,201,324
31738,FremontBridge,05/17/2016 10:00:00 AM,48,-122,68,79,147
31739,FremontBridge,05/17/2016 11:00:00 AM,48,-122,37,52,89
31740,FremontBridge,05/17/2016 12:00:00 PM,48,-122,60,35,95
31741,FremontBridge,05/17/2016 01:00:00 PM,48,-122,42,64,106
31742,FremontBridge,05/17/2016 02:00:00 PM,48,-122,82,52,134
31743,FremontBridge,05/17/2016 03:00:00 PM,48,-122,129,85,214
31744,FremontBridge,05/17/2016 04:00:00 PM,48,-122,291,135,426
31745,FremontBridge,05/17/2016 05:00:00 PM,48,-122,646,243,889
31746,FremontBridge,05/17/2016 06:00:00 PM,48,-122,374,184,558
31747,FremontBridge,05/17/2016 07:00:00 PM,48,-122,155,111,266
31748,FremontBridge,05/17/2016 08:00:00 PM,48,-122,86,67,153
31749,FremontBridge,05/17/2016 09:00:00 PM,48,-122,53,47,100
31750,FremontBridge,05/17/2016 10:00:00 PM,48,-122,32,31,63
31751,FremontBridge,05/17/2016 11:00:00 PM,48,-122,22,16,38
31752,FremontBridge,05/18/2016 12:00:00 AM,48,-122,7,8,15
31753,FremontBridge,05/18/2016 01:00:00 AM,48,-122,3,4,7
31754,FremontBridge,05/18/2016 02:00:00 AM,48,-122,3,1,4
31755,FremontBridge,05/18/2016 03:00:00 AM,48,-122,3,1,4
31756,FremontBridge,05/18/2016 04:00:00 AM,48,-122,6,4,10
31757,FremontBridge,05/18/2016 05:00:00 AM,48,-122,24,42,66
31758,FremontBridge,05/18/2016 06:00:00 AM,48,-122,67,160,227
31759,FremontBridge,05/18/2016 07:00:00 AM,48,-122,151,383,534
31760,FremontBridge,05/18/2016 08:00:00 AM,48,-122,193,437,630
31761,FremontBridge,05/18/2016 09:00:00 AM,48,-122,132,204,336
31762,FremontBridge,05/18/2016 10:00:00 AM,48,-122,57,66,123
31763,FremontBridge,05/18/2016 11:00:00 AM,48,-122,38,46,84
31764,FremontBridge,05/18/2016 12:00:00 PM,48,-122,36,49,85
31765,FremontBridge,05/18/2016 01:00:00 PM,48,-122,45,51,96
31766,FremontBridge,05/18/2016 02:00:00 PM,48,-122,72,44,116
31767,FremontBridge,05/18/2016 03:00:00 PM,48,-122,80,73,153
31768,FremontBridge,05/18/2016 04:00:00 PM,48,-122,248,110,358
31769,FremontBridge,05/18/2016 05:00:00 PM,48,-122,560,203,763
31770,FremontBridge,05/18/2016 06:00:00 PM,48,-122,286,180,466
31771,FremontBridge,05/18/2016 07:00:00 PM,48,-122,125,75,200
31772,FremontBridge,05/18/2016 08:00:00 PM,48,-122,90,51,141
31773,FremontBridge,05/18/2016 09:00:00 PM,48,-122,42,36,78
31774,FremontBridge,05/18/2016 10:00:00 PM,48,-122,17,24,41
31775,FremontBridge,05/18/2016 11:00:00 PM,48,-122,12,6,18
31776,FremontBridge,05/19/2016 12:00:00 AM,48,-122,8,2,10
31777,FremontBridge,05/19/2016 01:00:00 AM,48,-122,0,2,2
31778,FremontBridge,05/19/2016 02:00:00 AM,48,-122,1,2,3
31779,FremontBridge,05/19/2016 03:00:00 AM,48,-122,0,0,0
31780,FremontBridge,05/19/2016 04:00:00 AM,48,-122,3,4,7
31781,FremontBridge,05/19/2016 05:00:00 AM,48,-122,9,24,33
31782,FremontBridge,05/19/2016 06:00:00 AM,48,-122,51,106,157
31783,FremontBridge,05/19/2016 07:00:00 AM,48,-122,109,283,392
31784,FremontBridge,05/19/2016 08:00:00 AM,48,-122,126,320,446
31785,FremontBridge,05/19/2016 09:00:00 AM,48,-122,88,138,226
31786,FremontBridge,05/19/2016 10:00:00 AM,48,-122,32,44,76
31787,FremontBridge,05/19/2016 11:00:00 AM,48,-122,18,33,51
31788,FremontBridge,05/19/2016 12:00:00 PM,48,-122,39,30,69
31789,FremontBridge,05/19/2016 01:00:00 PM,48,-122,55,38,93
31790,FremontBridge,05/19/2016 02:00:00 PM,48,-122,56,31,87
31791,FremontBridge,05/19/2016 03:00:00 PM,48,-122,77,43,120
31792,FremontBridge,05/19/2016 04:00:00 PM,48,-122,163,88,251
31793,FremontBridge,05/19/2016 05:00:00 PM,48,-122,373,170,543
31794,FremontBridge,05/19/2016 06:00:00 PM,48,-122,259,109,368
31795,FremontBridge,05/19/2016 07:00:00 PM,48,-122,116,57,173
31796,FremontBridge,05/19/2016 08:00:00 PM,48,-122,43,27,70
31797,FremontBridge,05/19/2016 09:00:00 PM,48,-122,18,20,38
31798,FremontBridge,05/19/2016 10:00:00 PM,48,-122,18,12,30
31799,FremontBridge,05/19/2016 11:00:00 PM,48,-122,8,6,14
31800,FremontBridge,05/20/2016 12:00:00 AM,48,-122,6,3,9
31801,FremontBridge,05/20/2016 01:00:00 AM,48,-122,3,1,4
31802,FremontBridge,05/20/2016 02:00:00 AM,48,-122,5,1,6
31803,FremontBridge,05/20/2016 03:00:00 AM,48,-122,0,0,0
31804,FremontBridge,05/20/2016 04:00:00 AM,48,-122,4,3,7
31805,FremontBridge,05/20/2016 05:00:00 AM,48,-122,17,34,51
31806,FremontBridge,05/20/2016 06:00:00 AM,48,-122,63,169,232
31807,FremontBridge,05/20/2016 07:00:00 AM,48,-122,128,487,615
31808,FremontBridge,05/20/2016 08:00:00 AM,48,-122,195,504,699
31809,FremontBridge,05/20/2016 09:00:00 AM,48,-122,118,215,333
31810,FremontBridge,05/20/2016 10:00:00 AM,48,-122,57,72,129
31811,FremontBridge,05/20/2016 11:00:00 AM,48,-122,36,43,79
31812,FremontBridge,05/20/2016 12:00:00 PM,48,-122,51,59,110
31813,FremontBridge,05/20/2016 01:00:00 PM,48,-122,54,57,111
31814,FremontBridge,05/20/2016 02:00:00 PM,48,-122,76,72,148
31815,FremontBridge,05/20/2016 03:00:00 PM,48,-122,140,78,218
31816,FremontBridge,05/20/2016 04:00:00 PM,48,-122,267,156,423
31817,FremontBridge,05/20/2016 05:00:00 PM,48,-122,456,216,672
31818,FremontBridge,05/20/2016 06:00:00 PM,48,-122,312,127,439
31819,FremontBridge,05/20/2016 07:00:00 PM,48,-122,119,81,200
31820,FremontBridge,05/20/2016 08:00:00 PM,48,-122,67,37,104
31821,FremontBridge,05/20/2016 09:00:00 PM,48,-122,31,25,56
31822,FremontBridge,05/20/2016 10:00:00 PM,48,-122,19,16,35
31823,FremontBridge,05/20/2016 11:00:00 PM,48,-122,23,8,31
31824,FremontBridge,05/21/2016 12:00:00 AM,48,-122,9,7,16
31825,FremontBridge,05/21/2016 01:00:00 AM,48,-122,7,5,12
31826,FremontBridge,05/21/2016 02:00:00 AM,48,-122,5,1,6
31827,FremontBridge,05/21/2016 03:00:00 AM,48,-122,2,2,4
31828,FremontBridge,05/21/2016 04:00:00 AM,48,-122,3,3,6
31829,FremontBridge,05/21/2016 05:00:00 AM,48,-122,2,2,4
31830,FremontBridge,05/21/2016 06:00:00 AM,48,-122,9,6,15
31831,FremontBridge,05/21/2016 07:00:00 AM,48,-122,6,16,22
31832,FremontBridge,05/21/2016 08:00:00 AM,48,-122,20,28,48
31833,FremontBridge,05/21/2016 09:00:00 AM,48,-122,9,22,31
31834,FremontBridge,05/21/2016 10:00:00 AM,48,-122,18,12,30
31835,FremontBridge,05/21/2016 11:00:00 AM,48,-122,17,14,31
31836,FremontBridge,05/21/2016 12:00:00 PM,48,-122,20,31,51
31837,FremontBridge,05/21/2016 01:00:00 PM,48,-122,24,22,46
31838,FremontBridge,05/21/2016 02:00:00 PM,48,-122,26,30,56
31839,FremontBridge,05/21/2016 03:00:00 PM,48,-122,31,32,63
31840,FremontBridge,05/21/2016 04:00:00 PM,48,-122,25,36,61
31841,FremontBridge,05/21/2016 05:00:00 PM,48,-122,36,31,67
31842,FremontBridge,05/21/2016 06:00:00 PM,48,-122,28,22,50
31843,FremontBridge,05/21/2016 07:00:00 PM,48,-122,25,15,40
31844,FremontBridge,05/21/2016 08:00:00 PM,48,-122,19,9,28
31845,FremontBridge,05/21/2016 09:00:00 PM,48,-122,17,6,23
31846,FremontBridge,05/21/2016 10:00:00 PM,48,-122,9,8,17
31847,FremontBridge,05/21/2016 11:00:00 PM,48,-122,9,5,14
31848,FremontBridge,05/22/2016 12:00:00 AM,48,-122,4,5,9
31849,FremontBridge,05/22/2016 01:00:00 AM,48,-122,8,4,12
31850,FremontBridge,05/22/2016 02:00:00 AM,48,-122,2,3,5
31851,FremontBridge,05/22/2016 03:00:00 AM,48,-122,2,0,2
31852,FremontBridge,05/22/2016 04:00:00 AM,48,-122,5,1,6
31853,FremontBridge,05/22/2016 05:00:00 AM,48,-122,2,4,6
31854,FremontBridge,05/22/2016 06:00:00 AM,48,-122,14,10,24
31855,FremontBridge,05/22/2016 07:00:00 AM,48,-122,19,14,33
31856,FremontBridge,05/22/2016 08:00:00 AM,48,-122,28,24,52
31857,FremontBridge,05/22/2016 09:00:00 AM,48,-122,28,49,77
31858,FremontBridge,05/22/2016 10:00:00 AM,48,-122,45,74,119
31859,FremontBridge,05/22/2016 11:00:00 AM,48,-122,77,94,171
31860,FremontBridge,05/22/2016 12:00:00 PM,48,-122,84,89,173
31861,FremontBridge,05/22/2016 01:00:00 PM,48,-122,103,105,208
31862,FremontBridge,05/22/2016 02:00:00 PM,48,-122,97,108,205
31863,FremontBridge,05/22/2016 03:00:00 PM,48,-122,98,99,197
31864,FremontBridge,05/22/2016 04:00:00 PM,48,-122,101,80,181
31865,FremontBridge,05/22/2016 05:00:00 PM,48,-122,80,78,158
31866,FremontBridge,05/22/2016 06:00:00 PM,48,-122,69,68,137
31867,FremontBridge,05/22/2016 07:00:00 PM,48,-122,42,36,78
31868,FremontBridge,05/22/2016 08:00:00 PM,48,-122,18,19,37
31869,FremontBridge,05/22/2016 09:00:00 PM,48,-122,12,17,29
31870,FremontBridge,05/22/2016 10:00:00 PM,48,-122,15,11,26
31871,FremontBridge,05/22/2016 11:00:00 PM,48,-122,9,4,13
31872,FremontBridge,05/23/2016 12:00:00 AM,48,-122,4,1,5
31873,FremontBridge,05/23/2016 01:00:00 AM,48,-122,2,1,3
31874,FremontBridge,05/23/2016 02:00:00 AM,48,-122,2,1,3
31875,FremontBridge,05/23/2016 03:00:00 AM,48,-122,0,3,3
31876,FremontBridge,05/23/2016 04:00:00 AM,48,-122,4,4,8
31877,FremontBridge,05/23/2016 05:00:00 AM,48,-122,13,30,43
31878,FremontBridge,05/23/2016 06:00:00 AM,48,-122,53,109,162
31879,FremontBridge,05/23/2016 07:00:00 AM,48,-122,144,327,471
31880,FremontBridge,05/23/2016 08:00:00 AM,48,-122,203,404,607
31881,FremontBridge,05/23/2016 09:00:00 AM,48,-122,133,188,321
31882,FremontBridge,05/23/2016 10:00:00 AM,48,-122,38,61,99
31883,FremontBridge,05/23/2016 11:00:00 AM,48,-122,41,43,84
31884,FremontBridge,05/23/2016 12:00:00 PM,48,-122,37,43,80
31885,FremontBridge,05/23/2016 01:00:00 PM,48,-122,47,33,80
31886,FremontBridge,05/23/2016 02:00:00 PM,48,-122,42,41,83
31887,FremontBridge,05/23/2016 03:00:00 PM,48,-122,64,56,120
31888,FremontBridge,05/23/2016 04:00:00 PM,48,-122,224,112,336
31889,FremontBridge,05/23/2016 05:00:00 PM,48,-122,562,172,734
31890,FremontBridge,05/23/2016 06:00:00 PM,48,-122,327,169,496
31891,FremontBridge,05/23/2016 07:00:00 PM,48,-122,138,71,209
31892,FremontBridge,05/23/2016 08:00:00 PM,48,-122,65,49,114
31893,FremontBridge,05/23/2016 09:00:00 PM,48,-122,45,32,77
31894,FremontBridge,05/23/2016 10:00:00 PM,48,-122,30,19,49
31895,FremontBridge,05/23/2016 11:00:00 PM,48,-122,14,6,20
31896,FremontBridge,05/24/2016 12:00:00 AM,48,-122,2,4,6
31897,FremontBridge,05/24/2016 01:00:00 AM,48,-122,1,0,1
31898,FremontBridge,05/24/2016 02:00:00 AM,48,-122,0,0,0
31899,FremontBridge,05/24/2016 03:00:00 AM,48,-122,1,2,3
31900,FremontBridge,05/24/2016 04:00:00 AM,48,-122,4,5,9
31901,FremontBridge,05/24/2016 05:00:00 AM,48,-122,17,32,49
31902,FremontBridge,05/24/2016 06:00:00 AM,48,-122,80,143,223
31903,FremontBridge,05/24/2016 07:00:00 AM,48,-122,150,351,501
31904,FremontBridge,05/24/2016 08:00:00 AM,48,-122,230,433,663
31905,FremontBridge,05/24/2016 09:00:00 AM,48,-122,119,173,292
31906,FremontBridge,05/24/2016 10:00:00 AM,48,-122,39,64,103
31907,FremontBridge,05/24/2016 11:00:00 AM,48,-122,43,55,98
31908,FremontBridge,05/24/2016 12:00:00 PM,48,-122,36,52,88
31909,FremontBridge,05/24/2016 01:00:00 PM,48,-122,48,42,90
31910,FremontBridge,05/24/2016 02:00:00 PM,48,-122,61,58,119
31911,FremontBridge,05/24/2016 03:00:00 PM,48,-122,98,79,177
31912,FremontBridge,05/24/2016 04:00:00 PM,48,-122,269,132,401
31913,FremontBridge,05/24/2016 05:00:00 PM,48,-122,530,204,734
31914,FremontBridge,05/24/2016 06:00:00 PM,48,-122,337,168,505
31915,FremontBridge,05/24/2016 07:00:00 PM,48,-122,169,104,273
31916,FremontBridge,05/24/2016 08:00:00 PM,48,-122,86,81,167
31917,FremontBridge,05/24/2016 09:00:00 PM,48,-122,41,29,70
31918,FremontBridge,05/24/2016 10:00:00 PM,48,-122,39,16,55
31919,FremontBridge,05/24/2016 11:00:00 PM,48,-122,13,11,24
31920,FremontBridge,05/25/2016 12:00:00 AM,48,-122,6,10,16
31921,FremontBridge,05/25/2016 01:00:00 AM,48,-122,2,5,7
31922,FremontBridge,05/25/2016 02:00:00 AM,48,-122,2,0,2
31923,FremontBridge,05/25/2016 03:00:00 AM,48,-122,1,3,4
31924,FremontBridge,05/25/2016 04:00:00 AM,48,-122,6,3,9
31925,FremontBridge,05/25/2016 05:00:00 AM,48,-122,17,37,54
31926,FremontBridge,05/25/2016 06:00:00 AM,48,-122,69,128,197
31927,FremontBridge,05/25/2016 07:00:00 AM,48,-122,157,325,482
31928,FremontBridge,05/25/2016 08:00:00 AM,48,-122,197,408,605
31929,FremontBridge,05/25/2016 09:00:00 AM,48,-122,117,190,307
31930,FremontBridge,05/25/2016 10:00:00 AM,48,-122,53,73,126
31931,FremontBridge,05/25/2016 11:00:00 AM,48,-122,30,43,73
31932,FremontBridge,05/25/2016 12:00:00 PM,48,-122,96,50,146
31933,FremontBridge,05/25/2016 01:00:00 PM,48,-122,68,86,154
31934,FremontBridge,05/25/2016 02:00:00 PM,48,-122,70,53,123
31935,FremontBridge,05/25/2016 03:00:00 PM,48,-122,96,77,173
31936,FremontBridge,05/25/2016 04:00:00 PM,48,-122,249,113,362
31937,FremontBridge,05/25/2016 05:00:00 PM,48,-122,487,208,695
31938,FremontBridge,05/25/2016 06:00:00 PM,48,-122,298,157,455
31939,FremontBridge,05/25/2016 07:00:00 PM,48,-122,145,78,223
31940,FremontBridge,05/25/2016 08:00:00 PM,48,-122,78,49,127
31941,FremontBridge,05/25/2016 09:00:00 PM,48,-122,43,33,76
31942,FremontBridge,05/25/2016 10:00:00 PM,48,-122,31,19,50
31943,FremontBridge,05/25/2016 11:00:00 PM,48,-122,17,20,37
31944,FremontBridge,05/26/2016 12:00:00 AM,48,-122,3,5,8
31945,FremontBridge,05/26/2016 01:00:00 AM,48,-122,2,5,7
31946,FremontBridge,05/26/2016 02:00:00 AM,48,-122,0,2,2
31947,FremontBridge,05/26/2016 03:00:00 AM,48,-122,3,0,3
31948,FremontBridge,05/26/2016 04:00:00 AM,48,-122,2,8,10
31949,FremontBridge,05/26/2016 05:00:00 AM,48,-122,17,26,43
31950,FremontBridge,05/26/2016 06:00:00 AM,48,-122,47,117,164
31951,FremontBridge,05/26/2016 07:00:00 AM,48,-122,136,301,437
31952,FremontBridge,05/26/2016 08:00:00 AM,48,-122,197,406,603
31953,FremontBridge,05/26/2016 09:00:00 AM,48,-122,107,171,278
31954,FremontBridge,05/26/2016 10:00:00 AM,48,-122,45,68,113
31955,FremontBridge,05/26/2016 11:00:00 AM,48,-122,29,43,72
31956,FremontBridge,05/26/2016 12:00:00 PM,48,-122,62,38,100
31957,FremontBridge,05/26/2016 01:00:00 PM,48,-122,48,46,94
31958,FremontBridge,05/26/2016 02:00:00 PM,48,-122,52,39,91
31959,FremontBridge,05/26/2016 03:00:00 PM,48,-122,82,61,143
31960,FremontBridge,05/26/2016 04:00:00 PM,48,-122,204,108,312
31961,FremontBridge,05/26/2016 05:00:00 PM,48,-122,453,183,636
31962,FremontBridge,05/26/2016 06:00:00 PM,48,-122,281,141,422
31963,FremontBridge,05/26/2016 07:00:00 PM,48,-122,111,71,182
31964,FremontBridge,05/26/2016 08:00:00 PM,48,-122,76,36,112
31965,FremontBridge,05/26/2016 09:00:00 PM,48,-122,42,34,76
31966,FremontBridge,05/26/2016 10:00:00 PM,48,-122,23,8,31
31967,FremontBridge,05/26/2016 11:00:00 PM,48,-122,21,10,31
31968,FremontBridge,05/27/2016 12:00:00 AM,48,-122,2,6,8
31969,FremontBridge,05/27/2016 01:00:00 AM,48,-122,2,5,7
31970,FremontBridge,05/27/2016 02:00:00 AM,48,-122,0,2,2
31971,FremontBridge,05/27/2016 03:00:00 AM,48,-122,1,0,1
31972,FremontBridge,05/27/2016 04:00:00 AM,48,-122,3,1,4
31973,FremontBridge,05/27/2016 05:00:00 AM,48,-122,9,21,30
31974,FremontBridge,05/27/2016 06:00:00 AM,48,-122,27,58,85
31975,FremontBridge,05/27/2016 07:00:00 AM,48,-122,83,184,267
31976,FremontBridge,05/27/2016 08:00:00 AM,48,-122,134,278,412
31977,FremontBridge,05/27/2016 09:00:00 AM,48,-122,88,134,222
31978,FremontBridge,05/27/2016 10:00:00 AM,48,-122,41,54,95
31979,FremontBridge,05/27/2016 11:00:00 AM,48,-122,40,37,77
31980,FremontBridge,05/27/2016 12:00:00 PM,48,-122,36,50,86
31981,FremontBridge,05/27/2016 01:00:00 PM,48,-122,71,49,120
31982,FremontBridge,05/27/2016 02:00:00 PM,48,-122,70,54,124
31983,FremontBridge,05/27/2016 03:00:00 PM,48,-122,105,70,175
31984,FremontBridge,05/27/2016 04:00:00 PM,48,-122,187,95,282
31985,FremontBridge,05/27/2016 05:00:00 PM,48,-122,273,131,404
31986,FremontBridge,05/27/2016 06:00:00 PM,48,-122,133,66,199
31987,FremontBridge,05/27/2016 07:00:00 PM,48,-122,58,36,94
31988,FremontBridge,05/27/2016 08:00:00 PM,48,-122,35,26,61
31989,FremontBridge,05/27/2016 09:00:00 PM,48,-122,28,19,47
31990,FremontBridge,05/27/2016 10:00:00 PM,48,-122,26,14,40
31991,FremontBridge,05/27/2016 11:00:00 PM,48,-122,10,11,21
31992,FremontBridge,05/28/2016 12:00:00 AM,48,-122,7,7,14
31993,FremontBridge,05/28/2016 01:00:00 AM,48,-122,4,2,6
31994,FremontBridge,05/28/2016 02:00:00 AM,48,-122,7,4,11
31995,FremontBridge,05/28/2016 03:00:00 AM,48,-122,2,0,2
31996,FremontBridge,05/28/2016 04:00:00 AM,48,-122,1,1,2
31997,FremontBridge,05/28/2016 05:00:00 AM,48,-122,3,4,7
31998,FremontBridge,05/28/2016 06:00:00 AM,48,-122,9,8,17
31999,FremontBridge,05/28/2016 07:00:00 AM,48,-122,12,12,24
32000,FremontBridge,05/28/2016 08:00:00 AM,48,-122,21,32,53
32001,FremontBridge,05/28/2016 09:00:00 AM,48,-122,32,27,59
32002,FremontBridge,05/28/2016 10:00:00 AM,48,-122,35,42,77
32003,FremontBridge,05/28/2016 11:00:00 AM,48,-122,39,67,106
32004,FremontBridge,05/28/2016 12:00:00 PM,48,-122,61,55,116
32005,FremontBridge,05/28/2016 01:00:00 PM,48,-122,38,56,94
32006,FremontBridge,05/28/2016 02:00:00 PM,48,-122,45,45,90
32007,FremontBridge,05/28/2016 03:00:00 PM,48,-122,63,54,117
32008,FremontBridge,05/28/2016 04:00:00 PM,48,-122,48,52,100
32009,FremontBridge,05/28/2016 05:00:00 PM,48,-122,50,43,93
32010,FremontBridge,05/28/2016 06:00:00 PM,48,-122,29,38,67
32011,FremontBridge,05/28/2016 07:00:00 PM,48,-122,24,11,35
32012,FremontBridge,05/28/2016 08:00:00 PM,48,-122,22,7,29
32013,FremontBridge,05/28/2016 09:00:00 PM,48,-122,28,9,37
32014,FremontBridge,05/28/2016 10:00:00 PM,48,-122,12,4,16
32015,FremontBridge,05/28/2016 11:00:00 PM,48,-122,12,1,13
32016,FremontBridge,05/29/2016 12:00:00 AM,48,-122,8,3,11
32017,FremontBridge,05/29/2016 01:00:00 AM,48,-122,7,0,7
32018,FremontBridge,05/29/2016 02:00:00 AM,48,-122,2,2,4
32019,FremontBridge,05/29/2016 03:00:00 AM,48,-122,4,1,5
32020,FremontBridge,05/29/2016 04:00:00 AM,48,-122,0,0,0
32021,FremontBridge,05/29/2016 05:00:00 AM,48,-122,2,1,3
32022,FremontBridge,05/29/2016 06:00:00 AM,48,-122,6,5,11
32023,FremontBridge,05/29/2016 07:00:00 AM,48,-122,10,8,18
32024,FremontBridge,05/29/2016 08:00:00 AM,48,-122,24,14,38
32025,FremontBridge,05/29/2016 09:00:00 AM,48,-122,15,11,26
32026,FremontBridge,05/29/2016 10:00:00 AM,48,-122,16,21,37
32027,FremontBridge,05/29/2016 11:00:00 AM,48,-122,19,18,37
32028,FremontBridge,05/29/2016 12:00:00 PM,48,-122,31,36,67
32029,FremontBridge,05/29/2016 01:00:00 PM,48,-122,22,30,52
32030,FremontBridge,05/29/2016 02:00:00 PM,48,-122,36,32,68
32031,FremontBridge,05/29/2016 03:00:00 PM,48,-122,37,41,78
32032,FremontBridge,05/29/2016 04:00:00 PM,48,-122,47,65,112
32033,FremontBridge,05/29/2016 05:00:00 PM,48,-122,46,37,83
32034,FremontBridge,05/29/2016 06:00:00 PM,48,-122,36,36,72
32035,FremontBridge,05/29/2016 07:00:00 PM,48,-122,20,22,42
32036,FremontBridge,05/29/2016 08:00:00 PM,48,-122,36,20,56
32037,FremontBridge,05/29/2016 09:00:00 PM,48,-122,16,10,26
32038,FremontBridge,05/29/2016 10:00:00 PM,48,-122,21,8,29
32039,FremontBridge,05/29/2016 11:00:00 PM,48,-122,11,6,17
32040,FremontBridge,05/30/2016 12:00:00 AM,48,-122,2,8,10
32041,FremontBridge,05/30/2016 01:00:00 AM,48,-122,2,3,5
32042,FremontBridge,05/30/2016 02:00:00 AM,48,-122,3,0,3
32043,FremontBridge,05/30/2016 03:00:00 AM,48,-122,1,2,3
32044,FremontBridge,05/30/2016 04:00:00 AM,48,-122,4,1,5
32045,FremontBridge,05/30/2016 05:00:00 AM,48,-122,4,7,11
32046,FremontBridge,05/30/2016 06:00:00 AM,48,-122,17,15,32
32047,FremontBridge,05/30/2016 07:00:00 AM,48,-122,25,23,48
32048,FremontBridge,05/30/2016 08:00:00 AM,48,-122,53,36,89
32049,FremontBridge,05/30/2016 09:00:00 AM,48,-122,92,75,167
32050,FremontBridge,05/30/2016 10:00:00 AM,48,-122,79,126,205
32051,FremontBridge,05/30/2016 11:00:00 AM,48,-122,99,127,226
32052,FremontBridge,05/30/2016 12:00:00 PM,48,-122,123,155,278
32053,FremontBridge,05/30/2016 01:00:00 PM,48,-122,125,159,284
32054,FremontBridge,05/30/2016 02:00:00 PM,48,-122,148,196,344
32055,FremontBridge,05/30/2016 03:00:00 PM,48,-122,129,125,254
32056,FremontBridge,05/30/2016 04:00:00 PM,48,-122,142,123,265
32057,FremontBridge,05/30/2016 05:00:00 PM,48,-122,130,127,257
32058,FremontBridge,05/30/2016 06:00:00 PM,48,-122,92,82,174
32059,FremontBridge,05/30/2016 07:00:00 PM,48,-122,61,51,112
32060,FremontBridge,05/30/2016 08:00:00 PM,48,-122,39,41,80
32061,FremontBridge,05/30/2016 09:00:00 PM,48,-122,44,23,67
32062,FremontBridge,05/30/2016 10:00:00 PM,48,-122,9,16,25
32063,FremontBridge,05/30/2016 11:00:00 PM,48,-122,8,13,21
32064,FremontBridge,05/31/2016 12:00:00 AM,48,-122,5,2,7
32065,FremontBridge,05/31/2016 01:00:00 AM,48,-122,0,1,1
32066,FremontBridge,05/31/2016 02:00:00 AM,48,-122,0,1,1
32067,FremontBridge,05/31/2016 03:00:00 AM,48,-122,2,1,3
32068,FremontBridge,05/31/2016 04:00:00 AM,48,-122,3,5,8
32069,FremontBridge,05/31/2016 05:00:00 AM,48,-122,14,37,51
32070,FremontBridge,05/31/2016 06:00:00 AM,48,-122,58,145,203
32071,FremontBridge,05/31/2016 07:00:00 AM,48,-122,166,390,556
32072,FremontBridge,05/31/2016 08:00:00 AM,48,-122,214,467,681
32073,FremontBridge,05/31/2016 09:00:00 AM,48,-122,139,206,345
32074,FremontBridge,05/31/2016 10:00:00 AM,48,-122,56,84,140
32075,FremontBridge,05/31/2016 11:00:00 AM,48,-122,51,44,95
32076,FremontBridge,05/31/2016 12:00:00 PM,48,-122,50,62,112
32077,FremontBridge,05/31/2016 01:00:00 PM,48,-122,49,60,109
32078,FremontBridge,05/31/2016 02:00:00 PM,48,-122,65,61,126
32079,FremontBridge,05/31/2016 03:00:00 PM,48,-122,90,89,179
32080,FremontBridge,05/31/2016 04:00:00 PM,48,-122,263,118,381
32081,FremontBridge,05/31/2016 05:00:00 PM,48,-122,631,210,841
32082,FremontBridge,05/31/2016 06:00:00 PM,48,-122,295,210,505
32083,FremontBridge,05/31/2016 07:00:00 PM,48,-122,167,124,291
32084,FremontBridge,05/31/2016 08:00:00 PM,48,-122,65,59,124
32085,FremontBridge,05/31/2016 09:00:00 PM,48,-122,32,47,79
32086,FremontBridge,05/31/2016 10:00:00 PM,48,-122,23,18,41
32087,FremontBridge,05/31/2016 11:00:00 PM,48,-122,11,9,20
32088,FremontBridge,06/01/2016 12:00:00 AM,48,-122,6,7,13
32089,FremontBridge,06/01/2016 01:00:00 AM,48,-122,2,1,3
32090,FremontBridge,06/01/2016 02:00:00 AM,48,-122,1,0,1
32091,FremontBridge,06/01/2016 03:00:00 AM,48,-122,0,3,3
32092,FremontBridge,06/01/2016 04:00:00 AM,48,-122,2,5,7
32093,FremontBridge,06/01/2016 05:00:00 AM,48,-122,18,38,56
32094,FremontBridge,06/01/2016 06:00:00 AM,48,-122,67,150,217
32095,FremontBridge,06/01/2016 07:00:00 AM,48,-122,169,375,544
32096,FremontBridge,06/01/2016 08:00:00 AM,48,-122,215,420,635
32097,FremontBridge,06/01/2016 09:00:00 AM,48,-122,104,204,308
32098,FremontBridge,06/01/2016 10:00:00 AM,48,-122,73,88,161
32099,FremontBridge,06/01/2016 11:00:00 AM,48,-122,45,60,105
32100,FremontBridge,06/01/2016 12:00:00 PM,48,-122,52,55,107
32101,FremontBridge,06/01/2016 01:00:00 PM,48,-122,47,64,111
32102,FremontBridge,06/01/2016 02:00:00 PM,48,-122,66,76,142
32103,FremontBridge,06/01/2016 03:00:00 PM,48,-122,106,67,173
32104,FremontBridge,06/01/2016 04:00:00 PM,48,-122,261,130,391
32105,FremontBridge,06/01/2016 05:00:00 PM,48,-122,560,191,751
32106,FremontBridge,06/01/2016 06:00:00 PM,48,-122,335,189,524
32107,FremontBridge,06/01/2016 07:00:00 PM,48,-122,151,98,249
32108,FremontBridge,06/01/2016 08:00:00 PM,48,-122,95,76,171
32109,FremontBridge,06/01/2016 09:00:00 PM,48,-122,34,28,62
32110,FremontBridge,06/01/2016 10:00:00 PM,48,-122,33,22,55
32111,FremontBridge,06/01/2016 11:00:00 PM,48,-122,13,7,20
32112,FremontBridge,06/02/2016 12:00:00 AM,48,-122,8,6,14
32113,FremontBridge,06/02/2016 01:00:00 AM,48,-122,1,3,4
32114,FremontBridge,06/02/2016 02:00:00 AM,48,-122,2,1,3
32115,FremontBridge,06/02/2016 03:00:00 AM,48,-122,1,0,1
32116,FremontBridge,06/02/2016 04:00:00 AM,48,-122,6,6,12
32117,FremontBridge,06/02/2016 05:00:00 AM,48,-122,21,27,48
32118,FremontBridge,06/02/2016 06:00:00 AM,48,-122,48,104,152
32119,FremontBridge,06/02/2016 07:00:00 AM,48,-122,153,261,414
32120,FremontBridge,06/02/2016 08:00:00 AM,48,-122,175,384,559
32121,FremontBridge,06/02/2016 09:00:00 AM,48,-122,101,180,281
32122,FremontBridge,06/02/2016 10:00:00 AM,48,-122,42,70,112
32123,FremontBridge,06/02/2016 11:00:00 AM,48,-122,33,48,81
32124,FremontBridge,06/02/2016 12:00:00 PM,48,-122,44,38,82
32125,FremontBridge,06/02/2016 01:00:00 PM,48,-122,45,34,79
32126,FremontBridge,06/02/2016 02:00:00 PM,48,-122,74,33,107
32127,FremontBridge,06/02/2016 03:00:00 PM,48,-122,88,67,155
32128,FremontBridge,06/02/2016 04:00:00 PM,48,-122,211,122,333
32129,FremontBridge,06/02/2016 05:00:00 PM,48,-122,487,195,682
32130,FremontBridge,06/02/2016 06:00:00 PM,48,-122,311,145,456
32131,FremontBridge,06/02/2016 07:00:00 PM,48,-122,143,74,217
32132,FremontBridge,06/02/2016 08:00:00 PM,48,-122,70,54,124
32133,FremontBridge,06/02/2016 09:00:00 PM,48,-122,47,37,84
32134,FremontBridge,06/02/2016 10:00:00 PM,48,-122,30,25,55
32135,FremontBridge,06/02/2016 11:00:00 PM,48,-122,13,17,30
32136,FremontBridge,06/03/2016 12:00:00 AM,48,-122,10,9,19
32137,FremontBridge,06/03/2016 01:00:00 AM,48,-122,1,2,3
32138,FremontBridge,06/03/2016 02:00:00 AM,48,-122,0,3,3
32139,FremontBridge,06/03/2016 03:00:00 AM,48,-122,2,1,3
32140,FremontBridge,06/03/2016 04:00:00 AM,48,-122,4,7,11
32141,FremontBridge,06/03/2016 05:00:00 AM,48,-122,18,28,46
32142,FremontBridge,06/03/2016 06:00:00 AM,48,-122,44,114,158
32143,FremontBridge,06/03/2016 07:00:00 AM,48,-122,137,324,461
32144,FremontBridge,06/03/2016 08:00:00 AM,48,-122,206,393,599
32145,FremontBridge,06/03/2016 09:00:00 AM,48,-122,114,183,297
32146,FremontBridge,06/03/2016 10:00:00 AM,48,-122,53,65,118
32147,FremontBridge,06/03/2016 11:00:00 AM,48,-122,51,68,119
32148,FremontBridge,06/03/2016 12:00:00 PM,48,-122,55,61,116
32149,FremontBridge,06/03/2016 01:00:00 PM,48,-122,57,55,112
32150,FremontBridge,06/03/2016 02:00:00 PM,48,-122,84,62,146
32151,FremontBridge,06/03/2016 03:00:00 PM,48,-122,123,95,218
32152,FremontBridge,06/03/2016 04:00:00 PM,48,-122,323,158,481
32153,FremontBridge,06/03/2016 05:00:00 PM,48,-122,465,185,650
32154,FremontBridge,06/03/2016 06:00:00 PM,48,-122,259,146,405
32155,FremontBridge,06/03/2016 07:00:00 PM,48,-122,113,72,185
32156,FremontBridge,06/03/2016 08:00:00 PM,48,-122,64,68,132
32157,FremontBridge,06/03/2016 09:00:00 PM,48,-122,52,43,95
32158,FremontBridge,06/03/2016 10:00:00 PM,48,-122,28,27,55
32159,FremontBridge,06/03/2016 11:00:00 PM,48,-122,26,12,38
32160,FremontBridge,06/04/2016 12:00:00 AM,48,-122,19,7,26
32161,FremontBridge,06/04/2016 01:00:00 AM,48,-122,13,5,18
32162,FremontBridge,06/04/2016 02:00:00 AM,48,-122,5,3,8
32163,FremontBridge,06/04/2016 03:00:00 AM,48,-122,3,3,6
32164,FremontBridge,06/04/2016 04:00:00 AM,48,-122,4,0,4
32165,FremontBridge,06/04/2016 05:00:00 AM,48,-122,3,9,12
32166,FremontBridge,06/04/2016 06:00:00 AM,48,-122,17,13,30
32167,FremontBridge,06/04/2016 07:00:00 AM,48,-122,39,36,75
32168,FremontBridge,06/04/2016 08:00:00 AM,48,-122,77,66,143
32169,FremontBridge,06/04/2016 09:00:00 AM,48,-122,78,119,197
32170,FremontBridge,06/04/2016 10:00:00 AM,48,-122,67,90,157
32171,FremontBridge,06/04/2016 11:00:00 AM,48,-122,105,104,209
32172,FremontBridge,06/04/2016 12:00:00 PM,48,-122,96,94,190
32173,FremontBridge,06/04/2016 01:00:00 PM,48,-122,106,121,227
32174,FremontBridge,06/04/2016 02:00:00 PM,48,-122,105,129,234
32175,FremontBridge,06/04/2016 03:00:00 PM,48,-122,108,111,219
32176,FremontBridge,06/04/2016 04:00:00 PM,48,-122,93,107,200
32177,FremontBridge,06/04/2016 05:00:00 PM,48,-122,74,83,157
32178,FremontBridge,06/04/2016 06:00:00 PM,48,-122,79,84,163
32179,FremontBridge,06/04/2016 07:00:00 PM,48,-122,57,64,121
32180,FremontBridge,06/04/2016 08:00:00 PM,48,-122,44,25,69
32181,FremontBridge,06/04/2016 09:00:00 PM,48,-122,52,43,95
32182,FremontBridge,06/04/2016 10:00:00 PM,48,-122,19,23,42
32183,FremontBridge,06/04/2016 11:00:00 PM,48,-122,15,22,37
32184,FremontBridge,06/05/2016 12:00:00 AM,48,-122,14,9,23
32185,FremontBridge,06/05/2016 01:00:00 AM,48,-122,7,6,13
32186,FremontBridge,06/05/2016 02:00:00 AM,48,-122,2,0,2
32187,FremontBridge,06/05/2016 03:00:00 AM,48,-122,3,2,5
32188,FremontBridge,06/05/2016 04:00:00 AM,48,-122,2,2,4
32189,FremontBridge,06/05/2016 05:00:00 AM,48,-122,6,6,12
32190,FremontBridge,06/05/2016 06:00:00 AM,48,-122,17,7,24
32191,FremontBridge,06/05/2016 07:00:00 AM,48,-122,22,33,55
32192,FremontBridge,06/05/2016 08:00:00 AM,48,-122,46,61,107
32193,FremontBridge,06/05/2016 09:00:00 AM,48,-122,59,62,121
32194,FremontBridge,06/05/2016 10:00:00 AM,48,-122,84,93,177
32195,FremontBridge,06/05/2016 11:00:00 AM,48,-122,92,100,192
32196,FremontBridge,06/05/2016 12:00:00 PM,48,-122,66,107,173
32197,FremontBridge,06/05/2016 01:00:00 PM,48,-122,93,110,203
32198,FremontBridge,06/05/2016 02:00:00 PM,48,-122,103,116,219
32199,FremontBridge,06/05/2016 03:00:00 PM,48,-122,91,112,203
32200,FremontBridge,06/05/2016 04:00:00 PM,48,-122,57,77,134
32201,FremontBridge,06/05/2016 05:00:00 PM,48,-122,62,54,116
32202,FremontBridge,06/05/2016 06:00:00 PM,48,-122,56,57,113
32203,FremontBridge,06/05/2016 07:00:00 PM,48,-122,43,37,80
32204,FremontBridge,06/05/2016 08:00:00 PM,48,-122,28,36,64
32205,FremontBridge,06/05/2016 09:00:00 PM,48,-122,21,24,45
32206,FremontBridge,06/05/2016 10:00:00 PM,48,-122,10,14,24
32207,FremontBridge,06/05/2016 11:00:00 PM,48,-122,17,7,24
32208,FremontBridge,06/06/2016 12:00:00 AM,48,-122,6,1,7
32209,FremontBridge,06/06/2016 01:00:00 AM,48,-122,2,1,3
32210,FremontBridge,06/06/2016 02:00:00 AM,48,-122,3,0,3
32211,FremontBridge,06/06/2016 03:00:00 AM,48,-122,1,0,1
32212,FremontBridge,06/06/2016 04:00:00 AM,48,-122,5,9,14
32213,FremontBridge,06/06/2016 05:00:00 AM,48,-122,18,34,52
32214,FremontBridge,06/06/2016 06:00:00 AM,48,-122,68,126,194
32215,FremontBridge,06/06/2016 07:00:00 AM,48,-122,150,344,494
32216,FremontBridge,06/06/2016 08:00:00 AM,48,-122,213,432,645
32217,FremontBridge,06/06/2016 09:00:00 AM,48,-122,120,208,328
32218,FremontBridge,06/06/2016 10:00:00 AM,48,-122,45,81,126
32219,FremontBridge,06/06/2016 11:00:00 AM,48,-122,60,51,111
32220,FremontBridge,06/06/2016 12:00:00 PM,48,-122,33,54,87
32221,FremontBridge,06/06/2016 01:00:00 PM,48,-122,61,61,122
32222,FremontBridge,06/06/2016 02:00:00 PM,48,-122,52,60,112
32223,FremontBridge,06/06/2016 03:00:00 PM,48,-122,109,78,187
32224,FremontBridge,06/06/2016 04:00:00 PM,48,-122,257,119,376
32225,FremontBridge,06/06/2016 05:00:00 PM,48,-122,598,186,784
32226,FremontBridge,06/06/2016 06:00:00 PM,48,-122,371,185,556
32227,FremontBridge,06/06/2016 07:00:00 PM,48,-122,151,92,243
32228,FremontBridge,06/06/2016 08:00:00 PM,48,-122,85,78,163
32229,FremontBridge,06/06/2016 09:00:00 PM,48,-122,56,29,85
32230,FremontBridge,06/06/2016 10:00:00 PM,48,-122,25,21,46
32231,FremontBridge,06/06/2016 11:00:00 PM,48,-122,12,13,25
32232,FremontBridge,06/07/2016 12:00:00 AM,48,-122,7,6,13
32233,FremontBridge,06/07/2016 01:00:00 AM,48,-122,5,0,5
32234,FremontBridge,06/07/2016 02:00:00 AM,48,-122,4,0,4
32235,FremontBridge,06/07/2016 03:00:00 AM,48,-122,2,2,4
32236,FremontBridge,06/07/2016 04:00:00 AM,48,-122,2,5,7
32237,FremontBridge,06/07/2016 05:00:00 AM,48,-122,15,34,49
32238,FremontBridge,06/07/2016 06:00:00 AM,48,-122,75,155,230
32239,FremontBridge,06/07/2016 07:00:00 AM,48,-122,168,372,540
32240,FremontBridge,06/07/2016 08:00:00 AM,48,-122,232,477,709
32241,FremontBridge,06/07/2016 09:00:00 AM,48,-122,146,183,329
32242,FremontBridge,06/07/2016 10:00:00 AM,48,-122,62,90,152
32243,FremontBridge,06/07/2016 11:00:00 AM,48,-122,44,83,127
32244,FremontBridge,06/07/2016 12:00:00 PM,48,-122,55,55,110
32245,FremontBridge,06/07/2016 01:00:00 PM,48,-122,69,56,125
32246,FremontBridge,06/07/2016 02:00:00 PM,48,-122,60,54,114
32247,FremontBridge,06/07/2016 03:00:00 PM,48,-122,99,69,168
32248,FremontBridge,06/07/2016 04:00:00 PM,48,-122,259,135,394
32249,FremontBridge,06/07/2016 05:00:00 PM,48,-122,611,214,825
32250,FremontBridge,06/07/2016 06:00:00 PM,48,-122,372,186,558
32251,FremontBridge,06/07/2016 07:00:00 PM,48,-122,180,116,296
32252,FremontBridge,06/07/2016 08:00:00 PM,48,-122,85,65,150
32253,FremontBridge,06/07/2016 09:00:00 PM,48,-122,58,40,98
32254,FremontBridge,06/07/2016 10:00:00 PM,48,-122,36,20,56
32255,FremontBridge,06/07/2016 11:00:00 PM,48,-122,13,11,24
32256,FremontBridge,06/08/2016 12:00:00 AM,48,-122,6,8,14
32257,FremontBridge,06/08/2016 01:00:00 AM,48,-122,6,4,10
32258,FremontBridge,06/08/2016 02:00:00 AM,48,-122,4,2,6
32259,FremontBridge,06/08/2016 03:00:00 AM,48,-122,2,2,4
32260,FremontBridge,06/08/2016 04:00:00 AM,48,-122,3,5,8
32261,FremontBridge,06/08/2016 05:00:00 AM,48,-122,28,35,63
32262,FremontBridge,06/08/2016 06:00:00 AM,48,-122,65,137,202
32263,FremontBridge,06/08/2016 07:00:00 AM,48,-122,152,343,495
32264,FremontBridge,06/08/2016 08:00:00 AM,48,-122,211,430,641
32265,FremontBridge,06/08/2016 09:00:00 AM,48,-122,136,217,353
32266,FremontBridge,06/08/2016 10:00:00 AM,48,-122,61,79,140
32267,FremontBridge,06/08/2016 11:00:00 AM,48,-122,36,48,84
32268,FremontBridge,06/08/2016 12:00:00 PM,48,-122,35,56,91
32269,FremontBridge,06/08/2016 01:00:00 PM,48,-122,42,38,80
32270,FremontBridge,06/08/2016 02:00:00 PM,48,-122,65,51,116
32271,FremontBridge,06/08/2016 03:00:00 PM,48,-122,100,65,165
32272,FremontBridge,06/08/2016 04:00:00 PM,48,-122,247,106,353
32273,FremontBridge,06/08/2016 05:00:00 PM,48,-122,559,229,788
32274,FremontBridge,06/08/2016 06:00:00 PM,48,-122,326,161,487
32275,FremontBridge,06/08/2016 07:00:00 PM,48,-122,144,95,239
32276,FremontBridge,06/08/2016 08:00:00 PM,48,-122,92,48,140
32277,FremontBridge,06/08/2016 09:00:00 PM,48,-122,33,38,71
32278,FremontBridge,06/08/2016 10:00:00 PM,48,-122,23,21,44
32279,FremontBridge,06/08/2016 11:00:00 PM,48,-122,16,17,33
32280,FremontBridge,06/09/2016 12:00:00 AM,48,-122,10,3,13
32281,FremontBridge,06/09/2016 01:00:00 AM,48,-122,5,4,9
32282,FremontBridge,06/09/2016 02:00:00 AM,48,-122,0,0,0
32283,FremontBridge,06/09/2016 03:00:00 AM,48,-122,1,1,2
32284,FremontBridge,06/09/2016 04:00:00 AM,48,-122,4,5,9
32285,FremontBridge,06/09/2016 05:00:00 AM,48,-122,16,29,45
32286,FremontBridge,06/09/2016 06:00:00 AM,48,-122,61,109,170
32287,FremontBridge,06/09/2016 07:00:00 AM,48,-122,132,280,412
32288,FremontBridge,06/09/2016 08:00:00 AM,48,-122,170,392,562
32289,FremontBridge,06/09/2016 09:00:00 AM,48,-122,115,162,277
32290,FremontBridge,06/09/2016 10:00:00 AM,48,-122,42,80,122
32291,FremontBridge,06/09/2016 11:00:00 AM,48,-122,32,34,66
32292,FremontBridge,06/09/2016 12:00:00 PM,48,-122,50,36,86
32293,FremontBridge,06/09/2016 01:00:00 PM,48,-122,56,45,101
32294,FremontBridge,06/09/2016 02:00:00 PM,48,-122,42,46,88
32295,FremontBridge,06/09/2016 03:00:00 PM,48,-122,78,74,152
32296,FremontBridge,06/09/2016 04:00:00 PM,48,-122,225,99,324
32297,FremontBridge,06/09/2016 05:00:00 PM,48,-122,456,169,625
32298,FremontBridge,06/09/2016 06:00:00 PM,48,-122,309,138,447
32299,FremontBridge,06/09/2016 07:00:00 PM,48,-122,118,72,190
32300,FremontBridge,06/09/2016 08:00:00 PM,48,-122,88,55,143
32301,FremontBridge,06/09/2016 09:00:00 PM,48,-122,29,24,53
32302,FremontBridge,06/09/2016 10:00:00 PM,48,-122,28,15,43
32303,FremontBridge,06/09/2016 11:00:00 PM,48,-122,18,13,31
32304,FremontBridge,06/10/2016 12:00:00 AM,48,-122,11,6,17
32305,FremontBridge,06/10/2016 01:00:00 AM,48,-122,3,6,9
32306,FremontBridge,06/10/2016 02:00:00 AM,48,-122,0,2,2
32307,FremontBridge,06/10/2016 03:00:00 AM,48,-122,3,0,3
32308,FremontBridge,06/10/2016 04:00:00 AM,48,-122,6,0,6
32309,FremontBridge,06/10/2016 05:00:00 AM,48,-122,19,28,47
32310,FremontBridge,06/10/2016 06:00:00 AM,48,-122,38,79,117
32311,FremontBridge,06/10/2016 07:00:00 AM,48,-122,128,221,349
32312,FremontBridge,06/10/2016 08:00:00 AM,48,-122,163,295,458
32313,FremontBridge,06/10/2016 09:00:00 AM,48,-122,102,148,250
32314,FremontBridge,06/10/2016 10:00:00 AM,48,-122,45,61,106
32315,FremontBridge,06/10/2016 11:00:00 AM,48,-122,41,38,79
32316,FremontBridge,06/10/2016 12:00:00 PM,48,-122,43,53,96
32317,FremontBridge,06/10/2016 01:00:00 PM,48,-122,54,58,112
32318,FremontBridge,06/10/2016 02:00:00 PM,48,-122,59,54,113
32319,FremontBridge,06/10/2016 03:00:00 PM,48,-122,78,52,130
32320,FremontBridge,06/10/2016 04:00:00 PM,48,-122,203,90,293
32321,FremontBridge,06/10/2016 05:00:00 PM,48,-122,361,159,520
32322,FremontBridge,06/10/2016 06:00:00 PM,48,-122,180,87,267
32323,FremontBridge,06/10/2016 07:00:00 PM,48,-122,84,44,128
32324,FremontBridge,06/10/2016 08:00:00 PM,48,-122,37,28,65
32325,FremontBridge,06/10/2016 09:00:00 PM,48,-122,26,17,43
32326,FremontBridge,06/10/2016 10:00:00 PM,48,-122,28,17,45
32327,FremontBridge,06/10/2016 11:00:00 PM,48,-122,16,7,23
32328,FremontBridge,06/11/2016 12:00:00 AM,48,-122,18,7,25
32329,FremontBridge,06/11/2016 01:00:00 AM,48,-122,3,9,12
32330,FremontBridge,06/11/2016 02:00:00 AM,48,-122,3,2,5
32331,FremontBridge,06/11/2016 03:00:00 AM,48,-122,0,1,1
32332,FremontBridge,06/11/2016 04:00:00 AM,48,-122,2,2,4
32333,FremontBridge,06/11/2016 05:00:00 AM,48,-122,5,11,16
32334,FremontBridge,06/11/2016 06:00:00 AM,48,-122,12,12,24
32335,FremontBridge,06/11/2016 07:00:00 AM,48,-122,17,22,39
32336,FremontBridge,06/11/2016 08:00:00 AM,48,-122,43,31,74
32337,FremontBridge,06/11/2016 09:00:00 AM,48,-122,50,46,96
32338,FremontBridge,06/11/2016 10:00:00 AM,48,-122,50,66,116
32339,FremontBridge,06/11/2016 11:00:00 AM,48,-122,46,82,128
32340,FremontBridge,06/11/2016 12:00:00 PM,48,-122,62,67,129
32341,FremontBridge,06/11/2016 01:00:00 PM,48,-122,53,70,123
32342,FremontBridge,06/11/2016 02:00:00 PM,48,-122,76,86,162
32343,FremontBridge,06/11/2016 03:00:00 PM,48,-122,57,74,131
32344,FremontBridge,06/11/2016 04:00:00 PM,48,-122,46,50,96
32345,FremontBridge,06/11/2016 05:00:00 PM,48,-122,44,50,94
32346,FremontBridge,06/11/2016 06:00:00 PM,48,-122,40,53,93
32347,FremontBridge,06/11/2016 07:00:00 PM,48,-122,53,40,93
32348,FremontBridge,06/11/2016 08:00:00 PM,48,-122,29,37,66
32349,FremontBridge,06/11/2016 09:00:00 PM,48,-122,27,53,80
32350,FremontBridge,06/11/2016 10:00:00 PM,48,-122,14,14,28
32351,FremontBridge,06/11/2016 11:00:00 PM,48,-122,9,16,25
32352,FremontBridge,06/12/2016 12:00:00 AM,48,-122,11,9,20
32353,FremontBridge,06/12/2016 01:00:00 AM,48,-122,7,2,9
32354,FremontBridge,06/12/2016 02:00:00 AM,48,-122,8,3,11
32355,FremontBridge,06/12/2016 03:00:00 AM,48,-122,1,0,1
32356,FremontBridge,06/12/2016 04:00:00 AM,48,-122,3,0,3
32357,FremontBridge,06/12/2016 05:00:00 AM,48,-122,6,5,11
32358,FremontBridge,06/12/2016 06:00:00 AM,48,-122,10,8,18
32359,FremontBridge,06/12/2016 07:00:00 AM,48,-122,30,19,49
32360,FremontBridge,06/12/2016 08:00:00 AM,48,-122,45,29,74
32361,FremontBridge,06/12/2016 09:00:00 AM,48,-122,50,48,98
32362,FremontBridge,06/12/2016 10:00:00 AM,48,-122,49,67,116
32363,FremontBridge,06/12/2016 11:00:00 AM,48,-122,71,95,166
32364,FremontBridge,06/12/2016 12:00:00 PM,48,-122,83,92,175
32365,FremontBridge,06/12/2016 01:00:00 PM,48,-122,87,95,182
32366,FremontBridge,06/12/2016 02:00:00 PM,48,-122,125,125,250
32367,FremontBridge,06/12/2016 03:00:00 PM,48,-122,96,106,202
32368,FremontBridge,06/12/2016 04:00:00 PM,48,-122,95,102,197
32369,FremontBridge,06/12/2016 05:00:00 PM,48,-122,113,98,211
32370,FremontBridge,06/12/2016 06:00:00 PM,48,-122,70,61,131
32371,FremontBridge,06/12/2016 07:00:00 PM,48,-122,55,48,103
32372,FremontBridge,06/12/2016 08:00:00 PM,48,-122,33,33,66
32373,FremontBridge,06/12/2016 09:00:00 PM,48,-122,23,16,39
32374,FremontBridge,06/12/2016 10:00:00 PM,48,-122,14,9,23
32375,FremontBridge,06/12/2016 11:00:00 PM,48,-122,11,8,19
32376,FremontBridge,06/13/2016 12:00:00 AM,48,-122,8,5,13
32377,FremontBridge,06/13/2016 01:00:00 AM,48,-122,2,1,3
32378,FremontBridge,06/13/2016 02:00:00 AM,48,-122,2,1,3
32379,FremontBridge,06/13/2016 03:00:00 AM,48,-122,1,2,3
32380,FremontBridge,06/13/2016 04:00:00 AM,48,-122,2,4,6
32381,FremontBridge,06/13/2016 05:00:00 AM,48,-122,23,35,58
32382,FremontBridge,06/13/2016 06:00:00 AM,48,-122,65,79,144
32383,FremontBridge,06/13/2016 07:00:00 AM,48,-122,131,244,375
32384,FremontBridge,06/13/2016 08:00:00 AM,48,-122,186,359,545
32385,FremontBridge,06/13/2016 09:00:00 AM,48,-122,71,149,220
32386,FremontBridge,06/13/2016 10:00:00 AM,48,-122,42,41,83
32387,FremontBridge,06/13/2016 11:00:00 AM,48,-122,32,40,72
32388,FremontBridge,06/13/2016 12:00:00 PM,48,-122,25,17,42
32389,FremontBridge,06/13/2016 01:00:00 PM,48,-122,27,27,54
32390,FremontBridge,06/13/2016 02:00:00 PM,48,-122,47,39,86
32391,FremontBridge,06/13/2016 03:00:00 PM,48,-122,73,62,135
32392,FremontBridge,06/13/2016 04:00:00 PM,48,-122,212,93,305
32393,FremontBridge,06/13/2016 05:00:00 PM,48,-122,452,162,614
32394,FremontBridge,06/13/2016 06:00:00 PM,48,-122,274,127,401
32395,FremontBridge,06/13/2016 07:00:00 PM,48,-122,115,75,190
32396,FremontBridge,06/13/2016 08:00:00 PM,48,-122,55,41,96
32397,FremontBridge,06/13/2016 09:00:00 PM,48,-122,41,20,61
32398,FremontBridge,06/13/2016 10:00:00 PM,48,-122,20,18,38
32399,FremontBridge,06/13/2016 11:00:00 PM,48,-122,11,3,14
32400,FremontBridge,06/14/2016 12:00:00 AM,48,-122,5,2,7
32401,FremontBridge,06/14/2016 01:00:00 AM,48,-122,6,2,8
32402,FremontBridge,06/14/2016 02:00:00 AM,48,-122,2,4,6
32403,FremontBridge,06/14/2016 03:00:00 AM,48,-122,2,1,3
32404,FremontBridge,06/14/2016 04:00:00 AM,48,-122,1,6,7
32405,FremontBridge,06/14/2016 05:00:00 AM,48,-122,17,22,39
32406,FremontBridge,06/14/2016 06:00:00 AM,48,-122,42,84,126
32407,FremontBridge,06/14/2016 07:00:00 AM,48,-122,137,214,351
32408,FremontBridge,06/14/2016 08:00:00 AM,48,-122,165,335,500
32409,FremontBridge,06/14/2016 09:00:00 AM,48,-122,90,145,235
32410,FremontBridge,06/14/2016 10:00:00 AM,48,-122,29,45,74
32411,FremontBridge,06/14/2016 11:00:00 AM,48,-122,23,37,60
32412,FremontBridge,06/14/2016 12:00:00 PM,48,-122,43,41,84
32413,FremontBridge,06/14/2016 01:00:00 PM,48,-122,29,38,67
32414,FremontBridge,06/14/2016 02:00:00 PM,48,-122,30,33,63
32415,FremontBridge,06/14/2016 03:00:00 PM,48,-122,72,48,120
32416,FremontBridge,06/14/2016 04:00:00 PM,48,-122,167,78,245
32417,FremontBridge,06/14/2016 05:00:00 PM,48,-122,405,136,541
32418,FremontBridge,06/14/2016 06:00:00 PM,48,-122,216,105,321
32419,FremontBridge,06/14/2016 07:00:00 PM,48,-122,112,60,172
32420,FremontBridge,06/14/2016 08:00:00 PM,48,-122,42,37,79
32421,FremontBridge,06/14/2016 09:00:00 PM,48,-122,35,21,56
32422,FremontBridge,06/14/2016 10:00:00 PM,48,-122,20,13,33
32423,FremontBridge,06/14/2016 11:00:00 PM,48,-122,13,4,17
32424,FremontBridge,06/15/2016 12:00:00 AM,48,-122,7,7,14
32425,FremontBridge,06/15/2016 01:00:00 AM,48,-122,4,3,7
32426,FremontBridge,06/15/2016 02:00:00 AM,48,-122,1,0,1
32427,FremontBridge,06/15/2016 03:00:00 AM,48,-122,2,1,3
32428,FremontBridge,06/15/2016 04:00:00 AM,48,-122,4,3,7
32429,FremontBridge,06/15/2016 05:00:00 AM,48,-122,21,31,52
32430,FremontBridge,06/15/2016 06:00:00 AM,48,-122,63,119,182
32431,FremontBridge,06/15/2016 07:00:00 AM,48,-122,147,277,424
32432,FremontBridge,06/15/2016 08:00:00 AM,48,-122,182,371,553
32433,FremontBridge,06/15/2016 09:00:00 AM,48,-122,107,174,281
32434,FremontBridge,06/15/2016 10:00:00 AM,48,-122,62,79,141
32435,FremontBridge,06/15/2016 11:00:00 AM,48,-122,43,48,91
32436,FremontBridge,06/15/2016 12:00:00 PM,48,-122,49,46,95
32437,FremontBridge,06/15/2016 01:00:00 PM,48,-122,42,51,93
32438,FremontBridge,06/15/2016 02:00:00 PM,48,-122,64,58,122
32439,FremontBridge,06/15/2016 03:00:00 PM,48,-122,83,84,167
32440,FremontBridge,06/15/2016 04:00:00 PM,48,-122,242,110,352
32441,FremontBridge,06/15/2016 05:00:00 PM,48,-122,523,238,761
32442,FremontBridge,06/15/2016 06:00:00 PM,48,-122,343,158,501
32443,FremontBridge,06/15/2016 07:00:00 PM,48,-122,150,91,241
32444,FremontBridge,06/15/2016 08:00:00 PM,48,-122,85,65,150
32445,FremontBridge,06/15/2016 09:00:00 PM,48,-122,49,31,80
32446,FremontBridge,06/15/2016 10:00:00 PM,48,-122,26,16,42
32447,FremontBridge,06/15/2016 11:00:00 PM,48,-122,16,12,28
32448,FremontBridge,06/16/2016 12:00:00 AM,48,-122,8,5,13
32449,FremontBridge,06/16/2016 01:00:00 AM,48,-122,2,4,6
32450,FremontBridge,06/16/2016 02:00:00 AM,48,-122,4,1,5
32451,FremontBridge,06/16/2016 03:00:00 AM,48,-122,0,1,1
32452,FremontBridge,06/16/2016 04:00:00 AM,48,-122,1,6,7
32453,FremontBridge,06/16/2016 05:00:00 AM,48,-122,14,27,41
32454,FremontBridge,06/16/2016 06:00:00 AM,48,-122,53,103,156
32455,FremontBridge,06/16/2016 07:00:00 AM,48,-122,148,279,427
32456,FremontBridge,06/16/2016 08:00:00 AM,48,-122,205,394,599
32457,FremontBridge,06/16/2016 09:00:00 AM,48,-122,115,189,304
32458,FremontBridge,06/16/2016 10:00:00 AM,48,-122,41,67,108
32459,FremontBridge,06/16/2016 11:00:00 AM,48,-122,47,42,89
32460,FremontBridge,06/16/2016 12:00:00 PM,48,-122,50,46,96
32461,FremontBridge,06/16/2016 01:00:00 PM,48,-122,46,52,98
32462,FremontBridge,06/16/2016 02:00:00 PM,48,-122,74,41,115
32463,FremontBridge,06/16/2016 03:00:00 PM,48,-122,97,82,179
32464,FremontBridge,06/16/2016 04:00:00 PM,48,-122,236,140,376
32465,FremontBridge,06/16/2016 05:00:00 PM,48,-122,495,207,702
32466,FremontBridge,06/16/2016 06:00:00 PM,48,-122,314,155,469
32467,FremontBridge,06/16/2016 07:00:00 PM,48,-122,126,72,198
32468,FremontBridge,06/16/2016 08:00:00 PM,48,-122,65,55,120
32469,FremontBridge,06/16/2016 09:00:00 PM,48,-122,75,41,116
32470,FremontBridge,06/16/2016 10:00:00 PM,48,-122,37,22,59
32471,FremontBridge,06/16/2016 11:00:00 PM,48,-122,22,13,35
32472,FremontBridge,06/17/2016 12:00:00 AM,48,-122,15,7,22
32473,FremontBridge,06/17/2016 01:00:00 AM,48,-122,4,4,8
32474,FremontBridge,06/17/2016 02:00:00 AM,48,-122,3,1,4
32475,FremontBridge,06/17/2016 03:00:00 AM,48,-122,1,2,3
32476,FremontBridge,06/17/2016 04:00:00 AM,48,-122,4,2,6
32477,FremontBridge,06/17/2016 05:00:00 AM,48,-122,15,24,39
32478,FremontBridge,06/17/2016 06:00:00 AM,48,-122,51,78,129
32479,FremontBridge,06/17/2016 07:00:00 AM,48,-122,119,268,387
32480,FremontBridge,06/17/2016 08:00:00 AM,48,-122,182,338,520
32481,FremontBridge,06/17/2016 09:00:00 AM,48,-122,122,149,271
32482,FremontBridge,06/17/2016 10:00:00 AM,48,-122,56,87,143
32483,FremontBridge,06/17/2016 11:00:00 AM,48,-122,51,56,107
32484,FremontBridge,06/17/2016 12:00:00 PM,48,-122,57,47,104
32485,FremontBridge,06/17/2016 01:00:00 PM,48,-122,52,56,108
32486,FremontBridge,06/17/2016 02:00:00 PM,48,-122,65,42,107
32487,FremontBridge,06/17/2016 03:00:00 PM,48,-122,116,72,188
32488,FremontBridge,06/17/2016 04:00:00 PM,48,-122,219,118,337
32489,FremontBridge,06/17/2016 05:00:00 PM,48,-122,375,119,494
32490,FremontBridge,06/17/2016 06:00:00 PM,48,-122,169,103,272
32491,FremontBridge,06/17/2016 07:00:00 PM,48,-122,100,39,139
32492,FremontBridge,06/17/2016 08:00:00 PM,48,-122,34,19,53
32493,FremontBridge,06/17/2016 09:00:00 PM,48,-122,31,26,57
32494,FremontBridge,06/17/2016 10:00:00 PM,48,-122,16,12,28
32495,FremontBridge,06/17/2016 11:00:00 PM,48,-122,17,10,27
32496,FremontBridge,06/18/2016 12:00:00 AM,48,-122,3,9,12
32497,FremontBridge,06/18/2016 01:00:00 AM,48,-122,5,2,7
32498,FremontBridge,06/18/2016 02:00:00 AM,48,-122,2,1,3
32499,FremontBridge,06/18/2016 03:00:00 AM,48,-122,2,0,2
32500,FremontBridge,06/18/2016 04:00:00 AM,48,-122,1,0,1
32501,FremontBridge,06/18/2016 05:00:00 AM,48,-122,2,9,11
32502,FremontBridge,06/18/2016 06:00:00 AM,48,-122,13,15,28
32503,FremontBridge,06/18/2016 07:00:00 AM,48,-122,23,20,43
32504,FremontBridge,06/18/2016 08:00:00 AM,48,-122,23,29,52
32505,FremontBridge,06/18/2016 09:00:00 AM,48,-122,49,34,83
32506,FremontBridge,06/18/2016 10:00:00 AM,48,-122,36,33,69
32507,FremontBridge,06/18/2016 11:00:00 AM,48,-122,56,45,101
32508,FremontBridge,06/18/2016 12:00:00 PM,48,-122,52,37,89
32509,FremontBridge,06/18/2016 01:00:00 PM,48,-122,66,49,115
32510,FremontBridge,06/18/2016 02:00:00 PM,48,-122,22,20,42
32511,FremontBridge,06/18/2016 03:00:00 PM,48,-122,9,6,15
32512,FremontBridge,06/18/2016 04:00:00 PM,48,-122,14,11,25
32513,FremontBridge,06/18/2016 05:00:00 PM,48,-122,49,31,80
32514,FremontBridge,06/18/2016 06:00:00 PM,48,-122,42,59,101
32515,FremontBridge,06/18/2016 07:00:00 PM,48,-122,38,32,70
32516,FremontBridge,06/18/2016 08:00:00 PM,48,-122,18,21,39
32517,FremontBridge,06/18/2016 09:00:00 PM,48,-122,28,23,51
32518,FremontBridge,06/18/2016 10:00:00 PM,48,-122,15,24,39
32519,FremontBridge,06/18/2016 11:00:00 PM,48,-122,18,21,39
32520,FremontBridge,06/19/2016 12:00:00 AM,48,-122,9,6,15
32521,FremontBridge,06/19/2016 01:00:00 AM,48,-122,8,9,17
32522,FremontBridge,06/19/2016 02:00:00 AM,48,-122,2,4,6
32523,FremontBridge,06/19/2016 03:00:00 AM,48,-122,0,1,1
32524,FremontBridge,06/19/2016 04:00:00 AM,48,-122,1,1,2
32525,FremontBridge,06/19/2016 05:00:00 AM,48,-122,1,5,6
32526,FremontBridge,06/19/2016 06:00:00 AM,48,-122,14,3,17
32527,FremontBridge,06/19/2016 07:00:00 AM,48,-122,21,32,53
32528,FremontBridge,06/19/2016 08:00:00 AM,48,-122,40,30,70
32529,FremontBridge,06/19/2016 09:00:00 AM,48,-122,67,56,123
32530,FremontBridge,06/19/2016 10:00:00 AM,48,-122,84,105,189
32531,FremontBridge,06/19/2016 11:00:00 AM,48,-122,80,65,145
32532,FremontBridge,06/19/2016 12:00:00 PM,48,-122,86,115,201
32533,FremontBridge,06/19/2016 01:00:00 PM,48,-122,111,85,196
32534,FremontBridge,06/19/2016 02:00:00 PM,48,-122,126,118,244
32535,FremontBridge,06/19/2016 03:00:00 PM,48,-122,124,105,229
32536,FremontBridge,06/19/2016 04:00:00 PM,48,-122,117,93,210
32537,FremontBridge,06/19/2016 05:00:00 PM,48,-122,92,108,200
32538,FremontBridge,06/19/2016 06:00:00 PM,48,-122,55,69,124
32539,FremontBridge,06/19/2016 07:00:00 PM,48,-122,30,42,72
32540,FremontBridge,06/19/2016 08:00:00 PM,48,-122,35,33,68
32541,FremontBridge,06/19/2016 09:00:00 PM,48,-122,15,28,43
32542,FremontBridge,06/19/2016 10:00:00 PM,48,-122,11,10,21
32543,FremontBridge,06/19/2016 11:00:00 PM,48,-122,13,8,21
32544,FremontBridge,06/20/2016 12:00:00 AM,48,-122,4,1,5
32545,FremontBridge,06/20/2016 01:00:00 AM,48,-122,2,0,2
32546,FremontBridge,06/20/2016 02:00:00 AM,48,-122,1,0,1
32547,FremontBridge,06/20/2016 03:00:00 AM,48,-122,2,0,2
32548,FremontBridge,06/20/2016 04:00:00 AM,48,-122,4,6,10
32549,FremontBridge,06/20/2016 05:00:00 AM,48,-122,21,33,54
32550,FremontBridge,06/20/2016 06:00:00 AM,48,-122,63,121,184
32551,FremontBridge,06/20/2016 07:00:00 AM,48,-122,140,288,428
32552,FremontBridge,06/20/2016 08:00:00 AM,48,-122,194,394,588
32553,FremontBridge,06/20/2016 09:00:00 AM,48,-122,128,206,334
32554,FremontBridge,06/20/2016 10:00:00 AM,48,-122,55,59,114
32555,FremontBridge,06/20/2016 11:00:00 AM,48,-122,24,34,58
32556,FremontBridge,06/20/2016 12:00:00 PM,48,-122,45,42,87
32557,FremontBridge,06/20/2016 01:00:00 PM,48,-122,43,44,87
32558,FremontBridge,06/20/2016 02:00:00 PM,48,-122,46,43,89
32559,FremontBridge,06/20/2016 03:00:00 PM,48,-122,95,56,151
32560,FremontBridge,06/20/2016 04:00:00 PM,48,-122,218,122,340
32561,FremontBridge,06/20/2016 05:00:00 PM,48,-122,539,180,719
32562,FremontBridge,06/20/2016 06:00:00 PM,48,-122,345,167,512
32563,FremontBridge,06/20/2016 07:00:00 PM,48,-122,149,100,249
32564,FremontBridge,06/20/2016 08:00:00 PM,48,-122,92,68,160
32565,FremontBridge,06/20/2016 09:00:00 PM,48,-122,48,61,109
32566,FremontBridge,06/20/2016 10:00:00 PM,48,-122,23,26,49
32567,FremontBridge,06/20/2016 11:00:00 PM,48,-122,14,2,16
32568,FremontBridge,06/21/2016 12:00:00 AM,48,-122,2,0,2
32569,FremontBridge,06/21/2016 01:00:00 AM,48,-122,0,2,2
32570,FremontBridge,06/21/2016 02:00:00 AM,48,-122,1,0,1
32571,FremontBridge,06/21/2016 03:00:00 AM,48,-122,1,1,2
32572,FremontBridge,06/21/2016 04:00:00 AM,48,-122,5,2,7
32573,FremontBridge,06/21/2016 05:00:00 AM,48,-122,9,34,43
32574,FremontBridge,06/21/2016 06:00:00 AM,48,-122,65,114,179
32575,FremontBridge,06/21/2016 07:00:00 AM,48,-122,138,291,429
32576,FremontBridge,06/21/2016 08:00:00 AM,48,-122,212,408,620
32577,FremontBridge,06/21/2016 09:00:00 AM,48,-122,99,176,275
32578,FremontBridge,06/21/2016 10:00:00 AM,48,-122,68,61,129
32579,FremontBridge,06/21/2016 11:00:00 AM,48,-122,41,47,88
32580,FremontBridge,06/21/2016 12:00:00 PM,48,-122,56,48,104
32581,FremontBridge,06/21/2016 01:00:00 PM,48,-122,45,45,90
32582,FremontBridge,06/21/2016 02:00:00 PM,48,-122,79,41,120
32583,FremontBridge,06/21/2016 03:00:00 PM,48,-122,74,66,140
32584,FremontBridge,06/21/2016 04:00:00 PM,48,-122,246,116,362
32585,FremontBridge,06/21/2016 05:00:00 PM,48,-122,563,221,784
32586,FremontBridge,06/21/2016 06:00:00 PM,48,-122,307,143,450
32587,FremontBridge,06/21/2016 07:00:00 PM,48,-122,137,107,244
32588,FremontBridge,06/21/2016 08:00:00 PM,48,-122,73,82,155
32589,FremontBridge,06/21/2016 09:00:00 PM,48,-122,72,58,130
32590,FremontBridge,06/21/2016 10:00:00 PM,48,-122,24,17,41
32591,FremontBridge,06/21/2016 11:00:00 PM,48,-122,18,10,28
32592,FremontBridge,06/22/2016 12:00:00 AM,48,-122,16,5,21
32593,FremontBridge,06/22/2016 01:00:00 AM,48,-122,3,5,8
32594,FremontBridge,06/22/2016 02:00:00 AM,48,-122,4,0,4
32595,FremontBridge,06/22/2016 03:00:00 AM,48,-122,1,2,3
32596,FremontBridge,06/22/2016 04:00:00 AM,48,-122,2,9,11
32597,FremontBridge,06/22/2016 05:00:00 AM,48,-122,20,25,45
32598,FremontBridge,06/22/2016 06:00:00 AM,48,-122,64,140,204
32599,FremontBridge,06/22/2016 07:00:00 AM,48,-122,176,294,470
32600,FremontBridge,06/22/2016 08:00:00 AM,48,-122,239,367,606
32601,FremontBridge,06/22/2016 09:00:00 AM,48,-122,130,217,347
32602,FremontBridge,06/22/2016 10:00:00 AM,48,-122,62,98,160
32603,FremontBridge,06/22/2016 11:00:00 AM,48,-122,44,64,108
32604,FremontBridge,06/22/2016 12:00:00 PM,48,-122,51,60,111
32605,FremontBridge,06/22/2016 01:00:00 PM,48,-122,56,58,114
32606,FremontBridge,06/22/2016 02:00:00 PM,48,-122,62,40,102
32607,FremontBridge,06/22/2016 03:00:00 PM,48,-122,109,80,189
32608,FremontBridge,06/22/2016 04:00:00 PM,48,-122,236,126,362
32609,FremontBridge,06/22/2016 05:00:00 PM,48,-122,555,234,789
32610,FremontBridge,06/22/2016 06:00:00 PM,48,-122,342,178,520
32611,FremontBridge,06/22/2016 07:00:00 PM,48,-122,167,86,253
32612,FremontBridge,06/22/2016 08:00:00 PM,48,-122,94,62,156
32613,FremontBridge,06/22/2016 09:00:00 PM,48,-122,44,28,72
32614,FremontBridge,06/22/2016 10:00:00 PM,48,-122,21,25,46
32615,FremontBridge,06/22/2016 11:00:00 PM,48,-122,13,10,23
32616,FremontBridge,06/23/2016 12:00:00 AM,48,-122,7,10,17
32617,FremontBridge,06/23/2016 01:00:00 AM,48,-122,1,5,6
32618,FremontBridge,06/23/2016 02:00:00 AM,48,-122,2,0,2
32619,FremontBridge,06/23/2016 03:00:00 AM,48,-122,2,0,2
32620,FremontBridge,06/23/2016 04:00:00 AM,48,-122,0,4,4
32621,FremontBridge,06/23/2016 05:00:00 AM,48,-122,16,24,40
32622,FremontBridge,06/23/2016 06:00:00 AM,48,-122,32,56,88
32623,FremontBridge,06/23/2016 07:00:00 AM,48,-122,80,162,242
32624,FremontBridge,06/23/2016 08:00:00 AM,48,-122,110,253,363
32625,FremontBridge,06/23/2016 09:00:00 AM,48,-122,70,135,205
32626,FremontBridge,06/23/2016 10:00:00 AM,48,-122,43,51,94
32627,FremontBridge,06/23/2016 11:00:00 AM,48,-122,25,30,55
32628,FremontBridge,06/23/2016 12:00:00 PM,48,-122,31,37,68
32629,FremontBridge,06/23/2016 01:00:00 PM,48,-122,56,38,94
32630,FremontBridge,06/23/2016 02:00:00 PM,48,-122,34,32,66
32631,FremontBridge,06/23/2016 03:00:00 PM,48,-122,56,31,87
32632,FremontBridge,06/23/2016 04:00:00 PM,48,-122,138,49,187
32633,FremontBridge,06/23/2016 05:00:00 PM,48,-122,288,111,399
32634,FremontBridge,06/23/2016 06:00:00 PM,48,-122,185,86,271
32635,FremontBridge,06/23/2016 07:00:00 PM,48,-122,87,50,137
32636,FremontBridge,06/23/2016 08:00:00 PM,48,-122,44,18,62
32637,FremontBridge,06/23/2016 09:00:00 PM,48,-122,22,23,45
32638,FremontBridge,06/23/2016 10:00:00 PM,48,-122,14,12,26
32639,FremontBridge,06/23/2016 11:00:00 PM,48,-122,6,6,12
32640,FremontBridge,06/24/2016 12:00:00 AM,48,-122,3,6,9
32641,FremontBridge,06/24/2016 01:00:00 AM,48,-122,5,3,8
32642,FremontBridge,06/24/2016 02:00:00 AM,48,-122,0,0,0
32643,FremontBridge,06/24/2016 03:00:00 AM,48,-122,1,0,1
32644,FremontBridge,06/24/2016 04:00:00 AM,48,-122,5,3,8
32645,FremontBridge,06/24/2016 05:00:00 AM,48,-122,8,21,29
32646,FremontBridge,06/24/2016 06:00:00 AM,48,-122,39,56,95
32647,FremontBridge,06/24/2016 07:00:00 AM,48,-122,82,167,249
32648,FremontBridge,06/24/2016 08:00:00 AM,48,-122,137,222,359
32649,FremontBridge,06/24/2016 09:00:00 AM,48,-122,81,100,181
32650,FremontBridge,06/24/2016 10:00:00 AM,48,-122,45,47,92
32651,FremontBridge,06/24/2016 11:00:00 AM,48,-122,31,27,58
32652,FremontBridge,06/24/2016 12:00:00 PM,48,-122,34,39,73
32653,FremontBridge,06/24/2016 01:00:00 PM,48,-122,43,47,90
32654,FremontBridge,06/24/2016 02:00:00 PM,48,-122,60,43,103
32655,FremontBridge,06/24/2016 03:00:00 PM,48,-122,86,54,140
32656,FremontBridge,06/24/2016 04:00:00 PM,48,-122,145,71,216
32657,FremontBridge,06/24/2016 05:00:00 PM,48,-122,303,112,415
32658,FremontBridge,06/24/2016 06:00:00 PM,48,-122,164,79,243
32659,FremontBridge,06/24/2016 07:00:00 PM,48,-122,65,33,98
32660,FremontBridge,06/24/2016 08:00:00 PM,48,-122,39,19,58
32661,FremontBridge,06/24/2016 09:00:00 PM,48,-122,25,14,39
32662,FremontBridge,06/24/2016 10:00:00 PM,48,-122,23,10,33
32663,FremontBridge,06/24/2016 11:00:00 PM,48,-122,11,7,18
32664,FremontBridge,06/25/2016 12:00:00 AM,48,-122,9,3,12
32665,FremontBridge,06/25/2016 01:00:00 AM,48,-122,8,1,9
32666,FremontBridge,06/25/2016 02:00:00 AM,48,-122,4,5,9
32667,FremontBridge,06/25/2016 03:00:00 AM,48,-122,3,2,5
32668,FremontBridge,06/25/2016 04:00:00 AM,48,-122,3,4,7
32669,FremontBridge,06/25/2016 05:00:00 AM,48,-122,5,3,8
32670,FremontBridge,06/25/2016 06:00:00 AM,48,-122,27,8,35
32671,FremontBridge,06/25/2016 07:00:00 AM,48,-122,16,35,51
32672,FremontBridge,06/25/2016 08:00:00 AM,48,-122,52,74,126
32673,FremontBridge,06/25/2016 09:00:00 AM,48,-122,59,42,101
32674,FremontBridge,06/25/2016 10:00:00 AM,48,-122,66,69,135
32675,FremontBridge,06/25/2016 11:00:00 AM,48,-122,49,89,138
32676,FremontBridge,06/25/2016 12:00:00 PM,48,-122,66,95,161
32677,FremontBridge,06/25/2016 01:00:00 PM,48,-122,80,108,188
32678,FremontBridge,06/25/2016 02:00:00 PM,48,-122,87,81,168
32679,FremontBridge,06/25/2016 03:00:00 PM,48,-122,98,113,211
32680,FremontBridge,06/25/2016 04:00:00 PM,48,-122,106,112,218
32681,FremontBridge,06/25/2016 05:00:00 PM,48,-122,86,86,172
32682,FremontBridge,06/25/2016 06:00:00 PM,48,-122,84,88,172
32683,FremontBridge,06/25/2016 07:00:00 PM,48,-122,56,61,117
32684,FremontBridge,06/25/2016 08:00:00 PM,48,-122,31,30,61
32685,FremontBridge,06/25/2016 09:00:00 PM,48,-122,19,26,45
32686,FremontBridge,06/25/2016 10:00:00 PM,48,-122,19,23,42
32687,FremontBridge,06/25/2016 11:00:00 PM,48,-122,20,12,32
32688,FremontBridge,06/26/2016 12:00:00 AM,48,-122,23,4,27
32689,FremontBridge,06/26/2016 01:00:00 AM,48,-122,7,4,11
32690,FremontBridge,06/26/2016 02:00:00 AM,48,-122,3,2,5
32691,FremontBridge,06/26/2016 03:00:00 AM,48,-122,4,4,8
32692,FremontBridge,06/26/2016 04:00:00 AM,48,-122,1,0,1
32693,FremontBridge,06/26/2016 05:00:00 AM,48,-122,4,6,10
32694,FremontBridge,06/26/2016 06:00:00 AM,48,-122,9,10,19
32695,FremontBridge,06/26/2016 07:00:00 AM,48,-122,22,19,41
32696,FremontBridge,06/26/2016 08:00:00 AM,48,-122,44,48,92
32697,FremontBridge,06/26/2016 09:00:00 AM,48,-122,62,79,141
32698,FremontBridge,06/26/2016 10:00:00 AM,48,-122,84,92,176
32699,FremontBridge,06/26/2016 11:00:00 AM,48,-122,96,118,214
32700,FremontBridge,06/26/2016 12:00:00 PM,48,-122,91,117,208
32701,FremontBridge,06/26/2016 01:00:00 PM,48,-122,107,145,252
32702,FremontBridge,06/26/2016 02:00:00 PM,48,-122,114,115,229
32703,FremontBridge,06/26/2016 03:00:00 PM,48,-122,133,103,236
32704,FremontBridge,06/26/2016 04:00:00 PM,48,-122,146,101,247
32705,FremontBridge,06/26/2016 05:00:00 PM,48,-122,91,74,165
32706,FremontBridge,06/26/2016 06:00:00 PM,48,-122,63,84,147
32707,FremontBridge,06/26/2016 07:00:00 PM,48,-122,45,36,81
32708,FremontBridge,06/26/2016 08:00:00 PM,48,-122,57,45,102
32709,FremontBridge,06/26/2016 09:00:00 PM,48,-122,17,19,36
32710,FremontBridge,06/26/2016 10:00:00 PM,48,-122,20,10,30
32711,FremontBridge,06/26/2016 11:00:00 PM,48,-122,14,8,22
32712,FremontBridge,06/27/2016 12:00:00 AM,48,-122,8,2,10
32713,FremontBridge,06/27/2016 01:00:00 AM,48,-122,4,4,8
32714,FremontBridge,06/27/2016 02:00:00 AM,48,-122,4,0,4
32715,FremontBridge,06/27/2016 03:00:00 AM,48,-122,0,4,4
32716,FremontBridge,06/27/2016 04:00:00 AM,48,-122,2,8,10
32717,FremontBridge,06/27/2016 05:00:00 AM,48,-122,17,38,55
32718,FremontBridge,06/27/2016 06:00:00 AM,48,-122,73,101,174
32719,FremontBridge,06/27/2016 07:00:00 AM,48,-122,169,295,464
32720,FremontBridge,06/27/2016 08:00:00 AM,48,-122,198,391,589
32721,FremontBridge,06/27/2016 09:00:00 AM,48,-122,111,200,311
32722,FremontBridge,06/27/2016 10:00:00 AM,48,-122,42,66,108
32723,FremontBridge,06/27/2016 11:00:00 AM,48,-122,41,42,83
32724,FremontBridge,06/27/2016 12:00:00 PM,48,-122,36,61,97
32725,FremontBridge,06/27/2016 01:00:00 PM,48,-122,52,64,116
32726,FremontBridge,06/27/2016 02:00:00 PM,48,-122,46,36,82
32727,FremontBridge,06/27/2016 03:00:00 PM,48,-122,115,65,180
32728,FremontBridge,06/27/2016 04:00:00 PM,48,-122,243,118,361
32729,FremontBridge,06/27/2016 05:00:00 PM,48,-122,535,208,743
32730,FremontBridge,06/27/2016 06:00:00 PM,48,-122,348,152,500
32731,FremontBridge,06/27/2016 07:00:00 PM,48,-122,176,109,285
32732,FremontBridge,06/27/2016 08:00:00 PM,48,-122,109,69,178
32733,FremontBridge,06/27/2016 09:00:00 PM,48,-122,57,48,105
32734,FremontBridge,06/27/2016 10:00:00 PM,48,-122,25,35,60
32735,FremontBridge,06/27/2016 11:00:00 PM,48,-122,8,11,19
32736,FremontBridge,06/28/2016 12:00:00 AM,48,-122,6,6,12
32737,FremontBridge,06/28/2016 01:00:00 AM,48,-122,3,2,5
32738,FremontBridge,06/28/2016 02:00:00 AM,48,-122,2,1,3
32739,FremontBridge,06/28/2016 03:00:00 AM,48,-122,1,2,3
32740,FremontBridge,06/28/2016 04:00:00 AM,48,-122,4,5,9
32741,FremontBridge,06/28/2016 05:00:00 AM,48,-122,23,31,54
32742,FremontBridge,06/28/2016 06:00:00 AM,48,-122,72,121,193
32743,FremontBridge,06/28/2016 07:00:00 AM,48,-122,158,319,477
32744,FremontBridge,06/28/2016 08:00:00 AM,48,-122,236,394,630
32745,FremontBridge,06/28/2016 09:00:00 AM,48,-122,128,181,309
32746,FremontBridge,06/28/2016 10:00:00 AM,48,-122,43,73,116
32747,FremontBridge,06/28/2016 11:00:00 AM,48,-122,41,44,85
32748,FremontBridge,06/28/2016 12:00:00 PM,48,-122,49,45,94
32749,FremontBridge,06/28/2016 01:00:00 PM,48,-122,53,49,102
32750,FremontBridge,06/28/2016 02:00:00 PM,48,-122,70,55,125
32751,FremontBridge,06/28/2016 03:00:00 PM,48,-122,116,78,194
32752,FremontBridge,06/28/2016 04:00:00 PM,48,-122,290,142,432
32753,FremontBridge,06/28/2016 05:00:00 PM,48,-122,547,188,735
32754,FremontBridge,06/28/2016 06:00:00 PM,48,-122,348,201,549
32755,FremontBridge,06/28/2016 07:00:00 PM,48,-122,165,112,277
32756,FremontBridge,06/28/2016 08:00:00 PM,48,-122,102,66,168
32757,FremontBridge,06/28/2016 09:00:00 PM,48,-122,40,40,80
32758,FremontBridge,06/28/2016 10:00:00 PM,48,-122,22,27,49
32759,FremontBridge,06/28/2016 11:00:00 PM,48,-122,29,15,44
32760,FremontBridge,06/29/2016 12:00:00 AM,48,-122,5,5,10
32761,FremontBridge,06/29/2016 01:00:00 AM,48,-122,2,1,3
32762,FremontBridge,06/29/2016 02:00:00 AM,48,-122,1,0,1
32763,FremontBridge,06/29/2016 03:00:00 AM,48,-122,3,1,4
32764,FremontBridge,06/29/2016 04:00:00 AM,48,-122,1,12,13
32765,FremontBridge,06/29/2016 05:00:00 AM,48,-122,20,26,46
32766,FremontBridge,06/29/2016 06:00:00 AM,48,-122,66,119,185
32767,FremontBridge,06/29/2016 07:00:00 AM,48,-122,136,300,436
32768,FremontBridge,06/29/2016 08:00:00 AM,48,-122,217,367,584
32769,FremontBridge,06/29/2016 09:00:00 AM,48,-122,113,185,298
32770,FremontBridge,06/29/2016 10:00:00 AM,48,-122,57,79,136
32771,FremontBridge,06/29/2016 11:00:00 AM,48,-122,38,42,80
32772,FremontBridge,06/29/2016 12:00:00 PM,48,-122,49,44,93
32773,FremontBridge,06/29/2016 01:00:00 PM,48,-122,43,43,86
32774,FremontBridge,06/29/2016 02:00:00 PM,48,-122,52,42,94
32775,FremontBridge,06/29/2016 03:00:00 PM,48,-122,103,84,187
32776,FremontBridge,06/29/2016 04:00:00 PM,48,-122,249,105,354
32777,FremontBridge,06/29/2016 05:00:00 PM,48,-122,525,199,724
32778,FremontBridge,06/29/2016 06:00:00 PM,48,-122,339,165,504
32779,FremontBridge,06/29/2016 07:00:00 PM,48,-122,148,136,284
32780,FremontBridge,06/29/2016 08:00:00 PM,48,-122,96,64,160
32781,FremontBridge,06/29/2016 09:00:00 PM,48,-122,61,43,104
32782,FremontBridge,06/29/2016 10:00:00 PM,48,-122,34,36,70
32783,FremontBridge,06/29/2016 11:00:00 PM,48,-122,13,15,28
32784,FremontBridge,06/30/2016 12:00:00 AM,48,-122,7,11,18
32785,FremontBridge,06/30/2016 01:00:00 AM,48,-122,4,1,5
32786,FremontBridge,06/30/2016 02:00:00 AM,48,-122,2,0,2
32787,FremontBridge,06/30/2016 03:00:00 AM,48,-122,1,0,1
32788,FremontBridge,06/30/2016 04:00:00 AM,48,-122,3,6,9
32789,FremontBridge,06/30/2016 05:00:00 AM,48,-122,21,38,59
32790,FremontBridge,06/30/2016 06:00:00 AM,48,-122,44,116,160
32791,FremontBridge,06/30/2016 07:00:00 AM,48,-122,135,264,399
32792,FremontBridge,06/30/2016 08:00:00 AM,48,-122,206,359,565
32793,FremontBridge,06/30/2016 09:00:00 AM,48,-122,122,179,301
32794,FremontBridge,06/30/2016 10:00:00 AM,48,-122,65,64,129
32795,FremontBridge,06/30/2016 11:00:00 AM,48,-122,28,43,71
32796,FremontBridge,06/30/2016 12:00:00 PM,48,-122,36,57,93
32797,FremontBridge,06/30/2016 01:00:00 PM,48,-122,39,58,97
32798,FremontBridge,06/30/2016 02:00:00 PM,48,-122,62,75,137
32799,FremontBridge,06/30/2016 03:00:00 PM,48,-122,102,62,164
32800,FremontBridge,06/30/2016 04:00:00 PM,48,-122,263,117,380
32801,FremontBridge,06/30/2016 05:00:00 PM,48,-122,501,170,671
32802,FremontBridge,06/30/2016 06:00:00 PM,48,-122,301,174,475
32803,FremontBridge,06/30/2016 07:00:00 PM,48,-122,146,102,248
32804,FremontBridge,06/30/2016 08:00:00 PM,48,-122,98,58,156
32805,FremontBridge,06/30/2016 09:00:00 PM,48,-122,50,41,91
32806,FremontBridge,06/30/2016 10:00:00 PM,48,-122,33,27,60
32807,FremontBridge,06/30/2016 11:00:00 PM,48,-122,15,8,23
32808,FremontBridge,07/01/2016 12:00:00 AM,48,-122,14,8,22
32809,FremontBridge,07/01/2016 01:00:00 AM,48,-122,4,8,12
32810,FremontBridge,07/01/2016 02:00:00 AM,48,-122,1,4,5
32811,FremontBridge,07/01/2016 03:00:00 AM,48,-122,3,2,5
32812,FremontBridge,07/01/2016 04:00:00 AM,48,-122,5,8,13
32813,FremontBridge,07/01/2016 05:00:00 AM,48,-122,13,29,42
32814,FremontBridge,07/01/2016 06:00:00 AM,48,-122,40,85,125
32815,FremontBridge,07/01/2016 07:00:00 AM,48,-122,104,222,326
32816,FremontBridge,07/01/2016 08:00:00 AM,48,-122,156,280,436
32817,FremontBridge,07/01/2016 09:00:00 AM,48,-122,116,147,263
32818,FremontBridge,07/01/2016 10:00:00 AM,48,-122,79,76,155
32819,FremontBridge,07/01/2016 11:00:00 AM,48,-122,55,54,109
32820,FremontBridge,07/01/2016 12:00:00 PM,48,-122,61,55,116
32821,FremontBridge,07/01/2016 01:00:00 PM,48,-122,58,54,112
32822,FremontBridge,07/01/2016 02:00:00 PM,48,-122,81,63,144
32823,FremontBridge,07/01/2016 03:00:00 PM,48,-122,146,86,232
32824,FremontBridge,07/01/2016 04:00:00 PM,48,-122,266,119,385
32825,FremontBridge,07/01/2016 05:00:00 PM,48,-122,336,156,492
32826,FremontBridge,07/01/2016 06:00:00 PM,48,-122,156,117,273
32827,FremontBridge,07/01/2016 07:00:00 PM,48,-122,85,63,148
32828,FremontBridge,07/01/2016 08:00:00 PM,48,-122,71,43,114
32829,FremontBridge,07/01/2016 09:00:00 PM,48,-122,41,38,79
32830,FremontBridge,07/01/2016 10:00:00 PM,48,-122,22,29,51
32831,FremontBridge,07/01/2016 11:00:00 PM,48,-122,15,24,39
32832,FremontBridge,07/02/2016 12:00:00 AM,48,-122,13,10,23
32833,FremontBridge,07/02/2016 01:00:00 AM,48,-122,8,7,15
32834,FremontBridge,07/02/2016 02:00:00 AM,48,-122,1,4,5
32835,FremontBridge,07/02/2016 03:00:00 AM,48,-122,3,0,3
32836,FremontBridge,07/02/2016 04:00:00 AM,48,-122,2,3,5
32837,FremontBridge,07/02/2016 05:00:00 AM,48,-122,3,8,11
32838,FremontBridge,07/02/2016 06:00:00 AM,48,-122,12,10,22
32839,FremontBridge,07/02/2016 07:00:00 AM,48,-122,26,32,58
32840,FremontBridge,07/02/2016 08:00:00 AM,48,-122,42,34,76
32841,FremontBridge,07/02/2016 09:00:00 AM,48,-122,53,61,114
32842,FremontBridge,07/02/2016 10:00:00 AM,48,-122,41,71,112
32843,FremontBridge,07/02/2016 11:00:00 AM,48,-122,81,101,182
32844,FremontBridge,07/02/2016 12:00:00 PM,48,-122,72,67,139
32845,FremontBridge,07/02/2016 01:00:00 PM,48,-122,74,88,162
32846,FremontBridge,07/02/2016 02:00:00 PM,48,-122,72,87,159
32847,FremontBridge,07/02/2016 03:00:00 PM,48,-122,99,117,216
32848,FremontBridge,07/02/2016 04:00:00 PM,48,-122,63,76,139
32849,FremontBridge,07/02/2016 05:00:00 PM,48,-122,76,89,165
32850,FremontBridge,07/02/2016 06:00:00 PM,48,-122,55,80,135
32851,FremontBridge,07/02/2016 07:00:00 PM,48,-122,51,60,111
32852,FremontBridge,07/02/2016 08:00:00 PM,48,-122,38,30,68
32853,FremontBridge,07/02/2016 09:00:00 PM,48,-122,19,16,35
32854,FremontBridge,07/02/2016 10:00:00 PM,48,-122,17,13,30
32855,FremontBridge,07/02/2016 11:00:00 PM,48,-122,20,9,29
32856,FremontBridge,07/03/2016 12:00:00 AM,48,-122,15,7,22
32857,FremontBridge,07/03/2016 01:00:00 AM,48,-122,4,1,5
32858,FremontBridge,07/03/2016 02:00:00 AM,48,-122,1,7,8
32859,FremontBridge,07/03/2016 03:00:00 AM,48,-122,3,1,4
32860,FremontBridge,07/03/2016 04:00:00 AM,48,-122,5,0,5
32861,FremontBridge,07/03/2016 05:00:00 AM,48,-122,7,3,10
32862,FremontBridge,07/03/2016 06:00:00 AM,48,-122,11,4,15
32863,FremontBridge,07/03/2016 07:00:00 AM,48,-122,13,11,24
32864,FremontBridge,07/03/2016 08:00:00 AM,48,-122,26,32,58
32865,FremontBridge,07/03/2016 09:00:00 AM,48,-122,33,36,69
32866,FremontBridge,07/03/2016 10:00:00 AM,48,-122,41,35,76
32867,FremontBridge,07/03/2016 11:00:00 AM,48,-122,89,60,149
32868,FremontBridge,07/03/2016 12:00:00 PM,48,-122,63,64,127
32869,FremontBridge,07/03/2016 01:00:00 PM,48,-122,86,87,173
32870,FremontBridge,07/03/2016 02:00:00 PM,48,-122,92,77,169
32871,FremontBridge,07/03/2016 03:00:00 PM,48,-122,96,74,170
32872,FremontBridge,07/03/2016 04:00:00 PM,48,-122,92,86,178
32873,FremontBridge,07/03/2016 05:00:00 PM,48,-122,102,56,158
32874,FremontBridge,07/03/2016 06:00:00 PM,48,-122,61,60,121
32875,FremontBridge,07/03/2016 07:00:00 PM,48,-122,35,45,80
32876,FremontBridge,07/03/2016 08:00:00 PM,48,-122,26,25,51
32877,FremontBridge,07/03/2016 09:00:00 PM,48,-122,21,27,48
32878,FremontBridge,07/03/2016 10:00:00 PM,48,-122,17,15,32
32879,FremontBridge,07/03/2016 11:00:00 PM,48,-122,18,11,29
32880,FremontBridge,07/04/2016 12:00:00 AM,48,-122,10,8,18
32881,FremontBridge,07/04/2016 01:00:00 AM,48,-122,3,3,6
32882,FremontBridge,07/04/2016 02:00:00 AM,48,-122,1,2,3
32883,FremontBridge,07/04/2016 03:00:00 AM,48,-122,0,0,0
32884,FremontBridge,07/04/2016 04:00:00 AM,48,-122,3,0,3
32885,FremontBridge,07/04/2016 05:00:00 AM,48,-122,4,5,9
32886,FremontBridge,07/04/2016 06:00:00 AM,48,-122,19,11,30
32887,FremontBridge,07/04/2016 07:00:00 AM,48,-122,18,12,30
32888,FremontBridge,07/04/2016 08:00:00 AM,48,-122,28,31,59
32889,FremontBridge,07/04/2016 09:00:00 AM,48,-122,32,55,87
32890,FremontBridge,07/04/2016 10:00:00 AM,48,-122,50,58,108
32891,FremontBridge,07/04/2016 11:00:00 AM,48,-122,63,80,143
32892,FremontBridge,07/04/2016 12:00:00 PM,48,-122,62,82,144
32893,FremontBridge,07/04/2016 01:00:00 PM,48,-122,116,67,183
32894,FremontBridge,07/04/2016 02:00:00 PM,48,-122,80,85,165
32895,FremontBridge,07/04/2016 03:00:00 PM,48,-122,106,91,197
32896,FremontBridge,07/04/2016 04:00:00 PM,48,-122,84,93,177
32897,FremontBridge,07/04/2016 05:00:00 PM,48,-122,78,64,142
32898,FremontBridge,07/04/2016 06:00:00 PM,48,-122,70,56,126
32899,FremontBridge,07/04/2016 07:00:00 PM,48,-122,45,59,104
32900,FremontBridge,07/04/2016 08:00:00 PM,48,-122,57,53,110
32901,FremontBridge,07/04/2016 09:00:00 PM,48,-122,53,56,109
32902,FremontBridge,07/04/2016 10:00:00 PM,48,-122,44,39,83
32903,FremontBridge,07/04/2016 11:00:00 PM,48,-122,124,48,172
32904,FremontBridge,07/05/2016 12:00:00 AM,48,-122,15,17,32
32905,FremontBridge,07/05/2016 01:00:00 AM,48,-122,5,4,9
32906,FremontBridge,07/05/2016 02:00:00 AM,48,-122,4,1,5
32907,FremontBridge,07/05/2016 03:00:00 AM,48,-122,2,2,4
32908,FremontBridge,07/05/2016 04:00:00 AM,48,-122,1,7,8
32909,FremontBridge,07/05/2016 05:00:00 AM,48,-122,13,24,37
32910,FremontBridge,07/05/2016 06:00:00 AM,48,-122,32,80,112
32911,FremontBridge,07/05/2016 07:00:00 AM,48,-122,100,200,300
32912,FremontBridge,07/05/2016 08:00:00 AM,48,-122,155,304,459
32913,FremontBridge,07/05/2016 09:00:00 AM,48,-122,92,124,216
32914,FremontBridge,07/05/2016 10:00:00 AM,48,-122,63,60,123
32915,FremontBridge,07/05/2016 11:00:00 AM,48,-122,35,23,58
32916,FremontBridge,07/05/2016 12:00:00 PM,48,-122,23,40,63
32917,FremontBridge,07/05/2016 01:00:00 PM,48,-122,27,46,73
32918,FremontBridge,07/05/2016 02:00:00 PM,48,-122,44,48,92
32919,FremontBridge,07/05/2016 03:00:00 PM,48,-122,75,44,119
32920,FremontBridge,07/05/2016 04:00:00 PM,48,-122,165,76,241
32921,FremontBridge,07/05/2016 05:00:00 PM,48,-122,351,124,475
32922,FremontBridge,07/05/2016 06:00:00 PM,48,-122,244,142,386
32923,FremontBridge,07/05/2016 07:00:00 PM,48,-122,112,65,177
32924,FremontBridge,07/05/2016 08:00:00 PM,48,-122,71,41,112
32925,FremontBridge,07/05/2016 09:00:00 PM,48,-122,30,34,64
32926,FremontBridge,07/05/2016 10:00:00 PM,48,-122,23,11,34
32927,FremontBridge,07/05/2016 11:00:00 PM,48,-122,15,7,22
32928,FremontBridge,07/06/2016 12:00:00 AM,48,-122,6,6,12
32929,FremontBridge,07/06/2016 01:00:00 AM,48,-122,2,0,2
32930,FremontBridge,07/06/2016 02:00:00 AM,48,-122,3,1,4
32931,FremontBridge,07/06/2016 03:00:00 AM,48,-122,0,3,3
32932,FremontBridge,07/06/2016 04:00:00 AM,48,-122,2,14,16
32933,FremontBridge,07/06/2016 05:00:00 AM,48,-122,25,26,51
32934,FremontBridge,07/06/2016 06:00:00 AM,48,-122,71,118,189
32935,FremontBridge,07/06/2016 07:00:00 AM,48,-122,166,324,490
32936,FremontBridge,07/06/2016 08:00:00 AM,48,-122,214,375,589
32937,FremontBridge,07/06/2016 09:00:00 AM,48,-122,130,201,331
32938,FremontBridge,07/06/2016 10:00:00 AM,48,-122,60,65,125
32939,FremontBridge,07/06/2016 11:00:00 AM,48,-122,70,65,135
32940,FremontBridge,07/06/2016 12:00:00 PM,48,-122,47,61,108
32941,FremontBridge,07/06/2016 01:00:00 PM,48,-122,32,68,100
32942,FremontBridge,07/06/2016 02:00:00 PM,48,-122,65,55,120
32943,FremontBridge,07/06/2016 03:00:00 PM,48,-122,97,70,167
32944,FremontBridge,07/06/2016 04:00:00 PM,48,-122,234,153,387
32945,FremontBridge,07/06/2016 05:00:00 PM,48,-122,549,229,778
32946,FremontBridge,07/06/2016 06:00:00 PM,48,-122,352,210,562
32947,FremontBridge,07/06/2016 07:00:00 PM,48,-122,188,114,302
32948,FremontBridge,07/06/2016 08:00:00 PM,48,-122,99,74,173
32949,FremontBridge,07/06/2016 09:00:00 PM,48,-122,57,51,108
32950,FremontBridge,07/06/2016 10:00:00 PM,48,-122,23,19,42
32951,FremontBridge,07/06/2016 11:00:00 PM,48,-122,18,4,22
32952,FremontBridge,07/07/2016 12:00:00 AM,48,-122,9,5,14
32953,FremontBridge,07/07/2016 01:00:00 AM,48,-122,1,1,2
32954,FremontBridge,07/07/2016 02:00:00 AM,48,-122,1,1,2
32955,FremontBridge,07/07/2016 03:00:00 AM,48,-122,2,1,3
32956,FremontBridge,07/07/2016 04:00:00 AM,48,-122,4,3,7
32957,FremontBridge,07/07/2016 05:00:00 AM,48,-122,24,28,52
32958,FremontBridge,07/07/2016 06:00:00 AM,48,-122,53,94,147
32959,FremontBridge,07/07/2016 07:00:00 AM,48,-122,122,257,379
32960,FremontBridge,07/07/2016 08:00:00 AM,48,-122,162,305,467
32961,FremontBridge,07/07/2016 09:00:00 AM,48,-122,110,175,285
32962,FremontBridge,07/07/2016 10:00:00 AM,48,-122,43,51,94
32963,FremontBridge,07/07/2016 11:00:00 AM,48,-122,30,46,76
32964,FremontBridge,07/07/2016 12:00:00 PM,48,-122,49,35,84
32965,FremontBridge,07/07/2016 01:00:00 PM,48,-122,51,35,86
32966,FremontBridge,07/07/2016 02:00:00 PM,48,-122,77,36,113
32967,FremontBridge,07/07/2016 03:00:00 PM,48,-122,77,56,133
32968,FremontBridge,07/07/2016 04:00:00 PM,48,-122,203,93,296
32969,FremontBridge,07/07/2016 05:00:00 PM,48,-122,377,144,521
32970,FremontBridge,07/07/2016 06:00:00 PM,48,-122,241,92,333
32971,FremontBridge,07/07/2016 07:00:00 PM,48,-122,96,38,134
32972,FremontBridge,07/07/2016 08:00:00 PM,48,-122,60,26,86
32973,FremontBridge,07/07/2016 09:00:00 PM,48,-122,34,21,55
32974,FremontBridge,07/07/2016 10:00:00 PM,48,-122,26,12,38
32975,FremontBridge,07/07/2016 11:00:00 PM,48,-122,11,8,19
32976,FremontBridge,07/08/2016 12:00:00 AM,48,-122,6,2,8
32977,FremontBridge,07/08/2016 01:00:00 AM,48,-122,2,0,2
32978,FremontBridge,07/08/2016 02:00:00 AM,48,-122,1,2,3
32979,FremontBridge,07/08/2016 03:00:00 AM,48,-122,2,1,3
32980,FremontBridge,07/08/2016 04:00:00 AM,48,-122,2,2,4
32981,FremontBridge,07/08/2016 05:00:00 AM,48,-122,9,11,20
32982,FremontBridge,07/08/2016 06:00:00 AM,48,-122,46,76,122
32983,FremontBridge,07/08/2016 07:00:00 AM,48,-122,95,211,306
32984,FremontBridge,07/08/2016 08:00:00 AM,48,-122,153,239,392
32985,FremontBridge,07/08/2016 09:00:00 AM,48,-122,84,135,219
32986,FremontBridge,07/08/2016 10:00:00 AM,48,-122,29,32,61
32987,FremontBridge,07/08/2016 11:00:00 AM,48,-122,32,44,76
32988,FremontBridge,07/08/2016 12:00:00 PM,48,-122,45,36,81
32989,FremontBridge,07/08/2016 01:00:00 PM,48,-122,38,47,85
32990,FremontBridge,07/08/2016 02:00:00 PM,48,-122,63,52,115
32991,FremontBridge,07/08/2016 03:00:00 PM,48,-122,84,37,121
32992,FremontBridge,07/08/2016 04:00:00 PM,48,-122,212,102,314
32993,FremontBridge,07/08/2016 05:00:00 PM,48,-122,379,133,512
32994,FremontBridge,07/08/2016 06:00:00 PM,48,-122,188,95,283
32995,FremontBridge,07/08/2016 07:00:00 PM,48,-122,118,68,186
32996,FremontBridge,07/08/2016 08:00:00 PM,48,-122,67,56,123
32997,FremontBridge,07/08/2016 09:00:00 PM,48,-122,407,62,469
32998,FremontBridge,07/08/2016 10:00:00 PM,48,-122,89,172,261
32999,FremontBridge,07/08/2016 11:00:00 PM,48,-122,140,68,208
33000,FremontBridge,07/09/2016 12:00:00 AM,48,-122,7,11,18
33001,FremontBridge,07/09/2016 01:00:00 AM,48,-122,3,2,5
33002,FremontBridge,07/09/2016 02:00:00 AM,48,-122,3,3,6
33003,FremontBridge,07/09/2016 03:00:00 AM,48,-122,1,0,1
33004,FremontBridge,07/09/2016 04:00:00 AM,48,-122,5,1,6
33005,FremontBridge,07/09/2016 05:00:00 AM,48,-122,3,2,5
33006,FremontBridge,07/09/2016 06:00:00 AM,48,-122,13,11,24
33007,FremontBridge,07/09/2016 07:00:00 AM,48,-122,22,31,53
33008,FremontBridge,07/09/2016 08:00:00 AM,48,-122,54,47,101
33009,FremontBridge,07/09/2016 09:00:00 AM,48,-122,57,70,127
33010,FremontBridge,07/09/2016 10:00:00 AM,48,-122,73,93,166
33011,FremontBridge,07/09/2016 11:00:00 AM,48,-122,91,101,192
33012,FremontBridge,07/09/2016 12:00:00 PM,48,-122,103,70,173
33013,FremontBridge,07/09/2016 01:00:00 PM,48,-122,59,84,143
33014,FremontBridge,07/09/2016 02:00:00 PM,48,-122,78,114,192
33015,FremontBridge,07/09/2016 03:00:00 PM,48,-122,77,71,148
33016,FremontBridge,07/09/2016 04:00:00 PM,48,-122,100,83,183
33017,FremontBridge,07/09/2016 05:00:00 PM,48,-122,71,61,132
33018,FremontBridge,07/09/2016 06:00:00 PM,48,-122,59,52,111
33019,FremontBridge,07/09/2016 07:00:00 PM,48,-122,36,43,79
33020,FremontBridge,07/09/2016 08:00:00 PM,48,-122,24,31,55
33021,FremontBridge,07/09/2016 09:00:00 PM,48,-122,30,18,48
33022,FremontBridge,07/09/2016 10:00:00 PM,48,-122,15,13,28
33023,FremontBridge,07/09/2016 11:00:00 PM,48,-122,20,13,33
33024,FremontBridge,07/10/2016 12:00:00 AM,48,-122,7,4,11
33025,FremontBridge,07/10/2016 01:00:00 AM,48,-122,8,4,12
33026,FremontBridge,07/10/2016 02:00:00 AM,48,-122,4,3,7
33027,FremontBridge,07/10/2016 03:00:00 AM,48,-122,4,1,5
33028,FremontBridge,07/10/2016 04:00:00 AM,48,-122,5,2,7
33029,FremontBridge,07/10/2016 05:00:00 AM,48,-122,3,3,6
33030,FremontBridge,07/10/2016 06:00:00 AM,48,-122,11,9,20
33031,FremontBridge,07/10/2016 07:00:00 AM,48,-122,19,27,46
33032,FremontBridge,07/10/2016 08:00:00 AM,48,-122,27,35,62
33033,FremontBridge,07/10/2016 09:00:00 AM,48,-122,51,70,121
33034,FremontBridge,07/10/2016 10:00:00 AM,48,-122,54,65,119
33035,FremontBridge,07/10/2016 11:00:00 AM,48,-122,80,127,207
33036,FremontBridge,07/10/2016 12:00:00 PM,48,-122,91,97,188
33037,FremontBridge,07/10/2016 01:00:00 PM,48,-122,101,121,222
33038,FremontBridge,07/10/2016 02:00:00 PM,48,-122,98,135,233
33039,FremontBridge,07/10/2016 03:00:00 PM,48,-122,128,109,237
33040,FremontBridge,07/10/2016 04:00:00 PM,48,-122,87,66,153
33041,FremontBridge,07/10/2016 05:00:00 PM,48,-122,82,88,170
33042,FremontBridge,07/10/2016 06:00:00 PM,48,-122,50,79,129
33043,FremontBridge,07/10/2016 07:00:00 PM,48,-122,41,52,93
33044,FremontBridge,07/10/2016 08:00:00 PM,48,-122,34,30,64
33045,FremontBridge,07/10/2016 09:00:00 PM,48,-122,29,31,60
33046,FremontBridge,07/10/2016 10:00:00 PM,48,-122,16,20,36
33047,FremontBridge,07/10/2016 11:00:00 PM,48,-122,11,10,21
33048,FremontBridge,07/11/2016 12:00:00 AM,48,-122,7,9,16
33049,FremontBridge,07/11/2016 01:00:00 AM,48,-122,0,2,2
33050,FremontBridge,07/11/2016 02:00:00 AM,48,-122,3,0,3
33051,FremontBridge,07/11/2016 03:00:00 AM,48,-122,1,0,1
33052,FremontBridge,07/11/2016 04:00:00 AM,48,-122,1,3,4
33053,FremontBridge,07/11/2016 05:00:00 AM,48,-122,12,29,41
33054,FremontBridge,07/11/2016 06:00:00 AM,48,-122,69,102,171
33055,FremontBridge,07/11/2016 07:00:00 AM,48,-122,144,279,423
33056,FremontBridge,07/11/2016 08:00:00 AM,48,-122,193,358,551
33057,FremontBridge,07/11/2016 09:00:00 AM,48,-122,117,175,292
33058,FremontBridge,07/11/2016 10:00:00 AM,48,-122,60,64,124
33059,FremontBridge,07/11/2016 11:00:00 AM,48,-122,35,36,71
33060,FremontBridge,07/11/2016 12:00:00 PM,48,-122,44,42,86
33061,FremontBridge,07/11/2016 01:00:00 PM,48,-122,47,45,92
33062,FremontBridge,07/11/2016 02:00:00 PM,48,-122,53,52,105
33063,FremontBridge,07/11/2016 03:00:00 PM,48,-122,86,60,146
33064,FremontBridge,07/11/2016 04:00:00 PM,48,-122,238,119,357
33065,FremontBridge,07/11/2016 05:00:00 PM,48,-122,479,174,653
33066,FremontBridge,07/11/2016 06:00:00 PM,48,-122,364,144,508
33067,FremontBridge,07/11/2016 07:00:00 PM,48,-122,132,91,223
33068,FremontBridge,07/11/2016 08:00:00 PM,48,-122,92,52,144
33069,FremontBridge,07/11/2016 09:00:00 PM,48,-122,45,34,79
33070,FremontBridge,07/11/2016 10:00:00 PM,48,-122,19,15,34
33071,FremontBridge,07/11/2016 11:00:00 PM,48,-122,11,8,19
33072,FremontBridge,07/12/2016 12:00:00 AM,48,-122,8,5,13
33073,FremontBridge,07/12/2016 01:00:00 AM,48,-122,2,2,4
33074,FremontBridge,07/12/2016 02:00:00 AM,48,-122,3,5,8
33075,FremontBridge,07/12/2016 03:00:00 AM,48,-122,1,2,3
33076,FremontBridge,07/12/2016 04:00:00 AM,48,-122,4,5,9
33077,FremontBridge,07/12/2016 05:00:00 AM,48,-122,13,29,42
33078,FremontBridge,07/12/2016 06:00:00 AM,48,-122,74,113,187
33079,FremontBridge,07/12/2016 07:00:00 AM,48,-122,158,304,462
33080,FremontBridge,07/12/2016 08:00:00 AM,48,-122,186,347,533
33081,FremontBridge,07/12/2016 09:00:00 AM,48,-122,123,174,297
33082,FremontBridge,07/12/2016 10:00:00 AM,48,-122,53,60,113
33083,FremontBridge,07/12/2016 11:00:00 AM,48,-122,47,49,96
33084,FremontBridge,07/12/2016 12:00:00 PM,48,-122,37,63,100
33085,FremontBridge,07/12/2016 01:00:00 PM,48,-122,46,64,110
33086,FremontBridge,07/12/2016 02:00:00 PM,48,-122,56,54,110
33087,FremontBridge,07/12/2016 03:00:00 PM,48,-122,92,75,167
33088,FremontBridge,07/12/2016 04:00:00 PM,48,-122,214,112,326
33089,FremontBridge,07/12/2016 05:00:00 PM,48,-122,497,180,677
33090,FremontBridge,07/12/2016 06:00:00 PM,48,-122,359,172,531
33091,FremontBridge,07/12/2016 07:00:00 PM,48,-122,150,118,268
33092,FremontBridge,07/12/2016 08:00:00 PM,48,-122,104,74,178
33093,FremontBridge,07/12/2016 09:00:00 PM,48,-122,53,45,98
33094,FremontBridge,07/12/2016 10:00:00 PM,48,-122,17,10,27
33095,FremontBridge,07/12/2016 11:00:00 PM,48,-122,13,12,25
33096,FremontBridge,07/13/2016 12:00:00 AM,48,-122,11,7,18
33097,FremontBridge,07/13/2016 01:00:00 AM,48,-122,2,4,6
33098,FremontBridge,07/13/2016 02:00:00 AM,48,-122,3,0,3
33099,FremontBridge,07/13/2016 03:00:00 AM,48,-122,3,1,4
33100,FremontBridge,07/13/2016 04:00:00 AM,48,-122,2,6,8
33101,FremontBridge,07/13/2016 05:00:00 AM,48,-122,24,39,63
33102,FremontBridge,07/13/2016 06:00:00 AM,48,-122,71,122,193
33103,FremontBridge,07/13/2016 07:00:00 AM,48,-122,154,321,475
33104,FremontBridge,07/13/2016 08:00:00 AM,48,-122,227,399,626
33105,FremontBridge,07/13/2016 09:00:00 AM,48,-122,119,185,304
33106,FremontBridge,07/13/2016 10:00:00 AM,48,-122,59,75,134
33107,FremontBridge,07/13/2016 11:00:00 AM,48,-122,38,51,89
33108,FremontBridge,07/13/2016 12:00:00 PM,48,-122,49,61,110
33109,FremontBridge,07/13/2016 01:00:00 PM,48,-122,47,42,89
33110,FremontBridge,07/13/2016 02:00:00 PM,48,-122,52,68,120
33111,FremontBridge,07/13/2016 03:00:00 PM,48,-122,131,76,207
33112,FremontBridge,07/13/2016 04:00:00 PM,48,-122,225,133,358
33113,FremontBridge,07/13/2016 05:00:00 PM,48,-122,567,220,787
33114,FremontBridge,07/13/2016 06:00:00 PM,48,-122,309,179,488
33115,FremontBridge,07/13/2016 07:00:00 PM,48,-122,162,115,277
33116,FremontBridge,07/13/2016 08:00:00 PM,48,-122,84,57,141
33117,FremontBridge,07/13/2016 09:00:00 PM,48,-122,47,44,91
33118,FremontBridge,07/13/2016 10:00:00 PM,48,-122,52,26,78
33119,FremontBridge,07/13/2016 11:00:00 PM,48,-122,16,11,27
33120,FremontBridge,07/14/2016 12:00:00 AM,48,-122,10,6,16
33121,FremontBridge,07/14/2016 01:00:00 AM,48,-122,4,5,9
33122,FremontBridge,07/14/2016 02:00:00 AM,48,-122,4,2,6
33123,FremontBridge,07/14/2016 03:00:00 AM,48,-122,2,0,2
33124,FremontBridge,07/14/2016 04:00:00 AM,48,-122,3,8,11
33125,FremontBridge,07/14/2016 05:00:00 AM,48,-122,20,34,54
33126,FremontBridge,07/14/2016 06:00:00 AM,48,-122,73,124,197
33127,FremontBridge,07/14/2016 07:00:00 AM,48,-122,151,288,439
33128,FremontBridge,07/14/2016 08:00:00 AM,48,-122,204,394,598
33129,FremontBridge,07/14/2016 09:00:00 AM,48,-122,141,183,324
33130,FremontBridge,07/14/2016 10:00:00 AM,48,-122,56,71,127
33131,FremontBridge,07/14/2016 11:00:00 AM,48,-122,41,63,104
33132,FremontBridge,07/14/2016 12:00:00 PM,48,-122,51,74,125
33133,FremontBridge,07/14/2016 01:00:00 PM,48,-122,47,61,108
33134,FremontBridge,07/14/2016 02:00:00 PM,48,-122,71,66,137
33135,FremontBridge,07/14/2016 03:00:00 PM,48,-122,111,84,195
33136,FremontBridge,07/14/2016 04:00:00 PM,48,-122,260,132,392
33137,FremontBridge,07/14/2016 05:00:00 PM,48,-122,503,201,704
33138,FremontBridge,07/14/2016 06:00:00 PM,48,-122,343,164,507
33139,FremontBridge,07/14/2016 07:00:00 PM,48,-122,153,94,247
33140,FremontBridge,07/14/2016 08:00:00 PM,48,-122,91,73,164
33141,FremontBridge,07/14/2016 09:00:00 PM,48,-122,44,50,94
33142,FremontBridge,07/14/2016 10:00:00 PM,48,-122,21,20,41
33143,FremontBridge,07/14/2016 11:00:00 PM,48,-122,14,6,20
33144,FremontBridge,07/15/2016 12:00:00 AM,48,-122,10,4,14
33145,FremontBridge,07/15/2016 01:00:00 AM,48,-122,4,3,7
33146,FremontBridge,07/15/2016 02:00:00 AM,48,-122,5,4,9
33147,FremontBridge,07/15/2016 03:00:00 AM,48,-122,1,2,3
33148,FremontBridge,07/15/2016 04:00:00 AM,48,-122,4,4,8
33149,FremontBridge,07/15/2016 05:00:00 AM,48,-122,14,21,35
33150,FremontBridge,07/15/2016 06:00:00 AM,48,-122,49,76,125
33151,FremontBridge,07/15/2016 07:00:00 AM,48,-122,120,240,360
33152,FremontBridge,07/15/2016 08:00:00 AM,48,-122,180,302,482
33153,FremontBridge,07/15/2016 09:00:00 AM,48,-122,119,131,250
33154,FremontBridge,07/15/2016 10:00:00 AM,48,-122,54,54,108
33155,FremontBridge,07/15/2016 11:00:00 AM,48,-122,45,60,105
33156,FremontBridge,07/15/2016 12:00:00 PM,48,-122,69,52,121
33157,FremontBridge,07/15/2016 01:00:00 PM,48,-122,79,53,132
33158,FremontBridge,07/15/2016 02:00:00 PM,48,-122,80,59,139
33159,FremontBridge,07/15/2016 03:00:00 PM,48,-122,127,94,221
33160,FremontBridge,07/15/2016 04:00:00 PM,48,-122,253,123,376
33161,FremontBridge,07/15/2016 05:00:00 PM,48,-122,381,163,544
33162,FremontBridge,07/15/2016 06:00:00 PM,48,-122,217,132,349
33163,FremontBridge,07/15/2016 07:00:00 PM,48,-122,107,75,182
33164,FremontBridge,07/15/2016 08:00:00 PM,48,-122,69,40,109
33165,FremontBridge,07/15/2016 09:00:00 PM,48,-122,24,38,62
33166,FremontBridge,07/15/2016 10:00:00 PM,48,-122,31,25,56
33167,FremontBridge,07/15/2016 11:00:00 PM,48,-122,22,17,39
33168,FremontBridge,07/16/2016 12:00:00 AM,48,-122,10,8,18
33169,FremontBridge,07/16/2016 01:00:00 AM,48,-122,6,7,13
33170,FremontBridge,07/16/2016 02:00:00 AM,48,-122,3,3,6
33171,FremontBridge,07/16/2016 03:00:00 AM,48,-122,4,3,7
33172,FremontBridge,07/16/2016 04:00:00 AM,48,-122,29,10,39
33173,FremontBridge,07/16/2016 05:00:00 AM,48,-122,32,17,49
33174,FremontBridge,07/16/2016 06:00:00 AM,48,-122,45,18,63
33175,FremontBridge,07/16/2016 07:00:00 AM,48,-122,29,23,52
33176,FremontBridge,07/16/2016 08:00:00 AM,48,-122,40,42,82
33177,FremontBridge,07/16/2016 09:00:00 AM,48,-122,64,46,110
33178,FremontBridge,07/16/2016 10:00:00 AM,48,-122,62,63,125
33179,FremontBridge,07/16/2016 11:00:00 AM,48,-122,59,84,143
33180,FremontBridge,07/16/2016 12:00:00 PM,48,-122,80,105,185
33181,FremontBridge,07/16/2016 01:00:00 PM,48,-122,71,63,134
33182,FremontBridge,07/16/2016 02:00:00 PM,48,-122,59,99,158
33183,FremontBridge,07/16/2016 03:00:00 PM,48,-122,74,88,162
33184,FremontBridge,07/16/2016 04:00:00 PM,48,-122,72,100,172
33185,FremontBridge,07/16/2016 05:00:00 PM,48,-122,99,72,171
33186,FremontBridge,07/16/2016 06:00:00 PM,48,-122,67,43,110
33187,FremontBridge,07/16/2016 07:00:00 PM,48,-122,37,35,72
33188,FremontBridge,07/16/2016 08:00:00 PM,48,-122,38,44,82
33189,FremontBridge,07/16/2016 09:00:00 PM,48,-122,20,22,42
33190,FremontBridge,07/16/2016 10:00:00 PM,48,-122,19,17,36
33191,FremontBridge,07/16/2016 11:00:00 PM,48,-122,24,14,38
33192,FremontBridge,07/17/2016 12:00:00 AM,48,-122,7,10,17
33193,FremontBridge,07/17/2016 01:00:00 AM,48,-122,10,3,13
33194,FremontBridge,07/17/2016 02:00:00 AM,48,-122,2,2,4
33195,FremontBridge,07/17/2016 03:00:00 AM,48,-122,2,3,5
33196,FremontBridge,07/17/2016 04:00:00 AM,48,-122,1,0,1
33197,FremontBridge,07/17/2016 05:00:00 AM,48,-122,2,7,9
33198,FremontBridge,07/17/2016 06:00:00 AM,48,-122,11,10,21
33199,FremontBridge,07/17/2016 07:00:00 AM,48,-122,18,11,29
33200,FremontBridge,07/17/2016 08:00:00 AM,48,-122,35,38,73
33201,FremontBridge,07/17/2016 09:00:00 AM,48,-122,39,54,93
33202,FremontBridge,07/17/2016 10:00:00 AM,48,-122,61,55,116
33203,FremontBridge,07/17/2016 11:00:00 AM,48,-122,84,93,177
33204,FremontBridge,07/17/2016 12:00:00 PM,48,-122,81,93,174
33205,FremontBridge,07/17/2016 01:00:00 PM,48,-122,79,97,176
33206,FremontBridge,07/17/2016 02:00:00 PM,48,-122,108,103,211
33207,FremontBridge,07/17/2016 03:00:00 PM,48,-122,86,115,201
33208,FremontBridge,07/17/2016 04:00:00 PM,48,-122,93,75,168
33209,FremontBridge,07/17/2016 05:00:00 PM,48,-122,73,77,150
33210,FremontBridge,07/17/2016 06:00:00 PM,48,-122,73,63,136
33211,FremontBridge,07/17/2016 07:00:00 PM,48,-122,51,37,88
33212,FremontBridge,07/17/2016 08:00:00 PM,48,-122,48,33,81
33213,FremontBridge,07/17/2016 09:00:00 PM,48,-122,22,25,47
33214,FremontBridge,07/17/2016 10:00:00 PM,48,-122,17,15,32
33215,FremontBridge,07/17/2016 11:00:00 PM,48,-122,9,6,15
33216,FremontBridge,07/18/2016 12:00:00 AM,48,-122,13,9,22
33217,FremontBridge,07/18/2016 01:00:00 AM,48,-122,3,0,3
33218,FremontBridge,07/18/2016 02:00:00 AM,48,-122,3,1,4
33219,FremontBridge,07/18/2016 03:00:00 AM,48,-122,0,0,0
33220,FremontBridge,07/18/2016 04:00:00 AM,48,-122,3,7,10
33221,FremontBridge,07/18/2016 05:00:00 AM,48,-122,20,32,52
33222,FremontBridge,07/18/2016 06:00:00 AM,48,-122,55,106,161
33223,FremontBridge,07/18/2016 07:00:00 AM,48,-122,135,292,427
33224,FremontBridge,07/18/2016 08:00:00 AM,48,-122,178,345,523
33225,FremontBridge,07/18/2016 09:00:00 AM,48,-122,112,186,298
33226,FremontBridge,07/18/2016 10:00:00 AM,48,-122,67,66,133
33227,FremontBridge,07/18/2016 11:00:00 AM,48,-122,44,48,92
33228,FremontBridge,07/18/2016 12:00:00 PM,48,-122,44,43,87
33229,FremontBridge,07/18/2016 01:00:00 PM,48,-122,29,51,80
33230,FremontBridge,07/18/2016 02:00:00 PM,48,-122,54,33,87
33231,FremontBridge,07/18/2016 03:00:00 PM,48,-122,68,49,117
33232,FremontBridge,07/18/2016 04:00:00 PM,48,-122,207,80,287
33233,FremontBridge,07/18/2016 05:00:00 PM,48,-122,482,152,634
33234,FremontBridge,07/18/2016 06:00:00 PM,48,-122,251,149,400
33235,FremontBridge,07/18/2016 07:00:00 PM,48,-122,154,79,233
33236,FremontBridge,07/18/2016 08:00:00 PM,48,-122,75,38,113
33237,FremontBridge,07/18/2016 09:00:00 PM,48,-122,39,34,73
33238,FremontBridge,07/18/2016 10:00:00 PM,48,-122,24,16,40
33239,FremontBridge,07/18/2016 11:00:00 PM,48,-122,12,9,21
33240,FremontBridge,07/19/2016 12:00:00 AM,48,-122,6,3,9
33241,FremontBridge,07/19/2016 01:00:00 AM,48,-122,2,0,2
33242,FremontBridge,07/19/2016 02:00:00 AM,48,-122,3,2,5
33243,FremontBridge,07/19/2016 03:00:00 AM,48,-122,0,2,2
33244,FremontBridge,07/19/2016 04:00:00 AM,48,-122,2,7,9
33245,FremontBridge,07/19/2016 05:00:00 AM,48,-122,23,29,52
33246,FremontBridge,07/19/2016 06:00:00 AM,48,-122,62,119,181
33247,FremontBridge,07/19/2016 07:00:00 AM,48,-122,142,317,459
33248,FremontBridge,07/19/2016 08:00:00 AM,48,-122,226,386,612
33249,FremontBridge,07/19/2016 09:00:00 AM,48,-122,114,192,306
33250,FremontBridge,07/19/2016 10:00:00 AM,48,-122,60,70,130
33251,FremontBridge,07/19/2016 11:00:00 AM,48,-122,37,48,85
33252,FremontBridge,07/19/2016 12:00:00 PM,48,-122,36,71,107
33253,FremontBridge,07/19/2016 01:00:00 PM,48,-122,51,85,136
33254,FremontBridge,07/19/2016 02:00:00 PM,48,-122,53,61,114
33255,FremontBridge,07/19/2016 03:00:00 PM,48,-122,103,62,165
33256,FremontBridge,07/19/2016 04:00:00 PM,48,-122,246,116,362
33257,FremontBridge,07/19/2016 05:00:00 PM,48,-122,537,182,719
33258,FremontBridge,07/19/2016 06:00:00 PM,48,-122,289,153,442
33259,FremontBridge,07/19/2016 07:00:00 PM,48,-122,150,96,246
33260,FremontBridge,07/19/2016 08:00:00 PM,48,-122,86,69,155
33261,FremontBridge,07/19/2016 09:00:00 PM,48,-122,39,51,90
33262,FremontBridge,07/19/2016 10:00:00 PM,48,-122,28,32,60
33263,FremontBridge,07/19/2016 11:00:00 PM,48,-122,20,10,30
33264,FremontBridge,07/20/2016 12:00:00 AM,48,-122,5,7,12
33265,FremontBridge,07/20/2016 01:00:00 AM,48,-122,1,1,2
33266,FremontBridge,07/20/2016 02:00:00 AM,48,-122,3,2,5
33267,FremontBridge,07/20/2016 03:00:00 AM,48,-122,0,1,1
33268,FremontBridge,07/20/2016 04:00:00 AM,48,-122,4,9,13
33269,FremontBridge,07/20/2016 05:00:00 AM,48,-122,18,33,51
33270,FremontBridge,07/20/2016 06:00:00 AM,48,-122,75,124,199
33271,FremontBridge,07/20/2016 07:00:00 AM,48,-122,165,306,471
33272,FremontBridge,07/20/2016 08:00:00 AM,48,-122,245,370,615
33273,FremontBridge,07/20/2016 09:00:00 AM,48,-122,116,199,315
33274,FremontBridge,07/20/2016 10:00:00 AM,48,-122,48,75,123
33275,FremontBridge,07/20/2016 11:00:00 AM,48,-122,51,64,115
33276,FremontBridge,07/20/2016 12:00:00 PM,48,-122,53,44,97
33277,FremontBridge,07/20/2016 01:00:00 PM,48,-122,51,56,107
33278,FremontBridge,07/20/2016 02:00:00 PM,48,-122,65,64,129
33279,FremontBridge,07/20/2016 03:00:00 PM,48,-122,87,89,176
33280,FremontBridge,07/20/2016 04:00:00 PM,48,-122,243,111,354
33281,FremontBridge,07/20/2016 05:00:00 PM,48,-122,553,207,760
33282,FremontBridge,07/20/2016 06:00:00 PM,48,-122,313,176,489
33283,FremontBridge,07/20/2016 07:00:00 PM,48,-122,138,108,246
33284,FremontBridge,07/20/2016 08:00:00 PM,48,-122,117,90,207
33285,FremontBridge,07/20/2016 09:00:00 PM,48,-122,38,57,95
33286,FremontBridge,07/20/2016 10:00:00 PM,48,-122,17,17,34
33287,FremontBridge,07/20/2016 11:00:00 PM,48,-122,22,10,32
33288,FremontBridge,07/21/2016 12:00:00 AM,48,-122,7,6,13
33289,FremontBridge,07/21/2016 01:00:00 AM,48,-122,4,5,9
33290,FremontBridge,07/21/2016 02:00:00 AM,48,-122,6,4,10
33291,FremontBridge,07/21/2016 03:00:00 AM,48,-122,6,1,7
33292,FremontBridge,07/21/2016 04:00:00 AM,48,-122,3,6,9
33293,FremontBridge,07/21/2016 05:00:00 AM,48,-122,17,25,42
33294,FremontBridge,07/21/2016 06:00:00 AM,48,-122,61,114,175
33295,FremontBridge,07/21/2016 07:00:00 AM,48,-122,154,294,448
33296,FremontBridge,07/21/2016 08:00:00 AM,48,-122,202,376,578
33297,FremontBridge,07/21/2016 09:00:00 AM,48,-122,112,190,302
33298,FremontBridge,07/21/2016 10:00:00 AM,48,-122,59,86,145
33299,FremontBridge,07/21/2016 11:00:00 AM,48,-122,55,58,113
33300,FremontBridge,07/21/2016 12:00:00 PM,48,-122,61,55,116
33301,FremontBridge,07/21/2016 01:00:00 PM,48,-122,62,67,129
33302,FremontBridge,07/21/2016 02:00:00 PM,48,-122,73,55,128
33303,FremontBridge,07/21/2016 03:00:00 PM,48,-122,118,78,196
33304,FremontBridge,07/21/2016 04:00:00 PM,48,-122,238,132,370
33305,FremontBridge,07/21/2016 05:00:00 PM,48,-122,501,194,695
33306,FremontBridge,07/21/2016 06:00:00 PM,48,-122,328,163,491
33307,FremontBridge,07/21/2016 07:00:00 PM,48,-122,171,88,259
33308,FremontBridge,07/21/2016 08:00:00 PM,48,-122,91,46,137
33309,FremontBridge,07/21/2016 09:00:00 PM,48,-122,54,35,89
33310,FremontBridge,07/21/2016 10:00:00 PM,48,-122,27,22,49
33311,FremontBridge,07/21/2016 11:00:00 PM,48,-122,21,20,41
33312,FremontBridge,07/22/2016 12:00:00 AM,48,-122,11,14,25
33313,FremontBridge,07/22/2016 01:00:00 AM,48,-122,4,4,8
33314,FremontBridge,07/22/2016 02:00:00 AM,48,-122,1,3,4
33315,FremontBridge,07/22/2016 03:00:00 AM,48,-122,2,4,6
33316,FremontBridge,07/22/2016 04:00:00 AM,48,-122,3,5,8
33317,FremontBridge,07/22/2016 05:00:00 AM,48,-122,11,16,27
33318,FremontBridge,07/22/2016 06:00:00 AM,48,-122,25,60,85
33319,FremontBridge,07/22/2016 07:00:00 AM,48,-122,45,98,143
33320,FremontBridge,07/22/2016 08:00:00 AM,48,-122,74,143,217
33321,FremontBridge,07/22/2016 09:00:00 AM,48,-122,70,78,148
33322,FremontBridge,07/22/2016 10:00:00 AM,48,-122,28,36,64
33323,FremontBridge,07/22/2016 11:00:00 AM,48,-122,20,21,41
33324,FremontBridge,07/22/2016 12:00:00 PM,48,-122,30,24,54
33325,FremontBridge,07/22/2016 01:00:00 PM,48,-122,36,50,86
33326,FremontBridge,07/22/2016 02:00:00 PM,48,-122,44,42,86
33327,FremontBridge,07/22/2016 03:00:00 PM,48,-122,72,43,115
33328,FremontBridge,07/22/2016 04:00:00 PM,48,-122,140,58,198
33329,FremontBridge,07/22/2016 05:00:00 PM,48,-122,194,77,271
33330,FremontBridge,07/22/2016 06:00:00 PM,48,-122,144,87,231
33331,FremontBridge,07/22/2016 07:00:00 PM,48,-122,68,44,112
33332,FremontBridge,07/22/2016 08:00:00 PM,48,-122,29,29,58
33333,FremontBridge,07/22/2016 09:00:00 PM,48,-122,18,18,36
33334,FremontBridge,07/22/2016 10:00:00 PM,48,-122,19,9,28
33335,FremontBridge,07/22/2016 11:00:00 PM,48,-122,15,12,27
33336,FremontBridge,07/23/2016 12:00:00 AM,48,-122,10,6,16
33337,FremontBridge,07/23/2016 01:00:00 AM,48,-122,5,6,11
33338,FremontBridge,07/23/2016 02:00:00 AM,48,-122,4,5,9
33339,FremontBridge,07/23/2016 03:00:00 AM,48,-122,1,3,4
33340,FremontBridge,07/23/2016 04:00:00 AM,48,-122,2,1,3
33341,FremontBridge,07/23/2016 05:00:00 AM,48,-122,7,6,13
33342,FremontBridge,07/23/2016 06:00:00 AM,48,-122,11,14,25
33343,FremontBridge,07/23/2016 07:00:00 AM,48,-122,28,25,53
33344,FremontBridge,07/23/2016 08:00:00 AM,48,-122,37,30,67
33345,FremontBridge,07/23/2016 09:00:00 AM,48,-122,44,66,110
33346,FremontBridge,07/23/2016 10:00:00 AM,48,-122,55,61,116
33347,FremontBridge,07/23/2016 11:00:00 AM,48,-122,70,66,136
33348,FremontBridge,07/23/2016 12:00:00 PM,48,-122,76,76,152
33349,FremontBridge,07/23/2016 01:00:00 PM,48,-122,88,84,172
33350,FremontBridge,07/23/2016 02:00:00 PM,48,-122,88,105,193
33351,FremontBridge,07/23/2016 03:00:00 PM,48,-122,79,93,172
33352,FremontBridge,07/23/2016 04:00:00 PM,48,-122,86,93,179
33353,FremontBridge,07/23/2016 05:00:00 PM,48,-122,79,72,151
33354,FremontBridge,07/23/2016 06:00:00 PM,48,-122,92,100,192
33355,FremontBridge,07/23/2016 07:00:00 PM,48,-122,52,47,99
33356,FremontBridge,07/23/2016 08:00:00 PM,48,-122,38,30,68
33357,FremontBridge,07/23/2016 09:00:00 PM,48,-122,27,35,62
33358,FremontBridge,07/23/2016 10:00:00 PM,48,-122,25,23,48
33359,FremontBridge,07/23/2016 11:00:00 PM,48,-122,36,20,56
33360,FremontBridge,07/24/2016 12:00:00 AM,48,-122,8,14,22
33361,FremontBridge,07/24/2016 01:00:00 AM,48,-122,7,11,18
33362,FremontBridge,07/24/2016 02:00:00 AM,48,-122,6,4,10
33363,FremontBridge,07/24/2016 03:00:00 AM,48,-122,3,3,6
33364,FremontBridge,07/24/2016 04:00:00 AM,48,-122,1,1,2
33365,FremontBridge,07/24/2016 05:00:00 AM,48,-122,5,4,9
33366,FremontBridge,07/24/2016 06:00:00 AM,48,-122,9,7,16
33367,FremontBridge,07/24/2016 07:00:00 AM,48,-122,13,26,39
33368,FremontBridge,07/24/2016 08:00:00 AM,48,-122,27,32,59
33369,FremontBridge,07/24/2016 09:00:00 AM,48,-122,42,59,101
33370,FremontBridge,07/24/2016 10:00:00 AM,48,-122,56,78,134
33371,FremontBridge,07/24/2016 11:00:00 AM,48,-122,101,113,214
33372,FremontBridge,07/24/2016 12:00:00 PM,48,-122,87,95,182
33373,FremontBridge,07/24/2016 01:00:00 PM,48,-122,103,104,207
33374,FremontBridge,07/24/2016 02:00:00 PM,48,-122,86,124,210
33375,FremontBridge,07/24/2016 03:00:00 PM,48,-122,90,108,198
33376,FremontBridge,07/24/2016 04:00:00 PM,48,-122,98,73,171
33377,FremontBridge,07/24/2016 05:00:00 PM,48,-122,87,89,176
33378,FremontBridge,07/24/2016 06:00:00 PM,48,-122,62,61,123
33379,FremontBridge,07/24/2016 07:00:00 PM,48,-122,57,47,104
33380,FremontBridge,07/24/2016 08:00:00 PM,48,-122,32,34,66
33381,FremontBridge,07/24/2016 09:00:00 PM,48,-122,23,24,47
33382,FremontBridge,07/24/2016 10:00:00 PM,48,-122,18,18,36
33383,FremontBridge,07/24/2016 11:00:00 PM,48,-122,13,7,20
33384,FremontBridge,07/25/2016 12:00:00 AM,48,-122,11,4,15
33385,FremontBridge,07/25/2016 01:00:00 AM,48,-122,3,2,5
33386,FremontBridge,07/25/2016 02:00:00 AM,48,-122,0,1,1
33387,FremontBridge,07/25/2016 03:00:00 AM,48,-122,5,2,7
33388,FremontBridge,07/25/2016 04:00:00 AM,48,-122,4,6,10
33389,FremontBridge,07/25/2016 05:00:00 AM,48,-122,13,33,46
33390,FremontBridge,07/25/2016 06:00:00 AM,48,-122,61,100,161
33391,FremontBridge,07/25/2016 07:00:00 AM,48,-122,158,301,459
33392,FremontBridge,07/25/2016 08:00:00 AM,48,-122,213,366,579
33393,FremontBridge,07/25/2016 09:00:00 AM,48,-122,151,191,342
33394,FremontBridge,07/25/2016 10:00:00 AM,48,-122,41,65,106
33395,FremontBridge,07/25/2016 11:00:00 AM,48,-122,43,49,92
33396,FremontBridge,07/25/2016 12:00:00 PM,48,-122,47,52,99
33397,FremontBridge,07/25/2016 01:00:00 PM,48,-122,41,58,99
33398,FremontBridge,07/25/2016 02:00:00 PM,48,-122,43,50,93
33399,FremontBridge,07/25/2016 03:00:00 PM,48,-122,101,48,149
33400,FremontBridge,07/25/2016 04:00:00 PM,48,-122,238,116,354
33401,FremontBridge,07/25/2016 05:00:00 PM,48,-122,531,188,719
33402,FremontBridge,07/25/2016 06:00:00 PM,48,-122,321,162,483
33403,FremontBridge,07/25/2016 07:00:00 PM,48,-122,168,96,264
33404,FremontBridge,07/25/2016 08:00:00 PM,48,-122,75,70,145
33405,FremontBridge,07/25/2016 09:00:00 PM,48,-122,40,51,91
33406,FremontBridge,07/25/2016 10:00:00 PM,48,-122,24,16,40
33407,FremontBridge,07/25/2016 11:00:00 PM,48,-122,10,6,16
33408,FremontBridge,07/26/2016 12:00:00 AM,48,-122,6,3,9
33409,FremontBridge,07/26/2016 01:00:00 AM,48,-122,4,2,6
33410,FremontBridge,07/26/2016 02:00:00 AM,48,-122,4,1,5
33411,FremontBridge,07/26/2016 03:00:00 AM,48,-122,2,3,5
33412,FremontBridge,07/26/2016 04:00:00 AM,48,-122,6,10,16
33413,FremontBridge,07/26/2016 05:00:00 AM,48,-122,19,31,50
33414,FremontBridge,07/26/2016 06:00:00 AM,48,-122,63,122,185
33415,FremontBridge,07/26/2016 07:00:00 AM,48,-122,154,332,486
33416,FremontBridge,07/26/2016 08:00:00 AM,48,-122,231,353,584
33417,FremontBridge,07/26/2016 09:00:00 AM,48,-122,140,196,336
33418,FremontBridge,07/26/2016 10:00:00 AM,48,-122,49,73,122
33419,FremontBridge,07/26/2016 11:00:00 AM,48,-122,40,50,90
33420,FremontBridge,07/26/2016 12:00:00 PM,48,-122,53,51,104
33421,FremontBridge,07/26/2016 01:00:00 PM,48,-122,52,59,111
33422,FremontBridge,07/26/2016 02:00:00 PM,48,-122,70,49,119
33423,FremontBridge,07/26/2016 03:00:00 PM,48,-122,120,93,213
33424,FremontBridge,07/26/2016 04:00:00 PM,48,-122,242,124,366
33425,FremontBridge,07/26/2016 05:00:00 PM,48,-122,561,219,780
33426,FremontBridge,07/26/2016 06:00:00 PM,48,-122,311,163,474
33427,FremontBridge,07/26/2016 07:00:00 PM,48,-122,188,124,312
33428,FremontBridge,07/26/2016 08:00:00 PM,48,-122,101,92,193
33429,FremontBridge,07/26/2016 09:00:00 PM,48,-122,55,52,107
33430,FremontBridge,07/26/2016 10:00:00 PM,48,-122,23,24,47
33431,FremontBridge,07/26/2016 11:00:00 PM,48,-122,11,13,24
33432,FremontBridge,07/27/2016 12:00:00 AM,48,-122,7,6,13
33433,FremontBridge,07/27/2016 01:00:00 AM,48,-122,5,1,6
33434,FremontBridge,07/27/2016 02:00:00 AM,48,-122,7,0,7
33435,FremontBridge,07/27/2016 03:00:00 AM,48,-122,0,2,2
33436,FremontBridge,07/27/2016 04:00:00 AM,48,-122,3,8,11
33437,FremontBridge,07/27/2016 05:00:00 AM,48,-122,21,35,56
33438,FremontBridge,07/27/2016 06:00:00 AM,48,-122,67,130,197
33439,FremontBridge,07/27/2016 07:00:00 AM,48,-122,177,328,505
33440,FremontBridge,07/27/2016 08:00:00 AM,48,-122,213,336,549
33441,FremontBridge,07/27/2016 09:00:00 AM,48,-122,141,191,332
33442,FremontBridge,07/27/2016 10:00:00 AM,48,-122,49,76,125
33443,FremontBridge,07/27/2016 11:00:00 AM,48,-122,48,46,94
33444,FremontBridge,07/27/2016 12:00:00 PM,48,-122,66,52,118
33445,FremontBridge,07/27/2016 01:00:00 PM,48,-122,47,48,95
33446,FremontBridge,07/27/2016 02:00:00 PM,48,-122,74,45,119
33447,FremontBridge,07/27/2016 03:00:00 PM,48,-122,110,71,181
33448,FremontBridge,07/27/2016 04:00:00 PM,48,-122,264,151,415
33449,FremontBridge,07/27/2016 05:00:00 PM,48,-122,568,215,783
33450,FremontBridge,07/27/2016 06:00:00 PM,48,-122,332,178,510
33451,FremontBridge,07/27/2016 07:00:00 PM,48,-122,176,120,296
33452,FremontBridge,07/27/2016 08:00:00 PM,48,-122,83,91,174
33453,FremontBridge,07/27/2016 09:00:00 PM,48,-122,73,30,103
33454,FremontBridge,07/27/2016 10:00:00 PM,48,-122,38,34,72
33455,FremontBridge,07/27/2016 11:00:00 PM,48,-122,17,14,31
33456,FremontBridge,07/28/2016 12:00:00 AM,48,-122,11,6,17
33457,FremontBridge,07/28/2016 01:00:00 AM,48,-122,5,2,7
33458,FremontBridge,07/28/2016 02:00:00 AM,48,-122,2,1,3
33459,FremontBridge,07/28/2016 03:00:00 AM,48,-122,2,0,2
33460,FremontBridge,07/28/2016 04:00:00 AM,48,-122,2,7,9
33461,FremontBridge,07/28/2016 05:00:00 AM,48,-122,19,28,47
33462,FremontBridge,07/28/2016 06:00:00 AM,48,-122,57,115,172
33463,FremontBridge,07/28/2016 07:00:00 AM,48,-122,145,310,455
33464,FremontBridge,07/28/2016 08:00:00 AM,48,-122,206,364,570
33465,FremontBridge,07/28/2016 09:00:00 AM,48,-122,128,186,314
33466,FremontBridge,07/28/2016 10:00:00 AM,48,-122,53,85,138
33467,FremontBridge,07/28/2016 11:00:00 AM,48,-122,54,57,111
33468,FremontBridge,07/28/2016 12:00:00 PM,48,-122,38,67,105
33469,FremontBridge,07/28/2016 01:00:00 PM,48,-122,65,55,120
33470,FremontBridge,07/28/2016 02:00:00 PM,48,-122,47,61,108
33471,FremontBridge,07/28/2016 03:00:00 PM,48,-122,123,59,182
33472,FremontBridge,07/28/2016 04:00:00 PM,48,-122,214,104,318
33473,FremontBridge,07/28/2016 05:00:00 PM,48,-122,499,215,714
33474,FremontBridge,07/28/2016 06:00:00 PM,48,-122,319,166,485
33475,FremontBridge,07/28/2016 07:00:00 PM,48,-122,147,84,231
33476,FremontBridge,07/28/2016 08:00:00 PM,48,-122,112,63,175
33477,FremontBridge,07/28/2016 09:00:00 PM,48,-122,52,60,112
33478,FremontBridge,07/28/2016 10:00:00 PM,48,-122,31,27,58
33479,FremontBridge,07/28/2016 11:00:00 PM,48,-122,15,15,30
33480,FremontBridge,07/29/2016 12:00:00 AM,48,-122,10,2,12
33481,FremontBridge,07/29/2016 01:00:00 AM,48,-122,7,6,13
33482,FremontBridge,07/29/2016 02:00:00 AM,48,-122,3,3,6
33483,FremontBridge,07/29/2016 03:00:00 AM,48,-122,2,3,5
33484,FremontBridge,07/29/2016 04:00:00 AM,48,-122,5,4,9
33485,FremontBridge,07/29/2016 05:00:00 AM,48,-122,14,25,39
33486,FremontBridge,07/29/2016 06:00:00 AM,48,-122,46,93,139
33487,FremontBridge,07/29/2016 07:00:00 AM,48,-122,117,254,371
33488,FremontBridge,07/29/2016 08:00:00 AM,48,-122,182,295,477
33489,FremontBridge,07/29/2016 09:00:00 AM,48,-122,121,186,307
33490,FremontBridge,07/29/2016 10:00:00 AM,48,-122,63,71,134
33491,FremontBridge,07/29/2016 11:00:00 AM,48,-122,56,59,115
33492,FremontBridge,07/29/2016 12:00:00 PM,48,-122,66,62,128
33493,FremontBridge,07/29/2016 01:00:00 PM,48,-122,42,56,98
33494,FremontBridge,07/29/2016 02:00:00 PM,48,-122,81,53,134
33495,FremontBridge,07/29/2016 03:00:00 PM,48,-122,132,83,215
33496,FremontBridge,07/29/2016 04:00:00 PM,48,-122,230,119,349
33497,FremontBridge,07/29/2016 05:00:00 PM,48,-122,389,146,535
33498,FremontBridge,07/29/2016 06:00:00 PM,48,-122,224,121,345
33499,FremontBridge,07/29/2016 07:00:00 PM,48,-122,124,58,182
33500,FremontBridge,07/29/2016 08:00:00 PM,48,-122,90,60,150
33501,FremontBridge,07/29/2016 09:00:00 PM,48,-122,38,28,66
33502,FremontBridge,07/29/2016 10:00:00 PM,48,-122,28,28,56
33503,FremontBridge,07/29/2016 11:00:00 PM,48,-122,20,33,53
33504,FremontBridge,07/30/2016 12:00:00 AM,48,-122,26,18,44
33505,FremontBridge,07/30/2016 01:00:00 AM,48,-122,6,9,15
33506,FremontBridge,07/30/2016 02:00:00 AM,48,-122,1,6,7
33507,FremontBridge,07/30/2016 03:00:00 AM,48,-122,3,1,4
33508,FremontBridge,07/30/2016 04:00:00 AM,48,-122,4,2,6
33509,FremontBridge,07/30/2016 05:00:00 AM,48,-122,5,6,11
33510,FremontBridge,07/30/2016 06:00:00 AM,48,-122,8,14,22
33511,FremontBridge,07/30/2016 07:00:00 AM,48,-122,31,27,58
33512,FremontBridge,07/30/2016 08:00:00 AM,48,-122,37,55,92
33513,FremontBridge,07/30/2016 09:00:00 AM,48,-122,55,72,127
33514,FremontBridge,07/30/2016 10:00:00 AM,48,-122,66,58,124
33515,FremontBridge,07/30/2016 11:00:00 AM,48,-122,59,75,134
33516,FremontBridge,07/30/2016 12:00:00 PM,48,-122,82,79,161
33517,FremontBridge,07/30/2016 01:00:00 PM,48,-122,100,100,200
33518,FremontBridge,07/30/2016 02:00:00 PM,48,-122,86,80,166
33519,FremontBridge,07/30/2016 03:00:00 PM,48,-122,98,96,194
33520,FremontBridge,07/30/2016 04:00:00 PM,48,-122,70,102,172
33521,FremontBridge,07/30/2016 05:00:00 PM,48,-122,101,84,185
33522,FremontBridge,07/30/2016 06:00:00 PM,48,-122,58,60,118
33523,FremontBridge,07/30/2016 07:00:00 PM,48,-122,65,32,97
33524,FremontBridge,07/30/2016 08:00:00 PM,48,-122,33,37,70
33525,FremontBridge,07/30/2016 09:00:00 PM,48,-122,31,19,50
33526,FremontBridge,07/30/2016 10:00:00 PM,48,-122,16,15,31
33527,FremontBridge,07/30/2016 11:00:00 PM,48,-122,31,12,43
33528,FremontBridge,07/31/2016 12:00:00 AM,48,-122,13,12,25
33529,FremontBridge,07/31/2016 01:00:00 AM,48,-122,11,2,13
33530,FremontBridge,07/31/2016 02:00:00 AM,48,-122,7,1,8
33531,FremontBridge,07/31/2016 03:00:00 AM,48,-122,4,0,4
33532,FremontBridge,07/31/2016 04:00:00 AM,48,-122,3,2,5
33533,FremontBridge,07/31/2016 05:00:00 AM,48,-122,4,2,6
33534,FremontBridge,07/31/2016 06:00:00 AM,48,-122,11,14,25
33535,FremontBridge,07/31/2016 07:00:00 AM,48,-122,15,17,32
33536,FremontBridge,07/31/2016 08:00:00 AM,48,-122,33,38,71
33537,FremontBridge,07/31/2016 09:00:00 AM,48,-122,45,59,104
33538,FremontBridge,07/31/2016 10:00:00 AM,48,-122,67,68,135
33539,FremontBridge,07/31/2016 11:00:00 AM,48,-122,79,87,166
33540,FremontBridge,07/31/2016 12:00:00 PM,48,-122,82,116,198
33541,FremontBridge,07/31/2016 01:00:00 PM,48,-122,76,66,142
33542,FremontBridge,07/31/2016 02:00:00 PM,48,-122,91,99,190
33543,FremontBridge,07/31/2016 03:00:00 PM,48,-122,95,122,217
33544,FremontBridge,07/31/2016 04:00:00 PM,48,-122,101,114,215
33545,FremontBridge,07/31/2016 05:00:00 PM,48,-122,85,84,169
33546,FremontBridge,07/31/2016 06:00:00 PM,48,-122,63,66,129
33547,FremontBridge,07/31/2016 07:00:00 PM,48,-122,46,49,95
33548,FremontBridge,07/31/2016 08:00:00 PM,48,-122,42,31,73
33549,FremontBridge,07/31/2016 09:00:00 PM,48,-122,21,23,44
33550,FremontBridge,07/31/2016 10:00:00 PM,48,-122,11,14,25
33551,FremontBridge,07/31/2016 11:00:00 PM,48,-122,6,8,14
33552,FremontBridge,08/01/2016 12:00:00 AM,48,-122,8,3,11
33553,FremontBridge,08/01/2016 01:00:00 AM,48,-122,7,3,10
33554,FremontBridge,08/01/2016 02:00:00 AM,48,-122,4,2,6
33555,FremontBridge,08/01/2016 03:00:00 AM,48,-122,1,2,3
33556,FremontBridge,08/01/2016 04:00:00 AM,48,-122,6,4,10
33557,FremontBridge,08/01/2016 05:00:00 AM,48,-122,20,32,52
33558,FremontBridge,08/01/2016 06:00:00 AM,48,-122,57,121,178
33559,FremontBridge,08/01/2016 07:00:00 AM,48,-122,120,274,394
33560,FremontBridge,08/01/2016 08:00:00 AM,48,-122,227,382,609
33561,FremontBridge,08/01/2016 09:00:00 AM,48,-122,128,197,325
33562,FremontBridge,08/01/2016 10:00:00 AM,48,-122,49,51,100
33563,FremontBridge,08/01/2016 11:00:00 AM,48,-122,28,46,74
33564,FremontBridge,08/01/2016 12:00:00 PM,48,-122,41,41,82
33565,FremontBridge,08/01/2016 01:00:00 PM,48,-122,44,49,93
33566,FremontBridge,08/01/2016 02:00:00 PM,48,-122,58,61,119
33567,FremontBridge,08/01/2016 03:00:00 PM,48,-122,98,70,168
33568,FremontBridge,08/01/2016 04:00:00 PM,48,-122,221,102,323
33569,FremontBridge,08/01/2016 05:00:00 PM,48,-122,462,173,635
33570,FremontBridge,08/01/2016 06:00:00 PM,48,-122,373,185,558
33571,FremontBridge,08/01/2016 07:00:00 PM,48,-122,129,99,228
33572,FremontBridge,08/01/2016 08:00:00 PM,48,-122,77,56,133
33573,FremontBridge,08/01/2016 09:00:00 PM,48,-122,49,27,76
33574,FremontBridge,08/01/2016 10:00:00 PM,48,-122,35,8,43
33575,FremontBridge,08/01/2016 11:00:00 PM,48,-122,8,11,19
33576,FremontBridge,08/02/2016 12:00:00 AM,48,-122,6,1,7
33577,FremontBridge,08/02/2016 01:00:00 AM,48,-122,2,3,5
33578,FremontBridge,08/02/2016 02:00:00 AM,48,-122,1,0,1
33579,FremontBridge,08/02/2016 03:00:00 AM,48,-122,1,0,1
33580,FremontBridge,08/02/2016 04:00:00 AM,48,-122,4,6,10
33581,FremontBridge,08/02/2016 05:00:00 AM,48,-122,15,24,39
33582,FremontBridge,08/02/2016 06:00:00 AM,48,-122,56,97,153
33583,FremontBridge,08/02/2016 07:00:00 AM,48,-122,98,235,333
33584,FremontBridge,08/02/2016 08:00:00 AM,48,-122,192,320,512
33585,FremontBridge,08/02/2016 09:00:00 AM,48,-122,97,151,248
33586,FremontBridge,08/02/2016 10:00:00 AM,48,-122,39,59,98
33587,FremontBridge,08/02/2016 11:00:00 AM,48,-122,21,40,61
33588,FremontBridge,08/02/2016 12:00:00 PM,48,-122,32,47,79
33589,FremontBridge,08/02/2016 01:00:00 PM,48,-122,34,38,72
33590,FremontBridge,08/02/2016 02:00:00 PM,48,-122,48,36,84
33591,FremontBridge,08/02/2016 03:00:00 PM,48,-122,78,57,135
33592,FremontBridge,08/02/2016 04:00:00 PM,48,-122,210,93,303
33593,FremontBridge,08/02/2016 05:00:00 PM,48,-122,406,167,573
33594,FremontBridge,08/02/2016 06:00:00 PM,48,-122,272,144,416
33595,FremontBridge,08/02/2016 07:00:00 PM,48,-122,128,63,191
33596,FremontBridge,08/02/2016 08:00:00 PM,48,-122,44,49,93
33597,FremontBridge,08/02/2016 09:00:00 PM,48,-122,26,50,76
33598,FremontBridge,08/02/2016 10:00:00 PM,48,-122,29,13,42
33599,FremontBridge,08/02/2016 11:00:00 PM,48,-122,13,12,25
33600,FremontBridge,08/03/2016 12:00:00 AM,48,-122,8,3,11
33601,FremontBridge,08/03/2016 01:00:00 AM,48,-122,4,2,6
33602,FremontBridge,08/03/2016 02:00:00 AM,48,-122,2,0,2
33603,FremontBridge,08/03/2016 03:00:00 AM,48,-122,1,0,1
33604,FremontBridge,08/03/2016 04:00:00 AM,48,-122,4,9,13
33605,FremontBridge,08/03/2016 05:00:00 AM,48,-122,14,32,46
33606,FremontBridge,08/03/2016 06:00:00 AM,48,-122,71,108,179
33607,FremontBridge,08/03/2016 07:00:00 AM,48,-122,124,275,399
33608,FremontBridge,08/03/2016 08:00:00 AM,48,-122,216,389,605
33609,FremontBridge,08/03/2016 09:00:00 AM,48,-122,128,195,323
33610,FremontBridge,08/03/2016 10:00:00 AM,48,-122,56,77,133
33611,FremontBridge,08/03/2016 11:00:00 AM,48,-122,42,50,92
33612,FremontBridge,08/03/2016 12:00:00 PM,48,-122,48,49,97
33613,FremontBridge,08/03/2016 01:00:00 PM,48,-122,40,58,98
33614,FremontBridge,08/03/2016 02:00:00 PM,48,-122,67,47,114
33615,FremontBridge,08/03/2016 03:00:00 PM,48,-122,93,68,161
33616,FremontBridge,08/03/2016 04:00:00 PM,48,-122,287,109,396
33617,FremontBridge,08/03/2016 05:00:00 PM,48,-122,507,198,705
33618,FremontBridge,08/03/2016 06:00:00 PM,48,-122,340,206,546
33619,FremontBridge,08/03/2016 07:00:00 PM,48,-122,166,94,260
33620,FremontBridge,08/03/2016 08:00:00 PM,48,-122,111,56,167
33621,FremontBridge,08/03/2016 09:00:00 PM,48,-122,47,49,96
33622,FremontBridge,08/03/2016 10:00:00 PM,48,-122,25,27,52
33623,FremontBridge,08/03/2016 11:00:00 PM,48,-122,12,7,19
33624,FremontBridge,08/04/2016 12:00:00 AM,48,-122,11,9,20
33625,FremontBridge,08/04/2016 01:00:00 AM,48,-122,3,0,3
33626,FremontBridge,08/04/2016 02:00:00 AM,48,-122,2,0,2
33627,FremontBridge,08/04/2016 03:00:00 AM,48,-122,2,3,5
33628,FremontBridge,08/04/2016 04:00:00 AM,48,-122,5,2,7
33629,FremontBridge,08/04/2016 05:00:00 AM,48,-122,20,29,49
33630,FremontBridge,08/04/2016 06:00:00 AM,48,-122,59,115,174
33631,FremontBridge,08/04/2016 07:00:00 AM,48,-122,140,292,432
33632,FremontBridge,08/04/2016 08:00:00 AM,48,-122,197,378,575
33633,FremontBridge,08/04/2016 09:00:00 AM,48,-122,148,176,324
33634,FremontBridge,08/04/2016 10:00:00 AM,48,-122,63,80,143
33635,FremontBridge,08/04/2016 11:00:00 AM,48,-122,53,53,106
33636,FremontBridge,08/04/2016 12:00:00 PM,48,-122,55,65,120
33637,FremontBridge,08/04/2016 01:00:00 PM,48,-122,45,68,113
33638,FremontBridge,08/04/2016 02:00:00 PM,48,-122,64,48,112
33639,FremontBridge,08/04/2016 03:00:00 PM,48,-122,90,62,152
33640,FremontBridge,08/04/2016 04:00:00 PM,48,-122,267,149,416
33641,FremontBridge,08/04/2016 05:00:00 PM,48,-122,467,194,661
33642,FremontBridge,08/04/2016 06:00:00 PM,48,-122,340,172,512
33643,FremontBridge,08/04/2016 07:00:00 PM,48,-122,153,92,245
33644,FremontBridge,08/04/2016 08:00:00 PM,48,-122,108,61,169
33645,FremontBridge,08/04/2016 09:00:00 PM,48,-122,43,43,86
33646,FremontBridge,08/04/2016 10:00:00 PM,48,-122,31,33,64
33647,FremontBridge,08/04/2016 11:00:00 PM,48,-122,21,12,33
33648,FremontBridge,08/05/2016 12:00:00 AM,48,-122,16,10,26
33649,FremontBridge,08/05/2016 01:00:00 AM,48,-122,5,3,8
33650,FremontBridge,08/05/2016 02:00:00 AM,48,-122,6,0,6
33651,FremontBridge,08/05/2016 03:00:00 AM,48,-122,6,1,7
33652,FremontBridge,08/05/2016 04:00:00 AM,48,-122,6,5,11
33653,FremontBridge,08/05/2016 05:00:00 AM,48,-122,11,34,45
33654,FremontBridge,08/05/2016 06:00:00 AM,48,-122,40,98,138
33655,FremontBridge,08/05/2016 07:00:00 AM,48,-122,106,242,348
33656,FremontBridge,08/05/2016 08:00:00 AM,48,-122,179,287,466
33657,FremontBridge,08/05/2016 09:00:00 AM,48,-122,128,150,278
33658,FremontBridge,08/05/2016 10:00:00 AM,48,-122,58,79,137
33659,FremontBridge,08/05/2016 11:00:00 AM,48,-122,50,63,113
33660,FremontBridge,08/05/2016 12:00:00 PM,48,-122,49,69,118
33661,FremontBridge,08/05/2016 01:00:00 PM,48,-122,54,49,103
33662,FremontBridge,08/05/2016 02:00:00 PM,48,-122,61,54,115
33663,FremontBridge,08/05/2016 03:00:00 PM,48,-122,122,78,200
33664,FremontBridge,08/05/2016 04:00:00 PM,48,-122,252,122,374
33665,FremontBridge,08/05/2016 05:00:00 PM,48,-122,380,182,562
33666,FremontBridge,08/05/2016 06:00:00 PM,48,-122,236,113,349
33667,FremontBridge,08/05/2016 07:00:00 PM,48,-122,95,82,177
33668,FremontBridge,08/05/2016 08:00:00 PM,48,-122,84,46,130
33669,FremontBridge,08/05/2016 09:00:00 PM,48,-122,41,32,73
33670,FremontBridge,08/05/2016 10:00:00 PM,48,-122,29,13,42
33671,FremontBridge,08/05/2016 11:00:00 PM,48,-122,19,10,29
33672,FremontBridge,08/06/2016 12:00:00 AM,48,-122,14,9,23
33673,FremontBridge,08/06/2016 01:00:00 AM,48,-122,10,6,16
33674,FremontBridge,08/06/2016 02:00:00 AM,48,-122,5,3,8
33675,FremontBridge,08/06/2016 03:00:00 AM,48,-122,4,3,7
33676,FremontBridge,08/06/2016 04:00:00 AM,48,-122,3,5,8
33677,FremontBridge,08/06/2016 05:00:00 AM,48,-122,6,4,10
33678,FremontBridge,08/06/2016 06:00:00 AM,48,-122,15,12,27
33679,FremontBridge,08/06/2016 07:00:00 AM,48,-122,24,32,56
33680,FremontBridge,08/06/2016 08:00:00 AM,48,-122,38,47,85
33681,FremontBridge,08/06/2016 09:00:00 AM,48,-122,57,49,106
33682,FremontBridge,08/06/2016 10:00:00 AM,48,-122,60,60,120
33683,FremontBridge,08/06/2016 11:00:00 AM,48,-122,78,73,151
33684,FremontBridge,08/06/2016 12:00:00 PM,48,-122,63,67,130
33685,FremontBridge,08/06/2016 01:00:00 PM,48,-122,71,67,138
33686,FremontBridge,08/06/2016 02:00:00 PM,48,-122,68,59,127
33687,FremontBridge,08/06/2016 03:00:00 PM,48,-122,82,77,159
33688,FremontBridge,08/06/2016 04:00:00 PM,48,-122,98,84,182
33689,FremontBridge,08/06/2016 05:00:00 PM,48,-122,98,100,198
33690,FremontBridge,08/06/2016 06:00:00 PM,48,-122,61,77,138
33691,FremontBridge,08/06/2016 07:00:00 PM,48,-122,62,49,111
33692,FremontBridge,08/06/2016 08:00:00 PM,48,-122,43,36,79
33693,FremontBridge,08/06/2016 09:00:00 PM,48,-122,20,12,32
33694,FremontBridge,08/06/2016 10:00:00 PM,48,-122,20,8,28
33695,FremontBridge,08/06/2016 11:00:00 PM,48,-122,27,12,39
33696,FremontBridge,08/07/2016 12:00:00 AM,48,-122,26,8,34
33697,FremontBridge,08/07/2016 01:00:00 AM,48,-122,17,8,25
33698,FremontBridge,08/07/2016 02:00:00 AM,48,-122,13,3,16
33699,FremontBridge,08/07/2016 03:00:00 AM,48,-122,4,1,5
33700,FremontBridge,08/07/2016 04:00:00 AM,48,-122,1,0,1
33701,FremontBridge,08/07/2016 05:00:00 AM,48,-122,6,2,8
33702,FremontBridge,08/07/2016 06:00:00 AM,48,-122,5,11,16
33703,FremontBridge,08/07/2016 07:00:00 AM,48,-122,18,21,39
33704,FremontBridge,08/07/2016 08:00:00 AM,48,-122,23,45,68
33705,FremontBridge,08/07/2016 09:00:00 AM,48,-122,40,58,98
33706,FremontBridge,08/07/2016 10:00:00 AM,48,-122,55,65,120
33707,FremontBridge,08/07/2016 11:00:00 AM,48,-122,59,81,140
33708,FremontBridge,08/07/2016 12:00:00 PM,48,-122,60,48,108
33709,FremontBridge,08/07/2016 01:00:00 PM,48,-122,87,93,180
33710,FremontBridge,08/07/2016 02:00:00 PM,48,-122,64,70,134
33711,FremontBridge,08/07/2016 03:00:00 PM,48,-122,79,76,155
33712,FremontBridge,08/07/2016 04:00:00 PM,48,-122,56,65,121
33713,FremontBridge,08/07/2016 05:00:00 PM,48,-122,49,46,95
33714,FremontBridge,08/07/2016 06:00:00 PM,48,-122,52,50,102
33715,FremontBridge,08/07/2016 07:00:00 PM,48,-122,33,34,67
33716,FremontBridge,08/07/2016 08:00:00 PM,48,-122,15,21,36
33717,FremontBridge,08/07/2016 09:00:00 PM,48,-122,7,4,11
33718,FremontBridge,08/07/2016 10:00:00 PM,48,-122,11,3,14
33719,FremontBridge,08/07/2016 11:00:00 PM,48,-122,7,4,11
33720,FremontBridge,08/08/2016 12:00:00 AM,48,-122,8,2,10
33721,FremontBridge,08/08/2016 01:00:00 AM,48,-122,4,1,5
33722,FremontBridge,08/08/2016 02:00:00 AM,48,-122,3,1,4
33723,FremontBridge,08/08/2016 03:00:00 AM,48,-122,0,2,2
33724,FremontBridge,08/08/2016 04:00:00 AM,48,-122,7,5,12
33725,FremontBridge,08/08/2016 05:00:00 AM,48,-122,7,22,29
33726,FremontBridge,08/08/2016 06:00:00 AM,48,-122,38,78,116
33727,FremontBridge,08/08/2016 07:00:00 AM,48,-122,115,243,358
33728,FremontBridge,08/08/2016 08:00:00 AM,48,-122,172,277,449
33729,FremontBridge,08/08/2016 09:00:00 AM,48,-122,122,149,271
33730,FremontBridge,08/08/2016 10:00:00 AM,48,-122,46,55,101
33731,FremontBridge,08/08/2016 11:00:00 AM,48,-122,47,35,82
33732,FremontBridge,08/08/2016 12:00:00 PM,48,-122,35,44,79
33733,FremontBridge,08/08/2016 01:00:00 PM,48,-122,41,41,82
33734,FremontBridge,08/08/2016 02:00:00 PM,48,-122,50,43,93
33735,FremontBridge,08/08/2016 03:00:00 PM,48,-122,74,38,112
33736,FremontBridge,08/08/2016 04:00:00 PM,48,-122,216,79,295
33737,FremontBridge,08/08/2016 05:00:00 PM,48,-122,424,164,588
33738,FremontBridge,08/08/2016 06:00:00 PM,48,-122,286,129,415
33739,FremontBridge,08/08/2016 07:00:00 PM,48,-122,134,74,208
33740,FremontBridge,08/08/2016 08:00:00 PM,48,-122,58,43,101
33741,FremontBridge,08/08/2016 09:00:00 PM,48,-122,25,23,48
33742,FremontBridge,08/08/2016 10:00:00 PM,48,-122,18,15,33
33743,FremontBridge,08/08/2016 11:00:00 PM,48,-122,13,7,20
33744,FremontBridge,08/09/2016 12:00:00 AM,48,-122,13,6,19
33745,FremontBridge,08/09/2016 01:00:00 AM,48,-122,4,6,10
33746,FremontBridge,08/09/2016 02:00:00 AM,48,-122,1,0,1
33747,FremontBridge,08/09/2016 03:00:00 AM,48,-122,0,1,1
33748,FremontBridge,08/09/2016 04:00:00 AM,48,-122,4,5,9
33749,FremontBridge,08/09/2016 05:00:00 AM,48,-122,12,30,42
33750,FremontBridge,08/09/2016 06:00:00 AM,48,-122,64,104,168
33751,FremontBridge,08/09/2016 07:00:00 AM,48,-122,134,258,392
33752,FremontBridge,08/09/2016 08:00:00 AM,48,-122,232,351,583
33753,FremontBridge,08/09/2016 09:00:00 AM,48,-122,114,185,299
33754,FremontBridge,08/09/2016 10:00:00 AM,48,-122,52,66,118
33755,FremontBridge,08/09/2016 11:00:00 AM,48,-122,31,47,78
33756,FremontBridge,08/09/2016 12:00:00 PM,48,-122,52,45,97
33757,FremontBridge,08/09/2016 01:00:00 PM,48,-122,35,48,83
33758,FremontBridge,08/09/2016 02:00:00 PM,48,-122,41,45,86
33759,FremontBridge,08/09/2016 03:00:00 PM,48,-122,118,79,197
33760,FremontBridge,08/09/2016 04:00:00 PM,48,-122,247,118,365
33761,FremontBridge,08/09/2016 05:00:00 PM,48,-122,506,172,678
33762,FremontBridge,08/09/2016 06:00:00 PM,48,-122,288,183,471
33763,FremontBridge,08/09/2016 07:00:00 PM,48,-122,117,83,200
33764,FremontBridge,08/09/2016 08:00:00 PM,48,-122,73,49,122
33765,FremontBridge,08/09/2016 09:00:00 PM,48,-122,32,34,66
33766,FremontBridge,08/09/2016 10:00:00 PM,48,-122,22,24,46
33767,FremontBridge,08/09/2016 11:00:00 PM,48,-122,22,8,30
33768,FremontBridge,08/10/2016 12:00:00 AM,48,-122,7,4,11
33769,FremontBridge,08/10/2016 01:00:00 AM,48,-122,3,2,5
33770,FremontBridge,08/10/2016 02:00:00 AM,48,-122,2,0,2
33771,FremontBridge,08/10/2016 03:00:00 AM,48,-122,0,0,0
33772,FremontBridge,08/10/2016 04:00:00 AM,48,-122,4,8,12
33773,FremontBridge,08/10/2016 05:00:00 AM,48,-122,15,28,43
33774,FremontBridge,08/10/2016 06:00:00 AM,48,-122,56,114,170
33775,FremontBridge,08/10/2016 07:00:00 AM,48,-122,157,272,429
33776,FremontBridge,08/10/2016 08:00:00 AM,48,-122,227,368,595
33777,FremontBridge,08/10/2016 09:00:00 AM,48,-122,132,204,336
33778,FremontBridge,08/10/2016 10:00:00 AM,48,-122,52,67,119
33779,FremontBridge,08/10/2016 11:00:00 AM,48,-122,54,51,105
33780,FremontBridge,08/10/2016 12:00:00 PM,48,-122,49,48,97
33781,FremontBridge,08/10/2016 01:00:00 PM,48,-122,55,54,109
33782,FremontBridge,08/10/2016 02:00:00 PM,48,-122,65,63,128
33783,FremontBridge,08/10/2016 03:00:00 PM,48,-122,111,69,180
33784,FremontBridge,08/10/2016 04:00:00 PM,48,-122,226,105,331
33785,FremontBridge,08/10/2016 05:00:00 PM,48,-122,550,217,767
33786,FremontBridge,08/10/2016 06:00:00 PM,48,-122,307,181,488
33787,FremontBridge,08/10/2016 07:00:00 PM,48,-122,144,111,255
33788,FremontBridge,08/10/2016 08:00:00 PM,48,-122,101,50,151
33789,FremontBridge,08/10/2016 09:00:00 PM,48,-122,51,37,88
33790,FremontBridge,08/10/2016 10:00:00 PM,48,-122,33,20,53
33791,FremontBridge,08/10/2016 11:00:00 PM,48,-122,29,7,36
33792,FremontBridge,08/11/2016 12:00:00 AM,48,-122,11,8,19
33793,FremontBridge,08/11/2016 01:00:00 AM,48,-122,4,4,8
33794,FremontBridge,08/11/2016 02:00:00 AM,48,-122,4,0,4
33795,FremontBridge,08/11/2016 03:00:00 AM,48,-122,0,1,1
33796,FremontBridge,08/11/2016 04:00:00 AM,48,-122,6,10,16
33797,FremontBridge,08/11/2016 05:00:00 AM,48,-122,18,33,51
33798,FremontBridge,08/11/2016 06:00:00 AM,48,-122,65,111,176
33799,FremontBridge,08/11/2016 07:00:00 AM,48,-122,142,275,417
33800,FremontBridge,08/11/2016 08:00:00 AM,48,-122,247,368,615
33801,FremontBridge,08/11/2016 09:00:00 AM,48,-122,131,197,328
33802,FremontBridge,08/11/2016 10:00:00 AM,48,-122,61,60,121
33803,FremontBridge,08/11/2016 11:00:00 AM,48,-122,37,61,98
33804,FremontBridge,08/11/2016 12:00:00 PM,48,-122,58,57,115
33805,FremontBridge,08/11/2016 01:00:00 PM,48,-122,58,52,110
33806,FremontBridge,08/11/2016 02:00:00 PM,48,-122,69,59,128
33807,FremontBridge,08/11/2016 03:00:00 PM,48,-122,107,62,169
33808,FremontBridge,08/11/2016 04:00:00 PM,48,-122,231,129,360
33809,FremontBridge,08/11/2016 05:00:00 PM,48,-122,550,194,744
33810,FremontBridge,08/11/2016 06:00:00 PM,48,-122,310,182,492
33811,FremontBridge,08/11/2016 07:00:00 PM,48,-122,133,100,233
33812,FremontBridge,08/11/2016 08:00:00 PM,48,-122,91,81,172
33813,FremontBridge,08/11/2016 09:00:00 PM,48,-122,58,49,107
33814,FremontBridge,08/11/2016 10:00:00 PM,48,-122,35,24,59
33815,FremontBridge,08/11/2016 11:00:00 PM,48,-122,17,9,26
33816,FremontBridge,08/12/2016 12:00:00 AM,48,-122,5,2,7
33817,FremontBridge,08/12/2016 01:00:00 AM,48,-122,7,4,11
33818,FremontBridge,08/12/2016 02:00:00 AM,48,-122,2,3,5
33819,FremontBridge,08/12/2016 03:00:00 AM,48,-122,1,1,2
33820,FremontBridge,08/12/2016 04:00:00 AM,48,-122,6,5,11
33821,FremontBridge,08/12/2016 05:00:00 AM,48,-122,17,20,37
33822,FremontBridge,08/12/2016 06:00:00 AM,48,-122,66,88,154
33823,FremontBridge,08/12/2016 07:00:00 AM,48,-122,119,218,337
33824,FremontBridge,08/12/2016 08:00:00 AM,48,-122,190,302,492
33825,FremontBridge,08/12/2016 09:00:00 AM,48,-122,121,144,265
33826,FremontBridge,08/12/2016 10:00:00 AM,48,-122,63,72,135
33827,FremontBridge,08/12/2016 11:00:00 AM,48,-122,60,46,106
33828,FremontBridge,08/12/2016 12:00:00 PM,48,-122,78,58,136
33829,FremontBridge,08/12/2016 01:00:00 PM,48,-122,47,58,105
33830,FremontBridge,08/12/2016 02:00:00 PM,48,-122,76,54,130
33831,FremontBridge,08/12/2016 03:00:00 PM,48,-122,127,87,214
33832,FremontBridge,08/12/2016 04:00:00 PM,48,-122,241,101,342
33833,FremontBridge,08/12/2016 05:00:00 PM,48,-122,399,151,550
33834,FremontBridge,08/12/2016 06:00:00 PM,48,-122,216,120,336
33835,FremontBridge,08/12/2016 07:00:00 PM,48,-122,119,59,178
33836,FremontBridge,08/12/2016 08:00:00 PM,48,-122,88,48,136
33837,FremontBridge,08/12/2016 09:00:00 PM,48,-122,43,42,85
33838,FremontBridge,08/12/2016 10:00:00 PM,48,-122,22,25,47
33839,FremontBridge,08/12/2016 11:00:00 PM,48,-122,38,14,52
33840,FremontBridge,08/13/2016 12:00:00 AM,48,-122,10,6,16
33841,FremontBridge,08/13/2016 01:00:00 AM,48,-122,9,5,14
33842,FremontBridge,08/13/2016 02:00:00 AM,48,-122,8,3,11
33843,FremontBridge,08/13/2016 03:00:00 AM,48,-122,0,1,1
33844,FremontBridge,08/13/2016 04:00:00 AM,48,-122,4,0,4
33845,FremontBridge,08/13/2016 05:00:00 AM,48,-122,10,5,15
33846,FremontBridge,08/13/2016 06:00:00 AM,48,-122,20,23,43
33847,FremontBridge,08/13/2016 07:00:00 AM,48,-122,20,25,45
33848,FremontBridge,08/13/2016 08:00:00 AM,48,-122,39,52,91
33849,FremontBridge,08/13/2016 09:00:00 AM,48,-122,51,76,127
33850,FremontBridge,08/13/2016 10:00:00 AM,48,-122,60,90,150
33851,FremontBridge,08/13/2016 11:00:00 AM,48,-122,85,79,164
33852,FremontBridge,08/13/2016 12:00:00 PM,48,-122,81,71,152
33853,FremontBridge,08/13/2016 01:00:00 PM,48,-122,71,68,139
33854,FremontBridge,08/13/2016 02:00:00 PM,48,-122,72,60,132
33855,FremontBridge,08/13/2016 03:00:00 PM,48,-122,77,76,153
33856,FremontBridge,08/13/2016 04:00:00 PM,48,-122,70,47,117
33857,FremontBridge,08/13/2016 05:00:00 PM,48,-122,67,75,142
33858,FremontBridge,08/13/2016 06:00:00 PM,48,-122,53,59,112
33859,FremontBridge,08/13/2016 07:00:00 PM,48,-122,42,40,82
33860,FremontBridge,08/13/2016 08:00:00 PM,48,-122,48,39,87
33861,FremontBridge,08/13/2016 09:00:00 PM,48,-122,16,32,48
33862,FremontBridge,08/13/2016 10:00:00 PM,48,-122,15,5,20
33863,FremontBridge,08/13/2016 11:00:00 PM,48,-122,16,10,26
33864,FremontBridge,08/14/2016 12:00:00 AM,48,-122,17,6,23
33865,FremontBridge,08/14/2016 01:00:00 AM,48,-122,15,3,18
33866,FremontBridge,08/14/2016 02:00:00 AM,48,-122,5,0,5
33867,FremontBridge,08/14/2016 03:00:00 AM,48,-122,2,3,5
33868,FremontBridge,08/14/2016 04:00:00 AM,48,-122,1,1,2
33869,FremontBridge,08/14/2016 05:00:00 AM,48,-122,4,0,4
33870,FremontBridge,08/14/2016 06:00:00 AM,48,-122,14,16,30
33871,FremontBridge,08/14/2016 07:00:00 AM,48,-122,24,39,63
33872,FremontBridge,08/14/2016 08:00:00 AM,48,-122,45,60,105
33873,FremontBridge,08/14/2016 09:00:00 AM,48,-122,62,65,127
33874,FremontBridge,08/14/2016 10:00:00 AM,48,-122,80,76,156
33875,FremontBridge,08/14/2016 11:00:00 AM,48,-122,163,105,268
33876,FremontBridge,08/14/2016 12:00:00 PM,48,-122,224,104,328
33877,FremontBridge,08/14/2016 01:00:00 PM,48,-122,149,97,246
33878,FremontBridge,08/14/2016 02:00:00 PM,48,-122,161,122,283
33879,FremontBridge,08/14/2016 03:00:00 PM,48,-122,132,111,243
33880,FremontBridge,08/14/2016 04:00:00 PM,48,-122,89,86,175
33881,FremontBridge,08/14/2016 05:00:00 PM,48,-122,69,62,131
33882,FremontBridge,08/14/2016 06:00:00 PM,48,-122,67,74,141
33883,FremontBridge,08/14/2016 07:00:00 PM,48,-122,31,52,83
33884,FremontBridge,08/14/2016 08:00:00 PM,48,-122,39,38,77
33885,FremontBridge,08/14/2016 09:00:00 PM,48,-122,24,22,46
33886,FremontBridge,08/14/2016 10:00:00 PM,48,-122,11,17,28
33887,FremontBridge,08/14/2016 11:00:00 PM,48,-122,11,4,15
33888,FremontBridge,08/15/2016 12:00:00 AM,48,-122,5,2,7
33889,FremontBridge,08/15/2016 01:00:00 AM,48,-122,3,1,4
33890,FremontBridge,08/15/2016 02:00:00 AM,48,-122,4,1,5
33891,FremontBridge,08/15/2016 03:00:00 AM,48,-122,1,1,2
33892,FremontBridge,08/15/2016 04:00:00 AM,48,-122,6,6,12
33893,FremontBridge,08/15/2016 05:00:00 AM,48,-122,13,29,42
33894,FremontBridge,08/15/2016 06:00:00 AM,48,-122,54,93,147
33895,FremontBridge,08/15/2016 07:00:00 AM,48,-122,148,297,445
33896,FremontBridge,08/15/2016 08:00:00 AM,48,-122,234,373,607
33897,FremontBridge,08/15/2016 09:00:00 AM,48,-122,145,178,323
33898,FremontBridge,08/15/2016 10:00:00 AM,48,-122,57,61,118
33899,FremontBridge,08/15/2016 11:00:00 AM,48,-122,48,35,83
33900,FremontBridge,08/15/2016 12:00:00 PM,48,-122,47,44,91
33901,FremontBridge,08/15/2016 01:00:00 PM,48,-122,52,56,108
33902,FremontBridge,08/15/2016 02:00:00 PM,48,-122,38,57,95
33903,FremontBridge,08/15/2016 03:00:00 PM,48,-122,84,70,154
33904,FremontBridge,08/15/2016 04:00:00 PM,48,-122,244,127,371
33905,FremontBridge,08/15/2016 05:00:00 PM,48,-122,525,179,704
33906,FremontBridge,08/15/2016 06:00:00 PM,48,-122,301,160,461
33907,FremontBridge,08/15/2016 07:00:00 PM,48,-122,177,105,282
33908,FremontBridge,08/15/2016 08:00:00 PM,48,-122,94,62,156
33909,FremontBridge,08/15/2016 09:00:00 PM,48,-122,47,34,81
33910,FremontBridge,08/15/2016 10:00:00 PM,48,-122,21,13,34
33911,FremontBridge,08/15/2016 11:00:00 PM,48,-122,22,12,34
33912,FremontBridge,08/16/2016 12:00:00 AM,48,-122,9,2,11
33913,FremontBridge,08/16/2016 01:00:00 AM,48,-122,4,4,8
33914,FremontBridge,08/16/2016 02:00:00 AM,48,-122,4,0,4
33915,FremontBridge,08/16/2016 03:00:00 AM,48,-122,1,2,3
33916,FremontBridge,08/16/2016 04:00:00 AM,48,-122,3,6,9
33917,FremontBridge,08/16/2016 05:00:00 AM,48,-122,17,31,48
33918,FremontBridge,08/16/2016 06:00:00 AM,48,-122,74,111,185
33919,FremontBridge,08/16/2016 07:00:00 AM,48,-122,130,326,456
33920,FremontBridge,08/16/2016 08:00:00 AM,48,-122,255,414,669
33921,FremontBridge,08/16/2016 09:00:00 AM,48,-122,143,183,326
33922,FremontBridge,08/16/2016 10:00:00 AM,48,-122,56,65,121
33923,FremontBridge,08/16/2016 11:00:00 AM,48,-122,57,56,113
33924,FremontBridge,08/16/2016 12:00:00 PM,48,-122,44,46,90
33925,FremontBridge,08/16/2016 01:00:00 PM,48,-122,56,64,120
33926,FremontBridge,08/16/2016 02:00:00 PM,48,-122,69,58,127
33927,FremontBridge,08/16/2016 03:00:00 PM,48,-122,95,73,168
33928,FremontBridge,08/16/2016 04:00:00 PM,48,-122,257,103,360
33929,FremontBridge,08/16/2016 05:00:00 PM,48,-122,556,206,762
33930,FremontBridge,08/16/2016 06:00:00 PM,48,-122,328,186,514
33931,FremontBridge,08/16/2016 07:00:00 PM,48,-122,181,104,285
33932,FremontBridge,08/16/2016 08:00:00 PM,48,-122,89,51,140
33933,FremontBridge,08/16/2016 09:00:00 PM,48,-122,37,44,81
33934,FremontBridge,08/16/2016 10:00:00 PM,48,-122,29,20,49
33935,FremontBridge,08/16/2016 11:00:00 PM,48,-122,14,7,21
33936,FremontBridge,08/17/2016 12:00:00 AM,48,-122,9,6,15
33937,FremontBridge,08/17/2016 01:00:00 AM,48,-122,2,1,3
33938,FremontBridge,08/17/2016 02:00:00 AM,48,-122,4,2,6
33939,FremontBridge,08/17/2016 03:00:00 AM,48,-122,2,4,6
33940,FremontBridge,08/17/2016 04:00:00 AM,48,-122,4,7,11
33941,FremontBridge,08/17/2016 05:00:00 AM,48,-122,15,32,47
33942,FremontBridge,08/17/2016 06:00:00 AM,48,-122,72,124,196
33943,FremontBridge,08/17/2016 07:00:00 AM,48,-122,147,291,438
33944,FremontBridge,08/17/2016 08:00:00 AM,48,-122,236,423,659
33945,FremontBridge,08/17/2016 09:00:00 AM,48,-122,150,178,328
33946,FremontBridge,08/17/2016 10:00:00 AM,48,-122,71,64,135
33947,FremontBridge,08/17/2016 11:00:00 AM,48,-122,60,50,110
33948,FremontBridge,08/17/2016 12:00:00 PM,48,-122,51,46,97
33949,FremontBridge,08/17/2016 01:00:00 PM,48,-122,52,54,106
33950,FremontBridge,08/17/2016 02:00:00 PM,48,-122,58,53,111
33951,FremontBridge,08/17/2016 03:00:00 PM,48,-122,103,73,176
33952,FremontBridge,08/17/2016 04:00:00 PM,48,-122,262,97,359
33953,FremontBridge,08/17/2016 05:00:00 PM,48,-122,564,221,785
33954,FremontBridge,08/17/2016 06:00:00 PM,48,-122,303,162,465
33955,FremontBridge,08/17/2016 07:00:00 PM,48,-122,159,90,249
33956,FremontBridge,08/17/2016 08:00:00 PM,48,-122,89,59,148
33957,FremontBridge,08/17/2016 09:00:00 PM,48,-122,50,34,84
33958,FremontBridge,08/17/2016 10:00:00 PM,48,-122,33,14,47
33959,FremontBridge,08/17/2016 11:00:00 PM,48,-122,19,11,30
33960,FremontBridge,08/18/2016 12:00:00 AM,48,-122,12,2,14
33961,FremontBridge,08/18/2016 01:00:00 AM,48,-122,9,3,12
33962,FremontBridge,08/18/2016 02:00:00 AM,48,-122,1,2,3
33963,FremontBridge,08/18/2016 03:00:00 AM,48,-122,2,1,3
33964,FremontBridge,08/18/2016 04:00:00 AM,48,-122,7,8,15
33965,FremontBridge,08/18/2016 05:00:00 AM,48,-122,16,37,53
33966,FremontBridge,08/18/2016 06:00:00 AM,48,-122,58,100,158
33967,FremontBridge,08/18/2016 07:00:00 AM,48,-122,161,269,430
33968,FremontBridge,08/18/2016 08:00:00 AM,48,-122,210,365,575
33969,FremontBridge,08/18/2016 09:00:00 AM,48,-122,137,178,315
33970,FremontBridge,08/18/2016 10:00:00 AM,48,-122,64,77,141
33971,FremontBridge,08/18/2016 11:00:00 AM,48,-122,55,56,111
33972,FremontBridge,08/18/2016 12:00:00 PM,48,-122,52,55,107
33973,FremontBridge,08/18/2016 01:00:00 PM,48,-122,53,62,115
33974,FremontBridge,08/18/2016 02:00:00 PM,48,-122,75,65,140
33975,FremontBridge,08/18/2016 03:00:00 PM,48,-122,107,70,177
33976,FremontBridge,08/18/2016 04:00:00 PM,48,-122,255,107,362
33977,FremontBridge,08/18/2016 05:00:00 PM,48,-122,488,196,684
33978,FremontBridge,08/18/2016 06:00:00 PM,48,-122,287,180,467
33979,FremontBridge,08/18/2016 07:00:00 PM,48,-122,142,106,248
33980,FremontBridge,08/18/2016 08:00:00 PM,48,-122,79,54,133
33981,FremontBridge,08/18/2016 09:00:00 PM,48,-122,47,37,84
33982,FremontBridge,08/18/2016 10:00:00 PM,48,-122,44,17,61
33983,FremontBridge,08/18/2016 11:00:00 PM,48,-122,15,18,33
33984,FremontBridge,08/19/2016 12:00:00 AM,48,-122,12,8,20
33985,FremontBridge,08/19/2016 01:00:00 AM,48,-122,5,3,8
33986,FremontBridge,08/19/2016 02:00:00 AM,48,-122,0,1,1
33987,FremontBridge,08/19/2016 03:00:00 AM,48,-122,3,2,5
33988,FremontBridge,08/19/2016 04:00:00 AM,48,-122,8,7,15
33989,FremontBridge,08/19/2016 05:00:00 AM,48,-122,12,26,38
33990,FremontBridge,08/19/2016 06:00:00 AM,48,-122,49,85,134
33991,FremontBridge,08/19/2016 07:00:00 AM,48,-122,104,226,330
33992,FremontBridge,08/19/2016 08:00:00 AM,48,-122,209,309,518
33993,FremontBridge,08/19/2016 09:00:00 AM,48,-122,115,124,239
33994,FremontBridge,08/19/2016 10:00:00 AM,48,-122,63,67,130
33995,FremontBridge,08/19/2016 11:00:00 AM,48,-122,49,61,110
33996,FremontBridge,08/19/2016 12:00:00 PM,48,-122,62,38,100
33997,FremontBridge,08/19/2016 01:00:00 PM,48,-122,57,45,102
33998,FremontBridge,08/19/2016 02:00:00 PM,48,-122,64,43,107
33999,FremontBridge,08/19/2016 03:00:00 PM,48,-122,119,67,186
34000,FremontBridge,08/19/2016 04:00:00 PM,48,-122,237,103,340
34001,FremontBridge,08/19/2016 05:00:00 PM,48,-122,392,155,547
34002,FremontBridge,08/19/2016 06:00:00 PM,48,-122,222,103,325
34003,FremontBridge,08/19/2016 07:00:00 PM,48,-122,121,60,181
34004,FremontBridge,08/19/2016 08:00:00 PM,48,-122,69,39,108
34005,FremontBridge,08/19/2016 09:00:00 PM,48,-122,44,28,72
34006,FremontBridge,08/19/2016 10:00:00 PM,48,-122,37,23,60
34007,FremontBridge,08/19/2016 11:00:00 PM,48,-122,35,13,48
34008,FremontBridge,08/20/2016 12:00:00 AM,48,-122,11,14,25
34009,FremontBridge,08/20/2016 01:00:00 AM,48,-122,6,9,15
34010,FremontBridge,08/20/2016 02:00:00 AM,48,-122,8,4,12
34011,FremontBridge,08/20/2016 03:00:00 AM,48,-122,7,3,10
34012,FremontBridge,08/20/2016 04:00:00 AM,48,-122,2,0,2
34013,FremontBridge,08/20/2016 05:00:00 AM,48,-122,5,3,8
34014,FremontBridge,08/20/2016 06:00:00 AM,48,-122,13,13,26
34015,FremontBridge,08/20/2016 07:00:00 AM,48,-122,32,28,60
34016,FremontBridge,08/20/2016 08:00:00 AM,48,-122,52,59,111
34017,FremontBridge,08/20/2016 09:00:00 AM,48,-122,61,71,132
34018,FremontBridge,08/20/2016 10:00:00 AM,48,-122,64,143,207
34019,FremontBridge,08/20/2016 11:00:00 AM,48,-122,64,55,119
34020,FremontBridge,08/20/2016 12:00:00 PM,48,-122,75,85,160
34021,FremontBridge,08/20/2016 01:00:00 PM,48,-122,99,65,164
34022,FremontBridge,08/20/2016 02:00:00 PM,48,-122,91,80,171
34023,FremontBridge,08/20/2016 03:00:00 PM,48,-122,69,75,144
34024,FremontBridge,08/20/2016 04:00:00 PM,48,-122,71,46,117
34025,FremontBridge,08/20/2016 05:00:00 PM,48,-122,65,54,119
34026,FremontBridge,08/20/2016 06:00:00 PM,48,-122,66,42,108
34027,FremontBridge,08/20/2016 07:00:00 PM,48,-122,40,30,70
34028,FremontBridge,08/20/2016 08:00:00 PM,48,-122,56,26,82
34029,FremontBridge,08/20/2016 09:00:00 PM,48,-122,15,20,35
34030,FremontBridge,08/20/2016 10:00:00 PM,48,-122,25,10,35
34031,FremontBridge,08/20/2016 11:00:00 PM,48,-122,12,7,19
34032,FremontBridge,08/21/2016 12:00:00 AM,48,-122,12,7,19
34033,FremontBridge,08/21/2016 01:00:00 AM,48,-122,9,2,11
34034,FremontBridge,08/21/2016 02:00:00 AM,48,-122,7,4,11
34035,FremontBridge,08/21/2016 03:00:00 AM,48,-122,0,0,0
34036,FremontBridge,08/21/2016 04:00:00 AM,48,-122,2,0,2
34037,FremontBridge,08/21/2016 05:00:00 AM,48,-122,3,6,9
34038,FremontBridge,08/21/2016 06:00:00 AM,48,-122,9,9,18
34039,FremontBridge,08/21/2016 07:00:00 AM,48,-122,17,22,39
34040,FremontBridge,08/21/2016 08:00:00 AM,48,-122,32,29,61
34041,FremontBridge,08/21/2016 09:00:00 AM,48,-122,42,45,87
34042,FremontBridge,08/21/2016 10:00:00 AM,48,-122,39,56,95
34043,FremontBridge,08/21/2016 11:00:00 AM,48,-122,64,73,137
34044,FremontBridge,08/21/2016 12:00:00 PM,48,-122,70,90,160
34045,FremontBridge,08/21/2016 01:00:00 PM,48,-122,72,66,138
34046,FremontBridge,08/21/2016 02:00:00 PM,48,-122,68,74,142
34047,FremontBridge,08/21/2016 03:00:00 PM,48,-122,84,91,175
34048,FremontBridge,08/21/2016 04:00:00 PM,48,-122,78,78,156
34049,FremontBridge,08/21/2016 05:00:00 PM,48,-122,60,74,134
34050,FremontBridge,08/21/2016 06:00:00 PM,48,-122,73,53,126
34051,FremontBridge,08/21/2016 07:00:00 PM,48,-122,38,32,70
34052,FremontBridge,08/21/2016 08:00:00 PM,48,-122,15,35,50
34053,FremontBridge,08/21/2016 09:00:00 PM,48,-122,42,16,58
34054,FremontBridge,08/21/2016 10:00:00 PM,48,-122,24,6,30
34055,FremontBridge,08/21/2016 11:00:00 PM,48,-122,10,6,16
34056,FremontBridge,08/22/2016 12:00:00 AM,48,-122,5,3,8
34057,FremontBridge,08/22/2016 01:00:00 AM,48,-122,5,2,7
34058,FremontBridge,08/22/2016 02:00:00 AM,48,-122,1,1,2
34059,FremontBridge,08/22/2016 03:00:00 AM,48,-122,2,0,2
34060,FremontBridge,08/22/2016 04:00:00 AM,48,-122,3,5,8
34061,FremontBridge,08/22/2016 05:00:00 AM,48,-122,10,29,39
34062,FremontBridge,08/22/2016 06:00:00 AM,48,-122,62,91,153
34063,FremontBridge,08/22/2016 07:00:00 AM,48,-122,145,270,415
34064,FremontBridge,08/22/2016 08:00:00 AM,48,-122,226,378,604
34065,FremontBridge,08/22/2016 09:00:00 AM,48,-122,128,202,330
34066,FremontBridge,08/22/2016 10:00:00 AM,48,-122,56,66,122
34067,FremontBridge,08/22/2016 11:00:00 AM,48,-122,43,35,78
34068,FremontBridge,08/22/2016 12:00:00 PM,48,-122,40,44,84
34069,FremontBridge,08/22/2016 01:00:00 PM,48,-122,43,48,91
34070,FremontBridge,08/22/2016 02:00:00 PM,48,-122,48,45,93
34071,FremontBridge,08/22/2016 03:00:00 PM,48,-122,94,50,144
34072,FremontBridge,08/22/2016 04:00:00 PM,48,-122,261,107,368
34073,FremontBridge,08/22/2016 05:00:00 PM,48,-122,537,176,713
34074,FremontBridge,08/22/2016 06:00:00 PM,48,-122,368,143,511
34075,FremontBridge,08/22/2016 07:00:00 PM,48,-122,161,89,250
34076,FremontBridge,08/22/2016 08:00:00 PM,48,-122,75,61,136
34077,FremontBridge,08/22/2016 09:00:00 PM,48,-122,41,28,69
34078,FremontBridge,08/22/2016 10:00:00 PM,48,-122,26,15,41
34079,FremontBridge,08/22/2016 11:00:00 PM,48,-122,12,12,24
34080,FremontBridge,08/23/2016 12:00:00 AM,48,-122,6,3,9
34081,FremontBridge,08/23/2016 01:00:00 AM,48,-122,1,4,5
34082,FremontBridge,08/23/2016 02:00:00 AM,48,-122,5,2,7
34083,FremontBridge,08/23/2016 03:00:00 AM,48,-122,1,2,3
34084,FremontBridge,08/23/2016 04:00:00 AM,48,-122,4,6,10
34085,FremontBridge,08/23/2016 05:00:00 AM,48,-122,14,35,49
34086,FremontBridge,08/23/2016 06:00:00 AM,48,-122,77,111,188
34087,FremontBridge,08/23/2016 07:00:00 AM,48,-122,161,295,456
34088,FremontBridge,08/23/2016 08:00:00 AM,48,-122,266,401,667
34089,FremontBridge,08/23/2016 09:00:00 AM,48,-122,125,181,306
34090,FremontBridge,08/23/2016 10:00:00 AM,48,-122,64,69,133
34091,FremontBridge,08/23/2016 11:00:00 AM,48,-122,50,41,91
34092,FremontBridge,08/23/2016 12:00:00 PM,48,-122,76,44,120
34093,FremontBridge,08/23/2016 01:00:00 PM,48,-122,63,54,117
34094,FremontBridge,08/23/2016 02:00:00 PM,48,-122,65,54,119
34095,FremontBridge,08/23/2016 03:00:00 PM,48,-122,90,72,162
34096,FremontBridge,08/23/2016 04:00:00 PM,48,-122,274,124,398
34097,FremontBridge,08/23/2016 05:00:00 PM,48,-122,541,212,753
34098,FremontBridge,08/23/2016 06:00:00 PM,48,-122,333,195,528
34099,FremontBridge,08/23/2016 07:00:00 PM,48,-122,161,97,258
34100,FremontBridge,08/23/2016 08:00:00 PM,48,-122,82,58,140
34101,FremontBridge,08/23/2016 09:00:00 PM,48,-122,52,32,84
34102,FremontBridge,08/23/2016 10:00:00 PM,48,-122,26,20,46
34103,FremontBridge,08/23/2016 11:00:00 PM,48,-122,23,13,36
34104,FremontBridge,08/24/2016 12:00:00 AM,48,-122,11,5,16
34105,FremontBridge,08/24/2016 01:00:00 AM,48,-122,5,4,9
34106,FremontBridge,08/24/2016 02:00:00 AM,48,-122,2,0,2
34107,FremontBridge,08/24/2016 03:00:00 AM,48,-122,3,2,5
34108,FremontBridge,08/24/2016 04:00:00 AM,48,-122,6,7,13
34109,FremontBridge,08/24/2016 05:00:00 AM,48,-122,19,29,48
34110,FremontBridge,08/24/2016 06:00:00 AM,48,-122,93,108,201
34111,FremontBridge,08/24/2016 07:00:00 AM,48,-122,153,309,462
34112,FremontBridge,08/24/2016 08:00:00 AM,48,-122,235,398,633
34113,FremontBridge,08/24/2016 09:00:00 AM,48,-122,137,162,299
34114,FremontBridge,08/24/2016 10:00:00 AM,48,-122,76,84,160
34115,FremontBridge,08/24/2016 11:00:00 AM,48,-122,50,55,105
34116,FremontBridge,08/24/2016 12:00:00 PM,48,-122,44,55,99
34117,FremontBridge,08/24/2016 01:00:00 PM,48,-122,46,54,100
34118,FremontBridge,08/24/2016 02:00:00 PM,48,-122,61,40,101
34119,FremontBridge,08/24/2016 03:00:00 PM,48,-122,106,65,171
34120,FremontBridge,08/24/2016 04:00:00 PM,48,-122,256,102,358
34121,FremontBridge,08/24/2016 05:00:00 PM,48,-122,559,194,753
34122,FremontBridge,08/24/2016 06:00:00 PM,48,-122,346,156,502
34123,FremontBridge,08/24/2016 07:00:00 PM,48,-122,179,110,289
34124,FremontBridge,08/24/2016 08:00:00 PM,48,-122,87,57,144
34125,FremontBridge,08/24/2016 09:00:00 PM,48,-122,44,35,79
34126,FremontBridge,08/24/2016 10:00:00 PM,48,-122,29,16,45
34127,FremontBridge,08/24/2016 11:00:00 PM,48,-122,15,14,29
34128,FremontBridge,08/25/2016 12:00:00 AM,48,-122,11,9,20
34129,FremontBridge,08/25/2016 01:00:00 AM,48,-122,4,3,7
34130,FremontBridge,08/25/2016 02:00:00 AM,48,-122,3,1,4
34131,FremontBridge,08/25/2016 03:00:00 AM,48,-122,0,4,4
34132,FremontBridge,08/25/2016 04:00:00 AM,48,-122,5,3,8
34133,FremontBridge,08/25/2016 05:00:00 AM,48,-122,13,29,42
34134,FremontBridge,08/25/2016 06:00:00 AM,48,-122,60,110,170
34135,FremontBridge,08/25/2016 07:00:00 AM,48,-122,147,287,434
34136,FremontBridge,08/25/2016 08:00:00 AM,48,-122,223,353,576
34137,FremontBridge,08/25/2016 09:00:00 AM,48,-122,139,185,324
34138,FremontBridge,08/25/2016 10:00:00 AM,48,-122,63,82,145
34139,FremontBridge,08/25/2016 11:00:00 AM,48,-122,56,55,111
34140,FremontBridge,08/25/2016 12:00:00 PM,48,-122,64,53,117
34141,FremontBridge,08/25/2016 01:00:00 PM,48,-122,52,51,103
34142,FremontBridge,08/25/2016 02:00:00 PM,48,-122,66,50,116
34143,FremontBridge,08/25/2016 03:00:00 PM,48,-122,93,82,175
34144,FremontBridge,08/25/2016 04:00:00 PM,48,-122,239,90,329
34145,FremontBridge,08/25/2016 05:00:00 PM,48,-122,487,179,666
34146,FremontBridge,08/25/2016 06:00:00 PM,48,-122,309,153,462
34147,FremontBridge,08/25/2016 07:00:00 PM,48,-122,151,80,231
34148,FremontBridge,08/25/2016 08:00:00 PM,48,-122,76,75,151
34149,FremontBridge,08/25/2016 09:00:00 PM,48,-122,53,32,85
34150,FremontBridge,08/25/2016 10:00:00 PM,48,-122,31,30,61
34151,FremontBridge,08/25/2016 11:00:00 PM,48,-122,26,15,41
34152,FremontBridge,08/26/2016 12:00:00 AM,48,-122,11,11,22
34153,FremontBridge,08/26/2016 01:00:00 AM,48,-122,3,4,7
34154,FremontBridge,08/26/2016 02:00:00 AM,48,-122,3,6,9
34155,FremontBridge,08/26/2016 03:00:00 AM,48,-122,1,3,4
34156,FremontBridge,08/26/2016 04:00:00 AM,48,-122,5,7,12
34157,FremontBridge,08/26/2016 05:00:00 AM,48,-122,15,18,33
34158,FremontBridge,08/26/2016 06:00:00 AM,48,-122,52,73,125
34159,FremontBridge,08/26/2016 07:00:00 AM,48,-122,138,221,359
34160,FremontBridge,08/26/2016 08:00:00 AM,48,-122,190,299,489
34161,FremontBridge,08/26/2016 09:00:00 AM,48,-122,108,150,258
34162,FremontBridge,08/26/2016 10:00:00 AM,48,-122,61,76,137
34163,FremontBridge,08/26/2016 11:00:00 AM,48,-122,59,53,112
34164,FremontBridge,08/26/2016 12:00:00 PM,48,-122,64,46,110
34165,FremontBridge,08/26/2016 01:00:00 PM,48,-122,71,59,130
34166,FremontBridge,08/26/2016 02:00:00 PM,48,-122,75,62,137
34167,FremontBridge,08/26/2016 03:00:00 PM,48,-122,94,90,184
34168,FremontBridge,08/26/2016 04:00:00 PM,48,-122,246,101,347
34169,FremontBridge,08/26/2016 05:00:00 PM,48,-122,403,166,569
34170,FremontBridge,08/26/2016 06:00:00 PM,48,-122,223,126,349
34171,FremontBridge,08/26/2016 07:00:00 PM,48,-122,111,81,192
34172,FremontBridge,08/26/2016 08:00:00 PM,48,-122,83,57,140
34173,FremontBridge,08/26/2016 09:00:00 PM,48,-122,58,32,90
34174,FremontBridge,08/26/2016 10:00:00 PM,48,-122,34,17,51
34175,FremontBridge,08/26/2016 11:00:00 PM,48,-122,22,8,30
34176,FremontBridge,08/27/2016 12:00:00 AM,48,-122,12,9,21
34177,FremontBridge,08/27/2016 01:00:00 AM,48,-122,6,7,13
34178,FremontBridge,08/27/2016 02:00:00 AM,48,-122,4,4,8
34179,FremontBridge,08/27/2016 03:00:00 AM,48,-122,5,1,6
34180,FremontBridge,08/27/2016 04:00:00 AM,48,-122,1,1,2
34181,FremontBridge,08/27/2016 05:00:00 AM,48,-122,3,9,12
34182,FremontBridge,08/27/2016 06:00:00 AM,48,-122,13,10,23
34183,FremontBridge,08/27/2016 07:00:00 AM,48,-122,26,25,51
34184,FremontBridge,08/27/2016 08:00:00 AM,48,-122,24,46,70
34185,FremontBridge,08/27/2016 09:00:00 AM,48,-122,51,65,116
34186,FremontBridge,08/27/2016 10:00:00 AM,48,-122,71,57,128
34187,FremontBridge,08/27/2016 11:00:00 AM,48,-122,64,56,120
34188,FremontBridge,08/27/2016 12:00:00 PM,48,-122,62,96,158
34189,FremontBridge,08/27/2016 01:00:00 PM,48,-122,64,87,151
34190,FremontBridge,08/27/2016 02:00:00 PM,48,-122,70,52,122
34191,FremontBridge,08/27/2016 03:00:00 PM,48,-122,66,88,154
34192,FremontBridge,08/27/2016 04:00:00 PM,48,-122,84,56,140
34193,FremontBridge,08/27/2016 05:00:00 PM,48,-122,79,50,129
34194,FremontBridge,08/27/2016 06:00:00 PM,48,-122,65,51,116
34195,FremontBridge,08/27/2016 07:00:00 PM,48,-122,37,29,66
34196,FremontBridge,08/27/2016 08:00:00 PM,48,-122,26,27,53
34197,FremontBridge,08/27/2016 09:00:00 PM,48,-122,12,10,22
34198,FremontBridge,08/27/2016 10:00:00 PM,48,-122,15,13,28
34199,FremontBridge,08/27/2016 11:00:00 PM,48,-122,16,8,24
34200,FremontBridge,08/28/2016 12:00:00 AM,48,-122,8,7,15
34201,FremontBridge,08/28/2016 01:00:00 AM,48,-122,3,4,7
34202,FremontBridge,08/28/2016 02:00:00 AM,48,-122,2,2,4
34203,FremontBridge,08/28/2016 03:00:00 AM,48,-122,1,1,2
34204,FremontBridge,08/28/2016 04:00:00 AM,48,-122,4,1,5
34205,FremontBridge,08/28/2016 05:00:00 AM,48,-122,0,5,5
34206,FremontBridge,08/28/2016 06:00:00 AM,48,-122,8,4,12
34207,FremontBridge,08/28/2016 07:00:00 AM,48,-122,21,13,34
34208,FremontBridge,08/28/2016 08:00:00 AM,48,-122,37,44,81
34209,FremontBridge,08/28/2016 09:00:00 AM,48,-122,37,49,86
34210,FremontBridge,08/28/2016 10:00:00 AM,48,-122,47,59,106
34211,FremontBridge,08/28/2016 11:00:00 AM,48,-122,65,68,133
34212,FremontBridge,08/28/2016 12:00:00 PM,48,-122,65,53,118
34213,FremontBridge,08/28/2016 01:00:00 PM,48,-122,76,77,153
34214,FremontBridge,08/28/2016 02:00:00 PM,48,-122,70,85,155
34215,FremontBridge,08/28/2016 03:00:00 PM,48,-122,53,69,122
34216,FremontBridge,08/28/2016 04:00:00 PM,48,-122,65,76,141
34217,FremontBridge,08/28/2016 05:00:00 PM,48,-122,51,44,95
34218,FremontBridge,08/28/2016 06:00:00 PM,48,-122,35,39,74
34219,FremontBridge,08/28/2016 07:00:00 PM,48,-122,39,25,64
34220,FremontBridge,08/28/2016 08:00:00 PM,48,-122,40,16,56
34221,FremontBridge,08/28/2016 09:00:00 PM,48,-122,14,12,26
34222,FremontBridge,08/28/2016 10:00:00 PM,48,-122,12,17,29
34223,FremontBridge,08/28/2016 11:00:00 PM,48,-122,7,5,12
34224,FremontBridge,08/29/2016 12:00:00 AM,48,-122,3,5,8
34225,FremontBridge,08/29/2016 01:00:00 AM,48,-122,3,0,3
34226,FremontBridge,08/29/2016 02:00:00 AM,48,-122,1,1,2
34227,FremontBridge,08/29/2016 03:00:00 AM,48,-122,1,3,4
34228,FremontBridge,08/29/2016 04:00:00 AM,48,-122,2,9,11
34229,FremontBridge,08/29/2016 05:00:00 AM,48,-122,19,20,39
34230,FremontBridge,08/29/2016 06:00:00 AM,48,-122,64,99,163
34231,FremontBridge,08/29/2016 07:00:00 AM,48,-122,132,280,412
34232,FremontBridge,08/29/2016 08:00:00 AM,48,-122,207,328,535
34233,FremontBridge,08/29/2016 09:00:00 AM,48,-122,130,186,316
34234,FremontBridge,08/29/2016 10:00:00 AM,48,-122,55,72,127
34235,FremontBridge,08/29/2016 11:00:00 AM,48,-122,48,54,102
34236,FremontBridge,08/29/2016 12:00:00 PM,48,-122,41,52,93
34237,FremontBridge,08/29/2016 01:00:00 PM,48,-122,46,49,95
34238,FremontBridge,08/29/2016 02:00:00 PM,48,-122,71,64,135
34239,FremontBridge,08/29/2016 03:00:00 PM,48,-122,94,78,172
34240,FremontBridge,08/29/2016 04:00:00 PM,48,-122,230,111,341
34241,FremontBridge,08/29/2016 05:00:00 PM,48,-122,543,205,748
34242,FremontBridge,08/29/2016 06:00:00 PM,48,-122,343,164,507
34243,FremontBridge,08/29/2016 07:00:00 PM,48,-122,154,105,259
34244,FremontBridge,08/29/2016 08:00:00 PM,48,-122,73,61,134
34245,FremontBridge,08/29/2016 09:00:00 PM,48,-122,38,16,54
34246,FremontBridge,08/29/2016 10:00:00 PM,48,-122,25,15,40
34247,FremontBridge,08/29/2016 11:00:00 PM,48,-122,15,8,23
34248,FremontBridge,08/30/2016 12:00:00 AM,48,-122,8,4,12
34249,FremontBridge,08/30/2016 01:00:00 AM,48,-122,2,2,4
34250,FremontBridge,08/30/2016 02:00:00 AM,48,-122,0,0,0
34251,FremontBridge,08/30/2016 03:00:00 AM,48,-122,0,1,1
34252,FremontBridge,08/30/2016 04:00:00 AM,48,-122,9,7,16
34253,FremontBridge,08/30/2016 05:00:00 AM,48,-122,22,31,53
34254,FremontBridge,08/30/2016 06:00:00 AM,48,-122,56,96,152
34255,FremontBridge,08/30/2016 07:00:00 AM,48,-122,173,323,496
34256,FremontBridge,08/30/2016 08:00:00 AM,48,-122,210,383,593
34257,FremontBridge,08/30/2016 09:00:00 AM,48,-122,123,202,325
34258,FremontBridge,08/30/2016 10:00:00 AM,48,-122,72,62,134
34259,FremontBridge,08/30/2016 11:00:00 AM,48,-122,40,50,90
34260,FremontBridge,08/30/2016 12:00:00 PM,48,-122,41,40,81
34261,FremontBridge,08/30/2016 01:00:00 PM,48,-122,57,44,101
34262,FremontBridge,08/30/2016 02:00:00 PM,48,-122,61,35,96
34263,FremontBridge,08/30/2016 03:00:00 PM,48,-122,92,78,170
34264,FremontBridge,08/30/2016 04:00:00 PM,48,-122,275,94,369
34265,FremontBridge,08/30/2016 05:00:00 PM,48,-122,549,209,758
34266,FremontBridge,08/30/2016 06:00:00 PM,48,-122,282,161,443
34267,FremontBridge,08/30/2016 07:00:00 PM,48,-122,149,88,237
34268,FremontBridge,08/30/2016 08:00:00 PM,48,-122,68,53,121
34269,FremontBridge,08/30/2016 09:00:00 PM,48,-122,37,27,64
34270,FremontBridge,08/30/2016 10:00:00 PM,48,-122,31,15,46
34271,FremontBridge,08/30/2016 11:00:00 PM,48,-122,18,12,30
34272,FremontBridge,08/31/2016 12:00:00 AM,48,-122,7,5,12
34273,FremontBridge,08/31/2016 01:00:00 AM,48,-122,3,4,7
34274,FremontBridge,08/31/2016 02:00:00 AM,48,-122,0,1,1
34275,FremontBridge,08/31/2016 03:00:00 AM,48,-122,2,0,2
34276,FremontBridge,08/31/2016 04:00:00 AM,48,-122,5,12,17
34277,FremontBridge,08/31/2016 05:00:00 AM,48,-122,18,27,45
34278,FremontBridge,08/31/2016 06:00:00 AM,48,-122,66,99,165
34279,FremontBridge,08/31/2016 07:00:00 AM,48,-122,123,268,391
34280,FremontBridge,08/31/2016 08:00:00 AM,48,-122,180,311,491
34281,FremontBridge,08/31/2016 09:00:00 AM,48,-122,152,149,301
34282,FremontBridge,08/31/2016 10:00:00 AM,48,-122,49,70,119
34283,FremontBridge,08/31/2016 11:00:00 AM,48,-122,26,36,62
34284,FremontBridge,08/31/2016 12:00:00 PM,48,-122,36,18,54
34285,FremontBridge,08/31/2016 01:00:00 PM,48,-122,33,27,60
34286,FremontBridge,08/31/2016 02:00:00 PM,48,-122,42,30,72
34287,FremontBridge,08/31/2016 03:00:00 PM,48,-122,63,38,101
34288,FremontBridge,08/31/2016 04:00:00 PM,48,-122,201,98,299
34289,FremontBridge,08/31/2016 05:00:00 PM,48,-122,424,142,566
34290,FremontBridge,08/31/2016 06:00:00 PM,48,-122,303,127,430
34291,FremontBridge,08/31/2016 07:00:00 PM,48,-122,130,78,208
34292,FremontBridge,08/31/2016 08:00:00 PM,48,-122,47,31,78
34293,FremontBridge,08/31/2016 09:00:00 PM,48,-122,42,29,71
34294,FremontBridge,08/31/2016 10:00:00 PM,48,-122,23,14,37
34295,FremontBridge,08/31/2016 11:00:00 PM,48,-122,6,11,17
34296,FremontBridge,09/01/2016 12:00:00 AM,48,-122,11,5,16
34297,FremontBridge,09/01/2016 01:00:00 AM,48,-122,2,2,4
34298,FremontBridge,09/01/2016 02:00:00 AM,48,-122,4,2,6
34299,FremontBridge,09/01/2016 03:00:00 AM,48,-122,1,0,1
34300,FremontBridge,09/01/2016 04:00:00 AM,48,-122,4,5,9
34301,FremontBridge,09/01/2016 05:00:00 AM,48,-122,13,26,39
34302,FremontBridge,09/01/2016 06:00:00 AM,48,-122,53,90,143
34303,FremontBridge,09/01/2016 07:00:00 AM,48,-122,119,222,341
34304,FremontBridge,09/01/2016 08:00:00 AM,48,-122,177,304,481
34305,FremontBridge,09/01/2016 09:00:00 AM,48,-122,106,141,247
34306,FremontBridge,09/01/2016 10:00:00 AM,48,-122,44,55,99
34307,FremontBridge,09/01/2016 11:00:00 AM,48,-122,48,36,84
34308,FremontBridge,09/01/2016 12:00:00 PM,48,-122,41,43,84
34309,FremontBridge,09/01/2016 01:00:00 PM,48,-122,50,27,77
34310,FremontBridge,09/01/2016 02:00:00 PM,48,-122,53,36,89
34311,FremontBridge,09/01/2016 03:00:00 PM,48,-122,92,32,124
34312,FremontBridge,09/01/2016 04:00:00 PM,48,-122,212,78,290
34313,FremontBridge,09/01/2016 05:00:00 PM,48,-122,400,128,528
34314,FremontBridge,09/01/2016 06:00:00 PM,48,-122,244,125,369
34315,FremontBridge,09/01/2016 07:00:00 PM,48,-122,107,32,139
34316,FremontBridge,09/01/2016 08:00:00 PM,48,-122,53,37,90
34317,FremontBridge,09/01/2016 09:00:00 PM,48,-122,22,15,37
34318,FremontBridge,09/01/2016 10:00:00 PM,48,-122,14,16,30
34319,FremontBridge,09/01/2016 11:00:00 PM,48,-122,8,5,13
34320,FremontBridge,09/02/2016 12:00:00 AM,48,-122,10,3,13
34321,FremontBridge,09/02/2016 01:00:00 AM,48,-122,3,1,4
34322,FremontBridge,09/02/2016 02:00:00 AM,48,-122,2,1,3
34323,FremontBridge,09/02/2016 03:00:00 AM,48,-122,1,0,1
34324,FremontBridge,09/02/2016 04:00:00 AM,48,-122,6,6,12
34325,FremontBridge,09/02/2016 05:00:00 AM,48,-122,15,16,31
34326,FremontBridge,09/02/2016 06:00:00 AM,48,-122,28,59,87
34327,FremontBridge,09/02/2016 07:00:00 AM,48,-122,83,150,233
34328,FremontBridge,09/02/2016 08:00:00 AM,48,-122,111,197,308
34329,FremontBridge,09/02/2016 09:00:00 AM,48,-122,66,70,136
34330,FremontBridge,09/02/2016 10:00:00 AM,48,-122,15,19,34
34331,FremontBridge,09/02/2016 11:00:00 AM,48,-122,19,24,43
34332,FremontBridge,09/02/2016 12:00:00 PM,48,-122,24,19,43
34333,FremontBridge,09/02/2016 01:00:00 PM,48,-122,32,21,53
34334,FremontBridge,09/02/2016 02:00:00 PM,48,-122,55,46,101
34335,FremontBridge,09/02/2016 03:00:00 PM,48,-122,70,48,118
34336,FremontBridge,09/02/2016 04:00:00 PM,48,-122,156,61,217
34337,FremontBridge,09/02/2016 05:00:00 PM,48,-122,233,81,314
34338,FremontBridge,09/02/2016 06:00:00 PM,48,-122,119,49,168
34339,FremontBridge,09/02/2016 07:00:00 PM,48,-122,58,26,84
34340,FremontBridge,09/02/2016 08:00:00 PM,48,-122,19,19,38
34341,FremontBridge,09/02/2016 09:00:00 PM,48,-122,16,6,22
34342,FremontBridge,09/02/2016 10:00:00 PM,48,-122,15,17,32
34343,FremontBridge,09/02/2016 11:00:00 PM,48,-122,15,10,25
34344,FremontBridge,09/03/2016 12:00:00 AM,48,-122,9,8,17
34345,FremontBridge,09/03/2016 01:00:00 AM,48,-122,4,3,7
34346,FremontBridge,09/03/2016 02:00:00 AM,48,-122,0,3,3
34347,FremontBridge,09/03/2016 03:00:00 AM,48,-122,0,0,0
34348,FremontBridge,09/03/2016 04:00:00 AM,48,-122,0,0,0
34349,FremontBridge,09/03/2016 05:00:00 AM,48,-122,6,7,13
34350,FremontBridge,09/03/2016 06:00:00 AM,48,-122,8,10,18
34351,FremontBridge,09/03/2016 07:00:00 AM,48,-122,10,19,29
34352,FremontBridge,09/03/2016 08:00:00 AM,48,-122,26,23,49
34353,FremontBridge,09/03/2016 09:00:00 AM,48,-122,13,46,59
34354,FremontBridge,09/03/2016 10:00:00 AM,48,-122,32,21,53
34355,FremontBridge,09/03/2016 11:00:00 AM,48,-122,42,23,65
34356,FremontBridge,09/03/2016 12:00:00 PM,48,-122,20,39,59
34357,FremontBridge,09/03/2016 01:00:00 PM,48,-122,40,44,84
34358,FremontBridge,09/03/2016 02:00:00 PM,48,-122,40,63,103
34359,FremontBridge,09/03/2016 03:00:00 PM,48,-122,68,52,120
34360,FremontBridge,09/03/2016 04:00:00 PM,48,-122,78,86,164
34361,FremontBridge,09/03/2016 05:00:00 PM,48,-122,62,92,154
34362,FremontBridge,09/03/2016 06:00:00 PM,48,-122,65,77,142
34363,FremontBridge,09/03/2016 07:00:00 PM,48,-122,32,43,75
34364,FremontBridge,09/03/2016 08:00:00 PM,48,-122,37,21,58
34365,FremontBridge,09/03/2016 09:00:00 PM,48,-122,14,12,26
34366,FremontBridge,09/03/2016 10:00:00 PM,48,-122,15,9,24
34367,FremontBridge,09/03/2016 11:00:00 PM,48,-122,23,13,36
34368,FremontBridge,09/04/2016 12:00:00 AM,48,-122,9,4,13
34369,FremontBridge,09/04/2016 01:00:00 AM,48,-122,4,2,6
34370,FremontBridge,09/04/2016 02:00:00 AM,48,-122,5,0,5
34371,FremontBridge,09/04/2016 03:00:00 AM,48,-122,1,3,4
34372,FremontBridge,09/04/2016 04:00:00 AM,48,-122,2,2,4
34373,FremontBridge,09/04/2016 05:00:00 AM,48,-122,2,5,7
34374,FremontBridge,09/04/2016 06:00:00 AM,48,-122,7,11,18
34375,FremontBridge,09/04/2016 07:00:00 AM,48,-122,6,13,19
34376,FremontBridge,09/04/2016 08:00:00 AM,48,-122,17,20,37
34377,FremontBridge,09/04/2016 09:00:00 AM,48,-122,38,41,79
34378,FremontBridge,09/04/2016 10:00:00 AM,48,-122,35,56,91
34379,FremontBridge,09/04/2016 11:00:00 AM,48,-122,55,71,126
34380,FremontBridge,09/04/2016 12:00:00 PM,48,-122,60,69,129
34381,FremontBridge,09/04/2016 01:00:00 PM,48,-122,83,99,182
34382,FremontBridge,09/04/2016 02:00:00 PM,48,-122,75,117,192
34383,FremontBridge,09/04/2016 03:00:00 PM,48,-122,97,84,181
34384,FremontBridge,09/04/2016 04:00:00 PM,48,-122,83,118,201
34385,FremontBridge,09/04/2016 05:00:00 PM,48,-122,64,85,149
34386,FremontBridge,09/04/2016 06:00:00 PM,48,-122,40,61,101
34387,FremontBridge,09/04/2016 07:00:00 PM,48,-122,42,56,98
34388,FremontBridge,09/04/2016 08:00:00 PM,48,-122,26,15,41
34389,FremontBridge,09/04/2016 09:00:00 PM,48,-122,28,14,42
34390,FremontBridge,09/04/2016 10:00:00 PM,48,-122,21,13,34
34391,FremontBridge,09/04/2016 11:00:00 PM,48,-122,17,8,25
34392,FremontBridge,09/05/2016 12:00:00 AM,48,-122,11,9,20
34393,FremontBridge,09/05/2016 01:00:00 AM,48,-122,3,0,3
34394,FremontBridge,09/05/2016 02:00:00 AM,48,-122,2,0,2
34395,FremontBridge,09/05/2016 03:00:00 AM,48,-122,4,0,4
34396,FremontBridge,09/05/2016 04:00:00 AM,48,-122,5,3,8
34397,FremontBridge,09/05/2016 05:00:00 AM,48,-122,1,10,11
34398,FremontBridge,09/05/2016 06:00:00 AM,48,-122,7,5,12
34399,FremontBridge,09/05/2016 07:00:00 AM,48,-122,20,13,33
34400,FremontBridge,09/05/2016 08:00:00 AM,48,-122,18,37,55
34401,FremontBridge,09/05/2016 09:00:00 AM,48,-122,41,50,91
34402,FremontBridge,09/05/2016 10:00:00 AM,48,-122,36,58,94
34403,FremontBridge,09/05/2016 11:00:00 AM,48,-122,55,64,119
34404,FremontBridge,09/05/2016 12:00:00 PM,48,-122,54,86,140
34405,FremontBridge,09/05/2016 01:00:00 PM,48,-122,78,60,138
34406,FremontBridge,09/05/2016 02:00:00 PM,48,-122,65,86,151
34407,FremontBridge,09/05/2016 03:00:00 PM,48,-122,76,89,165
34408,FremontBridge,09/05/2016 04:00:00 PM,48,-122,80,65,145
34409,FremontBridge,09/05/2016 05:00:00 PM,48,-122,60,58,118
34410,FremontBridge,09/05/2016 06:00:00 PM,48,-122,33,38,71
34411,FremontBridge,09/05/2016 07:00:00 PM,48,-122,28,27,55
34412,FremontBridge,09/05/2016 08:00:00 PM,48,-122,24,17,41
34413,FremontBridge,09/05/2016 09:00:00 PM,48,-122,13,5,18
34414,FremontBridge,09/05/2016 10:00:00 PM,48,-122,12,5,17
34415,FremontBridge,09/05/2016 11:00:00 PM,48,-122,2,3,5
34416,FremontBridge,09/06/2016 12:00:00 AM,48,-122,3,2,5
34417,FremontBridge,09/06/2016 01:00:00 AM,48,-122,4,4,8
34418,FremontBridge,09/06/2016 02:00:00 AM,48,-122,0,2,2
34419,FremontBridge,09/06/2016 03:00:00 AM,48,-122,0,1,1
34420,FremontBridge,09/06/2016 04:00:00 AM,48,-122,2,1,3
34421,FremontBridge,09/06/2016 05:00:00 AM,48,-122,16,18,34
34422,FremontBridge,09/06/2016 06:00:00 AM,48,-122,38,50,88
34423,FremontBridge,09/06/2016 07:00:00 AM,48,-122,82,190,272
34424,FremontBridge,09/06/2016 08:00:00 AM,48,-122,162,269,431
34425,FremontBridge,09/06/2016 09:00:00 AM,48,-122,85,120,205
34426,FremontBridge,09/06/2016 10:00:00 AM,48,-122,54,55,109
34427,FremontBridge,09/06/2016 11:00:00 AM,48,-122,38,34,72
34428,FremontBridge,09/06/2016 12:00:00 PM,48,-122,32,31,63
34429,FremontBridge,09/06/2016 01:00:00 PM,48,-122,25,30,55
34430,FremontBridge,09/06/2016 02:00:00 PM,48,-122,27,34,61
34431,FremontBridge,09/06/2016 03:00:00 PM,48,-122,59,50,109
34432,FremontBridge,09/06/2016 04:00:00 PM,48,-122,183,81,264
34433,FremontBridge,09/06/2016 05:00:00 PM,48,-122,366,121,487
34434,FremontBridge,09/06/2016 06:00:00 PM,48,-122,175,103,278
34435,FremontBridge,09/06/2016 07:00:00 PM,48,-122,116,59,175
34436,FremontBridge,09/06/2016 08:00:00 PM,48,-122,52,51,103
34437,FremontBridge,09/06/2016 09:00:00 PM,48,-122,16,21,37
34438,FremontBridge,09/06/2016 10:00:00 PM,48,-122,15,5,20
34439,FremontBridge,09/06/2016 11:00:00 PM,48,-122,5,8,13
34440,FremontBridge,09/07/2016 12:00:00 AM,48,-122,5,5,10
34441,FremontBridge,09/07/2016 01:00:00 AM,48,-122,2,1,3
34442,FremontBridge,09/07/2016 02:00:00 AM,48,-122,1,0,1
34443,FremontBridge,09/07/2016 03:00:00 AM,48,-122,0,2,2
34444,FremontBridge,09/07/2016 04:00:00 AM,48,-122,3,4,7
34445,FremontBridge,09/07/2016 05:00:00 AM,48,-122,15,23,38
34446,FremontBridge,09/07/2016 06:00:00 AM,48,-122,57,87,144
34447,FremontBridge,09/07/2016 07:00:00 AM,48,-122,117,220,337
34448,FremontBridge,09/07/2016 08:00:00 AM,48,-122,194,317,511
34449,FremontBridge,09/07/2016 09:00:00 AM,48,-122,92,170,262
34450,FremontBridge,09/07/2016 10:00:00 AM,48,-122,46,48,94
34451,FremontBridge,09/07/2016 11:00:00 AM,48,-122,29,47,76
34452,FremontBridge,09/07/2016 12:00:00 PM,48,-122,29,31,60
34453,FremontBridge,09/07/2016 01:00:00 PM,48,-122,33,37,70
34454,FremontBridge,09/07/2016 02:00:00 PM,48,-122,42,33,75
34455,FremontBridge,09/07/2016 03:00:00 PM,48,-122,81,49,130
34456,FremontBridge,09/07/2016 04:00:00 PM,48,-122,175,70,245
34457,FremontBridge,09/07/2016 05:00:00 PM,48,-122,390,134,524
34458,FremontBridge,09/07/2016 06:00:00 PM,48,-122,251,123,374
34459,FremontBridge,09/07/2016 07:00:00 PM,48,-122,115,45,160
34460,FremontBridge,09/07/2016 08:00:00 PM,48,-122,48,28,76
34461,FremontBridge,09/07/2016 09:00:00 PM,48,-122,26,19,45
34462,FremontBridge,09/07/2016 10:00:00 PM,48,-122,26,11,37
34463,FremontBridge,09/07/2016 11:00:00 PM,48,-122,13,5,18
34464,FremontBridge,09/08/2016 12:00:00 AM,48,-122,7,2,9
34465,FremontBridge,09/08/2016 01:00:00 AM,48,-122,2,1,3
34466,FremontBridge,09/08/2016 02:00:00 AM,48,-122,3,1,4
34467,FremontBridge,09/08/2016 03:00:00 AM,48,-122,0,4,4
34468,FremontBridge,09/08/2016 04:00:00 AM,48,-122,5,8,13
34469,FremontBridge,09/08/2016 05:00:00 AM,48,-122,16,22,38
34470,FremontBridge,09/08/2016 06:00:00 AM,48,-122,55,105,160
34471,FremontBridge,09/08/2016 07:00:00 AM,48,-122,115,242,357
34472,FremontBridge,09/08/2016 08:00:00 AM,48,-122,186,296,482
34473,FremontBridge,09/08/2016 09:00:00 AM,48,-122,120,159,279
34474,FremontBridge,09/08/2016 10:00:00 AM,48,-122,47,55,102
34475,FremontBridge,09/08/2016 11:00:00 AM,48,-122,34,47,81
34476,FremontBridge,09/08/2016 12:00:00 PM,48,-122,38,44,82
34477,FremontBridge,09/08/2016 01:00:00 PM,48,-122,43,44,87
34478,FremontBridge,09/08/2016 02:00:00 PM,48,-122,45,36,81
34479,FremontBridge,09/08/2016 03:00:00 PM,48,-122,78,50,128
34480,FremontBridge,09/08/2016 04:00:00 PM,48,-122,220,107,327
34481,FremontBridge,09/08/2016 05:00:00 PM,48,-122,453,170,623
34482,FremontBridge,09/08/2016 06:00:00 PM,48,-122,292,151,443
34483,FremontBridge,09/08/2016 07:00:00 PM,48,-122,117,76,193
34484,FremontBridge,09/08/2016 08:00:00 PM,48,-122,69,38,107
34485,FremontBridge,09/08/2016 09:00:00 PM,48,-122,26,24,50
34486,FremontBridge,09/08/2016 10:00:00 PM,48,-122,25,11,36
34487,FremontBridge,09/08/2016 11:00:00 PM,48,-122,14,7,21
34488,FremontBridge,09/09/2016 12:00:00 AM,48,-122,12,4,16
34489,FremontBridge,09/09/2016 01:00:00 AM,48,-122,2,3,5
34490,FremontBridge,09/09/2016 02:00:00 AM,48,-122,2,1,3
34491,FremontBridge,09/09/2016 03:00:00 AM,48,-122,1,3,4
34492,FremontBridge,09/09/2016 04:00:00 AM,48,-122,4,7,11
34493,FremontBridge,09/09/2016 05:00:00 AM,48,-122,11,21,32
34494,FremontBridge,09/09/2016 06:00:00 AM,48,-122,40,92,132
34495,FremontBridge,09/09/2016 07:00:00 AM,48,-122,137,237,374
34496,FremontBridge,09/09/2016 08:00:00 AM,48,-122,208,307,515
34497,FremontBridge,09/09/2016 09:00:00 AM,48,-122,109,159,268
34498,FremontBridge,09/09/2016 10:00:00 AM,48,-122,72,56,128
34499,FremontBridge,09/09/2016 11:00:00 AM,48,-122,53,46,99
34500,FremontBridge,09/09/2016 12:00:00 PM,48,-122,43,57,100
34501,FremontBridge,09/09/2016 01:00:00 PM,48,-122,47,67,114
34502,FremontBridge,09/09/2016 02:00:00 PM,48,-122,97,76,173
34503,FremontBridge,09/09/2016 03:00:00 PM,48,-122,110,86,196
34504,FremontBridge,09/09/2016 04:00:00 PM,48,-122,244,123,367
34505,FremontBridge,09/09/2016 05:00:00 PM,48,-122,451,174,625
34506,FremontBridge,09/09/2016 06:00:00 PM,48,-122,208,106,314
34507,FremontBridge,09/09/2016 07:00:00 PM,48,-122,132,70,202
34508,FremontBridge,09/09/2016 08:00:00 PM,48,-122,62,49,111
34509,FremontBridge,09/09/2016 09:00:00 PM,48,-122,42,29,71
34510,FremontBridge,09/09/2016 10:00:00 PM,48,-122,34,19,53
34511,FremontBridge,09/09/2016 11:00:00 PM,48,-122,15,10,25
34512,FremontBridge,09/10/2016 12:00:00 AM,48,-122,14,12,26
34513,FremontBridge,09/10/2016 01:00:00 AM,48,-122,5,5,10
34514,FremontBridge,09/10/2016 02:00:00 AM,48,-122,7,6,13
34515,FremontBridge,09/10/2016 03:00:00 AM,48,-122,4,0,4
34516,FremontBridge,09/10/2016 04:00:00 AM,48,-122,4,2,6
34517,FremontBridge,09/10/2016 05:00:00 AM,48,-122,4,4,8
34518,FremontBridge,09/10/2016 06:00:00 AM,48,-122,3,11,14
34519,FremontBridge,09/10/2016 07:00:00 AM,48,-122,28,30,58
34520,FremontBridge,09/10/2016 08:00:00 AM,48,-122,41,44,85
34521,FremontBridge,09/10/2016 09:00:00 AM,48,-122,53,67,120
34522,FremontBridge,09/10/2016 10:00:00 AM,48,-122,67,65,132
34523,FremontBridge,09/10/2016 11:00:00 AM,48,-122,75,100,175
34524,FremontBridge,09/10/2016 12:00:00 PM,48,-122,75,80,155
34525,FremontBridge,09/10/2016 01:00:00 PM,48,-122,126,93,219
34526,FremontBridge,09/10/2016 02:00:00 PM,48,-122,70,103,173
34527,FremontBridge,09/10/2016 03:00:00 PM,48,-122,112,108,220
34528,FremontBridge,09/10/2016 04:00:00 PM,48,-122,101,99,200
34529,FremontBridge,09/10/2016 05:00:00 PM,48,-122,97,94,191
34530,FremontBridge,09/10/2016 06:00:00 PM,48,-122,94,61,155
34531,FremontBridge,09/10/2016 07:00:00 PM,48,-122,36,40,76
34532,FremontBridge,09/10/2016 08:00:00 PM,48,-122,34,22,56
34533,FremontBridge,09/10/2016 09:00:00 PM,48,-122,19,20,39
34534,FremontBridge,09/10/2016 10:00:00 PM,48,-122,11,21,32
34535,FremontBridge,09/10/2016 11:00:00 PM,48,-122,20,10,30
34536,FremontBridge,09/11/2016 12:00:00 AM,48,-122,12,5,17
34537,FremontBridge,09/11/2016 01:00:00 AM,48,-122,6,5,11
34538,FremontBridge,09/11/2016 02:00:00 AM,48,-122,2,6,8
34539,FremontBridge,09/11/2016 03:00:00 AM,48,-122,2,0,2
34540,FremontBridge,09/11/2016 04:00:00 AM,48,-122,1,2,3
34541,FremontBridge,09/11/2016 05:00:00 AM,48,-122,1,3,4
34542,FremontBridge,09/11/2016 06:00:00 AM,48,-122,8,4,12
34543,FremontBridge,09/11/2016 07:00:00 AM,48,-122,11,26,37
34544,FremontBridge,09/11/2016 08:00:00 AM,48,-122,38,25,63
34545,FremontBridge,09/11/2016 09:00:00 AM,48,-122,47,39,86
34546,FremontBridge,09/11/2016 10:00:00 AM,48,-122,51,47,98
34547,FremontBridge,09/11/2016 11:00:00 AM,48,-122,69,54,123
34548,FremontBridge,09/11/2016 12:00:00 PM,48,-122,63,77,140
34549,FremontBridge,09/11/2016 01:00:00 PM,48,-122,69,80,149
34550,FremontBridge,09/11/2016 02:00:00 PM,48,-122,90,80,170
34551,FremontBridge,09/11/2016 03:00:00 PM,48,-122,100,66,166
34552,FremontBridge,09/11/2016 04:00:00 PM,48,-122,82,80,162
34553,FremontBridge,09/11/2016 05:00:00 PM,48,-122,80,58,138
34554,FremontBridge,09/11/2016 06:00:00 PM,48,-122,48,71,119
34555,FremontBridge,09/11/2016 07:00:00 PM,48,-122,34,38,72
34556,FremontBridge,09/11/2016 08:00:00 PM,48,-122,15,17,32
34557,FremontBridge,09/11/2016 09:00:00 PM,48,-122,25,13,38
34558,FremontBridge,09/11/2016 10:00:00 PM,48,-122,12,10,22
34559,FremontBridge,09/11/2016 11:00:00 PM,48,-122,9,6,15
34560,FremontBridge,09/12/2016 12:00:00 AM,48,-122,9,3,12
34561,FremontBridge,09/12/2016 01:00:00 AM,48,-122,3,2,5
34562,FremontBridge,09/12/2016 02:00:00 AM,48,-122,1,0,1
34563,FremontBridge,09/12/2016 03:00:00 AM,48,-122,1,1,2
34564,FremontBridge,09/12/2016 04:00:00 AM,48,-122,3,5,8
34565,FremontBridge,09/12/2016 05:00:00 AM,48,-122,16,33,49
34566,FremontBridge,09/12/2016 06:00:00 AM,48,-122,56,94,150
34567,FremontBridge,09/12/2016 07:00:00 AM,48,-122,148,282,430
34568,FremontBridge,09/12/2016 08:00:00 AM,48,-122,241,383,624
34569,FremontBridge,09/12/2016 09:00:00 AM,48,-122,138,155,293
34570,FremontBridge,09/12/2016 10:00:00 AM,48,-122,63,55,118
34571,FremontBridge,09/12/2016 11:00:00 AM,48,-122,49,45,94
34572,FremontBridge,09/12/2016 12:00:00 PM,48,-122,43,48,91
34573,FremontBridge,09/12/2016 01:00:00 PM,48,-122,56,50,106
34574,FremontBridge,09/12/2016 02:00:00 PM,48,-122,70,45,115
34575,FremontBridge,09/12/2016 03:00:00 PM,48,-122,102,68,170
34576,FremontBridge,09/12/2016 04:00:00 PM,48,-122,216,109,325
34577,FremontBridge,09/12/2016 05:00:00 PM,48,-122,540,200,740
34578,FremontBridge,09/12/2016 06:00:00 PM,48,-122,270,173,443
34579,FremontBridge,09/12/2016 07:00:00 PM,48,-122,158,81,239
34580,FremontBridge,09/12/2016 08:00:00 PM,48,-122,70,40,110
34581,FremontBridge,09/12/2016 09:00:00 PM,48,-122,35,27,62
34582,FremontBridge,09/12/2016 10:00:00 PM,48,-122,23,14,37
34583,FremontBridge,09/12/2016 11:00:00 PM,48,-122,14,5,19
34584,FremontBridge,09/13/2016 12:00:00 AM,48,-122,7,4,11
34585,FremontBridge,09/13/2016 01:00:00 AM,48,-122,2,2,4
34586,FremontBridge,09/13/2016 02:00:00 AM,48,-122,2,1,3
34587,FremontBridge,09/13/2016 03:00:00 AM,48,-122,2,1,3
34588,FremontBridge,09/13/2016 04:00:00 AM,48,-122,1,7,8
34589,FremontBridge,09/13/2016 05:00:00 AM,48,-122,23,29,52
34590,FremontBridge,09/13/2016 06:00:00 AM,48,-122,72,118,190
34591,FremontBridge,09/13/2016 07:00:00 AM,48,-122,165,303,468
34592,FremontBridge,09/13/2016 08:00:00 AM,48,-122,225,395,620
34593,FremontBridge,09/13/2016 09:00:00 AM,48,-122,141,159,300
34594,FremontBridge,09/13/2016 10:00:00 AM,48,-122,60,56,116
34595,FremontBridge,09/13/2016 11:00:00 AM,48,-122,53,45,98
34596,FremontBridge,09/13/2016 12:00:00 PM,48,-122,50,55,105
34597,FremontBridge,09/13/2016 01:00:00 PM,48,-122,56,56,112
34598,FremontBridge,09/13/2016 02:00:00 PM,48,-122,50,53,103
34599,FremontBridge,09/13/2016 03:00:00 PM,48,-122,105,76,181
34600,FremontBridge,09/13/2016 04:00:00 PM,48,-122,259,122,381
34601,FremontBridge,09/13/2016 05:00:00 PM,48,-122,587,209,796
34602,FremontBridge,09/13/2016 06:00:00 PM,48,-122,334,172,506
34603,FremontBridge,09/13/2016 07:00:00 PM,48,-122,160,78,238
34604,FremontBridge,09/13/2016 08:00:00 PM,48,-122,77,41,118
34605,FremontBridge,09/13/2016 09:00:00 PM,48,-122,48,25,73
34606,FremontBridge,09/13/2016 10:00:00 PM,48,-122,33,15,48
34607,FremontBridge,09/13/2016 11:00:00 PM,48,-122,19,8,27
34608,FremontBridge,09/14/2016 12:00:00 AM,48,-122,9,8,17
34609,FremontBridge,09/14/2016 01:00:00 AM,48,-122,3,2,5
34610,FremontBridge,09/14/2016 02:00:00 AM,48,-122,4,0,4
34611,FremontBridge,09/14/2016 03:00:00 AM,48,-122,0,1,1
34612,FremontBridge,09/14/2016 04:00:00 AM,48,-122,4,5,9
34613,FremontBridge,09/14/2016 05:00:00 AM,48,-122,16,23,39
34614,FremontBridge,09/14/2016 06:00:00 AM,48,-122,58,106,164
34615,FremontBridge,09/14/2016 07:00:00 AM,48,-122,165,291,456
34616,FremontBridge,09/14/2016 08:00:00 AM,48,-122,249,369,618
34617,FremontBridge,09/14/2016 09:00:00 AM,48,-122,144,177,321
34618,FremontBridge,09/14/2016 10:00:00 AM,48,-122,58,83,141
34619,FremontBridge,09/14/2016 11:00:00 AM,48,-122,56,52,108
34620,FremontBridge,09/14/2016 12:00:00 PM,48,-122,38,45,83
34621,FremontBridge,09/14/2016 01:00:00 PM,48,-122,49,43,92
34622,FremontBridge,09/14/2016 02:00:00 PM,48,-122,64,47,111
34623,FremontBridge,09/14/2016 03:00:00 PM,48,-122,91,86,177
34624,FremontBridge,09/14/2016 04:00:00 PM,48,-122,231,120,351
34625,FremontBridge,09/14/2016 05:00:00 PM,48,-122,589,194,783
34626,FremontBridge,09/14/2016 06:00:00 PM,48,-122,338,174,512
34627,FremontBridge,09/14/2016 07:00:00 PM,48,-122,145,99,244
34628,FremontBridge,09/14/2016 08:00:00 PM,48,-122,61,36,97
34629,FremontBridge,09/14/2016 09:00:00 PM,48,-122,55,27,82
34630,FremontBridge,09/14/2016 10:00:00 PM,48,-122,27,29,56
34631,FremontBridge,09/14/2016 11:00:00 PM,48,-122,18,7,25
34632,FremontBridge,09/15/2016 12:00:00 AM,48,-122,5,5,10
34633,FremontBridge,09/15/2016 01:00:00 AM,48,-122,2,4,6
34634,FremontBridge,09/15/2016 02:00:00 AM,48,-122,5,1,6
34635,FremontBridge,09/15/2016 03:00:00 AM,48,-122,0,2,2
34636,FremontBridge,09/15/2016 04:00:00 AM,48,-122,3,1,4
34637,FremontBridge,09/15/2016 05:00:00 AM,48,-122,18,29,47
34638,FremontBridge,09/15/2016 06:00:00 AM,48,-122,54,110,164
34639,FremontBridge,09/15/2016 07:00:00 AM,48,-122,141,266,407
34640,FremontBridge,09/15/2016 08:00:00 AM,48,-122,220,316,536
34641,FremontBridge,09/15/2016 09:00:00 AM,48,-122,137,154,291
34642,FremontBridge,09/15/2016 10:00:00 AM,48,-122,74,65,139
34643,FremontBridge,09/15/2016 11:00:00 AM,48,-122,38,35,73
34644,FremontBridge,09/15/2016 12:00:00 PM,48,-122,51,52,103
34645,FremontBridge,09/15/2016 01:00:00 PM,48,-122,62,54,116
34646,FremontBridge,09/15/2016 02:00:00 PM,48,-122,63,49,112
34647,FremontBridge,09/15/2016 03:00:00 PM,48,-122,113,69,182
34648,FremontBridge,09/15/2016 04:00:00 PM,48,-122,233,121,354
34649,FremontBridge,09/15/2016 05:00:00 PM,48,-122,500,195,695
34650,FremontBridge,09/15/2016 06:00:00 PM,48,-122,336,149,485
34651,FremontBridge,09/15/2016 07:00:00 PM,48,-122,150,82,232
34652,FremontBridge,09/15/2016 08:00:00 PM,48,-122,60,48,108
34653,FremontBridge,09/15/2016 09:00:00 PM,48,-122,40,25,65
34654,FremontBridge,09/15/2016 10:00:00 PM,48,-122,31,18,49
34655,FremontBridge,09/15/2016 11:00:00 PM,48,-122,18,13,31
34656,FremontBridge,09/16/2016 12:00:00 AM,48,-122,13,5,18
34657,FremontBridge,09/16/2016 01:00:00 AM,48,-122,2,2,4
34658,FremontBridge,09/16/2016 02:00:00 AM,48,-122,3,0,3
34659,FremontBridge,09/16/2016 03:00:00 AM,48,-122,4,0,4
34660,FremontBridge,09/16/2016 04:00:00 AM,48,-122,5,5,10
34661,FremontBridge,09/16/2016 05:00:00 AM,48,-122,15,24,39
34662,FremontBridge,09/16/2016 06:00:00 AM,48,-122,49,96,145
34663,FremontBridge,09/16/2016 07:00:00 AM,48,-122,109,278,387
34664,FremontBridge,09/16/2016 08:00:00 AM,48,-122,201,305,506
34665,FremontBridge,09/16/2016 09:00:00 AM,48,-122,116,132,248
34666,FremontBridge,09/16/2016 10:00:00 AM,48,-122,55,70,125
34667,FremontBridge,09/16/2016 11:00:00 AM,48,-122,58,50,108
34668,FremontBridge,09/16/2016 12:00:00 PM,48,-122,56,56,112
34669,FremontBridge,09/16/2016 01:00:00 PM,48,-122,64,52,116
34670,FremontBridge,09/16/2016 02:00:00 PM,48,-122,67,63,130
34671,FremontBridge,09/16/2016 03:00:00 PM,48,-122,115,74,189
34672,FremontBridge,09/16/2016 04:00:00 PM,48,-122,270,92,362
34673,FremontBridge,09/16/2016 05:00:00 PM,48,-122,438,164,602
34674,FremontBridge,09/16/2016 06:00:00 PM,48,-122,220,105,325
34675,FremontBridge,09/16/2016 07:00:00 PM,48,-122,85,51,136
34676,FremontBridge,09/16/2016 08:00:00 PM,48,-122,40,22,62
34677,FremontBridge,09/16/2016 09:00:00 PM,48,-122,26,15,41
34678,FremontBridge,09/16/2016 10:00:00 PM,48,-122,22,10,32
34679,FremontBridge,09/16/2016 11:00:00 PM,48,-122,16,12,28
34680,FremontBridge,09/17/2016 12:00:00 AM,48,-122,16,5,21
34681,FremontBridge,09/17/2016 01:00:00 AM,48,-122,3,2,5
34682,FremontBridge,09/17/2016 02:00:00 AM,48,-122,2,5,7
34683,FremontBridge,09/17/2016 03:00:00 AM,48,-122,3,0,3
34684,FremontBridge,09/17/2016 04:00:00 AM,48,-122,0,0,0
34685,FremontBridge,09/17/2016 05:00:00 AM,48,-122,5,1,6
34686,FremontBridge,09/17/2016 06:00:00 AM,48,-122,7,8,15
34687,FremontBridge,09/17/2016 07:00:00 AM,48,-122,6,9,15
34688,FremontBridge,09/17/2016 08:00:00 AM,48,-122,18,20,38
34689,FremontBridge,09/17/2016 09:00:00 AM,48,-122,20,26,46
34690,FremontBridge,09/17/2016 10:00:00 AM,48,-122,16,22,38
34691,FremontBridge,09/17/2016 11:00:00 AM,48,-122,36,27,63
34692,FremontBridge,09/17/2016 12:00:00 PM,48,-122,31,23,54
34693,FremontBridge,09/17/2016 01:00:00 PM,48,-122,27,29,56
34694,FremontBridge,09/17/2016 02:00:00 PM,48,-122,34,36,70
34695,FremontBridge,09/17/2016 03:00:00 PM,48,-122,34,38,72
34696,FremontBridge,09/17/2016 04:00:00 PM,48,-122,59,65,124
34697,FremontBridge,09/17/2016 05:00:00 PM,48,-122,47,35,82
34698,FremontBridge,09/17/2016 06:00:00 PM,48,-122,26,24,50
34699,FremontBridge,09/17/2016 07:00:00 PM,48,-122,24,19,43
34700,FremontBridge,09/17/2016 08:00:00 PM,48,-122,15,14,29
34701,FremontBridge,09/17/2016 09:00:00 PM,48,-122,15,15,30
34702,FremontBridge,09/17/2016 10:00:00 PM,48,-122,10,20,30
34703,FremontBridge,09/17/2016 11:00:00 PM,48,-122,8,16,24
34704,FremontBridge,09/18/2016 12:00:00 AM,48,-122,3,12,15
34705,FremontBridge,09/18/2016 01:00:00 AM,48,-122,3,4,7
34706,FremontBridge,09/18/2016 02:00:00 AM,48,-122,1,5,6
34707,FremontBridge,09/18/2016 03:00:00 AM,48,-122,1,0,1
34708,FremontBridge,09/18/2016 04:00:00 AM,48,-122,0,1,1
34709,FremontBridge,09/18/2016 05:00:00 AM,48,-122,1,2,3
34710,FremontBridge,09/18/2016 06:00:00 AM,48,-122,10,4,14
34711,FremontBridge,09/18/2016 07:00:00 AM,48,-122,10,20,30
34712,FremontBridge,09/18/2016 08:00:00 AM,48,-122,25,21,46
34713,FremontBridge,09/18/2016 09:00:00 AM,48,-122,47,34,81
34714,FremontBridge,09/18/2016 10:00:00 AM,48,-122,52,45,97
34715,FremontBridge,09/18/2016 11:00:00 AM,48,-122,61,75,136
34716,FremontBridge,09/18/2016 12:00:00 PM,48,-122,116,65,181
34717,FremontBridge,09/18/2016 01:00:00 PM,48,-122,80,84,164
34718,FremontBridge,09/18/2016 02:00:00 PM,48,-122,85,86,171
34719,FremontBridge,09/18/2016 03:00:00 PM,48,-122,87,70,157
34720,FremontBridge,09/18/2016 04:00:00 PM,48,-122,63,79,142
34721,FremontBridge,09/18/2016 05:00:00 PM,48,-122,55,93,148
34722,FremontBridge,09/18/2016 06:00:00 PM,48,-122,56,67,123
34723,FremontBridge,09/18/2016 07:00:00 PM,48,-122,32,32,64
34724,FremontBridge,09/18/2016 08:00:00 PM,48,-122,22,22,44
34725,FremontBridge,09/18/2016 09:00:00 PM,48,-122,11,14,25
34726,FremontBridge,09/18/2016 10:00:00 PM,48,-122,15,10,25
34727,FremontBridge,09/18/2016 11:00:00 PM,48,-122,7,5,12
34728,FremontBridge,09/19/2016 12:00:00 AM,48,-122,3,4,7
34729,FremontBridge,09/19/2016 01:00:00 AM,48,-122,2,2,4
34730,FremontBridge,09/19/2016 02:00:00 AM,48,-122,1,1,2
34731,FremontBridge,09/19/2016 03:00:00 AM,48,-122,3,1,4
34732,FremontBridge,09/19/2016 04:00:00 AM,48,-122,3,2,5
34733,FremontBridge,09/19/2016 05:00:00 AM,48,-122,12,22,34
34734,FremontBridge,09/19/2016 06:00:00 AM,48,-122,41,74,115
34735,FremontBridge,09/19/2016 07:00:00 AM,48,-122,86,152,238
34736,FremontBridge,09/19/2016 08:00:00 AM,48,-122,178,260,438
34737,FremontBridge,09/19/2016 09:00:00 AM,48,-122,100,136,236
34738,FremontBridge,09/19/2016 10:00:00 AM,48,-122,44,46,90
34739,FremontBridge,09/19/2016 11:00:00 AM,48,-122,36,31,67
34740,FremontBridge,09/19/2016 12:00:00 PM,48,-122,30,34,64
34741,FremontBridge,09/19/2016 01:00:00 PM,48,-122,33,60,93
34742,FremontBridge,09/19/2016 02:00:00 PM,48,-122,47,29,76
34743,FremontBridge,09/19/2016 03:00:00 PM,48,-122,70,55,125
34744,FremontBridge,09/19/2016 04:00:00 PM,48,-122,166,79,245
34745,FremontBridge,09/19/2016 05:00:00 PM,48,-122,372,155,527
34746,FremontBridge,09/19/2016 06:00:00 PM,48,-122,210,134,344
34747,FremontBridge,09/19/2016 07:00:00 PM,48,-122,99,68,167
34748,FremontBridge,09/19/2016 08:00:00 PM,48,-122,46,45,91
34749,FremontBridge,09/19/2016 09:00:00 PM,48,-122,35,15,50
34750,FremontBridge,09/19/2016 10:00:00 PM,48,-122,22,13,35
34751,FremontBridge,09/19/2016 11:00:00 PM,48,-122,11,5,16
34752,FremontBridge,09/20/2016 12:00:00 AM,48,-122,7,3,10
34753,FremontBridge,09/20/2016 01:00:00 AM,48,-122,2,3,5
34754,FremontBridge,09/20/2016 02:00:00 AM,48,-122,3,1,4
34755,FremontBridge,09/20/2016 03:00:00 AM,48,-122,1,2,3
34756,FremontBridge,09/20/2016 04:00:00 AM,48,-122,1,4,5
34757,FremontBridge,09/20/2016 05:00:00 AM,48,-122,19,24,43
34758,FremontBridge,09/20/2016 06:00:00 AM,48,-122,63,96,159
34759,FremontBridge,09/20/2016 07:00:00 AM,48,-122,157,302,459
34760,FremontBridge,09/20/2016 08:00:00 AM,48,-122,219,349,568
34761,FremontBridge,09/20/2016 09:00:00 AM,48,-122,124,160,284
34762,FremontBridge,09/20/2016 10:00:00 AM,48,-122,65,57,122
34763,FremontBridge,09/20/2016 11:00:00 AM,48,-122,43,52,95
34764,FremontBridge,09/20/2016 12:00:00 PM,48,-122,43,46,89
34765,FremontBridge,09/20/2016 01:00:00 PM,48,-122,45,57,102
34766,FremontBridge,09/20/2016 02:00:00 PM,48,-122,58,72,130
34767,FremontBridge,09/20/2016 03:00:00 PM,48,-122,108,78,186
34768,FremontBridge,09/20/2016 04:00:00 PM,48,-122,219,130,349
34769,FremontBridge,09/20/2016 05:00:00 PM,48,-122,559,172,731
34770,FremontBridge,09/20/2016 06:00:00 PM,48,-122,365,141,506
34771,FremontBridge,09/20/2016 07:00:00 PM,48,-122,162,62,224
34772,FremontBridge,09/20/2016 08:00:00 PM,48,-122,68,45,113
34773,FremontBridge,09/20/2016 09:00:00 PM,48,-122,32,20,52
34774,FremontBridge,09/20/2016 10:00:00 PM,48,-122,10,7,17
34775,FremontBridge,09/20/2016 11:00:00 PM,48,-122,13,10,23
34776,FremontBridge,09/21/2016 12:00:00 AM,48,-122,10,5,15
34777,FremontBridge,09/21/2016 01:00:00 AM,48,-122,0,3,3
34778,FremontBridge,09/21/2016 02:00:00 AM,48,-122,3,0,3
34779,FremontBridge,09/21/2016 03:00:00 AM,48,-122,0,3,3
34780,FremontBridge,09/21/2016 04:00:00 AM,48,-122,5,5,10
34781,FremontBridge,09/21/2016 05:00:00 AM,48,-122,18,22,40
34782,FremontBridge,09/21/2016 06:00:00 AM,48,-122,58,111,169
34783,FremontBridge,09/21/2016 07:00:00 AM,48,-122,156,271,427
34784,FremontBridge,09/21/2016 08:00:00 AM,48,-122,234,334,568
34785,FremontBridge,09/21/2016 09:00:00 AM,48,-122,136,138,274
34786,FremontBridge,09/21/2016 10:00:00 AM,48,-122,57,67,124
34787,FremontBridge,09/21/2016 11:00:00 AM,48,-122,32,47,79
34788,FremontBridge,09/21/2016 12:00:00 PM,48,-122,33,43,76
34789,FremontBridge,09/21/2016 01:00:00 PM,48,-122,55,43,98
34790,FremontBridge,09/21/2016 02:00:00 PM,48,-122,49,42,91
34791,FremontBridge,09/21/2016 03:00:00 PM,48,-122,106,66,172
34792,FremontBridge,09/21/2016 04:00:00 PM,48,-122,225,124,349
34793,FremontBridge,09/21/2016 05:00:00 PM,48,-122,532,177,709
34794,FremontBridge,09/21/2016 06:00:00 PM,48,-122,267,148,415
34795,FremontBridge,09/21/2016 07:00:00 PM,48,-122,154,93,247
34796,FremontBridge,09/21/2016 08:00:00 PM,48,-122,46,35,81
34797,FremontBridge,09/21/2016 09:00:00 PM,48,-122,46,19,65
34798,FremontBridge,09/21/2016 10:00:00 PM,48,-122,31,18,49
34799,FremontBridge,09/21/2016 11:00:00 PM,48,-122,16,6,22
34800,FremontBridge,09/22/2016 12:00:00 AM,48,-122,4,3,7
34801,FremontBridge,09/22/2016 01:00:00 AM,48,-122,7,0,7
34802,FremontBridge,09/22/2016 02:00:00 AM,48,-122,1,1,2
34803,FremontBridge,09/22/2016 03:00:00 AM,48,-122,2,4,6
34804,FremontBridge,09/22/2016 04:00:00 AM,48,-122,3,8,11
34805,FremontBridge,09/22/2016 05:00:00 AM,48,-122,14,23,37
34806,FremontBridge,09/22/2016 06:00:00 AM,48,-122,55,95,150
34807,FremontBridge,09/22/2016 07:00:00 AM,48,-122,165,257,422
34808,FremontBridge,09/22/2016 08:00:00 AM,48,-122,249,360,609
34809,FremontBridge,09/22/2016 09:00:00 AM,48,-122,139,156,295
34810,FremontBridge,09/22/2016 10:00:00 AM,48,-122,63,72,135
34811,FremontBridge,09/22/2016 11:00:00 AM,48,-122,48,45,93
34812,FremontBridge,09/22/2016 12:00:00 PM,48,-122,53,55,108
34813,FremontBridge,09/22/2016 01:00:00 PM,48,-122,56,62,118
34814,FremontBridge,09/22/2016 02:00:00 PM,48,-122,62,53,115
34815,FremontBridge,09/22/2016 03:00:00 PM,48,-122,101,63,164
34816,FremontBridge,09/22/2016 04:00:00 PM,48,-122,259,125,384
34817,FremontBridge,09/22/2016 05:00:00 PM,48,-122,493,206,699
34818,FremontBridge,09/22/2016 06:00:00 PM,48,-122,311,144,455
34819,FremontBridge,09/22/2016 07:00:00 PM,48,-122,143,79,222
34820,FremontBridge,09/22/2016 08:00:00 PM,48,-122,66,34,100
34821,FremontBridge,09/22/2016 09:00:00 PM,48,-122,34,32,66
34822,FremontBridge,09/22/2016 10:00:00 PM,48,-122,35,22,57
34823,FremontBridge,09/22/2016 11:00:00 PM,48,-122,12,18,30
34824,FremontBridge,09/23/2016 12:00:00 AM,48,-122,9,7,16
34825,FremontBridge,09/23/2016 01:00:00 AM,48,-122,4,5,9
34826,FremontBridge,09/23/2016 02:00:00 AM,48,-122,2,1,3
34827,FremontBridge,09/23/2016 03:00:00 AM,48,-122,1,2,3
34828,FremontBridge,09/23/2016 04:00:00 AM,48,-122,4,5,9
34829,FremontBridge,09/23/2016 05:00:00 AM,48,-122,13,28,41
34830,FremontBridge,09/23/2016 06:00:00 AM,48,-122,37,47,84
34831,FremontBridge,09/23/2016 07:00:00 AM,48,-122,101,175,276
34832,FremontBridge,09/23/2016 08:00:00 AM,48,-122,153,249,402
34833,FremontBridge,09/23/2016 09:00:00 AM,48,-122,99,111,210
34834,FremontBridge,09/23/2016 10:00:00 AM,48,-122,42,45,87
34835,FremontBridge,09/23/2016 11:00:00 AM,48,-122,30,41,71
34836,FremontBridge,09/23/2016 12:00:00 PM,48,-122,41,21,62
34837,FremontBridge,09/23/2016 01:00:00 PM,48,-122,24,21,45
34838,FremontBridge,09/23/2016 02:00:00 PM,48,-122,40,25,65
34839,FremontBridge,09/23/2016 03:00:00 PM,48,-122,79,35,114
34840,FremontBridge,09/23/2016 04:00:00 PM,48,-122,155,96,251
34841,FremontBridge,09/23/2016 05:00:00 PM,48,-122,306,108,414
34842,FremontBridge,09/23/2016 06:00:00 PM,48,-122,191,69,260
34843,FremontBridge,09/23/2016 07:00:00 PM,48,-122,80,45,125
34844,FremontBridge,09/23/2016 08:00:00 PM,48,-122,32,16,48
34845,FremontBridge,09/23/2016 09:00:00 PM,48,-122,22,17,39
34846,FremontBridge,09/23/2016 10:00:00 PM,48,-122,40,23,63
34847,FremontBridge,09/23/2016 11:00:00 PM,48,-122,14,8,22
34848,FremontBridge,09/24/2016 12:00:00 AM,48,-122,7,7,14
34849,FremontBridge,09/24/2016 01:00:00 AM,48,-122,6,7,13
34850,FremontBridge,09/24/2016 02:00:00 AM,48,-122,7,3,10
34851,FremontBridge,09/24/2016 03:00:00 AM,48,-122,0,8,8
34852,FremontBridge,09/24/2016 04:00:00 AM,48,-122,1,0,1
34853,FremontBridge,09/24/2016 05:00:00 AM,48,-122,7,3,10
34854,FremontBridge,09/24/2016 06:00:00 AM,48,-122,5,12,17
34855,FremontBridge,09/24/2016 07:00:00 AM,48,-122,16,15,31
34856,FremontBridge,09/24/2016 08:00:00 AM,48,-122,23,47,70
34857,FremontBridge,09/24/2016 09:00:00 AM,48,-122,32,49,81
34858,FremontBridge,09/24/2016 10:00:00 AM,48,-122,42,72,114
34859,FremontBridge,09/24/2016 11:00:00 AM,48,-122,45,80,125
34860,FremontBridge,09/24/2016 12:00:00 PM,48,-122,77,95,172
34861,FremontBridge,09/24/2016 01:00:00 PM,48,-122,68,81,149
34862,FremontBridge,09/24/2016 02:00:00 PM,48,-122,81,80,161
34863,FremontBridge,09/24/2016 03:00:00 PM,48,-122,91,70,161
34864,FremontBridge,09/24/2016 04:00:00 PM,48,-122,86,86,172
34865,FremontBridge,09/24/2016 05:00:00 PM,48,-122,73,71,144
34866,FremontBridge,09/24/2016 06:00:00 PM,48,-122,48,33,81
34867,FremontBridge,09/24/2016 07:00:00 PM,48,-122,35,24,59
34868,FremontBridge,09/24/2016 08:00:00 PM,48,-122,10,20,30
34869,FremontBridge,09/24/2016 09:00:00 PM,48,-122,13,18,31
34870,FremontBridge,09/24/2016 10:00:00 PM,48,-122,10,9,19
34871,FremontBridge,09/24/2016 11:00:00 PM,48,-122,12,25,37
34872,FremontBridge,09/25/2016 12:00:00 AM,48,-122,8,8,16
34873,FremontBridge,09/25/2016 01:00:00 AM,48,-122,5,7,12
34874,FremontBridge,09/25/2016 02:00:00 AM,48,-122,1,4,5
34875,FremontBridge,09/25/2016 03:00:00 AM,48,-122,1,0,1
34876,FremontBridge,09/25/2016 04:00:00 AM,48,-122,0,1,1
34877,FremontBridge,09/25/2016 05:00:00 AM,48,-122,2,1,3
34878,FremontBridge,09/25/2016 06:00:00 AM,48,-122,5,5,10
34879,FremontBridge,09/25/2016 07:00:00 AM,48,-122,13,21,34
34880,FremontBridge,09/25/2016 08:00:00 AM,48,-122,26,32,58
34881,FremontBridge,09/25/2016 09:00:00 AM,48,-122,47,34,81
34882,FremontBridge,09/25/2016 10:00:00 AM,48,-122,58,49,107
34883,FremontBridge,09/25/2016 11:00:00 AM,48,-122,61,62,123
34884,FremontBridge,09/25/2016 12:00:00 PM,48,-122,80,59,139
34885,FremontBridge,09/25/2016 01:00:00 PM,48,-122,79,68,147
34886,FremontBridge,09/25/2016 02:00:00 PM,48,-122,82,72,154
34887,FremontBridge,09/25/2016 03:00:00 PM,48,-122,96,83,179
34888,FremontBridge,09/25/2016 04:00:00 PM,48,-122,87,82,169
34889,FremontBridge,09/25/2016 05:00:00 PM,48,-122,68,90,158
34890,FremontBridge,09/25/2016 06:00:00 PM,48,-122,57,61,118
34891,FremontBridge,09/25/2016 07:00:00 PM,48,-122,27,34,61
34892,FremontBridge,09/25/2016 08:00:00 PM,48,-122,21,13,34
34893,FremontBridge,09/25/2016 09:00:00 PM,48,-122,17,18,35
34894,FremontBridge,09/25/2016 10:00:00 PM,48,-122,17,2,19
34895,FremontBridge,09/25/2016 11:00:00 PM,48,-122,7,2,9
34896,FremontBridge,09/26/2016 12:00:00 AM,48,-122,5,1,6
34897,FremontBridge,09/26/2016 01:00:00 AM,48,-122,1,0,1
34898,FremontBridge,09/26/2016 02:00:00 AM,48,-122,1,0,1
34899,FremontBridge,09/26/2016 03:00:00 AM,48,-122,0,0,0
34900,FremontBridge,09/26/2016 04:00:00 AM,48,-122,4,4,8
34901,FremontBridge,09/26/2016 05:00:00 AM,48,-122,10,23,33
34902,FremontBridge,09/26/2016 06:00:00 AM,48,-122,61,112,173
34903,FremontBridge,09/26/2016 07:00:00 AM,48,-122,133,290,423
34904,FremontBridge,09/26/2016 08:00:00 AM,48,-122,234,381,615
34905,FremontBridge,09/26/2016 09:00:00 AM,48,-122,146,159,305
34906,FremontBridge,09/26/2016 10:00:00 AM,48,-122,52,69,121
34907,FremontBridge,09/26/2016 11:00:00 AM,48,-122,45,48,93
34908,FremontBridge,09/26/2016 12:00:00 PM,48,-122,61,58,119
34909,FremontBridge,09/26/2016 01:00:00 PM,48,-122,45,68,113
34910,FremontBridge,09/26/2016 02:00:00 PM,48,-122,81,55,136
34911,FremontBridge,09/26/2016 03:00:00 PM,48,-122,118,79,197
34912,FremontBridge,09/26/2016 04:00:00 PM,48,-122,265,159,424
34913,FremontBridge,09/26/2016 05:00:00 PM,48,-122,648,220,868
34914,FremontBridge,09/26/2016 06:00:00 PM,48,-122,249,139,388
34915,FremontBridge,09/26/2016 07:00:00 PM,48,-122,92,47,139
34916,FremontBridge,09/26/2016 08:00:00 PM,48,-122,70,44,114
34917,FremontBridge,09/26/2016 09:00:00 PM,48,-122,40,26,66
34918,FremontBridge,09/26/2016 10:00:00 PM,48,-122,19,8,27
34919,FremontBridge,09/26/2016 11:00:00 PM,48,-122,4,8,12
34920,FremontBridge,09/27/2016 12:00:00 AM,48,-122,5,3,8
34921,FremontBridge,09/27/2016 01:00:00 AM,48,-122,5,4,9
34922,FremontBridge,09/27/2016 02:00:00 AM,48,-122,1,2,3
34923,FremontBridge,09/27/2016 03:00:00 AM,48,-122,1,0,1
34924,FremontBridge,09/27/2016 04:00:00 AM,48,-122,1,3,4
34925,FremontBridge,09/27/2016 05:00:00 AM,48,-122,15,30,45
34926,FremontBridge,09/27/2016 06:00:00 AM,48,-122,62,108,170
34927,FremontBridge,09/27/2016 07:00:00 AM,48,-122,143,298,441
34928,FremontBridge,09/27/2016 08:00:00 AM,48,-122,231,373,604
34929,FremontBridge,09/27/2016 09:00:00 AM,48,-122,127,138,265
34930,FremontBridge,09/27/2016 10:00:00 AM,48,-122,60,54,114
34931,FremontBridge,09/27/2016 11:00:00 AM,48,-122,41,55,96
34932,FremontBridge,09/27/2016 12:00:00 PM,48,-122,33,30,63
34933,FremontBridge,09/27/2016 01:00:00 PM,48,-122,44,57,101
34934,FremontBridge,09/27/2016 02:00:00 PM,48,-122,76,53,129
34935,FremontBridge,09/27/2016 03:00:00 PM,48,-122,94,64,158
34936,FremontBridge,09/27/2016 04:00:00 PM,48,-122,241,127,368
34937,FremontBridge,09/27/2016 05:00:00 PM,48,-122,544,191,735
34938,FremontBridge,09/27/2016 06:00:00 PM,48,-122,325,138,463
34939,FremontBridge,09/27/2016 07:00:00 PM,48,-122,136,69,205
34940,FremontBridge,09/27/2016 08:00:00 PM,48,-122,52,37,89
34941,FremontBridge,09/27/2016 09:00:00 PM,48,-122,30,26,56
34942,FremontBridge,09/27/2016 10:00:00 PM,48,-122,20,12,32
34943,FremontBridge,09/27/2016 11:00:00 PM,48,-122,8,15,23
34944,FremontBridge,09/28/2016 12:00:00 AM,48,-122,8,3,11
34945,FremontBridge,09/28/2016 01:00:00 AM,48,-122,2,7,9
34946,FremontBridge,09/28/2016 02:00:00 AM,48,-122,1,1,2
34947,FremontBridge,09/28/2016 03:00:00 AM,48,-122,2,2,4
34948,FremontBridge,09/28/2016 04:00:00 AM,48,-122,5,5,10
34949,FremontBridge,09/28/2016 05:00:00 AM,48,-122,15,26,41
34950,FremontBridge,09/28/2016 06:00:00 AM,48,-122,59,92,151
34951,FremontBridge,09/28/2016 07:00:00 AM,48,-122,150,279,429
34952,FremontBridge,09/28/2016 08:00:00 AM,48,-122,242,349,591
34953,FremontBridge,09/28/2016 09:00:00 AM,48,-122,144,154,298
34954,FremontBridge,09/28/2016 10:00:00 AM,48,-122,60,80,140
34955,FremontBridge,09/28/2016 11:00:00 AM,48,-122,36,71,107
34956,FremontBridge,09/28/2016 12:00:00 PM,48,-122,52,35,87
34957,FremontBridge,09/28/2016 01:00:00 PM,48,-122,51,53,104
34958,FremontBridge,09/28/2016 02:00:00 PM,48,-122,80,60,140
34959,FremontBridge,09/28/2016 03:00:00 PM,48,-122,87,78,165
34960,FremontBridge,09/28/2016 04:00:00 PM,48,-122,265,120,385
34961,FremontBridge,09/28/2016 05:00:00 PM,48,-122,455,196,651
34962,FremontBridge,09/28/2016 06:00:00 PM,48,-122,360,174,534
34963,FremontBridge,09/28/2016 07:00:00 PM,48,-122,107,72,179
34964,FremontBridge,09/28/2016 08:00:00 PM,48,-122,73,40,113
34965,FremontBridge,09/28/2016 09:00:00 PM,48,-122,47,25,72
34966,FremontBridge,09/28/2016 10:00:00 PM,48,-122,44,20,64
34967,FremontBridge,09/28/2016 11:00:00 PM,48,-122,16,10,26
34968,FremontBridge,09/29/2016 12:00:00 AM,48,-122,4,10,14
34969,FremontBridge,09/29/2016 01:00:00 AM,48,-122,3,2,5
34970,FremontBridge,09/29/2016 02:00:00 AM,48,-122,0,1,1
34971,FremontBridge,09/29/2016 03:00:00 AM,48,-122,1,2,3
34972,FremontBridge,09/29/2016 04:00:00 AM,48,-122,2,9,11
34973,FremontBridge,09/29/2016 05:00:00 AM,48,-122,15,23,38
34974,FremontBridge,09/29/2016 06:00:00 AM,48,-122,61,93,154
34975,FremontBridge,09/29/2016 07:00:00 AM,48,-122,129,257,386
34976,FremontBridge,09/29/2016 08:00:00 AM,48,-122,228,338,566
34977,FremontBridge,09/29/2016 09:00:00 AM,48,-122,139,172,311
34978,FremontBridge,09/29/2016 10:00:00 AM,48,-122,61,58,119
34979,FremontBridge,09/29/2016 11:00:00 AM,48,-122,41,47,88
34980,FremontBridge,09/29/2016 12:00:00 PM,48,-122,67,46,113
34981,FremontBridge,09/29/2016 01:00:00 PM,48,-122,54,55,109
34982,FremontBridge,09/29/2016 02:00:00 PM,48,-122,63,44,107
34983,FremontBridge,09/29/2016 03:00:00 PM,48,-122,104,65,169
34984,FremontBridge,09/29/2016 04:00:00 PM,48,-122,222,117,339
34985,FremontBridge,09/29/2016 05:00:00 PM,48,-122,500,151,651
34986,FremontBridge,09/29/2016 06:00:00 PM,48,-122,291,157,448
34987,FremontBridge,09/29/2016 07:00:00 PM,48,-122,108,53,161
34988,FremontBridge,09/29/2016 08:00:00 PM,48,-122,53,27,80
34989,FremontBridge,09/29/2016 09:00:00 PM,48,-122,36,27,63
34990,FremontBridge,09/29/2016 10:00:00 PM,48,-122,23,16,39
34991,FremontBridge,09/29/2016 11:00:00 PM,48,-122,12,6,18
34992,FremontBridge,09/30/2016 12:00:00 AM,48,-122,7,8,15
34993,FremontBridge,09/30/2016 01:00:00 AM,48,-122,3,4,7
34994,FremontBridge,09/30/2016 02:00:00 AM,48,-122,3,1,4
34995,FremontBridge,09/30/2016 03:00:00 AM,48,-122,1,3,4
34996,FremontBridge,09/30/2016 04:00:00 AM,48,-122,3,5,8
34997,FremontBridge,09/30/2016 05:00:00 AM,48,-122,18,24,42
34998,FremontBridge,09/30/2016 06:00:00 AM,48,-122,46,69,115
34999,FremontBridge,09/30/2016 07:00:00 AM,48,-122,120,207,327
35000,FremontBridge,09/30/2016 08:00:00 AM,48,-122,185,300,485
35001,FremontBridge,09/30/2016 09:00:00 AM,48,-122,113,173,286
35002,FremontBridge,09/30/2016 10:00:00 AM,48,-122,56,81,137
35003,FremontBridge,09/30/2016 11:00:00 AM,48,-122,46,36,82
35004,FremontBridge,09/30/2016 12:00:00 PM,48,-122,53,44,97
35005,FremontBridge,09/30/2016 01:00:00 PM,48,-122,68,49,117
35006,FremontBridge,09/30/2016 02:00:00 PM,48,-122,70,66,136
35007,FremontBridge,09/30/2016 03:00:00 PM,48,-122,142,91,233
35008,FremontBridge,09/30/2016 04:00:00 PM,48,-122,276,122,398
35009,FremontBridge,09/30/2016 05:00:00 PM,48,-122,365,166,531
35010,FremontBridge,09/30/2016 06:00:00 PM,48,-122,209,125,334
35011,FremontBridge,09/30/2016 07:00:00 PM,48,-122,93,48,141
35012,FremontBridge,09/30/2016 08:00:00 PM,48,-122,47,24,71
35013,FremontBridge,09/30/2016 09:00:00 PM,48,-122,31,39,70
35014,FremontBridge,09/30/2016 10:00:00 PM,48,-122,40,29,69
35015,FremontBridge,09/30/2016 11:00:00 PM,48,-122,25,11,36
35016,FremontBridge,10/01/2016 12:00:00 AM,48,-122,14,11,25
35017,FremontBridge,10/01/2016 01:00:00 AM,48,-122,2,5,7
35018,FremontBridge,10/01/2016 02:00:00 AM,48,-122,4,3,7
35019,FremontBridge,10/01/2016 03:00:00 AM,48,-122,4,1,5
35020,FremontBridge,10/01/2016 04:00:00 AM,48,-122,1,1,2
35021,FremontBridge,10/01/2016 05:00:00 AM,48,-122,2,5,7
35022,FremontBridge,10/01/2016 06:00:00 AM,48,-122,9,14,23
35023,FremontBridge,10/01/2016 07:00:00 AM,48,-122,9,23,32
35024,FremontBridge,10/01/2016 08:00:00 AM,48,-122,20,42,62
35025,FremontBridge,10/01/2016 09:00:00 AM,48,-122,48,40,88
35026,FremontBridge,10/01/2016 10:00:00 AM,48,-122,39,60,99
35027,FremontBridge,10/01/2016 11:00:00 AM,48,-122,50,42,92
35028,FremontBridge,10/01/2016 12:00:00 PM,48,-122,48,59,107
35029,FremontBridge,10/01/2016 01:00:00 PM,48,-122,35,32,67
35030,FremontBridge,10/01/2016 02:00:00 PM,48,-122,33,25,58
35031,FremontBridge,10/01/2016 03:00:00 PM,48,-122,34,21,55
35032,FremontBridge,10/01/2016 04:00:00 PM,48,-122,42,49,91
35033,FremontBridge,10/01/2016 05:00:00 PM,48,-122,41,32,73
35034,FremontBridge,10/01/2016 06:00:00 PM,48,-122,33,39,72
35035,FremontBridge,10/01/2016 07:00:00 PM,48,-122,21,15,36
35036,FremontBridge,10/01/2016 08:00:00 PM,48,-122,14,5,19
35037,FremontBridge,10/01/2016 09:00:00 PM,48,-122,6,9,15
35038,FremontBridge,10/01/2016 10:00:00 PM,48,-122,13,6,19
35039,FremontBridge,10/01/2016 11:00:00 PM,48,-122,10,5,15
35040,FremontBridge,10/02/2016 12:00:00 AM,48,-122,6,4,10
35041,FremontBridge,10/02/2016 01:00:00 AM,48,-122,2,0,2
35042,FremontBridge,10/02/2016 02:00:00 AM,48,-122,1,0,1
35043,FremontBridge,10/02/2016 03:00:00 AM,48,-122,2,0,2
35044,FremontBridge,10/02/2016 04:00:00 AM,48,-122,1,1,2
35045,FremontBridge,10/02/2016 05:00:00 AM,48,-122,1,6,7
35046,FremontBridge,10/02/2016 06:00:00 AM,48,-122,6,4,10
35047,FremontBridge,10/02/2016 07:00:00 AM,48,-122,10,7,17
35048,FremontBridge,10/02/2016 08:00:00 AM,48,-122,35,31,66
35049,FremontBridge,10/02/2016 09:00:00 AM,48,-122,34,38,72
35050,FremontBridge,10/02/2016 10:00:00 AM,48,-122,35,44,79
35051,FremontBridge,10/02/2016 11:00:00 AM,48,-122,57,62,119
35052,FremontBridge,10/02/2016 12:00:00 PM,48,-122,58,60,118
35053,FremontBridge,10/02/2016 01:00:00 PM,48,-122,73,83,156
35054,FremontBridge,10/02/2016 02:00:00 PM,48,-122,113,87,200
35055,FremontBridge,10/02/2016 03:00:00 PM,48,-122,90,60,150
35056,FremontBridge,10/02/2016 04:00:00 PM,48,-122,104,118,222
35057,FremontBridge,10/02/2016 05:00:00 PM,48,-122,69,66,135
35058,FremontBridge,10/02/2016 06:00:00 PM,48,-122,39,56,95
35059,FremontBridge,10/02/2016 07:00:00 PM,48,-122,19,28,47
35060,FremontBridge,10/02/2016 08:00:00 PM,48,-122,23,10,33
35061,FremontBridge,10/02/2016 09:00:00 PM,48,-122,9,6,15
35062,FremontBridge,10/02/2016 10:00:00 PM,48,-122,6,7,13
35063,FremontBridge,10/02/2016 11:00:00 PM,48,-122,8,7,15
35064,FremontBridge,10/03/2016 12:00:00 AM,48,-122,6,5,11
35065,FremontBridge,10/03/2016 01:00:00 AM,48,-122,3,2,5
35066,FremontBridge,10/03/2016 02:00:00 AM,48,-122,1,4,5
35067,FremontBridge,10/03/2016 03:00:00 AM,48,-122,2,0,2
35068,FremontBridge,10/03/2016 04:00:00 AM,48,-122,5,7,12
35069,FremontBridge,10/03/2016 05:00:00 AM,48,-122,15,18,33
35070,FremontBridge,10/03/2016 06:00:00 AM,48,-122,60,103,163
35071,FremontBridge,10/03/2016 07:00:00 AM,48,-122,134,244,378
35072,FremontBridge,10/03/2016 08:00:00 AM,48,-122,223,342,565
35073,FremontBridge,10/03/2016 09:00:00 AM,48,-122,104,144,248
35074,FremontBridge,10/03/2016 10:00:00 AM,48,-122,54,59,113
35075,FremontBridge,10/03/2016 11:00:00 AM,48,-122,36,38,74
35076,FremontBridge,10/03/2016 12:00:00 PM,48,-122,49,34,83
35077,FremontBridge,10/03/2016 01:00:00 PM,48,-122,33,32,65
35078,FremontBridge,10/03/2016 02:00:00 PM,48,-122,41,42,83
35079,FremontBridge,10/03/2016 03:00:00 PM,48,-122,79,63,142
35080,FremontBridge,10/03/2016 04:00:00 PM,48,-122,221,101,322
35081,FremontBridge,10/03/2016 05:00:00 PM,48,-122,524,163,687
35082,FremontBridge,10/03/2016 06:00:00 PM,48,-122,280,137,417
35083,FremontBridge,10/03/2016 07:00:00 PM,48,-122,115,41,156
35084,FremontBridge,10/03/2016 08:00:00 PM,48,-122,52,32,84
35085,FremontBridge,10/03/2016 09:00:00 PM,48,-122,26,15,41
35086,FremontBridge,10/03/2016 10:00:00 PM,48,-122,10,6,16
35087,FremontBridge,10/03/2016 11:00:00 PM,48,-122,5,5,10
35088,FremontBridge,10/04/2016 12:00:00 AM,48,-122,2,1,3
35089,FremontBridge,10/04/2016 01:00:00 AM,48,-122,1,5,6
35090,FremontBridge,10/04/2016 02:00:00 AM,48,-122,3,2,5
35091,FremontBridge,10/04/2016 03:00:00 AM,48,-122,2,3,5
35092,FremontBridge,10/04/2016 04:00:00 AM,48,-122,2,7,9
35093,FremontBridge,10/04/2016 05:00:00 AM,48,-122,17,20,37
35094,FremontBridge,10/04/2016 06:00:00 AM,48,-122,43,79,122
35095,FremontBridge,10/04/2016 07:00:00 AM,48,-122,116,205,321
35096,FremontBridge,10/04/2016 08:00:00 AM,48,-122,166,331,497
35097,FremontBridge,10/04/2016 09:00:00 AM,48,-122,98,123,221
35098,FremontBridge,10/04/2016 10:00:00 AM,48,-122,47,42,89
35099,FremontBridge,10/04/2016 11:00:00 AM,48,-122,26,33,59
35100,FremontBridge,10/04/2016 12:00:00 PM,48,-122,30,37,67
35101,FremontBridge,10/04/2016 01:00:00 PM,48,-122,31,30,61
35102,FremontBridge,10/04/2016 02:00:00 PM,48,-122,30,25,55
35103,FremontBridge,10/04/2016 03:00:00 PM,48,-122,68,39,107
35104,FremontBridge,10/04/2016 04:00:00 PM,48,-122,175,69,244
35105,FremontBridge,10/04/2016 05:00:00 PM,48,-122,366,137,503
35106,FremontBridge,10/04/2016 06:00:00 PM,48,-122,196,89,285
35107,FremontBridge,10/04/2016 07:00:00 PM,48,-122,81,60,141
35108,FremontBridge,10/04/2016 08:00:00 PM,48,-122,59,21,80
35109,FremontBridge,10/04/2016 09:00:00 PM,48,-122,18,17,35
35110,FremontBridge,10/04/2016 10:00:00 PM,48,-122,8,15,23
35111,FremontBridge,10/04/2016 11:00:00 PM,48,-122,5,1,6
35112,FremontBridge,10/05/2016 12:00:00 AM,48,-122,3,9,12
35113,FremontBridge,10/05/2016 01:00:00 AM,48,-122,1,3,4
35114,FremontBridge,10/05/2016 02:00:00 AM,48,-122,0,4,4
35115,FremontBridge,10/05/2016 03:00:00 AM,48,-122,0,0,0
35116,FremontBridge,10/05/2016 04:00:00 AM,48,-122,5,8,13
35117,FremontBridge,10/05/2016 05:00:00 AM,48,-122,19,24,43
35118,FremontBridge,10/05/2016 06:00:00 AM,48,-122,48,69,117
35119,FremontBridge,10/05/2016 07:00:00 AM,48,-122,119,204,323
35120,FremontBridge,10/05/2016 08:00:00 AM,48,-122,187,293,480
35121,FremontBridge,10/05/2016 09:00:00 AM,48,-122,99,135,234
35122,FremontBridge,10/05/2016 10:00:00 AM,48,-122,61,46,107
35123,FremontBridge,10/05/2016 11:00:00 AM,48,-122,23,32,55
35124,FremontBridge,10/05/2016 12:00:00 PM,48,-122,35,27,62
35125,FremontBridge,10/05/2016 01:00:00 PM,48,-122,51,32,83
35126,FremontBridge,10/05/2016 02:00:00 PM,48,-122,47,25,72
35127,FremontBridge,10/05/2016 03:00:00 PM,48,-122,89,68,157
35128,FremontBridge,10/05/2016 04:00:00 PM,48,-122,194,100,294
35129,FremontBridge,10/05/2016 05:00:00 PM,48,-122,418,162,580
35130,FremontBridge,10/05/2016 06:00:00 PM,48,-122,259,140,399
35131,FremontBridge,10/05/2016 07:00:00 PM,48,-122,124,75,199
35132,FremontBridge,10/05/2016 08:00:00 PM,48,-122,65,29,94
35133,FremontBridge,10/05/2016 09:00:00 PM,48,-122,37,26,63
35134,FremontBridge,10/05/2016 10:00:00 PM,48,-122,26,18,44
35135,FremontBridge,10/05/2016 11:00:00 PM,48,-122,12,9,21
35136,FremontBridge,10/06/2016 12:00:00 AM,48,-122,7,7,14
35137,FremontBridge,10/06/2016 01:00:00 AM,48,-122,3,3,6
35138,FremontBridge,10/06/2016 02:00:00 AM,48,-122,0,5,5
35139,FremontBridge,10/06/2016 03:00:00 AM,48,-122,2,0,2
35140,FremontBridge,10/06/2016 04:00:00 AM,48,-122,6,6,12
35141,FremontBridge,10/06/2016 05:00:00 AM,48,-122,12,21,33
35142,FremontBridge,10/06/2016 06:00:00 AM,48,-122,45,83,128
35143,FremontBridge,10/06/2016 07:00:00 AM,48,-122,127,210,337
35144,FremontBridge,10/06/2016 08:00:00 AM,48,-122,197,306,503
35145,FremontBridge,10/06/2016 09:00:00 AM,48,-122,126,124,250
35146,FremontBridge,10/06/2016 10:00:00 AM,48,-122,61,52,113
35147,FremontBridge,10/06/2016 11:00:00 AM,48,-122,45,42,87
35148,FremontBridge,10/06/2016 12:00:00 PM,48,-122,43,42,85
35149,FremontBridge,10/06/2016 01:00:00 PM,48,-122,46,38,84
35150,FremontBridge,10/06/2016 02:00:00 PM,48,-122,43,41,84
35151,FremontBridge,10/06/2016 03:00:00 PM,48,-122,90,50,140
35152,FremontBridge,10/06/2016 04:00:00 PM,48,-122,172,82,254
35153,FremontBridge,10/06/2016 05:00:00 PM,48,-122,396,136,532
35154,FremontBridge,10/06/2016 06:00:00 PM,48,-122,229,85,314
35155,FremontBridge,10/06/2016 07:00:00 PM,48,-122,83,53,136
35156,FremontBridge,10/06/2016 08:00:00 PM,48,-122,45,21,66
35157,FremontBridge,10/06/2016 09:00:00 PM,48,-122,30,22,52
35158,FremontBridge,10/06/2016 10:00:00 PM,48,-122,22,11,33
35159,FremontBridge,10/06/2016 11:00:00 PM,48,-122,6,4,10
35160,FremontBridge,10/07/2016 12:00:00 AM,48,-122,1,1,2
35161,FremontBridge,10/07/2016 01:00:00 AM,48,-122,1,2,3
35162,FremontBridge,10/07/2016 02:00:00 AM,48,-122,0,0,0
35163,FremontBridge,10/07/2016 03:00:00 AM,48,-122,1,2,3
35164,FremontBridge,10/07/2016 04:00:00 AM,48,-122,6,2,8
35165,FremontBridge,10/07/2016 05:00:00 AM,48,-122,15,13,28
35166,FremontBridge,10/07/2016 06:00:00 AM,48,-122,43,49,92
35167,FremontBridge,10/07/2016 07:00:00 AM,48,-122,83,158,241
35168,FremontBridge,10/07/2016 08:00:00 AM,48,-122,143,208,351
35169,FremontBridge,10/07/2016 09:00:00 AM,48,-122,87,102,189
35170,FremontBridge,10/07/2016 10:00:00 AM,48,-122,40,49,89
35171,FremontBridge,10/07/2016 11:00:00 AM,48,-122,26,37,63
35172,FremontBridge,10/07/2016 12:00:00 PM,48,-122,25,29,54
35173,FremontBridge,10/07/2016 01:00:00 PM,48,-122,34,30,64
35174,FremontBridge,10/07/2016 02:00:00 PM,48,-122,36,34,70
35175,FremontBridge,10/07/2016 03:00:00 PM,48,-122,90,46,136
35176,FremontBridge,10/07/2016 04:00:00 PM,48,-122,149,75,224
35177,FremontBridge,10/07/2016 05:00:00 PM,48,-122,310,129,439
35178,FremontBridge,10/07/2016 06:00:00 PM,48,-122,171,79,250
35179,FremontBridge,10/07/2016 07:00:00 PM,48,-122,55,27,82
35180,FremontBridge,10/07/2016 08:00:00 PM,48,-122,29,15,44
35181,FremontBridge,10/07/2016 09:00:00 PM,48,-122,16,6,22
35182,FremontBridge,10/07/2016 10:00:00 PM,48,-122,16,5,21
35183,FremontBridge,10/07/2016 11:00:00 PM,48,-122,13,7,20
35184,FremontBridge,10/08/2016 12:00:00 AM,48,-122,6,6,12
35185,FremontBridge,10/08/2016 01:00:00 AM,48,-122,8,7,15
35186,FremontBridge,10/08/2016 02:00:00 AM,48,-122,0,3,3
35187,FremontBridge,10/08/2016 03:00:00 AM,48,-122,1,0,1
35188,FremontBridge,10/08/2016 04:00:00 AM,48,-122,2,0,2
35189,FremontBridge,10/08/2016 05:00:00 AM,48,-122,3,1,4
35190,FremontBridge,10/08/2016 06:00:00 AM,48,-122,3,5,8
35191,FremontBridge,10/08/2016 07:00:00 AM,48,-122,7,10,17
35192,FremontBridge,10/08/2016 08:00:00 AM,48,-122,17,24,41
35193,FremontBridge,10/08/2016 09:00:00 AM,48,-122,17,34,51
35194,FremontBridge,10/08/2016 10:00:00 AM,48,-122,24,42,66
35195,FremontBridge,10/08/2016 11:00:00 AM,48,-122,29,36,65
35196,FremontBridge,10/08/2016 12:00:00 PM,48,-122,33,54,87
35197,FremontBridge,10/08/2016 01:00:00 PM,48,-122,27,28,55
35198,FremontBridge,10/08/2016 02:00:00 PM,48,-122,26,25,51
35199,FremontBridge,10/08/2016 03:00:00 PM,48,-122,26,22,48
35200,FremontBridge,10/08/2016 04:00:00 PM,48,-122,23,14,37
35201,FremontBridge,10/08/2016 05:00:00 PM,48,-122,11,15,26
35202,FremontBridge,10/08/2016 06:00:00 PM,48,-122,23,7,30
35203,FremontBridge,10/08/2016 07:00:00 PM,48,-122,7,13,20
35204,FremontBridge,10/08/2016 08:00:00 PM,48,-122,11,11,22
35205,FremontBridge,10/08/2016 09:00:00 PM,48,-122,14,8,22
35206,FremontBridge,10/08/2016 10:00:00 PM,48,-122,7,0,7
35207,FremontBridge,10/08/2016 11:00:00 PM,48,-122,3,7,10
35208,FremontBridge,10/09/2016 12:00:00 AM,48,-122,3,2,5
35209,FremontBridge,10/09/2016 01:00:00 AM,48,-122,2,2,4
35210,FremontBridge,10/09/2016 02:00:00 AM,48,-122,0,1,1
35211,FremontBridge,10/09/2016 03:00:00 AM,48,-122,1,1,2
35212,FremontBridge,10/09/2016 04:00:00 AM,48,-122,0,1,1
35213,FremontBridge,10/09/2016 05:00:00 AM,48,-122,1,4,5
35214,FremontBridge,10/09/2016 06:00:00 AM,48,-122,3,3,6
35215,FremontBridge,10/09/2016 07:00:00 AM,48,-122,7,11,18
35216,FremontBridge,10/09/2016 08:00:00 AM,48,-122,15,15,30
35217,FremontBridge,10/09/2016 09:00:00 AM,48,-122,33,24,57
35218,FremontBridge,10/09/2016 10:00:00 AM,48,-122,28,35,63
35219,FremontBridge,10/09/2016 11:00:00 AM,48,-122,45,31,76
35220,FremontBridge,10/09/2016 12:00:00 PM,48,-122,53,49,102
35221,FremontBridge,10/09/2016 01:00:00 PM,48,-122,52,53,105
35222,FremontBridge,10/09/2016 02:00:00 PM,48,-122,69,65,134
35223,FremontBridge,10/09/2016 03:00:00 PM,48,-122,49,63,112
35224,FremontBridge,10/09/2016 04:00:00 PM,48,-122,68,61,129
35225,FremontBridge,10/09/2016 05:00:00 PM,48,-122,49,45,94
35226,FremontBridge,10/09/2016 06:00:00 PM,48,-122,24,24,48
35227,FremontBridge,10/09/2016 07:00:00 PM,48,-122,7,8,15
35228,FremontBridge,10/09/2016 08:00:00 PM,48,-122,13,10,23
35229,FremontBridge,10/09/2016 09:00:00 PM,48,-122,9,8,17
35230,FremontBridge,10/09/2016 10:00:00 PM,48,-122,11,9,20
35231,FremontBridge,10/09/2016 11:00:00 PM,48,-122,5,5,10
35232,FremontBridge,10/10/2016 12:00:00 AM,48,-122,2,1,3
35233,FremontBridge,10/10/2016 01:00:00 AM,48,-122,1,4,5
35234,FremontBridge,10/10/2016 02:00:00 AM,48,-122,0,0,0
35235,FremontBridge,10/10/2016 03:00:00 AM,48,-122,2,3,5
35236,FremontBridge,10/10/2016 04:00:00 AM,48,-122,3,2,5
35237,FremontBridge,10/10/2016 05:00:00 AM,48,-122,10,20,30
35238,FremontBridge,10/10/2016 06:00:00 AM,48,-122,36,90,126
35239,FremontBridge,10/10/2016 07:00:00 AM,48,-122,129,246,375
35240,FremontBridge,10/10/2016 08:00:00 AM,48,-122,202,337,539
35241,FremontBridge,10/10/2016 09:00:00 AM,48,-122,130,133,263
35242,FremontBridge,10/10/2016 10:00:00 AM,48,-122,64,61,125
35243,FremontBridge,10/10/2016 11:00:00 AM,48,-122,35,33,68
35244,FremontBridge,10/10/2016 12:00:00 PM,48,-122,41,34,75
35245,FremontBridge,10/10/2016 01:00:00 PM,48,-122,41,36,77
35246,FremontBridge,10/10/2016 02:00:00 PM,48,-122,48,50,98
35247,FremontBridge,10/10/2016 03:00:00 PM,48,-122,75,59,134
35248,FremontBridge,10/10/2016 04:00:00 PM,48,-122,196,94,290
35249,FremontBridge,10/10/2016 05:00:00 PM,48,-122,503,171,674
35250,FremontBridge,10/10/2016 06:00:00 PM,48,-122,274,119,393
35251,FremontBridge,10/10/2016 07:00:00 PM,48,-122,94,59,153
35252,FremontBridge,10/10/2016 08:00:00 PM,48,-122,42,36,78
35253,FremontBridge,10/10/2016 09:00:00 PM,48,-122,35,9,44
35254,FremontBridge,10/10/2016 10:00:00 PM,48,-122,17,6,23
35255,FremontBridge,10/10/2016 11:00:00 PM,48,-122,10,5,15
35256,FremontBridge,10/11/2016 12:00:00 AM,48,-122,9,2,11
35257,FremontBridge,10/11/2016 01:00:00 AM,48,-122,0,2,2
35258,FremontBridge,10/11/2016 02:00:00 AM,48,-122,3,1,4
35259,FremontBridge,10/11/2016 03:00:00 AM,48,-122,0,1,1
35260,FremontBridge,10/11/2016 04:00:00 AM,48,-122,4,9,13
35261,FremontBridge,10/11/2016 05:00:00 AM,48,-122,16,28,44
35262,FremontBridge,10/11/2016 06:00:00 AM,48,-122,52,107,159
35263,FremontBridge,10/11/2016 07:00:00 AM,48,-122,151,239,390
35264,FremontBridge,10/11/2016 08:00:00 AM,48,-122,208,352,560
35265,FremontBridge,10/11/2016 09:00:00 AM,48,-122,124,171,295
35266,FremontBridge,10/11/2016 10:00:00 AM,48,-122,53,59,112
35267,FremontBridge,10/11/2016 11:00:00 AM,48,-122,49,50,99
35268,FremontBridge,10/11/2016 12:00:00 PM,48,-122,44,48,92
35269,FremontBridge,10/11/2016 01:00:00 PM,48,-122,57,39,96
35270,FremontBridge,10/11/2016 02:00:00 PM,48,-122,62,55,117
35271,FremontBridge,10/11/2016 03:00:00 PM,48,-122,85,83,168
35272,FremontBridge,10/11/2016 04:00:00 PM,48,-122,238,102,340
35273,FremontBridge,10/11/2016 05:00:00 PM,48,-122,475,184,659
35274,FremontBridge,10/11/2016 06:00:00 PM,48,-122,314,133,447
35275,FremontBridge,10/11/2016 07:00:00 PM,48,-122,119,57,176
35276,FremontBridge,10/11/2016 08:00:00 PM,48,-122,62,33,95
35277,FremontBridge,10/11/2016 09:00:00 PM,48,-122,46,23,69
35278,FremontBridge,10/11/2016 10:00:00 PM,48,-122,17,12,29
35279,FremontBridge,10/11/2016 11:00:00 PM,48,-122,15,6,21
35280,FremontBridge,10/12/2016 12:00:00 AM,48,-122,6,9,15
35281,FremontBridge,10/12/2016 01:00:00 AM,48,-122,3,2,5
35282,FremontBridge,10/12/2016 02:00:00 AM,48,-122,0,0,0
35283,FremontBridge,10/12/2016 03:00:00 AM,48,-122,0,1,1
35284,FremontBridge,10/12/2016 04:00:00 AM,48,-122,4,3,7
35285,FremontBridge,10/12/2016 05:00:00 AM,48,-122,13,18,31
35286,FremontBridge,10/12/2016 06:00:00 AM,48,-122,53,74,127
35287,FremontBridge,10/12/2016 07:00:00 AM,48,-122,144,243,387
35288,FremontBridge,10/12/2016 08:00:00 AM,48,-122,221,333,554
35289,FremontBridge,10/12/2016 09:00:00 AM,48,-122,147,135,282
35290,FremontBridge,10/12/2016 10:00:00 AM,48,-122,53,61,114
35291,FremontBridge,10/12/2016 11:00:00 AM,48,-122,41,36,77
35292,FremontBridge,10/12/2016 12:00:00 PM,48,-122,56,42,98
35293,FremontBridge,10/12/2016 01:00:00 PM,48,-122,44,59,103
35294,FremontBridge,10/12/2016 02:00:00 PM,48,-122,74,48,122
35295,FremontBridge,10/12/2016 03:00:00 PM,48,-122,96,68,164
35296,FremontBridge,10/12/2016 04:00:00 PM,48,-122,230,133,363
35297,FremontBridge,10/12/2016 05:00:00 PM,48,-122,515,187,702
35298,FremontBridge,10/12/2016 06:00:00 PM,48,-122,257,134,391
35299,FremontBridge,10/12/2016 07:00:00 PM,48,-122,100,58,158
35300,FremontBridge,10/12/2016 08:00:00 PM,48,-122,52,24,76
35301,FremontBridge,10/12/2016 09:00:00 PM,48,-122,26,15,41
35302,FremontBridge,10/12/2016 10:00:00 PM,48,-122,37,13,50
35303,FremontBridge,10/12/2016 11:00:00 PM,48,-122,6,6,12
35304,FremontBridge,10/13/2016 12:00:00 AM,48,-122,2,3,5
35305,FremontBridge,10/13/2016 01:00:00 AM,48,-122,1,2,3
35306,FremontBridge,10/13/2016 02:00:00 AM,48,-122,2,0,2
35307,FremontBridge,10/13/2016 03:00:00 AM,48,-122,0,0,0
35308,FremontBridge,10/13/2016 04:00:00 AM,48,-122,2,1,3
35309,FremontBridge,10/13/2016 05:00:00 AM,48,-122,8,20,28
35310,FremontBridge,10/13/2016 06:00:00 AM,48,-122,25,39,64
35311,FremontBridge,10/13/2016 07:00:00 AM,48,-122,66,108,174
35312,FremontBridge,10/13/2016 08:00:00 AM,48,-122,93,142,235
35313,FremontBridge,10/13/2016 09:00:00 AM,48,-122,50,79,129
35314,FremontBridge,10/13/2016 10:00:00 AM,48,-122,21,23,44
35315,FremontBridge,10/13/2016 11:00:00 AM,48,-122,13,10,23
35316,FremontBridge,10/13/2016 12:00:00 PM,48,-122,13,10,23
35317,FremontBridge,10/13/2016 01:00:00 PM,48,-122,10,9,19
35318,FremontBridge,10/13/2016 02:00:00 PM,48,-122,24,10,34
35319,FremontBridge,10/13/2016 03:00:00 PM,48,-122,30,25,55
35320,FremontBridge,10/13/2016 04:00:00 PM,48,-122,69,30,99
35321,FremontBridge,10/13/2016 05:00:00 PM,48,-122,182,54,236
35322,FremontBridge,10/13/2016 06:00:00 PM,48,-122,112,50,162
35323,FremontBridge,10/13/2016 07:00:00 PM,48,-122,42,24,66
35324,FremontBridge,10/13/2016 08:00:00 PM,48,-122,15,17,32
35325,FremontBridge,10/13/2016 09:00:00 PM,48,-122,12,5,17
35326,FremontBridge,10/13/2016 10:00:00 PM,48,-122,6,6,12
35327,FremontBridge,10/13/2016 11:00:00 PM,48,-122,4,8,12
35328,FremontBridge,10/14/2016 12:00:00 AM,48,-122,1,2,3
35329,FremontBridge,10/14/2016 01:00:00 AM,48,-122,1,1,2
35330,FremontBridge,10/14/2016 02:00:00 AM,48,-122,0,2,2
35331,FremontBridge,10/14/2016 03:00:00 AM,48,-122,1,2,3
35332,FremontBridge,10/14/2016 04:00:00 AM,48,-122,3,1,4
35333,FremontBridge,10/14/2016 05:00:00 AM,48,-122,7,11,18
35334,FremontBridge,10/14/2016 06:00:00 AM,48,-122,14,26,40
35335,FremontBridge,10/14/2016 07:00:00 AM,48,-122,29,48,77
35336,FremontBridge,10/14/2016 08:00:00 AM,48,-122,43,87,130
35337,FremontBridge,10/14/2016 09:00:00 AM,48,-122,29,46,75
35338,FremontBridge,10/14/2016 10:00:00 AM,48,-122,18,24,42
35339,FremontBridge,10/14/2016 11:00:00 AM,48,-122,12,8,20
35340,FremontBridge,10/14/2016 12:00:00 PM,48,-122,10,6,16
35341,FremontBridge,10/14/2016 01:00:00 PM,48,-122,9,6,15
35342,FremontBridge,10/14/2016 02:00:00 PM,48,-122,11,7,18
35343,FremontBridge,10/14/2016 03:00:00 PM,48,-122,24,19,43
35344,FremontBridge,10/14/2016 04:00:00 PM,48,-122,53,38,91
35345,FremontBridge,10/14/2016 05:00:00 PM,48,-122,109,56,165
35346,FremontBridge,10/14/2016 06:00:00 PM,48,-122,55,36,91
35347,FremontBridge,10/14/2016 07:00:00 PM,48,-122,24,14,38
35348,FremontBridge,10/14/2016 08:00:00 PM,48,-122,16,3,19
35349,FremontBridge,10/14/2016 09:00:00 PM,48,-122,6,5,11
35350,FremontBridge,10/14/2016 10:00:00 PM,48,-122,8,8,16
35351,FremontBridge,10/14/2016 11:00:00 PM,48,-122,2,1,3
35352,FremontBridge,10/15/2016 12:00:00 AM,48,-122,0,3,3
35353,FremontBridge,10/15/2016 01:00:00 AM,48,-122,0,5,5
35354,FremontBridge,10/15/2016 02:00:00 AM,48,-122,0,1,1
35355,FremontBridge,10/15/2016 03:00:00 AM,48,-122,1,1,2
35356,FremontBridge,10/15/2016 04:00:00 AM,48,-122,1,0,1
35357,FremontBridge,10/15/2016 05:00:00 AM,48,-122,1,0,1
35358,FremontBridge,10/15/2016 06:00:00 AM,48,-122,4,4,8
35359,FremontBridge,10/15/2016 07:00:00 AM,48,-122,4,8,12
35360,FremontBridge,10/15/2016 08:00:00 AM,48,-122,14,12,26
35361,FremontBridge,10/15/2016 09:00:00 AM,48,-122,6,7,13
35362,FremontBridge,10/15/2016 10:00:00 AM,48,-122,15,12,27
35363,FremontBridge,10/15/2016 11:00:00 AM,48,-122,15,11,26
35364,FremontBridge,10/15/2016 12:00:00 PM,48,-122,12,10,22
35365,FremontBridge,10/15/2016 01:00:00 PM,48,-122,11,6,17
35366,FremontBridge,10/15/2016 02:00:00 PM,48,-122,9,9,18
35367,FremontBridge,10/15/2016 03:00:00 PM,48,-122,12,14,26
35368,FremontBridge,10/15/2016 04:00:00 PM,48,-122,4,13,17
35369,FremontBridge,10/15/2016 05:00:00 PM,48,-122,9,5,14
35370,FremontBridge,10/15/2016 06:00:00 PM,48,-122,11,6,17
35371,FremontBridge,10/15/2016 07:00:00 PM,48,-122,6,4,10
35372,FremontBridge,10/15/2016 08:00:00 PM,48,-122,6,2,8
35373,FremontBridge,10/15/2016 09:00:00 PM,48,-122,8,5,13
35374,FremontBridge,10/15/2016 10:00:00 PM,48,-122,2,1,3
35375,FremontBridge,10/15/2016 11:00:00 PM,48,-122,0,2,2
35376,FremontBridge,10/16/2016 12:00:00 AM,48,-122,3,5,8
35377,FremontBridge,10/16/2016 01:00:00 AM,48,-122,1,3,4
35378,FremontBridge,10/16/2016 02:00:00 AM,48,-122,0,1,1
35379,FremontBridge,10/16/2016 03:00:00 AM,48,-122,0,2,2
35380,FremontBridge,10/16/2016 04:00:00 AM,48,-122,0,0,0
35381,FremontBridge,10/16/2016 05:00:00 AM,48,-122,1,0,1
35382,FremontBridge,10/16/2016 06:00:00 AM,48,-122,4,1,5
35383,FremontBridge,10/16/2016 07:00:00 AM,48,-122,1,1,2
35384,FremontBridge,10/16/2016 08:00:00 AM,48,-122,7,3,10
35385,FremontBridge,10/16/2016 09:00:00 AM,48,-122,12,12,24
35386,FremontBridge,10/16/2016 10:00:00 AM,48,-122,18,12,30
35387,FremontBridge,10/16/2016 11:00:00 AM,48,-122,14,25,39
35388,FremontBridge,10/16/2016 12:00:00 PM,48,-122,18,16,34
35389,FremontBridge,10/16/2016 01:00:00 PM,48,-122,16,32,48
35390,FremontBridge,10/16/2016 02:00:00 PM,48,-122,16,27,43
35391,FremontBridge,10/16/2016 03:00:00 PM,48,-122,27,20,47
35392,FremontBridge,10/16/2016 04:00:00 PM,48,-122,21,21,42
35393,FremontBridge,10/16/2016 05:00:00 PM,48,-122,18,31,49
35394,FremontBridge,10/16/2016 06:00:00 PM,48,-122,14,14,28
35395,FremontBridge,10/16/2016 07:00:00 PM,48,-122,19,10,29
35396,FremontBridge,10/16/2016 08:00:00 PM,48,-122,13,7,20
35397,FremontBridge,10/16/2016 09:00:00 PM,48,-122,6,4,10
35398,FremontBridge,10/16/2016 10:00:00 PM,48,-122,4,7,11
35399,FremontBridge,10/16/2016 11:00:00 PM,48,-122,1,1,2
35400,FremontBridge,10/17/2016 12:00:00 AM,48,-122,0,2,2
35401,FremontBridge,10/17/2016 01:00:00 AM,48,-122,1,0,1
35402,FremontBridge,10/17/2016 02:00:00 AM,48,-122,0,1,1
35403,FremontBridge,10/17/2016 03:00:00 AM,48,-122,0,0,0
35404,FremontBridge,10/17/2016 04:00:00 AM,48,-122,2,4,6
35405,FremontBridge,10/17/2016 05:00:00 AM,48,-122,12,19,31
35406,FremontBridge,10/17/2016 06:00:00 AM,48,-122,38,57,95
35407,FremontBridge,10/17/2016 07:00:00 AM,48,-122,109,188,297
35408,FremontBridge,10/17/2016 08:00:00 AM,48,-122,156,266,422
35409,FremontBridge,10/17/2016 09:00:00 AM,48,-122,103,116,219
35410,FremontBridge,10/17/2016 10:00:00 AM,48,-122,50,45,95
35411,FremontBridge,10/17/2016 11:00:00 AM,48,-122,21,24,45
35412,FremontBridge,10/17/2016 12:00:00 PM,48,-122,25,26,51
35413,FremontBridge,10/17/2016 01:00:00 PM,48,-122,19,23,42
35414,FremontBridge,10/17/2016 02:00:00 PM,48,-122,33,25,58
35415,FremontBridge,10/17/2016 03:00:00 PM,48,-122,69,37,106
35416,FremontBridge,10/17/2016 04:00:00 PM,48,-122,136,83,219
35417,FremontBridge,10/17/2016 05:00:00 PM,48,-122,362,129,491
35418,FremontBridge,10/17/2016 06:00:00 PM,48,-122,261,85,346
35419,FremontBridge,10/17/2016 07:00:00 PM,48,-122,72,60,132
35420,FremontBridge,10/17/2016 08:00:00 PM,48,-122,52,26,78
35421,FremontBridge,10/17/2016 09:00:00 PM,48,-122,23,16,39
35422,FremontBridge,10/17/2016 10:00:00 PM,48,-122,8,6,14
35423,FremontBridge,10/17/2016 11:00:00 PM,48,-122,6,2,8
35424,FremontBridge,10/18/2016 12:00:00 AM,48,-122,2,3,5
35425,FremontBridge,10/18/2016 01:00:00 AM,48,-122,4,0,4
35426,FremontBridge,10/18/2016 02:00:00 AM,48,-122,0,5,5
35427,FremontBridge,10/18/2016 03:00:00 AM,48,-122,0,2,2
35428,FremontBridge,10/18/2016 04:00:00 AM,48,-122,1,3,4
35429,FremontBridge,10/18/2016 05:00:00 AM,48,-122,13,15,28
35430,FremontBridge,10/18/2016 06:00:00 AM,48,-122,42,76,118
35431,FremontBridge,10/18/2016 07:00:00 AM,48,-122,112,202,314
35432,FremontBridge,10/18/2016 08:00:00 AM,48,-122,154,259,413
35433,FremontBridge,10/18/2016 09:00:00 AM,48,-122,105,129,234
35434,FremontBridge,10/18/2016 10:00:00 AM,48,-122,37,33,70
35435,FremontBridge,10/18/2016 11:00:00 AM,48,-122,27,36,63
35436,FremontBridge,10/18/2016 12:00:00 PM,48,-122,26,39,65
35437,FremontBridge,10/18/2016 01:00:00 PM,48,-122,31,28,59
35438,FremontBridge,10/18/2016 02:00:00 PM,48,-122,24,28,52
35439,FremontBridge,10/18/2016 03:00:00 PM,48,-122,81,57,138
35440,FremontBridge,10/18/2016 04:00:00 PM,48,-122,161,106,267
35441,FremontBridge,10/18/2016 05:00:00 PM,48,-122,363,137,500
35442,FremontBridge,10/18/2016 06:00:00 PM,48,-122,233,107,340
35443,FremontBridge,10/18/2016 07:00:00 PM,48,-122,80,52,132
35444,FremontBridge,10/18/2016 08:00:00 PM,48,-122,61,32,93
35445,FremontBridge,10/18/2016 09:00:00 PM,48,-122,23,18,41
35446,FremontBridge,10/18/2016 10:00:00 PM,48,-122,15,11,26
35447,FremontBridge,10/18/2016 11:00:00 PM,48,-122,8,8,16
35448,FremontBridge,10/19/2016 12:00:00 AM,48,-122,2,3,5
35449,FremontBridge,10/19/2016 01:00:00 AM,48,-122,3,6,9
35450,FremontBridge,10/19/2016 02:00:00 AM,48,-122,1,3,4
35451,FremontBridge,10/19/2016 03:00:00 AM,48,-122,1,2,3
35452,FremontBridge,10/19/2016 04:00:00 AM,48,-122,4,7,11
35453,FremontBridge,10/19/2016 05:00:00 AM,48,-122,18,23,41
35454,FremontBridge,10/19/2016 06:00:00 AM,48,-122,55,81,136
35455,FremontBridge,10/19/2016 07:00:00 AM,48,-122,137,214,351
35456,FremontBridge,10/19/2016 08:00:00 AM,48,-122,209,312,521
35457,FremontBridge,10/19/2016 09:00:00 AM,48,-122,119,157,276
35458,FremontBridge,10/19/2016 10:00:00 AM,48,-122,69,56,125
35459,FremontBridge,10/19/2016 11:00:00 AM,48,-122,34,49,83
35460,FremontBridge,10/19/2016 12:00:00 PM,48,-122,30,45,75
35461,FremontBridge,10/19/2016 01:00:00 PM,48,-122,52,45,97
35462,FremontBridge,10/19/2016 02:00:00 PM,48,-122,54,36,90
35463,FremontBridge,10/19/2016 03:00:00 PM,48,-122,84,75,159
35464,FremontBridge,10/19/2016 04:00:00 PM,48,-122,216,103,319
35465,FremontBridge,10/19/2016 05:00:00 PM,48,-122,446,155,601
35466,FremontBridge,10/19/2016 06:00:00 PM,48,-122,212,108,320
35467,FremontBridge,10/19/2016 07:00:00 PM,48,-122,79,52,131
35468,FremontBridge,10/19/2016 08:00:00 PM,48,-122,32,24,56
35469,FremontBridge,10/19/2016 09:00:00 PM,48,-122,32,13,45
35470,FremontBridge,10/19/2016 10:00:00 PM,48,-122,12,10,22
35471,FremontBridge,10/19/2016 11:00:00 PM,48,-122,4,2,6
35472,FremontBridge,10/20/2016 12:00:00 AM,48,-122,3,1,4
35473,FremontBridge,10/20/2016 01:00:00 AM,48,-122,3,0,3
35474,FremontBridge,10/20/2016 02:00:00 AM,48,-122,1,2,3
35475,FremontBridge,10/20/2016 03:00:00 AM,48,-122,0,0,0
35476,FremontBridge,10/20/2016 04:00:00 AM,48,-122,1,2,3
35477,FremontBridge,10/20/2016 05:00:00 AM,48,-122,9,13,22
35478,FremontBridge,10/20/2016 06:00:00 AM,48,-122,29,34,63
35479,FremontBridge,10/20/2016 07:00:00 AM,48,-122,71,147,218
35480,FremontBridge,10/20/2016 08:00:00 AM,48,-122,115,169,284
35481,FremontBridge,10/20/2016 09:00:00 AM,48,-122,51,85,136
35482,FremontBridge,10/20/2016 10:00:00 AM,48,-122,15,33,48
35483,FremontBridge,10/20/2016 11:00:00 AM,48,-122,11,18,29
35484,FremontBridge,10/20/2016 12:00:00 PM,48,-122,17,21,38
35485,FremontBridge,10/20/2016 01:00:00 PM,48,-122,22,22,44
35486,FremontBridge,10/20/2016 02:00:00 PM,48,-122,22,15,37
35487,FremontBridge,10/20/2016 03:00:00 PM,48,-122,53,32,85
35488,FremontBridge,10/20/2016 04:00:00 PM,48,-122,110,62,172
35489,FremontBridge,10/20/2016 05:00:00 PM,48,-122,249,91,340
35490,FremontBridge,10/20/2016 06:00:00 PM,48,-122,166,78,244
35491,FremontBridge,10/20/2016 07:00:00 PM,48,-122,79,34,113
35492,FremontBridge,10/20/2016 08:00:00 PM,48,-122,25,26,51
35493,FremontBridge,10/20/2016 09:00:00 PM,48,-122,25,13,38
35494,FremontBridge,10/20/2016 10:00:00 PM,48,-122,14,13,27
35495,FremontBridge,10/20/2016 11:00:00 PM,48,-122,6,2,8
35496,FremontBridge,10/21/2016 12:00:00 AM,48,-122,5,3,8
35497,FremontBridge,10/21/2016 01:00:00 AM,48,-122,2,4,6
35498,FremontBridge,10/21/2016 02:00:00 AM,48,-122,4,1,5
35499,FremontBridge,10/21/2016 03:00:00 AM,48,-122,0,0,0
35500,FremontBridge,10/21/2016 04:00:00 AM,48,-122,5,4,9
35501,FremontBridge,10/21/2016 05:00:00 AM,48,-122,8,17,25
35502,FremontBridge,10/21/2016 06:00:00 AM,48,-122,46,52,98
35503,FremontBridge,10/21/2016 07:00:00 AM,48,-122,93,177,270
35504,FremontBridge,10/21/2016 08:00:00 AM,48,-122,160,228,388
35505,FremontBridge,10/21/2016 09:00:00 AM,48,-122,104,119,223
35506,FremontBridge,10/21/2016 10:00:00 AM,48,-122,35,66,101
35507,FremontBridge,10/21/2016 11:00:00 AM,48,-122,27,52,79
35508,FremontBridge,10/21/2016 12:00:00 PM,48,-122,38,47,85
35509,FremontBridge,10/21/2016 01:00:00 PM,48,-122,63,40,103
35510,FremontBridge,10/21/2016 02:00:00 PM,48,-122,50,45,95
35511,FremontBridge,10/21/2016 03:00:00 PM,48,-122,72,57,129
35512,FremontBridge,10/21/2016 04:00:00 PM,48,-122,186,73,259
35513,FremontBridge,10/21/2016 05:00:00 PM,48,-122,280,115,395
35514,FremontBridge,10/21/2016 06:00:00 PM,48,-122,181,63,244
35515,FremontBridge,10/21/2016 07:00:00 PM,48,-122,64,29,93
35516,FremontBridge,10/21/2016 08:00:00 PM,48,-122,46,26,72
35517,FremontBridge,10/21/2016 09:00:00 PM,48,-122,22,13,35
35518,FremontBridge,10/21/2016 10:00:00 PM,48,-122,10,6,16
35519,FremontBridge,10/21/2016 11:00:00 PM,48,-122,15,6,21
35520,FremontBridge,10/22/2016 12:00:00 AM,48,-122,4,5,9
35521,FremontBridge,10/22/2016 01:00:00 AM,48,-122,4,5,9
35522,FremontBridge,10/22/2016 02:00:00 AM,48,-122,4,4,8
35523,FremontBridge,10/22/2016 03:00:00 AM,48,-122,2,1,3
35524,FremontBridge,10/22/2016 04:00:00 AM,48,-122,1,0,1
35525,FremontBridge,10/22/2016 05:00:00 AM,48,-122,2,2,4
35526,FremontBridge,10/22/2016 06:00:00 AM,48,-122,5,2,7
35527,FremontBridge,10/22/2016 07:00:00 AM,48,-122,9,15,24
35528,FremontBridge,10/22/2016 08:00:00 AM,48,-122,30,36,66
35529,FremontBridge,10/22/2016 09:00:00 AM,48,-122,35,40,75
35530,FremontBridge,10/22/2016 10:00:00 AM,48,-122,36,50,86
35531,FremontBridge,10/22/2016 11:00:00 AM,48,-122,54,75,129
35532,FremontBridge,10/22/2016 12:00:00 PM,48,-122,81,54,135
35533,FremontBridge,10/22/2016 01:00:00 PM,48,-122,68,70,138
35534,FremontBridge,10/22/2016 02:00:00 PM,48,-122,83,70,153
35535,FremontBridge,10/22/2016 03:00:00 PM,48,-122,77,86,163
35536,FremontBridge,10/22/2016 04:00:00 PM,48,-122,58,63,121
35537,FremontBridge,10/22/2016 05:00:00 PM,48,-122,72,60,132
35538,FremontBridge,10/22/2016 06:00:00 PM,48,-122,42,42,84
35539,FremontBridge,10/22/2016 07:00:00 PM,48,-122,27,31,58
35540,FremontBridge,10/22/2016 08:00:00 PM,48,-122,15,14,29
35541,FremontBridge,10/22/2016 09:00:00 PM,48,-122,14,17,31
35542,FremontBridge,10/22/2016 10:00:00 PM,48,-122,12,10,22
35543,FremontBridge,10/22/2016 11:00:00 PM,48,-122,16,7,23
35544,FremontBridge,10/23/2016 12:00:00 AM,48,-122,4,5,9
35545,FremontBridge,10/23/2016 01:00:00 AM,48,-122,7,2,9
35546,FremontBridge,10/23/2016 02:00:00 AM,48,-122,3,2,5
35547,FremontBridge,10/23/2016 03:00:00 AM,48,-122,0,0,0
35548,FremontBridge,10/23/2016 04:00:00 AM,48,-122,0,0,0
35549,FremontBridge,10/23/2016 05:00:00 AM,48,-122,3,0,3
35550,FremontBridge,10/23/2016 06:00:00 AM,48,-122,4,1,5
35551,FremontBridge,10/23/2016 07:00:00 AM,48,-122,7,12,19
35552,FremontBridge,10/23/2016 08:00:00 AM,48,-122,25,14,39
35553,FremontBridge,10/23/2016 09:00:00 AM,48,-122,22,21,43
35554,FremontBridge,10/23/2016 10:00:00 AM,48,-122,27,32,59
35555,FremontBridge,10/23/2016 11:00:00 AM,48,-122,47,47,94
35556,FremontBridge,10/23/2016 12:00:00 PM,48,-122,71,50,121
35557,FremontBridge,10/23/2016 01:00:00 PM,48,-122,51,66,117
35558,FremontBridge,10/23/2016 02:00:00 PM,48,-122,53,71,124
35559,FremontBridge,10/23/2016 03:00:00 PM,48,-122,63,55,118
35560,FremontBridge,10/23/2016 04:00:00 PM,48,-122,50,54,104
35561,FremontBridge,10/23/2016 05:00:00 PM,48,-122,42,47,89
35562,FremontBridge,10/23/2016 06:00:00 PM,48,-122,28,19,47
35563,FremontBridge,10/23/2016 07:00:00 PM,48,-122,20,10,30
35564,FremontBridge,10/23/2016 08:00:00 PM,48,-122,9,14,23
35565,FremontBridge,10/23/2016 09:00:00 PM,48,-122,14,12,26
35566,FremontBridge,10/23/2016 10:00:00 PM,48,-122,8,6,14
35567,FremontBridge,10/23/2016 11:00:00 PM,48,-122,6,5,11
35568,FremontBridge,10/24/2016 12:00:00 AM,48,-122,3,6,9
35569,FremontBridge,10/24/2016 01:00:00 AM,48,-122,1,2,3
35570,FremontBridge,10/24/2016 02:00:00 AM,48,-122,2,0,2
35571,FremontBridge,10/24/2016 03:00:00 AM,48,-122,0,0,0
35572,FremontBridge,10/24/2016 04:00:00 AM,48,-122,4,5,9
35573,FremontBridge,10/24/2016 05:00:00 AM,48,-122,13,25,38
35574,FremontBridge,10/24/2016 06:00:00 AM,48,-122,38,72,110
35575,FremontBridge,10/24/2016 07:00:00 AM,48,-122,129,215,344
35576,FremontBridge,10/24/2016 08:00:00 AM,48,-122,188,300,488
35577,FremontBridge,10/24/2016 09:00:00 AM,48,-122,128,131,259
35578,FremontBridge,10/24/2016 10:00:00 AM,48,-122,50,52,102
35579,FremontBridge,10/24/2016 11:00:00 AM,48,-122,38,29,67
35580,FremontBridge,10/24/2016 12:00:00 PM,48,-122,44,34,78
35581,FremontBridge,10/24/2016 01:00:00 PM,48,-122,37,35,72
35582,FremontBridge,10/24/2016 02:00:00 PM,48,-122,34,30,64
35583,FremontBridge,10/24/2016 03:00:00 PM,48,-122,71,48,119
35584,FremontBridge,10/24/2016 04:00:00 PM,48,-122,163,75,238
35585,FremontBridge,10/24/2016 05:00:00 PM,48,-122,344,110,454
35586,FremontBridge,10/24/2016 06:00:00 PM,48,-122,213,93,306
35587,FremontBridge,10/24/2016 07:00:00 PM,48,-122,83,35,118
35588,FremontBridge,10/24/2016 08:00:00 PM,48,-122,43,16,59
35589,FremontBridge,10/24/2016 09:00:00 PM,48,-122,13,20,33
35590,FremontBridge,10/24/2016 10:00:00 PM,48,-122,8,4,12
35591,FremontBridge,10/24/2016 11:00:00 PM,48,-122,6,6,12
35592,FremontBridge,10/25/2016 12:00:00 AM,48,-122,1,2,3
35593,FremontBridge,10/25/2016 01:00:00 AM,48,-122,3,2,5
35594,FremontBridge,10/25/2016 02:00:00 AM,48,-122,1,1,2
35595,FremontBridge,10/25/2016 03:00:00 AM,48,-122,0,0,0
35596,FremontBridge,10/25/2016 04:00:00 AM,48,-122,1,6,7
35597,FremontBridge,10/25/2016 05:00:00 AM,48,-122,15,35,50
35598,FremontBridge,10/25/2016 06:00:00 AM,48,-122,49,81,130
35599,FremontBridge,10/25/2016 07:00:00 AM,48,-122,121,220,341
35600,FremontBridge,10/25/2016 08:00:00 AM,48,-122,186,288,474
35601,FremontBridge,10/25/2016 09:00:00 AM,48,-122,106,137,243
35602,FremontBridge,10/25/2016 10:00:00 AM,48,-122,60,59,119
35603,FremontBridge,10/25/2016 11:00:00 AM,48,-122,25,41,66
35604,FremontBridge,10/25/2016 12:00:00 PM,48,-122,42,38,80
35605,FremontBridge,10/25/2016 01:00:00 PM,48,-122,36,47,83
35606,FremontBridge,10/25/2016 02:00:00 PM,48,-122,44,43,87
35607,FremontBridge,10/25/2016 03:00:00 PM,48,-122,73,53,126
35608,FremontBridge,10/25/2016 04:00:00 PM,48,-122,190,97,287
35609,FremontBridge,10/25/2016 05:00:00 PM,48,-122,421,149,570
35610,FremontBridge,10/25/2016 06:00:00 PM,48,-122,254,116,370
35611,FremontBridge,10/25/2016 07:00:00 PM,48,-122,101,50,151
35612,FremontBridge,10/25/2016 08:00:00 PM,48,-122,49,25,74
35613,FremontBridge,10/25/2016 09:00:00 PM,48,-122,41,12,53
35614,FremontBridge,10/25/2016 10:00:00 PM,48,-122,25,18,43
35615,FremontBridge,10/25/2016 11:00:00 PM,48,-122,11,5,16
35616,FremontBridge,10/26/2016 12:00:00 AM,48,-122,5,6,11
35617,FremontBridge,10/26/2016 01:00:00 AM,48,-122,2,5,7
35618,FremontBridge,10/26/2016 02:00:00 AM,48,-122,0,1,1
35619,FremontBridge,10/26/2016 03:00:00 AM,48,-122,0,1,1
35620,FremontBridge,10/26/2016 04:00:00 AM,48,-122,2,5,7
35621,FremontBridge,10/26/2016 05:00:00 AM,48,-122,10,23,33
35622,FremontBridge,10/26/2016 06:00:00 AM,48,-122,36,66,102
35623,FremontBridge,10/26/2016 07:00:00 AM,48,-122,79,139,218
35624,FremontBridge,10/26/2016 08:00:00 AM,48,-122,124,170,294
35625,FremontBridge,10/26/2016 09:00:00 AM,48,-122,80,83,163
35626,FremontBridge,10/26/2016 10:00:00 AM,48,-122,26,30,56
35627,FremontBridge,10/26/2016 11:00:00 AM,48,-122,16,20,36
35628,FremontBridge,10/26/2016 12:00:00 PM,48,-122,11,12,23
35629,FremontBridge,10/26/2016 01:00:00 PM,48,-122,14,15,29
35630,FremontBridge,10/26/2016 02:00:00 PM,48,-122,13,14,27
35631,FremontBridge,10/26/2016 03:00:00 PM,48,-122,40,21,61
35632,FremontBridge,10/26/2016 04:00:00 PM,48,-122,101,47,148
35633,FremontBridge,10/26/2016 05:00:00 PM,48,-122,236,67,303
35634,FremontBridge,10/26/2016 06:00:00 PM,48,-122,175,59,234
35635,FremontBridge,10/26/2016 07:00:00 PM,48,-122,55,32,87
35636,FremontBridge,10/26/2016 08:00:00 PM,48,-122,40,15,55
35637,FremontBridge,10/26/2016 09:00:00 PM,48,-122,16,5,21
35638,FremontBridge,10/26/2016 10:00:00 PM,48,-122,7,2,9
35639,FremontBridge,10/26/2016 11:00:00 PM,48,-122,5,4,9
35640,FremontBridge,10/27/2016 12:00:00 AM,48,-122,4,1,5
35641,FremontBridge,10/27/2016 01:00:00 AM,48,-122,2,1,3
35642,FremontBridge,10/27/2016 02:00:00 AM,48,-122,0,1,1
35643,FremontBridge,10/27/2016 03:00:00 AM,48,-122,1,0,1
35644,FremontBridge,10/27/2016 04:00:00 AM,48,-122,4,7,11
35645,FremontBridge,10/27/2016 05:00:00 AM,48,-122,12,22,34
35646,FremontBridge,10/27/2016 06:00:00 AM,48,-122,43,57,100
35647,FremontBridge,10/27/2016 07:00:00 AM,48,-122,105,169,274
35648,FremontBridge,10/27/2016 08:00:00 AM,48,-122,177,255,432
35649,FremontBridge,10/27/2016 09:00:00 AM,48,-122,95,109,204
35650,FremontBridge,10/27/2016 10:00:00 AM,48,-122,46,50,96
35651,FremontBridge,10/27/2016 11:00:00 AM,48,-122,29,28,57
35652,FremontBridge,10/27/2016 12:00:00 PM,48,-122,24,34,58
35653,FremontBridge,10/27/2016 01:00:00 PM,48,-122,32,37,69
35654,FremontBridge,10/27/2016 02:00:00 PM,48,-122,43,34,77
35655,FremontBridge,10/27/2016 03:00:00 PM,48,-122,76,47,123
35656,FremontBridge,10/27/2016 04:00:00 PM,48,-122,141,79,220
35657,FremontBridge,10/27/2016 05:00:00 PM,48,-122,351,115,466
35658,FremontBridge,10/27/2016 06:00:00 PM,48,-122,195,86,281
35659,FremontBridge,10/27/2016 07:00:00 PM,48,-122,78,43,121
35660,FremontBridge,10/27/2016 08:00:00 PM,48,-122,34,51,85
35661,FremontBridge,10/27/2016 09:00:00 PM,48,-122,27,17,44
35662,FremontBridge,10/27/2016 10:00:00 PM,48,-122,27,17,44
35663,FremontBridge,10/27/2016 11:00:00 PM,48,-122,6,5,11
35664,FremontBridge,10/28/2016 12:00:00 AM,48,-122,2,3,5
35665,FremontBridge,10/28/2016 01:00:00 AM,48,-122,2,3,5
35666,FremontBridge,10/28/2016 02:00:00 AM,48,-122,1,8,9
35667,FremontBridge,10/28/2016 03:00:00 AM,48,-122,1,1,2
35668,FremontBridge,10/28/2016 04:00:00 AM,48,-122,2,5,7
35669,FremontBridge,10/28/2016 05:00:00 AM,48,-122,11,22,33
35670,FremontBridge,10/28/2016 06:00:00 AM,48,-122,42,62,104
35671,FremontBridge,10/28/2016 07:00:00 AM,48,-122,103,171,274
35672,FremontBridge,10/28/2016 08:00:00 AM,48,-122,161,238,399
35673,FremontBridge,10/28/2016 09:00:00 AM,48,-122,117,128,245
35674,FremontBridge,10/28/2016 10:00:00 AM,48,-122,42,73,115
35675,FremontBridge,10/28/2016 11:00:00 AM,48,-122,38,57,95
35676,FremontBridge,10/28/2016 12:00:00 PM,48,-122,42,45,87
35677,FremontBridge,10/28/2016 01:00:00 PM,48,-122,55,44,99
35678,FremontBridge,10/28/2016 02:00:00 PM,48,-122,49,49,98
35679,FremontBridge,10/28/2016 03:00:00 PM,48,-122,111,93,204
35680,FremontBridge,10/28/2016 04:00:00 PM,48,-122,197,120,317
35681,FremontBridge,10/28/2016 05:00:00 PM,48,-122,349,158,507
35682,FremontBridge,10/28/2016 06:00:00 PM,48,-122,204,103,307
35683,FremontBridge,10/28/2016 07:00:00 PM,48,-122,75,44,119
35684,FremontBridge,10/28/2016 08:00:00 PM,48,-122,54,24,78
35685,FremontBridge,10/28/2016 09:00:00 PM,48,-122,20,15,35
35686,FremontBridge,10/28/2016 10:00:00 PM,48,-122,12,14,26
35687,FremontBridge,10/28/2016 11:00:00 PM,48,-122,12,20,32
35688,FremontBridge,10/29/2016 12:00:00 AM,48,-122,9,9,18
35689,FremontBridge,10/29/2016 01:00:00 AM,48,-122,6,4,10
35690,FremontBridge,10/29/2016 02:00:00 AM,48,-122,7,5,12
35691,FremontBridge,10/29/2016 03:00:00 AM,48,-122,2,1,3
35692,FremontBridge,10/29/2016 04:00:00 AM,48,-122,2,2,4
35693,FremontBridge,10/29/2016 05:00:00 AM,48,-122,2,3,5
35694,FremontBridge,10/29/2016 06:00:00 AM,48,-122,8,9,17
35695,FremontBridge,10/29/2016 07:00:00 AM,48,-122,12,9,21
35696,FremontBridge,10/29/2016 08:00:00 AM,48,-122,20,18,38
35697,FremontBridge,10/29/2016 09:00:00 AM,48,-122,13,16,29
35698,FremontBridge,10/29/2016 10:00:00 AM,48,-122,21,17,38
35699,FremontBridge,10/29/2016 11:00:00 AM,48,-122,17,20,37
35700,FremontBridge,10/29/2016 12:00:00 PM,48,-122,12,11,23
35701,FremontBridge,10/29/2016 01:00:00 PM,48,-122,17,16,33
35702,FremontBridge,10/29/2016 02:00:00 PM,48,-122,26,20,46
35703,FremontBridge,10/29/2016 03:00:00 PM,48,-122,33,52,85
35704,FremontBridge,10/29/2016 04:00:00 PM,48,-122,29,39,68
35705,FremontBridge,10/29/2016 05:00:00 PM,48,-122,51,44,95
35706,FremontBridge,10/29/2016 06:00:00 PM,48,-122,32,27,59
35707,FremontBridge,10/29/2016 07:00:00 PM,48,-122,38,11,49
35708,FremontBridge,10/29/2016 08:00:00 PM,48,-122,16,9,25
35709,FremontBridge,10/29/2016 09:00:00 PM,48,-122,18,23,41
35710,FremontBridge,10/29/2016 10:00:00 PM,48,-122,11,8,19
35711,FremontBridge,10/29/2016 11:00:00 PM,48,-122,5,8,13
35712,FremontBridge,10/30/2016 12:00:00 AM,48,-122,6,4,10
35713,FremontBridge,10/30/2016 01:00:00 AM,48,-122,10,5,15
35714,FremontBridge,10/30/2016 02:00:00 AM,48,-122,5,2,7
35715,FremontBridge,10/30/2016 03:00:00 AM,48,-122,2,1,3
35716,FremontBridge,10/30/2016 04:00:00 AM,48,-122,1,1,2
35717,FremontBridge,10/30/2016 05:00:00 AM,48,-122,4,2,6
35718,FremontBridge,10/30/2016 06:00:00 AM,48,-122,3,7,10
35719,FremontBridge,10/30/2016 07:00:00 AM,48,-122,4,10,14
35720,FremontBridge,10/30/2016 08:00:00 AM,48,-122,24,23,47
35721,FremontBridge,10/30/2016 09:00:00 AM,48,-122,36,38,74
35722,FremontBridge,10/30/2016 10:00:00 AM,48,-122,32,37,69
35723,FremontBridge,10/30/2016 11:00:00 AM,48,-122,47,40,87
35724,FremontBridge,10/30/2016 12:00:00 PM,48,-122,59,39,98
35725,FremontBridge,10/30/2016 01:00:00 PM,48,-122,39,47,86
35726,FremontBridge,10/30/2016 02:00:00 PM,48,-122,34,31,65
35727,FremontBridge,10/30/2016 03:00:00 PM,48,-122,25,32,57
35728,FremontBridge,10/30/2016 04:00:00 PM,48,-122,25,30,55
35729,FremontBridge,10/30/2016 05:00:00 PM,48,-122,23,25,48
35730,FremontBridge,10/30/2016 06:00:00 PM,48,-122,17,16,33
35731,FremontBridge,10/30/2016 07:00:00 PM,48,-122,13,9,22
35732,FremontBridge,10/30/2016 08:00:00 PM,48,-122,14,5,19
35733,FremontBridge,10/30/2016 09:00:00 PM,48,-122,9,5,14
35734,FremontBridge,10/30/2016 10:00:00 PM,48,-122,4,5,9
35735,FremontBridge,10/30/2016 11:00:00 PM,48,-122,6,3,9
35736,FremontBridge,10/31/2016 12:00:00 AM,48,-122,3,1,4
35737,FremontBridge,10/31/2016 01:00:00 AM,48,-122,3,0,3
35738,FremontBridge,10/31/2016 02:00:00 AM,48,-122,1,0,1
35739,FremontBridge,10/31/2016 03:00:00 AM,48,-122,1,1,2
35740,FremontBridge,10/31/2016 04:00:00 AM,48,-122,1,3,4
35741,FremontBridge,10/31/2016 05:00:00 AM,48,-122,13,20,33
35742,FremontBridge,10/31/2016 06:00:00 AM,48,-122,35,54,89
35743,FremontBridge,10/31/2016 07:00:00 AM,48,-122,97,172,269
35744,FremontBridge,10/31/2016 08:00:00 AM,48,-122,141,189,330
35745,FremontBridge,10/31/2016 09:00:00 AM,48,-122,58,73,131
35746,FremontBridge,10/31/2016 10:00:00 AM,48,-122,29,31,60
35747,FremontBridge,10/31/2016 11:00:00 AM,48,-122,19,18,37
35748,FremontBridge,10/31/2016 12:00:00 PM,48,-122,18,11,29
35749,FremontBridge,10/31/2016 01:00:00 PM,48,-122,23,23,46
35750,FremontBridge,10/31/2016 02:00:00 PM,48,-122,26,24,50
35751,FremontBridge,10/31/2016 03:00:00 PM,48,-122,66,33,99
35752,FremontBridge,10/31/2016 04:00:00 PM,48,-122,179,69,248
35753,FremontBridge,10/31/2016 05:00:00 PM,48,-122,310,91,401
35754,FremontBridge,10/31/2016 06:00:00 PM,48,-122,129,73,202
35755,FremontBridge,10/31/2016 07:00:00 PM,48,-122,49,23,72
35756,FremontBridge,10/31/2016 08:00:00 PM,48,-122,29,15,44
35757,FremontBridge,10/31/2016 09:00:00 PM,48,-122,13,8,21
35758,FremontBridge,10/31/2016 10:00:00 PM,48,-122,5,5,10
35759,FremontBridge,10/31/2016 11:00:00 PM,48,-122,8,5,13
35760,FremontBridge,11/01/2016 12:00:00 AM,48,-122,6,2,8
35761,FremontBridge,11/01/2016 01:00:00 AM,48,-122,3,3,6
35762,FremontBridge,11/01/2016 02:00:00 AM,48,-122,1,0,1
35763,FremontBridge,11/01/2016 03:00:00 AM,48,-122,1,0,1
35764,FremontBridge,11/01/2016 04:00:00 AM,48,-122,2,5,7
35765,FremontBridge,11/01/2016 05:00:00 AM,48,-122,12,20,32
35766,FremontBridge,11/01/2016 06:00:00 AM,48,-122,40,67,107
35767,FremontBridge,11/01/2016 07:00:00 AM,48,-122,92,175,267
35768,FremontBridge,11/01/2016 08:00:00 AM,48,-122,135,219,354
35769,FremontBridge,11/01/2016 09:00:00 AM,48,-122,84,101,185
35770,FremontBridge,11/01/2016 10:00:00 AM,48,-122,37,27,64
35771,FremontBridge,11/01/2016 11:00:00 AM,48,-122,15,20,35
35772,FremontBridge,11/01/2016 12:00:00 PM,48,-122,15,27,42
35773,FremontBridge,11/01/2016 01:00:00 PM,48,-122,21,28,49
35774,FremontBridge,11/01/2016 02:00:00 PM,48,-122,26,23,49
35775,FremontBridge,11/01/2016 03:00:00 PM,48,-122,42,53,95
35776,FremontBridge,11/01/2016 04:00:00 PM,48,-122,154,72,226
35777,FremontBridge,11/01/2016 05:00:00 PM,48,-122,329,104,433
35778,FremontBridge,11/01/2016 06:00:00 PM,48,-122,190,82,272
35779,FremontBridge,11/01/2016 07:00:00 PM,48,-122,89,39,128
35780,FremontBridge,11/01/2016 08:00:00 PM,48,-122,40,22,62
35781,FremontBridge,11/01/2016 09:00:00 PM,48,-122,34,12,46
35782,FremontBridge,11/01/2016 10:00:00 PM,48,-122,14,8,22
35783,FremontBridge,11/01/2016 11:00:00 PM,48,-122,4,5,9
35784,FremontBridge,11/02/2016 12:00:00 AM,48,-122,2,2,4
35785,FremontBridge,11/02/2016 01:00:00 AM,48,-122,0,2,2
35786,FremontBridge,11/02/2016 02:00:00 AM,48,-122,0,1,1
35787,FremontBridge,11/02/2016 03:00:00 AM,48,-122,0,0,0
35788,FremontBridge,11/02/2016 04:00:00 AM,48,-122,6,3,9
35789,FremontBridge,11/02/2016 05:00:00 AM,48,-122,14,19,33
35790,FremontBridge,11/02/2016 06:00:00 AM,48,-122,58,69,127
35791,FremontBridge,11/02/2016 07:00:00 AM,48,-122,97,152,249
35792,FremontBridge,11/02/2016 08:00:00 AM,48,-122,133,197,330
35793,FremontBridge,11/02/2016 09:00:00 AM,48,-122,100,100,200
35794,FremontBridge,11/02/2016 10:00:00 AM,48,-122,24,36,60
35795,FremontBridge,11/02/2016 11:00:00 AM,48,-122,22,20,42
35796,FremontBridge,11/02/2016 12:00:00 PM,48,-122,15,11,26
35797,FremontBridge,11/02/2016 01:00:00 PM,48,-122,19,22,41
35798,FremontBridge,11/02/2016 02:00:00 PM,48,-122,23,25,48
35799,FremontBridge,11/02/2016 03:00:00 PM,48,-122,54,37,91
35800,FremontBridge,11/02/2016 04:00:00 PM,48,-122,164,68,232
35801,FremontBridge,11/02/2016 05:00:00 PM,48,-122,323,119,442
35802,FremontBridge,11/02/2016 06:00:00 PM,48,-122,185,85,270
35803,FremontBridge,11/02/2016 07:00:00 PM,48,-122,61,46,107
35804,FremontBridge,11/02/2016 08:00:00 PM,48,-122,43,25,68
35805,FremontBridge,11/02/2016 09:00:00 PM,48,-122,26,14,40
35806,FremontBridge,11/02/2016 10:00:00 PM,48,-122,14,8,22
35807,FremontBridge,11/02/2016 11:00:00 PM,48,-122,7,2,9
35808,FremontBridge,11/03/2016 12:00:00 AM,48,-122,1,2,3
35809,FremontBridge,11/03/2016 01:00:00 AM,48,-122,2,2,4
35810,FremontBridge,11/03/2016 02:00:00 AM,48,-122,2,0,2
35811,FremontBridge,11/03/2016 03:00:00 AM,48,-122,1,2,3
35812,FremontBridge,11/03/2016 04:00:00 AM,48,-122,1,1,2
35813,FremontBridge,11/03/2016 05:00:00 AM,48,-122,13,19,32
35814,FremontBridge,11/03/2016 06:00:00 AM,48,-122,46,77,123
35815,FremontBridge,11/03/2016 07:00:00 AM,48,-122,148,218,366
35816,FremontBridge,11/03/2016 08:00:00 AM,48,-122,230,304,534
35817,FremontBridge,11/03/2016 09:00:00 AM,48,-122,132,129,261
35818,FremontBridge,11/03/2016 10:00:00 AM,48,-122,53,57,110
35819,FremontBridge,11/03/2016 11:00:00 AM,48,-122,49,47,96
35820,FremontBridge,11/03/2016 12:00:00 PM,48,-122,43,44,87
35821,FremontBridge,11/03/2016 01:00:00 PM,48,-122,41,56,97
35822,FremontBridge,11/03/2016 02:00:00 PM,48,-122,62,50,112
35823,FremontBridge,11/03/2016 03:00:00 PM,48,-122,84,64,148
35824,FremontBridge,11/03/2016 04:00:00 PM,48,-122,213,116,329
35825,FremontBridge,11/03/2016 05:00:00 PM,48,-122,465,144,609
35826,FremontBridge,11/03/2016 06:00:00 PM,48,-122,245,117,362
35827,FremontBridge,11/03/2016 07:00:00 PM,48,-122,98,39,137
35828,FremontBridge,11/03/2016 08:00:00 PM,48,-122,65,41,106
35829,FremontBridge,11/03/2016 09:00:00 PM,48,-122,37,18,55
35830,FremontBridge,11/03/2016 10:00:00 PM,48,-122,21,14,35
35831,FremontBridge,11/03/2016 11:00:00 PM,48,-122,13,9,22
35832,FremontBridge,11/04/2016 12:00:00 AM,48,-122,8,8,16
35833,FremontBridge,11/04/2016 01:00:00 AM,48,-122,3,5,8
35834,FremontBridge,11/04/2016 02:00:00 AM,48,-122,1,0,1
35835,FremontBridge,11/04/2016 03:00:00 AM,48,-122,2,0,2
35836,FremontBridge,11/04/2016 04:00:00 AM,48,-122,4,5,9
35837,FremontBridge,11/04/2016 05:00:00 AM,48,-122,14,24,38
35838,FremontBridge,11/04/2016 06:00:00 AM,48,-122,44,72,116
35839,FremontBridge,11/04/2016 07:00:00 AM,48,-122,95,193,288
35840,FremontBridge,11/04/2016 08:00:00 AM,48,-122,170,253,423
35841,FremontBridge,11/04/2016 09:00:00 AM,48,-122,102,145,247
35842,FremontBridge,11/04/2016 10:00:00 AM,48,-122,54,69,123
35843,FremontBridge,11/04/2016 11:00:00 AM,48,-122,49,47,96
35844,FremontBridge,11/04/2016 12:00:00 PM,48,-122,51,55,106
35845,FremontBridge,11/04/2016 01:00:00 PM,48,-122,56,75,131
35846,FremontBridge,11/04/2016 02:00:00 PM,48,-122,56,67,123
35847,FremontBridge,11/04/2016 03:00:00 PM,48,-122,116,76,192
35848,FremontBridge,11/04/2016 04:00:00 PM,48,-122,196,118,314
35849,FremontBridge,11/04/2016 05:00:00 PM,48,-122,400,130,530
35850,FremontBridge,11/04/2016 06:00:00 PM,48,-122,190,97,287
35851,FremontBridge,11/04/2016 07:00:00 PM,48,-122,60,42,102
35852,FremontBridge,11/04/2016 08:00:00 PM,48,-122,39,19,58
35853,FremontBridge,11/04/2016 09:00:00 PM,48,-122,33,19,52
35854,FremontBridge,11/04/2016 10:00:00 PM,48,-122,18,12,30
35855,FremontBridge,11/04/2016 11:00:00 PM,48,-122,16,10,26
35856,FremontBridge,11/05/2016 12:00:00 AM,48,-122,11,7,18
35857,FremontBridge,11/05/2016 01:00:00 AM,48,-122,5,8,13
35858,FremontBridge,11/05/2016 02:00:00 AM,48,-122,3,1,4
35859,FremontBridge,11/05/2016 03:00:00 AM,48,-122,6,0,6
35860,FremontBridge,11/05/2016 04:00:00 AM,48,-122,4,0,4
35861,FremontBridge,11/05/2016 05:00:00 AM,48,-122,4,1,5
35862,FremontBridge,11/05/2016 06:00:00 AM,48,-122,1,8,9
35863,FremontBridge,11/05/2016 07:00:00 AM,48,-122,5,8,13
35864,FremontBridge,11/05/2016 08:00:00 AM,48,-122,19,18,37
35865,FremontBridge,11/05/2016 09:00:00 AM,48,-122,6,13,19
35866,FremontBridge,11/05/2016 10:00:00 AM,48,-122,9,15,24
35867,FremontBridge,11/05/2016 11:00:00 AM,48,-122,10,28,38
35868,FremontBridge,11/05/2016 12:00:00 PM,48,-122,9,16,25
35869,FremontBridge,11/05/2016 01:00:00 PM,48,-122,21,16,37
35870,FremontBridge,11/05/2016 02:00:00 PM,48,-122,11,11,22
35871,FremontBridge,11/05/2016 03:00:00 PM,48,-122,5,14,19
35872,FremontBridge,11/05/2016 04:00:00 PM,48,-122,13,23,36
35873,FremontBridge,11/05/2016 05:00:00 PM,48,-122,14,13,27
35874,FremontBridge,11/05/2016 06:00:00 PM,48,-122,7,11,18
35875,FremontBridge,11/05/2016 07:00:00 PM,48,-122,11,13,24
35876,FremontBridge,11/05/2016 08:00:00 PM,48,-122,4,4,8
35877,FremontBridge,11/05/2016 09:00:00 PM,48,-122,3,7,10
35878,FremontBridge,11/05/2016 10:00:00 PM,48,-122,7,7,14
35879,FremontBridge,11/05/2016 11:00:00 PM,48,-122,6,3,9
35880,FremontBridge,11/06/2016 12:00:00 AM,48,-122,2,5,7
35881,FremontBridge,11/06/2016 01:00:00 AM,48,-122,12,2,14
35882,FremontBridge,11/06/2016 02:00:00 AM,48,-122,3,0,3
35883,FremontBridge,11/06/2016 03:00:00 AM,48,-122,0,1,1
35884,FremontBridge,11/06/2016 04:00:00 AM,48,-122,1,0,1
35885,FremontBridge,11/06/2016 05:00:00 AM,48,-122,1,1,2
35886,FremontBridge,11/06/2016 06:00:00 AM,48,-122,6,5,11
35887,FremontBridge,11/06/2016 07:00:00 AM,48,-122,6,15,21
35888,FremontBridge,11/06/2016 08:00:00 AM,48,-122,27,23,50
35889,FremontBridge,11/06/2016 09:00:00 AM,48,-122,48,46,94
35890,FremontBridge,11/06/2016 10:00:00 AM,48,-122,54,101,155
35891,FremontBridge,11/06/2016 11:00:00 AM,48,-122,65,64,129
35892,FremontBridge,11/06/2016 12:00:00 PM,48,-122,69,73,142
35893,FremontBridge,11/06/2016 01:00:00 PM,48,-122,86,86,172
35894,FremontBridge,11/06/2016 02:00:00 PM,48,-122,94,84,178
35895,FremontBridge,11/06/2016 03:00:00 PM,48,-122,91,91,182
35896,FremontBridge,11/06/2016 04:00:00 PM,48,-122,66,64,130
35897,FremontBridge,11/06/2016 05:00:00 PM,48,-122,25,42,67
35898,FremontBridge,11/06/2016 06:00:00 PM,48,-122,27,16,43
35899,FremontBridge,11/06/2016 07:00:00 PM,48,-122,18,22,40
35900,FremontBridge,11/06/2016 08:00:00 PM,48,-122,15,11,26
35901,FremontBridge,11/06/2016 09:00:00 PM,48,-122,14,5,19
35902,FremontBridge,11/06/2016 10:00:00 PM,48,-122,6,4,10
35903,FremontBridge,11/06/2016 11:00:00 PM,48,-122,8,4,12
35904,FremontBridge,11/07/2016 12:00:00 AM,48,-122,2,2,4
35905,FremontBridge,11/07/2016 01:00:00 AM,48,-122,3,2,5
35906,FremontBridge,11/07/2016 02:00:00 AM,48,-122,1,0,1
35907,FremontBridge,11/07/2016 03:00:00 AM,48,-122,0,0,0
35908,FremontBridge,11/07/2016 04:00:00 AM,48,-122,0,0,0
35909,FremontBridge,11/07/2016 05:00:00 AM,48,-122,11,27,38
35910,FremontBridge,11/07/2016 06:00:00 AM,48,-122,50,76,126
35911,FremontBridge,11/07/2016 07:00:00 AM,48,-122,135,282,417
35912,FremontBridge,11/07/2016 08:00:00 AM,48,-122,198,281,479
35913,FremontBridge,11/07/2016 09:00:00 AM,48,-122,100,127,227
35914,FremontBridge,11/07/2016 10:00:00 AM,48,-122,48,41,89
35915,FremontBridge,11/07/2016 11:00:00 AM,48,-122,27,34,61
35916,FremontBridge,11/07/2016 12:00:00 PM,48,-122,22,39,61
35917,FremontBridge,11/07/2016 01:00:00 PM,48,-122,26,38,64
35918,FremontBridge,11/07/2016 02:00:00 PM,48,-122,44,34,78
35919,FremontBridge,11/07/2016 03:00:00 PM,48,-122,76,50,126
35920,FremontBridge,11/07/2016 04:00:00 PM,48,-122,238,80,318
35921,FremontBridge,11/07/2016 05:00:00 PM,48,-122,475,120,595
35922,FremontBridge,11/07/2016 06:00:00 PM,48,-122,188,79,267
35923,FremontBridge,11/07/2016 07:00:00 PM,48,-122,84,35,119
35924,FremontBridge,11/07/2016 08:00:00 PM,48,-122,45,27,72
35925,FremontBridge,11/07/2016 09:00:00 PM,48,-122,44,15,59
35926,FremontBridge,11/07/2016 10:00:00 PM,48,-122,16,8,24
35927,FremontBridge,11/07/2016 11:00:00 PM,48,-122,10,3,13
35928,FremontBridge,11/08/2016 12:00:00 AM,48,-122,4,1,5
35929,FremontBridge,11/08/2016 01:00:00 AM,48,-122,3,1,4
35930,FremontBridge,11/08/2016 02:00:00 AM,48,-122,1,0,1
35931,FremontBridge,11/08/2016 03:00:00 AM,48,-122,0,3,3
35932,FremontBridge,11/08/2016 04:00:00 AM,48,-122,4,7,11
35933,FremontBridge,11/08/2016 05:00:00 AM,48,-122,21,28,49
35934,FremontBridge,11/08/2016 06:00:00 AM,48,-122,65,98,163
35935,FremontBridge,11/08/2016 07:00:00 AM,48,-122,161,313,474
35936,FremontBridge,11/08/2016 08:00:00 AM,48,-122,216,322,538
35937,FremontBridge,11/08/2016 09:00:00 AM,48,-122,107,145,252
35938,FremontBridge,11/08/2016 10:00:00 AM,48,-122,50,63,113
35939,FremontBridge,11/08/2016 11:00:00 AM,48,-122,48,52,100
35940,FremontBridge,11/08/2016 12:00:00 PM,48,-122,53,68,121
35941,FremontBridge,11/08/2016 01:00:00 PM,48,-122,47,64,111
35942,FremontBridge,11/08/2016 02:00:00 PM,48,-122,70,54,124
35943,FremontBridge,11/08/2016 03:00:00 PM,48,-122,115,89,204
35944,FremontBridge,11/08/2016 04:00:00 PM,48,-122,337,121,458
35945,FremontBridge,11/08/2016 05:00:00 PM,48,-122,456,148,604
35946,FremontBridge,11/08/2016 06:00:00 PM,48,-122,206,110,316
35947,FremontBridge,11/08/2016 07:00:00 PM,48,-122,63,44,107
35948,FremontBridge,11/08/2016 08:00:00 PM,48,-122,62,18,80
35949,FremontBridge,11/08/2016 09:00:00 PM,48,-122,31,16,47
35950,FremontBridge,11/08/2016 10:00:00 PM,48,-122,23,17,40
35951,FremontBridge,11/08/2016 11:00:00 PM,48,-122,11,11,22
35952,FremontBridge,11/09/2016 12:00:00 AM,48,-122,4,5,9
35953,FremontBridge,11/09/2016 01:00:00 AM,48,-122,4,1,5
35954,FremontBridge,11/09/2016 02:00:00 AM,48,-122,1,0,1
35955,FremontBridge,11/09/2016 03:00:00 AM,48,-122,0,3,3
35956,FremontBridge,11/09/2016 04:00:00 AM,48,-122,4,5,9
35957,FremontBridge,11/09/2016 05:00:00 AM,48,-122,10,19,29
35958,FremontBridge,11/09/2016 06:00:00 AM,48,-122,37,68,105
35959,FremontBridge,11/09/2016 07:00:00 AM,48,-122,91,195,286
35960,FremontBridge,11/09/2016 08:00:00 AM,48,-122,157,240,397
35961,FremontBridge,11/09/2016 09:00:00 AM,48,-122,77,103,180
35962,FremontBridge,11/09/2016 10:00:00 AM,48,-122,31,33,64
35963,FremontBridge,11/09/2016 11:00:00 AM,48,-122,20,27,47
35964,FremontBridge,11/09/2016 12:00:00 PM,48,-122,30,18,48
35965,FremontBridge,11/09/2016 01:00:00 PM,48,-122,36,31,67
35966,FremontBridge,11/09/2016 02:00:00 PM,48,-122,36,32,68
35967,FremontBridge,11/09/2016 03:00:00 PM,48,-122,67,56,123
35968,FremontBridge,11/09/2016 04:00:00 PM,48,-122,168,93,261
35969,FremontBridge,11/09/2016 05:00:00 PM,48,-122,361,110,471
35970,FremontBridge,11/09/2016 06:00:00 PM,48,-122,211,81,292
35971,FremontBridge,11/09/2016 07:00:00 PM,48,-122,84,39,123
35972,FremontBridge,11/09/2016 08:00:00 PM,48,-122,57,35,92
35973,FremontBridge,11/09/2016 09:00:00 PM,48,-122,27,28,55
35974,FremontBridge,11/09/2016 10:00:00 PM,48,-122,25,10,35
35975,FremontBridge,11/09/2016 11:00:00 PM,48,-122,10,2,12
35976,FremontBridge,11/10/2016 12:00:00 AM,48,-122,4,6,10
35977,FremontBridge,11/10/2016 01:00:00 AM,48,-122,1,2,3
35978,FremontBridge,11/10/2016 02:00:00 AM,48,-122,2,0,2
35979,FremontBridge,11/10/2016 03:00:00 AM,48,-122,1,3,4
35980,FremontBridge,11/10/2016 04:00:00 AM,48,-122,3,2,5
35981,FremontBridge,11/10/2016 05:00:00 AM,48,-122,8,24,32
35982,FremontBridge,11/10/2016 06:00:00 AM,48,-122,43,76,119
35983,FremontBridge,11/10/2016 07:00:00 AM,48,-122,150,228,378
35984,FremontBridge,11/10/2016 08:00:00 AM,48,-122,195,290,485
35985,FremontBridge,11/10/2016 09:00:00 AM,48,-122,119,136,255
35986,FremontBridge,11/10/2016 10:00:00 AM,48,-122,44,47,91
35987,FremontBridge,11/10/2016 11:00:00 AM,48,-122,37,53,90
35988,FremontBridge,11/10/2016 12:00:00 PM,48,-122,40,30,70
35989,FremontBridge,11/10/2016 01:00:00 PM,48,-122,41,55,96
35990,FremontBridge,11/10/2016 02:00:00 PM,48,-122,60,69,129
35991,FremontBridge,11/10/2016 03:00:00 PM,48,-122,103,68,171
35992,FremontBridge,11/10/2016 04:00:00 PM,48,-122,209,99,308
35993,FremontBridge,11/10/2016 05:00:00 PM,48,-122,390,148,538
35994,FremontBridge,11/10/2016 06:00:00 PM,48,-122,226,103,329
35995,FremontBridge,11/10/2016 07:00:00 PM,48,-122,99,51,150
35996,FremontBridge,11/10/2016 08:00:00 PM,48,-122,59,37,96
35997,FremontBridge,11/10/2016 09:00:00 PM,48,-122,35,20,55
35998,FremontBridge,11/10/2016 10:00:00 PM,48,-122,36,14,50
35999,FremontBridge,11/10/2016 11:00:00 PM,48,-122,9,5,14
36000,FremontBridge,11/11/2016 12:00:00 AM,48,-122,5,8,13
36001,FremontBridge,11/11/2016 01:00:00 AM,48,-122,2,2,4
36002,FremontBridge,11/11/2016 02:00:00 AM,48,-122,3,1,4
36003,FremontBridge,11/11/2016 03:00:00 AM,48,-122,1,1,2
36004,FremontBridge,11/11/2016 04:00:00 AM,48,-122,4,3,7
36005,FremontBridge,11/11/2016 05:00:00 AM,48,-122,9,16,25
36006,FremontBridge,11/11/2016 06:00:00 AM,48,-122,32,49,81
36007,FremontBridge,11/11/2016 07:00:00 AM,48,-122,83,133,216
36008,FremontBridge,11/11/2016 08:00:00 AM,48,-122,137,211,348
36009,FremontBridge,11/11/2016 09:00:00 AM,48,-122,88,94,182
36010,FremontBridge,11/11/2016 10:00:00 AM,48,-122,34,49,83
36011,FremontBridge,11/11/2016 11:00:00 AM,48,-122,48,45,93
36012,FremontBridge,11/11/2016 12:00:00 PM,48,-122,52,43,95
36013,FremontBridge,11/11/2016 01:00:00 PM,48,-122,45,43,88
36014,FremontBridge,11/11/2016 02:00:00 PM,48,-122,65,42,107
36015,FremontBridge,11/11/2016 03:00:00 PM,48,-122,86,60,146
36016,FremontBridge,11/11/2016 04:00:00 PM,48,-122,174,73,247
36017,FremontBridge,11/11/2016 05:00:00 PM,48,-122,277,84,361
36018,FremontBridge,11/11/2016 06:00:00 PM,48,-122,144,47,191
36019,FremontBridge,11/11/2016 07:00:00 PM,48,-122,53,40,93
36020,FremontBridge,11/11/2016 08:00:00 PM,48,-122,29,13,42
36021,FremontBridge,11/11/2016 09:00:00 PM,48,-122,24,11,35
36022,FremontBridge,11/11/2016 10:00:00 PM,48,-122,10,8,18
36023,FremontBridge,11/11/2016 11:00:00 PM,48,-122,14,13,27
36024,FremontBridge,11/12/2016 12:00:00 AM,48,-122,8,12,20
36025,FremontBridge,11/12/2016 01:00:00 AM,48,-122,5,2,7
36026,FremontBridge,11/12/2016 02:00:00 AM,48,-122,3,1,4
36027,FremontBridge,11/12/2016 03:00:00 AM,48,-122,1,3,4
36028,FremontBridge,11/12/2016 04:00:00 AM,48,-122,0,1,1
36029,FremontBridge,11/12/2016 05:00:00 AM,48,-122,5,3,8
36030,FremontBridge,11/12/2016 06:00:00 AM,48,-122,3,5,8
36031,FremontBridge,11/12/2016 07:00:00 AM,48,-122,8,9,17
36032,FremontBridge,11/12/2016 08:00:00 AM,48,-122,26,25,51
36033,FremontBridge,11/12/2016 09:00:00 AM,48,-122,14,25,39
36034,FremontBridge,11/12/2016 10:00:00 AM,48,-122,18,31,49
36035,FremontBridge,11/12/2016 11:00:00 AM,48,-122,22,21,43
36036,FremontBridge,11/12/2016 12:00:00 PM,48,-122,39,28,67
36037,FremontBridge,11/12/2016 01:00:00 PM,48,-122,30,37,67
36038,FremontBridge,11/12/2016 02:00:00 PM,48,-122,41,24,65
36039,FremontBridge,11/12/2016 03:00:00 PM,48,-122,37,46,83
36040,FremontBridge,11/12/2016 04:00:00 PM,48,-122,42,31,73
36041,FremontBridge,11/12/2016 05:00:00 PM,48,-122,38,17,55
36042,FremontBridge,11/12/2016 06:00:00 PM,48,-122,23,41,64
36043,FremontBridge,11/12/2016 07:00:00 PM,48,-122,21,17,38
36044,FremontBridge,11/12/2016 08:00:00 PM,48,-122,17,24,41
36045,FremontBridge,11/12/2016 09:00:00 PM,48,-122,24,11,35
36046,FremontBridge,11/12/2016 10:00:00 PM,48,-122,14,7,21
36047,FremontBridge,11/12/2016 11:00:00 PM,48,-122,11,10,21
36048,FremontBridge,11/13/2016 12:00:00 AM,48,-122,11,5,16
36049,FremontBridge,11/13/2016 01:00:00 AM,48,-122,4,2,6
36050,FremontBridge,11/13/2016 02:00:00 AM,48,-122,1,3,4
36051,FremontBridge,11/13/2016 03:00:00 AM,48,-122,1,3,4
36052,FremontBridge,11/13/2016 04:00:00 AM,48,-122,1,1,2
36053,FremontBridge,11/13/2016 05:00:00 AM,48,-122,1,1,2
36054,FremontBridge,11/13/2016 06:00:00 AM,48,-122,5,3,8
36055,FremontBridge,11/13/2016 07:00:00 AM,48,-122,13,5,18
36056,FremontBridge,11/13/2016 08:00:00 AM,48,-122,13,12,25
36057,FremontBridge,11/13/2016 09:00:00 AM,48,-122,18,11,29
36058,FremontBridge,11/13/2016 10:00:00 AM,48,-122,20,19,39
36059,FremontBridge,11/13/2016 11:00:00 AM,48,-122,22,29,51
36060,FremontBridge,11/13/2016 12:00:00 PM,48,-122,25,29,54
36061,FremontBridge,11/13/2016 01:00:00 PM,48,-122,22,37,59
36062,FremontBridge,11/13/2016 02:00:00 PM,48,-122,22,37,59
36063,FremontBridge,11/13/2016 03:00:00 PM,48,-122,24,23,47
36064,FremontBridge,11/13/2016 04:00:00 PM,48,-122,24,31,55
36065,FremontBridge,11/13/2016 05:00:00 PM,48,-122,18,17,35
36066,FremontBridge,11/13/2016 06:00:00 PM,48,-122,14,11,25
36067,FremontBridge,11/13/2016 07:00:00 PM,48,-122,11,4,15
36068,FremontBridge,11/13/2016 08:00:00 PM,48,-122,11,6,17
36069,FremontBridge,11/13/2016 09:00:00 PM,48,-122,11,6,17
36070,FremontBridge,11/13/2016 10:00:00 PM,48,-122,11,3,14
36071,FremontBridge,11/13/2016 11:00:00 PM,48,-122,2,3,5
36072,FremontBridge,11/14/2016 12:00:00 AM,48,-122,5,3,8
36073,FremontBridge,11/14/2016 01:00:00 AM,48,-122,0,0,0
36074,FremontBridge,11/14/2016 02:00:00 AM,48,-122,0,0,0
36075,FremontBridge,11/14/2016 03:00:00 AM,48,-122,0,0,0
36076,FremontBridge,11/14/2016 04:00:00 AM,48,-122,0,5,5
36077,FremontBridge,11/14/2016 05:00:00 AM,48,-122,10,21,31
36078,FremontBridge,11/14/2016 06:00:00 AM,48,-122,47,56,103
36079,FremontBridge,11/14/2016 07:00:00 AM,48,-122,113,205,318
36080,FremontBridge,11/14/2016 08:00:00 AM,48,-122,210,271,481
36081,FremontBridge,11/14/2016 09:00:00 AM,48,-122,105,123,228
36082,FremontBridge,11/14/2016 10:00:00 AM,48,-122,35,43,78
36083,FremontBridge,11/14/2016 11:00:00 AM,48,-122,37,37,74
36084,FremontBridge,11/14/2016 12:00:00 PM,48,-122,33,34,67
36085,FremontBridge,11/14/2016 01:00:00 PM,48,-122,34,28,62
36086,FremontBridge,11/14/2016 02:00:00 PM,48,-122,37,45,82
36087,FremontBridge,11/14/2016 03:00:00 PM,48,-122,77,63,140
36088,FremontBridge,11/14/2016 04:00:00 PM,48,-122,170,80,250
36089,FremontBridge,11/14/2016 05:00:00 PM,48,-122,375,122,497
36090,FremontBridge,11/14/2016 06:00:00 PM,48,-122,270,86,356
36091,FremontBridge,11/14/2016 07:00:00 PM,48,-122,92,42,134
36092,FremontBridge,11/14/2016 08:00:00 PM,48,-122,61,28,89
36093,FremontBridge,11/14/2016 09:00:00 PM,48,-122,27,10,37
36094,FremontBridge,11/14/2016 10:00:00 PM,48,-122,19,11,30
36095,FremontBridge,11/14/2016 11:00:00 PM,48,-122,10,4,14
36096,FremontBridge,11/15/2016 12:00:00 AM,48,-122,3,2,5
36097,FremontBridge,11/15/2016 01:00:00 AM,48,-122,2,1,3
36098,FremontBridge,11/15/2016 02:00:00 AM,48,-122,1,1,2
36099,FremontBridge,11/15/2016 03:00:00 AM,48,-122,0,1,1
36100,FremontBridge,11/15/2016 04:00:00 AM,48,-122,4,5,9
36101,FremontBridge,11/15/2016 05:00:00 AM,48,-122,10,17,27
36102,FremontBridge,11/15/2016 06:00:00 AM,48,-122,39,60,99
36103,FremontBridge,11/15/2016 07:00:00 AM,48,-122,108,170,278
36104,FremontBridge,11/15/2016 08:00:00 AM,48,-122,136,237,373
36105,FremontBridge,11/15/2016 09:00:00 AM,48,-122,99,113,212
36106,FremontBridge,11/15/2016 10:00:00 AM,48,-122,43,46,89
36107,FremontBridge,11/15/2016 11:00:00 AM,48,-122,12,29,41
36108,FremontBridge,11/15/2016 12:00:00 PM,48,-122,29,20,49
36109,FremontBridge,11/15/2016 01:00:00 PM,48,-122,17,31,48
36110,FremontBridge,11/15/2016 02:00:00 PM,48,-122,29,24,53
36111,FremontBridge,11/15/2016 03:00:00 PM,48,-122,61,35,96
36112,FremontBridge,11/15/2016 04:00:00 PM,48,-122,148,57,205
36113,FremontBridge,11/15/2016 05:00:00 PM,48,-122,329,96,425
36114,FremontBridge,11/15/2016 06:00:00 PM,48,-122,173,64,237
36115,FremontBridge,11/15/2016 07:00:00 PM,48,-122,77,45,122
36116,FremontBridge,11/15/2016 08:00:00 PM,48,-122,28,16,44
36117,FremontBridge,11/15/2016 09:00:00 PM,48,-122,19,10,29
36118,FremontBridge,11/15/2016 10:00:00 PM,48,-122,18,4,22
36119,FremontBridge,11/15/2016 11:00:00 PM,48,-122,6,0,6
36120,FremontBridge,11/16/2016 12:00:00 AM,48,-122,3,2,5
36121,FremontBridge,11/16/2016 01:00:00 AM,48,-122,0,2,2
36122,FremontBridge,11/16/2016 02:00:00 AM,48,-122,1,1,2
36123,FremontBridge,11/16/2016 03:00:00 AM,48,-122,1,0,1
36124,FremontBridge,11/16/2016 04:00:00 AM,48,-122,4,8,12
36125,FremontBridge,11/16/2016 05:00:00 AM,48,-122,16,21,37
36126,FremontBridge,11/16/2016 06:00:00 AM,48,-122,63,68,131
36127,FremontBridge,11/16/2016 07:00:00 AM,48,-122,110,194,304
36128,FremontBridge,11/16/2016 08:00:00 AM,48,-122,154,260,414
36129,FremontBridge,11/16/2016 09:00:00 AM,48,-122,109,121,230
36130,FremontBridge,11/16/2016 10:00:00 AM,48,-122,45,48,93
36131,FremontBridge,11/16/2016 11:00:00 AM,48,-122,23,27,50
36132,FremontBridge,11/16/2016 12:00:00 PM,48,-122,27,35,62
36133,FremontBridge,11/16/2016 01:00:00 PM,48,-122,36,30,66
36134,FremontBridge,11/16/2016 02:00:00 PM,48,-122,36,23,59
36135,FremontBridge,11/16/2016 03:00:00 PM,48,-122,90,53,143
36136,FremontBridge,11/16/2016 04:00:00 PM,48,-122,164,77,241
36137,FremontBridge,11/16/2016 05:00:00 PM,48,-122,374,106,480
36138,FremontBridge,11/16/2016 06:00:00 PM,48,-122,203,85,288
36139,FremontBridge,11/16/2016 07:00:00 PM,48,-122,104,38,142
36140,FremontBridge,11/16/2016 08:00:00 PM,48,-122,46,22,68
36141,FremontBridge,11/16/2016 09:00:00 PM,48,-122,36,18,54
36142,FremontBridge,11/16/2016 10:00:00 PM,48,-122,23,12,35
36143,FremontBridge,11/16/2016 11:00:00 PM,48,-122,7,4,11
36144,FremontBridge,11/17/2016 12:00:00 AM,48,-122,0,4,4
36145,FremontBridge,11/17/2016 01:00:00 AM,48,-122,1,4,5
36146,FremontBridge,11/17/2016 02:00:00 AM,48,-122,2,5,7
36147,FremontBridge,11/17/2016 03:00:00 AM,48,-122,0,1,1
36148,FremontBridge,11/17/2016 04:00:00 AM,48,-122,1,3,4
36149,FremontBridge,11/17/2016 05:00:00 AM,48,-122,9,15,24
36150,FremontBridge,11/17/2016 06:00:00 AM,48,-122,54,62,116
36151,FremontBridge,11/17/2016 07:00:00 AM,48,-122,119,201,320
36152,FremontBridge,11/17/2016 08:00:00 AM,48,-122,177,249,426
36153,FremontBridge,11/17/2016 09:00:00 AM,48,-122,102,121,223
36154,FremontBridge,11/17/2016 10:00:00 AM,48,-122,58,52,110
36155,FremontBridge,11/17/2016 11:00:00 AM,48,-122,30,39,69
36156,FremontBridge,11/17/2016 12:00:00 PM,48,-122,30,48,78
36157,FremontBridge,11/17/2016 01:00:00 PM,48,-122,43,28,71
36158,FremontBridge,11/17/2016 02:00:00 PM,48,-122,53,33,86
36159,FremontBridge,11/17/2016 03:00:00 PM,48,-122,68,55,123
36160,FremontBridge,11/17/2016 04:00:00 PM,48,-122,175,86,261
36161,FremontBridge,11/17/2016 05:00:00 PM,48,-122,339,109,448
36162,FremontBridge,11/17/2016 06:00:00 PM,48,-122,212,95,307
36163,FremontBridge,11/17/2016 07:00:00 PM,48,-122,102,47,149
36164,FremontBridge,11/17/2016 08:00:00 PM,48,-122,65,24,89
36165,FremontBridge,11/17/2016 09:00:00 PM,48,-122,46,18,64
36166,FremontBridge,11/17/2016 10:00:00 PM,48,-122,30,15,45
36167,FremontBridge,11/17/2016 11:00:00 PM,48,-122,16,11,27
36168,FremontBridge,11/18/2016 12:00:00 AM,48,-122,4,1,5
36169,FremontBridge,11/18/2016 01:00:00 AM,48,-122,7,2,9
36170,FremontBridge,11/18/2016 02:00:00 AM,48,-122,2,2,4
36171,FremontBridge,11/18/2016 03:00:00 AM,48,-122,2,0,2
36172,FremontBridge,11/18/2016 04:00:00 AM,48,-122,4,1,5
36173,FremontBridge,11/18/2016 05:00:00 AM,48,-122,11,18,29
36174,FremontBridge,11/18/2016 06:00:00 AM,48,-122,43,62,105
36175,FremontBridge,11/18/2016 07:00:00 AM,48,-122,85,161,246
36176,FremontBridge,11/18/2016 08:00:00 AM,48,-122,167,248,415
36177,FremontBridge,11/18/2016 09:00:00 AM,48,-122,99,116,215
36178,FremontBridge,11/18/2016 10:00:00 AM,48,-122,49,60,109
36179,FremontBridge,11/18/2016 11:00:00 AM,48,-122,40,43,83
36180,FremontBridge,11/18/2016 12:00:00 PM,48,-122,38,26,64
36181,FremontBridge,11/18/2016 01:00:00 PM,48,-122,33,50,83
36182,FremontBridge,11/18/2016 02:00:00 PM,48,-122,51,35,86
36183,FremontBridge,11/18/2016 03:00:00 PM,48,-122,79,40,119
36184,FremontBridge,11/18/2016 04:00:00 PM,48,-122,188,82,270
36185,FremontBridge,11/18/2016 05:00:00 PM,48,-122,309,99,408
36186,FremontBridge,11/18/2016 06:00:00 PM,48,-122,167,63,230
36187,FremontBridge,11/18/2016 07:00:00 PM,48,-122,70,28,98
36188,FremontBridge,11/18/2016 08:00:00 PM,48,-122,27,15,42
36189,FremontBridge,11/18/2016 09:00:00 PM,48,-122,30,14,44
36190,FremontBridge,11/18/2016 10:00:00 PM,48,-122,16,14,30
36191,FremontBridge,11/18/2016 11:00:00 PM,48,-122,12,6,18
36192,FremontBridge,11/19/2016 12:00:00 AM,48,-122,12,2,14
36193,FremontBridge,11/19/2016 01:00:00 AM,48,-122,4,2,6
36194,FremontBridge,11/19/2016 02:00:00 AM,48,-122,5,1,6
36195,FremontBridge,11/19/2016 03:00:00 AM,48,-122,1,1,2
36196,FremontBridge,11/19/2016 04:00:00 AM,48,-122,0,0,0
36197,FremontBridge,11/19/2016 05:00:00 AM,48,-122,3,3,6
36198,FremontBridge,11/19/2016 06:00:00 AM,48,-122,6,5,11
36199,FremontBridge,11/19/2016 07:00:00 AM,48,-122,7,13,20
36200,FremontBridge,11/19/2016 08:00:00 AM,48,-122,20,22,42
36201,FremontBridge,11/19/2016 09:00:00 AM,48,-122,13,29,42
36202,FremontBridge,11/19/2016 10:00:00 AM,48,-122,26,21,47
36203,FremontBridge,11/19/2016 11:00:00 AM,48,-122,30,24,54
36204,FremontBridge,11/19/2016 12:00:00 PM,48,-122,38,50,88
36205,FremontBridge,11/19/2016 01:00:00 PM,48,-122,25,33,58
36206,FremontBridge,11/19/2016 02:00:00 PM,48,-122,46,24,70
36207,FremontBridge,11/19/2016 03:00:00 PM,48,-122,41,41,82
36208,FremontBridge,11/19/2016 04:00:00 PM,48,-122,33,35,68
36209,FremontBridge,11/19/2016 05:00:00 PM,48,-122,19,23,42
36210,FremontBridge,11/19/2016 06:00:00 PM,48,-122,17,19,36
36211,FremontBridge,11/19/2016 07:00:00 PM,48,-122,23,17,40
36212,FremontBridge,11/19/2016 08:00:00 PM,48,-122,12,17,29
36213,FremontBridge,11/19/2016 09:00:00 PM,48,-122,24,8,32
36214,FremontBridge,11/19/2016 10:00:00 PM,48,-122,19,9,28
36215,FremontBridge,11/19/2016 11:00:00 PM,48,-122,12,4,16
36216,FremontBridge,11/20/2016 12:00:00 AM,48,-122,10,7,17
36217,FremontBridge,11/20/2016 01:00:00 AM,48,-122,4,3,7
36218,FremontBridge,11/20/2016 02:00:00 AM,48,-122,0,3,3
36219,FremontBridge,11/20/2016 03:00:00 AM,48,-122,0,0,0
36220,FremontBridge,11/20/2016 04:00:00 AM,48,-122,1,1,2
36221,FremontBridge,11/20/2016 05:00:00 AM,48,-122,0,3,3
36222,FremontBridge,11/20/2016 06:00:00 AM,48,-122,3,0,3
36223,FremontBridge,11/20/2016 07:00:00 AM,48,-122,5,6,11
36224,FremontBridge,11/20/2016 08:00:00 AM,48,-122,8,12,20
36225,FremontBridge,11/20/2016 09:00:00 AM,48,-122,6,18,24
36226,FremontBridge,11/20/2016 10:00:00 AM,48,-122,18,16,34
36227,FremontBridge,11/20/2016 11:00:00 AM,48,-122,19,17,36
36228,FremontBridge,11/20/2016 12:00:00 PM,48,-122,21,27,48
36229,FremontBridge,11/20/2016 01:00:00 PM,48,-122,25,23,48
36230,FremontBridge,11/20/2016 02:00:00 PM,48,-122,20,20,40
36231,FremontBridge,11/20/2016 03:00:00 PM,48,-122,28,26,54
36232,FremontBridge,11/20/2016 04:00:00 PM,48,-122,17,18,35
36233,FremontBridge,11/20/2016 05:00:00 PM,48,-122,20,24,44
36234,FremontBridge,11/20/2016 06:00:00 PM,48,-122,24,12,36
36235,FremontBridge,11/20/2016 07:00:00 PM,48,-122,14,7,21
36236,FremontBridge,11/20/2016 08:00:00 PM,48,-122,9,7,16
36237,FremontBridge,11/20/2016 09:00:00 PM,48,-122,6,12,18
36238,FremontBridge,11/20/2016 10:00:00 PM,48,-122,6,9,15
36239,FremontBridge,11/20/2016 11:00:00 PM,48,-122,5,4,9
36240,FremontBridge,11/21/2016 12:00:00 AM,48,-122,0,0,0
36241,FremontBridge,11/21/2016 01:00:00 AM,48,-122,2,0,2
36242,FremontBridge,11/21/2016 02:00:00 AM,48,-122,0,0,0
36243,FremontBridge,11/21/2016 03:00:00 AM,48,-122,0,1,1
36244,FremontBridge,11/21/2016 04:00:00 AM,48,-122,1,6,7
36245,FremontBridge,11/21/2016 05:00:00 AM,48,-122,9,19,28
36246,FremontBridge,11/21/2016 06:00:00 AM,48,-122,53,74,127
36247,FremontBridge,11/21/2016 07:00:00 AM,48,-122,108,194,302
36248,FremontBridge,11/21/2016 08:00:00 AM,48,-122,166,226,392
36249,FremontBridge,11/21/2016 09:00:00 AM,48,-122,106,132,238
36250,FremontBridge,11/21/2016 10:00:00 AM,48,-122,36,70,106
36251,FremontBridge,11/21/2016 11:00:00 AM,48,-122,24,20,44
36252,FremontBridge,11/21/2016 12:00:00 PM,48,-122,40,34,74
36253,FremontBridge,11/21/2016 01:00:00 PM,48,-122,33,38,71
36254,FremontBridge,11/21/2016 02:00:00 PM,48,-122,61,55,116
36255,FremontBridge,11/21/2016 03:00:00 PM,48,-122,79,56,135
36256,FremontBridge,11/21/2016 04:00:00 PM,48,-122,187,91,278
36257,FremontBridge,11/21/2016 05:00:00 PM,48,-122,358,98,456
36258,FremontBridge,11/21/2016 06:00:00 PM,48,-122,227,85,312
36259,FremontBridge,11/21/2016 07:00:00 PM,48,-122,65,43,108
36260,FremontBridge,11/21/2016 08:00:00 PM,48,-122,54,34,88
36261,FremontBridge,11/21/2016 09:00:00 PM,48,-122,21,11,32
36262,FremontBridge,11/21/2016 10:00:00 PM,48,-122,18,12,30
36263,FremontBridge,11/21/2016 11:00:00 PM,48,-122,5,4,9
36264,FremontBridge,11/22/2016 12:00:00 AM,48,-122,5,4,9
36265,FremontBridge,11/22/2016 01:00:00 AM,48,-122,1,0,1
36266,FremontBridge,11/22/2016 02:00:00 AM,48,-122,1,0,1
36267,FremontBridge,11/22/2016 03:00:00 AM,48,-122,0,1,1
36268,FremontBridge,11/22/2016 04:00:00 AM,48,-122,3,5,8
36269,FremontBridge,11/22/2016 05:00:00 AM,48,-122,11,17,28
36270,FremontBridge,11/22/2016 06:00:00 AM,48,-122,41,67,108
36271,FremontBridge,11/22/2016 07:00:00 AM,48,-122,95,136,231
36272,FremontBridge,11/22/2016 08:00:00 AM,48,-122,136,196,332
36273,FremontBridge,11/22/2016 09:00:00 AM,48,-122,81,91,172
36274,FremontBridge,11/22/2016 10:00:00 AM,48,-122,40,41,81
36275,FremontBridge,11/22/2016 11:00:00 AM,48,-122,16,34,50
36276,FremontBridge,11/22/2016 12:00:00 PM,48,-122,20,35,55
36277,FremontBridge,11/22/2016 01:00:00 PM,48,-122,31,23,54
36278,FremontBridge,11/22/2016 02:00:00 PM,48,-122,34,21,55
36279,FremontBridge,11/22/2016 03:00:00 PM,48,-122,53,39,92
36280,FremontBridge,11/22/2016 04:00:00 PM,48,-122,112,62,174
36281,FremontBridge,11/22/2016 05:00:00 PM,48,-122,240,66,306
36282,FremontBridge,11/22/2016 06:00:00 PM,48,-122,146,39,185
36283,FremontBridge,11/22/2016 07:00:00 PM,48,-122,68,22,90
36284,FremontBridge,11/22/2016 08:00:00 PM,48,-122,33,16,49
36285,FremontBridge,11/22/2016 09:00:00 PM,48,-122,14,8,22
36286,FremontBridge,11/22/2016 10:00:00 PM,48,-122,16,6,22
36287,FremontBridge,11/22/2016 11:00:00 PM,48,-122,5,5,10
36288,FremontBridge,11/23/2016 12:00:00 AM,48,-122,4,3,7
36289,FremontBridge,11/23/2016 01:00:00 AM,48,-122,2,2,4
36290,FremontBridge,11/23/2016 02:00:00 AM,48,-122,2,0,2
36291,FremontBridge,11/23/2016 03:00:00 AM,48,-122,0,0,0
36292,FremontBridge,11/23/2016 04:00:00 AM,48,-122,2,1,3
36293,FremontBridge,11/23/2016 05:00:00 AM,48,-122,14,18,32
36294,FremontBridge,11/23/2016 06:00:00 AM,48,-122,27,40,67
36295,FremontBridge,11/23/2016 07:00:00 AM,48,-122,61,98,159
36296,FremontBridge,11/23/2016 08:00:00 AM,48,-122,97,158,255
36297,FremontBridge,11/23/2016 09:00:00 AM,48,-122,63,84,147
36298,FremontBridge,11/23/2016 10:00:00 AM,48,-122,48,32,80
36299,FremontBridge,11/23/2016 11:00:00 AM,48,-122,21,29,50
36300,FremontBridge,11/23/2016 12:00:00 PM,48,-122,29,26,55
36301,FremontBridge,11/23/2016 01:00:00 PM,48,-122,39,26,65
36302,FremontBridge,11/23/2016 02:00:00 PM,48,-122,63,28,91
36303,FremontBridge,11/23/2016 03:00:00 PM,48,-122,95,36,131
36304,FremontBridge,11/23/2016 04:00:00 PM,48,-122,151,59,210
36305,FremontBridge,11/23/2016 05:00:00 PM,48,-122,129,62,191
36306,FremontBridge,11/23/2016 06:00:00 PM,48,-122,100,33,133
36307,FremontBridge,11/23/2016 07:00:00 PM,48,-122,29,22,51
36308,FremontBridge,11/23/2016 08:00:00 PM,48,-122,23,14,37
36309,FremontBridge,11/23/2016 09:00:00 PM,48,-122,7,6,13
36310,FremontBridge,11/23/2016 10:00:00 PM,48,-122,5,3,8
36311,FremontBridge,11/23/2016 11:00:00 PM,48,-122,3,0,3
36312,FremontBridge,11/24/2016 12:00:00 AM,48,-122,2,0,2
36313,FremontBridge,11/24/2016 01:00:00 AM,48,-122,1,1,2
36314,FremontBridge,11/24/2016 02:00:00 AM,48,-122,1,0,1
36315,FremontBridge,11/24/2016 03:00:00 AM,48,-122,1,0,1
36316,FremontBridge,11/24/2016 04:00:00 AM,48,-122,1,0,1
36317,FremontBridge,11/24/2016 05:00:00 AM,48,-122,0,0,0
36318,FremontBridge,11/24/2016 06:00:00 AM,48,-122,1,2,3
36319,FremontBridge,11/24/2016 07:00:00 AM,48,-122,4,3,7
36320,FremontBridge,11/24/2016 08:00:00 AM,48,-122,8,4,12
36321,FremontBridge,11/24/2016 09:00:00 AM,48,-122,7,9,16
36322,FremontBridge,11/24/2016 10:00:00 AM,48,-122,6,11,17
36323,FremontBridge,11/24/2016 11:00:00 AM,48,-122,7,4,11
36324,FremontBridge,11/24/2016 12:00:00 PM,48,-122,21,3,24
36325,FremontBridge,11/24/2016 01:00:00 PM,48,-122,7,6,13
36326,FremontBridge,11/24/2016 02:00:00 PM,48,-122,3,7,10
36327,FremontBridge,11/24/2016 03:00:00 PM,48,-122,5,4,9
36328,FremontBridge,11/24/2016 04:00:00 PM,48,-122,2,1,3
36329,FremontBridge,11/24/2016 05:00:00 PM,48,-122,1,4,5
36330,FremontBridge,11/24/2016 06:00:00 PM,48,-122,0,0,0
36331,FremontBridge,11/24/2016 07:00:00 PM,48,-122,0,3,3
36332,FremontBridge,11/24/2016 08:00:00 PM,48,-122,23,2,25
36333,FremontBridge,11/24/2016 09:00:00 PM,48,-122,2,2,4
36334,FremontBridge,11/24/2016 10:00:00 PM,48,-122,2,2,4
36335,FremontBridge,11/24/2016 11:00:00 PM,48,-122,5,1,6
36336,FremontBridge,11/25/2016 12:00:00 AM,48,-122,1,2,3
36337,FremontBridge,11/25/2016 01:00:00 AM,48,-122,0,0,0
36338,FremontBridge,11/25/2016 02:00:00 AM,48,-122,1,1,2
36339,FremontBridge,11/25/2016 03:00:00 AM,48,-122,1,0,1
36340,FremontBridge,11/25/2016 04:00:00 AM,48,-122,3,4,7
36341,FremontBridge,11/25/2016 05:00:00 AM,48,-122,3,5,8
36342,FremontBridge,11/25/2016 06:00:00 AM,48,-122,6,7,13
36343,FremontBridge,11/25/2016 07:00:00 AM,48,-122,13,14,27
36344,FremontBridge,11/25/2016 08:00:00 AM,48,-122,20,25,45
36345,FremontBridge,11/25/2016 09:00:00 AM,48,-122,21,28,49
36346,FremontBridge,11/25/2016 10:00:00 AM,48,-122,33,44,77
36347,FremontBridge,11/25/2016 11:00:00 AM,48,-122,54,41,95
36348,FremontBridge,11/25/2016 12:00:00 PM,48,-122,48,63,111
36349,FremontBridge,11/25/2016 01:00:00 PM,48,-122,53,51,104
36350,FremontBridge,11/25/2016 02:00:00 PM,48,-122,54,37,91
36351,FremontBridge,11/25/2016 03:00:00 PM,48,-122,56,37,93
36352,FremontBridge,11/25/2016 04:00:00 PM,48,-122,35,27,62
36353,FremontBridge,11/25/2016 05:00:00 PM,48,-122,35,14,49
36354,FremontBridge,11/25/2016 06:00:00 PM,48,-122,32,17,49
36355,FremontBridge,11/25/2016 07:00:00 PM,48,-122,18,3,21
36356,FremontBridge,11/25/2016 08:00:00 PM,48,-122,11,15,26
36357,FremontBridge,11/25/2016 09:00:00 PM,48,-122,7,6,13
36358,FremontBridge,11/25/2016 10:00:00 PM,48,-122,5,4,9
36359,FremontBridge,11/25/2016 11:00:00 PM,48,-122,6,6,12
36360,FremontBridge,11/26/2016 12:00:00 AM,48,-122,5,5,10
36361,FremontBridge,11/26/2016 01:00:00 AM,48,-122,0,0,0
36362,FremontBridge,11/26/2016 02:00:00 AM,48,-122,0,1,1
36363,FremontBridge,11/26/2016 03:00:00 AM,48,-122,0,0,0
36364,FremontBridge,11/26/2016 04:00:00 AM,48,-122,0,2,2
36365,FremontBridge,11/26/2016 05:00:00 AM,48,-122,3,1,4
36366,FremontBridge,11/26/2016 06:00:00 AM,48,-122,3,3,6
36367,FremontBridge,11/26/2016 07:00:00 AM,48,-122,3,4,7
36368,FremontBridge,11/26/2016 08:00:00 AM,48,-122,14,6,20
36369,FremontBridge,11/26/2016 09:00:00 AM,48,-122,12,8,20
36370,FremontBridge,11/26/2016 10:00:00 AM,48,-122,5,9,14
36371,FremontBridge,11/26/2016 11:00:00 AM,48,-122,12,12,24
36372,FremontBridge,11/26/2016 12:00:00 PM,48,-122,14,25,39
36373,FremontBridge,11/26/2016 01:00:00 PM,48,-122,20,27,47
36374,FremontBridge,11/26/2016 02:00:00 PM,48,-122,25,17,42
36375,FremontBridge,11/26/2016 03:00:00 PM,48,-122,28,15,43
36376,FremontBridge,11/26/2016 04:00:00 PM,48,-122,14,13,27
36377,FremontBridge,11/26/2016 05:00:00 PM,48,-122,17,12,29
36378,FremontBridge,11/26/2016 06:00:00 PM,48,-122,19,12,31
36379,FremontBridge,11/26/2016 07:00:00 PM,48,-122,11,11,22
36380,FremontBridge,11/26/2016 08:00:00 PM,48,-122,6,7,13
36381,FremontBridge,11/26/2016 09:00:00 PM,48,-122,9,5,14
36382,FremontBridge,11/26/2016 10:00:00 PM,48,-122,4,2,6
36383,FremontBridge,11/26/2016 11:00:00 PM,48,-122,2,5,7
36384,FremontBridge,11/27/2016 12:00:00 AM,48,-122,4,5,9
36385,FremontBridge,11/27/2016 01:00:00 AM,48,-122,2,3,5
36386,FremontBridge,11/27/2016 02:00:00 AM,48,-122,1,1,2
36387,FremontBridge,11/27/2016 03:00:00 AM,48,-122,0,0,0
36388,FremontBridge,11/27/2016 04:00:00 AM,48,-122,0,1,1
36389,FremontBridge,11/27/2016 05:00:00 AM,48,-122,2,3,5
36390,FremontBridge,11/27/2016 06:00:00 AM,48,-122,4,2,6
36391,FremontBridge,11/27/2016 07:00:00 AM,48,-122,0,7,7
36392,FremontBridge,11/27/2016 08:00:00 AM,48,-122,11,18,29
36393,FremontBridge,11/27/2016 09:00:00 AM,48,-122,31,20,51
36394,FremontBridge,11/27/2016 10:00:00 AM,48,-122,27,34,61
36395,FremontBridge,11/27/2016 11:00:00 AM,48,-122,28,33,61
36396,FremontBridge,11/27/2016 12:00:00 PM,48,-122,30,31,61
36397,FremontBridge,11/27/2016 01:00:00 PM,48,-122,12,19,31
36398,FremontBridge,11/27/2016 02:00:00 PM,48,-122,11,14,25
36399,FremontBridge,11/27/2016 03:00:00 PM,48,-122,11,13,24
36400,FremontBridge,11/27/2016 04:00:00 PM,48,-122,17,13,30
36401,FremontBridge,11/27/2016 05:00:00 PM,48,-122,6,13,19
36402,FremontBridge,11/27/2016 06:00:00 PM,48,-122,9,5,14
36403,FremontBridge,11/27/2016 07:00:00 PM,48,-122,12,8,20
36404,FremontBridge,11/27/2016 08:00:00 PM,48,-122,6,4,10
36405,FremontBridge,11/27/2016 09:00:00 PM,48,-122,4,4,8
36406,FremontBridge,11/27/2016 10:00:00 PM,48,-122,5,3,8
36407,FremontBridge,11/27/2016 11:00:00 PM,48,-122,3,0,3
36408,FremontBridge,11/28/2016 12:00:00 AM,48,-122,2,1,3
36409,FremontBridge,11/28/2016 01:00:00 AM,48,-122,0,0,0
36410,FremontBridge,11/28/2016 02:00:00 AM,48,-122,0,0,0
36411,FremontBridge,11/28/2016 03:00:00 AM,48,-122,1,1,2
36412,FremontBridge,11/28/2016 04:00:00 AM,48,-122,4,2,6
36413,FremontBridge,11/28/2016 05:00:00 AM,48,-122,14,26,40
36414,FremontBridge,11/28/2016 06:00:00 AM,48,-122,43,61,104
36415,FremontBridge,11/28/2016 07:00:00 AM,48,-122,104,208,312
36416,FremontBridge,11/28/2016 08:00:00 AM,48,-122,144,244,388
36417,FremontBridge,11/28/2016 09:00:00 AM,48,-122,102,120,222
36418,FremontBridge,11/28/2016 10:00:00 AM,48,-122,44,44,88
36419,FremontBridge,11/28/2016 11:00:00 AM,48,-122,31,31,62
36420,FremontBridge,11/28/2016 12:00:00 PM,48,-122,28,23,51
36421,FremontBridge,11/28/2016 01:00:00 PM,48,-122,28,28,56
36422,FremontBridge,11/28/2016 02:00:00 PM,48,-122,38,30,68
36423,FremontBridge,11/28/2016 03:00:00 PM,48,-122,67,45,112
36424,FremontBridge,11/28/2016 04:00:00 PM,48,-122,153,79,232
36425,FremontBridge,11/28/2016 05:00:00 PM,48,-122,373,101,474
36426,FremontBridge,11/28/2016 06:00:00 PM,48,-122,205,86,291
36427,FremontBridge,11/28/2016 07:00:00 PM,48,-122,89,46,135
36428,FremontBridge,11/28/2016 08:00:00 PM,48,-122,42,21,63
36429,FremontBridge,11/28/2016 09:00:00 PM,48,-122,26,18,44
36430,FremontBridge,11/28/2016 10:00:00 PM,48,-122,15,4,19
36431,FremontBridge,11/28/2016 11:00:00 PM,48,-122,6,3,9
36432,FremontBridge,11/29/2016 12:00:00 AM,48,-122,4,3,7
36433,FremontBridge,11/29/2016 01:00:00 AM,48,-122,2,1,3
36434,FremontBridge,11/29/2016 02:00:00 AM,48,-122,0,0,0
36435,FremontBridge,11/29/2016 03:00:00 AM,48,-122,1,0,1
36436,FremontBridge,11/29/2016 04:00:00 AM,48,-122,2,5,7
36437,FremontBridge,11/29/2016 05:00:00 AM,48,-122,15,28,43
36438,FremontBridge,11/29/2016 06:00:00 AM,48,-122,49,71,120
36439,FremontBridge,11/29/2016 07:00:00 AM,48,-122,111,196,307
36440,FremontBridge,11/29/2016 08:00:00 AM,48,-122,192,270,462
36441,FremontBridge,11/29/2016 09:00:00 AM,48,-122,109,122,231
36442,FremontBridge,11/29/2016 10:00:00 AM,48,-122,48,68,116
36443,FremontBridge,11/29/2016 11:00:00 AM,48,-122,25,34,59
36444,FremontBridge,11/29/2016 12:00:00 PM,48,-122,25,24,49
36445,FremontBridge,11/29/2016 01:00:00 PM,48,-122,39,42,81
36446,FremontBridge,11/29/2016 02:00:00 PM,48,-122,41,37,78
36447,FremontBridge,11/29/2016 03:00:00 PM,48,-122,76,46,122
36448,FremontBridge,11/29/2016 04:00:00 PM,48,-122,176,82,258
36449,FremontBridge,11/29/2016 05:00:00 PM,48,-122,380,129,509
36450,FremontBridge,11/29/2016 06:00:00 PM,48,-122,210,97,307
36451,FremontBridge,11/29/2016 07:00:00 PM,48,-122,86,42,128
36452,FremontBridge,11/29/2016 08:00:00 PM,48,-122,40,22,62
36453,FremontBridge,11/29/2016 09:00:00 PM,48,-122,26,19,45
36454,FremontBridge,11/29/2016 10:00:00 PM,48,-122,11,15,26
36455,FremontBridge,11/29/2016 11:00:00 PM,48,-122,2,3,5
36456,FremontBridge,11/30/2016 12:00:00 AM,48,-122,0,3,3
36457,FremontBridge,11/30/2016 01:00:00 AM,48,-122,1,1,2
36458,FremontBridge,11/30/2016 02:00:00 AM,48,-122,1,2,3
36459,FremontBridge,11/30/2016 03:00:00 AM,48,-122,0,0,0
36460,FremontBridge,11/30/2016 04:00:00 AM,48,-122,2,6,8
36461,FremontBridge,11/30/2016 05:00:00 AM,48,-122,6,22,28
36462,FremontBridge,11/30/2016 06:00:00 AM,48,-122,40,68,108
36463,FremontBridge,11/30/2016 07:00:00 AM,48,-122,93,154,247
36464,FremontBridge,11/30/2016 08:00:00 AM,48,-122,144,221,365
36465,FremontBridge,11/30/2016 09:00:00 AM,48,-122,93,100,193
36466,FremontBridge,11/30/2016 10:00:00 AM,48,-122,47,29,76
36467,FremontBridge,11/30/2016 11:00:00 AM,48,-122,14,25,39
36468,FremontBridge,11/30/2016 12:00:00 PM,48,-122,26,19,45
36469,FremontBridge,11/30/2016 01:00:00 PM,48,-122,26,24,50
36470,FremontBridge,11/30/2016 02:00:00 PM,48,-122,25,31,56
36471,FremontBridge,11/30/2016 03:00:00 PM,48,-122,53,34,87
36472,FremontBridge,11/30/2016 04:00:00 PM,48,-122,142,56,198
36473,FremontBridge,11/30/2016 05:00:00 PM,48,-122,276,89,365
36474,FremontBridge,11/30/2016 06:00:00 PM,48,-122,174,80,254
36475,FremontBridge,11/30/2016 07:00:00 PM,48,-122,64,45,109
36476,FremontBridge,11/30/2016 08:00:00 PM,48,-122,46,30,76
36477,FremontBridge,11/30/2016 09:00:00 PM,48,-122,16,22,38
36478,FremontBridge,11/30/2016 10:00:00 PM,48,-122,16,12,28
36479,FremontBridge,11/30/2016 11:00:00 PM,48,-122,10,3,13
36480,FremontBridge,12/01/2016 12:00:00 AM,48,-122,4,7,11
36481,FremontBridge,12/01/2016 01:00:00 AM,48,-122,1,2,3
36482,FremontBridge,12/01/2016 02:00:00 AM,48,-122,2,0,2
36483,FremontBridge,12/01/2016 03:00:00 AM,48,-122,0,0,0
36484,FremontBridge,12/01/2016 04:00:00 AM,48,-122,4,1,5
36485,FremontBridge,12/01/2016 05:00:00 AM,48,-122,8,27,35
36486,FremontBridge,12/01/2016 06:00:00 AM,48,-122,49,70,119
36487,FremontBridge,12/01/2016 07:00:00 AM,48,-122,91,204,295
36488,FremontBridge,12/01/2016 08:00:00 AM,48,-122,171,243,414
36489,FremontBridge,12/01/2016 09:00:00 AM,48,-122,96,101,197
36490,FremontBridge,12/01/2016 10:00:00 AM,48,-122,45,53,98
36491,FremontBridge,12/01/2016 11:00:00 AM,48,-122,25,41,66
36492,FremontBridge,12/01/2016 12:00:00 PM,48,-122,25,28,53
36493,FremontBridge,12/01/2016 01:00:00 PM,48,-122,33,34,67
36494,FremontBridge,12/01/2016 02:00:00 PM,48,-122,33,23,56
36495,FremontBridge,12/01/2016 03:00:00 PM,48,-122,55,39,94
36496,FremontBridge,12/01/2016 04:00:00 PM,48,-122,151,76,227
36497,FremontBridge,12/01/2016 05:00:00 PM,48,-122,340,114,454
36498,FremontBridge,12/01/2016 06:00:00 PM,48,-122,219,87,306
36499,FremontBridge,12/01/2016 07:00:00 PM,48,-122,93,48,141
36500,FremontBridge,12/01/2016 08:00:00 PM,48,-122,50,24,74
36501,FremontBridge,12/01/2016 09:00:00 PM,48,-122,29,19,48
36502,FremontBridge,12/01/2016 10:00:00 PM,48,-122,23,10,33
36503,FremontBridge,12/01/2016 11:00:00 PM,48,-122,5,3,8
36504,FremontBridge,12/02/2016 12:00:00 AM,48,-122,7,0,7
36505,FremontBridge,12/02/2016 01:00:00 AM,48,-122,2,5,7
36506,FremontBridge,12/02/2016 02:00:00 AM,48,-122,0,0,0
36507,FremontBridge,12/02/2016 03:00:00 AM,48,-122,0,0,0
36508,FremontBridge,12/02/2016 04:00:00 AM,48,-122,2,6,8
36509,FremontBridge,12/02/2016 05:00:00 AM,48,-122,9,12,21
36510,FremontBridge,12/02/2016 06:00:00 AM,48,-122,25,40,65
36511,FremontBridge,12/02/2016 07:00:00 AM,48,-122,72,137,209
36512,FremontBridge,12/02/2016 08:00:00 AM,48,-122,87,153,240
36513,FremontBridge,12/02/2016 09:00:00 AM,48,-122,67,77,144
36514,FremontBridge,12/02/2016 10:00:00 AM,48,-122,28,31,59
36515,FremontBridge,12/02/2016 11:00:00 AM,48,-122,16,19,35
36516,FremontBridge,12/02/2016 12:00:00 PM,48,-122,22,23,45
36517,FremontBridge,12/02/2016 01:00:00 PM,48,-122,29,27,56
36518,FremontBridge,12/02/2016 02:00:00 PM,48,-122,18,19,37
36519,FremontBridge,12/02/2016 03:00:00 PM,48,-122,42,25,67
36520,FremontBridge,12/02/2016 04:00:00 PM,48,-122,101,38,139
36521,FremontBridge,12/02/2016 05:00:00 PM,48,-122,225,70,295
36522,FremontBridge,12/02/2016 06:00:00 PM,48,-122,113,40,153
36523,FremontBridge,12/02/2016 07:00:00 PM,48,-122,38,17,55
36524,FremontBridge,12/02/2016 08:00:00 PM,48,-122,16,13,29
36525,FremontBridge,12/02/2016 09:00:00 PM,48,-122,13,7,20
36526,FremontBridge,12/02/2016 10:00:00 PM,48,-122,19,11,30
36527,FremontBridge,12/02/2016 11:00:00 PM,48,-122,5,6,11
36528,FremontBridge,12/03/2016 12:00:00 AM,48,-122,3,6,9
36529,FremontBridge,12/03/2016 01:00:00 AM,48,-122,2,0,2
36530,FremontBridge,12/03/2016 02:00:00 AM,48,-122,1,1,2
36531,FremontBridge,12/03/2016 03:00:00 AM,48,-122,0,2,2
36532,FremontBridge,12/03/2016 04:00:00 AM,48,-122,3,0,3
36533,FremontBridge,12/03/2016 05:00:00 AM,48,-122,5,2,7
36534,FremontBridge,12/03/2016 06:00:00 AM,48,-122,8,9,17
36535,FremontBridge,12/03/2016 07:00:00 AM,48,-122,7,9,16
36536,FremontBridge,12/03/2016 08:00:00 AM,48,-122,25,33,58
36537,FremontBridge,12/03/2016 09:00:00 AM,48,-122,30,42,72
36538,FremontBridge,12/03/2016 10:00:00 AM,48,-122,30,28,58
36539,FremontBridge,12/03/2016 11:00:00 AM,48,-122,38,38,76
36540,FremontBridge,12/03/2016 12:00:00 PM,48,-122,32,59,91
36541,FremontBridge,12/03/2016 01:00:00 PM,48,-122,30,30,60
36542,FremontBridge,12/03/2016 02:00:00 PM,48,-122,32,44,76
36543,FremontBridge,12/03/2016 03:00:00 PM,48,-122,40,29,69
36544,FremontBridge,12/03/2016 04:00:00 PM,48,-122,25,49,74
36545,FremontBridge,12/03/2016 05:00:00 PM,48,-122,32,17,49
36546,FremontBridge,12/03/2016 06:00:00 PM,48,-122,19,11,30
36547,FremontBridge,12/03/2016 07:00:00 PM,48,-122,7,12,19
36548,FremontBridge,12/03/2016 08:00:00 PM,48,-122,9,8,17
36549,FremontBridge,12/03/2016 09:00:00 PM,48,-122,4,17,21
36550,FremontBridge,12/03/2016 10:00:00 PM,48,-122,7,2,9
36551,FremontBridge,12/03/2016 11:00:00 PM,48,-122,5,5,10
36552,FremontBridge,12/04/2016 12:00:00 AM,48,-122,6,6,12
36553,FremontBridge,12/04/2016 01:00:00 AM,48,-122,4,3,7
36554,FremontBridge,12/04/2016 02:00:00 AM,48,-122,2,0,2
36555,FremontBridge,12/04/2016 03:00:00 AM,48,-122,0,0,0
36556,FremontBridge,12/04/2016 04:00:00 AM,48,-122,1,2,3
36557,FremontBridge,12/04/2016 05:00:00 AM,48,-122,1,1,2
36558,FremontBridge,12/04/2016 06:00:00 AM,48,-122,2,1,3
36559,FremontBridge,12/04/2016 07:00:00 AM,48,-122,6,5,11
36560,FremontBridge,12/04/2016 08:00:00 AM,48,-122,9,11,20
36561,FremontBridge,12/04/2016 09:00:00 AM,48,-122,14,29,43
36562,FremontBridge,12/04/2016 10:00:00 AM,48,-122,27,21,48
36563,FremontBridge,12/04/2016 11:00:00 AM,48,-122,35,56,91
36564,FremontBridge,12/04/2016 12:00:00 PM,48,-122,41,63,104
36565,FremontBridge,12/04/2016 01:00:00 PM,48,-122,63,56,119
36566,FremontBridge,12/04/2016 02:00:00 PM,48,-122,48,59,107
36567,FremontBridge,12/04/2016 03:00:00 PM,48,-122,50,62,112
36568,FremontBridge,12/04/2016 04:00:00 PM,48,-122,38,38,76
36569,FremontBridge,12/04/2016 05:00:00 PM,48,-122,24,24,48
36570,FremontBridge,12/04/2016 06:00:00 PM,48,-122,18,24,42
36571,FremontBridge,12/04/2016 07:00:00 PM,48,-122,10,10,20
36572,FremontBridge,12/04/2016 08:00:00 PM,48,-122,8,5,13
36573,FremontBridge,12/04/2016 09:00:00 PM,48,-122,7,4,11
36574,FremontBridge,12/04/2016 10:00:00 PM,48,-122,7,3,10
36575,FremontBridge,12/04/2016 11:00:00 PM,48,-122,9,3,12
36576,FremontBridge,12/05/2016 12:00:00 AM,48,-122,1,1,2
36577,FremontBridge,12/05/2016 01:00:00 AM,48,-122,1,1,2
36578,FremontBridge,12/05/2016 02:00:00 AM,48,-122,0,0,0
36579,FremontBridge,12/05/2016 03:00:00 AM,48,-122,0,1,1
36580,FremontBridge,12/05/2016 04:00:00 AM,48,-122,3,4,7
36581,FremontBridge,12/05/2016 05:00:00 AM,48,-122,8,23,31
36582,FremontBridge,12/05/2016 06:00:00 AM,48,-122,31,46,77
36583,FremontBridge,12/05/2016 07:00:00 AM,48,-122,65,104,169
36584,FremontBridge,12/05/2016 08:00:00 AM,48,-122,82,138,220
36585,FremontBridge,12/05/2016 09:00:00 AM,48,-122,51,63,114
36586,FremontBridge,12/05/2016 10:00:00 AM,48,-122,21,20,41
36587,FremontBridge,12/05/2016 11:00:00 AM,48,-122,16,11,27
36588,FremontBridge,12/05/2016 12:00:00 PM,48,-122,11,11,22
36589,FremontBridge,12/05/2016 01:00:00 PM,48,-122,14,14,28
36590,FremontBridge,12/05/2016 02:00:00 PM,48,-122,20,15,35
36591,FremontBridge,12/05/2016 03:00:00 PM,48,-122,35,26,61
36592,FremontBridge,12/05/2016 04:00:00 PM,48,-122,76,34,110
36593,FremontBridge,12/05/2016 05:00:00 PM,48,-122,208,58,266
36594,FremontBridge,12/05/2016 06:00:00 PM,48,-122,124,39,163
36595,FremontBridge,12/05/2016 07:00:00 PM,48,-122,48,18,66
36596,FremontBridge,12/05/2016 08:00:00 PM,48,-122,19,19,38
36597,FremontBridge,12/05/2016 09:00:00 PM,48,-122,6,7,13
36598,FremontBridge,12/05/2016 10:00:00 PM,48,-122,8,4,12
36599,FremontBridge,12/05/2016 11:00:00 PM,48,-122,5,3,8
36600,FremontBridge,12/06/2016 12:00:00 AM,48,-122,3,3,6
36601,FremontBridge,12/06/2016 01:00:00 AM,48,-122,0,1,1
36602,FremontBridge,12/06/2016 02:00:00 AM,48,-122,1,0,1
36603,FremontBridge,12/06/2016 03:00:00 AM,48,-122,0,0,0
36604,FremontBridge,12/06/2016 04:00:00 AM,48,-122,1,3,4
36605,FremontBridge,12/06/2016 05:00:00 AM,48,-122,7,7,14
36606,FremontBridge,12/06/2016 06:00:00 AM,48,-122,27,39,66
36607,FremontBridge,12/06/2016 07:00:00 AM,48,-122,71,126,197
36608,FremontBridge,12/06/2016 08:00:00 AM,48,-122,125,149,274
36609,FremontBridge,12/06/2016 09:00:00 AM,48,-122,86,93,179
36610,FremontBridge,12/06/2016 10:00:00 AM,48,-122,26,32,58
36611,FremontBridge,12/06/2016 11:00:00 AM,48,-122,23,26,49
36612,FremontBridge,12/06/2016 12:00:00 PM,48,-122,20,28,48
36613,FremontBridge,12/06/2016 01:00:00 PM,48,-122,24,25,49
36614,FremontBridge,12/06/2016 02:00:00 PM,48,-122,25,23,48
36615,FremontBridge,12/06/2016 03:00:00 PM,48,-122,55,34,89
36616,FremontBridge,12/06/2016 04:00:00 PM,48,-122,124,57,181
36617,FremontBridge,12/06/2016 05:00:00 PM,48,-122,230,78,308
36618,FremontBridge,12/06/2016 06:00:00 PM,48,-122,150,67,217
36619,FremontBridge,12/06/2016 07:00:00 PM,48,-122,57,20,77
36620,FremontBridge,12/06/2016 08:00:00 PM,48,-122,32,17,49
36621,FremontBridge,12/06/2016 09:00:00 PM,48,-122,19,11,30
36622,FremontBridge,12/06/2016 10:00:00 PM,48,-122,10,6,16
36623,FremontBridge,12/06/2016 11:00:00 PM,48,-122,8,3,11
36624,FremontBridge,12/07/2016 12:00:00 AM,48,-122,3,3,6
36625,FremontBridge,12/07/2016 01:00:00 AM,48,-122,3,2,5
36626,FremontBridge,12/07/2016 02:00:00 AM,48,-122,0,0,0
36627,FremontBridge,12/07/2016 03:00:00 AM,48,-122,0,2,2
36628,FremontBridge,12/07/2016 04:00:00 AM,48,-122,1,4,5
36629,FremontBridge,12/07/2016 05:00:00 AM,48,-122,12,18,30
36630,FremontBridge,12/07/2016 06:00:00 AM,48,-122,32,41,73
36631,FremontBridge,12/07/2016 07:00:00 AM,48,-122,76,120,196
36632,FremontBridge,12/07/2016 08:00:00 AM,48,-122,114,164,278
36633,FremontBridge,12/07/2016 09:00:00 AM,48,-122,69,97,166
36634,FremontBridge,12/07/2016 10:00:00 AM,48,-122,40,36,76
36635,FremontBridge,12/07/2016 11:00:00 AM,48,-122,14,21,35
36636,FremontBridge,12/07/2016 12:00:00 PM,48,-122,21,25,46
36637,FremontBridge,12/07/2016 01:00:00 PM,48,-122,32,28,60
36638,FremontBridge,12/07/2016 02:00:00 PM,48,-122,28,19,47
36639,FremontBridge,12/07/2016 03:00:00 PM,48,-122,57,27,84
36640,FremontBridge,12/07/2016 04:00:00 PM,48,-122,102,55,157
36641,FremontBridge,12/07/2016 05:00:00 PM,48,-122,219,59,278
36642,FremontBridge,12/07/2016 06:00:00 PM,48,-122,136,64,200
36643,FremontBridge,12/07/2016 07:00:00 PM,48,-122,59,31,90
36644,FremontBridge,12/07/2016 08:00:00 PM,48,-122,36,12,48
36645,FremontBridge,12/07/2016 09:00:00 PM,48,-122,16,8,24
36646,FremontBridge,12/07/2016 10:00:00 PM,48,-122,17,10,27
36647,FremontBridge,12/07/2016 11:00:00 PM,48,-122,4,3,7
36648,FremontBridge,12/08/2016 12:00:00 AM,48,-122,2,3,5
36649,FremontBridge,12/08/2016 01:00:00 AM,48,-122,1,1,2
36650,FremontBridge,12/08/2016 02:00:00 AM,48,-122,0,1,1
36651,FremontBridge,12/08/2016 03:00:00 AM,48,-122,0,0,0
36652,FremontBridge,12/08/2016 04:00:00 AM,48,-122,1,6,7
36653,FremontBridge,12/08/2016 05:00:00 AM,48,-122,14,16,30
36654,FremontBridge,12/08/2016 06:00:00 AM,48,-122,18,35,53
36655,FremontBridge,12/08/2016 07:00:00 AM,48,-122,62,90,152
36656,FremontBridge,12/08/2016 08:00:00 AM,48,-122,102,130,232
36657,FremontBridge,12/08/2016 09:00:00 AM,48,-122,61,91,152
36658,FremontBridge,12/08/2016 10:00:00 AM,48,-122,27,26,53
36659,FremontBridge,12/08/2016 11:00:00 AM,48,-122,17,15,32
36660,FremontBridge,12/08/2016 12:00:00 PM,48,-122,20,14,34
36661,FremontBridge,12/08/2016 01:00:00 PM,48,-122,12,20,32
36662,FremontBridge,12/08/2016 02:00:00 PM,48,-122,19,23,42
36663,FremontBridge,12/08/2016 03:00:00 PM,48,-122,54,36,90
36664,FremontBridge,12/08/2016 04:00:00 PM,48,-122,111,49,160
36665,FremontBridge,12/08/2016 05:00:00 PM,48,-122,190,67,257
36666,FremontBridge,12/08/2016 06:00:00 PM,48,-122,87,39,126
36667,FremontBridge,12/08/2016 07:00:00 PM,48,-122,37,26,63
36668,FremontBridge,12/08/2016 08:00:00 PM,48,-122,19,15,34
36669,FremontBridge,12/08/2016 09:00:00 PM,48,-122,25,7,32
36670,FremontBridge,12/08/2016 10:00:00 PM,48,-122,5,6,11
36671,FremontBridge,12/08/2016 11:00:00 PM,48,-122,1,3,4
36672,FremontBridge,12/09/2016 12:00:00 AM,48,-122,1,0,1
36673,FremontBridge,12/09/2016 01:00:00 AM,48,-122,2,0,2
36674,FremontBridge,12/09/2016 02:00:00 AM,48,-122,0,1,1
36675,FremontBridge,12/09/2016 03:00:00 AM,48,-122,1,0,1
36676,FremontBridge,12/09/2016 04:00:00 AM,48,-122,5,0,5
36677,FremontBridge,12/09/2016 05:00:00 AM,48,-122,6,12,18
36678,FremontBridge,12/09/2016 06:00:00 AM,48,-122,7,6,13
36679,FremontBridge,12/09/2016 07:00:00 AM,48,-122,28,22,50
36680,FremontBridge,12/09/2016 08:00:00 AM,48,-122,27,28,55
36681,FremontBridge,12/09/2016 09:00:00 AM,48,-122,29,16,45
36682,FremontBridge,12/09/2016 10:00:00 AM,48,-122,18,18,36
36683,FremontBridge,12/09/2016 11:00:00 AM,48,-122,12,7,19
36684,FremontBridge,12/09/2016 12:00:00 PM,48,-122,10,4,14
36685,FremontBridge,12/09/2016 01:00:00 PM,48,-122,6,11,17
36686,FremontBridge,12/09/2016 02:00:00 PM,48,-122,12,9,21
36687,FremontBridge,12/09/2016 03:00:00 PM,48,-122,18,9,27
36688,FremontBridge,12/09/2016 04:00:00 PM,48,-122,31,15,46
36689,FremontBridge,12/09/2016 05:00:00 PM,48,-122,66,17,83
36690,FremontBridge,12/09/2016 06:00:00 PM,48,-122,30,15,45
36691,FremontBridge,12/09/2016 07:00:00 PM,48,-122,19,10,29
36692,FremontBridge,12/09/2016 08:00:00 PM,48,-122,12,3,15
36693,FremontBridge,12/09/2016 09:00:00 PM,48,-122,4,2,6
36694,FremontBridge,12/09/2016 10:00:00 PM,48,-122,9,3,12
36695,FremontBridge,12/09/2016 11:00:00 PM,48,-122,2,3,5
36696,FremontBridge,12/10/2016 12:00:00 AM,48,-122,1,2,3
36697,FremontBridge,12/10/2016 01:00:00 AM,48,-122,2,0,2
36698,FremontBridge,12/10/2016 02:00:00 AM,48,-122,1,1,2
36699,FremontBridge,12/10/2016 03:00:00 AM,48,-122,0,0,0
36700,FremontBridge,12/10/2016 04:00:00 AM,48,-122,0,1,1
36701,FremontBridge,12/10/2016 05:00:00 AM,48,-122,4,3,7
36702,FremontBridge,12/10/2016 06:00:00 AM,48,-122,5,2,7
36703,FremontBridge,12/10/2016 07:00:00 AM,48,-122,6,3,9
36704,FremontBridge,12/10/2016 08:00:00 AM,48,-122,18,19,37
36705,FremontBridge,12/10/2016 09:00:00 AM,48,-122,12,25,37
36706,FremontBridge,12/10/2016 10:00:00 AM,48,-122,16,28,44
36707,FremontBridge,12/10/2016 11:00:00 AM,48,-122,24,23,47
36708,FremontBridge,12/10/2016 12:00:00 PM,48,-122,12,11,23
36709,FremontBridge,12/10/2016 01:00:00 PM,48,-122,6,9,15
36710,FremontBridge,12/10/2016 02:00:00 PM,48,-122,14,9,23
36711,FremontBridge,12/10/2016 03:00:00 PM,48,-122,14,15,29
36712,FremontBridge,12/10/2016 04:00:00 PM,48,-122,14,10,24
36713,FremontBridge,12/10/2016 05:00:00 PM,48,-122,14,5,19
36714,FremontBridge,12/10/2016 06:00:00 PM,48,-122,17,14,31
36715,FremontBridge,12/10/2016 07:00:00 PM,48,-122,8,5,13
36716,FremontBridge,12/10/2016 08:00:00 PM,48,-122,9,8,17
36717,FremontBridge,12/10/2016 09:00:00 PM,48,-122,5,6,11
36718,FremontBridge,12/10/2016 10:00:00 PM,48,-122,5,3,8
36719,FremontBridge,12/10/2016 11:00:00 PM,48,-122,7,5,12
36720,FremontBridge,12/11/2016 12:00:00 AM,48,-122,4,5,9
36721,FremontBridge,12/11/2016 01:00:00 AM,48,-122,1,1,2
36722,FremontBridge,12/11/2016 02:00:00 AM,48,-122,0,1,1
36723,FremontBridge,12/11/2016 03:00:00 AM,48,-122,0,0,0
36724,FremontBridge,12/11/2016 04:00:00 AM,48,-122,1,1,2
36725,FremontBridge,12/11/2016 05:00:00 AM,48,-122,1,0,1
36726,FremontBridge,12/11/2016 06:00:00 AM,48,-122,4,3,7
36727,FremontBridge,12/11/2016 07:00:00 AM,48,-122,3,5,8
36728,FremontBridge,12/11/2016 08:00:00 AM,48,-122,10,10,20
36729,FremontBridge,12/11/2016 09:00:00 AM,48,-122,12,10,22
36730,FremontBridge,12/11/2016 10:00:00 AM,48,-122,14,25,39
36731,FremontBridge,12/11/2016 11:00:00 AM,48,-122,18,24,42
36732,FremontBridge,12/11/2016 12:00:00 PM,48,-122,16,23,39
36733,FremontBridge,12/11/2016 01:00:00 PM,48,-122,27,17,44
36734,FremontBridge,12/11/2016 02:00:00 PM,48,-122,27,19,46
36735,FremontBridge,12/11/2016 03:00:00 PM,48,-122,25,18,43
36736,FremontBridge,12/11/2016 04:00:00 PM,48,-122,20,19,39
36737,FremontBridge,12/11/2016 05:00:00 PM,48,-122,8,9,17
36738,FremontBridge,12/11/2016 06:00:00 PM,48,-122,8,18,26
36739,FremontBridge,12/11/2016 07:00:00 PM,48,-122,12,9,21
36740,FremontBridge,12/11/2016 08:00:00 PM,48,-122,6,4,10
36741,FremontBridge,12/11/2016 09:00:00 PM,48,-122,5,5,10
36742,FremontBridge,12/11/2016 10:00:00 PM,48,-122,4,1,5
36743,FremontBridge,12/11/2016 11:00:00 PM,48,-122,1,2,3
36744,FremontBridge,12/12/2016 12:00:00 AM,48,-122,2,3,5
36745,FremontBridge,12/12/2016 01:00:00 AM,48,-122,3,0,3
36746,FremontBridge,12/12/2016 02:00:00 AM,48,-122,0,2,2
36747,FremontBridge,12/12/2016 03:00:00 AM,48,-122,0,0,0
36748,FremontBridge,12/12/2016 04:00:00 AM,48,-122,4,5,9
36749,FremontBridge,12/12/2016 05:00:00 AM,48,-122,8,16,24
36750,FremontBridge,12/12/2016 06:00:00 AM,48,-122,31,53,84
36751,FremontBridge,12/12/2016 07:00:00 AM,48,-122,80,134,214
36752,FremontBridge,12/12/2016 08:00:00 AM,48,-122,121,172,293
36753,FremontBridge,12/12/2016 09:00:00 AM,48,-122,81,100,181
36754,FremontBridge,12/12/2016 10:00:00 AM,48,-122,36,21,57
36755,FremontBridge,12/12/2016 11:00:00 AM,48,-122,17,12,29
36756,FremontBridge,12/12/2016 12:00:00 PM,48,-122,17,16,33
36757,FremontBridge,12/12/2016 01:00:00 PM,48,-122,16,26,42
36758,FremontBridge,12/12/2016 02:00:00 PM,48,-122,13,13,26
36759,FremontBridge,12/12/2016 03:00:00 PM,48,-122,41,25,66
36760,FremontBridge,12/12/2016 04:00:00 PM,48,-122,116,50,166
36761,FremontBridge,12/12/2016 05:00:00 PM,48,-122,259,79,338
36762,FremontBridge,12/12/2016 06:00:00 PM,48,-122,166,61,227
36763,FremontBridge,12/12/2016 07:00:00 PM,48,-122,69,34,103
36764,FremontBridge,12/12/2016 08:00:00 PM,48,-122,39,14,53
36765,FremontBridge,12/12/2016 09:00:00 PM,48,-122,20,10,30
36766,FremontBridge,12/12/2016 10:00:00 PM,48,-122,6,4,10
36767,FremontBridge,12/12/2016 11:00:00 PM,48,-122,7,6,13
36768,FremontBridge,12/13/2016 12:00:00 AM,48,-122,4,2,6
36769,FremontBridge,12/13/2016 01:00:00 AM,48,-122,1,1,2
36770,FremontBridge,12/13/2016 02:00:00 AM,48,-122,0,0,0
36771,FremontBridge,12/13/2016 03:00:00 AM,48,-122,0,0,0
36772,FremontBridge,12/13/2016 04:00:00 AM,48,-122,3,3,6
36773,FremontBridge,12/13/2016 05:00:00 AM,48,-122,7,19,26
36774,FremontBridge,12/13/2016 06:00:00 AM,48,-122,38,51,89
36775,FremontBridge,12/13/2016 07:00:00 AM,48,-122,82,164,246
36776,FremontBridge,12/13/2016 08:00:00 AM,48,-122,143,201,344
36777,FremontBridge,12/13/2016 09:00:00 AM,48,-122,72,120,192
36778,FremontBridge,12/13/2016 10:00:00 AM,48,-122,44,35,79
36779,FremontBridge,12/13/2016 11:00:00 AM,48,-122,25,19,44
36780,FremontBridge,12/13/2016 12:00:00 PM,48,-122,31,24,55
36781,FremontBridge,12/13/2016 01:00:00 PM,48,-122,32,28,60
36782,FremontBridge,12/13/2016 02:00:00 PM,48,-122,24,25,49
36783,FremontBridge,12/13/2016 03:00:00 PM,48,-122,58,34,92
36784,FremontBridge,12/13/2016 04:00:00 PM,48,-122,130,51,181
36785,FremontBridge,12/13/2016 05:00:00 PM,48,-122,264,80,344
36786,FremontBridge,12/13/2016 06:00:00 PM,48,-122,176,66,242
36787,FremontBridge,12/13/2016 07:00:00 PM,48,-122,64,29,93
36788,FremontBridge,12/13/2016 08:00:00 PM,48,-122,34,18,52
36789,FremontBridge,12/13/2016 09:00:00 PM,48,-122,24,13,37
36790,FremontBridge,12/13/2016 10:00:00 PM,48,-122,16,7,23
36791,FremontBridge,12/13/2016 11:00:00 PM,48,-122,7,5,12
36792,FremontBridge,12/14/2016 12:00:00 AM,48,-122,7,4,11
36793,FremontBridge,12/14/2016 01:00:00 AM,48,-122,1,1,2
36794,FremontBridge,12/14/2016 02:00:00 AM,48,-122,0,0,0
36795,FremontBridge,12/14/2016 03:00:00 AM,48,-122,0,0,0
36796,FremontBridge,12/14/2016 04:00:00 AM,48,-122,2,2,4
36797,FremontBridge,12/14/2016 05:00:00 AM,48,-122,7,14,21
36798,FremontBridge,12/14/2016 06:00:00 AM,48,-122,39,44,83
36799,FremontBridge,12/14/2016 07:00:00 AM,48,-122,72,118,190
36800,FremontBridge,12/14/2016 08:00:00 AM,48,-122,121,174,295
36801,FremontBridge,12/14/2016 09:00:00 AM,48,-122,98,93,191
36802,FremontBridge,12/14/2016 10:00:00 AM,48,-122,41,38,79
36803,FremontBridge,12/14/2016 11:00:00 AM,48,-122,17,24,41
36804,FremontBridge,12/14/2016 12:00:00 PM,48,-122,27,23,50
36805,FremontBridge,12/14/2016 01:00:00 PM,48,-122,25,20,45
36806,FremontBridge,12/14/2016 02:00:00 PM,48,-122,32,26,58
36807,FremontBridge,12/14/2016 03:00:00 PM,48,-122,60,26,86
36808,FremontBridge,12/14/2016 04:00:00 PM,48,-122,95,50,145
36809,FremontBridge,12/14/2016 05:00:00 PM,48,-122,217,82,299
36810,FremontBridge,12/14/2016 06:00:00 PM,48,-122,160,46,206
36811,FremontBridge,12/14/2016 07:00:00 PM,48,-122,63,25,88
36812,FremontBridge,12/14/2016 08:00:00 PM,48,-122,32,18,50
36813,FremontBridge,12/14/2016 09:00:00 PM,48,-122,19,12,31
36814,FremontBridge,12/14/2016 10:00:00 PM,48,-122,18,4,22
36815,FremontBridge,12/14/2016 11:00:00 PM,48,-122,3,5,8
36816,FremontBridge,12/15/2016 12:00:00 AM,48,-122,2,2,4
36817,FremontBridge,12/15/2016 01:00:00 AM,48,-122,3,1,4
36818,FremontBridge,12/15/2016 02:00:00 AM,48,-122,1,0,1
36819,FremontBridge,12/15/2016 03:00:00 AM,48,-122,0,0,0
36820,FremontBridge,12/15/2016 04:00:00 AM,48,-122,2,1,3
36821,FremontBridge,12/15/2016 05:00:00 AM,48,-122,9,11,20
36822,FremontBridge,12/15/2016 06:00:00 AM,48,-122,31,32,63
36823,FremontBridge,12/15/2016 07:00:00 AM,48,-122,68,131,199
36824,FremontBridge,12/15/2016 08:00:00 AM,48,-122,105,147,252
36825,FremontBridge,12/15/2016 09:00:00 AM,48,-122,70,89,159
36826,FremontBridge,12/15/2016 10:00:00 AM,48,-122,37,32,69
36827,FremontBridge,12/15/2016 11:00:00 AM,48,-122,14,21,35
36828,FremontBridge,12/15/2016 12:00:00 PM,48,-122,22,17,39
36829,FremontBridge,12/15/2016 01:00:00 PM,48,-122,29,28,57
36830,FremontBridge,12/15/2016 02:00:00 PM,48,-122,21,19,40
36831,FremontBridge,12/15/2016 03:00:00 PM,48,-122,51,32,83
36832,FremontBridge,12/15/2016 04:00:00 PM,48,-122,126,51,177
36833,FremontBridge,12/15/2016 05:00:00 PM,48,-122,240,86,326
36834,FremontBridge,12/15/2016 06:00:00 PM,48,-122,114,59,173
36835,FremontBridge,12/15/2016 07:00:00 PM,48,-122,61,22,83
36836,FremontBridge,12/15/2016 08:00:00 PM,48,-122,27,9,36
36837,FremontBridge,12/15/2016 09:00:00 PM,48,-122,15,8,23
36838,FremontBridge,12/15/2016 10:00:00 PM,48,-122,13,9,22
36839,FremontBridge,12/15/2016 11:00:00 PM,48,-122,3,4,7
36840,FremontBridge,12/16/2016 12:00:00 AM,48,-122,4,0,4
36841,FremontBridge,12/16/2016 01:00:00 AM,48,-122,0,1,1
36842,FremontBridge,12/16/2016 02:00:00 AM,48,-122,0,0,0
36843,FremontBridge,12/16/2016 03:00:00 AM,48,-122,1,0,1
36844,FremontBridge,12/16/2016 04:00:00 AM,48,-122,1,0,1
36845,FremontBridge,12/16/2016 05:00:00 AM,48,-122,5,11,16
36846,FremontBridge,12/16/2016 06:00:00 AM,48,-122,16,31,47
36847,FremontBridge,12/16/2016 07:00:00 AM,48,-122,59,79,138
36848,FremontBridge,12/16/2016 08:00:00 AM,48,-122,73,132,205
36849,FremontBridge,12/16/2016 09:00:00 AM,48,-122,59,68,127
36850,FremontBridge,12/16/2016 10:00:00 AM,48,-122,33,30,63
36851,FremontBridge,12/16/2016 11:00:00 AM,48,-122,24,17,41
36852,FremontBridge,12/16/2016 12:00:00 PM,48,-122,18,20,38
36853,FremontBridge,12/16/2016 01:00:00 PM,48,-122,17,17,34
36854,FremontBridge,12/16/2016 02:00:00 PM,48,-122,29,15,44
36855,FremontBridge,12/16/2016 03:00:00 PM,48,-122,56,26,82
36856,FremontBridge,12/16/2016 04:00:00 PM,48,-122,121,42,163
36857,FremontBridge,12/16/2016 05:00:00 PM,48,-122,170,58,228
36858,FremontBridge,12/16/2016 06:00:00 PM,48,-122,90,44,134
36859,FremontBridge,12/16/2016 07:00:00 PM,48,-122,35,11,46
36860,FremontBridge,12/16/2016 08:00:00 PM,48,-122,24,7,31
36861,FremontBridge,12/16/2016 09:00:00 PM,48,-122,17,13,30
36862,FremontBridge,12/16/2016 10:00:00 PM,48,-122,15,3,18
36863,FremontBridge,12/16/2016 11:00:00 PM,48,-122,11,5,16
36864,FremontBridge,12/17/2016 12:00:00 AM,48,-122,5,4,9
36865,FremontBridge,12/17/2016 01:00:00 AM,48,-122,3,0,3
36866,FremontBridge,12/17/2016 02:00:00 AM,48,-122,2,1,3
36867,FremontBridge,12/17/2016 03:00:00 AM,48,-122,3,0,3
36868,FremontBridge,12/17/2016 04:00:00 AM,48,-122,0,0,0
36869,FremontBridge,12/17/2016 05:00:00 AM,48,-122,3,2,5
36870,FremontBridge,12/17/2016 06:00:00 AM,48,-122,4,7,11
36871,FremontBridge,12/17/2016 07:00:00 AM,48,-122,6,2,8
36872,FremontBridge,12/17/2016 08:00:00 AM,48,-122,8,10,18
36873,FremontBridge,12/17/2016 09:00:00 AM,48,-122,11,14,25
36874,FremontBridge,12/17/2016 10:00:00 AM,48,-122,13,18,31
36875,FremontBridge,12/17/2016 11:00:00 AM,48,-122,19,21,40
36876,FremontBridge,12/17/2016 12:00:00 PM,48,-122,17,17,34
36877,FremontBridge,12/17/2016 01:00:00 PM,48,-122,22,25,47
36878,FremontBridge,12/17/2016 02:00:00 PM,48,-122,27,20,47
36879,FremontBridge,12/17/2016 03:00:00 PM,48,-122,35,22,57
36880,FremontBridge,12/17/2016 04:00:00 PM,48,-122,27,19,46
36881,FremontBridge,12/17/2016 05:00:00 PM,48,-122,21,15,36
36882,FremontBridge,12/17/2016 06:00:00 PM,48,-122,14,18,32
36883,FremontBridge,12/17/2016 07:00:00 PM,48,-122,10,2,12
36884,FremontBridge,12/17/2016 08:00:00 PM,48,-122,5,3,8
36885,FremontBridge,12/17/2016 09:00:00 PM,48,-122,6,3,9
36886,FremontBridge,12/17/2016 10:00:00 PM,48,-122,10,4,14
36887,FremontBridge,12/17/2016 11:00:00 PM,48,-122,11,9,20
36888,FremontBridge,12/18/2016 12:00:00 AM,48,-122,8,2,10
36889,FremontBridge,12/18/2016 01:00:00 AM,48,-122,4,4,8
36890,FremontBridge,12/18/2016 02:00:00 AM,48,-122,1,2,3
36891,FremontBridge,12/18/2016 03:00:00 AM,48,-122,0,0,0
36892,FremontBridge,12/18/2016 04:00:00 AM,48,-122,0,1,1
36893,FremontBridge,12/18/2016 05:00:00 AM,48,-122,1,0,1
36894,FremontBridge,12/18/2016 06:00:00 AM,48,-122,2,2,4
36895,FremontBridge,12/18/2016 07:00:00 AM,48,-122,1,3,4
36896,FremontBridge,12/18/2016 08:00:00 AM,48,-122,6,9,15
36897,FremontBridge,12/18/2016 09:00:00 AM,48,-122,9,8,17
36898,FremontBridge,12/18/2016 10:00:00 AM,48,-122,12,14,26
36899,FremontBridge,12/18/2016 11:00:00 AM,48,-122,22,26,48
36900,FremontBridge,12/18/2016 12:00:00 PM,48,-122,22,27,49
36901,FremontBridge,12/18/2016 01:00:00 PM,48,-122,23,27,50
36902,FremontBridge,12/18/2016 02:00:00 PM,48,-122,26,25,51
36903,FremontBridge,12/18/2016 03:00:00 PM,48,-122,26,17,43
36904,FremontBridge,12/18/2016 04:00:00 PM,48,-122,17,16,33
36905,FremontBridge,12/18/2016 05:00:00 PM,48,-122,11,11,22
36906,FremontBridge,12/18/2016 06:00:00 PM,48,-122,7,13,20
36907,FremontBridge,12/18/2016 07:00:00 PM,48,-122,9,3,12
36908,FremontBridge,12/18/2016 08:00:00 PM,48,-122,2,4,6
36909,FremontBridge,12/18/2016 09:00:00 PM,48,-122,6,14,20
36910,FremontBridge,12/18/2016 10:00:00 PM,48,-122,2,3,5
36911,FremontBridge,12/18/2016 11:00:00 PM,48,-122,8,0,8
36912,FremontBridge,12/19/2016 12:00:00 AM,48,-122,1,1,2
36913,FremontBridge,12/19/2016 01:00:00 AM,48,-122,5,1,6
36914,FremontBridge,12/19/2016 02:00:00 AM,48,-122,0,1,1
36915,FremontBridge,12/19/2016 03:00:00 AM,48,-122,0,0,0
36916,FremontBridge,12/19/2016 04:00:00 AM,48,-122,1,2,3
36917,FremontBridge,12/19/2016 05:00:00 AM,48,-122,7,11,18
36918,FremontBridge,12/19/2016 06:00:00 AM,48,-122,18,38,56
36919,FremontBridge,12/19/2016 07:00:00 AM,48,-122,55,85,140
36920,FremontBridge,12/19/2016 08:00:00 AM,48,-122,73,121,194
36921,FremontBridge,12/19/2016 09:00:00 AM,48,-122,60,70,130
36922,FremontBridge,12/19/2016 10:00:00 AM,48,-122,24,30,54
36923,FremontBridge,12/19/2016 11:00:00 AM,48,-122,15,16,31
36924,FremontBridge,12/19/2016 12:00:00 PM,48,-122,11,7,18
36925,FremontBridge,12/19/2016 01:00:00 PM,48,-122,14,11,25
36926,FremontBridge,12/19/2016 02:00:00 PM,48,-122,18,16,34
36927,FremontBridge,12/19/2016 03:00:00 PM,48,-122,38,24,62
36928,FremontBridge,12/19/2016 04:00:00 PM,48,-122,92,47,139
36929,FremontBridge,12/19/2016 05:00:00 PM,48,-122,178,51,229
36930,FremontBridge,12/19/2016 06:00:00 PM,48,-122,123,49,172
36931,FremontBridge,12/19/2016 07:00:00 PM,48,-122,43,12,55
36932,FremontBridge,12/19/2016 08:00:00 PM,48,-122,21,11,32
36933,FremontBridge,12/19/2016 09:00:00 PM,48,-122,9,4,13
36934,FremontBridge,12/19/2016 10:00:00 PM,48,-122,4,2,6
36935,FremontBridge,12/19/2016 11:00:00 PM,48,-122,5,2,7
36936,FremontBridge,12/20/2016 12:00:00 AM,48,-122,2,1,3
36937,FremontBridge,12/20/2016 01:00:00 AM,48,-122,1,0,1
36938,FremontBridge,12/20/2016 02:00:00 AM,48,-122,0,0,0
36939,FremontBridge,12/20/2016 03:00:00 AM,48,-122,1,0,1
36940,FremontBridge,12/20/2016 04:00:00 AM,48,-122,3,2,5
36941,FremontBridge,12/20/2016 05:00:00 AM,48,-122,9,9,18
36942,FremontBridge,12/20/2016 06:00:00 AM,48,-122,23,39,62
36943,FremontBridge,12/20/2016 07:00:00 AM,48,-122,71,105,176
36944,FremontBridge,12/20/2016 08:00:00 AM,48,-122,96,133,229
36945,FremontBridge,12/20/2016 09:00:00 AM,48,-122,78,82,160
36946,FremontBridge,12/20/2016 10:00:00 AM,48,-122,34,44,78
36947,FremontBridge,12/20/2016 11:00:00 AM,48,-122,22,28,50
36948,FremontBridge,12/20/2016 12:00:00 PM,48,-122,23,23,46
36949,FremontBridge,12/20/2016 01:00:00 PM,48,-122,29,30,59
36950,FremontBridge,12/20/2016 02:00:00 PM,48,-122,28,33,61
36951,FremontBridge,12/20/2016 03:00:00 PM,48,-122,51,33,84
36952,FremontBridge,12/20/2016 04:00:00 PM,48,-122,125,49,174
36953,FremontBridge,12/20/2016 05:00:00 PM,48,-122,202,70,272
36954,FremontBridge,12/20/2016 06:00:00 PM,48,-122,142,52,194
36955,FremontBridge,12/20/2016 07:00:00 PM,48,-122,62,18,80
36956,FremontBridge,12/20/2016 08:00:00 PM,48,-122,21,12,33
36957,FremontBridge,12/20/2016 09:00:00 PM,48,-122,13,11,24
36958,FremontBridge,12/20/2016 10:00:00 PM,48,-122,6,7,13
36959,FremontBridge,12/20/2016 11:00:00 PM,48,-122,5,2,7
36960,FremontBridge,12/21/2016 12:00:00 AM,48,-122,3,3,6
36961,FremontBridge,12/21/2016 01:00:00 AM,48,-122,1,0,1
36962,FremontBridge,12/21/2016 02:00:00 AM,48,-122,0,0,0
36963,FremontBridge,12/21/2016 03:00:00 AM,48,-122,0,0,0
36964,FremontBridge,12/21/2016 04:00:00 AM,48,-122,1,2,3
36965,FremontBridge,12/21/2016 05:00:00 AM,48,-122,13,18,31
36966,FremontBridge,12/21/2016 06:00:00 AM,48,-122,33,40,73
36967,FremontBridge,12/21/2016 07:00:00 AM,48,-122,74,125,199
36968,FremontBridge,12/21/2016 08:00:00 AM,48,-122,104,154,258
36969,FremontBridge,12/21/2016 09:00:00 AM,48,-122,62,74,136
36970,FremontBridge,12/21/2016 10:00:00 AM,48,-122,39,35,74
36971,FremontBridge,12/21/2016 11:00:00 AM,48,-122,20,28,48
36972,FremontBridge,12/21/2016 12:00:00 PM,48,-122,21,35,56
36973,FremontBridge,12/21/2016 01:00:00 PM,48,-122,30,37,67
36974,FremontBridge,12/21/2016 02:00:00 PM,48,-122,37,32,69
36975,FremontBridge,12/21/2016 03:00:00 PM,48,-122,55,47,102
36976,FremontBridge,12/21/2016 04:00:00 PM,48,-122,121,50,171
36977,FremontBridge,12/21/2016 05:00:00 PM,48,-122,243,72,315
36978,FremontBridge,12/21/2016 06:00:00 PM,48,-122,136,60,196
36979,FremontBridge,12/21/2016 07:00:00 PM,48,-122,48,35,83
36980,FremontBridge,12/21/2016 08:00:00 PM,48,-122,33,11,44
36981,FremontBridge,12/21/2016 09:00:00 PM,48,-122,12,15,27
36982,FremontBridge,12/21/2016 10:00:00 PM,48,-122,12,10,22
36983,FremontBridge,12/21/2016 11:00:00 PM,48,-122,13,4,17
36984,FremontBridge,12/22/2016 12:00:00 AM,48,-122,5,4,9
36985,FremontBridge,12/22/2016 01:00:00 AM,48,-122,0,2,2
36986,FremontBridge,12/22/2016 02:00:00 AM,48,-122,1,0,1
36987,FremontBridge,12/22/2016 03:00:00 AM,48,-122,0,0,0
36988,FremontBridge,12/22/2016 04:00:00 AM,48,-122,3,1,4
36989,FremontBridge,12/22/2016 05:00:00 AM,48,-122,9,15,24
36990,FremontBridge,12/22/2016 06:00:00 AM,48,-122,25,42,67
36991,FremontBridge,12/22/2016 07:00:00 AM,48,-122,51,78,129
36992,FremontBridge,12/22/2016 08:00:00 AM,48,-122,86,113,199
36993,FremontBridge,12/22/2016 09:00:00 AM,48,-122,52,64,116
36994,FremontBridge,12/22/2016 10:00:00 AM,48,-122,29,40,69
36995,FremontBridge,12/22/2016 11:00:00 AM,48,-122,8,10,18
36996,FremontBridge,12/22/2016 12:00:00 PM,48,-122,15,15,30
36997,FremontBridge,12/22/2016 01:00:00 PM,48,-122,15,22,37
36998,FremontBridge,12/22/2016 02:00:00 PM,48,-122,27,11,38
36999,FremontBridge,12/22/2016 03:00:00 PM,48,-122,45,30,75
37000,FremontBridge,12/22/2016 04:00:00 PM,48,-122,98,46,144
37001,FremontBridge,12/22/2016 05:00:00 PM,48,-122,154,47,201
37002,FremontBridge,12/22/2016 06:00:00 PM,48,-122,86,43,129
37003,FremontBridge,12/22/2016 07:00:00 PM,48,-122,31,13,44
37004,FremontBridge,12/22/2016 08:00:00 PM,48,-122,20,7,27
37005,FremontBridge,12/22/2016 09:00:00 PM,48,-122,7,12,19
37006,FremontBridge,12/22/2016 10:00:00 PM,48,-122,11,8,19
37007,FremontBridge,12/22/2016 11:00:00 PM,48,-122,4,3,7
37008,FremontBridge,12/23/2016 12:00:00 AM,48,-122,4,2,6
37009,FremontBridge,12/23/2016 01:00:00 AM,48,-122,0,0,0
37010,FremontBridge,12/23/2016 02:00:00 AM,48,-122,0,1,1
37011,FremontBridge,12/23/2016 03:00:00 AM,48,-122,0,1,1
37012,FremontBridge,12/23/2016 04:00:00 AM,48,-122,1,1,2
37013,FremontBridge,12/23/2016 05:00:00 AM,48,-122,6,9,15
37014,FremontBridge,12/23/2016 06:00:00 AM,48,-122,10,16,26
37015,FremontBridge,12/23/2016 07:00:00 AM,48,-122,13,32,45
37016,FremontBridge,12/23/2016 08:00:00 AM,48,-122,32,31,63
37017,FremontBridge,12/23/2016 09:00:00 AM,48,-122,21,24,45
37018,FremontBridge,12/23/2016 10:00:00 AM,48,-122,15,9,24
37019,FremontBridge,12/23/2016 11:00:00 AM,48,-122,10,9,19
37020,FremontBridge,12/23/2016 12:00:00 PM,48,-122,11,8,19
37021,FremontBridge,12/23/2016 01:00:00 PM,48,-122,10,14,24
37022,FremontBridge,12/23/2016 02:00:00 PM,48,-122,12,13,25
37023,FremontBridge,12/23/2016 03:00:00 PM,48,-122,28,14,42
37024,FremontBridge,12/23/2016 04:00:00 PM,48,-122,37,13,50
37025,FremontBridge,12/23/2016 05:00:00 PM,48,-122,31,20,51
37026,FremontBridge,12/23/2016 06:00:00 PM,48,-122,29,15,44
37027,FremontBridge,12/23/2016 07:00:00 PM,48,-122,6,7,13
37028,FremontBridge,12/23/2016 08:00:00 PM,48,-122,9,4,13
37029,FremontBridge,12/23/2016 09:00:00 PM,48,-122,8,4,12
37030,FremontBridge,12/23/2016 10:00:00 PM,48,-122,3,4,7
37031,FremontBridge,12/23/2016 11:00:00 PM,48,-122,6,2,8
37032,FremontBridge,12/24/2016 12:00:00 AM,48,-122,0,2,2
37033,FremontBridge,12/24/2016 01:00:00 AM,48,-122,1,3,4
37034,FremontBridge,12/24/2016 02:00:00 AM,48,-122,0,0,0
37035,FremontBridge,12/24/2016 03:00:00 AM,48,-122,0,0,0
37036,FremontBridge,12/24/2016 04:00:00 AM,48,-122,1,0,1
37037,FremontBridge,12/24/2016 05:00:00 AM,48,-122,3,5,8
37038,FremontBridge,12/24/2016 06:00:00 AM,48,-122,4,6,10
37039,FremontBridge,12/24/2016 07:00:00 AM,48,-122,3,4,7
37040,FremontBridge,12/24/2016 08:00:00 AM,48,-122,14,18,32
37041,FremontBridge,12/24/2016 09:00:00 AM,48,-122,16,9,25
37042,FremontBridge,12/24/2016 10:00:00 AM,48,-122,8,13,21
37043,FremontBridge,12/24/2016 11:00:00 AM,48,-122,16,21,37
37044,FremontBridge,12/24/2016 12:00:00 PM,48,-122,18,26,44
37045,FremontBridge,12/24/2016 01:00:00 PM,48,-122,19,23,42
37046,FremontBridge,12/24/2016 02:00:00 PM,48,-122,14,19,33
37047,FremontBridge,12/24/2016 03:00:00 PM,48,-122,25,23,48
37048,FremontBridge,12/24/2016 04:00:00 PM,48,-122,12,8,20
37049,FremontBridge,12/24/2016 05:00:00 PM,48,-122,10,9,19
37050,FremontBridge,12/24/2016 06:00:00 PM,48,-122,9,1,10
37051,FremontBridge,12/24/2016 07:00:00 PM,48,-122,3,3,6
37052,FremontBridge,12/24/2016 08:00:00 PM,48,-122,3,5,8
37053,FremontBridge,12/24/2016 09:00:00 PM,48,-122,1,3,4
37054,FremontBridge,12/24/2016 10:00:00 PM,48,-122,0,1,1
37055,FremontBridge,12/24/2016 11:00:00 PM,48,-122,3,0,3
37056,FremontBridge,12/25/2016 12:00:00 AM,48,-122,2,2,4
37057,FremontBridge,12/25/2016 01:00:00 AM,48,-122,0,0,0
37058,FremontBridge,12/25/2016 02:00:00 AM,48,-122,1,0,1
37059,FremontBridge,12/25/2016 03:00:00 AM,48,-122,0,1,1
37060,FremontBridge,12/25/2016 04:00:00 AM,48,-122,0,0,0
37061,FremontBridge,12/25/2016 05:00:00 AM,48,-122,0,2,2
37062,FremontBridge,12/25/2016 06:00:00 AM,48,-122,1,1,2
37063,FremontBridge,12/25/2016 07:00:00 AM,48,-122,3,2,5
37064,FremontBridge,12/25/2016 08:00:00 AM,48,-122,1,2,3
37065,FremontBridge,12/25/2016 09:00:00 AM,48,-122,7,12,19
37066,FremontBridge,12/25/2016 10:00:00 AM,48,-122,9,12,21
37067,FremontBridge,12/25/2016 11:00:00 AM,48,-122,6,18,24
37068,FremontBridge,12/25/2016 12:00:00 PM,48,-122,12,13,25
37069,FremontBridge,12/25/2016 01:00:00 PM,48,-122,11,12,23
37070,FremontBridge,12/25/2016 02:00:00 PM,48,-122,19,19,38
37071,FremontBridge,12/25/2016 03:00:00 PM,48,-122,15,8,23
37072,FremontBridge,12/25/2016 04:00:00 PM,48,-122,11,6,17
37073,FremontBridge,12/25/2016 05:00:00 PM,48,-122,5,10,15
37074,FremontBridge,12/25/2016 06:00:00 PM,48,-122,8,3,11
37075,FremontBridge,12/25/2016 07:00:00 PM,48,-122,5,3,8
37076,FremontBridge,12/25/2016 08:00:00 PM,48,-122,5,2,7
37077,FremontBridge,12/25/2016 09:00:00 PM,48,-122,1,3,4
37078,FremontBridge,12/25/2016 10:00:00 PM,48,-122,1,1,2
37079,FremontBridge,12/25/2016 11:00:00 PM,48,-122,2,3,5
37080,FremontBridge,12/26/2016 12:00:00 AM,48,-122,2,2,4
37081,FremontBridge,12/26/2016 01:00:00 AM,48,-122,0,1,1
37082,FremontBridge,12/26/2016 02:00:00 AM,48,-122,2,2,4
37083,FremontBridge,12/26/2016 03:00:00 AM,48,-122,0,0,0
37084,FremontBridge,12/26/2016 04:00:00 AM,48,-122,1,3,4
37085,FremontBridge,12/26/2016 05:00:00 AM,48,-122,1,4,5
37086,FremontBridge,12/26/2016 06:00:00 AM,48,-122,4,6,10
37087,FremontBridge,12/26/2016 07:00:00 AM,48,-122,9,15,24
37088,FremontBridge,12/26/2016 08:00:00 AM,48,-122,3,8,11
37089,FremontBridge,12/26/2016 09:00:00 AM,48,-122,11,16,27
37090,FremontBridge,12/26/2016 10:00:00 AM,48,-122,10,10,20
37091,FremontBridge,12/26/2016 11:00:00 AM,48,-122,18,25,43
37092,FremontBridge,12/26/2016 12:00:00 PM,48,-122,21,17,38
37093,FremontBridge,12/26/2016 01:00:00 PM,48,-122,21,23,44
37094,FremontBridge,12/26/2016 02:00:00 PM,48,-122,17,24,41
37095,FremontBridge,12/26/2016 03:00:00 PM,48,-122,14,13,27
37096,FremontBridge,12/26/2016 04:00:00 PM,48,-122,12,6,18
37097,FremontBridge,12/26/2016 05:00:00 PM,48,-122,8,8,16
37098,FremontBridge,12/26/2016 06:00:00 PM,48,-122,12,9,21
37099,FremontBridge,12/26/2016 07:00:00 PM,48,-122,2,1,3
37100,FremontBridge,12/26/2016 08:00:00 PM,48,-122,6,3,9
37101,FremontBridge,12/26/2016 09:00:00 PM,48,-122,3,2,5
37102,FremontBridge,12/26/2016 10:00:00 PM,48,-122,2,2,4
37103,FremontBridge,12/26/2016 11:00:00 PM,48,-122,3,1,4
37104,FremontBridge,12/27/2016 12:00:00 AM,48,-122,1,3,4
37105,FremontBridge,12/27/2016 01:00:00 AM,48,-122,1,0,1
37106,FremontBridge,12/27/2016 02:00:00 AM,48,-122,0,0,0
37107,FremontBridge,12/27/2016 03:00:00 AM,48,-122,0,0,0
37108,FremontBridge,12/27/2016 04:00:00 AM,48,-122,3,3,6
37109,FremontBridge,12/27/2016 05:00:00 AM,48,-122,5,6,11
37110,FremontBridge,12/27/2016 06:00:00 AM,48,-122,26,29,55
37111,FremontBridge,12/27/2016 07:00:00 AM,48,-122,36,59,95
37112,FremontBridge,12/27/2016 08:00:00 AM,48,-122,54,55,109
37113,FremontBridge,12/27/2016 09:00:00 AM,48,-122,34,56,90
37114,FremontBridge,12/27/2016 10:00:00 AM,48,-122,28,28,56
37115,FremontBridge,12/27/2016 11:00:00 AM,48,-122,12,15,27
37116,FremontBridge,12/27/2016 12:00:00 PM,48,-122,24,18,42
37117,FremontBridge,12/27/2016 01:00:00 PM,48,-122,23,21,44
37118,FremontBridge,12/27/2016 02:00:00 PM,48,-122,21,20,41
37119,FremontBridge,12/27/2016 03:00:00 PM,48,-122,41,30,71
37120,FremontBridge,12/27/2016 04:00:00 PM,48,-122,76,31,107
37121,FremontBridge,12/27/2016 05:00:00 PM,48,-122,106,46,152
37122,FremontBridge,12/27/2016 06:00:00 PM,48,-122,59,40,99
37123,FremontBridge,12/27/2016 07:00:00 PM,48,-122,30,11,41
37124,FremontBridge,12/27/2016 08:00:00 PM,48,-122,12,9,21
37125,FremontBridge,12/27/2016 09:00:00 PM,48,-122,7,7,14
37126,FremontBridge,12/27/2016 10:00:00 PM,48,-122,4,3,7
37127,FremontBridge,12/27/2016 11:00:00 PM,48,-122,5,7,12
37128,FremontBridge,12/28/2016 12:00:00 AM,48,-122,1,1,2
37129,FremontBridge,12/28/2016 01:00:00 AM,48,-122,1,0,1
37130,FremontBridge,12/28/2016 02:00:00 AM,48,-122,0,0,0
37131,FremontBridge,12/28/2016 03:00:00 AM,48,-122,0,0,0
37132,FremontBridge,12/28/2016 04:00:00 AM,48,-122,5,2,7
37133,FremontBridge,12/28/2016 05:00:00 AM,48,-122,7,13,20
37134,FremontBridge,12/28/2016 06:00:00 AM,48,-122,27,28,55
37135,FremontBridge,12/28/2016 07:00:00 AM,48,-122,35,73,108
37136,FremontBridge,12/28/2016 08:00:00 AM,48,-122,70,92,162
37137,FremontBridge,12/28/2016 09:00:00 AM,48,-122,60,55,115
37138,FremontBridge,12/28/2016 10:00:00 AM,48,-122,32,24,56
37139,FremontBridge,12/28/2016 11:00:00 AM,48,-122,26,31,57
37140,FremontBridge,12/28/2016 12:00:00 PM,48,-122,30,40,70
37141,FremontBridge,12/28/2016 01:00:00 PM,48,-122,38,27,65
37142,FremontBridge,12/28/2016 02:00:00 PM,48,-122,43,29,72
37143,FremontBridge,12/28/2016 03:00:00 PM,48,-122,49,51,100
37144,FremontBridge,12/28/2016 04:00:00 PM,48,-122,79,47,126
37145,FremontBridge,12/28/2016 05:00:00 PM,48,-122,155,48,203
37146,FremontBridge,12/28/2016 06:00:00 PM,48,-122,87,35,122
37147,FremontBridge,12/28/2016 07:00:00 PM,48,-122,39,11,50
37148,FremontBridge,12/28/2016 08:00:00 PM,48,-122,16,11,27
37149,FremontBridge,12/28/2016 09:00:00 PM,48,-122,13,11,24
37150,FremontBridge,12/28/2016 10:00:00 PM,48,-122,11,10,21
37151,FremontBridge,12/28/2016 11:00:00 PM,48,-122,4,5,9
37152,FremontBridge,12/29/2016 12:00:00 AM,48,-122,3,6,9
37153,FremontBridge,12/29/2016 01:00:00 AM,48,-122,0,1,1
37154,FremontBridge,12/29/2016 02:00:00 AM,48,-122,0,0,0
37155,FremontBridge,12/29/2016 03:00:00 AM,48,-122,0,0,0
37156,FremontBridge,12/29/2016 04:00:00 AM,48,-122,0,3,3
37157,FremontBridge,12/29/2016 05:00:00 AM,48,-122,9,7,16
37158,FremontBridge,12/29/2016 06:00:00 AM,48,-122,16,24,40
37159,FremontBridge,12/29/2016 07:00:00 AM,48,-122,35,73,108
37160,FremontBridge,12/29/2016 08:00:00 AM,48,-122,63,86,149
37161,FremontBridge,12/29/2016 09:00:00 AM,48,-122,43,65,108
37162,FremontBridge,12/29/2016 10:00:00 AM,48,-122,28,27,55
37163,FremontBridge,12/29/2016 11:00:00 AM,48,-122,27,19,46
37164,FremontBridge,12/29/2016 12:00:00 PM,48,-122,12,13,25
37165,FremontBridge,12/29/2016 01:00:00 PM,48,-122,11,21,32
37166,FremontBridge,12/29/2016 02:00:00 PM,48,-122,25,18,43
37167,FremontBridge,12/29/2016 03:00:00 PM,48,-122,49,22,71
37168,FremontBridge,12/29/2016 04:00:00 PM,48,-122,70,36,106
37169,FremontBridge,12/29/2016 05:00:00 PM,48,-122,121,27,148
37170,FremontBridge,12/29/2016 06:00:00 PM,48,-122,59,28,87
37171,FremontBridge,12/29/2016 07:00:00 PM,48,-122,23,16,39
37172,FremontBridge,12/29/2016 08:00:00 PM,48,-122,12,7,19
37173,FremontBridge,12/29/2016 09:00:00 PM,48,-122,8,5,13
37174,FremontBridge,12/29/2016 10:00:00 PM,48,-122,7,4,11
37175,FremontBridge,12/29/2016 11:00:00 PM,48,-122,2,3,5
37176,FremontBridge,12/30/2016 12:00:00 AM,48,-122,4,1,5
37177,FremontBridge,12/30/2016 01:00:00 AM,48,-122,0,3,3
37178,FremontBridge,12/30/2016 02:00:00 AM,48,-122,0,0,0
37179,FremontBridge,12/30/2016 03:00:00 AM,48,-122,0,1,1
37180,FremontBridge,12/30/2016 04:00:00 AM,48,-122,3,0,3
37181,FremontBridge,12/30/2016 05:00:00 AM,48,-122,5,6,11
37182,FremontBridge,12/30/2016 06:00:00 AM,48,-122,16,15,31
37183,FremontBridge,12/30/2016 07:00:00 AM,48,-122,20,38,58
37184,FremontBridge,12/30/2016 08:00:00 AM,48,-122,51,56,107
37185,FremontBridge,12/30/2016 09:00:00 AM,48,-122,37,38,75
37186,FremontBridge,12/30/2016 10:00:00 AM,48,-122,37,30,67
37187,FremontBridge,12/30/2016 11:00:00 AM,48,-122,29,24,53
37188,FremontBridge,12/30/2016 12:00:00 PM,48,-122,26,33,59
37189,FremontBridge,12/30/2016 01:00:00 PM,48,-122,34,46,80
37190,FremontBridge,12/30/2016 02:00:00 PM,48,-122,44,30,74
37191,FremontBridge,12/30/2016 03:00:00 PM,48,-122,56,34,90
37192,FremontBridge,12/30/2016 04:00:00 PM,48,-122,81,50,131
37193,FremontBridge,12/30/2016 05:00:00 PM,48,-122,71,39,110
37194,FremontBridge,12/30/2016 06:00:00 PM,48,-122,38,20,58
37195,FremontBridge,12/30/2016 07:00:00 PM,48,-122,16,8,24
37196,FremontBridge,12/30/2016 08:00:00 PM,48,-122,9,7,16
37197,FremontBridge,12/30/2016 09:00:00 PM,48,-122,4,4,8
37198,FremontBridge,12/30/2016 10:00:00 PM,48,-122,7,6,13
37199,FremontBridge,12/30/2016 11:00:00 PM,48,-122,7,7,14
37200,FremontBridge,12/31/2016 12:00:00 AM,48,-122,1,3,4
37201,FremontBridge,12/31/2016 01:00:00 AM,48,-122,5,1,6
37202,FremontBridge,12/31/2016 02:00:00 AM,48,-122,2,0,2
37203,FremontBridge,12/31/2016 03:00:00 AM,48,-122,0,0,0
37204,FremontBridge,12/31/2016 04:00:00 AM,48,-122,1,3,4
37205,FremontBridge,12/31/2016 05:00:00 AM,48,-122,2,1,3
37206,FremontBridge,12/31/2016 06:00:00 AM,48,-122,2,4,6
37207,FremontBridge,12/31/2016 07:00:00 AM,48,-122,8,6,14
37208,FremontBridge,12/31/2016 08:00:00 AM,48,-122,15,21,36
37209,FremontBridge,12/31/2016 09:00:00 AM,48,-122,20,15,35
37210,FremontBridge,12/31/2016 10:00:00 AM,48,-122,16,27,43
37211,FremontBridge,12/31/2016 11:00:00 AM,48,-122,22,29,51
37212,FremontBridge,12/31/2016 12:00:00 PM,48,-122,13,27,40
37213,FremontBridge,12/31/2016 01:00:00 PM,48,-122,28,15,43
37214,FremontBridge,12/31/2016 02:00:00 PM,48,-122,15,14,29
37215,FremontBridge,12/31/2016 03:00:00 PM,48,-122,14,19,33
37216,FremontBridge,12/31/2016 04:00:00 PM,48,-122,22,16,38
37217,FremontBridge,12/31/2016 05:00:00 PM,48,-122,9,9,18
37218,FremontBridge,12/31/2016 06:00:00 PM,48,-122,11,4,15
37219,FremontBridge,12/31/2016 07:00:00 PM,48,-122,4,6,10
37220,FremontBridge,12/31/2016 08:00:00 PM,48,-122,6,3,9
37221,FremontBridge,12/31/2016 09:00:00 PM,48,-122,6,4,10
37222,FremontBridge,12/31/2016 10:00:00 PM,48,-122,8,7,15
37223,FremontBridge,12/31/2016 11:00:00 PM,48,-122,4,4,8
37224,FremontBridge,01/01/2017 12:00:00 AM,48,-122,5,0,5
37225,FremontBridge,01/01/2017 01:00:00 AM,48,-122,14,5,19
37226,FremontBridge,01/01/2017 02:00:00 AM,48,-122,0,1,1
37227,FremontBridge,01/01/2017 03:00:00 AM,48,-122,2,0,2
37228,FremontBridge,01/01/2017 04:00:00 AM,48,-122,1,0,1
37229,FremontBridge,01/01/2017 05:00:00 AM,48,-122,0,0,0
37230,FremontBridge,01/01/2017 06:00:00 AM,48,-122,2,2,4
37231,FremontBridge,01/01/2017 07:00:00 AM,48,-122,1,1,2
37232,FremontBridge,01/01/2017 08:00:00 AM,48,-122,3,2,5
37233,FremontBridge,01/01/2017 09:00:00 AM,48,-122,4,7,11
37234,FremontBridge,01/01/2017 10:00:00 AM,48,-122,6,7,13
37235,FremontBridge,01/01/2017 11:00:00 AM,48,-122,12,9,21
37236,FremontBridge,01/01/2017 12:00:00 PM,48,-122,8,17,25
37237,FremontBridge,01/01/2017 01:00:00 PM,48,-122,16,19,35
37238,FremontBridge,01/01/2017 02:00:00 PM,48,-122,26,16,42
37239,FremontBridge,01/01/2017 03:00:00 PM,48,-122,11,29,40
37240,FremontBridge,01/01/2017 04:00:00 PM,48,-122,11,21,32
37241,FremontBridge,01/01/2017 05:00:00 PM,48,-122,17,10,27
37242,FremontBridge,01/01/2017 06:00:00 PM,48,-122,9,7,16
37243,FremontBridge,01/01/2017 07:00:00 PM,48,-122,2,1,3
37244,FremontBridge,01/01/2017 08:00:00 PM,48,-122,2,1,3
37245,FremontBridge,01/01/2017 09:00:00 PM,48,-122,5,3,8
37246,FremontBridge,01/01/2017 10:00:00 PM,48,-122,4,2,6
37247,FremontBridge,01/01/2017 11:00:00 PM,48,-122,3,2,5
37248,FremontBridge,01/02/2017 12:00:00 AM,48,-122,1,0,1
37249,FremontBridge,01/02/2017 01:00:00 AM,48,-122,1,0,1
37250,FremontBridge,01/02/2017 02:00:00 AM,48,-122,0,1,1
37251,FremontBridge,01/02/2017 03:00:00 AM,48,-122,0,1,1
37252,FremontBridge,01/02/2017 04:00:00 AM,48,-122,1,0,1
37253,FremontBridge,01/02/2017 05:00:00 AM,48,-122,2,2,4
37254,FremontBridge,01/02/2017 06:00:00 AM,48,-122,4,7,11
37255,FremontBridge,01/02/2017 07:00:00 AM,48,-122,4,13,17
37256,FremontBridge,01/02/2017 08:00:00 AM,48,-122,12,17,29
37257,FremontBridge,01/02/2017 09:00:00 AM,48,-122,11,21,32
37258,FremontBridge,01/02/2017 10:00:00 AM,48,-122,23,20,43
37259,FremontBridge,01/02/2017 11:00:00 AM,48,-122,26,21,47
37260,FremontBridge,01/02/2017 12:00:00 PM,48,-122,28,27,55
37261,FremontBridge,01/02/2017 01:00:00 PM,48,-122,31,27,58
37262,FremontBridge,01/02/2017 02:00:00 PM,48,-122,37,36,73
37263,FremontBridge,01/02/2017 03:00:00 PM,48,-122,29,37,66
37264,FremontBridge,01/02/2017 04:00:00 PM,48,-122,29,25,54
37265,FremontBridge,01/02/2017 05:00:00 PM,48,-122,26,19,45
37266,FremontBridge,01/02/2017 06:00:00 PM,48,-122,15,16,31
37267,FremontBridge,01/02/2017 07:00:00 PM,48,-122,13,4,17
37268,FremontBridge,01/02/2017 08:00:00 PM,48,-122,6,6,12
37269,FremontBridge,01/02/2017 09:00:00 PM,48,-122,7,8,15
37270,FremontBridge,01/02/2017 10:00:00 PM,48,-122,1,3,4
37271,FremontBridge,01/02/2017 11:00:00 PM,48,-122,2,3,5
37272,FremontBridge,01/03/2017 12:00:00 AM,48,-122,3,0,3
37273,FremontBridge,01/03/2017 01:00:00 AM,48,-122,1,1,2
37274,FremontBridge,01/03/2017 02:00:00 AM,48,-122,0,2,2
37275,FremontBridge,01/03/2017 03:00:00 AM,48,-122,0,0,0
37276,FremontBridge,01/03/2017 04:00:00 AM,48,-122,2,7,9
37277,FremontBridge,01/03/2017 05:00:00 AM,48,-122,11,11,22
37278,FremontBridge,01/03/2017 06:00:00 AM,48,-122,29,46,75
37279,FremontBridge,01/03/2017 07:00:00 AM,48,-122,64,120,184
37280,FremontBridge,01/03/2017 08:00:00 AM,48,-122,97,175,272
37281,FremontBridge,01/03/2017 09:00:00 AM,48,-122,60,70,130
37282,FremontBridge,01/03/2017 10:00:00 AM,48,-122,27,31,58
37283,FremontBridge,01/03/2017 11:00:00 AM,48,-122,25,17,42
37284,FremontBridge,01/03/2017 12:00:00 PM,48,-122,18,16,34
37285,FremontBridge,01/03/2017 01:00:00 PM,48,-122,17,10,27
37286,FremontBridge,01/03/2017 02:00:00 PM,48,-122,18,13,31
37287,FremontBridge,01/03/2017 03:00:00 PM,48,-122,42,25,67
37288,FremontBridge,01/03/2017 04:00:00 PM,48,-122,111,49,160
37289,FremontBridge,01/03/2017 05:00:00 PM,48,-122,245,76,321
37290,FremontBridge,01/03/2017 06:00:00 PM,48,-122,132,48,180
37291,FremontBridge,01/03/2017 07:00:00 PM,48,-122,47,26,73
37292,FremontBridge,01/03/2017 08:00:00 PM,48,-122,16,8,24
37293,FremontBridge,01/03/2017 09:00:00 PM,48,-122,4,5,9
37294,FremontBridge,01/03/2017 10:00:00 PM,48,-122,7,1,8
37295,FremontBridge,01/03/2017 11:00:00 PM,48,-122,2,1,3
37296,FremontBridge,01/04/2017 12:00:00 AM,48,-122,1,2,3
37297,FremontBridge,01/04/2017 01:00:00 AM,48,-122,1,0,1
37298,FremontBridge,01/04/2017 02:00:00 AM,48,-122,0,0,0
37299,FremontBridge,01/04/2017 03:00:00 AM,48,-122,0,1,1
37300,FremontBridge,01/04/2017 04:00:00 AM,48,-122,2,3,5
37301,FremontBridge,01/04/2017 05:00:00 AM,48,-122,7,19,26
37302,FremontBridge,01/04/2017 06:00:00 AM,48,-122,32,36,68
37303,FremontBridge,01/04/2017 07:00:00 AM,48,-122,50,111,161
37304,FremontBridge,01/04/2017 08:00:00 AM,48,-122,103,175,278
37305,FremontBridge,01/04/2017 09:00:00 AM,48,-122,74,106,180
37306,FremontBridge,01/04/2017 10:00:00 AM,48,-122,31,26,57
37307,FremontBridge,01/04/2017 11:00:00 AM,48,-122,15,14,29
37308,FremontBridge,01/04/2017 12:00:00 PM,48,-122,21,14,35
37309,FremontBridge,01/04/2017 01:00:00 PM,48,-122,18,19,37
37310,FremontBridge,01/04/2017 02:00:00 PM,48,-122,27,17,44
37311,FremontBridge,01/04/2017 03:00:00 PM,48,-122,48,28,76
37312,FremontBridge,01/04/2017 04:00:00 PM,48,-122,101,54,155
37313,FremontBridge,01/04/2017 05:00:00 PM,48,-122,231,73,304
37314,FremontBridge,01/04/2017 06:00:00 PM,48,-122,138,60,198
37315,FremontBridge,01/04/2017 07:00:00 PM,48,-122,61,16,77
37316,FremontBridge,01/04/2017 08:00:00 PM,48,-122,19,10,29
37317,FremontBridge,01/04/2017 09:00:00 PM,48,-122,15,9,24
37318,FremontBridge,01/04/2017 10:00:00 PM,48,-122,4,8,12
37319,FremontBridge,01/04/2017 11:00:00 PM,48,-122,2,6,8
37320,FremontBridge,01/05/2017 12:00:00 AM,48,-122,1,0,1
37321,FremontBridge,01/05/2017 01:00:00 AM,48,-122,1,0,1
37322,FremontBridge,01/05/2017 02:00:00 AM,48,-122,1,0,1
37323,FremontBridge,01/05/2017 03:00:00 AM,48,-122,0,0,0
37324,FremontBridge,01/05/2017 04:00:00 AM,48,-122,1,3,4
37325,FremontBridge,01/05/2017 05:00:00 AM,48,-122,8,17,25
37326,FremontBridge,01/05/2017 06:00:00 AM,48,-122,25,36,61
37327,FremontBridge,01/05/2017 07:00:00 AM,48,-122,58,122,180
37328,FremontBridge,01/05/2017 08:00:00 AM,48,-122,107,162,269
37329,FremontBridge,01/05/2017 09:00:00 AM,48,-122,59,83,142
37330,FremontBridge,01/05/2017 10:00:00 AM,48,-122,27,30,57
37331,FremontBridge,01/05/2017 11:00:00 AM,48,-122,25,31,56
37332,FremontBridge,01/05/2017 12:00:00 PM,48,-122,19,23,42
37333,FremontBridge,01/05/2017 01:00:00 PM,48,-122,20,22,42
37334,FremontBridge,01/05/2017 02:00:00 PM,48,-122,30,20,50
37335,FremontBridge,01/05/2017 03:00:00 PM,48,-122,47,33,80
37336,FremontBridge,01/05/2017 04:00:00 PM,48,-122,114,48,162
37337,FremontBridge,01/05/2017 05:00:00 PM,48,-122,211,61,272
37338,FremontBridge,01/05/2017 06:00:00 PM,48,-122,127,58,185
37339,FremontBridge,01/05/2017 07:00:00 PM,48,-122,60,18,78
37340,FremontBridge,01/05/2017 08:00:00 PM,48,-122,20,6,26
37341,FremontBridge,01/05/2017 09:00:00 PM,48,-122,18,6,24
37342,FremontBridge,01/05/2017 10:00:00 PM,48,-122,6,5,11
37343,FremontBridge,01/05/2017 11:00:00 PM,48,-122,5,3,8
37344,FremontBridge,01/06/2017 12:00:00 AM,48,-122,1,3,4
37345,FremontBridge,01/06/2017 01:00:00 AM,48,-122,1,0,1
37346,FremontBridge,01/06/2017 02:00:00 AM,48,-122,0,0,0
37347,FremontBridge,01/06/2017 03:00:00 AM,48,-122,0,0,0
37348,FremontBridge,01/06/2017 04:00:00 AM,48,-122,1,2,3
37349,FremontBridge,01/06/2017 05:00:00 AM,48,-122,13,11,24
37350,FremontBridge,01/06/2017 06:00:00 AM,48,-122,31,34,65
37351,FremontBridge,01/06/2017 07:00:00 AM,48,-122,47,90,137
37352,FremontBridge,01/06/2017 08:00:00 AM,48,-122,93,161,254
37353,FremontBridge,01/06/2017 09:00:00 AM,48,-122,58,84,142
37354,FremontBridge,01/06/2017 10:00:00 AM,48,-122,31,40,71
37355,FremontBridge,01/06/2017 11:00:00 AM,48,-122,22,15,37
37356,FremontBridge,01/06/2017 12:00:00 PM,48,-122,24,27,51
37357,FremontBridge,01/06/2017 01:00:00 PM,48,-122,29,25,54
37358,FremontBridge,01/06/2017 02:00:00 PM,48,-122,24,17,41
37359,FremontBridge,01/06/2017 03:00:00 PM,48,-122,52,30,82
37360,FremontBridge,01/06/2017 04:00:00 PM,48,-122,114,40,154
37361,FremontBridge,01/06/2017 05:00:00 PM,48,-122,168,64,232
37362,FremontBridge,01/06/2017 06:00:00 PM,48,-122,122,41,163
37363,FremontBridge,01/06/2017 07:00:00 PM,48,-122,49,15,64
37364,FremontBridge,01/06/2017 08:00:00 PM,48,-122,20,13,33
37365,FremontBridge,01/06/2017 09:00:00 PM,48,-122,4,9,13
37366,FremontBridge,01/06/2017 10:00:00 PM,48,-122,9,3,12
37367,FremontBridge,01/06/2017 11:00:00 PM,48,-122,8,3,11
37368,FremontBridge,01/07/2017 12:00:00 AM,48,-122,6,5,11
37369,FremontBridge,01/07/2017 01:00:00 AM,48,-122,1,0,1
37370,FremontBridge,01/07/2017 02:00:00 AM,48,-122,2,1,3
37371,FremontBridge,01/07/2017 03:00:00 AM,48,-122,0,0,0
37372,FremontBridge,01/07/2017 04:00:00 AM,48,-122,0,0,0
37373,FremontBridge,01/07/2017 05:00:00 AM,48,-122,0,4,4
37374,FremontBridge,01/07/2017 06:00:00 AM,48,-122,2,4,6
37375,FremontBridge,01/07/2017 07:00:00 AM,48,-122,5,4,9
37376,FremontBridge,01/07/2017 08:00:00 AM,48,-122,12,17,29
37377,FremontBridge,01/07/2017 09:00:00 AM,48,-122,15,22,37
37378,FremontBridge,01/07/2017 10:00:00 AM,48,-122,12,18,30
37379,FremontBridge,01/07/2017 11:00:00 AM,48,-122,22,32,54
37380,FremontBridge,01/07/2017 12:00:00 PM,48,-122,20,27,47
37381,FremontBridge,01/07/2017 01:00:00 PM,48,-122,28,23,51
37382,FremontBridge,01/07/2017 02:00:00 PM,48,-122,23,25,48
37383,FremontBridge,01/07/2017 03:00:00 PM,48,-122,30,25,55
37384,FremontBridge,01/07/2017 04:00:00 PM,48,-122,22,27,49
37385,FremontBridge,01/07/2017 05:00:00 PM,48,-122,14,12,26
37386,FremontBridge,01/07/2017 06:00:00 PM,48,-122,15,14,29
37387,FremontBridge,01/07/2017 07:00:00 PM,48,-122,8,6,14
37388,FremontBridge,01/07/2017 08:00:00 PM,48,-122,9,4,13
37389,FremontBridge,01/07/2017 09:00:00 PM,48,-122,5,3,8
37390,FremontBridge,01/07/2017 10:00:00 PM,48,-122,4,2,6
37391,FremontBridge,01/07/2017 11:00:00 PM,48,-122,5,3,8
37392,FremontBridge,01/08/2017 12:00:00 AM,48,-122,7,4,11
37393,FremontBridge,01/08/2017 01:00:00 AM,48,-122,3,1,4
37394,FremontBridge,01/08/2017 02:00:00 AM,48,-122,0,1,1
37395,FremontBridge,01/08/2017 03:00:00 AM,48,-122,1,1,2
37396,FremontBridge,01/08/2017 04:00:00 AM,48,-122,0,0,0
37397,FremontBridge,01/08/2017 05:00:00 AM,48,-122,1,1,2
37398,FremontBridge,01/08/2017 06:00:00 AM,48,-122,5,1,6
37399,FremontBridge,01/08/2017 07:00:00 AM,48,-122,3,5,8
37400,FremontBridge,01/08/2017 08:00:00 AM,48,-122,9,8,17
37401,FremontBridge,01/08/2017 09:00:00 AM,48,-122,11,11,22
37402,FremontBridge,01/08/2017 10:00:00 AM,48,-122,17,19,36
37403,FremontBridge,01/08/2017 11:00:00 AM,48,-122,8,17,25
37404,FremontBridge,01/08/2017 12:00:00 PM,48,-122,11,14,25
37405,FremontBridge,01/08/2017 01:00:00 PM,48,-122,11,6,17
37406,FremontBridge,01/08/2017 02:00:00 PM,48,-122,6,10,16
37407,FremontBridge,01/08/2017 03:00:00 PM,48,-122,8,8,16
37408,FremontBridge,01/08/2017 04:00:00 PM,48,-122,8,5,13
37409,FremontBridge,01/08/2017 05:00:00 PM,48,-122,6,5,11
37410,FremontBridge,01/08/2017 06:00:00 PM,48,-122,4,4,8
37411,FremontBridge,01/08/2017 07:00:00 PM,48,-122,2,3,5
37412,FremontBridge,01/08/2017 08:00:00 PM,48,-122,6,1,7
37413,FremontBridge,01/08/2017 09:00:00 PM,48,-122,2,5,7
37414,FremontBridge,01/08/2017 10:00:00 PM,48,-122,3,2,5
37415,FremontBridge,01/08/2017 11:00:00 PM,48,-122,2,2,4
37416,FremontBridge,01/09/2017 12:00:00 AM,48,-122,1,2,3
37417,FremontBridge,01/09/2017 01:00:00 AM,48,-122,0,0,0
37418,FremontBridge,01/09/2017 02:00:00 AM,48,-122,0,0,0
37419,FremontBridge,01/09/2017 03:00:00 AM,48,-122,0,0,0
37420,FremontBridge,01/09/2017 04:00:00 AM,48,-122,2,5,7
37421,FremontBridge,01/09/2017 05:00:00 AM,48,-122,9,12,21
37422,FremontBridge,01/09/2017 06:00:00 AM,48,-122,28,55,83
37423,FremontBridge,01/09/2017 07:00:00 AM,48,-122,71,157,228
37424,FremontBridge,01/09/2017 08:00:00 AM,48,-122,131,202,333
37425,FremontBridge,01/09/2017 09:00:00 AM,48,-122,83,82,165
37426,FremontBridge,01/09/2017 10:00:00 AM,48,-122,34,30,64
37427,FremontBridge,01/09/2017 11:00:00 AM,48,-122,19,20,39
37428,FremontBridge,01/09/2017 12:00:00 PM,48,-122,10,19,29
37429,FremontBridge,01/09/2017 01:00:00 PM,48,-122,18,16,34
37430,FremontBridge,01/09/2017 02:00:00 PM,48,-122,13,10,23
37431,FremontBridge,01/09/2017 03:00:00 PM,48,-122,31,27,58
37432,FremontBridge,01/09/2017 04:00:00 PM,48,-122,107,52,159
37433,FremontBridge,01/09/2017 05:00:00 PM,48,-122,283,91,374
37434,FremontBridge,01/09/2017 06:00:00 PM,48,-122,188,48,236
37435,FremontBridge,01/09/2017 07:00:00 PM,48,-122,64,24,88
37436,FremontBridge,01/09/2017 08:00:00 PM,48,-122,28,13,41
37437,FremontBridge,01/09/2017 09:00:00 PM,48,-122,6,4,10
37438,FremontBridge,01/09/2017 10:00:00 PM,48,-122,6,6,12
37439,FremontBridge,01/09/2017 11:00:00 PM,48,-122,3,4,7
37440,FremontBridge,01/10/2017 12:00:00 AM,48,-122,3,2,5
37441,FremontBridge,01/10/2017 01:00:00 AM,48,-122,0,0,0
37442,FremontBridge,01/10/2017 02:00:00 AM,48,-122,0,1,1
37443,FremontBridge,01/10/2017 03:00:00 AM,48,-122,0,0,0
37444,FremontBridge,01/10/2017 04:00:00 AM,48,-122,1,5,6
37445,FremontBridge,01/10/2017 05:00:00 AM,48,-122,14,17,31
37446,FremontBridge,01/10/2017 06:00:00 AM,48,-122,32,53,85
37447,FremontBridge,01/10/2017 07:00:00 AM,48,-122,80,114,194
37448,FremontBridge,01/10/2017 08:00:00 AM,48,-122,112,158,270
37449,FremontBridge,01/10/2017 09:00:00 AM,48,-122,67,83,150
37450,FremontBridge,01/10/2017 10:00:00 AM,48,-122,28,25,53
37451,FremontBridge,01/10/2017 11:00:00 AM,48,-122,20,17,37
37452,FremontBridge,01/10/2017 12:00:00 PM,48,-122,19,21,40
37453,FremontBridge,01/10/2017 01:00:00 PM,48,-122,15,20,35
37454,FremontBridge,01/10/2017 02:00:00 PM,48,-122,27,19,46
37455,FremontBridge,01/10/2017 03:00:00 PM,48,-122,51,27,78
37456,FremontBridge,01/10/2017 04:00:00 PM,48,-122,87,53,140
37457,FremontBridge,01/10/2017 05:00:00 PM,48,-122,203,80,283
37458,FremontBridge,01/10/2017 06:00:00 PM,48,-122,141,59,200
37459,FremontBridge,01/10/2017 07:00:00 PM,48,-122,61,28,89
37460,FremontBridge,01/10/2017 08:00:00 PM,48,-122,32,9,41
37461,FremontBridge,01/10/2017 09:00:00 PM,48,-122,12,6,18
37462,FremontBridge,01/10/2017 10:00:00 PM,48,-122,9,4,13
37463,FremontBridge,01/10/2017 11:00:00 PM,48,-122,2,3,5
37464,FremontBridge,01/11/2017 12:00:00 AM,48,-122,1,2,3
37465,FremontBridge,01/11/2017 01:00:00 AM,48,-122,0,0,0
37466,FremontBridge,01/11/2017 02:00:00 AM,48,-122,0,0,0
37467,FremontBridge,01/11/2017 03:00:00 AM,48,-122,0,0,0
37468,FremontBridge,01/11/2017 04:00:00 AM,48,-122,2,4,6
37469,FremontBridge,01/11/2017 05:00:00 AM,48,-122,9,16,25
37470,FremontBridge,01/11/2017 06:00:00 AM,48,-122,21,51,72
37471,FremontBridge,01/11/2017 07:00:00 AM,48,-122,55,130,185
37472,FremontBridge,01/11/2017 08:00:00 AM,48,-122,106,162,268
37473,FremontBridge,01/11/2017 09:00:00 AM,48,-122,75,80,155
37474,FremontBridge,01/11/2017 10:00:00 AM,48,-122,47,35,82
37475,FremontBridge,01/11/2017 11:00:00 AM,48,-122,13,25,38
37476,FremontBridge,01/11/2017 12:00:00 PM,48,-122,14,22,36
37477,FremontBridge,01/11/2017 01:00:00 PM,48,-122,33,21,54
37478,FremontBridge,01/11/2017 02:00:00 PM,48,-122,22,15,37
37479,FremontBridge,01/11/2017 03:00:00 PM,48,-122,34,20,54
37480,FremontBridge,01/11/2017 04:00:00 PM,48,-122,103,56,159
37481,FremontBridge,01/11/2017 05:00:00 PM,48,-122,225,70,295
37482,FremontBridge,01/11/2017 06:00:00 PM,48,-122,163,62,225
37483,FremontBridge,01/11/2017 07:00:00 PM,48,-122,65,29,94
37484,FremontBridge,01/11/2017 08:00:00 PM,48,-122,22,14,36
37485,FremontBridge,01/11/2017 09:00:00 PM,48,-122,11,13,24
37486,FremontBridge,01/11/2017 10:00:00 PM,48,-122,11,9,20
37487,FremontBridge,01/11/2017 11:00:00 PM,48,-122,3,2,5
37488,FremontBridge,01/12/2017 12:00:00 AM,48,-122,4,2,6
37489,FremontBridge,01/12/2017 01:00:00 AM,48,-122,0,1,1
37490,FremontBridge,01/12/2017 02:00:00 AM,48,-122,1,1,2
37491,FremontBridge,01/12/2017 03:00:00 AM,48,-122,0,1,1
37492,FremontBridge,01/12/2017 04:00:00 AM,48,-122,1,1,2
37493,FremontBridge,01/12/2017 05:00:00 AM,48,-122,12,15,27
37494,FremontBridge,01/12/2017 06:00:00 AM,48,-122,23,37,60
37495,FremontBridge,01/12/2017 07:00:00 AM,48,-122,58,105,163
37496,FremontBridge,01/12/2017 08:00:00 AM,48,-122,113,158,271
37497,FremontBridge,01/12/2017 09:00:00 AM,48,-122,63,80,143
37498,FremontBridge,01/12/2017 10:00:00 AM,48,-122,28,39,67
37499,FremontBridge,01/12/2017 11:00:00 AM,48,-122,35,26,61
37500,FremontBridge,01/12/2017 12:00:00 PM,48,-122,17,20,37
37501,FremontBridge,01/12/2017 01:00:00 PM,48,-122,20,27,47
37502,FremontBridge,01/12/2017 02:00:00 PM,48,-122,24,30,54
37503,FremontBridge,01/12/2017 03:00:00 PM,48,-122,42,33,75
37504,FremontBridge,01/12/2017 04:00:00 PM,48,-122,87,54,141
37505,FremontBridge,01/12/2017 05:00:00 PM,48,-122,194,68,262
37506,FremontBridge,01/12/2017 06:00:00 PM,48,-122,143,68,211
37507,FremontBridge,01/12/2017 07:00:00 PM,48,-122,61,23,84
37508,FremontBridge,01/12/2017 08:00:00 PM,48,-122,35,12,47
37509,FremontBridge,01/12/2017 09:00:00 PM,48,-122,20,9,29
37510,FremontBridge,01/12/2017 10:00:00 PM,48,-122,13,17,30
37511,FremontBridge,01/12/2017 11:00:00 PM,48,-122,4,13,17
37512,FremontBridge,01/13/2017 12:00:00 AM,48,-122,2,2,4
37513,FremontBridge,01/13/2017 01:00:00 AM,48,-122,1,4,5
37514,FremontBridge,01/13/2017 02:00:00 AM,48,-122,0,1,1
37515,FremontBridge,01/13/2017 03:00:00 AM,48,-122,0,0,0
37516,FremontBridge,01/13/2017 04:00:00 AM,48,-122,1,2,3
37517,FremontBridge,01/13/2017 05:00:00 AM,48,-122,8,12,20
37518,FremontBridge,01/13/2017 06:00:00 AM,48,-122,23,39,62
37519,FremontBridge,01/13/2017 07:00:00 AM,48,-122,57,112,169
37520,FremontBridge,01/13/2017 08:00:00 AM,48,-122,97,139,236
37521,FremontBridge,01/13/2017 09:00:00 AM,48,-122,70,69,139
37522,FremontBridge,01/13/2017 10:00:00 AM,48,-122,31,30,61
37523,FremontBridge,01/13/2017 11:00:00 AM,48,-122,20,22,42
37524,FremontBridge,01/13/2017 12:00:00 PM,48,-122,17,23,40
37525,FremontBridge,01/13/2017 01:00:00 PM,48,-122,22,26,48
37526,FremontBridge,01/13/2017 02:00:00 PM,48,-122,31,19,50
37527,FremontBridge,01/13/2017 03:00:00 PM,48,-122,53,40,93
37528,FremontBridge,01/13/2017 04:00:00 PM,48,-122,115,51,166
37529,FremontBridge,01/13/2017 05:00:00 PM,48,-122,193,65,258
37530,FremontBridge,01/13/2017 06:00:00 PM,48,-122,123,44,167
37531,FremontBridge,01/13/2017 07:00:00 PM,48,-122,40,24,64
37532,FremontBridge,01/13/2017 08:00:00 PM,48,-122,21,8,29
37533,FremontBridge,01/13/2017 09:00:00 PM,48,-122,12,14,26
37534,FremontBridge,01/13/2017 10:00:00 PM,48,-122,9,3,12
37535,FremontBridge,01/13/2017 11:00:00 PM,48,-122,6,3,9
37536,FremontBridge,01/14/2017 12:00:00 AM,48,-122,1,1,2
37537,FremontBridge,01/14/2017 01:00:00 AM,48,-122,6,1,7
37538,FremontBridge,01/14/2017 02:00:00 AM,48,-122,0,2,2
37539,FremontBridge,01/14/2017 03:00:00 AM,48,-122,2,0,2
37540,FremontBridge,01/14/2017 04:00:00 AM,48,-122,0,0,0
37541,FremontBridge,01/14/2017 05:00:00 AM,48,-122,1,3,4
37542,FremontBridge,01/14/2017 06:00:00 AM,48,-122,3,6,9
37543,FremontBridge,01/14/2017 07:00:00 AM,48,-122,6,7,13
37544,FremontBridge,01/14/2017 08:00:00 AM,48,-122,13,14,27
37545,FremontBridge,01/14/2017 09:00:00 AM,48,-122,23,20,43
37546,FremontBridge,01/14/2017 10:00:00 AM,48,-122,28,37,65
37547,FremontBridge,01/14/2017 11:00:00 AM,48,-122,19,38,57
37548,FremontBridge,01/14/2017 12:00:00 PM,48,-122,38,41,79
37549,FremontBridge,01/14/2017 01:00:00 PM,48,-122,34,57,91
37550,FremontBridge,01/14/2017 02:00:00 PM,48,-122,31,45,76
37551,FremontBridge,01/14/2017 03:00:00 PM,48,-122,30,31,61
37552,FremontBridge,01/14/2017 04:00:00 PM,48,-122,22,34,56
37553,FremontBridge,01/14/2017 05:00:00 PM,48,-122,25,22,47
37554,FremontBridge,01/14/2017 06:00:00 PM,48,-122,16,15,31
37555,FremontBridge,01/14/2017 07:00:00 PM,48,-122,13,6,19
37556,FremontBridge,01/14/2017 08:00:00 PM,48,-122,4,13,17
37557,FremontBridge,01/14/2017 09:00:00 PM,48,-122,7,2,9
37558,FremontBridge,01/14/2017 10:00:00 PM,48,-122,4,6,10
37559,FremontBridge,01/14/2017 11:00:00 PM,48,-122,3,1,4
37560,FremontBridge,01/15/2017 12:00:00 AM,48,-122,2,4,6
37561,FremontBridge,01/15/2017 01:00:00 AM,48,-122,1,3,4
37562,FremontBridge,01/15/2017 02:00:00 AM,48,-122,1,1,2
37563,FremontBridge,01/15/2017 03:00:00 AM,48,-122,1,0,1
37564,FremontBridge,01/15/2017 04:00:00 AM,48,-122,0,0,0
37565,FremontBridge,01/15/2017 05:00:00 AM,48,-122,1,3,4
37566,FremontBridge,01/15/2017 06:00:00 AM,48,-122,5,2,7
37567,FremontBridge,01/15/2017 07:00:00 AM,48,-122,3,5,8
37568,FremontBridge,01/15/2017 08:00:00 AM,48,-122,11,13,24
37569,FremontBridge,01/15/2017 09:00:00 AM,48,-122,13,17,30
37570,FremontBridge,01/15/2017 10:00:00 AM,48,-122,15,24,39
37571,FremontBridge,01/15/2017 11:00:00 AM,48,-122,34,41,75
37572,FremontBridge,01/15/2017 12:00:00 PM,48,-122,45,46,91
37573,FremontBridge,01/15/2017 01:00:00 PM,48,-122,53,69,122
37574,FremontBridge,01/15/2017 02:00:00 PM,48,-122,59,46,105
37575,FremontBridge,01/15/2017 03:00:00 PM,48,-122,44,55,99
37576,FremontBridge,01/15/2017 04:00:00 PM,48,-122,30,32,62
37577,FremontBridge,01/15/2017 05:00:00 PM,48,-122,18,21,39
37578,FremontBridge,01/15/2017 06:00:00 PM,48,-122,14,14,28
37579,FremontBridge,01/15/2017 07:00:00 PM,48,-122,16,13,29
37580,FremontBridge,01/15/2017 08:00:00 PM,48,-122,7,6,13
37581,FremontBridge,01/15/2017 09:00:00 PM,48,-122,5,4,9
37582,FremontBridge,01/15/2017 10:00:00 PM,48,-122,7,5,12
37583,FremontBridge,01/15/2017 11:00:00 PM,48,-122,2,2,4
37584,FremontBridge,01/16/2017 12:00:00 AM,48,-122,2,1,3
37585,FremontBridge,01/16/2017 01:00:00 AM,48,-122,0,2,2
37586,FremontBridge,01/16/2017 02:00:00 AM,48,-122,1,0,1
37587,FremontBridge,01/16/2017 03:00:00 AM,48,-122,0,0,0
37588,FremontBridge,01/16/2017 04:00:00 AM,48,-122,2,1,3
37589,FremontBridge,01/16/2017 05:00:00 AM,48,-122,2,8,10
37590,FremontBridge,01/16/2017 06:00:00 AM,48,-122,23,21,44
37591,FremontBridge,01/16/2017 07:00:00 AM,48,-122,36,69,105
37592,FremontBridge,01/16/2017 08:00:00 AM,48,-122,65,93,158
37593,FremontBridge,01/16/2017 09:00:00 AM,48,-122,49,53,102
37594,FremontBridge,01/16/2017 10:00:00 AM,48,-122,37,41,78
37595,FremontBridge,01/16/2017 11:00:00 AM,48,-122,27,31,58
37596,FremontBridge,01/16/2017 12:00:00 PM,48,-122,53,40,93
37597,FremontBridge,01/16/2017 01:00:00 PM,48,-122,33,39,72
37598,FremontBridge,01/16/2017 02:00:00 PM,48,-122,39,44,83
37599,FremontBridge,01/16/2017 03:00:00 PM,48,-122,59,40,99
37600,FremontBridge,01/16/2017 04:00:00 PM,48,-122,67,24,91
37601,FremontBridge,01/16/2017 05:00:00 PM,48,-122,146,53,199
37602,FremontBridge,01/16/2017 06:00:00 PM,48,-122,82,39,121
37603,FremontBridge,01/16/2017 07:00:00 PM,48,-122,42,22,64
37604,FremontBridge,01/16/2017 08:00:00 PM,48,-122,16,7,23
37605,FremontBridge,01/16/2017 09:00:00 PM,48,-122,10,6,16
37606,FremontBridge,01/16/2017 10:00:00 PM,48,-122,3,6,9
37607,FremontBridge,01/16/2017 11:00:00 PM,48,-122,5,3,8
37608,FremontBridge,01/17/2017 12:00:00 AM,48,-122,1,4,5
37609,FremontBridge,01/17/2017 01:00:00 AM,48,-122,3,1,4
37610,FremontBridge,01/17/2017 02:00:00 AM,48,-122,1,0,1
37611,FremontBridge,01/17/2017 03:00:00 AM,48,-122,1,0,1
37612,FremontBridge,01/17/2017 04:00:00 AM,48,-122,2,4,6
37613,FremontBridge,01/17/2017 05:00:00 AM,48,-122,8,12,20
37614,FremontBridge,01/17/2017 06:00:00 AM,48,-122,26,51,77
37615,FremontBridge,01/17/2017 07:00:00 AM,48,-122,78,149,227
37616,FremontBridge,01/17/2017 08:00:00 AM,48,-122,118,180,298
37617,FremontBridge,01/17/2017 09:00:00 AM,48,-122,85,75,160
37618,FremontBridge,01/17/2017 10:00:00 AM,48,-122,28,27,55
37619,FremontBridge,01/17/2017 11:00:00 AM,48,-122,13,23,36
37620,FremontBridge,01/17/2017 12:00:00 PM,48,-122,18,11,29
37621,FremontBridge,01/17/2017 01:00:00 PM,48,-122,15,13,28
37622,FremontBridge,01/17/2017 02:00:00 PM,48,-122,13,10,23
37623,FremontBridge,01/17/2017 03:00:00 PM,48,-122,33,18,51
37624,FremontBridge,01/17/2017 04:00:00 PM,48,-122,89,43,132
37625,FremontBridge,01/17/2017 05:00:00 PM,48,-122,217,59,276
37626,FremontBridge,01/17/2017 06:00:00 PM,48,-122,143,48,191
37627,FremontBridge,01/17/2017 07:00:00 PM,48,-122,64,14,78
37628,FremontBridge,01/17/2017 08:00:00 PM,48,-122,22,6,28
37629,FremontBridge,01/17/2017 09:00:00 PM,48,-122,9,3,12
37630,FremontBridge,01/17/2017 10:00:00 PM,48,-122,2,2,4
37631,FremontBridge,01/17/2017 11:00:00 PM,48,-122,2,1,3
37632,FremontBridge,01/18/2017 12:00:00 AM,48,-122,1,2,3
37633,FremontBridge,01/18/2017 01:00:00 AM,48,-122,0,0,0
37634,FremontBridge,01/18/2017 02:00:00 AM,48,-122,0,0,0
37635,FremontBridge,01/18/2017 03:00:00 AM,48,-122,1,0,1
37636,FremontBridge,01/18/2017 04:00:00 AM,48,-122,1,5,6
37637,FremontBridge,01/18/2017 05:00:00 AM,48,-122,5,11,16
37638,FremontBridge,01/18/2017 06:00:00 AM,48,-122,23,47,70
37639,FremontBridge,01/18/2017 07:00:00 AM,48,-122,64,104,168
37640,FremontBridge,01/18/2017 08:00:00 AM,48,-122,71,114,185
37641,FremontBridge,01/18/2017 09:00:00 AM,48,-122,37,51,88
37642,FremontBridge,01/18/2017 10:00:00 AM,48,-122,20,12,32
37643,FremontBridge,01/18/2017 11:00:00 AM,48,-122,17,12,29
37644,FremontBridge,01/18/2017 12:00:00 PM,48,-122,14,17,31
37645,FremontBridge,01/18/2017 01:00:00 PM,48,-122,18,18,36
37646,FremontBridge,01/18/2017 02:00:00 PM,48,-122,11,13,24
37647,FremontBridge,01/18/2017 03:00:00 PM,48,-122,29,23,52
37648,FremontBridge,01/18/2017 04:00:00 PM,48,-122,90,46,136
37649,FremontBridge,01/18/2017 05:00:00 PM,48,-122,175,47,222
37650,FremontBridge,01/18/2017 06:00:00 PM,48,-122,115,49,164
37651,FremontBridge,01/18/2017 07:00:00 PM,48,-122,44,21,65
37652,FremontBridge,01/18/2017 08:00:00 PM,48,-122,20,14,34
37653,FremontBridge,01/18/2017 09:00:00 PM,48,-122,15,6,21
37654,FremontBridge,01/18/2017 10:00:00 PM,48,-122,9,5,14
37655,FremontBridge,01/18/2017 11:00:00 PM,48,-122,3,6,9
37656,FremontBridge,01/19/2017 12:00:00 AM,48,-122,0,0,0
37657,FremontBridge,01/19/2017 01:00:00 AM,48,-122,1,1,2
37658,FremontBridge,01/19/2017 02:00:00 AM,48,-122,1,0,1
37659,FremontBridge,01/19/2017 03:00:00 AM,48,-122,0,0,0
37660,FremontBridge,01/19/2017 04:00:00 AM,48,-122,1,3,4
37661,FremontBridge,01/19/2017 05:00:00 AM,48,-122,9,12,21
37662,FremontBridge,01/19/2017 06:00:00 AM,48,-122,19,43,62
37663,FremontBridge,01/19/2017 07:00:00 AM,48,-122,72,123,195
37664,FremontBridge,01/19/2017 08:00:00 AM,48,-122,135,193,328
37665,FremontBridge,01/19/2017 09:00:00 AM,48,-122,72,83,155
37666,FremontBridge,01/19/2017 10:00:00 AM,48,-122,32,31,63
37667,FremontBridge,01/19/2017 11:00:00 AM,48,-122,22,17,39
37668,FremontBridge,01/19/2017 12:00:00 PM,48,-122,16,30,46
37669,FremontBridge,01/19/2017 01:00:00 PM,48,-122,17,32,49
37670,FremontBridge,01/19/2017 02:00:00 PM,48,-122,24,20,44
37671,FremontBridge,01/19/2017 03:00:00 PM,48,-122,36,18,54
37672,FremontBridge,01/19/2017 04:00:00 PM,48,-122,110,51,161
37673,FremontBridge,01/19/2017 05:00:00 PM,48,-122,233,70,303
37674,FremontBridge,01/19/2017 06:00:00 PM,48,-122,159,54,213
37675,FremontBridge,01/19/2017 07:00:00 PM,48,-122,64,29,93
37676,FremontBridge,01/19/2017 08:00:00 PM,48,-122,36,15,51
37677,FremontBridge,01/19/2017 09:00:00 PM,48,-122,19,12,31
37678,FremontBridge,01/19/2017 10:00:00 PM,48,-122,12,7,19
37679,FremontBridge,01/19/2017 11:00:00 PM,48,-122,7,4,11
37680,FremontBridge,01/20/2017 12:00:00 AM,48,-122,1,1,2
37681,FremontBridge,01/20/2017 01:00:00 AM,48,-122,0,3,3
37682,FremontBridge,01/20/2017 02:00:00 AM,48,-122,0,0,0
37683,FremontBridge,01/20/2017 03:00:00 AM,48,-122,0,1,1
37684,FremontBridge,01/20/2017 04:00:00 AM,48,-122,3,6,9
37685,FremontBridge,01/20/2017 05:00:00 AM,48,-122,6,13,19
37686,FremontBridge,01/20/2017 06:00:00 AM,48,-122,27,42,69
37687,FremontBridge,01/20/2017 07:00:00 AM,48,-122,78,149,227
37688,FremontBridge,01/20/2017 08:00:00 AM,48,-122,166,180,346
37689,FremontBridge,01/20/2017 09:00:00 AM,48,-122,82,101,183
37690,FremontBridge,01/20/2017 10:00:00 AM,48,-122,26,30,56
37691,FremontBridge,01/20/2017 11:00:00 AM,48,-122,19,33,52
37692,FremontBridge,01/20/2017 12:00:00 PM,48,-122,23,25,48
37693,FremontBridge,01/20/2017 01:00:00 PM,48,-122,34,43,77
37694,FremontBridge,01/20/2017 02:00:00 PM,48,-122,42,23,65
37695,FremontBridge,01/20/2017 03:00:00 PM,48,-122,53,40,93
37696,FremontBridge,01/20/2017 04:00:00 PM,48,-122,160,57,217
37697,FremontBridge,01/20/2017 05:00:00 PM,48,-122,254,88,342
37698,FremontBridge,01/20/2017 06:00:00 PM,48,-122,137,59,196
37699,FremontBridge,01/20/2017 07:00:00 PM,48,-122,63,24,87
37700,FremontBridge,01/20/2017 08:00:00 PM,48,-122,36,13,49
37701,FremontBridge,01/20/2017 09:00:00 PM,48,-122,20,13,33
37702,FremontBridge,01/20/2017 10:00:00 PM,48,-122,16,10,26
37703,FremontBridge,01/20/2017 11:00:00 PM,48,-122,13,7,20
37704,FremontBridge,01/21/2017 12:00:00 AM,48,-122,11,3,14
37705,FremontBridge,01/21/2017 01:00:00 AM,48,-122,4,0,4
37706,FremontBridge,01/21/2017 02:00:00 AM,48,-122,1,1,2
37707,FremontBridge,01/21/2017 03:00:00 AM,48,-122,0,1,1
37708,FremontBridge,01/21/2017 04:00:00 AM,48,-122,1,1,2
37709,FremontBridge,01/21/2017 05:00:00 AM,48,-122,4,7,11
37710,FremontBridge,01/21/2017 06:00:00 AM,48,-122,3,7,10
37711,FremontBridge,01/21/2017 07:00:00 AM,48,-122,9,12,21
37712,FremontBridge,01/21/2017 08:00:00 AM,48,-122,34,30,64
37713,FremontBridge,01/21/2017 09:00:00 AM,48,-122,33,49,82
37714,FremontBridge,01/21/2017 10:00:00 AM,48,-122,42,78,120
37715,FremontBridge,01/21/2017 11:00:00 AM,48,-122,43,51,94
37716,FremontBridge,01/21/2017 12:00:00 PM,48,-122,54,75,129
37717,FremontBridge,01/21/2017 01:00:00 PM,48,-122,84,62,146
37718,FremontBridge,01/21/2017 02:00:00 PM,48,-122,128,59,187
37719,FremontBridge,01/21/2017 03:00:00 PM,48,-122,125,55,180
37720,FremontBridge,01/21/2017 04:00:00 PM,48,-122,69,49,118
37721,FremontBridge,01/21/2017 05:00:00 PM,48,-122,28,24,52
37722,FremontBridge,01/21/2017 06:00:00 PM,48,-122,31,8,39
37723,FremontBridge,01/21/2017 07:00:00 PM,48,-122,17,6,23
37724,FremontBridge,01/21/2017 08:00:00 PM,48,-122,7,3,10
37725,FremontBridge,01/21/2017 09:00:00 PM,48,-122,11,13,24
37726,FremontBridge,01/21/2017 10:00:00 PM,48,-122,5,10,15
37727,FremontBridge,01/21/2017 11:00:00 PM,48,-122,12,3,15
37728,FremontBridge,01/22/2017 12:00:00 AM,48,-122,5,3,8
37729,FremontBridge,01/22/2017 01:00:00 AM,48,-122,6,0,6
37730,FremontBridge,01/22/2017 02:00:00 AM,48,-122,1,2,3
37731,FremontBridge,01/22/2017 03:00:00 AM,48,-122,0,1,1
37732,FremontBridge,01/22/2017 04:00:00 AM,48,-122,0,0,0
37733,FremontBridge,01/22/2017 05:00:00 AM,48,-122,1,4,5
37734,FremontBridge,01/22/2017 06:00:00 AM,48,-122,0,2,2
37735,FremontBridge,01/22/2017 07:00:00 AM,48,-122,4,8,12
37736,FremontBridge,01/22/2017 08:00:00 AM,48,-122,12,9,21
37737,FremontBridge,01/22/2017 09:00:00 AM,48,-122,9,12,21
37738,FremontBridge,01/22/2017 10:00:00 AM,48,-122,8,9,17
37739,FremontBridge,01/22/2017 11:00:00 AM,48,-122,11,15,26
37740,FremontBridge,01/22/2017 12:00:00 PM,48,-122,15,13,28
37741,FremontBridge,01/22/2017 01:00:00 PM,48,-122,18,16,34
37742,FremontBridge,01/22/2017 02:00:00 PM,48,-122,18,22,40
37743,FremontBridge,01/22/2017 03:00:00 PM,48,-122,26,20,46
37744,FremontBridge,01/22/2017 04:00:00 PM,48,-122,20,32,52
37745,FremontBridge,01/22/2017 05:00:00 PM,48,-122,17,14,31
37746,FremontBridge,01/22/2017 06:00:00 PM,48,-122,14,14,28
37747,FremontBridge,01/22/2017 07:00:00 PM,48,-122,9,7,16
37748,FremontBridge,01/22/2017 08:00:00 PM,48,-122,8,7,15
37749,FremontBridge,01/22/2017 09:00:00 PM,48,-122,4,5,9
37750,FremontBridge,01/22/2017 10:00:00 PM,48,-122,3,2,5
37751,FremontBridge,01/22/2017 11:00:00 PM,48,-122,5,2,7
37752,FremontBridge,01/23/2017 12:00:00 AM,48,-122,1,0,1
37753,FremontBridge,01/23/2017 01:00:00 AM,48,-122,1,2,3
37754,FremontBridge,01/23/2017 02:00:00 AM,48,-122,1,1,2
37755,FremontBridge,01/23/2017 03:00:00 AM,48,-122,1,1,2
37756,FremontBridge,01/23/2017 04:00:00 AM,48,-122,2,1,3
37757,FremontBridge,01/23/2017 05:00:00 AM,48,-122,12,12,24
37758,FremontBridge,01/23/2017 06:00:00 AM,48,-122,35,59,94
37759,FremontBridge,01/23/2017 07:00:00 AM,48,-122,94,175,269
37760,FremontBridge,01/23/2017 08:00:00 AM,48,-122,150,256,406
37761,FremontBridge,01/23/2017 09:00:00 AM,48,-122,85,106,191
37762,FremontBridge,01/23/2017 10:00:00 AM,48,-122,45,44,89
37763,FremontBridge,01/23/2017 11:00:00 AM,48,-122,29,25,54
37764,FremontBridge,01/23/2017 12:00:00 PM,48,-122,39,25,64
37765,FremontBridge,01/23/2017 01:00:00 PM,48,-122,40,31,71
37766,FremontBridge,01/23/2017 02:00:00 PM,48,-122,48,25,73
37767,FremontBridge,01/23/2017 03:00:00 PM,48,-122,63,45,108
37768,FremontBridge,01/23/2017 04:00:00 PM,48,-122,128,81,209
37769,FremontBridge,01/23/2017 05:00:00 PM,48,-122,345,104,449
37770,FremontBridge,01/23/2017 06:00:00 PM,48,-122,187,90,277
37771,FremontBridge,01/23/2017 07:00:00 PM,48,-122,81,37,118
37772,FremontBridge,01/23/2017 08:00:00 PM,48,-122,45,22,67
37773,FremontBridge,01/23/2017 09:00:00 PM,48,-122,22,11,33
37774,FremontBridge,01/23/2017 10:00:00 PM,48,-122,11,6,17
37775,FremontBridge,01/23/2017 11:00:00 PM,48,-122,8,3,11
37776,FremontBridge,01/24/2017 12:00:00 AM,48,-122,2,3,5
37777,FremontBridge,01/24/2017 01:00:00 AM,48,-122,3,3,6
37778,FremontBridge,01/24/2017 02:00:00 AM,48,-122,1,2,3
37779,FremontBridge,01/24/2017 03:00:00 AM,48,-122,0,1,1
37780,FremontBridge,01/24/2017 04:00:00 AM,48,-122,2,3,5
37781,FremontBridge,01/24/2017 05:00:00 AM,48,-122,15,16,31
37782,FremontBridge,01/24/2017 06:00:00 AM,48,-122,36,58,94
37783,FremontBridge,01/24/2017 07:00:00 AM,48,-122,104,188,292
37784,FremontBridge,01/24/2017 08:00:00 AM,48,-122,139,232,371
37785,FremontBridge,01/24/2017 09:00:00 AM,48,-122,96,121,217
37786,FremontBridge,01/24/2017 10:00:00 AM,48,-122,45,38,83
37787,FremontBridge,01/24/2017 11:00:00 AM,48,-122,33,31,64
37788,FremontBridge,01/24/2017 12:00:00 PM,48,-122,20,28,48
37789,FremontBridge,01/24/2017 01:00:00 PM,48,-122,28,42,70
37790,FremontBridge,01/24/2017 02:00:00 PM,48,-122,25,22,47
37791,FremontBridge,01/24/2017 03:00:00 PM,48,-122,60,39,99
37792,FremontBridge,01/24/2017 04:00:00 PM,48,-122,131,50,181
37793,FremontBridge,01/24/2017 05:00:00 PM,48,-122,306,108,414
37794,FremontBridge,01/24/2017 06:00:00 PM,48,-122,193,86,279
37795,FremontBridge,01/24/2017 07:00:00 PM,48,-122,90,41,131
37796,FremontBridge,01/24/2017 08:00:00 PM,48,-122,44,18,62
37797,FremontBridge,01/24/2017 09:00:00 PM,48,-122,24,14,38
37798,FremontBridge,01/24/2017 10:00:00 PM,48,-122,13,5,18
37799,FremontBridge,01/24/2017 11:00:00 PM,48,-122,6,9,15
37800,FremontBridge,01/25/2017 12:00:00 AM,48,-122,5,6,11
37801,FremontBridge,01/25/2017 01:00:00 AM,48,-122,3,0,3
37802,FremontBridge,01/25/2017 02:00:00 AM,48,-122,0,1,1
37803,FremontBridge,01/25/2017 03:00:00 AM,48,-122,0,0,0
37804,FremontBridge,01/25/2017 04:00:00 AM,48,-122,0,7,7
37805,FremontBridge,01/25/2017 05:00:00 AM,48,-122,13,15,28
37806,FremontBridge,01/25/2017 06:00:00 AM,48,-122,41,59,100
37807,FremontBridge,01/25/2017 07:00:00 AM,48,-122,82,163,245
37808,FremontBridge,01/25/2017 08:00:00 AM,48,-122,152,233,385
37809,FremontBridge,01/25/2017 09:00:00 AM,48,-122,74,113,187
37810,FremontBridge,01/25/2017 10:00:00 AM,48,-122,40,28,68
37811,FremontBridge,01/25/2017 11:00:00 AM,48,-122,25,35,60
37812,FremontBridge,01/25/2017 12:00:00 PM,48,-122,21,31,52
37813,FremontBridge,01/25/2017 01:00:00 PM,48,-122,27,17,44
37814,FremontBridge,01/25/2017 02:00:00 PM,48,-122,23,17,40
37815,FremontBridge,01/25/2017 03:00:00 PM,48,-122,47,28,75
37816,FremontBridge,01/25/2017 04:00:00 PM,48,-122,105,62,167
37817,FremontBridge,01/25/2017 05:00:00 PM,48,-122,297,87,384
37818,FremontBridge,01/25/2017 06:00:00 PM,48,-122,176,83,259
37819,FremontBridge,01/25/2017 07:00:00 PM,48,-122,77,37,114
37820,FremontBridge,01/25/2017 08:00:00 PM,48,-122,27,22,49
37821,FremontBridge,01/25/2017 09:00:00 PM,48,-122,29,14,43
37822,FremontBridge,01/25/2017 10:00:00 PM,48,-122,9,3,12
37823,FremontBridge,01/25/2017 11:00:00 PM,48,-122,3,5,8
37824,FremontBridge,01/26/2017 12:00:00 AM,48,-122,2,3,5
37825,FremontBridge,01/26/2017 01:00:00 AM,48,-122,0,0,0
37826,FremontBridge,01/26/2017 02:00:00 AM,48,-122,2,3,5
37827,FremontBridge,01/26/2017 03:00:00 AM,48,-122,3,0,3
37828,FremontBridge,01/26/2017 04:00:00 AM,48,-122,2,5,7
37829,FremontBridge,01/26/2017 05:00:00 AM,48,-122,11,23,34
37830,FremontBridge,01/26/2017 06:00:00 AM,48,-122,40,63,103
37831,FremontBridge,01/26/2017 07:00:00 AM,48,-122,78,164,242
37832,FremontBridge,01/26/2017 08:00:00 AM,48,-122,154,247,401
37833,FremontBridge,01/26/2017 09:00:00 AM,48,-122,87,118,205
37834,FremontBridge,01/26/2017 10:00:00 AM,48,-122,35,22,57
37835,FremontBridge,01/26/2017 11:00:00 AM,48,-122,33,28,61
37836,FremontBridge,01/26/2017 12:00:00 PM,48,-122,31,20,51
37837,FremontBridge,01/26/2017 01:00:00 PM,48,-122,25,28,53
37838,FremontBridge,01/26/2017 02:00:00 PM,48,-122,36,29,65
37839,FremontBridge,01/26/2017 03:00:00 PM,48,-122,52,42,94
37840,FremontBridge,01/26/2017 04:00:00 PM,48,-122,138,72,210
37841,FremontBridge,01/26/2017 05:00:00 PM,48,-122,309,78,387
37842,FremontBridge,01/26/2017 06:00:00 PM,48,-122,184,89,273
37843,FremontBridge,01/26/2017 07:00:00 PM,48,-122,96,38,134
37844,FremontBridge,01/26/2017 08:00:00 PM,48,-122,41,14,55
37845,FremontBridge,01/26/2017 09:00:00 PM,48,-122,21,12,33
37846,FremontBridge,01/26/2017 10:00:00 PM,48,-122,15,12,27
37847,FremontBridge,01/26/2017 11:00:00 PM,48,-122,9,4,13
37848,FremontBridge,01/27/2017 12:00:00 AM,48,-122,5,1,6
37849,FremontBridge,01/27/2017 01:00:00 AM,48,-122,3,1,4
37850,FremontBridge,01/27/2017 02:00:00 AM,48,-122,0,1,1
37851,FremontBridge,01/27/2017 03:00:00 AM,48,-122,0,1,1
37852,FremontBridge,01/27/2017 04:00:00 AM,48,-122,3,4,7
37853,FremontBridge,01/27/2017 05:00:00 AM,48,-122,12,13,25
37854,FremontBridge,01/27/2017 06:00:00 AM,48,-122,22,45,67
37855,FremontBridge,01/27/2017 07:00:00 AM,48,-122,76,155,231
37856,FremontBridge,01/27/2017 08:00:00 AM,48,-122,148,194,342
37857,FremontBridge,01/27/2017 09:00:00 AM,48,-122,85,76,161
37858,FremontBridge,01/27/2017 10:00:00 AM,48,-122,41,41,82
37859,FremontBridge,01/27/2017 11:00:00 AM,48,-122,39,38,77
37860,FremontBridge,01/27/2017 12:00:00 PM,48,-122,28,29,57
37861,FremontBridge,01/27/2017 01:00:00 PM,48,-122,45,35,80
37862,FremontBridge,01/27/2017 02:00:00 PM,48,-122,40,47,87
37863,FremontBridge,01/27/2017 03:00:00 PM,48,-122,61,54,115
37864,FremontBridge,01/27/2017 04:00:00 PM,48,-122,179,81,260
37865,FremontBridge,01/27/2017 05:00:00 PM,48,-122,284,97,381
37866,FremontBridge,01/27/2017 06:00:00 PM,48,-122,154,60,214
37867,FremontBridge,01/27/2017 07:00:00 PM,48,-122,49,29,78
37868,FremontBridge,01/27/2017 08:00:00 PM,48,-122,26,11,37
37869,FremontBridge,01/27/2017 09:00:00 PM,48,-122,18,5,23
37870,FremontBridge,01/27/2017 10:00:00 PM,48,-122,23,6,29
37871,FremontBridge,01/27/2017 11:00:00 PM,48,-122,10,8,18
37872,FremontBridge,01/28/2017 12:00:00 AM,48,-122,8,5,13
37873,FremontBridge,01/28/2017 01:00:00 AM,48,-122,2,3,5
37874,FremontBridge,01/28/2017 02:00:00 AM,48,-122,2,1,3
37875,FremontBridge,01/28/2017 03:00:00 AM,48,-122,0,0,0
37876,FremontBridge,01/28/2017 04:00:00 AM,48,-122,2,1,3
37877,FremontBridge,01/28/2017 05:00:00 AM,48,-122,2,1,3
37878,FremontBridge,01/28/2017 06:00:00 AM,48,-122,4,2,6
37879,FremontBridge,01/28/2017 07:00:00 AM,48,-122,14,9,23
37880,FremontBridge,01/28/2017 08:00:00 AM,48,-122,21,33,54
37881,FremontBridge,01/28/2017 09:00:00 AM,48,-122,25,29,54
37882,FremontBridge,01/28/2017 10:00:00 AM,48,-122,36,63,99
37883,FremontBridge,01/28/2017 11:00:00 AM,48,-122,47,60,107
37884,FremontBridge,01/28/2017 12:00:00 PM,48,-122,46,56,102
37885,FremontBridge,01/28/2017 01:00:00 PM,48,-122,54,77,131
37886,FremontBridge,01/28/2017 02:00:00 PM,48,-122,34,75,109
37887,FremontBridge,01/28/2017 03:00:00 PM,48,-122,71,55,126
37888,FremontBridge,01/28/2017 04:00:00 PM,48,-122,58,78,136
37889,FremontBridge,01/28/2017 05:00:00 PM,48,-122,41,29,70
37890,FremontBridge,01/28/2017 06:00:00 PM,48,-122,31,28,59
37891,FremontBridge,01/28/2017 07:00:00 PM,48,-122,20,11,31
37892,FremontBridge,01/28/2017 08:00:00 PM,48,-122,19,7,26
37893,FremontBridge,01/28/2017 09:00:00 PM,48,-122,13,12,25
37894,FremontBridge,01/28/2017 10:00:00 PM,48,-122,14,3,17
37895,FremontBridge,01/28/2017 11:00:00 PM,48,-122,10,3,13
37896,FremontBridge,01/29/2017 12:00:00 AM,48,-122,11,6,17
37897,FremontBridge,01/29/2017 01:00:00 AM,48,-122,4,2,6
37898,FremontBridge,01/29/2017 02:00:00 AM,48,-122,3,1,4
37899,FremontBridge,01/29/2017 03:00:00 AM,48,-122,2,1,3
37900,FremontBridge,01/29/2017 04:00:00 AM,48,-122,1,0,1
37901,FremontBridge,01/29/2017 05:00:00 AM,48,-122,3,4,7
37902,FremontBridge,01/29/2017 06:00:00 AM,48,-122,4,4,8
37903,FremontBridge,01/29/2017 07:00:00 AM,48,-122,7,5,12
37904,FremontBridge,01/29/2017 08:00:00 AM,48,-122,22,19,41
37905,FremontBridge,01/29/2017 09:00:00 AM,48,-122,22,30,52
37906,FremontBridge,01/29/2017 10:00:00 AM,48,-122,37,23,60
37907,FremontBridge,01/29/2017 11:00:00 AM,48,-122,33,41,74
37908,FremontBridge,01/29/2017 12:00:00 PM,48,-122,38,50,88
37909,FremontBridge,01/29/2017 01:00:00 PM,48,-122,35,28,63
37910,FremontBridge,01/29/2017 02:00:00 PM,48,-122,20,38,58
37911,FremontBridge,01/29/2017 03:00:00 PM,48,-122,21,36,57
37912,FremontBridge,01/29/2017 04:00:00 PM,48,-122,36,23,59
37913,FremontBridge,01/29/2017 05:00:00 PM,48,-122,30,32,62
37914,FremontBridge,01/29/2017 06:00:00 PM,48,-122,23,15,38
37915,FremontBridge,01/29/2017 07:00:00 PM,48,-122,42,2,44
37916,FremontBridge,01/29/2017 08:00:00 PM,48,-122,21,5,26
37917,FremontBridge,01/29/2017 09:00:00 PM,48,-122,7,6,13
37918,FremontBridge,01/29/2017 10:00:00 PM,48,-122,7,6,13
37919,FremontBridge,01/29/2017 11:00:00 PM,48,-122,7,1,8
37920,FremontBridge,01/30/2017 12:00:00 AM,48,-122,1,0,1
37921,FremontBridge,01/30/2017 01:00:00 AM,48,-122,2,0,2
37922,FremontBridge,01/30/2017 02:00:00 AM,48,-122,1,1,2
37923,FremontBridge,01/30/2017 03:00:00 AM,48,-122,1,1,2
37924,FremontBridge,01/30/2017 04:00:00 AM,48,-122,4,2,6
37925,FremontBridge,01/30/2017 05:00:00 AM,48,-122,13,19,32
37926,FremontBridge,01/30/2017 06:00:00 AM,48,-122,41,62,103
37927,FremontBridge,01/30/2017 07:00:00 AM,48,-122,100,206,306
37928,FremontBridge,01/30/2017 08:00:00 AM,48,-122,154,256,410
37929,FremontBridge,01/30/2017 09:00:00 AM,48,-122,87,102,189
37930,FremontBridge,01/30/2017 10:00:00 AM,48,-122,40,39,79
37931,FremontBridge,01/30/2017 11:00:00 AM,48,-122,22,28,50
37932,FremontBridge,01/30/2017 12:00:00 PM,48,-122,34,12,46
37933,FremontBridge,01/30/2017 01:00:00 PM,48,-122,34,26,60
37934,FremontBridge,01/30/2017 02:00:00 PM,48,-122,38,30,68
37935,FremontBridge,01/30/2017 03:00:00 PM,48,-122,64,39,103
37936,FremontBridge,01/30/2017 04:00:00 PM,48,-122,136,64,200
37937,FremontBridge,01/30/2017 05:00:00 PM,48,-122,354,100,454
37938,FremontBridge,01/30/2017 06:00:00 PM,48,-122,228,74,302
37939,FremontBridge,01/30/2017 07:00:00 PM,48,-122,86,28,114
37940,FremontBridge,01/30/2017 08:00:00 PM,48,-122,36,19,55
37941,FremontBridge,01/30/2017 09:00:00 PM,48,-122,28,9,37
37942,FremontBridge,01/30/2017 10:00:00 PM,48,-122,9,6,15
37943,FremontBridge,01/30/2017 11:00:00 PM,48,-122,4,5,9
37944,FremontBridge,01/31/2017 12:00:00 AM,48,-122,2,1,3
37945,FremontBridge,01/31/2017 01:00:00 AM,48,-122,1,1,2
37946,FremontBridge,01/31/2017 02:00:00 AM,48,-122,0,0,0
37947,FremontBridge,01/31/2017 03:00:00 AM,48,-122,0,1,1
37948,FremontBridge,01/31/2017 04:00:00 AM,48,-122,3,3,6
37949,FremontBridge,01/31/2017 05:00:00 AM,48,-122,16,17,33
37950,FremontBridge,01/31/2017 06:00:00 AM,48,-122,36,67,103
37951,FremontBridge,01/31/2017 07:00:00 AM,48,-122,109,195,304
37952,FremontBridge,01/31/2017 08:00:00 AM,48,-122,168,237,405
37953,FremontBridge,01/31/2017 09:00:00 AM,48,-122,100,98,198
37954,FremontBridge,01/31/2017 10:00:00 AM,48,-122,40,43,83
37955,FremontBridge,01/31/2017 11:00:00 AM,48,-122,23,24,47
37956,FremontBridge,01/31/2017 12:00:00 PM,48,-122,18,29,47
37957,FremontBridge,01/31/2017 01:00:00 PM,48,-122,27,24,51
37958,FremontBridge,01/31/2017 02:00:00 PM,48,-122,26,18,44
37959,FremontBridge,01/31/2017 03:00:00 PM,48,-122,58,52,110
37960,FremontBridge,01/31/2017 04:00:00 PM,48,-122,135,73,208
37961,FremontBridge,01/31/2017 05:00:00 PM,48,-122,341,93,434
37962,FremontBridge,01/31/2017 06:00:00 PM,48,-122,194,89,283
37963,FremontBridge,01/31/2017 07:00:00 PM,48,-122,89,27,116
37964,FremontBridge,01/31/2017 08:00:00 PM,48,-122,39,25,64
37965,FremontBridge,01/31/2017 09:00:00 PM,48,-122,13,19,32
37966,FremontBridge,01/31/2017 10:00:00 PM,48,-122,15,4,19
37967,FremontBridge,01/31/2017 11:00:00 PM,48,-122,9,6,15
37968,FremontBridge,02/01/2017 12:00:00 AM,48,-122,4,3,7
37969,FremontBridge,02/01/2017 01:00:00 AM,48,-122,0,0,0
37970,FremontBridge,02/01/2017 02:00:00 AM,48,-122,1,0,1
37971,FremontBridge,02/01/2017 03:00:00 AM,48,-122,1,0,1
37972,FremontBridge,02/01/2017 04:00:00 AM,48,-122,1,3,4
37973,FremontBridge,02/01/2017 05:00:00 AM,48,-122,10,18,28
37974,FremontBridge,02/01/2017 06:00:00 AM,48,-122,33,54,87
37975,FremontBridge,02/01/2017 07:00:00 AM,48,-122,90,154,244
37976,FremontBridge,02/01/2017 08:00:00 AM,48,-122,139,216,355
37977,FremontBridge,02/01/2017 09:00:00 AM,48,-122,95,106,201
37978,FremontBridge,02/01/2017 10:00:00 AM,48,-122,32,39,71
37979,FremontBridge,02/01/2017 11:00:00 AM,48,-122,24,24,48
37980,FremontBridge,02/01/2017 12:00:00 PM,48,-122,21,27,48
37981,FremontBridge,02/01/2017 01:00:00 PM,48,-122,27,29,56
37982,FremontBridge,02/01/2017 02:00:00 PM,48,-122,31,25,56
37983,FremontBridge,02/01/2017 03:00:00 PM,48,-122,62,58,120
37984,FremontBridge,02/01/2017 04:00:00 PM,48,-122,112,70,182
37985,FremontBridge,02/01/2017 05:00:00 PM,48,-122,280,85,365
37986,FremontBridge,02/01/2017 06:00:00 PM,48,-122,191,85,276
37987,FremontBridge,02/01/2017 07:00:00 PM,48,-122,81,32,113
37988,FremontBridge,02/01/2017 08:00:00 PM,48,-122,47,23,70
37989,FremontBridge,02/01/2017 09:00:00 PM,48,-122,26,15,41
37990,FremontBridge,02/01/2017 10:00:00 PM,48,-122,15,3,18
37991,FremontBridge,02/01/2017 11:00:00 PM,48,-122,6,8,14
37992,FremontBridge,02/02/2017 12:00:00 AM,48,-122,3,2,5
37993,FremontBridge,02/02/2017 01:00:00 AM,48,-122,0,2,2
37994,FremontBridge,02/02/2017 02:00:00 AM,48,-122,0,0,0
37995,FremontBridge,02/02/2017 03:00:00 AM,48,-122,0,1,1
37996,FremontBridge,02/02/2017 04:00:00 AM,48,-122,2,3,5
37997,FremontBridge,02/02/2017 05:00:00 AM,48,-122,13,21,34
37998,FremontBridge,02/02/2017 06:00:00 AM,48,-122,37,51,88
37999,FremontBridge,02/02/2017 07:00:00 AM,48,-122,80,136,216
38000,FremontBridge,02/02/2017 08:00:00 AM,48,-122,139,228,367
38001,FremontBridge,02/02/2017 09:00:00 AM,48,-122,88,106,194
38002,FremontBridge,02/02/2017 10:00:00 AM,48,-122,37,31,68
38003,FremontBridge,02/02/2017 11:00:00 AM,48,-122,27,27,54
38004,FremontBridge,02/02/2017 12:00:00 PM,48,-122,17,25,42
38005,FremontBridge,02/02/2017 01:00:00 PM,48,-122,19,32,51
38006,FremontBridge,02/02/2017 02:00:00 PM,48,-122,38,25,63
38007,FremontBridge,02/02/2017 03:00:00 PM,48,-122,51,40,91
38008,FremontBridge,02/02/2017 04:00:00 PM,48,-122,122,76,198
38009,FremontBridge,02/02/2017 05:00:00 PM,48,-122,274,91,365
38010,FremontBridge,02/02/2017 06:00:00 PM,48,-122,172,86,258
38011,FremontBridge,02/02/2017 07:00:00 PM,48,-122,86,28,114
38012,FremontBridge,02/02/2017 08:00:00 PM,48,-122,48,19,67
38013,FremontBridge,02/02/2017 09:00:00 PM,48,-122,27,16,43
38014,FremontBridge,02/02/2017 10:00:00 PM,48,-122,15,5,20
38015,FremontBridge,02/02/2017 11:00:00 PM,48,-122,3,5,8
38016,FremontBridge,02/03/2017 12:00:00 AM,48,-122,2,0,2
38017,FremontBridge,02/03/2017 01:00:00 AM,48,-122,2,1,3
38018,FremontBridge,02/03/2017 02:00:00 AM,48,-122,1,0,1
38019,FremontBridge,02/03/2017 03:00:00 AM,48,-122,0,0,0
38020,FremontBridge,02/03/2017 04:00:00 AM,48,-122,2,2,4
38021,FremontBridge,02/03/2017 05:00:00 AM,48,-122,9,12,21
38022,FremontBridge,02/03/2017 06:00:00 AM,48,-122,11,24,35
38023,FremontBridge,02/03/2017 07:00:00 AM,48,-122,32,61,93
38024,FremontBridge,02/03/2017 08:00:00 AM,48,-122,82,83,165
38025,FremontBridge,02/03/2017 09:00:00 AM,48,-122,50,63,113
38026,FremontBridge,02/03/2017 10:00:00 AM,48,-122,24,25,49
38027,FremontBridge,02/03/2017 11:00:00 AM,48,-122,18,15,33
38028,FremontBridge,02/03/2017 12:00:00 PM,48,-122,10,13,23
38029,FremontBridge,02/03/2017 01:00:00 PM,48,-122,9,7,16
38030,FremontBridge,02/03/2017 02:00:00 PM,48,-122,19,13,32
38031,FremontBridge,02/03/2017 03:00:00 PM,48,-122,18,18,36
38032,FremontBridge,02/03/2017 04:00:00 PM,48,-122,57,25,82
38033,FremontBridge,02/03/2017 05:00:00 PM,48,-122,137,39,176
38034,FremontBridge,02/03/2017 06:00:00 PM,48,-122,95,34,129
38035,FremontBridge,02/03/2017 07:00:00 PM,48,-122,30,16,46
38036,FremontBridge,02/03/2017 08:00:00 PM,48,-122,16,5,21
38037,FremontBridge,02/03/2017 09:00:00 PM,48,-122,14,2,16
38038,FremontBridge,02/03/2017 10:00:00 PM,48,-122,10,1,11
38039,FremontBridge,02/03/2017 11:00:00 PM,48,-122,8,6,14
38040,FremontBridge,02/04/2017 12:00:00 AM,48,-122,3,4,7
38041,FremontBridge,02/04/2017 01:00:00 AM,48,-122,0,0,0
38042,FremontBridge,02/04/2017 02:00:00 AM,48,-122,4,0,4
38043,FremontBridge,02/04/2017 03:00:00 AM,48,-122,1,0,1
38044,FremontBridge,02/04/2017 04:00:00 AM,48,-122,2,0,2
38045,FremontBridge,02/04/2017 05:00:00 AM,48,-122,1,3,4
38046,FremontBridge,02/04/2017 06:00:00 AM,48,-122,4,4,8
38047,FremontBridge,02/04/2017 07:00:00 AM,48,-122,4,3,7
38048,FremontBridge,02/04/2017 08:00:00 AM,48,-122,14,19,33
38049,FremontBridge,02/04/2017 09:00:00 AM,48,-122,11,15,26
38050,FremontBridge,02/04/2017 10:00:00 AM,48,-122,5,20,25
38051,FremontBridge,02/04/2017 11:00:00 AM,48,-122,10,23,33
38052,FremontBridge,02/04/2017 12:00:00 PM,48,-122,15,16,31
38053,FremontBridge,02/04/2017 01:00:00 PM,48,-122,8,12,20
38054,FremontBridge,02/04/2017 02:00:00 PM,48,-122,9,9,18
38055,FremontBridge,02/04/2017 03:00:00 PM,48,-122,11,13,24
38056,FremontBridge,02/04/2017 04:00:00 PM,48,-122,7,11,18
38057,FremontBridge,02/04/2017 05:00:00 PM,48,-122,13,15,28
38058,FremontBridge,02/04/2017 06:00:00 PM,48,-122,11,7,18
38059,FremontBridge,02/04/2017 07:00:00 PM,48,-122,8,12,20
38060,FremontBridge,02/04/2017 08:00:00 PM,48,-122,3,4,7
38061,FremontBridge,02/04/2017 09:00:00 PM,48,-122,7,3,10
38062,FremontBridge,02/04/2017 10:00:00 PM,48,-122,2,2,4
38063,FremontBridge,02/04/2017 11:00:00 PM,48,-122,2,3,5
38064,FremontBridge,02/05/2017 12:00:00 AM,48,-122,5,2,7
38065,FremontBridge,02/05/2017 01:00:00 AM,48,-122,1,0,1
38066,FremontBridge,02/05/2017 02:00:00 AM,48,-122,0,0,0
38067,FremontBridge,02/05/2017 03:00:00 AM,48,-122,0,0,0
38068,FremontBridge,02/05/2017 04:00:00 AM,48,-122,0,1,1
38069,FremontBridge,02/05/2017 05:00:00 AM,48,-122,1,1,2
38070,FremontBridge,02/05/2017 06:00:00 AM,48,-122,5,3,8
38071,FremontBridge,02/05/2017 07:00:00 AM,48,-122,3,10,13
38072,FremontBridge,02/05/2017 08:00:00 AM,48,-122,10,12,22
38073,FremontBridge,02/05/2017 09:00:00 AM,48,-122,10,18,28
38074,FremontBridge,02/05/2017 10:00:00 AM,48,-122,15,14,29
38075,FremontBridge,02/05/2017 11:00:00 AM,48,-122,8,16,24
38076,FremontBridge,02/05/2017 12:00:00 PM,48,-122,14,14,28
38077,FremontBridge,02/05/2017 01:00:00 PM,48,-122,10,11,21
38078,FremontBridge,02/05/2017 02:00:00 PM,48,-122,10,16,26
38079,FremontBridge,02/05/2017 03:00:00 PM,48,-122,8,8,16
38080,FremontBridge,02/05/2017 04:00:00 PM,48,-122,6,7,13
38081,FremontBridge,02/05/2017 05:00:00 PM,48,-122,7,7,14
38082,FremontBridge,02/05/2017 06:00:00 PM,48,-122,5,5,10
38083,FremontBridge,02/05/2017 07:00:00 PM,48,-122,7,4,11
38084,FremontBridge,02/05/2017 08:00:00 PM,48,-122,6,7,13
38085,FremontBridge,02/05/2017 09:00:00 PM,48,-122,1,1,2
38086,FremontBridge,02/05/2017 10:00:00 PM,48,-122,0,1,1
38087,FremontBridge,02/05/2017 11:00:00 PM,48,-122,1,1,2
38088,FremontBridge,02/06/2017 12:00:00 AM,48,-122,3,1,4
38089,FremontBridge,02/06/2017 01:00:00 AM,48,-122,0,1,1
38090,FremontBridge,02/06/2017 02:00:00 AM,48,-122,0,0,0
38091,FremontBridge,02/06/2017 03:00:00 AM,48,-122,0,0,0
38092,FremontBridge,02/06/2017 04:00:00 AM,48,-122,0,2,2
38093,FremontBridge,02/06/2017 05:00:00 AM,48,-122,2,2,4
38094,FremontBridge,02/06/2017 06:00:00 AM,48,-122,4,5,9
38095,FremontBridge,02/06/2017 07:00:00 AM,48,-122,13,9,22
38096,FremontBridge,02/06/2017 08:00:00 AM,48,-122,17,26,43
38097,FremontBridge,02/06/2017 09:00:00 AM,48,-122,17,12,29
38098,FremontBridge,02/06/2017 10:00:00 AM,48,-122,14,11,25
38099,FremontBridge,02/06/2017 11:00:00 AM,48,-122,8,3,11
38100,FremontBridge,02/06/2017 12:00:00 PM,48,-122,8,1,9
38101,FremontBridge,02/06/2017 01:00:00 PM,48,-122,8,6,14
38102,FremontBridge,02/06/2017 02:00:00 PM,48,-122,8,6,14
38103,FremontBridge,02/06/2017 03:00:00 PM,48,-122,10,10,20
38104,FremontBridge,02/06/2017 04:00:00 PM,48,-122,20,9,29
38105,FremontBridge,02/06/2017 05:00:00 PM,48,-122,44,17,61
38106,FremontBridge,02/06/2017 06:00:00 PM,48,-122,20,6,26
38107,FremontBridge,02/06/2017 07:00:00 PM,48,-122,14,3,17
38108,FremontBridge,02/06/2017 08:00:00 PM,48,-122,8,6,14
38109,FremontBridge,02/06/2017 09:00:00 PM,48,-122,3,5,8
38110,FremontBridge,02/06/2017 10:00:00 PM,48,-122,4,0,4
38111,FremontBridge,02/06/2017 11:00:00 PM,48,-122,0,2,2
38112,FremontBridge,02/07/2017 12:00:00 AM,48,-122,0,1,1
38113,FremontBridge,02/07/2017 01:00:00 AM,48,-122,1,0,1
38114,FremontBridge,02/07/2017 02:00:00 AM,48,-122,0,0,0
38115,FremontBridge,02/07/2017 03:00:00 AM,48,-122,0,0,0
38116,FremontBridge,02/07/2017 04:00:00 AM,48,-122,2,1,3
38117,FremontBridge,02/07/2017 05:00:00 AM,48,-122,9,9,18
38118,FremontBridge,02/07/2017 06:00:00 AM,48,-122,18,25,43
38119,FremontBridge,02/07/2017 07:00:00 AM,48,-122,48,71,119
38120,FremontBridge,02/07/2017 08:00:00 AM,48,-122,89,130,219
38121,FremontBridge,02/07/2017 09:00:00 AM,48,-122,51,62,113
38122,FremontBridge,02/07/2017 10:00:00 AM,48,-122,19,27,46
38123,FremontBridge,02/07/2017 11:00:00 AM,48,-122,12,16,28
38124,FremontBridge,02/07/2017 12:00:00 PM,48,-122,11,14,25
38125,FremontBridge,02/07/2017 01:00:00 PM,48,-122,22,14,36
38126,FremontBridge,02/07/2017 02:00:00 PM,48,-122,12,9,21
38127,FremontBridge,02/07/2017 03:00:00 PM,48,-122,39,17,56
38128,FremontBridge,02/07/2017 04:00:00 PM,48,-122,66,30,96
38129,FremontBridge,02/07/2017 05:00:00 PM,48,-122,188,61,249
38130,FremontBridge,02/07/2017 06:00:00 PM,48,-122,121,58,179
38131,FremontBridge,02/07/2017 07:00:00 PM,48,-122,46,20,66
38132,FremontBridge,02/07/2017 08:00:00 PM,48,-122,23,19,42
38133,FremontBridge,02/07/2017 09:00:00 PM,48,-122,17,9,26
38134,FremontBridge,02/07/2017 10:00:00 PM,48,-122,6,3,9
38135,FremontBridge,02/07/2017 11:00:00 PM,48,-122,6,1,7
38136,FremontBridge,02/08/2017 12:00:00 AM,48,-122,1,3,4
38137,FremontBridge,02/08/2017 01:00:00 AM,48,-122,1,0,1
38138,FremontBridge,02/08/2017 02:00:00 AM,48,-122,3,1,4
38139,FremontBridge,02/08/2017 03:00:00 AM,48,-122,1,0,1
38140,FremontBridge,02/08/2017 04:00:00 AM,48,-122,2,5,7
38141,FremontBridge,02/08/2017 05:00:00 AM,48,-122,6,17,23
38142,FremontBridge,02/08/2017 06:00:00 AM,48,-122,21,49,70
38143,FremontBridge,02/08/2017 07:00:00 AM,48,-122,51,101,152
38144,FremontBridge,02/08/2017 08:00:00 AM,48,-122,126,138,264
38145,FremontBridge,02/08/2017 09:00:00 AM,48,-122,58,59,117
38146,FremontBridge,02/08/2017 10:00:00 AM,48,-122,17,25,42
38147,FremontBridge,02/08/2017 11:00:00 AM,48,-122,14,10,24
38148,FremontBridge,02/08/2017 12:00:00 PM,48,-122,9,6,15
38149,FremontBridge,02/08/2017 01:00:00 PM,48,-122,10,14,24
38150,FremontBridge,02/08/2017 02:00:00 PM,48,-122,13,7,20
38151,FremontBridge,02/08/2017 03:00:00 PM,48,-122,29,16,45
38152,FremontBridge,02/08/2017 04:00:00 PM,48,-122,76,20,96
38153,FremontBridge,02/08/2017 05:00:00 PM,48,-122,181,57,238
38154,FremontBridge,02/08/2017 06:00:00 PM,48,-122,108,58,166
38155,FremontBridge,02/08/2017 07:00:00 PM,48,-122,52,18,70
38156,FremontBridge,02/08/2017 08:00:00 PM,48,-122,19,6,25
38157,FremontBridge,02/08/2017 09:00:00 PM,48,-122,8,4,12
38158,FremontBridge,02/08/2017 10:00:00 PM,48,-122,13,0,13
38159,FremontBridge,02/08/2017 11:00:00 PM,48,-122,1,2,3
38160,FremontBridge,02/09/2017 12:00:00 AM,48,-122,1,0,1
38161,FremontBridge,02/09/2017 01:00:00 AM,48,-122,0,1,1
38162,FremontBridge,02/09/2017 02:00:00 AM,48,-122,0,1,1
38163,FremontBridge,02/09/2017 03:00:00 AM,48,-122,0,1,1
38164,FremontBridge,02/09/2017 04:00:00 AM,48,-122,3,2,5
38165,FremontBridge,02/09/2017 05:00:00 AM,48,-122,8,9,17
38166,FremontBridge,02/09/2017 06:00:00 AM,48,-122,20,40,60
38167,FremontBridge,02/09/2017 07:00:00 AM,48,-122,44,92,136
38168,FremontBridge,02/09/2017 08:00:00 AM,48,-122,79,87,166
38169,FremontBridge,02/09/2017 09:00:00 AM,48,-122,51,46,97
38170,FremontBridge,02/09/2017 10:00:00 AM,48,-122,23,15,38
38171,FremontBridge,02/09/2017 11:00:00 AM,48,-122,18,11,29
38172,FremontBridge,02/09/2017 12:00:00 PM,48,-122,15,9,24
38173,FremontBridge,02/09/2017 01:00:00 PM,48,-122,4,10,14
38174,FremontBridge,02/09/2017 02:00:00 PM,48,-122,13,17,30
38175,FremontBridge,02/09/2017 03:00:00 PM,48,-122,25,18,43
38176,FremontBridge,02/09/2017 04:00:00 PM,48,-122,59,42,101
38177,FremontBridge,02/09/2017 05:00:00 PM,48,-122,150,57,207
38178,FremontBridge,02/09/2017 06:00:00 PM,48,-122,97,54,151
38179,FremontBridge,02/09/2017 07:00:00 PM,48,-122,43,15,58
38180,FremontBridge,02/09/2017 08:00:00 PM,48,-122,18,11,29
38181,FremontBridge,02/09/2017 09:00:00 PM,48,-122,12,10,22
38182,FremontBridge,02/09/2017 10:00:00 PM,48,-122,8,1,9
38183,FremontBridge,02/09/2017 11:00:00 PM,48,-122,5,1,6
38184,FremontBridge,02/10/2017 12:00:00 AM,48,-122,2,2,4
38185,FremontBridge,02/10/2017 01:00:00 AM,48,-122,1,0,1
38186,FremontBridge,02/10/2017 02:00:00 AM,48,-122,1,2,3
38187,FremontBridge,02/10/2017 03:00:00 AM,48,-122,0,1,1
38188,FremontBridge,02/10/2017 04:00:00 AM,48,-122,2,5,7
38189,FremontBridge,02/10/2017 05:00:00 AM,48,-122,12,11,23
38190,FremontBridge,02/10/2017 06:00:00 AM,48,-122,19,43,62
38191,FremontBridge,02/10/2017 07:00:00 AM,48,-122,60,123,183
38192,FremontBridge,02/10/2017 08:00:00 AM,48,-122,105,153,258
38193,FremontBridge,02/10/2017 09:00:00 AM,48,-122,75,71,146
38194,FremontBridge,02/10/2017 10:00:00 AM,48,-122,30,22,52
38195,FremontBridge,02/10/2017 11:00:00 AM,48,-122,20,18,38
38196,FremontBridge,02/10/2017 12:00:00 PM,48,-122,17,14,31
38197,FremontBridge,02/10/2017 01:00:00 PM,48,-122,13,21,34
38198,FremontBridge,02/10/2017 02:00:00 PM,48,-122,13,13,26
38199,FremontBridge,02/10/2017 03:00:00 PM,48,-122,41,25,66
38200,FremontBridge,02/10/2017 04:00:00 PM,48,-122,89,50,139
38201,FremontBridge,02/10/2017 05:00:00 PM,48,-122,221,75,296
38202,FremontBridge,02/10/2017 06:00:00 PM,48,-122,133,40,173
38203,FremontBridge,02/10/2017 07:00:00 PM,48,-122,56,20,76
38204,FremontBridge,02/10/2017 08:00:00 PM,48,-122,33,8,41
38205,FremontBridge,02/10/2017 09:00:00 PM,48,-122,9,7,16
38206,FremontBridge,02/10/2017 10:00:00 PM,48,-122,11,4,15
38207,FremontBridge,02/10/2017 11:00:00 PM,48,-122,8,8,16
38208,FremontBridge,02/11/2017 12:00:00 AM,48,-122,2,4,6
38209,FremontBridge,02/11/2017 01:00:00 AM,48,-122,0,3,3
38210,FremontBridge,02/11/2017 02:00:00 AM,48,-122,1,2,3
38211,FremontBridge,02/11/2017 03:00:00 AM,48,-122,1,0,1
38212,FremontBridge,02/11/2017 04:00:00 AM,48,-122,1,1,2
38213,FremontBridge,02/11/2017 05:00:00 AM,48,-122,0,3,3
38214,FremontBridge,02/11/2017 06:00:00 AM,48,-122,8,2,10
38215,FremontBridge,02/11/2017 07:00:00 AM,48,-122,9,8,17
38216,FremontBridge,02/11/2017 08:00:00 AM,48,-122,17,25,42
38217,FremontBridge,02/11/2017 09:00:00 AM,48,-122,26,27,53
38218,FremontBridge,02/11/2017 10:00:00 AM,48,-122,28,36,64
38219,FremontBridge,02/11/2017 11:00:00 AM,48,-122,34,52,86
38220,FremontBridge,02/11/2017 12:00:00 PM,48,-122,37,51,88
38221,FremontBridge,02/11/2017 01:00:00 PM,48,-122,44,55,99
38222,FremontBridge,02/11/2017 02:00:00 PM,48,-122,69,56,125
38223,FremontBridge,02/11/2017 03:00:00 PM,48,-122,63,46,109
38224,FremontBridge,02/11/2017 04:00:00 PM,48,-122,41,41,82
38225,FremontBridge,02/11/2017 05:00:00 PM,48,-122,35,37,72
38226,FremontBridge,02/11/2017 06:00:00 PM,48,-122,23,10,33
38227,FremontBridge,02/11/2017 07:00:00 PM,48,-122,20,11,31
38228,FremontBridge,02/11/2017 08:00:00 PM,48,-122,10,10,20
38229,FremontBridge,02/11/2017 09:00:00 PM,48,-122,31,6,37
38230,FremontBridge,02/11/2017 10:00:00 PM,48,-122,13,11,24
38231,FremontBridge,02/11/2017 11:00:00 PM,48,-122,8,5,13
38232,FremontBridge,02/12/2017 12:00:00 AM,48,-122,5,1,6
38233,FremontBridge,02/12/2017 01:00:00 AM,48,-122,4,3,7
38234,FremontBridge,02/12/2017 02:00:00 AM,48,-122,2,2,4
38235,FremontBridge,02/12/2017 03:00:00 AM,48,-122,0,2,2
38236,FremontBridge,02/12/2017 04:00:00 AM,48,-122,0,3,3
38237,FremontBridge,02/12/2017 05:00:00 AM,48,-122,0,0,0
38238,FremontBridge,02/12/2017 06:00:00 AM,48,-122,4,1,5
38239,FremontBridge,02/12/2017 07:00:00 AM,48,-122,5,11,16
38240,FremontBridge,02/12/2017 08:00:00 AM,48,-122,17,19,36
38241,FremontBridge,02/12/2017 09:00:00 AM,48,-122,20,23,43
38242,FremontBridge,02/12/2017 10:00:00 AM,48,-122,30,44,74
38243,FremontBridge,02/12/2017 11:00:00 AM,48,-122,38,46,84
38244,FremontBridge,02/12/2017 12:00:00 PM,48,-122,51,67,118
38245,FremontBridge,02/12/2017 01:00:00 PM,48,-122,59,68,127
38246,FremontBridge,02/12/2017 02:00:00 PM,48,-122,89,102,191
38247,FremontBridge,02/12/2017 03:00:00 PM,48,-122,87,75,162
38248,FremontBridge,02/12/2017 04:00:00 PM,48,-122,79,76,155
38249,FremontBridge,02/12/2017 05:00:00 PM,48,-122,31,36,67
38250,FremontBridge,02/12/2017 06:00:00 PM,48,-122,27,14,41
38251,FremontBridge,02/12/2017 07:00:00 PM,48,-122,24,14,38
38252,FremontBridge,02/12/2017 08:00:00 PM,48,-122,18,5,23
38253,FremontBridge,02/12/2017 09:00:00 PM,48,-122,6,7,13
38254,FremontBridge,02/12/2017 10:00:00 PM,48,-122,4,7,11
38255,FremontBridge,02/12/2017 11:00:00 PM,48,-122,3,2,5
38256,FremontBridge,02/13/2017 12:00:00 AM,48,-122,2,0,2
38257,FremontBridge,02/13/2017 01:00:00 AM,48,-122,3,0,3
38258,FremontBridge,02/13/2017 02:00:00 AM,48,-122,0,0,0
38259,FremontBridge,02/13/2017 03:00:00 AM,48,-122,0,0,0
38260,FremontBridge,02/13/2017 04:00:00 AM,48,-122,1,3,4
38261,FremontBridge,02/13/2017 05:00:00 AM,48,-122,9,20,29
38262,FremontBridge,02/13/2017 06:00:00 AM,48,-122,45,67,112
38263,FremontBridge,02/13/2017 07:00:00 AM,48,-122,104,186,290
38264,FremontBridge,02/13/2017 08:00:00 AM,48,-122,186,250,436
38265,FremontBridge,02/13/2017 09:00:00 AM,48,-122,102,131,233
38266,FremontBridge,02/13/2017 10:00:00 AM,48,-122,55,57,112
38267,FremontBridge,02/13/2017 11:00:00 AM,48,-122,29,28,57
38268,FremontBridge,02/13/2017 12:00:00 PM,48,-122,43,24,67
38269,FremontBridge,02/13/2017 01:00:00 PM,48,-122,39,42,81
38270,FremontBridge,02/13/2017 02:00:00 PM,48,-122,51,44,95
38271,FremontBridge,02/13/2017 03:00:00 PM,48,-122,80,57,137
38272,FremontBridge,02/13/2017 04:00:00 PM,48,-122,157,85,242
38273,FremontBridge,02/13/2017 05:00:00 PM,48,-122,417,118,535
38274,FremontBridge,02/13/2017 06:00:00 PM,48,-122,215,116,331
38275,FremontBridge,02/13/2017 07:00:00 PM,48,-122,89,45,134
38276,FremontBridge,02/13/2017 08:00:00 PM,48,-122,41,23,64
38277,FremontBridge,02/13/2017 09:00:00 PM,48,-122,24,10,34
38278,FremontBridge,02/13/2017 10:00:00 PM,48,-122,10,11,21
38279,FremontBridge,02/13/2017 11:00:00 PM,48,-122,5,3,8
38280,FremontBridge,02/14/2017 12:00:00 AM,48,-122,3,2,5
38281,FremontBridge,02/14/2017 01:00:00 AM,48,-122,3,2,5
38282,FremontBridge,02/14/2017 02:00:00 AM,48,-122,2,3,5
38283,FremontBridge,02/14/2017 03:00:00 AM,48,-122,1,1,2
38284,FremontBridge,02/14/2017 04:00:00 AM,48,-122,1,3,4
38285,FremontBridge,02/14/2017 05:00:00 AM,48,-122,14,18,32
38286,FremontBridge,02/14/2017 06:00:00 AM,48,-122,44,80,124
38287,FremontBridge,02/14/2017 07:00:00 AM,48,-122,128,218,346
38288,FremontBridge,02/14/2017 08:00:00 AM,48,-122,175,274,449
38289,FremontBridge,02/14/2017 09:00:00 AM,48,-122,94,108,202
38290,FremontBridge,02/14/2017 10:00:00 AM,48,-122,51,35,86
38291,FremontBridge,02/14/2017 11:00:00 AM,48,-122,24,32,56
38292,FremontBridge,02/14/2017 12:00:00 PM,48,-122,29,35,64
38293,FremontBridge,02/14/2017 01:00:00 PM,48,-122,31,33,64
38294,FremontBridge,02/14/2017 02:00:00 PM,48,-122,45,29,74
38295,FremontBridge,02/14/2017 03:00:00 PM,48,-122,77,43,120
38296,FremontBridge,02/14/2017 04:00:00 PM,48,-122,186,75,261
38297,FremontBridge,02/14/2017 05:00:00 PM,48,-122,405,120,525
38298,FremontBridge,02/14/2017 06:00:00 PM,48,-122,195,71,266
38299,FremontBridge,02/14/2017 07:00:00 PM,48,-122,83,39,122
38300,FremontBridge,02/14/2017 08:00:00 PM,48,-122,26,21,47
38301,FremontBridge,02/14/2017 09:00:00 PM,48,-122,14,18,32
38302,FremontBridge,02/14/2017 10:00:00 PM,48,-122,9,3,12
38303,FremontBridge,02/14/2017 11:00:00 PM,48,-122,1,0,1
38304,FremontBridge,02/15/2017 12:00:00 AM,48,-122,1,3,4
38305,FremontBridge,02/15/2017 01:00:00 AM,48,-122,2,1,3
38306,FremontBridge,02/15/2017 02:00:00 AM,48,-122,0,0,0
38307,FremontBridge,02/15/2017 03:00:00 AM,48,-122,2,0,2
38308,FremontBridge,02/15/2017 04:00:00 AM,48,-122,1,1,2
38309,FremontBridge,02/15/2017 05:00:00 AM,48,-122,10,8,18
38310,FremontBridge,02/15/2017 06:00:00 AM,48,-122,15,45,60
38311,FremontBridge,02/15/2017 07:00:00 AM,48,-122,71,117,188
38312,FremontBridge,02/15/2017 08:00:00 AM,48,-122,110,152,262
38313,FremontBridge,02/15/2017 09:00:00 AM,48,-122,79,68,147
38314,FremontBridge,02/15/2017 10:00:00 AM,48,-122,24,25,49
38315,FremontBridge,02/15/2017 11:00:00 AM,48,-122,10,13,23
38316,FremontBridge,02/15/2017 12:00:00 PM,48,-122,5,7,12
38317,FremontBridge,02/15/2017 01:00:00 PM,48,-122,13,9,22
38318,FremontBridge,02/15/2017 02:00:00 PM,48,-122,15,2,17
38319,FremontBridge,02/15/2017 03:00:00 PM,48,-122,25,22,47
38320,FremontBridge,02/15/2017 04:00:00 PM,48,-122,70,29,99
38321,FremontBridge,02/15/2017 05:00:00 PM,48,-122,218,54,272
38322,FremontBridge,02/15/2017 06:00:00 PM,48,-122,133,48,181
38323,FremontBridge,02/15/2017 07:00:00 PM,48,-122,60,16,76
38324,FremontBridge,02/15/2017 08:00:00 PM,48,-122,29,14,43
38325,FremontBridge,02/15/2017 09:00:00 PM,48,-122,10,5,15
38326,FremontBridge,02/15/2017 10:00:00 PM,48,-122,10,6,16
38327,FremontBridge,02/15/2017 11:00:00 PM,48,-122,2,1,3
38328,FremontBridge,02/16/2017 12:00:00 AM,48,-122,1,0,1
38329,FremontBridge,02/16/2017 01:00:00 AM,48,-122,1,0,1
38330,FremontBridge,02/16/2017 02:00:00 AM,48,-122,1,2,3
38331,FremontBridge,02/16/2017 03:00:00 AM,48,-122,1,1,2
38332,FremontBridge,02/16/2017 04:00:00 AM,48,-122,1,4,5
38333,FremontBridge,02/16/2017 05:00:00 AM,48,-122,7,11,18
38334,FremontBridge,02/16/2017 06:00:00 AM,48,-122,40,56,96
38335,FremontBridge,02/16/2017 07:00:00 AM,48,-122,91,150,241
38336,FremontBridge,02/16/2017 08:00:00 AM,48,-122,125,201,326
38337,FremontBridge,02/16/2017 09:00:00 AM,48,-122,78,102,180
38338,FremontBridge,02/16/2017 10:00:00 AM,48,-122,33,39,72
38339,FremontBridge,02/16/2017 11:00:00 AM,48,-122,27,31,58
38340,FremontBridge,02/16/2017 12:00:00 PM,48,-122,27,29,56
38341,FremontBridge,02/16/2017 01:00:00 PM,48,-122,28,27,55
38342,FremontBridge,02/16/2017 02:00:00 PM,48,-122,32,26,58
38343,FremontBridge,02/16/2017 03:00:00 PM,48,-122,49,37,86
38344,FremontBridge,02/16/2017 04:00:00 PM,48,-122,120,56,176
38345,FremontBridge,02/16/2017 05:00:00 PM,48,-122,297,94,391
38346,FremontBridge,02/16/2017 06:00:00 PM,48,-122,177,75,252
38347,FremontBridge,02/16/2017 07:00:00 PM,48,-122,64,35,99
38348,FremontBridge,02/16/2017 08:00:00 PM,48,-122,50,15,65
38349,FremontBridge,02/16/2017 09:00:00 PM,48,-122,25,12,37
38350,FremontBridge,02/16/2017 10:00:00 PM,48,-122,10,5,15
38351,FremontBridge,02/16/2017 11:00:00 PM,48,-122,10,5,15
38352,FremontBridge,02/17/2017 12:00:00 AM,48,-122,5,6,11
38353,FremontBridge,02/17/2017 01:00:00 AM,48,-122,0,2,2
38354,FremontBridge,02/17/2017 02:00:00 AM,48,-122,2,0,2
38355,FremontBridge,02/17/2017 03:00:00 AM,48,-122,1,2,3
38356,FremontBridge,02/17/2017 04:00:00 AM,48,-122,3,5,8
38357,FremontBridge,02/17/2017 05:00:00 AM,48,-122,9,8,17
38358,FremontBridge,02/17/2017 06:00:00 AM,48,-122,39,53,92
38359,FremontBridge,02/17/2017 07:00:00 AM,48,-122,92,168,260
38360,FremontBridge,02/17/2017 08:00:00 AM,48,-122,144,203,347
38361,FremontBridge,02/17/2017 09:00:00 AM,48,-122,90,115,205
38362,FremontBridge,02/17/2017 10:00:00 AM,48,-122,40,31,71
38363,FremontBridge,02/17/2017 11:00:00 AM,48,-122,29,39,68
38364,FremontBridge,02/17/2017 12:00:00 PM,48,-122,43,49,92
38365,FremontBridge,02/17/2017 01:00:00 PM,48,-122,43,28,71
38366,FremontBridge,02/17/2017 02:00:00 PM,48,-122,44,42,86
38367,FremontBridge,02/17/2017 03:00:00 PM,48,-122,98,77,175
38368,FremontBridge,02/17/2017 04:00:00 PM,48,-122,169,94,263
38369,FremontBridge,02/17/2017 05:00:00 PM,48,-122,289,122,411
38370,FremontBridge,02/17/2017 06:00:00 PM,48,-122,168,64,232
38371,FremontBridge,02/17/2017 07:00:00 PM,48,-122,52,28,80
38372,FremontBridge,02/17/2017 08:00:00 PM,48,-122,35,11,46
38373,FremontBridge,02/17/2017 09:00:00 PM,48,-122,18,13,31
38374,FremontBridge,02/17/2017 10:00:00 PM,48,-122,17,7,24
38375,FremontBridge,02/17/2017 11:00:00 PM,48,-122,12,10,22
38376,FremontBridge,02/18/2017 12:00:00 AM,48,-122,7,3,10
38377,FremontBridge,02/18/2017 01:00:00 AM,48,-122,3,2,5
38378,FremontBridge,02/18/2017 02:00:00 AM,48,-122,0,0,0
38379,FremontBridge,02/18/2017 03:00:00 AM,48,-122,0,0,0
38380,FremontBridge,02/18/2017 04:00:00 AM,48,-122,1,5,6
38381,FremontBridge,02/18/2017 05:00:00 AM,48,-122,1,2,3
38382,FremontBridge,02/18/2017 06:00:00 AM,48,-122,4,3,7
38383,FremontBridge,02/18/2017 07:00:00 AM,48,-122,6,9,15
38384,FremontBridge,02/18/2017 08:00:00 AM,48,-122,16,26,42
38385,FremontBridge,02/18/2017 09:00:00 AM,48,-122,27,20,47
38386,FremontBridge,02/18/2017 10:00:00 AM,48,-122,25,31,56
38387,FremontBridge,02/18/2017 11:00:00 AM,48,-122,19,16,35
38388,FremontBridge,02/18/2017 12:00:00 PM,48,-122,31,17,48
38389,FremontBridge,02/18/2017 01:00:00 PM,48,-122,21,13,34
38390,FremontBridge,02/18/2017 02:00:00 PM,48,-122,20,24,44
38391,FremontBridge,02/18/2017 03:00:00 PM,48,-122,15,23,38
38392,FremontBridge,02/18/2017 04:00:00 PM,48,-122,17,20,37
38393,FremontBridge,02/18/2017 05:00:00 PM,48,-122,19,14,33
38394,FremontBridge,02/18/2017 06:00:00 PM,48,-122,19,19,38
38395,FremontBridge,02/18/2017 07:00:00 PM,48,-122,14,3,17
38396,FremontBridge,02/18/2017 08:00:00 PM,48,-122,4,6,10
38397,FremontBridge,02/18/2017 09:00:00 PM,48,-122,8,7,15
38398,FremontBridge,02/18/2017 10:00:00 PM,48,-122,9,4,13
38399,FremontBridge,02/18/2017 11:00:00 PM,48,-122,5,1,6
38400,FremontBridge,02/19/2017 12:00:00 AM,48,-122,5,5,10
38401,FremontBridge,02/19/2017 01:00:00 AM,48,-122,2,1,3
38402,FremontBridge,02/19/2017 02:00:00 AM,48,-122,3,0,3
38403,FremontBridge,02/19/2017 03:00:00 AM,48,-122,1,1,2
38404,FremontBridge,02/19/2017 04:00:00 AM,48,-122,2,1,3
38405,FremontBridge,02/19/2017 05:00:00 AM,48,-122,1,0,1
38406,FremontBridge,02/19/2017 06:00:00 AM,48,-122,3,2,5
38407,FremontBridge,02/19/2017 07:00:00 AM,48,-122,1,2,3
38408,FremontBridge,02/19/2017 08:00:00 AM,48,-122,9,11,20
38409,FremontBridge,02/19/2017 09:00:00 AM,48,-122,16,11,27
38410,FremontBridge,02/19/2017 10:00:00 AM,48,-122,28,28,56
38411,FremontBridge,02/19/2017 11:00:00 AM,48,-122,32,39,71
38412,FremontBridge,02/19/2017 12:00:00 PM,48,-122,51,40,91
38413,FremontBridge,02/19/2017 01:00:00 PM,48,-122,30,31,61
38414,FremontBridge,02/19/2017 02:00:00 PM,48,-122,22,22,44
38415,FremontBridge,02/19/2017 03:00:00 PM,48,-122,27,13,40
38416,FremontBridge,02/19/2017 04:00:00 PM,48,-122,17,16,33
38417,FremontBridge,02/19/2017 05:00:00 PM,48,-122,12,15,27
38418,FremontBridge,02/19/2017 06:00:00 PM,48,-122,6,11,17
38419,FremontBridge,02/19/2017 07:00:00 PM,48,-122,15,6,21
38420,FremontBridge,02/19/2017 08:00:00 PM,48,-122,4,2,6
38421,FremontBridge,02/19/2017 09:00:00 PM,48,-122,3,4,7
38422,FremontBridge,02/19/2017 10:00:00 PM,48,-122,4,3,7
38423,FremontBridge,02/19/2017 11:00:00 PM,48,-122,1,5,6
38424,FremontBridge,02/20/2017 12:00:00 AM,48,-122,0,2,2
38425,FremontBridge,02/20/2017 01:00:00 AM,48,-122,4,0,4
38426,FremontBridge,02/20/2017 02:00:00 AM,48,-122,3,1,4
38427,FremontBridge,02/20/2017 03:00:00 AM,48,-122,0,1,1
38428,FremontBridge,02/20/2017 04:00:00 AM,48,-122,1,2,3
38429,FremontBridge,02/20/2017 05:00:00 AM,48,-122,5,15,20
38430,FremontBridge,02/20/2017 06:00:00 AM,48,-122,8,22,30
38431,FremontBridge,02/20/2017 07:00:00 AM,48,-122,38,53,91
38432,FremontBridge,02/20/2017 08:00:00 AM,48,-122,62,83,145
38433,FremontBridge,02/20/2017 09:00:00 AM,48,-122,42,39,81
38434,FremontBridge,02/20/2017 10:00:00 AM,48,-122,12,25,37
38435,FremontBridge,02/20/2017 11:00:00 AM,48,-122,16,12,28
38436,FremontBridge,02/20/2017 12:00:00 PM,48,-122,15,13,28
38437,FremontBridge,02/20/2017 01:00:00 PM,48,-122,15,10,25
38438,FremontBridge,02/20/2017 02:00:00 PM,48,-122,13,8,21
38439,FremontBridge,02/20/2017 03:00:00 PM,48,-122,14,11,25
38440,FremontBridge,02/20/2017 04:00:00 PM,48,-122,37,22,59
38441,FremontBridge,02/20/2017 05:00:00 PM,48,-122,120,26,146
38442,FremontBridge,02/20/2017 06:00:00 PM,48,-122,92,18,110
38443,FremontBridge,02/20/2017 07:00:00 PM,48,-122,35,19,54
38444,FremontBridge,02/20/2017 08:00:00 PM,48,-122,15,8,23
38445,FremontBridge,02/20/2017 09:00:00 PM,48,-122,8,6,14
38446,FremontBridge,02/20/2017 10:00:00 PM,48,-122,7,3,10
38447,FremontBridge,02/20/2017 11:00:00 PM,48,-122,6,2,8
38448,FremontBridge,02/21/2017 12:00:00 AM,48,-122,1,5,6
38449,FremontBridge,02/21/2017 01:00:00 AM,48,-122,2,0,2
38450,FremontBridge,02/21/2017 02:00:00 AM,48,-122,0,4,4
38451,FremontBridge,02/21/2017 03:00:00 AM,48,-122,1,2,3
38452,FremontBridge,02/21/2017 04:00:00 AM,48,-122,2,1,3
38453,FremontBridge,02/21/2017 05:00:00 AM,48,-122,10,17,27
38454,FremontBridge,02/21/2017 06:00:00 AM,48,-122,32,60,92
38455,FremontBridge,02/21/2017 07:00:00 AM,48,-122,92,116,208
38456,FremontBridge,02/21/2017 08:00:00 AM,48,-122,111,171,282
38457,FremontBridge,02/21/2017 09:00:00 AM,48,-122,76,71,147
38458,FremontBridge,02/21/2017 10:00:00 AM,48,-122,33,28,61
38459,FremontBridge,02/21/2017 11:00:00 AM,48,-122,13,25,38
38460,FremontBridge,02/21/2017 12:00:00 PM,48,-122,28,10,38
38461,FremontBridge,02/21/2017 01:00:00 PM,48,-122,22,21,43
38462,FremontBridge,02/21/2017 02:00:00 PM,48,-122,16,24,40
38463,FremontBridge,02/21/2017 03:00:00 PM,48,-122,42,22,64
38464,FremontBridge,02/21/2017 04:00:00 PM,48,-122,99,58,157
38465,FremontBridge,02/21/2017 05:00:00 PM,48,-122,262,73,335
38466,FremontBridge,02/21/2017 06:00:00 PM,48,-122,170,54,224
38467,FremontBridge,02/21/2017 07:00:00 PM,48,-122,57,30,87
38468,FremontBridge,02/21/2017 08:00:00 PM,48,-122,26,12,38
38469,FremontBridge,02/21/2017 09:00:00 PM,48,-122,13,9,22
38470,FremontBridge,02/21/2017 10:00:00 PM,48,-122,8,2,10
38471,FremontBridge,02/21/2017 11:00:00 PM,48,-122,4,2,6
38472,FremontBridge,02/22/2017 12:00:00 AM,48,-122,0,2,2
38473,FremontBridge,02/22/2017 01:00:00 AM,48,-122,0,1,1
38474,FremontBridge,02/22/2017 02:00:00 AM,48,-122,0,0,0
38475,FremontBridge,02/22/2017 03:00:00 AM,48,-122,1,2,3
38476,FremontBridge,02/22/2017 04:00:00 AM,48,-122,2,4,6
38477,FremontBridge,02/22/2017 05:00:00 AM,48,-122,9,19,28
38478,FremontBridge,02/22/2017 06:00:00 AM,48,-122,32,52,84
38479,FremontBridge,02/22/2017 07:00:00 AM,48,-122,79,134,213
38480,FremontBridge,02/22/2017 08:00:00 AM,48,-122,140,182,322
38481,FremontBridge,02/22/2017 09:00:00 AM,48,-122,67,75,142
38482,FremontBridge,02/22/2017 10:00:00 AM,48,-122,37,26,63
38483,FremontBridge,02/22/2017 11:00:00 AM,48,-122,20,12,32
38484,FremontBridge,02/22/2017 12:00:00 PM,48,-122,18,21,39
38485,FremontBridge,02/22/2017 01:00:00 PM,48,-122,27,22,49
38486,FremontBridge,02/22/2017 02:00:00 PM,48,-122,28,38,66
38487,FremontBridge,02/22/2017 03:00:00 PM,48,-122,59,43,102
38488,FremontBridge,02/22/2017 04:00:00 PM,48,-122,123,69,192
38489,FremontBridge,02/22/2017 05:00:00 PM,48,-122,277,97,374
38490,FremontBridge,02/22/2017 06:00:00 PM,48,-122,151,57,208
38491,FremontBridge,02/22/2017 07:00:00 PM,48,-122,89,36,125
38492,FremontBridge,02/22/2017 08:00:00 PM,48,-122,32,18,50
38493,FremontBridge,02/22/2017 09:00:00 PM,48,-122,25,13,38
38494,FremontBridge,02/22/2017 10:00:00 PM,48,-122,12,12,24
38495,FremontBridge,02/22/2017 11:00:00 PM,48,-122,6,7,13
38496,FremontBridge,02/23/2017 12:00:00 AM,48,-122,6,1,7
38497,FremontBridge,02/23/2017 01:00:00 AM,48,-122,1,1,2
38498,FremontBridge,02/23/2017 02:00:00 AM,48,-122,1,0,1
38499,FremontBridge,02/23/2017 03:00:00 AM,48,-122,2,1,3
38500,FremontBridge,02/23/2017 04:00:00 AM,48,-122,3,4,7
38501,FremontBridge,02/23/2017 05:00:00 AM,48,-122,14,17,31
38502,FremontBridge,02/23/2017 06:00:00 AM,48,-122,35,62,97
38503,FremontBridge,02/23/2017 07:00:00 AM,48,-122,85,131,216
38504,FremontBridge,02/23/2017 08:00:00 AM,48,-122,129,177,306
38505,FremontBridge,02/23/2017 09:00:00 AM,48,-122,89,70,159
38506,FremontBridge,02/23/2017 10:00:00 AM,48,-122,45,25,70
38507,FremontBridge,02/23/2017 11:00:00 AM,48,-122,19,34,53
38508,FremontBridge,02/23/2017 12:00:00 PM,48,-122,28,21,49
38509,FremontBridge,02/23/2017 01:00:00 PM,48,-122,30,25,55
38510,FremontBridge,02/23/2017 02:00:00 PM,48,-122,25,22,47
38511,FremontBridge,02/23/2017 03:00:00 PM,48,-122,48,26,74
38512,FremontBridge,02/23/2017 04:00:00 PM,48,-122,116,36,152
38513,FremontBridge,02/23/2017 05:00:00 PM,48,-122,269,77,346
38514,FremontBridge,02/23/2017 06:00:00 PM,48,-122,156,62,218
38515,FremontBridge,02/23/2017 07:00:00 PM,48,-122,56,39,95
38516,FremontBridge,02/23/2017 08:00:00 PM,48,-122,43,22,65
38517,FremontBridge,02/23/2017 09:00:00 PM,48,-122,28,7,35
38518,FremontBridge,02/23/2017 10:00:00 PM,48,-122,13,7,20
38519,FremontBridge,02/23/2017 11:00:00 PM,48,-122,5,4,9
38520,FremontBridge,02/24/2017 12:00:00 AM,48,-122,2,2,4
38521,FremontBridge,02/24/2017 01:00:00 AM,48,-122,2,1,3
38522,FremontBridge,02/24/2017 02:00:00 AM,48,-122,1,2,3
38523,FremontBridge,02/24/2017 03:00:00 AM,48,-122,1,1,2
38524,FremontBridge,02/24/2017 04:00:00 AM,48,-122,2,4,6
38525,FremontBridge,02/24/2017 05:00:00 AM,48,-122,8,11,19
38526,FremontBridge,02/24/2017 06:00:00 AM,48,-122,27,35,62
38527,FremontBridge,02/24/2017 07:00:00 AM,48,-122,66,102,168
38528,FremontBridge,02/24/2017 08:00:00 AM,48,-122,111,141,252
38529,FremontBridge,02/24/2017 09:00:00 AM,48,-122,66,67,133
38530,FremontBridge,02/24/2017 10:00:00 AM,48,-122,30,35,65
38531,FremontBridge,02/24/2017 11:00:00 AM,48,-122,24,19,43
38532,FremontBridge,02/24/2017 12:00:00 PM,48,-122,18,20,38
38533,FremontBridge,02/24/2017 01:00:00 PM,48,-122,26,24,50
38534,FremontBridge,02/24/2017 02:00:00 PM,48,-122,23,29,52
38535,FremontBridge,02/24/2017 03:00:00 PM,48,-122,61,55,116
38536,FremontBridge,02/24/2017 04:00:00 PM,48,-122,124,72,196
38537,FremontBridge,02/24/2017 05:00:00 PM,48,-122,196,86,282
38538,FremontBridge,02/24/2017 06:00:00 PM,48,-122,122,63,185
38539,FremontBridge,02/24/2017 07:00:00 PM,48,-122,52,22,74
38540,FremontBridge,02/24/2017 08:00:00 PM,48,-122,32,13,45
38541,FremontBridge,02/24/2017 09:00:00 PM,48,-122,20,15,35
38542,FremontBridge,02/24/2017 10:00:00 PM,48,-122,8,9,17
38543,FremontBridge,02/24/2017 11:00:00 PM,48,-122,6,4,10
38544,FremontBridge,02/25/2017 12:00:00 AM,48,-122,6,2,8
38545,FremontBridge,02/25/2017 01:00:00 AM,48,-122,3,3,6
38546,FremontBridge,02/25/2017 02:00:00 AM,48,-122,0,1,1
38547,FremontBridge,02/25/2017 03:00:00 AM,48,-122,1,0,1
38548,FremontBridge,02/25/2017 04:00:00 AM,48,-122,1,0,1
38549,FremontBridge,02/25/2017 05:00:00 AM,48,-122,4,7,11
38550,FremontBridge,02/25/2017 06:00:00 AM,48,-122,2,4,6
38551,FremontBridge,02/25/2017 07:00:00 AM,48,-122,10,12,22
38552,FremontBridge,02/25/2017 08:00:00 AM,48,-122,21,26,47
38553,FremontBridge,02/25/2017 09:00:00 AM,48,-122,31,49,80
38554,FremontBridge,02/25/2017 10:00:00 AM,48,-122,39,36,75
38555,FremontBridge,02/25/2017 11:00:00 AM,48,-122,42,43,85
38556,FremontBridge,02/25/2017 12:00:00 PM,48,-122,47,52,99
38557,FremontBridge,02/25/2017 01:00:00 PM,48,-122,53,42,95
38558,FremontBridge,02/25/2017 02:00:00 PM,48,-122,56,55,111
38559,FremontBridge,02/25/2017 03:00:00 PM,48,-122,58,42,100
38560,FremontBridge,02/25/2017 04:00:00 PM,48,-122,30,40,70
38561,FremontBridge,02/25/2017 05:00:00 PM,48,-122,38,18,56
38562,FremontBridge,02/25/2017 06:00:00 PM,48,-122,16,14,30
38563,FremontBridge,02/25/2017 07:00:00 PM,48,-122,14,11,25
38564,FremontBridge,02/25/2017 08:00:00 PM,48,-122,14,8,22
38565,FremontBridge,02/25/2017 09:00:00 PM,48,-122,8,5,13
38566,FremontBridge,02/25/2017 10:00:00 PM,48,-122,6,4,10
38567,FremontBridge,02/25/2017 11:00:00 PM,48,-122,4,3,7
38568,FremontBridge,02/26/2017 12:00:00 AM,48,-122,4,4,8
38569,FremontBridge,02/26/2017 01:00:00 AM,48,-122,4,2,6
38570,FremontBridge,02/26/2017 02:00:00 AM,48,-122,1,1,2
38571,FremontBridge,02/26/2017 03:00:00 AM,48,-122,0,0,0
38572,FremontBridge,02/26/2017 04:00:00 AM,48,-122,1,1,2
38573,FremontBridge,02/26/2017 05:00:00 AM,48,-122,1,2,3
38574,FremontBridge,02/26/2017 06:00:00 AM,48,-122,3,9,12
38575,FremontBridge,02/26/2017 07:00:00 AM,48,-122,11,24,35
38576,FremontBridge,02/26/2017 08:00:00 AM,48,-122,9,29,38
38577,FremontBridge,02/26/2017 09:00:00 AM,48,-122,11,13,24
38578,FremontBridge,02/26/2017 10:00:00 AM,48,-122,11,16,27
38579,FremontBridge,02/26/2017 11:00:00 AM,48,-122,9,12,21
38580,FremontBridge,02/26/2017 12:00:00 PM,48,-122,21,13,34
38581,FremontBridge,02/26/2017 01:00:00 PM,48,-122,16,18,34
38582,FremontBridge,02/26/2017 02:00:00 PM,48,-122,23,15,38
38583,FremontBridge,02/26/2017 03:00:00 PM,48,-122,19,15,34
38584,FremontBridge,02/26/2017 04:00:00 PM,48,-122,24,23,47
38585,FremontBridge,02/26/2017 05:00:00 PM,48,-122,13,18,31
38586,FremontBridge,02/26/2017 06:00:00 PM,48,-122,15,15,30
38587,FremontBridge,02/26/2017 07:00:00 PM,48,-122,11,5,16
38588,FremontBridge,02/26/2017 08:00:00 PM,48,-122,10,4,14
38589,FremontBridge,02/26/2017 09:00:00 PM,48,-122,7,2,9
38590,FremontBridge,02/26/2017 10:00:00 PM,48,-122,4,2,6
38591,FremontBridge,02/26/2017 11:00:00 PM,48,-122,2,1,3
38592,FremontBridge,02/27/2017 12:00:00 AM,48,-122,1,4,5
38593,FremontBridge,02/27/2017 01:00:00 AM,48,-122,1,0,1
38594,FremontBridge,02/27/2017 02:00:00 AM,48,-122,0,0,0
38595,FremontBridge,02/27/2017 03:00:00 AM,48,-122,0,1,1
38596,FremontBridge,02/27/2017 04:00:00 AM,48,-122,0,4,4
38597,FremontBridge,02/27/2017 05:00:00 AM,48,-122,9,12,21
38598,FremontBridge,02/27/2017 06:00:00 AM,48,-122,22,29,51
38599,FremontBridge,02/27/2017 07:00:00 AM,48,-122,35,50,85
38600,FremontBridge,02/27/2017 08:00:00 AM,48,-122,81,80,161
38601,FremontBridge,02/27/2017 09:00:00 AM,48,-122,39,45,84
38602,FremontBridge,02/27/2017 10:00:00 AM,48,-122,19,12,31
38603,FremontBridge,02/27/2017 11:00:00 AM,48,-122,12,13,25
38604,FremontBridge,02/27/2017 12:00:00 PM,48,-122,14,9,23
38605,FremontBridge,02/27/2017 01:00:00 PM,48,-122,12,15,27
38606,FremontBridge,02/27/2017 02:00:00 PM,48,-122,15,12,27
38607,FremontBridge,02/27/2017 03:00:00 PM,48,-122,20,23,43
38608,FremontBridge,02/27/2017 04:00:00 PM,48,-122,54,28,82
38609,FremontBridge,02/27/2017 05:00:00 PM,48,-122,139,38,177
38610,FremontBridge,02/27/2017 06:00:00 PM,48,-122,69,35,104
38611,FremontBridge,02/27/2017 07:00:00 PM,48,-122,24,18,42
38612,FremontBridge,02/27/2017 08:00:00 PM,48,-122,16,6,22
38613,FremontBridge,02/27/2017 09:00:00 PM,48,-122,11,3,14
38614,FremontBridge,02/27/2017 10:00:00 PM,48,-122,7,7,14
38615,FremontBridge,02/27/2017 11:00:00 PM,48,-122,2,1,3
38616,FremontBridge,02/28/2017 12:00:00 AM,48,-122,0,2,2
38617,FremontBridge,02/28/2017 01:00:00 AM,48,-122,1,0,1
38618,FremontBridge,02/28/2017 02:00:00 AM,48,-122,0,0,0
38619,FremontBridge,02/28/2017 03:00:00 AM,48,-122,0,1,1
38620,FremontBridge,02/28/2017 04:00:00 AM,48,-122,1,2,3
38621,FremontBridge,02/28/2017 05:00:00 AM,48,-122,11,12,23
38622,FremontBridge,02/28/2017 06:00:00 AM,48,-122,20,56,76
38623,FremontBridge,02/28/2017 07:00:00 AM,48,-122,77,98,175
38624,FremontBridge,02/28/2017 08:00:00 AM,48,-122,111,161,272
38625,FremontBridge,02/28/2017 09:00:00 AM,48,-122,84,81,165
38626,FremontBridge,02/28/2017 10:00:00 AM,48,-122,33,30,63
38627,FremontBridge,02/28/2017 11:00:00 AM,48,-122,13,23,36
38628,FremontBridge,02/28/2017 12:00:00 PM,48,-122,28,16,44
38629,FremontBridge,02/28/2017 01:00:00 PM,48,-122,28,30,58
38630,FremontBridge,02/28/2017 02:00:00 PM,48,-122,29,15,44
38631,FremontBridge,02/28/2017 03:00:00 PM,48,-122,42,47,89
38632,FremontBridge,02/28/2017 04:00:00 PM,48,-122,111,52,163
38633,FremontBridge,02/28/2017 05:00:00 PM,48,-122,246,85,331
38634,FremontBridge,02/28/2017 06:00:00 PM,48,-122,140,68,208
38635,FremontBridge,02/28/2017 07:00:00 PM,48,-122,72,23,95
38636,FremontBridge,02/28/2017 08:00:00 PM,48,-122,39,21,60
38637,FremontBridge,02/28/2017 09:00:00 PM,48,-122,21,9,30
38638,FremontBridge,02/28/2017 10:00:00 PM,48,-122,5,7,12
38639,FremontBridge,02/28/2017 11:00:00 PM,48,-122,1,6,7
38640,FremontBridge,03/01/2017 12:00:00 AM,48,-122,2,1,3
38641,FremontBridge,03/01/2017 01:00:00 AM,48,-122,2,2,4
38642,FremontBridge,03/01/2017 02:00:00 AM,48,-122,1,1,2
38643,FremontBridge,03/01/2017 03:00:00 AM,48,-122,0,1,1
38644,FremontBridge,03/01/2017 04:00:00 AM,48,-122,3,3,6
38645,FremontBridge,03/01/2017 05:00:00 AM,48,-122,11,13,24
38646,FremontBridge,03/01/2017 06:00:00 AM,48,-122,33,63,96
38647,FremontBridge,03/01/2017 07:00:00 AM,48,-122,94,153,247
38648,FremontBridge,03/01/2017 08:00:00 AM,48,-122,145,194,339
38649,FremontBridge,03/01/2017 09:00:00 AM,48,-122,94,87,181
38650,FremontBridge,03/01/2017 10:00:00 AM,48,-122,34,36,70
38651,FremontBridge,03/01/2017 11:00:00 AM,48,-122,18,19,37
38652,FremontBridge,03/01/2017 12:00:00 PM,48,-122,15,29,44
38653,FremontBridge,03/01/2017 01:00:00 PM,48,-122,24,29,53
38654,FremontBridge,03/01/2017 02:00:00 PM,48,-122,40,19,59
38655,FremontBridge,03/01/2017 03:00:00 PM,48,-122,37,41,78
38656,FremontBridge,03/01/2017 04:00:00 PM,48,-122,115,45,160
38657,FremontBridge,03/01/2017 05:00:00 PM,48,-122,304,102,406
38658,FremontBridge,03/01/2017 06:00:00 PM,48,-122,168,97,265
38659,FremontBridge,03/01/2017 07:00:00 PM,48,-122,81,36,117
38660,FremontBridge,03/01/2017 08:00:00 PM,48,-122,48,27,75
38661,FremontBridge,03/01/2017 09:00:00 PM,48,-122,34,11,45
38662,FremontBridge,03/01/2017 10:00:00 PM,48,-122,17,11,28
38663,FremontBridge,03/01/2017 11:00:00 PM,48,-122,11,9,20
38664,FremontBridge,03/02/2017 12:00:00 AM,48,-122,1,1,2
38665,FremontBridge,03/02/2017 01:00:00 AM,48,-122,0,2,2
38666,FremontBridge,03/02/2017 02:00:00 AM,48,-122,1,1,2
38667,FremontBridge,03/02/2017 03:00:00 AM,48,-122,1,0,1
38668,FremontBridge,03/02/2017 04:00:00 AM,48,-122,3,6,9
38669,FremontBridge,03/02/2017 05:00:00 AM,48,-122,9,18,27
38670,FremontBridge,03/02/2017 06:00:00 AM,48,-122,33,50,83
38671,FremontBridge,03/02/2017 07:00:00 AM,48,-122,109,146,255
38672,FremontBridge,03/02/2017 08:00:00 AM,48,-122,157,194,351
38673,FremontBridge,03/02/2017 09:00:00 AM,48,-122,79,98,177
38674,FremontBridge,03/02/2017 10:00:00 AM,48,-122,34,40,74
38675,FremontBridge,03/02/2017 11:00:00 AM,48,-122,26,17,43
38676,FremontBridge,03/02/2017 12:00:00 PM,48,-122,17,23,40
38677,FremontBridge,03/02/2017 01:00:00 PM,48,-122,18,17,35
38678,FremontBridge,03/02/2017 02:00:00 PM,48,-122,26,19,45
38679,FremontBridge,03/02/2017 03:00:00 PM,48,-122,36,33,69
38680,FremontBridge,03/02/2017 04:00:00 PM,48,-122,137,49,186
38681,FremontBridge,03/02/2017 05:00:00 PM,48,-122,253,81,334
38682,FremontBridge,03/02/2017 06:00:00 PM,48,-122,165,76,241
38683,FremontBridge,03/02/2017 07:00:00 PM,48,-122,62,23,85
38684,FremontBridge,03/02/2017 08:00:00 PM,48,-122,56,12,68
38685,FremontBridge,03/02/2017 09:00:00 PM,48,-122,26,12,38
38686,FremontBridge,03/02/2017 10:00:00 PM,48,-122,15,6,21
38687,FremontBridge,03/02/2017 11:00:00 PM,48,-122,6,4,10
38688,FremontBridge,03/03/2017 12:00:00 AM,48,-122,6,3,9
38689,FremontBridge,03/03/2017 01:00:00 AM,48,-122,2,2,4
38690,FremontBridge,03/03/2017 02:00:00 AM,48,-122,0,0,0
38691,FremontBridge,03/03/2017 03:00:00 AM,48,-122,0,0,0
38692,FremontBridge,03/03/2017 04:00:00 AM,48,-122,1,2,3
38693,FremontBridge,03/03/2017 05:00:00 AM,48,-122,9,11,20
38694,FremontBridge,03/03/2017 06:00:00 AM,48,-122,25,38,63
38695,FremontBridge,03/03/2017 07:00:00 AM,48,-122,65,93,158
38696,FremontBridge,03/03/2017 08:00:00 AM,48,-122,115,154,269
38697,FremontBridge,03/03/2017 09:00:00 AM,48,-122,56,58,114
38698,FremontBridge,03/03/2017 10:00:00 AM,48,-122,29,22,51
38699,FremontBridge,03/03/2017 11:00:00 AM,48,-122,16,14,30
38700,FremontBridge,03/03/2017 12:00:00 PM,48,-122,16,13,29
38701,FremontBridge,03/03/2017 01:00:00 PM,48,-122,26,15,41
38702,FremontBridge,03/03/2017 02:00:00 PM,48,-122,26,17,43
38703,FremontBridge,03/03/2017 03:00:00 PM,48,-122,35,22,57
38704,FremontBridge,03/03/2017 04:00:00 PM,48,-122,81,32,113
38705,FremontBridge,03/03/2017 05:00:00 PM,48,-122,194,54,248
38706,FremontBridge,03/03/2017 06:00:00 PM,48,-122,104,55,159
38707,FremontBridge,03/03/2017 07:00:00 PM,48,-122,55,22,77
38708,FremontBridge,03/03/2017 08:00:00 PM,48,-122,19,7,26
38709,FremontBridge,03/03/2017 09:00:00 PM,48,-122,11,8,19
38710,FremontBridge,03/03/2017 10:00:00 PM,48,-122,13,5,18
38711,FremontBridge,03/03/2017 11:00:00 PM,48,-122,7,5,12
38712,FremontBridge,03/04/2017 12:00:00 AM,48,-122,5,2,7
38713,FremontBridge,03/04/2017 01:00:00 AM,48,-122,1,3,4
38714,FremontBridge,03/04/2017 02:00:00 AM,48,-122,0,0,0
38715,FremontBridge,03/04/2017 03:00:00 AM,48,-122,0,0,0
38716,FremontBridge,03/04/2017 04:00:00 AM,48,-122,3,1,4
38717,FremontBridge,03/04/2017 05:00:00 AM,48,-122,5,3,8
38718,FremontBridge,03/04/2017 06:00:00 AM,48,-122,6,3,9
38719,FremontBridge,03/04/2017 07:00:00 AM,48,-122,16,8,24
38720,FremontBridge,03/04/2017 08:00:00 AM,48,-122,23,26,49
38721,FremontBridge,03/04/2017 09:00:00 AM,48,-122,29,46,75
38722,FremontBridge,03/04/2017 10:00:00 AM,48,-122,59,32,91
38723,FremontBridge,03/04/2017 11:00:00 AM,48,-122,47,54,101
38724,FremontBridge,03/04/2017 12:00:00 PM,48,-122,56,68,124
38725,FremontBridge,03/04/2017 01:00:00 PM,48,-122,43,52,95
38726,FremontBridge,03/04/2017 02:00:00 PM,48,-122,69,53,122
38727,FremontBridge,03/04/2017 03:00:00 PM,48,-122,52,54,106
38728,FremontBridge,03/04/2017 04:00:00 PM,48,-122,36,46,82
38729,FremontBridge,03/04/2017 05:00:00 PM,48,-122,34,32,66
38730,FremontBridge,03/04/2017 06:00:00 PM,48,-122,25,27,52
38731,FremontBridge,03/04/2017 07:00:00 PM,48,-122,27,8,35
38732,FremontBridge,03/04/2017 08:00:00 PM,48,-122,12,10,22
38733,FremontBridge,03/04/2017 09:00:00 PM,48,-122,6,14,20
38734,FremontBridge,03/04/2017 10:00:00 PM,48,-122,7,10,17
38735,FremontBridge,03/04/2017 11:00:00 PM,48,-122,8,4,12
38736,FremontBridge,03/05/2017 12:00:00 AM,48,-122,2,5,7
38737,FremontBridge,03/05/2017 01:00:00 AM,48,-122,2,4,6
38738,FremontBridge,03/05/2017 02:00:00 AM,48,-122,2,0,2
38739,FremontBridge,03/05/2017 03:00:00 AM,48,-122,1,0,1
38740,FremontBridge,03/05/2017 04:00:00 AM,48,-122,0,0,0
38741,FremontBridge,03/05/2017 05:00:00 AM,48,-122,1,5,6
38742,FremontBridge,03/05/2017 06:00:00 AM,48,-122,6,2,8
38743,FremontBridge,03/05/2017 07:00:00 AM,48,-122,14,10,24
38744,FremontBridge,03/05/2017 08:00:00 AM,48,-122,15,21,36
38745,FremontBridge,03/05/2017 09:00:00 AM,48,-122,24,34,58
38746,FremontBridge,03/05/2017 10:00:00 AM,48,-122,40,34,74
38747,FremontBridge,03/05/2017 11:00:00 AM,48,-122,37,35,72
38748,FremontBridge,03/05/2017 12:00:00 PM,48,-122,30,30,60
38749,FremontBridge,03/05/2017 01:00:00 PM,48,-122,15,23,38
38750,FremontBridge,03/05/2017 02:00:00 PM,48,-122,30,20,50
38751,FremontBridge,03/05/2017 03:00:00 PM,48,-122,34,20,54
38752,FremontBridge,03/05/2017 04:00:00 PM,48,-122,15,23,38
38753,FremontBridge,03/05/2017 05:00:00 PM,48,-122,27,17,44
38754,FremontBridge,03/05/2017 06:00:00 PM,48,-122,10,11,21
38755,FremontBridge,03/05/2017 07:00:00 PM,48,-122,13,9,22
38756,FremontBridge,03/05/2017 08:00:00 PM,48,-122,20,8,28
38757,FremontBridge,03/05/2017 09:00:00 PM,48,-122,8,3,11
38758,FremontBridge,03/05/2017 10:00:00 PM,48,-122,2,3,5
38759,FremontBridge,03/05/2017 11:00:00 PM,48,-122,8,2,10
38760,FremontBridge,03/06/2017 12:00:00 AM,48,-122,0,4,4
38761,FremontBridge,03/06/2017 01:00:00 AM,48,-122,2,1,3
38762,FremontBridge,03/06/2017 02:00:00 AM,48,-122,0,1,1
38763,FremontBridge,03/06/2017 03:00:00 AM,48,-122,3,0,3
38764,FremontBridge,03/06/2017 04:00:00 AM,48,-122,1,5,6
38765,FremontBridge,03/06/2017 05:00:00 AM,48,-122,11,15,26
38766,FremontBridge,03/06/2017 06:00:00 AM,48,-122,47,58,105
38767,FremontBridge,03/06/2017 07:00:00 AM,48,-122,85,155,240
38768,FremontBridge,03/06/2017 08:00:00 AM,48,-122,164,206,370
38769,FremontBridge,03/06/2017 09:00:00 AM,48,-122,75,102,177
38770,FremontBridge,03/06/2017 10:00:00 AM,48,-122,36,25,61
38771,FremontBridge,03/06/2017 11:00:00 AM,48,-122,22,18,40
38772,FremontBridge,03/06/2017 12:00:00 PM,48,-122,22,15,37
38773,FremontBridge,03/06/2017 01:00:00 PM,48,-122,21,25,46
38774,FremontBridge,03/06/2017 02:00:00 PM,48,-122,31,20,51
38775,FremontBridge,03/06/2017 03:00:00 PM,48,-122,46,31,77
38776,FremontBridge,03/06/2017 04:00:00 PM,48,-122,117,56,173
38777,FremontBridge,03/06/2017 05:00:00 PM,48,-122,326,96,422
38778,FremontBridge,03/06/2017 06:00:00 PM,48,-122,201,95,296
38779,FremontBridge,03/06/2017 07:00:00 PM,48,-122,71,34,105
38780,FremontBridge,03/06/2017 08:00:00 PM,48,-122,31,18,49
38781,FremontBridge,03/06/2017 09:00:00 PM,48,-122,22,10,32
38782,FremontBridge,03/06/2017 10:00:00 PM,48,-122,9,6,15
38783,FremontBridge,03/06/2017 11:00:00 PM,48,-122,2,4,6
38784,FremontBridge,03/07/2017 12:00:00 AM,48,-122,2,4,6
38785,FremontBridge,03/07/2017 01:00:00 AM,48,-122,1,2,3
38786,FremontBridge,03/07/2017 02:00:00 AM,48,-122,1,0,1
38787,FremontBridge,03/07/2017 03:00:00 AM,48,-122,3,2,5
38788,FremontBridge,03/07/2017 04:00:00 AM,48,-122,3,5,8
38789,FremontBridge,03/07/2017 05:00:00 AM,48,-122,14,15,29
38790,FremontBridge,03/07/2017 06:00:00 AM,48,-122,35,51,86
38791,FremontBridge,03/07/2017 07:00:00 AM,48,-122,83,135,218
38792,FremontBridge,03/07/2017 08:00:00 AM,48,-122,105,147,252
38793,FremontBridge,03/07/2017 09:00:00 AM,48,-122,59,75,134
38794,FremontBridge,03/07/2017 10:00:00 AM,48,-122,19,11,30
38795,FremontBridge,03/07/2017 11:00:00 AM,48,-122,16,13,29
38796,FremontBridge,03/07/2017 12:00:00 PM,48,-122,16,14,30
38797,FremontBridge,03/07/2017 01:00:00 PM,48,-122,12,7,19
38798,FremontBridge,03/07/2017 02:00:00 PM,48,-122,16,13,29
38799,FremontBridge,03/07/2017 03:00:00 PM,48,-122,29,20,49
38800,FremontBridge,03/07/2017 04:00:00 PM,48,-122,92,33,125
38801,FremontBridge,03/07/2017 05:00:00 PM,48,-122,232,62,294
38802,FremontBridge,03/07/2017 06:00:00 PM,48,-122,147,59,206
38803,FremontBridge,03/07/2017 07:00:00 PM,48,-122,65,27,92
38804,FremontBridge,03/07/2017 08:00:00 PM,48,-122,25,15,40
38805,FremontBridge,03/07/2017 09:00:00 PM,48,-122,12,7,19
38806,FremontBridge,03/07/2017 10:00:00 PM,48,-122,13,3,16
38807,FremontBridge,03/07/2017 11:00:00 PM,48,-122,4,3,7
38808,FremontBridge,03/08/2017 12:00:00 AM,48,-122,1,0,1
38809,FremontBridge,03/08/2017 01:00:00 AM,48,-122,0,3,3
38810,FremontBridge,03/08/2017 02:00:00 AM,48,-122,1,0,1
38811,FremontBridge,03/08/2017 03:00:00 AM,48,-122,1,0,1
38812,FremontBridge,03/08/2017 04:00:00 AM,48,-122,1,6,7
38813,FremontBridge,03/08/2017 05:00:00 AM,48,-122,10,11,21
38814,FremontBridge,03/08/2017 06:00:00 AM,48,-122,42,64,106
38815,FremontBridge,03/08/2017 07:00:00 AM,48,-122,96,153,249
38816,FremontBridge,03/08/2017 08:00:00 AM,48,-122,133,192,325
38817,FremontBridge,03/08/2017 09:00:00 AM,48,-122,83,88,171
38818,FremontBridge,03/08/2017 10:00:00 AM,48,-122,36,50,86
38819,FremontBridge,03/08/2017 11:00:00 AM,48,-122,23,23,46
38820,FremontBridge,03/08/2017 12:00:00 PM,48,-122,20,25,45
38821,FremontBridge,03/08/2017 01:00:00 PM,48,-122,26,25,51
38822,FremontBridge,03/08/2017 02:00:00 PM,48,-122,15,29,44
38823,FremontBridge,03/08/2017 03:00:00 PM,48,-122,43,42,85
38824,FremontBridge,03/08/2017 04:00:00 PM,48,-122,123,44,167
38825,FremontBridge,03/08/2017 05:00:00 PM,48,-122,277,85,362
38826,FremontBridge,03/08/2017 06:00:00 PM,48,-122,165,64,229
38827,FremontBridge,03/08/2017 07:00:00 PM,48,-122,68,19,87
38828,FremontBridge,03/08/2017 08:00:00 PM,48,-122,34,14,48
38829,FremontBridge,03/08/2017 09:00:00 PM,48,-122,17,8,25
38830,FremontBridge,03/08/2017 10:00:00 PM,48,-122,12,8,20
38831,FremontBridge,03/08/2017 11:00:00 PM,48,-122,6,2,8
38832,FremontBridge,03/09/2017 12:00:00 AM,48,-122,6,6,12
38833,FremontBridge,03/09/2017 01:00:00 AM,48,-122,1,1,2
38834,FremontBridge,03/09/2017 02:00:00 AM,48,-122,0,0,0
38835,FremontBridge,03/09/2017 03:00:00 AM,48,-122,1,1,2
38836,FremontBridge,03/09/2017 04:00:00 AM,48,-122,2,3,5
38837,FremontBridge,03/09/2017 05:00:00 AM,48,-122,11,14,25
38838,FremontBridge,03/09/2017 06:00:00 AM,48,-122,28,48,76
38839,FremontBridge,03/09/2017 07:00:00 AM,48,-122,71,131,202
38840,FremontBridge,03/09/2017 08:00:00 AM,48,-122,129,153,282
38841,FremontBridge,03/09/2017 09:00:00 AM,48,-122,71,75,146
38842,FremontBridge,03/09/2017 10:00:00 AM,48,-122,29,32,61
38843,FremontBridge,03/09/2017 11:00:00 AM,48,-122,19,11,30
38844,FremontBridge,03/09/2017 12:00:00 PM,48,-122,9,14,23
38845,FremontBridge,03/09/2017 01:00:00 PM,48,-122,14,18,32
38846,FremontBridge,03/09/2017 02:00:00 PM,48,-122,10,11,21
38847,FremontBridge,03/09/2017 03:00:00 PM,48,-122,26,11,37
38848,FremontBridge,03/09/2017 04:00:00 PM,48,-122,95,28,123
38849,FremontBridge,03/09/2017 05:00:00 PM,48,-122,235,60,295
38850,FremontBridge,03/09/2017 06:00:00 PM,48,-122,145,43,188
38851,FremontBridge,03/09/2017 07:00:00 PM,48,-122,64,21,85
38852,FremontBridge,03/09/2017 08:00:00 PM,48,-122,42,9,51
38853,FremontBridge,03/09/2017 09:00:00 PM,48,-122,14,7,21
38854,FremontBridge,03/09/2017 10:00:00 PM,48,-122,16,4,20
38855,FremontBridge,03/09/2017 11:00:00 PM,48,-122,4,5,9
38856,FremontBridge,03/10/2017 12:00:00 AM,48,-122,5,2,7
38857,FremontBridge,03/10/2017 01:00:00 AM,48,-122,1,1,2
38858,FremontBridge,03/10/2017 02:00:00 AM,48,-122,1,1,2
38859,FremontBridge,03/10/2017 03:00:00 AM,48,-122,2,0,2
38860,FremontBridge,03/10/2017 04:00:00 AM,48,-122,3,5,8
38861,FremontBridge,03/10/2017 05:00:00 AM,48,-122,9,12,21
38862,FremontBridge,03/10/2017 06:00:00 AM,48,-122,22,29,51
38863,FremontBridge,03/10/2017 07:00:00 AM,48,-122,67,91,158
38864,FremontBridge,03/10/2017 08:00:00 AM,48,-122,116,141,257
38865,FremontBridge,03/10/2017 09:00:00 AM,48,-122,80,76,156
38866,FremontBridge,03/10/2017 10:00:00 AM,48,-122,25,35,60
38867,FremontBridge,03/10/2017 11:00:00 AM,48,-122,21,23,44
38868,FremontBridge,03/10/2017 12:00:00 PM,48,-122,27,19,46
38869,FremontBridge,03/10/2017 01:00:00 PM,48,-122,30,25,55
38870,FremontBridge,03/10/2017 02:00:00 PM,48,-122,22,26,48
38871,FremontBridge,03/10/2017 03:00:00 PM,48,-122,67,54,121
38872,FremontBridge,03/10/2017 04:00:00 PM,48,-122,114,74,188
38873,FremontBridge,03/10/2017 05:00:00 PM,48,-122,238,98,336
38874,FremontBridge,03/10/2017 06:00:00 PM,48,-122,153,74,227
38875,FremontBridge,03/10/2017 07:00:00 PM,48,-122,51,28,79
38876,FremontBridge,03/10/2017 08:00:00 PM,48,-122,22,11,33
38877,FremontBridge,03/10/2017 09:00:00 PM,48,-122,22,9,31
38878,FremontBridge,03/10/2017 10:00:00 PM,48,-122,17,8,25
38879,FremontBridge,03/10/2017 11:00:00 PM,48,-122,4,10,14
38880,FremontBridge,03/11/2017 12:00:00 AM,48,-122,10,2,12
38881,FremontBridge,03/11/2017 01:00:00 AM,48,-122,8,7,15
38882,FremontBridge,03/11/2017 02:00:00 AM,48,-122,0,1,1
38883,FremontBridge,03/11/2017 03:00:00 AM,48,-122,3,1,4
38884,FremontBridge,03/11/2017 04:00:00 AM,48,-122,1,1,2
38885,FremontBridge,03/11/2017 05:00:00 AM,48,-122,2,2,4
38886,FremontBridge,03/11/2017 06:00:00 AM,48,-122,6,9,15
38887,FremontBridge,03/11/2017 07:00:00 AM,48,-122,14,12,26
38888,FremontBridge,03/11/2017 08:00:00 AM,48,-122,25,28,53
38889,FremontBridge,03/11/2017 09:00:00 AM,48,-122,19,23,42
38890,FremontBridge,03/11/2017 10:00:00 AM,48,-122,4,17,21
38891,FremontBridge,03/11/2017 11:00:00 AM,48,-122,8,15,23
38892,FremontBridge,03/11/2017 12:00:00 PM,48,-122,10,6,16
38893,FremontBridge,03/11/2017 01:00:00 PM,48,-122,9,12,21
38894,FremontBridge,03/11/2017 02:00:00 PM,48,-122,11,15,26
38895,FremontBridge,03/11/2017 03:00:00 PM,48,-122,15,27,42
38896,FremontBridge,03/11/2017 04:00:00 PM,48,-122,18,15,33
38897,FremontBridge,03/11/2017 05:00:00 PM,48,-122,17,12,29
38898,FremontBridge,03/11/2017 06:00:00 PM,48,-122,16,14,30
38899,FremontBridge,03/11/2017 07:00:00 PM,48,-122,9,6,15
38900,FremontBridge,03/11/2017 08:00:00 PM,48,-122,9,4,13
38901,FremontBridge,03/11/2017 09:00:00 PM,48,-122,8,1,9
38902,FremontBridge,03/11/2017 10:00:00 PM,48,-122,5,5,10
38903,FremontBridge,03/11/2017 11:00:00 PM,48,-122,9,3,12
38904,FremontBridge,03/12/2017 12:00:00 AM,48,-122,3,2,5
38905,FremontBridge,03/12/2017 01:00:00 AM,48,-122,0,2,2
38906,FremontBridge,03/12/2017 02:00:00 AM,48,-122,,,
38907,FremontBridge,03/12/2017 03:00:00 AM,48,-122,1,1,2
38908,FremontBridge,03/12/2017 04:00:00 AM,48,-122,1,0,1
38909,FremontBridge,03/12/2017 05:00:00 AM,48,-122,0,2,2
38910,FremontBridge,03/12/2017 06:00:00 AM,48,-122,2,3,5
38911,FremontBridge,03/12/2017 07:00:00 AM,48,-122,3,3,6
38912,FremontBridge,03/12/2017 08:00:00 AM,48,-122,17,11,28
38913,FremontBridge,03/12/2017 09:00:00 AM,48,-122,17,20,37
38914,FremontBridge,03/12/2017 10:00:00 AM,48,-122,23,23,46
38915,FremontBridge,03/12/2017 11:00:00 AM,48,-122,25,41,66
38916,FremontBridge,03/12/2017 12:00:00 PM,48,-122,32,44,76
38917,FremontBridge,03/12/2017 01:00:00 PM,48,-122,32,33,65
38918,FremontBridge,03/12/2017 02:00:00 PM,48,-122,30,30,60
38919,FremontBridge,03/12/2017 03:00:00 PM,48,-122,27,34,61
38920,FremontBridge,03/12/2017 04:00:00 PM,48,-122,28,39,67
38921,FremontBridge,03/12/2017 05:00:00 PM,48,-122,24,33,57
38922,FremontBridge,03/12/2017 06:00:00 PM,48,-122,23,32,55
38923,FremontBridge,03/12/2017 07:00:00 PM,48,-122,12,12,24
38924,FremontBridge,03/12/2017 08:00:00 PM,48,-122,11,22,33
38925,FremontBridge,03/12/2017 09:00:00 PM,48,-122,4,10,14
38926,FremontBridge,03/12/2017 10:00:00 PM,48,-122,3,9,12
38927,FremontBridge,03/12/2017 11:00:00 PM,48,-122,8,4,12
38928,FremontBridge,03/13/2017 12:00:00 AM,48,-122,4,0,4
38929,FremontBridge,03/13/2017 01:00:00 AM,48,-122,4,0,4
38930,FremontBridge,03/13/2017 02:00:00 AM,48,-122,1,3,4
38931,FremontBridge,03/13/2017 03:00:00 AM,48,-122,2,1,3
38932,FremontBridge,03/13/2017 04:00:00 AM,48,-122,4,2,6
38933,FremontBridge,03/13/2017 05:00:00 AM,48,-122,11,13,24
38934,FremontBridge,03/13/2017 06:00:00 AM,48,-122,32,52,84
38935,FremontBridge,03/13/2017 07:00:00 AM,48,-122,65,117,182
38936,FremontBridge,03/13/2017 08:00:00 AM,48,-122,125,171,296
38937,FremontBridge,03/13/2017 09:00:00 AM,48,-122,78,89,167
38938,FremontBridge,03/13/2017 10:00:00 AM,48,-122,37,33,70
38939,FremontBridge,03/13/2017 11:00:00 AM,48,-122,17,9,26
38940,FremontBridge,03/13/2017 12:00:00 PM,48,-122,6,15,21
38941,FremontBridge,03/13/2017 01:00:00 PM,48,-122,12,10,22
38942,FremontBridge,03/13/2017 02:00:00 PM,48,-122,11,8,19
38943,FremontBridge,03/13/2017 03:00:00 PM,48,-122,26,19,45
38944,FremontBridge,03/13/2017 04:00:00 PM,48,-122,83,31,114
38945,FremontBridge,03/13/2017 05:00:00 PM,48,-122,254,66,320
38946,FremontBridge,03/13/2017 06:00:00 PM,48,-122,194,55,249
38947,FremontBridge,03/13/2017 07:00:00 PM,48,-122,69,24,93
38948,FremontBridge,03/13/2017 08:00:00 PM,48,-122,40,11,51
38949,FremontBridge,03/13/2017 09:00:00 PM,48,-122,15,10,25
38950,FremontBridge,03/13/2017 10:00:00 PM,48,-122,10,8,18
38951,FremontBridge,03/13/2017 11:00:00 PM,48,-122,3,4,7
38952,FremontBridge,03/14/2017 12:00:00 AM,48,-122,1,2,3
38953,FremontBridge,03/14/2017 01:00:00 AM,48,-122,2,1,3
38954,FremontBridge,03/14/2017 02:00:00 AM,48,-122,1,0,1
38955,FremontBridge,03/14/2017 03:00:00 AM,48,-122,1,1,2
38956,FremontBridge,03/14/2017 04:00:00 AM,48,-122,1,2,3
38957,FremontBridge,03/14/2017 05:00:00 AM,48,-122,10,18,28
38958,FremontBridge,03/14/2017 06:00:00 AM,48,-122,26,51,77
38959,FremontBridge,03/14/2017 07:00:00 AM,48,-122,61,130,191
38960,FremontBridge,03/14/2017 08:00:00 AM,48,-122,132,175,307
38961,FremontBridge,03/14/2017 09:00:00 AM,48,-122,96,95,191
38962,FremontBridge,03/14/2017 10:00:00 AM,48,-122,31,24,55
38963,FremontBridge,03/14/2017 11:00:00 AM,48,-122,23,13,36
38964,FremontBridge,03/14/2017 12:00:00 PM,48,-122,13,10,23
38965,FremontBridge,03/14/2017 01:00:00 PM,48,-122,15,12,27
38966,FremontBridge,03/14/2017 02:00:00 PM,48,-122,15,10,25
38967,FremontBridge,03/14/2017 03:00:00 PM,48,-122,36,22,58
38968,FremontBridge,03/14/2017 04:00:00 PM,48,-122,110,36,146
38969,FremontBridge,03/14/2017 05:00:00 PM,48,-122,253,68,321
38970,FremontBridge,03/14/2017 06:00:00 PM,48,-122,184,59,243
38971,FremontBridge,03/14/2017 07:00:00 PM,48,-122,85,37,122
38972,FremontBridge,03/14/2017 08:00:00 PM,48,-122,30,17,47
38973,FremontBridge,03/14/2017 09:00:00 PM,48,-122,8,11,19
38974,FremontBridge,03/14/2017 10:00:00 PM,48,-122,12,6,18
38975,FremontBridge,03/14/2017 11:00:00 PM,48,-122,5,4,9
38976,FremontBridge,03/15/2017 12:00:00 AM,48,-122,2,0,2
38977,FremontBridge,03/15/2017 01:00:00 AM,48,-122,0,1,1
38978,FremontBridge,03/15/2017 02:00:00 AM,48,-122,0,3,3
38979,FremontBridge,03/15/2017 03:00:00 AM,48,-122,0,2,2
38980,FremontBridge,03/15/2017 04:00:00 AM,48,-122,2,6,8
38981,FremontBridge,03/15/2017 05:00:00 AM,48,-122,12,12,24
38982,FremontBridge,03/15/2017 06:00:00 AM,48,-122,29,54,83
38983,FremontBridge,03/15/2017 07:00:00 AM,48,-122,77,109,186
38984,FremontBridge,03/15/2017 08:00:00 AM,48,-122,109,161,270
38985,FremontBridge,03/15/2017 09:00:00 AM,48,-122,71,70,141
38986,FremontBridge,03/15/2017 10:00:00 AM,48,-122,20,25,45
38987,FremontBridge,03/15/2017 11:00:00 AM,48,-122,16,12,28
38988,FremontBridge,03/15/2017 12:00:00 PM,48,-122,8,11,19
38989,FremontBridge,03/15/2017 01:00:00 PM,48,-122,10,14,24
38990,FremontBridge,03/15/2017 02:00:00 PM,48,-122,25,9,34
38991,FremontBridge,03/15/2017 03:00:00 PM,48,-122,35,32,67
38992,FremontBridge,03/15/2017 04:00:00 PM,48,-122,91,54,145
38993,FremontBridge,03/15/2017 05:00:00 PM,48,-122,232,88,320
38994,FremontBridge,03/15/2017 06:00:00 PM,48,-122,159,54,213
38995,FremontBridge,03/15/2017 07:00:00 PM,48,-122,59,35,94
38996,FremontBridge,03/15/2017 08:00:00 PM,48,-122,36,12,48
38997,FremontBridge,03/15/2017 09:00:00 PM,48,-122,21,14,35
38998,FremontBridge,03/15/2017 10:00:00 PM,48,-122,12,4,16
38999,FremontBridge,03/15/2017 11:00:00 PM,48,-122,9,4,13
39000,FremontBridge,03/16/2017 12:00:00 AM,48,-122,3,1,4
39001,FremontBridge,03/16/2017 01:00:00 AM,48,-122,2,1,3
39002,FremontBridge,03/16/2017 02:00:00 AM,48,-122,0,0,0
39003,FremontBridge,03/16/2017 03:00:00 AM,48,-122,1,0,1
39004,FremontBridge,03/16/2017 04:00:00 AM,48,-122,1,4,5
39005,FremontBridge,03/16/2017 05:00:00 AM,48,-122,10,19,29
39006,FremontBridge,03/16/2017 06:00:00 AM,48,-122,43,56,99
39007,FremontBridge,03/16/2017 07:00:00 AM,48,-122,97,184,281
39008,FremontBridge,03/16/2017 08:00:00 AM,48,-122,149,234,383
39009,FremontBridge,03/16/2017 09:00:00 AM,48,-122,114,135,249
39010,FremontBridge,03/16/2017 10:00:00 AM,48,-122,45,46,91
39011,FremontBridge,03/16/2017 11:00:00 AM,48,-122,38,25,63
39012,FremontBridge,03/16/2017 12:00:00 PM,48,-122,33,37,70
39013,FremontBridge,03/16/2017 01:00:00 PM,48,-122,39,43,82
39014,FremontBridge,03/16/2017 02:00:00 PM,48,-122,37,28,65
39015,FremontBridge,03/16/2017 03:00:00 PM,48,-122,47,42,89
39016,FremontBridge,03/16/2017 04:00:00 PM,48,-122,155,75,230
39017,FremontBridge,03/16/2017 05:00:00 PM,48,-122,344,110,454
39018,FremontBridge,03/16/2017 06:00:00 PM,48,-122,238,87,325
39019,FremontBridge,03/16/2017 07:00:00 PM,48,-122,108,43,151
39020,FremontBridge,03/16/2017 08:00:00 PM,48,-122,31,28,59
39021,FremontBridge,03/16/2017 09:00:00 PM,48,-122,32,19,51
39022,FremontBridge,03/16/2017 10:00:00 PM,48,-122,11,15,26
39023,FremontBridge,03/16/2017 11:00:00 PM,48,-122,7,11,18
39024,FremontBridge,03/17/2017 12:00:00 AM,48,-122,6,2,8
39025,FremontBridge,03/17/2017 01:00:00 AM,48,-122,5,4,9
39026,FremontBridge,03/17/2017 02:00:00 AM,48,-122,0,1,1
39027,FremontBridge,03/17/2017 03:00:00 AM,48,-122,1,0,1
39028,FremontBridge,03/17/2017 04:00:00 AM,48,-122,1,4,5
39029,FremontBridge,03/17/2017 05:00:00 AM,48,-122,12,14,26
39030,FremontBridge,03/17/2017 06:00:00 AM,48,-122,29,48,77
39031,FremontBridge,03/17/2017 07:00:00 AM,48,-122,65,135,200
39032,FremontBridge,03/17/2017 08:00:00 AM,48,-122,131,170,301
39033,FremontBridge,03/17/2017 09:00:00 AM,48,-122,88,88,176
39034,FremontBridge,03/17/2017 10:00:00 AM,48,-122,32,32,64
39035,FremontBridge,03/17/2017 11:00:00 AM,48,-122,21,32,53
39036,FremontBridge,03/17/2017 12:00:00 PM,48,-122,27,30,57
39037,FremontBridge,03/17/2017 01:00:00 PM,48,-122,20,9,29
39038,FremontBridge,03/17/2017 02:00:00 PM,48,-122,18,10,28
39039,FremontBridge,03/17/2017 03:00:00 PM,48,-122,29,28,57
39040,FremontBridge,03/17/2017 04:00:00 PM,48,-122,97,31,128
39041,FremontBridge,03/17/2017 05:00:00 PM,48,-122,227,54,281
39042,FremontBridge,03/17/2017 06:00:00 PM,48,-122,117,43,160
39043,FremontBridge,03/17/2017 07:00:00 PM,48,-122,49,21,70
39044,FremontBridge,03/17/2017 08:00:00 PM,48,-122,18,11,29
39045,FremontBridge,03/17/2017 09:00:00 PM,48,-122,12,8,20
39046,FremontBridge,03/17/2017 10:00:00 PM,48,-122,6,6,12
39047,FremontBridge,03/17/2017 11:00:00 PM,48,-122,5,3,8
39048,FremontBridge,03/18/2017 12:00:00 AM,48,-122,3,1,4
39049,FremontBridge,03/18/2017 01:00:00 AM,48,-122,2,0,2
39050,FremontBridge,03/18/2017 02:00:00 AM,48,-122,1,1,2
39051,FremontBridge,03/18/2017 03:00:00 AM,48,-122,0,1,1
39052,FremontBridge,03/18/2017 04:00:00 AM,48,-122,1,1,2
39053,FremontBridge,03/18/2017 05:00:00 AM,48,-122,6,2,8
39054,FremontBridge,03/18/2017 06:00:00 AM,48,-122,3,2,5
39055,FremontBridge,03/18/2017 07:00:00 AM,48,-122,4,8,12
39056,FremontBridge,03/18/2017 08:00:00 AM,48,-122,9,15,24
39057,FremontBridge,03/18/2017 09:00:00 AM,48,-122,8,14,22
39058,FremontBridge,03/18/2017 10:00:00 AM,48,-122,10,16,26
39059,FremontBridge,03/18/2017 11:00:00 AM,48,-122,10,17,27
39060,FremontBridge,03/18/2017 12:00:00 PM,48,-122,8,8,16
39061,FremontBridge,03/18/2017 01:00:00 PM,48,-122,14,17,31
39062,FremontBridge,03/18/2017 02:00:00 PM,48,-122,21,17,38
39063,FremontBridge,03/18/2017 03:00:00 PM,48,-122,32,29,61
39064,FremontBridge,03/18/2017 04:00:00 PM,48,-122,41,42,83
39065,FremontBridge,03/18/2017 05:00:00 PM,48,-122,43,27,70
39066,FremontBridge,03/18/2017 06:00:00 PM,48,-122,35,23,58
39067,FremontBridge,03/18/2017 07:00:00 PM,48,-122,15,16,31
39068,FremontBridge,03/18/2017 08:00:00 PM,48,-122,14,5,19
39069,FremontBridge,03/18/2017 09:00:00 PM,48,-122,12,2,14
39070,FremontBridge,03/18/2017 10:00:00 PM,48,-122,12,12,24
39071,FremontBridge,03/18/2017 11:00:00 PM,48,-122,8,9,17
39072,FremontBridge,03/19/2017 12:00:00 AM,48,-122,3,6,9
39073,FremontBridge,03/19/2017 01:00:00 AM,48,-122,5,4,9
39074,FremontBridge,03/19/2017 02:00:00 AM,48,-122,2,2,4
39075,FremontBridge,03/19/2017 03:00:00 AM,48,-122,3,1,4
39076,FremontBridge,03/19/2017 04:00:00 AM,48,-122,1,0,1
39077,FremontBridge,03/19/2017 05:00:00 AM,48,-122,2,2,4
39078,FremontBridge,03/19/2017 06:00:00 AM,48,-122,1,2,3
39079,FremontBridge,03/19/2017 07:00:00 AM,48,-122,11,21,32
39080,FremontBridge,03/19/2017 08:00:00 AM,48,-122,15,20,35
39081,FremontBridge,03/19/2017 09:00:00 AM,48,-122,31,39,70
39082,FremontBridge,03/19/2017 10:00:00 AM,48,-122,59,39,98
39083,FremontBridge,03/19/2017 11:00:00 AM,48,-122,81,97,178
39084,FremontBridge,03/19/2017 12:00:00 PM,48,-122,75,119,194
39085,FremontBridge,03/19/2017 01:00:00 PM,48,-122,119,124,243
39086,FremontBridge,03/19/2017 02:00:00 PM,48,-122,105,135,240
39087,FremontBridge,03/19/2017 03:00:00 PM,48,-122,110,117,227
39088,FremontBridge,03/19/2017 04:00:00 PM,48,-122,71,104,175
39089,FremontBridge,03/19/2017 05:00:00 PM,48,-122,61,60,121
39090,FremontBridge,03/19/2017 06:00:00 PM,48,-122,46,43,89
39091,FremontBridge,03/19/2017 07:00:00 PM,48,-122,34,29,63
39092,FremontBridge,03/19/2017 08:00:00 PM,48,-122,23,20,43
39093,FremontBridge,03/19/2017 09:00:00 PM,48,-122,15,8,23
39094,FremontBridge,03/19/2017 10:00:00 PM,48,-122,8,9,17
39095,FremontBridge,03/19/2017 11:00:00 PM,48,-122,3,2,5
39096,FremontBridge,03/20/2017 12:00:00 AM,48,-122,4,2,6
39097,FremontBridge,03/20/2017 01:00:00 AM,48,-122,1,0,1
39098,FremontBridge,03/20/2017 02:00:00 AM,48,-122,1,0,1
39099,FremontBridge,03/20/2017 03:00:00 AM,48,-122,0,1,1
39100,FremontBridge,03/20/2017 04:00:00 AM,48,-122,5,2,7
39101,FremontBridge,03/20/2017 05:00:00 AM,48,-122,17,23,40
39102,FremontBridge,03/20/2017 06:00:00 AM,48,-122,50,71,121
39103,FremontBridge,03/20/2017 07:00:00 AM,48,-122,99,161,260
39104,FremontBridge,03/20/2017 08:00:00 AM,48,-122,180,251,431
39105,FremontBridge,03/20/2017 09:00:00 AM,48,-122,89,102,191
39106,FremontBridge,03/20/2017 10:00:00 AM,48,-122,51,32,83
39107,FremontBridge,03/20/2017 11:00:00 AM,48,-122,18,21,39
39108,FremontBridge,03/20/2017 12:00:00 PM,48,-122,21,26,47
39109,FremontBridge,03/20/2017 01:00:00 PM,48,-122,35,37,72
39110,FremontBridge,03/20/2017 02:00:00 PM,48,-122,38,37,75
39111,FremontBridge,03/20/2017 03:00:00 PM,48,-122,56,46,102
39112,FremontBridge,03/20/2017 04:00:00 PM,48,-122,150,53,203
39113,FremontBridge,03/20/2017 05:00:00 PM,48,-122,384,96,480
39114,FremontBridge,03/20/2017 06:00:00 PM,48,-122,205,92,297
39115,FremontBridge,03/20/2017 07:00:00 PM,48,-122,95,42,137
39116,FremontBridge,03/20/2017 08:00:00 PM,48,-122,40,12,52
39117,FremontBridge,03/20/2017 09:00:00 PM,48,-122,24,12,36
39118,FremontBridge,03/20/2017 10:00:00 PM,48,-122,11,16,27
39119,FremontBridge,03/20/2017 11:00:00 PM,48,-122,6,3,9
39120,FremontBridge,03/21/2017 12:00:00 AM,48,-122,3,3,6
39121,FremontBridge,03/21/2017 01:00:00 AM,48,-122,0,0,0
39122,FremontBridge,03/21/2017 02:00:00 AM,48,-122,1,0,1
39123,FremontBridge,03/21/2017 03:00:00 AM,48,-122,0,1,1
39124,FremontBridge,03/21/2017 04:00:00 AM,48,-122,1,3,4
39125,FremontBridge,03/21/2017 05:00:00 AM,48,-122,11,17,28
39126,FremontBridge,03/21/2017 06:00:00 AM,48,-122,31,52,83
39127,FremontBridge,03/21/2017 07:00:00 AM,48,-122,78,121,199
39128,FremontBridge,03/21/2017 08:00:00 AM,48,-122,133,195,328
39129,FremontBridge,03/21/2017 09:00:00 AM,48,-122,86,87,173
39130,FremontBridge,03/21/2017 10:00:00 AM,48,-122,39,23,62
39131,FremontBridge,03/21/2017 11:00:00 AM,48,-122,13,24,37
39132,FremontBridge,03/21/2017 12:00:00 PM,48,-122,24,15,39
39133,FremontBridge,03/21/2017 01:00:00 PM,48,-122,15,19,34
39134,FremontBridge,03/21/2017 02:00:00 PM,48,-122,24,17,41
39135,FremontBridge,03/21/2017 03:00:00 PM,48,-122,50,26,76
39136,FremontBridge,03/21/2017 04:00:00 PM,48,-122,107,40,147
39137,FremontBridge,03/21/2017 05:00:00 PM,48,-122,308,83,391
39138,FremontBridge,03/21/2017 06:00:00 PM,48,-122,169,100,269
39139,FremontBridge,03/21/2017 07:00:00 PM,48,-122,82,43,125
39140,FremontBridge,03/21/2017 08:00:00 PM,48,-122,37,15,52
39141,FremontBridge,03/21/2017 09:00:00 PM,48,-122,23,15,38
39142,FremontBridge,03/21/2017 10:00:00 PM,48,-122,9,5,14
39143,FremontBridge,03/21/2017 11:00:00 PM,48,-122,10,5,15
39144,FremontBridge,03/22/2017 12:00:00 AM,48,-122,2,5,7
39145,FremontBridge,03/22/2017 01:00:00 AM,48,-122,1,1,2
39146,FremontBridge,03/22/2017 02:00:00 AM,48,-122,1,0,1
39147,FremontBridge,03/22/2017 03:00:00 AM,48,-122,0,0,0
39148,FremontBridge,03/22/2017 04:00:00 AM,48,-122,3,4,7
39149,FremontBridge,03/22/2017 05:00:00 AM,48,-122,11,19,30
39150,FremontBridge,03/22/2017 06:00:00 AM,48,-122,37,68,105
39151,FremontBridge,03/22/2017 07:00:00 AM,48,-122,111,152,263
39152,FremontBridge,03/22/2017 08:00:00 AM,48,-122,139,227,366
39153,FremontBridge,03/22/2017 09:00:00 AM,48,-122,97,102,199
39154,FremontBridge,03/22/2017 10:00:00 AM,48,-122,55,34,89
39155,FremontBridge,03/22/2017 11:00:00 AM,48,-122,18,31,49
39156,FremontBridge,03/22/2017 12:00:00 PM,48,-122,24,33,57
39157,FremontBridge,03/22/2017 01:00:00 PM,48,-122,16,37,53
39158,FremontBridge,03/22/2017 02:00:00 PM,48,-122,36,25,61
39159,FremontBridge,03/22/2017 03:00:00 PM,48,-122,53,49,102
39160,FremontBridge,03/22/2017 04:00:00 PM,48,-122,167,49,216
39161,FremontBridge,03/22/2017 05:00:00 PM,48,-122,327,113,440
39162,FremontBridge,03/22/2017 06:00:00 PM,48,-122,197,99,296
39163,FremontBridge,03/22/2017 07:00:00 PM,48,-122,91,49,140
39164,FremontBridge,03/22/2017 08:00:00 PM,48,-122,53,20,73
39165,FremontBridge,03/22/2017 09:00:00 PM,48,-122,33,16,49
39166,FremontBridge,03/22/2017 10:00:00 PM,48,-122,13,15,28
39167,FremontBridge,03/22/2017 11:00:00 PM,48,-122,9,5,14
39168,FremontBridge,03/23/2017 12:00:00 AM,48,-122,5,1,6
39169,FremontBridge,03/23/2017 01:00:00 AM,48,-122,2,2,4
39170,FremontBridge,03/23/2017 02:00:00 AM,48,-122,0,0,0
39171,FremontBridge,03/23/2017 03:00:00 AM,48,-122,2,0,2
39172,FremontBridge,03/23/2017 04:00:00 AM,48,-122,3,3,6
39173,FremontBridge,03/23/2017 05:00:00 AM,48,-122,18,17,35
39174,FremontBridge,03/23/2017 06:00:00 AM,48,-122,43,68,111
39175,FremontBridge,03/23/2017 07:00:00 AM,48,-122,114,172,286
39176,FremontBridge,03/23/2017 08:00:00 AM,48,-122,179,241,420
39177,FremontBridge,03/23/2017 09:00:00 AM,48,-122,98,124,222
39178,FremontBridge,03/23/2017 10:00:00 AM,48,-122,50,44,94
39179,FremontBridge,03/23/2017 11:00:00 AM,48,-122,30,28,58
39180,FremontBridge,03/23/2017 12:00:00 PM,48,-122,31,26,57
39181,FremontBridge,03/23/2017 01:00:00 PM,48,-122,44,31,75
39182,FremontBridge,03/23/2017 02:00:00 PM,48,-122,41,22,63
39183,FremontBridge,03/23/2017 03:00:00 PM,48,-122,65,45,110
39184,FremontBridge,03/23/2017 04:00:00 PM,48,-122,160,64,224
39185,FremontBridge,03/23/2017 05:00:00 PM,48,-122,344,135,479
39186,FremontBridge,03/23/2017 06:00:00 PM,48,-122,226,108,334
39187,FremontBridge,03/23/2017 07:00:00 PM,48,-122,92,32,124
39188,FremontBridge,03/23/2017 08:00:00 PM,48,-122,45,16,61
39189,FremontBridge,03/23/2017 09:00:00 PM,48,-122,23,12,35
39190,FremontBridge,03/23/2017 10:00:00 PM,48,-122,17,11,28
39191,FremontBridge,03/23/2017 11:00:00 PM,48,-122,13,6,19
39192,FremontBridge,03/24/2017 12:00:00 AM,48,-122,8,2,10
39193,FremontBridge,03/24/2017 01:00:00 AM,48,-122,1,2,3
39194,FremontBridge,03/24/2017 02:00:00 AM,48,-122,2,2,4
39195,FremontBridge,03/24/2017 03:00:00 AM,48,-122,0,1,1
39196,FremontBridge,03/24/2017 04:00:00 AM,48,-122,1,2,3
39197,FremontBridge,03/24/2017 05:00:00 AM,48,-122,11,13,24
39198,FremontBridge,03/24/2017 06:00:00 AM,48,-122,28,33,61
39199,FremontBridge,03/24/2017 07:00:00 AM,48,-122,67,98,165
39200,FremontBridge,03/24/2017 08:00:00 AM,48,-122,99,130,229
39201,FremontBridge,03/24/2017 09:00:00 AM,48,-122,42,62,104
39202,FremontBridge,03/24/2017 10:00:00 AM,48,-122,29,26,55
39203,FremontBridge,03/24/2017 11:00:00 AM,48,-122,17,18,35
39204,FremontBridge,03/24/2017 12:00:00 PM,48,-122,21,20,41
39205,FremontBridge,03/24/2017 01:00:00 PM,48,-122,24,22,46
39206,FremontBridge,03/24/2017 02:00:00 PM,48,-122,14,13,27
39207,FremontBridge,03/24/2017 03:00:00 PM,48,-122,55,17,72
39208,FremontBridge,03/24/2017 04:00:00 PM,48,-122,108,45,153
39209,FremontBridge,03/24/2017 05:00:00 PM,48,-122,181,68,249
39210,FremontBridge,03/24/2017 06:00:00 PM,48,-122,121,46,167
39211,FremontBridge,03/24/2017 07:00:00 PM,48,-122,39,21,60
39212,FremontBridge,03/24/2017 08:00:00 PM,48,-122,15,7,22
39213,FremontBridge,03/24/2017 09:00:00 PM,48,-122,16,6,22
39214,FremontBridge,03/24/2017 10:00:00 PM,48,-122,11,13,24
39215,FremontBridge,03/24/2017 11:00:00 PM,48,-122,5,3,8
39216,FremontBridge,03/25/2017 12:00:00 AM,48,-122,8,5,13
39217,FremontBridge,03/25/2017 01:00:00 AM,48,-122,3,2,5
39218,FremontBridge,03/25/2017 02:00:00 AM,48,-122,1,2,3
39219,FremontBridge,03/25/2017 03:00:00 AM,48,-122,2,0,2
39220,FremontBridge,03/25/2017 04:00:00 AM,48,-122,1,1,2
39221,FremontBridge,03/25/2017 05:00:00 AM,48,-122,4,0,4
39222,FremontBridge,03/25/2017 06:00:00 AM,48,-122,5,4,9
39223,FremontBridge,03/25/2017 07:00:00 AM,48,-122,21,18,39
39224,FremontBridge,03/25/2017 08:00:00 AM,48,-122,29,38,67
39225,FremontBridge,03/25/2017 09:00:00 AM,48,-122,40,61,101
39226,FremontBridge,03/25/2017 10:00:00 AM,48,-122,47,38,85
39227,FremontBridge,03/25/2017 11:00:00 AM,48,-122,60,75,135
39228,FremontBridge,03/25/2017 12:00:00 PM,48,-122,98,73,171
39229,FremontBridge,03/25/2017 01:00:00 PM,48,-122,79,59,138
39230,FremontBridge,03/25/2017 02:00:00 PM,48,-122,94,70,164
39231,FremontBridge,03/25/2017 03:00:00 PM,48,-122,84,81,165
39232,FremontBridge,03/25/2017 04:00:00 PM,48,-122,79,68,147
39233,FremontBridge,03/25/2017 05:00:00 PM,48,-122,63,68,131
39234,FremontBridge,03/25/2017 06:00:00 PM,48,-122,37,42,79
39235,FremontBridge,03/25/2017 07:00:00 PM,48,-122,20,22,42
39236,FremontBridge,03/25/2017 08:00:00 PM,48,-122,15,12,27
39237,FremontBridge,03/25/2017 09:00:00 PM,48,-122,15,12,27
39238,FremontBridge,03/25/2017 10:00:00 PM,48,-122,14,4,18
39239,FremontBridge,03/25/2017 11:00:00 PM,48,-122,10,9,19
39240,FremontBridge,03/26/2017 12:00:00 AM,48,-122,1,10,11
39241,FremontBridge,03/26/2017 01:00:00 AM,48,-122,5,1,6
39242,FremontBridge,03/26/2017 02:00:00 AM,48,-122,2,1,3
39243,FremontBridge,03/26/2017 03:00:00 AM,48,-122,0,0,0
39244,FremontBridge,03/26/2017 04:00:00 AM,48,-122,1,0,1
39245,FremontBridge,03/26/2017 05:00:00 AM,48,-122,1,2,3
39246,FremontBridge,03/26/2017 06:00:00 AM,48,-122,7,3,10
39247,FremontBridge,03/26/2017 07:00:00 AM,48,-122,9,7,16
39248,FremontBridge,03/26/2017 08:00:00 AM,48,-122,14,15,29
39249,FremontBridge,03/26/2017 09:00:00 AM,48,-122,10,15,25
39250,FremontBridge,03/26/2017 10:00:00 AM,48,-122,22,15,37
39251,FremontBridge,03/26/2017 11:00:00 AM,48,-122,9,7,16
39252,FremontBridge,03/26/2017 12:00:00 PM,48,-122,22,26,48
39253,FremontBridge,03/26/2017 01:00:00 PM,48,-122,21,17,38
39254,FremontBridge,03/26/2017 02:00:00 PM,48,-122,15,21,36
39255,FremontBridge,03/26/2017 03:00:00 PM,48,-122,16,11,27
39256,FremontBridge,03/26/2017 04:00:00 PM,48,-122,16,25,41
39257,FremontBridge,03/26/2017 05:00:00 PM,48,-122,11,20,31
39258,FremontBridge,03/26/2017 06:00:00 PM,48,-122,11,19,30
39259,FremontBridge,03/26/2017 07:00:00 PM,48,-122,10,15,25
39260,FremontBridge,03/26/2017 08:00:00 PM,48,-122,3,6,9
39261,FremontBridge,03/26/2017 09:00:00 PM,48,-122,2,6,8
39262,FremontBridge,03/26/2017 10:00:00 PM,48,-122,3,3,6
39263,FremontBridge,03/26/2017 11:00:00 PM,48,-122,4,6,10
39264,FremontBridge,03/27/2017 12:00:00 AM,48,-122,1,1,2
39265,FremontBridge,03/27/2017 01:00:00 AM,48,-122,2,1,3
39266,FremontBridge,03/27/2017 02:00:00 AM,48,-122,0,0,0
39267,FremontBridge,03/27/2017 03:00:00 AM,48,-122,1,1,2
39268,FremontBridge,03/27/2017 04:00:00 AM,48,-122,1,3,4
39269,FremontBridge,03/27/2017 05:00:00 AM,48,-122,10,20,30
39270,FremontBridge,03/27/2017 06:00:00 AM,48,-122,44,60,104
39271,FremontBridge,03/27/2017 07:00:00 AM,48,-122,87,158,245
39272,FremontBridge,03/27/2017 08:00:00 AM,48,-122,165,231,396
39273,FremontBridge,03/27/2017 09:00:00 AM,48,-122,102,105,207
39274,FremontBridge,03/27/2017 10:00:00 AM,48,-122,38,37,75
39275,FremontBridge,03/27/2017 11:00:00 AM,48,-122,22,30,52
39276,FremontBridge,03/27/2017 12:00:00 PM,48,-122,30,25,55
39277,FremontBridge,03/27/2017 01:00:00 PM,48,-122,24,31,55
39278,FremontBridge,03/27/2017 02:00:00 PM,48,-122,28,29,57
39279,FremontBridge,03/27/2017 03:00:00 PM,48,-122,52,32,84
39280,FremontBridge,03/27/2017 04:00:00 PM,48,-122,131,57,188
39281,FremontBridge,03/27/2017 05:00:00 PM,48,-122,366,119,485
39282,FremontBridge,03/27/2017 06:00:00 PM,48,-122,209,85,294
39283,FremontBridge,03/27/2017 07:00:00 PM,48,-122,82,53,135
39284,FremontBridge,03/27/2017 08:00:00 PM,48,-122,34,26,60
39285,FremontBridge,03/27/2017 09:00:00 PM,48,-122,24,9,33
39286,FremontBridge,03/27/2017 10:00:00 PM,48,-122,15,7,22
39287,FremontBridge,03/27/2017 11:00:00 PM,48,-122,7,2,9
39288,FremontBridge,03/28/2017 12:00:00 AM,48,-122,4,2,6
39289,FremontBridge,03/28/2017 01:00:00 AM,48,-122,1,1,2
39290,FremontBridge,03/28/2017 02:00:00 AM,48,-122,0,0,0
39291,FremontBridge,03/28/2017 03:00:00 AM,48,-122,2,0,2
39292,FremontBridge,03/28/2017 04:00:00 AM,48,-122,2,3,5
39293,FremontBridge,03/28/2017 05:00:00 AM,48,-122,13,20,33
39294,FremontBridge,03/28/2017 06:00:00 AM,48,-122,48,59,107
39295,FremontBridge,03/28/2017 07:00:00 AM,48,-122,99,135,234
39296,FremontBridge,03/28/2017 08:00:00 AM,48,-122,151,210,361
39297,FremontBridge,03/28/2017 09:00:00 AM,48,-122,90,109,199
39298,FremontBridge,03/28/2017 10:00:00 AM,48,-122,31,33,64
39299,FremontBridge,03/28/2017 11:00:00 AM,48,-122,23,14,37
39300,FremontBridge,03/28/2017 12:00:00 PM,48,-122,29,24,53
39301,FremontBridge,03/28/2017 01:00:00 PM,48,-122,29,18,47
39302,FremontBridge,03/28/2017 02:00:00 PM,48,-122,24,18,42
39303,FremontBridge,03/28/2017 03:00:00 PM,48,-122,42,26,68
39304,FremontBridge,03/28/2017 04:00:00 PM,48,-122,117,40,157
39305,FremontBridge,03/28/2017 05:00:00 PM,48,-122,303,105,408
39306,FremontBridge,03/28/2017 06:00:00 PM,48,-122,196,76,272
39307,FremontBridge,03/28/2017 07:00:00 PM,48,-122,86,39,125
39308,FremontBridge,03/28/2017 08:00:00 PM,48,-122,38,18,56
39309,FremontBridge,03/28/2017 09:00:00 PM,48,-122,16,13,29
39310,FremontBridge,03/28/2017 10:00:00 PM,48,-122,5,11,16
39311,FremontBridge,03/28/2017 11:00:00 PM,48,-122,5,1,6
39312,FremontBridge,03/29/2017 12:00:00 AM,48,-122,3,3,6
39313,FremontBridge,03/29/2017 01:00:00 AM,48,-122,0,4,4
39314,FremontBridge,03/29/2017 02:00:00 AM,48,-122,1,0,1
39315,FremontBridge,03/29/2017 03:00:00 AM,48,-122,1,0,1
39316,FremontBridge,03/29/2017 04:00:00 AM,48,-122,1,3,4
39317,FremontBridge,03/29/2017 05:00:00 AM,48,-122,7,12,19
39318,FremontBridge,03/29/2017 06:00:00 AM,48,-122,29,40,69
39319,FremontBridge,03/29/2017 07:00:00 AM,48,-122,72,123,195
39320,FremontBridge,03/29/2017 08:00:00 AM,48,-122,120,160,280
39321,FremontBridge,03/29/2017 09:00:00 AM,48,-122,69,81,150
39322,FremontBridge,03/29/2017 10:00:00 AM,48,-122,25,23,48
39323,FremontBridge,03/29/2017 11:00:00 AM,48,-122,22,18,40
39324,FremontBridge,03/29/2017 12:00:00 PM,48,-122,23,19,42
39325,FremontBridge,03/29/2017 01:00:00 PM,48,-122,20,16,36
39326,FremontBridge,03/29/2017 02:00:00 PM,48,-122,20,19,39
39327,FremontBridge,03/29/2017 03:00:00 PM,48,-122,40,35,75
39328,FremontBridge,03/29/2017 04:00:00 PM,48,-122,109,61,170
39329,FremontBridge,03/29/2017 05:00:00 PM,48,-122,284,91,375
39330,FremontBridge,03/29/2017 06:00:00 PM,48,-122,172,101,273
39331,FremontBridge,03/29/2017 07:00:00 PM,48,-122,105,48,153
39332,FremontBridge,03/29/2017 08:00:00 PM,48,-122,27,29,56
39333,FremontBridge,03/29/2017 09:00:00 PM,48,-122,22,13,35
39334,FremontBridge,03/29/2017 10:00:00 PM,48,-122,12,11,23
39335,FremontBridge,03/29/2017 11:00:00 PM,48,-122,8,6,14
39336,FremontBridge,03/30/2017 12:00:00 AM,48,-122,5,1,6
39337,FremontBridge,03/30/2017 01:00:00 AM,48,-122,0,0,0
39338,FremontBridge,03/30/2017 02:00:00 AM,48,-122,0,3,3
39339,FremontBridge,03/30/2017 03:00:00 AM,48,-122,1,0,1
39340,FremontBridge,03/30/2017 04:00:00 AM,48,-122,3,6,9
39341,FremontBridge,03/30/2017 05:00:00 AM,48,-122,15,19,34
39342,FremontBridge,03/30/2017 06:00:00 AM,48,-122,34,60,94
39343,FremontBridge,03/30/2017 07:00:00 AM,48,-122,105,169,274
39344,FremontBridge,03/30/2017 08:00:00 AM,48,-122,170,259,429
39345,FremontBridge,03/30/2017 09:00:00 AM,48,-122,112,114,226
39346,FremontBridge,03/30/2017 10:00:00 AM,48,-122,46,40,86
39347,FremontBridge,03/30/2017 11:00:00 AM,48,-122,37,26,63
39348,FremontBridge,03/30/2017 12:00:00 PM,48,-122,29,33,62
39349,FremontBridge,03/30/2017 01:00:00 PM,48,-122,45,31,76
39350,FremontBridge,03/30/2017 02:00:00 PM,48,-122,30,31,61
39351,FremontBridge,03/30/2017 03:00:00 PM,48,-122,38,46,84
39352,FremontBridge,03/30/2017 04:00:00 PM,48,-122,173,74,247
39353,FremontBridge,03/30/2017 05:00:00 PM,48,-122,336,101,437
39354,FremontBridge,03/30/2017 06:00:00 PM,48,-122,213,104,317
39355,FremontBridge,03/30/2017 07:00:00 PM,48,-122,125,50,175
39356,FremontBridge,03/30/2017 08:00:00 PM,48,-122,58,25,83
39357,FremontBridge,03/30/2017 09:00:00 PM,48,-122,21,15,36
39358,FremontBridge,03/30/2017 10:00:00 PM,48,-122,20,10,30
39359,FremontBridge,03/30/2017 11:00:00 PM,48,-122,5,11,16
39360,FremontBridge,03/31/2017 12:00:00 AM,48,-122,4,2,6
39361,FremontBridge,03/31/2017 01:00:00 AM,48,-122,0,2,2
39362,FremontBridge,03/31/2017 02:00:00 AM,48,-122,0,1,1
39363,FremontBridge,03/31/2017 03:00:00 AM,48,-122,0,1,1
39364,FremontBridge,03/31/2017 04:00:00 AM,48,-122,3,3,6
39365,FremontBridge,03/31/2017 05:00:00 AM,48,-122,14,23,37
39366,FremontBridge,03/31/2017 06:00:00 AM,48,-122,49,57,106
39367,FremontBridge,03/31/2017 07:00:00 AM,48,-122,99,163,262
39368,FremontBridge,03/31/2017 08:00:00 AM,48,-122,162,250,412
39369,FremontBridge,03/31/2017 09:00:00 AM,48,-122,70,90,160
39370,FremontBridge,03/31/2017 10:00:00 AM,48,-122,38,52,90
39371,FremontBridge,03/31/2017 11:00:00 AM,48,-122,31,39,70
39372,FremontBridge,03/31/2017 12:00:00 PM,48,-122,37,37,74
39373,FremontBridge,03/31/2017 01:00:00 PM,48,-122,34,52,86
39374,FremontBridge,03/31/2017 02:00:00 PM,48,-122,55,45,100
39375,FremontBridge,03/31/2017 03:00:00 PM,48,-122,87,74,161
39376,FremontBridge,03/31/2017 04:00:00 PM,48,-122,223,83,306
39377,FremontBridge,03/31/2017 05:00:00 PM,48,-122,333,145,478
39378,FremontBridge,03/31/2017 06:00:00 PM,48,-122,206,117,323
39379,FremontBridge,03/31/2017 07:00:00 PM,48,-122,84,50,134
39380,FremontBridge,03/31/2017 08:00:00 PM,48,-122,36,26,62
39381,FremontBridge,03/31/2017 09:00:00 PM,48,-122,40,16,56
39382,FremontBridge,03/31/2017 10:00:00 PM,48,-122,22,12,34
39383,FremontBridge,03/31/2017 11:00:00 PM,48,-122,15,5,20
39384,FremontBridge,04/01/2017 12:00:00 AM,48,-122,13,8,21
39385,FremontBridge,04/01/2017 01:00:00 AM,48,-122,5,5,10
39386,FremontBridge,04/01/2017 02:00:00 AM,48,-122,0,4,4
39387,FremontBridge,04/01/2017 03:00:00 AM,48,-122,5,0,5
39388,FremontBridge,04/01/2017 04:00:00 AM,48,-122,1,0,1
39389,FremontBridge,04/01/2017 05:00:00 AM,48,-122,2,2,4
39390,FremontBridge,04/01/2017 06:00:00 AM,48,-122,6,8,14
39391,FremontBridge,04/01/2017 07:00:00 AM,48,-122,11,13,24
39392,FremontBridge,04/01/2017 08:00:00 AM,48,-122,27,31,58
39393,FremontBridge,04/01/2017 09:00:00 AM,48,-122,31,29,60
39394,FremontBridge,04/01/2017 10:00:00 AM,48,-122,39,52,91
39395,FremontBridge,04/01/2017 11:00:00 AM,48,-122,51,36,87
39396,FremontBridge,04/01/2017 12:00:00 PM,48,-122,44,49,93
39397,FremontBridge,04/01/2017 01:00:00 PM,48,-122,43,49,92
39398,FremontBridge,04/01/2017 02:00:00 PM,48,-122,50,70,120
39399,FremontBridge,04/01/2017 03:00:00 PM,48,-122,50,66,116
39400,FremontBridge,04/01/2017 04:00:00 PM,48,-122,66,70,136
39401,FremontBridge,04/01/2017 05:00:00 PM,48,-122,58,36,94
39402,FremontBridge,04/01/2017 06:00:00 PM,48,-122,47,33,80
39403,FremontBridge,04/01/2017 07:00:00 PM,48,-122,11,26,37
39404,FremontBridge,04/01/2017 08:00:00 PM,48,-122,21,8,29
39405,FremontBridge,04/01/2017 09:00:00 PM,48,-122,18,9,27
39406,FremontBridge,04/01/2017 10:00:00 PM,48,-122,13,9,22
39407,FremontBridge,04/01/2017 11:00:00 PM,48,-122,10,2,12
39408,FremontBridge,04/02/2017 12:00:00 AM,48,-122,3,5,8
39409,FremontBridge,04/02/2017 01:00:00 AM,48,-122,2,0,2
39410,FremontBridge,04/02/2017 02:00:00 AM,48,-122,0,0,0
39411,FremontBridge,04/02/2017 03:00:00 AM,48,-122,0,1,1
39412,FremontBridge,04/02/2017 04:00:00 AM,48,-122,0,0,0
39413,FremontBridge,04/02/2017 05:00:00 AM,48,-122,1,2,3
39414,FremontBridge,04/02/2017 06:00:00 AM,48,-122,9,9,18
39415,FremontBridge,04/02/2017 07:00:00 AM,48,-122,15,16,31
39416,FremontBridge,04/02/2017 08:00:00 AM,48,-122,35,20,55
39417,FremontBridge,04/02/2017 09:00:00 AM,48,-122,49,37,86
39418,FremontBridge,04/02/2017 10:00:00 AM,48,-122,57,44,101
39419,FremontBridge,04/02/2017 11:00:00 AM,48,-122,70,84,154
39420,FremontBridge,04/02/2017 12:00:00 PM,48,-122,80,80,160
39421,FremontBridge,04/02/2017 01:00:00 PM,48,-122,78,90,168
39422,FremontBridge,04/02/2017 02:00:00 PM,48,-122,77,76,153
39423,FremontBridge,04/02/2017 03:00:00 PM,48,-122,73,82,155
39424,FremontBridge,04/02/2017 04:00:00 PM,48,-122,51,53,104
39425,FremontBridge,04/02/2017 05:00:00 PM,48,-122,61,51,112
39426,FremontBridge,04/02/2017 06:00:00 PM,48,-122,25,39,64
39427,FremontBridge,04/02/2017 07:00:00 PM,48,-122,20,18,38
39428,FremontBridge,04/02/2017 08:00:00 PM,48,-122,13,9,22
39429,FremontBridge,04/02/2017 09:00:00 PM,48,-122,11,11,22
39430,FremontBridge,04/02/2017 10:00:00 PM,48,-122,7,2,9
39431,FremontBridge,04/02/2017 11:00:00 PM,48,-122,4,1,5
39432,FremontBridge,04/03/2017 12:00:00 AM,48,-122,2,2,4
39433,FremontBridge,04/03/2017 01:00:00 AM,48,-122,2,0,2
39434,FremontBridge,04/03/2017 02:00:00 AM,48,-122,0,0,0
39435,FremontBridge,04/03/2017 03:00:00 AM,48,-122,2,1,3
39436,FremontBridge,04/03/2017 04:00:00 AM,48,-122,2,2,4
39437,FremontBridge,04/03/2017 05:00:00 AM,48,-122,10,28,38
39438,FremontBridge,04/03/2017 06:00:00 AM,48,-122,53,74,127
39439,FremontBridge,04/03/2017 07:00:00 AM,48,-122,137,228,365
39440,FremontBridge,04/03/2017 08:00:00 AM,48,-122,235,285,520
39441,FremontBridge,04/03/2017 09:00:00 AM,48,-122,116,127,243
39442,FremontBridge,04/03/2017 10:00:00 AM,48,-122,50,44,94
39443,FremontBridge,04/03/2017 11:00:00 AM,48,-122,32,23,55
39444,FremontBridge,04/03/2017 12:00:00 PM,48,-122,33,39,72
39445,FremontBridge,04/03/2017 01:00:00 PM,48,-122,42,36,78
39446,FremontBridge,04/03/2017 02:00:00 PM,48,-122,53,45,98
39447,FremontBridge,04/03/2017 03:00:00 PM,48,-122,91,50,141
39448,FremontBridge,04/03/2017 04:00:00 PM,48,-122,202,92,294
39449,FremontBridge,04/03/2017 05:00:00 PM,48,-122,445,174,619
39450,FremontBridge,04/03/2017 06:00:00 PM,48,-122,285,116,401
39451,FremontBridge,04/03/2017 07:00:00 PM,48,-122,101,60,161
39452,FremontBridge,04/03/2017 08:00:00 PM,48,-122,55,32,87
39453,FremontBridge,04/03/2017 09:00:00 PM,48,-122,27,27,54
39454,FremontBridge,04/03/2017 10:00:00 PM,48,-122,27,16,43
39455,FremontBridge,04/03/2017 11:00:00 PM,48,-122,6,4,10
39456,FremontBridge,04/04/2017 12:00:00 AM,48,-122,3,4,7
39457,FremontBridge,04/04/2017 01:00:00 AM,48,-122,1,1,2
39458,FremontBridge,04/04/2017 02:00:00 AM,48,-122,3,2,5
39459,FremontBridge,04/04/2017 03:00:00 AM,48,-122,1,0,1
39460,FremontBridge,04/04/2017 04:00:00 AM,48,-122,2,3,5
39461,FremontBridge,04/04/2017 05:00:00 AM,48,-122,8,22,30
39462,FremontBridge,04/04/2017 06:00:00 AM,48,-122,54,86,140
39463,FremontBridge,04/04/2017 07:00:00 AM,48,-122,143,206,349
39464,FremontBridge,04/04/2017 08:00:00 AM,48,-122,203,293,496
39465,FremontBridge,04/04/2017 09:00:00 AM,48,-122,120,121,241
39466,FremontBridge,04/04/2017 10:00:00 AM,48,-122,45,36,81
39467,FremontBridge,04/04/2017 11:00:00 AM,48,-122,22,23,45
39468,FremontBridge,04/04/2017 12:00:00 PM,48,-122,38,37,75
39469,FremontBridge,04/04/2017 01:00:00 PM,48,-122,36,40,76
39470,FremontBridge,04/04/2017 02:00:00 PM,48,-122,36,29,65
39471,FremontBridge,04/04/2017 03:00:00 PM,48,-122,66,54,120
39472,FremontBridge,04/04/2017 04:00:00 PM,48,-122,201,82,283
39473,FremontBridge,04/04/2017 05:00:00 PM,48,-122,397,135,532
39474,FremontBridge,04/04/2017 06:00:00 PM,48,-122,270,99,369
39475,FremontBridge,04/04/2017 07:00:00 PM,48,-122,108,50,158
39476,FremontBridge,04/04/2017 08:00:00 PM,48,-122,45,25,70
39477,FremontBridge,04/04/2017 09:00:00 PM,48,-122,16,15,31
39478,FremontBridge,04/04/2017 10:00:00 PM,48,-122,16,16,32
39479,FremontBridge,04/04/2017 11:00:00 PM,48,-122,8,6,14
39480,FremontBridge,04/05/2017 12:00:00 AM,48,-122,3,3,6
39481,FremontBridge,04/05/2017 01:00:00 AM,48,-122,2,1,3
39482,FremontBridge,04/05/2017 02:00:00 AM,48,-122,2,0,2
39483,FremontBridge,04/05/2017 03:00:00 AM,48,-122,1,2,3
39484,FremontBridge,04/05/2017 04:00:00 AM,48,-122,2,2,4
39485,FremontBridge,04/05/2017 05:00:00 AM,48,-122,5,19,24
39486,FremontBridge,04/05/2017 06:00:00 AM,48,-122,31,47,78
39487,FremontBridge,04/05/2017 07:00:00 AM,48,-122,73,130,203
39488,FremontBridge,04/05/2017 08:00:00 AM,48,-122,146,156,302
39489,FremontBridge,04/05/2017 09:00:00 AM,48,-122,73,78,151
39490,FremontBridge,04/05/2017 10:00:00 AM,48,-122,32,23,55
39491,FremontBridge,04/05/2017 11:00:00 AM,48,-122,10,8,18
39492,FremontBridge,04/05/2017 12:00:00 PM,48,-122,26,15,41
39493,FremontBridge,04/05/2017 01:00:00 PM,48,-122,14,12,26
39494,FremontBridge,04/05/2017 02:00:00 PM,48,-122,19,8,27
39495,FremontBridge,04/05/2017 03:00:00 PM,48,-122,48,23,71
39496,FremontBridge,04/05/2017 04:00:00 PM,48,-122,94,44,138
39497,FremontBridge,04/05/2017 05:00:00 PM,48,-122,243,73,316
39498,FremontBridge,04/05/2017 06:00:00 PM,48,-122,164,75,239
39499,FremontBridge,04/05/2017 07:00:00 PM,48,-122,64,28,92
39500,FremontBridge,04/05/2017 08:00:00 PM,48,-122,28,15,43
39501,FremontBridge,04/05/2017 09:00:00 PM,48,-122,17,7,24
39502,FremontBridge,04/05/2017 10:00:00 PM,48,-122,14,13,27
39503,FremontBridge,04/05/2017 11:00:00 PM,48,-122,8,3,11
39504,FremontBridge,04/06/2017 12:00:00 AM,48,-122,2,4,6
39505,FremontBridge,04/06/2017 01:00:00 AM,48,-122,1,0,1
39506,FremontBridge,04/06/2017 02:00:00 AM,48,-122,1,3,4
39507,FremontBridge,04/06/2017 03:00:00 AM,48,-122,2,0,2
39508,FremontBridge,04/06/2017 04:00:00 AM,48,-122,0,4,4
39509,FremontBridge,04/06/2017 05:00:00 AM,48,-122,10,13,23
39510,FremontBridge,04/06/2017 06:00:00 AM,48,-122,30,48,78
39511,FremontBridge,04/06/2017 07:00:00 AM,48,-122,80,127,207
39512,FremontBridge,04/06/2017 08:00:00 AM,48,-122,121,171,292
39513,FremontBridge,04/06/2017 09:00:00 AM,48,-122,69,88,157
39514,FremontBridge,04/06/2017 10:00:00 AM,48,-122,32,31,63
39515,FremontBridge,04/06/2017 11:00:00 AM,48,-122,19,8,27
39516,FremontBridge,04/06/2017 12:00:00 PM,48,-122,17,26,43
39517,FremontBridge,04/06/2017 01:00:00 PM,48,-122,22,21,43
39518,FremontBridge,04/06/2017 02:00:00 PM,48,-122,33,26,59
39519,FremontBridge,04/06/2017 03:00:00 PM,48,-122,50,55,105
39520,FremontBridge,04/06/2017 04:00:00 PM,48,-122,140,79,219
39521,FremontBridge,04/06/2017 05:00:00 PM,48,-122,278,101,379
39522,FremontBridge,04/06/2017 06:00:00 PM,48,-122,216,109,325
39523,FremontBridge,04/06/2017 07:00:00 PM,48,-122,84,64,148
39524,FremontBridge,04/06/2017 08:00:00 PM,48,-122,48,42,90
39525,FremontBridge,04/06/2017 09:00:00 PM,48,-122,27,19,46
39526,FremontBridge,04/06/2017 10:00:00 PM,48,-122,15,17,32
39527,FremontBridge,04/06/2017 11:00:00 PM,48,-122,8,3,11
39528,FremontBridge,04/07/2017 12:00:00 AM,48,-122,4,5,9
39529,FremontBridge,04/07/2017 01:00:00 AM,48,-122,1,3,4
39530,FremontBridge,04/07/2017 02:00:00 AM,48,-122,0,3,3
39531,FremontBridge,04/07/2017 03:00:00 AM,48,-122,2,0,2
39532,FremontBridge,04/07/2017 04:00:00 AM,48,-122,1,2,3
39533,FremontBridge,04/07/2017 05:00:00 AM,48,-122,6,14,20
39534,FremontBridge,04/07/2017 06:00:00 AM,48,-122,27,49,76
39535,FremontBridge,04/07/2017 07:00:00 AM,48,-122,85,133,218
39536,FremontBridge,04/07/2017 08:00:00 AM,48,-122,123,153,276
39537,FremontBridge,04/07/2017 09:00:00 AM,48,-122,60,72,132
39538,FremontBridge,04/07/2017 10:00:00 AM,48,-122,23,32,55
39539,FremontBridge,04/07/2017 11:00:00 AM,48,-122,19,12,31
39540,FremontBridge,04/07/2017 12:00:00 PM,48,-122,21,10,31
39541,FremontBridge,04/07/2017 01:00:00 PM,48,-122,33,16,49
39542,FremontBridge,04/07/2017 02:00:00 PM,48,-122,28,14,42
39543,FremontBridge,04/07/2017 03:00:00 PM,48,-122,49,23,72
39544,FremontBridge,04/07/2017 04:00:00 PM,48,-122,111,42,153
39545,FremontBridge,04/07/2017 05:00:00 PM,48,-122,199,71,270
39546,FremontBridge,04/07/2017 06:00:00 PM,48,-122,123,35,158
39547,FremontBridge,04/07/2017 07:00:00 PM,48,-122,30,24,54
39548,FremontBridge,04/07/2017 08:00:00 PM,48,-122,18,7,25
39549,FremontBridge,04/07/2017 09:00:00 PM,48,-122,9,5,14
39550,FremontBridge,04/07/2017 10:00:00 PM,48,-122,7,7,14
39551,FremontBridge,04/07/2017 11:00:00 PM,48,-122,8,3,11
39552,FremontBridge,04/08/2017 12:00:00 AM,48,-122,6,0,6
39553,FremontBridge,04/08/2017 01:00:00 AM,48,-122,0,1,1
39554,FremontBridge,04/08/2017 02:00:00 AM,48,-122,0,1,1
39555,FremontBridge,04/08/2017 03:00:00 AM,48,-122,0,1,1
39556,FremontBridge,04/08/2017 04:00:00 AM,48,-122,3,0,3
39557,FremontBridge,04/08/2017 05:00:00 AM,48,-122,0,4,4
39558,FremontBridge,04/08/2017 06:00:00 AM,48,-122,5,3,8
39559,FremontBridge,04/08/2017 07:00:00 AM,48,-122,8,9,17
39560,FremontBridge,04/08/2017 08:00:00 AM,48,-122,40,23,63
39561,FremontBridge,04/08/2017 09:00:00 AM,48,-122,33,39,72
39562,FremontBridge,04/08/2017 10:00:00 AM,48,-122,43,49,92
39563,FremontBridge,04/08/2017 11:00:00 AM,48,-122,35,39,74
39564,FremontBridge,04/08/2017 12:00:00 PM,48,-122,50,34,84
39565,FremontBridge,04/08/2017 01:00:00 PM,48,-122,38,43,81
39566,FremontBridge,04/08/2017 02:00:00 PM,48,-122,36,35,71
39567,FremontBridge,04/08/2017 03:00:00 PM,48,-122,30,30,60
39568,FremontBridge,04/08/2017 04:00:00 PM,48,-122,33,46,79
39569,FremontBridge,04/08/2017 05:00:00 PM,48,-122,25,33,58
39570,FremontBridge,04/08/2017 06:00:00 PM,48,-122,29,36,65
39571,FremontBridge,04/08/2017 07:00:00 PM,48,-122,28,23,51
39572,FremontBridge,04/08/2017 08:00:00 PM,48,-122,16,13,29
39573,FremontBridge,04/08/2017 09:00:00 PM,48,-122,12,5,17
39574,FremontBridge,04/08/2017 10:00:00 PM,48,-122,11,6,17
39575,FremontBridge,04/08/2017 11:00:00 PM,48,-122,14,7,21
39576,FremontBridge,04/09/2017 12:00:00 AM,48,-122,5,2,7
39577,FremontBridge,04/09/2017 01:00:00 AM,48,-122,1,0,1
39578,FremontBridge,04/09/2017 02:00:00 AM,48,-122,2,2,4
39579,FremontBridge,04/09/2017 03:00:00 AM,48,-122,0,0,0
39580,FremontBridge,04/09/2017 04:00:00 AM,48,-122,1,1,2
39581,FremontBridge,04/09/2017 05:00:00 AM,48,-122,1,4,5
39582,FremontBridge,04/09/2017 06:00:00 AM,48,-122,6,10,16
39583,FremontBridge,04/09/2017 07:00:00 AM,48,-122,7,17,24
39584,FremontBridge,04/09/2017 08:00:00 AM,48,-122,23,22,45
39585,FremontBridge,04/09/2017 09:00:00 AM,48,-122,38,53,91
39586,FremontBridge,04/09/2017 10:00:00 AM,48,-122,54,46,100
39587,FremontBridge,04/09/2017 11:00:00 AM,48,-122,76,97,173
39588,FremontBridge,04/09/2017 12:00:00 PM,48,-122,94,92,186
39589,FremontBridge,04/09/2017 01:00:00 PM,48,-122,89,96,185
39590,FremontBridge,04/09/2017 02:00:00 PM,48,-122,78,103,181
39591,FremontBridge,04/09/2017 03:00:00 PM,48,-122,66,93,159
39592,FremontBridge,04/09/2017 04:00:00 PM,48,-122,66,93,159
39593,FremontBridge,04/09/2017 05:00:00 PM,48,-122,53,53,106
39594,FremontBridge,04/09/2017 06:00:00 PM,48,-122,45,41,86
39595,FremontBridge,04/09/2017 07:00:00 PM,48,-122,36,23,59
39596,FremontBridge,04/09/2017 08:00:00 PM,48,-122,10,14,24
39597,FremontBridge,04/09/2017 09:00:00 PM,48,-122,13,9,22
39598,FremontBridge,04/09/2017 10:00:00 PM,48,-122,6,5,11
39599,FremontBridge,04/09/2017 11:00:00 PM,48,-122,6,3,9
39600,FremontBridge,04/10/2017 12:00:00 AM,48,-122,1,0,1
39601,FremontBridge,04/10/2017 01:00:00 AM,48,-122,1,1,2
39602,FremontBridge,04/10/2017 02:00:00 AM,48,-122,1,0,1
39603,FremontBridge,04/10/2017 03:00:00 AM,48,-122,0,0,0
39604,FremontBridge,04/10/2017 04:00:00 AM,48,-122,2,2,4
39605,FremontBridge,04/10/2017 05:00:00 AM,48,-122,8,20,28
39606,FremontBridge,04/10/2017 06:00:00 AM,48,-122,28,50,78
39607,FremontBridge,04/10/2017 07:00:00 AM,48,-122,108,159,267
39608,FremontBridge,04/10/2017 08:00:00 AM,48,-122,154,228,382
39609,FremontBridge,04/10/2017 09:00:00 AM,48,-122,115,108,223
39610,FremontBridge,04/10/2017 10:00:00 AM,48,-122,46,31,77
39611,FremontBridge,04/10/2017 11:00:00 AM,48,-122,32,17,49
39612,FremontBridge,04/10/2017 12:00:00 PM,48,-122,20,23,43
39613,FremontBridge,04/10/2017 01:00:00 PM,48,-122,18,18,36
39614,FremontBridge,04/10/2017 02:00:00 PM,48,-122,23,13,36
39615,FremontBridge,04/10/2017 03:00:00 PM,48,-122,41,27,68
39616,FremontBridge,04/10/2017 04:00:00 PM,48,-122,118,36,154
39617,FremontBridge,04/10/2017 05:00:00 PM,48,-122,292,75,367
39618,FremontBridge,04/10/2017 06:00:00 PM,48,-122,197,82,279
39619,FremontBridge,04/10/2017 07:00:00 PM,48,-122,84,35,119
39620,FremontBridge,04/10/2017 08:00:00 PM,48,-122,36,22,58
39621,FremontBridge,04/10/2017 09:00:00 PM,48,-122,22,15,37
39622,FremontBridge,04/10/2017 10:00:00 PM,48,-122,11,9,20
39623,FremontBridge,04/10/2017 11:00:00 PM,48,-122,6,5,11
39624,FremontBridge,04/11/2017 12:00:00 AM,48,-122,2,1,3
39625,FremontBridge,04/11/2017 01:00:00 AM,48,-122,2,0,2
39626,FremontBridge,04/11/2017 02:00:00 AM,48,-122,1,1,2
39627,FremontBridge,04/11/2017 03:00:00 AM,48,-122,1,0,1
39628,FremontBridge,04/11/2017 04:00:00 AM,48,-122,1,4,5
39629,FremontBridge,04/11/2017 05:00:00 AM,48,-122,10,20,30
39630,FremontBridge,04/11/2017 06:00:00 AM,48,-122,44,78,122
39631,FremontBridge,04/11/2017 07:00:00 AM,48,-122,139,191,330
39632,FremontBridge,04/11/2017 08:00:00 AM,48,-122,189,283,472
39633,FremontBridge,04/11/2017 09:00:00 AM,48,-122,104,117,221
39634,FremontBridge,04/11/2017 10:00:00 AM,48,-122,66,54,120
39635,FremontBridge,04/11/2017 11:00:00 AM,48,-122,38,47,85
39636,FremontBridge,04/11/2017 12:00:00 PM,48,-122,46,48,94
39637,FremontBridge,04/11/2017 01:00:00 PM,48,-122,49,47,96
39638,FremontBridge,04/11/2017 02:00:00 PM,48,-122,52,33,85
39639,FremontBridge,04/11/2017 03:00:00 PM,48,-122,66,49,115
39640,FremontBridge,04/11/2017 04:00:00 PM,48,-122,197,69,266
39641,FremontBridge,04/11/2017 05:00:00 PM,48,-122,417,149,566
39642,FremontBridge,04/11/2017 06:00:00 PM,48,-122,262,109,371
39643,FremontBridge,04/11/2017 07:00:00 PM,48,-122,122,50,172
39644,FremontBridge,04/11/2017 08:00:00 PM,48,-122,50,26,76
39645,FremontBridge,04/11/2017 09:00:00 PM,48,-122,24,26,50
39646,FremontBridge,04/11/2017 10:00:00 PM,48,-122,24,12,36
39647,FremontBridge,04/11/2017 11:00:00 PM,48,-122,13,4,17
39648,FremontBridge,04/12/2017 12:00:00 AM,48,-122,6,3,9
39649,FremontBridge,04/12/2017 01:00:00 AM,48,-122,1,2,3
39650,FremontBridge,04/12/2017 02:00:00 AM,48,-122,0,0,0
39651,FremontBridge,04/12/2017 03:00:00 AM,48,-122,0,2,2
39652,FremontBridge,04/12/2017 04:00:00 AM,48,-122,2,0,2
39653,FremontBridge,04/12/2017 05:00:00 AM,48,-122,6,8,14
39654,FremontBridge,04/12/2017 06:00:00 AM,48,-122,20,46,66
39655,FremontBridge,04/12/2017 07:00:00 AM,48,-122,64,91,155
39656,FremontBridge,04/12/2017 08:00:00 AM,48,-122,108,164,272
39657,FremontBridge,04/12/2017 09:00:00 AM,48,-122,78,71,149
39658,FremontBridge,04/12/2017 10:00:00 AM,48,-122,20,23,43
39659,FremontBridge,04/12/2017 11:00:00 AM,48,-122,15,12,27
39660,FremontBridge,04/12/2017 12:00:00 PM,48,-122,16,20,36
39661,FremontBridge,04/12/2017 01:00:00 PM,48,-122,18,16,34
39662,FremontBridge,04/12/2017 02:00:00 PM,48,-122,29,20,49
39663,FremontBridge,04/12/2017 03:00:00 PM,48,-122,25,34,59
39664,FremontBridge,04/12/2017 04:00:00 PM,48,-122,111,43,154
39665,FremontBridge,04/12/2017 05:00:00 PM,48,-122,232,77,309
39666,FremontBridge,04/12/2017 06:00:00 PM,48,-122,137,69,206
39667,FremontBridge,04/12/2017 07:00:00 PM,48,-122,66,45,111
39668,FremontBridge,04/12/2017 08:00:00 PM,48,-122,28,19,47
39669,FremontBridge,04/12/2017 09:00:00 PM,48,-122,20,13,33
39670,FremontBridge,04/12/2017 10:00:00 PM,48,-122,15,8,23
39671,FremontBridge,04/12/2017 11:00:00 PM,48,-122,10,6,16
39672,FremontBridge,04/13/2017 12:00:00 AM,48,-122,4,2,6
39673,FremontBridge,04/13/2017 01:00:00 AM,48,-122,2,0,2
39674,FremontBridge,04/13/2017 02:00:00 AM,48,-122,2,4,6
39675,FremontBridge,04/13/2017 03:00:00 AM,48,-122,2,1,3
39676,FremontBridge,04/13/2017 04:00:00 AM,48,-122,4,5,9
39677,FremontBridge,04/13/2017 05:00:00 AM,48,-122,7,13,20
39678,FremontBridge,04/13/2017 06:00:00 AM,48,-122,35,64,99
39679,FremontBridge,04/13/2017 07:00:00 AM,48,-122,100,153,253
39680,FremontBridge,04/13/2017 08:00:00 AM,48,-122,172,202,374
39681,FremontBridge,04/13/2017 09:00:00 AM,48,-122,91,92,183
39682,FremontBridge,04/13/2017 10:00:00 AM,48,-122,48,23,71
39683,FremontBridge,04/13/2017 11:00:00 AM,48,-122,34,22,56
39684,FremontBridge,04/13/2017 12:00:00 PM,48,-122,19,27,46
39685,FremontBridge,04/13/2017 01:00:00 PM,48,-122,32,18,50
39686,FremontBridge,04/13/2017 02:00:00 PM,48,-122,26,19,45
39687,FremontBridge,04/13/2017 03:00:00 PM,48,-122,58,28,86
39688,FremontBridge,04/13/2017 04:00:00 PM,48,-122,148,54,202
39689,FremontBridge,04/13/2017 05:00:00 PM,48,-122,288,108,396
39690,FremontBridge,04/13/2017 06:00:00 PM,48,-122,172,86,258
39691,FremontBridge,04/13/2017 07:00:00 PM,48,-122,98,38,136
39692,FremontBridge,04/13/2017 08:00:00 PM,48,-122,46,59,105
39693,FremontBridge,04/13/2017 09:00:00 PM,48,-122,26,15,41
39694,FremontBridge,04/13/2017 10:00:00 PM,48,-122,18,12,30
39695,FremontBridge,04/13/2017 11:00:00 PM,48,-122,6,4,10
39696,FremontBridge,04/14/2017 12:00:00 AM,48,-122,9,4,13
39697,FremontBridge,04/14/2017 01:00:00 AM,48,-122,0,0,0
39698,FremontBridge,04/14/2017 02:00:00 AM,48,-122,1,1,2
39699,FremontBridge,04/14/2017 03:00:00 AM,48,-122,1,0,1
39700,FremontBridge,04/14/2017 04:00:00 AM,48,-122,4,3,7
39701,FremontBridge,04/14/2017 05:00:00 AM,48,-122,9,16,25
39702,FremontBridge,04/14/2017 06:00:00 AM,48,-122,35,41,76
39703,FremontBridge,04/14/2017 07:00:00 AM,48,-122,90,130,220
39704,FremontBridge,04/14/2017 08:00:00 AM,48,-122,135,182,317
39705,FremontBridge,04/14/2017 09:00:00 AM,48,-122,89,80,169
39706,FremontBridge,04/14/2017 10:00:00 AM,48,-122,37,46,83
39707,FremontBridge,04/14/2017 11:00:00 AM,48,-122,40,30,70
39708,FremontBridge,04/14/2017 12:00:00 PM,48,-122,28,21,49
39709,FremontBridge,04/14/2017 01:00:00 PM,48,-122,30,33,63
39710,FremontBridge,04/14/2017 02:00:00 PM,48,-122,34,34,68
39711,FremontBridge,04/14/2017 03:00:00 PM,48,-122,72,41,113
39712,FremontBridge,04/14/2017 04:00:00 PM,48,-122,167,61,228
39713,FremontBridge,04/14/2017 05:00:00 PM,48,-122,243,83,326
39714,FremontBridge,04/14/2017 06:00:00 PM,48,-122,161,64,225
39715,FremontBridge,04/14/2017 07:00:00 PM,48,-122,64,37,101
39716,FremontBridge,04/14/2017 08:00:00 PM,48,-122,28,28,56
39717,FremontBridge,04/14/2017 09:00:00 PM,48,-122,28,13,41
39718,FremontBridge,04/14/2017 10:00:00 PM,48,-122,18,8,26
39719,FremontBridge,04/14/2017 11:00:00 PM,48,-122,14,4,18
39720,FremontBridge,04/15/2017 12:00:00 AM,48,-122,5,2,7
39721,FremontBridge,04/15/2017 01:00:00 AM,48,-122,4,7,11
39722,FremontBridge,04/15/2017 02:00:00 AM,48,-122,0,2,2
39723,FremontBridge,04/15/2017 03:00:00 AM,48,-122,1,2,3
39724,FremontBridge,04/15/2017 04:00:00 AM,48,-122,2,0,2
39725,FremontBridge,04/15/2017 05:00:00 AM,48,-122,4,4,8
39726,FremontBridge,04/15/2017 06:00:00 AM,48,-122,6,10,16
39727,FremontBridge,04/15/2017 07:00:00 AM,48,-122,19,18,37
39728,FremontBridge,04/15/2017 08:00:00 AM,48,-122,29,27,56
39729,FremontBridge,04/15/2017 09:00:00 AM,48,-122,55,57,112
39730,FremontBridge,04/15/2017 10:00:00 AM,48,-122,57,64,121
39731,FremontBridge,04/15/2017 11:00:00 AM,48,-122,59,70,129
39732,FremontBridge,04/15/2017 12:00:00 PM,48,-122,55,86,141
39733,FremontBridge,04/15/2017 01:00:00 PM,48,-122,82,82,164
39734,FremontBridge,04/15/2017 02:00:00 PM,48,-122,48,89,137
39735,FremontBridge,04/15/2017 03:00:00 PM,48,-122,123,96,219
39736,FremontBridge,04/15/2017 04:00:00 PM,48,-122,76,91,167
39737,FremontBridge,04/15/2017 05:00:00 PM,48,-122,89,78,167
39738,FremontBridge,04/15/2017 06:00:00 PM,48,-122,66,58,124
39739,FremontBridge,04/15/2017 07:00:00 PM,48,-122,31,38,69
39740,FremontBridge,04/15/2017 08:00:00 PM,48,-122,22,25,47
39741,FremontBridge,04/15/2017 09:00:00 PM,48,-122,21,9,30
39742,FremontBridge,04/15/2017 10:00:00 PM,48,-122,12,5,17
39743,FremontBridge,04/15/2017 11:00:00 PM,48,-122,17,3,20
39744,FremontBridge,04/16/2017 12:00:00 AM,48,-122,13,4,17
39745,FremontBridge,04/16/2017 01:00:00 AM,48,-122,5,7,12
39746,FremontBridge,04/16/2017 02:00:00 AM,48,-122,2,2,4
39747,FremontBridge,04/16/2017 03:00:00 AM,48,-122,2,2,4
39748,FremontBridge,04/16/2017 04:00:00 AM,48,-122,3,1,4
39749,FremontBridge,04/16/2017 05:00:00 AM,48,-122,3,1,4
39750,FremontBridge,04/16/2017 06:00:00 AM,48,-122,8,2,10
39751,FremontBridge,04/16/2017 07:00:00 AM,48,-122,16,15,31
39752,FremontBridge,04/16/2017 08:00:00 AM,48,-122,30,17,47
39753,FremontBridge,04/16/2017 09:00:00 AM,48,-122,42,38,80
39754,FremontBridge,04/16/2017 10:00:00 AM,48,-122,61,37,98
39755,FremontBridge,04/16/2017 11:00:00 AM,48,-122,59,56,115
39756,FremontBridge,04/16/2017 12:00:00 PM,48,-122,81,81,162
39757,FremontBridge,04/16/2017 01:00:00 PM,48,-122,91,99,190
39758,FremontBridge,04/16/2017 02:00:00 PM,48,-122,66,70,136
39759,FremontBridge,04/16/2017 03:00:00 PM,48,-122,87,81,168
39760,FremontBridge,04/16/2017 04:00:00 PM,48,-122,64,92,156
39761,FremontBridge,04/16/2017 05:00:00 PM,48,-122,56,48,104
39762,FremontBridge,04/16/2017 06:00:00 PM,48,-122,38,43,81
39763,FremontBridge,04/16/2017 07:00:00 PM,48,-122,31,35,66
39764,FremontBridge,04/16/2017 08:00:00 PM,48,-122,20,16,36
39765,FremontBridge,04/16/2017 09:00:00 PM,48,-122,8,11,19
39766,FremontBridge,04/16/2017 10:00:00 PM,48,-122,2,6,8
39767,FremontBridge,04/16/2017 11:00:00 PM,48,-122,6,4,10
39768,FremontBridge,04/17/2017 12:00:00 AM,48,-122,5,4,9
39769,FremontBridge,04/17/2017 01:00:00 AM,48,-122,2,0,2
39770,FremontBridge,04/17/2017 02:00:00 AM,48,-122,0,4,4
39771,FremontBridge,04/17/2017 03:00:00 AM,48,-122,1,0,1
39772,FremontBridge,04/17/2017 04:00:00 AM,48,-122,4,3,7
39773,FremontBridge,04/17/2017 05:00:00 AM,48,-122,11,18,29
39774,FremontBridge,04/17/2017 06:00:00 AM,48,-122,40,64,104
39775,FremontBridge,04/17/2017 07:00:00 AM,48,-122,100,178,278
39776,FremontBridge,04/17/2017 08:00:00 AM,48,-122,189,238,427
39777,FremontBridge,04/17/2017 09:00:00 AM,48,-122,126,110,236
39778,FremontBridge,04/17/2017 10:00:00 AM,48,-122,48,52,100
39779,FremontBridge,04/17/2017 11:00:00 AM,48,-122,35,30,65
39780,FremontBridge,04/17/2017 12:00:00 PM,48,-122,28,21,49
39781,FremontBridge,04/17/2017 01:00:00 PM,48,-122,32,31,63
39782,FremontBridge,04/17/2017 02:00:00 PM,48,-122,31,22,53
39783,FremontBridge,04/17/2017 03:00:00 PM,48,-122,46,43,89
39784,FremontBridge,04/17/2017 04:00:00 PM,48,-122,136,59,195
39785,FremontBridge,04/17/2017 05:00:00 PM,48,-122,318,84,402
39786,FremontBridge,04/17/2017 06:00:00 PM,48,-122,227,80,307
39787,FremontBridge,04/17/2017 07:00:00 PM,48,-122,88,39,127
39788,FremontBridge,04/17/2017 08:00:00 PM,48,-122,31,13,44
39789,FremontBridge,04/17/2017 09:00:00 PM,48,-122,18,14,32
39790,FremontBridge,04/17/2017 10:00:00 PM,48,-122,13,8,21
39791,FremontBridge,04/17/2017 11:00:00 PM,48,-122,4,5,9
39792,FremontBridge,04/18/2017 12:00:00 AM,48,-122,4,3,7
39793,FremontBridge,04/18/2017 01:00:00 AM,48,-122,2,1,3
39794,FremontBridge,04/18/2017 02:00:00 AM,48,-122,0,2,2
39795,FremontBridge,04/18/2017 03:00:00 AM,48,-122,1,2,3
39796,FremontBridge,04/18/2017 04:00:00 AM,48,-122,2,4,6
39797,FremontBridge,04/18/2017 05:00:00 AM,48,-122,9,21,30
39798,FremontBridge,04/18/2017 06:00:00 AM,48,-122,39,65,104
39799,FremontBridge,04/18/2017 07:00:00 AM,48,-122,102,180,282
39800,FremontBridge,04/18/2017 08:00:00 AM,48,-122,183,238,421
39801,FremontBridge,04/18/2017 09:00:00 AM,48,-122,103,112,215
39802,FremontBridge,04/18/2017 10:00:00 AM,48,-122,27,34,61
39803,FremontBridge,04/18/2017 11:00:00 AM,48,-122,36,21,57
39804,FremontBridge,04/18/2017 12:00:00 PM,48,-122,34,38,72
39805,FremontBridge,04/18/2017 01:00:00 PM,48,-122,21,26,47
39806,FremontBridge,04/18/2017 02:00:00 PM,48,-122,34,36,70
39807,FremontBridge,04/18/2017 03:00:00 PM,48,-122,58,31,89
39808,FremontBridge,04/18/2017 04:00:00 PM,48,-122,166,68,234
39809,FremontBridge,04/18/2017 05:00:00 PM,48,-122,327,135,462
39810,FremontBridge,04/18/2017 06:00:00 PM,48,-122,265,82,347
39811,FremontBridge,04/18/2017 07:00:00 PM,48,-122,80,41,121
39812,FremontBridge,04/18/2017 08:00:00 PM,48,-122,39,19,58
39813,FremontBridge,04/18/2017 09:00:00 PM,48,-122,31,22,53
39814,FremontBridge,04/18/2017 10:00:00 PM,48,-122,10,13,23
39815,FremontBridge,04/18/2017 11:00:00 PM,48,-122,6,9,15
39816,FremontBridge,04/19/2017 12:00:00 AM,48,-122,2,6,8
39817,FremontBridge,04/19/2017 01:00:00 AM,48,-122,0,0,0
39818,FremontBridge,04/19/2017 02:00:00 AM,48,-122,0,1,1
39819,FremontBridge,04/19/2017 03:00:00 AM,48,-122,0,0,0
39820,FremontBridge,04/19/2017 04:00:00 AM,48,-122,3,4,7
39821,FremontBridge,04/19/2017 05:00:00 AM,48,-122,12,22,34
39822,FremontBridge,04/19/2017 06:00:00 AM,48,-122,44,68,112
39823,FremontBridge,04/19/2017 07:00:00 AM,48,-122,117,183,300
39824,FremontBridge,04/19/2017 08:00:00 AM,48,-122,177,215,392
39825,FremontBridge,04/19/2017 09:00:00 AM,48,-122,95,93,188
39826,FremontBridge,04/19/2017 10:00:00 AM,48,-122,42,28,70
39827,FremontBridge,04/19/2017 11:00:00 AM,48,-122,21,18,39
39828,FremontBridge,04/19/2017 12:00:00 PM,48,-122,24,13,37
39829,FremontBridge,04/19/2017 01:00:00 PM,48,-122,18,12,30
39830,FremontBridge,04/19/2017 02:00:00 PM,48,-122,21,19,40
39831,FremontBridge,04/19/2017 03:00:00 PM,48,-122,49,34,83
39832,FremontBridge,04/19/2017 04:00:00 PM,48,-122,134,55,189
39833,FremontBridge,04/19/2017 05:00:00 PM,48,-122,309,112,421
39834,FremontBridge,04/19/2017 06:00:00 PM,48,-122,225,103,328
39835,FremontBridge,04/19/2017 07:00:00 PM,48,-122,122,36,158
39836,FremontBridge,04/19/2017 08:00:00 PM,48,-122,50,28,78
39837,FremontBridge,04/19/2017 09:00:00 PM,48,-122,19,17,36
39838,FremontBridge,04/19/2017 10:00:00 PM,48,-122,8,8,16
39839,FremontBridge,04/19/2017 11:00:00 PM,48,-122,4,4,8
39840,FremontBridge,04/20/2017 12:00:00 AM,48,-122,2,3,5
39841,FremontBridge,04/20/2017 01:00:00 AM,48,-122,3,0,3
39842,FremontBridge,04/20/2017 02:00:00 AM,48,-122,0,2,2
39843,FremontBridge,04/20/2017 03:00:00 AM,48,-122,1,0,1
39844,FremontBridge,04/20/2017 04:00:00 AM,48,-122,2,4,6
39845,FremontBridge,04/20/2017 05:00:00 AM,48,-122,12,28,40
39846,FremontBridge,04/20/2017 06:00:00 AM,48,-122,54,66,120
39847,FremontBridge,04/20/2017 07:00:00 AM,48,-122,108,164,272
39848,FremontBridge,04/20/2017 08:00:00 AM,48,-122,193,252,445
39849,FremontBridge,04/20/2017 09:00:00 AM,48,-122,118,113,231
39850,FremontBridge,04/20/2017 10:00:00 AM,48,-122,39,31,70
39851,FremontBridge,04/20/2017 11:00:00 AM,48,-122,29,28,57
39852,FremontBridge,04/20/2017 12:00:00 PM,48,-122,22,36,58
39853,FremontBridge,04/20/2017 01:00:00 PM,48,-122,39,29,68
39854,FremontBridge,04/20/2017 02:00:00 PM,48,-122,51,36,87
39855,FremontBridge,04/20/2017 03:00:00 PM,48,-122,74,53,127
39856,FremontBridge,04/20/2017 04:00:00 PM,48,-122,166,73,239
39857,FremontBridge,04/20/2017 05:00:00 PM,48,-122,353,149,502
39858,FremontBridge,04/20/2017 06:00:00 PM,48,-122,244,113,357
39859,FremontBridge,04/20/2017 07:00:00 PM,48,-122,118,54,172
39860,FremontBridge,04/20/2017 08:00:00 PM,48,-122,75,36,111
39861,FremontBridge,04/20/2017 09:00:00 PM,48,-122,37,20,57
39862,FremontBridge,04/20/2017 10:00:00 PM,48,-122,26,16,42
39863,FremontBridge,04/20/2017 11:00:00 PM,48,-122,9,4,13
39864,FremontBridge,04/21/2017 12:00:00 AM,48,-122,14,10,24
39865,FremontBridge,04/21/2017 01:00:00 AM,48,-122,3,2,5
39866,FremontBridge,04/21/2017 02:00:00 AM,48,-122,2,3,5
39867,FremontBridge,04/21/2017 03:00:00 AM,48,-122,1,0,1
39868,FremontBridge,04/21/2017 04:00:00 AM,48,-122,3,2,5
39869,FremontBridge,04/21/2017 05:00:00 AM,48,-122,9,24,33
39870,FremontBridge,04/21/2017 06:00:00 AM,48,-122,62,80,142
39871,FremontBridge,04/21/2017 07:00:00 AM,48,-122,114,227,341
39872,FremontBridge,04/21/2017 08:00:00 AM,48,-122,213,293,506
39873,FremontBridge,04/21/2017 09:00:00 AM,48,-122,125,151,276
39874,FremontBridge,04/21/2017 10:00:00 AM,48,-122,66,66,132
39875,FremontBridge,04/21/2017 11:00:00 AM,48,-122,57,55,112
39876,FremontBridge,04/21/2017 12:00:00 PM,48,-122,73,56,129
39877,FremontBridge,04/21/2017 01:00:00 PM,48,-122,67,83,150
39878,FremontBridge,04/21/2017 02:00:00 PM,48,-122,88,67,155
39879,FremontBridge,04/21/2017 03:00:00 PM,48,-122,168,99,267
39880,FremontBridge,04/21/2017 04:00:00 PM,48,-122,270,154,424
39881,FremontBridge,04/21/2017 05:00:00 PM,48,-122,433,197,630
39882,FremontBridge,04/21/2017 06:00:00 PM,48,-122,246,128,374
39883,FremontBridge,04/21/2017 07:00:00 PM,48,-122,107,69,176
39884,FremontBridge,04/21/2017 08:00:00 PM,48,-122,61,46,107
39885,FremontBridge,04/21/2017 09:00:00 PM,48,-122,23,25,48
39886,FremontBridge,04/21/2017 10:00:00 PM,48,-122,24,21,45
39887,FremontBridge,04/21/2017 11:00:00 PM,48,-122,13,9,22
39888,FremontBridge,04/22/2017 12:00:00 AM,48,-122,9,5,14
39889,FremontBridge,04/22/2017 01:00:00 AM,48,-122,6,3,9
39890,FremontBridge,04/22/2017 02:00:00 AM,48,-122,1,2,3
39891,FremontBridge,04/22/2017 03:00:00 AM,48,-122,2,0,2
39892,FremontBridge,04/22/2017 04:00:00 AM,48,-122,3,1,4
39893,FremontBridge,04/22/2017 05:00:00 AM,48,-122,2,2,4
39894,FremontBridge,04/22/2017 06:00:00 AM,48,-122,6,14,20
39895,FremontBridge,04/22/2017 07:00:00 AM,48,-122,24,24,48
39896,FremontBridge,04/22/2017 08:00:00 AM,48,-122,37,46,83
39897,FremontBridge,04/22/2017 09:00:00 AM,48,-122,38,63,101
39898,FremontBridge,04/22/2017 10:00:00 AM,48,-122,54,31,85
39899,FremontBridge,04/22/2017 11:00:00 AM,48,-122,38,52,90
39900,FremontBridge,04/22/2017 12:00:00 PM,48,-122,21,25,46
39901,FremontBridge,04/22/2017 01:00:00 PM,48,-122,61,33,94
39902,FremontBridge,04/22/2017 02:00:00 PM,48,-122,20,21,41
39903,FremontBridge,04/22/2017 03:00:00 PM,48,-122,38,19,57
39904,FremontBridge,04/22/2017 04:00:00 PM,48,-122,34,32,66
39905,FremontBridge,04/22/2017 05:00:00 PM,48,-122,32,24,56
39906,FremontBridge,04/22/2017 06:00:00 PM,48,-122,27,35,62
39907,FremontBridge,04/22/2017 07:00:00 PM,48,-122,26,33,59
39908,FremontBridge,04/22/2017 08:00:00 PM,48,-122,18,12,30
39909,FremontBridge,04/22/2017 09:00:00 PM,48,-122,7,15,22
39910,FremontBridge,04/22/2017 10:00:00 PM,48,-122,11,5,16
39911,FremontBridge,04/22/2017 11:00:00 PM,48,-122,9,4,13
39912,FremontBridge,04/23/2017 12:00:00 AM,48,-122,7,3,10
39913,FremontBridge,04/23/2017 01:00:00 AM,48,-122,3,2,5
39914,FremontBridge,04/23/2017 02:00:00 AM,48,-122,4,1,5
39915,FremontBridge,04/23/2017 03:00:00 AM,48,-122,2,1,3
39916,FremontBridge,04/23/2017 04:00:00 AM,48,-122,2,0,2
39917,FremontBridge,04/23/2017 05:00:00 AM,48,-122,0,1,1
39918,FremontBridge,04/23/2017 06:00:00 AM,48,-122,5,7,12
39919,FremontBridge,04/23/2017 07:00:00 AM,48,-122,12,12,24
39920,FremontBridge,04/23/2017 08:00:00 AM,48,-122,38,26,64
39921,FremontBridge,04/23/2017 09:00:00 AM,48,-122,28,50,78
39922,FremontBridge,04/23/2017 10:00:00 AM,48,-122,43,45,88
39923,FremontBridge,04/23/2017 11:00:00 AM,48,-122,39,35,74
39924,FremontBridge,04/23/2017 12:00:00 PM,48,-122,17,21,38
39925,FremontBridge,04/23/2017 01:00:00 PM,48,-122,29,25,54
39926,FremontBridge,04/23/2017 02:00:00 PM,48,-122,19,20,39
39927,FremontBridge,04/23/2017 03:00:00 PM,48,-122,17,17,34
39928,FremontBridge,04/23/2017 04:00:00 PM,48,-122,13,10,23
39929,FremontBridge,04/23/2017 05:00:00 PM,48,-122,15,8,23
39930,FremontBridge,04/23/2017 06:00:00 PM,48,-122,11,14,25
39931,FremontBridge,04/23/2017 07:00:00 PM,48,-122,13,9,22
39932,FremontBridge,04/23/2017 08:00:00 PM,48,-122,9,2,11
39933,FremontBridge,04/23/2017 09:00:00 PM,48,-122,3,5,8
39934,FremontBridge,04/23/2017 10:00:00 PM,48,-122,5,5,10
39935,FremontBridge,04/23/2017 11:00:00 PM,48,-122,5,1,6
39936,FremontBridge,04/24/2017 12:00:00 AM,48,-122,2,4,6
39937,FremontBridge,04/24/2017 01:00:00 AM,48,-122,1,1,2
39938,FremontBridge,04/24/2017 02:00:00 AM,48,-122,2,0,2
39939,FremontBridge,04/24/2017 03:00:00 AM,48,-122,1,0,1
39940,FremontBridge,04/24/2017 04:00:00 AM,48,-122,2,3,5
39941,FremontBridge,04/24/2017 05:00:00 AM,48,-122,10,18,28
39942,FremontBridge,04/24/2017 06:00:00 AM,48,-122,47,63,110
39943,FremontBridge,04/24/2017 07:00:00 AM,48,-122,126,203,329
39944,FremontBridge,04/24/2017 08:00:00 AM,48,-122,185,270,455
39945,FremontBridge,04/24/2017 09:00:00 AM,48,-122,113,107,220
39946,FremontBridge,04/24/2017 10:00:00 AM,48,-122,32,34,66
39947,FremontBridge,04/24/2017 11:00:00 AM,48,-122,26,23,49
39948,FremontBridge,04/24/2017 12:00:00 PM,48,-122,30,21,51
39949,FremontBridge,04/24/2017 01:00:00 PM,48,-122,33,31,64
39950,FremontBridge,04/24/2017 02:00:00 PM,48,-122,34,33,67
39951,FremontBridge,04/24/2017 03:00:00 PM,48,-122,59,47,106
39952,FremontBridge,04/24/2017 04:00:00 PM,48,-122,156,76,232
39953,FremontBridge,04/24/2017 05:00:00 PM,48,-122,398,131,529
39954,FremontBridge,04/24/2017 06:00:00 PM,48,-122,227,119,346
39955,FremontBridge,04/24/2017 07:00:00 PM,48,-122,145,61,206
39956,FremontBridge,04/24/2017 08:00:00 PM,48,-122,62,36,98
39957,FremontBridge,04/24/2017 09:00:00 PM,48,-122,22,22,44
39958,FremontBridge,04/24/2017 10:00:00 PM,48,-122,16,15,31
39959,FremontBridge,04/24/2017 11:00:00 PM,48,-122,14,4,18
39960,FremontBridge,04/25/2017 12:00:00 AM,48,-122,6,5,11
39961,FremontBridge,04/25/2017 01:00:00 AM,48,-122,7,3,10
39962,FremontBridge,04/25/2017 02:00:00 AM,48,-122,2,1,3
39963,FremontBridge,04/25/2017 03:00:00 AM,48,-122,0,0,0
39964,FremontBridge,04/25/2017 04:00:00 AM,48,-122,3,5,8
39965,FremontBridge,04/25/2017 05:00:00 AM,48,-122,15,25,40
39966,FremontBridge,04/25/2017 06:00:00 AM,48,-122,82,137,219
39967,FremontBridge,04/25/2017 07:00:00 AM,48,-122,134,226,360
39968,FremontBridge,04/25/2017 08:00:00 AM,48,-122,207,286,493
39969,FremontBridge,04/25/2017 09:00:00 AM,48,-122,126,138,264
39970,FremontBridge,04/25/2017 10:00:00 AM,48,-122,66,45,111
39971,FremontBridge,04/25/2017 11:00:00 AM,48,-122,23,29,52
39972,FremontBridge,04/25/2017 12:00:00 PM,48,-122,41,23,64
39973,FremontBridge,04/25/2017 01:00:00 PM,48,-122,48,34,82
39974,FremontBridge,04/25/2017 02:00:00 PM,48,-122,40,32,72
39975,FremontBridge,04/25/2017 03:00:00 PM,48,-122,73,51,124
39976,FremontBridge,04/25/2017 04:00:00 PM,48,-122,205,85,290
39977,FremontBridge,04/25/2017 05:00:00 PM,48,-122,390,142,532
39978,FremontBridge,04/25/2017 06:00:00 PM,48,-122,248,87,335
39979,FremontBridge,04/25/2017 07:00:00 PM,48,-122,100,36,136
39980,FremontBridge,04/25/2017 08:00:00 PM,48,-122,53,27,80
39981,FremontBridge,04/25/2017 09:00:00 PM,48,-122,17,10,27
39982,FremontBridge,04/25/2017 10:00:00 PM,48,-122,13,9,22
39983,FremontBridge,04/25/2017 11:00:00 PM,48,-122,16,5,21
39984,FremontBridge,04/26/2017 12:00:00 AM,48,-122,3,3,6
39985,FremontBridge,04/26/2017 01:00:00 AM,48,-122,0,3,3
39986,FremontBridge,04/26/2017 02:00:00 AM,48,-122,0,0,0
39987,FremontBridge,04/26/2017 03:00:00 AM,48,-122,1,1,2
39988,FremontBridge,04/26/2017 04:00:00 AM,48,-122,3,3,6
39989,FremontBridge,04/26/2017 05:00:00 AM,48,-122,12,18,30
39990,FremontBridge,04/26/2017 06:00:00 AM,48,-122,49,72,121
39991,FremontBridge,04/26/2017 07:00:00 AM,48,-122,132,170,302
39992,FremontBridge,04/26/2017 08:00:00 AM,48,-122,164,243,407
39993,FremontBridge,04/26/2017 09:00:00 AM,48,-122,80,88,168
39994,FremontBridge,04/26/2017 10:00:00 AM,48,-122,45,36,81
39995,FremontBridge,04/26/2017 11:00:00 AM,48,-122,30,25,55
39996,FremontBridge,04/26/2017 12:00:00 PM,48,-122,25,26,51
39997,FremontBridge,04/26/2017 01:00:00 PM,48,-122,22,20,42
39998,FremontBridge,04/26/2017 02:00:00 PM,48,-122,27,24,51
39999,FremontBridge,04/26/2017 03:00:00 PM,48,-122,52,28,80
40000,FremontBridge,04/26/2017 04:00:00 PM,48,-122,126,50,176
40001,FremontBridge,04/26/2017 05:00:00 PM,48,-122,329,96,425
40002,FremontBridge,04/26/2017 06:00:00 PM,48,-122,197,81,278
40003,FremontBridge,04/26/2017 07:00:00 PM,48,-122,92,31,123
40004,FremontBridge,04/26/2017 08:00:00 PM,48,-122,41,20,61
40005,FremontBridge,04/26/2017 09:00:00 PM,48,-122,31,10,41
40006,FremontBridge,04/26/2017 10:00:00 PM,48,-122,9,10,19
40007,FremontBridge,04/26/2017 11:00:00 PM,48,-122,6,5,11
40008,FremontBridge,04/27/2017 12:00:00 AM,48,-122,3,2,5
40009,FremontBridge,04/27/2017 01:00:00 AM,48,-122,1,0,1
40010,FremontBridge,04/27/2017 02:00:00 AM,48,-122,0,1,1
40011,FremontBridge,04/27/2017 03:00:00 AM,48,-122,0,0,0
40012,FremontBridge,04/27/2017 04:00:00 AM,48,-122,4,3,7
40013,FremontBridge,04/27/2017 05:00:00 AM,48,-122,8,30,38
40014,FremontBridge,04/27/2017 06:00:00 AM,48,-122,48,72,120
40015,FremontBridge,04/27/2017 07:00:00 AM,48,-122,107,186,293
40016,FremontBridge,04/27/2017 08:00:00 AM,48,-122,183,231,414
40017,FremontBridge,04/27/2017 09:00:00 AM,48,-122,95,106,201
40018,FremontBridge,04/27/2017 10:00:00 AM,48,-122,50,41,91
40019,FremontBridge,04/27/2017 11:00:00 AM,48,-122,34,30,64
40020,FremontBridge,04/27/2017 12:00:00 PM,48,-122,39,32,71
40021,FremontBridge,04/27/2017 01:00:00 PM,48,-122,40,23,63
40022,FremontBridge,04/27/2017 02:00:00 PM,48,-122,51,40,91
40023,FremontBridge,04/27/2017 03:00:00 PM,48,-122,67,54,121
40024,FremontBridge,04/27/2017 04:00:00 PM,48,-122,161,83,244
40025,FremontBridge,04/27/2017 05:00:00 PM,48,-122,366,117,483
40026,FremontBridge,04/27/2017 06:00:00 PM,48,-122,214,88,302
40027,FremontBridge,04/27/2017 07:00:00 PM,48,-122,120,41,161
40028,FremontBridge,04/27/2017 08:00:00 PM,48,-122,50,39,89
40029,FremontBridge,04/27/2017 09:00:00 PM,48,-122,31,17,48
40030,FremontBridge,04/27/2017 10:00:00 PM,48,-122,20,15,35
40031,FremontBridge,04/27/2017 11:00:00 PM,48,-122,10,8,18
40032,FremontBridge,04/28/2017 12:00:00 AM,48,-122,5,2,7
40033,FremontBridge,04/28/2017 01:00:00 AM,48,-122,2,1,3
40034,FremontBridge,04/28/2017 02:00:00 AM,48,-122,3,1,4
40035,FremontBridge,04/28/2017 03:00:00 AM,48,-122,3,1,4
40036,FremontBridge,04/28/2017 04:00:00 AM,48,-122,1,0,1
40037,FremontBridge,04/28/2017 05:00:00 AM,48,-122,9,21,30
40038,FremontBridge,04/28/2017 06:00:00 AM,48,-122,48,67,115
40039,FremontBridge,04/28/2017 07:00:00 AM,48,-122,107,199,306
40040,FremontBridge,04/28/2017 08:00:00 AM,48,-122,199,234,433
40041,FremontBridge,04/28/2017 09:00:00 AM,48,-122,104,118,222
40042,FremontBridge,04/28/2017 10:00:00 AM,48,-122,48,50,98
40043,FremontBridge,04/28/2017 11:00:00 AM,48,-122,44,24,68
40044,FremontBridge,04/28/2017 12:00:00 PM,48,-122,29,47,76
40045,FremontBridge,04/28/2017 01:00:00 PM,48,-122,41,44,85
40046,FremontBridge,04/28/2017 02:00:00 PM,48,-122,66,52,118
40047,FremontBridge,04/28/2017 03:00:00 PM,48,-122,98,59,157
40048,FremontBridge,04/28/2017 04:00:00 PM,48,-122,239,106,345
40049,FremontBridge,04/28/2017 05:00:00 PM,48,-122,364,143,507
40050,FremontBridge,04/28/2017 06:00:00 PM,48,-122,242,115,357
40051,FremontBridge,04/28/2017 07:00:00 PM,48,-122,92,78,170
40052,FremontBridge,04/28/2017 08:00:00 PM,48,-122,49,47,96
40053,FremontBridge,04/28/2017 09:00:00 PM,48,-122,26,16,42
40054,FremontBridge,04/28/2017 10:00:00 PM,48,-122,19,20,39
40055,FremontBridge,04/28/2017 11:00:00 PM,48,-122,23,9,32
40056,FremontBridge,04/29/2017 12:00:00 AM,48,-122,6,8,14
40057,FremontBridge,04/29/2017 01:00:00 AM,48,-122,4,3,7
40058,FremontBridge,04/29/2017 02:00:00 AM,48,-122,3,2,5
40059,FremontBridge,04/29/2017 03:00:00 AM,48,-122,1,3,4
40060,FremontBridge,04/29/2017 04:00:00 AM,48,-122,0,2,2
40061,FremontBridge,04/29/2017 05:00:00 AM,48,-122,5,1,6
40062,FremontBridge,04/29/2017 06:00:00 AM,48,-122,4,9,13
40063,FremontBridge,04/29/2017 07:00:00 AM,48,-122,18,21,39
40064,FremontBridge,04/29/2017 08:00:00 AM,48,-122,37,48,85
40065,FremontBridge,04/29/2017 09:00:00 AM,48,-122,56,70,126
40066,FremontBridge,04/29/2017 10:00:00 AM,48,-122,37,66,103
40067,FremontBridge,04/29/2017 11:00:00 AM,48,-122,53,84,137
40068,FremontBridge,04/29/2017 12:00:00 PM,48,-122,61,60,121
40069,FremontBridge,04/29/2017 01:00:00 PM,48,-122,52,68,120
40070,FremontBridge,04/29/2017 02:00:00 PM,48,-122,74,64,138
40071,FremontBridge,04/29/2017 03:00:00 PM,48,-122,48,57,105
40072,FremontBridge,04/29/2017 04:00:00 PM,48,-122,39,41,80
40073,FremontBridge,04/29/2017 05:00:00 PM,48,-122,47,39,86
40074,FremontBridge,04/29/2017 06:00:00 PM,48,-122,31,21,52
40075,FremontBridge,04/29/2017 07:00:00 PM,48,-122,14,22,36
40076,FremontBridge,04/29/2017 08:00:00 PM,48,-122,11,14,25
40077,FremontBridge,04/29/2017 09:00:00 PM,48,-122,22,5,27
40078,FremontBridge,04/29/2017 10:00:00 PM,48,-122,11,7,18
40079,FremontBridge,04/29/2017 11:00:00 PM,48,-122,7,2,9
40080,FremontBridge,04/30/2017 12:00:00 AM,48,-122,9,3,12
40081,FremontBridge,04/30/2017 01:00:00 AM,48,-122,2,3,5
40082,FremontBridge,04/30/2017 02:00:00 AM,48,-122,4,0,4
40083,FremontBridge,04/30/2017 03:00:00 AM,48,-122,1,1,2
40084,FremontBridge,04/30/2017 04:00:00 AM,48,-122,1,1,2
40085,FremontBridge,04/30/2017 05:00:00 AM,48,-122,1,1,2
40086,FremontBridge,04/30/2017 06:00:00 AM,48,-122,4,9,13
40087,FremontBridge,04/30/2017 07:00:00 AM,48,-122,7,8,15
40088,FremontBridge,04/30/2017 08:00:00 AM,48,-122,24,23,47
40089,FremontBridge,04/30/2017 09:00:00 AM,48,-122,24,19,43
40090,FremontBridge,04/30/2017 10:00:00 AM,48,-122,36,36,72
40091,FremontBridge,04/30/2017 11:00:00 AM,48,-122,41,34,75
40092,FremontBridge,04/30/2017 12:00:00 PM,48,-122,52,70,122
40093,FremontBridge,04/30/2017 01:00:00 PM,48,-122,84,87,171
40094,FremontBridge,04/30/2017 02:00:00 PM,48,-122,57,66,123
40095,FremontBridge,04/30/2017 03:00:00 PM,48,-122,65,63,128
40096,FremontBridge,04/30/2017 04:00:00 PM,48,-122,60,65,125
40097,FremontBridge,04/30/2017 05:00:00 PM,48,-122,46,27,73
40098,FremontBridge,04/30/2017 06:00:00 PM,48,-122,34,48,82
40099,FremontBridge,04/30/2017 07:00:00 PM,48,-122,11,24,35
40100,FremontBridge,04/30/2017 08:00:00 PM,48,-122,10,18,28
40101,FremontBridge,04/30/2017 09:00:00 PM,48,-122,11,3,14
40102,FremontBridge,04/30/2017 10:00:00 PM,48,-122,6,5,11
40103,FremontBridge,04/30/2017 11:00:00 PM,48,-122,7,4,11
40104,FremontBridge,05/01/2017 12:00:00 AM,48,-122,1,5,6
40105,FremontBridge,05/01/2017 01:00:00 AM,48,-122,1,3,4
40106,FremontBridge,05/01/2017 02:00:00 AM,48,-122,0,1,1
40107,FremontBridge,05/01/2017 03:00:00 AM,48,-122,1,1,2
40108,FremontBridge,05/01/2017 04:00:00 AM,48,-122,6,4,10
40109,FremontBridge,05/01/2017 05:00:00 AM,48,-122,16,26,42
40110,FremontBridge,05/01/2017 06:00:00 AM,48,-122,65,117,182
40111,FremontBridge,05/01/2017 07:00:00 AM,48,-122,147,246,393
40112,FremontBridge,05/01/2017 08:00:00 AM,48,-122,224,301,525
40113,FremontBridge,05/01/2017 09:00:00 AM,48,-122,109,119,228
40114,FremontBridge,05/01/2017 10:00:00 AM,48,-122,32,22,54
40115,FremontBridge,05/01/2017 11:00:00 AM,48,-122,29,15,44
40116,FremontBridge,05/01/2017 12:00:00 PM,48,-122,21,26,47
40117,FremontBridge,05/01/2017 01:00:00 PM,48,-122,17,21,38
40118,FremontBridge,05/01/2017 02:00:00 PM,48,-122,47,31,78
40119,FremontBridge,05/01/2017 03:00:00 PM,48,-122,75,48,123
40120,FremontBridge,05/01/2017 04:00:00 PM,48,-122,251,75,326
40121,FremontBridge,05/01/2017 05:00:00 PM,48,-122,459,134,593
40122,FremontBridge,05/01/2017 06:00:00 PM,48,-122,250,102,352
40123,FremontBridge,05/01/2017 07:00:00 PM,48,-122,81,70,151
40124,FremontBridge,05/01/2017 08:00:00 PM,48,-122,49,29,78
40125,FremontBridge,05/01/2017 09:00:00 PM,48,-122,30,19,49
40126,FremontBridge,05/01/2017 10:00:00 PM,48,-122,20,7,27
40127,FremontBridge,05/01/2017 11:00:00 PM,48,-122,6,4,10
40128,FremontBridge,05/02/2017 12:00:00 AM,48,-122,4,1,5
40129,FremontBridge,05/02/2017 01:00:00 AM,48,-122,7,0,7
40130,FremontBridge,05/02/2017 02:00:00 AM,48,-122,3,2,5
40131,FremontBridge,05/02/2017 03:00:00 AM,48,-122,1,1,2
40132,FremontBridge,05/02/2017 04:00:00 AM,48,-122,6,4,10
40133,FremontBridge,05/02/2017 05:00:00 AM,48,-122,14,32,46
40134,FremontBridge,05/02/2017 06:00:00 AM,48,-122,75,126,201
40135,FremontBridge,05/02/2017 07:00:00 AM,48,-122,161,274,435
40136,FremontBridge,05/02/2017 08:00:00 AM,48,-122,203,324,527
40137,FremontBridge,05/02/2017 09:00:00 AM,48,-122,122,139,261
40138,FremontBridge,05/02/2017 10:00:00 AM,48,-122,40,48,88
40139,FremontBridge,05/02/2017 11:00:00 AM,48,-122,36,47,83
40140,FremontBridge,05/02/2017 12:00:00 PM,48,-122,35,42,77
40141,FremontBridge,05/02/2017 01:00:00 PM,48,-122,31,42,73
40142,FremontBridge,05/02/2017 02:00:00 PM,48,-122,54,44,98
40143,FremontBridge,05/02/2017 03:00:00 PM,48,-122,72,58,130
40144,FremontBridge,05/02/2017 04:00:00 PM,48,-122,224,81,305
40145,FremontBridge,05/02/2017 05:00:00 PM,48,-122,479,149,628
40146,FremontBridge,05/02/2017 06:00:00 PM,48,-122,272,100,372
40147,FremontBridge,05/02/2017 07:00:00 PM,48,-122,109,55,164
40148,FremontBridge,05/02/2017 08:00:00 PM,48,-122,57,25,82
40149,FremontBridge,05/02/2017 09:00:00 PM,48,-122,35,13,48
40150,FremontBridge,05/02/2017 10:00:00 PM,48,-122,20,12,32
40151,FremontBridge,05/02/2017 11:00:00 PM,48,-122,12,5,17
40152,FremontBridge,05/03/2017 12:00:00 AM,48,-122,3,3,6
40153,FremontBridge,05/03/2017 01:00:00 AM,48,-122,3,1,4
40154,FremontBridge,05/03/2017 02:00:00 AM,48,-122,2,2,4
40155,FremontBridge,05/03/2017 03:00:00 AM,48,-122,1,1,2
40156,FremontBridge,05/03/2017 04:00:00 AM,48,-122,2,2,4
40157,FremontBridge,05/03/2017 05:00:00 AM,48,-122,12,23,35
40158,FremontBridge,05/03/2017 06:00:00 AM,48,-122,67,117,184
40159,FremontBridge,05/03/2017 07:00:00 AM,48,-122,158,286,444
40160,FremontBridge,05/03/2017 08:00:00 AM,48,-122,238,341,579
40161,FremontBridge,05/03/2017 09:00:00 AM,48,-122,149,142,291
40162,FremontBridge,05/03/2017 10:00:00 AM,48,-122,49,37,86
40163,FremontBridge,05/03/2017 11:00:00 AM,48,-122,32,35,67
40164,FremontBridge,05/03/2017 12:00:00 PM,48,-122,32,42,74
40165,FremontBridge,05/03/2017 01:00:00 PM,48,-122,40,44,84
40166,FremontBridge,05/03/2017 02:00:00 PM,48,-122,56,39,95
40167,FremontBridge,05/03/2017 03:00:00 PM,48,-122,103,68,171
40168,FremontBridge,05/03/2017 04:00:00 PM,48,-122,268,135,403
40169,FremontBridge,05/03/2017 05:00:00 PM,48,-122,618,211,829
40170,FremontBridge,05/03/2017 06:00:00 PM,48,-122,347,218,565
40171,FremontBridge,05/03/2017 07:00:00 PM,48,-122,163,111,274
40172,FremontBridge,05/03/2017 08:00:00 PM,48,-122,104,82,186
40173,FremontBridge,05/03/2017 09:00:00 PM,48,-122,47,38,85
40174,FremontBridge,05/03/2017 10:00:00 PM,48,-122,25,23,48
40175,FremontBridge,05/03/2017 11:00:00 PM,48,-122,15,8,23
40176,FremontBridge,05/04/2017 12:00:00 AM,48,-122,8,4,12
40177,FremontBridge,05/04/2017 01:00:00 AM,48,-122,3,4,7
40178,FremontBridge,05/04/2017 02:00:00 AM,48,-122,3,7,10
40179,FremontBridge,05/04/2017 03:00:00 AM,48,-122,1,1,2
40180,FremontBridge,05/04/2017 04:00:00 AM,48,-122,3,7,10
40181,FremontBridge,05/04/2017 05:00:00 AM,48,-122,20,26,46
40182,FremontBridge,05/04/2017 06:00:00 AM,48,-122,55,112,167
40183,FremontBridge,05/04/2017 07:00:00 AM,48,-122,170,235,405
40184,FremontBridge,05/04/2017 08:00:00 AM,48,-122,225,300,525
40185,FremontBridge,05/04/2017 09:00:00 AM,48,-122,126,131,257
40186,FremontBridge,05/04/2017 10:00:00 AM,48,-122,61,57,118
40187,FremontBridge,05/04/2017 11:00:00 AM,48,-122,41,51,92
40188,FremontBridge,05/04/2017 12:00:00 PM,48,-122,50,48,98
40189,FremontBridge,05/04/2017 01:00:00 PM,48,-122,59,57,116
40190,FremontBridge,05/04/2017 02:00:00 PM,48,-122,67,61,128
40191,FremontBridge,05/04/2017 03:00:00 PM,48,-122,103,82,185
40192,FremontBridge,05/04/2017 04:00:00 PM,48,-122,249,94,343
40193,FremontBridge,05/04/2017 05:00:00 PM,48,-122,337,99,436
40194,FremontBridge,05/04/2017 06:00:00 PM,48,-122,167,74,241
40195,FremontBridge,05/04/2017 07:00:00 PM,48,-122,95,41,136
40196,FremontBridge,05/04/2017 08:00:00 PM,48,-122,45,28,73
40197,FremontBridge,05/04/2017 09:00:00 PM,48,-122,14,15,29
40198,FremontBridge,05/04/2017 10:00:00 PM,48,-122,20,6,26
40199,FremontBridge,05/04/2017 11:00:00 PM,48,-122,7,7,14
40200,FremontBridge,05/05/2017 12:00:00 AM,48,-122,1,2,3
40201,FremontBridge,05/05/2017 01:00:00 AM,48,-122,2,3,5
40202,FremontBridge,05/05/2017 02:00:00 AM,48,-122,2,2,4
40203,FremontBridge,05/05/2017 03:00:00 AM,48,-122,0,2,2
40204,FremontBridge,05/05/2017 04:00:00 AM,48,-122,3,0,3
40205,FremontBridge,05/05/2017 05:00:00 AM,48,-122,14,22,36
40206,FremontBridge,05/05/2017 06:00:00 AM,48,-122,48,62,110
40207,FremontBridge,05/05/2017 07:00:00 AM,48,-122,100,192,292
40208,FremontBridge,05/05/2017 08:00:00 AM,48,-122,181,219,400
40209,FremontBridge,05/05/2017 09:00:00 AM,48,-122,99,90,189
40210,FremontBridge,05/05/2017 10:00:00 AM,48,-122,37,30,67
40211,FremontBridge,05/05/2017 11:00:00 AM,48,-122,25,23,48
40212,FremontBridge,05/05/2017 12:00:00 PM,48,-122,23,27,50
40213,FremontBridge,05/05/2017 01:00:00 PM,48,-122,36,28,64
40214,FremontBridge,05/05/2017 02:00:00 PM,48,-122,34,27,61
40215,FremontBridge,05/05/2017 03:00:00 PM,48,-122,54,43,97
40216,FremontBridge,05/05/2017 04:00:00 PM,48,-122,231,68,299
40217,FremontBridge,05/05/2017 05:00:00 PM,48,-122,355,128,483
40218,FremontBridge,05/05/2017 06:00:00 PM,48,-122,176,69,245
40219,FremontBridge,05/05/2017 07:00:00 PM,48,-122,89,43,132
40220,FremontBridge,05/05/2017 08:00:00 PM,48,-122,38,20,58
40221,FremontBridge,05/05/2017 09:00:00 PM,48,-122,16,12,28
40222,FremontBridge,05/05/2017 10:00:00 PM,48,-122,18,10,28
40223,FremontBridge,05/05/2017 11:00:00 PM,48,-122,24,5,29
40224,FremontBridge,05/06/2017 12:00:00 AM,48,-122,10,2,12
40225,FremontBridge,05/06/2017 01:00:00 AM,48,-122,2,3,5
40226,FremontBridge,05/06/2017 02:00:00 AM,48,-122,3,1,4
40227,FremontBridge,05/06/2017 03:00:00 AM,48,-122,4,2,6
40228,FremontBridge,05/06/2017 04:00:00 AM,48,-122,0,2,2
40229,FremontBridge,05/06/2017 05:00:00 AM,48,-122,1,2,3
40230,FremontBridge,05/06/2017 06:00:00 AM,48,-122,6,11,17
40231,FremontBridge,05/06/2017 07:00:00 AM,48,-122,31,19,50
40232,FremontBridge,05/06/2017 08:00:00 AM,48,-122,42,47,89
40233,FremontBridge,05/06/2017 09:00:00 AM,48,-122,64,99,163
40234,FremontBridge,05/06/2017 10:00:00 AM,48,-122,70,53,123
40235,FremontBridge,05/06/2017 11:00:00 AM,48,-122,85,84,169
40236,FremontBridge,05/06/2017 12:00:00 PM,48,-122,65,119,184
40237,FremontBridge,05/06/2017 01:00:00 PM,48,-122,83,101,184
40238,FremontBridge,05/06/2017 02:00:00 PM,48,-122,86,104,190
40239,FremontBridge,05/06/2017 03:00:00 PM,48,-122,78,89,167
40240,FremontBridge,05/06/2017 04:00:00 PM,48,-122,95,98,193
40241,FremontBridge,05/06/2017 05:00:00 PM,48,-122,66,76,142
40242,FremontBridge,05/06/2017 06:00:00 PM,48,-122,74,49,123
40243,FremontBridge,05/06/2017 07:00:00 PM,48,-122,40,47,87
40244,FremontBridge,05/06/2017 08:00:00 PM,48,-122,24,23,47
40245,FremontBridge,05/06/2017 09:00:00 PM,48,-122,21,11,32
40246,FremontBridge,05/06/2017 10:00:00 PM,48,-122,16,11,27
40247,FremontBridge,05/06/2017 11:00:00 PM,48,-122,9,10,19
40248,FremontBridge,05/07/2017 12:00:00 AM,48,-122,6,8,14
40249,FremontBridge,05/07/2017 01:00:00 AM,48,-122,6,1,7
40250,FremontBridge,05/07/2017 02:00:00 AM,48,-122,3,1,4
40251,FremontBridge,05/07/2017 03:00:00 AM,48,-122,1,0,1
40252,FremontBridge,05/07/2017 04:00:00 AM,48,-122,2,0,2
40253,FremontBridge,05/07/2017 05:00:00 AM,48,-122,0,1,1
40254,FremontBridge,05/07/2017 06:00:00 AM,48,-122,3,10,13
40255,FremontBridge,05/07/2017 07:00:00 AM,48,-122,17,21,38
40256,FremontBridge,05/07/2017 08:00:00 AM,48,-122,30,44,74
40257,FremontBridge,05/07/2017 09:00:00 AM,48,-122,30,46,76
40258,FremontBridge,05/07/2017 10:00:00 AM,48,-122,55,74,129
40259,FremontBridge,05/07/2017 11:00:00 AM,48,-122,88,80,168
40260,FremontBridge,05/07/2017 12:00:00 PM,48,-122,92,106,198
40261,FremontBridge,05/07/2017 01:00:00 PM,48,-122,88,130,218
40262,FremontBridge,05/07/2017 02:00:00 PM,48,-122,104,89,193
40263,FremontBridge,05/07/2017 03:00:00 PM,48,-122,91,118,209
40264,FremontBridge,05/07/2017 04:00:00 PM,48,-122,113,115,228
40265,FremontBridge,05/07/2017 05:00:00 PM,48,-122,95,120,215
40266,FremontBridge,05/07/2017 06:00:00 PM,48,-122,53,96,149
40267,FremontBridge,05/07/2017 07:00:00 PM,48,-122,31,44,75
40268,FremontBridge,05/07/2017 08:00:00 PM,48,-122,18,16,34
40269,FremontBridge,05/07/2017 09:00:00 PM,48,-122,15,13,28
40270,FremontBridge,05/07/2017 10:00:00 PM,48,-122,7,4,11
40271,FremontBridge,05/07/2017 11:00:00 PM,48,-122,8,5,13
40272,FremontBridge,05/08/2017 12:00:00 AM,48,-122,3,0,3
40273,FremontBridge,05/08/2017 01:00:00 AM,48,-122,5,0,5
40274,FremontBridge,05/08/2017 02:00:00 AM,48,-122,1,0,1
40275,FremontBridge,05/08/2017 03:00:00 AM,48,-122,0,1,1
40276,FremontBridge,05/08/2017 04:00:00 AM,48,-122,3,3,6
40277,FremontBridge,05/08/2017 05:00:00 AM,48,-122,20,31,51
40278,FremontBridge,05/08/2017 06:00:00 AM,48,-122,70,98,168
40279,FremontBridge,05/08/2017 07:00:00 AM,48,-122,174,303,477
40280,FremontBridge,05/08/2017 08:00:00 AM,48,-122,274,387,661
40281,FremontBridge,05/08/2017 09:00:00 AM,48,-122,131,145,276
40282,FremontBridge,05/08/2017 10:00:00 AM,48,-122,56,58,114
40283,FremontBridge,05/08/2017 11:00:00 AM,48,-122,38,22,60
40284,FremontBridge,05/08/2017 12:00:00 PM,48,-122,29,22,51
40285,FremontBridge,05/08/2017 01:00:00 PM,48,-122,28,35,63
40286,FremontBridge,05/08/2017 02:00:00 PM,48,-122,64,40,104
40287,FremontBridge,05/08/2017 03:00:00 PM,48,-122,99,61,160
40288,FremontBridge,05/08/2017 04:00:00 PM,48,-122,258,129,387
40289,FremontBridge,05/08/2017 05:00:00 PM,48,-122,608,180,788
40290,FremontBridge,05/08/2017 06:00:00 PM,48,-122,388,157,545
40291,FremontBridge,05/08/2017 07:00:00 PM,48,-122,129,86,215
40292,FremontBridge,05/08/2017 08:00:00 PM,48,-122,67,68,135
40293,FremontBridge,05/08/2017 09:00:00 PM,48,-122,41,25,66
40294,FremontBridge,05/08/2017 10:00:00 PM,48,-122,22,7,29
40295,FremontBridge,05/08/2017 11:00:00 PM,48,-122,14,7,21
40296,FremontBridge,05/09/2017 12:00:00 AM,48,-122,3,2,5
40297,FremontBridge,05/09/2017 01:00:00 AM,48,-122,2,2,4
40298,FremontBridge,05/09/2017 02:00:00 AM,48,-122,0,0,0
40299,FremontBridge,05/09/2017 03:00:00 AM,48,-122,0,1,1
40300,FremontBridge,05/09/2017 04:00:00 AM,48,-122,6,2,8
40301,FremontBridge,05/09/2017 05:00:00 AM,48,-122,13,35,48
40302,FremontBridge,05/09/2017 06:00:00 AM,48,-122,80,133,213
40303,FremontBridge,05/09/2017 07:00:00 AM,48,-122,207,363,570
40304,FremontBridge,05/09/2017 08:00:00 AM,48,-122,275,421,696
40305,FremontBridge,05/09/2017 09:00:00 AM,48,-122,171,152,323
40306,FremontBridge,05/09/2017 10:00:00 AM,48,-122,56,70,126
40307,FremontBridge,05/09/2017 11:00:00 AM,48,-122,48,42,90
40308,FremontBridge,05/09/2017 12:00:00 PM,48,-122,54,53,107
40309,FremontBridge,05/09/2017 01:00:00 PM,48,-122,48,65,113
40310,FremontBridge,05/09/2017 02:00:00 PM,48,-122,80,63,143
40311,FremontBridge,05/09/2017 03:00:00 PM,48,-122,103,80,183
40312,FremontBridge,05/09/2017 04:00:00 PM,48,-122,293,140,433
40313,FremontBridge,05/09/2017 05:00:00 PM,48,-122,623,204,827
40314,FremontBridge,05/09/2017 06:00:00 PM,48,-122,383,188,571
40315,FremontBridge,05/09/2017 07:00:00 PM,48,-122,178,106,284
40316,FremontBridge,05/09/2017 08:00:00 PM,48,-122,88,65,153
40317,FremontBridge,05/09/2017 09:00:00 PM,48,-122,53,33,86
40318,FremontBridge,05/09/2017 10:00:00 PM,48,-122,36,23,59
40319,FremontBridge,05/09/2017 11:00:00 PM,48,-122,18,10,28
40320,FremontBridge,05/10/2017 12:00:00 AM,48,-122,4,8,12
40321,FremontBridge,05/10/2017 01:00:00 AM,48,-122,2,2,4
40322,FremontBridge,05/10/2017 02:00:00 AM,48,-122,0,1,1
40323,FremontBridge,05/10/2017 03:00:00 AM,48,-122,2,0,2
40324,FremontBridge,05/10/2017 04:00:00 AM,48,-122,4,3,7
40325,FremontBridge,05/10/2017 05:00:00 AM,48,-122,19,33,52
40326,FremontBridge,05/10/2017 06:00:00 AM,48,-122,91,143,234
40327,FremontBridge,05/10/2017 07:00:00 AM,48,-122,201,318,519
40328,FremontBridge,05/10/2017 08:00:00 AM,48,-122,265,380,645
40329,FremontBridge,05/10/2017 09:00:00 AM,48,-122,158,131,289
40330,FremontBridge,05/10/2017 10:00:00 AM,48,-122,71,63,134
40331,FremontBridge,05/10/2017 11:00:00 AM,48,-122,50,51,101
40332,FremontBridge,05/10/2017 12:00:00 PM,48,-122,57,33,90
40333,FremontBridge,05/10/2017 01:00:00 PM,48,-122,63,73,136
40334,FremontBridge,05/10/2017 02:00:00 PM,48,-122,76,58,134
40335,FremontBridge,05/10/2017 03:00:00 PM,48,-122,122,75,197
40336,FremontBridge,05/10/2017 04:00:00 PM,48,-122,308,148,456
40337,FremontBridge,05/10/2017 05:00:00 PM,48,-122,623,189,812
40338,FremontBridge,05/10/2017 06:00:00 PM,48,-122,386,212,598
40339,FremontBridge,05/10/2017 07:00:00 PM,48,-122,149,100,249
40340,FremontBridge,05/10/2017 08:00:00 PM,48,-122,104,56,160
40341,FremontBridge,05/10/2017 09:00:00 PM,48,-122,55,30,85
40342,FremontBridge,05/10/2017 10:00:00 PM,48,-122,27,28,55
40343,FremontBridge,05/10/2017 11:00:00 PM,48,-122,19,8,27
40344,FremontBridge,05/11/2017 12:00:00 AM,48,-122,3,9,12
40345,FremontBridge,05/11/2017 01:00:00 AM,48,-122,2,3,5
40346,FremontBridge,05/11/2017 02:00:00 AM,48,-122,1,1,2
40347,FremontBridge,05/11/2017 03:00:00 AM,48,-122,1,2,3
40348,FremontBridge,05/11/2017 04:00:00 AM,48,-122,3,4,7
40349,FremontBridge,05/11/2017 05:00:00 AM,48,-122,14,19,33
40350,FremontBridge,05/11/2017 06:00:00 AM,48,-122,46,71,117
40351,FremontBridge,05/11/2017 07:00:00 AM,48,-122,151,194,345
40352,FremontBridge,05/11/2017 08:00:00 AM,48,-122,195,259,454
40353,FremontBridge,05/11/2017 09:00:00 AM,48,-122,100,132,232
40354,FremontBridge,05/11/2017 10:00:00 AM,48,-122,59,43,102
40355,FremontBridge,05/11/2017 11:00:00 AM,48,-122,16,19,35
40356,FremontBridge,05/11/2017 12:00:00 PM,48,-122,21,20,41
40357,FremontBridge,05/11/2017 01:00:00 PM,48,-122,19,16,35
40358,FremontBridge,05/11/2017 02:00:00 PM,48,-122,26,18,44
40359,FremontBridge,05/11/2017 03:00:00 PM,48,-122,49,45,94
40360,FremontBridge,05/11/2017 04:00:00 PM,48,-122,137,59,196
40361,FremontBridge,05/11/2017 05:00:00 PM,48,-122,414,110,524
40362,FremontBridge,05/11/2017 06:00:00 PM,48,-122,200,75,275
40363,FremontBridge,05/11/2017 07:00:00 PM,48,-122,103,44,147
40364,FremontBridge,05/11/2017 08:00:00 PM,48,-122,111,32,143
40365,FremontBridge,05/11/2017 09:00:00 PM,48,-122,24,15,39
40366,FremontBridge,05/11/2017 10:00:00 PM,48,-122,10,5,15
40367,FremontBridge,05/11/2017 11:00:00 PM,48,-122,17,1,18
40368,FremontBridge,05/12/2017 12:00:00 AM,48,-122,8,3,11
40369,FremontBridge,05/12/2017 01:00:00 AM,48,-122,1,2,3
40370,FremontBridge,05/12/2017 02:00:00 AM,48,-122,0,5,5
40371,FremontBridge,05/12/2017 03:00:00 AM,48,-122,2,0,2
40372,FremontBridge,05/12/2017 04:00:00 AM,48,-122,2,3,5
40373,FremontBridge,05/12/2017 05:00:00 AM,48,-122,10,28,38
40374,FremontBridge,05/12/2017 06:00:00 AM,48,-122,56,71,127
40375,FremontBridge,05/12/2017 07:00:00 AM,48,-122,170,216,386
40376,FremontBridge,05/12/2017 08:00:00 AM,48,-122,210,265,475
40377,FremontBridge,05/12/2017 09:00:00 AM,48,-122,114,109,223
40378,FremontBridge,05/12/2017 10:00:00 AM,48,-122,53,47,100
40379,FremontBridge,05/12/2017 11:00:00 AM,48,-122,47,28,75
40380,FremontBridge,05/12/2017 12:00:00 PM,48,-122,37,23,60
40381,FremontBridge,05/12/2017 01:00:00 PM,48,-122,29,22,51
40382,FremontBridge,05/12/2017 02:00:00 PM,48,-122,51,37,88
40383,FremontBridge,05/12/2017 03:00:00 PM,48,-122,74,51,125
40384,FremontBridge,05/12/2017 04:00:00 PM,48,-122,196,60,256
40385,FremontBridge,05/12/2017 05:00:00 PM,48,-122,363,122,485
40386,FremontBridge,05/12/2017 06:00:00 PM,48,-122,218,59,277
40387,FremontBridge,05/12/2017 07:00:00 PM,48,-122,82,50,132
40388,FremontBridge,05/12/2017 08:00:00 PM,48,-122,28,22,50
40389,FremontBridge,05/12/2017 09:00:00 PM,48,-122,26,12,38
40390,FremontBridge,05/12/2017 10:00:00 PM,48,-122,11,9,20
40391,FremontBridge,05/12/2017 11:00:00 PM,48,-122,12,6,18
40392,FremontBridge,05/13/2017 12:00:00 AM,48,-122,5,6,11
40393,FremontBridge,05/13/2017 01:00:00 AM,48,-122,1,1,2
40394,FremontBridge,05/13/2017 02:00:00 AM,48,-122,3,5,8
40395,FremontBridge,05/13/2017 03:00:00 AM,48,-122,5,0,5
40396,FremontBridge,05/13/2017 04:00:00 AM,48,-122,0,2,2
40397,FremontBridge,05/13/2017 05:00:00 AM,48,-122,4,2,6
40398,FremontBridge,05/13/2017 06:00:00 AM,48,-122,11,7,18
40399,FremontBridge,05/13/2017 07:00:00 AM,48,-122,16,15,31
40400,FremontBridge,05/13/2017 08:00:00 AM,48,-122,29,30,59
40401,FremontBridge,05/13/2017 09:00:00 AM,48,-122,38,46,84
40402,FremontBridge,05/13/2017 10:00:00 AM,48,-122,36,59,95
40403,FremontBridge,05/13/2017 11:00:00 AM,48,-122,65,56,121
40404,FremontBridge,05/13/2017 12:00:00 PM,48,-122,51,61,112
40405,FremontBridge,05/13/2017 01:00:00 PM,48,-122,51,43,94
40406,FremontBridge,05/13/2017 02:00:00 PM,48,-122,49,50,99
40407,FremontBridge,05/13/2017 03:00:00 PM,48,-122,75,85,160
40408,FremontBridge,05/13/2017 04:00:00 PM,48,-122,56,60,116
40409,FremontBridge,05/13/2017 05:00:00 PM,48,-122,55,58,113
40410,FremontBridge,05/13/2017 06:00:00 PM,48,-122,48,30,78
40411,FremontBridge,05/13/2017 07:00:00 PM,48,-122,27,15,42
40412,FremontBridge,05/13/2017 08:00:00 PM,48,-122,10,12,22
40413,FremontBridge,05/13/2017 09:00:00 PM,48,-122,9,12,21
40414,FremontBridge,05/13/2017 10:00:00 PM,48,-122,4,6,10
40415,FremontBridge,05/13/2017 11:00:00 PM,48,-122,16,8,24
40416,FremontBridge,05/14/2017 12:00:00 AM,48,-122,10,6,16
40417,FremontBridge,05/14/2017 01:00:00 AM,48,-122,3,3,6
40418,FremontBridge,05/14/2017 02:00:00 AM,48,-122,0,1,1
40419,FremontBridge,05/14/2017 03:00:00 AM,48,-122,2,1,3
40420,FremontBridge,05/14/2017 04:00:00 AM,48,-122,1,0,1
40421,FremontBridge,05/14/2017 05:00:00 AM,48,-122,2,2,4
40422,FremontBridge,05/14/2017 06:00:00 AM,48,-122,5,5,10
40423,FremontBridge,05/14/2017 07:00:00 AM,48,-122,8,12,20
40424,FremontBridge,05/14/2017 08:00:00 AM,48,-122,14,23,37
40425,FremontBridge,05/14/2017 09:00:00 AM,48,-122,15,37,52
40426,FremontBridge,05/14/2017 10:00:00 AM,48,-122,25,21,46
40427,FremontBridge,05/14/2017 11:00:00 AM,48,-122,32,37,69
40428,FremontBridge,05/14/2017 12:00:00 PM,48,-122,49,55,104
40429,FremontBridge,05/14/2017 01:00:00 PM,48,-122,39,50,89
40430,FremontBridge,05/14/2017 02:00:00 PM,48,-122,41,56,97
40431,FremontBridge,05/14/2017 03:00:00 PM,48,-122,49,56,105
40432,FremontBridge,05/14/2017 04:00:00 PM,48,-122,39,42,81
40433,FremontBridge,05/14/2017 05:00:00 PM,48,-122,41,36,77
40434,FremontBridge,05/14/2017 06:00:00 PM,48,-122,30,35,65
40435,FremontBridge,05/14/2017 07:00:00 PM,48,-122,22,18,40
40436,FremontBridge,05/14/2017 08:00:00 PM,48,-122,28,12,40
40437,FremontBridge,05/14/2017 09:00:00 PM,48,-122,11,11,22
40438,FremontBridge,05/14/2017 10:00:00 PM,48,-122,5,14,19
40439,FremontBridge,05/14/2017 11:00:00 PM,48,-122,7,5,12
40440,FremontBridge,05/15/2017 12:00:00 AM,48,-122,5,1,6
40441,FremontBridge,05/15/2017 01:00:00 AM,48,-122,4,2,6
40442,FremontBridge,05/15/2017 02:00:00 AM,48,-122,0,0,0
40443,FremontBridge,05/15/2017 03:00:00 AM,48,-122,0,1,1
40444,FremontBridge,05/15/2017 04:00:00 AM,48,-122,5,4,9
40445,FremontBridge,05/15/2017 05:00:00 AM,48,-122,12,30,42
40446,FremontBridge,05/15/2017 06:00:00 AM,48,-122,57,94,151
40447,FremontBridge,05/15/2017 07:00:00 AM,48,-122,141,232,373
40448,FremontBridge,05/15/2017 08:00:00 AM,48,-122,206,305,511
40449,FremontBridge,05/15/2017 09:00:00 AM,48,-122,94,107,201
40450,FremontBridge,05/15/2017 10:00:00 AM,48,-122,46,44,90
40451,FremontBridge,05/15/2017 11:00:00 AM,48,-122,28,24,52
40452,FremontBridge,05/15/2017 12:00:00 PM,48,-122,27,21,48
40453,FremontBridge,05/15/2017 01:00:00 PM,48,-122,22,27,49
40454,FremontBridge,05/15/2017 02:00:00 PM,48,-122,38,18,56
40455,FremontBridge,05/15/2017 03:00:00 PM,48,-122,58,31,89
40456,FremontBridge,05/15/2017 04:00:00 PM,48,-122,153,44,197
40457,FremontBridge,05/15/2017 05:00:00 PM,48,-122,390,103,493
40458,FremontBridge,05/15/2017 06:00:00 PM,48,-122,243,68,311
40459,FremontBridge,05/15/2017 07:00:00 PM,48,-122,81,39,120
40460,FremontBridge,05/15/2017 08:00:00 PM,48,-122,26,28,54
40461,FremontBridge,05/15/2017 09:00:00 PM,48,-122,24,8,32
40462,FremontBridge,05/15/2017 10:00:00 PM,48,-122,12,11,23
40463,FremontBridge,05/15/2017 11:00:00 PM,48,-122,4,0,4
40464,FremontBridge,05/16/2017 12:00:00 AM,48,-122,0,3,3
40465,FremontBridge,05/16/2017 01:00:00 AM,48,-122,2,1,3
40466,FremontBridge,05/16/2017 02:00:00 AM,48,-122,1,0,1
40467,FremontBridge,05/16/2017 03:00:00 AM,48,-122,1,0,1
40468,FremontBridge,05/16/2017 04:00:00 AM,48,-122,4,3,7
40469,FremontBridge,05/16/2017 05:00:00 AM,48,-122,7,19,26
40470,FremontBridge,05/16/2017 06:00:00 AM,48,-122,38,49,87
40471,FremontBridge,05/16/2017 07:00:00 AM,48,-122,86,142,228
40472,FremontBridge,05/16/2017 08:00:00 AM,48,-122,155,180,335
40473,FremontBridge,05/16/2017 09:00:00 AM,48,-122,81,75,156
40474,FremontBridge,05/16/2017 10:00:00 AM,48,-122,20,22,42
40475,FremontBridge,05/16/2017 11:00:00 AM,48,-122,24,12,36
40476,FremontBridge,05/16/2017 12:00:00 PM,48,-122,15,15,30
40477,FremontBridge,05/16/2017 01:00:00 PM,48,-122,30,23,53
40478,FremontBridge,05/16/2017 02:00:00 PM,48,-122,32,30,62
40479,FremontBridge,05/16/2017 03:00:00 PM,48,-122,56,48,104
40480,FremontBridge,05/16/2017 04:00:00 PM,48,-122,155,52,207
40481,FremontBridge,05/16/2017 05:00:00 PM,48,-122,312,93,405
40482,FremontBridge,05/16/2017 06:00:00 PM,48,-122,182,114,296
40483,FremontBridge,05/16/2017 07:00:00 PM,48,-122,87,46,133
40484,FremontBridge,05/16/2017 08:00:00 PM,48,-122,43,23,66
40485,FremontBridge,05/16/2017 09:00:00 PM,48,-122,25,10,35
40486,FremontBridge,05/16/2017 10:00:00 PM,48,-122,20,15,35
40487,FremontBridge,05/16/2017 11:00:00 PM,48,-122,15,6,21
40488,FremontBridge,05/17/2017 12:00:00 AM,48,-122,2,0,2
40489,FremontBridge,05/17/2017 01:00:00 AM,48,-122,1,1,2
40490,FremontBridge,05/17/2017 02:00:00 AM,48,-122,2,3,5
40491,FremontBridge,05/17/2017 03:00:00 AM,48,-122,1,1,2
40492,FremontBridge,05/17/2017 04:00:00 AM,48,-122,2,5,7
40493,FremontBridge,05/17/2017 05:00:00 AM,48,-122,20,25,45
40494,FremontBridge,05/17/2017 06:00:00 AM,48,-122,68,111,179
40495,FremontBridge,05/17/2017 07:00:00 AM,48,-122,197,278,475
40496,FremontBridge,05/17/2017 08:00:00 AM,48,-122,221,327,548
40497,FremontBridge,05/17/2017 09:00:00 AM,48,-122,123,162,285
40498,FremontBridge,05/17/2017 10:00:00 AM,48,-122,66,39,105
40499,FremontBridge,05/17/2017 11:00:00 AM,48,-122,37,30,67
40500,FremontBridge,05/17/2017 12:00:00 PM,48,-122,48,47,95
40501,FremontBridge,05/17/2017 01:00:00 PM,48,-122,30,46,76
40502,FremontBridge,05/17/2017 02:00:00 PM,48,-122,53,47,100
40503,FremontBridge,05/17/2017 03:00:00 PM,48,-122,99,53,152
40504,FremontBridge,05/17/2017 04:00:00 PM,48,-122,238,94,332
40505,FremontBridge,05/17/2017 05:00:00 PM,48,-122,563,169,732
40506,FremontBridge,05/17/2017 06:00:00 PM,48,-122,306,132,438
40507,FremontBridge,05/17/2017 07:00:00 PM,48,-122,140,69,209
40508,FremontBridge,05/17/2017 08:00:00 PM,48,-122,77,53,130
40509,FremontBridge,05/17/2017 09:00:00 PM,48,-122,38,26,64
40510,FremontBridge,05/17/2017 10:00:00 PM,48,-122,33,17,50
40511,FremontBridge,05/17/2017 11:00:00 PM,48,-122,13,12,25
40512,FremontBridge,05/18/2017 12:00:00 AM,48,-122,5,3,8
40513,FremontBridge,05/18/2017 01:00:00 AM,48,-122,2,1,3
40514,FremontBridge,05/18/2017 02:00:00 AM,48,-122,0,0,0
40515,FremontBridge,05/18/2017 03:00:00 AM,48,-122,2,2,4
40516,FremontBridge,05/18/2017 04:00:00 AM,48,-122,1,3,4
40517,FremontBridge,05/18/2017 05:00:00 AM,48,-122,16,31,47
40518,FremontBridge,05/18/2017 06:00:00 AM,48,-122,64,137,201
40519,FremontBridge,05/18/2017 07:00:00 AM,48,-122,169,265,434
40520,FremontBridge,05/18/2017 08:00:00 AM,48,-122,269,359,628
40521,FremontBridge,05/18/2017 09:00:00 AM,48,-122,139,150,289
40522,FremontBridge,05/18/2017 10:00:00 AM,48,-122,82,50,132
40523,FremontBridge,05/18/2017 11:00:00 AM,48,-122,41,40,81
40524,FremontBridge,05/18/2017 12:00:00 PM,48,-122,37,40,77
40525,FremontBridge,05/18/2017 01:00:00 PM,48,-122,58,35,93
40526,FremontBridge,05/18/2017 02:00:00 PM,48,-122,71,52,123
40527,FremontBridge,05/18/2017 03:00:00 PM,48,-122,115,55,170
40528,FremontBridge,05/18/2017 04:00:00 PM,48,-122,289,118,407
40529,FremontBridge,05/18/2017 05:00:00 PM,48,-122,485,186,671
40530,FremontBridge,05/18/2017 06:00:00 PM,48,-122,320,130,450
40531,FremontBridge,05/18/2017 07:00:00 PM,48,-122,148,97,245
40532,FremontBridge,05/18/2017 08:00:00 PM,48,-122,97,59,156
40533,FremontBridge,05/18/2017 09:00:00 PM,48,-122,44,38,82
40534,FremontBridge,05/18/2017 10:00:00 PM,48,-122,41,31,72
40535,FremontBridge,05/18/2017 11:00:00 PM,48,-122,18,2,20
40536,FremontBridge,05/19/2017 12:00:00 AM,48,-122,9,6,15
40537,FremontBridge,05/19/2017 01:00:00 AM,48,-122,3,3,6
40538,FremontBridge,05/19/2017 02:00:00 AM,48,-122,0,3,3
40539,FremontBridge,05/19/2017 03:00:00 AM,48,-122,3,3,6
40540,FremontBridge,05/19/2017 04:00:00 AM,48,-122,6,3,9
40541,FremontBridge,05/19/2017 05:00:00 AM,48,-122,22,48,70
40542,FremontBridge,05/19/2017 06:00:00 AM,48,-122,63,216,279
40543,FremontBridge,05/19/2017 07:00:00 AM,48,-122,202,517,719
40544,FremontBridge,05/19/2017 08:00:00 AM,48,-122,276,513,789
40545,FremontBridge,05/19/2017 09:00:00 AM,48,-122,176,178,354
40546,FremontBridge,05/19/2017 10:00:00 AM,48,-122,75,69,144
40547,FremontBridge,05/19/2017 11:00:00 AM,48,-122,60,54,114
40548,FremontBridge,05/19/2017 12:00:00 PM,48,-122,76,43,119
40549,FremontBridge,05/19/2017 01:00:00 PM,48,-122,73,59,132
40550,FremontBridge,05/19/2017 02:00:00 PM,48,-122,112,88,200
40551,FremontBridge,05/19/2017 03:00:00 PM,48,-122,195,111,306
40552,FremontBridge,05/19/2017 04:00:00 PM,48,-122,400,114,514
40553,FremontBridge,05/19/2017 05:00:00 PM,48,-122,553,190,743
40554,FremontBridge,05/19/2017 06:00:00 PM,48,-122,311,123,434
40555,FremontBridge,05/19/2017 07:00:00 PM,48,-122,119,70,189
40556,FremontBridge,05/19/2017 08:00:00 PM,48,-122,55,40,95
40557,FremontBridge,05/19/2017 09:00:00 PM,48,-122,49,23,72
40558,FremontBridge,05/19/2017 10:00:00 PM,48,-122,28,14,42
40559,FremontBridge,05/19/2017 11:00:00 PM,48,-122,28,10,38
40560,FremontBridge,05/20/2017 12:00:00 AM,48,-122,16,10,26
40561,FremontBridge,05/20/2017 01:00:00 AM,48,-122,7,7,14
40562,FremontBridge,05/20/2017 02:00:00 AM,48,-122,3,2,5
40563,FremontBridge,05/20/2017 03:00:00 AM,48,-122,4,3,7
40564,FremontBridge,05/20/2017 04:00:00 AM,48,-122,0,2,2
40565,FremontBridge,05/20/2017 05:00:00 AM,48,-122,3,7,10
40566,FremontBridge,05/20/2017 06:00:00 AM,48,-122,11,15,26
40567,FremontBridge,05/20/2017 07:00:00 AM,48,-122,33,24,57
40568,FremontBridge,05/20/2017 08:00:00 AM,48,-122,60,56,116
40569,FremontBridge,05/20/2017 09:00:00 AM,48,-122,68,65,133
40570,FremontBridge,05/20/2017 10:00:00 AM,48,-122,82,87,169
40571,FremontBridge,05/20/2017 11:00:00 AM,48,-122,93,100,193
40572,FremontBridge,05/20/2017 12:00:00 PM,48,-122,123,93,216
40573,FremontBridge,05/20/2017 01:00:00 PM,48,-122,117,114,231
40574,FremontBridge,05/20/2017 02:00:00 PM,48,-122,111,106,217
40575,FremontBridge,05/20/2017 03:00:00 PM,48,-122,128,121,249
40576,FremontBridge,05/20/2017 04:00:00 PM,48,-122,100,98,198
40577,FremontBridge,05/20/2017 05:00:00 PM,48,-122,112,77,189
40578,FremontBridge,05/20/2017 06:00:00 PM,48,-122,90,86,176
40579,FremontBridge,05/20/2017 07:00:00 PM,48,-122,38,62,100
40580,FremontBridge,05/20/2017 08:00:00 PM,48,-122,45,38,83
40581,FremontBridge,05/20/2017 09:00:00 PM,48,-122,22,26,48
40582,FremontBridge,05/20/2017 10:00:00 PM,48,-122,29,28,57
40583,FremontBridge,05/20/2017 11:00:00 PM,48,-122,13,15,28
40584,FremontBridge,05/21/2017 12:00:00 AM,48,-122,8,4,12
40585,FremontBridge,05/21/2017 01:00:00 AM,48,-122,2,2,4
40586,FremontBridge,05/21/2017 02:00:00 AM,48,-122,1,2,3
40587,FremontBridge,05/21/2017 03:00:00 AM,48,-122,1,0,1
40588,FremontBridge,05/21/2017 04:00:00 AM,48,-122,2,2,4
40589,FremontBridge,05/21/2017 05:00:00 AM,48,-122,0,4,4
40590,FremontBridge,05/21/2017 06:00:00 AM,48,-122,14,10,24
40591,FremontBridge,05/21/2017 07:00:00 AM,48,-122,28,17,45
40592,FremontBridge,05/21/2017 08:00:00 AM,48,-122,39,41,80
40593,FremontBridge,05/21/2017 09:00:00 AM,48,-122,59,52,111
40594,FremontBridge,05/21/2017 10:00:00 AM,48,-122,90,92,182
40595,FremontBridge,05/21/2017 11:00:00 AM,48,-122,113,95,208
40596,FremontBridge,05/21/2017 12:00:00 PM,48,-122,97,129,226
40597,FremontBridge,05/21/2017 01:00:00 PM,48,-122,97,111,208
40598,FremontBridge,05/21/2017 02:00:00 PM,48,-122,116,118,234
40599,FremontBridge,05/21/2017 03:00:00 PM,48,-122,108,143,251
40600,FremontBridge,05/21/2017 04:00:00 PM,48,-122,91,129,220
40601,FremontBridge,05/21/2017 05:00:00 PM,48,-122,86,140,226
40602,FremontBridge,05/21/2017 06:00:00 PM,48,-122,70,80,150
40603,FremontBridge,05/21/2017 07:00:00 PM,48,-122,50,66,116
40604,FremontBridge,05/21/2017 08:00:00 PM,48,-122,20,24,44
40605,FremontBridge,05/21/2017 09:00:00 PM,48,-122,25,16,41
40606,FremontBridge,05/21/2017 10:00:00 PM,48,-122,11,12,23
40607,FremontBridge,05/21/2017 11:00:00 PM,48,-122,10,4,14
40608,FremontBridge,05/22/2017 12:00:00 AM,48,-122,2,3,5
40609,FremontBridge,05/22/2017 01:00:00 AM,48,-122,2,2,4
40610,FremontBridge,05/22/2017 02:00:00 AM,48,-122,1,1,2
40611,FremontBridge,05/22/2017 03:00:00 AM,48,-122,2,0,2
40612,FremontBridge,05/22/2017 04:00:00 AM,48,-122,3,6,9
40613,FremontBridge,05/22/2017 05:00:00 AM,48,-122,17,41,58
40614,FremontBridge,05/22/2017 06:00:00 AM,48,-122,95,137,232
40615,FremontBridge,05/22/2017 07:00:00 AM,48,-122,194,351,545
40616,FremontBridge,05/22/2017 08:00:00 AM,48,-122,312,399,711
40617,FremontBridge,05/22/2017 09:00:00 AM,48,-122,198,181,379
40618,FremontBridge,05/22/2017 10:00:00 AM,48,-122,80,56,136
40619,FremontBridge,05/22/2017 11:00:00 AM,48,-122,42,52,94
40620,FremontBridge,05/22/2017 12:00:00 PM,48,-122,55,49,104
40621,FremontBridge,05/22/2017 01:00:00 PM,48,-122,44,45,89
40622,FremontBridge,05/22/2017 02:00:00 PM,48,-122,58,65,123
40623,FremontBridge,05/22/2017 03:00:00 PM,48,-122,129,77,206
40624,FremontBridge,05/22/2017 04:00:00 PM,48,-122,326,116,442
40625,FremontBridge,05/22/2017 05:00:00 PM,48,-122,696,217,913
40626,FremontBridge,05/22/2017 06:00:00 PM,48,-122,369,194,563
40627,FremontBridge,05/22/2017 07:00:00 PM,48,-122,176,114,290
40628,FremontBridge,05/22/2017 08:00:00 PM,48,-122,96,73,169
40629,FremontBridge,05/22/2017 09:00:00 PM,48,-122,44,53,97
40630,FremontBridge,05/22/2017 10:00:00 PM,48,-122,19,18,37
40631,FremontBridge,05/22/2017 11:00:00 PM,48,-122,8,11,19
40632,FremontBridge,05/23/2017 12:00:00 AM,48,-122,8,3,11
40633,FremontBridge,05/23/2017 01:00:00 AM,48,-122,1,5,6
40634,FremontBridge,05/23/2017 02:00:00 AM,48,-122,3,1,4
40635,FremontBridge,05/23/2017 03:00:00 AM,48,-122,0,2,2
40636,FremontBridge,05/23/2017 04:00:00 AM,48,-122,7,7,14
40637,FremontBridge,05/23/2017 05:00:00 AM,48,-122,25,37,62
40638,FremontBridge,05/23/2017 06:00:00 AM,48,-122,87,154,241
40639,FremontBridge,05/23/2017 07:00:00 AM,48,-122,266,400,666
40640,FremontBridge,05/23/2017 08:00:00 AM,48,-122,332,431,763
40641,FremontBridge,05/23/2017 09:00:00 AM,48,-122,173,177,350
40642,FremontBridge,05/23/2017 10:00:00 AM,48,-122,86,64,150
40643,FremontBridge,05/23/2017 11:00:00 AM,48,-122,61,47,108
40644,FremontBridge,05/23/2017 12:00:00 PM,48,-122,63,67,130
40645,FremontBridge,05/23/2017 01:00:00 PM,48,-122,65,53,118
40646,FremontBridge,05/23/2017 02:00:00 PM,48,-122,77,61,138
40647,FremontBridge,05/23/2017 03:00:00 PM,48,-122,142,66,208
40648,FremontBridge,05/23/2017 04:00:00 PM,48,-122,335,122,457
40649,FremontBridge,05/23/2017 05:00:00 PM,48,-122,664,210,874
40650,FremontBridge,05/23/2017 06:00:00 PM,48,-122,397,177,574
40651,FremontBridge,05/23/2017 07:00:00 PM,48,-122,194,88,282
40652,FremontBridge,05/23/2017 08:00:00 PM,48,-122,79,79,158
40653,FremontBridge,05/23/2017 09:00:00 PM,48,-122,54,40,94
40654,FremontBridge,05/23/2017 10:00:00 PM,48,-122,22,26,48
40655,FremontBridge,05/23/2017 11:00:00 PM,48,-122,8,12,20
40656,FremontBridge,05/24/2017 12:00:00 AM,48,-122,2,2,4
40657,FremontBridge,05/24/2017 01:00:00 AM,48,-122,4,4,8
40658,FremontBridge,05/24/2017 02:00:00 AM,48,-122,1,0,1
40659,FremontBridge,05/24/2017 03:00:00 AM,48,-122,0,2,2
40660,FremontBridge,05/24/2017 04:00:00 AM,48,-122,4,4,8
40661,FremontBridge,05/24/2017 05:00:00 AM,48,-122,14,30,44
40662,FremontBridge,05/24/2017 06:00:00 AM,48,-122,73,121,194
40663,FremontBridge,05/24/2017 07:00:00 AM,48,-122,192,311,503
40664,FremontBridge,05/24/2017 08:00:00 AM,48,-122,267,369,636
40665,FremontBridge,05/24/2017 09:00:00 AM,48,-122,190,162,352
40666,FremontBridge,05/24/2017 10:00:00 AM,48,-122,65,64,129
40667,FremontBridge,05/24/2017 11:00:00 AM,48,-122,41,40,81
40668,FremontBridge,05/24/2017 12:00:00 PM,48,-122,41,41,82
40669,FremontBridge,05/24/2017 01:00:00 PM,48,-122,57,33,90
40670,FremontBridge,05/24/2017 02:00:00 PM,48,-122,55,35,90
40671,FremontBridge,05/24/2017 03:00:00 PM,48,-122,85,67,152
40672,FremontBridge,05/24/2017 04:00:00 PM,48,-122,272,109,381
40673,FremontBridge,05/24/2017 05:00:00 PM,48,-122,540,173,713
40674,FremontBridge,05/24/2017 06:00:00 PM,48,-122,366,161,527
40675,FremontBridge,05/24/2017 07:00:00 PM,48,-122,133,88,221
40676,FremontBridge,05/24/2017 08:00:00 PM,48,-122,93,61,154
40677,FremontBridge,05/24/2017 09:00:00 PM,48,-122,55,39,94
40678,FremontBridge,05/24/2017 10:00:00 PM,48,-122,21,24,45
40679,FremontBridge,05/24/2017 11:00:00 PM,48,-122,15,9,24
40680,FremontBridge,05/25/2017 12:00:00 AM,48,-122,6,9,15
40681,FremontBridge,05/25/2017 01:00:00 AM,48,-122,0,1,1
40682,FremontBridge,05/25/2017 02:00:00 AM,48,-122,4,1,5
40683,FremontBridge,05/25/2017 03:00:00 AM,48,-122,1,3,4
40684,FremontBridge,05/25/2017 04:00:00 AM,48,-122,3,6,9
40685,FremontBridge,05/25/2017 05:00:00 AM,48,-122,16,45,61
40686,FremontBridge,05/25/2017 06:00:00 AM,48,-122,79,126,205
40687,FremontBridge,05/25/2017 07:00:00 AM,48,-122,188,301,489
40688,FremontBridge,05/25/2017 08:00:00 AM,48,-122,286,382,668
40689,FremontBridge,05/25/2017 09:00:00 AM,48,-122,181,172,353
40690,FremontBridge,05/25/2017 10:00:00 AM,48,-122,72,71,143
40691,FremontBridge,05/25/2017 11:00:00 AM,48,-122,52,56,108
40692,FremontBridge,05/25/2017 12:00:00 PM,48,-122,48,61,109
40693,FremontBridge,05/25/2017 01:00:00 PM,48,-122,51,53,104
40694,FremontBridge,05/25/2017 02:00:00 PM,48,-122,85,56,141
40695,FremontBridge,05/25/2017 03:00:00 PM,48,-122,105,63,168
40696,FremontBridge,05/25/2017 04:00:00 PM,48,-122,281,109,390
40697,FremontBridge,05/25/2017 05:00:00 PM,48,-122,607,185,792
40698,FremontBridge,05/25/2017 06:00:00 PM,48,-122,387,163,550
40699,FremontBridge,05/25/2017 07:00:00 PM,48,-122,168,103,271
40700,FremontBridge,05/25/2017 08:00:00 PM,48,-122,91,73,164
40701,FremontBridge,05/25/2017 09:00:00 PM,48,-122,45,52,97
40702,FremontBridge,05/25/2017 10:00:00 PM,48,-122,41,33,74
40703,FremontBridge,05/25/2017 11:00:00 PM,48,-122,9,12,21
40704,FremontBridge,05/26/2017 12:00:00 AM,48,-122,9,27,36
40705,FremontBridge,05/26/2017 01:00:00 AM,48,-122,9,2,11
40706,FremontBridge,05/26/2017 02:00:00 AM,48,-122,0,1,1
40707,FremontBridge,05/26/2017 03:00:00 AM,48,-122,1,3,4
40708,FremontBridge,05/26/2017 04:00:00 AM,48,-122,8,3,11
40709,FremontBridge,05/26/2017 05:00:00 AM,48,-122,22,36,58
40710,FremontBridge,05/26/2017 06:00:00 AM,48,-122,69,90,159
40711,FremontBridge,05/26/2017 07:00:00 AM,48,-122,150,264,414
40712,FremontBridge,05/26/2017 08:00:00 AM,48,-122,270,317,587
40713,FremontBridge,05/26/2017 09:00:00 AM,48,-122,135,146,281
40714,FremontBridge,05/26/2017 10:00:00 AM,48,-122,94,86,180
40715,FremontBridge,05/26/2017 11:00:00 AM,48,-122,60,67,127
40716,FremontBridge,05/26/2017 12:00:00 PM,48,-122,83,77,160
40717,FremontBridge,05/26/2017 01:00:00 PM,48,-122,97,65,162
40718,FremontBridge,05/26/2017 02:00:00 PM,48,-122,136,83,219
40719,FremontBridge,05/26/2017 03:00:00 PM,48,-122,195,123,318
40720,FremontBridge,05/26/2017 04:00:00 PM,48,-122,361,123,484
40721,FremontBridge,05/26/2017 05:00:00 PM,48,-122,364,144,508
40722,FremontBridge,05/26/2017 06:00:00 PM,48,-122,255,123,378
40723,FremontBridge,05/26/2017 07:00:00 PM,48,-122,108,57,165
40724,FremontBridge,05/26/2017 08:00:00 PM,48,-122,61,54,115
40725,FremontBridge,05/26/2017 09:00:00 PM,48,-122,52,40,92
40726,FremontBridge,05/26/2017 10:00:00 PM,48,-122,20,16,36
40727,FremontBridge,05/26/2017 11:00:00 PM,48,-122,21,16,37
40728,FremontBridge,05/27/2017 12:00:00 AM,48,-122,9,16,25
40729,FremontBridge,05/27/2017 01:00:00 AM,48,-122,9,2,11
40730,FremontBridge,05/27/2017 02:00:00 AM,48,-122,6,2,8
40731,FremontBridge,05/27/2017 03:00:00 AM,48,-122,2,2,4
40732,FremontBridge,05/27/2017 04:00:00 AM,48,-122,4,2,6
40733,FremontBridge,05/27/2017 05:00:00 AM,48,-122,4,7,11
40734,FremontBridge,05/27/2017 06:00:00 AM,48,-122,17,20,37
40735,FremontBridge,05/27/2017 07:00:00 AM,48,-122,32,33,65
40736,FremontBridge,05/27/2017 08:00:00 AM,48,-122,59,51,110
40737,FremontBridge,05/27/2017 09:00:00 AM,48,-122,77,78,155
40738,FremontBridge,05/27/2017 10:00:00 AM,48,-122,62,91,153
40739,FremontBridge,05/27/2017 11:00:00 AM,48,-122,95,109,204
40740,FremontBridge,05/27/2017 12:00:00 PM,48,-122,75,97,172
40741,FremontBridge,05/27/2017 01:00:00 PM,48,-122,98,94,192
40742,FremontBridge,05/27/2017 02:00:00 PM,48,-122,101,103,204
40743,FremontBridge,05/27/2017 03:00:00 PM,48,-122,97,84,181
40744,FremontBridge,05/27/2017 04:00:00 PM,48,-122,102,106,208
40745,FremontBridge,05/27/2017 05:00:00 PM,48,-122,90,72,162
40746,FremontBridge,05/27/2017 06:00:00 PM,48,-122,83,70,153
40747,FremontBridge,05/27/2017 07:00:00 PM,48,-122,73,40,113
40748,FremontBridge,05/27/2017 08:00:00 PM,48,-122,47,27,74
40749,FremontBridge,05/27/2017 09:00:00 PM,48,-122,39,21,60
40750,FremontBridge,05/27/2017 10:00:00 PM,48,-122,29,18,47
40751,FremontBridge,05/27/2017 11:00:00 PM,48,-122,32,18,50
40752,FremontBridge,05/28/2017 12:00:00 AM,48,-122,19,9,28
40753,FremontBridge,05/28/2017 01:00:00 AM,48,-122,6,2,8
40754,FremontBridge,05/28/2017 02:00:00 AM,48,-122,5,3,8
40755,FremontBridge,05/28/2017 03:00:00 AM,48,-122,2,0,2
40756,FremontBridge,05/28/2017 04:00:00 AM,48,-122,3,7,10
40757,FremontBridge,05/28/2017 05:00:00 AM,48,-122,31,68,99
40758,FremontBridge,05/28/2017 06:00:00 AM,48,-122,68,103,171
40759,FremontBridge,05/28/2017 07:00:00 AM,48,-122,24,29,53
40760,FremontBridge,05/28/2017 08:00:00 AM,48,-122,61,30,91
40761,FremontBridge,05/28/2017 09:00:00 AM,48,-122,93,64,157
40762,FremontBridge,05/28/2017 10:00:00 AM,48,-122,132,89,221
40763,FremontBridge,05/28/2017 11:00:00 AM,48,-122,117,86,203
40764,FremontBridge,05/28/2017 12:00:00 PM,48,-122,146,127,273
40765,FremontBridge,05/28/2017 01:00:00 PM,48,-122,130,96,226
40766,FremontBridge,05/28/2017 02:00:00 PM,48,-122,117,81,198
40767,FremontBridge,05/28/2017 03:00:00 PM,48,-122,95,89,184
40768,FremontBridge,05/28/2017 04:00:00 PM,48,-122,82,97,179
40769,FremontBridge,05/28/2017 05:00:00 PM,48,-122,73,61,134
40770,FremontBridge,05/28/2017 06:00:00 PM,48,-122,80,54,134
40771,FremontBridge,05/28/2017 07:00:00 PM,48,-122,59,45,104
40772,FremontBridge,05/28/2017 08:00:00 PM,48,-122,58,32,90
40773,FremontBridge,05/28/2017 09:00:00 PM,48,-122,27,18,45
40774,FremontBridge,05/28/2017 10:00:00 PM,48,-122,25,12,37
40775,FremontBridge,05/28/2017 11:00:00 PM,48,-122,10,6,16
40776,FremontBridge,05/29/2017 12:00:00 AM,48,-122,10,2,12
40777,FremontBridge,05/29/2017 01:00:00 AM,48,-122,3,0,3
40778,FremontBridge,05/29/2017 02:00:00 AM,48,-122,0,1,1
40779,FremontBridge,05/29/2017 03:00:00 AM,48,-122,0,1,1
40780,FremontBridge,05/29/2017 04:00:00 AM,48,-122,2,1,3
40781,FremontBridge,05/29/2017 05:00:00 AM,48,-122,3,12,15
40782,FremontBridge,05/29/2017 06:00:00 AM,48,-122,14,15,29
40783,FremontBridge,05/29/2017 07:00:00 AM,48,-122,16,24,40
40784,FremontBridge,05/29/2017 08:00:00 AM,48,-122,42,41,83
40785,FremontBridge,05/29/2017 09:00:00 AM,48,-122,57,63,120
40786,FremontBridge,05/29/2017 10:00:00 AM,48,-122,82,65,147
40787,FremontBridge,05/29/2017 11:00:00 AM,48,-122,71,76,147
40788,FremontBridge,05/29/2017 12:00:00 PM,48,-122,103,85,188
40789,FremontBridge,05/29/2017 01:00:00 PM,48,-122,142,113,255
40790,FremontBridge,05/29/2017 02:00:00 PM,48,-122,105,112,217
40791,FremontBridge,05/29/2017 03:00:00 PM,48,-122,116,120,236
40792,FremontBridge,05/29/2017 04:00:00 PM,48,-122,118,91,209
40793,FremontBridge,05/29/2017 05:00:00 PM,48,-122,137,100,237
40794,FremontBridge,05/29/2017 06:00:00 PM,48,-122,68,80,148
40795,FremontBridge,05/29/2017 07:00:00 PM,48,-122,70,56,126
40796,FremontBridge,05/29/2017 08:00:00 PM,48,-122,50,40,90
40797,FremontBridge,05/29/2017 09:00:00 PM,48,-122,30,18,48
40798,FremontBridge,05/29/2017 10:00:00 PM,48,-122,14,12,26
40799,FremontBridge,05/29/2017 11:00:00 PM,48,-122,7,8,15
40800,FremontBridge,05/30/2017 12:00:00 AM,48,-122,7,3,10
40801,FremontBridge,05/30/2017 01:00:00 AM,48,-122,0,0,0
40802,FremontBridge,05/30/2017 02:00:00 AM,48,-122,2,0,2
40803,FremontBridge,05/30/2017 03:00:00 AM,48,-122,1,1,2
40804,FremontBridge,05/30/2017 04:00:00 AM,48,-122,4,3,7
40805,FremontBridge,05/30/2017 05:00:00 AM,48,-122,11,28,39
40806,FremontBridge,05/30/2017 06:00:00 AM,48,-122,64,94,158
40807,FremontBridge,05/30/2017 07:00:00 AM,48,-122,164,223,387
40808,FremontBridge,05/30/2017 08:00:00 AM,48,-122,237,316,553
40809,FremontBridge,05/30/2017 09:00:00 AM,48,-122,124,138,262
40810,FremontBridge,05/30/2017 10:00:00 AM,48,-122,39,46,85
40811,FremontBridge,05/30/2017 11:00:00 AM,48,-122,32,30,62
40812,FremontBridge,05/30/2017 12:00:00 PM,48,-122,27,37,64
40813,FremontBridge,05/30/2017 01:00:00 PM,48,-122,35,28,63
40814,FremontBridge,05/30/2017 02:00:00 PM,48,-122,43,18,61
40815,FremontBridge,05/30/2017 03:00:00 PM,48,-122,72,51,123
40816,FremontBridge,05/30/2017 04:00:00 PM,48,-122,204,65,269
40817,FremontBridge,05/30/2017 05:00:00 PM,48,-122,493,128,621
40818,FremontBridge,05/30/2017 06:00:00 PM,48,-122,266,128,394
40819,FremontBridge,05/30/2017 07:00:00 PM,48,-122,108,52,160
40820,FremontBridge,05/30/2017 08:00:00 PM,48,-122,60,36,96
40821,FremontBridge,05/30/2017 09:00:00 PM,48,-122,27,15,42
40822,FremontBridge,05/30/2017 10:00:00 PM,48,-122,15,11,26
40823,FremontBridge,05/30/2017 11:00:00 PM,48,-122,3,2,5
40824,FremontBridge,05/31/2017 12:00:00 AM,48,-122,3,3,6
40825,FremontBridge,05/31/2017 01:00:00 AM,48,-122,1,1,2
40826,FremontBridge,05/31/2017 02:00:00 AM,48,-122,1,0,1
40827,FremontBridge,05/31/2017 03:00:00 AM,48,-122,1,0,1
40828,FremontBridge,05/31/2017 04:00:00 AM,48,-122,3,5,8
40829,FremontBridge,05/31/2017 05:00:00 AM,48,-122,15,30,45
40830,FremontBridge,05/31/2017 06:00:00 AM,48,-122,79,122,201
40831,FremontBridge,05/31/2017 07:00:00 AM,48,-122,195,293,488
40832,FremontBridge,05/31/2017 08:00:00 AM,48,-122,267,325,592
40833,FremontBridge,05/31/2017 09:00:00 AM,48,-122,142,154,296
40834,FremontBridge,05/31/2017 10:00:00 AM,48,-122,53,58,111
40835,FremontBridge,05/31/2017 11:00:00 AM,48,-122,51,51,102
40836,FremontBridge,05/31/2017 12:00:00 PM,48,-122,40,48,88
40837,FremontBridge,05/31/2017 01:00:00 PM,48,-122,66,61,127
40838,FremontBridge,05/31/2017 02:00:00 PM,48,-122,74,45,119
40839,FremontBridge,05/31/2017 03:00:00 PM,48,-122,130,69,199
40840,FremontBridge,05/31/2017 04:00:00 PM,48,-122,263,106,369
40841,FremontBridge,05/31/2017 05:00:00 PM,48,-122,543,178,721
40842,FremontBridge,05/31/2017 06:00:00 PM,48,-122,345,156,501
40843,FremontBridge,05/31/2017 07:00:00 PM,48,-122,129,83,212
40844,FremontBridge,05/31/2017 08:00:00 PM,48,-122,83,57,140
40845,FremontBridge,05/31/2017 09:00:00 PM,48,-122,40,27,67
40846,FremontBridge,05/31/2017 10:00:00 PM,48,-122,23,26,49
40847,FremontBridge,05/31/2017 11:00:00 PM,48,-122,16,32,48
40848,FremontBridge,06/01/2017 12:00:00 AM,48,-122,10,17,27
40849,FremontBridge,06/01/2017 01:00:00 AM,48,-122,2,5,7
40850,FremontBridge,06/01/2017 02:00:00 AM,48,-122,2,3,5
40851,FremontBridge,06/01/2017 03:00:00 AM,48,-122,1,2,3
40852,FremontBridge,06/01/2017 04:00:00 AM,48,-122,6,9,15
40853,FremontBridge,06/01/2017 05:00:00 AM,48,-122,34,51,85
40854,FremontBridge,06/01/2017 06:00:00 AM,48,-122,96,162,258
40855,FremontBridge,06/01/2017 07:00:00 AM,48,-122,222,375,597
40856,FremontBridge,06/01/2017 08:00:00 AM,48,-122,257,467,724
40857,FremontBridge,06/01/2017 09:00:00 AM,48,-122,131,257,388
40858,FremontBridge,06/01/2017 10:00:00 AM,48,-122,55,103,158
40859,FremontBridge,06/01/2017 11:00:00 AM,48,-122,37,77,114
40860,FremontBridge,06/01/2017 12:00:00 PM,48,-122,25,59,84
40861,FremontBridge,06/01/2017 01:00:00 PM,48,-122,46,102,148
40862,FremontBridge,06/01/2017 02:00:00 PM,48,-122,51,110,161
40863,FremontBridge,06/01/2017 03:00:00 PM,48,-122,65,148,213
40864,FremontBridge,06/01/2017 04:00:00 PM,48,-122,94,351,445
40865,FremontBridge,06/01/2017 05:00:00 PM,48,-122,164,630,794
40866,FremontBridge,06/01/2017 06:00:00 PM,48,-122,128,416,544
40867,FremontBridge,06/01/2017 07:00:00 PM,48,-122,75,204,279
40868,FremontBridge,06/01/2017 08:00:00 PM,48,-122,60,142,202
40869,FremontBridge,06/01/2017 09:00:00 PM,48,-122,42,91,133
40870,FremontBridge,06/01/2017 10:00:00 PM,48,-122,28,49,77
40871,FremontBridge,06/01/2017 11:00:00 PM,48,-122,10,16,26
40872,FremontBridge,06/02/2017 12:00:00 AM,48,-122,5,13,18
40873,FremontBridge,06/02/2017 01:00:00 AM,48,-122,3,4,7
40874,FremontBridge,06/02/2017 02:00:00 AM,48,-122,2,6,8
40875,FremontBridge,06/02/2017 03:00:00 AM,48,-122,4,7,11
40876,FremontBridge,06/02/2017 04:00:00 AM,48,-122,0,4,4
40877,FremontBridge,06/02/2017 05:00:00 AM,48,-122,40,50,90
40878,FremontBridge,06/02/2017 06:00:00 AM,48,-122,98,161,259
40879,FremontBridge,06/02/2017 07:00:00 AM,48,-122,217,352,569
40880,FremontBridge,06/02/2017 08:00:00 AM,48,-122,296,522,818
40881,FremontBridge,06/02/2017 09:00:00 AM,48,-122,141,275,416
40882,FremontBridge,06/02/2017 10:00:00 AM,48,-122,63,120,183
40883,FremontBridge,06/02/2017 11:00:00 AM,48,-122,48,96,144
40884,FremontBridge,06/02/2017 12:00:00 PM,48,-122,45,101,146
40885,FremontBridge,06/02/2017 01:00:00 PM,48,-122,47,117,164
40886,FremontBridge,06/02/2017 02:00:00 PM,48,-122,67,143,210
40887,FremontBridge,06/02/2017 03:00:00 PM,48,-122,71,205,276
40888,FremontBridge,06/02/2017 04:00:00 PM,48,-122,113,402,515
40889,FremontBridge,06/02/2017 05:00:00 PM,48,-122,151,610,761
40890,FremontBridge,06/02/2017 06:00:00 PM,48,-122,124,375,499
40891,FremontBridge,06/02/2017 07:00:00 PM,48,-122,84,197,281
40892,FremontBridge,06/02/2017 08:00:00 PM,48,-122,57,123,180
40893,FremontBridge,06/02/2017 09:00:00 PM,48,-122,29,84,113
40894,FremontBridge,06/02/2017 10:00:00 PM,48,-122,22,45,67
40895,FremontBridge,06/02/2017 11:00:00 PM,48,-122,11,28,39
40896,FremontBridge,06/03/2017 12:00:00 AM,48,-122,5,22,27
40897,FremontBridge,06/03/2017 01:00:00 AM,48,-122,1,7,8
40898,FremontBridge,06/03/2017 02:00:00 AM,48,-122,5,7,12
40899,FremontBridge,06/03/2017 03:00:00 AM,48,-122,0,0,0
40900,FremontBridge,06/03/2017 04:00:00 AM,48,-122,3,6,9
40901,FremontBridge,06/03/2017 05:00:00 AM,48,-122,8,12,20
40902,FremontBridge,06/03/2017 06:00:00 AM,48,-122,11,27,38
40903,FremontBridge,06/03/2017 07:00:00 AM,48,-122,23,49,72
40904,FremontBridge,06/03/2017 08:00:00 AM,48,-122,64,113,177
40905,FremontBridge,06/03/2017 09:00:00 AM,48,-122,59,94,153
40906,FremontBridge,06/03/2017 10:00:00 AM,48,-122,64,120,184
40907,FremontBridge,06/03/2017 11:00:00 AM,48,-122,78,154,232
40908,FremontBridge,06/03/2017 12:00:00 PM,48,-122,79,150,229
40909,FremontBridge,06/03/2017 01:00:00 PM,48,-122,71,141,212
40910,FremontBridge,06/03/2017 02:00:00 PM,48,-122,72,141,213
40911,FremontBridge,06/03/2017 03:00:00 PM,48,-122,85,163,248
40912,FremontBridge,06/03/2017 04:00:00 PM,48,-122,76,144,220
40913,FremontBridge,06/03/2017 05:00:00 PM,48,-122,78,157,235
40914,FremontBridge,06/03/2017 06:00:00 PM,48,-122,42,92,134
40915,FremontBridge,06/03/2017 07:00:00 PM,48,-122,45,85,130
40916,FremontBridge,06/03/2017 08:00:00 PM,48,-122,42,95,137
40917,FremontBridge,06/03/2017 09:00:00 PM,48,-122,19,43,62
40918,FremontBridge,06/03/2017 10:00:00 PM,48,-122,27,48,75
40919,FremontBridge,06/03/2017 11:00:00 PM,48,-122,11,21,32
40920,FremontBridge,06/04/2017 12:00:00 AM,48,-122,9,15,24
40921,FremontBridge,06/04/2017 01:00:00 AM,48,-122,2,4,6
40922,FremontBridge,06/04/2017 02:00:00 AM,48,-122,1,4,5
40923,FremontBridge,06/04/2017 03:00:00 AM,48,-122,6,8,14
40924,FremontBridge,06/04/2017 04:00:00 AM,48,-122,4,8,12
40925,FremontBridge,06/04/2017 05:00:00 AM,48,-122,4,7,11
40926,FremontBridge,06/04/2017 06:00:00 AM,48,-122,5,13,18
40927,FremontBridge,06/04/2017 07:00:00 AM,48,-122,29,51,80
40928,FremontBridge,06/04/2017 08:00:00 AM,48,-122,60,105,165
40929,FremontBridge,06/04/2017 09:00:00 AM,48,-122,70,134,204
40930,FremontBridge,06/04/2017 10:00:00 AM,48,-122,62,117,179
40931,FremontBridge,06/04/2017 11:00:00 AM,48,-122,74,148,222
40932,FremontBridge,06/04/2017 12:00:00 PM,48,-122,93,180,273
40933,FremontBridge,06/04/2017 01:00:00 PM,48,-122,104,210,314
40934,FremontBridge,06/04/2017 02:00:00 PM,48,-122,88,188,276
40935,FremontBridge,06/04/2017 03:00:00 PM,48,-122,73,176,249
40936,FremontBridge,06/04/2017 04:00:00 PM,48,-122,126,220,346
40937,FremontBridge,06/04/2017 05:00:00 PM,48,-122,61,146,207
40938,FremontBridge,06/04/2017 06:00:00 PM,48,-122,65,133,198
40939,FremontBridge,06/04/2017 07:00:00 PM,48,-122,37,71,108
40940,FremontBridge,06/04/2017 08:00:00 PM,48,-122,31,48,79
40941,FremontBridge,06/04/2017 09:00:00 PM,48,-122,10,28,38
40942,FremontBridge,06/04/2017 10:00:00 PM,48,-122,7,27,34
40943,FremontBridge,06/04/2017 11:00:00 PM,48,-122,3,9,12
40944,FremontBridge,06/05/2017 12:00:00 AM,48,-122,3,5,8
40945,FremontBridge,06/05/2017 01:00:00 AM,48,-122,3,4,7
40946,FremontBridge,06/05/2017 02:00:00 AM,48,-122,0,1,1
40947,FremontBridge,06/05/2017 03:00:00 AM,48,-122,1,2,3
40948,FremontBridge,06/05/2017 04:00:00 AM,48,-122,7,10,17
40949,FremontBridge,06/05/2017 05:00:00 AM,48,-122,39,55,94
40950,FremontBridge,06/05/2017 06:00:00 AM,48,-122,114,198,312
40951,FremontBridge,06/05/2017 07:00:00 AM,48,-122,282,460,742
40952,FremontBridge,06/05/2017 08:00:00 AM,48,-122,361,646,1007
40953,FremontBridge,06/05/2017 09:00:00 AM,48,-122,165,313,478
40954,FremontBridge,06/05/2017 10:00:00 AM,48,-122,64,117,181
40955,FremontBridge,06/05/2017 11:00:00 AM,48,-122,56,96,152
40956,FremontBridge,06/05/2017 12:00:00 PM,48,-122,47,87,134
40957,FremontBridge,06/05/2017 01:00:00 PM,48,-122,50,97,147
40958,FremontBridge,06/05/2017 02:00:00 PM,48,-122,56,109,165
40959,FremontBridge,06/05/2017 03:00:00 PM,48,-122,76,177,253
40960,FremontBridge,06/05/2017 04:00:00 PM,48,-122,116,400,516
40961,FremontBridge,06/05/2017 05:00:00 PM,48,-122,176,819,995
40962,FremontBridge,06/05/2017 06:00:00 PM,48,-122,136,497,633
40963,FremontBridge,06/05/2017 07:00:00 PM,48,-122,92,276,368
40964,FremontBridge,06/05/2017 08:00:00 PM,48,-122,56,137,193
40965,FremontBridge,06/05/2017 09:00:00 PM,48,-122,31,88,119
40966,FremontBridge,06/05/2017 10:00:00 PM,48,-122,15,32,47
40967,FremontBridge,06/05/2017 11:00:00 PM,48,-122,16,31,47
40968,FremontBridge,06/06/2017 12:00:00 AM,48,-122,3,11,14
40969,FremontBridge,06/06/2017 01:00:00 AM,48,-122,0,2,2
40970,FremontBridge,06/06/2017 02:00:00 AM,48,-122,0,2,2
40971,FremontBridge,06/06/2017 03:00:00 AM,48,-122,1,2,3
40972,FremontBridge,06/06/2017 04:00:00 AM,48,-122,10,14,24
40973,FremontBridge,06/06/2017 05:00:00 AM,48,-122,36,58,94
40974,FremontBridge,06/06/2017 06:00:00 AM,48,-122,133,218,351
40975,FremontBridge,06/06/2017 07:00:00 AM,48,-122,299,529,828
40976,FremontBridge,06/06/2017 08:00:00 AM,48,-122,418,747,1165
40977,FremontBridge,06/06/2017 09:00:00 AM,48,-122,160,327,487
40978,FremontBridge,06/06/2017 10:00:00 AM,48,-122,68,136,204
40979,FremontBridge,06/06/2017 11:00:00 AM,48,-122,58,121,179
40980,FremontBridge,06/06/2017 12:00:00 PM,48,-122,53,110,163
40981,FremontBridge,06/06/2017 01:00:00 PM,48,-122,73,128,201
40982,FremontBridge,06/06/2017 02:00:00 PM,48,-122,56,125,181
40983,FremontBridge,06/06/2017 03:00:00 PM,48,-122,87,198,285
40984,FremontBridge,06/06/2017 04:00:00 PM,48,-122,117,407,524
40985,FremontBridge,06/06/2017 05:00:00 PM,48,-122,209,854,1063
40986,FremontBridge,06/06/2017 06:00:00 PM,48,-122,151,506,657
40987,FremontBridge,06/06/2017 07:00:00 PM,48,-122,102,328,430
40988,FremontBridge,06/06/2017 08:00:00 PM,48,-122,67,160,227
40989,FremontBridge,06/06/2017 09:00:00 PM,48,-122,46,84,130
40990,FremontBridge,06/06/2017 10:00:00 PM,48,-122,18,52,70
40991,FremontBridge,06/06/2017 11:00:00 PM,48,-122,9,21,30
40992,FremontBridge,06/07/2017 12:00:00 AM,48,-122,5,10,15
40993,FremontBridge,06/07/2017 01:00:00 AM,48,-122,4,10,14
40994,FremontBridge,06/07/2017 02:00:00 AM,48,-122,3,5,8
40995,FremontBridge,06/07/2017 03:00:00 AM,48,-122,3,3,6
40996,FremontBridge,06/07/2017 04:00:00 AM,48,-122,5,9,14
40997,FremontBridge,06/07/2017 05:00:00 AM,48,-122,39,57,96
40998,FremontBridge,06/07/2017 06:00:00 AM,48,-122,116,199,315
40999,FremontBridge,06/07/2017 07:00:00 AM,48,-122,328,540,868
41000,FremontBridge,06/07/2017 08:00:00 AM,48,-122,411,704,1115
41001,FremontBridge,06/07/2017 09:00:00 AM,48,-122,190,350,540
41002,FremontBridge,06/07/2017 10:00:00 AM,48,-122,73,159,232
41003,FremontBridge,06/07/2017 11:00:00 AM,48,-122,51,106,157
41004,FremontBridge,06/07/2017 12:00:00 PM,48,-122,49,97,146
41005,FremontBridge,06/07/2017 01:00:00 PM,48,-122,51,108,159
41006,FremontBridge,06/07/2017 02:00:00 PM,48,-122,55,124,179
41007,FremontBridge,06/07/2017 03:00:00 PM,48,-122,92,194,286
41008,FremontBridge,06/07/2017 04:00:00 PM,48,-122,98,385,483
41009,FremontBridge,06/07/2017 05:00:00 PM,48,-122,181,822,1003
41010,FremontBridge,06/07/2017 06:00:00 PM,48,-122,177,510,687
41011,FremontBridge,06/07/2017 07:00:00 PM,48,-122,113,315,428
41012,FremontBridge,06/07/2017 08:00:00 PM,48,-122,85,172,257
41013,FremontBridge,06/07/2017 09:00:00 PM,48,-122,49,99,148
41014,FremontBridge,06/07/2017 10:00:00 PM,48,-122,37,70,107
41015,FremontBridge,06/07/2017 11:00:00 PM,48,-122,12,24,36
41016,FremontBridge,06/08/2017 12:00:00 AM,48,-122,6,12,18
41017,FremontBridge,06/08/2017 01:00:00 AM,48,-122,3,5,8
41018,FremontBridge,06/08/2017 02:00:00 AM,48,-122,0,0,0
41019,FremontBridge,06/08/2017 03:00:00 AM,48,-122,0,1,1
41020,FremontBridge,06/08/2017 04:00:00 AM,48,-122,3,6,9
41021,FremontBridge,06/08/2017 05:00:00 AM,48,-122,22,32,54
41022,FremontBridge,06/08/2017 06:00:00 AM,48,-122,53,93,146
41023,FremontBridge,06/08/2017 07:00:00 AM,48,-122,157,243,400
41024,FremontBridge,06/08/2017 08:00:00 AM,48,-122,173,300,473
41025,FremontBridge,06/08/2017 09:00:00 AM,48,-122,85,173,258
41026,FremontBridge,06/08/2017 10:00:00 AM,48,-122,35,65,100
41027,FremontBridge,06/08/2017 11:00:00 AM,48,-122,23,43,66
41028,FremontBridge,06/08/2017 12:00:00 PM,48,-122,21,37,58
41029,FremontBridge,06/08/2017 01:00:00 PM,48,-122,17,32,49
41030,FremontBridge,06/08/2017 02:00:00 PM,48,-122,18,50,68
41031,FremontBridge,06/08/2017 03:00:00 PM,48,-122,41,84,125
41032,FremontBridge,06/08/2017 04:00:00 PM,48,-122,61,203,264
41033,FremontBridge,06/08/2017 05:00:00 PM,48,-122,123,467,590
41034,FremontBridge,06/08/2017 06:00:00 PM,48,-122,74,279,353
41035,FremontBridge,06/08/2017 07:00:00 PM,48,-122,42,137,179
41036,FremontBridge,06/08/2017 08:00:00 PM,48,-122,45,103,148
41037,FremontBridge,06/08/2017 09:00:00 PM,48,-122,26,51,77
41038,FremontBridge,06/08/2017 10:00:00 PM,48,-122,19,44,63
41039,FremontBridge,06/08/2017 11:00:00 PM,48,-122,4,20,24
41040,FremontBridge,06/09/2017 12:00:00 AM,48,-122,4,11,15
41041,FremontBridge,06/09/2017 01:00:00 AM,48,-122,2,6,8
41042,FremontBridge,06/09/2017 02:00:00 AM,48,-122,0,0,0
41043,FremontBridge,06/09/2017 03:00:00 AM,48,-122,0,4,4
41044,FremontBridge,06/09/2017 04:00:00 AM,48,-122,3,5,8
41045,FremontBridge,06/09/2017 05:00:00 AM,48,-122,28,39,67
41046,FremontBridge,06/09/2017 06:00:00 AM,48,-122,61,117,178
41047,FremontBridge,06/09/2017 07:00:00 AM,48,-122,192,327,519
41048,FremontBridge,06/09/2017 08:00:00 AM,48,-122,279,493,772
41049,FremontBridge,06/09/2017 09:00:00 AM,48,-122,152,282,434
41050,FremontBridge,06/09/2017 10:00:00 AM,48,-122,61,115,176
41051,FremontBridge,06/09/2017 11:00:00 AM,48,-122,37,78,115
41052,FremontBridge,06/09/2017 12:00:00 PM,48,-122,36,75,111
41053,FremontBridge,06/09/2017 01:00:00 PM,48,-122,56,98,154
41054,FremontBridge,06/09/2017 02:00:00 PM,48,-122,30,79,109
41055,FremontBridge,06/09/2017 03:00:00 PM,48,-122,41,125,166
41056,FremontBridge,06/09/2017 04:00:00 PM,48,-122,83,349,432
41057,FremontBridge,06/09/2017 05:00:00 PM,48,-122,136,537,673
41058,FremontBridge,06/09/2017 06:00:00 PM,48,-122,76,293,369
41059,FremontBridge,06/09/2017 07:00:00 PM,48,-122,56,149,205
41060,FremontBridge,06/09/2017 08:00:00 PM,48,-122,22,69,91
41061,FremontBridge,06/09/2017 09:00:00 PM,48,-122,24,45,69
41062,FremontBridge,06/09/2017 10:00:00 PM,48,-122,9,33,42
41063,FremontBridge,06/09/2017 11:00:00 PM,48,-122,14,38,52
41064,FremontBridge,06/10/2017 12:00:00 AM,48,-122,9,18,27
41065,FremontBridge,06/10/2017 01:00:00 AM,48,-122,4,6,10
41066,FremontBridge,06/10/2017 02:00:00 AM,48,-122,4,10,14
41067,FremontBridge,06/10/2017 03:00:00 AM,48,-122,0,5,5
41068,FremontBridge,06/10/2017 04:00:00 AM,48,-122,2,6,8
41069,FremontBridge,06/10/2017 05:00:00 AM,48,-122,5,14,19
41070,FremontBridge,06/10/2017 06:00:00 AM,48,-122,13,26,39
41071,FremontBridge,06/10/2017 07:00:00 AM,48,-122,38,69,107
41072,FremontBridge,06/10/2017 08:00:00 AM,48,-122,51,99,150
41073,FremontBridge,06/10/2017 09:00:00 AM,48,-122,83,134,217
41074,FremontBridge,06/10/2017 10:00:00 AM,48,-122,78,143,221
41075,FremontBridge,06/10/2017 11:00:00 AM,48,-122,75,160,235
41076,FremontBridge,06/10/2017 12:00:00 PM,48,-122,84,185,269
41077,FremontBridge,06/10/2017 01:00:00 PM,48,-122,100,195,295
41078,FremontBridge,06/10/2017 02:00:00 PM,48,-122,126,237,363
41079,FremontBridge,06/10/2017 03:00:00 PM,48,-122,142,243,385
41080,FremontBridge,06/10/2017 04:00:00 PM,48,-122,148,230,378
41081,FremontBridge,06/10/2017 05:00:00 PM,48,-122,134,278,412
41082,FremontBridge,06/10/2017 06:00:00 PM,48,-122,108,214,322
41083,FremontBridge,06/10/2017 07:00:00 PM,48,-122,59,108,167
41084,FremontBridge,06/10/2017 08:00:00 PM,48,-122,50,102,152
41085,FremontBridge,06/10/2017 09:00:00 PM,48,-122,35,57,92
41086,FremontBridge,06/10/2017 10:00:00 PM,48,-122,23,48,71
41087,FremontBridge,06/10/2017 11:00:00 PM,48,-122,8,20,28
41088,FremontBridge,06/11/2017 12:00:00 AM,48,-122,7,31,38
41089,FremontBridge,06/11/2017 01:00:00 AM,48,-122,3,6,9
41090,FremontBridge,06/11/2017 02:00:00 AM,48,-122,2,2,4
41091,FremontBridge,06/11/2017 03:00:00 AM,48,-122,1,3,4
41092,FremontBridge,06/11/2017 04:00:00 AM,48,-122,2,2,4
41093,FremontBridge,06/11/2017 05:00:00 AM,48,-122,2,5,7
41094,FremontBridge,06/11/2017 06:00:00 AM,48,-122,12,22,34
41095,FremontBridge,06/11/2017 07:00:00 AM,48,-122,20,43,63
41096,FremontBridge,06/11/2017 08:00:00 AM,48,-122,44,66,110
41097,FremontBridge,06/11/2017 09:00:00 AM,48,-122,53,103,156
41098,FremontBridge,06/11/2017 10:00:00 AM,48,-122,60,124,184
41099,FremontBridge,06/11/2017 11:00:00 AM,48,-122,82,168,250
41100,FremontBridge,06/11/2017 12:00:00 PM,48,-122,84,165,249
41101,FremontBridge,06/11/2017 01:00:00 PM,48,-122,136,237,373
41102,FremontBridge,06/11/2017 02:00:00 PM,48,-122,101,208,309
41103,FremontBridge,06/11/2017 03:00:00 PM,48,-122,83,187,270
41104,FremontBridge,06/11/2017 04:00:00 PM,48,-122,87,181,268
41105,FremontBridge,06/11/2017 05:00:00 PM,48,-122,67,173,240
41106,FremontBridge,06/11/2017 06:00:00 PM,48,-122,65,122,187
41107,FremontBridge,06/11/2017 07:00:00 PM,48,-122,57,106,163
41108,FremontBridge,06/11/2017 08:00:00 PM,48,-122,34,74,108
41109,FremontBridge,06/11/2017 09:00:00 PM,48,-122,25,44,69
41110,FremontBridge,06/11/2017 10:00:00 PM,48,-122,10,29,39
41111,FremontBridge,06/11/2017 11:00:00 PM,48,-122,9,16,25
41112,FremontBridge,06/12/2017 12:00:00 AM,48,-122,1,2,3
41113,FremontBridge,06/12/2017 01:00:00 AM,48,-122,1,3,4
41114,FremontBridge,06/12/2017 02:00:00 AM,48,-122,2,3,5
41115,FremontBridge,06/12/2017 03:00:00 AM,48,-122,0,2,2
41116,FremontBridge,06/12/2017 04:00:00 AM,48,-122,7,10,17
41117,FremontBridge,06/12/2017 05:00:00 AM,48,-122,32,54,86
41118,FremontBridge,06/12/2017 06:00:00 AM,48,-122,108,175,283
41119,FremontBridge,06/12/2017 07:00:00 AM,48,-122,273,436,709
41120,FremontBridge,06/12/2017 08:00:00 AM,48,-122,330,594,924
41121,FremontBridge,06/12/2017 09:00:00 AM,48,-122,141,272,413
41122,FremontBridge,06/12/2017 10:00:00 AM,48,-122,79,139,218
41123,FremontBridge,06/12/2017 11:00:00 AM,48,-122,43,84,127
41124,FremontBridge,06/12/2017 12:00:00 PM,48,-122,37,74,111
41125,FremontBridge,06/12/2017 01:00:00 PM,48,-122,31,62,93
41126,FremontBridge,06/12/2017 02:00:00 PM,48,-122,34,88,122
41127,FremontBridge,06/12/2017 03:00:00 PM,48,-122,47,129,176
41128,FremontBridge,06/12/2017 04:00:00 PM,48,-122,81,320,401
41129,FremontBridge,06/12/2017 05:00:00 PM,48,-122,137,667,804
41130,FremontBridge,06/12/2017 06:00:00 PM,48,-122,122,462,584
41131,FremontBridge,06/12/2017 07:00:00 PM,48,-122,78,205,283
41132,FremontBridge,06/12/2017 08:00:00 PM,48,-122,51,109,160
41133,FremontBridge,06/12/2017 09:00:00 PM,48,-122,12,54,66
41134,FremontBridge,06/12/2017 10:00:00 PM,48,-122,25,42,67
41135,FremontBridge,06/12/2017 11:00:00 PM,48,-122,11,20,31
41136,FremontBridge,06/13/2017 12:00:00 AM,48,-122,1,6,7
41137,FremontBridge,06/13/2017 01:00:00 AM,48,-122,2,3,5
41138,FremontBridge,06/13/2017 02:00:00 AM,48,-122,0,2,2
41139,FremontBridge,06/13/2017 03:00:00 AM,48,-122,1,3,4
41140,FremontBridge,06/13/2017 04:00:00 AM,48,-122,5,9,14
41141,FremontBridge,06/13/2017 05:00:00 AM,48,-122,29,43,72
41142,FremontBridge,06/13/2017 06:00:00 AM,48,-122,85,149,234
41143,FremontBridge,06/13/2017 07:00:00 AM,48,-122,186,333,519
41144,FremontBridge,06/13/2017 08:00:00 AM,48,-122,279,501,780
41145,FremontBridge,06/13/2017 09:00:00 AM,48,-122,122,229,351
41146,FremontBridge,06/13/2017 10:00:00 AM,48,-122,50,103,153
41147,FremontBridge,06/13/2017 11:00:00 AM,48,-122,23,53,76
41148,FremontBridge,06/13/2017 12:00:00 PM,48,-122,32,67,99
41149,FremontBridge,06/13/2017 01:00:00 PM,48,-122,32,67,99
41150,FremontBridge,06/13/2017 02:00:00 PM,48,-122,35,90,125
41151,FremontBridge,06/13/2017 03:00:00 PM,48,-122,46,123,169
41152,FremontBridge,06/13/2017 04:00:00 PM,48,-122,95,278,373
41153,FremontBridge,06/13/2017 05:00:00 PM,48,-122,124,568,692
41154,FremontBridge,06/13/2017 06:00:00 PM,48,-122,106,382,488
41155,FremontBridge,06/13/2017 07:00:00 PM,48,-122,71,208,279
41156,FremontBridge,06/13/2017 08:00:00 PM,48,-122,33,98,131
41157,FremontBridge,06/13/2017 09:00:00 PM,48,-122,25,57,82
41158,FremontBridge,06/13/2017 10:00:00 PM,48,-122,11,37,48
41159,FremontBridge,06/13/2017 11:00:00 PM,48,-122,5,18,23
41160,FremontBridge,06/14/2017 12:00:00 AM,48,-122,3,8,11
41161,FremontBridge,06/14/2017 01:00:00 AM,48,-122,1,2,3
41162,FremontBridge,06/14/2017 02:00:00 AM,48,-122,2,3,5
41163,FremontBridge,06/14/2017 03:00:00 AM,48,-122,2,2,4
41164,FremontBridge,06/14/2017 04:00:00 AM,48,-122,6,10,16
41165,FremontBridge,06/14/2017 05:00:00 AM,48,-122,36,55,91
41166,FremontBridge,06/14/2017 06:00:00 AM,48,-122,111,186,297
41167,FremontBridge,06/14/2017 07:00:00 AM,48,-122,286,487,773
41168,FremontBridge,06/14/2017 08:00:00 AM,48,-122,318,545,863
41169,FremontBridge,06/14/2017 09:00:00 AM,48,-122,131,293,424
41170,FremontBridge,06/14/2017 10:00:00 AM,48,-122,57,137,194
41171,FremontBridge,06/14/2017 11:00:00 AM,48,-122,39,87,126
41172,FremontBridge,06/14/2017 12:00:00 PM,48,-122,47,92,139
41173,FremontBridge,06/14/2017 01:00:00 PM,48,-122,48,98,146
41174,FremontBridge,06/14/2017 02:00:00 PM,48,-122,48,124,172
41175,FremontBridge,06/14/2017 03:00:00 PM,48,-122,65,168,233
41176,FremontBridge,06/14/2017 04:00:00 PM,48,-122,88,318,406
41177,FremontBridge,06/14/2017 05:00:00 PM,48,-122,184,754,938
41178,FremontBridge,06/14/2017 06:00:00 PM,48,-122,143,463,606
41179,FremontBridge,06/14/2017 07:00:00 PM,48,-122,88,256,344
41180,FremontBridge,06/14/2017 08:00:00 PM,48,-122,74,161,235
41181,FremontBridge,06/14/2017 09:00:00 PM,48,-122,32,80,112
41182,FremontBridge,06/14/2017 10:00:00 PM,48,-122,15,41,56
41183,FremontBridge,06/14/2017 11:00:00 PM,48,-122,18,29,47
41184,FremontBridge,06/15/2017 12:00:00 AM,48,-122,1,6,7
41185,FremontBridge,06/15/2017 01:00:00 AM,48,-122,1,5,6
41186,FremontBridge,06/15/2017 02:00:00 AM,48,-122,0,0,0
41187,FremontBridge,06/15/2017 03:00:00 AM,48,-122,3,4,7
41188,FremontBridge,06/15/2017 04:00:00 AM,48,-122,3,5,8
41189,FremontBridge,06/15/2017 05:00:00 AM,48,-122,26,39,65
41190,FremontBridge,06/15/2017 06:00:00 AM,48,-122,55,97,152
41191,FremontBridge,06/15/2017 07:00:00 AM,48,-122,128,241,369
41192,FremontBridge,06/15/2017 08:00:00 AM,48,-122,237,410,647
41193,FremontBridge,06/15/2017 09:00:00 AM,48,-122,100,180,280
41194,FremontBridge,06/15/2017 10:00:00 AM,48,-122,28,53,81
41195,FremontBridge,06/15/2017 11:00:00 AM,48,-122,16,37,53
41196,FremontBridge,06/15/2017 12:00:00 PM,48,-122,11,23,34
41197,FremontBridge,06/15/2017 01:00:00 PM,48,-122,8,24,32
41198,FremontBridge,06/15/2017 02:00:00 PM,48,-122,12,29,41
41199,FremontBridge,06/15/2017 03:00:00 PM,48,-122,19,65,84
41200,FremontBridge,06/15/2017 04:00:00 PM,48,-122,49,169,218
41201,FremontBridge,06/15/2017 05:00:00 PM,48,-122,78,358,436
41202,FremontBridge,06/15/2017 06:00:00 PM,48,-122,78,254,332
41203,FremontBridge,06/15/2017 07:00:00 PM,48,-122,25,93,118
41204,FremontBridge,06/15/2017 08:00:00 PM,48,-122,12,45,57
41205,FremontBridge,06/15/2017 09:00:00 PM,48,-122,7,24,31
41206,FremontBridge,06/15/2017 10:00:00 PM,48,-122,7,20,27
41207,FremontBridge,06/15/2017 11:00:00 PM,48,-122,1,5,6
41208,FremontBridge,06/16/2017 12:00:00 AM,48,-122,3,4,7
41209,FremontBridge,06/16/2017 01:00:00 AM,48,-122,0,1,1
41210,FremontBridge,06/16/2017 02:00:00 AM,48,-122,0,2,2
41211,FremontBridge,06/16/2017 03:00:00 AM,48,-122,0,2,2
41212,FremontBridge,06/16/2017 04:00:00 AM,48,-122,2,3,5
41213,FremontBridge,06/16/2017 05:00:00 AM,48,-122,26,39,65
41214,FremontBridge,06/16/2017 06:00:00 AM,48,-122,73,120,193
41215,FremontBridge,06/16/2017 07:00:00 AM,48,-122,201,338,539
41216,FremontBridge,06/16/2017 08:00:00 AM,48,-122,256,446,702
41217,FremontBridge,06/16/2017 09:00:00 AM,48,-122,126,243,369
41218,FremontBridge,06/16/2017 10:00:00 AM,48,-122,63,110,173
41219,FremontBridge,06/16/2017 11:00:00 AM,48,-122,41,97,138
41220,FremontBridge,06/16/2017 12:00:00 PM,48,-122,51,93,144
41221,FremontBridge,06/16/2017 01:00:00 PM,48,-122,62,123,185
41222,FremontBridge,06/16/2017 02:00:00 PM,48,-122,49,139,188
41223,FremontBridge,06/16/2017 03:00:00 PM,48,-122,70,181,251
41224,FremontBridge,06/16/2017 04:00:00 PM,48,-122,108,374,482
41225,FremontBridge,06/16/2017 05:00:00 PM,48,-122,135,526,661
41226,FremontBridge,06/16/2017 06:00:00 PM,48,-122,113,384,497
41227,FremontBridge,06/16/2017 07:00:00 PM,48,-122,71,172,243
41228,FremontBridge,06/16/2017 08:00:00 PM,48,-122,46,116,162
41229,FremontBridge,06/16/2017 09:00:00 PM,48,-122,30,70,100
41230,FremontBridge,06/16/2017 10:00:00 PM,48,-122,16,42,58
41231,FremontBridge,06/16/2017 11:00:00 PM,48,-122,25,40,65
41232,FremontBridge,06/17/2017 12:00:00 AM,48,-122,7,25,32
41233,FremontBridge,06/17/2017 01:00:00 AM,48,-122,6,9,15
41234,FremontBridge,06/17/2017 02:00:00 AM,48,-122,7,10,17
41235,FremontBridge,06/17/2017 03:00:00 AM,48,-122,1,2,3
41236,FremontBridge,06/17/2017 04:00:00 AM,48,-122,0,1,1
41237,FremontBridge,06/17/2017 05:00:00 AM,48,-122,9,14,23
41238,FremontBridge,06/17/2017 06:00:00 AM,48,-122,15,32,47
41239,FremontBridge,06/17/2017 07:00:00 AM,48,-122,26,60,86
41240,FremontBridge,06/17/2017 08:00:00 AM,48,-122,52,101,153
41241,FremontBridge,06/17/2017 09:00:00 AM,48,-122,77,159,236
41242,FremontBridge,06/17/2017 10:00:00 AM,48,-122,74,182,256
41243,FremontBridge,06/17/2017 11:00:00 AM,48,-122,91,213,304
41244,FremontBridge,06/17/2017 12:00:00 PM,48,-122,22,48,70
41245,FremontBridge,06/17/2017 01:00:00 PM,48,-122,16,30,46
41246,FremontBridge,06/17/2017 02:00:00 PM,48,-122,52,91,143
41247,FremontBridge,06/17/2017 03:00:00 PM,48,-122,53,108,161
41248,FremontBridge,06/17/2017 04:00:00 PM,48,-122,63,160,223
41249,FremontBridge,06/17/2017 05:00:00 PM,48,-122,89,147,236
41250,FremontBridge,06/17/2017 06:00:00 PM,48,-122,33,85,118
41251,FremontBridge,06/17/2017 07:00:00 PM,48,-122,43,87,130
41252,FremontBridge,06/17/2017 08:00:00 PM,48,-122,19,48,67
41253,FremontBridge,06/17/2017 09:00:00 PM,48,-122,21,51,72
41254,FremontBridge,06/17/2017 10:00:00 PM,48,-122,16,30,46
41255,FremontBridge,06/17/2017 11:00:00 PM,48,-122,7,16,23
41256,FremontBridge,06/18/2017 12:00:00 AM,48,-122,11,22,33
41257,FremontBridge,06/18/2017 01:00:00 AM,48,-122,2,7,9
41258,FremontBridge,06/18/2017 02:00:00 AM,48,-122,3,6,9
41259,FremontBridge,06/18/2017 03:00:00 AM,48,-122,1,3,4
41260,FremontBridge,06/18/2017 04:00:00 AM,48,-122,5,5,10
41261,FremontBridge,06/18/2017 05:00:00 AM,48,-122,5,11,16
41262,FremontBridge,06/18/2017 06:00:00 AM,48,-122,15,25,40
41263,FremontBridge,06/18/2017 07:00:00 AM,48,-122,23,34,57
41264,FremontBridge,06/18/2017 08:00:00 AM,48,-122,35,72,107
41265,FremontBridge,06/18/2017 09:00:00 AM,48,-122,48,109,157
41266,FremontBridge,06/18/2017 10:00:00 AM,48,-122,48,103,151
41267,FremontBridge,06/18/2017 11:00:00 AM,48,-122,75,136,211
41268,FremontBridge,06/18/2017 12:00:00 PM,48,-122,55,130,185
41269,FremontBridge,06/18/2017 01:00:00 PM,48,-122,69,142,211
41270,FremontBridge,06/18/2017 02:00:00 PM,48,-122,81,164,245
41271,FremontBridge,06/18/2017 03:00:00 PM,48,-122,70,136,206
41272,FremontBridge,06/18/2017 04:00:00 PM,48,-122,58,110,168
41273,FremontBridge,06/18/2017 05:00:00 PM,48,-122,75,142,217
41274,FremontBridge,06/18/2017 06:00:00 PM,48,-122,51,93,144
41275,FremontBridge,06/18/2017 07:00:00 PM,48,-122,52,85,137
41276,FremontBridge,06/18/2017 08:00:00 PM,48,-122,22,51,73
41277,FremontBridge,06/18/2017 09:00:00 PM,48,-122,14,40,54
41278,FremontBridge,06/18/2017 10:00:00 PM,48,-122,12,26,38
41279,FremontBridge,06/18/2017 11:00:00 PM,48,-122,5,21,26
41280,FremontBridge,06/19/2017 12:00:00 AM,48,-122,2,3,5
41281,FremontBridge,06/19/2017 01:00:00 AM,48,-122,0,0,0
41282,FremontBridge,06/19/2017 02:00:00 AM,48,-122,0,1,1
41283,FremontBridge,06/19/2017 03:00:00 AM,48,-122,1,3,4
41284,FremontBridge,06/19/2017 04:00:00 AM,48,-122,3,7,10
41285,FremontBridge,06/19/2017 05:00:00 AM,48,-122,30,40,70
41286,FremontBridge,06/19/2017 06:00:00 AM,48,-122,101,159,260
41287,FremontBridge,06/19/2017 07:00:00 AM,48,-122,268,441,709
41288,FremontBridge,06/19/2017 08:00:00 AM,48,-122,327,608,935
41289,FremontBridge,06/19/2017 09:00:00 AM,48,-122,130,284,414
41290,FremontBridge,06/19/2017 10:00:00 AM,48,-122,49,111,160
41291,FremontBridge,06/19/2017 11:00:00 AM,48,-122,39,75,114
41292,FremontBridge,06/19/2017 12:00:00 PM,48,-122,47,92,139
41293,FremontBridge,06/19/2017 01:00:00 PM,48,-122,43,90,133
41294,FremontBridge,06/19/2017 02:00:00 PM,48,-122,46,98,144
41295,FremontBridge,06/19/2017 03:00:00 PM,48,-122,63,130,193
41296,FremontBridge,06/19/2017 04:00:00 PM,48,-122,87,349,436
41297,FremontBridge,06/19/2017 05:00:00 PM,48,-122,158,714,872
41298,FremontBridge,06/19/2017 06:00:00 PM,48,-122,139,488,627
41299,FremontBridge,06/19/2017 07:00:00 PM,48,-122,69,208,277
41300,FremontBridge,06/19/2017 08:00:00 PM,48,-122,63,161,224
41301,FremontBridge,06/19/2017 09:00:00 PM,48,-122,48,86,134
41302,FremontBridge,06/19/2017 10:00:00 PM,48,-122,13,49,62
41303,FremontBridge,06/19/2017 11:00:00 PM,48,-122,7,24,31
41304,FremontBridge,06/20/2017 12:00:00 AM,48,-122,7,12,19
41305,FremontBridge,06/20/2017 01:00:00 AM,48,-122,0,0,0
41306,FremontBridge,06/20/2017 02:00:00 AM,48,-122,1,3,4
41307,FremontBridge,06/20/2017 03:00:00 AM,48,-122,2,3,5
41308,FremontBridge,06/20/2017 04:00:00 AM,48,-122,8,12,20
41309,FremontBridge,06/20/2017 05:00:00 AM,48,-122,30,44,74
41310,FremontBridge,06/20/2017 06:00:00 AM,48,-122,101,161,262
41311,FremontBridge,06/20/2017 07:00:00 AM,48,-122,238,403,641
41312,FremontBridge,06/20/2017 08:00:00 AM,48,-122,282,501,783
41313,FremontBridge,06/20/2017 09:00:00 AM,48,-122,148,282,430
41314,FremontBridge,06/20/2017 10:00:00 AM,48,-122,47,100,147
41315,FremontBridge,06/20/2017 11:00:00 AM,48,-122,31,79,110
41316,FremontBridge,06/20/2017 12:00:00 PM,48,-122,33,74,107
41317,FremontBridge,06/20/2017 01:00:00 PM,48,-122,39,71,110
41318,FremontBridge,06/20/2017 02:00:00 PM,48,-122,22,76,98
41319,FremontBridge,06/20/2017 03:00:00 PM,48,-122,202,278,480
41320,FremontBridge,06/20/2017 04:00:00 PM,48,-122,87,315,402
41321,FremontBridge,06/20/2017 05:00:00 PM,48,-122,141,621,762
41322,FremontBridge,06/20/2017 06:00:00 PM,48,-122,114,433,547
41323,FremontBridge,06/20/2017 07:00:00 PM,48,-122,80,240,320
41324,FremontBridge,06/20/2017 08:00:00 PM,48,-122,54,117,171
41325,FremontBridge,06/20/2017 09:00:00 PM,48,-122,23,51,74
41326,FremontBridge,06/20/2017 10:00:00 PM,48,-122,20,36,56
41327,FremontBridge,06/20/2017 11:00:00 PM,48,-122,6,23,29
41328,FremontBridge,06/21/2017 12:00:00 AM,48,-122,2,5,7
41329,FremontBridge,06/21/2017 01:00:00 AM,48,-122,2,5,7
41330,FremontBridge,06/21/2017 02:00:00 AM,48,-122,2,3,5
41331,FremontBridge,06/21/2017 03:00:00 AM,48,-122,2,2,4
41332,FremontBridge,06/21/2017 04:00:00 AM,48,-122,2,4,6
41333,FremontBridge,06/21/2017 05:00:00 AM,48,-122,33,50,83
41334,FremontBridge,06/21/2017 06:00:00 AM,48,-122,101,188,289
41335,FremontBridge,06/21/2017 07:00:00 AM,48,-122,291,467,758
41336,FremontBridge,06/21/2017 08:00:00 AM,48,-122,337,609,946
41337,FremontBridge,06/21/2017 09:00:00 AM,48,-122,177,340,517
41338,FremontBridge,06/21/2017 10:00:00 AM,48,-122,60,118,178
41339,FremontBridge,06/21/2017 11:00:00 AM,48,-122,30,76,106
41340,FremontBridge,06/21/2017 12:00:00 PM,48,-122,48,101,149
41341,FremontBridge,06/21/2017 01:00:00 PM,48,-122,35,78,113
41342,FremontBridge,06/21/2017 02:00:00 PM,48,-122,54,122,176
41343,FremontBridge,06/21/2017 03:00:00 PM,48,-122,68,182,250
41344,FremontBridge,06/21/2017 04:00:00 PM,48,-122,103,393,496
41345,FremontBridge,06/21/2017 05:00:00 PM,48,-122,206,766,972
41346,FremontBridge,06/21/2017 06:00:00 PM,48,-122,134,483,617
41347,FremontBridge,06/21/2017 07:00:00 PM,48,-122,88,263,351
41348,FremontBridge,06/21/2017 08:00:00 PM,48,-122,69,179,248
41349,FremontBridge,06/21/2017 09:00:00 PM,48,-122,50,103,153
41350,FremontBridge,06/21/2017 10:00:00 PM,48,-122,31,81,112
41351,FremontBridge,06/21/2017 11:00:00 PM,48,-122,17,32,49
41352,FremontBridge,06/22/2017 12:00:00 AM,48,-122,4,10,14
41353,FremontBridge,06/22/2017 01:00:00 AM,48,-122,6,9,15
41354,FremontBridge,06/22/2017 02:00:00 AM,48,-122,0,3,3
41355,FremontBridge,06/22/2017 03:00:00 AM,48,-122,1,3,4
41356,FremontBridge,06/22/2017 04:00:00 AM,48,-122,6,11,17
41357,FremontBridge,06/22/2017 05:00:00 AM,48,-122,38,51,89
41358,FremontBridge,06/22/2017 06:00:00 AM,48,-122,139,230,369
41359,FremontBridge,06/22/2017 07:00:00 AM,48,-122,266,483,749
41360,FremontBridge,06/22/2017 08:00:00 AM,48,-122,344,628,972
41361,FremontBridge,06/22/2017 09:00:00 AM,48,-122,177,336,513
41362,FremontBridge,06/22/2017 10:00:00 AM,48,-122,71,149,220
41363,FremontBridge,06/22/2017 11:00:00 AM,48,-122,68,122,190
41364,FremontBridge,06/22/2017 12:00:00 PM,48,-122,53,113,166
41365,FremontBridge,06/22/2017 01:00:00 PM,48,-122,54,99,153
41366,FremontBridge,06/22/2017 02:00:00 PM,48,-122,47,130,177
41367,FremontBridge,06/22/2017 03:00:00 PM,48,-122,81,200,281
41368,FremontBridge,06/22/2017 04:00:00 PM,48,-122,118,398,516
41369,FremontBridge,06/22/2017 05:00:00 PM,48,-122,178,743,921
41370,FremontBridge,06/22/2017 06:00:00 PM,48,-122,185,569,754
41371,FremontBridge,06/22/2017 07:00:00 PM,48,-122,100,304,404
41372,FremontBridge,06/22/2017 08:00:00 PM,48,-122,82,198,280
41373,FremontBridge,06/22/2017 09:00:00 PM,48,-122,43,102,145
41374,FremontBridge,06/22/2017 10:00:00 PM,48,-122,46,88,134
41375,FremontBridge,06/22/2017 11:00:00 PM,48,-122,14,32,46
41376,FremontBridge,06/23/2017 12:00:00 AM,48,-122,10,15,25
41377,FremontBridge,06/23/2017 01:00:00 AM,48,-122,0,6,6
41378,FremontBridge,06/23/2017 02:00:00 AM,48,-122,2,5,7
41379,FremontBridge,06/23/2017 03:00:00 AM,48,-122,2,3,5
41380,FremontBridge,06/23/2017 04:00:00 AM,48,-122,5,10,15
41381,FremontBridge,06/23/2017 05:00:00 AM,48,-122,28,40,68
41382,FremontBridge,06/23/2017 06:00:00 AM,48,-122,90,153,243
41383,FremontBridge,06/23/2017 07:00:00 AM,48,-122,215,394,609
41384,FremontBridge,06/23/2017 08:00:00 AM,48,-122,332,594,926
41385,FremontBridge,06/23/2017 09:00:00 AM,48,-122,161,297,458
41386,FremontBridge,06/23/2017 10:00:00 AM,48,-122,81,140,221
41387,FremontBridge,06/23/2017 11:00:00 AM,48,-122,56,120,176
41388,FremontBridge,06/23/2017 12:00:00 PM,48,-122,70,128,198
41389,FremontBridge,06/23/2017 01:00:00 PM,48,-122,57,131,188
41390,FremontBridge,06/23/2017 02:00:00 PM,48,-122,56,148,204
41391,FremontBridge,06/23/2017 03:00:00 PM,48,-122,103,253,356
41392,FremontBridge,06/23/2017 04:00:00 PM,48,-122,127,460,587
41393,FremontBridge,06/23/2017 05:00:00 PM,48,-122,170,621,791
41394,FremontBridge,06/23/2017 06:00:00 PM,48,-122,116,333,449
41395,FremontBridge,06/23/2017 07:00:00 PM,48,-122,57,182,239
41396,FremontBridge,06/23/2017 08:00:00 PM,48,-122,55,114,169
41397,FremontBridge,06/23/2017 09:00:00 PM,48,-122,29,74,103
41398,FremontBridge,06/23/2017 10:00:00 PM,48,-122,18,46,64
41399,FremontBridge,06/23/2017 11:00:00 PM,48,-122,15,36,51
41400,FremontBridge,06/24/2017 12:00:00 AM,48,-122,7,21,28
41401,FremontBridge,06/24/2017 01:00:00 AM,48,-122,2,10,12
41402,FremontBridge,06/24/2017 02:00:00 AM,48,-122,9,14,23
41403,FremontBridge,06/24/2017 03:00:00 AM,48,-122,3,4,7
41404,FremontBridge,06/24/2017 04:00:00 AM,48,-122,2,5,7
41405,FremontBridge,06/24/2017 05:00:00 AM,48,-122,11,17,28
41406,FremontBridge,06/24/2017 06:00:00 AM,48,-122,13,31,44
41407,FremontBridge,06/24/2017 07:00:00 AM,48,-122,41,88,129
41408,FremontBridge,06/24/2017 08:00:00 AM,48,-122,93,151,244
41409,FremontBridge,06/24/2017 09:00:00 AM,48,-122,101,177,278
41410,FremontBridge,06/24/2017 10:00:00 AM,48,-122,101,182,283
41411,FremontBridge,06/24/2017 11:00:00 AM,48,-122,113,207,320
41412,FremontBridge,06/24/2017 12:00:00 PM,48,-122,95,200,295
41413,FremontBridge,06/24/2017 01:00:00 PM,48,-122,88,173,261
41414,FremontBridge,06/24/2017 02:00:00 PM,48,-122,87,189,276
41415,FremontBridge,06/24/2017 03:00:00 PM,48,-122,80,202,282
41416,FremontBridge,06/24/2017 04:00:00 PM,48,-122,60,144,204
41417,FremontBridge,06/24/2017 05:00:00 PM,48,-122,67,142,209
41418,FremontBridge,06/24/2017 06:00:00 PM,48,-122,69,138,207
41419,FremontBridge,06/24/2017 07:00:00 PM,48,-122,41,101,142
41420,FremontBridge,06/24/2017 08:00:00 PM,48,-122,43,110,153
41421,FremontBridge,06/24/2017 09:00:00 PM,48,-122,27,69,96
41422,FremontBridge,06/24/2017 10:00:00 PM,48,-122,19,39,58
41423,FremontBridge,06/24/2017 11:00:00 PM,48,-122,11,32,43
41424,FremontBridge,06/25/2017 12:00:00 AM,48,-122,4,19,23
41425,FremontBridge,06/25/2017 01:00:00 AM,48,-122,3,10,13
41426,FremontBridge,06/25/2017 02:00:00 AM,48,-122,4,8,12
41427,FremontBridge,06/25/2017 03:00:00 AM,48,-122,1,3,4
41428,FremontBridge,06/25/2017 04:00:00 AM,48,-122,3,3,6
41429,FremontBridge,06/25/2017 05:00:00 AM,48,-122,9,12,21
41430,FremontBridge,06/25/2017 06:00:00 AM,48,-122,5,12,17
41431,FremontBridge,06/25/2017 07:00:00 AM,48,-122,39,73,112
41432,FremontBridge,06/25/2017 08:00:00 AM,48,-122,67,106,173
41433,FremontBridge,06/25/2017 09:00:00 AM,48,-122,74,146,220
41434,FremontBridge,06/25/2017 10:00:00 AM,48,-122,99,184,283
41435,FremontBridge,06/25/2017 11:00:00 AM,48,-122,114,212,326
41436,FremontBridge,06/25/2017 12:00:00 PM,48,-122,105,209,314
41437,FremontBridge,06/25/2017 01:00:00 PM,48,-122,71,166,237
41438,FremontBridge,06/25/2017 02:00:00 PM,48,-122,72,141,213
41439,FremontBridge,06/25/2017 03:00:00 PM,48,-122,83,145,228
41440,FremontBridge,06/25/2017 04:00:00 PM,48,-122,82,210,292
41441,FremontBridge,06/25/2017 05:00:00 PM,48,-122,70,122,192
41442,FremontBridge,06/25/2017 06:00:00 PM,48,-122,50,95,145
41443,FremontBridge,06/25/2017 07:00:00 PM,48,-122,43,113,156
41444,FremontBridge,06/25/2017 08:00:00 PM,48,-122,22,69,91
41445,FremontBridge,06/25/2017 09:00:00 PM,48,-122,32,59,91
41446,FremontBridge,06/25/2017 10:00:00 PM,48,-122,9,27,36
41447,FremontBridge,06/25/2017 11:00:00 PM,48,-122,9,20,29
41448,FremontBridge,06/26/2017 12:00:00 AM,48,-122,3,10,13
41449,FremontBridge,06/26/2017 01:00:00 AM,48,-122,2,4,6
41450,FremontBridge,06/26/2017 02:00:00 AM,48,-122,1,2,3
41451,FremontBridge,06/26/2017 03:00:00 AM,48,-122,0,2,2
41452,FremontBridge,06/26/2017 04:00:00 AM,48,-122,1,2,3
41453,FremontBridge,06/26/2017 05:00:00 AM,48,-122,33,48,81
41454,FremontBridge,06/26/2017 06:00:00 AM,48,-122,94,160,254
41455,FremontBridge,06/26/2017 07:00:00 AM,48,-122,299,492,791
41456,FremontBridge,06/26/2017 08:00:00 AM,48,-122,334,597,931
41457,FremontBridge,06/26/2017 09:00:00 AM,48,-122,153,317,470
41458,FremontBridge,06/26/2017 10:00:00 AM,48,-122,55,110,165
41459,FremontBridge,06/26/2017 11:00:00 AM,48,-122,40,81,121
41460,FremontBridge,06/26/2017 12:00:00 PM,48,-122,35,80,115
41461,FremontBridge,06/26/2017 01:00:00 PM,48,-122,46,81,127
41462,FremontBridge,06/26/2017 02:00:00 PM,48,-122,48,101,149
41463,FremontBridge,06/26/2017 03:00:00 PM,48,-122,61,162,223
41464,FremontBridge,06/26/2017 04:00:00 PM,48,-122,86,328,414
41465,FremontBridge,06/26/2017 05:00:00 PM,48,-122,170,729,899
41466,FremontBridge,06/26/2017 06:00:00 PM,48,-122,151,471,622
41467,FremontBridge,06/26/2017 07:00:00 PM,48,-122,105,292,397
41468,FremontBridge,06/26/2017 08:00:00 PM,48,-122,51,137,188
41469,FremontBridge,06/26/2017 09:00:00 PM,48,-122,43,97,140
41470,FremontBridge,06/26/2017 10:00:00 PM,48,-122,26,47,73
41471,FremontBridge,06/26/2017 11:00:00 PM,48,-122,10,20,30
41472,FremontBridge,06/27/2017 12:00:00 AM,48,-122,4,13,17
41473,FremontBridge,06/27/2017 01:00:00 AM,48,-122,6,7,13
41474,FremontBridge,06/27/2017 02:00:00 AM,48,-122,2,6,8
41475,FremontBridge,06/27/2017 03:00:00 AM,48,-122,1,3,4
41476,FremontBridge,06/27/2017 04:00:00 AM,48,-122,2,5,7
41477,FremontBridge,06/27/2017 05:00:00 AM,48,-122,35,52,87
41478,FremontBridge,06/27/2017 06:00:00 AM,48,-122,106,175,281
41479,FremontBridge,06/27/2017 07:00:00 AM,48,-122,292,515,807
41480,FremontBridge,06/27/2017 08:00:00 AM,48,-122,327,606,933
41481,FremontBridge,06/27/2017 09:00:00 AM,48,-122,171,338,509
41482,FremontBridge,06/27/2017 10:00:00 AM,48,-122,74,139,213
41483,FremontBridge,06/27/2017 11:00:00 AM,48,-122,43,88,131
41484,FremontBridge,06/27/2017 12:00:00 PM,48,-122,37,82,119
41485,FremontBridge,06/27/2017 01:00:00 PM,48,-122,49,94,143
41486,FremontBridge,06/27/2017 02:00:00 PM,48,-122,48,110,158
41487,FremontBridge,06/27/2017 03:00:00 PM,48,-122,69,157,226
41488,FremontBridge,06/27/2017 04:00:00 PM,48,-122,134,433,567
41489,FremontBridge,06/27/2017 05:00:00 PM,48,-122,199,771,970
41490,FremontBridge,06/27/2017 06:00:00 PM,48,-122,142,502,644
41491,FremontBridge,06/27/2017 07:00:00 PM,48,-122,95,267,362
41492,FremontBridge,06/27/2017 08:00:00 PM,48,-122,60,160,220
41493,FremontBridge,06/27/2017 09:00:00 PM,48,-122,48,98,146
41494,FremontBridge,06/27/2017 10:00:00 PM,48,-122,27,55,82
41495,FremontBridge,06/27/2017 11:00:00 PM,48,-122,10,26,36
41496,FremontBridge,06/28/2017 12:00:00 AM,48,-122,4,12,16
41497,FremontBridge,06/28/2017 01:00:00 AM,48,-122,2,5,7
41498,FremontBridge,06/28/2017 02:00:00 AM,48,-122,0,2,2
41499,FremontBridge,06/28/2017 03:00:00 AM,48,-122,1,3,4
41500,FremontBridge,06/28/2017 04:00:00 AM,48,-122,4,9,13
41501,FremontBridge,06/28/2017 05:00:00 AM,48,-122,41,57,98
41502,FremontBridge,06/28/2017 06:00:00 AM,48,-122,116,190,306
41503,FremontBridge,06/28/2017 07:00:00 AM,48,-122,275,473,748
41504,FremontBridge,06/28/2017 08:00:00 AM,48,-122,343,599,942
41505,FremontBridge,06/28/2017 09:00:00 AM,48,-122,144,304,448
41506,FremontBridge,06/28/2017 10:00:00 AM,48,-122,66,141,207
41507,FremontBridge,06/28/2017 11:00:00 AM,48,-122,35,92,127
41508,FremontBridge,06/28/2017 12:00:00 PM,48,-122,49,94,143
41509,FremontBridge,06/28/2017 01:00:00 PM,48,-122,41,85,126
41510,FremontBridge,06/28/2017 02:00:00 PM,48,-122,44,91,135
41511,FremontBridge,06/28/2017 03:00:00 PM,48,-122,64,151,215
41512,FremontBridge,06/28/2017 04:00:00 PM,48,-122,112,353,465
41513,FremontBridge,06/28/2017 05:00:00 PM,48,-122,163,707,870
41514,FremontBridge,06/28/2017 06:00:00 PM,48,-122,173,527,700
41515,FremontBridge,06/28/2017 07:00:00 PM,48,-122,100,290,390
41516,FremontBridge,06/28/2017 08:00:00 PM,48,-122,72,190,262
41517,FremontBridge,06/28/2017 09:00:00 PM,48,-122,53,114,167
41518,FremontBridge,06/28/2017 10:00:00 PM,48,-122,23,52,75
41519,FremontBridge,06/28/2017 11:00:00 PM,48,-122,7,18,25
41520,FremontBridge,06/29/2017 12:00:00 AM,48,-122,2,7,9
41521,FremontBridge,06/29/2017 01:00:00 AM,48,-122,1,1,2
41522,FremontBridge,06/29/2017 02:00:00 AM,48,-122,0,1,1
41523,FremontBridge,06/29/2017 03:00:00 AM,48,-122,1,2,3
41524,FremontBridge,06/29/2017 04:00:00 AM,48,-122,2,4,6
41525,FremontBridge,06/29/2017 05:00:00 AM,48,-122,36,53,89
41526,FremontBridge,06/29/2017 06:00:00 AM,48,-122,102,172,274
41527,FremontBridge,06/29/2017 07:00:00 AM,48,-122,250,430,680
41528,FremontBridge,06/29/2017 08:00:00 AM,48,-122,328,583,911
41529,FremontBridge,06/29/2017 09:00:00 AM,48,-122,185,358,543
41530,FremontBridge,06/29/2017 10:00:00 AM,48,-122,58,143,201
41531,FremontBridge,06/29/2017 11:00:00 AM,48,-122,43,104,147
41532,FremontBridge,06/29/2017 12:00:00 PM,48,-122,50,110,160
41533,FremontBridge,06/29/2017 01:00:00 PM,48,-122,63,140,203
41534,FremontBridge,06/29/2017 02:00:00 PM,48,-122,59,122,181
41535,FremontBridge,06/29/2017 03:00:00 PM,48,-122,94,221,315
41536,FremontBridge,06/29/2017 04:00:00 PM,48,-122,117,373,490
41537,FremontBridge,06/29/2017 05:00:00 PM,48,-122,173,749,922
41538,FremontBridge,06/29/2017 06:00:00 PM,48,-122,143,498,641
41539,FremontBridge,06/29/2017 07:00:00 PM,48,-122,96,285,381
41540,FremontBridge,06/29/2017 08:00:00 PM,48,-122,64,162,226
41541,FremontBridge,06/29/2017 09:00:00 PM,48,-122,72,136,208
41542,FremontBridge,06/29/2017 10:00:00 PM,48,-122,35,63,98
41543,FremontBridge,06/29/2017 11:00:00 PM,48,-122,14,26,40
41544,FremontBridge,06/30/2017 12:00:00 AM,48,-122,4,16,20
41545,FremontBridge,06/30/2017 01:00:00 AM,48,-122,7,14,21
41546,FremontBridge,06/30/2017 02:00:00 AM,48,-122,2,4,6
41547,FremontBridge,06/30/2017 03:00:00 AM,48,-122,0,2,2
41548,FremontBridge,06/30/2017 04:00:00 AM,48,-122,3,6,9
41549,FremontBridge,06/30/2017 05:00:00 AM,48,-122,31,47,78
41550,FremontBridge,06/30/2017 06:00:00 AM,48,-122,105,162,267
41551,FremontBridge,06/30/2017 07:00:00 AM,48,-122,218,378,596
41552,FremontBridge,06/30/2017 08:00:00 AM,48,-122,302,540,842
41553,FremontBridge,06/30/2017 09:00:00 AM,48,-122,135,295,430
41554,FremontBridge,06/30/2017 10:00:00 AM,48,-122,76,157,233
41555,FremontBridge,06/30/2017 11:00:00 AM,48,-122,74,135,209
41556,FremontBridge,06/30/2017 12:00:00 PM,48,-122,81,155,236
41557,FremontBridge,06/30/2017 01:00:00 PM,48,-122,46,124,170
41558,FremontBridge,06/30/2017 02:00:00 PM,48,-122,75,183,258
41559,FremontBridge,06/30/2017 03:00:00 PM,48,-122,79,253,332
41560,FremontBridge,06/30/2017 04:00:00 PM,48,-122,115,417,532
41561,FremontBridge,06/30/2017 05:00:00 PM,48,-122,151,591,742
41562,FremontBridge,06/30/2017 06:00:00 PM,48,-122,112,361,473
41563,FremontBridge,06/30/2017 07:00:00 PM,48,-122,82,225,307
41564,FremontBridge,06/30/2017 08:00:00 PM,48,-122,43,119,162
41565,FremontBridge,06/30/2017 09:00:00 PM,48,-122,38,87,125
41566,FremontBridge,06/30/2017 10:00:00 PM,48,-122,22,58,80
41567,FremontBridge,06/30/2017 11:00:00 PM,48,-122,13,36,49
41568,FremontBridge,07/01/2017 12:00:00 AM,48,-122,12,7,19
41569,FremontBridge,07/01/2017 01:00:00 AM,48,-122,5,3,8
41570,FremontBridge,07/01/2017 02:00:00 AM,48,-122,6,4,10
41571,FremontBridge,07/01/2017 03:00:00 AM,48,-122,2,3,5
41572,FremontBridge,07/01/2017 04:00:00 AM,48,-122,0,2,2
41573,FremontBridge,07/01/2017 05:00:00 AM,48,-122,4,11,15
41574,FremontBridge,07/01/2017 06:00:00 AM,48,-122,16,14,30
41575,FremontBridge,07/01/2017 07:00:00 AM,48,-122,34,30,64
41576,FremontBridge,07/01/2017 08:00:00 AM,48,-122,49,60,109
41577,FremontBridge,07/01/2017 09:00:00 AM,48,-122,47,68,115
41578,FremontBridge,07/01/2017 10:00:00 AM,48,-122,71,47,118
41579,FremontBridge,07/01/2017 11:00:00 AM,48,-122,72,87,159
41580,FremontBridge,07/01/2017 12:00:00 PM,48,-122,71,70,141
41581,FremontBridge,07/01/2017 01:00:00 PM,48,-122,86,82,168
41582,FremontBridge,07/01/2017 02:00:00 PM,48,-122,86,87,173
41583,FremontBridge,07/01/2017 03:00:00 PM,48,-122,104,85,189
41584,FremontBridge,07/01/2017 04:00:00 PM,48,-122,113,86,199
41585,FremontBridge,07/01/2017 05:00:00 PM,48,-122,106,85,191
41586,FremontBridge,07/01/2017 06:00:00 PM,48,-122,53,70,123
41587,FremontBridge,07/01/2017 07:00:00 PM,48,-122,53,44,97
41588,FremontBridge,07/01/2017 08:00:00 PM,48,-122,33,36,69
41589,FremontBridge,07/01/2017 09:00:00 PM,48,-122,41,30,71
41590,FremontBridge,07/01/2017 10:00:00 PM,48,-122,26,16,42
41591,FremontBridge,07/01/2017 11:00:00 PM,48,-122,27,14,41
41592,FremontBridge,07/02/2017 12:00:00 AM,48,-122,12,21,33
41593,FremontBridge,07/02/2017 01:00:00 AM,48,-122,5,0,5
41594,FremontBridge,07/02/2017 02:00:00 AM,48,-122,3,5,8
41595,FremontBridge,07/02/2017 03:00:00 AM,48,-122,1,1,2
41596,FremontBridge,07/02/2017 04:00:00 AM,48,-122,1,4,5
41597,FremontBridge,07/02/2017 05:00:00 AM,48,-122,5,3,8
41598,FremontBridge,07/02/2017 06:00:00 AM,48,-122,18,13,31
41599,FremontBridge,07/02/2017 07:00:00 AM,48,-122,16,13,29
41600,FremontBridge,07/02/2017 08:00:00 AM,48,-122,35,65,100
41601,FremontBridge,07/02/2017 09:00:00 AM,48,-122,66,53,119
41602,FremontBridge,07/02/2017 10:00:00 AM,48,-122,73,71,144
41603,FremontBridge,07/02/2017 11:00:00 AM,48,-122,65,73,138
41604,FremontBridge,07/02/2017 12:00:00 PM,48,-122,76,107,183
41605,FremontBridge,07/02/2017 01:00:00 PM,48,-122,119,110,229
41606,FremontBridge,07/02/2017 02:00:00 PM,48,-122,72,94,166
41607,FremontBridge,07/02/2017 03:00:00 PM,48,-122,112,132,244
41608,FremontBridge,07/02/2017 04:00:00 PM,48,-122,100,91,191
41609,FremontBridge,07/02/2017 05:00:00 PM,48,-122,105,76,181
41610,FremontBridge,07/02/2017 06:00:00 PM,48,-122,64,71,135
41611,FremontBridge,07/02/2017 07:00:00 PM,48,-122,71,59,130
41612,FremontBridge,07/02/2017 08:00:00 PM,48,-122,36,39,75
41613,FremontBridge,07/02/2017 09:00:00 PM,48,-122,18,25,43
41614,FremontBridge,07/02/2017 10:00:00 PM,48,-122,21,13,34
41615,FremontBridge,07/02/2017 11:00:00 PM,48,-122,14,8,22
41616,FremontBridge,07/03/2017 12:00:00 AM,48,-122,4,4,8
41617,FremontBridge,07/03/2017 01:00:00 AM,48,-122,4,2,6
41618,FremontBridge,07/03/2017 02:00:00 AM,48,-122,1,0,1
41619,FremontBridge,07/03/2017 03:00:00 AM,48,-122,2,2,4
41620,FremontBridge,07/03/2017 04:00:00 AM,48,-122,7,5,12
41621,FremontBridge,07/03/2017 05:00:00 AM,48,-122,9,29,38
41622,FremontBridge,07/03/2017 06:00:00 AM,48,-122,48,55,103
41623,FremontBridge,07/03/2017 07:00:00 AM,48,-122,86,128,214
41624,FremontBridge,07/03/2017 08:00:00 AM,48,-122,135,150,285
41625,FremontBridge,07/03/2017 09:00:00 AM,48,-122,103,96,199
41626,FremontBridge,07/03/2017 10:00:00 AM,48,-122,68,57,125
41627,FremontBridge,07/03/2017 11:00:00 AM,48,-122,71,35,106
41628,FremontBridge,07/03/2017 12:00:00 PM,48,-122,63,59,122
41629,FremontBridge,07/03/2017 01:00:00 PM,48,-122,62,53,115
41630,FremontBridge,07/03/2017 02:00:00 PM,48,-122,113,62,175
41631,FremontBridge,07/03/2017 03:00:00 PM,48,-122,169,76,245
41632,FremontBridge,07/03/2017 04:00:00 PM,48,-122,189,105,294
41633,FremontBridge,07/03/2017 05:00:00 PM,48,-122,251,123,374
41634,FremontBridge,07/03/2017 06:00:00 PM,48,-122,151,92,243
41635,FremontBridge,07/03/2017 07:00:00 PM,48,-122,105,69,174
41636,FremontBridge,07/03/2017 08:00:00 PM,48,-122,67,53,120
41637,FremontBridge,07/03/2017 09:00:00 PM,48,-122,35,30,65
41638,FremontBridge,07/03/2017 10:00:00 PM,48,-122,14,24,38
41639,FremontBridge,07/03/2017 11:00:00 PM,48,-122,15,19,34
41640,FremontBridge,07/04/2017 12:00:00 AM,48,-122,5,5,10
41641,FremontBridge,07/04/2017 01:00:00 AM,48,-122,2,9,11
41642,FremontBridge,07/04/2017 02:00:00 AM,48,-122,0,1,1
41643,FremontBridge,07/04/2017 03:00:00 AM,48,-122,2,1,3
41644,FremontBridge,07/04/2017 04:00:00 AM,48,-122,6,2,8
41645,FremontBridge,07/04/2017 05:00:00 AM,48,-122,1,11,12
41646,FremontBridge,07/04/2017 06:00:00 AM,48,-122,15,16,31
41647,FremontBridge,07/04/2017 07:00:00 AM,48,-122,31,33,64
41648,FremontBridge,07/04/2017 08:00:00 AM,48,-122,47,52,99
41649,FremontBridge,07/04/2017 09:00:00 AM,48,-122,82,116,198
41650,FremontBridge,07/04/2017 10:00:00 AM,48,-122,82,94,176
41651,FremontBridge,07/04/2017 11:00:00 AM,48,-122,87,120,207
41652,FremontBridge,07/04/2017 12:00:00 PM,48,-122,99,105,204
41653,FremontBridge,07/04/2017 01:00:00 PM,48,-122,121,103,224
41654,FremontBridge,07/04/2017 02:00:00 PM,48,-122,133,110,243
41655,FremontBridge,07/04/2017 03:00:00 PM,48,-122,126,95,221
41656,FremontBridge,07/04/2017 04:00:00 PM,48,-122,122,118,240
41657,FremontBridge,07/04/2017 05:00:00 PM,48,-122,124,89,213
41658,FremontBridge,07/04/2017 06:00:00 PM,48,-122,121,86,207
41659,FremontBridge,07/04/2017 07:00:00 PM,48,-122,83,90,173
41660,FremontBridge,07/04/2017 08:00:00 PM,48,-122,86,63,149
41661,FremontBridge,07/04/2017 09:00:00 PM,48,-122,60,86,146
41662,FremontBridge,07/04/2017 10:00:00 PM,48,-122,46,58,104
41663,FremontBridge,07/04/2017 11:00:00 PM,48,-122,110,45,155
41664,FremontBridge,07/05/2017 12:00:00 AM,48,-122,19,23,42
41665,FremontBridge,07/05/2017 01:00:00 AM,48,-122,12,10,22
41666,FremontBridge,07/05/2017 02:00:00 AM,48,-122,5,1,6
41667,FremontBridge,07/05/2017 03:00:00 AM,48,-122,0,3,3
41668,FremontBridge,07/05/2017 04:00:00 AM,48,-122,3,2,5
41669,FremontBridge,07/05/2017 05:00:00 AM,48,-122,16,27,43
41670,FremontBridge,07/05/2017 06:00:00 AM,48,-122,66,104,170
41671,FremontBridge,07/05/2017 07:00:00 AM,48,-122,160,231,391
41672,FremontBridge,07/05/2017 08:00:00 AM,48,-122,256,322,578
41673,FremontBridge,07/05/2017 09:00:00 AM,48,-122,166,155,321
41674,FremontBridge,07/05/2017 10:00:00 AM,48,-122,63,69,132
41675,FremontBridge,07/05/2017 11:00:00 AM,48,-122,57,42,99
41676,FremontBridge,07/05/2017 12:00:00 PM,48,-122,40,54,94
41677,FremontBridge,07/05/2017 01:00:00 PM,48,-122,63,57,120
41678,FremontBridge,07/05/2017 02:00:00 PM,48,-122,82,44,126
41679,FremontBridge,07/05/2017 03:00:00 PM,48,-122,93,54,147
41680,FremontBridge,07/05/2017 04:00:00 PM,48,-122,253,116,369
41681,FremontBridge,07/05/2017 05:00:00 PM,48,-122,548,161,709
41682,FremontBridge,07/05/2017 06:00:00 PM,48,-122,336,178,514
41683,FremontBridge,07/05/2017 07:00:00 PM,48,-122,193,89,282
41684,FremontBridge,07/05/2017 08:00:00 PM,48,-122,104,66,170
41685,FremontBridge,07/05/2017 09:00:00 PM,48,-122,55,39,94
41686,FremontBridge,07/05/2017 10:00:00 PM,48,-122,27,33,60
41687,FremontBridge,07/05/2017 11:00:00 PM,48,-122,20,8,28
41688,FremontBridge,07/06/2017 12:00:00 AM,48,-122,6,5,11
41689,FremontBridge,07/06/2017 01:00:00 AM,48,-122,6,1,7
41690,FremontBridge,07/06/2017 02:00:00 AM,48,-122,1,1,2
41691,FremontBridge,07/06/2017 03:00:00 AM,48,-122,2,1,3
41692,FremontBridge,07/06/2017 04:00:00 AM,48,-122,5,6,11
41693,FremontBridge,07/06/2017 05:00:00 AM,48,-122,18,31,49
41694,FremontBridge,07/06/2017 06:00:00 AM,48,-122,85,111,196
41695,FremontBridge,07/06/2017 07:00:00 AM,48,-122,198,288,486
41696,FremontBridge,07/06/2017 08:00:00 AM,48,-122,300,356,656
41697,FremontBridge,07/06/2017 09:00:00 AM,48,-122,169,177,346
41698,FremontBridge,07/06/2017 10:00:00 AM,48,-122,84,58,142
41699,FremontBridge,07/06/2017 11:00:00 AM,48,-122,61,60,121
41700,FremontBridge,07/06/2017 12:00:00 PM,48,-122,51,56,107
41701,FremontBridge,07/06/2017 01:00:00 PM,48,-122,79,51,130
41702,FremontBridge,07/06/2017 02:00:00 PM,48,-122,69,48,117
41703,FremontBridge,07/06/2017 03:00:00 PM,48,-122,114,72,186
41704,FremontBridge,07/06/2017 04:00:00 PM,48,-122,263,111,374
41705,FremontBridge,07/06/2017 05:00:00 PM,48,-122,588,176,764
41706,FremontBridge,07/06/2017 06:00:00 PM,48,-122,390,179,569
41707,FremontBridge,07/06/2017 07:00:00 PM,48,-122,208,109,317
41708,FremontBridge,07/06/2017 08:00:00 PM,48,-122,103,57,160
41709,FremontBridge,07/06/2017 09:00:00 PM,48,-122,66,59,125
41710,FremontBridge,07/06/2017 10:00:00 PM,48,-122,32,36,68
41711,FremontBridge,07/06/2017 11:00:00 PM,48,-122,19,14,33
41712,FremontBridge,07/07/2017 12:00:00 AM,48,-122,12,11,23
41713,FremontBridge,07/07/2017 01:00:00 AM,48,-122,5,3,8
41714,FremontBridge,07/07/2017 02:00:00 AM,48,-122,5,2,7
41715,FremontBridge,07/07/2017 03:00:00 AM,48,-122,2,2,4
41716,FremontBridge,07/07/2017 04:00:00 AM,48,-122,3,2,5
41717,FremontBridge,07/07/2017 05:00:00 AM,48,-122,15,28,43
41718,FremontBridge,07/07/2017 06:00:00 AM,48,-122,71,93,164
41719,FremontBridge,07/07/2017 07:00:00 AM,48,-122,178,219,397
41720,FremontBridge,07/07/2017 08:00:00 AM,48,-122,258,284,542
41721,FremontBridge,07/07/2017 09:00:00 AM,48,-122,155,160,315
41722,FremontBridge,07/07/2017 10:00:00 AM,48,-122,61,50,111
41723,FremontBridge,07/07/2017 11:00:00 AM,48,-122,57,52,109
41724,FremontBridge,07/07/2017 12:00:00 PM,48,-122,76,59,135
41725,FremontBridge,07/07/2017 01:00:00 PM,48,-122,38,67,105
41726,FremontBridge,07/07/2017 02:00:00 PM,48,-122,75,53,128
41727,FremontBridge,07/07/2017 03:00:00 PM,48,-122,160,69,229
41728,FremontBridge,07/07/2017 04:00:00 PM,48,-122,287,106,393
41729,FremontBridge,07/07/2017 05:00:00 PM,48,-122,479,155,634
41730,FremontBridge,07/07/2017 06:00:00 PM,48,-122,263,150,413
41731,FremontBridge,07/07/2017 07:00:00 PM,48,-122,133,83,216
41732,FremontBridge,07/07/2017 08:00:00 PM,48,-122,81,74,155
41733,FremontBridge,07/07/2017 09:00:00 PM,48,-122,61,38,99
41734,FremontBridge,07/07/2017 10:00:00 PM,48,-122,213,64,277
41735,FremontBridge,07/07/2017 11:00:00 PM,48,-122,251,37,288
41736,FremontBridge,07/08/2017 12:00:00 AM,48,-122,26,17,43
41737,FremontBridge,07/08/2017 01:00:00 AM,48,-122,3,17,20
41738,FremontBridge,07/08/2017 02:00:00 AM,48,-122,2,4,6
41739,FremontBridge,07/08/2017 03:00:00 AM,48,-122,0,5,5
41740,FremontBridge,07/08/2017 04:00:00 AM,48,-122,3,1,4
41741,FremontBridge,07/08/2017 05:00:00 AM,48,-122,5,6,11
41742,FremontBridge,07/08/2017 06:00:00 AM,48,-122,16,23,39
41743,FremontBridge,07/08/2017 07:00:00 AM,48,-122,32,25,57
41744,FremontBridge,07/08/2017 08:00:00 AM,48,-122,70,65,135
41745,FremontBridge,07/08/2017 09:00:00 AM,48,-122,72,84,156
41746,FremontBridge,07/08/2017 10:00:00 AM,48,-122,85,71,156
41747,FremontBridge,07/08/2017 11:00:00 AM,48,-122,109,108,217
41748,FremontBridge,07/08/2017 12:00:00 PM,48,-122,87,87,174
41749,FremontBridge,07/08/2017 01:00:00 PM,48,-122,86,109,195
41750,FremontBridge,07/08/2017 02:00:00 PM,48,-122,118,111,229
41751,FremontBridge,07/08/2017 03:00:00 PM,48,-122,114,122,236
41752,FremontBridge,07/08/2017 04:00:00 PM,48,-122,101,100,201
41753,FremontBridge,07/08/2017 05:00:00 PM,48,-122,98,93,191
41754,FremontBridge,07/08/2017 06:00:00 PM,48,-122,70,77,147
41755,FremontBridge,07/08/2017 07:00:00 PM,48,-122,59,71,130
41756,FremontBridge,07/08/2017 08:00:00 PM,48,-122,56,47,103
41757,FremontBridge,07/08/2017 09:00:00 PM,48,-122,49,41,90
41758,FremontBridge,07/08/2017 10:00:00 PM,48,-122,25,18,43
41759,FremontBridge,07/08/2017 11:00:00 PM,48,-122,28,6,34
41760,FremontBridge,07/09/2017 12:00:00 AM,48,-122,11,8,19
41761,FremontBridge,07/09/2017 01:00:00 AM,48,-122,6,7,13
41762,FremontBridge,07/09/2017 02:00:00 AM,48,-122,6,3,9
41763,FremontBridge,07/09/2017 03:00:00 AM,48,-122,4,1,5
41764,FremontBridge,07/09/2017 04:00:00 AM,48,-122,1,2,3
41765,FremontBridge,07/09/2017 05:00:00 AM,48,-122,0,6,6
41766,FremontBridge,07/09/2017 06:00:00 AM,48,-122,6,16,22
41767,FremontBridge,07/09/2017 07:00:00 AM,48,-122,22,21,43
41768,FremontBridge,07/09/2017 08:00:00 AM,48,-122,38,49,87
41769,FremontBridge,07/09/2017 09:00:00 AM,48,-122,57,55,112
41770,FremontBridge,07/09/2017 10:00:00 AM,48,-122,60,80,140
41771,FremontBridge,07/09/2017 11:00:00 AM,48,-122,88,101,189
41772,FremontBridge,07/09/2017 12:00:00 PM,48,-122,125,117,242
41773,FremontBridge,07/09/2017 01:00:00 PM,48,-122,94,101,195
41774,FremontBridge,07/09/2017 02:00:00 PM,48,-122,124,104,228
41775,FremontBridge,07/09/2017 03:00:00 PM,48,-122,87,74,161
41776,FremontBridge,07/09/2017 04:00:00 PM,48,-122,99,68,167
41777,FremontBridge,07/09/2017 05:00:00 PM,48,-122,89,82,171
41778,FremontBridge,07/09/2017 06:00:00 PM,48,-122,78,74,152
41779,FremontBridge,07/09/2017 07:00:00 PM,48,-122,53,54,107
41780,FremontBridge,07/09/2017 08:00:00 PM,48,-122,44,41,85
41781,FremontBridge,07/09/2017 09:00:00 PM,48,-122,38,27,65
41782,FremontBridge,07/09/2017 10:00:00 PM,48,-122,22,6,28
41783,FremontBridge,07/09/2017 11:00:00 PM,48,-122,13,12,25
41784,FremontBridge,07/10/2017 12:00:00 AM,48,-122,4,4,8
41785,FremontBridge,07/10/2017 01:00:00 AM,48,-122,2,6,8
41786,FremontBridge,07/10/2017 02:00:00 AM,48,-122,0,0,0
41787,FremontBridge,07/10/2017 03:00:00 AM,48,-122,0,1,1
41788,FremontBridge,07/10/2017 04:00:00 AM,48,-122,5,3,8
41789,FremontBridge,07/10/2017 05:00:00 AM,48,-122,24,30,54
41790,FremontBridge,07/10/2017 06:00:00 AM,48,-122,84,126,210
41791,FremontBridge,07/10/2017 07:00:00 AM,48,-122,190,288,478
41792,FremontBridge,07/10/2017 08:00:00 AM,48,-122,318,347,665
41793,FremontBridge,07/10/2017 09:00:00 AM,48,-122,162,180,342
41794,FremontBridge,07/10/2017 10:00:00 AM,48,-122,83,59,142
41795,FremontBridge,07/10/2017 11:00:00 AM,48,-122,42,43,85
41796,FremontBridge,07/10/2017 12:00:00 PM,48,-122,48,50,98
41797,FremontBridge,07/10/2017 01:00:00 PM,48,-122,42,57,99
41798,FremontBridge,07/10/2017 02:00:00 PM,48,-122,67,45,112
41799,FremontBridge,07/10/2017 03:00:00 PM,48,-122,109,61,170
41800,FremontBridge,07/10/2017 04:00:00 PM,48,-122,264,126,390
41801,FremontBridge,07/10/2017 05:00:00 PM,48,-122,609,183,792
41802,FremontBridge,07/10/2017 06:00:00 PM,48,-122,402,178,580
41803,FremontBridge,07/10/2017 07:00:00 PM,48,-122,175,84,259
41804,FremontBridge,07/10/2017 08:00:00 PM,48,-122,102,63,165
41805,FremontBridge,07/10/2017 09:00:00 PM,48,-122,34,45,79
41806,FremontBridge,07/10/2017 10:00:00 PM,48,-122,23,21,44
41807,FremontBridge,07/10/2017 11:00:00 PM,48,-122,13,4,17
41808,FremontBridge,07/11/2017 12:00:00 AM,48,-122,2,4,6
41809,FremontBridge,07/11/2017 01:00:00 AM,48,-122,2,2,4
41810,FremontBridge,07/11/2017 02:00:00 AM,48,-122,2,1,3
41811,FremontBridge,07/11/2017 03:00:00 AM,48,-122,2,2,4
41812,FremontBridge,07/11/2017 04:00:00 AM,48,-122,7,8,15
41813,FremontBridge,07/11/2017 05:00:00 AM,48,-122,19,36,55
41814,FremontBridge,07/11/2017 06:00:00 AM,48,-122,111,117,228
41815,FremontBridge,07/11/2017 07:00:00 AM,48,-122,208,273,481
41816,FremontBridge,07/11/2017 08:00:00 AM,48,-122,275,320,595
41817,FremontBridge,07/11/2017 09:00:00 AM,48,-122,194,177,371
41818,FremontBridge,07/11/2017 10:00:00 AM,48,-122,62,82,144
41819,FremontBridge,07/11/2017 11:00:00 AM,48,-122,74,41,115
41820,FremontBridge,07/11/2017 12:00:00 PM,48,-122,48,42,90
41821,FremontBridge,07/11/2017 01:00:00 PM,48,-122,57,51,108
41822,FremontBridge,07/11/2017 02:00:00 PM,48,-122,56,67,123
41823,FremontBridge,07/11/2017 03:00:00 PM,48,-122,118,72,190
41824,FremontBridge,07/11/2017 04:00:00 PM,48,-122,273,131,404
41825,FremontBridge,07/11/2017 05:00:00 PM,48,-122,640,194,834
41826,FremontBridge,07/11/2017 06:00:00 PM,48,-122,386,172,558
41827,FremontBridge,07/11/2017 07:00:00 PM,48,-122,197,117,314
41828,FremontBridge,07/11/2017 08:00:00 PM,48,-122,98,64,162
41829,FremontBridge,07/11/2017 09:00:00 PM,48,-122,56,47,103
41830,FremontBridge,07/11/2017 10:00:00 PM,48,-122,27,25,52
41831,FremontBridge,07/11/2017 11:00:00 PM,48,-122,16,13,29
41832,FremontBridge,07/12/2017 12:00:00 AM,48,-122,10,3,13
41833,FremontBridge,07/12/2017 01:00:00 AM,48,-122,1,6,7
41834,FremontBridge,07/12/2017 02:00:00 AM,48,-122,2,1,3
41835,FremontBridge,07/12/2017 03:00:00 AM,48,-122,2,2,4
41836,FremontBridge,07/12/2017 04:00:00 AM,48,-122,7,4,11
41837,FremontBridge,07/12/2017 05:00:00 AM,48,-122,19,42,61
41838,FremontBridge,07/12/2017 06:00:00 AM,48,-122,85,114,199
41839,FremontBridge,07/12/2017 07:00:00 AM,48,-122,212,307,519
41840,FremontBridge,07/12/2017 08:00:00 AM,48,-122,326,373,699
41841,FremontBridge,07/12/2017 09:00:00 AM,48,-122,156,169,325
41842,FremontBridge,07/12/2017 10:00:00 AM,48,-122,86,59,145
41843,FremontBridge,07/12/2017 11:00:00 AM,48,-122,50,70,120
41844,FremontBridge,07/12/2017 12:00:00 PM,48,-122,52,63,115
41845,FremontBridge,07/12/2017 01:00:00 PM,48,-122,78,64,142
41846,FremontBridge,07/12/2017 02:00:00 PM,48,-122,78,56,134
41847,FremontBridge,07/12/2017 03:00:00 PM,48,-122,109,88,197
41848,FremontBridge,07/12/2017 04:00:00 PM,48,-122,293,124,417
41849,FremontBridge,07/12/2017 05:00:00 PM,48,-122,588,185,773
41850,FremontBridge,07/12/2017 06:00:00 PM,48,-122,413,199,612
41851,FremontBridge,07/12/2017 07:00:00 PM,48,-122,209,102,311
41852,FremontBridge,07/12/2017 08:00:00 PM,48,-122,153,83,236
41853,FremontBridge,07/12/2017 09:00:00 PM,48,-122,59,52,111
41854,FremontBridge,07/12/2017 10:00:00 PM,48,-122,36,39,75
41855,FremontBridge,07/12/2017 11:00:00 PM,48,-122,9,12,21
41856,FremontBridge,07/13/2017 12:00:00 AM,48,-122,9,9,18
41857,FremontBridge,07/13/2017 01:00:00 AM,48,-122,1,1,2
41858,FremontBridge,07/13/2017 02:00:00 AM,48,-122,1,1,2
41859,FremontBridge,07/13/2017 03:00:00 AM,48,-122,0,2,2
41860,FremontBridge,07/13/2017 04:00:00 AM,48,-122,6,6,12
41861,FremontBridge,07/13/2017 05:00:00 AM,48,-122,14,36,50
41862,FremontBridge,07/13/2017 06:00:00 AM,48,-122,67,103,170
41863,FremontBridge,07/13/2017 07:00:00 AM,48,-122,178,255,433
41864,FremontBridge,07/13/2017 08:00:00 AM,48,-122,282,317,599
41865,FremontBridge,07/13/2017 09:00:00 AM,48,-122,138,174,312
41866,FremontBridge,07/13/2017 10:00:00 AM,48,-122,63,64,127
41867,FremontBridge,07/13/2017 11:00:00 AM,48,-122,44,54,98
41868,FremontBridge,07/13/2017 12:00:00 PM,48,-122,47,34,81
41869,FremontBridge,07/13/2017 01:00:00 PM,48,-122,46,40,86
41870,FremontBridge,07/13/2017 02:00:00 PM,48,-122,74,40,114
41871,FremontBridge,07/13/2017 03:00:00 PM,48,-122,99,64,163
41872,FremontBridge,07/13/2017 04:00:00 PM,48,-122,259,101,360
41873,FremontBridge,07/13/2017 05:00:00 PM,48,-122,501,162,663
41874,FremontBridge,07/13/2017 06:00:00 PM,48,-122,17,52,69
41875,FremontBridge,07/13/2017 07:00:00 PM,48,-122,125,72,197
41876,FremontBridge,07/13/2017 08:00:00 PM,48,-122,146,66,212
41877,FremontBridge,07/13/2017 09:00:00 PM,48,-122,45,62,107
41878,FremontBridge,07/13/2017 10:00:00 PM,48,-122,44,25,69
41879,FremontBridge,07/13/2017 11:00:00 PM,48,-122,13,9,22
41880,FremontBridge,07/14/2017 12:00:00 AM,48,-122,10,5,15
41881,FremontBridge,07/14/2017 01:00:00 AM,48,-122,3,3,6
41882,FremontBridge,07/14/2017 02:00:00 AM,48,-122,0,2,2
41883,FremontBridge,07/14/2017 03:00:00 AM,48,-122,2,1,3
41884,FremontBridge,07/14/2017 04:00:00 AM,48,-122,5,5,10
41885,FremontBridge,07/14/2017 05:00:00 AM,48,-122,18,29,47
41886,FremontBridge,07/14/2017 06:00:00 AM,48,-122,70,86,156
41887,FremontBridge,07/14/2017 07:00:00 AM,48,-122,160,237,397
41888,FremontBridge,07/14/2017 08:00:00 AM,48,-122,244,278,522
41889,FremontBridge,07/14/2017 09:00:00 AM,48,-122,141,159,300
41890,FremontBridge,07/14/2017 10:00:00 AM,48,-122,84,73,157
41891,FremontBridge,07/14/2017 11:00:00 AM,48,-122,58,53,111
41892,FremontBridge,07/14/2017 12:00:00 PM,48,-122,70,65,135
41893,FremontBridge,07/14/2017 01:00:00 PM,48,-122,66,61,127
41894,FremontBridge,07/14/2017 02:00:00 PM,48,-122,85,50,135
41895,FremontBridge,07/14/2017 03:00:00 PM,48,-122,149,80,229
41896,FremontBridge,07/14/2017 04:00:00 PM,48,-122,283,130,413
41897,FremontBridge,07/14/2017 05:00:00 PM,48,-122,464,170,634
41898,FremontBridge,07/14/2017 06:00:00 PM,48,-122,290,105,395
41899,FremontBridge,07/14/2017 07:00:00 PM,48,-122,130,91,221
41900,FremontBridge,07/14/2017 08:00:00 PM,48,-122,86,51,137
41901,FremontBridge,07/14/2017 09:00:00 PM,48,-122,58,34,92
41902,FremontBridge,07/14/2017 10:00:00 PM,48,-122,28,20,48
41903,FremontBridge,07/14/2017 11:00:00 PM,48,-122,22,15,37
41904,FremontBridge,07/15/2017 12:00:00 AM,48,-122,16,11,27
41905,FremontBridge,07/15/2017 01:00:00 AM,48,-122,7,5,12
41906,FremontBridge,07/15/2017 02:00:00 AM,48,-122,1,3,4
41907,FremontBridge,07/15/2017 03:00:00 AM,48,-122,6,3,9
41908,FremontBridge,07/15/2017 04:00:00 AM,48,-122,20,10,30
41909,FremontBridge,07/15/2017 05:00:00 AM,48,-122,25,11,36
41910,FremontBridge,07/15/2017 06:00:00 AM,48,-122,23,13,36
41911,FremontBridge,07/15/2017 07:00:00 AM,48,-122,25,36,61
41912,FremontBridge,07/15/2017 08:00:00 AM,48,-122,51,61,112
41913,FremontBridge,07/15/2017 09:00:00 AM,48,-122,64,65,129
41914,FremontBridge,07/15/2017 10:00:00 AM,48,-122,77,76,153
41915,FremontBridge,07/15/2017 11:00:00 AM,48,-122,87,83,170
41916,FremontBridge,07/15/2017 12:00:00 PM,48,-122,110,110,220
41917,FremontBridge,07/15/2017 01:00:00 PM,48,-122,97,114,211
41918,FremontBridge,07/15/2017 02:00:00 PM,48,-122,105,84,189
41919,FremontBridge,07/15/2017 03:00:00 PM,48,-122,112,74,186
41920,FremontBridge,07/15/2017 04:00:00 PM,48,-122,81,72,153
41921,FremontBridge,07/15/2017 05:00:00 PM,48,-122,101,92,193
41922,FremontBridge,07/15/2017 06:00:00 PM,48,-122,62,67,129
41923,FremontBridge,07/15/2017 07:00:00 PM,48,-122,91,63,154
41924,FremontBridge,07/15/2017 08:00:00 PM,48,-122,49,40,89
41925,FremontBridge,07/15/2017 09:00:00 PM,48,-122,35,34,69
41926,FremontBridge,07/15/2017 10:00:00 PM,48,-122,23,12,35
41927,FremontBridge,07/15/2017 11:00:00 PM,48,-122,13,6,19
41928,FremontBridge,07/16/2017 12:00:00 AM,48,-122,22,4,26
41929,FremontBridge,07/16/2017 01:00:00 AM,48,-122,8,2,10
41930,FremontBridge,07/16/2017 02:00:00 AM,48,-122,5,0,5
41931,FremontBridge,07/16/2017 03:00:00 AM,48,-122,1,1,2
41932,FremontBridge,07/16/2017 04:00:00 AM,48,-122,4,4,8
41933,FremontBridge,07/16/2017 05:00:00 AM,48,-122,3,9,12
41934,FremontBridge,07/16/2017 06:00:00 AM,48,-122,13,10,23
41935,FremontBridge,07/16/2017 07:00:00 AM,48,-122,21,19,40
41936,FremontBridge,07/16/2017 08:00:00 AM,48,-122,39,43,82
41937,FremontBridge,07/16/2017 09:00:00 AM,48,-122,52,46,98
41938,FremontBridge,07/16/2017 10:00:00 AM,48,-122,70,75,145
41939,FremontBridge,07/16/2017 11:00:00 AM,48,-122,68,84,152
41940,FremontBridge,07/16/2017 12:00:00 PM,48,-122,97,100,197
41941,FremontBridge,07/16/2017 01:00:00 PM,48,-122,89,93,182
41942,FremontBridge,07/16/2017 02:00:00 PM,48,-122,125,102,227
41943,FremontBridge,07/16/2017 03:00:00 PM,48,-122,90,100,190
41944,FremontBridge,07/16/2017 04:00:00 PM,48,-122,95,68,163
41945,FremontBridge,07/16/2017 05:00:00 PM,48,-122,70,78,148
41946,FremontBridge,07/16/2017 06:00:00 PM,48,-122,75,84,159
41947,FremontBridge,07/16/2017 07:00:00 PM,48,-122,53,59,112
41948,FremontBridge,07/16/2017 08:00:00 PM,48,-122,40,28,68
41949,FremontBridge,07/16/2017 09:00:00 PM,48,-122,23,12,35
41950,FremontBridge,07/16/2017 10:00:00 PM,48,-122,17,14,31
41951,FremontBridge,07/16/2017 11:00:00 PM,48,-122,8,8,16
41952,FremontBridge,07/17/2017 12:00:00 AM,48,-122,4,3,7
41953,FremontBridge,07/17/2017 01:00:00 AM,48,-122,3,0,3
41954,FremontBridge,07/17/2017 02:00:00 AM,48,-122,1,1,2
41955,FremontBridge,07/17/2017 03:00:00 AM,48,-122,2,2,4
41956,FremontBridge,07/17/2017 04:00:00 AM,48,-122,5,5,10
41957,FremontBridge,07/17/2017 05:00:00 AM,48,-122,21,42,63
41958,FremontBridge,07/17/2017 06:00:00 AM,48,-122,91,88,179
41959,FremontBridge,07/17/2017 07:00:00 AM,48,-122,219,263,482
41960,FremontBridge,07/17/2017 08:00:00 AM,48,-122,309,339,648
41961,FremontBridge,07/17/2017 09:00:00 AM,48,-122,179,152,331
41962,FremontBridge,07/17/2017 10:00:00 AM,48,-122,72,62,134
41963,FremontBridge,07/17/2017 11:00:00 AM,48,-122,41,54,95
41964,FremontBridge,07/17/2017 12:00:00 PM,48,-122,52,47,99
41965,FremontBridge,07/17/2017 01:00:00 PM,48,-122,50,59,109
41966,FremontBridge,07/17/2017 02:00:00 PM,48,-122,83,44,127
41967,FremontBridge,07/17/2017 03:00:00 PM,48,-122,102,69,171
41968,FremontBridge,07/17/2017 04:00:00 PM,48,-122,280,119,399
41969,FremontBridge,07/17/2017 05:00:00 PM,48,-122,586,177,763
41970,FremontBridge,07/17/2017 06:00:00 PM,48,-122,413,150,563
41971,FremontBridge,07/17/2017 07:00:00 PM,48,-122,178,98,276
41972,FremontBridge,07/17/2017 08:00:00 PM,48,-122,109,59,168
41973,FremontBridge,07/17/2017 09:00:00 PM,48,-122,56,28,84
41974,FremontBridge,07/17/2017 10:00:00 PM,48,-122,30,20,50
41975,FremontBridge,07/17/2017 11:00:00 PM,48,-122,9,15,24
41976,FremontBridge,07/18/2017 12:00:00 AM,48,-122,7,2,9
41977,FremontBridge,07/18/2017 01:00:00 AM,48,-122,2,1,3
41978,FremontBridge,07/18/2017 02:00:00 AM,48,-122,2,4,6
41979,FremontBridge,07/18/2017 03:00:00 AM,48,-122,1,1,2
41980,FremontBridge,07/18/2017 04:00:00 AM,48,-122,3,6,9
41981,FremontBridge,07/18/2017 05:00:00 AM,48,-122,24,37,61
41982,FremontBridge,07/18/2017 06:00:00 AM,48,-122,87,111,198
41983,FremontBridge,07/18/2017 07:00:00 AM,48,-122,209,309,518
41984,FremontBridge,07/18/2017 08:00:00 AM,48,-122,337,394,731
41985,FremontBridge,07/18/2017 09:00:00 AM,48,-122,167,178,345
41986,FremontBridge,07/18/2017 10:00:00 AM,48,-122,77,64,141
41987,FremontBridge,07/18/2017 11:00:00 AM,48,-122,44,63,107
41988,FremontBridge,07/18/2017 12:00:00 PM,48,-122,66,46,112
41989,FremontBridge,07/18/2017 01:00:00 PM,48,-122,50,49,99
41990,FremontBridge,07/18/2017 02:00:00 PM,48,-122,83,67,150
41991,FremontBridge,07/18/2017 03:00:00 PM,48,-122,130,71,201
41992,FremontBridge,07/18/2017 04:00:00 PM,48,-122,299,138,437
41993,FremontBridge,07/18/2017 05:00:00 PM,48,-122,617,198,815
41994,FremontBridge,07/18/2017 06:00:00 PM,48,-122,385,167,552
41995,FremontBridge,07/18/2017 07:00:00 PM,48,-122,190,97,287
41996,FremontBridge,07/18/2017 08:00:00 PM,48,-122,149,83,232
41997,FremontBridge,07/18/2017 09:00:00 PM,48,-122,64,47,111
41998,FremontBridge,07/18/2017 10:00:00 PM,48,-122,43,24,67
41999,FremontBridge,07/18/2017 11:00:00 PM,48,-122,22,23,45
42000,FremontBridge,07/19/2017 12:00:00 AM,48,-122,6,5,11
42001,FremontBridge,07/19/2017 01:00:00 AM,48,-122,6,2,8
42002,FremontBridge,07/19/2017 02:00:00 AM,48,-122,3,0,3
42003,FremontBridge,07/19/2017 03:00:00 AM,48,-122,0,1,1
42004,FremontBridge,07/19/2017 04:00:00 AM,48,-122,6,3,9
42005,FremontBridge,07/19/2017 05:00:00 AM,48,-122,16,37,53
42006,FremontBridge,07/19/2017 06:00:00 AM,48,-122,92,111,203
42007,FremontBridge,07/19/2017 07:00:00 AM,48,-122,218,273,491
42008,FremontBridge,07/19/2017 08:00:00 AM,48,-122,331,364,695
42009,FremontBridge,07/19/2017 09:00:00 AM,48,-122,181,148,329
42010,FremontBridge,07/19/2017 10:00:00 AM,48,-122,80,111,191
42011,FremontBridge,07/19/2017 11:00:00 AM,48,-122,68,64,132
42012,FremontBridge,07/19/2017 12:00:00 PM,48,-122,58,50,108
42013,FremontBridge,07/19/2017 01:00:00 PM,48,-122,69,57,126
42014,FremontBridge,07/19/2017 02:00:00 PM,48,-122,75,57,132
42015,FremontBridge,07/19/2017 03:00:00 PM,48,-122,147,69,216
42016,FremontBridge,07/19/2017 04:00:00 PM,48,-122,302,110,412
42017,FremontBridge,07/19/2017 05:00:00 PM,48,-122,589,182,771
42018,FremontBridge,07/19/2017 06:00:00 PM,48,-122,383,175,558
42019,FremontBridge,07/19/2017 07:00:00 PM,48,-122,186,108,294
42020,FremontBridge,07/19/2017 08:00:00 PM,48,-122,94,63,157
42021,FremontBridge,07/19/2017 09:00:00 PM,48,-122,67,35,102
42022,FremontBridge,07/19/2017 10:00:00 PM,48,-122,34,30,64
42023,FremontBridge,07/19/2017 11:00:00 PM,48,-122,16,6,22
42024,FremontBridge,07/20/2017 12:00:00 AM,48,-122,11,6,17
42025,FremontBridge,07/20/2017 01:00:00 AM,48,-122,1,3,4
42026,FremontBridge,07/20/2017 02:00:00 AM,48,-122,2,0,2
42027,FremontBridge,07/20/2017 03:00:00 AM,48,-122,2,1,3
42028,FremontBridge,07/20/2017 04:00:00 AM,48,-122,2,6,8
42029,FremontBridge,07/20/2017 05:00:00 AM,48,-122,17,39,56
42030,FremontBridge,07/20/2017 06:00:00 AM,48,-122,74,86,160
42031,FremontBridge,07/20/2017 07:00:00 AM,48,-122,194,243,437
42032,FremontBridge,07/20/2017 08:00:00 AM,48,-122,330,323,653
42033,FremontBridge,07/20/2017 09:00:00 AM,48,-122,171,152,323
42034,FremontBridge,07/20/2017 10:00:00 AM,48,-122,63,75,138
42035,FremontBridge,07/20/2017 11:00:00 AM,48,-122,56,41,97
42036,FremontBridge,07/20/2017 12:00:00 PM,48,-122,45,48,93
42037,FremontBridge,07/20/2017 01:00:00 PM,48,-122,58,49,107
42038,FremontBridge,07/20/2017 02:00:00 PM,48,-122,69,43,112
42039,FremontBridge,07/20/2017 03:00:00 PM,48,-122,106,70,176
42040,FremontBridge,07/20/2017 04:00:00 PM,48,-122,264,114,378
42041,FremontBridge,07/20/2017 05:00:00 PM,48,-122,502,186,688
42042,FremontBridge,07/20/2017 06:00:00 PM,48,-122,341,168,509
42043,FremontBridge,07/20/2017 07:00:00 PM,48,-122,178,88,266
42044,FremontBridge,07/20/2017 08:00:00 PM,48,-122,94,79,173
42045,FremontBridge,07/20/2017 09:00:00 PM,48,-122,74,42,116
42046,FremontBridge,07/20/2017 10:00:00 PM,48,-122,41,24,65
42047,FremontBridge,07/20/2017 11:00:00 PM,48,-122,21,13,34
42048,FremontBridge,07/21/2017 12:00:00 AM,48,-122,6,5,11
42049,FremontBridge,07/21/2017 01:00:00 AM,48,-122,7,2,9
42050,FremontBridge,07/21/2017 02:00:00 AM,48,-122,3,0,3
42051,FremontBridge,07/21/2017 03:00:00 AM,48,-122,2,1,3
42052,FremontBridge,07/21/2017 04:00:00 AM,48,-122,4,3,7
42053,FremontBridge,07/21/2017 05:00:00 AM,48,-122,11,28,39
42054,FremontBridge,07/21/2017 06:00:00 AM,48,-122,61,88,149
42055,FremontBridge,07/21/2017 07:00:00 AM,48,-122,161,216,377
42056,FremontBridge,07/21/2017 08:00:00 AM,48,-122,230,289,519
42057,FremontBridge,07/21/2017 09:00:00 AM,48,-122,158,160,318
42058,FremontBridge,07/21/2017 10:00:00 AM,48,-122,68,56,124
42059,FremontBridge,07/21/2017 11:00:00 AM,48,-122,58,47,105
42060,FremontBridge,07/21/2017 12:00:00 PM,48,-122,55,43,98
42061,FremontBridge,07/21/2017 01:00:00 PM,48,-122,69,52,121
42062,FremontBridge,07/21/2017 02:00:00 PM,48,-122,88,69,157
42063,FremontBridge,07/21/2017 03:00:00 PM,48,-122,154,76,230
42064,FremontBridge,07/21/2017 04:00:00 PM,48,-122,265,111,376
42065,FremontBridge,07/21/2017 05:00:00 PM,48,-122,439,156,595
42066,FremontBridge,07/21/2017 06:00:00 PM,48,-122,254,94,348
42067,FremontBridge,07/21/2017 07:00:00 PM,48,-122,119,63,182
42068,FremontBridge,07/21/2017 08:00:00 PM,48,-122,68,44,112
42069,FremontBridge,07/21/2017 09:00:00 PM,48,-122,36,35,71
42070,FremontBridge,07/21/2017 10:00:00 PM,48,-122,17,8,25
42071,FremontBridge,07/21/2017 11:00:00 PM,48,-122,25,9,34
42072,FremontBridge,07/22/2017 12:00:00 AM,48,-122,23,11,34
42073,FremontBridge,07/22/2017 01:00:00 AM,48,-122,8,9,17
42074,FremontBridge,07/22/2017 02:00:00 AM,48,-122,2,2,4
42075,FremontBridge,07/22/2017 03:00:00 AM,48,-122,7,6,13
42076,FremontBridge,07/22/2017 04:00:00 AM,48,-122,2,2,4
42077,FremontBridge,07/22/2017 05:00:00 AM,48,-122,4,9,13
42078,FremontBridge,07/22/2017 06:00:00 AM,48,-122,16,14,30
42079,FremontBridge,07/22/2017 07:00:00 AM,48,-122,30,31,61
42080,FremontBridge,07/22/2017 08:00:00 AM,48,-122,50,54,104
42081,FremontBridge,07/22/2017 09:00:00 AM,48,-122,54,71,125
42082,FremontBridge,07/22/2017 10:00:00 AM,48,-122,82,67,149
42083,FremontBridge,07/22/2017 11:00:00 AM,48,-122,111,91,202
42084,FremontBridge,07/22/2017 12:00:00 PM,48,-122,97,103,200
42085,FremontBridge,07/22/2017 01:00:00 PM,48,-122,75,103,178
42086,FremontBridge,07/22/2017 02:00:00 PM,48,-122,119,110,229
42087,FremontBridge,07/22/2017 03:00:00 PM,48,-122,112,85,197
42088,FremontBridge,07/22/2017 04:00:00 PM,48,-122,89,105,194
42089,FremontBridge,07/22/2017 05:00:00 PM,48,-122,73,86,159
42090,FremontBridge,07/22/2017 06:00:00 PM,48,-122,66,73,139
42091,FremontBridge,07/22/2017 07:00:00 PM,48,-122,50,44,94
42092,FremontBridge,07/22/2017 08:00:00 PM,48,-122,43,32,75
42093,FremontBridge,07/22/2017 09:00:00 PM,48,-122,32,26,58
42094,FremontBridge,07/22/2017 10:00:00 PM,48,-122,20,9,29
42095,FremontBridge,07/22/2017 11:00:00 PM,48,-122,20,10,30
42096,FremontBridge,07/23/2017 12:00:00 AM,48,-122,21,12,33
42097,FremontBridge,07/23/2017 01:00:00 AM,48,-122,12,2,14
42098,FremontBridge,07/23/2017 02:00:00 AM,48,-122,1,3,4
42099,FremontBridge,07/23/2017 03:00:00 AM,48,-122,2,0,2
42100,FremontBridge,07/23/2017 04:00:00 AM,48,-122,3,2,5
42101,FremontBridge,07/23/2017 05:00:00 AM,48,-122,6,5,11
42102,FremontBridge,07/23/2017 06:00:00 AM,48,-122,13,12,25
42103,FremontBridge,07/23/2017 07:00:00 AM,48,-122,28,23,51
42104,FremontBridge,07/23/2017 08:00:00 AM,48,-122,36,40,76
42105,FremontBridge,07/23/2017 09:00:00 AM,48,-122,45,50,95
42106,FremontBridge,07/23/2017 10:00:00 AM,48,-122,63,71,134
42107,FremontBridge,07/23/2017 11:00:00 AM,48,-122,93,74,167
42108,FremontBridge,07/23/2017 12:00:00 PM,48,-122,83,80,163
42109,FremontBridge,07/23/2017 01:00:00 PM,48,-122,102,116,218
42110,FremontBridge,07/23/2017 02:00:00 PM,48,-122,88,99,187
42111,FremontBridge,07/23/2017 03:00:00 PM,48,-122,124,102,226
42112,FremontBridge,07/23/2017 04:00:00 PM,48,-122,81,87,168
42113,FremontBridge,07/23/2017 05:00:00 PM,48,-122,88,69,157
42114,FremontBridge,07/23/2017 06:00:00 PM,48,-122,68,54,122
42115,FremontBridge,07/23/2017 07:00:00 PM,48,-122,60,51,111
42116,FremontBridge,07/23/2017 08:00:00 PM,48,-122,50,26,76
42117,FremontBridge,07/23/2017 09:00:00 PM,48,-122,39,12,51
42118,FremontBridge,07/23/2017 10:00:00 PM,48,-122,19,17,36
42119,FremontBridge,07/23/2017 11:00:00 PM,48,-122,10,13,23
42120,FremontBridge,07/24/2017 12:00:00 AM,48,-122,9,4,13
42121,FremontBridge,07/24/2017 01:00:00 AM,48,-122,1,6,7
42122,FremontBridge,07/24/2017 02:00:00 AM,48,-122,3,2,5
42123,FremontBridge,07/24/2017 03:00:00 AM,48,-122,3,3,6
42124,FremontBridge,07/24/2017 04:00:00 AM,48,-122,8,3,11
42125,FremontBridge,07/24/2017 05:00:00 AM,48,-122,14,34,48
42126,FremontBridge,07/24/2017 06:00:00 AM,48,-122,79,114,193
42127,FremontBridge,07/24/2017 07:00:00 AM,48,-122,202,260,462
42128,FremontBridge,07/24/2017 08:00:00 AM,48,-122,305,362,667
42129,FremontBridge,07/24/2017 09:00:00 AM,48,-122,185,163,348
42130,FremontBridge,07/24/2017 10:00:00 AM,48,-122,71,61,132
42131,FremontBridge,07/24/2017 11:00:00 AM,48,-122,63,55,118
42132,FremontBridge,07/24/2017 12:00:00 PM,48,-122,55,46,101
42133,FremontBridge,07/24/2017 01:00:00 PM,48,-122,46,59,105
42134,FremontBridge,07/24/2017 02:00:00 PM,48,-122,89,55,144
42135,FremontBridge,07/24/2017 03:00:00 PM,48,-122,103,71,174
42136,FremontBridge,07/24/2017 04:00:00 PM,48,-122,316,115,431
42137,FremontBridge,07/24/2017 05:00:00 PM,48,-122,598,185,783
42138,FremontBridge,07/24/2017 06:00:00 PM,48,-122,368,173,541
42139,FremontBridge,07/24/2017 07:00:00 PM,48,-122,168,91,259
42140,FremontBridge,07/24/2017 08:00:00 PM,48,-122,96,63,159
42141,FremontBridge,07/24/2017 09:00:00 PM,48,-122,63,41,104
42142,FremontBridge,07/24/2017 10:00:00 PM,48,-122,28,32,60
42143,FremontBridge,07/24/2017 11:00:00 PM,48,-122,25,11,36
42144,FremontBridge,07/25/2017 12:00:00 AM,48,-122,8,3,11
42145,FremontBridge,07/25/2017 01:00:00 AM,48,-122,2,7,9
42146,FremontBridge,07/25/2017 02:00:00 AM,48,-122,1,1,2
42147,FremontBridge,07/25/2017 03:00:00 AM,48,-122,3,2,5
42148,FremontBridge,07/25/2017 04:00:00 AM,48,-122,6,6,12
42149,FremontBridge,07/25/2017 05:00:00 AM,48,-122,19,33,52
42150,FremontBridge,07/25/2017 06:00:00 AM,48,-122,90,106,196
42151,FremontBridge,07/25/2017 07:00:00 AM,48,-122,260,274,534
42152,FremontBridge,07/25/2017 08:00:00 AM,48,-122,309,398,707
42153,FremontBridge,07/25/2017 09:00:00 AM,48,-122,188,155,343
42154,FremontBridge,07/25/2017 10:00:00 AM,48,-122,69,64,133
42155,FremontBridge,07/25/2017 11:00:00 AM,48,-122,57,58,115
42156,FremontBridge,07/25/2017 12:00:00 PM,48,-122,59,49,108
42157,FremontBridge,07/25/2017 01:00:00 PM,48,-122,36,60,96
42158,FremontBridge,07/25/2017 02:00:00 PM,48,-122,81,69,150
42159,FremontBridge,07/25/2017 03:00:00 PM,48,-122,93,77,170
42160,FremontBridge,07/25/2017 04:00:00 PM,48,-122,297,107,404
42161,FremontBridge,07/25/2017 05:00:00 PM,48,-122,593,205,798
42162,FremontBridge,07/25/2017 06:00:00 PM,48,-122,369,160,529
42163,FremontBridge,07/25/2017 07:00:00 PM,48,-122,226,107,333
42164,FremontBridge,07/25/2017 08:00:00 PM,48,-122,113,72,185
42165,FremontBridge,07/25/2017 09:00:00 PM,48,-122,61,49,110
42166,FremontBridge,07/25/2017 10:00:00 PM,48,-122,34,27,61
42167,FremontBridge,07/25/2017 11:00:00 PM,48,-122,16,15,31
42168,FremontBridge,07/26/2017 12:00:00 AM,48,-122,11,6,17
42169,FremontBridge,07/26/2017 01:00:00 AM,48,-122,0,5,5
42170,FremontBridge,07/26/2017 02:00:00 AM,48,-122,2,2,4
42171,FremontBridge,07/26/2017 03:00:00 AM,48,-122,1,0,1
42172,FremontBridge,07/26/2017 04:00:00 AM,48,-122,8,6,14
42173,FremontBridge,07/26/2017 05:00:00 AM,48,-122,18,28,46
42174,FremontBridge,07/26/2017 06:00:00 AM,48,-122,86,119,205
42175,FremontBridge,07/26/2017 07:00:00 AM,48,-122,231,276,507
42176,FremontBridge,07/26/2017 08:00:00 AM,48,-122,293,357,650
42177,FremontBridge,07/26/2017 09:00:00 AM,48,-122,181,167,348
42178,FremontBridge,07/26/2017 10:00:00 AM,48,-122,91,72,163
42179,FremontBridge,07/26/2017 11:00:00 AM,48,-122,49,61,110
42180,FremontBridge,07/26/2017 12:00:00 PM,48,-122,44,62,106
42181,FremontBridge,07/26/2017 01:00:00 PM,48,-122,62,44,106
42182,FremontBridge,07/26/2017 02:00:00 PM,48,-122,92,42,134
42183,FremontBridge,07/26/2017 03:00:00 PM,48,-122,119,75,194
42184,FremontBridge,07/26/2017 04:00:00 PM,48,-122,292,110,402
42185,FremontBridge,07/26/2017 05:00:00 PM,48,-122,571,217,788
42186,FremontBridge,07/26/2017 06:00:00 PM,48,-122,384,167,551
42187,FremontBridge,07/26/2017 07:00:00 PM,48,-122,204,93,297
42188,FremontBridge,07/26/2017 08:00:00 PM,48,-122,138,67,205
42189,FremontBridge,07/26/2017 09:00:00 PM,48,-122,63,52,115
42190,FremontBridge,07/26/2017 10:00:00 PM,48,-122,47,38,85
42191,FremontBridge,07/26/2017 11:00:00 PM,48,-122,23,11,34
42192,FremontBridge,07/27/2017 12:00:00 AM,48,-122,7,7,14
42193,FremontBridge,07/27/2017 01:00:00 AM,48,-122,7,7,14
42194,FremontBridge,07/27/2017 02:00:00 AM,48,-122,3,3,6
42195,FremontBridge,07/27/2017 03:00:00 AM,48,-122,2,2,4
42196,FremontBridge,07/27/2017 04:00:00 AM,48,-122,7,10,17
42197,FremontBridge,07/27/2017 05:00:00 AM,48,-122,24,35,59
42198,FremontBridge,07/27/2017 06:00:00 AM,48,-122,74,101,175
42199,FremontBridge,07/27/2017 07:00:00 AM,48,-122,151,184,335
42200,FremontBridge,07/27/2017 08:00:00 AM,48,-122,242,257,499
42201,FremontBridge,07/27/2017 09:00:00 AM,48,-122,126,130,256
42202,FremontBridge,07/27/2017 10:00:00 AM,48,-122,65,63,128
42203,FremontBridge,07/27/2017 11:00:00 AM,48,-122,44,41,85
42204,FremontBridge,07/27/2017 12:00:00 PM,48,-122,27,44,71
42205,FremontBridge,07/27/2017 01:00:00 PM,48,-122,38,46,84
42206,FremontBridge,07/27/2017 02:00:00 PM,48,-122,53,59,112
42207,FremontBridge,07/27/2017 03:00:00 PM,48,-122,108,55,163
42208,FremontBridge,07/27/2017 04:00:00 PM,48,-122,229,96,325
42209,FremontBridge,07/27/2017 05:00:00 PM,48,-122,444,169,613
42210,FremontBridge,07/27/2017 06:00:00 PM,48,-122,290,127,417
42211,FremontBridge,07/27/2017 07:00:00 PM,48,-122,175,77,252
42212,FremontBridge,07/27/2017 08:00:00 PM,48,-122,97,72,169
42213,FremontBridge,07/27/2017 09:00:00 PM,48,-122,57,48,105
42214,FremontBridge,07/27/2017 10:00:00 PM,48,-122,29,19,48
42215,FremontBridge,07/27/2017 11:00:00 PM,48,-122,19,10,29
42216,FremontBridge,07/28/2017 12:00:00 AM,48,-122,8,7,15
42217,FremontBridge,07/28/2017 01:00:00 AM,48,-122,4,4,8
42218,FremontBridge,07/28/2017 02:00:00 AM,48,-122,1,1,2
42219,FremontBridge,07/28/2017 03:00:00 AM,48,-122,2,0,2
42220,FremontBridge,07/28/2017 04:00:00 AM,48,-122,5,6,11
42221,FremontBridge,07/28/2017 05:00:00 AM,48,-122,15,30,45
42222,FremontBridge,07/28/2017 06:00:00 AM,48,-122,71,79,150
42223,FremontBridge,07/28/2017 07:00:00 AM,48,-122,161,192,353
42224,FremontBridge,07/28/2017 08:00:00 AM,48,-122,248,285,533
42225,FremontBridge,07/28/2017 09:00:00 AM,48,-122,154,143,297
42226,FremontBridge,07/28/2017 10:00:00 AM,48,-122,86,64,150
42227,FremontBridge,07/28/2017 11:00:00 AM,48,-122,59,58,117
42228,FremontBridge,07/28/2017 12:00:00 PM,48,-122,58,61,119
42229,FremontBridge,07/28/2017 01:00:00 PM,48,-122,67,47,114
42230,FremontBridge,07/28/2017 02:00:00 PM,48,-122,101,72,173
42231,FremontBridge,07/28/2017 03:00:00 PM,48,-122,149,83,232
42232,FremontBridge,07/28/2017 04:00:00 PM,48,-122,294,91,385
42233,FremontBridge,07/28/2017 05:00:00 PM,48,-122,456,196,652
42234,FremontBridge,07/28/2017 06:00:00 PM,48,-122,288,110,398
42235,FremontBridge,07/28/2017 07:00:00 PM,48,-122,127,82,209
42236,FremontBridge,07/28/2017 08:00:00 PM,48,-122,83,45,128
42237,FremontBridge,07/28/2017 09:00:00 PM,48,-122,57,49,106
42238,FremontBridge,07/28/2017 10:00:00 PM,48,-122,37,30,67
42239,FremontBridge,07/28/2017 11:00:00 PM,48,-122,30,15,45
42240,FremontBridge,07/29/2017 12:00:00 AM,48,-122,19,11,30
42241,FremontBridge,07/29/2017 01:00:00 AM,48,-122,12,6,18
42242,FremontBridge,07/29/2017 02:00:00 AM,48,-122,3,9,12
42243,FremontBridge,07/29/2017 03:00:00 AM,48,-122,3,1,4
42244,FremontBridge,07/29/2017 04:00:00 AM,48,-122,2,3,5
42245,FremontBridge,07/29/2017 05:00:00 AM,48,-122,6,6,12
42246,FremontBridge,07/29/2017 06:00:00 AM,48,-122,18,15,33
42247,FremontBridge,07/29/2017 07:00:00 AM,48,-122,42,23,65
42248,FremontBridge,07/29/2017 08:00:00 AM,48,-122,44,44,88
42249,FremontBridge,07/29/2017 09:00:00 AM,48,-122,75,59,134
42250,FremontBridge,07/29/2017 10:00:00 AM,48,-122,79,89,168
42251,FremontBridge,07/29/2017 11:00:00 AM,48,-122,98,108,206
42252,FremontBridge,07/29/2017 12:00:00 PM,48,-122,81,101,182
42253,FremontBridge,07/29/2017 01:00:00 PM,48,-122,122,102,224
42254,FremontBridge,07/29/2017 02:00:00 PM,48,-122,91,117,208
42255,FremontBridge,07/29/2017 03:00:00 PM,48,-122,106,93,199
42256,FremontBridge,07/29/2017 04:00:00 PM,48,-122,90,91,181
42257,FremontBridge,07/29/2017 05:00:00 PM,48,-122,90,71,161
42258,FremontBridge,07/29/2017 06:00:00 PM,48,-122,82,76,158
42259,FremontBridge,07/29/2017 07:00:00 PM,48,-122,47,52,99
42260,FremontBridge,07/29/2017 08:00:00 PM,48,-122,41,49,90
42261,FremontBridge,07/29/2017 09:00:00 PM,48,-122,37,32,69
42262,FremontBridge,07/29/2017 10:00:00 PM,48,-122,29,20,49
42263,FremontBridge,07/29/2017 11:00:00 PM,48,-122,24,16,40
42264,FremontBridge,07/30/2017 12:00:00 AM,48,-122,22,11,33
42265,FremontBridge,07/30/2017 01:00:00 AM,48,-122,14,8,22
42266,FremontBridge,07/30/2017 02:00:00 AM,48,-122,5,3,8
42267,FremontBridge,07/30/2017 03:00:00 AM,48,-122,3,1,4
42268,FremontBridge,07/30/2017 04:00:00 AM,48,-122,2,5,7
42269,FremontBridge,07/30/2017 05:00:00 AM,48,-122,3,10,13
42270,FremontBridge,07/30/2017 06:00:00 AM,48,-122,15,13,28
42271,FremontBridge,07/30/2017 07:00:00 AM,48,-122,11,26,37
42272,FremontBridge,07/30/2017 08:00:00 AM,48,-122,36,40,76
42273,FremontBridge,07/30/2017 09:00:00 AM,48,-122,39,54,93
42274,FremontBridge,07/30/2017 10:00:00 AM,48,-122,80,48,128
42275,FremontBridge,07/30/2017 11:00:00 AM,48,-122,86,70,156
42276,FremontBridge,07/30/2017 12:00:00 PM,48,-122,84,105,189
42277,FremontBridge,07/30/2017 01:00:00 PM,48,-122,104,89,193
42278,FremontBridge,07/30/2017 02:00:00 PM,48,-122,110,89,199
42279,FremontBridge,07/30/2017 03:00:00 PM,48,-122,95,82,177
42280,FremontBridge,07/30/2017 04:00:00 PM,48,-122,97,82,179
42281,FremontBridge,07/30/2017 05:00:00 PM,48,-122,100,103,203
42282,FremontBridge,07/30/2017 06:00:00 PM,48,-122,92,60,152
42283,FremontBridge,07/30/2017 07:00:00 PM,48,-122,70,46,116
42284,FremontBridge,07/30/2017 08:00:00 PM,48,-122,47,49,96
42285,FremontBridge,07/30/2017 09:00:00 PM,48,-122,34,18,52
42286,FremontBridge,07/30/2017 10:00:00 PM,48,-122,13,21,34
42287,FremontBridge,07/30/2017 11:00:00 PM,48,-122,12,12,24
42288,FremontBridge,07/31/2017 12:00:00 AM,48,-122,3,2,5
42289,FremontBridge,07/31/2017 01:00:00 AM,48,-122,2,5,7
42290,FremontBridge,07/31/2017 02:00:00 AM,48,-122,0,1,1
42291,FremontBridge,07/31/2017 03:00:00 AM,48,-122,0,2,2
42292,FremontBridge,07/31/2017 04:00:00 AM,48,-122,5,6,11
42293,FremontBridge,07/31/2017 05:00:00 AM,48,-122,20,32,52
42294,FremontBridge,07/31/2017 06:00:00 AM,48,-122,67,99,166
42295,FremontBridge,07/31/2017 07:00:00 AM,48,-122,223,269,492
42296,FremontBridge,07/31/2017 08:00:00 AM,48,-122,312,348,660
42297,FremontBridge,07/31/2017 09:00:00 AM,48,-122,192,172,364
42298,FremontBridge,07/31/2017 10:00:00 AM,48,-122,75,73,148
42299,FremontBridge,07/31/2017 11:00:00 AM,48,-122,61,58,119
42300,FremontBridge,07/31/2017 12:00:00 PM,48,-122,51,56,107
42301,FremontBridge,07/31/2017 01:00:00 PM,48,-122,63,44,107
42302,FremontBridge,07/31/2017 02:00:00 PM,48,-122,77,68,145
42303,FremontBridge,07/31/2017 03:00:00 PM,48,-122,93,74,167
42304,FremontBridge,07/31/2017 04:00:00 PM,48,-122,261,104,365
42305,FremontBridge,07/31/2017 05:00:00 PM,48,-122,641,199,840
42306,FremontBridge,07/31/2017 06:00:00 PM,48,-122,393,162,555
42307,FremontBridge,07/31/2017 07:00:00 PM,48,-122,182,88,270
42308,FremontBridge,07/31/2017 08:00:00 PM,48,-122,98,56,154
42309,FremontBridge,07/31/2017 09:00:00 PM,48,-122,53,53,106
42310,FremontBridge,07/31/2017 10:00:00 PM,48,-122,28,13,41
42311,FremontBridge,07/31/2017 11:00:00 PM,48,-122,26,12,38
42312,FremontBridge,08/01/2017 12:00:00 AM,48,-122,10,8,18
42313,FremontBridge,08/01/2017 01:00:00 AM,48,-122,5,3,8
42314,FremontBridge,08/01/2017 02:00:00 AM,48,-122,4,1,5
42315,FremontBridge,08/01/2017 03:00:00 AM,48,-122,1,1,2
42316,FremontBridge,08/01/2017 04:00:00 AM,48,-122,5,7,12
42317,FremontBridge,08/01/2017 05:00:00 AM,48,-122,21,30,51
42318,FremontBridge,08/01/2017 06:00:00 AM,48,-122,95,114,209
42319,FremontBridge,08/01/2017 07:00:00 AM,48,-122,232,281,513
42320,FremontBridge,08/01/2017 08:00:00 AM,48,-122,339,395,734
42321,FremontBridge,08/01/2017 09:00:00 AM,48,-122,151,192,343
42322,FremontBridge,08/01/2017 10:00:00 AM,48,-122,76,84,160
42323,FremontBridge,08/01/2017 11:00:00 AM,48,-122,54,55,109
42324,FremontBridge,08/01/2017 12:00:00 PM,48,-122,48,64,112
42325,FremontBridge,08/01/2017 01:00:00 PM,48,-122,63,56,119
42326,FremontBridge,08/01/2017 02:00:00 PM,48,-122,59,46,105
42327,FremontBridge,08/01/2017 03:00:00 PM,48,-122,118,76,194
42328,FremontBridge,08/01/2017 04:00:00 PM,48,-122,325,111,436
42329,FremontBridge,08/01/2017 05:00:00 PM,48,-122,621,214,835
42330,FremontBridge,08/01/2017 06:00:00 PM,48,-122,371,137,508
42331,FremontBridge,08/01/2017 07:00:00 PM,48,-122,208,103,311
42332,FremontBridge,08/01/2017 08:00:00 PM,48,-122,116,72,188
42333,FremontBridge,08/01/2017 09:00:00 PM,48,-122,63,41,104
42334,FremontBridge,08/01/2017 10:00:00 PM,48,-122,26,24,50
42335,FremontBridge,08/01/2017 11:00:00 PM,48,-122,22,18,40
42336,FremontBridge,08/02/2017 12:00:00 AM,48,-122,11,5,16
42337,FremontBridge,08/02/2017 01:00:00 AM,48,-122,3,2,5
42338,FremontBridge,08/02/2017 02:00:00 AM,48,-122,3,3,6
42339,FremontBridge,08/02/2017 03:00:00 AM,48,-122,1,1,2
42340,FremontBridge,08/02/2017 04:00:00 AM,48,-122,6,5,11
42341,FremontBridge,08/02/2017 05:00:00 AM,48,-122,17,35,52
42342,FremontBridge,08/02/2017 06:00:00 AM,48,-122,80,109,189
42343,FremontBridge,08/02/2017 07:00:00 AM,48,-122,202,281,483
42344,FremontBridge,08/02/2017 08:00:00 AM,48,-122,281,325,606
42345,FremontBridge,08/02/2017 09:00:00 AM,48,-122,203,170,373
42346,FremontBridge,08/02/2017 10:00:00 AM,48,-122,70,73,143
42347,FremontBridge,08/02/2017 11:00:00 AM,48,-122,64,42,106
42348,FremontBridge,08/02/2017 12:00:00 PM,48,-122,58,54,112
42349,FremontBridge,08/02/2017 01:00:00 PM,48,-122,63,44,107
42350,FremontBridge,08/02/2017 02:00:00 PM,48,-122,68,47,115
42351,FremontBridge,08/02/2017 03:00:00 PM,48,-122,112,52,164
42352,FremontBridge,08/02/2017 04:00:00 PM,48,-122,272,117,389
42353,FremontBridge,08/02/2017 05:00:00 PM,48,-122,576,174,750
42354,FremontBridge,08/02/2017 06:00:00 PM,48,-122,336,135,471
42355,FremontBridge,08/02/2017 07:00:00 PM,48,-122,176,95,271
42356,FremontBridge,08/02/2017 08:00:00 PM,48,-122,92,66,158
42357,FremontBridge,08/02/2017 09:00:00 PM,48,-122,56,51,107
42358,FremontBridge,08/02/2017 10:00:00 PM,48,-122,44,16,60
42359,FremontBridge,08/02/2017 11:00:00 PM,48,-122,15,9,24
42360,FremontBridge,08/03/2017 12:00:00 AM,48,-122,5,9,14
42361,FremontBridge,08/03/2017 01:00:00 AM,48,-122,3,3,6
42362,FremontBridge,08/03/2017 02:00:00 AM,48,-122,0,0,0
42363,FremontBridge,08/03/2017 03:00:00 AM,48,-122,0,2,2
42364,FremontBridge,08/03/2017 04:00:00 AM,48,-122,6,6,12
42365,FremontBridge,08/03/2017 05:00:00 AM,48,-122,16,23,39
42366,FremontBridge,08/03/2017 06:00:00 AM,48,-122,46,84,130
42367,FremontBridge,08/03/2017 07:00:00 AM,48,-122,189,198,387
42368,FremontBridge,08/03/2017 08:00:00 AM,48,-122,289,274,563
42369,FremontBridge,08/03/2017 09:00:00 AM,48,-122,153,164,317
42370,FremontBridge,08/03/2017 10:00:00 AM,48,-122,71,50,121
42371,FremontBridge,08/03/2017 11:00:00 AM,48,-122,48,45,93
42372,FremontBridge,08/03/2017 12:00:00 PM,48,-122,45,45,90
42373,FremontBridge,08/03/2017 01:00:00 PM,48,-122,66,46,112
42374,FremontBridge,08/03/2017 02:00:00 PM,48,-122,62,40,102
42375,FremontBridge,08/03/2017 03:00:00 PM,48,-122,86,48,134
42376,FremontBridge,08/03/2017 04:00:00 PM,48,-122,228,94,322
42377,FremontBridge,08/03/2017 05:00:00 PM,48,-122,460,142,602
42378,FremontBridge,08/03/2017 06:00:00 PM,48,-122,282,163,445
42379,FremontBridge,08/03/2017 07:00:00 PM,48,-122,169,86,255
42380,FremontBridge,08/03/2017 08:00:00 PM,48,-122,90,53,143
42381,FremontBridge,08/03/2017 09:00:00 PM,48,-122,64,46,110
42382,FremontBridge,08/03/2017 10:00:00 PM,48,-122,31,24,55
42383,FremontBridge,08/03/2017 11:00:00 PM,48,-122,28,15,43
42384,FremontBridge,08/04/2017 12:00:00 AM,48,-122,10,3,13
42385,FremontBridge,08/04/2017 01:00:00 AM,48,-122,10,7,17
42386,FremontBridge,08/04/2017 02:00:00 AM,48,-122,7,6,13
42387,FremontBridge,08/04/2017 03:00:00 AM,48,-122,1,0,1
42388,FremontBridge,08/04/2017 04:00:00 AM,48,-122,7,6,13
42389,FremontBridge,08/04/2017 05:00:00 AM,48,-122,13,33,46
42390,FremontBridge,08/04/2017 06:00:00 AM,48,-122,60,66,126
42391,FremontBridge,08/04/2017 07:00:00 AM,48,-122,155,191,346
42392,FremontBridge,08/04/2017 08:00:00 AM,48,-122,239,242,481
42393,FremontBridge,08/04/2017 09:00:00 AM,48,-122,141,127,268
42394,FremontBridge,08/04/2017 10:00:00 AM,48,-122,76,73,149
42395,FremontBridge,08/04/2017 11:00:00 AM,48,-122,63,47,110
42396,FremontBridge,08/04/2017 12:00:00 PM,48,-122,62,55,117
42397,FremontBridge,08/04/2017 01:00:00 PM,48,-122,53,66,119
42398,FremontBridge,08/04/2017 02:00:00 PM,48,-122,81,35,116
42399,FremontBridge,08/04/2017 03:00:00 PM,48,-122,107,54,161
42400,FremontBridge,08/04/2017 04:00:00 PM,48,-122,259,99,358
42401,FremontBridge,08/04/2017 05:00:00 PM,48,-122,371,104,475
42402,FremontBridge,08/04/2017 06:00:00 PM,48,-122,196,110,306
42403,FremontBridge,08/04/2017 07:00:00 PM,48,-122,139,72,211
42404,FremontBridge,08/04/2017 08:00:00 PM,48,-122,69,41,110
42405,FremontBridge,08/04/2017 09:00:00 PM,48,-122,55,33,88
42406,FremontBridge,08/04/2017 10:00:00 PM,48,-122,38,27,65
42407,FremontBridge,08/04/2017 11:00:00 PM,48,-122,14,12,26
42408,FremontBridge,08/05/2017 12:00:00 AM,48,-122,14,8,22
42409,FremontBridge,08/05/2017 01:00:00 AM,48,-122,6,9,15
42410,FremontBridge,08/05/2017 02:00:00 AM,48,-122,7,6,13
42411,FremontBridge,08/05/2017 03:00:00 AM,48,-122,3,2,5
42412,FremontBridge,08/05/2017 04:00:00 AM,48,-122,2,2,4
42413,FremontBridge,08/05/2017 05:00:00 AM,48,-122,5,7,12
42414,FremontBridge,08/05/2017 06:00:00 AM,48,-122,11,8,19
42415,FremontBridge,08/05/2017 07:00:00 AM,48,-122,31,22,53
42416,FremontBridge,08/05/2017 08:00:00 AM,48,-122,42,46,88
42417,FremontBridge,08/05/2017 09:00:00 AM,48,-122,59,83,142
42418,FremontBridge,08/05/2017 10:00:00 AM,48,-122,53,75,128
42419,FremontBridge,08/05/2017 11:00:00 AM,48,-122,55,68,123
42420,FremontBridge,08/05/2017 12:00:00 PM,48,-122,81,80,161
42421,FremontBridge,08/05/2017 01:00:00 PM,48,-122,76,83,159
42422,FremontBridge,08/05/2017 02:00:00 PM,48,-122,75,85,160
42423,FremontBridge,08/05/2017 03:00:00 PM,48,-122,81,88,169
42424,FremontBridge,08/05/2017 04:00:00 PM,48,-122,99,77,176
42425,FremontBridge,08/05/2017 05:00:00 PM,48,-122,80,70,150
42426,FremontBridge,08/05/2017 06:00:00 PM,48,-122,58,48,106
42427,FremontBridge,08/05/2017 07:00:00 PM,48,-122,60,56,116
42428,FremontBridge,08/05/2017 08:00:00 PM,48,-122,36,26,62
42429,FremontBridge,08/05/2017 09:00:00 PM,48,-122,33,24,57
42430,FremontBridge,08/05/2017 10:00:00 PM,48,-122,30,19,49
42431,FremontBridge,08/05/2017 11:00:00 PM,48,-122,29,8,37
42432,FremontBridge,08/06/2017 12:00:00 AM,48,-122,23,9,32
42433,FremontBridge,08/06/2017 01:00:00 AM,48,-122,22,7,29
42434,FremontBridge,08/06/2017 02:00:00 AM,48,-122,10,4,14
42435,FremontBridge,08/06/2017 03:00:00 AM,48,-122,4,4,8
42436,FremontBridge,08/06/2017 04:00:00 AM,48,-122,3,2,5
42437,FremontBridge,08/06/2017 05:00:00 AM,48,-122,4,6,10
42438,FremontBridge,08/06/2017 06:00:00 AM,48,-122,4,9,13
42439,FremontBridge,08/06/2017 07:00:00 AM,48,-122,29,27,56
42440,FremontBridge,08/06/2017 08:00:00 AM,48,-122,61,46,107
42441,FremontBridge,08/06/2017 09:00:00 AM,48,-122,62,59,121
42442,FremontBridge,08/06/2017 10:00:00 AM,48,-122,78,81,159
42443,FremontBridge,08/06/2017 11:00:00 AM,48,-122,102,79,181
42444,FremontBridge,08/06/2017 12:00:00 PM,48,-122,100,95,195
42445,FremontBridge,08/06/2017 01:00:00 PM,48,-122,104,92,196
42446,FremontBridge,08/06/2017 02:00:00 PM,48,-122,58,89,147
42447,FremontBridge,08/06/2017 03:00:00 PM,48,-122,89,86,175
42448,FremontBridge,08/06/2017 04:00:00 PM,48,-122,83,100,183
42449,FremontBridge,08/06/2017 05:00:00 PM,48,-122,84,74,158
42450,FremontBridge,08/06/2017 06:00:00 PM,48,-122,77,50,127
42451,FremontBridge,08/06/2017 07:00:00 PM,48,-122,49,49,98
42452,FremontBridge,08/06/2017 08:00:00 PM,48,-122,48,28,76
42453,FremontBridge,08/06/2017 09:00:00 PM,48,-122,20,15,35
42454,FremontBridge,08/06/2017 10:00:00 PM,48,-122,15,12,27
42455,FremontBridge,08/06/2017 11:00:00 PM,48,-122,10,10,20
42456,FremontBridge,08/07/2017 12:00:00 AM,48,-122,6,1,7
42457,FremontBridge,08/07/2017 01:00:00 AM,48,-122,0,2,2
42458,FremontBridge,08/07/2017 02:00:00 AM,48,-122,0,3,3
42459,FremontBridge,08/07/2017 03:00:00 AM,48,-122,0,2,2
42460,FremontBridge,08/07/2017 04:00:00 AM,48,-122,6,4,10
42461,FremontBridge,08/07/2017 05:00:00 AM,48,-122,23,32,55
42462,FremontBridge,08/07/2017 06:00:00 AM,48,-122,73,96,169
42463,FremontBridge,08/07/2017 07:00:00 AM,48,-122,205,224,429
42464,FremontBridge,08/07/2017 08:00:00 AM,48,-122,315,298,613
42465,FremontBridge,08/07/2017 09:00:00 AM,48,-122,148,147,295
42466,FremontBridge,08/07/2017 10:00:00 AM,48,-122,69,58,127
42467,FremontBridge,08/07/2017 11:00:00 AM,48,-122,57,49,106
42468,FremontBridge,08/07/2017 12:00:00 PM,48,-122,58,45,103
42469,FremontBridge,08/07/2017 01:00:00 PM,48,-122,47,42,89
42470,FremontBridge,08/07/2017 02:00:00 PM,48,-122,62,61,123
42471,FremontBridge,08/07/2017 03:00:00 PM,48,-122,91,73,164
42472,FremontBridge,08/07/2017 04:00:00 PM,48,-122,267,101,368
42473,FremontBridge,08/07/2017 05:00:00 PM,48,-122,550,185,735
42474,FremontBridge,08/07/2017 06:00:00 PM,48,-122,349,145,494
42475,FremontBridge,08/07/2017 07:00:00 PM,48,-122,170,87,257
42476,FremontBridge,08/07/2017 08:00:00 PM,48,-122,86,66,152
42477,FremontBridge,08/07/2017 09:00:00 PM,48,-122,47,28,75
42478,FremontBridge,08/07/2017 10:00:00 PM,48,-122,29,23,52
42479,FremontBridge,08/07/2017 11:00:00 PM,48,-122,9,9,18
42480,FremontBridge,08/08/2017 12:00:00 AM,48,-122,7,7,14
42481,FremontBridge,08/08/2017 01:00:00 AM,48,-122,5,5,10
42482,FremontBridge,08/08/2017 02:00:00 AM,48,-122,1,3,4
42483,FremontBridge,08/08/2017 03:00:00 AM,48,-122,3,1,4
42484,FremontBridge,08/08/2017 04:00:00 AM,48,-122,5,11,16
42485,FremontBridge,08/08/2017 05:00:00 AM,48,-122,12,42,54
42486,FremontBridge,08/08/2017 06:00:00 AM,48,-122,99,109,208
42487,FremontBridge,08/08/2017 07:00:00 AM,48,-122,220,272,492
42488,FremontBridge,08/08/2017 08:00:00 AM,48,-122,308,332,640
42489,FremontBridge,08/08/2017 09:00:00 AM,48,-122,182,170,352
42490,FremontBridge,08/08/2017 10:00:00 AM,48,-122,73,52,125
42491,FremontBridge,08/08/2017 11:00:00 AM,48,-122,52,50,102
42492,FremontBridge,08/08/2017 12:00:00 PM,48,-122,40,63,103
42493,FremontBridge,08/08/2017 01:00:00 PM,48,-122,45,47,92
42494,FremontBridge,08/08/2017 02:00:00 PM,48,-122,64,45,109
42495,FremontBridge,08/08/2017 03:00:00 PM,48,-122,101,57,158
42496,FremontBridge,08/08/2017 04:00:00 PM,48,-122,288,107,395
42497,FremontBridge,08/08/2017 05:00:00 PM,48,-122,610,180,790
42498,FremontBridge,08/08/2017 06:00:00 PM,48,-122,317,169,486
42499,FremontBridge,08/08/2017 07:00:00 PM,48,-122,213,98,311
42500,FremontBridge,08/08/2017 08:00:00 PM,48,-122,95,74,169
42501,FremontBridge,08/08/2017 09:00:00 PM,48,-122,60,51,111
42502,FremontBridge,08/08/2017 10:00:00 PM,48,-122,24,19,43
42503,FremontBridge,08/08/2017 11:00:00 PM,48,-122,26,6,32
42504,FremontBridge,08/09/2017 12:00:00 AM,48,-122,5,10,15
42505,FremontBridge,08/09/2017 01:00:00 AM,48,-122,4,1,5
42506,FremontBridge,08/09/2017 02:00:00 AM,48,-122,3,4,7
42507,FremontBridge,08/09/2017 03:00:00 AM,48,-122,1,1,2
42508,FremontBridge,08/09/2017 04:00:00 AM,48,-122,10,7,17
42509,FremontBridge,08/09/2017 05:00:00 AM,48,-122,15,32,47
42510,FremontBridge,08/09/2017 06:00:00 AM,48,-122,79,95,174
42511,FremontBridge,08/09/2017 07:00:00 AM,48,-122,211,249,460
42512,FremontBridge,08/09/2017 08:00:00 AM,48,-122,313,324,637
42513,FremontBridge,08/09/2017 09:00:00 AM,48,-122,166,150,316
42514,FremontBridge,08/09/2017 10:00:00 AM,48,-122,77,66,143
42515,FremontBridge,08/09/2017 11:00:00 AM,48,-122,57,61,118
42516,FremontBridge,08/09/2017 12:00:00 PM,48,-122,49,47,96
42517,FremontBridge,08/09/2017 01:00:00 PM,48,-122,61,68,129
42518,FremontBridge,08/09/2017 02:00:00 PM,48,-122,64,47,111
42519,FremontBridge,08/09/2017 03:00:00 PM,48,-122,104,56,160
42520,FremontBridge,08/09/2017 04:00:00 PM,48,-122,242,120,362
42521,FremontBridge,08/09/2017 05:00:00 PM,48,-122,566,171,737
42522,FremontBridge,08/09/2017 06:00:00 PM,48,-122,402,152,554
42523,FremontBridge,08/09/2017 07:00:00 PM,48,-122,165,95,260
42524,FremontBridge,08/09/2017 08:00:00 PM,48,-122,90,65,155
42525,FremontBridge,08/09/2017 09:00:00 PM,48,-122,55,56,111
42526,FremontBridge,08/09/2017 10:00:00 PM,48,-122,28,26,54
42527,FremontBridge,08/09/2017 11:00:00 PM,48,-122,17,12,29
42528,FremontBridge,08/10/2017 12:00:00 AM,48,-122,11,18,29
42529,FremontBridge,08/10/2017 01:00:00 AM,48,-122,6,2,8
42530,FremontBridge,08/10/2017 02:00:00 AM,48,-122,2,3,5
42531,FremontBridge,08/10/2017 03:00:00 AM,48,-122,3,1,4
42532,FremontBridge,08/10/2017 04:00:00 AM,48,-122,6,5,11
42533,FremontBridge,08/10/2017 05:00:00 AM,48,-122,19,28,47
42534,FremontBridge,08/10/2017 06:00:00 AM,48,-122,63,81,144
42535,FremontBridge,08/10/2017 07:00:00 AM,48,-122,199,252,451
42536,FremontBridge,08/10/2017 08:00:00 AM,48,-122,276,283,559
42537,FremontBridge,08/10/2017 09:00:00 AM,48,-122,155,152,307
42538,FremontBridge,08/10/2017 10:00:00 AM,48,-122,67,70,137
42539,FremontBridge,08/10/2017 11:00:00 AM,48,-122,44,49,93
42540,FremontBridge,08/10/2017 12:00:00 PM,48,-122,48,46,94
42541,FremontBridge,08/10/2017 01:00:00 PM,48,-122,58,48,106
42542,FremontBridge,08/10/2017 02:00:00 PM,48,-122,62,61,123
42543,FremontBridge,08/10/2017 03:00:00 PM,48,-122,92,78,170
42544,FremontBridge,08/10/2017 04:00:00 PM,48,-122,288,103,391
42545,FremontBridge,08/10/2017 05:00:00 PM,48,-122,504,180,684
42546,FremontBridge,08/10/2017 06:00:00 PM,48,-122,292,148,440
42547,FremontBridge,08/10/2017 07:00:00 PM,48,-122,186,94,280
42548,FremontBridge,08/10/2017 08:00:00 PM,48,-122,117,69,186
42549,FremontBridge,08/10/2017 09:00:00 PM,48,-122,46,32,78
42550,FremontBridge,08/10/2017 10:00:00 PM,48,-122,33,23,56
42551,FremontBridge,08/10/2017 11:00:00 PM,48,-122,19,14,33
42552,FremontBridge,08/11/2017 12:00:00 AM,48,-122,15,7,22
42553,FremontBridge,08/11/2017 01:00:00 AM,48,-122,1,3,4
42554,FremontBridge,08/11/2017 02:00:00 AM,48,-122,5,1,6
42555,FremontBridge,08/11/2017 03:00:00 AM,48,-122,1,1,2
42556,FremontBridge,08/11/2017 04:00:00 AM,48,-122,3,7,10
42557,FremontBridge,08/11/2017 05:00:00 AM,48,-122,22,25,47
42558,FremontBridge,08/11/2017 06:00:00 AM,48,-122,57,71,128
42559,FremontBridge,08/11/2017 07:00:00 AM,48,-122,162,190,352
42560,FremontBridge,08/11/2017 08:00:00 AM,48,-122,250,262,512
42561,FremontBridge,08/11/2017 09:00:00 AM,48,-122,132,120,252
42562,FremontBridge,08/11/2017 10:00:00 AM,48,-122,67,56,123
42563,FremontBridge,08/11/2017 11:00:00 AM,48,-122,59,50,109
42564,FremontBridge,08/11/2017 12:00:00 PM,48,-122,62,56,118
42565,FremontBridge,08/11/2017 01:00:00 PM,48,-122,67,60,127
42566,FremontBridge,08/11/2017 02:00:00 PM,48,-122,77,56,133
42567,FremontBridge,08/11/2017 03:00:00 PM,48,-122,161,75,236
42568,FremontBridge,08/11/2017 04:00:00 PM,48,-122,253,107,360
42569,FremontBridge,08/11/2017 05:00:00 PM,48,-122,451,169,620
42570,FremontBridge,08/11/2017 06:00:00 PM,48,-122,242,123,365
42571,FremontBridge,08/11/2017 07:00:00 PM,48,-122,133,88,221
42572,FremontBridge,08/11/2017 08:00:00 PM,48,-122,86,62,148
42573,FremontBridge,08/11/2017 09:00:00 PM,48,-122,39,20,59
42574,FremontBridge,08/11/2017 10:00:00 PM,48,-122,30,22,52
42575,FremontBridge,08/11/2017 11:00:00 PM,48,-122,24,12,36
42576,FremontBridge,08/12/2017 12:00:00 AM,48,-122,17,16,33
42577,FremontBridge,08/12/2017 01:00:00 AM,48,-122,11,5,16
42578,FremontBridge,08/12/2017 02:00:00 AM,48,-122,6,5,11
42579,FremontBridge,08/12/2017 03:00:00 AM,48,-122,2,1,3
42580,FremontBridge,08/12/2017 04:00:00 AM,48,-122,3,2,5
42581,FremontBridge,08/12/2017 05:00:00 AM,48,-122,5,5,10
42582,FremontBridge,08/12/2017 06:00:00 AM,48,-122,18,18,36
42583,FremontBridge,08/12/2017 07:00:00 AM,48,-122,31,25,56
42584,FremontBridge,08/12/2017 08:00:00 AM,48,-122,40,60,100
42585,FremontBridge,08/12/2017 09:00:00 AM,48,-122,49,41,90
42586,FremontBridge,08/12/2017 10:00:00 AM,48,-122,61,66,127
42587,FremontBridge,08/12/2017 11:00:00 AM,48,-122,79,55,134
42588,FremontBridge,08/12/2017 12:00:00 PM,48,-122,92,119,211
42589,FremontBridge,08/12/2017 01:00:00 PM,48,-122,94,95,189
42590,FremontBridge,08/12/2017 02:00:00 PM,48,-122,70,114,184
42591,FremontBridge,08/12/2017 03:00:00 PM,48,-122,106,102,208
42592,FremontBridge,08/12/2017 04:00:00 PM,48,-122,110,79,189
42593,FremontBridge,08/12/2017 05:00:00 PM,48,-122,107,75,182
42594,FremontBridge,08/12/2017 06:00:00 PM,48,-122,76,69,145
42595,FremontBridge,08/12/2017 07:00:00 PM,48,-122,49,54,103
42596,FremontBridge,08/12/2017 08:00:00 PM,48,-122,42,37,79
42597,FremontBridge,08/12/2017 09:00:00 PM,48,-122,26,19,45
42598,FremontBridge,08/12/2017 10:00:00 PM,48,-122,11,17,28
42599,FremontBridge,08/12/2017 11:00:00 PM,48,-122,14,7,21
42600,FremontBridge,08/13/2017 12:00:00 AM,48,-122,6,10,16
42601,FremontBridge,08/13/2017 01:00:00 AM,48,-122,6,4,10
42602,FremontBridge,08/13/2017 02:00:00 AM,48,-122,5,4,9
42603,FremontBridge,08/13/2017 03:00:00 AM,48,-122,1,1,2
42604,FremontBridge,08/13/2017 04:00:00 AM,48,-122,1,0,1
42605,FremontBridge,08/13/2017 05:00:00 AM,48,-122,2,3,5
42606,FremontBridge,08/13/2017 06:00:00 AM,48,-122,45,21,66
42607,FremontBridge,08/13/2017 07:00:00 AM,48,-122,22,33,55
42608,FremontBridge,08/13/2017 08:00:00 AM,48,-122,40,42,82
42609,FremontBridge,08/13/2017 09:00:00 AM,48,-122,50,42,92
42610,FremontBridge,08/13/2017 10:00:00 AM,48,-122,56,56,112
42611,FremontBridge,08/13/2017 11:00:00 AM,48,-122,165,38,203
42612,FremontBridge,08/13/2017 12:00:00 PM,48,-122,566,71,637
42613,FremontBridge,08/13/2017 01:00:00 PM,48,-122,456,89,545
42614,FremontBridge,08/13/2017 02:00:00 PM,48,-122,221,113,334
42615,FremontBridge,08/13/2017 03:00:00 PM,48,-122,233,142,375
42616,FremontBridge,08/13/2017 04:00:00 PM,48,-122,174,99,273
42617,FremontBridge,08/13/2017 05:00:00 PM,48,-122,90,72,162
42618,FremontBridge,08/13/2017 06:00:00 PM,48,-122,50,63,113
42619,FremontBridge,08/13/2017 07:00:00 PM,48,-122,31,36,67
42620,FremontBridge,08/13/2017 08:00:00 PM,48,-122,21,21,42
42621,FremontBridge,08/13/2017 09:00:00 PM,48,-122,19,14,33
42622,FremontBridge,08/13/2017 10:00:00 PM,48,-122,11,12,23
42623,FremontBridge,08/13/2017 11:00:00 PM,48,-122,7,4,11
42624,FremontBridge,08/14/2017 12:00:00 AM,48,-122,6,4,10
42625,FremontBridge,08/14/2017 01:00:00 AM,48,-122,0,5,5
42626,FremontBridge,08/14/2017 02:00:00 AM,48,-122,0,2,2
42627,FremontBridge,08/14/2017 03:00:00 AM,48,-122,1,1,2
42628,FremontBridge,08/14/2017 04:00:00 AM,48,-122,5,11,16
42629,FremontBridge,08/14/2017 05:00:00 AM,48,-122,14,30,44
42630,FremontBridge,08/14/2017 06:00:00 AM,48,-122,74,98,172
42631,FremontBridge,08/14/2017 07:00:00 AM,48,-122,195,237,432
42632,FremontBridge,08/14/2017 08:00:00 AM,48,-122,290,305,595
42633,FremontBridge,08/14/2017 09:00:00 AM,48,-122,168,161,329
42634,FremontBridge,08/14/2017 10:00:00 AM,48,-122,75,63,138
42635,FremontBridge,08/14/2017 11:00:00 AM,48,-122,41,55,96
42636,FremontBridge,08/14/2017 12:00:00 PM,48,-122,42,51,93
42637,FremontBridge,08/14/2017 01:00:00 PM,48,-122,50,51,101
42638,FremontBridge,08/14/2017 02:00:00 PM,48,-122,75,50,125
42639,FremontBridge,08/14/2017 03:00:00 PM,48,-122,100,61,161
42640,FremontBridge,08/14/2017 04:00:00 PM,48,-122,241,101,342
42641,FremontBridge,08/14/2017 05:00:00 PM,48,-122,583,186,769
42642,FremontBridge,08/14/2017 06:00:00 PM,48,-122,353,153,506
42643,FremontBridge,08/14/2017 07:00:00 PM,48,-122,143,79,222
42644,FremontBridge,08/14/2017 08:00:00 PM,48,-122,82,52,134
42645,FremontBridge,08/14/2017 09:00:00 PM,48,-122,43,32,75
42646,FremontBridge,08/14/2017 10:00:00 PM,48,-122,19,17,36
42647,FremontBridge,08/14/2017 11:00:00 PM,48,-122,9,9,18
42648,FremontBridge,08/15/2017 12:00:00 AM,48,-122,8,7,15
42649,FremontBridge,08/15/2017 01:00:00 AM,48,-122,6,1,7
42650,FremontBridge,08/15/2017 02:00:00 AM,48,-122,4,0,4
42651,FremontBridge,08/15/2017 03:00:00 AM,48,-122,0,0,0
42652,FremontBridge,08/15/2017 04:00:00 AM,48,-122,2,4,6
42653,FremontBridge,08/15/2017 05:00:00 AM,48,-122,11,40,51
42654,FremontBridge,08/15/2017 06:00:00 AM,48,-122,74,115,189
42655,FremontBridge,08/15/2017 07:00:00 AM,48,-122,225,274,499
42656,FremontBridge,08/15/2017 08:00:00 AM,48,-122,316,372,688
42657,FremontBridge,08/15/2017 09:00:00 AM,48,-122,164,155,319
42658,FremontBridge,08/15/2017 10:00:00 AM,48,-122,77,73,150
42659,FremontBridge,08/15/2017 11:00:00 AM,48,-122,61,53,114
42660,FremontBridge,08/15/2017 12:00:00 PM,48,-122,50,60,110
42661,FremontBridge,08/15/2017 01:00:00 PM,48,-122,52,70,122
42662,FremontBridge,08/15/2017 02:00:00 PM,48,-122,68,44,112
42663,FremontBridge,08/15/2017 03:00:00 PM,48,-122,109,76,185
42664,FremontBridge,08/15/2017 04:00:00 PM,48,-122,290,102,392
42665,FremontBridge,08/15/2017 05:00:00 PM,48,-122,638,174,812
42666,FremontBridge,08/15/2017 06:00:00 PM,48,-122,327,160,487
42667,FremontBridge,08/15/2017 07:00:00 PM,48,-122,200,86,286
42668,FremontBridge,08/15/2017 08:00:00 PM,48,-122,77,81,158
42669,FremontBridge,08/15/2017 09:00:00 PM,48,-122,54,59,113
42670,FremontBridge,08/15/2017 10:00:00 PM,48,-122,34,31,65
42671,FremontBridge,08/15/2017 11:00:00 PM,48,-122,12,19,31
42672,FremontBridge,08/16/2017 12:00:00 AM,48,-122,12,6,18
42673,FremontBridge,08/16/2017 01:00:00 AM,48,-122,0,5,5
42674,FremontBridge,08/16/2017 02:00:00 AM,48,-122,4,1,5
42675,FremontBridge,08/16/2017 03:00:00 AM,48,-122,1,1,2
42676,FremontBridge,08/16/2017 04:00:00 AM,48,-122,4,7,11
42677,FremontBridge,08/16/2017 05:00:00 AM,48,-122,20,24,44
42678,FremontBridge,08/16/2017 06:00:00 AM,48,-122,77,109,186
42679,FremontBridge,08/16/2017 07:00:00 AM,48,-122,208,271,479
42680,FremontBridge,08/16/2017 08:00:00 AM,48,-122,311,345,656
42681,FremontBridge,08/16/2017 09:00:00 AM,48,-122,189,180,369
42682,FremontBridge,08/16/2017 10:00:00 AM,48,-122,65,74,139
42683,FremontBridge,08/16/2017 11:00:00 AM,48,-122,65,60,125
42684,FremontBridge,08/16/2017 12:00:00 PM,48,-122,61,62,123
42685,FremontBridge,08/16/2017 01:00:00 PM,48,-122,62,66,128
42686,FremontBridge,08/16/2017 02:00:00 PM,48,-122,65,64,129
42687,FremontBridge,08/16/2017 03:00:00 PM,48,-122,107,71,178
42688,FremontBridge,08/16/2017 04:00:00 PM,48,-122,289,137,426
42689,FremontBridge,08/16/2017 05:00:00 PM,48,-122,587,192,779
42690,FremontBridge,08/16/2017 06:00:00 PM,48,-122,356,167,523
42691,FremontBridge,08/16/2017 07:00:00 PM,48,-122,210,110,320
42692,FremontBridge,08/16/2017 08:00:00 PM,48,-122,103,77,180
42693,FremontBridge,08/16/2017 09:00:00 PM,48,-122,58,41,99
42694,FremontBridge,08/16/2017 10:00:00 PM,48,-122,36,20,56
42695,FremontBridge,08/16/2017 11:00:00 PM,48,-122,19,11,30
42696,FremontBridge,08/17/2017 12:00:00 AM,48,-122,10,6,16
42697,FremontBridge,08/17/2017 01:00:00 AM,48,-122,3,5,8
42698,FremontBridge,08/17/2017 02:00:00 AM,48,-122,0,2,2
42699,FremontBridge,08/17/2017 03:00:00 AM,48,-122,2,4,6
42700,FremontBridge,08/17/2017 04:00:00 AM,48,-122,4,12,16
42701,FremontBridge,08/17/2017 05:00:00 AM,48,-122,13,32,45
42702,FremontBridge,08/17/2017 06:00:00 AM,48,-122,57,96,153
42703,FremontBridge,08/17/2017 07:00:00 AM,48,-122,219,221,440
42704,FremontBridge,08/17/2017 08:00:00 AM,48,-122,270,342,612
42705,FremontBridge,08/17/2017 09:00:00 AM,48,-122,161,154,315
42706,FremontBridge,08/17/2017 10:00:00 AM,48,-122,76,74,150
42707,FremontBridge,08/17/2017 11:00:00 AM,48,-122,49,53,102
42708,FremontBridge,08/17/2017 12:00:00 PM,48,-122,44,50,94
42709,FremontBridge,08/17/2017 01:00:00 PM,48,-122,78,68,146
42710,FremontBridge,08/17/2017 02:00:00 PM,48,-122,70,67,137
42711,FremontBridge,08/17/2017 03:00:00 PM,48,-122,118,64,182
42712,FremontBridge,08/17/2017 04:00:00 PM,48,-122,272,108,380
42713,FremontBridge,08/17/2017 05:00:00 PM,48,-122,576,165,741
42714,FremontBridge,08/17/2017 06:00:00 PM,48,-122,378,178,556
42715,FremontBridge,08/17/2017 07:00:00 PM,48,-122,155,101,256
42716,FremontBridge,08/17/2017 08:00:00 PM,48,-122,110,63,173
42717,FremontBridge,08/17/2017 09:00:00 PM,48,-122,62,36,98
42718,FremontBridge,08/17/2017 10:00:00 PM,48,-122,37,23,60
42719,FremontBridge,08/17/2017 11:00:00 PM,48,-122,12,15,27
42720,FremontBridge,08/18/2017 12:00:00 AM,48,-122,6,6,12
42721,FremontBridge,08/18/2017 01:00:00 AM,48,-122,6,4,10
42722,FremontBridge,08/18/2017 02:00:00 AM,48,-122,3,2,5
42723,FremontBridge,08/18/2017 03:00:00 AM,48,-122,1,4,5
42724,FremontBridge,08/18/2017 04:00:00 AM,48,-122,4,1,5
42725,FremontBridge,08/18/2017 05:00:00 AM,48,-122,36,27,63
42726,FremontBridge,08/18/2017 06:00:00 AM,48,-122,74,81,155
42727,FremontBridge,08/18/2017 07:00:00 AM,48,-122,194,194,388
42728,FremontBridge,08/18/2017 08:00:00 AM,48,-122,226,228,454
42729,FremontBridge,08/18/2017 09:00:00 AM,48,-122,143,133,276
42730,FremontBridge,08/18/2017 10:00:00 AM,48,-122,68,48,116
42731,FremontBridge,08/18/2017 11:00:00 AM,48,-122,55,46,101
42732,FremontBridge,08/18/2017 12:00:00 PM,48,-122,70,39,109
42733,FremontBridge,08/18/2017 01:00:00 PM,48,-122,48,68,116
42734,FremontBridge,08/18/2017 02:00:00 PM,48,-122,108,64,172
42735,FremontBridge,08/18/2017 03:00:00 PM,48,-122,136,70,206
42736,FremontBridge,08/18/2017 04:00:00 PM,48,-122,282,100,382
42737,FremontBridge,08/18/2017 05:00:00 PM,48,-122,420,158,578
42738,FremontBridge,08/18/2017 06:00:00 PM,48,-122,222,126,348
42739,FremontBridge,08/18/2017 07:00:00 PM,48,-122,112,61,173
42740,FremontBridge,08/18/2017 08:00:00 PM,48,-122,54,44,98
42741,FremontBridge,08/18/2017 09:00:00 PM,48,-122,55,27,82
42742,FremontBridge,08/18/2017 10:00:00 PM,48,-122,37,22,59
42743,FremontBridge,08/18/2017 11:00:00 PM,48,-122,16,14,30
42744,FremontBridge,08/19/2017 12:00:00 AM,48,-122,16,11,27
42745,FremontBridge,08/19/2017 01:00:00 AM,48,-122,11,5,16
42746,FremontBridge,08/19/2017 02:00:00 AM,48,-122,9,5,14
42747,FremontBridge,08/19/2017 03:00:00 AM,48,-122,3,2,5
42748,FremontBridge,08/19/2017 04:00:00 AM,48,-122,1,1,2
42749,FremontBridge,08/19/2017 05:00:00 AM,48,-122,3,5,8
42750,FremontBridge,08/19/2017 06:00:00 AM,48,-122,16,9,25
42751,FremontBridge,08/19/2017 07:00:00 AM,48,-122,35,22,57
42752,FremontBridge,08/19/2017 08:00:00 AM,48,-122,47,41,88
42753,FremontBridge,08/19/2017 09:00:00 AM,48,-122,44,57,101
42754,FremontBridge,08/19/2017 10:00:00 AM,48,-122,63,61,124
42755,FremontBridge,08/19/2017 11:00:00 AM,48,-122,82,80,162
42756,FremontBridge,08/19/2017 12:00:00 PM,48,-122,106,84,190
42757,FremontBridge,08/19/2017 01:00:00 PM,48,-122,100,67,167
42758,FremontBridge,08/19/2017 02:00:00 PM,48,-122,94,122,216
42759,FremontBridge,08/19/2017 03:00:00 PM,48,-122,85,102,187
42760,FremontBridge,08/19/2017 04:00:00 PM,48,-122,116,68,184
42761,FremontBridge,08/19/2017 05:00:00 PM,48,-122,89,81,170
42762,FremontBridge,08/19/2017 06:00:00 PM,48,-122,57,75,132
42763,FremontBridge,08/19/2017 07:00:00 PM,48,-122,66,47,113
42764,FremontBridge,08/19/2017 08:00:00 PM,48,-122,45,42,87
42765,FremontBridge,08/19/2017 09:00:00 PM,48,-122,28,18,46
42766,FremontBridge,08/19/2017 10:00:00 PM,48,-122,11,10,21
42767,FremontBridge,08/19/2017 11:00:00 PM,48,-122,21,7,28
42768,FremontBridge,08/20/2017 12:00:00 AM,48,-122,10,9,19
42769,FremontBridge,08/20/2017 01:00:00 AM,48,-122,4,9,13
42770,FremontBridge,08/20/2017 02:00:00 AM,48,-122,3,6,9
42771,FremontBridge,08/20/2017 03:00:00 AM,48,-122,2,3,5
42772,FremontBridge,08/20/2017 04:00:00 AM,48,-122,0,2,2
42773,FremontBridge,08/20/2017 05:00:00 AM,48,-122,1,0,1
42774,FremontBridge,08/20/2017 06:00:00 AM,48,-122,8,5,13
42775,FremontBridge,08/20/2017 07:00:00 AM,48,-122,8,17,25
42776,FremontBridge,08/20/2017 08:00:00 AM,48,-122,39,22,61
42777,FremontBridge,08/20/2017 09:00:00 AM,48,-122,35,43,78
42778,FremontBridge,08/20/2017 10:00:00 AM,48,-122,56,43,99
42779,FremontBridge,08/20/2017 11:00:00 AM,48,-122,79,80,159
42780,FremontBridge,08/20/2017 12:00:00 PM,48,-122,91,100,191
42781,FremontBridge,08/20/2017 01:00:00 PM,48,-122,94,106,200
42782,FremontBridge,08/20/2017 02:00:00 PM,48,-122,107,90,197
42783,FremontBridge,08/20/2017 03:00:00 PM,48,-122,76,76,152
42784,FremontBridge,08/20/2017 04:00:00 PM,48,-122,73,90,163
42785,FremontBridge,08/20/2017 05:00:00 PM,48,-122,78,46,124
42786,FremontBridge,08/20/2017 06:00:00 PM,48,-122,64,47,111
42787,FremontBridge,08/20/2017 07:00:00 PM,48,-122,37,39,76
42788,FremontBridge,08/20/2017 08:00:00 PM,48,-122,31,35,66
42789,FremontBridge,08/20/2017 09:00:00 PM,48,-122,26,16,42
42790,FremontBridge,08/20/2017 10:00:00 PM,48,-122,10,8,18
42791,FremontBridge,08/20/2017 11:00:00 PM,48,-122,8,6,14
42792,FremontBridge,08/21/2017 12:00:00 AM,48,-122,5,2,7
42793,FremontBridge,08/21/2017 01:00:00 AM,48,-122,2,0,2
42794,FremontBridge,08/21/2017 02:00:00 AM,48,-122,3,0,3
42795,FremontBridge,08/21/2017 03:00:00 AM,48,-122,1,1,2
42796,FremontBridge,08/21/2017 04:00:00 AM,48,-122,6,3,9
42797,FremontBridge,08/21/2017 05:00:00 AM,48,-122,11,20,31
42798,FremontBridge,08/21/2017 06:00:00 AM,48,-122,46,72,118
42799,FremontBridge,08/21/2017 07:00:00 AM,48,-122,183,175,358
42800,FremontBridge,08/21/2017 08:00:00 AM,48,-122,240,236,476
42801,FremontBridge,08/21/2017 09:00:00 AM,48,-122,133,120,253
42802,FremontBridge,08/21/2017 10:00:00 AM,48,-122,72,102,174
42803,FremontBridge,08/21/2017 11:00:00 AM,48,-122,63,72,135
42804,FremontBridge,08/21/2017 12:00:00 PM,48,-122,48,52,100
42805,FremontBridge,08/21/2017 01:00:00 PM,48,-122,52,50,102
42806,FremontBridge,08/21/2017 02:00:00 PM,48,-122,52,43,95
42807,FremontBridge,08/21/2017 03:00:00 PM,48,-122,87,62,149
42808,FremontBridge,08/21/2017 04:00:00 PM,48,-122,235,83,318
42809,FremontBridge,08/21/2017 05:00:00 PM,48,-122,461,136,597
42810,FremontBridge,08/21/2017 06:00:00 PM,48,-122,277,125,402
42811,FremontBridge,08/21/2017 07:00:00 PM,48,-122,151,84,235
42812,FremontBridge,08/21/2017 08:00:00 PM,48,-122,65,39,104
42813,FremontBridge,08/21/2017 09:00:00 PM,48,-122,33,18,51
42814,FremontBridge,08/21/2017 10:00:00 PM,48,-122,12,16,28
42815,FremontBridge,08/21/2017 11:00:00 PM,48,-122,7,12,19
42816,FremontBridge,08/22/2017 12:00:00 AM,48,-122,12,5,17
42817,FremontBridge,08/22/2017 01:00:00 AM,48,-122,4,2,6
42818,FremontBridge,08/22/2017 02:00:00 AM,48,-122,2,0,2
42819,FremontBridge,08/22/2017 03:00:00 AM,48,-122,3,1,4
42820,FremontBridge,08/22/2017 04:00:00 AM,48,-122,5,2,7
42821,FremontBridge,08/22/2017 05:00:00 AM,48,-122,11,28,39
42822,FremontBridge,08/22/2017 06:00:00 AM,48,-122,62,85,147
42823,FremontBridge,08/22/2017 07:00:00 AM,48,-122,210,232,442
42824,FremontBridge,08/22/2017 08:00:00 AM,48,-122,280,328,608
42825,FremontBridge,08/22/2017 09:00:00 AM,48,-122,173,158,331
42826,FremontBridge,08/22/2017 10:00:00 AM,48,-122,72,66,138
42827,FremontBridge,08/22/2017 11:00:00 AM,48,-122,57,61,118
42828,FremontBridge,08/22/2017 12:00:00 PM,48,-122,47,48,95
42829,FremontBridge,08/22/2017 01:00:00 PM,48,-122,45,54,99
42830,FremontBridge,08/22/2017 02:00:00 PM,48,-122,82,41,123
42831,FremontBridge,08/22/2017 03:00:00 PM,48,-122,96,67,163
42832,FremontBridge,08/22/2017 04:00:00 PM,48,-122,282,109,391
42833,FremontBridge,08/22/2017 05:00:00 PM,48,-122,562,190,752
42834,FremontBridge,08/22/2017 06:00:00 PM,48,-122,313,145,458
42835,FremontBridge,08/22/2017 07:00:00 PM,48,-122,181,88,269
42836,FremontBridge,08/22/2017 08:00:00 PM,48,-122,83,59,142
42837,FremontBridge,08/22/2017 09:00:00 PM,48,-122,38,32,70
42838,FremontBridge,08/22/2017 10:00:00 PM,48,-122,27,21,48
42839,FremontBridge,08/22/2017 11:00:00 PM,48,-122,11,9,20
42840,FremontBridge,08/23/2017 12:00:00 AM,48,-122,6,2,8
42841,FremontBridge,08/23/2017 01:00:00 AM,48,-122,3,0,3
42842,FremontBridge,08/23/2017 02:00:00 AM,48,-122,2,2,4
42843,FremontBridge,08/23/2017 03:00:00 AM,48,-122,3,6,9
42844,FremontBridge,08/23/2017 04:00:00 AM,48,-122,6,5,11
42845,FremontBridge,08/23/2017 05:00:00 AM,48,-122,15,27,42
42846,FremontBridge,08/23/2017 06:00:00 AM,48,-122,81,91,172
42847,FremontBridge,08/23/2017 07:00:00 AM,48,-122,226,240,466
42848,FremontBridge,08/23/2017 08:00:00 AM,48,-122,298,326,624
42849,FremontBridge,08/23/2017 09:00:00 AM,48,-122,177,170,347
42850,FremontBridge,08/23/2017 10:00:00 AM,48,-122,82,50,132
42851,FremontBridge,08/23/2017 11:00:00 AM,48,-122,58,42,100
42852,FremontBridge,08/23/2017 12:00:00 PM,48,-122,52,40,92
42853,FremontBridge,08/23/2017 01:00:00 PM,48,-122,46,52,98
42854,FremontBridge,08/23/2017 02:00:00 PM,48,-122,64,56,120
42855,FremontBridge,08/23/2017 03:00:00 PM,48,-122,92,68,160
42856,FremontBridge,08/23/2017 04:00:00 PM,48,-122,294,115,409
42857,FremontBridge,08/23/2017 05:00:00 PM,48,-122,593,175,768
42858,FremontBridge,08/23/2017 06:00:00 PM,48,-122,371,175,546
42859,FremontBridge,08/23/2017 07:00:00 PM,48,-122,194,102,296
42860,FremontBridge,08/23/2017 08:00:00 PM,48,-122,82,48,130
42861,FremontBridge,08/23/2017 09:00:00 PM,48,-122,35,29,64
42862,FremontBridge,08/23/2017 10:00:00 PM,48,-122,25,28,53
42863,FremontBridge,08/23/2017 11:00:00 PM,48,-122,16,8,24
42864,FremontBridge,08/24/2017 12:00:00 AM,48,-122,13,5,18
42865,FremontBridge,08/24/2017 01:00:00 AM,48,-122,3,1,4
42866,FremontBridge,08/24/2017 02:00:00 AM,48,-122,1,0,1
42867,FremontBridge,08/24/2017 03:00:00 AM,48,-122,0,1,1
42868,FremontBridge,08/24/2017 04:00:00 AM,48,-122,3,7,10
42869,FremontBridge,08/24/2017 05:00:00 AM,48,-122,19,23,42
42870,FremontBridge,08/24/2017 06:00:00 AM,48,-122,53,88,141
42871,FremontBridge,08/24/2017 07:00:00 AM,48,-122,195,193,388
42872,FremontBridge,08/24/2017 08:00:00 AM,48,-122,241,305,546
42873,FremontBridge,08/24/2017 09:00:00 AM,48,-122,142,151,293
42874,FremontBridge,08/24/2017 10:00:00 AM,48,-122,68,61,129
42875,FremontBridge,08/24/2017 11:00:00 AM,48,-122,60,48,108
42876,FremontBridge,08/24/2017 12:00:00 PM,48,-122,58,42,100
42877,FremontBridge,08/24/2017 01:00:00 PM,48,-122,52,69,121
42878,FremontBridge,08/24/2017 02:00:00 PM,48,-122,67,61,128
42879,FremontBridge,08/24/2017 03:00:00 PM,48,-122,113,75,188
42880,FremontBridge,08/24/2017 04:00:00 PM,48,-122,242,113,355
42881,FremontBridge,08/24/2017 05:00:00 PM,48,-122,458,162,620
42882,FremontBridge,08/24/2017 06:00:00 PM,48,-122,367,171,538
42883,FremontBridge,08/24/2017 07:00:00 PM,48,-122,181,104,285
42884,FremontBridge,08/24/2017 08:00:00 PM,48,-122,83,63,146
42885,FremontBridge,08/24/2017 09:00:00 PM,48,-122,34,34,68
42886,FremontBridge,08/24/2017 10:00:00 PM,48,-122,39,22,61
42887,FremontBridge,08/24/2017 11:00:00 PM,48,-122,15,27,42
42888,FremontBridge,08/25/2017 12:00:00 AM,48,-122,16,5,21
42889,FremontBridge,08/25/2017 01:00:00 AM,48,-122,3,7,10
42890,FremontBridge,08/25/2017 02:00:00 AM,48,-122,3,6,9
42891,FremontBridge,08/25/2017 03:00:00 AM,48,-122,3,5,8
42892,FremontBridge,08/25/2017 04:00:00 AM,48,-122,5,1,6
42893,FremontBridge,08/25/2017 05:00:00 AM,48,-122,18,31,49
42894,FremontBridge,08/25/2017 06:00:00 AM,48,-122,61,68,129
42895,FremontBridge,08/25/2017 07:00:00 AM,48,-122,180,196,376
42896,FremontBridge,08/25/2017 08:00:00 AM,48,-122,251,246,497
42897,FremontBridge,08/25/2017 09:00:00 AM,48,-122,159,138,297
42898,FremontBridge,08/25/2017 10:00:00 AM,48,-122,75,56,131
42899,FremontBridge,08/25/2017 11:00:00 AM,48,-122,54,53,107
42900,FremontBridge,08/25/2017 12:00:00 PM,48,-122,54,51,105
42901,FremontBridge,08/25/2017 01:00:00 PM,48,-122,46,48,94
42902,FremontBridge,08/25/2017 02:00:00 PM,48,-122,99,65,164
42903,FremontBridge,08/25/2017 03:00:00 PM,48,-122,141,79,220
42904,FremontBridge,08/25/2017 04:00:00 PM,48,-122,307,88,395
42905,FremontBridge,08/25/2017 05:00:00 PM,48,-122,457,151,608
42906,FremontBridge,08/25/2017 06:00:00 PM,48,-122,259,112,371
42907,FremontBridge,08/25/2017 07:00:00 PM,48,-122,121,66,187
42908,FremontBridge,08/25/2017 08:00:00 PM,48,-122,80,64,144
42909,FremontBridge,08/25/2017 09:00:00 PM,48,-122,40,25,65
42910,FremontBridge,08/25/2017 10:00:00 PM,48,-122,23,20,43
42911,FremontBridge,08/25/2017 11:00:00 PM,48,-122,19,17,36
42912,FremontBridge,08/26/2017 12:00:00 AM,48,-122,12,8,20
42913,FremontBridge,08/26/2017 01:00:00 AM,48,-122,9,4,13
42914,FremontBridge,08/26/2017 02:00:00 AM,48,-122,3,2,5
42915,FremontBridge,08/26/2017 03:00:00 AM,48,-122,2,2,4
42916,FremontBridge,08/26/2017 04:00:00 AM,48,-122,9,7,16
42917,FremontBridge,08/26/2017 05:00:00 AM,48,-122,7,7,14
42918,FremontBridge,08/26/2017 06:00:00 AM,48,-122,13,9,22
42919,FremontBridge,08/26/2017 07:00:00 AM,48,-122,23,17,40
42920,FremontBridge,08/26/2017 08:00:00 AM,48,-122,57,33,90
42921,FremontBridge,08/26/2017 09:00:00 AM,48,-122,50,65,115
42922,FremontBridge,08/26/2017 10:00:00 AM,48,-122,72,77,149
42923,FremontBridge,08/26/2017 11:00:00 AM,48,-122,97,73,170
42924,FremontBridge,08/26/2017 12:00:00 PM,48,-122,100,97,197
42925,FremontBridge,08/26/2017 01:00:00 PM,48,-122,97,101,198
42926,FremontBridge,08/26/2017 02:00:00 PM,48,-122,84,97,181
42927,FremontBridge,08/26/2017 03:00:00 PM,48,-122,104,70,174
42928,FremontBridge,08/26/2017 04:00:00 PM,48,-122,96,89,185
42929,FremontBridge,08/26/2017 05:00:00 PM,48,-122,107,86,193
42930,FremontBridge,08/26/2017 06:00:00 PM,48,-122,71,69,140
42931,FremontBridge,08/26/2017 07:00:00 PM,48,-122,68,59,127
42932,FremontBridge,08/26/2017 08:00:00 PM,48,-122,41,39,80
42933,FremontBridge,08/26/2017 09:00:00 PM,48,-122,25,24,49
42934,FremontBridge,08/26/2017 10:00:00 PM,48,-122,26,12,38
42935,FremontBridge,08/26/2017 11:00:00 PM,48,-122,16,5,21
42936,FremontBridge,08/27/2017 12:00:00 AM,48,-122,4,8,12
42937,FremontBridge,08/27/2017 01:00:00 AM,48,-122,5,6,11
42938,FremontBridge,08/27/2017 02:00:00 AM,48,-122,1,7,8
42939,FremontBridge,08/27/2017 03:00:00 AM,48,-122,6,1,7
42940,FremontBridge,08/27/2017 04:00:00 AM,48,-122,3,1,4
42941,FremontBridge,08/27/2017 05:00:00 AM,48,-122,2,4,6
42942,FremontBridge,08/27/2017 06:00:00 AM,48,-122,9,10,19
42943,FremontBridge,08/27/2017 07:00:00 AM,48,-122,17,23,40
42944,FremontBridge,08/27/2017 08:00:00 AM,48,-122,29,29,58
42945,FremontBridge,08/27/2017 09:00:00 AM,48,-122,54,70,124
42946,FremontBridge,08/27/2017 10:00:00 AM,48,-122,78,76,154
42947,FremontBridge,08/27/2017 11:00:00 AM,48,-122,100,105,205
42948,FremontBridge,08/27/2017 12:00:00 PM,48,-122,108,91,199
42949,FremontBridge,08/27/2017 01:00:00 PM,48,-122,82,94,176
42950,FremontBridge,08/27/2017 02:00:00 PM,48,-122,90,94,184
42951,FremontBridge,08/27/2017 03:00:00 PM,48,-122,111,80,191
42952,FremontBridge,08/27/2017 04:00:00 PM,48,-122,87,96,183
42953,FremontBridge,08/27/2017 05:00:00 PM,48,-122,76,78,154
42954,FremontBridge,08/27/2017 06:00:00 PM,48,-122,55,74,129
42955,FremontBridge,08/27/2017 07:00:00 PM,48,-122,37,36,73
42956,FremontBridge,08/27/2017 08:00:00 PM,48,-122,39,31,70
42957,FremontBridge,08/27/2017 09:00:00 PM,48,-122,40,20,60
42958,FremontBridge,08/27/2017 10:00:00 PM,48,-122,15,14,29
42959,FremontBridge,08/27/2017 11:00:00 PM,48,-122,6,4,10
42960,FremontBridge,08/28/2017 12:00:00 AM,48,-122,7,2,9
42961,FremontBridge,08/28/2017 01:00:00 AM,48,-122,1,0,1
42962,FremontBridge,08/28/2017 02:00:00 AM,48,-122,0,2,2
42963,FremontBridge,08/28/2017 03:00:00 AM,48,-122,2,1,3
42964,FremontBridge,08/28/2017 04:00:00 AM,48,-122,3,2,5
42965,FremontBridge,08/28/2017 05:00:00 AM,48,-122,16,28,44
42966,FremontBridge,08/28/2017 06:00:00 AM,48,-122,66,79,145
42967,FremontBridge,08/28/2017 07:00:00 AM,48,-122,232,247,479
42968,FremontBridge,08/28/2017 08:00:00 AM,48,-122,276,308,584
42969,FremontBridge,08/28/2017 09:00:00 AM,48,-122,179,145,324
42970,FremontBridge,08/28/2017 10:00:00 AM,48,-122,56,57,113
42971,FremontBridge,08/28/2017 11:00:00 AM,48,-122,63,55,118
42972,FremontBridge,08/28/2017 12:00:00 PM,48,-122,45,56,101
42973,FremontBridge,08/28/2017 01:00:00 PM,48,-122,49,54,103
42974,FremontBridge,08/28/2017 02:00:00 PM,48,-122,52,51,103
42975,FremontBridge,08/28/2017 03:00:00 PM,48,-122,100,55,155
42976,FremontBridge,08/28/2017 04:00:00 PM,48,-122,248,97,345
42977,FremontBridge,08/28/2017 05:00:00 PM,48,-122,560,166,726
42978,FremontBridge,08/28/2017 06:00:00 PM,48,-122,402,114,516
42979,FremontBridge,08/28/2017 07:00:00 PM,48,-122,151,95,246
42980,FremontBridge,08/28/2017 08:00:00 PM,48,-122,83,41,124
42981,FremontBridge,08/28/2017 09:00:00 PM,48,-122,44,16,60
42982,FremontBridge,08/28/2017 10:00:00 PM,48,-122,24,20,44
42983,FremontBridge,08/28/2017 11:00:00 PM,48,-122,9,11,20
42984,FremontBridge,08/29/2017 12:00:00 AM,48,-122,10,4,14
42985,FremontBridge,08/29/2017 01:00:00 AM,48,-122,5,1,6
42986,FremontBridge,08/29/2017 02:00:00 AM,48,-122,2,3,5
42987,FremontBridge,08/29/2017 03:00:00 AM,48,-122,1,1,2
42988,FremontBridge,08/29/2017 04:00:00 AM,48,-122,3,6,9
42989,FremontBridge,08/29/2017 05:00:00 AM,48,-122,16,28,44
42990,FremontBridge,08/29/2017 06:00:00 AM,48,-122,77,120,197
42991,FremontBridge,08/29/2017 07:00:00 AM,48,-122,257,275,532
42992,FremontBridge,08/29/2017 08:00:00 AM,48,-122,316,314,630
42993,FremontBridge,08/29/2017 09:00:00 AM,48,-122,158,149,307
42994,FremontBridge,08/29/2017 10:00:00 AM,48,-122,79,83,162
42995,FremontBridge,08/29/2017 11:00:00 AM,48,-122,52,62,114
42996,FremontBridge,08/29/2017 12:00:00 PM,48,-122,62,45,107
42997,FremontBridge,08/29/2017 01:00:00 PM,48,-122,53,41,94
42998,FremontBridge,08/29/2017 02:00:00 PM,48,-122,53,54,107
42999,FremontBridge,08/29/2017 03:00:00 PM,48,-122,103,76,179
43000,FremontBridge,08/29/2017 04:00:00 PM,48,-122,324,116,440
43001,FremontBridge,08/29/2017 05:00:00 PM,48,-122,574,177,751
43002,FremontBridge,08/29/2017 06:00:00 PM,48,-122,342,174,516
43003,FremontBridge,08/29/2017 07:00:00 PM,48,-122,180,117,297
43004,FremontBridge,08/29/2017 08:00:00 PM,48,-122,86,55,141
43005,FremontBridge,08/29/2017 09:00:00 PM,48,-122,37,31,68
43006,FremontBridge,08/29/2017 10:00:00 PM,48,-122,32,16,48
43007,FremontBridge,08/29/2017 11:00:00 PM,48,-122,12,11,23
43008,FremontBridge,08/30/2017 12:00:00 AM,48,-122,6,5,11
43009,FremontBridge,08/30/2017 01:00:00 AM,48,-122,4,1,5
43010,FremontBridge,08/30/2017 02:00:00 AM,48,-122,1,4,5
43011,FremontBridge,08/30/2017 03:00:00 AM,48,-122,3,0,3
43012,FremontBridge,08/30/2017 04:00:00 AM,48,-122,2,3,5
43013,FremontBridge,08/30/2017 05:00:00 AM,48,-122,24,21,45
43014,FremontBridge,08/30/2017 06:00:00 AM,48,-122,71,103,174
43015,FremontBridge,08/30/2017 07:00:00 AM,48,-122,226,246,472
43016,FremontBridge,08/30/2017 08:00:00 AM,48,-122,288,303,591
43017,FremontBridge,08/30/2017 09:00:00 AM,48,-122,154,165,319
43018,FremontBridge,08/30/2017 10:00:00 AM,48,-122,69,66,135
43019,FremontBridge,08/30/2017 11:00:00 AM,48,-122,53,45,98
43020,FremontBridge,08/30/2017 12:00:00 PM,48,-122,48,47,95
43021,FremontBridge,08/30/2017 01:00:00 PM,48,-122,48,49,97
43022,FremontBridge,08/30/2017 02:00:00 PM,48,-122,57,43,100
43023,FremontBridge,08/30/2017 03:00:00 PM,48,-122,92,80,172
43024,FremontBridge,08/30/2017 04:00:00 PM,48,-122,262,96,358
43025,FremontBridge,08/30/2017 05:00:00 PM,48,-122,558,191,749
43026,FremontBridge,08/30/2017 06:00:00 PM,48,-122,355,165,520
43027,FremontBridge,08/30/2017 07:00:00 PM,48,-122,208,114,322
43028,FremontBridge,08/30/2017 08:00:00 PM,48,-122,114,48,162
43029,FremontBridge,08/30/2017 09:00:00 PM,48,-122,40,17,57
43030,FremontBridge,08/30/2017 10:00:00 PM,48,-122,34,23,57
43031,FremontBridge,08/30/2017 11:00:00 PM,48,-122,19,11,30
43032,FremontBridge,08/31/2017 12:00:00 AM,48,-122,7,4,11
43033,FremontBridge,08/31/2017 01:00:00 AM,48,-122,3,5,8
43034,FremontBridge,08/31/2017 02:00:00 AM,48,-122,2,3,5
43035,FremontBridge,08/31/2017 03:00:00 AM,48,-122,2,5,7
43036,FremontBridge,08/31/2017 04:00:00 AM,48,-122,6,5,11
43037,FremontBridge,08/31/2017 05:00:00 AM,48,-122,14,32,46
43038,FremontBridge,08/31/2017 06:00:00 AM,48,-122,63,78,141
43039,FremontBridge,08/31/2017 07:00:00 AM,48,-122,188,225,413
43040,FremontBridge,08/31/2017 08:00:00 AM,48,-122,262,311,573
43041,FremontBridge,08/31/2017 09:00:00 AM,48,-122,113,121,234
43042,FremontBridge,08/31/2017 10:00:00 AM,48,-122,40,40,80
43043,FremontBridge,08/31/2017 11:00:00 AM,48,-122,31,23,54
43044,FremontBridge,08/31/2017 12:00:00 PM,48,-122,46,34,80
43045,FremontBridge,08/31/2017 01:00:00 PM,48,-122,34,33,67
43046,FremontBridge,08/31/2017 02:00:00 PM,48,-122,43,37,80
43047,FremontBridge,08/31/2017 03:00:00 PM,48,-122,83,59,142
43048,FremontBridge,08/31/2017 04:00:00 PM,48,-122,239,126,365
43049,FremontBridge,08/31/2017 05:00:00 PM,48,-122,473,154,627
43050,FremontBridge,08/31/2017 06:00:00 PM,48,-122,299,141,440
43051,FremontBridge,08/31/2017 07:00:00 PM,48,-122,140,81,221
43052,FremontBridge,08/31/2017 08:00:00 PM,48,-122,95,62,157
43053,FremontBridge,08/31/2017 09:00:00 PM,48,-122,40,35,75
43054,FremontBridge,08/31/2017 10:00:00 PM,48,-122,25,25,50
43055,FremontBridge,08/31/2017 11:00:00 PM,48,-122,7,14,21
43056,FremontBridge,09/01/2017 12:00:00 AM,48,-122,13,4,17
43057,FremontBridge,09/01/2017 01:00:00 AM,48,-122,8,2,10
43058,FremontBridge,09/01/2017 02:00:00 AM,48,-122,1,3,4
43059,FremontBridge,09/01/2017 03:00:00 AM,48,-122,2,0,2
43060,FremontBridge,09/01/2017 04:00:00 AM,48,-122,6,2,8
43061,FremontBridge,09/01/2017 05:00:00 AM,48,-122,21,27,48
43062,FremontBridge,09/01/2017 06:00:00 AM,48,-122,59,67,126
43063,FremontBridge,09/01/2017 07:00:00 AM,48,-122,144,212,356
43064,FremontBridge,09/01/2017 08:00:00 AM,48,-122,220,261,481
43065,FremontBridge,09/01/2017 09:00:00 AM,48,-122,131,98,229
43066,FremontBridge,09/01/2017 10:00:00 AM,48,-122,76,51,127
43067,FremontBridge,09/01/2017 11:00:00 AM,48,-122,54,58,112
43068,FremontBridge,09/01/2017 12:00:00 PM,48,-122,82,65,147
43069,FremontBridge,09/01/2017 01:00:00 PM,48,-122,75,62,137
43070,FremontBridge,09/01/2017 02:00:00 PM,48,-122,93,60,153
43071,FremontBridge,09/01/2017 03:00:00 PM,48,-122,169,95,264
43072,FremontBridge,09/01/2017 04:00:00 PM,48,-122,282,110,392
43073,FremontBridge,09/01/2017 05:00:00 PM,48,-122,330,133,463
43074,FremontBridge,09/01/2017 06:00:00 PM,48,-122,203,79,282
43075,FremontBridge,09/01/2017 07:00:00 PM,48,-122,109,65,174
43076,FremontBridge,09/01/2017 08:00:00 PM,48,-122,58,60,118
43077,FremontBridge,09/01/2017 09:00:00 PM,48,-122,29,32,61
43078,FremontBridge,09/01/2017 10:00:00 PM,48,-122,26,18,44
43079,FremontBridge,09/01/2017 11:00:00 PM,48,-122,17,14,31
43080,FremontBridge,09/02/2017 12:00:00 AM,48,-122,13,7,20
43081,FremontBridge,09/02/2017 01:00:00 AM,48,-122,10,5,15
43082,FremontBridge,09/02/2017 02:00:00 AM,48,-122,4,1,5
43083,FremontBridge,09/02/2017 03:00:00 AM,48,-122,6,3,9
43084,FremontBridge,09/02/2017 04:00:00 AM,48,-122,1,0,1
43085,FremontBridge,09/02/2017 05:00:00 AM,48,-122,6,6,12
43086,FremontBridge,09/02/2017 06:00:00 AM,48,-122,7,15,22
43087,FremontBridge,09/02/2017 07:00:00 AM,48,-122,36,34,70
43088,FremontBridge,09/02/2017 08:00:00 AM,48,-122,56,35,91
43089,FremontBridge,09/02/2017 09:00:00 AM,48,-122,50,71,121
43090,FremontBridge,09/02/2017 10:00:00 AM,48,-122,53,73,126
43091,FremontBridge,09/02/2017 11:00:00 AM,48,-122,81,84,165
43092,FremontBridge,09/02/2017 12:00:00 PM,48,-122,76,70,146
43093,FremontBridge,09/02/2017 01:00:00 PM,48,-122,84,110,194
43094,FremontBridge,09/02/2017 02:00:00 PM,48,-122,123,89,212
43095,FremontBridge,09/02/2017 03:00:00 PM,48,-122,93,100,193
43096,FremontBridge,09/02/2017 04:00:00 PM,48,-122,89,105,194
43097,FremontBridge,09/02/2017 05:00:00 PM,48,-122,84,89,173
43098,FremontBridge,09/02/2017 06:00:00 PM,48,-122,49,59,108
43099,FremontBridge,09/02/2017 07:00:00 PM,48,-122,59,43,102
43100,FremontBridge,09/02/2017 08:00:00 PM,48,-122,42,26,68
43101,FremontBridge,09/02/2017 09:00:00 PM,48,-122,13,10,23
43102,FremontBridge,09/02/2017 10:00:00 PM,48,-122,21,18,39
43103,FremontBridge,09/02/2017 11:00:00 PM,48,-122,38,6,44
43104,FremontBridge,09/03/2017 12:00:00 AM,48,-122,10,14,24
43105,FremontBridge,09/03/2017 01:00:00 AM,48,-122,4,5,9
43106,FremontBridge,09/03/2017 02:00:00 AM,48,-122,4,1,5
43107,FremontBridge,09/03/2017 03:00:00 AM,48,-122,0,1,1
43108,FremontBridge,09/03/2017 04:00:00 AM,48,-122,3,2,5
43109,FremontBridge,09/03/2017 05:00:00 AM,48,-122,1,8,9
43110,FremontBridge,09/03/2017 06:00:00 AM,48,-122,6,14,20
43111,FremontBridge,09/03/2017 07:00:00 AM,48,-122,13,16,29
43112,FremontBridge,09/03/2017 08:00:00 AM,48,-122,43,42,85
43113,FremontBridge,09/03/2017 09:00:00 AM,48,-122,70,56,126
43114,FremontBridge,09/03/2017 10:00:00 AM,48,-122,66,82,148
43115,FremontBridge,09/03/2017 11:00:00 AM,48,-122,76,92,168
43116,FremontBridge,09/03/2017 12:00:00 PM,48,-122,70,88,158
43117,FremontBridge,09/03/2017 01:00:00 PM,48,-122,89,93,182
43118,FremontBridge,09/03/2017 02:00:00 PM,48,-122,75,87,162
43119,FremontBridge,09/03/2017 03:00:00 PM,48,-122,89,75,164
43120,FremontBridge,09/03/2017 04:00:00 PM,48,-122,72,55,127
43121,FremontBridge,09/03/2017 05:00:00 PM,48,-122,70,59,129
43122,FremontBridge,09/03/2017 06:00:00 PM,48,-122,50,73,123
43123,FremontBridge,09/03/2017 07:00:00 PM,48,-122,35,34,69
43124,FremontBridge,09/03/2017 08:00:00 PM,48,-122,25,20,45
43125,FremontBridge,09/03/2017 09:00:00 PM,48,-122,25,19,44
43126,FremontBridge,09/03/2017 10:00:00 PM,48,-122,19,4,23
43127,FremontBridge,09/03/2017 11:00:00 PM,48,-122,16,8,24
43128,FremontBridge,09/04/2017 12:00:00 AM,48,-122,22,6,28
43129,FremontBridge,09/04/2017 01:00:00 AM,48,-122,5,1,6
43130,FremontBridge,09/04/2017 02:00:00 AM,48,-122,5,3,8
43131,FremontBridge,09/04/2017 03:00:00 AM,48,-122,2,1,3
43132,FremontBridge,09/04/2017 04:00:00 AM,48,-122,3,2,5
43133,FremontBridge,09/04/2017 05:00:00 AM,48,-122,2,12,14
43134,FremontBridge,09/04/2017 06:00:00 AM,48,-122,13,17,30
43135,FremontBridge,09/04/2017 07:00:00 AM,48,-122,23,26,49
43136,FremontBridge,09/04/2017 08:00:00 AM,48,-122,45,48,93
43137,FremontBridge,09/04/2017 09:00:00 AM,48,-122,87,66,153
43138,FremontBridge,09/04/2017 10:00:00 AM,48,-122,86,71,157
43139,FremontBridge,09/04/2017 11:00:00 AM,48,-122,84,101,185
43140,FremontBridge,09/04/2017 12:00:00 PM,48,-122,74,94,168
43141,FremontBridge,09/04/2017 01:00:00 PM,48,-122,89,124,213
43142,FremontBridge,09/04/2017 02:00:00 PM,48,-122,83,116,199
43143,FremontBridge,09/04/2017 03:00:00 PM,48,-122,84,77,161
43144,FremontBridge,09/04/2017 04:00:00 PM,48,-122,75,84,159
43145,FremontBridge,09/04/2017 05:00:00 PM,48,-122,75,64,139
43146,FremontBridge,09/04/2017 06:00:00 PM,48,-122,49,59,108
43147,FremontBridge,09/04/2017 07:00:00 PM,48,-122,42,54,96
43148,FremontBridge,09/04/2017 08:00:00 PM,48,-122,32,25,57
43149,FremontBridge,09/04/2017 09:00:00 PM,48,-122,23,10,33
43150,FremontBridge,09/04/2017 10:00:00 PM,48,-122,20,11,31
43151,FremontBridge,09/04/2017 11:00:00 PM,48,-122,9,17,26
43152,FremontBridge,09/05/2017 12:00:00 AM,48,-122,5,3,8
43153,FremontBridge,09/05/2017 01:00:00 AM,48,-122,2,3,5
43154,FremontBridge,09/05/2017 02:00:00 AM,48,-122,3,2,5
43155,FremontBridge,09/05/2017 03:00:00 AM,48,-122,0,3,3
43156,FremontBridge,09/05/2017 04:00:00 AM,48,-122,5,3,8
43157,FremontBridge,09/05/2017 05:00:00 AM,48,-122,15,32,47
43158,FremontBridge,09/05/2017 06:00:00 AM,48,-122,75,75,150
43159,FremontBridge,09/05/2017 07:00:00 AM,48,-122,210,228,438
43160,FremontBridge,09/05/2017 08:00:00 AM,48,-122,261,276,537
43161,FremontBridge,09/05/2017 09:00:00 AM,48,-122,141,96,237
43162,FremontBridge,09/05/2017 10:00:00 AM,48,-122,50,58,108
43163,FremontBridge,09/05/2017 11:00:00 AM,48,-122,33,37,70
43164,FremontBridge,09/05/2017 12:00:00 PM,48,-122,31,31,62
43165,FremontBridge,09/05/2017 01:00:00 PM,48,-122,40,24,64
43166,FremontBridge,09/05/2017 02:00:00 PM,48,-122,32,37,69
43167,FremontBridge,09/05/2017 03:00:00 PM,48,-122,78,47,125
43168,FremontBridge,09/05/2017 04:00:00 PM,48,-122,201,69,270
43169,FremontBridge,09/05/2017 05:00:00 PM,48,-122,437,151,588
43170,FremontBridge,09/05/2017 06:00:00 PM,48,-122,294,105,399
43171,FremontBridge,09/05/2017 07:00:00 PM,48,-122,102,66,168
43172,FremontBridge,09/05/2017 08:00:00 PM,48,-122,51,32,83
43173,FremontBridge,09/05/2017 09:00:00 PM,48,-122,29,22,51
43174,FremontBridge,09/05/2017 10:00:00 PM,48,-122,16,17,33
43175,FremontBridge,09/05/2017 11:00:00 PM,48,-122,11,11,22
43176,FremontBridge,09/06/2017 12:00:00 AM,48,-122,5,3,8
43177,FremontBridge,09/06/2017 01:00:00 AM,48,-122,2,1,3
43178,FremontBridge,09/06/2017 02:00:00 AM,48,-122,2,0,2
43179,FremontBridge,09/06/2017 03:00:00 AM,48,-122,2,4,6
43180,FremontBridge,09/06/2017 04:00:00 AM,48,-122,7,2,9
43181,FremontBridge,09/06/2017 05:00:00 AM,48,-122,17,26,43
43182,FremontBridge,09/06/2017 06:00:00 AM,48,-122,69,80,149
43183,FremontBridge,09/06/2017 07:00:00 AM,48,-122,183,210,393
43184,FremontBridge,09/06/2017 08:00:00 AM,48,-122,262,277,539
43185,FremontBridge,09/06/2017 09:00:00 AM,48,-122,148,121,269
43186,FremontBridge,09/06/2017 10:00:00 AM,48,-122,50,49,99
43187,FremontBridge,09/06/2017 11:00:00 AM,48,-122,36,32,68
43188,FremontBridge,09/06/2017 12:00:00 PM,48,-122,43,48,91
43189,FremontBridge,09/06/2017 01:00:00 PM,48,-122,24,26,50
43190,FremontBridge,09/06/2017 02:00:00 PM,48,-122,60,45,105
43191,FremontBridge,09/06/2017 03:00:00 PM,48,-122,76,59,135
43192,FremontBridge,09/06/2017 04:00:00 PM,48,-122,212,73,285
43193,FremontBridge,09/06/2017 05:00:00 PM,48,-122,459,144,603
43194,FremontBridge,09/06/2017 06:00:00 PM,48,-122,260,132,392
43195,FremontBridge,09/06/2017 07:00:00 PM,48,-122,153,55,208
43196,FremontBridge,09/06/2017 08:00:00 PM,48,-122,59,30,89
43197,FremontBridge,09/06/2017 09:00:00 PM,48,-122,33,20,53
43198,FremontBridge,09/06/2017 10:00:00 PM,48,-122,24,15,39
43199,FremontBridge,09/06/2017 11:00:00 PM,48,-122,15,11,26
43200,FremontBridge,09/07/2017 12:00:00 AM,48,-122,6,3,9
43201,FremontBridge,09/07/2017 01:00:00 AM,48,-122,1,3,4
43202,FremontBridge,09/07/2017 02:00:00 AM,48,-122,2,1,3
43203,FremontBridge,09/07/2017 03:00:00 AM,48,-122,1,1,2
43204,FremontBridge,09/07/2017 04:00:00 AM,48,-122,6,3,9
43205,FremontBridge,09/07/2017 05:00:00 AM,48,-122,11,27,38
43206,FremontBridge,09/07/2017 06:00:00 AM,48,-122,69,84,153
43207,FremontBridge,09/07/2017 07:00:00 AM,48,-122,192,212,404
43208,FremontBridge,09/07/2017 08:00:00 AM,48,-122,263,326,589
43209,FremontBridge,09/07/2017 09:00:00 AM,48,-122,146,112,258
43210,FremontBridge,09/07/2017 10:00:00 AM,48,-122,43,52,95
43211,FremontBridge,09/07/2017 11:00:00 AM,48,-122,55,33,88
43212,FremontBridge,09/07/2017 12:00:00 PM,48,-122,31,28,59
43213,FremontBridge,09/07/2017 01:00:00 PM,48,-122,36,46,82
43214,FremontBridge,09/07/2017 02:00:00 PM,48,-122,56,39,95
43215,FremontBridge,09/07/2017 03:00:00 PM,48,-122,94,53,147
43216,FremontBridge,09/07/2017 04:00:00 PM,48,-122,216,100,316
43217,FremontBridge,09/07/2017 05:00:00 PM,48,-122,497,151,648
43218,FremontBridge,09/07/2017 06:00:00 PM,48,-122,270,129,399
43219,FremontBridge,09/07/2017 07:00:00 PM,48,-122,150,60,210
43220,FremontBridge,09/07/2017 08:00:00 PM,48,-122,83,46,129
43221,FremontBridge,09/07/2017 09:00:00 PM,48,-122,46,24,70
43222,FremontBridge,09/07/2017 10:00:00 PM,48,-122,29,17,46
43223,FremontBridge,09/07/2017 11:00:00 PM,48,-122,17,9,26
43224,FremontBridge,09/08/2017 12:00:00 AM,48,-122,3,5,8
43225,FremontBridge,09/08/2017 01:00:00 AM,48,-122,3,2,5
43226,FremontBridge,09/08/2017 02:00:00 AM,48,-122,4,3,7
43227,FremontBridge,09/08/2017 03:00:00 AM,48,-122,3,2,5
43228,FremontBridge,09/08/2017 04:00:00 AM,48,-122,7,5,12
43229,FremontBridge,09/08/2017 05:00:00 AM,48,-122,10,31,41
43230,FremontBridge,09/08/2017 06:00:00 AM,48,-122,64,73,137
43231,FremontBridge,09/08/2017 07:00:00 AM,48,-122,155,186,341
43232,FremontBridge,09/08/2017 08:00:00 AM,48,-122,254,285,539
43233,FremontBridge,09/08/2017 09:00:00 AM,48,-122,132,118,250
43234,FremontBridge,09/08/2017 10:00:00 AM,48,-122,51,49,100
43235,FremontBridge,09/08/2017 11:00:00 AM,48,-122,48,50,98
43236,FremontBridge,09/08/2017 12:00:00 PM,48,-122,42,45,87
43237,FremontBridge,09/08/2017 01:00:00 PM,48,-122,46,50,96
43238,FremontBridge,09/08/2017 02:00:00 PM,48,-122,62,42,104
43239,FremontBridge,09/08/2017 03:00:00 PM,48,-122,104,69,173
43240,FremontBridge,09/08/2017 04:00:00 PM,48,-122,254,101,355
43241,FremontBridge,09/08/2017 05:00:00 PM,48,-122,396,127,523
43242,FremontBridge,09/08/2017 06:00:00 PM,48,-122,223,114,337
43243,FremontBridge,09/08/2017 07:00:00 PM,48,-122,117,71,188
43244,FremontBridge,09/08/2017 08:00:00 PM,48,-122,67,37,104
43245,FremontBridge,09/08/2017 09:00:00 PM,48,-122,41,18,59
43246,FremontBridge,09/08/2017 10:00:00 PM,48,-122,24,11,35
43247,FremontBridge,09/08/2017 11:00:00 PM,48,-122,19,14,33
43248,FremontBridge,09/09/2017 12:00:00 AM,48,-122,7,14,21
43249,FremontBridge,09/09/2017 01:00:00 AM,48,-122,3,2,5
43250,FremontBridge,09/09/2017 02:00:00 AM,48,-122,4,4,8
43251,FremontBridge,09/09/2017 03:00:00 AM,48,-122,2,2,4
43252,FremontBridge,09/09/2017 04:00:00 AM,48,-122,4,4,8
43253,FremontBridge,09/09/2017 05:00:00 AM,48,-122,1,4,5
43254,FremontBridge,09/09/2017 06:00:00 AM,48,-122,18,13,31
43255,FremontBridge,09/09/2017 07:00:00 AM,48,-122,17,16,33
43256,FremontBridge,09/09/2017 08:00:00 AM,48,-122,38,34,72
43257,FremontBridge,09/09/2017 09:00:00 AM,48,-122,48,47,95
43258,FremontBridge,09/09/2017 10:00:00 AM,48,-122,54,60,114
43259,FremontBridge,09/09/2017 11:00:00 AM,48,-122,58,57,115
43260,FremontBridge,09/09/2017 12:00:00 PM,48,-122,69,58,127
43261,FremontBridge,09/09/2017 01:00:00 PM,48,-122,71,76,147
43262,FremontBridge,09/09/2017 02:00:00 PM,48,-122,64,58,122
43263,FremontBridge,09/09/2017 03:00:00 PM,48,-122,74,66,140
43264,FremontBridge,09/09/2017 04:00:00 PM,48,-122,62,52,114
43265,FremontBridge,09/09/2017 05:00:00 PM,48,-122,70,54,124
43266,FremontBridge,09/09/2017 06:00:00 PM,48,-122,50,44,94
43267,FremontBridge,09/09/2017 07:00:00 PM,48,-122,28,45,73
43268,FremontBridge,09/09/2017 08:00:00 PM,48,-122,33,22,55
43269,FremontBridge,09/09/2017 09:00:00 PM,48,-122,19,16,35
43270,FremontBridge,09/09/2017 10:00:00 PM,48,-122,20,9,29
43271,FremontBridge,09/09/2017 11:00:00 PM,48,-122,19,11,30
43272,FremontBridge,09/10/2017 12:00:00 AM,48,-122,16,9,25
43273,FremontBridge,09/10/2017 01:00:00 AM,48,-122,6,5,11
43274,FremontBridge,09/10/2017 02:00:00 AM,48,-122,2,2,4
43275,FremontBridge,09/10/2017 03:00:00 AM,48,-122,1,2,3
43276,FremontBridge,09/10/2017 04:00:00 AM,48,-122,5,2,7
43277,FremontBridge,09/10/2017 05:00:00 AM,48,-122,1,2,3
43278,FremontBridge,09/10/2017 06:00:00 AM,48,-122,11,7,18
43279,FremontBridge,09/10/2017 07:00:00 AM,48,-122,22,26,48
43280,FremontBridge,09/10/2017 08:00:00 AM,48,-122,40,36,76
43281,FremontBridge,09/10/2017 09:00:00 AM,48,-122,55,66,121
43282,FremontBridge,09/10/2017 10:00:00 AM,48,-122,77,67,144
43283,FremontBridge,09/10/2017 11:00:00 AM,48,-122,104,95,199
43284,FremontBridge,09/10/2017 12:00:00 PM,48,-122,101,100,201
43285,FremontBridge,09/10/2017 01:00:00 PM,48,-122,109,130,239
43286,FremontBridge,09/10/2017 02:00:00 PM,48,-122,89,102,191
43287,FremontBridge,09/10/2017 03:00:00 PM,48,-122,79,77,156
43288,FremontBridge,09/10/2017 04:00:00 PM,48,-122,93,71,164
43289,FremontBridge,09/10/2017 05:00:00 PM,48,-122,77,72,149
43290,FremontBridge,09/10/2017 06:00:00 PM,48,-122,68,60,128
43291,FremontBridge,09/10/2017 07:00:00 PM,48,-122,45,37,82
43292,FremontBridge,09/10/2017 08:00:00 PM,48,-122,36,36,72
43293,FremontBridge,09/10/2017 09:00:00 PM,48,-122,28,11,39
43294,FremontBridge,09/10/2017 10:00:00 PM,48,-122,14,2,16
43295,FremontBridge,09/10/2017 11:00:00 PM,48,-122,18,2,20
43296,FremontBridge,09/11/2017 12:00:00 AM,48,-122,2,4,6
43297,FremontBridge,09/11/2017 01:00:00 AM,48,-122,2,0,2
43298,FremontBridge,09/11/2017 02:00:00 AM,48,-122,1,0,1
43299,FremontBridge,09/11/2017 03:00:00 AM,48,-122,0,1,1
43300,FremontBridge,09/11/2017 04:00:00 AM,48,-122,9,3,12
43301,FremontBridge,09/11/2017 05:00:00 AM,48,-122,16,32,48
43302,FremontBridge,09/11/2017 06:00:00 AM,48,-122,79,84,163
43303,FremontBridge,09/11/2017 07:00:00 AM,48,-122,203,265,468
43304,FremontBridge,09/11/2017 08:00:00 AM,48,-122,345,359,704
43305,FremontBridge,09/11/2017 09:00:00 AM,48,-122,174,129,303
43306,FremontBridge,09/11/2017 10:00:00 AM,48,-122,57,74,131
43307,FremontBridge,09/11/2017 11:00:00 AM,48,-122,51,46,97
43308,FremontBridge,09/11/2017 12:00:00 PM,48,-122,44,53,97
43309,FremontBridge,09/11/2017 01:00:00 PM,48,-122,38,55,93
43310,FremontBridge,09/11/2017 02:00:00 PM,48,-122,67,65,132
43311,FremontBridge,09/11/2017 03:00:00 PM,48,-122,120,79,199
43312,FremontBridge,09/11/2017 04:00:00 PM,48,-122,270,85,355
43313,FremontBridge,09/11/2017 05:00:00 PM,48,-122,599,181,780
43314,FremontBridge,09/11/2017 06:00:00 PM,48,-122,394,162,556
43315,FremontBridge,09/11/2017 07:00:00 PM,48,-122,200,73,273
43316,FremontBridge,09/11/2017 08:00:00 PM,48,-122,78,39,117
43317,FremontBridge,09/11/2017 09:00:00 PM,48,-122,50,23,73
43318,FremontBridge,09/11/2017 10:00:00 PM,48,-122,21,16,37
43319,FremontBridge,09/11/2017 11:00:00 PM,48,-122,15,17,32
43320,FremontBridge,09/12/2017 12:00:00 AM,48,-122,6,3,9
43321,FremontBridge,09/12/2017 01:00:00 AM,48,-122,4,1,5
43322,FremontBridge,09/12/2017 02:00:00 AM,48,-122,1,2,3
43323,FremontBridge,09/12/2017 03:00:00 AM,48,-122,0,1,1
43324,FremontBridge,09/12/2017 04:00:00 AM,48,-122,4,7,11
43325,FremontBridge,09/12/2017 05:00:00 AM,48,-122,15,40,55
43326,FremontBridge,09/12/2017 06:00:00 AM,48,-122,81,97,178
43327,FremontBridge,09/12/2017 07:00:00 AM,48,-122,247,297,544
43328,FremontBridge,09/12/2017 08:00:00 AM,48,-122,321,343,664
43329,FremontBridge,09/12/2017 09:00:00 AM,48,-122,164,176,340
43330,FremontBridge,09/12/2017 10:00:00 AM,48,-122,92,61,153
43331,FremontBridge,09/12/2017 11:00:00 AM,48,-122,58,42,100
43332,FremontBridge,09/12/2017 12:00:00 PM,48,-122,44,61,105
43333,FremontBridge,09/12/2017 01:00:00 PM,48,-122,61,45,106
43334,FremontBridge,09/12/2017 02:00:00 PM,48,-122,71,57,128
43335,FremontBridge,09/12/2017 03:00:00 PM,48,-122,113,79,192
43336,FremontBridge,09/12/2017 04:00:00 PM,48,-122,265,106,371
43337,FremontBridge,09/12/2017 05:00:00 PM,48,-122,599,193,792
43338,FremontBridge,09/12/2017 06:00:00 PM,48,-122,390,160,550
43339,FremontBridge,09/12/2017 07:00:00 PM,48,-122,159,99,258
43340,FremontBridge,09/12/2017 08:00:00 PM,48,-122,75,51,126
43341,FremontBridge,09/12/2017 09:00:00 PM,48,-122,46,18,64
43342,FremontBridge,09/12/2017 10:00:00 PM,48,-122,24,16,40
43343,FremontBridge,09/12/2017 11:00:00 PM,48,-122,13,4,17
43344,FremontBridge,09/13/2017 12:00:00 AM,48,-122,3,3,6
43345,FremontBridge,09/13/2017 01:00:00 AM,48,-122,1,2,3
43346,FremontBridge,09/13/2017 02:00:00 AM,48,-122,4,1,5
43347,FremontBridge,09/13/2017 03:00:00 AM,48,-122,3,0,3
43348,FremontBridge,09/13/2017 04:00:00 AM,48,-122,4,5,9
43349,FremontBridge,09/13/2017 05:00:00 AM,48,-122,15,32,47
43350,FremontBridge,09/13/2017 06:00:00 AM,48,-122,90,82,172
43351,FremontBridge,09/13/2017 07:00:00 AM,48,-122,253,253,506
43352,FremontBridge,09/13/2017 08:00:00 AM,48,-122,301,350,651
43353,FremontBridge,09/13/2017 09:00:00 AM,48,-122,168,136,304
43354,FremontBridge,09/13/2017 10:00:00 AM,48,-122,72,67,139
43355,FremontBridge,09/13/2017 11:00:00 AM,48,-122,44,41,85
43356,FremontBridge,09/13/2017 12:00:00 PM,48,-122,41,48,89
43357,FremontBridge,09/13/2017 01:00:00 PM,48,-122,66,40,106
43358,FremontBridge,09/13/2017 02:00:00 PM,48,-122,63,47,110
43359,FremontBridge,09/13/2017 03:00:00 PM,48,-122,114,64,178
43360,FremontBridge,09/13/2017 04:00:00 PM,48,-122,263,100,363
43361,FremontBridge,09/13/2017 05:00:00 PM,48,-122,557,175,732
43362,FremontBridge,09/13/2017 06:00:00 PM,48,-122,360,151,511
43363,FremontBridge,09/13/2017 07:00:00 PM,48,-122,180,87,267
43364,FremontBridge,09/13/2017 08:00:00 PM,48,-122,81,48,129
43365,FremontBridge,09/13/2017 09:00:00 PM,48,-122,52,22,74
43366,FremontBridge,09/13/2017 10:00:00 PM,48,-122,27,13,40
43367,FremontBridge,09/13/2017 11:00:00 PM,48,-122,13,13,26
43368,FremontBridge,09/14/2017 12:00:00 AM,48,-122,5,3,8
43369,FremontBridge,09/14/2017 01:00:00 AM,48,-122,4,3,7
43370,FremontBridge,09/14/2017 02:00:00 AM,48,-122,1,2,3
43371,FremontBridge,09/14/2017 03:00:00 AM,48,-122,2,1,3
43372,FremontBridge,09/14/2017 04:00:00 AM,48,-122,7,6,13
43373,FremontBridge,09/14/2017 05:00:00 AM,48,-122,8,26,34
43374,FremontBridge,09/14/2017 06:00:00 AM,48,-122,86,92,178
43375,FremontBridge,09/14/2017 07:00:00 AM,48,-122,201,237,438
43376,FremontBridge,09/14/2017 08:00:00 AM,48,-122,316,328,644
43377,FremontBridge,09/14/2017 09:00:00 AM,48,-122,178,132,310
43378,FremontBridge,09/14/2017 10:00:00 AM,48,-122,54,62,116
43379,FremontBridge,09/14/2017 11:00:00 AM,48,-122,43,52,95
43380,FremontBridge,09/14/2017 12:00:00 PM,48,-122,58,38,96
43381,FremontBridge,09/14/2017 01:00:00 PM,48,-122,51,59,110
43382,FremontBridge,09/14/2017 02:00:00 PM,48,-122,61,44,105
43383,FremontBridge,09/14/2017 03:00:00 PM,48,-122,109,53,162
43384,FremontBridge,09/14/2017 04:00:00 PM,48,-122,244,108,352
43385,FremontBridge,09/14/2017 05:00:00 PM,48,-122,531,195,726
43386,FremontBridge,09/14/2017 06:00:00 PM,48,-122,376,157,533
43387,FremontBridge,09/14/2017 07:00:00 PM,48,-122,174,79,253
43388,FremontBridge,09/14/2017 08:00:00 PM,48,-122,73,37,110
43389,FremontBridge,09/14/2017 09:00:00 PM,48,-122,38,38,76
43390,FremontBridge,09/14/2017 10:00:00 PM,48,-122,30,20,50
43391,FremontBridge,09/14/2017 11:00:00 PM,48,-122,20,9,29
43392,FremontBridge,09/15/2017 12:00:00 AM,48,-122,14,5,19
43393,FremontBridge,09/15/2017 01:00:00 AM,48,-122,6,1,7
43394,FremontBridge,09/15/2017 02:00:00 AM,48,-122,2,3,5
43395,FremontBridge,09/15/2017 03:00:00 AM,48,-122,1,1,2
43396,FremontBridge,09/15/2017 04:00:00 AM,48,-122,6,5,11
43397,FremontBridge,09/15/2017 05:00:00 AM,48,-122,10,28,38
43398,FremontBridge,09/15/2017 06:00:00 AM,48,-122,53,59,112
43399,FremontBridge,09/15/2017 07:00:00 AM,48,-122,175,221,396
43400,FremontBridge,09/15/2017 08:00:00 AM,48,-122,255,298,553
43401,FremontBridge,09/15/2017 09:00:00 AM,48,-122,147,137,284
43402,FremontBridge,09/15/2017 10:00:00 AM,48,-122,70,62,132
43403,FremontBridge,09/15/2017 11:00:00 AM,48,-122,74,50,124
43404,FremontBridge,09/15/2017 12:00:00 PM,48,-122,41,56,97
43405,FremontBridge,09/15/2017 01:00:00 PM,48,-122,63,73,136
43406,FremontBridge,09/15/2017 02:00:00 PM,48,-122,76,73,149
43407,FremontBridge,09/15/2017 03:00:00 PM,48,-122,130,84,214
43408,FremontBridge,09/15/2017 04:00:00 PM,48,-122,314,126,440
43409,FremontBridge,09/15/2017 05:00:00 PM,48,-122,446,161,607
43410,FremontBridge,09/15/2017 06:00:00 PM,48,-122,267,107,374
43411,FremontBridge,09/15/2017 07:00:00 PM,48,-122,109,74,183
43412,FremontBridge,09/15/2017 08:00:00 PM,48,-122,67,37,104
43413,FremontBridge,09/15/2017 09:00:00 PM,48,-122,41,23,64
43414,FremontBridge,09/15/2017 10:00:00 PM,48,-122,12,27,39
43415,FremontBridge,09/15/2017 11:00:00 PM,48,-122,17,9,26
43416,FremontBridge,09/16/2017 12:00:00 AM,48,-122,12,11,23
43417,FremontBridge,09/16/2017 01:00:00 AM,48,-122,6,5,11
43418,FremontBridge,09/16/2017 02:00:00 AM,48,-122,3,3,6
43419,FremontBridge,09/16/2017 03:00:00 AM,48,-122,5,2,7
43420,FremontBridge,09/16/2017 04:00:00 AM,48,-122,3,2,5
43421,FremontBridge,09/16/2017 05:00:00 AM,48,-122,3,9,12
43422,FremontBridge,09/16/2017 06:00:00 AM,48,-122,13,15,28
43423,FremontBridge,09/16/2017 07:00:00 AM,48,-122,23,20,43
43424,FremontBridge,09/16/2017 08:00:00 AM,48,-122,60,57,117
43425,FremontBridge,09/16/2017 09:00:00 AM,48,-122,55,68,123
43426,FremontBridge,09/16/2017 10:00:00 AM,48,-122,87,71,158
43427,FremontBridge,09/16/2017 11:00:00 AM,48,-122,75,62,137
43428,FremontBridge,09/16/2017 12:00:00 PM,48,-122,62,89,151
43429,FremontBridge,09/16/2017 01:00:00 PM,48,-122,94,82,176
43430,FremontBridge,09/16/2017 02:00:00 PM,48,-122,103,95,198
43431,FremontBridge,09/16/2017 03:00:00 PM,48,-122,109,76,185
43432,FremontBridge,09/16/2017 04:00:00 PM,48,-122,78,92,170
43433,FremontBridge,09/16/2017 05:00:00 PM,48,-122,88,80,168
43434,FremontBridge,09/16/2017 06:00:00 PM,48,-122,50,73,123
43435,FremontBridge,09/16/2017 07:00:00 PM,48,-122,68,35,103
43436,FremontBridge,09/16/2017 08:00:00 PM,48,-122,39,32,71
43437,FremontBridge,09/16/2017 09:00:00 PM,48,-122,18,32,50
43438,FremontBridge,09/16/2017 10:00:00 PM,48,-122,27,24,51
43439,FremontBridge,09/16/2017 11:00:00 PM,48,-122,23,14,37
43440,FremontBridge,09/17/2017 12:00:00 AM,48,-122,11,7,18
43441,FremontBridge,09/17/2017 01:00:00 AM,48,-122,5,3,8
43442,FremontBridge,09/17/2017 02:00:00 AM,48,-122,4,2,6
43443,FremontBridge,09/17/2017 03:00:00 AM,48,-122,3,0,3
43444,FremontBridge,09/17/2017 04:00:00 AM,48,-122,4,2,6
43445,FremontBridge,09/17/2017 05:00:00 AM,48,-122,3,4,7
43446,FremontBridge,09/17/2017 06:00:00 AM,48,-122,10,6,16
43447,FremontBridge,09/17/2017 07:00:00 AM,48,-122,19,15,34
43448,FremontBridge,09/17/2017 08:00:00 AM,48,-122,23,35,58
43449,FremontBridge,09/17/2017 09:00:00 AM,48,-122,57,54,111
43450,FremontBridge,09/17/2017 10:00:00 AM,48,-122,60,49,109
43451,FremontBridge,09/17/2017 11:00:00 AM,48,-122,75,68,143
43452,FremontBridge,09/17/2017 12:00:00 PM,48,-122,54,73,127
43453,FremontBridge,09/17/2017 01:00:00 PM,48,-122,44,47,91
43454,FremontBridge,09/17/2017 02:00:00 PM,48,-122,32,19,51
43455,FremontBridge,09/17/2017 03:00:00 PM,48,-122,14,28,42
43456,FremontBridge,09/17/2017 04:00:00 PM,48,-122,26,10,36
43457,FremontBridge,09/17/2017 05:00:00 PM,48,-122,22,23,45
43458,FremontBridge,09/17/2017 06:00:00 PM,48,-122,18,10,28
43459,FremontBridge,09/17/2017 07:00:00 PM,48,-122,25,13,38
43460,FremontBridge,09/17/2017 08:00:00 PM,48,-122,15,9,24
43461,FremontBridge,09/17/2017 09:00:00 PM,48,-122,8,9,17
43462,FremontBridge,09/17/2017 10:00:00 PM,48,-122,7,3,10
43463,FremontBridge,09/17/2017 11:00:00 PM,48,-122,3,2,5
43464,FremontBridge,09/18/2017 12:00:00 AM,48,-122,4,1,5
43465,FremontBridge,09/18/2017 01:00:00 AM,48,-122,2,0,2
43466,FremontBridge,09/18/2017 02:00:00 AM,48,-122,1,3,4
43467,FremontBridge,09/18/2017 03:00:00 AM,48,-122,0,2,2
43468,FremontBridge,09/18/2017 04:00:00 AM,48,-122,3,5,8
43469,FremontBridge,09/18/2017 05:00:00 AM,48,-122,16,13,29
43470,FremontBridge,09/18/2017 06:00:00 AM,48,-122,51,71,122
43471,FremontBridge,09/18/2017 07:00:00 AM,48,-122,151,169,320
43472,FremontBridge,09/18/2017 08:00:00 AM,48,-122,220,251,471
43473,FremontBridge,09/18/2017 09:00:00 AM,48,-122,124,102,226
43474,FremontBridge,09/18/2017 10:00:00 AM,48,-122,41,44,85
43475,FremontBridge,09/18/2017 11:00:00 AM,48,-122,29,32,61
43476,FremontBridge,09/18/2017 12:00:00 PM,48,-122,34,45,79
43477,FremontBridge,09/18/2017 01:00:00 PM,48,-122,36,34,70
43478,FremontBridge,09/18/2017 02:00:00 PM,48,-122,50,33,83
43479,FremontBridge,09/18/2017 03:00:00 PM,48,-122,77,51,128
43480,FremontBridge,09/18/2017 04:00:00 PM,48,-122,160,52,212
43481,FremontBridge,09/18/2017 05:00:00 PM,48,-122,420,107,527
43482,FremontBridge,09/18/2017 06:00:00 PM,48,-122,261,63,324
43483,FremontBridge,09/18/2017 07:00:00 PM,48,-122,87,30,117
43484,FremontBridge,09/18/2017 08:00:00 PM,48,-122,34,12,46
43485,FremontBridge,09/18/2017 09:00:00 PM,48,-122,25,11,36
43486,FremontBridge,09/18/2017 10:00:00 PM,48,-122,18,9,27
43487,FremontBridge,09/18/2017 11:00:00 PM,48,-122,13,14,27
43488,FremontBridge,09/19/2017 12:00:00 AM,48,-122,7,1,8
43489,FremontBridge,09/19/2017 01:00:00 AM,48,-122,1,1,2
43490,FremontBridge,09/19/2017 02:00:00 AM,48,-122,2,0,2
43491,FremontBridge,09/19/2017 03:00:00 AM,48,-122,2,0,2
43492,FremontBridge,09/19/2017 04:00:00 AM,48,-122,5,5,10
43493,FremontBridge,09/19/2017 05:00:00 AM,48,-122,9,21,30
43494,FremontBridge,09/19/2017 06:00:00 AM,48,-122,42,57,99
43495,FremontBridge,09/19/2017 07:00:00 AM,48,-122,151,150,301
43496,FremontBridge,09/19/2017 08:00:00 AM,48,-122,191,249,440
43497,FremontBridge,09/19/2017 09:00:00 AM,48,-122,114,101,215
43498,FremontBridge,09/19/2017 10:00:00 AM,48,-122,45,34,79
43499,FremontBridge,09/19/2017 11:00:00 AM,48,-122,29,22,51
43500,FremontBridge,09/19/2017 12:00:00 PM,48,-122,25,28,53
43501,FremontBridge,09/19/2017 01:00:00 PM,48,-122,18,21,39
43502,FremontBridge,09/19/2017 02:00:00 PM,48,-122,29,29,58
43503,FremontBridge,09/19/2017 03:00:00 PM,48,-122,56,33,89
43504,FremontBridge,09/19/2017 04:00:00 PM,48,-122,144,54,198
43505,FremontBridge,09/19/2017 05:00:00 PM,48,-122,341,67,408
43506,FremontBridge,09/19/2017 06:00:00 PM,48,-122,185,84,269
43507,FremontBridge,09/19/2017 07:00:00 PM,48,-122,85,28,113
43508,FremontBridge,09/19/2017 08:00:00 PM,48,-122,40,19,59
43509,FremontBridge,09/19/2017 09:00:00 PM,48,-122,19,5,24
43510,FremontBridge,09/19/2017 10:00:00 PM,48,-122,8,5,13
43511,FremontBridge,09/19/2017 11:00:00 PM,48,-122,15,3,18
43512,FremontBridge,09/20/2017 12:00:00 AM,48,-122,1,2,3
43513,FremontBridge,09/20/2017 01:00:00 AM,48,-122,0,0,0
43514,FremontBridge,09/20/2017 02:00:00 AM,48,-122,1,1,2
43515,FremontBridge,09/20/2017 03:00:00 AM,48,-122,1,1,2
43516,FremontBridge,09/20/2017 04:00:00 AM,48,-122,4,7,11
43517,FremontBridge,09/20/2017 05:00:00 AM,48,-122,15,21,36
43518,FremontBridge,09/20/2017 06:00:00 AM,48,-122,62,69,131
43519,FremontBridge,09/20/2017 07:00:00 AM,48,-122,157,163,320
43520,FremontBridge,09/20/2017 08:00:00 AM,48,-122,210,273,483
43521,FremontBridge,09/20/2017 09:00:00 AM,48,-122,123,118,241
43522,FremontBridge,09/20/2017 10:00:00 AM,48,-122,56,46,102
43523,FremontBridge,09/20/2017 11:00:00 AM,48,-122,37,35,72
43524,FremontBridge,09/20/2017 12:00:00 PM,48,-122,36,22,58
43525,FremontBridge,09/20/2017 01:00:00 PM,48,-122,44,37,81
43526,FremontBridge,09/20/2017 02:00:00 PM,48,-122,42,52,94
43527,FremontBridge,09/20/2017 03:00:00 PM,48,-122,76,49,125
43528,FremontBridge,09/20/2017 04:00:00 PM,48,-122,218,100,318
43529,FremontBridge,09/20/2017 05:00:00 PM,48,-122,407,128,535
43530,FremontBridge,09/20/2017 06:00:00 PM,48,-122,249,135,384
43531,FremontBridge,09/20/2017 07:00:00 PM,48,-122,100,51,151
43532,FremontBridge,09/20/2017 08:00:00 PM,48,-122,57,30,87
43533,FremontBridge,09/20/2017 09:00:00 PM,48,-122,30,19,49
43534,FremontBridge,09/20/2017 10:00:00 PM,48,-122,18,7,25
43535,FremontBridge,09/20/2017 11:00:00 PM,48,-122,12,9,21
43536,FremontBridge,09/21/2017 12:00:00 AM,48,-122,6,2,8
43537,FremontBridge,09/21/2017 01:00:00 AM,48,-122,0,5,5
43538,FremontBridge,09/21/2017 02:00:00 AM,48,-122,1,0,1
43539,FremontBridge,09/21/2017 03:00:00 AM,48,-122,0,1,1
43540,FremontBridge,09/21/2017 04:00:00 AM,48,-122,2,10,12
43541,FremontBridge,09/21/2017 05:00:00 AM,48,-122,16,24,40
43542,FremontBridge,09/21/2017 06:00:00 AM,48,-122,51,55,106
43543,FremontBridge,09/21/2017 07:00:00 AM,48,-122,150,176,326
43544,FremontBridge,09/21/2017 08:00:00 AM,48,-122,218,249,467
43545,FremontBridge,09/21/2017 09:00:00 AM,48,-122,130,121,251
43546,FremontBridge,09/21/2017 10:00:00 AM,48,-122,61,45,106
43547,FremontBridge,09/21/2017 11:00:00 AM,48,-122,35,30,65
43548,FremontBridge,09/21/2017 12:00:00 PM,48,-122,26,33,59
43549,FremontBridge,09/21/2017 01:00:00 PM,48,-122,46,35,81
43550,FremontBridge,09/21/2017 02:00:00 PM,48,-122,62,46,108
43551,FremontBridge,09/21/2017 03:00:00 PM,48,-122,86,59,145
43552,FremontBridge,09/21/2017 04:00:00 PM,48,-122,196,93,289
43553,FremontBridge,09/21/2017 05:00:00 PM,48,-122,432,145,577
43554,FremontBridge,09/21/2017 06:00:00 PM,48,-122,252,113,365
43555,FremontBridge,09/21/2017 07:00:00 PM,48,-122,100,55,155
43556,FremontBridge,09/21/2017 08:00:00 PM,48,-122,61,28,89
43557,FremontBridge,09/21/2017 09:00:00 PM,48,-122,28,24,52
43558,FremontBridge,09/21/2017 10:00:00 PM,48,-122,21,21,42
43559,FremontBridge,09/21/2017 11:00:00 PM,48,-122,13,7,20
43560,FremontBridge,09/22/2017 12:00:00 AM,48,-122,4,3,7
43561,FremontBridge,09/22/2017 01:00:00 AM,48,-122,5,1,6
43562,FremontBridge,09/22/2017 02:00:00 AM,48,-122,2,4,6
43563,FremontBridge,09/22/2017 03:00:00 AM,48,-122,1,1,2
43564,FremontBridge,09/22/2017 04:00:00 AM,48,-122,5,1,6
43565,FremontBridge,09/22/2017 05:00:00 AM,48,-122,13,28,41
43566,FremontBridge,09/22/2017 06:00:00 AM,48,-122,54,62,116
43567,FremontBridge,09/22/2017 07:00:00 AM,48,-122,144,185,329
43568,FremontBridge,09/22/2017 08:00:00 AM,48,-122,220,276,496
43569,FremontBridge,09/22/2017 09:00:00 AM,48,-122,143,149,292
43570,FremontBridge,09/22/2017 10:00:00 AM,48,-122,63,64,127
43571,FremontBridge,09/22/2017 11:00:00 AM,48,-122,65,53,118
43572,FremontBridge,09/22/2017 12:00:00 PM,48,-122,67,50,117
43573,FremontBridge,09/22/2017 01:00:00 PM,48,-122,63,62,125
43574,FremontBridge,09/22/2017 02:00:00 PM,48,-122,85,59,144
43575,FremontBridge,09/22/2017 03:00:00 PM,48,-122,114,87,201
43576,FremontBridge,09/22/2017 04:00:00 PM,48,-122,299,109,408
43577,FremontBridge,09/22/2017 05:00:00 PM,48,-122,432,167,599
43578,FremontBridge,09/22/2017 06:00:00 PM,48,-122,224,111,335
43579,FremontBridge,09/22/2017 07:00:00 PM,48,-122,112,54,166
43580,FremontBridge,09/22/2017 08:00:00 PM,48,-122,46,23,69
43581,FremontBridge,09/22/2017 09:00:00 PM,48,-122,36,18,54
43582,FremontBridge,09/22/2017 10:00:00 PM,48,-122,23,21,44
43583,FremontBridge,09/22/2017 11:00:00 PM,48,-122,16,16,32
43584,FremontBridge,09/23/2017 12:00:00 AM,48,-122,18,11,29
43585,FremontBridge,09/23/2017 01:00:00 AM,48,-122,8,6,14
43586,FremontBridge,09/23/2017 02:00:00 AM,48,-122,5,1,6
43587,FremontBridge,09/23/2017 03:00:00 AM,48,-122,0,2,2
43588,FremontBridge,09/23/2017 04:00:00 AM,48,-122,1,3,4
43589,FremontBridge,09/23/2017 05:00:00 AM,48,-122,4,4,8
43590,FremontBridge,09/23/2017 06:00:00 AM,48,-122,9,10,19
43591,FremontBridge,09/23/2017 07:00:00 AM,48,-122,19,19,38
43592,FremontBridge,09/23/2017 08:00:00 AM,48,-122,46,38,84
43593,FremontBridge,09/23/2017 09:00:00 AM,48,-122,44,58,102
43594,FremontBridge,09/23/2017 10:00:00 AM,48,-122,67,84,151
43595,FremontBridge,09/23/2017 11:00:00 AM,48,-122,95,87,182
43596,FremontBridge,09/23/2017 12:00:00 PM,48,-122,81,93,174
43597,FremontBridge,09/23/2017 01:00:00 PM,48,-122,104,97,201
43598,FremontBridge,09/23/2017 02:00:00 PM,48,-122,115,84,199
43599,FremontBridge,09/23/2017 03:00:00 PM,48,-122,139,89,228
43600,FremontBridge,09/23/2017 04:00:00 PM,48,-122,81,106,187
43601,FremontBridge,09/23/2017 05:00:00 PM,48,-122,91,73,164
43602,FremontBridge,09/23/2017 06:00:00 PM,48,-122,86,80,166
43603,FremontBridge,09/23/2017 07:00:00 PM,48,-122,30,55,85
43604,FremontBridge,09/23/2017 08:00:00 PM,48,-122,44,18,62
43605,FremontBridge,09/23/2017 09:00:00 PM,48,-122,12,25,37
43606,FremontBridge,09/23/2017 10:00:00 PM,48,-122,13,19,32
43607,FremontBridge,09/23/2017 11:00:00 PM,48,-122,13,20,33
43608,FremontBridge,09/24/2017 12:00:00 AM,48,-122,9,13,22
43609,FremontBridge,09/24/2017 01:00:00 AM,48,-122,6,5,11
43610,FremontBridge,09/24/2017 02:00:00 AM,48,-122,4,2,6
43611,FremontBridge,09/24/2017 03:00:00 AM,48,-122,2,1,3
43612,FremontBridge,09/24/2017 04:00:00 AM,48,-122,2,3,5
43613,FremontBridge,09/24/2017 05:00:00 AM,48,-122,0,5,5
43614,FremontBridge,09/24/2017 06:00:00 AM,48,-122,13,3,16
43615,FremontBridge,09/24/2017 07:00:00 AM,48,-122,19,20,39
43616,FremontBridge,09/24/2017 08:00:00 AM,48,-122,36,27,63
43617,FremontBridge,09/24/2017 09:00:00 AM,48,-122,42,45,87
43618,FremontBridge,09/24/2017 10:00:00 AM,48,-122,41,45,86
43619,FremontBridge,09/24/2017 11:00:00 AM,48,-122,77,69,146
43620,FremontBridge,09/24/2017 12:00:00 PM,48,-122,83,99,182
43621,FremontBridge,09/24/2017 01:00:00 PM,48,-122,81,93,174
43622,FremontBridge,09/24/2017 02:00:00 PM,48,-122,112,104,216
43623,FremontBridge,09/24/2017 03:00:00 PM,48,-122,90,85,175
43624,FremontBridge,09/24/2017 04:00:00 PM,48,-122,104,111,215
43625,FremontBridge,09/24/2017 05:00:00 PM,48,-122,108,85,193
43626,FremontBridge,09/24/2017 06:00:00 PM,48,-122,69,70,139
43627,FremontBridge,09/24/2017 07:00:00 PM,48,-122,45,41,86
43628,FremontBridge,09/24/2017 08:00:00 PM,48,-122,22,25,47
43629,FremontBridge,09/24/2017 09:00:00 PM,48,-122,14,11,25
43630,FremontBridge,09/24/2017 10:00:00 PM,48,-122,7,6,13
43631,FremontBridge,09/24/2017 11:00:00 PM,48,-122,5,9,14
43632,FremontBridge,09/25/2017 12:00:00 AM,48,-122,7,8,15
43633,FremontBridge,09/25/2017 01:00:00 AM,48,-122,2,1,3
43634,FremontBridge,09/25/2017 02:00:00 AM,48,-122,1,2,3
43635,FremontBridge,09/25/2017 03:00:00 AM,48,-122,1,3,4
43636,FremontBridge,09/25/2017 04:00:00 AM,48,-122,8,8,16
43637,FremontBridge,09/25/2017 05:00:00 AM,48,-122,10,18,28
43638,FremontBridge,09/25/2017 06:00:00 AM,48,-122,66,78,144
43639,FremontBridge,09/25/2017 07:00:00 AM,48,-122,147,177,324
43640,FremontBridge,09/25/2017 08:00:00 AM,48,-122,249,296,545
43641,FremontBridge,09/25/2017 09:00:00 AM,48,-122,134,126,260
43642,FremontBridge,09/25/2017 10:00:00 AM,48,-122,47,48,95
43643,FremontBridge,09/25/2017 11:00:00 AM,48,-122,26,41,67
43644,FremontBridge,09/25/2017 12:00:00 PM,48,-122,43,34,77
43645,FremontBridge,09/25/2017 01:00:00 PM,48,-122,33,33,66
43646,FremontBridge,09/25/2017 02:00:00 PM,48,-122,39,32,71
43647,FremontBridge,09/25/2017 03:00:00 PM,48,-122,88,58,146
43648,FremontBridge,09/25/2017 04:00:00 PM,48,-122,214,94,308
43649,FremontBridge,09/25/2017 05:00:00 PM,48,-122,453,121,574
43650,FremontBridge,09/25/2017 06:00:00 PM,48,-122,273,99,372
43651,FremontBridge,09/25/2017 07:00:00 PM,48,-122,101,42,143
43652,FremontBridge,09/25/2017 08:00:00 PM,48,-122,46,20,66
43653,FremontBridge,09/25/2017 09:00:00 PM,48,-122,30,21,51
43654,FremontBridge,09/25/2017 10:00:00 PM,48,-122,22,10,32
43655,FremontBridge,09/25/2017 11:00:00 PM,48,-122,12,9,21
43656,FremontBridge,09/26/2017 12:00:00 AM,48,-122,4,3,7
43657,FremontBridge,09/26/2017 01:00:00 AM,48,-122,5,1,6
43658,FremontBridge,09/26/2017 02:00:00 AM,48,-122,2,0,2
43659,FremontBridge,09/26/2017 03:00:00 AM,48,-122,0,3,3
43660,FremontBridge,09/26/2017 04:00:00 AM,48,-122,6,8,14
43661,FremontBridge,09/26/2017 05:00:00 AM,48,-122,15,25,40
43662,FremontBridge,09/26/2017 06:00:00 AM,48,-122,73,86,159
43663,FremontBridge,09/26/2017 07:00:00 AM,48,-122,228,255,483
43664,FremontBridge,09/26/2017 08:00:00 AM,48,-122,298,353,651
43665,FremontBridge,09/26/2017 09:00:00 AM,48,-122,165,158,323
43666,FremontBridge,09/26/2017 10:00:00 AM,48,-122,66,82,148
43667,FremontBridge,09/26/2017 11:00:00 AM,48,-122,51,51,102
43668,FremontBridge,09/26/2017 12:00:00 PM,48,-122,68,51,119
43669,FremontBridge,09/26/2017 01:00:00 PM,48,-122,51,63,114
43670,FremontBridge,09/26/2017 02:00:00 PM,48,-122,53,49,102
43671,FremontBridge,09/26/2017 03:00:00 PM,48,-122,117,87,204
43672,FremontBridge,09/26/2017 04:00:00 PM,48,-122,257,110,367
43673,FremontBridge,09/26/2017 05:00:00 PM,48,-122,585,207,792
43674,FremontBridge,09/26/2017 06:00:00 PM,48,-122,381,151,532
43675,FremontBridge,09/26/2017 07:00:00 PM,48,-122,150,84,234
43676,FremontBridge,09/26/2017 08:00:00 PM,48,-122,80,35,115
43677,FremontBridge,09/26/2017 09:00:00 PM,48,-122,41,30,71
43678,FremontBridge,09/26/2017 10:00:00 PM,48,-122,22,21,43
43679,FremontBridge,09/26/2017 11:00:00 PM,48,-122,15,3,18
43680,FremontBridge,09/27/2017 12:00:00 AM,48,-122,6,4,10
43681,FremontBridge,09/27/2017 01:00:00 AM,48,-122,2,2,4
43682,FremontBridge,09/27/2017 02:00:00 AM,48,-122,2,0,2
43683,FremontBridge,09/27/2017 03:00:00 AM,48,-122,1,2,3
43684,FremontBridge,09/27/2017 04:00:00 AM,48,-122,4,8,12
43685,FremontBridge,09/27/2017 05:00:00 AM,48,-122,14,23,37
43686,FremontBridge,09/27/2017 06:00:00 AM,48,-122,69,102,171
43687,FremontBridge,09/27/2017 07:00:00 AM,48,-122,222,255,477
43688,FremontBridge,09/27/2017 08:00:00 AM,48,-122,305,340,645
43689,FremontBridge,09/27/2017 09:00:00 AM,48,-122,184,168,352
43690,FremontBridge,09/27/2017 10:00:00 AM,48,-122,86,70,156
43691,FremontBridge,09/27/2017 11:00:00 AM,48,-122,45,60,105
43692,FremontBridge,09/27/2017 12:00:00 PM,48,-122,50,52,102
43693,FremontBridge,09/27/2017 01:00:00 PM,48,-122,57,58,115
43694,FremontBridge,09/27/2017 02:00:00 PM,48,-122,71,61,132
43695,FremontBridge,09/27/2017 03:00:00 PM,48,-122,118,82,200
43696,FremontBridge,09/27/2017 04:00:00 PM,48,-122,299,130,429
43697,FremontBridge,09/27/2017 05:00:00 PM,48,-122,569,191,760
43698,FremontBridge,09/27/2017 06:00:00 PM,48,-122,349,168,517
43699,FremontBridge,09/27/2017 07:00:00 PM,48,-122,154,80,234
43700,FremontBridge,09/27/2017 08:00:00 PM,48,-122,65,51,116
43701,FremontBridge,09/27/2017 09:00:00 PM,48,-122,54,17,71
43702,FremontBridge,09/27/2017 10:00:00 PM,48,-122,44,31,75
43703,FremontBridge,09/27/2017 11:00:00 PM,48,-122,20,13,33
43704,FremontBridge,09/28/2017 12:00:00 AM,48,-122,8,7,15
43705,FremontBridge,09/28/2017 01:00:00 AM,48,-122,2,3,5
43706,FremontBridge,09/28/2017 02:00:00 AM,48,-122,3,0,3
43707,FremontBridge,09/28/2017 03:00:00 AM,48,-122,0,0,0
43708,FremontBridge,09/28/2017 04:00:00 AM,48,-122,5,8,13
43709,FremontBridge,09/28/2017 05:00:00 AM,48,-122,16,24,40
43710,FremontBridge,09/28/2017 06:00:00 AM,48,-122,74,97,171
43711,FremontBridge,09/28/2017 07:00:00 AM,48,-122,227,250,477
43712,FremontBridge,09/28/2017 08:00:00 AM,48,-122,303,343,646
43713,FremontBridge,09/28/2017 09:00:00 AM,48,-122,177,167,344
43714,FremontBridge,09/28/2017 10:00:00 AM,48,-122,71,70,141
43715,FremontBridge,09/28/2017 11:00:00 AM,48,-122,58,68,126
43716,FremontBridge,09/28/2017 12:00:00 PM,48,-122,66,51,117
43717,FremontBridge,09/28/2017 01:00:00 PM,48,-122,69,59,128
43718,FremontBridge,09/28/2017 02:00:00 PM,48,-122,79,62,141
43719,FremontBridge,09/28/2017 03:00:00 PM,48,-122,146,98,244
43720,FremontBridge,09/28/2017 04:00:00 PM,48,-122,306,171,477
43721,FremontBridge,09/28/2017 05:00:00 PM,48,-122,611,240,851
43722,FremontBridge,09/28/2017 06:00:00 PM,48,-122,274,167,441
43723,FremontBridge,09/28/2017 07:00:00 PM,48,-122,155,93,248
43724,FremontBridge,09/28/2017 08:00:00 PM,48,-122,71,47,118
43725,FremontBridge,09/28/2017 09:00:00 PM,48,-122,54,33,87
43726,FremontBridge,09/28/2017 10:00:00 PM,48,-122,33,22,55
43727,FremontBridge,09/28/2017 11:00:00 PM,48,-122,16,9,25
43728,FremontBridge,09/29/2017 12:00:00 AM,48,-122,8,4,12
43729,FremontBridge,09/29/2017 01:00:00 AM,48,-122,8,5,13
43730,FremontBridge,09/29/2017 02:00:00 AM,48,-122,2,0,2
43731,FremontBridge,09/29/2017 03:00:00 AM,48,-122,5,1,6
43732,FremontBridge,09/29/2017 04:00:00 AM,48,-122,2,4,6
43733,FremontBridge,09/29/2017 05:00:00 AM,48,-122,17,12,29
43734,FremontBridge,09/29/2017 06:00:00 AM,48,-122,58,61,119
43735,FremontBridge,09/29/2017 07:00:00 AM,48,-122,157,182,339
43736,FremontBridge,09/29/2017 08:00:00 AM,48,-122,188,229,417
43737,FremontBridge,09/29/2017 09:00:00 AM,48,-122,91,87,178
43738,FremontBridge,09/29/2017 10:00:00 AM,48,-122,40,37,77
43739,FremontBridge,09/29/2017 11:00:00 AM,48,-122,23,34,57
43740,FremontBridge,09/29/2017 12:00:00 PM,48,-122,30,24,54
43741,FremontBridge,09/29/2017 01:00:00 PM,48,-122,41,33,74
43742,FremontBridge,09/29/2017 02:00:00 PM,48,-122,47,38,85
43743,FremontBridge,09/29/2017 03:00:00 PM,48,-122,85,52,137
43744,FremontBridge,09/29/2017 04:00:00 PM,48,-122,199,96,295
43745,FremontBridge,09/29/2017 05:00:00 PM,48,-122,350,138,488
43746,FremontBridge,09/29/2017 06:00:00 PM,48,-122,170,77,247
43747,FremontBridge,09/29/2017 07:00:00 PM,48,-122,104,52,156
43748,FremontBridge,09/29/2017 08:00:00 PM,48,-122,41,32,73
43749,FremontBridge,09/29/2017 09:00:00 PM,48,-122,23,11,34
43750,FremontBridge,09/29/2017 10:00:00 PM,48,-122,24,15,39
43751,FremontBridge,09/29/2017 11:00:00 PM,48,-122,17,16,33
43752,FremontBridge,09/30/2017 12:00:00 AM,48,-122,12,7,19
43753,FremontBridge,09/30/2017 01:00:00 AM,48,-122,4,3,7
43754,FremontBridge,09/30/2017 02:00:00 AM,48,-122,2,5,7
43755,FremontBridge,09/30/2017 03:00:00 AM,48,-122,1,2,3
43756,FremontBridge,09/30/2017 04:00:00 AM,48,-122,0,2,2
43757,FremontBridge,09/30/2017 05:00:00 AM,48,-122,5,3,8
43758,FremontBridge,09/30/2017 06:00:00 AM,48,-122,7,6,13
43759,FremontBridge,09/30/2017 07:00:00 AM,48,-122,20,10,30
43760,FremontBridge,09/30/2017 08:00:00 AM,48,-122,29,28,57
43761,FremontBridge,09/30/2017 09:00:00 AM,48,-122,37,42,79
43762,FremontBridge,09/30/2017 10:00:00 AM,48,-122,32,58,90
43763,FremontBridge,09/30/2017 11:00:00 AM,48,-122,61,84,145
43764,FremontBridge,09/30/2017 12:00:00 PM,48,-122,63,69,132
43765,FremontBridge,09/30/2017 01:00:00 PM,48,-122,71,68,139
43766,FremontBridge,09/30/2017 02:00:00 PM,48,-122,61,67,128
43767,FremontBridge,09/30/2017 03:00:00 PM,48,-122,48,48,96
43768,FremontBridge,09/30/2017 04:00:00 PM,48,-122,35,29,64
43769,FremontBridge,09/30/2017 05:00:00 PM,48,-122,26,32,58
43770,FremontBridge,09/30/2017 06:00:00 PM,48,-122,26,33,59
43771,FremontBridge,09/30/2017 07:00:00 PM,48,-122,23,16,39
43772,FremontBridge,09/30/2017 08:00:00 PM,48,-122,25,12,37
43773,FremontBridge,09/30/2017 09:00:00 PM,48,-122,29,10,39
43774,FremontBridge,09/30/2017 10:00:00 PM,48,-122,10,5,15
43775,FremontBridge,09/30/2017 11:00:00 PM,48,-122,13,5,18
43776,FremontBridge,10/01/2017 12:00:00 AM,48,-122,17,2,19
43777,FremontBridge,10/01/2017 01:00:00 AM,48,-122,3,4,7
43778,FremontBridge,10/01/2017 02:00:00 AM,48,-122,2,2,4
43779,FremontBridge,10/01/2017 03:00:00 AM,48,-122,2,0,2
43780,FremontBridge,10/01/2017 04:00:00 AM,48,-122,0,4,4
43781,FremontBridge,10/01/2017 05:00:00 AM,48,-122,1,3,4
43782,FremontBridge,10/01/2017 06:00:00 AM,48,-122,3,3,6
43783,FremontBridge,10/01/2017 07:00:00 AM,48,-122,11,7,18
43784,FremontBridge,10/01/2017 08:00:00 AM,48,-122,25,18,43
43785,FremontBridge,10/01/2017 09:00:00 AM,48,-122,37,39,76
43786,FremontBridge,10/01/2017 10:00:00 AM,48,-122,43,51,94
43787,FremontBridge,10/01/2017 11:00:00 AM,48,-122,49,56,105
43788,FremontBridge,10/01/2017 12:00:00 PM,48,-122,62,58,120
43789,FremontBridge,10/01/2017 01:00:00 PM,48,-122,62,70,132
43790,FremontBridge,10/01/2017 02:00:00 PM,48,-122,72,66,138
43791,FremontBridge,10/01/2017 03:00:00 PM,48,-122,83,73,156
43792,FremontBridge,10/01/2017 04:00:00 PM,48,-122,65,79,144
43793,FremontBridge,10/01/2017 05:00:00 PM,48,-122,52,50,102
43794,FremontBridge,10/01/2017 06:00:00 PM,48,-122,30,47,77
43795,FremontBridge,10/01/2017 07:00:00 PM,48,-122,19,23,42
43796,FremontBridge,10/01/2017 08:00:00 PM,48,-122,15,18,33
43797,FremontBridge,10/01/2017 09:00:00 PM,48,-122,20,10,30
43798,FremontBridge,10/01/2017 10:00:00 PM,48,-122,8,5,13
43799,FremontBridge,10/01/2017 11:00:00 PM,48,-122,4,5,9
43800,FremontBridge,10/02/2017 12:00:00 AM,48,-122,3,2,5
43801,FremontBridge,10/02/2017 01:00:00 AM,48,-122,1,0,1
43802,FremontBridge,10/02/2017 02:00:00 AM,48,-122,1,0,1
43803,FremontBridge,10/02/2017 03:00:00 AM,48,-122,1,1,2
43804,FremontBridge,10/02/2017 04:00:00 AM,48,-122,4,7,11
43805,FremontBridge,10/02/2017 05:00:00 AM,48,-122,18,26,44
43806,FremontBridge,10/02/2017 06:00:00 AM,48,-122,72,85,157
43807,FremontBridge,10/02/2017 07:00:00 AM,48,-122,189,215,404
43808,FremontBridge,10/02/2017 08:00:00 AM,48,-122,286,295,581
43809,FremontBridge,10/02/2017 09:00:00 AM,48,-122,163,158,321
43810,FremontBridge,10/02/2017 10:00:00 AM,48,-122,69,53,122
43811,FremontBridge,10/02/2017 11:00:00 AM,48,-122,27,47,74
43812,FremontBridge,10/02/2017 12:00:00 PM,48,-122,35,36,71
43813,FremontBridge,10/02/2017 01:00:00 PM,48,-122,35,29,64
43814,FremontBridge,10/02/2017 02:00:00 PM,48,-122,48,37,85
43815,FremontBridge,10/02/2017 03:00:00 PM,48,-122,89,76,165
43816,FremontBridge,10/02/2017 04:00:00 PM,48,-122,219,86,305
43817,FremontBridge,10/02/2017 05:00:00 PM,48,-122,551,159,710
43818,FremontBridge,10/02/2017 06:00:00 PM,48,-122,321,110,431
43819,FremontBridge,10/02/2017 07:00:00 PM,48,-122,126,56,182
43820,FremontBridge,10/02/2017 08:00:00 PM,48,-122,66,29,95
43821,FremontBridge,10/02/2017 09:00:00 PM,48,-122,37,25,62
43822,FremontBridge,10/02/2017 10:00:00 PM,48,-122,11,12,23
43823,FremontBridge,10/02/2017 11:00:00 PM,48,-122,9,7,16
43824,FremontBridge,10/03/2017 12:00:00 AM,48,-122,6,3,9
43825,FremontBridge,10/03/2017 01:00:00 AM,48,-122,2,2,4
43826,FremontBridge,10/03/2017 02:00:00 AM,48,-122,3,7,10
43827,FremontBridge,10/03/2017 03:00:00 AM,48,-122,1,0,1
43828,FremontBridge,10/03/2017 04:00:00 AM,48,-122,4,5,9
43829,FremontBridge,10/03/2017 05:00:00 AM,48,-122,12,21,33
43830,FremontBridge,10/03/2017 06:00:00 AM,48,-122,73,94,167
43831,FremontBridge,10/03/2017 07:00:00 AM,48,-122,210,237,447
43832,FremontBridge,10/03/2017 08:00:00 AM,48,-122,326,350,676
43833,FremontBridge,10/03/2017 09:00:00 AM,48,-122,157,138,295
43834,FremontBridge,10/03/2017 10:00:00 AM,48,-122,74,59,133
43835,FremontBridge,10/03/2017 11:00:00 AM,48,-122,46,43,89
43836,FremontBridge,10/03/2017 12:00:00 PM,48,-122,49,45,94
43837,FremontBridge,10/03/2017 01:00:00 PM,48,-122,49,54,103
43838,FremontBridge,10/03/2017 02:00:00 PM,48,-122,82,55,137
43839,FremontBridge,10/03/2017 03:00:00 PM,48,-122,108,65,173
43840,FremontBridge,10/03/2017 04:00:00 PM,48,-122,253,118,371
43841,FremontBridge,10/03/2017 05:00:00 PM,48,-122,566,176,742
43842,FremontBridge,10/03/2017 06:00:00 PM,48,-122,355,136,491
43843,FremontBridge,10/03/2017 07:00:00 PM,48,-122,136,62,198
43844,FremontBridge,10/03/2017 08:00:00 PM,48,-122,71,39,110
43845,FremontBridge,10/03/2017 09:00:00 PM,48,-122,47,20,67
43846,FremontBridge,10/03/2017 10:00:00 PM,48,-122,17,23,40
43847,FremontBridge,10/03/2017 11:00:00 PM,48,-122,13,5,18
43848,FremontBridge,10/04/2017 12:00:00 AM,48,-122,7,0,7
43849,FremontBridge,10/04/2017 01:00:00 AM,48,-122,1,1,2
43850,FremontBridge,10/04/2017 02:00:00 AM,48,-122,3,1,4
43851,FremontBridge,10/04/2017 03:00:00 AM,48,-122,3,0,3
43852,FremontBridge,10/04/2017 04:00:00 AM,48,-122,6,7,13
43853,FremontBridge,10/04/2017 05:00:00 AM,48,-122,12,26,38
43854,FremontBridge,10/04/2017 06:00:00 AM,48,-122,81,77,158
43855,FremontBridge,10/04/2017 07:00:00 AM,48,-122,221,240,461
43856,FremontBridge,10/04/2017 08:00:00 AM,48,-122,267,315,582
43857,FremontBridge,10/04/2017 09:00:00 AM,48,-122,155,141,296
43858,FremontBridge,10/04/2017 10:00:00 AM,48,-122,82,54,136
43859,FremontBridge,10/04/2017 11:00:00 AM,48,-122,48,46,94
43860,FremontBridge,10/04/2017 12:00:00 PM,48,-122,49,41,90
43861,FremontBridge,10/04/2017 01:00:00 PM,48,-122,39,56,95
43862,FremontBridge,10/04/2017 02:00:00 PM,48,-122,78,60,138
43863,FremontBridge,10/04/2017 03:00:00 PM,48,-122,99,73,172
43864,FremontBridge,10/04/2017 04:00:00 PM,48,-122,269,95,364
43865,FremontBridge,10/04/2017 05:00:00 PM,48,-122,534,178,712
43866,FremontBridge,10/04/2017 06:00:00 PM,48,-122,329,138,467
43867,FremontBridge,10/04/2017 07:00:00 PM,48,-122,125,56,181
43868,FremontBridge,10/04/2017 08:00:00 PM,48,-122,60,36,96
43869,FremontBridge,10/04/2017 09:00:00 PM,48,-122,38,33,71
43870,FremontBridge,10/04/2017 10:00:00 PM,48,-122,27,19,46
43871,FremontBridge,10/04/2017 11:00:00 PM,48,-122,8,5,13
43872,FremontBridge,10/05/2017 12:00:00 AM,48,-122,6,4,10
43873,FremontBridge,10/05/2017 01:00:00 AM,48,-122,4,1,5
43874,FremontBridge,10/05/2017 02:00:00 AM,48,-122,1,0,1
43875,FremontBridge,10/05/2017 03:00:00 AM,48,-122,0,1,1
43876,FremontBridge,10/05/2017 04:00:00 AM,48,-122,4,4,8
43877,FremontBridge,10/05/2017 05:00:00 AM,48,-122,13,22,35
43878,FremontBridge,10/05/2017 06:00:00 AM,48,-122,74,76,150
43879,FremontBridge,10/05/2017 07:00:00 AM,48,-122,198,220,418
43880,FremontBridge,10/05/2017 08:00:00 AM,48,-122,270,323,593
43881,FremontBridge,10/05/2017 09:00:00 AM,48,-122,160,146,306
43882,FremontBridge,10/05/2017 10:00:00 AM,48,-122,67,69,136
43883,FremontBridge,10/05/2017 11:00:00 AM,48,-122,40,45,85
43884,FremontBridge,10/05/2017 12:00:00 PM,48,-122,60,44,104
43885,FremontBridge,10/05/2017 01:00:00 PM,48,-122,50,44,94
43886,FremontBridge,10/05/2017 02:00:00 PM,48,-122,86,48,134
43887,FremontBridge,10/05/2017 03:00:00 PM,48,-122,90,76,166
43888,FremontBridge,10/05/2017 04:00:00 PM,48,-122,245,105,350
43889,FremontBridge,10/05/2017 05:00:00 PM,48,-122,512,151,663
43890,FremontBridge,10/05/2017 06:00:00 PM,48,-122,335,134,469
43891,FremontBridge,10/05/2017 07:00:00 PM,48,-122,128,67,195
43892,FremontBridge,10/05/2017 08:00:00 PM,48,-122,59,26,85
43893,FremontBridge,10/05/2017 09:00:00 PM,48,-122,52,38,90
43894,FremontBridge,10/05/2017 10:00:00 PM,48,-122,20,23,43
43895,FremontBridge,10/05/2017 11:00:00 PM,48,-122,23,9,32
43896,FremontBridge,10/06/2017 12:00:00 AM,48,-122,5,3,8
43897,FremontBridge,10/06/2017 01:00:00 AM,48,-122,2,1,3
43898,FremontBridge,10/06/2017 02:00:00 AM,48,-122,1,0,1
43899,FremontBridge,10/06/2017 03:00:00 AM,48,-122,1,1,2
43900,FremontBridge,10/06/2017 04:00:00 AM,48,-122,5,4,9
43901,FremontBridge,10/06/2017 05:00:00 AM,48,-122,12,21,33
43902,FremontBridge,10/06/2017 06:00:00 AM,48,-122,45,70,115
43903,FremontBridge,10/06/2017 07:00:00 AM,48,-122,158,193,351
43904,FremontBridge,10/06/2017 08:00:00 AM,48,-122,231,296,527
43905,FremontBridge,10/06/2017 09:00:00 AM,48,-122,153,137,290
43906,FremontBridge,10/06/2017 10:00:00 AM,48,-122,63,59,122
43907,FremontBridge,10/06/2017 11:00:00 AM,48,-122,51,36,87
43908,FremontBridge,10/06/2017 12:00:00 PM,48,-122,63,32,95
43909,FremontBridge,10/06/2017 01:00:00 PM,48,-122,50,49,99
43910,FremontBridge,10/06/2017 02:00:00 PM,48,-122,58,51,109
43911,FremontBridge,10/06/2017 03:00:00 PM,48,-122,112,67,179
43912,FremontBridge,10/06/2017 04:00:00 PM,48,-122,271,107,378
43913,FremontBridge,10/06/2017 05:00:00 PM,48,-122,426,138,564
43914,FremontBridge,10/06/2017 06:00:00 PM,48,-122,213,73,286
43915,FremontBridge,10/06/2017 07:00:00 PM,48,-122,81,58,139
43916,FremontBridge,10/06/2017 08:00:00 PM,48,-122,40,30,70
43917,FremontBridge,10/06/2017 09:00:00 PM,48,-122,27,19,46
43918,FremontBridge,10/06/2017 10:00:00 PM,48,-122,17,10,27
43919,FremontBridge,10/06/2017 11:00:00 PM,48,-122,19,15,34
43920,FremontBridge,10/07/2017 12:00:00 AM,48,-122,12,12,24
43921,FremontBridge,10/07/2017 01:00:00 AM,48,-122,4,5,9
43922,FremontBridge,10/07/2017 02:00:00 AM,48,-122,2,1,3
43923,FremontBridge,10/07/2017 03:00:00 AM,48,-122,0,0,0
43924,FremontBridge,10/07/2017 04:00:00 AM,48,-122,2,2,4
43925,FremontBridge,10/07/2017 05:00:00 AM,48,-122,4,5,9
43926,FremontBridge,10/07/2017 06:00:00 AM,48,-122,4,10,14
43927,FremontBridge,10/07/2017 07:00:00 AM,48,-122,11,12,23
43928,FremontBridge,10/07/2017 08:00:00 AM,48,-122,30,17,47
43929,FremontBridge,10/07/2017 09:00:00 AM,48,-122,36,49,85
43930,FremontBridge,10/07/2017 10:00:00 AM,48,-122,42,48,90
43931,FremontBridge,10/07/2017 11:00:00 AM,48,-122,69,37,106
43932,FremontBridge,10/07/2017 12:00:00 PM,48,-122,65,65,130
43933,FremontBridge,10/07/2017 01:00:00 PM,48,-122,73,52,125
43934,FremontBridge,10/07/2017 02:00:00 PM,48,-122,56,66,122
43935,FremontBridge,10/07/2017 03:00:00 PM,48,-122,51,44,95
43936,FremontBridge,10/07/2017 04:00:00 PM,48,-122,40,49,89
43937,FremontBridge,10/07/2017 05:00:00 PM,48,-122,49,56,105
43938,FremontBridge,10/07/2017 06:00:00 PM,48,-122,36,22,58
43939,FremontBridge,10/07/2017 07:00:00 PM,48,-122,13,25,38
43940,FremontBridge,10/07/2017 08:00:00 PM,48,-122,6,5,11
43941,FremontBridge,10/07/2017 09:00:00 PM,48,-122,13,3,16
43942,FremontBridge,10/07/2017 10:00:00 PM,48,-122,7,12,19
43943,FremontBridge,10/07/2017 11:00:00 PM,48,-122,9,20,29
43944,FremontBridge,10/08/2017 12:00:00 AM,48,-122,9,1,10
43945,FremontBridge,10/08/2017 01:00:00 AM,48,-122,3,3,6
43946,FremontBridge,10/08/2017 02:00:00 AM,48,-122,2,2,4
43947,FremontBridge,10/08/2017 03:00:00 AM,48,-122,0,3,3
43948,FremontBridge,10/08/2017 04:00:00 AM,48,-122,2,2,4
43949,FremontBridge,10/08/2017 05:00:00 AM,48,-122,2,3,5
43950,FremontBridge,10/08/2017 06:00:00 AM,48,-122,6,4,10
43951,FremontBridge,10/08/2017 07:00:00 AM,48,-122,16,8,24
43952,FremontBridge,10/08/2017 08:00:00 AM,48,-122,18,21,39
43953,FremontBridge,10/08/2017 09:00:00 AM,48,-122,20,27,47
43954,FremontBridge,10/08/2017 10:00:00 AM,48,-122,49,49,98
43955,FremontBridge,10/08/2017 11:00:00 AM,48,-122,44,84,128
43956,FremontBridge,10/08/2017 12:00:00 PM,48,-122,65,61,126
43957,FremontBridge,10/08/2017 01:00:00 PM,48,-122,97,70,167
43958,FremontBridge,10/08/2017 02:00:00 PM,48,-122,69,62,131
43959,FremontBridge,10/08/2017 03:00:00 PM,48,-122,62,76,138
43960,FremontBridge,10/08/2017 04:00:00 PM,48,-122,66,72,138
43961,FremontBridge,10/08/2017 05:00:00 PM,48,-122,67,71,138
43962,FremontBridge,10/08/2017 06:00:00 PM,48,-122,32,41,73
43963,FremontBridge,10/08/2017 07:00:00 PM,48,-122,17,20,37
43964,FremontBridge,10/08/2017 08:00:00 PM,48,-122,12,9,21
43965,FremontBridge,10/08/2017 09:00:00 PM,48,-122,10,9,19
43966,FremontBridge,10/08/2017 10:00:00 PM,48,-122,9,4,13
43967,FremontBridge,10/08/2017 11:00:00 PM,48,-122,6,4,10
43968,FremontBridge,10/09/2017 12:00:00 AM,48,-122,4,2,6
43969,FremontBridge,10/09/2017 01:00:00 AM,48,-122,2,0,2
43970,FremontBridge,10/09/2017 02:00:00 AM,48,-122,0,0,0
43971,FremontBridge,10/09/2017 03:00:00 AM,48,-122,0,2,2
43972,FremontBridge,10/09/2017 04:00:00 AM,48,-122,7,6,13
43973,FremontBridge,10/09/2017 05:00:00 AM,48,-122,17,19,36
43974,FremontBridge,10/09/2017 06:00:00 AM,48,-122,61,65,126
43975,FremontBridge,10/09/2017 07:00:00 AM,48,-122,187,214,401
43976,FremontBridge,10/09/2017 08:00:00 AM,48,-122,266,297,563
43977,FremontBridge,10/09/2017 09:00:00 AM,48,-122,152,151,303
43978,FremontBridge,10/09/2017 10:00:00 AM,48,-122,58,44,102
43979,FremontBridge,10/09/2017 11:00:00 AM,48,-122,34,48,82
43980,FremontBridge,10/09/2017 12:00:00 PM,48,-122,45,38,83
43981,FremontBridge,10/09/2017 01:00:00 PM,48,-122,46,41,87
43982,FremontBridge,10/09/2017 02:00:00 PM,48,-122,77,51,128
43983,FremontBridge,10/09/2017 03:00:00 PM,48,-122,116,77,193
43984,FremontBridge,10/09/2017 04:00:00 PM,48,-122,239,100,339
43985,FremontBridge,10/09/2017 05:00:00 PM,48,-122,534,156,690
43986,FremontBridge,10/09/2017 06:00:00 PM,48,-122,297,130,427
43987,FremontBridge,10/09/2017 07:00:00 PM,48,-122,136,57,193
43988,FremontBridge,10/09/2017 08:00:00 PM,48,-122,52,26,78
43989,FremontBridge,10/09/2017 09:00:00 PM,48,-122,32,25,57
43990,FremontBridge,10/09/2017 10:00:00 PM,48,-122,16,9,25
43991,FremontBridge,10/09/2017 11:00:00 PM,48,-122,13,8,21
43992,FremontBridge,10/10/2017 12:00:00 AM,48,-122,1,1,2
43993,FremontBridge,10/10/2017 01:00:00 AM,48,-122,1,2,3
43994,FremontBridge,10/10/2017 02:00:00 AM,48,-122,5,0,5
43995,FremontBridge,10/10/2017 03:00:00 AM,48,-122,0,0,0
43996,FremontBridge,10/10/2017 04:00:00 AM,48,-122,9,5,14
43997,FremontBridge,10/10/2017 05:00:00 AM,48,-122,15,29,44
43998,FremontBridge,10/10/2017 06:00:00 AM,48,-122,53,69,122
43999,FremontBridge,10/10/2017 07:00:00 AM,48,-122,186,212,398
44000,FremontBridge,10/10/2017 08:00:00 AM,48,-122,243,272,515
44001,FremontBridge,10/10/2017 09:00:00 AM,48,-122,125,124,249
44002,FremontBridge,10/10/2017 10:00:00 AM,48,-122,63,50,113
44003,FremontBridge,10/10/2017 11:00:00 AM,48,-122,26,30,56
44004,FremontBridge,10/10/2017 12:00:00 PM,48,-122,30,40,70
44005,FremontBridge,10/10/2017 01:00:00 PM,48,-122,26,23,49
44006,FremontBridge,10/10/2017 02:00:00 PM,48,-122,36,28,64
44007,FremontBridge,10/10/2017 03:00:00 PM,48,-122,75,52,127
44008,FremontBridge,10/10/2017 04:00:00 PM,48,-122,210,73,283
44009,FremontBridge,10/10/2017 05:00:00 PM,48,-122,444,127,571
44010,FremontBridge,10/10/2017 06:00:00 PM,48,-122,256,94,350
44011,FremontBridge,10/10/2017 07:00:00 PM,48,-122,87,49,136
44012,FremontBridge,10/10/2017 08:00:00 PM,48,-122,49,16,65
44013,FremontBridge,10/10/2017 09:00:00 PM,48,-122,30,14,44
44014,FremontBridge,10/10/2017 10:00:00 PM,48,-122,12,11,23
44015,FremontBridge,10/10/2017 11:00:00 PM,48,-122,9,6,15
44016,FremontBridge,10/11/2017 12:00:00 AM,48,-122,3,2,5
44017,FremontBridge,10/11/2017 01:00:00 AM,48,-122,3,0,3
44018,FremontBridge,10/11/2017 02:00:00 AM,48,-122,0,0,0
44019,FremontBridge,10/11/2017 03:00:00 AM,48,-122,1,0,1
44020,FremontBridge,10/11/2017 04:00:00 AM,48,-122,6,6,12
44021,FremontBridge,10/11/2017 05:00:00 AM,48,-122,15,25,40
44022,FremontBridge,10/11/2017 06:00:00 AM,48,-122,67,65,132
44023,FremontBridge,10/11/2017 07:00:00 AM,48,-122,166,183,349
44024,FremontBridge,10/11/2017 08:00:00 AM,48,-122,198,243,441
44025,FremontBridge,10/11/2017 09:00:00 AM,48,-122,125,122,247
44026,FremontBridge,10/11/2017 10:00:00 AM,48,-122,55,53,108
44027,FremontBridge,10/11/2017 11:00:00 AM,48,-122,36,40,76
44028,FremontBridge,10/11/2017 12:00:00 PM,48,-122,31,31,62
44029,FremontBridge,10/11/2017 01:00:00 PM,48,-122,55,40,95
44030,FremontBridge,10/11/2017 02:00:00 PM,48,-122,57,53,110
44031,FremontBridge,10/11/2017 03:00:00 PM,48,-122,84,52,136
44032,FremontBridge,10/11/2017 04:00:00 PM,48,-122,194,83,277
44033,FremontBridge,10/11/2017 05:00:00 PM,48,-122,411,108,519
44034,FremontBridge,10/11/2017 06:00:00 PM,48,-122,283,105,388
44035,FremontBridge,10/11/2017 07:00:00 PM,48,-122,95,42,137
44036,FremontBridge,10/11/2017 08:00:00 PM,48,-122,48,25,73
44037,FremontBridge,10/11/2017 09:00:00 PM,48,-122,46,22,68
44038,FremontBridge,10/11/2017 10:00:00 PM,48,-122,22,14,36
44039,FremontBridge,10/11/2017 11:00:00 PM,48,-122,12,12,24
44040,FremontBridge,10/12/2017 12:00:00 AM,48,-122,7,2,9
44041,FremontBridge,10/12/2017 01:00:00 AM,48,-122,1,3,4
44042,FremontBridge,10/12/2017 02:00:00 AM,48,-122,0,0,0
44043,FremontBridge,10/12/2017 03:00:00 AM,48,-122,1,0,1
44044,FremontBridge,10/12/2017 04:00:00 AM,48,-122,3,5,8
44045,FremontBridge,10/12/2017 05:00:00 AM,48,-122,9,19,28
44046,FremontBridge,10/12/2017 06:00:00 AM,48,-122,55,62,117
44047,FremontBridge,10/12/2017 07:00:00 AM,48,-122,136,138,274
44048,FremontBridge,10/12/2017 08:00:00 AM,48,-122,192,228,420
44049,FremontBridge,10/12/2017 09:00:00 AM,48,-122,125,104,229
44050,FremontBridge,10/12/2017 10:00:00 AM,48,-122,41,35,76
44051,FremontBridge,10/12/2017 11:00:00 AM,48,-122,25,17,42
44052,FremontBridge,10/12/2017 12:00:00 PM,48,-122,14,22,36
44053,FremontBridge,10/12/2017 01:00:00 PM,48,-122,24,28,52
44054,FremontBridge,10/12/2017 02:00:00 PM,48,-122,31,20,51
44055,FremontBridge,10/12/2017 03:00:00 PM,48,-122,70,38,108
44056,FremontBridge,10/12/2017 04:00:00 PM,48,-122,164,55,219
44057,FremontBridge,10/12/2017 05:00:00 PM,48,-122,354,106,460
44058,FremontBridge,10/12/2017 06:00:00 PM,48,-122,206,76,282
44059,FremontBridge,10/12/2017 07:00:00 PM,48,-122,87,45,132
44060,FremontBridge,10/12/2017 08:00:00 PM,48,-122,45,24,69
44061,FremontBridge,10/12/2017 09:00:00 PM,48,-122,34,22,56
44062,FremontBridge,10/12/2017 10:00:00 PM,48,-122,12,14,26
44063,FremontBridge,10/12/2017 11:00:00 PM,48,-122,8,5,13
44064,FremontBridge,10/13/2017 12:00:00 AM,48,-122,4,1,5
44065,FremontBridge,10/13/2017 01:00:00 AM,48,-122,4,1,5
44066,FremontBridge,10/13/2017 02:00:00 AM,48,-122,0,0,0
44067,FremontBridge,10/13/2017 03:00:00 AM,48,-122,2,0,2
44068,FremontBridge,10/13/2017 04:00:00 AM,48,-122,5,4,9
44069,FremontBridge,10/13/2017 05:00:00 AM,48,-122,11,17,28
44070,FremontBridge,10/13/2017 06:00:00 AM,48,-122,35,54,89
44071,FremontBridge,10/13/2017 07:00:00 AM,48,-122,110,134,244
44072,FremontBridge,10/13/2017 08:00:00 AM,48,-122,179,181,360
44073,FremontBridge,10/13/2017 09:00:00 AM,48,-122,128,108,236
44074,FremontBridge,10/13/2017 10:00:00 AM,48,-122,43,46,89
44075,FremontBridge,10/13/2017 11:00:00 AM,48,-122,38,20,58
44076,FremontBridge,10/13/2017 12:00:00 PM,48,-122,36,31,67
44077,FremontBridge,10/13/2017 01:00:00 PM,48,-122,30,39,69
44078,FremontBridge,10/13/2017 02:00:00 PM,48,-122,47,42,89
44079,FremontBridge,10/13/2017 03:00:00 PM,48,-122,98,53,151
44080,FremontBridge,10/13/2017 04:00:00 PM,48,-122,214,96,310
44081,FremontBridge,10/13/2017 05:00:00 PM,48,-122,326,105,431
44082,FremontBridge,10/13/2017 06:00:00 PM,48,-122,189,79,268
44083,FremontBridge,10/13/2017 07:00:00 PM,48,-122,63,29,92
44084,FremontBridge,10/13/2017 08:00:00 PM,48,-122,42,15,57
44085,FremontBridge,10/13/2017 09:00:00 PM,48,-122,11,14,25
44086,FremontBridge,10/13/2017 10:00:00 PM,48,-122,21,10,31
44087,FremontBridge,10/13/2017 11:00:00 PM,48,-122,11,16,27
44088,FremontBridge,10/14/2017 12:00:00 AM,48,-122,6,9,15
44089,FremontBridge,10/14/2017 01:00:00 AM,48,-122,7,7,14
44090,FremontBridge,10/14/2017 02:00:00 AM,48,-122,5,4,9
44091,FremontBridge,10/14/2017 03:00:00 AM,48,-122,1,2,3
44092,FremontBridge,10/14/2017 04:00:00 AM,48,-122,3,2,5
44093,FremontBridge,10/14/2017 05:00:00 AM,48,-122,4,2,6
44094,FremontBridge,10/14/2017 06:00:00 AM,48,-122,6,9,15
44095,FremontBridge,10/14/2017 07:00:00 AM,48,-122,16,6,22
44096,FremontBridge,10/14/2017 08:00:00 AM,48,-122,29,30,59
44097,FremontBridge,10/14/2017 09:00:00 AM,48,-122,34,35,69
44098,FremontBridge,10/14/2017 10:00:00 AM,48,-122,52,38,90
44099,FremontBridge,10/14/2017 11:00:00 AM,48,-122,66,48,114
44100,FremontBridge,10/14/2017 12:00:00 PM,48,-122,52,48,100
44101,FremontBridge,10/14/2017 01:00:00 PM,48,-122,51,57,108
44102,FremontBridge,10/14/2017 02:00:00 PM,48,-122,82,57,139
44103,FremontBridge,10/14/2017 03:00:00 PM,48,-122,77,45,122
44104,FremontBridge,10/14/2017 04:00:00 PM,48,-122,57,57,114
44105,FremontBridge,10/14/2017 05:00:00 PM,48,-122,54,45,99
44106,FremontBridge,10/14/2017 06:00:00 PM,48,-122,41,38,79
44107,FremontBridge,10/14/2017 07:00:00 PM,48,-122,31,25,56
44108,FremontBridge,10/14/2017 08:00:00 PM,48,-122,34,12,46
44109,FremontBridge,10/14/2017 09:00:00 PM,48,-122,14,3,17
44110,FremontBridge,10/14/2017 10:00:00 PM,48,-122,14,20,34
44111,FremontBridge,10/14/2017 11:00:00 PM,48,-122,15,16,31
44112,FremontBridge,10/15/2017 12:00:00 AM,48,-122,4,1,5
44113,FremontBridge,10/15/2017 01:00:00 AM,48,-122,4,2,6
44114,FremontBridge,10/15/2017 02:00:00 AM,48,-122,6,4,10
44115,FremontBridge,10/15/2017 03:00:00 AM,48,-122,1,1,2
44116,FremontBridge,10/15/2017 04:00:00 AM,48,-122,2,3,5
44117,FremontBridge,10/15/2017 05:00:00 AM,48,-122,4,3,7
44118,FremontBridge,10/15/2017 06:00:00 AM,48,-122,5,7,12
44119,FremontBridge,10/15/2017 07:00:00 AM,48,-122,16,9,25
44120,FremontBridge,10/15/2017 08:00:00 AM,48,-122,24,29,53
44121,FremontBridge,10/15/2017 09:00:00 AM,48,-122,36,37,73
44122,FremontBridge,10/15/2017 10:00:00 AM,48,-122,60,58,118
44123,FremontBridge,10/15/2017 11:00:00 AM,48,-122,79,64,143
44124,FremontBridge,10/15/2017 12:00:00 PM,48,-122,79,83,162
44125,FremontBridge,10/15/2017 01:00:00 PM,48,-122,83,107,190
44126,FremontBridge,10/15/2017 02:00:00 PM,48,-122,103,116,219
44127,FremontBridge,10/15/2017 03:00:00 PM,48,-122,79,93,172
44128,FremontBridge,10/15/2017 04:00:00 PM,48,-122,91,80,171
44129,FremontBridge,10/15/2017 05:00:00 PM,48,-122,67,75,142
44130,FremontBridge,10/15/2017 06:00:00 PM,48,-122,42,51,93
44131,FremontBridge,10/15/2017 07:00:00 PM,48,-122,32,23,55
44132,FremontBridge,10/15/2017 08:00:00 PM,48,-122,21,16,37
44133,FremontBridge,10/15/2017 09:00:00 PM,48,-122,14,9,23
44134,FremontBridge,10/15/2017 10:00:00 PM,48,-122,12,7,19
44135,FremontBridge,10/15/2017 11:00:00 PM,48,-122,13,6,19
44136,FremontBridge,10/16/2017 12:00:00 AM,48,-122,4,0,4
44137,FremontBridge,10/16/2017 01:00:00 AM,48,-122,0,0,0
44138,FremontBridge,10/16/2017 02:00:00 AM,48,-122,1,3,4
44139,FremontBridge,10/16/2017 03:00:00 AM,48,-122,1,1,2
44140,FremontBridge,10/16/2017 04:00:00 AM,48,-122,10,6,16
44141,FremontBridge,10/16/2017 05:00:00 AM,48,-122,14,17,31
44142,FremontBridge,10/16/2017 06:00:00 AM,48,-122,70,88,158
44143,FremontBridge,10/16/2017 07:00:00 AM,48,-122,207,229,436
44144,FremontBridge,10/16/2017 08:00:00 AM,48,-122,272,315,587
44145,FremontBridge,10/16/2017 09:00:00 AM,48,-122,160,135,295
44146,FremontBridge,10/16/2017 10:00:00 AM,48,-122,64,47,111
44147,FremontBridge,10/16/2017 11:00:00 AM,48,-122,34,48,82
44148,FremontBridge,10/16/2017 12:00:00 PM,48,-122,34,36,70
44149,FremontBridge,10/16/2017 01:00:00 PM,48,-122,47,48,95
44150,FremontBridge,10/16/2017 02:00:00 PM,48,-122,74,52,126
44151,FremontBridge,10/16/2017 03:00:00 PM,48,-122,100,65,165
44152,FremontBridge,10/16/2017 04:00:00 PM,48,-122,210,87,297
44153,FremontBridge,10/16/2017 05:00:00 PM,48,-122,542,145,687
44154,FremontBridge,10/16/2017 06:00:00 PM,48,-122,283,118,401
44155,FremontBridge,10/16/2017 07:00:00 PM,48,-122,99,61,160
44156,FremontBridge,10/16/2017 08:00:00 PM,48,-122,56,27,83
44157,FremontBridge,10/16/2017 09:00:00 PM,48,-122,37,24,61
44158,FremontBridge,10/16/2017 10:00:00 PM,48,-122,15,12,27
44159,FremontBridge,10/16/2017 11:00:00 PM,48,-122,16,7,23
44160,FremontBridge,10/17/2017 12:00:00 AM,48,-122,4,2,6
44161,FremontBridge,10/17/2017 01:00:00 AM,48,-122,2,2,4
44162,FremontBridge,10/17/2017 02:00:00 AM,48,-122,1,2,3
44163,FremontBridge,10/17/2017 03:00:00 AM,48,-122,0,0,0
44164,FremontBridge,10/17/2017 04:00:00 AM,48,-122,5,6,11
44165,FremontBridge,10/17/2017 05:00:00 AM,48,-122,13,19,32
44166,FremontBridge,10/17/2017 06:00:00 AM,48,-122,61,58,119
44167,FremontBridge,10/17/2017 07:00:00 AM,48,-122,148,150,298
44168,FremontBridge,10/17/2017 08:00:00 AM,48,-122,187,218,405
44169,FremontBridge,10/17/2017 09:00:00 AM,48,-122,105,94,199
44170,FremontBridge,10/17/2017 10:00:00 AM,48,-122,47,38,85
44171,FremontBridge,10/17/2017 11:00:00 AM,48,-122,15,21,36
44172,FremontBridge,10/17/2017 12:00:00 PM,48,-122,21,22,43
44173,FremontBridge,10/17/2017 01:00:00 PM,48,-122,26,26,52
44174,FremontBridge,10/17/2017 02:00:00 PM,48,-122,30,27,57
44175,FremontBridge,10/17/2017 03:00:00 PM,48,-122,54,35,89
44176,FremontBridge,10/17/2017 04:00:00 PM,48,-122,157,67,224
44177,FremontBridge,10/17/2017 05:00:00 PM,48,-122,367,114,481
44178,FremontBridge,10/17/2017 06:00:00 PM,48,-122,237,95,332
44179,FremontBridge,10/17/2017 07:00:00 PM,48,-122,78,31,109
44180,FremontBridge,10/17/2017 08:00:00 PM,48,-122,34,24,58
44181,FremontBridge,10/17/2017 09:00:00 PM,48,-122,24,24,48
44182,FremontBridge,10/17/2017 10:00:00 PM,48,-122,17,22,39
44183,FremontBridge,10/17/2017 11:00:00 PM,48,-122,9,7,16
44184,FremontBridge,10/18/2017 12:00:00 AM,48,-122,4,2,6
44185,FremontBridge,10/18/2017 01:00:00 AM,48,-122,3,0,3
44186,FremontBridge,10/18/2017 02:00:00 AM,48,-122,3,0,3
44187,FremontBridge,10/18/2017 03:00:00 AM,48,-122,3,1,4
44188,FremontBridge,10/18/2017 04:00:00 AM,48,-122,3,3,6
44189,FremontBridge,10/18/2017 05:00:00 AM,48,-122,16,21,37
44190,FremontBridge,10/18/2017 06:00:00 AM,48,-122,49,73,122
44191,FremontBridge,10/18/2017 07:00:00 AM,48,-122,132,159,291
44192,FremontBridge,10/18/2017 08:00:00 AM,48,-122,176,217,393
44193,FremontBridge,10/18/2017 09:00:00 AM,48,-122,107,94,201
44194,FremontBridge,10/18/2017 10:00:00 AM,48,-122,41,20,61
44195,FremontBridge,10/18/2017 11:00:00 AM,48,-122,22,17,39
44196,FremontBridge,10/18/2017 12:00:00 PM,48,-122,13,13,26
44197,FremontBridge,10/18/2017 01:00:00 PM,48,-122,17,19,36
44198,FremontBridge,10/18/2017 02:00:00 PM,48,-122,38,16,54
44199,FremontBridge,10/18/2017 03:00:00 PM,48,-122,50,33,83
44200,FremontBridge,10/18/2017 04:00:00 PM,48,-122,148,49,197
44201,FremontBridge,10/18/2017 05:00:00 PM,48,-122,313,67,380
44202,FremontBridge,10/18/2017 06:00:00 PM,48,-122,153,59,212
44203,FremontBridge,10/18/2017 07:00:00 PM,48,-122,56,24,80
44204,FremontBridge,10/18/2017 08:00:00 PM,48,-122,23,9,32
44205,FremontBridge,10/18/2017 09:00:00 PM,48,-122,10,6,16
44206,FremontBridge,10/18/2017 10:00:00 PM,48,-122,6,3,9
44207,FremontBridge,10/18/2017 11:00:00 PM,48,-122,7,3,10
44208,FremontBridge,10/19/2017 12:00:00 AM,48,-122,2,0,2
44209,FremontBridge,10/19/2017 01:00:00 AM,48,-122,4,1,5
44210,FremontBridge,10/19/2017 02:00:00 AM,48,-122,2,0,2
44211,FremontBridge,10/19/2017 03:00:00 AM,48,-122,0,0,0
44212,FremontBridge,10/19/2017 04:00:00 AM,48,-122,4,2,6
44213,FremontBridge,10/19/2017 05:00:00 AM,48,-122,7,13,20
44214,FremontBridge,10/19/2017 06:00:00 AM,48,-122,40,51,91
44215,FremontBridge,10/19/2017 07:00:00 AM,48,-122,115,128,243
44216,FremontBridge,10/19/2017 08:00:00 AM,48,-122,150,182,332
44217,FremontBridge,10/19/2017 09:00:00 AM,48,-122,87,87,174
44218,FremontBridge,10/19/2017 10:00:00 AM,48,-122,31,26,57
44219,FremontBridge,10/19/2017 11:00:00 AM,48,-122,14,18,32
44220,FremontBridge,10/19/2017 12:00:00 PM,48,-122,18,22,40
44221,FremontBridge,10/19/2017 01:00:00 PM,48,-122,31,27,58
44222,FremontBridge,10/19/2017 02:00:00 PM,48,-122,37,25,62
44223,FremontBridge,10/19/2017 03:00:00 PM,48,-122,49,31,80
44224,FremontBridge,10/19/2017 04:00:00 PM,48,-122,129,37,166
44225,FremontBridge,10/19/2017 05:00:00 PM,48,-122,315,74,389
44226,FremontBridge,10/19/2017 06:00:00 PM,48,-122,147,70,217
44227,FremontBridge,10/19/2017 07:00:00 PM,48,-122,46,25,71
44228,FremontBridge,10/19/2017 08:00:00 PM,48,-122,29,15,44
44229,FremontBridge,10/19/2017 09:00:00 PM,48,-122,23,13,36
44230,FremontBridge,10/19/2017 10:00:00 PM,48,-122,13,10,23
44231,FremontBridge,10/19/2017 11:00:00 PM,48,-122,10,7,17
44232,FremontBridge,10/20/2017 12:00:00 AM,48,-122,1,1,2
44233,FremontBridge,10/20/2017 01:00:00 AM,48,-122,2,0,2
44234,FremontBridge,10/20/2017 02:00:00 AM,48,-122,3,0,3
44235,FremontBridge,10/20/2017 03:00:00 AM,48,-122,3,0,3
44236,FremontBridge,10/20/2017 04:00:00 AM,48,-122,3,5,8
44237,FremontBridge,10/20/2017 05:00:00 AM,48,-122,14,15,29
44238,FremontBridge,10/20/2017 06:00:00 AM,48,-122,39,42,81
44239,FremontBridge,10/20/2017 07:00:00 AM,48,-122,97,136,233
44240,FremontBridge,10/20/2017 08:00:00 AM,48,-122,154,182,336
44241,FremontBridge,10/20/2017 09:00:00 AM,48,-122,98,70,168
44242,FremontBridge,10/20/2017 10:00:00 AM,48,-122,36,30,66
44243,FremontBridge,10/20/2017 11:00:00 AM,48,-122,22,23,45
44244,FremontBridge,10/20/2017 12:00:00 PM,48,-122,20,16,36
44245,FremontBridge,10/20/2017 01:00:00 PM,48,-122,20,24,44
44246,FremontBridge,10/20/2017 02:00:00 PM,48,-122,37,22,59
44247,FremontBridge,10/20/2017 03:00:00 PM,48,-122,64,51,115
44248,FremontBridge,10/20/2017 04:00:00 PM,48,-122,148,74,222
44249,FremontBridge,10/20/2017 05:00:00 PM,48,-122,320,98,418
44250,FremontBridge,10/20/2017 06:00:00 PM,48,-122,128,77,205
44251,FremontBridge,10/20/2017 07:00:00 PM,48,-122,61,37,98
44252,FremontBridge,10/20/2017 08:00:00 PM,48,-122,30,15,45
44253,FremontBridge,10/20/2017 09:00:00 PM,48,-122,20,7,27
44254,FremontBridge,10/20/2017 10:00:00 PM,48,-122,16,11,27
44255,FremontBridge,10/20/2017 11:00:00 PM,48,-122,12,7,19
44256,FremontBridge,10/21/2017 12:00:00 AM,48,-122,6,3,9
44257,FremontBridge,10/21/2017 01:00:00 AM,48,-122,3,3,6
44258,FremontBridge,10/21/2017 02:00:00 AM,48,-122,3,0,3
44259,FremontBridge,10/21/2017 03:00:00 AM,48,-122,1,1,2
44260,FremontBridge,10/21/2017 04:00:00 AM,48,-122,1,2,3
44261,FremontBridge,10/21/2017 05:00:00 AM,48,-122,1,3,4
44262,FremontBridge,10/21/2017 06:00:00 AM,48,-122,4,3,7
44263,FremontBridge,10/21/2017 07:00:00 AM,48,-122,6,1,7
44264,FremontBridge,10/21/2017 08:00:00 AM,48,-122,13,10,23
44265,FremontBridge,10/21/2017 09:00:00 AM,48,-122,24,27,51
44266,FremontBridge,10/21/2017 10:00:00 AM,48,-122,13,16,29
44267,FremontBridge,10/21/2017 11:00:00 AM,48,-122,16,17,33
44268,FremontBridge,10/21/2017 12:00:00 PM,48,-122,14,23,37
44269,FremontBridge,10/21/2017 01:00:00 PM,48,-122,14,21,35
44270,FremontBridge,10/21/2017 02:00:00 PM,48,-122,21,13,34
44271,FremontBridge,10/21/2017 03:00:00 PM,48,-122,15,15,30
44272,FremontBridge,10/21/2017 04:00:00 PM,48,-122,14,18,32
44273,FremontBridge,10/21/2017 05:00:00 PM,48,-122,15,11,26
44274,FremontBridge,10/21/2017 06:00:00 PM,48,-122,4,12,16
44275,FremontBridge,10/21/2017 07:00:00 PM,48,-122,8,9,17
44276,FremontBridge,10/21/2017 08:00:00 PM,48,-122,9,5,14
44277,FremontBridge,10/21/2017 09:00:00 PM,48,-122,8,2,10
44278,FremontBridge,10/21/2017 10:00:00 PM,48,-122,6,4,10
44279,FremontBridge,10/21/2017 11:00:00 PM,48,-122,7,7,14
44280,FremontBridge,10/22/2017 12:00:00 AM,48,-122,6,2,8
44281,FremontBridge,10/22/2017 01:00:00 AM,48,-122,1,2,3
44282,FremontBridge,10/22/2017 02:00:00 AM,48,-122,1,2,3
44283,FremontBridge,10/22/2017 03:00:00 AM,48,-122,0,0,0
44284,FremontBridge,10/22/2017 04:00:00 AM,48,-122,1,4,5
44285,FremontBridge,10/22/2017 05:00:00 AM,48,-122,0,4,4
44286,FremontBridge,10/22/2017 06:00:00 AM,48,-122,4,5,9
44287,FremontBridge,10/22/2017 07:00:00 AM,48,-122,7,6,13
44288,FremontBridge,10/22/2017 08:00:00 AM,48,-122,15,17,32
44289,FremontBridge,10/22/2017 09:00:00 AM,48,-122,20,32,52
44290,FremontBridge,10/22/2017 10:00:00 AM,48,-122,54,66,120
44291,FremontBridge,10/22/2017 11:00:00 AM,48,-122,56,58,114
44292,FremontBridge,10/22/2017 12:00:00 PM,48,-122,84,76,160
44293,FremontBridge,10/22/2017 01:00:00 PM,48,-122,56,67,123
44294,FremontBridge,10/22/2017 02:00:00 PM,48,-122,52,69,121
44295,FremontBridge,10/22/2017 03:00:00 PM,48,-122,53,67,120
44296,FremontBridge,10/22/2017 04:00:00 PM,48,-122,58,64,122
44297,FremontBridge,10/22/2017 05:00:00 PM,48,-122,50,45,95
44298,FremontBridge,10/22/2017 06:00:00 PM,48,-122,32,37,69
44299,FremontBridge,10/22/2017 07:00:00 PM,48,-122,18,15,33
44300,FremontBridge,10/22/2017 08:00:00 PM,48,-122,16,12,28
44301,FremontBridge,10/22/2017 09:00:00 PM,48,-122,10,5,15
44302,FremontBridge,10/22/2017 10:00:00 PM,48,-122,9,10,19
44303,FremontBridge,10/22/2017 11:00:00 PM,48,-122,14,3,17
44304,FremontBridge,10/23/2017 12:00:00 AM,48,-122,2,3,5
44305,FremontBridge,10/23/2017 01:00:00 AM,48,-122,1,1,2
44306,FremontBridge,10/23/2017 02:00:00 AM,48,-122,1,0,1
44307,FremontBridge,10/23/2017 03:00:00 AM,48,-122,0,0,0
44308,FremontBridge,10/23/2017 04:00:00 AM,48,-122,3,5,8
44309,FremontBridge,10/23/2017 05:00:00 AM,48,-122,15,22,37
44310,FremontBridge,10/23/2017 06:00:00 AM,48,-122,67,88,155
44311,FremontBridge,10/23/2017 07:00:00 AM,48,-122,185,219,404
44312,FremontBridge,10/23/2017 08:00:00 AM,48,-122,264,296,560
44313,FremontBridge,10/23/2017 09:00:00 AM,48,-122,155,140,295
44314,FremontBridge,10/23/2017 10:00:00 AM,48,-122,68,62,130
44315,FremontBridge,10/23/2017 11:00:00 AM,48,-122,43,36,79
44316,FremontBridge,10/23/2017 12:00:00 PM,48,-122,43,42,85
44317,FremontBridge,10/23/2017 01:00:00 PM,48,-122,42,45,87
44318,FremontBridge,10/23/2017 02:00:00 PM,48,-122,59,60,119
44319,FremontBridge,10/23/2017 03:00:00 PM,48,-122,85,67,152
44320,FremontBridge,10/23/2017 04:00:00 PM,48,-122,260,108,368
44321,FremontBridge,10/23/2017 05:00:00 PM,48,-122,534,155,689
44322,FremontBridge,10/23/2017 06:00:00 PM,48,-122,292,115,407
44323,FremontBridge,10/23/2017 07:00:00 PM,48,-122,98,46,144
44324,FremontBridge,10/23/2017 08:00:00 PM,48,-122,49,32,81
44325,FremontBridge,10/23/2017 09:00:00 PM,48,-122,31,15,46
44326,FremontBridge,10/23/2017 10:00:00 PM,48,-122,19,11,30
44327,FremontBridge,10/23/2017 11:00:00 PM,48,-122,14,42,56
44328,FremontBridge,10/24/2017 12:00:00 AM,48,-122,7,1,8
44329,FremontBridge,10/24/2017 01:00:00 AM,48,-122,0,1,1
44330,FremontBridge,10/24/2017 02:00:00 AM,48,-122,2,2,4
44331,FremontBridge,10/24/2017 03:00:00 AM,48,-122,1,2,3
44332,FremontBridge,10/24/2017 04:00:00 AM,48,-122,8,5,13
44333,FremontBridge,10/24/2017 05:00:00 AM,48,-122,12,21,33
44334,FremontBridge,10/24/2017 06:00:00 AM,48,-122,57,81,138
44335,FremontBridge,10/24/2017 07:00:00 AM,48,-122,205,216,421
44336,FremontBridge,10/24/2017 08:00:00 AM,48,-122,281,328,609
44337,FremontBridge,10/24/2017 09:00:00 AM,48,-122,161,150,311
44338,FremontBridge,10/24/2017 10:00:00 AM,48,-122,70,52,122
44339,FremontBridge,10/24/2017 11:00:00 AM,48,-122,50,33,83
44340,FremontBridge,10/24/2017 12:00:00 PM,48,-122,49,60,109
44341,FremontBridge,10/24/2017 01:00:00 PM,48,-122,58,42,100
44342,FremontBridge,10/24/2017 02:00:00 PM,48,-122,69,56,125
44343,FremontBridge,10/24/2017 03:00:00 PM,48,-122,118,61,179
44344,FremontBridge,10/24/2017 04:00:00 PM,48,-122,244,112,356
44345,FremontBridge,10/24/2017 05:00:00 PM,48,-122,570,141,711
44346,FremontBridge,10/24/2017 06:00:00 PM,48,-122,296,149,445
44347,FremontBridge,10/24/2017 07:00:00 PM,48,-122,124,54,178
44348,FremontBridge,10/24/2017 08:00:00 PM,48,-122,58,23,81
44349,FremontBridge,10/24/2017 09:00:00 PM,48,-122,31,31,62
44350,FremontBridge,10/24/2017 10:00:00 PM,48,-122,23,20,43
44351,FremontBridge,10/24/2017 11:00:00 PM,48,-122,7,9,16
44352,FremontBridge,10/25/2017 12:00:00 AM,48,-122,8,2,10
44353,FremontBridge,10/25/2017 01:00:00 AM,48,-122,1,1,2
44354,FremontBridge,10/25/2017 02:00:00 AM,48,-122,1,1,2
44355,FremontBridge,10/25/2017 03:00:00 AM,48,-122,1,2,3
44356,FremontBridge,10/25/2017 04:00:00 AM,48,-122,6,3,9
44357,FremontBridge,10/25/2017 05:00:00 AM,48,-122,12,24,36
44358,FremontBridge,10/25/2017 06:00:00 AM,48,-122,58,76,134
44359,FremontBridge,10/25/2017 07:00:00 AM,48,-122,190,206,396
44360,FremontBridge,10/25/2017 08:00:00 AM,48,-122,229,266,495
44361,FremontBridge,10/25/2017 09:00:00 AM,48,-122,133,149,282
44362,FremontBridge,10/25/2017 10:00:00 AM,48,-122,49,38,87
44363,FremontBridge,10/25/2017 11:00:00 AM,48,-122,43,27,70
44364,FremontBridge,10/25/2017 12:00:00 PM,48,-122,27,38,65
44365,FremontBridge,10/25/2017 01:00:00 PM,48,-122,27,27,54
44366,FremontBridge,10/25/2017 02:00:00 PM,48,-122,52,37,89
44367,FremontBridge,10/25/2017 03:00:00 PM,48,-122,67,37,104
44368,FremontBridge,10/25/2017 04:00:00 PM,48,-122,210,74,284
44369,FremontBridge,10/25/2017 05:00:00 PM,48,-122,474,128,602
44370,FremontBridge,10/25/2017 06:00:00 PM,48,-122,259,99,358
44371,FremontBridge,10/25/2017 07:00:00 PM,48,-122,103,46,149
44372,FremontBridge,10/25/2017 08:00:00 PM,48,-122,57,38,95
44373,FremontBridge,10/25/2017 09:00:00 PM,48,-122,40,19,59
44374,FremontBridge,10/25/2017 10:00:00 PM,48,-122,24,7,31
44375,FremontBridge,10/25/2017 11:00:00 PM,48,-122,13,3,16
44376,FremontBridge,10/26/2017 12:00:00 AM,48,-122,6,6,12
44377,FremontBridge,10/26/2017 01:00:00 AM,48,-122,2,6,8
44378,FremontBridge,10/26/2017 02:00:00 AM,48,-122,1,0,1
44379,FremontBridge,10/26/2017 03:00:00 AM,48,-122,1,1,2
44380,FremontBridge,10/26/2017 04:00:00 AM,48,-122,4,7,11
44381,FremontBridge,10/26/2017 05:00:00 AM,48,-122,10,17,27
44382,FremontBridge,10/26/2017 06:00:00 AM,48,-122,65,74,139
44383,FremontBridge,10/26/2017 07:00:00 AM,48,-122,151,196,347
44384,FremontBridge,10/26/2017 08:00:00 AM,48,-122,214,289,503
44385,FremontBridge,10/26/2017 09:00:00 AM,48,-122,152,140,292
44386,FremontBridge,10/26/2017 10:00:00 AM,48,-122,42,54,96
44387,FremontBridge,10/26/2017 11:00:00 AM,48,-122,46,38,84
44388,FremontBridge,10/26/2017 12:00:00 PM,48,-122,32,34,66
44389,FremontBridge,10/26/2017 01:00:00 PM,48,-122,33,41,74
44390,FremontBridge,10/26/2017 02:00:00 PM,48,-122,53,31,84
44391,FremontBridge,10/26/2017 03:00:00 PM,48,-122,92,60,152
44392,FremontBridge,10/26/2017 04:00:00 PM,48,-122,198,95,293
44393,FremontBridge,10/26/2017 05:00:00 PM,48,-122,455,140,595
44394,FremontBridge,10/26/2017 06:00:00 PM,48,-122,275,120,395
44395,FremontBridge,10/26/2017 07:00:00 PM,48,-122,103,40,143
44396,FremontBridge,10/26/2017 08:00:00 PM,48,-122,60,33,93
44397,FremontBridge,10/26/2017 09:00:00 PM,48,-122,47,19,66
44398,FremontBridge,10/26/2017 10:00:00 PM,48,-122,20,14,34
44399,FremontBridge,10/26/2017 11:00:00 PM,48,-122,21,11,32
44400,FremontBridge,10/27/2017 12:00:00 AM,48,-122,5,3,8
44401,FremontBridge,10/27/2017 01:00:00 AM,48,-122,4,3,7
44402,FremontBridge,10/27/2017 02:00:00 AM,48,-122,1,0,1
44403,FremontBridge,10/27/2017 03:00:00 AM,48,-122,1,1,2
44404,FremontBridge,10/27/2017 04:00:00 AM,48,-122,7,3,10
44405,FremontBridge,10/27/2017 05:00:00 AM,48,-122,13,17,30
44406,FremontBridge,10/27/2017 06:00:00 AM,48,-122,50,65,115
44407,FremontBridge,10/27/2017 07:00:00 AM,48,-122,156,167,323
44408,FremontBridge,10/27/2017 08:00:00 AM,48,-122,226,265,491
44409,FremontBridge,10/27/2017 09:00:00 AM,48,-122,125,109,234
44410,FremontBridge,10/27/2017 10:00:00 AM,48,-122,73,65,138
44411,FremontBridge,10/27/2017 11:00:00 AM,48,-122,41,34,75
44412,FremontBridge,10/27/2017 12:00:00 PM,48,-122,47,55,102
44413,FremontBridge,10/27/2017 01:00:00 PM,48,-122,56,65,121
44414,FremontBridge,10/27/2017 02:00:00 PM,48,-122,79,62,141
44415,FremontBridge,10/27/2017 03:00:00 PM,48,-122,125,79,204
44416,FremontBridge,10/27/2017 04:00:00 PM,48,-122,260,109,369
44417,FremontBridge,10/27/2017 05:00:00 PM,48,-122,426,141,567
44418,FremontBridge,10/27/2017 06:00:00 PM,48,-122,223,85,308
44419,FremontBridge,10/27/2017 07:00:00 PM,48,-122,78,25,103
44420,FremontBridge,10/27/2017 08:00:00 PM,48,-122,42,23,65
44421,FremontBridge,10/27/2017 09:00:00 PM,48,-122,26,24,50
44422,FremontBridge,10/27/2017 10:00:00 PM,48,-122,15,12,27
44423,FremontBridge,10/27/2017 11:00:00 PM,48,-122,17,12,29
44424,FremontBridge,10/28/2017 12:00:00 AM,48,-122,8,8,16
44425,FremontBridge,10/28/2017 01:00:00 AM,48,-122,4,5,9
44426,FremontBridge,10/28/2017 02:00:00 AM,48,-122,7,0,7
44427,FremontBridge,10/28/2017 03:00:00 AM,48,-122,4,4,8
44428,FremontBridge,10/28/2017 04:00:00 AM,48,-122,1,3,4
44429,FremontBridge,10/28/2017 05:00:00 AM,48,-122,8,3,11
44430,FremontBridge,10/28/2017 06:00:00 AM,48,-122,6,11,17
44431,FremontBridge,10/28/2017 07:00:00 AM,48,-122,26,10,36
44432,FremontBridge,10/28/2017 08:00:00 AM,48,-122,42,20,62
44433,FremontBridge,10/28/2017 09:00:00 AM,48,-122,45,54,99
44434,FremontBridge,10/28/2017 10:00:00 AM,48,-122,59,58,117
44435,FremontBridge,10/28/2017 11:00:00 AM,48,-122,87,51,138
44436,FremontBridge,10/28/2017 12:00:00 PM,48,-122,78,83,161
44437,FremontBridge,10/28/2017 01:00:00 PM,48,-122,92,84,176
44438,FremontBridge,10/28/2017 02:00:00 PM,48,-122,82,79,161
44439,FremontBridge,10/28/2017 03:00:00 PM,48,-122,92,121,213
44440,FremontBridge,10/28/2017 04:00:00 PM,48,-122,99,107,206
44441,FremontBridge,10/28/2017 05:00:00 PM,48,-122,56,90,146
44442,FremontBridge,10/28/2017 06:00:00 PM,48,-122,33,58,91
44443,FremontBridge,10/28/2017 07:00:00 PM,48,-122,20,19,39
44444,FremontBridge,10/28/2017 08:00:00 PM,48,-122,19,9,28
44445,FremontBridge,10/28/2017 09:00:00 PM,48,-122,15,12,27
44446,FremontBridge,10/28/2017 10:00:00 PM,48,-122,10,10,20
44447,FremontBridge,10/28/2017 11:00:00 PM,48,-122,15,7,22
44448,FremontBridge,10/29/2017 12:00:00 AM,48,-122,3,5,8
44449,FremontBridge,10/29/2017 01:00:00 AM,48,-122,2,5,7
44450,FremontBridge,10/29/2017 02:00:00 AM,48,-122,5,4,9
44451,FremontBridge,10/29/2017 03:00:00 AM,48,-122,2,1,3
44452,FremontBridge,10/29/2017 04:00:00 AM,48,-122,1,2,3
44453,FremontBridge,10/29/2017 05:00:00 AM,48,-122,0,5,5
44454,FremontBridge,10/29/2017 06:00:00 AM,48,-122,5,5,10
44455,FremontBridge,10/29/2017 07:00:00 AM,48,-122,6,16,22
44456,FremontBridge,10/29/2017 08:00:00 AM,48,-122,27,20,47
44457,FremontBridge,10/29/2017 09:00:00 AM,48,-122,27,28,55
44458,FremontBridge,10/29/2017 10:00:00 AM,48,-122,38,41,79
44459,FremontBridge,10/29/2017 11:00:00 AM,48,-122,43,37,80
44460,FremontBridge,10/29/2017 12:00:00 PM,48,-122,43,46,89
44461,FremontBridge,10/29/2017 01:00:00 PM,48,-122,43,57,100
44462,FremontBridge,10/29/2017 02:00:00 PM,48,-122,72,80,152
44463,FremontBridge,10/29/2017 03:00:00 PM,48,-122,68,84,152
44464,FremontBridge,10/29/2017 04:00:00 PM,48,-122,74,50,124
44465,FremontBridge,10/29/2017 05:00:00 PM,48,-122,64,59,123
44466,FremontBridge,10/29/2017 06:00:00 PM,48,-122,32,30,62
44467,FremontBridge,10/29/2017 07:00:00 PM,48,-122,12,13,25
44468,FremontBridge,10/29/2017 08:00:00 PM,48,-122,20,7,27
44469,FremontBridge,10/29/2017 09:00:00 PM,48,-122,12,5,17
44470,FremontBridge,10/29/2017 10:00:00 PM,48,-122,6,4,10
44471,FremontBridge,10/29/2017 11:00:00 PM,48,-122,7,2,9
44472,FremontBridge,10/30/2017 12:00:00 AM,48,-122,4,1,5
44473,FremontBridge,10/30/2017 01:00:00 AM,48,-122,1,0,1
44474,FremontBridge,10/30/2017 02:00:00 AM,48,-122,2,0,2
44475,FremontBridge,10/30/2017 03:00:00 AM,48,-122,1,1,2
44476,FremontBridge,10/30/2017 04:00:00 AM,48,-122,6,2,8
44477,FremontBridge,10/30/2017 05:00:00 AM,48,-122,17,18,35
44478,FremontBridge,10/30/2017 06:00:00 AM,48,-122,60,82,142
44479,FremontBridge,10/30/2017 07:00:00 AM,48,-122,178,199,377
44480,FremontBridge,10/30/2017 08:00:00 AM,48,-122,283,312,595
44481,FremontBridge,10/30/2017 09:00:00 AM,48,-122,178,159,337
44482,FremontBridge,10/30/2017 10:00:00 AM,48,-122,65,57,122
44483,FremontBridge,10/30/2017 11:00:00 AM,48,-122,40,39,79
44484,FremontBridge,10/30/2017 12:00:00 PM,48,-122,48,36,84
44485,FremontBridge,10/30/2017 01:00:00 PM,48,-122,49,53,102
44486,FremontBridge,10/30/2017 02:00:00 PM,48,-122,49,34,83
44487,FremontBridge,10/30/2017 03:00:00 PM,48,-122,102,68,170
44488,FremontBridge,10/30/2017 04:00:00 PM,48,-122,219,108,327
44489,FremontBridge,10/30/2017 05:00:00 PM,48,-122,553,156,709
44490,FremontBridge,10/30/2017 06:00:00 PM,48,-122,297,118,415
44491,FremontBridge,10/30/2017 07:00:00 PM,48,-122,127,46,173
44492,FremontBridge,10/30/2017 08:00:00 PM,48,-122,42,30,72
44493,FremontBridge,10/30/2017 09:00:00 PM,48,-122,43,18,61
44494,FremontBridge,10/30/2017 10:00:00 PM,48,-122,18,10,28
44495,FremontBridge,10/30/2017 11:00:00 PM,48,-122,10,5,15
44496,FremontBridge,10/31/2017 12:00:00 AM,48,-122,4,3,7
44497,FremontBridge,10/31/2017 01:00:00 AM,48,-122,5,2,7
44498,FremontBridge,10/31/2017 02:00:00 AM,48,-122,0,1,1
44499,FremontBridge,10/31/2017 03:00:00 AM,48,-122,3,2,5
44500,FremontBridge,10/31/2017 04:00:00 AM,48,-122,8,4,12
44501,FremontBridge,10/31/2017 05:00:00 AM,48,-122,17,22,39
44502,FremontBridge,10/31/2017 06:00:00 AM,48,-122,57,74,131
44503,FremontBridge,10/31/2017 07:00:00 AM,48,-122,182,222,404
44504,FremontBridge,10/31/2017 08:00:00 AM,48,-122,289,292,581
44505,FremontBridge,10/31/2017 09:00:00 AM,48,-122,144,134,278
44506,FremontBridge,10/31/2017 10:00:00 AM,48,-122,57,60,117
44507,FremontBridge,10/31/2017 11:00:00 AM,48,-122,38,41,79
44508,FremontBridge,10/31/2017 12:00:00 PM,48,-122,46,50,96
44509,FremontBridge,10/31/2017 01:00:00 PM,48,-122,72,62,134
44510,FremontBridge,10/31/2017 02:00:00 PM,48,-122,56,45,101
44511,FremontBridge,10/31/2017 03:00:00 PM,48,-122,116,63,179
44512,FremontBridge,10/31/2017 04:00:00 PM,48,-122,297,110,407
44513,FremontBridge,10/31/2017 05:00:00 PM,48,-122,531,148,679
44514,FremontBridge,10/31/2017 06:00:00 PM,48,-122,222,102,324
44515,FremontBridge,10/31/2017 07:00:00 PM,48,-122,77,39,116
44516,FremontBridge,10/31/2017 08:00:00 PM,48,-122,41,31,72
44517,FremontBridge,10/31/2017 09:00:00 PM,48,-122,19,13,32
44518,FremontBridge,10/31/2017 10:00:00 PM,48,-122,23,17,40
44519,FremontBridge,10/31/2017 11:00:00 PM,48,-122,15,8,23
44520,FremontBridge,11/01/2017 12:00:00 AM,48,-122,5,1,6
44521,FremontBridge,11/01/2017 01:00:00 AM,48,-122,8,6,14
44522,FremontBridge,11/01/2017 02:00:00 AM,48,-122,3,0,3
44523,FremontBridge,11/01/2017 03:00:00 AM,48,-122,3,0,3
44524,FremontBridge,11/01/2017 04:00:00 AM,48,-122,6,4,10
44525,FremontBridge,11/01/2017 05:00:00 AM,48,-122,13,19,32
44526,FremontBridge,11/01/2017 06:00:00 AM,48,-122,60,66,126
44527,FremontBridge,11/01/2017 07:00:00 AM,48,-122,177,193,370
44528,FremontBridge,11/01/2017 08:00:00 AM,48,-122,240,276,516
44529,FremontBridge,11/01/2017 09:00:00 AM,48,-122,131,126,257
44530,FremontBridge,11/01/2017 10:00:00 AM,48,-122,64,40,104
44531,FremontBridge,11/01/2017 11:00:00 AM,48,-122,29,28,57
44532,FremontBridge,11/01/2017 12:00:00 PM,48,-122,34,21,55
44533,FremontBridge,11/01/2017 01:00:00 PM,48,-122,39,25,64
44534,FremontBridge,11/01/2017 02:00:00 PM,48,-122,41,36,77
44535,FremontBridge,11/01/2017 03:00:00 PM,48,-122,71,47,118
44536,FremontBridge,11/01/2017 04:00:00 PM,48,-122,201,88,289
44537,FremontBridge,11/01/2017 05:00:00 PM,48,-122,435,131,566
44538,FremontBridge,11/01/2017 06:00:00 PM,48,-122,249,107,356
44539,FremontBridge,11/01/2017 07:00:00 PM,48,-122,91,40,131
44540,FremontBridge,11/01/2017 08:00:00 PM,48,-122,62,26,88
44541,FremontBridge,11/01/2017 09:00:00 PM,48,-122,36,30,66
44542,FremontBridge,11/01/2017 10:00:00 PM,48,-122,17,17,34
44543,FremontBridge,11/01/2017 11:00:00 PM,48,-122,12,4,16
44544,FremontBridge,11/02/2017 12:00:00 AM,48,-122,8,3,11
44545,FremontBridge,11/02/2017 01:00:00 AM,48,-122,6,1,7
44546,FremontBridge,11/02/2017 02:00:00 AM,48,-122,3,2,5
44547,FremontBridge,11/02/2017 03:00:00 AM,48,-122,2,2,4
44548,FremontBridge,11/02/2017 04:00:00 AM,48,-122,4,4,8
44549,FremontBridge,11/02/2017 05:00:00 AM,48,-122,9,20,29
44550,FremontBridge,11/02/2017 06:00:00 AM,48,-122,64,58,122
44551,FremontBridge,11/02/2017 07:00:00 AM,48,-122,144,150,294
44552,FremontBridge,11/02/2017 08:00:00 AM,48,-122,218,257,475
44553,FremontBridge,11/02/2017 09:00:00 AM,48,-122,124,115,239
44554,FremontBridge,11/02/2017 10:00:00 AM,48,-122,48,31,79
44555,FremontBridge,11/02/2017 11:00:00 AM,48,-122,32,26,58
44556,FremontBridge,11/02/2017 12:00:00 PM,48,-122,19,18,37
44557,FremontBridge,11/02/2017 01:00:00 PM,48,-122,23,16,39
44558,FremontBridge,11/02/2017 02:00:00 PM,48,-122,36,20,56
44559,FremontBridge,11/02/2017 03:00:00 PM,48,-122,67,36,103
44560,FremontBridge,11/02/2017 04:00:00 PM,48,-122,159,63,222
44561,FremontBridge,11/02/2017 05:00:00 PM,48,-122,374,124,498
44562,FremontBridge,11/02/2017 06:00:00 PM,48,-122,221,72,293
44563,FremontBridge,11/02/2017 07:00:00 PM,48,-122,96,43,139
44564,FremontBridge,11/02/2017 08:00:00 PM,48,-122,33,23,56
44565,FremontBridge,11/02/2017 09:00:00 PM,48,-122,34,8,42
44566,FremontBridge,11/02/2017 10:00:00 PM,48,-122,29,10,39
44567,FremontBridge,11/02/2017 11:00:00 PM,48,-122,9,5,14
44568,FremontBridge,11/03/2017 12:00:00 AM,48,-122,3,2,5
44569,FremontBridge,11/03/2017 01:00:00 AM,48,-122,3,1,4
44570,FremontBridge,11/03/2017 02:00:00 AM,48,-122,1,1,2
44571,FremontBridge,11/03/2017 03:00:00 AM,48,-122,0,1,1
44572,FremontBridge,11/03/2017 04:00:00 AM,48,-122,3,2,5
44573,FremontBridge,11/03/2017 05:00:00 AM,48,-122,8,8,16
44574,FremontBridge,11/03/2017 06:00:00 AM,48,-122,29,38,67
44575,FremontBridge,11/03/2017 07:00:00 AM,48,-122,89,120,209
44576,FremontBridge,11/03/2017 08:00:00 AM,48,-122,162,170,332
44577,FremontBridge,11/03/2017 09:00:00 AM,48,-122,95,93,188
44578,FremontBridge,11/03/2017 10:00:00 AM,48,-122,39,32,71
44579,FremontBridge,11/03/2017 11:00:00 AM,48,-122,24,20,44
44580,FremontBridge,11/03/2017 12:00:00 PM,48,-122,20,20,40
44581,FremontBridge,11/03/2017 01:00:00 PM,48,-122,25,17,42
44582,FremontBridge,11/03/2017 02:00:00 PM,48,-122,18,25,43
44583,FremontBridge,11/03/2017 03:00:00 PM,48,-122,56,25,81
44584,FremontBridge,11/03/2017 04:00:00 PM,48,-122,114,49,163
44585,FremontBridge,11/03/2017 05:00:00 PM,48,-122,274,76,350
44586,FremontBridge,11/03/2017 06:00:00 PM,48,-122,133,56,189
44587,FremontBridge,11/03/2017 07:00:00 PM,48,-122,43,16,59
44588,FremontBridge,11/03/2017 08:00:00 PM,48,-122,25,17,42
44589,FremontBridge,11/03/2017 09:00:00 PM,48,-122,12,10,22
44590,FremontBridge,11/03/2017 10:00:00 PM,48,-122,4,6,10
44591,FremontBridge,11/03/2017 11:00:00 PM,48,-122,6,8,14
44592,FremontBridge,11/04/2017 12:00:00 AM,48,-122,7,6,13
44593,FremontBridge,11/04/2017 01:00:00 AM,48,-122,2,2,4
44594,FremontBridge,11/04/2017 02:00:00 AM,48,-122,2,0,2
44595,FremontBridge,11/04/2017 03:00:00 AM,48,-122,1,1,2
44596,FremontBridge,11/04/2017 04:00:00 AM,48,-122,1,2,3
44597,FremontBridge,11/04/2017 05:00:00 AM,48,-122,0,1,1
44598,FremontBridge,11/04/2017 06:00:00 AM,48,-122,5,6,11
44599,FremontBridge,11/04/2017 07:00:00 AM,48,-122,9,7,16
44600,FremontBridge,11/04/2017 08:00:00 AM,48,-122,21,21,42
44601,FremontBridge,11/04/2017 09:00:00 AM,48,-122,18,25,43
44602,FremontBridge,11/04/2017 10:00:00 AM,48,-122,23,39,62
44603,FremontBridge,11/04/2017 11:00:00 AM,48,-122,42,40,82
44604,FremontBridge,11/04/2017 12:00:00 PM,48,-122,38,51,89
44605,FremontBridge,11/04/2017 01:00:00 PM,48,-122,39,48,87
44606,FremontBridge,11/04/2017 02:00:00 PM,48,-122,29,30,59
44607,FremontBridge,11/04/2017 03:00:00 PM,48,-122,21,30,51
44608,FremontBridge,11/04/2017 04:00:00 PM,48,-122,29,31,60
44609,FremontBridge,11/04/2017 05:00:00 PM,48,-122,21,20,41
44610,FremontBridge,11/04/2017 06:00:00 PM,48,-122,11,8,19
44611,FremontBridge,11/04/2017 07:00:00 PM,48,-122,10,7,17
44612,FremontBridge,11/04/2017 08:00:00 PM,48,-122,6,11,17
44613,FremontBridge,11/04/2017 09:00:00 PM,48,-122,9,6,15
44614,FremontBridge,11/04/2017 10:00:00 PM,48,-122,9,8,17
44615,FremontBridge,11/04/2017 11:00:00 PM,48,-122,5,7,12
44616,FremontBridge,11/05/2017 12:00:00 AM,48,-122,3,0,3
44617,FremontBridge,11/05/2017 01:00:00 AM,48,-122,1,3,4
44618,FremontBridge,11/05/2017 02:00:00 AM,48,-122,0,1,1
44619,FremontBridge,11/05/2017 03:00:00 AM,48,-122,2,1,3
44620,FremontBridge,11/05/2017 04:00:00 AM,48,-122,1,2,3
44621,FremontBridge,11/05/2017 05:00:00 AM,48,-122,2,2,4
44622,FremontBridge,11/05/2017 06:00:00 AM,48,-122,2,2,4
44623,FremontBridge,11/05/2017 07:00:00 AM,48,-122,4,4,8
44624,FremontBridge,11/05/2017 08:00:00 AM,48,-122,6,7,13
44625,FremontBridge,11/05/2017 09:00:00 AM,48,-122,11,14,25
44626,FremontBridge,11/05/2017 10:00:00 AM,48,-122,12,8,20
44627,FremontBridge,11/05/2017 11:00:00 AM,48,-122,9,12,21
44628,FremontBridge,11/05/2017 12:00:00 PM,48,-122,10,10,20
44629,FremontBridge,11/05/2017 01:00:00 PM,48,-122,16,6,22
44630,FremontBridge,11/05/2017 02:00:00 PM,48,-122,14,11,25
44631,FremontBridge,11/05/2017 03:00:00 PM,48,-122,7,8,15
44632,FremontBridge,11/05/2017 04:00:00 PM,48,-122,12,14,26
44633,FremontBridge,11/05/2017 05:00:00 PM,48,-122,13,16,29
44634,FremontBridge,11/05/2017 06:00:00 PM,48,-122,9,12,21
44635,FremontBridge,11/05/2017 07:00:00 PM,48,-122,5,4,9
44636,FremontBridge,11/05/2017 08:00:00 PM,48,-122,7,2,9
44637,FremontBridge,11/05/2017 09:00:00 PM,48,-122,6,8,14
44638,FremontBridge,11/05/2017 10:00:00 PM,48,-122,5,3,8
44639,FremontBridge,11/05/2017 11:00:00 PM,48,-122,4,4,8
44640,FremontBridge,11/06/2017 12:00:00 AM,48,-122,0,2,2
44641,FremontBridge,11/06/2017 01:00:00 AM,48,-122,0,0,0
44642,FremontBridge,11/06/2017 02:00:00 AM,48,-122,1,0,1
44643,FremontBridge,11/06/2017 03:00:00 AM,48,-122,0,0,0
44644,FremontBridge,11/06/2017 04:00:00 AM,48,-122,0,0,0
44645,FremontBridge,11/06/2017 05:00:00 AM,48,-122,10,19,29
44646,FremontBridge,11/06/2017 06:00:00 AM,48,-122,50,69,119
44647,FremontBridge,11/06/2017 07:00:00 AM,48,-122,167,210,377
44648,FremontBridge,11/06/2017 08:00:00 AM,48,-122,221,259,480
44649,FremontBridge,11/06/2017 09:00:00 AM,48,-122,130,120,250
44650,FremontBridge,11/06/2017 10:00:00 AM,48,-122,49,37,86
44651,FremontBridge,11/06/2017 11:00:00 AM,48,-122,39,26,65
44652,FremontBridge,11/06/2017 12:00:00 PM,48,-122,38,30,68
44653,FremontBridge,11/06/2017 01:00:00 PM,48,-122,55,46,101
44654,FremontBridge,11/06/2017 02:00:00 PM,48,-122,39,42,81
44655,FremontBridge,11/06/2017 03:00:00 PM,48,-122,89,49,138
44656,FremontBridge,11/06/2017 04:00:00 PM,48,-122,194,69,263
44657,FremontBridge,11/06/2017 05:00:00 PM,48,-122,453,104,557
44658,FremontBridge,11/06/2017 06:00:00 PM,48,-122,246,100,346
44659,FremontBridge,11/06/2017 07:00:00 PM,48,-122,87,35,122
44660,FremontBridge,11/06/2017 08:00:00 PM,48,-122,46,14,60
44661,FremontBridge,11/06/2017 09:00:00 PM,48,-122,27,16,43
44662,FremontBridge,11/06/2017 10:00:00 PM,48,-122,12,11,23
44663,FremontBridge,11/06/2017 11:00:00 PM,48,-122,6,5,11
44664,FremontBridge,11/07/2017 12:00:00 AM,48,-122,2,3,5
44665,FremontBridge,11/07/2017 01:00:00 AM,48,-122,3,0,3
44666,FremontBridge,11/07/2017 02:00:00 AM,48,-122,2,0,2
44667,FremontBridge,11/07/2017 03:00:00 AM,48,-122,1,0,1
44668,FremontBridge,11/07/2017 04:00:00 AM,48,-122,5,4,9
44669,FremontBridge,11/07/2017 05:00:00 AM,48,-122,15,21,36
44670,FremontBridge,11/07/2017 06:00:00 AM,48,-122,77,77,154
44671,FremontBridge,11/07/2017 07:00:00 AM,48,-122,171,201,372
44672,FremontBridge,11/07/2017 08:00:00 AM,48,-122,210,267,477
44673,FremontBridge,11/07/2017 09:00:00 AM,48,-122,126,115,241
44674,FremontBridge,11/07/2017 10:00:00 AM,48,-122,51,43,94
44675,FremontBridge,11/07/2017 11:00:00 AM,48,-122,40,31,71
44676,FremontBridge,11/07/2017 12:00:00 PM,48,-122,30,32,62
44677,FremontBridge,11/07/2017 01:00:00 PM,48,-122,35,30,65
44678,FremontBridge,11/07/2017 02:00:00 PM,48,-122,39,34,73
44679,FremontBridge,11/07/2017 03:00:00 PM,48,-122,71,44,115
44680,FremontBridge,11/07/2017 04:00:00 PM,48,-122,213,80,293
44681,FremontBridge,11/07/2017 05:00:00 PM,48,-122,424,115,539
44682,FremontBridge,11/07/2017 06:00:00 PM,48,-122,249,92,341
44683,FremontBridge,11/07/2017 07:00:00 PM,48,-122,104,47,151
44684,FremontBridge,11/07/2017 08:00:00 PM,48,-122,53,20,73
44685,FremontBridge,11/07/2017 09:00:00 PM,48,-122,33,20,53
44686,FremontBridge,11/07/2017 10:00:00 PM,48,-122,19,8,27
44687,FremontBridge,11/07/2017 11:00:00 PM,48,-122,7,4,11
44688,FremontBridge,11/08/2017 12:00:00 AM,48,-122,5,4,9
44689,FremontBridge,11/08/2017 01:00:00 AM,48,-122,2,0,2
44690,FremontBridge,11/08/2017 02:00:00 AM,48,-122,2,0,2
44691,FremontBridge,11/08/2017 03:00:00 AM,48,-122,3,3,6
44692,FremontBridge,11/08/2017 04:00:00 AM,48,-122,2,3,5
44693,FremontBridge,11/08/2017 05:00:00 AM,48,-122,12,20,32
44694,FremontBridge,11/08/2017 06:00:00 AM,48,-122,52,71,123
44695,FremontBridge,11/08/2017 07:00:00 AM,48,-122,163,194,357
44696,FremontBridge,11/08/2017 08:00:00 AM,48,-122,212,226,438
44697,FremontBridge,11/08/2017 09:00:00 AM,48,-122,116,99,215
44698,FremontBridge,11/08/2017 10:00:00 AM,48,-122,50,38,88
44699,FremontBridge,11/08/2017 11:00:00 AM,48,-122,23,28,51
44700,FremontBridge,11/08/2017 12:00:00 PM,48,-122,30,42,72
44701,FremontBridge,11/08/2017 01:00:00 PM,48,-122,32,35,67
44702,FremontBridge,11/08/2017 02:00:00 PM,48,-122,44,32,76
44703,FremontBridge,11/08/2017 03:00:00 PM,48,-122,66,48,114
44704,FremontBridge,11/08/2017 04:00:00 PM,48,-122,170,58,228
44705,FremontBridge,11/08/2017 05:00:00 PM,48,-122,348,94,442
44706,FremontBridge,11/08/2017 06:00:00 PM,48,-122,195,79,274
44707,FremontBridge,11/08/2017 07:00:00 PM,48,-122,99,28,127
44708,FremontBridge,11/08/2017 08:00:00 PM,48,-122,60,18,78
44709,FremontBridge,11/08/2017 09:00:00 PM,48,-122,26,15,41
44710,FremontBridge,11/08/2017 10:00:00 PM,48,-122,14,3,17
44711,FremontBridge,11/08/2017 11:00:00 PM,48,-122,11,4,15
44712,FremontBridge,11/09/2017 12:00:00 AM,48,-122,6,4,10
44713,FremontBridge,11/09/2017 01:00:00 AM,48,-122,0,2,2
44714,FremontBridge,11/09/2017 02:00:00 AM,48,-122,0,0,0
44715,FremontBridge,11/09/2017 03:00:00 AM,48,-122,2,1,3
44716,FremontBridge,11/09/2017 04:00:00 AM,48,-122,1,2,3
44717,FremontBridge,11/09/2017 05:00:00 AM,48,-122,9,19,28
44718,FremontBridge,11/09/2017 06:00:00 AM,48,-122,45,50,95
44719,FremontBridge,11/09/2017 07:00:00 AM,48,-122,123,140,263
44720,FremontBridge,11/09/2017 08:00:00 AM,48,-122,138,197,335
44721,FremontBridge,11/09/2017 09:00:00 AM,48,-122,100,111,211
44722,FremontBridge,11/09/2017 10:00:00 AM,48,-122,33,36,69
44723,FremontBridge,11/09/2017 11:00:00 AM,48,-122,20,17,37
44724,FremontBridge,11/09/2017 12:00:00 PM,48,-122,9,16,25
44725,FremontBridge,11/09/2017 01:00:00 PM,48,-122,22,12,34
44726,FremontBridge,11/09/2017 02:00:00 PM,48,-122,18,21,39
44727,FremontBridge,11/09/2017 03:00:00 PM,48,-122,45,32,77
44728,FremontBridge,11/09/2017 04:00:00 PM,48,-122,138,49,187
44729,FremontBridge,11/09/2017 05:00:00 PM,48,-122,321,83,404
44730,FremontBridge,11/09/2017 06:00:00 PM,48,-122,173,51,224
44731,FremontBridge,11/09/2017 07:00:00 PM,48,-122,86,39,125
44732,FremontBridge,11/09/2017 08:00:00 PM,48,-122,33,25,58
44733,FremontBridge,11/09/2017 09:00:00 PM,48,-122,28,17,45
44734,FremontBridge,11/09/2017 10:00:00 PM,48,-122,26,7,33
44735,FremontBridge,11/09/2017 11:00:00 PM,48,-122,15,4,19
44736,FremontBridge,11/10/2017 12:00:00 AM,48,-122,6,6,12
44737,FremontBridge,11/10/2017 01:00:00 AM,48,-122,1,2,3
44738,FremontBridge,11/10/2017 02:00:00 AM,48,-122,4,2,6
44739,FremontBridge,11/10/2017 03:00:00 AM,48,-122,1,3,4
44740,FremontBridge,11/10/2017 04:00:00 AM,48,-122,5,2,7
44741,FremontBridge,11/10/2017 05:00:00 AM,48,-122,4,12,16
44742,FremontBridge,11/10/2017 06:00:00 AM,48,-122,29,34,63
44743,FremontBridge,11/10/2017 07:00:00 AM,48,-122,99,105,204
44744,FremontBridge,11/10/2017 08:00:00 AM,48,-122,148,172,320
44745,FremontBridge,11/10/2017 09:00:00 AM,48,-122,94,82,176
44746,FremontBridge,11/10/2017 10:00:00 AM,48,-122,47,39,86
44747,FremontBridge,11/10/2017 11:00:00 AM,48,-122,38,40,78
44748,FremontBridge,11/10/2017 12:00:00 PM,48,-122,46,31,77
44749,FremontBridge,11/10/2017 01:00:00 PM,48,-122,59,57,116
44750,FremontBridge,11/10/2017 02:00:00 PM,48,-122,63,56,119
44751,FremontBridge,11/10/2017 03:00:00 PM,48,-122,100,73,173
44752,FremontBridge,11/10/2017 04:00:00 PM,48,-122,175,64,239
44753,FremontBridge,11/10/2017 05:00:00 PM,48,-122,247,79,326
44754,FremontBridge,11/10/2017 06:00:00 PM,48,-122,141,45,186
44755,FremontBridge,11/10/2017 07:00:00 PM,48,-122,59,26,85
44756,FremontBridge,11/10/2017 08:00:00 PM,48,-122,22,13,35
44757,FremontBridge,11/10/2017 09:00:00 PM,48,-122,25,6,31
44758,FremontBridge,11/10/2017 10:00:00 PM,48,-122,15,8,23
44759,FremontBridge,11/10/2017 11:00:00 PM,48,-122,13,10,23
44760,FremontBridge,11/11/2017 12:00:00 AM,48,-122,8,2,10
44761,FremontBridge,11/11/2017 01:00:00 AM,48,-122,5,5,10
44762,FremontBridge,11/11/2017 02:00:00 AM,48,-122,2,2,4
44763,FremontBridge,11/11/2017 03:00:00 AM,48,-122,0,0,0
44764,FremontBridge,11/11/2017 04:00:00 AM,48,-122,1,2,3
44765,FremontBridge,11/11/2017 05:00:00 AM,48,-122,2,0,2
44766,FremontBridge,11/11/2017 06:00:00 AM,48,-122,4,4,8
44767,FremontBridge,11/11/2017 07:00:00 AM,48,-122,11,12,23
44768,FremontBridge,11/11/2017 08:00:00 AM,48,-122,35,25,60
44769,FremontBridge,11/11/2017 09:00:00 AM,48,-122,26,27,53
44770,FremontBridge,11/11/2017 10:00:00 AM,48,-122,21,26,47
44771,FremontBridge,11/11/2017 11:00:00 AM,48,-122,20,33,53
44772,FremontBridge,11/11/2017 12:00:00 PM,48,-122,20,19,39
44773,FremontBridge,11/11/2017 01:00:00 PM,48,-122,16,14,30
44774,FremontBridge,11/11/2017 02:00:00 PM,48,-122,25,13,38
44775,FremontBridge,11/11/2017 03:00:00 PM,48,-122,44,28,72
44776,FremontBridge,11/11/2017 04:00:00 PM,48,-122,21,20,41
44777,FremontBridge,11/11/2017 05:00:00 PM,48,-122,15,11,26
44778,FremontBridge,11/11/2017 06:00:00 PM,48,-122,19,22,41
44779,FremontBridge,11/11/2017 07:00:00 PM,48,-122,7,11,18
44780,FremontBridge,11/11/2017 08:00:00 PM,48,-122,16,11,27
44781,FremontBridge,11/11/2017 09:00:00 PM,48,-122,8,5,13
44782,FremontBridge,11/11/2017 10:00:00 PM,48,-122,16,4,20
44783,FremontBridge,11/11/2017 11:00:00 PM,48,-122,6,7,13
44784,FremontBridge,11/12/2017 12:00:00 AM,48,-122,8,9,17
44785,FremontBridge,11/12/2017 01:00:00 AM,48,-122,1,4,5
44786,FremontBridge,11/12/2017 02:00:00 AM,48,-122,2,1,3
44787,FremontBridge,11/12/2017 03:00:00 AM,48,-122,0,0,0
44788,FremontBridge,11/12/2017 04:00:00 AM,48,-122,1,2,3
44789,FremontBridge,11/12/2017 05:00:00 AM,48,-122,0,3,3
44790,FremontBridge,11/12/2017 06:00:00 AM,48,-122,2,3,5
44791,FremontBridge,11/12/2017 07:00:00 AM,48,-122,4,1,5
44792,FremontBridge,11/12/2017 08:00:00 AM,48,-122,9,12,21
44793,FremontBridge,11/12/2017 09:00:00 AM,48,-122,12,21,33
44794,FremontBridge,11/12/2017 10:00:00 AM,48,-122,22,23,45
44795,FremontBridge,11/12/2017 11:00:00 AM,48,-122,40,43,83
44796,FremontBridge,11/12/2017 12:00:00 PM,48,-122,29,35,64
44797,FremontBridge,11/12/2017 01:00:00 PM,48,-122,40,42,82
44798,FremontBridge,11/12/2017 02:00:00 PM,48,-122,20,27,47
44799,FremontBridge,11/12/2017 03:00:00 PM,48,-122,14,18,32
44800,FremontBridge,11/12/2017 04:00:00 PM,48,-122,17,18,35
44801,FremontBridge,11/12/2017 05:00:00 PM,48,-122,17,14,31
44802,FremontBridge,11/12/2017 06:00:00 PM,48,-122,10,8,18
44803,FremontBridge,11/12/2017 07:00:00 PM,48,-122,9,5,14
44804,FremontBridge,11/12/2017 08:00:00 PM,48,-122,7,6,13
44805,FremontBridge,11/12/2017 09:00:00 PM,48,-122,4,3,7
44806,FremontBridge,11/12/2017 10:00:00 PM,48,-122,2,2,4
44807,FremontBridge,11/12/2017 11:00:00 PM,48,-122,8,1,9
44808,FremontBridge,11/13/2017 12:00:00 AM,48,-122,0,1,1
44809,FremontBridge,11/13/2017 01:00:00 AM,48,-122,2,0,2
44810,FremontBridge,11/13/2017 02:00:00 AM,48,-122,0,0,0
44811,FremontBridge,11/13/2017 03:00:00 AM,48,-122,1,0,1
44812,FremontBridge,11/13/2017 04:00:00 AM,48,-122,2,1,3
44813,FremontBridge,11/13/2017 05:00:00 AM,48,-122,12,12,24
44814,FremontBridge,11/13/2017 06:00:00 AM,48,-122,31,56,87
44815,FremontBridge,11/13/2017 07:00:00 AM,48,-122,120,126,246
44816,FremontBridge,11/13/2017 08:00:00 AM,48,-122,175,211,386
44817,FremontBridge,11/13/2017 09:00:00 AM,48,-122,92,92,184
44818,FremontBridge,11/13/2017 10:00:00 AM,48,-122,40,30,70
44819,FremontBridge,11/13/2017 11:00:00 AM,48,-122,21,20,41
44820,FremontBridge,11/13/2017 12:00:00 PM,48,-122,21,21,42
44821,FremontBridge,11/13/2017 01:00:00 PM,48,-122,24,24,48
44822,FremontBridge,11/13/2017 02:00:00 PM,48,-122,22,30,52
44823,FremontBridge,11/13/2017 03:00:00 PM,48,-122,62,21,83
44824,FremontBridge,11/13/2017 04:00:00 PM,48,-122,107,33,140
44825,FremontBridge,11/13/2017 05:00:00 PM,48,-122,274,48,322
44826,FremontBridge,11/13/2017 06:00:00 PM,48,-122,135,53,188
44827,FremontBridge,11/13/2017 07:00:00 PM,48,-122,50,16,66
44828,FremontBridge,11/13/2017 08:00:00 PM,48,-122,30,11,41
44829,FremontBridge,11/13/2017 09:00:00 PM,48,-122,15,12,27
44830,FremontBridge,11/13/2017 10:00:00 PM,48,-122,8,6,14
44831,FremontBridge,11/13/2017 11:00:00 PM,48,-122,5,4,9
44832,FremontBridge,11/14/2017 12:00:00 AM,48,-122,4,1,5
44833,FremontBridge,11/14/2017 01:00:00 AM,48,-122,2,0,2
44834,FremontBridge,11/14/2017 02:00:00 AM,48,-122,2,1,3
44835,FremontBridge,11/14/2017 03:00:00 AM,48,-122,3,0,3
44836,FremontBridge,11/14/2017 04:00:00 AM,48,-122,4,3,7
44837,FremontBridge,11/14/2017 05:00:00 AM,48,-122,4,16,20
44838,FremontBridge,11/14/2017 06:00:00 AM,48,-122,41,47,88
44839,FremontBridge,11/14/2017 07:00:00 AM,48,-122,131,129,260
44840,FremontBridge,11/14/2017 08:00:00 AM,48,-122,187,210,397
44841,FremontBridge,11/14/2017 09:00:00 AM,48,-122,102,79,181
44842,FremontBridge,11/14/2017 10:00:00 AM,48,-122,35,38,73
44843,FremontBridge,11/14/2017 11:00:00 AM,48,-122,22,22,44
44844,FremontBridge,11/14/2017 12:00:00 PM,48,-122,25,25,50
44845,FremontBridge,11/14/2017 01:00:00 PM,48,-122,32,15,47
44846,FremontBridge,11/14/2017 02:00:00 PM,48,-122,27,24,51
44847,FremontBridge,11/14/2017 03:00:00 PM,48,-122,59,30,89
44848,FremontBridge,11/14/2017 04:00:00 PM,48,-122,147,52,199
44849,FremontBridge,11/14/2017 05:00:00 PM,48,-122,327,95,422
44850,FremontBridge,11/14/2017 06:00:00 PM,48,-122,194,67,261
44851,FremontBridge,11/14/2017 07:00:00 PM,48,-122,88,40,128
44852,FremontBridge,11/14/2017 08:00:00 PM,48,-122,51,22,73
44853,FremontBridge,11/14/2017 09:00:00 PM,48,-122,25,18,43
44854,FremontBridge,11/14/2017 10:00:00 PM,48,-122,10,16,26
44855,FremontBridge,11/14/2017 11:00:00 PM,48,-122,6,4,10
44856,FremontBridge,11/15/2017 12:00:00 AM,48,-122,4,1,5
44857,FremontBridge,11/15/2017 01:00:00 AM,48,-122,0,0,0
44858,FremontBridge,11/15/2017 02:00:00 AM,48,-122,1,2,3
44859,FremontBridge,11/15/2017 03:00:00 AM,48,-122,0,1,1
44860,FremontBridge,11/15/2017 04:00:00 AM,48,-122,4,4,8
44861,FremontBridge,11/15/2017 05:00:00 AM,48,-122,9,19,28
44862,FremontBridge,11/15/2017 06:00:00 AM,48,-122,39,48,87
44863,FremontBridge,11/15/2017 07:00:00 AM,48,-122,106,123,229
44864,FremontBridge,11/15/2017 08:00:00 AM,48,-122,139,138,277
44865,FremontBridge,11/15/2017 09:00:00 AM,48,-122,91,80,171
44866,FremontBridge,11/15/2017 10:00:00 AM,48,-122,41,41,82
44867,FremontBridge,11/15/2017 11:00:00 AM,48,-122,13,15,28
44868,FremontBridge,11/15/2017 12:00:00 PM,48,-122,22,23,45
44869,FremontBridge,11/15/2017 01:00:00 PM,48,-122,22,19,41
44870,FremontBridge,11/15/2017 02:00:00 PM,48,-122,23,26,49
44871,FremontBridge,11/15/2017 03:00:00 PM,48,-122,50,34,84
44872,FremontBridge,11/15/2017 04:00:00 PM,48,-122,131,56,187
44873,FremontBridge,11/15/2017 05:00:00 PM,48,-122,297,94,391
44874,FremontBridge,11/15/2017 06:00:00 PM,48,-122,182,68,250
44875,FremontBridge,11/15/2017 07:00:00 PM,48,-122,69,36,105
44876,FremontBridge,11/15/2017 08:00:00 PM,48,-122,54,21,75
44877,FremontBridge,11/15/2017 09:00:00 PM,48,-122,20,13,33
44878,FremontBridge,11/15/2017 10:00:00 PM,48,-122,12,9,21
44879,FremontBridge,11/15/2017 11:00:00 PM,48,-122,11,4,15
44880,FremontBridge,11/16/2017 12:00:00 AM,48,-122,7,0,7
44881,FremontBridge,11/16/2017 01:00:00 AM,48,-122,1,0,1
44882,FremontBridge,11/16/2017 02:00:00 AM,48,-122,2,0,2
44883,FremontBridge,11/16/2017 03:00:00 AM,48,-122,1,2,3
44884,FremontBridge,11/16/2017 04:00:00 AM,48,-122,4,2,6
44885,FremontBridge,11/16/2017 05:00:00 AM,48,-122,12,22,34
44886,FremontBridge,11/16/2017 06:00:00 AM,48,-122,47,52,99
44887,FremontBridge,11/16/2017 07:00:00 AM,48,-122,154,162,316
44888,FremontBridge,11/16/2017 08:00:00 AM,48,-122,177,194,371
44889,FremontBridge,11/16/2017 09:00:00 AM,48,-122,104,103,207
44890,FremontBridge,11/16/2017 10:00:00 AM,48,-122,40,33,73
44891,FremontBridge,11/16/2017 11:00:00 AM,48,-122,25,22,47
44892,FremontBridge,11/16/2017 12:00:00 PM,48,-122,16,12,28
44893,FremontBridge,11/16/2017 01:00:00 PM,48,-122,21,16,37
44894,FremontBridge,11/16/2017 02:00:00 PM,48,-122,34,23,57
44895,FremontBridge,11/16/2017 03:00:00 PM,48,-122,51,27,78
44896,FremontBridge,11/16/2017 04:00:00 PM,48,-122,150,59,209
44897,FremontBridge,11/16/2017 05:00:00 PM,48,-122,348,81,429
44898,FremontBridge,11/16/2017 06:00:00 PM,48,-122,206,72,278
44899,FremontBridge,11/16/2017 07:00:00 PM,48,-122,94,28,122
44900,FremontBridge,11/16/2017 08:00:00 PM,48,-122,39,20,59
44901,FremontBridge,11/16/2017 09:00:00 PM,48,-122,30,19,49
44902,FremontBridge,11/16/2017 10:00:00 PM,48,-122,14,12,26
44903,FremontBridge,11/16/2017 11:00:00 PM,48,-122,9,7,16
44904,FremontBridge,11/17/2017 12:00:00 AM,48,-122,8,1,9
44905,FremontBridge,11/17/2017 01:00:00 AM,48,-122,1,1,2
44906,FremontBridge,11/17/2017 02:00:00 AM,48,-122,1,0,1
44907,FremontBridge,11/17/2017 03:00:00 AM,48,-122,1,3,4
44908,FremontBridge,11/17/2017 04:00:00 AM,48,-122,4,5,9
44909,FremontBridge,11/17/2017 05:00:00 AM,48,-122,7,17,24
44910,FremontBridge,11/17/2017 06:00:00 AM,48,-122,60,46,106
44911,FremontBridge,11/17/2017 07:00:00 AM,48,-122,129,150,279
44912,FremontBridge,11/17/2017 08:00:00 AM,48,-122,184,205,389
44913,FremontBridge,11/17/2017 09:00:00 AM,48,-122,105,102,207
44914,FremontBridge,11/17/2017 10:00:00 AM,48,-122,50,49,99
44915,FremontBridge,11/17/2017 11:00:00 AM,48,-122,35,39,74
44916,FremontBridge,11/17/2017 12:00:00 PM,48,-122,47,36,83
44917,FremontBridge,11/17/2017 01:00:00 PM,48,-122,49,45,94
44918,FremontBridge,11/17/2017 02:00:00 PM,48,-122,61,46,107
44919,FremontBridge,11/17/2017 03:00:00 PM,48,-122,74,52,126
44920,FremontBridge,11/17/2017 04:00:00 PM,48,-122,189,58,247
44921,FremontBridge,11/17/2017 05:00:00 PM,48,-122,323,100,423
44922,FremontBridge,11/17/2017 06:00:00 PM,48,-122,173,57,230
44923,FremontBridge,11/17/2017 07:00:00 PM,48,-122,80,22,102
44924,FremontBridge,11/17/2017 08:00:00 PM,48,-122,37,15,52
44925,FremontBridge,11/17/2017 09:00:00 PM,48,-122,23,15,38
44926,FremontBridge,11/17/2017 10:00:00 PM,48,-122,23,13,36
44927,FremontBridge,11/17/2017 11:00:00 PM,48,-122,10,10,20
44928,FremontBridge,11/18/2017 12:00:00 AM,48,-122,17,10,27
44929,FremontBridge,11/18/2017 01:00:00 AM,48,-122,5,5,10
44930,FremontBridge,11/18/2017 02:00:00 AM,48,-122,2,5,7
44931,FremontBridge,11/18/2017 03:00:00 AM,48,-122,0,1,1
44932,FremontBridge,11/18/2017 04:00:00 AM,48,-122,3,4,7
44933,FremontBridge,11/18/2017 05:00:00 AM,48,-122,4,2,6
44934,FremontBridge,11/18/2017 06:00:00 AM,48,-122,6,7,13
44935,FremontBridge,11/18/2017 07:00:00 AM,48,-122,17,11,28
44936,FremontBridge,11/18/2017 08:00:00 AM,48,-122,42,35,77
44937,FremontBridge,11/18/2017 09:00:00 AM,48,-122,44,53,97
44938,FremontBridge,11/18/2017 10:00:00 AM,48,-122,36,53,89
44939,FremontBridge,11/18/2017 11:00:00 AM,48,-122,39,52,91
44940,FremontBridge,11/18/2017 12:00:00 PM,48,-122,71,61,132
44941,FremontBridge,11/18/2017 01:00:00 PM,48,-122,91,76,167
44942,FremontBridge,11/18/2017 02:00:00 PM,48,-122,100,88,188
44943,FremontBridge,11/18/2017 03:00:00 PM,48,-122,75,73,148
44944,FremontBridge,11/18/2017 04:00:00 PM,48,-122,53,61,114
44945,FremontBridge,11/18/2017 05:00:00 PM,48,-122,45,33,78
44946,FremontBridge,11/18/2017 06:00:00 PM,48,-122,34,28,62
44947,FremontBridge,11/18/2017 07:00:00 PM,48,-122,20,10,30
44948,FremontBridge,11/18/2017 08:00:00 PM,48,-122,16,5,21
44949,FremontBridge,11/18/2017 09:00:00 PM,48,-122,19,12,31
44950,FremontBridge,11/18/2017 10:00:00 PM,48,-122,13,6,19
44951,FremontBridge,11/18/2017 11:00:00 PM,48,-122,19,18,37
44952,FremontBridge,11/19/2017 12:00:00 AM,48,-122,12,10,22
44953,FremontBridge,11/19/2017 01:00:00 AM,48,-122,4,7,11
44954,FremontBridge,11/19/2017 02:00:00 AM,48,-122,3,6,9
44955,FremontBridge,11/19/2017 03:00:00 AM,48,-122,0,1,1
44956,FremontBridge,11/19/2017 04:00:00 AM,48,-122,2,1,3
44957,FremontBridge,11/19/2017 05:00:00 AM,48,-122,0,4,4
44958,FremontBridge,11/19/2017 06:00:00 AM,48,-122,5,3,8
44959,FremontBridge,11/19/2017 07:00:00 AM,48,-122,10,10,20
44960,FremontBridge,11/19/2017 08:00:00 AM,48,-122,27,26,53
44961,FremontBridge,11/19/2017 09:00:00 AM,48,-122,41,19,60
44962,FremontBridge,11/19/2017 10:00:00 AM,48,-122,32,43,75
44963,FremontBridge,11/19/2017 11:00:00 AM,48,-122,24,53,77
44964,FremontBridge,11/19/2017 12:00:00 PM,48,-122,30,47,77
44965,FremontBridge,11/19/2017 01:00:00 PM,48,-122,38,41,79
44966,FremontBridge,11/19/2017 02:00:00 PM,48,-122,37,24,61
44967,FremontBridge,11/19/2017 03:00:00 PM,48,-122,22,17,39
44968,FremontBridge,11/19/2017 04:00:00 PM,48,-122,13,14,27
44969,FremontBridge,11/19/2017 05:00:00 PM,48,-122,6,11,17
44970,FremontBridge,11/19/2017 06:00:00 PM,48,-122,9,10,19
44971,FremontBridge,11/19/2017 07:00:00 PM,48,-122,8,8,16
44972,FremontBridge,11/19/2017 08:00:00 PM,48,-122,3,4,7
44973,FremontBridge,11/19/2017 09:00:00 PM,48,-122,3,5,8
44974,FremontBridge,11/19/2017 10:00:00 PM,48,-122,1,5,6
44975,FremontBridge,11/19/2017 11:00:00 PM,48,-122,2,3,5
44976,FremontBridge,11/20/2017 12:00:00 AM,48,-122,2,1,3
44977,FremontBridge,11/20/2017 01:00:00 AM,48,-122,1,1,2
44978,FremontBridge,11/20/2017 02:00:00 AM,48,-122,1,0,1
44979,FremontBridge,11/20/2017 03:00:00 AM,48,-122,0,1,1
44980,FremontBridge,11/20/2017 04:00:00 AM,48,-122,3,5,8
44981,FremontBridge,11/20/2017 05:00:00 AM,48,-122,11,15,26
44982,FremontBridge,11/20/2017 06:00:00 AM,48,-122,38,51,89
44983,FremontBridge,11/20/2017 07:00:00 AM,48,-122,81,110,191
44984,FremontBridge,11/20/2017 08:00:00 AM,48,-122,117,146,263
44985,FremontBridge,11/20/2017 09:00:00 AM,48,-122,81,83,164
44986,FremontBridge,11/20/2017 10:00:00 AM,48,-122,38,27,65
44987,FremontBridge,11/20/2017 11:00:00 AM,48,-122,26,17,43
44988,FremontBridge,11/20/2017 12:00:00 PM,48,-122,25,24,49
44989,FremontBridge,11/20/2017 01:00:00 PM,48,-122,23,28,51
44990,FremontBridge,11/20/2017 02:00:00 PM,48,-122,20,19,39
44991,FremontBridge,11/20/2017 03:00:00 PM,48,-122,52,21,73
44992,FremontBridge,11/20/2017 04:00:00 PM,48,-122,121,41,162
44993,FremontBridge,11/20/2017 05:00:00 PM,48,-122,272,67,339
44994,FremontBridge,11/20/2017 06:00:00 PM,48,-122,170,47,217
44995,FremontBridge,11/20/2017 07:00:00 PM,48,-122,75,32,107
44996,FremontBridge,11/20/2017 08:00:00 PM,48,-122,24,13,37
44997,FremontBridge,11/20/2017 09:00:00 PM,48,-122,19,9,28
44998,FremontBridge,11/20/2017 10:00:00 PM,48,-122,13,11,24
44999,FremontBridge,11/20/2017 11:00:00 PM,48,-122,5,1,6
45000,FremontBridge,11/21/2017 12:00:00 AM,48,-122,6,1,7
45001,FremontBridge,11/21/2017 01:00:00 AM,48,-122,0,3,3
45002,FremontBridge,11/21/2017 02:00:00 AM,48,-122,1,0,1
45003,FremontBridge,11/21/2017 03:00:00 AM,48,-122,0,2,2
45004,FremontBridge,11/21/2017 04:00:00 AM,48,-122,7,3,10
45005,FremontBridge,11/21/2017 05:00:00 AM,48,-122,11,17,28
45006,FremontBridge,11/21/2017 06:00:00 AM,48,-122,35,33,68
45007,FremontBridge,11/21/2017 07:00:00 AM,48,-122,89,95,184
45008,FremontBridge,11/21/2017 08:00:00 AM,48,-122,116,137,253
45009,FremontBridge,11/21/2017 09:00:00 AM,48,-122,81,65,146
45010,FremontBridge,11/21/2017 10:00:00 AM,48,-122,22,15,37
45011,FremontBridge,11/21/2017 11:00:00 AM,48,-122,19,11,30
45012,FremontBridge,11/21/2017 12:00:00 PM,48,-122,13,11,24
45013,FremontBridge,11/21/2017 01:00:00 PM,48,-122,22,13,35
45014,FremontBridge,11/21/2017 02:00:00 PM,48,-122,17,18,35
45015,FremontBridge,11/21/2017 03:00:00 PM,48,-122,32,22,54
45016,FremontBridge,11/21/2017 04:00:00 PM,48,-122,96,43,139
45017,FremontBridge,11/21/2017 05:00:00 PM,48,-122,262,48,310
45018,FremontBridge,11/21/2017 06:00:00 PM,48,-122,139,49,188
45019,FremontBridge,11/21/2017 07:00:00 PM,48,-122,58,26,84
45020,FremontBridge,11/21/2017 08:00:00 PM,48,-122,22,11,33
45021,FremontBridge,11/21/2017 09:00:00 PM,48,-122,10,10,20
45022,FremontBridge,11/21/2017 10:00:00 PM,48,-122,6,6,12
45023,FremontBridge,11/21/2017 11:00:00 PM,48,-122,2,2,4
45024,FremontBridge,11/22/2017 12:00:00 AM,48,-122,3,0,3
45025,FremontBridge,11/22/2017 01:00:00 AM,48,-122,1,1,2
45026,FremontBridge,11/22/2017 02:00:00 AM,48,-122,2,1,3
45027,FremontBridge,11/22/2017 03:00:00 AM,48,-122,1,2,3
45028,FremontBridge,11/22/2017 04:00:00 AM,48,-122,3,2,5
45029,FremontBridge,11/22/2017 05:00:00 AM,48,-122,12,11,23
45030,FremontBridge,11/22/2017 06:00:00 AM,48,-122,28,41,69
45031,FremontBridge,11/22/2017 07:00:00 AM,48,-122,97,103,200
45032,FremontBridge,11/22/2017 08:00:00 AM,48,-122,117,138,255
45033,FremontBridge,11/22/2017 09:00:00 AM,48,-122,81,71,152
45034,FremontBridge,11/22/2017 10:00:00 AM,48,-122,32,45,77
45035,FremontBridge,11/22/2017 11:00:00 AM,48,-122,28,27,55
45036,FremontBridge,11/22/2017 12:00:00 PM,48,-122,40,18,58
45037,FremontBridge,11/22/2017 01:00:00 PM,48,-122,45,28,73
45038,FremontBridge,11/22/2017 02:00:00 PM,48,-122,72,42,114
45039,FremontBridge,11/22/2017 03:00:00 PM,48,-122,105,46,151
45040,FremontBridge,11/22/2017 04:00:00 PM,48,-122,148,67,215
45041,FremontBridge,11/22/2017 05:00:00 PM,48,-122,170,59,229
45042,FremontBridge,11/22/2017 06:00:00 PM,48,-122,69,46,115
45043,FremontBridge,11/22/2017 07:00:00 PM,48,-122,32,25,57
45044,FremontBridge,11/22/2017 08:00:00 PM,48,-122,18,16,34
45045,FremontBridge,11/22/2017 09:00:00 PM,48,-122,13,4,17
45046,FremontBridge,11/22/2017 10:00:00 PM,48,-122,5,1,6
45047,FremontBridge,11/22/2017 11:00:00 PM,48,-122,2,4,6
45048,FremontBridge,11/23/2017 12:00:00 AM,48,-122,2,1,3
45049,FremontBridge,11/23/2017 01:00:00 AM,48,-122,2,2,4
45050,FremontBridge,11/23/2017 02:00:00 AM,48,-122,3,5,8
45051,FremontBridge,11/23/2017 03:00:00 AM,48,-122,1,3,4
45052,FremontBridge,11/23/2017 04:00:00 AM,48,-122,1,0,1
45053,FremontBridge,11/23/2017 05:00:00 AM,48,-122,1,1,2
45054,FremontBridge,11/23/2017 06:00:00 AM,48,-122,4,3,7
45055,FremontBridge,11/23/2017 07:00:00 AM,48,-122,3,8,11
45056,FremontBridge,11/23/2017 08:00:00 AM,48,-122,13,10,23
45057,FremontBridge,11/23/2017 09:00:00 AM,48,-122,12,13,25
45058,FremontBridge,11/23/2017 10:00:00 AM,48,-122,12,14,26
45059,FremontBridge,11/23/2017 11:00:00 AM,48,-122,21,14,35
45060,FremontBridge,11/23/2017 12:00:00 PM,48,-122,10,6,16
45061,FremontBridge,11/23/2017 01:00:00 PM,48,-122,6,12,18
45062,FremontBridge,11/23/2017 02:00:00 PM,48,-122,15,25,40
45063,FremontBridge,11/23/2017 03:00:00 PM,48,-122,12,17,29
45064,FremontBridge,11/23/2017 04:00:00 PM,48,-122,7,4,11
45065,FremontBridge,11/23/2017 05:00:00 PM,48,-122,11,9,20
45066,FremontBridge,11/23/2017 06:00:00 PM,48,-122,7,5,12
45067,FremontBridge,11/23/2017 07:00:00 PM,48,-122,7,1,8
45068,FremontBridge,11/23/2017 08:00:00 PM,48,-122,33,7,40
45069,FremontBridge,11/23/2017 09:00:00 PM,48,-122,10,4,14
45070,FremontBridge,11/23/2017 10:00:00 PM,48,-122,5,3,8
45071,FremontBridge,11/23/2017 11:00:00 PM,48,-122,4,1,5
45072,FremontBridge,11/24/2017 12:00:00 AM,48,-122,5,4,9
45073,FremontBridge,11/24/2017 01:00:00 AM,48,-122,1,1,2
45074,FremontBridge,11/24/2017 02:00:00 AM,48,-122,4,0,4
45075,FremontBridge,11/24/2017 03:00:00 AM,48,-122,0,0,0
45076,FremontBridge,11/24/2017 04:00:00 AM,48,-122,3,2,5
45077,FremontBridge,11/24/2017 05:00:00 AM,48,-122,3,6,9
45078,FremontBridge,11/24/2017 06:00:00 AM,48,-122,15,8,23
45079,FremontBridge,11/24/2017 07:00:00 AM,48,-122,17,12,29
45080,FremontBridge,11/24/2017 08:00:00 AM,48,-122,25,27,52
45081,FremontBridge,11/24/2017 09:00:00 AM,48,-122,30,26,56
45082,FremontBridge,11/24/2017 10:00:00 AM,48,-122,31,34,65
45083,FremontBridge,11/24/2017 11:00:00 AM,48,-122,38,58,96
45084,FremontBridge,11/24/2017 12:00:00 PM,48,-122,28,41,69
45085,FremontBridge,11/24/2017 01:00:00 PM,48,-122,30,58,88
45086,FremontBridge,11/24/2017 02:00:00 PM,48,-122,37,34,71
45087,FremontBridge,11/24/2017 03:00:00 PM,48,-122,44,30,74
45088,FremontBridge,11/24/2017 04:00:00 PM,48,-122,40,27,67
45089,FremontBridge,11/24/2017 05:00:00 PM,48,-122,22,10,32
45090,FremontBridge,11/24/2017 06:00:00 PM,48,-122,22,15,37
45091,FremontBridge,11/24/2017 07:00:00 PM,48,-122,9,8,17
45092,FremontBridge,11/24/2017 08:00:00 PM,48,-122,8,6,14
45093,FremontBridge,11/24/2017 09:00:00 PM,48,-122,14,15,29
45094,FremontBridge,11/24/2017 10:00:00 PM,48,-122,3,2,5
45095,FremontBridge,11/24/2017 11:00:00 PM,48,-122,8,2,10
45096,FremontBridge,11/25/2017 12:00:00 AM,48,-122,2,6,8
45097,FremontBridge,11/25/2017 01:00:00 AM,48,-122,3,7,10
45098,FremontBridge,11/25/2017 02:00:00 AM,48,-122,0,0,0
45099,FremontBridge,11/25/2017 03:00:00 AM,48,-122,0,1,1
45100,FremontBridge,11/25/2017 04:00:00 AM,48,-122,1,2,3
45101,FremontBridge,11/25/2017 05:00:00 AM,48,-122,7,3,10
45102,FremontBridge,11/25/2017 06:00:00 AM,48,-122,7,4,11
45103,FremontBridge,11/25/2017 07:00:00 AM,48,-122,5,12,17
45104,FremontBridge,11/25/2017 08:00:00 AM,48,-122,25,24,49
45105,FremontBridge,11/25/2017 09:00:00 AM,48,-122,24,29,53
45106,FremontBridge,11/25/2017 10:00:00 AM,48,-122,33,49,82
45107,FremontBridge,11/25/2017 11:00:00 AM,48,-122,41,38,79
45108,FremontBridge,11/25/2017 12:00:00 PM,48,-122,41,60,101
45109,FremontBridge,11/25/2017 01:00:00 PM,48,-122,59,45,104
45110,FremontBridge,11/25/2017 02:00:00 PM,48,-122,38,36,74
45111,FremontBridge,11/25/2017 03:00:00 PM,48,-122,40,33,73
45112,FremontBridge,11/25/2017 04:00:00 PM,48,-122,28,14,42
45113,FremontBridge,11/25/2017 05:00:00 PM,48,-122,16,18,34
45114,FremontBridge,11/25/2017 06:00:00 PM,48,-122,10,7,17
45115,FremontBridge,11/25/2017 07:00:00 PM,48,-122,7,4,11
45116,FremontBridge,11/25/2017 08:00:00 PM,48,-122,13,12,25
45117,FremontBridge,11/25/2017 09:00:00 PM,48,-122,15,6,21
45118,FremontBridge,11/25/2017 10:00:00 PM,48,-122,9,6,15
45119,FremontBridge,11/25/2017 11:00:00 PM,48,-122,14,4,18
45120,FremontBridge,11/26/2017 12:00:00 AM,48,-122,3,2,5
45121,FremontBridge,11/26/2017 01:00:00 AM,48,-122,0,0,0
45122,FremontBridge,11/26/2017 02:00:00 AM,48,-122,0,1,1
45123,FremontBridge,11/26/2017 03:00:00 AM,48,-122,0,2,2
45124,FremontBridge,11/26/2017 04:00:00 AM,48,-122,2,1,3
45125,FremontBridge,11/26/2017 05:00:00 AM,48,-122,0,2,2
45126,FremontBridge,11/26/2017 06:00:00 AM,48,-122,7,2,9
45127,FremontBridge,11/26/2017 07:00:00 AM,48,-122,2,7,9
45128,FremontBridge,11/26/2017 08:00:00 AM,48,-122,8,9,17
45129,FremontBridge,11/26/2017 09:00:00 AM,48,-122,12,16,28
45130,FremontBridge,11/26/2017 10:00:00 AM,48,-122,29,26,55
45131,FremontBridge,11/26/2017 11:00:00 AM,48,-122,36,34,70
45132,FremontBridge,11/26/2017 12:00:00 PM,48,-122,25,25,50
45133,FremontBridge,11/26/2017 01:00:00 PM,48,-122,11,8,19
45134,FremontBridge,11/26/2017 02:00:00 PM,48,-122,17,15,32
45135,FremontBridge,11/26/2017 03:00:00 PM,48,-122,6,16,22
45136,FremontBridge,11/26/2017 04:00:00 PM,48,-122,17,16,33
45137,FremontBridge,11/26/2017 05:00:00 PM,48,-122,16,9,25
45138,FremontBridge,11/26/2017 06:00:00 PM,48,-122,8,9,17
45139,FremontBridge,11/26/2017 07:00:00 PM,48,-122,10,6,16
45140,FremontBridge,11/26/2017 08:00:00 PM,48,-122,5,5,10
45141,FremontBridge,11/26/2017 09:00:00 PM,48,-122,3,5,8
45142,FremontBridge,11/26/2017 10:00:00 PM,48,-122,2,2,4
45143,FremontBridge,11/26/2017 11:00:00 PM,48,-122,4,1,5
45144,FremontBridge,11/27/2017 12:00:00 AM,48,-122,1,0,1
45145,FremontBridge,11/27/2017 01:00:00 AM,48,-122,1,0,1
45146,FremontBridge,11/27/2017 02:00:00 AM,48,-122,1,0,1
45147,FremontBridge,11/27/2017 03:00:00 AM,48,-122,0,0,0
45148,FremontBridge,11/27/2017 04:00:00 AM,48,-122,5,3,8
45149,FremontBridge,11/27/2017 05:00:00 AM,48,-122,13,28,41
45150,FremontBridge,11/27/2017 06:00:00 AM,48,-122,59,65,124
45151,FremontBridge,11/27/2017 07:00:00 AM,48,-122,142,200,342
45152,FremontBridge,11/27/2017 08:00:00 AM,48,-122,235,258,493
45153,FremontBridge,11/27/2017 09:00:00 AM,48,-122,109,90,199
45154,FremontBridge,11/27/2017 10:00:00 AM,48,-122,53,45,98
45155,FremontBridge,11/27/2017 11:00:00 AM,48,-122,21,17,38
45156,FremontBridge,11/27/2017 12:00:00 PM,48,-122,30,27,57
45157,FremontBridge,11/27/2017 01:00:00 PM,48,-122,32,26,58
45158,FremontBridge,11/27/2017 02:00:00 PM,48,-122,47,27,74
45159,FremontBridge,11/27/2017 03:00:00 PM,48,-122,70,42,112
45160,FremontBridge,11/27/2017 04:00:00 PM,48,-122,215,73,288
45161,FremontBridge,11/27/2017 05:00:00 PM,48,-122,425,104,529
45162,FremontBridge,11/27/2017 06:00:00 PM,48,-122,246,93,339
45163,FremontBridge,11/27/2017 07:00:00 PM,48,-122,98,45,143
45164,FremontBridge,11/27/2017 08:00:00 PM,48,-122,45,21,66
45165,FremontBridge,11/27/2017 09:00:00 PM,48,-122,27,20,47
45166,FremontBridge,11/27/2017 10:00:00 PM,48,-122,15,5,20
45167,FremontBridge,11/27/2017 11:00:00 PM,48,-122,11,8,19
45168,FremontBridge,11/28/2017 12:00:00 AM,48,-122,5,0,5
45169,FremontBridge,11/28/2017 01:00:00 AM,48,-122,2,0,2
45170,FremontBridge,11/28/2017 02:00:00 AM,48,-122,3,1,4
45171,FremontBridge,11/28/2017 03:00:00 AM,48,-122,1,1,2
45172,FremontBridge,11/28/2017 04:00:00 AM,48,-122,4,5,9
45173,FremontBridge,11/28/2017 05:00:00 AM,48,-122,13,13,26
45174,FremontBridge,11/28/2017 06:00:00 AM,48,-122,48,48,96
45175,FremontBridge,11/28/2017 07:00:00 AM,48,-122,133,157,290
45176,FremontBridge,11/28/2017 08:00:00 AM,48,-122,178,183,361
45177,FremontBridge,11/28/2017 09:00:00 AM,48,-122,95,89,184
45178,FremontBridge,11/28/2017 10:00:00 AM,48,-122,35,26,61
45179,FremontBridge,11/28/2017 11:00:00 AM,48,-122,14,12,26
45180,FremontBridge,11/28/2017 12:00:00 PM,48,-122,18,18,36
45181,FremontBridge,11/28/2017 01:00:00 PM,48,-122,22,9,31
45182,FremontBridge,11/28/2017 02:00:00 PM,48,-122,18,21,39
45183,FremontBridge,11/28/2017 03:00:00 PM,48,-122,42,33,75
45184,FremontBridge,11/28/2017 04:00:00 PM,48,-122,135,49,184
45185,FremontBridge,11/28/2017 05:00:00 PM,48,-122,319,86,405
45186,FremontBridge,11/28/2017 06:00:00 PM,48,-122,224,60,284
45187,FremontBridge,11/28/2017 07:00:00 PM,48,-122,63,27,90
45188,FremontBridge,11/28/2017 08:00:00 PM,48,-122,38,14,52
45189,FremontBridge,11/28/2017 09:00:00 PM,48,-122,31,10,41
45190,FremontBridge,11/28/2017 10:00:00 PM,48,-122,14,8,22
45191,FremontBridge,11/28/2017 11:00:00 PM,48,-122,5,1,6
45192,FremontBridge,11/29/2017 12:00:00 AM,48,-122,5,2,7
45193,FremontBridge,11/29/2017 01:00:00 AM,48,-122,2,2,4
45194,FremontBridge,11/29/2017 02:00:00 AM,48,-122,3,2,5
45195,FremontBridge,11/29/2017 03:00:00 AM,48,-122,2,2,4
45196,FremontBridge,11/29/2017 04:00:00 AM,48,-122,6,2,8
45197,FremontBridge,11/29/2017 05:00:00 AM,48,-122,17,20,37
45198,FremontBridge,11/29/2017 06:00:00 AM,48,-122,56,78,134
45199,FremontBridge,11/29/2017 07:00:00 AM,48,-122,141,187,328
45200,FremontBridge,11/29/2017 08:00:00 AM,48,-122,192,239,431
45201,FremontBridge,11/29/2017 09:00:00 AM,48,-122,137,123,260
45202,FremontBridge,11/29/2017 10:00:00 AM,48,-122,51,35,86
45203,FremontBridge,11/29/2017 11:00:00 AM,48,-122,25,34,59
45204,FremontBridge,11/29/2017 12:00:00 PM,48,-122,44,21,65
45205,FremontBridge,11/29/2017 01:00:00 PM,48,-122,48,35,83
45206,FremontBridge,11/29/2017 02:00:00 PM,48,-122,44,40,84
45207,FremontBridge,11/29/2017 03:00:00 PM,48,-122,86,63,149
45208,FremontBridge,11/29/2017 04:00:00 PM,48,-122,196,81,277
45209,FremontBridge,11/29/2017 05:00:00 PM,48,-122,383,113,496
45210,FremontBridge,11/29/2017 06:00:00 PM,48,-122,223,88,311
45211,FremontBridge,11/29/2017 07:00:00 PM,48,-122,90,32,122
45212,FremontBridge,11/29/2017 08:00:00 PM,48,-122,56,35,91
45213,FremontBridge,11/29/2017 09:00:00 PM,48,-122,21,19,40
45214,FremontBridge,11/29/2017 10:00:00 PM,48,-122,14,5,19
45215,FremontBridge,11/29/2017 11:00:00 PM,48,-122,11,8,19
45216,FremontBridge,11/30/2017 12:00:00 AM,48,-122,11,2,13
45217,FremontBridge,11/30/2017 01:00:00 AM,48,-122,1,1,2
45218,FremontBridge,11/30/2017 02:00:00 AM,48,-122,1,1,2
45219,FremontBridge,11/30/2017 03:00:00 AM,48,-122,0,2,2
45220,FremontBridge,11/30/2017 04:00:00 AM,48,-122,5,4,9
45221,FremontBridge,11/30/2017 05:00:00 AM,48,-122,12,24,36
45222,FremontBridge,11/30/2017 06:00:00 AM,48,-122,44,53,97
45223,FremontBridge,11/30/2017 07:00:00 AM,48,-122,106,123,229
45224,FremontBridge,11/30/2017 08:00:00 AM,48,-122,124,162,286
45225,FremontBridge,11/30/2017 09:00:00 AM,48,-122,74,84,158
45226,FremontBridge,11/30/2017 10:00:00 AM,48,-122,27,28,55
45227,FremontBridge,11/30/2017 11:00:00 AM,48,-122,18,19,37
45228,FremontBridge,11/30/2017 12:00:00 PM,48,-122,19,17,36
45229,FremontBridge,11/30/2017 01:00:00 PM,48,-122,22,23,45
45230,FremontBridge,11/30/2017 02:00:00 PM,48,-122,23,26,49
45231,FremontBridge,11/30/2017 03:00:00 PM,48,-122,44,36,80
45232,FremontBridge,11/30/2017 04:00:00 PM,48,-122,131,58,189
45233,FremontBridge,11/30/2017 05:00:00 PM,48,-122,254,74,328
45234,FremontBridge,11/30/2017 06:00:00 PM,48,-122,150,50,200
45235,FremontBridge,11/30/2017 07:00:00 PM,48,-122,70,28,98
45236,FremontBridge,11/30/2017 08:00:00 PM,48,-122,31,16,47
45237,FremontBridge,11/30/2017 09:00:00 PM,48,-122,25,14,39
45238,FremontBridge,11/30/2017 10:00:00 PM,48,-122,16,12,28
45239,FremontBridge,11/30/2017 11:00:00 PM,48,-122,4,5,9
45240,FremontBridge,12/01/2017 12:00:00 AM,48,-122,7,4,11
45241,FremontBridge,12/01/2017 01:00:00 AM,48,-122,3,3,6
45242,FremontBridge,12/01/2017 02:00:00 AM,48,-122,5,1,6
45243,FremontBridge,12/01/2017 03:00:00 AM,48,-122,1,3,4
45244,FremontBridge,12/01/2017 04:00:00 AM,48,-122,2,2,4
45245,FremontBridge,12/01/2017 05:00:00 AM,48,-122,10,20,30
45246,FremontBridge,12/01/2017 06:00:00 AM,48,-122,36,38,74
45247,FremontBridge,12/01/2017 07:00:00 AM,48,-122,94,118,212
45248,FremontBridge,12/01/2017 08:00:00 AM,48,-122,151,193,344
45249,FremontBridge,12/01/2017 09:00:00 AM,48,-122,106,96,202
45250,FremontBridge,12/01/2017 10:00:00 AM,48,-122,40,43,83
45251,FremontBridge,12/01/2017 11:00:00 AM,48,-122,39,33,72
45252,FremontBridge,12/01/2017 12:00:00 PM,48,-122,32,21,53
45253,FremontBridge,12/01/2017 01:00:00 PM,48,-122,37,26,63
45254,FremontBridge,12/01/2017 02:00:00 PM,48,-122,32,13,45
45255,FremontBridge,12/01/2017 03:00:00 PM,48,-122,52,26,78
45256,FremontBridge,12/01/2017 04:00:00 PM,48,-122,139,49,188
45257,FremontBridge,12/01/2017 05:00:00 PM,48,-122,315,85,400
45258,FremontBridge,12/01/2017 06:00:00 PM,48,-122,134,44,178
45259,FremontBridge,12/01/2017 07:00:00 PM,48,-122,53,20,73
45260,FremontBridge,12/01/2017 08:00:00 PM,48,-122,23,7,30
45261,FremontBridge,12/01/2017 09:00:00 PM,48,-122,19,11,30
45262,FremontBridge,12/01/2017 10:00:00 PM,48,-122,11,9,20
45263,FremontBridge,12/01/2017 11:00:00 PM,48,-122,6,9,15
45264,FremontBridge,12/02/2017 12:00:00 AM,48,-122,10,5,15
45265,FremontBridge,12/02/2017 01:00:00 AM,48,-122,12,3,15
45266,FremontBridge,12/02/2017 02:00:00 AM,48,-122,1,1,2
45267,FremontBridge,12/02/2017 03:00:00 AM,48,-122,0,2,2
45268,FremontBridge,12/02/2017 04:00:00 AM,48,-122,1,0,1
45269,FremontBridge,12/02/2017 05:00:00 AM,48,-122,1,1,2
45270,FremontBridge,12/02/2017 06:00:00 AM,48,-122,1,10,11
45271,FremontBridge,12/02/2017 07:00:00 AM,48,-122,5,5,10
45272,FremontBridge,12/02/2017 08:00:00 AM,48,-122,18,16,34
45273,FremontBridge,12/02/2017 09:00:00 AM,48,-122,16,15,31
45274,FremontBridge,12/02/2017 10:00:00 AM,48,-122,7,16,23
45275,FremontBridge,12/02/2017 11:00:00 AM,48,-122,11,18,29
45276,FremontBridge,12/02/2017 12:00:00 PM,48,-122,10,17,27
45277,FremontBridge,12/02/2017 01:00:00 PM,48,-122,15,13,28
45278,FremontBridge,12/02/2017 02:00:00 PM,48,-122,14,6,20
45279,FremontBridge,12/02/2017 03:00:00 PM,48,-122,10,16,26
45280,FremontBridge,12/02/2017 04:00:00 PM,48,-122,9,7,16
45281,FremontBridge,12/02/2017 05:00:00 PM,48,-122,17,5,22
45282,FremontBridge,12/02/2017 06:00:00 PM,48,-122,7,20,27
45283,FremontBridge,12/02/2017 07:00:00 PM,48,-122,8,5,13
45284,FremontBridge,12/02/2017 08:00:00 PM,48,-122,2,3,5
45285,FremontBridge,12/02/2017 09:00:00 PM,48,-122,3,3,6
45286,FremontBridge,12/02/2017 10:00:00 PM,48,-122,7,3,10
45287,FremontBridge,12/02/2017 11:00:00 PM,48,-122,5,3,8
45288,FremontBridge,12/03/2017 12:00:00 AM,48,-122,4,1,5
45289,FremontBridge,12/03/2017 01:00:00 AM,48,-122,1,2,3
45290,FremontBridge,12/03/2017 02:00:00 AM,48,-122,0,3,3
45291,FremontBridge,12/03/2017 03:00:00 AM,48,-122,2,4,6
45292,FremontBridge,12/03/2017 04:00:00 AM,48,-122,2,2,4
45293,FremontBridge,12/03/2017 05:00:00 AM,48,-122,2,1,3
45294,FremontBridge,12/03/2017 06:00:00 AM,48,-122,3,5,8
45295,FremontBridge,12/03/2017 07:00:00 AM,48,-122,7,7,14
45296,FremontBridge,12/03/2017 08:00:00 AM,48,-122,18,26,44
45297,FremontBridge,12/03/2017 09:00:00 AM,48,-122,19,21,40
45298,FremontBridge,12/03/2017 10:00:00 AM,48,-122,31,41,72
45299,FremontBridge,12/03/2017 11:00:00 AM,48,-122,47,56,103
45300,FremontBridge,12/03/2017 12:00:00 PM,48,-122,31,37,68
45301,FremontBridge,12/03/2017 01:00:00 PM,48,-122,48,49,97
45302,FremontBridge,12/03/2017 02:00:00 PM,48,-122,36,48,84
45303,FremontBridge,12/03/2017 03:00:00 PM,48,-122,45,36,81
45304,FremontBridge,12/03/2017 04:00:00 PM,48,-122,30,26,56
45305,FremontBridge,12/03/2017 05:00:00 PM,48,-122,15,12,27
45306,FremontBridge,12/03/2017 06:00:00 PM,48,-122,12,6,18
45307,FremontBridge,12/03/2017 07:00:00 PM,48,-122,12,10,22
45308,FremontBridge,12/03/2017 08:00:00 PM,48,-122,10,1,11
45309,FremontBridge,12/03/2017 09:00:00 PM,48,-122,9,0,9
45310,FremontBridge,12/03/2017 10:00:00 PM,48,-122,6,5,11
45311,FremontBridge,12/03/2017 11:00:00 PM,48,-122,2,6,8
45312,FremontBridge,12/04/2017 12:00:00 AM,48,-122,4,0,4
45313,FremontBridge,12/04/2017 01:00:00 AM,48,-122,1,0,1
45314,FremontBridge,12/04/2017 02:00:00 AM,48,-122,0,0,0
45315,FremontBridge,12/04/2017 03:00:00 AM,48,-122,2,0,2
45316,FremontBridge,12/04/2017 04:00:00 AM,48,-122,6,3,9
45317,FremontBridge,12/04/2017 05:00:00 AM,48,-122,19,26,45
45318,FremontBridge,12/04/2017 06:00:00 AM,48,-122,41,55,96
45319,FremontBridge,12/04/2017 07:00:00 AM,48,-122,112,157,269
45320,FremontBridge,12/04/2017 08:00:00 AM,48,-122,196,245,441
45321,FremontBridge,12/04/2017 09:00:00 AM,48,-122,125,122,247
45322,FremontBridge,12/04/2017 10:00:00 AM,48,-122,47,43,90
45323,FremontBridge,12/04/2017 11:00:00 AM,48,-122,27,25,52
45324,FremontBridge,12/04/2017 12:00:00 PM,48,-122,31,28,59
45325,FremontBridge,12/04/2017 01:00:00 PM,48,-122,36,33,69
45326,FremontBridge,12/04/2017 02:00:00 PM,48,-122,48,23,71
45327,FremontBridge,12/04/2017 03:00:00 PM,48,-122,72,40,112
45328,FremontBridge,12/04/2017 04:00:00 PM,48,-122,172,56,228
45329,FremontBridge,12/04/2017 05:00:00 PM,48,-122,391,110,501
45330,FremontBridge,12/04/2017 06:00:00 PM,48,-122,245,89,334
45331,FremontBridge,12/04/2017 07:00:00 PM,48,-122,118,40,158
45332,FremontBridge,12/04/2017 08:00:00 PM,48,-122,41,16,57
45333,FremontBridge,12/04/2017 09:00:00 PM,48,-122,18,12,30
45334,FremontBridge,12/04/2017 10:00:00 PM,48,-122,18,9,27
45335,FremontBridge,12/04/2017 11:00:00 PM,48,-122,8,3,11
45336,FremontBridge,12/05/2017 12:00:00 AM,48,-122,2,1,3
45337,FremontBridge,12/05/2017 01:00:00 AM,48,-122,4,2,6
45338,FremontBridge,12/05/2017 02:00:00 AM,48,-122,2,2,4
45339,FremontBridge,12/05/2017 03:00:00 AM,48,-122,1,2,3
45340,FremontBridge,12/05/2017 04:00:00 AM,48,-122,6,3,9
45341,FremontBridge,12/05/2017 05:00:00 AM,48,-122,13,21,34
45342,FremontBridge,12/05/2017 06:00:00 AM,48,-122,51,65,116
45343,FremontBridge,12/05/2017 07:00:00 AM,48,-122,124,161,285
45344,FremontBridge,12/05/2017 08:00:00 AM,48,-122,199,215,414
45345,FremontBridge,12/05/2017 09:00:00 AM,48,-122,126,122,248
45346,FremontBridge,12/05/2017 10:00:00 AM,48,-122,46,47,93
45347,FremontBridge,12/05/2017 11:00:00 AM,48,-122,24,40,64
45348,FremontBridge,12/05/2017 12:00:00 PM,48,-122,29,34,63
45349,FremontBridge,12/05/2017 01:00:00 PM,48,-122,25,36,61
45350,FremontBridge,12/05/2017 02:00:00 PM,48,-122,50,41,91
45351,FremontBridge,12/05/2017 03:00:00 PM,48,-122,67,58,125
45352,FremontBridge,12/05/2017 04:00:00 PM,48,-122,169,70,239
45353,FremontBridge,12/05/2017 05:00:00 PM,48,-122,376,109,485
45354,FremontBridge,12/05/2017 06:00:00 PM,48,-122,231,92,323
45355,FremontBridge,12/05/2017 07:00:00 PM,48,-122,81,38,119
45356,FremontBridge,12/05/2017 08:00:00 PM,48,-122,46,22,68
45357,FremontBridge,12/05/2017 09:00:00 PM,48,-122,34,14,48
45358,FremontBridge,12/05/2017 10:00:00 PM,48,-122,18,15,33
45359,FremontBridge,12/05/2017 11:00:00 PM,48,-122,11,4,15
45360,FremontBridge,12/06/2017 12:00:00 AM,48,-122,5,1,6
45361,FremontBridge,12/06/2017 01:00:00 AM,48,-122,1,0,1
45362,FremontBridge,12/06/2017 02:00:00 AM,48,-122,2,1,3
45363,FremontBridge,12/06/2017 03:00:00 AM,48,-122,1,1,2
45364,FremontBridge,12/06/2017 04:00:00 AM,48,-122,4,3,7
45365,FremontBridge,12/06/2017 05:00:00 AM,48,-122,13,22,35
45366,FremontBridge,12/06/2017 06:00:00 AM,48,-122,40,58,98
45367,FremontBridge,12/06/2017 07:00:00 AM,48,-122,149,170,319
45368,FremontBridge,12/06/2017 08:00:00 AM,48,-122,190,206,396
45369,FremontBridge,12/06/2017 09:00:00 AM,48,-122,120,110,230
45370,FremontBridge,12/06/2017 10:00:00 AM,48,-122,59,54,113
45371,FremontBridge,12/06/2017 11:00:00 AM,48,-122,33,28,61
45372,FremontBridge,12/06/2017 12:00:00 PM,48,-122,36,34,70
45373,FremontBridge,12/06/2017 01:00:00 PM,48,-122,45,50,95
45374,FremontBridge,12/06/2017 02:00:00 PM,48,-122,46,41,87
45375,FremontBridge,12/06/2017 03:00:00 PM,48,-122,69,51,120
45376,FremontBridge,12/06/2017 04:00:00 PM,48,-122,181,77,258
45377,FremontBridge,12/06/2017 05:00:00 PM,48,-122,317,103,420
45378,FremontBridge,12/06/2017 06:00:00 PM,48,-122,206,81,287
45379,FremontBridge,12/06/2017 07:00:00 PM,48,-122,99,23,122
45380,FremontBridge,12/06/2017 08:00:00 PM,48,-122,58,17,75
45381,FremontBridge,12/06/2017 09:00:00 PM,48,-122,40,14,54
45382,FremontBridge,12/06/2017 10:00:00 PM,48,-122,21,10,31
45383,FremontBridge,12/06/2017 11:00:00 PM,48,-122,9,3,12
45384,FremontBridge,12/07/2017 12:00:00 AM,48,-122,6,5,11
45385,FremontBridge,12/07/2017 01:00:00 AM,48,-122,5,4,9
45386,FremontBridge,12/07/2017 02:00:00 AM,48,-122,1,2,3
45387,FremontBridge,12/07/2017 03:00:00 AM,48,-122,0,2,2
45388,FremontBridge,12/07/2017 04:00:00 AM,48,-122,4,3,7
45389,FremontBridge,12/07/2017 05:00:00 AM,48,-122,13,19,32
45390,FremontBridge,12/07/2017 06:00:00 AM,48,-122,32,55,87
45391,FremontBridge,12/07/2017 07:00:00 AM,48,-122,109,145,254
45392,FremontBridge,12/07/2017 08:00:00 AM,48,-122,196,193,389
45393,FremontBridge,12/07/2017 09:00:00 AM,48,-122,109,85,194
45394,FremontBridge,12/07/2017 10:00:00 AM,48,-122,48,47,95
45395,FremontBridge,12/07/2017 11:00:00 AM,48,-122,28,45,73
45396,FremontBridge,12/07/2017 12:00:00 PM,48,-122,34,30,64
45397,FremontBridge,12/07/2017 01:00:00 PM,48,-122,43,46,89
45398,FremontBridge,12/07/2017 02:00:00 PM,48,-122,38,40,78
45399,FremontBridge,12/07/2017 03:00:00 PM,48,-122,78,46,124
45400,FremontBridge,12/07/2017 04:00:00 PM,48,-122,156,87,243
45401,FremontBridge,12/07/2017 05:00:00 PM,48,-122,291,94,385
45402,FremontBridge,12/07/2017 06:00:00 PM,48,-122,209,62,271
45403,FremontBridge,12/07/2017 07:00:00 PM,48,-122,90,31,121
45404,FremontBridge,12/07/2017 08:00:00 PM,48,-122,45,15,60
45405,FremontBridge,12/07/2017 09:00:00 PM,48,-122,36,15,51
45406,FremontBridge,12/07/2017 10:00:00 PM,48,-122,23,8,31
45407,FremontBridge,12/07/2017 11:00:00 PM,48,-122,13,4,17
45408,FremontBridge,12/08/2017 12:00:00 AM,48,-122,4,3,7
45409,FremontBridge,12/08/2017 01:00:00 AM,48,-122,0,1,1
45410,FremontBridge,12/08/2017 02:00:00 AM,48,-122,1,3,4
45411,FremontBridge,12/08/2017 03:00:00 AM,48,-122,3,1,4
45412,FremontBridge,12/08/2017 04:00:00 AM,48,-122,4,3,7
45413,FremontBridge,12/08/2017 05:00:00 AM,48,-122,11,14,25
45414,FremontBridge,12/08/2017 06:00:00 AM,48,-122,28,28,56
45415,FremontBridge,12/08/2017 07:00:00 AM,48,-122,74,96,170
45416,FremontBridge,12/08/2017 08:00:00 AM,48,-122,138,158,296
45417,FremontBridge,12/08/2017 09:00:00 AM,48,-122,98,66,164
45418,FremontBridge,12/08/2017 10:00:00 AM,48,-122,46,42,88
45419,FremontBridge,12/08/2017 11:00:00 AM,48,-122,38,30,68
45420,FremontBridge,12/08/2017 12:00:00 PM,48,-122,32,22,54
45421,FremontBridge,12/08/2017 01:00:00 PM,48,-122,35,32,67
45422,FremontBridge,12/08/2017 02:00:00 PM,48,-122,41,39,80
45423,FremontBridge,12/08/2017 03:00:00 PM,48,-122,68,38,106
45424,FremontBridge,12/08/2017 04:00:00 PM,48,-122,163,61,224
45425,FremontBridge,12/08/2017 05:00:00 PM,48,-122,237,73,310
45426,FremontBridge,12/08/2017 06:00:00 PM,48,-122,148,39,187
45427,FremontBridge,12/08/2017 07:00:00 PM,48,-122,47,15,62
45428,FremontBridge,12/08/2017 08:00:00 PM,48,-122,25,16,41
45429,FremontBridge,12/08/2017 09:00:00 PM,48,-122,17,8,25
45430,FremontBridge,12/08/2017 10:00:00 PM,48,-122,10,3,13
45431,FremontBridge,12/08/2017 11:00:00 PM,48,-122,12,9,21
45432,FremontBridge,12/09/2017 12:00:00 AM,48,-122,13,5,18
45433,FremontBridge,12/09/2017 01:00:00 AM,48,-122,1,2,3
45434,FremontBridge,12/09/2017 02:00:00 AM,48,-122,1,2,3
45435,FremontBridge,12/09/2017 03:00:00 AM,48,-122,4,2,6
45436,FremontBridge,12/09/2017 04:00:00 AM,48,-122,2,4,6
45437,FremontBridge,12/09/2017 05:00:00 AM,48,-122,2,3,5
45438,FremontBridge,12/09/2017 06:00:00 AM,48,-122,3,4,7
45439,FremontBridge,12/09/2017 07:00:00 AM,48,-122,6,9,15
45440,FremontBridge,12/09/2017 08:00:00 AM,48,-122,15,15,30
45441,FremontBridge,12/09/2017 09:00:00 AM,48,-122,14,23,37
45442,FremontBridge,12/09/2017 10:00:00 AM,48,-122,23,21,44
45443,FremontBridge,12/09/2017 11:00:00 AM,48,-122,30,31,61
45444,FremontBridge,12/09/2017 12:00:00 PM,48,-122,40,45,85
45445,FremontBridge,12/09/2017 01:00:00 PM,48,-122,43,37,80
45446,FremontBridge,12/09/2017 02:00:00 PM,48,-122,51,44,95
45447,FremontBridge,12/09/2017 03:00:00 PM,48,-122,45,56,101
45448,FremontBridge,12/09/2017 04:00:00 PM,48,-122,38,28,66
45449,FremontBridge,12/09/2017 05:00:00 PM,48,-122,22,17,39
45450,FremontBridge,12/09/2017 06:00:00 PM,48,-122,17,10,27
45451,FremontBridge,12/09/2017 07:00:00 PM,48,-122,16,7,23
45452,FremontBridge,12/09/2017 08:00:00 PM,48,-122,8,4,12
45453,FremontBridge,12/09/2017 09:00:00 PM,48,-122,6,6,12
45454,FremontBridge,12/09/2017 10:00:00 PM,48,-122,13,6,19
45455,FremontBridge,12/09/2017 11:00:00 PM,48,-122,13,3,16
45456,FremontBridge,12/10/2017 12:00:00 AM,48,-122,6,5,11
45457,FremontBridge,12/10/2017 01:00:00 AM,48,-122,7,5,12
45458,FremontBridge,12/10/2017 02:00:00 AM,48,-122,1,2,3
45459,FremontBridge,12/10/2017 03:00:00 AM,48,-122,0,0,0
45460,FremontBridge,12/10/2017 04:00:00 AM,48,-122,3,2,5
45461,FremontBridge,12/10/2017 05:00:00 AM,48,-122,1,3,4
45462,FremontBridge,12/10/2017 06:00:00 AM,48,-122,3,1,4
45463,FremontBridge,12/10/2017 07:00:00 AM,48,-122,8,10,18
45464,FremontBridge,12/10/2017 08:00:00 AM,48,-122,10,14,24
45465,FremontBridge,12/10/2017 09:00:00 AM,48,-122,19,9,28
45466,FremontBridge,12/10/2017 10:00:00 AM,48,-122,24,22,46
45467,FremontBridge,12/10/2017 11:00:00 AM,48,-122,42,49,91
45468,FremontBridge,12/10/2017 12:00:00 PM,48,-122,37,41,78
45469,FremontBridge,12/10/2017 01:00:00 PM,48,-122,49,66,115
45470,FremontBridge,12/10/2017 02:00:00 PM,48,-122,57,64,121
45471,FremontBridge,12/10/2017 03:00:00 PM,48,-122,61,64,125
45472,FremontBridge,12/10/2017 04:00:00 PM,48,-122,34,37,71
45473,FremontBridge,12/10/2017 05:00:00 PM,48,-122,20,15,35
45474,FremontBridge,12/10/2017 06:00:00 PM,48,-122,22,19,41
45475,FremontBridge,12/10/2017 07:00:00 PM,48,-122,14,8,22
45476,FremontBridge,12/10/2017 08:00:00 PM,48,-122,7,4,11
45477,FremontBridge,12/10/2017 09:00:00 PM,48,-122,6,11,17
45478,FremontBridge,12/10/2017 10:00:00 PM,48,-122,7,2,9
45479,FremontBridge,12/10/2017 11:00:00 PM,48,-122,4,2,6
45480,FremontBridge,12/11/2017 12:00:00 AM,48,-122,5,0,5
45481,FremontBridge,12/11/2017 01:00:00 AM,48,-122,0,0,0
45482,FremontBridge,12/11/2017 02:00:00 AM,48,-122,0,1,1
45483,FremontBridge,12/11/2017 03:00:00 AM,48,-122,1,0,1
45484,FremontBridge,12/11/2017 04:00:00 AM,48,-122,5,3,8
45485,FremontBridge,12/11/2017 05:00:00 AM,48,-122,13,15,28
45486,FremontBridge,12/11/2017 06:00:00 AM,48,-122,44,47,91
45487,FremontBridge,12/11/2017 07:00:00 AM,48,-122,105,114,219
45488,FremontBridge,12/11/2017 08:00:00 AM,48,-122,166,197,363
45489,FremontBridge,12/11/2017 09:00:00 AM,48,-122,116,91,207
45490,FremontBridge,12/11/2017 10:00:00 AM,48,-122,42,26,68
45491,FremontBridge,12/11/2017 11:00:00 AM,48,-122,27,23,50
45492,FremontBridge,12/11/2017 12:00:00 PM,48,-122,35,29,64
45493,FremontBridge,12/11/2017 01:00:00 PM,48,-122,22,25,47
45494,FremontBridge,12/11/2017 02:00:00 PM,48,-122,42,26,68
45495,FremontBridge,12/11/2017 03:00:00 PM,48,-122,62,34,96
45496,FremontBridge,12/11/2017 04:00:00 PM,48,-122,163,57,220
45497,FremontBridge,12/11/2017 05:00:00 PM,48,-122,319,81,400
45498,FremontBridge,12/11/2017 06:00:00 PM,48,-122,188,62,250
45499,FremontBridge,12/11/2017 07:00:00 PM,48,-122,75,28,103
45500,FremontBridge,12/11/2017 08:00:00 PM,48,-122,36,15,51
45501,FremontBridge,12/11/2017 09:00:00 PM,48,-122,29,10,39
45502,FremontBridge,12/11/2017 10:00:00 PM,48,-122,17,4,21
45503,FremontBridge,12/11/2017 11:00:00 PM,48,-122,5,5,10
45504,FremontBridge,12/12/2017 12:00:00 AM,48,-122,2,1,3
45505,FremontBridge,12/12/2017 01:00:00 AM,48,-122,1,1,2
45506,FremontBridge,12/12/2017 02:00:00 AM,48,-122,2,0,2
45507,FremontBridge,12/12/2017 03:00:00 AM,48,-122,2,2,4
45508,FremontBridge,12/12/2017 04:00:00 AM,48,-122,7,5,12
45509,FremontBridge,12/12/2017 05:00:00 AM,48,-122,12,20,32
45510,FremontBridge,12/12/2017 06:00:00 AM,48,-122,43,55,98
45511,FremontBridge,12/12/2017 07:00:00 AM,48,-122,113,141,254
45512,FremontBridge,12/12/2017 08:00:00 AM,48,-122,182,209,391
45513,FremontBridge,12/12/2017 09:00:00 AM,48,-122,108,106,214
45514,FremontBridge,12/12/2017 10:00:00 AM,48,-122,63,44,107
45515,FremontBridge,12/12/2017 11:00:00 AM,48,-122,27,29,56
45516,FremontBridge,12/12/2017 12:00:00 PM,48,-122,25,30,55
45517,FremontBridge,12/12/2017 01:00:00 PM,48,-122,36,35,71
45518,FremontBridge,12/12/2017 02:00:00 PM,48,-122,33,15,48
45519,FremontBridge,12/12/2017 03:00:00 PM,48,-122,70,48,118
45520,FremontBridge,12/12/2017 04:00:00 PM,48,-122,151,66,217
45521,FremontBridge,12/12/2017 05:00:00 PM,48,-122,331,69,400
45522,FremontBridge,12/12/2017 06:00:00 PM,48,-122,195,85,280
45523,FremontBridge,12/12/2017 07:00:00 PM,48,-122,111,37,148
45524,FremontBridge,12/12/2017 08:00:00 PM,48,-122,40,27,67
45525,FremontBridge,12/12/2017 09:00:00 PM,48,-122,22,13,35
45526,FremontBridge,12/12/2017 10:00:00 PM,48,-122,13,10,23
45527,FremontBridge,12/12/2017 11:00:00 PM,48,-122,5,3,8
45528,FremontBridge,12/13/2017 12:00:00 AM,48,-122,5,0,5
45529,FremontBridge,12/13/2017 01:00:00 AM,48,-122,2,1,3
45530,FremontBridge,12/13/2017 02:00:00 AM,48,-122,1,2,3
45531,FremontBridge,12/13/2017 03:00:00 AM,48,-122,2,1,3
45532,FremontBridge,12/13/2017 04:00:00 AM,48,-122,4,3,7
45533,FremontBridge,12/13/2017 05:00:00 AM,48,-122,10,22,32
45534,FremontBridge,12/13/2017 06:00:00 AM,48,-122,42,50,92
45535,FremontBridge,12/13/2017 07:00:00 AM,48,-122,127,147,274
45536,FremontBridge,12/13/2017 08:00:00 AM,48,-122,166,226,392
45537,FremontBridge,12/13/2017 09:00:00 AM,48,-122,138,102,240
45538,FremontBridge,12/13/2017 10:00:00 AM,48,-122,54,41,95
45539,FremontBridge,12/13/2017 11:00:00 AM,48,-122,22,32,54
45540,FremontBridge,12/13/2017 12:00:00 PM,48,-122,31,29,60
45541,FremontBridge,12/13/2017 01:00:00 PM,48,-122,45,24,69
45542,FremontBridge,12/13/2017 02:00:00 PM,48,-122,60,40,100
45543,FremontBridge,12/13/2017 03:00:00 PM,48,-122,76,39,115
45544,FremontBridge,12/13/2017 04:00:00 PM,48,-122,156,63,219
45545,FremontBridge,12/13/2017 05:00:00 PM,48,-122,330,89,419
45546,FremontBridge,12/13/2017 06:00:00 PM,48,-122,195,85,280
45547,FremontBridge,12/13/2017 07:00:00 PM,48,-122,97,33,130
45548,FremontBridge,12/13/2017 08:00:00 PM,48,-122,49,13,62
45549,FremontBridge,12/13/2017 09:00:00 PM,48,-122,36,13,49
45550,FremontBridge,12/13/2017 10:00:00 PM,48,-122,12,9,21
45551,FremontBridge,12/13/2017 11:00:00 PM,48,-122,13,4,17
45552,FremontBridge,12/14/2017 12:00:00 AM,48,-122,7,0,7
45553,FremontBridge,12/14/2017 01:00:00 AM,48,-122,0,4,4
45554,FremontBridge,12/14/2017 02:00:00 AM,48,-122,1,2,3
45555,FremontBridge,12/14/2017 03:00:00 AM,48,-122,1,2,3
45556,FremontBridge,12/14/2017 04:00:00 AM,48,-122,2,1,3
45557,FremontBridge,12/14/2017 05:00:00 AM,48,-122,18,18,36
45558,FremontBridge,12/14/2017 06:00:00 AM,48,-122,46,51,97
45559,FremontBridge,12/14/2017 07:00:00 AM,48,-122,106,147,253
45560,FremontBridge,12/14/2017 08:00:00 AM,48,-122,179,194,373
45561,FremontBridge,12/14/2017 09:00:00 AM,48,-122,112,92,204
45562,FremontBridge,12/14/2017 10:00:00 AM,48,-122,45,52,97
45563,FremontBridge,12/14/2017 11:00:00 AM,48,-122,30,28,58
45564,FremontBridge,12/14/2017 12:00:00 PM,48,-122,24,20,44
45565,FremontBridge,12/14/2017 01:00:00 PM,48,-122,38,26,64
45566,FremontBridge,12/14/2017 02:00:00 PM,48,-122,44,41,85
45567,FremontBridge,12/14/2017 03:00:00 PM,48,-122,65,45,110
45568,FremontBridge,12/14/2017 04:00:00 PM,48,-122,174,64,238
45569,FremontBridge,12/14/2017 05:00:00 PM,48,-122,301,105,406
45570,FremontBridge,12/14/2017 06:00:00 PM,48,-122,178,61,239
45571,FremontBridge,12/14/2017 07:00:00 PM,48,-122,68,36,104
45572,FremontBridge,12/14/2017 08:00:00 PM,48,-122,39,13,52
45573,FremontBridge,12/14/2017 09:00:00 PM,48,-122,31,13,44
45574,FremontBridge,12/14/2017 10:00:00 PM,48,-122,20,9,29
45575,FremontBridge,12/14/2017 11:00:00 PM,48,-122,8,8,16
45576,FremontBridge,12/15/2017 12:00:00 AM,48,-122,4,5,9
45577,FremontBridge,12/15/2017 01:00:00 AM,48,-122,7,3,10
45578,FremontBridge,12/15/2017 02:00:00 AM,48,-122,1,2,3
45579,FremontBridge,12/15/2017 03:00:00 AM,48,-122,4,0,4
45580,FremontBridge,12/15/2017 04:00:00 AM,48,-122,4,2,6
45581,FremontBridge,12/15/2017 05:00:00 AM,48,-122,13,14,27
45582,FremontBridge,12/15/2017 06:00:00 AM,48,-122,23,39,62
45583,FremontBridge,12/15/2017 07:00:00 AM,48,-122,85,106,191
45584,FremontBridge,12/15/2017 08:00:00 AM,48,-122,134,164,298
45585,FremontBridge,12/15/2017 09:00:00 AM,48,-122,76,78,154
45586,FremontBridge,12/15/2017 10:00:00 AM,48,-122,49,38,87
45587,FremontBridge,12/15/2017 11:00:00 AM,48,-122,32,24,56
45588,FremontBridge,12/15/2017 12:00:00 PM,48,-122,28,27,55
45589,FremontBridge,12/15/2017 01:00:00 PM,48,-122,34,18,52
45590,FremontBridge,12/15/2017 02:00:00 PM,48,-122,42,20,62
45591,FremontBridge,12/15/2017 03:00:00 PM,48,-122,49,31,80
45592,FremontBridge,12/15/2017 04:00:00 PM,48,-122,143,46,189
45593,FremontBridge,12/15/2017 05:00:00 PM,48,-122,228,68,296
45594,FremontBridge,12/15/2017 06:00:00 PM,48,-122,103,49,152
45595,FremontBridge,12/15/2017 07:00:00 PM,48,-122,50,20,70
45596,FremontBridge,12/15/2017 08:00:00 PM,48,-122,4,9,13
45597,FremontBridge,12/15/2017 09:00:00 PM,48,-122,14,14,28
45598,FremontBridge,12/15/2017 10:00:00 PM,48,-122,7,12,19
45599,FremontBridge,12/15/2017 11:00:00 PM,48,-122,8,11,19
45600,FremontBridge,12/16/2017 12:00:00 AM,48,-122,3,5,8
45601,FremontBridge,12/16/2017 01:00:00 AM,48,-122,3,3,6
45602,FremontBridge,12/16/2017 02:00:00 AM,48,-122,2,4,6
45603,FremontBridge,12/16/2017 03:00:00 AM,48,-122,1,0,1
45604,FremontBridge,12/16/2017 04:00:00 AM,48,-122,2,2,4
45605,FremontBridge,12/16/2017 05:00:00 AM,48,-122,3,5,8
45606,FremontBridge,12/16/2017 06:00:00 AM,48,-122,4,6,10
45607,FremontBridge,12/16/2017 07:00:00 AM,48,-122,9,11,20
45608,FremontBridge,12/16/2017 08:00:00 AM,48,-122,26,14,40
45609,FremontBridge,12/16/2017 09:00:00 AM,48,-122,19,19,38
45610,FremontBridge,12/16/2017 10:00:00 AM,48,-122,20,24,44
45611,FremontBridge,12/16/2017 11:00:00 AM,48,-122,37,46,83
45612,FremontBridge,12/16/2017 12:00:00 PM,48,-122,31,48,79
45613,FremontBridge,12/16/2017 01:00:00 PM,48,-122,37,41,78
45614,FremontBridge,12/16/2017 02:00:00 PM,48,-122,52,39,91
45615,FremontBridge,12/16/2017 03:00:00 PM,48,-122,32,35,67
45616,FremontBridge,12/16/2017 04:00:00 PM,48,-122,32,25,57
45617,FremontBridge,12/16/2017 05:00:00 PM,48,-122,25,28,53
45618,FremontBridge,12/16/2017 06:00:00 PM,48,-122,14,19,33
45619,FremontBridge,12/16/2017 07:00:00 PM,48,-122,17,13,30
45620,FremontBridge,12/16/2017 08:00:00 PM,48,-122,15,6,21
45621,FremontBridge,12/16/2017 09:00:00 PM,48,-122,9,5,14
45622,FremontBridge,12/16/2017 10:00:00 PM,48,-122,0,2,2
45623,FremontBridge,12/16/2017 11:00:00 PM,48,-122,7,6,13
45624,FremontBridge,12/17/2017 12:00:00 AM,48,-122,3,0,3
45625,FremontBridge,12/17/2017 01:00:00 AM,48,-122,1,1,2
45626,FremontBridge,12/17/2017 02:00:00 AM,48,-122,2,8,10
45627,FremontBridge,12/17/2017 03:00:00 AM,48,-122,0,1,1
45628,FremontBridge,12/17/2017 04:00:00 AM,48,-122,1,2,3
45629,FremontBridge,12/17/2017 05:00:00 AM,48,-122,1,4,5
45630,FremontBridge,12/17/2017 06:00:00 AM,48,-122,2,2,4
45631,FremontBridge,12/17/2017 07:00:00 AM,48,-122,3,4,7
45632,FremontBridge,12/17/2017 08:00:00 AM,48,-122,7,11,18
45633,FremontBridge,12/17/2017 09:00:00 AM,48,-122,11,16,27
45634,FremontBridge,12/17/2017 10:00:00 AM,48,-122,16,27,43
45635,FremontBridge,12/17/2017 11:00:00 AM,48,-122,17,26,43
45636,FremontBridge,12/17/2017 12:00:00 PM,48,-122,21,23,44
45637,FremontBridge,12/17/2017 01:00:00 PM,48,-122,25,27,52
45638,FremontBridge,12/17/2017 02:00:00 PM,48,-122,21,25,46
45639,FremontBridge,12/17/2017 03:00:00 PM,48,-122,16,14,30
45640,FremontBridge,12/17/2017 04:00:00 PM,48,-122,16,16,32
45641,FremontBridge,12/17/2017 05:00:00 PM,48,-122,18,12,30
45642,FremontBridge,12/17/2017 06:00:00 PM,48,-122,14,8,22
45643,FremontBridge,12/17/2017 07:00:00 PM,48,-122,9,10,19
45644,FremontBridge,12/17/2017 08:00:00 PM,48,-122,5,3,8
45645,FremontBridge,12/17/2017 09:00:00 PM,48,-122,6,4,10
45646,FremontBridge,12/17/2017 10:00:00 PM,48,-122,3,2,5
45647,FremontBridge,12/17/2017 11:00:00 PM,48,-122,5,0,5
45648,FremontBridge,12/18/2017 12:00:00 AM,48,-122,0,1,1
45649,FremontBridge,12/18/2017 01:00:00 AM,48,-122,1,1,2
45650,FremontBridge,12/18/2017 02:00:00 AM,48,-122,0,1,1
45651,FremontBridge,12/18/2017 03:00:00 AM,48,-122,2,1,3
45652,FremontBridge,12/18/2017 04:00:00 AM,48,-122,4,2,6
45653,FremontBridge,12/18/2017 05:00:00 AM,48,-122,6,14,20
45654,FremontBridge,12/18/2017 06:00:00 AM,48,-122,33,50,83
45655,FremontBridge,12/18/2017 07:00:00 AM,48,-122,80,97,177
45656,FremontBridge,12/18/2017 08:00:00 AM,48,-122,125,153,278
45657,FremontBridge,12/18/2017 09:00:00 AM,48,-122,96,73,169
45658,FremontBridge,12/18/2017 10:00:00 AM,48,-122,29,16,45
45659,FremontBridge,12/18/2017 11:00:00 AM,48,-122,20,14,34
45660,FremontBridge,12/18/2017 12:00:00 PM,48,-122,14,17,31
45661,FremontBridge,12/18/2017 01:00:00 PM,48,-122,24,8,32
45662,FremontBridge,12/18/2017 02:00:00 PM,48,-122,19,15,34
45663,FremontBridge,12/18/2017 03:00:00 PM,48,-122,47,22,69
45664,FremontBridge,12/18/2017 04:00:00 PM,48,-122,116,33,149
45665,FremontBridge,12/18/2017 05:00:00 PM,48,-122,226,61,287
45666,FremontBridge,12/18/2017 06:00:00 PM,48,-122,153,48,201
45667,FremontBridge,12/18/2017 07:00:00 PM,48,-122,54,17,71
45668,FremontBridge,12/18/2017 08:00:00 PM,48,-122,21,16,37
45669,FremontBridge,12/18/2017 09:00:00 PM,48,-122,16,4,20
45670,FremontBridge,12/18/2017 10:00:00 PM,48,-122,11,3,14
45671,FremontBridge,12/18/2017 11:00:00 PM,48,-122,3,1,4
45672,FremontBridge,12/19/2017 12:00:00 AM,48,-122,2,0,2
45673,FremontBridge,12/19/2017 01:00:00 AM,48,-122,1,1,2
45674,FremontBridge,12/19/2017 02:00:00 AM,48,-122,3,0,3
45675,FremontBridge,12/19/2017 03:00:00 AM,48,-122,0,2,2
45676,FremontBridge,12/19/2017 04:00:00 AM,48,-122,4,4,8
45677,FremontBridge,12/19/2017 05:00:00 AM,48,-122,9,14,23
45678,FremontBridge,12/19/2017 06:00:00 AM,48,-122,27,38,65
45679,FremontBridge,12/19/2017 07:00:00 AM,48,-122,57,75,132
45680,FremontBridge,12/19/2017 08:00:00 AM,48,-122,75,100,175
45681,FremontBridge,12/19/2017 09:00:00 AM,48,-122,65,57,122
45682,FremontBridge,12/19/2017 10:00:00 AM,48,-122,30,16,46
45683,FremontBridge,12/19/2017 11:00:00 AM,48,-122,13,10,23
45684,FremontBridge,12/19/2017 12:00:00 PM,48,-122,15,8,23
45685,FremontBridge,12/19/2017 01:00:00 PM,48,-122,12,10,22
45686,FremontBridge,12/19/2017 02:00:00 PM,48,-122,17,9,26
45687,FremontBridge,12/19/2017 03:00:00 PM,48,-122,17,28,45
45688,FremontBridge,12/19/2017 04:00:00 PM,48,-122,107,30,137
45689,FremontBridge,12/19/2017 05:00:00 PM,48,-122,189,55,244
45690,FremontBridge,12/19/2017 06:00:00 PM,48,-122,111,46,157
45691,FremontBridge,12/19/2017 07:00:00 PM,48,-122,41,10,51
45692,FremontBridge,12/19/2017 08:00:00 PM,48,-122,18,19,37
45693,FremontBridge,12/19/2017 09:00:00 PM,48,-122,14,10,24
45694,FremontBridge,12/19/2017 10:00:00 PM,48,-122,9,5,14
45695,FremontBridge,12/19/2017 11:00:00 PM,48,-122,1,3,4
45696,FremontBridge,12/20/2017 12:00:00 AM,48,-122,4,3,7
45697,FremontBridge,12/20/2017 01:00:00 AM,48,-122,3,1,4
45698,FremontBridge,12/20/2017 02:00:00 AM,48,-122,0,0,0
45699,FremontBridge,12/20/2017 03:00:00 AM,48,-122,3,1,4
45700,FremontBridge,12/20/2017 04:00:00 AM,48,-122,6,2,8
45701,FremontBridge,12/20/2017 05:00:00 AM,48,-122,14,18,32
45702,FremontBridge,12/20/2017 06:00:00 AM,48,-122,40,47,87
45703,FremontBridge,12/20/2017 07:00:00 AM,48,-122,93,111,204
45704,FremontBridge,12/20/2017 08:00:00 AM,48,-122,129,153,282
45705,FremontBridge,12/20/2017 09:00:00 AM,48,-122,94,69,163
45706,FremontBridge,12/20/2017 10:00:00 AM,48,-122,52,41,93
45707,FremontBridge,12/20/2017 11:00:00 AM,48,-122,26,34,60
45708,FremontBridge,12/20/2017 12:00:00 PM,48,-122,39,19,58
45709,FremontBridge,12/20/2017 01:00:00 PM,48,-122,28,25,53
45710,FremontBridge,12/20/2017 02:00:00 PM,48,-122,49,32,81
45711,FremontBridge,12/20/2017 03:00:00 PM,48,-122,70,46,116
45712,FremontBridge,12/20/2017 04:00:00 PM,48,-122,149,52,201
45713,FremontBridge,12/20/2017 05:00:00 PM,48,-122,244,76,320
45714,FremontBridge,12/20/2017 06:00:00 PM,48,-122,116,50,166
45715,FremontBridge,12/20/2017 07:00:00 PM,48,-122,74,22,96
45716,FremontBridge,12/20/2017 08:00:00 PM,48,-122,29,16,45
45717,FremontBridge,12/20/2017 09:00:00 PM,48,-122,12,8,20
45718,FremontBridge,12/20/2017 10:00:00 PM,48,-122,10,7,17
45719,FremontBridge,12/20/2017 11:00:00 PM,48,-122,7,9,16
45720,FremontBridge,12/21/2017 12:00:00 AM,48,-122,6,3,9
45721,FremontBridge,12/21/2017 01:00:00 AM,48,-122,1,0,1
45722,FremontBridge,12/21/2017 02:00:00 AM,48,-122,0,3,3
45723,FremontBridge,12/21/2017 03:00:00 AM,48,-122,0,4,4
45724,FremontBridge,12/21/2017 04:00:00 AM,48,-122,2,2,4
45725,FremontBridge,12/21/2017 05:00:00 AM,48,-122,13,15,28
45726,FremontBridge,12/21/2017 06:00:00 AM,48,-122,32,35,67
45727,FremontBridge,12/21/2017 07:00:00 AM,48,-122,61,67,128
45728,FremontBridge,12/21/2017 08:00:00 AM,48,-122,117,122,239
45729,FremontBridge,12/21/2017 09:00:00 AM,48,-122,67,73,140
45730,FremontBridge,12/21/2017 10:00:00 AM,48,-122,38,28,66
45731,FremontBridge,12/21/2017 11:00:00 AM,48,-122,19,27,46
45732,FremontBridge,12/21/2017 12:00:00 PM,48,-122,29,19,48
45733,FremontBridge,12/21/2017 01:00:00 PM,48,-122,34,21,55
45734,FremontBridge,12/21/2017 02:00:00 PM,48,-122,38,31,69
45735,FremontBridge,12/21/2017 03:00:00 PM,48,-122,71,37,108
45736,FremontBridge,12/21/2017 04:00:00 PM,48,-122,144,60,204
45737,FremontBridge,12/21/2017 05:00:00 PM,48,-122,192,73,265
45738,FremontBridge,12/21/2017 06:00:00 PM,48,-122,82,47,129
45739,FremontBridge,12/21/2017 07:00:00 PM,48,-122,31,17,48
45740,FremontBridge,12/21/2017 08:00:00 PM,48,-122,25,10,35
45741,FremontBridge,12/21/2017 09:00:00 PM,48,-122,7,11,18
45742,FremontBridge,12/21/2017 10:00:00 PM,48,-122,8,6,14
45743,FremontBridge,12/21/2017 11:00:00 PM,48,-122,2,6,8
45744,FremontBridge,12/22/2017 12:00:00 AM,48,-122,8,4,12
45745,FremontBridge,12/22/2017 01:00:00 AM,48,-122,0,0,0
45746,FremontBridge,12/22/2017 02:00:00 AM,48,-122,0,0,0
45747,FremontBridge,12/22/2017 03:00:00 AM,48,-122,2,1,3
45748,FremontBridge,12/22/2017 04:00:00 AM,48,-122,2,4,6
45749,FremontBridge,12/22/2017 05:00:00 AM,48,-122,8,12,20
45750,FremontBridge,12/22/2017 06:00:00 AM,48,-122,16,38,54
45751,FremontBridge,12/22/2017 07:00:00 AM,48,-122,53,49,102
45752,FremontBridge,12/22/2017 08:00:00 AM,48,-122,59,61,120
45753,FremontBridge,12/22/2017 09:00:00 AM,48,-122,45,36,81
45754,FremontBridge,12/22/2017 10:00:00 AM,48,-122,27,22,49
45755,FremontBridge,12/22/2017 11:00:00 AM,48,-122,19,13,32
45756,FremontBridge,12/22/2017 12:00:00 PM,48,-122,22,14,36
45757,FremontBridge,12/22/2017 01:00:00 PM,48,-122,43,20,63
45758,FremontBridge,12/22/2017 02:00:00 PM,48,-122,53,36,89
45759,FremontBridge,12/22/2017 03:00:00 PM,48,-122,54,42,96
45760,FremontBridge,12/22/2017 04:00:00 PM,48,-122,89,41,130
45761,FremontBridge,12/22/2017 05:00:00 PM,48,-122,78,31,109
45762,FremontBridge,12/22/2017 06:00:00 PM,48,-122,40,23,63
45763,FremontBridge,12/22/2017 07:00:00 PM,48,-122,23,12,35
45764,FremontBridge,12/22/2017 08:00:00 PM,48,-122,16,5,21
45765,FremontBridge,12/22/2017 09:00:00 PM,48,-122,10,7,17
45766,FremontBridge,12/22/2017 10:00:00 PM,48,-122,8,9,17
45767,FremontBridge,12/22/2017 11:00:00 PM,48,-122,2,2,4
45768,FremontBridge,12/23/2017 12:00:00 AM,48,-122,1,3,4
45769,FremontBridge,12/23/2017 01:00:00 AM,48,-122,0,3,3
45770,FremontBridge,12/23/2017 02:00:00 AM,48,-122,1,2,3
45771,FremontBridge,12/23/2017 03:00:00 AM,48,-122,0,1,1
45772,FremontBridge,12/23/2017 04:00:00 AM,48,-122,1,1,2
45773,FremontBridge,12/23/2017 05:00:00 AM,48,-122,1,4,5
45774,FremontBridge,12/23/2017 06:00:00 AM,48,-122,3,4,7
45775,FremontBridge,12/23/2017 07:00:00 AM,48,-122,4,6,10
45776,FremontBridge,12/23/2017 08:00:00 AM,48,-122,13,12,25
45777,FremontBridge,12/23/2017 09:00:00 AM,48,-122,16,13,29
45778,FremontBridge,12/23/2017 10:00:00 AM,48,-122,12,16,28
45779,FremontBridge,12/23/2017 11:00:00 AM,48,-122,30,24,54
45780,FremontBridge,12/23/2017 12:00:00 PM,48,-122,30,29,59
45781,FremontBridge,12/23/2017 01:00:00 PM,48,-122,45,30,75
45782,FremontBridge,12/23/2017 02:00:00 PM,48,-122,39,48,87
45783,FremontBridge,12/23/2017 03:00:00 PM,48,-122,30,35,65
45784,FremontBridge,12/23/2017 04:00:00 PM,48,-122,12,16,28
45785,FremontBridge,12/23/2017 05:00:00 PM,48,-122,14,27,41
45786,FremontBridge,12/23/2017 06:00:00 PM,48,-122,15,6,21
45787,FremontBridge,12/23/2017 07:00:00 PM,48,-122,7,5,12
45788,FremontBridge,12/23/2017 08:00:00 PM,48,-122,5,3,8
45789,FremontBridge,12/23/2017 09:00:00 PM,48,-122,5,1,6
45790,FremontBridge,12/23/2017 10:00:00 PM,48,-122,4,1,5
45791,FremontBridge,12/23/2017 11:00:00 PM,48,-122,6,2,8
45792,FremontBridge,12/24/2017 12:00:00 AM,48,-122,3,2,5
45793,FremontBridge,12/24/2017 01:00:00 AM,48,-122,1,1,2
45794,FremontBridge,12/24/2017 02:00:00 AM,48,-122,0,1,1
45795,FremontBridge,12/24/2017 03:00:00 AM,48,-122,0,0,0
45796,FremontBridge,12/24/2017 04:00:00 AM,48,-122,2,2,4
45797,FremontBridge,12/24/2017 05:00:00 AM,48,-122,0,2,2
45798,FremontBridge,12/24/2017 06:00:00 AM,48,-122,1,3,4
45799,FremontBridge,12/24/2017 07:00:00 AM,48,-122,1,5,6
45800,FremontBridge,12/24/2017 08:00:00 AM,48,-122,11,10,21
45801,FremontBridge,12/24/2017 09:00:00 AM,48,-122,8,11,19
45802,FremontBridge,12/24/2017 10:00:00 AM,48,-122,11,12,23
45803,FremontBridge,12/24/2017 11:00:00 AM,48,-122,13,17,30
45804,FremontBridge,12/24/2017 12:00:00 PM,48,-122,12,12,24
45805,FremontBridge,12/24/2017 01:00:00 PM,48,-122,18,14,32
45806,FremontBridge,12/24/2017 02:00:00 PM,48,-122,11,16,27
45807,FremontBridge,12/24/2017 03:00:00 PM,48,-122,8,10,18
45808,FremontBridge,12/24/2017 04:00:00 PM,48,-122,4,6,10
45809,FremontBridge,12/24/2017 05:00:00 PM,48,-122,1,2,3
45810,FremontBridge,12/24/2017 06:00:00 PM,48,-122,3,3,6
45811,FremontBridge,12/24/2017 07:00:00 PM,48,-122,2,2,4
45812,FremontBridge,12/24/2017 08:00:00 PM,48,-122,0,0,0
45813,FremontBridge,12/24/2017 09:00:00 PM,48,-122,3,1,4
45814,FremontBridge,12/24/2017 10:00:00 PM,48,-122,1,0,1
45815,FremontBridge,12/24/2017 11:00:00 PM,48,-122,0,2,2
45816,FremontBridge,12/25/2017 12:00:00 AM,48,-122,2,0,2
45817,FremontBridge,12/25/2017 01:00:00 AM,48,-122,0,0,0
45818,FremontBridge,12/25/2017 02:00:00 AM,48,-122,0,0,0
45819,FremontBridge,12/25/2017 03:00:00 AM,48,-122,0,0,0
45820,FremontBridge,12/25/2017 04:00:00 AM,48,-122,0,0,0
45821,FremontBridge,12/25/2017 05:00:00 AM,48,-122,1,0,1
45822,FremontBridge,12/25/2017 06:00:00 AM,48,-122,0,0,0
45823,FremontBridge,12/25/2017 07:00:00 AM,48,-122,1,1,2
45824,FremontBridge,12/25/2017 08:00:00 AM,48,-122,1,0,1
45825,FremontBridge,12/25/2017 09:00:00 AM,48,-122,1,0,1
45826,FremontBridge,12/25/2017 10:00:00 AM,48,-122,1,3,4
45827,FremontBridge,12/25/2017 11:00:00 AM,48,-122,2,1,3
45828,FremontBridge,12/25/2017 12:00:00 PM,48,-122,2,3,5
45829,FremontBridge,12/25/2017 01:00:00 PM,48,-122,0,0,0
45830,FremontBridge,12/25/2017 02:00:00 PM,48,-122,4,2,6
45831,FremontBridge,12/25/2017 03:00:00 PM,48,-122,2,1,3
45832,FremontBridge,12/25/2017 04:00:00 PM,48,-122,1,1,2
45833,FremontBridge,12/25/2017 05:00:00 PM,48,-122,0,0,0
45834,FremontBridge,12/25/2017 06:00:00 PM,48,-122,4,1,5
45835,FremontBridge,12/25/2017 07:00:00 PM,48,-122,4,2,6
45836,FremontBridge,12/25/2017 08:00:00 PM,48,-122,0,3,3
45837,FremontBridge,12/25/2017 09:00:00 PM,48,-122,0,1,1
45838,FremontBridge,12/25/2017 10:00:00 PM,48,-122,1,0,1
45839,FremontBridge,12/25/2017 11:00:00 PM,48,-122,1,1,2
45840,FremontBridge,12/26/2017 12:00:00 AM,48,-122,2,0,2
45841,FremontBridge,12/26/2017 01:00:00 AM,48,-122,0,0,0
45842,FremontBridge,12/26/2017 02:00:00 AM,48,-122,0,0,0
45843,FremontBridge,12/26/2017 03:00:00 AM,48,-122,0,0,0
45844,FremontBridge,12/26/2017 04:00:00 AM,48,-122,4,4,8
45845,FremontBridge,12/26/2017 05:00:00 AM,48,-122,6,6,12
45846,FremontBridge,12/26/2017 06:00:00 AM,48,-122,7,5,12
45847,FremontBridge,12/26/2017 07:00:00 AM,48,-122,15,9,24
45848,FremontBridge,12/26/2017 08:00:00 AM,48,-122,18,23,41
45849,FremontBridge,12/26/2017 09:00:00 AM,48,-122,26,12,38
45850,FremontBridge,12/26/2017 10:00:00 AM,48,-122,20,14,34
45851,FremontBridge,12/26/2017 11:00:00 AM,48,-122,13,13,26
45852,FremontBridge,12/26/2017 12:00:00 PM,48,-122,11,11,22
45853,FremontBridge,12/26/2017 01:00:00 PM,48,-122,24,12,36
45854,FremontBridge,12/26/2017 02:00:00 PM,48,-122,20,18,38
45855,FremontBridge,12/26/2017 03:00:00 PM,48,-122,27,23,50
45856,FremontBridge,12/26/2017 04:00:00 PM,48,-122,39,28,67
45857,FremontBridge,12/26/2017 05:00:00 PM,48,-122,48,15,63
45858,FremontBridge,12/26/2017 06:00:00 PM,48,-122,19,5,24
45859,FremontBridge,12/26/2017 07:00:00 PM,48,-122,16,6,22
45860,FremontBridge,12/26/2017 08:00:00 PM,48,-122,7,12,19
45861,FremontBridge,12/26/2017 09:00:00 PM,48,-122,2,3,5
45862,FremontBridge,12/26/2017 10:00:00 PM,48,-122,3,1,4
45863,FremontBridge,12/26/2017 11:00:00 PM,48,-122,3,4,7
45864,FremontBridge,12/27/2017 12:00:00 AM,48,-122,1,3,4
45865,FremontBridge,12/27/2017 01:00:00 AM,48,-122,0,2,2
45866,FremontBridge,12/27/2017 02:00:00 AM,48,-122,0,0,0
45867,FremontBridge,12/27/2017 03:00:00 AM,48,-122,0,1,1
45868,FremontBridge,12/27/2017 04:00:00 AM,48,-122,1,3,4
45869,FremontBridge,12/27/2017 05:00:00 AM,48,-122,7,10,17
45870,FremontBridge,12/27/2017 06:00:00 AM,48,-122,17,25,42
45871,FremontBridge,12/27/2017 07:00:00 AM,48,-122,27,31,58
45872,FremontBridge,12/27/2017 08:00:00 AM,48,-122,58,60,118
45873,FremontBridge,12/27/2017 09:00:00 AM,48,-122,35,28,63
45874,FremontBridge,12/27/2017 10:00:00 AM,48,-122,18,15,33
45875,FremontBridge,12/27/2017 11:00:00 AM,48,-122,21,20,41
45876,FremontBridge,12/27/2017 12:00:00 PM,48,-122,16,25,41
45877,FremontBridge,12/27/2017 01:00:00 PM,48,-122,28,22,50
45878,FremontBridge,12/27/2017 02:00:00 PM,48,-122,25,20,45
45879,FremontBridge,12/27/2017 03:00:00 PM,48,-122,51,22,73
45880,FremontBridge,12/27/2017 04:00:00 PM,48,-122,86,47,133
45881,FremontBridge,12/27/2017 05:00:00 PM,48,-122,83,28,111
45882,FremontBridge,12/27/2017 06:00:00 PM,48,-122,39,23,62
45883,FremontBridge,12/27/2017 07:00:00 PM,48,-122,19,15,34
45884,FremontBridge,12/27/2017 08:00:00 PM,48,-122,24,3,27
45885,FremontBridge,12/27/2017 09:00:00 PM,48,-122,15,6,21
45886,FremontBridge,12/27/2017 10:00:00 PM,48,-122,4,6,10
45887,FremontBridge,12/27/2017 11:00:00 PM,48,-122,4,3,7
45888,FremontBridge,12/28/2017 12:00:00 AM,48,-122,1,1,2
45889,FremontBridge,12/28/2017 01:00:00 AM,48,-122,0,0,0
45890,FremontBridge,12/28/2017 02:00:00 AM,48,-122,1,1,2
45891,FremontBridge,12/28/2017 03:00:00 AM,48,-122,1,1,2
45892,FremontBridge,12/28/2017 04:00:00 AM,48,-122,4,4,8
45893,FremontBridge,12/28/2017 05:00:00 AM,48,-122,10,11,21
45894,FremontBridge,12/28/2017 06:00:00 AM,48,-122,22,21,43
45895,FremontBridge,12/28/2017 07:00:00 AM,48,-122,39,44,83
45896,FremontBridge,12/28/2017 08:00:00 AM,48,-122,52,65,117
45897,FremontBridge,12/28/2017 09:00:00 AM,48,-122,35,48,83
45898,FremontBridge,12/28/2017 10:00:00 AM,48,-122,19,18,37
45899,FremontBridge,12/28/2017 11:00:00 AM,48,-122,18,13,31
45900,FremontBridge,12/28/2017 12:00:00 PM,48,-122,22,15,37
45901,FremontBridge,12/28/2017 01:00:00 PM,48,-122,16,12,28
45902,FremontBridge,12/28/2017 02:00:00 PM,48,-122,21,9,30
45903,FremontBridge,12/28/2017 03:00:00 PM,48,-122,39,23,62
45904,FremontBridge,12/28/2017 04:00:00 PM,48,-122,71,30,101
45905,FremontBridge,12/28/2017 05:00:00 PM,48,-122,91,42,133
45906,FremontBridge,12/28/2017 06:00:00 PM,48,-122,36,15,51
45907,FremontBridge,12/28/2017 07:00:00 PM,48,-122,35,16,51
45908,FremontBridge,12/28/2017 08:00:00 PM,48,-122,10,8,18
45909,FremontBridge,12/28/2017 09:00:00 PM,48,-122,9,6,15
45910,FremontBridge,12/28/2017 10:00:00 PM,48,-122,8,6,14
45911,FremontBridge,12/28/2017 11:00:00 PM,48,-122,1,2,3
45912,FremontBridge,12/29/2017 12:00:00 AM,48,-122,8,3,11
45913,FremontBridge,12/29/2017 01:00:00 AM,48,-122,1,1,2
45914,FremontBridge,12/29/2017 02:00:00 AM,48,-122,1,1,2
45915,FremontBridge,12/29/2017 03:00:00 AM,48,-122,1,1,2
45916,FremontBridge,12/29/2017 04:00:00 AM,48,-122,3,2,5
45917,FremontBridge,12/29/2017 05:00:00 AM,48,-122,9,6,15
45918,FremontBridge,12/29/2017 06:00:00 AM,48,-122,11,24,35
45919,FremontBridge,12/29/2017 07:00:00 AM,48,-122,23,33,56
45920,FremontBridge,12/29/2017 08:00:00 AM,48,-122,34,36,70
45921,FremontBridge,12/29/2017 09:00:00 AM,48,-122,22,17,39
45922,FremontBridge,12/29/2017 10:00:00 AM,48,-122,13,14,27
45923,FremontBridge,12/29/2017 11:00:00 AM,48,-122,6,5,11
45924,FremontBridge,12/29/2017 12:00:00 PM,48,-122,9,6,15
45925,FremontBridge,12/29/2017 01:00:00 PM,48,-122,14,6,20
45926,FremontBridge,12/29/2017 02:00:00 PM,48,-122,19,16,35
45927,FremontBridge,12/29/2017 03:00:00 PM,48,-122,26,14,40
45928,FremontBridge,12/29/2017 04:00:00 PM,48,-122,37,23,60
45929,FremontBridge,12/29/2017 05:00:00 PM,48,-122,51,15,66
45930,FremontBridge,12/29/2017 06:00:00 PM,48,-122,14,15,29
45931,FremontBridge,12/29/2017 07:00:00 PM,48,-122,17,7,24
45932,FremontBridge,12/29/2017 08:00:00 PM,48,-122,5,5,10
45933,FremontBridge,12/29/2017 09:00:00 PM,48,-122,4,3,7
45934,FremontBridge,12/29/2017 10:00:00 PM,48,-122,3,3,6
45935,FremontBridge,12/29/2017 11:00:00 PM,48,-122,3,1,4
45936,FremontBridge,12/30/2017 12:00:00 AM,48,-122,2,1,3
45937,FremontBridge,12/30/2017 01:00:00 AM,48,-122,1,1,2
45938,FremontBridge,12/30/2017 02:00:00 AM,48,-122,0,1,1
45939,FremontBridge,12/30/2017 03:00:00 AM,48,-122,1,1,2
45940,FremontBridge,12/30/2017 04:00:00 AM,48,-122,1,2,3
45941,FremontBridge,12/30/2017 05:00:00 AM,48,-122,3,2,5
45942,FremontBridge,12/30/2017 06:00:00 AM,48,-122,7,2,9
45943,FremontBridge,12/30/2017 07:00:00 AM,48,-122,8,9,17
45944,FremontBridge,12/30/2017 08:00:00 AM,48,-122,12,17,29
45945,FremontBridge,12/30/2017 09:00:00 AM,48,-122,17,16,33
45946,FremontBridge,12/30/2017 10:00:00 AM,48,-122,31,29,60
45947,FremontBridge,12/30/2017 11:00:00 AM,48,-122,30,18,48
45948,FremontBridge,12/30/2017 12:00:00 PM,48,-122,38,40,78
45949,FremontBridge,12/30/2017 01:00:00 PM,48,-122,40,36,76
45950,FremontBridge,12/30/2017 02:00:00 PM,48,-122,32,43,75
45951,FremontBridge,12/30/2017 03:00:00 PM,48,-122,43,26,69
45952,FremontBridge,12/30/2017 04:00:00 PM,48,-122,48,41,89
45953,FremontBridge,12/30/2017 05:00:00 PM,48,-122,15,12,27
45954,FremontBridge,12/30/2017 06:00:00 PM,48,-122,9,17,26
45955,FremontBridge,12/30/2017 07:00:00 PM,48,-122,5,8,13
45956,FremontBridge,12/30/2017 08:00:00 PM,48,-122,21,5,26
45957,FremontBridge,12/30/2017 09:00:00 PM,48,-122,10,4,14
45958,FremontBridge,12/30/2017 10:00:00 PM,48,-122,3,9,12
45959,FremontBridge,12/30/2017 11:00:00 PM,48,-122,5,3,8
45960,FremontBridge,12/31/2017 12:00:00 AM,48,-122,9,3,12
45961,FremontBridge,12/31/2017 01:00:00 AM,48,-122,1,4,5
45962,FremontBridge,12/31/2017 02:00:00 AM,48,-122,2,0,2
45963,FremontBridge,12/31/2017 03:00:00 AM,48,-122,0,2,2
45964,FremontBridge,12/31/2017 04:00:00 AM,48,-122,2,3,5
45965,FremontBridge,12/31/2017 05:00:00 AM,48,-122,1,2,3
45966,FremontBridge,12/31/2017 06:00:00 AM,48,-122,6,0,6
45967,FremontBridge,12/31/2017 07:00:00 AM,48,-122,3,7,10
45968,FremontBridge,12/31/2017 08:00:00 AM,48,-122,9,13,22
45969,FremontBridge,12/31/2017 09:00:00 AM,48,-122,7,23,30
45970,FremontBridge,12/31/2017 10:00:00 AM,48,-122,20,27,47
45971,FremontBridge,12/31/2017 11:00:00 AM,48,-122,24,41,65
45972,FremontBridge,12/31/2017 12:00:00 PM,48,-122,45,41,86
45973,FremontBridge,12/31/2017 01:00:00 PM,48,-122,39,54,93
45974,FremontBridge,12/31/2017 02:00:00 PM,48,-122,36,54,90
45975,FremontBridge,12/31/2017 03:00:00 PM,48,-122,31,38,69
45976,FremontBridge,12/31/2017 04:00:00 PM,48,-122,25,32,57
45977,FremontBridge,12/31/2017 05:00:00 PM,48,-122,21,12,33
45978,FremontBridge,12/31/2017 06:00:00 PM,48,-122,17,3,20
45979,FremontBridge,12/31/2017 07:00:00 PM,48,-122,12,9,21
45980,FremontBridge,12/31/2017 08:00:00 PM,48,-122,8,6,14
45981,FremontBridge,12/31/2017 09:00:00 PM,48,-122,10,3,13
45982,FremontBridge,12/31/2017 10:00:00 PM,48,-122,6,7,13
45983,FremontBridge,12/31/2017 11:00:00 PM,48,-122,9,7,16
