,Name,Date,Latitude,Longitude,NB,SB,TotalCount
0,SpokaneStBridge,01/01/2014 12:00:00 AM,48,-122,0,0,0
1,SpokaneStBridge,01/01/2014 01:00:00 AM,48,-122,0,3,3
2,SpokaneStBridge,01/01/2014 02:00:00 AM,48,-122,1,5,6
3,SpokaneStBridge,01/01/2014 03:00:00 AM,48,-122,1,6,7
4,SpokaneStBridge,01/01/2014 04:00:00 AM,48,-122,0,0,0
5,SpokaneStBridge,01/01/2014 05:00:00 AM,48,-122,1,5,6
6,SpokaneStBridge,01/01/2014 06:00:00 AM,48,-122,0,1,1
7,SpokaneStBridge,01/01/2014 07:00:00 AM,48,-122,2,0,2
8,SpokaneStBridge,01/01/2014 08:00:00 AM,48,-122,6,1,7
9,SpokaneStBridge,01/01/2014 09:00:00 AM,48,-122,4,2,6
10,SpokaneStBridge,01/01/2014 10:00:00 AM,48,-122,11,6,17
11,SpokaneStBridge,01/01/2014 11:00:00 AM,48,-122,17,18,35
12,SpokaneStBridge,01/01/2014 12:00:00 PM,48,-122,16,12,28
13,SpokaneStBridge,01/01/2014 01:00:00 PM,48,-122,12,12,24
14,SpokaneStBridge,01/01/2014 02:00:00 PM,48,-122,22,18,40
15,SpokaneStBridge,01/01/2014 03:00:00 PM,48,-122,14,15,29
16,SpokaneStBridge,01/01/2014 04:00:00 PM,48,-122,11,9,20
17,SpokaneStBridge,01/01/2014 05:00:00 PM,48,-122,5,5,10
18,SpokaneStBridge,01/01/2014 06:00:00 PM,48,-122,0,1,1
19,SpokaneStBridge,01/01/2014 07:00:00 PM,48,-122,1,0,1
20,SpokaneStBridge,01/01/2014 08:00:00 PM,48,-122,0,0,0
21,SpokaneStBridge,01/01/2014 09:00:00 PM,48,-122,0,0,0
22,SpokaneStBridge,01/01/2014 10:00:00 PM,48,-122,1,2,3
23,SpokaneStBridge,01/01/2014 11:00:00 PM,48,-122,0,0,0
24,SpokaneStBridge,01/02/2014 12:00:00 AM,48,-122,0,1,1
25,SpokaneStBridge,01/02/2014 01:00:00 AM,48,-122,1,1,2
26,SpokaneStBridge,01/02/2014 02:00:00 AM,48,-122,0,0,0
27,SpokaneStBridge,01/02/2014 03:00:00 AM,48,-122,1,0,1
28,SpokaneStBridge,01/02/2014 04:00:00 AM,48,-122,2,0,2
29,SpokaneStBridge,01/02/2014 05:00:00 AM,48,-122,9,1,10
30,SpokaneStBridge,01/02/2014 06:00:00 AM,48,-122,29,8,37
31,SpokaneStBridge,01/02/2014 07:00:00 AM,48,-122,49,10,59
32,SpokaneStBridge,01/02/2014 08:00:00 AM,48,-122,67,9,76
33,SpokaneStBridge,01/02/2014 09:00:00 AM,48,-122,28,2,30
34,SpokaneStBridge,01/02/2014 10:00:00 AM,48,-122,5,0,5
35,SpokaneStBridge,01/02/2014 11:00:00 AM,48,-122,7,4,11
36,SpokaneStBridge,01/02/2014 12:00:00 PM,48,-122,12,1,13
37,SpokaneStBridge,01/02/2014 01:00:00 PM,48,-122,10,9,19
38,SpokaneStBridge,01/02/2014 02:00:00 PM,48,-122,6,10,16
39,SpokaneStBridge,01/02/2014 03:00:00 PM,48,-122,3,20,23
40,SpokaneStBridge,01/02/2014 04:00:00 PM,48,-122,11,27,38
41,SpokaneStBridge,01/02/2014 05:00:00 PM,48,-122,12,64,76
42,SpokaneStBridge,01/02/2014 06:00:00 PM,48,-122,3,38,41
43,SpokaneStBridge,01/02/2014 07:00:00 PM,48,-122,3,21,24
44,SpokaneStBridge,01/02/2014 08:00:00 PM,48,-122,1,2,3
45,SpokaneStBridge,01/02/2014 09:00:00 PM,48,-122,1,2,3
46,SpokaneStBridge,01/02/2014 10:00:00 PM,48,-122,1,2,3
47,SpokaneStBridge,01/02/2014 11:00:00 PM,48,-122,2,1,3
48,SpokaneStBridge,01/03/2014 12:00:00 AM,48,-122,8,0,8
49,SpokaneStBridge,01/03/2014 01:00:00 AM,48,-122,0,1,1
50,SpokaneStBridge,01/03/2014 02:00:00 AM,48,-122,0,0,0
51,SpokaneStBridge,01/03/2014 03:00:00 AM,48,-122,0,0,0
52,SpokaneStBridge,01/03/2014 04:00:00 AM,48,-122,2,0,2
53,SpokaneStBridge,01/03/2014 05:00:00 AM,48,-122,12,3,15
54,SpokaneStBridge,01/03/2014 06:00:00 AM,48,-122,31,3,34
55,SpokaneStBridge,01/03/2014 07:00:00 AM,48,-122,39,9,48
56,SpokaneStBridge,01/03/2014 08:00:00 AM,48,-122,61,8,69
57,SpokaneStBridge,01/03/2014 09:00:00 AM,48,-122,28,4,32
58,SpokaneStBridge,01/03/2014 10:00:00 AM,48,-122,7,4,11
59,SpokaneStBridge,01/03/2014 11:00:00 AM,48,-122,5,3,8
60,SpokaneStBridge,01/03/2014 12:00:00 PM,48,-122,9,7,16
61,SpokaneStBridge,01/03/2014 01:00:00 PM,48,-122,12,11,23
62,SpokaneStBridge,01/03/2014 02:00:00 PM,48,-122,17,11,28
63,SpokaneStBridge,01/03/2014 03:00:00 PM,48,-122,15,22,37
64,SpokaneStBridge,01/03/2014 04:00:00 PM,48,-122,11,40,51
65,SpokaneStBridge,01/03/2014 05:00:00 PM,48,-122,9,58,67
66,SpokaneStBridge,01/03/2014 06:00:00 PM,48,-122,1,26,27
67,SpokaneStBridge,01/03/2014 07:00:00 PM,48,-122,2,9,11
68,SpokaneStBridge,01/03/2014 08:00:00 PM,48,-122,0,8,8
69,SpokaneStBridge,01/03/2014 09:00:00 PM,48,-122,0,3,3
70,SpokaneStBridge,01/03/2014 10:00:00 PM,48,-122,2,7,9
71,SpokaneStBridge,01/03/2014 11:00:00 PM,48,-122,1,1,2
72,SpokaneStBridge,01/04/2014 12:00:00 AM,48,-122,0,0,0
73,SpokaneStBridge,01/04/2014 01:00:00 AM,48,-122,0,1,1
74,SpokaneStBridge,01/04/2014 02:00:00 AM,48,-122,2,2,4
75,SpokaneStBridge,01/04/2014 03:00:00 AM,48,-122,0,0,0
76,SpokaneStBridge,01/04/2014 04:00:00 AM,48,-122,0,1,1
77,SpokaneStBridge,01/04/2014 05:00:00 AM,48,-122,6,0,6
78,SpokaneStBridge,01/04/2014 06:00:00 AM,48,-122,4,1,5
79,SpokaneStBridge,01/04/2014 07:00:00 AM,48,-122,2,0,2
80,SpokaneStBridge,01/04/2014 08:00:00 AM,48,-122,11,2,13
81,SpokaneStBridge,01/04/2014 09:00:00 AM,48,-122,9,5,14
82,SpokaneStBridge,01/04/2014 10:00:00 AM,48,-122,9,28,37
83,SpokaneStBridge,01/04/2014 11:00:00 AM,48,-122,14,29,43
84,SpokaneStBridge,01/04/2014 12:00:00 PM,48,-122,27,18,45
85,SpokaneStBridge,01/04/2014 01:00:00 PM,48,-122,62,23,85
86,SpokaneStBridge,01/04/2014 02:00:00 PM,48,-122,29,22,51
87,SpokaneStBridge,01/04/2014 03:00:00 PM,48,-122,13,33,46
88,SpokaneStBridge,01/04/2014 04:00:00 PM,48,-122,22,10,32
89,SpokaneStBridge,01/04/2014 05:00:00 PM,48,-122,6,9,15
90,SpokaneStBridge,01/04/2014 06:00:00 PM,48,-122,3,2,5
91,SpokaneStBridge,01/04/2014 07:00:00 PM,48,-122,4,0,4
92,SpokaneStBridge,01/04/2014 08:00:00 PM,48,-122,0,1,1
93,SpokaneStBridge,01/04/2014 09:00:00 PM,48,-122,4,1,5
94,SpokaneStBridge,01/04/2014 10:00:00 PM,48,-122,1,2,3
95,SpokaneStBridge,01/04/2014 11:00:00 PM,48,-122,2,0,2
96,SpokaneStBridge,01/05/2014 12:00:00 AM,48,-122,0,1,1
97,SpokaneStBridge,01/05/2014 01:00:00 AM,48,-122,0,0,0
98,SpokaneStBridge,01/05/2014 02:00:00 AM,48,-122,0,1,1
99,SpokaneStBridge,01/05/2014 03:00:00 AM,48,-122,0,1,1
100,SpokaneStBridge,01/05/2014 04:00:00 AM,48,-122,0,0,0
101,SpokaneStBridge,01/05/2014 05:00:00 AM,48,-122,2,1,3
102,SpokaneStBridge,01/05/2014 06:00:00 AM,48,-122,0,1,1
103,SpokaneStBridge,01/05/2014 07:00:00 AM,48,-122,1,4,5
104,SpokaneStBridge,01/05/2014 08:00:00 AM,48,-122,5,0,5
105,SpokaneStBridge,01/05/2014 09:00:00 AM,48,-122,4,3,7
106,SpokaneStBridge,01/05/2014 10:00:00 AM,48,-122,13,10,23
107,SpokaneStBridge,01/05/2014 11:00:00 AM,48,-122,20,8,28
108,SpokaneStBridge,01/05/2014 12:00:00 PM,48,-122,13,20,33
109,SpokaneStBridge,01/05/2014 01:00:00 PM,48,-122,22,28,50
110,SpokaneStBridge,01/05/2014 02:00:00 PM,48,-122,24,26,50
111,SpokaneStBridge,01/05/2014 03:00:00 PM,48,-122,22,19,41
112,SpokaneStBridge,01/05/2014 04:00:00 PM,48,-122,11,11,22
113,SpokaneStBridge,01/05/2014 05:00:00 PM,48,-122,5,2,7
114,SpokaneStBridge,01/05/2014 06:00:00 PM,48,-122,1,3,4
115,SpokaneStBridge,01/05/2014 07:00:00 PM,48,-122,1,4,5
116,SpokaneStBridge,01/05/2014 08:00:00 PM,48,-122,0,1,1
117,SpokaneStBridge,01/05/2014 09:00:00 PM,48,-122,0,0,0
118,SpokaneStBridge,01/05/2014 10:00:00 PM,48,-122,1,0,1
119,SpokaneStBridge,01/05/2014 11:00:00 PM,48,-122,0,0,0
120,SpokaneStBridge,01/06/2014 12:00:00 AM,48,-122,0,0,0
121,SpokaneStBridge,01/06/2014 01:00:00 AM,48,-122,0,1,1
122,SpokaneStBridge,01/06/2014 02:00:00 AM,48,-122,0,0,0
123,SpokaneStBridge,01/06/2014 03:00:00 AM,48,-122,0,3,3
124,SpokaneStBridge,01/06/2014 04:00:00 AM,48,-122,3,1,4
125,SpokaneStBridge,01/06/2014 05:00:00 AM,48,-122,13,5,18
126,SpokaneStBridge,01/06/2014 06:00:00 AM,48,-122,47,7,54
127,SpokaneStBridge,01/06/2014 07:00:00 AM,48,-122,59,13,72
128,SpokaneStBridge,01/06/2014 08:00:00 AM,48,-122,64,3,67
129,SpokaneStBridge,01/06/2014 09:00:00 AM,48,-122,28,4,32
130,SpokaneStBridge,01/06/2014 10:00:00 AM,48,-122,13,2,15
131,SpokaneStBridge,01/06/2014 11:00:00 AM,48,-122,6,6,12
132,SpokaneStBridge,01/06/2014 12:00:00 PM,48,-122,3,0,3
133,SpokaneStBridge,01/06/2014 01:00:00 PM,48,-122,10,2,12
134,SpokaneStBridge,01/06/2014 02:00:00 PM,48,-122,6,11,17
135,SpokaneStBridge,01/06/2014 03:00:00 PM,48,-122,9,23,32
136,SpokaneStBridge,01/06/2014 04:00:00 PM,48,-122,18,42,60
137,SpokaneStBridge,01/06/2014 05:00:00 PM,48,-122,17,78,95
138,SpokaneStBridge,01/06/2014 06:00:00 PM,48,-122,7,50,57
139,SpokaneStBridge,01/06/2014 07:00:00 PM,48,-122,1,11,12
140,SpokaneStBridge,01/06/2014 08:00:00 PM,48,-122,2,8,10
141,SpokaneStBridge,01/06/2014 09:00:00 PM,48,-122,0,4,4
142,SpokaneStBridge,01/06/2014 10:00:00 PM,48,-122,0,2,2
143,SpokaneStBridge,01/06/2014 11:00:00 PM,48,-122,0,1,1
144,SpokaneStBridge,01/07/2014 12:00:00 AM,48,-122,0,2,2
145,SpokaneStBridge,01/07/2014 01:00:00 AM,48,-122,0,0,0
146,SpokaneStBridge,01/07/2014 02:00:00 AM,48,-122,0,1,1
147,SpokaneStBridge,01/07/2014 03:00:00 AM,48,-122,0,0,0
148,SpokaneStBridge,01/07/2014 04:00:00 AM,48,-122,3,0,3
149,SpokaneStBridge,01/07/2014 05:00:00 AM,48,-122,15,3,18
150,SpokaneStBridge,01/07/2014 06:00:00 AM,48,-122,37,10,47
151,SpokaneStBridge,01/07/2014 07:00:00 AM,48,-122,59,12,71
152,SpokaneStBridge,01/07/2014 08:00:00 AM,48,-122,79,4,83
153,SpokaneStBridge,01/07/2014 09:00:00 AM,48,-122,24,4,28
154,SpokaneStBridge,01/07/2014 10:00:00 AM,48,-122,14,0,14
155,SpokaneStBridge,01/07/2014 11:00:00 AM,48,-122,2,5,7
156,SpokaneStBridge,01/07/2014 12:00:00 PM,48,-122,4,3,7
157,SpokaneStBridge,01/07/2014 01:00:00 PM,48,-122,6,5,11
158,SpokaneStBridge,01/07/2014 02:00:00 PM,48,-122,2,7,9
159,SpokaneStBridge,01/07/2014 03:00:00 PM,48,-122,8,16,24
160,SpokaneStBridge,01/07/2014 04:00:00 PM,48,-122,18,31,49
161,SpokaneStBridge,01/07/2014 05:00:00 PM,48,-122,12,70,82
162,SpokaneStBridge,01/07/2014 06:00:00 PM,48,-122,6,46,52
163,SpokaneStBridge,01/07/2014 07:00:00 PM,48,-122,1,14,15
164,SpokaneStBridge,01/07/2014 08:00:00 PM,48,-122,1,13,14
165,SpokaneStBridge,01/07/2014 09:00:00 PM,48,-122,0,2,2
166,SpokaneStBridge,01/07/2014 10:00:00 PM,48,-122,0,0,0
167,SpokaneStBridge,01/07/2014 11:00:00 PM,48,-122,0,2,2
168,SpokaneStBridge,01/08/2014 12:00:00 AM,48,-122,0,2,2
169,SpokaneStBridge,01/08/2014 01:00:00 AM,48,-122,0,0,0
170,SpokaneStBridge,01/08/2014 02:00:00 AM,48,-122,0,1,1
171,SpokaneStBridge,01/08/2014 03:00:00 AM,48,-122,0,0,0
172,SpokaneStBridge,01/08/2014 04:00:00 AM,48,-122,3,0,3
173,SpokaneStBridge,01/08/2014 05:00:00 AM,48,-122,13,3,16
174,SpokaneStBridge,01/08/2014 06:00:00 AM,48,-122,38,9,47
175,SpokaneStBridge,01/08/2014 07:00:00 AM,48,-122,49,11,60
176,SpokaneStBridge,01/08/2014 08:00:00 AM,48,-122,79,7,86
177,SpokaneStBridge,01/08/2014 09:00:00 AM,48,-122,26,3,29
178,SpokaneStBridge,01/08/2014 10:00:00 AM,48,-122,10,3,13
179,SpokaneStBridge,01/08/2014 11:00:00 AM,48,-122,4,1,5
180,SpokaneStBridge,01/08/2014 12:00:00 PM,48,-122,4,5,9
181,SpokaneStBridge,01/08/2014 01:00:00 PM,48,-122,10,6,16
182,SpokaneStBridge,01/08/2014 02:00:00 PM,48,-122,5,6,11
183,SpokaneStBridge,01/08/2014 03:00:00 PM,48,-122,1,19,20
184,SpokaneStBridge,01/08/2014 04:00:00 PM,48,-122,13,44,57
185,SpokaneStBridge,01/08/2014 05:00:00 PM,48,-122,10,52,62
186,SpokaneStBridge,01/08/2014 06:00:00 PM,48,-122,6,37,43
187,SpokaneStBridge,01/08/2014 07:00:00 PM,48,-122,3,13,16
188,SpokaneStBridge,01/08/2014 08:00:00 PM,48,-122,0,8,8
189,SpokaneStBridge,01/08/2014 09:00:00 PM,48,-122,1,5,6
190,SpokaneStBridge,01/08/2014 10:00:00 PM,48,-122,1,5,6
191,SpokaneStBridge,01/08/2014 11:00:00 PM,48,-122,1,4,5
192,SpokaneStBridge,01/09/2014 12:00:00 AM,48,-122,0,2,2
193,SpokaneStBridge,01/09/2014 01:00:00 AM,48,-122,0,0,0
194,SpokaneStBridge,01/09/2014 02:00:00 AM,48,-122,1,0,1
195,SpokaneStBridge,01/09/2014 03:00:00 AM,48,-122,0,0,0
196,SpokaneStBridge,01/09/2014 04:00:00 AM,48,-122,3,1,4
197,SpokaneStBridge,01/09/2014 05:00:00 AM,48,-122,14,3,17
198,SpokaneStBridge,01/09/2014 06:00:00 AM,48,-122,32,10,42
199,SpokaneStBridge,01/09/2014 07:00:00 AM,48,-122,63,9,72
200,SpokaneStBridge,01/09/2014 08:00:00 AM,48,-122,60,3,63
201,SpokaneStBridge,01/09/2014 09:00:00 AM,48,-122,42,0,42
202,SpokaneStBridge,01/09/2014 10:00:00 AM,48,-122,12,1,13
203,SpokaneStBridge,01/09/2014 11:00:00 AM,48,-122,7,2,9
204,SpokaneStBridge,01/09/2014 12:00:00 PM,48,-122,6,6,12
205,SpokaneStBridge,01/09/2014 01:00:00 PM,48,-122,6,6,12
206,SpokaneStBridge,01/09/2014 02:00:00 PM,48,-122,3,10,13
207,SpokaneStBridge,01/09/2014 03:00:00 PM,48,-122,5,16,21
208,SpokaneStBridge,01/09/2014 04:00:00 PM,48,-122,13,28,41
209,SpokaneStBridge,01/09/2014 05:00:00 PM,48,-122,13,71,84
210,SpokaneStBridge,01/09/2014 06:00:00 PM,48,-122,3,48,51
211,SpokaneStBridge,01/09/2014 07:00:00 PM,48,-122,6,13,19
212,SpokaneStBridge,01/09/2014 08:00:00 PM,48,-122,0,12,12
213,SpokaneStBridge,01/09/2014 09:00:00 PM,48,-122,2,6,8
214,SpokaneStBridge,01/09/2014 10:00:00 PM,48,-122,1,1,2
215,SpokaneStBridge,01/09/2014 11:00:00 PM,48,-122,2,1,3
216,SpokaneStBridge,01/10/2014 12:00:00 AM,48,-122,0,2,2
217,SpokaneStBridge,01/10/2014 01:00:00 AM,48,-122,0,1,1
218,SpokaneStBridge,01/10/2014 02:00:00 AM,48,-122,0,1,1
219,SpokaneStBridge,01/10/2014 03:00:00 AM,48,-122,0,3,3
220,SpokaneStBridge,01/10/2014 04:00:00 AM,48,-122,2,1,3
221,SpokaneStBridge,01/10/2014 05:00:00 AM,48,-122,8,3,11
222,SpokaneStBridge,01/10/2014 06:00:00 AM,48,-122,24,6,30
223,SpokaneStBridge,01/10/2014 07:00:00 AM,48,-122,51,13,64
224,SpokaneStBridge,01/10/2014 08:00:00 AM,48,-122,48,3,51
225,SpokaneStBridge,01/10/2014 09:00:00 AM,48,-122,23,7,30
226,SpokaneStBridge,01/10/2014 10:00:00 AM,48,-122,11,0,11
227,SpokaneStBridge,01/10/2014 11:00:00 AM,48,-122,4,1,5
228,SpokaneStBridge,01/10/2014 12:00:00 PM,48,-122,5,3,8
229,SpokaneStBridge,01/10/2014 01:00:00 PM,48,-122,2,4,6
230,SpokaneStBridge,01/10/2014 02:00:00 PM,48,-122,4,6,10
231,SpokaneStBridge,01/10/2014 03:00:00 PM,48,-122,4,21,25
232,SpokaneStBridge,01/10/2014 04:00:00 PM,48,-122,10,20,30
233,SpokaneStBridge,01/10/2014 05:00:00 PM,48,-122,10,50,60
234,SpokaneStBridge,01/10/2014 06:00:00 PM,48,-122,7,32,39
235,SpokaneStBridge,01/10/2014 07:00:00 PM,48,-122,1,11,12
236,SpokaneStBridge,01/10/2014 08:00:00 PM,48,-122,0,2,2
237,SpokaneStBridge,01/10/2014 09:00:00 PM,48,-122,0,1,1
238,SpokaneStBridge,01/10/2014 10:00:00 PM,48,-122,0,4,4
239,SpokaneStBridge,01/10/2014 11:00:00 PM,48,-122,1,2,3
240,SpokaneStBridge,01/11/2014 12:00:00 AM,48,-122,0,0,0
241,SpokaneStBridge,01/11/2014 01:00:00 AM,48,-122,0,1,1
242,SpokaneStBridge,01/11/2014 02:00:00 AM,48,-122,0,1,1
243,SpokaneStBridge,01/11/2014 03:00:00 AM,48,-122,1,2,3
244,SpokaneStBridge,01/11/2014 04:00:00 AM,48,-122,0,0,0
245,SpokaneStBridge,01/11/2014 05:00:00 AM,48,-122,1,0,1
246,SpokaneStBridge,01/11/2014 06:00:00 AM,48,-122,1,1,2
247,SpokaneStBridge,01/11/2014 07:00:00 AM,48,-122,1,1,2
248,SpokaneStBridge,01/11/2014 08:00:00 AM,48,-122,5,1,6
249,SpokaneStBridge,01/11/2014 09:00:00 AM,48,-122,8,7,15
250,SpokaneStBridge,01/11/2014 10:00:00 AM,48,-122,6,2,8
251,SpokaneStBridge,01/11/2014 11:00:00 AM,48,-122,5,6,11
252,SpokaneStBridge,01/11/2014 12:00:00 PM,48,-122,4,1,5
253,SpokaneStBridge,01/11/2014 01:00:00 PM,48,-122,5,0,5
254,SpokaneStBridge,01/11/2014 02:00:00 PM,48,-122,2,1,3
255,SpokaneStBridge,01/11/2014 03:00:00 PM,48,-122,1,2,3
256,SpokaneStBridge,01/11/2014 04:00:00 PM,48,-122,4,1,5
257,SpokaneStBridge,01/11/2014 05:00:00 PM,48,-122,1,2,3
258,SpokaneStBridge,01/11/2014 06:00:00 PM,48,-122,1,3,4
259,SpokaneStBridge,01/11/2014 07:00:00 PM,48,-122,1,0,1
260,SpokaneStBridge,01/11/2014 08:00:00 PM,48,-122,1,1,2
261,SpokaneStBridge,01/11/2014 09:00:00 PM,48,-122,0,2,2
262,SpokaneStBridge,01/11/2014 10:00:00 PM,48,-122,0,2,2
263,SpokaneStBridge,01/11/2014 11:00:00 PM,48,-122,0,1,1
264,SpokaneStBridge,01/12/2014 12:00:00 AM,48,-122,0,0,0
265,SpokaneStBridge,01/12/2014 01:00:00 AM,48,-122,0,0,0
266,SpokaneStBridge,01/12/2014 02:00:00 AM,48,-122,0,1,1
267,SpokaneStBridge,01/12/2014 03:00:00 AM,48,-122,0,0,0
268,SpokaneStBridge,01/12/2014 04:00:00 AM,48,-122,0,0,0
269,SpokaneStBridge,01/12/2014 05:00:00 AM,48,-122,2,1,3
270,SpokaneStBridge,01/12/2014 06:00:00 AM,48,-122,2,1,3
271,SpokaneStBridge,01/12/2014 07:00:00 AM,48,-122,0,0,0
272,SpokaneStBridge,01/12/2014 08:00:00 AM,48,-122,6,0,6
273,SpokaneStBridge,01/12/2014 09:00:00 AM,48,-122,2,2,4
274,SpokaneStBridge,01/12/2014 10:00:00 AM,48,-122,5,6,11
275,SpokaneStBridge,01/12/2014 11:00:00 AM,48,-122,7,2,9
276,SpokaneStBridge,01/12/2014 12:00:00 PM,48,-122,8,3,11
277,SpokaneStBridge,01/12/2014 01:00:00 PM,48,-122,3,5,8
278,SpokaneStBridge,01/12/2014 02:00:00 PM,48,-122,3,5,8
279,SpokaneStBridge,01/12/2014 03:00:00 PM,48,-122,5,9,14
280,SpokaneStBridge,01/12/2014 04:00:00 PM,48,-122,6,5,11
281,SpokaneStBridge,01/12/2014 05:00:00 PM,48,-122,4,4,8
282,SpokaneStBridge,01/12/2014 06:00:00 PM,48,-122,2,3,5
283,SpokaneStBridge,01/12/2014 07:00:00 PM,48,-122,1,1,2
284,SpokaneStBridge,01/12/2014 08:00:00 PM,48,-122,0,1,1
285,SpokaneStBridge,01/12/2014 09:00:00 PM,48,-122,0,0,0
286,SpokaneStBridge,01/12/2014 10:00:00 PM,48,-122,0,0,0
287,SpokaneStBridge,01/12/2014 11:00:00 PM,48,-122,0,1,1
288,SpokaneStBridge,01/13/2014 12:00:00 AM,48,-122,0,0,0
289,SpokaneStBridge,01/13/2014 01:00:00 AM,48,-122,0,1,1
290,SpokaneStBridge,01/13/2014 02:00:00 AM,48,-122,2,0,2
291,SpokaneStBridge,01/13/2014 03:00:00 AM,48,-122,0,4,4
292,SpokaneStBridge,01/13/2014 04:00:00 AM,48,-122,4,0,4
293,SpokaneStBridge,01/13/2014 05:00:00 AM,48,-122,16,3,19
294,SpokaneStBridge,01/13/2014 06:00:00 AM,48,-122,30,7,37
295,SpokaneStBridge,01/13/2014 07:00:00 AM,48,-122,66,9,75
296,SpokaneStBridge,01/13/2014 08:00:00 AM,48,-122,67,8,75
297,SpokaneStBridge,01/13/2014 09:00:00 AM,48,-122,32,6,38
298,SpokaneStBridge,01/13/2014 10:00:00 AM,48,-122,23,4,27
299,SpokaneStBridge,01/13/2014 11:00:00 AM,48,-122,9,3,12
300,SpokaneStBridge,01/13/2014 12:00:00 PM,48,-122,9,6,15
301,SpokaneStBridge,01/13/2014 01:00:00 PM,48,-122,13,3,16
302,SpokaneStBridge,01/13/2014 02:00:00 PM,48,-122,4,11,15
303,SpokaneStBridge,01/13/2014 03:00:00 PM,48,-122,7,18,25
304,SpokaneStBridge,01/13/2014 04:00:00 PM,48,-122,13,41,54
305,SpokaneStBridge,01/13/2014 05:00:00 PM,48,-122,12,81,93
306,SpokaneStBridge,01/13/2014 06:00:00 PM,48,-122,8,65,73
307,SpokaneStBridge,01/13/2014 07:00:00 PM,48,-122,5,15,20
308,SpokaneStBridge,01/13/2014 08:00:00 PM,48,-122,2,14,16
309,SpokaneStBridge,01/13/2014 09:00:00 PM,48,-122,2,4,6
310,SpokaneStBridge,01/13/2014 10:00:00 PM,48,-122,1,2,3
311,SpokaneStBridge,01/13/2014 11:00:00 PM,48,-122,1,2,3
312,SpokaneStBridge,01/14/2014 12:00:00 AM,48,-122,2,1,3
313,SpokaneStBridge,01/14/2014 01:00:00 AM,48,-122,1,0,1
314,SpokaneStBridge,01/14/2014 02:00:00 AM,48,-122,1,0,1
315,SpokaneStBridge,01/14/2014 03:00:00 AM,48,-122,1,0,1
316,SpokaneStBridge,01/14/2014 04:00:00 AM,48,-122,4,1,5
317,SpokaneStBridge,01/14/2014 05:00:00 AM,48,-122,23,5,28
318,SpokaneStBridge,01/14/2014 06:00:00 AM,48,-122,53,13,66
319,SpokaneStBridge,01/14/2014 07:00:00 AM,48,-122,86,15,101
320,SpokaneStBridge,01/14/2014 08:00:00 AM,48,-122,92,6,98
321,SpokaneStBridge,01/14/2014 09:00:00 AM,48,-122,26,7,33
322,SpokaneStBridge,01/14/2014 10:00:00 AM,48,-122,15,6,21
323,SpokaneStBridge,01/14/2014 11:00:00 AM,48,-122,13,5,18
324,SpokaneStBridge,01/14/2014 12:00:00 PM,48,-122,6,6,12
325,SpokaneStBridge,01/14/2014 01:00:00 PM,48,-122,8,9,17
326,SpokaneStBridge,01/14/2014 02:00:00 PM,48,-122,9,19,28
327,SpokaneStBridge,01/14/2014 03:00:00 PM,48,-122,3,27,30
328,SpokaneStBridge,01/14/2014 04:00:00 PM,48,-122,22,59,81
329,SpokaneStBridge,01/14/2014 05:00:00 PM,48,-122,15,89,104
330,SpokaneStBridge,01/14/2014 06:00:00 PM,48,-122,13,57,70
331,SpokaneStBridge,01/14/2014 07:00:00 PM,48,-122,4,18,22
332,SpokaneStBridge,01/14/2014 08:00:00 PM,48,-122,3,6,9
333,SpokaneStBridge,01/14/2014 09:00:00 PM,48,-122,1,9,10
334,SpokaneStBridge,01/14/2014 10:00:00 PM,48,-122,1,4,5
335,SpokaneStBridge,01/14/2014 11:00:00 PM,48,-122,0,3,3
336,SpokaneStBridge,01/15/2014 12:00:00 AM,48,-122,1,2,3
337,SpokaneStBridge,01/15/2014 01:00:00 AM,48,-122,0,0,0
338,SpokaneStBridge,01/15/2014 02:00:00 AM,48,-122,0,2,2
339,SpokaneStBridge,01/15/2014 03:00:00 AM,48,-122,0,2,2
340,SpokaneStBridge,01/15/2014 04:00:00 AM,48,-122,7,0,7
341,SpokaneStBridge,01/15/2014 05:00:00 AM,48,-122,18,7,25
342,SpokaneStBridge,01/15/2014 06:00:00 AM,48,-122,48,11,59
343,SpokaneStBridge,01/15/2014 07:00:00 AM,48,-122,63,10,73
344,SpokaneStBridge,01/15/2014 08:00:00 AM,48,-122,99,12,111
345,SpokaneStBridge,01/15/2014 09:00:00 AM,48,-122,31,5,36
346,SpokaneStBridge,01/15/2014 10:00:00 AM,48,-122,15,6,21
347,SpokaneStBridge,01/15/2014 11:00:00 AM,48,-122,14,13,27
348,SpokaneStBridge,01/15/2014 12:00:00 PM,48,-122,13,7,20
349,SpokaneStBridge,01/15/2014 01:00:00 PM,48,-122,13,14,27
350,SpokaneStBridge,01/15/2014 02:00:00 PM,48,-122,11,11,22
351,SpokaneStBridge,01/15/2014 03:00:00 PM,48,-122,7,25,32
352,SpokaneStBridge,01/15/2014 04:00:00 PM,48,-122,18,55,73
353,SpokaneStBridge,01/15/2014 05:00:00 PM,48,-122,13,72,85
354,SpokaneStBridge,01/15/2014 06:00:00 PM,48,-122,10,70,80
355,SpokaneStBridge,01/15/2014 07:00:00 PM,48,-122,9,38,47
356,SpokaneStBridge,01/15/2014 08:00:00 PM,48,-122,11,16,27
357,SpokaneStBridge,01/15/2014 09:00:00 PM,48,-122,0,8,8
358,SpokaneStBridge,01/15/2014 10:00:00 PM,48,-122,3,5,8
359,SpokaneStBridge,01/15/2014 11:00:00 PM,48,-122,1,1,2
360,SpokaneStBridge,01/16/2014 12:00:00 AM,48,-122,0,0,0
361,SpokaneStBridge,01/16/2014 01:00:00 AM,48,-122,0,0,0
362,SpokaneStBridge,01/16/2014 02:00:00 AM,48,-122,0,1,1
363,SpokaneStBridge,01/16/2014 03:00:00 AM,48,-122,0,1,1
364,SpokaneStBridge,01/16/2014 04:00:00 AM,48,-122,4,0,4
365,SpokaneStBridge,01/16/2014 05:00:00 AM,48,-122,9,4,13
366,SpokaneStBridge,01/16/2014 06:00:00 AM,48,-122,48,8,56
367,SpokaneStBridge,01/16/2014 07:00:00 AM,48,-122,84,13,97
368,SpokaneStBridge,01/16/2014 08:00:00 AM,48,-122,87,4,91
369,SpokaneStBridge,01/16/2014 09:00:00 AM,48,-122,42,9,51
370,SpokaneStBridge,01/16/2014 10:00:00 AM,48,-122,8,2,10
371,SpokaneStBridge,01/16/2014 11:00:00 AM,48,-122,6,6,12
372,SpokaneStBridge,01/16/2014 12:00:00 PM,48,-122,13,7,20
373,SpokaneStBridge,01/16/2014 01:00:00 PM,48,-122,12,7,19
374,SpokaneStBridge,01/16/2014 02:00:00 PM,48,-122,7,11,18
375,SpokaneStBridge,01/16/2014 03:00:00 PM,48,-122,10,21,31
376,SpokaneStBridge,01/16/2014 04:00:00 PM,48,-122,17,44,61
377,SpokaneStBridge,01/16/2014 05:00:00 PM,48,-122,20,95,115
378,SpokaneStBridge,01/16/2014 06:00:00 PM,48,-122,11,46,57
379,SpokaneStBridge,01/16/2014 07:00:00 PM,48,-122,10,26,36
380,SpokaneStBridge,01/16/2014 08:00:00 PM,48,-122,4,12,16
381,SpokaneStBridge,01/16/2014 09:00:00 PM,48,-122,4,5,9
382,SpokaneStBridge,01/16/2014 10:00:00 PM,48,-122,0,7,7
383,SpokaneStBridge,01/16/2014 11:00:00 PM,48,-122,1,4,5
384,SpokaneStBridge,01/17/2014 12:00:00 AM,48,-122,0,2,2
385,SpokaneStBridge,01/17/2014 01:00:00 AM,48,-122,0,1,1
386,SpokaneStBridge,01/17/2014 02:00:00 AM,48,-122,0,0,0
387,SpokaneStBridge,01/17/2014 03:00:00 AM,48,-122,0,2,2
388,SpokaneStBridge,01/17/2014 04:00:00 AM,48,-122,2,0,2
389,SpokaneStBridge,01/17/2014 05:00:00 AM,48,-122,12,3,15
390,SpokaneStBridge,01/17/2014 06:00:00 AM,48,-122,45,11,56
391,SpokaneStBridge,01/17/2014 07:00:00 AM,48,-122,80,12,92
392,SpokaneStBridge,01/17/2014 08:00:00 AM,48,-122,66,7,73
393,SpokaneStBridge,01/17/2014 09:00:00 AM,48,-122,35,4,39
394,SpokaneStBridge,01/17/2014 10:00:00 AM,48,-122,10,1,11
395,SpokaneStBridge,01/17/2014 11:00:00 AM,48,-122,8,6,14
396,SpokaneStBridge,01/17/2014 12:00:00 PM,48,-122,12,6,18
397,SpokaneStBridge,01/17/2014 01:00:00 PM,48,-122,13,11,24
398,SpokaneStBridge,01/17/2014 02:00:00 PM,48,-122,9,14,23
399,SpokaneStBridge,01/17/2014 03:00:00 PM,48,-122,12,21,33
400,SpokaneStBridge,01/17/2014 04:00:00 PM,48,-122,10,60,70
401,SpokaneStBridge,01/17/2014 05:00:00 PM,48,-122,11,69,80
402,SpokaneStBridge,01/17/2014 06:00:00 PM,48,-122,13,40,53
403,SpokaneStBridge,01/17/2014 07:00:00 PM,48,-122,4,18,22
404,SpokaneStBridge,01/17/2014 08:00:00 PM,48,-122,1,6,7
405,SpokaneStBridge,01/17/2014 09:00:00 PM,48,-122,2,6,8
406,SpokaneStBridge,01/17/2014 10:00:00 PM,48,-122,1,2,3
407,SpokaneStBridge,01/17/2014 11:00:00 PM,48,-122,0,3,3
408,SpokaneStBridge,01/18/2014 12:00:00 AM,48,-122,0,3,3
409,SpokaneStBridge,01/18/2014 01:00:00 AM,48,-122,0,1,1
410,SpokaneStBridge,01/18/2014 02:00:00 AM,48,-122,1,2,3
411,SpokaneStBridge,01/18/2014 03:00:00 AM,48,-122,0,0,0
412,SpokaneStBridge,01/18/2014 04:00:00 AM,48,-122,1,1,2
413,SpokaneStBridge,01/18/2014 05:00:00 AM,48,-122,4,0,4
414,SpokaneStBridge,01/18/2014 06:00:00 AM,48,-122,4,1,5
415,SpokaneStBridge,01/18/2014 07:00:00 AM,48,-122,11,1,12
416,SpokaneStBridge,01/18/2014 08:00:00 AM,48,-122,20,1,21
417,SpokaneStBridge,01/18/2014 09:00:00 AM,48,-122,10,4,14
418,SpokaneStBridge,01/18/2014 10:00:00 AM,48,-122,10,3,13
419,SpokaneStBridge,01/18/2014 11:00:00 AM,48,-122,9,19,28
420,SpokaneStBridge,01/18/2014 12:00:00 PM,48,-122,26,17,43
421,SpokaneStBridge,01/18/2014 01:00:00 PM,48,-122,23,13,36
422,SpokaneStBridge,01/18/2014 02:00:00 PM,48,-122,22,22,44
423,SpokaneStBridge,01/18/2014 03:00:00 PM,48,-122,20,24,44
424,SpokaneStBridge,01/18/2014 04:00:00 PM,48,-122,17,26,43
425,SpokaneStBridge,01/18/2014 05:00:00 PM,48,-122,12,16,28
426,SpokaneStBridge,01/18/2014 06:00:00 PM,48,-122,4,13,17
427,SpokaneStBridge,01/18/2014 07:00:00 PM,48,-122,5,4,9
428,SpokaneStBridge,01/18/2014 08:00:00 PM,48,-122,4,5,9
429,SpokaneStBridge,01/18/2014 09:00:00 PM,48,-122,3,2,5
430,SpokaneStBridge,01/18/2014 10:00:00 PM,48,-122,2,3,5
431,SpokaneStBridge,01/18/2014 11:00:00 PM,48,-122,0,3,3
432,SpokaneStBridge,01/19/2014 12:00:00 AM,48,-122,0,0,0
433,SpokaneStBridge,01/19/2014 01:00:00 AM,48,-122,0,3,3
434,SpokaneStBridge,01/19/2014 02:00:00 AM,48,-122,3,1,4
435,SpokaneStBridge,01/19/2014 03:00:00 AM,48,-122,0,1,1
436,SpokaneStBridge,01/19/2014 04:00:00 AM,48,-122,0,2,2
437,SpokaneStBridge,01/19/2014 05:00:00 AM,48,-122,3,0,3
438,SpokaneStBridge,01/19/2014 06:00:00 AM,48,-122,3,0,3
439,SpokaneStBridge,01/19/2014 07:00:00 AM,48,-122,3,1,4
440,SpokaneStBridge,01/19/2014 08:00:00 AM,48,-122,9,2,11
441,SpokaneStBridge,01/19/2014 09:00:00 AM,48,-122,13,5,18
442,SpokaneStBridge,01/19/2014 10:00:00 AM,48,-122,14,14,28
443,SpokaneStBridge,01/19/2014 11:00:00 AM,48,-122,17,17,34
444,SpokaneStBridge,01/19/2014 12:00:00 PM,48,-122,19,16,35
445,SpokaneStBridge,01/19/2014 01:00:00 PM,48,-122,10,6,16
446,SpokaneStBridge,01/19/2014 02:00:00 PM,48,-122,15,10,25
447,SpokaneStBridge,01/19/2014 03:00:00 PM,48,-122,2,4,6
448,SpokaneStBridge,01/19/2014 04:00:00 PM,48,-122,0,6,6
449,SpokaneStBridge,01/19/2014 05:00:00 PM,48,-122,3,2,5
450,SpokaneStBridge,01/19/2014 06:00:00 PM,48,-122,0,2,2
451,SpokaneStBridge,01/19/2014 07:00:00 PM,48,-122,2,7,9
452,SpokaneStBridge,01/19/2014 08:00:00 PM,48,-122,3,5,8
453,SpokaneStBridge,01/19/2014 09:00:00 PM,48,-122,2,4,6
454,SpokaneStBridge,01/19/2014 10:00:00 PM,48,-122,1,1,2
455,SpokaneStBridge,01/19/2014 11:00:00 PM,48,-122,0,0,0
456,SpokaneStBridge,01/20/2014 12:00:00 AM,48,-122,0,0,0
457,SpokaneStBridge,01/20/2014 01:00:00 AM,48,-122,0,0,0
458,SpokaneStBridge,01/20/2014 02:00:00 AM,48,-122,2,1,3
459,SpokaneStBridge,01/20/2014 03:00:00 AM,48,-122,1,1,2
460,SpokaneStBridge,01/20/2014 04:00:00 AM,48,-122,3,1,4
461,SpokaneStBridge,01/20/2014 05:00:00 AM,48,-122,7,5,12
462,SpokaneStBridge,01/20/2014 06:00:00 AM,48,-122,21,6,27
463,SpokaneStBridge,01/20/2014 07:00:00 AM,48,-122,37,10,47
464,SpokaneStBridge,01/20/2014 08:00:00 AM,48,-122,43,3,46
465,SpokaneStBridge,01/20/2014 09:00:00 AM,48,-122,22,7,29
466,SpokaneStBridge,01/20/2014 10:00:00 AM,48,-122,21,9,30
467,SpokaneStBridge,01/20/2014 11:00:00 AM,48,-122,7,7,14
468,SpokaneStBridge,01/20/2014 12:00:00 PM,48,-122,13,20,33
469,SpokaneStBridge,01/20/2014 01:00:00 PM,48,-122,15,10,25
470,SpokaneStBridge,01/20/2014 02:00:00 PM,48,-122,14,17,31
471,SpokaneStBridge,01/20/2014 03:00:00 PM,48,-122,23,34,57
472,SpokaneStBridge,01/20/2014 04:00:00 PM,48,-122,25,40,65
473,SpokaneStBridge,01/20/2014 05:00:00 PM,48,-122,11,39,50
474,SpokaneStBridge,01/20/2014 06:00:00 PM,48,-122,8,28,36
475,SpokaneStBridge,01/20/2014 07:00:00 PM,48,-122,4,16,20
476,SpokaneStBridge,01/20/2014 08:00:00 PM,48,-122,2,7,9
477,SpokaneStBridge,01/20/2014 09:00:00 PM,48,-122,0,3,3
478,SpokaneStBridge,01/20/2014 10:00:00 PM,48,-122,0,2,2
479,SpokaneStBridge,01/20/2014 11:00:00 PM,48,-122,0,1,1
480,SpokaneStBridge,01/21/2014 12:00:00 AM,48,-122,0,0,0
481,SpokaneStBridge,01/21/2014 01:00:00 AM,48,-122,0,0,0
482,SpokaneStBridge,01/21/2014 02:00:00 AM,48,-122,0,1,1
483,SpokaneStBridge,01/21/2014 03:00:00 AM,48,-122,0,1,1
484,SpokaneStBridge,01/21/2014 04:00:00 AM,48,-122,2,0,2
485,SpokaneStBridge,01/21/2014 05:00:00 AM,48,-122,22,4,26
486,SpokaneStBridge,01/21/2014 06:00:00 AM,48,-122,46,10,56
487,SpokaneStBridge,01/21/2014 07:00:00 AM,48,-122,87,11,98
488,SpokaneStBridge,01/21/2014 08:00:00 AM,48,-122,94,5,99
489,SpokaneStBridge,01/21/2014 09:00:00 AM,48,-122,30,4,34
490,SpokaneStBridge,01/21/2014 10:00:00 AM,48,-122,12,1,13
491,SpokaneStBridge,01/21/2014 11:00:00 AM,48,-122,9,7,16
492,SpokaneStBridge,01/21/2014 12:00:00 PM,48,-122,10,8,18
493,SpokaneStBridge,01/21/2014 01:00:00 PM,48,-122,14,5,19
494,SpokaneStBridge,01/21/2014 02:00:00 PM,48,-122,7,13,20
495,SpokaneStBridge,01/21/2014 03:00:00 PM,48,-122,9,32,41
496,SpokaneStBridge,01/21/2014 04:00:00 PM,48,-122,13,51,64
497,SpokaneStBridge,01/21/2014 05:00:00 PM,48,-122,21,82,103
498,SpokaneStBridge,01/21/2014 06:00:00 PM,48,-122,7,74,81
499,SpokaneStBridge,01/21/2014 07:00:00 PM,48,-122,6,21,27
500,SpokaneStBridge,01/21/2014 08:00:00 PM,48,-122,1,12,13
501,SpokaneStBridge,01/21/2014 09:00:00 PM,48,-122,3,10,13
502,SpokaneStBridge,01/21/2014 10:00:00 PM,48,-122,1,3,4
503,SpokaneStBridge,01/21/2014 11:00:00 PM,48,-122,0,1,1
504,SpokaneStBridge,01/22/2014 12:00:00 AM,48,-122,0,2,2
505,SpokaneStBridge,01/22/2014 01:00:00 AM,48,-122,0,1,1
506,SpokaneStBridge,01/22/2014 02:00:00 AM,48,-122,0,0,0
507,SpokaneStBridge,01/22/2014 03:00:00 AM,48,-122,0,2,2
508,SpokaneStBridge,01/22/2014 04:00:00 AM,48,-122,9,0,9
509,SpokaneStBridge,01/22/2014 05:00:00 AM,48,-122,14,3,17
510,SpokaneStBridge,01/22/2014 06:00:00 AM,48,-122,49,8,57
511,SpokaneStBridge,01/22/2014 07:00:00 AM,48,-122,77,17,94
512,SpokaneStBridge,01/22/2014 08:00:00 AM,48,-122,87,10,97
513,SpokaneStBridge,01/22/2014 09:00:00 AM,48,-122,27,5,32
514,SpokaneStBridge,01/22/2014 10:00:00 AM,48,-122,20,5,25
515,SpokaneStBridge,01/22/2014 11:00:00 AM,48,-122,12,7,19
516,SpokaneStBridge,01/22/2014 12:00:00 PM,48,-122,5,7,12
517,SpokaneStBridge,01/22/2014 01:00:00 PM,48,-122,15,5,20
518,SpokaneStBridge,01/22/2014 02:00:00 PM,48,-122,6,16,22
519,SpokaneStBridge,01/22/2014 03:00:00 PM,48,-122,8,30,38
520,SpokaneStBridge,01/22/2014 04:00:00 PM,48,-122,15,43,58
521,SpokaneStBridge,01/22/2014 05:00:00 PM,48,-122,15,97,112
522,SpokaneStBridge,01/22/2014 06:00:00 PM,48,-122,12,65,77
523,SpokaneStBridge,01/22/2014 07:00:00 PM,48,-122,3,16,19
524,SpokaneStBridge,01/22/2014 08:00:00 PM,48,-122,2,23,25
525,SpokaneStBridge,01/22/2014 09:00:00 PM,48,-122,0,5,5
526,SpokaneStBridge,01/22/2014 10:00:00 PM,48,-122,2,5,7
527,SpokaneStBridge,01/22/2014 11:00:00 PM,48,-122,0,2,2
528,SpokaneStBridge,01/23/2014 12:00:00 AM,48,-122,0,1,1
529,SpokaneStBridge,01/23/2014 01:00:00 AM,48,-122,0,1,1
530,SpokaneStBridge,01/23/2014 02:00:00 AM,48,-122,0,1,1
531,SpokaneStBridge,01/23/2014 03:00:00 AM,48,-122,2,1,3
532,SpokaneStBridge,01/23/2014 04:00:00 AM,48,-122,5,1,6
533,SpokaneStBridge,01/23/2014 05:00:00 AM,48,-122,16,2,18
534,SpokaneStBridge,01/23/2014 06:00:00 AM,48,-122,51,7,58
535,SpokaneStBridge,01/23/2014 07:00:00 AM,48,-122,81,8,89
536,SpokaneStBridge,01/23/2014 08:00:00 AM,48,-122,89,4,93
537,SpokaneStBridge,01/23/2014 09:00:00 AM,48,-122,32,4,36
538,SpokaneStBridge,01/23/2014 10:00:00 AM,48,-122,12,10,22
539,SpokaneStBridge,01/23/2014 11:00:00 AM,48,-122,7,7,14
540,SpokaneStBridge,01/23/2014 12:00:00 PM,48,-122,9,8,17
541,SpokaneStBridge,01/23/2014 01:00:00 PM,48,-122,15,7,22
542,SpokaneStBridge,01/23/2014 02:00:00 PM,48,-122,17,16,33
543,SpokaneStBridge,01/23/2014 03:00:00 PM,48,-122,16,37,53
544,SpokaneStBridge,01/23/2014 04:00:00 PM,48,-122,30,56,86
545,SpokaneStBridge,01/23/2014 05:00:00 PM,48,-122,12,92,104
546,SpokaneStBridge,01/23/2014 06:00:00 PM,48,-122,5,51,56
547,SpokaneStBridge,01/23/2014 07:00:00 PM,48,-122,3,24,27
548,SpokaneStBridge,01/23/2014 08:00:00 PM,48,-122,6,11,17
549,SpokaneStBridge,01/23/2014 09:00:00 PM,48,-122,5,5,10
550,SpokaneStBridge,01/23/2014 10:00:00 PM,48,-122,2,9,11
551,SpokaneStBridge,01/23/2014 11:00:00 PM,48,-122,1,3,4
552,SpokaneStBridge,01/24/2014 12:00:00 AM,48,-122,0,2,2
553,SpokaneStBridge,01/24/2014 01:00:00 AM,48,-122,0,1,1
554,SpokaneStBridge,01/24/2014 02:00:00 AM,48,-122,1,1,2
555,SpokaneStBridge,01/24/2014 03:00:00 AM,48,-122,2,2,4
556,SpokaneStBridge,01/24/2014 04:00:00 AM,48,-122,5,0,5
557,SpokaneStBridge,01/24/2014 05:00:00 AM,48,-122,13,3,16
558,SpokaneStBridge,01/24/2014 06:00:00 AM,48,-122,37,6,43
559,SpokaneStBridge,01/24/2014 07:00:00 AM,48,-122,76,9,85
560,SpokaneStBridge,01/24/2014 08:00:00 AM,48,-122,76,8,84
561,SpokaneStBridge,01/24/2014 09:00:00 AM,48,-122,27,1,28
562,SpokaneStBridge,01/24/2014 10:00:00 AM,48,-122,14,3,17
563,SpokaneStBridge,01/24/2014 11:00:00 AM,48,-122,15,5,20
564,SpokaneStBridge,01/24/2014 12:00:00 PM,48,-122,5,5,10
565,SpokaneStBridge,01/24/2014 01:00:00 PM,48,-122,12,9,21
566,SpokaneStBridge,01/24/2014 02:00:00 PM,48,-122,13,25,38
567,SpokaneStBridge,01/24/2014 03:00:00 PM,48,-122,12,35,47
568,SpokaneStBridge,01/24/2014 04:00:00 PM,48,-122,18,49,67
569,SpokaneStBridge,01/24/2014 05:00:00 PM,48,-122,17,79,96
570,SpokaneStBridge,01/24/2014 06:00:00 PM,48,-122,7,49,56
571,SpokaneStBridge,01/24/2014 07:00:00 PM,48,-122,7,11,18
572,SpokaneStBridge,01/24/2014 08:00:00 PM,48,-122,2,10,12
573,SpokaneStBridge,01/24/2014 09:00:00 PM,48,-122,0,4,4
574,SpokaneStBridge,01/24/2014 10:00:00 PM,48,-122,1,5,6
575,SpokaneStBridge,01/24/2014 11:00:00 PM,48,-122,2,2,4
576,SpokaneStBridge,01/25/2014 12:00:00 AM,48,-122,0,3,3
577,SpokaneStBridge,01/25/2014 01:00:00 AM,48,-122,0,1,1
578,SpokaneStBridge,01/25/2014 02:00:00 AM,48,-122,0,0,0
579,SpokaneStBridge,01/25/2014 03:00:00 AM,48,-122,0,1,1
580,SpokaneStBridge,01/25/2014 04:00:00 AM,48,-122,2,1,3
581,SpokaneStBridge,01/25/2014 05:00:00 AM,48,-122,1,0,1
582,SpokaneStBridge,01/25/2014 06:00:00 AM,48,-122,6,0,6
583,SpokaneStBridge,01/25/2014 07:00:00 AM,48,-122,8,1,9
584,SpokaneStBridge,01/25/2014 08:00:00 AM,48,-122,12,7,19
585,SpokaneStBridge,01/25/2014 09:00:00 AM,48,-122,18,3,21
586,SpokaneStBridge,01/25/2014 10:00:00 AM,48,-122,16,9,25
587,SpokaneStBridge,01/25/2014 11:00:00 AM,48,-122,12,19,31
588,SpokaneStBridge,01/25/2014 12:00:00 PM,48,-122,17,28,45
589,SpokaneStBridge,01/25/2014 01:00:00 PM,48,-122,44,26,70
590,SpokaneStBridge,01/25/2014 02:00:00 PM,48,-122,40,26,66
591,SpokaneStBridge,01/25/2014 03:00:00 PM,48,-122,21,43,64
592,SpokaneStBridge,01/25/2014 04:00:00 PM,48,-122,36,19,55
593,SpokaneStBridge,01/25/2014 05:00:00 PM,48,-122,6,11,17
594,SpokaneStBridge,01/25/2014 06:00:00 PM,48,-122,2,4,6
595,SpokaneStBridge,01/25/2014 07:00:00 PM,48,-122,0,7,7
596,SpokaneStBridge,01/25/2014 08:00:00 PM,48,-122,2,0,2
597,SpokaneStBridge,01/25/2014 09:00:00 PM,48,-122,1,1,2
598,SpokaneStBridge,01/25/2014 10:00:00 PM,48,-122,0,1,1
599,SpokaneStBridge,01/25/2014 11:00:00 PM,48,-122,0,2,2
600,SpokaneStBridge,01/26/2014 12:00:00 AM,48,-122,0,3,3
601,SpokaneStBridge,01/26/2014 01:00:00 AM,48,-122,4,1,5
602,SpokaneStBridge,01/26/2014 02:00:00 AM,48,-122,1,1,2
603,SpokaneStBridge,01/26/2014 03:00:00 AM,48,-122,1,0,1
604,SpokaneStBridge,01/26/2014 04:00:00 AM,48,-122,1,1,2
605,SpokaneStBridge,01/26/2014 05:00:00 AM,48,-122,2,0,2
606,SpokaneStBridge,01/26/2014 06:00:00 AM,48,-122,2,0,2
607,SpokaneStBridge,01/26/2014 07:00:00 AM,48,-122,5,2,7
608,SpokaneStBridge,01/26/2014 08:00:00 AM,48,-122,8,1,9
609,SpokaneStBridge,01/26/2014 09:00:00 AM,48,-122,11,8,19
610,SpokaneStBridge,01/26/2014 10:00:00 AM,48,-122,9,10,19
611,SpokaneStBridge,01/26/2014 11:00:00 AM,48,-122,13,22,35
612,SpokaneStBridge,01/26/2014 12:00:00 PM,48,-122,17,29,46
613,SpokaneStBridge,01/26/2014 01:00:00 PM,48,-122,28,11,39
614,SpokaneStBridge,01/26/2014 02:00:00 PM,48,-122,26,31,57
615,SpokaneStBridge,01/26/2014 03:00:00 PM,48,-122,18,27,45
616,SpokaneStBridge,01/26/2014 04:00:00 PM,48,-122,23,19,42
617,SpokaneStBridge,01/26/2014 05:00:00 PM,48,-122,3,13,16
618,SpokaneStBridge,01/26/2014 06:00:00 PM,48,-122,4,6,10
619,SpokaneStBridge,01/26/2014 07:00:00 PM,48,-122,1,0,1
620,SpokaneStBridge,01/26/2014 08:00:00 PM,48,-122,1,2,3
621,SpokaneStBridge,01/26/2014 09:00:00 PM,48,-122,2,0,2
622,SpokaneStBridge,01/26/2014 10:00:00 PM,48,-122,0,1,1
623,SpokaneStBridge,01/26/2014 11:00:00 PM,48,-122,2,1,3
624,SpokaneStBridge,01/27/2014 12:00:00 AM,48,-122,1,1,2
625,SpokaneStBridge,01/27/2014 01:00:00 AM,48,-122,0,0,0
626,SpokaneStBridge,01/27/2014 02:00:00 AM,48,-122,0,0,0
627,SpokaneStBridge,01/27/2014 03:00:00 AM,48,-122,0,1,1
628,SpokaneStBridge,01/27/2014 04:00:00 AM,48,-122,5,0,5
629,SpokaneStBridge,01/27/2014 05:00:00 AM,48,-122,11,4,15
630,SpokaneStBridge,01/27/2014 06:00:00 AM,48,-122,36,9,45
631,SpokaneStBridge,01/27/2014 07:00:00 AM,48,-122,81,13,94
632,SpokaneStBridge,01/27/2014 08:00:00 AM,48,-122,81,1,82
633,SpokaneStBridge,01/27/2014 09:00:00 AM,48,-122,29,4,33
634,SpokaneStBridge,01/27/2014 10:00:00 AM,48,-122,15,4,19
635,SpokaneStBridge,01/27/2014 11:00:00 AM,48,-122,6,0,6
636,SpokaneStBridge,01/27/2014 12:00:00 PM,48,-122,7,8,15
637,SpokaneStBridge,01/27/2014 01:00:00 PM,48,-122,8,5,13
638,SpokaneStBridge,01/27/2014 02:00:00 PM,48,-122,9,9,18
639,SpokaneStBridge,01/27/2014 03:00:00 PM,48,-122,8,24,32
640,SpokaneStBridge,01/27/2014 04:00:00 PM,48,-122,18,46,64
641,SpokaneStBridge,01/27/2014 05:00:00 PM,48,-122,12,93,105
642,SpokaneStBridge,01/27/2014 06:00:00 PM,48,-122,5,56,61
643,SpokaneStBridge,01/27/2014 07:00:00 PM,48,-122,1,21,22
644,SpokaneStBridge,01/27/2014 08:00:00 PM,48,-122,1,11,12
645,SpokaneStBridge,01/27/2014 09:00:00 PM,48,-122,2,2,4
646,SpokaneStBridge,01/27/2014 10:00:00 PM,48,-122,0,3,3
647,SpokaneStBridge,01/27/2014 11:00:00 PM,48,-122,0,4,4
648,SpokaneStBridge,01/28/2014 12:00:00 AM,48,-122,1,1,2
649,SpokaneStBridge,01/28/2014 01:00:00 AM,48,-122,0,0,0
650,SpokaneStBridge,01/28/2014 02:00:00 AM,48,-122,0,0,0
651,SpokaneStBridge,01/28/2014 03:00:00 AM,48,-122,1,0,1
652,SpokaneStBridge,01/28/2014 04:00:00 AM,48,-122,2,1,3
653,SpokaneStBridge,01/28/2014 05:00:00 AM,48,-122,16,6,22
654,SpokaneStBridge,01/28/2014 06:00:00 AM,48,-122,43,8,51
655,SpokaneStBridge,01/28/2014 07:00:00 AM,48,-122,73,11,84
656,SpokaneStBridge,01/28/2014 08:00:00 AM,48,-122,91,3,94
657,SpokaneStBridge,01/28/2014 09:00:00 AM,48,-122,23,3,26
658,SpokaneStBridge,01/28/2014 10:00:00 AM,48,-122,7,2,9
659,SpokaneStBridge,01/28/2014 11:00:00 AM,48,-122,6,7,13
660,SpokaneStBridge,01/28/2014 12:00:00 PM,48,-122,7,5,12
661,SpokaneStBridge,01/28/2014 01:00:00 PM,48,-122,7,6,13
662,SpokaneStBridge,01/28/2014 02:00:00 PM,48,-122,7,14,21
663,SpokaneStBridge,01/28/2014 03:00:00 PM,48,-122,9,28,37
664,SpokaneStBridge,01/28/2014 04:00:00 PM,48,-122,15,39,54
665,SpokaneStBridge,01/28/2014 05:00:00 PM,48,-122,11,96,107
666,SpokaneStBridge,01/28/2014 06:00:00 PM,48,-122,9,53,62
667,SpokaneStBridge,01/28/2014 07:00:00 PM,48,-122,4,14,18
668,SpokaneStBridge,01/28/2014 08:00:00 PM,48,-122,1,7,8
669,SpokaneStBridge,01/28/2014 09:00:00 PM,48,-122,3,2,5
670,SpokaneStBridge,01/28/2014 10:00:00 PM,48,-122,0,3,3
671,SpokaneStBridge,01/28/2014 11:00:00 PM,48,-122,0,1,1
672,SpokaneStBridge,01/29/2014 12:00:00 AM,48,-122,0,2,2
673,SpokaneStBridge,01/29/2014 01:00:00 AM,48,-122,0,0,0
674,SpokaneStBridge,01/29/2014 02:00:00 AM,48,-122,0,1,1
675,SpokaneStBridge,01/29/2014 03:00:00 AM,48,-122,0,1,1
676,SpokaneStBridge,01/29/2014 04:00:00 AM,48,-122,2,2,4
677,SpokaneStBridge,01/29/2014 05:00:00 AM,48,-122,8,3,11
678,SpokaneStBridge,01/29/2014 06:00:00 AM,48,-122,34,8,42
679,SpokaneStBridge,01/29/2014 07:00:00 AM,48,-122,59,6,65
680,SpokaneStBridge,01/29/2014 08:00:00 AM,48,-122,75,7,82
681,SpokaneStBridge,01/29/2014 09:00:00 AM,48,-122,17,4,21
682,SpokaneStBridge,01/29/2014 10:00:00 AM,48,-122,6,0,6
683,SpokaneStBridge,01/29/2014 11:00:00 AM,48,-122,4,3,7
684,SpokaneStBridge,01/29/2014 12:00:00 PM,48,-122,3,3,6
685,SpokaneStBridge,01/29/2014 01:00:00 PM,48,-122,4,2,6
686,SpokaneStBridge,01/29/2014 02:00:00 PM,48,-122,4,6,10
687,SpokaneStBridge,01/29/2014 03:00:00 PM,48,-122,8,19,27
688,SpokaneStBridge,01/29/2014 04:00:00 PM,48,-122,11,31,42
689,SpokaneStBridge,01/29/2014 05:00:00 PM,48,-122,14,55,69
690,SpokaneStBridge,01/29/2014 06:00:00 PM,48,-122,9,46,55
691,SpokaneStBridge,01/29/2014 07:00:00 PM,48,-122,4,19,23
692,SpokaneStBridge,01/29/2014 08:00:00 PM,48,-122,2,9,11
693,SpokaneStBridge,01/29/2014 09:00:00 PM,48,-122,1,3,4
694,SpokaneStBridge,01/29/2014 10:00:00 PM,48,-122,1,4,5
695,SpokaneStBridge,01/29/2014 11:00:00 PM,48,-122,0,2,2
696,SpokaneStBridge,01/30/2014 12:00:00 AM,48,-122,0,1,1
697,SpokaneStBridge,01/30/2014 01:00:00 AM,48,-122,0,2,2
698,SpokaneStBridge,01/30/2014 02:00:00 AM,48,-122,0,2,2
699,SpokaneStBridge,01/30/2014 03:00:00 AM,48,-122,0,0,0
700,SpokaneStBridge,01/30/2014 04:00:00 AM,48,-122,1,1,2
701,SpokaneStBridge,01/30/2014 05:00:00 AM,48,-122,8,3,11
702,SpokaneStBridge,01/30/2014 06:00:00 AM,48,-122,39,7,46
703,SpokaneStBridge,01/30/2014 07:00:00 AM,48,-122,51,12,63
704,SpokaneStBridge,01/30/2014 08:00:00 AM,48,-122,77,4,81
705,SpokaneStBridge,01/30/2014 09:00:00 AM,48,-122,31,5,36
706,SpokaneStBridge,01/30/2014 10:00:00 AM,48,-122,8,1,9
707,SpokaneStBridge,01/30/2014 11:00:00 AM,48,-122,5,5,10
708,SpokaneStBridge,01/30/2014 12:00:00 PM,48,-122,6,4,10
709,SpokaneStBridge,01/30/2014 01:00:00 PM,48,-122,9,9,18
710,SpokaneStBridge,01/30/2014 02:00:00 PM,48,-122,14,12,26
711,SpokaneStBridge,01/30/2014 03:00:00 PM,48,-122,9,18,27
712,SpokaneStBridge,01/30/2014 04:00:00 PM,48,-122,17,40,57
713,SpokaneStBridge,01/30/2014 05:00:00 PM,48,-122,9,81,90
714,SpokaneStBridge,01/30/2014 06:00:00 PM,48,-122,6,48,54
715,SpokaneStBridge,01/30/2014 07:00:00 PM,48,-122,3,19,22
716,SpokaneStBridge,01/30/2014 08:00:00 PM,48,-122,5,6,11
717,SpokaneStBridge,01/30/2014 09:00:00 PM,48,-122,1,6,7
718,SpokaneStBridge,01/30/2014 10:00:00 PM,48,-122,3,3,6
719,SpokaneStBridge,01/30/2014 11:00:00 PM,48,-122,3,5,8
720,SpokaneStBridge,01/31/2014 12:00:00 AM,48,-122,1,1,2
721,SpokaneStBridge,01/31/2014 01:00:00 AM,48,-122,1,1,2
722,SpokaneStBridge,01/31/2014 02:00:00 AM,48,-122,1,1,2
723,SpokaneStBridge,01/31/2014 03:00:00 AM,48,-122,1,1,2
724,SpokaneStBridge,01/31/2014 04:00:00 AM,48,-122,3,0,3
725,SpokaneStBridge,01/31/2014 05:00:00 AM,48,-122,12,3,15
726,SpokaneStBridge,01/31/2014 06:00:00 AM,48,-122,29,8,37
727,SpokaneStBridge,01/31/2014 07:00:00 AM,48,-122,55,10,65
728,SpokaneStBridge,01/31/2014 08:00:00 AM,48,-122,64,4,68
729,SpokaneStBridge,01/31/2014 09:00:00 AM,48,-122,31,5,36
730,SpokaneStBridge,01/31/2014 10:00:00 AM,48,-122,12,8,20
731,SpokaneStBridge,01/31/2014 11:00:00 AM,48,-122,7,3,10
732,SpokaneStBridge,01/31/2014 12:00:00 PM,48,-122,9,9,18
733,SpokaneStBridge,01/31/2014 01:00:00 PM,48,-122,13,8,21
734,SpokaneStBridge,01/31/2014 02:00:00 PM,48,-122,11,7,18
735,SpokaneStBridge,01/31/2014 03:00:00 PM,48,-122,8,27,35
736,SpokaneStBridge,01/31/2014 04:00:00 PM,48,-122,10,45,55
737,SpokaneStBridge,01/31/2014 05:00:00 PM,48,-122,13,68,81
738,SpokaneStBridge,01/31/2014 06:00:00 PM,48,-122,10,31,41
739,SpokaneStBridge,01/31/2014 07:00:00 PM,48,-122,5,13,18
740,SpokaneStBridge,01/31/2014 08:00:00 PM,48,-122,0,0,0
741,SpokaneStBridge,01/31/2014 09:00:00 PM,48,-122,0,0,0
742,SpokaneStBridge,01/31/2014 10:00:00 PM,48,-122,0,0,0
743,SpokaneStBridge,01/31/2014 11:00:00 PM,48,-122,0,0,0
744,SpokaneStBridge,02/01/2014 12:00:00 AM,48,-122,0,4,4
745,SpokaneStBridge,02/01/2014 01:00:00 AM,48,-122,0,0,0
746,SpokaneStBridge,02/01/2014 02:00:00 AM,48,-122,0,0,0
747,SpokaneStBridge,02/01/2014 03:00:00 AM,48,-122,0,1,1
748,SpokaneStBridge,02/01/2014 04:00:00 AM,48,-122,1,0,1
749,SpokaneStBridge,02/01/2014 05:00:00 AM,48,-122,3,0,3
750,SpokaneStBridge,02/01/2014 06:00:00 AM,48,-122,6,1,7
751,SpokaneStBridge,02/01/2014 07:00:00 AM,48,-122,8,3,11
752,SpokaneStBridge,02/01/2014 08:00:00 AM,48,-122,25,8,33
753,SpokaneStBridge,02/01/2014 09:00:00 AM,48,-122,12,23,35
754,SpokaneStBridge,02/01/2014 10:00:00 AM,48,-122,16,18,34
755,SpokaneStBridge,02/01/2014 11:00:00 AM,48,-122,13,27,40
756,SpokaneStBridge,02/01/2014 12:00:00 PM,48,-122,23,14,37
757,SpokaneStBridge,02/01/2014 01:00:00 PM,48,-122,10,18,28
758,SpokaneStBridge,02/01/2014 02:00:00 PM,48,-122,19,13,32
759,SpokaneStBridge,02/01/2014 03:00:00 PM,48,-122,19,22,41
760,SpokaneStBridge,02/01/2014 04:00:00 PM,48,-122,6,16,22
761,SpokaneStBridge,02/01/2014 05:00:00 PM,48,-122,13,7,20
762,SpokaneStBridge,02/01/2014 06:00:00 PM,48,-122,9,7,16
763,SpokaneStBridge,02/01/2014 07:00:00 PM,48,-122,1,7,8
764,SpokaneStBridge,02/01/2014 08:00:00 PM,48,-122,0,5,5
765,SpokaneStBridge,02/01/2014 09:00:00 PM,48,-122,2,3,5
766,SpokaneStBridge,02/01/2014 10:00:00 PM,48,-122,0,3,3
767,SpokaneStBridge,02/01/2014 11:00:00 PM,48,-122,1,1,2
768,SpokaneStBridge,02/02/2014 12:00:00 AM,48,-122,0,2,2
769,SpokaneStBridge,02/02/2014 01:00:00 AM,48,-122,0,3,3
770,SpokaneStBridge,02/02/2014 02:00:00 AM,48,-122,0,0,0
771,SpokaneStBridge,02/02/2014 03:00:00 AM,48,-122,1,0,1
772,SpokaneStBridge,02/02/2014 04:00:00 AM,48,-122,0,1,1
773,SpokaneStBridge,02/02/2014 05:00:00 AM,48,-122,0,2,2
774,SpokaneStBridge,02/02/2014 06:00:00 AM,48,-122,1,1,2
775,SpokaneStBridge,02/02/2014 07:00:00 AM,48,-122,4,5,9
776,SpokaneStBridge,02/02/2014 08:00:00 AM,48,-122,7,5,12
777,SpokaneStBridge,02/02/2014 09:00:00 AM,48,-122,7,5,12
778,SpokaneStBridge,02/02/2014 10:00:00 AM,48,-122,20,10,30
779,SpokaneStBridge,02/02/2014 11:00:00 AM,48,-122,13,28,41
780,SpokaneStBridge,02/02/2014 12:00:00 PM,48,-122,27,17,44
781,SpokaneStBridge,02/02/2014 01:00:00 PM,48,-122,22,19,41
782,SpokaneStBridge,02/02/2014 02:00:00 PM,48,-122,16,20,36
783,SpokaneStBridge,02/02/2014 03:00:00 PM,48,-122,4,9,13
784,SpokaneStBridge,02/02/2014 04:00:00 PM,48,-122,7,9,16
785,SpokaneStBridge,02/02/2014 05:00:00 PM,48,-122,4,3,7
786,SpokaneStBridge,02/02/2014 06:00:00 PM,48,-122,3,2,5
787,SpokaneStBridge,02/02/2014 07:00:00 PM,48,-122,2,0,2
788,SpokaneStBridge,02/02/2014 08:00:00 PM,48,-122,5,3,8
789,SpokaneStBridge,02/02/2014 09:00:00 PM,48,-122,2,1,3
790,SpokaneStBridge,02/02/2014 10:00:00 PM,48,-122,2,1,3
791,SpokaneStBridge,02/02/2014 11:00:00 PM,48,-122,1,2,3
792,SpokaneStBridge,02/03/2014 12:00:00 AM,48,-122,1,1,2
793,SpokaneStBridge,02/03/2014 01:00:00 AM,48,-122,0,2,2
794,SpokaneStBridge,02/03/2014 02:00:00 AM,48,-122,0,1,1
795,SpokaneStBridge,02/03/2014 03:00:00 AM,48,-122,0,2,2
796,SpokaneStBridge,02/03/2014 04:00:00 AM,48,-122,3,1,4
797,SpokaneStBridge,02/03/2014 05:00:00 AM,48,-122,12,5,17
798,SpokaneStBridge,02/03/2014 06:00:00 AM,48,-122,36,10,46
799,SpokaneStBridge,02/03/2014 07:00:00 AM,48,-122,63,9,72
800,SpokaneStBridge,02/03/2014 08:00:00 AM,48,-122,76,3,79
801,SpokaneStBridge,02/03/2014 09:00:00 AM,48,-122,33,6,39
802,SpokaneStBridge,02/03/2014 10:00:00 AM,48,-122,15,1,16
803,SpokaneStBridge,02/03/2014 11:00:00 AM,48,-122,6,5,11
804,SpokaneStBridge,02/03/2014 12:00:00 PM,48,-122,10,5,15
805,SpokaneStBridge,02/03/2014 01:00:00 PM,48,-122,10,6,16
806,SpokaneStBridge,02/03/2014 02:00:00 PM,48,-122,5,9,14
807,SpokaneStBridge,02/03/2014 03:00:00 PM,48,-122,9,19,28
808,SpokaneStBridge,02/03/2014 04:00:00 PM,48,-122,15,47,62
809,SpokaneStBridge,02/03/2014 05:00:00 PM,48,-122,15,86,101
810,SpokaneStBridge,02/03/2014 06:00:00 PM,48,-122,3,55,58
811,SpokaneStBridge,02/03/2014 07:00:00 PM,48,-122,5,18,23
812,SpokaneStBridge,02/03/2014 08:00:00 PM,48,-122,2,6,8
813,SpokaneStBridge,02/03/2014 09:00:00 PM,48,-122,1,3,4
814,SpokaneStBridge,02/03/2014 10:00:00 PM,48,-122,0,4,4
815,SpokaneStBridge,02/03/2014 11:00:00 PM,48,-122,0,0,0
816,SpokaneStBridge,02/04/2014 12:00:00 AM,48,-122,0,2,2
817,SpokaneStBridge,02/04/2014 01:00:00 AM,48,-122,0,0,0
818,SpokaneStBridge,02/04/2014 02:00:00 AM,48,-122,0,0,0
819,SpokaneStBridge,02/04/2014 03:00:00 AM,48,-122,0,0,0
820,SpokaneStBridge,02/04/2014 04:00:00 AM,48,-122,1,1,2
821,SpokaneStBridge,02/04/2014 05:00:00 AM,48,-122,11,2,13
822,SpokaneStBridge,02/04/2014 06:00:00 AM,48,-122,28,7,35
823,SpokaneStBridge,02/04/2014 07:00:00 AM,48,-122,61,12,73
824,SpokaneStBridge,02/04/2014 08:00:00 AM,48,-122,83,2,85
825,SpokaneStBridge,02/04/2014 09:00:00 AM,48,-122,28,5,33
826,SpokaneStBridge,02/04/2014 10:00:00 AM,48,-122,8,1,9
827,SpokaneStBridge,02/04/2014 11:00:00 AM,48,-122,9,6,15
828,SpokaneStBridge,02/04/2014 12:00:00 PM,48,-122,5,6,11
829,SpokaneStBridge,02/04/2014 01:00:00 PM,48,-122,9,5,14
830,SpokaneStBridge,02/04/2014 02:00:00 PM,48,-122,1,9,10
831,SpokaneStBridge,02/04/2014 03:00:00 PM,48,-122,6,21,27
832,SpokaneStBridge,02/04/2014 04:00:00 PM,48,-122,15,29,44
833,SpokaneStBridge,02/04/2014 05:00:00 PM,48,-122,10,85,95
834,SpokaneStBridge,02/04/2014 06:00:00 PM,48,-122,6,48,54
835,SpokaneStBridge,02/04/2014 07:00:00 PM,48,-122,4,20,24
836,SpokaneStBridge,02/04/2014 08:00:00 PM,48,-122,2,7,9
837,SpokaneStBridge,02/04/2014 09:00:00 PM,48,-122,1,2,3
838,SpokaneStBridge,02/04/2014 10:00:00 PM,48,-122,0,2,2
839,SpokaneStBridge,02/04/2014 11:00:00 PM,48,-122,0,3,3
840,SpokaneStBridge,02/05/2014 12:00:00 AM,48,-122,1,2,3
841,SpokaneStBridge,02/05/2014 01:00:00 AM,48,-122,1,0,1
842,SpokaneStBridge,02/05/2014 02:00:00 AM,48,-122,0,0,0
843,SpokaneStBridge,02/05/2014 03:00:00 AM,48,-122,1,1,2
844,SpokaneStBridge,02/05/2014 04:00:00 AM,48,-122,3,0,3
845,SpokaneStBridge,02/05/2014 05:00:00 AM,48,-122,11,5,16
846,SpokaneStBridge,02/05/2014 06:00:00 AM,48,-122,36,7,43
847,SpokaneStBridge,02/05/2014 07:00:00 AM,48,-122,64,10,74
848,SpokaneStBridge,02/05/2014 08:00:00 AM,48,-122,66,3,69
849,SpokaneStBridge,02/05/2014 09:00:00 AM,48,-122,57,4,61
850,SpokaneStBridge,02/05/2014 10:00:00 AM,48,-122,50,2,52
851,SpokaneStBridge,02/05/2014 11:00:00 AM,48,-122,40,8,48
852,SpokaneStBridge,02/05/2014 12:00:00 PM,48,-122,26,11,37
853,SpokaneStBridge,02/05/2014 01:00:00 PM,48,-122,9,20,29
854,SpokaneStBridge,02/05/2014 02:00:00 PM,48,-122,16,44,60
855,SpokaneStBridge,02/05/2014 03:00:00 PM,48,-122,8,47,55
856,SpokaneStBridge,02/05/2014 04:00:00 PM,48,-122,15,48,63
857,SpokaneStBridge,02/05/2014 05:00:00 PM,48,-122,12,84,96
858,SpokaneStBridge,02/05/2014 06:00:00 PM,48,-122,9,51,60
859,SpokaneStBridge,02/05/2014 07:00:00 PM,48,-122,2,19,21
860,SpokaneStBridge,02/05/2014 08:00:00 PM,48,-122,2,2,4
861,SpokaneStBridge,02/05/2014 09:00:00 PM,48,-122,0,4,4
862,SpokaneStBridge,02/05/2014 10:00:00 PM,48,-122,1,6,7
863,SpokaneStBridge,02/05/2014 11:00:00 PM,48,-122,0,5,5
864,SpokaneStBridge,02/06/2014 12:00:00 AM,48,-122,0,0,0
865,SpokaneStBridge,02/06/2014 01:00:00 AM,48,-122,6,1,7
866,SpokaneStBridge,02/06/2014 02:00:00 AM,48,-122,0,0,0
867,SpokaneStBridge,02/06/2014 03:00:00 AM,48,-122,0,1,1
868,SpokaneStBridge,02/06/2014 04:00:00 AM,48,-122,3,0,3
869,SpokaneStBridge,02/06/2014 05:00:00 AM,48,-122,8,2,10
870,SpokaneStBridge,02/06/2014 06:00:00 AM,48,-122,20,8,28
871,SpokaneStBridge,02/06/2014 07:00:00 AM,48,-122,36,7,43
872,SpokaneStBridge,02/06/2014 08:00:00 AM,48,-122,49,5,54
873,SpokaneStBridge,02/06/2014 09:00:00 AM,48,-122,18,2,20
874,SpokaneStBridge,02/06/2014 10:00:00 AM,48,-122,12,4,16
875,SpokaneStBridge,02/06/2014 11:00:00 AM,48,-122,5,2,7
876,SpokaneStBridge,02/06/2014 12:00:00 PM,48,-122,7,4,11
877,SpokaneStBridge,02/06/2014 01:00:00 PM,48,-122,4,3,7
878,SpokaneStBridge,02/06/2014 02:00:00 PM,48,-122,4,5,9
879,SpokaneStBridge,02/06/2014 03:00:00 PM,48,-122,4,9,13
880,SpokaneStBridge,02/06/2014 04:00:00 PM,48,-122,14,29,43
881,SpokaneStBridge,02/06/2014 05:00:00 PM,48,-122,5,57,62
882,SpokaneStBridge,02/06/2014 06:00:00 PM,48,-122,4,30,34
883,SpokaneStBridge,02/06/2014 07:00:00 PM,48,-122,2,9,11
884,SpokaneStBridge,02/06/2014 08:00:00 PM,48,-122,0,4,4
885,SpokaneStBridge,02/06/2014 09:00:00 PM,48,-122,3,5,8
886,SpokaneStBridge,02/06/2014 10:00:00 PM,48,-122,2,1,3
887,SpokaneStBridge,02/06/2014 11:00:00 PM,48,-122,2,3,5
888,SpokaneStBridge,02/07/2014 12:00:00 AM,48,-122,0,1,1
889,SpokaneStBridge,02/07/2014 01:00:00 AM,48,-122,0,0,0
890,SpokaneStBridge,02/07/2014 02:00:00 AM,48,-122,0,1,1
891,SpokaneStBridge,02/07/2014 03:00:00 AM,48,-122,0,0,0
892,SpokaneStBridge,02/07/2014 04:00:00 AM,48,-122,2,1,3
893,SpokaneStBridge,02/07/2014 05:00:00 AM,48,-122,7,2,9
894,SpokaneStBridge,02/07/2014 06:00:00 AM,48,-122,32,1,33
895,SpokaneStBridge,02/07/2014 07:00:00 AM,48,-122,29,8,37
896,SpokaneStBridge,02/07/2014 08:00:00 AM,48,-122,49,0,49
897,SpokaneStBridge,02/07/2014 09:00:00 AM,48,-122,22,1,23
898,SpokaneStBridge,02/07/2014 10:00:00 AM,48,-122,7,4,11
899,SpokaneStBridge,02/07/2014 11:00:00 AM,48,-122,10,1,11
900,SpokaneStBridge,02/07/2014 12:00:00 PM,48,-122,2,1,3
901,SpokaneStBridge,02/07/2014 01:00:00 PM,48,-122,1,2,3
902,SpokaneStBridge,02/07/2014 02:00:00 PM,48,-122,4,7,11
903,SpokaneStBridge,02/07/2014 03:00:00 PM,48,-122,8,19,27
904,SpokaneStBridge,02/07/2014 04:00:00 PM,48,-122,8,33,41
905,SpokaneStBridge,02/07/2014 05:00:00 PM,48,-122,8,37,45
906,SpokaneStBridge,02/07/2014 06:00:00 PM,48,-122,5,25,30
907,SpokaneStBridge,02/07/2014 07:00:00 PM,48,-122,1,8,9
908,SpokaneStBridge,02/07/2014 08:00:00 PM,48,-122,4,3,7
909,SpokaneStBridge,02/07/2014 09:00:00 PM,48,-122,1,2,3
910,SpokaneStBridge,02/07/2014 10:00:00 PM,48,-122,1,2,3
911,SpokaneStBridge,02/07/2014 11:00:00 PM,48,-122,0,3,3
912,SpokaneStBridge,02/08/2014 12:00:00 AM,48,-122,0,3,3
913,SpokaneStBridge,02/08/2014 01:00:00 AM,48,-122,0,1,1
914,SpokaneStBridge,02/08/2014 02:00:00 AM,48,-122,0,0,0
915,SpokaneStBridge,02/08/2014 03:00:00 AM,48,-122,1,2,3
916,SpokaneStBridge,02/08/2014 04:00:00 AM,48,-122,0,0,0
917,SpokaneStBridge,02/08/2014 05:00:00 AM,48,-122,1,0,1
918,SpokaneStBridge,02/08/2014 06:00:00 AM,48,-122,1,0,1
919,SpokaneStBridge,02/08/2014 07:00:00 AM,48,-122,4,1,5
920,SpokaneStBridge,02/08/2014 08:00:00 AM,48,-122,9,1,10
921,SpokaneStBridge,02/08/2014 09:00:00 AM,48,-122,8,1,9
922,SpokaneStBridge,02/08/2014 10:00:00 AM,48,-122,3,7,10
923,SpokaneStBridge,02/08/2014 11:00:00 AM,48,-122,13,10,23
924,SpokaneStBridge,02/08/2014 12:00:00 PM,48,-122,10,14,24
925,SpokaneStBridge,02/08/2014 01:00:00 PM,48,-122,6,12,18
926,SpokaneStBridge,02/08/2014 02:00:00 PM,48,-122,8,8,16
927,SpokaneStBridge,02/08/2014 03:00:00 PM,48,-122,14,13,27
928,SpokaneStBridge,02/08/2014 04:00:00 PM,48,-122,6,3,9
929,SpokaneStBridge,02/08/2014 05:00:00 PM,48,-122,8,2,10
930,SpokaneStBridge,02/08/2014 06:00:00 PM,48,-122,1,3,4
931,SpokaneStBridge,02/08/2014 07:00:00 PM,48,-122,0,2,2
932,SpokaneStBridge,02/08/2014 08:00:00 PM,48,-122,0,1,1
933,SpokaneStBridge,02/08/2014 09:00:00 PM,48,-122,0,1,1
934,SpokaneStBridge,02/08/2014 10:00:00 PM,48,-122,0,1,1
935,SpokaneStBridge,02/08/2014 11:00:00 PM,48,-122,1,0,1
936,SpokaneStBridge,02/09/2014 12:00:00 AM,48,-122,1,0,1
937,SpokaneStBridge,02/09/2014 01:00:00 AM,48,-122,0,0,0
938,SpokaneStBridge,02/09/2014 02:00:00 AM,48,-122,0,0,0
939,SpokaneStBridge,02/09/2014 03:00:00 AM,48,-122,2,0,2
940,SpokaneStBridge,02/09/2014 04:00:00 AM,48,-122,0,0,0
941,SpokaneStBridge,02/09/2014 05:00:00 AM,48,-122,0,0,0
942,SpokaneStBridge,02/09/2014 06:00:00 AM,48,-122,0,0,0
943,SpokaneStBridge,02/09/2014 07:00:00 AM,48,-122,0,0,0
944,SpokaneStBridge,02/09/2014 08:00:00 AM,48,-122,0,0,0
945,SpokaneStBridge,02/09/2014 09:00:00 AM,48,-122,1,0,1
946,SpokaneStBridge,02/09/2014 10:00:00 AM,48,-122,1,1,2
947,SpokaneStBridge,02/09/2014 11:00:00 AM,48,-122,0,0,0
948,SpokaneStBridge,02/09/2014 12:00:00 PM,48,-122,0,1,1
949,SpokaneStBridge,02/09/2014 01:00:00 PM,48,-122,0,0,0
950,SpokaneStBridge,02/09/2014 02:00:00 PM,48,-122,0,0,0
951,SpokaneStBridge,02/09/2014 03:00:00 PM,48,-122,1,0,1
952,SpokaneStBridge,02/09/2014 04:00:00 PM,48,-122,2,0,2
953,SpokaneStBridge,02/09/2014 05:00:00 PM,48,-122,1,5,6
954,SpokaneStBridge,02/09/2014 06:00:00 PM,48,-122,0,2,2
955,SpokaneStBridge,02/09/2014 07:00:00 PM,48,-122,0,0,0
956,SpokaneStBridge,02/09/2014 08:00:00 PM,48,-122,1,0,1
957,SpokaneStBridge,02/09/2014 09:00:00 PM,48,-122,0,0,0
958,SpokaneStBridge,02/09/2014 10:00:00 PM,48,-122,0,0,0
959,SpokaneStBridge,02/09/2014 11:00:00 PM,48,-122,0,0,0
960,SpokaneStBridge,02/10/2014 12:00:00 AM,48,-122,0,1,1
961,SpokaneStBridge,02/10/2014 01:00:00 AM,48,-122,0,0,0
962,SpokaneStBridge,02/10/2014 02:00:00 AM,48,-122,1,1,2
963,SpokaneStBridge,02/10/2014 03:00:00 AM,48,-122,0,1,1
964,SpokaneStBridge,02/10/2014 04:00:00 AM,48,-122,5,0,5
965,SpokaneStBridge,02/10/2014 05:00:00 AM,48,-122,3,1,4
966,SpokaneStBridge,02/10/2014 06:00:00 AM,48,-122,22,4,26
967,SpokaneStBridge,02/10/2014 07:00:00 AM,48,-122,34,7,41
968,SpokaneStBridge,02/10/2014 08:00:00 AM,48,-122,41,3,44
969,SpokaneStBridge,02/10/2014 09:00:00 AM,48,-122,24,3,27
970,SpokaneStBridge,02/10/2014 10:00:00 AM,48,-122,7,2,9
971,SpokaneStBridge,02/10/2014 11:00:00 AM,48,-122,4,3,7
972,SpokaneStBridge,02/10/2014 12:00:00 PM,48,-122,4,3,7
973,SpokaneStBridge,02/10/2014 01:00:00 PM,48,-122,4,3,7
974,SpokaneStBridge,02/10/2014 02:00:00 PM,48,-122,2,2,4
975,SpokaneStBridge,02/10/2014 03:00:00 PM,48,-122,8,17,25
976,SpokaneStBridge,02/10/2014 04:00:00 PM,48,-122,11,22,33
977,SpokaneStBridge,02/10/2014 05:00:00 PM,48,-122,9,35,44
978,SpokaneStBridge,02/10/2014 06:00:00 PM,48,-122,7,32,39
979,SpokaneStBridge,02/10/2014 07:00:00 PM,48,-122,2,14,16
980,SpokaneStBridge,02/10/2014 08:00:00 PM,48,-122,3,5,8
981,SpokaneStBridge,02/10/2014 09:00:00 PM,48,-122,0,6,6
982,SpokaneStBridge,02/10/2014 10:00:00 PM,48,-122,0,1,1
983,SpokaneStBridge,02/10/2014 11:00:00 PM,48,-122,0,0,0
984,SpokaneStBridge,02/11/2014 12:00:00 AM,48,-122,0,2,2
985,SpokaneStBridge,02/11/2014 01:00:00 AM,48,-122,0,0,0
986,SpokaneStBridge,02/11/2014 02:00:00 AM,48,-122,0,1,1
987,SpokaneStBridge,02/11/2014 03:00:00 AM,48,-122,0,2,2
988,SpokaneStBridge,02/11/2014 04:00:00 AM,48,-122,1,0,1
989,SpokaneStBridge,02/11/2014 05:00:00 AM,48,-122,11,5,16
990,SpokaneStBridge,02/11/2014 06:00:00 AM,48,-122,39,8,47
991,SpokaneStBridge,02/11/2014 07:00:00 AM,48,-122,60,15,75
992,SpokaneStBridge,02/11/2014 08:00:00 AM,48,-122,71,8,79
993,SpokaneStBridge,02/11/2014 09:00:00 AM,48,-122,25,2,27
994,SpokaneStBridge,02/11/2014 10:00:00 AM,48,-122,9,1,10
995,SpokaneStBridge,02/11/2014 11:00:00 AM,48,-122,4,4,8
996,SpokaneStBridge,02/11/2014 12:00:00 PM,48,-122,5,6,11
997,SpokaneStBridge,02/11/2014 01:00:00 PM,48,-122,6,2,8
998,SpokaneStBridge,02/11/2014 02:00:00 PM,48,-122,2,9,11
999,SpokaneStBridge,02/11/2014 03:00:00 PM,48,-122,10,27,37
1000,SpokaneStBridge,02/11/2014 04:00:00 PM,48,-122,13,28,41
1001,SpokaneStBridge,02/11/2014 05:00:00 PM,48,-122,12,56,68
1002,SpokaneStBridge,02/11/2014 06:00:00 PM,48,-122,6,47,53
1003,SpokaneStBridge,02/11/2014 07:00:00 PM,48,-122,0,18,18
1004,SpokaneStBridge,02/11/2014 08:00:00 PM,48,-122,2,8,10
1005,SpokaneStBridge,02/11/2014 09:00:00 PM,48,-122,1,4,5
1006,SpokaneStBridge,02/11/2014 10:00:00 PM,48,-122,1,1,2
1007,SpokaneStBridge,02/11/2014 11:00:00 PM,48,-122,0,2,2
1008,SpokaneStBridge,02/12/2014 12:00:00 AM,48,-122,0,4,4
1009,SpokaneStBridge,02/12/2014 01:00:00 AM,48,-122,0,0,0
1010,SpokaneStBridge,02/12/2014 02:00:00 AM,48,-122,0,0,0
1011,SpokaneStBridge,02/12/2014 03:00:00 AM,48,-122,3,2,5
1012,SpokaneStBridge,02/12/2014 04:00:00 AM,48,-122,2,2,4
1013,SpokaneStBridge,02/12/2014 05:00:00 AM,48,-122,10,4,14
1014,SpokaneStBridge,02/12/2014 06:00:00 AM,48,-122,35,2,37
1015,SpokaneStBridge,02/12/2014 07:00:00 AM,48,-122,43,9,52
1016,SpokaneStBridge,02/12/2014 08:00:00 AM,48,-122,60,4,64
1017,SpokaneStBridge,02/12/2014 09:00:00 AM,48,-122,29,1,30
1018,SpokaneStBridge,02/12/2014 10:00:00 AM,48,-122,13,2,15
1019,SpokaneStBridge,02/12/2014 11:00:00 AM,48,-122,8,2,10
1020,SpokaneStBridge,02/12/2014 12:00:00 PM,48,-122,9,9,18
1021,SpokaneStBridge,02/12/2014 01:00:00 PM,48,-122,9,6,15
1022,SpokaneStBridge,02/12/2014 02:00:00 PM,48,-122,8,11,19
1023,SpokaneStBridge,02/12/2014 03:00:00 PM,48,-122,16,25,41
1024,SpokaneStBridge,02/12/2014 04:00:00 PM,48,-122,16,46,62
1025,SpokaneStBridge,02/12/2014 05:00:00 PM,48,-122,18,64,82
1026,SpokaneStBridge,02/12/2014 06:00:00 PM,48,-122,14,38,52
1027,SpokaneStBridge,02/12/2014 07:00:00 PM,48,-122,2,5,7
1028,SpokaneStBridge,02/12/2014 08:00:00 PM,48,-122,2,18,20
1029,SpokaneStBridge,02/12/2014 09:00:00 PM,48,-122,3,6,9
1030,SpokaneStBridge,02/12/2014 10:00:00 PM,48,-122,0,4,4
1031,SpokaneStBridge,02/12/2014 11:00:00 PM,48,-122,1,3,4
1032,SpokaneStBridge,02/13/2014 12:00:00 AM,48,-122,0,2,2
1033,SpokaneStBridge,02/13/2014 01:00:00 AM,48,-122,1,1,2
1034,SpokaneStBridge,02/13/2014 02:00:00 AM,48,-122,1,1,2
1035,SpokaneStBridge,02/13/2014 03:00:00 AM,48,-122,0,0,0
1036,SpokaneStBridge,02/13/2014 04:00:00 AM,48,-122,3,3,6
1037,SpokaneStBridge,02/13/2014 05:00:00 AM,48,-122,10,2,12
1038,SpokaneStBridge,02/13/2014 06:00:00 AM,48,-122,47,10,57
1039,SpokaneStBridge,02/13/2014 07:00:00 AM,48,-122,50,11,61
1040,SpokaneStBridge,02/13/2014 08:00:00 AM,48,-122,77,5,82
1041,SpokaneStBridge,02/13/2014 09:00:00 AM,48,-122,30,3,33
1042,SpokaneStBridge,02/13/2014 10:00:00 AM,48,-122,13,0,13
1043,SpokaneStBridge,02/13/2014 11:00:00 AM,48,-122,16,4,20
1044,SpokaneStBridge,02/13/2014 12:00:00 PM,48,-122,9,5,14
1045,SpokaneStBridge,02/13/2014 01:00:00 PM,48,-122,11,7,18
1046,SpokaneStBridge,02/13/2014 02:00:00 PM,48,-122,10,17,27
1047,SpokaneStBridge,02/13/2014 03:00:00 PM,48,-122,11,22,33
1048,SpokaneStBridge,02/13/2014 04:00:00 PM,48,-122,15,48,63
1049,SpokaneStBridge,02/13/2014 05:00:00 PM,48,-122,10,88,98
1050,SpokaneStBridge,02/13/2014 06:00:00 PM,48,-122,12,45,57
1051,SpokaneStBridge,02/13/2014 07:00:00 PM,48,-122,3,14,17
1052,SpokaneStBridge,02/13/2014 08:00:00 PM,48,-122,2,12,14
1053,SpokaneStBridge,02/13/2014 09:00:00 PM,48,-122,3,6,9
1054,SpokaneStBridge,02/13/2014 10:00:00 PM,48,-122,1,4,5
1055,SpokaneStBridge,02/13/2014 11:00:00 PM,48,-122,1,2,3
1056,SpokaneStBridge,02/14/2014 12:00:00 AM,48,-122,3,3,6
1057,SpokaneStBridge,02/14/2014 01:00:00 AM,48,-122,1,2,3
1058,SpokaneStBridge,02/14/2014 02:00:00 AM,48,-122,0,0,0
1059,SpokaneStBridge,02/14/2014 03:00:00 AM,48,-122,1,2,3
1060,SpokaneStBridge,02/14/2014 04:00:00 AM,48,-122,5,0,5
1061,SpokaneStBridge,02/14/2014 05:00:00 AM,48,-122,8,2,10
1062,SpokaneStBridge,02/14/2014 06:00:00 AM,48,-122,31,9,40
1063,SpokaneStBridge,02/14/2014 07:00:00 AM,48,-122,43,8,51
1064,SpokaneStBridge,02/14/2014 08:00:00 AM,48,-122,45,3,48
1065,SpokaneStBridge,02/14/2014 09:00:00 AM,48,-122,15,2,17
1066,SpokaneStBridge,02/14/2014 10:00:00 AM,48,-122,9,1,10
1067,SpokaneStBridge,02/14/2014 11:00:00 AM,48,-122,1,2,3
1068,SpokaneStBridge,02/14/2014 12:00:00 PM,48,-122,2,4,6
1069,SpokaneStBridge,02/14/2014 01:00:00 PM,48,-122,4,5,9
1070,SpokaneStBridge,02/14/2014 02:00:00 PM,48,-122,8,7,15
1071,SpokaneStBridge,02/14/2014 03:00:00 PM,48,-122,10,17,27
1072,SpokaneStBridge,02/14/2014 04:00:00 PM,48,-122,13,42,55
1073,SpokaneStBridge,02/14/2014 05:00:00 PM,48,-122,10,40,50
1074,SpokaneStBridge,02/14/2014 06:00:00 PM,48,-122,4,30,34
1075,SpokaneStBridge,02/14/2014 07:00:00 PM,48,-122,4,6,10
1076,SpokaneStBridge,02/14/2014 08:00:00 PM,48,-122,1,7,8
1077,SpokaneStBridge,02/14/2014 09:00:00 PM,48,-122,0,2,2
1078,SpokaneStBridge,02/14/2014 10:00:00 PM,48,-122,1,2,3
1079,SpokaneStBridge,02/14/2014 11:00:00 PM,48,-122,0,2,2
1080,SpokaneStBridge,02/15/2014 12:00:00 AM,48,-122,1,1,2
1081,SpokaneStBridge,02/15/2014 01:00:00 AM,48,-122,0,1,1
1082,SpokaneStBridge,02/15/2014 02:00:00 AM,48,-122,0,1,1
1083,SpokaneStBridge,02/15/2014 03:00:00 AM,48,-122,0,4,4
1084,SpokaneStBridge,02/15/2014 04:00:00 AM,48,-122,1,0,1
1085,SpokaneStBridge,02/15/2014 05:00:00 AM,48,-122,2,1,3
1086,SpokaneStBridge,02/15/2014 06:00:00 AM,48,-122,3,3,6
1087,SpokaneStBridge,02/15/2014 07:00:00 AM,48,-122,4,2,6
1088,SpokaneStBridge,02/15/2014 08:00:00 AM,48,-122,14,4,18
1089,SpokaneStBridge,02/15/2014 09:00:00 AM,48,-122,19,6,25
1090,SpokaneStBridge,02/15/2014 10:00:00 AM,48,-122,16,11,27
1091,SpokaneStBridge,02/15/2014 11:00:00 AM,48,-122,9,18,27
1092,SpokaneStBridge,02/15/2014 12:00:00 PM,48,-122,6,8,14
1093,SpokaneStBridge,02/15/2014 01:00:00 PM,48,-122,4,8,12
1094,SpokaneStBridge,02/15/2014 02:00:00 PM,48,-122,2,1,3
1095,SpokaneStBridge,02/15/2014 03:00:00 PM,48,-122,0,5,5
1096,SpokaneStBridge,02/15/2014 04:00:00 PM,48,-122,3,1,4
1097,SpokaneStBridge,02/15/2014 05:00:00 PM,48,-122,5,11,16
1098,SpokaneStBridge,02/15/2014 06:00:00 PM,48,-122,0,3,3
1099,SpokaneStBridge,02/15/2014 07:00:00 PM,48,-122,2,3,5
1100,SpokaneStBridge,02/15/2014 08:00:00 PM,48,-122,1,2,3
1101,SpokaneStBridge,02/15/2014 09:00:00 PM,48,-122,0,2,2
1102,SpokaneStBridge,02/15/2014 10:00:00 PM,48,-122,0,1,1
1103,SpokaneStBridge,02/15/2014 11:00:00 PM,48,-122,0,1,1
1104,SpokaneStBridge,02/16/2014 12:00:00 AM,48,-122,1,1,2
1105,SpokaneStBridge,02/16/2014 01:00:00 AM,48,-122,0,0,0
1106,SpokaneStBridge,02/16/2014 02:00:00 AM,48,-122,0,0,0
1107,SpokaneStBridge,02/16/2014 03:00:00 AM,48,-122,1,0,1
1108,SpokaneStBridge,02/16/2014 04:00:00 AM,48,-122,1,0,1
1109,SpokaneStBridge,02/16/2014 05:00:00 AM,48,-122,0,0,0
1110,SpokaneStBridge,02/16/2014 06:00:00 AM,48,-122,1,1,2
1111,SpokaneStBridge,02/16/2014 07:00:00 AM,48,-122,3,0,3
1112,SpokaneStBridge,02/16/2014 08:00:00 AM,48,-122,4,1,5
1113,SpokaneStBridge,02/16/2014 09:00:00 AM,48,-122,9,2,11
1114,SpokaneStBridge,02/16/2014 10:00:00 AM,48,-122,5,6,11
1115,SpokaneStBridge,02/16/2014 11:00:00 AM,48,-122,3,5,8
1116,SpokaneStBridge,02/16/2014 12:00:00 PM,48,-122,4,1,5
1117,SpokaneStBridge,02/16/2014 01:00:00 PM,48,-122,2,7,9
1118,SpokaneStBridge,02/16/2014 02:00:00 PM,48,-122,10,1,11
1119,SpokaneStBridge,02/16/2014 03:00:00 PM,48,-122,3,2,5
1120,SpokaneStBridge,02/16/2014 04:00:00 PM,48,-122,2,2,4
1121,SpokaneStBridge,02/16/2014 05:00:00 PM,48,-122,2,6,8
1122,SpokaneStBridge,02/16/2014 06:00:00 PM,48,-122,1,2,3
1123,SpokaneStBridge,02/16/2014 07:00:00 PM,48,-122,1,0,1
1124,SpokaneStBridge,02/16/2014 08:00:00 PM,48,-122,0,1,1
1125,SpokaneStBridge,02/16/2014 09:00:00 PM,48,-122,0,1,1
1126,SpokaneStBridge,02/16/2014 10:00:00 PM,48,-122,0,1,1
1127,SpokaneStBridge,02/16/2014 11:00:00 PM,48,-122,0,0,0
1128,SpokaneStBridge,02/17/2014 12:00:00 AM,48,-122,0,0,0
1129,SpokaneStBridge,02/17/2014 01:00:00 AM,48,-122,1,0,1
1130,SpokaneStBridge,02/17/2014 02:00:00 AM,48,-122,0,0,0
1131,SpokaneStBridge,02/17/2014 03:00:00 AM,48,-122,1,3,4
1132,SpokaneStBridge,02/17/2014 04:00:00 AM,48,-122,2,0,2
1133,SpokaneStBridge,02/17/2014 05:00:00 AM,48,-122,2,2,4
1134,SpokaneStBridge,02/17/2014 06:00:00 AM,48,-122,7,3,10
1135,SpokaneStBridge,02/17/2014 07:00:00 AM,48,-122,12,1,13
1136,SpokaneStBridge,02/17/2014 08:00:00 AM,48,-122,18,3,21
1137,SpokaneStBridge,02/17/2014 09:00:00 AM,48,-122,22,1,23
1138,SpokaneStBridge,02/17/2014 10:00:00 AM,48,-122,8,4,12
1139,SpokaneStBridge,02/17/2014 11:00:00 AM,48,-122,4,1,5
1140,SpokaneStBridge,02/17/2014 12:00:00 PM,48,-122,10,3,13
1141,SpokaneStBridge,02/17/2014 01:00:00 PM,48,-122,3,5,8
1142,SpokaneStBridge,02/17/2014 02:00:00 PM,48,-122,3,5,8
1143,SpokaneStBridge,02/17/2014 03:00:00 PM,48,-122,7,9,16
1144,SpokaneStBridge,02/17/2014 04:00:00 PM,48,-122,8,16,24
1145,SpokaneStBridge,02/17/2014 05:00:00 PM,48,-122,8,18,26
1146,SpokaneStBridge,02/17/2014 06:00:00 PM,48,-122,2,23,25
1147,SpokaneStBridge,02/17/2014 07:00:00 PM,48,-122,3,8,11
1148,SpokaneStBridge,02/17/2014 08:00:00 PM,48,-122,2,3,5
1149,SpokaneStBridge,02/17/2014 09:00:00 PM,48,-122,1,3,4
1150,SpokaneStBridge,02/17/2014 10:00:00 PM,48,-122,1,5,6
1151,SpokaneStBridge,02/17/2014 11:00:00 PM,48,-122,1,0,1
1152,SpokaneStBridge,02/18/2014 12:00:00 AM,48,-122,0,0,0
1153,SpokaneStBridge,02/18/2014 01:00:00 AM,48,-122,0,0,0
1154,SpokaneStBridge,02/18/2014 02:00:00 AM,48,-122,0,0,0
1155,SpokaneStBridge,02/18/2014 03:00:00 AM,48,-122,1,2,3
1156,SpokaneStBridge,02/18/2014 04:00:00 AM,48,-122,2,1,3
1157,SpokaneStBridge,02/18/2014 05:00:00 AM,48,-122,15,4,19
1158,SpokaneStBridge,02/18/2014 06:00:00 AM,48,-122,33,4,37
1159,SpokaneStBridge,02/18/2014 07:00:00 AM,48,-122,51,8,59
1160,SpokaneStBridge,02/18/2014 08:00:00 AM,48,-122,52,4,56
1161,SpokaneStBridge,02/18/2014 09:00:00 AM,48,-122,21,2,23
1162,SpokaneStBridge,02/18/2014 10:00:00 AM,48,-122,4,0,4
1163,SpokaneStBridge,02/18/2014 11:00:00 AM,48,-122,2,2,4
1164,SpokaneStBridge,02/18/2014 12:00:00 PM,48,-122,4,1,5
1165,SpokaneStBridge,02/18/2014 01:00:00 PM,48,-122,1,3,4
1166,SpokaneStBridge,02/18/2014 02:00:00 PM,48,-122,4,4,8
1167,SpokaneStBridge,02/18/2014 03:00:00 PM,48,-122,4,15,19
1168,SpokaneStBridge,02/18/2014 04:00:00 PM,48,-122,11,36,47
1169,SpokaneStBridge,02/18/2014 05:00:00 PM,48,-122,9,64,73
1170,SpokaneStBridge,02/18/2014 06:00:00 PM,48,-122,4,28,32
1171,SpokaneStBridge,02/18/2014 07:00:00 PM,48,-122,1,10,11
1172,SpokaneStBridge,02/18/2014 08:00:00 PM,48,-122,1,8,9
1173,SpokaneStBridge,02/18/2014 09:00:00 PM,48,-122,2,3,5
1174,SpokaneStBridge,02/18/2014 10:00:00 PM,48,-122,0,4,4
1175,SpokaneStBridge,02/18/2014 11:00:00 PM,48,-122,0,1,1
1176,SpokaneStBridge,02/19/2014 12:00:00 AM,48,-122,0,1,1
1177,SpokaneStBridge,02/19/2014 01:00:00 AM,48,-122,0,0,0
1178,SpokaneStBridge,02/19/2014 02:00:00 AM,48,-122,0,0,0
1179,SpokaneStBridge,02/19/2014 03:00:00 AM,48,-122,1,2,3
1180,SpokaneStBridge,02/19/2014 04:00:00 AM,48,-122,2,0,2
1181,SpokaneStBridge,02/19/2014 05:00:00 AM,48,-122,10,3,13
1182,SpokaneStBridge,02/19/2014 06:00:00 AM,48,-122,31,9,40
1183,SpokaneStBridge,02/19/2014 07:00:00 AM,48,-122,63,8,71
1184,SpokaneStBridge,02/19/2014 08:00:00 AM,48,-122,65,6,71
1185,SpokaneStBridge,02/19/2014 09:00:00 AM,48,-122,34,6,40
1186,SpokaneStBridge,02/19/2014 10:00:00 AM,48,-122,13,2,15
1187,SpokaneStBridge,02/19/2014 11:00:00 AM,48,-122,9,1,10
1188,SpokaneStBridge,02/19/2014 12:00:00 PM,48,-122,7,7,14
1189,SpokaneStBridge,02/19/2014 01:00:00 PM,48,-122,7,4,11
1190,SpokaneStBridge,02/19/2014 02:00:00 PM,48,-122,9,19,28
1191,SpokaneStBridge,02/19/2014 03:00:00 PM,48,-122,11,24,35
1192,SpokaneStBridge,02/19/2014 04:00:00 PM,48,-122,17,31,48
1193,SpokaneStBridge,02/19/2014 05:00:00 PM,48,-122,11,78,89
1194,SpokaneStBridge,02/19/2014 06:00:00 PM,48,-122,6,47,53
1195,SpokaneStBridge,02/19/2014 07:00:00 PM,48,-122,6,23,29
1196,SpokaneStBridge,02/19/2014 08:00:00 PM,48,-122,4,10,14
1197,SpokaneStBridge,02/19/2014 09:00:00 PM,48,-122,0,3,3
1198,SpokaneStBridge,02/19/2014 10:00:00 PM,48,-122,0,4,4
1199,SpokaneStBridge,02/19/2014 11:00:00 PM,48,-122,0,4,4
1200,SpokaneStBridge,02/20/2014 12:00:00 AM,48,-122,0,1,1
1201,SpokaneStBridge,02/20/2014 01:00:00 AM,48,-122,1,0,1
1202,SpokaneStBridge,02/20/2014 02:00:00 AM,48,-122,2,2,4
1203,SpokaneStBridge,02/20/2014 03:00:00 AM,48,-122,0,1,1
1204,SpokaneStBridge,02/20/2014 04:00:00 AM,48,-122,3,0,3
1205,SpokaneStBridge,02/20/2014 05:00:00 AM,48,-122,5,2,7
1206,SpokaneStBridge,02/20/2014 06:00:00 AM,48,-122,35,6,41
1207,SpokaneStBridge,02/20/2014 07:00:00 AM,48,-122,56,8,64
1208,SpokaneStBridge,02/20/2014 08:00:00 AM,48,-122,60,7,67
1209,SpokaneStBridge,02/20/2014 09:00:00 AM,48,-122,19,3,22
1210,SpokaneStBridge,02/20/2014 10:00:00 AM,48,-122,8,3,11
1211,SpokaneStBridge,02/20/2014 11:00:00 AM,48,-122,9,2,11
1212,SpokaneStBridge,02/20/2014 12:00:00 PM,48,-122,4,6,10
1213,SpokaneStBridge,02/20/2014 01:00:00 PM,48,-122,10,5,15
1214,SpokaneStBridge,02/20/2014 02:00:00 PM,48,-122,13,8,21
1215,SpokaneStBridge,02/20/2014 03:00:00 PM,48,-122,6,30,36
1216,SpokaneStBridge,02/20/2014 04:00:00 PM,48,-122,11,33,44
1217,SpokaneStBridge,02/20/2014 05:00:00 PM,48,-122,14,71,85
1218,SpokaneStBridge,02/20/2014 06:00:00 PM,48,-122,9,39,48
1219,SpokaneStBridge,02/20/2014 07:00:00 PM,48,-122,3,18,21
1220,SpokaneStBridge,02/20/2014 08:00:00 PM,48,-122,7,7,14
1221,SpokaneStBridge,02/20/2014 09:00:00 PM,48,-122,3,4,7
1222,SpokaneStBridge,02/20/2014 10:00:00 PM,48,-122,0,7,7
1223,SpokaneStBridge,02/20/2014 11:00:00 PM,48,-122,4,4,8
1224,SpokaneStBridge,02/21/2014 12:00:00 AM,48,-122,0,2,2
1225,SpokaneStBridge,02/21/2014 01:00:00 AM,48,-122,0,0,0
1226,SpokaneStBridge,02/21/2014 02:00:00 AM,48,-122,0,1,1
1227,SpokaneStBridge,02/21/2014 03:00:00 AM,48,-122,1,1,2
1228,SpokaneStBridge,02/21/2014 04:00:00 AM,48,-122,5,1,6
1229,SpokaneStBridge,02/21/2014 05:00:00 AM,48,-122,12,1,13
1230,SpokaneStBridge,02/21/2014 06:00:00 AM,48,-122,27,6,33
1231,SpokaneStBridge,02/21/2014 07:00:00 AM,48,-122,51,6,57
1232,SpokaneStBridge,02/21/2014 08:00:00 AM,48,-122,48,5,53
1233,SpokaneStBridge,02/21/2014 09:00:00 AM,48,-122,34,6,40
1234,SpokaneStBridge,02/21/2014 10:00:00 AM,48,-122,8,1,9
1235,SpokaneStBridge,02/21/2014 11:00:00 AM,48,-122,8,2,10
1236,SpokaneStBridge,02/21/2014 12:00:00 PM,48,-122,0,4,4
1237,SpokaneStBridge,02/21/2014 01:00:00 PM,48,-122,1,6,7
1238,SpokaneStBridge,02/21/2014 02:00:00 PM,48,-122,11,8,19
1239,SpokaneStBridge,02/21/2014 03:00:00 PM,48,-122,6,23,29
1240,SpokaneStBridge,02/21/2014 04:00:00 PM,48,-122,9,35,44
1241,SpokaneStBridge,02/21/2014 05:00:00 PM,48,-122,12,62,74
1242,SpokaneStBridge,02/21/2014 06:00:00 PM,48,-122,7,34,41
1243,SpokaneStBridge,02/21/2014 07:00:00 PM,48,-122,2,10,12
1244,SpokaneStBridge,02/21/2014 08:00:00 PM,48,-122,2,5,7
1245,SpokaneStBridge,02/21/2014 09:00:00 PM,48,-122,0,3,3
1246,SpokaneStBridge,02/21/2014 10:00:00 PM,48,-122,3,4,7
1247,SpokaneStBridge,02/21/2014 11:00:00 PM,48,-122,1,2,3
1248,SpokaneStBridge,02/22/2014 12:00:00 AM,48,-122,1,0,1
1249,SpokaneStBridge,02/22/2014 01:00:00 AM,48,-122,1,2,3
1250,SpokaneStBridge,02/22/2014 02:00:00 AM,48,-122,1,0,1
1251,SpokaneStBridge,02/22/2014 03:00:00 AM,48,-122,0,2,2
1252,SpokaneStBridge,02/22/2014 04:00:00 AM,48,-122,0,0,0
1253,SpokaneStBridge,02/22/2014 05:00:00 AM,48,-122,0,0,0
1254,SpokaneStBridge,02/22/2014 06:00:00 AM,48,-122,3,0,3
1255,SpokaneStBridge,02/22/2014 07:00:00 AM,48,-122,3,4,7
1256,SpokaneStBridge,02/22/2014 08:00:00 AM,48,-122,12,2,14
1257,SpokaneStBridge,02/22/2014 09:00:00 AM,48,-122,5,2,7
1258,SpokaneStBridge,02/22/2014 10:00:00 AM,48,-122,7,7,14
1259,SpokaneStBridge,02/22/2014 11:00:00 AM,48,-122,2,13,15
1260,SpokaneStBridge,02/22/2014 12:00:00 PM,48,-122,9,6,15
1261,SpokaneStBridge,02/22/2014 01:00:00 PM,48,-122,9,7,16
1262,SpokaneStBridge,02/22/2014 02:00:00 PM,48,-122,7,7,14
1263,SpokaneStBridge,02/22/2014 03:00:00 PM,48,-122,7,6,13
1264,SpokaneStBridge,02/22/2014 04:00:00 PM,48,-122,5,5,10
1265,SpokaneStBridge,02/22/2014 05:00:00 PM,48,-122,6,9,15
1266,SpokaneStBridge,02/22/2014 06:00:00 PM,48,-122,3,6,9
1267,SpokaneStBridge,02/22/2014 07:00:00 PM,48,-122,0,1,1
1268,SpokaneStBridge,02/22/2014 08:00:00 PM,48,-122,0,1,1
1269,SpokaneStBridge,02/22/2014 09:00:00 PM,48,-122,0,0,0
1270,SpokaneStBridge,02/22/2014 10:00:00 PM,48,-122,1,3,4
1271,SpokaneStBridge,02/22/2014 11:00:00 PM,48,-122,2,1,3
1272,SpokaneStBridge,02/23/2014 12:00:00 AM,48,-122,1,0,1
1273,SpokaneStBridge,02/23/2014 01:00:00 AM,48,-122,1,0,1
1274,SpokaneStBridge,02/23/2014 02:00:00 AM,48,-122,0,0,0
1275,SpokaneStBridge,02/23/2014 03:00:00 AM,48,-122,0,0,0
1276,SpokaneStBridge,02/23/2014 04:00:00 AM,48,-122,0,0,0
1277,SpokaneStBridge,02/23/2014 05:00:00 AM,48,-122,0,2,2
1278,SpokaneStBridge,02/23/2014 06:00:00 AM,48,-122,6,0,6
1279,SpokaneStBridge,02/23/2014 07:00:00 AM,48,-122,28,1,29
1280,SpokaneStBridge,02/23/2014 08:00:00 AM,48,-122,16,2,18
1281,SpokaneStBridge,02/23/2014 09:00:00 AM,48,-122,11,4,15
1282,SpokaneStBridge,02/23/2014 10:00:00 AM,48,-122,3,11,14
1283,SpokaneStBridge,02/23/2014 11:00:00 AM,48,-122,17,11,28
1284,SpokaneStBridge,02/23/2014 12:00:00 PM,48,-122,5,17,22
1285,SpokaneStBridge,02/23/2014 01:00:00 PM,48,-122,11,18,29
1286,SpokaneStBridge,02/23/2014 02:00:00 PM,48,-122,3,9,12
1287,SpokaneStBridge,02/23/2014 03:00:00 PM,48,-122,3,14,17
1288,SpokaneStBridge,02/23/2014 04:00:00 PM,48,-122,4,5,9
1289,SpokaneStBridge,02/23/2014 05:00:00 PM,48,-122,2,2,4
1290,SpokaneStBridge,02/23/2014 06:00:00 PM,48,-122,4,3,7
1291,SpokaneStBridge,02/23/2014 07:00:00 PM,48,-122,0,0,0
1292,SpokaneStBridge,02/23/2014 08:00:00 PM,48,-122,0,1,1
1293,SpokaneStBridge,02/23/2014 09:00:00 PM,48,-122,0,1,1
1294,SpokaneStBridge,02/23/2014 10:00:00 PM,48,-122,2,0,2
1295,SpokaneStBridge,02/23/2014 11:00:00 PM,48,-122,1,0,1
1296,SpokaneStBridge,02/24/2014 12:00:00 AM,48,-122,0,1,1
1297,SpokaneStBridge,02/24/2014 01:00:00 AM,48,-122,0,0,0
1298,SpokaneStBridge,02/24/2014 02:00:00 AM,48,-122,1,0,1
1299,SpokaneStBridge,02/24/2014 03:00:00 AM,48,-122,1,1,2
1300,SpokaneStBridge,02/24/2014 04:00:00 AM,48,-122,2,0,2
1301,SpokaneStBridge,02/24/2014 05:00:00 AM,48,-122,15,5,20
1302,SpokaneStBridge,02/24/2014 06:00:00 AM,48,-122,31,9,40
1303,SpokaneStBridge,02/24/2014 07:00:00 AM,48,-122,60,9,69
1304,SpokaneStBridge,02/24/2014 08:00:00 AM,48,-122,49,7,56
1305,SpokaneStBridge,02/24/2014 09:00:00 AM,48,-122,19,3,22
1306,SpokaneStBridge,02/24/2014 10:00:00 AM,48,-122,6,0,6
1307,SpokaneStBridge,02/24/2014 11:00:00 AM,48,-122,4,1,5
1308,SpokaneStBridge,02/24/2014 12:00:00 PM,48,-122,2,1,3
1309,SpokaneStBridge,02/24/2014 01:00:00 PM,48,-122,5,2,7
1310,SpokaneStBridge,02/24/2014 02:00:00 PM,48,-122,3,5,8
1311,SpokaneStBridge,02/24/2014 03:00:00 PM,48,-122,5,21,26
1312,SpokaneStBridge,02/24/2014 04:00:00 PM,48,-122,12,29,41
1313,SpokaneStBridge,02/24/2014 05:00:00 PM,48,-122,14,67,81
1314,SpokaneStBridge,02/24/2014 06:00:00 PM,48,-122,5,42,47
1315,SpokaneStBridge,02/24/2014 07:00:00 PM,48,-122,2,11,13
1316,SpokaneStBridge,02/24/2014 08:00:00 PM,48,-122,1,7,8
1317,SpokaneStBridge,02/24/2014 09:00:00 PM,48,-122,2,3,5
1318,SpokaneStBridge,02/24/2014 10:00:00 PM,48,-122,0,2,2
1319,SpokaneStBridge,02/24/2014 11:00:00 PM,48,-122,0,0,0
1320,SpokaneStBridge,02/25/2014 12:00:00 AM,48,-122,0,1,1
1321,SpokaneStBridge,02/25/2014 01:00:00 AM,48,-122,1,2,3
1322,SpokaneStBridge,02/25/2014 02:00:00 AM,48,-122,1,0,1
1323,SpokaneStBridge,02/25/2014 03:00:00 AM,48,-122,1,2,3
1324,SpokaneStBridge,02/25/2014 04:00:00 AM,48,-122,0,0,0
1325,SpokaneStBridge,02/25/2014 05:00:00 AM,48,-122,20,5,25
1326,SpokaneStBridge,02/25/2014 06:00:00 AM,48,-122,38,6,44
1327,SpokaneStBridge,02/25/2014 07:00:00 AM,48,-122,73,14,87
1328,SpokaneStBridge,02/25/2014 08:00:00 AM,48,-122,84,8,92
1329,SpokaneStBridge,02/25/2014 09:00:00 AM,48,-122,30,4,34
1330,SpokaneStBridge,02/25/2014 10:00:00 AM,48,-122,12,6,18
1331,SpokaneStBridge,02/25/2014 11:00:00 AM,48,-122,10,3,13
1332,SpokaneStBridge,02/25/2014 12:00:00 PM,48,-122,11,7,18
1333,SpokaneStBridge,02/25/2014 01:00:00 PM,48,-122,10,4,14
1334,SpokaneStBridge,02/25/2014 02:00:00 PM,48,-122,15,20,35
1335,SpokaneStBridge,02/25/2014 03:00:00 PM,48,-122,15,28,43
1336,SpokaneStBridge,02/25/2014 04:00:00 PM,48,-122,22,46,68
1337,SpokaneStBridge,02/25/2014 05:00:00 PM,48,-122,19,91,110
1338,SpokaneStBridge,02/25/2014 06:00:00 PM,48,-122,13,55,68
1339,SpokaneStBridge,02/25/2014 07:00:00 PM,48,-122,4,18,22
1340,SpokaneStBridge,02/25/2014 08:00:00 PM,48,-122,0,16,16
1341,SpokaneStBridge,02/25/2014 09:00:00 PM,48,-122,1,8,9
1342,SpokaneStBridge,02/25/2014 10:00:00 PM,48,-122,0,2,2
1343,SpokaneStBridge,02/25/2014 11:00:00 PM,48,-122,2,3,5
1344,SpokaneStBridge,02/26/2014 12:00:00 AM,48,-122,1,2,3
1345,SpokaneStBridge,02/26/2014 01:00:00 AM,48,-122,0,0,0
1346,SpokaneStBridge,02/26/2014 02:00:00 AM,48,-122,1,1,2
1347,SpokaneStBridge,02/26/2014 03:00:00 AM,48,-122,1,1,2
1348,SpokaneStBridge,02/26/2014 04:00:00 AM,48,-122,3,0,3
1349,SpokaneStBridge,02/26/2014 05:00:00 AM,48,-122,18,3,21
1350,SpokaneStBridge,02/26/2014 06:00:00 AM,48,-122,53,11,64
1351,SpokaneStBridge,02/26/2014 07:00:00 AM,48,-122,81,17,98
1352,SpokaneStBridge,02/26/2014 08:00:00 AM,48,-122,71,9,80
1353,SpokaneStBridge,02/26/2014 09:00:00 AM,48,-122,48,3,51
1354,SpokaneStBridge,02/26/2014 10:00:00 AM,48,-122,12,5,17
1355,SpokaneStBridge,02/26/2014 11:00:00 AM,48,-122,12,3,15
1356,SpokaneStBridge,02/26/2014 12:00:00 PM,48,-122,12,11,23
1357,SpokaneStBridge,02/26/2014 01:00:00 PM,48,-122,10,10,20
1358,SpokaneStBridge,02/26/2014 02:00:00 PM,48,-122,11,14,25
1359,SpokaneStBridge,02/26/2014 03:00:00 PM,48,-122,12,27,39
1360,SpokaneStBridge,02/26/2014 04:00:00 PM,48,-122,32,54,86
1361,SpokaneStBridge,02/26/2014 05:00:00 PM,48,-122,27,114,141
1362,SpokaneStBridge,02/26/2014 06:00:00 PM,48,-122,15,61,76
1363,SpokaneStBridge,02/26/2014 07:00:00 PM,48,-122,5,27,32
1364,SpokaneStBridge,02/26/2014 08:00:00 PM,48,-122,8,17,25
1365,SpokaneStBridge,02/26/2014 09:00:00 PM,48,-122,2,4,6
1366,SpokaneStBridge,02/26/2014 10:00:00 PM,48,-122,1,5,6
1367,SpokaneStBridge,02/26/2014 11:00:00 PM,48,-122,1,4,5
1368,SpokaneStBridge,02/27/2014 12:00:00 AM,48,-122,0,1,1
1369,SpokaneStBridge,02/27/2014 01:00:00 AM,48,-122,0,1,1
1370,SpokaneStBridge,02/27/2014 02:00:00 AM,48,-122,0,0,0
1371,SpokaneStBridge,02/27/2014 03:00:00 AM,48,-122,0,1,1
1372,SpokaneStBridge,02/27/2014 04:00:00 AM,48,-122,2,1,3
1373,SpokaneStBridge,02/27/2014 05:00:00 AM,48,-122,11,5,16
1374,SpokaneStBridge,02/27/2014 06:00:00 AM,48,-122,36,6,42
1375,SpokaneStBridge,02/27/2014 07:00:00 AM,48,-122,82,15,97
1376,SpokaneStBridge,02/27/2014 08:00:00 AM,48,-122,77,10,87
1377,SpokaneStBridge,02/27/2014 09:00:00 AM,48,-122,42,8,50
1378,SpokaneStBridge,02/27/2014 10:00:00 AM,48,-122,16,5,21
1379,SpokaneStBridge,02/27/2014 11:00:00 AM,48,-122,14,4,18
1380,SpokaneStBridge,02/27/2014 12:00:00 PM,48,-122,10,12,22
1381,SpokaneStBridge,02/27/2014 01:00:00 PM,48,-122,4,12,16
1382,SpokaneStBridge,02/27/2014 02:00:00 PM,48,-122,12,22,34
1383,SpokaneStBridge,02/27/2014 03:00:00 PM,48,-122,16,21,37
1384,SpokaneStBridge,02/27/2014 04:00:00 PM,48,-122,20,46,66
1385,SpokaneStBridge,02/27/2014 05:00:00 PM,48,-122,19,90,109
1386,SpokaneStBridge,02/27/2014 06:00:00 PM,48,-122,10,60,70
1387,SpokaneStBridge,02/27/2014 07:00:00 PM,48,-122,4,21,25
1388,SpokaneStBridge,02/27/2014 08:00:00 PM,48,-122,6,15,21
1389,SpokaneStBridge,02/27/2014 09:00:00 PM,48,-122,1,6,7
1390,SpokaneStBridge,02/27/2014 10:00:00 PM,48,-122,2,7,9
1391,SpokaneStBridge,02/27/2014 11:00:00 PM,48,-122,2,4,6
1392,SpokaneStBridge,02/28/2014 12:00:00 AM,48,-122,1,2,3
1393,SpokaneStBridge,02/28/2014 01:00:00 AM,48,-122,1,1,2
1394,SpokaneStBridge,02/28/2014 02:00:00 AM,48,-122,1,1,2
1395,SpokaneStBridge,02/28/2014 03:00:00 AM,48,-122,2,3,5
1396,SpokaneStBridge,02/28/2014 04:00:00 AM,48,-122,5,0,5
1397,SpokaneStBridge,02/28/2014 05:00:00 AM,48,-122,14,3,17
1398,SpokaneStBridge,02/28/2014 06:00:00 AM,48,-122,31,7,38
1399,SpokaneStBridge,02/28/2014 07:00:00 AM,48,-122,79,13,92
1400,SpokaneStBridge,02/28/2014 08:00:00 AM,48,-122,73,10,83
1401,SpokaneStBridge,02/28/2014 09:00:00 AM,48,-122,29,2,31
1402,SpokaneStBridge,02/28/2014 10:00:00 AM,48,-122,21,4,25
1403,SpokaneStBridge,02/28/2014 11:00:00 AM,48,-122,14,8,22
1404,SpokaneStBridge,02/28/2014 12:00:00 PM,48,-122,8,11,19
1405,SpokaneStBridge,02/28/2014 01:00:00 PM,48,-122,15,13,28
1406,SpokaneStBridge,02/28/2014 02:00:00 PM,48,-122,17,21,38
1407,SpokaneStBridge,02/28/2014 03:00:00 PM,48,-122,18,29,47
1408,SpokaneStBridge,02/28/2014 04:00:00 PM,48,-122,19,48,67
1409,SpokaneStBridge,02/28/2014 05:00:00 PM,48,-122,18,81,99
1410,SpokaneStBridge,02/28/2014 06:00:00 PM,48,-122,15,39,54
1411,SpokaneStBridge,02/28/2014 07:00:00 PM,48,-122,7,17,24
1412,SpokaneStBridge,02/28/2014 08:00:00 PM,48,-122,3,8,11
1413,SpokaneStBridge,02/28/2014 09:00:00 PM,48,-122,0,5,5
1414,SpokaneStBridge,02/28/2014 10:00:00 PM,48,-122,0,4,4
1415,SpokaneStBridge,02/28/2014 11:00:00 PM,48,-122,4,2,6
1416,SpokaneStBridge,03/01/2014 12:00:00 AM,48,-122,2,1,3
1417,SpokaneStBridge,03/01/2014 01:00:00 AM,48,-122,1,1,2
1418,SpokaneStBridge,03/01/2014 02:00:00 AM,48,-122,1,1,2
1419,SpokaneStBridge,03/01/2014 03:00:00 AM,48,-122,0,1,1
1420,SpokaneStBridge,03/01/2014 04:00:00 AM,48,-122,1,2,3
1421,SpokaneStBridge,03/01/2014 05:00:00 AM,48,-122,3,1,4
1422,SpokaneStBridge,03/01/2014 06:00:00 AM,48,-122,4,1,5
1423,SpokaneStBridge,03/01/2014 07:00:00 AM,48,-122,5,0,5
1424,SpokaneStBridge,03/01/2014 08:00:00 AM,48,-122,17,3,20
1425,SpokaneStBridge,03/01/2014 09:00:00 AM,48,-122,18,14,32
1426,SpokaneStBridge,03/01/2014 10:00:00 AM,48,-122,20,9,29
1427,SpokaneStBridge,03/01/2014 11:00:00 AM,48,-122,16,22,38
1428,SpokaneStBridge,03/01/2014 12:00:00 PM,48,-122,18,21,39
1429,SpokaneStBridge,03/01/2014 01:00:00 PM,48,-122,13,20,33
1430,SpokaneStBridge,03/01/2014 02:00:00 PM,48,-122,3,5,8
1431,SpokaneStBridge,03/01/2014 03:00:00 PM,48,-122,6,8,14
1432,SpokaneStBridge,03/01/2014 04:00:00 PM,48,-122,2,9,11
1433,SpokaneStBridge,03/01/2014 05:00:00 PM,48,-122,1,13,14
1434,SpokaneStBridge,03/01/2014 06:00:00 PM,48,-122,4,5,9
1435,SpokaneStBridge,03/01/2014 07:00:00 PM,48,-122,1,4,5
1436,SpokaneStBridge,03/01/2014 08:00:00 PM,48,-122,2,2,4
1437,SpokaneStBridge,03/01/2014 09:00:00 PM,48,-122,0,1,1
1438,SpokaneStBridge,03/01/2014 10:00:00 PM,48,-122,1,1,2
1439,SpokaneStBridge,03/01/2014 11:00:00 PM,48,-122,2,1,3
1440,SpokaneStBridge,03/02/2014 12:00:00 AM,48,-122,1,1,2
1441,SpokaneStBridge,03/02/2014 01:00:00 AM,48,-122,0,3,3
1442,SpokaneStBridge,03/02/2014 02:00:00 AM,48,-122,2,0,2
1443,SpokaneStBridge,03/02/2014 03:00:00 AM,48,-122,1,1,2
1444,SpokaneStBridge,03/02/2014 04:00:00 AM,48,-122,2,0,2
1445,SpokaneStBridge,03/02/2014 05:00:00 AM,48,-122,1,1,2
1446,SpokaneStBridge,03/02/2014 06:00:00 AM,48,-122,1,1,2
1447,SpokaneStBridge,03/02/2014 07:00:00 AM,48,-122,3,0,3
1448,SpokaneStBridge,03/02/2014 08:00:00 AM,48,-122,2,1,3
1449,SpokaneStBridge,03/02/2014 09:00:00 AM,48,-122,5,4,9
1450,SpokaneStBridge,03/02/2014 10:00:00 AM,48,-122,12,4,16
1451,SpokaneStBridge,03/02/2014 11:00:00 AM,48,-122,4,3,7
1452,SpokaneStBridge,03/02/2014 12:00:00 PM,48,-122,2,3,5
1453,SpokaneStBridge,03/02/2014 01:00:00 PM,48,-122,1,3,4
1454,SpokaneStBridge,03/02/2014 02:00:00 PM,48,-122,1,4,5
1455,SpokaneStBridge,03/02/2014 03:00:00 PM,48,-122,3,9,12
1456,SpokaneStBridge,03/02/2014 04:00:00 PM,48,-122,1,6,7
1457,SpokaneStBridge,03/02/2014 05:00:00 PM,48,-122,1,3,4
1458,SpokaneStBridge,03/02/2014 06:00:00 PM,48,-122,2,0,2
1459,SpokaneStBridge,03/02/2014 07:00:00 PM,48,-122,0,0,0
1460,SpokaneStBridge,03/02/2014 08:00:00 PM,48,-122,0,1,1
1461,SpokaneStBridge,03/02/2014 09:00:00 PM,48,-122,1,0,1
1462,SpokaneStBridge,03/02/2014 10:00:00 PM,48,-122,0,1,1
1463,SpokaneStBridge,03/02/2014 11:00:00 PM,48,-122,0,0,0
1464,SpokaneStBridge,03/03/2014 12:00:00 AM,48,-122,0,0,0
1465,SpokaneStBridge,03/03/2014 01:00:00 AM,48,-122,0,0,0
1466,SpokaneStBridge,03/03/2014 02:00:00 AM,48,-122,0,0,0
1467,SpokaneStBridge,03/03/2014 03:00:00 AM,48,-122,1,1,2
1468,SpokaneStBridge,03/03/2014 04:00:00 AM,48,-122,2,1,3
1469,SpokaneStBridge,03/03/2014 05:00:00 AM,48,-122,10,3,13
1470,SpokaneStBridge,03/03/2014 06:00:00 AM,48,-122,31,3,34
1471,SpokaneStBridge,03/03/2014 07:00:00 AM,48,-122,54,6,60
1472,SpokaneStBridge,03/03/2014 08:00:00 AM,48,-122,46,2,48
1473,SpokaneStBridge,03/03/2014 09:00:00 AM,48,-122,14,2,16
1474,SpokaneStBridge,03/03/2014 10:00:00 AM,48,-122,4,0,4
1475,SpokaneStBridge,03/03/2014 11:00:00 AM,48,-122,3,1,4
1476,SpokaneStBridge,03/03/2014 12:00:00 PM,48,-122,6,3,9
1477,SpokaneStBridge,03/03/2014 01:00:00 PM,48,-122,7,3,10
1478,SpokaneStBridge,03/03/2014 02:00:00 PM,48,-122,6,8,14
1479,SpokaneStBridge,03/03/2014 03:00:00 PM,48,-122,8,28,36
1480,SpokaneStBridge,03/03/2014 04:00:00 PM,48,-122,20,31,51
1481,SpokaneStBridge,03/03/2014 05:00:00 PM,48,-122,11,68,79
1482,SpokaneStBridge,03/03/2014 06:00:00 PM,48,-122,5,33,38
1483,SpokaneStBridge,03/03/2014 07:00:00 PM,48,-122,6,21,27
1484,SpokaneStBridge,03/03/2014 08:00:00 PM,48,-122,1,6,7
1485,SpokaneStBridge,03/03/2014 09:00:00 PM,48,-122,1,3,4
1486,SpokaneStBridge,03/03/2014 10:00:00 PM,48,-122,2,1,3
1487,SpokaneStBridge,03/03/2014 11:00:00 PM,48,-122,0,1,1
1488,SpokaneStBridge,03/04/2014 12:00:00 AM,48,-122,1,1,2
1489,SpokaneStBridge,03/04/2014 01:00:00 AM,48,-122,1,1,2
1490,SpokaneStBridge,03/04/2014 02:00:00 AM,48,-122,1,0,1
1491,SpokaneStBridge,03/04/2014 03:00:00 AM,48,-122,2,0,2
1492,SpokaneStBridge,03/04/2014 04:00:00 AM,48,-122,0,1,1
1493,SpokaneStBridge,03/04/2014 05:00:00 AM,48,-122,13,3,16
1494,SpokaneStBridge,03/04/2014 06:00:00 AM,48,-122,42,6,48
1495,SpokaneStBridge,03/04/2014 07:00:00 AM,48,-122,57,13,70
1496,SpokaneStBridge,03/04/2014 08:00:00 AM,48,-122,51,5,56
1497,SpokaneStBridge,03/04/2014 09:00:00 AM,48,-122,28,1,29
1498,SpokaneStBridge,03/04/2014 10:00:00 AM,48,-122,4,2,6
1499,SpokaneStBridge,03/04/2014 11:00:00 AM,48,-122,5,0,5
1500,SpokaneStBridge,03/04/2014 12:00:00 PM,48,-122,3,4,7
1501,SpokaneStBridge,03/04/2014 01:00:00 PM,48,-122,4,6,10
1502,SpokaneStBridge,03/04/2014 02:00:00 PM,48,-122,2,6,8
1503,SpokaneStBridge,03/04/2014 03:00:00 PM,48,-122,9,11,20
1504,SpokaneStBridge,03/04/2014 04:00:00 PM,48,-122,11,27,38
1505,SpokaneStBridge,03/04/2014 05:00:00 PM,48,-122,17,72,89
1506,SpokaneStBridge,03/04/2014 06:00:00 PM,48,-122,3,31,34
1507,SpokaneStBridge,03/04/2014 07:00:00 PM,48,-122,2,19,21
1508,SpokaneStBridge,03/04/2014 08:00:00 PM,48,-122,2,6,8
1509,SpokaneStBridge,03/04/2014 09:00:00 PM,48,-122,0,3,3
1510,SpokaneStBridge,03/04/2014 10:00:00 PM,48,-122,1,0,1
1511,SpokaneStBridge,03/04/2014 11:00:00 PM,48,-122,0,5,5
1512,SpokaneStBridge,03/05/2014 12:00:00 AM,48,-122,0,2,2
1513,SpokaneStBridge,03/05/2014 01:00:00 AM,48,-122,1,0,1
1514,SpokaneStBridge,03/05/2014 02:00:00 AM,48,-122,0,1,1
1515,SpokaneStBridge,03/05/2014 03:00:00 AM,48,-122,1,0,1
1516,SpokaneStBridge,03/05/2014 04:00:00 AM,48,-122,2,0,2
1517,SpokaneStBridge,03/05/2014 05:00:00 AM,48,-122,8,1,9
1518,SpokaneStBridge,03/05/2014 06:00:00 AM,48,-122,28,5,33
1519,SpokaneStBridge,03/05/2014 07:00:00 AM,48,-122,51,8,59
1520,SpokaneStBridge,03/05/2014 08:00:00 AM,48,-122,55,8,63
1521,SpokaneStBridge,03/05/2014 09:00:00 AM,48,-122,17,1,18
1522,SpokaneStBridge,03/05/2014 10:00:00 AM,48,-122,11,5,16
1523,SpokaneStBridge,03/05/2014 11:00:00 AM,48,-122,5,1,6
1524,SpokaneStBridge,03/05/2014 12:00:00 PM,48,-122,11,5,16
1525,SpokaneStBridge,03/05/2014 01:00:00 PM,48,-122,9,3,12
1526,SpokaneStBridge,03/05/2014 02:00:00 PM,48,-122,8,11,19
1527,SpokaneStBridge,03/05/2014 03:00:00 PM,48,-122,5,18,23
1528,SpokaneStBridge,03/05/2014 04:00:00 PM,48,-122,11,25,36
1529,SpokaneStBridge,03/05/2014 05:00:00 PM,48,-122,8,45,53
1530,SpokaneStBridge,03/05/2014 06:00:00 PM,48,-122,5,44,49
1531,SpokaneStBridge,03/05/2014 07:00:00 PM,48,-122,3,13,16
1532,SpokaneStBridge,03/05/2014 08:00:00 PM,48,-122,3,11,14
1533,SpokaneStBridge,03/05/2014 09:00:00 PM,48,-122,1,8,9
1534,SpokaneStBridge,03/05/2014 10:00:00 PM,48,-122,1,3,4
1535,SpokaneStBridge,03/05/2014 11:00:00 PM,48,-122,2,2,4
1536,SpokaneStBridge,03/06/2014 12:00:00 AM,48,-122,0,1,1
1537,SpokaneStBridge,03/06/2014 01:00:00 AM,48,-122,0,0,0
1538,SpokaneStBridge,03/06/2014 02:00:00 AM,48,-122,1,1,2
1539,SpokaneStBridge,03/06/2014 03:00:00 AM,48,-122,1,0,1
1540,SpokaneStBridge,03/06/2014 04:00:00 AM,48,-122,2,0,2
1541,SpokaneStBridge,03/06/2014 05:00:00 AM,48,-122,9,2,11
1542,SpokaneStBridge,03/06/2014 06:00:00 AM,48,-122,28,6,34
1543,SpokaneStBridge,03/06/2014 07:00:00 AM,48,-122,51,5,56
1544,SpokaneStBridge,03/06/2014 08:00:00 AM,48,-122,60,6,66
1545,SpokaneStBridge,03/06/2014 09:00:00 AM,48,-122,25,3,28
1546,SpokaneStBridge,03/06/2014 10:00:00 AM,48,-122,5,2,7
1547,SpokaneStBridge,03/06/2014 11:00:00 AM,48,-122,3,2,5
1548,SpokaneStBridge,03/06/2014 12:00:00 PM,48,-122,6,6,12
1549,SpokaneStBridge,03/06/2014 01:00:00 PM,48,-122,9,1,10
1550,SpokaneStBridge,03/06/2014 02:00:00 PM,48,-122,8,2,10
1551,SpokaneStBridge,03/06/2014 03:00:00 PM,48,-122,5,19,24
1552,SpokaneStBridge,03/06/2014 04:00:00 PM,48,-122,14,29,43
1553,SpokaneStBridge,03/06/2014 05:00:00 PM,48,-122,8,54,62
1554,SpokaneStBridge,03/06/2014 06:00:00 PM,48,-122,12,44,56
1555,SpokaneStBridge,03/06/2014 07:00:00 PM,48,-122,4,16,20
1556,SpokaneStBridge,03/06/2014 08:00:00 PM,48,-122,3,9,12
1557,SpokaneStBridge,03/06/2014 09:00:00 PM,48,-122,5,4,9
1558,SpokaneStBridge,03/06/2014 10:00:00 PM,48,-122,1,4,5
1559,SpokaneStBridge,03/06/2014 11:00:00 PM,48,-122,0,3,3
1560,SpokaneStBridge,03/07/2014 12:00:00 AM,48,-122,2,5,7
1561,SpokaneStBridge,03/07/2014 01:00:00 AM,48,-122,0,1,1
1562,SpokaneStBridge,03/07/2014 02:00:00 AM,48,-122,1,2,3
1563,SpokaneStBridge,03/07/2014 03:00:00 AM,48,-122,1,1,2
1564,SpokaneStBridge,03/07/2014 04:00:00 AM,48,-122,4,0,4
1565,SpokaneStBridge,03/07/2014 05:00:00 AM,48,-122,12,2,14
1566,SpokaneStBridge,03/07/2014 06:00:00 AM,48,-122,37,8,45
1567,SpokaneStBridge,03/07/2014 07:00:00 AM,48,-122,75,18,93
1568,SpokaneStBridge,03/07/2014 08:00:00 AM,48,-122,64,3,67
1569,SpokaneStBridge,03/07/2014 09:00:00 AM,48,-122,25,8,33
1570,SpokaneStBridge,03/07/2014 10:00:00 AM,48,-122,21,7,28
1571,SpokaneStBridge,03/07/2014 11:00:00 AM,48,-122,11,3,14
1572,SpokaneStBridge,03/07/2014 12:00:00 PM,48,-122,11,6,17
1573,SpokaneStBridge,03/07/2014 01:00:00 PM,48,-122,20,13,33
1574,SpokaneStBridge,03/07/2014 02:00:00 PM,48,-122,11,15,26
1575,SpokaneStBridge,03/07/2014 03:00:00 PM,48,-122,15,39,54
1576,SpokaneStBridge,03/07/2014 04:00:00 PM,48,-122,19,50,69
1577,SpokaneStBridge,03/07/2014 05:00:00 PM,48,-122,15,85,100
1578,SpokaneStBridge,03/07/2014 06:00:00 PM,48,-122,14,50,64
1579,SpokaneStBridge,03/07/2014 07:00:00 PM,48,-122,6,13,19
1580,SpokaneStBridge,03/07/2014 08:00:00 PM,48,-122,4,10,14
1581,SpokaneStBridge,03/07/2014 09:00:00 PM,48,-122,0,5,5
1582,SpokaneStBridge,03/07/2014 10:00:00 PM,48,-122,1,2,3
1583,SpokaneStBridge,03/07/2014 11:00:00 PM,48,-122,3,2,5
1584,SpokaneStBridge,03/08/2014 12:00:00 AM,48,-122,0,3,3
1585,SpokaneStBridge,03/08/2014 01:00:00 AM,48,-122,0,0,0
1586,SpokaneStBridge,03/08/2014 02:00:00 AM,48,-122,0,1,1
1587,SpokaneStBridge,03/08/2014 03:00:00 AM,48,-122,4,2,6
1588,SpokaneStBridge,03/08/2014 04:00:00 AM,48,-122,2,1,3
1589,SpokaneStBridge,03/08/2014 05:00:00 AM,48,-122,2,0,2
1590,SpokaneStBridge,03/08/2014 06:00:00 AM,48,-122,7,2,9
1591,SpokaneStBridge,03/08/2014 07:00:00 AM,48,-122,6,4,10
1592,SpokaneStBridge,03/08/2014 08:00:00 AM,48,-122,20,9,29
1593,SpokaneStBridge,03/08/2014 09:00:00 AM,48,-122,14,19,33
1594,SpokaneStBridge,03/08/2014 10:00:00 AM,48,-122,16,15,31
1595,SpokaneStBridge,03/08/2014 11:00:00 AM,48,-122,12,12,24
1596,SpokaneStBridge,03/08/2014 12:00:00 PM,48,-122,7,5,12
1597,SpokaneStBridge,03/08/2014 01:00:00 PM,48,-122,5,7,12
1598,SpokaneStBridge,03/08/2014 02:00:00 PM,48,-122,3,3,6
1599,SpokaneStBridge,03/08/2014 03:00:00 PM,48,-122,4,6,10
1600,SpokaneStBridge,03/08/2014 04:00:00 PM,48,-122,4,1,5
1601,SpokaneStBridge,03/08/2014 05:00:00 PM,48,-122,0,3,3
1602,SpokaneStBridge,03/08/2014 06:00:00 PM,48,-122,0,2,2
1603,SpokaneStBridge,03/08/2014 07:00:00 PM,48,-122,2,1,3
1604,SpokaneStBridge,03/08/2014 08:00:00 PM,48,-122,0,0,0
1605,SpokaneStBridge,03/08/2014 09:00:00 PM,48,-122,0,1,1
1606,SpokaneStBridge,03/08/2014 10:00:00 PM,48,-122,0,0,0
1607,SpokaneStBridge,03/08/2014 11:00:00 PM,48,-122,1,0,1
1608,SpokaneStBridge,03/09/2014 12:00:00 AM,48,-122,0,2,2
1609,SpokaneStBridge,03/09/2014 01:00:00 AM,48,-122,0,0,0
1610,SpokaneStBridge,03/09/2014 03:00:00 AM,48,-122,,,
1611,SpokaneStBridge,03/09/2014 03:00:00 AM,48,-122,0,2,2
1612,SpokaneStBridge,03/09/2014 04:00:00 AM,48,-122,1,0,1
1613,SpokaneStBridge,03/09/2014 05:00:00 AM,48,-122,1,1,2
1614,SpokaneStBridge,03/09/2014 06:00:00 AM,48,-122,0,1,1
1615,SpokaneStBridge,03/09/2014 07:00:00 AM,48,-122,0,0,0
1616,SpokaneStBridge,03/09/2014 08:00:00 AM,48,-122,1,0,1
1617,SpokaneStBridge,03/09/2014 09:00:00 AM,48,-122,4,2,6
1618,SpokaneStBridge,03/09/2014 10:00:00 AM,48,-122,8,4,12
1619,SpokaneStBridge,03/09/2014 11:00:00 AM,48,-122,7,10,17
1620,SpokaneStBridge,03/09/2014 12:00:00 PM,48,-122,13,18,31
1621,SpokaneStBridge,03/09/2014 01:00:00 PM,48,-122,24,16,40
1622,SpokaneStBridge,03/09/2014 02:00:00 PM,48,-122,23,20,43
1623,SpokaneStBridge,03/09/2014 03:00:00 PM,48,-122,14,40,54
1624,SpokaneStBridge,03/09/2014 04:00:00 PM,48,-122,24,16,40
1625,SpokaneStBridge,03/09/2014 05:00:00 PM,48,-122,8,5,13
1626,SpokaneStBridge,03/09/2014 06:00:00 PM,48,-122,10,3,13
1627,SpokaneStBridge,03/09/2014 07:00:00 PM,48,-122,4,2,6
1628,SpokaneStBridge,03/09/2014 08:00:00 PM,48,-122,3,0,3
1629,SpokaneStBridge,03/09/2014 09:00:00 PM,48,-122,0,2,2
1630,SpokaneStBridge,03/09/2014 10:00:00 PM,48,-122,1,2,3
1631,SpokaneStBridge,03/09/2014 11:00:00 PM,48,-122,0,0,0
1632,SpokaneStBridge,03/10/2014 12:00:00 AM,48,-122,0,1,1
1633,SpokaneStBridge,03/10/2014 01:00:00 AM,48,-122,0,0,0
1634,SpokaneStBridge,03/10/2014 02:00:00 AM,48,-122,0,0,0
1635,SpokaneStBridge,03/10/2014 03:00:00 AM,48,-122,1,2,3
1636,SpokaneStBridge,03/10/2014 04:00:00 AM,48,-122,2,1,3
1637,SpokaneStBridge,03/10/2014 05:00:00 AM,48,-122,5,4,9
1638,SpokaneStBridge,03/10/2014 06:00:00 AM,48,-122,36,6,42
1639,SpokaneStBridge,03/10/2014 07:00:00 AM,48,-122,51,11,62
1640,SpokaneStBridge,03/10/2014 08:00:00 AM,48,-122,46,9,55
1641,SpokaneStBridge,03/10/2014 09:00:00 AM,48,-122,30,2,32
1642,SpokaneStBridge,03/10/2014 10:00:00 AM,48,-122,10,0,10
1643,SpokaneStBridge,03/10/2014 11:00:00 AM,48,-122,5,2,7
1644,SpokaneStBridge,03/10/2014 12:00:00 PM,48,-122,6,0,6
1645,SpokaneStBridge,03/10/2014 01:00:00 PM,48,-122,4,4,8
1646,SpokaneStBridge,03/10/2014 02:00:00 PM,48,-122,7,7,14
1647,SpokaneStBridge,03/10/2014 03:00:00 PM,48,-122,9,14,23
1648,SpokaneStBridge,03/10/2014 04:00:00 PM,48,-122,21,44,65
1649,SpokaneStBridge,03/10/2014 05:00:00 PM,48,-122,9,54,63
1650,SpokaneStBridge,03/10/2014 06:00:00 PM,48,-122,7,47,54
1651,SpokaneStBridge,03/10/2014 07:00:00 PM,48,-122,2,20,22
1652,SpokaneStBridge,03/10/2014 08:00:00 PM,48,-122,1,4,5
1653,SpokaneStBridge,03/10/2014 09:00:00 PM,48,-122,0,3,3
1654,SpokaneStBridge,03/10/2014 10:00:00 PM,48,-122,1,5,6
1655,SpokaneStBridge,03/10/2014 11:00:00 PM,48,-122,0,2,2
1656,SpokaneStBridge,03/11/2014 12:00:00 AM,48,-122,0,1,1
1657,SpokaneStBridge,03/11/2014 01:00:00 AM,48,-122,0,0,0
1658,SpokaneStBridge,03/11/2014 02:00:00 AM,48,-122,0,1,1
1659,SpokaneStBridge,03/11/2014 03:00:00 AM,48,-122,0,1,1
1660,SpokaneStBridge,03/11/2014 04:00:00 AM,48,-122,2,0,2
1661,SpokaneStBridge,03/11/2014 05:00:00 AM,48,-122,14,4,18
1662,SpokaneStBridge,03/11/2014 06:00:00 AM,48,-122,46,10,56
1663,SpokaneStBridge,03/11/2014 07:00:00 AM,48,-122,90,17,107
1664,SpokaneStBridge,03/11/2014 08:00:00 AM,48,-122,83,11,94
1665,SpokaneStBridge,03/11/2014 09:00:00 AM,48,-122,42,10,52
1666,SpokaneStBridge,03/11/2014 10:00:00 AM,48,-122,12,4,16
1667,SpokaneStBridge,03/11/2014 11:00:00 AM,48,-122,14,8,22
1668,SpokaneStBridge,03/11/2014 12:00:00 PM,48,-122,10,15,25
1669,SpokaneStBridge,03/11/2014 01:00:00 PM,48,-122,19,14,33
1670,SpokaneStBridge,03/11/2014 02:00:00 PM,48,-122,11,20,31
1671,SpokaneStBridge,03/11/2014 03:00:00 PM,48,-122,20,51,71
1672,SpokaneStBridge,03/11/2014 04:00:00 PM,48,-122,29,55,84
1673,SpokaneStBridge,03/11/2014 05:00:00 PM,48,-122,26,120,146
1674,SpokaneStBridge,03/11/2014 06:00:00 PM,48,-122,18,83,101
1675,SpokaneStBridge,03/11/2014 07:00:00 PM,48,-122,6,29,35
1676,SpokaneStBridge,03/11/2014 08:00:00 PM,48,-122,2,10,12
1677,SpokaneStBridge,03/11/2014 09:00:00 PM,48,-122,6,11,17
1678,SpokaneStBridge,03/11/2014 10:00:00 PM,48,-122,2,7,9
1679,SpokaneStBridge,03/11/2014 11:00:00 PM,48,-122,0,0,0
1680,SpokaneStBridge,03/12/2014 12:00:00 AM,48,-122,2,4,6
1681,SpokaneStBridge,03/12/2014 01:00:00 AM,48,-122,2,0,2
1682,SpokaneStBridge,03/12/2014 02:00:00 AM,48,-122,0,1,1
1683,SpokaneStBridge,03/12/2014 03:00:00 AM,48,-122,1,1,2
1684,SpokaneStBridge,03/12/2014 04:00:00 AM,48,-122,4,0,4
1685,SpokaneStBridge,03/12/2014 05:00:00 AM,48,-122,14,5,19
1686,SpokaneStBridge,03/12/2014 06:00:00 AM,48,-122,50,12,62
1687,SpokaneStBridge,03/12/2014 07:00:00 AM,48,-122,91,17,108
1688,SpokaneStBridge,03/12/2014 08:00:00 AM,48,-122,109,11,120
1689,SpokaneStBridge,03/12/2014 09:00:00 AM,48,-122,49,6,55
1690,SpokaneStBridge,03/12/2014 10:00:00 AM,48,-122,24,6,30
1691,SpokaneStBridge,03/12/2014 11:00:00 AM,48,-122,8,11,19
1692,SpokaneStBridge,03/12/2014 12:00:00 PM,48,-122,13,8,21
1693,SpokaneStBridge,03/12/2014 01:00:00 PM,48,-122,14,25,39
1694,SpokaneStBridge,03/12/2014 02:00:00 PM,48,-122,18,29,47
1695,SpokaneStBridge,03/12/2014 03:00:00 PM,48,-122,16,38,54
1696,SpokaneStBridge,03/12/2014 04:00:00 PM,48,-122,32,63,95
1697,SpokaneStBridge,03/12/2014 05:00:00 PM,48,-122,25,116,141
1698,SpokaneStBridge,03/12/2014 06:00:00 PM,48,-122,26,108,134
1699,SpokaneStBridge,03/12/2014 07:00:00 PM,48,-122,5,35,40
1700,SpokaneStBridge,03/12/2014 08:00:00 PM,48,-122,8,14,22
1701,SpokaneStBridge,03/12/2014 09:00:00 PM,48,-122,5,4,9
1702,SpokaneStBridge,03/12/2014 10:00:00 PM,48,-122,0,10,10
1703,SpokaneStBridge,03/12/2014 11:00:00 PM,48,-122,5,2,7
1704,SpokaneStBridge,03/13/2014 12:00:00 AM,48,-122,0,0,0
1705,SpokaneStBridge,03/13/2014 01:00:00 AM,48,-122,0,1,1
1706,SpokaneStBridge,03/13/2014 02:00:00 AM,48,-122,0,1,1
1707,SpokaneStBridge,03/13/2014 03:00:00 AM,48,-122,1,2,3
1708,SpokaneStBridge,03/13/2014 04:00:00 AM,48,-122,5,0,5
1709,SpokaneStBridge,03/13/2014 05:00:00 AM,48,-122,17,4,21
1710,SpokaneStBridge,03/13/2014 06:00:00 AM,48,-122,54,7,61
1711,SpokaneStBridge,03/13/2014 07:00:00 AM,48,-122,102,12,114
1712,SpokaneStBridge,03/13/2014 08:00:00 AM,48,-122,74,9,83
1713,SpokaneStBridge,03/13/2014 09:00:00 AM,48,-122,41,9,50
1714,SpokaneStBridge,03/13/2014 10:00:00 AM,48,-122,19,2,21
1715,SpokaneStBridge,03/13/2014 11:00:00 AM,48,-122,12,5,17
1716,SpokaneStBridge,03/13/2014 12:00:00 PM,48,-122,11,15,26
1717,SpokaneStBridge,03/13/2014 01:00:00 PM,48,-122,13,12,25
1718,SpokaneStBridge,03/13/2014 02:00:00 PM,48,-122,14,16,30
1719,SpokaneStBridge,03/13/2014 03:00:00 PM,48,-122,16,31,47
1720,SpokaneStBridge,03/13/2014 04:00:00 PM,48,-122,17,51,68
1721,SpokaneStBridge,03/13/2014 05:00:00 PM,48,-122,22,105,127
1722,SpokaneStBridge,03/13/2014 06:00:00 PM,48,-122,20,75,95
1723,SpokaneStBridge,03/13/2014 07:00:00 PM,48,-122,11,93,104
1724,SpokaneStBridge,03/13/2014 08:00:00 PM,48,-122,13,11,24
1725,SpokaneStBridge,03/13/2014 09:00:00 PM,48,-122,9,6,15
1726,SpokaneStBridge,03/13/2014 10:00:00 PM,48,-122,6,7,13
1727,SpokaneStBridge,03/13/2014 11:00:00 PM,48,-122,6,4,10
1728,SpokaneStBridge,03/14/2014 12:00:00 AM,48,-122,11,4,15
1729,SpokaneStBridge,03/14/2014 01:00:00 AM,48,-122,8,1,9
1730,SpokaneStBridge,03/14/2014 02:00:00 AM,48,-122,0,0,0
1731,SpokaneStBridge,03/14/2014 03:00:00 AM,48,-122,1,0,1
1732,SpokaneStBridge,03/14/2014 04:00:00 AM,48,-122,4,0,4
1733,SpokaneStBridge,03/14/2014 05:00:00 AM,48,-122,11,1,12
1734,SpokaneStBridge,03/14/2014 06:00:00 AM,48,-122,25,5,30
1735,SpokaneStBridge,03/14/2014 07:00:00 AM,48,-122,44,9,53
1736,SpokaneStBridge,03/14/2014 08:00:00 AM,48,-122,59,5,64
1737,SpokaneStBridge,03/14/2014 09:00:00 AM,48,-122,17,1,18
1738,SpokaneStBridge,03/14/2014 10:00:00 AM,48,-122,12,1,13
1739,SpokaneStBridge,03/14/2014 11:00:00 AM,48,-122,6,4,10
1740,SpokaneStBridge,03/14/2014 12:00:00 PM,48,-122,9,9,18
1741,SpokaneStBridge,03/14/2014 01:00:00 PM,48,-122,9,6,15
1742,SpokaneStBridge,03/14/2014 02:00:00 PM,48,-122,8,12,20
1743,SpokaneStBridge,03/14/2014 03:00:00 PM,48,-122,4,20,24
1744,SpokaneStBridge,03/14/2014 04:00:00 PM,48,-122,16,37,53
1745,SpokaneStBridge,03/14/2014 05:00:00 PM,48,-122,7,45,52
1746,SpokaneStBridge,03/14/2014 06:00:00 PM,48,-122,9,44,53
1747,SpokaneStBridge,03/14/2014 07:00:00 PM,48,-122,6,9,15
1748,SpokaneStBridge,03/14/2014 08:00:00 PM,48,-122,3,8,11
1749,SpokaneStBridge,03/14/2014 09:00:00 PM,48,-122,0,3,3
1750,SpokaneStBridge,03/14/2014 10:00:00 PM,48,-122,2,2,4
1751,SpokaneStBridge,03/14/2014 11:00:00 PM,48,-122,3,2,5
1752,SpokaneStBridge,03/15/2014 12:00:00 AM,48,-122,0,1,1
1753,SpokaneStBridge,03/15/2014 01:00:00 AM,48,-122,2,3,5
1754,SpokaneStBridge,03/15/2014 02:00:00 AM,48,-122,0,3,3
1755,SpokaneStBridge,03/15/2014 03:00:00 AM,48,-122,2,2,4
1756,SpokaneStBridge,03/15/2014 04:00:00 AM,48,-122,0,0,0
1757,SpokaneStBridge,03/15/2014 05:00:00 AM,48,-122,2,0,2
1758,SpokaneStBridge,03/15/2014 06:00:00 AM,48,-122,2,0,2
1759,SpokaneStBridge,03/15/2014 07:00:00 AM,48,-122,0,1,1
1760,SpokaneStBridge,03/15/2014 08:00:00 AM,48,-122,13,13,26
1761,SpokaneStBridge,03/15/2014 09:00:00 AM,48,-122,10,6,16
1762,SpokaneStBridge,03/15/2014 10:00:00 AM,48,-122,11,8,19
1763,SpokaneStBridge,03/15/2014 11:00:00 AM,48,-122,5,19,24
1764,SpokaneStBridge,03/15/2014 12:00:00 PM,48,-122,23,12,35
1765,SpokaneStBridge,03/15/2014 01:00:00 PM,48,-122,20,15,35
1766,SpokaneStBridge,03/15/2014 02:00:00 PM,48,-122,18,10,28
1767,SpokaneStBridge,03/15/2014 03:00:00 PM,48,-122,14,15,29
1768,SpokaneStBridge,03/15/2014 04:00:00 PM,48,-122,6,14,20
1769,SpokaneStBridge,03/15/2014 05:00:00 PM,48,-122,7,12,19
1770,SpokaneStBridge,03/15/2014 06:00:00 PM,48,-122,4,7,11
1771,SpokaneStBridge,03/15/2014 07:00:00 PM,48,-122,0,1,1
1772,SpokaneStBridge,03/15/2014 08:00:00 PM,48,-122,2,3,5
1773,SpokaneStBridge,03/15/2014 09:00:00 PM,48,-122,3,1,4
1774,SpokaneStBridge,03/15/2014 10:00:00 PM,48,-122,0,0,0
1775,SpokaneStBridge,03/15/2014 11:00:00 PM,48,-122,1,1,2
1776,SpokaneStBridge,03/16/2014 12:00:00 AM,48,-122,1,1,2
1777,SpokaneStBridge,03/16/2014 01:00:00 AM,48,-122,0,1,1
1778,SpokaneStBridge,03/16/2014 02:00:00 AM,48,-122,0,1,1
1779,SpokaneStBridge,03/16/2014 03:00:00 AM,48,-122,0,0,0
1780,SpokaneStBridge,03/16/2014 04:00:00 AM,48,-122,0,0,0
1781,SpokaneStBridge,03/16/2014 05:00:00 AM,48,-122,1,2,3
1782,SpokaneStBridge,03/16/2014 06:00:00 AM,48,-122,2,1,3
1783,SpokaneStBridge,03/16/2014 07:00:00 AM,48,-122,2,2,4
1784,SpokaneStBridge,03/16/2014 08:00:00 AM,48,-122,1,0,1
1785,SpokaneStBridge,03/16/2014 09:00:00 AM,48,-122,3,0,3
1786,SpokaneStBridge,03/16/2014 10:00:00 AM,48,-122,9,0,9
1787,SpokaneStBridge,03/16/2014 11:00:00 AM,48,-122,0,3,3
1788,SpokaneStBridge,03/16/2014 12:00:00 PM,48,-122,6,3,9
1789,SpokaneStBridge,03/16/2014 01:00:00 PM,48,-122,4,1,5
1790,SpokaneStBridge,03/16/2014 02:00:00 PM,48,-122,2,4,6
1791,SpokaneStBridge,03/16/2014 03:00:00 PM,48,-122,4,4,8
1792,SpokaneStBridge,03/16/2014 04:00:00 PM,48,-122,0,5,5
1793,SpokaneStBridge,03/16/2014 05:00:00 PM,48,-122,0,3,3
1794,SpokaneStBridge,03/16/2014 06:00:00 PM,48,-122,2,0,2
1795,SpokaneStBridge,03/16/2014 07:00:00 PM,48,-122,2,2,4
1796,SpokaneStBridge,03/16/2014 08:00:00 PM,48,-122,0,1,1
1797,SpokaneStBridge,03/16/2014 09:00:00 PM,48,-122,0,0,0
1798,SpokaneStBridge,03/16/2014 10:00:00 PM,48,-122,0,0,0
1799,SpokaneStBridge,03/16/2014 11:00:00 PM,48,-122,0,2,2
1800,SpokaneStBridge,03/17/2014 12:00:00 AM,48,-122,1,0,1
1801,SpokaneStBridge,03/17/2014 01:00:00 AM,48,-122,0,0,0
1802,SpokaneStBridge,03/17/2014 02:00:00 AM,48,-122,0,0,0
1803,SpokaneStBridge,03/17/2014 03:00:00 AM,48,-122,1,0,1
1804,SpokaneStBridge,03/17/2014 04:00:00 AM,48,-122,1,1,2
1805,SpokaneStBridge,03/17/2014 05:00:00 AM,48,-122,12,3,15
1806,SpokaneStBridge,03/17/2014 06:00:00 AM,48,-122,47,7,54
1807,SpokaneStBridge,03/17/2014 07:00:00 AM,48,-122,74,12,86
1808,SpokaneStBridge,03/17/2014 08:00:00 AM,48,-122,78,8,86
1809,SpokaneStBridge,03/17/2014 09:00:00 AM,48,-122,40,8,48
1810,SpokaneStBridge,03/17/2014 10:00:00 AM,48,-122,12,6,18
1811,SpokaneStBridge,03/17/2014 11:00:00 AM,48,-122,8,7,15
1812,SpokaneStBridge,03/17/2014 12:00:00 PM,48,-122,7,4,11
1813,SpokaneStBridge,03/17/2014 01:00:00 PM,48,-122,12,9,21
1814,SpokaneStBridge,03/17/2014 02:00:00 PM,48,-122,11,15,26
1815,SpokaneStBridge,03/17/2014 03:00:00 PM,48,-122,14,40,54
1816,SpokaneStBridge,03/17/2014 04:00:00 PM,48,-122,28,53,81
1817,SpokaneStBridge,03/17/2014 05:00:00 PM,48,-122,16,100,116
1818,SpokaneStBridge,03/17/2014 06:00:00 PM,48,-122,15,74,89
1819,SpokaneStBridge,03/17/2014 07:00:00 PM,48,-122,7,19,26
1820,SpokaneStBridge,03/17/2014 08:00:00 PM,48,-122,3,11,14
1821,SpokaneStBridge,03/17/2014 09:00:00 PM,48,-122,3,8,11
1822,SpokaneStBridge,03/17/2014 10:00:00 PM,48,-122,0,3,3
1823,SpokaneStBridge,03/17/2014 11:00:00 PM,48,-122,1,2,3
1824,SpokaneStBridge,03/18/2014 12:00:00 AM,48,-122,0,1,1
1825,SpokaneStBridge,03/18/2014 01:00:00 AM,48,-122,0,0,0
1826,SpokaneStBridge,03/18/2014 02:00:00 AM,48,-122,0,0,0
1827,SpokaneStBridge,03/18/2014 03:00:00 AM,48,-122,1,1,2
1828,SpokaneStBridge,03/18/2014 04:00:00 AM,48,-122,0,0,0
1829,SpokaneStBridge,03/18/2014 05:00:00 AM,48,-122,17,5,22
1830,SpokaneStBridge,03/18/2014 06:00:00 AM,48,-122,49,14,63
1831,SpokaneStBridge,03/18/2014 07:00:00 AM,48,-122,82,11,93
1832,SpokaneStBridge,03/18/2014 08:00:00 AM,48,-122,82,20,102
1833,SpokaneStBridge,03/18/2014 09:00:00 AM,48,-122,39,8,47
1834,SpokaneStBridge,03/18/2014 10:00:00 AM,48,-122,17,3,20
1835,SpokaneStBridge,03/18/2014 11:00:00 AM,48,-122,13,11,24
1836,SpokaneStBridge,03/18/2014 12:00:00 PM,48,-122,18,3,21
1837,SpokaneStBridge,03/18/2014 01:00:00 PM,48,-122,9,8,17
1838,SpokaneStBridge,03/18/2014 02:00:00 PM,48,-122,8,16,24
1839,SpokaneStBridge,03/18/2014 03:00:00 PM,48,-122,14,28,42
1840,SpokaneStBridge,03/18/2014 04:00:00 PM,48,-122,15,44,59
1841,SpokaneStBridge,03/18/2014 05:00:00 PM,48,-122,16,99,115
1842,SpokaneStBridge,03/18/2014 06:00:00 PM,48,-122,10,62,72
1843,SpokaneStBridge,03/18/2014 07:00:00 PM,48,-122,3,25,28
1844,SpokaneStBridge,03/18/2014 08:00:00 PM,48,-122,1,13,14
1845,SpokaneStBridge,03/18/2014 09:00:00 PM,48,-122,0,5,5
1846,SpokaneStBridge,03/18/2014 10:00:00 PM,48,-122,1,4,5
1847,SpokaneStBridge,03/18/2014 11:00:00 PM,48,-122,0,4,4
1848,SpokaneStBridge,03/19/2014 12:00:00 AM,48,-122,2,3,5
1849,SpokaneStBridge,03/19/2014 01:00:00 AM,48,-122,0,0,0
1850,SpokaneStBridge,03/19/2014 02:00:00 AM,48,-122,1,2,3
1851,SpokaneStBridge,03/19/2014 03:00:00 AM,48,-122,0,3,3
1852,SpokaneStBridge,03/19/2014 04:00:00 AM,48,-122,4,1,5
1853,SpokaneStBridge,03/19/2014 05:00:00 AM,48,-122,11,4,15
1854,SpokaneStBridge,03/19/2014 06:00:00 AM,48,-122,41,6,47
1855,SpokaneStBridge,03/19/2014 07:00:00 AM,48,-122,61,11,72
1856,SpokaneStBridge,03/19/2014 08:00:00 AM,48,-122,76,7,83
1857,SpokaneStBridge,03/19/2014 09:00:00 AM,48,-122,30,3,33
1858,SpokaneStBridge,03/19/2014 10:00:00 AM,48,-122,9,4,13
1859,SpokaneStBridge,03/19/2014 11:00:00 AM,48,-122,10,3,13
1860,SpokaneStBridge,03/19/2014 12:00:00 PM,48,-122,8,2,10
1861,SpokaneStBridge,03/19/2014 01:00:00 PM,48,-122,13,6,19
1862,SpokaneStBridge,03/19/2014 02:00:00 PM,48,-122,7,10,17
1863,SpokaneStBridge,03/19/2014 03:00:00 PM,48,-122,10,29,39
1864,SpokaneStBridge,03/19/2014 04:00:00 PM,48,-122,12,50,62
1865,SpokaneStBridge,03/19/2014 05:00:00 PM,48,-122,16,59,75
1866,SpokaneStBridge,03/19/2014 06:00:00 PM,48,-122,10,54,64
1867,SpokaneStBridge,03/19/2014 07:00:00 PM,48,-122,2,21,23
1868,SpokaneStBridge,03/19/2014 08:00:00 PM,48,-122,2,10,12
1869,SpokaneStBridge,03/19/2014 09:00:00 PM,48,-122,2,11,13
1870,SpokaneStBridge,03/19/2014 10:00:00 PM,48,-122,2,2,4
1871,SpokaneStBridge,03/19/2014 11:00:00 PM,48,-122,3,2,5
1872,SpokaneStBridge,03/20/2014 12:00:00 AM,48,-122,0,3,3
1873,SpokaneStBridge,03/20/2014 01:00:00 AM,48,-122,0,1,1
1874,SpokaneStBridge,03/20/2014 02:00:00 AM,48,-122,1,1,2
1875,SpokaneStBridge,03/20/2014 03:00:00 AM,48,-122,2,0,2
1876,SpokaneStBridge,03/20/2014 04:00:00 AM,48,-122,2,1,3
1877,SpokaneStBridge,03/20/2014 05:00:00 AM,48,-122,16,2,18
1878,SpokaneStBridge,03/20/2014 06:00:00 AM,48,-122,49,10,59
1879,SpokaneStBridge,03/20/2014 07:00:00 AM,48,-122,66,8,74
1880,SpokaneStBridge,03/20/2014 08:00:00 AM,48,-122,84,8,92
1881,SpokaneStBridge,03/20/2014 09:00:00 AM,48,-122,35,4,39
1882,SpokaneStBridge,03/20/2014 10:00:00 AM,48,-122,10,4,14
1883,SpokaneStBridge,03/20/2014 11:00:00 AM,48,-122,12,7,19
1884,SpokaneStBridge,03/20/2014 12:00:00 PM,48,-122,14,10,24
1885,SpokaneStBridge,03/20/2014 01:00:00 PM,48,-122,10,9,19
1886,SpokaneStBridge,03/20/2014 02:00:00 PM,48,-122,7,18,25
1887,SpokaneStBridge,03/20/2014 03:00:00 PM,48,-122,15,32,47
1888,SpokaneStBridge,03/20/2014 04:00:00 PM,48,-122,21,43,64
1889,SpokaneStBridge,03/20/2014 05:00:00 PM,48,-122,13,92,105
1890,SpokaneStBridge,03/20/2014 06:00:00 PM,48,-122,17,45,62
1891,SpokaneStBridge,03/20/2014 07:00:00 PM,48,-122,6,29,35
1892,SpokaneStBridge,03/20/2014 08:00:00 PM,48,-122,3,16,19
1893,SpokaneStBridge,03/20/2014 09:00:00 PM,48,-122,5,4,9
1894,SpokaneStBridge,03/20/2014 10:00:00 PM,48,-122,1,4,5
1895,SpokaneStBridge,03/20/2014 11:00:00 PM,48,-122,0,5,5
1896,SpokaneStBridge,03/21/2014 12:00:00 AM,48,-122,0,0,0
1897,SpokaneStBridge,03/21/2014 01:00:00 AM,48,-122,0,0,0
1898,SpokaneStBridge,03/21/2014 02:00:00 AM,48,-122,0,2,2
1899,SpokaneStBridge,03/21/2014 03:00:00 AM,48,-122,1,3,4
1900,SpokaneStBridge,03/21/2014 04:00:00 AM,48,-122,4,0,4
1901,SpokaneStBridge,03/21/2014 05:00:00 AM,48,-122,10,1,11
1902,SpokaneStBridge,03/21/2014 06:00:00 AM,48,-122,32,10,42
1903,SpokaneStBridge,03/21/2014 07:00:00 AM,48,-122,73,8,81
1904,SpokaneStBridge,03/21/2014 08:00:00 AM,48,-122,72,14,86
1905,SpokaneStBridge,03/21/2014 09:00:00 AM,48,-122,43,8,51
1906,SpokaneStBridge,03/21/2014 10:00:00 AM,48,-122,19,9,28
1907,SpokaneStBridge,03/21/2014 11:00:00 AM,48,-122,14,10,24
1908,SpokaneStBridge,03/21/2014 12:00:00 PM,48,-122,13,13,26
1909,SpokaneStBridge,03/21/2014 01:00:00 PM,48,-122,16,18,34
1910,SpokaneStBridge,03/21/2014 02:00:00 PM,48,-122,14,27,41
1911,SpokaneStBridge,03/21/2014 03:00:00 PM,48,-122,14,31,45
1912,SpokaneStBridge,03/21/2014 04:00:00 PM,48,-122,19,56,75
1913,SpokaneStBridge,03/21/2014 05:00:00 PM,48,-122,25,69,94
1914,SpokaneStBridge,03/21/2014 06:00:00 PM,48,-122,13,63,76
1915,SpokaneStBridge,03/21/2014 07:00:00 PM,48,-122,8,14,22
1916,SpokaneStBridge,03/21/2014 08:00:00 PM,48,-122,3,7,10
1917,SpokaneStBridge,03/21/2014 09:00:00 PM,48,-122,2,1,3
1918,SpokaneStBridge,03/21/2014 10:00:00 PM,48,-122,0,0,0
1919,SpokaneStBridge,03/21/2014 11:00:00 PM,48,-122,4,1,5
1920,SpokaneStBridge,03/22/2014 12:00:00 AM,48,-122,2,1,3
1921,SpokaneStBridge,03/22/2014 01:00:00 AM,48,-122,1,2,3
1922,SpokaneStBridge,03/22/2014 02:00:00 AM,48,-122,0,1,1
1923,SpokaneStBridge,03/22/2014 03:00:00 AM,48,-122,1,0,1
1924,SpokaneStBridge,03/22/2014 04:00:00 AM,48,-122,0,0,0
1925,SpokaneStBridge,03/22/2014 05:00:00 AM,48,-122,2,0,2
1926,SpokaneStBridge,03/22/2014 06:00:00 AM,48,-122,3,0,3
1927,SpokaneStBridge,03/22/2014 07:00:00 AM,48,-122,10,1,11
1928,SpokaneStBridge,03/22/2014 08:00:00 AM,48,-122,16,7,23
1929,SpokaneStBridge,03/22/2014 09:00:00 AM,48,-122,21,14,35
1930,SpokaneStBridge,03/22/2014 10:00:00 AM,48,-122,33,37,70
1931,SpokaneStBridge,03/22/2014 11:00:00 AM,48,-122,27,32,59
1932,SpokaneStBridge,03/22/2014 12:00:00 PM,48,-122,25,27,52
1933,SpokaneStBridge,03/22/2014 01:00:00 PM,48,-122,22,24,46
1934,SpokaneStBridge,03/22/2014 02:00:00 PM,48,-122,34,19,53
1935,SpokaneStBridge,03/22/2014 03:00:00 PM,48,-122,19,31,50
1936,SpokaneStBridge,03/22/2014 04:00:00 PM,48,-122,23,21,44
1937,SpokaneStBridge,03/22/2014 05:00:00 PM,48,-122,26,16,42
1938,SpokaneStBridge,03/22/2014 06:00:00 PM,48,-122,6,13,19
1939,SpokaneStBridge,03/22/2014 07:00:00 PM,48,-122,2,8,10
1940,SpokaneStBridge,03/22/2014 08:00:00 PM,48,-122,2,4,6
1941,SpokaneStBridge,03/22/2014 09:00:00 PM,48,-122,2,1,3
1942,SpokaneStBridge,03/22/2014 10:00:00 PM,48,-122,3,8,11
1943,SpokaneStBridge,03/22/2014 11:00:00 PM,48,-122,2,3,5
1944,SpokaneStBridge,03/23/2014 12:00:00 AM,48,-122,0,4,4
1945,SpokaneStBridge,03/23/2014 01:00:00 AM,48,-122,0,0,0
1946,SpokaneStBridge,03/23/2014 02:00:00 AM,48,-122,0,1,1
1947,SpokaneStBridge,03/23/2014 03:00:00 AM,48,-122,1,0,1
1948,SpokaneStBridge,03/23/2014 04:00:00 AM,48,-122,0,0,0
1949,SpokaneStBridge,03/23/2014 05:00:00 AM,48,-122,1,1,2
1950,SpokaneStBridge,03/23/2014 06:00:00 AM,48,-122,3,1,4
1951,SpokaneStBridge,03/23/2014 07:00:00 AM,48,-122,5,2,7
1952,SpokaneStBridge,03/23/2014 08:00:00 AM,48,-122,13,3,16
1953,SpokaneStBridge,03/23/2014 09:00:00 AM,48,-122,19,25,44
1954,SpokaneStBridge,03/23/2014 10:00:00 AM,48,-122,20,25,45
1955,SpokaneStBridge,03/23/2014 11:00:00 AM,48,-122,32,32,64
1956,SpokaneStBridge,03/23/2014 12:00:00 PM,48,-122,21,37,58
1957,SpokaneStBridge,03/23/2014 01:00:00 PM,48,-122,41,30,71
1958,SpokaneStBridge,03/23/2014 02:00:00 PM,48,-122,46,35,81
1959,SpokaneStBridge,03/23/2014 03:00:00 PM,48,-122,37,42,79
1960,SpokaneStBridge,03/23/2014 04:00:00 PM,48,-122,31,37,68
1961,SpokaneStBridge,03/23/2014 05:00:00 PM,48,-122,39,16,55
1962,SpokaneStBridge,03/23/2014 06:00:00 PM,48,-122,9,10,19
1963,SpokaneStBridge,03/23/2014 07:00:00 PM,48,-122,6,10,16
1964,SpokaneStBridge,03/23/2014 08:00:00 PM,48,-122,3,8,11
1965,SpokaneStBridge,03/23/2014 09:00:00 PM,48,-122,1,5,6
1966,SpokaneStBridge,03/23/2014 10:00:00 PM,48,-122,3,0,3
1967,SpokaneStBridge,03/23/2014 11:00:00 PM,48,-122,0,1,1
1968,SpokaneStBridge,03/24/2014 12:00:00 AM,48,-122,0,2,2
1969,SpokaneStBridge,03/24/2014 01:00:00 AM,48,-122,1,0,1
1970,SpokaneStBridge,03/24/2014 02:00:00 AM,48,-122,0,0,0
1971,SpokaneStBridge,03/24/2014 03:00:00 AM,48,-122,1,0,1
1972,SpokaneStBridge,03/24/2014 04:00:00 AM,48,-122,5,0,5
1973,SpokaneStBridge,03/24/2014 05:00:00 AM,48,-122,18,4,22
1974,SpokaneStBridge,03/24/2014 06:00:00 AM,48,-122,54,12,66
1975,SpokaneStBridge,03/24/2014 07:00:00 AM,48,-122,101,10,111
1976,SpokaneStBridge,03/24/2014 08:00:00 AM,48,-122,95,10,105
1977,SpokaneStBridge,03/24/2014 09:00:00 AM,48,-122,49,5,54
1978,SpokaneStBridge,03/24/2014 10:00:00 AM,48,-122,13,13,26
1979,SpokaneStBridge,03/24/2014 11:00:00 AM,48,-122,9,8,17
1980,SpokaneStBridge,03/24/2014 12:00:00 PM,48,-122,12,8,20
1981,SpokaneStBridge,03/24/2014 01:00:00 PM,48,-122,23,19,42
1982,SpokaneStBridge,03/24/2014 02:00:00 PM,48,-122,16,24,40
1983,SpokaneStBridge,03/24/2014 03:00:00 PM,48,-122,27,56,83
1984,SpokaneStBridge,03/24/2014 04:00:00 PM,48,-122,25,92,117
1985,SpokaneStBridge,03/24/2014 05:00:00 PM,48,-122,35,129,164
1986,SpokaneStBridge,03/24/2014 06:00:00 PM,48,-122,24,78,102
1987,SpokaneStBridge,03/24/2014 07:00:00 PM,48,-122,16,33,49
1988,SpokaneStBridge,03/24/2014 08:00:00 PM,48,-122,9,12,21
1989,SpokaneStBridge,03/24/2014 09:00:00 PM,48,-122,3,8,11
1990,SpokaneStBridge,03/24/2014 10:00:00 PM,48,-122,2,6,8
1991,SpokaneStBridge,03/24/2014 11:00:00 PM,48,-122,2,4,6
1992,SpokaneStBridge,03/25/2014 12:00:00 AM,48,-122,1,4,5
1993,SpokaneStBridge,03/25/2014 01:00:00 AM,48,-122,0,0,0
1994,SpokaneStBridge,03/25/2014 02:00:00 AM,48,-122,0,1,1
1995,SpokaneStBridge,03/25/2014 03:00:00 AM,48,-122,0,1,1
1996,SpokaneStBridge,03/25/2014 04:00:00 AM,48,-122,3,1,4
1997,SpokaneStBridge,03/25/2014 05:00:00 AM,48,-122,18,6,24
1998,SpokaneStBridge,03/25/2014 06:00:00 AM,48,-122,43,11,54
1999,SpokaneStBridge,03/25/2014 07:00:00 AM,48,-122,70,21,91
2000,SpokaneStBridge,03/25/2014 08:00:00 AM,48,-122,61,10,71
2001,SpokaneStBridge,03/25/2014 09:00:00 AM,48,-122,31,3,34
2002,SpokaneStBridge,03/25/2014 10:00:00 AM,48,-122,4,2,6
2003,SpokaneStBridge,03/25/2014 11:00:00 AM,48,-122,3,3,6
2004,SpokaneStBridge,03/25/2014 12:00:00 PM,48,-122,5,8,13
2005,SpokaneStBridge,03/25/2014 01:00:00 PM,48,-122,5,3,8
2006,SpokaneStBridge,03/25/2014 02:00:00 PM,48,-122,5,8,13
2007,SpokaneStBridge,03/25/2014 03:00:00 PM,48,-122,11,18,29
2008,SpokaneStBridge,03/25/2014 04:00:00 PM,48,-122,7,40,47
2009,SpokaneStBridge,03/25/2014 05:00:00 PM,48,-122,4,61,65
2010,SpokaneStBridge,03/25/2014 06:00:00 PM,48,-122,8,47,55
2011,SpokaneStBridge,03/25/2014 07:00:00 PM,48,-122,2,17,19
2012,SpokaneStBridge,03/25/2014 08:00:00 PM,48,-122,3,9,12
2013,SpokaneStBridge,03/25/2014 09:00:00 PM,48,-122,2,5,7
2014,SpokaneStBridge,03/25/2014 10:00:00 PM,48,-122,1,1,2
2015,SpokaneStBridge,03/25/2014 11:00:00 PM,48,-122,0,0,0
2016,SpokaneStBridge,03/26/2014 12:00:00 AM,48,-122,1,0,1
2017,SpokaneStBridge,03/26/2014 01:00:00 AM,48,-122,0,0,0
2018,SpokaneStBridge,03/26/2014 02:00:00 AM,48,-122,1,1,2
2019,SpokaneStBridge,03/26/2014 03:00:00 AM,48,-122,2,1,3
2020,SpokaneStBridge,03/26/2014 04:00:00 AM,48,-122,2,1,3
2021,SpokaneStBridge,03/26/2014 05:00:00 AM,48,-122,14,4,18
2022,SpokaneStBridge,03/26/2014 06:00:00 AM,48,-122,38,6,44
2023,SpokaneStBridge,03/26/2014 07:00:00 AM,48,-122,57,15,72
2024,SpokaneStBridge,03/26/2014 08:00:00 AM,48,-122,74,5,79
2025,SpokaneStBridge,03/26/2014 09:00:00 AM,48,-122,26,5,31
2026,SpokaneStBridge,03/26/2014 10:00:00 AM,48,-122,10,3,13
2027,SpokaneStBridge,03/26/2014 11:00:00 AM,48,-122,9,4,13
2028,SpokaneStBridge,03/26/2014 12:00:00 PM,48,-122,5,4,9
2029,SpokaneStBridge,03/26/2014 01:00:00 PM,48,-122,12,6,18
2030,SpokaneStBridge,03/26/2014 02:00:00 PM,48,-122,3,8,11
2031,SpokaneStBridge,03/26/2014 03:00:00 PM,48,-122,5,27,32
2032,SpokaneStBridge,03/26/2014 04:00:00 PM,48,-122,15,34,49
2033,SpokaneStBridge,03/26/2014 05:00:00 PM,48,-122,9,78,87
2034,SpokaneStBridge,03/26/2014 06:00:00 PM,48,-122,8,44,52
2035,SpokaneStBridge,03/26/2014 07:00:00 PM,48,-122,1,15,16
2036,SpokaneStBridge,03/26/2014 08:00:00 PM,48,-122,4,9,13
2037,SpokaneStBridge,03/26/2014 09:00:00 PM,48,-122,0,6,6
2038,SpokaneStBridge,03/26/2014 10:00:00 PM,48,-122,0,4,4
2039,SpokaneStBridge,03/26/2014 11:00:00 PM,48,-122,1,3,4
2040,SpokaneStBridge,03/27/2014 12:00:00 AM,48,-122,1,1,2
2041,SpokaneStBridge,03/27/2014 01:00:00 AM,48,-122,3,0,3
2042,SpokaneStBridge,03/27/2014 02:00:00 AM,48,-122,1,0,1
2043,SpokaneStBridge,03/27/2014 03:00:00 AM,48,-122,2,0,2
2044,SpokaneStBridge,03/27/2014 04:00:00 AM,48,-122,1,1,2
2045,SpokaneStBridge,03/27/2014 05:00:00 AM,48,-122,14,2,16
2046,SpokaneStBridge,03/27/2014 06:00:00 AM,48,-122,42,9,51
2047,SpokaneStBridge,03/27/2014 07:00:00 AM,48,-122,66,10,76
2048,SpokaneStBridge,03/27/2014 08:00:00 AM,48,-122,64,4,68
2049,SpokaneStBridge,03/27/2014 09:00:00 AM,48,-122,25,8,33
2050,SpokaneStBridge,03/27/2014 10:00:00 AM,48,-122,8,2,10
2051,SpokaneStBridge,03/27/2014 11:00:00 AM,48,-122,5,2,7
2052,SpokaneStBridge,03/27/2014 12:00:00 PM,48,-122,11,10,21
2053,SpokaneStBridge,03/27/2014 01:00:00 PM,48,-122,7,6,13
2054,SpokaneStBridge,03/27/2014 02:00:00 PM,48,-122,12,12,24
2055,SpokaneStBridge,03/27/2014 03:00:00 PM,48,-122,14,25,39
2056,SpokaneStBridge,03/27/2014 04:00:00 PM,48,-122,11,46,57
2057,SpokaneStBridge,03/27/2014 05:00:00 PM,48,-122,22,70,92
2058,SpokaneStBridge,03/27/2014 06:00:00 PM,48,-122,13,64,77
2059,SpokaneStBridge,03/27/2014 07:00:00 PM,48,-122,7,17,24
2060,SpokaneStBridge,03/27/2014 08:00:00 PM,48,-122,4,8,12
2061,SpokaneStBridge,03/27/2014 09:00:00 PM,48,-122,4,8,12
2062,SpokaneStBridge,03/27/2014 10:00:00 PM,48,-122,3,2,5
2063,SpokaneStBridge,03/27/2014 11:00:00 PM,48,-122,1,3,4
2064,SpokaneStBridge,03/28/2014 12:00:00 AM,48,-122,1,1,2
2065,SpokaneStBridge,03/28/2014 01:00:00 AM,48,-122,0,1,1
2066,SpokaneStBridge,03/28/2014 02:00:00 AM,48,-122,1,1,2
2067,SpokaneStBridge,03/28/2014 03:00:00 AM,48,-122,1,1,2
2068,SpokaneStBridge,03/28/2014 04:00:00 AM,48,-122,3,0,3
2069,SpokaneStBridge,03/28/2014 05:00:00 AM,48,-122,13,2,15
2070,SpokaneStBridge,03/28/2014 06:00:00 AM,48,-122,20,5,25
2071,SpokaneStBridge,03/28/2014 07:00:00 AM,48,-122,39,4,43
2072,SpokaneStBridge,03/28/2014 08:00:00 AM,48,-122,44,3,47
2073,SpokaneStBridge,03/28/2014 09:00:00 AM,48,-122,13,5,18
2074,SpokaneStBridge,03/28/2014 10:00:00 AM,48,-122,8,2,10
2075,SpokaneStBridge,03/28/2014 11:00:00 AM,48,-122,5,3,8
2076,SpokaneStBridge,03/28/2014 12:00:00 PM,48,-122,4,2,6
2077,SpokaneStBridge,03/28/2014 01:00:00 PM,48,-122,2,4,6
2078,SpokaneStBridge,03/28/2014 02:00:00 PM,48,-122,4,12,16
2079,SpokaneStBridge,03/28/2014 03:00:00 PM,48,-122,6,8,14
2080,SpokaneStBridge,03/28/2014 04:00:00 PM,48,-122,5,34,39
2081,SpokaneStBridge,03/28/2014 05:00:00 PM,48,-122,5,41,46
2082,SpokaneStBridge,03/28/2014 06:00:00 PM,48,-122,5,25,30
2083,SpokaneStBridge,03/28/2014 07:00:00 PM,48,-122,1,15,16
2084,SpokaneStBridge,03/28/2014 08:00:00 PM,48,-122,2,5,7
2085,SpokaneStBridge,03/28/2014 09:00:00 PM,48,-122,1,2,3
2086,SpokaneStBridge,03/28/2014 10:00:00 PM,48,-122,1,1,2
2087,SpokaneStBridge,03/28/2014 11:00:00 PM,48,-122,1,3,4
2088,SpokaneStBridge,03/29/2014 12:00:00 AM,48,-122,0,0,0
2089,SpokaneStBridge,03/29/2014 01:00:00 AM,48,-122,0,2,2
2090,SpokaneStBridge,03/29/2014 02:00:00 AM,48,-122,1,0,1
2091,SpokaneStBridge,03/29/2014 03:00:00 AM,48,-122,0,1,1
2092,SpokaneStBridge,03/29/2014 04:00:00 AM,48,-122,1,0,1
2093,SpokaneStBridge,03/29/2014 05:00:00 AM,48,-122,3,0,3
2094,SpokaneStBridge,03/29/2014 06:00:00 AM,48,-122,1,0,1
2095,SpokaneStBridge,03/29/2014 07:00:00 AM,48,-122,4,1,5
2096,SpokaneStBridge,03/29/2014 08:00:00 AM,48,-122,4,3,7
2097,SpokaneStBridge,03/29/2014 09:00:00 AM,48,-122,5,2,7
2098,SpokaneStBridge,03/29/2014 10:00:00 AM,48,-122,6,0,6
2099,SpokaneStBridge,03/29/2014 11:00:00 AM,48,-122,3,3,6
2100,SpokaneStBridge,03/29/2014 12:00:00 PM,48,-122,4,4,8
2101,SpokaneStBridge,03/29/2014 01:00:00 PM,48,-122,2,11,13
2102,SpokaneStBridge,03/29/2014 02:00:00 PM,48,-122,7,6,13
2103,SpokaneStBridge,03/29/2014 03:00:00 PM,48,-122,7,5,12
2104,SpokaneStBridge,03/29/2014 04:00:00 PM,48,-122,3,1,4
2105,SpokaneStBridge,03/29/2014 05:00:00 PM,48,-122,4,4,8
2106,SpokaneStBridge,03/29/2014 06:00:00 PM,48,-122,4,4,8
2107,SpokaneStBridge,03/29/2014 07:00:00 PM,48,-122,4,1,5
2108,SpokaneStBridge,03/29/2014 08:00:00 PM,48,-122,0,3,3
2109,SpokaneStBridge,03/29/2014 09:00:00 PM,48,-122,1,0,1
2110,SpokaneStBridge,03/29/2014 10:00:00 PM,48,-122,2,0,2
2111,SpokaneStBridge,03/29/2014 11:00:00 PM,48,-122,0,0,0
2112,SpokaneStBridge,03/30/2014 12:00:00 AM,48,-122,0,0,0
2113,SpokaneStBridge,03/30/2014 01:00:00 AM,48,-122,0,3,3
2114,SpokaneStBridge,03/30/2014 02:00:00 AM,48,-122,0,0,0
2115,SpokaneStBridge,03/30/2014 03:00:00 AM,48,-122,0,0,0
2116,SpokaneStBridge,03/30/2014 04:00:00 AM,48,-122,1,1,2
2117,SpokaneStBridge,03/30/2014 05:00:00 AM,48,-122,0,0,0
2118,SpokaneStBridge,03/30/2014 06:00:00 AM,48,-122,7,2,9
2119,SpokaneStBridge,03/30/2014 07:00:00 AM,48,-122,5,1,6
2120,SpokaneStBridge,03/30/2014 08:00:00 AM,48,-122,3,4,7
2121,SpokaneStBridge,03/30/2014 09:00:00 AM,48,-122,12,10,22
2122,SpokaneStBridge,03/30/2014 10:00:00 AM,48,-122,11,3,14
2123,SpokaneStBridge,03/30/2014 11:00:00 AM,48,-122,14,16,30
2124,SpokaneStBridge,03/30/2014 12:00:00 PM,48,-122,21,11,32
2125,SpokaneStBridge,03/30/2014 01:00:00 PM,48,-122,13,20,33
2126,SpokaneStBridge,03/30/2014 02:00:00 PM,48,-122,11,28,39
2127,SpokaneStBridge,03/30/2014 03:00:00 PM,48,-122,23,14,37
2128,SpokaneStBridge,03/30/2014 04:00:00 PM,48,-122,17,15,32
2129,SpokaneStBridge,03/30/2014 05:00:00 PM,48,-122,6,14,20
2130,SpokaneStBridge,03/30/2014 06:00:00 PM,48,-122,9,4,13
2131,SpokaneStBridge,03/30/2014 07:00:00 PM,48,-122,7,3,10
2132,SpokaneStBridge,03/30/2014 08:00:00 PM,48,-122,2,3,5
2133,SpokaneStBridge,03/30/2014 09:00:00 PM,48,-122,1,0,1
2134,SpokaneStBridge,03/30/2014 10:00:00 PM,48,-122,2,1,3
2135,SpokaneStBridge,03/30/2014 11:00:00 PM,48,-122,4,2,6
2136,SpokaneStBridge,03/31/2014 12:00:00 AM,48,-122,0,1,1
2137,SpokaneStBridge,03/31/2014 01:00:00 AM,48,-122,0,0,0
2138,SpokaneStBridge,03/31/2014 02:00:00 AM,48,-122,2,0,2
2139,SpokaneStBridge,03/31/2014 03:00:00 AM,48,-122,2,0,2
2140,SpokaneStBridge,03/31/2014 04:00:00 AM,48,-122,3,2,5
2141,SpokaneStBridge,03/31/2014 05:00:00 AM,48,-122,19,1,20
2142,SpokaneStBridge,03/31/2014 06:00:00 AM,48,-122,53,14,67
2143,SpokaneStBridge,03/31/2014 07:00:00 AM,48,-122,89,12,101
2144,SpokaneStBridge,03/31/2014 08:00:00 AM,48,-122,104,8,112
2145,SpokaneStBridge,03/31/2014 09:00:00 AM,48,-122,48,10,58
2146,SpokaneStBridge,03/31/2014 10:00:00 AM,48,-122,22,4,26
2147,SpokaneStBridge,03/31/2014 11:00:00 AM,48,-122,16,8,24
2148,SpokaneStBridge,03/31/2014 12:00:00 PM,48,-122,16,8,24
2149,SpokaneStBridge,03/31/2014 01:00:00 PM,48,-122,13,16,29
2150,SpokaneStBridge,03/31/2014 02:00:00 PM,48,-122,14,17,31
2151,SpokaneStBridge,03/31/2014 03:00:00 PM,48,-122,23,37,60
2152,SpokaneStBridge,03/31/2014 04:00:00 PM,48,-122,26,61,87
2153,SpokaneStBridge,03/31/2014 05:00:00 PM,48,-122,24,134,158
2154,SpokaneStBridge,03/31/2014 06:00:00 PM,48,-122,25,95,120
2155,SpokaneStBridge,03/31/2014 07:00:00 PM,48,-122,14,33,47
2156,SpokaneStBridge,03/31/2014 08:00:00 PM,48,-122,3,12,15
2157,SpokaneStBridge,03/31/2014 09:00:00 PM,48,-122,1,8,9
2158,SpokaneStBridge,03/31/2014 10:00:00 PM,48,-122,4,6,10
2159,SpokaneStBridge,03/31/2014 11:00:00 PM,48,-122,0,2,2
2160,SpokaneStBridge,04/01/2014 12:00:00 AM,48,-122,0,3,3
2161,SpokaneStBridge,04/01/2014 01:00:00 AM,48,-122,0,0,0
2162,SpokaneStBridge,04/01/2014 02:00:00 AM,48,-122,0,0,0
2163,SpokaneStBridge,04/01/2014 03:00:00 AM,48,-122,0,0,0
2164,SpokaneStBridge,04/01/2014 04:00:00 AM,48,-122,3,0,3
2165,SpokaneStBridge,04/01/2014 05:00:00 AM,48,-122,22,6,28
2166,SpokaneStBridge,04/01/2014 06:00:00 AM,48,-122,56,10,66
2167,SpokaneStBridge,04/01/2014 07:00:00 AM,48,-122,103,20,123
2168,SpokaneStBridge,04/01/2014 08:00:00 AM,48,-122,108,14,122
2169,SpokaneStBridge,04/01/2014 09:00:00 AM,48,-122,43,10,53
2170,SpokaneStBridge,04/01/2014 10:00:00 AM,48,-122,23,5,28
2171,SpokaneStBridge,04/01/2014 11:00:00 AM,48,-122,8,9,17
2172,SpokaneStBridge,04/01/2014 12:00:00 PM,48,-122,15,9,24
2173,SpokaneStBridge,04/01/2014 01:00:00 PM,48,-122,16,8,24
2174,SpokaneStBridge,04/01/2014 02:00:00 PM,48,-122,12,23,35
2175,SpokaneStBridge,04/01/2014 03:00:00 PM,48,-122,19,33,52
2176,SpokaneStBridge,04/01/2014 04:00:00 PM,48,-122,24,74,98
2177,SpokaneStBridge,04/01/2014 05:00:00 PM,48,-122,26,129,155
2178,SpokaneStBridge,04/01/2014 06:00:00 PM,48,-122,23,90,113
2179,SpokaneStBridge,04/01/2014 07:00:00 PM,48,-122,9,35,44
2180,SpokaneStBridge,04/01/2014 08:00:00 PM,48,-122,12,14,26
2181,SpokaneStBridge,04/01/2014 09:00:00 PM,48,-122,2,10,12
2182,SpokaneStBridge,04/01/2014 10:00:00 PM,48,-122,3,6,9
2183,SpokaneStBridge,04/01/2014 11:00:00 PM,48,-122,0,5,5
2184,SpokaneStBridge,04/02/2014 12:00:00 AM,48,-122,0,2,2
2185,SpokaneStBridge,04/02/2014 01:00:00 AM,48,-122,1,1,2
2186,SpokaneStBridge,04/02/2014 02:00:00 AM,48,-122,1,0,1
2187,SpokaneStBridge,04/02/2014 03:00:00 AM,48,-122,1,1,2
2188,SpokaneStBridge,04/02/2014 04:00:00 AM,48,-122,4,0,4
2189,SpokaneStBridge,04/02/2014 05:00:00 AM,48,-122,18,4,22
2190,SpokaneStBridge,04/02/2014 06:00:00 AM,48,-122,52,14,66
2191,SpokaneStBridge,04/02/2014 07:00:00 AM,48,-122,84,17,101
2192,SpokaneStBridge,04/02/2014 08:00:00 AM,48,-122,103,10,113
2193,SpokaneStBridge,04/02/2014 09:00:00 AM,48,-122,38,1,39
2194,SpokaneStBridge,04/02/2014 10:00:00 AM,48,-122,19,6,25
2195,SpokaneStBridge,04/02/2014 11:00:00 AM,48,-122,8,6,14
2196,SpokaneStBridge,04/02/2014 12:00:00 PM,48,-122,13,11,24
2197,SpokaneStBridge,04/02/2014 01:00:00 PM,48,-122,15,14,29
2198,SpokaneStBridge,04/02/2014 02:00:00 PM,48,-122,18,16,34
2199,SpokaneStBridge,04/02/2014 03:00:00 PM,48,-122,22,29,51
2200,SpokaneStBridge,04/02/2014 04:00:00 PM,48,-122,25,57,82
2201,SpokaneStBridge,04/02/2014 05:00:00 PM,48,-122,20,126,146
2202,SpokaneStBridge,04/02/2014 06:00:00 PM,48,-122,21,76,97
2203,SpokaneStBridge,04/02/2014 07:00:00 PM,48,-122,11,31,42
2204,SpokaneStBridge,04/02/2014 08:00:00 PM,48,-122,9,17,26
2205,SpokaneStBridge,04/02/2014 09:00:00 PM,48,-122,1,15,16
2206,SpokaneStBridge,04/02/2014 10:00:00 PM,48,-122,0,5,5
2207,SpokaneStBridge,04/02/2014 11:00:00 PM,48,-122,1,3,4
2208,SpokaneStBridge,04/03/2014 12:00:00 AM,48,-122,1,2,3
2209,SpokaneStBridge,04/03/2014 01:00:00 AM,48,-122,0,3,3
2210,SpokaneStBridge,04/03/2014 02:00:00 AM,48,-122,1,1,2
2211,SpokaneStBridge,04/03/2014 03:00:00 AM,48,-122,2,2,4
2212,SpokaneStBridge,04/03/2014 04:00:00 AM,48,-122,4,2,6
2213,SpokaneStBridge,04/03/2014 05:00:00 AM,48,-122,21,3,24
2214,SpokaneStBridge,04/03/2014 06:00:00 AM,48,-122,40,12,52
2215,SpokaneStBridge,04/03/2014 07:00:00 AM,48,-122,78,10,88
2216,SpokaneStBridge,04/03/2014 08:00:00 AM,48,-122,85,15,100
2217,SpokaneStBridge,04/03/2014 09:00:00 AM,48,-122,30,7,37
2218,SpokaneStBridge,04/03/2014 10:00:00 AM,48,-122,13,1,14
2219,SpokaneStBridge,04/03/2014 11:00:00 AM,48,-122,6,4,10
2220,SpokaneStBridge,04/03/2014 12:00:00 PM,48,-122,6,8,14
2221,SpokaneStBridge,04/03/2014 01:00:00 PM,48,-122,15,10,25
2222,SpokaneStBridge,04/03/2014 02:00:00 PM,48,-122,17,13,30
2223,SpokaneStBridge,04/03/2014 03:00:00 PM,48,-122,6,16,22
2224,SpokaneStBridge,04/03/2014 04:00:00 PM,48,-122,15,39,54
2225,SpokaneStBridge,04/03/2014 05:00:00 PM,48,-122,12,74,86
2226,SpokaneStBridge,04/03/2014 06:00:00 PM,48,-122,7,50,57
2227,SpokaneStBridge,04/03/2014 07:00:00 PM,48,-122,3,17,20
2228,SpokaneStBridge,04/03/2014 08:00:00 PM,48,-122,3,6,9
2229,SpokaneStBridge,04/03/2014 09:00:00 PM,48,-122,2,4,6
2230,SpokaneStBridge,04/03/2014 10:00:00 PM,48,-122,2,4,6
2231,SpokaneStBridge,04/03/2014 11:00:00 PM,48,-122,0,3,3
2232,SpokaneStBridge,04/04/2014 12:00:00 AM,48,-122,0,2,2
2233,SpokaneStBridge,04/04/2014 01:00:00 AM,48,-122,0,0,0
2234,SpokaneStBridge,04/04/2014 02:00:00 AM,48,-122,0,0,0
2235,SpokaneStBridge,04/04/2014 03:00:00 AM,48,-122,2,0,2
2236,SpokaneStBridge,04/04/2014 04:00:00 AM,48,-122,3,0,3
2237,SpokaneStBridge,04/04/2014 05:00:00 AM,48,-122,13,2,15
2238,SpokaneStBridge,04/04/2014 06:00:00 AM,48,-122,32,7,39
2239,SpokaneStBridge,04/04/2014 07:00:00 AM,48,-122,68,10,78
2240,SpokaneStBridge,04/04/2014 08:00:00 AM,48,-122,69,5,74
2241,SpokaneStBridge,04/04/2014 09:00:00 AM,48,-122,31,4,35
2242,SpokaneStBridge,04/04/2014 10:00:00 AM,48,-122,10,5,15
2243,SpokaneStBridge,04/04/2014 11:00:00 AM,48,-122,7,5,12
2244,SpokaneStBridge,04/04/2014 12:00:00 PM,48,-122,13,5,18
2245,SpokaneStBridge,04/04/2014 01:00:00 PM,48,-122,5,8,13
2246,SpokaneStBridge,04/04/2014 02:00:00 PM,48,-122,6,21,27
2247,SpokaneStBridge,04/04/2014 03:00:00 PM,48,-122,18,21,39
2248,SpokaneStBridge,04/04/2014 04:00:00 PM,48,-122,22,53,75
2249,SpokaneStBridge,04/04/2014 05:00:00 PM,48,-122,16,77,93
2250,SpokaneStBridge,04/04/2014 06:00:00 PM,48,-122,11,57,68
2251,SpokaneStBridge,04/04/2014 07:00:00 PM,48,-122,7,15,22
2252,SpokaneStBridge,04/04/2014 08:00:00 PM,48,-122,3,14,17
2253,SpokaneStBridge,04/04/2014 09:00:00 PM,48,-122,0,3,3
2254,SpokaneStBridge,04/04/2014 10:00:00 PM,48,-122,2,5,7
2255,SpokaneStBridge,04/04/2014 11:00:00 PM,48,-122,2,3,5
2256,SpokaneStBridge,04/05/2014 12:00:00 AM,48,-122,1,2,3
2257,SpokaneStBridge,04/05/2014 01:00:00 AM,48,-122,1,1,2
2258,SpokaneStBridge,04/05/2014 02:00:00 AM,48,-122,0,3,3
2259,SpokaneStBridge,04/05/2014 03:00:00 AM,48,-122,0,1,1
2260,SpokaneStBridge,04/05/2014 04:00:00 AM,48,-122,1,1,2
2261,SpokaneStBridge,04/05/2014 05:00:00 AM,48,-122,3,1,4
2262,SpokaneStBridge,04/05/2014 06:00:00 AM,48,-122,2,2,4
2263,SpokaneStBridge,04/05/2014 07:00:00 AM,48,-122,3,1,4
2264,SpokaneStBridge,04/05/2014 08:00:00 AM,48,-122,12,10,22
2265,SpokaneStBridge,04/05/2014 09:00:00 AM,48,-122,18,8,26
2266,SpokaneStBridge,04/05/2014 10:00:00 AM,48,-122,13,3,16
2267,SpokaneStBridge,04/05/2014 11:00:00 AM,48,-122,14,24,38
2268,SpokaneStBridge,04/05/2014 12:00:00 PM,48,-122,10,17,27
2269,SpokaneStBridge,04/05/2014 01:00:00 PM,48,-122,10,17,27
2270,SpokaneStBridge,04/05/2014 02:00:00 PM,48,-122,19,10,29
2271,SpokaneStBridge,04/05/2014 03:00:00 PM,48,-122,4,5,9
2272,SpokaneStBridge,04/05/2014 04:00:00 PM,48,-122,10,6,16
2273,SpokaneStBridge,04/05/2014 05:00:00 PM,48,-122,5,7,12
2274,SpokaneStBridge,04/05/2014 06:00:00 PM,48,-122,1,6,7
2275,SpokaneStBridge,04/05/2014 07:00:00 PM,48,-122,2,5,7
2276,SpokaneStBridge,04/05/2014 08:00:00 PM,48,-122,3,2,5
2277,SpokaneStBridge,04/05/2014 09:00:00 PM,48,-122,1,4,5
2278,SpokaneStBridge,04/05/2014 10:00:00 PM,48,-122,2,1,3
2279,SpokaneStBridge,04/05/2014 11:00:00 PM,48,-122,3,0,3
2280,SpokaneStBridge,04/06/2014 12:00:00 AM,48,-122,0,3,3
2281,SpokaneStBridge,04/06/2014 01:00:00 AM,48,-122,1,1,2
2282,SpokaneStBridge,04/06/2014 02:00:00 AM,48,-122,0,3,3
2283,SpokaneStBridge,04/06/2014 03:00:00 AM,48,-122,2,0,2
2284,SpokaneStBridge,04/06/2014 04:00:00 AM,48,-122,0,0,0
2285,SpokaneStBridge,04/06/2014 05:00:00 AM,48,-122,1,2,3
2286,SpokaneStBridge,04/06/2014 06:00:00 AM,48,-122,2,1,3
2287,SpokaneStBridge,04/06/2014 07:00:00 AM,48,-122,6,3,9
2288,SpokaneStBridge,04/06/2014 08:00:00 AM,48,-122,7,9,16
2289,SpokaneStBridge,04/06/2014 09:00:00 AM,48,-122,20,13,33
2290,SpokaneStBridge,04/06/2014 10:00:00 AM,48,-122,17,9,26
2291,SpokaneStBridge,04/06/2014 11:00:00 AM,48,-122,23,27,50
2292,SpokaneStBridge,04/06/2014 12:00:00 PM,48,-122,28,34,62
2293,SpokaneStBridge,04/06/2014 01:00:00 PM,48,-122,33,19,52
2294,SpokaneStBridge,04/06/2014 02:00:00 PM,48,-122,23,18,41
2295,SpokaneStBridge,04/06/2014 03:00:00 PM,48,-122,23,24,47
2296,SpokaneStBridge,04/06/2014 04:00:00 PM,48,-122,30,21,51
2297,SpokaneStBridge,04/06/2014 05:00:00 PM,48,-122,3,18,21
2298,SpokaneStBridge,04/06/2014 06:00:00 PM,48,-122,11,15,26
2299,SpokaneStBridge,04/06/2014 07:00:00 PM,48,-122,3,6,9
2300,SpokaneStBridge,04/06/2014 08:00:00 PM,48,-122,0,4,4
2301,SpokaneStBridge,04/06/2014 09:00:00 PM,48,-122,3,0,3
2302,SpokaneStBridge,04/06/2014 10:00:00 PM,48,-122,2,2,4
2303,SpokaneStBridge,04/06/2014 11:00:00 PM,48,-122,0,0,0
2304,SpokaneStBridge,04/07/2014 12:00:00 AM,48,-122,0,2,2
2305,SpokaneStBridge,04/07/2014 01:00:00 AM,48,-122,1,0,1
2306,SpokaneStBridge,04/07/2014 02:00:00 AM,48,-122,1,0,1
2307,SpokaneStBridge,04/07/2014 03:00:00 AM,48,-122,1,0,1
2308,SpokaneStBridge,04/07/2014 04:00:00 AM,48,-122,3,1,4
2309,SpokaneStBridge,04/07/2014 05:00:00 AM,48,-122,15,2,17
2310,SpokaneStBridge,04/07/2014 06:00:00 AM,48,-122,60,14,74
2311,SpokaneStBridge,04/07/2014 07:00:00 AM,48,-122,118,21,139
2312,SpokaneStBridge,04/07/2014 08:00:00 AM,48,-122,110,16,126
2313,SpokaneStBridge,04/07/2014 09:00:00 AM,48,-122,62,11,73
2314,SpokaneStBridge,04/07/2014 10:00:00 AM,48,-122,18,6,24
2315,SpokaneStBridge,04/07/2014 11:00:00 AM,48,-122,21,18,39
2316,SpokaneStBridge,04/07/2014 12:00:00 PM,48,-122,31,16,47
2317,SpokaneStBridge,04/07/2014 01:00:00 PM,48,-122,21,18,39
2318,SpokaneStBridge,04/07/2014 02:00:00 PM,48,-122,21,37,58
2319,SpokaneStBridge,04/07/2014 03:00:00 PM,48,-122,31,49,80
2320,SpokaneStBridge,04/07/2014 04:00:00 PM,48,-122,40,94,134
2321,SpokaneStBridge,04/07/2014 05:00:00 PM,48,-122,45,159,204
2322,SpokaneStBridge,04/07/2014 06:00:00 PM,48,-122,29,113,142
2323,SpokaneStBridge,04/07/2014 07:00:00 PM,48,-122,14,35,49
2324,SpokaneStBridge,04/07/2014 08:00:00 PM,48,-122,5,15,20
2325,SpokaneStBridge,04/07/2014 09:00:00 PM,48,-122,10,10,20
2326,SpokaneStBridge,04/07/2014 10:00:00 PM,48,-122,2,10,12
2327,SpokaneStBridge,04/07/2014 11:00:00 PM,48,-122,0,2,2
2328,SpokaneStBridge,04/08/2014 12:00:00 AM,48,-122,1,3,4
2329,SpokaneStBridge,04/08/2014 01:00:00 AM,48,-122,0,2,2
2330,SpokaneStBridge,04/08/2014 02:00:00 AM,48,-122,1,2,3
2331,SpokaneStBridge,04/08/2014 03:00:00 AM,48,-122,0,0,0
2332,SpokaneStBridge,04/08/2014 04:00:00 AM,48,-122,2,1,3
2333,SpokaneStBridge,04/08/2014 05:00:00 AM,48,-122,14,6,20
2334,SpokaneStBridge,04/08/2014 06:00:00 AM,48,-122,36,12,48
2335,SpokaneStBridge,04/08/2014 07:00:00 AM,48,-122,97,12,109
2336,SpokaneStBridge,04/08/2014 08:00:00 AM,48,-122,93,9,102
2337,SpokaneStBridge,04/08/2014 09:00:00 AM,48,-122,32,7,39
2338,SpokaneStBridge,04/08/2014 10:00:00 AM,48,-122,16,1,17
2339,SpokaneStBridge,04/08/2014 11:00:00 AM,48,-122,9,6,15
2340,SpokaneStBridge,04/08/2014 12:00:00 PM,48,-122,5,8,13
2341,SpokaneStBridge,04/08/2014 01:00:00 PM,48,-122,7,9,16
2342,SpokaneStBridge,04/08/2014 02:00:00 PM,48,-122,7,13,20
2343,SpokaneStBridge,04/08/2014 03:00:00 PM,48,-122,12,27,39
2344,SpokaneStBridge,04/08/2014 04:00:00 PM,48,-122,15,38,53
2345,SpokaneStBridge,04/08/2014 05:00:00 PM,48,-122,17,70,87
2346,SpokaneStBridge,04/08/2014 06:00:00 PM,48,-122,7,58,65
2347,SpokaneStBridge,04/08/2014 07:00:00 PM,48,-122,3,24,27
2348,SpokaneStBridge,04/08/2014 08:00:00 PM,48,-122,2,10,12
2349,SpokaneStBridge,04/08/2014 09:00:00 PM,48,-122,1,10,11
2350,SpokaneStBridge,04/08/2014 10:00:00 PM,48,-122,1,4,5
2351,SpokaneStBridge,04/08/2014 11:00:00 PM,48,-122,0,4,4
2352,SpokaneStBridge,04/09/2014 12:00:00 AM,48,-122,0,2,2
2353,SpokaneStBridge,04/09/2014 01:00:00 AM,48,-122,0,1,1
2354,SpokaneStBridge,04/09/2014 02:00:00 AM,48,-122,0,1,1
2355,SpokaneStBridge,04/09/2014 03:00:00 AM,48,-122,0,0,0
2356,SpokaneStBridge,04/09/2014 04:00:00 AM,48,-122,4,0,4
2357,SpokaneStBridge,04/09/2014 05:00:00 AM,48,-122,14,3,17
2358,SpokaneStBridge,04/09/2014 06:00:00 AM,48,-122,51,18,69
2359,SpokaneStBridge,04/09/2014 07:00:00 AM,48,-122,80,22,102
2360,SpokaneStBridge,04/09/2014 08:00:00 AM,48,-122,99,13,112
2361,SpokaneStBridge,04/09/2014 09:00:00 AM,48,-122,41,7,48
2362,SpokaneStBridge,04/09/2014 10:00:00 AM,48,-122,14,13,27
2363,SpokaneStBridge,04/09/2014 11:00:00 AM,48,-122,20,5,25
2364,SpokaneStBridge,04/09/2014 12:00:00 PM,48,-122,16,10,26
2365,SpokaneStBridge,04/09/2014 01:00:00 PM,48,-122,16,11,27
2366,SpokaneStBridge,04/09/2014 02:00:00 PM,48,-122,13,20,33
2367,SpokaneStBridge,04/09/2014 03:00:00 PM,48,-122,21,31,52
2368,SpokaneStBridge,04/09/2014 04:00:00 PM,48,-122,22,66,88
2369,SpokaneStBridge,04/09/2014 05:00:00 PM,48,-122,18,120,138
2370,SpokaneStBridge,04/09/2014 06:00:00 PM,48,-122,21,83,104
2371,SpokaneStBridge,04/09/2014 07:00:00 PM,48,-122,5,31,36
2372,SpokaneStBridge,04/09/2014 08:00:00 PM,48,-122,5,20,25
2373,SpokaneStBridge,04/09/2014 09:00:00 PM,48,-122,3,10,13
2374,SpokaneStBridge,04/09/2014 10:00:00 PM,48,-122,1,7,8
2375,SpokaneStBridge,04/09/2014 11:00:00 PM,48,-122,1,3,4
2376,SpokaneStBridge,04/10/2014 12:00:00 AM,48,-122,2,4,6
2377,SpokaneStBridge,04/10/2014 01:00:00 AM,48,-122,0,0,0
2378,SpokaneStBridge,04/10/2014 02:00:00 AM,48,-122,1,1,2
2379,SpokaneStBridge,04/10/2014 03:00:00 AM,48,-122,2,0,2
2380,SpokaneStBridge,04/10/2014 04:00:00 AM,48,-122,3,0,3
2381,SpokaneStBridge,04/10/2014 05:00:00 AM,48,-122,17,4,21
2382,SpokaneStBridge,04/10/2014 06:00:00 AM,48,-122,54,13,67
2383,SpokaneStBridge,04/10/2014 07:00:00 AM,48,-122,116,21,137
2384,SpokaneStBridge,04/10/2014 08:00:00 AM,48,-122,100,7,107
2385,SpokaneStBridge,04/10/2014 09:00:00 AM,48,-122,47,6,53
2386,SpokaneStBridge,04/10/2014 10:00:00 AM,48,-122,19,6,25
2387,SpokaneStBridge,04/10/2014 11:00:00 AM,48,-122,11,7,18
2388,SpokaneStBridge,04/10/2014 12:00:00 PM,48,-122,12,19,31
2389,SpokaneStBridge,04/10/2014 01:00:00 PM,48,-122,29,21,50
2390,SpokaneStBridge,04/10/2014 02:00:00 PM,48,-122,10,21,31
2391,SpokaneStBridge,04/10/2014 03:00:00 PM,48,-122,17,28,45
2392,SpokaneStBridge,04/10/2014 04:00:00 PM,48,-122,28,64,92
2393,SpokaneStBridge,04/10/2014 05:00:00 PM,48,-122,25,138,163
2394,SpokaneStBridge,04/10/2014 06:00:00 PM,48,-122,20,87,107
2395,SpokaneStBridge,04/10/2014 07:00:00 PM,48,-122,11,45,56
2396,SpokaneStBridge,04/10/2014 08:00:00 PM,48,-122,16,9,25
2397,SpokaneStBridge,04/10/2014 09:00:00 PM,48,-122,4,5,9
2398,SpokaneStBridge,04/10/2014 10:00:00 PM,48,-122,3,2,5
2399,SpokaneStBridge,04/10/2014 11:00:00 PM,48,-122,2,11,13
2400,SpokaneStBridge,04/11/2014 12:00:00 AM,48,-122,1,0,1
2401,SpokaneStBridge,04/11/2014 01:00:00 AM,48,-122,0,1,1
2402,SpokaneStBridge,04/11/2014 02:00:00 AM,48,-122,2,1,3
2403,SpokaneStBridge,04/11/2014 03:00:00 AM,48,-122,2,2,4
2404,SpokaneStBridge,04/11/2014 04:00:00 AM,48,-122,5,1,6
2405,SpokaneStBridge,04/11/2014 05:00:00 AM,48,-122,24,4,28
2406,SpokaneStBridge,04/11/2014 06:00:00 AM,48,-122,51,12,63
2407,SpokaneStBridge,04/11/2014 07:00:00 AM,48,-122,76,14,90
2408,SpokaneStBridge,04/11/2014 08:00:00 AM,48,-122,103,12,115
2409,SpokaneStBridge,04/11/2014 09:00:00 AM,48,-122,33,10,43
2410,SpokaneStBridge,04/11/2014 10:00:00 AM,48,-122,18,5,23
2411,SpokaneStBridge,04/11/2014 11:00:00 AM,48,-122,7,12,19
2412,SpokaneStBridge,04/11/2014 12:00:00 PM,48,-122,13,12,25
2413,SpokaneStBridge,04/11/2014 01:00:00 PM,48,-122,11,19,30
2414,SpokaneStBridge,04/11/2014 02:00:00 PM,48,-122,21,16,37
2415,SpokaneStBridge,04/11/2014 03:00:00 PM,48,-122,12,34,46
2416,SpokaneStBridge,04/11/2014 04:00:00 PM,48,-122,32,68,100
2417,SpokaneStBridge,04/11/2014 05:00:00 PM,48,-122,35,106,141
2418,SpokaneStBridge,04/11/2014 06:00:00 PM,48,-122,21,73,94
2419,SpokaneStBridge,04/11/2014 07:00:00 PM,48,-122,5,35,40
2420,SpokaneStBridge,04/11/2014 08:00:00 PM,48,-122,5,10,15
2421,SpokaneStBridge,04/11/2014 09:00:00 PM,48,-122,1,0,1
2422,SpokaneStBridge,04/11/2014 10:00:00 PM,48,-122,1,6,7
2423,SpokaneStBridge,04/11/2014 11:00:00 PM,48,-122,3,3,6
2424,SpokaneStBridge,04/12/2014 12:00:00 AM,48,-122,0,1,1
2425,SpokaneStBridge,04/12/2014 01:00:00 AM,48,-122,0,3,3
2426,SpokaneStBridge,04/12/2014 02:00:00 AM,48,-122,0,4,4
2427,SpokaneStBridge,04/12/2014 03:00:00 AM,48,-122,0,0,0
2428,SpokaneStBridge,04/12/2014 04:00:00 AM,48,-122,0,0,0
2429,SpokaneStBridge,04/12/2014 05:00:00 AM,48,-122,1,0,1
2430,SpokaneStBridge,04/12/2014 06:00:00 AM,48,-122,3,5,8
2431,SpokaneStBridge,04/12/2014 07:00:00 AM,48,-122,7,2,9
2432,SpokaneStBridge,04/12/2014 08:00:00 AM,48,-122,16,6,22
2433,SpokaneStBridge,04/12/2014 09:00:00 AM,48,-122,29,19,48
2434,SpokaneStBridge,04/12/2014 10:00:00 AM,48,-122,12,10,22
2435,SpokaneStBridge,04/12/2014 11:00:00 AM,48,-122,31,26,57
2436,SpokaneStBridge,04/12/2014 12:00:00 PM,48,-122,26,32,58
2437,SpokaneStBridge,04/12/2014 01:00:00 PM,48,-122,28,42,70
2438,SpokaneStBridge,04/12/2014 02:00:00 PM,48,-122,28,29,57
2439,SpokaneStBridge,04/12/2014 03:00:00 PM,48,-122,32,29,61
2440,SpokaneStBridge,04/12/2014 04:00:00 PM,48,-122,27,31,58
2441,SpokaneStBridge,04/12/2014 05:00:00 PM,48,-122,25,29,54
2442,SpokaneStBridge,04/12/2014 06:00:00 PM,48,-122,19,22,41
2443,SpokaneStBridge,04/12/2014 07:00:00 PM,48,-122,13,11,24
2444,SpokaneStBridge,04/12/2014 08:00:00 PM,48,-122,4,6,10
2445,SpokaneStBridge,04/12/2014 09:00:00 PM,48,-122,6,4,10
2446,SpokaneStBridge,04/12/2014 10:00:00 PM,48,-122,1,5,6
2447,SpokaneStBridge,04/12/2014 11:00:00 PM,48,-122,4,3,7
2448,SpokaneStBridge,04/13/2014 12:00:00 AM,48,-122,3,1,4
2449,SpokaneStBridge,04/13/2014 01:00:00 AM,48,-122,0,1,1
2450,SpokaneStBridge,04/13/2014 02:00:00 AM,48,-122,5,2,7
2451,SpokaneStBridge,04/13/2014 03:00:00 AM,48,-122,0,1,1
2452,SpokaneStBridge,04/13/2014 04:00:00 AM,48,-122,0,0,0
2453,SpokaneStBridge,04/13/2014 05:00:00 AM,48,-122,0,0,0
2454,SpokaneStBridge,04/13/2014 06:00:00 AM,48,-122,5,3,8
2455,SpokaneStBridge,04/13/2014 07:00:00 AM,48,-122,8,2,10
2456,SpokaneStBridge,04/13/2014 08:00:00 AM,48,-122,10,5,15
2457,SpokaneStBridge,04/13/2014 09:00:00 AM,48,-122,37,24,61
2458,SpokaneStBridge,04/13/2014 10:00:00 AM,48,-122,46,23,69
2459,SpokaneStBridge,04/13/2014 11:00:00 AM,48,-122,35,59,94
2460,SpokaneStBridge,04/13/2014 12:00:00 PM,48,-122,48,62,110
2461,SpokaneStBridge,04/13/2014 01:00:00 PM,48,-122,40,50,90
2462,SpokaneStBridge,04/13/2014 02:00:00 PM,48,-122,49,58,107
2463,SpokaneStBridge,04/13/2014 03:00:00 PM,48,-122,54,49,103
2464,SpokaneStBridge,04/13/2014 04:00:00 PM,48,-122,34,38,72
2465,SpokaneStBridge,04/13/2014 05:00:00 PM,48,-122,28,25,53
2466,SpokaneStBridge,04/13/2014 06:00:00 PM,48,-122,24,18,42
2467,SpokaneStBridge,04/13/2014 07:00:00 PM,48,-122,10,17,27
2468,SpokaneStBridge,04/13/2014 08:00:00 PM,48,-122,4,5,9
2469,SpokaneStBridge,04/13/2014 09:00:00 PM,48,-122,4,4,8
2470,SpokaneStBridge,04/13/2014 10:00:00 PM,48,-122,2,1,3
2471,SpokaneStBridge,04/13/2014 11:00:00 PM,48,-122,2,2,4
2472,SpokaneStBridge,04/14/2014 12:00:00 AM,48,-122,0,2,2
2473,SpokaneStBridge,04/14/2014 01:00:00 AM,48,-122,1,0,1
2474,SpokaneStBridge,04/14/2014 02:00:00 AM,48,-122,0,1,1
2475,SpokaneStBridge,04/14/2014 03:00:00 AM,48,-122,0,2,2
2476,SpokaneStBridge,04/14/2014 04:00:00 AM,48,-122,4,0,4
2477,SpokaneStBridge,04/14/2014 05:00:00 AM,48,-122,15,4,19
2478,SpokaneStBridge,04/14/2014 06:00:00 AM,48,-122,57,18,75
2479,SpokaneStBridge,04/14/2014 07:00:00 AM,48,-122,104,17,121
2480,SpokaneStBridge,04/14/2014 08:00:00 AM,48,-122,99,9,108
2481,SpokaneStBridge,04/14/2014 09:00:00 AM,48,-122,52,7,59
2482,SpokaneStBridge,04/14/2014 10:00:00 AM,48,-122,21,12,33
2483,SpokaneStBridge,04/14/2014 11:00:00 AM,48,-122,16,13,29
2484,SpokaneStBridge,04/14/2014 12:00:00 PM,48,-122,14,17,31
2485,SpokaneStBridge,04/14/2014 01:00:00 PM,48,-122,20,13,33
2486,SpokaneStBridge,04/14/2014 02:00:00 PM,48,-122,19,29,48
2487,SpokaneStBridge,04/14/2014 03:00:00 PM,48,-122,18,39,57
2488,SpokaneStBridge,04/14/2014 04:00:00 PM,48,-122,21,61,82
2489,SpokaneStBridge,04/14/2014 05:00:00 PM,48,-122,29,133,162
2490,SpokaneStBridge,04/14/2014 06:00:00 PM,48,-122,13,88,101
2491,SpokaneStBridge,04/14/2014 07:00:00 PM,48,-122,19,37,56
2492,SpokaneStBridge,04/14/2014 08:00:00 PM,48,-122,9,14,23
2493,SpokaneStBridge,04/14/2014 09:00:00 PM,48,-122,4,6,10
2494,SpokaneStBridge,04/14/2014 10:00:00 PM,48,-122,1,3,4
2495,SpokaneStBridge,04/14/2014 11:00:00 PM,48,-122,2,0,2
2496,SpokaneStBridge,04/15/2014 12:00:00 AM,48,-122,0,0,0
2497,SpokaneStBridge,04/15/2014 01:00:00 AM,48,-122,1,0,1
2498,SpokaneStBridge,04/15/2014 02:00:00 AM,48,-122,0,0,0
2499,SpokaneStBridge,04/15/2014 03:00:00 AM,48,-122,3,2,5
2500,SpokaneStBridge,04/15/2014 04:00:00 AM,48,-122,3,1,4
2501,SpokaneStBridge,04/15/2014 05:00:00 AM,48,-122,16,5,21
2502,SpokaneStBridge,04/15/2014 06:00:00 AM,48,-122,49,8,57
2503,SpokaneStBridge,04/15/2014 07:00:00 AM,48,-122,71,26,97
2504,SpokaneStBridge,04/15/2014 08:00:00 AM,48,-122,92,13,105
2505,SpokaneStBridge,04/15/2014 09:00:00 AM,48,-122,35,3,38
2506,SpokaneStBridge,04/15/2014 10:00:00 AM,48,-122,14,2,16
2507,SpokaneStBridge,04/15/2014 11:00:00 AM,48,-122,16,10,26
2508,SpokaneStBridge,04/15/2014 12:00:00 PM,48,-122,8,7,15
2509,SpokaneStBridge,04/15/2014 01:00:00 PM,48,-122,10,6,16
2510,SpokaneStBridge,04/15/2014 02:00:00 PM,48,-122,8,16,24
2511,SpokaneStBridge,04/15/2014 03:00:00 PM,48,-122,15,34,49
2512,SpokaneStBridge,04/15/2014 04:00:00 PM,48,-122,22,51,73
2513,SpokaneStBridge,04/15/2014 05:00:00 PM,48,-122,15,100,115
2514,SpokaneStBridge,04/15/2014 06:00:00 PM,48,-122,16,63,79
2515,SpokaneStBridge,04/15/2014 07:00:00 PM,48,-122,5,24,29
2516,SpokaneStBridge,04/15/2014 08:00:00 PM,48,-122,7,9,16
2517,SpokaneStBridge,04/15/2014 09:00:00 PM,48,-122,4,7,11
2518,SpokaneStBridge,04/15/2014 10:00:00 PM,48,-122,3,7,10
2519,SpokaneStBridge,04/15/2014 11:00:00 PM,48,-122,0,4,4
2520,SpokaneStBridge,04/16/2014 12:00:00 AM,48,-122,0,2,2
2521,SpokaneStBridge,04/16/2014 01:00:00 AM,48,-122,0,2,2
2522,SpokaneStBridge,04/16/2014 02:00:00 AM,48,-122,2,0,2
2523,SpokaneStBridge,04/16/2014 03:00:00 AM,48,-122,0,0,0
2524,SpokaneStBridge,04/16/2014 04:00:00 AM,48,-122,3,0,3
2525,SpokaneStBridge,04/16/2014 05:00:00 AM,48,-122,8,7,15
2526,SpokaneStBridge,04/16/2014 06:00:00 AM,48,-122,23,8,31
2527,SpokaneStBridge,04/16/2014 07:00:00 AM,48,-122,56,8,64
2528,SpokaneStBridge,04/16/2014 08:00:00 AM,48,-122,68,4,72
2529,SpokaneStBridge,04/16/2014 09:00:00 AM,48,-122,19,5,24
2530,SpokaneStBridge,04/16/2014 10:00:00 AM,48,-122,11,1,12
2531,SpokaneStBridge,04/16/2014 11:00:00 AM,48,-122,10,0,10
2532,SpokaneStBridge,04/16/2014 12:00:00 PM,48,-122,4,2,6
2533,SpokaneStBridge,04/16/2014 01:00:00 PM,48,-122,2,7,9
2534,SpokaneStBridge,04/16/2014 02:00:00 PM,48,-122,3,9,12
2535,SpokaneStBridge,04/16/2014 03:00:00 PM,48,-122,8,20,28
2536,SpokaneStBridge,04/16/2014 04:00:00 PM,48,-122,11,30,41
2537,SpokaneStBridge,04/16/2014 05:00:00 PM,48,-122,11,51,62
2538,SpokaneStBridge,04/16/2014 06:00:00 PM,48,-122,5,39,44
2539,SpokaneStBridge,04/16/2014 07:00:00 PM,48,-122,1,19,20
2540,SpokaneStBridge,04/16/2014 08:00:00 PM,48,-122,2,7,9
2541,SpokaneStBridge,04/16/2014 09:00:00 PM,48,-122,3,3,6
2542,SpokaneStBridge,04/16/2014 10:00:00 PM,48,-122,2,3,5
2543,SpokaneStBridge,04/16/2014 11:00:00 PM,48,-122,1,4,5
2544,SpokaneStBridge,04/17/2014 12:00:00 AM,48,-122,0,1,1
2545,SpokaneStBridge,04/17/2014 01:00:00 AM,48,-122,0,0,0
2546,SpokaneStBridge,04/17/2014 02:00:00 AM,48,-122,2,1,3
2547,SpokaneStBridge,04/17/2014 03:00:00 AM,48,-122,0,0,0
2548,SpokaneStBridge,04/17/2014 04:00:00 AM,48,-122,3,0,3
2549,SpokaneStBridge,04/17/2014 05:00:00 AM,48,-122,10,4,14
2550,SpokaneStBridge,04/17/2014 06:00:00 AM,48,-122,32,9,41
2551,SpokaneStBridge,04/17/2014 07:00:00 AM,48,-122,61,8,69
2552,SpokaneStBridge,04/17/2014 08:00:00 AM,48,-122,55,7,62
2553,SpokaneStBridge,04/17/2014 09:00:00 AM,48,-122,21,4,25
2554,SpokaneStBridge,04/17/2014 10:00:00 AM,48,-122,6,1,7
2555,SpokaneStBridge,04/17/2014 11:00:00 AM,48,-122,4,4,8
2556,SpokaneStBridge,04/17/2014 12:00:00 PM,48,-122,2,5,7
2557,SpokaneStBridge,04/17/2014 01:00:00 PM,48,-122,3,6,9
2558,SpokaneStBridge,04/17/2014 02:00:00 PM,48,-122,2,7,9
2559,SpokaneStBridge,04/17/2014 03:00:00 PM,48,-122,5,15,20
2560,SpokaneStBridge,04/17/2014 04:00:00 PM,48,-122,10,26,36
2561,SpokaneStBridge,04/17/2014 05:00:00 PM,48,-122,12,63,75
2562,SpokaneStBridge,04/17/2014 06:00:00 PM,48,-122,9,39,48
2563,SpokaneStBridge,04/17/2014 07:00:00 PM,48,-122,2,11,13
2564,SpokaneStBridge,04/17/2014 08:00:00 PM,48,-122,3,2,5
2565,SpokaneStBridge,04/17/2014 09:00:00 PM,48,-122,3,2,5
2566,SpokaneStBridge,04/17/2014 10:00:00 PM,48,-122,2,2,4
2567,SpokaneStBridge,04/17/2014 11:00:00 PM,48,-122,1,1,2
2568,SpokaneStBridge,04/18/2014 12:00:00 AM,48,-122,0,0,0
2569,SpokaneStBridge,04/18/2014 01:00:00 AM,48,-122,0,0,0
2570,SpokaneStBridge,04/18/2014 02:00:00 AM,48,-122,0,1,1
2571,SpokaneStBridge,04/18/2014 03:00:00 AM,48,-122,0,1,1
2572,SpokaneStBridge,04/18/2014 04:00:00 AM,48,-122,3,1,4
2573,SpokaneStBridge,04/18/2014 05:00:00 AM,48,-122,16,1,17
2574,SpokaneStBridge,04/18/2014 06:00:00 AM,48,-122,35,12,47
2575,SpokaneStBridge,04/18/2014 07:00:00 AM,48,-122,71,8,79
2576,SpokaneStBridge,04/18/2014 08:00:00 AM,48,-122,70,6,76
2577,SpokaneStBridge,04/18/2014 09:00:00 AM,48,-122,37,11,48
2578,SpokaneStBridge,04/18/2014 10:00:00 AM,48,-122,23,6,29
2579,SpokaneStBridge,04/18/2014 11:00:00 AM,48,-122,20,16,36
2580,SpokaneStBridge,04/18/2014 12:00:00 PM,48,-122,6,23,29
2581,SpokaneStBridge,04/18/2014 01:00:00 PM,48,-122,12,11,23
2582,SpokaneStBridge,04/18/2014 02:00:00 PM,48,-122,20,14,34
2583,SpokaneStBridge,04/18/2014 03:00:00 PM,48,-122,20,28,48
2584,SpokaneStBridge,04/18/2014 04:00:00 PM,48,-122,25,54,79
2585,SpokaneStBridge,04/18/2014 05:00:00 PM,48,-122,25,86,111
2586,SpokaneStBridge,04/18/2014 06:00:00 PM,48,-122,18,55,73
2587,SpokaneStBridge,04/18/2014 07:00:00 PM,48,-122,9,34,43
2588,SpokaneStBridge,04/18/2014 08:00:00 PM,48,-122,6,10,16
2589,SpokaneStBridge,04/18/2014 09:00:00 PM,48,-122,3,3,6
2590,SpokaneStBridge,04/18/2014 10:00:00 PM,48,-122,2,4,6
2591,SpokaneStBridge,04/18/2014 11:00:00 PM,48,-122,1,0,1
2592,SpokaneStBridge,04/19/2014 12:00:00 AM,48,-122,1,5,6
2593,SpokaneStBridge,04/19/2014 01:00:00 AM,48,-122,0,0,0
2594,SpokaneStBridge,04/19/2014 02:00:00 AM,48,-122,0,1,1
2595,SpokaneStBridge,04/19/2014 03:00:00 AM,48,-122,3,1,4
2596,SpokaneStBridge,04/19/2014 04:00:00 AM,48,-122,0,0,0
2597,SpokaneStBridge,04/19/2014 05:00:00 AM,48,-122,4,0,4
2598,SpokaneStBridge,04/19/2014 06:00:00 AM,48,-122,4,3,7
2599,SpokaneStBridge,04/19/2014 07:00:00 AM,48,-122,15,5,20
2600,SpokaneStBridge,04/19/2014 08:00:00 AM,48,-122,16,13,29
2601,SpokaneStBridge,04/19/2014 09:00:00 AM,48,-122,15,15,30
2602,SpokaneStBridge,04/19/2014 10:00:00 AM,48,-122,20,51,71
2603,SpokaneStBridge,04/19/2014 11:00:00 AM,48,-122,13,11,24
2604,SpokaneStBridge,04/19/2014 12:00:00 PM,48,-122,4,8,12
2605,SpokaneStBridge,04/19/2014 01:00:00 PM,48,-122,4,2,6
2606,SpokaneStBridge,04/19/2014 02:00:00 PM,48,-122,2,5,7
2607,SpokaneStBridge,04/19/2014 03:00:00 PM,48,-122,1,2,3
2608,SpokaneStBridge,04/19/2014 04:00:00 PM,48,-122,3,0,3
2609,SpokaneStBridge,04/19/2014 05:00:00 PM,48,-122,3,6,9
2610,SpokaneStBridge,04/19/2014 06:00:00 PM,48,-122,1,5,6
2611,SpokaneStBridge,04/19/2014 07:00:00 PM,48,-122,1,5,6
2612,SpokaneStBridge,04/19/2014 08:00:00 PM,48,-122,0,3,3
2613,SpokaneStBridge,04/19/2014 09:00:00 PM,48,-122,1,0,1
2614,SpokaneStBridge,04/19/2014 10:00:00 PM,48,-122,1,2,3
2615,SpokaneStBridge,04/19/2014 11:00:00 PM,48,-122,0,3,3
2616,SpokaneStBridge,04/20/2014 12:00:00 AM,48,-122,2,0,2
2617,SpokaneStBridge,04/20/2014 01:00:00 AM,48,-122,0,0,0
2618,SpokaneStBridge,04/20/2014 02:00:00 AM,48,-122,0,0,0
2619,SpokaneStBridge,04/20/2014 03:00:00 AM,48,-122,0,0,0
2620,SpokaneStBridge,04/20/2014 04:00:00 AM,48,-122,1,0,1
2621,SpokaneStBridge,04/20/2014 05:00:00 AM,48,-122,0,0,0
2622,SpokaneStBridge,04/20/2014 06:00:00 AM,48,-122,2,2,4
2623,SpokaneStBridge,04/20/2014 07:00:00 AM,48,-122,2,3,5
2624,SpokaneStBridge,04/20/2014 08:00:00 AM,48,-122,8,8,16
2625,SpokaneStBridge,04/20/2014 09:00:00 AM,48,-122,22,24,46
2626,SpokaneStBridge,04/20/2014 10:00:00 AM,48,-122,17,14,31
2627,SpokaneStBridge,04/20/2014 11:00:00 AM,48,-122,35,33,68
2628,SpokaneStBridge,04/20/2014 12:00:00 PM,48,-122,33,26,59
2629,SpokaneStBridge,04/20/2014 01:00:00 PM,48,-122,30,35,65
2630,SpokaneStBridge,04/20/2014 02:00:00 PM,48,-122,14,28,42
2631,SpokaneStBridge,04/20/2014 03:00:00 PM,48,-122,34,30,64
2632,SpokaneStBridge,04/20/2014 04:00:00 PM,48,-122,13,29,42
2633,SpokaneStBridge,04/20/2014 05:00:00 PM,48,-122,26,20,46
2634,SpokaneStBridge,04/20/2014 06:00:00 PM,48,-122,13,7,20
2635,SpokaneStBridge,04/20/2014 07:00:00 PM,48,-122,6,7,13
2636,SpokaneStBridge,04/20/2014 08:00:00 PM,48,-122,3,0,3
2637,SpokaneStBridge,04/20/2014 09:00:00 PM,48,-122,4,2,6
2638,SpokaneStBridge,04/20/2014 10:00:00 PM,48,-122,3,3,6
2639,SpokaneStBridge,04/20/2014 11:00:00 PM,48,-122,1,2,3
2640,SpokaneStBridge,04/21/2014 12:00:00 AM,48,-122,0,0,0
2641,SpokaneStBridge,04/21/2014 01:00:00 AM,48,-122,0,1,1
2642,SpokaneStBridge,04/21/2014 02:00:00 AM,48,-122,1,0,1
2643,SpokaneStBridge,04/21/2014 03:00:00 AM,48,-122,0,0,0
2644,SpokaneStBridge,04/21/2014 04:00:00 AM,48,-122,1,0,1
2645,SpokaneStBridge,04/21/2014 05:00:00 AM,48,-122,21,4,25
2646,SpokaneStBridge,04/21/2014 06:00:00 AM,48,-122,58,12,70
2647,SpokaneStBridge,04/21/2014 07:00:00 AM,48,-122,107,26,133
2648,SpokaneStBridge,04/21/2014 08:00:00 AM,48,-122,82,13,95
2649,SpokaneStBridge,04/21/2014 09:00:00 AM,48,-122,42,12,54
2650,SpokaneStBridge,04/21/2014 10:00:00 AM,48,-122,14,10,24
2651,SpokaneStBridge,04/21/2014 11:00:00 AM,48,-122,11,4,15
2652,SpokaneStBridge,04/21/2014 12:00:00 PM,48,-122,6,6,12
2653,SpokaneStBridge,04/21/2014 01:00:00 PM,48,-122,13,10,23
2654,SpokaneStBridge,04/21/2014 02:00:00 PM,48,-122,10,15,25
2655,SpokaneStBridge,04/21/2014 03:00:00 PM,48,-122,19,32,51
2656,SpokaneStBridge,04/21/2014 04:00:00 PM,48,-122,28,57,85
2657,SpokaneStBridge,04/21/2014 05:00:00 PM,48,-122,23,123,146
2658,SpokaneStBridge,04/21/2014 06:00:00 PM,48,-122,8,76,84
2659,SpokaneStBridge,04/21/2014 07:00:00 PM,48,-122,6,23,29
2660,SpokaneStBridge,04/21/2014 08:00:00 PM,48,-122,2,12,14
2661,SpokaneStBridge,04/21/2014 09:00:00 PM,48,-122,0,12,12
2662,SpokaneStBridge,04/21/2014 10:00:00 PM,48,-122,2,4,6
2663,SpokaneStBridge,04/21/2014 11:00:00 PM,48,-122,0,1,1
2664,SpokaneStBridge,04/22/2014 12:00:00 AM,48,-122,0,0,0
2665,SpokaneStBridge,04/22/2014 01:00:00 AM,48,-122,0,1,1
2666,SpokaneStBridge,04/22/2014 02:00:00 AM,48,-122,0,0,0
2667,SpokaneStBridge,04/22/2014 03:00:00 AM,48,-122,1,0,1
2668,SpokaneStBridge,04/22/2014 04:00:00 AM,48,-122,1,0,1
2669,SpokaneStBridge,04/22/2014 05:00:00 AM,48,-122,9,4,13
2670,SpokaneStBridge,04/22/2014 06:00:00 AM,48,-122,40,5,45
2671,SpokaneStBridge,04/22/2014 07:00:00 AM,48,-122,73,14,87
2672,SpokaneStBridge,04/22/2014 08:00:00 AM,48,-122,54,4,58
2673,SpokaneStBridge,04/22/2014 09:00:00 AM,48,-122,33,5,38
2674,SpokaneStBridge,04/22/2014 10:00:00 AM,48,-122,14,2,16
2675,SpokaneStBridge,04/22/2014 11:00:00 AM,48,-122,8,9,17
2676,SpokaneStBridge,04/22/2014 12:00:00 PM,48,-122,13,6,19
2677,SpokaneStBridge,04/22/2014 01:00:00 PM,48,-122,7,6,13
2678,SpokaneStBridge,04/22/2014 02:00:00 PM,48,-122,4,13,17
2679,SpokaneStBridge,04/22/2014 03:00:00 PM,48,-122,13,23,36
2680,SpokaneStBridge,04/22/2014 04:00:00 PM,48,-122,15,45,60
2681,SpokaneStBridge,04/22/2014 05:00:00 PM,48,-122,21,74,95
2682,SpokaneStBridge,04/22/2014 06:00:00 PM,48,-122,12,52,64
2683,SpokaneStBridge,04/22/2014 07:00:00 PM,48,-122,9,21,30
2684,SpokaneStBridge,04/22/2014 08:00:00 PM,48,-122,3,5,8
2685,SpokaneStBridge,04/22/2014 09:00:00 PM,48,-122,3,1,4
2686,SpokaneStBridge,04/22/2014 10:00:00 PM,48,-122,0,2,2
2687,SpokaneStBridge,04/22/2014 11:00:00 PM,48,-122,0,3,3
2688,SpokaneStBridge,04/23/2014 12:00:00 AM,48,-122,0,2,2
2689,SpokaneStBridge,04/23/2014 01:00:00 AM,48,-122,2,0,2
2690,SpokaneStBridge,04/23/2014 02:00:00 AM,48,-122,0,2,2
2691,SpokaneStBridge,04/23/2014 03:00:00 AM,48,-122,0,1,1
2692,SpokaneStBridge,04/23/2014 04:00:00 AM,48,-122,1,1,2
2693,SpokaneStBridge,04/23/2014 05:00:00 AM,48,-122,13,2,15
2694,SpokaneStBridge,04/23/2014 06:00:00 AM,48,-122,51,9,60
2695,SpokaneStBridge,04/23/2014 07:00:00 AM,48,-122,79,18,97
2696,SpokaneStBridge,04/23/2014 08:00:00 AM,48,-122,89,10,99
2697,SpokaneStBridge,04/23/2014 09:00:00 AM,48,-122,27,8,35
2698,SpokaneStBridge,04/23/2014 10:00:00 AM,48,-122,13,3,16
2699,SpokaneStBridge,04/23/2014 11:00:00 AM,48,-122,11,3,14
2700,SpokaneStBridge,04/23/2014 12:00:00 PM,48,-122,10,6,16
2701,SpokaneStBridge,04/23/2014 01:00:00 PM,48,-122,8,10,18
2702,SpokaneStBridge,04/23/2014 02:00:00 PM,48,-122,8,16,24
2703,SpokaneStBridge,04/23/2014 03:00:00 PM,48,-122,11,19,30
2704,SpokaneStBridge,04/23/2014 04:00:00 PM,48,-122,20,57,77
2705,SpokaneStBridge,04/23/2014 05:00:00 PM,48,-122,21,96,117
2706,SpokaneStBridge,04/23/2014 06:00:00 PM,48,-122,10,48,58
2707,SpokaneStBridge,04/23/2014 07:00:00 PM,48,-122,2,24,26
2708,SpokaneStBridge,04/23/2014 08:00:00 PM,48,-122,3,13,16
2709,SpokaneStBridge,04/23/2014 09:00:00 PM,48,-122,1,10,11
2710,SpokaneStBridge,04/23/2014 10:00:00 PM,48,-122,0,5,5
2711,SpokaneStBridge,04/23/2014 11:00:00 PM,48,-122,1,1,2
2712,SpokaneStBridge,04/24/2014 12:00:00 AM,48,-122,0,2,2
2713,SpokaneStBridge,04/24/2014 01:00:00 AM,48,-122,0,0,0
2714,SpokaneStBridge,04/24/2014 02:00:00 AM,48,-122,0,0,0
2715,SpokaneStBridge,04/24/2014 03:00:00 AM,48,-122,0,1,1
2716,SpokaneStBridge,04/24/2014 04:00:00 AM,48,-122,1,0,1
2717,SpokaneStBridge,04/24/2014 05:00:00 AM,48,-122,9,2,11
2718,SpokaneStBridge,04/24/2014 06:00:00 AM,48,-122,44,9,53
2719,SpokaneStBridge,04/24/2014 07:00:00 AM,48,-122,62,17,79
2720,SpokaneStBridge,04/24/2014 08:00:00 AM,48,-122,79,13,92
2721,SpokaneStBridge,04/24/2014 09:00:00 AM,48,-122,20,4,24
2722,SpokaneStBridge,04/24/2014 10:00:00 AM,48,-122,13,1,14
2723,SpokaneStBridge,04/24/2014 11:00:00 AM,48,-122,9,5,14
2724,SpokaneStBridge,04/24/2014 12:00:00 PM,48,-122,3,12,15
2725,SpokaneStBridge,04/24/2014 01:00:00 PM,48,-122,8,2,10
2726,SpokaneStBridge,04/24/2014 02:00:00 PM,48,-122,7,10,17
2727,SpokaneStBridge,04/24/2014 03:00:00 PM,48,-122,8,19,27
2728,SpokaneStBridge,04/24/2014 04:00:00 PM,48,-122,19,44,63
2729,SpokaneStBridge,04/24/2014 05:00:00 PM,48,-122,18,77,95
2730,SpokaneStBridge,04/24/2014 06:00:00 PM,48,-122,19,64,83
2731,SpokaneStBridge,04/24/2014 07:00:00 PM,48,-122,6,16,22
2732,SpokaneStBridge,04/24/2014 08:00:00 PM,48,-122,4,12,16
2733,SpokaneStBridge,04/24/2014 09:00:00 PM,48,-122,1,4,5
2734,SpokaneStBridge,04/24/2014 10:00:00 PM,48,-122,4,3,7
2735,SpokaneStBridge,04/24/2014 11:00:00 PM,48,-122,3,4,7
2736,SpokaneStBridge,04/25/2014 12:00:00 AM,48,-122,1,2,3
2737,SpokaneStBridge,04/25/2014 01:00:00 AM,48,-122,1,2,3
2738,SpokaneStBridge,04/25/2014 02:00:00 AM,48,-122,0,0,0
2739,SpokaneStBridge,04/25/2014 03:00:00 AM,48,-122,0,0,0
2740,SpokaneStBridge,04/25/2014 04:00:00 AM,48,-122,3,2,5
2741,SpokaneStBridge,04/25/2014 05:00:00 AM,48,-122,19,3,22
2742,SpokaneStBridge,04/25/2014 06:00:00 AM,48,-122,51,9,60
2743,SpokaneStBridge,04/25/2014 07:00:00 AM,48,-122,90,18,108
2744,SpokaneStBridge,04/25/2014 08:00:00 AM,48,-122,94,10,104
2745,SpokaneStBridge,04/25/2014 09:00:00 AM,48,-122,33,8,41
2746,SpokaneStBridge,04/25/2014 10:00:00 AM,48,-122,21,4,25
2747,SpokaneStBridge,04/25/2014 11:00:00 AM,48,-122,14,27,41
2748,SpokaneStBridge,04/25/2014 12:00:00 PM,48,-122,15,10,25
2749,SpokaneStBridge,04/25/2014 01:00:00 PM,48,-122,25,12,37
2750,SpokaneStBridge,04/25/2014 02:00:00 PM,48,-122,20,28,48
2751,SpokaneStBridge,04/25/2014 03:00:00 PM,48,-122,20,36,56
2752,SpokaneStBridge,04/25/2014 04:00:00 PM,48,-122,14,71,85
2753,SpokaneStBridge,04/25/2014 05:00:00 PM,48,-122,26,109,135
2754,SpokaneStBridge,04/25/2014 06:00:00 PM,48,-122,12,69,81
2755,SpokaneStBridge,04/25/2014 07:00:00 PM,48,-122,14,29,43
2756,SpokaneStBridge,04/25/2014 08:00:00 PM,48,-122,7,13,20
2757,SpokaneStBridge,04/25/2014 09:00:00 PM,48,-122,2,4,6
2758,SpokaneStBridge,04/25/2014 10:00:00 PM,48,-122,2,6,8
2759,SpokaneStBridge,04/25/2014 11:00:00 PM,48,-122,1,5,6
2760,SpokaneStBridge,04/26/2014 12:00:00 AM,48,-122,0,1,1
2761,SpokaneStBridge,04/26/2014 01:00:00 AM,48,-122,0,0,0
2762,SpokaneStBridge,04/26/2014 02:00:00 AM,48,-122,1,1,2
2763,SpokaneStBridge,04/26/2014 03:00:00 AM,48,-122,0,2,2
2764,SpokaneStBridge,04/26/2014 04:00:00 AM,48,-122,0,0,0
2765,SpokaneStBridge,04/26/2014 05:00:00 AM,48,-122,6,0,6
2766,SpokaneStBridge,04/26/2014 06:00:00 AM,48,-122,3,3,6
2767,SpokaneStBridge,04/26/2014 07:00:00 AM,48,-122,19,2,21
2768,SpokaneStBridge,04/26/2014 08:00:00 AM,48,-122,27,9,36
2769,SpokaneStBridge,04/26/2014 09:00:00 AM,48,-122,20,15,35
2770,SpokaneStBridge,04/26/2014 10:00:00 AM,48,-122,30,30,60
2771,SpokaneStBridge,04/26/2014 11:00:00 AM,48,-122,37,30,67
2772,SpokaneStBridge,04/26/2014 12:00:00 PM,48,-122,41,38,79
2773,SpokaneStBridge,04/26/2014 01:00:00 PM,48,-122,26,41,67
2774,SpokaneStBridge,04/26/2014 02:00:00 PM,48,-122,37,35,72
2775,SpokaneStBridge,04/26/2014 03:00:00 PM,48,-122,18,25,43
2776,SpokaneStBridge,04/26/2014 04:00:00 PM,48,-122,16,31,47
2777,SpokaneStBridge,04/26/2014 05:00:00 PM,48,-122,28,14,42
2778,SpokaneStBridge,04/26/2014 06:00:00 PM,48,-122,11,9,20
2779,SpokaneStBridge,04/26/2014 07:00:00 PM,48,-122,4,8,12
2780,SpokaneStBridge,04/26/2014 08:00:00 PM,48,-122,2,9,11
2781,SpokaneStBridge,04/26/2014 09:00:00 PM,48,-122,1,4,5
2782,SpokaneStBridge,04/26/2014 10:00:00 PM,48,-122,1,4,5
2783,SpokaneStBridge,04/26/2014 11:00:00 PM,48,-122,3,1,4
2784,SpokaneStBridge,04/27/2014 12:00:00 AM,48,-122,0,1,1
2785,SpokaneStBridge,04/27/2014 01:00:00 AM,48,-122,0,0,0
2786,SpokaneStBridge,04/27/2014 02:00:00 AM,48,-122,1,1,2
2787,SpokaneStBridge,04/27/2014 03:00:00 AM,48,-122,1,1,2
2788,SpokaneStBridge,04/27/2014 04:00:00 AM,48,-122,0,1,1
2789,SpokaneStBridge,04/27/2014 05:00:00 AM,48,-122,0,0,0
2790,SpokaneStBridge,04/27/2014 06:00:00 AM,48,-122,5,1,6
2791,SpokaneStBridge,04/27/2014 07:00:00 AM,48,-122,5,2,7
2792,SpokaneStBridge,04/27/2014 08:00:00 AM,48,-122,11,2,13
2793,SpokaneStBridge,04/27/2014 09:00:00 AM,48,-122,13,14,27
2794,SpokaneStBridge,04/27/2014 10:00:00 AM,48,-122,17,8,25
2795,SpokaneStBridge,04/27/2014 11:00:00 AM,48,-122,11,19,30
2796,SpokaneStBridge,04/27/2014 12:00:00 PM,48,-122,11,7,18
2797,SpokaneStBridge,04/27/2014 01:00:00 PM,48,-122,11,23,34
2798,SpokaneStBridge,04/27/2014 02:00:00 PM,48,-122,17,8,25
2799,SpokaneStBridge,04/27/2014 03:00:00 PM,48,-122,12,7,19
2800,SpokaneStBridge,04/27/2014 04:00:00 PM,48,-122,8,11,19
2801,SpokaneStBridge,04/27/2014 05:00:00 PM,48,-122,7,16,23
2802,SpokaneStBridge,04/27/2014 06:00:00 PM,48,-122,6,5,11
2803,SpokaneStBridge,04/27/2014 07:00:00 PM,48,-122,6,7,13
2804,SpokaneStBridge,04/27/2014 08:00:00 PM,48,-122,3,0,3
2805,SpokaneStBridge,04/27/2014 09:00:00 PM,48,-122,3,1,4
2806,SpokaneStBridge,04/27/2014 10:00:00 PM,48,-122,2,1,3
2807,SpokaneStBridge,04/27/2014 11:00:00 PM,48,-122,0,4,4
2808,SpokaneStBridge,04/28/2014 12:00:00 AM,48,-122,0,0,0
2809,SpokaneStBridge,04/28/2014 01:00:00 AM,48,-122,2,0,2
2810,SpokaneStBridge,04/28/2014 02:00:00 AM,48,-122,1,1,2
2811,SpokaneStBridge,04/28/2014 03:00:00 AM,48,-122,0,3,3
2812,SpokaneStBridge,04/28/2014 04:00:00 AM,48,-122,2,1,3
2813,SpokaneStBridge,04/28/2014 05:00:00 AM,48,-122,23,2,25
2814,SpokaneStBridge,04/28/2014 06:00:00 AM,48,-122,58,13,71
2815,SpokaneStBridge,04/28/2014 07:00:00 AM,48,-122,115,19,134
2816,SpokaneStBridge,04/28/2014 08:00:00 AM,48,-122,119,11,130
2817,SpokaneStBridge,04/28/2014 09:00:00 AM,48,-122,53,10,63
2818,SpokaneStBridge,04/28/2014 10:00:00 AM,48,-122,16,6,22
2819,SpokaneStBridge,04/28/2014 11:00:00 AM,48,-122,12,3,15
2820,SpokaneStBridge,04/28/2014 12:00:00 PM,48,-122,14,12,26
2821,SpokaneStBridge,04/28/2014 01:00:00 PM,48,-122,12,10,22
2822,SpokaneStBridge,04/28/2014 02:00:00 PM,48,-122,11,29,40
2823,SpokaneStBridge,04/28/2014 03:00:00 PM,48,-122,19,44,63
2824,SpokaneStBridge,04/28/2014 04:00:00 PM,48,-122,28,71,99
2825,SpokaneStBridge,04/28/2014 05:00:00 PM,48,-122,38,153,191
2826,SpokaneStBridge,04/28/2014 06:00:00 PM,48,-122,22,104,126
2827,SpokaneStBridge,04/28/2014 07:00:00 PM,48,-122,13,37,50
2828,SpokaneStBridge,04/28/2014 08:00:00 PM,48,-122,3,15,18
2829,SpokaneStBridge,04/28/2014 09:00:00 PM,48,-122,3,13,16
2830,SpokaneStBridge,04/28/2014 10:00:00 PM,48,-122,5,4,9
2831,SpokaneStBridge,04/28/2014 11:00:00 PM,48,-122,1,1,2
2832,SpokaneStBridge,04/29/2014 12:00:00 AM,48,-122,2,3,5
2833,SpokaneStBridge,04/29/2014 01:00:00 AM,48,-122,1,0,1
2834,SpokaneStBridge,04/29/2014 02:00:00 AM,48,-122,1,1,2
2835,SpokaneStBridge,04/29/2014 03:00:00 AM,48,-122,0,0,0
2836,SpokaneStBridge,04/29/2014 04:00:00 AM,48,-122,1,1,2
2837,SpokaneStBridge,04/29/2014 05:00:00 AM,48,-122,24,5,29
2838,SpokaneStBridge,04/29/2014 06:00:00 AM,48,-122,83,9,92
2839,SpokaneStBridge,04/29/2014 07:00:00 AM,48,-122,145,30,175
2840,SpokaneStBridge,04/29/2014 08:00:00 AM,48,-122,115,18,133
2841,SpokaneStBridge,04/29/2014 09:00:00 AM,48,-122,60,12,72
2842,SpokaneStBridge,04/29/2014 10:00:00 AM,48,-122,24,7,31
2843,SpokaneStBridge,04/29/2014 11:00:00 AM,48,-122,12,9,21
2844,SpokaneStBridge,04/29/2014 12:00:00 PM,48,-122,17,20,37
2845,SpokaneStBridge,04/29/2014 01:00:00 PM,48,-122,18,15,33
2846,SpokaneStBridge,04/29/2014 02:00:00 PM,48,-122,20,14,34
2847,SpokaneStBridge,04/29/2014 03:00:00 PM,48,-122,20,52,72
2848,SpokaneStBridge,04/29/2014 04:00:00 PM,48,-122,28,86,114
2849,SpokaneStBridge,04/29/2014 05:00:00 PM,48,-122,49,192,241
2850,SpokaneStBridge,04/29/2014 06:00:00 PM,48,-122,34,113,147
2851,SpokaneStBridge,04/29/2014 07:00:00 PM,48,-122,18,53,71
2852,SpokaneStBridge,04/29/2014 08:00:00 PM,48,-122,21,20,41
2853,SpokaneStBridge,04/29/2014 09:00:00 PM,48,-122,8,3,11
2854,SpokaneStBridge,04/29/2014 10:00:00 PM,48,-122,0,6,6
2855,SpokaneStBridge,04/29/2014 11:00:00 PM,48,-122,0,1,1
2856,SpokaneStBridge,04/30/2014 12:00:00 AM,48,-122,2,2,4
2857,SpokaneStBridge,04/30/2014 01:00:00 AM,48,-122,2,2,4
2858,SpokaneStBridge,04/30/2014 02:00:00 AM,48,-122,2,0,2
2859,SpokaneStBridge,04/30/2014 03:00:00 AM,48,-122,0,1,1
2860,SpokaneStBridge,04/30/2014 04:00:00 AM,48,-122,4,1,5
2861,SpokaneStBridge,04/30/2014 05:00:00 AM,48,-122,24,4,28
2862,SpokaneStBridge,04/30/2014 06:00:00 AM,48,-122,96,22,118
2863,SpokaneStBridge,04/30/2014 07:00:00 AM,48,-122,155,30,185
2864,SpokaneStBridge,04/30/2014 08:00:00 AM,48,-122,131,15,146
2865,SpokaneStBridge,04/30/2014 09:00:00 AM,48,-122,55,7,62
2866,SpokaneStBridge,04/30/2014 10:00:00 AM,48,-122,29,8,37
2867,SpokaneStBridge,04/30/2014 11:00:00 AM,48,-122,16,11,27
2868,SpokaneStBridge,04/30/2014 12:00:00 PM,48,-122,22,15,37
2869,SpokaneStBridge,04/30/2014 01:00:00 PM,48,-122,19,12,31
2870,SpokaneStBridge,04/30/2014 02:00:00 PM,48,-122,36,42,78
2871,SpokaneStBridge,04/30/2014 03:00:00 PM,48,-122,27,52,79
2872,SpokaneStBridge,04/30/2014 04:00:00 PM,48,-122,44,115,159
2873,SpokaneStBridge,04/30/2014 05:00:00 PM,48,-122,33,176,209
2874,SpokaneStBridge,04/30/2014 06:00:00 PM,48,-122,30,128,158
2875,SpokaneStBridge,04/30/2014 07:00:00 PM,48,-122,29,52,81
2876,SpokaneStBridge,04/30/2014 08:00:00 PM,48,-122,21,28,49
2877,SpokaneStBridge,04/30/2014 09:00:00 PM,48,-122,2,9,11
2878,SpokaneStBridge,04/30/2014 10:00:00 PM,48,-122,6,14,20
2879,SpokaneStBridge,04/30/2014 11:00:00 PM,48,-122,1,4,5
2880,SpokaneStBridge,05/01/2014 12:00:00 AM,48,-122,1,5,6
2881,SpokaneStBridge,05/01/2014 01:00:00 AM,48,-122,0,1,1
2882,SpokaneStBridge,05/01/2014 02:00:00 AM,48,-122,0,0,0
2883,SpokaneStBridge,05/01/2014 03:00:00 AM,48,-122,0,1,1
2884,SpokaneStBridge,05/01/2014 04:00:00 AM,48,-122,4,1,5
2885,SpokaneStBridge,05/01/2014 05:00:00 AM,48,-122,28,5,33
2886,SpokaneStBridge,05/01/2014 06:00:00 AM,48,-122,106,22,128
2887,SpokaneStBridge,05/01/2014 07:00:00 AM,48,-122,178,33,211
2888,SpokaneStBridge,05/01/2014 08:00:00 AM,48,-122,182,12,194
2889,SpokaneStBridge,05/01/2014 09:00:00 AM,48,-122,91,8,99
2890,SpokaneStBridge,05/01/2014 10:00:00 AM,48,-122,32,7,39
2891,SpokaneStBridge,05/01/2014 11:00:00 AM,48,-122,16,15,31
2892,SpokaneStBridge,05/01/2014 12:00:00 PM,48,-122,23,18,41
2893,SpokaneStBridge,05/01/2014 01:00:00 PM,48,-122,26,33,59
2894,SpokaneStBridge,05/01/2014 02:00:00 PM,48,-122,28,39,67
2895,SpokaneStBridge,05/01/2014 03:00:00 PM,48,-122,31,57,88
2896,SpokaneStBridge,05/01/2014 04:00:00 PM,48,-122,40,140,180
2897,SpokaneStBridge,05/01/2014 05:00:00 PM,48,-122,33,212,245
2898,SpokaneStBridge,05/01/2014 06:00:00 PM,48,-122,38,138,176
2899,SpokaneStBridge,05/01/2014 07:00:00 PM,48,-122,24,55,79
2900,SpokaneStBridge,05/01/2014 08:00:00 PM,48,-122,18,27,45
2901,SpokaneStBridge,05/01/2014 09:00:00 PM,48,-122,9,17,26
2902,SpokaneStBridge,05/01/2014 10:00:00 PM,48,-122,3,8,11
2903,SpokaneStBridge,05/01/2014 11:00:00 PM,48,-122,4,3,7
2904,SpokaneStBridge,05/02/2014 12:00:00 AM,48,-122,1,3,4
2905,SpokaneStBridge,05/02/2014 01:00:00 AM,48,-122,0,6,6
2906,SpokaneStBridge,05/02/2014 02:00:00 AM,48,-122,0,1,1
2907,SpokaneStBridge,05/02/2014 03:00:00 AM,48,-122,3,1,4
2908,SpokaneStBridge,05/02/2014 04:00:00 AM,48,-122,6,0,6
2909,SpokaneStBridge,05/02/2014 05:00:00 AM,48,-122,24,2,26
2910,SpokaneStBridge,05/02/2014 06:00:00 AM,48,-122,70,17,87
2911,SpokaneStBridge,05/02/2014 07:00:00 AM,48,-122,160,29,189
2912,SpokaneStBridge,05/02/2014 08:00:00 AM,48,-122,145,15,160
2913,SpokaneStBridge,05/02/2014 09:00:00 AM,48,-122,62,13,75
2914,SpokaneStBridge,05/02/2014 10:00:00 AM,48,-122,25,8,33
2915,SpokaneStBridge,05/02/2014 11:00:00 AM,48,-122,16,13,29
2916,SpokaneStBridge,05/02/2014 12:00:00 PM,48,-122,16,21,37
2917,SpokaneStBridge,05/02/2014 01:00:00 PM,48,-122,22,16,38
2918,SpokaneStBridge,05/02/2014 02:00:00 PM,48,-122,17,28,45
2919,SpokaneStBridge,05/02/2014 03:00:00 PM,48,-122,21,53,74
2920,SpokaneStBridge,05/02/2014 04:00:00 PM,48,-122,33,107,140
2921,SpokaneStBridge,05/02/2014 05:00:00 PM,48,-122,26,159,185
2922,SpokaneStBridge,05/02/2014 06:00:00 PM,48,-122,14,88,102
2923,SpokaneStBridge,05/02/2014 07:00:00 PM,48,-122,17,32,49
2924,SpokaneStBridge,05/02/2014 08:00:00 PM,48,-122,2,17,19
2925,SpokaneStBridge,05/02/2014 09:00:00 PM,48,-122,1,8,9
2926,SpokaneStBridge,05/02/2014 10:00:00 PM,48,-122,41,7,48
2927,SpokaneStBridge,05/02/2014 11:00:00 PM,48,-122,2,1,3
2928,SpokaneStBridge,05/03/2014 12:00:00 AM,48,-122,2,6,8
2929,SpokaneStBridge,05/03/2014 01:00:00 AM,48,-122,2,2,4
2930,SpokaneStBridge,05/03/2014 02:00:00 AM,48,-122,0,4,4
2931,SpokaneStBridge,05/03/2014 03:00:00 AM,48,-122,0,1,1
2932,SpokaneStBridge,05/03/2014 04:00:00 AM,48,-122,0,1,1
2933,SpokaneStBridge,05/03/2014 05:00:00 AM,48,-122,1,0,1
2934,SpokaneStBridge,05/03/2014 06:00:00 AM,48,-122,9,5,14
2935,SpokaneStBridge,05/03/2014 07:00:00 AM,48,-122,16,4,20
2936,SpokaneStBridge,05/03/2014 08:00:00 AM,48,-122,31,8,39
2937,SpokaneStBridge,05/03/2014 09:00:00 AM,48,-122,14,37,51
2938,SpokaneStBridge,05/03/2014 10:00:00 AM,48,-122,36,26,62
2939,SpokaneStBridge,05/03/2014 11:00:00 AM,48,-122,23,25,48
2940,SpokaneStBridge,05/03/2014 12:00:00 PM,48,-122,23,20,43
2941,SpokaneStBridge,05/03/2014 01:00:00 PM,48,-122,10,7,17
2942,SpokaneStBridge,05/03/2014 02:00:00 PM,48,-122,7,11,18
2943,SpokaneStBridge,05/03/2014 03:00:00 PM,48,-122,2,9,11
2944,SpokaneStBridge,05/03/2014 04:00:00 PM,48,-122,4,3,7
2945,SpokaneStBridge,05/03/2014 05:00:00 PM,48,-122,3,8,11
2946,SpokaneStBridge,05/03/2014 06:00:00 PM,48,-122,4,8,12
2947,SpokaneStBridge,05/03/2014 07:00:00 PM,48,-122,0,2,2
2948,SpokaneStBridge,05/03/2014 08:00:00 PM,48,-122,0,0,0
2949,SpokaneStBridge,05/03/2014 09:00:00 PM,48,-122,0,1,1
2950,SpokaneStBridge,05/03/2014 10:00:00 PM,48,-122,3,2,5
2951,SpokaneStBridge,05/03/2014 11:00:00 PM,48,-122,0,1,1
2952,SpokaneStBridge,05/04/2014 12:00:00 AM,48,-122,0,2,2
2953,SpokaneStBridge,05/04/2014 01:00:00 AM,48,-122,0,0,0
2954,SpokaneStBridge,05/04/2014 02:00:00 AM,48,-122,0,1,1
2955,SpokaneStBridge,05/04/2014 03:00:00 AM,48,-122,0,0,0
2956,SpokaneStBridge,05/04/2014 04:00:00 AM,48,-122,0,0,0
2957,SpokaneStBridge,05/04/2014 05:00:00 AM,48,-122,1,0,1
2958,SpokaneStBridge,05/04/2014 06:00:00 AM,48,-122,1,0,1
2959,SpokaneStBridge,05/04/2014 07:00:00 AM,48,-122,2,2,4
2960,SpokaneStBridge,05/04/2014 08:00:00 AM,48,-122,6,7,13
2961,SpokaneStBridge,05/04/2014 09:00:00 AM,48,-122,26,5,31
2962,SpokaneStBridge,05/04/2014 10:00:00 AM,48,-122,8,8,16
2963,SpokaneStBridge,05/04/2014 11:00:00 AM,48,-122,20,8,28
2964,SpokaneStBridge,05/04/2014 12:00:00 PM,48,-122,7,6,13
2965,SpokaneStBridge,05/04/2014 01:00:00 PM,48,-122,6,14,20
2966,SpokaneStBridge,05/04/2014 02:00:00 PM,48,-122,12,5,17
2967,SpokaneStBridge,05/04/2014 03:00:00 PM,48,-122,7,9,16
2968,SpokaneStBridge,05/04/2014 04:00:00 PM,48,-122,7,2,9
2969,SpokaneStBridge,05/04/2014 05:00:00 PM,48,-122,5,6,11
2970,SpokaneStBridge,05/04/2014 06:00:00 PM,48,-122,2,4,6
2971,SpokaneStBridge,05/04/2014 07:00:00 PM,48,-122,5,5,10
2972,SpokaneStBridge,05/04/2014 08:00:00 PM,48,-122,1,2,3
2973,SpokaneStBridge,05/04/2014 09:00:00 PM,48,-122,2,3,5
2974,SpokaneStBridge,05/04/2014 10:00:00 PM,48,-122,0,0,0
2975,SpokaneStBridge,05/04/2014 11:00:00 PM,48,-122,0,1,1
2976,SpokaneStBridge,05/05/2014 12:00:00 AM,48,-122,0,0,0
2977,SpokaneStBridge,05/05/2014 01:00:00 AM,48,-122,0,0,0
2978,SpokaneStBridge,05/05/2014 02:00:00 AM,48,-122,0,2,2
2979,SpokaneStBridge,05/05/2014 03:00:00 AM,48,-122,0,1,1
2980,SpokaneStBridge,05/05/2014 04:00:00 AM,48,-122,0,2,2
2981,SpokaneStBridge,05/05/2014 05:00:00 AM,48,-122,14,5,19
2982,SpokaneStBridge,05/05/2014 06:00:00 AM,48,-122,54,10,64
2983,SpokaneStBridge,05/05/2014 07:00:00 AM,48,-122,96,13,109
2984,SpokaneStBridge,05/05/2014 08:00:00 AM,48,-122,84,11,95
2985,SpokaneStBridge,05/05/2014 09:00:00 AM,48,-122,32,4,36
2986,SpokaneStBridge,05/05/2014 10:00:00 AM,48,-122,19,4,23
2987,SpokaneStBridge,05/05/2014 11:00:00 AM,48,-122,8,1,9
2988,SpokaneStBridge,05/05/2014 12:00:00 PM,48,-122,10,8,18
2989,SpokaneStBridge,05/05/2014 01:00:00 PM,48,-122,7,3,10
2990,SpokaneStBridge,05/05/2014 02:00:00 PM,48,-122,8,15,23
2991,SpokaneStBridge,05/05/2014 03:00:00 PM,48,-122,5,35,40
2992,SpokaneStBridge,05/05/2014 04:00:00 PM,48,-122,16,53,69
2993,SpokaneStBridge,05/05/2014 05:00:00 PM,48,-122,24,99,123
2994,SpokaneStBridge,05/05/2014 06:00:00 PM,48,-122,15,70,85
2995,SpokaneStBridge,05/05/2014 07:00:00 PM,48,-122,15,30,45
2996,SpokaneStBridge,05/05/2014 08:00:00 PM,48,-122,7,9,16
2997,SpokaneStBridge,05/05/2014 09:00:00 PM,48,-122,5,6,11
2998,SpokaneStBridge,05/05/2014 10:00:00 PM,48,-122,1,6,7
2999,SpokaneStBridge,05/05/2014 11:00:00 PM,48,-122,1,2,3
3000,SpokaneStBridge,05/06/2014 12:00:00 AM,48,-122,0,2,2
3001,SpokaneStBridge,05/06/2014 01:00:00 AM,48,-122,0,0,0
3002,SpokaneStBridge,05/06/2014 02:00:00 AM,48,-122,0,0,0
3003,SpokaneStBridge,05/06/2014 03:00:00 AM,48,-122,1,1,2
3004,SpokaneStBridge,05/06/2014 04:00:00 AM,48,-122,5,2,7
3005,SpokaneStBridge,05/06/2014 05:00:00 AM,48,-122,30,4,34
3006,SpokaneStBridge,05/06/2014 06:00:00 AM,48,-122,100,19,119
3007,SpokaneStBridge,05/06/2014 07:00:00 AM,48,-122,155,27,182
3008,SpokaneStBridge,05/06/2014 08:00:00 AM,48,-122,149,12,161
3009,SpokaneStBridge,05/06/2014 09:00:00 AM,48,-122,57,25,82
3010,SpokaneStBridge,05/06/2014 10:00:00 AM,48,-122,20,8,28
3011,SpokaneStBridge,05/06/2014 11:00:00 AM,48,-122,10,5,15
3012,SpokaneStBridge,05/06/2014 12:00:00 PM,48,-122,13,11,24
3013,SpokaneStBridge,05/06/2014 01:00:00 PM,48,-122,12,8,20
3014,SpokaneStBridge,05/06/2014 02:00:00 PM,48,-122,14,17,31
3015,SpokaneStBridge,05/06/2014 03:00:00 PM,48,-122,10,39,49
3016,SpokaneStBridge,05/06/2014 04:00:00 PM,48,-122,32,86,118
3017,SpokaneStBridge,05/06/2014 05:00:00 PM,48,-122,30,184,214
3018,SpokaneStBridge,05/06/2014 06:00:00 PM,48,-122,19,135,154
3019,SpokaneStBridge,05/06/2014 07:00:00 PM,48,-122,10,64,74
3020,SpokaneStBridge,05/06/2014 08:00:00 PM,48,-122,15,21,36
3021,SpokaneStBridge,05/06/2014 09:00:00 PM,48,-122,4,7,11
3022,SpokaneStBridge,05/06/2014 10:00:00 PM,48,-122,5,5,10
3023,SpokaneStBridge,05/06/2014 11:00:00 PM,48,-122,0,4,4
3024,SpokaneStBridge,05/07/2014 12:00:00 AM,48,-122,0,2,2
3025,SpokaneStBridge,05/07/2014 01:00:00 AM,48,-122,0,0,0
3026,SpokaneStBridge,05/07/2014 02:00:00 AM,48,-122,1,0,1
3027,SpokaneStBridge,05/07/2014 03:00:00 AM,48,-122,0,1,1
3028,SpokaneStBridge,05/07/2014 04:00:00 AM,48,-122,6,0,6
3029,SpokaneStBridge,05/07/2014 05:00:00 AM,48,-122,24,4,28
3030,SpokaneStBridge,05/07/2014 06:00:00 AM,48,-122,103,27,130
3031,SpokaneStBridge,05/07/2014 07:00:00 AM,48,-122,169,28,197
3032,SpokaneStBridge,05/07/2014 08:00:00 AM,48,-122,141,15,156
3033,SpokaneStBridge,05/07/2014 09:00:00 AM,48,-122,61,9,70
3034,SpokaneStBridge,05/07/2014 10:00:00 AM,48,-122,29,9,38
3035,SpokaneStBridge,05/07/2014 11:00:00 AM,48,-122,25,16,41
3036,SpokaneStBridge,05/07/2014 12:00:00 PM,48,-122,15,13,28
3037,SpokaneStBridge,05/07/2014 01:00:00 PM,48,-122,25,17,42
3038,SpokaneStBridge,05/07/2014 02:00:00 PM,48,-122,20,28,48
3039,SpokaneStBridge,05/07/2014 03:00:00 PM,48,-122,28,65,93
3040,SpokaneStBridge,05/07/2014 04:00:00 PM,48,-122,30,102,132
3041,SpokaneStBridge,05/07/2014 05:00:00 PM,48,-122,56,200,256
3042,SpokaneStBridge,05/07/2014 06:00:00 PM,48,-122,30,120,150
3043,SpokaneStBridge,05/07/2014 07:00:00 PM,48,-122,25,53,78
3044,SpokaneStBridge,05/07/2014 08:00:00 PM,48,-122,14,19,33
3045,SpokaneStBridge,05/07/2014 09:00:00 PM,48,-122,11,33,44
3046,SpokaneStBridge,05/07/2014 10:00:00 PM,48,-122,3,10,13
3047,SpokaneStBridge,05/07/2014 11:00:00 PM,48,-122,4,1,5
3048,SpokaneStBridge,05/08/2014 12:00:00 AM,48,-122,4,3,7
3049,SpokaneStBridge,05/08/2014 01:00:00 AM,48,-122,0,2,2
3050,SpokaneStBridge,05/08/2014 02:00:00 AM,48,-122,0,1,1
3051,SpokaneStBridge,05/08/2014 03:00:00 AM,48,-122,1,2,3
3052,SpokaneStBridge,05/08/2014 04:00:00 AM,48,-122,6,3,9
3053,SpokaneStBridge,05/08/2014 05:00:00 AM,48,-122,26,1,27
3054,SpokaneStBridge,05/08/2014 06:00:00 AM,48,-122,67,15,82
3055,SpokaneStBridge,05/08/2014 07:00:00 AM,48,-122,112,20,132
3056,SpokaneStBridge,05/08/2014 08:00:00 AM,48,-122,122,9,131
3057,SpokaneStBridge,05/08/2014 09:00:00 AM,48,-122,49,7,56
3058,SpokaneStBridge,05/08/2014 10:00:00 AM,48,-122,10,3,13
3059,SpokaneStBridge,05/08/2014 11:00:00 AM,48,-122,8,5,13
3060,SpokaneStBridge,05/08/2014 12:00:00 PM,48,-122,11,11,22
3061,SpokaneStBridge,05/08/2014 01:00:00 PM,48,-122,7,7,14
3062,SpokaneStBridge,05/08/2014 02:00:00 PM,48,-122,3,11,14
3063,SpokaneStBridge,05/08/2014 03:00:00 PM,48,-122,5,24,29
3064,SpokaneStBridge,05/08/2014 04:00:00 PM,48,-122,8,46,54
3065,SpokaneStBridge,05/08/2014 05:00:00 PM,48,-122,17,101,118
3066,SpokaneStBridge,05/08/2014 06:00:00 PM,48,-122,11,69,80
3067,SpokaneStBridge,05/08/2014 07:00:00 PM,48,-122,7,29,36
3068,SpokaneStBridge,05/08/2014 08:00:00 PM,48,-122,4,10,14
3069,SpokaneStBridge,05/08/2014 09:00:00 PM,48,-122,1,5,6
3070,SpokaneStBridge,05/08/2014 10:00:00 PM,48,-122,0,4,4
3071,SpokaneStBridge,05/08/2014 11:00:00 PM,48,-122,0,1,1
3072,SpokaneStBridge,05/09/2014 12:00:00 AM,48,-122,2,0,2
3073,SpokaneStBridge,05/09/2014 01:00:00 AM,48,-122,0,1,1
3074,SpokaneStBridge,05/09/2014 02:00:00 AM,48,-122,1,0,1
3075,SpokaneStBridge,05/09/2014 03:00:00 AM,48,-122,0,0,0
3076,SpokaneStBridge,05/09/2014 04:00:00 AM,48,-122,4,0,4
3077,SpokaneStBridge,05/09/2014 05:00:00 AM,48,-122,15,3,18
3078,SpokaneStBridge,05/09/2014 06:00:00 AM,48,-122,39,7,46
3079,SpokaneStBridge,05/09/2014 07:00:00 AM,48,-122,100,19,119
3080,SpokaneStBridge,05/09/2014 08:00:00 AM,48,-122,95,4,99
3081,SpokaneStBridge,05/09/2014 09:00:00 AM,48,-122,39,3,42
3082,SpokaneStBridge,05/09/2014 10:00:00 AM,48,-122,18,6,24
3083,SpokaneStBridge,05/09/2014 11:00:00 AM,48,-122,3,7,10
3084,SpokaneStBridge,05/09/2014 12:00:00 PM,48,-122,4,6,10
3085,SpokaneStBridge,05/09/2014 01:00:00 PM,48,-122,10,7,17
3086,SpokaneStBridge,05/09/2014 02:00:00 PM,48,-122,5,12,17
3087,SpokaneStBridge,05/09/2014 03:00:00 PM,48,-122,10,29,39
3088,SpokaneStBridge,05/09/2014 04:00:00 PM,48,-122,19,44,63
3089,SpokaneStBridge,05/09/2014 05:00:00 PM,48,-122,24,111,135
3090,SpokaneStBridge,05/09/2014 06:00:00 PM,48,-122,5,61,66
3091,SpokaneStBridge,05/09/2014 07:00:00 PM,48,-122,3,24,27
3092,SpokaneStBridge,05/09/2014 08:00:00 PM,48,-122,3,8,11
3093,SpokaneStBridge,05/09/2014 09:00:00 PM,48,-122,4,4,8
3094,SpokaneStBridge,05/09/2014 10:00:00 PM,48,-122,0,5,5
3095,SpokaneStBridge,05/09/2014 11:00:00 PM,48,-122,1,0,1
3096,SpokaneStBridge,05/10/2014 12:00:00 AM,48,-122,1,2,3
3097,SpokaneStBridge,05/10/2014 01:00:00 AM,48,-122,0,1,1
3098,SpokaneStBridge,05/10/2014 02:00:00 AM,48,-122,0,0,0
3099,SpokaneStBridge,05/10/2014 03:00:00 AM,48,-122,1,0,1
3100,SpokaneStBridge,05/10/2014 04:00:00 AM,48,-122,1,0,1
3101,SpokaneStBridge,05/10/2014 05:00:00 AM,48,-122,6,3,9
3102,SpokaneStBridge,05/10/2014 06:00:00 AM,48,-122,4,3,7
3103,SpokaneStBridge,05/10/2014 07:00:00 AM,48,-122,6,2,8
3104,SpokaneStBridge,05/10/2014 08:00:00 AM,48,-122,8,8,16
3105,SpokaneStBridge,05/10/2014 09:00:00 AM,48,-122,15,9,24
3106,SpokaneStBridge,05/10/2014 10:00:00 AM,48,-122,12,29,41
3107,SpokaneStBridge,05/10/2014 11:00:00 AM,48,-122,30,12,42
3108,SpokaneStBridge,05/10/2014 12:00:00 PM,48,-122,33,17,50
3109,SpokaneStBridge,05/10/2014 01:00:00 PM,48,-122,20,27,47
3110,SpokaneStBridge,05/10/2014 02:00:00 PM,48,-122,38,29,67
3111,SpokaneStBridge,05/10/2014 03:00:00 PM,48,-122,25,20,45
3112,SpokaneStBridge,05/10/2014 04:00:00 PM,48,-122,15,16,31
3113,SpokaneStBridge,05/10/2014 05:00:00 PM,48,-122,18,18,36
3114,SpokaneStBridge,05/10/2014 06:00:00 PM,48,-122,5,9,14
3115,SpokaneStBridge,05/10/2014 07:00:00 PM,48,-122,7,12,19
3116,SpokaneStBridge,05/10/2014 08:00:00 PM,48,-122,7,11,18
3117,SpokaneStBridge,05/10/2014 09:00:00 PM,48,-122,7,3,10
3118,SpokaneStBridge,05/10/2014 10:00:00 PM,48,-122,0,3,3
3119,SpokaneStBridge,05/10/2014 11:00:00 PM,48,-122,0,2,2
3120,SpokaneStBridge,05/11/2014 12:00:00 AM,48,-122,0,3,3
3121,SpokaneStBridge,05/11/2014 01:00:00 AM,48,-122,1,0,1
3122,SpokaneStBridge,05/11/2014 02:00:00 AM,48,-122,0,0,0
3123,SpokaneStBridge,05/11/2014 03:00:00 AM,48,-122,0,1,1
3124,SpokaneStBridge,05/11/2014 04:00:00 AM,48,-122,0,2,2
3125,SpokaneStBridge,05/11/2014 05:00:00 AM,48,-122,3,1,4
3126,SpokaneStBridge,05/11/2014 06:00:00 AM,48,-122,3,3,6
3127,SpokaneStBridge,05/11/2014 07:00:00 AM,48,-122,5,6,11
3128,SpokaneStBridge,05/11/2014 08:00:00 AM,48,-122,15,2,17
3129,SpokaneStBridge,05/11/2014 09:00:00 AM,48,-122,28,11,39
3130,SpokaneStBridge,05/11/2014 10:00:00 AM,48,-122,10,13,23
3131,SpokaneStBridge,05/11/2014 11:00:00 AM,48,-122,46,22,68
3132,SpokaneStBridge,05/11/2014 12:00:00 PM,48,-122,40,35,75
3133,SpokaneStBridge,05/11/2014 01:00:00 PM,48,-122,35,36,71
3134,SpokaneStBridge,05/11/2014 02:00:00 PM,48,-122,46,49,95
3135,SpokaneStBridge,05/11/2014 03:00:00 PM,48,-122,39,40,79
3136,SpokaneStBridge,05/11/2014 04:00:00 PM,48,-122,23,45,68
3137,SpokaneStBridge,05/11/2014 05:00:00 PM,48,-122,30,26,56
3138,SpokaneStBridge,05/11/2014 06:00:00 PM,48,-122,25,23,48
3139,SpokaneStBridge,05/11/2014 07:00:00 PM,48,-122,15,16,31
3140,SpokaneStBridge,05/11/2014 08:00:00 PM,48,-122,5,8,13
3141,SpokaneStBridge,05/11/2014 09:00:00 PM,48,-122,5,2,7
3142,SpokaneStBridge,05/11/2014 10:00:00 PM,48,-122,2,3,5
3143,SpokaneStBridge,05/11/2014 11:00:00 PM,48,-122,0,1,1
3144,SpokaneStBridge,05/12/2014 12:00:00 AM,48,-122,2,3,5
3145,SpokaneStBridge,05/12/2014 01:00:00 AM,48,-122,0,1,1
3146,SpokaneStBridge,05/12/2014 02:00:00 AM,48,-122,0,0,0
3147,SpokaneStBridge,05/12/2014 03:00:00 AM,48,-122,0,2,2
3148,SpokaneStBridge,05/12/2014 04:00:00 AM,48,-122,9,0,9
3149,SpokaneStBridge,05/12/2014 05:00:00 AM,48,-122,27,8,35
3150,SpokaneStBridge,05/12/2014 06:00:00 AM,48,-122,88,17,105
3151,SpokaneStBridge,05/12/2014 07:00:00 AM,48,-122,174,32,206
3152,SpokaneStBridge,05/12/2014 08:00:00 AM,48,-122,154,19,173
3153,SpokaneStBridge,05/12/2014 09:00:00 AM,48,-122,69,6,75
3154,SpokaneStBridge,05/12/2014 10:00:00 AM,48,-122,23,9,32
3155,SpokaneStBridge,05/12/2014 11:00:00 AM,48,-122,14,8,22
3156,SpokaneStBridge,05/12/2014 12:00:00 PM,48,-122,25,14,39
3157,SpokaneStBridge,05/12/2014 01:00:00 PM,48,-122,13,16,29
3158,SpokaneStBridge,05/12/2014 02:00:00 PM,48,-122,23,29,52
3159,SpokaneStBridge,05/12/2014 03:00:00 PM,48,-122,26,47,73
3160,SpokaneStBridge,05/12/2014 04:00:00 PM,48,-122,39,97,136
3161,SpokaneStBridge,05/12/2014 05:00:00 PM,48,-122,42,216,258
3162,SpokaneStBridge,05/12/2014 06:00:00 PM,48,-122,21,165,186
3163,SpokaneStBridge,05/12/2014 07:00:00 PM,48,-122,18,45,63
3164,SpokaneStBridge,05/12/2014 08:00:00 PM,48,-122,17,32,49
3165,SpokaneStBridge,05/12/2014 09:00:00 PM,48,-122,11,6,17
3166,SpokaneStBridge,05/12/2014 10:00:00 PM,48,-122,6,11,17
3167,SpokaneStBridge,05/12/2014 11:00:00 PM,48,-122,5,4,9
3168,SpokaneStBridge,05/13/2014 12:00:00 AM,48,-122,2,3,5
3169,SpokaneStBridge,05/13/2014 01:00:00 AM,48,-122,0,3,3
3170,SpokaneStBridge,05/13/2014 02:00:00 AM,48,-122,0,0,0
3171,SpokaneStBridge,05/13/2014 03:00:00 AM,48,-122,0,2,2
3172,SpokaneStBridge,05/13/2014 04:00:00 AM,48,-122,1,0,1
3173,SpokaneStBridge,05/13/2014 05:00:00 AM,48,-122,28,4,32
3174,SpokaneStBridge,05/13/2014 06:00:00 AM,48,-122,116,20,136
3175,SpokaneStBridge,05/13/2014 07:00:00 AM,48,-122,200,20,220
3176,SpokaneStBridge,05/13/2014 08:00:00 AM,48,-122,165,12,177
3177,SpokaneStBridge,05/13/2014 09:00:00 AM,48,-122,73,7,80
3178,SpokaneStBridge,05/13/2014 10:00:00 AM,48,-122,35,12,47
3179,SpokaneStBridge,05/13/2014 11:00:00 AM,48,-122,15,15,30
3180,SpokaneStBridge,05/13/2014 12:00:00 PM,48,-122,19,21,40
3181,SpokaneStBridge,05/13/2014 01:00:00 PM,48,-122,18,16,34
3182,SpokaneStBridge,05/13/2014 02:00:00 PM,48,-122,20,33,53
3183,SpokaneStBridge,05/13/2014 03:00:00 PM,48,-122,28,48,76
3184,SpokaneStBridge,05/13/2014 04:00:00 PM,48,-122,41,119,160
3185,SpokaneStBridge,05/13/2014 05:00:00 PM,48,-122,48,237,285
3186,SpokaneStBridge,05/13/2014 06:00:00 PM,48,-122,28,145,173
3187,SpokaneStBridge,05/13/2014 07:00:00 PM,48,-122,24,70,94
3188,SpokaneStBridge,05/13/2014 08:00:00 PM,48,-122,27,42,69
3189,SpokaneStBridge,05/13/2014 09:00:00 PM,48,-122,5,13,18
3190,SpokaneStBridge,05/13/2014 10:00:00 PM,48,-122,3,10,13
3191,SpokaneStBridge,05/13/2014 11:00:00 PM,48,-122,3,1,4
3192,SpokaneStBridge,05/14/2014 12:00:00 AM,48,-122,2,5,7
3193,SpokaneStBridge,05/14/2014 01:00:00 AM,48,-122,1,2,3
3194,SpokaneStBridge,05/14/2014 02:00:00 AM,48,-122,1,0,1
3195,SpokaneStBridge,05/14/2014 03:00:00 AM,48,-122,0,1,1
3196,SpokaneStBridge,05/14/2014 04:00:00 AM,48,-122,4,1,5
3197,SpokaneStBridge,05/14/2014 05:00:00 AM,48,-122,29,8,37
3198,SpokaneStBridge,05/14/2014 06:00:00 AM,48,-122,106,29,135
3199,SpokaneStBridge,05/14/2014 07:00:00 AM,48,-122,187,24,211
3200,SpokaneStBridge,05/14/2014 08:00:00 AM,48,-122,172,10,182
3201,SpokaneStBridge,05/14/2014 09:00:00 AM,48,-122,76,9,85
3202,SpokaneStBridge,05/14/2014 10:00:00 AM,48,-122,16,8,24
3203,SpokaneStBridge,05/14/2014 11:00:00 AM,48,-122,21,15,36
3204,SpokaneStBridge,05/14/2014 12:00:00 PM,48,-122,30,30,60
3205,SpokaneStBridge,05/14/2014 01:00:00 PM,48,-122,26,27,53
3206,SpokaneStBridge,05/14/2014 02:00:00 PM,48,-122,12,34,46
3207,SpokaneStBridge,05/14/2014 03:00:00 PM,48,-122,28,54,82
3208,SpokaneStBridge,05/14/2014 04:00:00 PM,48,-122,37,127,164
3209,SpokaneStBridge,05/14/2014 05:00:00 PM,48,-122,46,241,287
3210,SpokaneStBridge,05/14/2014 06:00:00 PM,48,-122,38,142,180
3211,SpokaneStBridge,05/14/2014 07:00:00 PM,48,-122,27,94,121
3212,SpokaneStBridge,05/14/2014 08:00:00 PM,48,-122,29,46,75
3213,SpokaneStBridge,05/14/2014 09:00:00 PM,48,-122,17,10,27
3214,SpokaneStBridge,05/14/2014 10:00:00 PM,48,-122,12,10,22
3215,SpokaneStBridge,05/14/2014 11:00:00 PM,48,-122,2,1,3
3216,SpokaneStBridge,05/15/2014 12:00:00 AM,48,-122,2,4,6
3217,SpokaneStBridge,05/15/2014 01:00:00 AM,48,-122,0,2,2
3218,SpokaneStBridge,05/15/2014 02:00:00 AM,48,-122,2,0,2
3219,SpokaneStBridge,05/15/2014 03:00:00 AM,48,-122,0,0,0
3220,SpokaneStBridge,05/15/2014 04:00:00 AM,48,-122,5,3,8
3221,SpokaneStBridge,05/15/2014 05:00:00 AM,48,-122,28,4,32
3222,SpokaneStBridge,05/15/2014 06:00:00 AM,48,-122,105,16,121
3223,SpokaneStBridge,05/15/2014 07:00:00 AM,48,-122,193,24,217
3224,SpokaneStBridge,05/15/2014 08:00:00 AM,48,-122,165,10,175
3225,SpokaneStBridge,05/15/2014 09:00:00 AM,48,-122,71,6,77
3226,SpokaneStBridge,05/15/2014 10:00:00 AM,48,-122,26,24,50
3227,SpokaneStBridge,05/15/2014 11:00:00 AM,48,-122,23,9,32
3228,SpokaneStBridge,05/15/2014 12:00:00 PM,48,-122,19,24,43
3229,SpokaneStBridge,05/15/2014 01:00:00 PM,48,-122,19,26,45
3230,SpokaneStBridge,05/15/2014 02:00:00 PM,48,-122,13,31,44
3231,SpokaneStBridge,05/15/2014 03:00:00 PM,48,-122,28,35,63
3232,SpokaneStBridge,05/15/2014 04:00:00 PM,48,-122,24,120,144
3233,SpokaneStBridge,05/15/2014 05:00:00 PM,48,-122,47,212,259
3234,SpokaneStBridge,05/15/2014 06:00:00 PM,48,-122,27,128,155
3235,SpokaneStBridge,05/15/2014 07:00:00 PM,48,-122,18,71,89
3236,SpokaneStBridge,05/15/2014 08:00:00 PM,48,-122,17,14,31
3237,SpokaneStBridge,05/15/2014 09:00:00 PM,48,-122,12,22,34
3238,SpokaneStBridge,05/15/2014 10:00:00 PM,48,-122,6,11,17
3239,SpokaneStBridge,05/15/2014 11:00:00 PM,48,-122,1,1,2
3240,SpokaneStBridge,05/16/2014 12:00:00 AM,48,-122,2,6,8
3241,SpokaneStBridge,05/16/2014 01:00:00 AM,48,-122,3,0,3
3242,SpokaneStBridge,05/16/2014 02:00:00 AM,48,-122,0,1,1
3243,SpokaneStBridge,05/16/2014 03:00:00 AM,48,-122,2,2,4
3244,SpokaneStBridge,05/16/2014 04:00:00 AM,48,-122,3,2,5
3245,SpokaneStBridge,05/16/2014 05:00:00 AM,48,-122,34,11,45
3246,SpokaneStBridge,05/16/2014 06:00:00 AM,48,-122,105,30,135
3247,SpokaneStBridge,05/16/2014 07:00:00 AM,48,-122,220,29,249
3248,SpokaneStBridge,05/16/2014 08:00:00 AM,48,-122,171,23,194
3249,SpokaneStBridge,05/16/2014 09:00:00 AM,48,-122,78,15,93
3250,SpokaneStBridge,05/16/2014 10:00:00 AM,48,-122,25,8,33
3251,SpokaneStBridge,05/16/2014 11:00:00 AM,48,-122,16,15,31
3252,SpokaneStBridge,05/16/2014 12:00:00 PM,48,-122,16,55,71
3253,SpokaneStBridge,05/16/2014 01:00:00 PM,48,-122,18,21,39
3254,SpokaneStBridge,05/16/2014 02:00:00 PM,48,-122,46,49,95
3255,SpokaneStBridge,05/16/2014 03:00:00 PM,48,-122,19,47,66
3256,SpokaneStBridge,05/16/2014 04:00:00 PM,48,-122,51,128,179
3257,SpokaneStBridge,05/16/2014 05:00:00 PM,48,-122,38,193,231
3258,SpokaneStBridge,05/16/2014 06:00:00 PM,48,-122,18,102,120
3259,SpokaneStBridge,05/16/2014 07:00:00 PM,48,-122,12,61,73
3260,SpokaneStBridge,05/16/2014 08:00:00 PM,48,-122,16,21,37
3261,SpokaneStBridge,05/16/2014 09:00:00 PM,48,-122,2,8,10
3262,SpokaneStBridge,05/16/2014 10:00:00 PM,48,-122,4,4,8
3263,SpokaneStBridge,05/16/2014 11:00:00 PM,48,-122,3,2,5
3264,SpokaneStBridge,05/17/2014 12:00:00 AM,48,-122,4,4,8
3265,SpokaneStBridge,05/17/2014 01:00:00 AM,48,-122,0,2,2
3266,SpokaneStBridge,05/17/2014 02:00:00 AM,48,-122,0,4,4
3267,SpokaneStBridge,05/17/2014 03:00:00 AM,48,-122,1,0,1
3268,SpokaneStBridge,05/17/2014 04:00:00 AM,48,-122,0,1,1
3269,SpokaneStBridge,05/17/2014 05:00:00 AM,48,-122,2,1,3
3270,SpokaneStBridge,05/17/2014 06:00:00 AM,48,-122,13,3,16
3271,SpokaneStBridge,05/17/2014 07:00:00 AM,48,-122,13,10,23
3272,SpokaneStBridge,05/17/2014 08:00:00 AM,48,-122,13,9,22
3273,SpokaneStBridge,05/17/2014 09:00:00 AM,48,-122,27,21,48
3274,SpokaneStBridge,05/17/2014 10:00:00 AM,48,-122,16,21,37
3275,SpokaneStBridge,05/17/2014 11:00:00 AM,48,-122,29,34,63
3276,SpokaneStBridge,05/17/2014 12:00:00 PM,48,-122,26,25,51
3277,SpokaneStBridge,05/17/2014 01:00:00 PM,48,-122,31,36,67
3278,SpokaneStBridge,05/17/2014 02:00:00 PM,48,-122,36,21,57
3279,SpokaneStBridge,05/17/2014 03:00:00 PM,48,-122,31,27,58
3280,SpokaneStBridge,05/17/2014 04:00:00 PM,48,-122,34,22,56
3281,SpokaneStBridge,05/17/2014 05:00:00 PM,48,-122,11,16,27
3282,SpokaneStBridge,05/17/2014 06:00:00 PM,48,-122,15,17,32
3283,SpokaneStBridge,05/17/2014 07:00:00 PM,48,-122,9,11,20
3284,SpokaneStBridge,05/17/2014 08:00:00 PM,48,-122,4,5,9
3285,SpokaneStBridge,05/17/2014 09:00:00 PM,48,-122,0,9,9
3286,SpokaneStBridge,05/17/2014 10:00:00 PM,48,-122,2,8,10
3287,SpokaneStBridge,05/17/2014 11:00:00 PM,48,-122,3,2,5
3288,SpokaneStBridge,05/18/2014 12:00:00 AM,48,-122,0,4,4
3289,SpokaneStBridge,05/18/2014 01:00:00 AM,48,-122,1,2,3
3290,SpokaneStBridge,05/18/2014 02:00:00 AM,48,-122,0,1,1
3291,SpokaneStBridge,05/18/2014 03:00:00 AM,48,-122,0,0,0
3292,SpokaneStBridge,05/18/2014 04:00:00 AM,48,-122,1,1,2
3293,SpokaneStBridge,05/18/2014 05:00:00 AM,48,-122,4,1,5
3294,SpokaneStBridge,05/18/2014 06:00:00 AM,48,-122,3,1,4
3295,SpokaneStBridge,05/18/2014 07:00:00 AM,48,-122,6,3,9
3296,SpokaneStBridge,05/18/2014 08:00:00 AM,48,-122,17,9,26
3297,SpokaneStBridge,05/18/2014 09:00:00 AM,48,-122,23,10,33
3298,SpokaneStBridge,05/18/2014 10:00:00 AM,48,-122,28,17,45
3299,SpokaneStBridge,05/18/2014 11:00:00 AM,48,-122,23,33,56
3300,SpokaneStBridge,05/18/2014 12:00:00 PM,48,-122,40,33,73
3301,SpokaneStBridge,05/18/2014 01:00:00 PM,48,-122,40,30,70
3302,SpokaneStBridge,05/18/2014 02:00:00 PM,48,-122,52,50,102
3303,SpokaneStBridge,05/18/2014 03:00:00 PM,48,-122,31,21,52
3304,SpokaneStBridge,05/18/2014 04:00:00 PM,48,-122,20,17,37
3305,SpokaneStBridge,05/18/2014 05:00:00 PM,48,-122,15,22,37
3306,SpokaneStBridge,05/18/2014 06:00:00 PM,48,-122,13,6,19
3307,SpokaneStBridge,05/18/2014 07:00:00 PM,48,-122,9,5,14
3308,SpokaneStBridge,05/18/2014 08:00:00 PM,48,-122,4,4,8
3309,SpokaneStBridge,05/18/2014 09:00:00 PM,48,-122,0,3,3
3310,SpokaneStBridge,05/18/2014 10:00:00 PM,48,-122,2,1,3
3311,SpokaneStBridge,05/18/2014 11:00:00 PM,48,-122,1,1,2
3312,SpokaneStBridge,05/19/2014 12:00:00 AM,48,-122,1,0,1
3313,SpokaneStBridge,05/19/2014 01:00:00 AM,48,-122,0,0,0
3314,SpokaneStBridge,05/19/2014 02:00:00 AM,48,-122,0,1,1
3315,SpokaneStBridge,05/19/2014 03:00:00 AM,48,-122,1,0,1
3316,SpokaneStBridge,05/19/2014 04:00:00 AM,48,-122,4,2,6
3317,SpokaneStBridge,05/19/2014 05:00:00 AM,48,-122,19,4,23
3318,SpokaneStBridge,05/19/2014 06:00:00 AM,48,-122,91,10,101
3319,SpokaneStBridge,05/19/2014 07:00:00 AM,48,-122,154,22,176
3320,SpokaneStBridge,05/19/2014 08:00:00 AM,48,-122,141,11,152
3321,SpokaneStBridge,05/19/2014 09:00:00 AM,48,-122,62,7,69
3322,SpokaneStBridge,05/19/2014 10:00:00 AM,48,-122,31,8,39
3323,SpokaneStBridge,05/19/2014 11:00:00 AM,48,-122,20,9,29
3324,SpokaneStBridge,05/19/2014 12:00:00 PM,48,-122,14,14,28
3325,SpokaneStBridge,05/19/2014 01:00:00 PM,48,-122,11,13,24
3326,SpokaneStBridge,05/19/2014 02:00:00 PM,48,-122,18,35,53
3327,SpokaneStBridge,05/19/2014 03:00:00 PM,48,-122,19,34,53
3328,SpokaneStBridge,05/19/2014 04:00:00 PM,48,-122,29,91,120
3329,SpokaneStBridge,05/19/2014 05:00:00 PM,48,-122,29,186,215
3330,SpokaneStBridge,05/19/2014 06:00:00 PM,48,-122,8,131,139
3331,SpokaneStBridge,05/19/2014 07:00:00 PM,48,-122,15,50,65
3332,SpokaneStBridge,05/19/2014 08:00:00 PM,48,-122,14,21,35
3333,SpokaneStBridge,05/19/2014 09:00:00 PM,48,-122,9,15,24
3334,SpokaneStBridge,05/19/2014 10:00:00 PM,48,-122,4,7,11
3335,SpokaneStBridge,05/19/2014 11:00:00 PM,48,-122,4,5,9
3336,SpokaneStBridge,05/20/2014 12:00:00 AM,48,-122,0,7,7
3337,SpokaneStBridge,05/20/2014 01:00:00 AM,48,-122,6,3,9
3338,SpokaneStBridge,05/20/2014 02:00:00 AM,48,-122,0,0,0
3339,SpokaneStBridge,05/20/2014 03:00:00 AM,48,-122,1,0,1
3340,SpokaneStBridge,05/20/2014 04:00:00 AM,48,-122,4,2,6
3341,SpokaneStBridge,05/20/2014 05:00:00 AM,48,-122,37,6,43
3342,SpokaneStBridge,05/20/2014 06:00:00 AM,48,-122,121,26,147
3343,SpokaneStBridge,05/20/2014 07:00:00 AM,48,-122,175,25,200
3344,SpokaneStBridge,05/20/2014 08:00:00 AM,48,-122,198,12,210
3345,SpokaneStBridge,05/20/2014 09:00:00 AM,48,-122,78,4,82
3346,SpokaneStBridge,05/20/2014 10:00:00 AM,48,-122,20,15,35
3347,SpokaneStBridge,05/20/2014 11:00:00 AM,48,-122,18,13,31
3348,SpokaneStBridge,05/20/2014 12:00:00 PM,48,-122,14,11,25
3349,SpokaneStBridge,05/20/2014 01:00:00 PM,48,-122,18,19,37
3350,SpokaneStBridge,05/20/2014 02:00:00 PM,48,-122,22,26,48
3351,SpokaneStBridge,05/20/2014 03:00:00 PM,48,-122,28,53,81
3352,SpokaneStBridge,05/20/2014 04:00:00 PM,48,-122,31,119,150
3353,SpokaneStBridge,05/20/2014 05:00:00 PM,48,-122,28,225,253
3354,SpokaneStBridge,05/20/2014 06:00:00 PM,48,-122,27,140,167
3355,SpokaneStBridge,05/20/2014 07:00:00 PM,48,-122,19,54,73
3356,SpokaneStBridge,05/20/2014 08:00:00 PM,48,-122,5,31,36
3357,SpokaneStBridge,05/20/2014 09:00:00 PM,48,-122,14,18,32
3358,SpokaneStBridge,05/20/2014 10:00:00 PM,48,-122,4,8,12
3359,SpokaneStBridge,05/20/2014 11:00:00 PM,48,-122,2,4,6
3360,SpokaneStBridge,05/21/2014 12:00:00 AM,48,-122,0,1,1
3361,SpokaneStBridge,05/21/2014 01:00:00 AM,48,-122,0,3,3
3362,SpokaneStBridge,05/21/2014 02:00:00 AM,48,-122,1,1,2
3363,SpokaneStBridge,05/21/2014 03:00:00 AM,48,-122,0,0,0
3364,SpokaneStBridge,05/21/2014 04:00:00 AM,48,-122,7,3,10
3365,SpokaneStBridge,05/21/2014 05:00:00 AM,48,-122,32,1,33
3366,SpokaneStBridge,05/21/2014 06:00:00 AM,48,-122,105,14,119
3367,SpokaneStBridge,05/21/2014 07:00:00 AM,48,-122,182,25,207
3368,SpokaneStBridge,05/21/2014 08:00:00 AM,48,-122,121,10,131
3369,SpokaneStBridge,05/21/2014 09:00:00 AM,48,-122,89,12,101
3370,SpokaneStBridge,05/21/2014 10:00:00 AM,48,-122,22,8,30
3371,SpokaneStBridge,05/21/2014 11:00:00 AM,48,-122,9,17,26
3372,SpokaneStBridge,05/21/2014 12:00:00 PM,48,-122,22,13,35
3373,SpokaneStBridge,05/21/2014 01:00:00 PM,48,-122,25,21,46
3374,SpokaneStBridge,05/21/2014 02:00:00 PM,48,-122,25,17,42
3375,SpokaneStBridge,05/21/2014 03:00:00 PM,48,-122,22,43,65
3376,SpokaneStBridge,05/21/2014 04:00:00 PM,48,-122,27,100,127
3377,SpokaneStBridge,05/21/2014 05:00:00 PM,48,-122,35,191,226
3378,SpokaneStBridge,05/21/2014 06:00:00 PM,48,-122,23,141,164
3379,SpokaneStBridge,05/21/2014 07:00:00 PM,48,-122,19,49,68
3380,SpokaneStBridge,05/21/2014 08:00:00 PM,48,-122,9,27,36
3381,SpokaneStBridge,05/21/2014 09:00:00 PM,48,-122,6,15,21
3382,SpokaneStBridge,05/21/2014 10:00:00 PM,48,-122,6,10,16
3383,SpokaneStBridge,05/21/2014 11:00:00 PM,48,-122,2,7,9
3384,SpokaneStBridge,05/22/2014 12:00:00 AM,48,-122,2,4,6
3385,SpokaneStBridge,05/22/2014 01:00:00 AM,48,-122,2,0,2
3386,SpokaneStBridge,05/22/2014 02:00:00 AM,48,-122,0,2,2
3387,SpokaneStBridge,05/22/2014 03:00:00 AM,48,-122,1,1,2
3388,SpokaneStBridge,05/22/2014 04:00:00 AM,48,-122,7,1,8
3389,SpokaneStBridge,05/22/2014 05:00:00 AM,48,-122,25,7,32
3390,SpokaneStBridge,05/22/2014 06:00:00 AM,48,-122,100,18,118
3391,SpokaneStBridge,05/22/2014 07:00:00 AM,48,-122,170,24,194
3392,SpokaneStBridge,05/22/2014 08:00:00 AM,48,-122,163,20,183
3393,SpokaneStBridge,05/22/2014 09:00:00 AM,48,-122,74,5,79
3394,SpokaneStBridge,05/22/2014 10:00:00 AM,48,-122,22,9,31
3395,SpokaneStBridge,05/22/2014 11:00:00 AM,48,-122,25,15,40
3396,SpokaneStBridge,05/22/2014 12:00:00 PM,48,-122,18,15,33
3397,SpokaneStBridge,05/22/2014 01:00:00 PM,48,-122,25,25,50
3398,SpokaneStBridge,05/22/2014 02:00:00 PM,48,-122,13,32,45
3399,SpokaneStBridge,05/22/2014 03:00:00 PM,48,-122,20,39,59
3400,SpokaneStBridge,05/22/2014 04:00:00 PM,48,-122,30,98,128
3401,SpokaneStBridge,05/22/2014 05:00:00 PM,48,-122,29,196,225
3402,SpokaneStBridge,05/22/2014 06:00:00 PM,48,-122,27,148,175
3403,SpokaneStBridge,05/22/2014 07:00:00 PM,48,-122,21,53,74
3404,SpokaneStBridge,05/22/2014 08:00:00 PM,48,-122,10,23,33
3405,SpokaneStBridge,05/22/2014 09:00:00 PM,48,-122,6,9,15
3406,SpokaneStBridge,05/22/2014 10:00:00 PM,48,-122,5,11,16
3407,SpokaneStBridge,05/22/2014 11:00:00 PM,48,-122,0,1,1
3408,SpokaneStBridge,05/23/2014 12:00:00 AM,48,-122,2,6,8
3409,SpokaneStBridge,05/23/2014 01:00:00 AM,48,-122,0,1,1
3410,SpokaneStBridge,05/23/2014 02:00:00 AM,48,-122,1,1,2
3411,SpokaneStBridge,05/23/2014 03:00:00 AM,48,-122,1,0,1
3412,SpokaneStBridge,05/23/2014 04:00:00 AM,48,-122,3,1,4
3413,SpokaneStBridge,05/23/2014 05:00:00 AM,48,-122,14,5,19
3414,SpokaneStBridge,05/23/2014 06:00:00 AM,48,-122,66,16,82
3415,SpokaneStBridge,05/23/2014 07:00:00 AM,48,-122,93,13,106
3416,SpokaneStBridge,05/23/2014 08:00:00 AM,48,-122,70,6,76
3417,SpokaneStBridge,05/23/2014 09:00:00 AM,48,-122,35,3,38
3418,SpokaneStBridge,05/23/2014 10:00:00 AM,48,-122,9,8,17
3419,SpokaneStBridge,05/23/2014 11:00:00 AM,48,-122,3,8,11
3420,SpokaneStBridge,05/23/2014 12:00:00 PM,48,-122,7,10,17
3421,SpokaneStBridge,05/23/2014 01:00:00 PM,48,-122,12,3,15
3422,SpokaneStBridge,05/23/2014 02:00:00 PM,48,-122,6,27,33
3423,SpokaneStBridge,05/23/2014 03:00:00 PM,48,-122,10,36,46
3424,SpokaneStBridge,05/23/2014 04:00:00 PM,48,-122,12,56,68
3425,SpokaneStBridge,05/23/2014 05:00:00 PM,48,-122,14,67,81
3426,SpokaneStBridge,05/23/2014 06:00:00 PM,48,-122,13,47,60
3427,SpokaneStBridge,05/23/2014 07:00:00 PM,48,-122,6,26,32
3428,SpokaneStBridge,05/23/2014 08:00:00 PM,48,-122,3,10,13
3429,SpokaneStBridge,05/23/2014 09:00:00 PM,48,-122,3,6,9
3430,SpokaneStBridge,05/23/2014 10:00:00 PM,48,-122,4,3,7
3431,SpokaneStBridge,05/23/2014 11:00:00 PM,48,-122,5,0,5
3432,SpokaneStBridge,05/24/2014 12:00:00 AM,48,-122,0,0,0
3433,SpokaneStBridge,05/24/2014 01:00:00 AM,48,-122,0,1,1
3434,SpokaneStBridge,05/24/2014 02:00:00 AM,48,-122,0,1,1
3435,SpokaneStBridge,05/24/2014 03:00:00 AM,48,-122,0,2,2
3436,SpokaneStBridge,05/24/2014 04:00:00 AM,48,-122,0,0,0
3437,SpokaneStBridge,05/24/2014 05:00:00 AM,48,-122,3,2,5
3438,SpokaneStBridge,05/24/2014 06:00:00 AM,48,-122,8,2,10
3439,SpokaneStBridge,05/24/2014 07:00:00 AM,48,-122,14,2,16
3440,SpokaneStBridge,05/24/2014 08:00:00 AM,48,-122,23,21,44
3441,SpokaneStBridge,05/24/2014 09:00:00 AM,48,-122,21,20,41
3442,SpokaneStBridge,05/24/2014 10:00:00 AM,48,-122,28,24,52
3443,SpokaneStBridge,05/24/2014 11:00:00 AM,48,-122,34,34,68
3444,SpokaneStBridge,05/24/2014 12:00:00 PM,48,-122,22,47,69
3445,SpokaneStBridge,05/24/2014 01:00:00 PM,48,-122,38,29,67
3446,SpokaneStBridge,05/24/2014 02:00:00 PM,48,-122,25,40,65
3447,SpokaneStBridge,05/24/2014 03:00:00 PM,48,-122,20,24,44
3448,SpokaneStBridge,05/24/2014 04:00:00 PM,48,-122,31,19,50
3449,SpokaneStBridge,05/24/2014 05:00:00 PM,48,-122,13,23,36
3450,SpokaneStBridge,05/24/2014 06:00:00 PM,48,-122,17,10,27
3451,SpokaneStBridge,05/24/2014 07:00:00 PM,48,-122,9,7,16
3452,SpokaneStBridge,05/24/2014 08:00:00 PM,48,-122,8,8,16
3453,SpokaneStBridge,05/24/2014 09:00:00 PM,48,-122,0,10,10
3454,SpokaneStBridge,05/24/2014 10:00:00 PM,48,-122,3,5,8
3455,SpokaneStBridge,05/24/2014 11:00:00 PM,48,-122,1,5,6
3456,SpokaneStBridge,05/25/2014 12:00:00 AM,48,-122,3,2,5
3457,SpokaneStBridge,05/25/2014 01:00:00 AM,48,-122,0,2,2
3458,SpokaneStBridge,05/25/2014 02:00:00 AM,48,-122,1,0,1
3459,SpokaneStBridge,05/25/2014 03:00:00 AM,48,-122,0,0,0
3460,SpokaneStBridge,05/25/2014 04:00:00 AM,48,-122,0,0,0
3461,SpokaneStBridge,05/25/2014 05:00:00 AM,48,-122,1,0,1
3462,SpokaneStBridge,05/25/2014 06:00:00 AM,48,-122,3,3,6
3463,SpokaneStBridge,05/25/2014 07:00:00 AM,48,-122,7,2,9
3464,SpokaneStBridge,05/25/2014 08:00:00 AM,48,-122,11,4,15
3465,SpokaneStBridge,05/25/2014 09:00:00 AM,48,-122,20,17,37
3466,SpokaneStBridge,05/25/2014 10:00:00 AM,48,-122,21,28,49
3467,SpokaneStBridge,05/25/2014 11:00:00 AM,48,-122,19,28,47
3468,SpokaneStBridge,05/25/2014 12:00:00 PM,48,-122,24,18,42
3469,SpokaneStBridge,05/25/2014 01:00:00 PM,48,-122,14,19,33
3470,SpokaneStBridge,05/25/2014 02:00:00 PM,48,-122,16,20,36
3471,SpokaneStBridge,05/25/2014 03:00:00 PM,48,-122,13,8,21
3472,SpokaneStBridge,05/25/2014 04:00:00 PM,48,-122,12,9,21
3473,SpokaneStBridge,05/25/2014 05:00:00 PM,48,-122,8,3,11
3474,SpokaneStBridge,05/25/2014 06:00:00 PM,48,-122,2,8,10
3475,SpokaneStBridge,05/25/2014 07:00:00 PM,48,-122,0,1,1
3476,SpokaneStBridge,05/25/2014 08:00:00 PM,48,-122,2,6,8
3477,SpokaneStBridge,05/25/2014 09:00:00 PM,48,-122,0,3,3
3478,SpokaneStBridge,05/25/2014 10:00:00 PM,48,-122,2,3,5
3479,SpokaneStBridge,05/25/2014 11:00:00 PM,48,-122,1,2,3
3480,SpokaneStBridge,05/26/2014 12:00:00 AM,48,-122,0,0,0
3481,SpokaneStBridge,05/26/2014 01:00:00 AM,48,-122,0,0,0
3482,SpokaneStBridge,05/26/2014 02:00:00 AM,48,-122,0,1,1
3483,SpokaneStBridge,05/26/2014 03:00:00 AM,48,-122,0,0,0
3484,SpokaneStBridge,05/26/2014 04:00:00 AM,48,-122,0,0,0
3485,SpokaneStBridge,05/26/2014 05:00:00 AM,48,-122,1,2,3
3486,SpokaneStBridge,05/26/2014 06:00:00 AM,48,-122,6,0,6
3487,SpokaneStBridge,05/26/2014 07:00:00 AM,48,-122,6,4,10
3488,SpokaneStBridge,05/26/2014 08:00:00 AM,48,-122,13,4,17
3489,SpokaneStBridge,05/26/2014 09:00:00 AM,48,-122,14,10,24
3490,SpokaneStBridge,05/26/2014 10:00:00 AM,48,-122,21,19,40
3491,SpokaneStBridge,05/26/2014 11:00:00 AM,48,-122,31,13,44
3492,SpokaneStBridge,05/26/2014 12:00:00 PM,48,-122,34,36,70
3493,SpokaneStBridge,05/26/2014 01:00:00 PM,48,-122,34,45,79
3494,SpokaneStBridge,05/26/2014 02:00:00 PM,48,-122,39,29,68
3495,SpokaneStBridge,05/26/2014 03:00:00 PM,48,-122,31,42,73
3496,SpokaneStBridge,05/26/2014 04:00:00 PM,48,-122,28,34,62
3497,SpokaneStBridge,05/26/2014 05:00:00 PM,48,-122,10,27,37
3498,SpokaneStBridge,05/26/2014 06:00:00 PM,48,-122,31,24,55
3499,SpokaneStBridge,05/26/2014 07:00:00 PM,48,-122,17,9,26
3500,SpokaneStBridge,05/26/2014 08:00:00 PM,48,-122,3,10,13
3501,SpokaneStBridge,05/26/2014 09:00:00 PM,48,-122,6,6,12
3502,SpokaneStBridge,05/26/2014 10:00:00 PM,48,-122,1,6,7
3503,SpokaneStBridge,05/26/2014 11:00:00 PM,48,-122,3,2,5
3504,SpokaneStBridge,05/27/2014 12:00:00 AM,48,-122,1,0,1
3505,SpokaneStBridge,05/27/2014 01:00:00 AM,48,-122,0,0,0
3506,SpokaneStBridge,05/27/2014 02:00:00 AM,48,-122,0,1,1
3507,SpokaneStBridge,05/27/2014 03:00:00 AM,48,-122,0,0,0
3508,SpokaneStBridge,05/27/2014 04:00:00 AM,48,-122,4,1,5
3509,SpokaneStBridge,05/27/2014 05:00:00 AM,48,-122,21,3,24
3510,SpokaneStBridge,05/27/2014 06:00:00 AM,48,-122,98,11,109
3511,SpokaneStBridge,05/27/2014 07:00:00 AM,48,-122,168,21,189
3512,SpokaneStBridge,05/27/2014 08:00:00 AM,48,-122,161,12,173
3513,SpokaneStBridge,05/27/2014 09:00:00 AM,48,-122,64,9,73
3514,SpokaneStBridge,05/27/2014 10:00:00 AM,48,-122,26,7,33
3515,SpokaneStBridge,05/27/2014 11:00:00 AM,48,-122,13,10,23
3516,SpokaneStBridge,05/27/2014 12:00:00 PM,48,-122,14,16,30
3517,SpokaneStBridge,05/27/2014 01:00:00 PM,48,-122,15,17,32
3518,SpokaneStBridge,05/27/2014 02:00:00 PM,48,-122,17,25,42
3519,SpokaneStBridge,05/27/2014 03:00:00 PM,48,-122,13,46,59
3520,SpokaneStBridge,05/27/2014 04:00:00 PM,48,-122,21,86,107
3521,SpokaneStBridge,05/27/2014 05:00:00 PM,48,-122,45,221,266
3522,SpokaneStBridge,05/27/2014 06:00:00 PM,48,-122,30,127,157
3523,SpokaneStBridge,05/27/2014 07:00:00 PM,48,-122,15,61,76
3524,SpokaneStBridge,05/27/2014 08:00:00 PM,48,-122,27,23,50
3525,SpokaneStBridge,05/27/2014 09:00:00 PM,48,-122,4,12,16
3526,SpokaneStBridge,05/27/2014 10:00:00 PM,48,-122,2,9,11
3527,SpokaneStBridge,05/27/2014 11:00:00 PM,48,-122,1,4,5
3528,SpokaneStBridge,05/28/2014 12:00:00 AM,48,-122,1,4,5
3529,SpokaneStBridge,05/28/2014 01:00:00 AM,48,-122,0,1,1
3530,SpokaneStBridge,05/28/2014 02:00:00 AM,48,-122,1,0,1
3531,SpokaneStBridge,05/28/2014 03:00:00 AM,48,-122,1,0,1
3532,SpokaneStBridge,05/28/2014 04:00:00 AM,48,-122,2,3,5
3533,SpokaneStBridge,05/28/2014 05:00:00 AM,48,-122,12,4,16
3534,SpokaneStBridge,05/28/2014 06:00:00 AM,48,-122,74,12,86
3535,SpokaneStBridge,05/28/2014 07:00:00 AM,48,-122,110,22,132
3536,SpokaneStBridge,05/28/2014 08:00:00 AM,48,-122,116,9,125
3537,SpokaneStBridge,05/28/2014 09:00:00 AM,48,-122,47,4,51
3538,SpokaneStBridge,05/28/2014 10:00:00 AM,48,-122,18,9,27
3539,SpokaneStBridge,05/28/2014 11:00:00 AM,48,-122,10,17,27
3540,SpokaneStBridge,05/28/2014 12:00:00 PM,48,-122,18,8,26
3541,SpokaneStBridge,05/28/2014 01:00:00 PM,48,-122,32,8,40
3542,SpokaneStBridge,05/28/2014 02:00:00 PM,48,-122,16,15,31
3543,SpokaneStBridge,05/28/2014 03:00:00 PM,48,-122,15,38,53
3544,SpokaneStBridge,05/28/2014 04:00:00 PM,48,-122,19,85,104
3545,SpokaneStBridge,05/28/2014 05:00:00 PM,48,-122,22,110,132
3546,SpokaneStBridge,05/28/2014 06:00:00 PM,48,-122,18,89,107
3547,SpokaneStBridge,05/28/2014 07:00:00 PM,48,-122,5,30,35
3548,SpokaneStBridge,05/28/2014 08:00:00 PM,48,-122,6,18,24
3549,SpokaneStBridge,05/28/2014 09:00:00 PM,48,-122,6,9,15
3550,SpokaneStBridge,05/28/2014 10:00:00 PM,48,-122,3,8,11
3551,SpokaneStBridge,05/28/2014 11:00:00 PM,48,-122,2,4,6
3552,SpokaneStBridge,05/29/2014 12:00:00 AM,48,-122,0,1,1
3553,SpokaneStBridge,05/29/2014 01:00:00 AM,48,-122,0,3,3
3554,SpokaneStBridge,05/29/2014 02:00:00 AM,48,-122,0,0,0
3555,SpokaneStBridge,05/29/2014 03:00:00 AM,48,-122,0,0,0
3556,SpokaneStBridge,05/29/2014 04:00:00 AM,48,-122,3,0,3
3557,SpokaneStBridge,05/29/2014 05:00:00 AM,48,-122,35,4,39
3558,SpokaneStBridge,05/29/2014 06:00:00 AM,48,-122,94,14,108
3559,SpokaneStBridge,05/29/2014 07:00:00 AM,48,-122,148,17,165
3560,SpokaneStBridge,05/29/2014 08:00:00 AM,48,-122,127,15,142
3561,SpokaneStBridge,05/29/2014 09:00:00 AM,48,-122,71,10,81
3562,SpokaneStBridge,05/29/2014 10:00:00 AM,48,-122,19,11,30
3563,SpokaneStBridge,05/29/2014 11:00:00 AM,48,-122,13,14,27
3564,SpokaneStBridge,05/29/2014 12:00:00 PM,48,-122,25,13,38
3565,SpokaneStBridge,05/29/2014 01:00:00 PM,48,-122,20,15,35
3566,SpokaneStBridge,05/29/2014 02:00:00 PM,48,-122,20,11,31
3567,SpokaneStBridge,05/29/2014 03:00:00 PM,48,-122,16,44,60
3568,SpokaneStBridge,05/29/2014 04:00:00 PM,48,-122,22,91,113
3569,SpokaneStBridge,05/29/2014 05:00:00 PM,48,-122,42,165,207
3570,SpokaneStBridge,05/29/2014 06:00:00 PM,48,-122,22,132,154
3571,SpokaneStBridge,05/29/2014 07:00:00 PM,48,-122,11,39,50
3572,SpokaneStBridge,05/29/2014 08:00:00 PM,48,-122,7,22,29
3573,SpokaneStBridge,05/29/2014 09:00:00 PM,48,-122,5,20,25
3574,SpokaneStBridge,05/29/2014 10:00:00 PM,48,-122,2,6,8
3575,SpokaneStBridge,05/29/2014 11:00:00 PM,48,-122,0,4,4
3576,SpokaneStBridge,05/30/2014 12:00:00 AM,48,-122,0,4,4
3577,SpokaneStBridge,05/30/2014 01:00:00 AM,48,-122,0,4,4
3578,SpokaneStBridge,05/30/2014 02:00:00 AM,48,-122,1,3,4
3579,SpokaneStBridge,05/30/2014 03:00:00 AM,48,-122,0,0,0
3580,SpokaneStBridge,05/30/2014 04:00:00 AM,48,-122,3,0,3
3581,SpokaneStBridge,05/30/2014 05:00:00 AM,48,-122,29,5,34
3582,SpokaneStBridge,05/30/2014 06:00:00 AM,48,-122,69,23,92
3583,SpokaneStBridge,05/30/2014 07:00:00 AM,48,-122,171,20,191
3584,SpokaneStBridge,05/30/2014 08:00:00 AM,48,-122,163,10,173
3585,SpokaneStBridge,05/30/2014 09:00:00 AM,48,-122,65,7,72
3586,SpokaneStBridge,05/30/2014 10:00:00 AM,48,-122,19,12,31
3587,SpokaneStBridge,05/30/2014 11:00:00 AM,48,-122,18,14,32
3588,SpokaneStBridge,05/30/2014 12:00:00 PM,48,-122,17,20,37
3589,SpokaneStBridge,05/30/2014 01:00:00 PM,48,-122,19,19,38
3590,SpokaneStBridge,05/30/2014 02:00:00 PM,48,-122,19,33,52
3591,SpokaneStBridge,05/30/2014 03:00:00 PM,48,-122,20,44,64
3592,SpokaneStBridge,05/30/2014 04:00:00 PM,48,-122,32,111,143
3593,SpokaneStBridge,05/30/2014 05:00:00 PM,48,-122,27,176,203
3594,SpokaneStBridge,05/30/2014 06:00:00 PM,48,-122,24,144,168
3595,SpokaneStBridge,05/30/2014 07:00:00 PM,48,-122,12,50,62
3596,SpokaneStBridge,05/30/2014 08:00:00 PM,48,-122,11,15,26
3597,SpokaneStBridge,05/30/2014 09:00:00 PM,48,-122,5,5,10
3598,SpokaneStBridge,05/30/2014 10:00:00 PM,48,-122,18,11,29
3599,SpokaneStBridge,05/30/2014 11:00:00 PM,48,-122,3,2,5
3600,SpokaneStBridge,05/31/2014 12:00:00 AM,48,-122,2,0,2
3601,SpokaneStBridge,05/31/2014 01:00:00 AM,48,-122,4,4,8
3602,SpokaneStBridge,05/31/2014 02:00:00 AM,48,-122,1,3,4
3603,SpokaneStBridge,05/31/2014 03:00:00 AM,48,-122,0,1,1
3604,SpokaneStBridge,05/31/2014 04:00:00 AM,48,-122,0,0,0
3605,SpokaneStBridge,05/31/2014 05:00:00 AM,48,-122,3,0,3
3606,SpokaneStBridge,05/31/2014 06:00:00 AM,48,-122,15,6,21
3607,SpokaneStBridge,05/31/2014 07:00:00 AM,48,-122,19,9,28
3608,SpokaneStBridge,05/31/2014 08:00:00 AM,48,-122,33,13,46
3609,SpokaneStBridge,05/31/2014 09:00:00 AM,48,-122,33,32,65
3610,SpokaneStBridge,05/31/2014 10:00:00 AM,48,-122,36,35,71
3611,SpokaneStBridge,05/31/2014 11:00:00 AM,48,-122,51,49,100
3612,SpokaneStBridge,05/31/2014 12:00:00 PM,48,-122,73,50,123
3613,SpokaneStBridge,05/31/2014 01:00:00 PM,48,-122,36,42,78
3614,SpokaneStBridge,05/31/2014 02:00:00 PM,48,-122,50,58,108
3615,SpokaneStBridge,05/31/2014 03:00:00 PM,48,-122,41,68,109
3616,SpokaneStBridge,05/31/2014 04:00:00 PM,48,-122,42,42,84
3617,SpokaneStBridge,05/31/2014 05:00:00 PM,48,-122,46,39,85
3618,SpokaneStBridge,05/31/2014 06:00:00 PM,48,-122,13,36,49
3619,SpokaneStBridge,05/31/2014 07:00:00 PM,48,-122,28,17,45
3620,SpokaneStBridge,05/31/2014 08:00:00 PM,48,-122,21,17,38
3621,SpokaneStBridge,05/31/2014 09:00:00 PM,48,-122,6,14,20
3622,SpokaneStBridge,05/31/2014 10:00:00 PM,48,-122,6,3,9
3623,SpokaneStBridge,05/31/2014 11:00:00 PM,48,-122,4,3,7
3624,SpokaneStBridge,06/01/2014 12:00:00 AM,48,-122,4,6,10
3625,SpokaneStBridge,06/01/2014 01:00:00 AM,48,-122,0,1,1
3626,SpokaneStBridge,06/01/2014 02:00:00 AM,48,-122,1,2,3
3627,SpokaneStBridge,06/01/2014 03:00:00 AM,48,-122,0,0,0
3628,SpokaneStBridge,06/01/2014 04:00:00 AM,48,-122,2,2,4
3629,SpokaneStBridge,06/01/2014 05:00:00 AM,48,-122,2,0,2
3630,SpokaneStBridge,06/01/2014 06:00:00 AM,48,-122,12,6,18
3631,SpokaneStBridge,06/01/2014 07:00:00 AM,48,-122,12,9,21
3632,SpokaneStBridge,06/01/2014 08:00:00 AM,48,-122,22,19,41
3633,SpokaneStBridge,06/01/2014 09:00:00 AM,48,-122,13,22,35
3634,SpokaneStBridge,06/01/2014 10:00:00 AM,48,-122,27,31,58
3635,SpokaneStBridge,06/01/2014 11:00:00 AM,48,-122,38,37,75
3636,SpokaneStBridge,06/01/2014 12:00:00 PM,48,-122,40,35,75
3637,SpokaneStBridge,06/01/2014 01:00:00 PM,48,-122,34,34,68
3638,SpokaneStBridge,06/01/2014 02:00:00 PM,48,-122,50,46,96
3639,SpokaneStBridge,06/01/2014 03:00:00 PM,48,-122,35,40,75
3640,SpokaneStBridge,06/01/2014 04:00:00 PM,48,-122,35,45,80
3641,SpokaneStBridge,06/01/2014 05:00:00 PM,48,-122,37,36,73
3642,SpokaneStBridge,06/01/2014 06:00:00 PM,48,-122,26,17,43
3643,SpokaneStBridge,06/01/2014 07:00:00 PM,48,-122,17,15,32
3644,SpokaneStBridge,06/01/2014 08:00:00 PM,48,-122,10,7,17
3645,SpokaneStBridge,06/01/2014 09:00:00 PM,48,-122,3,5,8
3646,SpokaneStBridge,06/01/2014 10:00:00 PM,48,-122,4,2,6
3647,SpokaneStBridge,06/01/2014 11:00:00 PM,48,-122,3,0,3
3648,SpokaneStBridge,06/02/2014 12:00:00 AM,48,-122,0,3,3
3649,SpokaneStBridge,06/02/2014 01:00:00 AM,48,-122,0,0,0
3650,SpokaneStBridge,06/02/2014 02:00:00 AM,48,-122,0,2,2
3651,SpokaneStBridge,06/02/2014 03:00:00 AM,48,-122,1,0,1
3652,SpokaneStBridge,06/02/2014 04:00:00 AM,48,-122,3,1,4
3653,SpokaneStBridge,06/02/2014 05:00:00 AM,48,-122,27,8,35
3654,SpokaneStBridge,06/02/2014 06:00:00 AM,48,-122,77,11,88
3655,SpokaneStBridge,06/02/2014 07:00:00 AM,48,-122,154,19,173
3656,SpokaneStBridge,06/02/2014 08:00:00 AM,48,-122,133,14,147
3657,SpokaneStBridge,06/02/2014 09:00:00 AM,48,-122,61,5,66
3658,SpokaneStBridge,06/02/2014 10:00:00 AM,48,-122,21,8,29
3659,SpokaneStBridge,06/02/2014 11:00:00 AM,48,-122,14,6,20
3660,SpokaneStBridge,06/02/2014 12:00:00 PM,48,-122,15,24,39
3661,SpokaneStBridge,06/02/2014 01:00:00 PM,48,-122,17,16,33
3662,SpokaneStBridge,06/02/2014 02:00:00 PM,48,-122,15,21,36
3663,SpokaneStBridge,06/02/2014 03:00:00 PM,48,-122,15,49,64
3664,SpokaneStBridge,06/02/2014 04:00:00 PM,48,-122,31,91,122
3665,SpokaneStBridge,06/02/2014 05:00:00 PM,48,-122,36,162,198
3666,SpokaneStBridge,06/02/2014 06:00:00 PM,48,-122,21,122,143
3667,SpokaneStBridge,06/02/2014 07:00:00 PM,48,-122,12,56,68
3668,SpokaneStBridge,06/02/2014 08:00:00 PM,48,-122,20,21,41
3669,SpokaneStBridge,06/02/2014 09:00:00 PM,48,-122,10,13,23
3670,SpokaneStBridge,06/02/2014 10:00:00 PM,48,-122,4,2,6
3671,SpokaneStBridge,06/02/2014 11:00:00 PM,48,-122,0,6,6
3672,SpokaneStBridge,06/03/2014 12:00:00 AM,48,-122,1,3,4
3673,SpokaneStBridge,06/03/2014 01:00:00 AM,48,-122,1,0,1
3674,SpokaneStBridge,06/03/2014 02:00:00 AM,48,-122,2,0,2
3675,SpokaneStBridge,06/03/2014 03:00:00 AM,48,-122,0,0,0
3676,SpokaneStBridge,06/03/2014 04:00:00 AM,48,-122,3,1,4
3677,SpokaneStBridge,06/03/2014 05:00:00 AM,48,-122,33,4,37
3678,SpokaneStBridge,06/03/2014 06:00:00 AM,48,-122,96,14,110
3679,SpokaneStBridge,06/03/2014 07:00:00 AM,48,-122,158,21,179
3680,SpokaneStBridge,06/03/2014 08:00:00 AM,48,-122,154,16,170
3681,SpokaneStBridge,06/03/2014 09:00:00 AM,48,-122,58,12,70
3682,SpokaneStBridge,06/03/2014 10:00:00 AM,48,-122,25,6,31
3683,SpokaneStBridge,06/03/2014 11:00:00 AM,48,-122,15,6,21
3684,SpokaneStBridge,06/03/2014 12:00:00 PM,48,-122,8,12,20
3685,SpokaneStBridge,06/03/2014 01:00:00 PM,48,-122,13,11,24
3686,SpokaneStBridge,06/03/2014 02:00:00 PM,48,-122,12,22,34
3687,SpokaneStBridge,06/03/2014 03:00:00 PM,48,-122,10,42,52
3688,SpokaneStBridge,06/03/2014 04:00:00 PM,48,-122,26,97,123
3689,SpokaneStBridge,06/03/2014 05:00:00 PM,48,-122,33,191,224
3690,SpokaneStBridge,06/03/2014 06:00:00 PM,48,-122,29,113,142
3691,SpokaneStBridge,06/03/2014 07:00:00 PM,48,-122,18,73,91
3692,SpokaneStBridge,06/03/2014 08:00:00 PM,48,-122,6,18,24
3693,SpokaneStBridge,06/03/2014 09:00:00 PM,48,-122,12,5,17
3694,SpokaneStBridge,06/03/2014 10:00:00 PM,48,-122,20,10,30
3695,SpokaneStBridge,06/03/2014 11:00:00 PM,48,-122,3,3,6
3696,SpokaneStBridge,06/04/2014 12:00:00 AM,48,-122,0,2,2
3697,SpokaneStBridge,06/04/2014 01:00:00 AM,48,-122,1,0,1
3698,SpokaneStBridge,06/04/2014 02:00:00 AM,48,-122,0,0,0
3699,SpokaneStBridge,06/04/2014 03:00:00 AM,48,-122,0,2,2
3700,SpokaneStBridge,06/04/2014 04:00:00 AM,48,-122,4,1,5
3701,SpokaneStBridge,06/04/2014 05:00:00 AM,48,-122,17,4,21
3702,SpokaneStBridge,06/04/2014 06:00:00 AM,48,-122,91,19,110
3703,SpokaneStBridge,06/04/2014 07:00:00 AM,48,-122,156,26,182
3704,SpokaneStBridge,06/04/2014 08:00:00 AM,48,-122,131,8,139
3705,SpokaneStBridge,06/04/2014 09:00:00 AM,48,-122,62,9,71
3706,SpokaneStBridge,06/04/2014 10:00:00 AM,48,-122,26,12,38
3707,SpokaneStBridge,06/04/2014 11:00:00 AM,48,-122,16,9,25
3708,SpokaneStBridge,06/04/2014 12:00:00 PM,48,-122,16,14,30
3709,SpokaneStBridge,06/04/2014 01:00:00 PM,48,-122,14,13,27
3710,SpokaneStBridge,06/04/2014 02:00:00 PM,48,-122,23,17,40
3711,SpokaneStBridge,06/04/2014 03:00:00 PM,48,-122,12,48,60
3712,SpokaneStBridge,06/04/2014 04:00:00 PM,48,-122,28,98,126
3713,SpokaneStBridge,06/04/2014 05:00:00 PM,48,-122,43,160,203
3714,SpokaneStBridge,06/04/2014 06:00:00 PM,48,-122,15,110,125
3715,SpokaneStBridge,06/04/2014 07:00:00 PM,48,-122,24,57,81
3716,SpokaneStBridge,06/04/2014 08:00:00 PM,48,-122,12,38,50
3717,SpokaneStBridge,06/04/2014 09:00:00 PM,48,-122,12,16,28
3718,SpokaneStBridge,06/04/2014 10:00:00 PM,48,-122,10,11,21
3719,SpokaneStBridge,06/04/2014 11:00:00 PM,48,-122,1,4,5
3720,SpokaneStBridge,06/05/2014 12:00:00 AM,48,-122,3,4,7
3721,SpokaneStBridge,06/05/2014 01:00:00 AM,48,-122,0,0,0
3722,SpokaneStBridge,06/05/2014 02:00:00 AM,48,-122,0,0,0
3723,SpokaneStBridge,06/05/2014 03:00:00 AM,48,-122,1,2,3
3724,SpokaneStBridge,06/05/2014 04:00:00 AM,48,-122,4,1,5
3725,SpokaneStBridge,06/05/2014 05:00:00 AM,48,-122,31,7,38
3726,SpokaneStBridge,06/05/2014 06:00:00 AM,48,-122,91,16,107
3727,SpokaneStBridge,06/05/2014 07:00:00 AM,48,-122,143,22,165
3728,SpokaneStBridge,06/05/2014 08:00:00 AM,48,-122,107,18,125
3729,SpokaneStBridge,06/05/2014 09:00:00 AM,48,-122,69,11,80
3730,SpokaneStBridge,06/05/2014 10:00:00 AM,48,-122,24,6,30
3731,SpokaneStBridge,06/05/2014 11:00:00 AM,48,-122,17,8,25
3732,SpokaneStBridge,06/05/2014 12:00:00 PM,48,-122,17,18,35
3733,SpokaneStBridge,06/05/2014 01:00:00 PM,48,-122,20,17,37
3734,SpokaneStBridge,06/05/2014 02:00:00 PM,48,-122,17,25,42
3735,SpokaneStBridge,06/05/2014 03:00:00 PM,48,-122,16,42,58
3736,SpokaneStBridge,06/05/2014 04:00:00 PM,48,-122,28,87,115
3737,SpokaneStBridge,06/05/2014 05:00:00 PM,48,-122,31,170,201
3738,SpokaneStBridge,06/05/2014 06:00:00 PM,48,-122,22,115,137
3739,SpokaneStBridge,06/05/2014 07:00:00 PM,48,-122,11,74,85
3740,SpokaneStBridge,06/05/2014 08:00:00 PM,48,-122,24,34,58
3741,SpokaneStBridge,06/05/2014 09:00:00 PM,48,-122,5,18,23
3742,SpokaneStBridge,06/05/2014 10:00:00 PM,48,-122,7,4,11
3743,SpokaneStBridge,06/05/2014 11:00:00 PM,48,-122,7,10,17
3744,SpokaneStBridge,06/06/2014 12:00:00 AM,48,-122,1,6,7
3745,SpokaneStBridge,06/06/2014 01:00:00 AM,48,-122,0,3,3
3746,SpokaneStBridge,06/06/2014 02:00:00 AM,48,-122,0,1,1
3747,SpokaneStBridge,06/06/2014 03:00:00 AM,48,-122,1,0,1
3748,SpokaneStBridge,06/06/2014 04:00:00 AM,48,-122,5,1,6
3749,SpokaneStBridge,06/06/2014 05:00:00 AM,48,-122,34,1,35
3750,SpokaneStBridge,06/06/2014 06:00:00 AM,48,-122,63,10,73
3751,SpokaneStBridge,06/06/2014 07:00:00 AM,48,-122,119,27,146
3752,SpokaneStBridge,06/06/2014 08:00:00 AM,48,-122,117,10,127
3753,SpokaneStBridge,06/06/2014 09:00:00 AM,48,-122,51,9,60
3754,SpokaneStBridge,06/06/2014 10:00:00 AM,48,-122,26,11,37
3755,SpokaneStBridge,06/06/2014 11:00:00 AM,48,-122,21,15,36
3756,SpokaneStBridge,06/06/2014 12:00:00 PM,48,-122,13,21,34
3757,SpokaneStBridge,06/06/2014 01:00:00 PM,48,-122,22,23,45
3758,SpokaneStBridge,06/06/2014 02:00:00 PM,48,-122,21,22,43
3759,SpokaneStBridge,06/06/2014 03:00:00 PM,48,-122,14,34,48
3760,SpokaneStBridge,06/06/2014 04:00:00 PM,48,-122,33,99,132
3761,SpokaneStBridge,06/06/2014 05:00:00 PM,48,-122,35,139,174
3762,SpokaneStBridge,06/06/2014 06:00:00 PM,48,-122,19,81,100
3763,SpokaneStBridge,06/06/2014 07:00:00 PM,48,-122,20,36,56
3764,SpokaneStBridge,06/06/2014 08:00:00 PM,48,-122,12,23,35
3765,SpokaneStBridge,06/06/2014 09:00:00 PM,48,-122,9,11,20
3766,SpokaneStBridge,06/06/2014 10:00:00 PM,48,-122,1,6,7
3767,SpokaneStBridge,06/06/2014 11:00:00 PM,48,-122,1,9,10
3768,SpokaneStBridge,06/07/2014 12:00:00 AM,48,-122,5,4,9
3769,SpokaneStBridge,06/07/2014 01:00:00 AM,48,-122,0,2,2
3770,SpokaneStBridge,06/07/2014 02:00:00 AM,48,-122,1,2,3
3771,SpokaneStBridge,06/07/2014 03:00:00 AM,48,-122,0,2,2
3772,SpokaneStBridge,06/07/2014 04:00:00 AM,48,-122,0,1,1
3773,SpokaneStBridge,06/07/2014 05:00:00 AM,48,-122,3,1,4
3774,SpokaneStBridge,06/07/2014 06:00:00 AM,48,-122,5,7,12
3775,SpokaneStBridge,06/07/2014 07:00:00 AM,48,-122,29,6,35
3776,SpokaneStBridge,06/07/2014 08:00:00 AM,48,-122,32,19,51
3777,SpokaneStBridge,06/07/2014 09:00:00 AM,48,-122,34,32,66
3778,SpokaneStBridge,06/07/2014 10:00:00 AM,48,-122,34,33,67
3779,SpokaneStBridge,06/07/2014 11:00:00 AM,48,-122,31,41,72
3780,SpokaneStBridge,06/07/2014 12:00:00 PM,48,-122,38,36,74
3781,SpokaneStBridge,06/07/2014 01:00:00 PM,48,-122,58,53,111
3782,SpokaneStBridge,06/07/2014 02:00:00 PM,48,-122,41,48,89
3783,SpokaneStBridge,06/07/2014 03:00:00 PM,48,-122,36,57,93
3784,SpokaneStBridge,06/07/2014 04:00:00 PM,48,-122,55,49,104
3785,SpokaneStBridge,06/07/2014 05:00:00 PM,48,-122,25,54,79
3786,SpokaneStBridge,06/07/2014 06:00:00 PM,48,-122,23,15,38
3787,SpokaneStBridge,06/07/2014 07:00:00 PM,48,-122,16,10,26
3788,SpokaneStBridge,06/07/2014 08:00:00 PM,48,-122,16,20,36
3789,SpokaneStBridge,06/07/2014 09:00:00 PM,48,-122,7,12,19
3790,SpokaneStBridge,06/07/2014 10:00:00 PM,48,-122,7,5,12
3791,SpokaneStBridge,06/07/2014 11:00:00 PM,48,-122,1,3,4
3792,SpokaneStBridge,06/08/2014 12:00:00 AM,48,-122,12,0,12
3793,SpokaneStBridge,06/08/2014 01:00:00 AM,48,-122,1,4,5
3794,SpokaneStBridge,06/08/2014 02:00:00 AM,48,-122,3,3,6
3795,SpokaneStBridge,06/08/2014 03:00:00 AM,48,-122,0,2,2
3796,SpokaneStBridge,06/08/2014 04:00:00 AM,48,-122,1,1,2
3797,SpokaneStBridge,06/08/2014 05:00:00 AM,48,-122,6,4,10
3798,SpokaneStBridge,06/08/2014 06:00:00 AM,48,-122,4,3,7
3799,SpokaneStBridge,06/08/2014 07:00:00 AM,48,-122,11,11,22
3800,SpokaneStBridge,06/08/2014 08:00:00 AM,48,-122,39,10,49
3801,SpokaneStBridge,06/08/2014 09:00:00 AM,48,-122,18,22,40
3802,SpokaneStBridge,06/08/2014 10:00:00 AM,48,-122,40,29,69
3803,SpokaneStBridge,06/08/2014 11:00:00 AM,48,-122,29,40,69
3804,SpokaneStBridge,06/08/2014 12:00:00 PM,48,-122,31,25,56
3805,SpokaneStBridge,06/08/2014 01:00:00 PM,48,-122,38,39,77
3806,SpokaneStBridge,06/08/2014 02:00:00 PM,48,-122,29,39,68
3807,SpokaneStBridge,06/08/2014 03:00:00 PM,48,-122,33,36,69
3808,SpokaneStBridge,06/08/2014 04:00:00 PM,48,-122,48,42,90
3809,SpokaneStBridge,06/08/2014 05:00:00 PM,48,-122,12,28,40
3810,SpokaneStBridge,06/08/2014 06:00:00 PM,48,-122,20,16,36
3811,SpokaneStBridge,06/08/2014 07:00:00 PM,48,-122,12,16,28
3812,SpokaneStBridge,06/08/2014 08:00:00 PM,48,-122,10,10,20
3813,SpokaneStBridge,06/08/2014 09:00:00 PM,48,-122,2,4,6
3814,SpokaneStBridge,06/08/2014 10:00:00 PM,48,-122,1,7,8
3815,SpokaneStBridge,06/08/2014 11:00:00 PM,48,-122,5,3,8
3816,SpokaneStBridge,06/09/2014 12:00:00 AM,48,-122,2,1,3
3817,SpokaneStBridge,06/09/2014 01:00:00 AM,48,-122,0,0,0
3818,SpokaneStBridge,06/09/2014 02:00:00 AM,48,-122,0,0,0
3819,SpokaneStBridge,06/09/2014 03:00:00 AM,48,-122,0,1,1
3820,SpokaneStBridge,06/09/2014 04:00:00 AM,48,-122,4,0,4
3821,SpokaneStBridge,06/09/2014 05:00:00 AM,48,-122,21,4,25
3822,SpokaneStBridge,06/09/2014 06:00:00 AM,48,-122,72,8,80
3823,SpokaneStBridge,06/09/2014 07:00:00 AM,48,-122,127,17,144
3824,SpokaneStBridge,06/09/2014 08:00:00 AM,48,-122,116,14,130
3825,SpokaneStBridge,06/09/2014 09:00:00 AM,48,-122,57,6,63
3826,SpokaneStBridge,06/09/2014 10:00:00 AM,48,-122,28,4,32
3827,SpokaneStBridge,06/09/2014 11:00:00 AM,48,-122,20,11,31
3828,SpokaneStBridge,06/09/2014 12:00:00 PM,48,-122,9,8,17
3829,SpokaneStBridge,06/09/2014 01:00:00 PM,48,-122,6,8,14
3830,SpokaneStBridge,06/09/2014 02:00:00 PM,48,-122,11,30,41
3831,SpokaneStBridge,06/09/2014 03:00:00 PM,48,-122,13,30,43
3832,SpokaneStBridge,06/09/2014 04:00:00 PM,48,-122,20,81,101
3833,SpokaneStBridge,06/09/2014 05:00:00 PM,48,-122,29,172,201
3834,SpokaneStBridge,06/09/2014 06:00:00 PM,48,-122,18,108,126
3835,SpokaneStBridge,06/09/2014 07:00:00 PM,48,-122,17,32,49
3836,SpokaneStBridge,06/09/2014 08:00:00 PM,48,-122,10,25,35
3837,SpokaneStBridge,06/09/2014 09:00:00 PM,48,-122,6,10,16
3838,SpokaneStBridge,06/09/2014 10:00:00 PM,48,-122,5,8,13
3839,SpokaneStBridge,06/09/2014 11:00:00 PM,48,-122,1,3,4
3840,SpokaneStBridge,06/10/2014 12:00:00 AM,48,-122,1,2,3
3841,SpokaneStBridge,06/10/2014 01:00:00 AM,48,-122,0,0,0
3842,SpokaneStBridge,06/10/2014 02:00:00 AM,48,-122,0,1,1
3843,SpokaneStBridge,06/10/2014 03:00:00 AM,48,-122,2,0,2
3844,SpokaneStBridge,06/10/2014 04:00:00 AM,48,-122,2,1,3
3845,SpokaneStBridge,06/10/2014 05:00:00 AM,48,-122,32,5,37
3846,SpokaneStBridge,06/10/2014 06:00:00 AM,48,-122,76,19,95
3847,SpokaneStBridge,06/10/2014 07:00:00 AM,48,-122,153,18,171
3848,SpokaneStBridge,06/10/2014 08:00:00 AM,48,-122,129,14,143
3849,SpokaneStBridge,06/10/2014 09:00:00 AM,48,-122,58,5,63
3850,SpokaneStBridge,06/10/2014 10:00:00 AM,48,-122,21,7,28
3851,SpokaneStBridge,06/10/2014 11:00:00 AM,48,-122,14,7,21
3852,SpokaneStBridge,06/10/2014 12:00:00 PM,48,-122,18,14,32
3853,SpokaneStBridge,06/10/2014 01:00:00 PM,48,-122,13,8,21
3854,SpokaneStBridge,06/10/2014 02:00:00 PM,48,-122,16,17,33
3855,SpokaneStBridge,06/10/2014 03:00:00 PM,48,-122,19,38,57
3856,SpokaneStBridge,06/10/2014 04:00:00 PM,48,-122,25,86,111
3857,SpokaneStBridge,06/10/2014 05:00:00 PM,48,-122,31,178,209
3858,SpokaneStBridge,06/10/2014 06:00:00 PM,48,-122,27,116,143
3859,SpokaneStBridge,06/10/2014 07:00:00 PM,48,-122,10,36,46
3860,SpokaneStBridge,06/10/2014 08:00:00 PM,48,-122,10,22,32
3861,SpokaneStBridge,06/10/2014 09:00:00 PM,48,-122,3,19,22
3862,SpokaneStBridge,06/10/2014 10:00:00 PM,48,-122,4,14,18
3863,SpokaneStBridge,06/10/2014 11:00:00 PM,48,-122,1,2,3
3864,SpokaneStBridge,06/11/2014 12:00:00 AM,48,-122,0,3,3
3865,SpokaneStBridge,06/11/2014 01:00:00 AM,48,-122,0,1,1
3866,SpokaneStBridge,06/11/2014 02:00:00 AM,48,-122,0,0,0
3867,SpokaneStBridge,06/11/2014 03:00:00 AM,48,-122,0,1,1
3868,SpokaneStBridge,06/11/2014 04:00:00 AM,48,-122,4,2,6
3869,SpokaneStBridge,06/11/2014 05:00:00 AM,48,-122,30,4,34
3870,SpokaneStBridge,06/11/2014 06:00:00 AM,48,-122,86,17,103
3871,SpokaneStBridge,06/11/2014 07:00:00 AM,48,-122,152,18,170
3872,SpokaneStBridge,06/11/2014 08:00:00 AM,48,-122,135,13,148
3873,SpokaneStBridge,06/11/2014 09:00:00 AM,48,-122,80,10,90
3874,SpokaneStBridge,06/11/2014 10:00:00 AM,48,-122,25,9,34
3875,SpokaneStBridge,06/11/2014 11:00:00 AM,48,-122,14,8,22
3876,SpokaneStBridge,06/11/2014 12:00:00 PM,48,-122,17,17,34
3877,SpokaneStBridge,06/11/2014 01:00:00 PM,48,-122,20,19,39
3878,SpokaneStBridge,06/11/2014 02:00:00 PM,48,-122,20,30,50
3879,SpokaneStBridge,06/11/2014 03:00:00 PM,48,-122,28,61,89
3880,SpokaneStBridge,06/11/2014 04:00:00 PM,48,-122,27,107,134
3881,SpokaneStBridge,06/11/2014 05:00:00 PM,48,-122,47,172,219
3882,SpokaneStBridge,06/11/2014 06:00:00 PM,48,-122,30,122,152
3883,SpokaneStBridge,06/11/2014 07:00:00 PM,48,-122,15,60,75
3884,SpokaneStBridge,06/11/2014 08:00:00 PM,48,-122,12,29,41
3885,SpokaneStBridge,06/11/2014 09:00:00 PM,48,-122,10,13,23
3886,SpokaneStBridge,06/11/2014 10:00:00 PM,48,-122,6,14,20
3887,SpokaneStBridge,06/11/2014 11:00:00 PM,48,-122,0,4,4
3888,SpokaneStBridge,06/12/2014 12:00:00 AM,48,-122,1,4,5
3889,SpokaneStBridge,06/12/2014 01:00:00 AM,48,-122,0,1,1
3890,SpokaneStBridge,06/12/2014 02:00:00 AM,48,-122,0,0,0
3891,SpokaneStBridge,06/12/2014 03:00:00 AM,48,-122,0,1,1
3892,SpokaneStBridge,06/12/2014 04:00:00 AM,48,-122,4,1,5
3893,SpokaneStBridge,06/12/2014 05:00:00 AM,48,-122,29,6,35
3894,SpokaneStBridge,06/12/2014 06:00:00 AM,48,-122,75,14,89
3895,SpokaneStBridge,06/12/2014 07:00:00 AM,48,-122,133,16,149
3896,SpokaneStBridge,06/12/2014 08:00:00 AM,48,-122,125,8,133
3897,SpokaneStBridge,06/12/2014 09:00:00 AM,48,-122,38,10,48
3898,SpokaneStBridge,06/12/2014 10:00:00 AM,48,-122,23,4,27
3899,SpokaneStBridge,06/12/2014 11:00:00 AM,48,-122,15,7,22
3900,SpokaneStBridge,06/12/2014 12:00:00 PM,48,-122,20,12,32
3901,SpokaneStBridge,06/12/2014 01:00:00 PM,48,-122,18,13,31
3902,SpokaneStBridge,06/12/2014 02:00:00 PM,48,-122,11,19,30
3903,SpokaneStBridge,06/12/2014 03:00:00 PM,48,-122,15,33,48
3904,SpokaneStBridge,06/12/2014 04:00:00 PM,48,-122,29,64,93
3905,SpokaneStBridge,06/12/2014 05:00:00 PM,48,-122,26,131,157
3906,SpokaneStBridge,06/12/2014 06:00:00 PM,48,-122,13,95,108
3907,SpokaneStBridge,06/12/2014 07:00:00 PM,48,-122,19,43,62
3908,SpokaneStBridge,06/12/2014 08:00:00 PM,48,-122,6,17,23
3909,SpokaneStBridge,06/12/2014 09:00:00 PM,48,-122,7,9,16
3910,SpokaneStBridge,06/12/2014 10:00:00 PM,48,-122,1,8,9
3911,SpokaneStBridge,06/12/2014 11:00:00 PM,48,-122,0,9,9
3912,SpokaneStBridge,06/13/2014 12:00:00 AM,48,-122,1,2,3
3913,SpokaneStBridge,06/13/2014 01:00:00 AM,48,-122,0,1,1
3914,SpokaneStBridge,06/13/2014 02:00:00 AM,48,-122,0,0,0
3915,SpokaneStBridge,06/13/2014 03:00:00 AM,48,-122,1,2,3
3916,SpokaneStBridge,06/13/2014 04:00:00 AM,48,-122,3,1,4
3917,SpokaneStBridge,06/13/2014 05:00:00 AM,48,-122,8,4,12
3918,SpokaneStBridge,06/13/2014 06:00:00 AM,48,-122,36,5,41
3919,SpokaneStBridge,06/13/2014 07:00:00 AM,48,-122,56,9,65
3920,SpokaneStBridge,06/13/2014 08:00:00 AM,48,-122,59,3,62
3921,SpokaneStBridge,06/13/2014 09:00:00 AM,48,-122,25,5,30
3922,SpokaneStBridge,06/13/2014 10:00:00 AM,48,-122,6,3,9
3923,SpokaneStBridge,06/13/2014 11:00:00 AM,48,-122,5,4,9
3924,SpokaneStBridge,06/13/2014 12:00:00 PM,48,-122,5,3,8
3925,SpokaneStBridge,06/13/2014 01:00:00 PM,48,-122,5,7,12
3926,SpokaneStBridge,06/13/2014 02:00:00 PM,48,-122,5,8,13
3927,SpokaneStBridge,06/13/2014 03:00:00 PM,48,-122,7,20,27
3928,SpokaneStBridge,06/13/2014 04:00:00 PM,48,-122,16,57,73
3929,SpokaneStBridge,06/13/2014 05:00:00 PM,48,-122,10,73,83
3930,SpokaneStBridge,06/13/2014 06:00:00 PM,48,-122,9,44,53
3931,SpokaneStBridge,06/13/2014 07:00:00 PM,48,-122,6,13,19
3932,SpokaneStBridge,06/13/2014 08:00:00 PM,48,-122,3,9,12
3933,SpokaneStBridge,06/13/2014 09:00:00 PM,48,-122,0,7,7
3934,SpokaneStBridge,06/13/2014 10:00:00 PM,48,-122,3,3,6
3935,SpokaneStBridge,06/13/2014 11:00:00 PM,48,-122,2,4,6
3936,SpokaneStBridge,06/14/2014 12:00:00 AM,48,-122,1,4,5
3937,SpokaneStBridge,06/14/2014 01:00:00 AM,48,-122,2,0,2
3938,SpokaneStBridge,06/14/2014 02:00:00 AM,48,-122,0,0,0
3939,SpokaneStBridge,06/14/2014 03:00:00 AM,48,-122,0,4,4
3940,SpokaneStBridge,06/14/2014 04:00:00 AM,48,-122,1,1,2
3941,SpokaneStBridge,06/14/2014 05:00:00 AM,48,-122,4,0,4
3942,SpokaneStBridge,06/14/2014 06:00:00 AM,48,-122,7,6,13
3943,SpokaneStBridge,06/14/2014 07:00:00 AM,48,-122,17,4,21
3944,SpokaneStBridge,06/14/2014 08:00:00 AM,48,-122,23,15,38
3945,SpokaneStBridge,06/14/2014 09:00:00 AM,48,-122,28,14,42
3946,SpokaneStBridge,06/14/2014 10:00:00 AM,48,-122,20,23,43
3947,SpokaneStBridge,06/14/2014 11:00:00 AM,48,-122,13,27,40
3948,SpokaneStBridge,06/14/2014 12:00:00 PM,48,-122,19,33,52
3949,SpokaneStBridge,06/14/2014 01:00:00 PM,48,-122,33,22,55
3950,SpokaneStBridge,06/14/2014 02:00:00 PM,48,-122,36,30,66
3951,SpokaneStBridge,06/14/2014 03:00:00 PM,48,-122,41,59,100
3952,SpokaneStBridge,06/14/2014 04:00:00 PM,48,-122,56,38,94
3953,SpokaneStBridge,06/14/2014 05:00:00 PM,48,-122,20,16,36
3954,SpokaneStBridge,06/14/2014 06:00:00 PM,48,-122,23,18,41
3955,SpokaneStBridge,06/14/2014 07:00:00 PM,48,-122,2,7,9
3956,SpokaneStBridge,06/14/2014 08:00:00 PM,48,-122,1,10,11
3957,SpokaneStBridge,06/14/2014 09:00:00 PM,48,-122,3,1,4
3958,SpokaneStBridge,06/14/2014 10:00:00 PM,48,-122,5,6,11
3959,SpokaneStBridge,06/14/2014 11:00:00 PM,48,-122,1,1,2
3960,SpokaneStBridge,06/15/2014 12:00:00 AM,48,-122,1,3,4
3961,SpokaneStBridge,06/15/2014 01:00:00 AM,48,-122,1,1,2
3962,SpokaneStBridge,06/15/2014 02:00:00 AM,48,-122,0,2,2
3963,SpokaneStBridge,06/15/2014 03:00:00 AM,48,-122,0,1,1
3964,SpokaneStBridge,06/15/2014 04:00:00 AM,48,-122,0,2,2
3965,SpokaneStBridge,06/15/2014 05:00:00 AM,48,-122,2,1,3
3966,SpokaneStBridge,06/15/2014 06:00:00 AM,48,-122,3,2,5
3967,SpokaneStBridge,06/15/2014 07:00:00 AM,48,-122,5,2,7
3968,SpokaneStBridge,06/15/2014 08:00:00 AM,48,-122,20,7,27
3969,SpokaneStBridge,06/15/2014 09:00:00 AM,48,-122,12,12,24
3970,SpokaneStBridge,06/15/2014 10:00:00 AM,48,-122,31,20,51
3971,SpokaneStBridge,06/15/2014 11:00:00 AM,48,-122,27,27,54
3972,SpokaneStBridge,06/15/2014 12:00:00 PM,48,-122,16,23,39
3973,SpokaneStBridge,06/15/2014 01:00:00 PM,48,-122,26,18,44
3974,SpokaneStBridge,06/15/2014 02:00:00 PM,48,-122,17,14,31
3975,SpokaneStBridge,06/15/2014 03:00:00 PM,48,-122,19,23,42
3976,SpokaneStBridge,06/15/2014 04:00:00 PM,48,-122,20,19,39
3977,SpokaneStBridge,06/15/2014 05:00:00 PM,48,-122,19,12,31
3978,SpokaneStBridge,06/15/2014 06:00:00 PM,48,-122,6,5,11
3979,SpokaneStBridge,06/15/2014 07:00:00 PM,48,-122,6,3,9
3980,SpokaneStBridge,06/15/2014 08:00:00 PM,48,-122,2,3,5
3981,SpokaneStBridge,06/15/2014 09:00:00 PM,48,-122,1,5,6
3982,SpokaneStBridge,06/15/2014 10:00:00 PM,48,-122,1,3,4
3983,SpokaneStBridge,06/15/2014 11:00:00 PM,48,-122,0,12,12
3984,SpokaneStBridge,06/16/2014 12:00:00 AM,48,-122,0,1,1
3985,SpokaneStBridge,06/16/2014 01:00:00 AM,48,-122,0,0,0
3986,SpokaneStBridge,06/16/2014 02:00:00 AM,48,-122,0,1,1
3987,SpokaneStBridge,06/16/2014 03:00:00 AM,48,-122,1,0,1
3988,SpokaneStBridge,06/16/2014 04:00:00 AM,48,-122,1,1,2
3989,SpokaneStBridge,06/16/2014 05:00:00 AM,48,-122,14,4,18
3990,SpokaneStBridge,06/16/2014 06:00:00 AM,48,-122,49,6,55
3991,SpokaneStBridge,06/16/2014 07:00:00 AM,48,-122,104,11,115
3992,SpokaneStBridge,06/16/2014 08:00:00 AM,48,-122,91,9,100
3993,SpokaneStBridge,06/16/2014 09:00:00 AM,48,-122,37,8,45
3994,SpokaneStBridge,06/16/2014 10:00:00 AM,48,-122,14,5,19
3995,SpokaneStBridge,06/16/2014 11:00:00 AM,48,-122,5,4,9
3996,SpokaneStBridge,06/16/2014 12:00:00 PM,48,-122,10,5,15
3997,SpokaneStBridge,06/16/2014 01:00:00 PM,48,-122,10,2,12
3998,SpokaneStBridge,06/16/2014 02:00:00 PM,48,-122,10,25,35
3999,SpokaneStBridge,06/16/2014 03:00:00 PM,48,-122,20,36,56
4000,SpokaneStBridge,06/16/2014 04:00:00 PM,48,-122,21,53,74
4001,SpokaneStBridge,06/16/2014 05:00:00 PM,48,-122,25,114,139
4002,SpokaneStBridge,06/16/2014 06:00:00 PM,48,-122,19,85,104
4003,SpokaneStBridge,06/16/2014 07:00:00 PM,48,-122,13,29,42
4004,SpokaneStBridge,06/16/2014 08:00:00 PM,48,-122,6,20,26
4005,SpokaneStBridge,06/16/2014 09:00:00 PM,48,-122,9,12,21
4006,SpokaneStBridge,06/16/2014 10:00:00 PM,48,-122,1,6,7
4007,SpokaneStBridge,06/16/2014 11:00:00 PM,48,-122,1,4,5
4008,SpokaneStBridge,06/17/2014 12:00:00 AM,48,-122,1,3,4
4009,SpokaneStBridge,06/17/2014 01:00:00 AM,48,-122,1,0,1
4010,SpokaneStBridge,06/17/2014 02:00:00 AM,48,-122,0,2,2
4011,SpokaneStBridge,06/17/2014 03:00:00 AM,48,-122,0,0,0
4012,SpokaneStBridge,06/17/2014 04:00:00 AM,48,-122,0,0,0
4013,SpokaneStBridge,06/17/2014 05:00:00 AM,48,-122,17,4,21
4014,SpokaneStBridge,06/17/2014 06:00:00 AM,48,-122,67,9,76
4015,SpokaneStBridge,06/17/2014 07:00:00 AM,48,-122,120,17,137
4016,SpokaneStBridge,06/17/2014 08:00:00 AM,48,-122,120,11,131
4017,SpokaneStBridge,06/17/2014 09:00:00 AM,48,-122,47,7,54
4018,SpokaneStBridge,06/17/2014 10:00:00 AM,48,-122,30,4,34
4019,SpokaneStBridge,06/17/2014 11:00:00 AM,48,-122,10,8,18
4020,SpokaneStBridge,06/17/2014 12:00:00 PM,48,-122,13,10,23
4021,SpokaneStBridge,06/17/2014 01:00:00 PM,48,-122,14,10,24
4022,SpokaneStBridge,06/17/2014 02:00:00 PM,48,-122,12,12,24
4023,SpokaneStBridge,06/17/2014 03:00:00 PM,48,-122,17,28,45
4024,SpokaneStBridge,06/17/2014 04:00:00 PM,48,-122,11,83,94
4025,SpokaneStBridge,06/17/2014 05:00:00 PM,48,-122,30,131,161
4026,SpokaneStBridge,06/17/2014 06:00:00 PM,48,-122,20,106,126
4027,SpokaneStBridge,06/17/2014 07:00:00 PM,48,-122,16,34,50
4028,SpokaneStBridge,06/17/2014 08:00:00 PM,48,-122,6,22,28
4029,SpokaneStBridge,06/17/2014 09:00:00 PM,48,-122,4,8,12
4030,SpokaneStBridge,06/17/2014 10:00:00 PM,48,-122,3,6,9
4031,SpokaneStBridge,06/17/2014 11:00:00 PM,48,-122,1,4,5
4032,SpokaneStBridge,06/18/2014 12:00:00 AM,48,-122,1,4,5
4033,SpokaneStBridge,06/18/2014 01:00:00 AM,48,-122,2,2,4
4034,SpokaneStBridge,06/18/2014 02:00:00 AM,48,-122,2,1,3
4035,SpokaneStBridge,06/18/2014 03:00:00 AM,48,-122,1,1,2
4036,SpokaneStBridge,06/18/2014 04:00:00 AM,48,-122,4,4,8
4037,SpokaneStBridge,06/18/2014 05:00:00 AM,48,-122,20,7,27
4038,SpokaneStBridge,06/18/2014 06:00:00 AM,48,-122,90,19,109
4039,SpokaneStBridge,06/18/2014 07:00:00 AM,48,-122,135,17,152
4040,SpokaneStBridge,06/18/2014 08:00:00 AM,48,-122,141,10,151
4041,SpokaneStBridge,06/18/2014 09:00:00 AM,48,-122,32,7,39
4042,SpokaneStBridge,06/18/2014 10:00:00 AM,48,-122,27,11,38
4043,SpokaneStBridge,06/18/2014 11:00:00 AM,48,-122,16,7,23
4044,SpokaneStBridge,06/18/2014 12:00:00 PM,48,-122,12,13,25
4045,SpokaneStBridge,06/18/2014 01:00:00 PM,48,-122,11,17,28
4046,SpokaneStBridge,06/18/2014 02:00:00 PM,48,-122,19,23,42
4047,SpokaneStBridge,06/18/2014 03:00:00 PM,48,-122,18,37,55
4048,SpokaneStBridge,06/18/2014 04:00:00 PM,48,-122,29,90,119
4049,SpokaneStBridge,06/18/2014 05:00:00 PM,48,-122,71,92,163
4050,SpokaneStBridge,06/18/2014 06:00:00 PM,48,-122,61,62,123
4051,SpokaneStBridge,06/18/2014 07:00:00 PM,48,-122,8,26,34
4052,SpokaneStBridge,06/18/2014 08:00:00 PM,48,-122,11,25,36
4053,SpokaneStBridge,06/18/2014 09:00:00 PM,48,-122,5,12,17
4054,SpokaneStBridge,06/18/2014 10:00:00 PM,48,-122,4,6,10
4055,SpokaneStBridge,06/18/2014 11:00:00 PM,48,-122,4,3,7
4056,SpokaneStBridge,06/19/2014 12:00:00 AM,48,-122,3,4,7
4057,SpokaneStBridge,06/19/2014 01:00:00 AM,48,-122,2,1,3
4058,SpokaneStBridge,06/19/2014 02:00:00 AM,48,-122,0,0,0
4059,SpokaneStBridge,06/19/2014 03:00:00 AM,48,-122,0,1,1
4060,SpokaneStBridge,06/19/2014 04:00:00 AM,48,-122,5,1,6
4061,SpokaneStBridge,06/19/2014 05:00:00 AM,48,-122,22,4,26
4062,SpokaneStBridge,06/19/2014 06:00:00 AM,48,-122,91,12,103
4063,SpokaneStBridge,06/19/2014 07:00:00 AM,48,-122,130,21,151
4064,SpokaneStBridge,06/19/2014 08:00:00 AM,48,-122,118,18,136
4065,SpokaneStBridge,06/19/2014 09:00:00 AM,48,-122,43,6,49
4066,SpokaneStBridge,06/19/2014 10:00:00 AM,48,-122,23,1,24
4067,SpokaneStBridge,06/19/2014 11:00:00 AM,48,-122,11,16,27
4068,SpokaneStBridge,06/19/2014 12:00:00 PM,48,-122,19,15,34
4069,SpokaneStBridge,06/19/2014 01:00:00 PM,48,-122,20,22,42
4070,SpokaneStBridge,06/19/2014 02:00:00 PM,48,-122,14,27,41
4071,SpokaneStBridge,06/19/2014 03:00:00 PM,48,-122,27,30,57
4072,SpokaneStBridge,06/19/2014 04:00:00 PM,48,-122,22,88,110
4073,SpokaneStBridge,06/19/2014 05:00:00 PM,48,-122,34,162,196
4074,SpokaneStBridge,06/19/2014 06:00:00 PM,48,-122,19,109,128
4075,SpokaneStBridge,06/19/2014 07:00:00 PM,48,-122,20,39,59
4076,SpokaneStBridge,06/19/2014 08:00:00 PM,48,-122,11,21,32
4077,SpokaneStBridge,06/19/2014 09:00:00 PM,48,-122,2,20,22
4078,SpokaneStBridge,06/19/2014 10:00:00 PM,48,-122,7,6,13
4079,SpokaneStBridge,06/19/2014 11:00:00 PM,48,-122,0,3,3
4080,SpokaneStBridge,06/20/2014 12:00:00 AM,48,-122,0,3,3
4081,SpokaneStBridge,06/20/2014 01:00:00 AM,48,-122,0,2,2
4082,SpokaneStBridge,06/20/2014 02:00:00 AM,48,-122,0,1,1
4083,SpokaneStBridge,06/20/2014 03:00:00 AM,48,-122,2,0,2
4084,SpokaneStBridge,06/20/2014 04:00:00 AM,48,-122,2,0,2
4085,SpokaneStBridge,06/20/2014 05:00:00 AM,48,-122,26,5,31
4086,SpokaneStBridge,06/20/2014 06:00:00 AM,48,-122,49,4,53
4087,SpokaneStBridge,06/20/2014 07:00:00 AM,48,-122,101,17,118
4088,SpokaneStBridge,06/20/2014 08:00:00 AM,48,-122,108,11,119
4089,SpokaneStBridge,06/20/2014 09:00:00 AM,48,-122,42,10,52
4090,SpokaneStBridge,06/20/2014 10:00:00 AM,48,-122,22,7,29
4091,SpokaneStBridge,06/20/2014 11:00:00 AM,48,-122,7,7,14
4092,SpokaneStBridge,06/20/2014 12:00:00 PM,48,-122,13,19,32
4093,SpokaneStBridge,06/20/2014 01:00:00 PM,48,-122,10,8,18
4094,SpokaneStBridge,06/20/2014 02:00:00 PM,48,-122,8,25,33
4095,SpokaneStBridge,06/20/2014 03:00:00 PM,48,-122,22,38,60
4096,SpokaneStBridge,06/20/2014 04:00:00 PM,48,-122,29,74,103
4097,SpokaneStBridge,06/20/2014 05:00:00 PM,48,-122,29,139,168
4098,SpokaneStBridge,06/20/2014 06:00:00 PM,48,-122,11,68,79
4099,SpokaneStBridge,06/20/2014 07:00:00 PM,48,-122,9,27,36
4100,SpokaneStBridge,06/20/2014 08:00:00 PM,48,-122,9,12,21
4101,SpokaneStBridge,06/20/2014 09:00:00 PM,48,-122,11,4,15
4102,SpokaneStBridge,06/20/2014 10:00:00 PM,48,-122,9,12,21
4103,SpokaneStBridge,06/20/2014 11:00:00 PM,48,-122,4,4,8
4104,SpokaneStBridge,06/21/2014 12:00:00 AM,48,-122,2,5,7
4105,SpokaneStBridge,06/21/2014 01:00:00 AM,48,-122,8,5,13
4106,SpokaneStBridge,06/21/2014 02:00:00 AM,48,-122,0,1,1
4107,SpokaneStBridge,06/21/2014 03:00:00 AM,48,-122,0,0,0
4108,SpokaneStBridge,06/21/2014 04:00:00 AM,48,-122,1,0,1
4109,SpokaneStBridge,06/21/2014 05:00:00 AM,48,-122,5,0,5
4110,SpokaneStBridge,06/21/2014 06:00:00 AM,48,-122,3,3,6
4111,SpokaneStBridge,06/21/2014 07:00:00 AM,48,-122,20,20,40
4112,SpokaneStBridge,06/21/2014 08:00:00 AM,48,-122,24,32,56
4113,SpokaneStBridge,06/21/2014 09:00:00 AM,48,-122,40,37,77
4114,SpokaneStBridge,06/21/2014 10:00:00 AM,48,-122,49,37,86
4115,SpokaneStBridge,06/21/2014 11:00:00 AM,48,-122,54,39,93
4116,SpokaneStBridge,06/21/2014 12:00:00 PM,48,-122,55,34,89
4117,SpokaneStBridge,06/21/2014 01:00:00 PM,48,-122,76,26,102
4118,SpokaneStBridge,06/21/2014 02:00:00 PM,48,-122,75,43,118
4119,SpokaneStBridge,06/21/2014 03:00:00 PM,48,-122,46,37,83
4120,SpokaneStBridge,06/21/2014 04:00:00 PM,48,-122,39,53,92
4121,SpokaneStBridge,06/21/2014 05:00:00 PM,48,-122,30,55,85
4122,SpokaneStBridge,06/21/2014 06:00:00 PM,48,-122,16,37,53
4123,SpokaneStBridge,06/21/2014 07:00:00 PM,48,-122,13,29,42
4124,SpokaneStBridge,06/21/2014 08:00:00 PM,48,-122,12,24,36
4125,SpokaneStBridge,06/21/2014 09:00:00 PM,48,-122,6,23,29
4126,SpokaneStBridge,06/21/2014 10:00:00 PM,48,-122,4,5,9
4127,SpokaneStBridge,06/21/2014 11:00:00 PM,48,-122,6,6,12
4128,SpokaneStBridge,06/22/2014 12:00:00 AM,48,-122,3,7,10
4129,SpokaneStBridge,06/22/2014 01:00:00 AM,48,-122,2,4,6
4130,SpokaneStBridge,06/22/2014 02:00:00 AM,48,-122,3,1,4
4131,SpokaneStBridge,06/22/2014 03:00:00 AM,48,-122,1,2,3
4132,SpokaneStBridge,06/22/2014 04:00:00 AM,48,-122,1,2,3
4133,SpokaneStBridge,06/22/2014 05:00:00 AM,48,-122,3,0,3
4134,SpokaneStBridge,06/22/2014 06:00:00 AM,48,-122,8,1,9
4135,SpokaneStBridge,06/22/2014 07:00:00 AM,48,-122,12,11,23
4136,SpokaneStBridge,06/22/2014 08:00:00 AM,48,-122,24,25,49
4137,SpokaneStBridge,06/22/2014 09:00:00 AM,48,-122,36,24,60
4138,SpokaneStBridge,06/22/2014 10:00:00 AM,48,-122,43,43,86
4139,SpokaneStBridge,06/22/2014 11:00:00 AM,48,-122,27,22,49
4140,SpokaneStBridge,06/22/2014 12:00:00 PM,48,-122,49,39,88
4141,SpokaneStBridge,06/22/2014 01:00:00 PM,48,-122,52,45,97
4142,SpokaneStBridge,06/22/2014 02:00:00 PM,48,-122,40,44,84
4143,SpokaneStBridge,06/22/2014 03:00:00 PM,48,-122,37,26,63
4144,SpokaneStBridge,06/22/2014 04:00:00 PM,48,-122,34,32,66
4145,SpokaneStBridge,06/22/2014 05:00:00 PM,48,-122,28,32,60
4146,SpokaneStBridge,06/22/2014 06:00:00 PM,48,-122,16,36,52
4147,SpokaneStBridge,06/22/2014 07:00:00 PM,48,-122,18,18,36
4148,SpokaneStBridge,06/22/2014 08:00:00 PM,48,-122,13,13,26
4149,SpokaneStBridge,06/22/2014 09:00:00 PM,48,-122,6,9,15
4150,SpokaneStBridge,06/22/2014 10:00:00 PM,48,-122,6,8,14
4151,SpokaneStBridge,06/22/2014 11:00:00 PM,48,-122,1,3,4
4152,SpokaneStBridge,06/23/2014 12:00:00 AM,48,-122,3,1,4
4153,SpokaneStBridge,06/23/2014 01:00:00 AM,48,-122,0,0,0
4154,SpokaneStBridge,06/23/2014 02:00:00 AM,48,-122,1,0,1
4155,SpokaneStBridge,06/23/2014 03:00:00 AM,48,-122,2,1,3
4156,SpokaneStBridge,06/23/2014 04:00:00 AM,48,-122,1,3,4
4157,SpokaneStBridge,06/23/2014 05:00:00 AM,48,-122,25,8,33
4158,SpokaneStBridge,06/23/2014 06:00:00 AM,48,-122,71,11,82
4159,SpokaneStBridge,06/23/2014 07:00:00 AM,48,-122,140,15,155
4160,SpokaneStBridge,06/23/2014 08:00:00 AM,48,-122,130,13,143
4161,SpokaneStBridge,06/23/2014 09:00:00 AM,48,-122,56,7,63
4162,SpokaneStBridge,06/23/2014 10:00:00 AM,48,-122,21,9,30
4163,SpokaneStBridge,06/23/2014 11:00:00 AM,48,-122,34,12,46
4164,SpokaneStBridge,06/23/2014 12:00:00 PM,48,-122,20,20,40
4165,SpokaneStBridge,06/23/2014 01:00:00 PM,48,-122,20,21,41
4166,SpokaneStBridge,06/23/2014 02:00:00 PM,48,-122,19,24,43
4167,SpokaneStBridge,06/23/2014 03:00:00 PM,48,-122,19,39,58
4168,SpokaneStBridge,06/23/2014 04:00:00 PM,48,-122,23,72,95
4169,SpokaneStBridge,06/23/2014 05:00:00 PM,48,-122,36,181,217
4170,SpokaneStBridge,06/23/2014 06:00:00 PM,48,-122,16,125,141
4171,SpokaneStBridge,06/23/2014 07:00:00 PM,48,-122,17,60,77
4172,SpokaneStBridge,06/23/2014 08:00:00 PM,48,-122,16,22,38
4173,SpokaneStBridge,06/23/2014 09:00:00 PM,48,-122,3,13,16
4174,SpokaneStBridge,06/23/2014 10:00:00 PM,48,-122,4,3,7
4175,SpokaneStBridge,06/23/2014 11:00:00 PM,48,-122,1,2,3
4176,SpokaneStBridge,06/24/2014 12:00:00 AM,48,-122,2,4,6
4177,SpokaneStBridge,06/24/2014 01:00:00 AM,48,-122,0,1,1
4178,SpokaneStBridge,06/24/2014 02:00:00 AM,48,-122,1,2,3
4179,SpokaneStBridge,06/24/2014 03:00:00 AM,48,-122,1,1,2
4180,SpokaneStBridge,06/24/2014 04:00:00 AM,48,-122,4,2,6
4181,SpokaneStBridge,06/24/2014 05:00:00 AM,48,-122,24,5,29
4182,SpokaneStBridge,06/24/2014 06:00:00 AM,48,-122,53,15,68
4183,SpokaneStBridge,06/24/2014 07:00:00 AM,48,-122,113,16,129
4184,SpokaneStBridge,06/24/2014 08:00:00 AM,48,-122,124,8,132
4185,SpokaneStBridge,06/24/2014 09:00:00 AM,48,-122,43,8,51
4186,SpokaneStBridge,06/24/2014 10:00:00 AM,48,-122,16,7,23
4187,SpokaneStBridge,06/24/2014 11:00:00 AM,48,-122,10,6,16
4188,SpokaneStBridge,06/24/2014 12:00:00 PM,48,-122,19,16,35
4189,SpokaneStBridge,06/24/2014 01:00:00 PM,48,-122,13,16,29
4190,SpokaneStBridge,06/24/2014 02:00:00 PM,48,-122,15,19,34
4191,SpokaneStBridge,06/24/2014 03:00:00 PM,48,-122,25,40,65
4192,SpokaneStBridge,06/24/2014 04:00:00 PM,48,-122,21,70,91
4193,SpokaneStBridge,06/24/2014 05:00:00 PM,48,-122,30,155,185
4194,SpokaneStBridge,06/24/2014 06:00:00 PM,48,-122,16,101,117
4195,SpokaneStBridge,06/24/2014 07:00:00 PM,48,-122,19,50,69
4196,SpokaneStBridge,06/24/2014 08:00:00 PM,48,-122,13,23,36
4197,SpokaneStBridge,06/24/2014 09:00:00 PM,48,-122,6,11,17
4198,SpokaneStBridge,06/24/2014 10:00:00 PM,48,-122,4,15,19
4199,SpokaneStBridge,06/24/2014 11:00:00 PM,48,-122,4,5,9
4200,SpokaneStBridge,06/25/2014 12:00:00 AM,48,-122,1,1,2
4201,SpokaneStBridge,06/25/2014 01:00:00 AM,48,-122,0,1,1
4202,SpokaneStBridge,06/25/2014 02:00:00 AM,48,-122,0,0,0
4203,SpokaneStBridge,06/25/2014 03:00:00 AM,48,-122,1,0,1
4204,SpokaneStBridge,06/25/2014 04:00:00 AM,48,-122,5,3,8
4205,SpokaneStBridge,06/25/2014 05:00:00 AM,48,-122,30,5,35
4206,SpokaneStBridge,06/25/2014 06:00:00 AM,48,-122,76,8,84
4207,SpokaneStBridge,06/25/2014 07:00:00 AM,48,-122,139,21,160
4208,SpokaneStBridge,06/25/2014 08:00:00 AM,48,-122,128,17,145
4209,SpokaneStBridge,06/25/2014 09:00:00 AM,48,-122,60,5,65
4210,SpokaneStBridge,06/25/2014 10:00:00 AM,48,-122,30,16,46
4211,SpokaneStBridge,06/25/2014 11:00:00 AM,48,-122,20,13,33
4212,SpokaneStBridge,06/25/2014 12:00:00 PM,48,-122,15,16,31
4213,SpokaneStBridge,06/25/2014 01:00:00 PM,48,-122,24,18,42
4214,SpokaneStBridge,06/25/2014 02:00:00 PM,48,-122,26,20,46
4215,SpokaneStBridge,06/25/2014 03:00:00 PM,48,-122,21,44,65
4216,SpokaneStBridge,06/25/2014 04:00:00 PM,48,-122,31,99,130
4217,SpokaneStBridge,06/25/2014 05:00:00 PM,48,-122,29,156,185
4218,SpokaneStBridge,06/25/2014 06:00:00 PM,48,-122,30,94,124
4219,SpokaneStBridge,06/25/2014 07:00:00 PM,48,-122,14,54,68
4220,SpokaneStBridge,06/25/2014 08:00:00 PM,48,-122,14,26,40
4221,SpokaneStBridge,06/25/2014 09:00:00 PM,48,-122,12,13,25
4222,SpokaneStBridge,06/25/2014 10:00:00 PM,48,-122,5,21,26
4223,SpokaneStBridge,06/25/2014 11:00:00 PM,48,-122,3,9,12
4224,SpokaneStBridge,06/26/2014 12:00:00 AM,48,-122,2,6,8
4225,SpokaneStBridge,06/26/2014 01:00:00 AM,48,-122,3,3,6
4226,SpokaneStBridge,06/26/2014 02:00:00 AM,48,-122,0,1,1
4227,SpokaneStBridge,06/26/2014 03:00:00 AM,48,-122,0,1,1
4228,SpokaneStBridge,06/26/2014 04:00:00 AM,48,-122,4,3,7
4229,SpokaneStBridge,06/26/2014 05:00:00 AM,48,-122,26,6,32
4230,SpokaneStBridge,06/26/2014 06:00:00 AM,48,-122,63,14,77
4231,SpokaneStBridge,06/26/2014 07:00:00 AM,48,-122,137,17,154
4232,SpokaneStBridge,06/26/2014 08:00:00 AM,48,-122,106,14,120
4233,SpokaneStBridge,06/26/2014 09:00:00 AM,48,-122,58,9,67
4234,SpokaneStBridge,06/26/2014 10:00:00 AM,48,-122,12,9,21
4235,SpokaneStBridge,06/26/2014 11:00:00 AM,48,-122,11,10,21
4236,SpokaneStBridge,06/26/2014 12:00:00 PM,48,-122,15,13,28
4237,SpokaneStBridge,06/26/2014 01:00:00 PM,48,-122,18,7,25
4238,SpokaneStBridge,06/26/2014 02:00:00 PM,48,-122,22,11,33
4239,SpokaneStBridge,06/26/2014 03:00:00 PM,48,-122,22,41,63
4240,SpokaneStBridge,06/26/2014 04:00:00 PM,48,-122,30,69,99
4241,SpokaneStBridge,06/26/2014 05:00:00 PM,48,-122,26,142,168
4242,SpokaneStBridge,06/26/2014 06:00:00 PM,48,-122,24,102,126
4243,SpokaneStBridge,06/26/2014 07:00:00 PM,48,-122,16,49,65
4244,SpokaneStBridge,06/26/2014 08:00:00 PM,48,-122,10,18,28
4245,SpokaneStBridge,06/26/2014 09:00:00 PM,48,-122,8,20,28
4246,SpokaneStBridge,06/26/2014 10:00:00 PM,48,-122,4,7,11
4247,SpokaneStBridge,06/26/2014 11:00:00 PM,48,-122,3,6,9
4248,SpokaneStBridge,06/27/2014 12:00:00 AM,48,-122,1,3,4
4249,SpokaneStBridge,06/27/2014 01:00:00 AM,48,-122,1,8,9
4250,SpokaneStBridge,06/27/2014 02:00:00 AM,48,-122,0,2,2
4251,SpokaneStBridge,06/27/2014 03:00:00 AM,48,-122,1,1,2
4252,SpokaneStBridge,06/27/2014 04:00:00 AM,48,-122,4,1,5
4253,SpokaneStBridge,06/27/2014 05:00:00 AM,48,-122,9,6,15
4254,SpokaneStBridge,06/27/2014 06:00:00 AM,48,-122,40,5,45
4255,SpokaneStBridge,06/27/2014 07:00:00 AM,48,-122,71,6,77
4256,SpokaneStBridge,06/27/2014 08:00:00 AM,48,-122,57,12,69
4257,SpokaneStBridge,06/27/2014 09:00:00 AM,48,-122,31,8,39
4258,SpokaneStBridge,06/27/2014 10:00:00 AM,48,-122,12,4,16
4259,SpokaneStBridge,06/27/2014 11:00:00 AM,48,-122,18,8,26
4260,SpokaneStBridge,06/27/2014 12:00:00 PM,48,-122,9,8,17
4261,SpokaneStBridge,06/27/2014 01:00:00 PM,48,-122,13,11,24
4262,SpokaneStBridge,06/27/2014 02:00:00 PM,48,-122,6,25,31
4263,SpokaneStBridge,06/27/2014 03:00:00 PM,48,-122,18,22,40
4264,SpokaneStBridge,06/27/2014 04:00:00 PM,48,-122,14,52,66
4265,SpokaneStBridge,06/27/2014 05:00:00 PM,48,-122,24,77,101
4266,SpokaneStBridge,06/27/2014 06:00:00 PM,48,-122,14,50,64
4267,SpokaneStBridge,06/27/2014 07:00:00 PM,48,-122,4,20,24
4268,SpokaneStBridge,06/27/2014 08:00:00 PM,48,-122,5,6,11
4269,SpokaneStBridge,06/27/2014 09:00:00 PM,48,-122,3,8,11
4270,SpokaneStBridge,06/27/2014 10:00:00 PM,48,-122,1,6,7
4271,SpokaneStBridge,06/27/2014 11:00:00 PM,48,-122,2,3,5
4272,SpokaneStBridge,06/28/2014 12:00:00 AM,48,-122,1,2,3
4273,SpokaneStBridge,06/28/2014 01:00:00 AM,48,-122,0,2,2
4274,SpokaneStBridge,06/28/2014 02:00:00 AM,48,-122,1,0,1
4275,SpokaneStBridge,06/28/2014 03:00:00 AM,48,-122,0,0,0
4276,SpokaneStBridge,06/28/2014 04:00:00 AM,48,-122,0,1,1
4277,SpokaneStBridge,06/28/2014 05:00:00 AM,48,-122,3,0,3
4278,SpokaneStBridge,06/28/2014 06:00:00 AM,48,-122,7,1,8
4279,SpokaneStBridge,06/28/2014 07:00:00 AM,48,-122,8,5,13
4280,SpokaneStBridge,06/28/2014 08:00:00 AM,48,-122,15,11,26
4281,SpokaneStBridge,06/28/2014 09:00:00 AM,48,-122,29,11,40
4282,SpokaneStBridge,06/28/2014 10:00:00 AM,48,-122,11,14,25
4283,SpokaneStBridge,06/28/2014 11:00:00 AM,48,-122,31,29,60
4284,SpokaneStBridge,06/28/2014 12:00:00 PM,48,-122,31,24,55
4285,SpokaneStBridge,06/28/2014 01:00:00 PM,48,-122,17,23,40
4286,SpokaneStBridge,06/28/2014 02:00:00 PM,48,-122,25,21,46
4287,SpokaneStBridge,06/28/2014 03:00:00 PM,48,-122,24,25,49
4288,SpokaneStBridge,06/28/2014 04:00:00 PM,48,-122,16,15,31
4289,SpokaneStBridge,06/28/2014 05:00:00 PM,48,-122,19,17,36
4290,SpokaneStBridge,06/28/2014 06:00:00 PM,48,-122,16,17,33
4291,SpokaneStBridge,06/28/2014 07:00:00 PM,48,-122,9,17,26
4292,SpokaneStBridge,06/28/2014 08:00:00 PM,48,-122,8,8,16
4293,SpokaneStBridge,06/28/2014 09:00:00 PM,48,-122,9,11,20
4294,SpokaneStBridge,06/28/2014 10:00:00 PM,48,-122,4,6,10
4295,SpokaneStBridge,06/28/2014 11:00:00 PM,48,-122,2,3,5
4296,SpokaneStBridge,06/29/2014 12:00:00 AM,48,-122,0,3,3
4297,SpokaneStBridge,06/29/2014 01:00:00 AM,48,-122,1,0,1
4298,SpokaneStBridge,06/29/2014 02:00:00 AM,48,-122,0,2,2
4299,SpokaneStBridge,06/29/2014 03:00:00 AM,48,-122,0,2,2
4300,SpokaneStBridge,06/29/2014 04:00:00 AM,48,-122,0,0,0
4301,SpokaneStBridge,06/29/2014 05:00:00 AM,48,-122,4,3,7
4302,SpokaneStBridge,06/29/2014 06:00:00 AM,48,-122,10,2,12
4303,SpokaneStBridge,06/29/2014 07:00:00 AM,48,-122,9,7,16
4304,SpokaneStBridge,06/29/2014 08:00:00 AM,48,-122,17,9,26
4305,SpokaneStBridge,06/29/2014 09:00:00 AM,48,-122,32,23,55
4306,SpokaneStBridge,06/29/2014 10:00:00 AM,48,-122,39,27,66
4307,SpokaneStBridge,06/29/2014 11:00:00 AM,48,-122,40,29,69
4308,SpokaneStBridge,06/29/2014 12:00:00 PM,48,-122,32,38,70
4309,SpokaneStBridge,06/29/2014 01:00:00 PM,48,-122,33,37,70
4310,SpokaneStBridge,06/29/2014 02:00:00 PM,48,-122,47,40,87
4311,SpokaneStBridge,06/29/2014 03:00:00 PM,48,-122,34,43,77
4312,SpokaneStBridge,06/29/2014 04:00:00 PM,48,-122,29,35,64
4313,SpokaneStBridge,06/29/2014 05:00:00 PM,48,-122,24,29,53
4314,SpokaneStBridge,06/29/2014 06:00:00 PM,48,-122,22,25,47
4315,SpokaneStBridge,06/29/2014 07:00:00 PM,48,-122,12,2,14
4316,SpokaneStBridge,06/29/2014 08:00:00 PM,48,-122,5,12,17
4317,SpokaneStBridge,06/29/2014 09:00:00 PM,48,-122,1,6,7
4318,SpokaneStBridge,06/29/2014 10:00:00 PM,48,-122,7,5,12
4319,SpokaneStBridge,06/29/2014 11:00:00 PM,48,-122,3,1,4
4320,SpokaneStBridge,06/30/2014 12:00:00 AM,48,-122,0,1,1
4321,SpokaneStBridge,06/30/2014 01:00:00 AM,48,-122,0,3,3
4322,SpokaneStBridge,06/30/2014 02:00:00 AM,48,-122,1,1,2
4323,SpokaneStBridge,06/30/2014 03:00:00 AM,48,-122,1,1,2
4324,SpokaneStBridge,06/30/2014 04:00:00 AM,48,-122,4,2,6
4325,SpokaneStBridge,06/30/2014 05:00:00 AM,48,-122,28,7,35
4326,SpokaneStBridge,06/30/2014 06:00:00 AM,48,-122,83,11,94
4327,SpokaneStBridge,06/30/2014 07:00:00 AM,48,-122,127,14,141
4328,SpokaneStBridge,06/30/2014 08:00:00 AM,48,-122,124,14,138
4329,SpokaneStBridge,06/30/2014 09:00:00 AM,48,-122,53,14,67
4330,SpokaneStBridge,06/30/2014 10:00:00 AM,48,-122,27,8,35
4331,SpokaneStBridge,06/30/2014 11:00:00 AM,48,-122,16,9,25
4332,SpokaneStBridge,06/30/2014 12:00:00 PM,48,-122,15,16,31
4333,SpokaneStBridge,06/30/2014 01:00:00 PM,48,-122,26,24,50
4334,SpokaneStBridge,06/30/2014 02:00:00 PM,48,-122,7,22,29
4335,SpokaneStBridge,06/30/2014 03:00:00 PM,48,-122,17,40,57
4336,SpokaneStBridge,06/30/2014 04:00:00 PM,48,-122,26,99,125
4337,SpokaneStBridge,06/30/2014 05:00:00 PM,48,-122,29,176,205
4338,SpokaneStBridge,06/30/2014 06:00:00 PM,48,-122,29,126,155
4339,SpokaneStBridge,06/30/2014 07:00:00 PM,48,-122,18,52,70
4340,SpokaneStBridge,06/30/2014 08:00:00 PM,48,-122,26,16,42
4341,SpokaneStBridge,06/30/2014 09:00:00 PM,48,-122,9,14,23
4342,SpokaneStBridge,06/30/2014 10:00:00 PM,48,-122,6,9,15
4343,SpokaneStBridge,06/30/2014 11:00:00 PM,48,-122,2,6,8
4344,SpokaneStBridge,07/01/2014 12:00:00 AM,48,-122,2,4,6
4345,SpokaneStBridge,07/01/2014 01:00:00 AM,48,-122,2,1,3
4346,SpokaneStBridge,07/01/2014 02:00:00 AM,48,-122,0,1,1
4347,SpokaneStBridge,07/01/2014 03:00:00 AM,48,-122,2,0,2
4348,SpokaneStBridge,07/01/2014 04:00:00 AM,48,-122,5,0,5
4349,SpokaneStBridge,07/01/2014 05:00:00 AM,48,-122,26,6,32
4350,SpokaneStBridge,07/01/2014 06:00:00 AM,48,-122,95,19,114
4351,SpokaneStBridge,07/01/2014 07:00:00 AM,48,-122,128,27,155
4352,SpokaneStBridge,07/01/2014 08:00:00 AM,48,-122,154,18,172
4353,SpokaneStBridge,07/01/2014 09:00:00 AM,48,-122,63,10,73
4354,SpokaneStBridge,07/01/2014 10:00:00 AM,48,-122,27,13,40
4355,SpokaneStBridge,07/01/2014 11:00:00 AM,48,-122,19,10,29
4356,SpokaneStBridge,07/01/2014 12:00:00 PM,48,-122,17,11,28
4357,SpokaneStBridge,07/01/2014 01:00:00 PM,48,-122,18,18,36
4358,SpokaneStBridge,07/01/2014 02:00:00 PM,48,-122,9,23,32
4359,SpokaneStBridge,07/01/2014 03:00:00 PM,48,-122,20,39,59
4360,SpokaneStBridge,07/01/2014 04:00:00 PM,48,-122,23,86,109
4361,SpokaneStBridge,07/01/2014 05:00:00 PM,48,-122,33,188,221
4362,SpokaneStBridge,07/01/2014 06:00:00 PM,48,-122,25,139,164
4363,SpokaneStBridge,07/01/2014 07:00:00 PM,48,-122,30,65,95
4364,SpokaneStBridge,07/01/2014 08:00:00 PM,48,-122,22,22,44
4365,SpokaneStBridge,07/01/2014 09:00:00 PM,48,-122,13,9,22
4366,SpokaneStBridge,07/01/2014 10:00:00 PM,48,-122,3,8,11
4367,SpokaneStBridge,07/01/2014 11:00:00 PM,48,-122,4,10,14
4368,SpokaneStBridge,07/02/2014 12:00:00 AM,48,-122,2,6,8
4369,SpokaneStBridge,07/02/2014 01:00:00 AM,48,-122,2,2,4
4370,SpokaneStBridge,07/02/2014 02:00:00 AM,48,-122,0,0,0
4371,SpokaneStBridge,07/02/2014 03:00:00 AM,48,-122,3,1,4
4372,SpokaneStBridge,07/02/2014 04:00:00 AM,48,-122,5,2,7
4373,SpokaneStBridge,07/02/2014 05:00:00 AM,48,-122,28,5,33
4374,SpokaneStBridge,07/02/2014 06:00:00 AM,48,-122,82,15,97
4375,SpokaneStBridge,07/02/2014 07:00:00 AM,48,-122,139,20,159
4376,SpokaneStBridge,07/02/2014 08:00:00 AM,48,-122,125,19,144
4377,SpokaneStBridge,07/02/2014 09:00:00 AM,48,-122,61,19,80
4378,SpokaneStBridge,07/02/2014 10:00:00 AM,48,-122,32,8,40
4379,SpokaneStBridge,07/02/2014 11:00:00 AM,48,-122,18,13,31
4380,SpokaneStBridge,07/02/2014 12:00:00 PM,48,-122,16,12,28
4381,SpokaneStBridge,07/02/2014 01:00:00 PM,48,-122,21,22,43
4382,SpokaneStBridge,07/02/2014 02:00:00 PM,48,-122,15,23,38
4383,SpokaneStBridge,07/02/2014 03:00:00 PM,48,-122,21,39,60
4384,SpokaneStBridge,07/02/2014 04:00:00 PM,48,-122,25,77,102
4385,SpokaneStBridge,07/02/2014 05:00:00 PM,48,-122,35,159,194
4386,SpokaneStBridge,07/02/2014 06:00:00 PM,48,-122,25,136,161
4387,SpokaneStBridge,07/02/2014 07:00:00 PM,48,-122,12,56,68
4388,SpokaneStBridge,07/02/2014 08:00:00 PM,48,-122,21,29,50
4389,SpokaneStBridge,07/02/2014 09:00:00 PM,48,-122,12,13,25
4390,SpokaneStBridge,07/02/2014 10:00:00 PM,48,-122,1,5,6
4391,SpokaneStBridge,07/02/2014 11:00:00 PM,48,-122,3,10,13
4392,SpokaneStBridge,07/03/2014 12:00:00 AM,48,-122,1,3,4
4393,SpokaneStBridge,07/03/2014 01:00:00 AM,48,-122,1,1,2
4394,SpokaneStBridge,07/03/2014 02:00:00 AM,48,-122,0,1,1
4395,SpokaneStBridge,07/03/2014 03:00:00 AM,48,-122,1,0,1
4396,SpokaneStBridge,07/03/2014 04:00:00 AM,48,-122,2,1,3
4397,SpokaneStBridge,07/03/2014 05:00:00 AM,48,-122,16,5,21
4398,SpokaneStBridge,07/03/2014 06:00:00 AM,48,-122,74,8,82
4399,SpokaneStBridge,07/03/2014 07:00:00 AM,48,-122,94,19,113
4400,SpokaneStBridge,07/03/2014 08:00:00 AM,48,-122,98,16,114
4401,SpokaneStBridge,07/03/2014 09:00:00 AM,48,-122,43,10,53
4402,SpokaneStBridge,07/03/2014 10:00:00 AM,48,-122,24,14,38
4403,SpokaneStBridge,07/03/2014 11:00:00 AM,48,-122,17,10,27
4404,SpokaneStBridge,07/03/2014 12:00:00 PM,48,-122,16,11,27
4405,SpokaneStBridge,07/03/2014 01:00:00 PM,48,-122,16,25,41
4406,SpokaneStBridge,07/03/2014 02:00:00 PM,48,-122,12,23,35
4407,SpokaneStBridge,07/03/2014 03:00:00 PM,48,-122,26,57,83
4408,SpokaneStBridge,07/03/2014 04:00:00 PM,48,-122,20,79,99
4409,SpokaneStBridge,07/03/2014 05:00:00 PM,48,-122,26,99,125
4410,SpokaneStBridge,07/03/2014 06:00:00 PM,48,-122,16,63,79
4411,SpokaneStBridge,07/03/2014 07:00:00 PM,48,-122,8,35,43
4412,SpokaneStBridge,07/03/2014 08:00:00 PM,48,-122,8,22,30
4413,SpokaneStBridge,07/03/2014 09:00:00 PM,48,-122,10,10,20
4414,SpokaneStBridge,07/03/2014 10:00:00 PM,48,-122,4,6,10
4415,SpokaneStBridge,07/03/2014 11:00:00 PM,48,-122,3,6,9
4416,SpokaneStBridge,07/04/2014 12:00:00 AM,48,-122,7,6,13
4417,SpokaneStBridge,07/04/2014 01:00:00 AM,48,-122,3,1,4
4418,SpokaneStBridge,07/04/2014 02:00:00 AM,48,-122,0,2,2
4419,SpokaneStBridge,07/04/2014 03:00:00 AM,48,-122,1,0,1
4420,SpokaneStBridge,07/04/2014 04:00:00 AM,48,-122,1,1,2
4421,SpokaneStBridge,07/04/2014 05:00:00 AM,48,-122,6,2,8
4422,SpokaneStBridge,07/04/2014 06:00:00 AM,48,-122,13,5,18
4423,SpokaneStBridge,07/04/2014 07:00:00 AM,48,-122,21,11,32
4424,SpokaneStBridge,07/04/2014 08:00:00 AM,48,-122,20,19,39
4425,SpokaneStBridge,07/04/2014 09:00:00 AM,48,-122,38,32,70
4426,SpokaneStBridge,07/04/2014 10:00:00 AM,48,-122,33,48,81
4427,SpokaneStBridge,07/04/2014 11:00:00 AM,48,-122,40,38,78
4428,SpokaneStBridge,07/04/2014 12:00:00 PM,48,-122,62,41,103
4429,SpokaneStBridge,07/04/2014 01:00:00 PM,48,-122,41,35,76
4430,SpokaneStBridge,07/04/2014 02:00:00 PM,48,-122,27,46,73
4431,SpokaneStBridge,07/04/2014 03:00:00 PM,48,-122,35,48,83
4432,SpokaneStBridge,07/04/2014 04:00:00 PM,48,-122,36,36,72
4433,SpokaneStBridge,07/04/2014 05:00:00 PM,48,-122,12,31,43
4434,SpokaneStBridge,07/04/2014 06:00:00 PM,48,-122,17,15,32
4435,SpokaneStBridge,07/04/2014 07:00:00 PM,48,-122,14,3,17
4436,SpokaneStBridge,07/04/2014 08:00:00 PM,48,-122,6,4,10
4437,SpokaneStBridge,07/04/2014 09:00:00 PM,48,-122,9,6,15
4438,SpokaneStBridge,07/04/2014 10:00:00 PM,48,-122,5,7,12
4439,SpokaneStBridge,07/04/2014 11:00:00 PM,48,-122,4,10,14
4440,SpokaneStBridge,07/05/2014 12:00:00 AM,48,-122,3,14,17
4441,SpokaneStBridge,07/05/2014 01:00:00 AM,48,-122,2,6,8
4442,SpokaneStBridge,07/05/2014 02:00:00 AM,48,-122,0,4,4
4443,SpokaneStBridge,07/05/2014 03:00:00 AM,48,-122,1,2,3
4444,SpokaneStBridge,07/05/2014 04:00:00 AM,48,-122,3,0,3
4445,SpokaneStBridge,07/05/2014 05:00:00 AM,48,-122,5,1,6
4446,SpokaneStBridge,07/05/2014 06:00:00 AM,48,-122,6,1,7
4447,SpokaneStBridge,07/05/2014 07:00:00 AM,48,-122,14,3,17
4448,SpokaneStBridge,07/05/2014 08:00:00 AM,48,-122,15,13,28
4449,SpokaneStBridge,07/05/2014 09:00:00 AM,48,-122,23,22,45
4450,SpokaneStBridge,07/05/2014 10:00:00 AM,48,-122,29,19,48
4451,SpokaneStBridge,07/05/2014 11:00:00 AM,48,-122,19,26,45
4452,SpokaneStBridge,07/05/2014 12:00:00 PM,48,-122,22,45,67
4453,SpokaneStBridge,07/05/2014 01:00:00 PM,48,-122,37,32,69
4454,SpokaneStBridge,07/05/2014 02:00:00 PM,48,-122,32,25,57
4455,SpokaneStBridge,07/05/2014 03:00:00 PM,48,-122,17,21,38
4456,SpokaneStBridge,07/05/2014 04:00:00 PM,48,-122,24,19,43
4457,SpokaneStBridge,07/05/2014 05:00:00 PM,48,-122,8,17,25
4458,SpokaneStBridge,07/05/2014 06:00:00 PM,48,-122,23,13,36
4459,SpokaneStBridge,07/05/2014 07:00:00 PM,48,-122,10,14,24
4460,SpokaneStBridge,07/05/2014 08:00:00 PM,48,-122,8,9,17
4461,SpokaneStBridge,07/05/2014 09:00:00 PM,48,-122,3,2,5
4462,SpokaneStBridge,07/05/2014 10:00:00 PM,48,-122,4,1,5
4463,SpokaneStBridge,07/05/2014 11:00:00 PM,48,-122,3,1,4
4464,SpokaneStBridge,07/06/2014 12:00:00 AM,48,-122,0,4,4
4465,SpokaneStBridge,07/06/2014 01:00:00 AM,48,-122,0,2,2
4466,SpokaneStBridge,07/06/2014 02:00:00 AM,48,-122,2,1,3
4467,SpokaneStBridge,07/06/2014 03:00:00 AM,48,-122,0,1,1
4468,SpokaneStBridge,07/06/2014 04:00:00 AM,48,-122,1,0,1
4469,SpokaneStBridge,07/06/2014 05:00:00 AM,48,-122,3,0,3
4470,SpokaneStBridge,07/06/2014 06:00:00 AM,48,-122,6,3,9
4471,SpokaneStBridge,07/06/2014 07:00:00 AM,48,-122,8,3,11
4472,SpokaneStBridge,07/06/2014 08:00:00 AM,48,-122,21,23,44
4473,SpokaneStBridge,07/06/2014 09:00:00 AM,48,-122,18,23,41
4474,SpokaneStBridge,07/06/2014 10:00:00 AM,48,-122,45,35,80
4475,SpokaneStBridge,07/06/2014 11:00:00 AM,48,-122,32,36,68
4476,SpokaneStBridge,07/06/2014 12:00:00 PM,48,-122,60,59,119
4477,SpokaneStBridge,07/06/2014 01:00:00 PM,48,-122,46,55,101
4478,SpokaneStBridge,07/06/2014 02:00:00 PM,48,-122,60,54,114
4479,SpokaneStBridge,07/06/2014 03:00:00 PM,48,-122,35,40,75
4480,SpokaneStBridge,07/06/2014 04:00:00 PM,48,-122,31,54,85
4481,SpokaneStBridge,07/06/2014 05:00:00 PM,48,-122,37,45,82
4482,SpokaneStBridge,07/06/2014 06:00:00 PM,48,-122,19,19,38
4483,SpokaneStBridge,07/06/2014 07:00:00 PM,48,-122,24,29,53
4484,SpokaneStBridge,07/06/2014 08:00:00 PM,48,-122,14,10,24
4485,SpokaneStBridge,07/06/2014 09:00:00 PM,48,-122,5,2,7
4486,SpokaneStBridge,07/06/2014 10:00:00 PM,48,-122,4,7,11
4487,SpokaneStBridge,07/06/2014 11:00:00 PM,48,-122,1,2,3
4488,SpokaneStBridge,07/07/2014 12:00:00 AM,48,-122,0,2,2
4489,SpokaneStBridge,07/07/2014 01:00:00 AM,48,-122,1,1,2
4490,SpokaneStBridge,07/07/2014 02:00:00 AM,48,-122,1,1,2
4491,SpokaneStBridge,07/07/2014 03:00:00 AM,48,-122,2,3,5
4492,SpokaneStBridge,07/07/2014 04:00:00 AM,48,-122,3,0,3
4493,SpokaneStBridge,07/07/2014 05:00:00 AM,48,-122,16,5,21
4494,SpokaneStBridge,07/07/2014 06:00:00 AM,48,-122,79,7,86
4495,SpokaneStBridge,07/07/2014 07:00:00 AM,48,-122,136,16,152
4496,SpokaneStBridge,07/07/2014 08:00:00 AM,48,-122,117,10,127
4497,SpokaneStBridge,07/07/2014 09:00:00 AM,48,-122,53,10,63
4498,SpokaneStBridge,07/07/2014 10:00:00 AM,48,-122,19,11,30
4499,SpokaneStBridge,07/07/2014 11:00:00 AM,48,-122,16,9,25
4500,SpokaneStBridge,07/07/2014 12:00:00 PM,48,-122,14,20,34
4501,SpokaneStBridge,07/07/2014 01:00:00 PM,48,-122,16,14,30
4502,SpokaneStBridge,07/07/2014 02:00:00 PM,48,-122,20,21,41
4503,SpokaneStBridge,07/07/2014 03:00:00 PM,48,-122,17,38,55
4504,SpokaneStBridge,07/07/2014 04:00:00 PM,48,-122,35,76,111
4505,SpokaneStBridge,07/07/2014 05:00:00 PM,48,-122,30,150,180
4506,SpokaneStBridge,07/07/2014 06:00:00 PM,48,-122,23,112,135
4507,SpokaneStBridge,07/07/2014 07:00:00 PM,48,-122,26,57,83
4508,SpokaneStBridge,07/07/2014 08:00:00 PM,48,-122,5,16,21
4509,SpokaneStBridge,07/07/2014 09:00:00 PM,48,-122,5,17,22
4510,SpokaneStBridge,07/07/2014 10:00:00 PM,48,-122,2,7,9
4511,SpokaneStBridge,07/07/2014 11:00:00 PM,48,-122,2,7,9
4512,SpokaneStBridge,07/08/2014 12:00:00 AM,48,-122,2,6,8
4513,SpokaneStBridge,07/08/2014 01:00:00 AM,48,-122,1,2,3
4514,SpokaneStBridge,07/08/2014 02:00:00 AM,48,-122,0,0,0
4515,SpokaneStBridge,07/08/2014 03:00:00 AM,48,-122,1,1,2
4516,SpokaneStBridge,07/08/2014 04:00:00 AM,48,-122,4,2,6
4517,SpokaneStBridge,07/08/2014 05:00:00 AM,48,-122,25,5,30
4518,SpokaneStBridge,07/08/2014 06:00:00 AM,48,-122,79,16,95
4519,SpokaneStBridge,07/08/2014 07:00:00 AM,48,-122,155,20,175
4520,SpokaneStBridge,07/08/2014 08:00:00 AM,48,-122,155,13,168
4521,SpokaneStBridge,07/08/2014 09:00:00 AM,48,-122,60,5,65
4522,SpokaneStBridge,07/08/2014 10:00:00 AM,48,-122,32,14,46
4523,SpokaneStBridge,07/08/2014 11:00:00 AM,48,-122,16,12,28
4524,SpokaneStBridge,07/08/2014 12:00:00 PM,48,-122,25,15,40
4525,SpokaneStBridge,07/08/2014 01:00:00 PM,48,-122,20,21,41
4526,SpokaneStBridge,07/08/2014 02:00:00 PM,48,-122,25,20,45
4527,SpokaneStBridge,07/08/2014 03:00:00 PM,48,-122,24,40,64
4528,SpokaneStBridge,07/08/2014 04:00:00 PM,48,-122,29,96,125
4529,SpokaneStBridge,07/08/2014 05:00:00 PM,48,-122,36,184,220
4530,SpokaneStBridge,07/08/2014 06:00:00 PM,48,-122,21,112,133
4531,SpokaneStBridge,07/08/2014 07:00:00 PM,48,-122,26,59,85
4532,SpokaneStBridge,07/08/2014 08:00:00 PM,48,-122,14,38,52
4533,SpokaneStBridge,07/08/2014 09:00:00 PM,48,-122,6,18,24
4534,SpokaneStBridge,07/08/2014 10:00:00 PM,48,-122,12,16,28
4535,SpokaneStBridge,07/08/2014 11:00:00 PM,48,-122,5,3,8
4536,SpokaneStBridge,07/09/2014 12:00:00 AM,48,-122,2,3,5
4537,SpokaneStBridge,07/09/2014 01:00:00 AM,48,-122,2,1,3
4538,SpokaneStBridge,07/09/2014 02:00:00 AM,48,-122,2,4,6
4539,SpokaneStBridge,07/09/2014 03:00:00 AM,48,-122,2,1,3
4540,SpokaneStBridge,07/09/2014 04:00:00 AM,48,-122,4,1,5
4541,SpokaneStBridge,07/09/2014 05:00:00 AM,48,-122,32,5,37
4542,SpokaneStBridge,07/09/2014 06:00:00 AM,48,-122,79,8,87
4543,SpokaneStBridge,07/09/2014 07:00:00 AM,48,-122,152,20,172
4544,SpokaneStBridge,07/09/2014 08:00:00 AM,48,-122,135,16,151
4545,SpokaneStBridge,07/09/2014 09:00:00 AM,48,-122,44,9,53
4546,SpokaneStBridge,07/09/2014 10:00:00 AM,48,-122,37,9,46
4547,SpokaneStBridge,07/09/2014 11:00:00 AM,48,-122,26,9,35
4548,SpokaneStBridge,07/09/2014 12:00:00 PM,48,-122,23,21,44
4549,SpokaneStBridge,07/09/2014 01:00:00 PM,48,-122,22,16,38
4550,SpokaneStBridge,07/09/2014 02:00:00 PM,48,-122,12,27,39
4551,SpokaneStBridge,07/09/2014 03:00:00 PM,48,-122,13,35,48
4552,SpokaneStBridge,07/09/2014 04:00:00 PM,48,-122,31,86,117
4553,SpokaneStBridge,07/09/2014 05:00:00 PM,48,-122,34,165,199
4554,SpokaneStBridge,07/09/2014 06:00:00 PM,48,-122,24,131,155
4555,SpokaneStBridge,07/09/2014 07:00:00 PM,48,-122,22,51,73
4556,SpokaneStBridge,07/09/2014 08:00:00 PM,48,-122,15,36,51
4557,SpokaneStBridge,07/09/2014 09:00:00 PM,48,-122,16,25,41
4558,SpokaneStBridge,07/09/2014 10:00:00 PM,48,-122,10,8,18
4559,SpokaneStBridge,07/09/2014 11:00:00 PM,48,-122,4,12,16
4560,SpokaneStBridge,07/10/2014 12:00:00 AM,48,-122,5,9,14
4561,SpokaneStBridge,07/10/2014 01:00:00 AM,48,-122,0,1,1
4562,SpokaneStBridge,07/10/2014 02:00:00 AM,48,-122,2,4,6
4563,SpokaneStBridge,07/10/2014 03:00:00 AM,48,-122,1,2,3
4564,SpokaneStBridge,07/10/2014 04:00:00 AM,48,-122,1,1,2
4565,SpokaneStBridge,07/10/2014 05:00:00 AM,48,-122,24,3,27
4566,SpokaneStBridge,07/10/2014 06:00:00 AM,48,-122,84,13,97
4567,SpokaneStBridge,07/10/2014 07:00:00 AM,48,-122,133,23,156
4568,SpokaneStBridge,07/10/2014 08:00:00 AM,48,-122,131,13,144
4569,SpokaneStBridge,07/10/2014 09:00:00 AM,48,-122,48,6,54
4570,SpokaneStBridge,07/10/2014 10:00:00 AM,48,-122,27,15,42
4571,SpokaneStBridge,07/10/2014 11:00:00 AM,48,-122,22,12,34
4572,SpokaneStBridge,07/10/2014 12:00:00 PM,48,-122,17,17,34
4573,SpokaneStBridge,07/10/2014 01:00:00 PM,48,-122,21,12,33
4574,SpokaneStBridge,07/10/2014 02:00:00 PM,48,-122,13,29,42
4575,SpokaneStBridge,07/10/2014 03:00:00 PM,48,-122,13,33,46
4576,SpokaneStBridge,07/10/2014 04:00:00 PM,48,-122,22,71,93
4577,SpokaneStBridge,07/10/2014 05:00:00 PM,48,-122,35,147,182
4578,SpokaneStBridge,07/10/2014 06:00:00 PM,48,-122,21,113,134
4579,SpokaneStBridge,07/10/2014 07:00:00 PM,48,-122,16,45,61
4580,SpokaneStBridge,07/10/2014 08:00:00 PM,48,-122,18,36,54
4581,SpokaneStBridge,07/10/2014 09:00:00 PM,48,-122,9,30,39
4582,SpokaneStBridge,07/10/2014 10:00:00 PM,48,-122,2,10,12
4583,SpokaneStBridge,07/10/2014 11:00:00 PM,48,-122,3,3,6
4584,SpokaneStBridge,07/11/2014 12:00:00 AM,48,-122,1,2,3
4585,SpokaneStBridge,07/11/2014 01:00:00 AM,48,-122,0,5,5
4586,SpokaneStBridge,07/11/2014 02:00:00 AM,48,-122,0,1,1
4587,SpokaneStBridge,07/11/2014 03:00:00 AM,48,-122,3,0,3
4588,SpokaneStBridge,07/11/2014 04:00:00 AM,48,-122,5,3,8
4589,SpokaneStBridge,07/11/2014 05:00:00 AM,48,-122,24,5,29
4590,SpokaneStBridge,07/11/2014 06:00:00 AM,48,-122,66,14,80
4591,SpokaneStBridge,07/11/2014 07:00:00 AM,48,-122,120,14,134
4592,SpokaneStBridge,07/11/2014 08:00:00 AM,48,-122,97,8,105
4593,SpokaneStBridge,07/11/2014 09:00:00 AM,48,-122,57,14,71
4594,SpokaneStBridge,07/11/2014 10:00:00 AM,48,-122,25,11,36
4595,SpokaneStBridge,07/11/2014 11:00:00 AM,48,-122,21,11,32
4596,SpokaneStBridge,07/11/2014 12:00:00 PM,48,-122,18,17,35
4597,SpokaneStBridge,07/11/2014 01:00:00 PM,48,-122,35,17,52
4598,SpokaneStBridge,07/11/2014 02:00:00 PM,48,-122,23,25,48
4599,SpokaneStBridge,07/11/2014 03:00:00 PM,48,-122,20,52,72
4600,SpokaneStBridge,07/11/2014 04:00:00 PM,48,-122,27,82,109
4601,SpokaneStBridge,07/11/2014 05:00:00 PM,48,-122,16,128,144
4602,SpokaneStBridge,07/11/2014 06:00:00 PM,48,-122,20,82,102
4603,SpokaneStBridge,07/11/2014 07:00:00 PM,48,-122,18,36,54
4604,SpokaneStBridge,07/11/2014 08:00:00 PM,48,-122,12,16,28
4605,SpokaneStBridge,07/11/2014 09:00:00 PM,48,-122,10,6,16
4606,SpokaneStBridge,07/11/2014 10:00:00 PM,48,-122,12,10,22
4607,SpokaneStBridge,07/11/2014 11:00:00 PM,48,-122,2,6,8
4608,SpokaneStBridge,07/12/2014 12:00:00 AM,48,-122,1,2,3
4609,SpokaneStBridge,07/12/2014 01:00:00 AM,48,-122,3,2,5
4610,SpokaneStBridge,07/12/2014 02:00:00 AM,48,-122,1,1,2
4611,SpokaneStBridge,07/12/2014 03:00:00 AM,48,-122,3,1,4
4612,SpokaneStBridge,07/12/2014 04:00:00 AM,48,-122,10,1,11
4613,SpokaneStBridge,07/12/2014 05:00:00 AM,48,-122,15,1,16
4614,SpokaneStBridge,07/12/2014 06:00:00 AM,48,-122,14,5,19
4615,SpokaneStBridge,07/12/2014 07:00:00 AM,48,-122,16,16,32
4616,SpokaneStBridge,07/12/2014 08:00:00 AM,48,-122,17,33,50
4617,SpokaneStBridge,07/12/2014 09:00:00 AM,48,-122,51,20,71
4618,SpokaneStBridge,07/12/2014 10:00:00 AM,48,-122,26,33,59
4619,SpokaneStBridge,07/12/2014 11:00:00 AM,48,-122,31,40,71
4620,SpokaneStBridge,07/12/2014 12:00:00 PM,48,-122,28,31,59
4621,SpokaneStBridge,07/12/2014 01:00:00 PM,48,-122,31,29,60
4622,SpokaneStBridge,07/12/2014 02:00:00 PM,48,-122,37,33,70
4623,SpokaneStBridge,07/12/2014 03:00:00 PM,48,-122,23,35,58
4624,SpokaneStBridge,07/12/2014 04:00:00 PM,48,-122,23,35,58
4625,SpokaneStBridge,07/12/2014 05:00:00 PM,48,-122,27,26,53
4626,SpokaneStBridge,07/12/2014 06:00:00 PM,48,-122,11,25,36
4627,SpokaneStBridge,07/12/2014 07:00:00 PM,48,-122,25,24,49
4628,SpokaneStBridge,07/12/2014 08:00:00 PM,48,-122,14,13,27
4629,SpokaneStBridge,07/12/2014 09:00:00 PM,48,-122,10,16,26
4630,SpokaneStBridge,07/12/2014 10:00:00 PM,48,-122,6,4,10
4631,SpokaneStBridge,07/12/2014 11:00:00 PM,48,-122,16,8,24
4632,SpokaneStBridge,07/13/2014 12:00:00 AM,48,-122,10,3,13
4633,SpokaneStBridge,07/13/2014 01:00:00 AM,48,-122,4,7,11
4634,SpokaneStBridge,07/13/2014 02:00:00 AM,48,-122,2,3,5
4635,SpokaneStBridge,07/13/2014 03:00:00 AM,48,-122,1,0,1
4636,SpokaneStBridge,07/13/2014 04:00:00 AM,48,-122,1,2,3
4637,SpokaneStBridge,07/13/2014 05:00:00 AM,48,-122,0,1,1
4638,SpokaneStBridge,07/13/2014 06:00:00 AM,48,-122,13,5,18
4639,SpokaneStBridge,07/13/2014 07:00:00 AM,48,-122,19,9,28
4640,SpokaneStBridge,07/13/2014 08:00:00 AM,48,-122,24,28,52
4641,SpokaneStBridge,07/13/2014 09:00:00 AM,48,-122,36,27,63
4642,SpokaneStBridge,07/13/2014 10:00:00 AM,48,-122,45,32,77
4643,SpokaneStBridge,07/13/2014 11:00:00 AM,48,-122,19,33,52
4644,SpokaneStBridge,07/13/2014 12:00:00 PM,48,-122,37,29,66
4645,SpokaneStBridge,07/13/2014 01:00:00 PM,48,-122,19,17,36
4646,SpokaneStBridge,07/13/2014 02:00:00 PM,48,-122,15,23,38
4647,SpokaneStBridge,07/13/2014 03:00:00 PM,48,-122,34,26,60
4648,SpokaneStBridge,07/13/2014 04:00:00 PM,48,-122,23,23,46
4649,SpokaneStBridge,07/13/2014 05:00:00 PM,48,-122,25,21,46
4650,SpokaneStBridge,07/13/2014 06:00:00 PM,48,-122,20,13,33
4651,SpokaneStBridge,07/13/2014 07:00:00 PM,48,-122,17,20,37
4652,SpokaneStBridge,07/13/2014 08:00:00 PM,48,-122,9,5,14
4653,SpokaneStBridge,07/13/2014 09:00:00 PM,48,-122,4,5,9
4654,SpokaneStBridge,07/13/2014 10:00:00 PM,48,-122,3,15,18
4655,SpokaneStBridge,07/13/2014 11:00:00 PM,48,-122,4,5,9
4656,SpokaneStBridge,07/14/2014 12:00:00 AM,48,-122,2,1,3
4657,SpokaneStBridge,07/14/2014 01:00:00 AM,48,-122,1,1,2
4658,SpokaneStBridge,07/14/2014 02:00:00 AM,48,-122,1,0,1
4659,SpokaneStBridge,07/14/2014 03:00:00 AM,48,-122,0,1,1
4660,SpokaneStBridge,07/14/2014 04:00:00 AM,48,-122,5,1,6
4661,SpokaneStBridge,07/14/2014 05:00:00 AM,48,-122,16,6,22
4662,SpokaneStBridge,07/14/2014 06:00:00 AM,48,-122,70,7,77
4663,SpokaneStBridge,07/14/2014 07:00:00 AM,48,-122,146,15,161
4664,SpokaneStBridge,07/14/2014 08:00:00 AM,48,-122,126,14,140
4665,SpokaneStBridge,07/14/2014 09:00:00 AM,48,-122,56,9,65
4666,SpokaneStBridge,07/14/2014 10:00:00 AM,48,-122,23,18,41
4667,SpokaneStBridge,07/14/2014 11:00:00 AM,48,-122,19,12,31
4668,SpokaneStBridge,07/14/2014 12:00:00 PM,48,-122,17,12,29
4669,SpokaneStBridge,07/14/2014 01:00:00 PM,48,-122,19,10,29
4670,SpokaneStBridge,07/14/2014 02:00:00 PM,48,-122,15,22,37
4671,SpokaneStBridge,07/14/2014 03:00:00 PM,48,-122,15,20,35
4672,SpokaneStBridge,07/14/2014 04:00:00 PM,48,-122,27,82,109
4673,SpokaneStBridge,07/14/2014 05:00:00 PM,48,-122,32,177,209
4674,SpokaneStBridge,07/14/2014 06:00:00 PM,48,-122,14,119,133
4675,SpokaneStBridge,07/14/2014 07:00:00 PM,48,-122,18,45,63
4676,SpokaneStBridge,07/14/2014 08:00:00 PM,48,-122,15,20,35
4677,SpokaneStBridge,07/14/2014 09:00:00 PM,48,-122,9,12,21
4678,SpokaneStBridge,07/14/2014 10:00:00 PM,48,-122,5,4,9
4679,SpokaneStBridge,07/14/2014 11:00:00 PM,48,-122,3,6,9
4680,SpokaneStBridge,07/15/2014 12:00:00 AM,48,-122,0,3,3
4681,SpokaneStBridge,07/15/2014 01:00:00 AM,48,-122,0,2,2
4682,SpokaneStBridge,07/15/2014 02:00:00 AM,48,-122,0,2,2
4683,SpokaneStBridge,07/15/2014 03:00:00 AM,48,-122,3,0,3
4684,SpokaneStBridge,07/15/2014 04:00:00 AM,48,-122,2,2,4
4685,SpokaneStBridge,07/15/2014 05:00:00 AM,48,-122,31,7,38
4686,SpokaneStBridge,07/15/2014 06:00:00 AM,48,-122,75,13,88
4687,SpokaneStBridge,07/15/2014 07:00:00 AM,48,-122,140,14,154
4688,SpokaneStBridge,07/15/2014 08:00:00 AM,48,-122,140,15,155
4689,SpokaneStBridge,07/15/2014 09:00:00 AM,48,-122,50,9,59
4690,SpokaneStBridge,07/15/2014 10:00:00 AM,48,-122,20,10,30
4691,SpokaneStBridge,07/15/2014 11:00:00 AM,48,-122,21,20,41
4692,SpokaneStBridge,07/15/2014 12:00:00 PM,48,-122,14,14,28
4693,SpokaneStBridge,07/15/2014 01:00:00 PM,48,-122,16,15,31
4694,SpokaneStBridge,07/15/2014 02:00:00 PM,48,-122,14,16,30
4695,SpokaneStBridge,07/15/2014 03:00:00 PM,48,-122,10,32,42
4696,SpokaneStBridge,07/15/2014 04:00:00 PM,48,-122,22,79,101
4697,SpokaneStBridge,07/15/2014 05:00:00 PM,48,-122,29,174,203
4698,SpokaneStBridge,07/15/2014 06:00:00 PM,48,-122,31,130,161
4699,SpokaneStBridge,07/15/2014 07:00:00 PM,48,-122,22,51,73
4700,SpokaneStBridge,07/15/2014 08:00:00 PM,48,-122,14,32,46
4701,SpokaneStBridge,07/15/2014 09:00:00 PM,48,-122,10,15,25
4702,SpokaneStBridge,07/15/2014 10:00:00 PM,48,-122,4,11,15
4703,SpokaneStBridge,07/15/2014 11:00:00 PM,48,-122,2,7,9
4704,SpokaneStBridge,07/16/2014 12:00:00 AM,48,-122,0,1,1
4705,SpokaneStBridge,07/16/2014 01:00:00 AM,48,-122,1,1,2
4706,SpokaneStBridge,07/16/2014 02:00:00 AM,48,-122,0,0,0
4707,SpokaneStBridge,07/16/2014 03:00:00 AM,48,-122,0,0,0
4708,SpokaneStBridge,07/16/2014 04:00:00 AM,48,-122,6,1,7
4709,SpokaneStBridge,07/16/2014 05:00:00 AM,48,-122,20,4,24
4710,SpokaneStBridge,07/16/2014 06:00:00 AM,48,-122,67,15,82
4711,SpokaneStBridge,07/16/2014 07:00:00 AM,48,-122,166,20,186
4712,SpokaneStBridge,07/16/2014 08:00:00 AM,48,-122,143,8,151
4713,SpokaneStBridge,07/16/2014 09:00:00 AM,48,-122,61,7,68
4714,SpokaneStBridge,07/16/2014 10:00:00 AM,48,-122,20,14,34
4715,SpokaneStBridge,07/16/2014 11:00:00 AM,48,-122,16,16,32
4716,SpokaneStBridge,07/16/2014 12:00:00 PM,48,-122,22,23,45
4717,SpokaneStBridge,07/16/2014 01:00:00 PM,48,-122,12,15,27
4718,SpokaneStBridge,07/16/2014 02:00:00 PM,48,-122,16,23,39
4719,SpokaneStBridge,07/16/2014 03:00:00 PM,48,-122,13,37,50
4720,SpokaneStBridge,07/16/2014 04:00:00 PM,48,-122,24,84,108
4721,SpokaneStBridge,07/16/2014 05:00:00 PM,48,-122,33,177,210
4722,SpokaneStBridge,07/16/2014 06:00:00 PM,48,-122,18,114,132
4723,SpokaneStBridge,07/16/2014 07:00:00 PM,48,-122,19,71,90
4724,SpokaneStBridge,07/16/2014 08:00:00 PM,48,-122,19,32,51
4725,SpokaneStBridge,07/16/2014 09:00:00 PM,48,-122,10,17,27
4726,SpokaneStBridge,07/16/2014 10:00:00 PM,48,-122,10,13,23
4727,SpokaneStBridge,07/16/2014 11:00:00 PM,48,-122,10,5,15
4728,SpokaneStBridge,07/17/2014 12:00:00 AM,48,-122,0,2,2
4729,SpokaneStBridge,07/17/2014 01:00:00 AM,48,-122,2,2,4
4730,SpokaneStBridge,07/17/2014 02:00:00 AM,48,-122,2,2,4
4731,SpokaneStBridge,07/17/2014 03:00:00 AM,48,-122,2,1,3
4732,SpokaneStBridge,07/17/2014 04:00:00 AM,48,-122,8,2,10
4733,SpokaneStBridge,07/17/2014 05:00:00 AM,48,-122,19,3,22
4734,SpokaneStBridge,07/17/2014 06:00:00 AM,48,-122,78,12,90
4735,SpokaneStBridge,07/17/2014 07:00:00 AM,48,-122,130,16,146
4736,SpokaneStBridge,07/17/2014 08:00:00 AM,48,-122,123,15,138
4737,SpokaneStBridge,07/17/2014 09:00:00 AM,48,-122,53,4,57
4738,SpokaneStBridge,07/17/2014 10:00:00 AM,48,-122,19,6,25
4739,SpokaneStBridge,07/17/2014 11:00:00 AM,48,-122,11,10,21
4740,SpokaneStBridge,07/17/2014 12:00:00 PM,48,-122,18,12,30
4741,SpokaneStBridge,07/17/2014 01:00:00 PM,48,-122,21,20,41
4742,SpokaneStBridge,07/17/2014 02:00:00 PM,48,-122,5,19,24
4743,SpokaneStBridge,07/17/2014 03:00:00 PM,48,-122,14,33,47
4744,SpokaneStBridge,07/17/2014 04:00:00 PM,48,-122,27,74,101
4745,SpokaneStBridge,07/17/2014 05:00:00 PM,48,-122,29,149,178
4746,SpokaneStBridge,07/17/2014 06:00:00 PM,48,-122,39,105,144
4747,SpokaneStBridge,07/17/2014 07:00:00 PM,48,-122,18,54,72
4748,SpokaneStBridge,07/17/2014 08:00:00 PM,48,-122,22,40,62
4749,SpokaneStBridge,07/17/2014 09:00:00 PM,48,-122,13,11,24
4750,SpokaneStBridge,07/17/2014 10:00:00 PM,48,-122,7,10,17
4751,SpokaneStBridge,07/17/2014 11:00:00 PM,48,-122,3,2,5
4752,SpokaneStBridge,07/18/2014 12:00:00 AM,48,-122,3,3,6
4753,SpokaneStBridge,07/18/2014 01:00:00 AM,48,-122,3,5,8
4754,SpokaneStBridge,07/18/2014 02:00:00 AM,48,-122,1,0,1
4755,SpokaneStBridge,07/18/2014 03:00:00 AM,48,-122,2,0,2
4756,SpokaneStBridge,07/18/2014 04:00:00 AM,48,-122,5,1,6
4757,SpokaneStBridge,07/18/2014 05:00:00 AM,48,-122,18,6,24
4758,SpokaneStBridge,07/18/2014 06:00:00 AM,48,-122,58,9,67
4759,SpokaneStBridge,07/18/2014 07:00:00 AM,48,-122,118,14,132
4760,SpokaneStBridge,07/18/2014 08:00:00 AM,48,-122,102,11,113
4761,SpokaneStBridge,07/18/2014 09:00:00 AM,48,-122,40,14,54
4762,SpokaneStBridge,07/18/2014 10:00:00 AM,48,-122,27,15,42
4763,SpokaneStBridge,07/18/2014 11:00:00 AM,48,-122,29,14,43
4764,SpokaneStBridge,07/18/2014 12:00:00 PM,48,-122,23,25,48
4765,SpokaneStBridge,07/18/2014 01:00:00 PM,48,-122,14,16,30
4766,SpokaneStBridge,07/18/2014 02:00:00 PM,48,-122,23,29,52
4767,SpokaneStBridge,07/18/2014 03:00:00 PM,48,-122,18,45,63
4768,SpokaneStBridge,07/18/2014 04:00:00 PM,48,-122,25,77,102
4769,SpokaneStBridge,07/18/2014 05:00:00 PM,48,-122,26,117,143
4770,SpokaneStBridge,07/18/2014 06:00:00 PM,48,-122,14,64,78
4771,SpokaneStBridge,07/18/2014 07:00:00 PM,48,-122,9,36,45
4772,SpokaneStBridge,07/18/2014 08:00:00 PM,48,-122,13,20,33
4773,SpokaneStBridge,07/18/2014 09:00:00 PM,48,-122,8,11,19
4774,SpokaneStBridge,07/18/2014 10:00:00 PM,48,-122,2,5,7
4775,SpokaneStBridge,07/18/2014 11:00:00 PM,48,-122,1,2,3
4776,SpokaneStBridge,07/19/2014 12:00:00 AM,48,-122,7,5,12
4777,SpokaneStBridge,07/19/2014 01:00:00 AM,48,-122,0,1,1
4778,SpokaneStBridge,07/19/2014 02:00:00 AM,48,-122,1,0,1
4779,SpokaneStBridge,07/19/2014 03:00:00 AM,48,-122,1,1,2
4780,SpokaneStBridge,07/19/2014 04:00:00 AM,48,-122,0,2,2
4781,SpokaneStBridge,07/19/2014 05:00:00 AM,48,-122,5,2,7
4782,SpokaneStBridge,07/19/2014 06:00:00 AM,48,-122,6,3,9
4783,SpokaneStBridge,07/19/2014 07:00:00 AM,48,-122,14,4,18
4784,SpokaneStBridge,07/19/2014 08:00:00 AM,48,-122,13,12,25
4785,SpokaneStBridge,07/19/2014 09:00:00 AM,48,-122,23,21,44
4786,SpokaneStBridge,07/19/2014 10:00:00 AM,48,-122,23,17,40
4787,SpokaneStBridge,07/19/2014 11:00:00 AM,48,-122,27,21,48
4788,SpokaneStBridge,07/19/2014 12:00:00 PM,48,-122,25,17,42
4789,SpokaneStBridge,07/19/2014 01:00:00 PM,48,-122,27,25,52
4790,SpokaneStBridge,07/19/2014 02:00:00 PM,48,-122,28,34,62
4791,SpokaneStBridge,07/19/2014 03:00:00 PM,48,-122,23,34,57
4792,SpokaneStBridge,07/19/2014 04:00:00 PM,48,-122,23,28,51
4793,SpokaneStBridge,07/19/2014 05:00:00 PM,48,-122,25,26,51
4794,SpokaneStBridge,07/19/2014 06:00:00 PM,48,-122,25,16,41
4795,SpokaneStBridge,07/19/2014 07:00:00 PM,48,-122,8,15,23
4796,SpokaneStBridge,07/19/2014 08:00:00 PM,48,-122,7,20,27
4797,SpokaneStBridge,07/19/2014 09:00:00 PM,48,-122,7,2,9
4798,SpokaneStBridge,07/19/2014 10:00:00 PM,48,-122,3,4,7
4799,SpokaneStBridge,07/19/2014 11:00:00 PM,48,-122,0,2,2
4800,SpokaneStBridge,07/20/2014 12:00:00 AM,48,-122,0,2,2
4801,SpokaneStBridge,07/20/2014 01:00:00 AM,48,-122,1,3,4
4802,SpokaneStBridge,07/20/2014 02:00:00 AM,48,-122,0,2,2
4803,SpokaneStBridge,07/20/2014 03:00:00 AM,48,-122,0,0,0
4804,SpokaneStBridge,07/20/2014 04:00:00 AM,48,-122,1,1,2
4805,SpokaneStBridge,07/20/2014 05:00:00 AM,48,-122,6,0,6
4806,SpokaneStBridge,07/20/2014 06:00:00 AM,48,-122,11,3,14
4807,SpokaneStBridge,07/20/2014 07:00:00 AM,48,-122,3,1,4
4808,SpokaneStBridge,07/20/2014 08:00:00 AM,48,-122,18,18,36
4809,SpokaneStBridge,07/20/2014 09:00:00 AM,48,-122,16,10,26
4810,SpokaneStBridge,07/20/2014 10:00:00 AM,48,-122,18,17,35
4811,SpokaneStBridge,07/20/2014 11:00:00 AM,48,-122,25,30,55
4812,SpokaneStBridge,07/20/2014 12:00:00 PM,48,-122,30,28,58
4813,SpokaneStBridge,07/20/2014 01:00:00 PM,48,-122,22,31,53
4814,SpokaneStBridge,07/20/2014 02:00:00 PM,48,-122,41,23,64
4815,SpokaneStBridge,07/20/2014 03:00:00 PM,48,-122,36,34,70
4816,SpokaneStBridge,07/20/2014 04:00:00 PM,48,-122,24,23,47
4817,SpokaneStBridge,07/20/2014 05:00:00 PM,48,-122,17,19,36
4818,SpokaneStBridge,07/20/2014 06:00:00 PM,48,-122,5,19,24
4819,SpokaneStBridge,07/20/2014 07:00:00 PM,48,-122,7,14,21
4820,SpokaneStBridge,07/20/2014 08:00:00 PM,48,-122,6,9,15
4821,SpokaneStBridge,07/20/2014 09:00:00 PM,48,-122,3,3,6
4822,SpokaneStBridge,07/20/2014 10:00:00 PM,48,-122,2,2,4
4823,SpokaneStBridge,07/20/2014 11:00:00 PM,48,-122,0,1,1
4824,SpokaneStBridge,07/21/2014 12:00:00 AM,48,-122,4,1,5
4825,SpokaneStBridge,07/21/2014 01:00:00 AM,48,-122,0,1,1
4826,SpokaneStBridge,07/21/2014 02:00:00 AM,48,-122,0,2,2
4827,SpokaneStBridge,07/21/2014 03:00:00 AM,48,-122,1,0,1
4828,SpokaneStBridge,07/21/2014 04:00:00 AM,48,-122,4,1,5
4829,SpokaneStBridge,07/21/2014 05:00:00 AM,48,-122,29,4,33
4830,SpokaneStBridge,07/21/2014 06:00:00 AM,48,-122,72,9,81
4831,SpokaneStBridge,07/21/2014 07:00:00 AM,48,-122,131,13,144
4832,SpokaneStBridge,07/21/2014 08:00:00 AM,48,-122,134,11,145
4833,SpokaneStBridge,07/21/2014 09:00:00 AM,48,-122,56,8,64
4834,SpokaneStBridge,07/21/2014 10:00:00 AM,48,-122,19,7,26
4835,SpokaneStBridge,07/21/2014 11:00:00 AM,48,-122,15,15,30
4836,SpokaneStBridge,07/21/2014 12:00:00 PM,48,-122,14,13,27
4837,SpokaneStBridge,07/21/2014 01:00:00 PM,48,-122,27,21,48
4838,SpokaneStBridge,07/21/2014 02:00:00 PM,48,-122,13,25,38
4839,SpokaneStBridge,07/21/2014 03:00:00 PM,48,-122,18,39,57
4840,SpokaneStBridge,07/21/2014 04:00:00 PM,48,-122,28,79,107
4841,SpokaneStBridge,07/21/2014 05:00:00 PM,48,-122,43,157,200
4842,SpokaneStBridge,07/21/2014 06:00:00 PM,48,-122,26,155,181
4843,SpokaneStBridge,07/21/2014 07:00:00 PM,48,-122,21,47,68
4844,SpokaneStBridge,07/21/2014 08:00:00 PM,48,-122,25,54,79
4845,SpokaneStBridge,07/21/2014 09:00:00 PM,48,-122,10,10,20
4846,SpokaneStBridge,07/21/2014 10:00:00 PM,48,-122,4,13,17
4847,SpokaneStBridge,07/21/2014 11:00:00 PM,48,-122,5,5,10
4848,SpokaneStBridge,07/22/2014 12:00:00 AM,48,-122,1,4,5
4849,SpokaneStBridge,07/22/2014 01:00:00 AM,48,-122,2,2,4
4850,SpokaneStBridge,07/22/2014 02:00:00 AM,48,-122,1,2,3
4851,SpokaneStBridge,07/22/2014 03:00:00 AM,48,-122,3,1,4
4852,SpokaneStBridge,07/22/2014 04:00:00 AM,48,-122,4,3,7
4853,SpokaneStBridge,07/22/2014 05:00:00 AM,48,-122,33,5,38
4854,SpokaneStBridge,07/22/2014 06:00:00 AM,48,-122,86,6,92
4855,SpokaneStBridge,07/22/2014 07:00:00 AM,48,-122,142,19,161
4856,SpokaneStBridge,07/22/2014 08:00:00 AM,48,-122,140,14,154
4857,SpokaneStBridge,07/22/2014 09:00:00 AM,48,-122,60,8,68
4858,SpokaneStBridge,07/22/2014 10:00:00 AM,48,-122,21,3,24
4859,SpokaneStBridge,07/22/2014 11:00:00 AM,48,-122,17,7,24
4860,SpokaneStBridge,07/22/2014 12:00:00 PM,48,-122,15,13,28
4861,SpokaneStBridge,07/22/2014 01:00:00 PM,48,-122,18,15,33
4862,SpokaneStBridge,07/22/2014 02:00:00 PM,48,-122,13,23,36
4863,SpokaneStBridge,07/22/2014 03:00:00 PM,48,-122,18,41,59
4864,SpokaneStBridge,07/22/2014 04:00:00 PM,48,-122,19,80,99
4865,SpokaneStBridge,07/22/2014 05:00:00 PM,48,-122,37,168,205
4866,SpokaneStBridge,07/22/2014 06:00:00 PM,48,-122,23,128,151
4867,SpokaneStBridge,07/22/2014 07:00:00 PM,48,-122,10,54,64
4868,SpokaneStBridge,07/22/2014 08:00:00 PM,48,-122,7,18,25
4869,SpokaneStBridge,07/22/2014 09:00:00 PM,48,-122,9,7,16
4870,SpokaneStBridge,07/22/2014 10:00:00 PM,48,-122,6,11,17
4871,SpokaneStBridge,07/22/2014 11:00:00 PM,48,-122,0,8,8
4872,SpokaneStBridge,07/23/2014 12:00:00 AM,48,-122,0,3,3
4873,SpokaneStBridge,07/23/2014 01:00:00 AM,48,-122,0,1,1
4874,SpokaneStBridge,07/23/2014 02:00:00 AM,48,-122,1,0,1
4875,SpokaneStBridge,07/23/2014 03:00:00 AM,48,-122,2,1,3
4876,SpokaneStBridge,07/23/2014 04:00:00 AM,48,-122,3,2,5
4877,SpokaneStBridge,07/23/2014 05:00:00 AM,48,-122,19,3,22
4878,SpokaneStBridge,07/23/2014 06:00:00 AM,48,-122,62,7,69
4879,SpokaneStBridge,07/23/2014 07:00:00 AM,48,-122,65,9,74
4880,SpokaneStBridge,07/23/2014 08:00:00 AM,48,-122,68,7,75
4881,SpokaneStBridge,07/23/2014 09:00:00 AM,48,-122,35,1,36
4882,SpokaneStBridge,07/23/2014 10:00:00 AM,48,-122,6,2,8
4883,SpokaneStBridge,07/23/2014 11:00:00 AM,48,-122,6,0,6
4884,SpokaneStBridge,07/23/2014 12:00:00 PM,48,-122,5,5,10
4885,SpokaneStBridge,07/23/2014 01:00:00 PM,48,-122,8,5,13
4886,SpokaneStBridge,07/23/2014 02:00:00 PM,48,-122,1,10,11
4887,SpokaneStBridge,07/23/2014 03:00:00 PM,48,-122,2,14,16
4888,SpokaneStBridge,07/23/2014 04:00:00 PM,48,-122,7,34,41
4889,SpokaneStBridge,07/23/2014 05:00:00 PM,48,-122,18,72,90
4890,SpokaneStBridge,07/23/2014 06:00:00 PM,48,-122,5,58,63
4891,SpokaneStBridge,07/23/2014 07:00:00 PM,48,-122,10,32,42
4892,SpokaneStBridge,07/23/2014 08:00:00 PM,48,-122,12,8,20
4893,SpokaneStBridge,07/23/2014 09:00:00 PM,48,-122,0,2,2
4894,SpokaneStBridge,07/23/2014 10:00:00 PM,48,-122,0,4,4
4895,SpokaneStBridge,07/23/2014 11:00:00 PM,48,-122,1,2,3
4896,SpokaneStBridge,07/24/2014 12:00:00 AM,48,-122,1,0,1
4897,SpokaneStBridge,07/24/2014 01:00:00 AM,48,-122,0,0,0
4898,SpokaneStBridge,07/24/2014 02:00:00 AM,48,-122,2,3,5
4899,SpokaneStBridge,07/24/2014 03:00:00 AM,48,-122,1,0,1
4900,SpokaneStBridge,07/24/2014 04:00:00 AM,48,-122,4,0,4
4901,SpokaneStBridge,07/24/2014 05:00:00 AM,48,-122,21,3,24
4902,SpokaneStBridge,07/24/2014 06:00:00 AM,48,-122,51,7,58
4903,SpokaneStBridge,07/24/2014 07:00:00 AM,48,-122,96,15,111
4904,SpokaneStBridge,07/24/2014 08:00:00 AM,48,-122,94,10,104
4905,SpokaneStBridge,07/24/2014 09:00:00 AM,48,-122,33,3,36
4906,SpokaneStBridge,07/24/2014 10:00:00 AM,48,-122,23,1,24
4907,SpokaneStBridge,07/24/2014 11:00:00 AM,48,-122,11,6,17
4908,SpokaneStBridge,07/24/2014 12:00:00 PM,48,-122,17,6,23
4909,SpokaneStBridge,07/24/2014 01:00:00 PM,48,-122,14,20,34
4910,SpokaneStBridge,07/24/2014 02:00:00 PM,48,-122,11,15,26
4911,SpokaneStBridge,07/24/2014 03:00:00 PM,48,-122,9,31,40
4912,SpokaneStBridge,07/24/2014 04:00:00 PM,48,-122,19,57,76
4913,SpokaneStBridge,07/24/2014 05:00:00 PM,48,-122,24,126,150
4914,SpokaneStBridge,07/24/2014 06:00:00 PM,48,-122,16,74,90
4915,SpokaneStBridge,07/24/2014 07:00:00 PM,48,-122,11,27,38
4916,SpokaneStBridge,07/24/2014 08:00:00 PM,48,-122,8,15,23
4917,SpokaneStBridge,07/24/2014 09:00:00 PM,48,-122,5,7,12
4918,SpokaneStBridge,07/24/2014 10:00:00 PM,48,-122,4,11,15
4919,SpokaneStBridge,07/24/2014 11:00:00 PM,48,-122,4,2,6
4920,SpokaneStBridge,07/25/2014 12:00:00 AM,48,-122,6,0,6
4921,SpokaneStBridge,07/25/2014 01:00:00 AM,48,-122,3,3,6
4922,SpokaneStBridge,07/25/2014 02:00:00 AM,48,-122,11,1,12
4923,SpokaneStBridge,07/25/2014 03:00:00 AM,48,-122,2,0,2
4924,SpokaneStBridge,07/25/2014 04:00:00 AM,48,-122,7,0,7
4925,SpokaneStBridge,07/25/2014 05:00:00 AM,48,-122,25,6,31
4926,SpokaneStBridge,07/25/2014 06:00:00 AM,48,-122,56,7,63
4927,SpokaneStBridge,07/25/2014 07:00:00 AM,48,-122,90,17,107
4928,SpokaneStBridge,07/25/2014 08:00:00 AM,48,-122,100,15,115
4929,SpokaneStBridge,07/25/2014 09:00:00 AM,48,-122,60,14,74
4930,SpokaneStBridge,07/25/2014 10:00:00 AM,48,-122,53,12,65
4931,SpokaneStBridge,07/25/2014 11:00:00 AM,48,-122,23,8,31
4932,SpokaneStBridge,07/25/2014 12:00:00 PM,48,-122,13,19,32
4933,SpokaneStBridge,07/25/2014 01:00:00 PM,48,-122,18,23,41
4934,SpokaneStBridge,07/25/2014 02:00:00 PM,48,-122,15,45,60
4935,SpokaneStBridge,07/25/2014 03:00:00 PM,48,-122,17,42,59
4936,SpokaneStBridge,07/25/2014 04:00:00 PM,48,-122,23,85,108
4937,SpokaneStBridge,07/25/2014 05:00:00 PM,48,-122,34,128,162
4938,SpokaneStBridge,07/25/2014 06:00:00 PM,48,-122,22,86,108
4939,SpokaneStBridge,07/25/2014 07:00:00 PM,48,-122,17,41,58
4940,SpokaneStBridge,07/25/2014 08:00:00 PM,48,-122,20,19,39
4941,SpokaneStBridge,07/25/2014 09:00:00 PM,48,-122,4,4,8
4942,SpokaneStBridge,07/25/2014 10:00:00 PM,48,-122,2,7,9
4943,SpokaneStBridge,07/25/2014 11:00:00 PM,48,-122,5,11,16
4944,SpokaneStBridge,07/26/2014 12:00:00 AM,48,-122,0,6,6
4945,SpokaneStBridge,07/26/2014 01:00:00 AM,48,-122,2,4,6
4946,SpokaneStBridge,07/26/2014 02:00:00 AM,48,-122,1,0,1
4947,SpokaneStBridge,07/26/2014 03:00:00 AM,48,-122,0,2,2
4948,SpokaneStBridge,07/26/2014 04:00:00 AM,48,-122,1,0,1
4949,SpokaneStBridge,07/26/2014 05:00:00 AM,48,-122,4,0,4
4950,SpokaneStBridge,07/26/2014 06:00:00 AM,48,-122,11,8,19
4951,SpokaneStBridge,07/26/2014 07:00:00 AM,48,-122,18,11,29
4952,SpokaneStBridge,07/26/2014 08:00:00 AM,48,-122,34,18,52
4953,SpokaneStBridge,07/26/2014 09:00:00 AM,48,-122,21,34,55
4954,SpokaneStBridge,07/26/2014 10:00:00 AM,48,-122,35,25,60
4955,SpokaneStBridge,07/26/2014 11:00:00 AM,48,-122,46,37,83
4956,SpokaneStBridge,07/26/2014 12:00:00 PM,48,-122,44,52,96
4957,SpokaneStBridge,07/26/2014 01:00:00 PM,48,-122,32,37,69
4958,SpokaneStBridge,07/26/2014 02:00:00 PM,48,-122,44,41,85
4959,SpokaneStBridge,07/26/2014 03:00:00 PM,48,-122,34,71,105
4960,SpokaneStBridge,07/26/2014 04:00:00 PM,48,-122,36,39,75
4961,SpokaneStBridge,07/26/2014 05:00:00 PM,48,-122,29,30,59
4962,SpokaneStBridge,07/26/2014 06:00:00 PM,48,-122,26,34,60
4963,SpokaneStBridge,07/26/2014 07:00:00 PM,48,-122,25,20,45
4964,SpokaneStBridge,07/26/2014 08:00:00 PM,48,-122,14,13,27
4965,SpokaneStBridge,07/26/2014 09:00:00 PM,48,-122,10,6,16
4966,SpokaneStBridge,07/26/2014 10:00:00 PM,48,-122,7,4,11
4967,SpokaneStBridge,07/26/2014 11:00:00 PM,48,-122,8,6,14
4968,SpokaneStBridge,07/27/2014 12:00:00 AM,48,-122,4,3,7
4969,SpokaneStBridge,07/27/2014 01:00:00 AM,48,-122,2,4,6
4970,SpokaneStBridge,07/27/2014 02:00:00 AM,48,-122,3,1,4
4971,SpokaneStBridge,07/27/2014 03:00:00 AM,48,-122,0,1,1
4972,SpokaneStBridge,07/27/2014 04:00:00 AM,48,-122,1,2,3
4973,SpokaneStBridge,07/27/2014 05:00:00 AM,48,-122,7,0,7
4974,SpokaneStBridge,07/27/2014 06:00:00 AM,48,-122,5,0,5
4975,SpokaneStBridge,07/27/2014 07:00:00 AM,48,-122,11,3,14
4976,SpokaneStBridge,07/27/2014 08:00:00 AM,48,-122,9,12,21
4977,SpokaneStBridge,07/27/2014 09:00:00 AM,48,-122,34,31,65
4978,SpokaneStBridge,07/27/2014 10:00:00 AM,48,-122,48,24,72
4979,SpokaneStBridge,07/27/2014 11:00:00 AM,48,-122,41,39,80
4980,SpokaneStBridge,07/27/2014 12:00:00 PM,48,-122,45,38,83
4981,SpokaneStBridge,07/27/2014 01:00:00 PM,48,-122,33,59,92
4982,SpokaneStBridge,07/27/2014 02:00:00 PM,48,-122,33,50,83
4983,SpokaneStBridge,07/27/2014 03:00:00 PM,48,-122,44,40,84
4984,SpokaneStBridge,07/27/2014 04:00:00 PM,48,-122,31,44,75
4985,SpokaneStBridge,07/27/2014 05:00:00 PM,48,-122,43,37,80
4986,SpokaneStBridge,07/27/2014 06:00:00 PM,48,-122,28,35,63
4987,SpokaneStBridge,07/27/2014 07:00:00 PM,48,-122,21,17,38
4988,SpokaneStBridge,07/27/2014 08:00:00 PM,48,-122,13,18,31
4989,SpokaneStBridge,07/27/2014 09:00:00 PM,48,-122,18,7,25
4990,SpokaneStBridge,07/27/2014 10:00:00 PM,48,-122,5,7,12
4991,SpokaneStBridge,07/27/2014 11:00:00 PM,48,-122,8,2,10
4992,SpokaneStBridge,07/28/2014 12:00:00 AM,48,-122,1,4,5
4993,SpokaneStBridge,07/28/2014 01:00:00 AM,48,-122,0,2,2
4994,SpokaneStBridge,07/28/2014 02:00:00 AM,48,-122,1,1,2
4995,SpokaneStBridge,07/28/2014 03:00:00 AM,48,-122,2,2,4
4996,SpokaneStBridge,07/28/2014 04:00:00 AM,48,-122,3,1,4
4997,SpokaneStBridge,07/28/2014 05:00:00 AM,48,-122,21,5,26
4998,SpokaneStBridge,07/28/2014 06:00:00 AM,48,-122,65,13,78
4999,SpokaneStBridge,07/28/2014 07:00:00 AM,48,-122,157,19,176
5000,SpokaneStBridge,07/28/2014 08:00:00 AM,48,-122,132,14,146
5001,SpokaneStBridge,07/28/2014 09:00:00 AM,48,-122,63,7,70
5002,SpokaneStBridge,07/28/2014 10:00:00 AM,48,-122,30,12,42
5003,SpokaneStBridge,07/28/2014 11:00:00 AM,48,-122,12,15,27
5004,SpokaneStBridge,07/28/2014 12:00:00 PM,48,-122,25,18,43
5005,SpokaneStBridge,07/28/2014 01:00:00 PM,48,-122,16,14,30
5006,SpokaneStBridge,07/28/2014 02:00:00 PM,48,-122,18,33,51
5007,SpokaneStBridge,07/28/2014 03:00:00 PM,48,-122,27,30,57
5008,SpokaneStBridge,07/28/2014 04:00:00 PM,48,-122,28,79,107
5009,SpokaneStBridge,07/28/2014 05:00:00 PM,48,-122,30,170,200
5010,SpokaneStBridge,07/28/2014 06:00:00 PM,48,-122,32,129,161
5011,SpokaneStBridge,07/28/2014 07:00:00 PM,48,-122,24,67,91
5012,SpokaneStBridge,07/28/2014 08:00:00 PM,48,-122,14,20,34
5013,SpokaneStBridge,07/28/2014 09:00:00 PM,48,-122,9,28,37
5014,SpokaneStBridge,07/28/2014 10:00:00 PM,48,-122,7,9,16
5015,SpokaneStBridge,07/28/2014 11:00:00 PM,48,-122,1,6,7
5016,SpokaneStBridge,07/29/2014 12:00:00 AM,48,-122,0,1,1
5017,SpokaneStBridge,07/29/2014 01:00:00 AM,48,-122,1,4,5
5018,SpokaneStBridge,07/29/2014 02:00:00 AM,48,-122,1,2,3
5019,SpokaneStBridge,07/29/2014 03:00:00 AM,48,-122,1,1,2
5020,SpokaneStBridge,07/29/2014 04:00:00 AM,48,-122,4,3,7
5021,SpokaneStBridge,07/29/2014 05:00:00 AM,48,-122,31,7,38
5022,SpokaneStBridge,07/29/2014 06:00:00 AM,48,-122,84,8,92
5023,SpokaneStBridge,07/29/2014 07:00:00 AM,48,-122,152,24,176
5024,SpokaneStBridge,07/29/2014 08:00:00 AM,48,-122,151,22,173
5025,SpokaneStBridge,07/29/2014 09:00:00 AM,48,-122,69,9,78
5026,SpokaneStBridge,07/29/2014 10:00:00 AM,48,-122,27,12,39
5027,SpokaneStBridge,07/29/2014 11:00:00 AM,48,-122,21,16,37
5028,SpokaneStBridge,07/29/2014 12:00:00 PM,48,-122,16,22,38
5029,SpokaneStBridge,07/29/2014 01:00:00 PM,48,-122,28,24,52
5030,SpokaneStBridge,07/29/2014 02:00:00 PM,48,-122,17,25,42
5031,SpokaneStBridge,07/29/2014 03:00:00 PM,48,-122,18,31,49
5032,SpokaneStBridge,07/29/2014 04:00:00 PM,48,-122,31,83,114
5033,SpokaneStBridge,07/29/2014 05:00:00 PM,48,-122,40,207,247
5034,SpokaneStBridge,07/29/2014 06:00:00 PM,48,-122,26,133,159
5035,SpokaneStBridge,07/29/2014 07:00:00 PM,48,-122,17,59,76
5036,SpokaneStBridge,07/29/2014 08:00:00 PM,48,-122,19,38,57
5037,SpokaneStBridge,07/29/2014 09:00:00 PM,48,-122,8,8,16
5038,SpokaneStBridge,07/29/2014 10:00:00 PM,48,-122,4,8,12
5039,SpokaneStBridge,07/29/2014 11:00:00 PM,48,-122,3,6,9
5040,SpokaneStBridge,07/30/2014 12:00:00 AM,48,-122,1,5,6
5041,SpokaneStBridge,07/30/2014 01:00:00 AM,48,-122,1,2,3
5042,SpokaneStBridge,07/30/2014 02:00:00 AM,48,-122,1,3,4
5043,SpokaneStBridge,07/30/2014 03:00:00 AM,48,-122,3,1,4
5044,SpokaneStBridge,07/30/2014 04:00:00 AM,48,-122,4,2,6
5045,SpokaneStBridge,07/30/2014 05:00:00 AM,48,-122,24,11,35
5046,SpokaneStBridge,07/30/2014 06:00:00 AM,48,-122,77,10,87
5047,SpokaneStBridge,07/30/2014 07:00:00 AM,48,-122,154,21,175
5048,SpokaneStBridge,07/30/2014 08:00:00 AM,48,-122,149,20,169
5049,SpokaneStBridge,07/30/2014 09:00:00 AM,48,-122,61,11,72
5050,SpokaneStBridge,07/30/2014 10:00:00 AM,48,-122,33,13,46
5051,SpokaneStBridge,07/30/2014 11:00:00 AM,48,-122,22,13,35
5052,SpokaneStBridge,07/30/2014 12:00:00 PM,48,-122,20,15,35
5053,SpokaneStBridge,07/30/2014 01:00:00 PM,48,-122,23,20,43
5054,SpokaneStBridge,07/30/2014 02:00:00 PM,48,-122,24,27,51
5055,SpokaneStBridge,07/30/2014 03:00:00 PM,48,-122,18,35,53
5056,SpokaneStBridge,07/30/2014 04:00:00 PM,48,-122,29,90,119
5057,SpokaneStBridge,07/30/2014 05:00:00 PM,48,-122,31,181,212
5058,SpokaneStBridge,07/30/2014 06:00:00 PM,48,-122,27,119,146
5059,SpokaneStBridge,07/30/2014 07:00:00 PM,48,-122,16,57,73
5060,SpokaneStBridge,07/30/2014 08:00:00 PM,48,-122,21,41,62
5061,SpokaneStBridge,07/30/2014 09:00:00 PM,48,-122,16,12,28
5062,SpokaneStBridge,07/30/2014 10:00:00 PM,48,-122,5,14,19
5063,SpokaneStBridge,07/30/2014 11:00:00 PM,48,-122,3,6,9
5064,SpokaneStBridge,07/31/2014 12:00:00 AM,48,-122,3,2,5
5065,SpokaneStBridge,07/31/2014 01:00:00 AM,48,-122,1,1,2
5066,SpokaneStBridge,07/31/2014 02:00:00 AM,48,-122,2,2,4
5067,SpokaneStBridge,07/31/2014 03:00:00 AM,48,-122,1,2,3
5068,SpokaneStBridge,07/31/2014 04:00:00 AM,48,-122,3,2,5
5069,SpokaneStBridge,07/31/2014 05:00:00 AM,48,-122,26,6,32
5070,SpokaneStBridge,07/31/2014 06:00:00 AM,48,-122,23,13,36
5071,SpokaneStBridge,07/31/2014 07:00:00 AM,48,-122,146,14,160
5072,SpokaneStBridge,07/31/2014 08:00:00 AM,48,-122,133,19,152
5073,SpokaneStBridge,07/31/2014 09:00:00 AM,48,-122,61,9,70
5074,SpokaneStBridge,07/31/2014 10:00:00 AM,48,-122,19,16,35
5075,SpokaneStBridge,07/31/2014 11:00:00 AM,48,-122,23,7,30
5076,SpokaneStBridge,07/31/2014 12:00:00 PM,48,-122,30,15,45
5077,SpokaneStBridge,07/31/2014 01:00:00 PM,48,-122,13,13,26
5078,SpokaneStBridge,07/31/2014 02:00:00 PM,48,-122,20,23,43
5079,SpokaneStBridge,07/31/2014 03:00:00 PM,48,-122,22,33,55
5080,SpokaneStBridge,07/31/2014 04:00:00 PM,48,-122,21,70,91
5081,SpokaneStBridge,07/31/2014 05:00:00 PM,48,-122,22,164,186
5082,SpokaneStBridge,07/31/2014 06:00:00 PM,48,-122,18,112,130
5083,SpokaneStBridge,07/31/2014 07:00:00 PM,48,-122,33,55,88
5084,SpokaneStBridge,07/31/2014 08:00:00 PM,48,-122,16,33,49
5085,SpokaneStBridge,07/31/2014 09:00:00 PM,48,-122,6,8,14
5086,SpokaneStBridge,07/31/2014 10:00:00 PM,48,-122,4,14,18
5087,SpokaneStBridge,07/31/2014 11:00:00 PM,48,-122,4,6,10
5088,SpokaneStBridge,08/01/2014 12:00:00 AM,48,-122,4,1,5
5089,SpokaneStBridge,08/01/2014 01:00:00 AM,48,-122,2,1,3
5090,SpokaneStBridge,08/01/2014 02:00:00 AM,48,-122,4,3,7
5091,SpokaneStBridge,08/01/2014 03:00:00 AM,48,-122,0,2,2
5092,SpokaneStBridge,08/01/2014 04:00:00 AM,48,-122,3,0,3
5093,SpokaneStBridge,08/01/2014 05:00:00 AM,48,-122,22,4,26
5094,SpokaneStBridge,08/01/2014 06:00:00 AM,48,-122,62,7,69
5095,SpokaneStBridge,08/01/2014 07:00:00 AM,48,-122,125,17,142
5096,SpokaneStBridge,08/01/2014 08:00:00 AM,48,-122,117,15,132
5097,SpokaneStBridge,08/01/2014 09:00:00 AM,48,-122,54,6,60
5098,SpokaneStBridge,08/01/2014 10:00:00 AM,48,-122,23,16,39
5099,SpokaneStBridge,08/01/2014 11:00:00 AM,48,-122,16,10,26
5100,SpokaneStBridge,08/01/2014 12:00:00 PM,48,-122,29,12,41
5101,SpokaneStBridge,08/01/2014 01:00:00 PM,48,-122,15,23,38
5102,SpokaneStBridge,08/01/2014 02:00:00 PM,48,-122,13,25,38
5103,SpokaneStBridge,08/01/2014 03:00:00 PM,48,-122,16,49,65
5104,SpokaneStBridge,08/01/2014 04:00:00 PM,48,-122,36,87,123
5105,SpokaneStBridge,08/01/2014 05:00:00 PM,48,-122,42,136,178
5106,SpokaneStBridge,08/01/2014 06:00:00 PM,48,-122,21,158,179
5107,SpokaneStBridge,08/01/2014 07:00:00 PM,48,-122,19,40,59
5108,SpokaneStBridge,08/01/2014 08:00:00 PM,48,-122,5,25,30
5109,SpokaneStBridge,08/01/2014 09:00:00 PM,48,-122,7,14,21
5110,SpokaneStBridge,08/01/2014 10:00:00 PM,48,-122,7,9,16
5111,SpokaneStBridge,08/01/2014 11:00:00 PM,48,-122,7,8,15
5112,SpokaneStBridge,08/02/2014 12:00:00 AM,48,-122,2,15,17
5113,SpokaneStBridge,08/02/2014 01:00:00 AM,48,-122,0,9,9
5114,SpokaneStBridge,08/02/2014 02:00:00 AM,48,-122,4,7,11
5115,SpokaneStBridge,08/02/2014 03:00:00 AM,48,-122,4,3,7
5116,SpokaneStBridge,08/02/2014 04:00:00 AM,48,-122,1,3,4
5117,SpokaneStBridge,08/02/2014 05:00:00 AM,48,-122,3,1,4
5118,SpokaneStBridge,08/02/2014 06:00:00 AM,48,-122,14,1,15
5119,SpokaneStBridge,08/02/2014 07:00:00 AM,48,-122,10,4,14
5120,SpokaneStBridge,08/02/2014 08:00:00 AM,48,-122,24,19,43
5121,SpokaneStBridge,08/02/2014 09:00:00 AM,48,-122,21,16,37
5122,SpokaneStBridge,08/02/2014 10:00:00 AM,48,-122,31,35,66
5123,SpokaneStBridge,08/02/2014 11:00:00 AM,48,-122,24,44,68
5124,SpokaneStBridge,08/02/2014 12:00:00 PM,48,-122,55,22,77
5125,SpokaneStBridge,08/02/2014 01:00:00 PM,48,-122,41,26,67
5126,SpokaneStBridge,08/02/2014 02:00:00 PM,48,-122,39,27,66
5127,SpokaneStBridge,08/02/2014 03:00:00 PM,48,-122,37,35,72
5128,SpokaneStBridge,08/02/2014 04:00:00 PM,48,-122,29,43,72
5129,SpokaneStBridge,08/02/2014 05:00:00 PM,48,-122,25,24,49
5130,SpokaneStBridge,08/02/2014 06:00:00 PM,48,-122,26,29,55
5131,SpokaneStBridge,08/02/2014 07:00:00 PM,48,-122,9,11,20
5132,SpokaneStBridge,08/02/2014 08:00:00 PM,48,-122,19,4,23
5133,SpokaneStBridge,08/02/2014 09:00:00 PM,48,-122,2,3,5
5134,SpokaneStBridge,08/02/2014 10:00:00 PM,48,-122,3,3,6
5135,SpokaneStBridge,08/02/2014 11:00:00 PM,48,-122,4,7,11
5136,SpokaneStBridge,08/03/2014 12:00:00 AM,48,-122,3,4,7
5137,SpokaneStBridge,08/03/2014 01:00:00 AM,48,-122,1,5,6
5138,SpokaneStBridge,08/03/2014 02:00:00 AM,48,-122,0,1,1
5139,SpokaneStBridge,08/03/2014 03:00:00 AM,48,-122,0,2,2
5140,SpokaneStBridge,08/03/2014 04:00:00 AM,48,-122,1,0,1
5141,SpokaneStBridge,08/03/2014 05:00:00 AM,48,-122,3,0,3
5142,SpokaneStBridge,08/03/2014 06:00:00 AM,48,-122,8,2,10
5143,SpokaneStBridge,08/03/2014 07:00:00 AM,48,-122,7,4,11
5144,SpokaneStBridge,08/03/2014 08:00:00 AM,48,-122,22,7,29
5145,SpokaneStBridge,08/03/2014 09:00:00 AM,48,-122,20,16,36
5146,SpokaneStBridge,08/03/2014 10:00:00 AM,48,-122,33,31,64
5147,SpokaneStBridge,08/03/2014 11:00:00 AM,48,-122,56,38,94
5148,SpokaneStBridge,08/03/2014 12:00:00 PM,48,-122,48,44,92
5149,SpokaneStBridge,08/03/2014 01:00:00 PM,48,-122,47,49,96
5150,SpokaneStBridge,08/03/2014 02:00:00 PM,48,-122,25,29,54
5151,SpokaneStBridge,08/03/2014 03:00:00 PM,48,-122,43,55,98
5152,SpokaneStBridge,08/03/2014 04:00:00 PM,48,-122,31,48,79
5153,SpokaneStBridge,08/03/2014 05:00:00 PM,48,-122,23,42,65
5154,SpokaneStBridge,08/03/2014 06:00:00 PM,48,-122,27,26,53
5155,SpokaneStBridge,08/03/2014 07:00:00 PM,48,-122,23,15,38
5156,SpokaneStBridge,08/03/2014 08:00:00 PM,48,-122,7,9,16
5157,SpokaneStBridge,08/03/2014 09:00:00 PM,48,-122,6,3,9
5158,SpokaneStBridge,08/03/2014 10:00:00 PM,48,-122,2,3,5
5159,SpokaneStBridge,08/03/2014 11:00:00 PM,48,-122,2,1,3
5160,SpokaneStBridge,08/04/2014 12:00:00 AM,48,-122,1,0,1
5161,SpokaneStBridge,08/04/2014 01:00:00 AM,48,-122,1,1,2
5162,SpokaneStBridge,08/04/2014 02:00:00 AM,48,-122,1,1,2
5163,SpokaneStBridge,08/04/2014 03:00:00 AM,48,-122,2,1,3
5164,SpokaneStBridge,08/04/2014 04:00:00 AM,48,-122,1,2,3
5165,SpokaneStBridge,08/04/2014 05:00:00 AM,48,-122,19,5,24
5166,SpokaneStBridge,08/04/2014 06:00:00 AM,48,-122,73,11,84
5167,SpokaneStBridge,08/04/2014 07:00:00 AM,48,-122,139,13,152
5168,SpokaneStBridge,08/04/2014 08:00:00 AM,48,-122,125,9,134
5169,SpokaneStBridge,08/04/2014 09:00:00 AM,48,-122,60,13,73
5170,SpokaneStBridge,08/04/2014 10:00:00 AM,48,-122,18,8,26
5171,SpokaneStBridge,08/04/2014 11:00:00 AM,48,-122,10,17,27
5172,SpokaneStBridge,08/04/2014 12:00:00 PM,48,-122,12,11,23
5173,SpokaneStBridge,08/04/2014 01:00:00 PM,48,-122,16,16,32
5174,SpokaneStBridge,08/04/2014 02:00:00 PM,48,-122,12,6,18
5175,SpokaneStBridge,08/04/2014 03:00:00 PM,48,-122,13,45,58
5176,SpokaneStBridge,08/04/2014 04:00:00 PM,48,-122,22,69,91
5177,SpokaneStBridge,08/04/2014 05:00:00 PM,48,-122,44,166,210
5178,SpokaneStBridge,08/04/2014 06:00:00 PM,48,-122,23,108,131
5179,SpokaneStBridge,08/04/2014 07:00:00 PM,48,-122,16,54,70
5180,SpokaneStBridge,08/04/2014 08:00:00 PM,48,-122,14,25,39
5181,SpokaneStBridge,08/04/2014 09:00:00 PM,48,-122,9,16,25
5182,SpokaneStBridge,08/04/2014 10:00:00 PM,48,-122,2,9,11
5183,SpokaneStBridge,08/04/2014 11:00:00 PM,48,-122,2,5,7
5184,SpokaneStBridge,08/05/2014 12:00:00 AM,48,-122,0,3,3
5185,SpokaneStBridge,08/05/2014 01:00:00 AM,48,-122,1,1,2
5186,SpokaneStBridge,08/05/2014 02:00:00 AM,48,-122,0,0,0
5187,SpokaneStBridge,08/05/2014 03:00:00 AM,48,-122,1,0,1
5188,SpokaneStBridge,08/05/2014 04:00:00 AM,48,-122,1,2,3
5189,SpokaneStBridge,08/05/2014 05:00:00 AM,48,-122,25,5,30
5190,SpokaneStBridge,08/05/2014 06:00:00 AM,48,-122,75,12,87
5191,SpokaneStBridge,08/05/2014 07:00:00 AM,48,-122,151,21,172
5192,SpokaneStBridge,08/05/2014 08:00:00 AM,48,-122,128,13,141
5193,SpokaneStBridge,08/05/2014 09:00:00 AM,48,-122,64,7,71
5194,SpokaneStBridge,08/05/2014 10:00:00 AM,48,-122,28,5,33
5195,SpokaneStBridge,08/05/2014 11:00:00 AM,48,-122,14,15,29
5196,SpokaneStBridge,08/05/2014 12:00:00 PM,48,-122,15,14,29
5197,SpokaneStBridge,08/05/2014 01:00:00 PM,48,-122,19,14,33
5198,SpokaneStBridge,08/05/2014 02:00:00 PM,48,-122,18,18,36
5199,SpokaneStBridge,08/05/2014 03:00:00 PM,48,-122,16,33,49
5200,SpokaneStBridge,08/05/2014 04:00:00 PM,48,-122,23,91,114
5201,SpokaneStBridge,08/05/2014 05:00:00 PM,48,-122,32,172,204
5202,SpokaneStBridge,08/05/2014 06:00:00 PM,48,-122,27,111,138
5203,SpokaneStBridge,08/05/2014 07:00:00 PM,48,-122,17,52,69
5204,SpokaneStBridge,08/05/2014 08:00:00 PM,48,-122,18,28,46
5205,SpokaneStBridge,08/05/2014 09:00:00 PM,48,-122,4,14,18
5206,SpokaneStBridge,08/05/2014 10:00:00 PM,48,-122,3,7,10
5207,SpokaneStBridge,08/05/2014 11:00:00 PM,48,-122,1,10,11
5208,SpokaneStBridge,08/06/2014 12:00:00 AM,48,-122,1,1,2
5209,SpokaneStBridge,08/06/2014 01:00:00 AM,48,-122,1,2,3
5210,SpokaneStBridge,08/06/2014 02:00:00 AM,48,-122,0,0,0
5211,SpokaneStBridge,08/06/2014 03:00:00 AM,48,-122,1,0,1
5212,SpokaneStBridge,08/06/2014 04:00:00 AM,48,-122,1,1,2
5213,SpokaneStBridge,08/06/2014 05:00:00 AM,48,-122,20,4,24
5214,SpokaneStBridge,08/06/2014 06:00:00 AM,48,-122,66,8,74
5215,SpokaneStBridge,08/06/2014 07:00:00 AM,48,-122,141,14,155
5216,SpokaneStBridge,08/06/2014 08:00:00 AM,48,-122,136,18,154
5217,SpokaneStBridge,08/06/2014 09:00:00 AM,48,-122,65,10,75
5218,SpokaneStBridge,08/06/2014 10:00:00 AM,48,-122,19,8,27
5219,SpokaneStBridge,08/06/2014 11:00:00 AM,48,-122,33,10,43
5220,SpokaneStBridge,08/06/2014 12:00:00 PM,48,-122,20,11,31
5221,SpokaneStBridge,08/06/2014 01:00:00 PM,48,-122,18,32,50
5222,SpokaneStBridge,08/06/2014 02:00:00 PM,48,-122,14,24,38
5223,SpokaneStBridge,08/06/2014 03:00:00 PM,48,-122,20,36,56
5224,SpokaneStBridge,08/06/2014 04:00:00 PM,48,-122,29,93,122
5225,SpokaneStBridge,08/06/2014 05:00:00 PM,48,-122,31,159,190
5226,SpokaneStBridge,08/06/2014 06:00:00 PM,48,-122,25,122,147
5227,SpokaneStBridge,08/06/2014 07:00:00 PM,48,-122,24,61,85
5228,SpokaneStBridge,08/06/2014 08:00:00 PM,48,-122,21,42,63
5229,SpokaneStBridge,08/06/2014 09:00:00 PM,48,-122,6,10,16
5230,SpokaneStBridge,08/06/2014 10:00:00 PM,48,-122,5,6,11
5231,SpokaneStBridge,08/06/2014 11:00:00 PM,48,-122,1,7,8
5232,SpokaneStBridge,08/07/2014 12:00:00 AM,48,-122,0,3,3
5233,SpokaneStBridge,08/07/2014 01:00:00 AM,48,-122,1,1,2
5234,SpokaneStBridge,08/07/2014 02:00:00 AM,48,-122,0,0,0
5235,SpokaneStBridge,08/07/2014 03:00:00 AM,48,-122,2,2,4
5236,SpokaneStBridge,08/07/2014 04:00:00 AM,48,-122,3,0,3
5237,SpokaneStBridge,08/07/2014 05:00:00 AM,48,-122,25,4,29
5238,SpokaneStBridge,08/07/2014 06:00:00 AM,48,-122,69,6,75
5239,SpokaneStBridge,08/07/2014 07:00:00 AM,48,-122,147,20,167
5240,SpokaneStBridge,08/07/2014 08:00:00 AM,48,-122,106,10,116
5241,SpokaneStBridge,08/07/2014 09:00:00 AM,48,-122,71,11,82
5242,SpokaneStBridge,08/07/2014 10:00:00 AM,48,-122,32,10,42
5243,SpokaneStBridge,08/07/2014 11:00:00 AM,48,-122,9,8,17
5244,SpokaneStBridge,08/07/2014 12:00:00 PM,48,-122,18,12,30
5245,SpokaneStBridge,08/07/2014 01:00:00 PM,48,-122,17,17,34
5246,SpokaneStBridge,08/07/2014 02:00:00 PM,48,-122,15,30,45
5247,SpokaneStBridge,08/07/2014 03:00:00 PM,48,-122,13,43,56
5248,SpokaneStBridge,08/07/2014 04:00:00 PM,48,-122,36,64,100
5249,SpokaneStBridge,08/07/2014 05:00:00 PM,48,-122,26,170,196
5250,SpokaneStBridge,08/07/2014 06:00:00 PM,48,-122,33,112,145
5251,SpokaneStBridge,08/07/2014 07:00:00 PM,48,-122,21,42,63
5252,SpokaneStBridge,08/07/2014 08:00:00 PM,48,-122,18,33,51
5253,SpokaneStBridge,08/07/2014 09:00:00 PM,48,-122,5,15,20
5254,SpokaneStBridge,08/07/2014 10:00:00 PM,48,-122,4,10,14
5255,SpokaneStBridge,08/07/2014 11:00:00 PM,48,-122,4,4,8
5256,SpokaneStBridge,08/08/2014 12:00:00 AM,48,-122,2,3,5
5257,SpokaneStBridge,08/08/2014 01:00:00 AM,48,-122,0,2,2
5258,SpokaneStBridge,08/08/2014 02:00:00 AM,48,-122,2,3,5
5259,SpokaneStBridge,08/08/2014 03:00:00 AM,48,-122,1,1,2
5260,SpokaneStBridge,08/08/2014 04:00:00 AM,48,-122,2,2,4
5261,SpokaneStBridge,08/08/2014 05:00:00 AM,48,-122,24,6,30
5262,SpokaneStBridge,08/08/2014 06:00:00 AM,48,-122,52,7,59
5263,SpokaneStBridge,08/08/2014 07:00:00 AM,48,-122,111,21,132
5264,SpokaneStBridge,08/08/2014 08:00:00 AM,48,-122,104,12,116
5265,SpokaneStBridge,08/08/2014 09:00:00 AM,48,-122,47,9,56
5266,SpokaneStBridge,08/08/2014 10:00:00 AM,48,-122,20,13,33
5267,SpokaneStBridge,08/08/2014 11:00:00 AM,48,-122,15,13,28
5268,SpokaneStBridge,08/08/2014 12:00:00 PM,48,-122,22,13,35
5269,SpokaneStBridge,08/08/2014 01:00:00 PM,48,-122,20,19,39
5270,SpokaneStBridge,08/08/2014 02:00:00 PM,48,-122,30,26,56
5271,SpokaneStBridge,08/08/2014 03:00:00 PM,48,-122,11,48,59
5272,SpokaneStBridge,08/08/2014 04:00:00 PM,48,-122,31,76,107
5273,SpokaneStBridge,08/08/2014 05:00:00 PM,48,-122,29,119,148
5274,SpokaneStBridge,08/08/2014 06:00:00 PM,48,-122,22,62,84
5275,SpokaneStBridge,08/08/2014 07:00:00 PM,48,-122,13,41,54
5276,SpokaneStBridge,08/08/2014 08:00:00 PM,48,-122,8,20,28
5277,SpokaneStBridge,08/08/2014 09:00:00 PM,48,-122,4,11,15
5278,SpokaneStBridge,08/08/2014 10:00:00 PM,48,-122,3,7,10
5279,SpokaneStBridge,08/08/2014 11:00:00 PM,48,-122,3,5,8
5280,SpokaneStBridge,08/09/2014 12:00:00 AM,48,-122,1,4,5
5281,SpokaneStBridge,08/09/2014 01:00:00 AM,48,-122,0,0,0
5282,SpokaneStBridge,08/09/2014 02:00:00 AM,48,-122,0,0,0
5283,SpokaneStBridge,08/09/2014 03:00:00 AM,48,-122,0,2,2
5284,SpokaneStBridge,08/09/2014 04:00:00 AM,48,-122,2,0,2
5285,SpokaneStBridge,08/09/2014 05:00:00 AM,48,-122,3,0,3
5286,SpokaneStBridge,08/09/2014 06:00:00 AM,48,-122,8,2,10
5287,SpokaneStBridge,08/09/2014 07:00:00 AM,48,-122,16,6,22
5288,SpokaneStBridge,08/09/2014 08:00:00 AM,48,-122,20,18,38
5289,SpokaneStBridge,08/09/2014 09:00:00 AM,48,-122,23,26,49
5290,SpokaneStBridge,08/09/2014 10:00:00 AM,48,-122,25,37,62
5291,SpokaneStBridge,08/09/2014 11:00:00 AM,48,-122,33,31,64
5292,SpokaneStBridge,08/09/2014 12:00:00 PM,48,-122,45,37,82
5293,SpokaneStBridge,08/09/2014 01:00:00 PM,48,-122,49,40,89
5294,SpokaneStBridge,08/09/2014 02:00:00 PM,48,-122,26,23,49
5295,SpokaneStBridge,08/09/2014 03:00:00 PM,48,-122,32,29,61
5296,SpokaneStBridge,08/09/2014 04:00:00 PM,48,-122,32,31,63
5297,SpokaneStBridge,08/09/2014 05:00:00 PM,48,-122,28,26,54
5298,SpokaneStBridge,08/09/2014 06:00:00 PM,48,-122,19,21,40
5299,SpokaneStBridge,08/09/2014 07:00:00 PM,48,-122,14,22,36
5300,SpokaneStBridge,08/09/2014 08:00:00 PM,48,-122,8,11,19
5301,SpokaneStBridge,08/09/2014 09:00:00 PM,48,-122,10,12,22
5302,SpokaneStBridge,08/09/2014 10:00:00 PM,48,-122,4,5,9
5303,SpokaneStBridge,08/09/2014 11:00:00 PM,48,-122,4,3,7
5304,SpokaneStBridge,08/10/2014 12:00:00 AM,48,-122,2,4,6
5305,SpokaneStBridge,08/10/2014 01:00:00 AM,48,-122,2,4,6
5306,SpokaneStBridge,08/10/2014 02:00:00 AM,48,-122,0,2,2
5307,SpokaneStBridge,08/10/2014 03:00:00 AM,48,-122,1,0,1
5308,SpokaneStBridge,08/10/2014 04:00:00 AM,48,-122,0,2,2
5309,SpokaneStBridge,08/10/2014 05:00:00 AM,48,-122,3,0,3
5310,SpokaneStBridge,08/10/2014 06:00:00 AM,48,-122,5,8,13
5311,SpokaneStBridge,08/10/2014 07:00:00 AM,48,-122,18,4,22
5312,SpokaneStBridge,08/10/2014 08:00:00 AM,48,-122,14,10,24
5313,SpokaneStBridge,08/10/2014 09:00:00 AM,48,-122,23,20,43
5314,SpokaneStBridge,08/10/2014 10:00:00 AM,48,-122,44,36,80
5315,SpokaneStBridge,08/10/2014 11:00:00 AM,48,-122,84,37,121
5316,SpokaneStBridge,08/10/2014 12:00:00 PM,48,-122,72,39,111
5317,SpokaneStBridge,08/10/2014 01:00:00 PM,48,-122,60,42,102
5318,SpokaneStBridge,08/10/2014 02:00:00 PM,48,-122,25,33,58
5319,SpokaneStBridge,08/10/2014 03:00:00 PM,48,-122,42,51,93
5320,SpokaneStBridge,08/10/2014 04:00:00 PM,48,-122,31,27,58
5321,SpokaneStBridge,08/10/2014 05:00:00 PM,48,-122,37,35,72
5322,SpokaneStBridge,08/10/2014 06:00:00 PM,48,-122,19,16,35
5323,SpokaneStBridge,08/10/2014 07:00:00 PM,48,-122,21,12,33
5324,SpokaneStBridge,08/10/2014 08:00:00 PM,48,-122,8,11,19
5325,SpokaneStBridge,08/10/2014 09:00:00 PM,48,-122,7,10,17
5326,SpokaneStBridge,08/10/2014 10:00:00 PM,48,-122,4,9,13
5327,SpokaneStBridge,08/10/2014 11:00:00 PM,48,-122,0,6,6
5328,SpokaneStBridge,08/11/2014 12:00:00 AM,48,-122,0,0,0
5329,SpokaneStBridge,08/11/2014 01:00:00 AM,48,-122,1,2,3
5330,SpokaneStBridge,08/11/2014 02:00:00 AM,48,-122,1,0,1
5331,SpokaneStBridge,08/11/2014 03:00:00 AM,48,-122,2,1,3
5332,SpokaneStBridge,08/11/2014 04:00:00 AM,48,-122,1,0,1
5333,SpokaneStBridge,08/11/2014 05:00:00 AM,48,-122,25,6,31
5334,SpokaneStBridge,08/11/2014 06:00:00 AM,48,-122,54,18,72
5335,SpokaneStBridge,08/11/2014 07:00:00 AM,48,-122,142,18,160
5336,SpokaneStBridge,08/11/2014 08:00:00 AM,48,-122,126,13,139
5337,SpokaneStBridge,08/11/2014 09:00:00 AM,48,-122,41,8,49
5338,SpokaneStBridge,08/11/2014 10:00:00 AM,48,-122,23,7,30
5339,SpokaneStBridge,08/11/2014 11:00:00 AM,48,-122,12,11,23
5340,SpokaneStBridge,08/11/2014 12:00:00 PM,48,-122,16,17,33
5341,SpokaneStBridge,08/11/2014 01:00:00 PM,48,-122,14,6,20
5342,SpokaneStBridge,08/11/2014 02:00:00 PM,48,-122,16,16,32
5343,SpokaneStBridge,08/11/2014 03:00:00 PM,48,-122,14,40,54
5344,SpokaneStBridge,08/11/2014 04:00:00 PM,48,-122,25,65,90
5345,SpokaneStBridge,08/11/2014 05:00:00 PM,48,-122,26,151,177
5346,SpokaneStBridge,08/11/2014 06:00:00 PM,48,-122,22,109,131
5347,SpokaneStBridge,08/11/2014 07:00:00 PM,48,-122,11,41,52
5348,SpokaneStBridge,08/11/2014 08:00:00 PM,48,-122,9,24,33
5349,SpokaneStBridge,08/11/2014 09:00:00 PM,48,-122,3,14,17
5350,SpokaneStBridge,08/11/2014 10:00:00 PM,48,-122,6,6,12
5351,SpokaneStBridge,08/11/2014 11:00:00 PM,48,-122,0,2,2
5352,SpokaneStBridge,08/12/2014 12:00:00 AM,48,-122,0,2,2
5353,SpokaneStBridge,08/12/2014 01:00:00 AM,48,-122,1,0,1
5354,SpokaneStBridge,08/12/2014 02:00:00 AM,48,-122,0,2,2
5355,SpokaneStBridge,08/12/2014 03:00:00 AM,48,-122,2,0,2
5356,SpokaneStBridge,08/12/2014 04:00:00 AM,48,-122,1,0,1
5357,SpokaneStBridge,08/12/2014 05:00:00 AM,48,-122,33,2,35
5358,SpokaneStBridge,08/12/2014 06:00:00 AM,48,-122,60,9,69
5359,SpokaneStBridge,08/12/2014 07:00:00 AM,48,-122,121,17,138
5360,SpokaneStBridge,08/12/2014 08:00:00 AM,48,-122,103,11,114
5361,SpokaneStBridge,08/12/2014 09:00:00 AM,48,-122,39,6,45
5362,SpokaneStBridge,08/12/2014 10:00:00 AM,48,-122,9,3,12
5363,SpokaneStBridge,08/12/2014 11:00:00 AM,48,-122,10,1,11
5364,SpokaneStBridge,08/12/2014 12:00:00 PM,48,-122,10,12,22
5365,SpokaneStBridge,08/12/2014 01:00:00 PM,48,-122,15,7,22
5366,SpokaneStBridge,08/12/2014 02:00:00 PM,48,-122,13,22,35
5367,SpokaneStBridge,08/12/2014 03:00:00 PM,48,-122,12,28,40
5368,SpokaneStBridge,08/12/2014 04:00:00 PM,48,-122,11,72,83
5369,SpokaneStBridge,08/12/2014 05:00:00 PM,48,-122,28,128,156
5370,SpokaneStBridge,08/12/2014 06:00:00 PM,48,-122,14,91,105
5371,SpokaneStBridge,08/12/2014 07:00:00 PM,48,-122,11,27,38
5372,SpokaneStBridge,08/12/2014 08:00:00 PM,48,-122,10,17,27
5373,SpokaneStBridge,08/12/2014 09:00:00 PM,48,-122,3,5,8
5374,SpokaneStBridge,08/12/2014 10:00:00 PM,48,-122,1,6,7
5375,SpokaneStBridge,08/12/2014 11:00:00 PM,48,-122,1,2,3
5376,SpokaneStBridge,08/13/2014 12:00:00 AM,48,-122,0,1,1
5377,SpokaneStBridge,08/13/2014 01:00:00 AM,48,-122,0,3,3
5378,SpokaneStBridge,08/13/2014 02:00:00 AM,48,-122,1,0,1
5379,SpokaneStBridge,08/13/2014 03:00:00 AM,48,-122,0,0,0
5380,SpokaneStBridge,08/13/2014 04:00:00 AM,48,-122,1,1,2
5381,SpokaneStBridge,08/13/2014 05:00:00 AM,48,-122,11,4,15
5382,SpokaneStBridge,08/13/2014 06:00:00 AM,48,-122,33,5,38
5383,SpokaneStBridge,08/13/2014 07:00:00 AM,48,-122,75,15,90
5384,SpokaneStBridge,08/13/2014 08:00:00 AM,48,-122,86,11,97
5385,SpokaneStBridge,08/13/2014 09:00:00 AM,48,-122,37,8,45
5386,SpokaneStBridge,08/13/2014 10:00:00 AM,48,-122,11,1,12
5387,SpokaneStBridge,08/13/2014 11:00:00 AM,48,-122,8,7,15
5388,SpokaneStBridge,08/13/2014 12:00:00 PM,48,-122,9,7,16
5389,SpokaneStBridge,08/13/2014 01:00:00 PM,48,-122,12,7,19
5390,SpokaneStBridge,08/13/2014 02:00:00 PM,48,-122,10,8,18
5391,SpokaneStBridge,08/13/2014 03:00:00 PM,48,-122,12,23,35
5392,SpokaneStBridge,08/13/2014 04:00:00 PM,48,-122,17,39,56
5393,SpokaneStBridge,08/13/2014 05:00:00 PM,48,-122,17,98,115
5394,SpokaneStBridge,08/13/2014 06:00:00 PM,48,-122,16,82,98
5395,SpokaneStBridge,08/13/2014 07:00:00 PM,48,-122,8,31,39
5396,SpokaneStBridge,08/13/2014 08:00:00 PM,48,-122,10,17,27
5397,SpokaneStBridge,08/13/2014 09:00:00 PM,48,-122,3,9,12
5398,SpokaneStBridge,08/13/2014 10:00:00 PM,48,-122,3,8,11
5399,SpokaneStBridge,08/13/2014 11:00:00 PM,48,-122,1,4,5
5400,SpokaneStBridge,08/14/2014 12:00:00 AM,48,-122,2,4,6
5401,SpokaneStBridge,08/14/2014 01:00:00 AM,48,-122,1,3,4
5402,SpokaneStBridge,08/14/2014 02:00:00 AM,48,-122,1,0,1
5403,SpokaneStBridge,08/14/2014 03:00:00 AM,48,-122,2,0,2
5404,SpokaneStBridge,08/14/2014 04:00:00 AM,48,-122,2,0,2
5405,SpokaneStBridge,08/14/2014 05:00:00 AM,48,-122,21,5,26
5406,SpokaneStBridge,08/14/2014 06:00:00 AM,48,-122,57,8,65
5407,SpokaneStBridge,08/14/2014 07:00:00 AM,48,-122,117,24,141
5408,SpokaneStBridge,08/14/2014 08:00:00 AM,48,-122,107,15,122
5409,SpokaneStBridge,08/14/2014 09:00:00 AM,48,-122,49,9,58
5410,SpokaneStBridge,08/14/2014 10:00:00 AM,48,-122,19,8,27
5411,SpokaneStBridge,08/14/2014 11:00:00 AM,48,-122,13,8,21
5412,SpokaneStBridge,08/14/2014 12:00:00 PM,48,-122,18,11,29
5413,SpokaneStBridge,08/14/2014 01:00:00 PM,48,-122,13,15,28
5414,SpokaneStBridge,08/14/2014 02:00:00 PM,48,-122,10,14,24
5415,SpokaneStBridge,08/14/2014 03:00:00 PM,48,-122,13,21,34
5416,SpokaneStBridge,08/14/2014 04:00:00 PM,48,-122,17,69,86
5417,SpokaneStBridge,08/14/2014 05:00:00 PM,48,-122,18,123,141
5418,SpokaneStBridge,08/14/2014 06:00:00 PM,48,-122,15,97,112
5419,SpokaneStBridge,08/14/2014 07:00:00 PM,48,-122,12,39,51
5420,SpokaneStBridge,08/14/2014 08:00:00 PM,48,-122,15,18,33
5421,SpokaneStBridge,08/14/2014 09:00:00 PM,48,-122,0,7,7
5422,SpokaneStBridge,08/14/2014 10:00:00 PM,48,-122,5,7,12
5423,SpokaneStBridge,08/14/2014 11:00:00 PM,48,-122,7,4,11
5424,SpokaneStBridge,08/15/2014 12:00:00 AM,48,-122,0,4,4
5425,SpokaneStBridge,08/15/2014 01:00:00 AM,48,-122,1,1,2
5426,SpokaneStBridge,08/15/2014 02:00:00 AM,48,-122,2,0,2
5427,SpokaneStBridge,08/15/2014 03:00:00 AM,48,-122,2,0,2
5428,SpokaneStBridge,08/15/2014 04:00:00 AM,48,-122,2,2,4
5429,SpokaneStBridge,08/15/2014 05:00:00 AM,48,-122,20,5,25
5430,SpokaneStBridge,08/15/2014 06:00:00 AM,48,-122,42,7,49
5431,SpokaneStBridge,08/15/2014 07:00:00 AM,48,-122,72,14,86
5432,SpokaneStBridge,08/15/2014 08:00:00 AM,48,-122,72,8,80
5433,SpokaneStBridge,08/15/2014 09:00:00 AM,48,-122,43,8,51
5434,SpokaneStBridge,08/15/2014 10:00:00 AM,48,-122,17,4,21
5435,SpokaneStBridge,08/15/2014 11:00:00 AM,48,-122,8,10,18
5436,SpokaneStBridge,08/15/2014 12:00:00 PM,48,-122,9,6,15
5437,SpokaneStBridge,08/15/2014 01:00:00 PM,48,-122,17,8,25
5438,SpokaneStBridge,08/15/2014 02:00:00 PM,48,-122,13,22,35
5439,SpokaneStBridge,08/15/2014 03:00:00 PM,48,-122,22,23,45
5440,SpokaneStBridge,08/15/2014 04:00:00 PM,48,-122,18,62,80
5441,SpokaneStBridge,08/15/2014 05:00:00 PM,48,-122,25,82,107
5442,SpokaneStBridge,08/15/2014 06:00:00 PM,48,-122,17,51,68
5443,SpokaneStBridge,08/15/2014 07:00:00 PM,48,-122,10,32,42
5444,SpokaneStBridge,08/15/2014 08:00:00 PM,48,-122,5,12,17
5445,SpokaneStBridge,08/15/2014 09:00:00 PM,48,-122,2,13,15
5446,SpokaneStBridge,08/15/2014 10:00:00 PM,48,-122,3,9,12
5447,SpokaneStBridge,08/15/2014 11:00:00 PM,48,-122,1,11,12
5448,SpokaneStBridge,08/16/2014 12:00:00 AM,48,-122,3,1,4
5449,SpokaneStBridge,08/16/2014 01:00:00 AM,48,-122,0,4,4
5450,SpokaneStBridge,08/16/2014 02:00:00 AM,48,-122,1,1,2
5451,SpokaneStBridge,08/16/2014 03:00:00 AM,48,-122,0,0,0
5452,SpokaneStBridge,08/16/2014 04:00:00 AM,48,-122,0,0,0
5453,SpokaneStBridge,08/16/2014 05:00:00 AM,48,-122,5,0,5
5454,SpokaneStBridge,08/16/2014 06:00:00 AM,48,-122,8,3,11
5455,SpokaneStBridge,08/16/2014 07:00:00 AM,48,-122,10,6,16
5456,SpokaneStBridge,08/16/2014 08:00:00 AM,48,-122,11,8,19
5457,SpokaneStBridge,08/16/2014 09:00:00 AM,48,-122,28,25,53
5458,SpokaneStBridge,08/16/2014 10:00:00 AM,48,-122,21,23,44
5459,SpokaneStBridge,08/16/2014 11:00:00 AM,48,-122,38,30,68
5460,SpokaneStBridge,08/16/2014 12:00:00 PM,48,-122,27,25,52
5461,SpokaneStBridge,08/16/2014 01:00:00 PM,48,-122,40,37,77
5462,SpokaneStBridge,08/16/2014 02:00:00 PM,48,-122,34,32,66
5463,SpokaneStBridge,08/16/2014 03:00:00 PM,48,-122,15,39,54
5464,SpokaneStBridge,08/16/2014 04:00:00 PM,48,-122,26,27,53
5465,SpokaneStBridge,08/16/2014 05:00:00 PM,48,-122,26,33,59
5466,SpokaneStBridge,08/16/2014 06:00:00 PM,48,-122,9,21,30
5467,SpokaneStBridge,08/16/2014 07:00:00 PM,48,-122,11,20,31
5468,SpokaneStBridge,08/16/2014 08:00:00 PM,48,-122,24,7,31
5469,SpokaneStBridge,08/16/2014 09:00:00 PM,48,-122,4,6,10
5470,SpokaneStBridge,08/16/2014 10:00:00 PM,48,-122,1,1,2
5471,SpokaneStBridge,08/16/2014 11:00:00 PM,48,-122,8,4,12
5472,SpokaneStBridge,08/17/2014 12:00:00 AM,48,-122,2,5,7
5473,SpokaneStBridge,08/17/2014 01:00:00 AM,48,-122,3,5,8
5474,SpokaneStBridge,08/17/2014 02:00:00 AM,48,-122,0,3,3
5475,SpokaneStBridge,08/17/2014 03:00:00 AM,48,-122,1,1,2
5476,SpokaneStBridge,08/17/2014 04:00:00 AM,48,-122,0,2,2
5477,SpokaneStBridge,08/17/2014 05:00:00 AM,48,-122,4,0,4
5478,SpokaneStBridge,08/17/2014 06:00:00 AM,48,-122,6,1,7
5479,SpokaneStBridge,08/17/2014 07:00:00 AM,48,-122,12,5,17
5480,SpokaneStBridge,08/17/2014 08:00:00 AM,48,-122,19,2,21
5481,SpokaneStBridge,08/17/2014 09:00:00 AM,48,-122,20,19,39
5482,SpokaneStBridge,08/17/2014 10:00:00 AM,48,-122,13,18,31
5483,SpokaneStBridge,08/17/2014 11:00:00 AM,48,-122,29,20,49
5484,SpokaneStBridge,08/17/2014 12:00:00 PM,48,-122,24,37,61
5485,SpokaneStBridge,08/17/2014 01:00:00 PM,48,-122,31,30,61
5486,SpokaneStBridge,08/17/2014 02:00:00 PM,48,-122,43,31,74
5487,SpokaneStBridge,08/17/2014 03:00:00 PM,48,-122,35,31,66
5488,SpokaneStBridge,08/17/2014 04:00:00 PM,48,-122,21,26,47
5489,SpokaneStBridge,08/17/2014 05:00:00 PM,48,-122,36,36,72
5490,SpokaneStBridge,08/17/2014 06:00:00 PM,48,-122,29,19,48
5491,SpokaneStBridge,08/17/2014 07:00:00 PM,48,-122,13,15,28
5492,SpokaneStBridge,08/17/2014 08:00:00 PM,48,-122,15,10,25
5493,SpokaneStBridge,08/17/2014 09:00:00 PM,48,-122,0,8,8
5494,SpokaneStBridge,08/17/2014 10:00:00 PM,48,-122,3,9,12
5495,SpokaneStBridge,08/17/2014 11:00:00 PM,48,-122,1,2,3
5496,SpokaneStBridge,08/18/2014 12:00:00 AM,48,-122,1,2,3
5497,SpokaneStBridge,08/18/2014 01:00:00 AM,48,-122,0,2,2
5498,SpokaneStBridge,08/18/2014 02:00:00 AM,48,-122,1,0,1
5499,SpokaneStBridge,08/18/2014 03:00:00 AM,48,-122,1,3,4
5500,SpokaneStBridge,08/18/2014 04:00:00 AM,48,-122,2,0,2
5501,SpokaneStBridge,08/18/2014 05:00:00 AM,48,-122,27,6,33
5502,SpokaneStBridge,08/18/2014 06:00:00 AM,48,-122,65,8,73
5503,SpokaneStBridge,08/18/2014 07:00:00 AM,48,-122,126,22,148
5504,SpokaneStBridge,08/18/2014 08:00:00 AM,48,-122,126,16,142
5505,SpokaneStBridge,08/18/2014 09:00:00 AM,48,-122,55,11,66
5506,SpokaneStBridge,08/18/2014 10:00:00 AM,48,-122,25,11,36
5507,SpokaneStBridge,08/18/2014 11:00:00 AM,48,-122,15,11,26
5508,SpokaneStBridge,08/18/2014 12:00:00 PM,48,-122,19,24,43
5509,SpokaneStBridge,08/18/2014 01:00:00 PM,48,-122,17,18,35
5510,SpokaneStBridge,08/18/2014 02:00:00 PM,48,-122,21,23,44
5511,SpokaneStBridge,08/18/2014 03:00:00 PM,48,-122,12,30,42
5512,SpokaneStBridge,08/18/2014 04:00:00 PM,48,-122,24,80,104
5513,SpokaneStBridge,08/18/2014 05:00:00 PM,48,-122,22,172,194
5514,SpokaneStBridge,08/18/2014 06:00:00 PM,48,-122,20,130,150
5515,SpokaneStBridge,08/18/2014 07:00:00 PM,48,-122,36,59,95
5516,SpokaneStBridge,08/18/2014 08:00:00 PM,48,-122,15,18,33
5517,SpokaneStBridge,08/18/2014 09:00:00 PM,48,-122,4,7,11
5518,SpokaneStBridge,08/18/2014 10:00:00 PM,48,-122,1,6,7
5519,SpokaneStBridge,08/18/2014 11:00:00 PM,48,-122,2,3,5
5520,SpokaneStBridge,08/19/2014 12:00:00 AM,48,-122,0,6,6
5521,SpokaneStBridge,08/19/2014 01:00:00 AM,48,-122,0,2,2
5522,SpokaneStBridge,08/19/2014 02:00:00 AM,48,-122,2,3,5
5523,SpokaneStBridge,08/19/2014 03:00:00 AM,48,-122,1,0,1
5524,SpokaneStBridge,08/19/2014 04:00:00 AM,48,-122,1,2,3
5525,SpokaneStBridge,08/19/2014 05:00:00 AM,48,-122,19,4,23
5526,SpokaneStBridge,08/19/2014 06:00:00 AM,48,-122,76,10,86
5527,SpokaneStBridge,08/19/2014 07:00:00 AM,48,-122,179,18,197
5528,SpokaneStBridge,08/19/2014 08:00:00 AM,48,-122,147,19,166
5529,SpokaneStBridge,08/19/2014 09:00:00 AM,48,-122,49,9,58
5530,SpokaneStBridge,08/19/2014 10:00:00 AM,48,-122,22,4,26
5531,SpokaneStBridge,08/19/2014 11:00:00 AM,48,-122,19,7,26
5532,SpokaneStBridge,08/19/2014 12:00:00 PM,48,-122,11,15,26
5533,SpokaneStBridge,08/19/2014 01:00:00 PM,48,-122,22,15,37
5534,SpokaneStBridge,08/19/2014 02:00:00 PM,48,-122,13,20,33
5535,SpokaneStBridge,08/19/2014 03:00:00 PM,48,-122,22,44,66
5536,SpokaneStBridge,08/19/2014 04:00:00 PM,48,-122,28,86,114
5537,SpokaneStBridge,08/19/2014 05:00:00 PM,48,-122,37,161,198
5538,SpokaneStBridge,08/19/2014 06:00:00 PM,48,-122,21,123,144
5539,SpokaneStBridge,08/19/2014 07:00:00 PM,48,-122,19,45,64
5540,SpokaneStBridge,08/19/2014 08:00:00 PM,48,-122,16,25,41
5541,SpokaneStBridge,08/19/2014 09:00:00 PM,48,-122,6,11,17
5542,SpokaneStBridge,08/19/2014 10:00:00 PM,48,-122,1,5,6
5543,SpokaneStBridge,08/19/2014 11:00:00 PM,48,-122,0,4,4
5544,SpokaneStBridge,08/20/2014 12:00:00 AM,48,-122,1,7,8
5545,SpokaneStBridge,08/20/2014 01:00:00 AM,48,-122,0,1,1
5546,SpokaneStBridge,08/20/2014 02:00:00 AM,48,-122,1,2,3
5547,SpokaneStBridge,08/20/2014 03:00:00 AM,48,-122,2,2,4
5548,SpokaneStBridge,08/20/2014 04:00:00 AM,48,-122,6,1,7
5549,SpokaneStBridge,08/20/2014 05:00:00 AM,48,-122,22,5,27
5550,SpokaneStBridge,08/20/2014 06:00:00 AM,48,-122,72,4,76
5551,SpokaneStBridge,08/20/2014 07:00:00 AM,48,-122,111,16,127
5552,SpokaneStBridge,08/20/2014 08:00:00 AM,48,-122,152,16,168
5553,SpokaneStBridge,08/20/2014 09:00:00 AM,48,-122,60,13,73
5554,SpokaneStBridge,08/20/2014 10:00:00 AM,48,-122,20,5,25
5555,SpokaneStBridge,08/20/2014 11:00:00 AM,48,-122,20,12,32
5556,SpokaneStBridge,08/20/2014 12:00:00 PM,48,-122,13,15,28
5557,SpokaneStBridge,08/20/2014 01:00:00 PM,48,-122,20,12,32
5558,SpokaneStBridge,08/20/2014 02:00:00 PM,48,-122,8,16,24
5559,SpokaneStBridge,08/20/2014 03:00:00 PM,48,-122,14,34,48
5560,SpokaneStBridge,08/20/2014 04:00:00 PM,48,-122,19,81,100
5561,SpokaneStBridge,08/20/2014 05:00:00 PM,48,-122,24,153,177
5562,SpokaneStBridge,08/20/2014 06:00:00 PM,48,-122,19,113,132
5563,SpokaneStBridge,08/20/2014 07:00:00 PM,48,-122,14,40,54
5564,SpokaneStBridge,08/20/2014 08:00:00 PM,48,-122,15,23,38
5565,SpokaneStBridge,08/20/2014 09:00:00 PM,48,-122,2,19,21
5566,SpokaneStBridge,08/20/2014 10:00:00 PM,48,-122,6,5,11
5567,SpokaneStBridge,08/20/2014 11:00:00 PM,48,-122,1,5,6
5568,SpokaneStBridge,08/21/2014 12:00:00 AM,48,-122,3,4,7
5569,SpokaneStBridge,08/21/2014 01:00:00 AM,48,-122,1,3,4
5570,SpokaneStBridge,08/21/2014 02:00:00 AM,48,-122,2,1,3
5571,SpokaneStBridge,08/21/2014 03:00:00 AM,48,-122,0,0,0
5572,SpokaneStBridge,08/21/2014 04:00:00 AM,48,-122,2,1,3
5573,SpokaneStBridge,08/21/2014 05:00:00 AM,48,-122,23,5,28
5574,SpokaneStBridge,08/21/2014 06:00:00 AM,48,-122,56,10,66
5575,SpokaneStBridge,08/21/2014 07:00:00 AM,48,-122,129,14,143
5576,SpokaneStBridge,08/21/2014 08:00:00 AM,48,-122,114,19,133
5577,SpokaneStBridge,08/21/2014 09:00:00 AM,48,-122,47,5,52
5578,SpokaneStBridge,08/21/2014 10:00:00 AM,48,-122,16,4,20
5579,SpokaneStBridge,08/21/2014 11:00:00 AM,48,-122,14,7,21
5580,SpokaneStBridge,08/21/2014 12:00:00 PM,48,-122,14,17,31
5581,SpokaneStBridge,08/21/2014 01:00:00 PM,48,-122,17,17,34
5582,SpokaneStBridge,08/21/2014 02:00:00 PM,48,-122,9,10,19
5583,SpokaneStBridge,08/21/2014 03:00:00 PM,48,-122,16,28,44
5584,SpokaneStBridge,08/21/2014 04:00:00 PM,48,-122,31,69,100
5585,SpokaneStBridge,08/21/2014 05:00:00 PM,48,-122,15,132,147
5586,SpokaneStBridge,08/21/2014 06:00:00 PM,48,-122,29,107,136
5587,SpokaneStBridge,08/21/2014 07:00:00 PM,48,-122,12,106,118
5588,SpokaneStBridge,08/21/2014 08:00:00 PM,48,-122,15,17,32
5589,SpokaneStBridge,08/21/2014 09:00:00 PM,48,-122,15,9,24
5590,SpokaneStBridge,08/21/2014 10:00:00 PM,48,-122,14,3,17
5591,SpokaneStBridge,08/21/2014 11:00:00 PM,48,-122,11,5,16
5592,SpokaneStBridge,08/22/2014 12:00:00 AM,48,-122,7,8,15
5593,SpokaneStBridge,08/22/2014 01:00:00 AM,48,-122,20,1,21
5594,SpokaneStBridge,08/22/2014 02:00:00 AM,48,-122,1,0,1
5595,SpokaneStBridge,08/22/2014 03:00:00 AM,48,-122,0,0,0
5596,SpokaneStBridge,08/22/2014 04:00:00 AM,48,-122,4,3,7
5597,SpokaneStBridge,08/22/2014 05:00:00 AM,48,-122,14,6,20
5598,SpokaneStBridge,08/22/2014 06:00:00 AM,48,-122,45,9,54
5599,SpokaneStBridge,08/22/2014 07:00:00 AM,48,-122,101,23,124
5600,SpokaneStBridge,08/22/2014 08:00:00 AM,48,-122,99,9,108
5601,SpokaneStBridge,08/22/2014 09:00:00 AM,48,-122,47,11,58
5602,SpokaneStBridge,08/22/2014 10:00:00 AM,48,-122,22,8,30
5603,SpokaneStBridge,08/22/2014 11:00:00 AM,48,-122,21,18,39
5604,SpokaneStBridge,08/22/2014 12:00:00 PM,48,-122,25,13,38
5605,SpokaneStBridge,08/22/2014 01:00:00 PM,48,-122,12,15,27
5606,SpokaneStBridge,08/22/2014 02:00:00 PM,48,-122,19,28,47
5607,SpokaneStBridge,08/22/2014 03:00:00 PM,48,-122,21,48,69
5608,SpokaneStBridge,08/22/2014 04:00:00 PM,48,-122,36,87,123
5609,SpokaneStBridge,08/22/2014 05:00:00 PM,48,-122,38,103,141
5610,SpokaneStBridge,08/22/2014 06:00:00 PM,48,-122,18,61,79
5611,SpokaneStBridge,08/22/2014 07:00:00 PM,48,-122,9,26,35
5612,SpokaneStBridge,08/22/2014 08:00:00 PM,48,-122,11,14,25
5613,SpokaneStBridge,08/22/2014 09:00:00 PM,48,-122,4,8,12
5614,SpokaneStBridge,08/22/2014 10:00:00 PM,48,-122,2,15,17
5615,SpokaneStBridge,08/22/2014 11:00:00 PM,48,-122,5,7,12
5616,SpokaneStBridge,08/23/2014 12:00:00 AM,48,-122,4,6,10
5617,SpokaneStBridge,08/23/2014 01:00:00 AM,48,-122,1,4,5
5618,SpokaneStBridge,08/23/2014 02:00:00 AM,48,-122,1,3,4
5619,SpokaneStBridge,08/23/2014 03:00:00 AM,48,-122,1,1,2
5620,SpokaneStBridge,08/23/2014 04:00:00 AM,48,-122,1,1,2
5621,SpokaneStBridge,08/23/2014 05:00:00 AM,48,-122,3,0,3
5622,SpokaneStBridge,08/23/2014 06:00:00 AM,48,-122,15,4,19
5623,SpokaneStBridge,08/23/2014 07:00:00 AM,48,-122,12,11,23
5624,SpokaneStBridge,08/23/2014 08:00:00 AM,48,-122,27,23,50
5625,SpokaneStBridge,08/23/2014 09:00:00 AM,48,-122,27,19,46
5626,SpokaneStBridge,08/23/2014 10:00:00 AM,48,-122,44,33,77
5627,SpokaneStBridge,08/23/2014 11:00:00 AM,48,-122,42,93,135
5628,SpokaneStBridge,08/23/2014 12:00:00 PM,48,-122,98,40,138
5629,SpokaneStBridge,08/23/2014 01:00:00 PM,48,-122,33,37,70
5630,SpokaneStBridge,08/23/2014 02:00:00 PM,48,-122,36,46,82
5631,SpokaneStBridge,08/23/2014 03:00:00 PM,48,-122,50,41,91
5632,SpokaneStBridge,08/23/2014 04:00:00 PM,48,-122,30,30,60
5633,SpokaneStBridge,08/23/2014 05:00:00 PM,48,-122,29,37,66
5634,SpokaneStBridge,08/23/2014 06:00:00 PM,48,-122,27,39,66
5635,SpokaneStBridge,08/23/2014 07:00:00 PM,48,-122,18,18,36
5636,SpokaneStBridge,08/23/2014 08:00:00 PM,48,-122,14,14,28
5637,SpokaneStBridge,08/23/2014 09:00:00 PM,48,-122,7,9,16
5638,SpokaneStBridge,08/23/2014 10:00:00 PM,48,-122,6,3,9
5639,SpokaneStBridge,08/23/2014 11:00:00 PM,48,-122,4,7,11
5640,SpokaneStBridge,08/24/2014 12:00:00 AM,48,-122,2,2,4
5641,SpokaneStBridge,08/24/2014 01:00:00 AM,48,-122,0,4,4
5642,SpokaneStBridge,08/24/2014 02:00:00 AM,48,-122,0,1,1
5643,SpokaneStBridge,08/24/2014 03:00:00 AM,48,-122,3,3,6
5644,SpokaneStBridge,08/24/2014 04:00:00 AM,48,-122,1,1,2
5645,SpokaneStBridge,08/24/2014 05:00:00 AM,48,-122,2,0,2
5646,SpokaneStBridge,08/24/2014 06:00:00 AM,48,-122,3,3,6
5647,SpokaneStBridge,08/24/2014 07:00:00 AM,48,-122,16,10,26
5648,SpokaneStBridge,08/24/2014 08:00:00 AM,48,-122,18,9,27
5649,SpokaneStBridge,08/24/2014 09:00:00 AM,48,-122,25,40,65
5650,SpokaneStBridge,08/24/2014 10:00:00 AM,48,-122,37,21,58
5651,SpokaneStBridge,08/24/2014 11:00:00 AM,48,-122,28,36,64
5652,SpokaneStBridge,08/24/2014 12:00:00 PM,48,-122,36,26,62
5653,SpokaneStBridge,08/24/2014 01:00:00 PM,48,-122,39,39,78
5654,SpokaneStBridge,08/24/2014 02:00:00 PM,48,-122,32,35,67
5655,SpokaneStBridge,08/24/2014 03:00:00 PM,48,-122,36,31,67
5656,SpokaneStBridge,08/24/2014 04:00:00 PM,48,-122,27,51,78
5657,SpokaneStBridge,08/24/2014 05:00:00 PM,48,-122,33,30,63
5658,SpokaneStBridge,08/24/2014 06:00:00 PM,48,-122,23,27,50
5659,SpokaneStBridge,08/24/2014 07:00:00 PM,48,-122,16,19,35
5660,SpokaneStBridge,08/24/2014 08:00:00 PM,48,-122,18,10,28
5661,SpokaneStBridge,08/24/2014 09:00:00 PM,48,-122,6,5,11
5662,SpokaneStBridge,08/24/2014 10:00:00 PM,48,-122,2,4,6
5663,SpokaneStBridge,08/24/2014 11:00:00 PM,48,-122,2,3,5
5664,SpokaneStBridge,08/25/2014 12:00:00 AM,48,-122,1,1,2
5665,SpokaneStBridge,08/25/2014 01:00:00 AM,48,-122,1,1,2
5666,SpokaneStBridge,08/25/2014 02:00:00 AM,48,-122,2,2,4
5667,SpokaneStBridge,08/25/2014 03:00:00 AM,48,-122,0,0,0
5668,SpokaneStBridge,08/25/2014 04:00:00 AM,48,-122,1,4,5
5669,SpokaneStBridge,08/25/2014 05:00:00 AM,48,-122,27,4,31
5670,SpokaneStBridge,08/25/2014 06:00:00 AM,48,-122,67,9,76
5671,SpokaneStBridge,08/25/2014 07:00:00 AM,48,-122,173,20,193
5672,SpokaneStBridge,08/25/2014 08:00:00 AM,48,-122,157,20,177
5673,SpokaneStBridge,08/25/2014 09:00:00 AM,48,-122,77,10,87
5674,SpokaneStBridge,08/25/2014 10:00:00 AM,48,-122,37,13,50
5675,SpokaneStBridge,08/25/2014 11:00:00 AM,48,-122,13,12,25
5676,SpokaneStBridge,08/25/2014 12:00:00 PM,48,-122,17,13,30
5677,SpokaneStBridge,08/25/2014 01:00:00 PM,48,-122,17,15,32
5678,SpokaneStBridge,08/25/2014 02:00:00 PM,48,-122,17,27,44
5679,SpokaneStBridge,08/25/2014 03:00:00 PM,48,-122,17,36,53
5680,SpokaneStBridge,08/25/2014 04:00:00 PM,48,-122,28,91,119
5681,SpokaneStBridge,08/25/2014 05:00:00 PM,48,-122,38,206,244
5682,SpokaneStBridge,08/25/2014 06:00:00 PM,48,-122,26,157,183
5683,SpokaneStBridge,08/25/2014 07:00:00 PM,48,-122,19,53,72
5684,SpokaneStBridge,08/25/2014 08:00:00 PM,48,-122,12,19,31
5685,SpokaneStBridge,08/25/2014 09:00:00 PM,48,-122,6,13,19
5686,SpokaneStBridge,08/25/2014 10:00:00 PM,48,-122,2,15,17
5687,SpokaneStBridge,08/25/2014 11:00:00 PM,48,-122,3,7,10
5688,SpokaneStBridge,08/26/2014 12:00:00 AM,48,-122,0,4,4
5689,SpokaneStBridge,08/26/2014 01:00:00 AM,48,-122,2,1,3
5690,SpokaneStBridge,08/26/2014 02:00:00 AM,48,-122,1,1,2
5691,SpokaneStBridge,08/26/2014 03:00:00 AM,48,-122,0,0,0
5692,SpokaneStBridge,08/26/2014 04:00:00 AM,48,-122,4,2,6
5693,SpokaneStBridge,08/26/2014 05:00:00 AM,48,-122,25,9,34
5694,SpokaneStBridge,08/26/2014 06:00:00 AM,48,-122,76,16,92
5695,SpokaneStBridge,08/26/2014 07:00:00 AM,48,-122,178,16,194
5696,SpokaneStBridge,08/26/2014 08:00:00 AM,48,-122,144,24,168
5697,SpokaneStBridge,08/26/2014 09:00:00 AM,48,-122,67,13,80
5698,SpokaneStBridge,08/26/2014 10:00:00 AM,48,-122,21,13,34
5699,SpokaneStBridge,08/26/2014 11:00:00 AM,48,-122,24,11,35
5700,SpokaneStBridge,08/26/2014 12:00:00 PM,48,-122,18,12,30
5701,SpokaneStBridge,08/26/2014 01:00:00 PM,48,-122,10,17,27
5702,SpokaneStBridge,08/26/2014 02:00:00 PM,48,-122,13,15,28
5703,SpokaneStBridge,08/26/2014 03:00:00 PM,48,-122,22,53,75
5704,SpokaneStBridge,08/26/2014 04:00:00 PM,48,-122,31,81,112
5705,SpokaneStBridge,08/26/2014 05:00:00 PM,48,-122,41,201,242
5706,SpokaneStBridge,08/26/2014 06:00:00 PM,48,-122,27,140,167
5707,SpokaneStBridge,08/26/2014 07:00:00 PM,48,-122,10,49,59
5708,SpokaneStBridge,08/26/2014 08:00:00 PM,48,-122,11,24,35
5709,SpokaneStBridge,08/26/2014 09:00:00 PM,48,-122,3,5,8
5710,SpokaneStBridge,08/26/2014 10:00:00 PM,48,-122,2,11,13
5711,SpokaneStBridge,08/26/2014 11:00:00 PM,48,-122,0,11,11
5712,SpokaneStBridge,08/27/2014 12:00:00 AM,48,-122,1,4,5
5713,SpokaneStBridge,08/27/2014 01:00:00 AM,48,-122,0,2,2
5714,SpokaneStBridge,08/27/2014 02:00:00 AM,48,-122,3,1,4
5715,SpokaneStBridge,08/27/2014 03:00:00 AM,48,-122,0,0,0
5716,SpokaneStBridge,08/27/2014 04:00:00 AM,48,-122,6,4,10
5717,SpokaneStBridge,08/27/2014 05:00:00 AM,48,-122,19,5,24
5718,SpokaneStBridge,08/27/2014 06:00:00 AM,48,-122,70,10,80
5719,SpokaneStBridge,08/27/2014 07:00:00 AM,48,-122,125,18,143
5720,SpokaneStBridge,08/27/2014 08:00:00 AM,48,-122,155,18,173
5721,SpokaneStBridge,08/27/2014 09:00:00 AM,48,-122,60,8,68
5722,SpokaneStBridge,08/27/2014 10:00:00 AM,48,-122,26,13,39
5723,SpokaneStBridge,08/27/2014 11:00:00 AM,48,-122,22,5,27
5724,SpokaneStBridge,08/27/2014 12:00:00 PM,48,-122,17,34,51
5725,SpokaneStBridge,08/27/2014 01:00:00 PM,48,-122,16,20,36
5726,SpokaneStBridge,08/27/2014 02:00:00 PM,48,-122,18,21,39
5727,SpokaneStBridge,08/27/2014 03:00:00 PM,48,-122,24,39,63
5728,SpokaneStBridge,08/27/2014 04:00:00 PM,48,-122,26,80,106
5729,SpokaneStBridge,08/27/2014 05:00:00 PM,48,-122,32,167,199
5730,SpokaneStBridge,08/27/2014 06:00:00 PM,48,-122,16,122,138
5731,SpokaneStBridge,08/27/2014 07:00:00 PM,48,-122,19,74,93
5732,SpokaneStBridge,08/27/2014 08:00:00 PM,48,-122,18,25,43
5733,SpokaneStBridge,08/27/2014 09:00:00 PM,48,-122,9,20,29
5734,SpokaneStBridge,08/27/2014 10:00:00 PM,48,-122,5,4,9
5735,SpokaneStBridge,08/27/2014 11:00:00 PM,48,-122,5,6,11
5736,SpokaneStBridge,08/28/2014 12:00:00 AM,48,-122,3,2,5
5737,SpokaneStBridge,08/28/2014 01:00:00 AM,48,-122,1,0,1
5738,SpokaneStBridge,08/28/2014 02:00:00 AM,48,-122,1,3,4
5739,SpokaneStBridge,08/28/2014 03:00:00 AM,48,-122,0,0,0
5740,SpokaneStBridge,08/28/2014 04:00:00 AM,48,-122,4,0,4
5741,SpokaneStBridge,08/28/2014 05:00:00 AM,48,-122,18,9,27
5742,SpokaneStBridge,08/28/2014 06:00:00 AM,48,-122,55,12,67
5743,SpokaneStBridge,08/28/2014 07:00:00 AM,48,-122,125,17,142
5744,SpokaneStBridge,08/28/2014 08:00:00 AM,48,-122,119,13,132
5745,SpokaneStBridge,08/28/2014 09:00:00 AM,48,-122,52,7,59
5746,SpokaneStBridge,08/28/2014 10:00:00 AM,48,-122,22,6,28
5747,SpokaneStBridge,08/28/2014 11:00:00 AM,48,-122,16,6,22
5748,SpokaneStBridge,08/28/2014 12:00:00 PM,48,-122,18,10,28
5749,SpokaneStBridge,08/28/2014 01:00:00 PM,48,-122,12,7,19
5750,SpokaneStBridge,08/28/2014 02:00:00 PM,48,-122,16,16,32
5751,SpokaneStBridge,08/28/2014 03:00:00 PM,48,-122,14,25,39
5752,SpokaneStBridge,08/28/2014 04:00:00 PM,48,-122,26,70,96
5753,SpokaneStBridge,08/28/2014 05:00:00 PM,48,-122,38,141,179
5754,SpokaneStBridge,08/28/2014 06:00:00 PM,48,-122,16,94,110
5755,SpokaneStBridge,08/28/2014 07:00:00 PM,48,-122,13,55,68
5756,SpokaneStBridge,08/28/2014 08:00:00 PM,48,-122,10,27,37
5757,SpokaneStBridge,08/28/2014 09:00:00 PM,48,-122,4,12,16
5758,SpokaneStBridge,08/28/2014 10:00:00 PM,48,-122,2,4,6
5759,SpokaneStBridge,08/28/2014 11:00:00 PM,48,-122,3,11,14
5760,SpokaneStBridge,08/29/2014 12:00:00 AM,48,-122,0,2,2
5761,SpokaneStBridge,08/29/2014 01:00:00 AM,48,-122,0,1,1
5762,SpokaneStBridge,08/29/2014 02:00:00 AM,48,-122,1,0,1
5763,SpokaneStBridge,08/29/2014 03:00:00 AM,48,-122,0,0,0
5764,SpokaneStBridge,08/29/2014 04:00:00 AM,48,-122,2,0,2
5765,SpokaneStBridge,08/29/2014 05:00:00 AM,48,-122,15,2,17
5766,SpokaneStBridge,08/29/2014 06:00:00 AM,48,-122,44,3,47
5767,SpokaneStBridge,08/29/2014 07:00:00 AM,48,-122,101,13,114
5768,SpokaneStBridge,08/29/2014 08:00:00 AM,48,-122,85,7,92
5769,SpokaneStBridge,08/29/2014 09:00:00 AM,48,-122,42,12,54
5770,SpokaneStBridge,08/29/2014 10:00:00 AM,48,-122,26,7,33
5771,SpokaneStBridge,08/29/2014 11:00:00 AM,48,-122,13,9,22
5772,SpokaneStBridge,08/29/2014 12:00:00 PM,48,-122,10,12,22
5773,SpokaneStBridge,08/29/2014 01:00:00 PM,48,-122,9,12,21
5774,SpokaneStBridge,08/29/2014 02:00:00 PM,48,-122,12,18,30
5775,SpokaneStBridge,08/29/2014 03:00:00 PM,48,-122,14,26,40
5776,SpokaneStBridge,08/29/2014 04:00:00 PM,48,-122,15,67,82
5777,SpokaneStBridge,08/29/2014 05:00:00 PM,48,-122,19,98,117
5778,SpokaneStBridge,08/29/2014 06:00:00 PM,48,-122,15,68,83
5779,SpokaneStBridge,08/29/2014 07:00:00 PM,48,-122,8,32,40
5780,SpokaneStBridge,08/29/2014 08:00:00 PM,48,-122,4,18,22
5781,SpokaneStBridge,08/29/2014 09:00:00 PM,48,-122,3,8,11
5782,SpokaneStBridge,08/29/2014 10:00:00 PM,48,-122,3,4,7
5783,SpokaneStBridge,08/29/2014 11:00:00 PM,48,-122,1,5,6
5784,SpokaneStBridge,08/30/2014 12:00:00 AM,48,-122,1,4,5
5785,SpokaneStBridge,08/30/2014 01:00:00 AM,48,-122,2,2,4
5786,SpokaneStBridge,08/30/2014 02:00:00 AM,48,-122,0,0,0
5787,SpokaneStBridge,08/30/2014 03:00:00 AM,48,-122,0,1,1
5788,SpokaneStBridge,08/30/2014 04:00:00 AM,48,-122,0,1,1
5789,SpokaneStBridge,08/30/2014 05:00:00 AM,48,-122,3,1,4
5790,SpokaneStBridge,08/30/2014 06:00:00 AM,48,-122,2,2,4
5791,SpokaneStBridge,08/30/2014 07:00:00 AM,48,-122,4,1,5
5792,SpokaneStBridge,08/30/2014 08:00:00 AM,48,-122,17,6,23
5793,SpokaneStBridge,08/30/2014 09:00:00 AM,48,-122,11,6,17
5794,SpokaneStBridge,08/30/2014 10:00:00 AM,48,-122,8,6,14
5795,SpokaneStBridge,08/30/2014 11:00:00 AM,48,-122,6,11,17
5796,SpokaneStBridge,08/30/2014 12:00:00 PM,48,-122,7,9,16
5797,SpokaneStBridge,08/30/2014 01:00:00 PM,48,-122,6,9,15
5798,SpokaneStBridge,08/30/2014 02:00:00 PM,48,-122,9,5,14
5799,SpokaneStBridge,08/30/2014 03:00:00 PM,48,-122,10,9,19
5800,SpokaneStBridge,08/30/2014 04:00:00 PM,48,-122,5,9,14
5801,SpokaneStBridge,08/30/2014 05:00:00 PM,48,-122,6,4,10
5802,SpokaneStBridge,08/30/2014 06:00:00 PM,48,-122,8,8,16
5803,SpokaneStBridge,08/30/2014 07:00:00 PM,48,-122,3,2,5
5804,SpokaneStBridge,08/30/2014 08:00:00 PM,48,-122,3,2,5
5805,SpokaneStBridge,08/30/2014 09:00:00 PM,48,-122,0,4,4
5806,SpokaneStBridge,08/30/2014 10:00:00 PM,48,-122,1,2,3
5807,SpokaneStBridge,08/30/2014 11:00:00 PM,48,-122,2,7,9
5808,SpokaneStBridge,08/31/2014 12:00:00 AM,48,-122,0,0,0
5809,SpokaneStBridge,08/31/2014 01:00:00 AM,48,-122,1,4,5
5810,SpokaneStBridge,08/31/2014 02:00:00 AM,48,-122,0,1,1
5811,SpokaneStBridge,08/31/2014 03:00:00 AM,48,-122,1,0,1
5812,SpokaneStBridge,08/31/2014 04:00:00 AM,48,-122,0,2,2
5813,SpokaneStBridge,08/31/2014 05:00:00 AM,48,-122,0,0,0
5814,SpokaneStBridge,08/31/2014 06:00:00 AM,48,-122,3,0,3
5815,SpokaneStBridge,08/31/2014 07:00:00 AM,48,-122,1,3,4
5816,SpokaneStBridge,08/31/2014 08:00:00 AM,48,-122,5,1,6
5817,SpokaneStBridge,08/31/2014 09:00:00 AM,48,-122,12,13,25
5818,SpokaneStBridge,08/31/2014 10:00:00 AM,48,-122,26,22,48
5819,SpokaneStBridge,08/31/2014 11:00:00 AM,48,-122,30,17,47
5820,SpokaneStBridge,08/31/2014 12:00:00 PM,48,-122,14,17,31
5821,SpokaneStBridge,08/31/2014 01:00:00 PM,48,-122,39,10,49
5822,SpokaneStBridge,08/31/2014 02:00:00 PM,48,-122,19,20,39
5823,SpokaneStBridge,08/31/2014 03:00:00 PM,48,-122,30,32,62
5824,SpokaneStBridge,08/31/2014 04:00:00 PM,48,-122,18,32,50
5825,SpokaneStBridge,08/31/2014 05:00:00 PM,48,-122,20,18,38
5826,SpokaneStBridge,08/31/2014 06:00:00 PM,48,-122,11,15,26
5827,SpokaneStBridge,08/31/2014 07:00:00 PM,48,-122,6,8,14
5828,SpokaneStBridge,08/31/2014 08:00:00 PM,48,-122,4,7,11
5829,SpokaneStBridge,08/31/2014 09:00:00 PM,48,-122,4,2,6
5830,SpokaneStBridge,08/31/2014 10:00:00 PM,48,-122,1,4,5
5831,SpokaneStBridge,08/31/2014 11:00:00 PM,48,-122,3,2,5
5832,SpokaneStBridge,09/01/2014 12:00:00 AM,48,-122,0,0,0
5833,SpokaneStBridge,09/01/2014 01:00:00 AM,48,-122,0,1,1
5834,SpokaneStBridge,09/01/2014 02:00:00 AM,48,-122,0,0,0
5835,SpokaneStBridge,09/01/2014 03:00:00 AM,48,-122,3,0,3
5836,SpokaneStBridge,09/01/2014 04:00:00 AM,48,-122,0,1,1
5837,SpokaneStBridge,09/01/2014 05:00:00 AM,48,-122,1,2,3
5838,SpokaneStBridge,09/01/2014 06:00:00 AM,48,-122,5,3,8
5839,SpokaneStBridge,09/01/2014 07:00:00 AM,48,-122,11,1,12
5840,SpokaneStBridge,09/01/2014 08:00:00 AM,48,-122,17,9,26
5841,SpokaneStBridge,09/01/2014 09:00:00 AM,48,-122,8,79,87
5842,SpokaneStBridge,09/01/2014 10:00:00 AM,48,-122,22,11,33
5843,SpokaneStBridge,09/01/2014 11:00:00 AM,48,-122,29,33,62
5844,SpokaneStBridge,09/01/2014 12:00:00 PM,48,-122,39,36,75
5845,SpokaneStBridge,09/01/2014 01:00:00 PM,48,-122,42,28,70
5846,SpokaneStBridge,09/01/2014 02:00:00 PM,48,-122,36,50,86
5847,SpokaneStBridge,09/01/2014 03:00:00 PM,48,-122,49,45,94
5848,SpokaneStBridge,09/01/2014 04:00:00 PM,48,-122,33,48,81
5849,SpokaneStBridge,09/01/2014 05:00:00 PM,48,-122,28,31,59
5850,SpokaneStBridge,09/01/2014 06:00:00 PM,48,-122,16,21,37
5851,SpokaneStBridge,09/01/2014 07:00:00 PM,48,-122,10,7,17
5852,SpokaneStBridge,09/01/2014 08:00:00 PM,48,-122,7,8,15
5853,SpokaneStBridge,09/01/2014 09:00:00 PM,48,-122,6,2,8
5854,SpokaneStBridge,09/01/2014 10:00:00 PM,48,-122,1,1,2
5855,SpokaneStBridge,09/01/2014 11:00:00 PM,48,-122,2,1,3
5856,SpokaneStBridge,09/02/2014 12:00:00 AM,48,-122,2,3,5
5857,SpokaneStBridge,09/02/2014 01:00:00 AM,48,-122,0,2,2
5858,SpokaneStBridge,09/02/2014 02:00:00 AM,48,-122,3,2,5
5859,SpokaneStBridge,09/02/2014 03:00:00 AM,48,-122,1,1,2
5860,SpokaneStBridge,09/02/2014 04:00:00 AM,48,-122,2,1,3
5861,SpokaneStBridge,09/02/2014 05:00:00 AM,48,-122,14,2,16
5862,SpokaneStBridge,09/02/2014 06:00:00 AM,48,-122,46,6,52
5863,SpokaneStBridge,09/02/2014 07:00:00 AM,48,-122,121,14,135
5864,SpokaneStBridge,09/02/2014 08:00:00 AM,48,-122,114,12,126
5865,SpokaneStBridge,09/02/2014 09:00:00 AM,48,-122,50,7,57
5866,SpokaneStBridge,09/02/2014 10:00:00 AM,48,-122,17,3,20
5867,SpokaneStBridge,09/02/2014 11:00:00 AM,48,-122,10,19,29
5868,SpokaneStBridge,09/02/2014 12:00:00 PM,48,-122,20,6,26
5869,SpokaneStBridge,09/02/2014 01:00:00 PM,48,-122,9,11,20
5870,SpokaneStBridge,09/02/2014 02:00:00 PM,48,-122,9,16,25
5871,SpokaneStBridge,09/02/2014 03:00:00 PM,48,-122,6,23,29
5872,SpokaneStBridge,09/02/2014 04:00:00 PM,48,-122,13,53,66
5873,SpokaneStBridge,09/02/2014 05:00:00 PM,48,-122,20,127,147
5874,SpokaneStBridge,09/02/2014 06:00:00 PM,48,-122,13,97,110
5875,SpokaneStBridge,09/02/2014 07:00:00 PM,48,-122,8,29,37
5876,SpokaneStBridge,09/02/2014 08:00:00 PM,48,-122,3,8,11
5877,SpokaneStBridge,09/02/2014 09:00:00 PM,48,-122,2,4,6
5878,SpokaneStBridge,09/02/2014 10:00:00 PM,48,-122,2,2,4
5879,SpokaneStBridge,09/02/2014 11:00:00 PM,48,-122,1,1,2
5880,SpokaneStBridge,09/03/2014 12:00:00 AM,48,-122,0,1,1
5881,SpokaneStBridge,09/03/2014 01:00:00 AM,48,-122,1,1,2
5882,SpokaneStBridge,09/03/2014 02:00:00 AM,48,-122,0,0,0
5883,SpokaneStBridge,09/03/2014 03:00:00 AM,48,-122,3,1,4
5884,SpokaneStBridge,09/03/2014 04:00:00 AM,48,-122,3,2,5
5885,SpokaneStBridge,09/03/2014 05:00:00 AM,48,-122,17,3,20
5886,SpokaneStBridge,09/03/2014 06:00:00 AM,48,-122,56,13,69
5887,SpokaneStBridge,09/03/2014 07:00:00 AM,48,-122,102,20,122
5888,SpokaneStBridge,09/03/2014 08:00:00 AM,48,-122,111,12,123
5889,SpokaneStBridge,09/03/2014 09:00:00 AM,48,-122,51,11,62
5890,SpokaneStBridge,09/03/2014 10:00:00 AM,48,-122,29,5,34
5891,SpokaneStBridge,09/03/2014 11:00:00 AM,48,-122,12,8,20
5892,SpokaneStBridge,09/03/2014 12:00:00 PM,48,-122,12,11,23
5893,SpokaneStBridge,09/03/2014 01:00:00 PM,48,-122,18,13,31
5894,SpokaneStBridge,09/03/2014 02:00:00 PM,48,-122,11,23,34
5895,SpokaneStBridge,09/03/2014 03:00:00 PM,48,-122,13,27,40
5896,SpokaneStBridge,09/03/2014 04:00:00 PM,48,-122,20,79,99
5897,SpokaneStBridge,09/03/2014 05:00:00 PM,48,-122,27,139,166
5898,SpokaneStBridge,09/03/2014 06:00:00 PM,48,-122,15,124,139
5899,SpokaneStBridge,09/03/2014 07:00:00 PM,48,-122,15,38,53
5900,SpokaneStBridge,09/03/2014 08:00:00 PM,48,-122,10,25,35
5901,SpokaneStBridge,09/03/2014 09:00:00 PM,48,-122,2,6,8
5902,SpokaneStBridge,09/03/2014 10:00:00 PM,48,-122,2,5,7
5903,SpokaneStBridge,09/03/2014 11:00:00 PM,48,-122,1,9,10
5904,SpokaneStBridge,09/04/2014 12:00:00 AM,48,-122,2,4,6
5905,SpokaneStBridge,09/04/2014 01:00:00 AM,48,-122,1,2,3
5906,SpokaneStBridge,09/04/2014 02:00:00 AM,48,-122,0,1,1
5907,SpokaneStBridge,09/04/2014 03:00:00 AM,48,-122,2,1,3
5908,SpokaneStBridge,09/04/2014 04:00:00 AM,48,-122,7,0,7
5909,SpokaneStBridge,09/04/2014 05:00:00 AM,48,-122,27,6,33
5910,SpokaneStBridge,09/04/2014 06:00:00 AM,48,-122,70,14,84
5911,SpokaneStBridge,09/04/2014 07:00:00 AM,48,-122,162,15,177
5912,SpokaneStBridge,09/04/2014 08:00:00 AM,48,-122,144,19,163
5913,SpokaneStBridge,09/04/2014 09:00:00 AM,48,-122,65,5,70
5914,SpokaneStBridge,09/04/2014 10:00:00 AM,48,-122,27,17,44
5915,SpokaneStBridge,09/04/2014 11:00:00 AM,48,-122,25,15,40
5916,SpokaneStBridge,09/04/2014 12:00:00 PM,48,-122,22,23,45
5917,SpokaneStBridge,09/04/2014 01:00:00 PM,48,-122,24,11,35
5918,SpokaneStBridge,09/04/2014 02:00:00 PM,48,-122,20,25,45
5919,SpokaneStBridge,09/04/2014 03:00:00 PM,48,-122,21,41,62
5920,SpokaneStBridge,09/04/2014 04:00:00 PM,48,-122,35,124,159
5921,SpokaneStBridge,09/04/2014 05:00:00 PM,48,-122,31,206,237
5922,SpokaneStBridge,09/04/2014 06:00:00 PM,48,-122,13,87,100
5923,SpokaneStBridge,09/04/2014 07:00:00 PM,48,-122,5,35,40
5924,SpokaneStBridge,09/04/2014 08:00:00 PM,48,-122,4,13,17
5925,SpokaneStBridge,09/04/2014 09:00:00 PM,48,-122,14,20,34
5926,SpokaneStBridge,09/04/2014 10:00:00 PM,48,-122,0,8,8
5927,SpokaneStBridge,09/04/2014 11:00:00 PM,48,-122,2,7,9
5928,SpokaneStBridge,09/05/2014 12:00:00 AM,48,-122,0,5,5
5929,SpokaneStBridge,09/05/2014 01:00:00 AM,48,-122,0,2,2
5930,SpokaneStBridge,09/05/2014 02:00:00 AM,48,-122,1,1,2
5931,SpokaneStBridge,09/05/2014 03:00:00 AM,48,-122,3,2,5
5932,SpokaneStBridge,09/05/2014 04:00:00 AM,48,-122,3,0,3
5933,SpokaneStBridge,09/05/2014 05:00:00 AM,48,-122,18,1,19
5934,SpokaneStBridge,09/05/2014 06:00:00 AM,48,-122,46,5,51
5935,SpokaneStBridge,09/05/2014 07:00:00 AM,48,-122,112,10,122
5936,SpokaneStBridge,09/05/2014 08:00:00 AM,48,-122,130,8,138
5937,SpokaneStBridge,09/05/2014 09:00:00 AM,48,-122,40,16,56
5938,SpokaneStBridge,09/05/2014 10:00:00 AM,48,-122,30,12,42
5939,SpokaneStBridge,09/05/2014 11:00:00 AM,48,-122,14,9,23
5940,SpokaneStBridge,09/05/2014 12:00:00 PM,48,-122,13,19,32
5941,SpokaneStBridge,09/05/2014 01:00:00 PM,48,-122,20,21,41
5942,SpokaneStBridge,09/05/2014 02:00:00 PM,48,-122,14,26,40
5943,SpokaneStBridge,09/05/2014 03:00:00 PM,48,-122,25,37,62
5944,SpokaneStBridge,09/05/2014 04:00:00 PM,48,-122,32,78,110
5945,SpokaneStBridge,09/05/2014 05:00:00 PM,48,-122,21,106,127
5946,SpokaneStBridge,09/05/2014 06:00:00 PM,48,-122,25,97,122
5947,SpokaneStBridge,09/05/2014 07:00:00 PM,48,-122,10,34,44
5948,SpokaneStBridge,09/05/2014 08:00:00 PM,48,-122,5,18,23
5949,SpokaneStBridge,09/05/2014 09:00:00 PM,48,-122,7,8,15
5950,SpokaneStBridge,09/05/2014 10:00:00 PM,48,-122,5,3,8
5951,SpokaneStBridge,09/05/2014 11:00:00 PM,48,-122,5,3,8
5952,SpokaneStBridge,09/06/2014 12:00:00 AM,48,-122,0,2,2
5953,SpokaneStBridge,09/06/2014 01:00:00 AM,48,-122,4,5,9
5954,SpokaneStBridge,09/06/2014 02:00:00 AM,48,-122,0,3,3
5955,SpokaneStBridge,09/06/2014 03:00:00 AM,48,-122,0,1,1
5956,SpokaneStBridge,09/06/2014 04:00:00 AM,48,-122,1,0,1
5957,SpokaneStBridge,09/06/2014 05:00:00 AM,48,-122,4,0,4
5958,SpokaneStBridge,09/06/2014 06:00:00 AM,48,-122,7,3,10
5959,SpokaneStBridge,09/06/2014 07:00:00 AM,48,-122,8,6,14
5960,SpokaneStBridge,09/06/2014 08:00:00 AM,48,-122,23,13,36
5961,SpokaneStBridge,09/06/2014 09:00:00 AM,48,-122,24,13,37
5962,SpokaneStBridge,09/06/2014 10:00:00 AM,48,-122,30,24,54
5963,SpokaneStBridge,09/06/2014 11:00:00 AM,48,-122,33,25,58
5964,SpokaneStBridge,09/06/2014 12:00:00 PM,48,-122,27,33,60
5965,SpokaneStBridge,09/06/2014 01:00:00 PM,48,-122,42,43,85
5966,SpokaneStBridge,09/06/2014 02:00:00 PM,48,-122,31,42,73
5967,SpokaneStBridge,09/06/2014 03:00:00 PM,48,-122,29,34,63
5968,SpokaneStBridge,09/06/2014 04:00:00 PM,48,-122,23,36,59
5969,SpokaneStBridge,09/06/2014 05:00:00 PM,48,-122,19,22,41
5970,SpokaneStBridge,09/06/2014 06:00:00 PM,48,-122,14,27,41
5971,SpokaneStBridge,09/06/2014 07:00:00 PM,48,-122,13,13,26
5972,SpokaneStBridge,09/06/2014 08:00:00 PM,48,-122,7,11,18
5973,SpokaneStBridge,09/06/2014 09:00:00 PM,48,-122,9,6,15
5974,SpokaneStBridge,09/06/2014 10:00:00 PM,48,-122,4,2,6
5975,SpokaneStBridge,09/06/2014 11:00:00 PM,48,-122,1,7,8
5976,SpokaneStBridge,09/07/2014 12:00:00 AM,48,-122,1,1,2
5977,SpokaneStBridge,09/07/2014 01:00:00 AM,48,-122,2,0,2
5978,SpokaneStBridge,09/07/2014 02:00:00 AM,48,-122,2,2,4
5979,SpokaneStBridge,09/07/2014 03:00:00 AM,48,-122,2,6,8
5980,SpokaneStBridge,09/07/2014 04:00:00 AM,48,-122,1,0,1
5981,SpokaneStBridge,09/07/2014 05:00:00 AM,48,-122,3,3,6
5982,SpokaneStBridge,09/07/2014 06:00:00 AM,48,-122,2,1,3
5983,SpokaneStBridge,09/07/2014 07:00:00 AM,48,-122,5,4,9
5984,SpokaneStBridge,09/07/2014 08:00:00 AM,48,-122,16,5,21
5985,SpokaneStBridge,09/07/2014 09:00:00 AM,48,-122,26,13,39
5986,SpokaneStBridge,09/07/2014 10:00:00 AM,48,-122,30,16,46
5987,SpokaneStBridge,09/07/2014 11:00:00 AM,48,-122,27,31,58
5988,SpokaneStBridge,09/07/2014 12:00:00 PM,48,-122,33,40,73
5989,SpokaneStBridge,09/07/2014 01:00:00 PM,48,-122,26,27,53
5990,SpokaneStBridge,09/07/2014 02:00:00 PM,48,-122,32,34,66
5991,SpokaneStBridge,09/07/2014 03:00:00 PM,48,-122,28,35,63
5992,SpokaneStBridge,09/07/2014 04:00:00 PM,48,-122,19,32,51
5993,SpokaneStBridge,09/07/2014 05:00:00 PM,48,-122,24,22,46
5994,SpokaneStBridge,09/07/2014 06:00:00 PM,48,-122,17,19,36
5995,SpokaneStBridge,09/07/2014 07:00:00 PM,48,-122,11,6,17
5996,SpokaneStBridge,09/07/2014 08:00:00 PM,48,-122,4,8,12
5997,SpokaneStBridge,09/07/2014 09:00:00 PM,48,-122,6,4,10
5998,SpokaneStBridge,09/07/2014 10:00:00 PM,48,-122,5,5,10
5999,SpokaneStBridge,09/07/2014 11:00:00 PM,48,-122,2,5,7
6000,SpokaneStBridge,09/08/2014 12:00:00 AM,48,-122,0,0,0
6001,SpokaneStBridge,09/08/2014 01:00:00 AM,48,-122,1,1,2
6002,SpokaneStBridge,09/08/2014 02:00:00 AM,48,-122,2,3,5
6003,SpokaneStBridge,09/08/2014 03:00:00 AM,48,-122,2,1,3
6004,SpokaneStBridge,09/08/2014 04:00:00 AM,48,-122,5,2,7
6005,SpokaneStBridge,09/08/2014 05:00:00 AM,48,-122,19,6,25
6006,SpokaneStBridge,09/08/2014 06:00:00 AM,48,-122,56,7,63
6007,SpokaneStBridge,09/08/2014 07:00:00 AM,48,-122,117,15,132
6008,SpokaneStBridge,09/08/2014 08:00:00 AM,48,-122,104,13,117
6009,SpokaneStBridge,09/08/2014 09:00:00 AM,48,-122,74,4,78
6010,SpokaneStBridge,09/08/2014 10:00:00 AM,48,-122,23,9,32
6011,SpokaneStBridge,09/08/2014 11:00:00 AM,48,-122,10,9,19
6012,SpokaneStBridge,09/08/2014 12:00:00 PM,48,-122,10,10,20
6013,SpokaneStBridge,09/08/2014 01:00:00 PM,48,-122,9,14,23
6014,SpokaneStBridge,09/08/2014 02:00:00 PM,48,-122,13,9,22
6015,SpokaneStBridge,09/08/2014 03:00:00 PM,48,-122,11,26,37
6016,SpokaneStBridge,09/08/2014 04:00:00 PM,48,-122,21,69,90
6017,SpokaneStBridge,09/08/2014 05:00:00 PM,48,-122,31,156,187
6018,SpokaneStBridge,09/08/2014 06:00:00 PM,48,-122,14,104,118
6019,SpokaneStBridge,09/08/2014 07:00:00 PM,48,-122,8,28,36
6020,SpokaneStBridge,09/08/2014 08:00:00 PM,48,-122,3,9,12
6021,SpokaneStBridge,09/08/2014 09:00:00 PM,48,-122,3,2,5
6022,SpokaneStBridge,09/08/2014 10:00:00 PM,48,-122,1,4,5
6023,SpokaneStBridge,09/08/2014 11:00:00 PM,48,-122,1,7,8
6024,SpokaneStBridge,09/09/2014 12:00:00 AM,48,-122,1,2,3
6025,SpokaneStBridge,09/09/2014 01:00:00 AM,48,-122,0,2,2
6026,SpokaneStBridge,09/09/2014 02:00:00 AM,48,-122,0,2,2
6027,SpokaneStBridge,09/09/2014 03:00:00 AM,48,-122,0,1,1
6028,SpokaneStBridge,09/09/2014 04:00:00 AM,48,-122,1,1,2
6029,SpokaneStBridge,09/09/2014 05:00:00 AM,48,-122,21,3,24
6030,SpokaneStBridge,09/09/2014 06:00:00 AM,48,-122,46,11,57
6031,SpokaneStBridge,09/09/2014 07:00:00 AM,48,-122,113,18,131
6032,SpokaneStBridge,09/09/2014 08:00:00 AM,48,-122,103,13,116
6033,SpokaneStBridge,09/09/2014 09:00:00 AM,48,-122,49,0,49
6034,SpokaneStBridge,09/09/2014 10:00:00 AM,48,-122,14,7,21
6035,SpokaneStBridge,09/09/2014 11:00:00 AM,48,-122,13,9,22
6036,SpokaneStBridge,09/09/2014 12:00:00 PM,48,-122,15,13,28
6037,SpokaneStBridge,09/09/2014 01:00:00 PM,48,-122,12,9,21
6038,SpokaneStBridge,09/09/2014 02:00:00 PM,48,-122,15,12,27
6039,SpokaneStBridge,09/09/2014 03:00:00 PM,48,-122,11,25,36
6040,SpokaneStBridge,09/09/2014 04:00:00 PM,48,-122,25,51,76
6041,SpokaneStBridge,09/09/2014 05:00:00 PM,48,-122,25,153,178
6042,SpokaneStBridge,09/09/2014 06:00:00 PM,48,-122,20,103,123
6043,SpokaneStBridge,09/09/2014 07:00:00 PM,48,-122,13,52,65
6044,SpokaneStBridge,09/09/2014 08:00:00 PM,48,-122,8,15,23
6045,SpokaneStBridge,09/09/2014 09:00:00 PM,48,-122,3,5,8
6046,SpokaneStBridge,09/09/2014 10:00:00 PM,48,-122,5,10,15
6047,SpokaneStBridge,09/09/2014 11:00:00 PM,48,-122,0,2,2
6048,SpokaneStBridge,09/10/2014 12:00:00 AM,48,-122,3,4,7
6049,SpokaneStBridge,09/10/2014 01:00:00 AM,48,-122,1,0,1
6050,SpokaneStBridge,09/10/2014 02:00:00 AM,48,-122,1,4,5
6051,SpokaneStBridge,09/10/2014 03:00:00 AM,48,-122,2,0,2
6052,SpokaneStBridge,09/10/2014 04:00:00 AM,48,-122,4,3,7
6053,SpokaneStBridge,09/10/2014 05:00:00 AM,48,-122,15,5,20
6054,SpokaneStBridge,09/10/2014 06:00:00 AM,48,-122,55,8,63
6055,SpokaneStBridge,09/10/2014 07:00:00 AM,48,-122,110,13,123
6056,SpokaneStBridge,09/10/2014 08:00:00 AM,48,-122,111,12,123
6057,SpokaneStBridge,09/10/2014 09:00:00 AM,48,-122,47,7,54
6058,SpokaneStBridge,09/10/2014 10:00:00 AM,48,-122,24,6,30
6059,SpokaneStBridge,09/10/2014 11:00:00 AM,48,-122,13,6,19
6060,SpokaneStBridge,09/10/2014 12:00:00 PM,48,-122,9,4,13
6061,SpokaneStBridge,09/10/2014 01:00:00 PM,48,-122,8,17,25
6062,SpokaneStBridge,09/10/2014 02:00:00 PM,48,-122,13,12,25
6063,SpokaneStBridge,09/10/2014 03:00:00 PM,48,-122,15,31,46
6064,SpokaneStBridge,09/10/2014 04:00:00 PM,48,-122,32,58,90
6065,SpokaneStBridge,09/10/2014 05:00:00 PM,48,-122,26,129,155
6066,SpokaneStBridge,09/10/2014 06:00:00 PM,48,-122,27,99,126
6067,SpokaneStBridge,09/10/2014 07:00:00 PM,48,-122,10,32,42
6068,SpokaneStBridge,09/10/2014 08:00:00 PM,48,-122,7,17,24
6069,SpokaneStBridge,09/10/2014 09:00:00 PM,48,-122,2,7,9
6070,SpokaneStBridge,09/10/2014 10:00:00 PM,48,-122,8,2,10
6071,SpokaneStBridge,09/10/2014 11:00:00 PM,48,-122,0,9,9
6072,SpokaneStBridge,09/11/2014 12:00:00 AM,48,-122,0,8,8
6073,SpokaneStBridge,09/11/2014 01:00:00 AM,48,-122,2,4,6
6074,SpokaneStBridge,09/11/2014 02:00:00 AM,48,-122,2,0,2
6075,SpokaneStBridge,09/11/2014 03:00:00 AM,48,-122,3,1,4
6076,SpokaneStBridge,09/11/2014 04:00:00 AM,48,-122,2,1,3
6077,SpokaneStBridge,09/11/2014 05:00:00 AM,48,-122,16,5,21
6078,SpokaneStBridge,09/11/2014 06:00:00 AM,48,-122,46,14,60
6079,SpokaneStBridge,09/11/2014 07:00:00 AM,48,-122,127,14,141
6080,SpokaneStBridge,09/11/2014 08:00:00 AM,48,-122,122,7,129
6081,SpokaneStBridge,09/11/2014 09:00:00 AM,48,-122,60,3,63
6082,SpokaneStBridge,09/11/2014 10:00:00 AM,48,-122,15,8,23
6083,SpokaneStBridge,09/11/2014 11:00:00 AM,48,-122,16,2,18
6084,SpokaneStBridge,09/11/2014 12:00:00 PM,48,-122,12,14,26
6085,SpokaneStBridge,09/11/2014 01:00:00 PM,48,-122,14,21,35
6086,SpokaneStBridge,09/11/2014 02:00:00 PM,48,-122,5,20,25
6087,SpokaneStBridge,09/11/2014 03:00:00 PM,48,-122,16,34,50
6088,SpokaneStBridge,09/11/2014 04:00:00 PM,48,-122,17,64,81
6089,SpokaneStBridge,09/11/2014 05:00:00 PM,48,-122,26,151,177
6090,SpokaneStBridge,09/11/2014 06:00:00 PM,48,-122,14,108,122
6091,SpokaneStBridge,09/11/2014 07:00:00 PM,48,-122,8,40,48
6092,SpokaneStBridge,09/11/2014 08:00:00 PM,48,-122,12,13,25
6093,SpokaneStBridge,09/11/2014 09:00:00 PM,48,-122,10,8,18
6094,SpokaneStBridge,09/11/2014 10:00:00 PM,48,-122,4,2,6
6095,SpokaneStBridge,09/11/2014 11:00:00 PM,48,-122,0,4,4
6096,SpokaneStBridge,09/12/2014 12:00:00 AM,48,-122,3,6,9
6097,SpokaneStBridge,09/12/2014 01:00:00 AM,48,-122,2,1,3
6098,SpokaneStBridge,09/12/2014 02:00:00 AM,48,-122,3,2,5
6099,SpokaneStBridge,09/12/2014 03:00:00 AM,48,-122,1,1,2
6100,SpokaneStBridge,09/12/2014 04:00:00 AM,48,-122,1,0,1
6101,SpokaneStBridge,09/12/2014 05:00:00 AM,48,-122,11,8,19
6102,SpokaneStBridge,09/12/2014 06:00:00 AM,48,-122,43,8,51
6103,SpokaneStBridge,09/12/2014 07:00:00 AM,48,-122,110,11,121
6104,SpokaneStBridge,09/12/2014 08:00:00 AM,48,-122,108,10,118
6105,SpokaneStBridge,09/12/2014 09:00:00 AM,48,-122,42,9,51
6106,SpokaneStBridge,09/12/2014 10:00:00 AM,48,-122,26,11,37
6107,SpokaneStBridge,09/12/2014 11:00:00 AM,48,-122,15,5,20
6108,SpokaneStBridge,09/12/2014 12:00:00 PM,48,-122,13,12,25
6109,SpokaneStBridge,09/12/2014 01:00:00 PM,48,-122,14,17,31
6110,SpokaneStBridge,09/12/2014 02:00:00 PM,48,-122,15,16,31
6111,SpokaneStBridge,09/12/2014 03:00:00 PM,48,-122,22,28,50
6112,SpokaneStBridge,09/12/2014 04:00:00 PM,48,-122,21,65,86
6113,SpokaneStBridge,09/12/2014 05:00:00 PM,48,-122,24,122,146
6114,SpokaneStBridge,09/12/2014 06:00:00 PM,48,-122,25,71,96
6115,SpokaneStBridge,09/12/2014 07:00:00 PM,48,-122,15,27,42
6116,SpokaneStBridge,09/12/2014 08:00:00 PM,48,-122,6,6,12
6117,SpokaneStBridge,09/12/2014 09:00:00 PM,48,-122,3,10,13
6118,SpokaneStBridge,09/12/2014 10:00:00 PM,48,-122,4,16,20
6119,SpokaneStBridge,09/12/2014 11:00:00 PM,48,-122,0,5,5
6120,SpokaneStBridge,09/13/2014 12:00:00 AM,48,-122,2,9,11
6121,SpokaneStBridge,09/13/2014 01:00:00 AM,48,-122,1,4,5
6122,SpokaneStBridge,09/13/2014 02:00:00 AM,48,-122,0,3,3
6123,SpokaneStBridge,09/13/2014 03:00:00 AM,48,-122,1,4,5
6124,SpokaneStBridge,09/13/2014 04:00:00 AM,48,-122,0,1,1
6125,SpokaneStBridge,09/13/2014 05:00:00 AM,48,-122,1,1,2
6126,SpokaneStBridge,09/13/2014 06:00:00 AM,48,-122,10,6,16
6127,SpokaneStBridge,09/13/2014 07:00:00 AM,48,-122,8,7,15
6128,SpokaneStBridge,09/13/2014 08:00:00 AM,48,-122,9,5,14
6129,SpokaneStBridge,09/13/2014 09:00:00 AM,48,-122,21,15,36
6130,SpokaneStBridge,09/13/2014 10:00:00 AM,48,-122,20,22,42
6131,SpokaneStBridge,09/13/2014 11:00:00 AM,48,-122,19,22,41
6132,SpokaneStBridge,09/13/2014 12:00:00 PM,48,-122,27,28,55
6133,SpokaneStBridge,09/13/2014 01:00:00 PM,48,-122,40,37,77
6134,SpokaneStBridge,09/13/2014 02:00:00 PM,48,-122,25,22,47
6135,SpokaneStBridge,09/13/2014 03:00:00 PM,48,-122,31,33,64
6136,SpokaneStBridge,09/13/2014 04:00:00 PM,48,-122,30,22,52
6137,SpokaneStBridge,09/13/2014 05:00:00 PM,48,-122,29,23,52
6138,SpokaneStBridge,09/13/2014 06:00:00 PM,48,-122,14,30,44
6139,SpokaneStBridge,09/13/2014 07:00:00 PM,48,-122,14,15,29
6140,SpokaneStBridge,09/13/2014 08:00:00 PM,48,-122,8,8,16
6141,SpokaneStBridge,09/13/2014 09:00:00 PM,48,-122,7,8,15
6142,SpokaneStBridge,09/13/2014 10:00:00 PM,48,-122,8,16,24
6143,SpokaneStBridge,09/13/2014 11:00:00 PM,48,-122,2,3,5
6144,SpokaneStBridge,09/14/2014 12:00:00 AM,48,-122,3,2,5
6145,SpokaneStBridge,09/14/2014 01:00:00 AM,48,-122,0,1,1
6146,SpokaneStBridge,09/14/2014 02:00:00 AM,48,-122,1,2,3
6147,SpokaneStBridge,09/14/2014 03:00:00 AM,48,-122,1,3,4
6148,SpokaneStBridge,09/14/2014 04:00:00 AM,48,-122,0,0,0
6149,SpokaneStBridge,09/14/2014 05:00:00 AM,48,-122,1,0,1
6150,SpokaneStBridge,09/14/2014 06:00:00 AM,48,-122,1,2,3
6151,SpokaneStBridge,09/14/2014 07:00:00 AM,48,-122,9,4,13
6152,SpokaneStBridge,09/14/2014 08:00:00 AM,48,-122,20,9,29
6153,SpokaneStBridge,09/14/2014 09:00:00 AM,48,-122,27,22,49
6154,SpokaneStBridge,09/14/2014 10:00:00 AM,48,-122,24,25,49
6155,SpokaneStBridge,09/14/2014 11:00:00 AM,48,-122,29,17,46
6156,SpokaneStBridge,09/14/2014 12:00:00 PM,48,-122,17,44,61
6157,SpokaneStBridge,09/14/2014 01:00:00 PM,48,-122,24,45,69
6158,SpokaneStBridge,09/14/2014 02:00:00 PM,48,-122,31,29,60
6159,SpokaneStBridge,09/14/2014 03:00:00 PM,48,-122,43,30,73
6160,SpokaneStBridge,09/14/2014 04:00:00 PM,48,-122,30,31,61
6161,SpokaneStBridge,09/14/2014 05:00:00 PM,48,-122,23,27,50
6162,SpokaneStBridge,09/14/2014 06:00:00 PM,48,-122,20,11,31
6163,SpokaneStBridge,09/14/2014 07:00:00 PM,48,-122,16,17,33
6164,SpokaneStBridge,09/14/2014 08:00:00 PM,48,-122,6,8,14
6165,SpokaneStBridge,09/14/2014 09:00:00 PM,48,-122,4,5,9
6166,SpokaneStBridge,09/14/2014 10:00:00 PM,48,-122,3,6,9
6167,SpokaneStBridge,09/14/2014 11:00:00 PM,48,-122,0,2,2
6168,SpokaneStBridge,09/15/2014 12:00:00 AM,48,-122,0,1,1
6169,SpokaneStBridge,09/15/2014 01:00:00 AM,48,-122,3,0,3
6170,SpokaneStBridge,09/15/2014 02:00:00 AM,48,-122,0,1,1
6171,SpokaneStBridge,09/15/2014 03:00:00 AM,48,-122,1,2,3
6172,SpokaneStBridge,09/15/2014 04:00:00 AM,48,-122,2,2,4
6173,SpokaneStBridge,09/15/2014 05:00:00 AM,48,-122,17,6,23
6174,SpokaneStBridge,09/15/2014 06:00:00 AM,48,-122,45,12,57
6175,SpokaneStBridge,09/15/2014 07:00:00 AM,48,-122,135,14,149
6176,SpokaneStBridge,09/15/2014 08:00:00 AM,48,-122,133,19,152
6177,SpokaneStBridge,09/15/2014 09:00:00 AM,48,-122,46,4,50
6178,SpokaneStBridge,09/15/2014 10:00:00 AM,48,-122,14,5,19
6179,SpokaneStBridge,09/15/2014 11:00:00 AM,48,-122,14,14,28
6180,SpokaneStBridge,09/15/2014 12:00:00 PM,48,-122,16,13,29
6181,SpokaneStBridge,09/15/2014 01:00:00 PM,48,-122,17,12,29
6182,SpokaneStBridge,09/15/2014 02:00:00 PM,48,-122,16,22,38
6183,SpokaneStBridge,09/15/2014 03:00:00 PM,48,-122,18,27,45
6184,SpokaneStBridge,09/15/2014 04:00:00 PM,48,-122,24,59,83
6185,SpokaneStBridge,09/15/2014 05:00:00 PM,48,-122,32,170,202
6186,SpokaneStBridge,09/15/2014 06:00:00 PM,48,-122,18,126,144
6187,SpokaneStBridge,09/15/2014 07:00:00 PM,48,-122,14,35,49
6188,SpokaneStBridge,09/15/2014 08:00:00 PM,48,-122,7,14,21
6189,SpokaneStBridge,09/15/2014 09:00:00 PM,48,-122,8,8,16
6190,SpokaneStBridge,09/15/2014 10:00:00 PM,48,-122,6,4,10
6191,SpokaneStBridge,09/15/2014 11:00:00 PM,48,-122,3,12,15
6192,SpokaneStBridge,09/16/2014 12:00:00 AM,48,-122,0,2,2
6193,SpokaneStBridge,09/16/2014 01:00:00 AM,48,-122,3,2,5
6194,SpokaneStBridge,09/16/2014 02:00:00 AM,48,-122,0,1,1
6195,SpokaneStBridge,09/16/2014 03:00:00 AM,48,-122,1,0,1
6196,SpokaneStBridge,09/16/2014 04:00:00 AM,48,-122,1,2,3
6197,SpokaneStBridge,09/16/2014 05:00:00 AM,48,-122,27,5,32
6198,SpokaneStBridge,09/16/2014 06:00:00 AM,48,-122,50,8,58
6199,SpokaneStBridge,09/16/2014 07:00:00 AM,48,-122,134,22,156
6200,SpokaneStBridge,09/16/2014 08:00:00 AM,48,-122,150,18,168
6201,SpokaneStBridge,09/16/2014 09:00:00 AM,48,-122,44,7,51
6202,SpokaneStBridge,09/16/2014 10:00:00 AM,48,-122,15,4,19
6203,SpokaneStBridge,09/16/2014 11:00:00 AM,48,-122,17,6,23
6204,SpokaneStBridge,09/16/2014 12:00:00 PM,48,-122,22,18,40
6205,SpokaneStBridge,09/16/2014 01:00:00 PM,48,-122,9,11,20
6206,SpokaneStBridge,09/16/2014 02:00:00 PM,48,-122,15,20,35
6207,SpokaneStBridge,09/16/2014 03:00:00 PM,48,-122,12,42,54
6208,SpokaneStBridge,09/16/2014 04:00:00 PM,48,-122,27,78,105
6209,SpokaneStBridge,09/16/2014 05:00:00 PM,48,-122,35,158,193
6210,SpokaneStBridge,09/16/2014 06:00:00 PM,48,-122,12,118,130
6211,SpokaneStBridge,09/16/2014 07:00:00 PM,48,-122,11,56,67
6212,SpokaneStBridge,09/16/2014 08:00:00 PM,48,-122,5,12,17
6213,SpokaneStBridge,09/16/2014 09:00:00 PM,48,-122,3,6,9
6214,SpokaneStBridge,09/16/2014 10:00:00 PM,48,-122,1,6,7
6215,SpokaneStBridge,09/16/2014 11:00:00 PM,48,-122,1,5,6
6216,SpokaneStBridge,09/17/2014 12:00:00 AM,48,-122,0,3,3
6217,SpokaneStBridge,09/17/2014 01:00:00 AM,48,-122,1,0,1
6218,SpokaneStBridge,09/17/2014 02:00:00 AM,48,-122,0,1,1
6219,SpokaneStBridge,09/17/2014 03:00:00 AM,48,-122,0,0,0
6220,SpokaneStBridge,09/17/2014 04:00:00 AM,48,-122,3,5,8
6221,SpokaneStBridge,09/17/2014 05:00:00 AM,48,-122,27,9,36
6222,SpokaneStBridge,09/17/2014 06:00:00 AM,48,-122,60,10,70
6223,SpokaneStBridge,09/17/2014 07:00:00 AM,48,-122,121,16,137
6224,SpokaneStBridge,09/17/2014 08:00:00 AM,48,-122,125,13,138
6225,SpokaneStBridge,09/17/2014 09:00:00 AM,48,-122,40,5,45
6226,SpokaneStBridge,09/17/2014 10:00:00 AM,48,-122,21,3,24
6227,SpokaneStBridge,09/17/2014 11:00:00 AM,48,-122,6,6,12
6228,SpokaneStBridge,09/17/2014 12:00:00 PM,48,-122,12,14,26
6229,SpokaneStBridge,09/17/2014 01:00:00 PM,48,-122,14,9,23
6230,SpokaneStBridge,09/17/2014 02:00:00 PM,48,-122,6,17,23
6231,SpokaneStBridge,09/17/2014 03:00:00 PM,48,-122,7,29,36
6232,SpokaneStBridge,09/17/2014 04:00:00 PM,48,-122,24,82,106
6233,SpokaneStBridge,09/17/2014 05:00:00 PM,48,-122,36,142,178
6234,SpokaneStBridge,09/17/2014 06:00:00 PM,48,-122,18,115,133
6235,SpokaneStBridge,09/17/2014 07:00:00 PM,48,-122,7,28,35
6236,SpokaneStBridge,09/17/2014 08:00:00 PM,48,-122,7,16,23
6237,SpokaneStBridge,09/17/2014 09:00:00 PM,48,-122,2,9,11
6238,SpokaneStBridge,09/17/2014 10:00:00 PM,48,-122,1,4,5
6239,SpokaneStBridge,09/17/2014 11:00:00 PM,48,-122,2,0,2
6240,SpokaneStBridge,09/18/2014 12:00:00 AM,48,-122,0,3,3
6241,SpokaneStBridge,09/18/2014 01:00:00 AM,48,-122,2,0,2
6242,SpokaneStBridge,09/18/2014 02:00:00 AM,48,-122,1,0,1
6243,SpokaneStBridge,09/18/2014 03:00:00 AM,48,-122,1,1,2
6244,SpokaneStBridge,09/18/2014 04:00:00 AM,48,-122,0,0,0
6245,SpokaneStBridge,09/18/2014 05:00:00 AM,48,-122,21,2,23
6246,SpokaneStBridge,09/18/2014 06:00:00 AM,48,-122,44,9,53
6247,SpokaneStBridge,09/18/2014 07:00:00 AM,48,-122,77,14,91
6248,SpokaneStBridge,09/18/2014 08:00:00 AM,48,-122,101,11,112
6249,SpokaneStBridge,09/18/2014 09:00:00 AM,48,-122,36,1,37
6250,SpokaneStBridge,09/18/2014 10:00:00 AM,48,-122,19,6,25
6251,SpokaneStBridge,09/18/2014 11:00:00 AM,48,-122,8,6,14
6252,SpokaneStBridge,09/18/2014 12:00:00 PM,48,-122,14,7,21
6253,SpokaneStBridge,09/18/2014 01:00:00 PM,48,-122,9,7,16
6254,SpokaneStBridge,09/18/2014 02:00:00 PM,48,-122,6,17,23
6255,SpokaneStBridge,09/18/2014 03:00:00 PM,48,-122,7,29,36
6256,SpokaneStBridge,09/18/2014 04:00:00 PM,48,-122,13,42,55
6257,SpokaneStBridge,09/18/2014 05:00:00 PM,48,-122,19,96,115
6258,SpokaneStBridge,09/18/2014 06:00:00 PM,48,-122,23,74,97
6259,SpokaneStBridge,09/18/2014 07:00:00 PM,48,-122,16,37,53
6260,SpokaneStBridge,09/18/2014 08:00:00 PM,48,-122,4,10,14
6261,SpokaneStBridge,09/18/2014 09:00:00 PM,48,-122,5,9,14
6262,SpokaneStBridge,09/18/2014 10:00:00 PM,48,-122,2,8,10
6263,SpokaneStBridge,09/18/2014 11:00:00 PM,48,-122,3,8,11
6264,SpokaneStBridge,09/19/2014 12:00:00 AM,48,-122,0,0,0
6265,SpokaneStBridge,09/19/2014 01:00:00 AM,48,-122,1,3,4
6266,SpokaneStBridge,09/19/2014 02:00:00 AM,48,-122,0,1,1
6267,SpokaneStBridge,09/19/2014 03:00:00 AM,48,-122,1,0,1
6268,SpokaneStBridge,09/19/2014 04:00:00 AM,48,-122,4,0,4
6269,SpokaneStBridge,09/19/2014 05:00:00 AM,48,-122,14,6,20
6270,SpokaneStBridge,09/19/2014 06:00:00 AM,48,-122,43,7,50
6271,SpokaneStBridge,09/19/2014 07:00:00 AM,48,-122,86,11,97
6272,SpokaneStBridge,09/19/2014 08:00:00 AM,48,-122,116,13,129
6273,SpokaneStBridge,09/19/2014 09:00:00 AM,48,-122,42,12,54
6274,SpokaneStBridge,09/19/2014 10:00:00 AM,48,-122,18,5,23
6275,SpokaneStBridge,09/19/2014 11:00:00 AM,48,-122,12,15,27
6276,SpokaneStBridge,09/19/2014 12:00:00 PM,48,-122,22,12,34
6277,SpokaneStBridge,09/19/2014 01:00:00 PM,48,-122,12,13,25
6278,SpokaneStBridge,09/19/2014 02:00:00 PM,48,-122,10,16,26
6279,SpokaneStBridge,09/19/2014 03:00:00 PM,48,-122,13,26,39
6280,SpokaneStBridge,09/19/2014 04:00:00 PM,48,-122,15,62,77
6281,SpokaneStBridge,09/19/2014 05:00:00 PM,48,-122,34,115,149
6282,SpokaneStBridge,09/19/2014 06:00:00 PM,48,-122,11,60,71
6283,SpokaneStBridge,09/19/2014 07:00:00 PM,48,-122,11,24,35
6284,SpokaneStBridge,09/19/2014 08:00:00 PM,48,-122,10,15,25
6285,SpokaneStBridge,09/19/2014 09:00:00 PM,48,-122,4,1,5
6286,SpokaneStBridge,09/19/2014 10:00:00 PM,48,-122,0,3,3
6287,SpokaneStBridge,09/19/2014 11:00:00 PM,48,-122,2,2,4
6288,SpokaneStBridge,09/20/2014 12:00:00 AM,48,-122,4,5,9
6289,SpokaneStBridge,09/20/2014 01:00:00 AM,48,-122,1,7,8
6290,SpokaneStBridge,09/20/2014 02:00:00 AM,48,-122,1,7,8
6291,SpokaneStBridge,09/20/2014 03:00:00 AM,48,-122,0,0,0
6292,SpokaneStBridge,09/20/2014 04:00:00 AM,48,-122,3,1,4
6293,SpokaneStBridge,09/20/2014 05:00:00 AM,48,-122,5,1,6
6294,SpokaneStBridge,09/20/2014 06:00:00 AM,48,-122,9,0,9
6295,SpokaneStBridge,09/20/2014 07:00:00 AM,48,-122,16,3,19
6296,SpokaneStBridge,09/20/2014 08:00:00 AM,48,-122,20,12,32
6297,SpokaneStBridge,09/20/2014 09:00:00 AM,48,-122,16,10,26
6298,SpokaneStBridge,09/20/2014 10:00:00 AM,48,-122,17,36,53
6299,SpokaneStBridge,09/20/2014 11:00:00 AM,48,-122,21,32,53
6300,SpokaneStBridge,09/20/2014 12:00:00 PM,48,-122,22,24,46
6301,SpokaneStBridge,09/20/2014 01:00:00 PM,48,-122,31,24,55
6302,SpokaneStBridge,09/20/2014 02:00:00 PM,48,-122,27,34,61
6303,SpokaneStBridge,09/20/2014 03:00:00 PM,48,-122,17,29,46
6304,SpokaneStBridge,09/20/2014 04:00:00 PM,48,-122,21,27,48
6305,SpokaneStBridge,09/20/2014 05:00:00 PM,48,-122,40,25,65
6306,SpokaneStBridge,09/20/2014 06:00:00 PM,48,-122,20,23,43
6307,SpokaneStBridge,09/20/2014 07:00:00 PM,48,-122,6,18,24
6308,SpokaneStBridge,09/20/2014 08:00:00 PM,48,-122,5,3,8
6309,SpokaneStBridge,09/20/2014 09:00:00 PM,48,-122,3,4,7
6310,SpokaneStBridge,09/20/2014 10:00:00 PM,48,-122,2,5,7
6311,SpokaneStBridge,09/20/2014 11:00:00 PM,48,-122,2,2,4
6312,SpokaneStBridge,09/21/2014 12:00:00 AM,48,-122,1,3,4
6313,SpokaneStBridge,09/21/2014 01:00:00 AM,48,-122,1,4,5
6314,SpokaneStBridge,09/21/2014 02:00:00 AM,48,-122,0,2,2
6315,SpokaneStBridge,09/21/2014 03:00:00 AM,48,-122,0,1,1
6316,SpokaneStBridge,09/21/2014 04:00:00 AM,48,-122,0,1,1
6317,SpokaneStBridge,09/21/2014 05:00:00 AM,48,-122,6,0,6
6318,SpokaneStBridge,09/21/2014 06:00:00 AM,48,-122,0,2,2
6319,SpokaneStBridge,09/21/2014 07:00:00 AM,48,-122,12,4,16
6320,SpokaneStBridge,09/21/2014 08:00:00 AM,48,-122,17,3,20
6321,SpokaneStBridge,09/21/2014 09:00:00 AM,48,-122,22,13,35
6322,SpokaneStBridge,09/21/2014 10:00:00 AM,48,-122,28,24,52
6323,SpokaneStBridge,09/21/2014 11:00:00 AM,48,-122,39,22,61
6324,SpokaneStBridge,09/21/2014 12:00:00 PM,48,-122,51,45,96
6325,SpokaneStBridge,09/21/2014 01:00:00 PM,48,-122,37,27,64
6326,SpokaneStBridge,09/21/2014 02:00:00 PM,48,-122,23,23,46
6327,SpokaneStBridge,09/21/2014 03:00:00 PM,48,-122,24,27,51
6328,SpokaneStBridge,09/21/2014 04:00:00 PM,48,-122,14,34,48
6329,SpokaneStBridge,09/21/2014 05:00:00 PM,48,-122,25,34,59
6330,SpokaneStBridge,09/21/2014 06:00:00 PM,48,-122,18,24,42
6331,SpokaneStBridge,09/21/2014 07:00:00 PM,48,-122,12,18,30
6332,SpokaneStBridge,09/21/2014 08:00:00 PM,48,-122,5,5,10
6333,SpokaneStBridge,09/21/2014 09:00:00 PM,48,-122,3,2,5
6334,SpokaneStBridge,09/21/2014 10:00:00 PM,48,-122,1,5,6
6335,SpokaneStBridge,09/21/2014 11:00:00 PM,48,-122,2,4,6
6336,SpokaneStBridge,09/22/2014 12:00:00 AM,48,-122,1,3,4
6337,SpokaneStBridge,09/22/2014 01:00:00 AM,48,-122,1,0,1
6338,SpokaneStBridge,09/22/2014 02:00:00 AM,48,-122,0,1,1
6339,SpokaneStBridge,09/22/2014 03:00:00 AM,48,-122,1,2,3
6340,SpokaneStBridge,09/22/2014 04:00:00 AM,48,-122,2,0,2
6341,SpokaneStBridge,09/22/2014 05:00:00 AM,48,-122,21,2,23
6342,SpokaneStBridge,09/22/2014 06:00:00 AM,48,-122,51,9,60
6343,SpokaneStBridge,09/22/2014 07:00:00 AM,48,-122,120,15,135
6344,SpokaneStBridge,09/22/2014 08:00:00 AM,48,-122,137,8,145
6345,SpokaneStBridge,09/22/2014 09:00:00 AM,48,-122,45,7,52
6346,SpokaneStBridge,09/22/2014 10:00:00 AM,48,-122,21,4,25
6347,SpokaneStBridge,09/22/2014 11:00:00 AM,48,-122,10,12,22
6348,SpokaneStBridge,09/22/2014 12:00:00 PM,48,-122,12,8,20
6349,SpokaneStBridge,09/22/2014 01:00:00 PM,48,-122,12,11,23
6350,SpokaneStBridge,09/22/2014 02:00:00 PM,48,-122,9,24,33
6351,SpokaneStBridge,09/22/2014 03:00:00 PM,48,-122,16,32,48
6352,SpokaneStBridge,09/22/2014 04:00:00 PM,48,-122,16,75,91
6353,SpokaneStBridge,09/22/2014 05:00:00 PM,48,-122,33,154,187
6354,SpokaneStBridge,09/22/2014 06:00:00 PM,48,-122,16,108,124
6355,SpokaneStBridge,09/22/2014 07:00:00 PM,48,-122,7,34,41
6356,SpokaneStBridge,09/22/2014 08:00:00 PM,48,-122,4,21,25
6357,SpokaneStBridge,09/22/2014 09:00:00 PM,48,-122,7,4,11
6358,SpokaneStBridge,09/22/2014 10:00:00 PM,48,-122,1,2,3
6359,SpokaneStBridge,09/22/2014 11:00:00 PM,48,-122,0,6,6
6360,SpokaneStBridge,09/23/2014 12:00:00 AM,48,-122,1,3,4
6361,SpokaneStBridge,09/23/2014 01:00:00 AM,48,-122,1,0,1
6362,SpokaneStBridge,09/23/2014 02:00:00 AM,48,-122,1,2,3
6363,SpokaneStBridge,09/23/2014 03:00:00 AM,48,-122,1,2,3
6364,SpokaneStBridge,09/23/2014 04:00:00 AM,48,-122,3,0,3
6365,SpokaneStBridge,09/23/2014 05:00:00 AM,48,-122,19,1,20
6366,SpokaneStBridge,09/23/2014 06:00:00 AM,48,-122,49,6,55
6367,SpokaneStBridge,09/23/2014 07:00:00 AM,48,-122,116,14,130
6368,SpokaneStBridge,09/23/2014 08:00:00 AM,48,-122,111,13,124
6369,SpokaneStBridge,09/23/2014 09:00:00 AM,48,-122,37,9,46
6370,SpokaneStBridge,09/23/2014 10:00:00 AM,48,-122,21,6,27
6371,SpokaneStBridge,09/23/2014 11:00:00 AM,48,-122,4,4,8
6372,SpokaneStBridge,09/23/2014 12:00:00 PM,48,-122,6,9,15
6373,SpokaneStBridge,09/23/2014 01:00:00 PM,48,-122,9,9,18
6374,SpokaneStBridge,09/23/2014 02:00:00 PM,48,-122,8,7,15
6375,SpokaneStBridge,09/23/2014 03:00:00 PM,48,-122,4,25,29
6376,SpokaneStBridge,09/23/2014 04:00:00 PM,48,-122,15,53,68
6377,SpokaneStBridge,09/23/2014 05:00:00 PM,48,-122,17,118,135
6378,SpokaneStBridge,09/23/2014 06:00:00 PM,48,-122,6,85,91
6379,SpokaneStBridge,09/23/2014 07:00:00 PM,48,-122,1,16,17
6380,SpokaneStBridge,09/23/2014 08:00:00 PM,48,-122,1,8,9
6381,SpokaneStBridge,09/23/2014 09:00:00 PM,48,-122,0,5,5
6382,SpokaneStBridge,09/23/2014 10:00:00 PM,48,-122,1,3,4
6383,SpokaneStBridge,09/23/2014 11:00:00 PM,48,-122,0,0,0
6384,SpokaneStBridge,09/24/2014 12:00:00 AM,48,-122,1,1,2
6385,SpokaneStBridge,09/24/2014 01:00:00 AM,48,-122,0,1,1
6386,SpokaneStBridge,09/24/2014 02:00:00 AM,48,-122,0,0,0
6387,SpokaneStBridge,09/24/2014 03:00:00 AM,48,-122,0,0,0
6388,SpokaneStBridge,09/24/2014 04:00:00 AM,48,-122,2,1,3
6389,SpokaneStBridge,09/24/2014 05:00:00 AM,48,-122,14,4,18
6390,SpokaneStBridge,09/24/2014 06:00:00 AM,48,-122,30,3,33
6391,SpokaneStBridge,09/24/2014 07:00:00 AM,48,-122,41,12,53
6392,SpokaneStBridge,09/24/2014 08:00:00 AM,48,-122,62,9,71
6393,SpokaneStBridge,09/24/2014 09:00:00 AM,48,-122,25,3,28
6394,SpokaneStBridge,09/24/2014 10:00:00 AM,48,-122,2,3,5
6395,SpokaneStBridge,09/24/2014 11:00:00 AM,48,-122,4,1,5
6396,SpokaneStBridge,09/24/2014 12:00:00 PM,48,-122,7,6,13
6397,SpokaneStBridge,09/24/2014 01:00:00 PM,48,-122,9,2,11
6398,SpokaneStBridge,09/24/2014 02:00:00 PM,48,-122,6,9,15
6399,SpokaneStBridge,09/24/2014 03:00:00 PM,48,-122,4,18,22
6400,SpokaneStBridge,09/24/2014 04:00:00 PM,48,-122,8,39,47
6401,SpokaneStBridge,09/24/2014 05:00:00 PM,48,-122,12,74,86
6402,SpokaneStBridge,09/24/2014 06:00:00 PM,48,-122,12,55,67
6403,SpokaneStBridge,09/24/2014 07:00:00 PM,48,-122,7,26,33
6404,SpokaneStBridge,09/24/2014 08:00:00 PM,48,-122,3,10,13
6405,SpokaneStBridge,09/24/2014 09:00:00 PM,48,-122,6,7,13
6406,SpokaneStBridge,09/24/2014 10:00:00 PM,48,-122,5,7,12
6407,SpokaneStBridge,09/24/2014 11:00:00 PM,48,-122,2,0,2
6408,SpokaneStBridge,09/25/2014 12:00:00 AM,48,-122,0,2,2
6409,SpokaneStBridge,09/25/2014 01:00:00 AM,48,-122,1,2,3
6410,SpokaneStBridge,09/25/2014 02:00:00 AM,48,-122,1,0,1
6411,SpokaneStBridge,09/25/2014 03:00:00 AM,48,-122,0,0,0
6412,SpokaneStBridge,09/25/2014 04:00:00 AM,48,-122,2,2,4
6413,SpokaneStBridge,09/25/2014 05:00:00 AM,48,-122,19,4,23
6414,SpokaneStBridge,09/25/2014 06:00:00 AM,48,-122,34,4,38
6415,SpokaneStBridge,09/25/2014 07:00:00 AM,48,-122,87,12,99
6416,SpokaneStBridge,09/25/2014 08:00:00 AM,48,-122,97,8,105
6417,SpokaneStBridge,09/25/2014 09:00:00 AM,48,-122,29,8,37
6418,SpokaneStBridge,09/25/2014 10:00:00 AM,48,-122,13,2,15
6419,SpokaneStBridge,09/25/2014 11:00:00 AM,48,-122,6,3,9
6420,SpokaneStBridge,09/25/2014 12:00:00 PM,48,-122,10,6,16
6421,SpokaneStBridge,09/25/2014 01:00:00 PM,48,-122,9,9,18
6422,SpokaneStBridge,09/25/2014 02:00:00 PM,48,-122,10,7,17
6423,SpokaneStBridge,09/25/2014 03:00:00 PM,48,-122,6,26,32
6424,SpokaneStBridge,09/25/2014 04:00:00 PM,48,-122,19,56,75
6425,SpokaneStBridge,09/25/2014 05:00:00 PM,48,-122,20,100,120
6426,SpokaneStBridge,09/25/2014 06:00:00 PM,48,-122,12,74,86
6427,SpokaneStBridge,09/25/2014 07:00:00 PM,48,-122,3,29,32
6428,SpokaneStBridge,09/25/2014 08:00:00 PM,48,-122,4,9,13
6429,SpokaneStBridge,09/25/2014 09:00:00 PM,48,-122,3,12,15
6430,SpokaneStBridge,09/25/2014 10:00:00 PM,48,-122,4,10,14
6431,SpokaneStBridge,09/25/2014 11:00:00 PM,48,-122,1,3,4
6432,SpokaneStBridge,09/26/2014 12:00:00 AM,48,-122,0,4,4
6433,SpokaneStBridge,09/26/2014 01:00:00 AM,48,-122,1,1,2
6434,SpokaneStBridge,09/26/2014 02:00:00 AM,48,-122,0,1,1
6435,SpokaneStBridge,09/26/2014 03:00:00 AM,48,-122,0,1,1
6436,SpokaneStBridge,09/26/2014 04:00:00 AM,48,-122,4,3,7
6437,SpokaneStBridge,09/26/2014 05:00:00 AM,48,-122,15,2,17
6438,SpokaneStBridge,09/26/2014 06:00:00 AM,48,-122,22,4,26
6439,SpokaneStBridge,09/26/2014 07:00:00 AM,48,-122,50,14,64
6440,SpokaneStBridge,09/26/2014 08:00:00 AM,48,-122,50,7,57
6441,SpokaneStBridge,09/26/2014 09:00:00 AM,48,-122,32,2,34
6442,SpokaneStBridge,09/26/2014 10:00:00 AM,48,-122,10,3,13
6443,SpokaneStBridge,09/26/2014 11:00:00 AM,48,-122,10,3,13
6444,SpokaneStBridge,09/26/2014 12:00:00 PM,48,-122,7,6,13
6445,SpokaneStBridge,09/26/2014 01:00:00 PM,48,-122,9,9,18
6446,SpokaneStBridge,09/26/2014 02:00:00 PM,48,-122,15,17,32
6447,SpokaneStBridge,09/26/2014 03:00:00 PM,48,-122,13,23,36
6448,SpokaneStBridge,09/26/2014 04:00:00 PM,48,-122,15,38,53
6449,SpokaneStBridge,09/26/2014 05:00:00 PM,48,-122,16,55,71
6450,SpokaneStBridge,09/26/2014 06:00:00 PM,48,-122,11,58,69
6451,SpokaneStBridge,09/26/2014 07:00:00 PM,48,-122,7,16,23
6452,SpokaneStBridge,09/26/2014 08:00:00 PM,48,-122,2,8,10
6453,SpokaneStBridge,09/26/2014 09:00:00 PM,48,-122,2,5,7
6454,SpokaneStBridge,09/26/2014 10:00:00 PM,48,-122,4,6,10
6455,SpokaneStBridge,09/26/2014 11:00:00 PM,48,-122,3,4,7
6456,SpokaneStBridge,09/27/2014 12:00:00 AM,48,-122,2,2,4
6457,SpokaneStBridge,09/27/2014 01:00:00 AM,48,-122,2,6,8
6458,SpokaneStBridge,09/27/2014 02:00:00 AM,48,-122,0,0,0
6459,SpokaneStBridge,09/27/2014 03:00:00 AM,48,-122,0,2,2
6460,SpokaneStBridge,09/27/2014 04:00:00 AM,48,-122,0,1,1
6461,SpokaneStBridge,09/27/2014 05:00:00 AM,48,-122,4,3,7
6462,SpokaneStBridge,09/27/2014 06:00:00 AM,48,-122,5,1,6
6463,SpokaneStBridge,09/27/2014 07:00:00 AM,48,-122,9,5,14
6464,SpokaneStBridge,09/27/2014 08:00:00 AM,48,-122,17,8,25
6465,SpokaneStBridge,09/27/2014 09:00:00 AM,48,-122,17,20,37
6466,SpokaneStBridge,09/27/2014 10:00:00 AM,48,-122,24,12,36
6467,SpokaneStBridge,09/27/2014 11:00:00 AM,48,-122,17,36,53
6468,SpokaneStBridge,09/27/2014 12:00:00 PM,48,-122,54,22,76
6469,SpokaneStBridge,09/27/2014 01:00:00 PM,48,-122,31,15,46
6470,SpokaneStBridge,09/27/2014 02:00:00 PM,48,-122,35,50,85
6471,SpokaneStBridge,09/27/2014 03:00:00 PM,48,-122,20,39,59
6472,SpokaneStBridge,09/27/2014 04:00:00 PM,48,-122,44,30,74
6473,SpokaneStBridge,09/27/2014 05:00:00 PM,48,-122,25,33,58
6474,SpokaneStBridge,09/27/2014 06:00:00 PM,48,-122,13,12,25
6475,SpokaneStBridge,09/27/2014 07:00:00 PM,48,-122,9,19,28
6476,SpokaneStBridge,09/27/2014 08:00:00 PM,48,-122,4,9,13
6477,SpokaneStBridge,09/27/2014 09:00:00 PM,48,-122,5,2,7
6478,SpokaneStBridge,09/27/2014 10:00:00 PM,48,-122,0,4,4
6479,SpokaneStBridge,09/27/2014 11:00:00 PM,48,-122,5,1,6
6480,SpokaneStBridge,09/28/2014 12:00:00 AM,48,-122,0,4,4
6481,SpokaneStBridge,09/28/2014 01:00:00 AM,48,-122,2,4,6
6482,SpokaneStBridge,09/28/2014 02:00:00 AM,48,-122,2,3,5
6483,SpokaneStBridge,09/28/2014 03:00:00 AM,48,-122,0,1,1
6484,SpokaneStBridge,09/28/2014 04:00:00 AM,48,-122,0,1,1
6485,SpokaneStBridge,09/28/2014 05:00:00 AM,48,-122,1,1,2
6486,SpokaneStBridge,09/28/2014 06:00:00 AM,48,-122,6,3,9
6487,SpokaneStBridge,09/28/2014 07:00:00 AM,48,-122,6,2,8
6488,SpokaneStBridge,09/28/2014 08:00:00 AM,48,-122,17,8,25
6489,SpokaneStBridge,09/28/2014 09:00:00 AM,48,-122,18,8,26
6490,SpokaneStBridge,09/28/2014 10:00:00 AM,48,-122,21,16,37
6491,SpokaneStBridge,09/28/2014 11:00:00 AM,48,-122,24,24,48
6492,SpokaneStBridge,09/28/2014 12:00:00 PM,48,-122,22,25,47
6493,SpokaneStBridge,09/28/2014 01:00:00 PM,48,-122,24,23,47
6494,SpokaneStBridge,09/28/2014 02:00:00 PM,48,-122,24,19,43
6495,SpokaneStBridge,09/28/2014 03:00:00 PM,48,-122,17,13,30
6496,SpokaneStBridge,09/28/2014 04:00:00 PM,48,-122,14,28,42
6497,SpokaneStBridge,09/28/2014 05:00:00 PM,48,-122,17,24,41
6498,SpokaneStBridge,09/28/2014 06:00:00 PM,48,-122,21,14,35
6499,SpokaneStBridge,09/28/2014 07:00:00 PM,48,-122,2,6,8
6500,SpokaneStBridge,09/28/2014 08:00:00 PM,48,-122,2,2,4
6501,SpokaneStBridge,09/28/2014 09:00:00 PM,48,-122,2,4,6
6502,SpokaneStBridge,09/28/2014 10:00:00 PM,48,-122,3,3,6
6503,SpokaneStBridge,09/28/2014 11:00:00 PM,48,-122,1,2,3
6504,SpokaneStBridge,09/29/2014 12:00:00 AM,48,-122,0,1,1
6505,SpokaneStBridge,09/29/2014 01:00:00 AM,48,-122,1,0,1
6506,SpokaneStBridge,09/29/2014 02:00:00 AM,48,-122,1,0,1
6507,SpokaneStBridge,09/29/2014 03:00:00 AM,48,-122,1,0,1
6508,SpokaneStBridge,09/29/2014 04:00:00 AM,48,-122,1,3,4
6509,SpokaneStBridge,09/29/2014 05:00:00 AM,48,-122,15,2,17
6510,SpokaneStBridge,09/29/2014 06:00:00 AM,48,-122,44,11,55
6511,SpokaneStBridge,09/29/2014 07:00:00 AM,48,-122,105,16,121
6512,SpokaneStBridge,09/29/2014 08:00:00 AM,48,-122,115,7,122
6513,SpokaneStBridge,09/29/2014 09:00:00 AM,48,-122,45,4,49
6514,SpokaneStBridge,09/29/2014 10:00:00 AM,48,-122,17,6,23
6515,SpokaneStBridge,09/29/2014 11:00:00 AM,48,-122,11,3,14
6516,SpokaneStBridge,09/29/2014 12:00:00 PM,48,-122,10,7,17
6517,SpokaneStBridge,09/29/2014 01:00:00 PM,48,-122,7,2,9
6518,SpokaneStBridge,09/29/2014 02:00:00 PM,48,-122,6,8,14
6519,SpokaneStBridge,09/29/2014 03:00:00 PM,48,-122,6,19,25
6520,SpokaneStBridge,09/29/2014 04:00:00 PM,48,-122,11,43,54
6521,SpokaneStBridge,09/29/2014 05:00:00 PM,48,-122,12,117,129
6522,SpokaneStBridge,09/29/2014 06:00:00 PM,48,-122,11,88,99
6523,SpokaneStBridge,09/29/2014 07:00:00 PM,48,-122,3,13,16
6524,SpokaneStBridge,09/29/2014 08:00:00 PM,48,-122,4,16,20
6525,SpokaneStBridge,09/29/2014 09:00:00 PM,48,-122,3,6,9
6526,SpokaneStBridge,09/29/2014 10:00:00 PM,48,-122,2,2,4
6527,SpokaneStBridge,09/29/2014 11:00:00 PM,48,-122,1,5,6
6528,SpokaneStBridge,09/30/2014 12:00:00 AM,48,-122,0,1,1
6529,SpokaneStBridge,09/30/2014 01:00:00 AM,48,-122,1,1,2
6530,SpokaneStBridge,09/30/2014 02:00:00 AM,48,-122,1,0,1
6531,SpokaneStBridge,09/30/2014 03:00:00 AM,48,-122,1,3,4
6532,SpokaneStBridge,09/30/2014 04:00:00 AM,48,-122,2,0,2
6533,SpokaneStBridge,09/30/2014 05:00:00 AM,48,-122,24,4,28
6534,SpokaneStBridge,09/30/2014 06:00:00 AM,48,-122,41,9,50
6535,SpokaneStBridge,09/30/2014 07:00:00 AM,48,-122,93,16,109
6536,SpokaneStBridge,09/30/2014 08:00:00 AM,48,-122,111,9,120
6537,SpokaneStBridge,09/30/2014 09:00:00 AM,48,-122,49,2,51
6538,SpokaneStBridge,09/30/2014 10:00:00 AM,48,-122,17,3,20
6539,SpokaneStBridge,09/30/2014 11:00:00 AM,48,-122,13,5,18
6540,SpokaneStBridge,09/30/2014 12:00:00 PM,48,-122,10,4,14
6541,SpokaneStBridge,09/30/2014 01:00:00 PM,48,-122,17,8,25
6542,SpokaneStBridge,09/30/2014 02:00:00 PM,48,-122,14,16,30
6543,SpokaneStBridge,09/30/2014 03:00:00 PM,48,-122,10,33,43
6544,SpokaneStBridge,09/30/2014 04:00:00 PM,48,-122,22,69,91
6545,SpokaneStBridge,09/30/2014 05:00:00 PM,48,-122,24,123,147
6546,SpokaneStBridge,09/30/2014 06:00:00 PM,48,-122,21,101,122
6547,SpokaneStBridge,09/30/2014 07:00:00 PM,48,-122,8,27,35
6548,SpokaneStBridge,09/30/2014 08:00:00 PM,48,-122,4,17,21
6549,SpokaneStBridge,09/30/2014 09:00:00 PM,48,-122,0,8,8
6550,SpokaneStBridge,09/30/2014 10:00:00 PM,48,-122,2,4,6
6551,SpokaneStBridge,09/30/2014 11:00:00 PM,48,-122,1,2,3
6552,SpokaneStBridge,10/01/2014 12:00:00 AM,48,-122,0,1,1
6553,SpokaneStBridge,10/01/2014 01:00:00 AM,48,-122,0,3,3
6554,SpokaneStBridge,10/01/2014 02:00:00 AM,48,-122,1,1,2
6555,SpokaneStBridge,10/01/2014 03:00:00 AM,48,-122,3,2,5
6556,SpokaneStBridge,10/01/2014 04:00:00 AM,48,-122,3,4,7
6557,SpokaneStBridge,10/01/2014 05:00:00 AM,48,-122,18,1,19
6558,SpokaneStBridge,10/01/2014 06:00:00 AM,48,-122,50,13,63
6559,SpokaneStBridge,10/01/2014 07:00:00 AM,48,-122,96,20,116
6560,SpokaneStBridge,10/01/2014 08:00:00 AM,48,-122,132,10,142
6561,SpokaneStBridge,10/01/2014 09:00:00 AM,48,-122,45,11,56
6562,SpokaneStBridge,10/01/2014 10:00:00 AM,48,-122,22,6,28
6563,SpokaneStBridge,10/01/2014 11:00:00 AM,48,-122,16,4,20
6564,SpokaneStBridge,10/01/2014 12:00:00 PM,48,-122,6,7,13
6565,SpokaneStBridge,10/01/2014 01:00:00 PM,48,-122,15,8,23
6566,SpokaneStBridge,10/01/2014 02:00:00 PM,48,-122,10,12,22
6567,SpokaneStBridge,10/01/2014 03:00:00 PM,48,-122,10,46,56
6568,SpokaneStBridge,10/01/2014 04:00:00 PM,48,-122,18,71,89
6569,SpokaneStBridge,10/01/2014 05:00:00 PM,48,-122,26,157,183
6570,SpokaneStBridge,10/01/2014 06:00:00 PM,48,-122,24,87,111
6571,SpokaneStBridge,10/01/2014 07:00:00 PM,48,-122,32,28,60
6572,SpokaneStBridge,10/01/2014 08:00:00 PM,48,-122,5,19,24
6573,SpokaneStBridge,10/01/2014 09:00:00 PM,48,-122,2,7,9
6574,SpokaneStBridge,10/01/2014 10:00:00 PM,48,-122,3,4,7
6575,SpokaneStBridge,10/01/2014 11:00:00 PM,48,-122,3,3,6
6576,SpokaneStBridge,10/02/2014 12:00:00 AM,48,-122,1,4,5
6577,SpokaneStBridge,10/02/2014 01:00:00 AM,48,-122,0,1,1
6578,SpokaneStBridge,10/02/2014 02:00:00 AM,48,-122,2,1,3
6579,SpokaneStBridge,10/02/2014 03:00:00 AM,48,-122,0,0,0
6580,SpokaneStBridge,10/02/2014 04:00:00 AM,48,-122,3,0,3
6581,SpokaneStBridge,10/02/2014 05:00:00 AM,48,-122,17,3,20
6582,SpokaneStBridge,10/02/2014 06:00:00 AM,48,-122,58,10,68
6583,SpokaneStBridge,10/02/2014 07:00:00 AM,48,-122,111,18,129
6584,SpokaneStBridge,10/02/2014 08:00:00 AM,48,-122,116,15,131
6585,SpokaneStBridge,10/02/2014 09:00:00 AM,48,-122,56,5,61
6586,SpokaneStBridge,10/02/2014 10:00:00 AM,48,-122,23,7,30
6587,SpokaneStBridge,10/02/2014 11:00:00 AM,48,-122,18,13,31
6588,SpokaneStBridge,10/02/2014 12:00:00 PM,48,-122,7,10,17
6589,SpokaneStBridge,10/02/2014 01:00:00 PM,48,-122,11,16,27
6590,SpokaneStBridge,10/02/2014 02:00:00 PM,48,-122,17,15,32
6591,SpokaneStBridge,10/02/2014 03:00:00 PM,48,-122,16,40,56
6592,SpokaneStBridge,10/02/2014 04:00:00 PM,48,-122,23,60,83
6593,SpokaneStBridge,10/02/2014 05:00:00 PM,48,-122,20,125,145
6594,SpokaneStBridge,10/02/2014 06:00:00 PM,48,-122,19,98,117
6595,SpokaneStBridge,10/02/2014 07:00:00 PM,48,-122,10,83,93
6596,SpokaneStBridge,10/02/2014 08:00:00 PM,48,-122,5,13,18
6597,SpokaneStBridge,10/02/2014 09:00:00 PM,48,-122,5,5,10
6598,SpokaneStBridge,10/02/2014 10:00:00 PM,48,-122,9,4,13
6599,SpokaneStBridge,10/02/2014 11:00:00 PM,48,-122,3,4,7
6600,SpokaneStBridge,10/03/2014 12:00:00 AM,48,-122,0,6,6
6601,SpokaneStBridge,10/03/2014 01:00:00 AM,48,-122,1,3,4
6602,SpokaneStBridge,10/03/2014 02:00:00 AM,48,-122,0,0,0
6603,SpokaneStBridge,10/03/2014 03:00:00 AM,48,-122,1,1,2
6604,SpokaneStBridge,10/03/2014 04:00:00 AM,48,-122,3,2,5
6605,SpokaneStBridge,10/03/2014 05:00:00 AM,48,-122,18,7,25
6606,SpokaneStBridge,10/03/2014 06:00:00 AM,48,-122,41,6,47
6607,SpokaneStBridge,10/03/2014 07:00:00 AM,48,-122,105,22,127
6608,SpokaneStBridge,10/03/2014 08:00:00 AM,48,-122,126,9,135
6609,SpokaneStBridge,10/03/2014 09:00:00 AM,48,-122,45,10,55
6610,SpokaneStBridge,10/03/2014 10:00:00 AM,48,-122,25,9,34
6611,SpokaneStBridge,10/03/2014 11:00:00 AM,48,-122,17,11,28
6612,SpokaneStBridge,10/03/2014 12:00:00 PM,48,-122,17,10,27
6613,SpokaneStBridge,10/03/2014 01:00:00 PM,48,-122,16,20,36
6614,SpokaneStBridge,10/03/2014 02:00:00 PM,48,-122,14,22,36
6615,SpokaneStBridge,10/03/2014 03:00:00 PM,48,-122,16,35,51
6616,SpokaneStBridge,10/03/2014 04:00:00 PM,48,-122,26,81,107
6617,SpokaneStBridge,10/03/2014 05:00:00 PM,48,-122,31,133,164
6618,SpokaneStBridge,10/03/2014 06:00:00 PM,48,-122,13,79,92
6619,SpokaneStBridge,10/03/2014 07:00:00 PM,48,-122,8,14,22
6620,SpokaneStBridge,10/03/2014 08:00:00 PM,48,-122,3,19,22
6621,SpokaneStBridge,10/03/2014 09:00:00 PM,48,-122,0,6,6
6622,SpokaneStBridge,10/03/2014 10:00:00 PM,48,-122,5,2,7
6623,SpokaneStBridge,10/03/2014 11:00:00 PM,48,-122,1,7,8
6624,SpokaneStBridge,10/04/2014 12:00:00 AM,48,-122,2,4,6
6625,SpokaneStBridge,10/04/2014 01:00:00 AM,48,-122,2,2,4
6626,SpokaneStBridge,10/04/2014 02:00:00 AM,48,-122,0,3,3
6627,SpokaneStBridge,10/04/2014 03:00:00 AM,48,-122,2,0,2
6628,SpokaneStBridge,10/04/2014 04:00:00 AM,48,-122,0,0,0
6629,SpokaneStBridge,10/04/2014 05:00:00 AM,48,-122,4,0,4
6630,SpokaneStBridge,10/04/2014 06:00:00 AM,48,-122,8,2,10
6631,SpokaneStBridge,10/04/2014 07:00:00 AM,48,-122,9,3,12
6632,SpokaneStBridge,10/04/2014 08:00:00 AM,48,-122,25,11,36
6633,SpokaneStBridge,10/04/2014 09:00:00 AM,48,-122,26,17,43
6634,SpokaneStBridge,10/04/2014 10:00:00 AM,48,-122,19,20,39
6635,SpokaneStBridge,10/04/2014 11:00:00 AM,48,-122,24,42,66
6636,SpokaneStBridge,10/04/2014 12:00:00 PM,48,-122,20,24,44
6637,SpokaneStBridge,10/04/2014 01:00:00 PM,48,-122,24,13,37
6638,SpokaneStBridge,10/04/2014 02:00:00 PM,48,-122,26,18,44
6639,SpokaneStBridge,10/04/2014 03:00:00 PM,48,-122,24,14,38
6640,SpokaneStBridge,10/04/2014 04:00:00 PM,48,-122,19,23,42
6641,SpokaneStBridge,10/04/2014 05:00:00 PM,48,-122,11,27,38
6642,SpokaneStBridge,10/04/2014 06:00:00 PM,48,-122,7,11,18
6643,SpokaneStBridge,10/04/2014 07:00:00 PM,48,-122,6,10,16
6644,SpokaneStBridge,10/04/2014 08:00:00 PM,48,-122,2,5,7
6645,SpokaneStBridge,10/04/2014 09:00:00 PM,48,-122,1,2,3
6646,SpokaneStBridge,10/04/2014 10:00:00 PM,48,-122,0,0,0
6647,SpokaneStBridge,10/04/2014 11:00:00 PM,48,-122,2,2,4
6648,SpokaneStBridge,10/05/2014 12:00:00 AM,48,-122,1,2,3
6649,SpokaneStBridge,10/05/2014 01:00:00 AM,48,-122,0,0,0
6650,SpokaneStBridge,10/05/2014 02:00:00 AM,48,-122,0,1,1
6651,SpokaneStBridge,10/05/2014 03:00:00 AM,48,-122,0,1,1
6652,SpokaneStBridge,10/05/2014 04:00:00 AM,48,-122,0,1,1
6653,SpokaneStBridge,10/05/2014 05:00:00 AM,48,-122,3,2,5
6654,SpokaneStBridge,10/05/2014 06:00:00 AM,48,-122,2,3,5
6655,SpokaneStBridge,10/05/2014 07:00:00 AM,48,-122,9,3,12
6656,SpokaneStBridge,10/05/2014 08:00:00 AM,48,-122,16,6,22
6657,SpokaneStBridge,10/05/2014 09:00:00 AM,48,-122,20,8,28
6658,SpokaneStBridge,10/05/2014 10:00:00 AM,48,-122,19,19,38
6659,SpokaneStBridge,10/05/2014 11:00:00 AM,48,-122,36,13,49
6660,SpokaneStBridge,10/05/2014 12:00:00 PM,48,-122,18,23,41
6661,SpokaneStBridge,10/05/2014 01:00:00 PM,48,-122,14,29,43
6662,SpokaneStBridge,10/05/2014 02:00:00 PM,48,-122,24,28,52
6663,SpokaneStBridge,10/05/2014 03:00:00 PM,48,-122,32,21,53
6664,SpokaneStBridge,10/05/2014 04:00:00 PM,48,-122,26,37,63
6665,SpokaneStBridge,10/05/2014 05:00:00 PM,48,-122,17,19,36
6666,SpokaneStBridge,10/05/2014 06:00:00 PM,48,-122,10,9,19
6667,SpokaneStBridge,10/05/2014 07:00:00 PM,48,-122,5,12,17
6668,SpokaneStBridge,10/05/2014 08:00:00 PM,48,-122,1,6,7
6669,SpokaneStBridge,10/05/2014 09:00:00 PM,48,-122,3,3,6
6670,SpokaneStBridge,10/05/2014 10:00:00 PM,48,-122,0,1,1
6671,SpokaneStBridge,10/05/2014 11:00:00 PM,48,-122,2,2,4
6672,SpokaneStBridge,10/06/2014 12:00:00 AM,48,-122,1,2,3
6673,SpokaneStBridge,10/06/2014 01:00:00 AM,48,-122,1,0,1
6674,SpokaneStBridge,10/06/2014 02:00:00 AM,48,-122,0,0,0
6675,SpokaneStBridge,10/06/2014 03:00:00 AM,48,-122,0,2,2
6676,SpokaneStBridge,10/06/2014 04:00:00 AM,48,-122,3,2,5
6677,SpokaneStBridge,10/06/2014 05:00:00 AM,48,-122,21,8,29
6678,SpokaneStBridge,10/06/2014 06:00:00 AM,48,-122,53,12,65
6679,SpokaneStBridge,10/06/2014 07:00:00 AM,48,-122,121,19,140
6680,SpokaneStBridge,10/06/2014 08:00:00 AM,48,-122,151,13,164
6681,SpokaneStBridge,10/06/2014 09:00:00 AM,48,-122,53,3,56
6682,SpokaneStBridge,10/06/2014 10:00:00 AM,48,-122,25,5,30
6683,SpokaneStBridge,10/06/2014 11:00:00 AM,48,-122,9,15,24
6684,SpokaneStBridge,10/06/2014 12:00:00 PM,48,-122,18,12,30
6685,SpokaneStBridge,10/06/2014 01:00:00 PM,48,-122,21,20,41
6686,SpokaneStBridge,10/06/2014 02:00:00 PM,48,-122,11,21,32
6687,SpokaneStBridge,10/06/2014 03:00:00 PM,48,-122,24,39,63
6688,SpokaneStBridge,10/06/2014 04:00:00 PM,48,-122,21,99,120
6689,SpokaneStBridge,10/06/2014 05:00:00 PM,48,-122,29,171,200
6690,SpokaneStBridge,10/06/2014 06:00:00 PM,48,-122,10,94,104
6691,SpokaneStBridge,10/06/2014 07:00:00 PM,48,-122,10,21,31
6692,SpokaneStBridge,10/06/2014 08:00:00 PM,48,-122,1,11,12
6693,SpokaneStBridge,10/06/2014 09:00:00 PM,48,-122,3,12,15
6694,SpokaneStBridge,10/06/2014 10:00:00 PM,48,-122,4,11,15
6695,SpokaneStBridge,10/06/2014 11:00:00 PM,48,-122,1,1,2
6696,SpokaneStBridge,10/07/2014 12:00:00 AM,48,-122,0,4,4
6697,SpokaneStBridge,10/07/2014 01:00:00 AM,48,-122,2,1,3
6698,SpokaneStBridge,10/07/2014 02:00:00 AM,48,-122,1,1,2
6699,SpokaneStBridge,10/07/2014 03:00:00 AM,48,-122,1,3,4
6700,SpokaneStBridge,10/07/2014 04:00:00 AM,48,-122,2,0,2
6701,SpokaneStBridge,10/07/2014 05:00:00 AM,48,-122,20,3,23
6702,SpokaneStBridge,10/07/2014 06:00:00 AM,48,-122,65,10,75
6703,SpokaneStBridge,10/07/2014 07:00:00 AM,48,-122,118,19,137
6704,SpokaneStBridge,10/07/2014 08:00:00 AM,48,-122,127,13,140
6705,SpokaneStBridge,10/07/2014 09:00:00 AM,48,-122,53,6,59
6706,SpokaneStBridge,10/07/2014 10:00:00 AM,48,-122,25,4,29
6707,SpokaneStBridge,10/07/2014 11:00:00 AM,48,-122,16,9,25
6708,SpokaneStBridge,10/07/2014 12:00:00 PM,48,-122,11,11,22
6709,SpokaneStBridge,10/07/2014 01:00:00 PM,48,-122,18,6,24
6710,SpokaneStBridge,10/07/2014 02:00:00 PM,48,-122,11,21,32
6711,SpokaneStBridge,10/07/2014 03:00:00 PM,48,-122,25,28,53
6712,SpokaneStBridge,10/07/2014 04:00:00 PM,48,-122,14,81,95
6713,SpokaneStBridge,10/07/2014 05:00:00 PM,48,-122,32,172,204
6714,SpokaneStBridge,10/07/2014 06:00:00 PM,48,-122,15,94,109
6715,SpokaneStBridge,10/07/2014 07:00:00 PM,48,-122,3,35,38
6716,SpokaneStBridge,10/07/2014 08:00:00 PM,48,-122,4,17,21
6717,SpokaneStBridge,10/07/2014 09:00:00 PM,48,-122,5,4,9
6718,SpokaneStBridge,10/07/2014 10:00:00 PM,48,-122,2,5,7
6719,SpokaneStBridge,10/07/2014 11:00:00 PM,48,-122,0,6,6
6720,SpokaneStBridge,10/08/2014 12:00:00 AM,48,-122,2,3,5
6721,SpokaneStBridge,10/08/2014 01:00:00 AM,48,-122,2,0,2
6722,SpokaneStBridge,10/08/2014 02:00:00 AM,48,-122,0,1,1
6723,SpokaneStBridge,10/08/2014 03:00:00 AM,48,-122,2,1,3
6724,SpokaneStBridge,10/08/2014 04:00:00 AM,48,-122,2,2,4
6725,SpokaneStBridge,10/08/2014 05:00:00 AM,48,-122,28,3,31
6726,SpokaneStBridge,10/08/2014 06:00:00 AM,48,-122,56,9,65
6727,SpokaneStBridge,10/08/2014 07:00:00 AM,48,-122,88,16,104
6728,SpokaneStBridge,10/08/2014 08:00:00 AM,48,-122,134,18,152
6729,SpokaneStBridge,10/08/2014 09:00:00 AM,48,-122,49,6,55
6730,SpokaneStBridge,10/08/2014 10:00:00 AM,48,-122,33,6,39
6731,SpokaneStBridge,10/08/2014 11:00:00 AM,48,-122,7,9,16
6732,SpokaneStBridge,10/08/2014 12:00:00 PM,48,-122,18,6,24
6733,SpokaneStBridge,10/08/2014 01:00:00 PM,48,-122,14,8,22
6734,SpokaneStBridge,10/08/2014 02:00:00 PM,48,-122,8,21,29
6735,SpokaneStBridge,10/08/2014 03:00:00 PM,48,-122,14,27,41
6736,SpokaneStBridge,10/08/2014 04:00:00 PM,48,-122,22,79,101
6737,SpokaneStBridge,10/08/2014 05:00:00 PM,48,-122,21,143,164
6738,SpokaneStBridge,10/08/2014 06:00:00 PM,48,-122,11,98,109
6739,SpokaneStBridge,10/08/2014 07:00:00 PM,48,-122,11,47,58
6740,SpokaneStBridge,10/08/2014 08:00:00 PM,48,-122,4,12,16
6741,SpokaneStBridge,10/08/2014 09:00:00 PM,48,-122,4,7,11
6742,SpokaneStBridge,10/08/2014 10:00:00 PM,48,-122,4,4,8
6743,SpokaneStBridge,10/08/2014 11:00:00 PM,48,-122,1,7,8
6744,SpokaneStBridge,10/09/2014 12:00:00 AM,48,-122,0,1,1
6745,SpokaneStBridge,10/09/2014 01:00:00 AM,48,-122,1,2,3
6746,SpokaneStBridge,10/09/2014 02:00:00 AM,48,-122,1,0,1
6747,SpokaneStBridge,10/09/2014 03:00:00 AM,48,-122,1,0,1
6748,SpokaneStBridge,10/09/2014 04:00:00 AM,48,-122,2,0,2
6749,SpokaneStBridge,10/09/2014 05:00:00 AM,48,-122,19,3,22
6750,SpokaneStBridge,10/09/2014 06:00:00 AM,48,-122,55,5,60
6751,SpokaneStBridge,10/09/2014 07:00:00 AM,48,-122,97,17,114
6752,SpokaneStBridge,10/09/2014 08:00:00 AM,48,-122,122,12,134
6753,SpokaneStBridge,10/09/2014 09:00:00 AM,48,-122,52,7,59
6754,SpokaneStBridge,10/09/2014 10:00:00 AM,48,-122,13,4,17
6755,SpokaneStBridge,10/09/2014 11:00:00 AM,48,-122,10,4,14
6756,SpokaneStBridge,10/09/2014 12:00:00 PM,48,-122,9,9,18
6757,SpokaneStBridge,10/09/2014 01:00:00 PM,48,-122,11,16,27
6758,SpokaneStBridge,10/09/2014 02:00:00 PM,48,-122,29,18,47
6759,SpokaneStBridge,10/09/2014 03:00:00 PM,48,-122,9,26,35
6760,SpokaneStBridge,10/09/2014 04:00:00 PM,48,-122,14,69,83
6761,SpokaneStBridge,10/09/2014 05:00:00 PM,48,-122,22,125,147
6762,SpokaneStBridge,10/09/2014 06:00:00 PM,48,-122,10,91,101
6763,SpokaneStBridge,10/09/2014 07:00:00 PM,48,-122,19,32,51
6764,SpokaneStBridge,10/09/2014 08:00:00 PM,48,-122,6,18,24
6765,SpokaneStBridge,10/09/2014 09:00:00 PM,48,-122,3,5,8
6766,SpokaneStBridge,10/09/2014 10:00:00 PM,48,-122,3,2,5
6767,SpokaneStBridge,10/09/2014 11:00:00 PM,48,-122,10,2,12
6768,SpokaneStBridge,10/10/2014 12:00:00 AM,48,-122,0,4,4
6769,SpokaneStBridge,10/10/2014 01:00:00 AM,48,-122,2,3,5
6770,SpokaneStBridge,10/10/2014 02:00:00 AM,48,-122,0,0,0
6771,SpokaneStBridge,10/10/2014 03:00:00 AM,48,-122,1,0,1
6772,SpokaneStBridge,10/10/2014 04:00:00 AM,48,-122,3,1,4
6773,SpokaneStBridge,10/10/2014 05:00:00 AM,48,-122,14,2,16
6774,SpokaneStBridge,10/10/2014 06:00:00 AM,48,-122,35,8,43
6775,SpokaneStBridge,10/10/2014 07:00:00 AM,48,-122,69,15,84
6776,SpokaneStBridge,10/10/2014 08:00:00 AM,48,-122,102,9,111
6777,SpokaneStBridge,10/10/2014 09:00:00 AM,48,-122,44,7,51
6778,SpokaneStBridge,10/10/2014 10:00:00 AM,48,-122,18,4,22
6779,SpokaneStBridge,10/10/2014 11:00:00 AM,48,-122,11,15,26
6780,SpokaneStBridge,10/10/2014 12:00:00 PM,48,-122,17,6,23
6781,SpokaneStBridge,10/10/2014 01:00:00 PM,48,-122,6,8,14
6782,SpokaneStBridge,10/10/2014 02:00:00 PM,48,-122,14,15,29
6783,SpokaneStBridge,10/10/2014 03:00:00 PM,48,-122,11,27,38
6784,SpokaneStBridge,10/10/2014 04:00:00 PM,48,-122,15,49,64
6785,SpokaneStBridge,10/10/2014 05:00:00 PM,48,-122,16,94,110
6786,SpokaneStBridge,10/10/2014 06:00:00 PM,48,-122,7,51,58
6787,SpokaneStBridge,10/10/2014 07:00:00 PM,48,-122,9,18,27
6788,SpokaneStBridge,10/10/2014 08:00:00 PM,48,-122,1,8,9
6789,SpokaneStBridge,10/10/2014 09:00:00 PM,48,-122,1,8,9
6790,SpokaneStBridge,10/10/2014 10:00:00 PM,48,-122,1,7,8
6791,SpokaneStBridge,10/10/2014 11:00:00 PM,48,-122,3,6,9
6792,SpokaneStBridge,10/11/2014 12:00:00 AM,48,-122,0,3,3
6793,SpokaneStBridge,10/11/2014 01:00:00 AM,48,-122,3,3,6
6794,SpokaneStBridge,10/11/2014 02:00:00 AM,48,-122,3,2,5
6795,SpokaneStBridge,10/11/2014 03:00:00 AM,48,-122,2,1,3
6796,SpokaneStBridge,10/11/2014 04:00:00 AM,48,-122,0,2,2
6797,SpokaneStBridge,10/11/2014 05:00:00 AM,48,-122,7,0,7
6798,SpokaneStBridge,10/11/2014 06:00:00 AM,48,-122,6,0,6
6799,SpokaneStBridge,10/11/2014 07:00:00 AM,48,-122,6,1,7
6800,SpokaneStBridge,10/11/2014 08:00:00 AM,48,-122,11,6,17
6801,SpokaneStBridge,10/11/2014 09:00:00 AM,48,-122,19,5,24
6802,SpokaneStBridge,10/11/2014 10:00:00 AM,48,-122,11,15,26
6803,SpokaneStBridge,10/11/2014 11:00:00 AM,48,-122,6,16,22
6804,SpokaneStBridge,10/11/2014 12:00:00 PM,48,-122,11,9,20
6805,SpokaneStBridge,10/11/2014 01:00:00 PM,48,-122,18,11,29
6806,SpokaneStBridge,10/11/2014 02:00:00 PM,48,-122,8,12,20
6807,SpokaneStBridge,10/11/2014 03:00:00 PM,48,-122,12,13,25
6808,SpokaneStBridge,10/11/2014 04:00:00 PM,48,-122,12,13,25
6809,SpokaneStBridge,10/11/2014 05:00:00 PM,48,-122,14,10,24
6810,SpokaneStBridge,10/11/2014 06:00:00 PM,48,-122,7,7,14
6811,SpokaneStBridge,10/11/2014 07:00:00 PM,48,-122,3,3,6
6812,SpokaneStBridge,10/11/2014 08:00:00 PM,48,-122,2,2,4
6813,SpokaneStBridge,10/11/2014 09:00:00 PM,48,-122,1,3,4
6814,SpokaneStBridge,10/11/2014 10:00:00 PM,48,-122,3,1,4
6815,SpokaneStBridge,10/11/2014 11:00:00 PM,48,-122,0,0,0
6816,SpokaneStBridge,10/12/2014 12:00:00 AM,48,-122,0,2,2
6817,SpokaneStBridge,10/12/2014 01:00:00 AM,48,-122,1,2,3
6818,SpokaneStBridge,10/12/2014 02:00:00 AM,48,-122,0,1,1
6819,SpokaneStBridge,10/12/2014 03:00:00 AM,48,-122,1,0,1
6820,SpokaneStBridge,10/12/2014 04:00:00 AM,48,-122,1,2,3
6821,SpokaneStBridge,10/12/2014 05:00:00 AM,48,-122,3,2,5
6822,SpokaneStBridge,10/12/2014 06:00:00 AM,48,-122,0,0,0
6823,SpokaneStBridge,10/12/2014 07:00:00 AM,48,-122,4,3,7
6824,SpokaneStBridge,10/12/2014 08:00:00 AM,48,-122,9,5,14
6825,SpokaneStBridge,10/12/2014 09:00:00 AM,48,-122,12,9,21
6826,SpokaneStBridge,10/12/2014 10:00:00 AM,48,-122,20,10,30
6827,SpokaneStBridge,10/12/2014 11:00:00 AM,48,-122,22,21,43
6828,SpokaneStBridge,10/12/2014 12:00:00 PM,48,-122,12,26,38
6829,SpokaneStBridge,10/12/2014 01:00:00 PM,48,-122,25,9,34
6830,SpokaneStBridge,10/12/2014 02:00:00 PM,48,-122,23,9,32
6831,SpokaneStBridge,10/12/2014 03:00:00 PM,48,-122,15,13,28
6832,SpokaneStBridge,10/12/2014 04:00:00 PM,48,-122,14,17,31
6833,SpokaneStBridge,10/12/2014 05:00:00 PM,48,-122,13,15,28
6834,SpokaneStBridge,10/12/2014 06:00:00 PM,48,-122,7,10,17
6835,SpokaneStBridge,10/12/2014 07:00:00 PM,48,-122,3,4,7
6836,SpokaneStBridge,10/12/2014 08:00:00 PM,48,-122,2,6,8
6837,SpokaneStBridge,10/12/2014 09:00:00 PM,48,-122,3,6,9
6838,SpokaneStBridge,10/12/2014 10:00:00 PM,48,-122,5,4,9
6839,SpokaneStBridge,10/12/2014 11:00:00 PM,48,-122,0,0,0
6840,SpokaneStBridge,10/13/2014 12:00:00 AM,48,-122,0,0,0
6841,SpokaneStBridge,10/13/2014 01:00:00 AM,48,-122,0,1,1
6842,SpokaneStBridge,10/13/2014 02:00:00 AM,48,-122,0,0,0
6843,SpokaneStBridge,10/13/2014 03:00:00 AM,48,-122,1,0,1
6844,SpokaneStBridge,10/13/2014 04:00:00 AM,48,-122,4,1,5
6845,SpokaneStBridge,10/13/2014 05:00:00 AM,48,-122,16,2,18
6846,SpokaneStBridge,10/13/2014 06:00:00 AM,48,-122,34,9,43
6847,SpokaneStBridge,10/13/2014 07:00:00 AM,48,-122,89,18,107
6848,SpokaneStBridge,10/13/2014 08:00:00 AM,48,-122,110,8,118
6849,SpokaneStBridge,10/13/2014 09:00:00 AM,48,-122,55,8,63
6850,SpokaneStBridge,10/13/2014 10:00:00 AM,48,-122,24,7,31
6851,SpokaneStBridge,10/13/2014 11:00:00 AM,48,-122,10,15,25
6852,SpokaneStBridge,10/13/2014 12:00:00 PM,48,-122,15,15,30
6853,SpokaneStBridge,10/13/2014 01:00:00 PM,48,-122,16,10,26
6854,SpokaneStBridge,10/13/2014 02:00:00 PM,48,-122,12,19,31
6855,SpokaneStBridge,10/13/2014 03:00:00 PM,48,-122,8,18,26
6856,SpokaneStBridge,10/13/2014 04:00:00 PM,48,-122,23,70,93
6857,SpokaneStBridge,10/13/2014 05:00:00 PM,48,-122,24,115,139
6858,SpokaneStBridge,10/13/2014 06:00:00 PM,48,-122,11,78,89
6859,SpokaneStBridge,10/13/2014 07:00:00 PM,48,-122,7,22,29
6860,SpokaneStBridge,10/13/2014 08:00:00 PM,48,-122,4,11,15
6861,SpokaneStBridge,10/13/2014 09:00:00 PM,48,-122,1,3,4
6862,SpokaneStBridge,10/13/2014 10:00:00 PM,48,-122,1,6,7
6863,SpokaneStBridge,10/13/2014 11:00:00 PM,48,-122,0,1,1
6864,SpokaneStBridge,10/14/2014 12:00:00 AM,48,-122,1,1,2
6865,SpokaneStBridge,10/14/2014 01:00:00 AM,48,-122,1,0,1
6866,SpokaneStBridge,10/14/2014 02:00:00 AM,48,-122,0,0,0
6867,SpokaneStBridge,10/14/2014 03:00:00 AM,48,-122,1,1,2
6868,SpokaneStBridge,10/14/2014 04:00:00 AM,48,-122,2,0,2
6869,SpokaneStBridge,10/14/2014 05:00:00 AM,48,-122,21,3,24
6870,SpokaneStBridge,10/14/2014 06:00:00 AM,48,-122,56,11,67
6871,SpokaneStBridge,10/14/2014 07:00:00 AM,48,-122,99,15,114
6872,SpokaneStBridge,10/14/2014 08:00:00 AM,48,-122,96,11,107
6873,SpokaneStBridge,10/14/2014 09:00:00 AM,48,-122,36,2,38
6874,SpokaneStBridge,10/14/2014 10:00:00 AM,48,-122,14,0,14
6875,SpokaneStBridge,10/14/2014 11:00:00 AM,48,-122,6,8,14
6876,SpokaneStBridge,10/14/2014 12:00:00 PM,48,-122,14,8,22
6877,SpokaneStBridge,10/14/2014 01:00:00 PM,48,-122,5,8,13
6878,SpokaneStBridge,10/14/2014 02:00:00 PM,48,-122,10,21,31
6879,SpokaneStBridge,10/14/2014 03:00:00 PM,48,-122,18,23,41
6880,SpokaneStBridge,10/14/2014 04:00:00 PM,48,-122,15,71,86
6881,SpokaneStBridge,10/14/2014 05:00:00 PM,48,-122,15,124,139
6882,SpokaneStBridge,10/14/2014 06:00:00 PM,48,-122,9,68,77
6883,SpokaneStBridge,10/14/2014 07:00:00 PM,48,-122,0,19,19
6884,SpokaneStBridge,10/14/2014 08:00:00 PM,48,-122,2,6,8
6885,SpokaneStBridge,10/14/2014 09:00:00 PM,48,-122,1,8,9
6886,SpokaneStBridge,10/14/2014 10:00:00 PM,48,-122,0,3,3
6887,SpokaneStBridge,10/14/2014 11:00:00 PM,48,-122,1,2,3
6888,SpokaneStBridge,10/15/2014 12:00:00 AM,48,-122,0,2,2
6889,SpokaneStBridge,10/15/2014 01:00:00 AM,48,-122,1,1,2
6890,SpokaneStBridge,10/15/2014 02:00:00 AM,48,-122,1,0,1
6891,SpokaneStBridge,10/15/2014 03:00:00 AM,48,-122,1,1,2
6892,SpokaneStBridge,10/15/2014 04:00:00 AM,48,-122,4,1,5
6893,SpokaneStBridge,10/15/2014 05:00:00 AM,48,-122,16,3,19
6894,SpokaneStBridge,10/15/2014 06:00:00 AM,48,-122,37,4,41
6895,SpokaneStBridge,10/15/2014 07:00:00 AM,48,-122,86,10,96
6896,SpokaneStBridge,10/15/2014 08:00:00 AM,48,-122,82,5,87
6897,SpokaneStBridge,10/15/2014 09:00:00 AM,48,-122,31,1,32
6898,SpokaneStBridge,10/15/2014 10:00:00 AM,48,-122,9,1,10
6899,SpokaneStBridge,10/15/2014 11:00:00 AM,48,-122,7,5,12
6900,SpokaneStBridge,10/15/2014 12:00:00 PM,48,-122,6,2,8
6901,SpokaneStBridge,10/15/2014 01:00:00 PM,48,-122,2,4,6
6902,SpokaneStBridge,10/15/2014 02:00:00 PM,48,-122,9,5,14
6903,SpokaneStBridge,10/15/2014 03:00:00 PM,48,-122,7,15,22
6904,SpokaneStBridge,10/15/2014 04:00:00 PM,48,-122,11,52,63
6905,SpokaneStBridge,10/15/2014 05:00:00 PM,48,-122,18,76,94
6906,SpokaneStBridge,10/15/2014 06:00:00 PM,48,-122,13,69,82
6907,SpokaneStBridge,10/15/2014 07:00:00 PM,48,-122,9,27,36
6908,SpokaneStBridge,10/15/2014 08:00:00 PM,48,-122,12,10,22
6909,SpokaneStBridge,10/15/2014 09:00:00 PM,48,-122,5,5,10
6910,SpokaneStBridge,10/15/2014 10:00:00 PM,48,-122,4,6,10
6911,SpokaneStBridge,10/15/2014 11:00:00 PM,48,-122,1,0,1
6912,SpokaneStBridge,10/16/2014 12:00:00 AM,48,-122,1,2,3
6913,SpokaneStBridge,10/16/2014 01:00:00 AM,48,-122,0,2,2
6914,SpokaneStBridge,10/16/2014 02:00:00 AM,48,-122,0,0,0
6915,SpokaneStBridge,10/16/2014 03:00:00 AM,48,-122,1,3,4
6916,SpokaneStBridge,10/16/2014 04:00:00 AM,48,-122,4,2,6
6917,SpokaneStBridge,10/16/2014 05:00:00 AM,48,-122,23,3,26
6918,SpokaneStBridge,10/16/2014 06:00:00 AM,48,-122,50,12,62
6919,SpokaneStBridge,10/16/2014 07:00:00 AM,48,-122,103,14,117
6920,SpokaneStBridge,10/16/2014 08:00:00 AM,48,-122,99,10,109
6921,SpokaneStBridge,10/16/2014 09:00:00 AM,48,-122,33,7,40
6922,SpokaneStBridge,10/16/2014 10:00:00 AM,48,-122,13,6,19
6923,SpokaneStBridge,10/16/2014 11:00:00 AM,48,-122,17,12,29
6924,SpokaneStBridge,10/16/2014 12:00:00 PM,48,-122,20,8,28
6925,SpokaneStBridge,10/16/2014 01:00:00 PM,48,-122,15,17,32
6926,SpokaneStBridge,10/16/2014 02:00:00 PM,48,-122,19,36,55
6927,SpokaneStBridge,10/16/2014 03:00:00 PM,48,-122,25,39,64
6928,SpokaneStBridge,10/16/2014 04:00:00 PM,48,-122,24,86,110
6929,SpokaneStBridge,10/16/2014 05:00:00 PM,48,-122,26,127,153
6930,SpokaneStBridge,10/16/2014 06:00:00 PM,48,-122,14,60,74
6931,SpokaneStBridge,10/16/2014 07:00:00 PM,48,-122,14,23,37
6932,SpokaneStBridge,10/16/2014 08:00:00 PM,48,-122,6,10,16
6933,SpokaneStBridge,10/16/2014 09:00:00 PM,48,-122,7,7,14
6934,SpokaneStBridge,10/16/2014 10:00:00 PM,48,-122,3,5,8
6935,SpokaneStBridge,10/16/2014 11:00:00 PM,48,-122,1,3,4
6936,SpokaneStBridge,10/17/2014 12:00:00 AM,48,-122,2,3,5
6937,SpokaneStBridge,10/17/2014 01:00:00 AM,48,-122,2,2,4
6938,SpokaneStBridge,10/17/2014 02:00:00 AM,48,-122,0,2,2
6939,SpokaneStBridge,10/17/2014 03:00:00 AM,48,-122,1,1,2
6940,SpokaneStBridge,10/17/2014 04:00:00 AM,48,-122,1,1,2
6941,SpokaneStBridge,10/17/2014 05:00:00 AM,48,-122,11,5,16
6942,SpokaneStBridge,10/17/2014 06:00:00 AM,48,-122,26,5,31
6943,SpokaneStBridge,10/17/2014 07:00:00 AM,48,-122,54,10,64
6944,SpokaneStBridge,10/17/2014 08:00:00 AM,48,-122,57,7,64
6945,SpokaneStBridge,10/17/2014 09:00:00 AM,48,-122,36,2,38
6946,SpokaneStBridge,10/17/2014 10:00:00 AM,48,-122,17,4,21
6947,SpokaneStBridge,10/17/2014 11:00:00 AM,48,-122,10,1,11
6948,SpokaneStBridge,10/17/2014 12:00:00 PM,48,-122,6,8,14
6949,SpokaneStBridge,10/17/2014 01:00:00 PM,48,-122,3,7,10
6950,SpokaneStBridge,10/17/2014 02:00:00 PM,48,-122,6,9,15
6951,SpokaneStBridge,10/17/2014 03:00:00 PM,48,-122,7,15,22
6952,SpokaneStBridge,10/17/2014 04:00:00 PM,48,-122,7,27,34
6953,SpokaneStBridge,10/17/2014 05:00:00 PM,48,-122,14,81,95
6954,SpokaneStBridge,10/17/2014 06:00:00 PM,48,-122,3,53,56
6955,SpokaneStBridge,10/17/2014 07:00:00 PM,48,-122,6,14,20
6956,SpokaneStBridge,10/17/2014 08:00:00 PM,48,-122,2,10,12
6957,SpokaneStBridge,10/17/2014 09:00:00 PM,48,-122,0,2,2
6958,SpokaneStBridge,10/17/2014 10:00:00 PM,48,-122,4,4,8
6959,SpokaneStBridge,10/17/2014 11:00:00 PM,48,-122,2,0,2
6960,SpokaneStBridge,10/18/2014 12:00:00 AM,48,-122,0,2,2
6961,SpokaneStBridge,10/18/2014 01:00:00 AM,48,-122,1,1,2
6962,SpokaneStBridge,10/18/2014 02:00:00 AM,48,-122,0,2,2
6963,SpokaneStBridge,10/18/2014 03:00:00 AM,48,-122,2,2,4
6964,SpokaneStBridge,10/18/2014 04:00:00 AM,48,-122,0,1,1
6965,SpokaneStBridge,10/18/2014 05:00:00 AM,48,-122,1,0,1
6966,SpokaneStBridge,10/18/2014 06:00:00 AM,48,-122,1,1,2
6967,SpokaneStBridge,10/18/2014 07:00:00 AM,48,-122,4,2,6
6968,SpokaneStBridge,10/18/2014 08:00:00 AM,48,-122,9,6,15
6969,SpokaneStBridge,10/18/2014 09:00:00 AM,48,-122,6,8,14
6970,SpokaneStBridge,10/18/2014 10:00:00 AM,48,-122,6,8,14
6971,SpokaneStBridge,10/18/2014 11:00:00 AM,48,-122,15,10,25
6972,SpokaneStBridge,10/18/2014 12:00:00 PM,48,-122,10,7,17
6973,SpokaneStBridge,10/18/2014 01:00:00 PM,48,-122,10,7,17
6974,SpokaneStBridge,10/18/2014 02:00:00 PM,48,-122,10,15,25
6975,SpokaneStBridge,10/18/2014 03:00:00 PM,48,-122,16,13,29
6976,SpokaneStBridge,10/18/2014 04:00:00 PM,48,-122,26,8,34
6977,SpokaneStBridge,10/18/2014 05:00:00 PM,48,-122,14,14,28
6978,SpokaneStBridge,10/18/2014 06:00:00 PM,48,-122,6,6,12
6979,SpokaneStBridge,10/18/2014 07:00:00 PM,48,-122,4,2,6
6980,SpokaneStBridge,10/18/2014 08:00:00 PM,48,-122,1,3,4
6981,SpokaneStBridge,10/18/2014 09:00:00 PM,48,-122,3,2,5
6982,SpokaneStBridge,10/18/2014 10:00:00 PM,48,-122,1,0,1
6983,SpokaneStBridge,10/18/2014 11:00:00 PM,48,-122,0,3,3
6984,SpokaneStBridge,10/19/2014 12:00:00 AM,48,-122,1,1,2
6985,SpokaneStBridge,10/19/2014 01:00:00 AM,48,-122,0,4,4
6986,SpokaneStBridge,10/19/2014 02:00:00 AM,48,-122,0,2,2
6987,SpokaneStBridge,10/19/2014 03:00:00 AM,48,-122,1,0,1
6988,SpokaneStBridge,10/19/2014 04:00:00 AM,48,-122,0,3,3
6989,SpokaneStBridge,10/19/2014 05:00:00 AM,48,-122,3,0,3
6990,SpokaneStBridge,10/19/2014 06:00:00 AM,48,-122,6,0,6
6991,SpokaneStBridge,10/19/2014 07:00:00 AM,48,-122,6,2,8
6992,SpokaneStBridge,10/19/2014 08:00:00 AM,48,-122,11,5,16
6993,SpokaneStBridge,10/19/2014 09:00:00 AM,48,-122,22,5,27
6994,SpokaneStBridge,10/19/2014 10:00:00 AM,48,-122,21,28,49
6995,SpokaneStBridge,10/19/2014 11:00:00 AM,48,-122,25,24,49
6996,SpokaneStBridge,10/19/2014 12:00:00 PM,48,-122,37,24,61
6997,SpokaneStBridge,10/19/2014 01:00:00 PM,48,-122,55,35,90
6998,SpokaneStBridge,10/19/2014 02:00:00 PM,48,-122,53,42,95
6999,SpokaneStBridge,10/19/2014 03:00:00 PM,48,-122,31,41,72
7000,SpokaneStBridge,10/19/2014 04:00:00 PM,48,-122,25,29,54
7001,SpokaneStBridge,10/19/2014 05:00:00 PM,48,-122,32,32,64
7002,SpokaneStBridge,10/19/2014 06:00:00 PM,48,-122,21,21,42
7003,SpokaneStBridge,10/19/2014 07:00:00 PM,48,-122,10,4,14
7004,SpokaneStBridge,10/19/2014 08:00:00 PM,48,-122,5,7,12
7005,SpokaneStBridge,10/19/2014 09:00:00 PM,48,-122,2,3,5
7006,SpokaneStBridge,10/19/2014 10:00:00 PM,48,-122,2,1,3
7007,SpokaneStBridge,10/19/2014 11:00:00 PM,48,-122,3,1,4
7008,SpokaneStBridge,10/20/2014 12:00:00 AM,48,-122,2,1,3
7009,SpokaneStBridge,10/20/2014 01:00:00 AM,48,-122,1,1,2
7010,SpokaneStBridge,10/20/2014 02:00:00 AM,48,-122,1,0,1
7011,SpokaneStBridge,10/20/2014 03:00:00 AM,48,-122,0,0,0
7012,SpokaneStBridge,10/20/2014 04:00:00 AM,48,-122,0,1,1
7013,SpokaneStBridge,10/20/2014 05:00:00 AM,48,-122,13,4,17
7014,SpokaneStBridge,10/20/2014 06:00:00 AM,48,-122,39,8,47
7015,SpokaneStBridge,10/20/2014 07:00:00 AM,48,-122,71,17,88
7016,SpokaneStBridge,10/20/2014 08:00:00 AM,48,-122,85,8,93
7017,SpokaneStBridge,10/20/2014 09:00:00 AM,48,-122,38,2,40
7018,SpokaneStBridge,10/20/2014 10:00:00 AM,48,-122,21,4,25
7019,SpokaneStBridge,10/20/2014 11:00:00 AM,48,-122,11,5,16
7020,SpokaneStBridge,10/20/2014 12:00:00 PM,48,-122,10,3,13
7021,SpokaneStBridge,10/20/2014 01:00:00 PM,48,-122,7,7,14
7022,SpokaneStBridge,10/20/2014 02:00:00 PM,48,-122,6,11,17
7023,SpokaneStBridge,10/20/2014 03:00:00 PM,48,-122,17,18,35
7024,SpokaneStBridge,10/20/2014 04:00:00 PM,48,-122,11,49,60
7025,SpokaneStBridge,10/20/2014 05:00:00 PM,48,-122,15,97,112
7026,SpokaneStBridge,10/20/2014 06:00:00 PM,48,-122,12,78,90
7027,SpokaneStBridge,10/20/2014 07:00:00 PM,48,-122,12,15,27
7028,SpokaneStBridge,10/20/2014 08:00:00 PM,48,-122,2,10,12
7029,SpokaneStBridge,10/20/2014 09:00:00 PM,48,-122,3,3,6
7030,SpokaneStBridge,10/20/2014 10:00:00 PM,48,-122,3,2,5
7031,SpokaneStBridge,10/20/2014 11:00:00 PM,48,-122,2,3,5
7032,SpokaneStBridge,10/21/2014 12:00:00 AM,48,-122,0,0,0
7033,SpokaneStBridge,10/21/2014 01:00:00 AM,48,-122,2,4,6
7034,SpokaneStBridge,10/21/2014 02:00:00 AM,48,-122,1,0,1
7035,SpokaneStBridge,10/21/2014 03:00:00 AM,48,-122,1,3,4
7036,SpokaneStBridge,10/21/2014 04:00:00 AM,48,-122,3,1,4
7037,SpokaneStBridge,10/21/2014 05:00:00 AM,48,-122,15,1,16
7038,SpokaneStBridge,10/21/2014 06:00:00 AM,48,-122,43,5,48
7039,SpokaneStBridge,10/21/2014 07:00:00 AM,48,-122,71,12,83
7040,SpokaneStBridge,10/21/2014 08:00:00 AM,48,-122,97,11,108
7041,SpokaneStBridge,10/21/2014 09:00:00 AM,48,-122,44,6,50
7042,SpokaneStBridge,10/21/2014 10:00:00 AM,48,-122,17,5,22
7043,SpokaneStBridge,10/21/2014 11:00:00 AM,48,-122,14,13,27
7044,SpokaneStBridge,10/21/2014 12:00:00 PM,48,-122,17,9,26
7045,SpokaneStBridge,10/21/2014 01:00:00 PM,48,-122,10,10,20
7046,SpokaneStBridge,10/21/2014 02:00:00 PM,48,-122,6,16,22
7047,SpokaneStBridge,10/21/2014 03:00:00 PM,48,-122,9,18,27
7048,SpokaneStBridge,10/21/2014 04:00:00 PM,48,-122,12,52,64
7049,SpokaneStBridge,10/21/2014 05:00:00 PM,48,-122,23,101,124
7050,SpokaneStBridge,10/21/2014 06:00:00 PM,48,-122,6,74,80
7051,SpokaneStBridge,10/21/2014 07:00:00 PM,48,-122,4,22,26
7052,SpokaneStBridge,10/21/2014 08:00:00 PM,48,-122,1,8,9
7053,SpokaneStBridge,10/21/2014 09:00:00 PM,48,-122,0,4,4
7054,SpokaneStBridge,10/21/2014 10:00:00 PM,48,-122,2,2,4
7055,SpokaneStBridge,10/21/2014 11:00:00 PM,48,-122,0,1,1
7056,SpokaneStBridge,10/22/2014 12:00:00 AM,48,-122,0,1,1
7057,SpokaneStBridge,10/22/2014 01:00:00 AM,48,-122,1,0,1
7058,SpokaneStBridge,10/22/2014 02:00:00 AM,48,-122,0,2,2
7059,SpokaneStBridge,10/22/2014 03:00:00 AM,48,-122,1,0,1
7060,SpokaneStBridge,10/22/2014 04:00:00 AM,48,-122,2,1,3
7061,SpokaneStBridge,10/22/2014 05:00:00 AM,48,-122,12,1,13
7062,SpokaneStBridge,10/22/2014 06:00:00 AM,48,-122,28,6,34
7063,SpokaneStBridge,10/22/2014 07:00:00 AM,48,-122,54,14,68
7064,SpokaneStBridge,10/22/2014 08:00:00 AM,48,-122,79,6,85
7065,SpokaneStBridge,10/22/2014 09:00:00 AM,48,-122,38,1,39
7066,SpokaneStBridge,10/22/2014 10:00:00 AM,48,-122,15,3,18
7067,SpokaneStBridge,10/22/2014 11:00:00 AM,48,-122,3,4,7
7068,SpokaneStBridge,10/22/2014 12:00:00 PM,48,-122,3,1,4
7069,SpokaneStBridge,10/22/2014 01:00:00 PM,48,-122,3,5,8
7070,SpokaneStBridge,10/22/2014 02:00:00 PM,48,-122,4,8,12
7071,SpokaneStBridge,10/22/2014 03:00:00 PM,48,-122,10,16,26
7072,SpokaneStBridge,10/22/2014 04:00:00 PM,48,-122,6,30,36
7073,SpokaneStBridge,10/22/2014 05:00:00 PM,48,-122,13,63,76
7074,SpokaneStBridge,10/22/2014 06:00:00 PM,48,-122,10,53,63
7075,SpokaneStBridge,10/22/2014 07:00:00 PM,48,-122,1,17,18
7076,SpokaneStBridge,10/22/2014 08:00:00 PM,48,-122,2,6,8
7077,SpokaneStBridge,10/22/2014 09:00:00 PM,48,-122,1,10,11
7078,SpokaneStBridge,10/22/2014 10:00:00 PM,48,-122,0,0,0
7079,SpokaneStBridge,10/22/2014 11:00:00 PM,48,-122,1,0,1
7080,SpokaneStBridge,10/23/2014 12:00:00 AM,48,-122,0,1,1
7081,SpokaneStBridge,10/23/2014 01:00:00 AM,48,-122,0,0,0
7082,SpokaneStBridge,10/23/2014 02:00:00 AM,48,-122,1,0,1
7083,SpokaneStBridge,10/23/2014 03:00:00 AM,48,-122,1,0,1
7084,SpokaneStBridge,10/23/2014 04:00:00 AM,48,-122,2,0,2
7085,SpokaneStBridge,10/23/2014 05:00:00 AM,48,-122,11,2,13
7086,SpokaneStBridge,10/23/2014 06:00:00 AM,48,-122,23,6,29
7087,SpokaneStBridge,10/23/2014 07:00:00 AM,48,-122,56,11,67
7088,SpokaneStBridge,10/23/2014 08:00:00 AM,48,-122,77,4,81
7089,SpokaneStBridge,10/23/2014 09:00:00 AM,48,-122,29,2,31
7090,SpokaneStBridge,10/23/2014 10:00:00 AM,48,-122,12,2,14
7091,SpokaneStBridge,10/23/2014 11:00:00 AM,48,-122,3,2,5
7092,SpokaneStBridge,10/23/2014 12:00:00 PM,48,-122,4,8,12
7093,SpokaneStBridge,10/23/2014 01:00:00 PM,48,-122,9,10,19
7094,SpokaneStBridge,10/23/2014 02:00:00 PM,48,-122,5,12,17
7095,SpokaneStBridge,10/23/2014 03:00:00 PM,48,-122,11,18,29
7096,SpokaneStBridge,10/23/2014 04:00:00 PM,48,-122,9,19,28
7097,SpokaneStBridge,10/23/2014 05:00:00 PM,48,-122,14,76,90
7098,SpokaneStBridge,10/23/2014 06:00:00 PM,48,-122,14,56,70
7099,SpokaneStBridge,10/23/2014 07:00:00 PM,48,-122,3,29,32
7100,SpokaneStBridge,10/23/2014 08:00:00 PM,48,-122,2,11,13
7101,SpokaneStBridge,10/23/2014 09:00:00 PM,48,-122,3,4,7
7102,SpokaneStBridge,10/23/2014 10:00:00 PM,48,-122,2,4,6
7103,SpokaneStBridge,10/23/2014 11:00:00 PM,48,-122,1,0,1
7104,SpokaneStBridge,10/24/2014 12:00:00 AM,48,-122,0,3,3
7105,SpokaneStBridge,10/24/2014 01:00:00 AM,48,-122,0,3,3
7106,SpokaneStBridge,10/24/2014 02:00:00 AM,48,-122,0,1,1
7107,SpokaneStBridge,10/24/2014 03:00:00 AM,48,-122,2,0,2
7108,SpokaneStBridge,10/24/2014 04:00:00 AM,48,-122,0,0,0
7109,SpokaneStBridge,10/24/2014 05:00:00 AM,48,-122,,,
7110,SpokaneStBridge,10/24/2014 06:00:00 AM,48,-122,47,9,56
7111,SpokaneStBridge,10/24/2014 07:00:00 AM,48,-122,79,7,86
7112,SpokaneStBridge,10/24/2014 08:00:00 AM,48,-122,75,11,86
7113,SpokaneStBridge,10/24/2014 09:00:00 AM,48,-122,30,2,32
7114,SpokaneStBridge,10/24/2014 10:00:00 AM,48,-122,16,5,21
7115,SpokaneStBridge,10/24/2014 11:00:00 AM,48,-122,7,4,11
7116,SpokaneStBridge,10/24/2014 12:00:00 PM,48,-122,15,18,33
7117,SpokaneStBridge,10/24/2014 01:00:00 PM,48,-122,23,11,34
7118,SpokaneStBridge,10/24/2014 02:00:00 PM,48,-122,10,20,30
7119,SpokaneStBridge,10/24/2014 03:00:00 PM,48,-122,12,31,43
7120,SpokaneStBridge,10/24/2014 04:00:00 PM,48,-122,20,61,81
7121,SpokaneStBridge,10/24/2014 05:00:00 PM,48,-122,18,95,113
7122,SpokaneStBridge,10/24/2014 06:00:00 PM,48,-122,12,49,61
7123,SpokaneStBridge,10/24/2014 07:00:00 PM,48,-122,6,12,18
7124,SpokaneStBridge,10/24/2014 08:00:00 PM,48,-122,2,2,4
7125,SpokaneStBridge,10/24/2014 09:00:00 PM,48,-122,1,5,6
7126,SpokaneStBridge,10/24/2014 10:00:00 PM,48,-122,0,6,6
7127,SpokaneStBridge,10/24/2014 11:00:00 PM,48,-122,0,4,4
7128,SpokaneStBridge,10/25/2014 12:00:00 AM,48,-122,0,6,6
7129,SpokaneStBridge,10/25/2014 01:00:00 AM,48,-122,1,4,5
7130,SpokaneStBridge,10/25/2014 02:00:00 AM,48,-122,2,0,2
7131,SpokaneStBridge,10/25/2014 03:00:00 AM,48,-122,2,2,4
7132,SpokaneStBridge,10/25/2014 04:00:00 AM,48,-122,3,2,5
7133,SpokaneStBridge,10/25/2014 05:00:00 AM,48,-122,1,0,1
7134,SpokaneStBridge,10/25/2014 06:00:00 AM,48,-122,1,0,1
7135,SpokaneStBridge,10/25/2014 07:00:00 AM,48,-122,6,1,7
7136,SpokaneStBridge,10/25/2014 08:00:00 AM,48,-122,6,4,10
7137,SpokaneStBridge,10/25/2014 09:00:00 AM,48,-122,7,4,11
7138,SpokaneStBridge,10/25/2014 10:00:00 AM,48,-122,9,7,16
7139,SpokaneStBridge,10/25/2014 11:00:00 AM,48,-122,12,10,22
7140,SpokaneStBridge,10/25/2014 12:00:00 PM,48,-122,8,4,12
7141,SpokaneStBridge,10/25/2014 01:00:00 PM,48,-122,4,2,6
7142,SpokaneStBridge,10/25/2014 02:00:00 PM,48,-122,11,7,18
7143,SpokaneStBridge,10/25/2014 03:00:00 PM,48,-122,4,9,13
7144,SpokaneStBridge,10/25/2014 04:00:00 PM,48,-122,2,7,9
7145,SpokaneStBridge,10/25/2014 05:00:00 PM,48,-122,8,5,13
7146,SpokaneStBridge,10/25/2014 06:00:00 PM,48,-122,3,4,7
7147,SpokaneStBridge,10/25/2014 07:00:00 PM,48,-122,0,1,1
7148,SpokaneStBridge,10/25/2014 08:00:00 PM,48,-122,1,2,3
7149,SpokaneStBridge,10/25/2014 09:00:00 PM,48,-122,2,2,4
7150,SpokaneStBridge,10/25/2014 10:00:00 PM,48,-122,3,0,3
7151,SpokaneStBridge,10/25/2014 11:00:00 PM,48,-122,3,1,4
7152,SpokaneStBridge,10/26/2014 12:00:00 AM,48,-122,0,1,1
7153,SpokaneStBridge,10/26/2014 01:00:00 AM,48,-122,0,1,1
7154,SpokaneStBridge,10/26/2014 02:00:00 AM,48,-122,0,0,0
7155,SpokaneStBridge,10/26/2014 03:00:00 AM,48,-122,0,2,2
7156,SpokaneStBridge,10/26/2014 04:00:00 AM,48,-122,0,4,4
7157,SpokaneStBridge,10/26/2014 05:00:00 AM,48,-122,1,0,1
7158,SpokaneStBridge,10/26/2014 06:00:00 AM,48,-122,3,1,4
7159,SpokaneStBridge,10/26/2014 07:00:00 AM,48,-122,2,1,3
7160,SpokaneStBridge,10/26/2014 08:00:00 AM,48,-122,0,0,0
7161,SpokaneStBridge,10/26/2014 09:00:00 AM,48,-122,8,2,10
7162,SpokaneStBridge,10/26/2014 10:00:00 AM,48,-122,8,5,13
7163,SpokaneStBridge,10/26/2014 11:00:00 AM,48,-122,13,24,37
7164,SpokaneStBridge,10/26/2014 12:00:00 PM,48,-122,16,9,25
7165,SpokaneStBridge,10/26/2014 01:00:00 PM,48,-122,8,8,16
7166,SpokaneStBridge,10/26/2014 02:00:00 PM,48,-122,9,4,13
7167,SpokaneStBridge,10/26/2014 03:00:00 PM,48,-122,6,13,19
7168,SpokaneStBridge,10/26/2014 04:00:00 PM,48,-122,10,12,22
7169,SpokaneStBridge,10/26/2014 05:00:00 PM,48,-122,7,9,16
7170,SpokaneStBridge,10/26/2014 06:00:00 PM,48,-122,8,5,13
7171,SpokaneStBridge,10/26/2014 07:00:00 PM,48,-122,3,2,5
7172,SpokaneStBridge,10/26/2014 08:00:00 PM,48,-122,2,3,5
7173,SpokaneStBridge,10/26/2014 09:00:00 PM,48,-122,0,1,1
7174,SpokaneStBridge,10/26/2014 10:00:00 PM,48,-122,0,1,1
7175,SpokaneStBridge,10/26/2014 11:00:00 PM,48,-122,0,2,2
7176,SpokaneStBridge,10/27/2014 12:00:00 AM,48,-122,0,1,1
7177,SpokaneStBridge,10/27/2014 01:00:00 AM,48,-122,0,1,1
7178,SpokaneStBridge,10/27/2014 02:00:00 AM,48,-122,1,0,1
7179,SpokaneStBridge,10/27/2014 03:00:00 AM,48,-122,2,1,3
7180,SpokaneStBridge,10/27/2014 04:00:00 AM,48,-122,6,2,8
7181,SpokaneStBridge,10/27/2014 05:00:00 AM,48,-122,14,4,18
7182,SpokaneStBridge,10/27/2014 06:00:00 AM,48,-122,37,7,44
7183,SpokaneStBridge,10/27/2014 07:00:00 AM,48,-122,95,16,111
7184,SpokaneStBridge,10/27/2014 08:00:00 AM,48,-122,109,8,117
7185,SpokaneStBridge,10/27/2014 09:00:00 AM,48,-122,39,1,40
7186,SpokaneStBridge,10/27/2014 10:00:00 AM,48,-122,13,7,20
7187,SpokaneStBridge,10/27/2014 11:00:00 AM,48,-122,13,8,21
7188,SpokaneStBridge,10/27/2014 12:00:00 PM,48,-122,16,12,28
7189,SpokaneStBridge,10/27/2014 01:00:00 PM,48,-122,19,12,31
7190,SpokaneStBridge,10/27/2014 02:00:00 PM,48,-122,13,12,25
7191,SpokaneStBridge,10/27/2014 03:00:00 PM,48,-122,10,35,45
7192,SpokaneStBridge,10/27/2014 04:00:00 PM,48,-122,8,60,68
7193,SpokaneStBridge,10/27/2014 05:00:00 PM,48,-122,22,106,128
7194,SpokaneStBridge,10/27/2014 06:00:00 PM,48,-122,15,82,97
7195,SpokaneStBridge,10/27/2014 07:00:00 PM,48,-122,5,20,25
7196,SpokaneStBridge,10/27/2014 08:00:00 PM,48,-122,4,6,10
7197,SpokaneStBridge,10/27/2014 09:00:00 PM,48,-122,1,9,10
7198,SpokaneStBridge,10/27/2014 10:00:00 PM,48,-122,5,2,7
7199,SpokaneStBridge,10/27/2014 11:00:00 PM,48,-122,1,1,2
7200,SpokaneStBridge,10/28/2014 12:00:00 AM,48,-122,0,0,0
7201,SpokaneStBridge,10/28/2014 01:00:00 AM,48,-122,1,1,2
7202,SpokaneStBridge,10/28/2014 02:00:00 AM,48,-122,0,1,1
7203,SpokaneStBridge,10/28/2014 03:00:00 AM,48,-122,0,0,0
7204,SpokaneStBridge,10/28/2014 04:00:00 AM,48,-122,1,1,2
7205,SpokaneStBridge,10/28/2014 05:00:00 AM,48,-122,12,2,14
7206,SpokaneStBridge,10/28/2014 06:00:00 AM,48,-122,40,5,45
7207,SpokaneStBridge,10/28/2014 07:00:00 AM,48,-122,60,13,73
7208,SpokaneStBridge,10/28/2014 08:00:00 AM,48,-122,72,7,79
7209,SpokaneStBridge,10/28/2014 09:00:00 AM,48,-122,28,3,31
7210,SpokaneStBridge,10/28/2014 10:00:00 AM,48,-122,10,4,14
7211,SpokaneStBridge,10/28/2014 11:00:00 AM,48,-122,3,1,4
7212,SpokaneStBridge,10/28/2014 12:00:00 PM,48,-122,4,2,6
7213,SpokaneStBridge,10/28/2014 01:00:00 PM,48,-122,6,1,7
7214,SpokaneStBridge,10/28/2014 02:00:00 PM,48,-122,5,4,9
7215,SpokaneStBridge,10/28/2014 03:00:00 PM,48,-122,5,15,20
7216,SpokaneStBridge,10/28/2014 04:00:00 PM,48,-122,12,29,41
7217,SpokaneStBridge,10/28/2014 05:00:00 PM,48,-122,22,80,102
7218,SpokaneStBridge,10/28/2014 06:00:00 PM,48,-122,7,63,70
7219,SpokaneStBridge,10/28/2014 07:00:00 PM,48,-122,4,19,23
7220,SpokaneStBridge,10/28/2014 08:00:00 PM,48,-122,2,7,9
7221,SpokaneStBridge,10/28/2014 09:00:00 PM,48,-122,1,7,8
7222,SpokaneStBridge,10/28/2014 10:00:00 PM,48,-122,1,2,3
7223,SpokaneStBridge,10/28/2014 11:00:00 PM,48,-122,1,1,2
7224,SpokaneStBridge,10/29/2014 12:00:00 AM,48,-122,2,1,3
7225,SpokaneStBridge,10/29/2014 01:00:00 AM,48,-122,0,1,1
7226,SpokaneStBridge,10/29/2014 02:00:00 AM,48,-122,0,2,2
7227,SpokaneStBridge,10/29/2014 03:00:00 AM,48,-122,1,1,2
7228,SpokaneStBridge,10/29/2014 04:00:00 AM,48,-122,4,1,5
7229,SpokaneStBridge,10/29/2014 05:00:00 AM,48,-122,16,2,18
7230,SpokaneStBridge,10/29/2014 06:00:00 AM,48,-122,44,1,45
7231,SpokaneStBridge,10/29/2014 07:00:00 AM,48,-122,99,16,115
7232,SpokaneStBridge,10/29/2014 08:00:00 AM,48,-122,124,12,136
7233,SpokaneStBridge,10/29/2014 09:00:00 AM,48,-122,44,3,47
7234,SpokaneStBridge,10/29/2014 10:00:00 AM,48,-122,22,6,28
7235,SpokaneStBridge,10/29/2014 11:00:00 AM,48,-122,15,8,23
7236,SpokaneStBridge,10/29/2014 12:00:00 PM,48,-122,10,18,28
7237,SpokaneStBridge,10/29/2014 01:00:00 PM,48,-122,20,8,28
7238,SpokaneStBridge,10/29/2014 02:00:00 PM,48,-122,17,16,33
7239,SpokaneStBridge,10/29/2014 03:00:00 PM,48,-122,15,41,56
7240,SpokaneStBridge,10/29/2014 04:00:00 PM,48,-122,19,72,91
7241,SpokaneStBridge,10/29/2014 05:00:00 PM,48,-122,23,109,132
7242,SpokaneStBridge,10/29/2014 06:00:00 PM,48,-122,15,83,98
7243,SpokaneStBridge,10/29/2014 07:00:00 PM,48,-122,5,19,24
7244,SpokaneStBridge,10/29/2014 08:00:00 PM,48,-122,3,22,25
7245,SpokaneStBridge,10/29/2014 09:00:00 PM,48,-122,4,11,15
7246,SpokaneStBridge,10/29/2014 10:00:00 PM,48,-122,1,9,10
7247,SpokaneStBridge,10/29/2014 11:00:00 PM,48,-122,1,2,3
7248,SpokaneStBridge,10/30/2014 12:00:00 AM,48,-122,1,3,4
7249,SpokaneStBridge,10/30/2014 01:00:00 AM,48,-122,3,1,4
7250,SpokaneStBridge,10/30/2014 02:00:00 AM,48,-122,0,1,1
7251,SpokaneStBridge,10/30/2014 03:00:00 AM,48,-122,0,0,0
7252,SpokaneStBridge,10/30/2014 04:00:00 AM,48,-122,2,0,2
7253,SpokaneStBridge,10/30/2014 05:00:00 AM,48,-122,13,4,17
7254,SpokaneStBridge,10/30/2014 06:00:00 AM,48,-122,43,4,47
7255,SpokaneStBridge,10/30/2014 07:00:00 AM,48,-122,87,11,98
7256,SpokaneStBridge,10/30/2014 08:00:00 AM,48,-122,89,6,95
7257,SpokaneStBridge,10/30/2014 09:00:00 AM,48,-122,30,4,34
7258,SpokaneStBridge,10/30/2014 10:00:00 AM,48,-122,14,2,16
7259,SpokaneStBridge,10/30/2014 11:00:00 AM,48,-122,5,5,10
7260,SpokaneStBridge,10/30/2014 12:00:00 PM,48,-122,5,5,10
7261,SpokaneStBridge,10/30/2014 01:00:00 PM,48,-122,9,3,12
7262,SpokaneStBridge,10/30/2014 02:00:00 PM,48,-122,1,9,10
7263,SpokaneStBridge,10/30/2014 03:00:00 PM,48,-122,6,11,17
7264,SpokaneStBridge,10/30/2014 04:00:00 PM,48,-122,9,33,42
7265,SpokaneStBridge,10/30/2014 05:00:00 PM,48,-122,9,104,113
7266,SpokaneStBridge,10/30/2014 06:00:00 PM,48,-122,16,56,72
7267,SpokaneStBridge,10/30/2014 07:00:00 PM,48,-122,3,19,22
7268,SpokaneStBridge,10/30/2014 08:00:00 PM,48,-122,4,10,14
7269,SpokaneStBridge,10/30/2014 09:00:00 PM,48,-122,4,9,13
7270,SpokaneStBridge,10/30/2014 10:00:00 PM,48,-122,0,2,2
7271,SpokaneStBridge,10/30/2014 11:00:00 PM,48,-122,0,2,2
7272,SpokaneStBridge,10/31/2014 12:00:00 AM,48,-122,0,1,1
7273,SpokaneStBridge,10/31/2014 01:00:00 AM,48,-122,0,1,1
7274,SpokaneStBridge,10/31/2014 02:00:00 AM,48,-122,0,1,1
7275,SpokaneStBridge,10/31/2014 03:00:00 AM,48,-122,1,0,1
7276,SpokaneStBridge,10/31/2014 04:00:00 AM,48,-122,1,0,1
7277,SpokaneStBridge,10/31/2014 05:00:00 AM,48,-122,5,2,7
7278,SpokaneStBridge,10/31/2014 06:00:00 AM,48,-122,26,5,31
7279,SpokaneStBridge,10/31/2014 07:00:00 AM,48,-122,50,8,58
7280,SpokaneStBridge,10/31/2014 08:00:00 AM,48,-122,52,6,58
7281,SpokaneStBridge,10/31/2014 09:00:00 AM,48,-122,28,4,32
7282,SpokaneStBridge,10/31/2014 10:00:00 AM,48,-122,8,2,10
7283,SpokaneStBridge,10/31/2014 11:00:00 AM,48,-122,6,2,8
7284,SpokaneStBridge,10/31/2014 12:00:00 PM,48,-122,4,6,10
7285,SpokaneStBridge,10/31/2014 01:00:00 PM,48,-122,6,1,7
7286,SpokaneStBridge,10/31/2014 02:00:00 PM,48,-122,6,8,14
7287,SpokaneStBridge,10/31/2014 03:00:00 PM,48,-122,6,21,27
7288,SpokaneStBridge,10/31/2014 04:00:00 PM,48,-122,16,43,59
7289,SpokaneStBridge,10/31/2014 05:00:00 PM,48,-122,8,66,74
7290,SpokaneStBridge,10/31/2014 06:00:00 PM,48,-122,5,27,32
7291,SpokaneStBridge,10/31/2014 07:00:00 PM,48,-122,8,10,18
7292,SpokaneStBridge,10/31/2014 08:00:00 PM,48,-122,0,7,7
7293,SpokaneStBridge,10/31/2014 09:00:00 PM,48,-122,4,3,7
7294,SpokaneStBridge,10/31/2014 10:00:00 PM,48,-122,2,0,2
7295,SpokaneStBridge,10/31/2014 11:00:00 PM,48,-122,4,6,10
7296,SpokaneStBridge,11/01/2014 12:00:00 AM,48,-122,1,4,5
7297,SpokaneStBridge,11/01/2014 01:00:00 AM,48,-122,0,4,4
7298,SpokaneStBridge,11/01/2014 02:00:00 AM,48,-122,2,2,4
7299,SpokaneStBridge,11/01/2014 03:00:00 AM,48,-122,2,2,4
7300,SpokaneStBridge,11/01/2014 04:00:00 AM,48,-122,1,3,4
7301,SpokaneStBridge,11/01/2014 05:00:00 AM,48,-122,1,1,2
7302,SpokaneStBridge,11/01/2014 06:00:00 AM,48,-122,3,1,4
7303,SpokaneStBridge,11/01/2014 07:00:00 AM,48,-122,4,2,6
7304,SpokaneStBridge,11/01/2014 08:00:00 AM,48,-122,13,5,18
7305,SpokaneStBridge,11/01/2014 09:00:00 AM,48,-122,12,11,23
7306,SpokaneStBridge,11/01/2014 10:00:00 AM,48,-122,8,14,22
7307,SpokaneStBridge,11/01/2014 11:00:00 AM,48,-122,16,17,33
7308,SpokaneStBridge,11/01/2014 12:00:00 PM,48,-122,19,16,35
7309,SpokaneStBridge,11/01/2014 01:00:00 PM,48,-122,31,25,56
7310,SpokaneStBridge,11/01/2014 02:00:00 PM,48,-122,13,16,29
7311,SpokaneStBridge,11/01/2014 03:00:00 PM,48,-122,22,15,37
7312,SpokaneStBridge,11/01/2014 04:00:00 PM,48,-122,19,22,41
7313,SpokaneStBridge,11/01/2014 05:00:00 PM,48,-122,7,13,20
7314,SpokaneStBridge,11/01/2014 06:00:00 PM,48,-122,3,9,12
7315,SpokaneStBridge,11/01/2014 07:00:00 PM,48,-122,3,1,4
7316,SpokaneStBridge,11/01/2014 08:00:00 PM,48,-122,4,2,6
7317,SpokaneStBridge,11/01/2014 09:00:00 PM,48,-122,0,3,3
7318,SpokaneStBridge,11/01/2014 10:00:00 PM,48,-122,1,4,5
7319,SpokaneStBridge,11/01/2014 11:00:00 PM,48,-122,1,3,4
7320,SpokaneStBridge,11/02/2014 12:00:00 AM,48,-122,2,2,4
7321,SpokaneStBridge,11/02/2014 01:00:00 AM,48,-122,4,4,8
7322,SpokaneStBridge,11/02/2014 02:00:00 AM,48,-122,0,1,1
7323,SpokaneStBridge,11/02/2014 03:00:00 AM,48,-122,0,0,0
7324,SpokaneStBridge,11/02/2014 04:00:00 AM,48,-122,1,3,4
7325,SpokaneStBridge,11/02/2014 05:00:00 AM,48,-122,3,1,4
7326,SpokaneStBridge,11/02/2014 06:00:00 AM,48,-122,3,2,5
7327,SpokaneStBridge,11/02/2014 07:00:00 AM,48,-122,5,1,6
7328,SpokaneStBridge,11/02/2014 08:00:00 AM,48,-122,17,5,22
7329,SpokaneStBridge,11/02/2014 09:00:00 AM,48,-122,14,11,25
7330,SpokaneStBridge,11/02/2014 10:00:00 AM,48,-122,26,21,47
7331,SpokaneStBridge,11/02/2014 11:00:00 AM,48,-122,20,16,36
7332,SpokaneStBridge,11/02/2014 12:00:00 PM,48,-122,19,18,37
7333,SpokaneStBridge,11/02/2014 01:00:00 PM,48,-122,9,12,21
7334,SpokaneStBridge,11/02/2014 02:00:00 PM,48,-122,3,6,9
7335,SpokaneStBridge,11/02/2014 03:00:00 PM,48,-122,6,2,8
7336,SpokaneStBridge,11/02/2014 04:00:00 PM,48,-122,5,4,9
7337,SpokaneStBridge,11/02/2014 05:00:00 PM,48,-122,3,11,14
7338,SpokaneStBridge,11/02/2014 06:00:00 PM,48,-122,2,4,6
7339,SpokaneStBridge,11/02/2014 07:00:00 PM,48,-122,0,1,1
7340,SpokaneStBridge,11/02/2014 08:00:00 PM,48,-122,1,0,1
7341,SpokaneStBridge,11/02/2014 09:00:00 PM,48,-122,0,0,0
7342,SpokaneStBridge,11/02/2014 10:00:00 PM,48,-122,0,0,0
7343,SpokaneStBridge,11/02/2014 11:00:00 PM,48,-122,1,1,2
7344,SpokaneStBridge,11/03/2014 12:00:00 AM,48,-122,1,0,1
7345,SpokaneStBridge,11/03/2014 01:00:00 AM,48,-122,1,1,2
7346,SpokaneStBridge,11/03/2014 02:00:00 AM,48,-122,0,0,0
7347,SpokaneStBridge,11/03/2014 03:00:00 AM,48,-122,2,2,4
7348,SpokaneStBridge,11/03/2014 04:00:00 AM,48,-122,3,2,5
7349,SpokaneStBridge,11/03/2014 05:00:00 AM,48,-122,18,8,26
7350,SpokaneStBridge,11/03/2014 06:00:00 AM,48,-122,41,4,45
7351,SpokaneStBridge,11/03/2014 07:00:00 AM,48,-122,102,15,117
7352,SpokaneStBridge,11/03/2014 08:00:00 AM,48,-122,82,6,88
7353,SpokaneStBridge,11/03/2014 09:00:00 AM,48,-122,35,2,37
7354,SpokaneStBridge,11/03/2014 10:00:00 AM,48,-122,10,4,14
7355,SpokaneStBridge,11/03/2014 11:00:00 AM,48,-122,6,4,10
7356,SpokaneStBridge,11/03/2014 12:00:00 PM,48,-122,9,7,16
7357,SpokaneStBridge,11/03/2014 01:00:00 PM,48,-122,7,8,15
7358,SpokaneStBridge,11/03/2014 02:00:00 PM,48,-122,8,7,15
7359,SpokaneStBridge,11/03/2014 03:00:00 PM,48,-122,10,17,27
7360,SpokaneStBridge,11/03/2014 04:00:00 PM,48,-122,9,33,42
7361,SpokaneStBridge,11/03/2014 05:00:00 PM,48,-122,20,98,118
7362,SpokaneStBridge,11/03/2014 06:00:00 PM,48,-122,7,60,67
7363,SpokaneStBridge,11/03/2014 07:00:00 PM,48,-122,3,15,18
7364,SpokaneStBridge,11/03/2014 08:00:00 PM,48,-122,1,8,9
7365,SpokaneStBridge,11/03/2014 09:00:00 PM,48,-122,4,4,8
7366,SpokaneStBridge,11/03/2014 10:00:00 PM,48,-122,2,3,5
7367,SpokaneStBridge,11/03/2014 11:00:00 PM,48,-122,1,1,2
7368,SpokaneStBridge,11/04/2014 12:00:00 AM,48,-122,0,1,1
7369,SpokaneStBridge,11/04/2014 01:00:00 AM,48,-122,1,2,3
7370,SpokaneStBridge,11/04/2014 02:00:00 AM,48,-122,2,0,2
7371,SpokaneStBridge,11/04/2014 03:00:00 AM,48,-122,0,0,0
7372,SpokaneStBridge,11/04/2014 04:00:00 AM,48,-122,2,1,3
7373,SpokaneStBridge,11/04/2014 05:00:00 AM,48,-122,20,1,21
7374,SpokaneStBridge,11/04/2014 06:00:00 AM,48,-122,39,9,48
7375,SpokaneStBridge,11/04/2014 07:00:00 AM,48,-122,94,9,103
7376,SpokaneStBridge,11/04/2014 08:00:00 AM,48,-122,84,3,87
7377,SpokaneStBridge,11/04/2014 09:00:00 AM,48,-122,30,5,35
7378,SpokaneStBridge,11/04/2014 10:00:00 AM,48,-122,8,1,9
7379,SpokaneStBridge,11/04/2014 11:00:00 AM,48,-122,8,7,15
7380,SpokaneStBridge,11/04/2014 12:00:00 PM,48,-122,8,2,10
7381,SpokaneStBridge,11/04/2014 01:00:00 PM,48,-122,6,6,12
7382,SpokaneStBridge,11/04/2014 02:00:00 PM,48,-122,11,13,24
7383,SpokaneStBridge,11/04/2014 03:00:00 PM,48,-122,10,24,34
7384,SpokaneStBridge,11/04/2014 04:00:00 PM,48,-122,16,50,66
7385,SpokaneStBridge,11/04/2014 05:00:00 PM,48,-122,20,112,132
7386,SpokaneStBridge,11/04/2014 06:00:00 PM,48,-122,9,50,59
7387,SpokaneStBridge,11/04/2014 07:00:00 PM,48,-122,5,8,13
7388,SpokaneStBridge,11/04/2014 08:00:00 PM,48,-122,3,11,14
7389,SpokaneStBridge,11/04/2014 09:00:00 PM,48,-122,0,8,8
7390,SpokaneStBridge,11/04/2014 10:00:00 PM,48,-122,2,3,5
7391,SpokaneStBridge,11/04/2014 11:00:00 PM,48,-122,3,2,5
7392,SpokaneStBridge,11/05/2014 12:00:00 AM,48,-122,3,3,6
7393,SpokaneStBridge,11/05/2014 01:00:00 AM,48,-122,2,2,4
7394,SpokaneStBridge,11/05/2014 02:00:00 AM,48,-122,2,0,2
7395,SpokaneStBridge,11/05/2014 03:00:00 AM,48,-122,1,2,3
7396,SpokaneStBridge,11/05/2014 04:00:00 AM,48,-122,3,0,3
7397,SpokaneStBridge,11/05/2014 05:00:00 AM,48,-122,21,4,25
7398,SpokaneStBridge,11/05/2014 06:00:00 AM,48,-122,43,7,50
7399,SpokaneStBridge,11/05/2014 07:00:00 AM,48,-122,75,14,89
7400,SpokaneStBridge,11/05/2014 08:00:00 AM,48,-122,111,12,123
7401,SpokaneStBridge,11/05/2014 09:00:00 AM,48,-122,50,5,55
7402,SpokaneStBridge,11/05/2014 10:00:00 AM,48,-122,12,3,15
7403,SpokaneStBridge,11/05/2014 11:00:00 AM,48,-122,6,2,8
7404,SpokaneStBridge,11/05/2014 12:00:00 PM,48,-122,17,22,39
7405,SpokaneStBridge,11/05/2014 01:00:00 PM,48,-122,17,6,23
7406,SpokaneStBridge,11/05/2014 02:00:00 PM,48,-122,8,15,23
7407,SpokaneStBridge,11/05/2014 03:00:00 PM,48,-122,12,19,31
7408,SpokaneStBridge,11/05/2014 04:00:00 PM,48,-122,16,51,67
7409,SpokaneStBridge,11/05/2014 05:00:00 PM,48,-122,18,98,116
7410,SpokaneStBridge,11/05/2014 06:00:00 PM,48,-122,5,43,48
7411,SpokaneStBridge,11/05/2014 07:00:00 PM,48,-122,0,15,15
7412,SpokaneStBridge,11/05/2014 08:00:00 PM,48,-122,5,7,12
7413,SpokaneStBridge,11/05/2014 09:00:00 PM,48,-122,3,5,8
7414,SpokaneStBridge,11/05/2014 10:00:00 PM,48,-122,2,4,6
7415,SpokaneStBridge,11/05/2014 11:00:00 PM,48,-122,1,8,9
7416,SpokaneStBridge,11/06/2014 12:00:00 AM,48,-122,2,2,4
7417,SpokaneStBridge,11/06/2014 01:00:00 AM,48,-122,1,1,2
7418,SpokaneStBridge,11/06/2014 02:00:00 AM,48,-122,1,2,3
7419,SpokaneStBridge,11/06/2014 03:00:00 AM,48,-122,2,1,3
7420,SpokaneStBridge,11/06/2014 04:00:00 AM,48,-122,1,0,1
7421,SpokaneStBridge,11/06/2014 05:00:00 AM,48,-122,13,3,16
7422,SpokaneStBridge,11/06/2014 06:00:00 AM,48,-122,42,4,46
7423,SpokaneStBridge,11/06/2014 07:00:00 AM,48,-122,74,13,87
7424,SpokaneStBridge,11/06/2014 08:00:00 AM,48,-122,60,3,63
7425,SpokaneStBridge,11/06/2014 09:00:00 AM,48,-122,35,4,39
7426,SpokaneStBridge,11/06/2014 10:00:00 AM,48,-122,14,6,20
7427,SpokaneStBridge,11/06/2014 11:00:00 AM,48,-122,17,4,21
7428,SpokaneStBridge,11/06/2014 12:00:00 PM,48,-122,4,3,7
7429,SpokaneStBridge,11/06/2014 01:00:00 PM,48,-122,3,3,6
7430,SpokaneStBridge,11/06/2014 02:00:00 PM,48,-122,7,9,16
7431,SpokaneStBridge,11/06/2014 03:00:00 PM,48,-122,9,17,26
7432,SpokaneStBridge,11/06/2014 04:00:00 PM,48,-122,15,44,59
7433,SpokaneStBridge,11/06/2014 05:00:00 PM,48,-122,20,87,107
7434,SpokaneStBridge,11/06/2014 06:00:00 PM,48,-122,9,42,51
7435,SpokaneStBridge,11/06/2014 07:00:00 PM,48,-122,5,12,17
7436,SpokaneStBridge,11/06/2014 08:00:00 PM,48,-122,3,3,6
7437,SpokaneStBridge,11/06/2014 09:00:00 PM,48,-122,0,3,3
7438,SpokaneStBridge,11/06/2014 10:00:00 PM,48,-122,1,4,5
7439,SpokaneStBridge,11/06/2014 11:00:00 PM,48,-122,0,3,3
7440,SpokaneStBridge,11/07/2014 12:00:00 AM,48,-122,0,2,2
7441,SpokaneStBridge,11/07/2014 01:00:00 AM,48,-122,1,0,1
7442,SpokaneStBridge,11/07/2014 02:00:00 AM,48,-122,0,0,0
7443,SpokaneStBridge,11/07/2014 03:00:00 AM,48,-122,1,1,2
7444,SpokaneStBridge,11/07/2014 04:00:00 AM,48,-122,1,2,3
7445,SpokaneStBridge,11/07/2014 05:00:00 AM,48,-122,18,1,19
7446,SpokaneStBridge,11/07/2014 06:00:00 AM,48,-122,38,5,43
7447,SpokaneStBridge,11/07/2014 07:00:00 AM,48,-122,102,19,121
7448,SpokaneStBridge,11/07/2014 08:00:00 AM,48,-122,80,11,91
7449,SpokaneStBridge,11/07/2014 09:00:00 AM,48,-122,46,8,54
7450,SpokaneStBridge,11/07/2014 10:00:00 AM,48,-122,10,9,19
7451,SpokaneStBridge,11/07/2014 11:00:00 AM,48,-122,16,11,27
7452,SpokaneStBridge,11/07/2014 12:00:00 PM,48,-122,15,14,29
7453,SpokaneStBridge,11/07/2014 01:00:00 PM,48,-122,18,15,33
7454,SpokaneStBridge,11/07/2014 02:00:00 PM,48,-122,15,21,36
7455,SpokaneStBridge,11/07/2014 03:00:00 PM,48,-122,16,31,47
7456,SpokaneStBridge,11/07/2014 04:00:00 PM,48,-122,21,59,80
7457,SpokaneStBridge,11/07/2014 05:00:00 PM,48,-122,17,82,99
7458,SpokaneStBridge,11/07/2014 06:00:00 PM,48,-122,9,42,51
7459,SpokaneStBridge,11/07/2014 07:00:00 PM,48,-122,10,12,22
7460,SpokaneStBridge,11/07/2014 08:00:00 PM,48,-122,2,7,9
7461,SpokaneStBridge,11/07/2014 09:00:00 PM,48,-122,2,5,7
7462,SpokaneStBridge,11/07/2014 10:00:00 PM,48,-122,1,5,6
7463,SpokaneStBridge,11/07/2014 11:00:00 PM,48,-122,1,5,6
7464,SpokaneStBridge,11/08/2014 12:00:00 AM,48,-122,0,4,4
7465,SpokaneStBridge,11/08/2014 01:00:00 AM,48,-122,0,2,2
7466,SpokaneStBridge,11/08/2014 02:00:00 AM,48,-122,0,5,5
7467,SpokaneStBridge,11/08/2014 03:00:00 AM,48,-122,0,1,1
7468,SpokaneStBridge,11/08/2014 04:00:00 AM,48,-122,0,1,1
7469,SpokaneStBridge,11/08/2014 05:00:00 AM,48,-122,7,1,8
7470,SpokaneStBridge,11/08/2014 06:00:00 AM,48,-122,3,0,3
7471,SpokaneStBridge,11/08/2014 07:00:00 AM,48,-122,7,3,10
7472,SpokaneStBridge,11/08/2014 08:00:00 AM,48,-122,23,8,31
7473,SpokaneStBridge,11/08/2014 09:00:00 AM,48,-122,18,23,41
7474,SpokaneStBridge,11/08/2014 10:00:00 AM,48,-122,14,18,32
7475,SpokaneStBridge,11/08/2014 11:00:00 AM,48,-122,38,42,80
7476,SpokaneStBridge,11/08/2014 12:00:00 PM,48,-122,39,26,65
7477,SpokaneStBridge,11/08/2014 01:00:00 PM,48,-122,39,24,63
7478,SpokaneStBridge,11/08/2014 02:00:00 PM,48,-122,40,31,71
7479,SpokaneStBridge,11/08/2014 03:00:00 PM,48,-122,17,33,50
7480,SpokaneStBridge,11/08/2014 04:00:00 PM,48,-122,23,17,40
7481,SpokaneStBridge,11/08/2014 05:00:00 PM,48,-122,15,12,27
7482,SpokaneStBridge,11/08/2014 06:00:00 PM,48,-122,5,6,11
7483,SpokaneStBridge,11/08/2014 07:00:00 PM,48,-122,4,5,9
7484,SpokaneStBridge,11/08/2014 08:00:00 PM,48,-122,5,1,6
7485,SpokaneStBridge,11/08/2014 09:00:00 PM,48,-122,1,5,6
7486,SpokaneStBridge,11/08/2014 10:00:00 PM,48,-122,0,0,0
7487,SpokaneStBridge,11/08/2014 11:00:00 PM,48,-122,0,2,2
7488,SpokaneStBridge,11/09/2014 12:00:00 AM,48,-122,0,1,1
7489,SpokaneStBridge,11/09/2014 01:00:00 AM,48,-122,0,2,2
7490,SpokaneStBridge,11/09/2014 02:00:00 AM,48,-122,2,0,2
7491,SpokaneStBridge,11/09/2014 03:00:00 AM,48,-122,0,1,1
7492,SpokaneStBridge,11/09/2014 04:00:00 AM,48,-122,1,1,2
7493,SpokaneStBridge,11/09/2014 05:00:00 AM,48,-122,2,3,5
7494,SpokaneStBridge,11/09/2014 06:00:00 AM,48,-122,2,2,4
7495,SpokaneStBridge,11/09/2014 07:00:00 AM,48,-122,3,0,3
7496,SpokaneStBridge,11/09/2014 08:00:00 AM,48,-122,4,2,6
7497,SpokaneStBridge,11/09/2014 09:00:00 AM,48,-122,7,2,9
7498,SpokaneStBridge,11/09/2014 10:00:00 AM,48,-122,9,2,11
7499,SpokaneStBridge,11/09/2014 11:00:00 AM,48,-122,11,6,17
7500,SpokaneStBridge,11/09/2014 12:00:00 PM,48,-122,9,7,16
7501,SpokaneStBridge,11/09/2014 01:00:00 PM,48,-122,9,11,20
7502,SpokaneStBridge,11/09/2014 02:00:00 PM,48,-122,6,7,13
7503,SpokaneStBridge,11/09/2014 03:00:00 PM,48,-122,3,4,7
7504,SpokaneStBridge,11/09/2014 04:00:00 PM,48,-122,4,7,11
7505,SpokaneStBridge,11/09/2014 05:00:00 PM,48,-122,4,6,10
7506,SpokaneStBridge,11/09/2014 06:00:00 PM,48,-122,0,5,5
7507,SpokaneStBridge,11/09/2014 07:00:00 PM,48,-122,4,3,7
7508,SpokaneStBridge,11/09/2014 08:00:00 PM,48,-122,3,1,4
7509,SpokaneStBridge,11/09/2014 09:00:00 PM,48,-122,0,2,2
7510,SpokaneStBridge,11/09/2014 10:00:00 PM,48,-122,1,2,3
7511,SpokaneStBridge,11/09/2014 11:00:00 PM,48,-122,0,2,2
7512,SpokaneStBridge,11/10/2014 12:00:00 AM,48,-122,0,0,0
7513,SpokaneStBridge,11/10/2014 01:00:00 AM,48,-122,1,1,2
7514,SpokaneStBridge,11/10/2014 02:00:00 AM,48,-122,0,0,0
7515,SpokaneStBridge,11/10/2014 03:00:00 AM,48,-122,1,0,1
7516,SpokaneStBridge,11/10/2014 04:00:00 AM,48,-122,5,1,6
7517,SpokaneStBridge,11/10/2014 05:00:00 AM,48,-122,14,5,19
7518,SpokaneStBridge,11/10/2014 06:00:00 AM,48,-122,29,9,38
7519,SpokaneStBridge,11/10/2014 07:00:00 AM,48,-122,111,9,120
7520,SpokaneStBridge,11/10/2014 08:00:00 AM,48,-122,82,6,88
7521,SpokaneStBridge,11/10/2014 09:00:00 AM,48,-122,38,4,42
7522,SpokaneStBridge,11/10/2014 10:00:00 AM,48,-122,19,1,20
7523,SpokaneStBridge,11/10/2014 11:00:00 AM,48,-122,9,6,15
7524,SpokaneStBridge,11/10/2014 12:00:00 PM,48,-122,16,12,28
7525,SpokaneStBridge,11/10/2014 01:00:00 PM,48,-122,11,12,23
7526,SpokaneStBridge,11/10/2014 02:00:00 PM,48,-122,13,23,36
7527,SpokaneStBridge,11/10/2014 03:00:00 PM,48,-122,17,24,41
7528,SpokaneStBridge,11/10/2014 04:00:00 PM,48,-122,19,67,86
7529,SpokaneStBridge,11/10/2014 05:00:00 PM,48,-122,26,99,125
7530,SpokaneStBridge,11/10/2014 06:00:00 PM,48,-122,6,68,74
7531,SpokaneStBridge,11/10/2014 07:00:00 PM,48,-122,6,21,27
7532,SpokaneStBridge,11/10/2014 08:00:00 PM,48,-122,2,7,9
7533,SpokaneStBridge,11/10/2014 09:00:00 PM,48,-122,3,4,7
7534,SpokaneStBridge,11/10/2014 10:00:00 PM,48,-122,4,12,16
7535,SpokaneStBridge,11/10/2014 11:00:00 PM,48,-122,0,3,3
7536,SpokaneStBridge,11/11/2014 12:00:00 AM,48,-122,0,2,2
7537,SpokaneStBridge,11/11/2014 01:00:00 AM,48,-122,0,1,1
7538,SpokaneStBridge,11/11/2014 02:00:00 AM,48,-122,0,2,2
7539,SpokaneStBridge,11/11/2014 03:00:00 AM,48,-122,0,0,0
7540,SpokaneStBridge,11/11/2014 04:00:00 AM,48,-122,1,2,3
7541,SpokaneStBridge,11/11/2014 05:00:00 AM,48,-122,9,4,13
7542,SpokaneStBridge,11/11/2014 06:00:00 AM,48,-122,32,7,39
7543,SpokaneStBridge,11/11/2014 07:00:00 AM,48,-122,82,5,87
7544,SpokaneStBridge,11/11/2014 08:00:00 AM,48,-122,68,10,78
7545,SpokaneStBridge,11/11/2014 09:00:00 AM,48,-122,35,8,43
7546,SpokaneStBridge,11/11/2014 10:00:00 AM,48,-122,20,7,27
7547,SpokaneStBridge,11/11/2014 11:00:00 AM,48,-122,16,7,23
7548,SpokaneStBridge,11/11/2014 12:00:00 PM,48,-122,10,13,23
7549,SpokaneStBridge,11/11/2014 01:00:00 PM,48,-122,18,11,29
7550,SpokaneStBridge,11/11/2014 02:00:00 PM,48,-122,15,19,34
7551,SpokaneStBridge,11/11/2014 03:00:00 PM,48,-122,11,27,38
7552,SpokaneStBridge,11/11/2014 04:00:00 PM,48,-122,22,50,72
7553,SpokaneStBridge,11/11/2014 05:00:00 PM,48,-122,12,76,88
7554,SpokaneStBridge,11/11/2014 06:00:00 PM,48,-122,10,45,55
7555,SpokaneStBridge,11/11/2014 07:00:00 PM,48,-122,4,23,27
7556,SpokaneStBridge,11/11/2014 08:00:00 PM,48,-122,2,7,9
7557,SpokaneStBridge,11/11/2014 09:00:00 PM,48,-122,0,4,4
7558,SpokaneStBridge,11/11/2014 10:00:00 PM,48,-122,0,2,2
7559,SpokaneStBridge,11/11/2014 11:00:00 PM,48,-122,0,1,1
7560,SpokaneStBridge,11/12/2014 12:00:00 AM,48,-122,0,0,0
7561,SpokaneStBridge,11/12/2014 01:00:00 AM,48,-122,0,2,2
7562,SpokaneStBridge,11/12/2014 02:00:00 AM,48,-122,0,1,1
7563,SpokaneStBridge,11/12/2014 03:00:00 AM,48,-122,0,0,0
7564,SpokaneStBridge,11/12/2014 04:00:00 AM,48,-122,7,2,9
7565,SpokaneStBridge,11/12/2014 05:00:00 AM,48,-122,19,6,25
7566,SpokaneStBridge,11/12/2014 06:00:00 AM,48,-122,41,4,45
7567,SpokaneStBridge,11/12/2014 07:00:00 AM,48,-122,72,12,84
7568,SpokaneStBridge,11/12/2014 08:00:00 AM,48,-122,80,7,87
7569,SpokaneStBridge,11/12/2014 09:00:00 AM,48,-122,34,9,43
7570,SpokaneStBridge,11/12/2014 10:00:00 AM,48,-122,13,11,24
7571,SpokaneStBridge,11/12/2014 11:00:00 AM,48,-122,8,5,13
7572,SpokaneStBridge,11/12/2014 12:00:00 PM,48,-122,7,4,11
7573,SpokaneStBridge,11/12/2014 01:00:00 PM,48,-122,7,7,14
7574,SpokaneStBridge,11/12/2014 02:00:00 PM,48,-122,8,16,24
7575,SpokaneStBridge,11/12/2014 03:00:00 PM,48,-122,10,28,38
7576,SpokaneStBridge,11/12/2014 04:00:00 PM,48,-122,13,47,60
7577,SpokaneStBridge,11/12/2014 05:00:00 PM,48,-122,14,79,93
7578,SpokaneStBridge,11/12/2014 06:00:00 PM,48,-122,11,51,62
7579,SpokaneStBridge,11/12/2014 07:00:00 PM,48,-122,5,16,21
7580,SpokaneStBridge,11/12/2014 08:00:00 PM,48,-122,4,11,15
7581,SpokaneStBridge,11/12/2014 09:00:00 PM,48,-122,2,10,12
7582,SpokaneStBridge,11/12/2014 10:00:00 PM,48,-122,1,3,4
7583,SpokaneStBridge,11/12/2014 11:00:00 PM,48,-122,1,1,2
7584,SpokaneStBridge,11/13/2014 12:00:00 AM,48,-122,0,1,1
7585,SpokaneStBridge,11/13/2014 01:00:00 AM,48,-122,0,1,1
7586,SpokaneStBridge,11/13/2014 02:00:00 AM,48,-122,2,0,2
7587,SpokaneStBridge,11/13/2014 03:00:00 AM,48,-122,0,0,0
7588,SpokaneStBridge,11/13/2014 04:00:00 AM,48,-122,5,1,6
7589,SpokaneStBridge,11/13/2014 05:00:00 AM,48,-122,16,4,20
7590,SpokaneStBridge,11/13/2014 06:00:00 AM,48,-122,44,3,47
7591,SpokaneStBridge,11/13/2014 07:00:00 AM,48,-122,70,17,87
7592,SpokaneStBridge,11/13/2014 08:00:00 AM,48,-122,66,6,72
7593,SpokaneStBridge,11/13/2014 09:00:00 AM,48,-122,32,0,32
7594,SpokaneStBridge,11/13/2014 10:00:00 AM,48,-122,16,0,16
7595,SpokaneStBridge,11/13/2014 11:00:00 AM,48,-122,10,6,16
7596,SpokaneStBridge,11/13/2014 12:00:00 PM,48,-122,8,5,13
7597,SpokaneStBridge,11/13/2014 01:00:00 PM,48,-122,6,10,16
7598,SpokaneStBridge,11/13/2014 02:00:00 PM,48,-122,7,18,25
7599,SpokaneStBridge,11/13/2014 03:00:00 PM,48,-122,9,23,32
7600,SpokaneStBridge,11/13/2014 04:00:00 PM,48,-122,10,41,51
7601,SpokaneStBridge,11/13/2014 05:00:00 PM,48,-122,11,84,95
7602,SpokaneStBridge,11/13/2014 06:00:00 PM,48,-122,8,55,63
7603,SpokaneStBridge,11/13/2014 07:00:00 PM,48,-122,7,15,22
7604,SpokaneStBridge,11/13/2014 08:00:00 PM,48,-122,2,7,9
7605,SpokaneStBridge,11/13/2014 09:00:00 PM,48,-122,2,6,8
7606,SpokaneStBridge,11/13/2014 10:00:00 PM,48,-122,3,4,7
7607,SpokaneStBridge,11/13/2014 11:00:00 PM,48,-122,1,1,2
7608,SpokaneStBridge,11/14/2014 12:00:00 AM,48,-122,0,1,1
7609,SpokaneStBridge,11/14/2014 01:00:00 AM,48,-122,0,0,0
7610,SpokaneStBridge,11/14/2014 02:00:00 AM,48,-122,0,1,1
7611,SpokaneStBridge,11/14/2014 03:00:00 AM,48,-122,1,0,1
7612,SpokaneStBridge,11/14/2014 04:00:00 AM,48,-122,2,0,2
7613,SpokaneStBridge,11/14/2014 05:00:00 AM,48,-122,12,4,16
7614,SpokaneStBridge,11/14/2014 06:00:00 AM,48,-122,25,6,31
7615,SpokaneStBridge,11/14/2014 07:00:00 AM,48,-122,71,9,80
7616,SpokaneStBridge,11/14/2014 08:00:00 AM,48,-122,56,3,59
7617,SpokaneStBridge,11/14/2014 09:00:00 AM,48,-122,26,2,28
7618,SpokaneStBridge,11/14/2014 10:00:00 AM,48,-122,10,1,11
7619,SpokaneStBridge,11/14/2014 11:00:00 AM,48,-122,3,7,10
7620,SpokaneStBridge,11/14/2014 12:00:00 PM,48,-122,13,9,22
7621,SpokaneStBridge,11/14/2014 01:00:00 PM,48,-122,9,12,21
7622,SpokaneStBridge,11/14/2014 02:00:00 PM,48,-122,14,14,28
7623,SpokaneStBridge,11/14/2014 03:00:00 PM,48,-122,10,22,32
7624,SpokaneStBridge,11/14/2014 04:00:00 PM,48,-122,20,45,65
7625,SpokaneStBridge,11/14/2014 05:00:00 PM,48,-122,9,59,68
7626,SpokaneStBridge,11/14/2014 06:00:00 PM,48,-122,4,34,38
7627,SpokaneStBridge,11/14/2014 07:00:00 PM,48,-122,4,13,17
7628,SpokaneStBridge,11/14/2014 08:00:00 PM,48,-122,1,4,5
7629,SpokaneStBridge,11/14/2014 09:00:00 PM,48,-122,2,4,6
7630,SpokaneStBridge,11/14/2014 10:00:00 PM,48,-122,1,4,5
7631,SpokaneStBridge,11/14/2014 11:00:00 PM,48,-122,5,4,9
7632,SpokaneStBridge,11/15/2014 12:00:00 AM,48,-122,0,0,0
7633,SpokaneStBridge,11/15/2014 01:00:00 AM,48,-122,0,1,1
7634,SpokaneStBridge,11/15/2014 02:00:00 AM,48,-122,0,0,0
7635,SpokaneStBridge,11/15/2014 03:00:00 AM,48,-122,1,2,3
7636,SpokaneStBridge,11/15/2014 04:00:00 AM,48,-122,0,1,1
7637,SpokaneStBridge,11/15/2014 05:00:00 AM,48,-122,5,0,5
7638,SpokaneStBridge,11/15/2014 06:00:00 AM,48,-122,5,2,7
7639,SpokaneStBridge,11/15/2014 07:00:00 AM,48,-122,3,0,3
7640,SpokaneStBridge,11/15/2014 08:00:00 AM,48,-122,11,2,13
7641,SpokaneStBridge,11/15/2014 09:00:00 AM,48,-122,17,10,27
7642,SpokaneStBridge,11/15/2014 10:00:00 AM,48,-122,12,15,27
7643,SpokaneStBridge,11/15/2014 11:00:00 AM,48,-122,24,13,37
7644,SpokaneStBridge,11/15/2014 12:00:00 PM,48,-122,25,24,49
7645,SpokaneStBridge,11/15/2014 01:00:00 PM,48,-122,14,19,33
7646,SpokaneStBridge,11/15/2014 02:00:00 PM,48,-122,14,22,36
7647,SpokaneStBridge,11/15/2014 03:00:00 PM,48,-122,5,22,27
7648,SpokaneStBridge,11/15/2014 04:00:00 PM,48,-122,10,14,24
7649,SpokaneStBridge,11/15/2014 05:00:00 PM,48,-122,11,5,16
7650,SpokaneStBridge,11/15/2014 06:00:00 PM,48,-122,7,11,18
7651,SpokaneStBridge,11/15/2014 07:00:00 PM,48,-122,2,2,4
7652,SpokaneStBridge,11/15/2014 08:00:00 PM,48,-122,0,1,1
7653,SpokaneStBridge,11/15/2014 09:00:00 PM,48,-122,0,4,4
7654,SpokaneStBridge,11/15/2014 10:00:00 PM,48,-122,0,2,2
7655,SpokaneStBridge,11/15/2014 11:00:00 PM,48,-122,1,0,1
7656,SpokaneStBridge,11/16/2014 12:00:00 AM,48,-122,4,0,4
7657,SpokaneStBridge,11/16/2014 01:00:00 AM,48,-122,0,1,1
7658,SpokaneStBridge,11/16/2014 02:00:00 AM,48,-122,2,1,3
7659,SpokaneStBridge,11/16/2014 03:00:00 AM,48,-122,1,1,2
7660,SpokaneStBridge,11/16/2014 04:00:00 AM,48,-122,0,1,1
7661,SpokaneStBridge,11/16/2014 05:00:00 AM,48,-122,3,0,3
7662,SpokaneStBridge,11/16/2014 06:00:00 AM,48,-122,2,1,3
7663,SpokaneStBridge,11/16/2014 07:00:00 AM,48,-122,4,4,8
7664,SpokaneStBridge,11/16/2014 08:00:00 AM,48,-122,5,4,9
7665,SpokaneStBridge,11/16/2014 09:00:00 AM,48,-122,8,8,16
7666,SpokaneStBridge,11/16/2014 10:00:00 AM,48,-122,15,3,18
7667,SpokaneStBridge,11/16/2014 11:00:00 AM,48,-122,12,10,22
7668,SpokaneStBridge,11/16/2014 12:00:00 PM,48,-122,6,14,20
7669,SpokaneStBridge,11/16/2014 01:00:00 PM,48,-122,14,16,30
7670,SpokaneStBridge,11/16/2014 02:00:00 PM,48,-122,17,31,48
7671,SpokaneStBridge,11/16/2014 03:00:00 PM,48,-122,24,16,40
7672,SpokaneStBridge,11/16/2014 04:00:00 PM,48,-122,9,9,18
7673,SpokaneStBridge,11/16/2014 05:00:00 PM,48,-122,8,7,15
7674,SpokaneStBridge,11/16/2014 06:00:00 PM,48,-122,0,5,5
7675,SpokaneStBridge,11/16/2014 07:00:00 PM,48,-122,2,2,4
7676,SpokaneStBridge,11/16/2014 08:00:00 PM,48,-122,1,1,2
7677,SpokaneStBridge,11/16/2014 09:00:00 PM,48,-122,1,2,3
7678,SpokaneStBridge,11/16/2014 10:00:00 PM,48,-122,1,2,3
7679,SpokaneStBridge,11/16/2014 11:00:00 PM,48,-122,1,1,2
7680,SpokaneStBridge,11/17/2014 12:00:00 AM,48,-122,0,1,1
7681,SpokaneStBridge,11/17/2014 01:00:00 AM,48,-122,0,0,0
7682,SpokaneStBridge,11/17/2014 02:00:00 AM,48,-122,0,0,0
7683,SpokaneStBridge,11/17/2014 03:00:00 AM,48,-122,1,1,2
7684,SpokaneStBridge,11/17/2014 04:00:00 AM,48,-122,2,2,4
7685,SpokaneStBridge,11/17/2014 05:00:00 AM,48,-122,19,4,23
7686,SpokaneStBridge,11/17/2014 06:00:00 AM,48,-122,48,12,60
7687,SpokaneStBridge,11/17/2014 07:00:00 AM,48,-122,91,10,101
7688,SpokaneStBridge,11/17/2014 08:00:00 AM,48,-122,90,8,98
7689,SpokaneStBridge,11/17/2014 09:00:00 AM,48,-122,33,2,35
7690,SpokaneStBridge,11/17/2014 10:00:00 AM,48,-122,12,4,16
7691,SpokaneStBridge,11/17/2014 11:00:00 AM,48,-122,4,4,8
7692,SpokaneStBridge,11/17/2014 12:00:00 PM,48,-122,6,5,11
7693,SpokaneStBridge,11/17/2014 01:00:00 PM,48,-122,12,7,19
7694,SpokaneStBridge,11/17/2014 02:00:00 PM,48,-122,12,19,31
7695,SpokaneStBridge,11/17/2014 03:00:00 PM,48,-122,10,27,37
7696,SpokaneStBridge,11/17/2014 04:00:00 PM,48,-122,12,68,80
7697,SpokaneStBridge,11/17/2014 05:00:00 PM,48,-122,14,102,116
7698,SpokaneStBridge,11/17/2014 06:00:00 PM,48,-122,2,57,59
7699,SpokaneStBridge,11/17/2014 07:00:00 PM,48,-122,3,21,24
7700,SpokaneStBridge,11/17/2014 08:00:00 PM,48,-122,5,9,14
7701,SpokaneStBridge,11/17/2014 09:00:00 PM,48,-122,1,1,2
7702,SpokaneStBridge,11/17/2014 10:00:00 PM,48,-122,2,3,5
7703,SpokaneStBridge,11/17/2014 11:00:00 PM,48,-122,1,1,2
7704,SpokaneStBridge,11/18/2014 12:00:00 AM,48,-122,0,3,3
7705,SpokaneStBridge,11/18/2014 01:00:00 AM,48,-122,1,1,2
7706,SpokaneStBridge,11/18/2014 02:00:00 AM,48,-122,2,1,3
7707,SpokaneStBridge,11/18/2014 03:00:00 AM,48,-122,0,0,0
7708,SpokaneStBridge,11/18/2014 04:00:00 AM,48,-122,0,0,0
7709,SpokaneStBridge,11/18/2014 05:00:00 AM,48,-122,16,3,19
7710,SpokaneStBridge,11/18/2014 06:00:00 AM,48,-122,46,6,52
7711,SpokaneStBridge,11/18/2014 07:00:00 AM,48,-122,86,16,102
7712,SpokaneStBridge,11/18/2014 08:00:00 AM,48,-122,85,9,94
7713,SpokaneStBridge,11/18/2014 09:00:00 AM,48,-122,37,6,43
7714,SpokaneStBridge,11/18/2014 10:00:00 AM,48,-122,12,7,19
7715,SpokaneStBridge,11/18/2014 11:00:00 AM,48,-122,5,6,11
7716,SpokaneStBridge,11/18/2014 12:00:00 PM,48,-122,14,6,20
7717,SpokaneStBridge,11/18/2014 01:00:00 PM,48,-122,10,6,16
7718,SpokaneStBridge,11/18/2014 02:00:00 PM,48,-122,6,15,21
7719,SpokaneStBridge,11/18/2014 03:00:00 PM,48,-122,6,27,33
7720,SpokaneStBridge,11/18/2014 04:00:00 PM,48,-122,15,52,67
7721,SpokaneStBridge,11/18/2014 05:00:00 PM,48,-122,13,89,102
7722,SpokaneStBridge,11/18/2014 06:00:00 PM,48,-122,9,59,68
7723,SpokaneStBridge,11/18/2014 07:00:00 PM,48,-122,2,22,24
7724,SpokaneStBridge,11/18/2014 08:00:00 PM,48,-122,6,12,18
7725,SpokaneStBridge,11/18/2014 09:00:00 PM,48,-122,2,5,7
7726,SpokaneStBridge,11/18/2014 10:00:00 PM,48,-122,0,3,3
7727,SpokaneStBridge,11/18/2014 11:00:00 PM,48,-122,3,0,3
7728,SpokaneStBridge,11/19/2014 12:00:00 AM,48,-122,0,1,1
7729,SpokaneStBridge,11/19/2014 01:00:00 AM,48,-122,0,1,1
7730,SpokaneStBridge,11/19/2014 02:00:00 AM,48,-122,4,1,5
7731,SpokaneStBridge,11/19/2014 03:00:00 AM,48,-122,0,1,1
7732,SpokaneStBridge,11/19/2014 04:00:00 AM,48,-122,2,1,3
7733,SpokaneStBridge,11/19/2014 05:00:00 AM,48,-122,17,3,20
7734,SpokaneStBridge,11/19/2014 06:00:00 AM,48,-122,47,8,55
7735,SpokaneStBridge,11/19/2014 07:00:00 AM,48,-122,97,12,109
7736,SpokaneStBridge,11/19/2014 08:00:00 AM,48,-122,81,8,89
7737,SpokaneStBridge,11/19/2014 09:00:00 AM,48,-122,28,6,34
7738,SpokaneStBridge,11/19/2014 10:00:00 AM,48,-122,12,5,17
7739,SpokaneStBridge,11/19/2014 11:00:00 AM,48,-122,16,8,24
7740,SpokaneStBridge,11/19/2014 12:00:00 PM,48,-122,11,6,17
7741,SpokaneStBridge,11/19/2014 01:00:00 PM,48,-122,10,11,21
7742,SpokaneStBridge,11/19/2014 02:00:00 PM,48,-122,11,16,27
7743,SpokaneStBridge,11/19/2014 03:00:00 PM,48,-122,8,32,40
7744,SpokaneStBridge,11/19/2014 04:00:00 PM,48,-122,13,52,65
7745,SpokaneStBridge,11/19/2014 05:00:00 PM,48,-122,12,88,100
7746,SpokaneStBridge,11/19/2014 06:00:00 PM,48,-122,9,65,74
7747,SpokaneStBridge,11/19/2014 07:00:00 PM,48,-122,4,16,20
7748,SpokaneStBridge,11/19/2014 08:00:00 PM,48,-122,4,8,12
7749,SpokaneStBridge,11/19/2014 09:00:00 PM,48,-122,4,16,20
7750,SpokaneStBridge,11/19/2014 10:00:00 PM,48,-122,2,3,5
7751,SpokaneStBridge,11/19/2014 11:00:00 PM,48,-122,4,4,8
7752,SpokaneStBridge,11/20/2014 12:00:00 AM,48,-122,0,1,1
7753,SpokaneStBridge,11/20/2014 01:00:00 AM,48,-122,0,0,0
7754,SpokaneStBridge,11/20/2014 02:00:00 AM,48,-122,0,0,0
7755,SpokaneStBridge,11/20/2014 03:00:00 AM,48,-122,3,1,4
7756,SpokaneStBridge,11/20/2014 04:00:00 AM,48,-122,1,0,1
7757,SpokaneStBridge,11/20/2014 05:00:00 AM,48,-122,15,5,20
7758,SpokaneStBridge,11/20/2014 06:00:00 AM,48,-122,44,6,50
7759,SpokaneStBridge,11/20/2014 07:00:00 AM,48,-122,91,11,102
7760,SpokaneStBridge,11/20/2014 08:00:00 AM,48,-122,72,3,75
7761,SpokaneStBridge,11/20/2014 09:00:00 AM,48,-122,36,14,50
7762,SpokaneStBridge,11/20/2014 10:00:00 AM,48,-122,11,2,13
7763,SpokaneStBridge,11/20/2014 11:00:00 AM,48,-122,8,7,15
7764,SpokaneStBridge,11/20/2014 12:00:00 PM,48,-122,6,3,9
7765,SpokaneStBridge,11/20/2014 01:00:00 PM,48,-122,8,8,16
7766,SpokaneStBridge,11/20/2014 02:00:00 PM,48,-122,8,10,18
7767,SpokaneStBridge,11/20/2014 03:00:00 PM,48,-122,7,23,30
7768,SpokaneStBridge,11/20/2014 04:00:00 PM,48,-122,7,45,52
7769,SpokaneStBridge,11/20/2014 05:00:00 PM,48,-122,12,89,101
7770,SpokaneStBridge,11/20/2014 06:00:00 PM,48,-122,12,55,67
7771,SpokaneStBridge,11/20/2014 07:00:00 PM,48,-122,4,19,23
7772,SpokaneStBridge,11/20/2014 08:00:00 PM,48,-122,3,13,16
7773,SpokaneStBridge,11/20/2014 09:00:00 PM,48,-122,3,9,12
7774,SpokaneStBridge,11/20/2014 10:00:00 PM,48,-122,1,5,6
7775,SpokaneStBridge,11/20/2014 11:00:00 PM,48,-122,4,10,14
7776,SpokaneStBridge,11/21/2014 12:00:00 AM,48,-122,0,0,0
7777,SpokaneStBridge,11/21/2014 01:00:00 AM,48,-122,7,1,8
7778,SpokaneStBridge,11/21/2014 02:00:00 AM,48,-122,1,1,2
7779,SpokaneStBridge,11/21/2014 03:00:00 AM,48,-122,3,1,4
7780,SpokaneStBridge,11/21/2014 04:00:00 AM,48,-122,0,0,0
7781,SpokaneStBridge,11/21/2014 05:00:00 AM,48,-122,16,2,18
7782,SpokaneStBridge,11/21/2014 06:00:00 AM,48,-122,24,6,30
7783,SpokaneStBridge,11/21/2014 07:00:00 AM,48,-122,56,6,62
7784,SpokaneStBridge,11/21/2014 08:00:00 AM,48,-122,58,11,69
7785,SpokaneStBridge,11/21/2014 09:00:00 AM,48,-122,26,3,29
7786,SpokaneStBridge,11/21/2014 10:00:00 AM,48,-122,7,1,8
7787,SpokaneStBridge,11/21/2014 11:00:00 AM,48,-122,4,1,5
7788,SpokaneStBridge,11/21/2014 12:00:00 PM,48,-122,2,2,4
7789,SpokaneStBridge,11/21/2014 01:00:00 PM,48,-122,5,6,11
7790,SpokaneStBridge,11/21/2014 02:00:00 PM,48,-122,2,3,5
7791,SpokaneStBridge,11/21/2014 03:00:00 PM,48,-122,4,15,19
7792,SpokaneStBridge,11/21/2014 04:00:00 PM,48,-122,9,28,37
7793,SpokaneStBridge,11/21/2014 05:00:00 PM,48,-122,8,43,51
7794,SpokaneStBridge,11/21/2014 06:00:00 PM,48,-122,1,35,36
7795,SpokaneStBridge,11/21/2014 07:00:00 PM,48,-122,5,10,15
7796,SpokaneStBridge,11/21/2014 08:00:00 PM,48,-122,2,11,13
7797,SpokaneStBridge,11/21/2014 09:00:00 PM,48,-122,3,2,5
7798,SpokaneStBridge,11/21/2014 10:00:00 PM,48,-122,1,0,1
7799,SpokaneStBridge,11/21/2014 11:00:00 PM,48,-122,1,3,4
7800,SpokaneStBridge,11/22/2014 12:00:00 AM,48,-122,0,1,1
7801,SpokaneStBridge,11/22/2014 01:00:00 AM,48,-122,1,1,2
7802,SpokaneStBridge,11/22/2014 02:00:00 AM,48,-122,1,1,2
7803,SpokaneStBridge,11/22/2014 03:00:00 AM,48,-122,0,0,0
7804,SpokaneStBridge,11/22/2014 04:00:00 AM,48,-122,0,1,1
7805,SpokaneStBridge,11/22/2014 05:00:00 AM,48,-122,6,0,6
7806,SpokaneStBridge,11/22/2014 06:00:00 AM,48,-122,3,1,4
7807,SpokaneStBridge,11/22/2014 07:00:00 AM,48,-122,5,0,5
7808,SpokaneStBridge,11/22/2014 08:00:00 AM,48,-122,5,5,10
7809,SpokaneStBridge,11/22/2014 09:00:00 AM,48,-122,11,4,15
7810,SpokaneStBridge,11/22/2014 10:00:00 AM,48,-122,7,2,9
7811,SpokaneStBridge,11/22/2014 11:00:00 AM,48,-122,8,10,18
7812,SpokaneStBridge,11/22/2014 12:00:00 PM,48,-122,8,11,19
7813,SpokaneStBridge,11/22/2014 01:00:00 PM,48,-122,6,6,12
7814,SpokaneStBridge,11/22/2014 02:00:00 PM,48,-122,18,18,36
7815,SpokaneStBridge,11/22/2014 03:00:00 PM,48,-122,9,17,26
7816,SpokaneStBridge,11/22/2014 04:00:00 PM,48,-122,10,15,25
7817,SpokaneStBridge,11/22/2014 05:00:00 PM,48,-122,5,10,15
7818,SpokaneStBridge,11/22/2014 06:00:00 PM,48,-122,3,4,7
7819,SpokaneStBridge,11/22/2014 07:00:00 PM,48,-122,3,2,5
7820,SpokaneStBridge,11/22/2014 08:00:00 PM,48,-122,2,1,3
7821,SpokaneStBridge,11/22/2014 09:00:00 PM,48,-122,4,1,5
7822,SpokaneStBridge,11/22/2014 10:00:00 PM,48,-122,1,2,3
7823,SpokaneStBridge,11/22/2014 11:00:00 PM,48,-122,2,0,2
7824,SpokaneStBridge,11/23/2014 12:00:00 AM,48,-122,0,5,5
7825,SpokaneStBridge,11/23/2014 01:00:00 AM,48,-122,0,0,0
7826,SpokaneStBridge,11/23/2014 02:00:00 AM,48,-122,0,2,2
7827,SpokaneStBridge,11/23/2014 03:00:00 AM,48,-122,1,0,1
7828,SpokaneStBridge,11/23/2014 04:00:00 AM,48,-122,0,2,2
7829,SpokaneStBridge,11/23/2014 05:00:00 AM,48,-122,7,1,8
7830,SpokaneStBridge,11/23/2014 06:00:00 AM,48,-122,1,2,3
7831,SpokaneStBridge,11/23/2014 07:00:00 AM,48,-122,0,1,1
7832,SpokaneStBridge,11/23/2014 08:00:00 AM,48,-122,3,1,4
7833,SpokaneStBridge,11/23/2014 09:00:00 AM,48,-122,4,2,6
7834,SpokaneStBridge,11/23/2014 10:00:00 AM,48,-122,3,2,5
7835,SpokaneStBridge,11/23/2014 11:00:00 AM,48,-122,9,4,13
7836,SpokaneStBridge,11/23/2014 12:00:00 PM,48,-122,15,8,23
7837,SpokaneStBridge,11/23/2014 01:00:00 PM,48,-122,8,10,18
7838,SpokaneStBridge,11/23/2014 02:00:00 PM,48,-122,12,20,32
7839,SpokaneStBridge,11/23/2014 03:00:00 PM,48,-122,16,14,30
7840,SpokaneStBridge,11/23/2014 04:00:00 PM,48,-122,14,18,32
7841,SpokaneStBridge,11/23/2014 05:00:00 PM,48,-122,13,11,24
7842,SpokaneStBridge,11/23/2014 06:00:00 PM,48,-122,3,4,7
7843,SpokaneStBridge,11/23/2014 07:00:00 PM,48,-122,2,4,6
7844,SpokaneStBridge,11/23/2014 08:00:00 PM,48,-122,1,1,2
7845,SpokaneStBridge,11/23/2014 09:00:00 PM,48,-122,1,1,2
7846,SpokaneStBridge,11/23/2014 10:00:00 PM,48,-122,0,2,2
7847,SpokaneStBridge,11/23/2014 11:00:00 PM,48,-122,2,0,2
7848,SpokaneStBridge,11/24/2014 12:00:00 AM,48,-122,1,1,2
7849,SpokaneStBridge,11/24/2014 01:00:00 AM,48,-122,0,0,0
7850,SpokaneStBridge,11/24/2014 02:00:00 AM,48,-122,1,0,1
7851,SpokaneStBridge,11/24/2014 03:00:00 AM,48,-122,1,0,1
7852,SpokaneStBridge,11/24/2014 04:00:00 AM,48,-122,4,0,4
7853,SpokaneStBridge,11/24/2014 05:00:00 AM,48,-122,16,4,20
7854,SpokaneStBridge,11/24/2014 06:00:00 AM,48,-122,40,6,46
7855,SpokaneStBridge,11/24/2014 07:00:00 AM,48,-122,95,13,108
7856,SpokaneStBridge,11/24/2014 08:00:00 AM,48,-122,70,6,76
7857,SpokaneStBridge,11/24/2014 09:00:00 AM,48,-122,39,7,46
7858,SpokaneStBridge,11/24/2014 10:00:00 AM,48,-122,11,0,11
7859,SpokaneStBridge,11/24/2014 11:00:00 AM,48,-122,9,4,13
7860,SpokaneStBridge,11/24/2014 12:00:00 PM,48,-122,3,9,12
7861,SpokaneStBridge,11/24/2014 01:00:00 PM,48,-122,9,4,13
7862,SpokaneStBridge,11/24/2014 02:00:00 PM,48,-122,11,12,23
7863,SpokaneStBridge,11/24/2014 03:00:00 PM,48,-122,5,24,29
7864,SpokaneStBridge,11/24/2014 04:00:00 PM,48,-122,9,45,54
7865,SpokaneStBridge,11/24/2014 05:00:00 PM,48,-122,13,82,95
7866,SpokaneStBridge,11/24/2014 06:00:00 PM,48,-122,4,58,62
7867,SpokaneStBridge,11/24/2014 07:00:00 PM,48,-122,3,14,17
7868,SpokaneStBridge,11/24/2014 08:00:00 PM,48,-122,4,5,9
7869,SpokaneStBridge,11/24/2014 09:00:00 PM,48,-122,1,5,6
7870,SpokaneStBridge,11/24/2014 10:00:00 PM,48,-122,1,1,2
7871,SpokaneStBridge,11/24/2014 11:00:00 PM,48,-122,2,4,6
7872,SpokaneStBridge,11/25/2014 12:00:00 AM,48,-122,0,1,1
7873,SpokaneStBridge,11/25/2014 01:00:00 AM,48,-122,1,1,2
7874,SpokaneStBridge,11/25/2014 02:00:00 AM,48,-122,0,0,0
7875,SpokaneStBridge,11/25/2014 03:00:00 AM,48,-122,3,2,5
7876,SpokaneStBridge,11/25/2014 04:00:00 AM,48,-122,1,0,1
7877,SpokaneStBridge,11/25/2014 05:00:00 AM,48,-122,10,2,12
7878,SpokaneStBridge,11/25/2014 06:00:00 AM,48,-122,25,3,28
7879,SpokaneStBridge,11/25/2014 07:00:00 AM,48,-122,72,5,77
7880,SpokaneStBridge,11/25/2014 08:00:00 AM,48,-122,61,3,64
7881,SpokaneStBridge,11/25/2014 09:00:00 AM,48,-122,32,1,33
7882,SpokaneStBridge,11/25/2014 10:00:00 AM,48,-122,13,2,15
7883,SpokaneStBridge,11/25/2014 11:00:00 AM,48,-122,6,3,9
7884,SpokaneStBridge,11/25/2014 12:00:00 PM,48,-122,3,3,6
7885,SpokaneStBridge,11/25/2014 01:00:00 PM,48,-122,6,4,10
7886,SpokaneStBridge,11/25/2014 02:00:00 PM,48,-122,5,8,13
7887,SpokaneStBridge,11/25/2014 03:00:00 PM,48,-122,8,15,23
7888,SpokaneStBridge,11/25/2014 04:00:00 PM,48,-122,4,32,36
7889,SpokaneStBridge,11/25/2014 05:00:00 PM,48,-122,13,75,88
7890,SpokaneStBridge,11/25/2014 06:00:00 PM,48,-122,5,37,42
7891,SpokaneStBridge,11/25/2014 07:00:00 PM,48,-122,1,18,19
7892,SpokaneStBridge,11/25/2014 08:00:00 PM,48,-122,2,3,5
7893,SpokaneStBridge,11/25/2014 09:00:00 PM,48,-122,1,7,8
7894,SpokaneStBridge,11/25/2014 10:00:00 PM,48,-122,1,2,3
7895,SpokaneStBridge,11/25/2014 11:00:00 PM,48,-122,0,2,2
7896,SpokaneStBridge,11/26/2014 12:00:00 AM,48,-122,1,1,2
7897,SpokaneStBridge,11/26/2014 01:00:00 AM,48,-122,0,0,0
7898,SpokaneStBridge,11/26/2014 02:00:00 AM,48,-122,0,0,0
7899,SpokaneStBridge,11/26/2014 03:00:00 AM,48,-122,0,0,0
7900,SpokaneStBridge,11/26/2014 04:00:00 AM,48,-122,2,0,2
7901,SpokaneStBridge,11/26/2014 05:00:00 AM,48,-122,19,4,22
7902,SpokaneStBridge,11/26/2014 06:00:00 AM,48,-122,43,5,50
7903,SpokaneStBridge,11/26/2014 07:00:00 AM,48,-122,86,13,100
7904,SpokaneStBridge,11/26/2014 08:00:00 AM,48,-122,100,10,110
7905,SpokaneStBridge,11/26/2014 09:00:00 AM,48,-122,40,5,45
7906,SpokaneStBridge,11/26/2014 10:00:00 AM,48,-122,16,7,22
7907,SpokaneStBridge,11/26/2014 11:00:00 AM,48,-122,12,7,17
7908,SpokaneStBridge,11/26/2014 12:00:00 PM,48,-122,11,12,24
7909,SpokaneStBridge,11/26/2014 01:00:00 PM,48,-122,14,9,22
7910,SpokaneStBridge,11/26/2014 02:00:00 PM,48,-122,11,16,28
7911,SpokaneStBridge,11/26/2014 03:00:00 PM,48,-122,12,30,42
7912,SpokaneStBridge,11/26/2014 04:00:00 PM,48,-122,16,56,71
7913,SpokaneStBridge,11/26/2014 05:00:00 PM,48,-122,18,95,111
7914,SpokaneStBridge,11/26/2014 06:00:00 PM,48,-122,10,61,71
7915,SpokaneStBridge,11/26/2014 07:00:00 PM,48,-122,3,17,21
7916,SpokaneStBridge,11/26/2014 08:00:00 PM,48,-122,5,12,16
7917,SpokaneStBridge,11/26/2014 09:00:00 PM,48,-122,4,12,14
7918,SpokaneStBridge,11/26/2014 10:00:00 PM,48,-122,2,6,7
7919,SpokaneStBridge,11/26/2014 11:00:00 PM,48,-122,2,4,5
7920,SpokaneStBridge,11/27/2014 12:00:00 AM,48,-122,0,1,1
7921,SpokaneStBridge,11/27/2014 01:00:00 AM,48,-122,1,0,1
7922,SpokaneStBridge,11/27/2014 02:00:00 AM,48,-122,1,1,2
7923,SpokaneStBridge,11/27/2014 03:00:00 AM,48,-122,2,0,2
7924,SpokaneStBridge,11/27/2014 04:00:00 AM,48,-122,0,1,1
7925,SpokaneStBridge,11/27/2014 05:00:00 AM,48,-122,4,0,4
7926,SpokaneStBridge,11/27/2014 06:00:00 AM,48,-122,4,0,4
7927,SpokaneStBridge,11/27/2014 07:00:00 AM,48,-122,2,3,5
7928,SpokaneStBridge,11/27/2014 08:00:00 AM,48,-122,9,4,13
7929,SpokaneStBridge,11/27/2014 09:00:00 AM,48,-122,11,6,17
7930,SpokaneStBridge,11/27/2014 10:00:00 AM,48,-122,7,4,11
7931,SpokaneStBridge,11/27/2014 11:00:00 AM,48,-122,3,13,16
7932,SpokaneStBridge,11/27/2014 12:00:00 PM,48,-122,7,8,15
7933,SpokaneStBridge,11/27/2014 01:00:00 PM,48,-122,10,12,22
7934,SpokaneStBridge,11/27/2014 02:00:00 PM,48,-122,3,3,6
7935,SpokaneStBridge,11/27/2014 03:00:00 PM,48,-122,6,9,15
7936,SpokaneStBridge,11/27/2014 04:00:00 PM,48,-122,5,3,8
7937,SpokaneStBridge,11/27/2014 05:00:00 PM,48,-122,1,0,1
7938,SpokaneStBridge,11/27/2014 06:00:00 PM,48,-122,2,3,5
7939,SpokaneStBridge,11/27/2014 07:00:00 PM,48,-122,6,0,6
7940,SpokaneStBridge,11/27/2014 08:00:00 PM,48,-122,2,3,5
7941,SpokaneStBridge,11/27/2014 09:00:00 PM,48,-122,1,1,2
7942,SpokaneStBridge,11/27/2014 10:00:00 PM,48,-122,1,1,2
7943,SpokaneStBridge,11/27/2014 11:00:00 PM,48,-122,4,1,5
7944,SpokaneStBridge,11/28/2014 12:00:00 AM,48,-122,1,5,6
7945,SpokaneStBridge,11/28/2014 01:00:00 AM,48,-122,1,3,4
7946,SpokaneStBridge,11/28/2014 02:00:00 AM,48,-122,0,0,0
7947,SpokaneStBridge,11/28/2014 03:00:00 AM,48,-122,0,0,0
7948,SpokaneStBridge,11/28/2014 04:00:00 AM,48,-122,2,0,2
7949,SpokaneStBridge,11/28/2014 05:00:00 AM,48,-122,6,2,8
7950,SpokaneStBridge,11/28/2014 06:00:00 AM,48,-122,9,5,14
7951,SpokaneStBridge,11/28/2014 07:00:00 AM,48,-122,4,2,6
7952,SpokaneStBridge,11/28/2014 08:00:00 AM,48,-122,8,1,9
7953,SpokaneStBridge,11/28/2014 09:00:00 AM,48,-122,8,3,11
7954,SpokaneStBridge,11/28/2014 10:00:00 AM,48,-122,6,2,8
7955,SpokaneStBridge,11/28/2014 11:00:00 AM,48,-122,3,2,5
7956,SpokaneStBridge,11/28/2014 12:00:00 PM,48,-122,2,0,2
7957,SpokaneStBridge,11/28/2014 01:00:00 PM,48,-122,1,5,6
7958,SpokaneStBridge,11/28/2014 02:00:00 PM,48,-122,3,4,7
7959,SpokaneStBridge,11/28/2014 03:00:00 PM,48,-122,1,5,6
7960,SpokaneStBridge,11/28/2014 04:00:00 PM,48,-122,1,4,5
7961,SpokaneStBridge,11/28/2014 05:00:00 PM,48,-122,1,4,5
7962,SpokaneStBridge,11/28/2014 06:00:00 PM,48,-122,1,2,3
7963,SpokaneStBridge,11/28/2014 07:00:00 PM,48,-122,2,3,5
7964,SpokaneStBridge,11/28/2014 08:00:00 PM,48,-122,1,2,3
7965,SpokaneStBridge,11/28/2014 09:00:00 PM,48,-122,0,1,1
7966,SpokaneStBridge,11/28/2014 10:00:00 PM,48,-122,0,2,2
7967,SpokaneStBridge,11/28/2014 11:00:00 PM,48,-122,0,1,1
7968,SpokaneStBridge,11/29/2014 12:00:00 AM,48,-122,0,0,0
7969,SpokaneStBridge,11/29/2014 01:00:00 AM,48,-122,0,0,0
7970,SpokaneStBridge,11/29/2014 02:00:00 AM,48,-122,0,0,0
7971,SpokaneStBridge,11/29/2014 03:00:00 AM,48,-122,2,1,3
7972,SpokaneStBridge,11/29/2014 04:00:00 AM,48,-122,1,0,1
7973,SpokaneStBridge,11/29/2014 05:00:00 AM,48,-122,1,0,1
7974,SpokaneStBridge,11/29/2014 06:00:00 AM,48,-122,0,0,0
7975,SpokaneStBridge,11/29/2014 07:00:00 AM,48,-122,2,0,2
7976,SpokaneStBridge,11/29/2014 08:00:00 AM,48,-122,3,0,3
7977,SpokaneStBridge,11/29/2014 09:00:00 AM,48,-122,1,1,2
7978,SpokaneStBridge,11/29/2014 10:00:00 AM,48,-122,2,2,4
7979,SpokaneStBridge,11/29/2014 11:00:00 AM,48,-122,2,1,3
7980,SpokaneStBridge,11/29/2014 12:00:00 PM,48,-122,1,2,3
7981,SpokaneStBridge,11/29/2014 01:00:00 PM,48,-122,2,3,5
7982,SpokaneStBridge,11/29/2014 02:00:00 PM,48,-122,4,1,5
7983,SpokaneStBridge,11/29/2014 03:00:00 PM,48,-122,4,2,6
7984,SpokaneStBridge,11/29/2014 04:00:00 PM,48,-122,1,2,3
7985,SpokaneStBridge,11/29/2014 05:00:00 PM,48,-122,1,6,7
7986,SpokaneStBridge,11/29/2014 06:00:00 PM,48,-122,1,3,4
7987,SpokaneStBridge,11/29/2014 07:00:00 PM,48,-122,1,2,3
7988,SpokaneStBridge,11/29/2014 08:00:00 PM,48,-122,0,0,0
7989,SpokaneStBridge,11/29/2014 09:00:00 PM,48,-122,0,0,0
7990,SpokaneStBridge,11/29/2014 10:00:00 PM,48,-122,0,0,0
7991,SpokaneStBridge,11/29/2014 11:00:00 PM,48,-122,1,0,1
7992,SpokaneStBridge,11/30/2014 12:00:00 AM,48,-122,2,0,2
7993,SpokaneStBridge,11/30/2014 01:00:00 AM,48,-122,0,0,0
7994,SpokaneStBridge,11/30/2014 02:00:00 AM,48,-122,0,0,0
7995,SpokaneStBridge,11/30/2014 03:00:00 AM,48,-122,1,1,2
7996,SpokaneStBridge,11/30/2014 04:00:00 AM,48,-122,0,2,2
7997,SpokaneStBridge,11/30/2014 05:00:00 AM,48,-122,2,2,4
7998,SpokaneStBridge,11/30/2014 06:00:00 AM,48,-122,1,0,1
7999,SpokaneStBridge,11/30/2014 07:00:00 AM,48,-122,0,1,1
8000,SpokaneStBridge,11/30/2014 08:00:00 AM,48,-122,1,2,3
8001,SpokaneStBridge,11/30/2014 09:00:00 AM,48,-122,3,0,3
8002,SpokaneStBridge,11/30/2014 10:00:00 AM,48,-122,2,1,3
8003,SpokaneStBridge,11/30/2014 11:00:00 AM,48,-122,8,4,12
8004,SpokaneStBridge,11/30/2014 12:00:00 PM,48,-122,6,8,14
8005,SpokaneStBridge,11/30/2014 01:00:00 PM,48,-122,10,5,15
8006,SpokaneStBridge,11/30/2014 02:00:00 PM,48,-122,7,5,12
8007,SpokaneStBridge,11/30/2014 03:00:00 PM,48,-122,12,3,15
8008,SpokaneStBridge,11/30/2014 04:00:00 PM,48,-122,4,9,13
8009,SpokaneStBridge,11/30/2014 05:00:00 PM,48,-122,1,2,3
8010,SpokaneStBridge,11/30/2014 06:00:00 PM,48,-122,0,2,2
8011,SpokaneStBridge,11/30/2014 07:00:00 PM,48,-122,1,1,2
8012,SpokaneStBridge,11/30/2014 08:00:00 PM,48,-122,0,3,3
8013,SpokaneStBridge,11/30/2014 09:00:00 PM,48,-122,4,5,9
8014,SpokaneStBridge,11/30/2014 10:00:00 PM,48,-122,1,1,2
8015,SpokaneStBridge,11/30/2014 11:00:00 PM,48,-122,0,1,1
8016,SpokaneStBridge,12/01/2014 12:00:00 AM,48,-122,0,0,0
8017,SpokaneStBridge,12/01/2014 01:00:00 AM,48,-122,0,0,0
8018,SpokaneStBridge,12/01/2014 02:00:00 AM,48,-122,1,0,1
8019,SpokaneStBridge,12/01/2014 03:00:00 AM,48,-122,1,1,2
8020,SpokaneStBridge,12/01/2014 04:00:00 AM,48,-122,3,0,3
8021,SpokaneStBridge,12/01/2014 05:00:00 AM,48,-122,10,1,11
8022,SpokaneStBridge,12/01/2014 06:00:00 AM,48,-122,19,4,23
8023,SpokaneStBridge,12/01/2014 07:00:00 AM,48,-122,43,11,54
8024,SpokaneStBridge,12/01/2014 08:00:00 AM,48,-122,56,3,59
8025,SpokaneStBridge,12/01/2014 09:00:00 AM,48,-122,14,5,19
8026,SpokaneStBridge,12/01/2014 10:00:00 AM,48,-122,3,1,4
8027,SpokaneStBridge,12/01/2014 11:00:00 AM,48,-122,4,10,14
8028,SpokaneStBridge,12/01/2014 12:00:00 PM,48,-122,15,7,22
8029,SpokaneStBridge,12/01/2014 01:00:00 PM,48,-122,5,3,8
8030,SpokaneStBridge,12/01/2014 02:00:00 PM,48,-122,8,4,12
8031,SpokaneStBridge,12/01/2014 03:00:00 PM,48,-122,5,13,18
8032,SpokaneStBridge,12/01/2014 04:00:00 PM,48,-122,10,26,36
8033,SpokaneStBridge,12/01/2014 05:00:00 PM,48,-122,9,59,68
8034,SpokaneStBridge,12/01/2014 06:00:00 PM,48,-122,3,40,43
8035,SpokaneStBridge,12/01/2014 07:00:00 PM,48,-122,1,9,10
8036,SpokaneStBridge,12/01/2014 08:00:00 PM,48,-122,1,4,5
8037,SpokaneStBridge,12/01/2014 09:00:00 PM,48,-122,2,3,5
8038,SpokaneStBridge,12/01/2014 10:00:00 PM,48,-122,3,1,4
8039,SpokaneStBridge,12/01/2014 11:00:00 PM,48,-122,1,0,1
8040,SpokaneStBridge,12/02/2014 12:00:00 AM,48,-122,0,1,1
8041,SpokaneStBridge,12/02/2014 01:00:00 AM,48,-122,0,1,1
8042,SpokaneStBridge,12/02/2014 02:00:00 AM,48,-122,1,0,1
8043,SpokaneStBridge,12/02/2014 03:00:00 AM,48,-122,0,3,3
8044,SpokaneStBridge,12/02/2014 04:00:00 AM,48,-122,0,0,0
8045,SpokaneStBridge,12/02/2014 05:00:00 AM,48,-122,11,2,13
8046,SpokaneStBridge,12/02/2014 06:00:00 AM,48,-122,37,4,41
8047,SpokaneStBridge,12/02/2014 07:00:00 AM,48,-122,56,8,64
8048,SpokaneStBridge,12/02/2014 08:00:00 AM,48,-122,62,9,71
8049,SpokaneStBridge,12/02/2014 09:00:00 AM,48,-122,27,3,30
8050,SpokaneStBridge,12/02/2014 10:00:00 AM,48,-122,5,3,8
8051,SpokaneStBridge,12/02/2014 11:00:00 AM,48,-122,4,4,8
8052,SpokaneStBridge,12/02/2014 12:00:00 PM,48,-122,5,7,12
8053,SpokaneStBridge,12/02/2014 01:00:00 PM,48,-122,8,7,15
8054,SpokaneStBridge,12/02/2014 02:00:00 PM,48,-122,6,10,16
8055,SpokaneStBridge,12/02/2014 03:00:00 PM,48,-122,1,15,16
8056,SpokaneStBridge,12/02/2014 04:00:00 PM,48,-122,13,39,52
8057,SpokaneStBridge,12/02/2014 05:00:00 PM,48,-122,10,77,87
8058,SpokaneStBridge,12/02/2014 06:00:00 PM,48,-122,4,35,39
8059,SpokaneStBridge,12/02/2014 07:00:00 PM,48,-122,2,14,16
8060,SpokaneStBridge,12/02/2014 08:00:00 PM,48,-122,1,5,6
8061,SpokaneStBridge,12/02/2014 09:00:00 PM,48,-122,1,4,5
8062,SpokaneStBridge,12/02/2014 10:00:00 PM,48,-122,1,0,1
8063,SpokaneStBridge,12/02/2014 11:00:00 PM,48,-122,2,2,4
8064,SpokaneStBridge,12/03/2014 12:00:00 AM,48,-122,0,0,0
8065,SpokaneStBridge,12/03/2014 01:00:00 AM,48,-122,0,1,1
8066,SpokaneStBridge,12/03/2014 02:00:00 AM,48,-122,1,2,3
8067,SpokaneStBridge,12/03/2014 03:00:00 AM,48,-122,1,0,1
8068,SpokaneStBridge,12/03/2014 04:00:00 AM,48,-122,4,1,5
8069,SpokaneStBridge,12/03/2014 05:00:00 AM,48,-122,10,3,13
8070,SpokaneStBridge,12/03/2014 06:00:00 AM,48,-122,35,2,37
8071,SpokaneStBridge,12/03/2014 07:00:00 AM,48,-122,67,7,74
8072,SpokaneStBridge,12/03/2014 08:00:00 AM,48,-122,57,7,64
8073,SpokaneStBridge,12/03/2014 09:00:00 AM,48,-122,26,1,27
8074,SpokaneStBridge,12/03/2014 10:00:00 AM,48,-122,9,3,12
8075,SpokaneStBridge,12/03/2014 11:00:00 AM,48,-122,9,3,12
8076,SpokaneStBridge,12/03/2014 12:00:00 PM,48,-122,9,4,13
8077,SpokaneStBridge,12/03/2014 01:00:00 PM,48,-122,4,8,12
8078,SpokaneStBridge,12/03/2014 02:00:00 PM,48,-122,7,8,15
8079,SpokaneStBridge,12/03/2014 03:00:00 PM,48,-122,8,19,27
8080,SpokaneStBridge,12/03/2014 04:00:00 PM,48,-122,15,43,58
8081,SpokaneStBridge,12/03/2014 05:00:00 PM,48,-122,11,69,80
8082,SpokaneStBridge,12/03/2014 06:00:00 PM,48,-122,2,47,49
8083,SpokaneStBridge,12/03/2014 07:00:00 PM,48,-122,3,20,23
8084,SpokaneStBridge,12/03/2014 08:00:00 PM,48,-122,2,7,9
8085,SpokaneStBridge,12/03/2014 09:00:00 PM,48,-122,3,4,7
8086,SpokaneStBridge,12/03/2014 10:00:00 PM,48,-122,0,2,2
8087,SpokaneStBridge,12/03/2014 11:00:00 PM,48,-122,0,2,2
8088,SpokaneStBridge,12/04/2014 12:00:00 AM,48,-122,1,1,2
8089,SpokaneStBridge,12/04/2014 01:00:00 AM,48,-122,0,0,0
8090,SpokaneStBridge,12/04/2014 02:00:00 AM,48,-122,1,1,2
8091,SpokaneStBridge,12/04/2014 03:00:00 AM,48,-122,1,1,2
8092,SpokaneStBridge,12/04/2014 04:00:00 AM,48,-122,1,0,1
8093,SpokaneStBridge,12/04/2014 05:00:00 AM,48,-122,12,3,15
8094,SpokaneStBridge,12/04/2014 06:00:00 AM,48,-122,24,6,30
8095,SpokaneStBridge,12/04/2014 07:00:00 AM,48,-122,74,14,88
8096,SpokaneStBridge,12/04/2014 08:00:00 AM,48,-122,69,6,75
8097,SpokaneStBridge,12/04/2014 09:00:00 AM,48,-122,30,1,31
8098,SpokaneStBridge,12/04/2014 10:00:00 AM,48,-122,5,1,6
8099,SpokaneStBridge,12/04/2014 11:00:00 AM,48,-122,10,4,14
8100,SpokaneStBridge,12/04/2014 12:00:00 PM,48,-122,3,3,6
8101,SpokaneStBridge,12/04/2014 01:00:00 PM,48,-122,7,4,11
8102,SpokaneStBridge,12/04/2014 02:00:00 PM,48,-122,6,11,17
8103,SpokaneStBridge,12/04/2014 03:00:00 PM,48,-122,6,13,19
8104,SpokaneStBridge,12/04/2014 04:00:00 PM,48,-122,7,37,44
8105,SpokaneStBridge,12/04/2014 05:00:00 PM,48,-122,18,80,98
8106,SpokaneStBridge,12/04/2014 06:00:00 PM,48,-122,5,45,50
8107,SpokaneStBridge,12/04/2014 07:00:00 PM,48,-122,1,21,22
8108,SpokaneStBridge,12/04/2014 08:00:00 PM,48,-122,1,8,9
8109,SpokaneStBridge,12/04/2014 09:00:00 PM,48,-122,3,5,8
8110,SpokaneStBridge,12/04/2014 10:00:00 PM,48,-122,0,0,0
8111,SpokaneStBridge,12/04/2014 11:00:00 PM,48,-122,1,3,4
8112,SpokaneStBridge,12/05/2014 12:00:00 AM,48,-122,1,2,3
8113,SpokaneStBridge,12/05/2014 01:00:00 AM,48,-122,0,0,0
8114,SpokaneStBridge,12/05/2014 02:00:00 AM,48,-122,0,1,1
8115,SpokaneStBridge,12/05/2014 03:00:00 AM,48,-122,3,0,3
8116,SpokaneStBridge,12/05/2014 04:00:00 AM,48,-122,1,0,1
8117,SpokaneStBridge,12/05/2014 05:00:00 AM,48,-122,8,4,12
8118,SpokaneStBridge,12/05/2014 06:00:00 AM,48,-122,35,2,37
8119,SpokaneStBridge,12/05/2014 07:00:00 AM,48,-122,53,13,66
8120,SpokaneStBridge,12/05/2014 08:00:00 AM,48,-122,68,6,74
8121,SpokaneStBridge,12/05/2014 09:00:00 AM,48,-122,20,3,23
8122,SpokaneStBridge,12/05/2014 10:00:00 AM,48,-122,7,2,9
8123,SpokaneStBridge,12/05/2014 11:00:00 AM,48,-122,4,4,8
8124,SpokaneStBridge,12/05/2014 12:00:00 PM,48,-122,5,6,11
8125,SpokaneStBridge,12/05/2014 01:00:00 PM,48,-122,2,3,5
8126,SpokaneStBridge,12/05/2014 02:00:00 PM,48,-122,9,11,20
8127,SpokaneStBridge,12/05/2014 03:00:00 PM,48,-122,5,14,19
8128,SpokaneStBridge,12/05/2014 04:00:00 PM,48,-122,11,33,44
8129,SpokaneStBridge,12/05/2014 05:00:00 PM,48,-122,13,59,72
8130,SpokaneStBridge,12/05/2014 06:00:00 PM,48,-122,6,35,41
8131,SpokaneStBridge,12/05/2014 07:00:00 PM,48,-122,4,12,16
8132,SpokaneStBridge,12/05/2014 08:00:00 PM,48,-122,4,7,11
8133,SpokaneStBridge,12/05/2014 09:00:00 PM,48,-122,2,9,11
8134,SpokaneStBridge,12/05/2014 10:00:00 PM,48,-122,0,2,2
8135,SpokaneStBridge,12/05/2014 11:00:00 PM,48,-122,1,3,4
8136,SpokaneStBridge,12/06/2014 12:00:00 AM,48,-122,1,2,3
8137,SpokaneStBridge,12/06/2014 01:00:00 AM,48,-122,1,0,1
8138,SpokaneStBridge,12/06/2014 02:00:00 AM,48,-122,1,2,3
8139,SpokaneStBridge,12/06/2014 03:00:00 AM,48,-122,1,3,4
8140,SpokaneStBridge,12/06/2014 04:00:00 AM,48,-122,0,0,0
8141,SpokaneStBridge,12/06/2014 05:00:00 AM,48,-122,3,0,3
8142,SpokaneStBridge,12/06/2014 06:00:00 AM,48,-122,5,3,8
8143,SpokaneStBridge,12/06/2014 07:00:00 AM,48,-122,6,10,16
8144,SpokaneStBridge,12/06/2014 08:00:00 AM,48,-122,11,8,19
8145,SpokaneStBridge,12/06/2014 09:00:00 AM,48,-122,12,8,20
8146,SpokaneStBridge,12/06/2014 10:00:00 AM,48,-122,7,11,18
8147,SpokaneStBridge,12/06/2014 11:00:00 AM,48,-122,9,12,21
8148,SpokaneStBridge,12/06/2014 12:00:00 PM,48,-122,9,8,17
8149,SpokaneStBridge,12/06/2014 01:00:00 PM,48,-122,10,10,20
8150,SpokaneStBridge,12/06/2014 02:00:00 PM,48,-122,17,7,24
8151,SpokaneStBridge,12/06/2014 03:00:00 PM,48,-122,7,9,16
8152,SpokaneStBridge,12/06/2014 04:00:00 PM,48,-122,5,10,15
8153,SpokaneStBridge,12/06/2014 05:00:00 PM,48,-122,2,2,4
8154,SpokaneStBridge,12/06/2014 06:00:00 PM,48,-122,6,9,15
8155,SpokaneStBridge,12/06/2014 07:00:00 PM,48,-122,4,7,11
8156,SpokaneStBridge,12/06/2014 08:00:00 PM,48,-122,3,2,5
8157,SpokaneStBridge,12/06/2014 09:00:00 PM,48,-122,2,0,2
8158,SpokaneStBridge,12/06/2014 10:00:00 PM,48,-122,2,1,3
8159,SpokaneStBridge,12/06/2014 11:00:00 PM,48,-122,2,4,6
8160,SpokaneStBridge,12/07/2014 12:00:00 AM,48,-122,5,0,5
8161,SpokaneStBridge,12/07/2014 01:00:00 AM,48,-122,2,1,3
8162,SpokaneStBridge,12/07/2014 02:00:00 AM,48,-122,0,2,2
8163,SpokaneStBridge,12/07/2014 03:00:00 AM,48,-122,1,2,3
8164,SpokaneStBridge,12/07/2014 04:00:00 AM,48,-122,0,1,1
8165,SpokaneStBridge,12/07/2014 05:00:00 AM,48,-122,3,0,3
8166,SpokaneStBridge,12/07/2014 06:00:00 AM,48,-122,1,0,1
8167,SpokaneStBridge,12/07/2014 07:00:00 AM,48,-122,5,2,7
8168,SpokaneStBridge,12/07/2014 08:00:00 AM,48,-122,11,2,13
8169,SpokaneStBridge,12/07/2014 09:00:00 AM,48,-122,15,11,26
8170,SpokaneStBridge,12/07/2014 10:00:00 AM,48,-122,17,14,31
8171,SpokaneStBridge,12/07/2014 11:00:00 AM,48,-122,18,29,47
8172,SpokaneStBridge,12/07/2014 12:00:00 PM,48,-122,30,27,57
8173,SpokaneStBridge,12/07/2014 01:00:00 PM,48,-122,26,9,35
8174,SpokaneStBridge,12/07/2014 02:00:00 PM,48,-122,14,18,32
8175,SpokaneStBridge,12/07/2014 03:00:00 PM,48,-122,17,19,36
8176,SpokaneStBridge,12/07/2014 04:00:00 PM,48,-122,20,16,36
8177,SpokaneStBridge,12/07/2014 05:00:00 PM,48,-122,9,10,19
8178,SpokaneStBridge,12/07/2014 06:00:00 PM,48,-122,1,5,6
8179,SpokaneStBridge,12/07/2014 07:00:00 PM,48,-122,2,2,4
8180,SpokaneStBridge,12/07/2014 08:00:00 PM,48,-122,3,5,8
8181,SpokaneStBridge,12/07/2014 09:00:00 PM,48,-122,3,1,4
8182,SpokaneStBridge,12/07/2014 10:00:00 PM,48,-122,0,6,6
8183,SpokaneStBridge,12/07/2014 11:00:00 PM,48,-122,4,3,7
8184,SpokaneStBridge,12/08/2014 12:00:00 AM,48,-122,0,0,0
8185,SpokaneStBridge,12/08/2014 01:00:00 AM,48,-122,0,0,0
8186,SpokaneStBridge,12/08/2014 02:00:00 AM,48,-122,2,0,2
8187,SpokaneStBridge,12/08/2014 03:00:00 AM,48,-122,3,0,3
8188,SpokaneStBridge,12/08/2014 04:00:00 AM,48,-122,2,1,3
8189,SpokaneStBridge,12/08/2014 05:00:00 AM,48,-122,19,2,21
8190,SpokaneStBridge,12/08/2014 06:00:00 AM,48,-122,51,6,57
8191,SpokaneStBridge,12/08/2014 07:00:00 AM,48,-122,92,11,103
8192,SpokaneStBridge,12/08/2014 08:00:00 AM,48,-122,73,6,79
8193,SpokaneStBridge,12/08/2014 09:00:00 AM,48,-122,38,3,41
8194,SpokaneStBridge,12/08/2014 10:00:00 AM,48,-122,13,2,15
8195,SpokaneStBridge,12/08/2014 11:00:00 AM,48,-122,10,11,21
8196,SpokaneStBridge,12/08/2014 12:00:00 PM,48,-122,14,8,22
8197,SpokaneStBridge,12/08/2014 01:00:00 PM,48,-122,7,12,19
8198,SpokaneStBridge,12/08/2014 02:00:00 PM,48,-122,8,10,18
8199,SpokaneStBridge,12/08/2014 03:00:00 PM,48,-122,5,29,34
8200,SpokaneStBridge,12/08/2014 04:00:00 PM,48,-122,13,44,57
8201,SpokaneStBridge,12/08/2014 05:00:00 PM,48,-122,14,82,96
8202,SpokaneStBridge,12/08/2014 06:00:00 PM,48,-122,4,53,57
8203,SpokaneStBridge,12/08/2014 07:00:00 PM,48,-122,3,18,21
8204,SpokaneStBridge,12/08/2014 08:00:00 PM,48,-122,1,3,4
8205,SpokaneStBridge,12/08/2014 09:00:00 PM,48,-122,0,3,3
8206,SpokaneStBridge,12/08/2014 10:00:00 PM,48,-122,2,5,7
8207,SpokaneStBridge,12/08/2014 11:00:00 PM,48,-122,1,0,1
8208,SpokaneStBridge,12/09/2014 12:00:00 AM,48,-122,0,0,0
8209,SpokaneStBridge,12/09/2014 01:00:00 AM,48,-122,0,0,0
8210,SpokaneStBridge,12/09/2014 02:00:00 AM,48,-122,0,0,0
8211,SpokaneStBridge,12/09/2014 03:00:00 AM,48,-122,0,0,0
8212,SpokaneStBridge,12/09/2014 04:00:00 AM,48,-122,1,0,1
8213,SpokaneStBridge,12/09/2014 05:00:00 AM,48,-122,8,3,11
8214,SpokaneStBridge,12/09/2014 06:00:00 AM,48,-122,37,6,43
8215,SpokaneStBridge,12/09/2014 07:00:00 AM,48,-122,81,6,87
8216,SpokaneStBridge,12/09/2014 08:00:00 AM,48,-122,66,7,73
8217,SpokaneStBridge,12/09/2014 09:00:00 AM,48,-122,25,3,28
8218,SpokaneStBridge,12/09/2014 10:00:00 AM,48,-122,5,3,8
8219,SpokaneStBridge,12/09/2014 11:00:00 AM,48,-122,7,2,9
8220,SpokaneStBridge,12/09/2014 12:00:00 PM,48,-122,1,0,1
8221,SpokaneStBridge,12/09/2014 01:00:00 PM,48,-122,3,2,5
8222,SpokaneStBridge,12/09/2014 02:00:00 PM,48,-122,5,10,15
8223,SpokaneStBridge,12/09/2014 03:00:00 PM,48,-122,14,21,35
8224,SpokaneStBridge,12/09/2014 04:00:00 PM,48,-122,10,38,48
8225,SpokaneStBridge,12/09/2014 05:00:00 PM,48,-122,14,78,92
8226,SpokaneStBridge,12/09/2014 06:00:00 PM,48,-122,6,51,57
8227,SpokaneStBridge,12/09/2014 07:00:00 PM,48,-122,5,10,15
8228,SpokaneStBridge,12/09/2014 08:00:00 PM,48,-122,1,9,10
8229,SpokaneStBridge,12/09/2014 09:00:00 PM,48,-122,3,4,7
8230,SpokaneStBridge,12/09/2014 10:00:00 PM,48,-122,2,3,5
8231,SpokaneStBridge,12/09/2014 11:00:00 PM,48,-122,0,2,2
8232,SpokaneStBridge,12/10/2014 12:00:00 AM,48,-122,0,2,2
8233,SpokaneStBridge,12/10/2014 01:00:00 AM,48,-122,0,0,0
8234,SpokaneStBridge,12/10/2014 02:00:00 AM,48,-122,1,0,1
8235,SpokaneStBridge,12/10/2014 03:00:00 AM,48,-122,1,0,1
8236,SpokaneStBridge,12/10/2014 04:00:00 AM,48,-122,1,2,3
8237,SpokaneStBridge,12/10/2014 05:00:00 AM,48,-122,19,3,22
8238,SpokaneStBridge,12/10/2014 06:00:00 AM,48,-122,38,4,42
8239,SpokaneStBridge,12/10/2014 07:00:00 AM,48,-122,71,9,80
8240,SpokaneStBridge,12/10/2014 08:00:00 AM,48,-122,67,2,69
8241,SpokaneStBridge,12/10/2014 09:00:00 AM,48,-122,32,4,36
8242,SpokaneStBridge,12/10/2014 10:00:00 AM,48,-122,11,6,17
8243,SpokaneStBridge,12/10/2014 11:00:00 AM,48,-122,6,1,7
8244,SpokaneStBridge,12/10/2014 12:00:00 PM,48,-122,3,5,8
8245,SpokaneStBridge,12/10/2014 01:00:00 PM,48,-122,3,1,4
8246,SpokaneStBridge,12/10/2014 02:00:00 PM,48,-122,4,3,7
8247,SpokaneStBridge,12/10/2014 03:00:00 PM,48,-122,5,11,16
8248,SpokaneStBridge,12/10/2014 04:00:00 PM,48,-122,9,36,45
8249,SpokaneStBridge,12/10/2014 05:00:00 PM,48,-122,15,72,87
8250,SpokaneStBridge,12/10/2014 06:00:00 PM,48,-122,6,40,46
8251,SpokaneStBridge,12/10/2014 07:00:00 PM,48,-122,0,14,14
8252,SpokaneStBridge,12/10/2014 08:00:00 PM,48,-122,1,6,7
8253,SpokaneStBridge,12/10/2014 09:00:00 PM,48,-122,1,4,5
8254,SpokaneStBridge,12/10/2014 10:00:00 PM,48,-122,0,1,1
8255,SpokaneStBridge,12/10/2014 11:00:00 PM,48,-122,1,1,2
8256,SpokaneStBridge,12/11/2014 12:00:00 AM,48,-122,0,0,0
8257,SpokaneStBridge,12/11/2014 01:00:00 AM,48,-122,0,1,1
8258,SpokaneStBridge,12/11/2014 02:00:00 AM,48,-122,1,0,1
8259,SpokaneStBridge,12/11/2014 03:00:00 AM,48,-122,6,1,7
8260,SpokaneStBridge,12/11/2014 04:00:00 AM,48,-122,4,0,4
8261,SpokaneStBridge,12/11/2014 05:00:00 AM,48,-122,13,7,20
8262,SpokaneStBridge,12/11/2014 06:00:00 AM,48,-122,23,6,29
8263,SpokaneStBridge,12/11/2014 07:00:00 AM,48,-122,61,14,75
8264,SpokaneStBridge,12/11/2014 08:00:00 AM,48,-122,65,5,70
8265,SpokaneStBridge,12/11/2014 09:00:00 AM,48,-122,19,6,25
8266,SpokaneStBridge,12/11/2014 10:00:00 AM,48,-122,3,2,5
8267,SpokaneStBridge,12/11/2014 11:00:00 AM,48,-122,3,7,10
8268,SpokaneStBridge,12/11/2014 12:00:00 PM,48,-122,7,0,7
8269,SpokaneStBridge,12/11/2014 01:00:00 PM,48,-122,2,3,5
8270,SpokaneStBridge,12/11/2014 02:00:00 PM,48,-122,2,7,9
8271,SpokaneStBridge,12/11/2014 03:00:00 PM,48,-122,8,22,30
8272,SpokaneStBridge,12/11/2014 04:00:00 PM,48,-122,10,32,42
8273,SpokaneStBridge,12/11/2014 05:00:00 PM,48,-122,19,54,73
8274,SpokaneStBridge,12/11/2014 06:00:00 PM,48,-122,3,35,38
8275,SpokaneStBridge,12/11/2014 07:00:00 PM,48,-122,2,10,12
8276,SpokaneStBridge,12/11/2014 08:00:00 PM,48,-122,1,3,4
8277,SpokaneStBridge,12/11/2014 09:00:00 PM,48,-122,2,4,6
8278,SpokaneStBridge,12/11/2014 10:00:00 PM,48,-122,3,14,17
8279,SpokaneStBridge,12/11/2014 11:00:00 PM,48,-122,2,0,2
8280,SpokaneStBridge,12/12/2014 12:00:00 AM,48,-122,0,0,0
8281,SpokaneStBridge,12/12/2014 01:00:00 AM,48,-122,0,0,0
8282,SpokaneStBridge,12/12/2014 02:00:00 AM,48,-122,0,0,0
8283,SpokaneStBridge,12/12/2014 03:00:00 AM,48,-122,1,2,3
8284,SpokaneStBridge,12/12/2014 04:00:00 AM,48,-122,2,1,3
8285,SpokaneStBridge,12/12/2014 05:00:00 AM,48,-122,16,4,20
8286,SpokaneStBridge,12/12/2014 06:00:00 AM,48,-122,19,3,22
8287,SpokaneStBridge,12/12/2014 07:00:00 AM,48,-122,64,12,76
8288,SpokaneStBridge,12/12/2014 08:00:00 AM,48,-122,65,5,70
8289,SpokaneStBridge,12/12/2014 09:00:00 AM,48,-122,25,4,29
8290,SpokaneStBridge,12/12/2014 10:00:00 AM,48,-122,9,5,14
8291,SpokaneStBridge,12/12/2014 11:00:00 AM,48,-122,6,4,10
8292,SpokaneStBridge,12/12/2014 12:00:00 PM,48,-122,10,6,16
8293,SpokaneStBridge,12/12/2014 01:00:00 PM,48,-122,16,7,23
8294,SpokaneStBridge,12/12/2014 02:00:00 PM,48,-122,1,9,10
8295,SpokaneStBridge,12/12/2014 03:00:00 PM,48,-122,12,18,30
8296,SpokaneStBridge,12/12/2014 04:00:00 PM,48,-122,12,48,60
8297,SpokaneStBridge,12/12/2014 05:00:00 PM,48,-122,14,71,85
8298,SpokaneStBridge,12/12/2014 06:00:00 PM,48,-122,6,46,52
8299,SpokaneStBridge,12/12/2014 07:00:00 PM,48,-122,2,11,13
8300,SpokaneStBridge,12/12/2014 08:00:00 PM,48,-122,3,7,10
8301,SpokaneStBridge,12/12/2014 09:00:00 PM,48,-122,1,2,3
8302,SpokaneStBridge,12/12/2014 10:00:00 PM,48,-122,0,1,1
8303,SpokaneStBridge,12/12/2014 11:00:00 PM,48,-122,1,3,4
8304,SpokaneStBridge,12/13/2014 12:00:00 AM,48,-122,0,3,3
8305,SpokaneStBridge,12/13/2014 01:00:00 AM,48,-122,0,1,1
8306,SpokaneStBridge,12/13/2014 02:00:00 AM,48,-122,0,0,0
8307,SpokaneStBridge,12/13/2014 03:00:00 AM,48,-122,0,3,3
8308,SpokaneStBridge,12/13/2014 04:00:00 AM,48,-122,0,1,1
8309,SpokaneStBridge,12/13/2014 05:00:00 AM,48,-122,2,0,2
8310,SpokaneStBridge,12/13/2014 06:00:00 AM,48,-122,11,1,12
8311,SpokaneStBridge,12/13/2014 07:00:00 AM,48,-122,6,3,9
8312,SpokaneStBridge,12/13/2014 08:00:00 AM,48,-122,14,3,17
8313,SpokaneStBridge,12/13/2014 09:00:00 AM,48,-122,7,8,15
8314,SpokaneStBridge,12/13/2014 10:00:00 AM,48,-122,11,8,19
8315,SpokaneStBridge,12/13/2014 11:00:00 AM,48,-122,19,20,39
8316,SpokaneStBridge,12/13/2014 12:00:00 PM,48,-122,17,20,37
8317,SpokaneStBridge,12/13/2014 01:00:00 PM,48,-122,38,25,63
8318,SpokaneStBridge,12/13/2014 02:00:00 PM,48,-122,23,15,38
8319,SpokaneStBridge,12/13/2014 03:00:00 PM,48,-122,14,16,30
8320,SpokaneStBridge,12/13/2014 04:00:00 PM,48,-122,10,13,23
8321,SpokaneStBridge,12/13/2014 05:00:00 PM,48,-122,6,8,14
8322,SpokaneStBridge,12/13/2014 06:00:00 PM,48,-122,9,9,18
8323,SpokaneStBridge,12/13/2014 07:00:00 PM,48,-122,0,2,2
8324,SpokaneStBridge,12/13/2014 08:00:00 PM,48,-122,1,1,2
8325,SpokaneStBridge,12/13/2014 09:00:00 PM,48,-122,5,4,9
8326,SpokaneStBridge,12/13/2014 10:00:00 PM,48,-122,0,4,4
8327,SpokaneStBridge,12/13/2014 11:00:00 PM,48,-122,0,2,2
8328,SpokaneStBridge,12/14/2014 12:00:00 AM,48,-122,0,0,0
8329,SpokaneStBridge,12/14/2014 01:00:00 AM,48,-122,5,1,6
8330,SpokaneStBridge,12/14/2014 02:00:00 AM,48,-122,0,2,2
8331,SpokaneStBridge,12/14/2014 03:00:00 AM,48,-122,1,1,2
8332,SpokaneStBridge,12/14/2014 04:00:00 AM,48,-122,0,1,1
8333,SpokaneStBridge,12/14/2014 05:00:00 AM,48,-122,3,0,3
8334,SpokaneStBridge,12/14/2014 06:00:00 AM,48,-122,4,2,6
8335,SpokaneStBridge,12/14/2014 07:00:00 AM,48,-122,1,0,1
8336,SpokaneStBridge,12/14/2014 08:00:00 AM,48,-122,11,1,12
8337,SpokaneStBridge,12/14/2014 09:00:00 AM,48,-122,31,8,39
8338,SpokaneStBridge,12/14/2014 10:00:00 AM,48,-122,13,18,31
8339,SpokaneStBridge,12/14/2014 11:00:00 AM,48,-122,19,23,42
8340,SpokaneStBridge,12/14/2014 12:00:00 PM,48,-122,26,25,51
8341,SpokaneStBridge,12/14/2014 01:00:00 PM,48,-122,24,28,52
8342,SpokaneStBridge,12/14/2014 02:00:00 PM,48,-122,22,14,36
8343,SpokaneStBridge,12/14/2014 03:00:00 PM,48,-122,17,23,40
8344,SpokaneStBridge,12/14/2014 04:00:00 PM,48,-122,12,13,25
8345,SpokaneStBridge,12/14/2014 05:00:00 PM,48,-122,9,16,25
8346,SpokaneStBridge,12/14/2014 06:00:00 PM,48,-122,2,5,7
8347,SpokaneStBridge,12/14/2014 07:00:00 PM,48,-122,0,1,1
8348,SpokaneStBridge,12/14/2014 08:00:00 PM,48,-122,0,8,8
8349,SpokaneStBridge,12/14/2014 09:00:00 PM,48,-122,3,0,3
8350,SpokaneStBridge,12/14/2014 10:00:00 PM,48,-122,3,1,4
8351,SpokaneStBridge,12/14/2014 11:00:00 PM,48,-122,3,2,5
8352,SpokaneStBridge,12/15/2014 12:00:00 AM,48,-122,2,0,2
8353,SpokaneStBridge,12/15/2014 01:00:00 AM,48,-122,1,0,1
8354,SpokaneStBridge,12/15/2014 02:00:00 AM,48,-122,0,0,0
8355,SpokaneStBridge,12/15/2014 03:00:00 AM,48,-122,0,0,0
8356,SpokaneStBridge,12/15/2014 04:00:00 AM,48,-122,3,0,3
8357,SpokaneStBridge,12/15/2014 05:00:00 AM,48,-122,18,4,22
8358,SpokaneStBridge,12/15/2014 06:00:00 AM,48,-122,42,5,47
8359,SpokaneStBridge,12/15/2014 07:00:00 AM,48,-122,87,12,99
8360,SpokaneStBridge,12/15/2014 08:00:00 AM,48,-122,74,5,79
8361,SpokaneStBridge,12/15/2014 09:00:00 AM,48,-122,37,3,40
8362,SpokaneStBridge,12/15/2014 10:00:00 AM,48,-122,12,3,15
8363,SpokaneStBridge,12/15/2014 11:00:00 AM,48,-122,7,5,12
8364,SpokaneStBridge,12/15/2014 12:00:00 PM,48,-122,9,7,16
8365,SpokaneStBridge,12/15/2014 01:00:00 PM,48,-122,14,5,19
8366,SpokaneStBridge,12/15/2014 02:00:00 PM,48,-122,8,15,23
8367,SpokaneStBridge,12/15/2014 03:00:00 PM,48,-122,9,25,34
8368,SpokaneStBridge,12/15/2014 04:00:00 PM,48,-122,13,46,59
8369,SpokaneStBridge,12/15/2014 05:00:00 PM,48,-122,14,100,114
8370,SpokaneStBridge,12/15/2014 06:00:00 PM,48,-122,3,58,61
8371,SpokaneStBridge,12/15/2014 07:00:00 PM,48,-122,2,19,21
8372,SpokaneStBridge,12/15/2014 08:00:00 PM,48,-122,4,7,11
8373,SpokaneStBridge,12/15/2014 09:00:00 PM,48,-122,2,3,5
8374,SpokaneStBridge,12/15/2014 10:00:00 PM,48,-122,0,6,6
8375,SpokaneStBridge,12/15/2014 11:00:00 PM,48,-122,4,1,5
8376,SpokaneStBridge,12/16/2014 12:00:00 AM,48,-122,0,0,0
8377,SpokaneStBridge,12/16/2014 01:00:00 AM,48,-122,0,1,1
8378,SpokaneStBridge,12/16/2014 02:00:00 AM,48,-122,0,0,0
8379,SpokaneStBridge,12/16/2014 03:00:00 AM,48,-122,1,0,1
8380,SpokaneStBridge,12/16/2014 04:00:00 AM,48,-122,2,1,3
8381,SpokaneStBridge,12/16/2014 05:00:00 AM,48,-122,15,6,21
8382,SpokaneStBridge,12/16/2014 06:00:00 AM,48,-122,54,13,67
8383,SpokaneStBridge,12/16/2014 07:00:00 AM,48,-122,74,15,89
8384,SpokaneStBridge,12/16/2014 08:00:00 AM,48,-122,91,8,99
8385,SpokaneStBridge,12/16/2014 09:00:00 AM,48,-122,32,9,41
8386,SpokaneStBridge,12/16/2014 10:00:00 AM,48,-122,14,4,18
8387,SpokaneStBridge,12/16/2014 11:00:00 AM,48,-122,6,8,14
8388,SpokaneStBridge,12/16/2014 12:00:00 PM,48,-122,11,8,19
8389,SpokaneStBridge,12/16/2014 01:00:00 PM,48,-122,9,4,13
8390,SpokaneStBridge,12/16/2014 02:00:00 PM,48,-122,6,11,17
8391,SpokaneStBridge,12/16/2014 03:00:00 PM,48,-122,10,15,25
8392,SpokaneStBridge,12/16/2014 04:00:00 PM,48,-122,11,56,67
8393,SpokaneStBridge,12/16/2014 05:00:00 PM,48,-122,14,107,121
8394,SpokaneStBridge,12/16/2014 06:00:00 PM,48,-122,3,55,58
8395,SpokaneStBridge,12/16/2014 07:00:00 PM,48,-122,3,19,22
8396,SpokaneStBridge,12/16/2014 08:00:00 PM,48,-122,1,6,7
8397,SpokaneStBridge,12/16/2014 09:00:00 PM,48,-122,4,4,8
8398,SpokaneStBridge,12/16/2014 10:00:00 PM,48,-122,2,3,5
8399,SpokaneStBridge,12/16/2014 11:00:00 PM,48,-122,3,1,4
8400,SpokaneStBridge,12/17/2014 12:00:00 AM,48,-122,1,4,5
8401,SpokaneStBridge,12/17/2014 01:00:00 AM,48,-122,0,1,1
8402,SpokaneStBridge,12/17/2014 02:00:00 AM,48,-122,2,2,4
8403,SpokaneStBridge,12/17/2014 03:00:00 AM,48,-122,2,0,2
8404,SpokaneStBridge,12/17/2014 04:00:00 AM,48,-122,2,2,4
8405,SpokaneStBridge,12/17/2014 05:00:00 AM,48,-122,14,5,19
8406,SpokaneStBridge,12/17/2014 06:00:00 AM,48,-122,39,7,46
8407,SpokaneStBridge,12/17/2014 07:00:00 AM,48,-122,68,10,78
8408,SpokaneStBridge,12/17/2014 08:00:00 AM,48,-122,74,6,80
8409,SpokaneStBridge,12/17/2014 09:00:00 AM,48,-122,28,1,29
8410,SpokaneStBridge,12/17/2014 10:00:00 AM,48,-122,6,3,9
8411,SpokaneStBridge,12/17/2014 11:00:00 AM,48,-122,7,4,11
8412,SpokaneStBridge,12/17/2014 12:00:00 PM,48,-122,7,6,13
8413,SpokaneStBridge,12/17/2014 01:00:00 PM,48,-122,9,7,16
8414,SpokaneStBridge,12/17/2014 02:00:00 PM,48,-122,4,8,12
8415,SpokaneStBridge,12/17/2014 03:00:00 PM,48,-122,4,16,20
8416,SpokaneStBridge,12/17/2014 04:00:00 PM,48,-122,10,49,59
8417,SpokaneStBridge,12/17/2014 05:00:00 PM,48,-122,18,83,101
8418,SpokaneStBridge,12/17/2014 06:00:00 PM,48,-122,4,38,42
8419,SpokaneStBridge,12/17/2014 07:00:00 PM,48,-122,1,13,14
8420,SpokaneStBridge,12/17/2014 08:00:00 PM,48,-122,2,10,12
8421,SpokaneStBridge,12/17/2014 09:00:00 PM,48,-122,0,4,4
8422,SpokaneStBridge,12/17/2014 10:00:00 PM,48,-122,0,0,0
8423,SpokaneStBridge,12/17/2014 11:00:00 PM,48,-122,1,0,1
8424,SpokaneStBridge,12/18/2014 12:00:00 AM,48,-122,0,0,0
8425,SpokaneStBridge,12/18/2014 01:00:00 AM,48,-122,0,0,0
8426,SpokaneStBridge,12/18/2014 02:00:00 AM,48,-122,1,0,1
8427,SpokaneStBridge,12/18/2014 03:00:00 AM,48,-122,2,0,2
8428,SpokaneStBridge,12/18/2014 04:00:00 AM,48,-122,1,0,1
8429,SpokaneStBridge,12/18/2014 05:00:00 AM,48,-122,16,6,22
8430,SpokaneStBridge,12/18/2014 06:00:00 AM,48,-122,35,11,46
8431,SpokaneStBridge,12/18/2014 07:00:00 AM,48,-122,68,12,80
8432,SpokaneStBridge,12/18/2014 08:00:00 AM,48,-122,67,10,77
8433,SpokaneStBridge,12/18/2014 09:00:00 AM,48,-122,41,8,49
8434,SpokaneStBridge,12/18/2014 10:00:00 AM,48,-122,8,3,11
8435,SpokaneStBridge,12/18/2014 11:00:00 AM,48,-122,6,3,9
8436,SpokaneStBridge,12/18/2014 12:00:00 PM,48,-122,8,4,12
8437,SpokaneStBridge,12/18/2014 01:00:00 PM,48,-122,1,6,7
8438,SpokaneStBridge,12/18/2014 02:00:00 PM,48,-122,0,10,10
8439,SpokaneStBridge,12/18/2014 03:00:00 PM,48,-122,8,16,24
8440,SpokaneStBridge,12/18/2014 04:00:00 PM,48,-122,9,33,42
8441,SpokaneStBridge,12/18/2014 05:00:00 PM,48,-122,14,72,86
8442,SpokaneStBridge,12/18/2014 06:00:00 PM,48,-122,8,42,50
8443,SpokaneStBridge,12/18/2014 07:00:00 PM,48,-122,3,21,24
8444,SpokaneStBridge,12/18/2014 08:00:00 PM,48,-122,2,5,7
8445,SpokaneStBridge,12/18/2014 09:00:00 PM,48,-122,1,3,4
8446,SpokaneStBridge,12/18/2014 10:00:00 PM,48,-122,2,4,6
8447,SpokaneStBridge,12/18/2014 11:00:00 PM,48,-122,2,1,3
8448,SpokaneStBridge,12/19/2014 12:00:00 AM,48,-122,0,0,0
8449,SpokaneStBridge,12/19/2014 01:00:00 AM,48,-122,0,3,3
8450,SpokaneStBridge,12/19/2014 02:00:00 AM,48,-122,1,0,1
8451,SpokaneStBridge,12/19/2014 03:00:00 AM,48,-122,1,0,1
8452,SpokaneStBridge,12/19/2014 04:00:00 AM,48,-122,2,1,3
8453,SpokaneStBridge,12/19/2014 05:00:00 AM,48,-122,14,5,19
8454,SpokaneStBridge,12/19/2014 06:00:00 AM,48,-122,23,7,30
8455,SpokaneStBridge,12/19/2014 07:00:00 AM,48,-122,61,7,68
8456,SpokaneStBridge,12/19/2014 08:00:00 AM,48,-122,48,1,49
8457,SpokaneStBridge,12/19/2014 09:00:00 AM,48,-122,14,1,15
8458,SpokaneStBridge,12/19/2014 10:00:00 AM,48,-122,9,3,12
8459,SpokaneStBridge,12/19/2014 11:00:00 AM,48,-122,7,3,10
8460,SpokaneStBridge,12/19/2014 12:00:00 PM,48,-122,10,8,18
8461,SpokaneStBridge,12/19/2014 01:00:00 PM,48,-122,9,13,22
8462,SpokaneStBridge,12/19/2014 02:00:00 PM,48,-122,8,11,19
8463,SpokaneStBridge,12/19/2014 03:00:00 PM,48,-122,11,20,31
8464,SpokaneStBridge,12/19/2014 04:00:00 PM,48,-122,14,45,59
8465,SpokaneStBridge,12/19/2014 05:00:00 PM,48,-122,12,49,61
8466,SpokaneStBridge,12/19/2014 06:00:00 PM,48,-122,3,36,39
8467,SpokaneStBridge,12/19/2014 07:00:00 PM,48,-122,3,9,12
8468,SpokaneStBridge,12/19/2014 08:00:00 PM,48,-122,1,8,9
8469,SpokaneStBridge,12/19/2014 09:00:00 PM,48,-122,5,4,9
8470,SpokaneStBridge,12/19/2014 10:00:00 PM,48,-122,2,4,6
8471,SpokaneStBridge,12/19/2014 11:00:00 PM,48,-122,2,1,3
8472,SpokaneStBridge,12/20/2014 12:00:00 AM,48,-122,0,2,2
8473,SpokaneStBridge,12/20/2014 01:00:00 AM,48,-122,0,0,0
8474,SpokaneStBridge,12/20/2014 02:00:00 AM,48,-122,1,2,3
8475,SpokaneStBridge,12/20/2014 03:00:00 AM,48,-122,0,0,0
8476,SpokaneStBridge,12/20/2014 04:00:00 AM,48,-122,0,0,0
8477,SpokaneStBridge,12/20/2014 05:00:00 AM,48,-122,1,1,2
8478,SpokaneStBridge,12/20/2014 06:00:00 AM,48,-122,3,2,5
8479,SpokaneStBridge,12/20/2014 07:00:00 AM,48,-122,1,1,2
8480,SpokaneStBridge,12/20/2014 08:00:00 AM,48,-122,6,4,10
8481,SpokaneStBridge,12/20/2014 09:00:00 AM,48,-122,6,6,12
8482,SpokaneStBridge,12/20/2014 10:00:00 AM,48,-122,1,3,4
8483,SpokaneStBridge,12/20/2014 11:00:00 AM,48,-122,2,6,8
8484,SpokaneStBridge,12/20/2014 12:00:00 PM,48,-122,1,2,3
8485,SpokaneStBridge,12/20/2014 01:00:00 PM,48,-122,4,2,6
8486,SpokaneStBridge,12/20/2014 02:00:00 PM,48,-122,3,1,4
8487,SpokaneStBridge,12/20/2014 03:00:00 PM,48,-122,3,3,6
8488,SpokaneStBridge,12/20/2014 04:00:00 PM,48,-122,3,42,45
8489,SpokaneStBridge,12/20/2014 05:00:00 PM,48,-122,3,8,11
8490,SpokaneStBridge,12/20/2014 06:00:00 PM,48,-122,1,1,2
8491,SpokaneStBridge,12/20/2014 07:00:00 PM,48,-122,2,2,4
8492,SpokaneStBridge,12/20/2014 08:00:00 PM,48,-122,0,2,2
8493,SpokaneStBridge,12/20/2014 09:00:00 PM,48,-122,5,1,6
8494,SpokaneStBridge,12/20/2014 10:00:00 PM,48,-122,5,3,8
8495,SpokaneStBridge,12/20/2014 11:00:00 PM,48,-122,5,3,8
8496,SpokaneStBridge,12/21/2014 12:00:00 AM,48,-122,5,0,5
8497,SpokaneStBridge,12/21/2014 01:00:00 AM,48,-122,17,1,18
8498,SpokaneStBridge,12/21/2014 02:00:00 AM,48,-122,5,1,6
8499,SpokaneStBridge,12/21/2014 03:00:00 AM,48,-122,2,0,2
8500,SpokaneStBridge,12/21/2014 04:00:00 AM,48,-122,1,1,2
8501,SpokaneStBridge,12/21/2014 05:00:00 AM,48,-122,4,1,5
8502,SpokaneStBridge,12/21/2014 06:00:00 AM,48,-122,1,2,3
8503,SpokaneStBridge,12/21/2014 07:00:00 AM,48,-122,4,3,7
8504,SpokaneStBridge,12/21/2014 08:00:00 AM,48,-122,5,1,6
8505,SpokaneStBridge,12/21/2014 09:00:00 AM,48,-122,7,6,13
8506,SpokaneStBridge,12/21/2014 10:00:00 AM,48,-122,13,5,18
8507,SpokaneStBridge,12/21/2014 11:00:00 AM,48,-122,11,16,27
8508,SpokaneStBridge,12/21/2014 12:00:00 PM,48,-122,16,11,27
8509,SpokaneStBridge,12/21/2014 01:00:00 PM,48,-122,9,18,27
8510,SpokaneStBridge,12/21/2014 02:00:00 PM,48,-122,15,14,29
8511,SpokaneStBridge,12/21/2014 03:00:00 PM,48,-122,23,15,38
8512,SpokaneStBridge,12/21/2014 04:00:00 PM,48,-122,6,8,14
8513,SpokaneStBridge,12/21/2014 05:00:00 PM,48,-122,7,5,12
8514,SpokaneStBridge,12/21/2014 06:00:00 PM,48,-122,0,4,4
8515,SpokaneStBridge,12/21/2014 07:00:00 PM,48,-122,5,3,8
8516,SpokaneStBridge,12/21/2014 08:00:00 PM,48,-122,0,0,0
8517,SpokaneStBridge,12/21/2014 09:00:00 PM,48,-122,4,2,6
8518,SpokaneStBridge,12/21/2014 10:00:00 PM,48,-122,3,5,8
8519,SpokaneStBridge,12/21/2014 11:00:00 PM,48,-122,2,1,3
8520,SpokaneStBridge,12/22/2014 12:00:00 AM,48,-122,0,1,1
8521,SpokaneStBridge,12/22/2014 01:00:00 AM,48,-122,0,2,2
8522,SpokaneStBridge,12/22/2014 02:00:00 AM,48,-122,2,1,3
8523,SpokaneStBridge,12/22/2014 03:00:00 AM,48,-122,1,2,3
8524,SpokaneStBridge,12/22/2014 04:00:00 AM,48,-122,2,1,3
8525,SpokaneStBridge,12/22/2014 05:00:00 AM,48,-122,11,2,13
8526,SpokaneStBridge,12/22/2014 06:00:00 AM,48,-122,35,8,43
8527,SpokaneStBridge,12/22/2014 07:00:00 AM,48,-122,65,10,75
8528,SpokaneStBridge,12/22/2014 08:00:00 AM,48,-122,64,9,73
8529,SpokaneStBridge,12/22/2014 09:00:00 AM,48,-122,23,6,29
8530,SpokaneStBridge,12/22/2014 10:00:00 AM,48,-122,13,8,21
8531,SpokaneStBridge,12/22/2014 11:00:00 AM,48,-122,9,8,17
8532,SpokaneStBridge,12/22/2014 12:00:00 PM,48,-122,9,17,26
8533,SpokaneStBridge,12/22/2014 01:00:00 PM,48,-122,9,6,15
8534,SpokaneStBridge,12/22/2014 02:00:00 PM,48,-122,21,14,35
8535,SpokaneStBridge,12/22/2014 03:00:00 PM,48,-122,7,16,23
8536,SpokaneStBridge,12/22/2014 04:00:00 PM,48,-122,12,48,60
8537,SpokaneStBridge,12/22/2014 05:00:00 PM,48,-122,9,65,74
8538,SpokaneStBridge,12/22/2014 06:00:00 PM,48,-122,4,32,36
8539,SpokaneStBridge,12/22/2014 07:00:00 PM,48,-122,4,14,18
8540,SpokaneStBridge,12/22/2014 08:00:00 PM,48,-122,2,6,8
8541,SpokaneStBridge,12/22/2014 09:00:00 PM,48,-122,0,5,5
8542,SpokaneStBridge,12/22/2014 10:00:00 PM,48,-122,1,3,4
8543,SpokaneStBridge,12/22/2014 11:00:00 PM,48,-122,0,2,2
8544,SpokaneStBridge,12/23/2014 12:00:00 AM,48,-122,0,0,0
8545,SpokaneStBridge,12/23/2014 01:00:00 AM,48,-122,0,2,2
8546,SpokaneStBridge,12/23/2014 02:00:00 AM,48,-122,0,0,0
8547,SpokaneStBridge,12/23/2014 03:00:00 AM,48,-122,2,1,3
8548,SpokaneStBridge,12/23/2014 04:00:00 AM,48,-122,0,0,0
8549,SpokaneStBridge,12/23/2014 05:00:00 AM,48,-122,9,9,18
8550,SpokaneStBridge,12/23/2014 06:00:00 AM,48,-122,29,1,30
8551,SpokaneStBridge,12/23/2014 07:00:00 AM,48,-122,47,7,54
8552,SpokaneStBridge,12/23/2014 08:00:00 AM,48,-122,44,5,49
8553,SpokaneStBridge,12/23/2014 09:00:00 AM,48,-122,22,7,29
8554,SpokaneStBridge,12/23/2014 10:00:00 AM,48,-122,12,10,22
8555,SpokaneStBridge,12/23/2014 11:00:00 AM,48,-122,3,7,10
8556,SpokaneStBridge,12/23/2014 12:00:00 PM,48,-122,7,2,9
8557,SpokaneStBridge,12/23/2014 01:00:00 PM,48,-122,4,6,10
8558,SpokaneStBridge,12/23/2014 02:00:00 PM,48,-122,5,10,15
8559,SpokaneStBridge,12/23/2014 03:00:00 PM,48,-122,5,15,20
8560,SpokaneStBridge,12/23/2014 04:00:00 PM,48,-122,6,29,35
8561,SpokaneStBridge,12/23/2014 05:00:00 PM,48,-122,6,46,52
8562,SpokaneStBridge,12/23/2014 06:00:00 PM,48,-122,2,19,21
8563,SpokaneStBridge,12/23/2014 07:00:00 PM,48,-122,0,3,3
8564,SpokaneStBridge,12/23/2014 08:00:00 PM,48,-122,0,1,1
8565,SpokaneStBridge,12/23/2014 09:00:00 PM,48,-122,0,0,0
8566,SpokaneStBridge,12/23/2014 10:00:00 PM,48,-122,0,1,1
8567,SpokaneStBridge,12/23/2014 11:00:00 PM,48,-122,0,2,2
8568,SpokaneStBridge,12/24/2014 12:00:00 AM,48,-122,0,0,0
8569,SpokaneStBridge,12/24/2014 01:00:00 AM,48,-122,0,0,0
8570,SpokaneStBridge,12/24/2014 02:00:00 AM,48,-122,0,1,1
8571,SpokaneStBridge,12/24/2014 03:00:00 AM,48,-122,0,0,0
8572,SpokaneStBridge,12/24/2014 04:00:00 AM,48,-122,0,1,1
8573,SpokaneStBridge,12/24/2014 05:00:00 AM,48,-122,2,2,4
8574,SpokaneStBridge,12/24/2014 06:00:00 AM,48,-122,12,4,16
8575,SpokaneStBridge,12/24/2014 07:00:00 AM,48,-122,16,2,18
8576,SpokaneStBridge,12/24/2014 08:00:00 AM,48,-122,13,3,16
8577,SpokaneStBridge,12/24/2014 09:00:00 AM,48,-122,9,2,11
8578,SpokaneStBridge,12/24/2014 10:00:00 AM,48,-122,3,4,7
8579,SpokaneStBridge,12/24/2014 11:00:00 AM,48,-122,4,5,9
8580,SpokaneStBridge,12/24/2014 12:00:00 PM,48,-122,5,5,10
8581,SpokaneStBridge,12/24/2014 01:00:00 PM,48,-122,5,14,19
8582,SpokaneStBridge,12/24/2014 02:00:00 PM,48,-122,6,12,18
8583,SpokaneStBridge,12/24/2014 03:00:00 PM,48,-122,7,20,27
8584,SpokaneStBridge,12/24/2014 04:00:00 PM,48,-122,6,11,17
8585,SpokaneStBridge,12/24/2014 05:00:00 PM,48,-122,2,14,16
8586,SpokaneStBridge,12/24/2014 06:00:00 PM,48,-122,1,5,6
8587,SpokaneStBridge,12/24/2014 07:00:00 PM,48,-122,0,0,0
8588,SpokaneStBridge,12/24/2014 08:00:00 PM,48,-122,5,0,5
8589,SpokaneStBridge,12/24/2014 09:00:00 PM,48,-122,2,0,2
8590,SpokaneStBridge,12/24/2014 10:00:00 PM,48,-122,0,0,0
8591,SpokaneStBridge,12/24/2014 11:00:00 PM,48,-122,2,0,2
8592,SpokaneStBridge,12/25/2014 12:00:00 AM,48,-122,0,1,1
8593,SpokaneStBridge,12/25/2014 01:00:00 AM,48,-122,0,0,0
8594,SpokaneStBridge,12/25/2014 02:00:00 AM,48,-122,1,0,1
8595,SpokaneStBridge,12/25/2014 03:00:00 AM,48,-122,0,0,0
8596,SpokaneStBridge,12/25/2014 04:00:00 AM,48,-122,0,0,0
8597,SpokaneStBridge,12/25/2014 05:00:00 AM,48,-122,2,0,2
8598,SpokaneStBridge,12/25/2014 06:00:00 AM,48,-122,3,2,5
8599,SpokaneStBridge,12/25/2014 07:00:00 AM,48,-122,0,0,0
8600,SpokaneStBridge,12/25/2014 08:00:00 AM,48,-122,5,5,10
8601,SpokaneStBridge,12/25/2014 09:00:00 AM,48,-122,4,3,7
8602,SpokaneStBridge,12/25/2014 10:00:00 AM,48,-122,4,8,12
8603,SpokaneStBridge,12/25/2014 11:00:00 AM,48,-122,11,18,29
8604,SpokaneStBridge,12/25/2014 12:00:00 PM,48,-122,24,14,38
8605,SpokaneStBridge,12/25/2014 01:00:00 PM,48,-122,9,9,18
8606,SpokaneStBridge,12/25/2014 02:00:00 PM,48,-122,24,13,37
8607,SpokaneStBridge,12/25/2014 03:00:00 PM,48,-122,14,9,23
8608,SpokaneStBridge,12/25/2014 04:00:00 PM,48,-122,10,9,19
8609,SpokaneStBridge,12/25/2014 05:00:00 PM,48,-122,4,2,6
8610,SpokaneStBridge,12/25/2014 06:00:00 PM,48,-122,0,1,1
8611,SpokaneStBridge,12/25/2014 07:00:00 PM,48,-122,1,1,2
8612,SpokaneStBridge,12/25/2014 08:00:00 PM,48,-122,0,0,0
8613,SpokaneStBridge,12/25/2014 09:00:00 PM,48,-122,2,2,4
8614,SpokaneStBridge,12/25/2014 10:00:00 PM,48,-122,0,4,4
8615,SpokaneStBridge,12/25/2014 11:00:00 PM,48,-122,1,0,1
8616,SpokaneStBridge,12/26/2014 12:00:00 AM,48,-122,0,1,1
8617,SpokaneStBridge,12/26/2014 01:00:00 AM,48,-122,0,0,0
8618,SpokaneStBridge,12/26/2014 02:00:00 AM,48,-122,0,0,0
8619,SpokaneStBridge,12/26/2014 03:00:00 AM,48,-122,1,0,1
8620,SpokaneStBridge,12/26/2014 04:00:00 AM,48,-122,5,1,6
8621,SpokaneStBridge,12/26/2014 05:00:00 AM,48,-122,5,2,7
8622,SpokaneStBridge,12/26/2014 06:00:00 AM,48,-122,8,1,9
8623,SpokaneStBridge,12/26/2014 07:00:00 AM,48,-122,13,4,17
8624,SpokaneStBridge,12/26/2014 08:00:00 AM,48,-122,15,5,20
8625,SpokaneStBridge,12/26/2014 09:00:00 AM,48,-122,18,10,28
8626,SpokaneStBridge,12/26/2014 10:00:00 AM,48,-122,7,15,22
8627,SpokaneStBridge,12/26/2014 11:00:00 AM,48,-122,10,6,16
8628,SpokaneStBridge,12/26/2014 12:00:00 PM,48,-122,23,9,32
8629,SpokaneStBridge,12/26/2014 01:00:00 PM,48,-122,9,10,19
8630,SpokaneStBridge,12/26/2014 02:00:00 PM,48,-122,14,12,26
8631,SpokaneStBridge,12/26/2014 03:00:00 PM,48,-122,10,13,23
8632,SpokaneStBridge,12/26/2014 04:00:00 PM,48,-122,7,19,26
8633,SpokaneStBridge,12/26/2014 05:00:00 PM,48,-122,2,15,17
8634,SpokaneStBridge,12/26/2014 06:00:00 PM,48,-122,1,14,15
8635,SpokaneStBridge,12/26/2014 07:00:00 PM,48,-122,3,6,9
8636,SpokaneStBridge,12/26/2014 08:00:00 PM,48,-122,1,2,3
8637,SpokaneStBridge,12/26/2014 09:00:00 PM,48,-122,1,1,2
8638,SpokaneStBridge,12/26/2014 10:00:00 PM,48,-122,2,0,2
8639,SpokaneStBridge,12/26/2014 11:00:00 PM,48,-122,1,2,3
8640,SpokaneStBridge,12/27/2014 12:00:00 AM,48,-122,1,1,2
8641,SpokaneStBridge,12/27/2014 01:00:00 AM,48,-122,0,1,1
8642,SpokaneStBridge,12/27/2014 02:00:00 AM,48,-122,2,2,4
8643,SpokaneStBridge,12/27/2014 03:00:00 AM,48,-122,0,1,1
8644,SpokaneStBridge,12/27/2014 04:00:00 AM,48,-122,2,2,4
8645,SpokaneStBridge,12/27/2014 05:00:00 AM,48,-122,3,0,3
8646,SpokaneStBridge,12/27/2014 06:00:00 AM,48,-122,3,0,3
8647,SpokaneStBridge,12/27/2014 07:00:00 AM,48,-122,3,4,7
8648,SpokaneStBridge,12/27/2014 08:00:00 AM,48,-122,6,1,7
8649,SpokaneStBridge,12/27/2014 09:00:00 AM,48,-122,10,0,10
8650,SpokaneStBridge,12/27/2014 10:00:00 AM,48,-122,9,4,13
8651,SpokaneStBridge,12/27/2014 11:00:00 AM,48,-122,8,7,15
8652,SpokaneStBridge,12/27/2014 12:00:00 PM,48,-122,9,11,20
8653,SpokaneStBridge,12/27/2014 01:00:00 PM,48,-122,4,12,16
8654,SpokaneStBridge,12/27/2014 02:00:00 PM,48,-122,5,3,8
8655,SpokaneStBridge,12/27/2014 03:00:00 PM,48,-122,9,8,17
8656,SpokaneStBridge,12/27/2014 04:00:00 PM,48,-122,8,7,15
8657,SpokaneStBridge,12/27/2014 05:00:00 PM,48,-122,3,3,6
8658,SpokaneStBridge,12/27/2014 06:00:00 PM,48,-122,3,4,7
8659,SpokaneStBridge,12/27/2014 07:00:00 PM,48,-122,3,1,4
8660,SpokaneStBridge,12/27/2014 08:00:00 PM,48,-122,0,1,1
8661,SpokaneStBridge,12/27/2014 09:00:00 PM,48,-122,1,1,2
8662,SpokaneStBridge,12/27/2014 10:00:00 PM,48,-122,0,1,1
8663,SpokaneStBridge,12/27/2014 11:00:00 PM,48,-122,0,0,0
8664,SpokaneStBridge,12/28/2014 12:00:00 AM,48,-122,0,1,1
8665,SpokaneStBridge,12/28/2014 01:00:00 AM,48,-122,0,0,0
8666,SpokaneStBridge,12/28/2014 02:00:00 AM,48,-122,1,1,2
8667,SpokaneStBridge,12/28/2014 03:00:00 AM,48,-122,2,0,2
8668,SpokaneStBridge,12/28/2014 04:00:00 AM,48,-122,1,1,2
8669,SpokaneStBridge,12/28/2014 05:00:00 AM,48,-122,0,0,0
8670,SpokaneStBridge,12/28/2014 06:00:00 AM,48,-122,1,3,4
8671,SpokaneStBridge,12/28/2014 07:00:00 AM,48,-122,3,1,4
8672,SpokaneStBridge,12/28/2014 08:00:00 AM,48,-122,7,0,7
8673,SpokaneStBridge,12/28/2014 09:00:00 AM,48,-122,16,14,30
8674,SpokaneStBridge,12/28/2014 10:00:00 AM,48,-122,11,18,29
8675,SpokaneStBridge,12/28/2014 11:00:00 AM,48,-122,11,12,23
8676,SpokaneStBridge,12/28/2014 12:00:00 PM,48,-122,9,12,21
8677,SpokaneStBridge,12/28/2014 01:00:00 PM,48,-122,7,7,14
8678,SpokaneStBridge,12/28/2014 02:00:00 PM,48,-122,7,10,17
8679,SpokaneStBridge,12/28/2014 03:00:00 PM,48,-122,15,14,29
8680,SpokaneStBridge,12/28/2014 04:00:00 PM,48,-122,6,4,10
8681,SpokaneStBridge,12/28/2014 05:00:00 PM,48,-122,5,5,10
8682,SpokaneStBridge,12/28/2014 06:00:00 PM,48,-122,4,3,7
8683,SpokaneStBridge,12/28/2014 07:00:00 PM,48,-122,2,1,3
8684,SpokaneStBridge,12/28/2014 08:00:00 PM,48,-122,0,4,4
8685,SpokaneStBridge,12/28/2014 09:00:00 PM,48,-122,1,3,4
8686,SpokaneStBridge,12/28/2014 10:00:00 PM,48,-122,0,1,1
8687,SpokaneStBridge,12/28/2014 11:00:00 PM,48,-122,0,2,2
8688,SpokaneStBridge,12/29/2014 12:00:00 AM,48,-122,0,0,0
8689,SpokaneStBridge,12/29/2014 01:00:00 AM,48,-122,1,1,2
8690,SpokaneStBridge,12/29/2014 02:00:00 AM,48,-122,2,0,2
8691,SpokaneStBridge,12/29/2014 03:00:00 AM,48,-122,5,5,10
8692,SpokaneStBridge,12/29/2014 04:00:00 AM,48,-122,0,0,0
8693,SpokaneStBridge,12/29/2014 05:00:00 AM,48,-122,8,4,12
8694,SpokaneStBridge,12/29/2014 06:00:00 AM,48,-122,28,7,35
8695,SpokaneStBridge,12/29/2014 07:00:00 AM,48,-122,50,4,54
8696,SpokaneStBridge,12/29/2014 08:00:00 AM,48,-122,50,7,57
8697,SpokaneStBridge,12/29/2014 09:00:00 AM,48,-122,30,3,33
8698,SpokaneStBridge,12/29/2014 10:00:00 AM,48,-122,9,3,12
8699,SpokaneStBridge,12/29/2014 11:00:00 AM,48,-122,9,5,14
8700,SpokaneStBridge,12/29/2014 12:00:00 PM,48,-122,8,4,12
8701,SpokaneStBridge,12/29/2014 01:00:00 PM,48,-122,7,7,14
8702,SpokaneStBridge,12/29/2014 02:00:00 PM,48,-122,11,7,18
8703,SpokaneStBridge,12/29/2014 03:00:00 PM,48,-122,5,30,35
8704,SpokaneStBridge,12/29/2014 04:00:00 PM,48,-122,9,33,42
8705,SpokaneStBridge,12/29/2014 05:00:00 PM,48,-122,10,62,72
8706,SpokaneStBridge,12/29/2014 06:00:00 PM,48,-122,3,35,38
8707,SpokaneStBridge,12/29/2014 07:00:00 PM,48,-122,0,5,5
8708,SpokaneStBridge,12/29/2014 08:00:00 PM,48,-122,1,5,6
8709,SpokaneStBridge,12/29/2014 09:00:00 PM,48,-122,3,1,4
8710,SpokaneStBridge,12/29/2014 10:00:00 PM,48,-122,1,2,3
8711,SpokaneStBridge,12/29/2014 11:00:00 PM,48,-122,0,3,3
8712,SpokaneStBridge,12/30/2014 12:00:00 AM,48,-122,0,0,0
8713,SpokaneStBridge,12/30/2014 01:00:00 AM,48,-122,0,3,3
8714,SpokaneStBridge,12/30/2014 02:00:00 AM,48,-122,3,0,3
8715,SpokaneStBridge,12/30/2014 03:00:00 AM,48,-122,1,0,1
8716,SpokaneStBridge,12/30/2014 04:00:00 AM,48,-122,2,1,3
8717,SpokaneStBridge,12/30/2014 05:00:00 AM,48,-122,7,0,7
8718,SpokaneStBridge,12/30/2014 06:00:00 AM,48,-122,18,6,24
8719,SpokaneStBridge,12/30/2014 07:00:00 AM,48,-122,41,3,44
8720,SpokaneStBridge,12/30/2014 08:00:00 AM,48,-122,41,4,45
8721,SpokaneStBridge,12/30/2014 09:00:00 AM,48,-122,13,4,17
8722,SpokaneStBridge,12/30/2014 10:00:00 AM,48,-122,8,2,10
8723,SpokaneStBridge,12/30/2014 11:00:00 AM,48,-122,8,7,15
8724,SpokaneStBridge,12/30/2014 12:00:00 PM,48,-122,7,12,19
8725,SpokaneStBridge,12/30/2014 01:00:00 PM,48,-122,11,10,21
8726,SpokaneStBridge,12/30/2014 02:00:00 PM,48,-122,8,11,19
8727,SpokaneStBridge,12/30/2014 03:00:00 PM,48,-122,8,15,23
8728,SpokaneStBridge,12/30/2014 04:00:00 PM,48,-122,6,36,42
8729,SpokaneStBridge,12/30/2014 05:00:00 PM,48,-122,6,43,49
8730,SpokaneStBridge,12/30/2014 06:00:00 PM,48,-122,4,25,29
8731,SpokaneStBridge,12/30/2014 07:00:00 PM,48,-122,4,6,10
8732,SpokaneStBridge,12/30/2014 08:00:00 PM,48,-122,0,4,4
8733,SpokaneStBridge,12/30/2014 09:00:00 PM,48,-122,0,2,2
8734,SpokaneStBridge,12/30/2014 10:00:00 PM,48,-122,1,0,1
8735,SpokaneStBridge,12/30/2014 11:00:00 PM,48,-122,0,4,4
8736,SpokaneStBridge,12/31/2014 12:00:00 AM,48,-122,1,0,1
8737,SpokaneStBridge,12/31/2014 01:00:00 AM,48,-122,0,0,0
8738,SpokaneStBridge,12/31/2014 02:00:00 AM,48,-122,0,0,0
8739,SpokaneStBridge,12/31/2014 03:00:00 AM,48,-122,1,0,1
8740,SpokaneStBridge,12/31/2014 04:00:00 AM,48,-122,3,2,5
8741,SpokaneStBridge,12/31/2014 05:00:00 AM,48,-122,7,1,8
8742,SpokaneStBridge,12/31/2014 06:00:00 AM,48,-122,19,2,21
8743,SpokaneStBridge,12/31/2014 07:00:00 AM,48,-122,38,8,46
8744,SpokaneStBridge,12/31/2014 08:00:00 AM,48,-122,35,5,40
8745,SpokaneStBridge,12/31/2014 09:00:00 AM,48,-122,19,2,21
8746,SpokaneStBridge,12/31/2014 10:00:00 AM,48,-122,4,4,8
8747,SpokaneStBridge,12/31/2014 11:00:00 AM,48,-122,6,4,10
8748,SpokaneStBridge,12/31/2014 12:00:00 PM,48,-122,11,10,21
8749,SpokaneStBridge,12/31/2014 01:00:00 PM,48,-122,7,4,11
8750,SpokaneStBridge,12/31/2014 02:00:00 PM,48,-122,10,25,35
8751,SpokaneStBridge,12/31/2014 03:00:00 PM,48,-122,11,35,46
8752,SpokaneStBridge,12/31/2014 04:00:00 PM,48,-122,13,32,45
8753,SpokaneStBridge,12/31/2014 05:00:00 PM,48,-122,8,27,35
8754,SpokaneStBridge,12/31/2014 06:00:00 PM,48,-122,3,13,16
8755,SpokaneStBridge,12/31/2014 07:00:00 PM,48,-122,2,9,11
8756,SpokaneStBridge,12/31/2014 08:00:00 PM,48,-122,0,3,3
8757,SpokaneStBridge,12/31/2014 09:00:00 PM,48,-122,0,0,0
8758,SpokaneStBridge,12/31/2014 10:00:00 PM,48,-122,2,0,2
8759,SpokaneStBridge,12/31/2014 11:00:00 PM,48,-122,2,0,2
8760,SpokaneStBridge,01/01/2015 12:00:00 AM,48,-122,0,0,0
8761,SpokaneStBridge,01/01/2015 01:00:00 AM,48,-122,1,4,5
8762,SpokaneStBridge,01/01/2015 02:00:00 AM,48,-122,1,1,2
8763,SpokaneStBridge,01/01/2015 03:00:00 AM,48,-122,3,4,7
8764,SpokaneStBridge,01/01/2015 04:00:00 AM,48,-122,1,1,2
8765,SpokaneStBridge,01/01/2015 05:00:00 AM,48,-122,0,0,0
8766,SpokaneStBridge,01/01/2015 06:00:00 AM,48,-122,1,0,1
8767,SpokaneStBridge,01/01/2015 07:00:00 AM,48,-122,2,1,3
8768,SpokaneStBridge,01/01/2015 08:00:00 AM,48,-122,2,1,3
8769,SpokaneStBridge,01/01/2015 09:00:00 AM,48,-122,2,2,4
8770,SpokaneStBridge,01/01/2015 10:00:00 AM,48,-122,1,5,6
8771,SpokaneStBridge,01/01/2015 11:00:00 AM,48,-122,15,6,21
8772,SpokaneStBridge,01/01/2015 12:00:00 PM,48,-122,12,9,21
8773,SpokaneStBridge,01/01/2015 01:00:00 PM,48,-122,20,15,35
8774,SpokaneStBridge,01/01/2015 02:00:00 PM,48,-122,18,12,30
8775,SpokaneStBridge,01/01/2015 03:00:00 PM,48,-122,19,19,38
8776,SpokaneStBridge,01/01/2015 04:00:00 PM,48,-122,4,9,13
8777,SpokaneStBridge,01/01/2015 05:00:00 PM,48,-122,4,5,9
8778,SpokaneStBridge,01/01/2015 06:00:00 PM,48,-122,6,4,10
8779,SpokaneStBridge,01/01/2015 07:00:00 PM,48,-122,3,32,35
8780,SpokaneStBridge,01/01/2015 08:00:00 PM,48,-122,0,1,1
8781,SpokaneStBridge,01/01/2015 09:00:00 PM,48,-122,1,1,2
8782,SpokaneStBridge,01/01/2015 10:00:00 PM,48,-122,2,1,3
8783,SpokaneStBridge,01/01/2015 11:00:00 PM,48,-122,4,1,5
8784,SpokaneStBridge,01/02/2015 12:00:00 AM,48,-122,0,2,2
8785,SpokaneStBridge,01/02/2015 01:00:00 AM,48,-122,1,0,1
8786,SpokaneStBridge,01/02/2015 02:00:00 AM,48,-122,0,1,1
8787,SpokaneStBridge,01/02/2015 03:00:00 AM,48,-122,1,0,1
8788,SpokaneStBridge,01/02/2015 04:00:00 AM,48,-122,4,0,4
8789,SpokaneStBridge,01/02/2015 05:00:00 AM,48,-122,3,3,6
8790,SpokaneStBridge,01/02/2015 06:00:00 AM,48,-122,19,3,22
8791,SpokaneStBridge,01/02/2015 07:00:00 AM,48,-122,23,2,25
8792,SpokaneStBridge,01/02/2015 08:00:00 AM,48,-122,34,4,38
8793,SpokaneStBridge,01/02/2015 09:00:00 AM,48,-122,13,3,16
8794,SpokaneStBridge,01/02/2015 10:00:00 AM,48,-122,8,1,9
8795,SpokaneStBridge,01/02/2015 11:00:00 AM,48,-122,5,10,15
8796,SpokaneStBridge,01/02/2015 12:00:00 PM,48,-122,3,8,11
8797,SpokaneStBridge,01/02/2015 01:00:00 PM,48,-122,13,5,18
8798,SpokaneStBridge,01/02/2015 02:00:00 PM,48,-122,3,6,9
8799,SpokaneStBridge,01/02/2015 03:00:00 PM,48,-122,1,21,22
8800,SpokaneStBridge,01/02/2015 04:00:00 PM,48,-122,8,26,34
8801,SpokaneStBridge,01/02/2015 05:00:00 PM,48,-122,3,35,38
8802,SpokaneStBridge,01/02/2015 06:00:00 PM,48,-122,2,11,13
8803,SpokaneStBridge,01/02/2015 07:00:00 PM,48,-122,2,8,10
8804,SpokaneStBridge,01/02/2015 08:00:00 PM,48,-122,2,2,4
8805,SpokaneStBridge,01/02/2015 09:00:00 PM,48,-122,1,0,1
8806,SpokaneStBridge,01/02/2015 10:00:00 PM,48,-122,0,1,1
8807,SpokaneStBridge,01/02/2015 11:00:00 PM,48,-122,0,3,3
8808,SpokaneStBridge,01/03/2015 12:00:00 AM,48,-122,0,1,1
8809,SpokaneStBridge,01/03/2015 01:00:00 AM,48,-122,1,0,1
8810,SpokaneStBridge,01/03/2015 02:00:00 AM,48,-122,0,1,1
8811,SpokaneStBridge,01/03/2015 03:00:00 AM,48,-122,1,2,3
8812,SpokaneStBridge,01/03/2015 04:00:00 AM,48,-122,2,0,2
8813,SpokaneStBridge,01/03/2015 05:00:00 AM,48,-122,1,0,1
8814,SpokaneStBridge,01/03/2015 06:00:00 AM,48,-122,3,3,6
8815,SpokaneStBridge,01/03/2015 07:00:00 AM,48,-122,3,1,4
8816,SpokaneStBridge,01/03/2015 08:00:00 AM,48,-122,6,2,8
8817,SpokaneStBridge,01/03/2015 09:00:00 AM,48,-122,9,5,14
8818,SpokaneStBridge,01/03/2015 10:00:00 AM,48,-122,12,9,21
8819,SpokaneStBridge,01/03/2015 11:00:00 AM,48,-122,10,8,18
8820,SpokaneStBridge,01/03/2015 12:00:00 PM,48,-122,11,15,26
8821,SpokaneStBridge,01/03/2015 01:00:00 PM,48,-122,17,20,37
8822,SpokaneStBridge,01/03/2015 02:00:00 PM,48,-122,6,6,12
8823,SpokaneStBridge,01/03/2015 03:00:00 PM,48,-122,10,8,18
8824,SpokaneStBridge,01/03/2015 04:00:00 PM,48,-122,9,2,11
8825,SpokaneStBridge,01/03/2015 05:00:00 PM,48,-122,3,9,12
8826,SpokaneStBridge,01/03/2015 06:00:00 PM,48,-122,2,2,4
8827,SpokaneStBridge,01/03/2015 07:00:00 PM,48,-122,3,5,8
8828,SpokaneStBridge,01/03/2015 08:00:00 PM,48,-122,2,1,3
8829,SpokaneStBridge,01/03/2015 09:00:00 PM,48,-122,3,3,6
8830,SpokaneStBridge,01/03/2015 10:00:00 PM,48,-122,3,1,4
8831,SpokaneStBridge,01/03/2015 11:00:00 PM,48,-122,1,2,3
8832,SpokaneStBridge,01/04/2015 12:00:00 AM,48,-122,0,1,1
8833,SpokaneStBridge,01/04/2015 01:00:00 AM,48,-122,1,1,2
8834,SpokaneStBridge,01/04/2015 02:00:00 AM,48,-122,0,0,0
8835,SpokaneStBridge,01/04/2015 03:00:00 AM,48,-122,1,1,2
8836,SpokaneStBridge,01/04/2015 04:00:00 AM,48,-122,0,2,2
8837,SpokaneStBridge,01/04/2015 05:00:00 AM,48,-122,4,0,4
8838,SpokaneStBridge,01/04/2015 06:00:00 AM,48,-122,4,2,6
8839,SpokaneStBridge,01/04/2015 07:00:00 AM,48,-122,0,3,3
8840,SpokaneStBridge,01/04/2015 08:00:00 AM,48,-122,5,1,6
8841,SpokaneStBridge,01/04/2015 09:00:00 AM,48,-122,0,3,3
8842,SpokaneStBridge,01/04/2015 10:00:00 AM,48,-122,3,4,7
8843,SpokaneStBridge,01/04/2015 11:00:00 AM,48,-122,5,3,8
8844,SpokaneStBridge,01/04/2015 12:00:00 PM,48,-122,4,1,5
8845,SpokaneStBridge,01/04/2015 01:00:00 PM,48,-122,2,5,7
8846,SpokaneStBridge,01/04/2015 02:00:00 PM,48,-122,0,3,3
8847,SpokaneStBridge,01/04/2015 03:00:00 PM,48,-122,0,4,4
8848,SpokaneStBridge,01/04/2015 04:00:00 PM,48,-122,5,4,9
8849,SpokaneStBridge,01/04/2015 05:00:00 PM,48,-122,8,1,9
8850,SpokaneStBridge,01/04/2015 06:00:00 PM,48,-122,2,2,4
8851,SpokaneStBridge,01/04/2015 07:00:00 PM,48,-122,0,1,1
8852,SpokaneStBridge,01/04/2015 08:00:00 PM,48,-122,0,3,3
8853,SpokaneStBridge,01/04/2015 09:00:00 PM,48,-122,3,0,3
8854,SpokaneStBridge,01/04/2015 10:00:00 PM,48,-122,1,0,1
8855,SpokaneStBridge,01/04/2015 11:00:00 PM,48,-122,0,0,0
8856,SpokaneStBridge,01/05/2015 12:00:00 AM,48,-122,1,0,1
8857,SpokaneStBridge,01/05/2015 01:00:00 AM,48,-122,1,0,1
8858,SpokaneStBridge,01/05/2015 02:00:00 AM,48,-122,0,0,0
8859,SpokaneStBridge,01/05/2015 03:00:00 AM,48,-122,0,1,1
8860,SpokaneStBridge,01/05/2015 04:00:00 AM,48,-122,1,0,1
8861,SpokaneStBridge,01/05/2015 05:00:00 AM,48,-122,13,5,18
8862,SpokaneStBridge,01/05/2015 06:00:00 AM,48,-122,38,7,45
8863,SpokaneStBridge,01/05/2015 07:00:00 AM,48,-122,68,8,76
8864,SpokaneStBridge,01/05/2015 08:00:00 AM,48,-122,68,8,76
8865,SpokaneStBridge,01/05/2015 09:00:00 AM,48,-122,17,0,17
8866,SpokaneStBridge,01/05/2015 10:00:00 AM,48,-122,9,1,10
8867,SpokaneStBridge,01/05/2015 11:00:00 AM,48,-122,2,1,3
8868,SpokaneStBridge,01/05/2015 12:00:00 PM,48,-122,1,1,2
8869,SpokaneStBridge,01/05/2015 01:00:00 PM,48,-122,5,2,7
8870,SpokaneStBridge,01/05/2015 02:00:00 PM,48,-122,6,7,13
8871,SpokaneStBridge,01/05/2015 03:00:00 PM,48,-122,5,12,17
8872,SpokaneStBridge,01/05/2015 04:00:00 PM,48,-122,8,30,38
8873,SpokaneStBridge,01/05/2015 05:00:00 PM,48,-122,20,81,101
8874,SpokaneStBridge,01/05/2015 06:00:00 PM,48,-122,3,52,55
8875,SpokaneStBridge,01/05/2015 07:00:00 PM,48,-122,3,10,13
8876,SpokaneStBridge,01/05/2015 08:00:00 PM,48,-122,1,3,4
8877,SpokaneStBridge,01/05/2015 09:00:00 PM,48,-122,0,2,2
8878,SpokaneStBridge,01/05/2015 10:00:00 PM,48,-122,1,0,1
8879,SpokaneStBridge,01/05/2015 11:00:00 PM,48,-122,0,2,2
8880,SpokaneStBridge,01/06/2015 12:00:00 AM,48,-122,0,0,0
8881,SpokaneStBridge,01/06/2015 01:00:00 AM,48,-122,0,0,0
8882,SpokaneStBridge,01/06/2015 02:00:00 AM,48,-122,1,1,2
8883,SpokaneStBridge,01/06/2015 03:00:00 AM,48,-122,2,1,3
8884,SpokaneStBridge,01/06/2015 04:00:00 AM,48,-122,1,2,3
8885,SpokaneStBridge,01/06/2015 05:00:00 AM,48,-122,17,2,19
8886,SpokaneStBridge,01/06/2015 06:00:00 AM,48,-122,56,5,61
8887,SpokaneStBridge,01/06/2015 07:00:00 AM,48,-122,92,18,110
8888,SpokaneStBridge,01/06/2015 08:00:00 AM,48,-122,108,14,122
8889,SpokaneStBridge,01/06/2015 09:00:00 AM,48,-122,36,8,44
8890,SpokaneStBridge,01/06/2015 10:00:00 AM,48,-122,15,6,21
8891,SpokaneStBridge,01/06/2015 11:00:00 AM,48,-122,10,8,18
8892,SpokaneStBridge,01/06/2015 12:00:00 PM,48,-122,12,8,20
8893,SpokaneStBridge,01/06/2015 01:00:00 PM,48,-122,11,8,19
8894,SpokaneStBridge,01/06/2015 02:00:00 PM,48,-122,5,15,20
8895,SpokaneStBridge,01/06/2015 03:00:00 PM,48,-122,7,25,32
8896,SpokaneStBridge,01/06/2015 04:00:00 PM,48,-122,19,68,87
8897,SpokaneStBridge,01/06/2015 05:00:00 PM,48,-122,13,112,125
8898,SpokaneStBridge,01/06/2015 06:00:00 PM,48,-122,6,70,76
8899,SpokaneStBridge,01/06/2015 07:00:00 PM,48,-122,8,23,31
8900,SpokaneStBridge,01/06/2015 08:00:00 PM,48,-122,2,6,8
8901,SpokaneStBridge,01/06/2015 09:00:00 PM,48,-122,2,9,11
8902,SpokaneStBridge,01/06/2015 10:00:00 PM,48,-122,3,3,6
8903,SpokaneStBridge,01/06/2015 11:00:00 PM,48,-122,1,1,2
8904,SpokaneStBridge,01/07/2015 12:00:00 AM,48,-122,0,0,0
8905,SpokaneStBridge,01/07/2015 01:00:00 AM,48,-122,1,0,1
8906,SpokaneStBridge,01/07/2015 02:00:00 AM,48,-122,0,0,0
8907,SpokaneStBridge,01/07/2015 03:00:00 AM,48,-122,3,0,3
8908,SpokaneStBridge,01/07/2015 04:00:00 AM,48,-122,2,1,3
8909,SpokaneStBridge,01/07/2015 05:00:00 AM,48,-122,15,2,17
8910,SpokaneStBridge,01/07/2015 06:00:00 AM,48,-122,62,10,72
8911,SpokaneStBridge,01/07/2015 07:00:00 AM,48,-122,86,12,98
8912,SpokaneStBridge,01/07/2015 08:00:00 AM,48,-122,99,11,110
8913,SpokaneStBridge,01/07/2015 09:00:00 AM,48,-122,35,5,40
8914,SpokaneStBridge,01/07/2015 10:00:00 AM,48,-122,11,4,15
8915,SpokaneStBridge,01/07/2015 11:00:00 AM,48,-122,15,13,28
8916,SpokaneStBridge,01/07/2015 12:00:00 PM,48,-122,14,4,18
8917,SpokaneStBridge,01/07/2015 01:00:00 PM,48,-122,9,6,15
8918,SpokaneStBridge,01/07/2015 02:00:00 PM,48,-122,9,15,24
8919,SpokaneStBridge,01/07/2015 03:00:00 PM,48,-122,8,38,46
8920,SpokaneStBridge,01/07/2015 04:00:00 PM,48,-122,8,58,66
8921,SpokaneStBridge,01/07/2015 05:00:00 PM,48,-122,19,107,126
8922,SpokaneStBridge,01/07/2015 06:00:00 PM,48,-122,14,74,88
8923,SpokaneStBridge,01/07/2015 07:00:00 PM,48,-122,4,19,23
8924,SpokaneStBridge,01/07/2015 08:00:00 PM,48,-122,2,7,9
8925,SpokaneStBridge,01/07/2015 09:00:00 PM,48,-122,3,5,8
8926,SpokaneStBridge,01/07/2015 10:00:00 PM,48,-122,4,1,5
8927,SpokaneStBridge,01/07/2015 11:00:00 PM,48,-122,0,5,5
8928,SpokaneStBridge,01/08/2015 12:00:00 AM,48,-122,0,3,3
8929,SpokaneStBridge,01/08/2015 01:00:00 AM,48,-122,1,1,2
8930,SpokaneStBridge,01/08/2015 02:00:00 AM,48,-122,1,2,3
8931,SpokaneStBridge,01/08/2015 03:00:00 AM,48,-122,1,1,2
8932,SpokaneStBridge,01/08/2015 04:00:00 AM,48,-122,3,0,3
8933,SpokaneStBridge,01/08/2015 05:00:00 AM,48,-122,15,4,19
8934,SpokaneStBridge,01/08/2015 06:00:00 AM,48,-122,43,7,50
8935,SpokaneStBridge,01/08/2015 07:00:00 AM,48,-122,91,16,107
8936,SpokaneStBridge,01/08/2015 08:00:00 AM,48,-122,89,5,94
8937,SpokaneStBridge,01/08/2015 09:00:00 AM,48,-122,37,3,40
8938,SpokaneStBridge,01/08/2015 10:00:00 AM,48,-122,13,5,18
8939,SpokaneStBridge,01/08/2015 11:00:00 AM,48,-122,11,7,18
8940,SpokaneStBridge,01/08/2015 12:00:00 PM,48,-122,13,12,25
8941,SpokaneStBridge,01/08/2015 01:00:00 PM,48,-122,12,11,23
8942,SpokaneStBridge,01/08/2015 02:00:00 PM,48,-122,13,22,35
8943,SpokaneStBridge,01/08/2015 03:00:00 PM,48,-122,9,25,34
8944,SpokaneStBridge,01/08/2015 04:00:00 PM,48,-122,20,55,75
8945,SpokaneStBridge,01/08/2015 05:00:00 PM,48,-122,17,110,127
8946,SpokaneStBridge,01/08/2015 06:00:00 PM,48,-122,8,47,55
8947,SpokaneStBridge,01/08/2015 07:00:00 PM,48,-122,4,21,25
8948,SpokaneStBridge,01/08/2015 08:00:00 PM,48,-122,3,15,18
8949,SpokaneStBridge,01/08/2015 09:00:00 PM,48,-122,2,2,4
8950,SpokaneStBridge,01/08/2015 10:00:00 PM,48,-122,2,3,5
8951,SpokaneStBridge,01/08/2015 11:00:00 PM,48,-122,1,2,3
8952,SpokaneStBridge,01/09/2015 12:00:00 AM,48,-122,0,3,3
8953,SpokaneStBridge,01/09/2015 01:00:00 AM,48,-122,0,5,5
8954,SpokaneStBridge,01/09/2015 02:00:00 AM,48,-122,2,0,2
8955,SpokaneStBridge,01/09/2015 03:00:00 AM,48,-122,2,0,2
8956,SpokaneStBridge,01/09/2015 04:00:00 AM,48,-122,4,0,4
8957,SpokaneStBridge,01/09/2015 05:00:00 AM,48,-122,12,2,14
8958,SpokaneStBridge,01/09/2015 06:00:00 AM,48,-122,45,7,52
8959,SpokaneStBridge,01/09/2015 07:00:00 AM,48,-122,55,10,65
8960,SpokaneStBridge,01/09/2015 08:00:00 AM,48,-122,88,16,104
8961,SpokaneStBridge,01/09/2015 09:00:00 AM,48,-122,31,5,36
8962,SpokaneStBridge,01/09/2015 10:00:00 AM,48,-122,7,6,13
8963,SpokaneStBridge,01/09/2015 11:00:00 AM,48,-122,7,5,12
8964,SpokaneStBridge,01/09/2015 12:00:00 PM,48,-122,7,12,19
8965,SpokaneStBridge,01/09/2015 01:00:00 PM,48,-122,9,10,19
8966,SpokaneStBridge,01/09/2015 02:00:00 PM,48,-122,6,11,17
8967,SpokaneStBridge,01/09/2015 03:00:00 PM,48,-122,12,22,34
8968,SpokaneStBridge,01/09/2015 04:00:00 PM,48,-122,14,51,65
8969,SpokaneStBridge,01/09/2015 05:00:00 PM,48,-122,8,84,92
8970,SpokaneStBridge,01/09/2015 06:00:00 PM,48,-122,2,40,42
8971,SpokaneStBridge,01/09/2015 07:00:00 PM,48,-122,2,16,18
8972,SpokaneStBridge,01/09/2015 08:00:00 PM,48,-122,3,9,12
8973,SpokaneStBridge,01/09/2015 09:00:00 PM,48,-122,0,4,4
8974,SpokaneStBridge,01/09/2015 10:00:00 PM,48,-122,2,3,5
8975,SpokaneStBridge,01/09/2015 11:00:00 PM,48,-122,1,1,2
8976,SpokaneStBridge,01/10/2015 12:00:00 AM,48,-122,0,3,3
8977,SpokaneStBridge,01/10/2015 01:00:00 AM,48,-122,0,1,1
8978,SpokaneStBridge,01/10/2015 02:00:00 AM,48,-122,0,0,0
8979,SpokaneStBridge,01/10/2015 03:00:00 AM,48,-122,3,0,3
8980,SpokaneStBridge,01/10/2015 04:00:00 AM,48,-122,0,1,1
8981,SpokaneStBridge,01/10/2015 05:00:00 AM,48,-122,1,0,1
8982,SpokaneStBridge,01/10/2015 06:00:00 AM,48,-122,5,1,6
8983,SpokaneStBridge,01/10/2015 07:00:00 AM,48,-122,11,3,14
8984,SpokaneStBridge,01/10/2015 08:00:00 AM,48,-122,14,3,17
8985,SpokaneStBridge,01/10/2015 09:00:00 AM,48,-122,14,9,23
8986,SpokaneStBridge,01/10/2015 10:00:00 AM,48,-122,15,9,24
8987,SpokaneStBridge,01/10/2015 11:00:00 AM,48,-122,8,9,17
8988,SpokaneStBridge,01/10/2015 12:00:00 PM,48,-122,9,10,19
8989,SpokaneStBridge,01/10/2015 01:00:00 PM,48,-122,9,7,16
8990,SpokaneStBridge,01/10/2015 02:00:00 PM,48,-122,7,9,16
8991,SpokaneStBridge,01/10/2015 03:00:00 PM,48,-122,5,9,14
8992,SpokaneStBridge,01/10/2015 04:00:00 PM,48,-122,7,7,14
8993,SpokaneStBridge,01/10/2015 05:00:00 PM,48,-122,3,7,10
8994,SpokaneStBridge,01/10/2015 06:00:00 PM,48,-122,1,4,5
8995,SpokaneStBridge,01/10/2015 07:00:00 PM,48,-122,1,8,9
8996,SpokaneStBridge,01/10/2015 08:00:00 PM,48,-122,2,2,4
8997,SpokaneStBridge,01/10/2015 09:00:00 PM,48,-122,2,4,6
8998,SpokaneStBridge,01/10/2015 10:00:00 PM,48,-122,4,4,8
8999,SpokaneStBridge,01/10/2015 11:00:00 PM,48,-122,0,1,1
9000,SpokaneStBridge,01/11/2015 12:00:00 AM,48,-122,1,1,2
9001,SpokaneStBridge,01/11/2015 01:00:00 AM,48,-122,0,0,0
9002,SpokaneStBridge,01/11/2015 02:00:00 AM,48,-122,1,2,3
9003,SpokaneStBridge,01/11/2015 03:00:00 AM,48,-122,1,0,1
9004,SpokaneStBridge,01/11/2015 04:00:00 AM,48,-122,0,2,2
9005,SpokaneStBridge,01/11/2015 05:00:00 AM,48,-122,4,0,4
9006,SpokaneStBridge,01/11/2015 06:00:00 AM,48,-122,0,0,0
9007,SpokaneStBridge,01/11/2015 07:00:00 AM,48,-122,4,2,6
9008,SpokaneStBridge,01/11/2015 08:00:00 AM,48,-122,8,3,11
9009,SpokaneStBridge,01/11/2015 09:00:00 AM,48,-122,7,11,18
9010,SpokaneStBridge,01/11/2015 10:00:00 AM,48,-122,22,10,32
9011,SpokaneStBridge,01/11/2015 11:00:00 AM,48,-122,10,23,33
9012,SpokaneStBridge,01/11/2015 12:00:00 PM,48,-122,11,11,22
9013,SpokaneStBridge,01/11/2015 01:00:00 PM,48,-122,15,6,21
9014,SpokaneStBridge,01/11/2015 02:00:00 PM,48,-122,11,17,28
9015,SpokaneStBridge,01/11/2015 03:00:00 PM,48,-122,6,5,11
9016,SpokaneStBridge,01/11/2015 04:00:00 PM,48,-122,8,6,14
9017,SpokaneStBridge,01/11/2015 05:00:00 PM,48,-122,8,8,16
9018,SpokaneStBridge,01/11/2015 06:00:00 PM,48,-122,4,3,7
9019,SpokaneStBridge,01/11/2015 07:00:00 PM,48,-122,0,1,1
9020,SpokaneStBridge,01/11/2015 08:00:00 PM,48,-122,2,2,4
9021,SpokaneStBridge,01/11/2015 09:00:00 PM,48,-122,3,1,4
9022,SpokaneStBridge,01/11/2015 10:00:00 PM,48,-122,1,2,3
9023,SpokaneStBridge,01/11/2015 11:00:00 PM,48,-122,0,1,1
9024,SpokaneStBridge,01/12/2015 12:00:00 AM,48,-122,0,0,0
9025,SpokaneStBridge,01/12/2015 01:00:00 AM,48,-122,0,0,0
9026,SpokaneStBridge,01/12/2015 02:00:00 AM,48,-122,0,1,1
9027,SpokaneStBridge,01/12/2015 03:00:00 AM,48,-122,1,2,3
9028,SpokaneStBridge,01/12/2015 04:00:00 AM,48,-122,3,0,3
9029,SpokaneStBridge,01/12/2015 05:00:00 AM,48,-122,15,4,19
9030,SpokaneStBridge,01/12/2015 06:00:00 AM,48,-122,40,6,46
9031,SpokaneStBridge,01/12/2015 07:00:00 AM,48,-122,85,10,95
9032,SpokaneStBridge,01/12/2015 08:00:00 AM,48,-122,94,7,101
9033,SpokaneStBridge,01/12/2015 09:00:00 AM,48,-122,39,4,43
9034,SpokaneStBridge,01/12/2015 10:00:00 AM,48,-122,16,4,20
9035,SpokaneStBridge,01/12/2015 11:00:00 AM,48,-122,9,5,14
9036,SpokaneStBridge,01/12/2015 12:00:00 PM,48,-122,14,8,22
9037,SpokaneStBridge,01/12/2015 01:00:00 PM,48,-122,6,9,15
9038,SpokaneStBridge,01/12/2015 02:00:00 PM,48,-122,11,14,25
9039,SpokaneStBridge,01/12/2015 03:00:00 PM,48,-122,10,28,38
9040,SpokaneStBridge,01/12/2015 04:00:00 PM,48,-122,15,63,78
9041,SpokaneStBridge,01/12/2015 05:00:00 PM,48,-122,13,93,106
9042,SpokaneStBridge,01/12/2015 06:00:00 PM,48,-122,6,58,64
9043,SpokaneStBridge,01/12/2015 07:00:00 PM,48,-122,5,11,16
9044,SpokaneStBridge,01/12/2015 08:00:00 PM,48,-122,2,10,12
9045,SpokaneStBridge,01/12/2015 09:00:00 PM,48,-122,3,2,5
9046,SpokaneStBridge,01/12/2015 10:00:00 PM,48,-122,2,5,7
9047,SpokaneStBridge,01/12/2015 11:00:00 PM,48,-122,1,0,1
9048,SpokaneStBridge,01/13/2015 12:00:00 AM,48,-122,3,2,5
9049,SpokaneStBridge,01/13/2015 01:00:00 AM,48,-122,0,0,0
9050,SpokaneStBridge,01/13/2015 02:00:00 AM,48,-122,0,1,1
9051,SpokaneStBridge,01/13/2015 03:00:00 AM,48,-122,0,0,0
9052,SpokaneStBridge,01/13/2015 04:00:00 AM,48,-122,2,1,3
9053,SpokaneStBridge,01/13/2015 05:00:00 AM,48,-122,14,4,18
9054,SpokaneStBridge,01/13/2015 06:00:00 AM,48,-122,47,8,55
9055,SpokaneStBridge,01/13/2015 07:00:00 AM,48,-122,92,13,105
9056,SpokaneStBridge,01/13/2015 08:00:00 AM,48,-122,109,9,118
9057,SpokaneStBridge,01/13/2015 09:00:00 AM,48,-122,43,4,47
9058,SpokaneStBridge,01/13/2015 10:00:00 AM,48,-122,13,3,16
9059,SpokaneStBridge,01/13/2015 11:00:00 AM,48,-122,9,8,17
9060,SpokaneStBridge,01/13/2015 12:00:00 PM,48,-122,13,9,22
9061,SpokaneStBridge,01/13/2015 01:00:00 PM,48,-122,13,10,23
9062,SpokaneStBridge,01/13/2015 02:00:00 PM,48,-122,9,13,22
9063,SpokaneStBridge,01/13/2015 03:00:00 PM,48,-122,10,29,39
9064,SpokaneStBridge,01/13/2015 04:00:00 PM,48,-122,18,63,81
9065,SpokaneStBridge,01/13/2015 05:00:00 PM,48,-122,17,122,139
9066,SpokaneStBridge,01/13/2015 06:00:00 PM,48,-122,9,60,69
9067,SpokaneStBridge,01/13/2015 07:00:00 PM,48,-122,4,21,25
9068,SpokaneStBridge,01/13/2015 08:00:00 PM,48,-122,2,10,12
9069,SpokaneStBridge,01/13/2015 09:00:00 PM,48,-122,3,6,9
9070,SpokaneStBridge,01/13/2015 10:00:00 PM,48,-122,5,3,8
9071,SpokaneStBridge,01/13/2015 11:00:00 PM,48,-122,2,0,2
9072,SpokaneStBridge,01/14/2015 12:00:00 AM,48,-122,0,1,1
9073,SpokaneStBridge,01/14/2015 01:00:00 AM,48,-122,0,0,0
9074,SpokaneStBridge,01/14/2015 02:00:00 AM,48,-122,0,0,0
9075,SpokaneStBridge,01/14/2015 03:00:00 AM,48,-122,0,4,4
9076,SpokaneStBridge,01/14/2015 04:00:00 AM,48,-122,3,0,3
9077,SpokaneStBridge,01/14/2015 05:00:00 AM,48,-122,23,5,28
9078,SpokaneStBridge,01/14/2015 06:00:00 AM,48,-122,42,6,48
9079,SpokaneStBridge,01/14/2015 07:00:00 AM,48,-122,71,14,85
9080,SpokaneStBridge,01/14/2015 08:00:00 AM,48,-122,81,9,90
9081,SpokaneStBridge,01/14/2015 09:00:00 AM,48,-122,42,9,51
9082,SpokaneStBridge,01/14/2015 10:00:00 AM,48,-122,13,7,20
9083,SpokaneStBridge,01/14/2015 11:00:00 AM,48,-122,6,10,16
9084,SpokaneStBridge,01/14/2015 12:00:00 PM,48,-122,8,9,17
9085,SpokaneStBridge,01/14/2015 01:00:00 PM,48,-122,16,7,23
9086,SpokaneStBridge,01/14/2015 02:00:00 PM,48,-122,14,12,26
9087,SpokaneStBridge,01/14/2015 03:00:00 PM,48,-122,9,31,40
9088,SpokaneStBridge,01/14/2015 04:00:00 PM,48,-122,7,54,61
9089,SpokaneStBridge,01/14/2015 05:00:00 PM,48,-122,22,94,116
9090,SpokaneStBridge,01/14/2015 06:00:00 PM,48,-122,9,62,71
9091,SpokaneStBridge,01/14/2015 07:00:00 PM,48,-122,6,26,32
9092,SpokaneStBridge,01/14/2015 08:00:00 PM,48,-122,3,13,16
9093,SpokaneStBridge,01/14/2015 09:00:00 PM,48,-122,5,5,10
9094,SpokaneStBridge,01/14/2015 10:00:00 PM,48,-122,1,5,6
9095,SpokaneStBridge,01/14/2015 11:00:00 PM,48,-122,1,0,1
9096,SpokaneStBridge,01/15/2015 12:00:00 AM,48,-122,0,0,0
9097,SpokaneStBridge,01/15/2015 01:00:00 AM,48,-122,1,1,2
9098,SpokaneStBridge,01/15/2015 02:00:00 AM,48,-122,0,1,1
9099,SpokaneStBridge,01/15/2015 03:00:00 AM,48,-122,0,1,1
9100,SpokaneStBridge,01/15/2015 04:00:00 AM,48,-122,1,0,1
9101,SpokaneStBridge,01/15/2015 05:00:00 AM,48,-122,10,3,13
9102,SpokaneStBridge,01/15/2015 06:00:00 AM,48,-122,36,8,44
9103,SpokaneStBridge,01/15/2015 07:00:00 AM,48,-122,50,8,58
9104,SpokaneStBridge,01/15/2015 08:00:00 AM,48,-122,77,9,86
9105,SpokaneStBridge,01/15/2015 09:00:00 AM,48,-122,24,7,31
9106,SpokaneStBridge,01/15/2015 10:00:00 AM,48,-122,8,3,11
9107,SpokaneStBridge,01/15/2015 11:00:00 AM,48,-122,5,3,8
9108,SpokaneStBridge,01/15/2015 12:00:00 PM,48,-122,2,5,7
9109,SpokaneStBridge,01/15/2015 01:00:00 PM,48,-122,6,3,9
9110,SpokaneStBridge,01/15/2015 02:00:00 PM,48,-122,5,7,12
9111,SpokaneStBridge,01/15/2015 03:00:00 PM,48,-122,6,13,19
9112,SpokaneStBridge,01/15/2015 04:00:00 PM,48,-122,10,43,53
9113,SpokaneStBridge,01/15/2015 05:00:00 PM,48,-122,16,63,79
9114,SpokaneStBridge,01/15/2015 06:00:00 PM,48,-122,3,39,42
9115,SpokaneStBridge,01/15/2015 07:00:00 PM,48,-122,5,10,15
9116,SpokaneStBridge,01/15/2015 08:00:00 PM,48,-122,1,5,6
9117,SpokaneStBridge,01/15/2015 09:00:00 PM,48,-122,2,0,2
9118,SpokaneStBridge,01/15/2015 10:00:00 PM,48,-122,0,5,5
9119,SpokaneStBridge,01/15/2015 11:00:00 PM,48,-122,0,2,2
9120,SpokaneStBridge,01/16/2015 12:00:00 AM,48,-122,2,3,5
9121,SpokaneStBridge,01/16/2015 01:00:00 AM,48,-122,2,0,2
9122,SpokaneStBridge,01/16/2015 02:00:00 AM,48,-122,0,0,0
9123,SpokaneStBridge,01/16/2015 03:00:00 AM,48,-122,1,0,1
9124,SpokaneStBridge,01/16/2015 04:00:00 AM,48,-122,2,1,3
9125,SpokaneStBridge,01/16/2015 05:00:00 AM,48,-122,10,3,13
9126,SpokaneStBridge,01/16/2015 06:00:00 AM,48,-122,26,5,31
9127,SpokaneStBridge,01/16/2015 07:00:00 AM,48,-122,57,8,65
9128,SpokaneStBridge,01/16/2015 08:00:00 AM,48,-122,72,5,77
9129,SpokaneStBridge,01/16/2015 09:00:00 AM,48,-122,28,3,31
9130,SpokaneStBridge,01/16/2015 10:00:00 AM,48,-122,13,7,20
9131,SpokaneStBridge,01/16/2015 11:00:00 AM,48,-122,13,7,20
9132,SpokaneStBridge,01/16/2015 12:00:00 PM,48,-122,12,2,14
9133,SpokaneStBridge,01/16/2015 01:00:00 PM,48,-122,8,8,16
9134,SpokaneStBridge,01/16/2015 02:00:00 PM,48,-122,8,14,22
9135,SpokaneStBridge,01/16/2015 03:00:00 PM,48,-122,8,18,26
9136,SpokaneStBridge,01/16/2015 04:00:00 PM,48,-122,15,46,61
9137,SpokaneStBridge,01/16/2015 05:00:00 PM,48,-122,11,69,80
9138,SpokaneStBridge,01/16/2015 06:00:00 PM,48,-122,3,39,42
9139,SpokaneStBridge,01/16/2015 07:00:00 PM,48,-122,11,17,28
9140,SpokaneStBridge,01/16/2015 08:00:00 PM,48,-122,2,12,14
9141,SpokaneStBridge,01/16/2015 09:00:00 PM,48,-122,3,6,9
9142,SpokaneStBridge,01/16/2015 10:00:00 PM,48,-122,2,1,3
9143,SpokaneStBridge,01/16/2015 11:00:00 PM,48,-122,0,1,1
9144,SpokaneStBridge,01/17/2015 12:00:00 AM,48,-122,1,0,1
9145,SpokaneStBridge,01/17/2015 01:00:00 AM,48,-122,0,1,1
9146,SpokaneStBridge,01/17/2015 02:00:00 AM,48,-122,2,0,2
9147,SpokaneStBridge,01/17/2015 03:00:00 AM,48,-122,2,2,4
9148,SpokaneStBridge,01/17/2015 04:00:00 AM,48,-122,1,0,1
9149,SpokaneStBridge,01/17/2015 05:00:00 AM,48,-122,4,0,4
9150,SpokaneStBridge,01/17/2015 06:00:00 AM,48,-122,7,2,9
9151,SpokaneStBridge,01/17/2015 07:00:00 AM,48,-122,2,3,5
9152,SpokaneStBridge,01/17/2015 08:00:00 AM,48,-122,5,5,10
9153,SpokaneStBridge,01/17/2015 09:00:00 AM,48,-122,6,3,9
9154,SpokaneStBridge,01/17/2015 10:00:00 AM,48,-122,9,5,14
9155,SpokaneStBridge,01/17/2015 11:00:00 AM,48,-122,12,12,24
9156,SpokaneStBridge,01/17/2015 12:00:00 PM,48,-122,6,2,8
9157,SpokaneStBridge,01/17/2015 01:00:00 PM,48,-122,7,7,14
9158,SpokaneStBridge,01/17/2015 02:00:00 PM,48,-122,6,9,15
9159,SpokaneStBridge,01/17/2015 03:00:00 PM,48,-122,0,11,11
9160,SpokaneStBridge,01/17/2015 04:00:00 PM,48,-122,4,6,10
9161,SpokaneStBridge,01/17/2015 05:00:00 PM,48,-122,5,1,6
9162,SpokaneStBridge,01/17/2015 06:00:00 PM,48,-122,2,3,5
9163,SpokaneStBridge,01/17/2015 07:00:00 PM,48,-122,4,0,4
9164,SpokaneStBridge,01/17/2015 08:00:00 PM,48,-122,1,2,3
9165,SpokaneStBridge,01/17/2015 09:00:00 PM,48,-122,2,2,4
9166,SpokaneStBridge,01/17/2015 10:00:00 PM,48,-122,0,0,0
9167,SpokaneStBridge,01/17/2015 11:00:00 PM,48,-122,0,0,0
9168,SpokaneStBridge,01/18/2015 12:00:00 AM,48,-122,0,2,2
9169,SpokaneStBridge,01/18/2015 01:00:00 AM,48,-122,1,0,1
9170,SpokaneStBridge,01/18/2015 02:00:00 AM,48,-122,1,1,2
9171,SpokaneStBridge,01/18/2015 03:00:00 AM,48,-122,2,1,3
9172,SpokaneStBridge,01/18/2015 04:00:00 AM,48,-122,1,2,3
9173,SpokaneStBridge,01/18/2015 05:00:00 AM,48,-122,2,0,2
9174,SpokaneStBridge,01/18/2015 06:00:00 AM,48,-122,1,1,2
9175,SpokaneStBridge,01/18/2015 07:00:00 AM,48,-122,3,3,6
9176,SpokaneStBridge,01/18/2015 08:00:00 AM,48,-122,9,6,15
9177,SpokaneStBridge,01/18/2015 09:00:00 AM,48,-122,5,3,8
9178,SpokaneStBridge,01/18/2015 10:00:00 AM,48,-122,12,2,14
9179,SpokaneStBridge,01/18/2015 11:00:00 AM,48,-122,4,3,7
9180,SpokaneStBridge,01/18/2015 12:00:00 PM,48,-122,4,2,6
9181,SpokaneStBridge,01/18/2015 01:00:00 PM,48,-122,2,1,3
9182,SpokaneStBridge,01/18/2015 02:00:00 PM,48,-122,3,5,8
9183,SpokaneStBridge,01/18/2015 03:00:00 PM,48,-122,1,2,3
9184,SpokaneStBridge,01/18/2015 04:00:00 PM,48,-122,5,2,7
9185,SpokaneStBridge,01/18/2015 05:00:00 PM,48,-122,5,2,7
9186,SpokaneStBridge,01/18/2015 06:00:00 PM,48,-122,0,3,3
9187,SpokaneStBridge,01/18/2015 07:00:00 PM,48,-122,0,3,3
9188,SpokaneStBridge,01/18/2015 08:00:00 PM,48,-122,0,0,0
9189,SpokaneStBridge,01/18/2015 09:00:00 PM,48,-122,1,2,3
9190,SpokaneStBridge,01/18/2015 10:00:00 PM,48,-122,0,1,1
9191,SpokaneStBridge,01/18/2015 11:00:00 PM,48,-122,0,0,0
9192,SpokaneStBridge,01/19/2015 12:00:00 AM,48,-122,0,1,1
9193,SpokaneStBridge,01/19/2015 01:00:00 AM,48,-122,0,0,0
9194,SpokaneStBridge,01/19/2015 02:00:00 AM,48,-122,1,1,2
9195,SpokaneStBridge,01/19/2015 03:00:00 AM,48,-122,2,1,3
9196,SpokaneStBridge,01/19/2015 04:00:00 AM,48,-122,2,0,2
9197,SpokaneStBridge,01/19/2015 05:00:00 AM,48,-122,8,3,11
9198,SpokaneStBridge,01/19/2015 06:00:00 AM,48,-122,20,7,27
9199,SpokaneStBridge,01/19/2015 07:00:00 AM,48,-122,36,7,43
9200,SpokaneStBridge,01/19/2015 08:00:00 AM,48,-122,51,6,57
9201,SpokaneStBridge,01/19/2015 09:00:00 AM,48,-122,21,15,36
9202,SpokaneStBridge,01/19/2015 10:00:00 AM,48,-122,12,10,22
9203,SpokaneStBridge,01/19/2015 11:00:00 AM,48,-122,12,11,23
9204,SpokaneStBridge,01/19/2015 12:00:00 PM,48,-122,13,11,24
9205,SpokaneStBridge,01/19/2015 01:00:00 PM,48,-122,14,17,31
9206,SpokaneStBridge,01/19/2015 02:00:00 PM,48,-122,17,11,28
9207,SpokaneStBridge,01/19/2015 03:00:00 PM,48,-122,11,17,28
9208,SpokaneStBridge,01/19/2015 04:00:00 PM,48,-122,25,38,63
9209,SpokaneStBridge,01/19/2015 05:00:00 PM,48,-122,16,57,73
9210,SpokaneStBridge,01/19/2015 06:00:00 PM,48,-122,3,26,29
9211,SpokaneStBridge,01/19/2015 07:00:00 PM,48,-122,3,12,15
9212,SpokaneStBridge,01/19/2015 08:00:00 PM,48,-122,2,3,5
9213,SpokaneStBridge,01/19/2015 09:00:00 PM,48,-122,1,4,5
9214,SpokaneStBridge,01/19/2015 10:00:00 PM,48,-122,1,2,3
9215,SpokaneStBridge,01/19/2015 11:00:00 PM,48,-122,2,0,2
9216,SpokaneStBridge,01/20/2015 12:00:00 AM,48,-122,1,1,2
9217,SpokaneStBridge,01/20/2015 01:00:00 AM,48,-122,1,2,3
9218,SpokaneStBridge,01/20/2015 02:00:00 AM,48,-122,0,0,0
9219,SpokaneStBridge,01/20/2015 03:00:00 AM,48,-122,1,0,1
9220,SpokaneStBridge,01/20/2015 04:00:00 AM,48,-122,1,4,5
9221,SpokaneStBridge,01/20/2015 05:00:00 AM,48,-122,21,1,22
9222,SpokaneStBridge,01/20/2015 06:00:00 AM,48,-122,38,12,50
9223,SpokaneStBridge,01/20/2015 07:00:00 AM,48,-122,98,11,109
9224,SpokaneStBridge,01/20/2015 08:00:00 AM,48,-122,90,8,98
9225,SpokaneStBridge,01/20/2015 09:00:00 AM,48,-122,36,5,41
9226,SpokaneStBridge,01/20/2015 10:00:00 AM,48,-122,18,8,26
9227,SpokaneStBridge,01/20/2015 11:00:00 AM,48,-122,11,10,21
9228,SpokaneStBridge,01/20/2015 12:00:00 PM,48,-122,6,7,13
9229,SpokaneStBridge,01/20/2015 01:00:00 PM,48,-122,18,17,35
9230,SpokaneStBridge,01/20/2015 02:00:00 PM,48,-122,24,30,54
9231,SpokaneStBridge,01/20/2015 03:00:00 PM,48,-122,24,30,54
9232,SpokaneStBridge,01/20/2015 04:00:00 PM,48,-122,16,54,70
9233,SpokaneStBridge,01/20/2015 05:00:00 PM,48,-122,15,123,138
9234,SpokaneStBridge,01/20/2015 06:00:00 PM,48,-122,9,71,80
9235,SpokaneStBridge,01/20/2015 07:00:00 PM,48,-122,10,25,35
9236,SpokaneStBridge,01/20/2015 08:00:00 PM,48,-122,4,14,18
9237,SpokaneStBridge,01/20/2015 09:00:00 PM,48,-122,2,5,7
9238,SpokaneStBridge,01/20/2015 10:00:00 PM,48,-122,3,4,7
9239,SpokaneStBridge,01/20/2015 11:00:00 PM,48,-122,0,1,1
9240,SpokaneStBridge,01/21/2015 12:00:00 AM,48,-122,0,1,1
9241,SpokaneStBridge,01/21/2015 01:00:00 AM,48,-122,0,1,1
9242,SpokaneStBridge,01/21/2015 02:00:00 AM,48,-122,0,0,0
9243,SpokaneStBridge,01/21/2015 03:00:00 AM,48,-122,1,0,1
9244,SpokaneStBridge,01/21/2015 04:00:00 AM,48,-122,4,1,5
9245,SpokaneStBridge,01/21/2015 05:00:00 AM,48,-122,13,4,17
9246,SpokaneStBridge,01/21/2015 06:00:00 AM,48,-122,46,8,54
9247,SpokaneStBridge,01/21/2015 07:00:00 AM,48,-122,82,14,96
9248,SpokaneStBridge,01/21/2015 08:00:00 AM,48,-122,85,10,95
9249,SpokaneStBridge,01/21/2015 09:00:00 AM,48,-122,33,9,42
9250,SpokaneStBridge,01/21/2015 10:00:00 AM,48,-122,11,2,13
9251,SpokaneStBridge,01/21/2015 11:00:00 AM,48,-122,12,5,17
9252,SpokaneStBridge,01/21/2015 12:00:00 PM,48,-122,7,7,14
9253,SpokaneStBridge,01/21/2015 01:00:00 PM,48,-122,12,5,17
9254,SpokaneStBridge,01/21/2015 02:00:00 PM,48,-122,10,16,26
9255,SpokaneStBridge,01/21/2015 03:00:00 PM,48,-122,6,25,31
9256,SpokaneStBridge,01/21/2015 04:00:00 PM,48,-122,10,58,68
9257,SpokaneStBridge,01/21/2015 05:00:00 PM,48,-122,13,108,121
9258,SpokaneStBridge,01/21/2015 06:00:00 PM,48,-122,3,63,66
9259,SpokaneStBridge,01/21/2015 07:00:00 PM,48,-122,4,30,34
9260,SpokaneStBridge,01/21/2015 08:00:00 PM,48,-122,5,14,19
9261,SpokaneStBridge,01/21/2015 09:00:00 PM,48,-122,3,4,7
9262,SpokaneStBridge,01/21/2015 10:00:00 PM,48,-122,0,3,3
9263,SpokaneStBridge,01/21/2015 11:00:00 PM,48,-122,1,3,4
9264,SpokaneStBridge,01/22/2015 12:00:00 AM,48,-122,0,1,1
9265,SpokaneStBridge,01/22/2015 01:00:00 AM,48,-122,0,0,0
9266,SpokaneStBridge,01/22/2015 02:00:00 AM,48,-122,1,0,1
9267,SpokaneStBridge,01/22/2015 03:00:00 AM,48,-122,0,0,0
9268,SpokaneStBridge,01/22/2015 04:00:00 AM,48,-122,3,0,3
9269,SpokaneStBridge,01/22/2015 05:00:00 AM,48,-122,11,4,15
9270,SpokaneStBridge,01/22/2015 06:00:00 AM,48,-122,34,4,38
9271,SpokaneStBridge,01/22/2015 07:00:00 AM,48,-122,66,10,76
9272,SpokaneStBridge,01/22/2015 08:00:00 AM,48,-122,82,6,88
9273,SpokaneStBridge,01/22/2015 09:00:00 AM,48,-122,39,1,40
9274,SpokaneStBridge,01/22/2015 10:00:00 AM,48,-122,7,1,8
9275,SpokaneStBridge,01/22/2015 11:00:00 AM,48,-122,9,5,14
9276,SpokaneStBridge,01/22/2015 12:00:00 PM,48,-122,8,11,19
9277,SpokaneStBridge,01/22/2015 01:00:00 PM,48,-122,6,3,9
9278,SpokaneStBridge,01/22/2015 02:00:00 PM,48,-122,4,11,15
9279,SpokaneStBridge,01/22/2015 03:00:00 PM,48,-122,5,18,23
9280,SpokaneStBridge,01/22/2015 04:00:00 PM,48,-122,13,38,51
9281,SpokaneStBridge,01/22/2015 05:00:00 PM,48,-122,13,85,98
9282,SpokaneStBridge,01/22/2015 06:00:00 PM,48,-122,5,53,58
9283,SpokaneStBridge,01/22/2015 07:00:00 PM,48,-122,3,22,25
9284,SpokaneStBridge,01/22/2015 08:00:00 PM,48,-122,0,12,12
9285,SpokaneStBridge,01/22/2015 09:00:00 PM,48,-122,4,3,7
9286,SpokaneStBridge,01/22/2015 10:00:00 PM,48,-122,2,6,8
9287,SpokaneStBridge,01/22/2015 11:00:00 PM,48,-122,2,6,8
9288,SpokaneStBridge,01/23/2015 12:00:00 AM,48,-122,0,5,5
9289,SpokaneStBridge,01/23/2015 01:00:00 AM,48,-122,0,3,3
9290,SpokaneStBridge,01/23/2015 02:00:00 AM,48,-122,0,0,0
9291,SpokaneStBridge,01/23/2015 03:00:00 AM,48,-122,2,0,2
9292,SpokaneStBridge,01/23/2015 04:00:00 AM,48,-122,4,0,4
9293,SpokaneStBridge,01/23/2015 05:00:00 AM,48,-122,9,2,11
9294,SpokaneStBridge,01/23/2015 06:00:00 AM,48,-122,30,8,38
9295,SpokaneStBridge,01/23/2015 07:00:00 AM,48,-122,53,10,63
9296,SpokaneStBridge,01/23/2015 08:00:00 AM,48,-122,69,10,79
9297,SpokaneStBridge,01/23/2015 09:00:00 AM,48,-122,33,8,41
9298,SpokaneStBridge,01/23/2015 10:00:00 AM,48,-122,11,4,15
9299,SpokaneStBridge,01/23/2015 11:00:00 AM,48,-122,2,0,2
9300,SpokaneStBridge,01/23/2015 12:00:00 PM,48,-122,5,3,8
9301,SpokaneStBridge,01/23/2015 01:00:00 PM,48,-122,4,7,11
9302,SpokaneStBridge,01/23/2015 02:00:00 PM,48,-122,6,13,19
9303,SpokaneStBridge,01/23/2015 03:00:00 PM,48,-122,3,16,19
9304,SpokaneStBridge,01/23/2015 04:00:00 PM,48,-122,7,37,44
9305,SpokaneStBridge,01/23/2015 05:00:00 PM,48,-122,13,60,73
9306,SpokaneStBridge,01/23/2015 06:00:00 PM,48,-122,6,41,47
9307,SpokaneStBridge,01/23/2015 07:00:00 PM,48,-122,5,14,19
9308,SpokaneStBridge,01/23/2015 08:00:00 PM,48,-122,3,13,16
9309,SpokaneStBridge,01/23/2015 09:00:00 PM,48,-122,1,2,3
9310,SpokaneStBridge,01/23/2015 10:00:00 PM,48,-122,0,2,2
9311,SpokaneStBridge,01/23/2015 11:00:00 PM,48,-122,4,3,7
9312,SpokaneStBridge,01/24/2015 12:00:00 AM,48,-122,4,0,4
9313,SpokaneStBridge,01/24/2015 01:00:00 AM,48,-122,1,2,3
9314,SpokaneStBridge,01/24/2015 02:00:00 AM,48,-122,5,1,6
9315,SpokaneStBridge,01/24/2015 03:00:00 AM,48,-122,4,0,4
9316,SpokaneStBridge,01/24/2015 04:00:00 AM,48,-122,1,0,1
9317,SpokaneStBridge,01/24/2015 05:00:00 AM,48,-122,3,0,3
9318,SpokaneStBridge,01/24/2015 06:00:00 AM,48,-122,3,2,5
9319,SpokaneStBridge,01/24/2015 07:00:00 AM,48,-122,4,0,4
9320,SpokaneStBridge,01/24/2015 08:00:00 AM,48,-122,13,9,22
9321,SpokaneStBridge,01/24/2015 09:00:00 AM,48,-122,19,7,26
9322,SpokaneStBridge,01/24/2015 10:00:00 AM,48,-122,7,5,12
9323,SpokaneStBridge,01/24/2015 11:00:00 AM,48,-122,7,12,19
9324,SpokaneStBridge,01/24/2015 12:00:00 PM,48,-122,13,9,22
9325,SpokaneStBridge,01/24/2015 01:00:00 PM,48,-122,14,21,35
9326,SpokaneStBridge,01/24/2015 02:00:00 PM,48,-122,11,17,28
9327,SpokaneStBridge,01/24/2015 03:00:00 PM,48,-122,17,18,35
9328,SpokaneStBridge,01/24/2015 04:00:00 PM,48,-122,15,10,25
9329,SpokaneStBridge,01/24/2015 05:00:00 PM,48,-122,10,13,23
9330,SpokaneStBridge,01/24/2015 06:00:00 PM,48,-122,5,7,12
9331,SpokaneStBridge,01/24/2015 07:00:00 PM,48,-122,0,4,4
9332,SpokaneStBridge,01/24/2015 08:00:00 PM,48,-122,3,3,6
9333,SpokaneStBridge,01/24/2015 09:00:00 PM,48,-122,4,1,5
9334,SpokaneStBridge,01/24/2015 10:00:00 PM,48,-122,2,2,4
9335,SpokaneStBridge,01/24/2015 11:00:00 PM,48,-122,1,0,1
9336,SpokaneStBridge,01/25/2015 12:00:00 AM,48,-122,0,2,2
9337,SpokaneStBridge,01/25/2015 01:00:00 AM,48,-122,0,3,3
9338,SpokaneStBridge,01/25/2015 02:00:00 AM,48,-122,0,4,4
9339,SpokaneStBridge,01/25/2015 03:00:00 AM,48,-122,4,1,5
9340,SpokaneStBridge,01/25/2015 04:00:00 AM,48,-122,3,3,6
9341,SpokaneStBridge,01/25/2015 05:00:00 AM,48,-122,2,1,3
9342,SpokaneStBridge,01/25/2015 06:00:00 AM,48,-122,3,1,4
9343,SpokaneStBridge,01/25/2015 07:00:00 AM,48,-122,6,1,7
9344,SpokaneStBridge,01/25/2015 08:00:00 AM,48,-122,7,8,15
9345,SpokaneStBridge,01/25/2015 09:00:00 AM,48,-122,24,9,33
9346,SpokaneStBridge,01/25/2015 10:00:00 AM,48,-122,22,14,36
9347,SpokaneStBridge,01/25/2015 11:00:00 AM,48,-122,29,36,65
9348,SpokaneStBridge,01/25/2015 12:00:00 PM,48,-122,37,51,88
9349,SpokaneStBridge,01/25/2015 01:00:00 PM,48,-122,63,53,116
9350,SpokaneStBridge,01/25/2015 02:00:00 PM,48,-122,59,55,114
9351,SpokaneStBridge,01/25/2015 03:00:00 PM,48,-122,46,49,95
9352,SpokaneStBridge,01/25/2015 04:00:00 PM,48,-122,41,29,70
9353,SpokaneStBridge,01/25/2015 05:00:00 PM,48,-122,38,26,64
9354,SpokaneStBridge,01/25/2015 06:00:00 PM,48,-122,3,13,16
9355,SpokaneStBridge,01/25/2015 07:00:00 PM,48,-122,1,5,6
9356,SpokaneStBridge,01/25/2015 08:00:00 PM,48,-122,1,6,7
9357,SpokaneStBridge,01/25/2015 09:00:00 PM,48,-122,2,0,2
9358,SpokaneStBridge,01/25/2015 10:00:00 PM,48,-122,0,0,0
9359,SpokaneStBridge,01/25/2015 11:00:00 PM,48,-122,2,0,2
9360,SpokaneStBridge,01/26/2015 12:00:00 AM,48,-122,0,1,1
9361,SpokaneStBridge,01/26/2015 01:00:00 AM,48,-122,1,0,1
9362,SpokaneStBridge,01/26/2015 02:00:00 AM,48,-122,1,0,1
9363,SpokaneStBridge,01/26/2015 03:00:00 AM,48,-122,4,0,4
9364,SpokaneStBridge,01/26/2015 04:00:00 AM,48,-122,4,1,5
9365,SpokaneStBridge,01/26/2015 05:00:00 AM,48,-122,19,7,26
9366,SpokaneStBridge,01/26/2015 06:00:00 AM,48,-122,47,10,57
9367,SpokaneStBridge,01/26/2015 07:00:00 AM,48,-122,106,9,115
9368,SpokaneStBridge,01/26/2015 08:00:00 AM,48,-122,87,12,99
9369,SpokaneStBridge,01/26/2015 09:00:00 AM,48,-122,45,13,58
9370,SpokaneStBridge,01/26/2015 10:00:00 AM,48,-122,22,9,31
9371,SpokaneStBridge,01/26/2015 11:00:00 AM,48,-122,8,5,13
9372,SpokaneStBridge,01/26/2015 12:00:00 PM,48,-122,17,16,33
9373,SpokaneStBridge,01/26/2015 01:00:00 PM,48,-122,21,17,38
9374,SpokaneStBridge,01/26/2015 02:00:00 PM,48,-122,22,24,46
9375,SpokaneStBridge,01/26/2015 03:00:00 PM,48,-122,15,33,48
9376,SpokaneStBridge,01/26/2015 04:00:00 PM,48,-122,25,75,100
9377,SpokaneStBridge,01/26/2015 05:00:00 PM,48,-122,15,101,116
9378,SpokaneStBridge,01/26/2015 06:00:00 PM,48,-122,12,86,98
9379,SpokaneStBridge,01/26/2015 07:00:00 PM,48,-122,8,16,24
9380,SpokaneStBridge,01/26/2015 08:00:00 PM,48,-122,2,8,10
9381,SpokaneStBridge,01/26/2015 09:00:00 PM,48,-122,9,8,17
9382,SpokaneStBridge,01/26/2015 10:00:00 PM,48,-122,0,7,7
9383,SpokaneStBridge,01/26/2015 11:00:00 PM,48,-122,4,2,6
9384,SpokaneStBridge,01/27/2015 12:00:00 AM,48,-122,2,2,4
9385,SpokaneStBridge,01/27/2015 01:00:00 AM,48,-122,0,2,2
9386,SpokaneStBridge,01/27/2015 02:00:00 AM,48,-122,0,1,1
9387,SpokaneStBridge,01/27/2015 03:00:00 AM,48,-122,2,0,2
9388,SpokaneStBridge,01/27/2015 04:00:00 AM,48,-122,0,1,1
9389,SpokaneStBridge,01/27/2015 05:00:00 AM,48,-122,17,4,21
9390,SpokaneStBridge,01/27/2015 06:00:00 AM,48,-122,45,11,56
9391,SpokaneStBridge,01/27/2015 07:00:00 AM,48,-122,109,10,119
9392,SpokaneStBridge,01/27/2015 08:00:00 AM,48,-122,102,16,118
9393,SpokaneStBridge,01/27/2015 09:00:00 AM,48,-122,29,4,33
9394,SpokaneStBridge,01/27/2015 10:00:00 AM,48,-122,19,6,25
9395,SpokaneStBridge,01/27/2015 11:00:00 AM,48,-122,5,7,12
9396,SpokaneStBridge,01/27/2015 12:00:00 PM,48,-122,8,8,16
9397,SpokaneStBridge,01/27/2015 01:00:00 PM,48,-122,5,6,11
9398,SpokaneStBridge,01/27/2015 02:00:00 PM,48,-122,7,13,20
9399,SpokaneStBridge,01/27/2015 03:00:00 PM,48,-122,8,20,28
9400,SpokaneStBridge,01/27/2015 04:00:00 PM,48,-122,12,48,60
9401,SpokaneStBridge,01/27/2015 05:00:00 PM,48,-122,11,104,115
9402,SpokaneStBridge,01/27/2015 06:00:00 PM,48,-122,7,57,64
9403,SpokaneStBridge,01/27/2015 07:00:00 PM,48,-122,2,31,33
9404,SpokaneStBridge,01/27/2015 08:00:00 PM,48,-122,9,15,24
9405,SpokaneStBridge,01/27/2015 09:00:00 PM,48,-122,2,6,8
9406,SpokaneStBridge,01/27/2015 10:00:00 PM,48,-122,1,5,6
9407,SpokaneStBridge,01/27/2015 11:00:00 PM,48,-122,2,1,3
9408,SpokaneStBridge,01/28/2015 12:00:00 AM,48,-122,1,1,2
9409,SpokaneStBridge,01/28/2015 01:00:00 AM,48,-122,0,1,1
9410,SpokaneStBridge,01/28/2015 02:00:00 AM,48,-122,0,3,3
9411,SpokaneStBridge,01/28/2015 03:00:00 AM,48,-122,0,1,1
9412,SpokaneStBridge,01/28/2015 04:00:00 AM,48,-122,4,2,6
9413,SpokaneStBridge,01/28/2015 05:00:00 AM,48,-122,18,5,23
9414,SpokaneStBridge,01/28/2015 06:00:00 AM,48,-122,49,10,59
9415,SpokaneStBridge,01/28/2015 07:00:00 AM,48,-122,88,8,96
9416,SpokaneStBridge,01/28/2015 08:00:00 AM,48,-122,78,8,86
9417,SpokaneStBridge,01/28/2015 09:00:00 AM,48,-122,41,9,50
9418,SpokaneStBridge,01/28/2015 10:00:00 AM,48,-122,16,6,22
9419,SpokaneStBridge,01/28/2015 11:00:00 AM,48,-122,13,9,22
9420,SpokaneStBridge,01/28/2015 12:00:00 PM,48,-122,16,11,27
9421,SpokaneStBridge,01/28/2015 01:00:00 PM,48,-122,11,6,17
9422,SpokaneStBridge,01/28/2015 02:00:00 PM,48,-122,13,15,28
9423,SpokaneStBridge,01/28/2015 03:00:00 PM,48,-122,10,28,38
9424,SpokaneStBridge,01/28/2015 04:00:00 PM,48,-122,17,52,69
9425,SpokaneStBridge,01/28/2015 05:00:00 PM,48,-122,14,93,107
9426,SpokaneStBridge,01/28/2015 06:00:00 PM,48,-122,11,56,67
9427,SpokaneStBridge,01/28/2015 07:00:00 PM,48,-122,3,22,25
9428,SpokaneStBridge,01/28/2015 08:00:00 PM,48,-122,1,17,18
9429,SpokaneStBridge,01/28/2015 09:00:00 PM,48,-122,1,6,7
9430,SpokaneStBridge,01/28/2015 10:00:00 PM,48,-122,1,2,3
9431,SpokaneStBridge,01/28/2015 11:00:00 PM,48,-122,3,2,5
9432,SpokaneStBridge,01/29/2015 12:00:00 AM,48,-122,0,2,2
9433,SpokaneStBridge,01/29/2015 01:00:00 AM,48,-122,0,0,0
9434,SpokaneStBridge,01/29/2015 02:00:00 AM,48,-122,2,2,4
9435,SpokaneStBridge,01/29/2015 03:00:00 AM,48,-122,1,0,1
9436,SpokaneStBridge,01/29/2015 04:00:00 AM,48,-122,3,0,3
9437,SpokaneStBridge,01/29/2015 05:00:00 AM,48,-122,18,7,25
9438,SpokaneStBridge,01/29/2015 06:00:00 AM,48,-122,42,10,52
9439,SpokaneStBridge,01/29/2015 07:00:00 AM,48,-122,89,15,104
9440,SpokaneStBridge,01/29/2015 08:00:00 AM,48,-122,95,13,108
9441,SpokaneStBridge,01/29/2015 09:00:00 AM,48,-122,30,1,31
9442,SpokaneStBridge,01/29/2015 10:00:00 AM,48,-122,17,3,20
9443,SpokaneStBridge,01/29/2015 11:00:00 AM,48,-122,14,13,27
9444,SpokaneStBridge,01/29/2015 12:00:00 PM,48,-122,13,9,22
9445,SpokaneStBridge,01/29/2015 01:00:00 PM,48,-122,24,13,37
9446,SpokaneStBridge,01/29/2015 02:00:00 PM,48,-122,6,20,26
9447,SpokaneStBridge,01/29/2015 03:00:00 PM,48,-122,14,30,44
9448,SpokaneStBridge,01/29/2015 04:00:00 PM,48,-122,22,58,80
9449,SpokaneStBridge,01/29/2015 05:00:00 PM,48,-122,18,106,124
9450,SpokaneStBridge,01/29/2015 06:00:00 PM,48,-122,12,73,85
9451,SpokaneStBridge,01/29/2015 07:00:00 PM,48,-122,4,28,32
9452,SpokaneStBridge,01/29/2015 08:00:00 PM,48,-122,5,15,20
9453,SpokaneStBridge,01/29/2015 09:00:00 PM,48,-122,4,4,8
9454,SpokaneStBridge,01/29/2015 10:00:00 PM,48,-122,3,2,5
9455,SpokaneStBridge,01/29/2015 11:00:00 PM,48,-122,2,4,6
9456,SpokaneStBridge,01/30/2015 12:00:00 AM,48,-122,1,1,2
9457,SpokaneStBridge,01/30/2015 01:00:00 AM,48,-122,2,2,4
9458,SpokaneStBridge,01/30/2015 02:00:00 AM,48,-122,0,2,2
9459,SpokaneStBridge,01/30/2015 03:00:00 AM,48,-122,1,0,1
9460,SpokaneStBridge,01/30/2015 04:00:00 AM,48,-122,5,1,6
9461,SpokaneStBridge,01/30/2015 05:00:00 AM,48,-122,13,5,18
9462,SpokaneStBridge,01/30/2015 06:00:00 AM,48,-122,30,3,33
9463,SpokaneStBridge,01/30/2015 07:00:00 AM,48,-122,69,4,73
9464,SpokaneStBridge,01/30/2015 08:00:00 AM,48,-122,92,11,103
9465,SpokaneStBridge,01/30/2015 09:00:00 AM,48,-122,25,4,29
9466,SpokaneStBridge,01/30/2015 10:00:00 AM,48,-122,10,5,15
9467,SpokaneStBridge,01/30/2015 11:00:00 AM,48,-122,5,3,8
9468,SpokaneStBridge,01/30/2015 12:00:00 PM,48,-122,10,7,17
9469,SpokaneStBridge,01/30/2015 01:00:00 PM,48,-122,6,13,19
9470,SpokaneStBridge,01/30/2015 02:00:00 PM,48,-122,14,9,23
9471,SpokaneStBridge,01/30/2015 03:00:00 PM,48,-122,12,25,37
9472,SpokaneStBridge,01/30/2015 04:00:00 PM,48,-122,2,60,62
9473,SpokaneStBridge,01/30/2015 05:00:00 PM,48,-122,12,77,89
9474,SpokaneStBridge,01/30/2015 06:00:00 PM,48,-122,7,46,53
9475,SpokaneStBridge,01/30/2015 07:00:00 PM,48,-122,1,20,21
9476,SpokaneStBridge,01/30/2015 08:00:00 PM,48,-122,1,5,6
9477,SpokaneStBridge,01/30/2015 09:00:00 PM,48,-122,3,5,8
9478,SpokaneStBridge,01/30/2015 10:00:00 PM,48,-122,0,7,7
9479,SpokaneStBridge,01/30/2015 11:00:00 PM,48,-122,3,1,4
9480,SpokaneStBridge,01/31/2015 12:00:00 AM,48,-122,0,1,1
9481,SpokaneStBridge,01/31/2015 01:00:00 AM,48,-122,1,1,2
9482,SpokaneStBridge,01/31/2015 02:00:00 AM,48,-122,0,0,0
9483,SpokaneStBridge,01/31/2015 03:00:00 AM,48,-122,3,4,7
9484,SpokaneStBridge,01/31/2015 04:00:00 AM,48,-122,3,0,3
9485,SpokaneStBridge,01/31/2015 05:00:00 AM,48,-122,2,0,2
9486,SpokaneStBridge,01/31/2015 06:00:00 AM,48,-122,4,2,6
9487,SpokaneStBridge,01/31/2015 07:00:00 AM,48,-122,8,2,10
9488,SpokaneStBridge,01/31/2015 08:00:00 AM,48,-122,14,5,19
9489,SpokaneStBridge,01/31/2015 09:00:00 AM,48,-122,10,9,19
9490,SpokaneStBridge,01/31/2015 10:00:00 AM,48,-122,21,15,36
9491,SpokaneStBridge,01/31/2015 11:00:00 AM,48,-122,14,14,28
9492,SpokaneStBridge,01/31/2015 12:00:00 PM,48,-122,11,13,24
9493,SpokaneStBridge,01/31/2015 01:00:00 PM,48,-122,19,37,56
9494,SpokaneStBridge,01/31/2015 02:00:00 PM,48,-122,21,24,45
9495,SpokaneStBridge,01/31/2015 03:00:00 PM,48,-122,25,18,43
9496,SpokaneStBridge,01/31/2015 04:00:00 PM,48,-122,33,15,48
9497,SpokaneStBridge,01/31/2015 05:00:00 PM,48,-122,17,12,29
9498,SpokaneStBridge,01/31/2015 06:00:00 PM,48,-122,4,13,17
9499,SpokaneStBridge,01/31/2015 07:00:00 PM,48,-122,5,3,8
9500,SpokaneStBridge,01/31/2015 08:00:00 PM,48,-122,1,3,4
9501,SpokaneStBridge,01/31/2015 09:00:00 PM,48,-122,3,2,5
9502,SpokaneStBridge,01/31/2015 10:00:00 PM,48,-122,0,2,2
9503,SpokaneStBridge,01/31/2015 11:00:00 PM,48,-122,2,14,16
9504,SpokaneStBridge,02/01/2015 12:00:00 AM,48,-122,2,2,4
9505,SpokaneStBridge,02/01/2015 01:00:00 AM,48,-122,0,0,0
9506,SpokaneStBridge,02/01/2015 02:00:00 AM,48,-122,1,1,2
9507,SpokaneStBridge,02/01/2015 03:00:00 AM,48,-122,2,0,2
9508,SpokaneStBridge,02/01/2015 04:00:00 AM,48,-122,1,1,2
9509,SpokaneStBridge,02/01/2015 05:00:00 AM,48,-122,0,1,1
9510,SpokaneStBridge,02/01/2015 06:00:00 AM,48,-122,1,1,2
9511,SpokaneStBridge,02/01/2015 07:00:00 AM,48,-122,3,1,4
9512,SpokaneStBridge,02/01/2015 08:00:00 AM,48,-122,7,3,10
9513,SpokaneStBridge,02/01/2015 09:00:00 AM,48,-122,9,6,15
9514,SpokaneStBridge,02/01/2015 10:00:00 AM,48,-122,7,19,26
9515,SpokaneStBridge,02/01/2015 11:00:00 AM,48,-122,21,11,32
9516,SpokaneStBridge,02/01/2015 12:00:00 PM,48,-122,9,10,19
9517,SpokaneStBridge,02/01/2015 01:00:00 PM,48,-122,11,3,14
9518,SpokaneStBridge,02/01/2015 02:00:00 PM,48,-122,4,5,9
9519,SpokaneStBridge,02/01/2015 03:00:00 PM,48,-122,7,5,12
9520,SpokaneStBridge,02/01/2015 04:00:00 PM,48,-122,2,6,8
9521,SpokaneStBridge,02/01/2015 05:00:00 PM,48,-122,1,2,3
9522,SpokaneStBridge,02/01/2015 06:00:00 PM,48,-122,1,0,1
9523,SpokaneStBridge,02/01/2015 07:00:00 PM,48,-122,7,2,9
9524,SpokaneStBridge,02/01/2015 08:00:00 PM,48,-122,0,4,4
9525,SpokaneStBridge,02/01/2015 09:00:00 PM,48,-122,2,2,4
9526,SpokaneStBridge,02/01/2015 10:00:00 PM,48,-122,0,3,3
9527,SpokaneStBridge,02/01/2015 11:00:00 PM,48,-122,3,1,4
9528,SpokaneStBridge,02/02/2015 12:00:00 AM,48,-122,0,0,0
9529,SpokaneStBridge,02/02/2015 01:00:00 AM,48,-122,1,0,1
9530,SpokaneStBridge,02/02/2015 02:00:00 AM,48,-122,0,0,0
9531,SpokaneStBridge,02/02/2015 03:00:00 AM,48,-122,1,0,1
9532,SpokaneStBridge,02/02/2015 04:00:00 AM,48,-122,1,2,3
9533,SpokaneStBridge,02/02/2015 05:00:00 AM,48,-122,14,3,17
9534,SpokaneStBridge,02/02/2015 06:00:00 AM,48,-122,39,4,43
9535,SpokaneStBridge,02/02/2015 07:00:00 AM,48,-122,68,10,78
9536,SpokaneStBridge,02/02/2015 08:00:00 AM,48,-122,68,6,74
9537,SpokaneStBridge,02/02/2015 09:00:00 AM,48,-122,21,6,27
9538,SpokaneStBridge,02/02/2015 10:00:00 AM,48,-122,5,5,10
9539,SpokaneStBridge,02/02/2015 11:00:00 AM,48,-122,3,2,5
9540,SpokaneStBridge,02/02/2015 12:00:00 PM,48,-122,5,2,7
9541,SpokaneStBridge,02/02/2015 01:00:00 PM,48,-122,9,4,13
9542,SpokaneStBridge,02/02/2015 02:00:00 PM,48,-122,9,5,14
9543,SpokaneStBridge,02/02/2015 03:00:00 PM,48,-122,9,19,28
9544,SpokaneStBridge,02/02/2015 04:00:00 PM,48,-122,9,44,53
9545,SpokaneStBridge,02/02/2015 05:00:00 PM,48,-122,15,64,79
9546,SpokaneStBridge,02/02/2015 06:00:00 PM,48,-122,6,55,61
9547,SpokaneStBridge,02/02/2015 07:00:00 PM,48,-122,3,15,18
9548,SpokaneStBridge,02/02/2015 08:00:00 PM,48,-122,2,3,5
9549,SpokaneStBridge,02/02/2015 09:00:00 PM,48,-122,0,3,3
9550,SpokaneStBridge,02/02/2015 10:00:00 PM,48,-122,1,0,1
9551,SpokaneStBridge,02/02/2015 11:00:00 PM,48,-122,1,2,3
9552,SpokaneStBridge,02/03/2015 12:00:00 AM,48,-122,0,1,1
9553,SpokaneStBridge,02/03/2015 01:00:00 AM,48,-122,2,0,2
9554,SpokaneStBridge,02/03/2015 02:00:00 AM,48,-122,0,0,0
9555,SpokaneStBridge,02/03/2015 03:00:00 AM,48,-122,1,1,2
9556,SpokaneStBridge,02/03/2015 04:00:00 AM,48,-122,3,1,4
9557,SpokaneStBridge,02/03/2015 05:00:00 AM,48,-122,17,3,20
9558,SpokaneStBridge,02/03/2015 06:00:00 AM,48,-122,46,6,52
9559,SpokaneStBridge,02/03/2015 07:00:00 AM,48,-122,91,13,104
9560,SpokaneStBridge,02/03/2015 08:00:00 AM,48,-122,93,13,106
9561,SpokaneStBridge,02/03/2015 09:00:00 AM,48,-122,33,3,36
9562,SpokaneStBridge,02/03/2015 10:00:00 AM,48,-122,17,4,21
9563,SpokaneStBridge,02/03/2015 11:00:00 AM,48,-122,9,3,12
9564,SpokaneStBridge,02/03/2015 12:00:00 PM,48,-122,7,1,8
9565,SpokaneStBridge,02/03/2015 01:00:00 PM,48,-122,3,6,9
9566,SpokaneStBridge,02/03/2015 02:00:00 PM,48,-122,4,11,15
9567,SpokaneStBridge,02/03/2015 03:00:00 PM,48,-122,4,21,25
9568,SpokaneStBridge,02/03/2015 04:00:00 PM,48,-122,11,51,62
9569,SpokaneStBridge,02/03/2015 05:00:00 PM,48,-122,16,89,105
9570,SpokaneStBridge,02/03/2015 06:00:00 PM,48,-122,9,62,71
9571,SpokaneStBridge,02/03/2015 07:00:00 PM,48,-122,5,27,32
9572,SpokaneStBridge,02/03/2015 08:00:00 PM,48,-122,2,10,12
9573,SpokaneStBridge,02/03/2015 09:00:00 PM,48,-122,3,7,10
9574,SpokaneStBridge,02/03/2015 10:00:00 PM,48,-122,0,3,3
9575,SpokaneStBridge,02/03/2015 11:00:00 PM,48,-122,2,2,4
9576,SpokaneStBridge,02/04/2015 12:00:00 AM,48,-122,1,3,4
9577,SpokaneStBridge,02/04/2015 01:00:00 AM,48,-122,2,1,3
9578,SpokaneStBridge,02/04/2015 02:00:00 AM,48,-122,0,0,0
9579,SpokaneStBridge,02/04/2015 03:00:00 AM,48,-122,0,0,0
9580,SpokaneStBridge,02/04/2015 04:00:00 AM,48,-122,4,2,6
9581,SpokaneStBridge,02/04/2015 05:00:00 AM,48,-122,14,4,18
9582,SpokaneStBridge,02/04/2015 06:00:00 AM,48,-122,45,7,52
9583,SpokaneStBridge,02/04/2015 07:00:00 AM,48,-122,91,10,101
9584,SpokaneStBridge,02/04/2015 08:00:00 AM,48,-122,84,11,95
9585,SpokaneStBridge,02/04/2015 09:00:00 AM,48,-122,39,4,43
9586,SpokaneStBridge,02/04/2015 10:00:00 AM,48,-122,9,8,17
9587,SpokaneStBridge,02/04/2015 11:00:00 AM,48,-122,6,8,14
9588,SpokaneStBridge,02/04/2015 12:00:00 PM,48,-122,10,5,15
9589,SpokaneStBridge,02/04/2015 01:00:00 PM,48,-122,8,7,15
9590,SpokaneStBridge,02/04/2015 02:00:00 PM,48,-122,6,14,20
9591,SpokaneStBridge,02/04/2015 03:00:00 PM,48,-122,11,23,34
9592,SpokaneStBridge,02/04/2015 04:00:00 PM,48,-122,12,56,68
9593,SpokaneStBridge,02/04/2015 05:00:00 PM,48,-122,13,78,91
9594,SpokaneStBridge,02/04/2015 06:00:00 PM,48,-122,7,65,72
9595,SpokaneStBridge,02/04/2015 07:00:00 PM,48,-122,5,16,21
9596,SpokaneStBridge,02/04/2015 08:00:00 PM,48,-122,2,10,12
9597,SpokaneStBridge,02/04/2015 09:00:00 PM,48,-122,2,2,4
9598,SpokaneStBridge,02/04/2015 10:00:00 PM,48,-122,0,1,1
9599,SpokaneStBridge,02/04/2015 11:00:00 PM,48,-122,3,8,11
9600,SpokaneStBridge,02/05/2015 12:00:00 AM,48,-122,0,1,1
9601,SpokaneStBridge,02/05/2015 01:00:00 AM,48,-122,1,1,2
9602,SpokaneStBridge,02/05/2015 02:00:00 AM,48,-122,0,1,1
9603,SpokaneStBridge,02/05/2015 03:00:00 AM,48,-122,1,1,2
9604,SpokaneStBridge,02/05/2015 04:00:00 AM,48,-122,2,0,2
9605,SpokaneStBridge,02/05/2015 05:00:00 AM,48,-122,5,2,7
9606,SpokaneStBridge,02/05/2015 06:00:00 AM,48,-122,28,3,31
9607,SpokaneStBridge,02/05/2015 07:00:00 AM,48,-122,48,10,58
9608,SpokaneStBridge,02/05/2015 08:00:00 AM,48,-122,43,5,48
9609,SpokaneStBridge,02/05/2015 09:00:00 AM,48,-122,19,0,19
9610,SpokaneStBridge,02/05/2015 10:00:00 AM,48,-122,10,1,11
9611,SpokaneStBridge,02/05/2015 11:00:00 AM,48,-122,9,6,15
9612,SpokaneStBridge,02/05/2015 12:00:00 PM,48,-122,7,1,8
9613,SpokaneStBridge,02/05/2015 01:00:00 PM,48,-122,7,2,9
9614,SpokaneStBridge,02/05/2015 02:00:00 PM,48,-122,3,4,7
9615,SpokaneStBridge,02/05/2015 03:00:00 PM,48,-122,9,15,24
9616,SpokaneStBridge,02/05/2015 04:00:00 PM,48,-122,9,30,39
9617,SpokaneStBridge,02/05/2015 05:00:00 PM,48,-122,8,40,48
9618,SpokaneStBridge,02/05/2015 06:00:00 PM,48,-122,4,44,48
9619,SpokaneStBridge,02/05/2015 07:00:00 PM,48,-122,7,17,24
9620,SpokaneStBridge,02/05/2015 08:00:00 PM,48,-122,2,6,8
9621,SpokaneStBridge,02/05/2015 09:00:00 PM,48,-122,2,6,8
9622,SpokaneStBridge,02/05/2015 10:00:00 PM,48,-122,1,1,2
9623,SpokaneStBridge,02/05/2015 11:00:00 PM,48,-122,1,1,2
9624,SpokaneStBridge,02/06/2015 12:00:00 AM,48,-122,0,2,2
9625,SpokaneStBridge,02/06/2015 01:00:00 AM,48,-122,1,0,1
9626,SpokaneStBridge,02/06/2015 02:00:00 AM,48,-122,0,0,0
9627,SpokaneStBridge,02/06/2015 03:00:00 AM,48,-122,0,0,0
9628,SpokaneStBridge,02/06/2015 04:00:00 AM,48,-122,2,0,2
9629,SpokaneStBridge,02/06/2015 05:00:00 AM,48,-122,8,1,9
9630,SpokaneStBridge,02/06/2015 06:00:00 AM,48,-122,24,3,27
9631,SpokaneStBridge,02/06/2015 07:00:00 AM,48,-122,52,6,58
9632,SpokaneStBridge,02/06/2015 08:00:00 AM,48,-122,65,4,69
9633,SpokaneStBridge,02/06/2015 09:00:00 AM,48,-122,22,2,24
9634,SpokaneStBridge,02/06/2015 10:00:00 AM,48,-122,6,4,10
9635,SpokaneStBridge,02/06/2015 11:00:00 AM,48,-122,0,1,1
9636,SpokaneStBridge,02/06/2015 12:00:00 PM,48,-122,6,2,8
9637,SpokaneStBridge,02/06/2015 01:00:00 PM,48,-122,5,2,7
9638,SpokaneStBridge,02/06/2015 02:00:00 PM,48,-122,4,7,11
9639,SpokaneStBridge,02/06/2015 03:00:00 PM,48,-122,4,14,18
9640,SpokaneStBridge,02/06/2015 04:00:00 PM,48,-122,10,41,51
9641,SpokaneStBridge,02/06/2015 05:00:00 PM,48,-122,8,64,72
9642,SpokaneStBridge,02/06/2015 06:00:00 PM,48,-122,5,31,36
9643,SpokaneStBridge,02/06/2015 07:00:00 PM,48,-122,3,12,15
9644,SpokaneStBridge,02/06/2015 08:00:00 PM,48,-122,1,9,10
9645,SpokaneStBridge,02/06/2015 09:00:00 PM,48,-122,2,3,5
9646,SpokaneStBridge,02/06/2015 10:00:00 PM,48,-122,2,2,4
9647,SpokaneStBridge,02/06/2015 11:00:00 PM,48,-122,0,2,2
9648,SpokaneStBridge,02/07/2015 12:00:00 AM,48,-122,0,1,1
9649,SpokaneStBridge,02/07/2015 01:00:00 AM,48,-122,0,1,1
9650,SpokaneStBridge,02/07/2015 02:00:00 AM,48,-122,0,0,0
9651,SpokaneStBridge,02/07/2015 03:00:00 AM,48,-122,3,0,3
9652,SpokaneStBridge,02/07/2015 04:00:00 AM,48,-122,0,0,0
9653,SpokaneStBridge,02/07/2015 05:00:00 AM,48,-122,1,0,1
9654,SpokaneStBridge,02/07/2015 06:00:00 AM,48,-122,2,0,2
9655,SpokaneStBridge,02/07/2015 07:00:00 AM,48,-122,3,1,4
9656,SpokaneStBridge,02/07/2015 08:00:00 AM,48,-122,1,1,2
9657,SpokaneStBridge,02/07/2015 09:00:00 AM,48,-122,6,1,7
9658,SpokaneStBridge,02/07/2015 10:00:00 AM,48,-122,1,7,8
9659,SpokaneStBridge,02/07/2015 11:00:00 AM,48,-122,5,0,5
9660,SpokaneStBridge,02/07/2015 12:00:00 PM,48,-122,10,3,13
9661,SpokaneStBridge,02/07/2015 01:00:00 PM,48,-122,6,6,12
9662,SpokaneStBridge,02/07/2015 02:00:00 PM,48,-122,5,7,12
9663,SpokaneStBridge,02/07/2015 03:00:00 PM,48,-122,5,2,7
9664,SpokaneStBridge,02/07/2015 04:00:00 PM,48,-122,5,5,10
9665,SpokaneStBridge,02/07/2015 05:00:00 PM,48,-122,5,5,10
9666,SpokaneStBridge,02/07/2015 06:00:00 PM,48,-122,4,3,7
9667,SpokaneStBridge,02/07/2015 07:00:00 PM,48,-122,0,0,0
9668,SpokaneStBridge,02/07/2015 08:00:00 PM,48,-122,2,1,3
9669,SpokaneStBridge,02/07/2015 09:00:00 PM,48,-122,0,1,1
9670,SpokaneStBridge,02/07/2015 10:00:00 PM,48,-122,0,3,3
9671,SpokaneStBridge,02/07/2015 11:00:00 PM,48,-122,0,2,2
9672,SpokaneStBridge,02/08/2015 12:00:00 AM,48,-122,1,0,1
9673,SpokaneStBridge,02/08/2015 01:00:00 AM,48,-122,0,1,1
9674,SpokaneStBridge,02/08/2015 02:00:00 AM,48,-122,0,2,2
9675,SpokaneStBridge,02/08/2015 03:00:00 AM,48,-122,1,0,1
9676,SpokaneStBridge,02/08/2015 04:00:00 AM,48,-122,1,1,2
9677,SpokaneStBridge,02/08/2015 05:00:00 AM,48,-122,5,0,5
9678,SpokaneStBridge,02/08/2015 06:00:00 AM,48,-122,1,1,2
9679,SpokaneStBridge,02/08/2015 07:00:00 AM,48,-122,2,1,3
9680,SpokaneStBridge,02/08/2015 08:00:00 AM,48,-122,17,3,20
9681,SpokaneStBridge,02/08/2015 09:00:00 AM,48,-122,11,10,21
9682,SpokaneStBridge,02/08/2015 10:00:00 AM,48,-122,23,17,40
9683,SpokaneStBridge,02/08/2015 11:00:00 AM,48,-122,25,37,62
9684,SpokaneStBridge,02/08/2015 12:00:00 PM,48,-122,37,35,72
9685,SpokaneStBridge,02/08/2015 01:00:00 PM,48,-122,28,26,54
9686,SpokaneStBridge,02/08/2015 02:00:00 PM,48,-122,26,29,55
9687,SpokaneStBridge,02/08/2015 03:00:00 PM,48,-122,24,15,39
9688,SpokaneStBridge,02/08/2015 04:00:00 PM,48,-122,12,20,32
9689,SpokaneStBridge,02/08/2015 05:00:00 PM,48,-122,14,7,21
9690,SpokaneStBridge,02/08/2015 06:00:00 PM,48,-122,3,8,11
9691,SpokaneStBridge,02/08/2015 07:00:00 PM,48,-122,0,2,2
9692,SpokaneStBridge,02/08/2015 08:00:00 PM,48,-122,3,2,5
9693,SpokaneStBridge,02/08/2015 09:00:00 PM,48,-122,0,1,1
9694,SpokaneStBridge,02/08/2015 10:00:00 PM,48,-122,1,4,5
9695,SpokaneStBridge,02/08/2015 11:00:00 PM,48,-122,0,0,0
9696,SpokaneStBridge,02/09/2015 12:00:00 AM,48,-122,1,0,1
9697,SpokaneStBridge,02/09/2015 01:00:00 AM,48,-122,0,0,0
9698,SpokaneStBridge,02/09/2015 02:00:00 AM,48,-122,0,0,0
9699,SpokaneStBridge,02/09/2015 03:00:00 AM,48,-122,0,1,1
9700,SpokaneStBridge,02/09/2015 04:00:00 AM,48,-122,3,2,5
9701,SpokaneStBridge,02/09/2015 05:00:00 AM,48,-122,15,2,17
9702,SpokaneStBridge,02/09/2015 06:00:00 AM,48,-122,39,7,46
9703,SpokaneStBridge,02/09/2015 07:00:00 AM,48,-122,81,16,97
9704,SpokaneStBridge,02/09/2015 08:00:00 AM,48,-122,61,5,66
9705,SpokaneStBridge,02/09/2015 09:00:00 AM,48,-122,30,2,32
9706,SpokaneStBridge,02/09/2015 10:00:00 AM,48,-122,5,3,8
9707,SpokaneStBridge,02/09/2015 11:00:00 AM,48,-122,6,3,9
9708,SpokaneStBridge,02/09/2015 12:00:00 PM,48,-122,6,4,10
9709,SpokaneStBridge,02/09/2015 01:00:00 PM,48,-122,8,2,10
9710,SpokaneStBridge,02/09/2015 02:00:00 PM,48,-122,9,9,18
9711,SpokaneStBridge,02/09/2015 03:00:00 PM,48,-122,9,28,37
9712,SpokaneStBridge,02/09/2015 04:00:00 PM,48,-122,8,42,50
9713,SpokaneStBridge,02/09/2015 05:00:00 PM,48,-122,16,72,88
9714,SpokaneStBridge,02/09/2015 06:00:00 PM,48,-122,8,59,67
9715,SpokaneStBridge,02/09/2015 07:00:00 PM,48,-122,7,17,24
9716,SpokaneStBridge,02/09/2015 08:00:00 PM,48,-122,3,5,8
9717,SpokaneStBridge,02/09/2015 09:00:00 PM,48,-122,2,6,8
9718,SpokaneStBridge,02/09/2015 10:00:00 PM,48,-122,1,1,2
9719,SpokaneStBridge,02/09/2015 11:00:00 PM,48,-122,0,3,3
9720,SpokaneStBridge,02/10/2015 12:00:00 AM,48,-122,0,1,1
9721,SpokaneStBridge,02/10/2015 01:00:00 AM,48,-122,1,0,1
9722,SpokaneStBridge,02/10/2015 02:00:00 AM,48,-122,0,0,0
9723,SpokaneStBridge,02/10/2015 03:00:00 AM,48,-122,0,1,1
9724,SpokaneStBridge,02/10/2015 04:00:00 AM,48,-122,1,0,1
9725,SpokaneStBridge,02/10/2015 05:00:00 AM,48,-122,11,1,12
9726,SpokaneStBridge,02/10/2015 06:00:00 AM,48,-122,49,8,57
9727,SpokaneStBridge,02/10/2015 07:00:00 AM,48,-122,84,8,92
9728,SpokaneStBridge,02/10/2015 08:00:00 AM,48,-122,97,7,104
9729,SpokaneStBridge,02/10/2015 09:00:00 AM,48,-122,29,7,36
9730,SpokaneStBridge,02/10/2015 10:00:00 AM,48,-122,9,3,12
9731,SpokaneStBridge,02/10/2015 11:00:00 AM,48,-122,10,4,14
9732,SpokaneStBridge,02/10/2015 12:00:00 PM,48,-122,11,4,15
9733,SpokaneStBridge,02/10/2015 01:00:00 PM,48,-122,9,6,15
9734,SpokaneStBridge,02/10/2015 02:00:00 PM,48,-122,12,17,29
9735,SpokaneStBridge,02/10/2015 03:00:00 PM,48,-122,6,26,32
9736,SpokaneStBridge,02/10/2015 04:00:00 PM,48,-122,23,64,87
9737,SpokaneStBridge,02/10/2015 05:00:00 PM,48,-122,21,96,117
9738,SpokaneStBridge,02/10/2015 06:00:00 PM,48,-122,11,61,72
9739,SpokaneStBridge,02/10/2015 07:00:00 PM,48,-122,2,34,36
9740,SpokaneStBridge,02/10/2015 08:00:00 PM,48,-122,0,11,11
9741,SpokaneStBridge,02/10/2015 09:00:00 PM,48,-122,2,6,8
9742,SpokaneStBridge,02/10/2015 10:00:00 PM,48,-122,2,3,5
9743,SpokaneStBridge,02/10/2015 11:00:00 PM,48,-122,0,4,4
9744,SpokaneStBridge,02/11/2015 12:00:00 AM,48,-122,1,1,2
9745,SpokaneStBridge,02/11/2015 01:00:00 AM,48,-122,2,1,3
9746,SpokaneStBridge,02/11/2015 02:00:00 AM,48,-122,0,0,0
9747,SpokaneStBridge,02/11/2015 03:00:00 AM,48,-122,0,0,0
9748,SpokaneStBridge,02/11/2015 04:00:00 AM,48,-122,3,1,4
9749,SpokaneStBridge,02/11/2015 05:00:00 AM,48,-122,21,4,25
9750,SpokaneStBridge,02/11/2015 06:00:00 AM,48,-122,55,8,63
9751,SpokaneStBridge,02/11/2015 07:00:00 AM,48,-122,98,13,111
9752,SpokaneStBridge,02/11/2015 08:00:00 AM,48,-122,91,10,101
9753,SpokaneStBridge,02/11/2015 09:00:00 AM,48,-122,31,4,35
9754,SpokaneStBridge,02/11/2015 10:00:00 AM,48,-122,21,7,28
9755,SpokaneStBridge,02/11/2015 11:00:00 AM,48,-122,8,6,14
9756,SpokaneStBridge,02/11/2015 12:00:00 PM,48,-122,15,8,23
9757,SpokaneStBridge,02/11/2015 01:00:00 PM,48,-122,17,14,31
9758,SpokaneStBridge,02/11/2015 02:00:00 PM,48,-122,6,11,17
9759,SpokaneStBridge,02/11/2015 03:00:00 PM,48,-122,10,31,41
9760,SpokaneStBridge,02/11/2015 04:00:00 PM,48,-122,19,67,86
9761,SpokaneStBridge,02/11/2015 05:00:00 PM,48,-122,16,93,109
9762,SpokaneStBridge,02/11/2015 06:00:00 PM,48,-122,10,64,74
9763,SpokaneStBridge,02/11/2015 07:00:00 PM,48,-122,4,31,35
9764,SpokaneStBridge,02/11/2015 08:00:00 PM,48,-122,3,13,16
9765,SpokaneStBridge,02/11/2015 09:00:00 PM,48,-122,10,13,23
9766,SpokaneStBridge,02/11/2015 10:00:00 PM,48,-122,2,1,3
9767,SpokaneStBridge,02/11/2015 11:00:00 PM,48,-122,1,3,4
9768,SpokaneStBridge,02/12/2015 12:00:00 AM,48,-122,1,1,2
9769,SpokaneStBridge,02/12/2015 01:00:00 AM,48,-122,1,1,2
9770,SpokaneStBridge,02/12/2015 02:00:00 AM,48,-122,0,0,0
9771,SpokaneStBridge,02/12/2015 03:00:00 AM,48,-122,1,1,2
9772,SpokaneStBridge,02/12/2015 04:00:00 AM,48,-122,3,1,4
9773,SpokaneStBridge,02/12/2015 05:00:00 AM,48,-122,9,4,13
9774,SpokaneStBridge,02/12/2015 06:00:00 AM,48,-122,50,6,56
9775,SpokaneStBridge,02/12/2015 07:00:00 AM,48,-122,73,10,83
9776,SpokaneStBridge,02/12/2015 08:00:00 AM,48,-122,77,5,82
9777,SpokaneStBridge,02/12/2015 09:00:00 AM,48,-122,37,4,41
9778,SpokaneStBridge,02/12/2015 10:00:00 AM,48,-122,13,4,17
9779,SpokaneStBridge,02/12/2015 11:00:00 AM,48,-122,14,2,16
9780,SpokaneStBridge,02/12/2015 12:00:00 PM,48,-122,7,4,11
9781,SpokaneStBridge,02/12/2015 01:00:00 PM,48,-122,13,6,19
9782,SpokaneStBridge,02/12/2015 02:00:00 PM,48,-122,10,14,24
9783,SpokaneStBridge,02/12/2015 03:00:00 PM,48,-122,10,31,41
9784,SpokaneStBridge,02/12/2015 04:00:00 PM,48,-122,16,58,74
9785,SpokaneStBridge,02/12/2015 05:00:00 PM,48,-122,23,87,110
9786,SpokaneStBridge,02/12/2015 06:00:00 PM,48,-122,10,52,62
9787,SpokaneStBridge,02/12/2015 07:00:00 PM,48,-122,1,22,23
9788,SpokaneStBridge,02/12/2015 08:00:00 PM,48,-122,2,11,13
9789,SpokaneStBridge,02/12/2015 09:00:00 PM,48,-122,2,1,3
9790,SpokaneStBridge,02/12/2015 10:00:00 PM,48,-122,5,2,7
9791,SpokaneStBridge,02/12/2015 11:00:00 PM,48,-122,1,3,4
9792,SpokaneStBridge,02/13/2015 12:00:00 AM,48,-122,1,2,3
9793,SpokaneStBridge,02/13/2015 01:00:00 AM,48,-122,0,0,0
9794,SpokaneStBridge,02/13/2015 02:00:00 AM,48,-122,0,0,0
9795,SpokaneStBridge,02/13/2015 03:00:00 AM,48,-122,1,0,1
9796,SpokaneStBridge,02/13/2015 04:00:00 AM,48,-122,1,0,1
9797,SpokaneStBridge,02/13/2015 05:00:00 AM,48,-122,10,1,11
9798,SpokaneStBridge,02/13/2015 06:00:00 AM,48,-122,29,4,33
9799,SpokaneStBridge,02/13/2015 07:00:00 AM,48,-122,81,6,87
9800,SpokaneStBridge,02/13/2015 08:00:00 AM,48,-122,80,8,88
9801,SpokaneStBridge,02/13/2015 09:00:00 AM,48,-122,30,3,33
9802,SpokaneStBridge,02/13/2015 10:00:00 AM,48,-122,12,6,18
9803,SpokaneStBridge,02/13/2015 11:00:00 AM,48,-122,12,12,24
9804,SpokaneStBridge,02/13/2015 12:00:00 PM,48,-122,15,11,26
9805,SpokaneStBridge,02/13/2015 01:00:00 PM,48,-122,16,18,34
9806,SpokaneStBridge,02/13/2015 02:00:00 PM,48,-122,19,12,31
9807,SpokaneStBridge,02/13/2015 03:00:00 PM,48,-122,7,34,41
9808,SpokaneStBridge,02/13/2015 04:00:00 PM,48,-122,11,48,59
9809,SpokaneStBridge,02/13/2015 05:00:00 PM,48,-122,20,76,96
9810,SpokaneStBridge,02/13/2015 06:00:00 PM,48,-122,9,41,50
9811,SpokaneStBridge,02/13/2015 07:00:00 PM,48,-122,9,14,23
9812,SpokaneStBridge,02/13/2015 08:00:00 PM,48,-122,2,8,10
9813,SpokaneStBridge,02/13/2015 09:00:00 PM,48,-122,0,5,5
9814,SpokaneStBridge,02/13/2015 10:00:00 PM,48,-122,2,6,8
9815,SpokaneStBridge,02/13/2015 11:00:00 PM,48,-122,3,1,4
9816,SpokaneStBridge,02/14/2015 12:00:00 AM,48,-122,0,2,2
9817,SpokaneStBridge,02/14/2015 01:00:00 AM,48,-122,1,2,3
9818,SpokaneStBridge,02/14/2015 02:00:00 AM,48,-122,2,0,2
9819,SpokaneStBridge,02/14/2015 03:00:00 AM,48,-122,1,0,1
9820,SpokaneStBridge,02/14/2015 04:00:00 AM,48,-122,1,0,1
9821,SpokaneStBridge,02/14/2015 05:00:00 AM,48,-122,4,0,4
9822,SpokaneStBridge,02/14/2015 06:00:00 AM,48,-122,2,1,3
9823,SpokaneStBridge,02/14/2015 07:00:00 AM,48,-122,11,4,15
9824,SpokaneStBridge,02/14/2015 08:00:00 AM,48,-122,7,6,13
9825,SpokaneStBridge,02/14/2015 09:00:00 AM,48,-122,13,8,21
9826,SpokaneStBridge,02/14/2015 10:00:00 AM,48,-122,13,34,47
9827,SpokaneStBridge,02/14/2015 11:00:00 AM,48,-122,24,13,37
9828,SpokaneStBridge,02/14/2015 12:00:00 PM,48,-122,26,21,47
9829,SpokaneStBridge,02/14/2015 01:00:00 PM,48,-122,20,13,33
9830,SpokaneStBridge,02/14/2015 02:00:00 PM,48,-122,25,18,43
9831,SpokaneStBridge,02/14/2015 03:00:00 PM,48,-122,27,25,52
9832,SpokaneStBridge,02/14/2015 04:00:00 PM,48,-122,24,32,56
9833,SpokaneStBridge,02/14/2015 05:00:00 PM,48,-122,11,24,35
9834,SpokaneStBridge,02/14/2015 06:00:00 PM,48,-122,0,12,12
9835,SpokaneStBridge,02/14/2015 07:00:00 PM,48,-122,1,5,6
9836,SpokaneStBridge,02/14/2015 08:00:00 PM,48,-122,4,11,15
9837,SpokaneStBridge,02/14/2015 09:00:00 PM,48,-122,3,2,5
9838,SpokaneStBridge,02/14/2015 10:00:00 PM,48,-122,1,3,4
9839,SpokaneStBridge,02/14/2015 11:00:00 PM,48,-122,0,0,0
9840,SpokaneStBridge,02/15/2015 12:00:00 AM,48,-122,0,1,1
9841,SpokaneStBridge,02/15/2015 01:00:00 AM,48,-122,1,1,2
9842,SpokaneStBridge,02/15/2015 02:00:00 AM,48,-122,0,1,1
9843,SpokaneStBridge,02/15/2015 03:00:00 AM,48,-122,1,0,1
9844,SpokaneStBridge,02/15/2015 04:00:00 AM,48,-122,0,1,1
9845,SpokaneStBridge,02/15/2015 05:00:00 AM,48,-122,4,0,4
9846,SpokaneStBridge,02/15/2015 06:00:00 AM,48,-122,2,1,3
9847,SpokaneStBridge,02/15/2015 07:00:00 AM,48,-122,12,3,15
9848,SpokaneStBridge,02/15/2015 08:00:00 AM,48,-122,4,4,8
9849,SpokaneStBridge,02/15/2015 09:00:00 AM,48,-122,25,19,44
9850,SpokaneStBridge,02/15/2015 10:00:00 AM,48,-122,25,22,47
9851,SpokaneStBridge,02/15/2015 11:00:00 AM,48,-122,35,38,73
9852,SpokaneStBridge,02/15/2015 12:00:00 PM,48,-122,38,53,91
9853,SpokaneStBridge,02/15/2015 01:00:00 PM,48,-122,35,51,86
9854,SpokaneStBridge,02/15/2015 02:00:00 PM,48,-122,37,48,85
9855,SpokaneStBridge,02/15/2015 03:00:00 PM,48,-122,42,41,83
9856,SpokaneStBridge,02/15/2015 04:00:00 PM,48,-122,39,32,71
9857,SpokaneStBridge,02/15/2015 05:00:00 PM,48,-122,21,15,36
9858,SpokaneStBridge,02/15/2015 06:00:00 PM,48,-122,7,6,13
9859,SpokaneStBridge,02/15/2015 07:00:00 PM,48,-122,8,4,12
9860,SpokaneStBridge,02/15/2015 08:00:00 PM,48,-122,1,2,3
9861,SpokaneStBridge,02/15/2015 09:00:00 PM,48,-122,1,0,1
9862,SpokaneStBridge,02/15/2015 10:00:00 PM,48,-122,0,1,1
9863,SpokaneStBridge,02/15/2015 11:00:00 PM,48,-122,1,1,2
9864,SpokaneStBridge,02/16/2015 12:00:00 AM,48,-122,2,0,2
9865,SpokaneStBridge,02/16/2015 01:00:00 AM,48,-122,2,2,4
9866,SpokaneStBridge,02/16/2015 02:00:00 AM,48,-122,0,0,0
9867,SpokaneStBridge,02/16/2015 03:00:00 AM,48,-122,2,0,2
9868,SpokaneStBridge,02/16/2015 04:00:00 AM,48,-122,2,0,2
9869,SpokaneStBridge,02/16/2015 05:00:00 AM,48,-122,6,1,7
9870,SpokaneStBridge,02/16/2015 06:00:00 AM,48,-122,19,6,25
9871,SpokaneStBridge,02/16/2015 07:00:00 AM,48,-122,36,4,40
9872,SpokaneStBridge,02/16/2015 08:00:00 AM,48,-122,46,13,59
9873,SpokaneStBridge,02/16/2015 09:00:00 AM,48,-122,28,5,33
9874,SpokaneStBridge,02/16/2015 10:00:00 AM,48,-122,22,25,47
9875,SpokaneStBridge,02/16/2015 11:00:00 AM,48,-122,18,11,29
9876,SpokaneStBridge,02/16/2015 12:00:00 PM,48,-122,21,19,40
9877,SpokaneStBridge,02/16/2015 01:00:00 PM,48,-122,23,30,53
9878,SpokaneStBridge,02/16/2015 02:00:00 PM,48,-122,32,31,63
9879,SpokaneStBridge,02/16/2015 03:00:00 PM,48,-122,28,38,66
9880,SpokaneStBridge,02/16/2015 04:00:00 PM,48,-122,19,28,47
9881,SpokaneStBridge,02/16/2015 05:00:00 PM,48,-122,34,49,83
9882,SpokaneStBridge,02/16/2015 06:00:00 PM,48,-122,5,39,44
9883,SpokaneStBridge,02/16/2015 07:00:00 PM,48,-122,7,11,18
9884,SpokaneStBridge,02/16/2015 08:00:00 PM,48,-122,3,5,8
9885,SpokaneStBridge,02/16/2015 09:00:00 PM,48,-122,1,4,5
9886,SpokaneStBridge,02/16/2015 10:00:00 PM,48,-122,1,3,4
9887,SpokaneStBridge,02/16/2015 11:00:00 PM,48,-122,1,3,4
9888,SpokaneStBridge,02/17/2015 12:00:00 AM,48,-122,0,1,1
9889,SpokaneStBridge,02/17/2015 01:00:00 AM,48,-122,1,1,2
9890,SpokaneStBridge,02/17/2015 02:00:00 AM,48,-122,0,0,0
9891,SpokaneStBridge,02/17/2015 03:00:00 AM,48,-122,0,0,0
9892,SpokaneStBridge,02/17/2015 04:00:00 AM,48,-122,2,1,3
9893,SpokaneStBridge,02/17/2015 05:00:00 AM,48,-122,27,1,28
9894,SpokaneStBridge,02/17/2015 06:00:00 AM,48,-122,47,11,58
9895,SpokaneStBridge,02/17/2015 07:00:00 AM,48,-122,105,12,117
9896,SpokaneStBridge,02/17/2015 08:00:00 AM,48,-122,105,8,113
9897,SpokaneStBridge,02/17/2015 09:00:00 AM,48,-122,44,6,50
9898,SpokaneStBridge,02/17/2015 10:00:00 AM,48,-122,17,3,20
9899,SpokaneStBridge,02/17/2015 11:00:00 AM,48,-122,12,14,26
9900,SpokaneStBridge,02/17/2015 12:00:00 PM,48,-122,21,11,32
9901,SpokaneStBridge,02/17/2015 01:00:00 PM,48,-122,15,13,28
9902,SpokaneStBridge,02/17/2015 02:00:00 PM,48,-122,19,27,46
9903,SpokaneStBridge,02/17/2015 03:00:00 PM,48,-122,15,36,51
9904,SpokaneStBridge,02/17/2015 04:00:00 PM,48,-122,17,66,83
9905,SpokaneStBridge,02/17/2015 05:00:00 PM,48,-122,21,133,154
9906,SpokaneStBridge,02/17/2015 06:00:00 PM,48,-122,11,52,63
9907,SpokaneStBridge,02/17/2015 07:00:00 PM,48,-122,6,34,40
9908,SpokaneStBridge,02/17/2015 08:00:00 PM,48,-122,2,12,14
9909,SpokaneStBridge,02/17/2015 09:00:00 PM,48,-122,0,8,8
9910,SpokaneStBridge,02/17/2015 10:00:00 PM,48,-122,0,0,0
9911,SpokaneStBridge,02/17/2015 11:00:00 PM,48,-122,0,5,5
9912,SpokaneStBridge,02/18/2015 12:00:00 AM,48,-122,1,0,1
9913,SpokaneStBridge,02/18/2015 01:00:00 AM,48,-122,2,1,3
9914,SpokaneStBridge,02/18/2015 02:00:00 AM,48,-122,1,0,1
9915,SpokaneStBridge,02/18/2015 03:00:00 AM,48,-122,1,1,2
9916,SpokaneStBridge,02/18/2015 04:00:00 AM,48,-122,7,2,9
9917,SpokaneStBridge,02/18/2015 05:00:00 AM,48,-122,11,6,17
9918,SpokaneStBridge,02/18/2015 06:00:00 AM,48,-122,61,11,72
9919,SpokaneStBridge,02/18/2015 07:00:00 AM,48,-122,102,12,114
9920,SpokaneStBridge,02/18/2015 08:00:00 AM,48,-122,101,9,110
9921,SpokaneStBridge,02/18/2015 09:00:00 AM,48,-122,41,4,45
9922,SpokaneStBridge,02/18/2015 10:00:00 AM,48,-122,23,5,28
9923,SpokaneStBridge,02/18/2015 11:00:00 AM,48,-122,9,11,20
9924,SpokaneStBridge,02/18/2015 12:00:00 PM,48,-122,9,10,19
9925,SpokaneStBridge,02/18/2015 01:00:00 PM,48,-122,15,10,25
9926,SpokaneStBridge,02/18/2015 02:00:00 PM,48,-122,11,15,26
9927,SpokaneStBridge,02/18/2015 03:00:00 PM,48,-122,8,29,37
9928,SpokaneStBridge,02/18/2015 04:00:00 PM,48,-122,13,55,68
9929,SpokaneStBridge,02/18/2015 05:00:00 PM,48,-122,15,115,130
9930,SpokaneStBridge,02/18/2015 06:00:00 PM,48,-122,6,73,79
9931,SpokaneStBridge,02/18/2015 07:00:00 PM,48,-122,3,31,34
9932,SpokaneStBridge,02/18/2015 08:00:00 PM,48,-122,2,16,18
9933,SpokaneStBridge,02/18/2015 09:00:00 PM,48,-122,0,3,3
9934,SpokaneStBridge,02/18/2015 10:00:00 PM,48,-122,0,3,3
9935,SpokaneStBridge,02/18/2015 11:00:00 PM,48,-122,1,4,5
9936,SpokaneStBridge,02/19/2015 12:00:00 AM,48,-122,0,3,3
9937,SpokaneStBridge,02/19/2015 01:00:00 AM,48,-122,0,0,0
9938,SpokaneStBridge,02/19/2015 02:00:00 AM,48,-122,3,0,3
9939,SpokaneStBridge,02/19/2015 03:00:00 AM,48,-122,0,0,0
9940,SpokaneStBridge,02/19/2015 04:00:00 AM,48,-122,2,1,3
9941,SpokaneStBridge,02/19/2015 05:00:00 AM,48,-122,15,3,18
9942,SpokaneStBridge,02/19/2015 06:00:00 AM,48,-122,42,11,53
9943,SpokaneStBridge,02/19/2015 07:00:00 AM,48,-122,67,10,77
9944,SpokaneStBridge,02/19/2015 08:00:00 AM,48,-122,90,16,106
9945,SpokaneStBridge,02/19/2015 09:00:00 AM,48,-122,39,2,41
9946,SpokaneStBridge,02/19/2015 10:00:00 AM,48,-122,12,3,15
9947,SpokaneStBridge,02/19/2015 11:00:00 AM,48,-122,6,7,13
9948,SpokaneStBridge,02/19/2015 12:00:00 PM,48,-122,7,1,8
9949,SpokaneStBridge,02/19/2015 01:00:00 PM,48,-122,5,2,7
9950,SpokaneStBridge,02/19/2015 02:00:00 PM,48,-122,6,6,12
9951,SpokaneStBridge,02/19/2015 03:00:00 PM,48,-122,6,20,26
9952,SpokaneStBridge,02/19/2015 04:00:00 PM,48,-122,8,45,53
9953,SpokaneStBridge,02/19/2015 05:00:00 PM,48,-122,10,91,101
9954,SpokaneStBridge,02/19/2015 06:00:00 PM,48,-122,5,39,44
9955,SpokaneStBridge,02/19/2015 07:00:00 PM,48,-122,7,20,27
9956,SpokaneStBridge,02/19/2015 08:00:00 PM,48,-122,2,14,16
9957,SpokaneStBridge,02/19/2015 09:00:00 PM,48,-122,0,5,5
9958,SpokaneStBridge,02/19/2015 10:00:00 PM,48,-122,2,2,4
9959,SpokaneStBridge,02/19/2015 11:00:00 PM,48,-122,0,2,2
9960,SpokaneStBridge,02/20/2015 12:00:00 AM,48,-122,0,1,1
9961,SpokaneStBridge,02/20/2015 01:00:00 AM,48,-122,0,2,2
9962,SpokaneStBridge,02/20/2015 02:00:00 AM,48,-122,1,0,1
9963,SpokaneStBridge,02/20/2015 03:00:00 AM,48,-122,0,2,2
9964,SpokaneStBridge,02/20/2015 04:00:00 AM,48,-122,1,0,1
9965,SpokaneStBridge,02/20/2015 05:00:00 AM,48,-122,12,0,12
9966,SpokaneStBridge,02/20/2015 06:00:00 AM,48,-122,35,4,39
9967,SpokaneStBridge,02/20/2015 07:00:00 AM,48,-122,57,18,75
9968,SpokaneStBridge,02/20/2015 08:00:00 AM,48,-122,65,4,69
9969,SpokaneStBridge,02/20/2015 09:00:00 AM,48,-122,29,8,37
9970,SpokaneStBridge,02/20/2015 10:00:00 AM,48,-122,13,3,16
9971,SpokaneStBridge,02/20/2015 11:00:00 AM,48,-122,6,8,14
9972,SpokaneStBridge,02/20/2015 12:00:00 PM,48,-122,10,1,11
9973,SpokaneStBridge,02/20/2015 01:00:00 PM,48,-122,16,6,22
9974,SpokaneStBridge,02/20/2015 02:00:00 PM,48,-122,11,12,23
9975,SpokaneStBridge,02/20/2015 03:00:00 PM,48,-122,6,23,29
9976,SpokaneStBridge,02/20/2015 04:00:00 PM,48,-122,5,42,47
9977,SpokaneStBridge,02/20/2015 05:00:00 PM,48,-122,18,67,85
9978,SpokaneStBridge,02/20/2015 06:00:00 PM,48,-122,9,36,45
9979,SpokaneStBridge,02/20/2015 07:00:00 PM,48,-122,4,15,19
9980,SpokaneStBridge,02/20/2015 08:00:00 PM,48,-122,2,5,7
9981,SpokaneStBridge,02/20/2015 09:00:00 PM,48,-122,0,3,3
9982,SpokaneStBridge,02/20/2015 10:00:00 PM,48,-122,0,1,1
9983,SpokaneStBridge,02/20/2015 11:00:00 PM,48,-122,1,4,5
9984,SpokaneStBridge,02/21/2015 12:00:00 AM,48,-122,3,1,4
9985,SpokaneStBridge,02/21/2015 01:00:00 AM,48,-122,0,0,0
9986,SpokaneStBridge,02/21/2015 02:00:00 AM,48,-122,1,3,4
9987,SpokaneStBridge,02/21/2015 03:00:00 AM,48,-122,0,0,0
9988,SpokaneStBridge,02/21/2015 04:00:00 AM,48,-122,2,0,2
9989,SpokaneStBridge,02/21/2015 05:00:00 AM,48,-122,3,0,3
9990,SpokaneStBridge,02/21/2015 06:00:00 AM,48,-122,4,3,7
9991,SpokaneStBridge,02/21/2015 07:00:00 AM,48,-122,8,2,10
9992,SpokaneStBridge,02/21/2015 08:00:00 AM,48,-122,14,9,23
9993,SpokaneStBridge,02/21/2015 09:00:00 AM,48,-122,12,11,23
9994,SpokaneStBridge,02/21/2015 10:00:00 AM,48,-122,21,13,34
9995,SpokaneStBridge,02/21/2015 11:00:00 AM,48,-122,25,16,41
9996,SpokaneStBridge,02/21/2015 12:00:00 PM,48,-122,25,18,43
9997,SpokaneStBridge,02/21/2015 01:00:00 PM,48,-122,17,34,51
9998,SpokaneStBridge,02/21/2015 02:00:00 PM,48,-122,21,16,37
9999,SpokaneStBridge,02/21/2015 03:00:00 PM,48,-122,20,26,46
10000,SpokaneStBridge,02/21/2015 04:00:00 PM,48,-122,24,24,48
10001,SpokaneStBridge,02/21/2015 05:00:00 PM,48,-122,21,12,33
10002,SpokaneStBridge,02/21/2015 06:00:00 PM,48,-122,7,13,20
10003,SpokaneStBridge,02/21/2015 07:00:00 PM,48,-122,3,5,8
10004,SpokaneStBridge,02/21/2015 08:00:00 PM,48,-122,0,2,2
10005,SpokaneStBridge,02/21/2015 09:00:00 PM,48,-122,0,1,1
10006,SpokaneStBridge,02/21/2015 10:00:00 PM,48,-122,1,2,3
10007,SpokaneStBridge,02/21/2015 11:00:00 PM,48,-122,1,2,3
10008,SpokaneStBridge,02/22/2015 12:00:00 AM,48,-122,0,1,1
10009,SpokaneStBridge,02/22/2015 01:00:00 AM,48,-122,0,0,0
10010,SpokaneStBridge,02/22/2015 02:00:00 AM,48,-122,0,0,0
10011,SpokaneStBridge,02/22/2015 03:00:00 AM,48,-122,1,0,1
10012,SpokaneStBridge,02/22/2015 04:00:00 AM,48,-122,2,2,4
10013,SpokaneStBridge,02/22/2015 05:00:00 AM,48,-122,4,0,4
10014,SpokaneStBridge,02/22/2015 06:00:00 AM,48,-122,11,0,11
10015,SpokaneStBridge,02/22/2015 07:00:00 AM,48,-122,52,9,61
10016,SpokaneStBridge,02/22/2015 08:00:00 AM,48,-122,40,5,45
10017,SpokaneStBridge,02/22/2015 09:00:00 AM,48,-122,23,16,39
10018,SpokaneStBridge,02/22/2015 10:00:00 AM,48,-122,27,18,45
10019,SpokaneStBridge,02/22/2015 11:00:00 AM,48,-122,14,25,39
10020,SpokaneStBridge,02/22/2015 12:00:00 PM,48,-122,21,46,67
10021,SpokaneStBridge,02/22/2015 01:00:00 PM,48,-122,38,58,96
10022,SpokaneStBridge,02/22/2015 02:00:00 PM,48,-122,36,40,76
10023,SpokaneStBridge,02/22/2015 03:00:00 PM,48,-122,26,40,66
10024,SpokaneStBridge,02/22/2015 04:00:00 PM,48,-122,34,56,90
10025,SpokaneStBridge,02/22/2015 05:00:00 PM,48,-122,9,18,27
10026,SpokaneStBridge,02/22/2015 06:00:00 PM,48,-122,5,11,16
10027,SpokaneStBridge,02/22/2015 07:00:00 PM,48,-122,0,3,3
10028,SpokaneStBridge,02/22/2015 08:00:00 PM,48,-122,2,0,2
10029,SpokaneStBridge,02/22/2015 09:00:00 PM,48,-122,2,3,5
10030,SpokaneStBridge,02/22/2015 10:00:00 PM,48,-122,0,5,5
10031,SpokaneStBridge,02/22/2015 11:00:00 PM,48,-122,1,1,2
10032,SpokaneStBridge,02/23/2015 12:00:00 AM,48,-122,0,0,0
10033,SpokaneStBridge,02/23/2015 01:00:00 AM,48,-122,0,0,0
10034,SpokaneStBridge,02/23/2015 02:00:00 AM,48,-122,1,0,1
10035,SpokaneStBridge,02/23/2015 03:00:00 AM,48,-122,1,3,4
10036,SpokaneStBridge,02/23/2015 04:00:00 AM,48,-122,4,0,4
10037,SpokaneStBridge,02/23/2015 05:00:00 AM,48,-122,10,2,12
10038,SpokaneStBridge,02/23/2015 06:00:00 AM,48,-122,37,10,47
10039,SpokaneStBridge,02/23/2015 07:00:00 AM,48,-122,102,14,116
10040,SpokaneStBridge,02/23/2015 08:00:00 AM,48,-122,76,16,92
10041,SpokaneStBridge,02/23/2015 09:00:00 AM,48,-122,36,12,48
10042,SpokaneStBridge,02/23/2015 10:00:00 AM,48,-122,15,3,18
10043,SpokaneStBridge,02/23/2015 11:00:00 AM,48,-122,10,5,15
10044,SpokaneStBridge,02/23/2015 12:00:00 PM,48,-122,15,8,23
10045,SpokaneStBridge,02/23/2015 01:00:00 PM,48,-122,12,11,23
10046,SpokaneStBridge,02/23/2015 02:00:00 PM,48,-122,5,20,25
10047,SpokaneStBridge,02/23/2015 03:00:00 PM,48,-122,18,36,54
10048,SpokaneStBridge,02/23/2015 04:00:00 PM,48,-122,19,61,80
10049,SpokaneStBridge,02/23/2015 05:00:00 PM,48,-122,24,98,122
10050,SpokaneStBridge,02/23/2015 06:00:00 PM,48,-122,13,92,105
10051,SpokaneStBridge,02/23/2015 07:00:00 PM,48,-122,6,18,24
10052,SpokaneStBridge,02/23/2015 08:00:00 PM,48,-122,1,12,13
10053,SpokaneStBridge,02/23/2015 09:00:00 PM,48,-122,0,3,3
10054,SpokaneStBridge,02/23/2015 10:00:00 PM,48,-122,2,5,7
10055,SpokaneStBridge,02/23/2015 11:00:00 PM,48,-122,3,3,6
10056,SpokaneStBridge,02/24/2015 12:00:00 AM,48,-122,0,1,1
10057,SpokaneStBridge,02/24/2015 01:00:00 AM,48,-122,1,3,4
10058,SpokaneStBridge,02/24/2015 02:00:00 AM,48,-122,0,0,0
10059,SpokaneStBridge,02/24/2015 03:00:00 AM,48,-122,0,0,0
10060,SpokaneStBridge,02/24/2015 04:00:00 AM,48,-122,3,1,4
10061,SpokaneStBridge,02/24/2015 05:00:00 AM,48,-122,19,3,22
10062,SpokaneStBridge,02/24/2015 06:00:00 AM,48,-122,51,9,60
10063,SpokaneStBridge,02/24/2015 07:00:00 AM,48,-122,102,18,120
10064,SpokaneStBridge,02/24/2015 08:00:00 AM,48,-122,103,13,116
10065,SpokaneStBridge,02/24/2015 09:00:00 AM,48,-122,47,7,54
10066,SpokaneStBridge,02/24/2015 10:00:00 AM,48,-122,19,4,23
10067,SpokaneStBridge,02/24/2015 11:00:00 AM,48,-122,13,12,25
10068,SpokaneStBridge,02/24/2015 12:00:00 PM,48,-122,15,9,24
10069,SpokaneStBridge,02/24/2015 01:00:00 PM,48,-122,12,11,23
10070,SpokaneStBridge,02/24/2015 02:00:00 PM,48,-122,7,19,26
10071,SpokaneStBridge,02/24/2015 03:00:00 PM,48,-122,15,25,40
10072,SpokaneStBridge,02/24/2015 04:00:00 PM,48,-122,22,63,85
10073,SpokaneStBridge,02/24/2015 05:00:00 PM,48,-122,24,129,153
10074,SpokaneStBridge,02/24/2015 06:00:00 PM,48,-122,11,74,85
10075,SpokaneStBridge,02/24/2015 07:00:00 PM,48,-122,8,32,40
10076,SpokaneStBridge,02/24/2015 08:00:00 PM,48,-122,0,11,11
10077,SpokaneStBridge,02/24/2015 09:00:00 PM,48,-122,0,14,14
10078,SpokaneStBridge,02/24/2015 10:00:00 PM,48,-122,2,7,9
10079,SpokaneStBridge,02/24/2015 11:00:00 PM,48,-122,5,3,8
10080,SpokaneStBridge,02/25/2015 12:00:00 AM,48,-122,0,2,2
10081,SpokaneStBridge,02/25/2015 01:00:00 AM,48,-122,0,0,0
10082,SpokaneStBridge,02/25/2015 02:00:00 AM,48,-122,0,0,0
10083,SpokaneStBridge,02/25/2015 03:00:00 AM,48,-122,0,0,0
10084,SpokaneStBridge,02/25/2015 04:00:00 AM,48,-122,4,1,5
10085,SpokaneStBridge,02/25/2015 05:00:00 AM,48,-122,13,2,15
10086,SpokaneStBridge,02/25/2015 06:00:00 AM,48,-122,43,8,51
10087,SpokaneStBridge,02/25/2015 07:00:00 AM,48,-122,66,11,77
10088,SpokaneStBridge,02/25/2015 08:00:00 AM,48,-122,103,9,112
10089,SpokaneStBridge,02/25/2015 09:00:00 AM,48,-122,29,2,31
10090,SpokaneStBridge,02/25/2015 10:00:00 AM,48,-122,14,5,19
10091,SpokaneStBridge,02/25/2015 11:00:00 AM,48,-122,9,2,11
10092,SpokaneStBridge,02/25/2015 12:00:00 PM,48,-122,7,3,10
10093,SpokaneStBridge,02/25/2015 01:00:00 PM,48,-122,14,7,21
10094,SpokaneStBridge,02/25/2015 02:00:00 PM,48,-122,8,13,21
10095,SpokaneStBridge,02/25/2015 03:00:00 PM,48,-122,6,31,37
10096,SpokaneStBridge,02/25/2015 04:00:00 PM,48,-122,13,41,54
10097,SpokaneStBridge,02/25/2015 05:00:00 PM,48,-122,11,91,102
10098,SpokaneStBridge,02/25/2015 06:00:00 PM,48,-122,3,56,59
10099,SpokaneStBridge,02/25/2015 07:00:00 PM,48,-122,0,24,24
10100,SpokaneStBridge,02/25/2015 08:00:00 PM,48,-122,11,6,17
10101,SpokaneStBridge,02/25/2015 09:00:00 PM,48,-122,0,7,7
10102,SpokaneStBridge,02/25/2015 10:00:00 PM,48,-122,2,1,3
10103,SpokaneStBridge,02/25/2015 11:00:00 PM,48,-122,0,1,1
10104,SpokaneStBridge,02/26/2015 12:00:00 AM,48,-122,0,0,0
10105,SpokaneStBridge,02/26/2015 01:00:00 AM,48,-122,0,0,0
10106,SpokaneStBridge,02/26/2015 02:00:00 AM,48,-122,0,1,1
10107,SpokaneStBridge,02/26/2015 03:00:00 AM,48,-122,0,1,1
10108,SpokaneStBridge,02/26/2015 04:00:00 AM,48,-122,3,1,4
10109,SpokaneStBridge,02/26/2015 05:00:00 AM,48,-122,11,3,14
10110,SpokaneStBridge,02/26/2015 06:00:00 AM,48,-122,43,10,53
10111,SpokaneStBridge,02/26/2015 07:00:00 AM,48,-122,75,14,89
10112,SpokaneStBridge,02/26/2015 08:00:00 AM,48,-122,87,6,93
10113,SpokaneStBridge,02/26/2015 09:00:00 AM,48,-122,22,0,22
10114,SpokaneStBridge,02/26/2015 10:00:00 AM,48,-122,16,2,18
10115,SpokaneStBridge,02/26/2015 11:00:00 AM,48,-122,8,1,9
10116,SpokaneStBridge,02/26/2015 12:00:00 PM,48,-122,10,6,16
10117,SpokaneStBridge,02/26/2015 01:00:00 PM,48,-122,6,5,11
10118,SpokaneStBridge,02/26/2015 02:00:00 PM,48,-122,6,13,19
10119,SpokaneStBridge,02/26/2015 03:00:00 PM,48,-122,4,24,28
10120,SpokaneStBridge,02/26/2015 04:00:00 PM,48,-122,20,48,68
10121,SpokaneStBridge,02/26/2015 05:00:00 PM,48,-122,19,82,101
10122,SpokaneStBridge,02/26/2015 06:00:00 PM,48,-122,5,51,56
10123,SpokaneStBridge,02/26/2015 07:00:00 PM,48,-122,2,68,70
10124,SpokaneStBridge,02/26/2015 08:00:00 PM,48,-122,2,8,10
10125,SpokaneStBridge,02/26/2015 09:00:00 PM,48,-122,10,2,12
10126,SpokaneStBridge,02/26/2015 10:00:00 PM,48,-122,5,3,8
10127,SpokaneStBridge,02/26/2015 11:00:00 PM,48,-122,22,2,24
10128,SpokaneStBridge,02/27/2015 12:00:00 AM,48,-122,0,0,0
10129,SpokaneStBridge,02/27/2015 01:00:00 AM,48,-122,1,0,1
10130,SpokaneStBridge,02/27/2015 02:00:00 AM,48,-122,0,0,0
10131,SpokaneStBridge,02/27/2015 03:00:00 AM,48,-122,0,1,1
10132,SpokaneStBridge,02/27/2015 04:00:00 AM,48,-122,1,0,1
10133,SpokaneStBridge,02/27/2015 05:00:00 AM,48,-122,12,1,13
10134,SpokaneStBridge,02/27/2015 06:00:00 AM,48,-122,32,5,37
10135,SpokaneStBridge,02/27/2015 07:00:00 AM,48,-122,63,12,75
10136,SpokaneStBridge,02/27/2015 08:00:00 AM,48,-122,61,4,65
10137,SpokaneStBridge,02/27/2015 09:00:00 AM,48,-122,19,1,20
10138,SpokaneStBridge,02/27/2015 10:00:00 AM,48,-122,5,2,7
10139,SpokaneStBridge,02/27/2015 11:00:00 AM,48,-122,4,5,9
10140,SpokaneStBridge,02/27/2015 12:00:00 PM,48,-122,8,3,11
10141,SpokaneStBridge,02/27/2015 01:00:00 PM,48,-122,7,10,17
10142,SpokaneStBridge,02/27/2015 02:00:00 PM,48,-122,13,14,27
10143,SpokaneStBridge,02/27/2015 03:00:00 PM,48,-122,11,14,25
10144,SpokaneStBridge,02/27/2015 04:00:00 PM,48,-122,13,38,51
10145,SpokaneStBridge,02/27/2015 05:00:00 PM,48,-122,11,61,72
10146,SpokaneStBridge,02/27/2015 06:00:00 PM,48,-122,2,43,45
10147,SpokaneStBridge,02/27/2015 07:00:00 PM,48,-122,4,14,18
10148,SpokaneStBridge,02/27/2015 08:00:00 PM,48,-122,1,1,2
10149,SpokaneStBridge,02/27/2015 09:00:00 PM,48,-122,5,6,11
10150,SpokaneStBridge,02/27/2015 10:00:00 PM,48,-122,0,3,3
10151,SpokaneStBridge,02/27/2015 11:00:00 PM,48,-122,0,2,2
10152,SpokaneStBridge,02/28/2015 12:00:00 AM,48,-122,1,0,1
10153,SpokaneStBridge,02/28/2015 01:00:00 AM,48,-122,0,0,0
10154,SpokaneStBridge,02/28/2015 02:00:00 AM,48,-122,2,2,4
10155,SpokaneStBridge,02/28/2015 03:00:00 AM,48,-122,1,2,3
10156,SpokaneStBridge,02/28/2015 04:00:00 AM,48,-122,2,0,2
10157,SpokaneStBridge,02/28/2015 05:00:00 AM,48,-122,3,0,3
10158,SpokaneStBridge,02/28/2015 06:00:00 AM,48,-122,6,2,8
10159,SpokaneStBridge,02/28/2015 07:00:00 AM,48,-122,10,1,11
10160,SpokaneStBridge,02/28/2015 08:00:00 AM,48,-122,10,9,19
10161,SpokaneStBridge,02/28/2015 09:00:00 AM,48,-122,17,14,31
10162,SpokaneStBridge,02/28/2015 10:00:00 AM,48,-122,33,27,60
10163,SpokaneStBridge,02/28/2015 11:00:00 AM,48,-122,49,41,90
10164,SpokaneStBridge,02/28/2015 12:00:00 PM,48,-122,48,51,99
10165,SpokaneStBridge,02/28/2015 01:00:00 PM,48,-122,38,34,72
10166,SpokaneStBridge,02/28/2015 02:00:00 PM,48,-122,38,43,81
10167,SpokaneStBridge,02/28/2015 03:00:00 PM,48,-122,33,43,76
10168,SpokaneStBridge,02/28/2015 04:00:00 PM,48,-122,23,25,48
10169,SpokaneStBridge,02/28/2015 05:00:00 PM,48,-122,17,28,45
10170,SpokaneStBridge,02/28/2015 06:00:00 PM,48,-122,9,10,19
10171,SpokaneStBridge,02/28/2015 07:00:00 PM,48,-122,5,11,16
10172,SpokaneStBridge,02/28/2015 08:00:00 PM,48,-122,8,5,13
10173,SpokaneStBridge,02/28/2015 09:00:00 PM,48,-122,5,3,8
10174,SpokaneStBridge,02/28/2015 10:00:00 PM,48,-122,3,1,4
10175,SpokaneStBridge,02/28/2015 11:00:00 PM,48,-122,0,4,4
10176,SpokaneStBridge,03/01/2015 12:00:00 AM,48,-122,1,0,1
10177,SpokaneStBridge,03/01/2015 01:00:00 AM,48,-122,3,5,8
10178,SpokaneStBridge,03/01/2015 02:00:00 AM,48,-122,0,0,0
10179,SpokaneStBridge,03/01/2015 03:00:00 AM,48,-122,2,2,4
10180,SpokaneStBridge,03/01/2015 04:00:00 AM,48,-122,0,1,1
10181,SpokaneStBridge,03/01/2015 05:00:00 AM,48,-122,3,0,3
10182,SpokaneStBridge,03/01/2015 06:00:00 AM,48,-122,2,1,3
10183,SpokaneStBridge,03/01/2015 07:00:00 AM,48,-122,5,3,8
10184,SpokaneStBridge,03/01/2015 08:00:00 AM,48,-122,13,6,19
10185,SpokaneStBridge,03/01/2015 09:00:00 AM,48,-122,19,16,35
10186,SpokaneStBridge,03/01/2015 10:00:00 AM,48,-122,25,22,47
10187,SpokaneStBridge,03/01/2015 11:00:00 AM,48,-122,32,54,86
10188,SpokaneStBridge,03/01/2015 12:00:00 PM,48,-122,54,44,98
10189,SpokaneStBridge,03/01/2015 01:00:00 PM,48,-122,44,39,83
10190,SpokaneStBridge,03/01/2015 02:00:00 PM,48,-122,32,27,59
10191,SpokaneStBridge,03/01/2015 03:00:00 PM,48,-122,26,28,54
10192,SpokaneStBridge,03/01/2015 04:00:00 PM,48,-122,25,37,62
10193,SpokaneStBridge,03/01/2015 05:00:00 PM,48,-122,24,12,36
10194,SpokaneStBridge,03/01/2015 06:00:00 PM,48,-122,13,9,22
10195,SpokaneStBridge,03/01/2015 07:00:00 PM,48,-122,6,3,9
10196,SpokaneStBridge,03/01/2015 08:00:00 PM,48,-122,0,5,5
10197,SpokaneStBridge,03/01/2015 09:00:00 PM,48,-122,0,4,4
10198,SpokaneStBridge,03/01/2015 10:00:00 PM,48,-122,1,2,3
10199,SpokaneStBridge,03/01/2015 11:00:00 PM,48,-122,0,1,1
10200,SpokaneStBridge,03/02/2015 12:00:00 AM,48,-122,0,0,0
10201,SpokaneStBridge,03/02/2015 01:00:00 AM,48,-122,0,1,1
10202,SpokaneStBridge,03/02/2015 02:00:00 AM,48,-122,0,0,0
10203,SpokaneStBridge,03/02/2015 03:00:00 AM,48,-122,2,0,2
10204,SpokaneStBridge,03/02/2015 04:00:00 AM,48,-122,4,0,4
10205,SpokaneStBridge,03/02/2015 05:00:00 AM,48,-122,17,5,22
10206,SpokaneStBridge,03/02/2015 06:00:00 AM,48,-122,45,7,52
10207,SpokaneStBridge,03/02/2015 07:00:00 AM,48,-122,101,15,116
10208,SpokaneStBridge,03/02/2015 08:00:00 AM,48,-122,89,14,103
10209,SpokaneStBridge,03/02/2015 09:00:00 AM,48,-122,38,2,40
10210,SpokaneStBridge,03/02/2015 10:00:00 AM,48,-122,15,4,19
10211,SpokaneStBridge,03/02/2015 11:00:00 AM,48,-122,4,3,7
10212,SpokaneStBridge,03/02/2015 12:00:00 PM,48,-122,6,2,8
10213,SpokaneStBridge,03/02/2015 01:00:00 PM,48,-122,9,9,18
10214,SpokaneStBridge,03/02/2015 02:00:00 PM,48,-122,9,7,16
10215,SpokaneStBridge,03/02/2015 03:00:00 PM,48,-122,6,29,35
10216,SpokaneStBridge,03/02/2015 04:00:00 PM,48,-122,19,71,90
10217,SpokaneStBridge,03/02/2015 05:00:00 PM,48,-122,15,109,124
10218,SpokaneStBridge,03/02/2015 06:00:00 PM,48,-122,10,83,93
10219,SpokaneStBridge,03/02/2015 07:00:00 PM,48,-122,4,20,24
10220,SpokaneStBridge,03/02/2015 08:00:00 PM,48,-122,2,9,11
10221,SpokaneStBridge,03/02/2015 09:00:00 PM,48,-122,2,8,10
10222,SpokaneStBridge,03/02/2015 10:00:00 PM,48,-122,0,5,5
10223,SpokaneStBridge,03/02/2015 11:00:00 PM,48,-122,1,3,4
10224,SpokaneStBridge,03/03/2015 12:00:00 AM,48,-122,1,1,2
10225,SpokaneStBridge,03/03/2015 01:00:00 AM,48,-122,0,2,2
10226,SpokaneStBridge,03/03/2015 02:00:00 AM,48,-122,1,2,3
10227,SpokaneStBridge,03/03/2015 03:00:00 AM,48,-122,0,1,1
10228,SpokaneStBridge,03/03/2015 04:00:00 AM,48,-122,5,0,5
10229,SpokaneStBridge,03/03/2015 05:00:00 AM,48,-122,19,5,24
10230,SpokaneStBridge,03/03/2015 06:00:00 AM,48,-122,55,3,58
10231,SpokaneStBridge,03/03/2015 07:00:00 AM,48,-122,113,15,128
10232,SpokaneStBridge,03/03/2015 08:00:00 AM,48,-122,115,13,128
10233,SpokaneStBridge,03/03/2015 09:00:00 AM,48,-122,25,3,28
10234,SpokaneStBridge,03/03/2015 10:00:00 AM,48,-122,11,4,15
10235,SpokaneStBridge,03/03/2015 11:00:00 AM,48,-122,9,24,33
10236,SpokaneStBridge,03/03/2015 12:00:00 PM,48,-122,24,16,40
10237,SpokaneStBridge,03/03/2015 01:00:00 PM,48,-122,11,12,23
10238,SpokaneStBridge,03/03/2015 02:00:00 PM,48,-122,8,17,25
10239,SpokaneStBridge,03/03/2015 03:00:00 PM,48,-122,13,33,46
10240,SpokaneStBridge,03/03/2015 04:00:00 PM,48,-122,17,69,86
10241,SpokaneStBridge,03/03/2015 05:00:00 PM,48,-122,20,125,145
10242,SpokaneStBridge,03/03/2015 06:00:00 PM,48,-122,11,85,96
10243,SpokaneStBridge,03/03/2015 07:00:00 PM,48,-122,5,28,33
10244,SpokaneStBridge,03/03/2015 08:00:00 PM,48,-122,2,9,11
10245,SpokaneStBridge,03/03/2015 09:00:00 PM,48,-122,1,9,10
10246,SpokaneStBridge,03/03/2015 10:00:00 PM,48,-122,1,4,5
10247,SpokaneStBridge,03/03/2015 11:00:00 PM,48,-122,0,1,1
10248,SpokaneStBridge,03/04/2015 12:00:00 AM,48,-122,0,1,1
10249,SpokaneStBridge,03/04/2015 01:00:00 AM,48,-122,1,2,3
10250,SpokaneStBridge,03/04/2015 02:00:00 AM,48,-122,0,0,0
10251,SpokaneStBridge,03/04/2015 03:00:00 AM,48,-122,0,0,0
10252,SpokaneStBridge,03/04/2015 04:00:00 AM,48,-122,3,1,4
10253,SpokaneStBridge,03/04/2015 05:00:00 AM,48,-122,15,2,17
10254,SpokaneStBridge,03/04/2015 06:00:00 AM,48,-122,49,12,61
10255,SpokaneStBridge,03/04/2015 07:00:00 AM,48,-122,82,14,96
10256,SpokaneStBridge,03/04/2015 08:00:00 AM,48,-122,104,14,118
10257,SpokaneStBridge,03/04/2015 09:00:00 AM,48,-122,37,10,47
10258,SpokaneStBridge,03/04/2015 10:00:00 AM,48,-122,15,11,26
10259,SpokaneStBridge,03/04/2015 11:00:00 AM,48,-122,10,13,23
10260,SpokaneStBridge,03/04/2015 12:00:00 PM,48,-122,23,13,36
10261,SpokaneStBridge,03/04/2015 01:00:00 PM,48,-122,15,16,31
10262,SpokaneStBridge,03/04/2015 02:00:00 PM,48,-122,15,21,36
10263,SpokaneStBridge,03/04/2015 03:00:00 PM,48,-122,17,31,48
10264,SpokaneStBridge,03/04/2015 04:00:00 PM,48,-122,17,63,80
10265,SpokaneStBridge,03/04/2015 05:00:00 PM,48,-122,23,110,133
10266,SpokaneStBridge,03/04/2015 06:00:00 PM,48,-122,12,64,76
10267,SpokaneStBridge,03/04/2015 07:00:00 PM,48,-122,4,22,26
10268,SpokaneStBridge,03/04/2015 08:00:00 PM,48,-122,2,7,9
10269,SpokaneStBridge,03/04/2015 09:00:00 PM,48,-122,3,10,13
10270,SpokaneStBridge,03/04/2015 10:00:00 PM,48,-122,0,5,5
10271,SpokaneStBridge,03/04/2015 11:00:00 PM,48,-122,0,0,0
10272,SpokaneStBridge,03/05/2015 12:00:00 AM,48,-122,1,1,2
10273,SpokaneStBridge,03/05/2015 01:00:00 AM,48,-122,1,0,1
10274,SpokaneStBridge,03/05/2015 02:00:00 AM,48,-122,0,1,1
10275,SpokaneStBridge,03/05/2015 03:00:00 AM,48,-122,1,0,1
10276,SpokaneStBridge,03/05/2015 04:00:00 AM,48,-122,3,1,4
10277,SpokaneStBridge,03/05/2015 05:00:00 AM,48,-122,16,3,19
10278,SpokaneStBridge,03/05/2015 06:00:00 AM,48,-122,55,6,61
10279,SpokaneStBridge,03/05/2015 07:00:00 AM,48,-122,76,18,94
10280,SpokaneStBridge,03/05/2015 08:00:00 AM,48,-122,107,11,118
10281,SpokaneStBridge,03/05/2015 09:00:00 AM,48,-122,45,10,55
10282,SpokaneStBridge,03/05/2015 10:00:00 AM,48,-122,19,13,32
10283,SpokaneStBridge,03/05/2015 11:00:00 AM,48,-122,13,9,22
10284,SpokaneStBridge,03/05/2015 12:00:00 PM,48,-122,22,13,35
10285,SpokaneStBridge,03/05/2015 01:00:00 PM,48,-122,16,14,30
10286,SpokaneStBridge,03/05/2015 02:00:00 PM,48,-122,11,30,41
10287,SpokaneStBridge,03/05/2015 03:00:00 PM,48,-122,14,40,54
10288,SpokaneStBridge,03/05/2015 04:00:00 PM,48,-122,15,59,74
10289,SpokaneStBridge,03/05/2015 05:00:00 PM,48,-122,23,116,139
10290,SpokaneStBridge,03/05/2015 06:00:00 PM,48,-122,7,60,67
10291,SpokaneStBridge,03/05/2015 07:00:00 PM,48,-122,2,28,30
10292,SpokaneStBridge,03/05/2015 08:00:00 PM,48,-122,4,9,13
10293,SpokaneStBridge,03/05/2015 09:00:00 PM,48,-122,3,2,5
10294,SpokaneStBridge,03/05/2015 10:00:00 PM,48,-122,1,4,5
10295,SpokaneStBridge,03/05/2015 11:00:00 PM,48,-122,1,2,3
10296,SpokaneStBridge,03/06/2015 12:00:00 AM,48,-122,1,1,2
10297,SpokaneStBridge,03/06/2015 01:00:00 AM,48,-122,2,2,4
10298,SpokaneStBridge,03/06/2015 02:00:00 AM,48,-122,2,2,4
10299,SpokaneStBridge,03/06/2015 03:00:00 AM,48,-122,1,1,2
10300,SpokaneStBridge,03/06/2015 04:00:00 AM,48,-122,6,2,8
10301,SpokaneStBridge,03/06/2015 05:00:00 AM,48,-122,15,1,16
10302,SpokaneStBridge,03/06/2015 06:00:00 AM,48,-122,47,10,57
10303,SpokaneStBridge,03/06/2015 07:00:00 AM,48,-122,84,13,97
10304,SpokaneStBridge,03/06/2015 08:00:00 AM,48,-122,72,12,84
10305,SpokaneStBridge,03/06/2015 09:00:00 AM,48,-122,37,4,41
10306,SpokaneStBridge,03/06/2015 10:00:00 AM,48,-122,8,4,12
10307,SpokaneStBridge,03/06/2015 11:00:00 AM,48,-122,11,4,15
10308,SpokaneStBridge,03/06/2015 12:00:00 PM,48,-122,18,18,36
10309,SpokaneStBridge,03/06/2015 01:00:00 PM,48,-122,23,17,40
10310,SpokaneStBridge,03/06/2015 02:00:00 PM,48,-122,18,26,44
10311,SpokaneStBridge,03/06/2015 03:00:00 PM,48,-122,11,33,44
10312,SpokaneStBridge,03/06/2015 04:00:00 PM,48,-122,22,62,84
10313,SpokaneStBridge,03/06/2015 05:00:00 PM,48,-122,19,102,121
10314,SpokaneStBridge,03/06/2015 06:00:00 PM,48,-122,9,46,55
10315,SpokaneStBridge,03/06/2015 07:00:00 PM,48,-122,6,12,18
10316,SpokaneStBridge,03/06/2015 08:00:00 PM,48,-122,8,9,17
10317,SpokaneStBridge,03/06/2015 09:00:00 PM,48,-122,3,1,4
10318,SpokaneStBridge,03/06/2015 10:00:00 PM,48,-122,0,3,3
10319,SpokaneStBridge,03/06/2015 11:00:00 PM,48,-122,0,0,0
10320,SpokaneStBridge,03/07/2015 12:00:00 AM,48,-122,1,2,3
10321,SpokaneStBridge,03/07/2015 01:00:00 AM,48,-122,1,2,3
10322,SpokaneStBridge,03/07/2015 02:00:00 AM,48,-122,0,0,0
10323,SpokaneStBridge,03/07/2015 03:00:00 AM,48,-122,1,0,1
10324,SpokaneStBridge,03/07/2015 04:00:00 AM,48,-122,1,1,2
10325,SpokaneStBridge,03/07/2015 05:00:00 AM,48,-122,6,0,6
10326,SpokaneStBridge,03/07/2015 06:00:00 AM,48,-122,4,1,5
10327,SpokaneStBridge,03/07/2015 07:00:00 AM,48,-122,9,2,11
10328,SpokaneStBridge,03/07/2015 08:00:00 AM,48,-122,24,8,32
10329,SpokaneStBridge,03/07/2015 09:00:00 AM,48,-122,18,21,39
10330,SpokaneStBridge,03/07/2015 10:00:00 AM,48,-122,23,14,37
10331,SpokaneStBridge,03/07/2015 11:00:00 AM,48,-122,30,25,55
10332,SpokaneStBridge,03/07/2015 12:00:00 PM,48,-122,32,39,71
10333,SpokaneStBridge,03/07/2015 01:00:00 PM,48,-122,34,32,66
10334,SpokaneStBridge,03/07/2015 02:00:00 PM,48,-122,36,55,91
10335,SpokaneStBridge,03/07/2015 03:00:00 PM,48,-122,46,49,95
10336,SpokaneStBridge,03/07/2015 04:00:00 PM,48,-122,28,19,47
10337,SpokaneStBridge,03/07/2015 05:00:00 PM,48,-122,24,22,46
10338,SpokaneStBridge,03/07/2015 06:00:00 PM,48,-122,16,16,32
10339,SpokaneStBridge,03/07/2015 07:00:00 PM,48,-122,3,2,5
10340,SpokaneStBridge,03/07/2015 08:00:00 PM,48,-122,3,3,6
10341,SpokaneStBridge,03/07/2015 09:00:00 PM,48,-122,0,3,3
10342,SpokaneStBridge,03/07/2015 10:00:00 PM,48,-122,5,1,6
10343,SpokaneStBridge,03/07/2015 11:00:00 PM,48,-122,0,2,2
10344,SpokaneStBridge,03/08/2015 12:00:00 AM,48,-122,1,1,2
10345,SpokaneStBridge,03/08/2015 01:00:00 AM,48,-122,2,2,4
10346,SpokaneStBridge,03/08/2015 03:00:00 AM,48,-122,,,
10347,SpokaneStBridge,03/08/2015 03:00:00 AM,48,-122,1,0,1
10348,SpokaneStBridge,03/08/2015 04:00:00 AM,48,-122,1,5,6
10349,SpokaneStBridge,03/08/2015 05:00:00 AM,48,-122,3,0,3
10350,SpokaneStBridge,03/08/2015 06:00:00 AM,48,-122,0,0,0
10351,SpokaneStBridge,03/08/2015 07:00:00 AM,48,-122,7,5,12
10352,SpokaneStBridge,03/08/2015 08:00:00 AM,48,-122,6,4,10
10353,SpokaneStBridge,03/08/2015 09:00:00 AM,48,-122,21,8,29
10354,SpokaneStBridge,03/08/2015 10:00:00 AM,48,-122,28,17,45
10355,SpokaneStBridge,03/08/2015 11:00:00 AM,48,-122,36,46,82
10356,SpokaneStBridge,03/08/2015 12:00:00 PM,48,-122,47,39,86
10357,SpokaneStBridge,03/08/2015 01:00:00 PM,48,-122,37,44,81
10358,SpokaneStBridge,03/08/2015 02:00:00 PM,48,-122,47,56,103
10359,SpokaneStBridge,03/08/2015 03:00:00 PM,48,-122,35,51,86
10360,SpokaneStBridge,03/08/2015 04:00:00 PM,48,-122,46,31,77
10361,SpokaneStBridge,03/08/2015 05:00:00 PM,48,-122,23,16,39
10362,SpokaneStBridge,03/08/2015 06:00:00 PM,48,-122,21,17,38
10363,SpokaneStBridge,03/08/2015 07:00:00 PM,48,-122,6,4,10
10364,SpokaneStBridge,03/08/2015 08:00:00 PM,48,-122,2,9,11
10365,SpokaneStBridge,03/08/2015 09:00:00 PM,48,-122,1,2,3
10366,SpokaneStBridge,03/08/2015 10:00:00 PM,48,-122,0,5,5
10367,SpokaneStBridge,03/08/2015 11:00:00 PM,48,-122,0,1,1
10368,SpokaneStBridge,03/09/2015 12:00:00 AM,48,-122,0,0,0
10369,SpokaneStBridge,03/09/2015 01:00:00 AM,48,-122,1,0,1
10370,SpokaneStBridge,03/09/2015 02:00:00 AM,48,-122,1,1,2
10371,SpokaneStBridge,03/09/2015 03:00:00 AM,48,-122,1,0,1
10372,SpokaneStBridge,03/09/2015 04:00:00 AM,48,-122,4,1,5
10373,SpokaneStBridge,03/09/2015 05:00:00 AM,48,-122,10,1,11
10374,SpokaneStBridge,03/09/2015 06:00:00 AM,48,-122,50,7,57
10375,SpokaneStBridge,03/09/2015 07:00:00 AM,48,-122,86,12,98
10376,SpokaneStBridge,03/09/2015 08:00:00 AM,48,-122,102,14,116
10377,SpokaneStBridge,03/09/2015 09:00:00 AM,48,-122,50,7,57
10378,SpokaneStBridge,03/09/2015 10:00:00 AM,48,-122,17,3,20
10379,SpokaneStBridge,03/09/2015 11:00:00 AM,48,-122,7,7,14
10380,SpokaneStBridge,03/09/2015 12:00:00 PM,48,-122,23,10,33
10381,SpokaneStBridge,03/09/2015 01:00:00 PM,48,-122,13,14,27
10382,SpokaneStBridge,03/09/2015 02:00:00 PM,48,-122,12,22,34
10383,SpokaneStBridge,03/09/2015 03:00:00 PM,48,-122,8,30,38
10384,SpokaneStBridge,03/09/2015 04:00:00 PM,48,-122,12,68,80
10385,SpokaneStBridge,03/09/2015 05:00:00 PM,48,-122,22,120,142
10386,SpokaneStBridge,03/09/2015 06:00:00 PM,48,-122,13,86,99
10387,SpokaneStBridge,03/09/2015 07:00:00 PM,48,-122,5,25,30
10388,SpokaneStBridge,03/09/2015 08:00:00 PM,48,-122,5,11,16
10389,SpokaneStBridge,03/09/2015 09:00:00 PM,48,-122,4,5,9
10390,SpokaneStBridge,03/09/2015 10:00:00 PM,48,-122,1,1,2
10391,SpokaneStBridge,03/09/2015 11:00:00 PM,48,-122,3,7,10
10392,SpokaneStBridge,03/10/2015 12:00:00 AM,48,-122,0,1,1
10393,SpokaneStBridge,03/10/2015 01:00:00 AM,48,-122,0,2,2
10394,SpokaneStBridge,03/10/2015 02:00:00 AM,48,-122,0,2,2
10395,SpokaneStBridge,03/10/2015 03:00:00 AM,48,-122,2,1,3
10396,SpokaneStBridge,03/10/2015 04:00:00 AM,48,-122,2,1,3
10397,SpokaneStBridge,03/10/2015 05:00:00 AM,48,-122,21,3,24
10398,SpokaneStBridge,03/10/2015 06:00:00 AM,48,-122,42,7,49
10399,SpokaneStBridge,03/10/2015 07:00:00 AM,48,-122,112,11,123
10400,SpokaneStBridge,03/10/2015 08:00:00 AM,48,-122,104,18,122
10401,SpokaneStBridge,03/10/2015 09:00:00 AM,48,-122,45,7,52
10402,SpokaneStBridge,03/10/2015 10:00:00 AM,48,-122,13,2,15
10403,SpokaneStBridge,03/10/2015 11:00:00 AM,48,-122,7,6,13
10404,SpokaneStBridge,03/10/2015 12:00:00 PM,48,-122,12,9,21
10405,SpokaneStBridge,03/10/2015 01:00:00 PM,48,-122,17,18,35
10406,SpokaneStBridge,03/10/2015 02:00:00 PM,48,-122,13,14,27
10407,SpokaneStBridge,03/10/2015 03:00:00 PM,48,-122,4,31,35
10408,SpokaneStBridge,03/10/2015 04:00:00 PM,48,-122,14,83,97
10409,SpokaneStBridge,03/10/2015 05:00:00 PM,48,-122,22,120,142
10410,SpokaneStBridge,03/10/2015 06:00:00 PM,48,-122,15,95,110
10411,SpokaneStBridge,03/10/2015 07:00:00 PM,48,-122,8,29,37
10412,SpokaneStBridge,03/10/2015 08:00:00 PM,48,-122,2,12,14
10413,SpokaneStBridge,03/10/2015 09:00:00 PM,48,-122,4,6,10
10414,SpokaneStBridge,03/10/2015 10:00:00 PM,48,-122,4,5,9
10415,SpokaneStBridge,03/10/2015 11:00:00 PM,48,-122,0,6,6
10416,SpokaneStBridge,03/11/2015 12:00:00 AM,48,-122,0,1,1
10417,SpokaneStBridge,03/11/2015 01:00:00 AM,48,-122,1,0,1
10418,SpokaneStBridge,03/11/2015 02:00:00 AM,48,-122,2,0,2
10419,SpokaneStBridge,03/11/2015 03:00:00 AM,48,-122,0,1,1
10420,SpokaneStBridge,03/11/2015 04:00:00 AM,48,-122,3,0,3
10421,SpokaneStBridge,03/11/2015 05:00:00 AM,48,-122,12,2,14
10422,SpokaneStBridge,03/11/2015 06:00:00 AM,48,-122,30,6,36
10423,SpokaneStBridge,03/11/2015 07:00:00 AM,48,-122,81,17,98
10424,SpokaneStBridge,03/11/2015 08:00:00 AM,48,-122,78,9,87
10425,SpokaneStBridge,03/11/2015 09:00:00 AM,48,-122,24,3,27
10426,SpokaneStBridge,03/11/2015 10:00:00 AM,48,-122,10,3,13
10427,SpokaneStBridge,03/11/2015 11:00:00 AM,48,-122,10,11,21
10428,SpokaneStBridge,03/11/2015 12:00:00 PM,48,-122,8,5,13
10429,SpokaneStBridge,03/11/2015 01:00:00 PM,48,-122,10,3,13
10430,SpokaneStBridge,03/11/2015 02:00:00 PM,48,-122,5,10,15
10431,SpokaneStBridge,03/11/2015 03:00:00 PM,48,-122,5,14,19
10432,SpokaneStBridge,03/11/2015 04:00:00 PM,48,-122,6,36,42
10433,SpokaneStBridge,03/11/2015 05:00:00 PM,48,-122,19,85,104
10434,SpokaneStBridge,03/11/2015 06:00:00 PM,48,-122,11,49,60
10435,SpokaneStBridge,03/11/2015 07:00:00 PM,48,-122,3,19,22
10436,SpokaneStBridge,03/11/2015 08:00:00 PM,48,-122,4,14,18
10437,SpokaneStBridge,03/11/2015 09:00:00 PM,48,-122,0,3,3
10438,SpokaneStBridge,03/11/2015 10:00:00 PM,48,-122,4,7,11
10439,SpokaneStBridge,03/11/2015 11:00:00 PM,48,-122,0,2,2
10440,SpokaneStBridge,03/12/2015 12:00:00 AM,48,-122,0,1,1
10441,SpokaneStBridge,03/12/2015 01:00:00 AM,48,-122,1,2,3
10442,SpokaneStBridge,03/12/2015 02:00:00 AM,48,-122,1,0,1
10443,SpokaneStBridge,03/12/2015 03:00:00 AM,48,-122,0,0,0
10444,SpokaneStBridge,03/12/2015 04:00:00 AM,48,-122,1,0,1
10445,SpokaneStBridge,03/12/2015 05:00:00 AM,48,-122,14,3,17
10446,SpokaneStBridge,03/12/2015 06:00:00 AM,48,-122,50,11,61
10447,SpokaneStBridge,03/12/2015 07:00:00 AM,48,-122,93,13,106
10448,SpokaneStBridge,03/12/2015 08:00:00 AM,48,-122,93,7,100
10449,SpokaneStBridge,03/12/2015 09:00:00 AM,48,-122,40,5,45
10450,SpokaneStBridge,03/12/2015 10:00:00 AM,48,-122,20,6,26
10451,SpokaneStBridge,03/12/2015 11:00:00 AM,48,-122,8,7,15
10452,SpokaneStBridge,03/12/2015 12:00:00 PM,48,-122,12,4,16
10453,SpokaneStBridge,03/12/2015 01:00:00 PM,48,-122,19,12,31
10454,SpokaneStBridge,03/12/2015 02:00:00 PM,48,-122,11,14,25
10455,SpokaneStBridge,03/12/2015 03:00:00 PM,48,-122,23,36,59
10456,SpokaneStBridge,03/12/2015 04:00:00 PM,48,-122,30,55,85
10457,SpokaneStBridge,03/12/2015 05:00:00 PM,48,-122,22,101,123
10458,SpokaneStBridge,03/12/2015 06:00:00 PM,48,-122,19,73,92
10459,SpokaneStBridge,03/12/2015 07:00:00 PM,48,-122,9,42,51
10460,SpokaneStBridge,03/12/2015 08:00:00 PM,48,-122,9,11,20
10461,SpokaneStBridge,03/12/2015 09:00:00 PM,48,-122,10,12,22
10462,SpokaneStBridge,03/12/2015 10:00:00 PM,48,-122,3,5,8
10463,SpokaneStBridge,03/12/2015 11:00:00 PM,48,-122,1,6,7
10464,SpokaneStBridge,03/13/2015 12:00:00 AM,48,-122,2,2,4
10465,SpokaneStBridge,03/13/2015 01:00:00 AM,48,-122,0,3,3
10466,SpokaneStBridge,03/13/2015 02:00:00 AM,48,-122,2,2,4
10467,SpokaneStBridge,03/13/2015 03:00:00 AM,48,-122,2,0,2
10468,SpokaneStBridge,03/13/2015 04:00:00 AM,48,-122,2,0,2
10469,SpokaneStBridge,03/13/2015 05:00:00 AM,48,-122,12,1,13
10470,SpokaneStBridge,03/13/2015 06:00:00 AM,48,-122,50,13,63
10471,SpokaneStBridge,03/13/2015 07:00:00 AM,48,-122,94,20,114
10472,SpokaneStBridge,03/13/2015 08:00:00 AM,48,-122,91,24,115
10473,SpokaneStBridge,03/13/2015 09:00:00 AM,48,-122,39,14,53
10474,SpokaneStBridge,03/13/2015 10:00:00 AM,48,-122,17,8,25
10475,SpokaneStBridge,03/13/2015 11:00:00 AM,48,-122,7,14,21
10476,SpokaneStBridge,03/13/2015 12:00:00 PM,48,-122,10,13,23
10477,SpokaneStBridge,03/13/2015 01:00:00 PM,48,-122,30,17,47
10478,SpokaneStBridge,03/13/2015 02:00:00 PM,48,-122,18,27,45
10479,SpokaneStBridge,03/13/2015 03:00:00 PM,48,-122,16,33,49
10480,SpokaneStBridge,03/13/2015 04:00:00 PM,48,-122,21,75,96
10481,SpokaneStBridge,03/13/2015 05:00:00 PM,48,-122,14,106,120
10482,SpokaneStBridge,03/13/2015 06:00:00 PM,48,-122,11,60,71
10483,SpokaneStBridge,03/13/2015 07:00:00 PM,48,-122,0,27,27
10484,SpokaneStBridge,03/13/2015 08:00:00 PM,48,-122,11,7,18
10485,SpokaneStBridge,03/13/2015 09:00:00 PM,48,-122,1,7,8
10486,SpokaneStBridge,03/13/2015 10:00:00 PM,48,-122,5,3,8
10487,SpokaneStBridge,03/13/2015 11:00:00 PM,48,-122,2,3,5
10488,SpokaneStBridge,03/14/2015 12:00:00 AM,48,-122,0,4,4
10489,SpokaneStBridge,03/14/2015 01:00:00 AM,48,-122,2,0,2
10490,SpokaneStBridge,03/14/2015 02:00:00 AM,48,-122,0,0,0
10491,SpokaneStBridge,03/14/2015 03:00:00 AM,48,-122,1,0,1
10492,SpokaneStBridge,03/14/2015 04:00:00 AM,48,-122,0,0,0
10493,SpokaneStBridge,03/14/2015 05:00:00 AM,48,-122,3,0,3
10494,SpokaneStBridge,03/14/2015 06:00:00 AM,48,-122,5,2,7
10495,SpokaneStBridge,03/14/2015 07:00:00 AM,48,-122,0,2,2
10496,SpokaneStBridge,03/14/2015 08:00:00 AM,48,-122,3,2,5
10497,SpokaneStBridge,03/14/2015 09:00:00 AM,48,-122,2,3,5
10498,SpokaneStBridge,03/14/2015 10:00:00 AM,48,-122,4,7,11
10499,SpokaneStBridge,03/14/2015 11:00:00 AM,48,-122,3,5,8
10500,SpokaneStBridge,03/14/2015 12:00:00 PM,48,-122,2,6,8
10501,SpokaneStBridge,03/14/2015 01:00:00 PM,48,-122,2,3,5
10502,SpokaneStBridge,03/14/2015 02:00:00 PM,48,-122,14,3,17
10503,SpokaneStBridge,03/14/2015 03:00:00 PM,48,-122,9,6,15
10504,SpokaneStBridge,03/14/2015 04:00:00 PM,48,-122,6,4,10
10505,SpokaneStBridge,03/14/2015 05:00:00 PM,48,-122,8,7,15
10506,SpokaneStBridge,03/14/2015 06:00:00 PM,48,-122,6,7,13
10507,SpokaneStBridge,03/14/2015 07:00:00 PM,48,-122,4,5,9
10508,SpokaneStBridge,03/14/2015 08:00:00 PM,48,-122,1,0,1
10509,SpokaneStBridge,03/14/2015 09:00:00 PM,48,-122,0,3,3
10510,SpokaneStBridge,03/14/2015 10:00:00 PM,48,-122,0,7,7
10511,SpokaneStBridge,03/14/2015 11:00:00 PM,48,-122,0,4,4
10512,SpokaneStBridge,03/15/2015 12:00:00 AM,48,-122,2,5,7
10513,SpokaneStBridge,03/15/2015 01:00:00 AM,48,-122,4,0,4
10514,SpokaneStBridge,03/15/2015 02:00:00 AM,48,-122,0,0,0
10515,SpokaneStBridge,03/15/2015 03:00:00 AM,48,-122,5,0,5
10516,SpokaneStBridge,03/15/2015 04:00:00 AM,48,-122,0,1,1
10517,SpokaneStBridge,03/15/2015 05:00:00 AM,48,-122,3,0,3
10518,SpokaneStBridge,03/15/2015 06:00:00 AM,48,-122,1,0,1
10519,SpokaneStBridge,03/15/2015 07:00:00 AM,48,-122,1,2,3
10520,SpokaneStBridge,03/15/2015 08:00:00 AM,48,-122,5,0,5
10521,SpokaneStBridge,03/15/2015 09:00:00 AM,48,-122,2,5,7
10522,SpokaneStBridge,03/15/2015 10:00:00 AM,48,-122,0,1,1
10523,SpokaneStBridge,03/15/2015 11:00:00 AM,48,-122,2,2,4
10524,SpokaneStBridge,03/15/2015 12:00:00 PM,48,-122,4,1,5
10525,SpokaneStBridge,03/15/2015 01:00:00 PM,48,-122,0,0,0
10526,SpokaneStBridge,03/15/2015 02:00:00 PM,48,-122,0,2,2
10527,SpokaneStBridge,03/15/2015 03:00:00 PM,48,-122,1,3,4
10528,SpokaneStBridge,03/15/2015 04:00:00 PM,48,-122,2,1,3
10529,SpokaneStBridge,03/15/2015 05:00:00 PM,48,-122,3,0,3
10530,SpokaneStBridge,03/15/2015 06:00:00 PM,48,-122,1,2,3
10531,SpokaneStBridge,03/15/2015 07:00:00 PM,48,-122,0,1,1
10532,SpokaneStBridge,03/15/2015 08:00:00 PM,48,-122,0,0,0
10533,SpokaneStBridge,03/15/2015 09:00:00 PM,48,-122,1,0,1
10534,SpokaneStBridge,03/15/2015 10:00:00 PM,48,-122,0,1,1
10535,SpokaneStBridge,03/15/2015 11:00:00 PM,48,-122,0,0,0
10536,SpokaneStBridge,03/16/2015 12:00:00 AM,48,-122,0,0,0
10537,SpokaneStBridge,03/16/2015 01:00:00 AM,48,-122,0,1,1
10538,SpokaneStBridge,03/16/2015 02:00:00 AM,48,-122,0,0,0
10539,SpokaneStBridge,03/16/2015 03:00:00 AM,48,-122,2,1,3
10540,SpokaneStBridge,03/16/2015 04:00:00 AM,48,-122,1,1,2
10541,SpokaneStBridge,03/16/2015 05:00:00 AM,48,-122,6,1,7
10542,SpokaneStBridge,03/16/2015 06:00:00 AM,48,-122,40,6,46
10543,SpokaneStBridge,03/16/2015 07:00:00 AM,48,-122,81,11,92
10544,SpokaneStBridge,03/16/2015 08:00:00 AM,48,-122,90,8,98
10545,SpokaneStBridge,03/16/2015 09:00:00 AM,48,-122,38,3,41
10546,SpokaneStBridge,03/16/2015 10:00:00 AM,48,-122,13,2,15
10547,SpokaneStBridge,03/16/2015 11:00:00 AM,48,-122,7,5,12
10548,SpokaneStBridge,03/16/2015 12:00:00 PM,48,-122,15,14,29
10549,SpokaneStBridge,03/16/2015 01:00:00 PM,48,-122,17,10,27
10550,SpokaneStBridge,03/16/2015 02:00:00 PM,48,-122,13,14,27
10551,SpokaneStBridge,03/16/2015 03:00:00 PM,48,-122,9,37,46
10552,SpokaneStBridge,03/16/2015 04:00:00 PM,48,-122,20,58,78
10553,SpokaneStBridge,03/16/2015 05:00:00 PM,48,-122,21,102,123
10554,SpokaneStBridge,03/16/2015 06:00:00 PM,48,-122,14,73,87
10555,SpokaneStBridge,03/16/2015 07:00:00 PM,48,-122,10,23,33
10556,SpokaneStBridge,03/16/2015 08:00:00 PM,48,-122,5,10,15
10557,SpokaneStBridge,03/16/2015 09:00:00 PM,48,-122,3,7,10
10558,SpokaneStBridge,03/16/2015 10:00:00 PM,48,-122,1,0,1
10559,SpokaneStBridge,03/16/2015 11:00:00 PM,48,-122,1,4,5
10560,SpokaneStBridge,03/17/2015 12:00:00 AM,48,-122,1,3,4
10561,SpokaneStBridge,03/17/2015 01:00:00 AM,48,-122,1,0,1
10562,SpokaneStBridge,03/17/2015 02:00:00 AM,48,-122,0,1,1
10563,SpokaneStBridge,03/17/2015 03:00:00 AM,48,-122,0,1,1
10564,SpokaneStBridge,03/17/2015 04:00:00 AM,48,-122,1,0,1
10565,SpokaneStBridge,03/17/2015 05:00:00 AM,48,-122,11,2,13
10566,SpokaneStBridge,03/17/2015 06:00:00 AM,48,-122,42,9,51
10567,SpokaneStBridge,03/17/2015 07:00:00 AM,48,-122,97,14,111
10568,SpokaneStBridge,03/17/2015 08:00:00 AM,48,-122,108,9,117
10569,SpokaneStBridge,03/17/2015 09:00:00 AM,48,-122,44,5,49
10570,SpokaneStBridge,03/17/2015 10:00:00 AM,48,-122,17,6,23
10571,SpokaneStBridge,03/17/2015 11:00:00 AM,48,-122,10,13,23
10572,SpokaneStBridge,03/17/2015 12:00:00 PM,48,-122,12,6,18
10573,SpokaneStBridge,03/17/2015 01:00:00 PM,48,-122,14,8,22
10574,SpokaneStBridge,03/17/2015 02:00:00 PM,48,-122,6,21,27
10575,SpokaneStBridge,03/17/2015 03:00:00 PM,48,-122,11,29,40
10576,SpokaneStBridge,03/17/2015 04:00:00 PM,48,-122,14,48,62
10577,SpokaneStBridge,03/17/2015 05:00:00 PM,48,-122,15,89,104
10578,SpokaneStBridge,03/17/2015 06:00:00 PM,48,-122,7,80,87
10579,SpokaneStBridge,03/17/2015 07:00:00 PM,48,-122,2,20,22
10580,SpokaneStBridge,03/17/2015 08:00:00 PM,48,-122,1,7,8
10581,SpokaneStBridge,03/17/2015 09:00:00 PM,48,-122,1,3,4
10582,SpokaneStBridge,03/17/2015 10:00:00 PM,48,-122,1,7,8
10583,SpokaneStBridge,03/17/2015 11:00:00 PM,48,-122,1,2,3
10584,SpokaneStBridge,03/18/2015 12:00:00 AM,48,-122,0,5,5
10585,SpokaneStBridge,03/18/2015 01:00:00 AM,48,-122,0,0,0
10586,SpokaneStBridge,03/18/2015 02:00:00 AM,48,-122,1,0,1
10587,SpokaneStBridge,03/18/2015 03:00:00 AM,48,-122,1,0,1
10588,SpokaneStBridge,03/18/2015 04:00:00 AM,48,-122,2,2,4
10589,SpokaneStBridge,03/18/2015 05:00:00 AM,48,-122,9,3,12
10590,SpokaneStBridge,03/18/2015 06:00:00 AM,48,-122,62,5,67
10591,SpokaneStBridge,03/18/2015 07:00:00 AM,48,-122,90,9,99
10592,SpokaneStBridge,03/18/2015 08:00:00 AM,48,-122,112,11,123
10593,SpokaneStBridge,03/18/2015 09:00:00 AM,48,-122,37,2,39
10594,SpokaneStBridge,03/18/2015 10:00:00 AM,48,-122,14,5,19
10595,SpokaneStBridge,03/18/2015 11:00:00 AM,48,-122,6,9,15
10596,SpokaneStBridge,03/18/2015 12:00:00 PM,48,-122,13,13,26
10597,SpokaneStBridge,03/18/2015 01:00:00 PM,48,-122,16,8,24
10598,SpokaneStBridge,03/18/2015 02:00:00 PM,48,-122,9,24,33
10599,SpokaneStBridge,03/18/2015 03:00:00 PM,48,-122,10,27,37
10600,SpokaneStBridge,03/18/2015 04:00:00 PM,48,-122,12,68,80
10601,SpokaneStBridge,03/18/2015 05:00:00 PM,48,-122,17,113,130
10602,SpokaneStBridge,03/18/2015 06:00:00 PM,48,-122,20,80,100
10603,SpokaneStBridge,03/18/2015 07:00:00 PM,48,-122,6,33,39
10604,SpokaneStBridge,03/18/2015 08:00:00 PM,48,-122,8,19,27
10605,SpokaneStBridge,03/18/2015 09:00:00 PM,48,-122,3,5,8
10606,SpokaneStBridge,03/18/2015 10:00:00 PM,48,-122,0,6,6
10607,SpokaneStBridge,03/18/2015 11:00:00 PM,48,-122,0,5,5
10608,SpokaneStBridge,03/19/2015 12:00:00 AM,48,-122,2,0,2
10609,SpokaneStBridge,03/19/2015 01:00:00 AM,48,-122,0,0,0
10610,SpokaneStBridge,03/19/2015 02:00:00 AM,48,-122,2,1,3
10611,SpokaneStBridge,03/19/2015 03:00:00 AM,48,-122,0,0,0
10612,SpokaneStBridge,03/19/2015 04:00:00 AM,48,-122,3,3,6
10613,SpokaneStBridge,03/19/2015 05:00:00 AM,48,-122,15,3,18
10614,SpokaneStBridge,03/19/2015 06:00:00 AM,48,-122,55,11,66
10615,SpokaneStBridge,03/19/2015 07:00:00 AM,48,-122,92,16,108
10616,SpokaneStBridge,03/19/2015 08:00:00 AM,48,-122,111,6,117
10617,SpokaneStBridge,03/19/2015 09:00:00 AM,48,-122,48,6,54
10618,SpokaneStBridge,03/19/2015 10:00:00 AM,48,-122,16,12,28
10619,SpokaneStBridge,03/19/2015 11:00:00 AM,48,-122,13,9,22
10620,SpokaneStBridge,03/19/2015 12:00:00 PM,48,-122,9,10,19
10621,SpokaneStBridge,03/19/2015 01:00:00 PM,48,-122,14,12,26
10622,SpokaneStBridge,03/19/2015 02:00:00 PM,48,-122,14,13,27
10623,SpokaneStBridge,03/19/2015 03:00:00 PM,48,-122,14,25,39
10624,SpokaneStBridge,03/19/2015 04:00:00 PM,48,-122,16,61,77
10625,SpokaneStBridge,03/19/2015 05:00:00 PM,48,-122,18,94,112
10626,SpokaneStBridge,03/19/2015 06:00:00 PM,48,-122,11,67,78
10627,SpokaneStBridge,03/19/2015 07:00:00 PM,48,-122,4,35,39
10628,SpokaneStBridge,03/19/2015 08:00:00 PM,48,-122,5,19,24
10629,SpokaneStBridge,03/19/2015 09:00:00 PM,48,-122,2,4,6
10630,SpokaneStBridge,03/19/2015 10:00:00 PM,48,-122,1,5,6
10631,SpokaneStBridge,03/19/2015 11:00:00 PM,48,-122,2,5,7
10632,SpokaneStBridge,03/20/2015 12:00:00 AM,48,-122,1,3,4
10633,SpokaneStBridge,03/20/2015 01:00:00 AM,48,-122,0,0,0
10634,SpokaneStBridge,03/20/2015 02:00:00 AM,48,-122,0,1,1
10635,SpokaneStBridge,03/20/2015 03:00:00 AM,48,-122,0,0,0
10636,SpokaneStBridge,03/20/2015 04:00:00 AM,48,-122,1,1,2
10637,SpokaneStBridge,03/20/2015 05:00:00 AM,48,-122,9,3,12
10638,SpokaneStBridge,03/20/2015 06:00:00 AM,48,-122,26,8,34
10639,SpokaneStBridge,03/20/2015 07:00:00 AM,48,-122,63,9,72
10640,SpokaneStBridge,03/20/2015 08:00:00 AM,48,-122,72,6,78
10641,SpokaneStBridge,03/20/2015 09:00:00 AM,48,-122,25,9,34
10642,SpokaneStBridge,03/20/2015 10:00:00 AM,48,-122,8,4,12
10643,SpokaneStBridge,03/20/2015 11:00:00 AM,48,-122,11,11,22
10644,SpokaneStBridge,03/20/2015 12:00:00 PM,48,-122,11,8,19
10645,SpokaneStBridge,03/20/2015 01:00:00 PM,48,-122,9,11,20
10646,SpokaneStBridge,03/20/2015 02:00:00 PM,48,-122,9,11,20
10647,SpokaneStBridge,03/20/2015 03:00:00 PM,48,-122,7,24,31
10648,SpokaneStBridge,03/20/2015 04:00:00 PM,48,-122,11,42,53
10649,SpokaneStBridge,03/20/2015 05:00:00 PM,48,-122,7,54,61
10650,SpokaneStBridge,03/20/2015 06:00:00 PM,48,-122,2,54,56
10651,SpokaneStBridge,03/20/2015 07:00:00 PM,48,-122,3,13,16
10652,SpokaneStBridge,03/20/2015 08:00:00 PM,48,-122,4,2,6
10653,SpokaneStBridge,03/20/2015 09:00:00 PM,48,-122,2,5,7
10654,SpokaneStBridge,03/20/2015 10:00:00 PM,48,-122,1,5,6
10655,SpokaneStBridge,03/20/2015 11:00:00 PM,48,-122,0,3,3
10656,SpokaneStBridge,03/21/2015 12:00:00 AM,48,-122,0,2,2
10657,SpokaneStBridge,03/21/2015 01:00:00 AM,48,-122,1,1,2
10658,SpokaneStBridge,03/21/2015 02:00:00 AM,48,-122,0,1,1
10659,SpokaneStBridge,03/21/2015 03:00:00 AM,48,-122,1,0,1
10660,SpokaneStBridge,03/21/2015 04:00:00 AM,48,-122,0,3,3
10661,SpokaneStBridge,03/21/2015 05:00:00 AM,48,-122,1,0,1
10662,SpokaneStBridge,03/21/2015 06:00:00 AM,48,-122,3,0,3
10663,SpokaneStBridge,03/21/2015 07:00:00 AM,48,-122,6,10,16
10664,SpokaneStBridge,03/21/2015 08:00:00 AM,48,-122,13,5,18
10665,SpokaneStBridge,03/21/2015 09:00:00 AM,48,-122,6,5,11
10666,SpokaneStBridge,03/21/2015 10:00:00 AM,48,-122,7,6,13
10667,SpokaneStBridge,03/21/2015 11:00:00 AM,48,-122,5,6,11
10668,SpokaneStBridge,03/21/2015 12:00:00 PM,48,-122,8,10,18
10669,SpokaneStBridge,03/21/2015 01:00:00 PM,48,-122,14,16,30
10670,SpokaneStBridge,03/21/2015 02:00:00 PM,48,-122,13,14,27
10671,SpokaneStBridge,03/21/2015 03:00:00 PM,48,-122,11,14,25
10672,SpokaneStBridge,03/21/2015 04:00:00 PM,48,-122,19,18,37
10673,SpokaneStBridge,03/21/2015 05:00:00 PM,48,-122,17,12,29
10674,SpokaneStBridge,03/21/2015 06:00:00 PM,48,-122,13,14,27
10675,SpokaneStBridge,03/21/2015 07:00:00 PM,48,-122,6,8,14
10676,SpokaneStBridge,03/21/2015 08:00:00 PM,48,-122,3,1,4
10677,SpokaneStBridge,03/21/2015 09:00:00 PM,48,-122,1,0,1
10678,SpokaneStBridge,03/21/2015 10:00:00 PM,48,-122,0,3,3
10679,SpokaneStBridge,03/21/2015 11:00:00 PM,48,-122,1,3,4
10680,SpokaneStBridge,03/22/2015 12:00:00 AM,48,-122,0,2,2
10681,SpokaneStBridge,03/22/2015 01:00:00 AM,48,-122,1,1,2
10682,SpokaneStBridge,03/22/2015 02:00:00 AM,48,-122,0,0,0
10683,SpokaneStBridge,03/22/2015 03:00:00 AM,48,-122,4,1,5
10684,SpokaneStBridge,03/22/2015 04:00:00 AM,48,-122,0,1,1
10685,SpokaneStBridge,03/22/2015 05:00:00 AM,48,-122,4,1,5
10686,SpokaneStBridge,03/22/2015 06:00:00 AM,48,-122,2,1,3
10687,SpokaneStBridge,03/22/2015 07:00:00 AM,48,-122,5,0,5
10688,SpokaneStBridge,03/22/2015 08:00:00 AM,48,-122,14,2,16
10689,SpokaneStBridge,03/22/2015 09:00:00 AM,48,-122,15,11,26
10690,SpokaneStBridge,03/22/2015 10:00:00 AM,48,-122,24,43,67
10691,SpokaneStBridge,03/22/2015 11:00:00 AM,48,-122,37,22,59
10692,SpokaneStBridge,03/22/2015 12:00:00 PM,48,-122,26,19,45
10693,SpokaneStBridge,03/22/2015 01:00:00 PM,48,-122,13,9,22
10694,SpokaneStBridge,03/22/2015 02:00:00 PM,48,-122,17,14,31
10695,SpokaneStBridge,03/22/2015 03:00:00 PM,48,-122,2,12,14
10696,SpokaneStBridge,03/22/2015 04:00:00 PM,48,-122,9,7,16
10697,SpokaneStBridge,03/22/2015 05:00:00 PM,48,-122,6,7,13
10698,SpokaneStBridge,03/22/2015 06:00:00 PM,48,-122,1,2,3
10699,SpokaneStBridge,03/22/2015 07:00:00 PM,48,-122,1,1,2
10700,SpokaneStBridge,03/22/2015 08:00:00 PM,48,-122,2,4,6
10701,SpokaneStBridge,03/22/2015 09:00:00 PM,48,-122,2,2,4
10702,SpokaneStBridge,03/22/2015 10:00:00 PM,48,-122,1,1,2
10703,SpokaneStBridge,03/22/2015 11:00:00 PM,48,-122,2,3,5
10704,SpokaneStBridge,03/23/2015 12:00:00 AM,48,-122,0,1,1
10705,SpokaneStBridge,03/23/2015 01:00:00 AM,48,-122,1,0,1
10706,SpokaneStBridge,03/23/2015 02:00:00 AM,48,-122,0,1,1
10707,SpokaneStBridge,03/23/2015 03:00:00 AM,48,-122,2,0,2
10708,SpokaneStBridge,03/23/2015 04:00:00 AM,48,-122,3,1,4
10709,SpokaneStBridge,03/23/2015 05:00:00 AM,48,-122,13,3,16
10710,SpokaneStBridge,03/23/2015 06:00:00 AM,48,-122,38,13,51
10711,SpokaneStBridge,03/23/2015 07:00:00 AM,48,-122,78,9,87
10712,SpokaneStBridge,03/23/2015 08:00:00 AM,48,-122,75,6,81
10713,SpokaneStBridge,03/23/2015 09:00:00 AM,48,-122,30,4,34
10714,SpokaneStBridge,03/23/2015 10:00:00 AM,48,-122,10,3,13
10715,SpokaneStBridge,03/23/2015 11:00:00 AM,48,-122,7,4,11
10716,SpokaneStBridge,03/23/2015 12:00:00 PM,48,-122,4,3,7
10717,SpokaneStBridge,03/23/2015 01:00:00 PM,48,-122,5,2,7
10718,SpokaneStBridge,03/23/2015 02:00:00 PM,48,-122,2,7,9
10719,SpokaneStBridge,03/23/2015 03:00:00 PM,48,-122,4,19,23
10720,SpokaneStBridge,03/23/2015 04:00:00 PM,48,-122,12,48,60
10721,SpokaneStBridge,03/23/2015 05:00:00 PM,48,-122,10,76,86
10722,SpokaneStBridge,03/23/2015 06:00:00 PM,48,-122,4,56,60
10723,SpokaneStBridge,03/23/2015 07:00:00 PM,48,-122,2,16,18
10724,SpokaneStBridge,03/23/2015 08:00:00 PM,48,-122,2,7,9
10725,SpokaneStBridge,03/23/2015 09:00:00 PM,48,-122,3,4,7
10726,SpokaneStBridge,03/23/2015 10:00:00 PM,48,-122,1,3,4
10727,SpokaneStBridge,03/23/2015 11:00:00 PM,48,-122,1,0,1
10728,SpokaneStBridge,03/24/2015 12:00:00 AM,48,-122,1,0,1
10729,SpokaneStBridge,03/24/2015 01:00:00 AM,48,-122,1,0,1
10730,SpokaneStBridge,03/24/2015 02:00:00 AM,48,-122,0,0,0
10731,SpokaneStBridge,03/24/2015 03:00:00 AM,48,-122,1,0,1
10732,SpokaneStBridge,03/24/2015 04:00:00 AM,48,-122,1,1,2
10733,SpokaneStBridge,03/24/2015 05:00:00 AM,48,-122,14,2,16
10734,SpokaneStBridge,03/24/2015 06:00:00 AM,48,-122,54,8,62
10735,SpokaneStBridge,03/24/2015 07:00:00 AM,48,-122,73,12,85
10736,SpokaneStBridge,03/24/2015 08:00:00 AM,48,-122,89,7,96
10737,SpokaneStBridge,03/24/2015 09:00:00 AM,48,-122,23,0,23
10738,SpokaneStBridge,03/24/2015 10:00:00 AM,48,-122,12,5,17
10739,SpokaneStBridge,03/24/2015 11:00:00 AM,48,-122,6,6,12
10740,SpokaneStBridge,03/24/2015 12:00:00 PM,48,-122,15,8,23
10741,SpokaneStBridge,03/24/2015 01:00:00 PM,48,-122,10,9,19
10742,SpokaneStBridge,03/24/2015 02:00:00 PM,48,-122,8,23,31
10743,SpokaneStBridge,03/24/2015 03:00:00 PM,48,-122,10,21,31
10744,SpokaneStBridge,03/24/2015 04:00:00 PM,48,-122,11,54,65
10745,SpokaneStBridge,03/24/2015 05:00:00 PM,48,-122,10,92,102
10746,SpokaneStBridge,03/24/2015 06:00:00 PM,48,-122,9,66,75
10747,SpokaneStBridge,03/24/2015 07:00:00 PM,48,-122,9,22,31
10748,SpokaneStBridge,03/24/2015 08:00:00 PM,48,-122,3,15,18
10749,SpokaneStBridge,03/24/2015 09:00:00 PM,48,-122,2,15,17
10750,SpokaneStBridge,03/24/2015 10:00:00 PM,48,-122,0,6,6
10751,SpokaneStBridge,03/24/2015 11:00:00 PM,48,-122,1,5,6
10752,SpokaneStBridge,03/25/2015 12:00:00 AM,48,-122,0,1,1
10753,SpokaneStBridge,03/25/2015 01:00:00 AM,48,-122,0,0,0
10754,SpokaneStBridge,03/25/2015 02:00:00 AM,48,-122,0,0,0
10755,SpokaneStBridge,03/25/2015 03:00:00 AM,48,-122,0,0,0
10756,SpokaneStBridge,03/25/2015 04:00:00 AM,48,-122,1,1,2
10757,SpokaneStBridge,03/25/2015 05:00:00 AM,48,-122,10,1,11
10758,SpokaneStBridge,03/25/2015 06:00:00 AM,48,-122,33,9,42
10759,SpokaneStBridge,03/25/2015 07:00:00 AM,48,-122,57,8,65
10760,SpokaneStBridge,03/25/2015 08:00:00 AM,48,-122,75,10,85
10761,SpokaneStBridge,03/25/2015 09:00:00 AM,48,-122,25,3,28
10762,SpokaneStBridge,03/25/2015 10:00:00 AM,48,-122,6,4,10
10763,SpokaneStBridge,03/25/2015 11:00:00 AM,48,-122,4,1,5
10764,SpokaneStBridge,03/25/2015 12:00:00 PM,48,-122,6,4,10
10765,SpokaneStBridge,03/25/2015 01:00:00 PM,48,-122,3,2,5
10766,SpokaneStBridge,03/25/2015 02:00:00 PM,48,-122,3,4,7
10767,SpokaneStBridge,03/25/2015 03:00:00 PM,48,-122,11,19,30
10768,SpokaneStBridge,03/25/2015 04:00:00 PM,48,-122,11,42,53
10769,SpokaneStBridge,03/25/2015 05:00:00 PM,48,-122,7,54,61
10770,SpokaneStBridge,03/25/2015 06:00:00 PM,48,-122,8,56,64
10771,SpokaneStBridge,03/25/2015 07:00:00 PM,48,-122,5,23,28
10772,SpokaneStBridge,03/25/2015 08:00:00 PM,48,-122,0,7,7
10773,SpokaneStBridge,03/25/2015 09:00:00 PM,48,-122,1,7,8
10774,SpokaneStBridge,03/25/2015 10:00:00 PM,48,-122,1,4,5
10775,SpokaneStBridge,03/25/2015 11:00:00 PM,48,-122,0,0,0
10776,SpokaneStBridge,03/26/2015 12:00:00 AM,48,-122,2,0,2
10777,SpokaneStBridge,03/26/2015 01:00:00 AM,48,-122,0,0,0
10778,SpokaneStBridge,03/26/2015 02:00:00 AM,48,-122,1,2,3
10779,SpokaneStBridge,03/26/2015 03:00:00 AM,48,-122,0,1,1
10780,SpokaneStBridge,03/26/2015 04:00:00 AM,48,-122,5,2,7
10781,SpokaneStBridge,03/26/2015 05:00:00 AM,48,-122,15,4,19
10782,SpokaneStBridge,03/26/2015 06:00:00 AM,48,-122,56,11,67
10783,SpokaneStBridge,03/26/2015 07:00:00 AM,48,-122,93,19,112
10784,SpokaneStBridge,03/26/2015 08:00:00 AM,48,-122,119,11,130
10785,SpokaneStBridge,03/26/2015 09:00:00 AM,48,-122,38,4,42
10786,SpokaneStBridge,03/26/2015 10:00:00 AM,48,-122,25,13,38
10787,SpokaneStBridge,03/26/2015 11:00:00 AM,48,-122,20,8,28
10788,SpokaneStBridge,03/26/2015 12:00:00 PM,48,-122,12,11,23
10789,SpokaneStBridge,03/26/2015 01:00:00 PM,48,-122,24,18,42
10790,SpokaneStBridge,03/26/2015 02:00:00 PM,48,-122,19,36,55
10791,SpokaneStBridge,03/26/2015 03:00:00 PM,48,-122,24,49,73
10792,SpokaneStBridge,03/26/2015 04:00:00 PM,48,-122,25,83,108
10793,SpokaneStBridge,03/26/2015 05:00:00 PM,48,-122,37,115,152
10794,SpokaneStBridge,03/26/2015 06:00:00 PM,48,-122,21,92,113
10795,SpokaneStBridge,03/26/2015 07:00:00 PM,48,-122,25,133,158
10796,SpokaneStBridge,03/26/2015 08:00:00 PM,48,-122,12,23,35
10797,SpokaneStBridge,03/26/2015 09:00:00 PM,48,-122,7,3,10
10798,SpokaneStBridge,03/26/2015 10:00:00 PM,48,-122,6,5,11
10799,SpokaneStBridge,03/26/2015 11:00:00 PM,48,-122,44,4,48
10800,SpokaneStBridge,03/27/2015 12:00:00 AM,48,-122,21,3,24
10801,SpokaneStBridge,03/27/2015 01:00:00 AM,48,-122,14,1,15
10802,SpokaneStBridge,03/27/2015 02:00:00 AM,48,-122,1,0,1
10803,SpokaneStBridge,03/27/2015 03:00:00 AM,48,-122,1,0,1
10804,SpokaneStBridge,03/27/2015 04:00:00 AM,48,-122,2,1,3
10805,SpokaneStBridge,03/27/2015 05:00:00 AM,48,-122,16,3,19
10806,SpokaneStBridge,03/27/2015 06:00:00 AM,48,-122,41,13,54
10807,SpokaneStBridge,03/27/2015 07:00:00 AM,48,-122,105,20,125
10808,SpokaneStBridge,03/27/2015 08:00:00 AM,48,-122,99,20,119
10809,SpokaneStBridge,03/27/2015 09:00:00 AM,48,-122,32,10,42
10810,SpokaneStBridge,03/27/2015 10:00:00 AM,48,-122,20,9,29
10811,SpokaneStBridge,03/27/2015 11:00:00 AM,48,-122,16,8,24
10812,SpokaneStBridge,03/27/2015 12:00:00 PM,48,-122,22,13,35
10813,SpokaneStBridge,03/27/2015 01:00:00 PM,48,-122,12,33,45
10814,SpokaneStBridge,03/27/2015 02:00:00 PM,48,-122,20,25,45
10815,SpokaneStBridge,03/27/2015 03:00:00 PM,48,-122,24,57,81
10816,SpokaneStBridge,03/27/2015 04:00:00 PM,48,-122,29,89,118
10817,SpokaneStBridge,03/27/2015 05:00:00 PM,48,-122,21,110,131
10818,SpokaneStBridge,03/27/2015 06:00:00 PM,48,-122,15,75,90
10819,SpokaneStBridge,03/27/2015 07:00:00 PM,48,-122,8,17,25
10820,SpokaneStBridge,03/27/2015 08:00:00 PM,48,-122,6,13,19
10821,SpokaneStBridge,03/27/2015 09:00:00 PM,48,-122,3,5,8
10822,SpokaneStBridge,03/27/2015 10:00:00 PM,48,-122,1,1,2
10823,SpokaneStBridge,03/27/2015 11:00:00 PM,48,-122,5,3,8
10824,SpokaneStBridge,03/28/2015 12:00:00 AM,48,-122,3,2,5
10825,SpokaneStBridge,03/28/2015 01:00:00 AM,48,-122,2,0,2
10826,SpokaneStBridge,03/28/2015 02:00:00 AM,48,-122,0,0,0
10827,SpokaneStBridge,03/28/2015 03:00:00 AM,48,-122,2,0,2
10828,SpokaneStBridge,03/28/2015 04:00:00 AM,48,-122,1,0,1
10829,SpokaneStBridge,03/28/2015 05:00:00 AM,48,-122,6,0,6
10830,SpokaneStBridge,03/28/2015 06:00:00 AM,48,-122,10,3,13
10831,SpokaneStBridge,03/28/2015 07:00:00 AM,48,-122,12,10,22
10832,SpokaneStBridge,03/28/2015 08:00:00 AM,48,-122,14,9,23
10833,SpokaneStBridge,03/28/2015 09:00:00 AM,48,-122,16,17,33
10834,SpokaneStBridge,03/28/2015 10:00:00 AM,48,-122,21,16,37
10835,SpokaneStBridge,03/28/2015 11:00:00 AM,48,-122,21,26,47
10836,SpokaneStBridge,03/28/2015 12:00:00 PM,48,-122,24,25,49
10837,SpokaneStBridge,03/28/2015 01:00:00 PM,48,-122,36,26,62
10838,SpokaneStBridge,03/28/2015 02:00:00 PM,48,-122,32,33,65
10839,SpokaneStBridge,03/28/2015 03:00:00 PM,48,-122,18,28,46
10840,SpokaneStBridge,03/28/2015 04:00:00 PM,48,-122,11,20,31
10841,SpokaneStBridge,03/28/2015 05:00:00 PM,48,-122,17,24,41
10842,SpokaneStBridge,03/28/2015 06:00:00 PM,48,-122,15,17,32
10843,SpokaneStBridge,03/28/2015 07:00:00 PM,48,-122,9,9,18
10844,SpokaneStBridge,03/28/2015 08:00:00 PM,48,-122,2,3,5
10845,SpokaneStBridge,03/28/2015 09:00:00 PM,48,-122,3,5,8
10846,SpokaneStBridge,03/28/2015 10:00:00 PM,48,-122,1,0,1
10847,SpokaneStBridge,03/28/2015 11:00:00 PM,48,-122,1,1,2
10848,SpokaneStBridge,03/29/2015 12:00:00 AM,48,-122,0,1,1
10849,SpokaneStBridge,03/29/2015 01:00:00 AM,48,-122,0,1,1
10850,SpokaneStBridge,03/29/2015 02:00:00 AM,48,-122,0,1,1
10851,SpokaneStBridge,03/29/2015 03:00:00 AM,48,-122,1,0,1
10852,SpokaneStBridge,03/29/2015 04:00:00 AM,48,-122,0,2,2
10853,SpokaneStBridge,03/29/2015 05:00:00 AM,48,-122,8,1,9
10854,SpokaneStBridge,03/29/2015 06:00:00 AM,48,-122,2,0,2
10855,SpokaneStBridge,03/29/2015 07:00:00 AM,48,-122,12,2,14
10856,SpokaneStBridge,03/29/2015 08:00:00 AM,48,-122,18,5,23
10857,SpokaneStBridge,03/29/2015 09:00:00 AM,48,-122,25,16,41
10858,SpokaneStBridge,03/29/2015 10:00:00 AM,48,-122,17,28,45
10859,SpokaneStBridge,03/29/2015 11:00:00 AM,48,-122,26,29,55
10860,SpokaneStBridge,03/29/2015 12:00:00 PM,48,-122,32,25,57
10861,SpokaneStBridge,03/29/2015 01:00:00 PM,48,-122,18,25,43
10862,SpokaneStBridge,03/29/2015 02:00:00 PM,48,-122,25,35,60
10863,SpokaneStBridge,03/29/2015 03:00:00 PM,48,-122,21,17,38
10864,SpokaneStBridge,03/29/2015 04:00:00 PM,48,-122,20,18,38
10865,SpokaneStBridge,03/29/2015 05:00:00 PM,48,-122,7,12,19
10866,SpokaneStBridge,03/29/2015 06:00:00 PM,48,-122,9,9,18
10867,SpokaneStBridge,03/29/2015 07:00:00 PM,48,-122,3,6,9
10868,SpokaneStBridge,03/29/2015 08:00:00 PM,48,-122,4,2,6
10869,SpokaneStBridge,03/29/2015 09:00:00 PM,48,-122,1,2,3
10870,SpokaneStBridge,03/29/2015 10:00:00 PM,48,-122,3,1,4
10871,SpokaneStBridge,03/29/2015 11:00:00 PM,48,-122,1,2,3
10872,SpokaneStBridge,03/30/2015 12:00:00 AM,48,-122,0,1,1
10873,SpokaneStBridge,03/30/2015 01:00:00 AM,48,-122,0,0,0
10874,SpokaneStBridge,03/30/2015 02:00:00 AM,48,-122,1,1,2
10875,SpokaneStBridge,03/30/2015 03:00:00 AM,48,-122,2,1,3
10876,SpokaneStBridge,03/30/2015 04:00:00 AM,48,-122,2,1,3
10877,SpokaneStBridge,03/30/2015 05:00:00 AM,48,-122,18,4,22
10878,SpokaneStBridge,03/30/2015 06:00:00 AM,48,-122,54,11,65
10879,SpokaneStBridge,03/30/2015 07:00:00 AM,48,-122,113,17,130
10880,SpokaneStBridge,03/30/2015 08:00:00 AM,48,-122,119,11,130
10881,SpokaneStBridge,03/30/2015 09:00:00 AM,48,-122,44,6,50
10882,SpokaneStBridge,03/30/2015 10:00:00 AM,48,-122,14,6,20
10883,SpokaneStBridge,03/30/2015 11:00:00 AM,48,-122,13,5,18
10884,SpokaneStBridge,03/30/2015 12:00:00 PM,48,-122,13,13,26
10885,SpokaneStBridge,03/30/2015 01:00:00 PM,48,-122,14,8,22
10886,SpokaneStBridge,03/30/2015 02:00:00 PM,48,-122,13,19,32
10887,SpokaneStBridge,03/30/2015 03:00:00 PM,48,-122,17,46,63
10888,SpokaneStBridge,03/30/2015 04:00:00 PM,48,-122,23,70,93
10889,SpokaneStBridge,03/30/2015 05:00:00 PM,48,-122,20,154,174
10890,SpokaneStBridge,03/30/2015 06:00:00 PM,48,-122,21,95,116
10891,SpokaneStBridge,03/30/2015 07:00:00 PM,48,-122,7,19,26
10892,SpokaneStBridge,03/30/2015 08:00:00 PM,48,-122,1,12,13
10893,SpokaneStBridge,03/30/2015 09:00:00 PM,48,-122,3,5,8
10894,SpokaneStBridge,03/30/2015 10:00:00 PM,48,-122,0,2,2
10895,SpokaneStBridge,03/30/2015 11:00:00 PM,48,-122,3,2,5
10896,SpokaneStBridge,03/31/2015 12:00:00 AM,48,-122,2,2,4
10897,SpokaneStBridge,03/31/2015 01:00:00 AM,48,-122,0,0,0
10898,SpokaneStBridge,03/31/2015 02:00:00 AM,48,-122,0,0,0
10899,SpokaneStBridge,03/31/2015 03:00:00 AM,48,-122,0,0,0
10900,SpokaneStBridge,03/31/2015 04:00:00 AM,48,-122,0,1,1
10901,SpokaneStBridge,03/31/2015 05:00:00 AM,48,-122,17,2,19
10902,SpokaneStBridge,03/31/2015 06:00:00 AM,48,-122,45,10,55
10903,SpokaneStBridge,03/31/2015 07:00:00 AM,48,-122,87,18,105
10904,SpokaneStBridge,03/31/2015 08:00:00 AM,48,-122,76,15,91
10905,SpokaneStBridge,03/31/2015 09:00:00 AM,48,-122,27,4,31
10906,SpokaneStBridge,03/31/2015 10:00:00 AM,48,-122,14,1,15
10907,SpokaneStBridge,03/31/2015 11:00:00 AM,48,-122,4,4,8
10908,SpokaneStBridge,03/31/2015 12:00:00 PM,48,-122,11,6,17
10909,SpokaneStBridge,03/31/2015 01:00:00 PM,48,-122,3,8,11
10910,SpokaneStBridge,03/31/2015 02:00:00 PM,48,-122,8,16,24
10911,SpokaneStBridge,03/31/2015 03:00:00 PM,48,-122,10,21,31
10912,SpokaneStBridge,03/31/2015 04:00:00 PM,48,-122,7,52,59
10913,SpokaneStBridge,03/31/2015 05:00:00 PM,48,-122,13,81,94
10914,SpokaneStBridge,03/31/2015 06:00:00 PM,48,-122,5,48,53
10915,SpokaneStBridge,03/31/2015 07:00:00 PM,48,-122,3,19,22
10916,SpokaneStBridge,03/31/2015 08:00:00 PM,48,-122,2,10,12
10917,SpokaneStBridge,03/31/2015 09:00:00 PM,48,-122,2,7,9
10918,SpokaneStBridge,03/31/2015 10:00:00 PM,48,-122,0,2,2
10919,SpokaneStBridge,03/31/2015 11:00:00 PM,48,-122,0,1,1
10920,SpokaneStBridge,04/01/2015 12:00:00 AM,48,-122,2,0,2
10921,SpokaneStBridge,04/01/2015 01:00:00 AM,48,-122,0,1,1
10922,SpokaneStBridge,04/01/2015 02:00:00 AM,48,-122,0,0,0
10923,SpokaneStBridge,04/01/2015 03:00:00 AM,48,-122,2,1,3
10924,SpokaneStBridge,04/01/2015 04:00:00 AM,48,-122,2,1,3
10925,SpokaneStBridge,04/01/2015 05:00:00 AM,48,-122,19,1,20
10926,SpokaneStBridge,04/01/2015 06:00:00 AM,48,-122,41,5,46
10927,SpokaneStBridge,04/01/2015 07:00:00 AM,48,-122,78,7,85
10928,SpokaneStBridge,04/01/2015 08:00:00 AM,48,-122,94,11,105
10929,SpokaneStBridge,04/01/2015 09:00:00 AM,48,-122,36,9,45
10930,SpokaneStBridge,04/01/2015 10:00:00 AM,48,-122,11,6,17
10931,SpokaneStBridge,04/01/2015 11:00:00 AM,48,-122,10,4,14
10932,SpokaneStBridge,04/01/2015 12:00:00 PM,48,-122,9,9,18
10933,SpokaneStBridge,04/01/2015 01:00:00 PM,48,-122,10,10,20
10934,SpokaneStBridge,04/01/2015 02:00:00 PM,48,-122,8,14,22
10935,SpokaneStBridge,04/01/2015 03:00:00 PM,48,-122,6,22,28
10936,SpokaneStBridge,04/01/2015 04:00:00 PM,48,-122,12,36,48
10937,SpokaneStBridge,04/01/2015 05:00:00 PM,48,-122,16,84,100
10938,SpokaneStBridge,04/01/2015 06:00:00 PM,48,-122,2,67,69
10939,SpokaneStBridge,04/01/2015 07:00:00 PM,48,-122,3,27,30
10940,SpokaneStBridge,04/01/2015 08:00:00 PM,48,-122,4,9,13
10941,SpokaneStBridge,04/01/2015 09:00:00 PM,48,-122,3,6,9
10942,SpokaneStBridge,04/01/2015 10:00:00 PM,48,-122,1,3,4
10943,SpokaneStBridge,04/01/2015 11:00:00 PM,48,-122,1,1,2
10944,SpokaneStBridge,04/02/2015 12:00:00 AM,48,-122,1,0,1
10945,SpokaneStBridge,04/02/2015 01:00:00 AM,48,-122,1,0,1
10946,SpokaneStBridge,04/02/2015 02:00:00 AM,48,-122,0,0,0
10947,SpokaneStBridge,04/02/2015 03:00:00 AM,48,-122,0,0,0
10948,SpokaneStBridge,04/02/2015 04:00:00 AM,48,-122,2,0,2
10949,SpokaneStBridge,04/02/2015 05:00:00 AM,48,-122,21,4,25
10950,SpokaneStBridge,04/02/2015 06:00:00 AM,48,-122,47,6,53
10951,SpokaneStBridge,04/02/2015 07:00:00 AM,48,-122,101,12,113
10952,SpokaneStBridge,04/02/2015 08:00:00 AM,48,-122,96,14,110
10953,SpokaneStBridge,04/02/2015 09:00:00 AM,48,-122,46,4,50
10954,SpokaneStBridge,04/02/2015 10:00:00 AM,48,-122,15,5,20
10955,SpokaneStBridge,04/02/2015 11:00:00 AM,48,-122,12,4,16
10956,SpokaneStBridge,04/02/2015 12:00:00 PM,48,-122,7,9,16
10957,SpokaneStBridge,04/02/2015 01:00:00 PM,48,-122,14,10,24
10958,SpokaneStBridge,04/02/2015 02:00:00 PM,48,-122,12,15,27
10959,SpokaneStBridge,04/02/2015 03:00:00 PM,48,-122,16,26,42
10960,SpokaneStBridge,04/02/2015 04:00:00 PM,48,-122,16,62,78
10961,SpokaneStBridge,04/02/2015 05:00:00 PM,48,-122,23,110,133
10962,SpokaneStBridge,04/02/2015 06:00:00 PM,48,-122,18,94,112
10963,SpokaneStBridge,04/02/2015 07:00:00 PM,48,-122,8,30,38
10964,SpokaneStBridge,04/02/2015 08:00:00 PM,48,-122,1,10,11
10965,SpokaneStBridge,04/02/2015 09:00:00 PM,48,-122,5,10,15
10966,SpokaneStBridge,04/02/2015 10:00:00 PM,48,-122,1,3,4
10967,SpokaneStBridge,04/02/2015 11:00:00 PM,48,-122,1,4,5
10968,SpokaneStBridge,04/03/2015 12:00:00 AM,48,-122,2,4,6
10969,SpokaneStBridge,04/03/2015 01:00:00 AM,48,-122,0,0,0
10970,SpokaneStBridge,04/03/2015 02:00:00 AM,48,-122,0,1,1
10971,SpokaneStBridge,04/03/2015 03:00:00 AM,48,-122,0,1,1
10972,SpokaneStBridge,04/03/2015 04:00:00 AM,48,-122,1,0,1
10973,SpokaneStBridge,04/03/2015 05:00:00 AM,48,-122,10,1,11
10974,SpokaneStBridge,04/03/2015 06:00:00 AM,48,-122,35,9,44
10975,SpokaneStBridge,04/03/2015 07:00:00 AM,48,-122,73,13,86
10976,SpokaneStBridge,04/03/2015 08:00:00 AM,48,-122,75,10,85
10977,SpokaneStBridge,04/03/2015 09:00:00 AM,48,-122,34,4,38
10978,SpokaneStBridge,04/03/2015 10:00:00 AM,48,-122,13,4,17
10979,SpokaneStBridge,04/03/2015 11:00:00 AM,48,-122,11,18,29
10980,SpokaneStBridge,04/03/2015 12:00:00 PM,48,-122,12,6,18
10981,SpokaneStBridge,04/03/2015 01:00:00 PM,48,-122,8,4,12
10982,SpokaneStBridge,04/03/2015 02:00:00 PM,48,-122,3,8,11
10983,SpokaneStBridge,04/03/2015 03:00:00 PM,48,-122,11,28,39
10984,SpokaneStBridge,04/03/2015 04:00:00 PM,48,-122,9,54,63
10985,SpokaneStBridge,04/03/2015 05:00:00 PM,48,-122,11,73,84
10986,SpokaneStBridge,04/03/2015 06:00:00 PM,48,-122,6,38,44
10987,SpokaneStBridge,04/03/2015 07:00:00 PM,48,-122,3,26,29
10988,SpokaneStBridge,04/03/2015 08:00:00 PM,48,-122,0,5,5
10989,SpokaneStBridge,04/03/2015 09:00:00 PM,48,-122,5,2,7
10990,SpokaneStBridge,04/03/2015 10:00:00 PM,48,-122,0,7,7
10991,SpokaneStBridge,04/03/2015 11:00:00 PM,48,-122,4,2,6
10992,SpokaneStBridge,04/04/2015 12:00:00 AM,48,-122,2,4,6
10993,SpokaneStBridge,04/04/2015 01:00:00 AM,48,-122,0,1,1
10994,SpokaneStBridge,04/04/2015 02:00:00 AM,48,-122,0,2,2
10995,SpokaneStBridge,04/04/2015 03:00:00 AM,48,-122,1,1,2
10996,SpokaneStBridge,04/04/2015 04:00:00 AM,48,-122,0,1,1
10997,SpokaneStBridge,04/04/2015 05:00:00 AM,48,-122,5,0,5
10998,SpokaneStBridge,04/04/2015 06:00:00 AM,48,-122,4,2,6
10999,SpokaneStBridge,04/04/2015 07:00:00 AM,48,-122,12,6,18
11000,SpokaneStBridge,04/04/2015 08:00:00 AM,48,-122,30,8,38
11001,SpokaneStBridge,04/04/2015 09:00:00 AM,48,-122,18,21,39
11002,SpokaneStBridge,04/04/2015 10:00:00 AM,48,-122,26,25,51
11003,SpokaneStBridge,04/04/2015 11:00:00 AM,48,-122,19,25,44
11004,SpokaneStBridge,04/04/2015 12:00:00 PM,48,-122,31,36,67
11005,SpokaneStBridge,04/04/2015 01:00:00 PM,48,-122,35,41,76
11006,SpokaneStBridge,04/04/2015 02:00:00 PM,48,-122,32,38,70
11007,SpokaneStBridge,04/04/2015 03:00:00 PM,48,-122,38,37,75
11008,SpokaneStBridge,04/04/2015 04:00:00 PM,48,-122,59,44,103
11009,SpokaneStBridge,04/04/2015 05:00:00 PM,48,-122,35,22,57
11010,SpokaneStBridge,04/04/2015 06:00:00 PM,48,-122,26,20,46
11011,SpokaneStBridge,04/04/2015 07:00:00 PM,48,-122,6,7,13
11012,SpokaneStBridge,04/04/2015 08:00:00 PM,48,-122,1,2,3
11013,SpokaneStBridge,04/04/2015 09:00:00 PM,48,-122,1,4,5
11014,SpokaneStBridge,04/04/2015 10:00:00 PM,48,-122,4,7,11
11015,SpokaneStBridge,04/04/2015 11:00:00 PM,48,-122,1,2,3
11016,SpokaneStBridge,04/05/2015 12:00:00 AM,48,-122,0,2,2
11017,SpokaneStBridge,04/05/2015 01:00:00 AM,48,-122,0,1,1
11018,SpokaneStBridge,04/05/2015 02:00:00 AM,48,-122,1,0,1
11019,SpokaneStBridge,04/05/2015 03:00:00 AM,48,-122,1,1,2
11020,SpokaneStBridge,04/05/2015 04:00:00 AM,48,-122,1,3,4
11021,SpokaneStBridge,04/05/2015 05:00:00 AM,48,-122,5,2,7
11022,SpokaneStBridge,04/05/2015 06:00:00 AM,48,-122,5,1,6
11023,SpokaneStBridge,04/05/2015 07:00:00 AM,48,-122,5,3,8
11024,SpokaneStBridge,04/05/2015 08:00:00 AM,48,-122,9,10,19
11025,SpokaneStBridge,04/05/2015 09:00:00 AM,48,-122,13,22,35
11026,SpokaneStBridge,04/05/2015 10:00:00 AM,48,-122,18,17,35
11027,SpokaneStBridge,04/05/2015 11:00:00 AM,48,-122,28,29,57
11028,SpokaneStBridge,04/05/2015 12:00:00 PM,48,-122,23,30,53
11029,SpokaneStBridge,04/05/2015 01:00:00 PM,48,-122,22,36,58
11030,SpokaneStBridge,04/05/2015 02:00:00 PM,48,-122,34,22,56
11031,SpokaneStBridge,04/05/2015 03:00:00 PM,48,-122,40,27,67
11032,SpokaneStBridge,04/05/2015 04:00:00 PM,48,-122,28,25,53
11033,SpokaneStBridge,04/05/2015 05:00:00 PM,48,-122,20,19,39
11034,SpokaneStBridge,04/05/2015 06:00:00 PM,48,-122,14,8,22
11035,SpokaneStBridge,04/05/2015 07:00:00 PM,48,-122,11,7,18
11036,SpokaneStBridge,04/05/2015 08:00:00 PM,48,-122,3,2,5
11037,SpokaneStBridge,04/05/2015 09:00:00 PM,48,-122,2,1,3
11038,SpokaneStBridge,04/05/2015 10:00:00 PM,48,-122,0,1,1
11039,SpokaneStBridge,04/05/2015 11:00:00 PM,48,-122,2,1,3
11040,SpokaneStBridge,04/06/2015 12:00:00 AM,48,-122,1,2,3
11041,SpokaneStBridge,04/06/2015 01:00:00 AM,48,-122,0,0,0
11042,SpokaneStBridge,04/06/2015 02:00:00 AM,48,-122,0,0,0
11043,SpokaneStBridge,04/06/2015 03:00:00 AM,48,-122,1,2,3
11044,SpokaneStBridge,04/06/2015 04:00:00 AM,48,-122,4,0,4
11045,SpokaneStBridge,04/06/2015 05:00:00 AM,48,-122,16,1,17
11046,SpokaneStBridge,04/06/2015 06:00:00 AM,48,-122,53,9,62
11047,SpokaneStBridge,04/06/2015 07:00:00 AM,48,-122,94,10,104
11048,SpokaneStBridge,04/06/2015 08:00:00 AM,48,-122,101,8,109
11049,SpokaneStBridge,04/06/2015 09:00:00 AM,48,-122,37,4,41
11050,SpokaneStBridge,04/06/2015 10:00:00 AM,48,-122,17,4,21
11051,SpokaneStBridge,04/06/2015 11:00:00 AM,48,-122,5,3,8
11052,SpokaneStBridge,04/06/2015 12:00:00 PM,48,-122,9,5,14
11053,SpokaneStBridge,04/06/2015 01:00:00 PM,48,-122,9,10,19
11054,SpokaneStBridge,04/06/2015 02:00:00 PM,48,-122,11,13,24
11055,SpokaneStBridge,04/06/2015 03:00:00 PM,48,-122,9,32,41
11056,SpokaneStBridge,04/06/2015 04:00:00 PM,48,-122,18,67,85
11057,SpokaneStBridge,04/06/2015 05:00:00 PM,48,-122,16,125,141
11058,SpokaneStBridge,04/06/2015 06:00:00 PM,48,-122,16,80,96
11059,SpokaneStBridge,04/06/2015 07:00:00 PM,48,-122,9,20,29
11060,SpokaneStBridge,04/06/2015 08:00:00 PM,48,-122,5,10,15
11061,SpokaneStBridge,04/06/2015 09:00:00 PM,48,-122,2,6,8
11062,SpokaneStBridge,04/06/2015 10:00:00 PM,48,-122,3,3,6
11063,SpokaneStBridge,04/06/2015 11:00:00 PM,48,-122,3,1,4
11064,SpokaneStBridge,04/07/2015 12:00:00 AM,48,-122,0,2,2
11065,SpokaneStBridge,04/07/2015 01:00:00 AM,48,-122,0,0,0
11066,SpokaneStBridge,04/07/2015 02:00:00 AM,48,-122,0,0,0
11067,SpokaneStBridge,04/07/2015 03:00:00 AM,48,-122,0,1,1
11068,SpokaneStBridge,04/07/2015 04:00:00 AM,48,-122,0,0,0
11069,SpokaneStBridge,04/07/2015 05:00:00 AM,48,-122,26,3,29
11070,SpokaneStBridge,04/07/2015 06:00:00 AM,48,-122,63,12,75
11071,SpokaneStBridge,04/07/2015 07:00:00 AM,48,-122,118,15,133
11072,SpokaneStBridge,04/07/2015 08:00:00 AM,48,-122,117,7,124
11073,SpokaneStBridge,04/07/2015 09:00:00 AM,48,-122,36,7,43
11074,SpokaneStBridge,04/07/2015 10:00:00 AM,48,-122,15,8,23
11075,SpokaneStBridge,04/07/2015 11:00:00 AM,48,-122,5,6,11
11076,SpokaneStBridge,04/07/2015 12:00:00 PM,48,-122,3,5,8
11077,SpokaneStBridge,04/07/2015 01:00:00 PM,48,-122,5,6,11
11078,SpokaneStBridge,04/07/2015 02:00:00 PM,48,-122,7,14,21
11079,SpokaneStBridge,04/07/2015 03:00:00 PM,48,-122,7,30,37
11080,SpokaneStBridge,04/07/2015 04:00:00 PM,48,-122,20,73,93
11081,SpokaneStBridge,04/07/2015 05:00:00 PM,48,-122,28,132,160
11082,SpokaneStBridge,04/07/2015 06:00:00 PM,48,-122,11,80,91
11083,SpokaneStBridge,04/07/2015 07:00:00 PM,48,-122,7,22,29
11084,SpokaneStBridge,04/07/2015 08:00:00 PM,48,-122,2,17,19
11085,SpokaneStBridge,04/07/2015 09:00:00 PM,48,-122,3,10,13
11086,SpokaneStBridge,04/07/2015 10:00:00 PM,48,-122,4,3,7
11087,SpokaneStBridge,04/07/2015 11:00:00 PM,48,-122,1,1,2
11088,SpokaneStBridge,04/08/2015 12:00:00 AM,48,-122,6,1,7
11089,SpokaneStBridge,04/08/2015 01:00:00 AM,48,-122,0,0,0
11090,SpokaneStBridge,04/08/2015 02:00:00 AM,48,-122,0,0,0
11091,SpokaneStBridge,04/08/2015 03:00:00 AM,48,-122,0,2,2
11092,SpokaneStBridge,04/08/2015 04:00:00 AM,48,-122,1,0,1
11093,SpokaneStBridge,04/08/2015 05:00:00 AM,48,-122,21,2,23
11094,SpokaneStBridge,04/08/2015 06:00:00 AM,48,-122,70,13,83
11095,SpokaneStBridge,04/08/2015 07:00:00 AM,48,-122,108,10,118
11096,SpokaneStBridge,04/08/2015 08:00:00 AM,48,-122,100,7,107
11097,SpokaneStBridge,04/08/2015 09:00:00 AM,48,-122,40,15,55
11098,SpokaneStBridge,04/08/2015 10:00:00 AM,48,-122,20,2,22
11099,SpokaneStBridge,04/08/2015 11:00:00 AM,48,-122,19,4,23
11100,SpokaneStBridge,04/08/2015 12:00:00 PM,48,-122,9,9,18
11101,SpokaneStBridge,04/08/2015 01:00:00 PM,48,-122,16,19,35
11102,SpokaneStBridge,04/08/2015 02:00:00 PM,48,-122,15,26,41
11103,SpokaneStBridge,04/08/2015 03:00:00 PM,48,-122,17,34,51
11104,SpokaneStBridge,04/08/2015 04:00:00 PM,48,-122,28,88,116
11105,SpokaneStBridge,04/08/2015 05:00:00 PM,48,-122,27,128,155
11106,SpokaneStBridge,04/08/2015 06:00:00 PM,48,-122,12,81,93
11107,SpokaneStBridge,04/08/2015 07:00:00 PM,48,-122,23,39,62
11108,SpokaneStBridge,04/08/2015 08:00:00 PM,48,-122,6,16,22
11109,SpokaneStBridge,04/08/2015 09:00:00 PM,48,-122,4,13,17
11110,SpokaneStBridge,04/08/2015 10:00:00 PM,48,-122,4,3,7
11111,SpokaneStBridge,04/08/2015 11:00:00 PM,48,-122,1,3,4
11112,SpokaneStBridge,04/09/2015 12:00:00 AM,48,-122,2,1,3
11113,SpokaneStBridge,04/09/2015 01:00:00 AM,48,-122,1,0,1
11114,SpokaneStBridge,04/09/2015 02:00:00 AM,48,-122,0,0,0
11115,SpokaneStBridge,04/09/2015 03:00:00 AM,48,-122,0,0,0
11116,SpokaneStBridge,04/09/2015 04:00:00 AM,48,-122,4,0,4
11117,SpokaneStBridge,04/09/2015 05:00:00 AM,48,-122,17,5,22
11118,SpokaneStBridge,04/09/2015 06:00:00 AM,48,-122,61,11,72
11119,SpokaneStBridge,04/09/2015 07:00:00 AM,48,-122,112,17,129
11120,SpokaneStBridge,04/09/2015 08:00:00 AM,48,-122,111,8,119
11121,SpokaneStBridge,04/09/2015 09:00:00 AM,48,-122,38,9,47
11122,SpokaneStBridge,04/09/2015 10:00:00 AM,48,-122,16,9,25
11123,SpokaneStBridge,04/09/2015 11:00:00 AM,48,-122,8,10,18
11124,SpokaneStBridge,04/09/2015 12:00:00 PM,48,-122,17,16,33
11125,SpokaneStBridge,04/09/2015 01:00:00 PM,48,-122,20,18,38
11126,SpokaneStBridge,04/09/2015 02:00:00 PM,48,-122,11,26,37
11127,SpokaneStBridge,04/09/2015 03:00:00 PM,48,-122,19,43,62
11128,SpokaneStBridge,04/09/2015 04:00:00 PM,48,-122,12,78,90
11129,SpokaneStBridge,04/09/2015 05:00:00 PM,48,-122,43,148,191
11130,SpokaneStBridge,04/09/2015 06:00:00 PM,48,-122,29,100,129
11131,SpokaneStBridge,04/09/2015 07:00:00 PM,48,-122,28,40,68
11132,SpokaneStBridge,04/09/2015 08:00:00 PM,48,-122,6,16,22
11133,SpokaneStBridge,04/09/2015 09:00:00 PM,48,-122,5,13,18
11134,SpokaneStBridge,04/09/2015 10:00:00 PM,48,-122,10,6,16
11135,SpokaneStBridge,04/09/2015 11:00:00 PM,48,-122,2,4,6
11136,SpokaneStBridge,04/10/2015 12:00:00 AM,48,-122,1,2,3
11137,SpokaneStBridge,04/10/2015 01:00:00 AM,48,-122,0,0,0
11138,SpokaneStBridge,04/10/2015 02:00:00 AM,48,-122,0,0,0
11139,SpokaneStBridge,04/10/2015 03:00:00 AM,48,-122,0,0,0
11140,SpokaneStBridge,04/10/2015 04:00:00 AM,48,-122,1,0,1
11141,SpokaneStBridge,04/10/2015 05:00:00 AM,48,-122,7,1,8
11142,SpokaneStBridge,04/10/2015 06:00:00 AM,48,-122,37,9,46
11143,SpokaneStBridge,04/10/2015 07:00:00 AM,48,-122,90,13,103
11144,SpokaneStBridge,04/10/2015 08:00:00 AM,48,-122,81,11,92
11145,SpokaneStBridge,04/10/2015 09:00:00 AM,48,-122,24,4,28
11146,SpokaneStBridge,04/10/2015 10:00:00 AM,48,-122,12,9,21
11147,SpokaneStBridge,04/10/2015 11:00:00 AM,48,-122,7,2,9
11148,SpokaneStBridge,04/10/2015 12:00:00 PM,48,-122,12,15,27
11149,SpokaneStBridge,04/10/2015 01:00:00 PM,48,-122,10,11,21
11150,SpokaneStBridge,04/10/2015 02:00:00 PM,48,-122,13,11,24
11151,SpokaneStBridge,04/10/2015 03:00:00 PM,48,-122,8,28,36
11152,SpokaneStBridge,04/10/2015 04:00:00 PM,48,-122,13,48,61
11153,SpokaneStBridge,04/10/2015 05:00:00 PM,48,-122,10,63,73
11154,SpokaneStBridge,04/10/2015 06:00:00 PM,48,-122,2,35,37
11155,SpokaneStBridge,04/10/2015 07:00:00 PM,48,-122,1,7,8
11156,SpokaneStBridge,04/10/2015 08:00:00 PM,48,-122,0,3,3
11157,SpokaneStBridge,04/10/2015 09:00:00 PM,48,-122,2,3,5
11158,SpokaneStBridge,04/10/2015 10:00:00 PM,48,-122,1,2,3
11159,SpokaneStBridge,04/10/2015 11:00:00 PM,48,-122,0,1,1
11160,SpokaneStBridge,04/11/2015 12:00:00 AM,48,-122,1,0,1
11161,SpokaneStBridge,04/11/2015 01:00:00 AM,48,-122,0,0,0
11162,SpokaneStBridge,04/11/2015 02:00:00 AM,48,-122,0,0,0
11163,SpokaneStBridge,04/11/2015 03:00:00 AM,48,-122,1,1,2
11164,SpokaneStBridge,04/11/2015 04:00:00 AM,48,-122,2,0,2
11165,SpokaneStBridge,04/11/2015 05:00:00 AM,48,-122,1,2,3
11166,SpokaneStBridge,04/11/2015 06:00:00 AM,48,-122,4,1,5
11167,SpokaneStBridge,04/11/2015 07:00:00 AM,48,-122,12,4,16
11168,SpokaneStBridge,04/11/2015 08:00:00 AM,48,-122,11,8,19
11169,SpokaneStBridge,04/11/2015 09:00:00 AM,48,-122,11,9,20
11170,SpokaneStBridge,04/11/2015 10:00:00 AM,48,-122,11,13,24
11171,SpokaneStBridge,04/11/2015 11:00:00 AM,48,-122,10,8,18
11172,SpokaneStBridge,04/11/2015 12:00:00 PM,48,-122,19,12,31
11173,SpokaneStBridge,04/11/2015 01:00:00 PM,48,-122,15,11,26
11174,SpokaneStBridge,04/11/2015 02:00:00 PM,48,-122,15,21,36
11175,SpokaneStBridge,04/11/2015 03:00:00 PM,48,-122,17,16,33
11176,SpokaneStBridge,04/11/2015 04:00:00 PM,48,-122,9,24,33
11177,SpokaneStBridge,04/11/2015 05:00:00 PM,48,-122,8,5,13
11178,SpokaneStBridge,04/11/2015 06:00:00 PM,48,-122,3,12,15
11179,SpokaneStBridge,04/11/2015 07:00:00 PM,48,-122,5,8,13
11180,SpokaneStBridge,04/11/2015 08:00:00 PM,48,-122,2,4,6
11181,SpokaneStBridge,04/11/2015 09:00:00 PM,48,-122,1,2,3
11182,SpokaneStBridge,04/11/2015 10:00:00 PM,48,-122,5,0,5
11183,SpokaneStBridge,04/11/2015 11:00:00 PM,48,-122,1,2,3
11184,SpokaneStBridge,04/12/2015 12:00:00 AM,48,-122,3,3,6
11185,SpokaneStBridge,04/12/2015 01:00:00 AM,48,-122,1,1,2
11186,SpokaneStBridge,04/12/2015 02:00:00 AM,48,-122,0,0,0
11187,SpokaneStBridge,04/12/2015 03:00:00 AM,48,-122,2,1,3
11188,SpokaneStBridge,04/12/2015 04:00:00 AM,48,-122,2,0,2
11189,SpokaneStBridge,04/12/2015 05:00:00 AM,48,-122,4,0,4
11190,SpokaneStBridge,04/12/2015 06:00:00 AM,48,-122,3,0,3
11191,SpokaneStBridge,04/12/2015 07:00:00 AM,48,-122,6,2,8
11192,SpokaneStBridge,04/12/2015 08:00:00 AM,48,-122,27,4,31
11193,SpokaneStBridge,04/12/2015 09:00:00 AM,48,-122,22,22,44
11194,SpokaneStBridge,04/12/2015 10:00:00 AM,48,-122,18,23,41
11195,SpokaneStBridge,04/12/2015 11:00:00 AM,48,-122,35,32,67
11196,SpokaneStBridge,04/12/2015 12:00:00 PM,48,-122,34,29,63
11197,SpokaneStBridge,04/12/2015 01:00:00 PM,48,-122,31,41,72
11198,SpokaneStBridge,04/12/2015 02:00:00 PM,48,-122,39,33,72
11199,SpokaneStBridge,04/12/2015 03:00:00 PM,48,-122,18,37,55
11200,SpokaneStBridge,04/12/2015 04:00:00 PM,48,-122,20,12,32
11201,SpokaneStBridge,04/12/2015 05:00:00 PM,48,-122,15,24,39
11202,SpokaneStBridge,04/12/2015 06:00:00 PM,48,-122,8,13,21
11203,SpokaneStBridge,04/12/2015 07:00:00 PM,48,-122,7,7,14
11204,SpokaneStBridge,04/12/2015 08:00:00 PM,48,-122,1,5,6
11205,SpokaneStBridge,04/12/2015 09:00:00 PM,48,-122,1,3,4
11206,SpokaneStBridge,04/12/2015 10:00:00 PM,48,-122,2,2,4
11207,SpokaneStBridge,04/12/2015 11:00:00 PM,48,-122,2,0,2
11208,SpokaneStBridge,04/13/2015 12:00:00 AM,48,-122,3,3,6
11209,SpokaneStBridge,04/13/2015 01:00:00 AM,48,-122,2,1,3
11210,SpokaneStBridge,04/13/2015 02:00:00 AM,48,-122,0,0,0
11211,SpokaneStBridge,04/13/2015 03:00:00 AM,48,-122,0,1,1
11212,SpokaneStBridge,04/13/2015 04:00:00 AM,48,-122,7,1,8
11213,SpokaneStBridge,04/13/2015 05:00:00 AM,48,-122,13,1,14
11214,SpokaneStBridge,04/13/2015 06:00:00 AM,48,-122,51,9,60
11215,SpokaneStBridge,04/13/2015 07:00:00 AM,48,-122,79,10,89
11216,SpokaneStBridge,04/13/2015 08:00:00 AM,48,-122,78,8,86
11217,SpokaneStBridge,04/13/2015 09:00:00 AM,48,-122,28,2,30
11218,SpokaneStBridge,04/13/2015 10:00:00 AM,48,-122,8,6,14
11219,SpokaneStBridge,04/13/2015 11:00:00 AM,48,-122,15,3,18
11220,SpokaneStBridge,04/13/2015 12:00:00 PM,48,-122,5,3,8
11221,SpokaneStBridge,04/13/2015 01:00:00 PM,48,-122,6,4,10
11222,SpokaneStBridge,04/13/2015 02:00:00 PM,48,-122,10,11,21
11223,SpokaneStBridge,04/13/2015 03:00:00 PM,48,-122,6,26,32
11224,SpokaneStBridge,04/13/2015 04:00:00 PM,48,-122,7,48,55
11225,SpokaneStBridge,04/13/2015 05:00:00 PM,48,-122,11,66,77
11226,SpokaneStBridge,04/13/2015 06:00:00 PM,48,-122,7,55,62
11227,SpokaneStBridge,04/13/2015 07:00:00 PM,48,-122,2,12,14
11228,SpokaneStBridge,04/13/2015 08:00:00 PM,48,-122,1,6,7
11229,SpokaneStBridge,04/13/2015 09:00:00 PM,48,-122,1,4,5
11230,SpokaneStBridge,04/13/2015 10:00:00 PM,48,-122,0,0,0
11231,SpokaneStBridge,04/13/2015 11:00:00 PM,48,-122,0,1,1
11232,SpokaneStBridge,04/14/2015 12:00:00 AM,48,-122,0,0,0
11233,SpokaneStBridge,04/14/2015 01:00:00 AM,48,-122,0,0,0
11234,SpokaneStBridge,04/14/2015 02:00:00 AM,48,-122,2,0,2
11235,SpokaneStBridge,04/14/2015 03:00:00 AM,48,-122,1,4,5
11236,SpokaneStBridge,04/14/2015 04:00:00 AM,48,-122,2,2,4
11237,SpokaneStBridge,04/14/2015 05:00:00 AM,48,-122,10,1,11
11238,SpokaneStBridge,04/14/2015 06:00:00 AM,48,-122,50,3,53
11239,SpokaneStBridge,04/14/2015 07:00:00 AM,48,-122,77,9,86
11240,SpokaneStBridge,04/14/2015 08:00:00 AM,48,-122,75,12,87
11241,SpokaneStBridge,04/14/2015 09:00:00 AM,48,-122,23,5,28
11242,SpokaneStBridge,04/14/2015 10:00:00 AM,48,-122,7,6,13
11243,SpokaneStBridge,04/14/2015 11:00:00 AM,48,-122,11,5,16
11244,SpokaneStBridge,04/14/2015 12:00:00 PM,48,-122,5,6,11
11245,SpokaneStBridge,04/14/2015 01:00:00 PM,48,-122,5,10,15
11246,SpokaneStBridge,04/14/2015 02:00:00 PM,48,-122,8,11,19
11247,SpokaneStBridge,04/14/2015 03:00:00 PM,48,-122,6,12,18
11248,SpokaneStBridge,04/14/2015 04:00:00 PM,48,-122,7,52,59
11249,SpokaneStBridge,04/14/2015 05:00:00 PM,48,-122,7,91,98
11250,SpokaneStBridge,04/14/2015 06:00:00 PM,48,-122,5,50,55
11251,SpokaneStBridge,04/14/2015 07:00:00 PM,48,-122,6,20,26
11252,SpokaneStBridge,04/14/2015 08:00:00 PM,48,-122,1,7,8
11253,SpokaneStBridge,04/14/2015 09:00:00 PM,48,-122,3,7,10
11254,SpokaneStBridge,04/14/2015 10:00:00 PM,48,-122,0,1,1
11255,SpokaneStBridge,04/14/2015 11:00:00 PM,48,-122,1,1,2
11256,SpokaneStBridge,04/15/2015 12:00:00 AM,48,-122,0,2,2
11257,SpokaneStBridge,04/15/2015 01:00:00 AM,48,-122,0,1,1
11258,SpokaneStBridge,04/15/2015 02:00:00 AM,48,-122,1,0,1
11259,SpokaneStBridge,04/15/2015 03:00:00 AM,48,-122,1,1,2
11260,SpokaneStBridge,04/15/2015 04:00:00 AM,48,-122,3,1,4
11261,SpokaneStBridge,04/15/2015 05:00:00 AM,48,-122,18,3,21
11262,SpokaneStBridge,04/15/2015 06:00:00 AM,48,-122,59,6,65
11263,SpokaneStBridge,04/15/2015 07:00:00 AM,48,-122,96,14,110
11264,SpokaneStBridge,04/15/2015 08:00:00 AM,48,-122,102,5,107
11265,SpokaneStBridge,04/15/2015 09:00:00 AM,48,-122,35,8,43
11266,SpokaneStBridge,04/15/2015 10:00:00 AM,48,-122,17,6,23
11267,SpokaneStBridge,04/15/2015 11:00:00 AM,48,-122,10,4,14
11268,SpokaneStBridge,04/15/2015 12:00:00 PM,48,-122,12,11,23
11269,SpokaneStBridge,04/15/2015 01:00:00 PM,48,-122,10,10,20
11270,SpokaneStBridge,04/15/2015 02:00:00 PM,48,-122,12,22,34
11271,SpokaneStBridge,04/15/2015 03:00:00 PM,48,-122,11,32,43
11272,SpokaneStBridge,04/15/2015 04:00:00 PM,48,-122,22,81,103
11273,SpokaneStBridge,04/15/2015 05:00:00 PM,48,-122,19,117,136
11274,SpokaneStBridge,04/15/2015 06:00:00 PM,48,-122,26,82,108
11275,SpokaneStBridge,04/15/2015 07:00:00 PM,48,-122,16,39,55
11276,SpokaneStBridge,04/15/2015 08:00:00 PM,48,-122,7,15,22
11277,SpokaneStBridge,04/15/2015 09:00:00 PM,48,-122,4,6,10
11278,SpokaneStBridge,04/15/2015 10:00:00 PM,48,-122,2,7,9
11279,SpokaneStBridge,04/15/2015 11:00:00 PM,48,-122,1,2,3
11280,SpokaneStBridge,04/16/2015 12:00:00 AM,48,-122,1,3,4
11281,SpokaneStBridge,04/16/2015 01:00:00 AM,48,-122,0,0,0
11282,SpokaneStBridge,04/16/2015 02:00:00 AM,48,-122,2,0,2
11283,SpokaneStBridge,04/16/2015 03:00:00 AM,48,-122,0,0,0
11284,SpokaneStBridge,04/16/2015 04:00:00 AM,48,-122,5,0,5
11285,SpokaneStBridge,04/16/2015 05:00:00 AM,48,-122,19,2,21
11286,SpokaneStBridge,04/16/2015 06:00:00 AM,48,-122,62,9,71
11287,SpokaneStBridge,04/16/2015 07:00:00 AM,48,-122,101,15,116
11288,SpokaneStBridge,04/16/2015 08:00:00 AM,48,-122,101,12,113
11289,SpokaneStBridge,04/16/2015 09:00:00 AM,48,-122,43,6,49
11290,SpokaneStBridge,04/16/2015 10:00:00 AM,48,-122,20,3,23
11291,SpokaneStBridge,04/16/2015 11:00:00 AM,48,-122,19,10,29
11292,SpokaneStBridge,04/16/2015 12:00:00 PM,48,-122,18,13,31
11293,SpokaneStBridge,04/16/2015 01:00:00 PM,48,-122,19,10,29
11294,SpokaneStBridge,04/16/2015 02:00:00 PM,48,-122,17,23,40
11295,SpokaneStBridge,04/16/2015 03:00:00 PM,48,-122,15,44,59
11296,SpokaneStBridge,04/16/2015 04:00:00 PM,48,-122,25,85,110
11297,SpokaneStBridge,04/16/2015 05:00:00 PM,48,-122,22,129,151
11298,SpokaneStBridge,04/16/2015 06:00:00 PM,48,-122,22,94,116
11299,SpokaneStBridge,04/16/2015 07:00:00 PM,48,-122,14,35,49
11300,SpokaneStBridge,04/16/2015 08:00:00 PM,48,-122,14,16,30
11301,SpokaneStBridge,04/16/2015 09:00:00 PM,48,-122,7,11,18
11302,SpokaneStBridge,04/16/2015 10:00:00 PM,48,-122,2,4,6
11303,SpokaneStBridge,04/16/2015 11:00:00 PM,48,-122,1,4,5
11304,SpokaneStBridge,04/17/2015 12:00:00 AM,48,-122,1,3,4
11305,SpokaneStBridge,04/17/2015 01:00:00 AM,48,-122,1,1,2
11306,SpokaneStBridge,04/17/2015 02:00:00 AM,48,-122,0,1,1
11307,SpokaneStBridge,04/17/2015 03:00:00 AM,48,-122,0,0,0
11308,SpokaneStBridge,04/17/2015 04:00:00 AM,48,-122,0,0,0
11309,SpokaneStBridge,04/17/2015 05:00:00 AM,48,-122,15,1,16
11310,SpokaneStBridge,04/17/2015 06:00:00 AM,48,-122,50,6,56
11311,SpokaneStBridge,04/17/2015 07:00:00 AM,48,-122,94,18,112
11312,SpokaneStBridge,04/17/2015 08:00:00 AM,48,-122,87,10,97
11313,SpokaneStBridge,04/17/2015 09:00:00 AM,48,-122,33,3,36
11314,SpokaneStBridge,04/17/2015 10:00:00 AM,48,-122,21,14,35
11315,SpokaneStBridge,04/17/2015 11:00:00 AM,48,-122,6,4,10
11316,SpokaneStBridge,04/17/2015 12:00:00 PM,48,-122,17,16,33
11317,SpokaneStBridge,04/17/2015 01:00:00 PM,48,-122,12,11,23
11318,SpokaneStBridge,04/17/2015 02:00:00 PM,48,-122,18,19,37
11319,SpokaneStBridge,04/17/2015 03:00:00 PM,48,-122,21,44,65
11320,SpokaneStBridge,04/17/2015 04:00:00 PM,48,-122,21,89,110
11321,SpokaneStBridge,04/17/2015 05:00:00 PM,48,-122,15,110,125
11322,SpokaneStBridge,04/17/2015 06:00:00 PM,48,-122,12,65,77
11323,SpokaneStBridge,04/17/2015 07:00:00 PM,48,-122,8,24,32
11324,SpokaneStBridge,04/17/2015 08:00:00 PM,48,-122,4,16,20
11325,SpokaneStBridge,04/17/2015 09:00:00 PM,48,-122,4,6,10
11326,SpokaneStBridge,04/17/2015 10:00:00 PM,48,-122,4,3,7
11327,SpokaneStBridge,04/17/2015 11:00:00 PM,48,-122,0,2,2
11328,SpokaneStBridge,04/18/2015 12:00:00 AM,48,-122,1,2,3
11329,SpokaneStBridge,04/18/2015 01:00:00 AM,48,-122,1,2,3
11330,SpokaneStBridge,04/18/2015 02:00:00 AM,48,-122,0,0,0
11331,SpokaneStBridge,04/18/2015 03:00:00 AM,48,-122,2,1,3
11332,SpokaneStBridge,04/18/2015 04:00:00 AM,48,-122,1,0,1
11333,SpokaneStBridge,04/18/2015 05:00:00 AM,48,-122,5,0,5
11334,SpokaneStBridge,04/18/2015 06:00:00 AM,48,-122,8,6,14
11335,SpokaneStBridge,04/18/2015 07:00:00 AM,48,-122,18,23,41
11336,SpokaneStBridge,04/18/2015 08:00:00 AM,48,-122,30,36,66
11337,SpokaneStBridge,04/18/2015 09:00:00 AM,48,-122,31,25,56
11338,SpokaneStBridge,04/18/2015 10:00:00 AM,48,-122,30,43,73
11339,SpokaneStBridge,04/18/2015 11:00:00 AM,48,-122,56,34,90
11340,SpokaneStBridge,04/18/2015 12:00:00 PM,48,-122,34,36,70
11341,SpokaneStBridge,04/18/2015 01:00:00 PM,48,-122,52,48,100
11342,SpokaneStBridge,04/18/2015 02:00:00 PM,48,-122,55,44,99
11343,SpokaneStBridge,04/18/2015 03:00:00 PM,48,-122,39,35,74
11344,SpokaneStBridge,04/18/2015 04:00:00 PM,48,-122,24,26,50
11345,SpokaneStBridge,04/18/2015 05:00:00 PM,48,-122,28,39,67
11346,SpokaneStBridge,04/18/2015 06:00:00 PM,48,-122,25,24,49
11347,SpokaneStBridge,04/18/2015 07:00:00 PM,48,-122,11,8,19
11348,SpokaneStBridge,04/18/2015 08:00:00 PM,48,-122,13,10,23
11349,SpokaneStBridge,04/18/2015 09:00:00 PM,48,-122,4,7,11
11350,SpokaneStBridge,04/18/2015 10:00:00 PM,48,-122,2,3,5
11351,SpokaneStBridge,04/18/2015 11:00:00 PM,48,-122,1,2,3
11352,SpokaneStBridge,04/19/2015 12:00:00 AM,48,-122,2,4,6
11353,SpokaneStBridge,04/19/2015 01:00:00 AM,48,-122,1,3,4
11354,SpokaneStBridge,04/19/2015 02:00:00 AM,48,-122,0,1,1
11355,SpokaneStBridge,04/19/2015 03:00:00 AM,48,-122,1,0,1
11356,SpokaneStBridge,04/19/2015 04:00:00 AM,48,-122,4,1,5
11357,SpokaneStBridge,04/19/2015 05:00:00 AM,48,-122,3,0,3
11358,SpokaneStBridge,04/19/2015 06:00:00 AM,48,-122,4,4,8
11359,SpokaneStBridge,04/19/2015 07:00:00 AM,48,-122,12,4,16
11360,SpokaneStBridge,04/19/2015 08:00:00 AM,48,-122,22,18,40
11361,SpokaneStBridge,04/19/2015 09:00:00 AM,48,-122,52,25,77
11362,SpokaneStBridge,04/19/2015 10:00:00 AM,48,-122,31,34,65
11363,SpokaneStBridge,04/19/2015 11:00:00 AM,48,-122,35,43,78
11364,SpokaneStBridge,04/19/2015 12:00:00 PM,48,-122,44,67,111
11365,SpokaneStBridge,04/19/2015 01:00:00 PM,48,-122,34,45,79
11366,SpokaneStBridge,04/19/2015 02:00:00 PM,48,-122,42,51,93
11367,SpokaneStBridge,04/19/2015 03:00:00 PM,48,-122,32,36,68
11368,SpokaneStBridge,04/19/2015 04:00:00 PM,48,-122,36,39,75
11369,SpokaneStBridge,04/19/2015 05:00:00 PM,48,-122,41,31,72
11370,SpokaneStBridge,04/19/2015 06:00:00 PM,48,-122,15,13,28
11371,SpokaneStBridge,04/19/2015 07:00:00 PM,48,-122,7,13,20
11372,SpokaneStBridge,04/19/2015 08:00:00 PM,48,-122,6,8,14
11373,SpokaneStBridge,04/19/2015 09:00:00 PM,48,-122,7,4,11
11374,SpokaneStBridge,04/19/2015 10:00:00 PM,48,-122,1,5,6
11375,SpokaneStBridge,04/19/2015 11:00:00 PM,48,-122,1,1,2
11376,SpokaneStBridge,04/20/2015 12:00:00 AM,48,-122,1,0,1
11377,SpokaneStBridge,04/20/2015 01:00:00 AM,48,-122,1,4,5
11378,SpokaneStBridge,04/20/2015 02:00:00 AM,48,-122,0,1,1
11379,SpokaneStBridge,04/20/2015 03:00:00 AM,48,-122,0,0,0
11380,SpokaneStBridge,04/20/2015 04:00:00 AM,48,-122,3,2,5
11381,SpokaneStBridge,04/20/2015 05:00:00 AM,48,-122,19,2,21
11382,SpokaneStBridge,04/20/2015 06:00:00 AM,48,-122,70,13,83
11383,SpokaneStBridge,04/20/2015 07:00:00 AM,48,-122,126,20,146
11384,SpokaneStBridge,04/20/2015 08:00:00 AM,48,-122,121,14,135
11385,SpokaneStBridge,04/20/2015 09:00:00 AM,48,-122,49,8,57
11386,SpokaneStBridge,04/20/2015 10:00:00 AM,48,-122,22,6,28
11387,SpokaneStBridge,04/20/2015 11:00:00 AM,48,-122,19,10,29
11388,SpokaneStBridge,04/20/2015 12:00:00 PM,48,-122,19,13,32
11389,SpokaneStBridge,04/20/2015 01:00:00 PM,48,-122,9,14,23
11390,SpokaneStBridge,04/20/2015 02:00:00 PM,48,-122,20,26,46
11391,SpokaneStBridge,04/20/2015 03:00:00 PM,48,-122,20,41,61
11392,SpokaneStBridge,04/20/2015 04:00:00 PM,48,-122,34,101,135
11393,SpokaneStBridge,04/20/2015 05:00:00 PM,48,-122,29,152,181
11394,SpokaneStBridge,04/20/2015 06:00:00 PM,48,-122,18,112,130
11395,SpokaneStBridge,04/20/2015 07:00:00 PM,48,-122,6,34,40
11396,SpokaneStBridge,04/20/2015 08:00:00 PM,48,-122,8,20,28
11397,SpokaneStBridge,04/20/2015 09:00:00 PM,48,-122,5,14,19
11398,SpokaneStBridge,04/20/2015 10:00:00 PM,48,-122,0,3,3
11399,SpokaneStBridge,04/20/2015 11:00:00 PM,48,-122,2,5,7
11400,SpokaneStBridge,04/21/2015 12:00:00 AM,48,-122,1,1,2
11401,SpokaneStBridge,04/21/2015 01:00:00 AM,48,-122,1,2,3
11402,SpokaneStBridge,04/21/2015 02:00:00 AM,48,-122,1,2,3
11403,SpokaneStBridge,04/21/2015 03:00:00 AM,48,-122,1,2,3
11404,SpokaneStBridge,04/21/2015 04:00:00 AM,48,-122,3,2,5
11405,SpokaneStBridge,04/21/2015 05:00:00 AM,48,-122,22,4,26
11406,SpokaneStBridge,04/21/2015 06:00:00 AM,48,-122,79,13,92
11407,SpokaneStBridge,04/21/2015 07:00:00 AM,48,-122,135,15,150
11408,SpokaneStBridge,04/21/2015 08:00:00 AM,48,-122,99,9,108
11409,SpokaneStBridge,04/21/2015 09:00:00 AM,48,-122,32,11,43
11410,SpokaneStBridge,04/21/2015 10:00:00 AM,48,-122,14,10,24
11411,SpokaneStBridge,04/21/2015 11:00:00 AM,48,-122,13,10,23
11412,SpokaneStBridge,04/21/2015 12:00:00 PM,48,-122,18,11,29
11413,SpokaneStBridge,04/21/2015 01:00:00 PM,48,-122,17,14,31
11414,SpokaneStBridge,04/21/2015 02:00:00 PM,48,-122,9,16,25
11415,SpokaneStBridge,04/21/2015 03:00:00 PM,48,-122,7,37,44
11416,SpokaneStBridge,04/21/2015 04:00:00 PM,48,-122,21,104,125
11417,SpokaneStBridge,04/21/2015 05:00:00 PM,48,-122,9,104,113
11418,SpokaneStBridge,04/21/2015 06:00:00 PM,48,-122,12,67,79
11419,SpokaneStBridge,04/21/2015 07:00:00 PM,48,-122,6,23,29
11420,SpokaneStBridge,04/21/2015 08:00:00 PM,48,-122,4,5,9
11421,SpokaneStBridge,04/21/2015 09:00:00 PM,48,-122,1,11,12
11422,SpokaneStBridge,04/21/2015 10:00:00 PM,48,-122,2,4,6
11423,SpokaneStBridge,04/21/2015 11:00:00 PM,48,-122,0,5,5
11424,SpokaneStBridge,04/22/2015 12:00:00 AM,48,-122,0,0,0
11425,SpokaneStBridge,04/22/2015 01:00:00 AM,48,-122,0,1,1
11426,SpokaneStBridge,04/22/2015 02:00:00 AM,48,-122,1,1,2
11427,SpokaneStBridge,04/22/2015 03:00:00 AM,48,-122,1,1,2
11428,SpokaneStBridge,04/22/2015 04:00:00 AM,48,-122,1,1,2
11429,SpokaneStBridge,04/22/2015 05:00:00 AM,48,-122,16,3,19
11430,SpokaneStBridge,04/22/2015 06:00:00 AM,48,-122,72,9,81
11431,SpokaneStBridge,04/22/2015 07:00:00 AM,48,-122,118,13,131
11432,SpokaneStBridge,04/22/2015 08:00:00 AM,48,-122,96,14,110
11433,SpokaneStBridge,04/22/2015 09:00:00 AM,48,-122,34,13,47
11434,SpokaneStBridge,04/22/2015 10:00:00 AM,48,-122,10,2,12
11435,SpokaneStBridge,04/22/2015 11:00:00 AM,48,-122,12,5,17
11436,SpokaneStBridge,04/22/2015 12:00:00 PM,48,-122,15,12,27
11437,SpokaneStBridge,04/22/2015 01:00:00 PM,48,-122,23,8,31
11438,SpokaneStBridge,04/22/2015 02:00:00 PM,48,-122,11,21,32
11439,SpokaneStBridge,04/22/2015 03:00:00 PM,48,-122,10,33,43
11440,SpokaneStBridge,04/22/2015 04:00:00 PM,48,-122,20,71,91
11441,SpokaneStBridge,04/22/2015 05:00:00 PM,48,-122,23,118,141
11442,SpokaneStBridge,04/22/2015 06:00:00 PM,48,-122,14,96,110
11443,SpokaneStBridge,04/22/2015 07:00:00 PM,48,-122,19,26,45
11444,SpokaneStBridge,04/22/2015 08:00:00 PM,48,-122,4,21,25
11445,SpokaneStBridge,04/22/2015 09:00:00 PM,48,-122,3,13,16
11446,SpokaneStBridge,04/22/2015 10:00:00 PM,48,-122,4,4,8
11447,SpokaneStBridge,04/22/2015 11:00:00 PM,48,-122,2,1,3
11448,SpokaneStBridge,04/23/2015 12:00:00 AM,48,-122,0,2,2
11449,SpokaneStBridge,04/23/2015 01:00:00 AM,48,-122,0,1,1
11450,SpokaneStBridge,04/23/2015 02:00:00 AM,48,-122,0,0,0
11451,SpokaneStBridge,04/23/2015 03:00:00 AM,48,-122,0,1,1
11452,SpokaneStBridge,04/23/2015 04:00:00 AM,48,-122,3,0,3
11453,SpokaneStBridge,04/23/2015 05:00:00 AM,48,-122,15,1,16
11454,SpokaneStBridge,04/23/2015 06:00:00 AM,48,-122,51,8,59
11455,SpokaneStBridge,04/23/2015 07:00:00 AM,48,-122,90,9,99
11456,SpokaneStBridge,04/23/2015 08:00:00 AM,48,-122,93,12,105
11457,SpokaneStBridge,04/23/2015 09:00:00 AM,48,-122,31,4,35
11458,SpokaneStBridge,04/23/2015 10:00:00 AM,48,-122,11,2,13
11459,SpokaneStBridge,04/23/2015 11:00:00 AM,48,-122,9,3,12
11460,SpokaneStBridge,04/23/2015 12:00:00 PM,48,-122,11,2,13
11461,SpokaneStBridge,04/23/2015 01:00:00 PM,48,-122,5,4,9
11462,SpokaneStBridge,04/23/2015 02:00:00 PM,48,-122,6,15,21
11463,SpokaneStBridge,04/23/2015 03:00:00 PM,48,-122,11,25,36
11464,SpokaneStBridge,04/23/2015 04:00:00 PM,48,-122,6,46,52
11465,SpokaneStBridge,04/23/2015 05:00:00 PM,48,-122,5,83,88
11466,SpokaneStBridge,04/23/2015 06:00:00 PM,48,-122,11,76,87
11467,SpokaneStBridge,04/23/2015 07:00:00 PM,48,-122,5,31,36
11468,SpokaneStBridge,04/23/2015 08:00:00 PM,48,-122,1,4,5
11469,SpokaneStBridge,04/23/2015 09:00:00 PM,48,-122,4,9,13
11470,SpokaneStBridge,04/23/2015 10:00:00 PM,48,-122,0,6,6
11471,SpokaneStBridge,04/23/2015 11:00:00 PM,48,-122,1,2,3
11472,SpokaneStBridge,04/24/2015 12:00:00 AM,48,-122,0,3,3
11473,SpokaneStBridge,04/24/2015 01:00:00 AM,48,-122,1,1,2
11474,SpokaneStBridge,04/24/2015 02:00:00 AM,48,-122,0,1,1
11475,SpokaneStBridge,04/24/2015 03:00:00 AM,48,-122,0,0,0
11476,SpokaneStBridge,04/24/2015 04:00:00 AM,48,-122,2,0,2
11477,SpokaneStBridge,04/24/2015 05:00:00 AM,48,-122,9,2,11
11478,SpokaneStBridge,04/24/2015 06:00:00 AM,48,-122,42,4,46
11479,SpokaneStBridge,04/24/2015 07:00:00 AM,48,-122,63,12,75
11480,SpokaneStBridge,04/24/2015 08:00:00 AM,48,-122,67,5,72
11481,SpokaneStBridge,04/24/2015 09:00:00 AM,48,-122,25,1,26
11482,SpokaneStBridge,04/24/2015 10:00:00 AM,48,-122,10,1,11
11483,SpokaneStBridge,04/24/2015 11:00:00 AM,48,-122,4,1,5
11484,SpokaneStBridge,04/24/2015 12:00:00 PM,48,-122,7,5,12
11485,SpokaneStBridge,04/24/2015 01:00:00 PM,48,-122,7,5,12
11486,SpokaneStBridge,04/24/2015 02:00:00 PM,48,-122,4,10,14
11487,SpokaneStBridge,04/24/2015 03:00:00 PM,48,-122,7,21,28
11488,SpokaneStBridge,04/24/2015 04:00:00 PM,48,-122,10,55,65
11489,SpokaneStBridge,04/24/2015 05:00:00 PM,48,-122,11,66,77
11490,SpokaneStBridge,04/24/2015 06:00:00 PM,48,-122,7,31,38
11491,SpokaneStBridge,04/24/2015 07:00:00 PM,48,-122,8,20,28
11492,SpokaneStBridge,04/24/2015 08:00:00 PM,48,-122,2,8,10
11493,SpokaneStBridge,04/24/2015 09:00:00 PM,48,-122,0,4,4
11494,SpokaneStBridge,04/24/2015 10:00:00 PM,48,-122,0,5,5
11495,SpokaneStBridge,04/24/2015 11:00:00 PM,48,-122,3,0,3
11496,SpokaneStBridge,04/25/2015 12:00:00 AM,48,-122,2,3,5
11497,SpokaneStBridge,04/25/2015 01:00:00 AM,48,-122,1,1,2
11498,SpokaneStBridge,04/25/2015 02:00:00 AM,48,-122,0,2,2
11499,SpokaneStBridge,04/25/2015 03:00:00 AM,48,-122,2,0,2
11500,SpokaneStBridge,04/25/2015 04:00:00 AM,48,-122,0,0,0
11501,SpokaneStBridge,04/25/2015 05:00:00 AM,48,-122,3,0,3
11502,SpokaneStBridge,04/25/2015 06:00:00 AM,48,-122,4,1,5
11503,SpokaneStBridge,04/25/2015 07:00:00 AM,48,-122,9,3,12
11504,SpokaneStBridge,04/25/2015 08:00:00 AM,48,-122,15,11,26
11505,SpokaneStBridge,04/25/2015 09:00:00 AM,48,-122,15,11,26
11506,SpokaneStBridge,04/25/2015 10:00:00 AM,48,-122,26,20,46
11507,SpokaneStBridge,04/25/2015 11:00:00 AM,48,-122,19,18,37
11508,SpokaneStBridge,04/25/2015 12:00:00 PM,48,-122,23,26,49
11509,SpokaneStBridge,04/25/2015 01:00:00 PM,48,-122,40,27,67
11510,SpokaneStBridge,04/25/2015 02:00:00 PM,48,-122,30,26,56
11511,SpokaneStBridge,04/25/2015 03:00:00 PM,48,-122,10,28,38
11512,SpokaneStBridge,04/25/2015 04:00:00 PM,48,-122,14,17,31
11513,SpokaneStBridge,04/25/2015 05:00:00 PM,48,-122,22,25,47
11514,SpokaneStBridge,04/25/2015 06:00:00 PM,48,-122,4,16,20
11515,SpokaneStBridge,04/25/2015 07:00:00 PM,48,-122,11,14,25
11516,SpokaneStBridge,04/25/2015 08:00:00 PM,48,-122,8,12,20
11517,SpokaneStBridge,04/25/2015 09:00:00 PM,48,-122,4,6,10
11518,SpokaneStBridge,04/25/2015 10:00:00 PM,48,-122,2,7,9
11519,SpokaneStBridge,04/25/2015 11:00:00 PM,48,-122,2,2,4
11520,SpokaneStBridge,04/26/2015 12:00:00 AM,48,-122,2,2,4
11521,SpokaneStBridge,04/26/2015 01:00:00 AM,48,-122,1,0,1
11522,SpokaneStBridge,04/26/2015 02:00:00 AM,48,-122,0,1,1
11523,SpokaneStBridge,04/26/2015 03:00:00 AM,48,-122,1,0,1
11524,SpokaneStBridge,04/26/2015 04:00:00 AM,48,-122,1,1,2
11525,SpokaneStBridge,04/26/2015 05:00:00 AM,48,-122,3,1,4
11526,SpokaneStBridge,04/26/2015 06:00:00 AM,48,-122,3,3,6
11527,SpokaneStBridge,04/26/2015 07:00:00 AM,48,-122,10,3,13
11528,SpokaneStBridge,04/26/2015 08:00:00 AM,48,-122,28,9,37
11529,SpokaneStBridge,04/26/2015 09:00:00 AM,48,-122,12,18,30
11530,SpokaneStBridge,04/26/2015 10:00:00 AM,48,-122,18,26,44
11531,SpokaneStBridge,04/26/2015 11:00:00 AM,48,-122,27,26,53
11532,SpokaneStBridge,04/26/2015 12:00:00 PM,48,-122,27,24,51
11533,SpokaneStBridge,04/26/2015 01:00:00 PM,48,-122,25,26,51
11534,SpokaneStBridge,04/26/2015 02:00:00 PM,48,-122,20,20,40
11535,SpokaneStBridge,04/26/2015 03:00:00 PM,48,-122,33,35,68
11536,SpokaneStBridge,04/26/2015 04:00:00 PM,48,-122,29,41,70
11537,SpokaneStBridge,04/26/2015 05:00:00 PM,48,-122,37,29,66
11538,SpokaneStBridge,04/26/2015 06:00:00 PM,48,-122,7,11,18
11539,SpokaneStBridge,04/26/2015 07:00:00 PM,48,-122,7,9,16
11540,SpokaneStBridge,04/26/2015 08:00:00 PM,48,-122,3,5,8
11541,SpokaneStBridge,04/26/2015 09:00:00 PM,48,-122,0,3,3
11542,SpokaneStBridge,04/26/2015 10:00:00 PM,48,-122,2,3,5
11543,SpokaneStBridge,04/26/2015 11:00:00 PM,48,-122,0,5,5
11544,SpokaneStBridge,04/27/2015 12:00:00 AM,48,-122,1,1,2
11545,SpokaneStBridge,04/27/2015 01:00:00 AM,48,-122,1,0,1
11546,SpokaneStBridge,04/27/2015 02:00:00 AM,48,-122,0,0,0
11547,SpokaneStBridge,04/27/2015 03:00:00 AM,48,-122,2,1,3
11548,SpokaneStBridge,04/27/2015 04:00:00 AM,48,-122,2,2,4
11549,SpokaneStBridge,04/27/2015 05:00:00 AM,48,-122,18,4,22
11550,SpokaneStBridge,04/27/2015 06:00:00 AM,48,-122,57,12,69
11551,SpokaneStBridge,04/27/2015 07:00:00 AM,48,-122,133,25,158
11552,SpokaneStBridge,04/27/2015 08:00:00 AM,48,-122,125,9,134
11553,SpokaneStBridge,04/27/2015 09:00:00 AM,48,-122,46,5,51
11554,SpokaneStBridge,04/27/2015 10:00:00 AM,48,-122,14,4,18
11555,SpokaneStBridge,04/27/2015 11:00:00 AM,48,-122,13,7,20
11556,SpokaneStBridge,04/27/2015 12:00:00 PM,48,-122,19,13,32
11557,SpokaneStBridge,04/27/2015 01:00:00 PM,48,-122,15,11,26
11558,SpokaneStBridge,04/27/2015 02:00:00 PM,48,-122,18,27,45
11559,SpokaneStBridge,04/27/2015 03:00:00 PM,48,-122,21,51,72
11560,SpokaneStBridge,04/27/2015 04:00:00 PM,48,-122,32,133,165
11561,SpokaneStBridge,04/27/2015 05:00:00 PM,48,-122,35,171,206
11562,SpokaneStBridge,04/27/2015 06:00:00 PM,48,-122,27,118,145
11563,SpokaneStBridge,04/27/2015 07:00:00 PM,48,-122,18,30,48
11564,SpokaneStBridge,04/27/2015 08:00:00 PM,48,-122,13,16,29
11565,SpokaneStBridge,04/27/2015 09:00:00 PM,48,-122,6,3,9
11566,SpokaneStBridge,04/27/2015 10:00:00 PM,48,-122,0,5,5
11567,SpokaneStBridge,04/27/2015 11:00:00 PM,48,-122,3,4,7
11568,SpokaneStBridge,04/28/2015 12:00:00 AM,48,-122,0,1,1
11569,SpokaneStBridge,04/28/2015 01:00:00 AM,48,-122,0,1,1
11570,SpokaneStBridge,04/28/2015 02:00:00 AM,48,-122,1,0,1
11571,SpokaneStBridge,04/28/2015 03:00:00 AM,48,-122,1,3,4
11572,SpokaneStBridge,04/28/2015 04:00:00 AM,48,-122,2,0,2
11573,SpokaneStBridge,04/28/2015 05:00:00 AM,48,-122,13,2,15
11574,SpokaneStBridge,04/28/2015 06:00:00 AM,48,-122,73,12,85
11575,SpokaneStBridge,04/28/2015 07:00:00 AM,48,-122,110,14,124
11576,SpokaneStBridge,04/28/2015 08:00:00 AM,48,-122,110,11,121
11577,SpokaneStBridge,04/28/2015 09:00:00 AM,48,-122,26,4,30
11578,SpokaneStBridge,04/28/2015 10:00:00 AM,48,-122,17,4,21
11579,SpokaneStBridge,04/28/2015 11:00:00 AM,48,-122,11,13,24
11580,SpokaneStBridge,04/28/2015 12:00:00 PM,48,-122,16,9,25
11581,SpokaneStBridge,04/28/2015 01:00:00 PM,48,-122,3,4,7
11582,SpokaneStBridge,04/28/2015 02:00:00 PM,48,-122,11,10,21
11583,SpokaneStBridge,04/28/2015 03:00:00 PM,48,-122,10,32,42
11584,SpokaneStBridge,04/28/2015 04:00:00 PM,48,-122,9,57,66
11585,SpokaneStBridge,04/28/2015 05:00:00 PM,48,-122,13,94,107
11586,SpokaneStBridge,04/28/2015 06:00:00 PM,48,-122,8,79,87
11587,SpokaneStBridge,04/28/2015 07:00:00 PM,48,-122,8,26,34
11588,SpokaneStBridge,04/28/2015 08:00:00 PM,48,-122,1,17,18
11589,SpokaneStBridge,04/28/2015 09:00:00 PM,48,-122,3,10,13
11590,SpokaneStBridge,04/28/2015 10:00:00 PM,48,-122,1,4,5
11591,SpokaneStBridge,04/28/2015 11:00:00 PM,48,-122,0,3,3
11592,SpokaneStBridge,04/29/2015 12:00:00 AM,48,-122,0,0,0
11593,SpokaneStBridge,04/29/2015 01:00:00 AM,48,-122,0,1,1
11594,SpokaneStBridge,04/29/2015 02:00:00 AM,48,-122,1,0,1
11595,SpokaneStBridge,04/29/2015 03:00:00 AM,48,-122,0,0,0
11596,SpokaneStBridge,04/29/2015 04:00:00 AM,48,-122,1,1,2
11597,SpokaneStBridge,04/29/2015 05:00:00 AM,48,-122,9,2,11
11598,SpokaneStBridge,04/29/2015 06:00:00 AM,48,-122,57,5,62
11599,SpokaneStBridge,04/29/2015 07:00:00 AM,48,-122,122,15,137
11600,SpokaneStBridge,04/29/2015 08:00:00 AM,48,-122,104,15,119
11601,SpokaneStBridge,04/29/2015 09:00:00 AM,48,-122,55,13,68
11602,SpokaneStBridge,04/29/2015 10:00:00 AM,48,-122,7,7,14
11603,SpokaneStBridge,04/29/2015 11:00:00 AM,48,-122,11,6,17
11604,SpokaneStBridge,04/29/2015 12:00:00 PM,48,-122,9,11,20
11605,SpokaneStBridge,04/29/2015 01:00:00 PM,48,-122,16,10,26
11606,SpokaneStBridge,04/29/2015 02:00:00 PM,48,-122,11,20,31
11607,SpokaneStBridge,04/29/2015 03:00:00 PM,48,-122,7,29,36
11608,SpokaneStBridge,04/29/2015 04:00:00 PM,48,-122,17,84,101
11609,SpokaneStBridge,04/29/2015 05:00:00 PM,48,-122,30,135,165
11610,SpokaneStBridge,04/29/2015 06:00:00 PM,48,-122,19,89,108
11611,SpokaneStBridge,04/29/2015 07:00:00 PM,48,-122,18,46,64
11612,SpokaneStBridge,04/29/2015 08:00:00 PM,48,-122,9,19,28
11613,SpokaneStBridge,04/29/2015 09:00:00 PM,48,-122,5,6,11
11614,SpokaneStBridge,04/29/2015 10:00:00 PM,48,-122,0,6,6
11615,SpokaneStBridge,04/29/2015 11:00:00 PM,48,-122,1,2,3
11616,SpokaneStBridge,04/30/2015 12:00:00 AM,48,-122,1,0,1
11617,SpokaneStBridge,04/30/2015 01:00:00 AM,48,-122,0,0,0
11618,SpokaneStBridge,04/30/2015 02:00:00 AM,48,-122,0,1,1
11619,SpokaneStBridge,04/30/2015 03:00:00 AM,48,-122,0,0,0
11620,SpokaneStBridge,04/30/2015 04:00:00 AM,48,-122,3,0,3
11621,SpokaneStBridge,04/30/2015 05:00:00 AM,48,-122,21,4,25
11622,SpokaneStBridge,04/30/2015 06:00:00 AM,48,-122,69,13,82
11623,SpokaneStBridge,04/30/2015 07:00:00 AM,48,-122,134,16,150
11624,SpokaneStBridge,04/30/2015 08:00:00 AM,48,-122,113,8,121
11625,SpokaneStBridge,04/30/2015 09:00:00 AM,48,-122,44,8,52
11626,SpokaneStBridge,04/30/2015 10:00:00 AM,48,-122,14,6,20
11627,SpokaneStBridge,04/30/2015 11:00:00 AM,48,-122,19,7,26
11628,SpokaneStBridge,04/30/2015 12:00:00 PM,48,-122,13,14,27
11629,SpokaneStBridge,04/30/2015 01:00:00 PM,48,-122,10,14,24
11630,SpokaneStBridge,04/30/2015 02:00:00 PM,48,-122,20,22,42
11631,SpokaneStBridge,04/30/2015 03:00:00 PM,48,-122,12,40,52
11632,SpokaneStBridge,04/30/2015 04:00:00 PM,48,-122,19,85,104
11633,SpokaneStBridge,04/30/2015 05:00:00 PM,48,-122,25,131,156
11634,SpokaneStBridge,04/30/2015 06:00:00 PM,48,-122,19,98,117
11635,SpokaneStBridge,04/30/2015 07:00:00 PM,48,-122,11,48,59
11636,SpokaneStBridge,04/30/2015 08:00:00 PM,48,-122,8,20,28
11637,SpokaneStBridge,04/30/2015 09:00:00 PM,48,-122,8,9,17
11638,SpokaneStBridge,04/30/2015 10:00:00 PM,48,-122,1,11,12
11639,SpokaneStBridge,04/30/2015 11:00:00 PM,48,-122,2,3,5
11640,SpokaneStBridge,05/01/2015 12:00:00 AM,48,-122,0,1,1
11641,SpokaneStBridge,05/01/2015 01:00:00 AM,48,-122,0,2,2
11642,SpokaneStBridge,05/01/2015 02:00:00 AM,48,-122,1,1,2
11643,SpokaneStBridge,05/01/2015 03:00:00 AM,48,-122,0,0,0
11644,SpokaneStBridge,05/01/2015 04:00:00 AM,48,-122,2,2,4
11645,SpokaneStBridge,05/01/2015 05:00:00 AM,48,-122,23,3,26
11646,SpokaneStBridge,05/01/2015 06:00:00 AM,48,-122,86,18,104
11647,SpokaneStBridge,05/01/2015 07:00:00 AM,48,-122,162,25,187
11648,SpokaneStBridge,05/01/2015 08:00:00 AM,48,-122,144,15,159
11649,SpokaneStBridge,05/01/2015 09:00:00 AM,48,-122,50,5,55
11650,SpokaneStBridge,05/01/2015 10:00:00 AM,48,-122,23,6,29
11651,SpokaneStBridge,05/01/2015 11:00:00 AM,48,-122,16,18,34
11652,SpokaneStBridge,05/01/2015 12:00:00 PM,48,-122,11,20,31
11653,SpokaneStBridge,05/01/2015 01:00:00 PM,48,-122,26,25,51
11654,SpokaneStBridge,05/01/2015 02:00:00 PM,48,-122,13,37,50
11655,SpokaneStBridge,05/01/2015 03:00:00 PM,48,-122,20,60,80
11656,SpokaneStBridge,05/01/2015 04:00:00 PM,48,-122,27,122,149
11657,SpokaneStBridge,05/01/2015 05:00:00 PM,48,-122,19,155,174
11658,SpokaneStBridge,05/01/2015 06:00:00 PM,48,-122,12,73,85
11659,SpokaneStBridge,05/01/2015 07:00:00 PM,48,-122,15,35,50
11660,SpokaneStBridge,05/01/2015 08:00:00 PM,48,-122,6,9,15
11661,SpokaneStBridge,05/01/2015 09:00:00 PM,48,-122,0,12,12
11662,SpokaneStBridge,05/01/2015 10:00:00 PM,48,-122,0,3,3
11663,SpokaneStBridge,05/01/2015 11:00:00 PM,48,-122,0,1,1
11664,SpokaneStBridge,05/02/2015 12:00:00 AM,48,-122,0,2,2
11665,SpokaneStBridge,05/02/2015 01:00:00 AM,48,-122,3,2,5
11666,SpokaneStBridge,05/02/2015 02:00:00 AM,48,-122,0,0,0
11667,SpokaneStBridge,05/02/2015 03:00:00 AM,48,-122,1,1,2
11668,SpokaneStBridge,05/02/2015 04:00:00 AM,48,-122,1,0,1
11669,SpokaneStBridge,05/02/2015 05:00:00 AM,48,-122,5,4,9
11670,SpokaneStBridge,05/02/2015 06:00:00 AM,48,-122,7,4,11
11671,SpokaneStBridge,05/02/2015 07:00:00 AM,48,-122,22,11,33
11672,SpokaneStBridge,05/02/2015 08:00:00 AM,48,-122,29,18,47
11673,SpokaneStBridge,05/02/2015 09:00:00 AM,48,-122,24,23,47
11674,SpokaneStBridge,05/02/2015 10:00:00 AM,48,-122,44,29,73
11675,SpokaneStBridge,05/02/2015 11:00:00 AM,48,-122,27,69,96
11676,SpokaneStBridge,05/02/2015 12:00:00 PM,48,-122,43,38,81
11677,SpokaneStBridge,05/02/2015 01:00:00 PM,48,-122,32,32,64
11678,SpokaneStBridge,05/02/2015 02:00:00 PM,48,-122,32,44,76
11679,SpokaneStBridge,05/02/2015 03:00:00 PM,48,-122,42,43,85
11680,SpokaneStBridge,05/02/2015 04:00:00 PM,48,-122,47,51,98
11681,SpokaneStBridge,05/02/2015 05:00:00 PM,48,-122,18,40,58
11682,SpokaneStBridge,05/02/2015 06:00:00 PM,48,-122,24,19,43
11683,SpokaneStBridge,05/02/2015 07:00:00 PM,48,-122,14,14,28
11684,SpokaneStBridge,05/02/2015 08:00:00 PM,48,-122,1,4,5
11685,SpokaneStBridge,05/02/2015 09:00:00 PM,48,-122,9,4,13
11686,SpokaneStBridge,05/02/2015 10:00:00 PM,48,-122,3,4,7
11687,SpokaneStBridge,05/02/2015 11:00:00 PM,48,-122,6,4,10
11688,SpokaneStBridge,05/03/2015 12:00:00 AM,48,-122,0,3,3
11689,SpokaneStBridge,05/03/2015 01:00:00 AM,48,-122,0,0,0
11690,SpokaneStBridge,05/03/2015 02:00:00 AM,48,-122,1,1,2
11691,SpokaneStBridge,05/03/2015 03:00:00 AM,48,-122,1,1,2
11692,SpokaneStBridge,05/03/2015 04:00:00 AM,48,-122,0,0,0
11693,SpokaneStBridge,05/03/2015 05:00:00 AM,48,-122,5,3,8
11694,SpokaneStBridge,05/03/2015 06:00:00 AM,48,-122,9,6,15
11695,SpokaneStBridge,05/03/2015 07:00:00 AM,48,-122,11,7,18
11696,SpokaneStBridge,05/03/2015 08:00:00 AM,48,-122,43,18,61
11697,SpokaneStBridge,05/03/2015 09:00:00 AM,48,-122,37,25,62
11698,SpokaneStBridge,05/03/2015 10:00:00 AM,48,-122,25,47,72
11699,SpokaneStBridge,05/03/2015 11:00:00 AM,48,-122,30,57,87
11700,SpokaneStBridge,05/03/2015 12:00:00 PM,48,-122,33,48,81
11701,SpokaneStBridge,05/03/2015 01:00:00 PM,48,-122,59,57,116
11702,SpokaneStBridge,05/03/2015 02:00:00 PM,48,-122,31,40,71
11703,SpokaneStBridge,05/03/2015 03:00:00 PM,48,-122,25,46,71
11704,SpokaneStBridge,05/03/2015 04:00:00 PM,48,-122,43,41,84
11705,SpokaneStBridge,05/03/2015 05:00:00 PM,48,-122,31,26,57
11706,SpokaneStBridge,05/03/2015 06:00:00 PM,48,-122,21,14,35
11707,SpokaneStBridge,05/03/2015 07:00:00 PM,48,-122,12,13,25
11708,SpokaneStBridge,05/03/2015 08:00:00 PM,48,-122,7,4,11
11709,SpokaneStBridge,05/03/2015 09:00:00 PM,48,-122,5,3,8
11710,SpokaneStBridge,05/03/2015 10:00:00 PM,48,-122,0,0,0
11711,SpokaneStBridge,05/03/2015 11:00:00 PM,48,-122,1,2,3
11712,SpokaneStBridge,05/04/2015 12:00:00 AM,48,-122,1,0,1
11713,SpokaneStBridge,05/04/2015 01:00:00 AM,48,-122,0,0,0
11714,SpokaneStBridge,05/04/2015 02:00:00 AM,48,-122,1,0,1
11715,SpokaneStBridge,05/04/2015 03:00:00 AM,48,-122,1,1,2
11716,SpokaneStBridge,05/04/2015 04:00:00 AM,48,-122,5,0,5
11717,SpokaneStBridge,05/04/2015 05:00:00 AM,48,-122,21,1,22
11718,SpokaneStBridge,05/04/2015 06:00:00 AM,48,-122,96,14,110
11719,SpokaneStBridge,05/04/2015 07:00:00 AM,48,-122,191,24,215
11720,SpokaneStBridge,05/04/2015 08:00:00 AM,48,-122,141,12,153
11721,SpokaneStBridge,05/04/2015 09:00:00 AM,48,-122,57,8,65
11722,SpokaneStBridge,05/04/2015 10:00:00 AM,48,-122,24,10,34
11723,SpokaneStBridge,05/04/2015 11:00:00 AM,48,-122,12,12,24
11724,SpokaneStBridge,05/04/2015 12:00:00 PM,48,-122,16,14,30
11725,SpokaneStBridge,05/04/2015 01:00:00 PM,48,-122,9,14,23
11726,SpokaneStBridge,05/04/2015 02:00:00 PM,48,-122,13,14,27
11727,SpokaneStBridge,05/04/2015 03:00:00 PM,48,-122,18,46,64
11728,SpokaneStBridge,05/04/2015 04:00:00 PM,48,-122,29,94,123
11729,SpokaneStBridge,05/04/2015 05:00:00 PM,48,-122,29,206,235
11730,SpokaneStBridge,05/04/2015 06:00:00 PM,48,-122,15,147,162
11731,SpokaneStBridge,05/04/2015 07:00:00 PM,48,-122,9,40,49
11732,SpokaneStBridge,05/04/2015 08:00:00 PM,48,-122,4,17,21
11733,SpokaneStBridge,05/04/2015 09:00:00 PM,48,-122,1,7,8
11734,SpokaneStBridge,05/04/2015 10:00:00 PM,48,-122,3,2,5
11735,SpokaneStBridge,05/04/2015 11:00:00 PM,48,-122,2,2,4
11736,SpokaneStBridge,05/05/2015 12:00:00 AM,48,-122,1,3,4
11737,SpokaneStBridge,05/05/2015 01:00:00 AM,48,-122,0,2,2
11738,SpokaneStBridge,05/05/2015 02:00:00 AM,48,-122,2,0,2
11739,SpokaneStBridge,05/05/2015 03:00:00 AM,48,-122,0,1,1
11740,SpokaneStBridge,05/05/2015 04:00:00 AM,48,-122,2,0,2
11741,SpokaneStBridge,05/05/2015 05:00:00 AM,48,-122,20,1,21
11742,SpokaneStBridge,05/05/2015 06:00:00 AM,48,-122,54,9,63
11743,SpokaneStBridge,05/05/2015 07:00:00 AM,48,-122,103,11,114
11744,SpokaneStBridge,05/05/2015 08:00:00 AM,48,-122,94,4,98
11745,SpokaneStBridge,05/05/2015 09:00:00 AM,48,-122,38,5,43
11746,SpokaneStBridge,05/05/2015 10:00:00 AM,48,-122,19,4,23
11747,SpokaneStBridge,05/05/2015 11:00:00 AM,48,-122,5,9,14
11748,SpokaneStBridge,05/05/2015 12:00:00 PM,48,-122,9,10,19
11749,SpokaneStBridge,05/05/2015 01:00:00 PM,48,-122,14,8,22
11750,SpokaneStBridge,05/05/2015 02:00:00 PM,48,-122,7,8,15
11751,SpokaneStBridge,05/05/2015 03:00:00 PM,48,-122,8,13,21
11752,SpokaneStBridge,05/05/2015 04:00:00 PM,48,-122,16,58,74
11753,SpokaneStBridge,05/05/2015 05:00:00 PM,48,-122,12,105,117
11754,SpokaneStBridge,05/05/2015 06:00:00 PM,48,-122,4,48,52
11755,SpokaneStBridge,05/05/2015 07:00:00 PM,48,-122,5,35,40
11756,SpokaneStBridge,05/05/2015 08:00:00 PM,48,-122,1,12,13
11757,SpokaneStBridge,05/05/2015 09:00:00 PM,48,-122,1,7,8
11758,SpokaneStBridge,05/05/2015 10:00:00 PM,48,-122,0,3,3
11759,SpokaneStBridge,05/05/2015 11:00:00 PM,48,-122,2,2,4
11760,SpokaneStBridge,05/06/2015 12:00:00 AM,48,-122,0,1,1
11761,SpokaneStBridge,05/06/2015 01:00:00 AM,48,-122,0,0,0
11762,SpokaneStBridge,05/06/2015 02:00:00 AM,48,-122,1,0,1
11763,SpokaneStBridge,05/06/2015 03:00:00 AM,48,-122,1,1,2
11764,SpokaneStBridge,05/06/2015 04:00:00 AM,48,-122,4,1,5
11765,SpokaneStBridge,05/06/2015 05:00:00 AM,48,-122,22,2,24
11766,SpokaneStBridge,05/06/2015 06:00:00 AM,48,-122,94,17,111
11767,SpokaneStBridge,05/06/2015 07:00:00 AM,48,-122,163,24,187
11768,SpokaneStBridge,05/06/2015 08:00:00 AM,48,-122,145,6,151
11769,SpokaneStBridge,05/06/2015 09:00:00 AM,48,-122,47,11,58
11770,SpokaneStBridge,05/06/2015 10:00:00 AM,48,-122,19,6,25
11771,SpokaneStBridge,05/06/2015 11:00:00 AM,48,-122,10,9,19
11772,SpokaneStBridge,05/06/2015 12:00:00 PM,48,-122,13,8,21
11773,SpokaneStBridge,05/06/2015 01:00:00 PM,48,-122,16,13,29
11774,SpokaneStBridge,05/06/2015 02:00:00 PM,48,-122,15,26,41
11775,SpokaneStBridge,05/06/2015 03:00:00 PM,48,-122,15,38,53
11776,SpokaneStBridge,05/06/2015 04:00:00 PM,48,-122,19,102,121
11777,SpokaneStBridge,05/06/2015 05:00:00 PM,48,-122,21,189,210
11778,SpokaneStBridge,05/06/2015 06:00:00 PM,48,-122,28,128,156
11779,SpokaneStBridge,05/06/2015 07:00:00 PM,48,-122,19,52,71
11780,SpokaneStBridge,05/06/2015 08:00:00 PM,48,-122,7,22,29
11781,SpokaneStBridge,05/06/2015 09:00:00 PM,48,-122,4,11,15
11782,SpokaneStBridge,05/06/2015 10:00:00 PM,48,-122,4,5,9
11783,SpokaneStBridge,05/06/2015 11:00:00 PM,48,-122,0,3,3
11784,SpokaneStBridge,05/07/2015 12:00:00 AM,48,-122,0,1,1
11785,SpokaneStBridge,05/07/2015 01:00:00 AM,48,-122,0,1,1
11786,SpokaneStBridge,05/07/2015 02:00:00 AM,48,-122,0,0,0
11787,SpokaneStBridge,05/07/2015 03:00:00 AM,48,-122,0,0,0
11788,SpokaneStBridge,05/07/2015 04:00:00 AM,48,-122,4,0,4
11789,SpokaneStBridge,05/07/2015 05:00:00 AM,48,-122,29,2,31
11790,SpokaneStBridge,05/07/2015 06:00:00 AM,48,-122,132,11,143
11791,SpokaneStBridge,05/07/2015 07:00:00 AM,48,-122,154,12,166
11792,SpokaneStBridge,05/07/2015 08:00:00 AM,48,-122,142,21,163
11793,SpokaneStBridge,05/07/2015 09:00:00 AM,48,-122,73,10,83
11794,SpokaneStBridge,05/07/2015 10:00:00 AM,48,-122,14,6,20
11795,SpokaneStBridge,05/07/2015 11:00:00 AM,48,-122,13,13,26
11796,SpokaneStBridge,05/07/2015 12:00:00 PM,48,-122,17,7,24
11797,SpokaneStBridge,05/07/2015 01:00:00 PM,48,-122,17,20,37
11798,SpokaneStBridge,05/07/2015 02:00:00 PM,48,-122,24,27,51
11799,SpokaneStBridge,05/07/2015 03:00:00 PM,48,-122,17,40,57
11800,SpokaneStBridge,05/07/2015 04:00:00 PM,48,-122,24,118,142
11801,SpokaneStBridge,05/07/2015 05:00:00 PM,48,-122,78,182,260
11802,SpokaneStBridge,05/07/2015 06:00:00 PM,48,-122,49,85,134
11803,SpokaneStBridge,05/07/2015 07:00:00 PM,48,-122,21,130,151
11804,SpokaneStBridge,05/07/2015 08:00:00 PM,48,-122,13,25,38
11805,SpokaneStBridge,05/07/2015 09:00:00 PM,48,-122,6,12,18
11806,SpokaneStBridge,05/07/2015 10:00:00 PM,48,-122,9,5,14
11807,SpokaneStBridge,05/07/2015 11:00:00 PM,48,-122,37,5,42
11808,SpokaneStBridge,05/08/2015 12:00:00 AM,48,-122,14,2,16
11809,SpokaneStBridge,05/08/2015 01:00:00 AM,48,-122,11,3,14
11810,SpokaneStBridge,05/08/2015 02:00:00 AM,48,-122,0,0,0
11811,SpokaneStBridge,05/08/2015 03:00:00 AM,48,-122,0,1,1
11812,SpokaneStBridge,05/08/2015 04:00:00 AM,48,-122,1,0,1
11813,SpokaneStBridge,05/08/2015 05:00:00 AM,48,-122,27,3,30
11814,SpokaneStBridge,05/08/2015 06:00:00 AM,48,-122,98,13,111
11815,SpokaneStBridge,05/08/2015 07:00:00 AM,48,-122,172,21,193
11816,SpokaneStBridge,05/08/2015 08:00:00 AM,48,-122,131,21,152
11817,SpokaneStBridge,05/08/2015 09:00:00 AM,48,-122,45,11,56
11818,SpokaneStBridge,05/08/2015 10:00:00 AM,48,-122,24,10,34
11819,SpokaneStBridge,05/08/2015 11:00:00 AM,48,-122,15,12,27
11820,SpokaneStBridge,05/08/2015 12:00:00 PM,48,-122,20,18,38
11821,SpokaneStBridge,05/08/2015 01:00:00 PM,48,-122,11,21,32
11822,SpokaneStBridge,05/08/2015 02:00:00 PM,48,-122,14,28,42
11823,SpokaneStBridge,05/08/2015 03:00:00 PM,48,-122,19,57,76
11824,SpokaneStBridge,05/08/2015 04:00:00 PM,48,-122,30,108,138
11825,SpokaneStBridge,05/08/2015 05:00:00 PM,48,-122,31,179,210
11826,SpokaneStBridge,05/08/2015 06:00:00 PM,48,-122,15,70,85
11827,SpokaneStBridge,05/08/2015 07:00:00 PM,48,-122,11,50,61
11828,SpokaneStBridge,05/08/2015 08:00:00 PM,48,-122,9,23,32
11829,SpokaneStBridge,05/08/2015 09:00:00 PM,48,-122,6,14,20
11830,SpokaneStBridge,05/08/2015 10:00:00 PM,48,-122,4,2,6
11831,SpokaneStBridge,05/08/2015 11:00:00 PM,48,-122,0,3,3
11832,SpokaneStBridge,05/09/2015 12:00:00 AM,48,-122,2,2,4
11833,SpokaneStBridge,05/09/2015 01:00:00 AM,48,-122,1,0,1
11834,SpokaneStBridge,05/09/2015 02:00:00 AM,48,-122,0,1,1
11835,SpokaneStBridge,05/09/2015 03:00:00 AM,48,-122,1,0,1
11836,SpokaneStBridge,05/09/2015 04:00:00 AM,48,-122,1,0,1
11837,SpokaneStBridge,05/09/2015 05:00:00 AM,48,-122,12,2,14
11838,SpokaneStBridge,05/09/2015 06:00:00 AM,48,-122,15,7,22
11839,SpokaneStBridge,05/09/2015 07:00:00 AM,48,-122,31,11,42
11840,SpokaneStBridge,05/09/2015 08:00:00 AM,48,-122,26,21,47
11841,SpokaneStBridge,05/09/2015 09:00:00 AM,48,-122,36,31,67
11842,SpokaneStBridge,05/09/2015 10:00:00 AM,48,-122,30,48,78
11843,SpokaneStBridge,05/09/2015 11:00:00 AM,48,-122,30,37,67
11844,SpokaneStBridge,05/09/2015 12:00:00 PM,48,-122,68,86,154
11845,SpokaneStBridge,05/09/2015 01:00:00 PM,48,-122,49,75,124
11846,SpokaneStBridge,05/09/2015 02:00:00 PM,48,-122,56,56,112
11847,SpokaneStBridge,05/09/2015 03:00:00 PM,48,-122,60,40,100
11848,SpokaneStBridge,05/09/2015 04:00:00 PM,48,-122,60,44,104
11849,SpokaneStBridge,05/09/2015 05:00:00 PM,48,-122,37,26,63
11850,SpokaneStBridge,05/09/2015 06:00:00 PM,48,-122,36,40,76
11851,SpokaneStBridge,05/09/2015 07:00:00 PM,48,-122,15,18,33
11852,SpokaneStBridge,05/09/2015 08:00:00 PM,48,-122,12,11,23
11853,SpokaneStBridge,05/09/2015 09:00:00 PM,48,-122,3,6,9
11854,SpokaneStBridge,05/09/2015 10:00:00 PM,48,-122,1,3,4
11855,SpokaneStBridge,05/09/2015 11:00:00 PM,48,-122,1,3,4
11856,SpokaneStBridge,05/10/2015 12:00:00 AM,48,-122,4,2,6
11857,SpokaneStBridge,05/10/2015 01:00:00 AM,48,-122,1,0,1
11858,SpokaneStBridge,05/10/2015 02:00:00 AM,48,-122,1,3,4
11859,SpokaneStBridge,05/10/2015 03:00:00 AM,48,-122,1,1,2
11860,SpokaneStBridge,05/10/2015 04:00:00 AM,48,-122,1,1,2
11861,SpokaneStBridge,05/10/2015 05:00:00 AM,48,-122,5,0,5
11862,SpokaneStBridge,05/10/2015 06:00:00 AM,48,-122,4,2,6
11863,SpokaneStBridge,05/10/2015 07:00:00 AM,48,-122,21,1,22
11864,SpokaneStBridge,05/10/2015 08:00:00 AM,48,-122,13,6,19
11865,SpokaneStBridge,05/10/2015 09:00:00 AM,48,-122,16,40,56
11866,SpokaneStBridge,05/10/2015 10:00:00 AM,48,-122,45,32,77
11867,SpokaneStBridge,05/10/2015 11:00:00 AM,48,-122,43,47,90
11868,SpokaneStBridge,05/10/2015 12:00:00 PM,48,-122,38,24,62
11869,SpokaneStBridge,05/10/2015 01:00:00 PM,48,-122,29,39,68
11870,SpokaneStBridge,05/10/2015 02:00:00 PM,48,-122,31,41,72
11871,SpokaneStBridge,05/10/2015 03:00:00 PM,48,-122,36,33,69
11872,SpokaneStBridge,05/10/2015 04:00:00 PM,48,-122,31,40,71
11873,SpokaneStBridge,05/10/2015 05:00:00 PM,48,-122,18,19,37
11874,SpokaneStBridge,05/10/2015 06:00:00 PM,48,-122,14,14,28
11875,SpokaneStBridge,05/10/2015 07:00:00 PM,48,-122,7,9,16
11876,SpokaneStBridge,05/10/2015 08:00:00 PM,48,-122,9,6,15
11877,SpokaneStBridge,05/10/2015 09:00:00 PM,48,-122,3,1,4
11878,SpokaneStBridge,05/10/2015 10:00:00 PM,48,-122,4,2,6
11879,SpokaneStBridge,05/10/2015 11:00:00 PM,48,-122,0,0,0
11880,SpokaneStBridge,05/11/2015 12:00:00 AM,48,-122,1,0,1
11881,SpokaneStBridge,05/11/2015 01:00:00 AM,48,-122,0,0,0
11882,SpokaneStBridge,05/11/2015 02:00:00 AM,48,-122,0,1,1
11883,SpokaneStBridge,05/11/2015 03:00:00 AM,48,-122,1,2,3
11884,SpokaneStBridge,05/11/2015 04:00:00 AM,48,-122,6,1,7
11885,SpokaneStBridge,05/11/2015 05:00:00 AM,48,-122,22,2,24
11886,SpokaneStBridge,05/11/2015 06:00:00 AM,48,-122,83,14,97
11887,SpokaneStBridge,05/11/2015 07:00:00 AM,48,-122,138,16,154
11888,SpokaneStBridge,05/11/2015 08:00:00 AM,48,-122,111,21,132
11889,SpokaneStBridge,05/11/2015 09:00:00 AM,48,-122,44,7,51
11890,SpokaneStBridge,05/11/2015 10:00:00 AM,48,-122,16,6,22
11891,SpokaneStBridge,05/11/2015 11:00:00 AM,48,-122,7,7,14
11892,SpokaneStBridge,05/11/2015 12:00:00 PM,48,-122,11,5,16
11893,SpokaneStBridge,05/11/2015 01:00:00 PM,48,-122,8,9,17
11894,SpokaneStBridge,05/11/2015 02:00:00 PM,48,-122,9,17,26
11895,SpokaneStBridge,05/11/2015 03:00:00 PM,48,-122,11,29,40
11896,SpokaneStBridge,05/11/2015 04:00:00 PM,48,-122,18,85,103
11897,SpokaneStBridge,05/11/2015 05:00:00 PM,48,-122,18,164,182
11898,SpokaneStBridge,05/11/2015 06:00:00 PM,48,-122,13,91,104
11899,SpokaneStBridge,05/11/2015 07:00:00 PM,48,-122,8,38,46
11900,SpokaneStBridge,05/11/2015 08:00:00 PM,48,-122,7,16,23
11901,SpokaneStBridge,05/11/2015 09:00:00 PM,48,-122,3,11,14
11902,SpokaneStBridge,05/11/2015 10:00:00 PM,48,-122,2,3,5
11903,SpokaneStBridge,05/11/2015 11:00:00 PM,48,-122,1,1,2
11904,SpokaneStBridge,05/12/2015 12:00:00 AM,48,-122,1,4,5
11905,SpokaneStBridge,05/12/2015 01:00:00 AM,48,-122,0,0,0
11906,SpokaneStBridge,05/12/2015 02:00:00 AM,48,-122,1,0,1
11907,SpokaneStBridge,05/12/2015 03:00:00 AM,48,-122,1,1,2
11908,SpokaneStBridge,05/12/2015 04:00:00 AM,48,-122,5,1,6
11909,SpokaneStBridge,05/12/2015 05:00:00 AM,48,-122,24,3,27
11910,SpokaneStBridge,05/12/2015 06:00:00 AM,48,-122,76,16,92
11911,SpokaneStBridge,05/12/2015 07:00:00 AM,48,-122,140,28,168
11912,SpokaneStBridge,05/12/2015 08:00:00 AM,48,-122,121,13,134
11913,SpokaneStBridge,05/12/2015 09:00:00 AM,48,-122,39,5,44
11914,SpokaneStBridge,05/12/2015 10:00:00 AM,48,-122,12,9,21
11915,SpokaneStBridge,05/12/2015 11:00:00 AM,48,-122,9,6,15
11916,SpokaneStBridge,05/12/2015 12:00:00 PM,48,-122,16,11,27
11917,SpokaneStBridge,05/12/2015 01:00:00 PM,48,-122,5,3,8
11918,SpokaneStBridge,05/12/2015 02:00:00 PM,48,-122,7,21,28
11919,SpokaneStBridge,05/12/2015 03:00:00 PM,48,-122,14,27,41
11920,SpokaneStBridge,05/12/2015 04:00:00 PM,48,-122,22,74,96
11921,SpokaneStBridge,05/12/2015 05:00:00 PM,48,-122,22,140,162
11922,SpokaneStBridge,05/12/2015 06:00:00 PM,48,-122,11,118,129
11923,SpokaneStBridge,05/12/2015 07:00:00 PM,48,-122,11,41,52
11924,SpokaneStBridge,05/12/2015 08:00:00 PM,48,-122,7,20,27
11925,SpokaneStBridge,05/12/2015 09:00:00 PM,48,-122,3,7,10
11926,SpokaneStBridge,05/12/2015 10:00:00 PM,48,-122,2,8,10
11927,SpokaneStBridge,05/12/2015 11:00:00 PM,48,-122,0,1,1
11928,SpokaneStBridge,05/13/2015 12:00:00 AM,48,-122,2,0,2
11929,SpokaneStBridge,05/13/2015 01:00:00 AM,48,-122,0,3,3
11930,SpokaneStBridge,05/13/2015 02:00:00 AM,48,-122,0,0,0
11931,SpokaneStBridge,05/13/2015 03:00:00 AM,48,-122,0,2,2
11932,SpokaneStBridge,05/13/2015 04:00:00 AM,48,-122,4,0,4
11933,SpokaneStBridge,05/13/2015 05:00:00 AM,48,-122,17,3,20
11934,SpokaneStBridge,05/13/2015 06:00:00 AM,48,-122,55,4,59
11935,SpokaneStBridge,05/13/2015 07:00:00 AM,48,-122,112,10,122
11936,SpokaneStBridge,05/13/2015 08:00:00 AM,48,-122,95,7,102
11937,SpokaneStBridge,05/13/2015 09:00:00 AM,48,-122,44,4,48
11938,SpokaneStBridge,05/13/2015 10:00:00 AM,48,-122,15,4,19
11939,SpokaneStBridge,05/13/2015 11:00:00 AM,48,-122,6,9,15
11940,SpokaneStBridge,05/13/2015 12:00:00 PM,48,-122,5,3,8
11941,SpokaneStBridge,05/13/2015 01:00:00 PM,48,-122,4,3,7
11942,SpokaneStBridge,05/13/2015 02:00:00 PM,48,-122,8,15,23
11943,SpokaneStBridge,05/13/2015 03:00:00 PM,48,-122,6,17,23
11944,SpokaneStBridge,05/13/2015 04:00:00 PM,48,-122,17,59,76
11945,SpokaneStBridge,05/13/2015 05:00:00 PM,48,-122,13,116,129
11946,SpokaneStBridge,05/13/2015 06:00:00 PM,48,-122,4,73,77
11947,SpokaneStBridge,05/13/2015 07:00:00 PM,48,-122,3,24,27
11948,SpokaneStBridge,05/13/2015 08:00:00 PM,48,-122,4,12,16
11949,SpokaneStBridge,05/13/2015 09:00:00 PM,48,-122,0,11,11
11950,SpokaneStBridge,05/13/2015 10:00:00 PM,48,-122,2,9,11
11951,SpokaneStBridge,05/13/2015 11:00:00 PM,48,-122,1,4,5
11952,SpokaneStBridge,05/14/2015 12:00:00 AM,48,-122,0,0,0
11953,SpokaneStBridge,05/14/2015 01:00:00 AM,48,-122,0,1,1
11954,SpokaneStBridge,05/14/2015 02:00:00 AM,48,-122,1,0,1
11955,SpokaneStBridge,05/14/2015 03:00:00 AM,48,-122,0,1,1
11956,SpokaneStBridge,05/14/2015 04:00:00 AM,48,-122,4,0,4
11957,SpokaneStBridge,05/14/2015 05:00:00 AM,48,-122,15,3,18
11958,SpokaneStBridge,05/14/2015 06:00:00 AM,48,-122,77,8,85
11959,SpokaneStBridge,05/14/2015 07:00:00 AM,48,-122,138,18,156
11960,SpokaneStBridge,05/14/2015 08:00:00 AM,48,-122,116,9,125
11961,SpokaneStBridge,05/14/2015 09:00:00 AM,48,-122,43,3,46
11962,SpokaneStBridge,05/14/2015 10:00:00 AM,48,-122,21,0,21
11963,SpokaneStBridge,05/14/2015 11:00:00 AM,48,-122,9,5,14
11964,SpokaneStBridge,05/14/2015 12:00:00 PM,48,-122,11,14,25
11965,SpokaneStBridge,05/14/2015 01:00:00 PM,48,-122,20,18,38
11966,SpokaneStBridge,05/14/2015 02:00:00 PM,48,-122,9,23,32
11967,SpokaneStBridge,05/14/2015 03:00:00 PM,48,-122,34,37,71
11968,SpokaneStBridge,05/14/2015 04:00:00 PM,48,-122,29,108,137
11969,SpokaneStBridge,05/14/2015 05:00:00 PM,48,-122,46,144,190
11970,SpokaneStBridge,05/14/2015 06:00:00 PM,48,-122,24,91,115
11971,SpokaneStBridge,05/14/2015 07:00:00 PM,48,-122,15,42,57
11972,SpokaneStBridge,05/14/2015 08:00:00 PM,48,-122,15,38,53
11973,SpokaneStBridge,05/14/2015 09:00:00 PM,48,-122,2,12,14
11974,SpokaneStBridge,05/14/2015 10:00:00 PM,48,-122,4,15,19
11975,SpokaneStBridge,05/14/2015 11:00:00 PM,48,-122,2,4,6
11976,SpokaneStBridge,05/15/2015 12:00:00 AM,48,-122,2,3,5
11977,SpokaneStBridge,05/15/2015 01:00:00 AM,48,-122,0,0,0
11978,SpokaneStBridge,05/15/2015 02:00:00 AM,48,-122,1,1,2
11979,SpokaneStBridge,05/15/2015 03:00:00 AM,48,-122,0,1,1
11980,SpokaneStBridge,05/15/2015 04:00:00 AM,48,-122,3,1,4
11981,SpokaneStBridge,05/15/2015 05:00:00 AM,48,-122,31,2,33
11982,SpokaneStBridge,05/15/2015 06:00:00 AM,48,-122,135,17,152
11983,SpokaneStBridge,05/15/2015 07:00:00 AM,48,-122,198,30,228
11984,SpokaneStBridge,05/15/2015 08:00:00 AM,48,-122,207,30,237
11985,SpokaneStBridge,05/15/2015 09:00:00 AM,48,-122,65,11,76
11986,SpokaneStBridge,05/15/2015 10:00:00 AM,48,-122,21,10,31
11987,SpokaneStBridge,05/15/2015 11:00:00 AM,48,-122,15,13,28
11988,SpokaneStBridge,05/15/2015 12:00:00 PM,48,-122,20,26,46
11989,SpokaneStBridge,05/15/2015 01:00:00 PM,48,-122,36,31,67
11990,SpokaneStBridge,05/15/2015 02:00:00 PM,48,-122,13,30,43
11991,SpokaneStBridge,05/15/2015 03:00:00 PM,48,-122,28,66,94
11992,SpokaneStBridge,05/15/2015 04:00:00 PM,48,-122,39,144,183
11993,SpokaneStBridge,05/15/2015 05:00:00 PM,48,-122,40,190,230
11994,SpokaneStBridge,05/15/2015 06:00:00 PM,48,-122,21,113,134
11995,SpokaneStBridge,05/15/2015 07:00:00 PM,48,-122,5,51,56
11996,SpokaneStBridge,05/15/2015 08:00:00 PM,48,-122,3,25,28
11997,SpokaneStBridge,05/15/2015 09:00:00 PM,48,-122,5,9,14
11998,SpokaneStBridge,05/15/2015 10:00:00 PM,48,-122,2,14,16
11999,SpokaneStBridge,05/15/2015 11:00:00 PM,48,-122,6,5,11
12000,SpokaneStBridge,05/16/2015 12:00:00 AM,48,-122,4,9,13
12001,SpokaneStBridge,05/16/2015 01:00:00 AM,48,-122,0,1,1
12002,SpokaneStBridge,05/16/2015 02:00:00 AM,48,-122,1,0,1
12003,SpokaneStBridge,05/16/2015 03:00:00 AM,48,-122,1,0,1
12004,SpokaneStBridge,05/16/2015 04:00:00 AM,48,-122,0,0,0
12005,SpokaneStBridge,05/16/2015 05:00:00 AM,48,-122,4,1,5
12006,SpokaneStBridge,05/16/2015 06:00:00 AM,48,-122,8,0,8
12007,SpokaneStBridge,05/16/2015 07:00:00 AM,48,-122,24,9,33
12008,SpokaneStBridge,05/16/2015 08:00:00 AM,48,-122,20,38,58
12009,SpokaneStBridge,05/16/2015 09:00:00 AM,48,-122,24,22,46
12010,SpokaneStBridge,05/16/2015 10:00:00 AM,48,-122,31,37,68
12011,SpokaneStBridge,05/16/2015 11:00:00 AM,48,-122,23,31,54
12012,SpokaneStBridge,05/16/2015 12:00:00 PM,48,-122,38,65,103
12013,SpokaneStBridge,05/16/2015 01:00:00 PM,48,-122,30,45,75
12014,SpokaneStBridge,05/16/2015 02:00:00 PM,48,-122,40,40,80
12015,SpokaneStBridge,05/16/2015 03:00:00 PM,48,-122,43,32,75
12016,SpokaneStBridge,05/16/2015 04:00:00 PM,48,-122,61,20,81
12017,SpokaneStBridge,05/16/2015 05:00:00 PM,48,-122,30,15,45
12018,SpokaneStBridge,05/16/2015 06:00:00 PM,48,-122,13,19,32
12019,SpokaneStBridge,05/16/2015 07:00:00 PM,48,-122,8,13,21
12020,SpokaneStBridge,05/16/2015 08:00:00 PM,48,-122,6,8,14
12021,SpokaneStBridge,05/16/2015 09:00:00 PM,48,-122,5,6,11
12022,SpokaneStBridge,05/16/2015 10:00:00 PM,48,-122,1,7,8
12023,SpokaneStBridge,05/16/2015 11:00:00 PM,48,-122,2,2,4
12024,SpokaneStBridge,05/17/2015 12:00:00 AM,48,-122,0,4,4
12025,SpokaneStBridge,05/17/2015 01:00:00 AM,48,-122,0,1,1
12026,SpokaneStBridge,05/17/2015 02:00:00 AM,48,-122,0,1,1
12027,SpokaneStBridge,05/17/2015 03:00:00 AM,48,-122,1,0,1
12028,SpokaneStBridge,05/17/2015 04:00:00 AM,48,-122,1,1,2
12029,SpokaneStBridge,05/17/2015 05:00:00 AM,48,-122,5,0,5
12030,SpokaneStBridge,05/17/2015 06:00:00 AM,48,-122,7,3,10
12031,SpokaneStBridge,05/17/2015 07:00:00 AM,48,-122,18,6,24
12032,SpokaneStBridge,05/17/2015 08:00:00 AM,48,-122,16,18,34
12033,SpokaneStBridge,05/17/2015 09:00:00 AM,48,-122,26,31,57
12034,SpokaneStBridge,05/17/2015 10:00:00 AM,48,-122,26,34,60
12035,SpokaneStBridge,05/17/2015 11:00:00 AM,48,-122,41,31,72
12036,SpokaneStBridge,05/17/2015 12:00:00 PM,48,-122,44,37,81
12037,SpokaneStBridge,05/17/2015 01:00:00 PM,48,-122,23,51,74
12038,SpokaneStBridge,05/17/2015 02:00:00 PM,48,-122,37,35,72
12039,SpokaneStBridge,05/17/2015 03:00:00 PM,48,-122,31,41,72
12040,SpokaneStBridge,05/17/2015 04:00:00 PM,48,-122,40,38,78
12041,SpokaneStBridge,05/17/2015 05:00:00 PM,48,-122,21,32,53
12042,SpokaneStBridge,05/17/2015 06:00:00 PM,48,-122,21,27,48
12043,SpokaneStBridge,05/17/2015 07:00:00 PM,48,-122,22,18,40
12044,SpokaneStBridge,05/17/2015 08:00:00 PM,48,-122,13,15,28
12045,SpokaneStBridge,05/17/2015 09:00:00 PM,48,-122,2,6,8
12046,SpokaneStBridge,05/17/2015 10:00:00 PM,48,-122,7,2,9
12047,SpokaneStBridge,05/17/2015 11:00:00 PM,48,-122,3,1,4
12048,SpokaneStBridge,05/18/2015 12:00:00 AM,48,-122,0,1,1
12049,SpokaneStBridge,05/18/2015 01:00:00 AM,48,-122,0,0,0
12050,SpokaneStBridge,05/18/2015 02:00:00 AM,48,-122,0,0,0
12051,SpokaneStBridge,05/18/2015 03:00:00 AM,48,-122,2,2,4
12052,SpokaneStBridge,05/18/2015 04:00:00 AM,48,-122,7,0,7
12053,SpokaneStBridge,05/18/2015 05:00:00 AM,48,-122,24,7,31
12054,SpokaneStBridge,05/18/2015 06:00:00 AM,48,-122,118,26,144
12055,SpokaneStBridge,05/18/2015 07:00:00 AM,48,-122,163,36,199
12056,SpokaneStBridge,05/18/2015 08:00:00 AM,48,-122,177,27,204
12057,SpokaneStBridge,05/18/2015 09:00:00 AM,48,-122,73,21,94
12058,SpokaneStBridge,05/18/2015 10:00:00 AM,48,-122,32,18,50
12059,SpokaneStBridge,05/18/2015 11:00:00 AM,48,-122,26,16,42
12060,SpokaneStBridge,05/18/2015 12:00:00 PM,48,-122,23,39,62
12061,SpokaneStBridge,05/18/2015 01:00:00 PM,48,-122,24,19,43
12062,SpokaneStBridge,05/18/2015 02:00:00 PM,48,-122,27,42,69
12063,SpokaneStBridge,05/18/2015 03:00:00 PM,48,-122,17,63,80
12064,SpokaneStBridge,05/18/2015 04:00:00 PM,48,-122,32,118,150
12065,SpokaneStBridge,05/18/2015 05:00:00 PM,48,-122,33,214,247
12066,SpokaneStBridge,05/18/2015 06:00:00 PM,48,-122,18,137,155
12067,SpokaneStBridge,05/18/2015 07:00:00 PM,48,-122,20,45,65
12068,SpokaneStBridge,05/18/2015 08:00:00 PM,48,-122,19,19,38
12069,SpokaneStBridge,05/18/2015 09:00:00 PM,48,-122,4,9,13
12070,SpokaneStBridge,05/18/2015 10:00:00 PM,48,-122,4,9,13
12071,SpokaneStBridge,05/18/2015 11:00:00 PM,48,-122,2,2,4
12072,SpokaneStBridge,05/19/2015 12:00:00 AM,48,-122,2,5,7
12073,SpokaneStBridge,05/19/2015 01:00:00 AM,48,-122,0,3,3
12074,SpokaneStBridge,05/19/2015 02:00:00 AM,48,-122,0,0,0
12075,SpokaneStBridge,05/19/2015 03:00:00 AM,48,-122,1,3,4
12076,SpokaneStBridge,05/19/2015 04:00:00 AM,48,-122,4,0,4
12077,SpokaneStBridge,05/19/2015 05:00:00 AM,48,-122,24,6,30
12078,SpokaneStBridge,05/19/2015 06:00:00 AM,48,-122,112,16,128
12079,SpokaneStBridge,05/19/2015 07:00:00 AM,48,-122,186,19,205
12080,SpokaneStBridge,05/19/2015 08:00:00 AM,48,-122,151,24,175
12081,SpokaneStBridge,05/19/2015 09:00:00 AM,48,-122,50,8,58
12082,SpokaneStBridge,05/19/2015 10:00:00 AM,48,-122,25,10,35
12083,SpokaneStBridge,05/19/2015 11:00:00 AM,48,-122,21,8,29
12084,SpokaneStBridge,05/19/2015 12:00:00 PM,48,-122,19,19,38
12085,SpokaneStBridge,05/19/2015 01:00:00 PM,48,-122,15,13,28
12086,SpokaneStBridge,05/19/2015 02:00:00 PM,48,-122,15,22,37
12087,SpokaneStBridge,05/19/2015 03:00:00 PM,48,-122,18,42,60
12088,SpokaneStBridge,05/19/2015 04:00:00 PM,48,-122,24,113,137
12089,SpokaneStBridge,05/19/2015 05:00:00 PM,48,-122,36,224,260
12090,SpokaneStBridge,05/19/2015 06:00:00 PM,48,-122,21,129,150
12091,SpokaneStBridge,05/19/2015 07:00:00 PM,48,-122,28,54,82
12092,SpokaneStBridge,05/19/2015 08:00:00 PM,48,-122,12,26,38
12093,SpokaneStBridge,05/19/2015 09:00:00 PM,48,-122,3,8,11
12094,SpokaneStBridge,05/19/2015 10:00:00 PM,48,-122,1,10,11
12095,SpokaneStBridge,05/19/2015 11:00:00 PM,48,-122,2,4,6
12096,SpokaneStBridge,05/20/2015 12:00:00 AM,48,-122,0,1,1
12097,SpokaneStBridge,05/20/2015 01:00:00 AM,48,-122,1,1,2
12098,SpokaneStBridge,05/20/2015 02:00:00 AM,48,-122,1,0,1
12099,SpokaneStBridge,05/20/2015 03:00:00 AM,48,-122,2,2,4
12100,SpokaneStBridge,05/20/2015 04:00:00 AM,48,-122,5,2,7
12101,SpokaneStBridge,05/20/2015 05:00:00 AM,48,-122,28,4,32
12102,SpokaneStBridge,05/20/2015 06:00:00 AM,48,-122,103,20,123
12103,SpokaneStBridge,05/20/2015 07:00:00 AM,48,-122,147,20,167
12104,SpokaneStBridge,05/20/2015 08:00:00 AM,48,-122,155,23,178
12105,SpokaneStBridge,05/20/2015 09:00:00 AM,48,-122,49,7,56
12106,SpokaneStBridge,05/20/2015 10:00:00 AM,48,-122,9,14,23
12107,SpokaneStBridge,05/20/2015 11:00:00 AM,48,-122,9,8,17
12108,SpokaneStBridge,05/20/2015 12:00:00 PM,48,-122,12,11,23
12109,SpokaneStBridge,05/20/2015 01:00:00 PM,48,-122,13,10,23
12110,SpokaneStBridge,05/20/2015 02:00:00 PM,48,-122,21,26,47
12111,SpokaneStBridge,05/20/2015 03:00:00 PM,48,-122,12,45,57
12112,SpokaneStBridge,05/20/2015 04:00:00 PM,48,-122,28,117,145
12113,SpokaneStBridge,05/20/2015 05:00:00 PM,48,-122,37,197,234
12114,SpokaneStBridge,05/20/2015 06:00:00 PM,48,-122,33,132,165
12115,SpokaneStBridge,05/20/2015 07:00:00 PM,48,-122,23,49,72
12116,SpokaneStBridge,05/20/2015 08:00:00 PM,48,-122,12,29,41
12117,SpokaneStBridge,05/20/2015 09:00:00 PM,48,-122,3,17,20
12118,SpokaneStBridge,05/20/2015 10:00:00 PM,48,-122,2,3,5
12119,SpokaneStBridge,05/20/2015 11:00:00 PM,48,-122,1,2,3
12120,SpokaneStBridge,05/21/2015 12:00:00 AM,48,-122,1,4,5
12121,SpokaneStBridge,05/21/2015 01:00:00 AM,48,-122,0,0,0
12122,SpokaneStBridge,05/21/2015 02:00:00 AM,48,-122,0,0,0
12123,SpokaneStBridge,05/21/2015 03:00:00 AM,48,-122,1,2,3
12124,SpokaneStBridge,05/21/2015 04:00:00 AM,48,-122,8,2,10
12125,SpokaneStBridge,05/21/2015 05:00:00 AM,48,-122,26,2,28
12126,SpokaneStBridge,05/21/2015 06:00:00 AM,48,-122,94,20,114
12127,SpokaneStBridge,05/21/2015 07:00:00 AM,48,-122,186,17,203
12128,SpokaneStBridge,05/21/2015 08:00:00 AM,48,-122,169,13,182
12129,SpokaneStBridge,05/21/2015 09:00:00 AM,48,-122,53,12,65
12130,SpokaneStBridge,05/21/2015 10:00:00 AM,48,-122,17,11,28
12131,SpokaneStBridge,05/21/2015 11:00:00 AM,48,-122,13,11,24
12132,SpokaneStBridge,05/21/2015 12:00:00 PM,48,-122,16,13,29
12133,SpokaneStBridge,05/21/2015 01:00:00 PM,48,-122,11,17,28
12134,SpokaneStBridge,05/21/2015 02:00:00 PM,48,-122,18,29,47
12135,SpokaneStBridge,05/21/2015 03:00:00 PM,48,-122,23,44,67
12136,SpokaneStBridge,05/21/2015 04:00:00 PM,48,-122,34,128,162
12137,SpokaneStBridge,05/21/2015 05:00:00 PM,48,-122,44,200,244
12138,SpokaneStBridge,05/21/2015 06:00:00 PM,48,-122,15,116,131
12139,SpokaneStBridge,05/21/2015 07:00:00 PM,48,-122,13,49,62
12140,SpokaneStBridge,05/21/2015 08:00:00 PM,48,-122,9,21,30
12141,SpokaneStBridge,05/21/2015 09:00:00 PM,48,-122,9,16,25
12142,SpokaneStBridge,05/21/2015 10:00:00 PM,48,-122,5,6,11
12143,SpokaneStBridge,05/21/2015 11:00:00 PM,48,-122,3,5,8
12144,SpokaneStBridge,05/22/2015 12:00:00 AM,48,-122,1,5,6
12145,SpokaneStBridge,05/22/2015 01:00:00 AM,48,-122,1,1,2
12146,SpokaneStBridge,05/22/2015 02:00:00 AM,48,-122,1,1,2
12147,SpokaneStBridge,05/22/2015 03:00:00 AM,48,-122,1,0,1
12148,SpokaneStBridge,05/22/2015 04:00:00 AM,48,-122,3,2,5
12149,SpokaneStBridge,05/22/2015 05:00:00 AM,48,-122,24,1,25
12150,SpokaneStBridge,05/22/2015 06:00:00 AM,48,-122,69,15,84
12151,SpokaneStBridge,05/22/2015 07:00:00 AM,48,-122,119,22,141
12152,SpokaneStBridge,05/22/2015 08:00:00 AM,48,-122,124,17,141
12153,SpokaneStBridge,05/22/2015 09:00:00 AM,48,-122,51,8,59
12154,SpokaneStBridge,05/22/2015 10:00:00 AM,48,-122,15,5,20
12155,SpokaneStBridge,05/22/2015 11:00:00 AM,48,-122,12,31,43
12156,SpokaneStBridge,05/22/2015 12:00:00 PM,48,-122,20,18,38
12157,SpokaneStBridge,05/22/2015 01:00:00 PM,48,-122,17,23,40
12158,SpokaneStBridge,05/22/2015 02:00:00 PM,48,-122,12,33,45
12159,SpokaneStBridge,05/22/2015 03:00:00 PM,48,-122,11,55,66
12160,SpokaneStBridge,05/22/2015 04:00:00 PM,48,-122,20,92,112
12161,SpokaneStBridge,05/22/2015 05:00:00 PM,48,-122,21,119,140
12162,SpokaneStBridge,05/22/2015 06:00:00 PM,48,-122,16,66,82
12163,SpokaneStBridge,05/22/2015 07:00:00 PM,48,-122,3,37,40
12164,SpokaneStBridge,05/22/2015 08:00:00 PM,48,-122,8,15,23
12165,SpokaneStBridge,05/22/2015 09:00:00 PM,48,-122,2,9,11
12166,SpokaneStBridge,05/22/2015 10:00:00 PM,48,-122,2,6,8
12167,SpokaneStBridge,05/22/2015 11:00:00 PM,48,-122,0,4,4
12168,SpokaneStBridge,05/23/2015 12:00:00 AM,48,-122,2,1,3
12169,SpokaneStBridge,05/23/2015 01:00:00 AM,48,-122,1,0,1
12170,SpokaneStBridge,05/23/2015 02:00:00 AM,48,-122,0,2,2
12171,SpokaneStBridge,05/23/2015 03:00:00 AM,48,-122,1,0,1
12172,SpokaneStBridge,05/23/2015 04:00:00 AM,48,-122,2,0,2
12173,SpokaneStBridge,05/23/2015 05:00:00 AM,48,-122,7,1,8
12174,SpokaneStBridge,05/23/2015 06:00:00 AM,48,-122,10,6,16
12175,SpokaneStBridge,05/23/2015 07:00:00 AM,48,-122,14,12,26
12176,SpokaneStBridge,05/23/2015 08:00:00 AM,48,-122,8,11,19
12177,SpokaneStBridge,05/23/2015 09:00:00 AM,48,-122,18,16,34
12178,SpokaneStBridge,05/23/2015 10:00:00 AM,48,-122,15,13,28
12179,SpokaneStBridge,05/23/2015 11:00:00 AM,48,-122,17,17,34
12180,SpokaneStBridge,05/23/2015 12:00:00 PM,48,-122,25,18,43
12181,SpokaneStBridge,05/23/2015 01:00:00 PM,48,-122,18,22,40
12182,SpokaneStBridge,05/23/2015 02:00:00 PM,48,-122,21,32,53
12183,SpokaneStBridge,05/23/2015 03:00:00 PM,48,-122,22,10,32
12184,SpokaneStBridge,05/23/2015 04:00:00 PM,48,-122,12,20,32
12185,SpokaneStBridge,05/23/2015 05:00:00 PM,48,-122,23,12,35
12186,SpokaneStBridge,05/23/2015 06:00:00 PM,48,-122,11,16,27
12187,SpokaneStBridge,05/23/2015 07:00:00 PM,48,-122,7,9,16
12188,SpokaneStBridge,05/23/2015 08:00:00 PM,48,-122,4,8,12
12189,SpokaneStBridge,05/23/2015 09:00:00 PM,48,-122,2,13,15
12190,SpokaneStBridge,05/23/2015 10:00:00 PM,48,-122,0,1,1
12191,SpokaneStBridge,05/23/2015 11:00:00 PM,48,-122,2,4,6
12192,SpokaneStBridge,05/24/2015 12:00:00 AM,48,-122,2,4,6
12193,SpokaneStBridge,05/24/2015 01:00:00 AM,48,-122,0,4,4
12194,SpokaneStBridge,05/24/2015 02:00:00 AM,48,-122,0,1,1
12195,SpokaneStBridge,05/24/2015 03:00:00 AM,48,-122,1,0,1
12196,SpokaneStBridge,05/24/2015 04:00:00 AM,48,-122,0,4,4
12197,SpokaneStBridge,05/24/2015 05:00:00 AM,48,-122,7,0,7
12198,SpokaneStBridge,05/24/2015 06:00:00 AM,48,-122,4,2,6
12199,SpokaneStBridge,05/24/2015 07:00:00 AM,48,-122,12,2,14
12200,SpokaneStBridge,05/24/2015 08:00:00 AM,48,-122,13,14,27
12201,SpokaneStBridge,05/24/2015 09:00:00 AM,48,-122,14,31,45
12202,SpokaneStBridge,05/24/2015 10:00:00 AM,48,-122,23,19,42
12203,SpokaneStBridge,05/24/2015 11:00:00 AM,48,-122,29,32,61
12204,SpokaneStBridge,05/24/2015 12:00:00 PM,48,-122,30,12,42
12205,SpokaneStBridge,05/24/2015 01:00:00 PM,48,-122,24,27,51
12206,SpokaneStBridge,05/24/2015 02:00:00 PM,48,-122,34,26,60
12207,SpokaneStBridge,05/24/2015 03:00:00 PM,48,-122,31,25,56
12208,SpokaneStBridge,05/24/2015 04:00:00 PM,48,-122,24,29,53
12209,SpokaneStBridge,05/24/2015 05:00:00 PM,48,-122,13,33,46
12210,SpokaneStBridge,05/24/2015 06:00:00 PM,48,-122,10,12,22
12211,SpokaneStBridge,05/24/2015 07:00:00 PM,48,-122,11,11,22
12212,SpokaneStBridge,05/24/2015 08:00:00 PM,48,-122,9,8,17
12213,SpokaneStBridge,05/24/2015 09:00:00 PM,48,-122,7,3,10
12214,SpokaneStBridge,05/24/2015 10:00:00 PM,48,-122,1,5,6
12215,SpokaneStBridge,05/24/2015 11:00:00 PM,48,-122,0,6,6
12216,SpokaneStBridge,05/25/2015 12:00:00 AM,48,-122,0,2,2
12217,SpokaneStBridge,05/25/2015 01:00:00 AM,48,-122,0,3,3
12218,SpokaneStBridge,05/25/2015 02:00:00 AM,48,-122,0,1,1
12219,SpokaneStBridge,05/25/2015 03:00:00 AM,48,-122,0,3,3
12220,SpokaneStBridge,05/25/2015 04:00:00 AM,48,-122,1,1,2
12221,SpokaneStBridge,05/25/2015 05:00:00 AM,48,-122,5,1,6
12222,SpokaneStBridge,05/25/2015 06:00:00 AM,48,-122,8,0,8
12223,SpokaneStBridge,05/25/2015 07:00:00 AM,48,-122,15,5,20
12224,SpokaneStBridge,05/25/2015 08:00:00 AM,48,-122,10,11,21
12225,SpokaneStBridge,05/25/2015 09:00:00 AM,48,-122,21,15,36
12226,SpokaneStBridge,05/25/2015 10:00:00 AM,48,-122,26,36,62
12227,SpokaneStBridge,05/25/2015 11:00:00 AM,48,-122,26,45,71
12228,SpokaneStBridge,05/25/2015 12:00:00 PM,48,-122,43,26,69
12229,SpokaneStBridge,05/25/2015 01:00:00 PM,48,-122,41,24,65
12230,SpokaneStBridge,05/25/2015 02:00:00 PM,48,-122,37,23,60
12231,SpokaneStBridge,05/25/2015 03:00:00 PM,48,-122,30,21,51
12232,SpokaneStBridge,05/25/2015 04:00:00 PM,48,-122,27,26,53
12233,SpokaneStBridge,05/25/2015 05:00:00 PM,48,-122,19,18,37
12234,SpokaneStBridge,05/25/2015 06:00:00 PM,48,-122,11,25,36
12235,SpokaneStBridge,05/25/2015 07:00:00 PM,48,-122,10,9,19
12236,SpokaneStBridge,05/25/2015 08:00:00 PM,48,-122,7,6,13
12237,SpokaneStBridge,05/25/2015 09:00:00 PM,48,-122,1,9,10
12238,SpokaneStBridge,05/25/2015 10:00:00 PM,48,-122,3,1,4
12239,SpokaneStBridge,05/25/2015 11:00:00 PM,48,-122,0,10,10
12240,SpokaneStBridge,05/26/2015 12:00:00 AM,48,-122,2,3,5
12241,SpokaneStBridge,05/26/2015 01:00:00 AM,48,-122,1,0,1
12242,SpokaneStBridge,05/26/2015 02:00:00 AM,48,-122,0,0,0
12243,SpokaneStBridge,05/26/2015 03:00:00 AM,48,-122,2,0,2
12244,SpokaneStBridge,05/26/2015 04:00:00 AM,48,-122,6,0,6
12245,SpokaneStBridge,05/26/2015 05:00:00 AM,48,-122,21,2,23
12246,SpokaneStBridge,05/26/2015 06:00:00 AM,48,-122,96,14,110
12247,SpokaneStBridge,05/26/2015 07:00:00 AM,48,-122,153,12,165
12248,SpokaneStBridge,05/26/2015 08:00:00 AM,48,-122,151,20,171
12249,SpokaneStBridge,05/26/2015 09:00:00 AM,48,-122,50,11,61
12250,SpokaneStBridge,05/26/2015 10:00:00 AM,48,-122,24,12,36
12251,SpokaneStBridge,05/26/2015 11:00:00 AM,48,-122,9,8,17
12252,SpokaneStBridge,05/26/2015 12:00:00 PM,48,-122,19,14,33
12253,SpokaneStBridge,05/26/2015 01:00:00 PM,48,-122,9,9,18
12254,SpokaneStBridge,05/26/2015 02:00:00 PM,48,-122,21,24,45
12255,SpokaneStBridge,05/26/2015 03:00:00 PM,48,-122,20,45,65
12256,SpokaneStBridge,05/26/2015 04:00:00 PM,48,-122,22,108,130
12257,SpokaneStBridge,05/26/2015 05:00:00 PM,48,-122,28,209,237
12258,SpokaneStBridge,05/26/2015 06:00:00 PM,48,-122,26,121,147
12259,SpokaneStBridge,05/26/2015 07:00:00 PM,48,-122,11,42,53
12260,SpokaneStBridge,05/26/2015 08:00:00 PM,48,-122,12,21,33
12261,SpokaneStBridge,05/26/2015 09:00:00 PM,48,-122,3,12,15
12262,SpokaneStBridge,05/26/2015 10:00:00 PM,48,-122,1,6,7
12263,SpokaneStBridge,05/26/2015 11:00:00 PM,48,-122,0,3,3
12264,SpokaneStBridge,05/27/2015 12:00:00 AM,48,-122,0,1,1
12265,SpokaneStBridge,05/27/2015 01:00:00 AM,48,-122,0,1,1
12266,SpokaneStBridge,05/27/2015 02:00:00 AM,48,-122,2,1,3
12267,SpokaneStBridge,05/27/2015 03:00:00 AM,48,-122,2,0,2
12268,SpokaneStBridge,05/27/2015 04:00:00 AM,48,-122,5,1,6
12269,SpokaneStBridge,05/27/2015 05:00:00 AM,48,-122,25,3,28
12270,SpokaneStBridge,05/27/2015 06:00:00 AM,48,-122,104,14,118
12271,SpokaneStBridge,05/27/2015 07:00:00 AM,48,-122,177,28,205
12272,SpokaneStBridge,05/27/2015 08:00:00 AM,48,-122,152,13,165
12273,SpokaneStBridge,05/27/2015 09:00:00 AM,48,-122,46,8,54
12274,SpokaneStBridge,05/27/2015 10:00:00 AM,48,-122,23,16,39
12275,SpokaneStBridge,05/27/2015 11:00:00 AM,48,-122,15,9,24
12276,SpokaneStBridge,05/27/2015 12:00:00 PM,48,-122,5,17,22
12277,SpokaneStBridge,05/27/2015 01:00:00 PM,48,-122,38,14,52
12278,SpokaneStBridge,05/27/2015 02:00:00 PM,48,-122,12,27,39
12279,SpokaneStBridge,05/27/2015 03:00:00 PM,48,-122,19,49,68
12280,SpokaneStBridge,05/27/2015 04:00:00 PM,48,-122,28,124,152
12281,SpokaneStBridge,05/27/2015 05:00:00 PM,48,-122,33,201,234
12282,SpokaneStBridge,05/27/2015 06:00:00 PM,48,-122,21,118,139
12283,SpokaneStBridge,05/27/2015 07:00:00 PM,48,-122,24,48,72
12284,SpokaneStBridge,05/27/2015 08:00:00 PM,48,-122,18,24,42
12285,SpokaneStBridge,05/27/2015 09:00:00 PM,48,-122,8,22,30
12286,SpokaneStBridge,05/27/2015 10:00:00 PM,48,-122,2,9,11
12287,SpokaneStBridge,05/27/2015 11:00:00 PM,48,-122,2,13,15
12288,SpokaneStBridge,05/28/2015 12:00:00 AM,48,-122,1,1,2
12289,SpokaneStBridge,05/28/2015 01:00:00 AM,48,-122,0,0,0
12290,SpokaneStBridge,05/28/2015 02:00:00 AM,48,-122,1,1,2
12291,SpokaneStBridge,05/28/2015 03:00:00 AM,48,-122,3,0,3
12292,SpokaneStBridge,05/28/2015 04:00:00 AM,48,-122,11,3,14
12293,SpokaneStBridge,05/28/2015 05:00:00 AM,48,-122,26,8,34
12294,SpokaneStBridge,05/28/2015 06:00:00 AM,48,-122,95,22,117
12295,SpokaneStBridge,05/28/2015 07:00:00 AM,48,-122,162,21,183
12296,SpokaneStBridge,05/28/2015 08:00:00 AM,48,-122,170,13,183
12297,SpokaneStBridge,05/28/2015 09:00:00 AM,48,-122,69,15,84
12298,SpokaneStBridge,05/28/2015 10:00:00 AM,48,-122,27,11,38
12299,SpokaneStBridge,05/28/2015 11:00:00 AM,48,-122,19,18,37
12300,SpokaneStBridge,05/28/2015 12:00:00 PM,48,-122,15,11,26
12301,SpokaneStBridge,05/28/2015 01:00:00 PM,48,-122,12,24,36
12302,SpokaneStBridge,05/28/2015 02:00:00 PM,48,-122,22,23,45
12303,SpokaneStBridge,05/28/2015 03:00:00 PM,48,-122,24,50,74
12304,SpokaneStBridge,05/28/2015 04:00:00 PM,48,-122,31,128,159
12305,SpokaneStBridge,05/28/2015 05:00:00 PM,48,-122,44,198,242
12306,SpokaneStBridge,05/28/2015 06:00:00 PM,48,-122,35,118,153
12307,SpokaneStBridge,05/28/2015 07:00:00 PM,48,-122,20,60,80
12308,SpokaneStBridge,05/28/2015 08:00:00 PM,48,-122,14,29,43
12309,SpokaneStBridge,05/28/2015 09:00:00 PM,48,-122,10,14,24
12310,SpokaneStBridge,05/28/2015 10:00:00 PM,48,-122,9,10,19
12311,SpokaneStBridge,05/28/2015 11:00:00 PM,48,-122,0,4,4
12312,SpokaneStBridge,05/29/2015 12:00:00 AM,48,-122,1,5,6
12313,SpokaneStBridge,05/29/2015 01:00:00 AM,48,-122,0,2,2
12314,SpokaneStBridge,05/29/2015 02:00:00 AM,48,-122,1,1,2
12315,SpokaneStBridge,05/29/2015 03:00:00 AM,48,-122,2,1,3
12316,SpokaneStBridge,05/29/2015 04:00:00 AM,48,-122,4,2,6
12317,SpokaneStBridge,05/29/2015 05:00:00 AM,48,-122,24,4,28
12318,SpokaneStBridge,05/29/2015 06:00:00 AM,48,-122,105,12,117
12319,SpokaneStBridge,05/29/2015 07:00:00 AM,48,-122,158,23,181
12320,SpokaneStBridge,05/29/2015 08:00:00 AM,48,-122,148,15,163
12321,SpokaneStBridge,05/29/2015 09:00:00 AM,48,-122,63,12,75
12322,SpokaneStBridge,05/29/2015 10:00:00 AM,48,-122,26,23,49
12323,SpokaneStBridge,05/29/2015 11:00:00 AM,48,-122,15,14,29
12324,SpokaneStBridge,05/29/2015 12:00:00 PM,48,-122,17,20,37
12325,SpokaneStBridge,05/29/2015 01:00:00 PM,48,-122,25,18,43
12326,SpokaneStBridge,05/29/2015 02:00:00 PM,48,-122,20,42,62
12327,SpokaneStBridge,05/29/2015 03:00:00 PM,48,-122,22,68,90
12328,SpokaneStBridge,05/29/2015 04:00:00 PM,48,-122,30,116,146
12329,SpokaneStBridge,05/29/2015 05:00:00 PM,48,-122,36,165,201
12330,SpokaneStBridge,05/29/2015 06:00:00 PM,48,-122,36,107,143
12331,SpokaneStBridge,05/29/2015 07:00:00 PM,48,-122,16,45,61
12332,SpokaneStBridge,05/29/2015 08:00:00 PM,48,-122,15,32,47
12333,SpokaneStBridge,05/29/2015 09:00:00 PM,48,-122,3,14,17
12334,SpokaneStBridge,05/29/2015 10:00:00 PM,48,-122,6,12,18
12335,SpokaneStBridge,05/29/2015 11:00:00 PM,48,-122,3,7,10
12336,SpokaneStBridge,05/30/2015 12:00:00 AM,48,-122,4,2,6
12337,SpokaneStBridge,05/30/2015 01:00:00 AM,48,-122,0,2,2
12338,SpokaneStBridge,05/30/2015 02:00:00 AM,48,-122,0,0,0
12339,SpokaneStBridge,05/30/2015 03:00:00 AM,48,-122,3,0,3
12340,SpokaneStBridge,05/30/2015 04:00:00 AM,48,-122,2,1,3
12341,SpokaneStBridge,05/30/2015 05:00:00 AM,48,-122,7,0,7
12342,SpokaneStBridge,05/30/2015 06:00:00 AM,48,-122,13,3,16
12343,SpokaneStBridge,05/30/2015 07:00:00 AM,48,-122,13,9,22
12344,SpokaneStBridge,05/30/2015 08:00:00 AM,48,-122,29,11,40
12345,SpokaneStBridge,05/30/2015 09:00:00 AM,48,-122,18,28,46
12346,SpokaneStBridge,05/30/2015 10:00:00 AM,48,-122,37,25,62
12347,SpokaneStBridge,05/30/2015 11:00:00 AM,48,-122,29,36,65
12348,SpokaneStBridge,05/30/2015 12:00:00 PM,48,-122,27,44,71
12349,SpokaneStBridge,05/30/2015 01:00:00 PM,48,-122,32,37,69
12350,SpokaneStBridge,05/30/2015 02:00:00 PM,48,-122,40,36,76
12351,SpokaneStBridge,05/30/2015 03:00:00 PM,48,-122,56,41,97
12352,SpokaneStBridge,05/30/2015 04:00:00 PM,48,-122,44,32,76
12353,SpokaneStBridge,05/30/2015 05:00:00 PM,48,-122,31,46,77
12354,SpokaneStBridge,05/30/2015 06:00:00 PM,48,-122,28,35,63
12355,SpokaneStBridge,05/30/2015 07:00:00 PM,48,-122,9,12,21
12356,SpokaneStBridge,05/30/2015 08:00:00 PM,48,-122,9,13,22
12357,SpokaneStBridge,05/30/2015 09:00:00 PM,48,-122,13,12,25
12358,SpokaneStBridge,05/30/2015 10:00:00 PM,48,-122,2,5,7
12359,SpokaneStBridge,05/30/2015 11:00:00 PM,48,-122,3,6,9
12360,SpokaneStBridge,05/31/2015 12:00:00 AM,48,-122,1,2,3
12361,SpokaneStBridge,05/31/2015 01:00:00 AM,48,-122,0,7,7
12362,SpokaneStBridge,05/31/2015 02:00:00 AM,48,-122,0,1,1
12363,SpokaneStBridge,05/31/2015 03:00:00 AM,48,-122,1,0,1
12364,SpokaneStBridge,05/31/2015 04:00:00 AM,48,-122,1,2,3
12365,SpokaneStBridge,05/31/2015 05:00:00 AM,48,-122,4,1,5
12366,SpokaneStBridge,05/31/2015 06:00:00 AM,48,-122,5,3,8
12367,SpokaneStBridge,05/31/2015 07:00:00 AM,48,-122,20,8,28
12368,SpokaneStBridge,05/31/2015 08:00:00 AM,48,-122,24,9,33
12369,SpokaneStBridge,05/31/2015 09:00:00 AM,48,-122,26,27,53
12370,SpokaneStBridge,05/31/2015 10:00:00 AM,48,-122,29,54,83
12371,SpokaneStBridge,05/31/2015 11:00:00 AM,48,-122,46,50,96
12372,SpokaneStBridge,05/31/2015 12:00:00 PM,48,-122,42,38,80
12373,SpokaneStBridge,05/31/2015 01:00:00 PM,48,-122,58,35,93
12374,SpokaneStBridge,05/31/2015 02:00:00 PM,48,-122,50,24,74
12375,SpokaneStBridge,05/31/2015 03:00:00 PM,48,-122,51,38,89
12376,SpokaneStBridge,05/31/2015 04:00:00 PM,48,-122,44,52,96
12377,SpokaneStBridge,05/31/2015 05:00:00 PM,48,-122,21,41,62
12378,SpokaneStBridge,05/31/2015 06:00:00 PM,48,-122,14,28,42
12379,SpokaneStBridge,05/31/2015 07:00:00 PM,48,-122,14,13,27
12380,SpokaneStBridge,05/31/2015 08:00:00 PM,48,-122,6,5,11
12381,SpokaneStBridge,05/31/2015 09:00:00 PM,48,-122,2,0,2
12382,SpokaneStBridge,05/31/2015 10:00:00 PM,48,-122,6,3,9
12383,SpokaneStBridge,05/31/2015 11:00:00 PM,48,-122,2,2,4
12384,SpokaneStBridge,06/01/2015 12:00:00 AM,48,-122,0,1,1
12385,SpokaneStBridge,06/01/2015 01:00:00 AM,48,-122,1,0,1
12386,SpokaneStBridge,06/01/2015 02:00:00 AM,48,-122,3,0,3
12387,SpokaneStBridge,06/01/2015 03:00:00 AM,48,-122,1,0,1
12388,SpokaneStBridge,06/01/2015 04:00:00 AM,48,-122,5,0,5
12389,SpokaneStBridge,06/01/2015 05:00:00 AM,48,-122,21,8,29
12390,SpokaneStBridge,06/01/2015 06:00:00 AM,48,-122,64,10,74
12391,SpokaneStBridge,06/01/2015 07:00:00 AM,48,-122,124,20,144
12392,SpokaneStBridge,06/01/2015 08:00:00 AM,48,-122,104,13,117
12393,SpokaneStBridge,06/01/2015 09:00:00 AM,48,-122,32,3,35
12394,SpokaneStBridge,06/01/2015 10:00:00 AM,48,-122,5,6,11
12395,SpokaneStBridge,06/01/2015 11:00:00 AM,48,-122,3,4,7
12396,SpokaneStBridge,06/01/2015 12:00:00 PM,48,-122,5,10,15
12397,SpokaneStBridge,06/01/2015 01:00:00 PM,48,-122,7,11,18
12398,SpokaneStBridge,06/01/2015 02:00:00 PM,48,-122,8,12,20
12399,SpokaneStBridge,06/01/2015 03:00:00 PM,48,-122,11,29,40
12400,SpokaneStBridge,06/01/2015 04:00:00 PM,48,-122,15,68,83
12401,SpokaneStBridge,06/01/2015 05:00:00 PM,48,-122,22,130,152
12402,SpokaneStBridge,06/01/2015 06:00:00 PM,48,-122,9,86,95
12403,SpokaneStBridge,06/01/2015 07:00:00 PM,48,-122,6,26,32
12404,SpokaneStBridge,06/01/2015 08:00:00 PM,48,-122,6,12,18
12405,SpokaneStBridge,06/01/2015 09:00:00 PM,48,-122,2,4,6
12406,SpokaneStBridge,06/01/2015 10:00:00 PM,48,-122,1,3,4
12407,SpokaneStBridge,06/01/2015 11:00:00 PM,48,-122,2,6,8
12408,SpokaneStBridge,06/02/2015 12:00:00 AM,48,-122,2,2,4
12409,SpokaneStBridge,06/02/2015 01:00:00 AM,48,-122,0,0,0
12410,SpokaneStBridge,06/02/2015 02:00:00 AM,48,-122,1,0,1
12411,SpokaneStBridge,06/02/2015 03:00:00 AM,48,-122,2,1,3
12412,SpokaneStBridge,06/02/2015 04:00:00 AM,48,-122,3,1,4
12413,SpokaneStBridge,06/02/2015 05:00:00 AM,48,-122,18,3,21
12414,SpokaneStBridge,06/02/2015 06:00:00 AM,48,-122,71,10,81
12415,SpokaneStBridge,06/02/2015 07:00:00 AM,48,-122,134,13,147
12416,SpokaneStBridge,06/02/2015 08:00:00 AM,48,-122,90,13,103
12417,SpokaneStBridge,06/02/2015 09:00:00 AM,48,-122,38,5,43
12418,SpokaneStBridge,06/02/2015 10:00:00 AM,48,-122,8,6,14
12419,SpokaneStBridge,06/02/2015 11:00:00 AM,48,-122,11,16,27
12420,SpokaneStBridge,06/02/2015 12:00:00 PM,48,-122,9,10,19
12421,SpokaneStBridge,06/02/2015 01:00:00 PM,48,-122,10,11,21
12422,SpokaneStBridge,06/02/2015 02:00:00 PM,48,-122,6,17,23
12423,SpokaneStBridge,06/02/2015 03:00:00 PM,48,-122,20,24,44
12424,SpokaneStBridge,06/02/2015 04:00:00 PM,48,-122,16,77,93
12425,SpokaneStBridge,06/02/2015 05:00:00 PM,48,-122,25,128,153
12426,SpokaneStBridge,06/02/2015 06:00:00 PM,48,-122,14,86,100
12427,SpokaneStBridge,06/02/2015 07:00:00 PM,48,-122,10,40,50
12428,SpokaneStBridge,06/02/2015 08:00:00 PM,48,-122,4,17,21
12429,SpokaneStBridge,06/02/2015 09:00:00 PM,48,-122,5,8,13
12430,SpokaneStBridge,06/02/2015 10:00:00 PM,48,-122,2,2,4
12431,SpokaneStBridge,06/02/2015 11:00:00 PM,48,-122,1,2,3
12432,SpokaneStBridge,06/03/2015 12:00:00 AM,48,-122,0,1,1
12433,SpokaneStBridge,06/03/2015 01:00:00 AM,48,-122,0,1,1
12434,SpokaneStBridge,06/03/2015 02:00:00 AM,48,-122,5,2,7
12435,SpokaneStBridge,06/03/2015 03:00:00 AM,48,-122,1,2,3
12436,SpokaneStBridge,06/03/2015 04:00:00 AM,48,-122,4,0,4
12437,SpokaneStBridge,06/03/2015 05:00:00 AM,48,-122,13,2,15
12438,SpokaneStBridge,06/03/2015 06:00:00 AM,48,-122,82,9,91
12439,SpokaneStBridge,06/03/2015 07:00:00 AM,48,-122,123,20,143
12440,SpokaneStBridge,06/03/2015 08:00:00 AM,48,-122,117,12,129
12441,SpokaneStBridge,06/03/2015 09:00:00 AM,48,-122,44,5,49
12442,SpokaneStBridge,06/03/2015 10:00:00 AM,48,-122,17,9,26
12443,SpokaneStBridge,06/03/2015 11:00:00 AM,48,-122,5,5,10
12444,SpokaneStBridge,06/03/2015 12:00:00 PM,48,-122,7,7,14
12445,SpokaneStBridge,06/03/2015 01:00:00 PM,48,-122,20,15,35
12446,SpokaneStBridge,06/03/2015 02:00:00 PM,48,-122,16,18,34
12447,SpokaneStBridge,06/03/2015 03:00:00 PM,48,-122,17,47,64
12448,SpokaneStBridge,06/03/2015 04:00:00 PM,48,-122,21,85,106
12449,SpokaneStBridge,06/03/2015 05:00:00 PM,48,-122,29,142,171
12450,SpokaneStBridge,06/03/2015 06:00:00 PM,48,-122,19,89,108
12451,SpokaneStBridge,06/03/2015 07:00:00 PM,48,-122,12,43,55
12452,SpokaneStBridge,06/03/2015 08:00:00 PM,48,-122,12,19,31
12453,SpokaneStBridge,06/03/2015 09:00:00 PM,48,-122,6,9,15
12454,SpokaneStBridge,06/03/2015 10:00:00 PM,48,-122,5,6,11
12455,SpokaneStBridge,06/03/2015 11:00:00 PM,48,-122,2,5,7
12456,SpokaneStBridge,06/04/2015 12:00:00 AM,48,-122,0,2,2
12457,SpokaneStBridge,06/04/2015 01:00:00 AM,48,-122,1,2,3
12458,SpokaneStBridge,06/04/2015 02:00:00 AM,48,-122,0,2,2
12459,SpokaneStBridge,06/04/2015 03:00:00 AM,48,-122,2,0,2
12460,SpokaneStBridge,06/04/2015 04:00:00 AM,48,-122,3,1,4
12461,SpokaneStBridge,06/04/2015 05:00:00 AM,48,-122,27,6,33
12462,SpokaneStBridge,06/04/2015 06:00:00 AM,48,-122,94,18,112
12463,SpokaneStBridge,06/04/2015 07:00:00 AM,48,-122,134,19,153
12464,SpokaneStBridge,06/04/2015 08:00:00 AM,48,-122,154,12,166
12465,SpokaneStBridge,06/04/2015 09:00:00 AM,48,-122,57,14,71
12466,SpokaneStBridge,06/04/2015 10:00:00 AM,48,-122,26,9,35
12467,SpokaneStBridge,06/04/2015 11:00:00 AM,48,-122,12,10,22
12468,SpokaneStBridge,06/04/2015 12:00:00 PM,48,-122,16,12,28
12469,SpokaneStBridge,06/04/2015 01:00:00 PM,48,-122,14,8,22
12470,SpokaneStBridge,06/04/2015 02:00:00 PM,48,-122,13,23,36
12471,SpokaneStBridge,06/04/2015 03:00:00 PM,48,-122,11,49,60
12472,SpokaneStBridge,06/04/2015 04:00:00 PM,48,-122,23,100,123
12473,SpokaneStBridge,06/04/2015 05:00:00 PM,48,-122,48,182,230
12474,SpokaneStBridge,06/04/2015 06:00:00 PM,48,-122,32,123,155
12475,SpokaneStBridge,06/04/2015 07:00:00 PM,48,-122,16,53,69
12476,SpokaneStBridge,06/04/2015 08:00:00 PM,48,-122,13,29,42
12477,SpokaneStBridge,06/04/2015 09:00:00 PM,48,-122,14,19,33
12478,SpokaneStBridge,06/04/2015 10:00:00 PM,48,-122,3,10,13
12479,SpokaneStBridge,06/04/2015 11:00:00 PM,48,-122,5,5,10
12480,SpokaneStBridge,06/05/2015 12:00:00 AM,48,-122,2,3,5
12481,SpokaneStBridge,06/05/2015 01:00:00 AM,48,-122,0,6,6
12482,SpokaneStBridge,06/05/2015 02:00:00 AM,48,-122,0,1,1
12483,SpokaneStBridge,06/05/2015 03:00:00 AM,48,-122,2,1,3
12484,SpokaneStBridge,06/05/2015 04:00:00 AM,48,-122,3,2,5
12485,SpokaneStBridge,06/05/2015 05:00:00 AM,48,-122,21,3,24
12486,SpokaneStBridge,06/05/2015 06:00:00 AM,48,-122,76,12,88
12487,SpokaneStBridge,06/05/2015 07:00:00 AM,48,-122,143,15,158
12488,SpokaneStBridge,06/05/2015 08:00:00 AM,48,-122,118,21,139
12489,SpokaneStBridge,06/05/2015 09:00:00 AM,48,-122,57,13,70
12490,SpokaneStBridge,06/05/2015 10:00:00 AM,48,-122,31,12,43
12491,SpokaneStBridge,06/05/2015 11:00:00 AM,48,-122,21,22,43
12492,SpokaneStBridge,06/05/2015 12:00:00 PM,48,-122,14,22,36
12493,SpokaneStBridge,06/05/2015 01:00:00 PM,48,-122,20,28,48
12494,SpokaneStBridge,06/05/2015 02:00:00 PM,48,-122,18,35,53
12495,SpokaneStBridge,06/05/2015 03:00:00 PM,48,-122,26,50,76
12496,SpokaneStBridge,06/05/2015 04:00:00 PM,48,-122,18,97,115
12497,SpokaneStBridge,06/05/2015 05:00:00 PM,48,-122,31,151,182
12498,SpokaneStBridge,06/05/2015 06:00:00 PM,48,-122,15,91,106
12499,SpokaneStBridge,06/05/2015 07:00:00 PM,48,-122,10,53,63
12500,SpokaneStBridge,06/05/2015 08:00:00 PM,48,-122,12,19,31
12501,SpokaneStBridge,06/05/2015 09:00:00 PM,48,-122,8,8,16
12502,SpokaneStBridge,06/05/2015 10:00:00 PM,48,-122,11,9,20
12503,SpokaneStBridge,06/05/2015 11:00:00 PM,48,-122,10,5,15
12504,SpokaneStBridge,06/06/2015 12:00:00 AM,48,-122,37,6,43
12505,SpokaneStBridge,06/06/2015 01:00:00 AM,48,-122,2,3,5
12506,SpokaneStBridge,06/06/2015 02:00:00 AM,48,-122,3,6,9
12507,SpokaneStBridge,06/06/2015 03:00:00 AM,48,-122,1,2,3
12508,SpokaneStBridge,06/06/2015 04:00:00 AM,48,-122,2,6,8
12509,SpokaneStBridge,06/06/2015 05:00:00 AM,48,-122,3,2,5
12510,SpokaneStBridge,06/06/2015 06:00:00 AM,48,-122,13,14,27
12511,SpokaneStBridge,06/06/2015 07:00:00 AM,48,-122,19,11,30
12512,SpokaneStBridge,06/06/2015 08:00:00 AM,48,-122,40,18,58
12513,SpokaneStBridge,06/06/2015 09:00:00 AM,48,-122,31,30,61
12514,SpokaneStBridge,06/06/2015 10:00:00 AM,48,-122,41,31,72
12515,SpokaneStBridge,06/06/2015 11:00:00 AM,48,-122,43,37,80
12516,SpokaneStBridge,06/06/2015 12:00:00 PM,48,-122,37,45,82
12517,SpokaneStBridge,06/06/2015 01:00:00 PM,48,-122,56,46,102
12518,SpokaneStBridge,06/06/2015 02:00:00 PM,48,-122,48,63,111
12519,SpokaneStBridge,06/06/2015 03:00:00 PM,48,-122,48,60,108
12520,SpokaneStBridge,06/06/2015 04:00:00 PM,48,-122,33,30,63
12521,SpokaneStBridge,06/06/2015 05:00:00 PM,48,-122,36,30,66
12522,SpokaneStBridge,06/06/2015 06:00:00 PM,48,-122,28,22,50
12523,SpokaneStBridge,06/06/2015 07:00:00 PM,48,-122,20,21,41
12524,SpokaneStBridge,06/06/2015 08:00:00 PM,48,-122,17,12,29
12525,SpokaneStBridge,06/06/2015 09:00:00 PM,48,-122,6,7,13
12526,SpokaneStBridge,06/06/2015 10:00:00 PM,48,-122,8,3,11
12527,SpokaneStBridge,06/06/2015 11:00:00 PM,48,-122,6,6,12
12528,SpokaneStBridge,06/07/2015 12:00:00 AM,48,-122,0,5,5
12529,SpokaneStBridge,06/07/2015 01:00:00 AM,48,-122,1,1,2
12530,SpokaneStBridge,06/07/2015 02:00:00 AM,48,-122,0,0,0
12531,SpokaneStBridge,06/07/2015 03:00:00 AM,48,-122,2,4,6
12532,SpokaneStBridge,06/07/2015 04:00:00 AM,48,-122,0,2,2
12533,SpokaneStBridge,06/07/2015 05:00:00 AM,48,-122,7,0,7
12534,SpokaneStBridge,06/07/2015 06:00:00 AM,48,-122,7,5,12
12535,SpokaneStBridge,06/07/2015 07:00:00 AM,48,-122,25,14,39
12536,SpokaneStBridge,06/07/2015 08:00:00 AM,48,-122,38,26,64
12537,SpokaneStBridge,06/07/2015 09:00:00 AM,48,-122,43,31,74
12538,SpokaneStBridge,06/07/2015 10:00:00 AM,48,-122,47,57,104
12539,SpokaneStBridge,06/07/2015 11:00:00 AM,48,-122,32,66,98
12540,SpokaneStBridge,06/07/2015 12:00:00 PM,48,-122,63,69,132
12541,SpokaneStBridge,06/07/2015 01:00:00 PM,48,-122,49,37,86
12542,SpokaneStBridge,06/07/2015 02:00:00 PM,48,-122,37,43,80
12543,SpokaneStBridge,06/07/2015 03:00:00 PM,48,-122,43,44,87
12544,SpokaneStBridge,06/07/2015 04:00:00 PM,48,-122,32,41,73
12545,SpokaneStBridge,06/07/2015 05:00:00 PM,48,-122,44,33,77
12546,SpokaneStBridge,06/07/2015 06:00:00 PM,48,-122,25,30,55
12547,SpokaneStBridge,06/07/2015 07:00:00 PM,48,-122,18,18,36
12548,SpokaneStBridge,06/07/2015 08:00:00 PM,48,-122,16,6,22
12549,SpokaneStBridge,06/07/2015 09:00:00 PM,48,-122,7,8,15
12550,SpokaneStBridge,06/07/2015 10:00:00 PM,48,-122,1,5,6
12551,SpokaneStBridge,06/07/2015 11:00:00 PM,48,-122,2,4,6
12552,SpokaneStBridge,06/08/2015 12:00:00 AM,48,-122,1,0,1
12553,SpokaneStBridge,06/08/2015 01:00:00 AM,48,-122,0,1,1
12554,SpokaneStBridge,06/08/2015 02:00:00 AM,48,-122,0,0,0
12555,SpokaneStBridge,06/08/2015 03:00:00 AM,48,-122,1,0,1
12556,SpokaneStBridge,06/08/2015 04:00:00 AM,48,-122,2,12,14
12557,SpokaneStBridge,06/08/2015 05:00:00 AM,48,-122,22,6,28
12558,SpokaneStBridge,06/08/2015 06:00:00 AM,48,-122,80,18,98
12559,SpokaneStBridge,06/08/2015 07:00:00 AM,48,-122,159,27,186
12560,SpokaneStBridge,06/08/2015 08:00:00 AM,48,-122,141,21,162
12561,SpokaneStBridge,06/08/2015 09:00:00 AM,48,-122,69,12,81
12562,SpokaneStBridge,06/08/2015 10:00:00 AM,48,-122,18,6,24
12563,SpokaneStBridge,06/08/2015 11:00:00 AM,48,-122,12,8,20
12564,SpokaneStBridge,06/08/2015 12:00:00 PM,48,-122,19,23,42
12565,SpokaneStBridge,06/08/2015 01:00:00 PM,48,-122,14,24,38
12566,SpokaneStBridge,06/08/2015 02:00:00 PM,48,-122,14,22,36
12567,SpokaneStBridge,06/08/2015 03:00:00 PM,48,-122,17,45,62
12568,SpokaneStBridge,06/08/2015 04:00:00 PM,48,-122,31,119,150
12569,SpokaneStBridge,06/08/2015 05:00:00 PM,48,-122,25,175,200
12570,SpokaneStBridge,06/08/2015 06:00:00 PM,48,-122,43,121,164
12571,SpokaneStBridge,06/08/2015 07:00:00 PM,48,-122,10,44,54
12572,SpokaneStBridge,06/08/2015 08:00:00 PM,48,-122,7,19,26
12573,SpokaneStBridge,06/08/2015 09:00:00 PM,48,-122,12,8,20
12574,SpokaneStBridge,06/08/2015 10:00:00 PM,48,-122,5,7,12
12575,SpokaneStBridge,06/08/2015 11:00:00 PM,48,-122,3,4,7
12576,SpokaneStBridge,06/09/2015 12:00:00 AM,48,-122,2,1,3
12577,SpokaneStBridge,06/09/2015 01:00:00 AM,48,-122,0,3,3
12578,SpokaneStBridge,06/09/2015 02:00:00 AM,48,-122,0,1,1
12579,SpokaneStBridge,06/09/2015 03:00:00 AM,48,-122,2,1,3
12580,SpokaneStBridge,06/09/2015 04:00:00 AM,48,-122,6,2,8
12581,SpokaneStBridge,06/09/2015 05:00:00 AM,48,-122,25,8,33
12582,SpokaneStBridge,06/09/2015 06:00:00 AM,48,-122,105,23,128
12583,SpokaneStBridge,06/09/2015 07:00:00 AM,48,-122,176,26,202
12584,SpokaneStBridge,06/09/2015 08:00:00 AM,48,-122,132,23,155
12585,SpokaneStBridge,06/09/2015 09:00:00 AM,48,-122,65,12,77
12586,SpokaneStBridge,06/09/2015 10:00:00 AM,48,-122,22,10,32
12587,SpokaneStBridge,06/09/2015 11:00:00 AM,48,-122,19,14,33
12588,SpokaneStBridge,06/09/2015 12:00:00 PM,48,-122,16,19,35
12589,SpokaneStBridge,06/09/2015 01:00:00 PM,48,-122,19,14,33
12590,SpokaneStBridge,06/09/2015 02:00:00 PM,48,-122,19,21,40
12591,SpokaneStBridge,06/09/2015 03:00:00 PM,48,-122,21,56,77
12592,SpokaneStBridge,06/09/2015 04:00:00 PM,48,-122,30,113,143
12593,SpokaneStBridge,06/09/2015 05:00:00 PM,48,-122,29,200,229
12594,SpokaneStBridge,06/09/2015 06:00:00 PM,48,-122,28,136,164
12595,SpokaneStBridge,06/09/2015 07:00:00 PM,48,-122,16,44,60
12596,SpokaneStBridge,06/09/2015 08:00:00 PM,48,-122,8,38,46
12597,SpokaneStBridge,06/09/2015 09:00:00 PM,48,-122,14,23,37
12598,SpokaneStBridge,06/09/2015 10:00:00 PM,48,-122,3,5,8
12599,SpokaneStBridge,06/09/2015 11:00:00 PM,48,-122,4,4,8
12600,SpokaneStBridge,06/10/2015 12:00:00 AM,48,-122,2,3,5
12601,SpokaneStBridge,06/10/2015 01:00:00 AM,48,-122,1,0,1
12602,SpokaneStBridge,06/10/2015 02:00:00 AM,48,-122,0,1,1
12603,SpokaneStBridge,06/10/2015 03:00:00 AM,48,-122,0,3,3
12604,SpokaneStBridge,06/10/2015 04:00:00 AM,48,-122,3,0,3
12605,SpokaneStBridge,06/10/2015 05:00:00 AM,48,-122,23,6,29
12606,SpokaneStBridge,06/10/2015 06:00:00 AM,48,-122,102,19,121
12607,SpokaneStBridge,06/10/2015 07:00:00 AM,48,-122,167,26,193
12608,SpokaneStBridge,06/10/2015 08:00:00 AM,48,-122,153,17,170
12609,SpokaneStBridge,06/10/2015 09:00:00 AM,48,-122,52,7,59
12610,SpokaneStBridge,06/10/2015 10:00:00 AM,48,-122,19,8,27
12611,SpokaneStBridge,06/10/2015 11:00:00 AM,48,-122,14,10,24
12612,SpokaneStBridge,06/10/2015 12:00:00 PM,48,-122,17,20,37
12613,SpokaneStBridge,06/10/2015 01:00:00 PM,48,-122,21,18,39
12614,SpokaneStBridge,06/10/2015 02:00:00 PM,48,-122,14,24,38
12615,SpokaneStBridge,06/10/2015 03:00:00 PM,48,-122,24,44,68
12616,SpokaneStBridge,06/10/2015 04:00:00 PM,48,-122,32,127,159
12617,SpokaneStBridge,06/10/2015 05:00:00 PM,48,-122,25,177,202
12618,SpokaneStBridge,06/10/2015 06:00:00 PM,48,-122,30,132,162
12619,SpokaneStBridge,06/10/2015 07:00:00 PM,48,-122,36,58,94
12620,SpokaneStBridge,06/10/2015 08:00:00 PM,48,-122,29,38,67
12621,SpokaneStBridge,06/10/2015 09:00:00 PM,48,-122,13,10,23
12622,SpokaneStBridge,06/10/2015 10:00:00 PM,48,-122,1,6,7
12623,SpokaneStBridge,06/10/2015 11:00:00 PM,48,-122,2,1,3
12624,SpokaneStBridge,06/11/2015 12:00:00 AM,48,-122,2,3,5
12625,SpokaneStBridge,06/11/2015 01:00:00 AM,48,-122,1,0,1
12626,SpokaneStBridge,06/11/2015 02:00:00 AM,48,-122,0,0,0
12627,SpokaneStBridge,06/11/2015 03:00:00 AM,48,-122,2,1,3
12628,SpokaneStBridge,06/11/2015 04:00:00 AM,48,-122,5,3,8
12629,SpokaneStBridge,06/11/2015 05:00:00 AM,48,-122,22,5,27
12630,SpokaneStBridge,06/11/2015 06:00:00 AM,48,-122,89,11,100
12631,SpokaneStBridge,06/11/2015 07:00:00 AM,48,-122,174,24,198
12632,SpokaneStBridge,06/11/2015 08:00:00 AM,48,-122,152,12,164
12633,SpokaneStBridge,06/11/2015 09:00:00 AM,48,-122,64,6,70
12634,SpokaneStBridge,06/11/2015 10:00:00 AM,48,-122,26,11,37
12635,SpokaneStBridge,06/11/2015 11:00:00 AM,48,-122,9,19,28
12636,SpokaneStBridge,06/11/2015 12:00:00 PM,48,-122,23,14,37
12637,SpokaneStBridge,06/11/2015 01:00:00 PM,48,-122,12,21,33
12638,SpokaneStBridge,06/11/2015 02:00:00 PM,48,-122,10,20,30
12639,SpokaneStBridge,06/11/2015 03:00:00 PM,48,-122,19,54,73
12640,SpokaneStBridge,06/11/2015 04:00:00 PM,48,-122,29,112,141
12641,SpokaneStBridge,06/11/2015 05:00:00 PM,48,-122,34,179,213
12642,SpokaneStBridge,06/11/2015 06:00:00 PM,48,-122,29,118,147
12643,SpokaneStBridge,06/11/2015 07:00:00 PM,48,-122,18,58,76
12644,SpokaneStBridge,06/11/2015 08:00:00 PM,48,-122,23,26,49
12645,SpokaneStBridge,06/11/2015 09:00:00 PM,48,-122,5,9,14
12646,SpokaneStBridge,06/11/2015 10:00:00 PM,48,-122,10,12,22
12647,SpokaneStBridge,06/11/2015 11:00:00 PM,48,-122,3,4,7
12648,SpokaneStBridge,06/12/2015 12:00:00 AM,48,-122,0,1,1
12649,SpokaneStBridge,06/12/2015 01:00:00 AM,48,-122,0,6,6
12650,SpokaneStBridge,06/12/2015 02:00:00 AM,48,-122,0,4,4
12651,SpokaneStBridge,06/12/2015 03:00:00 AM,48,-122,3,0,3
12652,SpokaneStBridge,06/12/2015 04:00:00 AM,48,-122,1,0,1
12653,SpokaneStBridge,06/12/2015 05:00:00 AM,48,-122,19,4,23
12654,SpokaneStBridge,06/12/2015 06:00:00 AM,48,-122,62,12,74
12655,SpokaneStBridge,06/12/2015 07:00:00 AM,48,-122,123,15,138
12656,SpokaneStBridge,06/12/2015 08:00:00 AM,48,-122,99,15,114
12657,SpokaneStBridge,06/12/2015 09:00:00 AM,48,-122,55,9,64
12658,SpokaneStBridge,06/12/2015 10:00:00 AM,48,-122,19,6,25
12659,SpokaneStBridge,06/12/2015 11:00:00 AM,48,-122,14,10,24
12660,SpokaneStBridge,06/12/2015 12:00:00 PM,48,-122,11,9,20
12661,SpokaneStBridge,06/12/2015 01:00:00 PM,48,-122,11,17,28
12662,SpokaneStBridge,06/12/2015 02:00:00 PM,48,-122,15,20,35
12663,SpokaneStBridge,06/12/2015 03:00:00 PM,48,-122,18,43,61
12664,SpokaneStBridge,06/12/2015 04:00:00 PM,48,-122,25,92,117
12665,SpokaneStBridge,06/12/2015 05:00:00 PM,48,-122,16,123,139
12666,SpokaneStBridge,06/12/2015 06:00:00 PM,48,-122,12,71,83
12667,SpokaneStBridge,06/12/2015 07:00:00 PM,48,-122,7,31,38
12668,SpokaneStBridge,06/12/2015 08:00:00 PM,48,-122,13,21,34
12669,SpokaneStBridge,06/12/2015 09:00:00 PM,48,-122,7,7,14
12670,SpokaneStBridge,06/12/2015 10:00:00 PM,48,-122,2,7,9
12671,SpokaneStBridge,06/12/2015 11:00:00 PM,48,-122,2,4,6
12672,SpokaneStBridge,06/13/2015 12:00:00 AM,48,-122,0,3,3
12673,SpokaneStBridge,06/13/2015 01:00:00 AM,48,-122,1,1,2
12674,SpokaneStBridge,06/13/2015 02:00:00 AM,48,-122,0,0,0
12675,SpokaneStBridge,06/13/2015 03:00:00 AM,48,-122,2,1,3
12676,SpokaneStBridge,06/13/2015 04:00:00 AM,48,-122,0,0,0
12677,SpokaneStBridge,06/13/2015 05:00:00 AM,48,-122,10,3,13
12678,SpokaneStBridge,06/13/2015 06:00:00 AM,48,-122,13,3,16
12679,SpokaneStBridge,06/13/2015 07:00:00 AM,48,-122,23,21,44
12680,SpokaneStBridge,06/13/2015 08:00:00 AM,48,-122,30,23,53
12681,SpokaneStBridge,06/13/2015 09:00:00 AM,48,-122,30,33,63
12682,SpokaneStBridge,06/13/2015 10:00:00 AM,48,-122,41,40,81
12683,SpokaneStBridge,06/13/2015 11:00:00 AM,48,-122,65,41,106
12684,SpokaneStBridge,06/13/2015 12:00:00 PM,48,-122,39,36,75
12685,SpokaneStBridge,06/13/2015 01:00:00 PM,48,-122,42,47,89
12686,SpokaneStBridge,06/13/2015 02:00:00 PM,48,-122,46,37,83
12687,SpokaneStBridge,06/13/2015 03:00:00 PM,48,-122,33,38,71
12688,SpokaneStBridge,06/13/2015 04:00:00 PM,48,-122,46,33,79
12689,SpokaneStBridge,06/13/2015 05:00:00 PM,48,-122,34,33,67
12690,SpokaneStBridge,06/13/2015 06:00:00 PM,48,-122,31,27,58
12691,SpokaneStBridge,06/13/2015 07:00:00 PM,48,-122,18,19,37
12692,SpokaneStBridge,06/13/2015 08:00:00 PM,48,-122,9,5,14
12693,SpokaneStBridge,06/13/2015 09:00:00 PM,48,-122,7,20,27
12694,SpokaneStBridge,06/13/2015 10:00:00 PM,48,-122,1,2,3
12695,SpokaneStBridge,06/13/2015 11:00:00 PM,48,-122,1,2,3
12696,SpokaneStBridge,06/14/2015 12:00:00 AM,48,-122,0,5,5
12697,SpokaneStBridge,06/14/2015 01:00:00 AM,48,-122,0,4,4
12698,SpokaneStBridge,06/14/2015 02:00:00 AM,48,-122,1,0,1
12699,SpokaneStBridge,06/14/2015 03:00:00 AM,48,-122,2,1,3
12700,SpokaneStBridge,06/14/2015 04:00:00 AM,48,-122,1,0,1
12701,SpokaneStBridge,06/14/2015 05:00:00 AM,48,-122,6,1,7
12702,SpokaneStBridge,06/14/2015 06:00:00 AM,48,-122,8,3,11
12703,SpokaneStBridge,06/14/2015 07:00:00 AM,48,-122,10,1,11
12704,SpokaneStBridge,06/14/2015 08:00:00 AM,48,-122,39,15,54
12705,SpokaneStBridge,06/14/2015 09:00:00 AM,48,-122,33,40,73
12706,SpokaneStBridge,06/14/2015 10:00:00 AM,48,-122,30,53,83
12707,SpokaneStBridge,06/14/2015 11:00:00 AM,48,-122,39,30,69
12708,SpokaneStBridge,06/14/2015 12:00:00 PM,48,-122,58,54,112
12709,SpokaneStBridge,06/14/2015 01:00:00 PM,48,-122,50,52,102
12710,SpokaneStBridge,06/14/2015 02:00:00 PM,48,-122,30,53,83
12711,SpokaneStBridge,06/14/2015 03:00:00 PM,48,-122,29,35,64
12712,SpokaneStBridge,06/14/2015 04:00:00 PM,48,-122,32,34,66
12713,SpokaneStBridge,06/14/2015 05:00:00 PM,48,-122,26,26,52
12714,SpokaneStBridge,06/14/2015 06:00:00 PM,48,-122,17,23,40
12715,SpokaneStBridge,06/14/2015 07:00:00 PM,48,-122,17,22,39
12716,SpokaneStBridge,06/14/2015 08:00:00 PM,48,-122,18,7,25
12717,SpokaneStBridge,06/14/2015 09:00:00 PM,48,-122,4,2,6
12718,SpokaneStBridge,06/14/2015 10:00:00 PM,48,-122,3,6,9
12719,SpokaneStBridge,06/14/2015 11:00:00 PM,48,-122,1,5,6
12720,SpokaneStBridge,06/15/2015 12:00:00 AM,48,-122,0,1,1
12721,SpokaneStBridge,06/15/2015 01:00:00 AM,48,-122,1,0,1
12722,SpokaneStBridge,06/15/2015 02:00:00 AM,48,-122,0,0,0
12723,SpokaneStBridge,06/15/2015 03:00:00 AM,48,-122,1,2,3
12724,SpokaneStBridge,06/15/2015 04:00:00 AM,48,-122,4,1,5
12725,SpokaneStBridge,06/15/2015 05:00:00 AM,48,-122,21,6,27
12726,SpokaneStBridge,06/15/2015 06:00:00 AM,48,-122,80,18,98
12727,SpokaneStBridge,06/15/2015 07:00:00 AM,48,-122,152,26,178
12728,SpokaneStBridge,06/15/2015 08:00:00 AM,48,-122,146,12,158
12729,SpokaneStBridge,06/15/2015 09:00:00 AM,48,-122,59,15,74
12730,SpokaneStBridge,06/15/2015 10:00:00 AM,48,-122,25,3,28
12731,SpokaneStBridge,06/15/2015 11:00:00 AM,48,-122,16,8,24
12732,SpokaneStBridge,06/15/2015 12:00:00 PM,48,-122,19,10,29
12733,SpokaneStBridge,06/15/2015 01:00:00 PM,48,-122,15,10,25
12734,SpokaneStBridge,06/15/2015 02:00:00 PM,48,-122,15,35,50
12735,SpokaneStBridge,06/15/2015 03:00:00 PM,48,-122,21,44,65
12736,SpokaneStBridge,06/15/2015 04:00:00 PM,48,-122,23,103,126
12737,SpokaneStBridge,06/15/2015 05:00:00 PM,48,-122,32,185,217
12738,SpokaneStBridge,06/15/2015 06:00:00 PM,48,-122,13,119,132
12739,SpokaneStBridge,06/15/2015 07:00:00 PM,48,-122,13,51,64
12740,SpokaneStBridge,06/15/2015 08:00:00 PM,48,-122,19,19,38
12741,SpokaneStBridge,06/15/2015 09:00:00 PM,48,-122,7,12,19
12742,SpokaneStBridge,06/15/2015 10:00:00 PM,48,-122,1,6,7
12743,SpokaneStBridge,06/15/2015 11:00:00 PM,48,-122,1,4,5
12744,SpokaneStBridge,06/16/2015 12:00:00 AM,48,-122,2,2,4
12745,SpokaneStBridge,06/16/2015 01:00:00 AM,48,-122,0,1,1
12746,SpokaneStBridge,06/16/2015 02:00:00 AM,48,-122,0,2,2
12747,SpokaneStBridge,06/16/2015 03:00:00 AM,48,-122,0,3,3
12748,SpokaneStBridge,06/16/2015 04:00:00 AM,48,-122,4,0,4
12749,SpokaneStBridge,06/16/2015 05:00:00 AM,48,-122,27,5,32
12750,SpokaneStBridge,06/16/2015 06:00:00 AM,48,-122,84,17,101
12751,SpokaneStBridge,06/16/2015 07:00:00 AM,48,-122,171,22,193
12752,SpokaneStBridge,06/16/2015 08:00:00 AM,48,-122,144,16,160
12753,SpokaneStBridge,06/16/2015 09:00:00 AM,48,-122,42,8,50
12754,SpokaneStBridge,06/16/2015 10:00:00 AM,48,-122,23,11,34
12755,SpokaneStBridge,06/16/2015 11:00:00 AM,48,-122,12,7,19
12756,SpokaneStBridge,06/16/2015 12:00:00 PM,48,-122,11,17,28
12757,SpokaneStBridge,06/16/2015 01:00:00 PM,48,-122,19,15,34
12758,SpokaneStBridge,06/16/2015 02:00:00 PM,48,-122,20,22,42
12759,SpokaneStBridge,06/16/2015 03:00:00 PM,48,-122,16,33,49
12760,SpokaneStBridge,06/16/2015 04:00:00 PM,48,-122,26,102,128
12761,SpokaneStBridge,06/16/2015 05:00:00 PM,48,-122,34,202,236
12762,SpokaneStBridge,06/16/2015 06:00:00 PM,48,-122,31,99,130
12763,SpokaneStBridge,06/16/2015 07:00:00 PM,48,-122,13,45,58
12764,SpokaneStBridge,06/16/2015 08:00:00 PM,48,-122,7,24,31
12765,SpokaneStBridge,06/16/2015 09:00:00 PM,48,-122,7,13,20
12766,SpokaneStBridge,06/16/2015 10:00:00 PM,48,-122,4,9,13
12767,SpokaneStBridge,06/16/2015 11:00:00 PM,48,-122,0,3,3
12768,SpokaneStBridge,06/17/2015 12:00:00 AM,48,-122,0,1,1
12769,SpokaneStBridge,06/17/2015 01:00:00 AM,48,-122,1,1,2
12770,SpokaneStBridge,06/17/2015 02:00:00 AM,48,-122,3,4,7
12771,SpokaneStBridge,06/17/2015 03:00:00 AM,48,-122,1,0,1
12772,SpokaneStBridge,06/17/2015 04:00:00 AM,48,-122,4,1,5
12773,SpokaneStBridge,06/17/2015 05:00:00 AM,48,-122,16,5,21
12774,SpokaneStBridge,06/17/2015 06:00:00 AM,48,-122,71,6,77
12775,SpokaneStBridge,06/17/2015 07:00:00 AM,48,-122,167,16,183
12776,SpokaneStBridge,06/17/2015 08:00:00 AM,48,-122,142,30,172
12777,SpokaneStBridge,06/17/2015 09:00:00 AM,48,-122,47,14,61
12778,SpokaneStBridge,06/17/2015 10:00:00 AM,48,-122,25,13,38
12779,SpokaneStBridge,06/17/2015 11:00:00 AM,48,-122,12,21,33
12780,SpokaneStBridge,06/17/2015 12:00:00 PM,48,-122,25,22,47
12781,SpokaneStBridge,06/17/2015 01:00:00 PM,48,-122,38,11,49
12782,SpokaneStBridge,06/17/2015 02:00:00 PM,48,-122,21,28,49
12783,SpokaneStBridge,06/17/2015 03:00:00 PM,48,-122,25,38,63
12784,SpokaneStBridge,06/17/2015 04:00:00 PM,48,-122,29,87,116
12785,SpokaneStBridge,06/17/2015 05:00:00 PM,48,-122,31,168,199
12786,SpokaneStBridge,06/17/2015 06:00:00 PM,48,-122,35,126,161
12787,SpokaneStBridge,06/17/2015 07:00:00 PM,48,-122,12,43,55
12788,SpokaneStBridge,06/17/2015 08:00:00 PM,48,-122,13,21,34
12789,SpokaneStBridge,06/17/2015 09:00:00 PM,48,-122,9,15,24
12790,SpokaneStBridge,06/17/2015 10:00:00 PM,48,-122,3,7,10
12791,SpokaneStBridge,06/17/2015 11:00:00 PM,48,-122,2,3,5
12792,SpokaneStBridge,06/18/2015 12:00:00 AM,48,-122,0,2,2
12793,SpokaneStBridge,06/18/2015 01:00:00 AM,48,-122,2,1,3
12794,SpokaneStBridge,06/18/2015 02:00:00 AM,48,-122,0,2,2
12795,SpokaneStBridge,06/18/2015 03:00:00 AM,48,-122,2,0,2
12796,SpokaneStBridge,06/18/2015 04:00:00 AM,48,-122,2,1,3
12797,SpokaneStBridge,06/18/2015 05:00:00 AM,48,-122,19,5,24
12798,SpokaneStBridge,06/18/2015 06:00:00 AM,48,-122,81,11,92
12799,SpokaneStBridge,06/18/2015 07:00:00 AM,48,-122,131,15,146
12800,SpokaneStBridge,06/18/2015 08:00:00 AM,48,-122,146,15,161
12801,SpokaneStBridge,06/18/2015 09:00:00 AM,48,-122,56,9,65
12802,SpokaneStBridge,06/18/2015 10:00:00 AM,48,-122,25,19,44
12803,SpokaneStBridge,06/18/2015 11:00:00 AM,48,-122,18,14,32
12804,SpokaneStBridge,06/18/2015 12:00:00 PM,48,-122,22,16,38
12805,SpokaneStBridge,06/18/2015 01:00:00 PM,48,-122,17,17,34
12806,SpokaneStBridge,06/18/2015 02:00:00 PM,48,-122,15,24,39
12807,SpokaneStBridge,06/18/2015 03:00:00 PM,48,-122,19,35,54
12808,SpokaneStBridge,06/18/2015 04:00:00 PM,48,-122,29,84,113
12809,SpokaneStBridge,06/18/2015 05:00:00 PM,48,-122,34,171,205
12810,SpokaneStBridge,06/18/2015 06:00:00 PM,48,-122,34,119,153
12811,SpokaneStBridge,06/18/2015 07:00:00 PM,48,-122,8,46,54
12812,SpokaneStBridge,06/18/2015 08:00:00 PM,48,-122,10,22,32
12813,SpokaneStBridge,06/18/2015 09:00:00 PM,48,-122,5,14,19
12814,SpokaneStBridge,06/18/2015 10:00:00 PM,48,-122,1,12,13
12815,SpokaneStBridge,06/18/2015 11:00:00 PM,48,-122,1,10,11
12816,SpokaneStBridge,06/19/2015 12:00:00 AM,48,-122,1,2,3
12817,SpokaneStBridge,06/19/2015 01:00:00 AM,48,-122,0,0,0
12818,SpokaneStBridge,06/19/2015 02:00:00 AM,48,-122,0,0,0
12819,SpokaneStBridge,06/19/2015 03:00:00 AM,48,-122,1,0,1
12820,SpokaneStBridge,06/19/2015 04:00:00 AM,48,-122,2,1,3
12821,SpokaneStBridge,06/19/2015 05:00:00 AM,48,-122,13,5,18
12822,SpokaneStBridge,06/19/2015 06:00:00 AM,48,-122,47,6,53
12823,SpokaneStBridge,06/19/2015 07:00:00 AM,48,-122,86,11,97
12824,SpokaneStBridge,06/19/2015 08:00:00 AM,48,-122,75,15,90
12825,SpokaneStBridge,06/19/2015 09:00:00 AM,48,-122,43,8,51
12826,SpokaneStBridge,06/19/2015 10:00:00 AM,48,-122,13,7,20
12827,SpokaneStBridge,06/19/2015 11:00:00 AM,48,-122,13,5,18
12828,SpokaneStBridge,06/19/2015 12:00:00 PM,48,-122,5,11,16
12829,SpokaneStBridge,06/19/2015 01:00:00 PM,48,-122,12,11,23
12830,SpokaneStBridge,06/19/2015 02:00:00 PM,48,-122,13,27,40
12831,SpokaneStBridge,06/19/2015 03:00:00 PM,48,-122,25,24,49
12832,SpokaneStBridge,06/19/2015 04:00:00 PM,48,-122,24,67,91
12833,SpokaneStBridge,06/19/2015 05:00:00 PM,48,-122,26,82,108
12834,SpokaneStBridge,06/19/2015 06:00:00 PM,48,-122,16,60,76
12835,SpokaneStBridge,06/19/2015 07:00:00 PM,48,-122,8,25,33
12836,SpokaneStBridge,06/19/2015 08:00:00 PM,48,-122,11,17,28
12837,SpokaneStBridge,06/19/2015 09:00:00 PM,48,-122,9,10,19
12838,SpokaneStBridge,06/19/2015 10:00:00 PM,48,-122,1,12,13
12839,SpokaneStBridge,06/19/2015 11:00:00 PM,48,-122,1,8,9
12840,SpokaneStBridge,06/20/2015 12:00:00 AM,48,-122,2,6,8
12841,SpokaneStBridge,06/20/2015 01:00:00 AM,48,-122,1,2,3
12842,SpokaneStBridge,06/20/2015 02:00:00 AM,48,-122,1,1,2
12843,SpokaneStBridge,06/20/2015 03:00:00 AM,48,-122,1,1,2
12844,SpokaneStBridge,06/20/2015 04:00:00 AM,48,-122,3,1,4
12845,SpokaneStBridge,06/20/2015 05:00:00 AM,48,-122,4,0,4
12846,SpokaneStBridge,06/20/2015 06:00:00 AM,48,-122,13,8,21
12847,SpokaneStBridge,06/20/2015 07:00:00 AM,48,-122,24,8,32
12848,SpokaneStBridge,06/20/2015 08:00:00 AM,48,-122,26,15,41
12849,SpokaneStBridge,06/20/2015 09:00:00 AM,48,-122,30,27,57
12850,SpokaneStBridge,06/20/2015 10:00:00 AM,48,-122,38,23,61
12851,SpokaneStBridge,06/20/2015 11:00:00 AM,48,-122,39,38,77
12852,SpokaneStBridge,06/20/2015 12:00:00 PM,48,-122,47,30,77
12853,SpokaneStBridge,06/20/2015 01:00:00 PM,48,-122,48,39,87
12854,SpokaneStBridge,06/20/2015 02:00:00 PM,48,-122,52,32,84
12855,SpokaneStBridge,06/20/2015 03:00:00 PM,48,-122,26,49,75
12856,SpokaneStBridge,06/20/2015 04:00:00 PM,48,-122,27,24,51
12857,SpokaneStBridge,06/20/2015 05:00:00 PM,48,-122,26,28,54
12858,SpokaneStBridge,06/20/2015 06:00:00 PM,48,-122,14,29,43
12859,SpokaneStBridge,06/20/2015 07:00:00 PM,48,-122,14,37,51
12860,SpokaneStBridge,06/20/2015 08:00:00 PM,48,-122,15,23,38
12861,SpokaneStBridge,06/20/2015 09:00:00 PM,48,-122,7,8,15
12862,SpokaneStBridge,06/20/2015 10:00:00 PM,48,-122,0,6,6
12863,SpokaneStBridge,06/20/2015 11:00:00 PM,48,-122,2,3,5
12864,SpokaneStBridge,06/21/2015 12:00:00 AM,48,-122,2,1,3
12865,SpokaneStBridge,06/21/2015 01:00:00 AM,48,-122,0,4,4
12866,SpokaneStBridge,06/21/2015 02:00:00 AM,48,-122,1,2,3
12867,SpokaneStBridge,06/21/2015 03:00:00 AM,48,-122,1,2,3
12868,SpokaneStBridge,06/21/2015 04:00:00 AM,48,-122,0,1,1
12869,SpokaneStBridge,06/21/2015 05:00:00 AM,48,-122,5,3,8
12870,SpokaneStBridge,06/21/2015 06:00:00 AM,48,-122,7,2,9
12871,SpokaneStBridge,06/21/2015 07:00:00 AM,48,-122,10,3,13
12872,SpokaneStBridge,06/21/2015 08:00:00 AM,48,-122,18,18,36
12873,SpokaneStBridge,06/21/2015 09:00:00 AM,48,-122,26,18,44
12874,SpokaneStBridge,06/21/2015 10:00:00 AM,48,-122,18,24,42
12875,SpokaneStBridge,06/21/2015 11:00:00 AM,48,-122,16,33,49
12876,SpokaneStBridge,06/21/2015 12:00:00 PM,48,-122,43,66,109
12877,SpokaneStBridge,06/21/2015 01:00:00 PM,48,-122,46,37,83
12878,SpokaneStBridge,06/21/2015 02:00:00 PM,48,-122,43,30,73
12879,SpokaneStBridge,06/21/2015 03:00:00 PM,48,-122,33,44,77
12880,SpokaneStBridge,06/21/2015 04:00:00 PM,48,-122,38,37,75
12881,SpokaneStBridge,06/21/2015 05:00:00 PM,48,-122,24,45,69
12882,SpokaneStBridge,06/21/2015 06:00:00 PM,48,-122,16,18,34
12883,SpokaneStBridge,06/21/2015 07:00:00 PM,48,-122,14,13,27
12884,SpokaneStBridge,06/21/2015 08:00:00 PM,48,-122,10,6,16
12885,SpokaneStBridge,06/21/2015 09:00:00 PM,48,-122,7,6,13
12886,SpokaneStBridge,06/21/2015 10:00:00 PM,48,-122,6,4,10
12887,SpokaneStBridge,06/21/2015 11:00:00 PM,48,-122,5,2,7
12888,SpokaneStBridge,06/22/2015 12:00:00 AM,48,-122,1,1,2
12889,SpokaneStBridge,06/22/2015 01:00:00 AM,48,-122,0,1,1
12890,SpokaneStBridge,06/22/2015 02:00:00 AM,48,-122,1,0,1
12891,SpokaneStBridge,06/22/2015 03:00:00 AM,48,-122,1,1,2
12892,SpokaneStBridge,06/22/2015 04:00:00 AM,48,-122,4,0,4
12893,SpokaneStBridge,06/22/2015 05:00:00 AM,48,-122,23,1,24
12894,SpokaneStBridge,06/22/2015 06:00:00 AM,48,-122,71,8,79
12895,SpokaneStBridge,06/22/2015 07:00:00 AM,48,-122,131,17,148
12896,SpokaneStBridge,06/22/2015 08:00:00 AM,48,-122,133,20,153
12897,SpokaneStBridge,06/22/2015 09:00:00 AM,48,-122,51,8,59
12898,SpokaneStBridge,06/22/2015 10:00:00 AM,48,-122,25,1,26
12899,SpokaneStBridge,06/22/2015 11:00:00 AM,48,-122,14,9,23
12900,SpokaneStBridge,06/22/2015 12:00:00 PM,48,-122,14,14,28
12901,SpokaneStBridge,06/22/2015 01:00:00 PM,48,-122,13,9,22
12902,SpokaneStBridge,06/22/2015 02:00:00 PM,48,-122,16,25,41
12903,SpokaneStBridge,06/22/2015 03:00:00 PM,48,-122,16,45,61
12904,SpokaneStBridge,06/22/2015 04:00:00 PM,48,-122,23,99,122
12905,SpokaneStBridge,06/22/2015 05:00:00 PM,48,-122,23,180,203
12906,SpokaneStBridge,06/22/2015 06:00:00 PM,48,-122,25,112,137
12907,SpokaneStBridge,06/22/2015 07:00:00 PM,48,-122,12,44,56
12908,SpokaneStBridge,06/22/2015 08:00:00 PM,48,-122,16,13,29
12909,SpokaneStBridge,06/22/2015 09:00:00 PM,48,-122,4,13,17
12910,SpokaneStBridge,06/22/2015 10:00:00 PM,48,-122,3,8,11
12911,SpokaneStBridge,06/22/2015 11:00:00 PM,48,-122,2,2,4
12912,SpokaneStBridge,06/23/2015 12:00:00 AM,48,-122,2,1,3
12913,SpokaneStBridge,06/23/2015 01:00:00 AM,48,-122,0,0,0
12914,SpokaneStBridge,06/23/2015 02:00:00 AM,48,-122,1,3,4
12915,SpokaneStBridge,06/23/2015 03:00:00 AM,48,-122,1,2,3
12916,SpokaneStBridge,06/23/2015 04:00:00 AM,48,-122,4,2,6
12917,SpokaneStBridge,06/23/2015 05:00:00 AM,48,-122,26,5,31
12918,SpokaneStBridge,06/23/2015 06:00:00 AM,48,-122,93,13,106
12919,SpokaneStBridge,06/23/2015 07:00:00 AM,48,-122,155,16,171
12920,SpokaneStBridge,06/23/2015 08:00:00 AM,48,-122,166,17,183
12921,SpokaneStBridge,06/23/2015 09:00:00 AM,48,-122,44,8,52
12922,SpokaneStBridge,06/23/2015 10:00:00 AM,48,-122,21,10,31
12923,SpokaneStBridge,06/23/2015 11:00:00 AM,48,-122,6,14,20
12924,SpokaneStBridge,06/23/2015 12:00:00 PM,48,-122,11,17,28
12925,SpokaneStBridge,06/23/2015 01:00:00 PM,48,-122,22,18,40
12926,SpokaneStBridge,06/23/2015 02:00:00 PM,48,-122,15,16,31
12927,SpokaneStBridge,06/23/2015 03:00:00 PM,48,-122,25,34,59
12928,SpokaneStBridge,06/23/2015 04:00:00 PM,48,-122,30,109,139
12929,SpokaneStBridge,06/23/2015 05:00:00 PM,48,-122,32,163,195
12930,SpokaneStBridge,06/23/2015 06:00:00 PM,48,-122,29,150,179
12931,SpokaneStBridge,06/23/2015 07:00:00 PM,48,-122,13,38,51
12932,SpokaneStBridge,06/23/2015 08:00:00 PM,48,-122,5,29,34
12933,SpokaneStBridge,06/23/2015 09:00:00 PM,48,-122,8,17,25
12934,SpokaneStBridge,06/23/2015 10:00:00 PM,48,-122,2,20,22
12935,SpokaneStBridge,06/23/2015 11:00:00 PM,48,-122,1,8,9
12936,SpokaneStBridge,06/24/2015 12:00:00 AM,48,-122,0,1,1
12937,SpokaneStBridge,06/24/2015 01:00:00 AM,48,-122,0,0,0
12938,SpokaneStBridge,06/24/2015 02:00:00 AM,48,-122,2,3,5
12939,SpokaneStBridge,06/24/2015 03:00:00 AM,48,-122,2,0,2
12940,SpokaneStBridge,06/24/2015 04:00:00 AM,48,-122,3,2,5
12941,SpokaneStBridge,06/24/2015 05:00:00 AM,48,-122,32,6,38
12942,SpokaneStBridge,06/24/2015 06:00:00 AM,48,-122,86,17,103
12943,SpokaneStBridge,06/24/2015 07:00:00 AM,48,-122,161,13,174
12944,SpokaneStBridge,06/24/2015 08:00:00 AM,48,-122,154,18,172
12945,SpokaneStBridge,06/24/2015 09:00:00 AM,48,-122,43,12,55
12946,SpokaneStBridge,06/24/2015 10:00:00 AM,48,-122,25,14,39
12947,SpokaneStBridge,06/24/2015 11:00:00 AM,48,-122,17,14,31
12948,SpokaneStBridge,06/24/2015 12:00:00 PM,48,-122,22,16,38
12949,SpokaneStBridge,06/24/2015 01:00:00 PM,48,-122,20,11,31
12950,SpokaneStBridge,06/24/2015 02:00:00 PM,48,-122,10,31,41
12951,SpokaneStBridge,06/24/2015 03:00:00 PM,48,-122,14,33,47
12952,SpokaneStBridge,06/24/2015 04:00:00 PM,48,-122,32,108,140
12953,SpokaneStBridge,06/24/2015 05:00:00 PM,48,-122,33,163,196
12954,SpokaneStBridge,06/24/2015 06:00:00 PM,48,-122,30,135,165
12955,SpokaneStBridge,06/24/2015 07:00:00 PM,48,-122,17,61,78
12956,SpokaneStBridge,06/24/2015 08:00:00 PM,48,-122,24,24,48
12957,SpokaneStBridge,06/24/2015 09:00:00 PM,48,-122,5,21,26
12958,SpokaneStBridge,06/24/2015 10:00:00 PM,48,-122,5,17,22
12959,SpokaneStBridge,06/24/2015 11:00:00 PM,48,-122,1,4,5
12960,SpokaneStBridge,06/25/2015 12:00:00 AM,48,-122,2,1,3
12961,SpokaneStBridge,06/25/2015 01:00:00 AM,48,-122,1,0,1
12962,SpokaneStBridge,06/25/2015 02:00:00 AM,48,-122,1,0,1
12963,SpokaneStBridge,06/25/2015 03:00:00 AM,48,-122,2,0,2
12964,SpokaneStBridge,06/25/2015 04:00:00 AM,48,-122,6,2,8
12965,SpokaneStBridge,06/25/2015 05:00:00 AM,48,-122,33,5,38
12966,SpokaneStBridge,06/25/2015 06:00:00 AM,48,-122,89,10,99
12967,SpokaneStBridge,06/25/2015 07:00:00 AM,48,-122,141,22,163
12968,SpokaneStBridge,06/25/2015 08:00:00 AM,48,-122,143,15,158
12969,SpokaneStBridge,06/25/2015 09:00:00 AM,48,-122,50,7,57
12970,SpokaneStBridge,06/25/2015 10:00:00 AM,48,-122,23,12,35
12971,SpokaneStBridge,06/25/2015 11:00:00 AM,48,-122,15,14,29
12972,SpokaneStBridge,06/25/2015 12:00:00 PM,48,-122,26,16,42
12973,SpokaneStBridge,06/25/2015 01:00:00 PM,48,-122,12,14,26
12974,SpokaneStBridge,06/25/2015 02:00:00 PM,48,-122,23,32,55
12975,SpokaneStBridge,06/25/2015 03:00:00 PM,48,-122,17,36,53
12976,SpokaneStBridge,06/25/2015 04:00:00 PM,48,-122,39,100,139
12977,SpokaneStBridge,06/25/2015 05:00:00 PM,48,-122,40,172,212
12978,SpokaneStBridge,06/25/2015 06:00:00 PM,48,-122,34,100,134
12979,SpokaneStBridge,06/25/2015 07:00:00 PM,48,-122,16,57,73
12980,SpokaneStBridge,06/25/2015 08:00:00 PM,48,-122,22,35,57
12981,SpokaneStBridge,06/25/2015 09:00:00 PM,48,-122,10,12,22
12982,SpokaneStBridge,06/25/2015 10:00:00 PM,48,-122,5,8,13
12983,SpokaneStBridge,06/25/2015 11:00:00 PM,48,-122,2,9,11
12984,SpokaneStBridge,06/26/2015 12:00:00 AM,48,-122,3,3,6
12985,SpokaneStBridge,06/26/2015 01:00:00 AM,48,-122,2,0,2
12986,SpokaneStBridge,06/26/2015 02:00:00 AM,48,-122,0,2,2
12987,SpokaneStBridge,06/26/2015 03:00:00 AM,48,-122,1,1,2
12988,SpokaneStBridge,06/26/2015 04:00:00 AM,48,-122,4,1,5
12989,SpokaneStBridge,06/26/2015 05:00:00 AM,48,-122,26,2,28
12990,SpokaneStBridge,06/26/2015 06:00:00 AM,48,-122,60,8,68
12991,SpokaneStBridge,06/26/2015 07:00:00 AM,48,-122,115,26,141
12992,SpokaneStBridge,06/26/2015 08:00:00 AM,48,-122,116,17,133
12993,SpokaneStBridge,06/26/2015 09:00:00 AM,48,-122,45,11,56
12994,SpokaneStBridge,06/26/2015 10:00:00 AM,48,-122,23,5,28
12995,SpokaneStBridge,06/26/2015 11:00:00 AM,48,-122,23,16,39
12996,SpokaneStBridge,06/26/2015 12:00:00 PM,48,-122,15,16,31
12997,SpokaneStBridge,06/26/2015 01:00:00 PM,48,-122,13,12,25
12998,SpokaneStBridge,06/26/2015 02:00:00 PM,48,-122,13,23,36
12999,SpokaneStBridge,06/26/2015 03:00:00 PM,48,-122,19,47,66
13000,SpokaneStBridge,06/26/2015 04:00:00 PM,48,-122,23,89,112
13001,SpokaneStBridge,06/26/2015 05:00:00 PM,48,-122,24,107,131
13002,SpokaneStBridge,06/26/2015 06:00:00 PM,48,-122,12,60,72
13003,SpokaneStBridge,06/26/2015 07:00:00 PM,48,-122,10,44,54
13004,SpokaneStBridge,06/26/2015 08:00:00 PM,48,-122,11,23,34
13005,SpokaneStBridge,06/26/2015 09:00:00 PM,48,-122,15,11,26
13006,SpokaneStBridge,06/26/2015 10:00:00 PM,48,-122,3,12,15
13007,SpokaneStBridge,06/26/2015 11:00:00 PM,48,-122,3,3,6
13008,SpokaneStBridge,06/27/2015 12:00:00 AM,48,-122,2,4,6
13009,SpokaneStBridge,06/27/2015 01:00:00 AM,48,-122,1,3,4
13010,SpokaneStBridge,06/27/2015 02:00:00 AM,48,-122,1,0,1
13011,SpokaneStBridge,06/27/2015 03:00:00 AM,48,-122,1,1,2
13012,SpokaneStBridge,06/27/2015 04:00:00 AM,48,-122,3,1,4
13013,SpokaneStBridge,06/27/2015 05:00:00 AM,48,-122,5,3,8
13014,SpokaneStBridge,06/27/2015 06:00:00 AM,48,-122,22,10,32
13015,SpokaneStBridge,06/27/2015 07:00:00 AM,48,-122,31,12,43
13016,SpokaneStBridge,06/27/2015 08:00:00 AM,48,-122,29,40,69
13017,SpokaneStBridge,06/27/2015 09:00:00 AM,48,-122,29,40,69
13018,SpokaneStBridge,06/27/2015 10:00:00 AM,48,-122,50,55,105
13019,SpokaneStBridge,06/27/2015 11:00:00 AM,48,-122,36,44,80
13020,SpokaneStBridge,06/27/2015 12:00:00 PM,48,-122,34,35,69
13021,SpokaneStBridge,06/27/2015 01:00:00 PM,48,-122,29,29,58
13022,SpokaneStBridge,06/27/2015 02:00:00 PM,48,-122,41,32,73
13023,SpokaneStBridge,06/27/2015 03:00:00 PM,48,-122,47,13,60
13024,SpokaneStBridge,06/27/2015 04:00:00 PM,48,-122,22,18,40
13025,SpokaneStBridge,06/27/2015 05:00:00 PM,48,-122,14,22,36
13026,SpokaneStBridge,06/27/2015 06:00:00 PM,48,-122,12,21,33
13027,SpokaneStBridge,06/27/2015 07:00:00 PM,48,-122,19,15,34
13028,SpokaneStBridge,06/27/2015 08:00:00 PM,48,-122,10,12,22
13029,SpokaneStBridge,06/27/2015 09:00:00 PM,48,-122,6,9,15
13030,SpokaneStBridge,06/27/2015 10:00:00 PM,48,-122,4,4,8
13031,SpokaneStBridge,06/27/2015 11:00:00 PM,48,-122,2,4,6
13032,SpokaneStBridge,06/28/2015 12:00:00 AM,48,-122,3,8,11
13033,SpokaneStBridge,06/28/2015 01:00:00 AM,48,-122,1,2,3
13034,SpokaneStBridge,06/28/2015 02:00:00 AM,48,-122,2,3,5
13035,SpokaneStBridge,06/28/2015 03:00:00 AM,48,-122,1,1,2
13036,SpokaneStBridge,06/28/2015 04:00:00 AM,48,-122,2,2,4
13037,SpokaneStBridge,06/28/2015 05:00:00 AM,48,-122,8,3,11
13038,SpokaneStBridge,06/28/2015 06:00:00 AM,48,-122,9,4,13
13039,SpokaneStBridge,06/28/2015 07:00:00 AM,48,-122,32,13,45
13040,SpokaneStBridge,06/28/2015 08:00:00 AM,48,-122,21,22,43
13041,SpokaneStBridge,06/28/2015 09:00:00 AM,48,-122,20,15,35
13042,SpokaneStBridge,06/28/2015 10:00:00 AM,48,-122,20,33,53
13043,SpokaneStBridge,06/28/2015 11:00:00 AM,48,-122,25,23,48
13044,SpokaneStBridge,06/28/2015 12:00:00 PM,48,-122,38,21,59
13045,SpokaneStBridge,06/28/2015 01:00:00 PM,48,-122,28,29,57
13046,SpokaneStBridge,06/28/2015 02:00:00 PM,48,-122,16,23,39
13047,SpokaneStBridge,06/28/2015 03:00:00 PM,48,-122,30,28,58
13048,SpokaneStBridge,06/28/2015 04:00:00 PM,48,-122,20,23,43
13049,SpokaneStBridge,06/28/2015 05:00:00 PM,48,-122,13,21,34
13050,SpokaneStBridge,06/28/2015 06:00:00 PM,48,-122,15,15,30
13051,SpokaneStBridge,06/28/2015 07:00:00 PM,48,-122,6,19,25
13052,SpokaneStBridge,06/28/2015 08:00:00 PM,48,-122,8,8,16
13053,SpokaneStBridge,06/28/2015 09:00:00 PM,48,-122,5,9,14
13054,SpokaneStBridge,06/28/2015 10:00:00 PM,48,-122,0,1,1
13055,SpokaneStBridge,06/28/2015 11:00:00 PM,48,-122,1,1,2
13056,SpokaneStBridge,06/29/2015 12:00:00 AM,48,-122,2,3,5
13057,SpokaneStBridge,06/29/2015 01:00:00 AM,48,-122,2,2,4
13058,SpokaneStBridge,06/29/2015 02:00:00 AM,48,-122,1,0,1
13059,SpokaneStBridge,06/29/2015 03:00:00 AM,48,-122,2,2,4
13060,SpokaneStBridge,06/29/2015 04:00:00 AM,48,-122,5,1,6
13061,SpokaneStBridge,06/29/2015 05:00:00 AM,48,-122,21,5,26
13062,SpokaneStBridge,06/29/2015 06:00:00 AM,48,-122,81,17,98
13063,SpokaneStBridge,06/29/2015 07:00:00 AM,48,-122,148,18,166
13064,SpokaneStBridge,06/29/2015 08:00:00 AM,48,-122,134,19,153
13065,SpokaneStBridge,06/29/2015 09:00:00 AM,48,-122,56,11,67
13066,SpokaneStBridge,06/29/2015 10:00:00 AM,48,-122,29,11,40
13067,SpokaneStBridge,06/29/2015 11:00:00 AM,48,-122,9,10,19
13068,SpokaneStBridge,06/29/2015 12:00:00 PM,48,-122,10,14,24
13069,SpokaneStBridge,06/29/2015 01:00:00 PM,48,-122,17,5,22
13070,SpokaneStBridge,06/29/2015 02:00:00 PM,48,-122,19,27,46
13071,SpokaneStBridge,06/29/2015 03:00:00 PM,48,-122,14,32,46
13072,SpokaneStBridge,06/29/2015 04:00:00 PM,48,-122,20,98,118
13073,SpokaneStBridge,06/29/2015 05:00:00 PM,48,-122,33,179,212
13074,SpokaneStBridge,06/29/2015 06:00:00 PM,48,-122,26,137,163
13075,SpokaneStBridge,06/29/2015 07:00:00 PM,48,-122,32,43,75
13076,SpokaneStBridge,06/29/2015 08:00:00 PM,48,-122,11,33,44
13077,SpokaneStBridge,06/29/2015 09:00:00 PM,48,-122,7,17,24
13078,SpokaneStBridge,06/29/2015 10:00:00 PM,48,-122,5,5,10
13079,SpokaneStBridge,06/29/2015 11:00:00 PM,48,-122,1,5,6
13080,SpokaneStBridge,06/30/2015 12:00:00 AM,48,-122,3,5,8
13081,SpokaneStBridge,06/30/2015 01:00:00 AM,48,-122,4,3,7
13082,SpokaneStBridge,06/30/2015 02:00:00 AM,48,-122,1,0,1
13083,SpokaneStBridge,06/30/2015 03:00:00 AM,48,-122,2,1,3
13084,SpokaneStBridge,06/30/2015 04:00:00 AM,48,-122,5,3,8
13085,SpokaneStBridge,06/30/2015 05:00:00 AM,48,-122,20,9,29
13086,SpokaneStBridge,06/30/2015 06:00:00 AM,48,-122,76,28,104
13087,SpokaneStBridge,06/30/2015 07:00:00 AM,48,-122,151,30,181
13088,SpokaneStBridge,06/30/2015 08:00:00 AM,48,-122,137,18,155
13089,SpokaneStBridge,06/30/2015 09:00:00 AM,48,-122,61,14,75
13090,SpokaneStBridge,06/30/2015 10:00:00 AM,48,-122,19,14,33
13091,SpokaneStBridge,06/30/2015 11:00:00 AM,48,-122,17,10,27
13092,SpokaneStBridge,06/30/2015 12:00:00 PM,48,-122,18,19,37
13093,SpokaneStBridge,06/30/2015 01:00:00 PM,48,-122,19,18,37
13094,SpokaneStBridge,06/30/2015 02:00:00 PM,48,-122,14,31,45
13095,SpokaneStBridge,06/30/2015 03:00:00 PM,48,-122,16,29,45
13096,SpokaneStBridge,06/30/2015 04:00:00 PM,48,-122,33,100,133
13097,SpokaneStBridge,06/30/2015 05:00:00 PM,48,-122,26,179,205
13098,SpokaneStBridge,06/30/2015 06:00:00 PM,48,-122,25,135,160
13099,SpokaneStBridge,06/30/2015 07:00:00 PM,48,-122,32,53,85
13100,SpokaneStBridge,06/30/2015 08:00:00 PM,48,-122,13,32,45
13101,SpokaneStBridge,06/30/2015 09:00:00 PM,48,-122,13,18,31
13102,SpokaneStBridge,06/30/2015 10:00:00 PM,48,-122,3,10,13
13103,SpokaneStBridge,06/30/2015 11:00:00 PM,48,-122,2,6,8
13104,SpokaneStBridge,07/01/2015 12:00:00 AM,48,-122,2,2,4
13105,SpokaneStBridge,07/01/2015 01:00:00 AM,48,-122,2,0,2
13106,SpokaneStBridge,07/01/2015 02:00:00 AM,48,-122,1,2,3
13107,SpokaneStBridge,07/01/2015 03:00:00 AM,48,-122,2,0,2
13108,SpokaneStBridge,07/01/2015 04:00:00 AM,48,-122,4,2,6
13109,SpokaneStBridge,07/01/2015 05:00:00 AM,48,-122,18,7,25
13110,SpokaneStBridge,07/01/2015 06:00:00 AM,48,-122,78,12,90
13111,SpokaneStBridge,07/01/2015 07:00:00 AM,48,-122,162,19,181
13112,SpokaneStBridge,07/01/2015 08:00:00 AM,48,-122,157,21,178
13113,SpokaneStBridge,07/01/2015 09:00:00 AM,48,-122,60,19,79
13114,SpokaneStBridge,07/01/2015 10:00:00 AM,48,-122,23,13,36
13115,SpokaneStBridge,07/01/2015 11:00:00 AM,48,-122,20,11,31
13116,SpokaneStBridge,07/01/2015 12:00:00 PM,48,-122,13,27,40
13117,SpokaneStBridge,07/01/2015 01:00:00 PM,48,-122,11,12,23
13118,SpokaneStBridge,07/01/2015 02:00:00 PM,48,-122,11,23,34
13119,SpokaneStBridge,07/01/2015 03:00:00 PM,48,-122,22,32,54
13120,SpokaneStBridge,07/01/2015 04:00:00 PM,48,-122,23,115,138
13121,SpokaneStBridge,07/01/2015 05:00:00 PM,48,-122,35,172,207
13122,SpokaneStBridge,07/01/2015 06:00:00 PM,48,-122,24,126,150
13123,SpokaneStBridge,07/01/2015 07:00:00 PM,48,-122,14,63,77
13124,SpokaneStBridge,07/01/2015 08:00:00 PM,48,-122,17,35,52
13125,SpokaneStBridge,07/01/2015 09:00:00 PM,48,-122,13,22,35
13126,SpokaneStBridge,07/01/2015 10:00:00 PM,48,-122,9,6,15
13127,SpokaneStBridge,07/01/2015 11:00:00 PM,48,-122,0,5,5
13128,SpokaneStBridge,07/02/2015 12:00:00 AM,48,-122,2,8,10
13129,SpokaneStBridge,07/02/2015 01:00:00 AM,48,-122,0,2,2
13130,SpokaneStBridge,07/02/2015 02:00:00 AM,48,-122,1,2,3
13131,SpokaneStBridge,07/02/2015 03:00:00 AM,48,-122,1,1,2
13132,SpokaneStBridge,07/02/2015 04:00:00 AM,48,-122,6,1,7
13133,SpokaneStBridge,07/02/2015 05:00:00 AM,48,-122,27,6,33
13134,SpokaneStBridge,07/02/2015 06:00:00 AM,48,-122,57,20,77
13135,SpokaneStBridge,07/02/2015 07:00:00 AM,48,-122,145,22,167
13136,SpokaneStBridge,07/02/2015 08:00:00 AM,48,-122,122,18,140
13137,SpokaneStBridge,07/02/2015 09:00:00 AM,48,-122,55,14,69
13138,SpokaneStBridge,07/02/2015 10:00:00 AM,48,-122,25,9,34
13139,SpokaneStBridge,07/02/2015 11:00:00 AM,48,-122,13,11,24
13140,SpokaneStBridge,07/02/2015 12:00:00 PM,48,-122,21,28,49
13141,SpokaneStBridge,07/02/2015 01:00:00 PM,48,-122,18,18,36
13142,SpokaneStBridge,07/02/2015 02:00:00 PM,48,-122,16,36,52
13143,SpokaneStBridge,07/02/2015 03:00:00 PM,48,-122,29,51,80
13144,SpokaneStBridge,07/02/2015 04:00:00 PM,48,-122,25,87,112
13145,SpokaneStBridge,07/02/2015 05:00:00 PM,48,-122,21,132,153
13146,SpokaneStBridge,07/02/2015 06:00:00 PM,48,-122,17,71,88
13147,SpokaneStBridge,07/02/2015 07:00:00 PM,48,-122,15,44,59
13148,SpokaneStBridge,07/02/2015 08:00:00 PM,48,-122,11,23,34
13149,SpokaneStBridge,07/02/2015 09:00:00 PM,48,-122,9,10,19
13150,SpokaneStBridge,07/02/2015 10:00:00 PM,48,-122,4,8,12
13151,SpokaneStBridge,07/02/2015 11:00:00 PM,48,-122,3,6,9
13152,SpokaneStBridge,07/03/2015 12:00:00 AM,48,-122,3,5,8
13153,SpokaneStBridge,07/03/2015 01:00:00 AM,48,-122,1,3,4
13154,SpokaneStBridge,07/03/2015 02:00:00 AM,48,-122,0,3,3
13155,SpokaneStBridge,07/03/2015 03:00:00 AM,48,-122,2,0,2
13156,SpokaneStBridge,07/03/2015 04:00:00 AM,48,-122,3,4,7
13157,SpokaneStBridge,07/03/2015 05:00:00 AM,48,-122,13,2,15
13158,SpokaneStBridge,07/03/2015 06:00:00 AM,48,-122,14,5,19
13159,SpokaneStBridge,07/03/2015 07:00:00 AM,48,-122,44,21,65
13160,SpokaneStBridge,07/03/2015 08:00:00 AM,48,-122,36,38,74
13161,SpokaneStBridge,07/03/2015 09:00:00 AM,48,-122,46,29,75
13162,SpokaneStBridge,07/03/2015 10:00:00 AM,48,-122,26,42,68
13163,SpokaneStBridge,07/03/2015 11:00:00 AM,48,-122,39,39,78
13164,SpokaneStBridge,07/03/2015 12:00:00 PM,48,-122,33,49,82
13165,SpokaneStBridge,07/03/2015 01:00:00 PM,48,-122,38,43,81
13166,SpokaneStBridge,07/03/2015 02:00:00 PM,48,-122,26,29,55
13167,SpokaneStBridge,07/03/2015 03:00:00 PM,48,-122,39,39,78
13168,SpokaneStBridge,07/03/2015 04:00:00 PM,48,-122,25,35,60
13169,SpokaneStBridge,07/03/2015 05:00:00 PM,48,-122,26,29,55
13170,SpokaneStBridge,07/03/2015 06:00:00 PM,48,-122,17,22,39
13171,SpokaneStBridge,07/03/2015 07:00:00 PM,48,-122,7,17,24
13172,SpokaneStBridge,07/03/2015 08:00:00 PM,48,-122,14,11,25
13173,SpokaneStBridge,07/03/2015 09:00:00 PM,48,-122,9,6,15
13174,SpokaneStBridge,07/03/2015 10:00:00 PM,48,-122,7,11,18
13175,SpokaneStBridge,07/03/2015 11:00:00 PM,48,-122,6,6,12
13176,SpokaneStBridge,07/04/2015 12:00:00 AM,48,-122,2,6,8
13177,SpokaneStBridge,07/04/2015 01:00:00 AM,48,-122,1,0,1
13178,SpokaneStBridge,07/04/2015 02:00:00 AM,48,-122,0,0,0
13179,SpokaneStBridge,07/04/2015 03:00:00 AM,48,-122,2,2,4
13180,SpokaneStBridge,07/04/2015 04:00:00 AM,48,-122,0,0,0
13181,SpokaneStBridge,07/04/2015 05:00:00 AM,48,-122,5,2,7
13182,SpokaneStBridge,07/04/2015 06:00:00 AM,48,-122,10,9,19
13183,SpokaneStBridge,07/04/2015 07:00:00 AM,48,-122,28,11,39
13184,SpokaneStBridge,07/04/2015 08:00:00 AM,48,-122,28,39,67
13185,SpokaneStBridge,07/04/2015 09:00:00 AM,48,-122,37,30,67
13186,SpokaneStBridge,07/04/2015 10:00:00 AM,48,-122,31,36,67
13187,SpokaneStBridge,07/04/2015 11:00:00 AM,48,-122,32,40,72
13188,SpokaneStBridge,07/04/2015 12:00:00 PM,48,-122,31,34,65
13189,SpokaneStBridge,07/04/2015 01:00:00 PM,48,-122,30,32,62
13190,SpokaneStBridge,07/04/2015 02:00:00 PM,48,-122,25,28,53
13191,SpokaneStBridge,07/04/2015 03:00:00 PM,48,-122,20,29,49
13192,SpokaneStBridge,07/04/2015 04:00:00 PM,48,-122,25,22,47
13193,SpokaneStBridge,07/04/2015 05:00:00 PM,48,-122,24,21,45
13194,SpokaneStBridge,07/04/2015 06:00:00 PM,48,-122,16,24,40
13195,SpokaneStBridge,07/04/2015 07:00:00 PM,48,-122,12,9,21
13196,SpokaneStBridge,07/04/2015 08:00:00 PM,48,-122,11,10,21
13197,SpokaneStBridge,07/04/2015 09:00:00 PM,48,-122,12,6,18
13198,SpokaneStBridge,07/04/2015 10:00:00 PM,48,-122,5,6,11
13199,SpokaneStBridge,07/04/2015 11:00:00 PM,48,-122,6,19,25
13200,SpokaneStBridge,07/05/2015 12:00:00 AM,48,-122,13,3,16
13201,SpokaneStBridge,07/05/2015 01:00:00 AM,48,-122,1,5,6
13202,SpokaneStBridge,07/05/2015 02:00:00 AM,48,-122,2,3,5
13203,SpokaneStBridge,07/05/2015 03:00:00 AM,48,-122,2,3,5
13204,SpokaneStBridge,07/05/2015 04:00:00 AM,48,-122,0,1,1
13205,SpokaneStBridge,07/05/2015 05:00:00 AM,48,-122,7,0,7
13206,SpokaneStBridge,07/05/2015 06:00:00 AM,48,-122,7,4,11
13207,SpokaneStBridge,07/05/2015 07:00:00 AM,48,-122,14,10,24
13208,SpokaneStBridge,07/05/2015 08:00:00 AM,48,-122,27,19,46
13209,SpokaneStBridge,07/05/2015 09:00:00 AM,48,-122,24,19,43
13210,SpokaneStBridge,07/05/2015 10:00:00 AM,48,-122,28,33,61
13211,SpokaneStBridge,07/05/2015 11:00:00 AM,48,-122,41,39,80
13212,SpokaneStBridge,07/05/2015 12:00:00 PM,48,-122,33,33,66
13213,SpokaneStBridge,07/05/2015 01:00:00 PM,48,-122,29,42,71
13214,SpokaneStBridge,07/05/2015 02:00:00 PM,48,-122,34,17,51
13215,SpokaneStBridge,07/05/2015 03:00:00 PM,48,-122,35,25,60
13216,SpokaneStBridge,07/05/2015 04:00:00 PM,48,-122,22,18,40
13217,SpokaneStBridge,07/05/2015 05:00:00 PM,48,-122,15,21,36
13218,SpokaneStBridge,07/05/2015 06:00:00 PM,48,-122,16,17,33
13219,SpokaneStBridge,07/05/2015 07:00:00 PM,48,-122,10,5,15
13220,SpokaneStBridge,07/05/2015 08:00:00 PM,48,-122,14,12,26
13221,SpokaneStBridge,07/05/2015 09:00:00 PM,48,-122,4,2,6
13222,SpokaneStBridge,07/05/2015 10:00:00 PM,48,-122,1,3,4
13223,SpokaneStBridge,07/05/2015 11:00:00 PM,48,-122,1,1,2
13224,SpokaneStBridge,07/06/2015 12:00:00 AM,48,-122,0,1,1
13225,SpokaneStBridge,07/06/2015 01:00:00 AM,48,-122,0,0,0
13226,SpokaneStBridge,07/06/2015 02:00:00 AM,48,-122,2,0,2
13227,SpokaneStBridge,07/06/2015 03:00:00 AM,48,-122,1,1,2
13228,SpokaneStBridge,07/06/2015 04:00:00 AM,48,-122,6,0,6
13229,SpokaneStBridge,07/06/2015 05:00:00 AM,48,-122,21,2,23
13230,SpokaneStBridge,07/06/2015 06:00:00 AM,48,-122,78,10,88
13231,SpokaneStBridge,07/06/2015 07:00:00 AM,48,-122,135,16,151
13232,SpokaneStBridge,07/06/2015 08:00:00 AM,48,-122,124,21,145
13233,SpokaneStBridge,07/06/2015 09:00:00 AM,48,-122,59,12,71
13234,SpokaneStBridge,07/06/2015 10:00:00 AM,48,-122,16,7,23
13235,SpokaneStBridge,07/06/2015 11:00:00 AM,48,-122,20,16,36
13236,SpokaneStBridge,07/06/2015 12:00:00 PM,48,-122,16,22,38
13237,SpokaneStBridge,07/06/2015 01:00:00 PM,48,-122,15,17,32
13238,SpokaneStBridge,07/06/2015 02:00:00 PM,48,-122,11,15,26
13239,SpokaneStBridge,07/06/2015 03:00:00 PM,48,-122,16,39,55
13240,SpokaneStBridge,07/06/2015 04:00:00 PM,48,-122,23,83,106
13241,SpokaneStBridge,07/06/2015 05:00:00 PM,48,-122,31,167,198
13242,SpokaneStBridge,07/06/2015 06:00:00 PM,48,-122,19,122,141
13243,SpokaneStBridge,07/06/2015 07:00:00 PM,48,-122,10,34,44
13244,SpokaneStBridge,07/06/2015 08:00:00 PM,48,-122,7,15,22
13245,SpokaneStBridge,07/06/2015 09:00:00 PM,48,-122,6,19,25
13246,SpokaneStBridge,07/06/2015 10:00:00 PM,48,-122,3,8,11
13247,SpokaneStBridge,07/06/2015 11:00:00 PM,48,-122,2,5,7
13248,SpokaneStBridge,07/07/2015 12:00:00 AM,48,-122,0,4,4
13249,SpokaneStBridge,07/07/2015 01:00:00 AM,48,-122,1,1,2
13250,SpokaneStBridge,07/07/2015 02:00:00 AM,48,-122,2,0,2
13251,SpokaneStBridge,07/07/2015 03:00:00 AM,48,-122,1,0,1
13252,SpokaneStBridge,07/07/2015 04:00:00 AM,48,-122,4,1,5
13253,SpokaneStBridge,07/07/2015 05:00:00 AM,48,-122,33,4,37
13254,SpokaneStBridge,07/07/2015 06:00:00 AM,48,-122,94,20,114
13255,SpokaneStBridge,07/07/2015 07:00:00 AM,48,-122,165,23,188
13256,SpokaneStBridge,07/07/2015 08:00:00 AM,48,-122,159,19,178
13257,SpokaneStBridge,07/07/2015 09:00:00 AM,48,-122,56,10,66
13258,SpokaneStBridge,07/07/2015 10:00:00 AM,48,-122,28,11,39
13259,SpokaneStBridge,07/07/2015 11:00:00 AM,48,-122,10,13,23
13260,SpokaneStBridge,07/07/2015 12:00:00 PM,48,-122,19,20,39
13261,SpokaneStBridge,07/07/2015 01:00:00 PM,48,-122,13,19,32
13262,SpokaneStBridge,07/07/2015 02:00:00 PM,48,-122,13,16,29
13263,SpokaneStBridge,07/07/2015 03:00:00 PM,48,-122,24,50,74
13264,SpokaneStBridge,07/07/2015 04:00:00 PM,48,-122,25,103,128
13265,SpokaneStBridge,07/07/2015 05:00:00 PM,48,-122,28,203,231
13266,SpokaneStBridge,07/07/2015 06:00:00 PM,48,-122,24,122,146
13267,SpokaneStBridge,07/07/2015 07:00:00 PM,48,-122,15,44,59
13268,SpokaneStBridge,07/07/2015 08:00:00 PM,48,-122,13,22,35
13269,SpokaneStBridge,07/07/2015 09:00:00 PM,48,-122,6,17,23
13270,SpokaneStBridge,07/07/2015 10:00:00 PM,48,-122,2,15,17
13271,SpokaneStBridge,07/07/2015 11:00:00 PM,48,-122,2,9,11
13272,SpokaneStBridge,07/08/2015 12:00:00 AM,48,-122,0,2,2
13273,SpokaneStBridge,07/08/2015 01:00:00 AM,48,-122,1,2,3
13274,SpokaneStBridge,07/08/2015 02:00:00 AM,48,-122,2,2,4
13275,SpokaneStBridge,07/08/2015 03:00:00 AM,48,-122,1,1,2
13276,SpokaneStBridge,07/08/2015 04:00:00 AM,48,-122,7,0,7
13277,SpokaneStBridge,07/08/2015 05:00:00 AM,48,-122,25,4,29
13278,SpokaneStBridge,07/08/2015 06:00:00 AM,48,-122,84,17,101
13279,SpokaneStBridge,07/08/2015 07:00:00 AM,48,-122,150,18,168
13280,SpokaneStBridge,07/08/2015 08:00:00 AM,48,-122,151,10,161
13281,SpokaneStBridge,07/08/2015 09:00:00 AM,48,-122,73,17,90
13282,SpokaneStBridge,07/08/2015 10:00:00 AM,48,-122,24,13,37
13283,SpokaneStBridge,07/08/2015 11:00:00 AM,48,-122,22,16,38
13284,SpokaneStBridge,07/08/2015 12:00:00 PM,48,-122,19,11,30
13285,SpokaneStBridge,07/08/2015 01:00:00 PM,48,-122,30,18,48
13286,SpokaneStBridge,07/08/2015 02:00:00 PM,48,-122,16,26,42
13287,SpokaneStBridge,07/08/2015 03:00:00 PM,48,-122,18,56,74
13288,SpokaneStBridge,07/08/2015 04:00:00 PM,48,-122,40,114,154
13289,SpokaneStBridge,07/08/2015 05:00:00 PM,48,-122,31,180,211
13290,SpokaneStBridge,07/08/2015 06:00:00 PM,48,-122,19,118,137
13291,SpokaneStBridge,07/08/2015 07:00:00 PM,48,-122,24,62,86
13292,SpokaneStBridge,07/08/2015 08:00:00 PM,48,-122,31,27,58
13293,SpokaneStBridge,07/08/2015 09:00:00 PM,48,-122,6,19,25
13294,SpokaneStBridge,07/08/2015 10:00:00 PM,48,-122,5,12,17
13295,SpokaneStBridge,07/08/2015 11:00:00 PM,48,-122,1,8,9
13296,SpokaneStBridge,07/09/2015 12:00:00 AM,48,-122,0,3,3
13297,SpokaneStBridge,07/09/2015 01:00:00 AM,48,-122,1,0,1
13298,SpokaneStBridge,07/09/2015 02:00:00 AM,48,-122,1,1,2
13299,SpokaneStBridge,07/09/2015 03:00:00 AM,48,-122,1,1,2
13300,SpokaneStBridge,07/09/2015 04:00:00 AM,48,-122,8,1,9
13301,SpokaneStBridge,07/09/2015 05:00:00 AM,48,-122,19,5,24
13302,SpokaneStBridge,07/09/2015 06:00:00 AM,48,-122,79,12,91
13303,SpokaneStBridge,07/09/2015 07:00:00 AM,48,-122,134,11,145
13304,SpokaneStBridge,07/09/2015 08:00:00 AM,48,-122,144,24,168
13305,SpokaneStBridge,07/09/2015 09:00:00 AM,48,-122,68,7,75
13306,SpokaneStBridge,07/09/2015 10:00:00 AM,48,-122,25,11,36
13307,SpokaneStBridge,07/09/2015 11:00:00 AM,48,-122,10,8,18
13308,SpokaneStBridge,07/09/2015 12:00:00 PM,48,-122,24,16,40
13309,SpokaneStBridge,07/09/2015 01:00:00 PM,48,-122,17,19,36
13310,SpokaneStBridge,07/09/2015 02:00:00 PM,48,-122,11,19,30
13311,SpokaneStBridge,07/09/2015 03:00:00 PM,48,-122,18,36,54
13312,SpokaneStBridge,07/09/2015 04:00:00 PM,48,-122,27,94,121
13313,SpokaneStBridge,07/09/2015 05:00:00 PM,48,-122,29,147,176
13314,SpokaneStBridge,07/09/2015 06:00:00 PM,48,-122,25,122,147
13315,SpokaneStBridge,07/09/2015 07:00:00 PM,48,-122,18,56,74
13316,SpokaneStBridge,07/09/2015 08:00:00 PM,48,-122,9,31,40
13317,SpokaneStBridge,07/09/2015 09:00:00 PM,48,-122,8,17,25
13318,SpokaneStBridge,07/09/2015 10:00:00 PM,48,-122,2,13,15
13319,SpokaneStBridge,07/09/2015 11:00:00 PM,48,-122,0,7,7
13320,SpokaneStBridge,07/10/2015 12:00:00 AM,48,-122,2,3,5
13321,SpokaneStBridge,07/10/2015 01:00:00 AM,48,-122,2,1,3
13322,SpokaneStBridge,07/10/2015 02:00:00 AM,48,-122,2,0,2
13323,SpokaneStBridge,07/10/2015 03:00:00 AM,48,-122,1,3,4
13324,SpokaneStBridge,07/10/2015 04:00:00 AM,48,-122,5,3,8
13325,SpokaneStBridge,07/10/2015 05:00:00 AM,48,-122,17,8,25
13326,SpokaneStBridge,07/10/2015 06:00:00 AM,48,-122,64,8,72
13327,SpokaneStBridge,07/10/2015 07:00:00 AM,48,-122,112,15,127
13328,SpokaneStBridge,07/10/2015 08:00:00 AM,48,-122,116,22,138
13329,SpokaneStBridge,07/10/2015 09:00:00 AM,48,-122,39,9,48
13330,SpokaneStBridge,07/10/2015 10:00:00 AM,48,-122,15,7,22
13331,SpokaneStBridge,07/10/2015 11:00:00 AM,48,-122,17,9,26
13332,SpokaneStBridge,07/10/2015 12:00:00 PM,48,-122,17,13,30
13333,SpokaneStBridge,07/10/2015 01:00:00 PM,48,-122,12,7,19
13334,SpokaneStBridge,07/10/2015 02:00:00 PM,48,-122,11,19,30
13335,SpokaneStBridge,07/10/2015 03:00:00 PM,48,-122,18,39,57
13336,SpokaneStBridge,07/10/2015 04:00:00 PM,48,-122,17,88,105
13337,SpokaneStBridge,07/10/2015 05:00:00 PM,48,-122,19,128,147
13338,SpokaneStBridge,07/10/2015 06:00:00 PM,48,-122,15,68,83
13339,SpokaneStBridge,07/10/2015 07:00:00 PM,48,-122,8,36,44
13340,SpokaneStBridge,07/10/2015 08:00:00 PM,48,-122,7,22,29
13341,SpokaneStBridge,07/10/2015 09:00:00 PM,48,-122,5,9,14
13342,SpokaneStBridge,07/10/2015 10:00:00 PM,48,-122,8,11,19
13343,SpokaneStBridge,07/10/2015 11:00:00 PM,48,-122,6,9,15
13344,SpokaneStBridge,07/11/2015 12:00:00 AM,48,-122,8,3,11
13345,SpokaneStBridge,07/11/2015 01:00:00 AM,48,-122,1,2,3
13346,SpokaneStBridge,07/11/2015 02:00:00 AM,48,-122,0,3,3
13347,SpokaneStBridge,07/11/2015 03:00:00 AM,48,-122,0,0,0
13348,SpokaneStBridge,07/11/2015 04:00:00 AM,48,-122,3,7,10
13349,SpokaneStBridge,07/11/2015 05:00:00 AM,48,-122,19,9,28
13350,SpokaneStBridge,07/11/2015 06:00:00 AM,48,-122,10,5,15
13351,SpokaneStBridge,07/11/2015 07:00:00 AM,48,-122,18,1,19
13352,SpokaneStBridge,07/11/2015 08:00:00 AM,48,-122,22,23,45
13353,SpokaneStBridge,07/11/2015 09:00:00 AM,48,-122,25,22,47
13354,SpokaneStBridge,07/11/2015 10:00:00 AM,48,-122,28,15,43
13355,SpokaneStBridge,07/11/2015 11:00:00 AM,48,-122,23,26,49
13356,SpokaneStBridge,07/11/2015 12:00:00 PM,48,-122,23,20,43
13357,SpokaneStBridge,07/11/2015 01:00:00 PM,48,-122,32,27,59
13358,SpokaneStBridge,07/11/2015 02:00:00 PM,48,-122,22,32,54
13359,SpokaneStBridge,07/11/2015 03:00:00 PM,48,-122,29,30,59
13360,SpokaneStBridge,07/11/2015 04:00:00 PM,48,-122,22,26,48
13361,SpokaneStBridge,07/11/2015 05:00:00 PM,48,-122,16,24,40
13362,SpokaneStBridge,07/11/2015 06:00:00 PM,48,-122,10,14,24
13363,SpokaneStBridge,07/11/2015 07:00:00 PM,48,-122,5,12,17
13364,SpokaneStBridge,07/11/2015 08:00:00 PM,48,-122,2,12,14
13365,SpokaneStBridge,07/11/2015 09:00:00 PM,48,-122,6,8,14
13366,SpokaneStBridge,07/11/2015 10:00:00 PM,48,-122,6,15,21
13367,SpokaneStBridge,07/11/2015 11:00:00 PM,48,-122,7,3,10
13368,SpokaneStBridge,07/12/2015 12:00:00 AM,48,-122,4,3,7
13369,SpokaneStBridge,07/12/2015 01:00:00 AM,48,-122,0,1,1
13370,SpokaneStBridge,07/12/2015 02:00:00 AM,48,-122,0,2,2
13371,SpokaneStBridge,07/12/2015 03:00:00 AM,48,-122,1,2,3
13372,SpokaneStBridge,07/12/2015 04:00:00 AM,48,-122,3,1,4
13373,SpokaneStBridge,07/12/2015 05:00:00 AM,48,-122,4,0,4
13374,SpokaneStBridge,07/12/2015 06:00:00 AM,48,-122,5,1,6
13375,SpokaneStBridge,07/12/2015 07:00:00 AM,48,-122,15,10,25
13376,SpokaneStBridge,07/12/2015 08:00:00 AM,48,-122,24,14,38
13377,SpokaneStBridge,07/12/2015 09:00:00 AM,48,-122,20,14,34
13378,SpokaneStBridge,07/12/2015 10:00:00 AM,48,-122,26,19,45
13379,SpokaneStBridge,07/12/2015 11:00:00 AM,48,-122,27,23,50
13380,SpokaneStBridge,07/12/2015 12:00:00 PM,48,-122,30,31,61
13381,SpokaneStBridge,07/12/2015 01:00:00 PM,48,-122,35,41,76
13382,SpokaneStBridge,07/12/2015 02:00:00 PM,48,-122,36,33,69
13383,SpokaneStBridge,07/12/2015 03:00:00 PM,48,-122,28,39,67
13384,SpokaneStBridge,07/12/2015 04:00:00 PM,48,-122,25,22,47
13385,SpokaneStBridge,07/12/2015 05:00:00 PM,48,-122,27,25,52
13386,SpokaneStBridge,07/12/2015 06:00:00 PM,48,-122,7,22,29
13387,SpokaneStBridge,07/12/2015 07:00:00 PM,48,-122,11,10,21
13388,SpokaneStBridge,07/12/2015 08:00:00 PM,48,-122,14,6,20
13389,SpokaneStBridge,07/12/2015 09:00:00 PM,48,-122,3,9,12
13390,SpokaneStBridge,07/12/2015 10:00:00 PM,48,-122,2,7,9
13391,SpokaneStBridge,07/12/2015 11:00:00 PM,48,-122,0,4,4
13392,SpokaneStBridge,07/13/2015 12:00:00 AM,48,-122,0,2,2
13393,SpokaneStBridge,07/13/2015 01:00:00 AM,48,-122,1,1,2
13394,SpokaneStBridge,07/13/2015 02:00:00 AM,48,-122,1,1,2
13395,SpokaneStBridge,07/13/2015 03:00:00 AM,48,-122,2,2,4
13396,SpokaneStBridge,07/13/2015 04:00:00 AM,48,-122,6,1,7
13397,SpokaneStBridge,07/13/2015 05:00:00 AM,48,-122,22,3,25
13398,SpokaneStBridge,07/13/2015 06:00:00 AM,48,-122,62,15,77
13399,SpokaneStBridge,07/13/2015 07:00:00 AM,48,-122,135,18,153
13400,SpokaneStBridge,07/13/2015 08:00:00 AM,48,-122,123,14,137
13401,SpokaneStBridge,07/13/2015 09:00:00 AM,48,-122,35,5,40
13402,SpokaneStBridge,07/13/2015 10:00:00 AM,48,-122,34,6,40
13403,SpokaneStBridge,07/13/2015 11:00:00 AM,48,-122,10,5,15
13404,SpokaneStBridge,07/13/2015 12:00:00 PM,48,-122,4,12,16
13405,SpokaneStBridge,07/13/2015 01:00:00 PM,48,-122,15,18,33
13406,SpokaneStBridge,07/13/2015 02:00:00 PM,48,-122,13,15,28
13407,SpokaneStBridge,07/13/2015 03:00:00 PM,48,-122,10,39,49
13408,SpokaneStBridge,07/13/2015 04:00:00 PM,48,-122,19,74,93
13409,SpokaneStBridge,07/13/2015 05:00:00 PM,48,-122,25,161,186
13410,SpokaneStBridge,07/13/2015 06:00:00 PM,48,-122,16,94,110
13411,SpokaneStBridge,07/13/2015 07:00:00 PM,48,-122,16,51,67
13412,SpokaneStBridge,07/13/2015 08:00:00 PM,48,-122,10,19,29
13413,SpokaneStBridge,07/13/2015 09:00:00 PM,48,-122,14,18,32
13414,SpokaneStBridge,07/13/2015 10:00:00 PM,48,-122,2,10,12
13415,SpokaneStBridge,07/13/2015 11:00:00 PM,48,-122,2,4,6
13416,SpokaneStBridge,07/14/2015 12:00:00 AM,48,-122,1,1,2
13417,SpokaneStBridge,07/14/2015 01:00:00 AM,48,-122,1,3,4
13418,SpokaneStBridge,07/14/2015 02:00:00 AM,48,-122,1,4,5
13419,SpokaneStBridge,07/14/2015 03:00:00 AM,48,-122,0,3,3
13420,SpokaneStBridge,07/14/2015 04:00:00 AM,48,-122,4,1,5
13421,SpokaneStBridge,07/14/2015 05:00:00 AM,48,-122,28,7,35
13422,SpokaneStBridge,07/14/2015 06:00:00 AM,48,-122,68,15,83
13423,SpokaneStBridge,07/14/2015 07:00:00 AM,48,-122,173,20,193
13424,SpokaneStBridge,07/14/2015 08:00:00 AM,48,-122,129,19,148
13425,SpokaneStBridge,07/14/2015 09:00:00 AM,48,-122,60,8,68
13426,SpokaneStBridge,07/14/2015 10:00:00 AM,48,-122,31,8,39
13427,SpokaneStBridge,07/14/2015 11:00:00 AM,48,-122,9,12,21
13428,SpokaneStBridge,07/14/2015 12:00:00 PM,48,-122,14,14,28
13429,SpokaneStBridge,07/14/2015 01:00:00 PM,48,-122,11,21,32
13430,SpokaneStBridge,07/14/2015 02:00:00 PM,48,-122,10,21,31
13431,SpokaneStBridge,07/14/2015 03:00:00 PM,48,-122,18,40,58
13432,SpokaneStBridge,07/14/2015 04:00:00 PM,48,-122,28,105,133
13433,SpokaneStBridge,07/14/2015 05:00:00 PM,48,-122,33,185,218
13434,SpokaneStBridge,07/14/2015 06:00:00 PM,48,-122,23,116,139
13435,SpokaneStBridge,07/14/2015 07:00:00 PM,48,-122,13,58,71
13436,SpokaneStBridge,07/14/2015 08:00:00 PM,48,-122,16,23,39
13437,SpokaneStBridge,07/14/2015 09:00:00 PM,48,-122,7,19,26
13438,SpokaneStBridge,07/14/2015 10:00:00 PM,48,-122,4,14,18
13439,SpokaneStBridge,07/14/2015 11:00:00 PM,48,-122,4,4,8
13440,SpokaneStBridge,07/15/2015 12:00:00 AM,48,-122,0,5,5
13441,SpokaneStBridge,07/15/2015 01:00:00 AM,48,-122,1,2,3
13442,SpokaneStBridge,07/15/2015 02:00:00 AM,48,-122,1,0,1
13443,SpokaneStBridge,07/15/2015 03:00:00 AM,48,-122,1,2,3
13444,SpokaneStBridge,07/15/2015 04:00:00 AM,48,-122,6,2,8
13445,SpokaneStBridge,07/15/2015 05:00:00 AM,48,-122,21,7,28
13446,SpokaneStBridge,07/15/2015 06:00:00 AM,48,-122,76,14,90
13447,SpokaneStBridge,07/15/2015 07:00:00 AM,48,-122,168,22,190
13448,SpokaneStBridge,07/15/2015 08:00:00 AM,48,-122,136,15,151
13449,SpokaneStBridge,07/15/2015 09:00:00 AM,48,-122,49,10,59
13450,SpokaneStBridge,07/15/2015 10:00:00 AM,48,-122,25,18,43
13451,SpokaneStBridge,07/15/2015 11:00:00 AM,48,-122,29,16,45
13452,SpokaneStBridge,07/15/2015 12:00:00 PM,48,-122,12,21,33
13453,SpokaneStBridge,07/15/2015 01:00:00 PM,48,-122,18,29,47
13454,SpokaneStBridge,07/15/2015 02:00:00 PM,48,-122,12,18,30
13455,SpokaneStBridge,07/15/2015 03:00:00 PM,48,-122,14,31,45
13456,SpokaneStBridge,07/15/2015 04:00:00 PM,48,-122,40,99,139
13457,SpokaneStBridge,07/15/2015 05:00:00 PM,48,-122,31,171,202
13458,SpokaneStBridge,07/15/2015 06:00:00 PM,48,-122,19,127,146
13459,SpokaneStBridge,07/15/2015 07:00:00 PM,48,-122,17,46,63
13460,SpokaneStBridge,07/15/2015 08:00:00 PM,48,-122,17,30,47
13461,SpokaneStBridge,07/15/2015 09:00:00 PM,48,-122,13,18,31
13462,SpokaneStBridge,07/15/2015 10:00:00 PM,48,-122,6,6,12
13463,SpokaneStBridge,07/15/2015 11:00:00 PM,48,-122,0,9,9
13464,SpokaneStBridge,07/16/2015 12:00:00 AM,48,-122,2,0,2
13465,SpokaneStBridge,07/16/2015 01:00:00 AM,48,-122,1,2,3
13466,SpokaneStBridge,07/16/2015 02:00:00 AM,48,-122,2,1,3
13467,SpokaneStBridge,07/16/2015 03:00:00 AM,48,-122,0,1,1
13468,SpokaneStBridge,07/16/2015 04:00:00 AM,48,-122,4,2,6
13469,SpokaneStBridge,07/16/2015 05:00:00 AM,48,-122,28,2,30
13470,SpokaneStBridge,07/16/2015 06:00:00 AM,48,-122,78,13,91
13471,SpokaneStBridge,07/16/2015 07:00:00 AM,48,-122,127,19,146
13472,SpokaneStBridge,07/16/2015 08:00:00 AM,48,-122,140,24,164
13473,SpokaneStBridge,07/16/2015 09:00:00 AM,48,-122,62,11,73
13474,SpokaneStBridge,07/16/2015 10:00:00 AM,48,-122,19,10,29
13475,SpokaneStBridge,07/16/2015 11:00:00 AM,48,-122,18,11,29
13476,SpokaneStBridge,07/16/2015 12:00:00 PM,48,-122,12,17,29
13477,SpokaneStBridge,07/16/2015 01:00:00 PM,48,-122,13,24,37
13478,SpokaneStBridge,07/16/2015 02:00:00 PM,48,-122,20,18,38
13479,SpokaneStBridge,07/16/2015 03:00:00 PM,48,-122,23,43,66
13480,SpokaneStBridge,07/16/2015 04:00:00 PM,48,-122,27,85,112
13481,SpokaneStBridge,07/16/2015 05:00:00 PM,48,-122,27,157,184
13482,SpokaneStBridge,07/16/2015 06:00:00 PM,48,-122,26,105,131
13483,SpokaneStBridge,07/16/2015 07:00:00 PM,48,-122,18,61,79
13484,SpokaneStBridge,07/16/2015 08:00:00 PM,48,-122,8,21,29
13485,SpokaneStBridge,07/16/2015 09:00:00 PM,48,-122,6,18,24
13486,SpokaneStBridge,07/16/2015 10:00:00 PM,48,-122,3,11,14
13487,SpokaneStBridge,07/16/2015 11:00:00 PM,48,-122,2,7,9
13488,SpokaneStBridge,07/17/2015 12:00:00 AM,48,-122,4,8,12
13489,SpokaneStBridge,07/17/2015 01:00:00 AM,48,-122,1,4,5
13490,SpokaneStBridge,07/17/2015 02:00:00 AM,48,-122,1,2,3
13491,SpokaneStBridge,07/17/2015 03:00:00 AM,48,-122,0,0,0
13492,SpokaneStBridge,07/17/2015 04:00:00 AM,48,-122,3,1,4
13493,SpokaneStBridge,07/17/2015 05:00:00 AM,48,-122,24,6,30
13494,SpokaneStBridge,07/17/2015 06:00:00 AM,48,-122,70,13,83
13495,SpokaneStBridge,07/17/2015 07:00:00 AM,48,-122,133,12,145
13496,SpokaneStBridge,07/17/2015 08:00:00 AM,48,-122,120,14,134
13497,SpokaneStBridge,07/17/2015 09:00:00 AM,48,-122,48,10,58
13498,SpokaneStBridge,07/17/2015 10:00:00 AM,48,-122,14,9,23
13499,SpokaneStBridge,07/17/2015 11:00:00 AM,48,-122,15,11,26
13500,SpokaneStBridge,07/17/2015 12:00:00 PM,48,-122,12,17,29
13501,SpokaneStBridge,07/17/2015 01:00:00 PM,48,-122,21,22,43
13502,SpokaneStBridge,07/17/2015 02:00:00 PM,48,-122,17,29,46
13503,SpokaneStBridge,07/17/2015 03:00:00 PM,48,-122,27,45,72
13504,SpokaneStBridge,07/17/2015 04:00:00 PM,48,-122,28,89,117
13505,SpokaneStBridge,07/17/2015 05:00:00 PM,48,-122,25,126,151
13506,SpokaneStBridge,07/17/2015 06:00:00 PM,48,-122,22,85,107
13507,SpokaneStBridge,07/17/2015 07:00:00 PM,48,-122,13,33,46
13508,SpokaneStBridge,07/17/2015 08:00:00 PM,48,-122,13,24,37
13509,SpokaneStBridge,07/17/2015 09:00:00 PM,48,-122,4,6,10
13510,SpokaneStBridge,07/17/2015 10:00:00 PM,48,-122,5,12,17
13511,SpokaneStBridge,07/17/2015 11:00:00 PM,48,-122,5,5,10
13512,SpokaneStBridge,07/18/2015 12:00:00 AM,48,-122,3,8,11
13513,SpokaneStBridge,07/18/2015 01:00:00 AM,48,-122,1,4,5
13514,SpokaneStBridge,07/18/2015 02:00:00 AM,48,-122,0,6,6
13515,SpokaneStBridge,07/18/2015 03:00:00 AM,48,-122,3,0,3
13516,SpokaneStBridge,07/18/2015 04:00:00 AM,48,-122,3,2,5
13517,SpokaneStBridge,07/18/2015 05:00:00 AM,48,-122,7,2,9
13518,SpokaneStBridge,07/18/2015 06:00:00 AM,48,-122,12,5,17
13519,SpokaneStBridge,07/18/2015 07:00:00 AM,48,-122,34,11,45
13520,SpokaneStBridge,07/18/2015 08:00:00 AM,48,-122,28,21,49
13521,SpokaneStBridge,07/18/2015 09:00:00 AM,48,-122,29,34,63
13522,SpokaneStBridge,07/18/2015 10:00:00 AM,48,-122,21,39,60
13523,SpokaneStBridge,07/18/2015 11:00:00 AM,48,-122,43,31,74
13524,SpokaneStBridge,07/18/2015 12:00:00 PM,48,-122,32,33,65
13525,SpokaneStBridge,07/18/2015 01:00:00 PM,48,-122,43,47,90
13526,SpokaneStBridge,07/18/2015 02:00:00 PM,48,-122,32,27,59
13527,SpokaneStBridge,07/18/2015 03:00:00 PM,48,-122,37,30,67
13528,SpokaneStBridge,07/18/2015 04:00:00 PM,48,-122,19,38,57
13529,SpokaneStBridge,07/18/2015 05:00:00 PM,48,-122,25,27,52
13530,SpokaneStBridge,07/18/2015 06:00:00 PM,48,-122,30,19,49
13531,SpokaneStBridge,07/18/2015 07:00:00 PM,48,-122,19,23,42
13532,SpokaneStBridge,07/18/2015 08:00:00 PM,48,-122,13,7,20
13533,SpokaneStBridge,07/18/2015 09:00:00 PM,48,-122,6,15,21
13534,SpokaneStBridge,07/18/2015 10:00:00 PM,48,-122,9,13,22
13535,SpokaneStBridge,07/18/2015 11:00:00 PM,48,-122,1,6,7
13536,SpokaneStBridge,07/19/2015 12:00:00 AM,48,-122,1,5,6
13537,SpokaneStBridge,07/19/2015 01:00:00 AM,48,-122,3,3,6
13538,SpokaneStBridge,07/19/2015 02:00:00 AM,48,-122,0,1,1
13539,SpokaneStBridge,07/19/2015 03:00:00 AM,48,-122,0,0,0
13540,SpokaneStBridge,07/19/2015 04:00:00 AM,48,-122,0,2,2
13541,SpokaneStBridge,07/19/2015 05:00:00 AM,48,-122,6,2,8
13542,SpokaneStBridge,07/19/2015 06:00:00 AM,48,-122,6,8,14
13543,SpokaneStBridge,07/19/2015 07:00:00 AM,48,-122,15,12,27
13544,SpokaneStBridge,07/19/2015 08:00:00 AM,48,-122,22,14,36
13545,SpokaneStBridge,07/19/2015 09:00:00 AM,48,-122,33,28,61
13546,SpokaneStBridge,07/19/2015 10:00:00 AM,48,-122,43,42,85
13547,SpokaneStBridge,07/19/2015 11:00:00 AM,48,-122,39,28,67
13548,SpokaneStBridge,07/19/2015 12:00:00 PM,48,-122,35,45,80
13549,SpokaneStBridge,07/19/2015 01:00:00 PM,48,-122,46,34,80
13550,SpokaneStBridge,07/19/2015 02:00:00 PM,48,-122,20,28,48
13551,SpokaneStBridge,07/19/2015 03:00:00 PM,48,-122,18,23,41
13552,SpokaneStBridge,07/19/2015 04:00:00 PM,48,-122,21,29,50
13553,SpokaneStBridge,07/19/2015 05:00:00 PM,48,-122,21,18,39
13554,SpokaneStBridge,07/19/2015 06:00:00 PM,48,-122,14,17,31
13555,SpokaneStBridge,07/19/2015 07:00:00 PM,48,-122,9,13,22
13556,SpokaneStBridge,07/19/2015 08:00:00 PM,48,-122,12,9,21
13557,SpokaneStBridge,07/19/2015 09:00:00 PM,48,-122,3,4,7
13558,SpokaneStBridge,07/19/2015 10:00:00 PM,48,-122,4,4,8
13559,SpokaneStBridge,07/19/2015 11:00:00 PM,48,-122,2,2,4
13560,SpokaneStBridge,07/20/2015 12:00:00 AM,48,-122,1,0,1
13561,SpokaneStBridge,07/20/2015 01:00:00 AM,48,-122,1,3,4
13562,SpokaneStBridge,07/20/2015 02:00:00 AM,48,-122,1,3,4
13563,SpokaneStBridge,07/20/2015 03:00:00 AM,48,-122,0,1,1
13564,SpokaneStBridge,07/20/2015 04:00:00 AM,48,-122,4,2,6
13565,SpokaneStBridge,07/20/2015 05:00:00 AM,48,-122,13,6,19
13566,SpokaneStBridge,07/20/2015 06:00:00 AM,48,-122,65,13,78
13567,SpokaneStBridge,07/20/2015 07:00:00 AM,48,-122,136,16,152
13568,SpokaneStBridge,07/20/2015 08:00:00 AM,48,-122,134,22,156
13569,SpokaneStBridge,07/20/2015 09:00:00 AM,48,-122,36,9,45
13570,SpokaneStBridge,07/20/2015 10:00:00 AM,48,-122,20,8,28
13571,SpokaneStBridge,07/20/2015 11:00:00 AM,48,-122,16,9,25
13572,SpokaneStBridge,07/20/2015 12:00:00 PM,48,-122,10,18,28
13573,SpokaneStBridge,07/20/2015 01:00:00 PM,48,-122,13,7,20
13574,SpokaneStBridge,07/20/2015 02:00:00 PM,48,-122,19,18,37
13575,SpokaneStBridge,07/20/2015 03:00:00 PM,48,-122,14,32,46
13576,SpokaneStBridge,07/20/2015 04:00:00 PM,48,-122,25,82,107
13577,SpokaneStBridge,07/20/2015 05:00:00 PM,48,-122,25,171,196
13578,SpokaneStBridge,07/20/2015 06:00:00 PM,48,-122,15,115,130
13579,SpokaneStBridge,07/20/2015 07:00:00 PM,48,-122,16,43,59
13580,SpokaneStBridge,07/20/2015 08:00:00 PM,48,-122,11,27,38
13581,SpokaneStBridge,07/20/2015 09:00:00 PM,48,-122,5,9,14
13582,SpokaneStBridge,07/20/2015 10:00:00 PM,48,-122,5,6,11
13583,SpokaneStBridge,07/20/2015 11:00:00 PM,48,-122,2,7,9
13584,SpokaneStBridge,07/21/2015 12:00:00 AM,48,-122,1,1,2
13585,SpokaneStBridge,07/21/2015 01:00:00 AM,48,-122,0,4,4
13586,SpokaneStBridge,07/21/2015 02:00:00 AM,48,-122,3,1,4
13587,SpokaneStBridge,07/21/2015 03:00:00 AM,48,-122,0,1,1
13588,SpokaneStBridge,07/21/2015 04:00:00 AM,48,-122,5,2,7
13589,SpokaneStBridge,07/21/2015 05:00:00 AM,48,-122,22,4,26
13590,SpokaneStBridge,07/21/2015 06:00:00 AM,48,-122,46,9,55
13591,SpokaneStBridge,07/21/2015 07:00:00 AM,48,-122,126,18,144
13592,SpokaneStBridge,07/21/2015 08:00:00 AM,48,-122,105,13,118
13593,SpokaneStBridge,07/21/2015 09:00:00 AM,48,-122,34,10,44
13594,SpokaneStBridge,07/21/2015 10:00:00 AM,48,-122,22,7,29
13595,SpokaneStBridge,07/21/2015 11:00:00 AM,48,-122,13,6,19
13596,SpokaneStBridge,07/21/2015 12:00:00 PM,48,-122,14,12,26
13597,SpokaneStBridge,07/21/2015 01:00:00 PM,48,-122,17,7,24
13598,SpokaneStBridge,07/21/2015 02:00:00 PM,48,-122,11,14,25
13599,SpokaneStBridge,07/21/2015 03:00:00 PM,48,-122,13,31,44
13600,SpokaneStBridge,07/21/2015 04:00:00 PM,48,-122,17,63,80
13601,SpokaneStBridge,07/21/2015 05:00:00 PM,48,-122,23,134,157
13602,SpokaneStBridge,07/21/2015 06:00:00 PM,48,-122,21,101,122
13603,SpokaneStBridge,07/21/2015 07:00:00 PM,48,-122,21,48,69
13604,SpokaneStBridge,07/21/2015 08:00:00 PM,48,-122,11,24,35
13605,SpokaneStBridge,07/21/2015 09:00:00 PM,48,-122,7,15,22
13606,SpokaneStBridge,07/21/2015 10:00:00 PM,48,-122,2,5,7
13607,SpokaneStBridge,07/21/2015 11:00:00 PM,48,-122,1,7,8
13608,SpokaneStBridge,07/22/2015 12:00:00 AM,48,-122,0,0,0
13609,SpokaneStBridge,07/22/2015 01:00:00 AM,48,-122,1,1,2
13610,SpokaneStBridge,07/22/2015 02:00:00 AM,48,-122,1,2,3
13611,SpokaneStBridge,07/22/2015 03:00:00 AM,48,-122,0,3,3
13612,SpokaneStBridge,07/22/2015 04:00:00 AM,48,-122,4,1,5
13613,SpokaneStBridge,07/22/2015 05:00:00 AM,48,-122,27,4,31
13614,SpokaneStBridge,07/22/2015 06:00:00 AM,48,-122,79,9,88
13615,SpokaneStBridge,07/22/2015 07:00:00 AM,48,-122,167,11,178
13616,SpokaneStBridge,07/22/2015 08:00:00 AM,48,-122,135,25,160
13617,SpokaneStBridge,07/22/2015 09:00:00 AM,48,-122,54,12,66
13618,SpokaneStBridge,07/22/2015 10:00:00 AM,48,-122,25,11,36
13619,SpokaneStBridge,07/22/2015 11:00:00 AM,48,-122,22,14,36
13620,SpokaneStBridge,07/22/2015 12:00:00 PM,48,-122,17,20,37
13621,SpokaneStBridge,07/22/2015 01:00:00 PM,48,-122,18,14,32
13622,SpokaneStBridge,07/22/2015 02:00:00 PM,48,-122,10,23,33
13623,SpokaneStBridge,07/22/2015 03:00:00 PM,48,-122,25,48,73
13624,SpokaneStBridge,07/22/2015 04:00:00 PM,48,-122,22,95,117
13625,SpokaneStBridge,07/22/2015 05:00:00 PM,48,-122,29,171,200
13626,SpokaneStBridge,07/22/2015 06:00:00 PM,48,-122,30,135,165
13627,SpokaneStBridge,07/22/2015 07:00:00 PM,48,-122,14,58,72
13628,SpokaneStBridge,07/22/2015 08:00:00 PM,48,-122,18,25,43
13629,SpokaneStBridge,07/22/2015 09:00:00 PM,48,-122,5,16,21
13630,SpokaneStBridge,07/22/2015 10:00:00 PM,48,-122,2,7,9
13631,SpokaneStBridge,07/22/2015 11:00:00 PM,48,-122,4,3,7
13632,SpokaneStBridge,07/23/2015 12:00:00 AM,48,-122,1,3,4
13633,SpokaneStBridge,07/23/2015 01:00:00 AM,48,-122,0,0,0
13634,SpokaneStBridge,07/23/2015 02:00:00 AM,48,-122,0,1,1
13635,SpokaneStBridge,07/23/2015 03:00:00 AM,48,-122,1,1,2
13636,SpokaneStBridge,07/23/2015 04:00:00 AM,48,-122,3,1,4
13637,SpokaneStBridge,07/23/2015 05:00:00 AM,48,-122,26,5,31
13638,SpokaneStBridge,07/23/2015 06:00:00 AM,48,-122,75,10,85
13639,SpokaneStBridge,07/23/2015 07:00:00 AM,48,-122,161,21,182
13640,SpokaneStBridge,07/23/2015 08:00:00 AM,48,-122,117,15,132
13641,SpokaneStBridge,07/23/2015 09:00:00 AM,48,-122,52,11,63
13642,SpokaneStBridge,07/23/2015 10:00:00 AM,48,-122,20,7,27
13643,SpokaneStBridge,07/23/2015 11:00:00 AM,48,-122,12,7,19
13644,SpokaneStBridge,07/23/2015 12:00:00 PM,48,-122,21,19,40
13645,SpokaneStBridge,07/23/2015 01:00:00 PM,48,-122,14,15,29
13646,SpokaneStBridge,07/23/2015 02:00:00 PM,48,-122,16,28,44
13647,SpokaneStBridge,07/23/2015 03:00:00 PM,48,-122,19,45,64
13648,SpokaneStBridge,07/23/2015 04:00:00 PM,48,-122,25,77,102
13649,SpokaneStBridge,07/23/2015 05:00:00 PM,48,-122,31,158,189
13650,SpokaneStBridge,07/23/2015 06:00:00 PM,48,-122,18,103,121
13651,SpokaneStBridge,07/23/2015 07:00:00 PM,48,-122,18,47,65
13652,SpokaneStBridge,07/23/2015 08:00:00 PM,48,-122,11,22,33
13653,SpokaneStBridge,07/23/2015 09:00:00 PM,48,-122,3,11,14
13654,SpokaneStBridge,07/23/2015 10:00:00 PM,48,-122,5,18,23
13655,SpokaneStBridge,07/23/2015 11:00:00 PM,48,-122,0,6,6
13656,SpokaneStBridge,07/24/2015 12:00:00 AM,48,-122,0,1,1
13657,SpokaneStBridge,07/24/2015 01:00:00 AM,48,-122,0,4,4
13658,SpokaneStBridge,07/24/2015 02:00:00 AM,48,-122,1,2,3
13659,SpokaneStBridge,07/24/2015 03:00:00 AM,48,-122,5,1,6
13660,SpokaneStBridge,07/24/2015 04:00:00 AM,48,-122,1,2,3
13661,SpokaneStBridge,07/24/2015 05:00:00 AM,48,-122,14,4,18
13662,SpokaneStBridge,07/24/2015 06:00:00 AM,48,-122,64,9,73
13663,SpokaneStBridge,07/24/2015 07:00:00 AM,48,-122,117,11,128
13664,SpokaneStBridge,07/24/2015 08:00:00 AM,48,-122,80,24,104
13665,SpokaneStBridge,07/24/2015 09:00:00 AM,48,-122,36,8,44
13666,SpokaneStBridge,07/24/2015 10:00:00 AM,48,-122,16,7,23
13667,SpokaneStBridge,07/24/2015 11:00:00 AM,48,-122,10,3,13
13668,SpokaneStBridge,07/24/2015 12:00:00 PM,48,-122,16,7,23
13669,SpokaneStBridge,07/24/2015 01:00:00 PM,48,-122,17,15,32
13670,SpokaneStBridge,07/24/2015 02:00:00 PM,48,-122,11,22,33
13671,SpokaneStBridge,07/24/2015 03:00:00 PM,48,-122,20,35,55
13672,SpokaneStBridge,07/24/2015 04:00:00 PM,48,-122,21,77,98
13673,SpokaneStBridge,07/24/2015 05:00:00 PM,48,-122,15,105,120
13674,SpokaneStBridge,07/24/2015 06:00:00 PM,48,-122,19,54,73
13675,SpokaneStBridge,07/24/2015 07:00:00 PM,48,-122,7,34,41
13676,SpokaneStBridge,07/24/2015 08:00:00 PM,48,-122,9,16,25
13677,SpokaneStBridge,07/24/2015 09:00:00 PM,48,-122,3,12,15
13678,SpokaneStBridge,07/24/2015 10:00:00 PM,48,-122,2,7,9
13679,SpokaneStBridge,07/24/2015 11:00:00 PM,48,-122,2,9,11
13680,SpokaneStBridge,07/25/2015 12:00:00 AM,48,-122,3,8,11
13681,SpokaneStBridge,07/25/2015 01:00:00 AM,48,-122,0,3,3
13682,SpokaneStBridge,07/25/2015 02:00:00 AM,48,-122,0,0,0
13683,SpokaneStBridge,07/25/2015 03:00:00 AM,48,-122,1,0,1
13684,SpokaneStBridge,07/25/2015 04:00:00 AM,48,-122,0,0,0
13685,SpokaneStBridge,07/25/2015 05:00:00 AM,48,-122,2,2,4
13686,SpokaneStBridge,07/25/2015 06:00:00 AM,48,-122,8,1,9
13687,SpokaneStBridge,07/25/2015 07:00:00 AM,48,-122,5,4,9
13688,SpokaneStBridge,07/25/2015 08:00:00 AM,48,-122,23,9,32
13689,SpokaneStBridge,07/25/2015 09:00:00 AM,48,-122,19,22,41
13690,SpokaneStBridge,07/25/2015 10:00:00 AM,48,-122,27,15,42
13691,SpokaneStBridge,07/25/2015 11:00:00 AM,48,-122,34,12,46
13692,SpokaneStBridge,07/25/2015 12:00:00 PM,48,-122,13,20,33
13693,SpokaneStBridge,07/25/2015 01:00:00 PM,48,-122,23,13,36
13694,SpokaneStBridge,07/25/2015 02:00:00 PM,48,-122,13,24,37
13695,SpokaneStBridge,07/25/2015 03:00:00 PM,48,-122,18,24,42
13696,SpokaneStBridge,07/25/2015 04:00:00 PM,48,-122,11,11,22
13697,SpokaneStBridge,07/25/2015 05:00:00 PM,48,-122,12,21,33
13698,SpokaneStBridge,07/25/2015 06:00:00 PM,48,-122,12,12,24
13699,SpokaneStBridge,07/25/2015 07:00:00 PM,48,-122,10,18,28
13700,SpokaneStBridge,07/25/2015 08:00:00 PM,48,-122,1,7,8
13701,SpokaneStBridge,07/25/2015 09:00:00 PM,48,-122,0,6,6
13702,SpokaneStBridge,07/25/2015 10:00:00 PM,48,-122,0,4,4
13703,SpokaneStBridge,07/25/2015 11:00:00 PM,48,-122,1,4,5
13704,SpokaneStBridge,07/26/2015 12:00:00 AM,48,-122,4,3,7
13705,SpokaneStBridge,07/26/2015 01:00:00 AM,48,-122,0,3,3
13706,SpokaneStBridge,07/26/2015 02:00:00 AM,48,-122,0,0,0
13707,SpokaneStBridge,07/26/2015 03:00:00 AM,48,-122,0,2,2
13708,SpokaneStBridge,07/26/2015 04:00:00 AM,48,-122,1,1,2
13709,SpokaneStBridge,07/26/2015 05:00:00 AM,48,-122,3,3,6
13710,SpokaneStBridge,07/26/2015 06:00:00 AM,48,-122,6,5,11
13711,SpokaneStBridge,07/26/2015 07:00:00 AM,48,-122,11,7,18
13712,SpokaneStBridge,07/26/2015 08:00:00 AM,48,-122,22,7,29
13713,SpokaneStBridge,07/26/2015 09:00:00 AM,48,-122,21,13,34
13714,SpokaneStBridge,07/26/2015 10:00:00 AM,48,-122,20,20,40
13715,SpokaneStBridge,07/26/2015 11:00:00 AM,48,-122,20,22,42
13716,SpokaneStBridge,07/26/2015 12:00:00 PM,48,-122,19,25,44
13717,SpokaneStBridge,07/26/2015 01:00:00 PM,48,-122,25,22,47
13718,SpokaneStBridge,07/26/2015 02:00:00 PM,48,-122,27,27,54
13719,SpokaneStBridge,07/26/2015 03:00:00 PM,48,-122,24,19,43
13720,SpokaneStBridge,07/26/2015 04:00:00 PM,48,-122,11,18,29
13721,SpokaneStBridge,07/26/2015 05:00:00 PM,48,-122,3,10,13
13722,SpokaneStBridge,07/26/2015 06:00:00 PM,48,-122,4,7,11
13723,SpokaneStBridge,07/26/2015 07:00:00 PM,48,-122,4,9,13
13724,SpokaneStBridge,07/26/2015 08:00:00 PM,48,-122,0,3,3
13725,SpokaneStBridge,07/26/2015 09:00:00 PM,48,-122,2,6,8
13726,SpokaneStBridge,07/26/2015 10:00:00 PM,48,-122,1,1,2
13727,SpokaneStBridge,07/26/2015 11:00:00 PM,48,-122,1,1,2
13728,SpokaneStBridge,07/27/2015 12:00:00 AM,48,-122,1,0,1
13729,SpokaneStBridge,07/27/2015 01:00:00 AM,48,-122,0,0,0
13730,SpokaneStBridge,07/27/2015 02:00:00 AM,48,-122,0,1,1
13731,SpokaneStBridge,07/27/2015 03:00:00 AM,48,-122,1,0,1
13732,SpokaneStBridge,07/27/2015 04:00:00 AM,48,-122,6,1,7
13733,SpokaneStBridge,07/27/2015 05:00:00 AM,48,-122,20,5,25
13734,SpokaneStBridge,07/27/2015 06:00:00 AM,48,-122,63,13,76
13735,SpokaneStBridge,07/27/2015 07:00:00 AM,48,-122,128,16,144
13736,SpokaneStBridge,07/27/2015 08:00:00 AM,48,-122,119,19,138
13737,SpokaneStBridge,07/27/2015 09:00:00 AM,48,-122,46,6,52
13738,SpokaneStBridge,07/27/2015 10:00:00 AM,48,-122,18,8,26
13739,SpokaneStBridge,07/27/2015 11:00:00 AM,48,-122,22,11,33
13740,SpokaneStBridge,07/27/2015 12:00:00 PM,48,-122,19,15,34
13741,SpokaneStBridge,07/27/2015 01:00:00 PM,48,-122,13,12,25
13742,SpokaneStBridge,07/27/2015 02:00:00 PM,48,-122,18,17,35
13743,SpokaneStBridge,07/27/2015 03:00:00 PM,48,-122,17,34,51
13744,SpokaneStBridge,07/27/2015 04:00:00 PM,48,-122,23,86,109
13745,SpokaneStBridge,07/27/2015 05:00:00 PM,48,-122,21,157,178
13746,SpokaneStBridge,07/27/2015 06:00:00 PM,48,-122,16,100,116
13747,SpokaneStBridge,07/27/2015 07:00:00 PM,48,-122,14,53,67
13748,SpokaneStBridge,07/27/2015 08:00:00 PM,48,-122,9,14,23
13749,SpokaneStBridge,07/27/2015 09:00:00 PM,48,-122,5,12,17
13750,SpokaneStBridge,07/27/2015 10:00:00 PM,48,-122,6,4,10
13751,SpokaneStBridge,07/27/2015 11:00:00 PM,48,-122,3,6,9
13752,SpokaneStBridge,07/28/2015 12:00:00 AM,48,-122,1,2,3
13753,SpokaneStBridge,07/28/2015 01:00:00 AM,48,-122,2,3,5
13754,SpokaneStBridge,07/28/2015 02:00:00 AM,48,-122,2,1,3
13755,SpokaneStBridge,07/28/2015 03:00:00 AM,48,-122,0,4,4
13756,SpokaneStBridge,07/28/2015 04:00:00 AM,48,-122,2,1,3
13757,SpokaneStBridge,07/28/2015 05:00:00 AM,48,-122,26,5,31
13758,SpokaneStBridge,07/28/2015 06:00:00 AM,48,-122,90,10,100
13759,SpokaneStBridge,07/28/2015 07:00:00 AM,48,-122,164,18,182
13760,SpokaneStBridge,07/28/2015 08:00:00 AM,48,-122,145,25,170
13761,SpokaneStBridge,07/28/2015 09:00:00 AM,48,-122,56,16,72
13762,SpokaneStBridge,07/28/2015 10:00:00 AM,48,-122,29,7,36
13763,SpokaneStBridge,07/28/2015 11:00:00 AM,48,-122,22,11,33
13764,SpokaneStBridge,07/28/2015 12:00:00 PM,48,-122,14,11,25
13765,SpokaneStBridge,07/28/2015 01:00:00 PM,48,-122,18,15,33
13766,SpokaneStBridge,07/28/2015 02:00:00 PM,48,-122,6,24,30
13767,SpokaneStBridge,07/28/2015 03:00:00 PM,48,-122,24,45,69
13768,SpokaneStBridge,07/28/2015 04:00:00 PM,48,-122,32,95,127
13769,SpokaneStBridge,07/28/2015 05:00:00 PM,48,-122,21,171,192
13770,SpokaneStBridge,07/28/2015 06:00:00 PM,48,-122,31,154,185
13771,SpokaneStBridge,07/28/2015 07:00:00 PM,48,-122,23,68,91
13772,SpokaneStBridge,07/28/2015 08:00:00 PM,48,-122,17,21,38
13773,SpokaneStBridge,07/28/2015 09:00:00 PM,48,-122,16,27,43
13774,SpokaneStBridge,07/28/2015 10:00:00 PM,48,-122,3,16,19
13775,SpokaneStBridge,07/28/2015 11:00:00 PM,48,-122,3,5,8
13776,SpokaneStBridge,07/29/2015 12:00:00 AM,48,-122,0,0,0
13777,SpokaneStBridge,07/29/2015 01:00:00 AM,48,-122,3,0,3
13778,SpokaneStBridge,07/29/2015 02:00:00 AM,48,-122,1,0,1
13779,SpokaneStBridge,07/29/2015 03:00:00 AM,48,-122,1,1,2
13780,SpokaneStBridge,07/29/2015 04:00:00 AM,48,-122,6,1,7
13781,SpokaneStBridge,07/29/2015 05:00:00 AM,48,-122,26,7,33
13782,SpokaneStBridge,07/29/2015 06:00:00 AM,48,-122,92,14,106
13783,SpokaneStBridge,07/29/2015 07:00:00 AM,48,-122,102,15,117
13784,SpokaneStBridge,07/29/2015 08:00:00 AM,48,-122,204,27,231
13785,SpokaneStBridge,07/29/2015 09:00:00 AM,48,-122,66,15,81
13786,SpokaneStBridge,07/29/2015 10:00:00 AM,48,-122,37,11,48
13787,SpokaneStBridge,07/29/2015 11:00:00 AM,48,-122,10,22,32
13788,SpokaneStBridge,07/29/2015 12:00:00 PM,48,-122,29,9,38
13789,SpokaneStBridge,07/29/2015 01:00:00 PM,48,-122,32,24,56
13790,SpokaneStBridge,07/29/2015 02:00:00 PM,48,-122,15,30,45
13791,SpokaneStBridge,07/29/2015 03:00:00 PM,48,-122,17,46,63
13792,SpokaneStBridge,07/29/2015 04:00:00 PM,48,-122,24,92,116
13793,SpokaneStBridge,07/29/2015 05:00:00 PM,48,-122,32,191,223
13794,SpokaneStBridge,07/29/2015 06:00:00 PM,48,-122,32,120,152
13795,SpokaneStBridge,07/29/2015 07:00:00 PM,48,-122,30,72,102
13796,SpokaneStBridge,07/29/2015 08:00:00 PM,48,-122,11,29,40
13797,SpokaneStBridge,07/29/2015 09:00:00 PM,48,-122,12,12,24
13798,SpokaneStBridge,07/29/2015 10:00:00 PM,48,-122,7,9,16
13799,SpokaneStBridge,07/29/2015 11:00:00 PM,48,-122,5,7,12
13800,SpokaneStBridge,07/30/2015 12:00:00 AM,48,-122,0,2,2
13801,SpokaneStBridge,07/30/2015 01:00:00 AM,48,-122,2,1,3
13802,SpokaneStBridge,07/30/2015 02:00:00 AM,48,-122,1,1,2
13803,SpokaneStBridge,07/30/2015 03:00:00 AM,48,-122,1,2,3
13804,SpokaneStBridge,07/30/2015 04:00:00 AM,48,-122,7,1,8
13805,SpokaneStBridge,07/30/2015 05:00:00 AM,48,-122,21,10,31
13806,SpokaneStBridge,07/30/2015 06:00:00 AM,48,-122,76,5,81
13807,SpokaneStBridge,07/30/2015 07:00:00 AM,48,-122,151,15,166
13808,SpokaneStBridge,07/30/2015 08:00:00 AM,48,-122,148,22,170
13809,SpokaneStBridge,07/30/2015 09:00:00 AM,48,-122,57,19,76
13810,SpokaneStBridge,07/30/2015 10:00:00 AM,48,-122,21,17,38
13811,SpokaneStBridge,07/30/2015 11:00:00 AM,48,-122,23,7,30
13812,SpokaneStBridge,07/30/2015 12:00:00 PM,48,-122,13,23,36
13813,SpokaneStBridge,07/30/2015 01:00:00 PM,48,-122,19,18,37
13814,SpokaneStBridge,07/30/2015 02:00:00 PM,48,-122,14,17,31
13815,SpokaneStBridge,07/30/2015 03:00:00 PM,48,-122,20,41,61
13816,SpokaneStBridge,07/30/2015 04:00:00 PM,48,-122,19,77,96
13817,SpokaneStBridge,07/30/2015 05:00:00 PM,48,-122,21,153,174
13818,SpokaneStBridge,07/30/2015 06:00:00 PM,48,-122,18,114,132
13819,SpokaneStBridge,07/30/2015 07:00:00 PM,48,-122,20,57,77
13820,SpokaneStBridge,07/30/2015 08:00:00 PM,48,-122,18,23,41
13821,SpokaneStBridge,07/30/2015 09:00:00 PM,48,-122,12,21,33
13822,SpokaneStBridge,07/30/2015 10:00:00 PM,48,-122,11,12,23
13823,SpokaneStBridge,07/30/2015 11:00:00 PM,48,-122,0,5,5
13824,SpokaneStBridge,07/31/2015 12:00:00 AM,48,-122,0,6,6
13825,SpokaneStBridge,07/31/2015 01:00:00 AM,48,-122,3,3,6
13826,SpokaneStBridge,07/31/2015 02:00:00 AM,48,-122,2,1,3
13827,SpokaneStBridge,07/31/2015 03:00:00 AM,48,-122,3,1,4
13828,SpokaneStBridge,07/31/2015 04:00:00 AM,48,-122,2,1,3
13829,SpokaneStBridge,07/31/2015 05:00:00 AM,48,-122,24,4,28
13830,SpokaneStBridge,07/31/2015 06:00:00 AM,48,-122,64,5,69
13831,SpokaneStBridge,07/31/2015 07:00:00 AM,48,-122,106,15,121
13832,SpokaneStBridge,07/31/2015 08:00:00 AM,48,-122,107,13,120
13833,SpokaneStBridge,07/31/2015 09:00:00 AM,48,-122,49,11,60
13834,SpokaneStBridge,07/31/2015 10:00:00 AM,48,-122,28,18,46
13835,SpokaneStBridge,07/31/2015 11:00:00 AM,48,-122,25,15,40
13836,SpokaneStBridge,07/31/2015 12:00:00 PM,48,-122,20,19,39
13837,SpokaneStBridge,07/31/2015 01:00:00 PM,48,-122,16,25,41
13838,SpokaneStBridge,07/31/2015 02:00:00 PM,48,-122,16,20,36
13839,SpokaneStBridge,07/31/2015 03:00:00 PM,48,-122,19,52,71
13840,SpokaneStBridge,07/31/2015 04:00:00 PM,48,-122,21,100,121
13841,SpokaneStBridge,07/31/2015 05:00:00 PM,48,-122,22,124,146
13842,SpokaneStBridge,07/31/2015 06:00:00 PM,48,-122,16,55,71
13843,SpokaneStBridge,07/31/2015 07:00:00 PM,48,-122,17,33,50
13844,SpokaneStBridge,07/31/2015 08:00:00 PM,48,-122,7,17,24
13845,SpokaneStBridge,07/31/2015 09:00:00 PM,48,-122,7,11,18
13846,SpokaneStBridge,07/31/2015 10:00:00 PM,48,-122,0,7,7
13847,SpokaneStBridge,07/31/2015 11:00:00 PM,48,-122,1,7,8
13848,SpokaneStBridge,08/01/2015 12:00:00 AM,48,-122,4,5,9
13849,SpokaneStBridge,08/01/2015 01:00:00 AM,48,-122,4,3,7
13850,SpokaneStBridge,08/01/2015 02:00:00 AM,48,-122,0,1,1
13851,SpokaneStBridge,08/01/2015 03:00:00 AM,48,-122,1,0,1
13852,SpokaneStBridge,08/01/2015 04:00:00 AM,48,-122,1,1,2
13853,SpokaneStBridge,08/01/2015 05:00:00 AM,48,-122,6,2,8
13854,SpokaneStBridge,08/01/2015 06:00:00 AM,48,-122,14,6,20
13855,SpokaneStBridge,08/01/2015 07:00:00 AM,48,-122,15,9,24
13856,SpokaneStBridge,08/01/2015 08:00:00 AM,48,-122,16,19,35
13857,SpokaneStBridge,08/01/2015 09:00:00 AM,48,-122,34,22,56
13858,SpokaneStBridge,08/01/2015 10:00:00 AM,48,-122,41,32,73
13859,SpokaneStBridge,08/01/2015 11:00:00 AM,48,-122,43,37,80
13860,SpokaneStBridge,08/01/2015 12:00:00 PM,48,-122,45,33,78
13861,SpokaneStBridge,08/01/2015 01:00:00 PM,48,-122,27,32,59
13862,SpokaneStBridge,08/01/2015 02:00:00 PM,48,-122,37,44,81
13863,SpokaneStBridge,08/01/2015 03:00:00 PM,48,-122,37,42,79
13864,SpokaneStBridge,08/01/2015 04:00:00 PM,48,-122,15,28,43
13865,SpokaneStBridge,08/01/2015 05:00:00 PM,48,-122,27,38,65
13866,SpokaneStBridge,08/01/2015 06:00:00 PM,48,-122,17,18,35
13867,SpokaneStBridge,08/01/2015 07:00:00 PM,48,-122,11,12,23
13868,SpokaneStBridge,08/01/2015 08:00:00 PM,48,-122,6,10,16
13869,SpokaneStBridge,08/01/2015 09:00:00 PM,48,-122,4,17,21
13870,SpokaneStBridge,08/01/2015 10:00:00 PM,48,-122,1,7,8
13871,SpokaneStBridge,08/01/2015 11:00:00 PM,48,-122,1,6,7
13872,SpokaneStBridge,08/02/2015 12:00:00 AM,48,-122,2,3,5
13873,SpokaneStBridge,08/02/2015 01:00:00 AM,48,-122,1,1,2
13874,SpokaneStBridge,08/02/2015 02:00:00 AM,48,-122,2,2,4
13875,SpokaneStBridge,08/02/2015 03:00:00 AM,48,-122,0,2,2
13876,SpokaneStBridge,08/02/2015 04:00:00 AM,48,-122,6,2,8
13877,SpokaneStBridge,08/02/2015 05:00:00 AM,48,-122,5,2,7
13878,SpokaneStBridge,08/02/2015 06:00:00 AM,48,-122,8,1,9
13879,SpokaneStBridge,08/02/2015 07:00:00 AM,48,-122,18,16,34
13880,SpokaneStBridge,08/02/2015 08:00:00 AM,48,-122,26,27,53
13881,SpokaneStBridge,08/02/2015 09:00:00 AM,48,-122,26,19,45
13882,SpokaneStBridge,08/02/2015 10:00:00 AM,48,-122,50,31,81
13883,SpokaneStBridge,08/02/2015 11:00:00 AM,48,-122,28,26,54
13884,SpokaneStBridge,08/02/2015 12:00:00 PM,48,-122,38,31,69
13885,SpokaneStBridge,08/02/2015 01:00:00 PM,48,-122,23,25,48
13886,SpokaneStBridge,08/02/2015 02:00:00 PM,48,-122,33,42,75
13887,SpokaneStBridge,08/02/2015 03:00:00 PM,48,-122,34,43,77
13888,SpokaneStBridge,08/02/2015 04:00:00 PM,48,-122,30,33,63
13889,SpokaneStBridge,08/02/2015 05:00:00 PM,48,-122,23,21,44
13890,SpokaneStBridge,08/02/2015 06:00:00 PM,48,-122,16,30,46
13891,SpokaneStBridge,08/02/2015 07:00:00 PM,48,-122,11,10,21
13892,SpokaneStBridge,08/02/2015 08:00:00 PM,48,-122,11,12,23
13893,SpokaneStBridge,08/02/2015 09:00:00 PM,48,-122,3,8,11
13894,SpokaneStBridge,08/02/2015 10:00:00 PM,48,-122,3,6,9
13895,SpokaneStBridge,08/02/2015 11:00:00 PM,48,-122,2,6,8
13896,SpokaneStBridge,08/03/2015 12:00:00 AM,48,-122,0,0,0
13897,SpokaneStBridge,08/03/2015 01:00:00 AM,48,-122,0,1,1
13898,SpokaneStBridge,08/03/2015 02:00:00 AM,48,-122,1,2,3
13899,SpokaneStBridge,08/03/2015 03:00:00 AM,48,-122,1,3,4
13900,SpokaneStBridge,08/03/2015 04:00:00 AM,48,-122,9,4,13
13901,SpokaneStBridge,08/03/2015 05:00:00 AM,48,-122,18,6,24
13902,SpokaneStBridge,08/03/2015 06:00:00 AM,48,-122,82,12,94
13903,SpokaneStBridge,08/03/2015 07:00:00 AM,48,-122,116,16,132
13904,SpokaneStBridge,08/03/2015 08:00:00 AM,48,-122,142,21,163
13905,SpokaneStBridge,08/03/2015 09:00:00 AM,48,-122,48,6,54
13906,SpokaneStBridge,08/03/2015 10:00:00 AM,48,-122,26,8,34
13907,SpokaneStBridge,08/03/2015 11:00:00 AM,48,-122,14,14,28
13908,SpokaneStBridge,08/03/2015 12:00:00 PM,48,-122,9,14,23
13909,SpokaneStBridge,08/03/2015 01:00:00 PM,48,-122,22,13,35
13910,SpokaneStBridge,08/03/2015 02:00:00 PM,48,-122,13,22,35
13911,SpokaneStBridge,08/03/2015 03:00:00 PM,48,-122,17,35,52
13912,SpokaneStBridge,08/03/2015 04:00:00 PM,48,-122,23,97,120
13913,SpokaneStBridge,08/03/2015 05:00:00 PM,48,-122,22,165,187
13914,SpokaneStBridge,08/03/2015 06:00:00 PM,48,-122,23,129,152
13915,SpokaneStBridge,08/03/2015 07:00:00 PM,48,-122,20,42,62
13916,SpokaneStBridge,08/03/2015 08:00:00 PM,48,-122,17,23,40
13917,SpokaneStBridge,08/03/2015 09:00:00 PM,48,-122,17,12,29
13918,SpokaneStBridge,08/03/2015 10:00:00 PM,48,-122,3,4,7
13919,SpokaneStBridge,08/03/2015 11:00:00 PM,48,-122,2,4,6
13920,SpokaneStBridge,08/04/2015 12:00:00 AM,48,-122,0,4,4
13921,SpokaneStBridge,08/04/2015 01:00:00 AM,48,-122,0,2,2
13922,SpokaneStBridge,08/04/2015 02:00:00 AM,48,-122,0,1,1
13923,SpokaneStBridge,08/04/2015 03:00:00 AM,48,-122,3,1,4
13924,SpokaneStBridge,08/04/2015 04:00:00 AM,48,-122,4,1,5
13925,SpokaneStBridge,08/04/2015 05:00:00 AM,48,-122,17,5,22
13926,SpokaneStBridge,08/04/2015 06:00:00 AM,48,-122,78,13,91
13927,SpokaneStBridge,08/04/2015 07:00:00 AM,48,-122,155,21,176
13928,SpokaneStBridge,08/04/2015 08:00:00 AM,48,-122,138,22,160
13929,SpokaneStBridge,08/04/2015 09:00:00 AM,48,-122,60,8,68
13930,SpokaneStBridge,08/04/2015 10:00:00 AM,48,-122,19,14,33
13931,SpokaneStBridge,08/04/2015 11:00:00 AM,48,-122,15,12,27
13932,SpokaneStBridge,08/04/2015 12:00:00 PM,48,-122,24,21,45
13933,SpokaneStBridge,08/04/2015 01:00:00 PM,48,-122,26,23,49
13934,SpokaneStBridge,08/04/2015 02:00:00 PM,48,-122,19,16,35
13935,SpokaneStBridge,08/04/2015 03:00:00 PM,48,-122,11,31,42
13936,SpokaneStBridge,08/04/2015 04:00:00 PM,48,-122,26,104,130
13937,SpokaneStBridge,08/04/2015 05:00:00 PM,48,-122,23,185,208
13938,SpokaneStBridge,08/04/2015 06:00:00 PM,48,-122,23,127,150
13939,SpokaneStBridge,08/04/2015 07:00:00 PM,48,-122,12,52,64
13940,SpokaneStBridge,08/04/2015 08:00:00 PM,48,-122,14,33,47
13941,SpokaneStBridge,08/04/2015 09:00:00 PM,48,-122,12,10,22
13942,SpokaneStBridge,08/04/2015 10:00:00 PM,48,-122,7,6,13
13943,SpokaneStBridge,08/04/2015 11:00:00 PM,48,-122,1,3,4
13944,SpokaneStBridge,08/05/2015 12:00:00 AM,48,-122,0,3,3
13945,SpokaneStBridge,08/05/2015 01:00:00 AM,48,-122,0,2,2
13946,SpokaneStBridge,08/05/2015 02:00:00 AM,48,-122,0,1,1
13947,SpokaneStBridge,08/05/2015 03:00:00 AM,48,-122,2,2,4
13948,SpokaneStBridge,08/05/2015 04:00:00 AM,48,-122,6,1,7
13949,SpokaneStBridge,08/05/2015 05:00:00 AM,48,-122,24,5,29
13950,SpokaneStBridge,08/05/2015 06:00:00 AM,48,-122,89,16,105
13951,SpokaneStBridge,08/05/2015 07:00:00 AM,48,-122,124,16,140
13952,SpokaneStBridge,08/05/2015 08:00:00 AM,48,-122,137,7,144
13953,SpokaneStBridge,08/05/2015 09:00:00 AM,48,-122,33,10,43
13954,SpokaneStBridge,08/05/2015 10:00:00 AM,48,-122,18,11,29
13955,SpokaneStBridge,08/05/2015 11:00:00 AM,48,-122,14,17,31
13956,SpokaneStBridge,08/05/2015 12:00:00 PM,48,-122,14,9,23
13957,SpokaneStBridge,08/05/2015 01:00:00 PM,48,-122,14,10,24
13958,SpokaneStBridge,08/05/2015 02:00:00 PM,48,-122,14,19,33
13959,SpokaneStBridge,08/05/2015 03:00:00 PM,48,-122,16,32,48
13960,SpokaneStBridge,08/05/2015 04:00:00 PM,48,-122,24,99,123
13961,SpokaneStBridge,08/05/2015 05:00:00 PM,48,-122,27,172,199
13962,SpokaneStBridge,08/05/2015 06:00:00 PM,48,-122,19,92,111
13963,SpokaneStBridge,08/05/2015 07:00:00 PM,48,-122,12,46,58
13964,SpokaneStBridge,08/05/2015 08:00:00 PM,48,-122,12,26,38
13965,SpokaneStBridge,08/05/2015 09:00:00 PM,48,-122,5,16,21
13966,SpokaneStBridge,08/05/2015 10:00:00 PM,48,-122,2,6,8
13967,SpokaneStBridge,08/05/2015 11:00:00 PM,48,-122,2,4,6
13968,SpokaneStBridge,08/06/2015 12:00:00 AM,48,-122,0,2,2
13969,SpokaneStBridge,08/06/2015 01:00:00 AM,48,-122,1,1,2
13970,SpokaneStBridge,08/06/2015 02:00:00 AM,48,-122,1,0,1
13971,SpokaneStBridge,08/06/2015 03:00:00 AM,48,-122,1,0,1
13972,SpokaneStBridge,08/06/2015 04:00:00 AM,48,-122,7,2,9
13973,SpokaneStBridge,08/06/2015 05:00:00 AM,48,-122,21,4,25
13974,SpokaneStBridge,08/06/2015 06:00:00 AM,48,-122,61,8,69
13975,SpokaneStBridge,08/06/2015 07:00:00 AM,48,-122,142,11,153
13976,SpokaneStBridge,08/06/2015 08:00:00 AM,48,-122,126,11,137
13977,SpokaneStBridge,08/06/2015 09:00:00 AM,48,-122,52,14,66
13978,SpokaneStBridge,08/06/2015 10:00:00 AM,48,-122,23,7,30
13979,SpokaneStBridge,08/06/2015 11:00:00 AM,48,-122,18,16,34
13980,SpokaneStBridge,08/06/2015 12:00:00 PM,48,-122,18,13,31
13981,SpokaneStBridge,08/06/2015 01:00:00 PM,48,-122,16,15,31
13982,SpokaneStBridge,08/06/2015 02:00:00 PM,48,-122,19,20,39
13983,SpokaneStBridge,08/06/2015 03:00:00 PM,48,-122,14,39,53
13984,SpokaneStBridge,08/06/2015 04:00:00 PM,48,-122,23,88,111
13985,SpokaneStBridge,08/06/2015 05:00:00 PM,48,-122,29,170,199
13986,SpokaneStBridge,08/06/2015 06:00:00 PM,48,-122,31,115,146
13987,SpokaneStBridge,08/06/2015 07:00:00 PM,48,-122,13,51,64
13988,SpokaneStBridge,08/06/2015 08:00:00 PM,48,-122,11,26,37
13989,SpokaneStBridge,08/06/2015 09:00:00 PM,48,-122,5,11,16
13990,SpokaneStBridge,08/06/2015 10:00:00 PM,48,-122,1,11,12
13991,SpokaneStBridge,08/06/2015 11:00:00 PM,48,-122,3,6,9
13992,SpokaneStBridge,08/07/2015 12:00:00 AM,48,-122,1,6,7
13993,SpokaneStBridge,08/07/2015 01:00:00 AM,48,-122,0,2,2
13994,SpokaneStBridge,08/07/2015 02:00:00 AM,48,-122,0,2,2
13995,SpokaneStBridge,08/07/2015 03:00:00 AM,48,-122,3,2,5
13996,SpokaneStBridge,08/07/2015 04:00:00 AM,48,-122,3,0,3
13997,SpokaneStBridge,08/07/2015 05:00:00 AM,48,-122,15,4,19
13998,SpokaneStBridge,08/07/2015 06:00:00 AM,48,-122,58,10,68
13999,SpokaneStBridge,08/07/2015 07:00:00 AM,48,-122,99,16,115
14000,SpokaneStBridge,08/07/2015 08:00:00 AM,48,-122,128,19,147
14001,SpokaneStBridge,08/07/2015 09:00:00 AM,48,-122,49,16,65
14002,SpokaneStBridge,08/07/2015 10:00:00 AM,48,-122,15,4,19
14003,SpokaneStBridge,08/07/2015 11:00:00 AM,48,-122,21,11,32
14004,SpokaneStBridge,08/07/2015 12:00:00 PM,48,-122,19,20,39
14005,SpokaneStBridge,08/07/2015 01:00:00 PM,48,-122,20,39,59
14006,SpokaneStBridge,08/07/2015 02:00:00 PM,48,-122,17,14,31
14007,SpokaneStBridge,08/07/2015 03:00:00 PM,48,-122,17,46,63
14008,SpokaneStBridge,08/07/2015 04:00:00 PM,48,-122,19,69,88
14009,SpokaneStBridge,08/07/2015 05:00:00 PM,48,-122,42,127,169
14010,SpokaneStBridge,08/07/2015 06:00:00 PM,48,-122,30,73,103
14011,SpokaneStBridge,08/07/2015 07:00:00 PM,48,-122,14,29,43
14012,SpokaneStBridge,08/07/2015 08:00:00 PM,48,-122,16,24,40
14013,SpokaneStBridge,08/07/2015 09:00:00 PM,48,-122,11,9,20
14014,SpokaneStBridge,08/07/2015 10:00:00 PM,48,-122,2,10,12
14015,SpokaneStBridge,08/07/2015 11:00:00 PM,48,-122,1,14,15
14016,SpokaneStBridge,08/08/2015 12:00:00 AM,48,-122,2,14,16
14017,SpokaneStBridge,08/08/2015 01:00:00 AM,48,-122,2,13,15
14018,SpokaneStBridge,08/08/2015 02:00:00 AM,48,-122,0,6,6
14019,SpokaneStBridge,08/08/2015 03:00:00 AM,48,-122,2,0,2
14020,SpokaneStBridge,08/08/2015 04:00:00 AM,48,-122,2,0,2
14021,SpokaneStBridge,08/08/2015 05:00:00 AM,48,-122,6,0,6
14022,SpokaneStBridge,08/08/2015 06:00:00 AM,48,-122,6,4,10
14023,SpokaneStBridge,08/08/2015 07:00:00 AM,48,-122,15,7,22
14024,SpokaneStBridge,08/08/2015 08:00:00 AM,48,-122,18,9,27
14025,SpokaneStBridge,08/08/2015 09:00:00 AM,48,-122,19,22,41
14026,SpokaneStBridge,08/08/2015 10:00:00 AM,48,-122,22,25,47
14027,SpokaneStBridge,08/08/2015 11:00:00 AM,48,-122,27,15,42
14028,SpokaneStBridge,08/08/2015 12:00:00 PM,48,-122,29,24,53
14029,SpokaneStBridge,08/08/2015 01:00:00 PM,48,-122,27,28,55
14030,SpokaneStBridge,08/08/2015 02:00:00 PM,48,-122,34,14,48
14031,SpokaneStBridge,08/08/2015 03:00:00 PM,48,-122,34,36,70
14032,SpokaneStBridge,08/08/2015 04:00:00 PM,48,-122,26,31,57
14033,SpokaneStBridge,08/08/2015 05:00:00 PM,48,-122,18,21,39
14034,SpokaneStBridge,08/08/2015 06:00:00 PM,48,-122,13,14,27
14035,SpokaneStBridge,08/08/2015 07:00:00 PM,48,-122,7,6,13
14036,SpokaneStBridge,08/08/2015 08:00:00 PM,48,-122,3,7,10
14037,SpokaneStBridge,08/08/2015 09:00:00 PM,48,-122,4,9,13
14038,SpokaneStBridge,08/08/2015 10:00:00 PM,48,-122,1,6,7
14039,SpokaneStBridge,08/08/2015 11:00:00 PM,48,-122,5,6,11
14040,SpokaneStBridge,08/09/2015 12:00:00 AM,48,-122,0,2,2
14041,SpokaneStBridge,08/09/2015 01:00:00 AM,48,-122,2,2,4
14042,SpokaneStBridge,08/09/2015 02:00:00 AM,48,-122,0,4,4
14043,SpokaneStBridge,08/09/2015 03:00:00 AM,48,-122,0,0,0
14044,SpokaneStBridge,08/09/2015 04:00:00 AM,48,-122,2,2,4
14045,SpokaneStBridge,08/09/2015 05:00:00 AM,48,-122,6,1,7
14046,SpokaneStBridge,08/09/2015 06:00:00 AM,48,-122,7,1,8
14047,SpokaneStBridge,08/09/2015 07:00:00 AM,48,-122,13,8,21
14048,SpokaneStBridge,08/09/2015 08:00:00 AM,48,-122,23,19,42
14049,SpokaneStBridge,08/09/2015 09:00:00 AM,48,-122,33,31,64
14050,SpokaneStBridge,08/09/2015 10:00:00 AM,48,-122,44,17,61
14051,SpokaneStBridge,08/09/2015 11:00:00 AM,48,-122,62,46,108
14052,SpokaneStBridge,08/09/2015 12:00:00 PM,48,-122,96,39,135
14053,SpokaneStBridge,08/09/2015 01:00:00 PM,48,-122,51,32,83
14054,SpokaneStBridge,08/09/2015 02:00:00 PM,48,-122,32,40,72
14055,SpokaneStBridge,08/09/2015 03:00:00 PM,48,-122,37,49,86
14056,SpokaneStBridge,08/09/2015 04:00:00 PM,48,-122,29,45,74
14057,SpokaneStBridge,08/09/2015 05:00:00 PM,48,-122,29,26,55
14058,SpokaneStBridge,08/09/2015 06:00:00 PM,48,-122,17,20,37
14059,SpokaneStBridge,08/09/2015 07:00:00 PM,48,-122,19,22,41
14060,SpokaneStBridge,08/09/2015 08:00:00 PM,48,-122,17,13,30
14061,SpokaneStBridge,08/09/2015 09:00:00 PM,48,-122,3,3,6
14062,SpokaneStBridge,08/09/2015 10:00:00 PM,48,-122,3,3,6
14063,SpokaneStBridge,08/09/2015 11:00:00 PM,48,-122,0,4,4
14064,SpokaneStBridge,08/10/2015 12:00:00 AM,48,-122,0,1,1
14065,SpokaneStBridge,08/10/2015 01:00:00 AM,48,-122,0,1,1
14066,SpokaneStBridge,08/10/2015 02:00:00 AM,48,-122,2,0,2
14067,SpokaneStBridge,08/10/2015 03:00:00 AM,48,-122,1,0,1
14068,SpokaneStBridge,08/10/2015 04:00:00 AM,48,-122,7,2,9
14069,SpokaneStBridge,08/10/2015 05:00:00 AM,48,-122,24,2,26
14070,SpokaneStBridge,08/10/2015 06:00:00 AM,48,-122,67,10,77
14071,SpokaneStBridge,08/10/2015 07:00:00 AM,48,-122,117,18,135
14072,SpokaneStBridge,08/10/2015 08:00:00 AM,48,-122,114,18,132
14073,SpokaneStBridge,08/10/2015 09:00:00 AM,48,-122,47,6,53
14074,SpokaneStBridge,08/10/2015 10:00:00 AM,48,-122,23,2,25
14075,SpokaneStBridge,08/10/2015 11:00:00 AM,48,-122,12,25,37
14076,SpokaneStBridge,08/10/2015 12:00:00 PM,48,-122,16,15,31
14077,SpokaneStBridge,08/10/2015 01:00:00 PM,48,-122,24,14,38
14078,SpokaneStBridge,08/10/2015 02:00:00 PM,48,-122,15,17,32
14079,SpokaneStBridge,08/10/2015 03:00:00 PM,48,-122,16,31,47
14080,SpokaneStBridge,08/10/2015 04:00:00 PM,48,-122,14,91,105
14081,SpokaneStBridge,08/10/2015 05:00:00 PM,48,-122,32,151,183
14082,SpokaneStBridge,08/10/2015 06:00:00 PM,48,-122,20,117,137
14083,SpokaneStBridge,08/10/2015 07:00:00 PM,48,-122,12,37,49
14084,SpokaneStBridge,08/10/2015 08:00:00 PM,48,-122,14,23,37
14085,SpokaneStBridge,08/10/2015 09:00:00 PM,48,-122,5,10,15
14086,SpokaneStBridge,08/10/2015 10:00:00 PM,48,-122,3,4,7
14087,SpokaneStBridge,08/10/2015 11:00:00 PM,48,-122,1,6,7
14088,SpokaneStBridge,08/11/2015 12:00:00 AM,48,-122,1,2,3
14089,SpokaneStBridge,08/11/2015 01:00:00 AM,48,-122,1,1,2
14090,SpokaneStBridge,08/11/2015 02:00:00 AM,48,-122,2,0,2
14091,SpokaneStBridge,08/11/2015 03:00:00 AM,48,-122,3,0,3
14092,SpokaneStBridge,08/11/2015 04:00:00 AM,48,-122,2,2,4
14093,SpokaneStBridge,08/11/2015 05:00:00 AM,48,-122,18,3,21
14094,SpokaneStBridge,08/11/2015 06:00:00 AM,48,-122,75,15,90
14095,SpokaneStBridge,08/11/2015 07:00:00 AM,48,-122,156,25,181
14096,SpokaneStBridge,08/11/2015 08:00:00 AM,48,-122,141,14,155
14097,SpokaneStBridge,08/11/2015 09:00:00 AM,48,-122,65,14,79
14098,SpokaneStBridge,08/11/2015 10:00:00 AM,48,-122,11,12,23
14099,SpokaneStBridge,08/11/2015 11:00:00 AM,48,-122,14,10,24
14100,SpokaneStBridge,08/11/2015 12:00:00 PM,48,-122,18,18,36
14101,SpokaneStBridge,08/11/2015 01:00:00 PM,48,-122,18,18,36
14102,SpokaneStBridge,08/11/2015 02:00:00 PM,48,-122,14,22,36
14103,SpokaneStBridge,08/11/2015 03:00:00 PM,48,-122,18,43,61
14104,SpokaneStBridge,08/11/2015 04:00:00 PM,48,-122,22,96,118
14105,SpokaneStBridge,08/11/2015 05:00:00 PM,48,-122,28,187,215
14106,SpokaneStBridge,08/11/2015 06:00:00 PM,48,-122,30,128,158
14107,SpokaneStBridge,08/11/2015 07:00:00 PM,48,-122,20,51,71
14108,SpokaneStBridge,08/11/2015 08:00:00 PM,48,-122,14,24,38
14109,SpokaneStBridge,08/11/2015 09:00:00 PM,48,-122,2,16,18
14110,SpokaneStBridge,08/11/2015 10:00:00 PM,48,-122,0,7,7
14111,SpokaneStBridge,08/11/2015 11:00:00 PM,48,-122,3,6,9
14112,SpokaneStBridge,08/12/2015 12:00:00 AM,48,-122,0,3,3
14113,SpokaneStBridge,08/12/2015 01:00:00 AM,48,-122,2,3,5
14114,SpokaneStBridge,08/12/2015 02:00:00 AM,48,-122,1,1,2
14115,SpokaneStBridge,08/12/2015 03:00:00 AM,48,-122,2,3,5
14116,SpokaneStBridge,08/12/2015 04:00:00 AM,48,-122,4,1,5
14117,SpokaneStBridge,08/12/2015 05:00:00 AM,48,-122,21,4,25
14118,SpokaneStBridge,08/12/2015 06:00:00 AM,48,-122,81,10,91
14119,SpokaneStBridge,08/12/2015 07:00:00 AM,48,-122,146,23,169
14120,SpokaneStBridge,08/12/2015 08:00:00 AM,48,-122,158,17,175
14121,SpokaneStBridge,08/12/2015 09:00:00 AM,48,-122,48,11,59
14122,SpokaneStBridge,08/12/2015 10:00:00 AM,48,-122,31,10,41
14123,SpokaneStBridge,08/12/2015 11:00:00 AM,48,-122,12,6,18
14124,SpokaneStBridge,08/12/2015 12:00:00 PM,48,-122,10,8,18
14125,SpokaneStBridge,08/12/2015 01:00:00 PM,48,-122,8,14,22
14126,SpokaneStBridge,08/12/2015 02:00:00 PM,48,-122,16,13,29
14127,SpokaneStBridge,08/12/2015 03:00:00 PM,48,-122,11,42,53
14128,SpokaneStBridge,08/12/2015 04:00:00 PM,48,-122,23,97,120
14129,SpokaneStBridge,08/12/2015 05:00:00 PM,48,-122,28,186,214
14130,SpokaneStBridge,08/12/2015 06:00:00 PM,48,-122,20,105,125
14131,SpokaneStBridge,08/12/2015 07:00:00 PM,48,-122,24,40,64
14132,SpokaneStBridge,08/12/2015 08:00:00 PM,48,-122,15,41,56
14133,SpokaneStBridge,08/12/2015 09:00:00 PM,48,-122,7,15,22
14134,SpokaneStBridge,08/12/2015 10:00:00 PM,48,-122,0,8,8
14135,SpokaneStBridge,08/12/2015 11:00:00 PM,48,-122,2,4,6
14136,SpokaneStBridge,08/13/2015 12:00:00 AM,48,-122,6,2,8
14137,SpokaneStBridge,08/13/2015 01:00:00 AM,48,-122,1,0,1
14138,SpokaneStBridge,08/13/2015 02:00:00 AM,48,-122,1,5,6
14139,SpokaneStBridge,08/13/2015 03:00:00 AM,48,-122,2,1,3
14140,SpokaneStBridge,08/13/2015 04:00:00 AM,48,-122,5,1,6
14141,SpokaneStBridge,08/13/2015 05:00:00 AM,48,-122,21,2,23
14142,SpokaneStBridge,08/13/2015 06:00:00 AM,48,-122,68,14,82
14143,SpokaneStBridge,08/13/2015 07:00:00 AM,48,-122,131,17,148
14144,SpokaneStBridge,08/13/2015 08:00:00 AM,48,-122,126,18,144
14145,SpokaneStBridge,08/13/2015 09:00:00 AM,48,-122,62,11,73
14146,SpokaneStBridge,08/13/2015 10:00:00 AM,48,-122,17,16,33
14147,SpokaneStBridge,08/13/2015 11:00:00 AM,48,-122,17,13,30
14148,SpokaneStBridge,08/13/2015 12:00:00 PM,48,-122,24,16,40
14149,SpokaneStBridge,08/13/2015 01:00:00 PM,48,-122,21,14,35
14150,SpokaneStBridge,08/13/2015 02:00:00 PM,48,-122,18,17,35
14151,SpokaneStBridge,08/13/2015 03:00:00 PM,48,-122,20,47,67
14152,SpokaneStBridge,08/13/2015 04:00:00 PM,48,-122,32,87,119
14153,SpokaneStBridge,08/13/2015 05:00:00 PM,48,-122,32,136,168
14154,SpokaneStBridge,08/13/2015 06:00:00 PM,48,-122,17,103,120
14155,SpokaneStBridge,08/13/2015 07:00:00 PM,48,-122,15,63,78
14156,SpokaneStBridge,08/13/2015 08:00:00 PM,48,-122,15,31,46
14157,SpokaneStBridge,08/13/2015 09:00:00 PM,48,-122,5,10,15
14158,SpokaneStBridge,08/13/2015 10:00:00 PM,48,-122,4,8,12
14159,SpokaneStBridge,08/13/2015 11:00:00 PM,48,-122,2,10,12
14160,SpokaneStBridge,08/14/2015 12:00:00 AM,48,-122,0,3,3
14161,SpokaneStBridge,08/14/2015 01:00:00 AM,48,-122,5,2,7
14162,SpokaneStBridge,08/14/2015 02:00:00 AM,48,-122,1,1,2
14163,SpokaneStBridge,08/14/2015 03:00:00 AM,48,-122,1,1,2
14164,SpokaneStBridge,08/14/2015 04:00:00 AM,48,-122,3,0,3
14165,SpokaneStBridge,08/14/2015 05:00:00 AM,48,-122,10,4,14
14166,SpokaneStBridge,08/14/2015 06:00:00 AM,48,-122,38,4,42
14167,SpokaneStBridge,08/14/2015 07:00:00 AM,48,-122,62,12,74
14168,SpokaneStBridge,08/14/2015 08:00:00 AM,48,-122,69,7,76
14169,SpokaneStBridge,08/14/2015 09:00:00 AM,48,-122,31,6,37
14170,SpokaneStBridge,08/14/2015 10:00:00 AM,48,-122,14,6,20
14171,SpokaneStBridge,08/14/2015 11:00:00 AM,48,-122,8,10,18
14172,SpokaneStBridge,08/14/2015 12:00:00 PM,48,-122,8,11,19
14173,SpokaneStBridge,08/14/2015 01:00:00 PM,48,-122,10,7,17
14174,SpokaneStBridge,08/14/2015 02:00:00 PM,48,-122,1,10,11
14175,SpokaneStBridge,08/14/2015 03:00:00 PM,48,-122,10,18,28
14176,SpokaneStBridge,08/14/2015 04:00:00 PM,48,-122,6,28,34
14177,SpokaneStBridge,08/14/2015 05:00:00 PM,48,-122,6,47,53
14178,SpokaneStBridge,08/14/2015 06:00:00 PM,48,-122,6,29,35
14179,SpokaneStBridge,08/14/2015 07:00:00 PM,48,-122,1,11,12
14180,SpokaneStBridge,08/14/2015 08:00:00 PM,48,-122,3,13,16
14181,SpokaneStBridge,08/14/2015 09:00:00 PM,48,-122,1,5,6
14182,SpokaneStBridge,08/14/2015 10:00:00 PM,48,-122,1,4,5
14183,SpokaneStBridge,08/14/2015 11:00:00 PM,48,-122,1,5,6
14184,SpokaneStBridge,08/15/2015 12:00:00 AM,48,-122,0,3,3
14185,SpokaneStBridge,08/15/2015 01:00:00 AM,48,-122,0,0,0
14186,SpokaneStBridge,08/15/2015 02:00:00 AM,48,-122,1,0,1
14187,SpokaneStBridge,08/15/2015 03:00:00 AM,48,-122,3,1,4
14188,SpokaneStBridge,08/15/2015 04:00:00 AM,48,-122,1,0,1
14189,SpokaneStBridge,08/15/2015 05:00:00 AM,48,-122,4,2,6
14190,SpokaneStBridge,08/15/2015 06:00:00 AM,48,-122,3,7,10
14191,SpokaneStBridge,08/15/2015 07:00:00 AM,48,-122,12,4,16
14192,SpokaneStBridge,08/15/2015 08:00:00 AM,48,-122,15,8,23
14193,SpokaneStBridge,08/15/2015 09:00:00 AM,48,-122,20,13,33
14194,SpokaneStBridge,08/15/2015 10:00:00 AM,48,-122,16,24,40
14195,SpokaneStBridge,08/15/2015 11:00:00 AM,48,-122,20,18,38
14196,SpokaneStBridge,08/15/2015 12:00:00 PM,48,-122,20,31,51
14197,SpokaneStBridge,08/15/2015 01:00:00 PM,48,-122,28,28,56
14198,SpokaneStBridge,08/15/2015 02:00:00 PM,48,-122,31,27,58
14199,SpokaneStBridge,08/15/2015 03:00:00 PM,48,-122,25,26,51
14200,SpokaneStBridge,08/15/2015 04:00:00 PM,48,-122,25,32,57
14201,SpokaneStBridge,08/15/2015 05:00:00 PM,48,-122,19,13,32
14202,SpokaneStBridge,08/15/2015 06:00:00 PM,48,-122,10,13,23
14203,SpokaneStBridge,08/15/2015 07:00:00 PM,48,-122,9,9,18
14204,SpokaneStBridge,08/15/2015 08:00:00 PM,48,-122,2,12,14
14205,SpokaneStBridge,08/15/2015 09:00:00 PM,48,-122,8,4,12
14206,SpokaneStBridge,08/15/2015 10:00:00 PM,48,-122,1,9,10
14207,SpokaneStBridge,08/15/2015 11:00:00 PM,48,-122,4,7,11
14208,SpokaneStBridge,08/16/2015 12:00:00 AM,48,-122,2,2,4
14209,SpokaneStBridge,08/16/2015 01:00:00 AM,48,-122,1,2,3
14210,SpokaneStBridge,08/16/2015 02:00:00 AM,48,-122,1,4,5
14211,SpokaneStBridge,08/16/2015 03:00:00 AM,48,-122,1,3,4
14212,SpokaneStBridge,08/16/2015 04:00:00 AM,48,-122,1,1,2
14213,SpokaneStBridge,08/16/2015 05:00:00 AM,48,-122,5,4,9
14214,SpokaneStBridge,08/16/2015 06:00:00 AM,48,-122,2,3,5
14215,SpokaneStBridge,08/16/2015 07:00:00 AM,48,-122,6,4,10
14216,SpokaneStBridge,08/16/2015 08:00:00 AM,48,-122,21,10,31
14217,SpokaneStBridge,08/16/2015 09:00:00 AM,48,-122,14,13,27
14218,SpokaneStBridge,08/16/2015 10:00:00 AM,48,-122,27,35,62
14219,SpokaneStBridge,08/16/2015 11:00:00 AM,48,-122,38,42,80
14220,SpokaneStBridge,08/16/2015 12:00:00 PM,48,-122,48,41,89
14221,SpokaneStBridge,08/16/2015 01:00:00 PM,48,-122,53,45,98
14222,SpokaneStBridge,08/16/2015 02:00:00 PM,48,-122,48,35,83
14223,SpokaneStBridge,08/16/2015 03:00:00 PM,48,-122,30,38,68
14224,SpokaneStBridge,08/16/2015 04:00:00 PM,48,-122,34,42,76
14225,SpokaneStBridge,08/16/2015 05:00:00 PM,48,-122,23,40,63
14226,SpokaneStBridge,08/16/2015 06:00:00 PM,48,-122,18,30,48
14227,SpokaneStBridge,08/16/2015 07:00:00 PM,48,-122,16,11,27
14228,SpokaneStBridge,08/16/2015 08:00:00 PM,48,-122,7,5,12
14229,SpokaneStBridge,08/16/2015 09:00:00 PM,48,-122,4,7,11
14230,SpokaneStBridge,08/16/2015 10:00:00 PM,48,-122,5,5,10
14231,SpokaneStBridge,08/16/2015 11:00:00 PM,48,-122,1,4,5
14232,SpokaneStBridge,08/17/2015 12:00:00 AM,48,-122,0,0,0
14233,SpokaneStBridge,08/17/2015 01:00:00 AM,48,-122,2,1,3
14234,SpokaneStBridge,08/17/2015 02:00:00 AM,48,-122,1,0,1
14235,SpokaneStBridge,08/17/2015 03:00:00 AM,48,-122,1,1,2
14236,SpokaneStBridge,08/17/2015 04:00:00 AM,48,-122,5,2,7
14237,SpokaneStBridge,08/17/2015 05:00:00 AM,48,-122,22,2,24
14238,SpokaneStBridge,08/17/2015 06:00:00 AM,48,-122,59,11,70
14239,SpokaneStBridge,08/17/2015 07:00:00 AM,48,-122,133,15,148
14240,SpokaneStBridge,08/17/2015 08:00:00 AM,48,-122,119,15,134
14241,SpokaneStBridge,08/17/2015 09:00:00 AM,48,-122,49,5,54
14242,SpokaneStBridge,08/17/2015 10:00:00 AM,48,-122,12,10,22
14243,SpokaneStBridge,08/17/2015 11:00:00 AM,48,-122,16,10,26
14244,SpokaneStBridge,08/17/2015 12:00:00 PM,48,-122,14,17,31
14245,SpokaneStBridge,08/17/2015 01:00:00 PM,48,-122,19,14,33
14246,SpokaneStBridge,08/17/2015 02:00:00 PM,48,-122,9,16,25
14247,SpokaneStBridge,08/17/2015 03:00:00 PM,48,-122,17,43,60
14248,SpokaneStBridge,08/17/2015 04:00:00 PM,48,-122,26,90,116
14249,SpokaneStBridge,08/17/2015 05:00:00 PM,48,-122,29,188,217
14250,SpokaneStBridge,08/17/2015 06:00:00 PM,48,-122,23,112,135
14251,SpokaneStBridge,08/17/2015 07:00:00 PM,48,-122,15,39,54
14252,SpokaneStBridge,08/17/2015 08:00:00 PM,48,-122,15,10,25
14253,SpokaneStBridge,08/17/2015 09:00:00 PM,48,-122,4,12,16
14254,SpokaneStBridge,08/17/2015 10:00:00 PM,48,-122,1,12,13
14255,SpokaneStBridge,08/17/2015 11:00:00 PM,48,-122,1,3,4
14256,SpokaneStBridge,08/18/2015 12:00:00 AM,48,-122,0,2,2
14257,SpokaneStBridge,08/18/2015 01:00:00 AM,48,-122,0,0,0
14258,SpokaneStBridge,08/18/2015 02:00:00 AM,48,-122,0,2,2
14259,SpokaneStBridge,08/18/2015 03:00:00 AM,48,-122,5,0,5
14260,SpokaneStBridge,08/18/2015 04:00:00 AM,48,-122,4,3,7
14261,SpokaneStBridge,08/18/2015 05:00:00 AM,48,-122,22,4,26
14262,SpokaneStBridge,08/18/2015 06:00:00 AM,48,-122,73,11,84
14263,SpokaneStBridge,08/18/2015 07:00:00 AM,48,-122,167,13,180
14264,SpokaneStBridge,08/18/2015 08:00:00 AM,48,-122,138,21,159
14265,SpokaneStBridge,08/18/2015 09:00:00 AM,48,-122,57,8,65
14266,SpokaneStBridge,08/18/2015 10:00:00 AM,48,-122,21,15,36
14267,SpokaneStBridge,08/18/2015 11:00:00 AM,48,-122,22,20,42
14268,SpokaneStBridge,08/18/2015 12:00:00 PM,48,-122,10,21,31
14269,SpokaneStBridge,08/18/2015 01:00:00 PM,48,-122,19,28,47
14270,SpokaneStBridge,08/18/2015 02:00:00 PM,48,-122,19,22,41
14271,SpokaneStBridge,08/18/2015 03:00:00 PM,48,-122,14,40,54
14272,SpokaneStBridge,08/18/2015 04:00:00 PM,48,-122,31,96,127
14273,SpokaneStBridge,08/18/2015 05:00:00 PM,48,-122,27,162,189
14274,SpokaneStBridge,08/18/2015 06:00:00 PM,48,-122,19,117,136
14275,SpokaneStBridge,08/18/2015 07:00:00 PM,48,-122,12,44,56
14276,SpokaneStBridge,08/18/2015 08:00:00 PM,48,-122,6,28,34
14277,SpokaneStBridge,08/18/2015 09:00:00 PM,48,-122,6,21,27
14278,SpokaneStBridge,08/18/2015 10:00:00 PM,48,-122,3,9,12
14279,SpokaneStBridge,08/18/2015 11:00:00 PM,48,-122,0,1,1
14280,SpokaneStBridge,08/19/2015 12:00:00 AM,48,-122,0,2,2
14281,SpokaneStBridge,08/19/2015 01:00:00 AM,48,-122,0,1,1
14282,SpokaneStBridge,08/19/2015 02:00:00 AM,48,-122,1,2,3
14283,SpokaneStBridge,08/19/2015 03:00:00 AM,48,-122,1,1,2
14284,SpokaneStBridge,08/19/2015 04:00:00 AM,48,-122,7,0,7
14285,SpokaneStBridge,08/19/2015 05:00:00 AM,48,-122,19,6,25
14286,SpokaneStBridge,08/19/2015 06:00:00 AM,48,-122,67,10,77
14287,SpokaneStBridge,08/19/2015 07:00:00 AM,48,-122,142,24,166
14288,SpokaneStBridge,08/19/2015 08:00:00 AM,48,-122,165,14,179
14289,SpokaneStBridge,08/19/2015 09:00:00 AM,48,-122,50,18,68
14290,SpokaneStBridge,08/19/2015 10:00:00 AM,48,-122,22,10,32
14291,SpokaneStBridge,08/19/2015 11:00:00 AM,48,-122,21,15,36
14292,SpokaneStBridge,08/19/2015 12:00:00 PM,48,-122,22,14,36
14293,SpokaneStBridge,08/19/2015 01:00:00 PM,48,-122,16,22,38
14294,SpokaneStBridge,08/19/2015 02:00:00 PM,48,-122,11,24,35
14295,SpokaneStBridge,08/19/2015 03:00:00 PM,48,-122,13,46,59
14296,SpokaneStBridge,08/19/2015 04:00:00 PM,48,-122,24,84,108
14297,SpokaneStBridge,08/19/2015 05:00:00 PM,48,-122,24,178,202
14298,SpokaneStBridge,08/19/2015 06:00:00 PM,48,-122,22,101,123
14299,SpokaneStBridge,08/19/2015 07:00:00 PM,48,-122,23,57,80
14300,SpokaneStBridge,08/19/2015 08:00:00 PM,48,-122,20,28,48
14301,SpokaneStBridge,08/19/2015 09:00:00 PM,48,-122,5,15,20
14302,SpokaneStBridge,08/19/2015 10:00:00 PM,48,-122,0,6,6
14303,SpokaneStBridge,08/19/2015 11:00:00 PM,48,-122,3,9,12
14304,SpokaneStBridge,08/20/2015 12:00:00 AM,48,-122,0,5,5
14305,SpokaneStBridge,08/20/2015 01:00:00 AM,48,-122,0,0,0
14306,SpokaneStBridge,08/20/2015 02:00:00 AM,48,-122,2,0,2
14307,SpokaneStBridge,08/20/2015 03:00:00 AM,48,-122,0,1,1
14308,SpokaneStBridge,08/20/2015 04:00:00 AM,48,-122,10,2,12
14309,SpokaneStBridge,08/20/2015 05:00:00 AM,48,-122,20,5,25
14310,SpokaneStBridge,08/20/2015 06:00:00 AM,48,-122,64,7,71
14311,SpokaneStBridge,08/20/2015 07:00:00 AM,48,-122,117,19,136
14312,SpokaneStBridge,08/20/2015 08:00:00 AM,48,-122,116,10,126
14313,SpokaneStBridge,08/20/2015 09:00:00 AM,48,-122,54,7,61
14314,SpokaneStBridge,08/20/2015 10:00:00 AM,48,-122,21,9,30
14315,SpokaneStBridge,08/20/2015 11:00:00 AM,48,-122,13,9,22
14316,SpokaneStBridge,08/20/2015 12:00:00 PM,48,-122,10,21,31
14317,SpokaneStBridge,08/20/2015 01:00:00 PM,48,-122,22,16,38
14318,SpokaneStBridge,08/20/2015 02:00:00 PM,48,-122,13,25,38
14319,SpokaneStBridge,08/20/2015 03:00:00 PM,48,-122,16,38,54
14320,SpokaneStBridge,08/20/2015 04:00:00 PM,48,-122,20,78,98
14321,SpokaneStBridge,08/20/2015 05:00:00 PM,48,-122,24,133,157
14322,SpokaneStBridge,08/20/2015 06:00:00 PM,48,-122,23,87,110
14323,SpokaneStBridge,08/20/2015 07:00:00 PM,48,-122,13,51,64
14324,SpokaneStBridge,08/20/2015 08:00:00 PM,48,-122,7,33,40
14325,SpokaneStBridge,08/20/2015 09:00:00 PM,48,-122,9,14,23
14326,SpokaneStBridge,08/20/2015 10:00:00 PM,48,-122,2,9,11
14327,SpokaneStBridge,08/20/2015 11:00:00 PM,48,-122,4,7,11
14328,SpokaneStBridge,08/21/2015 12:00:00 AM,48,-122,1,4,5
14329,SpokaneStBridge,08/21/2015 01:00:00 AM,48,-122,0,0,0
14330,SpokaneStBridge,08/21/2015 02:00:00 AM,48,-122,2,1,3
14331,SpokaneStBridge,08/21/2015 03:00:00 AM,48,-122,1,0,1
14332,SpokaneStBridge,08/21/2015 04:00:00 AM,48,-122,5,1,6
14333,SpokaneStBridge,08/21/2015 05:00:00 AM,48,-122,14,2,16
14334,SpokaneStBridge,08/21/2015 06:00:00 AM,48,-122,46,5,51
14335,SpokaneStBridge,08/21/2015 07:00:00 AM,48,-122,93,16,109
14336,SpokaneStBridge,08/21/2015 08:00:00 AM,48,-122,97,12,109
14337,SpokaneStBridge,08/21/2015 09:00:00 AM,48,-122,48,6,54
14338,SpokaneStBridge,08/21/2015 10:00:00 AM,48,-122,20,11,31
14339,SpokaneStBridge,08/21/2015 11:00:00 AM,48,-122,30,4,34
14340,SpokaneStBridge,08/21/2015 12:00:00 PM,48,-122,16,12,28
14341,SpokaneStBridge,08/21/2015 01:00:00 PM,48,-122,11,16,27
14342,SpokaneStBridge,08/21/2015 02:00:00 PM,48,-122,11,19,30
14343,SpokaneStBridge,08/21/2015 03:00:00 PM,48,-122,11,39,50
14344,SpokaneStBridge,08/21/2015 04:00:00 PM,48,-122,19,74,93
14345,SpokaneStBridge,08/21/2015 05:00:00 PM,48,-122,14,117,131
14346,SpokaneStBridge,08/21/2015 06:00:00 PM,48,-122,15,58,73
14347,SpokaneStBridge,08/21/2015 07:00:00 PM,48,-122,6,34,40
14348,SpokaneStBridge,08/21/2015 08:00:00 PM,48,-122,7,14,21
14349,SpokaneStBridge,08/21/2015 09:00:00 PM,48,-122,9,10,19
14350,SpokaneStBridge,08/21/2015 10:00:00 PM,48,-122,2,7,9
14351,SpokaneStBridge,08/21/2015 11:00:00 PM,48,-122,3,5,8
14352,SpokaneStBridge,08/22/2015 12:00:00 AM,48,-122,1,8,9
14353,SpokaneStBridge,08/22/2015 01:00:00 AM,48,-122,1,1,2
14354,SpokaneStBridge,08/22/2015 02:00:00 AM,48,-122,1,4,5
14355,SpokaneStBridge,08/22/2015 03:00:00 AM,48,-122,1,3,4
14356,SpokaneStBridge,08/22/2015 04:00:00 AM,48,-122,2,0,2
14357,SpokaneStBridge,08/22/2015 05:00:00 AM,48,-122,5,0,5
14358,SpokaneStBridge,08/22/2015 06:00:00 AM,48,-122,6,3,9
14359,SpokaneStBridge,08/22/2015 07:00:00 AM,48,-122,16,6,22
14360,SpokaneStBridge,08/22/2015 08:00:00 AM,48,-122,30,18,48
14361,SpokaneStBridge,08/22/2015 09:00:00 AM,48,-122,28,14,42
14362,SpokaneStBridge,08/22/2015 10:00:00 AM,48,-122,43,74,117
14363,SpokaneStBridge,08/22/2015 11:00:00 AM,48,-122,36,64,100
14364,SpokaneStBridge,08/22/2015 12:00:00 PM,48,-122,68,45,113
14365,SpokaneStBridge,08/22/2015 01:00:00 PM,48,-122,39,19,58
14366,SpokaneStBridge,08/22/2015 02:00:00 PM,48,-122,25,28,53
14367,SpokaneStBridge,08/22/2015 03:00:00 PM,48,-122,31,31,62
14368,SpokaneStBridge,08/22/2015 04:00:00 PM,48,-122,19,30,49
14369,SpokaneStBridge,08/22/2015 05:00:00 PM,48,-122,24,20,44
14370,SpokaneStBridge,08/22/2015 06:00:00 PM,48,-122,14,12,26
14371,SpokaneStBridge,08/22/2015 07:00:00 PM,48,-122,11,10,21
14372,SpokaneStBridge,08/22/2015 08:00:00 PM,48,-122,5,13,18
14373,SpokaneStBridge,08/22/2015 09:00:00 PM,48,-122,7,5,12
14374,SpokaneStBridge,08/22/2015 10:00:00 PM,48,-122,2,8,10
14375,SpokaneStBridge,08/22/2015 11:00:00 PM,48,-122,1,4,5
14376,SpokaneStBridge,08/23/2015 12:00:00 AM,48,-122,2,5,7
14377,SpokaneStBridge,08/23/2015 01:00:00 AM,48,-122,1,1,2
14378,SpokaneStBridge,08/23/2015 02:00:00 AM,48,-122,0,2,2
14379,SpokaneStBridge,08/23/2015 03:00:00 AM,48,-122,0,3,3
14380,SpokaneStBridge,08/23/2015 04:00:00 AM,48,-122,0,1,1
14381,SpokaneStBridge,08/23/2015 05:00:00 AM,48,-122,3,1,4
14382,SpokaneStBridge,08/23/2015 06:00:00 AM,48,-122,6,4,10
14383,SpokaneStBridge,08/23/2015 07:00:00 AM,48,-122,10,4,14
14384,SpokaneStBridge,08/23/2015 08:00:00 AM,48,-122,15,14,29
14385,SpokaneStBridge,08/23/2015 09:00:00 AM,48,-122,29,29,58
14386,SpokaneStBridge,08/23/2015 10:00:00 AM,48,-122,23,22,45
14387,SpokaneStBridge,08/23/2015 11:00:00 AM,48,-122,28,28,56
14388,SpokaneStBridge,08/23/2015 12:00:00 PM,48,-122,35,45,80
14389,SpokaneStBridge,08/23/2015 01:00:00 PM,48,-122,34,39,73
14390,SpokaneStBridge,08/23/2015 02:00:00 PM,48,-122,39,40,79
14391,SpokaneStBridge,08/23/2015 03:00:00 PM,48,-122,18,39,57
14392,SpokaneStBridge,08/23/2015 04:00:00 PM,48,-122,30,33,63
14393,SpokaneStBridge,08/23/2015 05:00:00 PM,48,-122,27,25,52
14394,SpokaneStBridge,08/23/2015 06:00:00 PM,48,-122,18,18,36
14395,SpokaneStBridge,08/23/2015 07:00:00 PM,48,-122,8,7,15
14396,SpokaneStBridge,08/23/2015 08:00:00 PM,48,-122,9,8,17
14397,SpokaneStBridge,08/23/2015 09:00:00 PM,48,-122,2,3,5
14398,SpokaneStBridge,08/23/2015 10:00:00 PM,48,-122,1,2,3
14399,SpokaneStBridge,08/23/2015 11:00:00 PM,48,-122,3,2,5
14400,SpokaneStBridge,08/24/2015 12:00:00 AM,48,-122,4,2,6
14401,SpokaneStBridge,08/24/2015 01:00:00 AM,48,-122,0,1,1
14402,SpokaneStBridge,08/24/2015 02:00:00 AM,48,-122,1,2,3
14403,SpokaneStBridge,08/24/2015 03:00:00 AM,48,-122,0,1,1
14404,SpokaneStBridge,08/24/2015 04:00:00 AM,48,-122,6,0,6
14405,SpokaneStBridge,08/24/2015 05:00:00 AM,48,-122,25,1,26
14406,SpokaneStBridge,08/24/2015 06:00:00 AM,48,-122,50,16,66
14407,SpokaneStBridge,08/24/2015 07:00:00 AM,48,-122,130,14,144
14408,SpokaneStBridge,08/24/2015 08:00:00 AM,48,-122,148,31,179
14409,SpokaneStBridge,08/24/2015 09:00:00 AM,48,-122,40,6,46
14410,SpokaneStBridge,08/24/2015 10:00:00 AM,48,-122,20,3,23
14411,SpokaneStBridge,08/24/2015 11:00:00 AM,48,-122,13,9,22
14412,SpokaneStBridge,08/24/2015 12:00:00 PM,48,-122,15,13,28
14413,SpokaneStBridge,08/24/2015 01:00:00 PM,48,-122,20,12,32
14414,SpokaneStBridge,08/24/2015 02:00:00 PM,48,-122,15,20,35
14415,SpokaneStBridge,08/24/2015 03:00:00 PM,48,-122,20,38,58
14416,SpokaneStBridge,08/24/2015 04:00:00 PM,48,-122,30,95,125
14417,SpokaneStBridge,08/24/2015 05:00:00 PM,48,-122,19,151,170
14418,SpokaneStBridge,08/24/2015 06:00:00 PM,48,-122,14,99,113
14419,SpokaneStBridge,08/24/2015 07:00:00 PM,48,-122,15,39,54
14420,SpokaneStBridge,08/24/2015 08:00:00 PM,48,-122,4,25,29
14421,SpokaneStBridge,08/24/2015 09:00:00 PM,48,-122,0,7,7
14422,SpokaneStBridge,08/24/2015 10:00:00 PM,48,-122,4,8,12
14423,SpokaneStBridge,08/24/2015 11:00:00 PM,48,-122,2,4,6
14424,SpokaneStBridge,08/25/2015 12:00:00 AM,48,-122,0,5,5
14425,SpokaneStBridge,08/25/2015 01:00:00 AM,48,-122,1,2,3
14426,SpokaneStBridge,08/25/2015 02:00:00 AM,48,-122,1,1,2
14427,SpokaneStBridge,08/25/2015 03:00:00 AM,48,-122,1,0,1
14428,SpokaneStBridge,08/25/2015 04:00:00 AM,48,-122,1,0,1
14429,SpokaneStBridge,08/25/2015 05:00:00 AM,48,-122,23,3,26
14430,SpokaneStBridge,08/25/2015 06:00:00 AM,48,-122,66,12,78
14431,SpokaneStBridge,08/25/2015 07:00:00 AM,48,-122,163,22,185
14432,SpokaneStBridge,08/25/2015 08:00:00 AM,48,-122,144,23,167
14433,SpokaneStBridge,08/25/2015 09:00:00 AM,48,-122,50,14,64
14434,SpokaneStBridge,08/25/2015 10:00:00 AM,48,-122,19,9,28
14435,SpokaneStBridge,08/25/2015 11:00:00 AM,48,-122,10,5,15
14436,SpokaneStBridge,08/25/2015 12:00:00 PM,48,-122,15,19,34
14437,SpokaneStBridge,08/25/2015 01:00:00 PM,48,-122,24,15,39
14438,SpokaneStBridge,08/25/2015 02:00:00 PM,48,-122,17,18,35
14439,SpokaneStBridge,08/25/2015 03:00:00 PM,48,-122,16,45,61
14440,SpokaneStBridge,08/25/2015 04:00:00 PM,48,-122,37,96,133
14441,SpokaneStBridge,08/25/2015 05:00:00 PM,48,-122,23,181,204
14442,SpokaneStBridge,08/25/2015 06:00:00 PM,48,-122,28,115,143
14443,SpokaneStBridge,08/25/2015 07:00:00 PM,48,-122,22,47,69
14444,SpokaneStBridge,08/25/2015 08:00:00 PM,48,-122,10,35,45
14445,SpokaneStBridge,08/25/2015 09:00:00 PM,48,-122,7,13,20
14446,SpokaneStBridge,08/25/2015 10:00:00 PM,48,-122,5,8,13
14447,SpokaneStBridge,08/25/2015 11:00:00 PM,48,-122,9,8,17
14448,SpokaneStBridge,08/26/2015 12:00:00 AM,48,-122,1,1,2
14449,SpokaneStBridge,08/26/2015 01:00:00 AM,48,-122,1,1,2
14450,SpokaneStBridge,08/26/2015 02:00:00 AM,48,-122,1,0,1
14451,SpokaneStBridge,08/26/2015 03:00:00 AM,48,-122,1,0,1
14452,SpokaneStBridge,08/26/2015 04:00:00 AM,48,-122,3,0,3
14453,SpokaneStBridge,08/26/2015 05:00:00 AM,48,-122,24,6,30
14454,SpokaneStBridge,08/26/2015 06:00:00 AM,48,-122,62,11,73
14455,SpokaneStBridge,08/26/2015 07:00:00 AM,48,-122,142,21,163
14456,SpokaneStBridge,08/26/2015 08:00:00 AM,48,-122,141,11,152
14457,SpokaneStBridge,08/26/2015 09:00:00 AM,48,-122,51,6,57
14458,SpokaneStBridge,08/26/2015 10:00:00 AM,48,-122,25,17,42
14459,SpokaneStBridge,08/26/2015 11:00:00 AM,48,-122,17,12,29
14460,SpokaneStBridge,08/26/2015 12:00:00 PM,48,-122,12,17,29
14461,SpokaneStBridge,08/26/2015 01:00:00 PM,48,-122,26,19,45
14462,SpokaneStBridge,08/26/2015 02:00:00 PM,48,-122,17,19,36
14463,SpokaneStBridge,08/26/2015 03:00:00 PM,48,-122,18,45,63
14464,SpokaneStBridge,08/26/2015 04:00:00 PM,48,-122,32,103,135
14465,SpokaneStBridge,08/26/2015 05:00:00 PM,48,-122,30,173,203
14466,SpokaneStBridge,08/26/2015 06:00:00 PM,48,-122,13,90,103
14467,SpokaneStBridge,08/26/2015 07:00:00 PM,48,-122,12,56,68
14468,SpokaneStBridge,08/26/2015 08:00:00 PM,48,-122,20,22,42
14469,SpokaneStBridge,08/26/2015 09:00:00 PM,48,-122,4,16,20
14470,SpokaneStBridge,08/26/2015 10:00:00 PM,48,-122,1,8,9
14471,SpokaneStBridge,08/26/2015 11:00:00 PM,48,-122,3,5,8
14472,SpokaneStBridge,08/27/2015 12:00:00 AM,48,-122,1,0,1
14473,SpokaneStBridge,08/27/2015 01:00:00 AM,48,-122,0,0,0
14474,SpokaneStBridge,08/27/2015 02:00:00 AM,48,-122,2,0,2
14475,SpokaneStBridge,08/27/2015 03:00:00 AM,48,-122,0,1,1
14476,SpokaneStBridge,08/27/2015 04:00:00 AM,48,-122,4,1,5
14477,SpokaneStBridge,08/27/2015 05:00:00 AM,48,-122,30,4,34
14478,SpokaneStBridge,08/27/2015 06:00:00 AM,48,-122,66,12,78
14479,SpokaneStBridge,08/27/2015 07:00:00 AM,48,-122,142,16,158
14480,SpokaneStBridge,08/27/2015 08:00:00 AM,48,-122,129,24,153
14481,SpokaneStBridge,08/27/2015 09:00:00 AM,48,-122,53,7,60
14482,SpokaneStBridge,08/27/2015 10:00:00 AM,48,-122,24,11,35
14483,SpokaneStBridge,08/27/2015 11:00:00 AM,48,-122,22,8,30
14484,SpokaneStBridge,08/27/2015 12:00:00 PM,48,-122,15,21,36
14485,SpokaneStBridge,08/27/2015 01:00:00 PM,48,-122,27,14,41
14486,SpokaneStBridge,08/27/2015 02:00:00 PM,48,-122,20,25,45
14487,SpokaneStBridge,08/27/2015 03:00:00 PM,48,-122,38,38,76
14488,SpokaneStBridge,08/27/2015 04:00:00 PM,48,-122,24,101,125
14489,SpokaneStBridge,08/27/2015 05:00:00 PM,48,-122,29,165,194
14490,SpokaneStBridge,08/27/2015 06:00:00 PM,48,-122,21,92,113
14491,SpokaneStBridge,08/27/2015 07:00:00 PM,48,-122,16,49,65
14492,SpokaneStBridge,08/27/2015 08:00:00 PM,48,-122,6,24,30
14493,SpokaneStBridge,08/27/2015 09:00:00 PM,48,-122,3,13,16
14494,SpokaneStBridge,08/27/2015 10:00:00 PM,48,-122,3,14,17
14495,SpokaneStBridge,08/27/2015 11:00:00 PM,48,-122,2,9,11
14496,SpokaneStBridge,08/28/2015 12:00:00 AM,48,-122,1,4,5
14497,SpokaneStBridge,08/28/2015 01:00:00 AM,48,-122,1,1,2
14498,SpokaneStBridge,08/28/2015 02:00:00 AM,48,-122,1,2,3
14499,SpokaneStBridge,08/28/2015 03:00:00 AM,48,-122,1,0,1
14500,SpokaneStBridge,08/28/2015 04:00:00 AM,48,-122,1,2,3
14501,SpokaneStBridge,08/28/2015 05:00:00 AM,48,-122,19,2,21
14502,SpokaneStBridge,08/28/2015 06:00:00 AM,48,-122,30,6,36
14503,SpokaneStBridge,08/28/2015 07:00:00 AM,48,-122,71,7,78
14504,SpokaneStBridge,08/28/2015 08:00:00 AM,48,-122,66,10,76
14505,SpokaneStBridge,08/28/2015 09:00:00 AM,48,-122,30,6,36
14506,SpokaneStBridge,08/28/2015 10:00:00 AM,48,-122,20,5,25
14507,SpokaneStBridge,08/28/2015 11:00:00 AM,48,-122,12,6,18
14508,SpokaneStBridge,08/28/2015 12:00:00 PM,48,-122,10,8,18
14509,SpokaneStBridge,08/28/2015 01:00:00 PM,48,-122,11,13,24
14510,SpokaneStBridge,08/28/2015 02:00:00 PM,48,-122,10,18,28
14511,SpokaneStBridge,08/28/2015 03:00:00 PM,48,-122,10,43,53
14512,SpokaneStBridge,08/28/2015 04:00:00 PM,48,-122,11,47,58
14513,SpokaneStBridge,08/28/2015 05:00:00 PM,48,-122,18,84,102
14514,SpokaneStBridge,08/28/2015 06:00:00 PM,48,-122,10,50,60
14515,SpokaneStBridge,08/28/2015 07:00:00 PM,48,-122,2,14,16
14516,SpokaneStBridge,08/28/2015 08:00:00 PM,48,-122,5,5,10
14517,SpokaneStBridge,08/28/2015 09:00:00 PM,48,-122,3,8,11
14518,SpokaneStBridge,08/28/2015 10:00:00 PM,48,-122,3,5,8
14519,SpokaneStBridge,08/28/2015 11:00:00 PM,48,-122,0,5,5
14520,SpokaneStBridge,08/29/2015 12:00:00 AM,48,-122,2,1,3
14521,SpokaneStBridge,08/29/2015 01:00:00 AM,48,-122,2,5,7
14522,SpokaneStBridge,08/29/2015 02:00:00 AM,48,-122,0,1,1
14523,SpokaneStBridge,08/29/2015 03:00:00 AM,48,-122,1,1,2
14524,SpokaneStBridge,08/29/2015 04:00:00 AM,48,-122,1,1,2
14525,SpokaneStBridge,08/29/2015 05:00:00 AM,48,-122,5,2,7
14526,SpokaneStBridge,08/29/2015 06:00:00 AM,48,-122,1,1,2
14527,SpokaneStBridge,08/29/2015 07:00:00 AM,48,-122,0,0,0
14528,SpokaneStBridge,08/29/2015 08:00:00 AM,48,-122,7,0,7
14529,SpokaneStBridge,08/29/2015 09:00:00 AM,48,-122,9,4,13
14530,SpokaneStBridge,08/29/2015 10:00:00 AM,48,-122,8,8,16
14531,SpokaneStBridge,08/29/2015 11:00:00 AM,48,-122,8,5,13
14532,SpokaneStBridge,08/29/2015 12:00:00 PM,48,-122,9,7,16
14533,SpokaneStBridge,08/29/2015 01:00:00 PM,48,-122,9,14,23
14534,SpokaneStBridge,08/29/2015 02:00:00 PM,48,-122,11,5,16
14535,SpokaneStBridge,08/29/2015 03:00:00 PM,48,-122,11,11,22
14536,SpokaneStBridge,08/29/2015 04:00:00 PM,48,-122,8,6,14
14537,SpokaneStBridge,08/29/2015 05:00:00 PM,48,-122,11,12,23
14538,SpokaneStBridge,08/29/2015 06:00:00 PM,48,-122,2,4,6
14539,SpokaneStBridge,08/29/2015 07:00:00 PM,48,-122,3,6,9
14540,SpokaneStBridge,08/29/2015 08:00:00 PM,48,-122,3,6,9
14541,SpokaneStBridge,08/29/2015 09:00:00 PM,48,-122,1,0,1
14542,SpokaneStBridge,08/29/2015 10:00:00 PM,48,-122,0,1,1
14543,SpokaneStBridge,08/29/2015 11:00:00 PM,48,-122,1,0,1
14544,SpokaneStBridge,08/30/2015 12:00:00 AM,48,-122,0,0,0
14545,SpokaneStBridge,08/30/2015 01:00:00 AM,48,-122,1,3,4
14546,SpokaneStBridge,08/30/2015 02:00:00 AM,48,-122,0,0,0
14547,SpokaneStBridge,08/30/2015 03:00:00 AM,48,-122,1,0,1
14548,SpokaneStBridge,08/30/2015 04:00:00 AM,48,-122,0,0,0
14549,SpokaneStBridge,08/30/2015 05:00:00 AM,48,-122,1,0,1
14550,SpokaneStBridge,08/30/2015 06:00:00 AM,48,-122,2,1,3
14551,SpokaneStBridge,08/30/2015 07:00:00 AM,48,-122,5,3,8
14552,SpokaneStBridge,08/30/2015 08:00:00 AM,48,-122,3,3,6
14553,SpokaneStBridge,08/30/2015 09:00:00 AM,48,-122,10,5,15
14554,SpokaneStBridge,08/30/2015 10:00:00 AM,48,-122,13,8,21
14555,SpokaneStBridge,08/30/2015 11:00:00 AM,48,-122,10,13,23
14556,SpokaneStBridge,08/30/2015 12:00:00 PM,48,-122,16,14,30
14557,SpokaneStBridge,08/30/2015 01:00:00 PM,48,-122,13,7,20
14558,SpokaneStBridge,08/30/2015 02:00:00 PM,48,-122,13,20,33
14559,SpokaneStBridge,08/30/2015 03:00:00 PM,48,-122,17,11,28
14560,SpokaneStBridge,08/30/2015 04:00:00 PM,48,-122,7,19,26
14561,SpokaneStBridge,08/30/2015 05:00:00 PM,48,-122,12,18,30
14562,SpokaneStBridge,08/30/2015 06:00:00 PM,48,-122,4,10,14
14563,SpokaneStBridge,08/30/2015 07:00:00 PM,48,-122,8,1,9
14564,SpokaneStBridge,08/30/2015 08:00:00 PM,48,-122,4,4,8
14565,SpokaneStBridge,08/30/2015 09:00:00 PM,48,-122,1,4,5
14566,SpokaneStBridge,08/30/2015 10:00:00 PM,48,-122,0,2,2
14567,SpokaneStBridge,08/30/2015 11:00:00 PM,48,-122,2,3,5
14568,SpokaneStBridge,08/31/2015 12:00:00 AM,48,-122,0,2,2
14569,SpokaneStBridge,08/31/2015 01:00:00 AM,48,-122,0,0,0
14570,SpokaneStBridge,08/31/2015 02:00:00 AM,48,-122,1,0,1
14571,SpokaneStBridge,08/31/2015 03:00:00 AM,48,-122,1,0,1
14572,SpokaneStBridge,08/31/2015 04:00:00 AM,48,-122,6,1,7
14573,SpokaneStBridge,08/31/2015 05:00:00 AM,48,-122,13,2,15
14574,SpokaneStBridge,08/31/2015 06:00:00 AM,48,-122,42,7,49
14575,SpokaneStBridge,08/31/2015 07:00:00 AM,48,-122,102,15,117
14576,SpokaneStBridge,08/31/2015 08:00:00 AM,48,-122,106,11,117
14577,SpokaneStBridge,08/31/2015 09:00:00 AM,48,-122,34,5,39
14578,SpokaneStBridge,08/31/2015 10:00:00 AM,48,-122,12,4,16
14579,SpokaneStBridge,08/31/2015 11:00:00 AM,48,-122,4,3,7
14580,SpokaneStBridge,08/31/2015 12:00:00 PM,48,-122,6,6,12
14581,SpokaneStBridge,08/31/2015 01:00:00 PM,48,-122,6,3,9
14582,SpokaneStBridge,08/31/2015 02:00:00 PM,48,-122,3,16,19
14583,SpokaneStBridge,08/31/2015 03:00:00 PM,48,-122,12,25,37
14584,SpokaneStBridge,08/31/2015 04:00:00 PM,48,-122,15,58,73
14585,SpokaneStBridge,08/31/2015 05:00:00 PM,48,-122,10,122,132
14586,SpokaneStBridge,08/31/2015 06:00:00 PM,48,-122,15,67,82
14587,SpokaneStBridge,08/31/2015 07:00:00 PM,48,-122,7,33,40
14588,SpokaneStBridge,08/31/2015 08:00:00 PM,48,-122,4,14,18
14589,SpokaneStBridge,08/31/2015 09:00:00 PM,48,-122,1,4,5
14590,SpokaneStBridge,08/31/2015 10:00:00 PM,48,-122,0,2,2
14591,SpokaneStBridge,08/31/2015 11:00:00 PM,48,-122,3,1,4
14592,SpokaneStBridge,09/01/2015 12:00:00 AM,48,-122,0,3,3
14593,SpokaneStBridge,09/01/2015 01:00:00 AM,48,-122,0,4,4
14594,SpokaneStBridge,09/01/2015 02:00:00 AM,48,-122,0,1,1
14595,SpokaneStBridge,09/01/2015 03:00:00 AM,48,-122,1,1,2
14596,SpokaneStBridge,09/01/2015 04:00:00 AM,48,-122,5,1,6
14597,SpokaneStBridge,09/01/2015 05:00:00 AM,48,-122,18,0,18
14598,SpokaneStBridge,09/01/2015 06:00:00 AM,48,-122,46,7,53
14599,SpokaneStBridge,09/01/2015 07:00:00 AM,48,-122,96,13,109
14600,SpokaneStBridge,09/01/2015 08:00:00 AM,48,-122,83,13,96
14601,SpokaneStBridge,09/01/2015 09:00:00 AM,48,-122,29,4,33
14602,SpokaneStBridge,09/01/2015 10:00:00 AM,48,-122,7,2,9
14603,SpokaneStBridge,09/01/2015 11:00:00 AM,48,-122,8,2,10
14604,SpokaneStBridge,09/01/2015 12:00:00 PM,48,-122,7,7,14
14605,SpokaneStBridge,09/01/2015 01:00:00 PM,48,-122,13,7,20
14606,SpokaneStBridge,09/01/2015 02:00:00 PM,48,-122,11,10,21
14607,SpokaneStBridge,09/01/2015 03:00:00 PM,48,-122,5,18,23
14608,SpokaneStBridge,09/01/2015 04:00:00 PM,48,-122,13,53,66
14609,SpokaneStBridge,09/01/2015 05:00:00 PM,48,-122,15,103,118
14610,SpokaneStBridge,09/01/2015 06:00:00 PM,48,-122,9,64,73
14611,SpokaneStBridge,09/01/2015 07:00:00 PM,48,-122,7,26,33
14612,SpokaneStBridge,09/01/2015 08:00:00 PM,48,-122,4,14,18
14613,SpokaneStBridge,09/01/2015 09:00:00 PM,48,-122,1,13,14
14614,SpokaneStBridge,09/01/2015 10:00:00 PM,48,-122,0,2,2
14615,SpokaneStBridge,09/01/2015 11:00:00 PM,48,-122,1,6,7
14616,SpokaneStBridge,09/02/2015 12:00:00 AM,48,-122,1,2,3
14617,SpokaneStBridge,09/02/2015 01:00:00 AM,48,-122,0,1,1
14618,SpokaneStBridge,09/02/2015 02:00:00 AM,48,-122,0,2,2
14619,SpokaneStBridge,09/02/2015 03:00:00 AM,48,-122,2,1,3
14620,SpokaneStBridge,09/02/2015 04:00:00 AM,48,-122,4,0,4
14621,SpokaneStBridge,09/02/2015 05:00:00 AM,48,-122,19,0,19
14622,SpokaneStBridge,09/02/2015 06:00:00 AM,48,-122,63,4,67
14623,SpokaneStBridge,09/02/2015 07:00:00 AM,48,-122,121,12,133
14624,SpokaneStBridge,09/02/2015 08:00:00 AM,48,-122,106,13,119
14625,SpokaneStBridge,09/02/2015 09:00:00 AM,48,-122,44,7,51
14626,SpokaneStBridge,09/02/2015 10:00:00 AM,48,-122,19,7,26
14627,SpokaneStBridge,09/02/2015 11:00:00 AM,48,-122,19,10,29
14628,SpokaneStBridge,09/02/2015 12:00:00 PM,48,-122,21,11,32
14629,SpokaneStBridge,09/02/2015 01:00:00 PM,48,-122,13,8,21
14630,SpokaneStBridge,09/02/2015 02:00:00 PM,48,-122,11,15,26
14631,SpokaneStBridge,09/02/2015 03:00:00 PM,48,-122,19,24,43
14632,SpokaneStBridge,09/02/2015 04:00:00 PM,48,-122,26,88,114
14633,SpokaneStBridge,09/02/2015 05:00:00 PM,48,-122,18,139,157
14634,SpokaneStBridge,09/02/2015 06:00:00 PM,48,-122,19,98,117
14635,SpokaneStBridge,09/02/2015 07:00:00 PM,48,-122,8,26,34
14636,SpokaneStBridge,09/02/2015 08:00:00 PM,48,-122,7,22,29
14637,SpokaneStBridge,09/02/2015 09:00:00 PM,48,-122,1,15,16
14638,SpokaneStBridge,09/02/2015 10:00:00 PM,48,-122,1,4,5
14639,SpokaneStBridge,09/02/2015 11:00:00 PM,48,-122,2,1,3
14640,SpokaneStBridge,09/03/2015 12:00:00 AM,48,-122,0,2,2
14641,SpokaneStBridge,09/03/2015 01:00:00 AM,48,-122,0,0,0
14642,SpokaneStBridge,09/03/2015 02:00:00 AM,48,-122,2,0,2
14643,SpokaneStBridge,09/03/2015 03:00:00 AM,48,-122,0,1,1
14644,SpokaneStBridge,09/03/2015 04:00:00 AM,48,-122,6,1,7
14645,SpokaneStBridge,09/03/2015 05:00:00 AM,48,-122,20,1,21
14646,SpokaneStBridge,09/03/2015 06:00:00 AM,48,-122,55,15,70
14647,SpokaneStBridge,09/03/2015 07:00:00 AM,48,-122,100,19,119
14648,SpokaneStBridge,09/03/2015 08:00:00 AM,48,-122,103,15,118
14649,SpokaneStBridge,09/03/2015 09:00:00 AM,48,-122,46,10,56
14650,SpokaneStBridge,09/03/2015 10:00:00 AM,48,-122,17,4,21
14651,SpokaneStBridge,09/03/2015 11:00:00 AM,48,-122,13,6,19
14652,SpokaneStBridge,09/03/2015 12:00:00 PM,48,-122,20,13,33
14653,SpokaneStBridge,09/03/2015 01:00:00 PM,48,-122,6,10,16
14654,SpokaneStBridge,09/03/2015 02:00:00 PM,48,-122,8,17,25
14655,SpokaneStBridge,09/03/2015 03:00:00 PM,48,-122,17,18,35
14656,SpokaneStBridge,09/03/2015 04:00:00 PM,48,-122,24,56,80
14657,SpokaneStBridge,09/03/2015 05:00:00 PM,48,-122,23,126,149
14658,SpokaneStBridge,09/03/2015 06:00:00 PM,48,-122,12,85,97
14659,SpokaneStBridge,09/03/2015 07:00:00 PM,48,-122,7,31,38
14660,SpokaneStBridge,09/03/2015 08:00:00 PM,48,-122,6,18,24
14661,SpokaneStBridge,09/03/2015 09:00:00 PM,48,-122,1,9,10
14662,SpokaneStBridge,09/03/2015 10:00:00 PM,48,-122,0,7,7
14663,SpokaneStBridge,09/03/2015 11:00:00 PM,48,-122,2,8,10
14664,SpokaneStBridge,09/04/2015 12:00:00 AM,48,-122,1,2,3
14665,SpokaneStBridge,09/04/2015 01:00:00 AM,48,-122,0,0,0
14666,SpokaneStBridge,09/04/2015 02:00:00 AM,48,-122,2,0,2
14667,SpokaneStBridge,09/04/2015 03:00:00 AM,48,-122,1,1,2
14668,SpokaneStBridge,09/04/2015 04:00:00 AM,48,-122,3,0,3
14669,SpokaneStBridge,09/04/2015 05:00:00 AM,48,-122,21,1,22
14670,SpokaneStBridge,09/04/2015 06:00:00 AM,48,-122,47,10,57
14671,SpokaneStBridge,09/04/2015 07:00:00 AM,48,-122,87,19,106
14672,SpokaneStBridge,09/04/2015 08:00:00 AM,48,-122,91,14,105
14673,SpokaneStBridge,09/04/2015 09:00:00 AM,48,-122,34,10,44
14674,SpokaneStBridge,09/04/2015 10:00:00 AM,48,-122,21,9,30
14675,SpokaneStBridge,09/04/2015 11:00:00 AM,48,-122,12,17,29
14676,SpokaneStBridge,09/04/2015 12:00:00 PM,48,-122,23,10,33
14677,SpokaneStBridge,09/04/2015 01:00:00 PM,48,-122,11,16,27
14678,SpokaneStBridge,09/04/2015 02:00:00 PM,48,-122,8,25,33
14679,SpokaneStBridge,09/04/2015 03:00:00 PM,48,-122,19,43,62
14680,SpokaneStBridge,09/04/2015 04:00:00 PM,48,-122,25,76,101
14681,SpokaneStBridge,09/04/2015 05:00:00 PM,48,-122,14,95,109
14682,SpokaneStBridge,09/04/2015 06:00:00 PM,48,-122,16,43,59
14683,SpokaneStBridge,09/04/2015 07:00:00 PM,48,-122,6,31,37
14684,SpokaneStBridge,09/04/2015 08:00:00 PM,48,-122,6,13,19
14685,SpokaneStBridge,09/04/2015 09:00:00 PM,48,-122,5,8,13
14686,SpokaneStBridge,09/04/2015 10:00:00 PM,48,-122,0,2,2
14687,SpokaneStBridge,09/04/2015 11:00:00 PM,48,-122,0,1,1
14688,SpokaneStBridge,09/05/2015 12:00:00 AM,48,-122,2,1,3
14689,SpokaneStBridge,09/05/2015 01:00:00 AM,48,-122,1,2,3
14690,SpokaneStBridge,09/05/2015 02:00:00 AM,48,-122,2,0,2
14691,SpokaneStBridge,09/05/2015 03:00:00 AM,48,-122,1,0,1
14692,SpokaneStBridge,09/05/2015 04:00:00 AM,48,-122,2,1,3
14693,SpokaneStBridge,09/05/2015 05:00:00 AM,48,-122,2,0,2
14694,SpokaneStBridge,09/05/2015 06:00:00 AM,48,-122,9,1,10
14695,SpokaneStBridge,09/05/2015 07:00:00 AM,48,-122,20,9,29
14696,SpokaneStBridge,09/05/2015 08:00:00 AM,48,-122,18,23,41
14697,SpokaneStBridge,09/05/2015 09:00:00 AM,48,-122,10,24,34
14698,SpokaneStBridge,09/05/2015 10:00:00 AM,48,-122,39,24,63
14699,SpokaneStBridge,09/05/2015 11:00:00 AM,48,-122,20,11,31
14700,SpokaneStBridge,09/05/2015 12:00:00 PM,48,-122,26,29,55
14701,SpokaneStBridge,09/05/2015 01:00:00 PM,48,-122,30,22,52
14702,SpokaneStBridge,09/05/2015 02:00:00 PM,48,-122,36,36,72
14703,SpokaneStBridge,09/05/2015 03:00:00 PM,48,-122,31,32,63
14704,SpokaneStBridge,09/05/2015 04:00:00 PM,48,-122,14,20,34
14705,SpokaneStBridge,09/05/2015 05:00:00 PM,48,-122,20,11,31
14706,SpokaneStBridge,09/05/2015 06:00:00 PM,48,-122,6,18,24
14707,SpokaneStBridge,09/05/2015 07:00:00 PM,48,-122,3,12,15
14708,SpokaneStBridge,09/05/2015 08:00:00 PM,48,-122,1,2,3
14709,SpokaneStBridge,09/05/2015 09:00:00 PM,48,-122,2,6,8
14710,SpokaneStBridge,09/05/2015 10:00:00 PM,48,-122,1,3,4
14711,SpokaneStBridge,09/05/2015 11:00:00 PM,48,-122,2,2,4
14712,SpokaneStBridge,09/06/2015 12:00:00 AM,48,-122,2,2,4
14713,SpokaneStBridge,09/06/2015 01:00:00 AM,48,-122,0,3,3
14714,SpokaneStBridge,09/06/2015 02:00:00 AM,48,-122,0,1,1
14715,SpokaneStBridge,09/06/2015 03:00:00 AM,48,-122,1,1,2
14716,SpokaneStBridge,09/06/2015 04:00:00 AM,48,-122,0,2,2
14717,SpokaneStBridge,09/06/2015 05:00:00 AM,48,-122,3,0,3
14718,SpokaneStBridge,09/06/2015 06:00:00 AM,48,-122,2,0,2
14719,SpokaneStBridge,09/06/2015 07:00:00 AM,48,-122,1,2,3
14720,SpokaneStBridge,09/06/2015 08:00:00 AM,48,-122,6,3,9
14721,SpokaneStBridge,09/06/2015 09:00:00 AM,48,-122,5,4,9
14722,SpokaneStBridge,09/06/2015 10:00:00 AM,48,-122,13,6,19
14723,SpokaneStBridge,09/06/2015 11:00:00 AM,48,-122,13,8,21
14724,SpokaneStBridge,09/06/2015 12:00:00 PM,48,-122,5,11,16
14725,SpokaneStBridge,09/06/2015 01:00:00 PM,48,-122,13,6,19
14726,SpokaneStBridge,09/06/2015 02:00:00 PM,48,-122,6,10,16
14727,SpokaneStBridge,09/06/2015 03:00:00 PM,48,-122,12,10,22
14728,SpokaneStBridge,09/06/2015 04:00:00 PM,48,-122,6,12,18
14729,SpokaneStBridge,09/06/2015 05:00:00 PM,48,-122,5,10,15
14730,SpokaneStBridge,09/06/2015 06:00:00 PM,48,-122,9,6,15
14731,SpokaneStBridge,09/06/2015 07:00:00 PM,48,-122,4,1,5
14732,SpokaneStBridge,09/06/2015 08:00:00 PM,48,-122,5,11,16
14733,SpokaneStBridge,09/06/2015 09:00:00 PM,48,-122,2,1,3
14734,SpokaneStBridge,09/06/2015 10:00:00 PM,48,-122,0,2,2
14735,SpokaneStBridge,09/06/2015 11:00:00 PM,48,-122,1,1,2
14736,SpokaneStBridge,09/07/2015 12:00:00 AM,48,-122,0,1,1
14737,SpokaneStBridge,09/07/2015 01:00:00 AM,48,-122,0,2,2
14738,SpokaneStBridge,09/07/2015 02:00:00 AM,48,-122,1,2,3
14739,SpokaneStBridge,09/07/2015 03:00:00 AM,48,-122,0,0,0
14740,SpokaneStBridge,09/07/2015 04:00:00 AM,48,-122,0,2,2
14741,SpokaneStBridge,09/07/2015 05:00:00 AM,48,-122,2,0,2
14742,SpokaneStBridge,09/07/2015 06:00:00 AM,48,-122,5,0,5
14743,SpokaneStBridge,09/07/2015 07:00:00 AM,48,-122,6,2,8
14744,SpokaneStBridge,09/07/2015 08:00:00 AM,48,-122,14,7,21
14745,SpokaneStBridge,09/07/2015 09:00:00 AM,48,-122,28,57,85
14746,SpokaneStBridge,09/07/2015 10:00:00 AM,48,-122,27,25,52
14747,SpokaneStBridge,09/07/2015 11:00:00 AM,48,-122,20,34,54
14748,SpokaneStBridge,09/07/2015 12:00:00 PM,48,-122,25,53,78
14749,SpokaneStBridge,09/07/2015 01:00:00 PM,48,-122,41,30,71
14750,SpokaneStBridge,09/07/2015 02:00:00 PM,48,-122,47,32,79
14751,SpokaneStBridge,09/07/2015 03:00:00 PM,48,-122,55,49,104
14752,SpokaneStBridge,09/07/2015 04:00:00 PM,48,-122,37,51,88
14753,SpokaneStBridge,09/07/2015 05:00:00 PM,48,-122,28,31,59
14754,SpokaneStBridge,09/07/2015 06:00:00 PM,48,-122,23,24,47
14755,SpokaneStBridge,09/07/2015 07:00:00 PM,48,-122,11,21,32
14756,SpokaneStBridge,09/07/2015 08:00:00 PM,48,-122,10,7,17
14757,SpokaneStBridge,09/07/2015 09:00:00 PM,48,-122,2,5,7
14758,SpokaneStBridge,09/07/2015 10:00:00 PM,48,-122,3,3,6
14759,SpokaneStBridge,09/07/2015 11:00:00 PM,48,-122,1,5,6
14760,SpokaneStBridge,09/08/2015 12:00:00 AM,48,-122,0,2,2
14761,SpokaneStBridge,09/08/2015 01:00:00 AM,48,-122,0,1,1
14762,SpokaneStBridge,09/08/2015 02:00:00 AM,48,-122,2,0,2
14763,SpokaneStBridge,09/08/2015 03:00:00 AM,48,-122,1,3,4
14764,SpokaneStBridge,09/08/2015 04:00:00 AM,48,-122,5,0,5
14765,SpokaneStBridge,09/08/2015 05:00:00 AM,48,-122,22,2,24
14766,SpokaneStBridge,09/08/2015 06:00:00 AM,48,-122,48,11,59
14767,SpokaneStBridge,09/08/2015 07:00:00 AM,48,-122,135,22,157
14768,SpokaneStBridge,09/08/2015 08:00:00 AM,48,-122,131,17,148
14769,SpokaneStBridge,09/08/2015 09:00:00 AM,48,-122,50,7,57
14770,SpokaneStBridge,09/08/2015 10:00:00 AM,48,-122,10,5,15
14771,SpokaneStBridge,09/08/2015 11:00:00 AM,48,-122,7,5,12
14772,SpokaneStBridge,09/08/2015 12:00:00 PM,48,-122,14,15,29
14773,SpokaneStBridge,09/08/2015 01:00:00 PM,48,-122,10,11,21
14774,SpokaneStBridge,09/08/2015 02:00:00 PM,48,-122,10,17,27
14775,SpokaneStBridge,09/08/2015 03:00:00 PM,48,-122,14,31,45
14776,SpokaneStBridge,09/08/2015 04:00:00 PM,48,-122,30,79,109
14777,SpokaneStBridge,09/08/2015 05:00:00 PM,48,-122,21,155,176
14778,SpokaneStBridge,09/08/2015 06:00:00 PM,48,-122,20,117,137
14779,SpokaneStBridge,09/08/2015 07:00:00 PM,48,-122,12,41,53
14780,SpokaneStBridge,09/08/2015 08:00:00 PM,48,-122,3,20,23
14781,SpokaneStBridge,09/08/2015 09:00:00 PM,48,-122,4,17,21
14782,SpokaneStBridge,09/08/2015 10:00:00 PM,48,-122,4,5,9
14783,SpokaneStBridge,09/08/2015 11:00:00 PM,48,-122,5,8,13
14784,SpokaneStBridge,09/09/2015 12:00:00 AM,48,-122,2,2,4
14785,SpokaneStBridge,09/09/2015 01:00:00 AM,48,-122,0,0,0
14786,SpokaneStBridge,09/09/2015 02:00:00 AM,48,-122,2,0,2
14787,SpokaneStBridge,09/09/2015 03:00:00 AM,48,-122,1,4,5
14788,SpokaneStBridge,09/09/2015 04:00:00 AM,48,-122,4,0,4
14789,SpokaneStBridge,09/09/2015 05:00:00 AM,48,-122,23,2,25
14790,SpokaneStBridge,09/09/2015 06:00:00 AM,48,-122,63,9,72
14791,SpokaneStBridge,09/09/2015 07:00:00 AM,48,-122,145,15,160
14792,SpokaneStBridge,09/09/2015 08:00:00 AM,48,-122,139,21,160
14793,SpokaneStBridge,09/09/2015 09:00:00 AM,48,-122,49,8,57
14794,SpokaneStBridge,09/09/2015 10:00:00 AM,48,-122,29,10,39
14795,SpokaneStBridge,09/09/2015 11:00:00 AM,48,-122,15,11,26
14796,SpokaneStBridge,09/09/2015 12:00:00 PM,48,-122,17,18,35
14797,SpokaneStBridge,09/09/2015 01:00:00 PM,48,-122,13,24,37
14798,SpokaneStBridge,09/09/2015 02:00:00 PM,48,-122,16,17,33
14799,SpokaneStBridge,09/09/2015 03:00:00 PM,48,-122,14,46,60
14800,SpokaneStBridge,09/09/2015 04:00:00 PM,48,-122,32,77,109
14801,SpokaneStBridge,09/09/2015 05:00:00 PM,48,-122,25,160,185
14802,SpokaneStBridge,09/09/2015 06:00:00 PM,48,-122,26,115,141
14803,SpokaneStBridge,09/09/2015 07:00:00 PM,48,-122,12,43,55
14804,SpokaneStBridge,09/09/2015 08:00:00 PM,48,-122,5,21,26
14805,SpokaneStBridge,09/09/2015 09:00:00 PM,48,-122,2,16,18
14806,SpokaneStBridge,09/09/2015 10:00:00 PM,48,-122,4,13,17
14807,SpokaneStBridge,09/09/2015 11:00:00 PM,48,-122,1,4,5
14808,SpokaneStBridge,09/10/2015 12:00:00 AM,48,-122,2,2,4
14809,SpokaneStBridge,09/10/2015 01:00:00 AM,48,-122,1,0,1
14810,SpokaneStBridge,09/10/2015 02:00:00 AM,48,-122,1,2,3
14811,SpokaneStBridge,09/10/2015 03:00:00 AM,48,-122,1,0,1
14812,SpokaneStBridge,09/10/2015 04:00:00 AM,48,-122,3,0,3
14813,SpokaneStBridge,09/10/2015 05:00:00 AM,48,-122,17,2,19
14814,SpokaneStBridge,09/10/2015 06:00:00 AM,48,-122,65,9,74
14815,SpokaneStBridge,09/10/2015 07:00:00 AM,48,-122,138,14,152
14816,SpokaneStBridge,09/10/2015 08:00:00 AM,48,-122,136,19,155
14817,SpokaneStBridge,09/10/2015 09:00:00 AM,48,-122,64,12,76
14818,SpokaneStBridge,09/10/2015 10:00:00 AM,48,-122,24,12,36
14819,SpokaneStBridge,09/10/2015 11:00:00 AM,48,-122,19,8,27
14820,SpokaneStBridge,09/10/2015 12:00:00 PM,48,-122,13,18,31
14821,SpokaneStBridge,09/10/2015 01:00:00 PM,48,-122,19,9,28
14822,SpokaneStBridge,09/10/2015 02:00:00 PM,48,-122,16,20,36
14823,SpokaneStBridge,09/10/2015 03:00:00 PM,48,-122,13,40,53
14824,SpokaneStBridge,09/10/2015 04:00:00 PM,48,-122,23,82,105
14825,SpokaneStBridge,09/10/2015 05:00:00 PM,48,-122,37,170,207
14826,SpokaneStBridge,09/10/2015 06:00:00 PM,48,-122,14,109,123
14827,SpokaneStBridge,09/10/2015 07:00:00 PM,48,-122,6,42,48
14828,SpokaneStBridge,09/10/2015 08:00:00 PM,48,-122,11,19,30
14829,SpokaneStBridge,09/10/2015 09:00:00 PM,48,-122,6,16,22
14830,SpokaneStBridge,09/10/2015 10:00:00 PM,48,-122,5,8,13
14831,SpokaneStBridge,09/10/2015 11:00:00 PM,48,-122,3,6,9
14832,SpokaneStBridge,09/11/2015 12:00:00 AM,48,-122,2,2,4
14833,SpokaneStBridge,09/11/2015 01:00:00 AM,48,-122,0,0,0
14834,SpokaneStBridge,09/11/2015 02:00:00 AM,48,-122,2,1,3
14835,SpokaneStBridge,09/11/2015 03:00:00 AM,48,-122,0,0,0
14836,SpokaneStBridge,09/11/2015 04:00:00 AM,48,-122,6,0,6
14837,SpokaneStBridge,09/11/2015 05:00:00 AM,48,-122,17,5,22
14838,SpokaneStBridge,09/11/2015 06:00:00 AM,48,-122,48,10,58
14839,SpokaneStBridge,09/11/2015 07:00:00 AM,48,-122,111,19,130
14840,SpokaneStBridge,09/11/2015 08:00:00 AM,48,-122,126,14,140
14841,SpokaneStBridge,09/11/2015 09:00:00 AM,48,-122,34,6,40
14842,SpokaneStBridge,09/11/2015 10:00:00 AM,48,-122,28,10,38
14843,SpokaneStBridge,09/11/2015 11:00:00 AM,48,-122,10,11,21
14844,SpokaneStBridge,09/11/2015 12:00:00 PM,48,-122,13,14,27
14845,SpokaneStBridge,09/11/2015 01:00:00 PM,48,-122,18,17,35
14846,SpokaneStBridge,09/11/2015 02:00:00 PM,48,-122,24,24,48
14847,SpokaneStBridge,09/11/2015 03:00:00 PM,48,-122,19,50,69
14848,SpokaneStBridge,09/11/2015 04:00:00 PM,48,-122,26,80,106
14849,SpokaneStBridge,09/11/2015 05:00:00 PM,48,-122,18,133,151
14850,SpokaneStBridge,09/11/2015 06:00:00 PM,48,-122,10,57,67
14851,SpokaneStBridge,09/11/2015 07:00:00 PM,48,-122,11,47,58
14852,SpokaneStBridge,09/11/2015 08:00:00 PM,48,-122,6,16,22
14853,SpokaneStBridge,09/11/2015 09:00:00 PM,48,-122,5,10,15
14854,SpokaneStBridge,09/11/2015 10:00:00 PM,48,-122,2,7,9
14855,SpokaneStBridge,09/11/2015 11:00:00 PM,48,-122,0,5,5
14856,SpokaneStBridge,09/12/2015 12:00:00 AM,48,-122,6,3,9
14857,SpokaneStBridge,09/12/2015 01:00:00 AM,48,-122,0,1,1
14858,SpokaneStBridge,09/12/2015 02:00:00 AM,48,-122,1,1,2
14859,SpokaneStBridge,09/12/2015 03:00:00 AM,48,-122,2,0,2
14860,SpokaneStBridge,09/12/2015 04:00:00 AM,48,-122,1,1,2
14861,SpokaneStBridge,09/12/2015 05:00:00 AM,48,-122,8,2,10
14862,SpokaneStBridge,09/12/2015 06:00:00 AM,48,-122,3,4,7
14863,SpokaneStBridge,09/12/2015 07:00:00 AM,48,-122,16,5,21
14864,SpokaneStBridge,09/12/2015 08:00:00 AM,48,-122,17,13,30
14865,SpokaneStBridge,09/12/2015 09:00:00 AM,48,-122,28,18,46
14866,SpokaneStBridge,09/12/2015 10:00:00 AM,48,-122,31,35,66
14867,SpokaneStBridge,09/12/2015 11:00:00 AM,48,-122,32,24,56
14868,SpokaneStBridge,09/12/2015 12:00:00 PM,48,-122,36,39,75
14869,SpokaneStBridge,09/12/2015 01:00:00 PM,48,-122,36,41,77
14870,SpokaneStBridge,09/12/2015 02:00:00 PM,48,-122,36,34,70
14871,SpokaneStBridge,09/12/2015 03:00:00 PM,48,-122,36,50,86
14872,SpokaneStBridge,09/12/2015 04:00:00 PM,48,-122,28,44,72
14873,SpokaneStBridge,09/12/2015 05:00:00 PM,48,-122,38,33,71
14874,SpokaneStBridge,09/12/2015 06:00:00 PM,48,-122,17,15,32
14875,SpokaneStBridge,09/12/2015 07:00:00 PM,48,-122,8,22,30
14876,SpokaneStBridge,09/12/2015 08:00:00 PM,48,-122,10,12,22
14877,SpokaneStBridge,09/12/2015 09:00:00 PM,48,-122,4,9,13
14878,SpokaneStBridge,09/12/2015 10:00:00 PM,48,-122,5,4,9
14879,SpokaneStBridge,09/12/2015 11:00:00 PM,48,-122,6,9,15
14880,SpokaneStBridge,09/13/2015 12:00:00 AM,48,-122,4,4,8
14881,SpokaneStBridge,09/13/2015 01:00:00 AM,48,-122,1,6,7
14882,SpokaneStBridge,09/13/2015 02:00:00 AM,48,-122,0,2,2
14883,SpokaneStBridge,09/13/2015 03:00:00 AM,48,-122,0,0,0
14884,SpokaneStBridge,09/13/2015 04:00:00 AM,48,-122,1,2,3
14885,SpokaneStBridge,09/13/2015 05:00:00 AM,48,-122,2,1,3
14886,SpokaneStBridge,09/13/2015 06:00:00 AM,48,-122,1,0,1
14887,SpokaneStBridge,09/13/2015 07:00:00 AM,48,-122,5,0,5
14888,SpokaneStBridge,09/13/2015 08:00:00 AM,48,-122,11,6,17
14889,SpokaneStBridge,09/13/2015 09:00:00 AM,48,-122,18,12,30
14890,SpokaneStBridge,09/13/2015 10:00:00 AM,48,-122,17,17,34
14891,SpokaneStBridge,09/13/2015 11:00:00 AM,48,-122,8,9,17
14892,SpokaneStBridge,09/13/2015 12:00:00 PM,48,-122,17,4,21
14893,SpokaneStBridge,09/13/2015 01:00:00 PM,48,-122,9,10,19
14894,SpokaneStBridge,09/13/2015 02:00:00 PM,48,-122,24,11,35
14895,SpokaneStBridge,09/13/2015 03:00:00 PM,48,-122,13,18,31
14896,SpokaneStBridge,09/13/2015 04:00:00 PM,48,-122,11,20,31
14897,SpokaneStBridge,09/13/2015 05:00:00 PM,48,-122,12,18,30
14898,SpokaneStBridge,09/13/2015 06:00:00 PM,48,-122,8,7,15
14899,SpokaneStBridge,09/13/2015 07:00:00 PM,48,-122,3,13,16
14900,SpokaneStBridge,09/13/2015 08:00:00 PM,48,-122,1,3,4
14901,SpokaneStBridge,09/13/2015 09:00:00 PM,48,-122,1,3,4
14902,SpokaneStBridge,09/13/2015 10:00:00 PM,48,-122,2,1,3
14903,SpokaneStBridge,09/13/2015 11:00:00 PM,48,-122,3,2,5
14904,SpokaneStBridge,09/14/2015 12:00:00 AM,48,-122,1,2,3
14905,SpokaneStBridge,09/14/2015 01:00:00 AM,48,-122,0,0,0
14906,SpokaneStBridge,09/14/2015 02:00:00 AM,48,-122,1,0,1
14907,SpokaneStBridge,09/14/2015 03:00:00 AM,48,-122,0,2,2
14908,SpokaneStBridge,09/14/2015 04:00:00 AM,48,-122,6,1,7
14909,SpokaneStBridge,09/14/2015 05:00:00 AM,48,-122,16,2,18
14910,SpokaneStBridge,09/14/2015 06:00:00 AM,48,-122,54,8,62
14911,SpokaneStBridge,09/14/2015 07:00:00 AM,48,-122,130,9,139
14912,SpokaneStBridge,09/14/2015 08:00:00 AM,48,-122,137,12,149
14913,SpokaneStBridge,09/14/2015 09:00:00 AM,48,-122,39,6,45
14914,SpokaneStBridge,09/14/2015 10:00:00 AM,48,-122,17,9,26
14915,SpokaneStBridge,09/14/2015 11:00:00 AM,48,-122,12,5,17
14916,SpokaneStBridge,09/14/2015 12:00:00 PM,48,-122,12,10,22
14917,SpokaneStBridge,09/14/2015 01:00:00 PM,48,-122,11,12,23
14918,SpokaneStBridge,09/14/2015 02:00:00 PM,48,-122,14,11,25
14919,SpokaneStBridge,09/14/2015 03:00:00 PM,48,-122,12,28,40
14920,SpokaneStBridge,09/14/2015 04:00:00 PM,48,-122,20,75,95
14921,SpokaneStBridge,09/14/2015 05:00:00 PM,48,-122,22,150,172
14922,SpokaneStBridge,09/14/2015 06:00:00 PM,48,-122,13,82,95
14923,SpokaneStBridge,09/14/2015 07:00:00 PM,48,-122,8,34,42
14924,SpokaneStBridge,09/14/2015 08:00:00 PM,48,-122,4,12,16
14925,SpokaneStBridge,09/14/2015 09:00:00 PM,48,-122,2,7,9
14926,SpokaneStBridge,09/14/2015 10:00:00 PM,48,-122,2,3,5
14927,SpokaneStBridge,09/14/2015 11:00:00 PM,48,-122,2,2,4
14928,SpokaneStBridge,09/15/2015 12:00:00 AM,48,-122,1,2,3
14929,SpokaneStBridge,09/15/2015 01:00:00 AM,48,-122,0,0,0
14930,SpokaneStBridge,09/15/2015 02:00:00 AM,48,-122,2,1,3
14931,SpokaneStBridge,09/15/2015 03:00:00 AM,48,-122,1,1,2
14932,SpokaneStBridge,09/15/2015 04:00:00 AM,48,-122,4,0,4
14933,SpokaneStBridge,09/15/2015 05:00:00 AM,48,-122,21,3,24
14934,SpokaneStBridge,09/15/2015 06:00:00 AM,48,-122,53,8,61
14935,SpokaneStBridge,09/15/2015 07:00:00 AM,48,-122,133,11,144
14936,SpokaneStBridge,09/15/2015 08:00:00 AM,48,-122,122,18,140
14937,SpokaneStBridge,09/15/2015 09:00:00 AM,48,-122,49,5,54
14938,SpokaneStBridge,09/15/2015 10:00:00 AM,48,-122,14,9,23
14939,SpokaneStBridge,09/15/2015 11:00:00 AM,48,-122,6,12,18
14940,SpokaneStBridge,09/15/2015 12:00:00 PM,48,-122,9,14,23
14941,SpokaneStBridge,09/15/2015 01:00:00 PM,48,-122,15,8,23
14942,SpokaneStBridge,09/15/2015 02:00:00 PM,48,-122,7,15,22
14943,SpokaneStBridge,09/15/2015 03:00:00 PM,48,-122,9,27,36
14944,SpokaneStBridge,09/15/2015 04:00:00 PM,48,-122,18,79,97
14945,SpokaneStBridge,09/15/2015 05:00:00 PM,48,-122,22,145,167
14946,SpokaneStBridge,09/15/2015 06:00:00 PM,48,-122,15,97,112
14947,SpokaneStBridge,09/15/2015 07:00:00 PM,48,-122,7,27,34
14948,SpokaneStBridge,09/15/2015 08:00:00 PM,48,-122,2,7,9
14949,SpokaneStBridge,09/15/2015 09:00:00 PM,48,-122,4,8,12
14950,SpokaneStBridge,09/15/2015 10:00:00 PM,48,-122,2,8,10
14951,SpokaneStBridge,09/15/2015 11:00:00 PM,48,-122,0,5,5
14952,SpokaneStBridge,09/16/2015 12:00:00 AM,48,-122,2,0,2
14953,SpokaneStBridge,09/16/2015 01:00:00 AM,48,-122,0,0,0
14954,SpokaneStBridge,09/16/2015 02:00:00 AM,48,-122,2,0,2
14955,SpokaneStBridge,09/16/2015 03:00:00 AM,48,-122,1,1,2
14956,SpokaneStBridge,09/16/2015 04:00:00 AM,48,-122,6,0,6
14957,SpokaneStBridge,09/16/2015 05:00:00 AM,48,-122,23,1,24
14958,SpokaneStBridge,09/16/2015 06:00:00 AM,48,-122,48,9,57
14959,SpokaneStBridge,09/16/2015 07:00:00 AM,48,-122,116,12,128
14960,SpokaneStBridge,09/16/2015 08:00:00 AM,48,-122,135,10,145
14961,SpokaneStBridge,09/16/2015 09:00:00 AM,48,-122,41,8,49
14962,SpokaneStBridge,09/16/2015 10:00:00 AM,48,-122,18,5,23
14963,SpokaneStBridge,09/16/2015 11:00:00 AM,48,-122,18,13,31
14964,SpokaneStBridge,09/16/2015 12:00:00 PM,48,-122,12,9,21
14965,SpokaneStBridge,09/16/2015 01:00:00 PM,48,-122,15,15,30
14966,SpokaneStBridge,09/16/2015 02:00:00 PM,48,-122,17,26,43
14967,SpokaneStBridge,09/16/2015 03:00:00 PM,48,-122,14,28,42
14968,SpokaneStBridge,09/16/2015 04:00:00 PM,48,-122,25,75,100
14969,SpokaneStBridge,09/16/2015 05:00:00 PM,48,-122,17,152,169
14970,SpokaneStBridge,09/16/2015 06:00:00 PM,48,-122,17,90,107
14971,SpokaneStBridge,09/16/2015 07:00:00 PM,48,-122,9,28,37
14972,SpokaneStBridge,09/16/2015 08:00:00 PM,48,-122,11,28,39
14973,SpokaneStBridge,09/16/2015 09:00:00 PM,48,-122,3,13,16
14974,SpokaneStBridge,09/16/2015 10:00:00 PM,48,-122,3,5,8
14975,SpokaneStBridge,09/16/2015 11:00:00 PM,48,-122,0,0,0
14976,SpokaneStBridge,09/17/2015 12:00:00 AM,48,-122,1,2,3
14977,SpokaneStBridge,09/17/2015 01:00:00 AM,48,-122,0,1,1
14978,SpokaneStBridge,09/17/2015 02:00:00 AM,48,-122,1,0,1
14979,SpokaneStBridge,09/17/2015 03:00:00 AM,48,-122,0,0,0
14980,SpokaneStBridge,09/17/2015 04:00:00 AM,48,-122,5,0,5
14981,SpokaneStBridge,09/17/2015 05:00:00 AM,48,-122,8,2,10
14982,SpokaneStBridge,09/17/2015 06:00:00 AM,48,-122,41,6,47
14983,SpokaneStBridge,09/17/2015 07:00:00 AM,48,-122,97,13,110
14984,SpokaneStBridge,09/17/2015 08:00:00 AM,48,-122,90,5,95
14985,SpokaneStBridge,09/17/2015 09:00:00 AM,48,-122,41,4,45
14986,SpokaneStBridge,09/17/2015 10:00:00 AM,48,-122,14,1,15
14987,SpokaneStBridge,09/17/2015 11:00:00 AM,48,-122,2,4,6
14988,SpokaneStBridge,09/17/2015 12:00:00 PM,48,-122,5,10,15
14989,SpokaneStBridge,09/17/2015 01:00:00 PM,48,-122,3,7,10
14990,SpokaneStBridge,09/17/2015 02:00:00 PM,48,-122,11,8,19
14991,SpokaneStBridge,09/17/2015 03:00:00 PM,48,-122,8,13,21
14992,SpokaneStBridge,09/17/2015 04:00:00 PM,48,-122,7,36,43
14993,SpokaneStBridge,09/17/2015 05:00:00 PM,48,-122,10,90,100
14994,SpokaneStBridge,09/17/2015 06:00:00 PM,48,-122,5,63,68
14995,SpokaneStBridge,09/17/2015 07:00:00 PM,48,-122,4,58,62
14996,SpokaneStBridge,09/17/2015 08:00:00 PM,48,-122,3,13,16
14997,SpokaneStBridge,09/17/2015 09:00:00 PM,48,-122,2,9,11
14998,SpokaneStBridge,09/17/2015 10:00:00 PM,48,-122,2,3,5
14999,SpokaneStBridge,09/17/2015 11:00:00 PM,48,-122,19,3,22
15000,SpokaneStBridge,09/18/2015 12:00:00 AM,48,-122,8,1,9
15001,SpokaneStBridge,09/18/2015 01:00:00 AM,48,-122,5,2,7
15002,SpokaneStBridge,09/18/2015 02:00:00 AM,48,-122,8,1,9
15003,SpokaneStBridge,09/18/2015 03:00:00 AM,48,-122,0,0,0
15004,SpokaneStBridge,09/18/2015 04:00:00 AM,48,-122,3,1,4
15005,SpokaneStBridge,09/18/2015 05:00:00 AM,48,-122,11,2,13
15006,SpokaneStBridge,09/18/2015 06:00:00 AM,48,-122,36,8,44
15007,SpokaneStBridge,09/18/2015 07:00:00 AM,48,-122,89,20,109
15008,SpokaneStBridge,09/18/2015 08:00:00 AM,48,-122,98,17,115
15009,SpokaneStBridge,09/18/2015 09:00:00 AM,48,-122,34,6,40
15010,SpokaneStBridge,09/18/2015 10:00:00 AM,48,-122,13,7,20
15011,SpokaneStBridge,09/18/2015 11:00:00 AM,48,-122,6,5,11
15012,SpokaneStBridge,09/18/2015 12:00:00 PM,48,-122,12,8,20
15013,SpokaneStBridge,09/18/2015 01:00:00 PM,48,-122,16,12,28
15014,SpokaneStBridge,09/18/2015 02:00:00 PM,48,-122,10,20,30
15015,SpokaneStBridge,09/18/2015 03:00:00 PM,48,-122,16,33,49
15016,SpokaneStBridge,09/18/2015 04:00:00 PM,48,-122,18,64,82
15017,SpokaneStBridge,09/18/2015 05:00:00 PM,48,-122,9,110,119
15018,SpokaneStBridge,09/18/2015 06:00:00 PM,48,-122,10,71,81
15019,SpokaneStBridge,09/18/2015 07:00:00 PM,48,-122,5,27,32
15020,SpokaneStBridge,09/18/2015 08:00:00 PM,48,-122,5,4,9
15021,SpokaneStBridge,09/18/2015 09:00:00 PM,48,-122,3,11,14
15022,SpokaneStBridge,09/18/2015 10:00:00 PM,48,-122,1,1,2
15023,SpokaneStBridge,09/18/2015 11:00:00 PM,48,-122,1,1,2
15024,SpokaneStBridge,09/19/2015 12:00:00 AM,48,-122,1,7,8
15025,SpokaneStBridge,09/19/2015 01:00:00 AM,48,-122,0,0,0
15026,SpokaneStBridge,09/19/2015 02:00:00 AM,48,-122,2,1,3
15027,SpokaneStBridge,09/19/2015 03:00:00 AM,48,-122,0,1,1
15028,SpokaneStBridge,09/19/2015 04:00:00 AM,48,-122,0,1,1
15029,SpokaneStBridge,09/19/2015 05:00:00 AM,48,-122,7,1,8
15030,SpokaneStBridge,09/19/2015 06:00:00 AM,48,-122,14,2,16
15031,SpokaneStBridge,09/19/2015 07:00:00 AM,48,-122,13,5,18
15032,SpokaneStBridge,09/19/2015 08:00:00 AM,48,-122,16,11,27
15033,SpokaneStBridge,09/19/2015 09:00:00 AM,48,-122,20,14,34
15034,SpokaneStBridge,09/19/2015 10:00:00 AM,48,-122,20,15,35
15035,SpokaneStBridge,09/19/2015 11:00:00 AM,48,-122,30,31,61
15036,SpokaneStBridge,09/19/2015 12:00:00 PM,48,-122,28,32,60
15037,SpokaneStBridge,09/19/2015 01:00:00 PM,48,-122,24,26,50
15038,SpokaneStBridge,09/19/2015 02:00:00 PM,48,-122,22,27,49
15039,SpokaneStBridge,09/19/2015 03:00:00 PM,48,-122,22,19,41
15040,SpokaneStBridge,09/19/2015 04:00:00 PM,48,-122,19,29,48
15041,SpokaneStBridge,09/19/2015 05:00:00 PM,48,-122,12,25,37
15042,SpokaneStBridge,09/19/2015 06:00:00 PM,48,-122,11,19,30
15043,SpokaneStBridge,09/19/2015 07:00:00 PM,48,-122,3,9,12
15044,SpokaneStBridge,09/19/2015 08:00:00 PM,48,-122,2,5,7
15045,SpokaneStBridge,09/19/2015 09:00:00 PM,48,-122,1,3,4
15046,SpokaneStBridge,09/19/2015 10:00:00 PM,48,-122,0,1,1
15047,SpokaneStBridge,09/19/2015 11:00:00 PM,48,-122,0,2,2
15048,SpokaneStBridge,09/20/2015 12:00:00 AM,48,-122,1,4,5
15049,SpokaneStBridge,09/20/2015 01:00:00 AM,48,-122,0,1,1
15050,SpokaneStBridge,09/20/2015 02:00:00 AM,48,-122,0,0,0
15051,SpokaneStBridge,09/20/2015 03:00:00 AM,48,-122,1,2,3
15052,SpokaneStBridge,09/20/2015 04:00:00 AM,48,-122,2,0,2
15053,SpokaneStBridge,09/20/2015 05:00:00 AM,48,-122,3,1,4
15054,SpokaneStBridge,09/20/2015 06:00:00 AM,48,-122,0,0,0
15055,SpokaneStBridge,09/20/2015 07:00:00 AM,48,-122,6,3,9
15056,SpokaneStBridge,09/20/2015 08:00:00 AM,48,-122,8,11,19
15057,SpokaneStBridge,09/20/2015 09:00:00 AM,48,-122,15,16,31
15058,SpokaneStBridge,09/20/2015 10:00:00 AM,48,-122,19,13,32
15059,SpokaneStBridge,09/20/2015 11:00:00 AM,48,-122,25,22,47
15060,SpokaneStBridge,09/20/2015 12:00:00 PM,48,-122,15,15,30
15061,SpokaneStBridge,09/20/2015 01:00:00 PM,48,-122,22,14,36
15062,SpokaneStBridge,09/20/2015 02:00:00 PM,48,-122,15,15,30
15063,SpokaneStBridge,09/20/2015 03:00:00 PM,48,-122,11,18,29
15064,SpokaneStBridge,09/20/2015 04:00:00 PM,48,-122,18,13,31
15065,SpokaneStBridge,09/20/2015 05:00:00 PM,48,-122,7,20,27
15066,SpokaneStBridge,09/20/2015 06:00:00 PM,48,-122,8,10,18
15067,SpokaneStBridge,09/20/2015 07:00:00 PM,48,-122,2,8,10
15068,SpokaneStBridge,09/20/2015 08:00:00 PM,48,-122,2,1,3
15069,SpokaneStBridge,09/20/2015 09:00:00 PM,48,-122,1,1,2
15070,SpokaneStBridge,09/20/2015 10:00:00 PM,48,-122,0,0,0
15071,SpokaneStBridge,09/20/2015 11:00:00 PM,48,-122,2,3,5
15072,SpokaneStBridge,09/21/2015 12:00:00 AM,48,-122,0,2,2
15073,SpokaneStBridge,09/21/2015 01:00:00 AM,48,-122,0,0,0
15074,SpokaneStBridge,09/21/2015 02:00:00 AM,48,-122,0,0,0
15075,SpokaneStBridge,09/21/2015 03:00:00 AM,48,-122,0,1,1
15076,SpokaneStBridge,09/21/2015 04:00:00 AM,48,-122,3,1,4
15077,SpokaneStBridge,09/21/2015 05:00:00 AM,48,-122,22,3,25
15078,SpokaneStBridge,09/21/2015 06:00:00 AM,48,-122,52,7,59
15079,SpokaneStBridge,09/21/2015 07:00:00 AM,48,-122,150,20,170
15080,SpokaneStBridge,09/21/2015 08:00:00 AM,48,-122,136,21,157
15081,SpokaneStBridge,09/21/2015 09:00:00 AM,48,-122,39,6,45
15082,SpokaneStBridge,09/21/2015 10:00:00 AM,48,-122,22,6,28
15083,SpokaneStBridge,09/21/2015 11:00:00 AM,48,-122,13,8,21
15084,SpokaneStBridge,09/21/2015 12:00:00 PM,48,-122,18,16,34
15085,SpokaneStBridge,09/21/2015 01:00:00 PM,48,-122,15,12,27
15086,SpokaneStBridge,09/21/2015 02:00:00 PM,48,-122,11,23,34
15087,SpokaneStBridge,09/21/2015 03:00:00 PM,48,-122,16,38,54
15088,SpokaneStBridge,09/21/2015 04:00:00 PM,48,-122,21,96,117
15089,SpokaneStBridge,09/21/2015 05:00:00 PM,48,-122,20,153,173
15090,SpokaneStBridge,09/21/2015 06:00:00 PM,48,-122,21,124,145
15091,SpokaneStBridge,09/21/2015 07:00:00 PM,48,-122,9,33,42
15092,SpokaneStBridge,09/21/2015 08:00:00 PM,48,-122,8,13,21
15093,SpokaneStBridge,09/21/2015 09:00:00 PM,48,-122,3,8,11
15094,SpokaneStBridge,09/21/2015 10:00:00 PM,48,-122,3,6,9
15095,SpokaneStBridge,09/21/2015 11:00:00 PM,48,-122,0,6,6
15096,SpokaneStBridge,09/22/2015 12:00:00 AM,48,-122,0,1,1
15097,SpokaneStBridge,09/22/2015 01:00:00 AM,48,-122,0,1,1
15098,SpokaneStBridge,09/22/2015 02:00:00 AM,48,-122,1,0,1
15099,SpokaneStBridge,09/22/2015 03:00:00 AM,48,-122,2,2,4
15100,SpokaneStBridge,09/22/2015 04:00:00 AM,48,-122,2,0,2
15101,SpokaneStBridge,09/22/2015 05:00:00 AM,48,-122,32,4,36
15102,SpokaneStBridge,09/22/2015 06:00:00 AM,48,-122,83,12,95
15103,SpokaneStBridge,09/22/2015 07:00:00 AM,48,-122,166,25,191
15104,SpokaneStBridge,09/22/2015 08:00:00 AM,48,-122,169,14,183
15105,SpokaneStBridge,09/22/2015 09:00:00 AM,48,-122,47,4,51
15106,SpokaneStBridge,09/22/2015 10:00:00 AM,48,-122,24,12,36
15107,SpokaneStBridge,09/22/2015 11:00:00 AM,48,-122,16,7,23
15108,SpokaneStBridge,09/22/2015 12:00:00 PM,48,-122,11,24,35
15109,SpokaneStBridge,09/22/2015 01:00:00 PM,48,-122,18,19,37
15110,SpokaneStBridge,09/22/2015 02:00:00 PM,48,-122,23,20,43
15111,SpokaneStBridge,09/22/2015 03:00:00 PM,48,-122,15,39,54
15112,SpokaneStBridge,09/22/2015 04:00:00 PM,48,-122,22,120,142
15113,SpokaneStBridge,09/22/2015 05:00:00 PM,48,-122,28,181,209
15114,SpokaneStBridge,09/22/2015 06:00:00 PM,48,-122,18,136,154
15115,SpokaneStBridge,09/22/2015 07:00:00 PM,48,-122,12,44,56
15116,SpokaneStBridge,09/22/2015 08:00:00 PM,48,-122,6,18,24
15117,SpokaneStBridge,09/22/2015 09:00:00 PM,48,-122,1,7,8
15118,SpokaneStBridge,09/22/2015 10:00:00 PM,48,-122,1,11,12
15119,SpokaneStBridge,09/22/2015 11:00:00 PM,48,-122,1,1,2
15120,SpokaneStBridge,09/23/2015 12:00:00 AM,48,-122,0,1,1
15121,SpokaneStBridge,09/23/2015 01:00:00 AM,48,-122,0,0,0
15122,SpokaneStBridge,09/23/2015 02:00:00 AM,48,-122,1,0,1
15123,SpokaneStBridge,09/23/2015 03:00:00 AM,48,-122,1,2,3
15124,SpokaneStBridge,09/23/2015 04:00:00 AM,48,-122,2,1,3
15125,SpokaneStBridge,09/23/2015 05:00:00 AM,48,-122,27,3,30
15126,SpokaneStBridge,09/23/2015 06:00:00 AM,48,-122,69,9,78
15127,SpokaneStBridge,09/23/2015 07:00:00 AM,48,-122,154,24,178
15128,SpokaneStBridge,09/23/2015 08:00:00 AM,48,-122,161,15,176
15129,SpokaneStBridge,09/23/2015 09:00:00 AM,48,-122,60,5,65
15130,SpokaneStBridge,09/23/2015 10:00:00 AM,48,-122,26,9,35
15131,SpokaneStBridge,09/23/2015 11:00:00 AM,48,-122,14,13,27
15132,SpokaneStBridge,09/23/2015 12:00:00 PM,48,-122,26,15,41
15133,SpokaneStBridge,09/23/2015 01:00:00 PM,48,-122,20,19,39
15134,SpokaneStBridge,09/23/2015 02:00:00 PM,48,-122,16,21,37
15135,SpokaneStBridge,09/23/2015 03:00:00 PM,48,-122,18,51,69
15136,SpokaneStBridge,09/23/2015 04:00:00 PM,48,-122,21,109,130
15137,SpokaneStBridge,09/23/2015 05:00:00 PM,48,-122,36,184,220
15138,SpokaneStBridge,09/23/2015 06:00:00 PM,48,-122,25,111,136
15139,SpokaneStBridge,09/23/2015 07:00:00 PM,48,-122,12,56,68
15140,SpokaneStBridge,09/23/2015 08:00:00 PM,48,-122,11,18,29
15141,SpokaneStBridge,09/23/2015 09:00:00 PM,48,-122,5,25,30
15142,SpokaneStBridge,09/23/2015 10:00:00 PM,48,-122,7,11,18
15143,SpokaneStBridge,09/23/2015 11:00:00 PM,48,-122,3,3,6
15144,SpokaneStBridge,09/24/2015 12:00:00 AM,48,-122,2,3,5
15145,SpokaneStBridge,09/24/2015 01:00:00 AM,48,-122,0,0,0
15146,SpokaneStBridge,09/24/2015 02:00:00 AM,48,-122,2,1,3
15147,SpokaneStBridge,09/24/2015 03:00:00 AM,48,-122,0,3,3
15148,SpokaneStBridge,09/24/2015 04:00:00 AM,48,-122,5,1,6
15149,SpokaneStBridge,09/24/2015 05:00:00 AM,48,-122,30,7,37
15150,SpokaneStBridge,09/24/2015 06:00:00 AM,48,-122,80,7,87
15151,SpokaneStBridge,09/24/2015 07:00:00 AM,48,-122,141,16,157
15152,SpokaneStBridge,09/24/2015 08:00:00 AM,48,-122,125,7,132
15153,SpokaneStBridge,09/24/2015 09:00:00 AM,48,-122,54,8,62
15154,SpokaneStBridge,09/24/2015 10:00:00 AM,48,-122,23,4,27
15155,SpokaneStBridge,09/24/2015 11:00:00 AM,48,-122,14,10,24
15156,SpokaneStBridge,09/24/2015 12:00:00 PM,48,-122,11,9,20
15157,SpokaneStBridge,09/24/2015 01:00:00 PM,48,-122,20,14,34
15158,SpokaneStBridge,09/24/2015 02:00:00 PM,48,-122,20,19,39
15159,SpokaneStBridge,09/24/2015 03:00:00 PM,48,-122,15,42,57
15160,SpokaneStBridge,09/24/2015 04:00:00 PM,48,-122,24,99,123
15161,SpokaneStBridge,09/24/2015 05:00:00 PM,48,-122,20,157,177
15162,SpokaneStBridge,09/24/2015 06:00:00 PM,48,-122,14,98,112
15163,SpokaneStBridge,09/24/2015 07:00:00 PM,48,-122,13,60,73
15164,SpokaneStBridge,09/24/2015 08:00:00 PM,48,-122,9,15,24
15165,SpokaneStBridge,09/24/2015 09:00:00 PM,48,-122,9,8,17
15166,SpokaneStBridge,09/24/2015 10:00:00 PM,48,-122,0,8,8
15167,SpokaneStBridge,09/24/2015 11:00:00 PM,48,-122,2,5,7
15168,SpokaneStBridge,09/25/2015 12:00:00 AM,48,-122,2,4,6
15169,SpokaneStBridge,09/25/2015 01:00:00 AM,48,-122,0,2,2
15170,SpokaneStBridge,09/25/2015 02:00:00 AM,48,-122,1,1,2
15171,SpokaneStBridge,09/25/2015 03:00:00 AM,48,-122,0,1,1
15172,SpokaneStBridge,09/25/2015 04:00:00 AM,48,-122,3,0,3
15173,SpokaneStBridge,09/25/2015 05:00:00 AM,48,-122,19,1,20
15174,SpokaneStBridge,09/25/2015 06:00:00 AM,48,-122,38,12,50
15175,SpokaneStBridge,09/25/2015 07:00:00 AM,48,-122,68,12,80
15176,SpokaneStBridge,09/25/2015 08:00:00 AM,48,-122,71,10,81
15177,SpokaneStBridge,09/25/2015 09:00:00 AM,48,-122,27,5,32
15178,SpokaneStBridge,09/25/2015 10:00:00 AM,48,-122,16,2,18
15179,SpokaneStBridge,09/25/2015 11:00:00 AM,48,-122,4,3,7
15180,SpokaneStBridge,09/25/2015 12:00:00 PM,48,-122,5,1,6
15181,SpokaneStBridge,09/25/2015 01:00:00 PM,48,-122,5,13,18
15182,SpokaneStBridge,09/25/2015 02:00:00 PM,48,-122,6,9,15
15183,SpokaneStBridge,09/25/2015 03:00:00 PM,48,-122,6,28,34
15184,SpokaneStBridge,09/25/2015 04:00:00 PM,48,-122,12,51,63
15185,SpokaneStBridge,09/25/2015 05:00:00 PM,48,-122,14,88,102
15186,SpokaneStBridge,09/25/2015 06:00:00 PM,48,-122,4,42,46
15187,SpokaneStBridge,09/25/2015 07:00:00 PM,48,-122,1,12,13
15188,SpokaneStBridge,09/25/2015 08:00:00 PM,48,-122,0,14,14
15189,SpokaneStBridge,09/25/2015 09:00:00 PM,48,-122,4,3,7
15190,SpokaneStBridge,09/25/2015 10:00:00 PM,48,-122,2,2,4
15191,SpokaneStBridge,09/25/2015 11:00:00 PM,48,-122,0,2,2
15192,SpokaneStBridge,09/26/2015 12:00:00 AM,48,-122,1,1,2
15193,SpokaneStBridge,09/26/2015 01:00:00 AM,48,-122,0,2,2
15194,SpokaneStBridge,09/26/2015 02:00:00 AM,48,-122,2,0,2
15195,SpokaneStBridge,09/26/2015 03:00:00 AM,48,-122,2,0,2
15196,SpokaneStBridge,09/26/2015 04:00:00 AM,48,-122,0,0,0
15197,SpokaneStBridge,09/26/2015 05:00:00 AM,48,-122,7,0,7
15198,SpokaneStBridge,09/26/2015 06:00:00 AM,48,-122,7,0,7
15199,SpokaneStBridge,09/26/2015 07:00:00 AM,48,-122,13,1,14
15200,SpokaneStBridge,09/26/2015 08:00:00 AM,48,-122,9,10,19
15201,SpokaneStBridge,09/26/2015 09:00:00 AM,48,-122,20,17,37
15202,SpokaneStBridge,09/26/2015 10:00:00 AM,48,-122,12,14,26
15203,SpokaneStBridge,09/26/2015 11:00:00 AM,48,-122,26,16,42
15204,SpokaneStBridge,09/26/2015 12:00:00 PM,48,-122,36,19,55
15205,SpokaneStBridge,09/26/2015 01:00:00 PM,48,-122,20,41,61
15206,SpokaneStBridge,09/26/2015 02:00:00 PM,48,-122,12,14,26
15207,SpokaneStBridge,09/26/2015 03:00:00 PM,48,-122,23,19,42
15208,SpokaneStBridge,09/26/2015 04:00:00 PM,48,-122,19,25,44
15209,SpokaneStBridge,09/26/2015 05:00:00 PM,48,-122,16,18,34
15210,SpokaneStBridge,09/26/2015 06:00:00 PM,48,-122,6,12,18
15211,SpokaneStBridge,09/26/2015 07:00:00 PM,48,-122,11,14,25
15212,SpokaneStBridge,09/26/2015 08:00:00 PM,48,-122,6,9,15
15213,SpokaneStBridge,09/26/2015 09:00:00 PM,48,-122,2,2,4
15214,SpokaneStBridge,09/26/2015 10:00:00 PM,48,-122,4,8,12
15215,SpokaneStBridge,09/26/2015 11:00:00 PM,48,-122,2,4,6
15216,SpokaneStBridge,09/27/2015 12:00:00 AM,48,-122,1,1,2
15217,SpokaneStBridge,09/27/2015 01:00:00 AM,48,-122,0,1,1
15218,SpokaneStBridge,09/27/2015 02:00:00 AM,48,-122,0,1,1
15219,SpokaneStBridge,09/27/2015 03:00:00 AM,48,-122,1,0,1
15220,SpokaneStBridge,09/27/2015 04:00:00 AM,48,-122,2,1,3
15221,SpokaneStBridge,09/27/2015 05:00:00 AM,48,-122,3,1,4
15222,SpokaneStBridge,09/27/2015 06:00:00 AM,48,-122,1,0,1
15223,SpokaneStBridge,09/27/2015 07:00:00 AM,48,-122,8,2,10
15224,SpokaneStBridge,09/27/2015 08:00:00 AM,48,-122,13,8,21
15225,SpokaneStBridge,09/27/2015 09:00:00 AM,48,-122,19,10,29
15226,SpokaneStBridge,09/27/2015 10:00:00 AM,48,-122,29,18,47
15227,SpokaneStBridge,09/27/2015 11:00:00 AM,48,-122,33,36,69
15228,SpokaneStBridge,09/27/2015 12:00:00 PM,48,-122,34,30,64
15229,SpokaneStBridge,09/27/2015 01:00:00 PM,48,-122,27,24,51
15230,SpokaneStBridge,09/27/2015 02:00:00 PM,48,-122,29,25,54
15231,SpokaneStBridge,09/27/2015 03:00:00 PM,48,-122,15,29,44
15232,SpokaneStBridge,09/27/2015 04:00:00 PM,48,-122,20,22,42
15233,SpokaneStBridge,09/27/2015 05:00:00 PM,48,-122,7,17,24
15234,SpokaneStBridge,09/27/2015 06:00:00 PM,48,-122,9,8,17
15235,SpokaneStBridge,09/27/2015 07:00:00 PM,48,-122,0,8,8
15236,SpokaneStBridge,09/27/2015 08:00:00 PM,48,-122,1,4,5
15237,SpokaneStBridge,09/27/2015 09:00:00 PM,48,-122,4,2,6
15238,SpokaneStBridge,09/27/2015 10:00:00 PM,48,-122,0,2,2
15239,SpokaneStBridge,09/27/2015 11:00:00 PM,48,-122,2,1,3
15240,SpokaneStBridge,09/28/2015 12:00:00 AM,48,-122,2,1,3
15241,SpokaneStBridge,09/28/2015 01:00:00 AM,48,-122,1,0,1
15242,SpokaneStBridge,09/28/2015 02:00:00 AM,48,-122,1,1,2
15243,SpokaneStBridge,09/28/2015 03:00:00 AM,48,-122,1,1,2
15244,SpokaneStBridge,09/28/2015 04:00:00 AM,48,-122,3,1,4
15245,SpokaneStBridge,09/28/2015 05:00:00 AM,48,-122,28,2,30
15246,SpokaneStBridge,09/28/2015 06:00:00 AM,48,-122,64,10,74
15247,SpokaneStBridge,09/28/2015 07:00:00 AM,48,-122,131,11,142
15248,SpokaneStBridge,09/28/2015 08:00:00 AM,48,-122,141,12,153
15249,SpokaneStBridge,09/28/2015 09:00:00 AM,48,-122,41,6,47
15250,SpokaneStBridge,09/28/2015 10:00:00 AM,48,-122,23,5,28
15251,SpokaneStBridge,09/28/2015 11:00:00 AM,48,-122,9,9,18
15252,SpokaneStBridge,09/28/2015 12:00:00 PM,48,-122,19,14,33
15253,SpokaneStBridge,09/28/2015 01:00:00 PM,48,-122,14,14,28
15254,SpokaneStBridge,09/28/2015 02:00:00 PM,48,-122,11,17,28
15255,SpokaneStBridge,09/28/2015 03:00:00 PM,48,-122,17,32,49
15256,SpokaneStBridge,09/28/2015 04:00:00 PM,48,-122,30,86,116
15257,SpokaneStBridge,09/28/2015 05:00:00 PM,48,-122,21,143,164
15258,SpokaneStBridge,09/28/2015 06:00:00 PM,48,-122,13,121,134
15259,SpokaneStBridge,09/28/2015 07:00:00 PM,48,-122,18,34,52
15260,SpokaneStBridge,09/28/2015 08:00:00 PM,48,-122,4,12,16
15261,SpokaneStBridge,09/28/2015 09:00:00 PM,48,-122,1,7,8
15262,SpokaneStBridge,09/28/2015 10:00:00 PM,48,-122,3,2,5
15263,SpokaneStBridge,09/28/2015 11:00:00 PM,48,-122,4,1,5
15264,SpokaneStBridge,09/29/2015 12:00:00 AM,48,-122,1,1,2
15265,SpokaneStBridge,09/29/2015 01:00:00 AM,48,-122,0,3,3
15266,SpokaneStBridge,09/29/2015 02:00:00 AM,48,-122,1,0,1
15267,SpokaneStBridge,09/29/2015 03:00:00 AM,48,-122,2,1,3
15268,SpokaneStBridge,09/29/2015 04:00:00 AM,48,-122,3,0,3
15269,SpokaneStBridge,09/29/2015 05:00:00 AM,48,-122,23,1,24
15270,SpokaneStBridge,09/29/2015 06:00:00 AM,48,-122,68,13,81
15271,SpokaneStBridge,09/29/2015 07:00:00 AM,48,-122,150,15,165
15272,SpokaneStBridge,09/29/2015 08:00:00 AM,48,-122,160,16,176
15273,SpokaneStBridge,09/29/2015 09:00:00 AM,48,-122,62,16,78
15274,SpokaneStBridge,09/29/2015 10:00:00 AM,48,-122,30,10,40
15275,SpokaneStBridge,09/29/2015 11:00:00 AM,48,-122,13,7,20
15276,SpokaneStBridge,09/29/2015 12:00:00 PM,48,-122,18,11,29
15277,SpokaneStBridge,09/29/2015 01:00:00 PM,48,-122,24,14,38
15278,SpokaneStBridge,09/29/2015 02:00:00 PM,48,-122,11,19,30
15279,SpokaneStBridge,09/29/2015 03:00:00 PM,48,-122,11,42,53
15280,SpokaneStBridge,09/29/2015 04:00:00 PM,48,-122,36,98,134
15281,SpokaneStBridge,09/29/2015 05:00:00 PM,48,-122,27,193,220
15282,SpokaneStBridge,09/29/2015 06:00:00 PM,48,-122,17,118,135
15283,SpokaneStBridge,09/29/2015 07:00:00 PM,48,-122,11,36,47
15284,SpokaneStBridge,09/29/2015 08:00:00 PM,48,-122,4,18,22
15285,SpokaneStBridge,09/29/2015 09:00:00 PM,48,-122,1,12,13
15286,SpokaneStBridge,09/29/2015 10:00:00 PM,48,-122,1,5,6
15287,SpokaneStBridge,09/29/2015 11:00:00 PM,48,-122,2,3,5
15288,SpokaneStBridge,09/30/2015 12:00:00 AM,48,-122,3,1,4
15289,SpokaneStBridge,09/30/2015 01:00:00 AM,48,-122,0,2,2
15290,SpokaneStBridge,09/30/2015 02:00:00 AM,48,-122,1,0,1
15291,SpokaneStBridge,09/30/2015 03:00:00 AM,48,-122,2,2,4
15292,SpokaneStBridge,09/30/2015 04:00:00 AM,48,-122,5,0,5
15293,SpokaneStBridge,09/30/2015 05:00:00 AM,48,-122,38,2,40
15294,SpokaneStBridge,09/30/2015 06:00:00 AM,48,-122,53,9,62
15295,SpokaneStBridge,09/30/2015 07:00:00 AM,48,-122,144,17,161
15296,SpokaneStBridge,09/30/2015 08:00:00 AM,48,-122,151,11,162
15297,SpokaneStBridge,09/30/2015 09:00:00 AM,48,-122,50,5,55
15298,SpokaneStBridge,09/30/2015 10:00:00 AM,48,-122,23,9,32
15299,SpokaneStBridge,09/30/2015 11:00:00 AM,48,-122,7,9,16
15300,SpokaneStBridge,09/30/2015 12:00:00 PM,48,-122,14,5,19
15301,SpokaneStBridge,09/30/2015 01:00:00 PM,48,-122,6,8,14
15302,SpokaneStBridge,09/30/2015 02:00:00 PM,48,-122,13,21,34
15303,SpokaneStBridge,09/30/2015 03:00:00 PM,48,-122,18,32,50
15304,SpokaneStBridge,09/30/2015 04:00:00 PM,48,-122,23,107,130
15305,SpokaneStBridge,09/30/2015 05:00:00 PM,48,-122,22,177,199
15306,SpokaneStBridge,09/30/2015 06:00:00 PM,48,-122,24,95,119
15307,SpokaneStBridge,09/30/2015 07:00:00 PM,48,-122,8,49,57
15308,SpokaneStBridge,09/30/2015 08:00:00 PM,48,-122,14,23,37
15309,SpokaneStBridge,09/30/2015 09:00:00 PM,48,-122,3,8,11
15310,SpokaneStBridge,09/30/2015 10:00:00 PM,48,-122,3,7,10
15311,SpokaneStBridge,09/30/2015 11:00:00 PM,48,-122,2,2,4
15312,SpokaneStBridge,10/01/2015 12:00:00 AM,48,-122,2,1,3
15313,SpokaneStBridge,10/01/2015 01:00:00 AM,48,-122,1,0,1
15314,SpokaneStBridge,10/01/2015 02:00:00 AM,48,-122,1,1,2
15315,SpokaneStBridge,10/01/2015 03:00:00 AM,48,-122,1,2,3
15316,SpokaneStBridge,10/01/2015 04:00:00 AM,48,-122,4,0,4
15317,SpokaneStBridge,10/01/2015 05:00:00 AM,48,-122,27,4,31
15318,SpokaneStBridge,10/01/2015 06:00:00 AM,48,-122,81,15,96
15319,SpokaneStBridge,10/01/2015 07:00:00 AM,48,-122,120,15,135
15320,SpokaneStBridge,10/01/2015 08:00:00 AM,48,-122,132,15,147
15321,SpokaneStBridge,10/01/2015 09:00:00 AM,48,-122,52,9,61
15322,SpokaneStBridge,10/01/2015 10:00:00 AM,48,-122,15,12,27
15323,SpokaneStBridge,10/01/2015 11:00:00 AM,48,-122,14,9,23
15324,SpokaneStBridge,10/01/2015 12:00:00 PM,48,-122,15,15,30
15325,SpokaneStBridge,10/01/2015 01:00:00 PM,48,-122,19,9,28
15326,SpokaneStBridge,10/01/2015 02:00:00 PM,48,-122,18,23,41
15327,SpokaneStBridge,10/01/2015 03:00:00 PM,48,-122,12,43,55
15328,SpokaneStBridge,10/01/2015 04:00:00 PM,48,-122,27,85,112
15329,SpokaneStBridge,10/01/2015 05:00:00 PM,48,-122,27,161,188
15330,SpokaneStBridge,10/01/2015 06:00:00 PM,48,-122,15,79,94
15331,SpokaneStBridge,10/01/2015 07:00:00 PM,48,-122,6,31,37
15332,SpokaneStBridge,10/01/2015 08:00:00 PM,48,-122,6,18,24
15333,SpokaneStBridge,10/01/2015 09:00:00 PM,48,-122,2,7,9
15334,SpokaneStBridge,10/01/2015 10:00:00 PM,48,-122,7,4,11
15335,SpokaneStBridge,10/01/2015 11:00:00 PM,48,-122,3,4,7
15336,SpokaneStBridge,10/02/2015 12:00:00 AM,48,-122,1,2,3
15337,SpokaneStBridge,10/02/2015 01:00:00 AM,48,-122,2,0,2
15338,SpokaneStBridge,10/02/2015 02:00:00 AM,48,-122,1,0,1
15339,SpokaneStBridge,10/02/2015 03:00:00 AM,48,-122,2,3,5
15340,SpokaneStBridge,10/02/2015 04:00:00 AM,48,-122,4,0,4
15341,SpokaneStBridge,10/02/2015 05:00:00 AM,48,-122,21,3,24
15342,SpokaneStBridge,10/02/2015 06:00:00 AM,48,-122,49,10,59
15343,SpokaneStBridge,10/02/2015 07:00:00 AM,48,-122,93,12,105
15344,SpokaneStBridge,10/02/2015 08:00:00 AM,48,-122,97,9,106
15345,SpokaneStBridge,10/02/2015 09:00:00 AM,48,-122,35,2,37
15346,SpokaneStBridge,10/02/2015 10:00:00 AM,48,-122,12,7,19
15347,SpokaneStBridge,10/02/2015 11:00:00 AM,48,-122,7,4,11
15348,SpokaneStBridge,10/02/2015 12:00:00 PM,48,-122,8,9,17
15349,SpokaneStBridge,10/02/2015 01:00:00 PM,48,-122,13,6,19
15350,SpokaneStBridge,10/02/2015 02:00:00 PM,48,-122,6,16,22
15351,SpokaneStBridge,10/02/2015 03:00:00 PM,48,-122,12,32,44
15352,SpokaneStBridge,10/02/2015 04:00:00 PM,48,-122,14,66,80
15353,SpokaneStBridge,10/02/2015 05:00:00 PM,48,-122,11,113,124
15354,SpokaneStBridge,10/02/2015 06:00:00 PM,48,-122,7,58,65
15355,SpokaneStBridge,10/02/2015 07:00:00 PM,48,-122,4,16,20
15356,SpokaneStBridge,10/02/2015 08:00:00 PM,48,-122,2,6,8
15357,SpokaneStBridge,10/02/2015 09:00:00 PM,48,-122,0,8,8
15358,SpokaneStBridge,10/02/2015 10:00:00 PM,48,-122,1,4,5
15359,SpokaneStBridge,10/02/2015 11:00:00 PM,48,-122,1,2,3
15360,SpokaneStBridge,10/03/2015 12:00:00 AM,48,-122,2,1,3
15361,SpokaneStBridge,10/03/2015 01:00:00 AM,48,-122,1,2,3
15362,SpokaneStBridge,10/03/2015 02:00:00 AM,48,-122,0,2,2
15363,SpokaneStBridge,10/03/2015 03:00:00 AM,48,-122,1,1,2
15364,SpokaneStBridge,10/03/2015 04:00:00 AM,48,-122,0,1,1
15365,SpokaneStBridge,10/03/2015 05:00:00 AM,48,-122,3,0,3
15366,SpokaneStBridge,10/03/2015 06:00:00 AM,48,-122,2,1,3
15367,SpokaneStBridge,10/03/2015 07:00:00 AM,48,-122,8,1,9
15368,SpokaneStBridge,10/03/2015 08:00:00 AM,48,-122,13,11,24
15369,SpokaneStBridge,10/03/2015 09:00:00 AM,48,-122,16,10,26
15370,SpokaneStBridge,10/03/2015 10:00:00 AM,48,-122,31,13,44
15371,SpokaneStBridge,10/03/2015 11:00:00 AM,48,-122,16,12,28
15372,SpokaneStBridge,10/03/2015 12:00:00 PM,48,-122,25,31,56
15373,SpokaneStBridge,10/03/2015 01:00:00 PM,48,-122,23,24,47
15374,SpokaneStBridge,10/03/2015 02:00:00 PM,48,-122,14,24,38
15375,SpokaneStBridge,10/03/2015 03:00:00 PM,48,-122,28,39,67
15376,SpokaneStBridge,10/03/2015 04:00:00 PM,48,-122,27,26,53
15377,SpokaneStBridge,10/03/2015 05:00:00 PM,48,-122,12,19,31
15378,SpokaneStBridge,10/03/2015 06:00:00 PM,48,-122,11,10,21
15379,SpokaneStBridge,10/03/2015 07:00:00 PM,48,-122,4,5,9
15380,SpokaneStBridge,10/03/2015 08:00:00 PM,48,-122,5,6,11
15381,SpokaneStBridge,10/03/2015 09:00:00 PM,48,-122,0,2,2
15382,SpokaneStBridge,10/03/2015 10:00:00 PM,48,-122,0,1,1
15383,SpokaneStBridge,10/03/2015 11:00:00 PM,48,-122,5,3,8
15384,SpokaneStBridge,10/04/2015 12:00:00 AM,48,-122,2,0,2
15385,SpokaneStBridge,10/04/2015 01:00:00 AM,48,-122,0,4,4
15386,SpokaneStBridge,10/04/2015 02:00:00 AM,48,-122,0,0,0
15387,SpokaneStBridge,10/04/2015 03:00:00 AM,48,-122,1,2,3
15388,SpokaneStBridge,10/04/2015 04:00:00 AM,48,-122,1,2,3
15389,SpokaneStBridge,10/04/2015 05:00:00 AM,48,-122,4,1,5
15390,SpokaneStBridge,10/04/2015 06:00:00 AM,48,-122,2,2,4
15391,SpokaneStBridge,10/04/2015 07:00:00 AM,48,-122,5,3,8
15392,SpokaneStBridge,10/04/2015 08:00:00 AM,48,-122,26,5,31
15393,SpokaneStBridge,10/04/2015 09:00:00 AM,48,-122,17,8,25
15394,SpokaneStBridge,10/04/2015 10:00:00 AM,48,-122,20,17,37
15395,SpokaneStBridge,10/04/2015 11:00:00 AM,48,-122,29,40,69
15396,SpokaneStBridge,10/04/2015 12:00:00 PM,48,-122,30,35,65
15397,SpokaneStBridge,10/04/2015 01:00:00 PM,48,-122,29,30,59
15398,SpokaneStBridge,10/04/2015 02:00:00 PM,48,-122,41,33,74
15399,SpokaneStBridge,10/04/2015 03:00:00 PM,48,-122,41,40,81
15400,SpokaneStBridge,10/04/2015 04:00:00 PM,48,-122,30,33,63
15401,SpokaneStBridge,10/04/2015 05:00:00 PM,48,-122,19,24,43
15402,SpokaneStBridge,10/04/2015 06:00:00 PM,48,-122,13,12,25
15403,SpokaneStBridge,10/04/2015 07:00:00 PM,48,-122,8,7,15
15404,SpokaneStBridge,10/04/2015 08:00:00 PM,48,-122,1,9,10
15405,SpokaneStBridge,10/04/2015 09:00:00 PM,48,-122,1,5,6
15406,SpokaneStBridge,10/04/2015 10:00:00 PM,48,-122,1,3,4
15407,SpokaneStBridge,10/04/2015 11:00:00 PM,48,-122,1,2,3
15408,SpokaneStBridge,10/05/2015 12:00:00 AM,48,-122,1,1,2
15409,SpokaneStBridge,10/05/2015 01:00:00 AM,48,-122,1,1,2
15410,SpokaneStBridge,10/05/2015 02:00:00 AM,48,-122,1,0,1
15411,SpokaneStBridge,10/05/2015 03:00:00 AM,48,-122,0,1,1
15412,SpokaneStBridge,10/05/2015 04:00:00 AM,48,-122,8,2,10
15413,SpokaneStBridge,10/05/2015 05:00:00 AM,48,-122,26,2,28
15414,SpokaneStBridge,10/05/2015 06:00:00 AM,48,-122,64,11,75
15415,SpokaneStBridge,10/05/2015 07:00:00 AM,48,-122,143,19,162
15416,SpokaneStBridge,10/05/2015 08:00:00 AM,48,-122,157,14,171
15417,SpokaneStBridge,10/05/2015 09:00:00 AM,48,-122,54,7,61
15418,SpokaneStBridge,10/05/2015 10:00:00 AM,48,-122,18,2,20
15419,SpokaneStBridge,10/05/2015 11:00:00 AM,48,-122,17,7,24
15420,SpokaneStBridge,10/05/2015 12:00:00 PM,48,-122,11,9,20
15421,SpokaneStBridge,10/05/2015 01:00:00 PM,48,-122,14,14,28
15422,SpokaneStBridge,10/05/2015 02:00:00 PM,48,-122,16,20,36
15423,SpokaneStBridge,10/05/2015 03:00:00 PM,48,-122,18,44,62
15424,SpokaneStBridge,10/05/2015 04:00:00 PM,48,-122,30,127,157
15425,SpokaneStBridge,10/05/2015 05:00:00 PM,48,-122,19,164,183
15426,SpokaneStBridge,10/05/2015 06:00:00 PM,48,-122,13,89,102
15427,SpokaneStBridge,10/05/2015 07:00:00 PM,48,-122,7,23,30
15428,SpokaneStBridge,10/05/2015 08:00:00 PM,48,-122,5,16,21
15429,SpokaneStBridge,10/05/2015 09:00:00 PM,48,-122,1,14,15
15430,SpokaneStBridge,10/05/2015 10:00:00 PM,48,-122,2,5,7
15431,SpokaneStBridge,10/05/2015 11:00:00 PM,48,-122,1,2,3
15432,SpokaneStBridge,10/06/2015 12:00:00 AM,48,-122,0,1,1
15433,SpokaneStBridge,10/06/2015 01:00:00 AM,48,-122,0,2,2
15434,SpokaneStBridge,10/06/2015 02:00:00 AM,48,-122,1,1,2
15435,SpokaneStBridge,10/06/2015 03:00:00 AM,48,-122,1,1,2
15436,SpokaneStBridge,10/06/2015 04:00:00 AM,48,-122,3,2,5
15437,SpokaneStBridge,10/06/2015 05:00:00 AM,48,-122,30,4,34
15438,SpokaneStBridge,10/06/2015 06:00:00 AM,48,-122,63,19,82
15439,SpokaneStBridge,10/06/2015 07:00:00 AM,48,-122,138,13,151
15440,SpokaneStBridge,10/06/2015 08:00:00 AM,48,-122,159,11,170
15441,SpokaneStBridge,10/06/2015 09:00:00 AM,48,-122,44,11,55
15442,SpokaneStBridge,10/06/2015 10:00:00 AM,48,-122,14,6,20
15443,SpokaneStBridge,10/06/2015 11:00:00 AM,48,-122,11,2,13
15444,SpokaneStBridge,10/06/2015 12:00:00 PM,48,-122,4,11,15
15445,SpokaneStBridge,10/06/2015 01:00:00 PM,48,-122,12,13,25
15446,SpokaneStBridge,10/06/2015 02:00:00 PM,48,-122,14,18,32
15447,SpokaneStBridge,10/06/2015 03:00:00 PM,48,-122,10,25,35
15448,SpokaneStBridge,10/06/2015 04:00:00 PM,48,-122,20,84,104
15449,SpokaneStBridge,10/06/2015 05:00:00 PM,48,-122,29,158,187
15450,SpokaneStBridge,10/06/2015 06:00:00 PM,48,-122,15,117,132
15451,SpokaneStBridge,10/06/2015 07:00:00 PM,48,-122,3,41,44
15452,SpokaneStBridge,10/06/2015 08:00:00 PM,48,-122,6,14,20
15453,SpokaneStBridge,10/06/2015 09:00:00 PM,48,-122,0,10,10
15454,SpokaneStBridge,10/06/2015 10:00:00 PM,48,-122,2,5,7
15455,SpokaneStBridge,10/06/2015 11:00:00 PM,48,-122,0,1,1
15456,SpokaneStBridge,10/07/2015 12:00:00 AM,48,-122,1,1,2
15457,SpokaneStBridge,10/07/2015 01:00:00 AM,48,-122,0,1,1
15458,SpokaneStBridge,10/07/2015 02:00:00 AM,48,-122,1,1,2
15459,SpokaneStBridge,10/07/2015 03:00:00 AM,48,-122,0,1,1
15460,SpokaneStBridge,10/07/2015 04:00:00 AM,48,-122,2,0,2
15461,SpokaneStBridge,10/07/2015 05:00:00 AM,48,-122,17,4,21
15462,SpokaneStBridge,10/07/2015 06:00:00 AM,48,-122,41,6,47
15463,SpokaneStBridge,10/07/2015 07:00:00 AM,48,-122,80,14,94
15464,SpokaneStBridge,10/07/2015 08:00:00 AM,48,-122,96,3,99
15465,SpokaneStBridge,10/07/2015 09:00:00 AM,48,-122,22,2,24
15466,SpokaneStBridge,10/07/2015 10:00:00 AM,48,-122,8,2,10
15467,SpokaneStBridge,10/07/2015 11:00:00 AM,48,-122,12,2,14
15468,SpokaneStBridge,10/07/2015 12:00:00 PM,48,-122,2,4,6
15469,SpokaneStBridge,10/07/2015 01:00:00 PM,48,-122,3,5,8
15470,SpokaneStBridge,10/07/2015 02:00:00 PM,48,-122,4,8,12
15471,SpokaneStBridge,10/07/2015 03:00:00 PM,48,-122,6,19,25
15472,SpokaneStBridge,10/07/2015 04:00:00 PM,48,-122,19,50,69
15473,SpokaneStBridge,10/07/2015 05:00:00 PM,48,-122,12,93,105
15474,SpokaneStBridge,10/07/2015 06:00:00 PM,48,-122,4,67,71
15475,SpokaneStBridge,10/07/2015 07:00:00 PM,48,-122,0,30,30
15476,SpokaneStBridge,10/07/2015 08:00:00 PM,48,-122,4,8,12
15477,SpokaneStBridge,10/07/2015 09:00:00 PM,48,-122,4,8,12
15478,SpokaneStBridge,10/07/2015 10:00:00 PM,48,-122,1,4,5
15479,SpokaneStBridge,10/07/2015 11:00:00 PM,48,-122,0,1,1
15480,SpokaneStBridge,10/08/2015 12:00:00 AM,48,-122,1,0,1
15481,SpokaneStBridge,10/08/2015 01:00:00 AM,48,-122,1,1,2
15482,SpokaneStBridge,10/08/2015 02:00:00 AM,48,-122,0,1,1
15483,SpokaneStBridge,10/08/2015 03:00:00 AM,48,-122,0,0,0
15484,SpokaneStBridge,10/08/2015 04:00:00 AM,48,-122,6,0,6
15485,SpokaneStBridge,10/08/2015 05:00:00 AM,48,-122,25,8,33
15486,SpokaneStBridge,10/08/2015 06:00:00 AM,48,-122,64,16,80
15487,SpokaneStBridge,10/08/2015 07:00:00 AM,48,-122,103,24,127
15488,SpokaneStBridge,10/08/2015 08:00:00 AM,48,-122,117,22,139
15489,SpokaneStBridge,10/08/2015 09:00:00 AM,48,-122,48,11,59
15490,SpokaneStBridge,10/08/2015 10:00:00 AM,48,-122,16,14,30
15491,SpokaneStBridge,10/08/2015 11:00:00 AM,48,-122,9,6,15
15492,SpokaneStBridge,10/08/2015 12:00:00 PM,48,-122,16,14,30
15493,SpokaneStBridge,10/08/2015 01:00:00 PM,48,-122,16,6,22
15494,SpokaneStBridge,10/08/2015 02:00:00 PM,48,-122,15,12,27
15495,SpokaneStBridge,10/08/2015 03:00:00 PM,48,-122,11,33,44
15496,SpokaneStBridge,10/08/2015 04:00:00 PM,48,-122,14,89,103
15497,SpokaneStBridge,10/08/2015 05:00:00 PM,48,-122,26,136,162
15498,SpokaneStBridge,10/08/2015 06:00:00 PM,48,-122,8,74,82
15499,SpokaneStBridge,10/08/2015 07:00:00 PM,48,-122,4,34,38
15500,SpokaneStBridge,10/08/2015 08:00:00 PM,48,-122,4,64,68
15501,SpokaneStBridge,10/08/2015 09:00:00 PM,48,-122,5,4,9
15502,SpokaneStBridge,10/08/2015 10:00:00 PM,48,-122,2,11,13
15503,SpokaneStBridge,10/08/2015 11:00:00 PM,48,-122,5,2,7
15504,SpokaneStBridge,10/09/2015 12:00:00 AM,48,-122,2,0,2
15505,SpokaneStBridge,10/09/2015 01:00:00 AM,48,-122,0,1,1
15506,SpokaneStBridge,10/09/2015 02:00:00 AM,48,-122,1,1,2
15507,SpokaneStBridge,10/09/2015 03:00:00 AM,48,-122,3,2,5
15508,SpokaneStBridge,10/09/2015 04:00:00 AM,48,-122,4,0,4
15509,SpokaneStBridge,10/09/2015 05:00:00 AM,48,-122,20,3,23
15510,SpokaneStBridge,10/09/2015 06:00:00 AM,48,-122,35,10,45
15511,SpokaneStBridge,10/09/2015 07:00:00 AM,48,-122,98,15,113
15512,SpokaneStBridge,10/09/2015 08:00:00 AM,48,-122,94,6,100
15513,SpokaneStBridge,10/09/2015 09:00:00 AM,48,-122,33,7,40
15514,SpokaneStBridge,10/09/2015 10:00:00 AM,48,-122,15,9,24
15515,SpokaneStBridge,10/09/2015 11:00:00 AM,48,-122,5,8,13
15516,SpokaneStBridge,10/09/2015 12:00:00 PM,48,-122,7,3,10
15517,SpokaneStBridge,10/09/2015 01:00:00 PM,48,-122,8,9,17
15518,SpokaneStBridge,10/09/2015 02:00:00 PM,48,-122,13,15,28
15519,SpokaneStBridge,10/09/2015 03:00:00 PM,48,-122,19,31,50
15520,SpokaneStBridge,10/09/2015 04:00:00 PM,48,-122,10,73,83
15521,SpokaneStBridge,10/09/2015 05:00:00 PM,48,-122,15,91,106
15522,SpokaneStBridge,10/09/2015 06:00:00 PM,48,-122,6,59,65
15523,SpokaneStBridge,10/09/2015 07:00:00 PM,48,-122,4,27,31
15524,SpokaneStBridge,10/09/2015 08:00:00 PM,48,-122,2,5,7
15525,SpokaneStBridge,10/09/2015 09:00:00 PM,48,-122,5,11,16
15526,SpokaneStBridge,10/09/2015 10:00:00 PM,48,-122,2,2,4
15527,SpokaneStBridge,10/09/2015 11:00:00 PM,48,-122,1,2,3
15528,SpokaneStBridge,10/10/2015 12:00:00 AM,48,-122,1,1,2
15529,SpokaneStBridge,10/10/2015 01:00:00 AM,48,-122,1,2,3
15530,SpokaneStBridge,10/10/2015 02:00:00 AM,48,-122,0,1,1
15531,SpokaneStBridge,10/10/2015 03:00:00 AM,48,-122,1,1,2
15532,SpokaneStBridge,10/10/2015 04:00:00 AM,48,-122,0,0,0
15533,SpokaneStBridge,10/10/2015 05:00:00 AM,48,-122,2,1,3
15534,SpokaneStBridge,10/10/2015 06:00:00 AM,48,-122,4,0,4
15535,SpokaneStBridge,10/10/2015 07:00:00 AM,48,-122,2,1,3
15536,SpokaneStBridge,10/10/2015 08:00:00 AM,48,-122,7,6,13
15537,SpokaneStBridge,10/10/2015 09:00:00 AM,48,-122,9,4,13
15538,SpokaneStBridge,10/10/2015 10:00:00 AM,48,-122,1,3,4
15539,SpokaneStBridge,10/10/2015 11:00:00 AM,48,-122,0,3,3
15540,SpokaneStBridge,10/10/2015 12:00:00 PM,48,-122,4,9,13
15541,SpokaneStBridge,10/10/2015 01:00:00 PM,48,-122,6,1,7
15542,SpokaneStBridge,10/10/2015 02:00:00 PM,48,-122,1,3,4
15543,SpokaneStBridge,10/10/2015 03:00:00 PM,48,-122,1,1,2
15544,SpokaneStBridge,10/10/2015 04:00:00 PM,48,-122,0,5,5
15545,SpokaneStBridge,10/10/2015 05:00:00 PM,48,-122,2,5,7
15546,SpokaneStBridge,10/10/2015 06:00:00 PM,48,-122,4,6,10
15547,SpokaneStBridge,10/10/2015 07:00:00 PM,48,-122,2,2,4
15548,SpokaneStBridge,10/10/2015 08:00:00 PM,48,-122,0,0,0
15549,SpokaneStBridge,10/10/2015 09:00:00 PM,48,-122,2,1,3
15550,SpokaneStBridge,10/10/2015 10:00:00 PM,48,-122,2,2,4
15551,SpokaneStBridge,10/10/2015 11:00:00 PM,48,-122,3,1,4
15552,SpokaneStBridge,10/11/2015 12:00:00 AM,48,-122,1,2,3
15553,SpokaneStBridge,10/11/2015 01:00:00 AM,48,-122,0,0,0
15554,SpokaneStBridge,10/11/2015 02:00:00 AM,48,-122,2,0,2
15555,SpokaneStBridge,10/11/2015 03:00:00 AM,48,-122,1,1,2
15556,SpokaneStBridge,10/11/2015 04:00:00 AM,48,-122,0,1,1
15557,SpokaneStBridge,10/11/2015 05:00:00 AM,48,-122,3,0,3
15558,SpokaneStBridge,10/11/2015 06:00:00 AM,48,-122,3,2,5
15559,SpokaneStBridge,10/11/2015 07:00:00 AM,48,-122,2,4,6
15560,SpokaneStBridge,10/11/2015 08:00:00 AM,48,-122,15,3,18
15561,SpokaneStBridge,10/11/2015 09:00:00 AM,48,-122,18,11,29
15562,SpokaneStBridge,10/11/2015 10:00:00 AM,48,-122,10,20,30
15563,SpokaneStBridge,10/11/2015 11:00:00 AM,48,-122,28,16,44
15564,SpokaneStBridge,10/11/2015 12:00:00 PM,48,-122,32,21,53
15565,SpokaneStBridge,10/11/2015 01:00:00 PM,48,-122,23,24,47
15566,SpokaneStBridge,10/11/2015 02:00:00 PM,48,-122,32,28,60
15567,SpokaneStBridge,10/11/2015 03:00:00 PM,48,-122,24,34,58
15568,SpokaneStBridge,10/11/2015 04:00:00 PM,48,-122,18,21,39
15569,SpokaneStBridge,10/11/2015 05:00:00 PM,48,-122,16,15,31
15570,SpokaneStBridge,10/11/2015 06:00:00 PM,48,-122,7,17,24
15571,SpokaneStBridge,10/11/2015 07:00:00 PM,48,-122,3,7,10
15572,SpokaneStBridge,10/11/2015 08:00:00 PM,48,-122,7,4,11
15573,SpokaneStBridge,10/11/2015 09:00:00 PM,48,-122,1,1,2
15574,SpokaneStBridge,10/11/2015 10:00:00 PM,48,-122,1,3,4
15575,SpokaneStBridge,10/11/2015 11:00:00 PM,48,-122,3,0,3
15576,SpokaneStBridge,10/12/2015 12:00:00 AM,48,-122,0,0,0
15577,SpokaneStBridge,10/12/2015 01:00:00 AM,48,-122,0,0,0
15578,SpokaneStBridge,10/12/2015 02:00:00 AM,48,-122,1,1,2
15579,SpokaneStBridge,10/12/2015 03:00:00 AM,48,-122,1,1,2
15580,SpokaneStBridge,10/12/2015 04:00:00 AM,48,-122,6,0,6
15581,SpokaneStBridge,10/12/2015 05:00:00 AM,48,-122,14,3,17
15582,SpokaneStBridge,10/12/2015 06:00:00 AM,48,-122,50,9,59
15583,SpokaneStBridge,10/12/2015 07:00:00 AM,48,-122,116,10,126
15584,SpokaneStBridge,10/12/2015 08:00:00 AM,48,-122,145,13,158
15585,SpokaneStBridge,10/12/2015 09:00:00 AM,48,-122,47,8,55
15586,SpokaneStBridge,10/12/2015 10:00:00 AM,48,-122,21,6,27
15587,SpokaneStBridge,10/12/2015 11:00:00 AM,48,-122,8,3,11
15588,SpokaneStBridge,10/12/2015 12:00:00 PM,48,-122,5,9,14
15589,SpokaneStBridge,10/12/2015 01:00:00 PM,48,-122,13,11,24
15590,SpokaneStBridge,10/12/2015 02:00:00 PM,48,-122,10,13,23
15591,SpokaneStBridge,10/12/2015 03:00:00 PM,48,-122,11,31,42
15592,SpokaneStBridge,10/12/2015 04:00:00 PM,48,-122,20,73,93
15593,SpokaneStBridge,10/12/2015 05:00:00 PM,48,-122,17,132,149
15594,SpokaneStBridge,10/12/2015 06:00:00 PM,48,-122,11,79,90
15595,SpokaneStBridge,10/12/2015 07:00:00 PM,48,-122,3,28,31
15596,SpokaneStBridge,10/12/2015 08:00:00 PM,48,-122,5,13,18
15597,SpokaneStBridge,10/12/2015 09:00:00 PM,48,-122,0,6,6
15598,SpokaneStBridge,10/12/2015 10:00:00 PM,48,-122,0,1,1
15599,SpokaneStBridge,10/12/2015 11:00:00 PM,48,-122,0,1,1
15600,SpokaneStBridge,10/13/2015 12:00:00 AM,48,-122,0,0,0
15601,SpokaneStBridge,10/13/2015 01:00:00 AM,48,-122,0,0,0
15602,SpokaneStBridge,10/13/2015 02:00:00 AM,48,-122,1,0,1
15603,SpokaneStBridge,10/13/2015 03:00:00 AM,48,-122,3,2,5
15604,SpokaneStBridge,10/13/2015 04:00:00 AM,48,-122,1,3,4
15605,SpokaneStBridge,10/13/2015 05:00:00 AM,48,-122,24,2,26
15606,SpokaneStBridge,10/13/2015 06:00:00 AM,48,-122,51,10,61
15607,SpokaneStBridge,10/13/2015 07:00:00 AM,48,-122,100,15,115
15608,SpokaneStBridge,10/13/2015 08:00:00 AM,48,-122,117,14,131
15609,SpokaneStBridge,10/13/2015 09:00:00 AM,48,-122,46,8,54
15610,SpokaneStBridge,10/13/2015 10:00:00 AM,48,-122,12,3,15
15611,SpokaneStBridge,10/13/2015 11:00:00 AM,48,-122,10,2,12
15612,SpokaneStBridge,10/13/2015 12:00:00 PM,48,-122,10,11,21
15613,SpokaneStBridge,10/13/2015 01:00:00 PM,48,-122,14,9,23
15614,SpokaneStBridge,10/13/2015 02:00:00 PM,48,-122,8,16,24
15615,SpokaneStBridge,10/13/2015 03:00:00 PM,48,-122,14,29,43
15616,SpokaneStBridge,10/13/2015 04:00:00 PM,48,-122,13,60,73
15617,SpokaneStBridge,10/13/2015 05:00:00 PM,48,-122,31,141,172
15618,SpokaneStBridge,10/13/2015 06:00:00 PM,48,-122,12,95,107
15619,SpokaneStBridge,10/13/2015 07:00:00 PM,48,-122,3,32,35
15620,SpokaneStBridge,10/13/2015 08:00:00 PM,48,-122,4,10,14
15621,SpokaneStBridge,10/13/2015 09:00:00 PM,48,-122,2,9,11
15622,SpokaneStBridge,10/13/2015 10:00:00 PM,48,-122,2,4,6
15623,SpokaneStBridge,10/13/2015 11:00:00 PM,48,-122,1,2,3
15624,SpokaneStBridge,10/14/2015 12:00:00 AM,48,-122,1,0,1
15625,SpokaneStBridge,10/14/2015 01:00:00 AM,48,-122,0,0,0
15626,SpokaneStBridge,10/14/2015 02:00:00 AM,48,-122,1,0,1
15627,SpokaneStBridge,10/14/2015 03:00:00 AM,48,-122,0,1,1
15628,SpokaneStBridge,10/14/2015 04:00:00 AM,48,-122,4,1,5
15629,SpokaneStBridge,10/14/2015 05:00:00 AM,48,-122,31,3,34
15630,SpokaneStBridge,10/14/2015 06:00:00 AM,48,-122,68,11,79
15631,SpokaneStBridge,10/14/2015 07:00:00 AM,48,-122,130,10,140
15632,SpokaneStBridge,10/14/2015 08:00:00 AM,48,-122,128,10,138
15633,SpokaneStBridge,10/14/2015 09:00:00 AM,48,-122,50,4,54
15634,SpokaneStBridge,10/14/2015 10:00:00 AM,48,-122,35,6,41
15635,SpokaneStBridge,10/14/2015 11:00:00 AM,48,-122,6,6,12
15636,SpokaneStBridge,10/14/2015 12:00:00 PM,48,-122,9,7,16
15637,SpokaneStBridge,10/14/2015 01:00:00 PM,48,-122,11,10,21
15638,SpokaneStBridge,10/14/2015 02:00:00 PM,48,-122,10,18,28
15639,SpokaneStBridge,10/14/2015 03:00:00 PM,48,-122,12,25,37
15640,SpokaneStBridge,10/14/2015 04:00:00 PM,48,-122,29,101,130
15641,SpokaneStBridge,10/14/2015 05:00:00 PM,48,-122,19,146,165
15642,SpokaneStBridge,10/14/2015 06:00:00 PM,48,-122,18,101,119
15643,SpokaneStBridge,10/14/2015 07:00:00 PM,48,-122,14,39,53
15644,SpokaneStBridge,10/14/2015 08:00:00 PM,48,-122,10,21,31
15645,SpokaneStBridge,10/14/2015 09:00:00 PM,48,-122,3,7,10
15646,SpokaneStBridge,10/14/2015 10:00:00 PM,48,-122,3,4,7
15647,SpokaneStBridge,10/14/2015 11:00:00 PM,48,-122,1,1,2
15648,SpokaneStBridge,10/15/2015 12:00:00 AM,48,-122,1,1,2
15649,SpokaneStBridge,10/15/2015 01:00:00 AM,48,-122,0,0,0
15650,SpokaneStBridge,10/15/2015 02:00:00 AM,48,-122,0,0,0
15651,SpokaneStBridge,10/15/2015 03:00:00 AM,48,-122,0,0,0
15652,SpokaneStBridge,10/15/2015 04:00:00 AM,48,-122,5,1,6
15653,SpokaneStBridge,10/15/2015 05:00:00 AM,48,-122,23,3,26
15654,SpokaneStBridge,10/15/2015 06:00:00 AM,48,-122,55,9,64
15655,SpokaneStBridge,10/15/2015 07:00:00 AM,48,-122,121,10,131
15656,SpokaneStBridge,10/15/2015 08:00:00 AM,48,-122,118,4,122
15657,SpokaneStBridge,10/15/2015 09:00:00 AM,48,-122,42,3,45
15658,SpokaneStBridge,10/15/2015 10:00:00 AM,48,-122,19,5,24
15659,SpokaneStBridge,10/15/2015 11:00:00 AM,48,-122,15,10,25
15660,SpokaneStBridge,10/15/2015 12:00:00 PM,48,-122,7,14,21
15661,SpokaneStBridge,10/15/2015 01:00:00 PM,48,-122,21,15,36
15662,SpokaneStBridge,10/15/2015 02:00:00 PM,48,-122,10,22,32
15663,SpokaneStBridge,10/15/2015 03:00:00 PM,48,-122,12,31,43
15664,SpokaneStBridge,10/15/2015 04:00:00 PM,48,-122,15,73,88
15665,SpokaneStBridge,10/15/2015 05:00:00 PM,48,-122,12,133,145
15666,SpokaneStBridge,10/15/2015 06:00:00 PM,48,-122,14,78,92
15667,SpokaneStBridge,10/15/2015 07:00:00 PM,48,-122,10,23,33
15668,SpokaneStBridge,10/15/2015 08:00:00 PM,48,-122,2,20,22
15669,SpokaneStBridge,10/15/2015 09:00:00 PM,48,-122,5,8,13
15670,SpokaneStBridge,10/15/2015 10:00:00 PM,48,-122,1,5,6
15671,SpokaneStBridge,10/15/2015 11:00:00 PM,48,-122,1,2,3
15672,SpokaneStBridge,10/16/2015 12:00:00 AM,48,-122,1,3,4
15673,SpokaneStBridge,10/16/2015 01:00:00 AM,48,-122,2,1,3
15674,SpokaneStBridge,10/16/2015 02:00:00 AM,48,-122,1,5,6
15675,SpokaneStBridge,10/16/2015 03:00:00 AM,48,-122,0,0,0
15676,SpokaneStBridge,10/16/2015 04:00:00 AM,48,-122,10,1,11
15677,SpokaneStBridge,10/16/2015 05:00:00 AM,48,-122,16,7,23
15678,SpokaneStBridge,10/16/2015 06:00:00 AM,48,-122,52,7,59
15679,SpokaneStBridge,10/16/2015 07:00:00 AM,48,-122,90,10,100
15680,SpokaneStBridge,10/16/2015 08:00:00 AM,48,-122,130,9,139
15681,SpokaneStBridge,10/16/2015 09:00:00 AM,48,-122,43,11,54
15682,SpokaneStBridge,10/16/2015 10:00:00 AM,48,-122,15,7,22
15683,SpokaneStBridge,10/16/2015 11:00:00 AM,48,-122,9,14,23
15684,SpokaneStBridge,10/16/2015 12:00:00 PM,48,-122,8,11,19
15685,SpokaneStBridge,10/16/2015 01:00:00 PM,48,-122,23,16,39
15686,SpokaneStBridge,10/16/2015 02:00:00 PM,48,-122,15,17,32
15687,SpokaneStBridge,10/16/2015 03:00:00 PM,48,-122,18,36,54
15688,SpokaneStBridge,10/16/2015 04:00:00 PM,48,-122,16,82,98
15689,SpokaneStBridge,10/16/2015 05:00:00 PM,48,-122,33,125,158
15690,SpokaneStBridge,10/16/2015 06:00:00 PM,48,-122,16,75,91
15691,SpokaneStBridge,10/16/2015 07:00:00 PM,48,-122,7,14,21
15692,SpokaneStBridge,10/16/2015 08:00:00 PM,48,-122,5,10,15
15693,SpokaneStBridge,10/16/2015 09:00:00 PM,48,-122,2,2,4
15694,SpokaneStBridge,10/16/2015 10:00:00 PM,48,-122,1,2,3
15695,SpokaneStBridge,10/16/2015 11:00:00 PM,48,-122,0,4,4
15696,SpokaneStBridge,10/17/2015 12:00:00 AM,48,-122,1,1,2
15697,SpokaneStBridge,10/17/2015 01:00:00 AM,48,-122,0,0,0
15698,SpokaneStBridge,10/17/2015 02:00:00 AM,48,-122,1,1,2
15699,SpokaneStBridge,10/17/2015 03:00:00 AM,48,-122,1,1,2
15700,SpokaneStBridge,10/17/2015 04:00:00 AM,48,-122,3,1,4
15701,SpokaneStBridge,10/17/2015 05:00:00 AM,48,-122,4,4,8
15702,SpokaneStBridge,10/17/2015 06:00:00 AM,48,-122,4,1,5
15703,SpokaneStBridge,10/17/2015 07:00:00 AM,48,-122,7,1,8
15704,SpokaneStBridge,10/17/2015 08:00:00 AM,48,-122,14,7,21
15705,SpokaneStBridge,10/17/2015 09:00:00 AM,48,-122,15,20,35
15706,SpokaneStBridge,10/17/2015 10:00:00 AM,48,-122,11,26,37
15707,SpokaneStBridge,10/17/2015 11:00:00 AM,48,-122,21,14,35
15708,SpokaneStBridge,10/17/2015 12:00:00 PM,48,-122,15,17,32
15709,SpokaneStBridge,10/17/2015 01:00:00 PM,48,-122,17,13,30
15710,SpokaneStBridge,10/17/2015 02:00:00 PM,48,-122,22,18,40
15711,SpokaneStBridge,10/17/2015 03:00:00 PM,48,-122,13,29,42
15712,SpokaneStBridge,10/17/2015 04:00:00 PM,48,-122,16,17,33
15713,SpokaneStBridge,10/17/2015 05:00:00 PM,48,-122,9,13,22
15714,SpokaneStBridge,10/17/2015 06:00:00 PM,48,-122,4,7,11
15715,SpokaneStBridge,10/17/2015 07:00:00 PM,48,-122,0,2,2
15716,SpokaneStBridge,10/17/2015 08:00:00 PM,48,-122,4,2,6
15717,SpokaneStBridge,10/17/2015 09:00:00 PM,48,-122,2,0,2
15718,SpokaneStBridge,10/17/2015 10:00:00 PM,48,-122,0,2,2
15719,SpokaneStBridge,10/17/2015 11:00:00 PM,48,-122,0,6,6
15720,SpokaneStBridge,10/18/2015 12:00:00 AM,48,-122,1,2,3
15721,SpokaneStBridge,10/18/2015 01:00:00 AM,48,-122,0,0,0
15722,SpokaneStBridge,10/18/2015 02:00:00 AM,48,-122,1,2,3
15723,SpokaneStBridge,10/18/2015 03:00:00 AM,48,-122,1,2,3
15724,SpokaneStBridge,10/18/2015 04:00:00 AM,48,-122,2,1,3
15725,SpokaneStBridge,10/18/2015 05:00:00 AM,48,-122,7,0,7
15726,SpokaneStBridge,10/18/2015 06:00:00 AM,48,-122,1,0,1
15727,SpokaneStBridge,10/18/2015 07:00:00 AM,48,-122,3,1,4
15728,SpokaneStBridge,10/18/2015 08:00:00 AM,48,-122,4,4,8
15729,SpokaneStBridge,10/18/2015 09:00:00 AM,48,-122,16,3,19
15730,SpokaneStBridge,10/18/2015 10:00:00 AM,48,-122,6,14,20
15731,SpokaneStBridge,10/18/2015 11:00:00 AM,48,-122,8,5,13
15732,SpokaneStBridge,10/18/2015 12:00:00 PM,48,-122,7,7,14
15733,SpokaneStBridge,10/18/2015 01:00:00 PM,48,-122,11,9,20
15734,SpokaneStBridge,10/18/2015 02:00:00 PM,48,-122,11,6,17
15735,SpokaneStBridge,10/18/2015 03:00:00 PM,48,-122,3,6,9
15736,SpokaneStBridge,10/18/2015 04:00:00 PM,48,-122,2,9,11
15737,SpokaneStBridge,10/18/2015 05:00:00 PM,48,-122,3,6,9
15738,SpokaneStBridge,10/18/2015 06:00:00 PM,48,-122,2,4,6
15739,SpokaneStBridge,10/18/2015 07:00:00 PM,48,-122,0,6,6
15740,SpokaneStBridge,10/18/2015 08:00:00 PM,48,-122,0,3,3
15741,SpokaneStBridge,10/18/2015 09:00:00 PM,48,-122,0,1,1
15742,SpokaneStBridge,10/18/2015 10:00:00 PM,48,-122,2,0,2
15743,SpokaneStBridge,10/18/2015 11:00:00 PM,48,-122,1,1,2
15744,SpokaneStBridge,10/19/2015 12:00:00 AM,48,-122,1,0,1
15745,SpokaneStBridge,10/19/2015 01:00:00 AM,48,-122,0,1,1
15746,SpokaneStBridge,10/19/2015 02:00:00 AM,48,-122,0,0,0
15747,SpokaneStBridge,10/19/2015 03:00:00 AM,48,-122,1,2,3
15748,SpokaneStBridge,10/19/2015 04:00:00 AM,48,-122,6,0,6
15749,SpokaneStBridge,10/19/2015 05:00:00 AM,48,-122,18,1,19
15750,SpokaneStBridge,10/19/2015 06:00:00 AM,48,-122,50,14,64
15751,SpokaneStBridge,10/19/2015 07:00:00 AM,48,-122,99,17,116
15752,SpokaneStBridge,10/19/2015 08:00:00 AM,48,-122,102,14,116
15753,SpokaneStBridge,10/19/2015 09:00:00 AM,48,-122,23,8,31
15754,SpokaneStBridge,10/19/2015 10:00:00 AM,48,-122,12,8,20
15755,SpokaneStBridge,10/19/2015 11:00:00 AM,48,-122,7,4,11
15756,SpokaneStBridge,10/19/2015 12:00:00 PM,48,-122,5,11,16
15757,SpokaneStBridge,10/19/2015 01:00:00 PM,48,-122,7,6,13
15758,SpokaneStBridge,10/19/2015 02:00:00 PM,48,-122,7,13,20
15759,SpokaneStBridge,10/19/2015 03:00:00 PM,48,-122,8,25,33
15760,SpokaneStBridge,10/19/2015 04:00:00 PM,48,-122,13,75,88
15761,SpokaneStBridge,10/19/2015 05:00:00 PM,48,-122,21,126,147
15762,SpokaneStBridge,10/19/2015 06:00:00 PM,48,-122,9,66,75
15763,SpokaneStBridge,10/19/2015 07:00:00 PM,48,-122,1,24,25
15764,SpokaneStBridge,10/19/2015 08:00:00 PM,48,-122,1,9,10
15765,SpokaneStBridge,10/19/2015 09:00:00 PM,48,-122,2,7,9
15766,SpokaneStBridge,10/19/2015 10:00:00 PM,48,-122,5,3,8
15767,SpokaneStBridge,10/19/2015 11:00:00 PM,48,-122,0,3,3
15768,SpokaneStBridge,10/20/2015 12:00:00 AM,48,-122,1,2,3
15769,SpokaneStBridge,10/20/2015 01:00:00 AM,48,-122,2,1,3
15770,SpokaneStBridge,10/20/2015 02:00:00 AM,48,-122,1,0,1
15771,SpokaneStBridge,10/20/2015 03:00:00 AM,48,-122,1,1,2
15772,SpokaneStBridge,10/20/2015 04:00:00 AM,48,-122,2,2,4
15773,SpokaneStBridge,10/20/2015 05:00:00 AM,48,-122,24,7,31
15774,SpokaneStBridge,10/20/2015 06:00:00 AM,48,-122,55,15,70
15775,SpokaneStBridge,10/20/2015 07:00:00 AM,48,-122,115,24,139
15776,SpokaneStBridge,10/20/2015 08:00:00 AM,48,-122,135,7,142
15777,SpokaneStBridge,10/20/2015 09:00:00 AM,48,-122,44,10,54
15778,SpokaneStBridge,10/20/2015 10:00:00 AM,48,-122,13,6,19
15779,SpokaneStBridge,10/20/2015 11:00:00 AM,48,-122,12,5,17
15780,SpokaneStBridge,10/20/2015 12:00:00 PM,48,-122,15,13,28
15781,SpokaneStBridge,10/20/2015 01:00:00 PM,48,-122,11,13,24
15782,SpokaneStBridge,10/20/2015 02:00:00 PM,48,-122,20,15,35
15783,SpokaneStBridge,10/20/2015 03:00:00 PM,48,-122,9,25,34
15784,SpokaneStBridge,10/20/2015 04:00:00 PM,48,-122,22,94,116
15785,SpokaneStBridge,10/20/2015 05:00:00 PM,48,-122,20,165,185
15786,SpokaneStBridge,10/20/2015 06:00:00 PM,48,-122,9,84,93
15787,SpokaneStBridge,10/20/2015 07:00:00 PM,48,-122,10,29,39
15788,SpokaneStBridge,10/20/2015 08:00:00 PM,48,-122,6,10,16
15789,SpokaneStBridge,10/20/2015 09:00:00 PM,48,-122,1,11,12
15790,SpokaneStBridge,10/20/2015 10:00:00 PM,48,-122,0,4,4
15791,SpokaneStBridge,10/20/2015 11:00:00 PM,48,-122,1,2,3
15792,SpokaneStBridge,10/21/2015 12:00:00 AM,48,-122,3,3,6
15793,SpokaneStBridge,10/21/2015 01:00:00 AM,48,-122,1,2,3
15794,SpokaneStBridge,10/21/2015 02:00:00 AM,48,-122,0,1,1
15795,SpokaneStBridge,10/21/2015 03:00:00 AM,48,-122,1,1,2
15796,SpokaneStBridge,10/21/2015 04:00:00 AM,48,-122,4,1,5
15797,SpokaneStBridge,10/21/2015 05:00:00 AM,48,-122,25,3,28
15798,SpokaneStBridge,10/21/2015 06:00:00 AM,48,-122,59,10,69
15799,SpokaneStBridge,10/21/2015 07:00:00 AM,48,-122,125,16,141
15800,SpokaneStBridge,10/21/2015 08:00:00 AM,48,-122,118,6,124
15801,SpokaneStBridge,10/21/2015 09:00:00 AM,48,-122,43,5,48
15802,SpokaneStBridge,10/21/2015 10:00:00 AM,48,-122,18,4,22
15803,SpokaneStBridge,10/21/2015 11:00:00 AM,48,-122,5,7,12
15804,SpokaneStBridge,10/21/2015 12:00:00 PM,48,-122,12,10,22
15805,SpokaneStBridge,10/21/2015 01:00:00 PM,48,-122,12,8,20
15806,SpokaneStBridge,10/21/2015 02:00:00 PM,48,-122,21,18,39
15807,SpokaneStBridge,10/21/2015 03:00:00 PM,48,-122,4,27,31
15808,SpokaneStBridge,10/21/2015 04:00:00 PM,48,-122,20,74,94
15809,SpokaneStBridge,10/21/2015 05:00:00 PM,48,-122,21,149,170
15810,SpokaneStBridge,10/21/2015 06:00:00 PM,48,-122,19,83,102
15811,SpokaneStBridge,10/21/2015 07:00:00 PM,48,-122,7,25,32
15812,SpokaneStBridge,10/21/2015 08:00:00 PM,48,-122,2,13,15
15813,SpokaneStBridge,10/21/2015 09:00:00 PM,48,-122,4,13,17
15814,SpokaneStBridge,10/21/2015 10:00:00 PM,48,-122,1,6,7
15815,SpokaneStBridge,10/21/2015 11:00:00 PM,48,-122,0,2,2
15816,SpokaneStBridge,10/22/2015 12:00:00 AM,48,-122,1,3,4
15817,SpokaneStBridge,10/22/2015 01:00:00 AM,48,-122,0,0,0
15818,SpokaneStBridge,10/22/2015 02:00:00 AM,48,-122,0,0,0
15819,SpokaneStBridge,10/22/2015 03:00:00 AM,48,-122,2,0,2
15820,SpokaneStBridge,10/22/2015 04:00:00 AM,48,-122,5,0,5
15821,SpokaneStBridge,10/22/2015 05:00:00 AM,48,-122,17,5,22
15822,SpokaneStBridge,10/22/2015 06:00:00 AM,48,-122,66,8,74
15823,SpokaneStBridge,10/22/2015 07:00:00 AM,48,-122,98,12,110
15824,SpokaneStBridge,10/22/2015 08:00:00 AM,48,-122,134,12,146
15825,SpokaneStBridge,10/22/2015 09:00:00 AM,48,-122,49,12,61
15826,SpokaneStBridge,10/22/2015 10:00:00 AM,48,-122,14,5,19
15827,SpokaneStBridge,10/22/2015 11:00:00 AM,48,-122,11,8,19
15828,SpokaneStBridge,10/22/2015 12:00:00 PM,48,-122,13,15,28
15829,SpokaneStBridge,10/22/2015 01:00:00 PM,48,-122,19,7,26
15830,SpokaneStBridge,10/22/2015 02:00:00 PM,48,-122,15,20,35
15831,SpokaneStBridge,10/22/2015 03:00:00 PM,48,-122,19,29,48
15832,SpokaneStBridge,10/22/2015 04:00:00 PM,48,-122,20,78,98
15833,SpokaneStBridge,10/22/2015 05:00:00 PM,48,-122,19,145,164
15834,SpokaneStBridge,10/22/2015 06:00:00 PM,48,-122,10,71,81
15835,SpokaneStBridge,10/22/2015 07:00:00 PM,48,-122,9,26,35
15836,SpokaneStBridge,10/22/2015 08:00:00 PM,48,-122,5,11,16
15837,SpokaneStBridge,10/22/2015 09:00:00 PM,48,-122,3,8,11
15838,SpokaneStBridge,10/22/2015 10:00:00 PM,48,-122,0,4,4
15839,SpokaneStBridge,10/22/2015 11:00:00 PM,48,-122,1,4,5
15840,SpokaneStBridge,10/23/2015 12:00:00 AM,48,-122,2,2,4
15841,SpokaneStBridge,10/23/2015 01:00:00 AM,48,-122,0,0,0
15842,SpokaneStBridge,10/23/2015 02:00:00 AM,48,-122,1,3,4
15843,SpokaneStBridge,10/23/2015 03:00:00 AM,48,-122,2,0,2
15844,SpokaneStBridge,10/23/2015 04:00:00 AM,48,-122,5,0,5
15845,SpokaneStBridge,10/23/2015 05:00:00 AM,48,-122,21,1,22
15846,SpokaneStBridge,10/23/2015 06:00:00 AM,48,-122,54,7,61
15847,SpokaneStBridge,10/23/2015 07:00:00 AM,48,-122,90,13,103
15848,SpokaneStBridge,10/23/2015 08:00:00 AM,48,-122,106,9,115
15849,SpokaneStBridge,10/23/2015 09:00:00 AM,48,-122,40,10,50
15850,SpokaneStBridge,10/23/2015 10:00:00 AM,48,-122,13,1,14
15851,SpokaneStBridge,10/23/2015 11:00:00 AM,48,-122,7,9,16
15852,SpokaneStBridge,10/23/2015 12:00:00 PM,48,-122,16,14,30
15853,SpokaneStBridge,10/23/2015 01:00:00 PM,48,-122,13,10,23
15854,SpokaneStBridge,10/23/2015 02:00:00 PM,48,-122,9,17,26
15855,SpokaneStBridge,10/23/2015 03:00:00 PM,48,-122,11,30,41
15856,SpokaneStBridge,10/23/2015 04:00:00 PM,48,-122,16,65,81
15857,SpokaneStBridge,10/23/2015 05:00:00 PM,48,-122,24,111,135
15858,SpokaneStBridge,10/23/2015 06:00:00 PM,48,-122,8,62,70
15859,SpokaneStBridge,10/23/2015 07:00:00 PM,48,-122,6,13,19
15860,SpokaneStBridge,10/23/2015 08:00:00 PM,48,-122,5,10,15
15861,SpokaneStBridge,10/23/2015 09:00:00 PM,48,-122,1,5,6
15862,SpokaneStBridge,10/23/2015 10:00:00 PM,48,-122,1,8,9
15863,SpokaneStBridge,10/23/2015 11:00:00 PM,48,-122,1,5,6
15864,SpokaneStBridge,10/24/2015 12:00:00 AM,48,-122,1,3,4
15865,SpokaneStBridge,10/24/2015 01:00:00 AM,48,-122,0,1,1
15866,SpokaneStBridge,10/24/2015 02:00:00 AM,48,-122,1,0,1
15867,SpokaneStBridge,10/24/2015 03:00:00 AM,48,-122,1,0,1
15868,SpokaneStBridge,10/24/2015 04:00:00 AM,48,-122,0,0,0
15869,SpokaneStBridge,10/24/2015 05:00:00 AM,48,-122,6,3,9
15870,SpokaneStBridge,10/24/2015 06:00:00 AM,48,-122,7,0,7
15871,SpokaneStBridge,10/24/2015 07:00:00 AM,48,-122,5,2,7
15872,SpokaneStBridge,10/24/2015 08:00:00 AM,48,-122,7,7,14
15873,SpokaneStBridge,10/24/2015 09:00:00 AM,48,-122,15,14,29
15874,SpokaneStBridge,10/24/2015 10:00:00 AM,48,-122,14,10,24
15875,SpokaneStBridge,10/24/2015 11:00:00 AM,48,-122,14,25,39
15876,SpokaneStBridge,10/24/2015 12:00:00 PM,48,-122,24,9,33
15877,SpokaneStBridge,10/24/2015 01:00:00 PM,48,-122,23,11,34
15878,SpokaneStBridge,10/24/2015 02:00:00 PM,48,-122,19,11,30
15879,SpokaneStBridge,10/24/2015 03:00:00 PM,48,-122,14,24,38
15880,SpokaneStBridge,10/24/2015 04:00:00 PM,48,-122,12,17,29
15881,SpokaneStBridge,10/24/2015 05:00:00 PM,48,-122,12,12,24
15882,SpokaneStBridge,10/24/2015 06:00:00 PM,48,-122,1,6,7
15883,SpokaneStBridge,10/24/2015 07:00:00 PM,48,-122,4,3,7
15884,SpokaneStBridge,10/24/2015 08:00:00 PM,48,-122,4,5,9
15885,SpokaneStBridge,10/24/2015 09:00:00 PM,48,-122,1,5,6
15886,SpokaneStBridge,10/24/2015 10:00:00 PM,48,-122,2,3,5
15887,SpokaneStBridge,10/24/2015 11:00:00 PM,48,-122,1,2,3
15888,SpokaneStBridge,10/25/2015 12:00:00 AM,48,-122,3,1,4
15889,SpokaneStBridge,10/25/2015 01:00:00 AM,48,-122,0,0,0
15890,SpokaneStBridge,10/25/2015 02:00:00 AM,48,-122,1,2,3
15891,SpokaneStBridge,10/25/2015 03:00:00 AM,48,-122,0,2,2
15892,SpokaneStBridge,10/25/2015 04:00:00 AM,48,-122,0,0,0
15893,SpokaneStBridge,10/25/2015 05:00:00 AM,48,-122,5,0,5
15894,SpokaneStBridge,10/25/2015 06:00:00 AM,48,-122,3,1,4
15895,SpokaneStBridge,10/25/2015 07:00:00 AM,48,-122,5,3,8
15896,SpokaneStBridge,10/25/2015 08:00:00 AM,48,-122,8,5,13
15897,SpokaneStBridge,10/25/2015 09:00:00 AM,48,-122,12,10,22
15898,SpokaneStBridge,10/25/2015 10:00:00 AM,48,-122,14,15,29
15899,SpokaneStBridge,10/25/2015 11:00:00 AM,48,-122,12,11,23
15900,SpokaneStBridge,10/25/2015 12:00:00 PM,48,-122,25,16,41
15901,SpokaneStBridge,10/25/2015 01:00:00 PM,48,-122,17,13,30
15902,SpokaneStBridge,10/25/2015 02:00:00 PM,48,-122,18,27,45
15903,SpokaneStBridge,10/25/2015 03:00:00 PM,48,-122,14,14,28
15904,SpokaneStBridge,10/25/2015 04:00:00 PM,48,-122,9,10,19
15905,SpokaneStBridge,10/25/2015 05:00:00 PM,48,-122,5,3,8
15906,SpokaneStBridge,10/25/2015 06:00:00 PM,48,-122,3,6,9
15907,SpokaneStBridge,10/25/2015 07:00:00 PM,48,-122,1,3,4
15908,SpokaneStBridge,10/25/2015 08:00:00 PM,48,-122,0,0,0
15909,SpokaneStBridge,10/25/2015 09:00:00 PM,48,-122,0,0,0
15910,SpokaneStBridge,10/25/2015 10:00:00 PM,48,-122,0,4,4
15911,SpokaneStBridge,10/25/2015 11:00:00 PM,48,-122,0,0,0
15912,SpokaneStBridge,10/26/2015 12:00:00 AM,48,-122,0,1,1
15913,SpokaneStBridge,10/26/2015 01:00:00 AM,48,-122,0,0,0
15914,SpokaneStBridge,10/26/2015 02:00:00 AM,48,-122,2,0,2
15915,SpokaneStBridge,10/26/2015 03:00:00 AM,48,-122,1,1,2
15916,SpokaneStBridge,10/26/2015 04:00:00 AM,48,-122,3,1,4
15917,SpokaneStBridge,10/26/2015 05:00:00 AM,48,-122,17,1,18
15918,SpokaneStBridge,10/26/2015 06:00:00 AM,48,-122,34,7,41
15919,SpokaneStBridge,10/26/2015 07:00:00 AM,48,-122,75,10,85
15920,SpokaneStBridge,10/26/2015 08:00:00 AM,48,-122,85,9,94
15921,SpokaneStBridge,10/26/2015 09:00:00 AM,48,-122,35,2,37
15922,SpokaneStBridge,10/26/2015 10:00:00 AM,48,-122,13,3,16
15923,SpokaneStBridge,10/26/2015 11:00:00 AM,48,-122,1,1,2
15924,SpokaneStBridge,10/26/2015 12:00:00 PM,48,-122,1,6,7
15925,SpokaneStBridge,10/26/2015 01:00:00 PM,48,-122,3,3,6
15926,SpokaneStBridge,10/26/2015 02:00:00 PM,48,-122,8,17,25
15927,SpokaneStBridge,10/26/2015 03:00:00 PM,48,-122,2,24,26
15928,SpokaneStBridge,10/26/2015 04:00:00 PM,48,-122,11,44,55
15929,SpokaneStBridge,10/26/2015 05:00:00 PM,48,-122,10,106,116
15930,SpokaneStBridge,10/26/2015 06:00:00 PM,48,-122,3,60,63
15931,SpokaneStBridge,10/26/2015 07:00:00 PM,48,-122,4,20,24
15932,SpokaneStBridge,10/26/2015 08:00:00 PM,48,-122,4,10,14
15933,SpokaneStBridge,10/26/2015 09:00:00 PM,48,-122,2,9,11
15934,SpokaneStBridge,10/26/2015 10:00:00 PM,48,-122,2,3,5
15935,SpokaneStBridge,10/26/2015 11:00:00 PM,48,-122,0,1,1
15936,SpokaneStBridge,10/27/2015 12:00:00 AM,48,-122,1,0,1
15937,SpokaneStBridge,10/27/2015 01:00:00 AM,48,-122,0,2,2
15938,SpokaneStBridge,10/27/2015 02:00:00 AM,48,-122,1,0,1
15939,SpokaneStBridge,10/27/2015 03:00:00 AM,48,-122,2,1,3
15940,SpokaneStBridge,10/27/2015 04:00:00 AM,48,-122,5,0,5
15941,SpokaneStBridge,10/27/2015 05:00:00 AM,48,-122,19,5,24
15942,SpokaneStBridge,10/27/2015 06:00:00 AM,48,-122,57,18,75
15943,SpokaneStBridge,10/27/2015 07:00:00 AM,48,-122,122,13,135
15944,SpokaneStBridge,10/27/2015 08:00:00 AM,48,-122,134,9,143
15945,SpokaneStBridge,10/27/2015 09:00:00 AM,48,-122,48,5,53
15946,SpokaneStBridge,10/27/2015 10:00:00 AM,48,-122,19,5,24
15947,SpokaneStBridge,10/27/2015 11:00:00 AM,48,-122,12,9,21
15948,SpokaneStBridge,10/27/2015 12:00:00 PM,48,-122,9,19,28
15949,SpokaneStBridge,10/27/2015 01:00:00 PM,48,-122,20,12,32
15950,SpokaneStBridge,10/27/2015 02:00:00 PM,48,-122,9,17,26
15951,SpokaneStBridge,10/27/2015 03:00:00 PM,48,-122,12,29,41
15952,SpokaneStBridge,10/27/2015 04:00:00 PM,48,-122,26,66,92
15953,SpokaneStBridge,10/27/2015 05:00:00 PM,48,-122,22,146,168
15954,SpokaneStBridge,10/27/2015 06:00:00 PM,48,-122,14,83,97
15955,SpokaneStBridge,10/27/2015 07:00:00 PM,48,-122,4,34,38
15956,SpokaneStBridge,10/27/2015 08:00:00 PM,48,-122,5,6,11
15957,SpokaneStBridge,10/27/2015 09:00:00 PM,48,-122,0,12,12
15958,SpokaneStBridge,10/27/2015 10:00:00 PM,48,-122,2,9,11
15959,SpokaneStBridge,10/27/2015 11:00:00 PM,48,-122,1,3,4
15960,SpokaneStBridge,10/28/2015 12:00:00 AM,48,-122,1,1,2
15961,SpokaneStBridge,10/28/2015 01:00:00 AM,48,-122,0,0,0
15962,SpokaneStBridge,10/28/2015 02:00:00 AM,48,-122,1,0,1
15963,SpokaneStBridge,10/28/2015 03:00:00 AM,48,-122,1,0,1
15964,SpokaneStBridge,10/28/2015 04:00:00 AM,48,-122,3,1,4
15965,SpokaneStBridge,10/28/2015 05:00:00 AM,48,-122,15,3,18
15966,SpokaneStBridge,10/28/2015 06:00:00 AM,48,-122,46,11,57
15967,SpokaneStBridge,10/28/2015 07:00:00 AM,48,-122,89,10,99
15968,SpokaneStBridge,10/28/2015 08:00:00 AM,48,-122,104,5,109
15969,SpokaneStBridge,10/28/2015 09:00:00 AM,48,-122,32,5,37
15970,SpokaneStBridge,10/28/2015 10:00:00 AM,48,-122,9,1,10
15971,SpokaneStBridge,10/28/2015 11:00:00 AM,48,-122,6,2,8
15972,SpokaneStBridge,10/28/2015 12:00:00 PM,48,-122,4,7,11
15973,SpokaneStBridge,10/28/2015 01:00:00 PM,48,-122,4,5,9
15974,SpokaneStBridge,10/28/2015 02:00:00 PM,48,-122,5,11,16
15975,SpokaneStBridge,10/28/2015 03:00:00 PM,48,-122,5,25,30
15976,SpokaneStBridge,10/28/2015 04:00:00 PM,48,-122,9,49,58
15977,SpokaneStBridge,10/28/2015 05:00:00 PM,48,-122,11,110,121
15978,SpokaneStBridge,10/28/2015 06:00:00 PM,48,-122,9,55,64
15979,SpokaneStBridge,10/28/2015 07:00:00 PM,48,-122,5,23,28
15980,SpokaneStBridge,10/28/2015 08:00:00 PM,48,-122,4,9,13
15981,SpokaneStBridge,10/28/2015 09:00:00 PM,48,-122,3,11,14
15982,SpokaneStBridge,10/28/2015 10:00:00 PM,48,-122,1,7,8
15983,SpokaneStBridge,10/28/2015 11:00:00 PM,48,-122,2,3,5
15984,SpokaneStBridge,10/29/2015 12:00:00 AM,48,-122,3,1,4
15985,SpokaneStBridge,10/29/2015 01:00:00 AM,48,-122,3,1,4
15986,SpokaneStBridge,10/29/2015 02:00:00 AM,48,-122,0,0,0
15987,SpokaneStBridge,10/29/2015 03:00:00 AM,48,-122,0,1,1
15988,SpokaneStBridge,10/29/2015 04:00:00 AM,48,-122,4,0,4
15989,SpokaneStBridge,10/29/2015 05:00:00 AM,48,-122,13,3,16
15990,SpokaneStBridge,10/29/2015 06:00:00 AM,48,-122,50,12,62
15991,SpokaneStBridge,10/29/2015 07:00:00 AM,48,-122,89,16,105
15992,SpokaneStBridge,10/29/2015 08:00:00 AM,48,-122,113,12,125
15993,SpokaneStBridge,10/29/2015 09:00:00 AM,48,-122,26,7,33
15994,SpokaneStBridge,10/29/2015 10:00:00 AM,48,-122,18,3,21
15995,SpokaneStBridge,10/29/2015 11:00:00 AM,48,-122,10,6,16
15996,SpokaneStBridge,10/29/2015 12:00:00 PM,48,-122,5,6,11
15997,SpokaneStBridge,10/29/2015 01:00:00 PM,48,-122,12,6,18
15998,SpokaneStBridge,10/29/2015 02:00:00 PM,48,-122,2,15,17
15999,SpokaneStBridge,10/29/2015 03:00:00 PM,48,-122,14,31,45
16000,SpokaneStBridge,10/29/2015 04:00:00 PM,48,-122,11,57,68
16001,SpokaneStBridge,10/29/2015 05:00:00 PM,48,-122,15,107,122
16002,SpokaneStBridge,10/29/2015 06:00:00 PM,48,-122,6,67,73
16003,SpokaneStBridge,10/29/2015 07:00:00 PM,48,-122,5,20,25
16004,SpokaneStBridge,10/29/2015 08:00:00 PM,48,-122,2,16,18
16005,SpokaneStBridge,10/29/2015 09:00:00 PM,48,-122,2,6,8
16006,SpokaneStBridge,10/29/2015 10:00:00 PM,48,-122,1,8,9
16007,SpokaneStBridge,10/29/2015 11:00:00 PM,48,-122,2,3,5
16008,SpokaneStBridge,10/30/2015 12:00:00 AM,48,-122,1,1,2
16009,SpokaneStBridge,10/30/2015 01:00:00 AM,48,-122,0,2,2
16010,SpokaneStBridge,10/30/2015 02:00:00 AM,48,-122,0,0,0
16011,SpokaneStBridge,10/30/2015 03:00:00 AM,48,-122,3,3,6
16012,SpokaneStBridge,10/30/2015 04:00:00 AM,48,-122,3,0,3
16013,SpokaneStBridge,10/30/2015 05:00:00 AM,48,-122,10,1,11
16014,SpokaneStBridge,10/30/2015 06:00:00 AM,48,-122,20,7,27
16015,SpokaneStBridge,10/30/2015 07:00:00 AM,48,-122,52,10,62
16016,SpokaneStBridge,10/30/2015 08:00:00 AM,48,-122,52,9,61
16017,SpokaneStBridge,10/30/2015 09:00:00 AM,48,-122,33,0,33
16018,SpokaneStBridge,10/30/2015 10:00:00 AM,48,-122,8,1,9
16019,SpokaneStBridge,10/30/2015 11:00:00 AM,48,-122,6,4,10
16020,SpokaneStBridge,10/30/2015 12:00:00 PM,48,-122,7,7,14
16021,SpokaneStBridge,10/30/2015 01:00:00 PM,48,-122,5,7,12
16022,SpokaneStBridge,10/30/2015 02:00:00 PM,48,-122,2,13,15
16023,SpokaneStBridge,10/30/2015 03:00:00 PM,48,-122,10,11,21
16024,SpokaneStBridge,10/30/2015 04:00:00 PM,48,-122,12,43,55
16025,SpokaneStBridge,10/30/2015 05:00:00 PM,48,-122,11,62,73
16026,SpokaneStBridge,10/30/2015 06:00:00 PM,48,-122,6,33,39
16027,SpokaneStBridge,10/30/2015 07:00:00 PM,48,-122,3,15,18
16028,SpokaneStBridge,10/30/2015 08:00:00 PM,48,-122,1,5,6
16029,SpokaneStBridge,10/30/2015 09:00:00 PM,48,-122,1,4,5
16030,SpokaneStBridge,10/30/2015 10:00:00 PM,48,-122,1,1,2
16031,SpokaneStBridge,10/30/2015 11:00:00 PM,48,-122,0,4,4
16032,SpokaneStBridge,10/31/2015 12:00:00 AM,48,-122,0,1,1
16033,SpokaneStBridge,10/31/2015 01:00:00 AM,48,-122,0,2,2
16034,SpokaneStBridge,10/31/2015 02:00:00 AM,48,-122,0,0,0
16035,SpokaneStBridge,10/31/2015 03:00:00 AM,48,-122,0,1,1
16036,SpokaneStBridge,10/31/2015 04:00:00 AM,48,-122,0,0,0
16037,SpokaneStBridge,10/31/2015 05:00:00 AM,48,-122,3,0,3
16038,SpokaneStBridge,10/31/2015 06:00:00 AM,48,-122,2,0,2
16039,SpokaneStBridge,10/31/2015 07:00:00 AM,48,-122,2,0,2
16040,SpokaneStBridge,10/31/2015 08:00:00 AM,48,-122,5,1,6
16041,SpokaneStBridge,10/31/2015 09:00:00 AM,48,-122,6,4,10
16042,SpokaneStBridge,10/31/2015 10:00:00 AM,48,-122,3,1,4
16043,SpokaneStBridge,10/31/2015 11:00:00 AM,48,-122,4,4,8
16044,SpokaneStBridge,10/31/2015 12:00:00 PM,48,-122,2,3,5
16045,SpokaneStBridge,10/31/2015 01:00:00 PM,48,-122,2,2,4
16046,SpokaneStBridge,10/31/2015 02:00:00 PM,48,-122,3,8,11
16047,SpokaneStBridge,10/31/2015 03:00:00 PM,48,-122,6,10,16
16048,SpokaneStBridge,10/31/2015 04:00:00 PM,48,-122,2,4,6
16049,SpokaneStBridge,10/31/2015 05:00:00 PM,48,-122,4,1,5
16050,SpokaneStBridge,10/31/2015 06:00:00 PM,48,-122,4,4,8
16051,SpokaneStBridge,10/31/2015 07:00:00 PM,48,-122,1,5,6
16052,SpokaneStBridge,10/31/2015 08:00:00 PM,48,-122,1,5,6
16053,SpokaneStBridge,10/31/2015 09:00:00 PM,48,-122,0,0,0
16054,SpokaneStBridge,10/31/2015 10:00:00 PM,48,-122,0,0,0
16055,SpokaneStBridge,10/31/2015 11:00:00 PM,48,-122,1,1,2
16056,SpokaneStBridge,11/01/2015 12:00:00 AM,48,-122,2,13,15
16057,SpokaneStBridge,11/01/2015 01:00:00 AM,48,-122,2,3,5
16058,SpokaneStBridge,11/01/2015 02:00:00 AM,48,-122,6,0,6
16059,SpokaneStBridge,11/01/2015 03:00:00 AM,48,-122,0,0,0
16060,SpokaneStBridge,11/01/2015 04:00:00 AM,48,-122,0,0,0
16061,SpokaneStBridge,11/01/2015 05:00:00 AM,48,-122,2,0,2
16062,SpokaneStBridge,11/01/2015 06:00:00 AM,48,-122,1,1,2
16063,SpokaneStBridge,11/01/2015 07:00:00 AM,48,-122,4,4,8
16064,SpokaneStBridge,11/01/2015 08:00:00 AM,48,-122,13,4,17
16065,SpokaneStBridge,11/01/2015 09:00:00 AM,48,-122,9,4,13
16066,SpokaneStBridge,11/01/2015 10:00:00 AM,48,-122,5,6,11
16067,SpokaneStBridge,11/01/2015 11:00:00 AM,48,-122,9,16,25
16068,SpokaneStBridge,11/01/2015 12:00:00 PM,48,-122,0,6,6
16069,SpokaneStBridge,11/01/2015 01:00:00 PM,48,-122,4,3,7
16070,SpokaneStBridge,11/01/2015 02:00:00 PM,48,-122,8,2,10
16071,SpokaneStBridge,11/01/2015 03:00:00 PM,48,-122,2,2,4
16072,SpokaneStBridge,11/01/2015 04:00:00 PM,48,-122,4,3,7
16073,SpokaneStBridge,11/01/2015 05:00:00 PM,48,-122,8,7,15
16074,SpokaneStBridge,11/01/2015 06:00:00 PM,48,-122,1,3,4
16075,SpokaneStBridge,11/01/2015 07:00:00 PM,48,-122,1,3,4
16076,SpokaneStBridge,11/01/2015 08:00:00 PM,48,-122,1,4,5
16077,SpokaneStBridge,11/01/2015 09:00:00 PM,48,-122,0,1,1
16078,SpokaneStBridge,11/01/2015 10:00:00 PM,48,-122,0,1,1
16079,SpokaneStBridge,11/01/2015 11:00:00 PM,48,-122,1,1,2
16080,SpokaneStBridge,11/02/2015 12:00:00 AM,48,-122,0,0,0
16081,SpokaneStBridge,11/02/2015 01:00:00 AM,48,-122,0,1,1
16082,SpokaneStBridge,11/02/2015 02:00:00 AM,48,-122,1,0,1
16083,SpokaneStBridge,11/02/2015 03:00:00 AM,48,-122,0,2,2
16084,SpokaneStBridge,11/02/2015 04:00:00 AM,48,-122,0,2,2
16085,SpokaneStBridge,11/02/2015 05:00:00 AM,48,-122,19,1,20
16086,SpokaneStBridge,11/02/2015 06:00:00 AM,48,-122,65,10,75
16087,SpokaneStBridge,11/02/2015 07:00:00 AM,48,-122,112,15,127
16088,SpokaneStBridge,11/02/2015 08:00:00 AM,48,-122,115,12,127
16089,SpokaneStBridge,11/02/2015 09:00:00 AM,48,-122,35,2,37
16090,SpokaneStBridge,11/02/2015 10:00:00 AM,48,-122,8,3,11
16091,SpokaneStBridge,11/02/2015 11:00:00 AM,48,-122,8,3,11
16092,SpokaneStBridge,11/02/2015 12:00:00 PM,48,-122,10,5,15
16093,SpokaneStBridge,11/02/2015 01:00:00 PM,48,-122,7,10,17
16094,SpokaneStBridge,11/02/2015 02:00:00 PM,48,-122,8,13,21
16095,SpokaneStBridge,11/02/2015 03:00:00 PM,48,-122,7,33,40
16096,SpokaneStBridge,11/02/2015 04:00:00 PM,48,-122,14,68,82
16097,SpokaneStBridge,11/02/2015 05:00:00 PM,48,-122,14,139,153
16098,SpokaneStBridge,11/02/2015 06:00:00 PM,48,-122,7,66,73
16099,SpokaneStBridge,11/02/2015 07:00:00 PM,48,-122,3,21,24
16100,SpokaneStBridge,11/02/2015 08:00:00 PM,48,-122,5,10,15
16101,SpokaneStBridge,11/02/2015 09:00:00 PM,48,-122,1,4,5
16102,SpokaneStBridge,11/02/2015 10:00:00 PM,48,-122,2,0,2
16103,SpokaneStBridge,11/02/2015 11:00:00 PM,48,-122,0,2,2
16104,SpokaneStBridge,11/03/2015 12:00:00 AM,48,-122,1,0,1
16105,SpokaneStBridge,11/03/2015 01:00:00 AM,48,-122,0,0,0
16106,SpokaneStBridge,11/03/2015 02:00:00 AM,48,-122,0,0,0
16107,SpokaneStBridge,11/03/2015 03:00:00 AM,48,-122,2,1,3
16108,SpokaneStBridge,11/03/2015 04:00:00 AM,48,-122,4,0,4
16109,SpokaneStBridge,11/03/2015 05:00:00 AM,48,-122,20,1,21
16110,SpokaneStBridge,11/03/2015 06:00:00 AM,48,-122,62,7,69
16111,SpokaneStBridge,11/03/2015 07:00:00 AM,48,-122,116,15,131
16112,SpokaneStBridge,11/03/2015 08:00:00 AM,48,-122,130,11,141
16113,SpokaneStBridge,11/03/2015 09:00:00 AM,48,-122,38,6,44
16114,SpokaneStBridge,11/03/2015 10:00:00 AM,48,-122,8,5,13
16115,SpokaneStBridge,11/03/2015 11:00:00 AM,48,-122,5,4,9
16116,SpokaneStBridge,11/03/2015 12:00:00 PM,48,-122,6,9,15
16117,SpokaneStBridge,11/03/2015 01:00:00 PM,48,-122,11,6,17
16118,SpokaneStBridge,11/03/2015 02:00:00 PM,48,-122,11,19,30
16119,SpokaneStBridge,11/03/2015 03:00:00 PM,48,-122,8,21,29
16120,SpokaneStBridge,11/03/2015 04:00:00 PM,48,-122,18,81,99
16121,SpokaneStBridge,11/03/2015 05:00:00 PM,48,-122,16,130,146
16122,SpokaneStBridge,11/03/2015 06:00:00 PM,48,-122,5,81,86
16123,SpokaneStBridge,11/03/2015 07:00:00 PM,48,-122,2,24,26
16124,SpokaneStBridge,11/03/2015 08:00:00 PM,48,-122,5,8,13
16125,SpokaneStBridge,11/03/2015 09:00:00 PM,48,-122,2,3,5
16126,SpokaneStBridge,11/03/2015 10:00:00 PM,48,-122,1,3,4
16127,SpokaneStBridge,11/03/2015 11:00:00 PM,48,-122,0,1,1
16128,SpokaneStBridge,11/04/2015 12:00:00 AM,48,-122,2,2,4
16129,SpokaneStBridge,11/04/2015 01:00:00 AM,48,-122,0,0,0
16130,SpokaneStBridge,11/04/2015 02:00:00 AM,48,-122,0,1,1
16131,SpokaneStBridge,11/04/2015 03:00:00 AM,48,-122,0,1,1
16132,SpokaneStBridge,11/04/2015 04:00:00 AM,48,-122,4,0,4
16133,SpokaneStBridge,11/04/2015 05:00:00 AM,48,-122,17,2,19
16134,SpokaneStBridge,11/04/2015 06:00:00 AM,48,-122,61,11,72
16135,SpokaneStBridge,11/04/2015 07:00:00 AM,48,-122,121,15,136
16136,SpokaneStBridge,11/04/2015 08:00:00 AM,48,-122,116,8,124
16137,SpokaneStBridge,11/04/2015 09:00:00 AM,48,-122,42,5,47
16138,SpokaneStBridge,11/04/2015 10:00:00 AM,48,-122,22,7,29
16139,SpokaneStBridge,11/04/2015 11:00:00 AM,48,-122,9,12,21
16140,SpokaneStBridge,11/04/2015 12:00:00 PM,48,-122,17,11,28
16141,SpokaneStBridge,11/04/2015 01:00:00 PM,48,-122,11,10,21
16142,SpokaneStBridge,11/04/2015 02:00:00 PM,48,-122,13,15,28
16143,SpokaneStBridge,11/04/2015 03:00:00 PM,48,-122,10,39,49
16144,SpokaneStBridge,11/04/2015 04:00:00 PM,48,-122,14,66,80
16145,SpokaneStBridge,11/04/2015 05:00:00 PM,48,-122,19,125,144
16146,SpokaneStBridge,11/04/2015 06:00:00 PM,48,-122,6,85,91
16147,SpokaneStBridge,11/04/2015 07:00:00 PM,48,-122,3,33,36
16148,SpokaneStBridge,11/04/2015 08:00:00 PM,48,-122,10,16,26
16149,SpokaneStBridge,11/04/2015 09:00:00 PM,48,-122,3,10,13
16150,SpokaneStBridge,11/04/2015 10:00:00 PM,48,-122,2,10,12
16151,SpokaneStBridge,11/04/2015 11:00:00 PM,48,-122,0,1,1
16152,SpokaneStBridge,11/05/2015 12:00:00 AM,48,-122,1,0,1
16153,SpokaneStBridge,11/05/2015 01:00:00 AM,48,-122,0,0,0
16154,SpokaneStBridge,11/05/2015 02:00:00 AM,48,-122,0,1,1
16155,SpokaneStBridge,11/05/2015 03:00:00 AM,48,-122,1,1,2
16156,SpokaneStBridge,11/05/2015 04:00:00 AM,48,-122,2,0,2
16157,SpokaneStBridge,11/05/2015 05:00:00 AM,48,-122,14,1,15
16158,SpokaneStBridge,11/05/2015 06:00:00 AM,48,-122,45,7,52
16159,SpokaneStBridge,11/05/2015 07:00:00 AM,48,-122,101,6,107
16160,SpokaneStBridge,11/05/2015 08:00:00 AM,48,-122,92,8,100
16161,SpokaneStBridge,11/05/2015 09:00:00 AM,48,-122,34,7,41
16162,SpokaneStBridge,11/05/2015 10:00:00 AM,48,-122,19,2,21
16163,SpokaneStBridge,11/05/2015 11:00:00 AM,48,-122,10,2,12
16164,SpokaneStBridge,11/05/2015 12:00:00 PM,48,-122,4,5,9
16165,SpokaneStBridge,11/05/2015 01:00:00 PM,48,-122,8,8,16
16166,SpokaneStBridge,11/05/2015 02:00:00 PM,48,-122,6,7,13
16167,SpokaneStBridge,11/05/2015 03:00:00 PM,48,-122,7,19,26
16168,SpokaneStBridge,11/05/2015 04:00:00 PM,48,-122,6,48,54
16169,SpokaneStBridge,11/05/2015 05:00:00 PM,48,-122,12,94,106
16170,SpokaneStBridge,11/05/2015 06:00:00 PM,48,-122,9,64,73
16171,SpokaneStBridge,11/05/2015 07:00:00 PM,48,-122,2,27,29
16172,SpokaneStBridge,11/05/2015 08:00:00 PM,48,-122,4,12,16
16173,SpokaneStBridge,11/05/2015 09:00:00 PM,48,-122,2,10,12
16174,SpokaneStBridge,11/05/2015 10:00:00 PM,48,-122,1,4,5
16175,SpokaneStBridge,11/05/2015 11:00:00 PM,48,-122,1,4,5
16176,SpokaneStBridge,11/06/2015 12:00:00 AM,48,-122,1,1,2
16177,SpokaneStBridge,11/06/2015 01:00:00 AM,48,-122,1,2,3
16178,SpokaneStBridge,11/06/2015 02:00:00 AM,48,-122,1,1,2
16179,SpokaneStBridge,11/06/2015 03:00:00 AM,48,-122,2,0,2
16180,SpokaneStBridge,11/06/2015 04:00:00 AM,48,-122,2,0,2
16181,SpokaneStBridge,11/06/2015 05:00:00 AM,48,-122,15,4,19
16182,SpokaneStBridge,11/06/2015 06:00:00 AM,48,-122,39,6,45
16183,SpokaneStBridge,11/06/2015 07:00:00 AM,48,-122,71,8,79
16184,SpokaneStBridge,11/06/2015 08:00:00 AM,48,-122,90,9,99
16185,SpokaneStBridge,11/06/2015 09:00:00 AM,48,-122,38,2,40
16186,SpokaneStBridge,11/06/2015 10:00:00 AM,48,-122,14,3,17
16187,SpokaneStBridge,11/06/2015 11:00:00 AM,48,-122,8,2,10
16188,SpokaneStBridge,11/06/2015 12:00:00 PM,48,-122,8,7,15
16189,SpokaneStBridge,11/06/2015 01:00:00 PM,48,-122,12,15,27
16190,SpokaneStBridge,11/06/2015 02:00:00 PM,48,-122,11,21,32
16191,SpokaneStBridge,11/06/2015 03:00:00 PM,48,-122,7,31,38
16192,SpokaneStBridge,11/06/2015 04:00:00 PM,48,-122,17,53,70
16193,SpokaneStBridge,11/06/2015 05:00:00 PM,48,-122,9,74,83
16194,SpokaneStBridge,11/06/2015 06:00:00 PM,48,-122,5,47,52
16195,SpokaneStBridge,11/06/2015 07:00:00 PM,48,-122,9,13,22
16196,SpokaneStBridge,11/06/2015 08:00:00 PM,48,-122,4,9,13
16197,SpokaneStBridge,11/06/2015 09:00:00 PM,48,-122,4,8,12
16198,SpokaneStBridge,11/06/2015 10:00:00 PM,48,-122,1,4,5
16199,SpokaneStBridge,11/06/2015 11:00:00 PM,48,-122,3,4,7
16200,SpokaneStBridge,11/07/2015 12:00:00 AM,48,-122,1,2,3
16201,SpokaneStBridge,11/07/2015 01:00:00 AM,48,-122,0,0,0
16202,SpokaneStBridge,11/07/2015 02:00:00 AM,48,-122,0,0,0
16203,SpokaneStBridge,11/07/2015 03:00:00 AM,48,-122,2,0,2
16204,SpokaneStBridge,11/07/2015 04:00:00 AM,48,-122,0,0,0
16205,SpokaneStBridge,11/07/2015 05:00:00 AM,48,-122,8,0,8
16206,SpokaneStBridge,11/07/2015 06:00:00 AM,48,-122,4,2,6
16207,SpokaneStBridge,11/07/2015 07:00:00 AM,48,-122,4,2,6
16208,SpokaneStBridge,11/07/2015 08:00:00 AM,48,-122,9,5,14
16209,SpokaneStBridge,11/07/2015 09:00:00 AM,48,-122,2,3,5
16210,SpokaneStBridge,11/07/2015 10:00:00 AM,48,-122,4,5,9
16211,SpokaneStBridge,11/07/2015 11:00:00 AM,48,-122,5,2,7
16212,SpokaneStBridge,11/07/2015 12:00:00 PM,48,-122,4,6,10
16213,SpokaneStBridge,11/07/2015 01:00:00 PM,48,-122,1,4,5
16214,SpokaneStBridge,11/07/2015 02:00:00 PM,48,-122,3,6,9
16215,SpokaneStBridge,11/07/2015 03:00:00 PM,48,-122,5,0,5
16216,SpokaneStBridge,11/07/2015 04:00:00 PM,48,-122,1,5,6
16217,SpokaneStBridge,11/07/2015 05:00:00 PM,48,-122,2,4,6
16218,SpokaneStBridge,11/07/2015 06:00:00 PM,48,-122,1,2,3
16219,SpokaneStBridge,11/07/2015 07:00:00 PM,48,-122,0,2,2
16220,SpokaneStBridge,11/07/2015 08:00:00 PM,48,-122,0,1,1
16221,SpokaneStBridge,11/07/2015 09:00:00 PM,48,-122,0,1,1
16222,SpokaneStBridge,11/07/2015 10:00:00 PM,48,-122,0,4,4
16223,SpokaneStBridge,11/07/2015 11:00:00 PM,48,-122,1,2,3
16224,SpokaneStBridge,11/08/2015 12:00:00 AM,48,-122,0,0,0
16225,SpokaneStBridge,11/08/2015 01:00:00 AM,48,-122,0,1,1
16226,SpokaneStBridge,11/08/2015 02:00:00 AM,48,-122,0,0,0
16227,SpokaneStBridge,11/08/2015 03:00:00 AM,48,-122,0,1,1
16228,SpokaneStBridge,11/08/2015 04:00:00 AM,48,-122,0,1,1
16229,SpokaneStBridge,11/08/2015 05:00:00 AM,48,-122,2,1,3
16230,SpokaneStBridge,11/08/2015 06:00:00 AM,48,-122,4,0,4
16231,SpokaneStBridge,11/08/2015 07:00:00 AM,48,-122,5,1,6
16232,SpokaneStBridge,11/08/2015 08:00:00 AM,48,-122,9,5,14
16233,SpokaneStBridge,11/08/2015 09:00:00 AM,48,-122,5,2,7
16234,SpokaneStBridge,11/08/2015 10:00:00 AM,48,-122,9,11,20
16235,SpokaneStBridge,11/08/2015 11:00:00 AM,48,-122,4,7,11
16236,SpokaneStBridge,11/08/2015 12:00:00 PM,48,-122,7,1,8
16237,SpokaneStBridge,11/08/2015 01:00:00 PM,48,-122,3,10,13
16238,SpokaneStBridge,11/08/2015 02:00:00 PM,48,-122,15,8,23
16239,SpokaneStBridge,11/08/2015 03:00:00 PM,48,-122,13,19,32
16240,SpokaneStBridge,11/08/2015 04:00:00 PM,48,-122,12,13,25
16241,SpokaneStBridge,11/08/2015 05:00:00 PM,48,-122,5,11,16
16242,SpokaneStBridge,11/08/2015 06:00:00 PM,48,-122,0,2,2
16243,SpokaneStBridge,11/08/2015 07:00:00 PM,48,-122,2,4,6
16244,SpokaneStBridge,11/08/2015 08:00:00 PM,48,-122,0,3,3
16245,SpokaneStBridge,11/08/2015 09:00:00 PM,48,-122,0,2,2
16246,SpokaneStBridge,11/08/2015 10:00:00 PM,48,-122,0,0,0
16247,SpokaneStBridge,11/08/2015 11:00:00 PM,48,-122,0,3,3
16248,SpokaneStBridge,11/09/2015 12:00:00 AM,48,-122,1,0,1
16249,SpokaneStBridge,11/09/2015 01:00:00 AM,48,-122,0,0,0
16250,SpokaneStBridge,11/09/2015 02:00:00 AM,48,-122,0,2,2
16251,SpokaneStBridge,11/09/2015 03:00:00 AM,48,-122,1,1,2
16252,SpokaneStBridge,11/09/2015 04:00:00 AM,48,-122,5,0,5
16253,SpokaneStBridge,11/09/2015 05:00:00 AM,48,-122,16,0,16
16254,SpokaneStBridge,11/09/2015 06:00:00 AM,48,-122,51,6,57
16255,SpokaneStBridge,11/09/2015 07:00:00 AM,48,-122,106,16,122
16256,SpokaneStBridge,11/09/2015 08:00:00 AM,48,-122,90,10,100
16257,SpokaneStBridge,11/09/2015 09:00:00 AM,48,-122,37,3,40
16258,SpokaneStBridge,11/09/2015 10:00:00 AM,48,-122,9,3,12
16259,SpokaneStBridge,11/09/2015 11:00:00 AM,48,-122,4,5,9
16260,SpokaneStBridge,11/09/2015 12:00:00 PM,48,-122,6,5,11
16261,SpokaneStBridge,11/09/2015 01:00:00 PM,48,-122,5,3,8
16262,SpokaneStBridge,11/09/2015 02:00:00 PM,48,-122,10,16,26
16263,SpokaneStBridge,11/09/2015 03:00:00 PM,48,-122,7,25,32
16264,SpokaneStBridge,11/09/2015 04:00:00 PM,48,-122,14,69,83
16265,SpokaneStBridge,11/09/2015 05:00:00 PM,48,-122,17,109,126
16266,SpokaneStBridge,11/09/2015 06:00:00 PM,48,-122,9,56,65
16267,SpokaneStBridge,11/09/2015 07:00:00 PM,48,-122,1,28,29
16268,SpokaneStBridge,11/09/2015 08:00:00 PM,48,-122,3,9,12
16269,SpokaneStBridge,11/09/2015 09:00:00 PM,48,-122,1,7,8
16270,SpokaneStBridge,11/09/2015 10:00:00 PM,48,-122,0,0,0
16271,SpokaneStBridge,11/09/2015 11:00:00 PM,48,-122,1,2,3
16272,SpokaneStBridge,11/10/2015 12:00:00 AM,48,-122,1,1,2
16273,SpokaneStBridge,11/10/2015 01:00:00 AM,48,-122,1,0,1
16274,SpokaneStBridge,11/10/2015 02:00:00 AM,48,-122,0,1,1
16275,SpokaneStBridge,11/10/2015 03:00:00 AM,48,-122,2,0,2
16276,SpokaneStBridge,11/10/2015 04:00:00 AM,48,-122,1,0,1
16277,SpokaneStBridge,11/10/2015 05:00:00 AM,48,-122,18,4,22
16278,SpokaneStBridge,11/10/2015 06:00:00 AM,48,-122,57,10,67
16279,SpokaneStBridge,11/10/2015 07:00:00 AM,48,-122,108,15,123
16280,SpokaneStBridge,11/10/2015 08:00:00 AM,48,-122,122,7,129
16281,SpokaneStBridge,11/10/2015 09:00:00 AM,48,-122,50,7,57
16282,SpokaneStBridge,11/10/2015 10:00:00 AM,48,-122,19,6,25
16283,SpokaneStBridge,11/10/2015 11:00:00 AM,48,-122,12,11,23
16284,SpokaneStBridge,11/10/2015 12:00:00 PM,48,-122,7,10,17
16285,SpokaneStBridge,11/10/2015 01:00:00 PM,48,-122,11,2,13
16286,SpokaneStBridge,11/10/2015 02:00:00 PM,48,-122,13,19,32
16287,SpokaneStBridge,11/10/2015 03:00:00 PM,48,-122,9,23,32
16288,SpokaneStBridge,11/10/2015 04:00:00 PM,48,-122,19,63,82
16289,SpokaneStBridge,11/10/2015 05:00:00 PM,48,-122,12,125,137
16290,SpokaneStBridge,11/10/2015 06:00:00 PM,48,-122,13,56,69
16291,SpokaneStBridge,11/10/2015 07:00:00 PM,48,-122,4,37,41
16292,SpokaneStBridge,11/10/2015 08:00:00 PM,48,-122,7,13,20
16293,SpokaneStBridge,11/10/2015 09:00:00 PM,48,-122,1,5,6
16294,SpokaneStBridge,11/10/2015 10:00:00 PM,48,-122,2,7,9
16295,SpokaneStBridge,11/10/2015 11:00:00 PM,48,-122,1,0,1
16296,SpokaneStBridge,11/11/2015 12:00:00 AM,48,-122,0,0,0
16297,SpokaneStBridge,11/11/2015 01:00:00 AM,48,-122,0,0,0
16298,SpokaneStBridge,11/11/2015 02:00:00 AM,48,-122,0,0,0
16299,SpokaneStBridge,11/11/2015 03:00:00 AM,48,-122,0,1,1
16300,SpokaneStBridge,11/11/2015 04:00:00 AM,48,-122,3,1,4
16301,SpokaneStBridge,11/11/2015 05:00:00 AM,48,-122,8,1,9
16302,SpokaneStBridge,11/11/2015 06:00:00 AM,48,-122,30,6,36
16303,SpokaneStBridge,11/11/2015 07:00:00 AM,48,-122,81,5,86
16304,SpokaneStBridge,11/11/2015 08:00:00 AM,48,-122,107,10,117
16305,SpokaneStBridge,11/11/2015 09:00:00 AM,48,-122,32,6,38
16306,SpokaneStBridge,11/11/2015 10:00:00 AM,48,-122,17,7,24
16307,SpokaneStBridge,11/11/2015 11:00:00 AM,48,-122,8,8,16
16308,SpokaneStBridge,11/11/2015 12:00:00 PM,48,-122,13,19,32
16309,SpokaneStBridge,11/11/2015 01:00:00 PM,48,-122,11,15,26
16310,SpokaneStBridge,11/11/2015 02:00:00 PM,48,-122,24,23,47
16311,SpokaneStBridge,11/11/2015 03:00:00 PM,48,-122,23,22,45
16312,SpokaneStBridge,11/11/2015 04:00:00 PM,48,-122,14,60,74
16313,SpokaneStBridge,11/11/2015 05:00:00 PM,48,-122,14,96,110
16314,SpokaneStBridge,11/11/2015 06:00:00 PM,48,-122,13,63,76
16315,SpokaneStBridge,11/11/2015 07:00:00 PM,48,-122,9,26,35
16316,SpokaneStBridge,11/11/2015 08:00:00 PM,48,-122,3,11,14
16317,SpokaneStBridge,11/11/2015 09:00:00 PM,48,-122,1,6,7
16318,SpokaneStBridge,11/11/2015 10:00:00 PM,48,-122,1,6,7
16319,SpokaneStBridge,11/11/2015 11:00:00 PM,48,-122,3,3,6
16320,SpokaneStBridge,11/12/2015 12:00:00 AM,48,-122,2,0,2
16321,SpokaneStBridge,11/12/2015 01:00:00 AM,48,-122,3,1,4
16322,SpokaneStBridge,11/12/2015 02:00:00 AM,48,-122,0,0,0
16323,SpokaneStBridge,11/12/2015 03:00:00 AM,48,-122,1,0,1
16324,SpokaneStBridge,11/12/2015 04:00:00 AM,48,-122,2,0,2
16325,SpokaneStBridge,11/12/2015 05:00:00 AM,48,-122,12,4,16
16326,SpokaneStBridge,11/12/2015 06:00:00 AM,48,-122,46,7,53
16327,SpokaneStBridge,11/12/2015 07:00:00 AM,48,-122,108,11,119
16328,SpokaneStBridge,11/12/2015 08:00:00 AM,48,-122,88,8,96
16329,SpokaneStBridge,11/12/2015 09:00:00 AM,48,-122,37,4,41
16330,SpokaneStBridge,11/12/2015 10:00:00 AM,48,-122,13,4,17
16331,SpokaneStBridge,11/12/2015 11:00:00 AM,48,-122,6,3,9
16332,SpokaneStBridge,11/12/2015 12:00:00 PM,48,-122,6,10,16
16333,SpokaneStBridge,11/12/2015 01:00:00 PM,48,-122,5,4,9
16334,SpokaneStBridge,11/12/2015 02:00:00 PM,48,-122,8,10,18
16335,SpokaneStBridge,11/12/2015 03:00:00 PM,48,-122,5,29,34
16336,SpokaneStBridge,11/12/2015 04:00:00 PM,48,-122,9,46,55
16337,SpokaneStBridge,11/12/2015 05:00:00 PM,48,-122,11,98,109
16338,SpokaneStBridge,11/12/2015 06:00:00 PM,48,-122,9,42,51
16339,SpokaneStBridge,11/12/2015 07:00:00 PM,48,-122,3,18,21
16340,SpokaneStBridge,11/12/2015 08:00:00 PM,48,-122,1,10,11
16341,SpokaneStBridge,11/12/2015 09:00:00 PM,48,-122,1,7,8
16342,SpokaneStBridge,11/12/2015 10:00:00 PM,48,-122,2,1,3
16343,SpokaneStBridge,11/12/2015 11:00:00 PM,48,-122,0,2,2
16344,SpokaneStBridge,11/13/2015 12:00:00 AM,48,-122,1,2,3
16345,SpokaneStBridge,11/13/2015 01:00:00 AM,48,-122,0,0,0
16346,SpokaneStBridge,11/13/2015 02:00:00 AM,48,-122,1,0,1
16347,SpokaneStBridge,11/13/2015 03:00:00 AM,48,-122,1,0,1
16348,SpokaneStBridge,11/13/2015 04:00:00 AM,48,-122,2,0,2
16349,SpokaneStBridge,11/13/2015 05:00:00 AM,48,-122,5,2,7
16350,SpokaneStBridge,11/13/2015 06:00:00 AM,48,-122,18,3,21
16351,SpokaneStBridge,11/13/2015 07:00:00 AM,48,-122,38,9,47
16352,SpokaneStBridge,11/13/2015 08:00:00 AM,48,-122,52,3,55
16353,SpokaneStBridge,11/13/2015 09:00:00 AM,48,-122,21,2,23
16354,SpokaneStBridge,11/13/2015 10:00:00 AM,48,-122,6,1,7
16355,SpokaneStBridge,11/13/2015 11:00:00 AM,48,-122,4,4,8
16356,SpokaneStBridge,11/13/2015 12:00:00 PM,48,-122,3,4,7
16357,SpokaneStBridge,11/13/2015 01:00:00 PM,48,-122,3,4,7
16358,SpokaneStBridge,11/13/2015 02:00:00 PM,48,-122,2,3,5
16359,SpokaneStBridge,11/13/2015 03:00:00 PM,48,-122,2,15,17
16360,SpokaneStBridge,11/13/2015 04:00:00 PM,48,-122,9,27,36
16361,SpokaneStBridge,11/13/2015 05:00:00 PM,48,-122,5,44,49
16362,SpokaneStBridge,11/13/2015 06:00:00 PM,48,-122,4,22,26
16363,SpokaneStBridge,11/13/2015 07:00:00 PM,48,-122,0,7,7
16364,SpokaneStBridge,11/13/2015 08:00:00 PM,48,-122,3,6,9
16365,SpokaneStBridge,11/13/2015 09:00:00 PM,48,-122,0,0,0
16366,SpokaneStBridge,11/13/2015 10:00:00 PM,48,-122,1,4,5
16367,SpokaneStBridge,11/13/2015 11:00:00 PM,48,-122,0,3,3
16368,SpokaneStBridge,11/14/2015 12:00:00 AM,48,-122,1,0,1
16369,SpokaneStBridge,11/14/2015 01:00:00 AM,48,-122,0,0,0
16370,SpokaneStBridge,11/14/2015 02:00:00 AM,48,-122,0,0,0
16371,SpokaneStBridge,11/14/2015 03:00:00 AM,48,-122,1,0,1
16372,SpokaneStBridge,11/14/2015 04:00:00 AM,48,-122,1,0,1
16373,SpokaneStBridge,11/14/2015 05:00:00 AM,48,-122,5,0,5
16374,SpokaneStBridge,11/14/2015 06:00:00 AM,48,-122,1,1,2
16375,SpokaneStBridge,11/14/2015 07:00:00 AM,48,-122,4,0,4
16376,SpokaneStBridge,11/14/2015 08:00:00 AM,48,-122,8,1,9
16377,SpokaneStBridge,11/14/2015 09:00:00 AM,48,-122,2,2,4
16378,SpokaneStBridge,11/14/2015 10:00:00 AM,48,-122,1,0,1
16379,SpokaneStBridge,11/14/2015 11:00:00 AM,48,-122,1,2,3
16380,SpokaneStBridge,11/14/2015 12:00:00 PM,48,-122,4,5,9
16381,SpokaneStBridge,11/14/2015 01:00:00 PM,48,-122,4,3,7
16382,SpokaneStBridge,11/14/2015 02:00:00 PM,48,-122,3,5,8
16383,SpokaneStBridge,11/14/2015 03:00:00 PM,48,-122,1,4,5
16384,SpokaneStBridge,11/14/2015 04:00:00 PM,48,-122,1,3,4
16385,SpokaneStBridge,11/14/2015 05:00:00 PM,48,-122,1,3,4
16386,SpokaneStBridge,11/14/2015 06:00:00 PM,48,-122,1,1,2
16387,SpokaneStBridge,11/14/2015 07:00:00 PM,48,-122,2,3,5
16388,SpokaneStBridge,11/14/2015 08:00:00 PM,48,-122,2,2,4
16389,SpokaneStBridge,11/14/2015 09:00:00 PM,48,-122,0,2,2
16390,SpokaneStBridge,11/14/2015 10:00:00 PM,48,-122,0,3,3
16391,SpokaneStBridge,11/14/2015 11:00:00 PM,48,-122,1,0,1
16392,SpokaneStBridge,11/15/2015 12:00:00 AM,48,-122,1,0,1
16393,SpokaneStBridge,11/15/2015 01:00:00 AM,48,-122,0,1,1
16394,SpokaneStBridge,11/15/2015 02:00:00 AM,48,-122,0,0,0
16395,SpokaneStBridge,11/15/2015 03:00:00 AM,48,-122,0,1,1
16396,SpokaneStBridge,11/15/2015 04:00:00 AM,48,-122,2,0,2
16397,SpokaneStBridge,11/15/2015 05:00:00 AM,48,-122,1,0,1
16398,SpokaneStBridge,11/15/2015 06:00:00 AM,48,-122,1,0,1
16399,SpokaneStBridge,11/15/2015 07:00:00 AM,48,-122,2,1,3
16400,SpokaneStBridge,11/15/2015 08:00:00 AM,48,-122,7,1,8
16401,SpokaneStBridge,11/15/2015 09:00:00 AM,48,-122,4,3,7
16402,SpokaneStBridge,11/15/2015 10:00:00 AM,48,-122,3,2,5
16403,SpokaneStBridge,11/15/2015 11:00:00 AM,48,-122,5,4,9
16404,SpokaneStBridge,11/15/2015 12:00:00 PM,48,-122,12,12,24
16405,SpokaneStBridge,11/15/2015 01:00:00 PM,48,-122,10,9,19
16406,SpokaneStBridge,11/15/2015 02:00:00 PM,48,-122,18,14,32
16407,SpokaneStBridge,11/15/2015 03:00:00 PM,48,-122,18,11,29
16408,SpokaneStBridge,11/15/2015 04:00:00 PM,48,-122,7,8,15
16409,SpokaneStBridge,11/15/2015 05:00:00 PM,48,-122,4,6,10
16410,SpokaneStBridge,11/15/2015 06:00:00 PM,48,-122,0,0,0
16411,SpokaneStBridge,11/15/2015 07:00:00 PM,48,-122,3,3,6
16412,SpokaneStBridge,11/15/2015 08:00:00 PM,48,-122,0,2,2
16413,SpokaneStBridge,11/15/2015 09:00:00 PM,48,-122,1,1,2
16414,SpokaneStBridge,11/15/2015 10:00:00 PM,48,-122,0,2,2
16415,SpokaneStBridge,11/15/2015 11:00:00 PM,48,-122,1,1,2
16416,SpokaneStBridge,11/16/2015 12:00:00 AM,48,-122,0,0,0
16417,SpokaneStBridge,11/16/2015 01:00:00 AM,48,-122,0,0,0
16418,SpokaneStBridge,11/16/2015 02:00:00 AM,48,-122,0,0,0
16419,SpokaneStBridge,11/16/2015 03:00:00 AM,48,-122,1,1,2
16420,SpokaneStBridge,11/16/2015 04:00:00 AM,48,-122,4,0,4
16421,SpokaneStBridge,11/16/2015 05:00:00 AM,48,-122,14,2,16
16422,SpokaneStBridge,11/16/2015 06:00:00 AM,48,-122,44,9,53
16423,SpokaneStBridge,11/16/2015 07:00:00 AM,48,-122,88,12,100
16424,SpokaneStBridge,11/16/2015 08:00:00 AM,48,-122,110,9,119
16425,SpokaneStBridge,11/16/2015 09:00:00 AM,48,-122,31,0,31
16426,SpokaneStBridge,11/16/2015 10:00:00 AM,48,-122,11,4,15
16427,SpokaneStBridge,11/16/2015 11:00:00 AM,48,-122,7,6,13
16428,SpokaneStBridge,11/16/2015 12:00:00 PM,48,-122,4,4,8
16429,SpokaneStBridge,11/16/2015 01:00:00 PM,48,-122,4,2,6
16430,SpokaneStBridge,11/16/2015 02:00:00 PM,48,-122,6,7,13
16431,SpokaneStBridge,11/16/2015 03:00:00 PM,48,-122,3,19,22
16432,SpokaneStBridge,11/16/2015 04:00:00 PM,48,-122,10,46,56
16433,SpokaneStBridge,11/16/2015 05:00:00 PM,48,-122,10,100,110
16434,SpokaneStBridge,11/16/2015 06:00:00 PM,48,-122,5,62,67
16435,SpokaneStBridge,11/16/2015 07:00:00 PM,48,-122,2,24,26
16436,SpokaneStBridge,11/16/2015 08:00:00 PM,48,-122,2,10,12
16437,SpokaneStBridge,11/16/2015 09:00:00 PM,48,-122,0,5,5
16438,SpokaneStBridge,11/16/2015 10:00:00 PM,48,-122,1,1,2
16439,SpokaneStBridge,11/16/2015 11:00:00 PM,48,-122,0,2,2
16440,SpokaneStBridge,11/17/2015 12:00:00 AM,48,-122,1,4,5
16441,SpokaneStBridge,11/17/2015 01:00:00 AM,48,-122,0,0,0
16442,SpokaneStBridge,11/17/2015 02:00:00 AM,48,-122,0,0,0
16443,SpokaneStBridge,11/17/2015 03:00:00 AM,48,-122,1,1,2
16444,SpokaneStBridge,11/17/2015 04:00:00 AM,48,-122,1,0,1
16445,SpokaneStBridge,11/17/2015 05:00:00 AM,48,-122,14,3,17
16446,SpokaneStBridge,11/17/2015 06:00:00 AM,48,-122,28,3,31
16447,SpokaneStBridge,11/17/2015 07:00:00 AM,48,-122,48,7,55
16448,SpokaneStBridge,11/17/2015 08:00:00 AM,48,-122,63,4,67
16449,SpokaneStBridge,11/17/2015 09:00:00 AM,48,-122,22,1,23
16450,SpokaneStBridge,11/17/2015 10:00:00 AM,48,-122,6,2,8
16451,SpokaneStBridge,11/17/2015 11:00:00 AM,48,-122,1,3,4
16452,SpokaneStBridge,11/17/2015 12:00:00 PM,48,-122,1,1,2
16453,SpokaneStBridge,11/17/2015 01:00:00 PM,48,-122,4,1,5
16454,SpokaneStBridge,11/17/2015 02:00:00 PM,48,-122,6,4,10
16455,SpokaneStBridge,11/17/2015 03:00:00 PM,48,-122,0,15,15
16456,SpokaneStBridge,11/17/2015 04:00:00 PM,48,-122,10,38,48
16457,SpokaneStBridge,11/17/2015 05:00:00 PM,48,-122,7,53,60
16458,SpokaneStBridge,11/17/2015 06:00:00 PM,48,-122,4,39,43
16459,SpokaneStBridge,11/17/2015 07:00:00 PM,48,-122,6,15,21
16460,SpokaneStBridge,11/17/2015 08:00:00 PM,48,-122,3,12,15
16461,SpokaneStBridge,11/17/2015 09:00:00 PM,48,-122,0,4,4
16462,SpokaneStBridge,11/17/2015 10:00:00 PM,48,-122,0,1,1
16463,SpokaneStBridge,11/17/2015 11:00:00 PM,48,-122,0,1,1
16464,SpokaneStBridge,11/18/2015 12:00:00 AM,48,-122,1,1,2
16465,SpokaneStBridge,11/18/2015 01:00:00 AM,48,-122,1,1,2
16466,SpokaneStBridge,11/18/2015 02:00:00 AM,48,-122,1,0,1
16467,SpokaneStBridge,11/18/2015 03:00:00 AM,48,-122,0,1,1
16468,SpokaneStBridge,11/18/2015 04:00:00 AM,48,-122,3,0,3
16469,SpokaneStBridge,11/18/2015 05:00:00 AM,48,-122,16,1,17
16470,SpokaneStBridge,11/18/2015 06:00:00 AM,48,-122,44,7,51
16471,SpokaneStBridge,11/18/2015 07:00:00 AM,48,-122,102,7,109
16472,SpokaneStBridge,11/18/2015 08:00:00 AM,48,-122,110,4,114
16473,SpokaneStBridge,11/18/2015 09:00:00 AM,48,-122,31,10,41
16474,SpokaneStBridge,11/18/2015 10:00:00 AM,48,-122,14,6,20
16475,SpokaneStBridge,11/18/2015 11:00:00 AM,48,-122,10,5,15
16476,SpokaneStBridge,11/18/2015 12:00:00 PM,48,-122,4,7,11
16477,SpokaneStBridge,11/18/2015 01:00:00 PM,48,-122,10,7,17
16478,SpokaneStBridge,11/18/2015 02:00:00 PM,48,-122,6,16,22
16479,SpokaneStBridge,11/18/2015 03:00:00 PM,48,-122,9,23,32
16480,SpokaneStBridge,11/18/2015 04:00:00 PM,48,-122,10,61,71
16481,SpokaneStBridge,11/18/2015 05:00:00 PM,48,-122,12,105,117
16482,SpokaneStBridge,11/18/2015 06:00:00 PM,48,-122,7,65,72
16483,SpokaneStBridge,11/18/2015 07:00:00 PM,48,-122,8,26,34
16484,SpokaneStBridge,11/18/2015 08:00:00 PM,48,-122,2,14,16
16485,SpokaneStBridge,11/18/2015 09:00:00 PM,48,-122,0,7,7
16486,SpokaneStBridge,11/18/2015 10:00:00 PM,48,-122,0,3,3
16487,SpokaneStBridge,11/18/2015 11:00:00 PM,48,-122,3,1,4
16488,SpokaneStBridge,11/19/2015 12:00:00 AM,48,-122,1,1,2
16489,SpokaneStBridge,11/19/2015 01:00:00 AM,48,-122,0,1,1
16490,SpokaneStBridge,11/19/2015 02:00:00 AM,48,-122,1,0,1
16491,SpokaneStBridge,11/19/2015 03:00:00 AM,48,-122,1,0,1
16492,SpokaneStBridge,11/19/2015 04:00:00 AM,48,-122,2,0,2
16493,SpokaneStBridge,11/19/2015 05:00:00 AM,48,-122,19,1,20
16494,SpokaneStBridge,11/19/2015 06:00:00 AM,48,-122,49,2,51
16495,SpokaneStBridge,11/19/2015 07:00:00 AM,48,-122,100,9,109
16496,SpokaneStBridge,11/19/2015 08:00:00 AM,48,-122,99,12,111
16497,SpokaneStBridge,11/19/2015 09:00:00 AM,48,-122,48,3,51
16498,SpokaneStBridge,11/19/2015 10:00:00 AM,48,-122,12,3,15
16499,SpokaneStBridge,11/19/2015 11:00:00 AM,48,-122,8,5,13
16500,SpokaneStBridge,11/19/2015 12:00:00 PM,48,-122,11,12,23
16501,SpokaneStBridge,11/19/2015 01:00:00 PM,48,-122,11,9,20
16502,SpokaneStBridge,11/19/2015 02:00:00 PM,48,-122,10,16,26
16503,SpokaneStBridge,11/19/2015 03:00:00 PM,48,-122,15,34,49
16504,SpokaneStBridge,11/19/2015 04:00:00 PM,48,-122,18,59,77
16505,SpokaneStBridge,11/19/2015 05:00:00 PM,48,-122,14,102,116
16506,SpokaneStBridge,11/19/2015 06:00:00 PM,48,-122,10,72,82
16507,SpokaneStBridge,11/19/2015 07:00:00 PM,48,-122,4,24,28
16508,SpokaneStBridge,11/19/2015 08:00:00 PM,48,-122,2,10,12
16509,SpokaneStBridge,11/19/2015 09:00:00 PM,48,-122,2,12,14
16510,SpokaneStBridge,11/19/2015 10:00:00 PM,48,-122,0,6,6
16511,SpokaneStBridge,11/19/2015 11:00:00 PM,48,-122,0,5,5
16512,SpokaneStBridge,11/20/2015 12:00:00 AM,48,-122,4,2,6
16513,SpokaneStBridge,11/20/2015 01:00:00 AM,48,-122,0,1,1
16514,SpokaneStBridge,11/20/2015 02:00:00 AM,48,-122,2,1,3
16515,SpokaneStBridge,11/20/2015 03:00:00 AM,48,-122,0,0,0
16516,SpokaneStBridge,11/20/2015 04:00:00 AM,48,-122,2,1,3
16517,SpokaneStBridge,11/20/2015 05:00:00 AM,48,-122,9,1,10
16518,SpokaneStBridge,11/20/2015 06:00:00 AM,48,-122,40,11,51
16519,SpokaneStBridge,11/20/2015 07:00:00 AM,48,-122,56,13,69
16520,SpokaneStBridge,11/20/2015 08:00:00 AM,48,-122,78,5,83
16521,SpokaneStBridge,11/20/2015 09:00:00 AM,48,-122,29,6,35
16522,SpokaneStBridge,11/20/2015 10:00:00 AM,48,-122,10,2,12
16523,SpokaneStBridge,11/20/2015 11:00:00 AM,48,-122,14,5,19
16524,SpokaneStBridge,11/20/2015 12:00:00 PM,48,-122,11,12,23
16525,SpokaneStBridge,11/20/2015 01:00:00 PM,48,-122,12,13,25
16526,SpokaneStBridge,11/20/2015 02:00:00 PM,48,-122,7,19,26
16527,SpokaneStBridge,11/20/2015 03:00:00 PM,48,-122,8,28,36
16528,SpokaneStBridge,11/20/2015 04:00:00 PM,48,-122,16,46,62
16529,SpokaneStBridge,11/20/2015 05:00:00 PM,48,-122,12,73,85
16530,SpokaneStBridge,11/20/2015 06:00:00 PM,48,-122,7,40,47
16531,SpokaneStBridge,11/20/2015 07:00:00 PM,48,-122,5,21,26
16532,SpokaneStBridge,11/20/2015 08:00:00 PM,48,-122,3,8,11
16533,SpokaneStBridge,11/20/2015 09:00:00 PM,48,-122,4,6,10
16534,SpokaneStBridge,11/20/2015 10:00:00 PM,48,-122,0,3,3
16535,SpokaneStBridge,11/20/2015 11:00:00 PM,48,-122,0,2,2
16536,SpokaneStBridge,11/21/2015 12:00:00 AM,48,-122,0,0,0
16537,SpokaneStBridge,11/21/2015 01:00:00 AM,48,-122,1,0,1
16538,SpokaneStBridge,11/21/2015 02:00:00 AM,48,-122,1,1,2
16539,SpokaneStBridge,11/21/2015 03:00:00 AM,48,-122,1,0,1
16540,SpokaneStBridge,11/21/2015 04:00:00 AM,48,-122,0,2,2
16541,SpokaneStBridge,11/21/2015 05:00:00 AM,48,-122,7,0,7
16542,SpokaneStBridge,11/21/2015 06:00:00 AM,48,-122,6,1,7
16543,SpokaneStBridge,11/21/2015 07:00:00 AM,48,-122,10,3,13
16544,SpokaneStBridge,11/21/2015 08:00:00 AM,48,-122,10,2,12
16545,SpokaneStBridge,11/21/2015 09:00:00 AM,48,-122,8,6,14
16546,SpokaneStBridge,11/21/2015 10:00:00 AM,48,-122,15,12,27
16547,SpokaneStBridge,11/21/2015 11:00:00 AM,48,-122,19,12,31
16548,SpokaneStBridge,11/21/2015 12:00:00 PM,48,-122,15,24,39
16549,SpokaneStBridge,11/21/2015 01:00:00 PM,48,-122,17,21,38
16550,SpokaneStBridge,11/21/2015 02:00:00 PM,48,-122,22,22,44
16551,SpokaneStBridge,11/21/2015 03:00:00 PM,48,-122,17,20,37
16552,SpokaneStBridge,11/21/2015 04:00:00 PM,48,-122,15,18,33
16553,SpokaneStBridge,11/21/2015 05:00:00 PM,48,-122,7,10,17
16554,SpokaneStBridge,11/21/2015 06:00:00 PM,48,-122,4,7,11
16555,SpokaneStBridge,11/21/2015 07:00:00 PM,48,-122,5,5,10
16556,SpokaneStBridge,11/21/2015 08:00:00 PM,48,-122,1,3,4
16557,SpokaneStBridge,11/21/2015 09:00:00 PM,48,-122,1,1,2
16558,SpokaneStBridge,11/21/2015 10:00:00 PM,48,-122,1,1,2
16559,SpokaneStBridge,11/21/2015 11:00:00 PM,48,-122,0,1,1
16560,SpokaneStBridge,11/22/2015 12:00:00 AM,48,-122,0,2,2
16561,SpokaneStBridge,11/22/2015 01:00:00 AM,48,-122,1,2,3
16562,SpokaneStBridge,11/22/2015 02:00:00 AM,48,-122,1,0,1
16563,SpokaneStBridge,11/22/2015 03:00:00 AM,48,-122,0,1,1
16564,SpokaneStBridge,11/22/2015 04:00:00 AM,48,-122,0,1,1
16565,SpokaneStBridge,11/22/2015 05:00:00 AM,48,-122,3,0,3
16566,SpokaneStBridge,11/22/2015 06:00:00 AM,48,-122,1,3,4
16567,SpokaneStBridge,11/22/2015 07:00:00 AM,48,-122,3,0,3
16568,SpokaneStBridge,11/22/2015 08:00:00 AM,48,-122,11,4,15
16569,SpokaneStBridge,11/22/2015 09:00:00 AM,48,-122,14,2,16
16570,SpokaneStBridge,11/22/2015 10:00:00 AM,48,-122,16,3,19
16571,SpokaneStBridge,11/22/2015 11:00:00 AM,48,-122,12,20,32
16572,SpokaneStBridge,11/22/2015 12:00:00 PM,48,-122,17,25,42
16573,SpokaneStBridge,11/22/2015 01:00:00 PM,48,-122,14,16,30
16574,SpokaneStBridge,11/22/2015 02:00:00 PM,48,-122,19,16,35
16575,SpokaneStBridge,11/22/2015 03:00:00 PM,48,-122,17,20,37
16576,SpokaneStBridge,11/22/2015 04:00:00 PM,48,-122,9,10,19
16577,SpokaneStBridge,11/22/2015 05:00:00 PM,48,-122,1,9,10
16578,SpokaneStBridge,11/22/2015 06:00:00 PM,48,-122,1,4,5
16579,SpokaneStBridge,11/22/2015 07:00:00 PM,48,-122,3,2,5
16580,SpokaneStBridge,11/22/2015 08:00:00 PM,48,-122,0,4,4
16581,SpokaneStBridge,11/22/2015 09:00:00 PM,48,-122,0,2,2
16582,SpokaneStBridge,11/22/2015 10:00:00 PM,48,-122,0,1,1
16583,SpokaneStBridge,11/22/2015 11:00:00 PM,48,-122,0,1,1
16584,SpokaneStBridge,11/23/2015 12:00:00 AM,48,-122,0,0,0
16585,SpokaneStBridge,11/23/2015 01:00:00 AM,48,-122,1,0,1
16586,SpokaneStBridge,11/23/2015 02:00:00 AM,48,-122,2,1,3
16587,SpokaneStBridge,11/23/2015 03:00:00 AM,48,-122,0,1,1
16588,SpokaneStBridge,11/23/2015 04:00:00 AM,48,-122,4,0,4
16589,SpokaneStBridge,11/23/2015 05:00:00 AM,48,-122,11,2,13
16590,SpokaneStBridge,11/23/2015 06:00:00 AM,48,-122,31,6,37
16591,SpokaneStBridge,11/23/2015 07:00:00 AM,48,-122,77,12,89
16592,SpokaneStBridge,11/23/2015 08:00:00 AM,48,-122,89,7,96
16593,SpokaneStBridge,11/23/2015 09:00:00 AM,48,-122,29,3,32
16594,SpokaneStBridge,11/23/2015 10:00:00 AM,48,-122,11,2,13
16595,SpokaneStBridge,11/23/2015 11:00:00 AM,48,-122,8,3,11
16596,SpokaneStBridge,11/23/2015 12:00:00 PM,48,-122,9,9,18
16597,SpokaneStBridge,11/23/2015 01:00:00 PM,48,-122,9,7,16
16598,SpokaneStBridge,11/23/2015 02:00:00 PM,48,-122,9,8,17
16599,SpokaneStBridge,11/23/2015 03:00:00 PM,48,-122,7,20,27
16600,SpokaneStBridge,11/23/2015 04:00:00 PM,48,-122,9,47,56
16601,SpokaneStBridge,11/23/2015 05:00:00 PM,48,-122,9,70,79
16602,SpokaneStBridge,11/23/2015 06:00:00 PM,48,-122,3,56,59
16603,SpokaneStBridge,11/23/2015 07:00:00 PM,48,-122,3,17,20
16604,SpokaneStBridge,11/23/2015 08:00:00 PM,48,-122,4,16,20
16605,SpokaneStBridge,11/23/2015 09:00:00 PM,48,-122,1,5,6
16606,SpokaneStBridge,11/23/2015 10:00:00 PM,48,-122,1,0,1
16607,SpokaneStBridge,11/23/2015 11:00:00 PM,48,-122,1,0,1
16608,SpokaneStBridge,11/24/2015 12:00:00 AM,48,-122,0,1,1
16609,SpokaneStBridge,11/24/2015 01:00:00 AM,48,-122,0,0,0
16610,SpokaneStBridge,11/24/2015 02:00:00 AM,48,-122,1,0,1
16611,SpokaneStBridge,11/24/2015 03:00:00 AM,48,-122,0,1,1
16612,SpokaneStBridge,11/24/2015 04:00:00 AM,48,-122,1,0,1
16613,SpokaneStBridge,11/24/2015 05:00:00 AM,48,-122,8,1,9
16614,SpokaneStBridge,11/24/2015 06:00:00 AM,48,-122,29,4,33
16615,SpokaneStBridge,11/24/2015 07:00:00 AM,48,-122,55,7,62
16616,SpokaneStBridge,11/24/2015 08:00:00 AM,48,-122,61,6,67
16617,SpokaneStBridge,11/24/2015 09:00:00 AM,48,-122,23,3,26
16618,SpokaneStBridge,11/24/2015 10:00:00 AM,48,-122,9,0,9
16619,SpokaneStBridge,11/24/2015 11:00:00 AM,48,-122,6,2,8
16620,SpokaneStBridge,11/24/2015 12:00:00 PM,48,-122,4,6,10
16621,SpokaneStBridge,11/24/2015 01:00:00 PM,48,-122,2,5,7
16622,SpokaneStBridge,11/24/2015 02:00:00 PM,48,-122,4,8,12
16623,SpokaneStBridge,11/24/2015 03:00:00 PM,48,-122,5,14,19
16624,SpokaneStBridge,11/24/2015 04:00:00 PM,48,-122,12,31,43
16625,SpokaneStBridge,11/24/2015 05:00:00 PM,48,-122,5,72,77
16626,SpokaneStBridge,11/24/2015 06:00:00 PM,48,-122,10,42,52
16627,SpokaneStBridge,11/24/2015 07:00:00 PM,48,-122,4,14,18
16628,SpokaneStBridge,11/24/2015 08:00:00 PM,48,-122,2,8,10
16629,SpokaneStBridge,11/24/2015 09:00:00 PM,48,-122,2,2,4
16630,SpokaneStBridge,11/24/2015 10:00:00 PM,48,-122,0,4,4
16631,SpokaneStBridge,11/24/2015 11:00:00 PM,48,-122,1,2,3
16632,SpokaneStBridge,11/25/2015 12:00:00 AM,48,-122,0,1,1
16633,SpokaneStBridge,11/25/2015 01:00:00 AM,48,-122,0,0,0
16634,SpokaneStBridge,11/25/2015 02:00:00 AM,48,-122,1,0,1
16635,SpokaneStBridge,11/25/2015 03:00:00 AM,48,-122,0,1,1
16636,SpokaneStBridge,11/25/2015 04:00:00 AM,48,-122,1,0,1
16637,SpokaneStBridge,11/25/2015 05:00:00 AM,48,-122,12,1,13
16638,SpokaneStBridge,11/25/2015 06:00:00 AM,48,-122,23,8,31
16639,SpokaneStBridge,11/25/2015 07:00:00 AM,48,-122,38,9,47
16640,SpokaneStBridge,11/25/2015 08:00:00 AM,48,-122,71,7,78
16641,SpokaneStBridge,11/25/2015 09:00:00 AM,48,-122,29,2,31
16642,SpokaneStBridge,11/25/2015 10:00:00 AM,48,-122,12,3,15
16643,SpokaneStBridge,11/25/2015 11:00:00 AM,48,-122,9,7,16
16644,SpokaneStBridge,11/25/2015 12:00:00 PM,48,-122,8,8,16
16645,SpokaneStBridge,11/25/2015 01:00:00 PM,48,-122,9,9,18
16646,SpokaneStBridge,11/25/2015 02:00:00 PM,48,-122,7,27,34
16647,SpokaneStBridge,11/25/2015 03:00:00 PM,48,-122,10,38,48
16648,SpokaneStBridge,11/25/2015 04:00:00 PM,48,-122,13,42,55
16649,SpokaneStBridge,11/25/2015 05:00:00 PM,48,-122,8,44,52
16650,SpokaneStBridge,11/25/2015 06:00:00 PM,48,-122,11,16,27
16651,SpokaneStBridge,11/25/2015 07:00:00 PM,48,-122,5,24,29
16652,SpokaneStBridge,11/25/2015 08:00:00 PM,48,-122,9,8,17
16653,SpokaneStBridge,11/25/2015 09:00:00 PM,48,-122,1,3,4
16654,SpokaneStBridge,11/25/2015 10:00:00 PM,48,-122,0,1,1
16655,SpokaneStBridge,11/25/2015 11:00:00 PM,48,-122,2,1,3
16656,SpokaneStBridge,11/26/2015 12:00:00 AM,48,-122,0,1,1
16657,SpokaneStBridge,11/26/2015 01:00:00 AM,48,-122,1,1,2
16658,SpokaneStBridge,11/26/2015 02:00:00 AM,48,-122,0,0,0
16659,SpokaneStBridge,11/26/2015 03:00:00 AM,48,-122,0,0,0
16660,SpokaneStBridge,11/26/2015 04:00:00 AM,48,-122,0,0,0
16661,SpokaneStBridge,11/26/2015 05:00:00 AM,48,-122,1,1,2
16662,SpokaneStBridge,11/26/2015 06:00:00 AM,48,-122,0,0,0
16663,SpokaneStBridge,11/26/2015 07:00:00 AM,48,-122,5,1,6
16664,SpokaneStBridge,11/26/2015 08:00:00 AM,48,-122,7,2,9
16665,SpokaneStBridge,11/26/2015 09:00:00 AM,48,-122,9,9,18
16666,SpokaneStBridge,11/26/2015 10:00:00 AM,48,-122,5,9,14
16667,SpokaneStBridge,11/26/2015 11:00:00 AM,48,-122,9,8,17
16668,SpokaneStBridge,11/26/2015 12:00:00 PM,48,-122,14,11,25
16669,SpokaneStBridge,11/26/2015 01:00:00 PM,48,-122,24,15,39
16670,SpokaneStBridge,11/26/2015 02:00:00 PM,48,-122,13,9,22
16671,SpokaneStBridge,11/26/2015 03:00:00 PM,48,-122,6,8,14
16672,SpokaneStBridge,11/26/2015 04:00:00 PM,48,-122,1,6,7
16673,SpokaneStBridge,11/26/2015 05:00:00 PM,48,-122,1,2,3
16674,SpokaneStBridge,11/26/2015 06:00:00 PM,48,-122,5,0,5
16675,SpokaneStBridge,11/26/2015 07:00:00 PM,48,-122,4,3,7
16676,SpokaneStBridge,11/26/2015 08:00:00 PM,48,-122,0,0,0
16677,SpokaneStBridge,11/26/2015 09:00:00 PM,48,-122,3,2,5
16678,SpokaneStBridge,11/26/2015 10:00:00 PM,48,-122,1,0,1
16679,SpokaneStBridge,11/26/2015 11:00:00 PM,48,-122,0,6,6
16680,SpokaneStBridge,11/27/2015 12:00:00 AM,48,-122,3,2,5
16681,SpokaneStBridge,11/27/2015 01:00:00 AM,48,-122,0,0,0
16682,SpokaneStBridge,11/27/2015 02:00:00 AM,48,-122,3,1,4
16683,SpokaneStBridge,11/27/2015 03:00:00 AM,48,-122,0,0,0
16684,SpokaneStBridge,11/27/2015 04:00:00 AM,48,-122,0,0,0
16685,SpokaneStBridge,11/27/2015 05:00:00 AM,48,-122,3,0,3
16686,SpokaneStBridge,11/27/2015 06:00:00 AM,48,-122,4,1,5
16687,SpokaneStBridge,11/27/2015 07:00:00 AM,48,-122,5,2,7
16688,SpokaneStBridge,11/27/2015 08:00:00 AM,48,-122,8,2,10
16689,SpokaneStBridge,11/27/2015 09:00:00 AM,48,-122,7,2,9
16690,SpokaneStBridge,11/27/2015 10:00:00 AM,48,-122,8,11,19
16691,SpokaneStBridge,11/27/2015 11:00:00 AM,48,-122,26,10,36
16692,SpokaneStBridge,11/27/2015 12:00:00 PM,48,-122,13,29,42
16693,SpokaneStBridge,11/27/2015 01:00:00 PM,48,-122,37,17,54
16694,SpokaneStBridge,11/27/2015 02:00:00 PM,48,-122,7,12,19
16695,SpokaneStBridge,11/27/2015 03:00:00 PM,48,-122,11,21,32
16696,SpokaneStBridge,11/27/2015 04:00:00 PM,48,-122,8,13,21
16697,SpokaneStBridge,11/27/2015 05:00:00 PM,48,-122,5,13,18
16698,SpokaneStBridge,11/27/2015 06:00:00 PM,48,-122,4,2,6
16699,SpokaneStBridge,11/27/2015 07:00:00 PM,48,-122,2,1,3
16700,SpokaneStBridge,11/27/2015 08:00:00 PM,48,-122,0,2,2
16701,SpokaneStBridge,11/27/2015 09:00:00 PM,48,-122,0,2,2
16702,SpokaneStBridge,11/27/2015 10:00:00 PM,48,-122,0,0,0
16703,SpokaneStBridge,11/27/2015 11:00:00 PM,48,-122,0,0,0
16704,SpokaneStBridge,11/28/2015 12:00:00 AM,48,-122,2,1,3
16705,SpokaneStBridge,11/28/2015 01:00:00 AM,48,-122,0,0,0
16706,SpokaneStBridge,11/28/2015 02:00:00 AM,48,-122,0,0,0
16707,SpokaneStBridge,11/28/2015 03:00:00 AM,48,-122,2,0,2
16708,SpokaneStBridge,11/28/2015 04:00:00 AM,48,-122,0,1,1
16709,SpokaneStBridge,11/28/2015 05:00:00 AM,48,-122,4,0,4
16710,SpokaneStBridge,11/28/2015 06:00:00 AM,48,-122,1,0,1
16711,SpokaneStBridge,11/28/2015 07:00:00 AM,48,-122,3,1,4
16712,SpokaneStBridge,11/28/2015 08:00:00 AM,48,-122,5,2,7
16713,SpokaneStBridge,11/28/2015 09:00:00 AM,48,-122,5,3,8
16714,SpokaneStBridge,11/28/2015 10:00:00 AM,48,-122,4,9,13
16715,SpokaneStBridge,11/28/2015 11:00:00 AM,48,-122,3,9,12
16716,SpokaneStBridge,11/28/2015 12:00:00 PM,48,-122,14,10,24
16717,SpokaneStBridge,11/28/2015 01:00:00 PM,48,-122,9,9,18
16718,SpokaneStBridge,11/28/2015 02:00:00 PM,48,-122,13,18,31
16719,SpokaneStBridge,11/28/2015 03:00:00 PM,48,-122,9,14,23
16720,SpokaneStBridge,11/28/2015 04:00:00 PM,48,-122,9,5,14
16721,SpokaneStBridge,11/28/2015 05:00:00 PM,48,-122,1,3,4
16722,SpokaneStBridge,11/28/2015 06:00:00 PM,48,-122,3,5,8
16723,SpokaneStBridge,11/28/2015 07:00:00 PM,48,-122,3,4,7
16724,SpokaneStBridge,11/28/2015 08:00:00 PM,48,-122,1,1,2
16725,SpokaneStBridge,11/28/2015 09:00:00 PM,48,-122,0,2,2
16726,SpokaneStBridge,11/28/2015 10:00:00 PM,48,-122,2,2,4
16727,SpokaneStBridge,11/28/2015 11:00:00 PM,48,-122,1,1,2
16728,SpokaneStBridge,11/29/2015 12:00:00 AM,48,-122,1,1,2
16729,SpokaneStBridge,11/29/2015 01:00:00 AM,48,-122,0,1,1
16730,SpokaneStBridge,11/29/2015 02:00:00 AM,48,-122,0,1,1
16731,SpokaneStBridge,11/29/2015 03:00:00 AM,48,-122,1,2,3
16732,SpokaneStBridge,11/29/2015 04:00:00 AM,48,-122,0,1,1
16733,SpokaneStBridge,11/29/2015 05:00:00 AM,48,-122,2,0,2
16734,SpokaneStBridge,11/29/2015 06:00:00 AM,48,-122,0,0,0
16735,SpokaneStBridge,11/29/2015 07:00:00 AM,48,-122,1,1,2
16736,SpokaneStBridge,11/29/2015 08:00:00 AM,48,-122,6,1,7
16737,SpokaneStBridge,11/29/2015 09:00:00 AM,48,-122,7,4,11
16738,SpokaneStBridge,11/29/2015 10:00:00 AM,48,-122,12,7,19
16739,SpokaneStBridge,11/29/2015 11:00:00 AM,48,-122,31,10,41
16740,SpokaneStBridge,11/29/2015 12:00:00 PM,48,-122,3,10,13
16741,SpokaneStBridge,11/29/2015 01:00:00 PM,48,-122,6,8,14
16742,SpokaneStBridge,11/29/2015 02:00:00 PM,48,-122,5,11,16
16743,SpokaneStBridge,11/29/2015 03:00:00 PM,48,-122,6,4,10
16744,SpokaneStBridge,11/29/2015 04:00:00 PM,48,-122,5,9,14
16745,SpokaneStBridge,11/29/2015 05:00:00 PM,48,-122,1,8,9
16746,SpokaneStBridge,11/29/2015 06:00:00 PM,48,-122,0,2,2
16747,SpokaneStBridge,11/29/2015 07:00:00 PM,48,-122,1,3,4
16748,SpokaneStBridge,11/29/2015 08:00:00 PM,48,-122,0,0,0
16749,SpokaneStBridge,11/29/2015 09:00:00 PM,48,-122,0,0,0
16750,SpokaneStBridge,11/29/2015 10:00:00 PM,48,-122,2,0,2
16751,SpokaneStBridge,11/29/2015 11:00:00 PM,48,-122,2,1,3
16752,SpokaneStBridge,11/30/2015 12:00:00 AM,48,-122,1,1,2
16753,SpokaneStBridge,11/30/2015 01:00:00 AM,48,-122,0,0,0
16754,SpokaneStBridge,11/30/2015 02:00:00 AM,48,-122,1,1,2
16755,SpokaneStBridge,11/30/2015 03:00:00 AM,48,-122,1,1,2
16756,SpokaneStBridge,11/30/2015 04:00:00 AM,48,-122,2,1,3
16757,SpokaneStBridge,11/30/2015 05:00:00 AM,48,-122,15,2,17
16758,SpokaneStBridge,11/30/2015 06:00:00 AM,48,-122,36,4,40
16759,SpokaneStBridge,11/30/2015 07:00:00 AM,48,-122,65,12,77
16760,SpokaneStBridge,11/30/2015 08:00:00 AM,48,-122,76,3,79
16761,SpokaneStBridge,11/30/2015 09:00:00 AM,48,-122,21,1,22
16762,SpokaneStBridge,11/30/2015 10:00:00 AM,48,-122,11,1,12
16763,SpokaneStBridge,11/30/2015 11:00:00 AM,48,-122,7,3,10
16764,SpokaneStBridge,11/30/2015 12:00:00 PM,48,-122,10,8,18
16765,SpokaneStBridge,11/30/2015 01:00:00 PM,48,-122,7,2,9
16766,SpokaneStBridge,11/30/2015 02:00:00 PM,48,-122,7,15,22
16767,SpokaneStBridge,11/30/2015 03:00:00 PM,48,-122,8,16,24
16768,SpokaneStBridge,11/30/2015 04:00:00 PM,48,-122,9,38,47
16769,SpokaneStBridge,11/30/2015 05:00:00 PM,48,-122,11,70,81
16770,SpokaneStBridge,11/30/2015 06:00:00 PM,48,-122,3,36,39
16771,SpokaneStBridge,11/30/2015 07:00:00 PM,48,-122,1,25,26
16772,SpokaneStBridge,11/30/2015 08:00:00 PM,48,-122,3,7,10
16773,SpokaneStBridge,11/30/2015 09:00:00 PM,48,-122,3,1,4
16774,SpokaneStBridge,11/30/2015 10:00:00 PM,48,-122,0,1,1
16775,SpokaneStBridge,11/30/2015 11:00:00 PM,48,-122,0,3,3
16776,SpokaneStBridge,12/01/2015 12:00:00 AM,48,-122,0,0,0
16777,SpokaneStBridge,12/01/2015 01:00:00 AM,48,-122,0,1,1
16778,SpokaneStBridge,12/01/2015 02:00:00 AM,48,-122,1,1,2
16779,SpokaneStBridge,12/01/2015 03:00:00 AM,48,-122,1,1,2
16780,SpokaneStBridge,12/01/2015 04:00:00 AM,48,-122,1,0,1
16781,SpokaneStBridge,12/01/2015 05:00:00 AM,48,-122,16,1,17
16782,SpokaneStBridge,12/01/2015 06:00:00 AM,48,-122,39,8,47
16783,SpokaneStBridge,12/01/2015 07:00:00 AM,48,-122,87,8,95
16784,SpokaneStBridge,12/01/2015 08:00:00 AM,48,-122,86,4,90
16785,SpokaneStBridge,12/01/2015 09:00:00 AM,48,-122,41,1,42
16786,SpokaneStBridge,12/01/2015 10:00:00 AM,48,-122,11,6,17
16787,SpokaneStBridge,12/01/2015 11:00:00 AM,48,-122,5,7,12
16788,SpokaneStBridge,12/01/2015 12:00:00 PM,48,-122,4,5,9
16789,SpokaneStBridge,12/01/2015 01:00:00 PM,48,-122,8,6,14
16790,SpokaneStBridge,12/01/2015 02:00:00 PM,48,-122,6,16,22
16791,SpokaneStBridge,12/01/2015 03:00:00 PM,48,-122,9,27,36
16792,SpokaneStBridge,12/01/2015 04:00:00 PM,48,-122,14,44,58
16793,SpokaneStBridge,12/01/2015 05:00:00 PM,48,-122,10,94,104
16794,SpokaneStBridge,12/01/2015 06:00:00 PM,48,-122,11,49,60
16795,SpokaneStBridge,12/01/2015 07:00:00 PM,48,-122,5,19,24
16796,SpokaneStBridge,12/01/2015 08:00:00 PM,48,-122,2,3,5
16797,SpokaneStBridge,12/01/2015 09:00:00 PM,48,-122,0,4,4
16798,SpokaneStBridge,12/01/2015 10:00:00 PM,48,-122,0,1,1
16799,SpokaneStBridge,12/01/2015 11:00:00 PM,48,-122,0,1,1
16800,SpokaneStBridge,12/02/2015 12:00:00 AM,48,-122,1,1,2
16801,SpokaneStBridge,12/02/2015 01:00:00 AM,48,-122,0,0,0
16802,SpokaneStBridge,12/02/2015 02:00:00 AM,48,-122,1,0,1
16803,SpokaneStBridge,12/02/2015 03:00:00 AM,48,-122,1,1,2
16804,SpokaneStBridge,12/02/2015 04:00:00 AM,48,-122,3,0,3
16805,SpokaneStBridge,12/02/2015 05:00:00 AM,48,-122,10,1,11
16806,SpokaneStBridge,12/02/2015 06:00:00 AM,48,-122,39,7,46
16807,SpokaneStBridge,12/02/2015 07:00:00 AM,48,-122,79,6,85
16808,SpokaneStBridge,12/02/2015 08:00:00 AM,48,-122,83,5,88
16809,SpokaneStBridge,12/02/2015 09:00:00 AM,48,-122,36,6,42
16810,SpokaneStBridge,12/02/2015 10:00:00 AM,48,-122,9,2,11
16811,SpokaneStBridge,12/02/2015 11:00:00 AM,48,-122,8,3,11
16812,SpokaneStBridge,12/02/2015 12:00:00 PM,48,-122,4,3,7
16813,SpokaneStBridge,12/02/2015 01:00:00 PM,48,-122,6,13,19
16814,SpokaneStBridge,12/02/2015 02:00:00 PM,48,-122,9,13,22
16815,SpokaneStBridge,12/02/2015 03:00:00 PM,48,-122,12,22,34
16816,SpokaneStBridge,12/02/2015 04:00:00 PM,48,-122,9,54,63
16817,SpokaneStBridge,12/02/2015 05:00:00 PM,48,-122,6,81,87
16818,SpokaneStBridge,12/02/2015 06:00:00 PM,48,-122,12,55,67
16819,SpokaneStBridge,12/02/2015 07:00:00 PM,48,-122,4,18,22
16820,SpokaneStBridge,12/02/2015 08:00:00 PM,48,-122,4,8,12
16821,SpokaneStBridge,12/02/2015 09:00:00 PM,48,-122,3,5,8
16822,SpokaneStBridge,12/02/2015 10:00:00 PM,48,-122,2,1,3
16823,SpokaneStBridge,12/02/2015 11:00:00 PM,48,-122,1,2,3
16824,SpokaneStBridge,12/03/2015 12:00:00 AM,48,-122,0,0,0
16825,SpokaneStBridge,12/03/2015 01:00:00 AM,48,-122,0,0,0
16826,SpokaneStBridge,12/03/2015 02:00:00 AM,48,-122,1,0,1
16827,SpokaneStBridge,12/03/2015 03:00:00 AM,48,-122,0,0,0
16828,SpokaneStBridge,12/03/2015 04:00:00 AM,48,-122,3,0,3
16829,SpokaneStBridge,12/03/2015 05:00:00 AM,48,-122,6,2,8
16830,SpokaneStBridge,12/03/2015 06:00:00 AM,48,-122,31,3,34
16831,SpokaneStBridge,12/03/2015 07:00:00 AM,48,-122,57,8,65
16832,SpokaneStBridge,12/03/2015 08:00:00 AM,48,-122,59,4,63
16833,SpokaneStBridge,12/03/2015 09:00:00 AM,48,-122,38,4,42
16834,SpokaneStBridge,12/03/2015 10:00:00 AM,48,-122,9,0,9
16835,SpokaneStBridge,12/03/2015 11:00:00 AM,48,-122,3,3,6
16836,SpokaneStBridge,12/03/2015 12:00:00 PM,48,-122,4,3,7
16837,SpokaneStBridge,12/03/2015 01:00:00 PM,48,-122,6,6,12
16838,SpokaneStBridge,12/03/2015 02:00:00 PM,48,-122,2,5,7
16839,SpokaneStBridge,12/03/2015 03:00:00 PM,48,-122,6,19,25
16840,SpokaneStBridge,12/03/2015 04:00:00 PM,48,-122,6,21,27
16841,SpokaneStBridge,12/03/2015 05:00:00 PM,48,-122,5,56,61
16842,SpokaneStBridge,12/03/2015 06:00:00 PM,48,-122,10,39,49
16843,SpokaneStBridge,12/03/2015 07:00:00 PM,48,-122,2,16,18
16844,SpokaneStBridge,12/03/2015 08:00:00 PM,48,-122,1,7,8
16845,SpokaneStBridge,12/03/2015 09:00:00 PM,48,-122,1,7,8
16846,SpokaneStBridge,12/03/2015 10:00:00 PM,48,-122,1,2,3
16847,SpokaneStBridge,12/03/2015 11:00:00 PM,48,-122,1,3,4
16848,SpokaneStBridge,12/04/2015 12:00:00 AM,48,-122,2,4,6
16849,SpokaneStBridge,12/04/2015 01:00:00 AM,48,-122,2,0,2
16850,SpokaneStBridge,12/04/2015 02:00:00 AM,48,-122,1,1,2
16851,SpokaneStBridge,12/04/2015 03:00:00 AM,48,-122,1,0,1
16852,SpokaneStBridge,12/04/2015 04:00:00 AM,48,-122,2,1,3
16853,SpokaneStBridge,12/04/2015 05:00:00 AM,48,-122,5,1,6
16854,SpokaneStBridge,12/04/2015 06:00:00 AM,48,-122,29,6,35
16855,SpokaneStBridge,12/04/2015 07:00:00 AM,48,-122,57,10,67
16856,SpokaneStBridge,12/04/2015 08:00:00 AM,48,-122,68,6,74
16857,SpokaneStBridge,12/04/2015 09:00:00 AM,48,-122,31,2,33
16858,SpokaneStBridge,12/04/2015 10:00:00 AM,48,-122,11,5,16
16859,SpokaneStBridge,12/04/2015 11:00:00 AM,48,-122,7,1,8
16860,SpokaneStBridge,12/04/2015 12:00:00 PM,48,-122,5,2,7
16861,SpokaneStBridge,12/04/2015 01:00:00 PM,48,-122,6,13,19
16862,SpokaneStBridge,12/04/2015 02:00:00 PM,48,-122,12,12,24
16863,SpokaneStBridge,12/04/2015 03:00:00 PM,48,-122,13,22,35
16864,SpokaneStBridge,12/04/2015 04:00:00 PM,48,-122,10,40,50
16865,SpokaneStBridge,12/04/2015 05:00:00 PM,48,-122,15,64,79
16866,SpokaneStBridge,12/04/2015 06:00:00 PM,48,-122,4,36,40
16867,SpokaneStBridge,12/04/2015 07:00:00 PM,48,-122,3,12,15
16868,SpokaneStBridge,12/04/2015 08:00:00 PM,48,-122,3,6,9
16869,SpokaneStBridge,12/04/2015 09:00:00 PM,48,-122,0,2,2
16870,SpokaneStBridge,12/04/2015 10:00:00 PM,48,-122,3,2,5
16871,SpokaneStBridge,12/04/2015 11:00:00 PM,48,-122,0,3,3
16872,SpokaneStBridge,12/05/2015 12:00:00 AM,48,-122,1,6,7
16873,SpokaneStBridge,12/05/2015 01:00:00 AM,48,-122,0,5,5
16874,SpokaneStBridge,12/05/2015 02:00:00 AM,48,-122,1,1,2
16875,SpokaneStBridge,12/05/2015 03:00:00 AM,48,-122,0,2,2
16876,SpokaneStBridge,12/05/2015 04:00:00 AM,48,-122,1,1,2
16877,SpokaneStBridge,12/05/2015 05:00:00 AM,48,-122,5,0,5
16878,SpokaneStBridge,12/05/2015 06:00:00 AM,48,-122,2,1,3
16879,SpokaneStBridge,12/05/2015 07:00:00 AM,48,-122,3,0,3
16880,SpokaneStBridge,12/05/2015 08:00:00 AM,48,-122,6,0,6
16881,SpokaneStBridge,12/05/2015 09:00:00 AM,48,-122,2,3,5
16882,SpokaneStBridge,12/05/2015 10:00:00 AM,48,-122,3,2,5
16883,SpokaneStBridge,12/05/2015 11:00:00 AM,48,-122,1,1,2
16884,SpokaneStBridge,12/05/2015 12:00:00 PM,48,-122,4,5,9
16885,SpokaneStBridge,12/05/2015 01:00:00 PM,48,-122,1,5,6
16886,SpokaneStBridge,12/05/2015 02:00:00 PM,48,-122,5,6,11
16887,SpokaneStBridge,12/05/2015 03:00:00 PM,48,-122,1,3,4
16888,SpokaneStBridge,12/05/2015 04:00:00 PM,48,-122,1,2,3
16889,SpokaneStBridge,12/05/2015 05:00:00 PM,48,-122,0,1,1
16890,SpokaneStBridge,12/05/2015 06:00:00 PM,48,-122,3,1,4
16891,SpokaneStBridge,12/05/2015 07:00:00 PM,48,-122,3,1,4
16892,SpokaneStBridge,12/05/2015 08:00:00 PM,48,-122,1,2,3
16893,SpokaneStBridge,12/05/2015 09:00:00 PM,48,-122,0,1,1
16894,SpokaneStBridge,12/05/2015 10:00:00 PM,48,-122,0,0,0
16895,SpokaneStBridge,12/05/2015 11:00:00 PM,48,-122,0,1,1
16896,SpokaneStBridge,12/06/2015 12:00:00 AM,48,-122,0,1,1
16897,SpokaneStBridge,12/06/2015 01:00:00 AM,48,-122,0,1,1
16898,SpokaneStBridge,12/06/2015 02:00:00 AM,48,-122,1,1,2
16899,SpokaneStBridge,12/06/2015 03:00:00 AM,48,-122,0,1,1
16900,SpokaneStBridge,12/06/2015 04:00:00 AM,48,-122,0,0,0
16901,SpokaneStBridge,12/06/2015 05:00:00 AM,48,-122,2,0,2
16902,SpokaneStBridge,12/06/2015 06:00:00 AM,48,-122,2,1,3
16903,SpokaneStBridge,12/06/2015 07:00:00 AM,48,-122,0,1,1
16904,SpokaneStBridge,12/06/2015 08:00:00 AM,48,-122,3,0,3
16905,SpokaneStBridge,12/06/2015 09:00:00 AM,48,-122,2,2,4
16906,SpokaneStBridge,12/06/2015 10:00:00 AM,48,-122,3,4,7
16907,SpokaneStBridge,12/06/2015 11:00:00 AM,48,-122,3,4,7
16908,SpokaneStBridge,12/06/2015 12:00:00 PM,48,-122,7,10,17
16909,SpokaneStBridge,12/06/2015 01:00:00 PM,48,-122,7,3,10
16910,SpokaneStBridge,12/06/2015 02:00:00 PM,48,-122,10,10,20
16911,SpokaneStBridge,12/06/2015 03:00:00 PM,48,-122,7,12,19
16912,SpokaneStBridge,12/06/2015 04:00:00 PM,48,-122,5,5,10
16913,SpokaneStBridge,12/06/2015 05:00:00 PM,48,-122,2,1,3
16914,SpokaneStBridge,12/06/2015 06:00:00 PM,48,-122,2,0,2
16915,SpokaneStBridge,12/06/2015 07:00:00 PM,48,-122,0,4,4
16916,SpokaneStBridge,12/06/2015 08:00:00 PM,48,-122,0,2,2
16917,SpokaneStBridge,12/06/2015 09:00:00 PM,48,-122,0,1,1
16918,SpokaneStBridge,12/06/2015 10:00:00 PM,48,-122,0,1,1
16919,SpokaneStBridge,12/06/2015 11:00:00 PM,48,-122,1,1,2
16920,SpokaneStBridge,12/07/2015 12:00:00 AM,48,-122,1,1,2
16921,SpokaneStBridge,12/07/2015 01:00:00 AM,48,-122,0,1,1
16922,SpokaneStBridge,12/07/2015 02:00:00 AM,48,-122,0,0,0
16923,SpokaneStBridge,12/07/2015 03:00:00 AM,48,-122,2,1,3
16924,SpokaneStBridge,12/07/2015 04:00:00 AM,48,-122,4,0,4
16925,SpokaneStBridge,12/07/2015 05:00:00 AM,48,-122,9,1,10
16926,SpokaneStBridge,12/07/2015 06:00:00 AM,48,-122,44,6,50
16927,SpokaneStBridge,12/07/2015 07:00:00 AM,48,-122,74,6,80
16928,SpokaneStBridge,12/07/2015 08:00:00 AM,48,-122,71,5,76
16929,SpokaneStBridge,12/07/2015 09:00:00 AM,48,-122,24,4,28
16930,SpokaneStBridge,12/07/2015 10:00:00 AM,48,-122,8,1,9
16931,SpokaneStBridge,12/07/2015 11:00:00 AM,48,-122,3,0,3
16932,SpokaneStBridge,12/07/2015 12:00:00 PM,48,-122,2,5,7
16933,SpokaneStBridge,12/07/2015 01:00:00 PM,48,-122,1,1,2
16934,SpokaneStBridge,12/07/2015 02:00:00 PM,48,-122,4,2,6
16935,SpokaneStBridge,12/07/2015 03:00:00 PM,48,-122,6,12,18
16936,SpokaneStBridge,12/07/2015 04:00:00 PM,48,-122,6,47,53
16937,SpokaneStBridge,12/07/2015 05:00:00 PM,48,-122,9,85,94
16938,SpokaneStBridge,12/07/2015 06:00:00 PM,48,-122,3,38,41
16939,SpokaneStBridge,12/07/2015 07:00:00 PM,48,-122,3,16,19
16940,SpokaneStBridge,12/07/2015 08:00:00 PM,48,-122,0,6,6
16941,SpokaneStBridge,12/07/2015 09:00:00 PM,48,-122,1,4,5
16942,SpokaneStBridge,12/07/2015 10:00:00 PM,48,-122,0,2,2
16943,SpokaneStBridge,12/07/2015 11:00:00 PM,48,-122,0,2,2
16944,SpokaneStBridge,12/08/2015 12:00:00 AM,48,-122,0,0,0
16945,SpokaneStBridge,12/08/2015 01:00:00 AM,48,-122,0,0,0
16946,SpokaneStBridge,12/08/2015 02:00:00 AM,48,-122,1,2,3
16947,SpokaneStBridge,12/08/2015 03:00:00 AM,48,-122,0,1,1
16948,SpokaneStBridge,12/08/2015 04:00:00 AM,48,-122,1,0,1
16949,SpokaneStBridge,12/08/2015 05:00:00 AM,48,-122,9,0,9
16950,SpokaneStBridge,12/08/2015 06:00:00 AM,48,-122,20,5,25
16951,SpokaneStBridge,12/08/2015 07:00:00 AM,48,-122,58,9,67
16952,SpokaneStBridge,12/08/2015 08:00:00 AM,48,-122,56,3,59
16953,SpokaneStBridge,12/08/2015 09:00:00 AM,48,-122,24,2,26
16954,SpokaneStBridge,12/08/2015 10:00:00 AM,48,-122,2,2,4
16955,SpokaneStBridge,12/08/2015 11:00:00 AM,48,-122,0,0,0
16956,SpokaneStBridge,12/08/2015 12:00:00 PM,48,-122,1,0,1
16957,SpokaneStBridge,12/08/2015 01:00:00 PM,48,-122,4,1,5
16958,SpokaneStBridge,12/08/2015 02:00:00 PM,48,-122,2,4,6
16959,SpokaneStBridge,12/08/2015 03:00:00 PM,48,-122,5,11,16
16960,SpokaneStBridge,12/08/2015 04:00:00 PM,48,-122,7,25,32
16961,SpokaneStBridge,12/08/2015 05:00:00 PM,48,-122,7,51,58
16962,SpokaneStBridge,12/08/2015 06:00:00 PM,48,-122,4,37,41
16963,SpokaneStBridge,12/08/2015 07:00:00 PM,48,-122,1,17,18
16964,SpokaneStBridge,12/08/2015 08:00:00 PM,48,-122,1,6,7
16965,SpokaneStBridge,12/08/2015 09:00:00 PM,48,-122,1,5,6
16966,SpokaneStBridge,12/08/2015 10:00:00 PM,48,-122,0,5,5
16967,SpokaneStBridge,12/08/2015 11:00:00 PM,48,-122,0,0,0
16968,SpokaneStBridge,12/09/2015 12:00:00 AM,48,-122,0,0,0
16969,SpokaneStBridge,12/09/2015 01:00:00 AM,48,-122,0,0,0
16970,SpokaneStBridge,12/09/2015 02:00:00 AM,48,-122,0,1,1
16971,SpokaneStBridge,12/09/2015 03:00:00 AM,48,-122,0,0,0
16972,SpokaneStBridge,12/09/2015 04:00:00 AM,48,-122,2,1,3
16973,SpokaneStBridge,12/09/2015 05:00:00 AM,48,-122,12,1,13
16974,SpokaneStBridge,12/09/2015 06:00:00 AM,48,-122,18,2,20
16975,SpokaneStBridge,12/09/2015 07:00:00 AM,48,-122,40,9,49
16976,SpokaneStBridge,12/09/2015 08:00:00 AM,48,-122,64,6,70
16977,SpokaneStBridge,12/09/2015 09:00:00 AM,48,-122,22,1,23
16978,SpokaneStBridge,12/09/2015 10:00:00 AM,48,-122,11,5,16
16979,SpokaneStBridge,12/09/2015 11:00:00 AM,48,-122,7,4,11
16980,SpokaneStBridge,12/09/2015 12:00:00 PM,48,-122,6,3,9
16981,SpokaneStBridge,12/09/2015 01:00:00 PM,48,-122,5,6,11
16982,SpokaneStBridge,12/09/2015 02:00:00 PM,48,-122,11,13,24
16983,SpokaneStBridge,12/09/2015 03:00:00 PM,48,-122,14,15,29
16984,SpokaneStBridge,12/09/2015 04:00:00 PM,48,-122,7,29,36
16985,SpokaneStBridge,12/09/2015 05:00:00 PM,48,-122,13,65,78
16986,SpokaneStBridge,12/09/2015 06:00:00 PM,48,-122,9,30,39
16987,SpokaneStBridge,12/09/2015 07:00:00 PM,48,-122,1,19,20
16988,SpokaneStBridge,12/09/2015 08:00:00 PM,48,-122,12,8,20
16989,SpokaneStBridge,12/09/2015 09:00:00 PM,48,-122,2,9,11
16990,SpokaneStBridge,12/09/2015 10:00:00 PM,48,-122,2,2,4
16991,SpokaneStBridge,12/09/2015 11:00:00 PM,48,-122,0,2,2
16992,SpokaneStBridge,12/10/2015 12:00:00 AM,48,-122,2,2,4
16993,SpokaneStBridge,12/10/2015 01:00:00 AM,48,-122,0,0,0
16994,SpokaneStBridge,12/10/2015 02:00:00 AM,48,-122,1,1,2
16995,SpokaneStBridge,12/10/2015 03:00:00 AM,48,-122,0,0,0
16996,SpokaneStBridge,12/10/2015 04:00:00 AM,48,-122,1,0,1
16997,SpokaneStBridge,12/10/2015 05:00:00 AM,48,-122,9,1,10
16998,SpokaneStBridge,12/10/2015 06:00:00 AM,48,-122,33,6,39
16999,SpokaneStBridge,12/10/2015 07:00:00 AM,48,-122,52,10,62
17000,SpokaneStBridge,12/10/2015 08:00:00 AM,48,-122,71,7,78
17001,SpokaneStBridge,12/10/2015 09:00:00 AM,48,-122,25,4,29
17002,SpokaneStBridge,12/10/2015 10:00:00 AM,48,-122,6,0,6
17003,SpokaneStBridge,12/10/2015 11:00:00 AM,48,-122,4,3,7
17004,SpokaneStBridge,12/10/2015 12:00:00 PM,48,-122,2,2,4
17005,SpokaneStBridge,12/10/2015 01:00:00 PM,48,-122,3,1,4
17006,SpokaneStBridge,12/10/2015 02:00:00 PM,48,-122,7,10,17
17007,SpokaneStBridge,12/10/2015 03:00:00 PM,48,-122,6,15,21
17008,SpokaneStBridge,12/10/2015 04:00:00 PM,48,-122,10,29,39
17009,SpokaneStBridge,12/10/2015 05:00:00 PM,48,-122,6,55,61
17010,SpokaneStBridge,12/10/2015 06:00:00 PM,48,-122,4,42,46
17011,SpokaneStBridge,12/10/2015 07:00:00 PM,48,-122,2,12,14
17012,SpokaneStBridge,12/10/2015 08:00:00 PM,48,-122,1,4,5
17013,SpokaneStBridge,12/10/2015 09:00:00 PM,48,-122,0,8,8
17014,SpokaneStBridge,12/10/2015 10:00:00 PM,48,-122,1,3,4
17015,SpokaneStBridge,12/10/2015 11:00:00 PM,48,-122,3,2,5
17016,SpokaneStBridge,12/11/2015 12:00:00 AM,48,-122,0,3,3
17017,SpokaneStBridge,12/11/2015 01:00:00 AM,48,-122,1,1,2
17018,SpokaneStBridge,12/11/2015 02:00:00 AM,48,-122,0,1,1
17019,SpokaneStBridge,12/11/2015 03:00:00 AM,48,-122,2,0,2
17020,SpokaneStBridge,12/11/2015 04:00:00 AM,48,-122,2,1,3
17021,SpokaneStBridge,12/11/2015 05:00:00 AM,48,-122,9,2,11
17022,SpokaneStBridge,12/11/2015 06:00:00 AM,48,-122,23,5,28
17023,SpokaneStBridge,12/11/2015 07:00:00 AM,48,-122,60,5,65
17024,SpokaneStBridge,12/11/2015 08:00:00 AM,48,-122,69,5,74
17025,SpokaneStBridge,12/11/2015 09:00:00 AM,48,-122,30,1,31
17026,SpokaneStBridge,12/11/2015 10:00:00 AM,48,-122,16,7,23
17027,SpokaneStBridge,12/11/2015 11:00:00 AM,48,-122,8,3,11
17028,SpokaneStBridge,12/11/2015 12:00:00 PM,48,-122,4,6,10
17029,SpokaneStBridge,12/11/2015 01:00:00 PM,48,-122,12,11,23
17030,SpokaneStBridge,12/11/2015 02:00:00 PM,48,-122,8,17,25
17031,SpokaneStBridge,12/11/2015 03:00:00 PM,48,-122,8,25,33
17032,SpokaneStBridge,12/11/2015 04:00:00 PM,48,-122,9,37,46
17033,SpokaneStBridge,12/11/2015 05:00:00 PM,48,-122,5,73,78
17034,SpokaneStBridge,12/11/2015 06:00:00 PM,48,-122,5,29,34
17035,SpokaneStBridge,12/11/2015 07:00:00 PM,48,-122,1,11,12
17036,SpokaneStBridge,12/11/2015 08:00:00 PM,48,-122,4,7,11
17037,SpokaneStBridge,12/11/2015 09:00:00 PM,48,-122,0,4,4
17038,SpokaneStBridge,12/11/2015 10:00:00 PM,48,-122,2,1,3
17039,SpokaneStBridge,12/11/2015 11:00:00 PM,48,-122,1,4,5
17040,SpokaneStBridge,12/12/2015 12:00:00 AM,48,-122,3,5,8
17041,SpokaneStBridge,12/12/2015 01:00:00 AM,48,-122,0,0,0
17042,SpokaneStBridge,12/12/2015 02:00:00 AM,48,-122,1,1,2
17043,SpokaneStBridge,12/12/2015 03:00:00 AM,48,-122,0,0,0
17044,SpokaneStBridge,12/12/2015 04:00:00 AM,48,-122,0,1,1
17045,SpokaneStBridge,12/12/2015 05:00:00 AM,48,-122,3,2,5
17046,SpokaneStBridge,12/12/2015 06:00:00 AM,48,-122,2,1,3
17047,SpokaneStBridge,12/12/2015 07:00:00 AM,48,-122,1,1,2
17048,SpokaneStBridge,12/12/2015 08:00:00 AM,48,-122,7,2,9
17049,SpokaneStBridge,12/12/2015 09:00:00 AM,48,-122,4,2,6
17050,SpokaneStBridge,12/12/2015 10:00:00 AM,48,-122,4,3,7
17051,SpokaneStBridge,12/12/2015 11:00:00 AM,48,-122,6,5,11
17052,SpokaneStBridge,12/12/2015 12:00:00 PM,48,-122,0,2,2
17053,SpokaneStBridge,12/12/2015 01:00:00 PM,48,-122,2,6,8
17054,SpokaneStBridge,12/12/2015 02:00:00 PM,48,-122,2,3,5
17055,SpokaneStBridge,12/12/2015 03:00:00 PM,48,-122,1,4,5
17056,SpokaneStBridge,12/12/2015 04:00:00 PM,48,-122,4,1,5
17057,SpokaneStBridge,12/12/2015 05:00:00 PM,48,-122,2,2,4
17058,SpokaneStBridge,12/12/2015 06:00:00 PM,48,-122,2,2,4
17059,SpokaneStBridge,12/12/2015 07:00:00 PM,48,-122,3,0,3
17060,SpokaneStBridge,12/12/2015 08:00:00 PM,48,-122,0,0,0
17061,SpokaneStBridge,12/12/2015 09:00:00 PM,48,-122,0,0,0
17062,SpokaneStBridge,12/12/2015 10:00:00 PM,48,-122,0,1,1
17063,SpokaneStBridge,12/12/2015 11:00:00 PM,48,-122,0,1,1
17064,SpokaneStBridge,12/13/2015 12:00:00 AM,48,-122,0,1,1
17065,SpokaneStBridge,12/13/2015 01:00:00 AM,48,-122,0,3,3
17066,SpokaneStBridge,12/13/2015 02:00:00 AM,48,-122,0,0,0
17067,SpokaneStBridge,12/13/2015 03:00:00 AM,48,-122,1,2,3
17068,SpokaneStBridge,12/13/2015 04:00:00 AM,48,-122,0,0,0
17069,SpokaneStBridge,12/13/2015 05:00:00 AM,48,-122,3,0,3
17070,SpokaneStBridge,12/13/2015 06:00:00 AM,48,-122,1,0,1
17071,SpokaneStBridge,12/13/2015 07:00:00 AM,48,-122,1,2,3
17072,SpokaneStBridge,12/13/2015 08:00:00 AM,48,-122,12,3,15
17073,SpokaneStBridge,12/13/2015 09:00:00 AM,48,-122,9,5,14
17074,SpokaneStBridge,12/13/2015 10:00:00 AM,48,-122,10,11,21
17075,SpokaneStBridge,12/13/2015 11:00:00 AM,48,-122,5,4,9
17076,SpokaneStBridge,12/13/2015 12:00:00 PM,48,-122,9,4,13
17077,SpokaneStBridge,12/13/2015 01:00:00 PM,48,-122,4,0,4
17078,SpokaneStBridge,12/13/2015 02:00:00 PM,48,-122,7,4,11
17079,SpokaneStBridge,12/13/2015 03:00:00 PM,48,-122,15,9,24
17080,SpokaneStBridge,12/13/2015 04:00:00 PM,48,-122,4,4,8
17081,SpokaneStBridge,12/13/2015 05:00:00 PM,48,-122,2,2,4
17082,SpokaneStBridge,12/13/2015 06:00:00 PM,48,-122,0,2,2
17083,SpokaneStBridge,12/13/2015 07:00:00 PM,48,-122,0,2,2
17084,SpokaneStBridge,12/13/2015 08:00:00 PM,48,-122,0,3,3
17085,SpokaneStBridge,12/13/2015 09:00:00 PM,48,-122,1,3,4
17086,SpokaneStBridge,12/13/2015 10:00:00 PM,48,-122,0,0,0
17087,SpokaneStBridge,12/13/2015 11:00:00 PM,48,-122,3,2,5
17088,SpokaneStBridge,12/14/2015 12:00:00 AM,48,-122,1,3,4
17089,SpokaneStBridge,12/14/2015 01:00:00 AM,48,-122,0,0,0
17090,SpokaneStBridge,12/14/2015 02:00:00 AM,48,-122,0,0,0
17091,SpokaneStBridge,12/14/2015 03:00:00 AM,48,-122,0,1,1
17092,SpokaneStBridge,12/14/2015 04:00:00 AM,48,-122,2,1,3
17093,SpokaneStBridge,12/14/2015 05:00:00 AM,48,-122,14,0,14
17094,SpokaneStBridge,12/14/2015 06:00:00 AM,48,-122,36,6,42
17095,SpokaneStBridge,12/14/2015 07:00:00 AM,48,-122,94,8,102
17096,SpokaneStBridge,12/14/2015 08:00:00 AM,48,-122,97,6,103
17097,SpokaneStBridge,12/14/2015 09:00:00 AM,48,-122,31,5,36
17098,SpokaneStBridge,12/14/2015 10:00:00 AM,48,-122,12,2,14
17099,SpokaneStBridge,12/14/2015 11:00:00 AM,48,-122,11,2,13
17100,SpokaneStBridge,12/14/2015 12:00:00 PM,48,-122,9,9,18
17101,SpokaneStBridge,12/14/2015 01:00:00 PM,48,-122,8,2,10
17102,SpokaneStBridge,12/14/2015 02:00:00 PM,48,-122,14,16,30
17103,SpokaneStBridge,12/14/2015 03:00:00 PM,48,-122,10,20,30
17104,SpokaneStBridge,12/14/2015 04:00:00 PM,48,-122,16,60,76
17105,SpokaneStBridge,12/14/2015 05:00:00 PM,48,-122,15,107,122
17106,SpokaneStBridge,12/14/2015 06:00:00 PM,48,-122,7,55,62
17107,SpokaneStBridge,12/14/2015 07:00:00 PM,48,-122,5,24,29
17108,SpokaneStBridge,12/14/2015 08:00:00 PM,48,-122,1,6,7
17109,SpokaneStBridge,12/14/2015 09:00:00 PM,48,-122,1,9,10
17110,SpokaneStBridge,12/14/2015 10:00:00 PM,48,-122,0,3,3
17111,SpokaneStBridge,12/14/2015 11:00:00 PM,48,-122,1,2,3
17112,SpokaneStBridge,12/15/2015 12:00:00 AM,48,-122,0,0,0
17113,SpokaneStBridge,12/15/2015 01:00:00 AM,48,-122,0,0,0
17114,SpokaneStBridge,12/15/2015 02:00:00 AM,48,-122,0,1,1
17115,SpokaneStBridge,12/15/2015 03:00:00 AM,48,-122,0,2,2
17116,SpokaneStBridge,12/15/2015 04:00:00 AM,48,-122,3,0,3
17117,SpokaneStBridge,12/15/2015 05:00:00 AM,48,-122,15,2,17
17118,SpokaneStBridge,12/15/2015 06:00:00 AM,48,-122,43,7,50
17119,SpokaneStBridge,12/15/2015 07:00:00 AM,48,-122,70,8,78
17120,SpokaneStBridge,12/15/2015 08:00:00 AM,48,-122,107,6,113
17121,SpokaneStBridge,12/15/2015 09:00:00 AM,48,-122,47,7,54
17122,SpokaneStBridge,12/15/2015 10:00:00 AM,48,-122,11,5,16
17123,SpokaneStBridge,12/15/2015 11:00:00 AM,48,-122,7,6,13
17124,SpokaneStBridge,12/15/2015 12:00:00 PM,48,-122,7,5,12
17125,SpokaneStBridge,12/15/2015 01:00:00 PM,48,-122,4,7,11
17126,SpokaneStBridge,12/15/2015 02:00:00 PM,48,-122,10,12,22
17127,SpokaneStBridge,12/15/2015 03:00:00 PM,48,-122,5,21,26
17128,SpokaneStBridge,12/15/2015 04:00:00 PM,48,-122,14,40,54
17129,SpokaneStBridge,12/15/2015 05:00:00 PM,48,-122,9,93,102
17130,SpokaneStBridge,12/15/2015 06:00:00 PM,48,-122,11,44,55
17131,SpokaneStBridge,12/15/2015 07:00:00 PM,48,-122,4,24,28
17132,SpokaneStBridge,12/15/2015 08:00:00 PM,48,-122,4,10,14
17133,SpokaneStBridge,12/15/2015 09:00:00 PM,48,-122,1,9,10
17134,SpokaneStBridge,12/15/2015 10:00:00 PM,48,-122,0,1,1
17135,SpokaneStBridge,12/15/2015 11:00:00 PM,48,-122,3,8,11
17136,SpokaneStBridge,12/16/2015 12:00:00 AM,48,-122,0,1,1
17137,SpokaneStBridge,12/16/2015 01:00:00 AM,48,-122,0,0,0
17138,SpokaneStBridge,12/16/2015 02:00:00 AM,48,-122,0,1,1
17139,SpokaneStBridge,12/16/2015 03:00:00 AM,48,-122,0,0,0
17140,SpokaneStBridge,12/16/2015 04:00:00 AM,48,-122,2,1,3
17141,SpokaneStBridge,12/16/2015 05:00:00 AM,48,-122,11,2,13
17142,SpokaneStBridge,12/16/2015 06:00:00 AM,48,-122,40,9,49
17143,SpokaneStBridge,12/16/2015 07:00:00 AM,48,-122,63,12,75
17144,SpokaneStBridge,12/16/2015 08:00:00 AM,48,-122,89,6,95
17145,SpokaneStBridge,12/16/2015 09:00:00 AM,48,-122,33,2,35
17146,SpokaneStBridge,12/16/2015 10:00:00 AM,48,-122,19,4,23
17147,SpokaneStBridge,12/16/2015 11:00:00 AM,48,-122,9,3,12
17148,SpokaneStBridge,12/16/2015 12:00:00 PM,48,-122,7,4,11
17149,SpokaneStBridge,12/16/2015 01:00:00 PM,48,-122,5,5,10
17150,SpokaneStBridge,12/16/2015 02:00:00 PM,48,-122,13,19,32
17151,SpokaneStBridge,12/16/2015 03:00:00 PM,48,-122,6,25,31
17152,SpokaneStBridge,12/16/2015 04:00:00 PM,48,-122,12,51,63
17153,SpokaneStBridge,12/16/2015 05:00:00 PM,48,-122,10,86,96
17154,SpokaneStBridge,12/16/2015 06:00:00 PM,48,-122,12,48,60
17155,SpokaneStBridge,12/16/2015 07:00:00 PM,48,-122,3,20,23
17156,SpokaneStBridge,12/16/2015 08:00:00 PM,48,-122,3,16,19
17157,SpokaneStBridge,12/16/2015 09:00:00 PM,48,-122,3,10,13
17158,SpokaneStBridge,12/16/2015 10:00:00 PM,48,-122,0,2,2
17159,SpokaneStBridge,12/16/2015 11:00:00 PM,48,-122,2,2,4
17160,SpokaneStBridge,12/17/2015 12:00:00 AM,48,-122,0,4,4
17161,SpokaneStBridge,12/17/2015 01:00:00 AM,48,-122,1,0,1
17162,SpokaneStBridge,12/17/2015 02:00:00 AM,48,-122,1,0,1
17163,SpokaneStBridge,12/17/2015 03:00:00 AM,48,-122,1,1,2
17164,SpokaneStBridge,12/17/2015 04:00:00 AM,48,-122,3,0,3
17165,SpokaneStBridge,12/17/2015 05:00:00 AM,48,-122,15,1,16
17166,SpokaneStBridge,12/17/2015 06:00:00 AM,48,-122,26,3,29
17167,SpokaneStBridge,12/17/2015 07:00:00 AM,48,-122,61,7,68
17168,SpokaneStBridge,12/17/2015 08:00:00 AM,48,-122,57,5,62
17169,SpokaneStBridge,12/17/2015 09:00:00 AM,48,-122,20,1,21
17170,SpokaneStBridge,12/17/2015 10:00:00 AM,48,-122,13,1,14
17171,SpokaneStBridge,12/17/2015 11:00:00 AM,48,-122,5,4,9
17172,SpokaneStBridge,12/17/2015 12:00:00 PM,48,-122,3,3,6
17173,SpokaneStBridge,12/17/2015 01:00:00 PM,48,-122,2,0,2
17174,SpokaneStBridge,12/17/2015 02:00:00 PM,48,-122,3,2,5
17175,SpokaneStBridge,12/17/2015 03:00:00 PM,48,-122,2,12,14
17176,SpokaneStBridge,12/17/2015 04:00:00 PM,48,-122,5,35,40
17177,SpokaneStBridge,12/17/2015 05:00:00 PM,48,-122,8,44,52
17178,SpokaneStBridge,12/17/2015 06:00:00 PM,48,-122,6,43,49
17179,SpokaneStBridge,12/17/2015 07:00:00 PM,48,-122,3,13,16
17180,SpokaneStBridge,12/17/2015 08:00:00 PM,48,-122,0,4,4
17181,SpokaneStBridge,12/17/2015 09:00:00 PM,48,-122,0,4,4
17182,SpokaneStBridge,12/17/2015 10:00:00 PM,48,-122,1,3,4
17183,SpokaneStBridge,12/17/2015 11:00:00 PM,48,-122,0,3,3
17184,SpokaneStBridge,12/18/2015 12:00:00 AM,48,-122,0,1,1
17185,SpokaneStBridge,12/18/2015 01:00:00 AM,48,-122,3,0,3
17186,SpokaneStBridge,12/18/2015 02:00:00 AM,48,-122,1,2,3
17187,SpokaneStBridge,12/18/2015 03:00:00 AM,48,-122,0,0,0
17188,SpokaneStBridge,12/18/2015 04:00:00 AM,48,-122,1,0,1
17189,SpokaneStBridge,12/18/2015 05:00:00 AM,48,-122,9,1,10
17190,SpokaneStBridge,12/18/2015 06:00:00 AM,48,-122,14,5,19
17191,SpokaneStBridge,12/18/2015 07:00:00 AM,48,-122,46,5,51
17192,SpokaneStBridge,12/18/2015 08:00:00 AM,48,-122,54,7,61
17193,SpokaneStBridge,12/18/2015 09:00:00 AM,48,-122,28,3,31
17194,SpokaneStBridge,12/18/2015 10:00:00 AM,48,-122,3,9,12
17195,SpokaneStBridge,12/18/2015 11:00:00 AM,48,-122,5,6,11
17196,SpokaneStBridge,12/18/2015 12:00:00 PM,48,-122,12,6,18
17197,SpokaneStBridge,12/18/2015 01:00:00 PM,48,-122,3,4,7
17198,SpokaneStBridge,12/18/2015 02:00:00 PM,48,-122,4,5,9
17199,SpokaneStBridge,12/18/2015 03:00:00 PM,48,-122,7,16,23
17200,SpokaneStBridge,12/18/2015 04:00:00 PM,48,-122,7,29,36
17201,SpokaneStBridge,12/18/2015 05:00:00 PM,48,-122,7,63,70
17202,SpokaneStBridge,12/18/2015 06:00:00 PM,48,-122,5,28,33
17203,SpokaneStBridge,12/18/2015 07:00:00 PM,48,-122,1,8,9
17204,SpokaneStBridge,12/18/2015 08:00:00 PM,48,-122,0,6,6
17205,SpokaneStBridge,12/18/2015 09:00:00 PM,48,-122,0,1,1
17206,SpokaneStBridge,12/18/2015 10:00:00 PM,48,-122,0,1,1
17207,SpokaneStBridge,12/18/2015 11:00:00 PM,48,-122,1,1,2
17208,SpokaneStBridge,12/19/2015 12:00:00 AM,48,-122,1,1,2
17209,SpokaneStBridge,12/19/2015 01:00:00 AM,48,-122,0,0,0
17210,SpokaneStBridge,12/19/2015 02:00:00 AM,48,-122,0,1,1
17211,SpokaneStBridge,12/19/2015 03:00:00 AM,48,-122,1,0,1
17212,SpokaneStBridge,12/19/2015 04:00:00 AM,48,-122,0,1,1
17213,SpokaneStBridge,12/19/2015 05:00:00 AM,48,-122,4,0,4
17214,SpokaneStBridge,12/19/2015 06:00:00 AM,48,-122,4,3,7
17215,SpokaneStBridge,12/19/2015 07:00:00 AM,48,-122,2,0,2
17216,SpokaneStBridge,12/19/2015 08:00:00 AM,48,-122,6,4,10
17217,SpokaneStBridge,12/19/2015 09:00:00 AM,48,-122,8,3,11
17218,SpokaneStBridge,12/19/2015 10:00:00 AM,48,-122,9,8,17
17219,SpokaneStBridge,12/19/2015 11:00:00 AM,48,-122,14,12,26
17220,SpokaneStBridge,12/19/2015 12:00:00 PM,48,-122,10,7,17
17221,SpokaneStBridge,12/19/2015 01:00:00 PM,48,-122,15,18,33
17222,SpokaneStBridge,12/19/2015 02:00:00 PM,48,-122,15,11,26
17223,SpokaneStBridge,12/19/2015 03:00:00 PM,48,-122,11,14,25
17224,SpokaneStBridge,12/19/2015 04:00:00 PM,48,-122,6,4,10
17225,SpokaneStBridge,12/19/2015 05:00:00 PM,48,-122,4,1,5
17226,SpokaneStBridge,12/19/2015 06:00:00 PM,48,-122,0,2,2
17227,SpokaneStBridge,12/19/2015 07:00:00 PM,48,-122,0,2,2
17228,SpokaneStBridge,12/19/2015 08:00:00 PM,48,-122,1,3,4
17229,SpokaneStBridge,12/19/2015 09:00:00 PM,48,-122,0,3,3
17230,SpokaneStBridge,12/19/2015 10:00:00 PM,48,-122,0,1,1
17231,SpokaneStBridge,12/19/2015 11:00:00 PM,48,-122,0,2,2
17232,SpokaneStBridge,12/20/2015 12:00:00 AM,48,-122,0,0,0
17233,SpokaneStBridge,12/20/2015 01:00:00 AM,48,-122,1,2,3
17234,SpokaneStBridge,12/20/2015 02:00:00 AM,48,-122,0,0,0
17235,SpokaneStBridge,12/20/2015 03:00:00 AM,48,-122,0,0,0
17236,SpokaneStBridge,12/20/2015 04:00:00 AM,48,-122,0,1,1
17237,SpokaneStBridge,12/20/2015 05:00:00 AM,48,-122,2,0,2
17238,SpokaneStBridge,12/20/2015 06:00:00 AM,48,-122,2,1,3
17239,SpokaneStBridge,12/20/2015 07:00:00 AM,48,-122,0,0,0
17240,SpokaneStBridge,12/20/2015 08:00:00 AM,48,-122,6,3,9
17241,SpokaneStBridge,12/20/2015 09:00:00 AM,48,-122,3,4,7
17242,SpokaneStBridge,12/20/2015 10:00:00 AM,48,-122,10,7,17
17243,SpokaneStBridge,12/20/2015 11:00:00 AM,48,-122,13,6,19
17244,SpokaneStBridge,12/20/2015 12:00:00 PM,48,-122,6,11,17
17245,SpokaneStBridge,12/20/2015 01:00:00 PM,48,-122,10,9,19
17246,SpokaneStBridge,12/20/2015 02:00:00 PM,48,-122,4,13,17
17247,SpokaneStBridge,12/20/2015 03:00:00 PM,48,-122,7,10,17
17248,SpokaneStBridge,12/20/2015 04:00:00 PM,48,-122,11,8,19
17249,SpokaneStBridge,12/20/2015 05:00:00 PM,48,-122,4,3,7
17250,SpokaneStBridge,12/20/2015 06:00:00 PM,48,-122,1,0,1
17251,SpokaneStBridge,12/20/2015 07:00:00 PM,48,-122,1,2,3
17252,SpokaneStBridge,12/20/2015 08:00:00 PM,48,-122,1,3,4
17253,SpokaneStBridge,12/20/2015 09:00:00 PM,48,-122,0,4,4
17254,SpokaneStBridge,12/20/2015 10:00:00 PM,48,-122,2,1,3
17255,SpokaneStBridge,12/20/2015 11:00:00 PM,48,-122,1,1,2
17256,SpokaneStBridge,12/21/2015 12:00:00 AM,48,-122,1,1,2
17257,SpokaneStBridge,12/21/2015 01:00:00 AM,48,-122,0,0,0
17258,SpokaneStBridge,12/21/2015 02:00:00 AM,48,-122,0,0,0
17259,SpokaneStBridge,12/21/2015 03:00:00 AM,48,-122,1,0,1
17260,SpokaneStBridge,12/21/2015 04:00:00 AM,48,-122,2,1,3
17261,SpokaneStBridge,12/21/2015 05:00:00 AM,48,-122,11,1,12
17262,SpokaneStBridge,12/21/2015 06:00:00 AM,48,-122,24,1,25
17263,SpokaneStBridge,12/21/2015 07:00:00 AM,48,-122,59,4,63
17264,SpokaneStBridge,12/21/2015 08:00:00 AM,48,-122,43,4,47
17265,SpokaneStBridge,12/21/2015 09:00:00 AM,48,-122,12,1,13
17266,SpokaneStBridge,12/21/2015 10:00:00 AM,48,-122,7,2,9
17267,SpokaneStBridge,12/21/2015 11:00:00 AM,48,-122,3,2,5
17268,SpokaneStBridge,12/21/2015 12:00:00 PM,48,-122,1,2,3
17269,SpokaneStBridge,12/21/2015 01:00:00 PM,48,-122,3,2,5
17270,SpokaneStBridge,12/21/2015 02:00:00 PM,48,-122,2,3,5
17271,SpokaneStBridge,12/21/2015 03:00:00 PM,48,-122,2,12,14
17272,SpokaneStBridge,12/21/2015 04:00:00 PM,48,-122,5,34,39
17273,SpokaneStBridge,12/21/2015 05:00:00 PM,48,-122,8,47,55
17274,SpokaneStBridge,12/21/2015 06:00:00 PM,48,-122,5,22,27
17275,SpokaneStBridge,12/21/2015 07:00:00 PM,48,-122,1,14,15
17276,SpokaneStBridge,12/21/2015 08:00:00 PM,48,-122,1,3,4
17277,SpokaneStBridge,12/21/2015 09:00:00 PM,48,-122,0,2,2
17278,SpokaneStBridge,12/21/2015 10:00:00 PM,48,-122,2,1,3
17279,SpokaneStBridge,12/21/2015 11:00:00 PM,48,-122,0,2,2
17280,SpokaneStBridge,12/22/2015 12:00:00 AM,48,-122,0,0,0
17281,SpokaneStBridge,12/22/2015 01:00:00 AM,48,-122,0,1,1
17282,SpokaneStBridge,12/22/2015 02:00:00 AM,48,-122,0,1,1
17283,SpokaneStBridge,12/22/2015 03:00:00 AM,48,-122,0,2,2
17284,SpokaneStBridge,12/22/2015 04:00:00 AM,48,-122,4,0,4
17285,SpokaneStBridge,12/22/2015 05:00:00 AM,48,-122,12,3,15
17286,SpokaneStBridge,12/22/2015 06:00:00 AM,48,-122,22,2,24
17287,SpokaneStBridge,12/22/2015 07:00:00 AM,48,-122,52,2,54
17288,SpokaneStBridge,12/22/2015 08:00:00 AM,48,-122,56,2,58
17289,SpokaneStBridge,12/22/2015 09:00:00 AM,48,-122,21,2,23
17290,SpokaneStBridge,12/22/2015 10:00:00 AM,48,-122,11,4,15
17291,SpokaneStBridge,12/22/2015 11:00:00 AM,48,-122,3,2,5
17292,SpokaneStBridge,12/22/2015 12:00:00 PM,48,-122,8,5,13
17293,SpokaneStBridge,12/22/2015 01:00:00 PM,48,-122,2,10,12
17294,SpokaneStBridge,12/22/2015 02:00:00 PM,48,-122,12,10,22
17295,SpokaneStBridge,12/22/2015 03:00:00 PM,48,-122,8,11,19
17296,SpokaneStBridge,12/22/2015 04:00:00 PM,48,-122,8,38,46
17297,SpokaneStBridge,12/22/2015 05:00:00 PM,48,-122,7,59,66
17298,SpokaneStBridge,12/22/2015 06:00:00 PM,48,-122,4,22,26
17299,SpokaneStBridge,12/22/2015 07:00:00 PM,48,-122,2,7,9
17300,SpokaneStBridge,12/22/2015 08:00:00 PM,48,-122,0,5,5
17301,SpokaneStBridge,12/22/2015 09:00:00 PM,48,-122,0,5,5
17302,SpokaneStBridge,12/22/2015 10:00:00 PM,48,-122,0,1,1
17303,SpokaneStBridge,12/22/2015 11:00:00 PM,48,-122,0,2,2
17304,SpokaneStBridge,12/23/2015 12:00:00 AM,48,-122,1,3,4
17305,SpokaneStBridge,12/23/2015 01:00:00 AM,48,-122,0,1,1
17306,SpokaneStBridge,12/23/2015 02:00:00 AM,48,-122,0,1,1
17307,SpokaneStBridge,12/23/2015 03:00:00 AM,48,-122,0,1,1
17308,SpokaneStBridge,12/23/2015 04:00:00 AM,48,-122,2,1,3
17309,SpokaneStBridge,12/23/2015 05:00:00 AM,48,-122,6,3,9
17310,SpokaneStBridge,12/23/2015 06:00:00 AM,48,-122,22,2,24
17311,SpokaneStBridge,12/23/2015 07:00:00 AM,48,-122,34,6,40
17312,SpokaneStBridge,12/23/2015 08:00:00 AM,48,-122,34,1,35
17313,SpokaneStBridge,12/23/2015 09:00:00 AM,48,-122,23,1,24
17314,SpokaneStBridge,12/23/2015 10:00:00 AM,48,-122,13,1,14
17315,SpokaneStBridge,12/23/2015 11:00:00 AM,48,-122,3,3,6
17316,SpokaneStBridge,12/23/2015 12:00:00 PM,48,-122,1,2,3
17317,SpokaneStBridge,12/23/2015 01:00:00 PM,48,-122,5,7,12
17318,SpokaneStBridge,12/23/2015 02:00:00 PM,48,-122,3,12,15
17319,SpokaneStBridge,12/23/2015 03:00:00 PM,48,-122,3,17,20
17320,SpokaneStBridge,12/23/2015 04:00:00 PM,48,-122,5,26,31
17321,SpokaneStBridge,12/23/2015 05:00:00 PM,48,-122,5,37,42
17322,SpokaneStBridge,12/23/2015 06:00:00 PM,48,-122,5,18,23
17323,SpokaneStBridge,12/23/2015 07:00:00 PM,48,-122,2,8,10
17324,SpokaneStBridge,12/23/2015 08:00:00 PM,48,-122,1,2,3
17325,SpokaneStBridge,12/23/2015 09:00:00 PM,48,-122,0,2,2
17326,SpokaneStBridge,12/23/2015 10:00:00 PM,48,-122,0,1,1
17327,SpokaneStBridge,12/23/2015 11:00:00 PM,48,-122,0,1,1
17328,SpokaneStBridge,12/24/2015 12:00:00 AM,48,-122,0,0,0
17329,SpokaneStBridge,12/24/2015 01:00:00 AM,48,-122,1,0,1
17330,SpokaneStBridge,12/24/2015 02:00:00 AM,48,-122,0,1,1
17331,SpokaneStBridge,12/24/2015 03:00:00 AM,48,-122,1,1,2
17332,SpokaneStBridge,12/24/2015 04:00:00 AM,48,-122,1,1,2
17333,SpokaneStBridge,12/24/2015 05:00:00 AM,48,-122,7,3,10
17334,SpokaneStBridge,12/24/2015 06:00:00 AM,48,-122,10,0,10
17335,SpokaneStBridge,12/24/2015 07:00:00 AM,48,-122,12,0,12
17336,SpokaneStBridge,12/24/2015 08:00:00 AM,48,-122,8,3,11
17337,SpokaneStBridge,12/24/2015 09:00:00 AM,48,-122,9,2,11
17338,SpokaneStBridge,12/24/2015 10:00:00 AM,48,-122,5,6,11
17339,SpokaneStBridge,12/24/2015 11:00:00 AM,48,-122,6,8,14
17340,SpokaneStBridge,12/24/2015 12:00:00 PM,48,-122,6,9,15
17341,SpokaneStBridge,12/24/2015 01:00:00 PM,48,-122,12,14,26
17342,SpokaneStBridge,12/24/2015 02:00:00 PM,48,-122,7,13,20
17343,SpokaneStBridge,12/24/2015 03:00:00 PM,48,-122,2,8,10
17344,SpokaneStBridge,12/24/2015 04:00:00 PM,48,-122,5,9,14
17345,SpokaneStBridge,12/24/2015 05:00:00 PM,48,-122,1,5,6
17346,SpokaneStBridge,12/24/2015 06:00:00 PM,48,-122,1,3,4
17347,SpokaneStBridge,12/24/2015 07:00:00 PM,48,-122,2,1,3
17348,SpokaneStBridge,12/24/2015 08:00:00 PM,48,-122,2,1,3
17349,SpokaneStBridge,12/24/2015 09:00:00 PM,48,-122,0,2,2
17350,SpokaneStBridge,12/24/2015 10:00:00 PM,48,-122,0,0,0
17351,SpokaneStBridge,12/24/2015 11:00:00 PM,48,-122,0,1,1
17352,SpokaneStBridge,12/25/2015 12:00:00 AM,48,-122,1,1,2
17353,SpokaneStBridge,12/25/2015 01:00:00 AM,48,-122,0,1,1
17354,SpokaneStBridge,12/25/2015 02:00:00 AM,48,-122,0,0,0
17355,SpokaneStBridge,12/25/2015 03:00:00 AM,48,-122,0,0,0
17356,SpokaneStBridge,12/25/2015 04:00:00 AM,48,-122,0,0,0
17357,SpokaneStBridge,12/25/2015 05:00:00 AM,48,-122,1,1,2
17358,SpokaneStBridge,12/25/2015 06:00:00 AM,48,-122,1,0,1
17359,SpokaneStBridge,12/25/2015 07:00:00 AM,48,-122,0,0,0
17360,SpokaneStBridge,12/25/2015 08:00:00 AM,48,-122,1,0,1
17361,SpokaneStBridge,12/25/2015 09:00:00 AM,48,-122,1,0,1
17362,SpokaneStBridge,12/25/2015 10:00:00 AM,48,-122,3,1,4
17363,SpokaneStBridge,12/25/2015 11:00:00 AM,48,-122,4,2,6
17364,SpokaneStBridge,12/25/2015 12:00:00 PM,48,-122,2,19,21
17365,SpokaneStBridge,12/25/2015 01:00:00 PM,48,-122,22,6,28
17366,SpokaneStBridge,12/25/2015 02:00:00 PM,48,-122,10,11,21
17367,SpokaneStBridge,12/25/2015 03:00:00 PM,48,-122,7,3,10
17368,SpokaneStBridge,12/25/2015 04:00:00 PM,48,-122,5,4,9
17369,SpokaneStBridge,12/25/2015 05:00:00 PM,48,-122,5,3,8
17370,SpokaneStBridge,12/25/2015 06:00:00 PM,48,-122,2,2,4
17371,SpokaneStBridge,12/25/2015 07:00:00 PM,48,-122,1,1,2
17372,SpokaneStBridge,12/25/2015 08:00:00 PM,48,-122,1,1,2
17373,SpokaneStBridge,12/25/2015 09:00:00 PM,48,-122,1,3,4
17374,SpokaneStBridge,12/25/2015 10:00:00 PM,48,-122,1,2,3
17375,SpokaneStBridge,12/25/2015 11:00:00 PM,48,-122,1,0,1
17376,SpokaneStBridge,12/26/2015 12:00:00 AM,48,-122,0,1,1
17377,SpokaneStBridge,12/26/2015 01:00:00 AM,48,-122,0,0,0
17378,SpokaneStBridge,12/26/2015 02:00:00 AM,48,-122,0,0,0
17379,SpokaneStBridge,12/26/2015 03:00:00 AM,48,-122,1,0,1
17380,SpokaneStBridge,12/26/2015 04:00:00 AM,48,-122,0,1,1
17381,SpokaneStBridge,12/26/2015 05:00:00 AM,48,-122,3,0,3
17382,SpokaneStBridge,12/26/2015 06:00:00 AM,48,-122,0,2,2
17383,SpokaneStBridge,12/26/2015 07:00:00 AM,48,-122,1,2,3
17384,SpokaneStBridge,12/26/2015 08:00:00 AM,48,-122,9,3,12
17385,SpokaneStBridge,12/26/2015 09:00:00 AM,48,-122,8,3,11
17386,SpokaneStBridge,12/26/2015 10:00:00 AM,48,-122,2,9,11
17387,SpokaneStBridge,12/26/2015 11:00:00 AM,48,-122,9,3,12
17388,SpokaneStBridge,12/26/2015 12:00:00 PM,48,-122,6,5,11
17389,SpokaneStBridge,12/26/2015 01:00:00 PM,48,-122,9,10,19
17390,SpokaneStBridge,12/26/2015 02:00:00 PM,48,-122,11,13,24
17391,SpokaneStBridge,12/26/2015 03:00:00 PM,48,-122,16,12,28
17392,SpokaneStBridge,12/26/2015 04:00:00 PM,48,-122,4,4,8
17393,SpokaneStBridge,12/26/2015 05:00:00 PM,48,-122,9,6,15
17394,SpokaneStBridge,12/26/2015 06:00:00 PM,48,-122,4,11,15
17395,SpokaneStBridge,12/26/2015 07:00:00 PM,48,-122,3,2,5
17396,SpokaneStBridge,12/26/2015 08:00:00 PM,48,-122,0,1,1
17397,SpokaneStBridge,12/26/2015 09:00:00 PM,48,-122,0,0,0
17398,SpokaneStBridge,12/26/2015 10:00:00 PM,48,-122,1,3,4
17399,SpokaneStBridge,12/26/2015 11:00:00 PM,48,-122,1,2,3
17400,SpokaneStBridge,12/27/2015 12:00:00 AM,48,-122,4,2,6
17401,SpokaneStBridge,12/27/2015 01:00:00 AM,48,-122,2,1,3
17402,SpokaneStBridge,12/27/2015 02:00:00 AM,48,-122,0,0,0
17403,SpokaneStBridge,12/27/2015 03:00:00 AM,48,-122,0,1,1
17404,SpokaneStBridge,12/27/2015 04:00:00 AM,48,-122,0,1,1
17405,SpokaneStBridge,12/27/2015 05:00:00 AM,48,-122,5,1,6
17406,SpokaneStBridge,12/27/2015 06:00:00 AM,48,-122,2,1,3
17407,SpokaneStBridge,12/27/2015 07:00:00 AM,48,-122,1,5,6
17408,SpokaneStBridge,12/27/2015 08:00:00 AM,48,-122,6,3,9
17409,SpokaneStBridge,12/27/2015 09:00:00 AM,48,-122,7,4,11
17410,SpokaneStBridge,12/27/2015 10:00:00 AM,48,-122,3,3,6
17411,SpokaneStBridge,12/27/2015 11:00:00 AM,48,-122,0,3,3
17412,SpokaneStBridge,12/27/2015 12:00:00 PM,48,-122,2,1,3
17413,SpokaneStBridge,12/27/2015 01:00:00 PM,48,-122,1,0,1
17414,SpokaneStBridge,12/27/2015 02:00:00 PM,48,-122,1,2,3
17415,SpokaneStBridge,12/27/2015 03:00:00 PM,48,-122,0,5,5
17416,SpokaneStBridge,12/27/2015 04:00:00 PM,48,-122,2,0,2
17417,SpokaneStBridge,12/27/2015 05:00:00 PM,48,-122,1,1,2
17418,SpokaneStBridge,12/27/2015 06:00:00 PM,48,-122,0,0,0
17419,SpokaneStBridge,12/27/2015 07:00:00 PM,48,-122,0,1,1
17420,SpokaneStBridge,12/27/2015 08:00:00 PM,48,-122,0,2,2
17421,SpokaneStBridge,12/27/2015 09:00:00 PM,48,-122,0,1,1
17422,SpokaneStBridge,12/27/2015 10:00:00 PM,48,-122,0,0,0
17423,SpokaneStBridge,12/27/2015 11:00:00 PM,48,-122,0,0,0
17424,SpokaneStBridge,12/28/2015 12:00:00 AM,48,-122,1,0,1
17425,SpokaneStBridge,12/28/2015 01:00:00 AM,48,-122,0,0,0
17426,SpokaneStBridge,12/28/2015 02:00:00 AM,48,-122,1,0,1
17427,SpokaneStBridge,12/28/2015 03:00:00 AM,48,-122,0,0,0
17428,SpokaneStBridge,12/28/2015 04:00:00 AM,48,-122,2,1,3
17429,SpokaneStBridge,12/28/2015 05:00:00 AM,48,-122,11,2,13
17430,SpokaneStBridge,12/28/2015 06:00:00 AM,48,-122,14,5,19
17431,SpokaneStBridge,12/28/2015 07:00:00 AM,48,-122,47,6,53
17432,SpokaneStBridge,12/28/2015 08:00:00 AM,48,-122,30,0,30
17433,SpokaneStBridge,12/28/2015 09:00:00 AM,48,-122,25,4,29
17434,SpokaneStBridge,12/28/2015 10:00:00 AM,48,-122,11,1,12
17435,SpokaneStBridge,12/28/2015 11:00:00 AM,48,-122,6,6,12
17436,SpokaneStBridge,12/28/2015 12:00:00 PM,48,-122,7,2,9
17437,SpokaneStBridge,12/28/2015 01:00:00 PM,48,-122,4,6,10
17438,SpokaneStBridge,12/28/2015 02:00:00 PM,48,-122,5,10,15
17439,SpokaneStBridge,12/28/2015 03:00:00 PM,48,-122,3,19,22
17440,SpokaneStBridge,12/28/2015 04:00:00 PM,48,-122,11,33,44
17441,SpokaneStBridge,12/28/2015 05:00:00 PM,48,-122,5,37,42
17442,SpokaneStBridge,12/28/2015 06:00:00 PM,48,-122,4,26,30
17443,SpokaneStBridge,12/28/2015 07:00:00 PM,48,-122,4,12,16
17444,SpokaneStBridge,12/28/2015 08:00:00 PM,48,-122,2,3,5
17445,SpokaneStBridge,12/28/2015 09:00:00 PM,48,-122,1,2,3
17446,SpokaneStBridge,12/28/2015 10:00:00 PM,48,-122,1,1,2
17447,SpokaneStBridge,12/28/2015 11:00:00 PM,48,-122,0,0,0
17448,SpokaneStBridge,12/29/2015 12:00:00 AM,48,-122,0,0,0
17449,SpokaneStBridge,12/29/2015 01:00:00 AM,48,-122,0,0,0
17450,SpokaneStBridge,12/29/2015 02:00:00 AM,48,-122,1,1,2
17451,SpokaneStBridge,12/29/2015 03:00:00 AM,48,-122,1,0,1
17452,SpokaneStBridge,12/29/2015 04:00:00 AM,48,-122,1,1,2
17453,SpokaneStBridge,12/29/2015 05:00:00 AM,48,-122,9,3,12
17454,SpokaneStBridge,12/29/2015 06:00:00 AM,48,-122,20,10,30
17455,SpokaneStBridge,12/29/2015 07:00:00 AM,48,-122,47,5,52
17456,SpokaneStBridge,12/29/2015 08:00:00 AM,48,-122,50,3,53
17457,SpokaneStBridge,12/29/2015 09:00:00 AM,48,-122,27,6,33
17458,SpokaneStBridge,12/29/2015 10:00:00 AM,48,-122,11,4,15
17459,SpokaneStBridge,12/29/2015 11:00:00 AM,48,-122,10,4,14
17460,SpokaneStBridge,12/29/2015 12:00:00 PM,48,-122,5,5,10
17461,SpokaneStBridge,12/29/2015 01:00:00 PM,48,-122,4,11,15
17462,SpokaneStBridge,12/29/2015 02:00:00 PM,48,-122,14,15,29
17463,SpokaneStBridge,12/29/2015 03:00:00 PM,48,-122,5,20,25
17464,SpokaneStBridge,12/29/2015 04:00:00 PM,48,-122,16,41,57
17465,SpokaneStBridge,12/29/2015 05:00:00 PM,48,-122,11,66,77
17466,SpokaneStBridge,12/29/2015 06:00:00 PM,48,-122,7,22,29
17467,SpokaneStBridge,12/29/2015 07:00:00 PM,48,-122,1,9,10
17468,SpokaneStBridge,12/29/2015 08:00:00 PM,48,-122,1,2,3
17469,SpokaneStBridge,12/29/2015 09:00:00 PM,48,-122,1,6,7
17470,SpokaneStBridge,12/29/2015 10:00:00 PM,48,-122,0,1,1
17471,SpokaneStBridge,12/29/2015 11:00:00 PM,48,-122,2,0,2
17472,SpokaneStBridge,12/30/2015 12:00:00 AM,48,-122,1,1,2
17473,SpokaneStBridge,12/30/2015 01:00:00 AM,48,-122,0,0,0
17474,SpokaneStBridge,12/30/2015 02:00:00 AM,48,-122,1,0,1
17475,SpokaneStBridge,12/30/2015 03:00:00 AM,48,-122,0,0,0
17476,SpokaneStBridge,12/30/2015 04:00:00 AM,48,-122,0,1,1
17477,SpokaneStBridge,12/30/2015 05:00:00 AM,48,-122,7,2,9
17478,SpokaneStBridge,12/30/2015 06:00:00 AM,48,-122,13,6,19
17479,SpokaneStBridge,12/30/2015 07:00:00 AM,48,-122,33,10,43
17480,SpokaneStBridge,12/30/2015 08:00:00 AM,48,-122,30,2,32
17481,SpokaneStBridge,12/30/2015 09:00:00 AM,48,-122,20,4,24
17482,SpokaneStBridge,12/30/2015 10:00:00 AM,48,-122,10,4,14
17483,SpokaneStBridge,12/30/2015 11:00:00 AM,48,-122,7,8,15
17484,SpokaneStBridge,12/30/2015 12:00:00 PM,48,-122,14,9,23
17485,SpokaneStBridge,12/30/2015 01:00:00 PM,48,-122,9,10,19
17486,SpokaneStBridge,12/30/2015 02:00:00 PM,48,-122,8,10,18
17487,SpokaneStBridge,12/30/2015 03:00:00 PM,48,-122,7,24,31
17488,SpokaneStBridge,12/30/2015 04:00:00 PM,48,-122,22,36,58
17489,SpokaneStBridge,12/30/2015 05:00:00 PM,48,-122,6,39,45
17490,SpokaneStBridge,12/30/2015 06:00:00 PM,48,-122,11,18,29
17491,SpokaneStBridge,12/30/2015 07:00:00 PM,48,-122,3,13,16
17492,SpokaneStBridge,12/30/2015 08:00:00 PM,48,-122,2,5,7
17493,SpokaneStBridge,12/30/2015 09:00:00 PM,48,-122,0,2,2
17494,SpokaneStBridge,12/30/2015 10:00:00 PM,48,-122,0,2,2
17495,SpokaneStBridge,12/30/2015 11:00:00 PM,48,-122,0,1,1
17496,SpokaneStBridge,12/31/2015 12:00:00 AM,48,-122,2,2,4
17497,SpokaneStBridge,12/31/2015 01:00:00 AM,48,-122,1,1,2
17498,SpokaneStBridge,12/31/2015 02:00:00 AM,48,-122,0,0,0
17499,SpokaneStBridge,12/31/2015 03:00:00 AM,48,-122,0,3,3
17500,SpokaneStBridge,12/31/2015 04:00:00 AM,48,-122,0,0,0
17501,SpokaneStBridge,12/31/2015 05:00:00 AM,48,-122,3,2,5
17502,SpokaneStBridge,12/31/2015 06:00:00 AM,48,-122,18,4,22
17503,SpokaneStBridge,12/31/2015 07:00:00 AM,48,-122,9,5,14
17504,SpokaneStBridge,12/31/2015 08:00:00 AM,48,-122,24,3,27
17505,SpokaneStBridge,12/31/2015 09:00:00 AM,48,-122,10,3,13
17506,SpokaneStBridge,12/31/2015 10:00:00 AM,48,-122,8,3,11
17507,SpokaneStBridge,12/31/2015 11:00:00 AM,48,-122,4,6,10
17508,SpokaneStBridge,12/31/2015 12:00:00 PM,48,-122,6,9,15
17509,SpokaneStBridge,12/31/2015 01:00:00 PM,48,-122,16,14,30
17510,SpokaneStBridge,12/31/2015 02:00:00 PM,48,-122,11,17,28
17511,SpokaneStBridge,12/31/2015 03:00:00 PM,48,-122,17,23,40
17512,SpokaneStBridge,12/31/2015 04:00:00 PM,48,-122,7,12,19
17513,SpokaneStBridge,12/31/2015 05:00:00 PM,48,-122,3,20,23
17514,SpokaneStBridge,12/31/2015 06:00:00 PM,48,-122,6,4,10
17515,SpokaneStBridge,12/31/2015 07:00:00 PM,48,-122,1,4,5
17516,SpokaneStBridge,12/31/2015 08:00:00 PM,48,-122,0,2,2
17517,SpokaneStBridge,12/31/2015 09:00:00 PM,48,-122,2,2,4
17518,SpokaneStBridge,12/31/2015 10:00:00 PM,48,-122,0,0,0
17519,SpokaneStBridge,12/31/2015 11:00:00 PM,48,-122,0,1,1
17520,SpokaneStBridge,01/01/2016 12:00:00 AM,48,-122,0,2,2
17521,SpokaneStBridge,01/01/2016 01:00:00 AM,48,-122,0,1,1
17522,SpokaneStBridge,01/01/2016 02:00:00 AM,48,-122,0,0,0
17523,SpokaneStBridge,01/01/2016 03:00:00 AM,48,-122,0,1,1
17524,SpokaneStBridge,01/01/2016 04:00:00 AM,48,-122,0,2,2
17525,SpokaneStBridge,01/01/2016 05:00:00 AM,48,-122,1,0,1
17526,SpokaneStBridge,01/01/2016 06:00:00 AM,48,-122,1,0,1
17527,SpokaneStBridge,01/01/2016 07:00:00 AM,48,-122,1,1,2
17528,SpokaneStBridge,01/01/2016 08:00:00 AM,48,-122,1,0,1
17529,SpokaneStBridge,01/01/2016 09:00:00 AM,48,-122,0,0,0
17530,SpokaneStBridge,01/01/2016 10:00:00 AM,48,-122,9,4,13
17531,SpokaneStBridge,01/01/2016 11:00:00 AM,48,-122,11,12,23
17532,SpokaneStBridge,01/01/2016 12:00:00 PM,48,-122,9,15,24
17533,SpokaneStBridge,01/01/2016 01:00:00 PM,48,-122,16,18,34
17534,SpokaneStBridge,01/01/2016 02:00:00 PM,48,-122,19,20,39
17535,SpokaneStBridge,01/01/2016 03:00:00 PM,48,-122,16,9,25
17536,SpokaneStBridge,01/01/2016 04:00:00 PM,48,-122,5,6,11
17537,SpokaneStBridge,01/01/2016 05:00:00 PM,48,-122,4,3,7
17538,SpokaneStBridge,01/01/2016 06:00:00 PM,48,-122,6,3,9
17539,SpokaneStBridge,01/01/2016 07:00:00 PM,48,-122,7,2,9
17540,SpokaneStBridge,01/01/2016 08:00:00 PM,48,-122,1,2,3
17541,SpokaneStBridge,01/01/2016 09:00:00 PM,48,-122,1,1,2
17542,SpokaneStBridge,01/01/2016 10:00:00 PM,48,-122,0,0,0
17543,SpokaneStBridge,01/01/2016 11:00:00 PM,48,-122,0,2,2
17544,SpokaneStBridge,01/02/2016 12:00:00 AM,48,-122,0,3,3
17545,SpokaneStBridge,01/02/2016 01:00:00 AM,48,-122,0,0,0
17546,SpokaneStBridge,01/02/2016 02:00:00 AM,48,-122,2,1,3
17547,SpokaneStBridge,01/02/2016 03:00:00 AM,48,-122,0,0,0
17548,SpokaneStBridge,01/02/2016 04:00:00 AM,48,-122,0,1,1
17549,SpokaneStBridge,01/02/2016 05:00:00 AM,48,-122,3,0,3
17550,SpokaneStBridge,01/02/2016 06:00:00 AM,48,-122,1,1,2
17551,SpokaneStBridge,01/02/2016 07:00:00 AM,48,-122,0,0,0
17552,SpokaneStBridge,01/02/2016 08:00:00 AM,48,-122,1,2,3
17553,SpokaneStBridge,01/02/2016 09:00:00 AM,48,-122,11,3,14
17554,SpokaneStBridge,01/02/2016 10:00:00 AM,48,-122,6,10,16
17555,SpokaneStBridge,01/02/2016 11:00:00 AM,48,-122,14,9,23
17556,SpokaneStBridge,01/02/2016 12:00:00 PM,48,-122,11,9,20
17557,SpokaneStBridge,01/02/2016 01:00:00 PM,48,-122,16,11,27
17558,SpokaneStBridge,01/02/2016 02:00:00 PM,48,-122,8,16,24
17559,SpokaneStBridge,01/02/2016 03:00:00 PM,48,-122,9,17,26
17560,SpokaneStBridge,01/02/2016 04:00:00 PM,48,-122,13,9,22
17561,SpokaneStBridge,01/02/2016 05:00:00 PM,48,-122,5,6,11
17562,SpokaneStBridge,01/02/2016 06:00:00 PM,48,-122,4,0,4
17563,SpokaneStBridge,01/02/2016 07:00:00 PM,48,-122,0,1,1
17564,SpokaneStBridge,01/02/2016 08:00:00 PM,48,-122,0,4,4
17565,SpokaneStBridge,01/02/2016 09:00:00 PM,48,-122,2,2,4
17566,SpokaneStBridge,01/02/2016 10:00:00 PM,48,-122,1,0,1
17567,SpokaneStBridge,01/02/2016 11:00:00 PM,48,-122,0,1,1
17568,SpokaneStBridge,01/03/2016 12:00:00 AM,48,-122,0,0,0
17569,SpokaneStBridge,01/03/2016 01:00:00 AM,48,-122,0,1,1
17570,SpokaneStBridge,01/03/2016 02:00:00 AM,48,-122,0,0,0
17571,SpokaneStBridge,01/03/2016 03:00:00 AM,48,-122,1,0,1
17572,SpokaneStBridge,01/03/2016 04:00:00 AM,48,-122,0,2,2
17573,SpokaneStBridge,01/03/2016 05:00:00 AM,48,-122,3,1,4
17574,SpokaneStBridge,01/03/2016 06:00:00 AM,48,-122,3,1,4
17575,SpokaneStBridge,01/03/2016 07:00:00 AM,48,-122,2,0,2
17576,SpokaneStBridge,01/03/2016 08:00:00 AM,48,-122,2,3,5
17577,SpokaneStBridge,01/03/2016 09:00:00 AM,48,-122,6,1,7
17578,SpokaneStBridge,01/03/2016 10:00:00 AM,48,-122,3,7,10
17579,SpokaneStBridge,01/03/2016 11:00:00 AM,48,-122,13,5,18
17580,SpokaneStBridge,01/03/2016 12:00:00 PM,48,-122,13,9,22
17581,SpokaneStBridge,01/03/2016 01:00:00 PM,48,-122,11,10,21
17582,SpokaneStBridge,01/03/2016 02:00:00 PM,48,-122,4,3,7
17583,SpokaneStBridge,01/03/2016 03:00:00 PM,48,-122,4,5,9
17584,SpokaneStBridge,01/03/2016 04:00:00 PM,48,-122,1,1,2
17585,SpokaneStBridge,01/03/2016 05:00:00 PM,48,-122,2,5,7
17586,SpokaneStBridge,01/03/2016 06:00:00 PM,48,-122,0,3,3
17587,SpokaneStBridge,01/03/2016 07:00:00 PM,48,-122,2,2,4
17588,SpokaneStBridge,01/03/2016 08:00:00 PM,48,-122,0,3,3
17589,SpokaneStBridge,01/03/2016 09:00:00 PM,48,-122,1,1,2
17590,SpokaneStBridge,01/03/2016 10:00:00 PM,48,-122,0,1,1
17591,SpokaneStBridge,01/03/2016 11:00:00 PM,48,-122,0,0,0
17592,SpokaneStBridge,01/04/2016 12:00:00 AM,48,-122,0,0,0
17593,SpokaneStBridge,01/04/2016 01:00:00 AM,48,-122,0,0,0
17594,SpokaneStBridge,01/04/2016 02:00:00 AM,48,-122,1,0,1
17595,SpokaneStBridge,01/04/2016 03:00:00 AM,48,-122,1,2,3
17596,SpokaneStBridge,01/04/2016 04:00:00 AM,48,-122,0,1,1
17597,SpokaneStBridge,01/04/2016 05:00:00 AM,48,-122,8,1,9
17598,SpokaneStBridge,01/04/2016 06:00:00 AM,48,-122,30,5,35
17599,SpokaneStBridge,01/04/2016 07:00:00 AM,48,-122,58,5,63
17600,SpokaneStBridge,01/04/2016 08:00:00 AM,48,-122,77,5,82
17601,SpokaneStBridge,01/04/2016 09:00:00 AM,48,-122,22,0,22
17602,SpokaneStBridge,01/04/2016 10:00:00 AM,48,-122,10,3,13
17603,SpokaneStBridge,01/04/2016 11:00:00 AM,48,-122,2,4,6
17604,SpokaneStBridge,01/04/2016 12:00:00 PM,48,-122,3,2,5
17605,SpokaneStBridge,01/04/2016 01:00:00 PM,48,-122,3,2,5
17606,SpokaneStBridge,01/04/2016 02:00:00 PM,48,-122,4,3,7
17607,SpokaneStBridge,01/04/2016 03:00:00 PM,48,-122,3,15,18
17608,SpokaneStBridge,01/04/2016 04:00:00 PM,48,-122,8,44,52
17609,SpokaneStBridge,01/04/2016 05:00:00 PM,48,-122,12,78,90
17610,SpokaneStBridge,01/04/2016 06:00:00 PM,48,-122,4,33,37
17611,SpokaneStBridge,01/04/2016 07:00:00 PM,48,-122,2,21,23
17612,SpokaneStBridge,01/04/2016 08:00:00 PM,48,-122,1,5,6
17613,SpokaneStBridge,01/04/2016 09:00:00 PM,48,-122,0,1,1
17614,SpokaneStBridge,01/04/2016 10:00:00 PM,48,-122,0,1,1
17615,SpokaneStBridge,01/04/2016 11:00:00 PM,48,-122,0,1,1
17616,SpokaneStBridge,01/05/2016 12:00:00 AM,48,-122,0,0,0
17617,SpokaneStBridge,01/05/2016 01:00:00 AM,48,-122,1,0,1
17618,SpokaneStBridge,01/05/2016 02:00:00 AM,48,-122,1,1,2
17619,SpokaneStBridge,01/05/2016 03:00:00 AM,48,-122,1,2,3
17620,SpokaneStBridge,01/05/2016 04:00:00 AM,48,-122,0,0,0
17621,SpokaneStBridge,01/05/2016 05:00:00 AM,48,-122,11,2,13
17622,SpokaneStBridge,01/05/2016 06:00:00 AM,48,-122,41,7,48
17623,SpokaneStBridge,01/05/2016 07:00:00 AM,48,-122,62,14,76
17624,SpokaneStBridge,01/05/2016 08:00:00 AM,48,-122,69,4,73
17625,SpokaneStBridge,01/05/2016 09:00:00 AM,48,-122,29,1,30
17626,SpokaneStBridge,01/05/2016 10:00:00 AM,48,-122,8,3,11
17627,SpokaneStBridge,01/05/2016 11:00:00 AM,48,-122,4,4,8
17628,SpokaneStBridge,01/05/2016 12:00:00 PM,48,-122,1,3,4
17629,SpokaneStBridge,01/05/2016 01:00:00 PM,48,-122,3,4,7
17630,SpokaneStBridge,01/05/2016 02:00:00 PM,48,-122,5,6,11
17631,SpokaneStBridge,01/05/2016 03:00:00 PM,48,-122,2,15,17
17632,SpokaneStBridge,01/05/2016 04:00:00 PM,48,-122,11,36,47
17633,SpokaneStBridge,01/05/2016 05:00:00 PM,48,-122,12,82,94
17634,SpokaneStBridge,01/05/2016 06:00:00 PM,48,-122,6,35,41
17635,SpokaneStBridge,01/05/2016 07:00:00 PM,48,-122,1,16,17
17636,SpokaneStBridge,01/05/2016 08:00:00 PM,48,-122,4,10,14
17637,SpokaneStBridge,01/05/2016 09:00:00 PM,48,-122,0,2,2
17638,SpokaneStBridge,01/05/2016 10:00:00 PM,48,-122,0,4,4
17639,SpokaneStBridge,01/05/2016 11:00:00 PM,48,-122,0,1,1
17640,SpokaneStBridge,01/06/2016 12:00:00 AM,48,-122,0,1,1
17641,SpokaneStBridge,01/06/2016 01:00:00 AM,48,-122,0,0,0
17642,SpokaneStBridge,01/06/2016 02:00:00 AM,48,-122,1,0,1
17643,SpokaneStBridge,01/06/2016 03:00:00 AM,48,-122,0,1,1
17644,SpokaneStBridge,01/06/2016 04:00:00 AM,48,-122,1,0,1
17645,SpokaneStBridge,01/06/2016 05:00:00 AM,48,-122,15,3,18
17646,SpokaneStBridge,01/06/2016 06:00:00 AM,48,-122,41,3,44
17647,SpokaneStBridge,01/06/2016 07:00:00 AM,48,-122,75,10,85
17648,SpokaneStBridge,01/06/2016 08:00:00 AM,48,-122,85,11,96
17649,SpokaneStBridge,01/06/2016 09:00:00 AM,48,-122,38,4,42
17650,SpokaneStBridge,01/06/2016 10:00:00 AM,48,-122,14,5,19
17651,SpokaneStBridge,01/06/2016 11:00:00 AM,48,-122,12,2,14
17652,SpokaneStBridge,01/06/2016 12:00:00 PM,48,-122,6,9,15
17653,SpokaneStBridge,01/06/2016 01:00:00 PM,48,-122,11,7,18
17654,SpokaneStBridge,01/06/2016 02:00:00 PM,48,-122,10,22,32
17655,SpokaneStBridge,01/06/2016 03:00:00 PM,48,-122,13,25,38
17656,SpokaneStBridge,01/06/2016 04:00:00 PM,48,-122,13,57,70
17657,SpokaneStBridge,01/06/2016 05:00:00 PM,48,-122,9,101,110
17658,SpokaneStBridge,01/06/2016 06:00:00 PM,48,-122,10,44,54
17659,SpokaneStBridge,01/06/2016 07:00:00 PM,48,-122,0,21,21
17660,SpokaneStBridge,01/06/2016 08:00:00 PM,48,-122,3,15,18
17661,SpokaneStBridge,01/06/2016 09:00:00 PM,48,-122,1,8,9
17662,SpokaneStBridge,01/06/2016 10:00:00 PM,48,-122,1,2,3
17663,SpokaneStBridge,01/06/2016 11:00:00 PM,48,-122,1,1,2
17664,SpokaneStBridge,01/07/2016 12:00:00 AM,48,-122,1,2,3
17665,SpokaneStBridge,01/07/2016 01:00:00 AM,48,-122,0,0,0
17666,SpokaneStBridge,01/07/2016 02:00:00 AM,48,-122,1,1,2
17667,SpokaneStBridge,01/07/2016 03:00:00 AM,48,-122,0,0,0
17668,SpokaneStBridge,01/07/2016 04:00:00 AM,48,-122,0,0,0
17669,SpokaneStBridge,01/07/2016 05:00:00 AM,48,-122,12,3,15
17670,SpokaneStBridge,01/07/2016 06:00:00 AM,48,-122,43,4,47
17671,SpokaneStBridge,01/07/2016 07:00:00 AM,48,-122,72,13,85
17672,SpokaneStBridge,01/07/2016 08:00:00 AM,48,-122,85,10,95
17673,SpokaneStBridge,01/07/2016 09:00:00 AM,48,-122,31,1,32
17674,SpokaneStBridge,01/07/2016 10:00:00 AM,48,-122,13,2,15
17675,SpokaneStBridge,01/07/2016 11:00:00 AM,48,-122,7,2,9
17676,SpokaneStBridge,01/07/2016 12:00:00 PM,48,-122,4,6,10
17677,SpokaneStBridge,01/07/2016 01:00:00 PM,48,-122,14,7,21
17678,SpokaneStBridge,01/07/2016 02:00:00 PM,48,-122,9,14,23
17679,SpokaneStBridge,01/07/2016 03:00:00 PM,48,-122,8,17,25
17680,SpokaneStBridge,01/07/2016 04:00:00 PM,48,-122,12,43,55
17681,SpokaneStBridge,01/07/2016 05:00:00 PM,48,-122,12,90,102
17682,SpokaneStBridge,01/07/2016 06:00:00 PM,48,-122,12,52,64
17683,SpokaneStBridge,01/07/2016 07:00:00 PM,48,-122,7,19,26
17684,SpokaneStBridge,01/07/2016 08:00:00 PM,48,-122,0,4,4
17685,SpokaneStBridge,01/07/2016 09:00:00 PM,48,-122,1,9,10
17686,SpokaneStBridge,01/07/2016 10:00:00 PM,48,-122,0,7,7
17687,SpokaneStBridge,01/07/2016 11:00:00 PM,48,-122,1,3,4
17688,SpokaneStBridge,01/08/2016 12:00:00 AM,48,-122,1,5,6
17689,SpokaneStBridge,01/08/2016 01:00:00 AM,48,-122,1,0,1
17690,SpokaneStBridge,01/08/2016 02:00:00 AM,48,-122,1,0,1
17691,SpokaneStBridge,01/08/2016 03:00:00 AM,48,-122,3,2,5
17692,SpokaneStBridge,01/08/2016 04:00:00 AM,48,-122,0,1,1
17693,SpokaneStBridge,01/08/2016 05:00:00 AM,48,-122,5,2,7
17694,SpokaneStBridge,01/08/2016 06:00:00 AM,48,-122,35,3,38
17695,SpokaneStBridge,01/08/2016 07:00:00 AM,48,-122,62,7,69
17696,SpokaneStBridge,01/08/2016 08:00:00 AM,48,-122,74,7,81
17697,SpokaneStBridge,01/08/2016 09:00:00 AM,48,-122,26,2,28
17698,SpokaneStBridge,01/08/2016 10:00:00 AM,48,-122,7,1,8
17699,SpokaneStBridge,01/08/2016 11:00:00 AM,48,-122,9,12,21
17700,SpokaneStBridge,01/08/2016 12:00:00 PM,48,-122,14,10,24
17701,SpokaneStBridge,01/08/2016 01:00:00 PM,48,-122,13,4,17
17702,SpokaneStBridge,01/08/2016 02:00:00 PM,48,-122,9,18,27
17703,SpokaneStBridge,01/08/2016 03:00:00 PM,48,-122,12,27,39
17704,SpokaneStBridge,01/08/2016 04:00:00 PM,48,-122,14,51,65
17705,SpokaneStBridge,01/08/2016 05:00:00 PM,48,-122,7,83,90
17706,SpokaneStBridge,01/08/2016 06:00:00 PM,48,-122,6,43,49
17707,SpokaneStBridge,01/08/2016 07:00:00 PM,48,-122,7,12,19
17708,SpokaneStBridge,01/08/2016 08:00:00 PM,48,-122,2,6,8
17709,SpokaneStBridge,01/08/2016 09:00:00 PM,48,-122,2,7,9
17710,SpokaneStBridge,01/08/2016 10:00:00 PM,48,-122,1,3,4
17711,SpokaneStBridge,01/08/2016 11:00:00 PM,48,-122,0,2,2
17712,SpokaneStBridge,01/09/2016 12:00:00 AM,48,-122,2,4,6
17713,SpokaneStBridge,01/09/2016 01:00:00 AM,48,-122,1,2,3
17714,SpokaneStBridge,01/09/2016 02:00:00 AM,48,-122,1,0,1
17715,SpokaneStBridge,01/09/2016 03:00:00 AM,48,-122,1,1,2
17716,SpokaneStBridge,01/09/2016 04:00:00 AM,48,-122,1,0,1
17717,SpokaneStBridge,01/09/2016 05:00:00 AM,48,-122,4,1,5
17718,SpokaneStBridge,01/09/2016 06:00:00 AM,48,-122,2,0,2
17719,SpokaneStBridge,01/09/2016 07:00:00 AM,48,-122,5,4,9
17720,SpokaneStBridge,01/09/2016 08:00:00 AM,48,-122,9,6,15
17721,SpokaneStBridge,01/09/2016 09:00:00 AM,48,-122,18,3,21
17722,SpokaneStBridge,01/09/2016 10:00:00 AM,48,-122,5,12,17
17723,SpokaneStBridge,01/09/2016 11:00:00 AM,48,-122,15,13,28
17724,SpokaneStBridge,01/09/2016 12:00:00 PM,48,-122,18,19,37
17725,SpokaneStBridge,01/09/2016 01:00:00 PM,48,-122,15,14,29
17726,SpokaneStBridge,01/09/2016 02:00:00 PM,48,-122,19,30,49
17727,SpokaneStBridge,01/09/2016 03:00:00 PM,48,-122,27,26,53
17728,SpokaneStBridge,01/09/2016 04:00:00 PM,48,-122,16,14,30
17729,SpokaneStBridge,01/09/2016 05:00:00 PM,48,-122,2,5,7
17730,SpokaneStBridge,01/09/2016 06:00:00 PM,48,-122,4,2,6
17731,SpokaneStBridge,01/09/2016 07:00:00 PM,48,-122,3,4,7
17732,SpokaneStBridge,01/09/2016 08:00:00 PM,48,-122,4,2,6
17733,SpokaneStBridge,01/09/2016 09:00:00 PM,48,-122,0,2,2
17734,SpokaneStBridge,01/09/2016 10:00:00 PM,48,-122,0,4,4
17735,SpokaneStBridge,01/09/2016 11:00:00 PM,48,-122,0,3,3
17736,SpokaneStBridge,01/10/2016 12:00:00 AM,48,-122,0,0,0
17737,SpokaneStBridge,01/10/2016 01:00:00 AM,48,-122,0,0,0
17738,SpokaneStBridge,01/10/2016 02:00:00 AM,48,-122,0,2,2
17739,SpokaneStBridge,01/10/2016 03:00:00 AM,48,-122,0,1,1
17740,SpokaneStBridge,01/10/2016 04:00:00 AM,48,-122,0,0,0
17741,SpokaneStBridge,01/10/2016 05:00:00 AM,48,-122,3,0,3
17742,SpokaneStBridge,01/10/2016 06:00:00 AM,48,-122,1,0,1
17743,SpokaneStBridge,01/10/2016 07:00:00 AM,48,-122,1,0,1
17744,SpokaneStBridge,01/10/2016 08:00:00 AM,48,-122,8,8,16
17745,SpokaneStBridge,01/10/2016 09:00:00 AM,48,-122,8,10,18
17746,SpokaneStBridge,01/10/2016 10:00:00 AM,48,-122,12,16,28
17747,SpokaneStBridge,01/10/2016 11:00:00 AM,48,-122,6,9,15
17748,SpokaneStBridge,01/10/2016 12:00:00 PM,48,-122,20,7,27
17749,SpokaneStBridge,01/10/2016 01:00:00 PM,48,-122,15,16,31
17750,SpokaneStBridge,01/10/2016 02:00:00 PM,48,-122,17,24,41
17751,SpokaneStBridge,01/10/2016 03:00:00 PM,48,-122,26,26,52
17752,SpokaneStBridge,01/10/2016 04:00:00 PM,48,-122,15,12,27
17753,SpokaneStBridge,01/10/2016 05:00:00 PM,48,-122,9,2,11
17754,SpokaneStBridge,01/10/2016 06:00:00 PM,48,-122,3,1,4
17755,SpokaneStBridge,01/10/2016 07:00:00 PM,48,-122,0,4,4
17756,SpokaneStBridge,01/10/2016 08:00:00 PM,48,-122,0,1,1
17757,SpokaneStBridge,01/10/2016 09:00:00 PM,48,-122,0,0,0
17758,SpokaneStBridge,01/10/2016 10:00:00 PM,48,-122,0,0,0
17759,SpokaneStBridge,01/10/2016 11:00:00 PM,48,-122,0,1,1
17760,SpokaneStBridge,01/11/2016 12:00:00 AM,48,-122,0,2,2
17761,SpokaneStBridge,01/11/2016 01:00:00 AM,48,-122,1,1,2
17762,SpokaneStBridge,01/11/2016 02:00:00 AM,48,-122,1,0,1
17763,SpokaneStBridge,01/11/2016 03:00:00 AM,48,-122,1,1,2
17764,SpokaneStBridge,01/11/2016 04:00:00 AM,48,-122,0,0,0
17765,SpokaneStBridge,01/11/2016 05:00:00 AM,48,-122,13,0,13
17766,SpokaneStBridge,01/11/2016 06:00:00 AM,48,-122,43,3,46
17767,SpokaneStBridge,01/11/2016 07:00:00 AM,48,-122,84,13,97
17768,SpokaneStBridge,01/11/2016 08:00:00 AM,48,-122,76,11,87
17769,SpokaneStBridge,01/11/2016 09:00:00 AM,48,-122,25,3,28
17770,SpokaneStBridge,01/11/2016 10:00:00 AM,48,-122,9,1,10
17771,SpokaneStBridge,01/11/2016 11:00:00 AM,48,-122,5,2,7
17772,SpokaneStBridge,01/11/2016 12:00:00 PM,48,-122,3,4,7
17773,SpokaneStBridge,01/11/2016 01:00:00 PM,48,-122,5,2,7
17774,SpokaneStBridge,01/11/2016 02:00:00 PM,48,-122,7,4,11
17775,SpokaneStBridge,01/11/2016 03:00:00 PM,48,-122,8,22,30
17776,SpokaneStBridge,01/11/2016 04:00:00 PM,48,-122,11,43,54
17777,SpokaneStBridge,01/11/2016 05:00:00 PM,48,-122,10,102,112
17778,SpokaneStBridge,01/11/2016 06:00:00 PM,48,-122,6,46,52
17779,SpokaneStBridge,01/11/2016 07:00:00 PM,48,-122,2,13,15
17780,SpokaneStBridge,01/11/2016 08:00:00 PM,48,-122,1,7,8
17781,SpokaneStBridge,01/11/2016 09:00:00 PM,48,-122,4,10,14
17782,SpokaneStBridge,01/11/2016 10:00:00 PM,48,-122,2,4,6
17783,SpokaneStBridge,01/11/2016 11:00:00 PM,48,-122,0,2,2
17784,SpokaneStBridge,01/12/2016 12:00:00 AM,48,-122,0,0,0
17785,SpokaneStBridge,01/12/2016 01:00:00 AM,48,-122,1,0,1
17786,SpokaneStBridge,01/12/2016 02:00:00 AM,48,-122,1,0,1
17787,SpokaneStBridge,01/12/2016 03:00:00 AM,48,-122,0,2,2
17788,SpokaneStBridge,01/12/2016 04:00:00 AM,48,-122,1,1,2
17789,SpokaneStBridge,01/12/2016 05:00:00 AM,48,-122,13,1,14
17790,SpokaneStBridge,01/12/2016 06:00:00 AM,48,-122,38,7,45
17791,SpokaneStBridge,01/12/2016 07:00:00 AM,48,-122,67,12,79
17792,SpokaneStBridge,01/12/2016 08:00:00 AM,48,-122,84,3,87
17793,SpokaneStBridge,01/12/2016 09:00:00 AM,48,-122,26,2,28
17794,SpokaneStBridge,01/12/2016 10:00:00 AM,48,-122,7,0,7
17795,SpokaneStBridge,01/12/2016 11:00:00 AM,48,-122,8,2,10
17796,SpokaneStBridge,01/12/2016 12:00:00 PM,48,-122,3,3,6
17797,SpokaneStBridge,01/12/2016 01:00:00 PM,48,-122,5,3,8
17798,SpokaneStBridge,01/12/2016 02:00:00 PM,48,-122,1,3,4
17799,SpokaneStBridge,01/12/2016 03:00:00 PM,48,-122,3,11,14
17800,SpokaneStBridge,01/12/2016 04:00:00 PM,48,-122,8,33,41
17801,SpokaneStBridge,01/12/2016 05:00:00 PM,48,-122,12,87,99
17802,SpokaneStBridge,01/12/2016 06:00:00 PM,48,-122,10,52,62
17803,SpokaneStBridge,01/12/2016 07:00:00 PM,48,-122,1,11,12
17804,SpokaneStBridge,01/12/2016 08:00:00 PM,48,-122,3,7,10
17805,SpokaneStBridge,01/12/2016 09:00:00 PM,48,-122,1,5,6
17806,SpokaneStBridge,01/12/2016 10:00:00 PM,48,-122,0,5,5
17807,SpokaneStBridge,01/12/2016 11:00:00 PM,48,-122,0,2,2
17808,SpokaneStBridge,01/13/2016 12:00:00 AM,48,-122,0,0,0
17809,SpokaneStBridge,01/13/2016 01:00:00 AM,48,-122,1,0,1
17810,SpokaneStBridge,01/13/2016 02:00:00 AM,48,-122,1,1,2
17811,SpokaneStBridge,01/13/2016 03:00:00 AM,48,-122,0,1,1
17812,SpokaneStBridge,01/13/2016 04:00:00 AM,48,-122,1,0,1
17813,SpokaneStBridge,01/13/2016 05:00:00 AM,48,-122,17,2,19
17814,SpokaneStBridge,01/13/2016 06:00:00 AM,48,-122,32,3,35
17815,SpokaneStBridge,01/13/2016 07:00:00 AM,48,-122,56,8,64
17816,SpokaneStBridge,01/13/2016 08:00:00 AM,48,-122,70,6,76
17817,SpokaneStBridge,01/13/2016 09:00:00 AM,48,-122,16,0,16
17818,SpokaneStBridge,01/13/2016 10:00:00 AM,48,-122,10,1,11
17819,SpokaneStBridge,01/13/2016 11:00:00 AM,48,-122,3,1,4
17820,SpokaneStBridge,01/13/2016 12:00:00 PM,48,-122,2,0,2
17821,SpokaneStBridge,01/13/2016 01:00:00 PM,48,-122,3,4,7
17822,SpokaneStBridge,01/13/2016 02:00:00 PM,48,-122,6,10,16
17823,SpokaneStBridge,01/13/2016 03:00:00 PM,48,-122,9,17,26
17824,SpokaneStBridge,01/13/2016 04:00:00 PM,48,-122,11,30,41
17825,SpokaneStBridge,01/13/2016 05:00:00 PM,48,-122,8,80,88
17826,SpokaneStBridge,01/13/2016 06:00:00 PM,48,-122,11,52,63
17827,SpokaneStBridge,01/13/2016 07:00:00 PM,48,-122,3,16,19
17828,SpokaneStBridge,01/13/2016 08:00:00 PM,48,-122,2,8,10
17829,SpokaneStBridge,01/13/2016 09:00:00 PM,48,-122,0,4,4
17830,SpokaneStBridge,01/13/2016 10:00:00 PM,48,-122,0,4,4
17831,SpokaneStBridge,01/13/2016 11:00:00 PM,48,-122,2,3,5
17832,SpokaneStBridge,01/14/2016 12:00:00 AM,48,-122,0,3,3
17833,SpokaneStBridge,01/14/2016 01:00:00 AM,48,-122,0,0,0
17834,SpokaneStBridge,01/14/2016 02:00:00 AM,48,-122,2,0,2
17835,SpokaneStBridge,01/14/2016 03:00:00 AM,48,-122,0,0,0
17836,SpokaneStBridge,01/14/2016 04:00:00 AM,48,-122,2,0,2
17837,SpokaneStBridge,01/14/2016 05:00:00 AM,48,-122,17,2,19
17838,SpokaneStBridge,01/14/2016 06:00:00 AM,48,-122,34,8,42
17839,SpokaneStBridge,01/14/2016 07:00:00 AM,48,-122,71,11,82
17840,SpokaneStBridge,01/14/2016 08:00:00 AM,48,-122,96,15,111
17841,SpokaneStBridge,01/14/2016 09:00:00 AM,48,-122,42,2,44
17842,SpokaneStBridge,01/14/2016 10:00:00 AM,48,-122,13,4,17
17843,SpokaneStBridge,01/14/2016 11:00:00 AM,48,-122,9,4,13
17844,SpokaneStBridge,01/14/2016 12:00:00 PM,48,-122,12,8,20
17845,SpokaneStBridge,01/14/2016 01:00:00 PM,48,-122,8,12,20
17846,SpokaneStBridge,01/14/2016 02:00:00 PM,48,-122,10,8,18
17847,SpokaneStBridge,01/14/2016 03:00:00 PM,48,-122,15,28,43
17848,SpokaneStBridge,01/14/2016 04:00:00 PM,48,-122,15,52,67
17849,SpokaneStBridge,01/14/2016 05:00:00 PM,48,-122,11,107,118
17850,SpokaneStBridge,01/14/2016 06:00:00 PM,48,-122,9,50,59
17851,SpokaneStBridge,01/14/2016 07:00:00 PM,48,-122,1,18,19
17852,SpokaneStBridge,01/14/2016 08:00:00 PM,48,-122,1,12,13
17853,SpokaneStBridge,01/14/2016 09:00:00 PM,48,-122,1,8,9
17854,SpokaneStBridge,01/14/2016 10:00:00 PM,48,-122,1,2,3
17855,SpokaneStBridge,01/14/2016 11:00:00 PM,48,-122,0,2,2
17856,SpokaneStBridge,01/15/2016 12:00:00 AM,48,-122,2,4,6
17857,SpokaneStBridge,01/15/2016 01:00:00 AM,48,-122,1,0,1
17858,SpokaneStBridge,01/15/2016 02:00:00 AM,48,-122,0,1,1
17859,SpokaneStBridge,01/15/2016 03:00:00 AM,48,-122,0,0,0
17860,SpokaneStBridge,01/15/2016 04:00:00 AM,48,-122,2,0,2
17861,SpokaneStBridge,01/15/2016 05:00:00 AM,48,-122,7,5,12
17862,SpokaneStBridge,01/15/2016 06:00:00 AM,48,-122,27,6,33
17863,SpokaneStBridge,01/15/2016 07:00:00 AM,48,-122,57,10,67
17864,SpokaneStBridge,01/15/2016 08:00:00 AM,48,-122,65,8,73
17865,SpokaneStBridge,01/15/2016 09:00:00 AM,48,-122,30,3,33
17866,SpokaneStBridge,01/15/2016 10:00:00 AM,48,-122,11,6,17
17867,SpokaneStBridge,01/15/2016 11:00:00 AM,48,-122,5,5,10
17868,SpokaneStBridge,01/15/2016 12:00:00 PM,48,-122,8,10,18
17869,SpokaneStBridge,01/15/2016 01:00:00 PM,48,-122,8,7,15
17870,SpokaneStBridge,01/15/2016 02:00:00 PM,48,-122,12,8,20
17871,SpokaneStBridge,01/15/2016 03:00:00 PM,48,-122,7,17,24
17872,SpokaneStBridge,01/15/2016 04:00:00 PM,48,-122,10,45,55
17873,SpokaneStBridge,01/15/2016 05:00:00 PM,48,-122,7,63,70
17874,SpokaneStBridge,01/15/2016 06:00:00 PM,48,-122,8,37,45
17875,SpokaneStBridge,01/15/2016 07:00:00 PM,48,-122,3,10,13
17876,SpokaneStBridge,01/15/2016 08:00:00 PM,48,-122,1,3,4
17877,SpokaneStBridge,01/15/2016 09:00:00 PM,48,-122,2,3,5
17878,SpokaneStBridge,01/15/2016 10:00:00 PM,48,-122,1,7,8
17879,SpokaneStBridge,01/15/2016 11:00:00 PM,48,-122,0,2,2
17880,SpokaneStBridge,01/16/2016 12:00:00 AM,48,-122,3,0,3
17881,SpokaneStBridge,01/16/2016 01:00:00 AM,48,-122,0,3,3
17882,SpokaneStBridge,01/16/2016 02:00:00 AM,48,-122,1,1,2
17883,SpokaneStBridge,01/16/2016 03:00:00 AM,48,-122,0,0,0
17884,SpokaneStBridge,01/16/2016 04:00:00 AM,48,-122,0,0,0
17885,SpokaneStBridge,01/16/2016 05:00:00 AM,48,-122,2,0,2
17886,SpokaneStBridge,01/16/2016 06:00:00 AM,48,-122,2,0,2
17887,SpokaneStBridge,01/16/2016 07:00:00 AM,48,-122,2,0,2
17888,SpokaneStBridge,01/16/2016 08:00:00 AM,48,-122,5,0,5
17889,SpokaneStBridge,01/16/2016 09:00:00 AM,48,-122,6,2,8
17890,SpokaneStBridge,01/16/2016 10:00:00 AM,48,-122,9,6,15
17891,SpokaneStBridge,01/16/2016 11:00:00 AM,48,-122,12,5,17
17892,SpokaneStBridge,01/16/2016 12:00:00 PM,48,-122,15,6,21
17893,SpokaneStBridge,01/16/2016 01:00:00 PM,48,-122,6,9,15
17894,SpokaneStBridge,01/16/2016 02:00:00 PM,48,-122,11,9,20
17895,SpokaneStBridge,01/16/2016 03:00:00 PM,48,-122,5,7,12
17896,SpokaneStBridge,01/16/2016 04:00:00 PM,48,-122,3,4,7
17897,SpokaneStBridge,01/16/2016 05:00:00 PM,48,-122,6,3,9
17898,SpokaneStBridge,01/16/2016 06:00:00 PM,48,-122,3,1,4
17899,SpokaneStBridge,01/16/2016 07:00:00 PM,48,-122,2,2,4
17900,SpokaneStBridge,01/16/2016 08:00:00 PM,48,-122,0,3,3
17901,SpokaneStBridge,01/16/2016 09:00:00 PM,48,-122,3,2,5
17902,SpokaneStBridge,01/16/2016 10:00:00 PM,48,-122,0,0,0
17903,SpokaneStBridge,01/16/2016 11:00:00 PM,48,-122,0,0,0
17904,SpokaneStBridge,01/17/2016 12:00:00 AM,48,-122,1,4,5
17905,SpokaneStBridge,01/17/2016 01:00:00 AM,48,-122,0,1,1
17906,SpokaneStBridge,01/17/2016 02:00:00 AM,48,-122,0,0,0
17907,SpokaneStBridge,01/17/2016 03:00:00 AM,48,-122,0,1,1
17908,SpokaneStBridge,01/17/2016 04:00:00 AM,48,-122,0,1,1
17909,SpokaneStBridge,01/17/2016 05:00:00 AM,48,-122,3,1,4
17910,SpokaneStBridge,01/17/2016 06:00:00 AM,48,-122,5,0,5
17911,SpokaneStBridge,01/17/2016 07:00:00 AM,48,-122,0,0,0
17912,SpokaneStBridge,01/17/2016 08:00:00 AM,48,-122,4,3,7
17913,SpokaneStBridge,01/17/2016 09:00:00 AM,48,-122,2,1,3
17914,SpokaneStBridge,01/17/2016 10:00:00 AM,48,-122,1,1,2
17915,SpokaneStBridge,01/17/2016 11:00:00 AM,48,-122,3,3,6
17916,SpokaneStBridge,01/17/2016 12:00:00 PM,48,-122,3,7,10
17917,SpokaneStBridge,01/17/2016 01:00:00 PM,48,-122,3,6,9
17918,SpokaneStBridge,01/17/2016 02:00:00 PM,48,-122,5,3,8
17919,SpokaneStBridge,01/17/2016 03:00:00 PM,48,-122,4,7,11
17920,SpokaneStBridge,01/17/2016 04:00:00 PM,48,-122,2,3,5
17921,SpokaneStBridge,01/17/2016 05:00:00 PM,48,-122,4,2,6
17922,SpokaneStBridge,01/17/2016 06:00:00 PM,48,-122,0,3,3
17923,SpokaneStBridge,01/17/2016 07:00:00 PM,48,-122,0,2,2
17924,SpokaneStBridge,01/17/2016 08:00:00 PM,48,-122,0,2,2
17925,SpokaneStBridge,01/17/2016 09:00:00 PM,48,-122,1,2,3
17926,SpokaneStBridge,01/17/2016 10:00:00 PM,48,-122,0,0,0
17927,SpokaneStBridge,01/17/2016 11:00:00 PM,48,-122,0,1,1
17928,SpokaneStBridge,01/18/2016 12:00:00 AM,48,-122,0,0,0
17929,SpokaneStBridge,01/18/2016 01:00:00 AM,48,-122,0,0,0
17930,SpokaneStBridge,01/18/2016 02:00:00 AM,48,-122,0,0,0
17931,SpokaneStBridge,01/18/2016 03:00:00 AM,48,-122,1,1,2
17932,SpokaneStBridge,01/18/2016 04:00:00 AM,48,-122,2,0,2
17933,SpokaneStBridge,01/18/2016 05:00:00 AM,48,-122,4,1,5
17934,SpokaneStBridge,01/18/2016 06:00:00 AM,48,-122,17,6,23
17935,SpokaneStBridge,01/18/2016 07:00:00 AM,48,-122,37,4,41
17936,SpokaneStBridge,01/18/2016 08:00:00 AM,48,-122,45,3,48
17937,SpokaneStBridge,01/18/2016 09:00:00 AM,48,-122,24,4,28
17938,SpokaneStBridge,01/18/2016 10:00:00 AM,48,-122,12,8,20
17939,SpokaneStBridge,01/18/2016 11:00:00 AM,48,-122,10,12,22
17940,SpokaneStBridge,01/18/2016 12:00:00 PM,48,-122,17,5,22
17941,SpokaneStBridge,01/18/2016 01:00:00 PM,48,-122,19,10,29
17942,SpokaneStBridge,01/18/2016 02:00:00 PM,48,-122,17,24,41
17943,SpokaneStBridge,01/18/2016 03:00:00 PM,48,-122,24,25,49
17944,SpokaneStBridge,01/18/2016 04:00:00 PM,48,-122,19,43,62
17945,SpokaneStBridge,01/18/2016 05:00:00 PM,48,-122,7,39,46
17946,SpokaneStBridge,01/18/2016 06:00:00 PM,48,-122,2,36,38
17947,SpokaneStBridge,01/18/2016 07:00:00 PM,48,-122,2,9,11
17948,SpokaneStBridge,01/18/2016 08:00:00 PM,48,-122,1,4,5
17949,SpokaneStBridge,01/18/2016 09:00:00 PM,48,-122,0,5,5
17950,SpokaneStBridge,01/18/2016 10:00:00 PM,48,-122,1,2,3
17951,SpokaneStBridge,01/18/2016 11:00:00 PM,48,-122,1,0,1
17952,SpokaneStBridge,01/19/2016 12:00:00 AM,48,-122,0,0,0
17953,SpokaneStBridge,01/19/2016 01:00:00 AM,48,-122,0,1,1
17954,SpokaneStBridge,01/19/2016 02:00:00 AM,48,-122,1,0,1
17955,SpokaneStBridge,01/19/2016 03:00:00 AM,48,-122,2,2,4
17956,SpokaneStBridge,01/19/2016 04:00:00 AM,48,-122,2,1,3
17957,SpokaneStBridge,01/19/2016 05:00:00 AM,48,-122,23,3,26
17958,SpokaneStBridge,01/19/2016 06:00:00 AM,48,-122,40,9,49
17959,SpokaneStBridge,01/19/2016 07:00:00 AM,48,-122,65,12,77
17960,SpokaneStBridge,01/19/2016 08:00:00 AM,48,-122,103,10,113
17961,SpokaneStBridge,01/19/2016 09:00:00 AM,48,-122,28,3,31
17962,SpokaneStBridge,01/19/2016 10:00:00 AM,48,-122,12,2,14
17963,SpokaneStBridge,01/19/2016 11:00:00 AM,48,-122,13,6,19
17964,SpokaneStBridge,01/19/2016 12:00:00 PM,48,-122,4,8,12
17965,SpokaneStBridge,01/19/2016 01:00:00 PM,48,-122,8,6,14
17966,SpokaneStBridge,01/19/2016 02:00:00 PM,48,-122,3,4,7
17967,SpokaneStBridge,01/19/2016 03:00:00 PM,48,-122,3,16,19
17968,SpokaneStBridge,01/19/2016 04:00:00 PM,48,-122,10,37,47
17969,SpokaneStBridge,01/19/2016 05:00:00 PM,48,-122,8,95,103
17970,SpokaneStBridge,01/19/2016 06:00:00 PM,48,-122,10,48,58
17971,SpokaneStBridge,01/19/2016 07:00:00 PM,48,-122,2,15,17
17972,SpokaneStBridge,01/19/2016 08:00:00 PM,48,-122,2,5,7
17973,SpokaneStBridge,01/19/2016 09:00:00 PM,48,-122,1,11,12
17974,SpokaneStBridge,01/19/2016 10:00:00 PM,48,-122,0,0,0
17975,SpokaneStBridge,01/19/2016 11:00:00 PM,48,-122,0,0,0
17976,SpokaneStBridge,01/20/2016 12:00:00 AM,48,-122,0,1,1
17977,SpokaneStBridge,01/20/2016 01:00:00 AM,48,-122,0,1,1
17978,SpokaneStBridge,01/20/2016 02:00:00 AM,48,-122,1,0,1
17979,SpokaneStBridge,01/20/2016 03:00:00 AM,48,-122,0,1,1
17980,SpokaneStBridge,01/20/2016 04:00:00 AM,48,-122,5,0,5
17981,SpokaneStBridge,01/20/2016 05:00:00 AM,48,-122,10,3,13
17982,SpokaneStBridge,01/20/2016 06:00:00 AM,48,-122,31,5,36
17983,SpokaneStBridge,01/20/2016 07:00:00 AM,48,-122,73,10,83
17984,SpokaneStBridge,01/20/2016 08:00:00 AM,48,-122,88,10,98
17985,SpokaneStBridge,01/20/2016 09:00:00 AM,48,-122,20,4,24
17986,SpokaneStBridge,01/20/2016 10:00:00 AM,48,-122,15,5,20
17987,SpokaneStBridge,01/20/2016 11:00:00 AM,48,-122,11,4,15
17988,SpokaneStBridge,01/20/2016 12:00:00 PM,48,-122,3,5,8
17989,SpokaneStBridge,01/20/2016 01:00:00 PM,48,-122,12,5,17
17990,SpokaneStBridge,01/20/2016 02:00:00 PM,48,-122,7,16,23
17991,SpokaneStBridge,01/20/2016 03:00:00 PM,48,-122,10,19,29
17992,SpokaneStBridge,01/20/2016 04:00:00 PM,48,-122,10,48,58
17993,SpokaneStBridge,01/20/2016 05:00:00 PM,48,-122,13,90,103
17994,SpokaneStBridge,01/20/2016 06:00:00 PM,48,-122,11,47,58
17995,SpokaneStBridge,01/20/2016 07:00:00 PM,48,-122,3,21,24
17996,SpokaneStBridge,01/20/2016 08:00:00 PM,48,-122,2,6,8
17997,SpokaneStBridge,01/20/2016 09:00:00 PM,48,-122,0,6,6
17998,SpokaneStBridge,01/20/2016 10:00:00 PM,48,-122,1,5,6
17999,SpokaneStBridge,01/20/2016 11:00:00 PM,48,-122,0,2,2
18000,SpokaneStBridge,01/21/2016 12:00:00 AM,48,-122,0,2,2
18001,SpokaneStBridge,01/21/2016 01:00:00 AM,48,-122,0,2,2
18002,SpokaneStBridge,01/21/2016 02:00:00 AM,48,-122,0,0,0
18003,SpokaneStBridge,01/21/2016 03:00:00 AM,48,-122,0,0,0
18004,SpokaneStBridge,01/21/2016 04:00:00 AM,48,-122,2,0,2
18005,SpokaneStBridge,01/21/2016 05:00:00 AM,48,-122,14,3,17
18006,SpokaneStBridge,01/21/2016 06:00:00 AM,48,-122,34,5,39
18007,SpokaneStBridge,01/21/2016 07:00:00 AM,48,-122,49,6,55
18008,SpokaneStBridge,01/21/2016 08:00:00 AM,48,-122,59,8,67
18009,SpokaneStBridge,01/21/2016 09:00:00 AM,48,-122,13,1,14
18010,SpokaneStBridge,01/21/2016 10:00:00 AM,48,-122,10,1,11
18011,SpokaneStBridge,01/21/2016 11:00:00 AM,48,-122,3,1,4
18012,SpokaneStBridge,01/21/2016 12:00:00 PM,48,-122,2,1,3
18013,SpokaneStBridge,01/21/2016 01:00:00 PM,48,-122,4,0,4
18014,SpokaneStBridge,01/21/2016 02:00:00 PM,48,-122,5,7,12
18015,SpokaneStBridge,01/21/2016 03:00:00 PM,48,-122,8,9,17
18016,SpokaneStBridge,01/21/2016 04:00:00 PM,48,-122,4,26,30
18017,SpokaneStBridge,01/21/2016 05:00:00 PM,48,-122,6,58,64
18018,SpokaneStBridge,01/21/2016 06:00:00 PM,48,-122,7,40,47
18019,SpokaneStBridge,01/21/2016 07:00:00 PM,48,-122,1,13,14
18020,SpokaneStBridge,01/21/2016 08:00:00 PM,48,-122,2,6,8
18021,SpokaneStBridge,01/21/2016 09:00:00 PM,48,-122,1,5,6
18022,SpokaneStBridge,01/21/2016 10:00:00 PM,48,-122,0,3,3
18023,SpokaneStBridge,01/21/2016 11:00:00 PM,48,-122,1,3,4
18024,SpokaneStBridge,01/22/2016 12:00:00 AM,48,-122,0,3,3
18025,SpokaneStBridge,01/22/2016 01:00:00 AM,48,-122,3,0,3
18026,SpokaneStBridge,01/22/2016 02:00:00 AM,48,-122,1,2,3
18027,SpokaneStBridge,01/22/2016 03:00:00 AM,48,-122,2,0,2
18028,SpokaneStBridge,01/22/2016 04:00:00 AM,48,-122,0,0,0
18029,SpokaneStBridge,01/22/2016 05:00:00 AM,48,-122,6,2,8
18030,SpokaneStBridge,01/22/2016 06:00:00 AM,48,-122,28,3,31
18031,SpokaneStBridge,01/22/2016 07:00:00 AM,48,-122,43,13,56
18032,SpokaneStBridge,01/22/2016 08:00:00 AM,48,-122,74,11,85
18033,SpokaneStBridge,01/22/2016 09:00:00 AM,48,-122,23,3,26
18034,SpokaneStBridge,01/22/2016 10:00:00 AM,48,-122,9,5,14
18035,SpokaneStBridge,01/22/2016 11:00:00 AM,48,-122,6,6,12
18036,SpokaneStBridge,01/22/2016 12:00:00 PM,48,-122,8,9,17
18037,SpokaneStBridge,01/22/2016 01:00:00 PM,48,-122,7,7,14
18038,SpokaneStBridge,01/22/2016 02:00:00 PM,48,-122,13,9,22
18039,SpokaneStBridge,01/22/2016 03:00:00 PM,48,-122,8,18,26
18040,SpokaneStBridge,01/22/2016 04:00:00 PM,48,-122,17,33,50
18041,SpokaneStBridge,01/22/2016 05:00:00 PM,48,-122,7,63,70
18042,SpokaneStBridge,01/22/2016 06:00:00 PM,48,-122,9,47,56
18043,SpokaneStBridge,01/22/2016 07:00:00 PM,48,-122,4,11,15
18044,SpokaneStBridge,01/22/2016 08:00:00 PM,48,-122,6,5,11
18045,SpokaneStBridge,01/22/2016 09:00:00 PM,48,-122,0,3,3
18046,SpokaneStBridge,01/22/2016 10:00:00 PM,48,-122,1,8,9
18047,SpokaneStBridge,01/22/2016 11:00:00 PM,48,-122,0,2,2
18048,SpokaneStBridge,01/23/2016 12:00:00 AM,48,-122,1,7,8
18049,SpokaneStBridge,01/23/2016 01:00:00 AM,48,-122,1,4,5
18050,SpokaneStBridge,01/23/2016 02:00:00 AM,48,-122,2,0,2
18051,SpokaneStBridge,01/23/2016 03:00:00 AM,48,-122,1,1,2
18052,SpokaneStBridge,01/23/2016 04:00:00 AM,48,-122,1,0,1
18053,SpokaneStBridge,01/23/2016 05:00:00 AM,48,-122,3,3,6
18054,SpokaneStBridge,01/23/2016 06:00:00 AM,48,-122,0,2,2
18055,SpokaneStBridge,01/23/2016 07:00:00 AM,48,-122,4,0,4
18056,SpokaneStBridge,01/23/2016 08:00:00 AM,48,-122,8,1,9
18057,SpokaneStBridge,01/23/2016 09:00:00 AM,48,-122,2,0,2
18058,SpokaneStBridge,01/23/2016 10:00:00 AM,48,-122,3,2,5
18059,SpokaneStBridge,01/23/2016 11:00:00 AM,48,-122,5,6,11
18060,SpokaneStBridge,01/23/2016 12:00:00 PM,48,-122,4,7,11
18061,SpokaneStBridge,01/23/2016 01:00:00 PM,48,-122,2,1,3
18062,SpokaneStBridge,01/23/2016 02:00:00 PM,48,-122,0,4,4
18063,SpokaneStBridge,01/23/2016 03:00:00 PM,48,-122,3,5,8
18064,SpokaneStBridge,01/23/2016 04:00:00 PM,48,-122,4,2,6
18065,SpokaneStBridge,01/23/2016 05:00:00 PM,48,-122,4,3,7
18066,SpokaneStBridge,01/23/2016 06:00:00 PM,48,-122,1,2,3
18067,SpokaneStBridge,01/23/2016 07:00:00 PM,48,-122,1,2,3
18068,SpokaneStBridge,01/23/2016 08:00:00 PM,48,-122,0,1,1
18069,SpokaneStBridge,01/23/2016 09:00:00 PM,48,-122,1,1,2
18070,SpokaneStBridge,01/23/2016 10:00:00 PM,48,-122,0,2,2
18071,SpokaneStBridge,01/23/2016 11:00:00 PM,48,-122,0,2,2
18072,SpokaneStBridge,01/24/2016 12:00:00 AM,48,-122,0,0,0
18073,SpokaneStBridge,01/24/2016 01:00:00 AM,48,-122,1,0,1
18074,SpokaneStBridge,01/24/2016 02:00:00 AM,48,-122,1,1,2
18075,SpokaneStBridge,01/24/2016 03:00:00 AM,48,-122,0,0,0
18076,SpokaneStBridge,01/24/2016 04:00:00 AM,48,-122,2,2,4
18077,SpokaneStBridge,01/24/2016 05:00:00 AM,48,-122,3,0,3
18078,SpokaneStBridge,01/24/2016 06:00:00 AM,48,-122,3,2,5
18079,SpokaneStBridge,01/24/2016 07:00:00 AM,48,-122,8,3,11
18080,SpokaneStBridge,01/24/2016 08:00:00 AM,48,-122,12,2,14
18081,SpokaneStBridge,01/24/2016 09:00:00 AM,48,-122,13,10,23
18082,SpokaneStBridge,01/24/2016 10:00:00 AM,48,-122,20,14,34
18083,SpokaneStBridge,01/24/2016 11:00:00 AM,48,-122,27,23,50
18084,SpokaneStBridge,01/24/2016 12:00:00 PM,48,-122,22,19,41
18085,SpokaneStBridge,01/24/2016 01:00:00 PM,48,-122,20,36,56
18086,SpokaneStBridge,01/24/2016 02:00:00 PM,48,-122,20,37,57
18087,SpokaneStBridge,01/24/2016 03:00:00 PM,48,-122,27,21,48
18088,SpokaneStBridge,01/24/2016 04:00:00 PM,48,-122,10,20,30
18089,SpokaneStBridge,01/24/2016 05:00:00 PM,48,-122,10,7,17
18090,SpokaneStBridge,01/24/2016 06:00:00 PM,48,-122,1,4,5
18091,SpokaneStBridge,01/24/2016 07:00:00 PM,48,-122,1,7,8
18092,SpokaneStBridge,01/24/2016 08:00:00 PM,48,-122,0,1,1
18093,SpokaneStBridge,01/24/2016 09:00:00 PM,48,-122,1,2,3
18094,SpokaneStBridge,01/24/2016 10:00:00 PM,48,-122,0,1,1
18095,SpokaneStBridge,01/24/2016 11:00:00 PM,48,-122,1,0,1
18096,SpokaneStBridge,01/25/2016 12:00:00 AM,48,-122,0,0,0
18097,SpokaneStBridge,01/25/2016 01:00:00 AM,48,-122,0,0,0
18098,SpokaneStBridge,01/25/2016 02:00:00 AM,48,-122,2,0,2
18099,SpokaneStBridge,01/25/2016 03:00:00 AM,48,-122,0,1,1
18100,SpokaneStBridge,01/25/2016 04:00:00 AM,48,-122,1,0,1
18101,SpokaneStBridge,01/25/2016 05:00:00 AM,48,-122,16,1,17
18102,SpokaneStBridge,01/25/2016 06:00:00 AM,48,-122,40,10,50
18103,SpokaneStBridge,01/25/2016 07:00:00 AM,48,-122,83,15,98
18104,SpokaneStBridge,01/25/2016 08:00:00 AM,48,-122,100,15,115
18105,SpokaneStBridge,01/25/2016 09:00:00 AM,48,-122,31,9,40
18106,SpokaneStBridge,01/25/2016 10:00:00 AM,48,-122,18,5,23
18107,SpokaneStBridge,01/25/2016 11:00:00 AM,48,-122,8,5,13
18108,SpokaneStBridge,01/25/2016 12:00:00 PM,48,-122,12,9,21
18109,SpokaneStBridge,01/25/2016 01:00:00 PM,48,-122,5,9,14
18110,SpokaneStBridge,01/25/2016 02:00:00 PM,48,-122,16,13,29
18111,SpokaneStBridge,01/25/2016 03:00:00 PM,48,-122,8,26,34
18112,SpokaneStBridge,01/25/2016 04:00:00 PM,48,-122,24,54,78
18113,SpokaneStBridge,01/25/2016 05:00:00 PM,48,-122,10,122,132
18114,SpokaneStBridge,01/25/2016 06:00:00 PM,48,-122,8,66,74
18115,SpokaneStBridge,01/25/2016 07:00:00 PM,48,-122,3,19,22
18116,SpokaneStBridge,01/25/2016 08:00:00 PM,48,-122,1,11,12
18117,SpokaneStBridge,01/25/2016 09:00:00 PM,48,-122,3,13,16
18118,SpokaneStBridge,01/25/2016 10:00:00 PM,48,-122,2,3,5
18119,SpokaneStBridge,01/25/2016 11:00:00 PM,48,-122,0,2,2
18120,SpokaneStBridge,01/26/2016 12:00:00 AM,48,-122,0,0,0
18121,SpokaneStBridge,01/26/2016 01:00:00 AM,48,-122,1,0,1
18122,SpokaneStBridge,01/26/2016 02:00:00 AM,48,-122,1,2,3
18123,SpokaneStBridge,01/26/2016 03:00:00 AM,48,-122,1,1,2
18124,SpokaneStBridge,01/26/2016 04:00:00 AM,48,-122,3,0,3
18125,SpokaneStBridge,01/26/2016 05:00:00 AM,48,-122,15,3,18
18126,SpokaneStBridge,01/26/2016 06:00:00 AM,48,-122,37,5,42
18127,SpokaneStBridge,01/26/2016 07:00:00 AM,48,-122,73,7,80
18128,SpokaneStBridge,01/26/2016 08:00:00 AM,48,-122,80,7,87
18129,SpokaneStBridge,01/26/2016 09:00:00 AM,48,-122,25,3,28
18130,SpokaneStBridge,01/26/2016 10:00:00 AM,48,-122,11,2,13
18131,SpokaneStBridge,01/26/2016 11:00:00 AM,48,-122,4,2,6
18132,SpokaneStBridge,01/26/2016 12:00:00 PM,48,-122,5,0,5
18133,SpokaneStBridge,01/26/2016 01:00:00 PM,48,-122,8,5,13
18134,SpokaneStBridge,01/26/2016 02:00:00 PM,48,-122,5,5,10
18135,SpokaneStBridge,01/26/2016 03:00:00 PM,48,-122,9,16,25
18136,SpokaneStBridge,01/26/2016 04:00:00 PM,48,-122,11,45,56
18137,SpokaneStBridge,01/26/2016 05:00:00 PM,48,-122,9,86,95
18138,SpokaneStBridge,01/26/2016 06:00:00 PM,48,-122,9,58,67
18139,SpokaneStBridge,01/26/2016 07:00:00 PM,48,-122,1,15,16
18140,SpokaneStBridge,01/26/2016 08:00:00 PM,48,-122,4,12,16
18141,SpokaneStBridge,01/26/2016 09:00:00 PM,48,-122,2,5,7
18142,SpokaneStBridge,01/26/2016 10:00:00 PM,48,-122,4,2,6
18143,SpokaneStBridge,01/26/2016 11:00:00 PM,48,-122,0,3,3
18144,SpokaneStBridge,01/27/2016 12:00:00 AM,48,-122,2,0,2
18145,SpokaneStBridge,01/27/2016 01:00:00 AM,48,-122,1,3,4
18146,SpokaneStBridge,01/27/2016 02:00:00 AM,48,-122,1,0,1
18147,SpokaneStBridge,01/27/2016 03:00:00 AM,48,-122,0,1,1
18148,SpokaneStBridge,01/27/2016 04:00:00 AM,48,-122,0,0,0
18149,SpokaneStBridge,01/27/2016 05:00:00 AM,48,-122,12,7,19
18150,SpokaneStBridge,01/27/2016 06:00:00 AM,48,-122,48,5,53
18151,SpokaneStBridge,01/27/2016 07:00:00 AM,48,-122,67,8,75
18152,SpokaneStBridge,01/27/2016 08:00:00 AM,48,-122,90,11,101
18153,SpokaneStBridge,01/27/2016 09:00:00 AM,48,-122,30,7,37
18154,SpokaneStBridge,01/27/2016 10:00:00 AM,48,-122,10,4,14
18155,SpokaneStBridge,01/27/2016 11:00:00 AM,48,-122,4,6,10
18156,SpokaneStBridge,01/27/2016 12:00:00 PM,48,-122,8,3,11
18157,SpokaneStBridge,01/27/2016 01:00:00 PM,48,-122,12,8,20
18158,SpokaneStBridge,01/27/2016 02:00:00 PM,48,-122,9,13,22
18159,SpokaneStBridge,01/27/2016 03:00:00 PM,48,-122,6,18,24
18160,SpokaneStBridge,01/27/2016 04:00:00 PM,48,-122,14,44,58
18161,SpokaneStBridge,01/27/2016 05:00:00 PM,48,-122,3,86,89
18162,SpokaneStBridge,01/27/2016 06:00:00 PM,48,-122,15,42,57
18163,SpokaneStBridge,01/27/2016 07:00:00 PM,48,-122,1,18,19
18164,SpokaneStBridge,01/27/2016 08:00:00 PM,48,-122,3,9,12
18165,SpokaneStBridge,01/27/2016 09:00:00 PM,48,-122,1,7,8
18166,SpokaneStBridge,01/27/2016 10:00:00 PM,48,-122,0,5,5
18167,SpokaneStBridge,01/27/2016 11:00:00 PM,48,-122,0,2,2
18168,SpokaneStBridge,01/28/2016 12:00:00 AM,48,-122,1,1,2
18169,SpokaneStBridge,01/28/2016 01:00:00 AM,48,-122,0,1,1
18170,SpokaneStBridge,01/28/2016 02:00:00 AM,48,-122,1,0,1
18171,SpokaneStBridge,01/28/2016 03:00:00 AM,48,-122,0,0,0
18172,SpokaneStBridge,01/28/2016 04:00:00 AM,48,-122,2,0,2
18173,SpokaneStBridge,01/28/2016 05:00:00 AM,48,-122,5,1,6
18174,SpokaneStBridge,01/28/2016 06:00:00 AM,48,-122,28,5,33
18175,SpokaneStBridge,01/28/2016 07:00:00 AM,48,-122,48,8,56
18176,SpokaneStBridge,01/28/2016 08:00:00 AM,48,-122,62,8,70
18177,SpokaneStBridge,01/28/2016 09:00:00 AM,48,-122,19,1,20
18178,SpokaneStBridge,01/28/2016 10:00:00 AM,48,-122,12,2,14
18179,SpokaneStBridge,01/28/2016 11:00:00 AM,48,-122,8,4,12
18180,SpokaneStBridge,01/28/2016 12:00:00 PM,48,-122,5,3,8
18181,SpokaneStBridge,01/28/2016 01:00:00 PM,48,-122,8,7,15
18182,SpokaneStBridge,01/28/2016 02:00:00 PM,48,-122,8,9,17
18183,SpokaneStBridge,01/28/2016 03:00:00 PM,48,-122,13,15,28
18184,SpokaneStBridge,01/28/2016 04:00:00 PM,48,-122,13,33,46
18185,SpokaneStBridge,01/28/2016 05:00:00 PM,48,-122,6,71,77
18186,SpokaneStBridge,01/28/2016 06:00:00 PM,48,-122,6,47,53
18187,SpokaneStBridge,01/28/2016 07:00:00 PM,48,-122,6,19,25
18188,SpokaneStBridge,01/28/2016 08:00:00 PM,48,-122,1,11,12
18189,SpokaneStBridge,01/28/2016 09:00:00 PM,48,-122,2,6,8
18190,SpokaneStBridge,01/28/2016 10:00:00 PM,48,-122,3,4,7
18191,SpokaneStBridge,01/28/2016 11:00:00 PM,48,-122,0,4,4
18192,SpokaneStBridge,01/29/2016 12:00:00 AM,48,-122,2,4,6
18193,SpokaneStBridge,01/29/2016 01:00:00 AM,48,-122,0,0,0
18194,SpokaneStBridge,01/29/2016 02:00:00 AM,48,-122,1,0,1
18195,SpokaneStBridge,01/29/2016 03:00:00 AM,48,-122,1,0,1
18196,SpokaneStBridge,01/29/2016 04:00:00 AM,48,-122,3,0,3
18197,SpokaneStBridge,01/29/2016 05:00:00 AM,48,-122,11,0,11
18198,SpokaneStBridge,01/29/2016 06:00:00 AM,48,-122,30,5,35
18199,SpokaneStBridge,01/29/2016 07:00:00 AM,48,-122,54,9,63
18200,SpokaneStBridge,01/29/2016 08:00:00 AM,48,-122,60,5,65
18201,SpokaneStBridge,01/29/2016 09:00:00 AM,48,-122,17,2,19
18202,SpokaneStBridge,01/29/2016 10:00:00 AM,48,-122,5,2,7
18203,SpokaneStBridge,01/29/2016 11:00:00 AM,48,-122,1,0,1
18204,SpokaneStBridge,01/29/2016 12:00:00 PM,48,-122,2,3,5
18205,SpokaneStBridge,01/29/2016 01:00:00 PM,48,-122,5,3,8
18206,SpokaneStBridge,01/29/2016 02:00:00 PM,48,-122,7,3,10
18207,SpokaneStBridge,01/29/2016 03:00:00 PM,48,-122,3,20,23
18208,SpokaneStBridge,01/29/2016 04:00:00 PM,48,-122,6,33,39
18209,SpokaneStBridge,01/29/2016 05:00:00 PM,48,-122,11,64,75
18210,SpokaneStBridge,01/29/2016 06:00:00 PM,48,-122,14,42,56
18211,SpokaneStBridge,01/29/2016 07:00:00 PM,48,-122,6,15,21
18212,SpokaneStBridge,01/29/2016 08:00:00 PM,48,-122,3,3,6
18213,SpokaneStBridge,01/29/2016 09:00:00 PM,48,-122,2,3,5
18214,SpokaneStBridge,01/29/2016 10:00:00 PM,48,-122,5,6,11
18215,SpokaneStBridge,01/29/2016 11:00:00 PM,48,-122,2,2,4
18216,SpokaneStBridge,01/30/2016 12:00:00 AM,48,-122,2,4,6
18217,SpokaneStBridge,01/30/2016 01:00:00 AM,48,-122,0,1,1
18218,SpokaneStBridge,01/30/2016 02:00:00 AM,48,-122,2,1,3
18219,SpokaneStBridge,01/30/2016 03:00:00 AM,48,-122,1,1,2
18220,SpokaneStBridge,01/30/2016 04:00:00 AM,48,-122,1,1,2
18221,SpokaneStBridge,01/30/2016 05:00:00 AM,48,-122,5,2,7
18222,SpokaneStBridge,01/30/2016 06:00:00 AM,48,-122,2,1,3
18223,SpokaneStBridge,01/30/2016 07:00:00 AM,48,-122,4,1,5
18224,SpokaneStBridge,01/30/2016 08:00:00 AM,48,-122,11,4,15
18225,SpokaneStBridge,01/30/2016 09:00:00 AM,48,-122,11,5,16
18226,SpokaneStBridge,01/30/2016 10:00:00 AM,48,-122,13,17,30
18227,SpokaneStBridge,01/30/2016 11:00:00 AM,48,-122,21,21,42
18228,SpokaneStBridge,01/30/2016 12:00:00 PM,48,-122,22,10,32
18229,SpokaneStBridge,01/30/2016 01:00:00 PM,48,-122,14,14,28
18230,SpokaneStBridge,01/30/2016 02:00:00 PM,48,-122,14,18,32
18231,SpokaneStBridge,01/30/2016 03:00:00 PM,48,-122,14,14,28
18232,SpokaneStBridge,01/30/2016 04:00:00 PM,48,-122,11,21,32
18233,SpokaneStBridge,01/30/2016 05:00:00 PM,48,-122,6,10,16
18234,SpokaneStBridge,01/30/2016 06:00:00 PM,48,-122,3,7,10
18235,SpokaneStBridge,01/30/2016 07:00:00 PM,48,-122,0,3,3
18236,SpokaneStBridge,01/30/2016 08:00:00 PM,48,-122,1,3,4
18237,SpokaneStBridge,01/30/2016 09:00:00 PM,48,-122,0,4,4
18238,SpokaneStBridge,01/30/2016 10:00:00 PM,48,-122,2,1,3
18239,SpokaneStBridge,01/30/2016 11:00:00 PM,48,-122,0,2,2
18240,SpokaneStBridge,01/31/2016 12:00:00 AM,48,-122,0,1,1
18241,SpokaneStBridge,01/31/2016 01:00:00 AM,48,-122,1,2,3
18242,SpokaneStBridge,01/31/2016 02:00:00 AM,48,-122,0,1,1
18243,SpokaneStBridge,01/31/2016 03:00:00 AM,48,-122,0,1,1
18244,SpokaneStBridge,01/31/2016 04:00:00 AM,48,-122,0,2,2
18245,SpokaneStBridge,01/31/2016 05:00:00 AM,48,-122,2,1,3
18246,SpokaneStBridge,01/31/2016 06:00:00 AM,48,-122,1,3,4
18247,SpokaneStBridge,01/31/2016 07:00:00 AM,48,-122,4,1,5
18248,SpokaneStBridge,01/31/2016 08:00:00 AM,48,-122,6,5,11
18249,SpokaneStBridge,01/31/2016 09:00:00 AM,48,-122,9,4,13
18250,SpokaneStBridge,01/31/2016 10:00:00 AM,48,-122,11,12,23
18251,SpokaneStBridge,01/31/2016 11:00:00 AM,48,-122,16,12,28
18252,SpokaneStBridge,01/31/2016 12:00:00 PM,48,-122,13,15,28
18253,SpokaneStBridge,01/31/2016 01:00:00 PM,48,-122,12,11,23
18254,SpokaneStBridge,01/31/2016 02:00:00 PM,48,-122,10,13,23
18255,SpokaneStBridge,01/31/2016 03:00:00 PM,48,-122,11,9,20
18256,SpokaneStBridge,01/31/2016 04:00:00 PM,48,-122,9,5,14
18257,SpokaneStBridge,01/31/2016 05:00:00 PM,48,-122,5,5,10
18258,SpokaneStBridge,01/31/2016 06:00:00 PM,48,-122,1,3,4
18259,SpokaneStBridge,01/31/2016 07:00:00 PM,48,-122,1,6,7
18260,SpokaneStBridge,01/31/2016 08:00:00 PM,48,-122,0,1,1
18261,SpokaneStBridge,01/31/2016 09:00:00 PM,48,-122,0,3,3
18262,SpokaneStBridge,01/31/2016 10:00:00 PM,48,-122,1,0,1
18263,SpokaneStBridge,01/31/2016 11:00:00 PM,48,-122,0,1,1
18264,SpokaneStBridge,02/01/2016 12:00:00 AM,48,-122,2,1,3
18265,SpokaneStBridge,02/01/2016 01:00:00 AM,48,-122,0,1,1
18266,SpokaneStBridge,02/01/2016 02:00:00 AM,48,-122,1,0,1
18267,SpokaneStBridge,02/01/2016 03:00:00 AM,48,-122,1,0,1
18268,SpokaneStBridge,02/01/2016 04:00:00 AM,48,-122,4,2,6
18269,SpokaneStBridge,02/01/2016 05:00:00 AM,48,-122,17,0,17
18270,SpokaneStBridge,02/01/2016 06:00:00 AM,48,-122,39,9,48
18271,SpokaneStBridge,02/01/2016 07:00:00 AM,48,-122,82,9,91
18272,SpokaneStBridge,02/01/2016 08:00:00 AM,48,-122,93,10,103
18273,SpokaneStBridge,02/01/2016 09:00:00 AM,48,-122,33,3,36
18274,SpokaneStBridge,02/01/2016 10:00:00 AM,48,-122,17,5,22
18275,SpokaneStBridge,02/01/2016 11:00:00 AM,48,-122,10,4,14
18276,SpokaneStBridge,02/01/2016 12:00:00 PM,48,-122,8,8,16
18277,SpokaneStBridge,02/01/2016 01:00:00 PM,48,-122,5,6,11
18278,SpokaneStBridge,02/01/2016 02:00:00 PM,48,-122,10,10,20
18279,SpokaneStBridge,02/01/2016 03:00:00 PM,48,-122,11,25,36
18280,SpokaneStBridge,02/01/2016 04:00:00 PM,48,-122,15,49,64
18281,SpokaneStBridge,02/01/2016 05:00:00 PM,48,-122,12,97,109
18282,SpokaneStBridge,02/01/2016 06:00:00 PM,48,-122,2,80,82
18283,SpokaneStBridge,02/01/2016 07:00:00 PM,48,-122,7,17,24
18284,SpokaneStBridge,02/01/2016 08:00:00 PM,48,-122,1,8,9
18285,SpokaneStBridge,02/01/2016 09:00:00 PM,48,-122,1,5,6
18286,SpokaneStBridge,02/01/2016 10:00:00 PM,48,-122,1,1,2
18287,SpokaneStBridge,02/01/2016 11:00:00 PM,48,-122,1,1,2
18288,SpokaneStBridge,02/02/2016 12:00:00 AM,48,-122,0,2,2
18289,SpokaneStBridge,02/02/2016 01:00:00 AM,48,-122,1,0,1
18290,SpokaneStBridge,02/02/2016 02:00:00 AM,48,-122,0,0,0
18291,SpokaneStBridge,02/02/2016 03:00:00 AM,48,-122,0,2,2
18292,SpokaneStBridge,02/02/2016 04:00:00 AM,48,-122,0,1,1
18293,SpokaneStBridge,02/02/2016 05:00:00 AM,48,-122,18,3,21
18294,SpokaneStBridge,02/02/2016 06:00:00 AM,48,-122,44,7,51
18295,SpokaneStBridge,02/02/2016 07:00:00 AM,48,-122,96,15,111
18296,SpokaneStBridge,02/02/2016 08:00:00 AM,48,-122,105,8,113
18297,SpokaneStBridge,02/02/2016 09:00:00 AM,48,-122,42,7,49
18298,SpokaneStBridge,02/02/2016 10:00:00 AM,48,-122,18,6,24
18299,SpokaneStBridge,02/02/2016 11:00:00 AM,48,-122,5,4,9
18300,SpokaneStBridge,02/02/2016 12:00:00 PM,48,-122,13,10,23
18301,SpokaneStBridge,02/02/2016 01:00:00 PM,48,-122,13,19,32
18302,SpokaneStBridge,02/02/2016 02:00:00 PM,48,-122,18,11,29
18303,SpokaneStBridge,02/02/2016 03:00:00 PM,48,-122,9,29,38
18304,SpokaneStBridge,02/02/2016 04:00:00 PM,48,-122,16,68,84
18305,SpokaneStBridge,02/02/2016 05:00:00 PM,48,-122,20,112,132
18306,SpokaneStBridge,02/02/2016 06:00:00 PM,48,-122,7,69,76
18307,SpokaneStBridge,02/02/2016 07:00:00 PM,48,-122,4,19,23
18308,SpokaneStBridge,02/02/2016 08:00:00 PM,48,-122,7,15,22
18309,SpokaneStBridge,02/02/2016 09:00:00 PM,48,-122,3,9,12
18310,SpokaneStBridge,02/02/2016 10:00:00 PM,48,-122,1,6,7
18311,SpokaneStBridge,02/02/2016 11:00:00 PM,48,-122,1,2,3
18312,SpokaneStBridge,02/03/2016 12:00:00 AM,48,-122,3,1,4
18313,SpokaneStBridge,02/03/2016 01:00:00 AM,48,-122,0,0,0
18314,SpokaneStBridge,02/03/2016 02:00:00 AM,48,-122,1,0,1
18315,SpokaneStBridge,02/03/2016 03:00:00 AM,48,-122,0,0,0
18316,SpokaneStBridge,02/03/2016 04:00:00 AM,48,-122,1,1,2
18317,SpokaneStBridge,02/03/2016 05:00:00 AM,48,-122,14,2,16
18318,SpokaneStBridge,02/03/2016 06:00:00 AM,48,-122,29,4,33
18319,SpokaneStBridge,02/03/2016 07:00:00 AM,48,-122,81,14,95
18320,SpokaneStBridge,02/03/2016 08:00:00 AM,48,-122,87,10,97
18321,SpokaneStBridge,02/03/2016 09:00:00 AM,48,-122,30,6,36
18322,SpokaneStBridge,02/03/2016 10:00:00 AM,48,-122,14,5,19
18323,SpokaneStBridge,02/03/2016 11:00:00 AM,48,-122,4,3,7
18324,SpokaneStBridge,02/03/2016 12:00:00 PM,48,-122,2,6,8
18325,SpokaneStBridge,02/03/2016 01:00:00 PM,48,-122,5,3,8
18326,SpokaneStBridge,02/03/2016 02:00:00 PM,48,-122,5,7,12
18327,SpokaneStBridge,02/03/2016 03:00:00 PM,48,-122,3,10,13
18328,SpokaneStBridge,02/03/2016 04:00:00 PM,48,-122,6,39,45
18329,SpokaneStBridge,02/03/2016 05:00:00 PM,48,-122,12,83,95
18330,SpokaneStBridge,02/03/2016 06:00:00 PM,48,-122,9,48,57
18331,SpokaneStBridge,02/03/2016 07:00:00 PM,48,-122,1,20,21
18332,SpokaneStBridge,02/03/2016 08:00:00 PM,48,-122,3,9,12
18333,SpokaneStBridge,02/03/2016 09:00:00 PM,48,-122,1,2,3
18334,SpokaneStBridge,02/03/2016 10:00:00 PM,48,-122,0,2,2
18335,SpokaneStBridge,02/03/2016 11:00:00 PM,48,-122,1,1,2
18336,SpokaneStBridge,02/04/2016 12:00:00 AM,48,-122,0,1,1
18337,SpokaneStBridge,02/04/2016 01:00:00 AM,48,-122,0,0,0
18338,SpokaneStBridge,02/04/2016 02:00:00 AM,48,-122,2,1,3
18339,SpokaneStBridge,02/04/2016 03:00:00 AM,48,-122,0,1,1
18340,SpokaneStBridge,02/04/2016 04:00:00 AM,48,-122,3,1,4
18341,SpokaneStBridge,02/04/2016 05:00:00 AM,48,-122,14,3,17
18342,SpokaneStBridge,02/04/2016 06:00:00 AM,48,-122,27,4,31
18343,SpokaneStBridge,02/04/2016 07:00:00 AM,48,-122,69,9,78
18344,SpokaneStBridge,02/04/2016 08:00:00 AM,48,-122,79,11,90
18345,SpokaneStBridge,02/04/2016 09:00:00 AM,48,-122,29,1,30
18346,SpokaneStBridge,02/04/2016 10:00:00 AM,48,-122,18,2,20
18347,SpokaneStBridge,02/04/2016 11:00:00 AM,48,-122,6,3,9
18348,SpokaneStBridge,02/04/2016 12:00:00 PM,48,-122,5,3,8
18349,SpokaneStBridge,02/04/2016 01:00:00 PM,48,-122,6,7,13
18350,SpokaneStBridge,02/04/2016 02:00:00 PM,48,-122,5,9,14
18351,SpokaneStBridge,02/04/2016 03:00:00 PM,48,-122,5,15,20
18352,SpokaneStBridge,02/04/2016 04:00:00 PM,48,-122,15,51,66
18353,SpokaneStBridge,02/04/2016 05:00:00 PM,48,-122,7,81,88
18354,SpokaneStBridge,02/04/2016 06:00:00 PM,48,-122,8,52,60
18355,SpokaneStBridge,02/04/2016 07:00:00 PM,48,-122,1,12,13
18356,SpokaneStBridge,02/04/2016 08:00:00 PM,48,-122,2,8,10
18357,SpokaneStBridge,02/04/2016 09:00:00 PM,48,-122,1,13,14
18358,SpokaneStBridge,02/04/2016 10:00:00 PM,48,-122,3,9,12
18359,SpokaneStBridge,02/04/2016 11:00:00 PM,48,-122,2,1,3
18360,SpokaneStBridge,02/05/2016 12:00:00 AM,48,-122,0,3,3
18361,SpokaneStBridge,02/05/2016 01:00:00 AM,48,-122,1,0,1
18362,SpokaneStBridge,02/05/2016 02:00:00 AM,48,-122,1,0,1
18363,SpokaneStBridge,02/05/2016 03:00:00 AM,48,-122,1,0,1
18364,SpokaneStBridge,02/05/2016 04:00:00 AM,48,-122,1,0,1
18365,SpokaneStBridge,02/05/2016 05:00:00 AM,48,-122,7,2,9
18366,SpokaneStBridge,02/05/2016 06:00:00 AM,48,-122,28,5,33
18367,SpokaneStBridge,02/05/2016 07:00:00 AM,48,-122,53,14,67
18368,SpokaneStBridge,02/05/2016 08:00:00 AM,48,-122,70,9,79
18369,SpokaneStBridge,02/05/2016 09:00:00 AM,48,-122,30,2,32
18370,SpokaneStBridge,02/05/2016 10:00:00 AM,48,-122,15,5,20
18371,SpokaneStBridge,02/05/2016 11:00:00 AM,48,-122,5,6,11
18372,SpokaneStBridge,02/05/2016 12:00:00 PM,48,-122,4,4,8
18373,SpokaneStBridge,02/05/2016 01:00:00 PM,48,-122,10,13,23
18374,SpokaneStBridge,02/05/2016 02:00:00 PM,48,-122,8,9,17
18375,SpokaneStBridge,02/05/2016 03:00:00 PM,48,-122,13,16,29
18376,SpokaneStBridge,02/05/2016 04:00:00 PM,48,-122,15,32,47
18377,SpokaneStBridge,02/05/2016 05:00:00 PM,48,-122,8,60,68
18378,SpokaneStBridge,02/05/2016 06:00:00 PM,48,-122,10,33,43
18379,SpokaneStBridge,02/05/2016 07:00:00 PM,48,-122,4,15,19
18380,SpokaneStBridge,02/05/2016 08:00:00 PM,48,-122,1,4,5
18381,SpokaneStBridge,02/05/2016 09:00:00 PM,48,-122,0,6,6
18382,SpokaneStBridge,02/05/2016 10:00:00 PM,48,-122,1,2,3
18383,SpokaneStBridge,02/05/2016 11:00:00 PM,48,-122,1,1,2
18384,SpokaneStBridge,02/06/2016 12:00:00 AM,48,-122,0,1,1
18385,SpokaneStBridge,02/06/2016 01:00:00 AM,48,-122,1,1,2
18386,SpokaneStBridge,02/06/2016 02:00:00 AM,48,-122,1,1,2
18387,SpokaneStBridge,02/06/2016 03:00:00 AM,48,-122,2,0,2
18388,SpokaneStBridge,02/06/2016 04:00:00 AM,48,-122,1,0,1
18389,SpokaneStBridge,02/06/2016 05:00:00 AM,48,-122,3,0,3
18390,SpokaneStBridge,02/06/2016 06:00:00 AM,48,-122,0,0,0
18391,SpokaneStBridge,02/06/2016 07:00:00 AM,48,-122,9,1,10
18392,SpokaneStBridge,02/06/2016 08:00:00 AM,48,-122,17,5,22
18393,SpokaneStBridge,02/06/2016 09:00:00 AM,48,-122,12,15,27
18394,SpokaneStBridge,02/06/2016 10:00:00 AM,48,-122,16,5,21
18395,SpokaneStBridge,02/06/2016 11:00:00 AM,48,-122,11,14,25
18396,SpokaneStBridge,02/06/2016 12:00:00 PM,48,-122,16,23,39
18397,SpokaneStBridge,02/06/2016 01:00:00 PM,48,-122,23,17,40
18398,SpokaneStBridge,02/06/2016 02:00:00 PM,48,-122,21,17,38
18399,SpokaneStBridge,02/06/2016 03:00:00 PM,48,-122,12,20,32
18400,SpokaneStBridge,02/06/2016 04:00:00 PM,48,-122,17,26,43
18401,SpokaneStBridge,02/06/2016 05:00:00 PM,48,-122,8,7,15
18402,SpokaneStBridge,02/06/2016 06:00:00 PM,48,-122,4,7,11
18403,SpokaneStBridge,02/06/2016 07:00:00 PM,48,-122,2,4,6
18404,SpokaneStBridge,02/06/2016 08:00:00 PM,48,-122,3,4,7
18405,SpokaneStBridge,02/06/2016 09:00:00 PM,48,-122,2,1,3
18406,SpokaneStBridge,02/06/2016 10:00:00 PM,48,-122,1,3,4
18407,SpokaneStBridge,02/06/2016 11:00:00 PM,48,-122,1,2,3
18408,SpokaneStBridge,02/07/2016 12:00:00 AM,48,-122,1,2,3
18409,SpokaneStBridge,02/07/2016 01:00:00 AM,48,-122,0,0,0
18410,SpokaneStBridge,02/07/2016 02:00:00 AM,48,-122,1,1,2
18411,SpokaneStBridge,02/07/2016 03:00:00 AM,48,-122,0,2,2
18412,SpokaneStBridge,02/07/2016 04:00:00 AM,48,-122,1,3,4
18413,SpokaneStBridge,02/07/2016 05:00:00 AM,48,-122,4,1,5
18414,SpokaneStBridge,02/07/2016 06:00:00 AM,48,-122,2,1,3
18415,SpokaneStBridge,02/07/2016 07:00:00 AM,48,-122,7,4,11
18416,SpokaneStBridge,02/07/2016 08:00:00 AM,48,-122,9,3,12
18417,SpokaneStBridge,02/07/2016 09:00:00 AM,48,-122,21,12,33
18418,SpokaneStBridge,02/07/2016 10:00:00 AM,48,-122,23,9,32
18419,SpokaneStBridge,02/07/2016 11:00:00 AM,48,-122,23,25,48
18420,SpokaneStBridge,02/07/2016 12:00:00 PM,48,-122,14,24,38
18421,SpokaneStBridge,02/07/2016 01:00:00 PM,48,-122,25,20,45
18422,SpokaneStBridge,02/07/2016 02:00:00 PM,48,-122,20,28,48
18423,SpokaneStBridge,02/07/2016 03:00:00 PM,48,-122,18,11,29
18424,SpokaneStBridge,02/07/2016 04:00:00 PM,48,-122,5,9,14
18425,SpokaneStBridge,02/07/2016 05:00:00 PM,48,-122,5,3,8
18426,SpokaneStBridge,02/07/2016 06:00:00 PM,48,-122,6,2,8
18427,SpokaneStBridge,02/07/2016 07:00:00 PM,48,-122,2,7,9
18428,SpokaneStBridge,02/07/2016 08:00:00 PM,48,-122,1,4,5
18429,SpokaneStBridge,02/07/2016 09:00:00 PM,48,-122,0,0,0
18430,SpokaneStBridge,02/07/2016 10:00:00 PM,48,-122,4,0,4
18431,SpokaneStBridge,02/07/2016 11:00:00 PM,48,-122,4,0,4
18432,SpokaneStBridge,02/08/2016 12:00:00 AM,48,-122,1,5,6
18433,SpokaneStBridge,02/08/2016 01:00:00 AM,48,-122,0,0,0
18434,SpokaneStBridge,02/08/2016 02:00:00 AM,48,-122,1,0,1
18435,SpokaneStBridge,02/08/2016 03:00:00 AM,48,-122,0,4,4
18436,SpokaneStBridge,02/08/2016 04:00:00 AM,48,-122,1,0,1
18437,SpokaneStBridge,02/08/2016 05:00:00 AM,48,-122,13,1,14
18438,SpokaneStBridge,02/08/2016 06:00:00 AM,48,-122,38,7,45
18439,SpokaneStBridge,02/08/2016 07:00:00 AM,48,-122,117,10,127
18440,SpokaneStBridge,02/08/2016 08:00:00 AM,48,-122,97,16,113
18441,SpokaneStBridge,02/08/2016 09:00:00 AM,48,-122,34,4,38
18442,SpokaneStBridge,02/08/2016 10:00:00 AM,48,-122,15,3,18
18443,SpokaneStBridge,02/08/2016 11:00:00 AM,48,-122,15,4,19
18444,SpokaneStBridge,02/08/2016 12:00:00 PM,48,-122,24,11,35
18445,SpokaneStBridge,02/08/2016 01:00:00 PM,48,-122,9,15,24
18446,SpokaneStBridge,02/08/2016 02:00:00 PM,48,-122,8,18,26
18447,SpokaneStBridge,02/08/2016 03:00:00 PM,48,-122,14,24,38
18448,SpokaneStBridge,02/08/2016 04:00:00 PM,48,-122,18,62,80
18449,SpokaneStBridge,02/08/2016 05:00:00 PM,48,-122,26,120,146
18450,SpokaneStBridge,02/08/2016 06:00:00 PM,48,-122,9,69,78
18451,SpokaneStBridge,02/08/2016 07:00:00 PM,48,-122,6,26,32
18452,SpokaneStBridge,02/08/2016 08:00:00 PM,48,-122,3,9,12
18453,SpokaneStBridge,02/08/2016 09:00:00 PM,48,-122,2,8,10
18454,SpokaneStBridge,02/08/2016 10:00:00 PM,48,-122,1,4,5
18455,SpokaneStBridge,02/08/2016 11:00:00 PM,48,-122,1,3,4
18456,SpokaneStBridge,02/09/2016 12:00:00 AM,48,-122,0,0,0
18457,SpokaneStBridge,02/09/2016 01:00:00 AM,48,-122,2,1,3
18458,SpokaneStBridge,02/09/2016 02:00:00 AM,48,-122,1,1,2
18459,SpokaneStBridge,02/09/2016 03:00:00 AM,48,-122,1,1,2
18460,SpokaneStBridge,02/09/2016 04:00:00 AM,48,-122,3,0,3
18461,SpokaneStBridge,02/09/2016 05:00:00 AM,48,-122,18,2,20
18462,SpokaneStBridge,02/09/2016 06:00:00 AM,48,-122,52,6,58
18463,SpokaneStBridge,02/09/2016 07:00:00 AM,48,-122,99,16,115
18464,SpokaneStBridge,02/09/2016 08:00:00 AM,48,-122,111,11,122
18465,SpokaneStBridge,02/09/2016 09:00:00 AM,48,-122,38,11,49
18466,SpokaneStBridge,02/09/2016 10:00:00 AM,48,-122,13,7,20
18467,SpokaneStBridge,02/09/2016 11:00:00 AM,48,-122,19,6,25
18468,SpokaneStBridge,02/09/2016 12:00:00 PM,48,-122,7,7,14
18469,SpokaneStBridge,02/09/2016 01:00:00 PM,48,-122,18,25,43
18470,SpokaneStBridge,02/09/2016 02:00:00 PM,48,-122,16,15,31
18471,SpokaneStBridge,02/09/2016 03:00:00 PM,48,-122,18,35,53
18472,SpokaneStBridge,02/09/2016 04:00:00 PM,48,-122,28,84,112
18473,SpokaneStBridge,02/09/2016 05:00:00 PM,48,-122,16,124,140
18474,SpokaneStBridge,02/09/2016 06:00:00 PM,48,-122,14,67,81
18475,SpokaneStBridge,02/09/2016 07:00:00 PM,48,-122,8,27,35
18476,SpokaneStBridge,02/09/2016 08:00:00 PM,48,-122,3,19,22
18477,SpokaneStBridge,02/09/2016 09:00:00 PM,48,-122,5,14,19
18478,SpokaneStBridge,02/09/2016 10:00:00 PM,48,-122,4,5,9
18479,SpokaneStBridge,02/09/2016 11:00:00 PM,48,-122,1,3,4
18480,SpokaneStBridge,02/10/2016 12:00:00 AM,48,-122,1,1,2
18481,SpokaneStBridge,02/10/2016 01:00:00 AM,48,-122,0,1,1
18482,SpokaneStBridge,02/10/2016 02:00:00 AM,48,-122,1,0,1
18483,SpokaneStBridge,02/10/2016 03:00:00 AM,48,-122,0,3,3
18484,SpokaneStBridge,02/10/2016 04:00:00 AM,48,-122,1,0,1
18485,SpokaneStBridge,02/10/2016 05:00:00 AM,48,-122,13,4,17
18486,SpokaneStBridge,02/10/2016 06:00:00 AM,48,-122,39,4,43
18487,SpokaneStBridge,02/10/2016 07:00:00 AM,48,-122,74,8,82
18488,SpokaneStBridge,02/10/2016 08:00:00 AM,48,-122,97,5,102
18489,SpokaneStBridge,02/10/2016 09:00:00 AM,48,-122,32,9,41
18490,SpokaneStBridge,02/10/2016 10:00:00 AM,48,-122,14,4,18
18491,SpokaneStBridge,02/10/2016 11:00:00 AM,48,-122,2,3,5
18492,SpokaneStBridge,02/10/2016 12:00:00 PM,48,-122,9,5,14
18493,SpokaneStBridge,02/10/2016 01:00:00 PM,48,-122,4,4,8
18494,SpokaneStBridge,02/10/2016 02:00:00 PM,48,-122,10,21,31
18495,SpokaneStBridge,02/10/2016 03:00:00 PM,48,-122,3,14,17
18496,SpokaneStBridge,02/10/2016 04:00:00 PM,48,-122,10,44,54
18497,SpokaneStBridge,02/10/2016 05:00:00 PM,48,-122,20,93,113
18498,SpokaneStBridge,02/10/2016 06:00:00 PM,48,-122,17,62,79
18499,SpokaneStBridge,02/10/2016 07:00:00 PM,48,-122,8,28,36
18500,SpokaneStBridge,02/10/2016 08:00:00 PM,48,-122,6,12,18
18501,SpokaneStBridge,02/10/2016 09:00:00 PM,48,-122,1,6,7
18502,SpokaneStBridge,02/10/2016 10:00:00 PM,48,-122,1,3,4
18503,SpokaneStBridge,02/10/2016 11:00:00 PM,48,-122,1,3,4
18504,SpokaneStBridge,02/11/2016 12:00:00 AM,48,-122,0,0,0
18505,SpokaneStBridge,02/11/2016 01:00:00 AM,48,-122,0,0,0
18506,SpokaneStBridge,02/11/2016 02:00:00 AM,48,-122,2,1,3
18507,SpokaneStBridge,02/11/2016 03:00:00 AM,48,-122,0,1,1
18508,SpokaneStBridge,02/11/2016 04:00:00 AM,48,-122,1,0,1
18509,SpokaneStBridge,02/11/2016 05:00:00 AM,48,-122,8,3,11
18510,SpokaneStBridge,02/11/2016 06:00:00 AM,48,-122,50,5,55
18511,SpokaneStBridge,02/11/2016 07:00:00 AM,48,-122,76,9,85
18512,SpokaneStBridge,02/11/2016 08:00:00 AM,48,-122,72,4,76
18513,SpokaneStBridge,02/11/2016 09:00:00 AM,48,-122,26,3,29
18514,SpokaneStBridge,02/11/2016 10:00:00 AM,48,-122,10,1,11
18515,SpokaneStBridge,02/11/2016 11:00:00 AM,48,-122,12,3,15
18516,SpokaneStBridge,02/11/2016 12:00:00 PM,48,-122,6,3,9
18517,SpokaneStBridge,02/11/2016 01:00:00 PM,48,-122,4,8,12
18518,SpokaneStBridge,02/11/2016 02:00:00 PM,48,-122,10,7,17
18519,SpokaneStBridge,02/11/2016 03:00:00 PM,48,-122,5,18,23
18520,SpokaneStBridge,02/11/2016 04:00:00 PM,48,-122,6,38,44
18521,SpokaneStBridge,02/11/2016 05:00:00 PM,48,-122,8,76,84
18522,SpokaneStBridge,02/11/2016 06:00:00 PM,48,-122,7,42,49
18523,SpokaneStBridge,02/11/2016 07:00:00 PM,48,-122,4,17,21
18524,SpokaneStBridge,02/11/2016 08:00:00 PM,48,-122,2,7,9
18525,SpokaneStBridge,02/11/2016 09:00:00 PM,48,-122,1,6,7
18526,SpokaneStBridge,02/11/2016 10:00:00 PM,48,-122,0,6,6
18527,SpokaneStBridge,02/11/2016 11:00:00 PM,48,-122,0,2,2
18528,SpokaneStBridge,02/12/2016 12:00:00 AM,48,-122,2,3,5
18529,SpokaneStBridge,02/12/2016 01:00:00 AM,48,-122,0,1,1
18530,SpokaneStBridge,02/12/2016 02:00:00 AM,48,-122,1,1,2
18531,SpokaneStBridge,02/12/2016 03:00:00 AM,48,-122,0,0,0
18532,SpokaneStBridge,02/12/2016 04:00:00 AM,48,-122,1,0,1
18533,SpokaneStBridge,02/12/2016 05:00:00 AM,48,-122,6,3,9
18534,SpokaneStBridge,02/12/2016 06:00:00 AM,48,-122,23,2,25
18535,SpokaneStBridge,02/12/2016 07:00:00 AM,48,-122,44,4,48
18536,SpokaneStBridge,02/12/2016 08:00:00 AM,48,-122,56,6,62
18537,SpokaneStBridge,02/12/2016 09:00:00 AM,48,-122,28,8,36
18538,SpokaneStBridge,02/12/2016 10:00:00 AM,48,-122,8,1,9
18539,SpokaneStBridge,02/12/2016 11:00:00 AM,48,-122,4,3,7
18540,SpokaneStBridge,02/12/2016 12:00:00 PM,48,-122,7,2,9
18541,SpokaneStBridge,02/12/2016 01:00:00 PM,48,-122,6,5,11
18542,SpokaneStBridge,02/12/2016 02:00:00 PM,48,-122,11,3,14
18543,SpokaneStBridge,02/12/2016 03:00:00 PM,48,-122,8,19,27
18544,SpokaneStBridge,02/12/2016 04:00:00 PM,48,-122,12,33,45
18545,SpokaneStBridge,02/12/2016 05:00:00 PM,48,-122,10,57,67
18546,SpokaneStBridge,02/12/2016 06:00:00 PM,48,-122,8,46,54
18547,SpokaneStBridge,02/12/2016 07:00:00 PM,48,-122,2,14,16
18548,SpokaneStBridge,02/12/2016 08:00:00 PM,48,-122,4,3,7
18549,SpokaneStBridge,02/12/2016 09:00:00 PM,48,-122,2,7,9
18550,SpokaneStBridge,02/12/2016 10:00:00 PM,48,-122,0,1,1
18551,SpokaneStBridge,02/12/2016 11:00:00 PM,48,-122,0,3,3
18552,SpokaneStBridge,02/13/2016 12:00:00 AM,48,-122,1,0,1
18553,SpokaneStBridge,02/13/2016 01:00:00 AM,48,-122,1,1,2
18554,SpokaneStBridge,02/13/2016 02:00:00 AM,48,-122,0,0,0
18555,SpokaneStBridge,02/13/2016 03:00:00 AM,48,-122,0,1,1
18556,SpokaneStBridge,02/13/2016 04:00:00 AM,48,-122,1,3,4
18557,SpokaneStBridge,02/13/2016 05:00:00 AM,48,-122,3,1,4
18558,SpokaneStBridge,02/13/2016 06:00:00 AM,48,-122,4,3,7
18559,SpokaneStBridge,02/13/2016 07:00:00 AM,48,-122,6,0,6
18560,SpokaneStBridge,02/13/2016 08:00:00 AM,48,-122,15,8,23
18561,SpokaneStBridge,02/13/2016 09:00:00 AM,48,-122,7,3,10
18562,SpokaneStBridge,02/13/2016 10:00:00 AM,48,-122,15,14,29
18563,SpokaneStBridge,02/13/2016 11:00:00 AM,48,-122,7,4,11
18564,SpokaneStBridge,02/13/2016 12:00:00 PM,48,-122,6,14,20
18565,SpokaneStBridge,02/13/2016 01:00:00 PM,48,-122,6,4,10
18566,SpokaneStBridge,02/13/2016 02:00:00 PM,48,-122,2,5,7
18567,SpokaneStBridge,02/13/2016 03:00:00 PM,48,-122,1,1,2
18568,SpokaneStBridge,02/13/2016 04:00:00 PM,48,-122,5,5,10
18569,SpokaneStBridge,02/13/2016 05:00:00 PM,48,-122,4,7,11
18570,SpokaneStBridge,02/13/2016 06:00:00 PM,48,-122,2,5,7
18571,SpokaneStBridge,02/13/2016 07:00:00 PM,48,-122,3,3,6
18572,SpokaneStBridge,02/13/2016 08:00:00 PM,48,-122,1,2,3
18573,SpokaneStBridge,02/13/2016 09:00:00 PM,48,-122,0,2,2
18574,SpokaneStBridge,02/13/2016 10:00:00 PM,48,-122,2,2,4
18575,SpokaneStBridge,02/13/2016 11:00:00 PM,48,-122,0,1,1
18576,SpokaneStBridge,02/14/2016 12:00:00 AM,48,-122,0,1,1
18577,SpokaneStBridge,02/14/2016 01:00:00 AM,48,-122,0,1,1
18578,SpokaneStBridge,02/14/2016 02:00:00 AM,48,-122,0,0,0
18579,SpokaneStBridge,02/14/2016 03:00:00 AM,48,-122,0,2,2
18580,SpokaneStBridge,02/14/2016 04:00:00 AM,48,-122,1,2,3
18581,SpokaneStBridge,02/14/2016 05:00:00 AM,48,-122,2,1,3
18582,SpokaneStBridge,02/14/2016 06:00:00 AM,48,-122,2,2,4
18583,SpokaneStBridge,02/14/2016 07:00:00 AM,48,-122,1,0,1
18584,SpokaneStBridge,02/14/2016 08:00:00 AM,48,-122,7,3,10
18585,SpokaneStBridge,02/14/2016 09:00:00 AM,48,-122,6,2,8
18586,SpokaneStBridge,02/14/2016 10:00:00 AM,48,-122,5,4,9
18587,SpokaneStBridge,02/14/2016 11:00:00 AM,48,-122,2,8,10
18588,SpokaneStBridge,02/14/2016 12:00:00 PM,48,-122,8,1,9
18589,SpokaneStBridge,02/14/2016 01:00:00 PM,48,-122,5,8,13
18590,SpokaneStBridge,02/14/2016 02:00:00 PM,48,-122,9,9,18
18591,SpokaneStBridge,02/14/2016 03:00:00 PM,48,-122,5,6,11
18592,SpokaneStBridge,02/14/2016 04:00:00 PM,48,-122,9,6,15
18593,SpokaneStBridge,02/14/2016 05:00:00 PM,48,-122,9,2,11
18594,SpokaneStBridge,02/14/2016 06:00:00 PM,48,-122,2,1,3
18595,SpokaneStBridge,02/14/2016 07:00:00 PM,48,-122,0,1,1
18596,SpokaneStBridge,02/14/2016 08:00:00 PM,48,-122,0,1,1
18597,SpokaneStBridge,02/14/2016 09:00:00 PM,48,-122,1,2,3
18598,SpokaneStBridge,02/14/2016 10:00:00 PM,48,-122,1,1,2
18599,SpokaneStBridge,02/14/2016 11:00:00 PM,48,-122,1,7,8
18600,SpokaneStBridge,02/15/2016 12:00:00 AM,48,-122,0,0,0
18601,SpokaneStBridge,02/15/2016 01:00:00 AM,48,-122,0,0,0
18602,SpokaneStBridge,02/15/2016 02:00:00 AM,48,-122,0,0,0
18603,SpokaneStBridge,02/15/2016 03:00:00 AM,48,-122,0,1,1
18604,SpokaneStBridge,02/15/2016 04:00:00 AM,48,-122,1,2,3
18605,SpokaneStBridge,02/15/2016 05:00:00 AM,48,-122,3,1,4
18606,SpokaneStBridge,02/15/2016 06:00:00 AM,48,-122,18,2,20
18607,SpokaneStBridge,02/15/2016 07:00:00 AM,48,-122,18,2,20
18608,SpokaneStBridge,02/15/2016 08:00:00 AM,48,-122,26,3,29
18609,SpokaneStBridge,02/15/2016 09:00:00 AM,48,-122,22,5,27
18610,SpokaneStBridge,02/15/2016 10:00:00 AM,48,-122,11,4,15
18611,SpokaneStBridge,02/15/2016 11:00:00 AM,48,-122,4,4,8
18612,SpokaneStBridge,02/15/2016 12:00:00 PM,48,-122,2,8,10
18613,SpokaneStBridge,02/15/2016 01:00:00 PM,48,-122,4,4,8
18614,SpokaneStBridge,02/15/2016 02:00:00 PM,48,-122,4,1,5
18615,SpokaneStBridge,02/15/2016 03:00:00 PM,48,-122,2,4,6
18616,SpokaneStBridge,02/15/2016 04:00:00 PM,48,-122,5,12,17
18617,SpokaneStBridge,02/15/2016 05:00:00 PM,48,-122,6,29,35
18618,SpokaneStBridge,02/15/2016 06:00:00 PM,48,-122,8,20,28
18619,SpokaneStBridge,02/15/2016 07:00:00 PM,48,-122,4,11,15
18620,SpokaneStBridge,02/15/2016 08:00:00 PM,48,-122,0,4,4
18621,SpokaneStBridge,02/15/2016 09:00:00 PM,48,-122,0,1,1
18622,SpokaneStBridge,02/15/2016 10:00:00 PM,48,-122,0,1,1
18623,SpokaneStBridge,02/15/2016 11:00:00 PM,48,-122,0,2,2
18624,SpokaneStBridge,02/16/2016 12:00:00 AM,48,-122,2,0,2
18625,SpokaneStBridge,02/16/2016 01:00:00 AM,48,-122,0,1,1
18626,SpokaneStBridge,02/16/2016 02:00:00 AM,48,-122,1,1,2
18627,SpokaneStBridge,02/16/2016 03:00:00 AM,48,-122,0,2,2
18628,SpokaneStBridge,02/16/2016 04:00:00 AM,48,-122,4,0,4
18629,SpokaneStBridge,02/16/2016 05:00:00 AM,48,-122,18,2,20
18630,SpokaneStBridge,02/16/2016 06:00:00 AM,48,-122,40,9,49
18631,SpokaneStBridge,02/16/2016 07:00:00 AM,48,-122,67,4,71
18632,SpokaneStBridge,02/16/2016 08:00:00 AM,48,-122,90,7,97
18633,SpokaneStBridge,02/16/2016 09:00:00 AM,48,-122,31,2,33
18634,SpokaneStBridge,02/16/2016 10:00:00 AM,48,-122,15,2,17
18635,SpokaneStBridge,02/16/2016 11:00:00 AM,48,-122,2,5,7
18636,SpokaneStBridge,02/16/2016 12:00:00 PM,48,-122,6,3,9
18637,SpokaneStBridge,02/16/2016 01:00:00 PM,48,-122,6,6,12
18638,SpokaneStBridge,02/16/2016 02:00:00 PM,48,-122,11,9,20
18639,SpokaneStBridge,02/16/2016 03:00:00 PM,48,-122,8,25,33
18640,SpokaneStBridge,02/16/2016 04:00:00 PM,48,-122,16,36,52
18641,SpokaneStBridge,02/16/2016 05:00:00 PM,48,-122,15,90,105
18642,SpokaneStBridge,02/16/2016 06:00:00 PM,48,-122,9,58,67
18643,SpokaneStBridge,02/16/2016 07:00:00 PM,48,-122,3,21,24
18644,SpokaneStBridge,02/16/2016 08:00:00 PM,48,-122,4,16,20
18645,SpokaneStBridge,02/16/2016 09:00:00 PM,48,-122,2,8,10
18646,SpokaneStBridge,02/16/2016 10:00:00 PM,48,-122,0,2,2
18647,SpokaneStBridge,02/16/2016 11:00:00 PM,48,-122,2,3,5
18648,SpokaneStBridge,02/17/2016 12:00:00 AM,48,-122,1,1,2
18649,SpokaneStBridge,02/17/2016 01:00:00 AM,48,-122,0,0,0
18650,SpokaneStBridge,02/17/2016 02:00:00 AM,48,-122,1,1,2
18651,SpokaneStBridge,02/17/2016 03:00:00 AM,48,-122,0,5,5
18652,SpokaneStBridge,02/17/2016 04:00:00 AM,48,-122,3,0,3
18653,SpokaneStBridge,02/17/2016 05:00:00 AM,48,-122,23,3,26
18654,SpokaneStBridge,02/17/2016 06:00:00 AM,48,-122,38,6,44
18655,SpokaneStBridge,02/17/2016 07:00:00 AM,48,-122,77,15,92
18656,SpokaneStBridge,02/17/2016 08:00:00 AM,48,-122,111,5,116
18657,SpokaneStBridge,02/17/2016 09:00:00 AM,48,-122,25,9,34
18658,SpokaneStBridge,02/17/2016 10:00:00 AM,48,-122,12,3,15
18659,SpokaneStBridge,02/17/2016 11:00:00 AM,48,-122,8,7,15
18660,SpokaneStBridge,02/17/2016 12:00:00 PM,48,-122,9,8,17
18661,SpokaneStBridge,02/17/2016 01:00:00 PM,48,-122,9,13,22
18662,SpokaneStBridge,02/17/2016 02:00:00 PM,48,-122,4,8,12
18663,SpokaneStBridge,02/17/2016 03:00:00 PM,48,-122,6,20,26
18664,SpokaneStBridge,02/17/2016 04:00:00 PM,48,-122,11,46,57
18665,SpokaneStBridge,02/17/2016 05:00:00 PM,48,-122,14,84,98
18666,SpokaneStBridge,02/17/2016 06:00:00 PM,48,-122,9,63,72
18667,SpokaneStBridge,02/17/2016 07:00:00 PM,48,-122,9,21,30
18668,SpokaneStBridge,02/17/2016 08:00:00 PM,48,-122,4,9,13
18669,SpokaneStBridge,02/17/2016 09:00:00 PM,48,-122,0,3,3
18670,SpokaneStBridge,02/17/2016 10:00:00 PM,48,-122,0,2,2
18671,SpokaneStBridge,02/17/2016 11:00:00 PM,48,-122,0,0,0
18672,SpokaneStBridge,02/18/2016 12:00:00 AM,48,-122,1,1,2
18673,SpokaneStBridge,02/18/2016 01:00:00 AM,48,-122,1,2,3
18674,SpokaneStBridge,02/18/2016 02:00:00 AM,48,-122,1,0,1
18675,SpokaneStBridge,02/18/2016 03:00:00 AM,48,-122,1,2,3
18676,SpokaneStBridge,02/18/2016 04:00:00 AM,48,-122,0,0,0
18677,SpokaneStBridge,02/18/2016 05:00:00 AM,48,-122,11,4,15
18678,SpokaneStBridge,02/18/2016 06:00:00 AM,48,-122,35,5,40
18679,SpokaneStBridge,02/18/2016 07:00:00 AM,48,-122,60,11,71
18680,SpokaneStBridge,02/18/2016 08:00:00 AM,48,-122,89,11,100
18681,SpokaneStBridge,02/18/2016 09:00:00 AM,48,-122,36,3,39
18682,SpokaneStBridge,02/18/2016 10:00:00 AM,48,-122,13,6,19
18683,SpokaneStBridge,02/18/2016 11:00:00 AM,48,-122,8,3,11
18684,SpokaneStBridge,02/18/2016 12:00:00 PM,48,-122,6,6,12
18685,SpokaneStBridge,02/18/2016 01:00:00 PM,48,-122,10,12,22
18686,SpokaneStBridge,02/18/2016 02:00:00 PM,48,-122,7,9,16
18687,SpokaneStBridge,02/18/2016 03:00:00 PM,48,-122,10,19,29
18688,SpokaneStBridge,02/18/2016 04:00:00 PM,48,-122,14,42,56
18689,SpokaneStBridge,02/18/2016 05:00:00 PM,48,-122,11,83,94
18690,SpokaneStBridge,02/18/2016 06:00:00 PM,48,-122,10,67,77
18691,SpokaneStBridge,02/18/2016 07:00:00 PM,48,-122,6,18,24
18692,SpokaneStBridge,02/18/2016 08:00:00 PM,48,-122,1,10,11
18693,SpokaneStBridge,02/18/2016 09:00:00 PM,48,-122,1,9,10
18694,SpokaneStBridge,02/18/2016 10:00:00 PM,48,-122,2,2,4
18695,SpokaneStBridge,02/18/2016 11:00:00 PM,48,-122,0,4,4
18696,SpokaneStBridge,02/19/2016 12:00:00 AM,48,-122,2,2,4
18697,SpokaneStBridge,02/19/2016 01:00:00 AM,48,-122,2,2,4
18698,SpokaneStBridge,02/19/2016 02:00:00 AM,48,-122,1,3,4
18699,SpokaneStBridge,02/19/2016 03:00:00 AM,48,-122,0,0,0
18700,SpokaneStBridge,02/19/2016 04:00:00 AM,48,-122,0,0,0
18701,SpokaneStBridge,02/19/2016 05:00:00 AM,48,-122,9,1,10
18702,SpokaneStBridge,02/19/2016 06:00:00 AM,48,-122,14,4,18
18703,SpokaneStBridge,02/19/2016 07:00:00 AM,48,-122,38,10,48
18704,SpokaneStBridge,02/19/2016 08:00:00 AM,48,-122,53,2,55
18705,SpokaneStBridge,02/19/2016 09:00:00 AM,48,-122,22,5,27
18706,SpokaneStBridge,02/19/2016 10:00:00 AM,48,-122,6,0,6
18707,SpokaneStBridge,02/19/2016 11:00:00 AM,48,-122,2,1,3
18708,SpokaneStBridge,02/19/2016 12:00:00 PM,48,-122,2,2,4
18709,SpokaneStBridge,02/19/2016 01:00:00 PM,48,-122,6,3,9
18710,SpokaneStBridge,02/19/2016 02:00:00 PM,48,-122,2,4,6
18711,SpokaneStBridge,02/19/2016 03:00:00 PM,48,-122,4,10,14
18712,SpokaneStBridge,02/19/2016 04:00:00 PM,48,-122,3,21,24
18713,SpokaneStBridge,02/19/2016 05:00:00 PM,48,-122,4,52,56
18714,SpokaneStBridge,02/19/2016 06:00:00 PM,48,-122,9,33,42
18715,SpokaneStBridge,02/19/2016 07:00:00 PM,48,-122,1,10,11
18716,SpokaneStBridge,02/19/2016 08:00:00 PM,48,-122,0,8,8
18717,SpokaneStBridge,02/19/2016 09:00:00 PM,48,-122,2,1,3
18718,SpokaneStBridge,02/19/2016 10:00:00 PM,48,-122,2,1,3
18719,SpokaneStBridge,02/19/2016 11:00:00 PM,48,-122,1,0,1
18720,SpokaneStBridge,02/20/2016 12:00:00 AM,48,-122,0,2,2
18721,SpokaneStBridge,02/20/2016 01:00:00 AM,48,-122,0,1,1
18722,SpokaneStBridge,02/20/2016 02:00:00 AM,48,-122,1,0,1
18723,SpokaneStBridge,02/20/2016 03:00:00 AM,48,-122,0,1,1
18724,SpokaneStBridge,02/20/2016 04:00:00 AM,48,-122,2,0,2
18725,SpokaneStBridge,02/20/2016 05:00:00 AM,48,-122,3,0,3
18726,SpokaneStBridge,02/20/2016 06:00:00 AM,48,-122,2,3,5
18727,SpokaneStBridge,02/20/2016 07:00:00 AM,48,-122,8,0,8
18728,SpokaneStBridge,02/20/2016 08:00:00 AM,48,-122,12,4,16
18729,SpokaneStBridge,02/20/2016 09:00:00 AM,48,-122,14,13,27
18730,SpokaneStBridge,02/20/2016 10:00:00 AM,48,-122,31,17,48
18731,SpokaneStBridge,02/20/2016 11:00:00 AM,48,-122,29,38,67
18732,SpokaneStBridge,02/20/2016 12:00:00 PM,48,-122,39,26,65
18733,SpokaneStBridge,02/20/2016 01:00:00 PM,48,-122,25,30,55
18734,SpokaneStBridge,02/20/2016 02:00:00 PM,48,-122,29,65,94
18735,SpokaneStBridge,02/20/2016 03:00:00 PM,48,-122,36,25,61
18736,SpokaneStBridge,02/20/2016 04:00:00 PM,48,-122,28,16,44
18737,SpokaneStBridge,02/20/2016 05:00:00 PM,48,-122,10,15,25
18738,SpokaneStBridge,02/20/2016 06:00:00 PM,48,-122,4,13,17
18739,SpokaneStBridge,02/20/2016 07:00:00 PM,48,-122,3,2,5
18740,SpokaneStBridge,02/20/2016 08:00:00 PM,48,-122,2,1,3
18741,SpokaneStBridge,02/20/2016 09:00:00 PM,48,-122,2,4,6
18742,SpokaneStBridge,02/20/2016 10:00:00 PM,48,-122,0,3,3
18743,SpokaneStBridge,02/20/2016 11:00:00 PM,48,-122,0,1,1
18744,SpokaneStBridge,02/21/2016 12:00:00 AM,48,-122,0,2,2
18745,SpokaneStBridge,02/21/2016 01:00:00 AM,48,-122,0,0,0
18746,SpokaneStBridge,02/21/2016 02:00:00 AM,48,-122,0,0,0
18747,SpokaneStBridge,02/21/2016 03:00:00 AM,48,-122,3,2,5
18748,SpokaneStBridge,02/21/2016 04:00:00 AM,48,-122,1,1,2
18749,SpokaneStBridge,02/21/2016 05:00:00 AM,48,-122,3,0,3
18750,SpokaneStBridge,02/21/2016 06:00:00 AM,48,-122,3,1,4
18751,SpokaneStBridge,02/21/2016 07:00:00 AM,48,-122,3,1,4
18752,SpokaneStBridge,02/21/2016 08:00:00 AM,48,-122,9,4,13
18753,SpokaneStBridge,02/21/2016 09:00:00 AM,48,-122,1,8,9
18754,SpokaneStBridge,02/21/2016 10:00:00 AM,48,-122,14,15,29
18755,SpokaneStBridge,02/21/2016 11:00:00 AM,48,-122,10,7,17
18756,SpokaneStBridge,02/21/2016 12:00:00 PM,48,-122,6,6,12
18757,SpokaneStBridge,02/21/2016 01:00:00 PM,48,-122,6,3,9
18758,SpokaneStBridge,02/21/2016 02:00:00 PM,48,-122,8,7,15
18759,SpokaneStBridge,02/21/2016 03:00:00 PM,48,-122,4,7,11
18760,SpokaneStBridge,02/21/2016 04:00:00 PM,48,-122,8,3,11
18761,SpokaneStBridge,02/21/2016 05:00:00 PM,48,-122,5,2,7
18762,SpokaneStBridge,02/21/2016 06:00:00 PM,48,-122,2,0,2
18763,SpokaneStBridge,02/21/2016 07:00:00 PM,48,-122,2,5,7
18764,SpokaneStBridge,02/21/2016 08:00:00 PM,48,-122,2,3,5
18765,SpokaneStBridge,02/21/2016 09:00:00 PM,48,-122,0,0,0
18766,SpokaneStBridge,02/21/2016 10:00:00 PM,48,-122,0,0,0
18767,SpokaneStBridge,02/21/2016 11:00:00 PM,48,-122,1,1,2
18768,SpokaneStBridge,02/22/2016 12:00:00 AM,48,-122,1,0,1
18769,SpokaneStBridge,02/22/2016 01:00:00 AM,48,-122,0,0,0
18770,SpokaneStBridge,02/22/2016 02:00:00 AM,48,-122,2,0,2
18771,SpokaneStBridge,02/22/2016 03:00:00 AM,48,-122,0,3,3
18772,SpokaneStBridge,02/22/2016 04:00:00 AM,48,-122,1,0,1
18773,SpokaneStBridge,02/22/2016 05:00:00 AM,48,-122,19,1,20
18774,SpokaneStBridge,02/22/2016 06:00:00 AM,48,-122,37,4,41
18775,SpokaneStBridge,02/22/2016 07:00:00 AM,48,-122,75,8,83
18776,SpokaneStBridge,02/22/2016 08:00:00 AM,48,-122,99,9,108
18777,SpokaneStBridge,02/22/2016 09:00:00 AM,48,-122,28,1,29
18778,SpokaneStBridge,02/22/2016 10:00:00 AM,48,-122,17,3,20
18779,SpokaneStBridge,02/22/2016 11:00:00 AM,48,-122,11,7,18
18780,SpokaneStBridge,02/22/2016 12:00:00 PM,48,-122,9,4,13
18781,SpokaneStBridge,02/22/2016 01:00:00 PM,48,-122,8,3,11
18782,SpokaneStBridge,02/22/2016 02:00:00 PM,48,-122,10,10,20
18783,SpokaneStBridge,02/22/2016 03:00:00 PM,48,-122,6,25,31
18784,SpokaneStBridge,02/22/2016 04:00:00 PM,48,-122,15,57,72
18785,SpokaneStBridge,02/22/2016 05:00:00 PM,48,-122,21,106,127
18786,SpokaneStBridge,02/22/2016 06:00:00 PM,48,-122,6,59,65
18787,SpokaneStBridge,02/22/2016 07:00:00 PM,48,-122,3,17,20
18788,SpokaneStBridge,02/22/2016 08:00:00 PM,48,-122,1,10,11
18789,SpokaneStBridge,02/22/2016 09:00:00 PM,48,-122,4,7,11
18790,SpokaneStBridge,02/22/2016 10:00:00 PM,48,-122,0,4,4
18791,SpokaneStBridge,02/22/2016 11:00:00 PM,48,-122,0,3,3
18792,SpokaneStBridge,02/23/2016 12:00:00 AM,48,-122,0,0,0
18793,SpokaneStBridge,02/23/2016 01:00:00 AM,48,-122,0,1,1
18794,SpokaneStBridge,02/23/2016 02:00:00 AM,48,-122,1,1,2
18795,SpokaneStBridge,02/23/2016 03:00:00 AM,48,-122,0,1,1
18796,SpokaneStBridge,02/23/2016 04:00:00 AM,48,-122,0,1,1
18797,SpokaneStBridge,02/23/2016 05:00:00 AM,48,-122,16,3,19
18798,SpokaneStBridge,02/23/2016 06:00:00 AM,48,-122,43,6,49
18799,SpokaneStBridge,02/23/2016 07:00:00 AM,48,-122,109,12,121
18800,SpokaneStBridge,02/23/2016 08:00:00 AM,48,-122,104,4,108
18801,SpokaneStBridge,02/23/2016 09:00:00 AM,48,-122,45,7,52
18802,SpokaneStBridge,02/23/2016 10:00:00 AM,48,-122,16,6,22
18803,SpokaneStBridge,02/23/2016 11:00:00 AM,48,-122,7,8,15
18804,SpokaneStBridge,02/23/2016 12:00:00 PM,48,-122,10,10,20
18805,SpokaneStBridge,02/23/2016 01:00:00 PM,48,-122,12,16,28
18806,SpokaneStBridge,02/23/2016 02:00:00 PM,48,-122,18,14,32
18807,SpokaneStBridge,02/23/2016 03:00:00 PM,48,-122,15,29,44
18808,SpokaneStBridge,02/23/2016 04:00:00 PM,48,-122,22,64,86
18809,SpokaneStBridge,02/23/2016 05:00:00 PM,48,-122,20,133,153
18810,SpokaneStBridge,02/23/2016 06:00:00 PM,48,-122,12,80,92
18811,SpokaneStBridge,02/23/2016 07:00:00 PM,48,-122,3,31,34
18812,SpokaneStBridge,02/23/2016 08:00:00 PM,48,-122,3,16,19
18813,SpokaneStBridge,02/23/2016 09:00:00 PM,48,-122,6,8,14
18814,SpokaneStBridge,02/23/2016 10:00:00 PM,48,-122,3,10,13
18815,SpokaneStBridge,02/23/2016 11:00:00 PM,48,-122,0,1,1
18816,SpokaneStBridge,02/24/2016 12:00:00 AM,48,-122,0,1,1
18817,SpokaneStBridge,02/24/2016 01:00:00 AM,48,-122,0,1,1
18818,SpokaneStBridge,02/24/2016 02:00:00 AM,48,-122,2,1,3
18819,SpokaneStBridge,02/24/2016 03:00:00 AM,48,-122,0,2,2
18820,SpokaneStBridge,02/24/2016 04:00:00 AM,48,-122,0,1,1
18821,SpokaneStBridge,02/24/2016 05:00:00 AM,48,-122,22,3,25
18822,SpokaneStBridge,02/24/2016 06:00:00 AM,48,-122,54,9,63
18823,SpokaneStBridge,02/24/2016 07:00:00 AM,48,-122,108,10,118
18824,SpokaneStBridge,02/24/2016 08:00:00 AM,48,-122,105,14,119
18825,SpokaneStBridge,02/24/2016 09:00:00 AM,48,-122,40,5,45
18826,SpokaneStBridge,02/24/2016 10:00:00 AM,48,-122,22,6,28
18827,SpokaneStBridge,02/24/2016 11:00:00 AM,48,-122,11,14,25
18828,SpokaneStBridge,02/24/2016 12:00:00 PM,48,-122,12,18,30
18829,SpokaneStBridge,02/24/2016 01:00:00 PM,48,-122,13,12,25
18830,SpokaneStBridge,02/24/2016 02:00:00 PM,48,-122,14,12,26
18831,SpokaneStBridge,02/24/2016 03:00:00 PM,48,-122,11,23,34
18832,SpokaneStBridge,02/24/2016 04:00:00 PM,48,-122,20,55,75
18833,SpokaneStBridge,02/24/2016 05:00:00 PM,48,-122,13,122,135
18834,SpokaneStBridge,02/24/2016 06:00:00 PM,48,-122,15,71,86
18835,SpokaneStBridge,02/24/2016 07:00:00 PM,48,-122,6,30,36
18836,SpokaneStBridge,02/24/2016 08:00:00 PM,48,-122,3,16,19
18837,SpokaneStBridge,02/24/2016 09:00:00 PM,48,-122,0,7,7
18838,SpokaneStBridge,02/24/2016 10:00:00 PM,48,-122,3,6,9
18839,SpokaneStBridge,02/24/2016 11:00:00 PM,48,-122,0,2,2
18840,SpokaneStBridge,02/25/2016 12:00:00 AM,48,-122,0,0,0
18841,SpokaneStBridge,02/25/2016 01:00:00 AM,48,-122,1,0,1
18842,SpokaneStBridge,02/25/2016 02:00:00 AM,48,-122,1,1,2
18843,SpokaneStBridge,02/25/2016 03:00:00 AM,48,-122,0,0,0
18844,SpokaneStBridge,02/25/2016 04:00:00 AM,48,-122,2,0,2
18845,SpokaneStBridge,02/25/2016 05:00:00 AM,48,-122,18,1,19
18846,SpokaneStBridge,02/25/2016 06:00:00 AM,48,-122,50,8,58
18847,SpokaneStBridge,02/25/2016 07:00:00 AM,48,-122,87,18,105
18848,SpokaneStBridge,02/25/2016 08:00:00 AM,48,-122,115,16,131
18849,SpokaneStBridge,02/25/2016 09:00:00 AM,48,-122,46,8,54
18850,SpokaneStBridge,02/25/2016 10:00:00 AM,48,-122,24,5,29
18851,SpokaneStBridge,02/25/2016 11:00:00 AM,48,-122,11,12,23
18852,SpokaneStBridge,02/25/2016 12:00:00 PM,48,-122,20,20,40
18853,SpokaneStBridge,02/25/2016 01:00:00 PM,48,-122,20,15,35
18854,SpokaneStBridge,02/25/2016 02:00:00 PM,48,-122,21,23,44
18855,SpokaneStBridge,02/25/2016 03:00:00 PM,48,-122,27,35,62
18856,SpokaneStBridge,02/25/2016 04:00:00 PM,48,-122,21,64,85
18857,SpokaneStBridge,02/25/2016 05:00:00 PM,48,-122,22,134,156
18858,SpokaneStBridge,02/25/2016 06:00:00 PM,48,-122,11,65,76
18859,SpokaneStBridge,02/25/2016 07:00:00 PM,48,-122,5,34,39
18860,SpokaneStBridge,02/25/2016 08:00:00 PM,48,-122,2,12,14
18861,SpokaneStBridge,02/25/2016 09:00:00 PM,48,-122,2,7,9
18862,SpokaneStBridge,02/25/2016 10:00:00 PM,48,-122,3,7,10
18863,SpokaneStBridge,02/25/2016 11:00:00 PM,48,-122,1,2,3
18864,SpokaneStBridge,02/26/2016 12:00:00 AM,48,-122,2,2,4
18865,SpokaneStBridge,02/26/2016 01:00:00 AM,48,-122,1,1,2
18866,SpokaneStBridge,02/26/2016 02:00:00 AM,48,-122,1,1,2
18867,SpokaneStBridge,02/26/2016 03:00:00 AM,48,-122,0,0,0
18868,SpokaneStBridge,02/26/2016 04:00:00 AM,48,-122,2,2,4
18869,SpokaneStBridge,02/26/2016 05:00:00 AM,48,-122,12,3,15
18870,SpokaneStBridge,02/26/2016 06:00:00 AM,48,-122,31,10,41
18871,SpokaneStBridge,02/26/2016 07:00:00 AM,48,-122,67,11,78
18872,SpokaneStBridge,02/26/2016 08:00:00 AM,48,-122,89,6,95
18873,SpokaneStBridge,02/26/2016 09:00:00 AM,48,-122,26,7,33
18874,SpokaneStBridge,02/26/2016 10:00:00 AM,48,-122,20,3,23
18875,SpokaneStBridge,02/26/2016 11:00:00 AM,48,-122,11,10,21
18876,SpokaneStBridge,02/26/2016 12:00:00 PM,48,-122,14,10,24
18877,SpokaneStBridge,02/26/2016 01:00:00 PM,48,-122,18,10,28
18878,SpokaneStBridge,02/26/2016 02:00:00 PM,48,-122,9,12,21
18879,SpokaneStBridge,02/26/2016 03:00:00 PM,48,-122,16,26,42
18880,SpokaneStBridge,02/26/2016 04:00:00 PM,48,-122,8,44,52
18881,SpokaneStBridge,02/26/2016 05:00:00 PM,48,-122,11,66,77
18882,SpokaneStBridge,02/26/2016 06:00:00 PM,48,-122,4,37,41
18883,SpokaneStBridge,02/26/2016 07:00:00 PM,48,-122,3,12,15
18884,SpokaneStBridge,02/26/2016 08:00:00 PM,48,-122,1,3,4
18885,SpokaneStBridge,02/26/2016 09:00:00 PM,48,-122,2,2,4
18886,SpokaneStBridge,02/26/2016 10:00:00 PM,48,-122,0,2,2
18887,SpokaneStBridge,02/26/2016 11:00:00 PM,48,-122,1,2,3
18888,SpokaneStBridge,02/27/2016 12:00:00 AM,48,-122,0,3,3
18889,SpokaneStBridge,02/27/2016 01:00:00 AM,48,-122,0,0,0
18890,SpokaneStBridge,02/27/2016 02:00:00 AM,48,-122,0,0,0
18891,SpokaneStBridge,02/27/2016 03:00:00 AM,48,-122,0,0,0
18892,SpokaneStBridge,02/27/2016 04:00:00 AM,48,-122,0,0,0
18893,SpokaneStBridge,02/27/2016 05:00:00 AM,48,-122,4,0,4
18894,SpokaneStBridge,02/27/2016 06:00:00 AM,48,-122,8,1,9
18895,SpokaneStBridge,02/27/2016 07:00:00 AM,48,-122,4,4,8
18896,SpokaneStBridge,02/27/2016 08:00:00 AM,48,-122,6,8,14
18897,SpokaneStBridge,02/27/2016 09:00:00 AM,48,-122,14,11,25
18898,SpokaneStBridge,02/27/2016 10:00:00 AM,48,-122,18,19,37
18899,SpokaneStBridge,02/27/2016 11:00:00 AM,48,-122,21,15,36
18900,SpokaneStBridge,02/27/2016 12:00:00 PM,48,-122,12,19,31
18901,SpokaneStBridge,02/27/2016 01:00:00 PM,48,-122,22,20,42
18902,SpokaneStBridge,02/27/2016 02:00:00 PM,48,-122,23,21,44
18903,SpokaneStBridge,02/27/2016 03:00:00 PM,48,-122,24,21,45
18904,SpokaneStBridge,02/27/2016 04:00:00 PM,48,-122,24,33,57
18905,SpokaneStBridge,02/27/2016 05:00:00 PM,48,-122,15,11,26
18906,SpokaneStBridge,02/27/2016 06:00:00 PM,48,-122,11,8,19
18907,SpokaneStBridge,02/27/2016 07:00:00 PM,48,-122,7,5,12
18908,SpokaneStBridge,02/27/2016 08:00:00 PM,48,-122,0,6,6
18909,SpokaneStBridge,02/27/2016 09:00:00 PM,48,-122,3,1,4
18910,SpokaneStBridge,02/27/2016 10:00:00 PM,48,-122,0,1,1
18911,SpokaneStBridge,02/27/2016 11:00:00 PM,48,-122,2,1,3
18912,SpokaneStBridge,02/28/2016 12:00:00 AM,48,-122,0,5,5
18913,SpokaneStBridge,02/28/2016 01:00:00 AM,48,-122,0,2,2
18914,SpokaneStBridge,02/28/2016 02:00:00 AM,48,-122,1,2,3
18915,SpokaneStBridge,02/28/2016 03:00:00 AM,48,-122,1,0,1
18916,SpokaneStBridge,02/28/2016 04:00:00 AM,48,-122,0,2,2
18917,SpokaneStBridge,02/28/2016 05:00:00 AM,48,-122,5,0,5
18918,SpokaneStBridge,02/28/2016 06:00:00 AM,48,-122,6,0,6
18919,SpokaneStBridge,02/28/2016 07:00:00 AM,48,-122,35,1,36
18920,SpokaneStBridge,02/28/2016 08:00:00 AM,48,-122,26,4,30
18921,SpokaneStBridge,02/28/2016 09:00:00 AM,48,-122,13,0,13
18922,SpokaneStBridge,02/28/2016 10:00:00 AM,48,-122,4,2,6
18923,SpokaneStBridge,02/28/2016 11:00:00 AM,48,-122,3,6,9
18924,SpokaneStBridge,02/28/2016 12:00:00 PM,48,-122,3,14,17
18925,SpokaneStBridge,02/28/2016 01:00:00 PM,48,-122,6,18,24
18926,SpokaneStBridge,02/28/2016 02:00:00 PM,48,-122,6,12,18
18927,SpokaneStBridge,02/28/2016 03:00:00 PM,48,-122,4,17,21
18928,SpokaneStBridge,02/28/2016 04:00:00 PM,48,-122,4,15,19
18929,SpokaneStBridge,02/28/2016 05:00:00 PM,48,-122,0,3,3
18930,SpokaneStBridge,02/28/2016 06:00:00 PM,48,-122,2,5,7
18931,SpokaneStBridge,02/28/2016 07:00:00 PM,48,-122,1,2,3
18932,SpokaneStBridge,02/28/2016 08:00:00 PM,48,-122,1,1,2
18933,SpokaneStBridge,02/28/2016 09:00:00 PM,48,-122,0,2,2
18934,SpokaneStBridge,02/28/2016 10:00:00 PM,48,-122,1,0,1
18935,SpokaneStBridge,02/28/2016 11:00:00 PM,48,-122,0,1,1
18936,SpokaneStBridge,02/29/2016 12:00:00 AM,48,-122,1,0,1
18937,SpokaneStBridge,02/29/2016 01:00:00 AM,48,-122,0,0,0
18938,SpokaneStBridge,02/29/2016 02:00:00 AM,48,-122,0,0,0
18939,SpokaneStBridge,02/29/2016 03:00:00 AM,48,-122,0,0,0
18940,SpokaneStBridge,02/29/2016 04:00:00 AM,48,-122,1,1,2
18941,SpokaneStBridge,02/29/2016 05:00:00 AM,48,-122,9,0,9
18942,SpokaneStBridge,02/29/2016 06:00:00 AM,48,-122,48,6,54
18943,SpokaneStBridge,02/29/2016 07:00:00 AM,48,-122,78,9,87
18944,SpokaneStBridge,02/29/2016 08:00:00 AM,48,-122,80,11,91
18945,SpokaneStBridge,02/29/2016 09:00:00 AM,48,-122,27,1,28
18946,SpokaneStBridge,02/29/2016 10:00:00 AM,48,-122,15,5,20
18947,SpokaneStBridge,02/29/2016 11:00:00 AM,48,-122,6,11,17
18948,SpokaneStBridge,02/29/2016 12:00:00 PM,48,-122,18,11,29
18949,SpokaneStBridge,02/29/2016 01:00:00 PM,48,-122,10,9,19
18950,SpokaneStBridge,02/29/2016 02:00:00 PM,48,-122,15,12,27
18951,SpokaneStBridge,02/29/2016 03:00:00 PM,48,-122,5,29,34
18952,SpokaneStBridge,02/29/2016 04:00:00 PM,48,-122,19,46,65
18953,SpokaneStBridge,02/29/2016 05:00:00 PM,48,-122,10,107,117
18954,SpokaneStBridge,02/29/2016 06:00:00 PM,48,-122,7,59,66
18955,SpokaneStBridge,02/29/2016 07:00:00 PM,48,-122,4,25,29
18956,SpokaneStBridge,02/29/2016 08:00:00 PM,48,-122,5,8,13
18957,SpokaneStBridge,02/29/2016 09:00:00 PM,48,-122,2,6,8
18958,SpokaneStBridge,02/29/2016 10:00:00 PM,48,-122,0,2,2
18959,SpokaneStBridge,02/29/2016 11:00:00 PM,48,-122,3,3,6
18960,SpokaneStBridge,03/01/2016 12:00:00 AM,48,-122,2,1,3
18961,SpokaneStBridge,03/01/2016 01:00:00 AM,48,-122,0,0,0
18962,SpokaneStBridge,03/01/2016 02:00:00 AM,48,-122,0,1,1
18963,SpokaneStBridge,03/01/2016 03:00:00 AM,48,-122,1,1,2
18964,SpokaneStBridge,03/01/2016 04:00:00 AM,48,-122,0,0,0
18965,SpokaneStBridge,03/01/2016 05:00:00 AM,48,-122,9,1,10
18966,SpokaneStBridge,03/01/2016 06:00:00 AM,48,-122,22,5,27
18967,SpokaneStBridge,03/01/2016 07:00:00 AM,48,-122,63,8,71
18968,SpokaneStBridge,03/01/2016 08:00:00 AM,48,-122,75,11,86
18969,SpokaneStBridge,03/01/2016 09:00:00 AM,48,-122,28,6,34
18970,SpokaneStBridge,03/01/2016 10:00:00 AM,48,-122,7,0,7
18971,SpokaneStBridge,03/01/2016 11:00:00 AM,48,-122,3,2,5
18972,SpokaneStBridge,03/01/2016 12:00:00 PM,48,-122,1,3,4
18973,SpokaneStBridge,03/01/2016 01:00:00 PM,48,-122,5,1,6
18974,SpokaneStBridge,03/01/2016 02:00:00 PM,48,-122,4,3,7
18975,SpokaneStBridge,03/01/2016 03:00:00 PM,48,-122,4,7,11
18976,SpokaneStBridge,03/01/2016 04:00:00 PM,48,-122,11,29,40
18977,SpokaneStBridge,03/01/2016 05:00:00 PM,48,-122,4,73,77
18978,SpokaneStBridge,03/01/2016 06:00:00 PM,48,-122,5,44,49
18979,SpokaneStBridge,03/01/2016 07:00:00 PM,48,-122,1,15,16
18980,SpokaneStBridge,03/01/2016 08:00:00 PM,48,-122,0,8,8
18981,SpokaneStBridge,03/01/2016 09:00:00 PM,48,-122,1,2,3
18982,SpokaneStBridge,03/01/2016 10:00:00 PM,48,-122,1,1,2
18983,SpokaneStBridge,03/01/2016 11:00:00 PM,48,-122,0,0,0
18984,SpokaneStBridge,03/02/2016 12:00:00 AM,48,-122,0,0,0
18985,SpokaneStBridge,03/02/2016 01:00:00 AM,48,-122,0,2,2
18986,SpokaneStBridge,03/02/2016 02:00:00 AM,48,-122,1,0,1
18987,SpokaneStBridge,03/02/2016 03:00:00 AM,48,-122,0,0,0
18988,SpokaneStBridge,03/02/2016 04:00:00 AM,48,-122,2,1,3
18989,SpokaneStBridge,03/02/2016 05:00:00 AM,48,-122,10,3,13
18990,SpokaneStBridge,03/02/2016 06:00:00 AM,48,-122,41,6,47
18991,SpokaneStBridge,03/02/2016 07:00:00 AM,48,-122,70,8,78
18992,SpokaneStBridge,03/02/2016 08:00:00 AM,48,-122,99,9,108
18993,SpokaneStBridge,03/02/2016 09:00:00 AM,48,-122,30,12,42
18994,SpokaneStBridge,03/02/2016 10:00:00 AM,48,-122,16,8,24
18995,SpokaneStBridge,03/02/2016 11:00:00 AM,48,-122,7,4,11
18996,SpokaneStBridge,03/02/2016 12:00:00 PM,48,-122,12,13,25
18997,SpokaneStBridge,03/02/2016 01:00:00 PM,48,-122,8,4,12
18998,SpokaneStBridge,03/02/2016 02:00:00 PM,48,-122,5,10,15
18999,SpokaneStBridge,03/02/2016 03:00:00 PM,48,-122,5,18,23
19000,SpokaneStBridge,03/02/2016 04:00:00 PM,48,-122,19,61,80
19001,SpokaneStBridge,03/02/2016 05:00:00 PM,48,-122,18,102,120
19002,SpokaneStBridge,03/02/2016 06:00:00 PM,48,-122,5,61,66
19003,SpokaneStBridge,03/02/2016 07:00:00 PM,48,-122,4,18,22
19004,SpokaneStBridge,03/02/2016 08:00:00 PM,48,-122,2,19,21
19005,SpokaneStBridge,03/02/2016 09:00:00 PM,48,-122,1,6,7
19006,SpokaneStBridge,03/02/2016 10:00:00 PM,48,-122,1,4,5
19007,SpokaneStBridge,03/02/2016 11:00:00 PM,48,-122,0,1,1
19008,SpokaneStBridge,03/03/2016 12:00:00 AM,48,-122,0,0,0
19009,SpokaneStBridge,03/03/2016 01:00:00 AM,48,-122,0,0,0
19010,SpokaneStBridge,03/03/2016 02:00:00 AM,48,-122,1,0,1
19011,SpokaneStBridge,03/03/2016 03:00:00 AM,48,-122,0,0,0
19012,SpokaneStBridge,03/03/2016 04:00:00 AM,48,-122,2,1,3
19013,SpokaneStBridge,03/03/2016 05:00:00 AM,48,-122,13,1,14
19014,SpokaneStBridge,03/03/2016 06:00:00 AM,48,-122,46,5,51
19015,SpokaneStBridge,03/03/2016 07:00:00 AM,48,-122,67,11,78
19016,SpokaneStBridge,03/03/2016 08:00:00 AM,48,-122,90,10,100
19017,SpokaneStBridge,03/03/2016 09:00:00 AM,48,-122,38,7,45
19018,SpokaneStBridge,03/03/2016 10:00:00 AM,48,-122,12,1,13
19019,SpokaneStBridge,03/03/2016 11:00:00 AM,48,-122,5,0,5
19020,SpokaneStBridge,03/03/2016 12:00:00 PM,48,-122,8,5,13
19021,SpokaneStBridge,03/03/2016 01:00:00 PM,48,-122,7,6,13
19022,SpokaneStBridge,03/03/2016 02:00:00 PM,48,-122,2,4,6
19023,SpokaneStBridge,03/03/2016 03:00:00 PM,48,-122,6,19,25
19024,SpokaneStBridge,03/03/2016 04:00:00 PM,48,-122,17,38,55
19025,SpokaneStBridge,03/03/2016 05:00:00 PM,48,-122,12,106,118
19026,SpokaneStBridge,03/03/2016 06:00:00 PM,48,-122,13,66,79
19027,SpokaneStBridge,03/03/2016 07:00:00 PM,48,-122,6,16,22
19028,SpokaneStBridge,03/03/2016 08:00:00 PM,48,-122,3,7,10
19029,SpokaneStBridge,03/03/2016 09:00:00 PM,48,-122,0,5,5
19030,SpokaneStBridge,03/03/2016 10:00:00 PM,48,-122,2,9,11
19031,SpokaneStBridge,03/03/2016 11:00:00 PM,48,-122,0,2,2
19032,SpokaneStBridge,03/04/2016 12:00:00 AM,48,-122,0,2,2
19033,SpokaneStBridge,03/04/2016 01:00:00 AM,48,-122,0,0,0
19034,SpokaneStBridge,03/04/2016 02:00:00 AM,48,-122,0,0,0
19035,SpokaneStBridge,03/04/2016 03:00:00 AM,48,-122,0,1,1
19036,SpokaneStBridge,03/04/2016 04:00:00 AM,48,-122,5,0,5
19037,SpokaneStBridge,03/04/2016 05:00:00 AM,48,-122,10,1,11
19038,SpokaneStBridge,03/04/2016 06:00:00 AM,48,-122,42,3,45
19039,SpokaneStBridge,03/04/2016 07:00:00 AM,48,-122,69,12,81
19040,SpokaneStBridge,03/04/2016 08:00:00 AM,48,-122,98,6,104
19041,SpokaneStBridge,03/04/2016 09:00:00 AM,48,-122,25,8,33
19042,SpokaneStBridge,03/04/2016 10:00:00 AM,48,-122,16,5,21
19043,SpokaneStBridge,03/04/2016 11:00:00 AM,48,-122,14,5,19
19044,SpokaneStBridge,03/04/2016 12:00:00 PM,48,-122,6,9,15
19045,SpokaneStBridge,03/04/2016 01:00:00 PM,48,-122,8,7,15
19046,SpokaneStBridge,03/04/2016 02:00:00 PM,48,-122,5,12,17
19047,SpokaneStBridge,03/04/2016 03:00:00 PM,48,-122,4,14,18
19048,SpokaneStBridge,03/04/2016 04:00:00 PM,48,-122,9,39,48
19049,SpokaneStBridge,03/04/2016 05:00:00 PM,48,-122,4,82,86
19050,SpokaneStBridge,03/04/2016 06:00:00 PM,48,-122,4,38,42
19051,SpokaneStBridge,03/04/2016 07:00:00 PM,48,-122,4,23,27
19052,SpokaneStBridge,03/04/2016 08:00:00 PM,48,-122,3,6,9
19053,SpokaneStBridge,03/04/2016 09:00:00 PM,48,-122,1,4,5
19054,SpokaneStBridge,03/04/2016 10:00:00 PM,48,-122,1,2,3
19055,SpokaneStBridge,03/04/2016 11:00:00 PM,48,-122,0,1,1
19056,SpokaneStBridge,03/05/2016 12:00:00 AM,48,-122,0,1,1
19057,SpokaneStBridge,03/05/2016 01:00:00 AM,48,-122,0,1,1
19058,SpokaneStBridge,03/05/2016 02:00:00 AM,48,-122,0,0,0
19059,SpokaneStBridge,03/05/2016 03:00:00 AM,48,-122,0,0,0
19060,SpokaneStBridge,03/05/2016 04:00:00 AM,48,-122,1,0,1
19061,SpokaneStBridge,03/05/2016 05:00:00 AM,48,-122,7,1,8
19062,SpokaneStBridge,03/05/2016 06:00:00 AM,48,-122,5,1,6
19063,SpokaneStBridge,03/05/2016 07:00:00 AM,48,-122,7,1,8
19064,SpokaneStBridge,03/05/2016 08:00:00 AM,48,-122,15,7,22
19065,SpokaneStBridge,03/05/2016 09:00:00 AM,48,-122,7,6,13
19066,SpokaneStBridge,03/05/2016 10:00:00 AM,48,-122,25,22,47
19067,SpokaneStBridge,03/05/2016 11:00:00 AM,48,-122,29,25,54
19068,SpokaneStBridge,03/05/2016 12:00:00 PM,48,-122,32,43,75
19069,SpokaneStBridge,03/05/2016 01:00:00 PM,48,-122,38,43,81
19070,SpokaneStBridge,03/05/2016 02:00:00 PM,48,-122,28,56,84
19071,SpokaneStBridge,03/05/2016 03:00:00 PM,48,-122,38,46,84
19072,SpokaneStBridge,03/05/2016 04:00:00 PM,48,-122,25,14,39
19073,SpokaneStBridge,03/05/2016 05:00:00 PM,48,-122,10,8,18
19074,SpokaneStBridge,03/05/2016 06:00:00 PM,48,-122,15,4,19
19075,SpokaneStBridge,03/05/2016 07:00:00 PM,48,-122,3,7,10
19076,SpokaneStBridge,03/05/2016 08:00:00 PM,48,-122,1,1,2
19077,SpokaneStBridge,03/05/2016 09:00:00 PM,48,-122,2,0,2
19078,SpokaneStBridge,03/05/2016 10:00:00 PM,48,-122,3,4,7
19079,SpokaneStBridge,03/05/2016 11:00:00 PM,48,-122,1,0,1
19080,SpokaneStBridge,03/06/2016 12:00:00 AM,48,-122,0,0,0
19081,SpokaneStBridge,03/06/2016 01:00:00 AM,48,-122,1,3,4
19082,SpokaneStBridge,03/06/2016 02:00:00 AM,48,-122,0,1,1
19083,SpokaneStBridge,03/06/2016 03:00:00 AM,48,-122,0,0,0
19084,SpokaneStBridge,03/06/2016 04:00:00 AM,48,-122,0,1,1
19085,SpokaneStBridge,03/06/2016 05:00:00 AM,48,-122,3,0,3
19086,SpokaneStBridge,03/06/2016 06:00:00 AM,48,-122,3,0,3
19087,SpokaneStBridge,03/06/2016 07:00:00 AM,48,-122,8,3,11
19088,SpokaneStBridge,03/06/2016 08:00:00 AM,48,-122,4,5,9
19089,SpokaneStBridge,03/06/2016 09:00:00 AM,48,-122,6,5,11
19090,SpokaneStBridge,03/06/2016 10:00:00 AM,48,-122,5,2,7
19091,SpokaneStBridge,03/06/2016 11:00:00 AM,48,-122,11,11,22
19092,SpokaneStBridge,03/06/2016 12:00:00 PM,48,-122,2,6,8
19093,SpokaneStBridge,03/06/2016 01:00:00 PM,48,-122,7,6,13
19094,SpokaneStBridge,03/06/2016 02:00:00 PM,48,-122,12,6,18
19095,SpokaneStBridge,03/06/2016 03:00:00 PM,48,-122,13,13,26
19096,SpokaneStBridge,03/06/2016 04:00:00 PM,48,-122,8,12,20
19097,SpokaneStBridge,03/06/2016 05:00:00 PM,48,-122,9,5,14
19098,SpokaneStBridge,03/06/2016 06:00:00 PM,48,-122,2,3,5
19099,SpokaneStBridge,03/06/2016 07:00:00 PM,48,-122,1,3,4
19100,SpokaneStBridge,03/06/2016 08:00:00 PM,48,-122,1,1,2
19101,SpokaneStBridge,03/06/2016 09:00:00 PM,48,-122,1,2,3
19102,SpokaneStBridge,03/06/2016 10:00:00 PM,48,-122,0,0,0
19103,SpokaneStBridge,03/06/2016 11:00:00 PM,48,-122,2,2,4
19104,SpokaneStBridge,03/07/2016 12:00:00 AM,48,-122,0,0,0
19105,SpokaneStBridge,03/07/2016 01:00:00 AM,48,-122,2,1,3
19106,SpokaneStBridge,03/07/2016 02:00:00 AM,48,-122,1,0,1
19107,SpokaneStBridge,03/07/2016 03:00:00 AM,48,-122,0,1,1
19108,SpokaneStBridge,03/07/2016 04:00:00 AM,48,-122,2,1,3
19109,SpokaneStBridge,03/07/2016 05:00:00 AM,48,-122,15,1,16
19110,SpokaneStBridge,03/07/2016 06:00:00 AM,48,-122,32,10,42
19111,SpokaneStBridge,03/07/2016 07:00:00 AM,48,-122,55,7,62
19112,SpokaneStBridge,03/07/2016 08:00:00 AM,48,-122,54,7,61
19113,SpokaneStBridge,03/07/2016 09:00:00 AM,48,-122,24,6,30
19114,SpokaneStBridge,03/07/2016 10:00:00 AM,48,-122,10,2,12
19115,SpokaneStBridge,03/07/2016 11:00:00 AM,48,-122,8,5,13
19116,SpokaneStBridge,03/07/2016 12:00:00 PM,48,-122,3,2,5
19117,SpokaneStBridge,03/07/2016 01:00:00 PM,48,-122,6,2,8
19118,SpokaneStBridge,03/07/2016 02:00:00 PM,48,-122,3,5,8
19119,SpokaneStBridge,03/07/2016 03:00:00 PM,48,-122,4,18,22
19120,SpokaneStBridge,03/07/2016 04:00:00 PM,48,-122,12,47,59
19121,SpokaneStBridge,03/07/2016 05:00:00 PM,48,-122,14,93,107
19122,SpokaneStBridge,03/07/2016 06:00:00 PM,48,-122,12,52,64
19123,SpokaneStBridge,03/07/2016 07:00:00 PM,48,-122,3,16,19
19124,SpokaneStBridge,03/07/2016 08:00:00 PM,48,-122,3,5,8
19125,SpokaneStBridge,03/07/2016 09:00:00 PM,48,-122,1,6,7
19126,SpokaneStBridge,03/07/2016 10:00:00 PM,48,-122,1,3,4
19127,SpokaneStBridge,03/07/2016 11:00:00 PM,48,-122,0,1,1
19128,SpokaneStBridge,03/08/2016 12:00:00 AM,48,-122,0,1,1
19129,SpokaneStBridge,03/08/2016 01:00:00 AM,48,-122,0,0,0
19130,SpokaneStBridge,03/08/2016 02:00:00 AM,48,-122,1,0,1
19131,SpokaneStBridge,03/08/2016 03:00:00 AM,48,-122,1,2,3
19132,SpokaneStBridge,03/08/2016 04:00:00 AM,48,-122,2,0,2
19133,SpokaneStBridge,03/08/2016 05:00:00 AM,48,-122,22,3,25
19134,SpokaneStBridge,03/08/2016 06:00:00 AM,48,-122,50,10,60
19135,SpokaneStBridge,03/08/2016 07:00:00 AM,48,-122,104,11,115
19136,SpokaneStBridge,03/08/2016 08:00:00 AM,48,-122,97,8,105
19137,SpokaneStBridge,03/08/2016 09:00:00 AM,48,-122,36,4,40
19138,SpokaneStBridge,03/08/2016 10:00:00 AM,48,-122,18,3,21
19139,SpokaneStBridge,03/08/2016 11:00:00 AM,48,-122,6,4,10
19140,SpokaneStBridge,03/08/2016 12:00:00 PM,48,-122,9,6,15
19141,SpokaneStBridge,03/08/2016 01:00:00 PM,48,-122,6,3,9
19142,SpokaneStBridge,03/08/2016 02:00:00 PM,48,-122,10,12,22
19143,SpokaneStBridge,03/08/2016 03:00:00 PM,48,-122,6,22,28
19144,SpokaneStBridge,03/08/2016 04:00:00 PM,48,-122,23,66,89
19145,SpokaneStBridge,03/08/2016 05:00:00 PM,48,-122,13,112,125
19146,SpokaneStBridge,03/08/2016 06:00:00 PM,48,-122,10,72,82
19147,SpokaneStBridge,03/08/2016 07:00:00 PM,48,-122,4,25,29
19148,SpokaneStBridge,03/08/2016 08:00:00 PM,48,-122,4,13,17
19149,SpokaneStBridge,03/08/2016 09:00:00 PM,48,-122,5,8,13
19150,SpokaneStBridge,03/08/2016 10:00:00 PM,48,-122,1,7,8
19151,SpokaneStBridge,03/08/2016 11:00:00 PM,48,-122,2,2,4
19152,SpokaneStBridge,03/09/2016 12:00:00 AM,48,-122,0,1,1
19153,SpokaneStBridge,03/09/2016 01:00:00 AM,48,-122,0,0,0
19154,SpokaneStBridge,03/09/2016 02:00:00 AM,48,-122,0,1,1
19155,SpokaneStBridge,03/09/2016 03:00:00 AM,48,-122,1,1,2
19156,SpokaneStBridge,03/09/2016 04:00:00 AM,48,-122,4,3,7
19157,SpokaneStBridge,03/09/2016 05:00:00 AM,48,-122,20,0,20
19158,SpokaneStBridge,03/09/2016 06:00:00 AM,48,-122,35,12,47
19159,SpokaneStBridge,03/09/2016 07:00:00 AM,48,-122,74,12,86
19160,SpokaneStBridge,03/09/2016 08:00:00 AM,48,-122,82,11,93
19161,SpokaneStBridge,03/09/2016 09:00:00 AM,48,-122,35,5,40
19162,SpokaneStBridge,03/09/2016 10:00:00 AM,48,-122,16,2,18
19163,SpokaneStBridge,03/09/2016 11:00:00 AM,48,-122,7,6,13
19164,SpokaneStBridge,03/09/2016 12:00:00 PM,48,-122,1,3,4
19165,SpokaneStBridge,03/09/2016 01:00:00 PM,48,-122,3,2,5
19166,SpokaneStBridge,03/09/2016 02:00:00 PM,48,-122,7,4,11
19167,SpokaneStBridge,03/09/2016 03:00:00 PM,48,-122,3,14,17
19168,SpokaneStBridge,03/09/2016 04:00:00 PM,48,-122,9,35,44
19169,SpokaneStBridge,03/09/2016 05:00:00 PM,48,-122,8,74,82
19170,SpokaneStBridge,03/09/2016 06:00:00 PM,48,-122,11,41,52
19171,SpokaneStBridge,03/09/2016 07:00:00 PM,48,-122,5,16,21
19172,SpokaneStBridge,03/09/2016 08:00:00 PM,48,-122,1,11,12
19173,SpokaneStBridge,03/09/2016 09:00:00 PM,48,-122,1,1,2
19174,SpokaneStBridge,03/09/2016 10:00:00 PM,48,-122,1,2,3
19175,SpokaneStBridge,03/09/2016 11:00:00 PM,48,-122,1,1,2
19176,SpokaneStBridge,03/10/2016 12:00:00 AM,48,-122,0,0,0
19177,SpokaneStBridge,03/10/2016 01:00:00 AM,48,-122,0,0,0
19178,SpokaneStBridge,03/10/2016 02:00:00 AM,48,-122,0,1,1
19179,SpokaneStBridge,03/10/2016 03:00:00 AM,48,-122,0,0,0
19180,SpokaneStBridge,03/10/2016 04:00:00 AM,48,-122,1,1,2
19181,SpokaneStBridge,03/10/2016 05:00:00 AM,48,-122,8,2,10
19182,SpokaneStBridge,03/10/2016 06:00:00 AM,48,-122,28,5,33
19183,SpokaneStBridge,03/10/2016 07:00:00 AM,48,-122,61,9,70
19184,SpokaneStBridge,03/10/2016 08:00:00 AM,48,-122,67,5,72
19185,SpokaneStBridge,03/10/2016 09:00:00 AM,48,-122,18,4,22
19186,SpokaneStBridge,03/10/2016 10:00:00 AM,48,-122,13,4,17
19187,SpokaneStBridge,03/10/2016 11:00:00 AM,48,-122,7,3,10
19188,SpokaneStBridge,03/10/2016 12:00:00 PM,48,-122,4,1,5
19189,SpokaneStBridge,03/10/2016 01:00:00 PM,48,-122,4,11,15
19190,SpokaneStBridge,03/10/2016 02:00:00 PM,48,-122,2,5,7
19191,SpokaneStBridge,03/10/2016 03:00:00 PM,48,-122,4,19,23
19192,SpokaneStBridge,03/10/2016 04:00:00 PM,48,-122,10,26,36
19193,SpokaneStBridge,03/10/2016 05:00:00 PM,48,-122,9,79,88
19194,SpokaneStBridge,03/10/2016 06:00:00 PM,48,-122,10,51,61
19195,SpokaneStBridge,03/10/2016 07:00:00 PM,48,-122,5,15,20
19196,SpokaneStBridge,03/10/2016 08:00:00 PM,48,-122,1,7,8
19197,SpokaneStBridge,03/10/2016 09:00:00 PM,48,-122,1,3,4
19198,SpokaneStBridge,03/10/2016 10:00:00 PM,48,-122,0,4,4
19199,SpokaneStBridge,03/10/2016 11:00:00 PM,48,-122,1,2,3
19200,SpokaneStBridge,03/11/2016 12:00:00 AM,48,-122,1,3,4
19201,SpokaneStBridge,03/11/2016 01:00:00 AM,48,-122,0,1,1
19202,SpokaneStBridge,03/11/2016 02:00:00 AM,48,-122,1,1,2
19203,SpokaneStBridge,03/11/2016 03:00:00 AM,48,-122,1,0,1
19204,SpokaneStBridge,03/11/2016 04:00:00 AM,48,-122,0,0,0
19205,SpokaneStBridge,03/11/2016 05:00:00 AM,48,-122,11,1,12
19206,SpokaneStBridge,03/11/2016 06:00:00 AM,48,-122,30,8,38
19207,SpokaneStBridge,03/11/2016 07:00:00 AM,48,-122,76,9,85
19208,SpokaneStBridge,03/11/2016 08:00:00 AM,48,-122,87,7,94
19209,SpokaneStBridge,03/11/2016 09:00:00 AM,48,-122,25,5,30
19210,SpokaneStBridge,03/11/2016 10:00:00 AM,48,-122,15,2,17
19211,SpokaneStBridge,03/11/2016 11:00:00 AM,48,-122,7,10,17
19212,SpokaneStBridge,03/11/2016 12:00:00 PM,48,-122,4,9,13
19213,SpokaneStBridge,03/11/2016 01:00:00 PM,48,-122,7,7,14
19214,SpokaneStBridge,03/11/2016 02:00:00 PM,48,-122,4,4,8
19215,SpokaneStBridge,03/11/2016 03:00:00 PM,48,-122,11,18,29
19216,SpokaneStBridge,03/11/2016 04:00:00 PM,48,-122,8,51,59
19217,SpokaneStBridge,03/11/2016 05:00:00 PM,48,-122,5,81,86
19218,SpokaneStBridge,03/11/2016 06:00:00 PM,48,-122,4,29,33
19219,SpokaneStBridge,03/11/2016 07:00:00 PM,48,-122,1,12,13
19220,SpokaneStBridge,03/11/2016 08:00:00 PM,48,-122,0,4,4
19221,SpokaneStBridge,03/11/2016 09:00:00 PM,48,-122,0,3,3
19222,SpokaneStBridge,03/11/2016 10:00:00 PM,48,-122,0,6,6
19223,SpokaneStBridge,03/11/2016 11:00:00 PM,48,-122,0,0,0
19224,SpokaneStBridge,03/12/2016 12:00:00 AM,48,-122,0,1,1
19225,SpokaneStBridge,03/12/2016 01:00:00 AM,48,-122,0,0,0
19226,SpokaneStBridge,03/12/2016 02:00:00 AM,48,-122,0,0,0
19227,SpokaneStBridge,03/12/2016 03:00:00 AM,48,-122,1,1,2
19228,SpokaneStBridge,03/12/2016 04:00:00 AM,48,-122,1,0,1
19229,SpokaneStBridge,03/12/2016 05:00:00 AM,48,-122,3,1,4
19230,SpokaneStBridge,03/12/2016 06:00:00 AM,48,-122,4,1,5
19231,SpokaneStBridge,03/12/2016 07:00:00 AM,48,-122,4,3,7
19232,SpokaneStBridge,03/12/2016 08:00:00 AM,48,-122,3,6,9
19233,SpokaneStBridge,03/12/2016 09:00:00 AM,48,-122,2,3,5
19234,SpokaneStBridge,03/12/2016 10:00:00 AM,48,-122,9,0,9
19235,SpokaneStBridge,03/12/2016 11:00:00 AM,48,-122,12,7,19
19236,SpokaneStBridge,03/12/2016 12:00:00 PM,48,-122,13,11,24
19237,SpokaneStBridge,03/12/2016 01:00:00 PM,48,-122,13,14,27
19238,SpokaneStBridge,03/12/2016 02:00:00 PM,48,-122,9,15,24
19239,SpokaneStBridge,03/12/2016 03:00:00 PM,48,-122,11,16,27
19240,SpokaneStBridge,03/12/2016 04:00:00 PM,48,-122,7,4,11
19241,SpokaneStBridge,03/12/2016 05:00:00 PM,48,-122,7,7,14
19242,SpokaneStBridge,03/12/2016 06:00:00 PM,48,-122,2,3,5
19243,SpokaneStBridge,03/12/2016 07:00:00 PM,48,-122,1,4,5
19244,SpokaneStBridge,03/12/2016 08:00:00 PM,48,-122,0,2,2
19245,SpokaneStBridge,03/12/2016 09:00:00 PM,48,-122,1,0,1
19246,SpokaneStBridge,03/12/2016 10:00:00 PM,48,-122,0,0,0
19247,SpokaneStBridge,03/12/2016 11:00:00 PM,48,-122,0,1,1
19248,SpokaneStBridge,03/13/2016 12:00:00 AM,48,-122,0,4,4
19249,SpokaneStBridge,03/13/2016 01:00:00 AM,48,-122,1,2,3
19250,SpokaneStBridge,03/13/2016 03:00:00 AM,48,-122,,,
19251,SpokaneStBridge,03/13/2016 03:00:00 AM,48,-122,0,1,1
19252,SpokaneStBridge,03/13/2016 04:00:00 AM,48,-122,0,1,1
19253,SpokaneStBridge,03/13/2016 05:00:00 AM,48,-122,3,0,3
19254,SpokaneStBridge,03/13/2016 06:00:00 AM,48,-122,1,2,3
19255,SpokaneStBridge,03/13/2016 07:00:00 AM,48,-122,1,0,1
19256,SpokaneStBridge,03/13/2016 08:00:00 AM,48,-122,7,3,10
19257,SpokaneStBridge,03/13/2016 09:00:00 AM,48,-122,7,7,14
19258,SpokaneStBridge,03/13/2016 10:00:00 AM,48,-122,6,1,7
19259,SpokaneStBridge,03/13/2016 11:00:00 AM,48,-122,2,1,3
19260,SpokaneStBridge,03/13/2016 12:00:00 PM,48,-122,7,4,11
19261,SpokaneStBridge,03/13/2016 01:00:00 PM,48,-122,2,9,11
19262,SpokaneStBridge,03/13/2016 02:00:00 PM,48,-122,6,2,8
19263,SpokaneStBridge,03/13/2016 03:00:00 PM,48,-122,8,4,12
19264,SpokaneStBridge,03/13/2016 04:00:00 PM,48,-122,0,4,4
19265,SpokaneStBridge,03/13/2016 05:00:00 PM,48,-122,4,0,4
19266,SpokaneStBridge,03/13/2016 06:00:00 PM,48,-122,3,1,4
19267,SpokaneStBridge,03/13/2016 07:00:00 PM,48,-122,1,2,3
19268,SpokaneStBridge,03/13/2016 08:00:00 PM,48,-122,0,3,3
19269,SpokaneStBridge,03/13/2016 09:00:00 PM,48,-122,0,1,1
19270,SpokaneStBridge,03/13/2016 10:00:00 PM,48,-122,1,0,1
19271,SpokaneStBridge,03/13/2016 11:00:00 PM,48,-122,0,1,1
19272,SpokaneStBridge,03/14/2016 12:00:00 AM,48,-122,1,0,1
19273,SpokaneStBridge,03/14/2016 01:00:00 AM,48,-122,0,1,1
19274,SpokaneStBridge,03/14/2016 02:00:00 AM,48,-122,0,0,0
19275,SpokaneStBridge,03/14/2016 03:00:00 AM,48,-122,0,3,3
19276,SpokaneStBridge,03/14/2016 04:00:00 AM,48,-122,1,0,1
19277,SpokaneStBridge,03/14/2016 05:00:00 AM,48,-122,13,0,13
19278,SpokaneStBridge,03/14/2016 06:00:00 AM,48,-122,28,2,30
19279,SpokaneStBridge,03/14/2016 07:00:00 AM,48,-122,64,7,71
19280,SpokaneStBridge,03/14/2016 08:00:00 AM,48,-122,69,5,74
19281,SpokaneStBridge,03/14/2016 09:00:00 AM,48,-122,28,2,30
19282,SpokaneStBridge,03/14/2016 10:00:00 AM,48,-122,15,2,17
19283,SpokaneStBridge,03/14/2016 11:00:00 AM,48,-122,6,5,11
19284,SpokaneStBridge,03/14/2016 12:00:00 PM,48,-122,5,2,7
19285,SpokaneStBridge,03/14/2016 01:00:00 PM,48,-122,7,4,11
19286,SpokaneStBridge,03/14/2016 02:00:00 PM,48,-122,5,3,8
19287,SpokaneStBridge,03/14/2016 03:00:00 PM,48,-122,2,18,20
19288,SpokaneStBridge,03/14/2016 04:00:00 PM,48,-122,12,29,41
19289,SpokaneStBridge,03/14/2016 05:00:00 PM,48,-122,10,72,82
19290,SpokaneStBridge,03/14/2016 06:00:00 PM,48,-122,6,55,61
19291,SpokaneStBridge,03/14/2016 07:00:00 PM,48,-122,4,10,14
19292,SpokaneStBridge,03/14/2016 08:00:00 PM,48,-122,2,4,6
19293,SpokaneStBridge,03/14/2016 09:00:00 PM,48,-122,1,6,7
19294,SpokaneStBridge,03/14/2016 10:00:00 PM,48,-122,0,1,1
19295,SpokaneStBridge,03/14/2016 11:00:00 PM,48,-122,0,1,1
19296,SpokaneStBridge,03/15/2016 12:00:00 AM,48,-122,1,1,2
19297,SpokaneStBridge,03/15/2016 01:00:00 AM,48,-122,1,0,1
19298,SpokaneStBridge,03/15/2016 02:00:00 AM,48,-122,0,1,1
19299,SpokaneStBridge,03/15/2016 03:00:00 AM,48,-122,1,2,3
19300,SpokaneStBridge,03/15/2016 04:00:00 AM,48,-122,5,1,6
19301,SpokaneStBridge,03/15/2016 05:00:00 AM,48,-122,11,2,13
19302,SpokaneStBridge,03/15/2016 06:00:00 AM,48,-122,46,4,50
19303,SpokaneStBridge,03/15/2016 07:00:00 AM,48,-122,65,8,73
19304,SpokaneStBridge,03/15/2016 08:00:00 AM,48,-122,77,15,92
19305,SpokaneStBridge,03/15/2016 09:00:00 AM,48,-122,30,5,35
19306,SpokaneStBridge,03/15/2016 10:00:00 AM,48,-122,14,5,19
19307,SpokaneStBridge,03/15/2016 11:00:00 AM,48,-122,8,4,12
19308,SpokaneStBridge,03/15/2016 12:00:00 PM,48,-122,8,3,11
19309,SpokaneStBridge,03/15/2016 01:00:00 PM,48,-122,8,6,14
19310,SpokaneStBridge,03/15/2016 02:00:00 PM,48,-122,3,6,9
19311,SpokaneStBridge,03/15/2016 03:00:00 PM,48,-122,6,18,24
19312,SpokaneStBridge,03/15/2016 04:00:00 PM,48,-122,17,55,72
19313,SpokaneStBridge,03/15/2016 05:00:00 PM,48,-122,13,87,100
19314,SpokaneStBridge,03/15/2016 06:00:00 PM,48,-122,20,66,86
19315,SpokaneStBridge,03/15/2016 07:00:00 PM,48,-122,4,20,24
19316,SpokaneStBridge,03/15/2016 08:00:00 PM,48,-122,3,11,14
19317,SpokaneStBridge,03/15/2016 09:00:00 PM,48,-122,2,5,7
19318,SpokaneStBridge,03/15/2016 10:00:00 PM,48,-122,2,4,6
19319,SpokaneStBridge,03/15/2016 11:00:00 PM,48,-122,2,4,6
19320,SpokaneStBridge,03/16/2016 12:00:00 AM,48,-122,2,0,2
19321,SpokaneStBridge,03/16/2016 01:00:00 AM,48,-122,0,1,1
19322,SpokaneStBridge,03/16/2016 02:00:00 AM,48,-122,0,0,0
19323,SpokaneStBridge,03/16/2016 03:00:00 AM,48,-122,0,1,1
19324,SpokaneStBridge,03/16/2016 04:00:00 AM,48,-122,3,1,4
19325,SpokaneStBridge,03/16/2016 05:00:00 AM,48,-122,14,3,17
19326,SpokaneStBridge,03/16/2016 06:00:00 AM,48,-122,54,7,61
19327,SpokaneStBridge,03/16/2016 07:00:00 AM,48,-122,75,10,85
19328,SpokaneStBridge,03/16/2016 08:00:00 AM,48,-122,120,10,130
19329,SpokaneStBridge,03/16/2016 09:00:00 AM,48,-122,45,7,52
19330,SpokaneStBridge,03/16/2016 10:00:00 AM,48,-122,18,8,26
19331,SpokaneStBridge,03/16/2016 11:00:00 AM,48,-122,18,8,26
19332,SpokaneStBridge,03/16/2016 12:00:00 PM,48,-122,11,7,18
19333,SpokaneStBridge,03/16/2016 01:00:00 PM,48,-122,4,10,14
19334,SpokaneStBridge,03/16/2016 02:00:00 PM,48,-122,13,17,30
19335,SpokaneStBridge,03/16/2016 03:00:00 PM,48,-122,16,30,46
19336,SpokaneStBridge,03/16/2016 04:00:00 PM,48,-122,17,58,75
19337,SpokaneStBridge,03/16/2016 05:00:00 PM,48,-122,16,139,155
19338,SpokaneStBridge,03/16/2016 06:00:00 PM,48,-122,17,76,93
19339,SpokaneStBridge,03/16/2016 07:00:00 PM,48,-122,12,35,47
19340,SpokaneStBridge,03/16/2016 08:00:00 PM,48,-122,8,17,25
19341,SpokaneStBridge,03/16/2016 09:00:00 PM,48,-122,6,11,17
19342,SpokaneStBridge,03/16/2016 10:00:00 PM,48,-122,2,6,8
19343,SpokaneStBridge,03/16/2016 11:00:00 PM,48,-122,2,0,2
19344,SpokaneStBridge,03/17/2016 12:00:00 AM,48,-122,0,2,2
19345,SpokaneStBridge,03/17/2016 01:00:00 AM,48,-122,0,1,1
19346,SpokaneStBridge,03/17/2016 02:00:00 AM,48,-122,0,0,0
19347,SpokaneStBridge,03/17/2016 03:00:00 AM,48,-122,0,0,0
19348,SpokaneStBridge,03/17/2016 04:00:00 AM,48,-122,1,0,1
19349,SpokaneStBridge,03/17/2016 05:00:00 AM,48,-122,18,5,23
19350,SpokaneStBridge,03/17/2016 06:00:00 AM,48,-122,54,6,60
19351,SpokaneStBridge,03/17/2016 07:00:00 AM,48,-122,86,11,97
19352,SpokaneStBridge,03/17/2016 08:00:00 AM,48,-122,123,12,135
19353,SpokaneStBridge,03/17/2016 09:00:00 AM,48,-122,38,6,44
19354,SpokaneStBridge,03/17/2016 10:00:00 AM,48,-122,23,9,32
19355,SpokaneStBridge,03/17/2016 11:00:00 AM,48,-122,7,4,11
19356,SpokaneStBridge,03/17/2016 12:00:00 PM,48,-122,8,5,13
19357,SpokaneStBridge,03/17/2016 01:00:00 PM,48,-122,9,4,13
19358,SpokaneStBridge,03/17/2016 02:00:00 PM,48,-122,9,23,32
19359,SpokaneStBridge,03/17/2016 03:00:00 PM,48,-122,17,37,54
19360,SpokaneStBridge,03/17/2016 04:00:00 PM,48,-122,19,77,96
19361,SpokaneStBridge,03/17/2016 05:00:00 PM,48,-122,32,117,149
19362,SpokaneStBridge,03/17/2016 06:00:00 PM,48,-122,13,90,103
19363,SpokaneStBridge,03/17/2016 07:00:00 PM,48,-122,7,26,33
19364,SpokaneStBridge,03/17/2016 08:00:00 PM,48,-122,6,12,18
19365,SpokaneStBridge,03/17/2016 09:00:00 PM,48,-122,1,12,13
19366,SpokaneStBridge,03/17/2016 10:00:00 PM,48,-122,1,7,8
19367,SpokaneStBridge,03/17/2016 11:00:00 PM,48,-122,1,2,3
19368,SpokaneStBridge,03/18/2016 12:00:00 AM,48,-122,2,2,4
19369,SpokaneStBridge,03/18/2016 01:00:00 AM,48,-122,0,1,1
19370,SpokaneStBridge,03/18/2016 02:00:00 AM,48,-122,0,2,2
19371,SpokaneStBridge,03/18/2016 03:00:00 AM,48,-122,0,0,0
19372,SpokaneStBridge,03/18/2016 04:00:00 AM,48,-122,2,0,2
19373,SpokaneStBridge,03/18/2016 05:00:00 AM,48,-122,14,2,16
19374,SpokaneStBridge,03/18/2016 06:00:00 AM,48,-122,38,6,44
19375,SpokaneStBridge,03/18/2016 07:00:00 AM,48,-122,89,12,101
19376,SpokaneStBridge,03/18/2016 08:00:00 AM,48,-122,109,11,120
19377,SpokaneStBridge,03/18/2016 09:00:00 AM,48,-122,38,7,45
19378,SpokaneStBridge,03/18/2016 10:00:00 AM,48,-122,18,9,27
19379,SpokaneStBridge,03/18/2016 11:00:00 AM,48,-122,15,3,18
19380,SpokaneStBridge,03/18/2016 12:00:00 PM,48,-122,17,13,30
19381,SpokaneStBridge,03/18/2016 01:00:00 PM,48,-122,7,13,20
19382,SpokaneStBridge,03/18/2016 02:00:00 PM,48,-122,9,20,29
19383,SpokaneStBridge,03/18/2016 03:00:00 PM,48,-122,16,31,47
19384,SpokaneStBridge,03/18/2016 04:00:00 PM,48,-122,25,59,84
19385,SpokaneStBridge,03/18/2016 05:00:00 PM,48,-122,25,118,143
19386,SpokaneStBridge,03/18/2016 06:00:00 PM,48,-122,12,58,70
19387,SpokaneStBridge,03/18/2016 07:00:00 PM,48,-122,11,26,37
19388,SpokaneStBridge,03/18/2016 08:00:00 PM,48,-122,9,9,18
19389,SpokaneStBridge,03/18/2016 09:00:00 PM,48,-122,2,5,7
19390,SpokaneStBridge,03/18/2016 10:00:00 PM,48,-122,1,2,3
19391,SpokaneStBridge,03/18/2016 11:00:00 PM,48,-122,0,6,6
19392,SpokaneStBridge,03/19/2016 12:00:00 AM,48,-122,0,3,3
19393,SpokaneStBridge,03/19/2016 01:00:00 AM,48,-122,1,2,3
19394,SpokaneStBridge,03/19/2016 02:00:00 AM,48,-122,0,2,2
19395,SpokaneStBridge,03/19/2016 03:00:00 AM,48,-122,0,2,2
19396,SpokaneStBridge,03/19/2016 04:00:00 AM,48,-122,1,0,1
19397,SpokaneStBridge,03/19/2016 05:00:00 AM,48,-122,1,1,2
19398,SpokaneStBridge,03/19/2016 06:00:00 AM,48,-122,2,0,2
19399,SpokaneStBridge,03/19/2016 07:00:00 AM,48,-122,8,2,10
19400,SpokaneStBridge,03/19/2016 08:00:00 AM,48,-122,20,10,30
19401,SpokaneStBridge,03/19/2016 09:00:00 AM,48,-122,19,17,36
19402,SpokaneStBridge,03/19/2016 10:00:00 AM,48,-122,20,20,40
19403,SpokaneStBridge,03/19/2016 11:00:00 AM,48,-122,40,54,94
19404,SpokaneStBridge,03/19/2016 12:00:00 PM,48,-122,38,21,59
19405,SpokaneStBridge,03/19/2016 01:00:00 PM,48,-122,21,18,39
19406,SpokaneStBridge,03/19/2016 02:00:00 PM,48,-122,24,26,50
19407,SpokaneStBridge,03/19/2016 03:00:00 PM,48,-122,28,16,44
19408,SpokaneStBridge,03/19/2016 04:00:00 PM,48,-122,28,16,44
19409,SpokaneStBridge,03/19/2016 05:00:00 PM,48,-122,17,20,37
19410,SpokaneStBridge,03/19/2016 06:00:00 PM,48,-122,12,8,20
19411,SpokaneStBridge,03/19/2016 07:00:00 PM,48,-122,11,4,15
19412,SpokaneStBridge,03/19/2016 08:00:00 PM,48,-122,4,4,8
19413,SpokaneStBridge,03/19/2016 09:00:00 PM,48,-122,1,4,5
19414,SpokaneStBridge,03/19/2016 10:00:00 PM,48,-122,0,3,3
19415,SpokaneStBridge,03/19/2016 11:00:00 PM,48,-122,0,3,3
19416,SpokaneStBridge,03/20/2016 12:00:00 AM,48,-122,1,1,2
19417,SpokaneStBridge,03/20/2016 01:00:00 AM,48,-122,1,2,3
19418,SpokaneStBridge,03/20/2016 02:00:00 AM,48,-122,1,1,2
19419,SpokaneStBridge,03/20/2016 03:00:00 AM,48,-122,0,1,1
19420,SpokaneStBridge,03/20/2016 04:00:00 AM,48,-122,0,2,2
19421,SpokaneStBridge,03/20/2016 05:00:00 AM,48,-122,3,2,5
19422,SpokaneStBridge,03/20/2016 06:00:00 AM,48,-122,0,0,0
19423,SpokaneStBridge,03/20/2016 07:00:00 AM,48,-122,3,3,6
19424,SpokaneStBridge,03/20/2016 08:00:00 AM,48,-122,11,11,22
19425,SpokaneStBridge,03/20/2016 09:00:00 AM,48,-122,14,6,20
19426,SpokaneStBridge,03/20/2016 10:00:00 AM,48,-122,9,12,21
19427,SpokaneStBridge,03/20/2016 11:00:00 AM,48,-122,8,12,20
19428,SpokaneStBridge,03/20/2016 12:00:00 PM,48,-122,7,9,16
19429,SpokaneStBridge,03/20/2016 01:00:00 PM,48,-122,7,3,10
19430,SpokaneStBridge,03/20/2016 02:00:00 PM,48,-122,4,2,6
19431,SpokaneStBridge,03/20/2016 03:00:00 PM,48,-122,4,5,9
19432,SpokaneStBridge,03/20/2016 04:00:00 PM,48,-122,2,4,6
19433,SpokaneStBridge,03/20/2016 05:00:00 PM,48,-122,7,3,10
19434,SpokaneStBridge,03/20/2016 06:00:00 PM,48,-122,2,0,2
19435,SpokaneStBridge,03/20/2016 07:00:00 PM,48,-122,1,5,6
19436,SpokaneStBridge,03/20/2016 08:00:00 PM,48,-122,1,0,1
19437,SpokaneStBridge,03/20/2016 09:00:00 PM,48,-122,3,0,3
19438,SpokaneStBridge,03/20/2016 10:00:00 PM,48,-122,1,1,2
19439,SpokaneStBridge,03/20/2016 11:00:00 PM,48,-122,0,2,2
19440,SpokaneStBridge,03/21/2016 12:00:00 AM,48,-122,0,1,1
19441,SpokaneStBridge,03/21/2016 01:00:00 AM,48,-122,1,2,3
19442,SpokaneStBridge,03/21/2016 02:00:00 AM,48,-122,0,1,1
19443,SpokaneStBridge,03/21/2016 03:00:00 AM,48,-122,0,1,1
19444,SpokaneStBridge,03/21/2016 04:00:00 AM,48,-122,2,0,2
19445,SpokaneStBridge,03/21/2016 05:00:00 AM,48,-122,12,0,12
19446,SpokaneStBridge,03/21/2016 06:00:00 AM,48,-122,24,3,27
19447,SpokaneStBridge,03/21/2016 07:00:00 AM,48,-122,68,8,76
19448,SpokaneStBridge,03/21/2016 08:00:00 AM,48,-122,63,10,73
19449,SpokaneStBridge,03/21/2016 09:00:00 AM,48,-122,21,0,21
19450,SpokaneStBridge,03/21/2016 10:00:00 AM,48,-122,13,2,15
19451,SpokaneStBridge,03/21/2016 11:00:00 AM,48,-122,2,2,4
19452,SpokaneStBridge,03/21/2016 12:00:00 PM,48,-122,6,3,9
19453,SpokaneStBridge,03/21/2016 01:00:00 PM,48,-122,5,1,6
19454,SpokaneStBridge,03/21/2016 02:00:00 PM,48,-122,6,4,10
19455,SpokaneStBridge,03/21/2016 03:00:00 PM,48,-122,5,16,21
19456,SpokaneStBridge,03/21/2016 04:00:00 PM,48,-122,7,38,45
19457,SpokaneStBridge,03/21/2016 05:00:00 PM,48,-122,10,74,84
19458,SpokaneStBridge,03/21/2016 06:00:00 PM,48,-122,6,47,53
19459,SpokaneStBridge,03/21/2016 07:00:00 PM,48,-122,4,13,17
19460,SpokaneStBridge,03/21/2016 08:00:00 PM,48,-122,4,8,12
19461,SpokaneStBridge,03/21/2016 09:00:00 PM,48,-122,0,6,6
19462,SpokaneStBridge,03/21/2016 10:00:00 PM,48,-122,0,2,2
19463,SpokaneStBridge,03/21/2016 11:00:00 PM,48,-122,0,2,2
19464,SpokaneStBridge,03/22/2016 12:00:00 AM,48,-122,0,0,0
19465,SpokaneStBridge,03/22/2016 01:00:00 AM,48,-122,0,0,0
19466,SpokaneStBridge,03/22/2016 02:00:00 AM,48,-122,0,0,0
19467,SpokaneStBridge,03/22/2016 03:00:00 AM,48,-122,2,1,3
19468,SpokaneStBridge,03/22/2016 04:00:00 AM,48,-122,5,1,6
19469,SpokaneStBridge,03/22/2016 05:00:00 AM,48,-122,16,2,18
19470,SpokaneStBridge,03/22/2016 06:00:00 AM,48,-122,48,10,58
19471,SpokaneStBridge,03/22/2016 07:00:00 AM,48,-122,112,11,123
19472,SpokaneStBridge,03/22/2016 08:00:00 AM,48,-122,90,8,98
19473,SpokaneStBridge,03/22/2016 09:00:00 AM,48,-122,28,5,33
19474,SpokaneStBridge,03/22/2016 10:00:00 AM,48,-122,10,8,18
19475,SpokaneStBridge,03/22/2016 11:00:00 AM,48,-122,13,8,21
19476,SpokaneStBridge,03/22/2016 12:00:00 PM,48,-122,17,3,20
19477,SpokaneStBridge,03/22/2016 01:00:00 PM,48,-122,8,15,23
19478,SpokaneStBridge,03/22/2016 02:00:00 PM,48,-122,11,12,23
19479,SpokaneStBridge,03/22/2016 03:00:00 PM,48,-122,8,27,35
19480,SpokaneStBridge,03/22/2016 04:00:00 PM,48,-122,10,61,71
19481,SpokaneStBridge,03/22/2016 05:00:00 PM,48,-122,15,111,126
19482,SpokaneStBridge,03/22/2016 06:00:00 PM,48,-122,15,72,87
19483,SpokaneStBridge,03/22/2016 07:00:00 PM,48,-122,10,25,35
19484,SpokaneStBridge,03/22/2016 08:00:00 PM,48,-122,5,9,14
19485,SpokaneStBridge,03/22/2016 09:00:00 PM,48,-122,2,11,13
19486,SpokaneStBridge,03/22/2016 10:00:00 PM,48,-122,0,3,3
19487,SpokaneStBridge,03/22/2016 11:00:00 PM,48,-122,1,2,3
19488,SpokaneStBridge,03/23/2016 12:00:00 AM,48,-122,0,1,1
19489,SpokaneStBridge,03/23/2016 01:00:00 AM,48,-122,1,0,1
19490,SpokaneStBridge,03/23/2016 02:00:00 AM,48,-122,0,2,2
19491,SpokaneStBridge,03/23/2016 03:00:00 AM,48,-122,1,1,2
19492,SpokaneStBridge,03/23/2016 04:00:00 AM,48,-122,0,0,0
19493,SpokaneStBridge,03/23/2016 05:00:00 AM,48,-122,19,1,20
19494,SpokaneStBridge,03/23/2016 06:00:00 AM,48,-122,40,4,44
19495,SpokaneStBridge,03/23/2016 07:00:00 AM,48,-122,83,12,95
19496,SpokaneStBridge,03/23/2016 08:00:00 AM,48,-122,88,12,100
19497,SpokaneStBridge,03/23/2016 09:00:00 AM,48,-122,30,7,37
19498,SpokaneStBridge,03/23/2016 10:00:00 AM,48,-122,18,3,21
19499,SpokaneStBridge,03/23/2016 11:00:00 AM,48,-122,5,5,10
19500,SpokaneStBridge,03/23/2016 12:00:00 PM,48,-122,10,6,16
19501,SpokaneStBridge,03/23/2016 01:00:00 PM,48,-122,6,7,13
19502,SpokaneStBridge,03/23/2016 02:00:00 PM,48,-122,6,10,16
19503,SpokaneStBridge,03/23/2016 03:00:00 PM,48,-122,10,19,29
19504,SpokaneStBridge,03/23/2016 04:00:00 PM,48,-122,15,48,63
19505,SpokaneStBridge,03/23/2016 05:00:00 PM,48,-122,22,84,106
19506,SpokaneStBridge,03/23/2016 06:00:00 PM,48,-122,9,53,62
19507,SpokaneStBridge,03/23/2016 07:00:00 PM,48,-122,3,22,25
19508,SpokaneStBridge,03/23/2016 08:00:00 PM,48,-122,2,11,13
19509,SpokaneStBridge,03/23/2016 09:00:00 PM,48,-122,1,7,8
19510,SpokaneStBridge,03/23/2016 10:00:00 PM,48,-122,0,1,1
19511,SpokaneStBridge,03/23/2016 11:00:00 PM,48,-122,0,0,0
19512,SpokaneStBridge,03/24/2016 12:00:00 AM,48,-122,0,3,3
19513,SpokaneStBridge,03/24/2016 01:00:00 AM,48,-122,1,0,1
19514,SpokaneStBridge,03/24/2016 02:00:00 AM,48,-122,0,1,1
19515,SpokaneStBridge,03/24/2016 03:00:00 AM,48,-122,1,0,1
19516,SpokaneStBridge,03/24/2016 04:00:00 AM,48,-122,1,0,1
19517,SpokaneStBridge,03/24/2016 05:00:00 AM,48,-122,13,1,14
19518,SpokaneStBridge,03/24/2016 06:00:00 AM,48,-122,43,5,48
19519,SpokaneStBridge,03/24/2016 07:00:00 AM,48,-122,77,8,85
19520,SpokaneStBridge,03/24/2016 08:00:00 AM,48,-122,94,5,99
19521,SpokaneStBridge,03/24/2016 09:00:00 AM,48,-122,37,2,39
19522,SpokaneStBridge,03/24/2016 10:00:00 AM,48,-122,12,8,20
19523,SpokaneStBridge,03/24/2016 11:00:00 AM,48,-122,10,6,16
19524,SpokaneStBridge,03/24/2016 12:00:00 PM,48,-122,11,7,18
19525,SpokaneStBridge,03/24/2016 01:00:00 PM,48,-122,11,9,20
19526,SpokaneStBridge,03/24/2016 02:00:00 PM,48,-122,11,14,25
19527,SpokaneStBridge,03/24/2016 03:00:00 PM,48,-122,14,30,44
19528,SpokaneStBridge,03/24/2016 04:00:00 PM,48,-122,10,51,61
19529,SpokaneStBridge,03/24/2016 05:00:00 PM,48,-122,19,96,115
19530,SpokaneStBridge,03/24/2016 06:00:00 PM,48,-122,10,60,70
19531,SpokaneStBridge,03/24/2016 07:00:00 PM,48,-122,7,22,29
19532,SpokaneStBridge,03/24/2016 08:00:00 PM,48,-122,3,13,16
19533,SpokaneStBridge,03/24/2016 09:00:00 PM,48,-122,1,12,13
19534,SpokaneStBridge,03/24/2016 10:00:00 PM,48,-122,1,3,4
19535,SpokaneStBridge,03/24/2016 11:00:00 PM,48,-122,1,2,3
19536,SpokaneStBridge,03/25/2016 12:00:00 AM,48,-122,0,2,2
19537,SpokaneStBridge,03/25/2016 01:00:00 AM,48,-122,1,1,2
19538,SpokaneStBridge,03/25/2016 02:00:00 AM,48,-122,1,0,1
19539,SpokaneStBridge,03/25/2016 03:00:00 AM,48,-122,1,0,1
19540,SpokaneStBridge,03/25/2016 04:00:00 AM,48,-122,1,1,2
19541,SpokaneStBridge,03/25/2016 05:00:00 AM,48,-122,7,1,8
19542,SpokaneStBridge,03/25/2016 06:00:00 AM,48,-122,38,9,47
19543,SpokaneStBridge,03/25/2016 07:00:00 AM,48,-122,73,14,87
19544,SpokaneStBridge,03/25/2016 08:00:00 AM,48,-122,90,10,100
19545,SpokaneStBridge,03/25/2016 09:00:00 AM,48,-122,39,8,47
19546,SpokaneStBridge,03/25/2016 10:00:00 AM,48,-122,17,5,22
19547,SpokaneStBridge,03/25/2016 11:00:00 AM,48,-122,14,8,22
19548,SpokaneStBridge,03/25/2016 12:00:00 PM,48,-122,14,7,21
19549,SpokaneStBridge,03/25/2016 01:00:00 PM,48,-122,15,9,24
19550,SpokaneStBridge,03/25/2016 02:00:00 PM,48,-122,11,18,29
19551,SpokaneStBridge,03/25/2016 03:00:00 PM,48,-122,20,31,51
19552,SpokaneStBridge,03/25/2016 04:00:00 PM,48,-122,21,63,84
19553,SpokaneStBridge,03/25/2016 05:00:00 PM,48,-122,26,99,125
19554,SpokaneStBridge,03/25/2016 06:00:00 PM,48,-122,14,44,58
19555,SpokaneStBridge,03/25/2016 07:00:00 PM,48,-122,7,30,37
19556,SpokaneStBridge,03/25/2016 08:00:00 PM,48,-122,9,2,11
19557,SpokaneStBridge,03/25/2016 09:00:00 PM,48,-122,5,22,27
19558,SpokaneStBridge,03/25/2016 10:00:00 PM,48,-122,1,6,7
19559,SpokaneStBridge,03/25/2016 11:00:00 PM,48,-122,1,2,3
19560,SpokaneStBridge,03/26/2016 12:00:00 AM,48,-122,0,4,4
19561,SpokaneStBridge,03/26/2016 01:00:00 AM,48,-122,0,2,2
19562,SpokaneStBridge,03/26/2016 02:00:00 AM,48,-122,1,0,1
19563,SpokaneStBridge,03/26/2016 03:00:00 AM,48,-122,1,1,2
19564,SpokaneStBridge,03/26/2016 04:00:00 AM,48,-122,0,2,2
19565,SpokaneStBridge,03/26/2016 05:00:00 AM,48,-122,1,0,1
19566,SpokaneStBridge,03/26/2016 06:00:00 AM,48,-122,5,0,5
19567,SpokaneStBridge,03/26/2016 07:00:00 AM,48,-122,13,15,28
19568,SpokaneStBridge,03/26/2016 08:00:00 AM,48,-122,18,10,28
19569,SpokaneStBridge,03/26/2016 09:00:00 AM,48,-122,7,14,21
19570,SpokaneStBridge,03/26/2016 10:00:00 AM,48,-122,22,22,44
19571,SpokaneStBridge,03/26/2016 11:00:00 AM,48,-122,25,30,55
19572,SpokaneStBridge,03/26/2016 12:00:00 PM,48,-122,39,26,65
19573,SpokaneStBridge,03/26/2016 01:00:00 PM,48,-122,54,45,99
19574,SpokaneStBridge,03/26/2016 02:00:00 PM,48,-122,38,37,75
19575,SpokaneStBridge,03/26/2016 03:00:00 PM,48,-122,39,33,72
19576,SpokaneStBridge,03/26/2016 04:00:00 PM,48,-122,25,30,55
19577,SpokaneStBridge,03/26/2016 05:00:00 PM,48,-122,33,24,57
19578,SpokaneStBridge,03/26/2016 06:00:00 PM,48,-122,4,10,14
19579,SpokaneStBridge,03/26/2016 07:00:00 PM,48,-122,9,3,12
19580,SpokaneStBridge,03/26/2016 08:00:00 PM,48,-122,2,4,6
19581,SpokaneStBridge,03/26/2016 09:00:00 PM,48,-122,0,4,4
19582,SpokaneStBridge,03/26/2016 10:00:00 PM,48,-122,2,7,9
19583,SpokaneStBridge,03/26/2016 11:00:00 PM,48,-122,0,1,1
19584,SpokaneStBridge,03/27/2016 12:00:00 AM,48,-122,0,1,1
19585,SpokaneStBridge,03/27/2016 01:00:00 AM,48,-122,0,1,1
19586,SpokaneStBridge,03/27/2016 02:00:00 AM,48,-122,0,1,1
19587,SpokaneStBridge,03/27/2016 03:00:00 AM,48,-122,0,0,0
19588,SpokaneStBridge,03/27/2016 04:00:00 AM,48,-122,0,1,1
19589,SpokaneStBridge,03/27/2016 05:00:00 AM,48,-122,3,1,4
19590,SpokaneStBridge,03/27/2016 06:00:00 AM,48,-122,3,0,3
19591,SpokaneStBridge,03/27/2016 07:00:00 AM,48,-122,0,0,0
19592,SpokaneStBridge,03/27/2016 08:00:00 AM,48,-122,3,2,5
19593,SpokaneStBridge,03/27/2016 09:00:00 AM,48,-122,6,4,10
19594,SpokaneStBridge,03/27/2016 10:00:00 AM,48,-122,7,3,10
19595,SpokaneStBridge,03/27/2016 11:00:00 AM,48,-122,4,1,5
19596,SpokaneStBridge,03/27/2016 12:00:00 PM,48,-122,4,5,9
19597,SpokaneStBridge,03/27/2016 01:00:00 PM,48,-122,2,8,10
19598,SpokaneStBridge,03/27/2016 02:00:00 PM,48,-122,4,10,14
19599,SpokaneStBridge,03/27/2016 03:00:00 PM,48,-122,9,8,17
19600,SpokaneStBridge,03/27/2016 04:00:00 PM,48,-122,1,5,6
19601,SpokaneStBridge,03/27/2016 05:00:00 PM,48,-122,4,0,4
19602,SpokaneStBridge,03/27/2016 06:00:00 PM,48,-122,2,0,2
19603,SpokaneStBridge,03/27/2016 07:00:00 PM,48,-122,5,2,7
19604,SpokaneStBridge,03/27/2016 08:00:00 PM,48,-122,0,1,1
19605,SpokaneStBridge,03/27/2016 09:00:00 PM,48,-122,0,1,1
19606,SpokaneStBridge,03/27/2016 10:00:00 PM,48,-122,0,1,1
19607,SpokaneStBridge,03/27/2016 11:00:00 PM,48,-122,0,1,1
19608,SpokaneStBridge,03/28/2016 12:00:00 AM,48,-122,0,0,0
19609,SpokaneStBridge,03/28/2016 01:00:00 AM,48,-122,0,0,0
19610,SpokaneStBridge,03/28/2016 02:00:00 AM,48,-122,0,0,0
19611,SpokaneStBridge,03/28/2016 03:00:00 AM,48,-122,0,0,0
19612,SpokaneStBridge,03/28/2016 04:00:00 AM,48,-122,3,0,3
19613,SpokaneStBridge,03/28/2016 05:00:00 AM,48,-122,22,1,23
19614,SpokaneStBridge,03/28/2016 06:00:00 AM,48,-122,42,6,48
19615,SpokaneStBridge,03/28/2016 07:00:00 AM,48,-122,98,14,112
19616,SpokaneStBridge,03/28/2016 08:00:00 AM,48,-122,114,9,123
19617,SpokaneStBridge,03/28/2016 09:00:00 AM,48,-122,31,1,32
19618,SpokaneStBridge,03/28/2016 10:00:00 AM,48,-122,13,6,19
19619,SpokaneStBridge,03/28/2016 11:00:00 AM,48,-122,12,6,18
19620,SpokaneStBridge,03/28/2016 12:00:00 PM,48,-122,8,10,18
19621,SpokaneStBridge,03/28/2016 01:00:00 PM,48,-122,11,7,18
19622,SpokaneStBridge,03/28/2016 02:00:00 PM,48,-122,4,7,11
19623,SpokaneStBridge,03/28/2016 03:00:00 PM,48,-122,13,25,38
19624,SpokaneStBridge,03/28/2016 04:00:00 PM,48,-122,17,66,83
19625,SpokaneStBridge,03/28/2016 05:00:00 PM,48,-122,23,116,139
19626,SpokaneStBridge,03/28/2016 06:00:00 PM,48,-122,11,93,104
19627,SpokaneStBridge,03/28/2016 07:00:00 PM,48,-122,6,26,32
19628,SpokaneStBridge,03/28/2016 08:00:00 PM,48,-122,10,8,18
19629,SpokaneStBridge,03/28/2016 09:00:00 PM,48,-122,0,9,9
19630,SpokaneStBridge,03/28/2016 10:00:00 PM,48,-122,0,3,3
19631,SpokaneStBridge,03/28/2016 11:00:00 PM,48,-122,0,0,0
19632,SpokaneStBridge,03/29/2016 12:00:00 AM,48,-122,0,0,0
19633,SpokaneStBridge,03/29/2016 01:00:00 AM,48,-122,1,2,3
19634,SpokaneStBridge,03/29/2016 02:00:00 AM,48,-122,0,0,0
19635,SpokaneStBridge,03/29/2016 03:00:00 AM,48,-122,1,2,3
19636,SpokaneStBridge,03/29/2016 04:00:00 AM,48,-122,4,1,5
19637,SpokaneStBridge,03/29/2016 05:00:00 AM,48,-122,21,2,23
19638,SpokaneStBridge,03/29/2016 06:00:00 AM,48,-122,59,9,68
19639,SpokaneStBridge,03/29/2016 07:00:00 AM,48,-122,132,18,150
19640,SpokaneStBridge,03/29/2016 08:00:00 AM,48,-122,130,8,138
19641,SpokaneStBridge,03/29/2016 09:00:00 AM,48,-122,46,3,49
19642,SpokaneStBridge,03/29/2016 10:00:00 AM,48,-122,16,6,22
19643,SpokaneStBridge,03/29/2016 11:00:00 AM,48,-122,13,11,24
19644,SpokaneStBridge,03/29/2016 12:00:00 PM,48,-122,13,9,22
19645,SpokaneStBridge,03/29/2016 01:00:00 PM,48,-122,8,12,20
19646,SpokaneStBridge,03/29/2016 02:00:00 PM,48,-122,18,16,34
19647,SpokaneStBridge,03/29/2016 03:00:00 PM,48,-122,19,30,49
19648,SpokaneStBridge,03/29/2016 04:00:00 PM,48,-122,27,93,120
19649,SpokaneStBridge,03/29/2016 05:00:00 PM,48,-122,22,155,177
19650,SpokaneStBridge,03/29/2016 06:00:00 PM,48,-122,28,103,131
19651,SpokaneStBridge,03/29/2016 07:00:00 PM,48,-122,14,32,46
19652,SpokaneStBridge,03/29/2016 08:00:00 PM,48,-122,6,9,15
19653,SpokaneStBridge,03/29/2016 09:00:00 PM,48,-122,11,9,20
19654,SpokaneStBridge,03/29/2016 10:00:00 PM,48,-122,2,7,9
19655,SpokaneStBridge,03/29/2016 11:00:00 PM,48,-122,1,1,2
19656,SpokaneStBridge,03/30/2016 12:00:00 AM,48,-122,0,1,1
19657,SpokaneStBridge,03/30/2016 01:00:00 AM,48,-122,1,0,1
19658,SpokaneStBridge,03/30/2016 02:00:00 AM,48,-122,0,0,0
19659,SpokaneStBridge,03/30/2016 03:00:00 AM,48,-122,2,1,3
19660,SpokaneStBridge,03/30/2016 04:00:00 AM,48,-122,0,0,0
19661,SpokaneStBridge,03/30/2016 05:00:00 AM,48,-122,29,6,35
19662,SpokaneStBridge,03/30/2016 06:00:00 AM,48,-122,64,11,75
19663,SpokaneStBridge,03/30/2016 07:00:00 AM,48,-122,135,22,157
19664,SpokaneStBridge,03/30/2016 08:00:00 AM,48,-122,130,10,140
19665,SpokaneStBridge,03/30/2016 09:00:00 AM,48,-122,63,10,73
19666,SpokaneStBridge,03/30/2016 10:00:00 AM,48,-122,26,7,33
19667,SpokaneStBridge,03/30/2016 11:00:00 AM,48,-122,28,12,40
19668,SpokaneStBridge,03/30/2016 12:00:00 PM,48,-122,12,13,25
19669,SpokaneStBridge,03/30/2016 01:00:00 PM,48,-122,13,16,29
19670,SpokaneStBridge,03/30/2016 02:00:00 PM,48,-122,18,31,49
19671,SpokaneStBridge,03/30/2016 03:00:00 PM,48,-122,22,41,63
19672,SpokaneStBridge,03/30/2016 04:00:00 PM,48,-122,29,94,123
19673,SpokaneStBridge,03/30/2016 05:00:00 PM,48,-122,36,190,226
19674,SpokaneStBridge,03/30/2016 06:00:00 PM,48,-122,33,93,126
19675,SpokaneStBridge,03/30/2016 07:00:00 PM,48,-122,16,60,76
19676,SpokaneStBridge,03/30/2016 08:00:00 PM,48,-122,15,12,27
19677,SpokaneStBridge,03/30/2016 09:00:00 PM,48,-122,3,17,20
19678,SpokaneStBridge,03/30/2016 10:00:00 PM,48,-122,1,3,4
19679,SpokaneStBridge,03/30/2016 11:00:00 PM,48,-122,3,3,6
19680,SpokaneStBridge,03/31/2016 12:00:00 AM,48,-122,0,2,2
19681,SpokaneStBridge,03/31/2016 01:00:00 AM,48,-122,1,0,1
19682,SpokaneStBridge,03/31/2016 02:00:00 AM,48,-122,0,0,0
19683,SpokaneStBridge,03/31/2016 03:00:00 AM,48,-122,1,1,2
19684,SpokaneStBridge,03/31/2016 04:00:00 AM,48,-122,1,1,2
19685,SpokaneStBridge,03/31/2016 05:00:00 AM,48,-122,21,4,25
19686,SpokaneStBridge,03/31/2016 06:00:00 AM,48,-122,65,13,78
19687,SpokaneStBridge,03/31/2016 07:00:00 AM,48,-122,136,17,153
19688,SpokaneStBridge,03/31/2016 08:00:00 AM,48,-122,117,15,132
19689,SpokaneStBridge,03/31/2016 09:00:00 AM,48,-122,71,8,79
19690,SpokaneStBridge,03/31/2016 10:00:00 AM,48,-122,25,9,34
19691,SpokaneStBridge,03/31/2016 11:00:00 AM,48,-122,18,15,33
19692,SpokaneStBridge,03/31/2016 12:00:00 PM,48,-122,22,17,39
19693,SpokaneStBridge,03/31/2016 01:00:00 PM,48,-122,14,20,34
19694,SpokaneStBridge,03/31/2016 02:00:00 PM,48,-122,19,26,45
19695,SpokaneStBridge,03/31/2016 03:00:00 PM,48,-122,27,47,74
19696,SpokaneStBridge,03/31/2016 04:00:00 PM,48,-122,23,81,104
19697,SpokaneStBridge,03/31/2016 05:00:00 PM,48,-122,34,181,215
19698,SpokaneStBridge,03/31/2016 06:00:00 PM,48,-122,31,94,125
19699,SpokaneStBridge,03/31/2016 07:00:00 PM,48,-122,12,40,52
19700,SpokaneStBridge,03/31/2016 08:00:00 PM,48,-122,3,66,69
19701,SpokaneStBridge,03/31/2016 09:00:00 PM,48,-122,11,13,24
19702,SpokaneStBridge,03/31/2016 10:00:00 PM,48,-122,8,8,16
19703,SpokaneStBridge,03/31/2016 11:00:00 PM,48,-122,13,4,17
19704,SpokaneStBridge,04/01/2016 12:00:00 AM,48,-122,9,3,12
19705,SpokaneStBridge,04/01/2016 01:00:00 AM,48,-122,12,0,12
19706,SpokaneStBridge,04/01/2016 02:00:00 AM,48,-122,0,0,0
19707,SpokaneStBridge,04/01/2016 03:00:00 AM,48,-122,1,0,1
19708,SpokaneStBridge,04/01/2016 04:00:00 AM,48,-122,2,1,3
19709,SpokaneStBridge,04/01/2016 05:00:00 AM,48,-122,20,5,25
19710,SpokaneStBridge,04/01/2016 06:00:00 AM,48,-122,61,13,74
19711,SpokaneStBridge,04/01/2016 07:00:00 AM,48,-122,103,14,117
19712,SpokaneStBridge,04/01/2016 08:00:00 AM,48,-122,119,17,136
19713,SpokaneStBridge,04/01/2016 09:00:00 AM,48,-122,41,12,53
19714,SpokaneStBridge,04/01/2016 10:00:00 AM,48,-122,26,17,43
19715,SpokaneStBridge,04/01/2016 11:00:00 AM,48,-122,13,15,28
19716,SpokaneStBridge,04/01/2016 12:00:00 PM,48,-122,30,13,43
19717,SpokaneStBridge,04/01/2016 01:00:00 PM,48,-122,17,24,41
19718,SpokaneStBridge,04/01/2016 02:00:00 PM,48,-122,20,33,53
19719,SpokaneStBridge,04/01/2016 03:00:00 PM,48,-122,26,50,76
19720,SpokaneStBridge,04/01/2016 04:00:00 PM,48,-122,31,87,118
19721,SpokaneStBridge,04/01/2016 05:00:00 PM,48,-122,31,141,172
19722,SpokaneStBridge,04/01/2016 06:00:00 PM,48,-122,25,82,107
19723,SpokaneStBridge,04/01/2016 07:00:00 PM,48,-122,27,22,49
19724,SpokaneStBridge,04/01/2016 08:00:00 PM,48,-122,10,9,19
19725,SpokaneStBridge,04/01/2016 09:00:00 PM,48,-122,8,9,17
19726,SpokaneStBridge,04/01/2016 10:00:00 PM,48,-122,2,10,12
19727,SpokaneStBridge,04/01/2016 11:00:00 PM,48,-122,2,3,5
19728,SpokaneStBridge,04/02/2016 12:00:00 AM,48,-122,2,23,25
19729,SpokaneStBridge,04/02/2016 01:00:00 AM,48,-122,10,0,10
19730,SpokaneStBridge,04/02/2016 02:00:00 AM,48,-122,8,3,11
19731,SpokaneStBridge,04/02/2016 03:00:00 AM,48,-122,0,2,2
19732,SpokaneStBridge,04/02/2016 04:00:00 AM,48,-122,1,0,1
19733,SpokaneStBridge,04/02/2016 05:00:00 AM,48,-122,3,0,3
19734,SpokaneStBridge,04/02/2016 06:00:00 AM,48,-122,8,0,8
19735,SpokaneStBridge,04/02/2016 07:00:00 AM,48,-122,18,1,19
19736,SpokaneStBridge,04/02/2016 08:00:00 AM,48,-122,18,11,29
19737,SpokaneStBridge,04/02/2016 09:00:00 AM,48,-122,14,30,44
19738,SpokaneStBridge,04/02/2016 10:00:00 AM,48,-122,37,13,50
19739,SpokaneStBridge,04/02/2016 11:00:00 AM,48,-122,24,25,49
19740,SpokaneStBridge,04/02/2016 12:00:00 PM,48,-122,29,18,47
19741,SpokaneStBridge,04/02/2016 01:00:00 PM,48,-122,25,33,58
19742,SpokaneStBridge,04/02/2016 02:00:00 PM,48,-122,15,43,58
19743,SpokaneStBridge,04/02/2016 03:00:00 PM,48,-122,42,29,71
19744,SpokaneStBridge,04/02/2016 04:00:00 PM,48,-122,35,35,70
19745,SpokaneStBridge,04/02/2016 05:00:00 PM,48,-122,24,23,47
19746,SpokaneStBridge,04/02/2016 06:00:00 PM,48,-122,27,28,55
19747,SpokaneStBridge,04/02/2016 07:00:00 PM,48,-122,5,5,10
19748,SpokaneStBridge,04/02/2016 08:00:00 PM,48,-122,7,3,10
19749,SpokaneStBridge,04/02/2016 09:00:00 PM,48,-122,1,9,10
19750,SpokaneStBridge,04/02/2016 10:00:00 PM,48,-122,0,1,1
19751,SpokaneStBridge,04/02/2016 11:00:00 PM,48,-122,0,4,4
19752,SpokaneStBridge,04/03/2016 12:00:00 AM,48,-122,0,2,2
19753,SpokaneStBridge,04/03/2016 01:00:00 AM,48,-122,0,3,3
19754,SpokaneStBridge,04/03/2016 02:00:00 AM,48,-122,1,0,1
19755,SpokaneStBridge,04/03/2016 03:00:00 AM,48,-122,0,1,1
19756,SpokaneStBridge,04/03/2016 04:00:00 AM,48,-122,1,1,2
19757,SpokaneStBridge,04/03/2016 05:00:00 AM,48,-122,4,1,5
19758,SpokaneStBridge,04/03/2016 06:00:00 AM,48,-122,21,0,21
19759,SpokaneStBridge,04/03/2016 07:00:00 AM,48,-122,12,2,14
19760,SpokaneStBridge,04/03/2016 08:00:00 AM,48,-122,10,8,18
19761,SpokaneStBridge,04/03/2016 09:00:00 AM,48,-122,22,24,46
19762,SpokaneStBridge,04/03/2016 10:00:00 AM,48,-122,28,28,56
19763,SpokaneStBridge,04/03/2016 11:00:00 AM,48,-122,27,96,123
19764,SpokaneStBridge,04/03/2016 12:00:00 PM,48,-122,30,50,80
19765,SpokaneStBridge,04/03/2016 01:00:00 PM,48,-122,37,30,67
19766,SpokaneStBridge,04/03/2016 02:00:00 PM,48,-122,59,24,83
19767,SpokaneStBridge,04/03/2016 03:00:00 PM,48,-122,44,32,76
19768,SpokaneStBridge,04/03/2016 04:00:00 PM,48,-122,52,44,96
19769,SpokaneStBridge,04/03/2016 05:00:00 PM,48,-122,16,17,33
19770,SpokaneStBridge,04/03/2016 06:00:00 PM,48,-122,12,21,33
19771,SpokaneStBridge,04/03/2016 07:00:00 PM,48,-122,14,8,22
19772,SpokaneStBridge,04/03/2016 08:00:00 PM,48,-122,4,3,7
19773,SpokaneStBridge,04/03/2016 09:00:00 PM,48,-122,0,3,3
19774,SpokaneStBridge,04/03/2016 10:00:00 PM,48,-122,1,1,2
19775,SpokaneStBridge,04/03/2016 11:00:00 PM,48,-122,1,3,4
19776,SpokaneStBridge,04/04/2016 12:00:00 AM,48,-122,0,0,0
19777,SpokaneStBridge,04/04/2016 01:00:00 AM,48,-122,0,1,1
19778,SpokaneStBridge,04/04/2016 02:00:00 AM,48,-122,1,0,1
19779,SpokaneStBridge,04/04/2016 03:00:00 AM,48,-122,1,2,3
19780,SpokaneStBridge,04/04/2016 04:00:00 AM,48,-122,4,2,6
19781,SpokaneStBridge,04/04/2016 05:00:00 AM,48,-122,16,3,19
19782,SpokaneStBridge,04/04/2016 06:00:00 AM,48,-122,43,5,48
19783,SpokaneStBridge,04/04/2016 07:00:00 AM,48,-122,97,9,106
19784,SpokaneStBridge,04/04/2016 08:00:00 AM,48,-122,97,9,106
19785,SpokaneStBridge,04/04/2016 09:00:00 AM,48,-122,33,2,35
19786,SpokaneStBridge,04/04/2016 10:00:00 AM,48,-122,17,3,20
19787,SpokaneStBridge,04/04/2016 11:00:00 AM,48,-122,12,10,22
19788,SpokaneStBridge,04/04/2016 12:00:00 PM,48,-122,7,6,13
19789,SpokaneStBridge,04/04/2016 01:00:00 PM,48,-122,15,4,19
19790,SpokaneStBridge,04/04/2016 02:00:00 PM,48,-122,11,14,25
19791,SpokaneStBridge,04/04/2016 03:00:00 PM,48,-122,6,25,31
19792,SpokaneStBridge,04/04/2016 04:00:00 PM,48,-122,9,51,60
19793,SpokaneStBridge,04/04/2016 05:00:00 PM,48,-122,20,125,145
19794,SpokaneStBridge,04/04/2016 06:00:00 PM,48,-122,15,59,74
19795,SpokaneStBridge,04/04/2016 07:00:00 PM,48,-122,7,28,35
19796,SpokaneStBridge,04/04/2016 08:00:00 PM,48,-122,2,9,11
19797,SpokaneStBridge,04/04/2016 09:00:00 PM,48,-122,1,15,16
19798,SpokaneStBridge,04/04/2016 10:00:00 PM,48,-122,1,3,4
19799,SpokaneStBridge,04/04/2016 11:00:00 PM,48,-122,3,3,6
19800,SpokaneStBridge,04/05/2016 12:00:00 AM,48,-122,0,4,4
19801,SpokaneStBridge,04/05/2016 01:00:00 AM,48,-122,1,0,1
19802,SpokaneStBridge,04/05/2016 02:00:00 AM,48,-122,0,1,1
19803,SpokaneStBridge,04/05/2016 03:00:00 AM,48,-122,1,2,3
19804,SpokaneStBridge,04/05/2016 04:00:00 AM,48,-122,2,0,2
19805,SpokaneStBridge,04/05/2016 05:00:00 AM,48,-122,22,3,25
19806,SpokaneStBridge,04/05/2016 06:00:00 AM,48,-122,61,5,66
19807,SpokaneStBridge,04/05/2016 07:00:00 AM,48,-122,136,13,149
19808,SpokaneStBridge,04/05/2016 08:00:00 AM,48,-122,121,11,132
19809,SpokaneStBridge,04/05/2016 09:00:00 AM,48,-122,40,6,46
19810,SpokaneStBridge,04/05/2016 10:00:00 AM,48,-122,13,4,17
19811,SpokaneStBridge,04/05/2016 11:00:00 AM,48,-122,3,8,11
19812,SpokaneStBridge,04/05/2016 12:00:00 PM,48,-122,15,6,21
19813,SpokaneStBridge,04/05/2016 01:00:00 PM,48,-122,18,17,35
19814,SpokaneStBridge,04/05/2016 02:00:00 PM,48,-122,12,18,30
19815,SpokaneStBridge,04/05/2016 03:00:00 PM,48,-122,12,30,42
19816,SpokaneStBridge,04/05/2016 04:00:00 PM,48,-122,23,82,105
19817,SpokaneStBridge,04/05/2016 05:00:00 PM,48,-122,15,155,170
19818,SpokaneStBridge,04/05/2016 06:00:00 PM,48,-122,15,89,104
19819,SpokaneStBridge,04/05/2016 07:00:00 PM,48,-122,5,37,42
19820,SpokaneStBridge,04/05/2016 08:00:00 PM,48,-122,6,17,23
19821,SpokaneStBridge,04/05/2016 09:00:00 PM,48,-122,2,11,13
19822,SpokaneStBridge,04/05/2016 10:00:00 PM,48,-122,2,8,10
19823,SpokaneStBridge,04/05/2016 11:00:00 PM,48,-122,2,2,4
19824,SpokaneStBridge,04/06/2016 12:00:00 AM,48,-122,2,4,6
19825,SpokaneStBridge,04/06/2016 01:00:00 AM,48,-122,2,1,3
19826,SpokaneStBridge,04/06/2016 02:00:00 AM,48,-122,1,0,1
19827,SpokaneStBridge,04/06/2016 03:00:00 AM,48,-122,0,1,1
19828,SpokaneStBridge,04/06/2016 04:00:00 AM,48,-122,3,0,3
19829,SpokaneStBridge,04/06/2016 05:00:00 AM,48,-122,21,2,23
19830,SpokaneStBridge,04/06/2016 06:00:00 AM,48,-122,60,7,67
19831,SpokaneStBridge,04/06/2016 07:00:00 AM,48,-122,131,17,148
19832,SpokaneStBridge,04/06/2016 08:00:00 AM,48,-122,146,13,159
19833,SpokaneStBridge,04/06/2016 09:00:00 AM,48,-122,54,10,64
19834,SpokaneStBridge,04/06/2016 10:00:00 AM,48,-122,26,14,40
19835,SpokaneStBridge,04/06/2016 11:00:00 AM,48,-122,17,11,28
19836,SpokaneStBridge,04/06/2016 12:00:00 PM,48,-122,14,15,29
19837,SpokaneStBridge,04/06/2016 01:00:00 PM,48,-122,16,13,29
19838,SpokaneStBridge,04/06/2016 02:00:00 PM,48,-122,15,25,40
19839,SpokaneStBridge,04/06/2016 03:00:00 PM,48,-122,20,45,65
19840,SpokaneStBridge,04/06/2016 04:00:00 PM,48,-122,25,94,119
19841,SpokaneStBridge,04/06/2016 05:00:00 PM,48,-122,31,157,188
19842,SpokaneStBridge,04/06/2016 06:00:00 PM,48,-122,31,109,140
19843,SpokaneStBridge,04/06/2016 07:00:00 PM,48,-122,21,33,54
19844,SpokaneStBridge,04/06/2016 08:00:00 PM,48,-122,9,19,28
19845,SpokaneStBridge,04/06/2016 09:00:00 PM,48,-122,2,14,16
19846,SpokaneStBridge,04/06/2016 10:00:00 PM,48,-122,1,6,7
19847,SpokaneStBridge,04/06/2016 11:00:00 PM,48,-122,1,2,3
19848,SpokaneStBridge,04/07/2016 12:00:00 AM,48,-122,1,2,3
19849,SpokaneStBridge,04/07/2016 01:00:00 AM,48,-122,0,0,0
19850,SpokaneStBridge,04/07/2016 02:00:00 AM,48,-122,0,0,0
19851,SpokaneStBridge,04/07/2016 03:00:00 AM,48,-122,0,0,0
19852,SpokaneStBridge,04/07/2016 04:00:00 AM,48,-122,7,0,7
19853,SpokaneStBridge,04/07/2016 05:00:00 AM,48,-122,28,1,29
19854,SpokaneStBridge,04/07/2016 06:00:00 AM,48,-122,91,11,102
19855,SpokaneStBridge,04/07/2016 07:00:00 AM,48,-122,149,11,160
19856,SpokaneStBridge,04/07/2016 08:00:00 AM,48,-122,144,23,167
19857,SpokaneStBridge,04/07/2016 09:00:00 AM,48,-122,44,10,54
19858,SpokaneStBridge,04/07/2016 10:00:00 AM,48,-122,31,9,40
19859,SpokaneStBridge,04/07/2016 11:00:00 AM,48,-122,15,16,31
19860,SpokaneStBridge,04/07/2016 12:00:00 PM,48,-122,18,19,37
19861,SpokaneStBridge,04/07/2016 01:00:00 PM,48,-122,23,20,43
19862,SpokaneStBridge,04/07/2016 02:00:00 PM,48,-122,17,30,47
19863,SpokaneStBridge,04/07/2016 03:00:00 PM,48,-122,37,44,81
19864,SpokaneStBridge,04/07/2016 04:00:00 PM,48,-122,24,110,134
19865,SpokaneStBridge,04/07/2016 05:00:00 PM,48,-122,32,198,230
19866,SpokaneStBridge,04/07/2016 06:00:00 PM,48,-122,26,126,152
19867,SpokaneStBridge,04/07/2016 07:00:00 PM,48,-122,20,44,64
19868,SpokaneStBridge,04/07/2016 08:00:00 PM,48,-122,13,29,42
19869,SpokaneStBridge,04/07/2016 09:00:00 PM,48,-122,6,13,19
19870,SpokaneStBridge,04/07/2016 10:00:00 PM,48,-122,1,3,4
19871,SpokaneStBridge,04/07/2016 11:00:00 PM,48,-122,1,4,5
19872,SpokaneStBridge,04/08/2016 12:00:00 AM,48,-122,0,2,2
19873,SpokaneStBridge,04/08/2016 01:00:00 AM,48,-122,1,2,3
19874,SpokaneStBridge,04/08/2016 02:00:00 AM,48,-122,1,1,2
19875,SpokaneStBridge,04/08/2016 03:00:00 AM,48,-122,0,0,0
19876,SpokaneStBridge,04/08/2016 04:00:00 AM,48,-122,3,0,3
19877,SpokaneStBridge,04/08/2016 05:00:00 AM,48,-122,19,1,20
19878,SpokaneStBridge,04/08/2016 06:00:00 AM,48,-122,55,9,64
19879,SpokaneStBridge,04/08/2016 07:00:00 AM,48,-122,120,16,136
19880,SpokaneStBridge,04/08/2016 08:00:00 AM,48,-122,120,17,137
19881,SpokaneStBridge,04/08/2016 09:00:00 AM,48,-122,49,8,57
19882,SpokaneStBridge,04/08/2016 10:00:00 AM,48,-122,20,6,26
19883,SpokaneStBridge,04/08/2016 11:00:00 AM,48,-122,20,17,37
19884,SpokaneStBridge,04/08/2016 12:00:00 PM,48,-122,13,20,33
19885,SpokaneStBridge,04/08/2016 01:00:00 PM,48,-122,25,24,49
19886,SpokaneStBridge,04/08/2016 02:00:00 PM,48,-122,17,28,45
19887,SpokaneStBridge,04/08/2016 03:00:00 PM,48,-122,24,40,64
19888,SpokaneStBridge,04/08/2016 04:00:00 PM,48,-122,29,89,118
19889,SpokaneStBridge,04/08/2016 05:00:00 PM,48,-122,31,128,159
19890,SpokaneStBridge,04/08/2016 06:00:00 PM,48,-122,17,75,92
19891,SpokaneStBridge,04/08/2016 07:00:00 PM,48,-122,10,27,37
19892,SpokaneStBridge,04/08/2016 08:00:00 PM,48,-122,5,17,22
19893,SpokaneStBridge,04/08/2016 09:00:00 PM,48,-122,3,8,11
19894,SpokaneStBridge,04/08/2016 10:00:00 PM,48,-122,3,16,19
19895,SpokaneStBridge,04/08/2016 11:00:00 PM,48,-122,0,6,6
19896,SpokaneStBridge,04/09/2016 12:00:00 AM,48,-122,1,4,5
19897,SpokaneStBridge,04/09/2016 01:00:00 AM,48,-122,0,2,2
19898,SpokaneStBridge,04/09/2016 02:00:00 AM,48,-122,2,1,3
19899,SpokaneStBridge,04/09/2016 03:00:00 AM,48,-122,0,2,2
19900,SpokaneStBridge,04/09/2016 04:00:00 AM,48,-122,2,1,3
19901,SpokaneStBridge,04/09/2016 05:00:00 AM,48,-122,4,0,4
19902,SpokaneStBridge,04/09/2016 06:00:00 AM,48,-122,6,4,10
19903,SpokaneStBridge,04/09/2016 07:00:00 AM,48,-122,29,4,33
19904,SpokaneStBridge,04/09/2016 08:00:00 AM,48,-122,16,24,40
19905,SpokaneStBridge,04/09/2016 09:00:00 AM,48,-122,51,14,65
19906,SpokaneStBridge,04/09/2016 10:00:00 AM,48,-122,42,27,69
19907,SpokaneStBridge,04/09/2016 11:00:00 AM,48,-122,37,41,78
19908,SpokaneStBridge,04/09/2016 12:00:00 PM,48,-122,23,30,53
19909,SpokaneStBridge,04/09/2016 01:00:00 PM,48,-122,34,88,122
19910,SpokaneStBridge,04/09/2016 02:00:00 PM,48,-122,45,46,91
19911,SpokaneStBridge,04/09/2016 03:00:00 PM,48,-122,32,47,79
19912,SpokaneStBridge,04/09/2016 04:00:00 PM,48,-122,43,41,84
19913,SpokaneStBridge,04/09/2016 05:00:00 PM,48,-122,30,22,52
19914,SpokaneStBridge,04/09/2016 06:00:00 PM,48,-122,25,11,36
19915,SpokaneStBridge,04/09/2016 07:00:00 PM,48,-122,12,9,21
19916,SpokaneStBridge,04/09/2016 08:00:00 PM,48,-122,9,8,17
19917,SpokaneStBridge,04/09/2016 09:00:00 PM,48,-122,0,10,10
19918,SpokaneStBridge,04/09/2016 10:00:00 PM,48,-122,1,3,4
19919,SpokaneStBridge,04/09/2016 11:00:00 PM,48,-122,1,1,2
19920,SpokaneStBridge,04/10/2016 12:00:00 AM,48,-122,2,1,3
19921,SpokaneStBridge,04/10/2016 01:00:00 AM,48,-122,1,6,7
19922,SpokaneStBridge,04/10/2016 02:00:00 AM,48,-122,0,1,1
19923,SpokaneStBridge,04/10/2016 03:00:00 AM,48,-122,1,4,5
19924,SpokaneStBridge,04/10/2016 04:00:00 AM,48,-122,2,1,3
19925,SpokaneStBridge,04/10/2016 05:00:00 AM,48,-122,5,1,6
19926,SpokaneStBridge,04/10/2016 06:00:00 AM,48,-122,2,0,2
19927,SpokaneStBridge,04/10/2016 07:00:00 AM,48,-122,6,2,8
19928,SpokaneStBridge,04/10/2016 08:00:00 AM,48,-122,17,6,23
19929,SpokaneStBridge,04/10/2016 09:00:00 AM,48,-122,11,16,27
19930,SpokaneStBridge,04/10/2016 10:00:00 AM,48,-122,22,22,44
19931,SpokaneStBridge,04/10/2016 11:00:00 AM,48,-122,18,20,38
19932,SpokaneStBridge,04/10/2016 12:00:00 PM,48,-122,23,15,38
19933,SpokaneStBridge,04/10/2016 01:00:00 PM,48,-122,28,24,52
19934,SpokaneStBridge,04/10/2016 02:00:00 PM,48,-122,20,24,44
19935,SpokaneStBridge,04/10/2016 03:00:00 PM,48,-122,30,26,56
19936,SpokaneStBridge,04/10/2016 04:00:00 PM,48,-122,19,20,39
19937,SpokaneStBridge,04/10/2016 05:00:00 PM,48,-122,16,15,31
19938,SpokaneStBridge,04/10/2016 06:00:00 PM,48,-122,19,31,50
19939,SpokaneStBridge,04/10/2016 07:00:00 PM,48,-122,10,8,18
19940,SpokaneStBridge,04/10/2016 08:00:00 PM,48,-122,2,4,6
19941,SpokaneStBridge,04/10/2016 09:00:00 PM,48,-122,5,4,9
19942,SpokaneStBridge,04/10/2016 10:00:00 PM,48,-122,1,2,3
19943,SpokaneStBridge,04/10/2016 11:00:00 PM,48,-122,0,1,1
19944,SpokaneStBridge,04/11/2016 12:00:00 AM,48,-122,0,2,2
19945,SpokaneStBridge,04/11/2016 01:00:00 AM,48,-122,0,1,1
19946,SpokaneStBridge,04/11/2016 02:00:00 AM,48,-122,0,1,1
19947,SpokaneStBridge,04/11/2016 03:00:00 AM,48,-122,0,1,1
19948,SpokaneStBridge,04/11/2016 04:00:00 AM,48,-122,3,0,3
19949,SpokaneStBridge,04/11/2016 05:00:00 AM,48,-122,19,1,20
19950,SpokaneStBridge,04/11/2016 06:00:00 AM,48,-122,57,6,63
19951,SpokaneStBridge,04/11/2016 07:00:00 AM,48,-122,102,13,115
19952,SpokaneStBridge,04/11/2016 08:00:00 AM,48,-122,119,14,133
19953,SpokaneStBridge,04/11/2016 09:00:00 AM,48,-122,36,12,48
19954,SpokaneStBridge,04/11/2016 10:00:00 AM,48,-122,14,3,17
19955,SpokaneStBridge,04/11/2016 11:00:00 AM,48,-122,11,9,20
19956,SpokaneStBridge,04/11/2016 12:00:00 PM,48,-122,11,12,23
19957,SpokaneStBridge,04/11/2016 01:00:00 PM,48,-122,5,8,13
19958,SpokaneStBridge,04/11/2016 02:00:00 PM,48,-122,11,21,32
19959,SpokaneStBridge,04/11/2016 03:00:00 PM,48,-122,15,27,42
19960,SpokaneStBridge,04/11/2016 04:00:00 PM,48,-122,15,68,83
19961,SpokaneStBridge,04/11/2016 05:00:00 PM,48,-122,16,154,170
19962,SpokaneStBridge,04/11/2016 06:00:00 PM,48,-122,22,70,92
19963,SpokaneStBridge,04/11/2016 07:00:00 PM,48,-122,9,28,37
19964,SpokaneStBridge,04/11/2016 08:00:00 PM,48,-122,3,7,10
19965,SpokaneStBridge,04/11/2016 09:00:00 PM,48,-122,3,6,9
19966,SpokaneStBridge,04/11/2016 10:00:00 PM,48,-122,1,5,6
19967,SpokaneStBridge,04/11/2016 11:00:00 PM,48,-122,0,2,2
19968,SpokaneStBridge,04/12/2016 12:00:00 AM,48,-122,0,3,3
19969,SpokaneStBridge,04/12/2016 01:00:00 AM,48,-122,0,1,1
19970,SpokaneStBridge,04/12/2016 02:00:00 AM,48,-122,1,0,1
19971,SpokaneStBridge,04/12/2016 03:00:00 AM,48,-122,1,1,2
19972,SpokaneStBridge,04/12/2016 04:00:00 AM,48,-122,5,1,6
19973,SpokaneStBridge,04/12/2016 05:00:00 AM,48,-122,18,3,21
19974,SpokaneStBridge,04/12/2016 06:00:00 AM,48,-122,53,7,60
19975,SpokaneStBridge,04/12/2016 07:00:00 AM,48,-122,91,15,106
19976,SpokaneStBridge,04/12/2016 08:00:00 AM,48,-122,81,15,96
19977,SpokaneStBridge,04/12/2016 09:00:00 AM,48,-122,29,1,30
19978,SpokaneStBridge,04/12/2016 10:00:00 AM,48,-122,14,11,25
19979,SpokaneStBridge,04/12/2016 11:00:00 AM,48,-122,12,9,21
19980,SpokaneStBridge,04/12/2016 12:00:00 PM,48,-122,10,7,17
19981,SpokaneStBridge,04/12/2016 01:00:00 PM,48,-122,10,6,16
19982,SpokaneStBridge,04/12/2016 02:00:00 PM,48,-122,10,12,22
19983,SpokaneStBridge,04/12/2016 03:00:00 PM,48,-122,7,18,25
19984,SpokaneStBridge,04/12/2016 04:00:00 PM,48,-122,5,25,30
19985,SpokaneStBridge,04/12/2016 05:00:00 PM,48,-122,10,89,99
19986,SpokaneStBridge,04/12/2016 06:00:00 PM,48,-122,7,47,54
19987,SpokaneStBridge,04/12/2016 07:00:00 PM,48,-122,2,19,21
19988,SpokaneStBridge,04/12/2016 08:00:00 PM,48,-122,1,8,9
19989,SpokaneStBridge,04/12/2016 09:00:00 PM,48,-122,0,8,8
19990,SpokaneStBridge,04/12/2016 10:00:00 PM,48,-122,1,2,3
19991,SpokaneStBridge,04/12/2016 11:00:00 PM,48,-122,0,0,0
19992,SpokaneStBridge,04/13/2016 12:00:00 AM,48,-122,0,0,0
19993,SpokaneStBridge,04/13/2016 01:00:00 AM,48,-122,0,1,1
19994,SpokaneStBridge,04/13/2016 02:00:00 AM,48,-122,1,0,1
19995,SpokaneStBridge,04/13/2016 03:00:00 AM,48,-122,0,1,1
19996,SpokaneStBridge,04/13/2016 04:00:00 AM,48,-122,2,0,2
19997,SpokaneStBridge,04/13/2016 05:00:00 AM,48,-122,8,5,13
19998,SpokaneStBridge,04/13/2016 06:00:00 AM,48,-122,40,5,45
19999,SpokaneStBridge,04/13/2016 07:00:00 AM,48,-122,93,15,108
20000,SpokaneStBridge,04/13/2016 08:00:00 AM,48,-122,103,9,112
20001,SpokaneStBridge,04/13/2016 09:00:00 AM,48,-122,40,6,46
20002,SpokaneStBridge,04/13/2016 10:00:00 AM,48,-122,15,4,19
20003,SpokaneStBridge,04/13/2016 11:00:00 AM,48,-122,10,7,17
20004,SpokaneStBridge,04/13/2016 12:00:00 PM,48,-122,18,13,31
20005,SpokaneStBridge,04/13/2016 01:00:00 PM,48,-122,10,8,18
20006,SpokaneStBridge,04/13/2016 02:00:00 PM,48,-122,11,15,26
20007,SpokaneStBridge,04/13/2016 03:00:00 PM,48,-122,7,19,26
20008,SpokaneStBridge,04/13/2016 04:00:00 PM,48,-122,22,69,91
20009,SpokaneStBridge,04/13/2016 05:00:00 PM,48,-122,18,125,143
20010,SpokaneStBridge,04/13/2016 06:00:00 PM,48,-122,20,70,90
20011,SpokaneStBridge,04/13/2016 07:00:00 PM,48,-122,9,43,52
20012,SpokaneStBridge,04/13/2016 08:00:00 PM,48,-122,17,22,39
20013,SpokaneStBridge,04/13/2016 09:00:00 PM,48,-122,1,11,12
20014,SpokaneStBridge,04/13/2016 10:00:00 PM,48,-122,2,2,4
20015,SpokaneStBridge,04/13/2016 11:00:00 PM,48,-122,2,3,5
20016,SpokaneStBridge,04/14/2016 12:00:00 AM,48,-122,1,2,3
20017,SpokaneStBridge,04/14/2016 01:00:00 AM,48,-122,0,1,1
20018,SpokaneStBridge,04/14/2016 02:00:00 AM,48,-122,0,0,0
20019,SpokaneStBridge,04/14/2016 03:00:00 AM,48,-122,0,0,0
20020,SpokaneStBridge,04/14/2016 04:00:00 AM,48,-122,5,2,7
20021,SpokaneStBridge,04/14/2016 05:00:00 AM,48,-122,14,3,17
20022,SpokaneStBridge,04/14/2016 06:00:00 AM,48,-122,40,4,44
20023,SpokaneStBridge,04/14/2016 07:00:00 AM,48,-122,92,14,106
20024,SpokaneStBridge,04/14/2016 08:00:00 AM,48,-122,116,9,125
20025,SpokaneStBridge,04/14/2016 09:00:00 AM,48,-122,46,7,53
20026,SpokaneStBridge,04/14/2016 10:00:00 AM,48,-122,17,2,19
20027,SpokaneStBridge,04/14/2016 11:00:00 AM,48,-122,7,11,18
20028,SpokaneStBridge,04/14/2016 12:00:00 PM,48,-122,11,6,17
20029,SpokaneStBridge,04/14/2016 01:00:00 PM,48,-122,16,16,32
20030,SpokaneStBridge,04/14/2016 02:00:00 PM,48,-122,8,23,31
20031,SpokaneStBridge,04/14/2016 03:00:00 PM,48,-122,17,34,51
20032,SpokaneStBridge,04/14/2016 04:00:00 PM,48,-122,23,60,83
20033,SpokaneStBridge,04/14/2016 05:00:00 PM,48,-122,14,131,145
20034,SpokaneStBridge,04/14/2016 06:00:00 PM,48,-122,18,67,85
20035,SpokaneStBridge,04/14/2016 07:00:00 PM,48,-122,11,37,48
20036,SpokaneStBridge,04/14/2016 08:00:00 PM,48,-122,3,15,18
20037,SpokaneStBridge,04/14/2016 09:00:00 PM,48,-122,2,8,10
20038,SpokaneStBridge,04/14/2016 10:00:00 PM,48,-122,2,2,4
20039,SpokaneStBridge,04/14/2016 11:00:00 PM,48,-122,9,10,19
20040,SpokaneStBridge,04/15/2016 12:00:00 AM,48,-122,0,3,3
20041,SpokaneStBridge,04/15/2016 01:00:00 AM,48,-122,0,0,0
20042,SpokaneStBridge,04/15/2016 02:00:00 AM,48,-122,0,0,0
20043,SpokaneStBridge,04/15/2016 03:00:00 AM,48,-122,0,2,2
20044,SpokaneStBridge,04/15/2016 04:00:00 AM,48,-122,0,0,0
20045,SpokaneStBridge,04/15/2016 05:00:00 AM,48,-122,12,1,13
20046,SpokaneStBridge,04/15/2016 06:00:00 AM,48,-122,49,2,51
20047,SpokaneStBridge,04/15/2016 07:00:00 AM,48,-122,95,12,107
20048,SpokaneStBridge,04/15/2016 08:00:00 AM,48,-122,85,9,94
20049,SpokaneStBridge,04/15/2016 09:00:00 AM,48,-122,52,6,58
20050,SpokaneStBridge,04/15/2016 10:00:00 AM,48,-122,24,9,33
20051,SpokaneStBridge,04/15/2016 11:00:00 AM,48,-122,15,10,25
20052,SpokaneStBridge,04/15/2016 12:00:00 PM,48,-122,15,13,28
20053,SpokaneStBridge,04/15/2016 01:00:00 PM,48,-122,10,14,24
20054,SpokaneStBridge,04/15/2016 02:00:00 PM,48,-122,8,11,19
20055,SpokaneStBridge,04/15/2016 03:00:00 PM,48,-122,13,32,45
20056,SpokaneStBridge,04/15/2016 04:00:00 PM,48,-122,19,75,94
20057,SpokaneStBridge,04/15/2016 05:00:00 PM,48,-122,18,101,119
20058,SpokaneStBridge,04/15/2016 06:00:00 PM,48,-122,5,54,59
20059,SpokaneStBridge,04/15/2016 07:00:00 PM,48,-122,11,20,31
20060,SpokaneStBridge,04/15/2016 08:00:00 PM,48,-122,3,8,11
20061,SpokaneStBridge,04/15/2016 09:00:00 PM,48,-122,2,9,11
20062,SpokaneStBridge,04/15/2016 10:00:00 PM,48,-122,4,4,8
20063,SpokaneStBridge,04/15/2016 11:00:00 PM,48,-122,1,1,2
20064,SpokaneStBridge,04/16/2016 12:00:00 AM,48,-122,0,3,3
20065,SpokaneStBridge,04/16/2016 01:00:00 AM,48,-122,1,2,3
20066,SpokaneStBridge,04/16/2016 02:00:00 AM,48,-122,1,1,2
20067,SpokaneStBridge,04/16/2016 03:00:00 AM,48,-122,0,1,1
20068,SpokaneStBridge,04/16/2016 04:00:00 AM,48,-122,1,1,2
20069,SpokaneStBridge,04/16/2016 05:00:00 AM,48,-122,2,0,2
20070,SpokaneStBridge,04/16/2016 06:00:00 AM,48,-122,5,0,5
20071,SpokaneStBridge,04/16/2016 07:00:00 AM,48,-122,16,17,33
20072,SpokaneStBridge,04/16/2016 08:00:00 AM,48,-122,27,47,74
20073,SpokaneStBridge,04/16/2016 09:00:00 AM,48,-122,29,36,65
20074,SpokaneStBridge,04/16/2016 10:00:00 AM,48,-122,26,30,56
20075,SpokaneStBridge,04/16/2016 11:00:00 AM,48,-122,31,30,61
20076,SpokaneStBridge,04/16/2016 12:00:00 PM,48,-122,45,35,80
20077,SpokaneStBridge,04/16/2016 01:00:00 PM,48,-122,49,42,91
20078,SpokaneStBridge,04/16/2016 02:00:00 PM,48,-122,63,34,97
20079,SpokaneStBridge,04/16/2016 03:00:00 PM,48,-122,29,33,62
20080,SpokaneStBridge,04/16/2016 04:00:00 PM,48,-122,37,16,53
20081,SpokaneStBridge,04/16/2016 05:00:00 PM,48,-122,28,21,49
20082,SpokaneStBridge,04/16/2016 06:00:00 PM,48,-122,6,11,17
20083,SpokaneStBridge,04/16/2016 07:00:00 PM,48,-122,19,13,32
20084,SpokaneStBridge,04/16/2016 08:00:00 PM,48,-122,5,5,10
20085,SpokaneStBridge,04/16/2016 09:00:00 PM,48,-122,4,10,14
20086,SpokaneStBridge,04/16/2016 10:00:00 PM,48,-122,2,6,8
20087,SpokaneStBridge,04/16/2016 11:00:00 PM,48,-122,2,0,2
20088,SpokaneStBridge,04/17/2016 12:00:00 AM,48,-122,1,2,3
20089,SpokaneStBridge,04/17/2016 01:00:00 AM,48,-122,0,2,2
20090,SpokaneStBridge,04/17/2016 02:00:00 AM,48,-122,0,1,1
20091,SpokaneStBridge,04/17/2016 03:00:00 AM,48,-122,1,4,5
20092,SpokaneStBridge,04/17/2016 04:00:00 AM,48,-122,0,1,1
20093,SpokaneStBridge,04/17/2016 05:00:00 AM,48,-122,5,0,5
20094,SpokaneStBridge,04/17/2016 06:00:00 AM,48,-122,0,1,1
20095,SpokaneStBridge,04/17/2016 07:00:00 AM,48,-122,13,1,14
20096,SpokaneStBridge,04/17/2016 08:00:00 AM,48,-122,23,14,37
20097,SpokaneStBridge,04/17/2016 09:00:00 AM,48,-122,22,32,54
20098,SpokaneStBridge,04/17/2016 10:00:00 AM,48,-122,42,45,87
20099,SpokaneStBridge,04/17/2016 11:00:00 AM,48,-122,51,35,86
20100,SpokaneStBridge,04/17/2016 12:00:00 PM,48,-122,49,55,104
20101,SpokaneStBridge,04/17/2016 01:00:00 PM,48,-122,39,67,106
20102,SpokaneStBridge,04/17/2016 02:00:00 PM,48,-122,67,56,123
20103,SpokaneStBridge,04/17/2016 03:00:00 PM,48,-122,52,48,100
20104,SpokaneStBridge,04/17/2016 04:00:00 PM,48,-122,36,34,70
20105,SpokaneStBridge,04/17/2016 05:00:00 PM,48,-122,34,28,62
20106,SpokaneStBridge,04/17/2016 06:00:00 PM,48,-122,34,25,59
20107,SpokaneStBridge,04/17/2016 07:00:00 PM,48,-122,16,14,30
20108,SpokaneStBridge,04/17/2016 08:00:00 PM,48,-122,9,9,18
20109,SpokaneStBridge,04/17/2016 09:00:00 PM,48,-122,7,4,11
20110,SpokaneStBridge,04/17/2016 10:00:00 PM,48,-122,1,1,2
20111,SpokaneStBridge,04/17/2016 11:00:00 PM,48,-122,2,1,3
20112,SpokaneStBridge,04/18/2016 12:00:00 AM,48,-122,3,3,6
20113,SpokaneStBridge,04/18/2016 01:00:00 AM,48,-122,1,0,1
20114,SpokaneStBridge,04/18/2016 02:00:00 AM,48,-122,9,5,14
20115,SpokaneStBridge,04/18/2016 03:00:00 AM,48,-122,0,1,1
20116,SpokaneStBridge,04/18/2016 04:00:00 AM,48,-122,5,0,5
20117,SpokaneStBridge,04/18/2016 05:00:00 AM,48,-122,21,1,22
20118,SpokaneStBridge,04/18/2016 06:00:00 AM,48,-122,60,9,69
20119,SpokaneStBridge,04/18/2016 07:00:00 AM,48,-122,143,17,160
20120,SpokaneStBridge,04/18/2016 08:00:00 AM,48,-122,149,14,163
20121,SpokaneStBridge,04/18/2016 09:00:00 AM,48,-122,58,11,69
20122,SpokaneStBridge,04/18/2016 10:00:00 AM,48,-122,30,9,39
20123,SpokaneStBridge,04/18/2016 11:00:00 AM,48,-122,15,15,30
20124,SpokaneStBridge,04/18/2016 12:00:00 PM,48,-122,20,20,40
20125,SpokaneStBridge,04/18/2016 01:00:00 PM,48,-122,25,17,42
20126,SpokaneStBridge,04/18/2016 02:00:00 PM,48,-122,21,28,49
20127,SpokaneStBridge,04/18/2016 03:00:00 PM,48,-122,13,34,47
20128,SpokaneStBridge,04/18/2016 04:00:00 PM,48,-122,34,99,133
20129,SpokaneStBridge,04/18/2016 05:00:00 PM,48,-122,37,202,239
20130,SpokaneStBridge,04/18/2016 06:00:00 PM,48,-122,19,112,131
20131,SpokaneStBridge,04/18/2016 07:00:00 PM,48,-122,21,53,74
20132,SpokaneStBridge,04/18/2016 08:00:00 PM,48,-122,11,18,29
20133,SpokaneStBridge,04/18/2016 09:00:00 PM,48,-122,5,8,13
20134,SpokaneStBridge,04/18/2016 10:00:00 PM,48,-122,2,4,6
20135,SpokaneStBridge,04/18/2016 11:00:00 PM,48,-122,4,6,10
20136,SpokaneStBridge,04/19/2016 12:00:00 AM,48,-122,0,1,1
20137,SpokaneStBridge,04/19/2016 01:00:00 AM,48,-122,0,6,6
20138,SpokaneStBridge,04/19/2016 02:00:00 AM,48,-122,2,2,4
20139,SpokaneStBridge,04/19/2016 03:00:00 AM,48,-122,0,2,2
20140,SpokaneStBridge,04/19/2016 04:00:00 AM,48,-122,7,0,7
20141,SpokaneStBridge,04/19/2016 05:00:00 AM,48,-122,24,4,28
20142,SpokaneStBridge,04/19/2016 06:00:00 AM,48,-122,90,12,102
20143,SpokaneStBridge,04/19/2016 07:00:00 AM,48,-122,177,23,200
20144,SpokaneStBridge,04/19/2016 08:00:00 AM,48,-122,161,18,179
20145,SpokaneStBridge,04/19/2016 09:00:00 AM,48,-122,60,17,77
20146,SpokaneStBridge,04/19/2016 10:00:00 AM,48,-122,20,13,33
20147,SpokaneStBridge,04/19/2016 11:00:00 AM,48,-122,21,21,42
20148,SpokaneStBridge,04/19/2016 12:00:00 PM,48,-122,12,14,26
20149,SpokaneStBridge,04/19/2016 01:00:00 PM,48,-122,24,29,53
20150,SpokaneStBridge,04/19/2016 02:00:00 PM,48,-122,22,29,51
20151,SpokaneStBridge,04/19/2016 03:00:00 PM,48,-122,37,45,82
20152,SpokaneStBridge,04/19/2016 04:00:00 PM,48,-122,27,106,133
20153,SpokaneStBridge,04/19/2016 05:00:00 PM,48,-122,37,215,252
20154,SpokaneStBridge,04/19/2016 06:00:00 PM,48,-122,24,130,154
20155,SpokaneStBridge,04/19/2016 07:00:00 PM,48,-122,20,43,63
20156,SpokaneStBridge,04/19/2016 08:00:00 PM,48,-122,16,25,41
20157,SpokaneStBridge,04/19/2016 09:00:00 PM,48,-122,6,21,27
20158,SpokaneStBridge,04/19/2016 10:00:00 PM,48,-122,1,1,2
20159,SpokaneStBridge,04/19/2016 11:00:00 PM,48,-122,2,5,7
20160,SpokaneStBridge,04/20/2016 12:00:00 AM,48,-122,1,2,3
20161,SpokaneStBridge,04/20/2016 01:00:00 AM,48,-122,2,0,2
20162,SpokaneStBridge,04/20/2016 02:00:00 AM,48,-122,2,3,5
20163,SpokaneStBridge,04/20/2016 03:00:00 AM,48,-122,0,2,2
20164,SpokaneStBridge,04/20/2016 04:00:00 AM,48,-122,2,0,2
20165,SpokaneStBridge,04/20/2016 05:00:00 AM,48,-122,30,6,36
20166,SpokaneStBridge,04/20/2016 06:00:00 AM,48,-122,93,15,108
20167,SpokaneStBridge,04/20/2016 07:00:00 AM,48,-122,161,19,180
20168,SpokaneStBridge,04/20/2016 08:00:00 AM,48,-122,142,17,159
20169,SpokaneStBridge,04/20/2016 09:00:00 AM,48,-122,60,17,77
20170,SpokaneStBridge,04/20/2016 10:00:00 AM,48,-122,23,9,32
20171,SpokaneStBridge,04/20/2016 11:00:00 AM,48,-122,17,14,31
20172,SpokaneStBridge,04/20/2016 12:00:00 PM,48,-122,15,15,30
20173,SpokaneStBridge,04/20/2016 01:00:00 PM,48,-122,18,17,35
20174,SpokaneStBridge,04/20/2016 02:00:00 PM,48,-122,12,29,41
20175,SpokaneStBridge,04/20/2016 03:00:00 PM,48,-122,24,45,69
20176,SpokaneStBridge,04/20/2016 04:00:00 PM,48,-122,40,96,136
20177,SpokaneStBridge,04/20/2016 05:00:00 PM,48,-122,34,206,240
20178,SpokaneStBridge,04/20/2016 06:00:00 PM,48,-122,31,120,151
20179,SpokaneStBridge,04/20/2016 07:00:00 PM,48,-122,21,47,68
20180,SpokaneStBridge,04/20/2016 08:00:00 PM,48,-122,8,21,29
20181,SpokaneStBridge,04/20/2016 09:00:00 PM,48,-122,7,10,17
20182,SpokaneStBridge,04/20/2016 10:00:00 PM,48,-122,1,7,8
20183,SpokaneStBridge,04/20/2016 11:00:00 PM,48,-122,1,4,5
20184,SpokaneStBridge,04/21/2016 12:00:00 AM,48,-122,0,4,4
20185,SpokaneStBridge,04/21/2016 01:00:00 AM,48,-122,1,0,1
20186,SpokaneStBridge,04/21/2016 02:00:00 AM,48,-122,0,2,2
20187,SpokaneStBridge,04/21/2016 03:00:00 AM,48,-122,0,1,1
20188,SpokaneStBridge,04/21/2016 04:00:00 AM,48,-122,3,1,4
20189,SpokaneStBridge,04/21/2016 05:00:00 AM,48,-122,27,3,30
20190,SpokaneStBridge,04/21/2016 06:00:00 AM,48,-122,75,12,87
20191,SpokaneStBridge,04/21/2016 07:00:00 AM,48,-122,140,23,163
20192,SpokaneStBridge,04/21/2016 08:00:00 AM,48,-122,157,19,176
20193,SpokaneStBridge,04/21/2016 09:00:00 AM,48,-122,55,3,58
20194,SpokaneStBridge,04/21/2016 10:00:00 AM,48,-122,30,7,37
20195,SpokaneStBridge,04/21/2016 11:00:00 AM,48,-122,15,11,26
20196,SpokaneStBridge,04/21/2016 12:00:00 PM,48,-122,17,26,43
20197,SpokaneStBridge,04/21/2016 01:00:00 PM,48,-122,21,22,43
20198,SpokaneStBridge,04/21/2016 02:00:00 PM,48,-122,17,27,44
20199,SpokaneStBridge,04/21/2016 03:00:00 PM,48,-122,17,35,52
20200,SpokaneStBridge,04/21/2016 04:00:00 PM,48,-122,35,94,129
20201,SpokaneStBridge,04/21/2016 05:00:00 PM,48,-122,23,180,203
20202,SpokaneStBridge,04/21/2016 06:00:00 PM,48,-122,24,106,130
20203,SpokaneStBridge,04/21/2016 07:00:00 PM,48,-122,26,45,71
20204,SpokaneStBridge,04/21/2016 08:00:00 PM,48,-122,14,17,31
20205,SpokaneStBridge,04/21/2016 09:00:00 PM,48,-122,4,19,23
20206,SpokaneStBridge,04/21/2016 10:00:00 PM,48,-122,3,5,8
20207,SpokaneStBridge,04/21/2016 11:00:00 PM,48,-122,1,3,4
20208,SpokaneStBridge,04/22/2016 12:00:00 AM,48,-122,0,4,4
20209,SpokaneStBridge,04/22/2016 01:00:00 AM,48,-122,1,0,1
20210,SpokaneStBridge,04/22/2016 02:00:00 AM,48,-122,2,1,3
20211,SpokaneStBridge,04/22/2016 03:00:00 AM,48,-122,0,1,1
20212,SpokaneStBridge,04/22/2016 04:00:00 AM,48,-122,5,3,8
20213,SpokaneStBridge,04/22/2016 05:00:00 AM,48,-122,16,4,20
20214,SpokaneStBridge,04/22/2016 06:00:00 AM,48,-122,36,10,46
20215,SpokaneStBridge,04/22/2016 07:00:00 AM,48,-122,100,13,113
20216,SpokaneStBridge,04/22/2016 08:00:00 AM,48,-122,85,20,105
20217,SpokaneStBridge,04/22/2016 09:00:00 AM,48,-122,40,5,45
20218,SpokaneStBridge,04/22/2016 10:00:00 AM,48,-122,18,1,19
20219,SpokaneStBridge,04/22/2016 11:00:00 AM,48,-122,8,11,19
20220,SpokaneStBridge,04/22/2016 12:00:00 PM,48,-122,10,8,18
20221,SpokaneStBridge,04/22/2016 01:00:00 PM,48,-122,10,14,24
20222,SpokaneStBridge,04/22/2016 02:00:00 PM,48,-122,7,9,16
20223,SpokaneStBridge,04/22/2016 03:00:00 PM,48,-122,8,23,31
20224,SpokaneStBridge,04/22/2016 04:00:00 PM,48,-122,13,54,67
20225,SpokaneStBridge,04/22/2016 05:00:00 PM,48,-122,11,101,112
20226,SpokaneStBridge,04/22/2016 06:00:00 PM,48,-122,10,50,60
20227,SpokaneStBridge,04/22/2016 07:00:00 PM,48,-122,10,14,24
20228,SpokaneStBridge,04/22/2016 08:00:00 PM,48,-122,0,8,8
20229,SpokaneStBridge,04/22/2016 09:00:00 PM,48,-122,1,3,4
20230,SpokaneStBridge,04/22/2016 10:00:00 PM,48,-122,2,2,4
20231,SpokaneStBridge,04/22/2016 11:00:00 PM,48,-122,3,1,4
20232,SpokaneStBridge,04/23/2016 12:00:00 AM,48,-122,2,5,7
20233,SpokaneStBridge,04/23/2016 01:00:00 AM,48,-122,0,5,5
20234,SpokaneStBridge,04/23/2016 02:00:00 AM,48,-122,1,0,1
20235,SpokaneStBridge,04/23/2016 03:00:00 AM,48,-122,2,0,2
20236,SpokaneStBridge,04/23/2016 04:00:00 AM,48,-122,1,0,1
20237,SpokaneStBridge,04/23/2016 05:00:00 AM,48,-122,6,1,7
20238,SpokaneStBridge,04/23/2016 06:00:00 AM,48,-122,8,1,9
20239,SpokaneStBridge,04/23/2016 07:00:00 AM,48,-122,16,5,21
20240,SpokaneStBridge,04/23/2016 08:00:00 AM,48,-122,21,13,34
20241,SpokaneStBridge,04/23/2016 09:00:00 AM,48,-122,12,29,41
20242,SpokaneStBridge,04/23/2016 10:00:00 AM,48,-122,24,22,46
20243,SpokaneStBridge,04/23/2016 11:00:00 AM,48,-122,38,80,118
20244,SpokaneStBridge,04/23/2016 12:00:00 PM,48,-122,22,26,48
20245,SpokaneStBridge,04/23/2016 01:00:00 PM,48,-122,26,37,63
20246,SpokaneStBridge,04/23/2016 02:00:00 PM,48,-122,20,13,33
20247,SpokaneStBridge,04/23/2016 03:00:00 PM,48,-122,43,32,75
20248,SpokaneStBridge,04/23/2016 04:00:00 PM,48,-122,22,22,44
20249,SpokaneStBridge,04/23/2016 05:00:00 PM,48,-122,9,25,34
20250,SpokaneStBridge,04/23/2016 06:00:00 PM,48,-122,6,8,14
20251,SpokaneStBridge,04/23/2016 07:00:00 PM,48,-122,6,1,7
20252,SpokaneStBridge,04/23/2016 08:00:00 PM,48,-122,2,6,8
20253,SpokaneStBridge,04/23/2016 09:00:00 PM,48,-122,5,5,10
20254,SpokaneStBridge,04/23/2016 10:00:00 PM,48,-122,3,1,4
20255,SpokaneStBridge,04/23/2016 11:00:00 PM,48,-122,0,2,2
20256,SpokaneStBridge,04/24/2016 12:00:00 AM,48,-122,0,0,0
20257,SpokaneStBridge,04/24/2016 01:00:00 AM,48,-122,0,1,1
20258,SpokaneStBridge,04/24/2016 02:00:00 AM,48,-122,1,2,3
20259,SpokaneStBridge,04/24/2016 03:00:00 AM,48,-122,1,2,3
20260,SpokaneStBridge,04/24/2016 04:00:00 AM,48,-122,0,0,0
20261,SpokaneStBridge,04/24/2016 05:00:00 AM,48,-122,3,2,5
20262,SpokaneStBridge,04/24/2016 06:00:00 AM,48,-122,4,0,4
20263,SpokaneStBridge,04/24/2016 07:00:00 AM,48,-122,6,1,7
20264,SpokaneStBridge,04/24/2016 08:00:00 AM,48,-122,7,6,13
20265,SpokaneStBridge,04/24/2016 09:00:00 AM,48,-122,2,1,3
20266,SpokaneStBridge,04/24/2016 10:00:00 AM,48,-122,1,4,5
20267,SpokaneStBridge,04/24/2016 11:00:00 AM,48,-122,6,2,8
20268,SpokaneStBridge,04/24/2016 12:00:00 PM,48,-122,2,2,4
20269,SpokaneStBridge,04/24/2016 01:00:00 PM,48,-122,4,3,7
20270,SpokaneStBridge,04/24/2016 02:00:00 PM,48,-122,7,4,11
20271,SpokaneStBridge,04/24/2016 03:00:00 PM,48,-122,3,7,10
20272,SpokaneStBridge,04/24/2016 04:00:00 PM,48,-122,5,7,12
20273,SpokaneStBridge,04/24/2016 05:00:00 PM,48,-122,3,5,8
20274,SpokaneStBridge,04/24/2016 06:00:00 PM,48,-122,2,5,7
20275,SpokaneStBridge,04/24/2016 07:00:00 PM,48,-122,6,5,11
20276,SpokaneStBridge,04/24/2016 08:00:00 PM,48,-122,1,2,3
20277,SpokaneStBridge,04/24/2016 09:00:00 PM,48,-122,1,3,4
20278,SpokaneStBridge,04/24/2016 10:00:00 PM,48,-122,2,1,3
20279,SpokaneStBridge,04/24/2016 11:00:00 PM,48,-122,1,2,3
20280,SpokaneStBridge,04/25/2016 12:00:00 AM,48,-122,0,1,1
20281,SpokaneStBridge,04/25/2016 01:00:00 AM,48,-122,0,0,0
20282,SpokaneStBridge,04/25/2016 02:00:00 AM,48,-122,1,1,2
20283,SpokaneStBridge,04/25/2016 03:00:00 AM,48,-122,0,1,1
20284,SpokaneStBridge,04/25/2016 04:00:00 AM,48,-122,5,0,5
20285,SpokaneStBridge,04/25/2016 05:00:00 AM,48,-122,14,2,16
20286,SpokaneStBridge,04/25/2016 06:00:00 AM,48,-122,46,6,52
20287,SpokaneStBridge,04/25/2016 07:00:00 AM,48,-122,98,11,109
20288,SpokaneStBridge,04/25/2016 08:00:00 AM,48,-122,84,11,95
20289,SpokaneStBridge,04/25/2016 09:00:00 AM,48,-122,34,6,40
20290,SpokaneStBridge,04/25/2016 10:00:00 AM,48,-122,20,3,23
20291,SpokaneStBridge,04/25/2016 11:00:00 AM,48,-122,10,3,13
20292,SpokaneStBridge,04/25/2016 12:00:00 PM,48,-122,11,14,25
20293,SpokaneStBridge,04/25/2016 01:00:00 PM,48,-122,10,12,22
20294,SpokaneStBridge,04/25/2016 02:00:00 PM,48,-122,11,17,28
20295,SpokaneStBridge,04/25/2016 03:00:00 PM,48,-122,15,30,45
20296,SpokaneStBridge,04/25/2016 04:00:00 PM,48,-122,16,61,77
20297,SpokaneStBridge,04/25/2016 05:00:00 PM,48,-122,19,122,141
20298,SpokaneStBridge,04/25/2016 06:00:00 PM,48,-122,15,74,89
20299,SpokaneStBridge,04/25/2016 07:00:00 PM,48,-122,4,32,36
20300,SpokaneStBridge,04/25/2016 08:00:00 PM,48,-122,9,12,21
20301,SpokaneStBridge,04/25/2016 09:00:00 PM,48,-122,0,9,9
20302,SpokaneStBridge,04/25/2016 10:00:00 PM,48,-122,2,6,8
20303,SpokaneStBridge,04/25/2016 11:00:00 PM,48,-122,4,2,6
20304,SpokaneStBridge,04/26/2016 12:00:00 AM,48,-122,0,0,0
20305,SpokaneStBridge,04/26/2016 01:00:00 AM,48,-122,0,0,0
20306,SpokaneStBridge,04/26/2016 02:00:00 AM,48,-122,1,0,1
20307,SpokaneStBridge,04/26/2016 03:00:00 AM,48,-122,0,2,2
20308,SpokaneStBridge,04/26/2016 04:00:00 AM,48,-122,6,0,6
20309,SpokaneStBridge,04/26/2016 05:00:00 AM,48,-122,22,2,24
20310,SpokaneStBridge,04/26/2016 06:00:00 AM,48,-122,78,7,85
20311,SpokaneStBridge,04/26/2016 07:00:00 AM,48,-122,165,15,180
20312,SpokaneStBridge,04/26/2016 08:00:00 AM,48,-122,131,21,152
20313,SpokaneStBridge,04/26/2016 09:00:00 AM,48,-122,58,5,63
20314,SpokaneStBridge,04/26/2016 10:00:00 AM,48,-122,12,6,18
20315,SpokaneStBridge,04/26/2016 11:00:00 AM,48,-122,13,11,24
20316,SpokaneStBridge,04/26/2016 12:00:00 PM,48,-122,13,9,22
20317,SpokaneStBridge,04/26/2016 01:00:00 PM,48,-122,16,16,32
20318,SpokaneStBridge,04/26/2016 02:00:00 PM,48,-122,16,17,33
20319,SpokaneStBridge,04/26/2016 03:00:00 PM,48,-122,14,28,42
20320,SpokaneStBridge,04/26/2016 04:00:00 PM,48,-122,31,110,141
20321,SpokaneStBridge,04/26/2016 05:00:00 PM,48,-122,26,181,207
20322,SpokaneStBridge,04/26/2016 06:00:00 PM,48,-122,20,120,140
20323,SpokaneStBridge,04/26/2016 07:00:00 PM,48,-122,13,38,51
20324,SpokaneStBridge,04/26/2016 08:00:00 PM,48,-122,5,15,20
20325,SpokaneStBridge,04/26/2016 09:00:00 PM,48,-122,4,13,17
20326,SpokaneStBridge,04/26/2016 10:00:00 PM,48,-122,2,14,16
20327,SpokaneStBridge,04/26/2016 11:00:00 PM,48,-122,0,1,1
20328,SpokaneStBridge,04/27/2016 12:00:00 AM,48,-122,0,0,0
20329,SpokaneStBridge,04/27/2016 01:00:00 AM,48,-122,0,1,1
20330,SpokaneStBridge,04/27/2016 02:00:00 AM,48,-122,1,1,2
20331,SpokaneStBridge,04/27/2016 03:00:00 AM,48,-122,0,1,1
20332,SpokaneStBridge,04/27/2016 04:00:00 AM,48,-122,5,1,6
20333,SpokaneStBridge,04/27/2016 05:00:00 AM,48,-122,26,2,28
20334,SpokaneStBridge,04/27/2016 06:00:00 AM,48,-122,65,9,74
20335,SpokaneStBridge,04/27/2016 07:00:00 AM,48,-122,140,17,157
20336,SpokaneStBridge,04/27/2016 08:00:00 AM,48,-122,143,13,156
20337,SpokaneStBridge,04/27/2016 09:00:00 AM,48,-122,53,6,59
20338,SpokaneStBridge,04/27/2016 10:00:00 AM,48,-122,19,13,32
20339,SpokaneStBridge,04/27/2016 11:00:00 AM,48,-122,13,23,36
20340,SpokaneStBridge,04/27/2016 12:00:00 PM,48,-122,20,10,30
20341,SpokaneStBridge,04/27/2016 01:00:00 PM,48,-122,12,12,24
20342,SpokaneStBridge,04/27/2016 02:00:00 PM,48,-122,16,27,43
20343,SpokaneStBridge,04/27/2016 03:00:00 PM,48,-122,19,26,45
20344,SpokaneStBridge,04/27/2016 04:00:00 PM,48,-122,26,86,112
20345,SpokaneStBridge,04/27/2016 05:00:00 PM,48,-122,16,173,189
20346,SpokaneStBridge,04/27/2016 06:00:00 PM,48,-122,16,114,130
20347,SpokaneStBridge,04/27/2016 07:00:00 PM,48,-122,19,54,73
20348,SpokaneStBridge,04/27/2016 08:00:00 PM,48,-122,15,17,32
20349,SpokaneStBridge,04/27/2016 09:00:00 PM,48,-122,9,9,18
20350,SpokaneStBridge,04/27/2016 10:00:00 PM,48,-122,1,5,6
20351,SpokaneStBridge,04/27/2016 11:00:00 PM,48,-122,1,4,5
20352,SpokaneStBridge,04/28/2016 12:00:00 AM,48,-122,0,1,1
20353,SpokaneStBridge,04/28/2016 01:00:00 AM,48,-122,1,1,2
20354,SpokaneStBridge,04/28/2016 02:00:00 AM,48,-122,2,2,4
20355,SpokaneStBridge,04/28/2016 03:00:00 AM,48,-122,0,1,1
20356,SpokaneStBridge,04/28/2016 04:00:00 AM,48,-122,3,1,4
20357,SpokaneStBridge,04/28/2016 05:00:00 AM,48,-122,16,2,18
20358,SpokaneStBridge,04/28/2016 06:00:00 AM,48,-122,85,7,92
20359,SpokaneStBridge,04/28/2016 07:00:00 AM,48,-122,155,21,176
20360,SpokaneStBridge,04/28/2016 08:00:00 AM,48,-122,136,28,164
20361,SpokaneStBridge,04/28/2016 09:00:00 AM,48,-122,58,5,63
20362,SpokaneStBridge,04/28/2016 10:00:00 AM,48,-122,20,11,31
20363,SpokaneStBridge,04/28/2016 11:00:00 AM,48,-122,20,10,30
20364,SpokaneStBridge,04/28/2016 12:00:00 PM,48,-122,12,9,21
20365,SpokaneStBridge,04/28/2016 01:00:00 PM,48,-122,16,8,24
20366,SpokaneStBridge,04/28/2016 02:00:00 PM,48,-122,10,18,28
20367,SpokaneStBridge,04/28/2016 03:00:00 PM,48,-122,10,40,50
20368,SpokaneStBridge,04/28/2016 04:00:00 PM,48,-122,26,98,124
20369,SpokaneStBridge,04/28/2016 05:00:00 PM,48,-122,32,170,202
20370,SpokaneStBridge,04/28/2016 06:00:00 PM,48,-122,29,109,138
20371,SpokaneStBridge,04/28/2016 07:00:00 PM,48,-122,13,33,46
20372,SpokaneStBridge,04/28/2016 08:00:00 PM,48,-122,4,18,22
20373,SpokaneStBridge,04/28/2016 09:00:00 PM,48,-122,2,11,13
20374,SpokaneStBridge,04/28/2016 10:00:00 PM,48,-122,2,4,6
20375,SpokaneStBridge,04/28/2016 11:00:00 PM,48,-122,1,4,5
20376,SpokaneStBridge,04/29/2016 12:00:00 AM,48,-122,3,5,8
20377,SpokaneStBridge,04/29/2016 01:00:00 AM,48,-122,0,1,1
20378,SpokaneStBridge,04/29/2016 02:00:00 AM,48,-122,0,0,0
20379,SpokaneStBridge,04/29/2016 03:00:00 AM,48,-122,1,0,1
20380,SpokaneStBridge,04/29/2016 04:00:00 AM,48,-122,5,2,7
20381,SpokaneStBridge,04/29/2016 05:00:00 AM,48,-122,22,5,27
20382,SpokaneStBridge,04/29/2016 06:00:00 AM,48,-122,100,14,114
20383,SpokaneStBridge,04/29/2016 07:00:00 AM,48,-122,176,17,193
20384,SpokaneStBridge,04/29/2016 08:00:00 AM,48,-122,157,11,168
20385,SpokaneStBridge,04/29/2016 09:00:00 AM,48,-122,63,7,70
20386,SpokaneStBridge,04/29/2016 10:00:00 AM,48,-122,29,4,33
20387,SpokaneStBridge,04/29/2016 11:00:00 AM,48,-122,11,5,16
20388,SpokaneStBridge,04/29/2016 12:00:00 PM,48,-122,3,5,8
20389,SpokaneStBridge,04/29/2016 01:00:00 PM,48,-122,8,13,21
20390,SpokaneStBridge,04/29/2016 02:00:00 PM,48,-122,11,19,30
20391,SpokaneStBridge,04/29/2016 03:00:00 PM,48,-122,15,61,76
20392,SpokaneStBridge,04/29/2016 04:00:00 PM,48,-122,18,126,144
20393,SpokaneStBridge,04/29/2016 05:00:00 PM,48,-122,23,188,211
20394,SpokaneStBridge,04/29/2016 06:00:00 PM,48,-122,25,114,139
20395,SpokaneStBridge,04/29/2016 07:00:00 PM,48,-122,14,34,48
20396,SpokaneStBridge,04/29/2016 08:00:00 PM,48,-122,10,19,29
20397,SpokaneStBridge,04/29/2016 09:00:00 PM,48,-122,4,6,10
20398,SpokaneStBridge,04/29/2016 10:00:00 PM,48,-122,2,14,16
20399,SpokaneStBridge,04/29/2016 11:00:00 PM,48,-122,2,11,13
20400,SpokaneStBridge,04/30/2016 12:00:00 AM,48,-122,1,6,7
20401,SpokaneStBridge,04/30/2016 01:00:00 AM,48,-122,1,2,3
20402,SpokaneStBridge,04/30/2016 02:00:00 AM,48,-122,1,0,1
20403,SpokaneStBridge,04/30/2016 03:00:00 AM,48,-122,0,1,1
20404,SpokaneStBridge,04/30/2016 04:00:00 AM,48,-122,1,0,1
20405,SpokaneStBridge,04/30/2016 05:00:00 AM,48,-122,4,0,4
20406,SpokaneStBridge,04/30/2016 06:00:00 AM,48,-122,9,2,11
20407,SpokaneStBridge,04/30/2016 07:00:00 AM,48,-122,22,7,29
20408,SpokaneStBridge,04/30/2016 08:00:00 AM,48,-122,21,13,34
20409,SpokaneStBridge,04/30/2016 09:00:00 AM,48,-122,34,22,56
20410,SpokaneStBridge,04/30/2016 10:00:00 AM,48,-122,34,23,57
20411,SpokaneStBridge,04/30/2016 11:00:00 AM,48,-122,30,33,63
20412,SpokaneStBridge,04/30/2016 12:00:00 PM,48,-122,46,39,85
20413,SpokaneStBridge,04/30/2016 01:00:00 PM,48,-122,38,40,78
20414,SpokaneStBridge,04/30/2016 02:00:00 PM,48,-122,36,48,84
20415,SpokaneStBridge,04/30/2016 03:00:00 PM,48,-122,39,56,95
20416,SpokaneStBridge,04/30/2016 04:00:00 PM,48,-122,31,39,70
20417,SpokaneStBridge,04/30/2016 05:00:00 PM,48,-122,38,26,64
20418,SpokaneStBridge,04/30/2016 06:00:00 PM,48,-122,23,21,44
20419,SpokaneStBridge,04/30/2016 07:00:00 PM,48,-122,12,13,25
20420,SpokaneStBridge,04/30/2016 08:00:00 PM,48,-122,3,9,12
20421,SpokaneStBridge,04/30/2016 09:00:00 PM,48,-122,9,7,16
20422,SpokaneStBridge,04/30/2016 10:00:00 PM,48,-122,3,14,17
20423,SpokaneStBridge,04/30/2016 11:00:00 PM,48,-122,3,5,8
20424,SpokaneStBridge,05/01/2016 12:00:00 AM,48,-122,0,3,3
20425,SpokaneStBridge,05/01/2016 01:00:00 AM,48,-122,3,0,3
20426,SpokaneStBridge,05/01/2016 02:00:00 AM,48,-122,0,3,3
20427,SpokaneStBridge,05/01/2016 03:00:00 AM,48,-122,1,4,5
20428,SpokaneStBridge,05/01/2016 04:00:00 AM,48,-122,3,1,4
20429,SpokaneStBridge,05/01/2016 05:00:00 AM,48,-122,4,0,4
20430,SpokaneStBridge,05/01/2016 06:00:00 AM,48,-122,9,0,9
20431,SpokaneStBridge,05/01/2016 07:00:00 AM,48,-122,9,5,14
20432,SpokaneStBridge,05/01/2016 08:00:00 AM,48,-122,34,10,44
20433,SpokaneStBridge,05/01/2016 09:00:00 AM,48,-122,66,34,100
20434,SpokaneStBridge,05/01/2016 10:00:00 AM,48,-122,44,44,88
20435,SpokaneStBridge,05/01/2016 11:00:00 AM,48,-122,46,59,105
20436,SpokaneStBridge,05/01/2016 12:00:00 PM,48,-122,42,54,96
20437,SpokaneStBridge,05/01/2016 01:00:00 PM,48,-122,58,68,126
20438,SpokaneStBridge,05/01/2016 02:00:00 PM,48,-122,51,65,116
20439,SpokaneStBridge,05/01/2016 03:00:00 PM,48,-122,49,71,120
20440,SpokaneStBridge,05/01/2016 04:00:00 PM,48,-122,38,50,88
20441,SpokaneStBridge,05/01/2016 05:00:00 PM,48,-122,39,37,76
20442,SpokaneStBridge,05/01/2016 06:00:00 PM,48,-122,27,20,47
20443,SpokaneStBridge,05/01/2016 07:00:00 PM,48,-122,20,21,41
20444,SpokaneStBridge,05/01/2016 08:00:00 PM,48,-122,6,15,21
20445,SpokaneStBridge,05/01/2016 09:00:00 PM,48,-122,3,5,8
20446,SpokaneStBridge,05/01/2016 10:00:00 PM,48,-122,6,1,7
20447,SpokaneStBridge,05/01/2016 11:00:00 PM,48,-122,1,3,4
20448,SpokaneStBridge,05/02/2016 12:00:00 AM,48,-122,2,2,4
20449,SpokaneStBridge,05/02/2016 01:00:00 AM,48,-122,1,3,4
20450,SpokaneStBridge,05/02/2016 02:00:00 AM,48,-122,0,2,2
20451,SpokaneStBridge,05/02/2016 03:00:00 AM,48,-122,0,2,2
20452,SpokaneStBridge,05/02/2016 04:00:00 AM,48,-122,9,1,10
20453,SpokaneStBridge,05/02/2016 05:00:00 AM,48,-122,33,7,40
20454,SpokaneStBridge,05/02/2016 06:00:00 AM,48,-122,159,18,177
20455,SpokaneStBridge,05/02/2016 07:00:00 AM,48,-122,330,36,366
20456,SpokaneStBridge,05/02/2016 08:00:00 AM,48,-122,276,37,313
20457,SpokaneStBridge,05/02/2016 09:00:00 AM,48,-122,83,16,99
20458,SpokaneStBridge,05/02/2016 10:00:00 AM,48,-122,44,13,57
20459,SpokaneStBridge,05/02/2016 11:00:00 AM,48,-122,27,29,56
20460,SpokaneStBridge,05/02/2016 12:00:00 PM,48,-122,24,26,50
20461,SpokaneStBridge,05/02/2016 01:00:00 PM,48,-122,28,23,51
20462,SpokaneStBridge,05/02/2016 02:00:00 PM,48,-122,19,43,62
20463,SpokaneStBridge,05/02/2016 03:00:00 PM,48,-122,28,65,93
20464,SpokaneStBridge,05/02/2016 04:00:00 PM,48,-122,46,202,248
20465,SpokaneStBridge,05/02/2016 05:00:00 PM,48,-122,64,367,431
20466,SpokaneStBridge,05/02/2016 06:00:00 PM,48,-122,34,223,257
20467,SpokaneStBridge,05/02/2016 07:00:00 PM,48,-122,23,80,103
20468,SpokaneStBridge,05/02/2016 08:00:00 PM,48,-122,15,33,48
20469,SpokaneStBridge,05/02/2016 09:00:00 PM,48,-122,9,24,33
20470,SpokaneStBridge,05/02/2016 10:00:00 PM,48,-122,6,8,14
20471,SpokaneStBridge,05/02/2016 11:00:00 PM,48,-122,2,3,5
20472,SpokaneStBridge,05/03/2016 12:00:00 AM,48,-122,1,1,2
20473,SpokaneStBridge,05/03/2016 01:00:00 AM,48,-122,0,2,2
20474,SpokaneStBridge,05/03/2016 02:00:00 AM,48,-122,1,0,1
20475,SpokaneStBridge,05/03/2016 03:00:00 AM,48,-122,0,5,5
20476,SpokaneStBridge,05/03/2016 04:00:00 AM,48,-122,8,4,12
20477,SpokaneStBridge,05/03/2016 05:00:00 AM,48,-122,39,6,45
20478,SpokaneStBridge,05/03/2016 06:00:00 AM,48,-122,169,20,189
20479,SpokaneStBridge,05/03/2016 07:00:00 AM,48,-122,315,35,350
20480,SpokaneStBridge,05/03/2016 08:00:00 AM,48,-122,284,26,310
20481,SpokaneStBridge,05/03/2016 09:00:00 AM,48,-122,80,19,99
20482,SpokaneStBridge,05/03/2016 10:00:00 AM,48,-122,29,6,35
20483,SpokaneStBridge,05/03/2016 11:00:00 AM,48,-122,16,20,36
20484,SpokaneStBridge,05/03/2016 12:00:00 PM,48,-122,21,9,30
20485,SpokaneStBridge,05/03/2016 01:00:00 PM,48,-122,10,16,26
20486,SpokaneStBridge,05/03/2016 02:00:00 PM,48,-122,20,28,48
20487,SpokaneStBridge,05/03/2016 03:00:00 PM,48,-122,22,73,95
20488,SpokaneStBridge,05/03/2016 04:00:00 PM,48,-122,43,176,219
20489,SpokaneStBridge,05/03/2016 05:00:00 PM,48,-122,50,364,414
20490,SpokaneStBridge,05/03/2016 06:00:00 PM,48,-122,26,216,242
20491,SpokaneStBridge,05/03/2016 07:00:00 PM,48,-122,13,61,74
20492,SpokaneStBridge,05/03/2016 08:00:00 PM,48,-122,7,24,31
20493,SpokaneStBridge,05/03/2016 09:00:00 PM,48,-122,4,19,23
20494,SpokaneStBridge,05/03/2016 10:00:00 PM,48,-122,1,7,8
20495,SpokaneStBridge,05/03/2016 11:00:00 PM,48,-122,3,2,5
20496,SpokaneStBridge,05/04/2016 12:00:00 AM,48,-122,1,4,5
20497,SpokaneStBridge,05/04/2016 01:00:00 AM,48,-122,1,0,1
20498,SpokaneStBridge,05/04/2016 02:00:00 AM,48,-122,2,2,4
20499,SpokaneStBridge,05/04/2016 03:00:00 AM,48,-122,0,3,3
20500,SpokaneStBridge,05/04/2016 04:00:00 AM,48,-122,4,2,6
20501,SpokaneStBridge,05/04/2016 05:00:00 AM,48,-122,33,5,38
20502,SpokaneStBridge,05/04/2016 06:00:00 AM,48,-122,150,20,170
20503,SpokaneStBridge,05/04/2016 07:00:00 AM,48,-122,237,29,266
20504,SpokaneStBridge,05/04/2016 08:00:00 AM,48,-122,251,24,275
20505,SpokaneStBridge,05/04/2016 09:00:00 AM,48,-122,78,18,96
20506,SpokaneStBridge,05/04/2016 10:00:00 AM,48,-122,28,7,35
20507,SpokaneStBridge,05/04/2016 11:00:00 AM,48,-122,16,8,24
20508,SpokaneStBridge,05/04/2016 12:00:00 PM,48,-122,14,12,26
20509,SpokaneStBridge,05/04/2016 01:00:00 PM,48,-122,15,12,27
20510,SpokaneStBridge,05/04/2016 02:00:00 PM,48,-122,6,17,23
20511,SpokaneStBridge,05/04/2016 03:00:00 PM,48,-122,19,68,87
20512,SpokaneStBridge,05/04/2016 04:00:00 PM,48,-122,22,147,169
20513,SpokaneStBridge,05/04/2016 05:00:00 PM,48,-122,35,308,343
20514,SpokaneStBridge,05/04/2016 06:00:00 PM,48,-122,26,163,189
20515,SpokaneStBridge,05/04/2016 07:00:00 PM,48,-122,14,60,74
20516,SpokaneStBridge,05/04/2016 08:00:00 PM,48,-122,14,23,37
20517,SpokaneStBridge,05/04/2016 09:00:00 PM,48,-122,1,8,9
20518,SpokaneStBridge,05/04/2016 10:00:00 PM,48,-122,1,4,5
20519,SpokaneStBridge,05/04/2016 11:00:00 PM,48,-122,6,6,12
20520,SpokaneStBridge,05/05/2016 12:00:00 AM,48,-122,4,1,5
20521,SpokaneStBridge,05/05/2016 01:00:00 AM,48,-122,1,1,2
20522,SpokaneStBridge,05/05/2016 02:00:00 AM,48,-122,0,1,1
20523,SpokaneStBridge,05/05/2016 03:00:00 AM,48,-122,1,0,1
20524,SpokaneStBridge,05/05/2016 04:00:00 AM,48,-122,8,1,9
20525,SpokaneStBridge,05/05/2016 05:00:00 AM,48,-122,36,6,42
20526,SpokaneStBridge,05/05/2016 06:00:00 AM,48,-122,153,17,170
20527,SpokaneStBridge,05/05/2016 07:00:00 AM,48,-122,270,30,300
20528,SpokaneStBridge,05/05/2016 08:00:00 AM,48,-122,256,25,281
20529,SpokaneStBridge,05/05/2016 09:00:00 AM,48,-122,93,16,109
20530,SpokaneStBridge,05/05/2016 10:00:00 AM,48,-122,36,8,44
20531,SpokaneStBridge,05/05/2016 11:00:00 AM,48,-122,12,15,27
20532,SpokaneStBridge,05/05/2016 12:00:00 PM,48,-122,22,21,43
20533,SpokaneStBridge,05/05/2016 01:00:00 PM,48,-122,14,22,36
20534,SpokaneStBridge,05/05/2016 02:00:00 PM,48,-122,23,24,47
20535,SpokaneStBridge,05/05/2016 03:00:00 PM,48,-122,20,61,81
20536,SpokaneStBridge,05/05/2016 04:00:00 PM,48,-122,28,147,175
20537,SpokaneStBridge,05/05/2016 05:00:00 PM,48,-122,43,298,341
20538,SpokaneStBridge,05/05/2016 06:00:00 PM,48,-122,32,167,199
20539,SpokaneStBridge,05/05/2016 07:00:00 PM,48,-122,14,71,85
20540,SpokaneStBridge,05/05/2016 08:00:00 PM,48,-122,15,97,112
20541,SpokaneStBridge,05/05/2016 09:00:00 PM,48,-122,71,23,94
20542,SpokaneStBridge,05/05/2016 10:00:00 PM,48,-122,3,13,16
20543,SpokaneStBridge,05/05/2016 11:00:00 PM,48,-122,3,9,12
20544,SpokaneStBridge,05/06/2016 12:00:00 AM,48,-122,3,7,10
20545,SpokaneStBridge,05/06/2016 01:00:00 AM,48,-122,1,5,6
20546,SpokaneStBridge,05/06/2016 02:00:00 AM,48,-122,1,2,3
20547,SpokaneStBridge,05/06/2016 03:00:00 AM,48,-122,1,1,2
20548,SpokaneStBridge,05/06/2016 04:00:00 AM,48,-122,5,1,6
20549,SpokaneStBridge,05/06/2016 05:00:00 AM,48,-122,32,7,39
20550,SpokaneStBridge,05/06/2016 06:00:00 AM,48,-122,112,16,128
20551,SpokaneStBridge,05/06/2016 07:00:00 AM,48,-122,268,23,291
20552,SpokaneStBridge,05/06/2016 08:00:00 AM,48,-122,233,23,256
20553,SpokaneStBridge,05/06/2016 09:00:00 AM,48,-122,83,15,98
20554,SpokaneStBridge,05/06/2016 10:00:00 AM,48,-122,37,10,47
20555,SpokaneStBridge,05/06/2016 11:00:00 AM,48,-122,22,19,41
20556,SpokaneStBridge,05/06/2016 12:00:00 PM,48,-122,19,24,43
20557,SpokaneStBridge,05/06/2016 01:00:00 PM,48,-122,23,22,45
20558,SpokaneStBridge,05/06/2016 02:00:00 PM,48,-122,21,35,56
20559,SpokaneStBridge,05/06/2016 03:00:00 PM,48,-122,31,87,118
20560,SpokaneStBridge,05/06/2016 04:00:00 PM,48,-122,40,175,215
20561,SpokaneStBridge,05/06/2016 05:00:00 PM,48,-122,42,236,278
20562,SpokaneStBridge,05/06/2016 06:00:00 PM,48,-122,23,147,170
20563,SpokaneStBridge,05/06/2016 07:00:00 PM,48,-122,17,50,67
20564,SpokaneStBridge,05/06/2016 08:00:00 PM,48,-122,14,28,42
20565,SpokaneStBridge,05/06/2016 09:00:00 PM,48,-122,5,16,21
20566,SpokaneStBridge,05/06/2016 10:00:00 PM,48,-122,6,8,14
20567,SpokaneStBridge,05/06/2016 11:00:00 PM,48,-122,0,8,8
20568,SpokaneStBridge,05/07/2016 12:00:00 AM,48,-122,5,7,12
20569,SpokaneStBridge,05/07/2016 01:00:00 AM,48,-122,5,4,9
20570,SpokaneStBridge,05/07/2016 02:00:00 AM,48,-122,1,2,3
20571,SpokaneStBridge,05/07/2016 03:00:00 AM,48,-122,0,4,4
20572,SpokaneStBridge,05/07/2016 04:00:00 AM,48,-122,2,3,5
20573,SpokaneStBridge,05/07/2016 05:00:00 AM,48,-122,4,0,4
20574,SpokaneStBridge,05/07/2016 06:00:00 AM,48,-122,7,4,11
20575,SpokaneStBridge,05/07/2016 07:00:00 AM,48,-122,24,8,32
20576,SpokaneStBridge,05/07/2016 08:00:00 AM,48,-122,37,26,63
20577,SpokaneStBridge,05/07/2016 09:00:00 AM,48,-122,40,36,76
20578,SpokaneStBridge,05/07/2016 10:00:00 AM,48,-122,42,35,77
20579,SpokaneStBridge,05/07/2016 11:00:00 AM,48,-122,38,60,98
20580,SpokaneStBridge,05/07/2016 12:00:00 PM,48,-122,53,62,115
20581,SpokaneStBridge,05/07/2016 01:00:00 PM,48,-122,49,78,127
20582,SpokaneStBridge,05/07/2016 02:00:00 PM,48,-122,61,65,126
20583,SpokaneStBridge,05/07/2016 03:00:00 PM,48,-122,63,47,110
20584,SpokaneStBridge,05/07/2016 04:00:00 PM,48,-122,49,64,113
20585,SpokaneStBridge,05/07/2016 05:00:00 PM,48,-122,49,34,83
20586,SpokaneStBridge,05/07/2016 06:00:00 PM,48,-122,32,23,55
20587,SpokaneStBridge,05/07/2016 07:00:00 PM,48,-122,12,17,29
20588,SpokaneStBridge,05/07/2016 08:00:00 PM,48,-122,7,14,21
20589,SpokaneStBridge,05/07/2016 09:00:00 PM,48,-122,6,17,23
20590,SpokaneStBridge,05/07/2016 10:00:00 PM,48,-122,5,9,14
20591,SpokaneStBridge,05/07/2016 11:00:00 PM,48,-122,3,7,10
20592,SpokaneStBridge,05/08/2016 12:00:00 AM,48,-122,2,2,4
20593,SpokaneStBridge,05/08/2016 01:00:00 AM,48,-122,1,4,5
20594,SpokaneStBridge,05/08/2016 02:00:00 AM,48,-122,0,2,2
20595,SpokaneStBridge,05/08/2016 03:00:00 AM,48,-122,1,1,2
20596,SpokaneStBridge,05/08/2016 04:00:00 AM,48,-122,0,0,0
20597,SpokaneStBridge,05/08/2016 05:00:00 AM,48,-122,3,1,4
20598,SpokaneStBridge,05/08/2016 06:00:00 AM,48,-122,4,1,5
20599,SpokaneStBridge,05/08/2016 07:00:00 AM,48,-122,6,2,8
20600,SpokaneStBridge,05/08/2016 08:00:00 AM,48,-122,4,0,4
20601,SpokaneStBridge,05/08/2016 09:00:00 AM,48,-122,5,12,17
20602,SpokaneStBridge,05/08/2016 10:00:00 AM,48,-122,12,6,18
20603,SpokaneStBridge,05/08/2016 11:00:00 AM,48,-122,11,12,23
20604,SpokaneStBridge,05/08/2016 12:00:00 PM,48,-122,8,14,22
20605,SpokaneStBridge,05/08/2016 01:00:00 PM,48,-122,20,22,42
20606,SpokaneStBridge,05/08/2016 02:00:00 PM,48,-122,15,15,30
20607,SpokaneStBridge,05/08/2016 03:00:00 PM,48,-122,14,10,24
20608,SpokaneStBridge,05/08/2016 04:00:00 PM,48,-122,19,19,38
20609,SpokaneStBridge,05/08/2016 05:00:00 PM,48,-122,18,14,32
20610,SpokaneStBridge,05/08/2016 06:00:00 PM,48,-122,5,9,14
20611,SpokaneStBridge,05/08/2016 07:00:00 PM,48,-122,8,7,15
20612,SpokaneStBridge,05/08/2016 08:00:00 PM,48,-122,1,8,9
20613,SpokaneStBridge,05/08/2016 09:00:00 PM,48,-122,4,5,9
20614,SpokaneStBridge,05/08/2016 10:00:00 PM,48,-122,0,5,5
20615,SpokaneStBridge,05/08/2016 11:00:00 PM,48,-122,1,1,2
20616,SpokaneStBridge,05/09/2016 12:00:00 AM,48,-122,0,0,0
20617,SpokaneStBridge,05/09/2016 01:00:00 AM,48,-122,0,0,0
20618,SpokaneStBridge,05/09/2016 02:00:00 AM,48,-122,0,0,0
20619,SpokaneStBridge,05/09/2016 03:00:00 AM,48,-122,0,3,3
20620,SpokaneStBridge,05/09/2016 04:00:00 AM,48,-122,2,2,4
20621,SpokaneStBridge,05/09/2016 05:00:00 AM,48,-122,28,6,34
20622,SpokaneStBridge,05/09/2016 06:00:00 AM,48,-122,109,17,126
20623,SpokaneStBridge,05/09/2016 07:00:00 AM,48,-122,224,20,244
20624,SpokaneStBridge,05/09/2016 08:00:00 AM,48,-122,200,24,224
20625,SpokaneStBridge,05/09/2016 09:00:00 AM,48,-122,79,12,91
20626,SpokaneStBridge,05/09/2016 10:00:00 AM,48,-122,26,5,31
20627,SpokaneStBridge,05/09/2016 11:00:00 AM,48,-122,16,10,26
20628,SpokaneStBridge,05/09/2016 12:00:00 PM,48,-122,20,15,35
20629,SpokaneStBridge,05/09/2016 01:00:00 PM,48,-122,14,11,25
20630,SpokaneStBridge,05/09/2016 02:00:00 PM,48,-122,15,28,43
20631,SpokaneStBridge,05/09/2016 03:00:00 PM,48,-122,19,56,75
20632,SpokaneStBridge,05/09/2016 04:00:00 PM,48,-122,34,136,170
20633,SpokaneStBridge,05/09/2016 05:00:00 PM,48,-122,26,266,292
20634,SpokaneStBridge,05/09/2016 06:00:00 PM,48,-122,23,164,187
20635,SpokaneStBridge,05/09/2016 07:00:00 PM,48,-122,16,46,62
20636,SpokaneStBridge,05/09/2016 08:00:00 PM,48,-122,20,22,42
20637,SpokaneStBridge,05/09/2016 09:00:00 PM,48,-122,4,10,14
20638,SpokaneStBridge,05/09/2016 10:00:00 PM,48,-122,4,7,11
20639,SpokaneStBridge,05/09/2016 11:00:00 PM,48,-122,2,7,9
20640,SpokaneStBridge,05/10/2016 12:00:00 AM,48,-122,3,5,8
20641,SpokaneStBridge,05/10/2016 01:00:00 AM,48,-122,0,1,1
20642,SpokaneStBridge,05/10/2016 02:00:00 AM,48,-122,1,2,3
20643,SpokaneStBridge,05/10/2016 03:00:00 AM,48,-122,0,1,1
20644,SpokaneStBridge,05/10/2016 04:00:00 AM,48,-122,7,2,9
20645,SpokaneStBridge,05/10/2016 05:00:00 AM,48,-122,31,4,35
20646,SpokaneStBridge,05/10/2016 06:00:00 AM,48,-122,119,20,139
20647,SpokaneStBridge,05/10/2016 07:00:00 AM,48,-122,228,23,251
20648,SpokaneStBridge,05/10/2016 08:00:00 AM,48,-122,210,34,244
20649,SpokaneStBridge,05/10/2016 09:00:00 AM,48,-122,70,8,78
20650,SpokaneStBridge,05/10/2016 10:00:00 AM,48,-122,28,11,39
20651,SpokaneStBridge,05/10/2016 11:00:00 AM,48,-122,13,10,23
20652,SpokaneStBridge,05/10/2016 12:00:00 PM,48,-122,13,18,31
20653,SpokaneStBridge,05/10/2016 01:00:00 PM,48,-122,21,16,37
20654,SpokaneStBridge,05/10/2016 02:00:00 PM,48,-122,20,28,48
20655,SpokaneStBridge,05/10/2016 03:00:00 PM,48,-122,27,54,81
20656,SpokaneStBridge,05/10/2016 04:00:00 PM,48,-122,27,137,164
20657,SpokaneStBridge,05/10/2016 05:00:00 PM,48,-122,49,244,293
20658,SpokaneStBridge,05/10/2016 06:00:00 PM,48,-122,28,166,194
20659,SpokaneStBridge,05/10/2016 07:00:00 PM,48,-122,14,61,75
20660,SpokaneStBridge,05/10/2016 08:00:00 PM,48,-122,14,18,32
20661,SpokaneStBridge,05/10/2016 09:00:00 PM,48,-122,8,18,26
20662,SpokaneStBridge,05/10/2016 10:00:00 PM,48,-122,3,8,11
20663,SpokaneStBridge,05/10/2016 11:00:00 PM,48,-122,3,4,7
20664,SpokaneStBridge,05/11/2016 12:00:00 AM,48,-122,2,3,5
20665,SpokaneStBridge,05/11/2016 01:00:00 AM,48,-122,1,1,2
20666,SpokaneStBridge,05/11/2016 02:00:00 AM,48,-122,0,2,2
20667,SpokaneStBridge,05/11/2016 03:00:00 AM,48,-122,2,2,4
20668,SpokaneStBridge,05/11/2016 04:00:00 AM,48,-122,5,2,7
20669,SpokaneStBridge,05/11/2016 05:00:00 AM,48,-122,34,7,41
20670,SpokaneStBridge,05/11/2016 06:00:00 AM,48,-122,99,18,117
20671,SpokaneStBridge,05/11/2016 07:00:00 AM,48,-122,215,19,234
20672,SpokaneStBridge,05/11/2016 08:00:00 AM,48,-122,185,21,206
20673,SpokaneStBridge,05/11/2016 09:00:00 AM,48,-122,65,14,79
20674,SpokaneStBridge,05/11/2016 10:00:00 AM,48,-122,38,12,50
20675,SpokaneStBridge,05/11/2016 11:00:00 AM,48,-122,18,16,34
20676,SpokaneStBridge,05/11/2016 12:00:00 PM,48,-122,30,13,43
20677,SpokaneStBridge,05/11/2016 01:00:00 PM,48,-122,17,25,42
20678,SpokaneStBridge,05/11/2016 02:00:00 PM,48,-122,21,35,56
20679,SpokaneStBridge,05/11/2016 03:00:00 PM,48,-122,16,47,63
20680,SpokaneStBridge,05/11/2016 04:00:00 PM,48,-122,32,156,188
20681,SpokaneStBridge,05/11/2016 05:00:00 PM,48,-122,47,248,295
20682,SpokaneStBridge,05/11/2016 06:00:00 PM,48,-122,34,152,186
20683,SpokaneStBridge,05/11/2016 07:00:00 PM,48,-122,26,51,77
20684,SpokaneStBridge,05/11/2016 08:00:00 PM,48,-122,16,21,37
20685,SpokaneStBridge,05/11/2016 09:00:00 PM,48,-122,3,26,29
20686,SpokaneStBridge,05/11/2016 10:00:00 PM,48,-122,2,2,4
20687,SpokaneStBridge,05/11/2016 11:00:00 PM,48,-122,0,5,5
20688,SpokaneStBridge,05/12/2016 12:00:00 AM,48,-122,1,1,2
20689,SpokaneStBridge,05/12/2016 01:00:00 AM,48,-122,0,1,1
20690,SpokaneStBridge,05/12/2016 02:00:00 AM,48,-122,1,2,3
20691,SpokaneStBridge,05/12/2016 03:00:00 AM,48,-122,1,1,2
20692,SpokaneStBridge,05/12/2016 04:00:00 AM,48,-122,5,2,7
20693,SpokaneStBridge,05/12/2016 05:00:00 AM,48,-122,28,6,34
20694,SpokaneStBridge,05/12/2016 06:00:00 AM,48,-122,97,20,117
20695,SpokaneStBridge,05/12/2016 07:00:00 AM,48,-122,216,22,238
20696,SpokaneStBridge,05/12/2016 08:00:00 AM,48,-122,192,21,213
20697,SpokaneStBridge,05/12/2016 09:00:00 AM,48,-122,85,12,97
20698,SpokaneStBridge,05/12/2016 10:00:00 AM,48,-122,24,8,32
20699,SpokaneStBridge,05/12/2016 11:00:00 AM,48,-122,16,20,36
20700,SpokaneStBridge,05/12/2016 12:00:00 PM,48,-122,22,13,35
20701,SpokaneStBridge,05/12/2016 01:00:00 PM,48,-122,23,17,40
20702,SpokaneStBridge,05/12/2016 02:00:00 PM,48,-122,16,23,39
20703,SpokaneStBridge,05/12/2016 03:00:00 PM,48,-122,20,53,73
20704,SpokaneStBridge,05/12/2016 04:00:00 PM,48,-122,28,101,129
20705,SpokaneStBridge,05/12/2016 05:00:00 PM,48,-122,33,230,263
20706,SpokaneStBridge,05/12/2016 06:00:00 PM,48,-122,23,170,193
20707,SpokaneStBridge,05/12/2016 07:00:00 PM,48,-122,21,59,80
20708,SpokaneStBridge,05/12/2016 08:00:00 PM,48,-122,19,38,57
20709,SpokaneStBridge,05/12/2016 09:00:00 PM,48,-122,12,19,31
20710,SpokaneStBridge,05/12/2016 10:00:00 PM,48,-122,3,8,11
20711,SpokaneStBridge,05/12/2016 11:00:00 PM,48,-122,2,5,7
20712,SpokaneStBridge,05/13/2016 12:00:00 AM,48,-122,5,1,6
20713,SpokaneStBridge,05/13/2016 01:00:00 AM,48,-122,1,1,2
20714,SpokaneStBridge,05/13/2016 02:00:00 AM,48,-122,0,4,4
20715,SpokaneStBridge,05/13/2016 03:00:00 AM,48,-122,0,0,0
20716,SpokaneStBridge,05/13/2016 04:00:00 AM,48,-122,4,3,7
20717,SpokaneStBridge,05/13/2016 05:00:00 AM,48,-122,28,4,32
20718,SpokaneStBridge,05/13/2016 06:00:00 AM,48,-122,86,19,105
20719,SpokaneStBridge,05/13/2016 07:00:00 AM,48,-122,181,25,206
20720,SpokaneStBridge,05/13/2016 08:00:00 AM,48,-122,154,20,174
20721,SpokaneStBridge,05/13/2016 09:00:00 AM,48,-122,63,14,77
20722,SpokaneStBridge,05/13/2016 10:00:00 AM,48,-122,31,8,39
20723,SpokaneStBridge,05/13/2016 11:00:00 AM,48,-122,20,18,38
20724,SpokaneStBridge,05/13/2016 12:00:00 PM,48,-122,14,28,42
20725,SpokaneStBridge,05/13/2016 01:00:00 PM,48,-122,27,26,53
20726,SpokaneStBridge,05/13/2016 02:00:00 PM,48,-122,22,23,45
20727,SpokaneStBridge,05/13/2016 03:00:00 PM,48,-122,31,51,82
20728,SpokaneStBridge,05/13/2016 04:00:00 PM,48,-122,28,127,155
20729,SpokaneStBridge,05/13/2016 05:00:00 PM,48,-122,31,182,213
20730,SpokaneStBridge,05/13/2016 06:00:00 PM,48,-122,16,99,115
20731,SpokaneStBridge,05/13/2016 07:00:00 PM,48,-122,15,46,61
20732,SpokaneStBridge,05/13/2016 08:00:00 PM,48,-122,12,22,34
20733,SpokaneStBridge,05/13/2016 09:00:00 PM,48,-122,6,10,16
20734,SpokaneStBridge,05/13/2016 10:00:00 PM,48,-122,6,10,16
20735,SpokaneStBridge,05/13/2016 11:00:00 PM,48,-122,1,8,9
20736,SpokaneStBridge,05/14/2016 12:00:00 AM,48,-122,5,4,9
20737,SpokaneStBridge,05/14/2016 01:00:00 AM,48,-122,0,2,2
20738,SpokaneStBridge,05/14/2016 02:00:00 AM,48,-122,2,2,4
20739,SpokaneStBridge,05/14/2016 03:00:00 AM,48,-122,0,1,1
20740,SpokaneStBridge,05/14/2016 04:00:00 AM,48,-122,2,2,4
20741,SpokaneStBridge,05/14/2016 05:00:00 AM,48,-122,7,3,10
20742,SpokaneStBridge,05/14/2016 06:00:00 AM,48,-122,14,4,18
20743,SpokaneStBridge,05/14/2016 07:00:00 AM,48,-122,19,12,31
20744,SpokaneStBridge,05/14/2016 08:00:00 AM,48,-122,29,12,41
20745,SpokaneStBridge,05/14/2016 09:00:00 AM,48,-122,19,24,43
20746,SpokaneStBridge,05/14/2016 10:00:00 AM,48,-122,23,42,65
20747,SpokaneStBridge,05/14/2016 11:00:00 AM,48,-122,35,24,59
20748,SpokaneStBridge,05/14/2016 12:00:00 PM,48,-122,23,20,43
20749,SpokaneStBridge,05/14/2016 01:00:00 PM,48,-122,17,16,33
20750,SpokaneStBridge,05/14/2016 02:00:00 PM,48,-122,27,11,38
20751,SpokaneStBridge,05/14/2016 03:00:00 PM,48,-122,9,10,19
20752,SpokaneStBridge,05/14/2016 04:00:00 PM,48,-122,3,10,13
20753,SpokaneStBridge,05/14/2016 05:00:00 PM,48,-122,12,18,30
20754,SpokaneStBridge,05/14/2016 06:00:00 PM,48,-122,3,13,16
20755,SpokaneStBridge,05/14/2016 07:00:00 PM,48,-122,5,8,13
20756,SpokaneStBridge,05/14/2016 08:00:00 PM,48,-122,6,4,10
20757,SpokaneStBridge,05/14/2016 09:00:00 PM,48,-122,0,5,5
20758,SpokaneStBridge,05/14/2016 10:00:00 PM,48,-122,1,0,1
20759,SpokaneStBridge,05/14/2016 11:00:00 PM,48,-122,1,3,4
20760,SpokaneStBridge,05/15/2016 12:00:00 AM,48,-122,2,0,2
20761,SpokaneStBridge,05/15/2016 01:00:00 AM,48,-122,0,0,0
20762,SpokaneStBridge,05/15/2016 02:00:00 AM,48,-122,0,1,1
20763,SpokaneStBridge,05/15/2016 03:00:00 AM,48,-122,0,2,2
20764,SpokaneStBridge,05/15/2016 04:00:00 AM,48,-122,0,1,1
20765,SpokaneStBridge,05/15/2016 05:00:00 AM,48,-122,3,0,3
20766,SpokaneStBridge,05/15/2016 06:00:00 AM,48,-122,6,1,7
20767,SpokaneStBridge,05/15/2016 07:00:00 AM,48,-122,14,5,19
20768,SpokaneStBridge,05/15/2016 08:00:00 AM,48,-122,11,8,19
20769,SpokaneStBridge,05/15/2016 09:00:00 AM,48,-122,9,19,28
20770,SpokaneStBridge,05/15/2016 10:00:00 AM,48,-122,16,17,33
20771,SpokaneStBridge,05/15/2016 11:00:00 AM,48,-122,19,17,36
20772,SpokaneStBridge,05/15/2016 12:00:00 PM,48,-122,25,22,47
20773,SpokaneStBridge,05/15/2016 01:00:00 PM,48,-122,22,27,49
20774,SpokaneStBridge,05/15/2016 02:00:00 PM,48,-122,29,14,43
20775,SpokaneStBridge,05/15/2016 03:00:00 PM,48,-122,9,21,30
20776,SpokaneStBridge,05/15/2016 04:00:00 PM,48,-122,11,18,29
20777,SpokaneStBridge,05/15/2016 05:00:00 PM,48,-122,11,11,22
20778,SpokaneStBridge,05/15/2016 06:00:00 PM,48,-122,6,10,16
20779,SpokaneStBridge,05/15/2016 07:00:00 PM,48,-122,6,3,9
20780,SpokaneStBridge,05/15/2016 08:00:00 PM,48,-122,1,4,5
20781,SpokaneStBridge,05/15/2016 09:00:00 PM,48,-122,2,4,6
20782,SpokaneStBridge,05/15/2016 10:00:00 PM,48,-122,0,1,1
20783,SpokaneStBridge,05/15/2016 11:00:00 PM,48,-122,3,2,5
20784,SpokaneStBridge,05/16/2016 12:00:00 AM,48,-122,0,0,0
20785,SpokaneStBridge,05/16/2016 01:00:00 AM,48,-122,1,2,3
20786,SpokaneStBridge,05/16/2016 02:00:00 AM,48,-122,2,2,4
20787,SpokaneStBridge,05/16/2016 03:00:00 AM,48,-122,0,2,2
20788,SpokaneStBridge,05/16/2016 04:00:00 AM,48,-122,2,1,3
20789,SpokaneStBridge,05/16/2016 05:00:00 AM,48,-122,20,2,22
20790,SpokaneStBridge,05/16/2016 06:00:00 AM,48,-122,71,9,80
20791,SpokaneStBridge,05/16/2016 07:00:00 AM,48,-122,132,17,149
20792,SpokaneStBridge,05/16/2016 08:00:00 AM,48,-122,150,11,161
20793,SpokaneStBridge,05/16/2016 09:00:00 AM,48,-122,49,7,56
20794,SpokaneStBridge,05/16/2016 10:00:00 AM,48,-122,13,3,16
20795,SpokaneStBridge,05/16/2016 11:00:00 AM,48,-122,13,8,21
20796,SpokaneStBridge,05/16/2016 12:00:00 PM,48,-122,10,10,20
20797,SpokaneStBridge,05/16/2016 01:00:00 PM,48,-122,5,6,11
20798,SpokaneStBridge,05/16/2016 02:00:00 PM,48,-122,13,17,30
20799,SpokaneStBridge,05/16/2016 03:00:00 PM,48,-122,7,25,32
20800,SpokaneStBridge,05/16/2016 04:00:00 PM,48,-122,21,82,103
20801,SpokaneStBridge,05/16/2016 05:00:00 PM,48,-122,29,166,195
20802,SpokaneStBridge,05/16/2016 06:00:00 PM,48,-122,19,113,132
20803,SpokaneStBridge,05/16/2016 07:00:00 PM,48,-122,9,41,50
20804,SpokaneStBridge,05/16/2016 08:00:00 PM,48,-122,12,17,29
20805,SpokaneStBridge,05/16/2016 09:00:00 PM,48,-122,3,8,11
20806,SpokaneStBridge,05/16/2016 10:00:00 PM,48,-122,1,5,6
20807,SpokaneStBridge,05/16/2016 11:00:00 PM,48,-122,3,3,6
20808,SpokaneStBridge,05/17/2016 12:00:00 AM,48,-122,1,1,2
20809,SpokaneStBridge,05/17/2016 01:00:00 AM,48,-122,2,2,4
20810,SpokaneStBridge,05/17/2016 02:00:00 AM,48,-122,0,0,0
20811,SpokaneStBridge,05/17/2016 03:00:00 AM,48,-122,0,2,2
20812,SpokaneStBridge,05/17/2016 04:00:00 AM,48,-122,9,4,13
20813,SpokaneStBridge,05/17/2016 05:00:00 AM,48,-122,26,3,29
20814,SpokaneStBridge,05/17/2016 06:00:00 AM,48,-122,97,15,112
20815,SpokaneStBridge,05/17/2016 07:00:00 AM,48,-122,196,26,222
20816,SpokaneStBridge,05/17/2016 08:00:00 AM,48,-122,194,21,215
20817,SpokaneStBridge,05/17/2016 09:00:00 AM,48,-122,68,10,78
20818,SpokaneStBridge,05/17/2016 10:00:00 AM,48,-122,27,13,40
20819,SpokaneStBridge,05/17/2016 11:00:00 AM,48,-122,20,10,30
20820,SpokaneStBridge,05/17/2016 12:00:00 PM,48,-122,14,9,23
20821,SpokaneStBridge,05/17/2016 01:00:00 PM,48,-122,20,11,31
20822,SpokaneStBridge,05/17/2016 02:00:00 PM,48,-122,14,28,42
20823,SpokaneStBridge,05/17/2016 03:00:00 PM,48,-122,13,41,54
20824,SpokaneStBridge,05/17/2016 04:00:00 PM,48,-122,26,124,150
20825,SpokaneStBridge,05/17/2016 05:00:00 PM,48,-122,42,255,297
20826,SpokaneStBridge,05/17/2016 06:00:00 PM,48,-122,21,153,174
20827,SpokaneStBridge,05/17/2016 07:00:00 PM,48,-122,22,59,81
20828,SpokaneStBridge,05/17/2016 08:00:00 PM,48,-122,13,22,35
20829,SpokaneStBridge,05/17/2016 09:00:00 PM,48,-122,6,16,22
20830,SpokaneStBridge,05/17/2016 10:00:00 PM,48,-122,9,3,12
20831,SpokaneStBridge,05/17/2016 11:00:00 PM,48,-122,1,3,4
20832,SpokaneStBridge,05/18/2016 12:00:00 AM,48,-122,1,1,2
20833,SpokaneStBridge,05/18/2016 01:00:00 AM,48,-122,1,0,1
20834,SpokaneStBridge,05/18/2016 02:00:00 AM,48,-122,1,3,4
20835,SpokaneStBridge,05/18/2016 03:00:00 AM,48,-122,0,3,3
20836,SpokaneStBridge,05/18/2016 04:00:00 AM,48,-122,3,1,4
20837,SpokaneStBridge,05/18/2016 05:00:00 AM,48,-122,31,2,33
20838,SpokaneStBridge,05/18/2016 06:00:00 AM,48,-122,94,10,104
20839,SpokaneStBridge,05/18/2016 07:00:00 AM,48,-122,194,22,216
20840,SpokaneStBridge,05/18/2016 08:00:00 AM,48,-122,185,18,203
20841,SpokaneStBridge,05/18/2016 09:00:00 AM,48,-122,59,10,69
20842,SpokaneStBridge,05/18/2016 10:00:00 AM,48,-122,22,14,36
20843,SpokaneStBridge,05/18/2016 11:00:00 AM,48,-122,13,10,23
20844,SpokaneStBridge,05/18/2016 12:00:00 PM,48,-122,16,12,28
20845,SpokaneStBridge,05/18/2016 01:00:00 PM,48,-122,13,11,24
20846,SpokaneStBridge,05/18/2016 02:00:00 PM,48,-122,13,20,33
20847,SpokaneStBridge,05/18/2016 03:00:00 PM,48,-122,18,34,52
20848,SpokaneStBridge,05/18/2016 04:00:00 PM,48,-122,36,123,159
20849,SpokaneStBridge,05/18/2016 05:00:00 PM,48,-122,19,224,243
20850,SpokaneStBridge,05/18/2016 06:00:00 PM,48,-122,25,107,132
20851,SpokaneStBridge,05/18/2016 07:00:00 PM,48,-122,14,40,54
20852,SpokaneStBridge,05/18/2016 08:00:00 PM,48,-122,16,24,40
20853,SpokaneStBridge,05/18/2016 09:00:00 PM,48,-122,4,17,21
20854,SpokaneStBridge,05/18/2016 10:00:00 PM,48,-122,0,5,5
20855,SpokaneStBridge,05/18/2016 11:00:00 PM,48,-122,1,4,5
20856,SpokaneStBridge,05/19/2016 12:00:00 AM,48,-122,2,2,4
20857,SpokaneStBridge,05/19/2016 01:00:00 AM,48,-122,1,1,2
20858,SpokaneStBridge,05/19/2016 02:00:00 AM,48,-122,0,0,0
20859,SpokaneStBridge,05/19/2016 03:00:00 AM,48,-122,0,0,0
20860,SpokaneStBridge,05/19/2016 04:00:00 AM,48,-122,3,1,4
20861,SpokaneStBridge,05/19/2016 05:00:00 AM,48,-122,14,3,17
20862,SpokaneStBridge,05/19/2016 06:00:00 AM,48,-122,50,12,62
20863,SpokaneStBridge,05/19/2016 07:00:00 AM,48,-122,136,14,150
20864,SpokaneStBridge,05/19/2016 08:00:00 AM,48,-122,141,13,154
20865,SpokaneStBridge,05/19/2016 09:00:00 AM,48,-122,36,6,42
20866,SpokaneStBridge,05/19/2016 10:00:00 AM,48,-122,19,5,24
20867,SpokaneStBridge,05/19/2016 11:00:00 AM,48,-122,14,11,25
20868,SpokaneStBridge,05/19/2016 12:00:00 PM,48,-122,5,4,9
20869,SpokaneStBridge,05/19/2016 01:00:00 PM,48,-122,7,15,22
20870,SpokaneStBridge,05/19/2016 02:00:00 PM,48,-122,15,16,31
20871,SpokaneStBridge,05/19/2016 03:00:00 PM,48,-122,8,23,31
20872,SpokaneStBridge,05/19/2016 04:00:00 PM,48,-122,12,64,76
20873,SpokaneStBridge,05/19/2016 05:00:00 PM,48,-122,19,152,171
20874,SpokaneStBridge,05/19/2016 06:00:00 PM,48,-122,18,74,92
20875,SpokaneStBridge,05/19/2016 07:00:00 PM,48,-122,8,38,46
20876,SpokaneStBridge,05/19/2016 08:00:00 PM,48,-122,5,12,17
20877,SpokaneStBridge,05/19/2016 09:00:00 PM,48,-122,4,5,9
20878,SpokaneStBridge,05/19/2016 10:00:00 PM,48,-122,0,2,2
20879,SpokaneStBridge,05/19/2016 11:00:00 PM,48,-122,1,2,3
20880,SpokaneStBridge,05/20/2016 12:00:00 AM,48,-122,0,4,4
20881,SpokaneStBridge,05/20/2016 01:00:00 AM,48,-122,0,0,0
20882,SpokaneStBridge,05/20/2016 02:00:00 AM,48,-122,0,1,1
20883,SpokaneStBridge,05/20/2016 03:00:00 AM,48,-122,0,0,0
20884,SpokaneStBridge,05/20/2016 04:00:00 AM,48,-122,2,0,2
20885,SpokaneStBridge,05/20/2016 05:00:00 AM,48,-122,28,1,29
20886,SpokaneStBridge,05/20/2016 06:00:00 AM,48,-122,101,14,115
20887,SpokaneStBridge,05/20/2016 07:00:00 AM,48,-122,183,14,197
20888,SpokaneStBridge,05/20/2016 08:00:00 AM,48,-122,211,18,229
20889,SpokaneStBridge,05/20/2016 09:00:00 AM,48,-122,61,18,79
20890,SpokaneStBridge,05/20/2016 10:00:00 AM,48,-122,14,9,23
20891,SpokaneStBridge,05/20/2016 11:00:00 AM,48,-122,16,20,36
20892,SpokaneStBridge,05/20/2016 12:00:00 PM,48,-122,19,27,46
20893,SpokaneStBridge,05/20/2016 01:00:00 PM,48,-122,26,19,45
20894,SpokaneStBridge,05/20/2016 02:00:00 PM,48,-122,21,33,54
20895,SpokaneStBridge,05/20/2016 03:00:00 PM,48,-122,15,55,70
20896,SpokaneStBridge,05/20/2016 04:00:00 PM,48,-122,31,118,149
20897,SpokaneStBridge,05/20/2016 05:00:00 PM,48,-122,36,214,250
20898,SpokaneStBridge,05/20/2016 06:00:00 PM,48,-122,18,113,131
20899,SpokaneStBridge,05/20/2016 07:00:00 PM,48,-122,9,33,42
20900,SpokaneStBridge,05/20/2016 08:00:00 PM,48,-122,9,24,33
20901,SpokaneStBridge,05/20/2016 09:00:00 PM,48,-122,3,6,9
20902,SpokaneStBridge,05/20/2016 10:00:00 PM,48,-122,7,9,16
20903,SpokaneStBridge,05/20/2016 11:00:00 PM,48,-122,3,7,10
20904,SpokaneStBridge,05/21/2016 12:00:00 AM,48,-122,2,6,8
20905,SpokaneStBridge,05/21/2016 01:00:00 AM,48,-122,3,6,9
20906,SpokaneStBridge,05/21/2016 02:00:00 AM,48,-122,1,4,5
20907,SpokaneStBridge,05/21/2016 03:00:00 AM,48,-122,0,0,0
20908,SpokaneStBridge,05/21/2016 04:00:00 AM,48,-122,1,0,1
20909,SpokaneStBridge,05/21/2016 05:00:00 AM,48,-122,4,3,7
20910,SpokaneStBridge,05/21/2016 06:00:00 AM,48,-122,7,2,9
20911,SpokaneStBridge,05/21/2016 07:00:00 AM,48,-122,9,5,14
20912,SpokaneStBridge,05/21/2016 08:00:00 AM,48,-122,2,4,6
20913,SpokaneStBridge,05/21/2016 09:00:00 AM,48,-122,8,5,13
20914,SpokaneStBridge,05/21/2016 10:00:00 AM,48,-122,4,1,5
20915,SpokaneStBridge,05/21/2016 11:00:00 AM,48,-122,9,6,15
20916,SpokaneStBridge,05/21/2016 12:00:00 PM,48,-122,5,5,10
20917,SpokaneStBridge,05/21/2016 01:00:00 PM,48,-122,8,10,18
20918,SpokaneStBridge,05/21/2016 02:00:00 PM,48,-122,9,6,15
20919,SpokaneStBridge,05/21/2016 03:00:00 PM,48,-122,13,5,18
20920,SpokaneStBridge,05/21/2016 04:00:00 PM,48,-122,12,11,23
20921,SpokaneStBridge,05/21/2016 05:00:00 PM,48,-122,9,13,22
20922,SpokaneStBridge,05/21/2016 06:00:00 PM,48,-122,6,8,14
20923,SpokaneStBridge,05/21/2016 07:00:00 PM,48,-122,4,0,4
20924,SpokaneStBridge,05/21/2016 08:00:00 PM,48,-122,4,3,7
20925,SpokaneStBridge,05/21/2016 09:00:00 PM,48,-122,3,6,9
20926,SpokaneStBridge,05/21/2016 10:00:00 PM,48,-122,1,3,4
20927,SpokaneStBridge,05/21/2016 11:00:00 PM,48,-122,1,4,5
20928,SpokaneStBridge,05/22/2016 12:00:00 AM,48,-122,1,4,5
20929,SpokaneStBridge,05/22/2016 01:00:00 AM,48,-122,0,0,0
20930,SpokaneStBridge,05/22/2016 02:00:00 AM,48,-122,0,2,2
20931,SpokaneStBridge,05/22/2016 03:00:00 AM,48,-122,1,0,1
20932,SpokaneStBridge,05/22/2016 04:00:00 AM,48,-122,1,2,3
20933,SpokaneStBridge,05/22/2016 05:00:00 AM,48,-122,4,0,4
20934,SpokaneStBridge,05/22/2016 06:00:00 AM,48,-122,8,3,11
20935,SpokaneStBridge,05/22/2016 07:00:00 AM,48,-122,11,1,12
20936,SpokaneStBridge,05/22/2016 08:00:00 AM,48,-122,10,23,33
20937,SpokaneStBridge,05/22/2016 09:00:00 AM,48,-122,7,9,16
20938,SpokaneStBridge,05/22/2016 10:00:00 AM,48,-122,24,21,45
20939,SpokaneStBridge,05/22/2016 11:00:00 AM,48,-122,33,20,53
20940,SpokaneStBridge,05/22/2016 12:00:00 PM,48,-122,29,42,71
20941,SpokaneStBridge,05/22/2016 01:00:00 PM,48,-122,37,20,57
20942,SpokaneStBridge,05/22/2016 02:00:00 PM,48,-122,34,41,75
20943,SpokaneStBridge,05/22/2016 03:00:00 PM,48,-122,38,39,77
20944,SpokaneStBridge,05/22/2016 04:00:00 PM,48,-122,20,34,54
20945,SpokaneStBridge,05/22/2016 05:00:00 PM,48,-122,27,26,53
20946,SpokaneStBridge,05/22/2016 06:00:00 PM,48,-122,12,13,25
20947,SpokaneStBridge,05/22/2016 07:00:00 PM,48,-122,11,11,22
20948,SpokaneStBridge,05/22/2016 08:00:00 PM,48,-122,6,7,13
20949,SpokaneStBridge,05/22/2016 09:00:00 PM,48,-122,6,3,9
20950,SpokaneStBridge,05/22/2016 10:00:00 PM,48,-122,2,4,6
20951,SpokaneStBridge,05/22/2016 11:00:00 PM,48,-122,0,4,4
20952,SpokaneStBridge,05/23/2016 12:00:00 AM,48,-122,0,1,1
20953,SpokaneStBridge,05/23/2016 01:00:00 AM,48,-122,3,3,6
20954,SpokaneStBridge,05/23/2016 02:00:00 AM,48,-122,0,1,1
20955,SpokaneStBridge,05/23/2016 03:00:00 AM,48,-122,0,0,0
20956,SpokaneStBridge,05/23/2016 04:00:00 AM,48,-122,6,2,8
20957,SpokaneStBridge,05/23/2016 05:00:00 AM,48,-122,24,5,29
20958,SpokaneStBridge,05/23/2016 06:00:00 AM,48,-122,83,14,97
20959,SpokaneStBridge,05/23/2016 07:00:00 AM,48,-122,187,12,199
20960,SpokaneStBridge,05/23/2016 08:00:00 AM,48,-122,183,15,198
20961,SpokaneStBridge,05/23/2016 09:00:00 AM,48,-122,59,11,70
20962,SpokaneStBridge,05/23/2016 10:00:00 AM,48,-122,17,7,24
20963,SpokaneStBridge,05/23/2016 11:00:00 AM,48,-122,11,10,21
20964,SpokaneStBridge,05/23/2016 12:00:00 PM,48,-122,13,7,20
20965,SpokaneStBridge,05/23/2016 01:00:00 PM,48,-122,12,16,28
20966,SpokaneStBridge,05/23/2016 02:00:00 PM,48,-122,8,13,21
20967,SpokaneStBridge,05/23/2016 03:00:00 PM,48,-122,15,30,45
20968,SpokaneStBridge,05/23/2016 04:00:00 PM,48,-122,27,115,142
20969,SpokaneStBridge,05/23/2016 05:00:00 PM,48,-122,25,222,247
20970,SpokaneStBridge,05/23/2016 06:00:00 PM,48,-122,18,133,151
20971,SpokaneStBridge,05/23/2016 07:00:00 PM,48,-122,13,38,51
20972,SpokaneStBridge,05/23/2016 08:00:00 PM,48,-122,12,18,30
20973,SpokaneStBridge,05/23/2016 09:00:00 PM,48,-122,5,11,16
20974,SpokaneStBridge,05/23/2016 10:00:00 PM,48,-122,2,10,12
20975,SpokaneStBridge,05/23/2016 11:00:00 PM,48,-122,4,5,9
20976,SpokaneStBridge,05/24/2016 12:00:00 AM,48,-122,0,1,1
20977,SpokaneStBridge,05/24/2016 01:00:00 AM,48,-122,0,0,0
20978,SpokaneStBridge,05/24/2016 02:00:00 AM,48,-122,1,4,5
20979,SpokaneStBridge,05/24/2016 03:00:00 AM,48,-122,0,1,1
20980,SpokaneStBridge,05/24/2016 04:00:00 AM,48,-122,6,1,7
20981,SpokaneStBridge,05/24/2016 05:00:00 AM,48,-122,32,5,37
20982,SpokaneStBridge,05/24/2016 06:00:00 AM,48,-122,99,13,112
20983,SpokaneStBridge,05/24/2016 07:00:00 AM,48,-122,208,25,233
20984,SpokaneStBridge,05/24/2016 08:00:00 AM,48,-122,182,24,206
20985,SpokaneStBridge,05/24/2016 09:00:00 AM,48,-122,55,11,66
20986,SpokaneStBridge,05/24/2016 10:00:00 AM,48,-122,18,8,26
20987,SpokaneStBridge,05/24/2016 11:00:00 AM,48,-122,23,12,35
20988,SpokaneStBridge,05/24/2016 12:00:00 PM,48,-122,13,11,24
20989,SpokaneStBridge,05/24/2016 01:00:00 PM,48,-122,9,13,22
20990,SpokaneStBridge,05/24/2016 02:00:00 PM,48,-122,9,18,27
20991,SpokaneStBridge,05/24/2016 03:00:00 PM,48,-122,16,41,57
20992,SpokaneStBridge,05/24/2016 04:00:00 PM,48,-122,24,123,147
20993,SpokaneStBridge,05/24/2016 05:00:00 PM,48,-122,25,226,251
20994,SpokaneStBridge,05/24/2016 06:00:00 PM,48,-122,23,123,146
20995,SpokaneStBridge,05/24/2016 07:00:00 PM,48,-122,8,58,66
20996,SpokaneStBridge,05/24/2016 08:00:00 PM,48,-122,7,17,24
20997,SpokaneStBridge,05/24/2016 09:00:00 PM,48,-122,4,18,22
20998,SpokaneStBridge,05/24/2016 10:00:00 PM,48,-122,3,9,12
20999,SpokaneStBridge,05/24/2016 11:00:00 PM,48,-122,0,6,6
21000,SpokaneStBridge,05/25/2016 12:00:00 AM,48,-122,1,0,1
21001,SpokaneStBridge,05/25/2016 01:00:00 AM,48,-122,2,2,4
21002,SpokaneStBridge,05/25/2016 02:00:00 AM,48,-122,1,1,2
21003,SpokaneStBridge,05/25/2016 03:00:00 AM,48,-122,0,0,0
21004,SpokaneStBridge,05/25/2016 04:00:00 AM,48,-122,5,0,5
21005,SpokaneStBridge,05/25/2016 05:00:00 AM,48,-122,36,3,39
21006,SpokaneStBridge,05/25/2016 06:00:00 AM,48,-122,95,15,110
21007,SpokaneStBridge,05/25/2016 07:00:00 AM,48,-122,160,22,182
21008,SpokaneStBridge,05/25/2016 08:00:00 AM,48,-122,174,17,191
21009,SpokaneStBridge,05/25/2016 09:00:00 AM,48,-122,57,7,64
21010,SpokaneStBridge,05/25/2016 10:00:00 AM,48,-122,28,6,34
21011,SpokaneStBridge,05/25/2016 11:00:00 AM,48,-122,13,18,31
21012,SpokaneStBridge,05/25/2016 12:00:00 PM,48,-122,12,29,41
21013,SpokaneStBridge,05/25/2016 01:00:00 PM,48,-122,13,15,28
21014,SpokaneStBridge,05/25/2016 02:00:00 PM,48,-122,7,24,31
21015,SpokaneStBridge,05/25/2016 03:00:00 PM,48,-122,15,42,57
21016,SpokaneStBridge,05/25/2016 04:00:00 PM,48,-122,24,99,123
21017,SpokaneStBridge,05/25/2016 05:00:00 PM,48,-122,31,203,234
21018,SpokaneStBridge,05/25/2016 06:00:00 PM,48,-122,26,108,134
21019,SpokaneStBridge,05/25/2016 07:00:00 PM,48,-122,10,52,62
21020,SpokaneStBridge,05/25/2016 08:00:00 PM,48,-122,9,24,33
21021,SpokaneStBridge,05/25/2016 09:00:00 PM,48,-122,0,14,14
21022,SpokaneStBridge,05/25/2016 10:00:00 PM,48,-122,1,3,4
21023,SpokaneStBridge,05/25/2016 11:00:00 PM,48,-122,3,6,9
21024,SpokaneStBridge,05/26/2016 12:00:00 AM,48,-122,2,1,3
21025,SpokaneStBridge,05/26/2016 01:00:00 AM,48,-122,0,3,3
21026,SpokaneStBridge,05/26/2016 02:00:00 AM,48,-122,1,2,3
21027,SpokaneStBridge,05/26/2016 03:00:00 AM,48,-122,1,1,2
21028,SpokaneStBridge,05/26/2016 04:00:00 AM,48,-122,4,0,4
21029,SpokaneStBridge,05/26/2016 05:00:00 AM,48,-122,28,3,31
21030,SpokaneStBridge,05/26/2016 06:00:00 AM,48,-122,82,10,92
21031,SpokaneStBridge,05/26/2016 07:00:00 AM,48,-122,159,18,177
21032,SpokaneStBridge,05/26/2016 08:00:00 AM,48,-122,154,15,169
21033,SpokaneStBridge,05/26/2016 09:00:00 AM,48,-122,39,5,44
21034,SpokaneStBridge,05/26/2016 10:00:00 AM,48,-122,16,11,27
21035,SpokaneStBridge,05/26/2016 11:00:00 AM,48,-122,11,5,16
21036,SpokaneStBridge,05/26/2016 12:00:00 PM,48,-122,12,10,22
21037,SpokaneStBridge,05/26/2016 01:00:00 PM,48,-122,9,9,18
21038,SpokaneStBridge,05/26/2016 02:00:00 PM,48,-122,12,14,26
21039,SpokaneStBridge,05/26/2016 03:00:00 PM,48,-122,11,27,38
21040,SpokaneStBridge,05/26/2016 04:00:00 PM,48,-122,18,78,96
21041,SpokaneStBridge,05/26/2016 05:00:00 PM,48,-122,22,165,187
21042,SpokaneStBridge,05/26/2016 06:00:00 PM,48,-122,21,106,127
21043,SpokaneStBridge,05/26/2016 07:00:00 PM,48,-122,13,83,96
21044,SpokaneStBridge,05/26/2016 08:00:00 PM,48,-122,8,20,28
21045,SpokaneStBridge,05/26/2016 09:00:00 PM,48,-122,4,18,22
21046,SpokaneStBridge,05/26/2016 10:00:00 PM,48,-122,9,8,17
21047,SpokaneStBridge,05/26/2016 11:00:00 PM,48,-122,2,6,8
21048,SpokaneStBridge,05/27/2016 12:00:00 AM,48,-122,3,2,5
21049,SpokaneStBridge,05/27/2016 01:00:00 AM,48,-122,1,0,1
21050,SpokaneStBridge,05/27/2016 02:00:00 AM,48,-122,0,1,1
21051,SpokaneStBridge,05/27/2016 03:00:00 AM,48,-122,0,1,1
21052,SpokaneStBridge,05/27/2016 04:00:00 AM,48,-122,1,0,1
21053,SpokaneStBridge,05/27/2016 05:00:00 AM,48,-122,11,4,15
21054,SpokaneStBridge,05/27/2016 06:00:00 AM,48,-122,44,6,50
21055,SpokaneStBridge,05/27/2016 07:00:00 AM,48,-122,102,9,111
21056,SpokaneStBridge,05/27/2016 08:00:00 AM,48,-122,107,10,117
21057,SpokaneStBridge,05/27/2016 09:00:00 AM,48,-122,40,9,49
21058,SpokaneStBridge,05/27/2016 10:00:00 AM,48,-122,17,10,27
21059,SpokaneStBridge,05/27/2016 11:00:00 AM,48,-122,8,12,20
21060,SpokaneStBridge,05/27/2016 12:00:00 PM,48,-122,15,17,32
21061,SpokaneStBridge,05/27/2016 01:00:00 PM,48,-122,15,12,27
21062,SpokaneStBridge,05/27/2016 02:00:00 PM,48,-122,16,19,35
21063,SpokaneStBridge,05/27/2016 03:00:00 PM,48,-122,10,54,64
21064,SpokaneStBridge,05/27/2016 04:00:00 PM,48,-122,20,74,94
21065,SpokaneStBridge,05/27/2016 05:00:00 PM,48,-122,10,86,96
21066,SpokaneStBridge,05/27/2016 06:00:00 PM,48,-122,7,65,72
21067,SpokaneStBridge,05/27/2016 07:00:00 PM,48,-122,11,19,30
21068,SpokaneStBridge,05/27/2016 08:00:00 PM,48,-122,1,11,12
21069,SpokaneStBridge,05/27/2016 09:00:00 PM,48,-122,12,9,21
21070,SpokaneStBridge,05/27/2016 10:00:00 PM,48,-122,2,7,9
21071,SpokaneStBridge,05/27/2016 11:00:00 PM,48,-122,1,3,4
21072,SpokaneStBridge,05/28/2016 12:00:00 AM,48,-122,1,11,12
21073,SpokaneStBridge,05/28/2016 01:00:00 AM,48,-122,2,0,2
21074,SpokaneStBridge,05/28/2016 02:00:00 AM,48,-122,1,0,1
21075,SpokaneStBridge,05/28/2016 03:00:00 AM,48,-122,0,1,1
21076,SpokaneStBridge,05/28/2016 04:00:00 AM,48,-122,0,2,2
21077,SpokaneStBridge,05/28/2016 05:00:00 AM,48,-122,4,0,4
21078,SpokaneStBridge,05/28/2016 06:00:00 AM,48,-122,6,1,7
21079,SpokaneStBridge,05/28/2016 07:00:00 AM,48,-122,13,4,17
21080,SpokaneStBridge,05/28/2016 08:00:00 AM,48,-122,17,5,22
21081,SpokaneStBridge,05/28/2016 09:00:00 AM,48,-122,12,32,44
21082,SpokaneStBridge,05/28/2016 10:00:00 AM,48,-122,13,23,36
21083,SpokaneStBridge,05/28/2016 11:00:00 AM,48,-122,44,23,67
21084,SpokaneStBridge,05/28/2016 12:00:00 PM,48,-122,24,13,37
21085,SpokaneStBridge,05/28/2016 01:00:00 PM,48,-122,14,14,28
21086,SpokaneStBridge,05/28/2016 02:00:00 PM,48,-122,13,14,27
21087,SpokaneStBridge,05/28/2016 03:00:00 PM,48,-122,18,21,39
21088,SpokaneStBridge,05/28/2016 04:00:00 PM,48,-122,11,10,21
21089,SpokaneStBridge,05/28/2016 05:00:00 PM,48,-122,14,14,28
21090,SpokaneStBridge,05/28/2016 06:00:00 PM,48,-122,10,7,17
21091,SpokaneStBridge,05/28/2016 07:00:00 PM,48,-122,4,4,8
21092,SpokaneStBridge,05/28/2016 08:00:00 PM,48,-122,2,5,7
21093,SpokaneStBridge,05/28/2016 09:00:00 PM,48,-122,4,5,9
21094,SpokaneStBridge,05/28/2016 10:00:00 PM,48,-122,3,8,11
21095,SpokaneStBridge,05/28/2016 11:00:00 PM,48,-122,2,4,6
21096,SpokaneStBridge,05/29/2016 12:00:00 AM,48,-122,0,5,5
21097,SpokaneStBridge,05/29/2016 01:00:00 AM,48,-122,1,0,1
21098,SpokaneStBridge,05/29/2016 02:00:00 AM,48,-122,0,1,1
21099,SpokaneStBridge,05/29/2016 03:00:00 AM,48,-122,0,5,5
21100,SpokaneStBridge,05/29/2016 04:00:00 AM,48,-122,2,2,4
21101,SpokaneStBridge,05/29/2016 05:00:00 AM,48,-122,3,2,5
21102,SpokaneStBridge,05/29/2016 06:00:00 AM,48,-122,2,0,2
21103,SpokaneStBridge,05/29/2016 07:00:00 AM,48,-122,6,1,7
21104,SpokaneStBridge,05/29/2016 08:00:00 AM,48,-122,12,5,17
21105,SpokaneStBridge,05/29/2016 09:00:00 AM,48,-122,6,3,9
21106,SpokaneStBridge,05/29/2016 10:00:00 AM,48,-122,2,4,6
21107,SpokaneStBridge,05/29/2016 11:00:00 AM,48,-122,8,11,19
21108,SpokaneStBridge,05/29/2016 12:00:00 PM,48,-122,16,9,25
21109,SpokaneStBridge,05/29/2016 01:00:00 PM,48,-122,9,10,19
21110,SpokaneStBridge,05/29/2016 02:00:00 PM,48,-122,7,13,20
21111,SpokaneStBridge,05/29/2016 03:00:00 PM,48,-122,15,11,26
21112,SpokaneStBridge,05/29/2016 04:00:00 PM,48,-122,17,18,35
21113,SpokaneStBridge,05/29/2016 05:00:00 PM,48,-122,8,22,30
21114,SpokaneStBridge,05/29/2016 06:00:00 PM,48,-122,7,6,13
21115,SpokaneStBridge,05/29/2016 07:00:00 PM,48,-122,8,10,18
21116,SpokaneStBridge,05/29/2016 08:00:00 PM,48,-122,2,3,5
21117,SpokaneStBridge,05/29/2016 09:00:00 PM,48,-122,2,10,12
21118,SpokaneStBridge,05/29/2016 10:00:00 PM,48,-122,0,2,2
21119,SpokaneStBridge,05/29/2016 11:00:00 PM,48,-122,1,0,1
21120,SpokaneStBridge,05/30/2016 12:00:00 AM,48,-122,1,1,2
21121,SpokaneStBridge,05/30/2016 01:00:00 AM,48,-122,0,1,1
21122,SpokaneStBridge,05/30/2016 02:00:00 AM,48,-122,1,0,1
21123,SpokaneStBridge,05/30/2016 03:00:00 AM,48,-122,1,0,1
21124,SpokaneStBridge,05/30/2016 04:00:00 AM,48,-122,0,1,1
21125,SpokaneStBridge,05/30/2016 05:00:00 AM,48,-122,7,0,7
21126,SpokaneStBridge,05/30/2016 06:00:00 AM,48,-122,12,5,17
21127,SpokaneStBridge,05/30/2016 07:00:00 AM,48,-122,13,6,19
21128,SpokaneStBridge,05/30/2016 08:00:00 AM,48,-122,27,19,46
21129,SpokaneStBridge,05/30/2016 09:00:00 AM,48,-122,36,29,65
21130,SpokaneStBridge,05/30/2016 10:00:00 AM,48,-122,40,38,78
21131,SpokaneStBridge,05/30/2016 11:00:00 AM,48,-122,50,58,108
21132,SpokaneStBridge,05/30/2016 12:00:00 PM,48,-122,58,67,125
21133,SpokaneStBridge,05/30/2016 01:00:00 PM,48,-122,58,49,107
21134,SpokaneStBridge,05/30/2016 02:00:00 PM,48,-122,61,56,117
21135,SpokaneStBridge,05/30/2016 03:00:00 PM,48,-122,42,62,104
21136,SpokaneStBridge,05/30/2016 04:00:00 PM,48,-122,60,33,93
21137,SpokaneStBridge,05/30/2016 05:00:00 PM,48,-122,33,42,75
21138,SpokaneStBridge,05/30/2016 06:00:00 PM,48,-122,20,28,48
21139,SpokaneStBridge,05/30/2016 07:00:00 PM,48,-122,11,18,29
21140,SpokaneStBridge,05/30/2016 08:00:00 PM,48,-122,15,12,27
21141,SpokaneStBridge,05/30/2016 09:00:00 PM,48,-122,11,7,18
21142,SpokaneStBridge,05/30/2016 10:00:00 PM,48,-122,2,3,5
21143,SpokaneStBridge,05/30/2016 11:00:00 PM,48,-122,4,2,6
21144,SpokaneStBridge,05/31/2016 12:00:00 AM,48,-122,2,5,7
21145,SpokaneStBridge,05/31/2016 01:00:00 AM,48,-122,1,0,1
21146,SpokaneStBridge,05/31/2016 02:00:00 AM,48,-122,1,1,2
21147,SpokaneStBridge,05/31/2016 03:00:00 AM,48,-122,1,0,1
21148,SpokaneStBridge,05/31/2016 04:00:00 AM,48,-122,7,3,10
21149,SpokaneStBridge,05/31/2016 05:00:00 AM,48,-122,27,4,31
21150,SpokaneStBridge,05/31/2016 06:00:00 AM,48,-122,88,11,99
21151,SpokaneStBridge,05/31/2016 07:00:00 AM,48,-122,178,19,197
21152,SpokaneStBridge,05/31/2016 08:00:00 AM,48,-122,172,30,202
21153,SpokaneStBridge,05/31/2016 09:00:00 AM,48,-122,60,9,69
21154,SpokaneStBridge,05/31/2016 10:00:00 AM,48,-122,23,4,27
21155,SpokaneStBridge,05/31/2016 11:00:00 AM,48,-122,13,19,32
21156,SpokaneStBridge,05/31/2016 12:00:00 PM,48,-122,15,24,39
21157,SpokaneStBridge,05/31/2016 01:00:00 PM,48,-122,19,19,38
21158,SpokaneStBridge,05/31/2016 02:00:00 PM,48,-122,13,16,29
21159,SpokaneStBridge,05/31/2016 03:00:00 PM,48,-122,23,48,71
21160,SpokaneStBridge,05/31/2016 04:00:00 PM,48,-122,31,118,149
21161,SpokaneStBridge,05/31/2016 05:00:00 PM,48,-122,30,216,246
21162,SpokaneStBridge,05/31/2016 06:00:00 PM,48,-122,24,134,158
21163,SpokaneStBridge,05/31/2016 07:00:00 PM,48,-122,17,49,66
21164,SpokaneStBridge,05/31/2016 08:00:00 PM,48,-122,14,24,38
21165,SpokaneStBridge,05/31/2016 09:00:00 PM,48,-122,7,15,22
21166,SpokaneStBridge,05/31/2016 10:00:00 PM,48,-122,5,6,11
21167,SpokaneStBridge,05/31/2016 11:00:00 PM,48,-122,1,5,6
21168,SpokaneStBridge,06/01/2016 12:00:00 AM,48,-122,2,1,3
21169,SpokaneStBridge,06/01/2016 01:00:00 AM,48,-122,2,0,2
21170,SpokaneStBridge,06/01/2016 02:00:00 AM,48,-122,1,2,3
21171,SpokaneStBridge,06/01/2016 03:00:00 AM,48,-122,0,1,1
21172,SpokaneStBridge,06/01/2016 04:00:00 AM,48,-122,10,3,13
21173,SpokaneStBridge,06/01/2016 05:00:00 AM,48,-122,28,4,32
21174,SpokaneStBridge,06/01/2016 06:00:00 AM,48,-122,115,16,131
21175,SpokaneStBridge,06/01/2016 07:00:00 AM,48,-122,195,20,215
21176,SpokaneStBridge,06/01/2016 08:00:00 AM,48,-122,148,17,165
21177,SpokaneStBridge,06/01/2016 09:00:00 AM,48,-122,44,16,60
21178,SpokaneStBridge,06/01/2016 10:00:00 AM,48,-122,31,31,62
21179,SpokaneStBridge,06/01/2016 11:00:00 AM,48,-122,15,12,27
21180,SpokaneStBridge,06/01/2016 12:00:00 PM,48,-122,32,16,48
21181,SpokaneStBridge,06/01/2016 01:00:00 PM,48,-122,19,13,32
21182,SpokaneStBridge,06/01/2016 02:00:00 PM,48,-122,19,21,40
21183,SpokaneStBridge,06/01/2016 03:00:00 PM,48,-122,32,40,72
21184,SpokaneStBridge,06/01/2016 04:00:00 PM,48,-122,21,125,146
21185,SpokaneStBridge,06/01/2016 05:00:00 PM,48,-122,24,220,244
21186,SpokaneStBridge,06/01/2016 06:00:00 PM,48,-122,18,130,148
21187,SpokaneStBridge,06/01/2016 07:00:00 PM,48,-122,16,40,56
21188,SpokaneStBridge,06/01/2016 08:00:00 PM,48,-122,6,22,28
21189,SpokaneStBridge,06/01/2016 09:00:00 PM,48,-122,6,13,19
21190,SpokaneStBridge,06/01/2016 10:00:00 PM,48,-122,2,4,6
21191,SpokaneStBridge,06/01/2016 11:00:00 PM,48,-122,4,2,6
21192,SpokaneStBridge,06/02/2016 12:00:00 AM,48,-122,0,3,3
21193,SpokaneStBridge,06/02/2016 01:00:00 AM,48,-122,2,0,2
21194,SpokaneStBridge,06/02/2016 02:00:00 AM,48,-122,0,2,2
21195,SpokaneStBridge,06/02/2016 03:00:00 AM,48,-122,0,1,1
21196,SpokaneStBridge,06/02/2016 04:00:00 AM,48,-122,5,1,6
21197,SpokaneStBridge,06/02/2016 05:00:00 AM,48,-122,21,2,23
21198,SpokaneStBridge,06/02/2016 06:00:00 AM,48,-122,78,11,89
21199,SpokaneStBridge,06/02/2016 07:00:00 AM,48,-122,147,12,159
21200,SpokaneStBridge,06/02/2016 08:00:00 AM,48,-122,140,16,156
21201,SpokaneStBridge,06/02/2016 09:00:00 AM,48,-122,41,3,44
21202,SpokaneStBridge,06/02/2016 10:00:00 AM,48,-122,14,5,19
21203,SpokaneStBridge,06/02/2016 11:00:00 AM,48,-122,9,8,17
21204,SpokaneStBridge,06/02/2016 12:00:00 PM,48,-122,11,8,19
21205,SpokaneStBridge,06/02/2016 01:00:00 PM,48,-122,18,8,26
21206,SpokaneStBridge,06/02/2016 02:00:00 PM,48,-122,11,18,29
21207,SpokaneStBridge,06/02/2016 03:00:00 PM,48,-122,18,25,43
21208,SpokaneStBridge,06/02/2016 04:00:00 PM,48,-122,15,75,90
21209,SpokaneStBridge,06/02/2016 05:00:00 PM,48,-122,22,172,194
21210,SpokaneStBridge,06/02/2016 06:00:00 PM,48,-122,30,115,145
21211,SpokaneStBridge,06/02/2016 07:00:00 PM,48,-122,12,38,50
21212,SpokaneStBridge,06/02/2016 08:00:00 PM,48,-122,11,22,33
21213,SpokaneStBridge,06/02/2016 09:00:00 PM,48,-122,1,6,7
21214,SpokaneStBridge,06/02/2016 10:00:00 PM,48,-122,2,10,12
21215,SpokaneStBridge,06/02/2016 11:00:00 PM,48,-122,4,5,9
21216,SpokaneStBridge,06/03/2016 12:00:00 AM,48,-122,0,1,1
21217,SpokaneStBridge,06/03/2016 01:00:00 AM,48,-122,2,3,5
21218,SpokaneStBridge,06/03/2016 02:00:00 AM,48,-122,2,2,4
21219,SpokaneStBridge,06/03/2016 03:00:00 AM,48,-122,1,0,1
21220,SpokaneStBridge,06/03/2016 04:00:00 AM,48,-122,5,2,7
21221,SpokaneStBridge,06/03/2016 05:00:00 AM,48,-122,28,3,31
21222,SpokaneStBridge,06/03/2016 06:00:00 AM,48,-122,83,12,95
21223,SpokaneStBridge,06/03/2016 07:00:00 AM,48,-122,146,13,159
21224,SpokaneStBridge,06/03/2016 08:00:00 AM,48,-122,132,22,154
21225,SpokaneStBridge,06/03/2016 09:00:00 AM,48,-122,41,17,58
21226,SpokaneStBridge,06/03/2016 10:00:00 AM,48,-122,25,14,39
21227,SpokaneStBridge,06/03/2016 11:00:00 AM,48,-122,21,44,65
21228,SpokaneStBridge,06/03/2016 12:00:00 PM,48,-122,34,11,45
21229,SpokaneStBridge,06/03/2016 01:00:00 PM,48,-122,17,27,44
21230,SpokaneStBridge,06/03/2016 02:00:00 PM,48,-122,24,18,42
21231,SpokaneStBridge,06/03/2016 03:00:00 PM,48,-122,18,47,65
21232,SpokaneStBridge,06/03/2016 04:00:00 PM,48,-122,32,117,149
21233,SpokaneStBridge,06/03/2016 05:00:00 PM,48,-122,34,157,191
21234,SpokaneStBridge,06/03/2016 06:00:00 PM,48,-122,18,100,118
21235,SpokaneStBridge,06/03/2016 07:00:00 PM,48,-122,12,35,47
21236,SpokaneStBridge,06/03/2016 08:00:00 PM,48,-122,13,15,28
21237,SpokaneStBridge,06/03/2016 09:00:00 PM,48,-122,6,12,18
21238,SpokaneStBridge,06/03/2016 10:00:00 PM,48,-122,5,12,17
21239,SpokaneStBridge,06/03/2016 11:00:00 PM,48,-122,1,6,7
21240,SpokaneStBridge,06/04/2016 12:00:00 AM,48,-122,4,3,7
21241,SpokaneStBridge,06/04/2016 01:00:00 AM,48,-122,3,2,5
21242,SpokaneStBridge,06/04/2016 02:00:00 AM,48,-122,1,2,3
21243,SpokaneStBridge,06/04/2016 03:00:00 AM,48,-122,0,2,2
21244,SpokaneStBridge,06/04/2016 04:00:00 AM,48,-122,1,0,1
21245,SpokaneStBridge,06/04/2016 05:00:00 AM,48,-122,4,1,5
21246,SpokaneStBridge,06/04/2016 06:00:00 AM,48,-122,10,4,14
21247,SpokaneStBridge,06/04/2016 07:00:00 AM,48,-122,24,9,33
21248,SpokaneStBridge,06/04/2016 08:00:00 AM,48,-122,16,28,44
21249,SpokaneStBridge,06/04/2016 09:00:00 AM,48,-122,31,37,68
21250,SpokaneStBridge,06/04/2016 10:00:00 AM,48,-122,79,50,129
21251,SpokaneStBridge,06/04/2016 11:00:00 AM,48,-122,75,46,121
21252,SpokaneStBridge,06/04/2016 12:00:00 PM,48,-122,45,41,86
21253,SpokaneStBridge,06/04/2016 01:00:00 PM,48,-122,53,42,95
21254,SpokaneStBridge,06/04/2016 02:00:00 PM,48,-122,34,42,76
21255,SpokaneStBridge,06/04/2016 03:00:00 PM,48,-122,40,39,79
21256,SpokaneStBridge,06/04/2016 04:00:00 PM,48,-122,34,38,72
21257,SpokaneStBridge,06/04/2016 05:00:00 PM,48,-122,27,41,68
21258,SpokaneStBridge,06/04/2016 06:00:00 PM,48,-122,24,20,44
21259,SpokaneStBridge,06/04/2016 07:00:00 PM,48,-122,9,19,28
21260,SpokaneStBridge,06/04/2016 08:00:00 PM,48,-122,14,7,21
21261,SpokaneStBridge,06/04/2016 09:00:00 PM,48,-122,8,4,12
21262,SpokaneStBridge,06/04/2016 10:00:00 PM,48,-122,4,3,7
21263,SpokaneStBridge,06/04/2016 11:00:00 PM,48,-122,1,7,8
21264,SpokaneStBridge,06/05/2016 12:00:00 AM,48,-122,1,7,8
21265,SpokaneStBridge,06/05/2016 01:00:00 AM,48,-122,1,3,4
21266,SpokaneStBridge,06/05/2016 02:00:00 AM,48,-122,1,3,4
21267,SpokaneStBridge,06/05/2016 03:00:00 AM,48,-122,1,3,4
21268,SpokaneStBridge,06/05/2016 04:00:00 AM,48,-122,1,0,1
21269,SpokaneStBridge,06/05/2016 05:00:00 AM,48,-122,4,2,6
21270,SpokaneStBridge,06/05/2016 06:00:00 AM,48,-122,11,6,17
21271,SpokaneStBridge,06/05/2016 07:00:00 AM,48,-122,15,6,21
21272,SpokaneStBridge,06/05/2016 08:00:00 AM,48,-122,36,18,54
21273,SpokaneStBridge,06/05/2016 09:00:00 AM,48,-122,26,44,70
21274,SpokaneStBridge,06/05/2016 10:00:00 AM,48,-122,44,29,73
21275,SpokaneStBridge,06/05/2016 11:00:00 AM,48,-122,37,49,86
21276,SpokaneStBridge,06/05/2016 12:00:00 PM,48,-122,36,68,104
21277,SpokaneStBridge,06/05/2016 01:00:00 PM,48,-122,47,53,100
21278,SpokaneStBridge,06/05/2016 02:00:00 PM,48,-122,50,48,98
21279,SpokaneStBridge,06/05/2016 03:00:00 PM,48,-122,35,31,66
21280,SpokaneStBridge,06/05/2016 04:00:00 PM,48,-122,24,30,54
21281,SpokaneStBridge,06/05/2016 05:00:00 PM,48,-122,30,20,50
21282,SpokaneStBridge,06/05/2016 06:00:00 PM,48,-122,26,20,46
21283,SpokaneStBridge,06/05/2016 07:00:00 PM,48,-122,10,8,18
21284,SpokaneStBridge,06/05/2016 08:00:00 PM,48,-122,17,11,28
21285,SpokaneStBridge,06/05/2016 09:00:00 PM,48,-122,3,6,9
21286,SpokaneStBridge,06/05/2016 10:00:00 PM,48,-122,3,6,9
21287,SpokaneStBridge,06/05/2016 11:00:00 PM,48,-122,1,1,2
21288,SpokaneStBridge,06/06/2016 12:00:00 AM,48,-122,1,0,1
21289,SpokaneStBridge,06/06/2016 01:00:00 AM,48,-122,1,1,2
21290,SpokaneStBridge,06/06/2016 02:00:00 AM,48,-122,0,1,1
21291,SpokaneStBridge,06/06/2016 03:00:00 AM,48,-122,1,1,2
21292,SpokaneStBridge,06/06/2016 04:00:00 AM,48,-122,5,1,6
21293,SpokaneStBridge,06/06/2016 05:00:00 AM,48,-122,31,3,34
21294,SpokaneStBridge,06/06/2016 06:00:00 AM,48,-122,87,11,98
21295,SpokaneStBridge,06/06/2016 07:00:00 AM,48,-122,171,20,191
21296,SpokaneStBridge,06/06/2016 08:00:00 AM,48,-122,157,22,179
21297,SpokaneStBridge,06/06/2016 09:00:00 AM,48,-122,55,10,65
21298,SpokaneStBridge,06/06/2016 10:00:00 AM,48,-122,18,14,32
21299,SpokaneStBridge,06/06/2016 11:00:00 AM,48,-122,11,15,26
21300,SpokaneStBridge,06/06/2016 12:00:00 PM,48,-122,23,13,36
21301,SpokaneStBridge,06/06/2016 01:00:00 PM,48,-122,14,9,23
21302,SpokaneStBridge,06/06/2016 02:00:00 PM,48,-122,10,22,32
21303,SpokaneStBridge,06/06/2016 03:00:00 PM,48,-122,21,48,69
21304,SpokaneStBridge,06/06/2016 04:00:00 PM,48,-122,25,103,128
21305,SpokaneStBridge,06/06/2016 05:00:00 PM,48,-122,26,200,226
21306,SpokaneStBridge,06/06/2016 06:00:00 PM,48,-122,18,145,163
21307,SpokaneStBridge,06/06/2016 07:00:00 PM,48,-122,15,48,63
21308,SpokaneStBridge,06/06/2016 08:00:00 PM,48,-122,30,29,59
21309,SpokaneStBridge,06/06/2016 09:00:00 PM,48,-122,3,9,12
21310,SpokaneStBridge,06/06/2016 10:00:00 PM,48,-122,8,13,21
21311,SpokaneStBridge,06/06/2016 11:00:00 PM,48,-122,1,4,5
21312,SpokaneStBridge,06/07/2016 12:00:00 AM,48,-122,1,1,2
21313,SpokaneStBridge,06/07/2016 01:00:00 AM,48,-122,0,0,0
21314,SpokaneStBridge,06/07/2016 02:00:00 AM,48,-122,3,2,5
21315,SpokaneStBridge,06/07/2016 03:00:00 AM,48,-122,0,0,0
21316,SpokaneStBridge,06/07/2016 04:00:00 AM,48,-122,7,3,10
21317,SpokaneStBridge,06/07/2016 05:00:00 AM,48,-122,41,4,45
21318,SpokaneStBridge,06/07/2016 06:00:00 AM,48,-122,96,17,113
21319,SpokaneStBridge,06/07/2016 07:00:00 AM,48,-122,191,24,215
21320,SpokaneStBridge,06/07/2016 08:00:00 AM,48,-122,143,19,162
21321,SpokaneStBridge,06/07/2016 09:00:00 AM,48,-122,71,14,85
21322,SpokaneStBridge,06/07/2016 10:00:00 AM,48,-122,31,8,39
21323,SpokaneStBridge,06/07/2016 11:00:00 AM,48,-122,13,14,27
21324,SpokaneStBridge,06/07/2016 12:00:00 PM,48,-122,9,16,25
21325,SpokaneStBridge,06/07/2016 01:00:00 PM,48,-122,16,20,36
21326,SpokaneStBridge,06/07/2016 02:00:00 PM,48,-122,16,21,37
21327,SpokaneStBridge,06/07/2016 03:00:00 PM,48,-122,33,38,71
21328,SpokaneStBridge,06/07/2016 04:00:00 PM,48,-122,22,113,135
21329,SpokaneStBridge,06/07/2016 05:00:00 PM,48,-122,42,202,244
21330,SpokaneStBridge,06/07/2016 06:00:00 PM,48,-122,29,119,148
21331,SpokaneStBridge,06/07/2016 07:00:00 PM,48,-122,17,56,73
21332,SpokaneStBridge,06/07/2016 08:00:00 PM,48,-122,13,34,47
21333,SpokaneStBridge,06/07/2016 09:00:00 PM,48,-122,8,20,28
21334,SpokaneStBridge,06/07/2016 10:00:00 PM,48,-122,3,12,15
21335,SpokaneStBridge,06/07/2016 11:00:00 PM,48,-122,4,5,9
21336,SpokaneStBridge,06/08/2016 12:00:00 AM,48,-122,1,1,2
21337,SpokaneStBridge,06/08/2016 01:00:00 AM,48,-122,0,0,0
21338,SpokaneStBridge,06/08/2016 02:00:00 AM,48,-122,3,4,7
21339,SpokaneStBridge,06/08/2016 03:00:00 AM,48,-122,0,2,2
21340,SpokaneStBridge,06/08/2016 04:00:00 AM,48,-122,2,2,4
21341,SpokaneStBridge,06/08/2016 05:00:00 AM,48,-122,33,6,39
21342,SpokaneStBridge,06/08/2016 06:00:00 AM,48,-122,97,8,105
21343,SpokaneStBridge,06/08/2016 07:00:00 AM,48,-122,159,23,182
21344,SpokaneStBridge,06/08/2016 08:00:00 AM,48,-122,154,17,171
21345,SpokaneStBridge,06/08/2016 09:00:00 AM,48,-122,48,14,62
21346,SpokaneStBridge,06/08/2016 10:00:00 AM,48,-122,27,10,37
21347,SpokaneStBridge,06/08/2016 11:00:00 AM,48,-122,17,7,24
21348,SpokaneStBridge,06/08/2016 12:00:00 PM,48,-122,14,21,35
21349,SpokaneStBridge,06/08/2016 01:00:00 PM,48,-122,19,18,37
21350,SpokaneStBridge,06/08/2016 02:00:00 PM,48,-122,13,26,39
21351,SpokaneStBridge,06/08/2016 03:00:00 PM,48,-122,14,29,43
21352,SpokaneStBridge,06/08/2016 04:00:00 PM,48,-122,17,101,118
21353,SpokaneStBridge,06/08/2016 05:00:00 PM,48,-122,19,174,193
21354,SpokaneStBridge,06/08/2016 06:00:00 PM,48,-122,13,102,115
21355,SpokaneStBridge,06/08/2016 07:00:00 PM,48,-122,15,48,63
21356,SpokaneStBridge,06/08/2016 08:00:00 PM,48,-122,9,21,30
21357,SpokaneStBridge,06/08/2016 09:00:00 PM,48,-122,6,12,18
21358,SpokaneStBridge,06/08/2016 10:00:00 PM,48,-122,2,4,6
21359,SpokaneStBridge,06/08/2016 11:00:00 PM,48,-122,0,5,5
21360,SpokaneStBridge,06/09/2016 12:00:00 AM,48,-122,2,3,5
21361,SpokaneStBridge,06/09/2016 01:00:00 AM,48,-122,1,3,4
21362,SpokaneStBridge,06/09/2016 02:00:00 AM,48,-122,2,1,3
21363,SpokaneStBridge,06/09/2016 03:00:00 AM,48,-122,1,1,2
21364,SpokaneStBridge,06/09/2016 04:00:00 AM,48,-122,2,0,2
21365,SpokaneStBridge,06/09/2016 05:00:00 AM,48,-122,27,5,32
21366,SpokaneStBridge,06/09/2016 06:00:00 AM,48,-122,69,9,78
21367,SpokaneStBridge,06/09/2016 07:00:00 AM,48,-122,140,23,163
21368,SpokaneStBridge,06/09/2016 08:00:00 AM,48,-122,153,23,176
21369,SpokaneStBridge,06/09/2016 09:00:00 AM,48,-122,62,8,70
21370,SpokaneStBridge,06/09/2016 10:00:00 AM,48,-122,23,8,31
21371,SpokaneStBridge,06/09/2016 11:00:00 AM,48,-122,12,12,24
21372,SpokaneStBridge,06/09/2016 12:00:00 PM,48,-122,8,10,18
21373,SpokaneStBridge,06/09/2016 01:00:00 PM,48,-122,13,16,29
21374,SpokaneStBridge,06/09/2016 02:00:00 PM,48,-122,12,23,35
21375,SpokaneStBridge,06/09/2016 03:00:00 PM,48,-122,18,27,45
21376,SpokaneStBridge,06/09/2016 04:00:00 PM,48,-122,24,102,126
21377,SpokaneStBridge,06/09/2016 05:00:00 PM,48,-122,17,158,175
21378,SpokaneStBridge,06/09/2016 06:00:00 PM,48,-122,15,98,113
21379,SpokaneStBridge,06/09/2016 07:00:00 PM,48,-122,15,44,59
21380,SpokaneStBridge,06/09/2016 08:00:00 PM,48,-122,4,24,28
21381,SpokaneStBridge,06/09/2016 09:00:00 PM,48,-122,1,12,13
21382,SpokaneStBridge,06/09/2016 10:00:00 PM,48,-122,2,5,7
21383,SpokaneStBridge,06/09/2016 11:00:00 PM,48,-122,1,6,7
21384,SpokaneStBridge,06/10/2016 12:00:00 AM,48,-122,1,1,2
21385,SpokaneStBridge,06/10/2016 01:00:00 AM,48,-122,1,3,4
21386,SpokaneStBridge,06/10/2016 02:00:00 AM,48,-122,1,2,3
21387,SpokaneStBridge,06/10/2016 03:00:00 AM,48,-122,0,0,0
21388,SpokaneStBridge,06/10/2016 04:00:00 AM,48,-122,3,0,3
21389,SpokaneStBridge,06/10/2016 05:00:00 AM,48,-122,13,3,16
21390,SpokaneStBridge,06/10/2016 06:00:00 AM,48,-122,76,8,84
21391,SpokaneStBridge,06/10/2016 07:00:00 AM,48,-122,106,15,121
21392,SpokaneStBridge,06/10/2016 08:00:00 AM,48,-122,107,10,117
21393,SpokaneStBridge,06/10/2016 09:00:00 AM,48,-122,45,7,52
21394,SpokaneStBridge,06/10/2016 10:00:00 AM,48,-122,17,8,25
21395,SpokaneStBridge,06/10/2016 11:00:00 AM,48,-122,14,7,21
21396,SpokaneStBridge,06/10/2016 12:00:00 PM,48,-122,7,12,19
21397,SpokaneStBridge,06/10/2016 01:00:00 PM,48,-122,13,9,22
21398,SpokaneStBridge,06/10/2016 02:00:00 PM,48,-122,6,36,42
21399,SpokaneStBridge,06/10/2016 03:00:00 PM,48,-122,11,42,53
21400,SpokaneStBridge,06/10/2016 04:00:00 PM,48,-122,15,81,96
21401,SpokaneStBridge,06/10/2016 05:00:00 PM,48,-122,18,96,114
21402,SpokaneStBridge,06/10/2016 06:00:00 PM,48,-122,11,64,75
21403,SpokaneStBridge,06/10/2016 07:00:00 PM,48,-122,7,18,25
21404,SpokaneStBridge,06/10/2016 08:00:00 PM,48,-122,6,11,17
21405,SpokaneStBridge,06/10/2016 09:00:00 PM,48,-122,6,6,12
21406,SpokaneStBridge,06/10/2016 10:00:00 PM,48,-122,2,4,6
21407,SpokaneStBridge,06/10/2016 11:00:00 PM,48,-122,1,1,2
21408,SpokaneStBridge,06/11/2016 12:00:00 AM,48,-122,6,9,15
21409,SpokaneStBridge,06/11/2016 01:00:00 AM,48,-122,0,1,1
21410,SpokaneStBridge,06/11/2016 02:00:00 AM,48,-122,1,2,3
21411,SpokaneStBridge,06/11/2016 03:00:00 AM,48,-122,0,1,1
21412,SpokaneStBridge,06/11/2016 04:00:00 AM,48,-122,1,1,2
21413,SpokaneStBridge,06/11/2016 05:00:00 AM,48,-122,7,0,7
21414,SpokaneStBridge,06/11/2016 06:00:00 AM,48,-122,7,2,9
21415,SpokaneStBridge,06/11/2016 07:00:00 AM,48,-122,13,6,19
21416,SpokaneStBridge,06/11/2016 08:00:00 AM,48,-122,15,10,25
21417,SpokaneStBridge,06/11/2016 09:00:00 AM,48,-122,18,16,34
21418,SpokaneStBridge,06/11/2016 10:00:00 AM,48,-122,15,19,34
21419,SpokaneStBridge,06/11/2016 11:00:00 AM,48,-122,17,19,36
21420,SpokaneStBridge,06/11/2016 12:00:00 PM,48,-122,19,13,32
21421,SpokaneStBridge,06/11/2016 01:00:00 PM,48,-122,38,25,63
21422,SpokaneStBridge,06/11/2016 02:00:00 PM,48,-122,21,18,39
21423,SpokaneStBridge,06/11/2016 03:00:00 PM,48,-122,31,19,50
21424,SpokaneStBridge,06/11/2016 04:00:00 PM,48,-122,8,23,31
21425,SpokaneStBridge,06/11/2016 05:00:00 PM,48,-122,9,16,25
21426,SpokaneStBridge,06/11/2016 06:00:00 PM,48,-122,20,8,28
21427,SpokaneStBridge,06/11/2016 07:00:00 PM,48,-122,3,5,8
21428,SpokaneStBridge,06/11/2016 08:00:00 PM,48,-122,5,2,7
21429,SpokaneStBridge,06/11/2016 09:00:00 PM,48,-122,3,2,5
21430,SpokaneStBridge,06/11/2016 10:00:00 PM,48,-122,0,8,8
21431,SpokaneStBridge,06/11/2016 11:00:00 PM,48,-122,1,4,5
21432,SpokaneStBridge,06/12/2016 12:00:00 AM,48,-122,1,2,3
21433,SpokaneStBridge,06/12/2016 01:00:00 AM,48,-122,1,0,1
21434,SpokaneStBridge,06/12/2016 02:00:00 AM,48,-122,2,2,4
21435,SpokaneStBridge,06/12/2016 03:00:00 AM,48,-122,1,0,1
21436,SpokaneStBridge,06/12/2016 04:00:00 AM,48,-122,0,2,2
21437,SpokaneStBridge,06/12/2016 05:00:00 AM,48,-122,6,0,6
21438,SpokaneStBridge,06/12/2016 06:00:00 AM,48,-122,8,3,11
21439,SpokaneStBridge,06/12/2016 07:00:00 AM,48,-122,15,10,25
21440,SpokaneStBridge,06/12/2016 08:00:00 AM,48,-122,28,11,39
21441,SpokaneStBridge,06/12/2016 09:00:00 AM,48,-122,19,17,36
21442,SpokaneStBridge,06/12/2016 10:00:00 AM,48,-122,38,46,84
21443,SpokaneStBridge,06/12/2016 11:00:00 AM,48,-122,48,37,85
21444,SpokaneStBridge,06/12/2016 12:00:00 PM,48,-122,44,46,90
21445,SpokaneStBridge,06/12/2016 01:00:00 PM,48,-122,30,46,76
21446,SpokaneStBridge,06/12/2016 02:00:00 PM,48,-122,37,43,80
21447,SpokaneStBridge,06/12/2016 03:00:00 PM,48,-122,53,42,95
21448,SpokaneStBridge,06/12/2016 04:00:00 PM,48,-122,39,25,64
21449,SpokaneStBridge,06/12/2016 05:00:00 PM,48,-122,38,26,64
21450,SpokaneStBridge,06/12/2016 06:00:00 PM,48,-122,17,22,39
21451,SpokaneStBridge,06/12/2016 07:00:00 PM,48,-122,15,11,26
21452,SpokaneStBridge,06/12/2016 08:00:00 PM,48,-122,12,13,25
21453,SpokaneStBridge,06/12/2016 09:00:00 PM,48,-122,6,6,12
21454,SpokaneStBridge,06/12/2016 10:00:00 PM,48,-122,2,2,4
21455,SpokaneStBridge,06/12/2016 11:00:00 PM,48,-122,0,4,4
21456,SpokaneStBridge,06/13/2016 12:00:00 AM,48,-122,2,1,3
21457,SpokaneStBridge,06/13/2016 01:00:00 AM,48,-122,2,2,4
21458,SpokaneStBridge,06/13/2016 02:00:00 AM,48,-122,1,0,1
21459,SpokaneStBridge,06/13/2016 03:00:00 AM,48,-122,0,1,1
21460,SpokaneStBridge,06/13/2016 04:00:00 AM,48,-122,4,0,4
21461,SpokaneStBridge,06/13/2016 05:00:00 AM,48,-122,24,5,29
21462,SpokaneStBridge,06/13/2016 06:00:00 AM,48,-122,70,13,83
21463,SpokaneStBridge,06/13/2016 07:00:00 AM,48,-122,156,17,173
21464,SpokaneStBridge,06/13/2016 08:00:00 AM,48,-122,150,14,164
21465,SpokaneStBridge,06/13/2016 09:00:00 AM,48,-122,48,7,55
21466,SpokaneStBridge,06/13/2016 10:00:00 AM,48,-122,14,4,18
21467,SpokaneStBridge,06/13/2016 11:00:00 AM,48,-122,9,16,25
21468,SpokaneStBridge,06/13/2016 12:00:00 PM,48,-122,9,9,18
21469,SpokaneStBridge,06/13/2016 01:00:00 PM,48,-122,14,9,23
21470,SpokaneStBridge,06/13/2016 02:00:00 PM,48,-122,13,12,25
21471,SpokaneStBridge,06/13/2016 03:00:00 PM,48,-122,12,32,44
21472,SpokaneStBridge,06/13/2016 04:00:00 PM,48,-122,19,89,108
21473,SpokaneStBridge,06/13/2016 05:00:00 PM,48,-122,16,184,200
21474,SpokaneStBridge,06/13/2016 06:00:00 PM,48,-122,12,94,106
21475,SpokaneStBridge,06/13/2016 07:00:00 PM,48,-122,7,39,46
21476,SpokaneStBridge,06/13/2016 08:00:00 PM,48,-122,8,20,28
21477,SpokaneStBridge,06/13/2016 09:00:00 PM,48,-122,2,8,10
21478,SpokaneStBridge,06/13/2016 10:00:00 PM,48,-122,0,8,8
21479,SpokaneStBridge,06/13/2016 11:00:00 PM,48,-122,1,3,4
21480,SpokaneStBridge,06/14/2016 12:00:00 AM,48,-122,1,1,2
21481,SpokaneStBridge,06/14/2016 01:00:00 AM,48,-122,0,1,1
21482,SpokaneStBridge,06/14/2016 02:00:00 AM,48,-122,3,1,4
21483,SpokaneStBridge,06/14/2016 03:00:00 AM,48,-122,1,0,1
21484,SpokaneStBridge,06/14/2016 04:00:00 AM,48,-122,5,1,6
21485,SpokaneStBridge,06/14/2016 05:00:00 AM,48,-122,15,1,16
21486,SpokaneStBridge,06/14/2016 06:00:00 AM,48,-122,60,7,67
21487,SpokaneStBridge,06/14/2016 07:00:00 AM,48,-122,125,15,140
21488,SpokaneStBridge,06/14/2016 08:00:00 AM,48,-122,109,8,117
21489,SpokaneStBridge,06/14/2016 09:00:00 AM,48,-122,39,7,46
21490,SpokaneStBridge,06/14/2016 10:00:00 AM,48,-122,23,4,27
21491,SpokaneStBridge,06/14/2016 11:00:00 AM,48,-122,4,7,11
21492,SpokaneStBridge,06/14/2016 12:00:00 PM,48,-122,5,8,13
21493,SpokaneStBridge,06/14/2016 01:00:00 PM,48,-122,7,5,12
21494,SpokaneStBridge,06/14/2016 02:00:00 PM,48,-122,8,9,17
21495,SpokaneStBridge,06/14/2016 03:00:00 PM,48,-122,12,17,29
21496,SpokaneStBridge,06/14/2016 04:00:00 PM,48,-122,16,68,84
21497,SpokaneStBridge,06/14/2016 05:00:00 PM,48,-122,22,120,142
21498,SpokaneStBridge,06/14/2016 06:00:00 PM,48,-122,11,70,81
21499,SpokaneStBridge,06/14/2016 07:00:00 PM,48,-122,6,29,35
21500,SpokaneStBridge,06/14/2016 08:00:00 PM,48,-122,5,14,19
21501,SpokaneStBridge,06/14/2016 09:00:00 PM,48,-122,3,19,22
21502,SpokaneStBridge,06/14/2016 10:00:00 PM,48,-122,3,6,9
21503,SpokaneStBridge,06/14/2016 11:00:00 PM,48,-122,1,1,2
21504,SpokaneStBridge,06/15/2016 12:00:00 AM,48,-122,0,3,3
21505,SpokaneStBridge,06/15/2016 01:00:00 AM,48,-122,2,2,4
21506,SpokaneStBridge,06/15/2016 02:00:00 AM,48,-122,1,2,3
21507,SpokaneStBridge,06/15/2016 03:00:00 AM,48,-122,0,1,1
21508,SpokaneStBridge,06/15/2016 04:00:00 AM,48,-122,7,2,9
21509,SpokaneStBridge,06/15/2016 05:00:00 AM,48,-122,26,4,30
21510,SpokaneStBridge,06/15/2016 06:00:00 AM,48,-122,76,9,85
21511,SpokaneStBridge,06/15/2016 07:00:00 AM,48,-122,133,18,151
21512,SpokaneStBridge,06/15/2016 08:00:00 AM,48,-122,146,9,155
21513,SpokaneStBridge,06/15/2016 09:00:00 AM,48,-122,64,6,70
21514,SpokaneStBridge,06/15/2016 10:00:00 AM,48,-122,20,4,24
21515,SpokaneStBridge,06/15/2016 11:00:00 AM,48,-122,21,10,31
21516,SpokaneStBridge,06/15/2016 12:00:00 PM,48,-122,11,14,25
21517,SpokaneStBridge,06/15/2016 01:00:00 PM,48,-122,18,11,29
21518,SpokaneStBridge,06/15/2016 02:00:00 PM,48,-122,16,20,36
21519,SpokaneStBridge,06/15/2016 03:00:00 PM,48,-122,24,42,66
21520,SpokaneStBridge,06/15/2016 04:00:00 PM,48,-122,19,93,112
21521,SpokaneStBridge,06/15/2016 05:00:00 PM,48,-122,31,183,214
21522,SpokaneStBridge,06/15/2016 06:00:00 PM,48,-122,28,120,148
21523,SpokaneStBridge,06/15/2016 07:00:00 PM,48,-122,24,50,74
21524,SpokaneStBridge,06/15/2016 08:00:00 PM,48,-122,10,18,28
21525,SpokaneStBridge,06/15/2016 09:00:00 PM,48,-122,6,13,19
21526,SpokaneStBridge,06/15/2016 10:00:00 PM,48,-122,5,5,10
21527,SpokaneStBridge,06/15/2016 11:00:00 PM,48,-122,1,2,3
21528,SpokaneStBridge,06/16/2016 12:00:00 AM,48,-122,0,4,4
21529,SpokaneStBridge,06/16/2016 01:00:00 AM,48,-122,1,3,4
21530,SpokaneStBridge,06/16/2016 02:00:00 AM,48,-122,1,2,3
21531,SpokaneStBridge,06/16/2016 03:00:00 AM,48,-122,1,1,2
21532,SpokaneStBridge,06/16/2016 04:00:00 AM,48,-122,4,2,6
21533,SpokaneStBridge,06/16/2016 05:00:00 AM,48,-122,25,4,29
21534,SpokaneStBridge,06/16/2016 06:00:00 AM,48,-122,79,9,88
21535,SpokaneStBridge,06/16/2016 07:00:00 AM,48,-122,126,18,144
21536,SpokaneStBridge,06/16/2016 08:00:00 AM,48,-122,169,23,192
21537,SpokaneStBridge,06/16/2016 09:00:00 AM,48,-122,68,11,79
21538,SpokaneStBridge,06/16/2016 10:00:00 AM,48,-122,20,8,28
21539,SpokaneStBridge,06/16/2016 11:00:00 AM,48,-122,18,15,33
21540,SpokaneStBridge,06/16/2016 12:00:00 PM,48,-122,17,7,24
21541,SpokaneStBridge,06/16/2016 01:00:00 PM,48,-122,11,12,23
21542,SpokaneStBridge,06/16/2016 02:00:00 PM,48,-122,22,28,50
21543,SpokaneStBridge,06/16/2016 03:00:00 PM,48,-122,17,39,56
21544,SpokaneStBridge,06/16/2016 04:00:00 PM,48,-122,31,91,122
21545,SpokaneStBridge,06/16/2016 05:00:00 PM,48,-122,36,173,209
21546,SpokaneStBridge,06/16/2016 06:00:00 PM,48,-122,27,110,137
21547,SpokaneStBridge,06/16/2016 07:00:00 PM,48,-122,18,91,109
21548,SpokaneStBridge,06/16/2016 08:00:00 PM,48,-122,10,22,32
21549,SpokaneStBridge,06/16/2016 09:00:00 PM,48,-122,6,22,28
21550,SpokaneStBridge,06/16/2016 10:00:00 PM,48,-122,4,20,24
21551,SpokaneStBridge,06/16/2016 11:00:00 PM,48,-122,8,3,11
21552,SpokaneStBridge,06/17/2016 12:00:00 AM,48,-122,12,2,14
21553,SpokaneStBridge,06/17/2016 01:00:00 AM,48,-122,7,0,7
21554,SpokaneStBridge,06/17/2016 02:00:00 AM,48,-122,1,4,5
21555,SpokaneStBridge,06/17/2016 03:00:00 AM,48,-122,1,0,1
21556,SpokaneStBridge,06/17/2016 04:00:00 AM,48,-122,2,1,3
21557,SpokaneStBridge,06/17/2016 05:00:00 AM,48,-122,15,9,24
21558,SpokaneStBridge,06/17/2016 06:00:00 AM,48,-122,71,6,77
21559,SpokaneStBridge,06/17/2016 07:00:00 AM,48,-122,133,14,147
21560,SpokaneStBridge,06/17/2016 08:00:00 AM,48,-122,135,18,153
21561,SpokaneStBridge,06/17/2016 09:00:00 AM,48,-122,49,11,60
21562,SpokaneStBridge,06/17/2016 10:00:00 AM,48,-122,10,12,22
21563,SpokaneStBridge,06/17/2016 11:00:00 AM,48,-122,25,12,37
21564,SpokaneStBridge,06/17/2016 12:00:00 PM,48,-122,14,18,32
21565,SpokaneStBridge,06/17/2016 01:00:00 PM,48,-122,20,21,41
21566,SpokaneStBridge,06/17/2016 02:00:00 PM,48,-122,17,27,44
21567,SpokaneStBridge,06/17/2016 03:00:00 PM,48,-122,16,45,61
21568,SpokaneStBridge,06/17/2016 04:00:00 PM,48,-122,16,95,111
21569,SpokaneStBridge,06/17/2016 05:00:00 PM,48,-122,15,113,128
21570,SpokaneStBridge,06/17/2016 06:00:00 PM,48,-122,15,53,68
21571,SpokaneStBridge,06/17/2016 07:00:00 PM,48,-122,11,31,42
21572,SpokaneStBridge,06/17/2016 08:00:00 PM,48,-122,5,11,16
21573,SpokaneStBridge,06/17/2016 09:00:00 PM,48,-122,2,5,7
21574,SpokaneStBridge,06/17/2016 10:00:00 PM,48,-122,1,2,3
21575,SpokaneStBridge,06/17/2016 11:00:00 PM,48,-122,2,3,5
21576,SpokaneStBridge,06/18/2016 12:00:00 AM,48,-122,1,3,4
21577,SpokaneStBridge,06/18/2016 01:00:00 AM,48,-122,0,0,0
21578,SpokaneStBridge,06/18/2016 02:00:00 AM,48,-122,2,0,2
21579,SpokaneStBridge,06/18/2016 03:00:00 AM,48,-122,0,0,0
21580,SpokaneStBridge,06/18/2016 04:00:00 AM,48,-122,2,1,3
21581,SpokaneStBridge,06/18/2016 05:00:00 AM,48,-122,4,0,4
21582,SpokaneStBridge,06/18/2016 06:00:00 AM,48,-122,7,2,9
21583,SpokaneStBridge,06/18/2016 07:00:00 AM,48,-122,12,9,21
21584,SpokaneStBridge,06/18/2016 08:00:00 AM,48,-122,9,7,16
21585,SpokaneStBridge,06/18/2016 09:00:00 AM,48,-122,20,5,25
21586,SpokaneStBridge,06/18/2016 10:00:00 AM,48,-122,11,11,22
21587,SpokaneStBridge,06/18/2016 11:00:00 AM,48,-122,6,7,13
21588,SpokaneStBridge,06/18/2016 12:00:00 PM,48,-122,15,12,27
21589,SpokaneStBridge,06/18/2016 01:00:00 PM,48,-122,14,7,21
21590,SpokaneStBridge,06/18/2016 02:00:00 PM,48,-122,14,14,28
21591,SpokaneStBridge,06/18/2016 03:00:00 PM,48,-122,14,13,27
21592,SpokaneStBridge,06/18/2016 04:00:00 PM,48,-122,13,11,24
21593,SpokaneStBridge,06/18/2016 05:00:00 PM,48,-122,9,13,22
21594,SpokaneStBridge,06/18/2016 06:00:00 PM,48,-122,9,15,24
21595,SpokaneStBridge,06/18/2016 07:00:00 PM,48,-122,2,10,12
21596,SpokaneStBridge,06/18/2016 08:00:00 PM,48,-122,3,8,11
21597,SpokaneStBridge,06/18/2016 09:00:00 PM,48,-122,2,7,9
21598,SpokaneStBridge,06/18/2016 10:00:00 PM,48,-122,1,4,5
21599,SpokaneStBridge,06/18/2016 11:00:00 PM,48,-122,0,3,3
21600,SpokaneStBridge,06/19/2016 12:00:00 AM,48,-122,2,1,3
21601,SpokaneStBridge,06/19/2016 01:00:00 AM,48,-122,0,0,0
21602,SpokaneStBridge,06/19/2016 02:00:00 AM,48,-122,1,2,3
21603,SpokaneStBridge,06/19/2016 03:00:00 AM,48,-122,1,2,3
21604,SpokaneStBridge,06/19/2016 04:00:00 AM,48,-122,0,0,0
21605,SpokaneStBridge,06/19/2016 05:00:00 AM,48,-122,5,1,6
21606,SpokaneStBridge,06/19/2016 06:00:00 AM,48,-122,9,3,12
21607,SpokaneStBridge,06/19/2016 07:00:00 AM,48,-122,18,11,29
21608,SpokaneStBridge,06/19/2016 08:00:00 AM,48,-122,31,15,46
21609,SpokaneStBridge,06/19/2016 09:00:00 AM,48,-122,22,25,47
21610,SpokaneStBridge,06/19/2016 10:00:00 AM,48,-122,29,50,79
21611,SpokaneStBridge,06/19/2016 11:00:00 AM,48,-122,47,58,105
21612,SpokaneStBridge,06/19/2016 12:00:00 PM,48,-122,68,60,128
21613,SpokaneStBridge,06/19/2016 01:00:00 PM,48,-122,54,62,116
21614,SpokaneStBridge,06/19/2016 02:00:00 PM,48,-122,40,51,91
21615,SpokaneStBridge,06/19/2016 03:00:00 PM,48,-122,48,47,95
21616,SpokaneStBridge,06/19/2016 04:00:00 PM,48,-122,33,37,70
21617,SpokaneStBridge,06/19/2016 05:00:00 PM,48,-122,30,24,54
21618,SpokaneStBridge,06/19/2016 06:00:00 PM,48,-122,20,18,38
21619,SpokaneStBridge,06/19/2016 07:00:00 PM,48,-122,10,10,20
21620,SpokaneStBridge,06/19/2016 08:00:00 PM,48,-122,6,8,14
21621,SpokaneStBridge,06/19/2016 09:00:00 PM,48,-122,6,2,8
21622,SpokaneStBridge,06/19/2016 10:00:00 PM,48,-122,5,5,10
21623,SpokaneStBridge,06/19/2016 11:00:00 PM,48,-122,5,0,5
21624,SpokaneStBridge,06/20/2016 12:00:00 AM,48,-122,1,1,2
21625,SpokaneStBridge,06/20/2016 01:00:00 AM,48,-122,1,0,1
21626,SpokaneStBridge,06/20/2016 02:00:00 AM,48,-122,2,0,2
21627,SpokaneStBridge,06/20/2016 03:00:00 AM,48,-122,0,0,0
21628,SpokaneStBridge,06/20/2016 04:00:00 AM,48,-122,4,2,6
21629,SpokaneStBridge,06/20/2016 05:00:00 AM,48,-122,24,5,29
21630,SpokaneStBridge,06/20/2016 06:00:00 AM,48,-122,65,11,76
21631,SpokaneStBridge,06/20/2016 07:00:00 AM,48,-122,124,33,157
21632,SpokaneStBridge,06/20/2016 08:00:00 AM,48,-122,139,19,158
21633,SpokaneStBridge,06/20/2016 09:00:00 AM,48,-122,56,5,61
21634,SpokaneStBridge,06/20/2016 10:00:00 AM,48,-122,17,13,30
21635,SpokaneStBridge,06/20/2016 11:00:00 AM,48,-122,11,7,18
21636,SpokaneStBridge,06/20/2016 12:00:00 PM,48,-122,14,16,30
21637,SpokaneStBridge,06/20/2016 01:00:00 PM,48,-122,13,13,26
21638,SpokaneStBridge,06/20/2016 02:00:00 PM,48,-122,12,13,25
21639,SpokaneStBridge,06/20/2016 03:00:00 PM,48,-122,13,32,45
21640,SpokaneStBridge,06/20/2016 04:00:00 PM,48,-122,20,103,123
21641,SpokaneStBridge,06/20/2016 05:00:00 PM,48,-122,20,181,201
21642,SpokaneStBridge,06/20/2016 06:00:00 PM,48,-122,30,137,167
21643,SpokaneStBridge,06/20/2016 07:00:00 PM,48,-122,20,63,83
21644,SpokaneStBridge,06/20/2016 08:00:00 PM,48,-122,13,14,27
21645,SpokaneStBridge,06/20/2016 09:00:00 PM,48,-122,10,10,20
21646,SpokaneStBridge,06/20/2016 10:00:00 PM,48,-122,5,6,11
21647,SpokaneStBridge,06/20/2016 11:00:00 PM,48,-122,2,4,6
21648,SpokaneStBridge,06/21/2016 12:00:00 AM,48,-122,0,1,1
21649,SpokaneStBridge,06/21/2016 01:00:00 AM,48,-122,1,0,1
21650,SpokaneStBridge,06/21/2016 02:00:00 AM,48,-122,0,2,2
21651,SpokaneStBridge,06/21/2016 03:00:00 AM,48,-122,0,2,2
21652,SpokaneStBridge,06/21/2016 04:00:00 AM,48,-122,3,1,4
21653,SpokaneStBridge,06/21/2016 05:00:00 AM,48,-122,21,4,25
21654,SpokaneStBridge,06/21/2016 06:00:00 AM,48,-122,82,14,96
21655,SpokaneStBridge,06/21/2016 07:00:00 AM,48,-122,163,28,191
21656,SpokaneStBridge,06/21/2016 08:00:00 AM,48,-122,123,23,146
21657,SpokaneStBridge,06/21/2016 09:00:00 AM,48,-122,47,8,55
21658,SpokaneStBridge,06/21/2016 10:00:00 AM,48,-122,22,4,26
21659,SpokaneStBridge,06/21/2016 11:00:00 AM,48,-122,10,9,19
21660,SpokaneStBridge,06/21/2016 12:00:00 PM,48,-122,17,14,31
21661,SpokaneStBridge,06/21/2016 01:00:00 PM,48,-122,13,14,27
21662,SpokaneStBridge,06/21/2016 02:00:00 PM,48,-122,10,29,39
21663,SpokaneStBridge,06/21/2016 03:00:00 PM,48,-122,19,31,50
21664,SpokaneStBridge,06/21/2016 04:00:00 PM,48,-122,18,103,121
21665,SpokaneStBridge,06/21/2016 05:00:00 PM,48,-122,21,209,230
21666,SpokaneStBridge,06/21/2016 06:00:00 PM,48,-122,23,113,136
21667,SpokaneStBridge,06/21/2016 07:00:00 PM,48,-122,18,43,61
21668,SpokaneStBridge,06/21/2016 08:00:00 PM,48,-122,9,28,37
21669,SpokaneStBridge,06/21/2016 09:00:00 PM,48,-122,6,9,15
21670,SpokaneStBridge,06/21/2016 10:00:00 PM,48,-122,3,10,13
21671,SpokaneStBridge,06/21/2016 11:00:00 PM,48,-122,2,4,6
21672,SpokaneStBridge,06/22/2016 12:00:00 AM,48,-122,1,2,3
21673,SpokaneStBridge,06/22/2016 01:00:00 AM,48,-122,0,0,0
21674,SpokaneStBridge,06/22/2016 02:00:00 AM,48,-122,1,0,1
21675,SpokaneStBridge,06/22/2016 03:00:00 AM,48,-122,1,3,4
21676,SpokaneStBridge,06/22/2016 04:00:00 AM,48,-122,2,2,4
21677,SpokaneStBridge,06/22/2016 05:00:00 AM,48,-122,30,4,34
21678,SpokaneStBridge,06/22/2016 06:00:00 AM,48,-122,83,9,92
21679,SpokaneStBridge,06/22/2016 07:00:00 AM,48,-122,141,25,166
21680,SpokaneStBridge,06/22/2016 08:00:00 AM,48,-122,163,17,180
21681,SpokaneStBridge,06/22/2016 09:00:00 AM,48,-122,61,5,66
21682,SpokaneStBridge,06/22/2016 10:00:00 AM,48,-122,27,8,35
21683,SpokaneStBridge,06/22/2016 11:00:00 AM,48,-122,16,10,26
21684,SpokaneStBridge,06/22/2016 12:00:00 PM,48,-122,16,24,40
21685,SpokaneStBridge,06/22/2016 01:00:00 PM,48,-122,21,13,34
21686,SpokaneStBridge,06/22/2016 02:00:00 PM,48,-122,23,22,45
21687,SpokaneStBridge,06/22/2016 03:00:00 PM,48,-122,15,46,61
21688,SpokaneStBridge,06/22/2016 04:00:00 PM,48,-122,29,106,135
21689,SpokaneStBridge,06/22/2016 05:00:00 PM,48,-122,48,199,247
21690,SpokaneStBridge,06/22/2016 06:00:00 PM,48,-122,23,117,140
21691,SpokaneStBridge,06/22/2016 07:00:00 PM,48,-122,17,69,86
21692,SpokaneStBridge,06/22/2016 08:00:00 PM,48,-122,18,30,48
21693,SpokaneStBridge,06/22/2016 09:00:00 PM,48,-122,11,16,27
21694,SpokaneStBridge,06/22/2016 10:00:00 PM,48,-122,2,2,4
21695,SpokaneStBridge,06/22/2016 11:00:00 PM,48,-122,1,5,6
21696,SpokaneStBridge,06/23/2016 12:00:00 AM,48,-122,0,0,0
21697,SpokaneStBridge,06/23/2016 01:00:00 AM,48,-122,1,1,2
21698,SpokaneStBridge,06/23/2016 02:00:00 AM,48,-122,2,0,2
21699,SpokaneStBridge,06/23/2016 03:00:00 AM,48,-122,2,3,5
21700,SpokaneStBridge,06/23/2016 04:00:00 AM,48,-122,2,0,2
21701,SpokaneStBridge,06/23/2016 05:00:00 AM,48,-122,16,1,17
21702,SpokaneStBridge,06/23/2016 06:00:00 AM,48,-122,39,7,46
21703,SpokaneStBridge,06/23/2016 07:00:00 AM,48,-122,89,8,97
21704,SpokaneStBridge,06/23/2016 08:00:00 AM,48,-122,111,9,120
21705,SpokaneStBridge,06/23/2016 09:00:00 AM,48,-122,32,7,39
21706,SpokaneStBridge,06/23/2016 10:00:00 AM,48,-122,18,3,21
21707,SpokaneStBridge,06/23/2016 11:00:00 AM,48,-122,8,5,13
21708,SpokaneStBridge,06/23/2016 12:00:00 PM,48,-122,8,6,14
21709,SpokaneStBridge,06/23/2016 01:00:00 PM,48,-122,9,3,12
21710,SpokaneStBridge,06/23/2016 02:00:00 PM,48,-122,3,18,21
21711,SpokaneStBridge,06/23/2016 03:00:00 PM,48,-122,3,17,20
21712,SpokaneStBridge,06/23/2016 04:00:00 PM,48,-122,8,41,49
21713,SpokaneStBridge,06/23/2016 05:00:00 PM,48,-122,10,95,105
21714,SpokaneStBridge,06/23/2016 06:00:00 PM,48,-122,8,70,78
21715,SpokaneStBridge,06/23/2016 07:00:00 PM,48,-122,5,25,30
21716,SpokaneStBridge,06/23/2016 08:00:00 PM,48,-122,1,11,12
21717,SpokaneStBridge,06/23/2016 09:00:00 PM,48,-122,2,11,13
21718,SpokaneStBridge,06/23/2016 10:00:00 PM,48,-122,1,5,6
21719,SpokaneStBridge,06/23/2016 11:00:00 PM,48,-122,1,1,2
21720,SpokaneStBridge,06/24/2016 12:00:00 AM,48,-122,2,1,3
21721,SpokaneStBridge,06/24/2016 01:00:00 AM,48,-122,0,0,0
21722,SpokaneStBridge,06/24/2016 02:00:00 AM,48,-122,2,2,4
21723,SpokaneStBridge,06/24/2016 03:00:00 AM,48,-122,0,1,1
21724,SpokaneStBridge,06/24/2016 04:00:00 AM,48,-122,2,0,2
21725,SpokaneStBridge,06/24/2016 05:00:00 AM,48,-122,19,3,22
21726,SpokaneStBridge,06/24/2016 06:00:00 AM,48,-122,43,7,50
21727,SpokaneStBridge,06/24/2016 07:00:00 AM,48,-122,82,15,97
21728,SpokaneStBridge,06/24/2016 08:00:00 AM,48,-122,94,7,101
21729,SpokaneStBridge,06/24/2016 09:00:00 AM,48,-122,31,7,38
21730,SpokaneStBridge,06/24/2016 10:00:00 AM,48,-122,19,9,28
21731,SpokaneStBridge,06/24/2016 11:00:00 AM,48,-122,4,10,14
21732,SpokaneStBridge,06/24/2016 12:00:00 PM,48,-122,13,20,33
21733,SpokaneStBridge,06/24/2016 01:00:00 PM,48,-122,10,10,20
21734,SpokaneStBridge,06/24/2016 02:00:00 PM,48,-122,17,19,36
21735,SpokaneStBridge,06/24/2016 03:00:00 PM,48,-122,11,38,49
21736,SpokaneStBridge,06/24/2016 04:00:00 PM,48,-122,21,88,109
21737,SpokaneStBridge,06/24/2016 05:00:00 PM,48,-122,17,94,111
21738,SpokaneStBridge,06/24/2016 06:00:00 PM,48,-122,10,47,57
21739,SpokaneStBridge,06/24/2016 07:00:00 PM,48,-122,6,20,26
21740,SpokaneStBridge,06/24/2016 08:00:00 PM,48,-122,4,6,10
21741,SpokaneStBridge,06/24/2016 09:00:00 PM,48,-122,2,6,8
21742,SpokaneStBridge,06/24/2016 10:00:00 PM,48,-122,1,8,9
21743,SpokaneStBridge,06/24/2016 11:00:00 PM,48,-122,3,3,6
21744,SpokaneStBridge,06/25/2016 12:00:00 AM,48,-122,0,7,7
21745,SpokaneStBridge,06/25/2016 01:00:00 AM,48,-122,0,1,1
21746,SpokaneStBridge,06/25/2016 02:00:00 AM,48,-122,2,4,6
21747,SpokaneStBridge,06/25/2016 03:00:00 AM,48,-122,0,1,1
21748,SpokaneStBridge,06/25/2016 04:00:00 AM,48,-122,1,1,2
21749,SpokaneStBridge,06/25/2016 05:00:00 AM,48,-122,6,0,6
21750,SpokaneStBridge,06/25/2016 06:00:00 AM,48,-122,13,5,18
21751,SpokaneStBridge,06/25/2016 07:00:00 AM,48,-122,20,6,26
21752,SpokaneStBridge,06/25/2016 08:00:00 AM,48,-122,15,28,43
21753,SpokaneStBridge,06/25/2016 09:00:00 AM,48,-122,20,14,34
21754,SpokaneStBridge,06/25/2016 10:00:00 AM,48,-122,23,17,40
21755,SpokaneStBridge,06/25/2016 11:00:00 AM,48,-122,21,31,52
21756,SpokaneStBridge,06/25/2016 12:00:00 PM,48,-122,41,39,80
21757,SpokaneStBridge,06/25/2016 01:00:00 PM,48,-122,52,25,77
21758,SpokaneStBridge,06/25/2016 02:00:00 PM,48,-122,31,48,79
21759,SpokaneStBridge,06/25/2016 03:00:00 PM,48,-122,38,32,70
21760,SpokaneStBridge,06/25/2016 04:00:00 PM,48,-122,38,48,86
21761,SpokaneStBridge,06/25/2016 05:00:00 PM,48,-122,20,31,51
21762,SpokaneStBridge,06/25/2016 06:00:00 PM,48,-122,23,24,47
21763,SpokaneStBridge,06/25/2016 07:00:00 PM,48,-122,14,18,32
21764,SpokaneStBridge,06/25/2016 08:00:00 PM,48,-122,9,18,27
21765,SpokaneStBridge,06/25/2016 09:00:00 PM,48,-122,3,7,10
21766,SpokaneStBridge,06/25/2016 10:00:00 PM,48,-122,2,9,11
21767,SpokaneStBridge,06/25/2016 11:00:00 PM,48,-122,2,4,6
21768,SpokaneStBridge,06/26/2016 12:00:00 AM,48,-122,1,5,6
21769,SpokaneStBridge,06/26/2016 01:00:00 AM,48,-122,3,0,3
21770,SpokaneStBridge,06/26/2016 02:00:00 AM,48,-122,1,2,3
21771,SpokaneStBridge,06/26/2016 03:00:00 AM,48,-122,1,0,1
21772,SpokaneStBridge,06/26/2016 04:00:00 AM,48,-122,0,3,3
21773,SpokaneStBridge,06/26/2016 05:00:00 AM,48,-122,4,0,4
21774,SpokaneStBridge,06/26/2016 06:00:00 AM,48,-122,11,4,15
21775,SpokaneStBridge,06/26/2016 07:00:00 AM,48,-122,12,5,17
21776,SpokaneStBridge,06/26/2016 08:00:00 AM,48,-122,16,22,38
21777,SpokaneStBridge,06/26/2016 09:00:00 AM,48,-122,28,25,53
21778,SpokaneStBridge,06/26/2016 10:00:00 AM,48,-122,40,40,80
21779,SpokaneStBridge,06/26/2016 11:00:00 AM,48,-122,42,37,79
21780,SpokaneStBridge,06/26/2016 12:00:00 PM,48,-122,44,35,79
21781,SpokaneStBridge,06/26/2016 01:00:00 PM,48,-122,37,52,89
21782,SpokaneStBridge,06/26/2016 02:00:00 PM,48,-122,43,62,105
21783,SpokaneStBridge,06/26/2016 03:00:00 PM,48,-122,40,29,69
21784,SpokaneStBridge,06/26/2016 04:00:00 PM,48,-122,36,31,67
21785,SpokaneStBridge,06/26/2016 05:00:00 PM,48,-122,34,33,67
21786,SpokaneStBridge,06/26/2016 06:00:00 PM,48,-122,14,20,34
21787,SpokaneStBridge,06/26/2016 07:00:00 PM,48,-122,8,18,26
21788,SpokaneStBridge,06/26/2016 08:00:00 PM,48,-122,6,12,18
21789,SpokaneStBridge,06/26/2016 09:00:00 PM,48,-122,4,4,8
21790,SpokaneStBridge,06/26/2016 10:00:00 PM,48,-122,6,4,10
21791,SpokaneStBridge,06/26/2016 11:00:00 PM,48,-122,1,1,2
21792,SpokaneStBridge,06/27/2016 12:00:00 AM,48,-122,0,2,2
21793,SpokaneStBridge,06/27/2016 01:00:00 AM,48,-122,1,0,1
21794,SpokaneStBridge,06/27/2016 02:00:00 AM,48,-122,2,1,3
21795,SpokaneStBridge,06/27/2016 03:00:00 AM,48,-122,0,1,1
21796,SpokaneStBridge,06/27/2016 04:00:00 AM,48,-122,3,2,5
21797,SpokaneStBridge,06/27/2016 05:00:00 AM,48,-122,38,4,42
21798,SpokaneStBridge,06/27/2016 06:00:00 AM,48,-122,90,17,107
21799,SpokaneStBridge,06/27/2016 07:00:00 AM,48,-122,159,26,185
21800,SpokaneStBridge,06/27/2016 08:00:00 AM,48,-122,165,11,176
21801,SpokaneStBridge,06/27/2016 09:00:00 AM,48,-122,79,8,87
21802,SpokaneStBridge,06/27/2016 10:00:00 AM,48,-122,26,9,35
21803,SpokaneStBridge,06/27/2016 11:00:00 AM,48,-122,19,17,36
21804,SpokaneStBridge,06/27/2016 12:00:00 PM,48,-122,9,14,23
21805,SpokaneStBridge,06/27/2016 01:00:00 PM,48,-122,13,21,34
21806,SpokaneStBridge,06/27/2016 02:00:00 PM,48,-122,15,24,39
21807,SpokaneStBridge,06/27/2016 03:00:00 PM,48,-122,24,49,73
21808,SpokaneStBridge,06/27/2016 04:00:00 PM,48,-122,19,114,133
21809,SpokaneStBridge,06/27/2016 05:00:00 PM,48,-122,35,216,251
21810,SpokaneStBridge,06/27/2016 06:00:00 PM,48,-122,18,133,151
21811,SpokaneStBridge,06/27/2016 07:00:00 PM,48,-122,22,44,66
21812,SpokaneStBridge,06/27/2016 08:00:00 PM,48,-122,12,32,44
21813,SpokaneStBridge,06/27/2016 09:00:00 PM,48,-122,15,9,24
21814,SpokaneStBridge,06/27/2016 10:00:00 PM,48,-122,4,8,12
21815,SpokaneStBridge,06/27/2016 11:00:00 PM,48,-122,0,4,4
21816,SpokaneStBridge,06/28/2016 12:00:00 AM,48,-122,0,4,4
21817,SpokaneStBridge,06/28/2016 01:00:00 AM,48,-122,0,1,1
21818,SpokaneStBridge,06/28/2016 02:00:00 AM,48,-122,1,1,2
21819,SpokaneStBridge,06/28/2016 03:00:00 AM,48,-122,1,2,3
21820,SpokaneStBridge,06/28/2016 04:00:00 AM,48,-122,7,1,8
21821,SpokaneStBridge,06/28/2016 05:00:00 AM,48,-122,32,6,38
21822,SpokaneStBridge,06/28/2016 06:00:00 AM,48,-122,80,18,98
21823,SpokaneStBridge,06/28/2016 07:00:00 AM,48,-122,176,19,195
21824,SpokaneStBridge,06/28/2016 08:00:00 AM,48,-122,137,29,166
21825,SpokaneStBridge,06/28/2016 09:00:00 AM,48,-122,59,19,78
21826,SpokaneStBridge,06/28/2016 10:00:00 AM,48,-122,20,6,26
21827,SpokaneStBridge,06/28/2016 11:00:00 AM,48,-122,11,10,21
21828,SpokaneStBridge,06/28/2016 12:00:00 PM,48,-122,19,10,29
21829,SpokaneStBridge,06/28/2016 01:00:00 PM,48,-122,11,10,21
21830,SpokaneStBridge,06/28/2016 02:00:00 PM,48,-122,15,23,38
21831,SpokaneStBridge,06/28/2016 03:00:00 PM,48,-122,31,55,86
21832,SpokaneStBridge,06/28/2016 04:00:00 PM,48,-122,30,112,142
21833,SpokaneStBridge,06/28/2016 05:00:00 PM,48,-122,36,193,229
21834,SpokaneStBridge,06/28/2016 06:00:00 PM,48,-122,24,108,132
21835,SpokaneStBridge,06/28/2016 07:00:00 PM,48,-122,16,57,73
21836,SpokaneStBridge,06/28/2016 08:00:00 PM,48,-122,16,33,49
21837,SpokaneStBridge,06/28/2016 09:00:00 PM,48,-122,7,26,33
21838,SpokaneStBridge,06/28/2016 10:00:00 PM,48,-122,4,12,16
21839,SpokaneStBridge,06/28/2016 11:00:00 PM,48,-122,0,6,6
21840,SpokaneStBridge,06/29/2016 12:00:00 AM,48,-122,1,1,2
21841,SpokaneStBridge,06/29/2016 01:00:00 AM,48,-122,0,2,2
21842,SpokaneStBridge,06/29/2016 02:00:00 AM,48,-122,3,2,5
21843,SpokaneStBridge,06/29/2016 03:00:00 AM,48,-122,2,1,3
21844,SpokaneStBridge,06/29/2016 04:00:00 AM,48,-122,2,1,3
21845,SpokaneStBridge,06/29/2016 05:00:00 AM,48,-122,27,7,34
21846,SpokaneStBridge,06/29/2016 06:00:00 AM,48,-122,74,14,88
21847,SpokaneStBridge,06/29/2016 07:00:00 AM,48,-122,164,16,180
21848,SpokaneStBridge,06/29/2016 08:00:00 AM,48,-122,148,13,161
21849,SpokaneStBridge,06/29/2016 09:00:00 AM,48,-122,60,9,69
21850,SpokaneStBridge,06/29/2016 10:00:00 AM,48,-122,23,8,31
21851,SpokaneStBridge,06/29/2016 11:00:00 AM,48,-122,20,10,30
21852,SpokaneStBridge,06/29/2016 12:00:00 PM,48,-122,7,13,20
21853,SpokaneStBridge,06/29/2016 01:00:00 PM,48,-122,22,12,34
21854,SpokaneStBridge,06/29/2016 02:00:00 PM,48,-122,13,25,38
21855,SpokaneStBridge,06/29/2016 03:00:00 PM,48,-122,24,46,70
21856,SpokaneStBridge,06/29/2016 04:00:00 PM,48,-122,23,103,126
21857,SpokaneStBridge,06/29/2016 05:00:00 PM,48,-122,22,179,201
21858,SpokaneStBridge,06/29/2016 06:00:00 PM,48,-122,26,134,160
21859,SpokaneStBridge,06/29/2016 07:00:00 PM,48,-122,16,48,64
21860,SpokaneStBridge,06/29/2016 08:00:00 PM,48,-122,16,29,45
21861,SpokaneStBridge,06/29/2016 09:00:00 PM,48,-122,11,17,28
21862,SpokaneStBridge,06/29/2016 10:00:00 PM,48,-122,2,14,16
21863,SpokaneStBridge,06/29/2016 11:00:00 PM,48,-122,1,2,3
21864,SpokaneStBridge,06/30/2016 12:00:00 AM,48,-122,1,3,4
21865,SpokaneStBridge,06/30/2016 01:00:00 AM,48,-122,1,2,3
21866,SpokaneStBridge,06/30/2016 02:00:00 AM,48,-122,2,1,3
21867,SpokaneStBridge,06/30/2016 03:00:00 AM,48,-122,2,2,4
21868,SpokaneStBridge,06/30/2016 04:00:00 AM,48,-122,3,0,3
21869,SpokaneStBridge,06/30/2016 05:00:00 AM,48,-122,30,6,36
21870,SpokaneStBridge,06/30/2016 06:00:00 AM,48,-122,71,16,87
21871,SpokaneStBridge,06/30/2016 07:00:00 AM,48,-122,140,19,159
21872,SpokaneStBridge,06/30/2016 08:00:00 AM,48,-122,136,24,160
21873,SpokaneStBridge,06/30/2016 09:00:00 AM,48,-122,52,14,66
21874,SpokaneStBridge,06/30/2016 10:00:00 AM,48,-122,22,7,29
21875,SpokaneStBridge,06/30/2016 11:00:00 AM,48,-122,11,13,24
21876,SpokaneStBridge,06/30/2016 12:00:00 PM,48,-122,23,12,35
21877,SpokaneStBridge,06/30/2016 01:00:00 PM,48,-122,18,19,37
21878,SpokaneStBridge,06/30/2016 02:00:00 PM,48,-122,11,26,37
21879,SpokaneStBridge,06/30/2016 03:00:00 PM,48,-122,30,35,65
21880,SpokaneStBridge,06/30/2016 04:00:00 PM,48,-122,27,108,135
21881,SpokaneStBridge,06/30/2016 05:00:00 PM,48,-122,28,161,189
21882,SpokaneStBridge,06/30/2016 06:00:00 PM,48,-122,18,116,134
21883,SpokaneStBridge,06/30/2016 07:00:00 PM,48,-122,18,70,88
21884,SpokaneStBridge,06/30/2016 08:00:00 PM,48,-122,5,24,29
21885,SpokaneStBridge,06/30/2016 09:00:00 PM,48,-122,8,13,21
21886,SpokaneStBridge,06/30/2016 10:00:00 PM,48,-122,9,12,21
21887,SpokaneStBridge,06/30/2016 11:00:00 PM,48,-122,6,4,10
21888,SpokaneStBridge,07/01/2016 12:00:00 AM,48,-122,1,6,7
21889,SpokaneStBridge,07/01/2016 01:00:00 AM,48,-122,0,3,3
21890,SpokaneStBridge,07/01/2016 02:00:00 AM,48,-122,5,1,6
21891,SpokaneStBridge,07/01/2016 03:00:00 AM,48,-122,0,1,1
21892,SpokaneStBridge,07/01/2016 04:00:00 AM,48,-122,4,0,4
21893,SpokaneStBridge,07/01/2016 05:00:00 AM,48,-122,26,3,29
21894,SpokaneStBridge,07/01/2016 06:00:00 AM,48,-122,58,11,69
21895,SpokaneStBridge,07/01/2016 07:00:00 AM,48,-122,117,13,130
21896,SpokaneStBridge,07/01/2016 08:00:00 AM,48,-122,112,11,123
21897,SpokaneStBridge,07/01/2016 09:00:00 AM,48,-122,53,11,64
21898,SpokaneStBridge,07/01/2016 10:00:00 AM,48,-122,25,11,36
21899,SpokaneStBridge,07/01/2016 11:00:00 AM,48,-122,8,17,25
21900,SpokaneStBridge,07/01/2016 12:00:00 PM,48,-122,18,30,48
21901,SpokaneStBridge,07/01/2016 01:00:00 PM,48,-122,26,22,48
21902,SpokaneStBridge,07/01/2016 02:00:00 PM,48,-122,22,43,65
21903,SpokaneStBridge,07/01/2016 03:00:00 PM,48,-122,16,61,77
21904,SpokaneStBridge,07/01/2016 04:00:00 PM,48,-122,29,97,126
21905,SpokaneStBridge,07/01/2016 05:00:00 PM,48,-122,22,110,132
21906,SpokaneStBridge,07/01/2016 06:00:00 PM,48,-122,16,62,78
21907,SpokaneStBridge,07/01/2016 07:00:00 PM,48,-122,10,34,44
21908,SpokaneStBridge,07/01/2016 08:00:00 PM,48,-122,5,20,25
21909,SpokaneStBridge,07/01/2016 09:00:00 PM,48,-122,5,6,11
21910,SpokaneStBridge,07/01/2016 10:00:00 PM,48,-122,25,12,37
21911,SpokaneStBridge,07/01/2016 11:00:00 PM,48,-122,3,5,8
21912,SpokaneStBridge,07/02/2016 12:00:00 AM,48,-122,2,5,7
21913,SpokaneStBridge,07/02/2016 01:00:00 AM,48,-122,2,1,3
21914,SpokaneStBridge,07/02/2016 02:00:00 AM,48,-122,2,2,4
21915,SpokaneStBridge,07/02/2016 03:00:00 AM,48,-122,0,0,0
21916,SpokaneStBridge,07/02/2016 04:00:00 AM,48,-122,2,1,3
21917,SpokaneStBridge,07/02/2016 05:00:00 AM,48,-122,6,3,9
21918,SpokaneStBridge,07/02/2016 06:00:00 AM,48,-122,9,4,13
21919,SpokaneStBridge,07/02/2016 07:00:00 AM,48,-122,16,6,22
21920,SpokaneStBridge,07/02/2016 08:00:00 AM,48,-122,13,23,36
21921,SpokaneStBridge,07/02/2016 09:00:00 AM,48,-122,18,22,40
21922,SpokaneStBridge,07/02/2016 10:00:00 AM,48,-122,26,34,60
21923,SpokaneStBridge,07/02/2016 11:00:00 AM,48,-122,33,14,47
21924,SpokaneStBridge,07/02/2016 12:00:00 PM,48,-122,37,52,89
21925,SpokaneStBridge,07/02/2016 01:00:00 PM,48,-122,26,29,55
21926,SpokaneStBridge,07/02/2016 02:00:00 PM,48,-122,38,25,63
21927,SpokaneStBridge,07/02/2016 03:00:00 PM,48,-122,25,33,58
21928,SpokaneStBridge,07/02/2016 04:00:00 PM,48,-122,38,43,81
21929,SpokaneStBridge,07/02/2016 05:00:00 PM,48,-122,24,31,55
21930,SpokaneStBridge,07/02/2016 06:00:00 PM,48,-122,16,18,34
21931,SpokaneStBridge,07/02/2016 07:00:00 PM,48,-122,14,17,31
21932,SpokaneStBridge,07/02/2016 08:00:00 PM,48,-122,14,21,35
21933,SpokaneStBridge,07/02/2016 09:00:00 PM,48,-122,5,8,13
21934,SpokaneStBridge,07/02/2016 10:00:00 PM,48,-122,8,8,16
21935,SpokaneStBridge,07/02/2016 11:00:00 PM,48,-122,1,2,3
21936,SpokaneStBridge,07/03/2016 12:00:00 AM,48,-122,4,2,6
21937,SpokaneStBridge,07/03/2016 01:00:00 AM,48,-122,0,0,0
21938,SpokaneStBridge,07/03/2016 02:00:00 AM,48,-122,1,3,4
21939,SpokaneStBridge,07/03/2016 03:00:00 AM,48,-122,2,1,3
21940,SpokaneStBridge,07/03/2016 04:00:00 AM,48,-122,2,3,5
21941,SpokaneStBridge,07/03/2016 05:00:00 AM,48,-122,3,1,4
21942,SpokaneStBridge,07/03/2016 06:00:00 AM,48,-122,6,1,7
21943,SpokaneStBridge,07/03/2016 07:00:00 AM,48,-122,11,3,14
21944,SpokaneStBridge,07/03/2016 08:00:00 AM,48,-122,11,16,27
21945,SpokaneStBridge,07/03/2016 09:00:00 AM,48,-122,8,12,20
21946,SpokaneStBridge,07/03/2016 10:00:00 AM,48,-122,23,12,35
21947,SpokaneStBridge,07/03/2016 11:00:00 AM,48,-122,33,24,57
21948,SpokaneStBridge,07/03/2016 12:00:00 PM,48,-122,24,19,43
21949,SpokaneStBridge,07/03/2016 01:00:00 PM,48,-122,30,25,55
21950,SpokaneStBridge,07/03/2016 02:00:00 PM,48,-122,32,24,56
21951,SpokaneStBridge,07/03/2016 03:00:00 PM,48,-122,22,49,71
21952,SpokaneStBridge,07/03/2016 04:00:00 PM,48,-122,51,34,85
21953,SpokaneStBridge,07/03/2016 05:00:00 PM,48,-122,19,28,47
21954,SpokaneStBridge,07/03/2016 06:00:00 PM,48,-122,12,30,42
21955,SpokaneStBridge,07/03/2016 07:00:00 PM,48,-122,9,7,16
21956,SpokaneStBridge,07/03/2016 08:00:00 PM,48,-122,9,8,17
21957,SpokaneStBridge,07/03/2016 09:00:00 PM,48,-122,5,4,9
21958,SpokaneStBridge,07/03/2016 10:00:00 PM,48,-122,1,4,5
21959,SpokaneStBridge,07/03/2016 11:00:00 PM,48,-122,1,2,3
21960,SpokaneStBridge,07/04/2016 12:00:00 AM,48,-122,0,0,0
21961,SpokaneStBridge,07/04/2016 01:00:00 AM,48,-122,0,0,0
21962,SpokaneStBridge,07/04/2016 02:00:00 AM,48,-122,0,3,3
21963,SpokaneStBridge,07/04/2016 03:00:00 AM,48,-122,0,1,1
21964,SpokaneStBridge,07/04/2016 04:00:00 AM,48,-122,0,1,1
21965,SpokaneStBridge,07/04/2016 05:00:00 AM,48,-122,6,1,7
21966,SpokaneStBridge,07/04/2016 06:00:00 AM,48,-122,4,2,6
21967,SpokaneStBridge,07/04/2016 07:00:00 AM,48,-122,14,7,21
21968,SpokaneStBridge,07/04/2016 08:00:00 AM,48,-122,9,20,29
21969,SpokaneStBridge,07/04/2016 09:00:00 AM,48,-122,15,22,37
21970,SpokaneStBridge,07/04/2016 10:00:00 AM,48,-122,21,36,57
21971,SpokaneStBridge,07/04/2016 11:00:00 AM,48,-122,34,29,63
21972,SpokaneStBridge,07/04/2016 12:00:00 PM,48,-122,32,20,52
21973,SpokaneStBridge,07/04/2016 01:00:00 PM,48,-122,31,34,65
21974,SpokaneStBridge,07/04/2016 02:00:00 PM,48,-122,39,33,72
21975,SpokaneStBridge,07/04/2016 03:00:00 PM,48,-122,35,27,62
21976,SpokaneStBridge,07/04/2016 04:00:00 PM,48,-122,13,17,30
21977,SpokaneStBridge,07/04/2016 05:00:00 PM,48,-122,14,18,32
21978,SpokaneStBridge,07/04/2016 06:00:00 PM,48,-122,15,10,25
21979,SpokaneStBridge,07/04/2016 07:00:00 PM,48,-122,3,7,10
21980,SpokaneStBridge,07/04/2016 08:00:00 PM,48,-122,10,5,15
21981,SpokaneStBridge,07/04/2016 09:00:00 PM,48,-122,4,8,12
21982,SpokaneStBridge,07/04/2016 10:00:00 PM,48,-122,2,2,4
21983,SpokaneStBridge,07/04/2016 11:00:00 PM,48,-122,7,6,13
21984,SpokaneStBridge,07/05/2016 12:00:00 AM,48,-122,1,1,2
21985,SpokaneStBridge,07/05/2016 01:00:00 AM,48,-122,0,5,5
21986,SpokaneStBridge,07/05/2016 02:00:00 AM,48,-122,1,1,2
21987,SpokaneStBridge,07/05/2016 03:00:00 AM,48,-122,4,1,5
21988,SpokaneStBridge,07/05/2016 04:00:00 AM,48,-122,4,1,5
21989,SpokaneStBridge,07/05/2016 05:00:00 AM,48,-122,13,1,14
21990,SpokaneStBridge,07/05/2016 06:00:00 AM,48,-122,48,8,56
21991,SpokaneStBridge,07/05/2016 07:00:00 AM,48,-122,99,14,113
21992,SpokaneStBridge,07/05/2016 08:00:00 AM,48,-122,111,11,122
21993,SpokaneStBridge,07/05/2016 09:00:00 AM,48,-122,46,11,57
21994,SpokaneStBridge,07/05/2016 10:00:00 AM,48,-122,18,7,25
21995,SpokaneStBridge,07/05/2016 11:00:00 AM,48,-122,14,17,31
21996,SpokaneStBridge,07/05/2016 12:00:00 PM,48,-122,18,6,24
21997,SpokaneStBridge,07/05/2016 01:00:00 PM,48,-122,17,10,27
21998,SpokaneStBridge,07/05/2016 02:00:00 PM,48,-122,11,20,31
21999,SpokaneStBridge,07/05/2016 03:00:00 PM,48,-122,18,30,48
22000,SpokaneStBridge,07/05/2016 04:00:00 PM,48,-122,21,64,85
22001,SpokaneStBridge,07/05/2016 05:00:00 PM,48,-122,29,136,165
22002,SpokaneStBridge,07/05/2016 06:00:00 PM,48,-122,19,81,100
22003,SpokaneStBridge,07/05/2016 07:00:00 PM,48,-122,16,31,47
22004,SpokaneStBridge,07/05/2016 08:00:00 PM,48,-122,3,14,17
22005,SpokaneStBridge,07/05/2016 09:00:00 PM,48,-122,1,17,18
22006,SpokaneStBridge,07/05/2016 10:00:00 PM,48,-122,3,8,11
22007,SpokaneStBridge,07/05/2016 11:00:00 PM,48,-122,3,7,10
22008,SpokaneStBridge,07/06/2016 12:00:00 AM,48,-122,0,3,3
22009,SpokaneStBridge,07/06/2016 01:00:00 AM,48,-122,0,0,0
22010,SpokaneStBridge,07/06/2016 02:00:00 AM,48,-122,1,0,1
22011,SpokaneStBridge,07/06/2016 03:00:00 AM,48,-122,2,0,2
22012,SpokaneStBridge,07/06/2016 04:00:00 AM,48,-122,3,1,4
22013,SpokaneStBridge,07/06/2016 05:00:00 AM,48,-122,24,4,28
22014,SpokaneStBridge,07/06/2016 06:00:00 AM,48,-122,78,9,87
22015,SpokaneStBridge,07/06/2016 07:00:00 AM,48,-122,164,16,180
22016,SpokaneStBridge,07/06/2016 08:00:00 AM,48,-122,144,22,166
22017,SpokaneStBridge,07/06/2016 09:00:00 AM,48,-122,75,11,86
22018,SpokaneStBridge,07/06/2016 10:00:00 AM,48,-122,30,13,43
22019,SpokaneStBridge,07/06/2016 11:00:00 AM,48,-122,9,14,23
22020,SpokaneStBridge,07/06/2016 12:00:00 PM,48,-122,24,17,41
22021,SpokaneStBridge,07/06/2016 01:00:00 PM,48,-122,18,25,43
22022,SpokaneStBridge,07/06/2016 02:00:00 PM,48,-122,21,20,41
22023,SpokaneStBridge,07/06/2016 03:00:00 PM,48,-122,24,43,67
22024,SpokaneStBridge,07/06/2016 04:00:00 PM,48,-122,37,96,133
22025,SpokaneStBridge,07/06/2016 05:00:00 PM,48,-122,44,217,261
22026,SpokaneStBridge,07/06/2016 06:00:00 PM,48,-122,34,143,177
22027,SpokaneStBridge,07/06/2016 07:00:00 PM,48,-122,18,61,79
22028,SpokaneStBridge,07/06/2016 08:00:00 PM,48,-122,14,29,43
22029,SpokaneStBridge,07/06/2016 09:00:00 PM,48,-122,20,19,39
22030,SpokaneStBridge,07/06/2016 10:00:00 PM,48,-122,0,7,7
22031,SpokaneStBridge,07/06/2016 11:00:00 PM,48,-122,0,7,7
22032,SpokaneStBridge,07/07/2016 12:00:00 AM,48,-122,2,2,4
22033,SpokaneStBridge,07/07/2016 01:00:00 AM,48,-122,1,2,3
22034,SpokaneStBridge,07/07/2016 02:00:00 AM,48,-122,2,0,2
22035,SpokaneStBridge,07/07/2016 03:00:00 AM,48,-122,2,1,3
22036,SpokaneStBridge,07/07/2016 04:00:00 AM,48,-122,5,2,7
22037,SpokaneStBridge,07/07/2016 05:00:00 AM,48,-122,13,3,16
22038,SpokaneStBridge,07/07/2016 06:00:00 AM,48,-122,59,10,69
22039,SpokaneStBridge,07/07/2016 07:00:00 AM,48,-122,125,14,139
22040,SpokaneStBridge,07/07/2016 08:00:00 AM,48,-122,118,15,133
22041,SpokaneStBridge,07/07/2016 09:00:00 AM,48,-122,48,7,55
22042,SpokaneStBridge,07/07/2016 10:00:00 AM,48,-122,15,10,25
22043,SpokaneStBridge,07/07/2016 11:00:00 AM,48,-122,13,3,16
22044,SpokaneStBridge,07/07/2016 12:00:00 PM,48,-122,11,9,20
22045,SpokaneStBridge,07/07/2016 01:00:00 PM,48,-122,7,8,15
22046,SpokaneStBridge,07/07/2016 02:00:00 PM,48,-122,9,18,27
22047,SpokaneStBridge,07/07/2016 03:00:00 PM,48,-122,11,26,37
22048,SpokaneStBridge,07/07/2016 04:00:00 PM,48,-122,6,70,76
22049,SpokaneStBridge,07/07/2016 05:00:00 PM,48,-122,16,124,140
22050,SpokaneStBridge,07/07/2016 06:00:00 PM,48,-122,5,76,81
22051,SpokaneStBridge,07/07/2016 07:00:00 PM,48,-122,3,27,30
22052,SpokaneStBridge,07/07/2016 08:00:00 PM,48,-122,7,14,21
22053,SpokaneStBridge,07/07/2016 09:00:00 PM,48,-122,3,9,12
22054,SpokaneStBridge,07/07/2016 10:00:00 PM,48,-122,1,4,5
22055,SpokaneStBridge,07/07/2016 11:00:00 PM,48,-122,2,6,8
22056,SpokaneStBridge,07/08/2016 12:00:00 AM,48,-122,1,2,3
22057,SpokaneStBridge,07/08/2016 01:00:00 AM,48,-122,0,1,1
22058,SpokaneStBridge,07/08/2016 02:00:00 AM,48,-122,1,1,2
22059,SpokaneStBridge,07/08/2016 03:00:00 AM,48,-122,0,0,0
22060,SpokaneStBridge,07/08/2016 04:00:00 AM,48,-122,1,0,1
22061,SpokaneStBridge,07/08/2016 05:00:00 AM,48,-122,8,2,10
22062,SpokaneStBridge,07/08/2016 06:00:00 AM,48,-122,42,8,50
22063,SpokaneStBridge,07/08/2016 07:00:00 AM,48,-122,82,9,91
22064,SpokaneStBridge,07/08/2016 08:00:00 AM,48,-122,72,13,85
22065,SpokaneStBridge,07/08/2016 09:00:00 AM,48,-122,39,4,43
22066,SpokaneStBridge,07/08/2016 10:00:00 AM,48,-122,16,6,22
22067,SpokaneStBridge,07/08/2016 11:00:00 AM,48,-122,8,4,12
22068,SpokaneStBridge,07/08/2016 12:00:00 PM,48,-122,10,10,20
22069,SpokaneStBridge,07/08/2016 01:00:00 PM,48,-122,16,10,26
22070,SpokaneStBridge,07/08/2016 02:00:00 PM,48,-122,10,15,25
22071,SpokaneStBridge,07/08/2016 03:00:00 PM,48,-122,15,38,53
22072,SpokaneStBridge,07/08/2016 04:00:00 PM,48,-122,16,74,90
22073,SpokaneStBridge,07/08/2016 05:00:00 PM,48,-122,18,104,122
22074,SpokaneStBridge,07/08/2016 06:00:00 PM,48,-122,13,86,99
22075,SpokaneStBridge,07/08/2016 07:00:00 PM,48,-122,9,26,35
22076,SpokaneStBridge,07/08/2016 08:00:00 PM,48,-122,11,9,20
22077,SpokaneStBridge,07/08/2016 09:00:00 PM,48,-122,11,9,20
22078,SpokaneStBridge,07/08/2016 10:00:00 PM,48,-122,10,11,21
22079,SpokaneStBridge,07/08/2016 11:00:00 PM,48,-122,4,8,12
22080,SpokaneStBridge,07/09/2016 12:00:00 AM,48,-122,3,3,6
22081,SpokaneStBridge,07/09/2016 01:00:00 AM,48,-122,3,0,3
22082,SpokaneStBridge,07/09/2016 02:00:00 AM,48,-122,1,1,2
22083,SpokaneStBridge,07/09/2016 03:00:00 AM,48,-122,0,2,2
22084,SpokaneStBridge,07/09/2016 04:00:00 AM,48,-122,1,1,2
22085,SpokaneStBridge,07/09/2016 05:00:00 AM,48,-122,4,0,4
22086,SpokaneStBridge,07/09/2016 06:00:00 AM,48,-122,9,5,14
22087,SpokaneStBridge,07/09/2016 07:00:00 AM,48,-122,15,9,24
22088,SpokaneStBridge,07/09/2016 08:00:00 AM,48,-122,26,22,48
22089,SpokaneStBridge,07/09/2016 09:00:00 AM,48,-122,44,62,106
22090,SpokaneStBridge,07/09/2016 10:00:00 AM,48,-122,64,22,86
22091,SpokaneStBridge,07/09/2016 11:00:00 AM,48,-122,81,31,112
22092,SpokaneStBridge,07/09/2016 12:00:00 PM,48,-122,17,40,57
22093,SpokaneStBridge,07/09/2016 01:00:00 PM,48,-122,25,25,50
22094,SpokaneStBridge,07/09/2016 02:00:00 PM,48,-122,20,49,69
22095,SpokaneStBridge,07/09/2016 03:00:00 PM,48,-122,30,39,69
22096,SpokaneStBridge,07/09/2016 04:00:00 PM,48,-122,28,24,52
22097,SpokaneStBridge,07/09/2016 05:00:00 PM,48,-122,17,17,34
22098,SpokaneStBridge,07/09/2016 06:00:00 PM,48,-122,14,17,31
22099,SpokaneStBridge,07/09/2016 07:00:00 PM,48,-122,7,10,17
22100,SpokaneStBridge,07/09/2016 08:00:00 PM,48,-122,3,7,10
22101,SpokaneStBridge,07/09/2016 09:00:00 PM,48,-122,2,4,6
22102,SpokaneStBridge,07/09/2016 10:00:00 PM,48,-122,4,2,6
22103,SpokaneStBridge,07/09/2016 11:00:00 PM,48,-122,1,5,6
22104,SpokaneStBridge,07/10/2016 12:00:00 AM,48,-122,0,4,4
22105,SpokaneStBridge,07/10/2016 01:00:00 AM,48,-122,0,0,0
22106,SpokaneStBridge,07/10/2016 02:00:00 AM,48,-122,0,1,1
22107,SpokaneStBridge,07/10/2016 03:00:00 AM,48,-122,1,0,1
22108,SpokaneStBridge,07/10/2016 04:00:00 AM,48,-122,1,1,2
22109,SpokaneStBridge,07/10/2016 05:00:00 AM,48,-122,2,0,2
22110,SpokaneStBridge,07/10/2016 06:00:00 AM,48,-122,7,1,8
22111,SpokaneStBridge,07/10/2016 07:00:00 AM,48,-122,8,9,17
22112,SpokaneStBridge,07/10/2016 08:00:00 AM,48,-122,18,15,33
22113,SpokaneStBridge,07/10/2016 09:00:00 AM,48,-122,22,19,41
22114,SpokaneStBridge,07/10/2016 10:00:00 AM,48,-122,23,34,57
22115,SpokaneStBridge,07/10/2016 11:00:00 AM,48,-122,29,28,57
22116,SpokaneStBridge,07/10/2016 12:00:00 PM,48,-122,39,40,79
22117,SpokaneStBridge,07/10/2016 01:00:00 PM,48,-122,35,32,67
22118,SpokaneStBridge,07/10/2016 02:00:00 PM,48,-122,49,39,88
22119,SpokaneStBridge,07/10/2016 03:00:00 PM,48,-122,49,56,105
22120,SpokaneStBridge,07/10/2016 04:00:00 PM,48,-122,39,32,71
22121,SpokaneStBridge,07/10/2016 05:00:00 PM,48,-122,24,22,46
22122,SpokaneStBridge,07/10/2016 06:00:00 PM,48,-122,17,23,40
22123,SpokaneStBridge,07/10/2016 07:00:00 PM,48,-122,7,13,20
22124,SpokaneStBridge,07/10/2016 08:00:00 PM,48,-122,9,10,19
22125,SpokaneStBridge,07/10/2016 09:00:00 PM,48,-122,5,6,11
22126,SpokaneStBridge,07/10/2016 10:00:00 PM,48,-122,0,5,5
22127,SpokaneStBridge,07/10/2016 11:00:00 PM,48,-122,2,4,6
22128,SpokaneStBridge,07/11/2016 12:00:00 AM,48,-122,1,2,3
22129,SpokaneStBridge,07/11/2016 01:00:00 AM,48,-122,1,0,1
22130,SpokaneStBridge,07/11/2016 02:00:00 AM,48,-122,1,0,1
22131,SpokaneStBridge,07/11/2016 03:00:00 AM,48,-122,3,2,5
22132,SpokaneStBridge,07/11/2016 04:00:00 AM,48,-122,2,3,5
22133,SpokaneStBridge,07/11/2016 05:00:00 AM,48,-122,23,5,28
22134,SpokaneStBridge,07/11/2016 06:00:00 AM,48,-122,64,13,77
22135,SpokaneStBridge,07/11/2016 07:00:00 AM,48,-122,147,14,161
22136,SpokaneStBridge,07/11/2016 08:00:00 AM,48,-122,140,20,160
22137,SpokaneStBridge,07/11/2016 09:00:00 AM,48,-122,45,15,60
22138,SpokaneStBridge,07/11/2016 10:00:00 AM,48,-122,27,9,36
22139,SpokaneStBridge,07/11/2016 11:00:00 AM,48,-122,13,9,22
22140,SpokaneStBridge,07/11/2016 12:00:00 PM,48,-122,14,14,28
22141,SpokaneStBridge,07/11/2016 01:00:00 PM,48,-122,9,8,17
22142,SpokaneStBridge,07/11/2016 02:00:00 PM,48,-122,9,19,28
22143,SpokaneStBridge,07/11/2016 03:00:00 PM,48,-122,28,37,65
22144,SpokaneStBridge,07/11/2016 04:00:00 PM,48,-122,13,91,104
22145,SpokaneStBridge,07/11/2016 05:00:00 PM,48,-122,34,200,234
22146,SpokaneStBridge,07/11/2016 06:00:00 PM,48,-122,15,106,121
22147,SpokaneStBridge,07/11/2016 07:00:00 PM,48,-122,20,41,61
22148,SpokaneStBridge,07/11/2016 08:00:00 PM,48,-122,18,13,31
22149,SpokaneStBridge,07/11/2016 09:00:00 PM,48,-122,6,15,21
22150,SpokaneStBridge,07/11/2016 10:00:00 PM,48,-122,3,10,13
22151,SpokaneStBridge,07/11/2016 11:00:00 PM,48,-122,1,5,6
22152,SpokaneStBridge,07/12/2016 12:00:00 AM,48,-122,0,3,3
22153,SpokaneStBridge,07/12/2016 01:00:00 AM,48,-122,1,3,4
22154,SpokaneStBridge,07/12/2016 02:00:00 AM,48,-122,2,1,3
22155,SpokaneStBridge,07/12/2016 03:00:00 AM,48,-122,3,3,6
22156,SpokaneStBridge,07/12/2016 04:00:00 AM,48,-122,6,0,6
22157,SpokaneStBridge,07/12/2016 05:00:00 AM,48,-122,25,3,28
22158,SpokaneStBridge,07/12/2016 06:00:00 AM,48,-122,65,13,78
22159,SpokaneStBridge,07/12/2016 07:00:00 AM,48,-122,150,13,163
22160,SpokaneStBridge,07/12/2016 08:00:00 AM,48,-122,148,10,158
22161,SpokaneStBridge,07/12/2016 09:00:00 AM,48,-122,51,11,62
22162,SpokaneStBridge,07/12/2016 10:00:00 AM,48,-122,25,12,37
22163,SpokaneStBridge,07/12/2016 11:00:00 AM,48,-122,18,12,30
22164,SpokaneStBridge,07/12/2016 12:00:00 PM,48,-122,17,20,37
22165,SpokaneStBridge,07/12/2016 01:00:00 PM,48,-122,15,14,29
22166,SpokaneStBridge,07/12/2016 02:00:00 PM,48,-122,10,18,28
22167,SpokaneStBridge,07/12/2016 03:00:00 PM,48,-122,20,39,59
22168,SpokaneStBridge,07/12/2016 04:00:00 PM,48,-122,24,90,114
22169,SpokaneStBridge,07/12/2016 05:00:00 PM,48,-122,36,168,204
22170,SpokaneStBridge,07/12/2016 06:00:00 PM,48,-122,19,133,152
22171,SpokaneStBridge,07/12/2016 07:00:00 PM,48,-122,12,46,58
22172,SpokaneStBridge,07/12/2016 08:00:00 PM,48,-122,11,27,38
22173,SpokaneStBridge,07/12/2016 09:00:00 PM,48,-122,7,17,24
22174,SpokaneStBridge,07/12/2016 10:00:00 PM,48,-122,5,6,11
22175,SpokaneStBridge,07/12/2016 11:00:00 PM,48,-122,3,5,8
22176,SpokaneStBridge,07/13/2016 12:00:00 AM,48,-122,2,1,3
22177,SpokaneStBridge,07/13/2016 01:00:00 AM,48,-122,1,2,3
22178,SpokaneStBridge,07/13/2016 02:00:00 AM,48,-122,2,2,4
22179,SpokaneStBridge,07/13/2016 03:00:00 AM,48,-122,3,2,5
22180,SpokaneStBridge,07/13/2016 04:00:00 AM,48,-122,2,0,2
22181,SpokaneStBridge,07/13/2016 05:00:00 AM,48,-122,29,9,38
22182,SpokaneStBridge,07/13/2016 06:00:00 AM,48,-122,70,16,86
22183,SpokaneStBridge,07/13/2016 07:00:00 AM,48,-122,161,25,186
22184,SpokaneStBridge,07/13/2016 08:00:00 AM,48,-122,161,18,179
22185,SpokaneStBridge,07/13/2016 09:00:00 AM,48,-122,69,14,83
22186,SpokaneStBridge,07/13/2016 10:00:00 AM,48,-122,26,7,33
22187,SpokaneStBridge,07/13/2016 11:00:00 AM,48,-122,14,9,23
22188,SpokaneStBridge,07/13/2016 12:00:00 PM,48,-122,16,23,39
22189,SpokaneStBridge,07/13/2016 01:00:00 PM,48,-122,19,20,39
22190,SpokaneStBridge,07/13/2016 02:00:00 PM,48,-122,21,23,44
22191,SpokaneStBridge,07/13/2016 03:00:00 PM,48,-122,30,35,65
22192,SpokaneStBridge,07/13/2016 04:00:00 PM,48,-122,22,107,129
22193,SpokaneStBridge,07/13/2016 05:00:00 PM,48,-122,35,184,219
22194,SpokaneStBridge,07/13/2016 06:00:00 PM,48,-122,20,116,136
22195,SpokaneStBridge,07/13/2016 07:00:00 PM,48,-122,21,50,71
22196,SpokaneStBridge,07/13/2016 08:00:00 PM,48,-122,15,25,40
22197,SpokaneStBridge,07/13/2016 09:00:00 PM,48,-122,12,21,33
22198,SpokaneStBridge,07/13/2016 10:00:00 PM,48,-122,4,15,19
22199,SpokaneStBridge,07/13/2016 11:00:00 PM,48,-122,3,4,7
22200,SpokaneStBridge,07/14/2016 12:00:00 AM,48,-122,0,1,1
22201,SpokaneStBridge,07/14/2016 01:00:00 AM,48,-122,0,1,1
22202,SpokaneStBridge,07/14/2016 02:00:00 AM,48,-122,1,0,1
22203,SpokaneStBridge,07/14/2016 03:00:00 AM,48,-122,2,0,2
22204,SpokaneStBridge,07/14/2016 04:00:00 AM,48,-122,2,1,3
22205,SpokaneStBridge,07/14/2016 05:00:00 AM,48,-122,24,5,29
22206,SpokaneStBridge,07/14/2016 06:00:00 AM,48,-122,64,18,82
22207,SpokaneStBridge,07/14/2016 07:00:00 AM,48,-122,145,12,157
22208,SpokaneStBridge,07/14/2016 08:00:00 AM,48,-122,151,12,163
22209,SpokaneStBridge,07/14/2016 09:00:00 AM,48,-122,62,15,77
22210,SpokaneStBridge,07/14/2016 10:00:00 AM,48,-122,34,9,43
22211,SpokaneStBridge,07/14/2016 11:00:00 AM,48,-122,31,9,40
22212,SpokaneStBridge,07/14/2016 12:00:00 PM,48,-122,15,24,39
22213,SpokaneStBridge,07/14/2016 01:00:00 PM,48,-122,16,28,44
22214,SpokaneStBridge,07/14/2016 02:00:00 PM,48,-122,17,18,35
22215,SpokaneStBridge,07/14/2016 03:00:00 PM,48,-122,20,31,51
22216,SpokaneStBridge,07/14/2016 04:00:00 PM,48,-122,14,94,108
22217,SpokaneStBridge,07/14/2016 05:00:00 PM,48,-122,36,194,230
22218,SpokaneStBridge,07/14/2016 06:00:00 PM,48,-122,20,113,133
22219,SpokaneStBridge,07/14/2016 07:00:00 PM,48,-122,24,59,83
22220,SpokaneStBridge,07/14/2016 08:00:00 PM,48,-122,22,29,51
22221,SpokaneStBridge,07/14/2016 09:00:00 PM,48,-122,8,20,28
22222,SpokaneStBridge,07/14/2016 10:00:00 PM,48,-122,9,10,19
22223,SpokaneStBridge,07/14/2016 11:00:00 PM,48,-122,0,9,9
22224,SpokaneStBridge,07/15/2016 12:00:00 AM,48,-122,0,2,2
22225,SpokaneStBridge,07/15/2016 01:00:00 AM,48,-122,1,3,4
22226,SpokaneStBridge,07/15/2016 02:00:00 AM,48,-122,2,2,4
22227,SpokaneStBridge,07/15/2016 03:00:00 AM,48,-122,2,3,5
22228,SpokaneStBridge,07/15/2016 04:00:00 AM,48,-122,6,3,9
22229,SpokaneStBridge,07/15/2016 05:00:00 AM,48,-122,21,5,26
22230,SpokaneStBridge,07/15/2016 06:00:00 AM,48,-122,52,13,65
22231,SpokaneStBridge,07/15/2016 07:00:00 AM,48,-122,110,15,125
22232,SpokaneStBridge,07/15/2016 08:00:00 AM,48,-122,125,14,139
22233,SpokaneStBridge,07/15/2016 09:00:00 AM,48,-122,40,7,47
22234,SpokaneStBridge,07/15/2016 10:00:00 AM,48,-122,15,5,20
22235,SpokaneStBridge,07/15/2016 11:00:00 AM,48,-122,9,10,19
22236,SpokaneStBridge,07/15/2016 12:00:00 PM,48,-122,12,20,32
22237,SpokaneStBridge,07/15/2016 01:00:00 PM,48,-122,13,24,37
22238,SpokaneStBridge,07/15/2016 02:00:00 PM,48,-122,17,30,47
22239,SpokaneStBridge,07/15/2016 03:00:00 PM,48,-122,20,43,63
22240,SpokaneStBridge,07/15/2016 04:00:00 PM,48,-122,29,76,105
22241,SpokaneStBridge,07/15/2016 05:00:00 PM,48,-122,21,118,139
22242,SpokaneStBridge,07/15/2016 06:00:00 PM,48,-122,17,80,97
22243,SpokaneStBridge,07/15/2016 07:00:00 PM,48,-122,7,28,35
22244,SpokaneStBridge,07/15/2016 08:00:00 PM,48,-122,5,17,22
22245,SpokaneStBridge,07/15/2016 09:00:00 PM,48,-122,7,14,21
22246,SpokaneStBridge,07/15/2016 10:00:00 PM,48,-122,2,11,13
22247,SpokaneStBridge,07/15/2016 11:00:00 PM,48,-122,2,7,9
22248,SpokaneStBridge,07/16/2016 12:00:00 AM,48,-122,0,5,5
22249,SpokaneStBridge,07/16/2016 01:00:00 AM,48,-122,1,6,7
22250,SpokaneStBridge,07/16/2016 02:00:00 AM,48,-122,1,1,2
22251,SpokaneStBridge,07/16/2016 03:00:00 AM,48,-122,1,0,1
22252,SpokaneStBridge,07/16/2016 04:00:00 AM,48,-122,3,5,8
22253,SpokaneStBridge,07/16/2016 05:00:00 AM,48,-122,15,2,17
22254,SpokaneStBridge,07/16/2016 06:00:00 AM,48,-122,13,6,19
22255,SpokaneStBridge,07/16/2016 07:00:00 AM,48,-122,10,7,17
22256,SpokaneStBridge,07/16/2016 08:00:00 AM,48,-122,21,13,34
22257,SpokaneStBridge,07/16/2016 09:00:00 AM,48,-122,16,20,36
22258,SpokaneStBridge,07/16/2016 10:00:00 AM,48,-122,19,25,44
22259,SpokaneStBridge,07/16/2016 11:00:00 AM,48,-122,24,20,44
22260,SpokaneStBridge,07/16/2016 12:00:00 PM,48,-122,20,25,45
22261,SpokaneStBridge,07/16/2016 01:00:00 PM,48,-122,25,17,42
22262,SpokaneStBridge,07/16/2016 02:00:00 PM,48,-122,13,45,58
22263,SpokaneStBridge,07/16/2016 03:00:00 PM,48,-122,31,15,46
22264,SpokaneStBridge,07/16/2016 04:00:00 PM,48,-122,17,42,59
22265,SpokaneStBridge,07/16/2016 05:00:00 PM,48,-122,34,33,67
22266,SpokaneStBridge,07/16/2016 06:00:00 PM,48,-122,8,25,33
22267,SpokaneStBridge,07/16/2016 07:00:00 PM,48,-122,8,7,15
22268,SpokaneStBridge,07/16/2016 08:00:00 PM,48,-122,9,8,17
22269,SpokaneStBridge,07/16/2016 09:00:00 PM,48,-122,0,10,10
22270,SpokaneStBridge,07/16/2016 10:00:00 PM,48,-122,6,7,13
22271,SpokaneStBridge,07/16/2016 11:00:00 PM,48,-122,5,6,11
22272,SpokaneStBridge,07/17/2016 12:00:00 AM,48,-122,0,4,4
22273,SpokaneStBridge,07/17/2016 01:00:00 AM,48,-122,1,0,1
22274,SpokaneStBridge,07/17/2016 02:00:00 AM,48,-122,2,1,3
22275,SpokaneStBridge,07/17/2016 03:00:00 AM,48,-122,0,3,3
22276,SpokaneStBridge,07/17/2016 04:00:00 AM,48,-122,0,1,1
22277,SpokaneStBridge,07/17/2016 05:00:00 AM,48,-122,4,1,5
22278,SpokaneStBridge,07/17/2016 06:00:00 AM,48,-122,7,2,9
22279,SpokaneStBridge,07/17/2016 07:00:00 AM,48,-122,8,2,10
22280,SpokaneStBridge,07/17/2016 08:00:00 AM,48,-122,19,14,33
22281,SpokaneStBridge,07/17/2016 09:00:00 AM,48,-122,19,20,39
22282,SpokaneStBridge,07/17/2016 10:00:00 AM,48,-122,22,30,52
22283,SpokaneStBridge,07/17/2016 11:00:00 AM,48,-122,21,33,54
22284,SpokaneStBridge,07/17/2016 12:00:00 PM,48,-122,33,40,73
22285,SpokaneStBridge,07/17/2016 01:00:00 PM,48,-122,39,30,69
22286,SpokaneStBridge,07/17/2016 02:00:00 PM,48,-122,50,34,84
22287,SpokaneStBridge,07/17/2016 03:00:00 PM,48,-122,26,38,64
22288,SpokaneStBridge,07/17/2016 04:00:00 PM,48,-122,21,33,54
22289,SpokaneStBridge,07/17/2016 05:00:00 PM,48,-122,19,24,43
22290,SpokaneStBridge,07/17/2016 06:00:00 PM,48,-122,5,18,23
22291,SpokaneStBridge,07/17/2016 07:00:00 PM,48,-122,17,5,22
22292,SpokaneStBridge,07/17/2016 08:00:00 PM,48,-122,8,19,27
22293,SpokaneStBridge,07/17/2016 09:00:00 PM,48,-122,7,5,12
22294,SpokaneStBridge,07/17/2016 10:00:00 PM,48,-122,5,2,7
22295,SpokaneStBridge,07/17/2016 11:00:00 PM,48,-122,2,5,7
22296,SpokaneStBridge,07/18/2016 12:00:00 AM,48,-122,1,2,3
22297,SpokaneStBridge,07/18/2016 01:00:00 AM,48,-122,0,0,0
22298,SpokaneStBridge,07/18/2016 02:00:00 AM,48,-122,2,1,3
22299,SpokaneStBridge,07/18/2016 03:00:00 AM,48,-122,0,2,2
22300,SpokaneStBridge,07/18/2016 04:00:00 AM,48,-122,8,2,10
22301,SpokaneStBridge,07/18/2016 05:00:00 AM,48,-122,23,6,29
22302,SpokaneStBridge,07/18/2016 06:00:00 AM,48,-122,65,15,80
22303,SpokaneStBridge,07/18/2016 07:00:00 AM,48,-122,136,10,146
22304,SpokaneStBridge,07/18/2016 08:00:00 AM,48,-122,118,16,134
22305,SpokaneStBridge,07/18/2016 09:00:00 AM,48,-122,62,9,71
22306,SpokaneStBridge,07/18/2016 10:00:00 AM,48,-122,27,8,35
22307,SpokaneStBridge,07/18/2016 11:00:00 AM,48,-122,11,14,25
22308,SpokaneStBridge,07/18/2016 12:00:00 PM,48,-122,6,17,23
22309,SpokaneStBridge,07/18/2016 01:00:00 PM,48,-122,14,15,29
22310,SpokaneStBridge,07/18/2016 02:00:00 PM,48,-122,17,13,30
22311,SpokaneStBridge,07/18/2016 03:00:00 PM,48,-122,8,31,39
22312,SpokaneStBridge,07/18/2016 04:00:00 PM,48,-122,15,89,104
22313,SpokaneStBridge,07/18/2016 05:00:00 PM,48,-122,22,175,197
22314,SpokaneStBridge,07/18/2016 06:00:00 PM,48,-122,10,106,116
22315,SpokaneStBridge,07/18/2016 07:00:00 PM,48,-122,10,22,32
22316,SpokaneStBridge,07/18/2016 08:00:00 PM,48,-122,6,20,26
22317,SpokaneStBridge,07/18/2016 09:00:00 PM,48,-122,1,8,9
22318,SpokaneStBridge,07/18/2016 10:00:00 PM,48,-122,5,11,16
22319,SpokaneStBridge,07/18/2016 11:00:00 PM,48,-122,3,1,4
22320,SpokaneStBridge,07/19/2016 12:00:00 AM,48,-122,1,2,3
22321,SpokaneStBridge,07/19/2016 01:00:00 AM,48,-122,0,1,1
22322,SpokaneStBridge,07/19/2016 02:00:00 AM,48,-122,2,1,3
22323,SpokaneStBridge,07/19/2016 03:00:00 AM,48,-122,3,1,4
22324,SpokaneStBridge,07/19/2016 04:00:00 AM,48,-122,5,1,6
22325,SpokaneStBridge,07/19/2016 05:00:00 AM,48,-122,23,6,29
22326,SpokaneStBridge,07/19/2016 06:00:00 AM,48,-122,81,9,90
22327,SpokaneStBridge,07/19/2016 07:00:00 AM,48,-122,141,18,159
22328,SpokaneStBridge,07/19/2016 08:00:00 AM,48,-122,150,22,172
22329,SpokaneStBridge,07/19/2016 09:00:00 AM,48,-122,59,7,66
22330,SpokaneStBridge,07/19/2016 10:00:00 AM,48,-122,20,12,32
22331,SpokaneStBridge,07/19/2016 11:00:00 AM,48,-122,15,16,31
22332,SpokaneStBridge,07/19/2016 12:00:00 PM,48,-122,18,15,33
22333,SpokaneStBridge,07/19/2016 01:00:00 PM,48,-122,19,14,33
22334,SpokaneStBridge,07/19/2016 02:00:00 PM,48,-122,9,15,24
22335,SpokaneStBridge,07/19/2016 03:00:00 PM,48,-122,25,43,68
22336,SpokaneStBridge,07/19/2016 04:00:00 PM,48,-122,32,81,113
22337,SpokaneStBridge,07/19/2016 05:00:00 PM,48,-122,32,184,216
22338,SpokaneStBridge,07/19/2016 06:00:00 PM,48,-122,22,131,153
22339,SpokaneStBridge,07/19/2016 07:00:00 PM,48,-122,14,58,72
22340,SpokaneStBridge,07/19/2016 08:00:00 PM,48,-122,21,28,49
22341,SpokaneStBridge,07/19/2016 09:00:00 PM,48,-122,11,22,33
22342,SpokaneStBridge,07/19/2016 10:00:00 PM,48,-122,3,13,16
22343,SpokaneStBridge,07/19/2016 11:00:00 PM,48,-122,2,6,8
22344,SpokaneStBridge,07/20/2016 12:00:00 AM,48,-122,2,2,4
22345,SpokaneStBridge,07/20/2016 01:00:00 AM,48,-122,1,2,3
22346,SpokaneStBridge,07/20/2016 02:00:00 AM,48,-122,2,2,4
22347,SpokaneStBridge,07/20/2016 03:00:00 AM,48,-122,3,2,5
22348,SpokaneStBridge,07/20/2016 04:00:00 AM,48,-122,5,3,8
22349,SpokaneStBridge,07/20/2016 05:00:00 AM,48,-122,24,4,28
22350,SpokaneStBridge,07/20/2016 06:00:00 AM,48,-122,69,10,79
22351,SpokaneStBridge,07/20/2016 07:00:00 AM,48,-122,169,16,185
22352,SpokaneStBridge,07/20/2016 08:00:00 AM,48,-122,164,21,185
22353,SpokaneStBridge,07/20/2016 09:00:00 AM,48,-122,68,12,80
22354,SpokaneStBridge,07/20/2016 10:00:00 AM,48,-122,38,8,46
22355,SpokaneStBridge,07/20/2016 11:00:00 AM,48,-122,31,10,41
22356,SpokaneStBridge,07/20/2016 12:00:00 PM,48,-122,21,18,39
22357,SpokaneStBridge,07/20/2016 01:00:00 PM,48,-122,17,21,38
22358,SpokaneStBridge,07/20/2016 02:00:00 PM,48,-122,17,22,39
22359,SpokaneStBridge,07/20/2016 03:00:00 PM,48,-122,20,42,62
22360,SpokaneStBridge,07/20/2016 04:00:00 PM,48,-122,31,109,140
22361,SpokaneStBridge,07/20/2016 05:00:00 PM,48,-122,31,203,234
22362,SpokaneStBridge,07/20/2016 06:00:00 PM,48,-122,31,127,158
22363,SpokaneStBridge,07/20/2016 07:00:00 PM,48,-122,24,64,88
22364,SpokaneStBridge,07/20/2016 08:00:00 PM,48,-122,24,30,54
22365,SpokaneStBridge,07/20/2016 09:00:00 PM,48,-122,11,27,38
22366,SpokaneStBridge,07/20/2016 10:00:00 PM,48,-122,5,9,14
22367,SpokaneStBridge,07/20/2016 11:00:00 PM,48,-122,0,5,5
22368,SpokaneStBridge,07/21/2016 12:00:00 AM,48,-122,2,0,2
22369,SpokaneStBridge,07/21/2016 01:00:00 AM,48,-122,1,3,4
22370,SpokaneStBridge,07/21/2016 02:00:00 AM,48,-122,3,2,5
22371,SpokaneStBridge,07/21/2016 03:00:00 AM,48,-122,2,0,2
22372,SpokaneStBridge,07/21/2016 04:00:00 AM,48,-122,6,1,7
22373,SpokaneStBridge,07/21/2016 05:00:00 AM,48,-122,25,4,29
22374,SpokaneStBridge,07/21/2016 06:00:00 AM,48,-122,70,10,80
22375,SpokaneStBridge,07/21/2016 07:00:00 AM,48,-122,159,12,171
22376,SpokaneStBridge,07/21/2016 08:00:00 AM,48,-122,152,19,171
22377,SpokaneStBridge,07/21/2016 09:00:00 AM,48,-122,54,14,68
22378,SpokaneStBridge,07/21/2016 10:00:00 AM,48,-122,24,23,47
22379,SpokaneStBridge,07/21/2016 11:00:00 AM,48,-122,26,22,48
22380,SpokaneStBridge,07/21/2016 12:00:00 PM,48,-122,21,32,53
22381,SpokaneStBridge,07/21/2016 01:00:00 PM,48,-122,24,11,35
22382,SpokaneStBridge,07/21/2016 02:00:00 PM,48,-122,21,18,39
22383,SpokaneStBridge,07/21/2016 03:00:00 PM,48,-122,17,52,69
22384,SpokaneStBridge,07/21/2016 04:00:00 PM,48,-122,25,79,104
22385,SpokaneStBridge,07/21/2016 05:00:00 PM,48,-122,25,176,201
22386,SpokaneStBridge,07/21/2016 06:00:00 PM,48,-122,23,119,142
22387,SpokaneStBridge,07/21/2016 07:00:00 PM,48,-122,28,53,81
22388,SpokaneStBridge,07/21/2016 08:00:00 PM,48,-122,10,20,30
22389,SpokaneStBridge,07/21/2016 09:00:00 PM,48,-122,6,16,22
22390,SpokaneStBridge,07/21/2016 10:00:00 PM,48,-122,5,7,12
22391,SpokaneStBridge,07/21/2016 11:00:00 PM,48,-122,1,8,9
22392,SpokaneStBridge,07/22/2016 12:00:00 AM,48,-122,0,2,2
22393,SpokaneStBridge,07/22/2016 01:00:00 AM,48,-122,0,3,3
22394,SpokaneStBridge,07/22/2016 02:00:00 AM,48,-122,0,0,0
22395,SpokaneStBridge,07/22/2016 03:00:00 AM,48,-122,3,1,4
22396,SpokaneStBridge,07/22/2016 04:00:00 AM,48,-122,4,4,8
22397,SpokaneStBridge,07/22/2016 05:00:00 AM,48,-122,10,1,11
22398,SpokaneStBridge,07/22/2016 06:00:00 AM,48,-122,20,2,22
22399,SpokaneStBridge,07/22/2016 07:00:00 AM,48,-122,44,5,49
22400,SpokaneStBridge,07/22/2016 08:00:00 AM,48,-122,57,4,61
22401,SpokaneStBridge,07/22/2016 09:00:00 AM,48,-122,27,0,27
22402,SpokaneStBridge,07/22/2016 10:00:00 AM,48,-122,16,14,30
22403,SpokaneStBridge,07/22/2016 11:00:00 AM,48,-122,10,4,14
22404,SpokaneStBridge,07/22/2016 12:00:00 PM,48,-122,16,8,24
22405,SpokaneStBridge,07/22/2016 01:00:00 PM,48,-122,8,5,13
22406,SpokaneStBridge,07/22/2016 02:00:00 PM,48,-122,12,14,26
22407,SpokaneStBridge,07/22/2016 03:00:00 PM,48,-122,14,32,46
22408,SpokaneStBridge,07/22/2016 04:00:00 PM,48,-122,17,44,61
22409,SpokaneStBridge,07/22/2016 05:00:00 PM,48,-122,15,69,84
22410,SpokaneStBridge,07/22/2016 06:00:00 PM,48,-122,5,45,50
22411,SpokaneStBridge,07/22/2016 07:00:00 PM,48,-122,5,20,25
22412,SpokaneStBridge,07/22/2016 08:00:00 PM,48,-122,2,6,8
22413,SpokaneStBridge,07/22/2016 09:00:00 PM,48,-122,4,5,9
22414,SpokaneStBridge,07/22/2016 10:00:00 PM,48,-122,7,3,10
22415,SpokaneStBridge,07/22/2016 11:00:00 PM,48,-122,2,0,2
22416,SpokaneStBridge,07/23/2016 12:00:00 AM,48,-122,1,2,3
22417,SpokaneStBridge,07/23/2016 01:00:00 AM,48,-122,0,6,6
22418,SpokaneStBridge,07/23/2016 02:00:00 AM,48,-122,1,0,1
22419,SpokaneStBridge,07/23/2016 03:00:00 AM,48,-122,0,0,0
22420,SpokaneStBridge,07/23/2016 04:00:00 AM,48,-122,1,0,1
22421,SpokaneStBridge,07/23/2016 05:00:00 AM,48,-122,2,0,2
22422,SpokaneStBridge,07/23/2016 06:00:00 AM,48,-122,11,1,12
22423,SpokaneStBridge,07/23/2016 07:00:00 AM,48,-122,10,8,18
22424,SpokaneStBridge,07/23/2016 08:00:00 AM,48,-122,24,20,44
22425,SpokaneStBridge,07/23/2016 09:00:00 AM,48,-122,24,23,47
22426,SpokaneStBridge,07/23/2016 10:00:00 AM,48,-122,16,19,35
22427,SpokaneStBridge,07/23/2016 11:00:00 AM,48,-122,24,36,60
22428,SpokaneStBridge,07/23/2016 12:00:00 PM,48,-122,26,44,70
22429,SpokaneStBridge,07/23/2016 01:00:00 PM,48,-122,32,31,63
22430,SpokaneStBridge,07/23/2016 02:00:00 PM,48,-122,23,40,63
22431,SpokaneStBridge,07/23/2016 03:00:00 PM,48,-122,32,49,81
22432,SpokaneStBridge,07/23/2016 04:00:00 PM,48,-122,32,32,64
22433,SpokaneStBridge,07/23/2016 05:00:00 PM,48,-122,26,31,57
22434,SpokaneStBridge,07/23/2016 06:00:00 PM,48,-122,32,14,46
22435,SpokaneStBridge,07/23/2016 07:00:00 PM,48,-122,8,14,22
22436,SpokaneStBridge,07/23/2016 08:00:00 PM,48,-122,8,13,21
22437,SpokaneStBridge,07/23/2016 09:00:00 PM,48,-122,5,27,32
22438,SpokaneStBridge,07/23/2016 10:00:00 PM,48,-122,7,3,10
22439,SpokaneStBridge,07/23/2016 11:00:00 PM,48,-122,15,11,26
22440,SpokaneStBridge,07/24/2016 12:00:00 AM,48,-122,1,2,3
22441,SpokaneStBridge,07/24/2016 01:00:00 AM,48,-122,0,0,0
22442,SpokaneStBridge,07/24/2016 02:00:00 AM,48,-122,1,0,1
22443,SpokaneStBridge,07/24/2016 03:00:00 AM,48,-122,0,3,3
22444,SpokaneStBridge,07/24/2016 04:00:00 AM,48,-122,0,1,1
22445,SpokaneStBridge,07/24/2016 05:00:00 AM,48,-122,8,1,9
22446,SpokaneStBridge,07/24/2016 06:00:00 AM,48,-122,8,3,11
22447,SpokaneStBridge,07/24/2016 07:00:00 AM,48,-122,8,4,12
22448,SpokaneStBridge,07/24/2016 08:00:00 AM,48,-122,25,14,39
22449,SpokaneStBridge,07/24/2016 09:00:00 AM,48,-122,17,28,45
22450,SpokaneStBridge,07/24/2016 10:00:00 AM,48,-122,36,43,79
22451,SpokaneStBridge,07/24/2016 11:00:00 AM,48,-122,38,67,105
22452,SpokaneStBridge,07/24/2016 12:00:00 PM,48,-122,39,61,100
22453,SpokaneStBridge,07/24/2016 01:00:00 PM,48,-122,57,48,105
22454,SpokaneStBridge,07/24/2016 02:00:00 PM,48,-122,61,51,112
22455,SpokaneStBridge,07/24/2016 03:00:00 PM,48,-122,54,55,109
22456,SpokaneStBridge,07/24/2016 04:00:00 PM,48,-122,33,37,70
22457,SpokaneStBridge,07/24/2016 05:00:00 PM,48,-122,40,33,73
22458,SpokaneStBridge,07/24/2016 06:00:00 PM,48,-122,14,25,39
22459,SpokaneStBridge,07/24/2016 07:00:00 PM,48,-122,17,16,33
22460,SpokaneStBridge,07/24/2016 08:00:00 PM,48,-122,6,18,24
22461,SpokaneStBridge,07/24/2016 09:00:00 PM,48,-122,9,8,17
22462,SpokaneStBridge,07/24/2016 10:00:00 PM,48,-122,12,3,15
22463,SpokaneStBridge,07/24/2016 11:00:00 PM,48,-122,1,4,5
22464,SpokaneStBridge,07/25/2016 12:00:00 AM,48,-122,0,1,1
22465,SpokaneStBridge,07/25/2016 01:00:00 AM,48,-122,0,0,0
22466,SpokaneStBridge,07/25/2016 02:00:00 AM,48,-122,1,1,2
22467,SpokaneStBridge,07/25/2016 03:00:00 AM,48,-122,2,4,6
22468,SpokaneStBridge,07/25/2016 04:00:00 AM,48,-122,6,1,7
22469,SpokaneStBridge,07/25/2016 05:00:00 AM,48,-122,20,3,23
22470,SpokaneStBridge,07/25/2016 06:00:00 AM,48,-122,75,14,89
22471,SpokaneStBridge,07/25/2016 07:00:00 AM,48,-122,163,14,177
22472,SpokaneStBridge,07/25/2016 08:00:00 AM,48,-122,171,12,183
22473,SpokaneStBridge,07/25/2016 09:00:00 AM,48,-122,48,8,56
22474,SpokaneStBridge,07/25/2016 10:00:00 AM,48,-122,24,9,33
22475,SpokaneStBridge,07/25/2016 11:00:00 AM,48,-122,15,11,26
22476,SpokaneStBridge,07/25/2016 12:00:00 PM,48,-122,23,15,38
22477,SpokaneStBridge,07/25/2016 01:00:00 PM,48,-122,14,11,25
22478,SpokaneStBridge,07/25/2016 02:00:00 PM,48,-122,10,17,27
22479,SpokaneStBridge,07/25/2016 03:00:00 PM,48,-122,13,38,51
22480,SpokaneStBridge,07/25/2016 04:00:00 PM,48,-122,22,97,119
22481,SpokaneStBridge,07/25/2016 05:00:00 PM,48,-122,30,206,236
22482,SpokaneStBridge,07/25/2016 06:00:00 PM,48,-122,23,115,138
22483,SpokaneStBridge,07/25/2016 07:00:00 PM,48,-122,18,51,69
22484,SpokaneStBridge,07/25/2016 08:00:00 PM,48,-122,17,26,43
22485,SpokaneStBridge,07/25/2016 09:00:00 PM,48,-122,6,11,17
22486,SpokaneStBridge,07/25/2016 10:00:00 PM,48,-122,7,7,14
22487,SpokaneStBridge,07/25/2016 11:00:00 PM,48,-122,3,3,6
22488,SpokaneStBridge,07/26/2016 12:00:00 AM,48,-122,0,1,1
22489,SpokaneStBridge,07/26/2016 01:00:00 AM,48,-122,0,3,3
22490,SpokaneStBridge,07/26/2016 02:00:00 AM,48,-122,4,2,6
22491,SpokaneStBridge,07/26/2016 03:00:00 AM,48,-122,1,1,2
22492,SpokaneStBridge,07/26/2016 04:00:00 AM,48,-122,6,2,8
22493,SpokaneStBridge,07/26/2016 05:00:00 AM,48,-122,20,7,27
22494,SpokaneStBridge,07/26/2016 06:00:00 AM,48,-122,84,15,99
22495,SpokaneStBridge,07/26/2016 07:00:00 AM,48,-122,178,21,199
22496,SpokaneStBridge,07/26/2016 08:00:00 AM,48,-122,154,17,171
22497,SpokaneStBridge,07/26/2016 09:00:00 AM,48,-122,66,6,72
22498,SpokaneStBridge,07/26/2016 10:00:00 AM,48,-122,20,12,32
22499,SpokaneStBridge,07/26/2016 11:00:00 AM,48,-122,17,11,28
22500,SpokaneStBridge,07/26/2016 12:00:00 PM,48,-122,11,12,23
22501,SpokaneStBridge,07/26/2016 01:00:00 PM,48,-122,12,19,31
22502,SpokaneStBridge,07/26/2016 02:00:00 PM,48,-122,13,19,32
22503,SpokaneStBridge,07/26/2016 03:00:00 PM,48,-122,23,32,55
22504,SpokaneStBridge,07/26/2016 04:00:00 PM,48,-122,28,99,127
22505,SpokaneStBridge,07/26/2016 05:00:00 PM,48,-122,27,210,237
22506,SpokaneStBridge,07/26/2016 06:00:00 PM,48,-122,20,134,154
22507,SpokaneStBridge,07/26/2016 07:00:00 PM,48,-122,14,52,66
22508,SpokaneStBridge,07/26/2016 08:00:00 PM,48,-122,17,29,46
22509,SpokaneStBridge,07/26/2016 09:00:00 PM,48,-122,10,20,30
22510,SpokaneStBridge,07/26/2016 10:00:00 PM,48,-122,3,8,11
22511,SpokaneStBridge,07/26/2016 11:00:00 PM,48,-122,1,4,5
22512,SpokaneStBridge,07/27/2016 12:00:00 AM,48,-122,1,0,1
22513,SpokaneStBridge,07/27/2016 01:00:00 AM,48,-122,0,2,2
22514,SpokaneStBridge,07/27/2016 02:00:00 AM,48,-122,1,0,1
22515,SpokaneStBridge,07/27/2016 03:00:00 AM,48,-122,2,2,4
22516,SpokaneStBridge,07/27/2016 04:00:00 AM,48,-122,5,1,6
22517,SpokaneStBridge,07/27/2016 05:00:00 AM,48,-122,24,7,31
22518,SpokaneStBridge,07/27/2016 06:00:00 AM,48,-122,68,10,78
22519,SpokaneStBridge,07/27/2016 07:00:00 AM,48,-122,176,24,200
22520,SpokaneStBridge,07/27/2016 08:00:00 AM,48,-122,139,17,156
22521,SpokaneStBridge,07/27/2016 09:00:00 AM,48,-122,64,12,76
22522,SpokaneStBridge,07/27/2016 10:00:00 AM,48,-122,24,9,33
22523,SpokaneStBridge,07/27/2016 11:00:00 AM,48,-122,28,17,45
22524,SpokaneStBridge,07/27/2016 12:00:00 PM,48,-122,15,19,34
22525,SpokaneStBridge,07/27/2016 01:00:00 PM,48,-122,20,14,34
22526,SpokaneStBridge,07/27/2016 02:00:00 PM,48,-122,17,23,40
22527,SpokaneStBridge,07/27/2016 03:00:00 PM,48,-122,13,31,44
22528,SpokaneStBridge,07/27/2016 04:00:00 PM,48,-122,26,102,128
22529,SpokaneStBridge,07/27/2016 05:00:00 PM,48,-122,19,190,209
22530,SpokaneStBridge,07/27/2016 06:00:00 PM,48,-122,25,121,146
22531,SpokaneStBridge,07/27/2016 07:00:00 PM,48,-122,31,60,91
22532,SpokaneStBridge,07/27/2016 08:00:00 PM,48,-122,14,33,47
22533,SpokaneStBridge,07/27/2016 09:00:00 PM,48,-122,4,12,16
22534,SpokaneStBridge,07/27/2016 10:00:00 PM,48,-122,7,12,19
22535,SpokaneStBridge,07/27/2016 11:00:00 PM,48,-122,4,5,9
22536,SpokaneStBridge,07/28/2016 12:00:00 AM,48,-122,2,0,2
22537,SpokaneStBridge,07/28/2016 01:00:00 AM,48,-122,1,0,1
22538,SpokaneStBridge,07/28/2016 02:00:00 AM,48,-122,1,1,2
22539,SpokaneStBridge,07/28/2016 03:00:00 AM,48,-122,4,4,8
22540,SpokaneStBridge,07/28/2016 04:00:00 AM,48,-122,7,1,8
22541,SpokaneStBridge,07/28/2016 05:00:00 AM,48,-122,24,5,29
22542,SpokaneStBridge,07/28/2016 06:00:00 AM,48,-122,67,14,81
22543,SpokaneStBridge,07/28/2016 07:00:00 AM,48,-122,152,13,165
22544,SpokaneStBridge,07/28/2016 08:00:00 AM,48,-122,151,14,165
22545,SpokaneStBridge,07/28/2016 09:00:00 AM,48,-122,61,5,66
22546,SpokaneStBridge,07/28/2016 10:00:00 AM,48,-122,20,15,35
22547,SpokaneStBridge,07/28/2016 11:00:00 AM,48,-122,21,15,36
22548,SpokaneStBridge,07/28/2016 12:00:00 PM,48,-122,19,21,40
22549,SpokaneStBridge,07/28/2016 01:00:00 PM,48,-122,21,17,38
22550,SpokaneStBridge,07/28/2016 02:00:00 PM,48,-122,17,16,33
22551,SpokaneStBridge,07/28/2016 03:00:00 PM,48,-122,25,33,58
22552,SpokaneStBridge,07/28/2016 04:00:00 PM,48,-122,18,88,106
22553,SpokaneStBridge,07/28/2016 05:00:00 PM,48,-122,29,168,197
22554,SpokaneStBridge,07/28/2016 06:00:00 PM,48,-122,20,119,139
22555,SpokaneStBridge,07/28/2016 07:00:00 PM,48,-122,13,53,66
22556,SpokaneStBridge,07/28/2016 08:00:00 PM,48,-122,5,27,32
22557,SpokaneStBridge,07/28/2016 09:00:00 PM,48,-122,7,15,22
22558,SpokaneStBridge,07/28/2016 10:00:00 PM,48,-122,12,15,27
22559,SpokaneStBridge,07/28/2016 11:00:00 PM,48,-122,1,3,4
22560,SpokaneStBridge,07/29/2016 12:00:00 AM,48,-122,2,4,6
22561,SpokaneStBridge,07/29/2016 01:00:00 AM,48,-122,1,2,3
22562,SpokaneStBridge,07/29/2016 02:00:00 AM,48,-122,0,1,1
22563,SpokaneStBridge,07/29/2016 03:00:00 AM,48,-122,1,0,1
22564,SpokaneStBridge,07/29/2016 04:00:00 AM,48,-122,5,0,5
22565,SpokaneStBridge,07/29/2016 05:00:00 AM,48,-122,15,4,19
22566,SpokaneStBridge,07/29/2016 06:00:00 AM,48,-122,54,8,62
22567,SpokaneStBridge,07/29/2016 07:00:00 AM,48,-122,106,14,120
22568,SpokaneStBridge,07/29/2016 08:00:00 AM,48,-122,129,10,139
22569,SpokaneStBridge,07/29/2016 09:00:00 AM,48,-122,52,5,57
22570,SpokaneStBridge,07/29/2016 10:00:00 AM,48,-122,27,7,34
22571,SpokaneStBridge,07/29/2016 11:00:00 AM,48,-122,15,7,22
22572,SpokaneStBridge,07/29/2016 12:00:00 PM,48,-122,19,26,45
22573,SpokaneStBridge,07/29/2016 01:00:00 PM,48,-122,10,21,31
22574,SpokaneStBridge,07/29/2016 02:00:00 PM,48,-122,22,25,47
22575,SpokaneStBridge,07/29/2016 03:00:00 PM,48,-122,16,37,53
22576,SpokaneStBridge,07/29/2016 04:00:00 PM,48,-122,24,92,116
22577,SpokaneStBridge,07/29/2016 05:00:00 PM,48,-122,11,125,136
22578,SpokaneStBridge,07/29/2016 06:00:00 PM,48,-122,14,85,99
22579,SpokaneStBridge,07/29/2016 07:00:00 PM,48,-122,12,27,39
22580,SpokaneStBridge,07/29/2016 08:00:00 PM,48,-122,12,25,37
22581,SpokaneStBridge,07/29/2016 09:00:00 PM,48,-122,3,10,13
22582,SpokaneStBridge,07/29/2016 10:00:00 PM,48,-122,9,4,13
22583,SpokaneStBridge,07/29/2016 11:00:00 PM,48,-122,0,1,1
22584,SpokaneStBridge,07/30/2016 12:00:00 AM,48,-122,0,3,3
22585,SpokaneStBridge,07/30/2016 01:00:00 AM,48,-122,3,1,4
22586,SpokaneStBridge,07/30/2016 02:00:00 AM,48,-122,4,4,8
22587,SpokaneStBridge,07/30/2016 03:00:00 AM,48,-122,0,1,1
22588,SpokaneStBridge,07/30/2016 04:00:00 AM,48,-122,1,0,1
22589,SpokaneStBridge,07/30/2016 05:00:00 AM,48,-122,1,0,1
22590,SpokaneStBridge,07/30/2016 06:00:00 AM,48,-122,12,6,18
22591,SpokaneStBridge,07/30/2016 07:00:00 AM,48,-122,6,10,16
22592,SpokaneStBridge,07/30/2016 08:00:00 AM,48,-122,19,11,30
22593,SpokaneStBridge,07/30/2016 09:00:00 AM,48,-122,23,29,52
22594,SpokaneStBridge,07/30/2016 10:00:00 AM,48,-122,31,40,71
22595,SpokaneStBridge,07/30/2016 11:00:00 AM,48,-122,38,25,63
22596,SpokaneStBridge,07/30/2016 12:00:00 PM,48,-122,30,24,54
22597,SpokaneStBridge,07/30/2016 01:00:00 PM,48,-122,42,13,55
22598,SpokaneStBridge,07/30/2016 02:00:00 PM,48,-122,32,42,74
22599,SpokaneStBridge,07/30/2016 03:00:00 PM,48,-122,27,28,55
22600,SpokaneStBridge,07/30/2016 04:00:00 PM,48,-122,21,36,57
22601,SpokaneStBridge,07/30/2016 05:00:00 PM,48,-122,28,27,55
22602,SpokaneStBridge,07/30/2016 06:00:00 PM,48,-122,21,26,47
22603,SpokaneStBridge,07/30/2016 07:00:00 PM,48,-122,19,14,33
22604,SpokaneStBridge,07/30/2016 08:00:00 PM,48,-122,12,12,24
22605,SpokaneStBridge,07/30/2016 09:00:00 PM,48,-122,2,13,15
22606,SpokaneStBridge,07/30/2016 10:00:00 PM,48,-122,10,6,16
22607,SpokaneStBridge,07/30/2016 11:00:00 PM,48,-122,1,2,3
22608,SpokaneStBridge,07/31/2016 12:00:00 AM,48,-122,2,5,7
22609,SpokaneStBridge,07/31/2016 01:00:00 AM,48,-122,3,0,3
22610,SpokaneStBridge,07/31/2016 02:00:00 AM,48,-122,2,1,3
22611,SpokaneStBridge,07/31/2016 03:00:00 AM,48,-122,0,1,1
22612,SpokaneStBridge,07/31/2016 04:00:00 AM,48,-122,2,3,5
22613,SpokaneStBridge,07/31/2016 05:00:00 AM,48,-122,2,1,3
22614,SpokaneStBridge,07/31/2016 06:00:00 AM,48,-122,11,1,12
22615,SpokaneStBridge,07/31/2016 07:00:00 AM,48,-122,8,2,10
22616,SpokaneStBridge,07/31/2016 08:00:00 AM,48,-122,16,7,23
22617,SpokaneStBridge,07/31/2016 09:00:00 AM,48,-122,14,18,32
22618,SpokaneStBridge,07/31/2016 10:00:00 AM,48,-122,23,25,48
22619,SpokaneStBridge,07/31/2016 11:00:00 AM,48,-122,25,24,49
22620,SpokaneStBridge,07/31/2016 12:00:00 PM,48,-122,50,30,80
22621,SpokaneStBridge,07/31/2016 01:00:00 PM,48,-122,26,40,66
22622,SpokaneStBridge,07/31/2016 02:00:00 PM,48,-122,30,26,56
22623,SpokaneStBridge,07/31/2016 03:00:00 PM,48,-122,25,48,73
22624,SpokaneStBridge,07/31/2016 04:00:00 PM,48,-122,37,48,85
22625,SpokaneStBridge,07/31/2016 05:00:00 PM,48,-122,32,34,66
22626,SpokaneStBridge,07/31/2016 06:00:00 PM,48,-122,12,19,31
22627,SpokaneStBridge,07/31/2016 07:00:00 PM,48,-122,14,16,30
22628,SpokaneStBridge,07/31/2016 08:00:00 PM,48,-122,7,2,9
22629,SpokaneStBridge,07/31/2016 09:00:00 PM,48,-122,7,4,11
22630,SpokaneStBridge,07/31/2016 10:00:00 PM,48,-122,2,4,6
22631,SpokaneStBridge,07/31/2016 11:00:00 PM,48,-122,3,1,4
22632,SpokaneStBridge,08/01/2016 12:00:00 AM,48,-122,0,3,3
22633,SpokaneStBridge,08/01/2016 01:00:00 AM,48,-122,1,1,2
22634,SpokaneStBridge,08/01/2016 02:00:00 AM,48,-122,1,1,2
22635,SpokaneStBridge,08/01/2016 03:00:00 AM,48,-122,1,2,3
22636,SpokaneStBridge,08/01/2016 04:00:00 AM,48,-122,10,1,11
22637,SpokaneStBridge,08/01/2016 05:00:00 AM,48,-122,24,8,32
22638,SpokaneStBridge,08/01/2016 06:00:00 AM,48,-122,59,11,70
22639,SpokaneStBridge,08/01/2016 07:00:00 AM,48,-122,144,11,155
22640,SpokaneStBridge,08/01/2016 08:00:00 AM,48,-122,125,13,138
22641,SpokaneStBridge,08/01/2016 09:00:00 AM,48,-122,61,12,73
22642,SpokaneStBridge,08/01/2016 10:00:00 AM,48,-122,16,6,22
22643,SpokaneStBridge,08/01/2016 11:00:00 AM,48,-122,11,12,23
22644,SpokaneStBridge,08/01/2016 12:00:00 PM,48,-122,9,16,25
22645,SpokaneStBridge,08/01/2016 01:00:00 PM,48,-122,10,9,19
22646,SpokaneStBridge,08/01/2016 02:00:00 PM,48,-122,15,14,29
22647,SpokaneStBridge,08/01/2016 03:00:00 PM,48,-122,13,32,45
22648,SpokaneStBridge,08/01/2016 04:00:00 PM,48,-122,20,88,108
22649,SpokaneStBridge,08/01/2016 05:00:00 PM,48,-122,25,173,198
22650,SpokaneStBridge,08/01/2016 06:00:00 PM,48,-122,13,118,131
22651,SpokaneStBridge,08/01/2016 07:00:00 PM,48,-122,13,52,65
22652,SpokaneStBridge,08/01/2016 08:00:00 PM,48,-122,15,18,33
22653,SpokaneStBridge,08/01/2016 09:00:00 PM,48,-122,12,12,24
22654,SpokaneStBridge,08/01/2016 10:00:00 PM,48,-122,3,2,5
22655,SpokaneStBridge,08/01/2016 11:00:00 PM,48,-122,0,3,3
22656,SpokaneStBridge,08/02/2016 12:00:00 AM,48,-122,1,1,2
22657,SpokaneStBridge,08/02/2016 01:00:00 AM,48,-122,1,2,3
22658,SpokaneStBridge,08/02/2016 02:00:00 AM,48,-122,1,1,2
22659,SpokaneStBridge,08/02/2016 03:00:00 AM,48,-122,2,1,3
22660,SpokaneStBridge,08/02/2016 04:00:00 AM,48,-122,8,1,9
22661,SpokaneStBridge,08/02/2016 05:00:00 AM,48,-122,17,4,21
22662,SpokaneStBridge,08/02/2016 06:00:00 AM,48,-122,50,13,63
22663,SpokaneStBridge,08/02/2016 07:00:00 AM,48,-122,117,16,133
22664,SpokaneStBridge,08/02/2016 08:00:00 AM,48,-122,116,10,126
22665,SpokaneStBridge,08/02/2016 09:00:00 AM,48,-122,51,11,62
22666,SpokaneStBridge,08/02/2016 10:00:00 AM,48,-122,19,11,30
22667,SpokaneStBridge,08/02/2016 11:00:00 AM,48,-122,8,3,11
22668,SpokaneStBridge,08/02/2016 12:00:00 PM,48,-122,9,12,21
22669,SpokaneStBridge,08/02/2016 01:00:00 PM,48,-122,14,12,26
22670,SpokaneStBridge,08/02/2016 02:00:00 PM,48,-122,9,11,20
22671,SpokaneStBridge,08/02/2016 03:00:00 PM,48,-122,13,24,37
22672,SpokaneStBridge,08/02/2016 04:00:00 PM,48,-122,22,79,101
22673,SpokaneStBridge,08/02/2016 05:00:00 PM,48,-122,24,147,171
22674,SpokaneStBridge,08/02/2016 06:00:00 PM,48,-122,13,96,109
22675,SpokaneStBridge,08/02/2016 07:00:00 PM,48,-122,9,53,62
22676,SpokaneStBridge,08/02/2016 08:00:00 PM,48,-122,10,19,29
22677,SpokaneStBridge,08/02/2016 09:00:00 PM,48,-122,4,12,16
22678,SpokaneStBridge,08/02/2016 10:00:00 PM,48,-122,18,7,25
22679,SpokaneStBridge,08/02/2016 11:00:00 PM,48,-122,1,1,2
22680,SpokaneStBridge,08/03/2016 12:00:00 AM,48,-122,0,3,3
22681,SpokaneStBridge,08/03/2016 01:00:00 AM,48,-122,2,1,3
22682,SpokaneStBridge,08/03/2016 02:00:00 AM,48,-122,1,1,2
22683,SpokaneStBridge,08/03/2016 03:00:00 AM,48,-122,2,4,6
22684,SpokaneStBridge,08/03/2016 04:00:00 AM,48,-122,5,1,6
22685,SpokaneStBridge,08/03/2016 05:00:00 AM,48,-122,14,6,20
22686,SpokaneStBridge,08/03/2016 06:00:00 AM,48,-122,74,17,91
22687,SpokaneStBridge,08/03/2016 07:00:00 AM,48,-122,155,17,172
22688,SpokaneStBridge,08/03/2016 08:00:00 AM,48,-122,150,19,169
22689,SpokaneStBridge,08/03/2016 09:00:00 AM,48,-122,54,7,61
22690,SpokaneStBridge,08/03/2016 10:00:00 AM,48,-122,16,5,21
22691,SpokaneStBridge,08/03/2016 11:00:00 AM,48,-122,21,14,35
22692,SpokaneStBridge,08/03/2016 12:00:00 PM,48,-122,15,8,23
22693,SpokaneStBridge,08/03/2016 01:00:00 PM,48,-122,11,11,22
22694,SpokaneStBridge,08/03/2016 02:00:00 PM,48,-122,23,17,40
22695,SpokaneStBridge,08/03/2016 03:00:00 PM,48,-122,20,36,56
22696,SpokaneStBridge,08/03/2016 04:00:00 PM,48,-122,28,103,131
22697,SpokaneStBridge,08/03/2016 05:00:00 PM,48,-122,30,188,218
22698,SpokaneStBridge,08/03/2016 06:00:00 PM,48,-122,24,108,132
22699,SpokaneStBridge,08/03/2016 07:00:00 PM,48,-122,11,62,73
22700,SpokaneStBridge,08/03/2016 08:00:00 PM,48,-122,20,26,46
22701,SpokaneStBridge,08/03/2016 09:00:00 PM,48,-122,8,27,35
22702,SpokaneStBridge,08/03/2016 10:00:00 PM,48,-122,5,5,10
22703,SpokaneStBridge,08/03/2016 11:00:00 PM,48,-122,2,4,6
22704,SpokaneStBridge,08/04/2016 12:00:00 AM,48,-122,0,5,5
22705,SpokaneStBridge,08/04/2016 01:00:00 AM,48,-122,1,1,2
22706,SpokaneStBridge,08/04/2016 02:00:00 AM,48,-122,1,0,1
22707,SpokaneStBridge,08/04/2016 03:00:00 AM,48,-122,1,0,1
22708,SpokaneStBridge,08/04/2016 04:00:00 AM,48,-122,9,0,9
22709,SpokaneStBridge,08/04/2016 05:00:00 AM,48,-122,23,6,29
22710,SpokaneStBridge,08/04/2016 06:00:00 AM,48,-122,71,11,82
22711,SpokaneStBridge,08/04/2016 07:00:00 AM,48,-122,140,15,155
22712,SpokaneStBridge,08/04/2016 08:00:00 AM,48,-122,154,19,173
22713,SpokaneStBridge,08/04/2016 09:00:00 AM,48,-122,71,4,75
22714,SpokaneStBridge,08/04/2016 10:00:00 AM,48,-122,28,8,36
22715,SpokaneStBridge,08/04/2016 11:00:00 AM,48,-122,12,13,25
22716,SpokaneStBridge,08/04/2016 12:00:00 PM,48,-122,18,21,39
22717,SpokaneStBridge,08/04/2016 01:00:00 PM,48,-122,20,17,37
22718,SpokaneStBridge,08/04/2016 02:00:00 PM,48,-122,12,30,42
22719,SpokaneStBridge,08/04/2016 03:00:00 PM,48,-122,21,38,59
22720,SpokaneStBridge,08/04/2016 04:00:00 PM,48,-122,22,82,104
22721,SpokaneStBridge,08/04/2016 05:00:00 PM,48,-122,26,177,203
22722,SpokaneStBridge,08/04/2016 06:00:00 PM,48,-122,28,111,139
22723,SpokaneStBridge,08/04/2016 07:00:00 PM,48,-122,15,46,61
22724,SpokaneStBridge,08/04/2016 08:00:00 PM,48,-122,20,25,45
22725,SpokaneStBridge,08/04/2016 09:00:00 PM,48,-122,11,16,27
22726,SpokaneStBridge,08/04/2016 10:00:00 PM,48,-122,13,14,27
22727,SpokaneStBridge,08/04/2016 11:00:00 PM,48,-122,1,10,11
22728,SpokaneStBridge,08/05/2016 12:00:00 AM,48,-122,1,4,5
22729,SpokaneStBridge,08/05/2016 01:00:00 AM,48,-122,1,4,5
22730,SpokaneStBridge,08/05/2016 02:00:00 AM,48,-122,1,2,3
22731,SpokaneStBridge,08/05/2016 03:00:00 AM,48,-122,0,0,0
22732,SpokaneStBridge,08/05/2016 04:00:00 AM,48,-122,8,3,11
22733,SpokaneStBridge,08/05/2016 05:00:00 AM,48,-122,13,3,16
22734,SpokaneStBridge,08/05/2016 06:00:00 AM,48,-122,54,18,72
22735,SpokaneStBridge,08/05/2016 07:00:00 AM,48,-122,117,15,132
22736,SpokaneStBridge,08/05/2016 08:00:00 AM,48,-122,126,25,151
22737,SpokaneStBridge,08/05/2016 09:00:00 AM,48,-122,42,10,52
22738,SpokaneStBridge,08/05/2016 10:00:00 AM,48,-122,26,13,39
22739,SpokaneStBridge,08/05/2016 11:00:00 AM,48,-122,29,18,47
22740,SpokaneStBridge,08/05/2016 12:00:00 PM,48,-122,24,18,42
22741,SpokaneStBridge,08/05/2016 01:00:00 PM,48,-122,26,19,45
22742,SpokaneStBridge,08/05/2016 02:00:00 PM,48,-122,26,39,65
22743,SpokaneStBridge,08/05/2016 03:00:00 PM,48,-122,18,50,68
22744,SpokaneStBridge,08/05/2016 04:00:00 PM,48,-122,24,91,115
22745,SpokaneStBridge,08/05/2016 05:00:00 PM,48,-122,26,141,167
22746,SpokaneStBridge,08/05/2016 06:00:00 PM,48,-122,22,69,91
22747,SpokaneStBridge,08/05/2016 07:00:00 PM,48,-122,23,51,74
22748,SpokaneStBridge,08/05/2016 08:00:00 PM,48,-122,5,20,25
22749,SpokaneStBridge,08/05/2016 09:00:00 PM,48,-122,1,17,18
22750,SpokaneStBridge,08/05/2016 10:00:00 PM,48,-122,5,6,11
22751,SpokaneStBridge,08/05/2016 11:00:00 PM,48,-122,2,5,7
22752,SpokaneStBridge,08/06/2016 12:00:00 AM,48,-122,3,3,6
22753,SpokaneStBridge,08/06/2016 01:00:00 AM,48,-122,1,2,3
22754,SpokaneStBridge,08/06/2016 02:00:00 AM,48,-122,0,1,1
22755,SpokaneStBridge,08/06/2016 03:00:00 AM,48,-122,1,2,3
22756,SpokaneStBridge,08/06/2016 04:00:00 AM,48,-122,3,0,3
22757,SpokaneStBridge,08/06/2016 05:00:00 AM,48,-122,7,2,9
22758,SpokaneStBridge,08/06/2016 06:00:00 AM,48,-122,10,3,13
22759,SpokaneStBridge,08/06/2016 07:00:00 AM,48,-122,18,10,28
22760,SpokaneStBridge,08/06/2016 08:00:00 AM,48,-122,19,22,41
22761,SpokaneStBridge,08/06/2016 09:00:00 AM,48,-122,20,23,43
22762,SpokaneStBridge,08/06/2016 10:00:00 AM,48,-122,19,23,42
22763,SpokaneStBridge,08/06/2016 11:00:00 AM,48,-122,37,27,64
22764,SpokaneStBridge,08/06/2016 12:00:00 PM,48,-122,42,17,59
22765,SpokaneStBridge,08/06/2016 01:00:00 PM,48,-122,29,21,50
22766,SpokaneStBridge,08/06/2016 02:00:00 PM,48,-122,18,43,61
22767,SpokaneStBridge,08/06/2016 03:00:00 PM,48,-122,32,34,66
22768,SpokaneStBridge,08/06/2016 04:00:00 PM,48,-122,61,23,84
22769,SpokaneStBridge,08/06/2016 05:00:00 PM,48,-122,34,24,58
22770,SpokaneStBridge,08/06/2016 06:00:00 PM,48,-122,22,25,47
22771,SpokaneStBridge,08/06/2016 07:00:00 PM,48,-122,16,12,28
22772,SpokaneStBridge,08/06/2016 08:00:00 PM,48,-122,10,12,22
22773,SpokaneStBridge,08/06/2016 09:00:00 PM,48,-122,7,22,29
22774,SpokaneStBridge,08/06/2016 10:00:00 PM,48,-122,5,13,18
22775,SpokaneStBridge,08/06/2016 11:00:00 PM,48,-122,5,2,7
22776,SpokaneStBridge,08/07/2016 12:00:00 AM,48,-122,1,14,15
22777,SpokaneStBridge,08/07/2016 01:00:00 AM,48,-122,3,6,9
22778,SpokaneStBridge,08/07/2016 02:00:00 AM,48,-122,2,0,2
22779,SpokaneStBridge,08/07/2016 03:00:00 AM,48,-122,0,2,2
22780,SpokaneStBridge,08/07/2016 04:00:00 AM,48,-122,0,3,3
22781,SpokaneStBridge,08/07/2016 05:00:00 AM,48,-122,3,1,4
22782,SpokaneStBridge,08/07/2016 06:00:00 AM,48,-122,5,7,12
22783,SpokaneStBridge,08/07/2016 07:00:00 AM,48,-122,19,5,24
22784,SpokaneStBridge,08/07/2016 08:00:00 AM,48,-122,16,10,26
22785,SpokaneStBridge,08/07/2016 09:00:00 AM,48,-122,22,32,54
22786,SpokaneStBridge,08/07/2016 10:00:00 AM,48,-122,30,33,63
22787,SpokaneStBridge,08/07/2016 11:00:00 AM,48,-122,34,27,61
22788,SpokaneStBridge,08/07/2016 12:00:00 PM,48,-122,20,20,40
22789,SpokaneStBridge,08/07/2016 01:00:00 PM,48,-122,20,22,42
22790,SpokaneStBridge,08/07/2016 02:00:00 PM,48,-122,34,27,61
22791,SpokaneStBridge,08/07/2016 03:00:00 PM,48,-122,16,20,36
22792,SpokaneStBridge,08/07/2016 04:00:00 PM,48,-122,15,16,31
22793,SpokaneStBridge,08/07/2016 05:00:00 PM,48,-122,25,18,43
22794,SpokaneStBridge,08/07/2016 06:00:00 PM,48,-122,7,20,27
22795,SpokaneStBridge,08/07/2016 07:00:00 PM,48,-122,2,5,7
22796,SpokaneStBridge,08/07/2016 08:00:00 PM,48,-122,4,5,9
22797,SpokaneStBridge,08/07/2016 09:00:00 PM,48,-122,5,6,11
22798,SpokaneStBridge,08/07/2016 10:00:00 PM,48,-122,0,2,2
22799,SpokaneStBridge,08/07/2016 11:00:00 PM,48,-122,1,0,1
22800,SpokaneStBridge,08/08/2016 12:00:00 AM,48,-122,3,4,7
22801,SpokaneStBridge,08/08/2016 01:00:00 AM,48,-122,2,3,5
22802,SpokaneStBridge,08/08/2016 02:00:00 AM,48,-122,1,2,3
22803,SpokaneStBridge,08/08/2016 03:00:00 AM,48,-122,2,1,3
22804,SpokaneStBridge,08/08/2016 04:00:00 AM,48,-122,5,3,8
22805,SpokaneStBridge,08/08/2016 05:00:00 AM,48,-122,20,3,23
22806,SpokaneStBridge,08/08/2016 06:00:00 AM,48,-122,55,8,63
22807,SpokaneStBridge,08/08/2016 07:00:00 AM,48,-122,115,13,128
22808,SpokaneStBridge,08/08/2016 08:00:00 AM,48,-122,125,22,147
22809,SpokaneStBridge,08/08/2016 09:00:00 AM,48,-122,35,6,41
22810,SpokaneStBridge,08/08/2016 10:00:00 AM,48,-122,14,8,22
22811,SpokaneStBridge,08/08/2016 11:00:00 AM,48,-122,8,6,14
22812,SpokaneStBridge,08/08/2016 12:00:00 PM,48,-122,12,12,24
22813,SpokaneStBridge,08/08/2016 01:00:00 PM,48,-122,13,9,22
22814,SpokaneStBridge,08/08/2016 02:00:00 PM,48,-122,9,11,20
22815,SpokaneStBridge,08/08/2016 03:00:00 PM,48,-122,12,31,43
22816,SpokaneStBridge,08/08/2016 04:00:00 PM,48,-122,25,65,90
22817,SpokaneStBridge,08/08/2016 05:00:00 PM,48,-122,28,166,194
22818,SpokaneStBridge,08/08/2016 06:00:00 PM,48,-122,20,95,115
22819,SpokaneStBridge,08/08/2016 07:00:00 PM,48,-122,15,40,55
22820,SpokaneStBridge,08/08/2016 08:00:00 PM,48,-122,13,23,36
22821,SpokaneStBridge,08/08/2016 09:00:00 PM,48,-122,2,9,11
22822,SpokaneStBridge,08/08/2016 10:00:00 PM,48,-122,1,11,12
22823,SpokaneStBridge,08/08/2016 11:00:00 PM,48,-122,4,4,8
22824,SpokaneStBridge,08/09/2016 12:00:00 AM,48,-122,0,2,2
22825,SpokaneStBridge,08/09/2016 01:00:00 AM,48,-122,4,4,8
22826,SpokaneStBridge,08/09/2016 02:00:00 AM,48,-122,1,2,3
22827,SpokaneStBridge,08/09/2016 03:00:00 AM,48,-122,2,2,4
22828,SpokaneStBridge,08/09/2016 04:00:00 AM,48,-122,6,2,8
22829,SpokaneStBridge,08/09/2016 05:00:00 AM,48,-122,23,6,29
22830,SpokaneStBridge,08/09/2016 06:00:00 AM,48,-122,70,11,81
22831,SpokaneStBridge,08/09/2016 07:00:00 AM,48,-122,146,14,160
22832,SpokaneStBridge,08/09/2016 08:00:00 AM,48,-122,104,18,122
22833,SpokaneStBridge,08/09/2016 09:00:00 AM,48,-122,79,18,97
22834,SpokaneStBridge,08/09/2016 10:00:00 AM,48,-122,19,7,26
22835,SpokaneStBridge,08/09/2016 11:00:00 AM,48,-122,13,15,28
22836,SpokaneStBridge,08/09/2016 12:00:00 PM,48,-122,13,4,17
22837,SpokaneStBridge,08/09/2016 01:00:00 PM,48,-122,8,18,26
22838,SpokaneStBridge,08/09/2016 02:00:00 PM,48,-122,20,5,25
22839,SpokaneStBridge,08/09/2016 03:00:00 PM,48,-122,23,36,59
22840,SpokaneStBridge,08/09/2016 04:00:00 PM,48,-122,18,91,109
22841,SpokaneStBridge,08/09/2016 05:00:00 PM,48,-122,26,172,198
22842,SpokaneStBridge,08/09/2016 06:00:00 PM,48,-122,14,94,108
22843,SpokaneStBridge,08/09/2016 07:00:00 PM,48,-122,16,53,69
22844,SpokaneStBridge,08/09/2016 08:00:00 PM,48,-122,9,20,29
22845,SpokaneStBridge,08/09/2016 09:00:00 PM,48,-122,2,13,15
22846,SpokaneStBridge,08/09/2016 10:00:00 PM,48,-122,4,6,10
22847,SpokaneStBridge,08/09/2016 11:00:00 PM,48,-122,0,4,4
22848,SpokaneStBridge,08/10/2016 12:00:00 AM,48,-122,1,4,5
22849,SpokaneStBridge,08/10/2016 01:00:00 AM,48,-122,1,2,3
22850,SpokaneStBridge,08/10/2016 02:00:00 AM,48,-122,2,1,3
22851,SpokaneStBridge,08/10/2016 03:00:00 AM,48,-122,1,1,2
22852,SpokaneStBridge,08/10/2016 04:00:00 AM,48,-122,3,1,4
22853,SpokaneStBridge,08/10/2016 05:00:00 AM,48,-122,22,6,28
22854,SpokaneStBridge,08/10/2016 06:00:00 AM,48,-122,72,11,83
22855,SpokaneStBridge,08/10/2016 07:00:00 AM,48,-122,153,11,164
22856,SpokaneStBridge,08/10/2016 08:00:00 AM,48,-122,155,18,173
22857,SpokaneStBridge,08/10/2016 09:00:00 AM,48,-122,61,14,75
22858,SpokaneStBridge,08/10/2016 10:00:00 AM,48,-122,29,6,35
22859,SpokaneStBridge,08/10/2016 11:00:00 AM,48,-122,20,13,33
22860,SpokaneStBridge,08/10/2016 12:00:00 PM,48,-122,19,9,28
22861,SpokaneStBridge,08/10/2016 01:00:00 PM,48,-122,12,15,27
22862,SpokaneStBridge,08/10/2016 02:00:00 PM,48,-122,14,10,24
22863,SpokaneStBridge,08/10/2016 03:00:00 PM,48,-122,21,28,49
22864,SpokaneStBridge,08/10/2016 04:00:00 PM,48,-122,32,78,110
22865,SpokaneStBridge,08/10/2016 05:00:00 PM,48,-122,20,186,206
22866,SpokaneStBridge,08/10/2016 06:00:00 PM,48,-122,22,102,124
22867,SpokaneStBridge,08/10/2016 07:00:00 PM,48,-122,16,46,62
22868,SpokaneStBridge,08/10/2016 08:00:00 PM,48,-122,9,32,41
22869,SpokaneStBridge,08/10/2016 09:00:00 PM,48,-122,1,17,18
22870,SpokaneStBridge,08/10/2016 10:00:00 PM,48,-122,3,9,12
22871,SpokaneStBridge,08/10/2016 11:00:00 PM,48,-122,3,7,10
22872,SpokaneStBridge,08/11/2016 12:00:00 AM,48,-122,3,2,5
22873,SpokaneStBridge,08/11/2016 01:00:00 AM,48,-122,1,3,4
22874,SpokaneStBridge,08/11/2016 02:00:00 AM,48,-122,1,0,1
22875,SpokaneStBridge,08/11/2016 03:00:00 AM,48,-122,2,0,2
22876,SpokaneStBridge,08/11/2016 04:00:00 AM,48,-122,3,0,3
22877,SpokaneStBridge,08/11/2016 05:00:00 AM,48,-122,25,5,30
22878,SpokaneStBridge,08/11/2016 06:00:00 AM,48,-122,64,14,78
22879,SpokaneStBridge,08/11/2016 07:00:00 AM,48,-122,140,21,161
22880,SpokaneStBridge,08/11/2016 08:00:00 AM,48,-122,133,15,148
22881,SpokaneStBridge,08/11/2016 09:00:00 AM,48,-122,59,10,69
22882,SpokaneStBridge,08/11/2016 10:00:00 AM,48,-122,22,7,29
22883,SpokaneStBridge,08/11/2016 11:00:00 AM,48,-122,21,11,32
22884,SpokaneStBridge,08/11/2016 12:00:00 PM,48,-122,17,10,27
22885,SpokaneStBridge,08/11/2016 01:00:00 PM,48,-122,22,12,34
22886,SpokaneStBridge,08/11/2016 02:00:00 PM,48,-122,13,23,36
22887,SpokaneStBridge,08/11/2016 03:00:00 PM,48,-122,18,34,52
22888,SpokaneStBridge,08/11/2016 04:00:00 PM,48,-122,32,85,117
22889,SpokaneStBridge,08/11/2016 05:00:00 PM,48,-122,25,166,191
22890,SpokaneStBridge,08/11/2016 06:00:00 PM,48,-122,19,116,135
22891,SpokaneStBridge,08/11/2016 07:00:00 PM,48,-122,13,61,74
22892,SpokaneStBridge,08/11/2016 08:00:00 PM,48,-122,14,33,47
22893,SpokaneStBridge,08/11/2016 09:00:00 PM,48,-122,4,11,15
22894,SpokaneStBridge,08/11/2016 10:00:00 PM,48,-122,8,9,17
22895,SpokaneStBridge,08/11/2016 11:00:00 PM,48,-122,4,4,8
22896,SpokaneStBridge,08/12/2016 12:00:00 AM,48,-122,4,7,11
22897,SpokaneStBridge,08/12/2016 01:00:00 AM,48,-122,1,3,4
22898,SpokaneStBridge,08/12/2016 02:00:00 AM,48,-122,5,2,7
22899,SpokaneStBridge,08/12/2016 03:00:00 AM,48,-122,2,2,4
22900,SpokaneStBridge,08/12/2016 04:00:00 AM,48,-122,4,1,5
22901,SpokaneStBridge,08/12/2016 05:00:00 AM,48,-122,13,3,16
22902,SpokaneStBridge,08/12/2016 06:00:00 AM,48,-122,64,10,74
22903,SpokaneStBridge,08/12/2016 07:00:00 AM,48,-122,113,18,131
22904,SpokaneStBridge,08/12/2016 08:00:00 AM,48,-122,111,16,127
22905,SpokaneStBridge,08/12/2016 09:00:00 AM,48,-122,34,6,40
22906,SpokaneStBridge,08/12/2016 10:00:00 AM,48,-122,24,12,36
22907,SpokaneStBridge,08/12/2016 11:00:00 AM,48,-122,22,12,34
22908,SpokaneStBridge,08/12/2016 12:00:00 PM,48,-122,18,8,26
22909,SpokaneStBridge,08/12/2016 01:00:00 PM,48,-122,11,17,28
22910,SpokaneStBridge,08/12/2016 02:00:00 PM,48,-122,10,16,26
22911,SpokaneStBridge,08/12/2016 03:00:00 PM,48,-122,16,36,52
22912,SpokaneStBridge,08/12/2016 04:00:00 PM,48,-122,27,96,123
22913,SpokaneStBridge,08/12/2016 05:00:00 PM,48,-122,23,115,138
22914,SpokaneStBridge,08/12/2016 06:00:00 PM,48,-122,9,58,67
22915,SpokaneStBridge,08/12/2016 07:00:00 PM,48,-122,12,29,41
22916,SpokaneStBridge,08/12/2016 08:00:00 PM,48,-122,15,25,40
22917,SpokaneStBridge,08/12/2016 09:00:00 PM,48,-122,10,14,24
22918,SpokaneStBridge,08/12/2016 10:00:00 PM,48,-122,5,4,9
22919,SpokaneStBridge,08/12/2016 11:00:00 PM,48,-122,5,5,10
22920,SpokaneStBridge,08/13/2016 12:00:00 AM,48,-122,2,7,9
22921,SpokaneStBridge,08/13/2016 01:00:00 AM,48,-122,1,4,5
22922,SpokaneStBridge,08/13/2016 02:00:00 AM,48,-122,1,1,2
22923,SpokaneStBridge,08/13/2016 03:00:00 AM,48,-122,0,1,1
22924,SpokaneStBridge,08/13/2016 04:00:00 AM,48,-122,3,0,3
22925,SpokaneStBridge,08/13/2016 05:00:00 AM,48,-122,5,0,5
22926,SpokaneStBridge,08/13/2016 06:00:00 AM,48,-122,11,4,15
22927,SpokaneStBridge,08/13/2016 07:00:00 AM,48,-122,10,9,19
22928,SpokaneStBridge,08/13/2016 08:00:00 AM,48,-122,23,15,38
22929,SpokaneStBridge,08/13/2016 09:00:00 AM,48,-122,30,21,51
22930,SpokaneStBridge,08/13/2016 10:00:00 AM,48,-122,30,23,53
22931,SpokaneStBridge,08/13/2016 11:00:00 AM,48,-122,31,47,78
22932,SpokaneStBridge,08/13/2016 12:00:00 PM,48,-122,26,39,65
22933,SpokaneStBridge,08/13/2016 01:00:00 PM,48,-122,33,34,67
22934,SpokaneStBridge,08/13/2016 02:00:00 PM,48,-122,34,41,75
22935,SpokaneStBridge,08/13/2016 03:00:00 PM,48,-122,34,28,62
22936,SpokaneStBridge,08/13/2016 04:00:00 PM,48,-122,16,29,45
22937,SpokaneStBridge,08/13/2016 05:00:00 PM,48,-122,19,16,35
22938,SpokaneStBridge,08/13/2016 06:00:00 PM,48,-122,11,19,30
22939,SpokaneStBridge,08/13/2016 07:00:00 PM,48,-122,18,10,28
22940,SpokaneStBridge,08/13/2016 08:00:00 PM,48,-122,11,13,24
22941,SpokaneStBridge,08/13/2016 09:00:00 PM,48,-122,5,4,9
22942,SpokaneStBridge,08/13/2016 10:00:00 PM,48,-122,2,4,6
22943,SpokaneStBridge,08/13/2016 11:00:00 PM,48,-122,1,3,4
22944,SpokaneStBridge,08/14/2016 12:00:00 AM,48,-122,2,1,3
22945,SpokaneStBridge,08/14/2016 01:00:00 AM,48,-122,0,1,1
22946,SpokaneStBridge,08/14/2016 02:00:00 AM,48,-122,2,2,4
22947,SpokaneStBridge,08/14/2016 03:00:00 AM,48,-122,1,0,1
22948,SpokaneStBridge,08/14/2016 04:00:00 AM,48,-122,0,4,4
22949,SpokaneStBridge,08/14/2016 05:00:00 AM,48,-122,0,0,0
22950,SpokaneStBridge,08/14/2016 06:00:00 AM,48,-122,11,1,12
22951,SpokaneStBridge,08/14/2016 07:00:00 AM,48,-122,17,14,31
22952,SpokaneStBridge,08/14/2016 08:00:00 AM,48,-122,23,17,40
22953,SpokaneStBridge,08/14/2016 09:00:00 AM,48,-122,30,27,57
22954,SpokaneStBridge,08/14/2016 10:00:00 AM,48,-122,78,36,114
22955,SpokaneStBridge,08/14/2016 11:00:00 AM,48,-122,106,50,156
22956,SpokaneStBridge,08/14/2016 12:00:00 PM,48,-122,75,38,113
22957,SpokaneStBridge,08/14/2016 01:00:00 PM,48,-122,40,35,75
22958,SpokaneStBridge,08/14/2016 02:00:00 PM,48,-122,37,40,77
22959,SpokaneStBridge,08/14/2016 03:00:00 PM,48,-122,37,44,81
22960,SpokaneStBridge,08/14/2016 04:00:00 PM,48,-122,30,23,53
22961,SpokaneStBridge,08/14/2016 05:00:00 PM,48,-122,31,18,49
22962,SpokaneStBridge,08/14/2016 06:00:00 PM,48,-122,18,30,48
22963,SpokaneStBridge,08/14/2016 07:00:00 PM,48,-122,15,22,37
22964,SpokaneStBridge,08/14/2016 08:00:00 PM,48,-122,6,15,21
22965,SpokaneStBridge,08/14/2016 09:00:00 PM,48,-122,6,9,15
22966,SpokaneStBridge,08/14/2016 10:00:00 PM,48,-122,5,2,7
22967,SpokaneStBridge,08/14/2016 11:00:00 PM,48,-122,1,1,2
22968,SpokaneStBridge,08/15/2016 12:00:00 AM,48,-122,0,0,0
22969,SpokaneStBridge,08/15/2016 01:00:00 AM,48,-122,1,2,3
22970,SpokaneStBridge,08/15/2016 02:00:00 AM,48,-122,1,1,2
22971,SpokaneStBridge,08/15/2016 03:00:00 AM,48,-122,0,2,2
22972,SpokaneStBridge,08/15/2016 04:00:00 AM,48,-122,11,1,12
22973,SpokaneStBridge,08/15/2016 05:00:00 AM,48,-122,26,10,36
22974,SpokaneStBridge,08/15/2016 06:00:00 AM,48,-122,63,15,78
22975,SpokaneStBridge,08/15/2016 07:00:00 AM,48,-122,137,14,151
22976,SpokaneStBridge,08/15/2016 08:00:00 AM,48,-122,135,21,156
22977,SpokaneStBridge,08/15/2016 09:00:00 AM,48,-122,47,11,58
22978,SpokaneStBridge,08/15/2016 10:00:00 AM,48,-122,29,4,33
22979,SpokaneStBridge,08/15/2016 11:00:00 AM,48,-122,8,6,14
22980,SpokaneStBridge,08/15/2016 12:00:00 PM,48,-122,14,12,26
22981,SpokaneStBridge,08/15/2016 01:00:00 PM,48,-122,10,15,25
22982,SpokaneStBridge,08/15/2016 02:00:00 PM,48,-122,17,14,31
22983,SpokaneStBridge,08/15/2016 03:00:00 PM,48,-122,13,29,42
22984,SpokaneStBridge,08/15/2016 04:00:00 PM,48,-122,24,79,103
22985,SpokaneStBridge,08/15/2016 05:00:00 PM,48,-122,20,173,193
22986,SpokaneStBridge,08/15/2016 06:00:00 PM,48,-122,13,134,147
22987,SpokaneStBridge,08/15/2016 07:00:00 PM,48,-122,26,43,69
22988,SpokaneStBridge,08/15/2016 08:00:00 PM,48,-122,12,27,39
22989,SpokaneStBridge,08/15/2016 09:00:00 PM,48,-122,7,16,23
22990,SpokaneStBridge,08/15/2016 10:00:00 PM,48,-122,1,6,7
22991,SpokaneStBridge,08/15/2016 11:00:00 PM,48,-122,2,3,5
22992,SpokaneStBridge,08/16/2016 12:00:00 AM,48,-122,2,3,5
22993,SpokaneStBridge,08/16/2016 01:00:00 AM,48,-122,0,1,1
22994,SpokaneStBridge,08/16/2016 02:00:00 AM,48,-122,1,0,1
22995,SpokaneStBridge,08/16/2016 03:00:00 AM,48,-122,2,1,3
22996,SpokaneStBridge,08/16/2016 04:00:00 AM,48,-122,6,1,7
22997,SpokaneStBridge,08/16/2016 05:00:00 AM,48,-122,22,3,25
22998,SpokaneStBridge,08/16/2016 06:00:00 AM,48,-122,62,13,75
22999,SpokaneStBridge,08/16/2016 07:00:00 AM,48,-122,137,23,160
23000,SpokaneStBridge,08/16/2016 08:00:00 AM,48,-122,136,29,165
23001,SpokaneStBridge,08/16/2016 09:00:00 AM,48,-122,59,12,71
23002,SpokaneStBridge,08/16/2016 10:00:00 AM,48,-122,23,5,28
23003,SpokaneStBridge,08/16/2016 11:00:00 AM,48,-122,14,16,30
23004,SpokaneStBridge,08/16/2016 12:00:00 PM,48,-122,12,13,25
23005,SpokaneStBridge,08/16/2016 01:00:00 PM,48,-122,16,11,27
23006,SpokaneStBridge,08/16/2016 02:00:00 PM,48,-122,18,15,33
23007,SpokaneStBridge,08/16/2016 03:00:00 PM,48,-122,18,42,60
23008,SpokaneStBridge,08/16/2016 04:00:00 PM,48,-122,26,88,114
23009,SpokaneStBridge,08/16/2016 05:00:00 PM,48,-122,33,179,212
23010,SpokaneStBridge,08/16/2016 06:00:00 PM,48,-122,23,144,167
23011,SpokaneStBridge,08/16/2016 07:00:00 PM,48,-122,11,42,53
23012,SpokaneStBridge,08/16/2016 08:00:00 PM,48,-122,9,21,30
23013,SpokaneStBridge,08/16/2016 09:00:00 PM,48,-122,7,14,21
23014,SpokaneStBridge,08/16/2016 10:00:00 PM,48,-122,1,7,8
23015,SpokaneStBridge,08/16/2016 11:00:00 PM,48,-122,3,3,6
23016,SpokaneStBridge,08/17/2016 12:00:00 AM,48,-122,0,1,1
23017,SpokaneStBridge,08/17/2016 01:00:00 AM,48,-122,0,1,1
23018,SpokaneStBridge,08/17/2016 02:00:00 AM,48,-122,2,1,3
23019,SpokaneStBridge,08/17/2016 03:00:00 AM,48,-122,2,1,3
23020,SpokaneStBridge,08/17/2016 04:00:00 AM,48,-122,7,0,7
23021,SpokaneStBridge,08/17/2016 05:00:00 AM,48,-122,21,4,25
23022,SpokaneStBridge,08/17/2016 06:00:00 AM,48,-122,62,20,82
23023,SpokaneStBridge,08/17/2016 07:00:00 AM,48,-122,148,19,167
23024,SpokaneStBridge,08/17/2016 08:00:00 AM,48,-122,148,17,165
23025,SpokaneStBridge,08/17/2016 09:00:00 AM,48,-122,62,11,73
23026,SpokaneStBridge,08/17/2016 10:00:00 AM,48,-122,22,10,32
23027,SpokaneStBridge,08/17/2016 11:00:00 AM,48,-122,11,11,22
23028,SpokaneStBridge,08/17/2016 12:00:00 PM,48,-122,13,12,25
23029,SpokaneStBridge,08/17/2016 01:00:00 PM,48,-122,7,16,23
23030,SpokaneStBridge,08/17/2016 02:00:00 PM,48,-122,10,16,26
23031,SpokaneStBridge,08/17/2016 03:00:00 PM,48,-122,11,27,38
23032,SpokaneStBridge,08/17/2016 04:00:00 PM,48,-122,26,78,104
23033,SpokaneStBridge,08/17/2016 05:00:00 PM,48,-122,21,185,206
23034,SpokaneStBridge,08/17/2016 06:00:00 PM,48,-122,24,127,151
23035,SpokaneStBridge,08/17/2016 07:00:00 PM,48,-122,24,63,87
23036,SpokaneStBridge,08/17/2016 08:00:00 PM,48,-122,14,27,41
23037,SpokaneStBridge,08/17/2016 09:00:00 PM,48,-122,5,10,15
23038,SpokaneStBridge,08/17/2016 10:00:00 PM,48,-122,2,5,7
23039,SpokaneStBridge,08/17/2016 11:00:00 PM,48,-122,1,4,5
23040,SpokaneStBridge,08/18/2016 12:00:00 AM,48,-122,2,2,4
23041,SpokaneStBridge,08/18/2016 01:00:00 AM,48,-122,2,1,3
23042,SpokaneStBridge,08/18/2016 02:00:00 AM,48,-122,1,2,3
23043,SpokaneStBridge,08/18/2016 03:00:00 AM,48,-122,1,2,3
23044,SpokaneStBridge,08/18/2016 04:00:00 AM,48,-122,6,1,7
23045,SpokaneStBridge,08/18/2016 05:00:00 AM,48,-122,23,5,28
23046,SpokaneStBridge,08/18/2016 06:00:00 AM,48,-122,48,13,61
23047,SpokaneStBridge,08/18/2016 07:00:00 AM,48,-122,155,21,176
23048,SpokaneStBridge,08/18/2016 08:00:00 AM,48,-122,130,21,151
23049,SpokaneStBridge,08/18/2016 09:00:00 AM,48,-122,52,9,61
23050,SpokaneStBridge,08/18/2016 10:00:00 AM,48,-122,25,18,43
23051,SpokaneStBridge,08/18/2016 11:00:00 AM,48,-122,14,17,31
23052,SpokaneStBridge,08/18/2016 12:00:00 PM,48,-122,14,13,27
23053,SpokaneStBridge,08/18/2016 01:00:00 PM,48,-122,13,12,25
23054,SpokaneStBridge,08/18/2016 02:00:00 PM,48,-122,14,18,32
23055,SpokaneStBridge,08/18/2016 03:00:00 PM,48,-122,17,39,56
23056,SpokaneStBridge,08/18/2016 04:00:00 PM,48,-122,36,95,131
23057,SpokaneStBridge,08/18/2016 05:00:00 PM,48,-122,35,132,167
23058,SpokaneStBridge,08/18/2016 06:00:00 PM,48,-122,21,116,137
23059,SpokaneStBridge,08/18/2016 07:00:00 PM,48,-122,21,56,77
23060,SpokaneStBridge,08/18/2016 08:00:00 PM,48,-122,10,27,37
23061,SpokaneStBridge,08/18/2016 09:00:00 PM,48,-122,7,17,24
23062,SpokaneStBridge,08/18/2016 10:00:00 PM,48,-122,2,10,12
23063,SpokaneStBridge,08/18/2016 11:00:00 PM,48,-122,2,8,10
23064,SpokaneStBridge,08/19/2016 12:00:00 AM,48,-122,0,2,2
23065,SpokaneStBridge,08/19/2016 01:00:00 AM,48,-122,1,0,1
23066,SpokaneStBridge,08/19/2016 02:00:00 AM,48,-122,1,1,2
23067,SpokaneStBridge,08/19/2016 03:00:00 AM,48,-122,2,1,3
23068,SpokaneStBridge,08/19/2016 04:00:00 AM,48,-122,6,1,7
23069,SpokaneStBridge,08/19/2016 05:00:00 AM,48,-122,10,5,15
23070,SpokaneStBridge,08/19/2016 06:00:00 AM,48,-122,40,10,50
23071,SpokaneStBridge,08/19/2016 07:00:00 AM,48,-122,98,16,114
23072,SpokaneStBridge,08/19/2016 08:00:00 AM,48,-122,99,14,113
23073,SpokaneStBridge,08/19/2016 09:00:00 AM,48,-122,34,12,46
23074,SpokaneStBridge,08/19/2016 10:00:00 AM,48,-122,18,9,27
23075,SpokaneStBridge,08/19/2016 11:00:00 AM,48,-122,19,9,28
23076,SpokaneStBridge,08/19/2016 12:00:00 PM,48,-122,6,10,16
23077,SpokaneStBridge,08/19/2016 01:00:00 PM,48,-122,12,9,21
23078,SpokaneStBridge,08/19/2016 02:00:00 PM,48,-122,21,16,37
23079,SpokaneStBridge,08/19/2016 03:00:00 PM,48,-122,19,30,49
23080,SpokaneStBridge,08/19/2016 04:00:00 PM,48,-122,12,75,87
23081,SpokaneStBridge,08/19/2016 05:00:00 PM,48,-122,9,105,114
23082,SpokaneStBridge,08/19/2016 06:00:00 PM,48,-122,11,63,74
23083,SpokaneStBridge,08/19/2016 07:00:00 PM,48,-122,13,31,44
23084,SpokaneStBridge,08/19/2016 08:00:00 PM,48,-122,7,16,23
23085,SpokaneStBridge,08/19/2016 09:00:00 PM,48,-122,8,21,29
23086,SpokaneStBridge,08/19/2016 10:00:00 PM,48,-122,4,4,8
23087,SpokaneStBridge,08/19/2016 11:00:00 PM,48,-122,3,4,7
23088,SpokaneStBridge,08/20/2016 12:00:00 AM,48,-122,0,4,4
23089,SpokaneStBridge,08/20/2016 01:00:00 AM,48,-122,0,1,1
23090,SpokaneStBridge,08/20/2016 02:00:00 AM,48,-122,0,3,3
23091,SpokaneStBridge,08/20/2016 03:00:00 AM,48,-122,0,0,0
23092,SpokaneStBridge,08/20/2016 04:00:00 AM,48,-122,1,1,2
23093,SpokaneStBridge,08/20/2016 05:00:00 AM,48,-122,2,2,4
23094,SpokaneStBridge,08/20/2016 06:00:00 AM,48,-122,9,3,12
23095,SpokaneStBridge,08/20/2016 07:00:00 AM,48,-122,12,14,26
23096,SpokaneStBridge,08/20/2016 08:00:00 AM,48,-122,9,17,26
23097,SpokaneStBridge,08/20/2016 09:00:00 AM,48,-122,13,33,46
23098,SpokaneStBridge,08/20/2016 10:00:00 AM,48,-122,36,28,64
23099,SpokaneStBridge,08/20/2016 11:00:00 AM,48,-122,23,87,110
23100,SpokaneStBridge,08/20/2016 12:00:00 PM,48,-122,45,32,77
23101,SpokaneStBridge,08/20/2016 01:00:00 PM,48,-122,20,26,46
23102,SpokaneStBridge,08/20/2016 02:00:00 PM,48,-122,21,40,61
23103,SpokaneStBridge,08/20/2016 03:00:00 PM,48,-122,25,27,52
23104,SpokaneStBridge,08/20/2016 04:00:00 PM,48,-122,26,23,49
23105,SpokaneStBridge,08/20/2016 05:00:00 PM,48,-122,17,18,35
23106,SpokaneStBridge,08/20/2016 06:00:00 PM,48,-122,17,9,26
23107,SpokaneStBridge,08/20/2016 07:00:00 PM,48,-122,10,12,22
23108,SpokaneStBridge,08/20/2016 08:00:00 PM,48,-122,10,12,22
23109,SpokaneStBridge,08/20/2016 09:00:00 PM,48,-122,9,7,16
23110,SpokaneStBridge,08/20/2016 10:00:00 PM,48,-122,4,6,10
23111,SpokaneStBridge,08/20/2016 11:00:00 PM,48,-122,0,1,1
23112,SpokaneStBridge,08/21/2016 12:00:00 AM,48,-122,4,3,7
23113,SpokaneStBridge,08/21/2016 01:00:00 AM,48,-122,2,2,4
23114,SpokaneStBridge,08/21/2016 02:00:00 AM,48,-122,2,0,2
23115,SpokaneStBridge,08/21/2016 03:00:00 AM,48,-122,0,1,1
23116,SpokaneStBridge,08/21/2016 04:00:00 AM,48,-122,0,2,2
23117,SpokaneStBridge,08/21/2016 05:00:00 AM,48,-122,1,1,2
23118,SpokaneStBridge,08/21/2016 06:00:00 AM,48,-122,4,1,5
23119,SpokaneStBridge,08/21/2016 07:00:00 AM,48,-122,11,0,11
23120,SpokaneStBridge,08/21/2016 08:00:00 AM,48,-122,10,14,24
23121,SpokaneStBridge,08/21/2016 09:00:00 AM,48,-122,9,22,31
23122,SpokaneStBridge,08/21/2016 10:00:00 AM,48,-122,15,14,29
23123,SpokaneStBridge,08/21/2016 11:00:00 AM,48,-122,22,21,43
23124,SpokaneStBridge,08/21/2016 12:00:00 PM,48,-122,32,27,59
23125,SpokaneStBridge,08/21/2016 01:00:00 PM,48,-122,21,27,48
23126,SpokaneStBridge,08/21/2016 02:00:00 PM,48,-122,29,25,54
23127,SpokaneStBridge,08/21/2016 03:00:00 PM,48,-122,26,28,54
23128,SpokaneStBridge,08/21/2016 04:00:00 PM,48,-122,31,28,59
23129,SpokaneStBridge,08/21/2016 05:00:00 PM,48,-122,24,24,48
23130,SpokaneStBridge,08/21/2016 06:00:00 PM,48,-122,19,22,41
23131,SpokaneStBridge,08/21/2016 07:00:00 PM,48,-122,21,14,35
23132,SpokaneStBridge,08/21/2016 08:00:00 PM,48,-122,2,17,19
23133,SpokaneStBridge,08/21/2016 09:00:00 PM,48,-122,4,18,22
23134,SpokaneStBridge,08/21/2016 10:00:00 PM,48,-122,1,11,12
23135,SpokaneStBridge,08/21/2016 11:00:00 PM,48,-122,2,2,4
23136,SpokaneStBridge,08/22/2016 12:00:00 AM,48,-122,1,2,3
23137,SpokaneStBridge,08/22/2016 01:00:00 AM,48,-122,1,2,3
23138,SpokaneStBridge,08/22/2016 02:00:00 AM,48,-122,1,0,1
23139,SpokaneStBridge,08/22/2016 03:00:00 AM,48,-122,1,1,2
23140,SpokaneStBridge,08/22/2016 04:00:00 AM,48,-122,7,1,8
23141,SpokaneStBridge,08/22/2016 05:00:00 AM,48,-122,20,7,27
23142,SpokaneStBridge,08/22/2016 06:00:00 AM,48,-122,58,13,71
23143,SpokaneStBridge,08/22/2016 07:00:00 AM,48,-122,138,16,154
23144,SpokaneStBridge,08/22/2016 08:00:00 AM,48,-122,132,17,149
23145,SpokaneStBridge,08/22/2016 09:00:00 AM,48,-122,45,14,59
23146,SpokaneStBridge,08/22/2016 10:00:00 AM,48,-122,17,5,22
23147,SpokaneStBridge,08/22/2016 11:00:00 AM,48,-122,19,8,27
23148,SpokaneStBridge,08/22/2016 12:00:00 PM,48,-122,11,9,20
23149,SpokaneStBridge,08/22/2016 01:00:00 PM,48,-122,7,14,21
23150,SpokaneStBridge,08/22/2016 02:00:00 PM,48,-122,17,17,34
23151,SpokaneStBridge,08/22/2016 03:00:00 PM,48,-122,14,33,47
23152,SpokaneStBridge,08/22/2016 04:00:00 PM,48,-122,19,84,103
23153,SpokaneStBridge,08/22/2016 05:00:00 PM,48,-122,16,170,186
23154,SpokaneStBridge,08/22/2016 06:00:00 PM,48,-122,17,128,145
23155,SpokaneStBridge,08/22/2016 07:00:00 PM,48,-122,12,46,58
23156,SpokaneStBridge,08/22/2016 08:00:00 PM,48,-122,7,26,33
23157,SpokaneStBridge,08/22/2016 09:00:00 PM,48,-122,12,12,24
23158,SpokaneStBridge,08/22/2016 10:00:00 PM,48,-122,10,7,17
23159,SpokaneStBridge,08/22/2016 11:00:00 PM,48,-122,2,3,5
23160,SpokaneStBridge,08/23/2016 12:00:00 AM,48,-122,1,2,3
23161,SpokaneStBridge,08/23/2016 01:00:00 AM,48,-122,2,3,5
23162,SpokaneStBridge,08/23/2016 02:00:00 AM,48,-122,1,2,3
23163,SpokaneStBridge,08/23/2016 03:00:00 AM,48,-122,6,0,6
23164,SpokaneStBridge,08/23/2016 04:00:00 AM,48,-122,8,5,13
23165,SpokaneStBridge,08/23/2016 05:00:00 AM,48,-122,26,4,30
23166,SpokaneStBridge,08/23/2016 06:00:00 AM,48,-122,68,17,85
23167,SpokaneStBridge,08/23/2016 07:00:00 AM,48,-122,145,12,157
23168,SpokaneStBridge,08/23/2016 08:00:00 AM,48,-122,146,13,159
23169,SpokaneStBridge,08/23/2016 09:00:00 AM,48,-122,58,11,69
23170,SpokaneStBridge,08/23/2016 10:00:00 AM,48,-122,17,9,26
23171,SpokaneStBridge,08/23/2016 11:00:00 AM,48,-122,18,9,27
23172,SpokaneStBridge,08/23/2016 12:00:00 PM,48,-122,10,13,23
23173,SpokaneStBridge,08/23/2016 01:00:00 PM,48,-122,10,22,32
23174,SpokaneStBridge,08/23/2016 02:00:00 PM,48,-122,20,15,35
23175,SpokaneStBridge,08/23/2016 03:00:00 PM,48,-122,15,38,53
23176,SpokaneStBridge,08/23/2016 04:00:00 PM,48,-122,26,94,120
23177,SpokaneStBridge,08/23/2016 05:00:00 PM,48,-122,25,181,206
23178,SpokaneStBridge,08/23/2016 06:00:00 PM,48,-122,23,119,142
23179,SpokaneStBridge,08/23/2016 07:00:00 PM,48,-122,16,52,68
23180,SpokaneStBridge,08/23/2016 08:00:00 PM,48,-122,6,25,31
23181,SpokaneStBridge,08/23/2016 09:00:00 PM,48,-122,5,16,21
23182,SpokaneStBridge,08/23/2016 10:00:00 PM,48,-122,3,10,13
23183,SpokaneStBridge,08/23/2016 11:00:00 PM,48,-122,1,5,6
23184,SpokaneStBridge,08/24/2016 12:00:00 AM,48,-122,1,3,4
23185,SpokaneStBridge,08/24/2016 01:00:00 AM,48,-122,0,0,0
23186,SpokaneStBridge,08/24/2016 02:00:00 AM,48,-122,2,0,2
23187,SpokaneStBridge,08/24/2016 03:00:00 AM,48,-122,2,0,2
23188,SpokaneStBridge,08/24/2016 04:00:00 AM,48,-122,7,3,10
23189,SpokaneStBridge,08/24/2016 05:00:00 AM,48,-122,21,9,30
23190,SpokaneStBridge,08/24/2016 06:00:00 AM,48,-122,65,13,78
23191,SpokaneStBridge,08/24/2016 07:00:00 AM,48,-122,141,21,162
23192,SpokaneStBridge,08/24/2016 08:00:00 AM,48,-122,140,15,155
23193,SpokaneStBridge,08/24/2016 09:00:00 AM,48,-122,69,9,78
23194,SpokaneStBridge,08/24/2016 10:00:00 AM,48,-122,26,8,34
23195,SpokaneStBridge,08/24/2016 11:00:00 AM,48,-122,12,4,16
23196,SpokaneStBridge,08/24/2016 12:00:00 PM,48,-122,16,14,30
23197,SpokaneStBridge,08/24/2016 01:00:00 PM,48,-122,8,18,26
23198,SpokaneStBridge,08/24/2016 02:00:00 PM,48,-122,18,21,39
23199,SpokaneStBridge,08/24/2016 03:00:00 PM,48,-122,18,54,72
23200,SpokaneStBridge,08/24/2016 04:00:00 PM,48,-122,19,112,131
23201,SpokaneStBridge,08/24/2016 05:00:00 PM,48,-122,27,175,202
23202,SpokaneStBridge,08/24/2016 06:00:00 PM,48,-122,24,107,131
23203,SpokaneStBridge,08/24/2016 07:00:00 PM,48,-122,9,61,70
23204,SpokaneStBridge,08/24/2016 08:00:00 PM,48,-122,17,28,45
23205,SpokaneStBridge,08/24/2016 09:00:00 PM,48,-122,5,24,29
23206,SpokaneStBridge,08/24/2016 10:00:00 PM,48,-122,4,3,7
23207,SpokaneStBridge,08/24/2016 11:00:00 PM,48,-122,1,5,6
23208,SpokaneStBridge,08/25/2016 12:00:00 AM,48,-122,0,1,1
23209,SpokaneStBridge,08/25/2016 01:00:00 AM,48,-122,0,1,1
23210,SpokaneStBridge,08/25/2016 02:00:00 AM,48,-122,2,1,3
23211,SpokaneStBridge,08/25/2016 03:00:00 AM,48,-122,2,0,2
23212,SpokaneStBridge,08/25/2016 04:00:00 AM,48,-122,5,1,6
23213,SpokaneStBridge,08/25/2016 05:00:00 AM,48,-122,21,5,26
23214,SpokaneStBridge,08/25/2016 06:00:00 AM,48,-122,71,10,81
23215,SpokaneStBridge,08/25/2016 07:00:00 AM,48,-122,142,13,155
23216,SpokaneStBridge,08/25/2016 08:00:00 AM,48,-122,141,17,158
23217,SpokaneStBridge,08/25/2016 09:00:00 AM,48,-122,44,15,59
23218,SpokaneStBridge,08/25/2016 10:00:00 AM,48,-122,23,7,30
23219,SpokaneStBridge,08/25/2016 11:00:00 AM,48,-122,24,10,34
23220,SpokaneStBridge,08/25/2016 12:00:00 PM,48,-122,19,14,33
23221,SpokaneStBridge,08/25/2016 01:00:00 PM,48,-122,15,12,27
23222,SpokaneStBridge,08/25/2016 02:00:00 PM,48,-122,5,10,15
23223,SpokaneStBridge,08/25/2016 03:00:00 PM,48,-122,10,42,52
23224,SpokaneStBridge,08/25/2016 04:00:00 PM,48,-122,26,93,119
23225,SpokaneStBridge,08/25/2016 05:00:00 PM,48,-122,26,169,195
23226,SpokaneStBridge,08/25/2016 06:00:00 PM,48,-122,16,131,147
23227,SpokaneStBridge,08/25/2016 07:00:00 PM,48,-122,18,53,71
23228,SpokaneStBridge,08/25/2016 08:00:00 PM,48,-122,13,28,41
23229,SpokaneStBridge,08/25/2016 09:00:00 PM,48,-122,9,17,26
23230,SpokaneStBridge,08/25/2016 10:00:00 PM,48,-122,1,7,8
23231,SpokaneStBridge,08/25/2016 11:00:00 PM,48,-122,1,4,5
23232,SpokaneStBridge,08/26/2016 12:00:00 AM,48,-122,2,0,2
23233,SpokaneStBridge,08/26/2016 01:00:00 AM,48,-122,1,0,1
23234,SpokaneStBridge,08/26/2016 02:00:00 AM,48,-122,1,3,4
23235,SpokaneStBridge,08/26/2016 03:00:00 AM,48,-122,2,3,5
23236,SpokaneStBridge,08/26/2016 04:00:00 AM,48,-122,4,2,6
23237,SpokaneStBridge,08/26/2016 05:00:00 AM,48,-122,17,5,22
23238,SpokaneStBridge,08/26/2016 06:00:00 AM,48,-122,48,14,62
23239,SpokaneStBridge,08/26/2016 07:00:00 AM,48,-122,119,16,135
23240,SpokaneStBridge,08/26/2016 08:00:00 AM,48,-122,94,16,110
23241,SpokaneStBridge,08/26/2016 09:00:00 AM,48,-122,47,12,59
23242,SpokaneStBridge,08/26/2016 10:00:00 AM,48,-122,14,16,30
23243,SpokaneStBridge,08/26/2016 11:00:00 AM,48,-122,15,15,30
23244,SpokaneStBridge,08/26/2016 12:00:00 PM,48,-122,9,13,22
23245,SpokaneStBridge,08/26/2016 01:00:00 PM,48,-122,11,21,32
23246,SpokaneStBridge,08/26/2016 02:00:00 PM,48,-122,17,15,32
23247,SpokaneStBridge,08/26/2016 03:00:00 PM,48,-122,10,35,45
23248,SpokaneStBridge,08/26/2016 04:00:00 PM,48,-122,17,89,106
23249,SpokaneStBridge,08/26/2016 05:00:00 PM,48,-122,27,118,145
23250,SpokaneStBridge,08/26/2016 06:00:00 PM,48,-122,14,68,82
23251,SpokaneStBridge,08/26/2016 07:00:00 PM,48,-122,12,30,42
23252,SpokaneStBridge,08/26/2016 08:00:00 PM,48,-122,5,13,18
23253,SpokaneStBridge,08/26/2016 09:00:00 PM,48,-122,3,10,13
23254,SpokaneStBridge,08/26/2016 10:00:00 PM,48,-122,4,6,10
23255,SpokaneStBridge,08/26/2016 11:00:00 PM,48,-122,5,6,11
23256,SpokaneStBridge,08/27/2016 12:00:00 AM,48,-122,3,2,5
23257,SpokaneStBridge,08/27/2016 01:00:00 AM,48,-122,0,2,2
23258,SpokaneStBridge,08/27/2016 02:00:00 AM,48,-122,0,0,0
23259,SpokaneStBridge,08/27/2016 03:00:00 AM,48,-122,1,1,2
23260,SpokaneStBridge,08/27/2016 04:00:00 AM,48,-122,4,0,4
23261,SpokaneStBridge,08/27/2016 05:00:00 AM,48,-122,2,1,3
23262,SpokaneStBridge,08/27/2016 06:00:00 AM,48,-122,9,3,12
23263,SpokaneStBridge,08/27/2016 07:00:00 AM,48,-122,6,8,14
23264,SpokaneStBridge,08/27/2016 08:00:00 AM,48,-122,16,18,34
23265,SpokaneStBridge,08/27/2016 09:00:00 AM,48,-122,13,27,40
23266,SpokaneStBridge,08/27/2016 10:00:00 AM,48,-122,21,16,37
23267,SpokaneStBridge,08/27/2016 11:00:00 AM,48,-122,16,25,41
23268,SpokaneStBridge,08/27/2016 12:00:00 PM,48,-122,27,11,38
23269,SpokaneStBridge,08/27/2016 01:00:00 PM,48,-122,28,23,51
23270,SpokaneStBridge,08/27/2016 02:00:00 PM,48,-122,18,24,42
23271,SpokaneStBridge,08/27/2016 03:00:00 PM,48,-122,25,28,53
23272,SpokaneStBridge,08/27/2016 04:00:00 PM,48,-122,14,13,27
23273,SpokaneStBridge,08/27/2016 05:00:00 PM,48,-122,13,18,31
23274,SpokaneStBridge,08/27/2016 06:00:00 PM,48,-122,18,23,41
23275,SpokaneStBridge,08/27/2016 07:00:00 PM,48,-122,9,7,16
23276,SpokaneStBridge,08/27/2016 08:00:00 PM,48,-122,2,8,10
23277,SpokaneStBridge,08/27/2016 09:00:00 PM,48,-122,4,7,11
23278,SpokaneStBridge,08/27/2016 10:00:00 PM,48,-122,1,2,3
23279,SpokaneStBridge,08/27/2016 11:00:00 PM,48,-122,3,2,5
23280,SpokaneStBridge,08/28/2016 12:00:00 AM,48,-122,2,4,6
23281,SpokaneStBridge,08/28/2016 01:00:00 AM,48,-122,2,4,6
23282,SpokaneStBridge,08/28/2016 02:00:00 AM,48,-122,3,0,3
23283,SpokaneStBridge,08/28/2016 03:00:00 AM,48,-122,0,0,0
23284,SpokaneStBridge,08/28/2016 04:00:00 AM,48,-122,3,3,6
23285,SpokaneStBridge,08/28/2016 05:00:00 AM,48,-122,1,1,2
23286,SpokaneStBridge,08/28/2016 06:00:00 AM,48,-122,4,0,4
23287,SpokaneStBridge,08/28/2016 07:00:00 AM,48,-122,15,7,22
23288,SpokaneStBridge,08/28/2016 08:00:00 AM,48,-122,19,14,33
23289,SpokaneStBridge,08/28/2016 09:00:00 AM,48,-122,20,19,39
23290,SpokaneStBridge,08/28/2016 10:00:00 AM,48,-122,19,15,34
23291,SpokaneStBridge,08/28/2016 11:00:00 AM,48,-122,18,33,51
23292,SpokaneStBridge,08/28/2016 12:00:00 PM,48,-122,27,32,59
23293,SpokaneStBridge,08/28/2016 01:00:00 PM,48,-122,21,14,35
23294,SpokaneStBridge,08/28/2016 02:00:00 PM,48,-122,32,30,62
23295,SpokaneStBridge,08/28/2016 03:00:00 PM,48,-122,26,18,44
23296,SpokaneStBridge,08/28/2016 04:00:00 PM,48,-122,21,25,46
23297,SpokaneStBridge,08/28/2016 05:00:00 PM,48,-122,13,19,32
23298,SpokaneStBridge,08/28/2016 06:00:00 PM,48,-122,2,19,21
23299,SpokaneStBridge,08/28/2016 07:00:00 PM,48,-122,5,1,6
23300,SpokaneStBridge,08/28/2016 08:00:00 PM,48,-122,3,2,5
23301,SpokaneStBridge,08/28/2016 09:00:00 PM,48,-122,1,6,7
23302,SpokaneStBridge,08/28/2016 10:00:00 PM,48,-122,5,3,8
23303,SpokaneStBridge,08/28/2016 11:00:00 PM,48,-122,1,2,3
23304,SpokaneStBridge,08/29/2016 12:00:00 AM,48,-122,1,0,1
23305,SpokaneStBridge,08/29/2016 01:00:00 AM,48,-122,0,0,0
23306,SpokaneStBridge,08/29/2016 02:00:00 AM,48,-122,2,1,3
23307,SpokaneStBridge,08/29/2016 03:00:00 AM,48,-122,1,0,1
23308,SpokaneStBridge,08/29/2016 04:00:00 AM,48,-122,6,2,8
23309,SpokaneStBridge,08/29/2016 05:00:00 AM,48,-122,40,8,48
23310,SpokaneStBridge,08/29/2016 06:00:00 AM,48,-122,53,8,61
23311,SpokaneStBridge,08/29/2016 07:00:00 AM,48,-122,116,11,127
23312,SpokaneStBridge,08/29/2016 08:00:00 AM,48,-122,127,9,136
23313,SpokaneStBridge,08/29/2016 09:00:00 AM,48,-122,43,8,51
23314,SpokaneStBridge,08/29/2016 10:00:00 AM,48,-122,23,4,27
23315,SpokaneStBridge,08/29/2016 11:00:00 AM,48,-122,12,9,21
23316,SpokaneStBridge,08/29/2016 12:00:00 PM,48,-122,15,17,32
23317,SpokaneStBridge,08/29/2016 01:00:00 PM,48,-122,14,20,34
23318,SpokaneStBridge,08/29/2016 02:00:00 PM,48,-122,12,24,36
23319,SpokaneStBridge,08/29/2016 03:00:00 PM,48,-122,14,34,48
23320,SpokaneStBridge,08/29/2016 04:00:00 PM,48,-122,28,93,121
23321,SpokaneStBridge,08/29/2016 05:00:00 PM,48,-122,24,169,193
23322,SpokaneStBridge,08/29/2016 06:00:00 PM,48,-122,20,110,130
23323,SpokaneStBridge,08/29/2016 07:00:00 PM,48,-122,13,45,58
23324,SpokaneStBridge,08/29/2016 08:00:00 PM,48,-122,3,18,21
23325,SpokaneStBridge,08/29/2016 09:00:00 PM,48,-122,7,10,17
23326,SpokaneStBridge,08/29/2016 10:00:00 PM,48,-122,1,5,6
23327,SpokaneStBridge,08/29/2016 11:00:00 PM,48,-122,0,4,4
23328,SpokaneStBridge,08/30/2016 12:00:00 AM,48,-122,3,1,4
23329,SpokaneStBridge,08/30/2016 01:00:00 AM,48,-122,0,2,2
23330,SpokaneStBridge,08/30/2016 02:00:00 AM,48,-122,0,0,0
23331,SpokaneStBridge,08/30/2016 03:00:00 AM,48,-122,1,2,3
23332,SpokaneStBridge,08/30/2016 04:00:00 AM,48,-122,7,0,7
23333,SpokaneStBridge,08/30/2016 05:00:00 AM,48,-122,27,5,32
23334,SpokaneStBridge,08/30/2016 06:00:00 AM,48,-122,64,12,76
23335,SpokaneStBridge,08/30/2016 07:00:00 AM,48,-122,135,24,159
23336,SpokaneStBridge,08/30/2016 08:00:00 AM,48,-122,137,8,145
23337,SpokaneStBridge,08/30/2016 09:00:00 AM,48,-122,40,3,43
23338,SpokaneStBridge,08/30/2016 10:00:00 AM,48,-122,19,6,25
23339,SpokaneStBridge,08/30/2016 11:00:00 AM,48,-122,16,4,20
23340,SpokaneStBridge,08/30/2016 12:00:00 PM,48,-122,9,3,12
23341,SpokaneStBridge,08/30/2016 01:00:00 PM,48,-122,10,20,30
23342,SpokaneStBridge,08/30/2016 02:00:00 PM,48,-122,16,17,33
23343,SpokaneStBridge,08/30/2016 03:00:00 PM,48,-122,14,33,47
23344,SpokaneStBridge,08/30/2016 04:00:00 PM,48,-122,22,88,110
23345,SpokaneStBridge,08/30/2016 05:00:00 PM,48,-122,26,154,180
23346,SpokaneStBridge,08/30/2016 06:00:00 PM,48,-122,18,112,130
23347,SpokaneStBridge,08/30/2016 07:00:00 PM,48,-122,19,52,71
23348,SpokaneStBridge,08/30/2016 08:00:00 PM,48,-122,7,15,22
23349,SpokaneStBridge,08/30/2016 09:00:00 PM,48,-122,0,18,18
23350,SpokaneStBridge,08/30/2016 10:00:00 PM,48,-122,6,5,11
23351,SpokaneStBridge,08/30/2016 11:00:00 PM,48,-122,2,7,9
23352,SpokaneStBridge,08/31/2016 12:00:00 AM,48,-122,2,1,3
23353,SpokaneStBridge,08/31/2016 01:00:00 AM,48,-122,1,1,2
23354,SpokaneStBridge,08/31/2016 02:00:00 AM,48,-122,1,2,3
23355,SpokaneStBridge,08/31/2016 03:00:00 AM,48,-122,1,2,3
23356,SpokaneStBridge,08/31/2016 04:00:00 AM,48,-122,6,0,6
23357,SpokaneStBridge,08/31/2016 05:00:00 AM,48,-122,16,4,20
23358,SpokaneStBridge,08/31/2016 06:00:00 AM,48,-122,44,12,56
23359,SpokaneStBridge,08/31/2016 07:00:00 AM,48,-122,110,17,127
23360,SpokaneStBridge,08/31/2016 08:00:00 AM,48,-122,93,14,107
23361,SpokaneStBridge,08/31/2016 09:00:00 AM,48,-122,46,9,55
23362,SpokaneStBridge,08/31/2016 10:00:00 AM,48,-122,19,3,22
23363,SpokaneStBridge,08/31/2016 11:00:00 AM,48,-122,8,5,13
23364,SpokaneStBridge,08/31/2016 12:00:00 PM,48,-122,8,4,12
23365,SpokaneStBridge,08/31/2016 01:00:00 PM,48,-122,4,9,13
23366,SpokaneStBridge,08/31/2016 02:00:00 PM,48,-122,8,15,23
23367,SpokaneStBridge,08/31/2016 03:00:00 PM,48,-122,11,20,31
23368,SpokaneStBridge,08/31/2016 04:00:00 PM,48,-122,15,56,71
23369,SpokaneStBridge,08/31/2016 05:00:00 PM,48,-122,20,135,155
23370,SpokaneStBridge,08/31/2016 06:00:00 PM,48,-122,12,75,87
23371,SpokaneStBridge,08/31/2016 07:00:00 PM,48,-122,6,34,40
23372,SpokaneStBridge,08/31/2016 08:00:00 PM,48,-122,2,18,20
23373,SpokaneStBridge,08/31/2016 09:00:00 PM,48,-122,4,13,17
23374,SpokaneStBridge,08/31/2016 10:00:00 PM,48,-122,3,6,9
23375,SpokaneStBridge,08/31/2016 11:00:00 PM,48,-122,3,3,6
23376,SpokaneStBridge,09/01/2016 12:00:00 AM,48,-122,1,2,3
23377,SpokaneStBridge,09/01/2016 01:00:00 AM,48,-122,0,2,2
23378,SpokaneStBridge,09/01/2016 02:00:00 AM,48,-122,1,0,1
23379,SpokaneStBridge,09/01/2016 03:00:00 AM,48,-122,1,0,1
23380,SpokaneStBridge,09/01/2016 04:00:00 AM,48,-122,4,1,5
23381,SpokaneStBridge,09/01/2016 05:00:00 AM,48,-122,11,1,12
23382,SpokaneStBridge,09/01/2016 06:00:00 AM,48,-122,51,7,58
23383,SpokaneStBridge,09/01/2016 07:00:00 AM,48,-122,89,17,106
23384,SpokaneStBridge,09/01/2016 08:00:00 AM,48,-122,126,11,137
23385,SpokaneStBridge,09/01/2016 09:00:00 AM,48,-122,42,8,50
23386,SpokaneStBridge,09/01/2016 10:00:00 AM,48,-122,20,6,26
23387,SpokaneStBridge,09/01/2016 11:00:00 AM,48,-122,11,7,18
23388,SpokaneStBridge,09/01/2016 12:00:00 PM,48,-122,14,6,20
23389,SpokaneStBridge,09/01/2016 01:00:00 PM,48,-122,11,11,22
23390,SpokaneStBridge,09/01/2016 02:00:00 PM,48,-122,11,11,22
23391,SpokaneStBridge,09/01/2016 03:00:00 PM,48,-122,8,32,40
23392,SpokaneStBridge,09/01/2016 04:00:00 PM,48,-122,11,68,79
23393,SpokaneStBridge,09/01/2016 05:00:00 PM,48,-122,17,128,145
23394,SpokaneStBridge,09/01/2016 06:00:00 PM,48,-122,12,77,89
23395,SpokaneStBridge,09/01/2016 07:00:00 PM,48,-122,7,26,33
23396,SpokaneStBridge,09/01/2016 08:00:00 PM,48,-122,6,11,17
23397,SpokaneStBridge,09/01/2016 09:00:00 PM,48,-122,3,20,23
23398,SpokaneStBridge,09/01/2016 10:00:00 PM,48,-122,2,3,5
23399,SpokaneStBridge,09/01/2016 11:00:00 PM,48,-122,6,3,9
23400,SpokaneStBridge,09/02/2016 12:00:00 AM,48,-122,7,1,8
23401,SpokaneStBridge,09/02/2016 01:00:00 AM,48,-122,1,2,3
23402,SpokaneStBridge,09/02/2016 02:00:00 AM,48,-122,0,1,1
23403,SpokaneStBridge,09/02/2016 03:00:00 AM,48,-122,0,0,0
23404,SpokaneStBridge,09/02/2016 04:00:00 AM,48,-122,7,0,7
23405,SpokaneStBridge,09/02/2016 05:00:00 AM,48,-122,10,3,13
23406,SpokaneStBridge,09/02/2016 06:00:00 AM,48,-122,36,9,45
23407,SpokaneStBridge,09/02/2016 07:00:00 AM,48,-122,51,10,61
23408,SpokaneStBridge,09/02/2016 08:00:00 AM,48,-122,80,6,86
23409,SpokaneStBridge,09/02/2016 09:00:00 AM,48,-122,17,8,25
23410,SpokaneStBridge,09/02/2016 10:00:00 AM,48,-122,5,1,6
23411,SpokaneStBridge,09/02/2016 11:00:00 AM,48,-122,1,2,3
23412,SpokaneStBridge,09/02/2016 12:00:00 PM,48,-122,2,7,9
23413,SpokaneStBridge,09/02/2016 01:00:00 PM,48,-122,9,9,18
23414,SpokaneStBridge,09/02/2016 02:00:00 PM,48,-122,6,15,21
23415,SpokaneStBridge,09/02/2016 03:00:00 PM,48,-122,7,24,31
23416,SpokaneStBridge,09/02/2016 04:00:00 PM,48,-122,18,44,62
23417,SpokaneStBridge,09/02/2016 05:00:00 PM,48,-122,6,61,67
23418,SpokaneStBridge,09/02/2016 06:00:00 PM,48,-122,5,43,48
23419,SpokaneStBridge,09/02/2016 07:00:00 PM,48,-122,9,21,30
23420,SpokaneStBridge,09/02/2016 08:00:00 PM,48,-122,2,10,12
23421,SpokaneStBridge,09/02/2016 09:00:00 PM,48,-122,1,3,4
23422,SpokaneStBridge,09/02/2016 10:00:00 PM,48,-122,1,8,9
23423,SpokaneStBridge,09/02/2016 11:00:00 PM,48,-122,3,0,3
23424,SpokaneStBridge,09/03/2016 12:00:00 AM,48,-122,3,0,3
23425,SpokaneStBridge,09/03/2016 01:00:00 AM,48,-122,3,1,4
23426,SpokaneStBridge,09/03/2016 02:00:00 AM,48,-122,1,2,3
23427,SpokaneStBridge,09/03/2016 03:00:00 AM,48,-122,1,1,2
23428,SpokaneStBridge,09/03/2016 04:00:00 AM,48,-122,3,0,3
23429,SpokaneStBridge,09/03/2016 05:00:00 AM,48,-122,4,0,4
23430,SpokaneStBridge,09/03/2016 06:00:00 AM,48,-122,2,3,5
23431,SpokaneStBridge,09/03/2016 07:00:00 AM,48,-122,9,5,14
23432,SpokaneStBridge,09/03/2016 08:00:00 AM,48,-122,6,2,8
23433,SpokaneStBridge,09/03/2016 09:00:00 AM,48,-122,7,4,11
23434,SpokaneStBridge,09/03/2016 10:00:00 AM,48,-122,2,7,9
23435,SpokaneStBridge,09/03/2016 11:00:00 AM,48,-122,8,7,15
23436,SpokaneStBridge,09/03/2016 12:00:00 PM,48,-122,12,15,27
23437,SpokaneStBridge,09/03/2016 01:00:00 PM,48,-122,10,12,22
23438,SpokaneStBridge,09/03/2016 02:00:00 PM,48,-122,12,16,28
23439,SpokaneStBridge,09/03/2016 03:00:00 PM,48,-122,18,19,37
23440,SpokaneStBridge,09/03/2016 04:00:00 PM,48,-122,12,24,36
23441,SpokaneStBridge,09/03/2016 05:00:00 PM,48,-122,10,16,26
23442,SpokaneStBridge,09/03/2016 06:00:00 PM,48,-122,11,13,24
23443,SpokaneStBridge,09/03/2016 07:00:00 PM,48,-122,11,7,18
23444,SpokaneStBridge,09/03/2016 08:00:00 PM,48,-122,7,9,16
23445,SpokaneStBridge,09/03/2016 09:00:00 PM,48,-122,6,3,9
23446,SpokaneStBridge,09/03/2016 10:00:00 PM,48,-122,2,3,5
23447,SpokaneStBridge,09/03/2016 11:00:00 PM,48,-122,1,2,3
23448,SpokaneStBridge,09/04/2016 12:00:00 AM,48,-122,1,4,5
23449,SpokaneStBridge,09/04/2016 01:00:00 AM,48,-122,1,0,1
23450,SpokaneStBridge,09/04/2016 02:00:00 AM,48,-122,1,1,2
23451,SpokaneStBridge,09/04/2016 03:00:00 AM,48,-122,0,1,1
23452,SpokaneStBridge,09/04/2016 04:00:00 AM,48,-122,0,1,1
23453,SpokaneStBridge,09/04/2016 05:00:00 AM,48,-122,3,1,4
23454,SpokaneStBridge,09/04/2016 06:00:00 AM,48,-122,5,2,7
23455,SpokaneStBridge,09/04/2016 07:00:00 AM,48,-122,8,4,12
23456,SpokaneStBridge,09/04/2016 08:00:00 AM,48,-122,12,4,16
23457,SpokaneStBridge,09/04/2016 09:00:00 AM,48,-122,24,14,38
23458,SpokaneStBridge,09/04/2016 10:00:00 AM,48,-122,19,38,57
23459,SpokaneStBridge,09/04/2016 11:00:00 AM,48,-122,18,13,31
23460,SpokaneStBridge,09/04/2016 12:00:00 PM,48,-122,39,30,69
23461,SpokaneStBridge,09/04/2016 01:00:00 PM,48,-122,19,35,54
23462,SpokaneStBridge,09/04/2016 02:00:00 PM,48,-122,29,42,71
23463,SpokaneStBridge,09/04/2016 03:00:00 PM,48,-122,36,35,71
23464,SpokaneStBridge,09/04/2016 04:00:00 PM,48,-122,38,29,67
23465,SpokaneStBridge,09/04/2016 05:00:00 PM,48,-122,21,40,61
23466,SpokaneStBridge,09/04/2016 06:00:00 PM,48,-122,9,25,34
23467,SpokaneStBridge,09/04/2016 07:00:00 PM,48,-122,19,10,29
23468,SpokaneStBridge,09/04/2016 08:00:00 PM,48,-122,4,3,7
23469,SpokaneStBridge,09/04/2016 09:00:00 PM,48,-122,2,1,3
23470,SpokaneStBridge,09/04/2016 10:00:00 PM,48,-122,1,3,4
23471,SpokaneStBridge,09/04/2016 11:00:00 PM,48,-122,2,2,4
23472,SpokaneStBridge,09/05/2016 12:00:00 AM,48,-122,0,2,2
23473,SpokaneStBridge,09/05/2016 01:00:00 AM,48,-122,3,1,4
23474,SpokaneStBridge,09/05/2016 02:00:00 AM,48,-122,0,1,1
23475,SpokaneStBridge,09/05/2016 03:00:00 AM,48,-122,0,0,0
23476,SpokaneStBridge,09/05/2016 04:00:00 AM,48,-122,3,0,3
23477,SpokaneStBridge,09/05/2016 05:00:00 AM,48,-122,4,1,5
23478,SpokaneStBridge,09/05/2016 06:00:00 AM,48,-122,4,2,6
23479,SpokaneStBridge,09/05/2016 07:00:00 AM,48,-122,6,0,6
23480,SpokaneStBridge,09/05/2016 08:00:00 AM,48,-122,18,10,28
23481,SpokaneStBridge,09/05/2016 09:00:00 AM,48,-122,19,17,36
23482,SpokaneStBridge,09/05/2016 10:00:00 AM,48,-122,16,8,24
23483,SpokaneStBridge,09/05/2016 11:00:00 AM,48,-122,16,13,29
23484,SpokaneStBridge,09/05/2016 12:00:00 PM,48,-122,35,23,58
23485,SpokaneStBridge,09/05/2016 01:00:00 PM,48,-122,10,12,22
23486,SpokaneStBridge,09/05/2016 02:00:00 PM,48,-122,24,32,56
23487,SpokaneStBridge,09/05/2016 03:00:00 PM,48,-122,24,27,51
23488,SpokaneStBridge,09/05/2016 04:00:00 PM,48,-122,24,24,48
23489,SpokaneStBridge,09/05/2016 05:00:00 PM,48,-122,7,26,33
23490,SpokaneStBridge,09/05/2016 06:00:00 PM,48,-122,4,18,22
23491,SpokaneStBridge,09/05/2016 07:00:00 PM,48,-122,8,13,21
23492,SpokaneStBridge,09/05/2016 08:00:00 PM,48,-122,3,2,5
23493,SpokaneStBridge,09/05/2016 09:00:00 PM,48,-122,4,5,9
23494,SpokaneStBridge,09/05/2016 10:00:00 PM,48,-122,2,2,4
23495,SpokaneStBridge,09/05/2016 11:00:00 PM,48,-122,7,5,12
23496,SpokaneStBridge,09/06/2016 12:00:00 AM,48,-122,4,1,5
23497,SpokaneStBridge,09/06/2016 01:00:00 AM,48,-122,1,0,1
23498,SpokaneStBridge,09/06/2016 02:00:00 AM,48,-122,2,0,2
23499,SpokaneStBridge,09/06/2016 03:00:00 AM,48,-122,1,0,1
23500,SpokaneStBridge,09/06/2016 04:00:00 AM,48,-122,5,1,6
23501,SpokaneStBridge,09/06/2016 05:00:00 AM,48,-122,9,2,11
23502,SpokaneStBridge,09/06/2016 06:00:00 AM,48,-122,33,6,39
23503,SpokaneStBridge,09/06/2016 07:00:00 AM,48,-122,87,8,95
23504,SpokaneStBridge,09/06/2016 08:00:00 AM,48,-122,87,6,93
23505,SpokaneStBridge,09/06/2016 09:00:00 AM,48,-122,39,9,48
23506,SpokaneStBridge,09/06/2016 10:00:00 AM,48,-122,18,3,21
23507,SpokaneStBridge,09/06/2016 11:00:00 AM,48,-122,8,1,9
23508,SpokaneStBridge,09/06/2016 12:00:00 PM,48,-122,7,3,10
23509,SpokaneStBridge,09/06/2016 01:00:00 PM,48,-122,5,5,10
23510,SpokaneStBridge,09/06/2016 02:00:00 PM,48,-122,10,6,16
23511,SpokaneStBridge,09/06/2016 03:00:00 PM,48,-122,11,15,26
23512,SpokaneStBridge,09/06/2016 04:00:00 PM,48,-122,14,59,73
23513,SpokaneStBridge,09/06/2016 05:00:00 PM,48,-122,21,111,132
23514,SpokaneStBridge,09/06/2016 06:00:00 PM,48,-122,9,69,78
23515,SpokaneStBridge,09/06/2016 07:00:00 PM,48,-122,13,28,41
23516,SpokaneStBridge,09/06/2016 08:00:00 PM,48,-122,1,14,15
23517,SpokaneStBridge,09/06/2016 09:00:00 PM,48,-122,2,11,13
23518,SpokaneStBridge,09/06/2016 10:00:00 PM,48,-122,1,1,2
23519,SpokaneStBridge,09/06/2016 11:00:00 PM,48,-122,1,3,4
23520,SpokaneStBridge,09/07/2016 12:00:00 AM,48,-122,1,1,2
23521,SpokaneStBridge,09/07/2016 01:00:00 AM,48,-122,1,1,2
23522,SpokaneStBridge,09/07/2016 02:00:00 AM,48,-122,2,0,2
23523,SpokaneStBridge,09/07/2016 03:00:00 AM,48,-122,1,0,1
23524,SpokaneStBridge,09/07/2016 04:00:00 AM,48,-122,5,2,7
23525,SpokaneStBridge,09/07/2016 05:00:00 AM,48,-122,18,4,22
23526,SpokaneStBridge,09/07/2016 06:00:00 AM,48,-122,57,10,67
23527,SpokaneStBridge,09/07/2016 07:00:00 AM,48,-122,120,13,133
23528,SpokaneStBridge,09/07/2016 08:00:00 AM,48,-122,150,19,169
23529,SpokaneStBridge,09/07/2016 09:00:00 AM,48,-122,51,8,59
23530,SpokaneStBridge,09/07/2016 10:00:00 AM,48,-122,26,4,30
23531,SpokaneStBridge,09/07/2016 11:00:00 AM,48,-122,17,10,27
23532,SpokaneStBridge,09/07/2016 12:00:00 PM,48,-122,10,9,19
23533,SpokaneStBridge,09/07/2016 01:00:00 PM,48,-122,16,12,28
23534,SpokaneStBridge,09/07/2016 02:00:00 PM,48,-122,15,15,30
23535,SpokaneStBridge,09/07/2016 03:00:00 PM,48,-122,4,30,34
23536,SpokaneStBridge,09/07/2016 04:00:00 PM,48,-122,13,70,83
23537,SpokaneStBridge,09/07/2016 05:00:00 PM,48,-122,18,136,154
23538,SpokaneStBridge,09/07/2016 06:00:00 PM,48,-122,9,97,106
23539,SpokaneStBridge,09/07/2016 07:00:00 PM,48,-122,2,30,32
23540,SpokaneStBridge,09/07/2016 08:00:00 PM,48,-122,1,14,15
23541,SpokaneStBridge,09/07/2016 09:00:00 PM,48,-122,3,13,16
23542,SpokaneStBridge,09/07/2016 10:00:00 PM,48,-122,1,1,2
23543,SpokaneStBridge,09/07/2016 11:00:00 PM,48,-122,0,4,4
23544,SpokaneStBridge,09/08/2016 12:00:00 AM,48,-122,1,1,2
23545,SpokaneStBridge,09/08/2016 01:00:00 AM,48,-122,1,1,2
23546,SpokaneStBridge,09/08/2016 02:00:00 AM,48,-122,1,1,2
23547,SpokaneStBridge,09/08/2016 03:00:00 AM,48,-122,1,1,2
23548,SpokaneStBridge,09/08/2016 04:00:00 AM,48,-122,3,0,3
23549,SpokaneStBridge,09/08/2016 05:00:00 AM,48,-122,21,2,23
23550,SpokaneStBridge,09/08/2016 06:00:00 AM,48,-122,57,10,67
23551,SpokaneStBridge,09/08/2016 07:00:00 AM,48,-122,109,15,124
23552,SpokaneStBridge,09/08/2016 08:00:00 AM,48,-122,108,14,122
23553,SpokaneStBridge,09/08/2016 09:00:00 AM,48,-122,40,7,47
23554,SpokaneStBridge,09/08/2016 10:00:00 AM,48,-122,25,3,28
23555,SpokaneStBridge,09/08/2016 11:00:00 AM,48,-122,12,3,15
23556,SpokaneStBridge,09/08/2016 12:00:00 PM,48,-122,10,16,26
23557,SpokaneStBridge,09/08/2016 01:00:00 PM,48,-122,18,7,25
23558,SpokaneStBridge,09/08/2016 02:00:00 PM,48,-122,5,6,11
23559,SpokaneStBridge,09/08/2016 03:00:00 PM,48,-122,13,30,43
23560,SpokaneStBridge,09/08/2016 04:00:00 PM,48,-122,21,75,96
23561,SpokaneStBridge,09/08/2016 05:00:00 PM,48,-122,27,140,167
23562,SpokaneStBridge,09/08/2016 06:00:00 PM,48,-122,16,87,103
23563,SpokaneStBridge,09/08/2016 07:00:00 PM,48,-122,12,37,49
23564,SpokaneStBridge,09/08/2016 08:00:00 PM,48,-122,8,11,19
23565,SpokaneStBridge,09/08/2016 09:00:00 PM,48,-122,1,17,18
23566,SpokaneStBridge,09/08/2016 10:00:00 PM,48,-122,3,9,12
23567,SpokaneStBridge,09/08/2016 11:00:00 PM,48,-122,1,6,7
23568,SpokaneStBridge,09/09/2016 12:00:00 AM,48,-122,1,2,3
23569,SpokaneStBridge,09/09/2016 01:00:00 AM,48,-122,0,0,0
23570,SpokaneStBridge,09/09/2016 02:00:00 AM,48,-122,1,1,2
23571,SpokaneStBridge,09/09/2016 03:00:00 AM,48,-122,0,0,0
23572,SpokaneStBridge,09/09/2016 04:00:00 AM,48,-122,3,1,4
23573,SpokaneStBridge,09/09/2016 05:00:00 AM,48,-122,12,3,15
23574,SpokaneStBridge,09/09/2016 06:00:00 AM,48,-122,55,9,64
23575,SpokaneStBridge,09/09/2016 07:00:00 AM,48,-122,110,11,121
23576,SpokaneStBridge,09/09/2016 08:00:00 AM,48,-122,98,13,111
23577,SpokaneStBridge,09/09/2016 09:00:00 AM,48,-122,47,8,55
23578,SpokaneStBridge,09/09/2016 10:00:00 AM,48,-122,29,12,41
23579,SpokaneStBridge,09/09/2016 11:00:00 AM,48,-122,11,11,22
23580,SpokaneStBridge,09/09/2016 12:00:00 PM,48,-122,14,18,32
23581,SpokaneStBridge,09/09/2016 01:00:00 PM,48,-122,17,17,34
23582,SpokaneStBridge,09/09/2016 02:00:00 PM,48,-122,14,28,42
23583,SpokaneStBridge,09/09/2016 03:00:00 PM,48,-122,21,39,60
23584,SpokaneStBridge,09/09/2016 04:00:00 PM,48,-122,20,90,110
23585,SpokaneStBridge,09/09/2016 05:00:00 PM,48,-122,25,125,150
23586,SpokaneStBridge,09/09/2016 06:00:00 PM,48,-122,10,80,90
23587,SpokaneStBridge,09/09/2016 07:00:00 PM,48,-122,10,28,38
23588,SpokaneStBridge,09/09/2016 08:00:00 PM,48,-122,4,10,14
23589,SpokaneStBridge,09/09/2016 09:00:00 PM,48,-122,7,7,14
23590,SpokaneStBridge,09/09/2016 10:00:00 PM,48,-122,8,4,12
23591,SpokaneStBridge,09/09/2016 11:00:00 PM,48,-122,2,4,6
23592,SpokaneStBridge,09/10/2016 12:00:00 AM,48,-122,2,1,3
23593,SpokaneStBridge,09/10/2016 01:00:00 AM,48,-122,0,2,2
23594,SpokaneStBridge,09/10/2016 02:00:00 AM,48,-122,1,1,2
23595,SpokaneStBridge,09/10/2016 03:00:00 AM,48,-122,0,0,0
23596,SpokaneStBridge,09/10/2016 04:00:00 AM,48,-122,3,0,3
23597,SpokaneStBridge,09/10/2016 05:00:00 AM,48,-122,4,1,5
23598,SpokaneStBridge,09/10/2016 06:00:00 AM,48,-122,7,3,10
23599,SpokaneStBridge,09/10/2016 07:00:00 AM,48,-122,22,8,30
23600,SpokaneStBridge,09/10/2016 08:00:00 AM,48,-122,16,8,24
23601,SpokaneStBridge,09/10/2016 09:00:00 AM,48,-122,19,15,34
23602,SpokaneStBridge,09/10/2016 10:00:00 AM,48,-122,15,21,36
23603,SpokaneStBridge,09/10/2016 11:00:00 AM,48,-122,22,27,49
23604,SpokaneStBridge,09/10/2016 12:00:00 PM,48,-122,23,36,59
23605,SpokaneStBridge,09/10/2016 01:00:00 PM,48,-122,27,36,63
23606,SpokaneStBridge,09/10/2016 02:00:00 PM,48,-122,32,28,60
23607,SpokaneStBridge,09/10/2016 03:00:00 PM,48,-122,38,31,69
23608,SpokaneStBridge,09/10/2016 04:00:00 PM,48,-122,49,47,96
23609,SpokaneStBridge,09/10/2016 05:00:00 PM,48,-122,20,27,47
23610,SpokaneStBridge,09/10/2016 06:00:00 PM,48,-122,22,19,41
23611,SpokaneStBridge,09/10/2016 07:00:00 PM,48,-122,14,7,21
23612,SpokaneStBridge,09/10/2016 08:00:00 PM,48,-122,5,5,10
23613,SpokaneStBridge,09/10/2016 09:00:00 PM,48,-122,4,7,11
23614,SpokaneStBridge,09/10/2016 10:00:00 PM,48,-122,2,6,8
23615,SpokaneStBridge,09/10/2016 11:00:00 PM,48,-122,1,5,6
23616,SpokaneStBridge,09/11/2016 12:00:00 AM,48,-122,2,2,4
23617,SpokaneStBridge,09/11/2016 01:00:00 AM,48,-122,0,0,0
23618,SpokaneStBridge,09/11/2016 02:00:00 AM,48,-122,0,0,0
23619,SpokaneStBridge,09/11/2016 03:00:00 AM,48,-122,0,0,0
23620,SpokaneStBridge,09/11/2016 04:00:00 AM,48,-122,1,1,2
23621,SpokaneStBridge,09/11/2016 05:00:00 AM,48,-122,2,0,2
23622,SpokaneStBridge,09/11/2016 06:00:00 AM,48,-122,2,0,2
23623,SpokaneStBridge,09/11/2016 07:00:00 AM,48,-122,4,6,10
23624,SpokaneStBridge,09/11/2016 08:00:00 AM,48,-122,13,5,18
23625,SpokaneStBridge,09/11/2016 09:00:00 AM,48,-122,21,10,31
23626,SpokaneStBridge,09/11/2016 10:00:00 AM,48,-122,11,22,33
23627,SpokaneStBridge,09/11/2016 11:00:00 AM,48,-122,21,19,40
23628,SpokaneStBridge,09/11/2016 12:00:00 PM,48,-122,11,21,32
23629,SpokaneStBridge,09/11/2016 01:00:00 PM,48,-122,18,19,37
23630,SpokaneStBridge,09/11/2016 02:00:00 PM,48,-122,20,16,36
23631,SpokaneStBridge,09/11/2016 03:00:00 PM,48,-122,23,22,45
23632,SpokaneStBridge,09/11/2016 04:00:00 PM,48,-122,16,29,45
23633,SpokaneStBridge,09/11/2016 05:00:00 PM,48,-122,14,19,33
23634,SpokaneStBridge,09/11/2016 06:00:00 PM,48,-122,11,12,23
23635,SpokaneStBridge,09/11/2016 07:00:00 PM,48,-122,9,8,17
23636,SpokaneStBridge,09/11/2016 08:00:00 PM,48,-122,5,5,10
23637,SpokaneStBridge,09/11/2016 09:00:00 PM,48,-122,2,0,2
23638,SpokaneStBridge,09/11/2016 10:00:00 PM,48,-122,3,3,6
23639,SpokaneStBridge,09/11/2016 11:00:00 PM,48,-122,2,2,4
23640,SpokaneStBridge,09/12/2016 12:00:00 AM,48,-122,1,1,2
23641,SpokaneStBridge,09/12/2016 01:00:00 AM,48,-122,0,0,0
23642,SpokaneStBridge,09/12/2016 02:00:00 AM,48,-122,1,0,1
23643,SpokaneStBridge,09/12/2016 03:00:00 AM,48,-122,2,0,2
23644,SpokaneStBridge,09/12/2016 04:00:00 AM,48,-122,10,1,11
23645,SpokaneStBridge,09/12/2016 05:00:00 AM,48,-122,19,4,23
23646,SpokaneStBridge,09/12/2016 06:00:00 AM,48,-122,82,10,92
23647,SpokaneStBridge,09/12/2016 07:00:00 AM,48,-122,143,12,155
23648,SpokaneStBridge,09/12/2016 08:00:00 AM,48,-122,154,15,169
23649,SpokaneStBridge,09/12/2016 09:00:00 AM,48,-122,46,6,52
23650,SpokaneStBridge,09/12/2016 10:00:00 AM,48,-122,19,3,22
23651,SpokaneStBridge,09/12/2016 11:00:00 AM,48,-122,13,6,19
23652,SpokaneStBridge,09/12/2016 12:00:00 PM,48,-122,11,15,26
23653,SpokaneStBridge,09/12/2016 01:00:00 PM,48,-122,13,13,26
23654,SpokaneStBridge,09/12/2016 02:00:00 PM,48,-122,9,16,25
23655,SpokaneStBridge,09/12/2016 03:00:00 PM,48,-122,19,32,51
23656,SpokaneStBridge,09/12/2016 04:00:00 PM,48,-122,24,88,112
23657,SpokaneStBridge,09/12/2016 05:00:00 PM,48,-122,33,193,226
23658,SpokaneStBridge,09/12/2016 06:00:00 PM,48,-122,16,117,133
23659,SpokaneStBridge,09/12/2016 07:00:00 PM,48,-122,7,44,51
23660,SpokaneStBridge,09/12/2016 08:00:00 PM,48,-122,3,20,23
23661,SpokaneStBridge,09/12/2016 09:00:00 PM,48,-122,13,8,21
23662,SpokaneStBridge,09/12/2016 10:00:00 PM,48,-122,3,3,6
23663,SpokaneStBridge,09/12/2016 11:00:00 PM,48,-122,3,1,4
23664,SpokaneStBridge,09/13/2016 12:00:00 AM,48,-122,1,2,3
23665,SpokaneStBridge,09/13/2016 01:00:00 AM,48,-122,1,1,2
23666,SpokaneStBridge,09/13/2016 02:00:00 AM,48,-122,0,0,0
23667,SpokaneStBridge,09/13/2016 03:00:00 AM,48,-122,2,2,4
23668,SpokaneStBridge,09/13/2016 04:00:00 AM,48,-122,4,1,5
23669,SpokaneStBridge,09/13/2016 05:00:00 AM,48,-122,21,6,27
23670,SpokaneStBridge,09/13/2016 06:00:00 AM,48,-122,69,12,81
23671,SpokaneStBridge,09/13/2016 07:00:00 AM,48,-122,158,11,169
23672,SpokaneStBridge,09/13/2016 08:00:00 AM,48,-122,170,20,190
23673,SpokaneStBridge,09/13/2016 09:00:00 AM,48,-122,51,8,59
23674,SpokaneStBridge,09/13/2016 10:00:00 AM,48,-122,21,13,34
23675,SpokaneStBridge,09/13/2016 11:00:00 AM,48,-122,12,8,20
23676,SpokaneStBridge,09/13/2016 12:00:00 PM,48,-122,12,11,23
23677,SpokaneStBridge,09/13/2016 01:00:00 PM,48,-122,16,10,26
23678,SpokaneStBridge,09/13/2016 02:00:00 PM,48,-122,10,25,35
23679,SpokaneStBridge,09/13/2016 03:00:00 PM,48,-122,23,32,55
23680,SpokaneStBridge,09/13/2016 04:00:00 PM,48,-122,30,98,128
23681,SpokaneStBridge,09/13/2016 05:00:00 PM,48,-122,34,205,239
23682,SpokaneStBridge,09/13/2016 06:00:00 PM,48,-122,20,118,138
23683,SpokaneStBridge,09/13/2016 07:00:00 PM,48,-122,18,57,75
23684,SpokaneStBridge,09/13/2016 08:00:00 PM,48,-122,6,15,21
23685,SpokaneStBridge,09/13/2016 09:00:00 PM,48,-122,3,10,13
23686,SpokaneStBridge,09/13/2016 10:00:00 PM,48,-122,3,4,7
23687,SpokaneStBridge,09/13/2016 11:00:00 PM,48,-122,2,2,4
23688,SpokaneStBridge,09/14/2016 12:00:00 AM,48,-122,0,4,4
23689,SpokaneStBridge,09/14/2016 01:00:00 AM,48,-122,0,0,0
23690,SpokaneStBridge,09/14/2016 02:00:00 AM,48,-122,3,1,4
23691,SpokaneStBridge,09/14/2016 03:00:00 AM,48,-122,2,2,4
23692,SpokaneStBridge,09/14/2016 04:00:00 AM,48,-122,4,0,4
23693,SpokaneStBridge,09/14/2016 05:00:00 AM,48,-122,27,4,31
23694,SpokaneStBridge,09/14/2016 06:00:00 AM,48,-122,66,6,72
23695,SpokaneStBridge,09/14/2016 07:00:00 AM,48,-122,153,8,161
23696,SpokaneStBridge,09/14/2016 08:00:00 AM,48,-122,156,14,170
23697,SpokaneStBridge,09/14/2016 09:00:00 AM,48,-122,50,6,56
23698,SpokaneStBridge,09/14/2016 10:00:00 AM,48,-122,18,10,28
23699,SpokaneStBridge,09/14/2016 11:00:00 AM,48,-122,12,11,23
23700,SpokaneStBridge,09/14/2016 12:00:00 PM,48,-122,15,16,31
23701,SpokaneStBridge,09/14/2016 01:00:00 PM,48,-122,15,12,27
23702,SpokaneStBridge,09/14/2016 02:00:00 PM,48,-122,15,25,40
23703,SpokaneStBridge,09/14/2016 03:00:00 PM,48,-122,14,33,47
23704,SpokaneStBridge,09/14/2016 04:00:00 PM,48,-122,20,92,112
23705,SpokaneStBridge,09/14/2016 05:00:00 PM,48,-122,28,172,200
23706,SpokaneStBridge,09/14/2016 06:00:00 PM,48,-122,25,131,156
23707,SpokaneStBridge,09/14/2016 07:00:00 PM,48,-122,14,31,45
23708,SpokaneStBridge,09/14/2016 08:00:00 PM,48,-122,11,20,31
23709,SpokaneStBridge,09/14/2016 09:00:00 PM,48,-122,2,10,12
23710,SpokaneStBridge,09/14/2016 10:00:00 PM,48,-122,7,10,17
23711,SpokaneStBridge,09/14/2016 11:00:00 PM,48,-122,2,6,8
23712,SpokaneStBridge,09/15/2016 12:00:00 AM,48,-122,1,1,2
23713,SpokaneStBridge,09/15/2016 01:00:00 AM,48,-122,1,1,2
23714,SpokaneStBridge,09/15/2016 02:00:00 AM,48,-122,1,1,2
23715,SpokaneStBridge,09/15/2016 03:00:00 AM,48,-122,1,0,1
23716,SpokaneStBridge,09/15/2016 04:00:00 AM,48,-122,4,0,4
23717,SpokaneStBridge,09/15/2016 05:00:00 AM,48,-122,19,6,25
23718,SpokaneStBridge,09/15/2016 06:00:00 AM,48,-122,65,7,72
23719,SpokaneStBridge,09/15/2016 07:00:00 AM,48,-122,136,17,153
23720,SpokaneStBridge,09/15/2016 08:00:00 AM,48,-122,151,14,165
23721,SpokaneStBridge,09/15/2016 09:00:00 AM,48,-122,65,10,75
23722,SpokaneStBridge,09/15/2016 10:00:00 AM,48,-122,15,7,22
23723,SpokaneStBridge,09/15/2016 11:00:00 AM,48,-122,18,9,27
23724,SpokaneStBridge,09/15/2016 12:00:00 PM,48,-122,11,11,22
23725,SpokaneStBridge,09/15/2016 01:00:00 PM,48,-122,18,9,27
23726,SpokaneStBridge,09/15/2016 02:00:00 PM,48,-122,16,22,38
23727,SpokaneStBridge,09/15/2016 03:00:00 PM,48,-122,12,36,48
23728,SpokaneStBridge,09/15/2016 04:00:00 PM,48,-122,17,91,108
23729,SpokaneStBridge,09/15/2016 05:00:00 PM,48,-122,26,150,176
23730,SpokaneStBridge,09/15/2016 06:00:00 PM,48,-122,9,96,105
23731,SpokaneStBridge,09/15/2016 07:00:00 PM,48,-122,11,50,61
23732,SpokaneStBridge,09/15/2016 08:00:00 PM,48,-122,6,11,17
23733,SpokaneStBridge,09/15/2016 09:00:00 PM,48,-122,2,11,13
23734,SpokaneStBridge,09/15/2016 10:00:00 PM,48,-122,2,6,8
23735,SpokaneStBridge,09/15/2016 11:00:00 PM,48,-122,4,5,9
23736,SpokaneStBridge,09/16/2016 12:00:00 AM,48,-122,1,3,4
23737,SpokaneStBridge,09/16/2016 01:00:00 AM,48,-122,0,1,1
23738,SpokaneStBridge,09/16/2016 02:00:00 AM,48,-122,2,1,3
23739,SpokaneStBridge,09/16/2016 03:00:00 AM,48,-122,1,0,1
23740,SpokaneStBridge,09/16/2016 04:00:00 AM,48,-122,3,0,3
23741,SpokaneStBridge,09/16/2016 05:00:00 AM,48,-122,14,6,20
23742,SpokaneStBridge,09/16/2016 06:00:00 AM,48,-122,53,8,61
23743,SpokaneStBridge,09/16/2016 07:00:00 AM,48,-122,130,13,143
23744,SpokaneStBridge,09/16/2016 08:00:00 AM,48,-122,105,9,114
23745,SpokaneStBridge,09/16/2016 09:00:00 AM,48,-122,37,7,44
23746,SpokaneStBridge,09/16/2016 10:00:00 AM,48,-122,22,6,28
23747,SpokaneStBridge,09/16/2016 11:00:00 AM,48,-122,19,6,25
23748,SpokaneStBridge,09/16/2016 12:00:00 PM,48,-122,17,15,32
23749,SpokaneStBridge,09/16/2016 01:00:00 PM,48,-122,12,10,22
23750,SpokaneStBridge,09/16/2016 02:00:00 PM,48,-122,19,30,49
23751,SpokaneStBridge,09/16/2016 03:00:00 PM,48,-122,17,27,44
23752,SpokaneStBridge,09/16/2016 04:00:00 PM,48,-122,20,103,123
23753,SpokaneStBridge,09/16/2016 05:00:00 PM,48,-122,22,120,142
23754,SpokaneStBridge,09/16/2016 06:00:00 PM,48,-122,16,85,101
23755,SpokaneStBridge,09/16/2016 07:00:00 PM,48,-122,7,30,37
23756,SpokaneStBridge,09/16/2016 08:00:00 PM,48,-122,5,11,16
23757,SpokaneStBridge,09/16/2016 09:00:00 PM,48,-122,3,9,12
23758,SpokaneStBridge,09/16/2016 10:00:00 PM,48,-122,7,9,16
23759,SpokaneStBridge,09/16/2016 11:00:00 PM,48,-122,5,8,13
23760,SpokaneStBridge,09/17/2016 12:00:00 AM,48,-122,3,2,5
23761,SpokaneStBridge,09/17/2016 01:00:00 AM,48,-122,3,2,5
23762,SpokaneStBridge,09/17/2016 02:00:00 AM,48,-122,3,0,3
23763,SpokaneStBridge,09/17/2016 03:00:00 AM,48,-122,0,1,1
23764,SpokaneStBridge,09/17/2016 04:00:00 AM,48,-122,1,1,2
23765,SpokaneStBridge,09/17/2016 05:00:00 AM,48,-122,4,0,4
23766,SpokaneStBridge,09/17/2016 06:00:00 AM,48,-122,4,0,4
23767,SpokaneStBridge,09/17/2016 07:00:00 AM,48,-122,8,67,75
23768,SpokaneStBridge,09/17/2016 08:00:00 AM,48,-122,10,89,99
23769,SpokaneStBridge,09/17/2016 09:00:00 AM,48,-122,5,5,10
23770,SpokaneStBridge,09/17/2016 10:00:00 AM,48,-122,7,7,14
23771,SpokaneStBridge,09/17/2016 11:00:00 AM,48,-122,6,3,9
23772,SpokaneStBridge,09/17/2016 12:00:00 PM,48,-122,18,7,25
23773,SpokaneStBridge,09/17/2016 01:00:00 PM,48,-122,5,7,12
23774,SpokaneStBridge,09/17/2016 02:00:00 PM,48,-122,9,11,20
23775,SpokaneStBridge,09/17/2016 03:00:00 PM,48,-122,6,16,22
23776,SpokaneStBridge,09/17/2016 04:00:00 PM,48,-122,7,10,17
23777,SpokaneStBridge,09/17/2016 05:00:00 PM,48,-122,9,13,22
23778,SpokaneStBridge,09/17/2016 06:00:00 PM,48,-122,8,7,15
23779,SpokaneStBridge,09/17/2016 07:00:00 PM,48,-122,6,6,12
23780,SpokaneStBridge,09/17/2016 08:00:00 PM,48,-122,0,1,1
23781,SpokaneStBridge,09/17/2016 09:00:00 PM,48,-122,2,3,5
23782,SpokaneStBridge,09/17/2016 10:00:00 PM,48,-122,0,1,1
23783,SpokaneStBridge,09/17/2016 11:00:00 PM,48,-122,1,2,3
23784,SpokaneStBridge,09/18/2016 12:00:00 AM,48,-122,2,2,4
23785,SpokaneStBridge,09/18/2016 01:00:00 AM,48,-122,1,2,3
23786,SpokaneStBridge,09/18/2016 02:00:00 AM,48,-122,1,1,2
23787,SpokaneStBridge,09/18/2016 03:00:00 AM,48,-122,1,3,4
23788,SpokaneStBridge,09/18/2016 04:00:00 AM,48,-122,1,0,1
23789,SpokaneStBridge,09/18/2016 05:00:00 AM,48,-122,4,0,4
23790,SpokaneStBridge,09/18/2016 06:00:00 AM,48,-122,2,1,3
23791,SpokaneStBridge,09/18/2016 07:00:00 AM,48,-122,6,1,7
23792,SpokaneStBridge,09/18/2016 08:00:00 AM,48,-122,15,9,24
23793,SpokaneStBridge,09/18/2016 09:00:00 AM,48,-122,13,20,33
23794,SpokaneStBridge,09/18/2016 10:00:00 AM,48,-122,15,19,34
23795,SpokaneStBridge,09/18/2016 11:00:00 AM,48,-122,23,21,44
23796,SpokaneStBridge,09/18/2016 12:00:00 PM,48,-122,27,22,49
23797,SpokaneStBridge,09/18/2016 01:00:00 PM,48,-122,23,12,35
23798,SpokaneStBridge,09/18/2016 02:00:00 PM,48,-122,24,37,61
23799,SpokaneStBridge,09/18/2016 03:00:00 PM,48,-122,28,27,55
23800,SpokaneStBridge,09/18/2016 04:00:00 PM,48,-122,15,22,37
23801,SpokaneStBridge,09/18/2016 05:00:00 PM,48,-122,12,17,29
23802,SpokaneStBridge,09/18/2016 06:00:00 PM,48,-122,4,7,11
23803,SpokaneStBridge,09/18/2016 07:00:00 PM,48,-122,10,9,19
23804,SpokaneStBridge,09/18/2016 08:00:00 PM,48,-122,4,5,9
23805,SpokaneStBridge,09/18/2016 09:00:00 PM,48,-122,3,6,9
23806,SpokaneStBridge,09/18/2016 10:00:00 PM,48,-122,0,3,3
23807,SpokaneStBridge,09/18/2016 11:00:00 PM,48,-122,2,0,2
23808,SpokaneStBridge,09/19/2016 12:00:00 AM,48,-122,1,0,1
23809,SpokaneStBridge,09/19/2016 01:00:00 AM,48,-122,2,4,6
23810,SpokaneStBridge,09/19/2016 02:00:00 AM,48,-122,0,0,0
23811,SpokaneStBridge,09/19/2016 03:00:00 AM,48,-122,2,0,2
23812,SpokaneStBridge,09/19/2016 04:00:00 AM,48,-122,3,1,4
23813,SpokaneStBridge,09/19/2016 05:00:00 AM,48,-122,18,1,19
23814,SpokaneStBridge,09/19/2016 06:00:00 AM,48,-122,41,8,49
23815,SpokaneStBridge,09/19/2016 07:00:00 AM,48,-122,98,7,105
23816,SpokaneStBridge,09/19/2016 08:00:00 AM,48,-122,102,7,109
23817,SpokaneStBridge,09/19/2016 09:00:00 AM,48,-122,51,9,60
23818,SpokaneStBridge,09/19/2016 10:00:00 AM,48,-122,16,2,18
23819,SpokaneStBridge,09/19/2016 11:00:00 AM,48,-122,9,5,14
23820,SpokaneStBridge,09/19/2016 12:00:00 PM,48,-122,13,5,18
23821,SpokaneStBridge,09/19/2016 01:00:00 PM,48,-122,8,8,16
23822,SpokaneStBridge,09/19/2016 02:00:00 PM,48,-122,4,12,16
23823,SpokaneStBridge,09/19/2016 03:00:00 PM,48,-122,7,27,34
23824,SpokaneStBridge,09/19/2016 04:00:00 PM,48,-122,11,65,76
23825,SpokaneStBridge,09/19/2016 05:00:00 PM,48,-122,8,109,117
23826,SpokaneStBridge,09/19/2016 06:00:00 PM,48,-122,18,80,98
23827,SpokaneStBridge,09/19/2016 07:00:00 PM,48,-122,13,28,41
23828,SpokaneStBridge,09/19/2016 08:00:00 PM,48,-122,5,11,16
23829,SpokaneStBridge,09/19/2016 09:00:00 PM,48,-122,3,14,17
23830,SpokaneStBridge,09/19/2016 10:00:00 PM,48,-122,4,6,10
23831,SpokaneStBridge,09/19/2016 11:00:00 PM,48,-122,2,5,7
23832,SpokaneStBridge,09/20/2016 12:00:00 AM,48,-122,1,1,2
23833,SpokaneStBridge,09/20/2016 01:00:00 AM,48,-122,0,1,1
23834,SpokaneStBridge,09/20/2016 02:00:00 AM,48,-122,0,0,0
23835,SpokaneStBridge,09/20/2016 03:00:00 AM,48,-122,1,3,4
23836,SpokaneStBridge,09/20/2016 04:00:00 AM,48,-122,10,0,10
23837,SpokaneStBridge,09/20/2016 05:00:00 AM,48,-122,23,3,26
23838,SpokaneStBridge,09/20/2016 06:00:00 AM,48,-122,58,8,66
23839,SpokaneStBridge,09/20/2016 07:00:00 AM,48,-122,152,12,164
23840,SpokaneStBridge,09/20/2016 08:00:00 AM,48,-122,149,13,162
23841,SpokaneStBridge,09/20/2016 09:00:00 AM,48,-122,51,4,55
23842,SpokaneStBridge,09/20/2016 10:00:00 AM,48,-122,17,5,22
23843,SpokaneStBridge,09/20/2016 11:00:00 AM,48,-122,14,9,23
23844,SpokaneStBridge,09/20/2016 12:00:00 PM,48,-122,10,9,19
23845,SpokaneStBridge,09/20/2016 01:00:00 PM,48,-122,12,14,26
23846,SpokaneStBridge,09/20/2016 02:00:00 PM,48,-122,14,13,27
23847,SpokaneStBridge,09/20/2016 03:00:00 PM,48,-122,12,36,48
23848,SpokaneStBridge,09/20/2016 04:00:00 PM,48,-122,15,82,97
23849,SpokaneStBridge,09/20/2016 05:00:00 PM,48,-122,20,168,188
23850,SpokaneStBridge,09/20/2016 06:00:00 PM,48,-122,26,99,125
23851,SpokaneStBridge,09/20/2016 07:00:00 PM,48,-122,13,40,53
23852,SpokaneStBridge,09/20/2016 08:00:00 PM,48,-122,5,17,22
23853,SpokaneStBridge,09/20/2016 09:00:00 PM,48,-122,2,6,8
23854,SpokaneStBridge,09/20/2016 10:00:00 PM,48,-122,4,6,10
23855,SpokaneStBridge,09/20/2016 11:00:00 PM,48,-122,0,3,3
23856,SpokaneStBridge,09/21/2016 12:00:00 AM,48,-122,0,0,0
23857,SpokaneStBridge,09/21/2016 01:00:00 AM,48,-122,0,1,1
23858,SpokaneStBridge,09/21/2016 02:00:00 AM,48,-122,2,0,2
23859,SpokaneStBridge,09/21/2016 03:00:00 AM,48,-122,2,2,4
23860,SpokaneStBridge,09/21/2016 04:00:00 AM,48,-122,6,0,6
23861,SpokaneStBridge,09/21/2016 05:00:00 AM,48,-122,22,3,25
23862,SpokaneStBridge,09/21/2016 06:00:00 AM,48,-122,66,12,78
23863,SpokaneStBridge,09/21/2016 07:00:00 AM,48,-122,149,8,157
23864,SpokaneStBridge,09/21/2016 08:00:00 AM,48,-122,151,22,173
23865,SpokaneStBridge,09/21/2016 09:00:00 AM,48,-122,62,11,73
23866,SpokaneStBridge,09/21/2016 10:00:00 AM,48,-122,18,6,24
23867,SpokaneStBridge,09/21/2016 11:00:00 AM,48,-122,20,16,36
23868,SpokaneStBridge,09/21/2016 12:00:00 PM,48,-122,11,16,27
23869,SpokaneStBridge,09/21/2016 01:00:00 PM,48,-122,18,10,28
23870,SpokaneStBridge,09/21/2016 02:00:00 PM,48,-122,24,21,45
23871,SpokaneStBridge,09/21/2016 03:00:00 PM,48,-122,17,34,51
23872,SpokaneStBridge,09/21/2016 04:00:00 PM,48,-122,16,105,121
23873,SpokaneStBridge,09/21/2016 05:00:00 PM,48,-122,33,154,187
23874,SpokaneStBridge,09/21/2016 06:00:00 PM,48,-122,28,111,139
23875,SpokaneStBridge,09/21/2016 07:00:00 PM,48,-122,7,38,45
23876,SpokaneStBridge,09/21/2016 08:00:00 PM,48,-122,10,16,26
23877,SpokaneStBridge,09/21/2016 09:00:00 PM,48,-122,0,16,16
23878,SpokaneStBridge,09/21/2016 10:00:00 PM,48,-122,3,10,13
23879,SpokaneStBridge,09/21/2016 11:00:00 PM,48,-122,3,3,6
23880,SpokaneStBridge,09/22/2016 12:00:00 AM,48,-122,0,5,5
23881,SpokaneStBridge,09/22/2016 01:00:00 AM,48,-122,3,2,5
23882,SpokaneStBridge,09/22/2016 02:00:00 AM,48,-122,1,1,2
23883,SpokaneStBridge,09/22/2016 03:00:00 AM,48,-122,2,2,4
23884,SpokaneStBridge,09/22/2016 04:00:00 AM,48,-122,8,0,8
23885,SpokaneStBridge,09/22/2016 05:00:00 AM,48,-122,15,7,22
23886,SpokaneStBridge,09/22/2016 06:00:00 AM,48,-122,61,15,76
23887,SpokaneStBridge,09/22/2016 07:00:00 AM,48,-122,141,9,150
23888,SpokaneStBridge,09/22/2016 08:00:00 AM,48,-122,149,13,162
23889,SpokaneStBridge,09/22/2016 09:00:00 AM,48,-122,49,6,55
23890,SpokaneStBridge,09/22/2016 10:00:00 AM,48,-122,23,12,35
23891,SpokaneStBridge,09/22/2016 11:00:00 AM,48,-122,9,8,17
23892,SpokaneStBridge,09/22/2016 12:00:00 PM,48,-122,12,18,30
23893,SpokaneStBridge,09/22/2016 01:00:00 PM,48,-122,15,4,19
23894,SpokaneStBridge,09/22/2016 02:00:00 PM,48,-122,16,18,34
23895,SpokaneStBridge,09/22/2016 03:00:00 PM,48,-122,13,39,52
23896,SpokaneStBridge,09/22/2016 04:00:00 PM,48,-122,22,83,105
23897,SpokaneStBridge,09/22/2016 05:00:00 PM,48,-122,21,157,178
23898,SpokaneStBridge,09/22/2016 06:00:00 PM,48,-122,23,114,137
23899,SpokaneStBridge,09/22/2016 07:00:00 PM,48,-122,10,32,42
23900,SpokaneStBridge,09/22/2016 08:00:00 PM,48,-122,5,13,18
23901,SpokaneStBridge,09/22/2016 09:00:00 PM,48,-122,4,12,16
23902,SpokaneStBridge,09/22/2016 10:00:00 PM,48,-122,3,4,7
23903,SpokaneStBridge,09/22/2016 11:00:00 PM,48,-122,0,1,1
23904,SpokaneStBridge,09/23/2016 12:00:00 AM,48,-122,1,1,2
23905,SpokaneStBridge,09/23/2016 01:00:00 AM,48,-122,1,2,3
23906,SpokaneStBridge,09/23/2016 02:00:00 AM,48,-122,1,0,1
23907,SpokaneStBridge,09/23/2016 03:00:00 AM,48,-122,1,1,2
23908,SpokaneStBridge,09/23/2016 04:00:00 AM,48,-122,3,0,3
23909,SpokaneStBridge,09/23/2016 05:00:00 AM,48,-122,12,2,14
23910,SpokaneStBridge,09/23/2016 06:00:00 AM,48,-122,39,10,49
23911,SpokaneStBridge,09/23/2016 07:00:00 AM,48,-122,83,12,95
23912,SpokaneStBridge,09/23/2016 08:00:00 AM,48,-122,103,3,106
23913,SpokaneStBridge,09/23/2016 09:00:00 AM,48,-122,38,4,42
23914,SpokaneStBridge,09/23/2016 10:00:00 AM,48,-122,19,5,24
23915,SpokaneStBridge,09/23/2016 11:00:00 AM,48,-122,2,3,5
23916,SpokaneStBridge,09/23/2016 12:00:00 PM,48,-122,4,7,11
23917,SpokaneStBridge,09/23/2016 01:00:00 PM,48,-122,9,7,16
23918,SpokaneStBridge,09/23/2016 02:00:00 PM,48,-122,10,16,26
23919,SpokaneStBridge,09/23/2016 03:00:00 PM,48,-122,10,26,36
23920,SpokaneStBridge,09/23/2016 04:00:00 PM,48,-122,12,59,71
23921,SpokaneStBridge,09/23/2016 05:00:00 PM,48,-122,9,86,95
23922,SpokaneStBridge,09/23/2016 06:00:00 PM,48,-122,7,61,68
23923,SpokaneStBridge,09/23/2016 07:00:00 PM,48,-122,6,19,25
23924,SpokaneStBridge,09/23/2016 08:00:00 PM,48,-122,1,9,10
23925,SpokaneStBridge,09/23/2016 09:00:00 PM,48,-122,1,4,5
23926,SpokaneStBridge,09/23/2016 10:00:00 PM,48,-122,2,6,8
23927,SpokaneStBridge,09/23/2016 11:00:00 PM,48,-122,1,8,9
23928,SpokaneStBridge,09/24/2016 12:00:00 AM,48,-122,0,0,0
23929,SpokaneStBridge,09/24/2016 01:00:00 AM,48,-122,1,1,2
23930,SpokaneStBridge,09/24/2016 02:00:00 AM,48,-122,1,1,2
23931,SpokaneStBridge,09/24/2016 03:00:00 AM,48,-122,1,2,3
23932,SpokaneStBridge,09/24/2016 04:00:00 AM,48,-122,1,1,2
23933,SpokaneStBridge,09/24/2016 05:00:00 AM,48,-122,6,1,7
23934,SpokaneStBridge,09/24/2016 06:00:00 AM,48,-122,5,2,7
23935,SpokaneStBridge,09/24/2016 07:00:00 AM,48,-122,8,2,10
23936,SpokaneStBridge,09/24/2016 08:00:00 AM,48,-122,13,10,23
23937,SpokaneStBridge,09/24/2016 09:00:00 AM,48,-122,12,8,20
23938,SpokaneStBridge,09/24/2016 10:00:00 AM,48,-122,11,13,24
23939,SpokaneStBridge,09/24/2016 11:00:00 AM,48,-122,15,15,30
23940,SpokaneStBridge,09/24/2016 12:00:00 PM,48,-122,19,21,40
23941,SpokaneStBridge,09/24/2016 01:00:00 PM,48,-122,20,25,45
23942,SpokaneStBridge,09/24/2016 02:00:00 PM,48,-122,13,21,34
23943,SpokaneStBridge,09/24/2016 03:00:00 PM,48,-122,23,26,49
23944,SpokaneStBridge,09/24/2016 04:00:00 PM,48,-122,19,19,38
23945,SpokaneStBridge,09/24/2016 05:00:00 PM,48,-122,8,17,25
23946,SpokaneStBridge,09/24/2016 06:00:00 PM,48,-122,7,11,18
23947,SpokaneStBridge,09/24/2016 07:00:00 PM,48,-122,15,10,25
23948,SpokaneStBridge,09/24/2016 08:00:00 PM,48,-122,0,3,3
23949,SpokaneStBridge,09/24/2016 09:00:00 PM,48,-122,5,6,11
23950,SpokaneStBridge,09/24/2016 10:00:00 PM,48,-122,1,5,6
23951,SpokaneStBridge,09/24/2016 11:00:00 PM,48,-122,3,0,3
23952,SpokaneStBridge,09/25/2016 12:00:00 AM,48,-122,3,3,6
23953,SpokaneStBridge,09/25/2016 01:00:00 AM,48,-122,2,6,8
23954,SpokaneStBridge,09/25/2016 02:00:00 AM,48,-122,0,0,0
23955,SpokaneStBridge,09/25/2016 03:00:00 AM,48,-122,2,0,2
23956,SpokaneStBridge,09/25/2016 04:00:00 AM,48,-122,0,1,1
23957,SpokaneStBridge,09/25/2016 05:00:00 AM,48,-122,5,1,6
23958,SpokaneStBridge,09/25/2016 06:00:00 AM,48,-122,3,0,3
23959,SpokaneStBridge,09/25/2016 07:00:00 AM,48,-122,7,6,13
23960,SpokaneStBridge,09/25/2016 08:00:00 AM,48,-122,11,11,22
23961,SpokaneStBridge,09/25/2016 09:00:00 AM,48,-122,22,17,39
23962,SpokaneStBridge,09/25/2016 10:00:00 AM,48,-122,20,28,48
23963,SpokaneStBridge,09/25/2016 11:00:00 AM,48,-122,37,26,63
23964,SpokaneStBridge,09/25/2016 12:00:00 PM,48,-122,28,23,51
23965,SpokaneStBridge,09/25/2016 01:00:00 PM,48,-122,33,35,68
23966,SpokaneStBridge,09/25/2016 02:00:00 PM,48,-122,26,25,51
23967,SpokaneStBridge,09/25/2016 03:00:00 PM,48,-122,29,23,52
23968,SpokaneStBridge,09/25/2016 04:00:00 PM,48,-122,23,27,50
23969,SpokaneStBridge,09/25/2016 05:00:00 PM,48,-122,15,37,52
23970,SpokaneStBridge,09/25/2016 06:00:00 PM,48,-122,15,14,29
23971,SpokaneStBridge,09/25/2016 07:00:00 PM,48,-122,2,4,6
23972,SpokaneStBridge,09/25/2016 08:00:00 PM,48,-122,4,3,7
23973,SpokaneStBridge,09/25/2016 09:00:00 PM,48,-122,5,5,10
23974,SpokaneStBridge,09/25/2016 10:00:00 PM,48,-122,1,3,4
23975,SpokaneStBridge,09/25/2016 11:00:00 PM,48,-122,1,1,2
23976,SpokaneStBridge,09/26/2016 12:00:00 AM,48,-122,3,1,4
23977,SpokaneStBridge,09/26/2016 01:00:00 AM,48,-122,2,0,2
23978,SpokaneStBridge,09/26/2016 02:00:00 AM,48,-122,3,1,4
23979,SpokaneStBridge,09/26/2016 03:00:00 AM,48,-122,2,1,3
23980,SpokaneStBridge,09/26/2016 04:00:00 AM,48,-122,4,1,5
23981,SpokaneStBridge,09/26/2016 05:00:00 AM,48,-122,22,2,24
23982,SpokaneStBridge,09/26/2016 06:00:00 AM,48,-122,67,11,78
23983,SpokaneStBridge,09/26/2016 07:00:00 AM,48,-122,152,15,167
23984,SpokaneStBridge,09/26/2016 08:00:00 AM,48,-122,131,15,146
23985,SpokaneStBridge,09/26/2016 09:00:00 AM,48,-122,59,12,71
23986,SpokaneStBridge,09/26/2016 10:00:00 AM,48,-122,22,6,28
23987,SpokaneStBridge,09/26/2016 11:00:00 AM,48,-122,13,7,20
23988,SpokaneStBridge,09/26/2016 12:00:00 PM,48,-122,10,23,33
23989,SpokaneStBridge,09/26/2016 01:00:00 PM,48,-122,19,16,35
23990,SpokaneStBridge,09/26/2016 02:00:00 PM,48,-122,15,22,37
23991,SpokaneStBridge,09/26/2016 03:00:00 PM,48,-122,17,34,51
23992,SpokaneStBridge,09/26/2016 04:00:00 PM,48,-122,23,101,124
23993,SpokaneStBridge,09/26/2016 05:00:00 PM,48,-122,23,204,227
23994,SpokaneStBridge,09/26/2016 06:00:00 PM,48,-122,7,82,89
23995,SpokaneStBridge,09/26/2016 07:00:00 PM,48,-122,10,26,36
23996,SpokaneStBridge,09/26/2016 08:00:00 PM,48,-122,7,11,18
23997,SpokaneStBridge,09/26/2016 09:00:00 PM,48,-122,1,5,6
23998,SpokaneStBridge,09/26/2016 10:00:00 PM,48,-122,1,4,5
23999,SpokaneStBridge,09/26/2016 11:00:00 PM,48,-122,3,3,6
24000,SpokaneStBridge,09/27/2016 12:00:00 AM,48,-122,1,2,3
24001,SpokaneStBridge,09/27/2016 01:00:00 AM,48,-122,1,2,3
24002,SpokaneStBridge,09/27/2016 02:00:00 AM,48,-122,0,0,0
24003,SpokaneStBridge,09/27/2016 03:00:00 AM,48,-122,1,0,1
24004,SpokaneStBridge,09/27/2016 04:00:00 AM,48,-122,9,0,9
24005,SpokaneStBridge,09/27/2016 05:00:00 AM,48,-122,19,5,24
24006,SpokaneStBridge,09/27/2016 06:00:00 AM,48,-122,56,17,73
24007,SpokaneStBridge,09/27/2016 07:00:00 AM,48,-122,123,9,132
24008,SpokaneStBridge,09/27/2016 08:00:00 AM,48,-122,137,9,146
24009,SpokaneStBridge,09/27/2016 09:00:00 AM,48,-122,72,7,79
24010,SpokaneStBridge,09/27/2016 10:00:00 AM,48,-122,15,9,24
24011,SpokaneStBridge,09/27/2016 11:00:00 AM,48,-122,8,11,19
24012,SpokaneStBridge,09/27/2016 12:00:00 PM,48,-122,15,12,27
24013,SpokaneStBridge,09/27/2016 01:00:00 PM,48,-122,13,10,23
24014,SpokaneStBridge,09/27/2016 02:00:00 PM,48,-122,6,17,23
24015,SpokaneStBridge,09/27/2016 03:00:00 PM,48,-122,18,43,61
24016,SpokaneStBridge,09/27/2016 04:00:00 PM,48,-122,19,89,108
24017,SpokaneStBridge,09/27/2016 05:00:00 PM,48,-122,30,156,186
24018,SpokaneStBridge,09/27/2016 06:00:00 PM,48,-122,28,129,157
24019,SpokaneStBridge,09/27/2016 07:00:00 PM,48,-122,11,32,43
24020,SpokaneStBridge,09/27/2016 08:00:00 PM,48,-122,8,12,20
24021,SpokaneStBridge,09/27/2016 09:00:00 PM,48,-122,0,9,9
24022,SpokaneStBridge,09/27/2016 10:00:00 PM,48,-122,2,6,8
24023,SpokaneStBridge,09/27/2016 11:00:00 PM,48,-122,2,5,7
24024,SpokaneStBridge,09/28/2016 12:00:00 AM,48,-122,0,3,3
24025,SpokaneStBridge,09/28/2016 01:00:00 AM,48,-122,1,1,2
24026,SpokaneStBridge,09/28/2016 02:00:00 AM,48,-122,0,0,0
24027,SpokaneStBridge,09/28/2016 03:00:00 AM,48,-122,0,0,0
24028,SpokaneStBridge,09/28/2016 04:00:00 AM,48,-122,2,1,3
24029,SpokaneStBridge,09/28/2016 05:00:00 AM,48,-122,20,4,24
24030,SpokaneStBridge,09/28/2016 06:00:00 AM,48,-122,73,18,91
24031,SpokaneStBridge,09/28/2016 07:00:00 AM,48,-122,151,18,169
24032,SpokaneStBridge,09/28/2016 08:00:00 AM,48,-122,141,10,151
24033,SpokaneStBridge,09/28/2016 09:00:00 AM,48,-122,45,8,53
24034,SpokaneStBridge,09/28/2016 10:00:00 AM,48,-122,20,8,28
24035,SpokaneStBridge,09/28/2016 11:00:00 AM,48,-122,19,9,28
24036,SpokaneStBridge,09/28/2016 12:00:00 PM,48,-122,16,14,30
24037,SpokaneStBridge,09/28/2016 01:00:00 PM,48,-122,10,11,21
24038,SpokaneStBridge,09/28/2016 02:00:00 PM,48,-122,9,14,23
24039,SpokaneStBridge,09/28/2016 03:00:00 PM,48,-122,17,44,61
24040,SpokaneStBridge,09/28/2016 04:00:00 PM,48,-122,19,92,111
24041,SpokaneStBridge,09/28/2016 05:00:00 PM,48,-122,23,153,176
24042,SpokaneStBridge,09/28/2016 06:00:00 PM,48,-122,23,101,124
24043,SpokaneStBridge,09/28/2016 07:00:00 PM,48,-122,9,49,58
24044,SpokaneStBridge,09/28/2016 08:00:00 PM,48,-122,11,23,34
24045,SpokaneStBridge,09/28/2016 09:00:00 PM,48,-122,6,17,23
24046,SpokaneStBridge,09/28/2016 10:00:00 PM,48,-122,3,7,10
24047,SpokaneStBridge,09/28/2016 11:00:00 PM,48,-122,0,4,4
24048,SpokaneStBridge,09/29/2016 12:00:00 AM,48,-122,1,2,3
24049,SpokaneStBridge,09/29/2016 01:00:00 AM,48,-122,2,0,2
24050,SpokaneStBridge,09/29/2016 02:00:00 AM,48,-122,1,0,1
24051,SpokaneStBridge,09/29/2016 03:00:00 AM,48,-122,0,1,1
24052,SpokaneStBridge,09/29/2016 04:00:00 AM,48,-122,9,0,9
24053,SpokaneStBridge,09/29/2016 05:00:00 AM,48,-122,17,4,21
24054,SpokaneStBridge,09/29/2016 06:00:00 AM,48,-122,64,6,70
24055,SpokaneStBridge,09/29/2016 07:00:00 AM,48,-122,124,12,136
24056,SpokaneStBridge,09/29/2016 08:00:00 AM,48,-122,131,11,142
24057,SpokaneStBridge,09/29/2016 09:00:00 AM,48,-122,55,5,60
24058,SpokaneStBridge,09/29/2016 10:00:00 AM,48,-122,20,9,29
24059,SpokaneStBridge,09/29/2016 11:00:00 AM,48,-122,10,7,17
24060,SpokaneStBridge,09/29/2016 12:00:00 PM,48,-122,16,12,28
24061,SpokaneStBridge,09/29/2016 01:00:00 PM,48,-122,12,18,30
24062,SpokaneStBridge,09/29/2016 02:00:00 PM,48,-122,19,22,41
24063,SpokaneStBridge,09/29/2016 03:00:00 PM,48,-122,31,34,65
24064,SpokaneStBridge,09/29/2016 04:00:00 PM,48,-122,15,76,91
24065,SpokaneStBridge,09/29/2016 05:00:00 PM,48,-122,21,151,172
24066,SpokaneStBridge,09/29/2016 06:00:00 PM,48,-122,14,82,96
24067,SpokaneStBridge,09/29/2016 07:00:00 PM,48,-122,4,39,43
24068,SpokaneStBridge,09/29/2016 08:00:00 PM,48,-122,4,18,22
24069,SpokaneStBridge,09/29/2016 09:00:00 PM,48,-122,7,11,18
24070,SpokaneStBridge,09/29/2016 10:00:00 PM,48,-122,6,10,16
24071,SpokaneStBridge,09/29/2016 11:00:00 PM,48,-122,3,6,9
24072,SpokaneStBridge,09/30/2016 12:00:00 AM,48,-122,0,8,8
24073,SpokaneStBridge,09/30/2016 01:00:00 AM,48,-122,3,0,3
24074,SpokaneStBridge,09/30/2016 02:00:00 AM,48,-122,2,2,4
24075,SpokaneStBridge,09/30/2016 03:00:00 AM,48,-122,1,0,1
24076,SpokaneStBridge,09/30/2016 04:00:00 AM,48,-122,4,0,4
24077,SpokaneStBridge,09/30/2016 05:00:00 AM,48,-122,7,2,9
24078,SpokaneStBridge,09/30/2016 06:00:00 AM,48,-122,42,7,49
24079,SpokaneStBridge,09/30/2016 07:00:00 AM,48,-122,98,10,108
24080,SpokaneStBridge,09/30/2016 08:00:00 AM,48,-122,125,7,132
24081,SpokaneStBridge,09/30/2016 09:00:00 AM,48,-122,44,5,49
24082,SpokaneStBridge,09/30/2016 10:00:00 AM,48,-122,9,4,13
24083,SpokaneStBridge,09/30/2016 11:00:00 AM,48,-122,13,18,31
24084,SpokaneStBridge,09/30/2016 12:00:00 PM,48,-122,11,11,22
24085,SpokaneStBridge,09/30/2016 01:00:00 PM,48,-122,15,16,31
24086,SpokaneStBridge,09/30/2016 02:00:00 PM,48,-122,16,23,39
24087,SpokaneStBridge,09/30/2016 03:00:00 PM,48,-122,18,34,52
24088,SpokaneStBridge,09/30/2016 04:00:00 PM,48,-122,26,90,116
24089,SpokaneStBridge,09/30/2016 05:00:00 PM,48,-122,23,116,139
24090,SpokaneStBridge,09/30/2016 06:00:00 PM,48,-122,9,58,67
24091,SpokaneStBridge,09/30/2016 07:00:00 PM,48,-122,9,21,30
24092,SpokaneStBridge,09/30/2016 08:00:00 PM,48,-122,1,11,12
24093,SpokaneStBridge,09/30/2016 09:00:00 PM,48,-122,4,11,15
24094,SpokaneStBridge,09/30/2016 10:00:00 PM,48,-122,1,6,7
24095,SpokaneStBridge,09/30/2016 11:00:00 PM,48,-122,1,2,3
24096,SpokaneStBridge,10/01/2016 12:00:00 AM,48,-122,0,3,3
24097,SpokaneStBridge,10/01/2016 01:00:00 AM,48,-122,0,3,3
24098,SpokaneStBridge,10/01/2016 02:00:00 AM,48,-122,0,1,1
24099,SpokaneStBridge,10/01/2016 03:00:00 AM,48,-122,0,0,0
24100,SpokaneStBridge,10/01/2016 04:00:00 AM,48,-122,1,0,1
24101,SpokaneStBridge,10/01/2016 05:00:00 AM,48,-122,5,1,6
24102,SpokaneStBridge,10/01/2016 06:00:00 AM,48,-122,4,0,4
24103,SpokaneStBridge,10/01/2016 07:00:00 AM,48,-122,9,6,15
24104,SpokaneStBridge,10/01/2016 08:00:00 AM,48,-122,10,7,17
24105,SpokaneStBridge,10/01/2016 09:00:00 AM,48,-122,11,11,22
24106,SpokaneStBridge,10/01/2016 10:00:00 AM,48,-122,18,7,25
24107,SpokaneStBridge,10/01/2016 11:00:00 AM,48,-122,19,17,36
24108,SpokaneStBridge,10/01/2016 12:00:00 PM,48,-122,11,15,26
24109,SpokaneStBridge,10/01/2016 01:00:00 PM,48,-122,7,4,11
24110,SpokaneStBridge,10/01/2016 02:00:00 PM,48,-122,8,9,17
24111,SpokaneStBridge,10/01/2016 03:00:00 PM,48,-122,7,11,18
24112,SpokaneStBridge,10/01/2016 04:00:00 PM,48,-122,10,11,21
24113,SpokaneStBridge,10/01/2016 05:00:00 PM,48,-122,7,9,16
24114,SpokaneStBridge,10/01/2016 06:00:00 PM,48,-122,5,5,10
24115,SpokaneStBridge,10/01/2016 07:00:00 PM,48,-122,0,4,4
24116,SpokaneStBridge,10/01/2016 08:00:00 PM,48,-122,2,3,5
24117,SpokaneStBridge,10/01/2016 09:00:00 PM,48,-122,2,2,4
24118,SpokaneStBridge,10/01/2016 10:00:00 PM,48,-122,0,2,2
24119,SpokaneStBridge,10/01/2016 11:00:00 PM,48,-122,0,3,3
24120,SpokaneStBridge,10/02/2016 12:00:00 AM,48,-122,0,0,0
24121,SpokaneStBridge,10/02/2016 01:00:00 AM,48,-122,2,3,5
24122,SpokaneStBridge,10/02/2016 02:00:00 AM,48,-122,0,3,3
24123,SpokaneStBridge,10/02/2016 03:00:00 AM,48,-122,1,0,1
24124,SpokaneStBridge,10/02/2016 04:00:00 AM,48,-122,0,0,0
24125,SpokaneStBridge,10/02/2016 05:00:00 AM,48,-122,4,0,4
24126,SpokaneStBridge,10/02/2016 06:00:00 AM,48,-122,2,2,4
24127,SpokaneStBridge,10/02/2016 07:00:00 AM,48,-122,4,1,5
24128,SpokaneStBridge,10/02/2016 08:00:00 AM,48,-122,6,3,9
24129,SpokaneStBridge,10/02/2016 09:00:00 AM,48,-122,18,11,29
24130,SpokaneStBridge,10/02/2016 10:00:00 AM,48,-122,12,12,24
24131,SpokaneStBridge,10/02/2016 11:00:00 AM,48,-122,21,21,42
24132,SpokaneStBridge,10/02/2016 12:00:00 PM,48,-122,19,20,39
24133,SpokaneStBridge,10/02/2016 01:00:00 PM,48,-122,23,14,37
24134,SpokaneStBridge,10/02/2016 02:00:00 PM,48,-122,27,26,53
24135,SpokaneStBridge,10/02/2016 03:00:00 PM,48,-122,23,31,54
24136,SpokaneStBridge,10/02/2016 04:00:00 PM,48,-122,15,17,32
24137,SpokaneStBridge,10/02/2016 05:00:00 PM,48,-122,33,33,66
24138,SpokaneStBridge,10/02/2016 06:00:00 PM,48,-122,11,8,19
24139,SpokaneStBridge,10/02/2016 07:00:00 PM,48,-122,4,3,7
24140,SpokaneStBridge,10/02/2016 08:00:00 PM,48,-122,1,9,10
24141,SpokaneStBridge,10/02/2016 09:00:00 PM,48,-122,0,1,1
24142,SpokaneStBridge,10/02/2016 10:00:00 PM,48,-122,0,3,3
24143,SpokaneStBridge,10/02/2016 11:00:00 PM,48,-122,3,0,3
24144,SpokaneStBridge,10/03/2016 12:00:00 AM,48,-122,1,5,6
24145,SpokaneStBridge,10/03/2016 01:00:00 AM,48,-122,2,1,3
24146,SpokaneStBridge,10/03/2016 02:00:00 AM,48,-122,2,2,4
24147,SpokaneStBridge,10/03/2016 03:00:00 AM,48,-122,0,0,0
24148,SpokaneStBridge,10/03/2016 04:00:00 AM,48,-122,8,0,8
24149,SpokaneStBridge,10/03/2016 05:00:00 AM,48,-122,10,2,12
24150,SpokaneStBridge,10/03/2016 06:00:00 AM,48,-122,64,11,75
24151,SpokaneStBridge,10/03/2016 07:00:00 AM,48,-122,144,14,158
24152,SpokaneStBridge,10/03/2016 08:00:00 AM,48,-122,124,9,133
24153,SpokaneStBridge,10/03/2016 09:00:00 AM,48,-122,53,8,61
24154,SpokaneStBridge,10/03/2016 10:00:00 AM,48,-122,25,6,31
24155,SpokaneStBridge,10/03/2016 11:00:00 AM,48,-122,12,9,21
24156,SpokaneStBridge,10/03/2016 12:00:00 PM,48,-122,12,12,24
24157,SpokaneStBridge,10/03/2016 01:00:00 PM,48,-122,8,10,18
24158,SpokaneStBridge,10/03/2016 02:00:00 PM,48,-122,11,13,24
24159,SpokaneStBridge,10/03/2016 03:00:00 PM,48,-122,4,26,30
24160,SpokaneStBridge,10/03/2016 04:00:00 PM,48,-122,12,79,91
24161,SpokaneStBridge,10/03/2016 05:00:00 PM,48,-122,22,161,183
24162,SpokaneStBridge,10/03/2016 06:00:00 PM,48,-122,12,75,87
24163,SpokaneStBridge,10/03/2016 07:00:00 PM,48,-122,8,31,39
24164,SpokaneStBridge,10/03/2016 08:00:00 PM,48,-122,3,9,12
24165,SpokaneStBridge,10/03/2016 09:00:00 PM,48,-122,3,10,13
24166,SpokaneStBridge,10/03/2016 10:00:00 PM,48,-122,1,6,7
24167,SpokaneStBridge,10/03/2016 11:00:00 PM,48,-122,0,1,1
24168,SpokaneStBridge,10/04/2016 12:00:00 AM,48,-122,2,2,4
24169,SpokaneStBridge,10/04/2016 01:00:00 AM,48,-122,1,2,3
24170,SpokaneStBridge,10/04/2016 02:00:00 AM,48,-122,0,2,2
24171,SpokaneStBridge,10/04/2016 03:00:00 AM,48,-122,1,1,2
24172,SpokaneStBridge,10/04/2016 04:00:00 AM,48,-122,3,1,4
24173,SpokaneStBridge,10/04/2016 05:00:00 AM,48,-122,8,4,12
24174,SpokaneStBridge,10/04/2016 06:00:00 AM,48,-122,31,6,37
24175,SpokaneStBridge,10/04/2016 07:00:00 AM,48,-122,111,11,122
24176,SpokaneStBridge,10/04/2016 08:00:00 AM,48,-122,96,9,105
24177,SpokaneStBridge,10/04/2016 09:00:00 AM,48,-122,39,3,42
24178,SpokaneStBridge,10/04/2016 10:00:00 AM,48,-122,15,4,19
24179,SpokaneStBridge,10/04/2016 11:00:00 AM,48,-122,6,4,10
24180,SpokaneStBridge,10/04/2016 12:00:00 PM,48,-122,2,7,9
24181,SpokaneStBridge,10/04/2016 01:00:00 PM,48,-122,8,4,12
24182,SpokaneStBridge,10/04/2016 02:00:00 PM,48,-122,2,6,8
24183,SpokaneStBridge,10/04/2016 03:00:00 PM,48,-122,8,24,32
24184,SpokaneStBridge,10/04/2016 04:00:00 PM,48,-122,12,54,66
24185,SpokaneStBridge,10/04/2016 05:00:00 PM,48,-122,17,126,143
24186,SpokaneStBridge,10/04/2016 06:00:00 PM,48,-122,7,69,76
24187,SpokaneStBridge,10/04/2016 07:00:00 PM,48,-122,4,27,31
24188,SpokaneStBridge,10/04/2016 08:00:00 PM,48,-122,1,13,14
24189,SpokaneStBridge,10/04/2016 09:00:00 PM,48,-122,1,11,12
24190,SpokaneStBridge,10/04/2016 10:00:00 PM,48,-122,0,1,1
24191,SpokaneStBridge,10/04/2016 11:00:00 PM,48,-122,3,3,6
24192,SpokaneStBridge,10/05/2016 12:00:00 AM,48,-122,1,0,1
24193,SpokaneStBridge,10/05/2016 01:00:00 AM,48,-122,0,1,1
24194,SpokaneStBridge,10/05/2016 02:00:00 AM,48,-122,2,1,3
24195,SpokaneStBridge,10/05/2016 03:00:00 AM,48,-122,2,1,3
24196,SpokaneStBridge,10/05/2016 04:00:00 AM,48,-122,2,0,2
24197,SpokaneStBridge,10/05/2016 05:00:00 AM,48,-122,13,3,16
24198,SpokaneStBridge,10/05/2016 06:00:00 AM,48,-122,52,7,59
24199,SpokaneStBridge,10/05/2016 07:00:00 AM,48,-122,111,8,119
24200,SpokaneStBridge,10/05/2016 08:00:00 AM,48,-122,108,12,120
24201,SpokaneStBridge,10/05/2016 09:00:00 AM,48,-122,38,4,42
24202,SpokaneStBridge,10/05/2016 10:00:00 AM,48,-122,13,6,19
24203,SpokaneStBridge,10/05/2016 11:00:00 AM,48,-122,6,3,9
24204,SpokaneStBridge,10/05/2016 12:00:00 PM,48,-122,10,8,18
24205,SpokaneStBridge,10/05/2016 01:00:00 PM,48,-122,11,4,15
24206,SpokaneStBridge,10/05/2016 02:00:00 PM,48,-122,10,7,17
24207,SpokaneStBridge,10/05/2016 03:00:00 PM,48,-122,7,33,40
24208,SpokaneStBridge,10/05/2016 04:00:00 PM,48,-122,17,51,68
24209,SpokaneStBridge,10/05/2016 05:00:00 PM,48,-122,18,145,163
24210,SpokaneStBridge,10/05/2016 06:00:00 PM,48,-122,14,69,83
24211,SpokaneStBridge,10/05/2016 07:00:00 PM,48,-122,6,22,28
24212,SpokaneStBridge,10/05/2016 08:00:00 PM,48,-122,4,12,16
24213,SpokaneStBridge,10/05/2016 09:00:00 PM,48,-122,2,14,16
24214,SpokaneStBridge,10/05/2016 10:00:00 PM,48,-122,2,5,7
24215,SpokaneStBridge,10/05/2016 11:00:00 PM,48,-122,1,2,3
24216,SpokaneStBridge,10/06/2016 12:00:00 AM,48,-122,1,4,5
24217,SpokaneStBridge,10/06/2016 01:00:00 AM,48,-122,1,0,1
24218,SpokaneStBridge,10/06/2016 02:00:00 AM,48,-122,1,0,1
24219,SpokaneStBridge,10/06/2016 03:00:00 AM,48,-122,2,1,3
24220,SpokaneStBridge,10/06/2016 04:00:00 AM,48,-122,5,1,6
24221,SpokaneStBridge,10/06/2016 05:00:00 AM,48,-122,13,3,16
24222,SpokaneStBridge,10/06/2016 06:00:00 AM,48,-122,47,7,54
24223,SpokaneStBridge,10/06/2016 07:00:00 AM,48,-122,120,15,135
24224,SpokaneStBridge,10/06/2016 08:00:00 AM,48,-122,101,4,105
24225,SpokaneStBridge,10/06/2016 09:00:00 AM,48,-122,46,4,50
24226,SpokaneStBridge,10/06/2016 10:00:00 AM,48,-122,12,6,18
24227,SpokaneStBridge,10/06/2016 11:00:00 AM,48,-122,17,3,20
24228,SpokaneStBridge,10/06/2016 12:00:00 PM,48,-122,8,7,15
24229,SpokaneStBridge,10/06/2016 01:00:00 PM,48,-122,10,7,17
24230,SpokaneStBridge,10/06/2016 02:00:00 PM,48,-122,11,8,19
24231,SpokaneStBridge,10/06/2016 03:00:00 PM,48,-122,5,29,34
24232,SpokaneStBridge,10/06/2016 04:00:00 PM,48,-122,14,75,89
24233,SpokaneStBridge,10/06/2016 05:00:00 PM,48,-122,23,121,144
24234,SpokaneStBridge,10/06/2016 06:00:00 PM,48,-122,4,56,60
24235,SpokaneStBridge,10/06/2016 07:00:00 PM,48,-122,2,22,24
24236,SpokaneStBridge,10/06/2016 08:00:00 PM,48,-122,3,9,12
24237,SpokaneStBridge,10/06/2016 09:00:00 PM,48,-122,2,7,9
24238,SpokaneStBridge,10/06/2016 10:00:00 PM,48,-122,1,3,4
24239,SpokaneStBridge,10/06/2016 11:00:00 PM,48,-122,0,1,1
24240,SpokaneStBridge,10/07/2016 12:00:00 AM,48,-122,0,2,2
24241,SpokaneStBridge,10/07/2016 01:00:00 AM,48,-122,0,0,0
24242,SpokaneStBridge,10/07/2016 02:00:00 AM,48,-122,1,0,1
24243,SpokaneStBridge,10/07/2016 03:00:00 AM,48,-122,1,0,1
24244,SpokaneStBridge,10/07/2016 04:00:00 AM,48,-122,0,0,0
24245,SpokaneStBridge,10/07/2016 05:00:00 AM,48,-122,7,1,8
24246,SpokaneStBridge,10/07/2016 06:00:00 AM,48,-122,32,5,37
24247,SpokaneStBridge,10/07/2016 07:00:00 AM,48,-122,72,11,83
24248,SpokaneStBridge,10/07/2016 08:00:00 AM,48,-122,79,6,85
24249,SpokaneStBridge,10/07/2016 09:00:00 AM,48,-122,27,7,34
24250,SpokaneStBridge,10/07/2016 10:00:00 AM,48,-122,11,3,14
24251,SpokaneStBridge,10/07/2016 11:00:00 AM,48,-122,8,4,12
24252,SpokaneStBridge,10/07/2016 12:00:00 PM,48,-122,8,6,14
24253,SpokaneStBridge,10/07/2016 01:00:00 PM,48,-122,5,7,12
24254,SpokaneStBridge,10/07/2016 02:00:00 PM,48,-122,10,10,20
24255,SpokaneStBridge,10/07/2016 03:00:00 PM,48,-122,11,16,27
24256,SpokaneStBridge,10/07/2016 04:00:00 PM,48,-122,15,53,68
24257,SpokaneStBridge,10/07/2016 05:00:00 PM,48,-122,13,82,95
24258,SpokaneStBridge,10/07/2016 06:00:00 PM,48,-122,8,52,60
24259,SpokaneStBridge,10/07/2016 07:00:00 PM,48,-122,8,27,35
24260,SpokaneStBridge,10/07/2016 08:00:00 PM,48,-122,2,10,12
24261,SpokaneStBridge,10/07/2016 09:00:00 PM,48,-122,2,3,5
24262,SpokaneStBridge,10/07/2016 10:00:00 PM,48,-122,1,2,3
24263,SpokaneStBridge,10/07/2016 11:00:00 PM,48,-122,5,2,7
24264,SpokaneStBridge,10/08/2016 12:00:00 AM,48,-122,0,1,1
24265,SpokaneStBridge,10/08/2016 01:00:00 AM,48,-122,0,0,0
24266,SpokaneStBridge,10/08/2016 02:00:00 AM,48,-122,1,3,4
24267,SpokaneStBridge,10/08/2016 03:00:00 AM,48,-122,0,5,5
24268,SpokaneStBridge,10/08/2016 04:00:00 AM,48,-122,2,1,3
24269,SpokaneStBridge,10/08/2016 05:00:00 AM,48,-122,3,1,4
24270,SpokaneStBridge,10/08/2016 06:00:00 AM,48,-122,5,0,5
24271,SpokaneStBridge,10/08/2016 07:00:00 AM,48,-122,4,2,6
24272,SpokaneStBridge,10/08/2016 08:00:00 AM,48,-122,4,1,5
24273,SpokaneStBridge,10/08/2016 09:00:00 AM,48,-122,5,3,8
24274,SpokaneStBridge,10/08/2016 10:00:00 AM,48,-122,6,8,14
24275,SpokaneStBridge,10/08/2016 11:00:00 AM,48,-122,10,6,16
24276,SpokaneStBridge,10/08/2016 12:00:00 PM,48,-122,11,13,24
24277,SpokaneStBridge,10/08/2016 01:00:00 PM,48,-122,5,6,11
24278,SpokaneStBridge,10/08/2016 02:00:00 PM,48,-122,3,6,9
24279,SpokaneStBridge,10/08/2016 03:00:00 PM,48,-122,6,9,15
24280,SpokaneStBridge,10/08/2016 04:00:00 PM,48,-122,1,7,8
24281,SpokaneStBridge,10/08/2016 05:00:00 PM,48,-122,1,6,7
24282,SpokaneStBridge,10/08/2016 06:00:00 PM,48,-122,3,3,6
24283,SpokaneStBridge,10/08/2016 07:00:00 PM,48,-122,0,0,0
24284,SpokaneStBridge,10/08/2016 08:00:00 PM,48,-122,0,1,1
24285,SpokaneStBridge,10/08/2016 09:00:00 PM,48,-122,1,9,10
24286,SpokaneStBridge,10/08/2016 10:00:00 PM,48,-122,1,4,5
24287,SpokaneStBridge,10/08/2016 11:00:00 PM,48,-122,0,2,2
24288,SpokaneStBridge,10/09/2016 12:00:00 AM,48,-122,0,1,1
24289,SpokaneStBridge,10/09/2016 01:00:00 AM,48,-122,2,1,3
24290,SpokaneStBridge,10/09/2016 02:00:00 AM,48,-122,1,1,2
24291,SpokaneStBridge,10/09/2016 03:00:00 AM,48,-122,1,1,2
24292,SpokaneStBridge,10/09/2016 04:00:00 AM,48,-122,0,1,1
24293,SpokaneStBridge,10/09/2016 05:00:00 AM,48,-122,2,0,2
24294,SpokaneStBridge,10/09/2016 06:00:00 AM,48,-122,0,2,2
24295,SpokaneStBridge,10/09/2016 07:00:00 AM,48,-122,3,3,6
24296,SpokaneStBridge,10/09/2016 08:00:00 AM,48,-122,14,6,20
24297,SpokaneStBridge,10/09/2016 09:00:00 AM,48,-122,8,10,18
24298,SpokaneStBridge,10/09/2016 10:00:00 AM,48,-122,11,18,29
24299,SpokaneStBridge,10/09/2016 11:00:00 AM,48,-122,15,13,28
24300,SpokaneStBridge,10/09/2016 12:00:00 PM,48,-122,17,9,26
24301,SpokaneStBridge,10/09/2016 01:00:00 PM,48,-122,6,12,18
24302,SpokaneStBridge,10/09/2016 02:00:00 PM,48,-122,16,16,32
24303,SpokaneStBridge,10/09/2016 03:00:00 PM,48,-122,14,13,27
24304,SpokaneStBridge,10/09/2016 04:00:00 PM,48,-122,7,13,20
24305,SpokaneStBridge,10/09/2016 05:00:00 PM,48,-122,6,14,20
24306,SpokaneStBridge,10/09/2016 06:00:00 PM,48,-122,0,1,1
24307,SpokaneStBridge,10/09/2016 07:00:00 PM,48,-122,0,0,0
24308,SpokaneStBridge,10/09/2016 08:00:00 PM,48,-122,1,0,1
24309,SpokaneStBridge,10/09/2016 09:00:00 PM,48,-122,3,3,6
24310,SpokaneStBridge,10/09/2016 10:00:00 PM,48,-122,1,1,2
24311,SpokaneStBridge,10/09/2016 11:00:00 PM,48,-122,0,1,1
24312,SpokaneStBridge,10/10/2016 12:00:00 AM,48,-122,0,0,0
24313,SpokaneStBridge,10/10/2016 01:00:00 AM,48,-122,0,0,0
24314,SpokaneStBridge,10/10/2016 02:00:00 AM,48,-122,1,2,3
24315,SpokaneStBridge,10/10/2016 03:00:00 AM,48,-122,0,1,1
24316,SpokaneStBridge,10/10/2016 04:00:00 AM,48,-122,5,1,6
24317,SpokaneStBridge,10/10/2016 05:00:00 AM,48,-122,11,1,12
24318,SpokaneStBridge,10/10/2016 06:00:00 AM,48,-122,44,8,52
24319,SpokaneStBridge,10/10/2016 07:00:00 AM,48,-122,114,4,118
24320,SpokaneStBridge,10/10/2016 08:00:00 AM,48,-122,126,7,133
24321,SpokaneStBridge,10/10/2016 09:00:00 AM,48,-122,40,1,41
24322,SpokaneStBridge,10/10/2016 10:00:00 AM,48,-122,10,9,19
24323,SpokaneStBridge,10/10/2016 11:00:00 AM,48,-122,12,6,18
24324,SpokaneStBridge,10/10/2016 12:00:00 PM,48,-122,8,11,19
24325,SpokaneStBridge,10/10/2016 01:00:00 PM,48,-122,18,7,25
24326,SpokaneStBridge,10/10/2016 02:00:00 PM,48,-122,6,11,17
24327,SpokaneStBridge,10/10/2016 03:00:00 PM,48,-122,12,36,48
24328,SpokaneStBridge,10/10/2016 04:00:00 PM,48,-122,12,77,89
24329,SpokaneStBridge,10/10/2016 05:00:00 PM,48,-122,13,132,145
24330,SpokaneStBridge,10/10/2016 06:00:00 PM,48,-122,9,74,83
24331,SpokaneStBridge,10/10/2016 07:00:00 PM,48,-122,3,33,36
24332,SpokaneStBridge,10/10/2016 08:00:00 PM,48,-122,4,9,13
24333,SpokaneStBridge,10/10/2016 09:00:00 PM,48,-122,1,7,8
24334,SpokaneStBridge,10/10/2016 10:00:00 PM,48,-122,0,4,4
24335,SpokaneStBridge,10/10/2016 11:00:00 PM,48,-122,0,1,1
24336,SpokaneStBridge,10/11/2016 12:00:00 AM,48,-122,1,3,4
24337,SpokaneStBridge,10/11/2016 01:00:00 AM,48,-122,0,0,0
24338,SpokaneStBridge,10/11/2016 02:00:00 AM,48,-122,0,0,0
24339,SpokaneStBridge,10/11/2016 03:00:00 AM,48,-122,2,0,2
24340,SpokaneStBridge,10/11/2016 04:00:00 AM,48,-122,8,1,9
24341,SpokaneStBridge,10/11/2016 05:00:00 AM,48,-122,20,4,24
24342,SpokaneStBridge,10/11/2016 06:00:00 AM,48,-122,67,5,72
24343,SpokaneStBridge,10/11/2016 07:00:00 AM,48,-122,137,14,151
24344,SpokaneStBridge,10/11/2016 08:00:00 AM,48,-122,145,10,155
24345,SpokaneStBridge,10/11/2016 09:00:00 AM,48,-122,60,5,65
24346,SpokaneStBridge,10/11/2016 10:00:00 AM,48,-122,15,6,21
24347,SpokaneStBridge,10/11/2016 11:00:00 AM,48,-122,17,7,24
24348,SpokaneStBridge,10/11/2016 12:00:00 PM,48,-122,17,9,26
24349,SpokaneStBridge,10/11/2016 01:00:00 PM,48,-122,9,10,19
24350,SpokaneStBridge,10/11/2016 02:00:00 PM,48,-122,11,19,30
24351,SpokaneStBridge,10/11/2016 03:00:00 PM,48,-122,8,42,50
24352,SpokaneStBridge,10/11/2016 04:00:00 PM,48,-122,31,101,132
24353,SpokaneStBridge,10/11/2016 05:00:00 PM,48,-122,21,161,182
24354,SpokaneStBridge,10/11/2016 06:00:00 PM,48,-122,17,106,123
24355,SpokaneStBridge,10/11/2016 07:00:00 PM,48,-122,4,28,32
24356,SpokaneStBridge,10/11/2016 08:00:00 PM,48,-122,1,13,14
24357,SpokaneStBridge,10/11/2016 09:00:00 PM,48,-122,3,12,15
24358,SpokaneStBridge,10/11/2016 10:00:00 PM,48,-122,0,3,3
24359,SpokaneStBridge,10/11/2016 11:00:00 PM,48,-122,2,1,3
24360,SpokaneStBridge,10/12/2016 12:00:00 AM,48,-122,2,1,3
24361,SpokaneStBridge,10/12/2016 01:00:00 AM,48,-122,2,1,3
24362,SpokaneStBridge,10/12/2016 02:00:00 AM,48,-122,1,1,2
24363,SpokaneStBridge,10/12/2016 03:00:00 AM,48,-122,2,0,2
24364,SpokaneStBridge,10/12/2016 04:00:00 AM,48,-122,4,1,5
24365,SpokaneStBridge,10/12/2016 05:00:00 AM,48,-122,16,2,18
24366,SpokaneStBridge,10/12/2016 06:00:00 AM,48,-122,60,6,66
24367,SpokaneStBridge,10/12/2016 07:00:00 AM,48,-122,127,11,138
24368,SpokaneStBridge,10/12/2016 08:00:00 AM,48,-122,128,10,138
24369,SpokaneStBridge,10/12/2016 09:00:00 AM,48,-122,50,4,54
24370,SpokaneStBridge,10/12/2016 10:00:00 AM,48,-122,20,2,22
24371,SpokaneStBridge,10/12/2016 11:00:00 AM,48,-122,19,3,22
24372,SpokaneStBridge,10/12/2016 12:00:00 PM,48,-122,7,15,22
24373,SpokaneStBridge,10/12/2016 01:00:00 PM,48,-122,15,15,30
24374,SpokaneStBridge,10/12/2016 02:00:00 PM,48,-122,15,16,31
24375,SpokaneStBridge,10/12/2016 03:00:00 PM,48,-122,12,37,49
24376,SpokaneStBridge,10/12/2016 04:00:00 PM,48,-122,28,74,102
24377,SpokaneStBridge,10/12/2016 05:00:00 PM,48,-122,16,148,164
24378,SpokaneStBridge,10/12/2016 06:00:00 PM,48,-122,11,81,92
24379,SpokaneStBridge,10/12/2016 07:00:00 PM,48,-122,5,17,22
24380,SpokaneStBridge,10/12/2016 08:00:00 PM,48,-122,5,14,19
24381,SpokaneStBridge,10/12/2016 09:00:00 PM,48,-122,2,8,10
24382,SpokaneStBridge,10/12/2016 10:00:00 PM,48,-122,5,5,10
24383,SpokaneStBridge,10/12/2016 11:00:00 PM,48,-122,2,5,7
24384,SpokaneStBridge,10/13/2016 12:00:00 AM,48,-122,0,2,2
24385,SpokaneStBridge,10/13/2016 01:00:00 AM,48,-122,1,1,2
24386,SpokaneStBridge,10/13/2016 02:00:00 AM,48,-122,0,1,1
24387,SpokaneStBridge,10/13/2016 03:00:00 AM,48,-122,3,1,4
24388,SpokaneStBridge,10/13/2016 04:00:00 AM,48,-122,0,0,0
24389,SpokaneStBridge,10/13/2016 05:00:00 AM,48,-122,6,1,7
24390,SpokaneStBridge,10/13/2016 06:00:00 AM,48,-122,18,1,19
24391,SpokaneStBridge,10/13/2016 07:00:00 AM,48,-122,53,11,64
24392,SpokaneStBridge,10/13/2016 08:00:00 AM,48,-122,58,5,63
24393,SpokaneStBridge,10/13/2016 09:00:00 AM,48,-122,22,2,24
24394,SpokaneStBridge,10/13/2016 10:00:00 AM,48,-122,6,2,8
24395,SpokaneStBridge,10/13/2016 11:00:00 AM,48,-122,2,1,3
24396,SpokaneStBridge,10/13/2016 12:00:00 PM,48,-122,3,2,5
24397,SpokaneStBridge,10/13/2016 01:00:00 PM,48,-122,3,3,6
24398,SpokaneStBridge,10/13/2016 02:00:00 PM,48,-122,6,5,11
24399,SpokaneStBridge,10/13/2016 03:00:00 PM,48,-122,2,12,14
24400,SpokaneStBridge,10/13/2016 04:00:00 PM,48,-122,7,24,31
24401,SpokaneStBridge,10/13/2016 05:00:00 PM,48,-122,3,58,61
24402,SpokaneStBridge,10/13/2016 06:00:00 PM,48,-122,2,33,35
24403,SpokaneStBridge,10/13/2016 07:00:00 PM,48,-122,3,15,18
24404,SpokaneStBridge,10/13/2016 08:00:00 PM,48,-122,0,1,1
24405,SpokaneStBridge,10/13/2016 09:00:00 PM,48,-122,1,3,4
24406,SpokaneStBridge,10/13/2016 10:00:00 PM,48,-122,1,2,3
24407,SpokaneStBridge,10/13/2016 11:00:00 PM,48,-122,0,1,1
24408,SpokaneStBridge,10/14/2016 12:00:00 AM,48,-122,0,0,0
24409,SpokaneStBridge,10/14/2016 01:00:00 AM,48,-122,1,0,1
24410,SpokaneStBridge,10/14/2016 02:00:00 AM,48,-122,0,0,0
24411,SpokaneStBridge,10/14/2016 03:00:00 AM,48,-122,1,1,2
24412,SpokaneStBridge,10/14/2016 04:00:00 AM,48,-122,2,0,2
24413,SpokaneStBridge,10/14/2016 05:00:00 AM,48,-122,4,1,5
24414,SpokaneStBridge,10/14/2016 06:00:00 AM,48,-122,12,2,14
24415,SpokaneStBridge,10/14/2016 07:00:00 AM,48,-122,25,5,30
24416,SpokaneStBridge,10/14/2016 08:00:00 AM,48,-122,30,2,32
24417,SpokaneStBridge,10/14/2016 09:00:00 AM,48,-122,11,2,13
24418,SpokaneStBridge,10/14/2016 10:00:00 AM,48,-122,1,1,2
24419,SpokaneStBridge,10/14/2016 11:00:00 AM,48,-122,1,1,2
24420,SpokaneStBridge,10/14/2016 12:00:00 PM,48,-122,3,0,3
24421,SpokaneStBridge,10/14/2016 01:00:00 PM,48,-122,1,1,2
24422,SpokaneStBridge,10/14/2016 02:00:00 PM,48,-122,3,2,5
24423,SpokaneStBridge,10/14/2016 03:00:00 PM,48,-122,4,11,15
24424,SpokaneStBridge,10/14/2016 04:00:00 PM,48,-122,5,17,22
24425,SpokaneStBridge,10/14/2016 05:00:00 PM,48,-122,5,28,33
24426,SpokaneStBridge,10/14/2016 06:00:00 PM,48,-122,5,15,20
24427,SpokaneStBridge,10/14/2016 07:00:00 PM,48,-122,2,10,12
24428,SpokaneStBridge,10/14/2016 08:00:00 PM,48,-122,1,2,3
24429,SpokaneStBridge,10/14/2016 09:00:00 PM,48,-122,0,2,2
24430,SpokaneStBridge,10/14/2016 10:00:00 PM,48,-122,1,3,4
24431,SpokaneStBridge,10/14/2016 11:00:00 PM,48,-122,1,1,2
24432,SpokaneStBridge,10/15/2016 12:00:00 AM,48,-122,0,2,2
24433,SpokaneStBridge,10/15/2016 01:00:00 AM,48,-122,0,1,1
24434,SpokaneStBridge,10/15/2016 02:00:00 AM,48,-122,0,0,0
24435,SpokaneStBridge,10/15/2016 03:00:00 AM,48,-122,1,2,3
24436,SpokaneStBridge,10/15/2016 04:00:00 AM,48,-122,3,1,4
24437,SpokaneStBridge,10/15/2016 05:00:00 AM,48,-122,1,0,1
24438,SpokaneStBridge,10/15/2016 06:00:00 AM,48,-122,3,1,4
24439,SpokaneStBridge,10/15/2016 07:00:00 AM,48,-122,3,0,3
24440,SpokaneStBridge,10/15/2016 08:00:00 AM,48,-122,1,1,2
24441,SpokaneStBridge,10/15/2016 09:00:00 AM,48,-122,4,2,6
24442,SpokaneStBridge,10/15/2016 10:00:00 AM,48,-122,3,2,5
24443,SpokaneStBridge,10/15/2016 11:00:00 AM,48,-122,2,0,2
24444,SpokaneStBridge,10/15/2016 12:00:00 PM,48,-122,3,3,6
24445,SpokaneStBridge,10/15/2016 01:00:00 PM,48,-122,1,4,5
24446,SpokaneStBridge,10/15/2016 02:00:00 PM,48,-122,3,2,5
24447,SpokaneStBridge,10/15/2016 03:00:00 PM,48,-122,2,2,4
24448,SpokaneStBridge,10/15/2016 04:00:00 PM,48,-122,2,6,8
24449,SpokaneStBridge,10/15/2016 05:00:00 PM,48,-122,3,3,6
24450,SpokaneStBridge,10/15/2016 06:00:00 PM,48,-122,1,4,5
24451,SpokaneStBridge,10/15/2016 07:00:00 PM,48,-122,2,0,2
24452,SpokaneStBridge,10/15/2016 08:00:00 PM,48,-122,0,0,0
24453,SpokaneStBridge,10/15/2016 09:00:00 PM,48,-122,0,0,0
24454,SpokaneStBridge,10/15/2016 10:00:00 PM,48,-122,1,0,1
24455,SpokaneStBridge,10/15/2016 11:00:00 PM,48,-122,0,0,0
24456,SpokaneStBridge,10/16/2016 12:00:00 AM,48,-122,1,1,2
24457,SpokaneStBridge,10/16/2016 01:00:00 AM,48,-122,1,0,1
24458,SpokaneStBridge,10/16/2016 02:00:00 AM,48,-122,0,0,0
24459,SpokaneStBridge,10/16/2016 03:00:00 AM,48,-122,0,1,1
24460,SpokaneStBridge,10/16/2016 04:00:00 AM,48,-122,0,1,1
24461,SpokaneStBridge,10/16/2016 05:00:00 AM,48,-122,4,1,5
24462,SpokaneStBridge,10/16/2016 06:00:00 AM,48,-122,1,1,2
24463,SpokaneStBridge,10/16/2016 07:00:00 AM,48,-122,2,0,2
24464,SpokaneStBridge,10/16/2016 08:00:00 AM,48,-122,6,1,7
24465,SpokaneStBridge,10/16/2016 09:00:00 AM,48,-122,1,0,1
24466,SpokaneStBridge,10/16/2016 10:00:00 AM,48,-122,4,8,12
24467,SpokaneStBridge,10/16/2016 11:00:00 AM,48,-122,4,4,8
24468,SpokaneStBridge,10/16/2016 12:00:00 PM,48,-122,5,2,7
24469,SpokaneStBridge,10/16/2016 01:00:00 PM,48,-122,1,2,3
24470,SpokaneStBridge,10/16/2016 02:00:00 PM,48,-122,5,4,9
24471,SpokaneStBridge,10/16/2016 03:00:00 PM,48,-122,4,1,5
24472,SpokaneStBridge,10/16/2016 04:00:00 PM,48,-122,7,9,16
24473,SpokaneStBridge,10/16/2016 05:00:00 PM,48,-122,1,6,7
24474,SpokaneStBridge,10/16/2016 06:00:00 PM,48,-122,1,1,2
24475,SpokaneStBridge,10/16/2016 07:00:00 PM,48,-122,2,1,3
24476,SpokaneStBridge,10/16/2016 08:00:00 PM,48,-122,1,1,2
24477,SpokaneStBridge,10/16/2016 09:00:00 PM,48,-122,0,2,2
24478,SpokaneStBridge,10/16/2016 10:00:00 PM,48,-122,0,0,0
24479,SpokaneStBridge,10/16/2016 11:00:00 PM,48,-122,0,0,0
24480,SpokaneStBridge,10/17/2016 12:00:00 AM,48,-122,0,1,1
24481,SpokaneStBridge,10/17/2016 01:00:00 AM,48,-122,1,1,2
24482,SpokaneStBridge,10/17/2016 02:00:00 AM,48,-122,3,4,7
24483,SpokaneStBridge,10/17/2016 03:00:00 AM,48,-122,0,2,2
24484,SpokaneStBridge,10/17/2016 04:00:00 AM,48,-122,4,1,5
24485,SpokaneStBridge,10/17/2016 05:00:00 AM,48,-122,12,0,12
24486,SpokaneStBridge,10/17/2016 06:00:00 AM,48,-122,30,3,33
24487,SpokaneStBridge,10/17/2016 07:00:00 AM,48,-122,85,11,96
24488,SpokaneStBridge,10/17/2016 08:00:00 AM,48,-122,88,10,98
24489,SpokaneStBridge,10/17/2016 09:00:00 AM,48,-122,37,3,40
24490,SpokaneStBridge,10/17/2016 10:00:00 AM,48,-122,13,3,16
24491,SpokaneStBridge,10/17/2016 11:00:00 AM,48,-122,3,4,7
24492,SpokaneStBridge,10/17/2016 12:00:00 PM,48,-122,4,5,9
24493,SpokaneStBridge,10/17/2016 01:00:00 PM,48,-122,3,3,6
24494,SpokaneStBridge,10/17/2016 02:00:00 PM,48,-122,7,3,10
24495,SpokaneStBridge,10/17/2016 03:00:00 PM,48,-122,7,19,26
24496,SpokaneStBridge,10/17/2016 04:00:00 PM,48,-122,14,46,60
24497,SpokaneStBridge,10/17/2016 05:00:00 PM,48,-122,13,108,121
24498,SpokaneStBridge,10/17/2016 06:00:00 PM,48,-122,7,73,80
24499,SpokaneStBridge,10/17/2016 07:00:00 PM,48,-122,4,27,31
24500,SpokaneStBridge,10/17/2016 08:00:00 PM,48,-122,0,12,12
24501,SpokaneStBridge,10/17/2016 09:00:00 PM,48,-122,0,8,8
24502,SpokaneStBridge,10/17/2016 10:00:00 PM,48,-122,3,2,5
24503,SpokaneStBridge,10/17/2016 11:00:00 PM,48,-122,1,0,1
24504,SpokaneStBridge,10/18/2016 12:00:00 AM,48,-122,0,0,0
24505,SpokaneStBridge,10/18/2016 01:00:00 AM,48,-122,1,2,3
24506,SpokaneStBridge,10/18/2016 02:00:00 AM,48,-122,0,0,0
24507,SpokaneStBridge,10/18/2016 03:00:00 AM,48,-122,2,1,3
24508,SpokaneStBridge,10/18/2016 04:00:00 AM,48,-122,1,0,1
24509,SpokaneStBridge,10/18/2016 05:00:00 AM,48,-122,10,1,11
24510,SpokaneStBridge,10/18/2016 06:00:00 AM,48,-122,44,5,49
24511,SpokaneStBridge,10/18/2016 07:00:00 AM,48,-122,96,14,110
24512,SpokaneStBridge,10/18/2016 08:00:00 AM,48,-122,103,3,106
24513,SpokaneStBridge,10/18/2016 09:00:00 AM,48,-122,38,6,44
24514,SpokaneStBridge,10/18/2016 10:00:00 AM,48,-122,7,1,8
24515,SpokaneStBridge,10/18/2016 11:00:00 AM,48,-122,8,4,12
24516,SpokaneStBridge,10/18/2016 12:00:00 PM,48,-122,8,8,16
24517,SpokaneStBridge,10/18/2016 01:00:00 PM,48,-122,11,4,15
24518,SpokaneStBridge,10/18/2016 02:00:00 PM,48,-122,6,11,17
24519,SpokaneStBridge,10/18/2016 03:00:00 PM,48,-122,13,16,29
24520,SpokaneStBridge,10/18/2016 04:00:00 PM,48,-122,14,51,65
24521,SpokaneStBridge,10/18/2016 05:00:00 PM,48,-122,18,130,148
24522,SpokaneStBridge,10/18/2016 06:00:00 PM,48,-122,13,78,91
24523,SpokaneStBridge,10/18/2016 07:00:00 PM,48,-122,7,19,26
24524,SpokaneStBridge,10/18/2016 08:00:00 PM,48,-122,2,10,12
24525,SpokaneStBridge,10/18/2016 09:00:00 PM,48,-122,0,10,10
24526,SpokaneStBridge,10/18/2016 10:00:00 PM,48,-122,1,2,3
24527,SpokaneStBridge,10/18/2016 11:00:00 PM,48,-122,3,2,5
24528,SpokaneStBridge,10/19/2016 12:00:00 AM,48,-122,2,2,4
24529,SpokaneStBridge,10/19/2016 01:00:00 AM,48,-122,1,1,2
24530,SpokaneStBridge,10/19/2016 02:00:00 AM,48,-122,3,4,7
24531,SpokaneStBridge,10/19/2016 03:00:00 AM,48,-122,0,1,1
24532,SpokaneStBridge,10/19/2016 04:00:00 AM,48,-122,1,0,1
24533,SpokaneStBridge,10/19/2016 05:00:00 AM,48,-122,14,7,21
24534,SpokaneStBridge,10/19/2016 06:00:00 AM,48,-122,50,6,56
24535,SpokaneStBridge,10/19/2016 07:00:00 AM,48,-122,120,10,130
24536,SpokaneStBridge,10/19/2016 08:00:00 AM,48,-122,134,12,146
24537,SpokaneStBridge,10/19/2016 09:00:00 AM,48,-122,45,8,53
24538,SpokaneStBridge,10/19/2016 10:00:00 AM,48,-122,16,2,18
24539,SpokaneStBridge,10/19/2016 11:00:00 AM,48,-122,13,6,19
24540,SpokaneStBridge,10/19/2016 12:00:00 PM,48,-122,5,14,19
24541,SpokaneStBridge,10/19/2016 01:00:00 PM,48,-122,11,8,19
24542,SpokaneStBridge,10/19/2016 02:00:00 PM,48,-122,7,17,24
24543,SpokaneStBridge,10/19/2016 03:00:00 PM,48,-122,13,23,36
24544,SpokaneStBridge,10/19/2016 04:00:00 PM,48,-122,12,69,81
24545,SpokaneStBridge,10/19/2016 05:00:00 PM,48,-122,17,146,163
24546,SpokaneStBridge,10/19/2016 06:00:00 PM,48,-122,12,60,72
24547,SpokaneStBridge,10/19/2016 07:00:00 PM,48,-122,5,19,24
24548,SpokaneStBridge,10/19/2016 08:00:00 PM,48,-122,2,15,17
24549,SpokaneStBridge,10/19/2016 09:00:00 PM,48,-122,2,3,5
24550,SpokaneStBridge,10/19/2016 10:00:00 PM,48,-122,2,4,6
24551,SpokaneStBridge,10/19/2016 11:00:00 PM,48,-122,0,2,2
24552,SpokaneStBridge,10/20/2016 12:00:00 AM,48,-122,0,1,1
24553,SpokaneStBridge,10/20/2016 01:00:00 AM,48,-122,1,1,2
24554,SpokaneStBridge,10/20/2016 02:00:00 AM,48,-122,1,1,2
24555,SpokaneStBridge,10/20/2016 03:00:00 AM,48,-122,1,0,1
24556,SpokaneStBridge,10/20/2016 04:00:00 AM,48,-122,1,0,1
24557,SpokaneStBridge,10/20/2016 05:00:00 AM,48,-122,5,1,6
24558,SpokaneStBridge,10/20/2016 06:00:00 AM,48,-122,32,3,35
24559,SpokaneStBridge,10/20/2016 07:00:00 AM,48,-122,72,5,77
24560,SpokaneStBridge,10/20/2016 08:00:00 AM,48,-122,74,1,75
24561,SpokaneStBridge,10/20/2016 09:00:00 AM,48,-122,28,2,30
24562,SpokaneStBridge,10/20/2016 10:00:00 AM,48,-122,8,0,8
24563,SpokaneStBridge,10/20/2016 11:00:00 AM,48,-122,3,2,5
24564,SpokaneStBridge,10/20/2016 12:00:00 PM,48,-122,4,7,11
24565,SpokaneStBridge,10/20/2016 01:00:00 PM,48,-122,3,2,5
24566,SpokaneStBridge,10/20/2016 02:00:00 PM,48,-122,6,3,9
24567,SpokaneStBridge,10/20/2016 03:00:00 PM,48,-122,3,16,19
24568,SpokaneStBridge,10/20/2016 04:00:00 PM,48,-122,11,50,61
24569,SpokaneStBridge,10/20/2016 05:00:00 PM,48,-122,13,75,88
24570,SpokaneStBridge,10/20/2016 06:00:00 PM,48,-122,11,61,72
24571,SpokaneStBridge,10/20/2016 07:00:00 PM,48,-122,3,25,28
24572,SpokaneStBridge,10/20/2016 08:00:00 PM,48,-122,3,7,10
24573,SpokaneStBridge,10/20/2016 09:00:00 PM,48,-122,5,7,12
24574,SpokaneStBridge,10/20/2016 10:00:00 PM,48,-122,0,3,3
24575,SpokaneStBridge,10/20/2016 11:00:00 PM,48,-122,1,0,1
24576,SpokaneStBridge,10/21/2016 12:00:00 AM,48,-122,0,2,2
24577,SpokaneStBridge,10/21/2016 01:00:00 AM,48,-122,0,1,1
24578,SpokaneStBridge,10/21/2016 02:00:00 AM,48,-122,2,1,3
24579,SpokaneStBridge,10/21/2016 03:00:00 AM,48,-122,1,2,3
24580,SpokaneStBridge,10/21/2016 04:00:00 AM,48,-122,1,0,1
24581,SpokaneStBridge,10/21/2016 05:00:00 AM,48,-122,10,5,15
24582,SpokaneStBridge,10/21/2016 06:00:00 AM,48,-122,34,8,42
24583,SpokaneStBridge,10/21/2016 07:00:00 AM,48,-122,80,6,86
24584,SpokaneStBridge,10/21/2016 08:00:00 AM,48,-122,95,6,101
24585,SpokaneStBridge,10/21/2016 09:00:00 AM,48,-122,30,2,32
24586,SpokaneStBridge,10/21/2016 10:00:00 AM,48,-122,16,12,28
24587,SpokaneStBridge,10/21/2016 11:00:00 AM,48,-122,9,7,16
24588,SpokaneStBridge,10/21/2016 12:00:00 PM,48,-122,13,10,23
24589,SpokaneStBridge,10/21/2016 01:00:00 PM,48,-122,12,5,17
24590,SpokaneStBridge,10/21/2016 02:00:00 PM,48,-122,7,10,17
24591,SpokaneStBridge,10/21/2016 03:00:00 PM,48,-122,14,23,37
24592,SpokaneStBridge,10/21/2016 04:00:00 PM,48,-122,15,62,77
24593,SpokaneStBridge,10/21/2016 05:00:00 PM,48,-122,7,86,93
24594,SpokaneStBridge,10/21/2016 06:00:00 PM,48,-122,1,53,54
24595,SpokaneStBridge,10/21/2016 07:00:00 PM,48,-122,7,16,23
24596,SpokaneStBridge,10/21/2016 08:00:00 PM,48,-122,3,6,9
24597,SpokaneStBridge,10/21/2016 09:00:00 PM,48,-122,0,7,7
24598,SpokaneStBridge,10/21/2016 10:00:00 PM,48,-122,1,3,4
24599,SpokaneStBridge,10/21/2016 11:00:00 PM,48,-122,0,2,2
24600,SpokaneStBridge,10/22/2016 12:00:00 AM,48,-122,0,1,1
24601,SpokaneStBridge,10/22/2016 01:00:00 AM,48,-122,5,1,6
24602,SpokaneStBridge,10/22/2016 02:00:00 AM,48,-122,0,1,1
24603,SpokaneStBridge,10/22/2016 03:00:00 AM,48,-122,0,1,1
24604,SpokaneStBridge,10/22/2016 04:00:00 AM,48,-122,2,6,8
24605,SpokaneStBridge,10/22/2016 05:00:00 AM,48,-122,1,1,2
24606,SpokaneStBridge,10/22/2016 06:00:00 AM,48,-122,7,0,7
24607,SpokaneStBridge,10/22/2016 07:00:00 AM,48,-122,2,5,7
24608,SpokaneStBridge,10/22/2016 08:00:00 AM,48,-122,16,4,20
24609,SpokaneStBridge,10/22/2016 09:00:00 AM,48,-122,10,17,27
24610,SpokaneStBridge,10/22/2016 10:00:00 AM,48,-122,11,34,45
24611,SpokaneStBridge,10/22/2016 11:00:00 AM,48,-122,45,25,70
24612,SpokaneStBridge,10/22/2016 12:00:00 PM,48,-122,19,22,41
24613,SpokaneStBridge,10/22/2016 01:00:00 PM,48,-122,21,34,55
24614,SpokaneStBridge,10/22/2016 02:00:00 PM,48,-122,33,22,55
24615,SpokaneStBridge,10/22/2016 03:00:00 PM,48,-122,32,19,51
24616,SpokaneStBridge,10/22/2016 04:00:00 PM,48,-122,24,22,46
24617,SpokaneStBridge,10/22/2016 05:00:00 PM,48,-122,17,21,38
24618,SpokaneStBridge,10/22/2016 06:00:00 PM,48,-122,15,6,21
24619,SpokaneStBridge,10/22/2016 07:00:00 PM,48,-122,3,8,11
24620,SpokaneStBridge,10/22/2016 08:00:00 PM,48,-122,1,2,3
24621,SpokaneStBridge,10/22/2016 09:00:00 PM,48,-122,3,6,9
24622,SpokaneStBridge,10/22/2016 10:00:00 PM,48,-122,3,3,6
24623,SpokaneStBridge,10/22/2016 11:00:00 PM,48,-122,1,5,6
24624,SpokaneStBridge,10/23/2016 12:00:00 AM,48,-122,0,0,0
24625,SpokaneStBridge,10/23/2016 01:00:00 AM,48,-122,0,0,0
24626,SpokaneStBridge,10/23/2016 02:00:00 AM,48,-122,0,0,0
24627,SpokaneStBridge,10/23/2016 03:00:00 AM,48,-122,0,1,1
24628,SpokaneStBridge,10/23/2016 04:00:00 AM,48,-122,0,0,0
24629,SpokaneStBridge,10/23/2016 05:00:00 AM,48,-122,3,1,4
24630,SpokaneStBridge,10/23/2016 06:00:00 AM,48,-122,2,0,2
24631,SpokaneStBridge,10/23/2016 07:00:00 AM,48,-122,3,0,3
24632,SpokaneStBridge,10/23/2016 08:00:00 AM,48,-122,13,12,25
24633,SpokaneStBridge,10/23/2016 09:00:00 AM,48,-122,9,7,16
24634,SpokaneStBridge,10/23/2016 10:00:00 AM,48,-122,13,13,26
24635,SpokaneStBridge,10/23/2016 11:00:00 AM,48,-122,13,10,23
24636,SpokaneStBridge,10/23/2016 12:00:00 PM,48,-122,22,15,37
24637,SpokaneStBridge,10/23/2016 01:00:00 PM,48,-122,19,20,39
24638,SpokaneStBridge,10/23/2016 02:00:00 PM,48,-122,17,18,35
24639,SpokaneStBridge,10/23/2016 03:00:00 PM,48,-122,18,27,45
24640,SpokaneStBridge,10/23/2016 04:00:00 PM,48,-122,16,23,39
24641,SpokaneStBridge,10/23/2016 05:00:00 PM,48,-122,3,5,8
24642,SpokaneStBridge,10/23/2016 06:00:00 PM,48,-122,7,4,11
24643,SpokaneStBridge,10/23/2016 07:00:00 PM,48,-122,1,0,1
24644,SpokaneStBridge,10/23/2016 08:00:00 PM,48,-122,2,4,6
24645,SpokaneStBridge,10/23/2016 09:00:00 PM,48,-122,1,5,6
24646,SpokaneStBridge,10/23/2016 10:00:00 PM,48,-122,2,2,4
24647,SpokaneStBridge,10/23/2016 11:00:00 PM,48,-122,0,2,2
24648,SpokaneStBridge,10/24/2016 12:00:00 AM,48,-122,3,0,3
24649,SpokaneStBridge,10/24/2016 01:00:00 AM,48,-122,0,2,2
24650,SpokaneStBridge,10/24/2016 02:00:00 AM,48,-122,1,2,3
24651,SpokaneStBridge,10/24/2016 03:00:00 AM,48,-122,0,2,2
24652,SpokaneStBridge,10/24/2016 04:00:00 AM,48,-122,2,0,2
24653,SpokaneStBridge,10/24/2016 05:00:00 AM,48,-122,20,5,25
24654,SpokaneStBridge,10/24/2016 06:00:00 AM,48,-122,48,7,55
24655,SpokaneStBridge,10/24/2016 07:00:00 AM,48,-122,105,17,122
24656,SpokaneStBridge,10/24/2016 08:00:00 AM,48,-122,99,9,108
24657,SpokaneStBridge,10/24/2016 09:00:00 AM,48,-122,37,6,43
24658,SpokaneStBridge,10/24/2016 10:00:00 AM,48,-122,13,4,17
24659,SpokaneStBridge,10/24/2016 11:00:00 AM,48,-122,8,3,11
24660,SpokaneStBridge,10/24/2016 12:00:00 PM,48,-122,12,8,20
24661,SpokaneStBridge,10/24/2016 01:00:00 PM,48,-122,7,7,14
24662,SpokaneStBridge,10/24/2016 02:00:00 PM,48,-122,8,7,15
24663,SpokaneStBridge,10/24/2016 03:00:00 PM,48,-122,11,27,38
24664,SpokaneStBridge,10/24/2016 04:00:00 PM,48,-122,17,51,68
24665,SpokaneStBridge,10/24/2016 05:00:00 PM,48,-122,9,119,128
24666,SpokaneStBridge,10/24/2016 06:00:00 PM,48,-122,3,61,64
24667,SpokaneStBridge,10/24/2016 07:00:00 PM,48,-122,3,24,27
24668,SpokaneStBridge,10/24/2016 08:00:00 PM,48,-122,4,13,17
24669,SpokaneStBridge,10/24/2016 09:00:00 PM,48,-122,2,4,6
24670,SpokaneStBridge,10/24/2016 10:00:00 PM,48,-122,0,3,3
24671,SpokaneStBridge,10/24/2016 11:00:00 PM,48,-122,3,1,4
24672,SpokaneStBridge,10/25/2016 12:00:00 AM,48,-122,0,2,2
24673,SpokaneStBridge,10/25/2016 01:00:00 AM,48,-122,0,2,2
24674,SpokaneStBridge,10/25/2016 02:00:00 AM,48,-122,0,0,0
24675,SpokaneStBridge,10/25/2016 03:00:00 AM,48,-122,0,0,0
24676,SpokaneStBridge,10/25/2016 04:00:00 AM,48,-122,6,1,7
24677,SpokaneStBridge,10/25/2016 05:00:00 AM,48,-122,18,3,21
24678,SpokaneStBridge,10/25/2016 06:00:00 AM,48,-122,52,7,59
24679,SpokaneStBridge,10/25/2016 07:00:00 AM,48,-122,110,9,119
24680,SpokaneStBridge,10/25/2016 08:00:00 AM,48,-122,103,4,107
24681,SpokaneStBridge,10/25/2016 09:00:00 AM,48,-122,44,8,52
24682,SpokaneStBridge,10/25/2016 10:00:00 AM,48,-122,13,5,18
24683,SpokaneStBridge,10/25/2016 11:00:00 AM,48,-122,4,5,9
24684,SpokaneStBridge,10/25/2016 12:00:00 PM,48,-122,13,7,20
24685,SpokaneStBridge,10/25/2016 01:00:00 PM,48,-122,21,5,26
24686,SpokaneStBridge,10/25/2016 02:00:00 PM,48,-122,12,16,28
24687,SpokaneStBridge,10/25/2016 03:00:00 PM,48,-122,21,30,51
24688,SpokaneStBridge,10/25/2016 04:00:00 PM,48,-122,16,75,91
24689,SpokaneStBridge,10/25/2016 05:00:00 PM,48,-122,23,119,142
24690,SpokaneStBridge,10/25/2016 06:00:00 PM,48,-122,6,79,85
24691,SpokaneStBridge,10/25/2016 07:00:00 PM,48,-122,4,28,32
24692,SpokaneStBridge,10/25/2016 08:00:00 PM,48,-122,2,14,16
24693,SpokaneStBridge,10/25/2016 09:00:00 PM,48,-122,3,13,16
24694,SpokaneStBridge,10/25/2016 10:00:00 PM,48,-122,1,5,6
24695,SpokaneStBridge,10/25/2016 11:00:00 PM,48,-122,0,2,2
24696,SpokaneStBridge,10/26/2016 12:00:00 AM,48,-122,1,0,1
24697,SpokaneStBridge,10/26/2016 01:00:00 AM,48,-122,1,4,5
24698,SpokaneStBridge,10/26/2016 02:00:00 AM,48,-122,1,1,2
24699,SpokaneStBridge,10/26/2016 03:00:00 AM,48,-122,1,1,2
24700,SpokaneStBridge,10/26/2016 04:00:00 AM,48,-122,5,1,6
24701,SpokaneStBridge,10/26/2016 05:00:00 AM,48,-122,18,2,20
24702,SpokaneStBridge,10/26/2016 06:00:00 AM,48,-122,34,7,41
24703,SpokaneStBridge,10/26/2016 07:00:00 AM,48,-122,52,6,58
24704,SpokaneStBridge,10/26/2016 08:00:00 AM,48,-122,66,4,70
24705,SpokaneStBridge,10/26/2016 09:00:00 AM,48,-122,21,4,25
24706,SpokaneStBridge,10/26/2016 10:00:00 AM,48,-122,7,1,8
24707,SpokaneStBridge,10/26/2016 11:00:00 AM,48,-122,3,2,5
24708,SpokaneStBridge,10/26/2016 12:00:00 PM,48,-122,3,4,7
24709,SpokaneStBridge,10/26/2016 01:00:00 PM,48,-122,3,4,7
24710,SpokaneStBridge,10/26/2016 02:00:00 PM,48,-122,5,4,9
24711,SpokaneStBridge,10/26/2016 03:00:00 PM,48,-122,3,14,17
24712,SpokaneStBridge,10/26/2016 04:00:00 PM,48,-122,9,32,41
24713,SpokaneStBridge,10/26/2016 05:00:00 PM,48,-122,8,69,77
24714,SpokaneStBridge,10/26/2016 06:00:00 PM,48,-122,2,45,47
24715,SpokaneStBridge,10/26/2016 07:00:00 PM,48,-122,3,19,22
24716,SpokaneStBridge,10/26/2016 08:00:00 PM,48,-122,0,11,11
24717,SpokaneStBridge,10/26/2016 09:00:00 PM,48,-122,0,8,8
24718,SpokaneStBridge,10/26/2016 10:00:00 PM,48,-122,0,1,1
24719,SpokaneStBridge,10/26/2016 11:00:00 PM,48,-122,0,0,0
24720,SpokaneStBridge,10/27/2016 12:00:00 AM,48,-122,1,0,1
24721,SpokaneStBridge,10/27/2016 01:00:00 AM,48,-122,0,0,0
24722,SpokaneStBridge,10/27/2016 02:00:00 AM,48,-122,0,1,1
24723,SpokaneStBridge,10/27/2016 03:00:00 AM,48,-122,0,0,0
24724,SpokaneStBridge,10/27/2016 04:00:00 AM,48,-122,0,0,0
24725,SpokaneStBridge,10/27/2016 05:00:00 AM,48,-122,16,2,18
24726,SpokaneStBridge,10/27/2016 06:00:00 AM,48,-122,38,3,41
24727,SpokaneStBridge,10/27/2016 07:00:00 AM,48,-122,83,12,95
24728,SpokaneStBridge,10/27/2016 08:00:00 AM,48,-122,92,8,100
24729,SpokaneStBridge,10/27/2016 09:00:00 AM,48,-122,41,3,44
24730,SpokaneStBridge,10/27/2016 10:00:00 AM,48,-122,12,2,14
24731,SpokaneStBridge,10/27/2016 11:00:00 AM,48,-122,11,5,16
24732,SpokaneStBridge,10/27/2016 12:00:00 PM,48,-122,5,2,7
24733,SpokaneStBridge,10/27/2016 01:00:00 PM,48,-122,8,6,14
24734,SpokaneStBridge,10/27/2016 02:00:00 PM,48,-122,9,6,15
24735,SpokaneStBridge,10/27/2016 03:00:00 PM,48,-122,7,21,28
24736,SpokaneStBridge,10/27/2016 04:00:00 PM,48,-122,14,49,63
24737,SpokaneStBridge,10/27/2016 05:00:00 PM,48,-122,8,107,115
24738,SpokaneStBridge,10/27/2016 06:00:00 PM,48,-122,8,60,68
24739,SpokaneStBridge,10/27/2016 07:00:00 PM,48,-122,5,26,31
24740,SpokaneStBridge,10/27/2016 08:00:00 PM,48,-122,1,9,10
24741,SpokaneStBridge,10/27/2016 09:00:00 PM,48,-122,0,10,10
24742,SpokaneStBridge,10/27/2016 10:00:00 PM,48,-122,0,4,4
24743,SpokaneStBridge,10/27/2016 11:00:00 PM,48,-122,1,1,2
24744,SpokaneStBridge,10/28/2016 12:00:00 AM,48,-122,1,1,2
24745,SpokaneStBridge,10/28/2016 01:00:00 AM,48,-122,0,3,3
24746,SpokaneStBridge,10/28/2016 02:00:00 AM,48,-122,1,0,1
24747,SpokaneStBridge,10/28/2016 03:00:00 AM,48,-122,1,0,1
24748,SpokaneStBridge,10/28/2016 04:00:00 AM,48,-122,1,0,1
24749,SpokaneStBridge,10/28/2016 05:00:00 AM,48,-122,11,6,17
24750,SpokaneStBridge,10/28/2016 06:00:00 AM,48,-122,37,3,40
24751,SpokaneStBridge,10/28/2016 07:00:00 AM,48,-122,75,10,85
24752,SpokaneStBridge,10/28/2016 08:00:00 AM,48,-122,89,15,104
24753,SpokaneStBridge,10/28/2016 09:00:00 AM,48,-122,43,7,50
24754,SpokaneStBridge,10/28/2016 10:00:00 AM,48,-122,16,5,21
24755,SpokaneStBridge,10/28/2016 11:00:00 AM,48,-122,15,5,20
24756,SpokaneStBridge,10/28/2016 12:00:00 PM,48,-122,8,14,22
24757,SpokaneStBridge,10/28/2016 01:00:00 PM,48,-122,12,15,27
24758,SpokaneStBridge,10/28/2016 02:00:00 PM,48,-122,22,19,41
24759,SpokaneStBridge,10/28/2016 03:00:00 PM,48,-122,10,29,39
24760,SpokaneStBridge,10/28/2016 04:00:00 PM,48,-122,30,63,93
24761,SpokaneStBridge,10/28/2016 05:00:00 PM,48,-122,12,90,102
24762,SpokaneStBridge,10/28/2016 06:00:00 PM,48,-122,11,65,76
24763,SpokaneStBridge,10/28/2016 07:00:00 PM,48,-122,5,13,18
24764,SpokaneStBridge,10/28/2016 08:00:00 PM,48,-122,4,9,13
24765,SpokaneStBridge,10/28/2016 09:00:00 PM,48,-122,0,4,4
24766,SpokaneStBridge,10/28/2016 10:00:00 PM,48,-122,1,3,4
24767,SpokaneStBridge,10/28/2016 11:00:00 PM,48,-122,0,5,5
24768,SpokaneStBridge,10/29/2016 12:00:00 AM,48,-122,0,3,3
24769,SpokaneStBridge,10/29/2016 01:00:00 AM,48,-122,0,0,0
24770,SpokaneStBridge,10/29/2016 02:00:00 AM,48,-122,0,1,1
24771,SpokaneStBridge,10/29/2016 03:00:00 AM,48,-122,0,1,1
24772,SpokaneStBridge,10/29/2016 04:00:00 AM,48,-122,1,0,1
24773,SpokaneStBridge,10/29/2016 05:00:00 AM,48,-122,4,2,6
24774,SpokaneStBridge,10/29/2016 06:00:00 AM,48,-122,4,2,6
24775,SpokaneStBridge,10/29/2016 07:00:00 AM,48,-122,5,1,6
24776,SpokaneStBridge,10/29/2016 08:00:00 AM,48,-122,5,8,13
24777,SpokaneStBridge,10/29/2016 09:00:00 AM,48,-122,6,7,13
24778,SpokaneStBridge,10/29/2016 10:00:00 AM,48,-122,3,3,6
24779,SpokaneStBridge,10/29/2016 11:00:00 AM,48,-122,4,4,8
24780,SpokaneStBridge,10/29/2016 12:00:00 PM,48,-122,2,3,5
24781,SpokaneStBridge,10/29/2016 01:00:00 PM,48,-122,7,1,8
24782,SpokaneStBridge,10/29/2016 02:00:00 PM,48,-122,5,6,11
24783,SpokaneStBridge,10/29/2016 03:00:00 PM,48,-122,8,12,20
24784,SpokaneStBridge,10/29/2016 04:00:00 PM,48,-122,11,20,31
24785,SpokaneStBridge,10/29/2016 05:00:00 PM,48,-122,12,7,19
24786,SpokaneStBridge,10/29/2016 06:00:00 PM,48,-122,6,4,10
24787,SpokaneStBridge,10/29/2016 07:00:00 PM,48,-122,2,2,4
24788,SpokaneStBridge,10/29/2016 08:00:00 PM,48,-122,0,4,4
24789,SpokaneStBridge,10/29/2016 09:00:00 PM,48,-122,1,6,7
24790,SpokaneStBridge,10/29/2016 10:00:00 PM,48,-122,1,3,4
24791,SpokaneStBridge,10/29/2016 11:00:00 PM,48,-122,1,0,1
24792,SpokaneStBridge,10/30/2016 12:00:00 AM,48,-122,0,1,1
24793,SpokaneStBridge,10/30/2016 01:00:00 AM,48,-122,1,3,4
24794,SpokaneStBridge,10/30/2016 02:00:00 AM,48,-122,1,0,1
24795,SpokaneStBridge,10/30/2016 03:00:00 AM,48,-122,1,1,2
24796,SpokaneStBridge,10/30/2016 04:00:00 AM,48,-122,1,1,2
24797,SpokaneStBridge,10/30/2016 05:00:00 AM,48,-122,5,1,6
24798,SpokaneStBridge,10/30/2016 06:00:00 AM,48,-122,2,1,3
24799,SpokaneStBridge,10/30/2016 07:00:00 AM,48,-122,6,2,8
24800,SpokaneStBridge,10/30/2016 08:00:00 AM,48,-122,15,12,27
24801,SpokaneStBridge,10/30/2016 09:00:00 AM,48,-122,12,7,19
24802,SpokaneStBridge,10/30/2016 10:00:00 AM,48,-122,14,22,36
24803,SpokaneStBridge,10/30/2016 11:00:00 AM,48,-122,16,18,34
24804,SpokaneStBridge,10/30/2016 12:00:00 PM,48,-122,16,19,35
24805,SpokaneStBridge,10/30/2016 01:00:00 PM,48,-122,23,14,37
24806,SpokaneStBridge,10/30/2016 02:00:00 PM,48,-122,8,11,19
24807,SpokaneStBridge,10/30/2016 03:00:00 PM,48,-122,4,5,9
24808,SpokaneStBridge,10/30/2016 04:00:00 PM,48,-122,5,6,11
24809,SpokaneStBridge,10/30/2016 05:00:00 PM,48,-122,2,1,3
24810,SpokaneStBridge,10/30/2016 06:00:00 PM,48,-122,4,4,8
24811,SpokaneStBridge,10/30/2016 07:00:00 PM,48,-122,1,2,3
24812,SpokaneStBridge,10/30/2016 08:00:00 PM,48,-122,1,4,5
24813,SpokaneStBridge,10/30/2016 09:00:00 PM,48,-122,0,1,1
24814,SpokaneStBridge,10/30/2016 10:00:00 PM,48,-122,0,0,0
24815,SpokaneStBridge,10/30/2016 11:00:00 PM,48,-122,1,0,1
24816,SpokaneStBridge,10/31/2016 12:00:00 AM,48,-122,0,1,1
24817,SpokaneStBridge,10/31/2016 01:00:00 AM,48,-122,0,0,0
24818,SpokaneStBridge,10/31/2016 02:00:00 AM,48,-122,0,0,0
24819,SpokaneStBridge,10/31/2016 03:00:00 AM,48,-122,0,3,3
24820,SpokaneStBridge,10/31/2016 04:00:00 AM,48,-122,3,0,3
24821,SpokaneStBridge,10/31/2016 05:00:00 AM,48,-122,14,1,15
24822,SpokaneStBridge,10/31/2016 06:00:00 AM,48,-122,38,5,43
24823,SpokaneStBridge,10/31/2016 07:00:00 AM,48,-122,82,7,89
24824,SpokaneStBridge,10/31/2016 08:00:00 AM,48,-122,79,6,85
24825,SpokaneStBridge,10/31/2016 09:00:00 AM,48,-122,23,1,24
24826,SpokaneStBridge,10/31/2016 10:00:00 AM,48,-122,9,2,11
24827,SpokaneStBridge,10/31/2016 11:00:00 AM,48,-122,2,0,2
24828,SpokaneStBridge,10/31/2016 12:00:00 PM,48,-122,3,1,4
24829,SpokaneStBridge,10/31/2016 01:00:00 PM,48,-122,4,3,7
24830,SpokaneStBridge,10/31/2016 02:00:00 PM,48,-122,2,5,7
24831,SpokaneStBridge,10/31/2016 03:00:00 PM,48,-122,5,30,35
24832,SpokaneStBridge,10/31/2016 04:00:00 PM,48,-122,7,69,76
24833,SpokaneStBridge,10/31/2016 05:00:00 PM,48,-122,13,88,101
24834,SpokaneStBridge,10/31/2016 06:00:00 PM,48,-122,2,39,41
24835,SpokaneStBridge,10/31/2016 07:00:00 PM,48,-122,2,9,11
24836,SpokaneStBridge,10/31/2016 08:00:00 PM,48,-122,0,2,2
24837,SpokaneStBridge,10/31/2016 09:00:00 PM,48,-122,0,5,5
24838,SpokaneStBridge,10/31/2016 10:00:00 PM,48,-122,0,0,0
24839,SpokaneStBridge,10/31/2016 11:00:00 PM,48,-122,0,2,2
24840,SpokaneStBridge,11/01/2016 12:00:00 AM,48,-122,0,0,0
24841,SpokaneStBridge,11/01/2016 01:00:00 AM,48,-122,0,1,1
24842,SpokaneStBridge,11/01/2016 02:00:00 AM,48,-122,0,0,0
24843,SpokaneStBridge,11/01/2016 03:00:00 AM,48,-122,1,1,2
24844,SpokaneStBridge,11/01/2016 04:00:00 AM,48,-122,2,1,3
24845,SpokaneStBridge,11/01/2016 05:00:00 AM,48,-122,13,3,16
24846,SpokaneStBridge,11/01/2016 06:00:00 AM,48,-122,32,4,36
24847,SpokaneStBridge,11/01/2016 07:00:00 AM,48,-122,94,13,107
24848,SpokaneStBridge,11/01/2016 08:00:00 AM,48,-122,88,6,94
24849,SpokaneStBridge,11/01/2016 09:00:00 AM,48,-122,37,1,38
24850,SpokaneStBridge,11/01/2016 10:00:00 AM,48,-122,12,2,14
24851,SpokaneStBridge,11/01/2016 11:00:00 AM,48,-122,4,5,9
24852,SpokaneStBridge,11/01/2016 12:00:00 PM,48,-122,3,4,7
24853,SpokaneStBridge,11/01/2016 01:00:00 PM,48,-122,11,2,13
24854,SpokaneStBridge,11/01/2016 02:00:00 PM,48,-122,4,11,15
24855,SpokaneStBridge,11/01/2016 03:00:00 PM,48,-122,3,20,23
24856,SpokaneStBridge,11/01/2016 04:00:00 PM,48,-122,13,35,48
24857,SpokaneStBridge,11/01/2016 05:00:00 PM,48,-122,18,99,117
24858,SpokaneStBridge,11/01/2016 06:00:00 PM,48,-122,3,65,68
24859,SpokaneStBridge,11/01/2016 07:00:00 PM,48,-122,3,25,28
24860,SpokaneStBridge,11/01/2016 08:00:00 PM,48,-122,1,8,9
24861,SpokaneStBridge,11/01/2016 09:00:00 PM,48,-122,3,7,10
24862,SpokaneStBridge,11/01/2016 10:00:00 PM,48,-122,0,1,1
24863,SpokaneStBridge,11/01/2016 11:00:00 PM,48,-122,0,4,4
24864,SpokaneStBridge,11/02/2016 12:00:00 AM,48,-122,0,2,2
24865,SpokaneStBridge,11/02/2016 01:00:00 AM,48,-122,1,2,3
24866,SpokaneStBridge,11/02/2016 02:00:00 AM,48,-122,1,1,2
24867,SpokaneStBridge,11/02/2016 03:00:00 AM,48,-122,1,1,2
24868,SpokaneStBridge,11/02/2016 04:00:00 AM,48,-122,2,1,3
24869,SpokaneStBridge,11/02/2016 05:00:00 AM,48,-122,16,1,17
24870,SpokaneStBridge,11/02/2016 06:00:00 AM,48,-122,35,2,37
24871,SpokaneStBridge,11/02/2016 07:00:00 AM,48,-122,74,8,82
24872,SpokaneStBridge,11/02/2016 08:00:00 AM,48,-122,83,7,90
24873,SpokaneStBridge,11/02/2016 09:00:00 AM,48,-122,30,2,32
24874,SpokaneStBridge,11/02/2016 10:00:00 AM,48,-122,7,2,9
24875,SpokaneStBridge,11/02/2016 11:00:00 AM,48,-122,1,2,3
24876,SpokaneStBridge,11/02/2016 12:00:00 PM,48,-122,2,1,3
24877,SpokaneStBridge,11/02/2016 01:00:00 PM,48,-122,4,6,10
24878,SpokaneStBridge,11/02/2016 02:00:00 PM,48,-122,6,8,14
24879,SpokaneStBridge,11/02/2016 03:00:00 PM,48,-122,0,14,14
24880,SpokaneStBridge,11/02/2016 04:00:00 PM,48,-122,5,58,63
24881,SpokaneStBridge,11/02/2016 05:00:00 PM,48,-122,9,89,98
24882,SpokaneStBridge,11/02/2016 06:00:00 PM,48,-122,6,48,54
24883,SpokaneStBridge,11/02/2016 07:00:00 PM,48,-122,2,13,15
24884,SpokaneStBridge,11/02/2016 08:00:00 PM,48,-122,3,11,14
24885,SpokaneStBridge,11/02/2016 09:00:00 PM,48,-122,2,6,8
24886,SpokaneStBridge,11/02/2016 10:00:00 PM,48,-122,1,6,7
24887,SpokaneStBridge,11/02/2016 11:00:00 PM,48,-122,1,1,2
24888,SpokaneStBridge,11/03/2016 12:00:00 AM,48,-122,1,1,2
24889,SpokaneStBridge,11/03/2016 01:00:00 AM,48,-122,0,1,1
24890,SpokaneStBridge,11/03/2016 02:00:00 AM,48,-122,1,0,1
24891,SpokaneStBridge,11/03/2016 03:00:00 AM,48,-122,1,2,3
24892,SpokaneStBridge,11/03/2016 04:00:00 AM,48,-122,1,1,2
24893,SpokaneStBridge,11/03/2016 05:00:00 AM,48,-122,12,1,13
24894,SpokaneStBridge,11/03/2016 06:00:00 AM,48,-122,49,8,57
24895,SpokaneStBridge,11/03/2016 07:00:00 AM,48,-122,96,8,104
24896,SpokaneStBridge,11/03/2016 08:00:00 AM,48,-122,133,11,144
24897,SpokaneStBridge,11/03/2016 09:00:00 AM,48,-122,39,4,43
24898,SpokaneStBridge,11/03/2016 10:00:00 AM,48,-122,15,3,18
24899,SpokaneStBridge,11/03/2016 11:00:00 AM,48,-122,13,7,20
24900,SpokaneStBridge,11/03/2016 12:00:00 PM,48,-122,16,10,26
24901,SpokaneStBridge,11/03/2016 01:00:00 PM,48,-122,19,13,32
24902,SpokaneStBridge,11/03/2016 02:00:00 PM,48,-122,18,20,38
24903,SpokaneStBridge,11/03/2016 03:00:00 PM,48,-122,14,28,42
24904,SpokaneStBridge,11/03/2016 04:00:00 PM,48,-122,21,76,97
24905,SpokaneStBridge,11/03/2016 05:00:00 PM,48,-122,18,132,150
24906,SpokaneStBridge,11/03/2016 06:00:00 PM,48,-122,12,77,89
24907,SpokaneStBridge,11/03/2016 07:00:00 PM,48,-122,8,32,40
24908,SpokaneStBridge,11/03/2016 08:00:00 PM,48,-122,5,43,48
24909,SpokaneStBridge,11/03/2016 09:00:00 PM,48,-122,4,17,21
24910,SpokaneStBridge,11/03/2016 10:00:00 PM,48,-122,10,5,15
24911,SpokaneStBridge,11/03/2016 11:00:00 PM,48,-122,2,3,5
24912,SpokaneStBridge,11/04/2016 12:00:00 AM,48,-122,12,1,13
24913,SpokaneStBridge,11/04/2016 01:00:00 AM,48,-122,6,0,6
24914,SpokaneStBridge,11/04/2016 02:00:00 AM,48,-122,5,3,8
24915,SpokaneStBridge,11/04/2016 03:00:00 AM,48,-122,1,0,1
24916,SpokaneStBridge,11/04/2016 04:00:00 AM,48,-122,5,0,5
24917,SpokaneStBridge,11/04/2016 05:00:00 AM,48,-122,14,3,17
24918,SpokaneStBridge,11/04/2016 06:00:00 AM,48,-122,30,9,39
24919,SpokaneStBridge,11/04/2016 07:00:00 AM,48,-122,103,6,109
24920,SpokaneStBridge,11/04/2016 08:00:00 AM,48,-122,106,5,111
24921,SpokaneStBridge,11/04/2016 09:00:00 AM,48,-122,59,6,65
24922,SpokaneStBridge,11/04/2016 10:00:00 AM,48,-122,21,8,29
24923,SpokaneStBridge,11/04/2016 11:00:00 AM,48,-122,18,16,34
24924,SpokaneStBridge,11/04/2016 12:00:00 PM,48,-122,11,14,25
24925,SpokaneStBridge,11/04/2016 01:00:00 PM,48,-122,16,9,25
24926,SpokaneStBridge,11/04/2016 02:00:00 PM,48,-122,18,27,45
24927,SpokaneStBridge,11/04/2016 03:00:00 PM,48,-122,22,36,58
24928,SpokaneStBridge,11/04/2016 04:00:00 PM,48,-122,21,65,86
24929,SpokaneStBridge,11/04/2016 05:00:00 PM,48,-122,14,127,141
24930,SpokaneStBridge,11/04/2016 06:00:00 PM,48,-122,9,47,56
24931,SpokaneStBridge,11/04/2016 07:00:00 PM,48,-122,7,24,31
24932,SpokaneStBridge,11/04/2016 08:00:00 PM,48,-122,2,15,17
24933,SpokaneStBridge,11/04/2016 09:00:00 PM,48,-122,0,3,3
24934,SpokaneStBridge,11/04/2016 10:00:00 PM,48,-122,3,2,5
24935,SpokaneStBridge,11/04/2016 11:00:00 PM,48,-122,2,4,6
24936,SpokaneStBridge,11/05/2016 12:00:00 AM,48,-122,0,0,0
24937,SpokaneStBridge,11/05/2016 01:00:00 AM,48,-122,0,3,3
24938,SpokaneStBridge,11/05/2016 02:00:00 AM,48,-122,1,1,2
24939,SpokaneStBridge,11/05/2016 03:00:00 AM,48,-122,0,1,1
24940,SpokaneStBridge,11/05/2016 04:00:00 AM,48,-122,1,1,2
24941,SpokaneStBridge,11/05/2016 05:00:00 AM,48,-122,3,2,5
24942,SpokaneStBridge,11/05/2016 06:00:00 AM,48,-122,4,0,4
24943,SpokaneStBridge,11/05/2016 07:00:00 AM,48,-122,7,1,8
24944,SpokaneStBridge,11/05/2016 08:00:00 AM,48,-122,1,2,3
24945,SpokaneStBridge,11/05/2016 09:00:00 AM,48,-122,3,5,8
24946,SpokaneStBridge,11/05/2016 10:00:00 AM,48,-122,4,3,7
24947,SpokaneStBridge,11/05/2016 11:00:00 AM,48,-122,3,3,6
24948,SpokaneStBridge,11/05/2016 12:00:00 PM,48,-122,3,2,5
24949,SpokaneStBridge,11/05/2016 01:00:00 PM,48,-122,2,4,6
24950,SpokaneStBridge,11/05/2016 02:00:00 PM,48,-122,1,4,5
24951,SpokaneStBridge,11/05/2016 03:00:00 PM,48,-122,1,3,4
24952,SpokaneStBridge,11/05/2016 04:00:00 PM,48,-122,2,4,6
24953,SpokaneStBridge,11/05/2016 05:00:00 PM,48,-122,4,7,11
24954,SpokaneStBridge,11/05/2016 06:00:00 PM,48,-122,3,4,7
24955,SpokaneStBridge,11/05/2016 07:00:00 PM,48,-122,1,2,3
24956,SpokaneStBridge,11/05/2016 08:00:00 PM,48,-122,2,2,4
24957,SpokaneStBridge,11/05/2016 09:00:00 PM,48,-122,2,4,6
24958,SpokaneStBridge,11/05/2016 10:00:00 PM,48,-122,1,1,2
24959,SpokaneStBridge,11/05/2016 11:00:00 PM,48,-122,0,8,8
24960,SpokaneStBridge,11/06/2016 12:00:00 AM,48,-122,2,5,7
24961,SpokaneStBridge,11/06/2016 01:00:00 AM,48,-122,17,10,27
24962,SpokaneStBridge,11/06/2016 02:00:00 AM,48,-122,0,1,1
24963,SpokaneStBridge,11/06/2016 03:00:00 AM,48,-122,1,1,2
24964,SpokaneStBridge,11/06/2016 04:00:00 AM,48,-122,0,0,0
24965,SpokaneStBridge,11/06/2016 05:00:00 AM,48,-122,1,1,2
24966,SpokaneStBridge,11/06/2016 06:00:00 AM,48,-122,2,1,3
24967,SpokaneStBridge,11/06/2016 07:00:00 AM,48,-122,2,0,2
24968,SpokaneStBridge,11/06/2016 08:00:00 AM,48,-122,5,2,7
24969,SpokaneStBridge,11/06/2016 09:00:00 AM,48,-122,15,10,25
24970,SpokaneStBridge,11/06/2016 10:00:00 AM,48,-122,20,53,73
24971,SpokaneStBridge,11/06/2016 11:00:00 AM,48,-122,37,45,82
24972,SpokaneStBridge,11/06/2016 12:00:00 PM,48,-122,59,23,82
24973,SpokaneStBridge,11/06/2016 01:00:00 PM,48,-122,32,26,58
24974,SpokaneStBridge,11/06/2016 02:00:00 PM,48,-122,21,21,42
24975,SpokaneStBridge,11/06/2016 03:00:00 PM,48,-122,17,18,35
24976,SpokaneStBridge,11/06/2016 04:00:00 PM,48,-122,11,24,35
24977,SpokaneStBridge,11/06/2016 05:00:00 PM,48,-122,11,6,17
24978,SpokaneStBridge,11/06/2016 06:00:00 PM,48,-122,3,11,14
24979,SpokaneStBridge,11/06/2016 07:00:00 PM,48,-122,2,1,3
24980,SpokaneStBridge,11/06/2016 08:00:00 PM,48,-122,0,4,4
24981,SpokaneStBridge,11/06/2016 09:00:00 PM,48,-122,3,6,9
24982,SpokaneStBridge,11/06/2016 10:00:00 PM,48,-122,0,2,2
24983,SpokaneStBridge,11/06/2016 11:00:00 PM,48,-122,1,1,2
24984,SpokaneStBridge,11/07/2016 12:00:00 AM,48,-122,2,3,5
24985,SpokaneStBridge,11/07/2016 01:00:00 AM,48,-122,1,0,1
24986,SpokaneStBridge,11/07/2016 02:00:00 AM,48,-122,1,1,2
24987,SpokaneStBridge,11/07/2016 03:00:00 AM,48,-122,0,0,0
24988,SpokaneStBridge,11/07/2016 04:00:00 AM,48,-122,0,0,0
24989,SpokaneStBridge,11/07/2016 05:00:00 AM,48,-122,14,1,15
24990,SpokaneStBridge,11/07/2016 06:00:00 AM,48,-122,46,6,52
24991,SpokaneStBridge,11/07/2016 07:00:00 AM,48,-122,113,10,123
24992,SpokaneStBridge,11/07/2016 08:00:00 AM,48,-122,112,4,116
24993,SpokaneStBridge,11/07/2016 09:00:00 AM,48,-122,43,7,50
24994,SpokaneStBridge,11/07/2016 10:00:00 AM,48,-122,17,2,19
24995,SpokaneStBridge,11/07/2016 11:00:00 AM,48,-122,3,9,12
24996,SpokaneStBridge,11/07/2016 12:00:00 PM,48,-122,11,8,19
24997,SpokaneStBridge,11/07/2016 01:00:00 PM,48,-122,12,8,20
24998,SpokaneStBridge,11/07/2016 02:00:00 PM,48,-122,12,9,21
24999,SpokaneStBridge,11/07/2016 03:00:00 PM,48,-122,15,22,37
25000,SpokaneStBridge,11/07/2016 04:00:00 PM,48,-122,26,81,107
25001,SpokaneStBridge,11/07/2016 05:00:00 PM,48,-122,9,139,148
25002,SpokaneStBridge,11/07/2016 06:00:00 PM,48,-122,6,53,59
25003,SpokaneStBridge,11/07/2016 07:00:00 PM,48,-122,2,18,20
25004,SpokaneStBridge,11/07/2016 08:00:00 PM,48,-122,2,17,19
25005,SpokaneStBridge,11/07/2016 09:00:00 PM,48,-122,2,9,11
25006,SpokaneStBridge,11/07/2016 10:00:00 PM,48,-122,0,4,4
25007,SpokaneStBridge,11/07/2016 11:00:00 PM,48,-122,0,4,4
25008,SpokaneStBridge,11/08/2016 12:00:00 AM,48,-122,2,3,5
25009,SpokaneStBridge,11/08/2016 01:00:00 AM,48,-122,0,1,1
25010,SpokaneStBridge,11/08/2016 02:00:00 AM,48,-122,0,1,1
25011,SpokaneStBridge,11/08/2016 03:00:00 AM,48,-122,0,1,1
25012,SpokaneStBridge,11/08/2016 04:00:00 AM,48,-122,3,2,5
25013,SpokaneStBridge,11/08/2016 05:00:00 AM,48,-122,23,4,27
25014,SpokaneStBridge,11/08/2016 06:00:00 AM,48,-122,60,9,69
25015,SpokaneStBridge,11/08/2016 07:00:00 AM,48,-122,144,17,161
25016,SpokaneStBridge,11/08/2016 08:00:00 AM,48,-122,138,11,149
25017,SpokaneStBridge,11/08/2016 09:00:00 AM,48,-122,51,6,57
25018,SpokaneStBridge,11/08/2016 10:00:00 AM,48,-122,14,3,17
25019,SpokaneStBridge,11/08/2016 11:00:00 AM,48,-122,15,20,35
25020,SpokaneStBridge,11/08/2016 12:00:00 PM,48,-122,20,18,38
25021,SpokaneStBridge,11/08/2016 01:00:00 PM,48,-122,21,21,42
25022,SpokaneStBridge,11/08/2016 02:00:00 PM,48,-122,19,33,52
25023,SpokaneStBridge,11/08/2016 03:00:00 PM,48,-122,21,42,63
25024,SpokaneStBridge,11/08/2016 04:00:00 PM,48,-122,15,96,111
25025,SpokaneStBridge,11/08/2016 05:00:00 PM,48,-122,24,162,186
25026,SpokaneStBridge,11/08/2016 06:00:00 PM,48,-122,6,56,62
25027,SpokaneStBridge,11/08/2016 07:00:00 PM,48,-122,7,21,28
25028,SpokaneStBridge,11/08/2016 08:00:00 PM,48,-122,2,9,11
25029,SpokaneStBridge,11/08/2016 09:00:00 PM,48,-122,3,8,11
25030,SpokaneStBridge,11/08/2016 10:00:00 PM,48,-122,1,4,5
25031,SpokaneStBridge,11/08/2016 11:00:00 PM,48,-122,3,3,6
25032,SpokaneStBridge,11/09/2016 12:00:00 AM,48,-122,1,3,4
25033,SpokaneStBridge,11/09/2016 01:00:00 AM,48,-122,0,1,1
25034,SpokaneStBridge,11/09/2016 02:00:00 AM,48,-122,3,0,3
25035,SpokaneStBridge,11/09/2016 03:00:00 AM,48,-122,1,0,1
25036,SpokaneStBridge,11/09/2016 04:00:00 AM,48,-122,2,2,4
25037,SpokaneStBridge,11/09/2016 05:00:00 AM,48,-122,14,5,19
25038,SpokaneStBridge,11/09/2016 06:00:00 AM,48,-122,33,5,38
25039,SpokaneStBridge,11/09/2016 07:00:00 AM,48,-122,91,8,99
25040,SpokaneStBridge,11/09/2016 08:00:00 AM,48,-122,109,6,115
25041,SpokaneStBridge,11/09/2016 09:00:00 AM,48,-122,42,8,50
25042,SpokaneStBridge,11/09/2016 10:00:00 AM,48,-122,6,2,8
25043,SpokaneStBridge,11/09/2016 11:00:00 AM,48,-122,10,2,12
25044,SpokaneStBridge,11/09/2016 12:00:00 PM,48,-122,11,7,18
25045,SpokaneStBridge,11/09/2016 01:00:00 PM,48,-122,8,9,17
25046,SpokaneStBridge,11/09/2016 02:00:00 PM,48,-122,8,17,25
25047,SpokaneStBridge,11/09/2016 03:00:00 PM,48,-122,15,28,43
25048,SpokaneStBridge,11/09/2016 04:00:00 PM,48,-122,16,74,90
25049,SpokaneStBridge,11/09/2016 05:00:00 PM,48,-122,19,106,125
25050,SpokaneStBridge,11/09/2016 06:00:00 PM,48,-122,7,69,76
25051,SpokaneStBridge,11/09/2016 07:00:00 PM,48,-122,1,20,21
25052,SpokaneStBridge,11/09/2016 08:00:00 PM,48,-122,2,13,15
25053,SpokaneStBridge,11/09/2016 09:00:00 PM,48,-122,3,10,13
25054,SpokaneStBridge,11/09/2016 10:00:00 PM,48,-122,1,2,3
25055,SpokaneStBridge,11/09/2016 11:00:00 PM,48,-122,1,0,1
25056,SpokaneStBridge,11/10/2016 12:00:00 AM,48,-122,0,3,3
25057,SpokaneStBridge,11/10/2016 01:00:00 AM,48,-122,3,4,7
25058,SpokaneStBridge,11/10/2016 02:00:00 AM,48,-122,2,0,2
25059,SpokaneStBridge,11/10/2016 03:00:00 AM,48,-122,4,1,5
25060,SpokaneStBridge,11/10/2016 04:00:00 AM,48,-122,1,1,2
25061,SpokaneStBridge,11/10/2016 05:00:00 AM,48,-122,11,2,13
25062,SpokaneStBridge,11/10/2016 06:00:00 AM,48,-122,42,11,53
25063,SpokaneStBridge,11/10/2016 07:00:00 AM,48,-122,116,12,128
25064,SpokaneStBridge,11/10/2016 08:00:00 AM,48,-122,122,8,130
25065,SpokaneStBridge,11/10/2016 09:00:00 AM,48,-122,52,9,61
25066,SpokaneStBridge,11/10/2016 10:00:00 AM,48,-122,12,7,19
25067,SpokaneStBridge,11/10/2016 11:00:00 AM,48,-122,21,14,35
25068,SpokaneStBridge,11/10/2016 12:00:00 PM,48,-122,13,10,23
25069,SpokaneStBridge,11/10/2016 01:00:00 PM,48,-122,15,11,26
25070,SpokaneStBridge,11/10/2016 02:00:00 PM,48,-122,18,19,37
25071,SpokaneStBridge,11/10/2016 03:00:00 PM,48,-122,16,24,40
25072,SpokaneStBridge,11/10/2016 04:00:00 PM,48,-122,24,79,103
25073,SpokaneStBridge,11/10/2016 05:00:00 PM,48,-122,15,113,128
25074,SpokaneStBridge,11/10/2016 06:00:00 PM,48,-122,7,69,76
25075,SpokaneStBridge,11/10/2016 07:00:00 PM,48,-122,3,21,24
25076,SpokaneStBridge,11/10/2016 08:00:00 PM,48,-122,3,17,20
25077,SpokaneStBridge,11/10/2016 09:00:00 PM,48,-122,3,9,12
25078,SpokaneStBridge,11/10/2016 10:00:00 PM,48,-122,3,6,9
25079,SpokaneStBridge,11/10/2016 11:00:00 PM,48,-122,1,1,2
25080,SpokaneStBridge,11/11/2016 12:00:00 AM,48,-122,0,2,2
25081,SpokaneStBridge,11/11/2016 01:00:00 AM,48,-122,1,0,1
25082,SpokaneStBridge,11/11/2016 02:00:00 AM,48,-122,0,4,4
25083,SpokaneStBridge,11/11/2016 03:00:00 AM,48,-122,2,1,3
25084,SpokaneStBridge,11/11/2016 04:00:00 AM,48,-122,2,0,2
25085,SpokaneStBridge,11/11/2016 05:00:00 AM,48,-122,10,2,12
25086,SpokaneStBridge,11/11/2016 06:00:00 AM,48,-122,34,4,38
25087,SpokaneStBridge,11/11/2016 07:00:00 AM,48,-122,83,10,93
25088,SpokaneStBridge,11/11/2016 08:00:00 AM,48,-122,81,7,88
25089,SpokaneStBridge,11/11/2016 09:00:00 AM,48,-122,43,6,49
25090,SpokaneStBridge,11/11/2016 10:00:00 AM,48,-122,16,9,25
25091,SpokaneStBridge,11/11/2016 11:00:00 AM,48,-122,12,32,44
25092,SpokaneStBridge,11/11/2016 12:00:00 PM,48,-122,15,22,37
25093,SpokaneStBridge,11/11/2016 01:00:00 PM,48,-122,33,6,39
25094,SpokaneStBridge,11/11/2016 02:00:00 PM,48,-122,7,18,25
25095,SpokaneStBridge,11/11/2016 03:00:00 PM,48,-122,15,34,49
25096,SpokaneStBridge,11/11/2016 04:00:00 PM,48,-122,18,55,73
25097,SpokaneStBridge,11/11/2016 05:00:00 PM,48,-122,12,75,87
25098,SpokaneStBridge,11/11/2016 06:00:00 PM,48,-122,4,36,40
25099,SpokaneStBridge,11/11/2016 07:00:00 PM,48,-122,7,17,24
25100,SpokaneStBridge,11/11/2016 08:00:00 PM,48,-122,1,14,15
25101,SpokaneStBridge,11/11/2016 09:00:00 PM,48,-122,3,9,12
25102,SpokaneStBridge,11/11/2016 10:00:00 PM,48,-122,1,3,4
25103,SpokaneStBridge,11/11/2016 11:00:00 PM,48,-122,0,0,0
25104,SpokaneStBridge,11/12/2016 12:00:00 AM,48,-122,2,2,4
25105,SpokaneStBridge,11/12/2016 01:00:00 AM,48,-122,0,1,1
25106,SpokaneStBridge,11/12/2016 02:00:00 AM,48,-122,0,3,3
25107,SpokaneStBridge,11/12/2016 03:00:00 AM,48,-122,0,3,3
25108,SpokaneStBridge,11/12/2016 04:00:00 AM,48,-122,1,0,1
25109,SpokaneStBridge,11/12/2016 05:00:00 AM,48,-122,4,1,5
25110,SpokaneStBridge,11/12/2016 06:00:00 AM,48,-122,4,2,6
25111,SpokaneStBridge,11/12/2016 07:00:00 AM,48,-122,2,1,3
25112,SpokaneStBridge,11/12/2016 08:00:00 AM,48,-122,5,6,11
25113,SpokaneStBridge,11/12/2016 09:00:00 AM,48,-122,3,0,3
25114,SpokaneStBridge,11/12/2016 10:00:00 AM,48,-122,8,4,12
25115,SpokaneStBridge,11/12/2016 11:00:00 AM,48,-122,3,2,5
25116,SpokaneStBridge,11/12/2016 12:00:00 PM,48,-122,9,6,15
25117,SpokaneStBridge,11/12/2016 01:00:00 PM,48,-122,8,3,11
25118,SpokaneStBridge,11/12/2016 02:00:00 PM,48,-122,6,8,14
25119,SpokaneStBridge,11/12/2016 03:00:00 PM,48,-122,6,7,13
25120,SpokaneStBridge,11/12/2016 04:00:00 PM,48,-122,8,12,20
25121,SpokaneStBridge,11/12/2016 05:00:00 PM,48,-122,5,6,11
25122,SpokaneStBridge,11/12/2016 06:00:00 PM,48,-122,3,4,7
25123,SpokaneStBridge,11/12/2016 07:00:00 PM,48,-122,1,3,4
25124,SpokaneStBridge,11/12/2016 08:00:00 PM,48,-122,1,3,4
25125,SpokaneStBridge,11/12/2016 09:00:00 PM,48,-122,1,4,5
25126,SpokaneStBridge,11/12/2016 10:00:00 PM,48,-122,0,2,2
25127,SpokaneStBridge,11/12/2016 11:00:00 PM,48,-122,0,2,2
25128,SpokaneStBridge,11/13/2016 12:00:00 AM,48,-122,1,0,1
25129,SpokaneStBridge,11/13/2016 01:00:00 AM,48,-122,1,2,3
25130,SpokaneStBridge,11/13/2016 02:00:00 AM,48,-122,1,2,3
25131,SpokaneStBridge,11/13/2016 03:00:00 AM,48,-122,2,1,3
25132,SpokaneStBridge,11/13/2016 04:00:00 AM,48,-122,0,1,1
25133,SpokaneStBridge,11/13/2016 05:00:00 AM,48,-122,4,1,5
25134,SpokaneStBridge,11/13/2016 06:00:00 AM,48,-122,3,0,3
25135,SpokaneStBridge,11/13/2016 07:00:00 AM,48,-122,6,1,7
25136,SpokaneStBridge,11/13/2016 08:00:00 AM,48,-122,5,1,6
25137,SpokaneStBridge,11/13/2016 09:00:00 AM,48,-122,3,5,8
25138,SpokaneStBridge,11/13/2016 10:00:00 AM,48,-122,3,2,5
25139,SpokaneStBridge,11/13/2016 11:00:00 AM,48,-122,4,4,8
25140,SpokaneStBridge,11/13/2016 12:00:00 PM,48,-122,2,6,8
25141,SpokaneStBridge,11/13/2016 01:00:00 PM,48,-122,8,3,11
25142,SpokaneStBridge,11/13/2016 02:00:00 PM,48,-122,1,7,8
25143,SpokaneStBridge,11/13/2016 03:00:00 PM,48,-122,1,3,4
25144,SpokaneStBridge,11/13/2016 04:00:00 PM,48,-122,3,7,10
25145,SpokaneStBridge,11/13/2016 05:00:00 PM,48,-122,1,5,6
25146,SpokaneStBridge,11/13/2016 06:00:00 PM,48,-122,1,0,1
25147,SpokaneStBridge,11/13/2016 07:00:00 PM,48,-122,0,0,0
25148,SpokaneStBridge,11/13/2016 08:00:00 PM,48,-122,0,0,0
25149,SpokaneStBridge,11/13/2016 09:00:00 PM,48,-122,2,1,3
25150,SpokaneStBridge,11/13/2016 10:00:00 PM,48,-122,0,1,1
25151,SpokaneStBridge,11/13/2016 11:00:00 PM,48,-122,2,1,3
25152,SpokaneStBridge,11/14/2016 12:00:00 AM,48,-122,0,0,0
25153,SpokaneStBridge,11/14/2016 01:00:00 AM,48,-122,1,1,2
25154,SpokaneStBridge,11/14/2016 02:00:00 AM,48,-122,0,0,0
25155,SpokaneStBridge,11/14/2016 03:00:00 AM,48,-122,0,6,6
25156,SpokaneStBridge,11/14/2016 04:00:00 AM,48,-122,2,0,2
25157,SpokaneStBridge,11/14/2016 05:00:00 AM,48,-122,17,3,20
25158,SpokaneStBridge,11/14/2016 06:00:00 AM,48,-122,47,6,53
25159,SpokaneStBridge,11/14/2016 07:00:00 AM,48,-122,101,8,109
25160,SpokaneStBridge,11/14/2016 08:00:00 AM,48,-122,116,8,124
25161,SpokaneStBridge,11/14/2016 09:00:00 AM,48,-122,42,7,49
25162,SpokaneStBridge,11/14/2016 10:00:00 AM,48,-122,10,5,15
25163,SpokaneStBridge,11/14/2016 11:00:00 AM,48,-122,6,3,9
25164,SpokaneStBridge,11/14/2016 12:00:00 PM,48,-122,6,5,11
25165,SpokaneStBridge,11/14/2016 01:00:00 PM,48,-122,10,5,15
25166,SpokaneStBridge,11/14/2016 02:00:00 PM,48,-122,8,13,21
25167,SpokaneStBridge,11/14/2016 03:00:00 PM,48,-122,14,28,42
25168,SpokaneStBridge,11/14/2016 04:00:00 PM,48,-122,14,72,86
25169,SpokaneStBridge,11/14/2016 05:00:00 PM,48,-122,19,123,142
25170,SpokaneStBridge,11/14/2016 06:00:00 PM,48,-122,5,70,75
25171,SpokaneStBridge,11/14/2016 07:00:00 PM,48,-122,3,22,25
25172,SpokaneStBridge,11/14/2016 08:00:00 PM,48,-122,1,9,10
25173,SpokaneStBridge,11/14/2016 09:00:00 PM,48,-122,4,8,12
25174,SpokaneStBridge,11/14/2016 10:00:00 PM,48,-122,1,2,3
25175,SpokaneStBridge,11/14/2016 11:00:00 PM,48,-122,0,3,3
25176,SpokaneStBridge,11/15/2016 12:00:00 AM,48,-122,0,1,1
25177,SpokaneStBridge,11/15/2016 01:00:00 AM,48,-122,0,1,1
25178,SpokaneStBridge,11/15/2016 02:00:00 AM,48,-122,0,0,0
25179,SpokaneStBridge,11/15/2016 03:00:00 AM,48,-122,2,0,2
25180,SpokaneStBridge,11/15/2016 04:00:00 AM,48,-122,1,0,1
25181,SpokaneStBridge,11/15/2016 05:00:00 AM,48,-122,12,0,12
25182,SpokaneStBridge,11/15/2016 06:00:00 AM,48,-122,31,2,33
25183,SpokaneStBridge,11/15/2016 07:00:00 AM,48,-122,88,11,99
25184,SpokaneStBridge,11/15/2016 08:00:00 AM,48,-122,94,11,105
25185,SpokaneStBridge,11/15/2016 09:00:00 AM,48,-122,41,1,42
25186,SpokaneStBridge,11/15/2016 10:00:00 AM,48,-122,16,4,20
25187,SpokaneStBridge,11/15/2016 11:00:00 AM,48,-122,11,10,21
25188,SpokaneStBridge,11/15/2016 12:00:00 PM,48,-122,8,10,18
25189,SpokaneStBridge,11/15/2016 01:00:00 PM,48,-122,12,5,17
25190,SpokaneStBridge,11/15/2016 02:00:00 PM,48,-122,4,12,16
25191,SpokaneStBridge,11/15/2016 03:00:00 PM,48,-122,4,17,21
25192,SpokaneStBridge,11/15/2016 04:00:00 PM,48,-122,9,51,60
25193,SpokaneStBridge,11/15/2016 05:00:00 PM,48,-122,11,88,99
25194,SpokaneStBridge,11/15/2016 06:00:00 PM,48,-122,10,55,65
25195,SpokaneStBridge,11/15/2016 07:00:00 PM,48,-122,5,17,22
25196,SpokaneStBridge,11/15/2016 08:00:00 PM,48,-122,2,6,8
25197,SpokaneStBridge,11/15/2016 09:00:00 PM,48,-122,1,5,6
25198,SpokaneStBridge,11/15/2016 10:00:00 PM,48,-122,0,4,4
25199,SpokaneStBridge,11/15/2016 11:00:00 PM,48,-122,0,3,3
25200,SpokaneStBridge,11/16/2016 12:00:00 AM,48,-122,1,3,4
25201,SpokaneStBridge,11/16/2016 01:00:00 AM,48,-122,0,0,0
25202,SpokaneStBridge,11/16/2016 02:00:00 AM,48,-122,0,0,0
25203,SpokaneStBridge,11/16/2016 03:00:00 AM,48,-122,1,2,3
25204,SpokaneStBridge,11/16/2016 04:00:00 AM,48,-122,4,1,5
25205,SpokaneStBridge,11/16/2016 05:00:00 AM,48,-122,16,3,19
25206,SpokaneStBridge,11/16/2016 06:00:00 AM,48,-122,41,6,47
25207,SpokaneStBridge,11/16/2016 07:00:00 AM,48,-122,112,13,125
25208,SpokaneStBridge,11/16/2016 08:00:00 AM,48,-122,111,14,125
25209,SpokaneStBridge,11/16/2016 09:00:00 AM,48,-122,27,7,34
25210,SpokaneStBridge,11/16/2016 10:00:00 AM,48,-122,20,2,22
25211,SpokaneStBridge,11/16/2016 11:00:00 AM,48,-122,14,5,19
25212,SpokaneStBridge,11/16/2016 12:00:00 PM,48,-122,6,9,15
25213,SpokaneStBridge,11/16/2016 01:00:00 PM,48,-122,9,8,17
25214,SpokaneStBridge,11/16/2016 02:00:00 PM,48,-122,4,13,17
25215,SpokaneStBridge,11/16/2016 03:00:00 PM,48,-122,9,23,32
25216,SpokaneStBridge,11/16/2016 04:00:00 PM,48,-122,13,56,69
25217,SpokaneStBridge,11/16/2016 05:00:00 PM,48,-122,11,109,120
25218,SpokaneStBridge,11/16/2016 06:00:00 PM,48,-122,11,63,74
25219,SpokaneStBridge,11/16/2016 07:00:00 PM,48,-122,11,18,29
25220,SpokaneStBridge,11/16/2016 08:00:00 PM,48,-122,1,12,13
25221,SpokaneStBridge,11/16/2016 09:00:00 PM,48,-122,2,10,12
25222,SpokaneStBridge,11/16/2016 10:00:00 PM,48,-122,4,5,9
25223,SpokaneStBridge,11/16/2016 11:00:00 PM,48,-122,2,3,5
25224,SpokaneStBridge,11/17/2016 12:00:00 AM,48,-122,0,2,2
25225,SpokaneStBridge,11/17/2016 01:00:00 AM,48,-122,1,1,2
25226,SpokaneStBridge,11/17/2016 02:00:00 AM,48,-122,1,0,1
25227,SpokaneStBridge,11/17/2016 03:00:00 AM,48,-122,1,0,1
25228,SpokaneStBridge,11/17/2016 04:00:00 AM,48,-122,3,0,3
25229,SpokaneStBridge,11/17/2016 05:00:00 AM,48,-122,14,0,14
25230,SpokaneStBridge,11/17/2016 06:00:00 AM,48,-122,47,5,52
25231,SpokaneStBridge,11/17/2016 07:00:00 AM,48,-122,103,12,115
25232,SpokaneStBridge,11/17/2016 08:00:00 AM,48,-122,113,6,119
25233,SpokaneStBridge,11/17/2016 09:00:00 AM,48,-122,39,4,43
25234,SpokaneStBridge,11/17/2016 10:00:00 AM,48,-122,12,5,17
25235,SpokaneStBridge,11/17/2016 11:00:00 AM,48,-122,10,7,17
25236,SpokaneStBridge,11/17/2016 12:00:00 PM,48,-122,5,9,14
25237,SpokaneStBridge,11/17/2016 01:00:00 PM,48,-122,10,4,14
25238,SpokaneStBridge,11/17/2016 02:00:00 PM,48,-122,11,16,27
25239,SpokaneStBridge,11/17/2016 03:00:00 PM,48,-122,19,28,47
25240,SpokaneStBridge,11/17/2016 04:00:00 PM,48,-122,18,68,86
25241,SpokaneStBridge,11/17/2016 05:00:00 PM,48,-122,21,104,125
25242,SpokaneStBridge,11/17/2016 06:00:00 PM,48,-122,17,66,83
25243,SpokaneStBridge,11/17/2016 07:00:00 PM,48,-122,4,25,29
25244,SpokaneStBridge,11/17/2016 08:00:00 PM,48,-122,2,12,14
25245,SpokaneStBridge,11/17/2016 09:00:00 PM,48,-122,2,8,10
25246,SpokaneStBridge,11/17/2016 10:00:00 PM,48,-122,0,1,1
25247,SpokaneStBridge,11/17/2016 11:00:00 PM,48,-122,0,2,2
25248,SpokaneStBridge,11/18/2016 12:00:00 AM,48,-122,0,0,0
25249,SpokaneStBridge,11/18/2016 01:00:00 AM,48,-122,1,1,2
25250,SpokaneStBridge,11/18/2016 02:00:00 AM,48,-122,1,1,2
25251,SpokaneStBridge,11/18/2016 03:00:00 AM,48,-122,0,1,1
25252,SpokaneStBridge,11/18/2016 04:00:00 AM,48,-122,6,0,6
25253,SpokaneStBridge,11/18/2016 05:00:00 AM,48,-122,14,3,17
25254,SpokaneStBridge,11/18/2016 06:00:00 AM,48,-122,37,4,41
25255,SpokaneStBridge,11/18/2016 07:00:00 AM,48,-122,88,7,95
25256,SpokaneStBridge,11/18/2016 08:00:00 AM,48,-122,100,8,108
25257,SpokaneStBridge,11/18/2016 09:00:00 AM,48,-122,27,6,33
25258,SpokaneStBridge,11/18/2016 10:00:00 AM,48,-122,21,4,25
25259,SpokaneStBridge,11/18/2016 11:00:00 AM,48,-122,12,4,16
25260,SpokaneStBridge,11/18/2016 12:00:00 PM,48,-122,9,12,21
25261,SpokaneStBridge,11/18/2016 01:00:00 PM,48,-122,9,12,21
25262,SpokaneStBridge,11/18/2016 02:00:00 PM,48,-122,16,20,36
25263,SpokaneStBridge,11/18/2016 03:00:00 PM,48,-122,17,34,51
25264,SpokaneStBridge,11/18/2016 04:00:00 PM,48,-122,10,56,66
25265,SpokaneStBridge,11/18/2016 05:00:00 PM,48,-122,16,79,95
25266,SpokaneStBridge,11/18/2016 06:00:00 PM,48,-122,8,48,56
25267,SpokaneStBridge,11/18/2016 07:00:00 PM,48,-122,6,14,20
25268,SpokaneStBridge,11/18/2016 08:00:00 PM,48,-122,5,3,8
25269,SpokaneStBridge,11/18/2016 09:00:00 PM,48,-122,0,4,4
25270,SpokaneStBridge,11/18/2016 10:00:00 PM,48,-122,1,2,3
25271,SpokaneStBridge,11/18/2016 11:00:00 PM,48,-122,1,1,2
25272,SpokaneStBridge,11/19/2016 12:00:00 AM,48,-122,1,1,2
25273,SpokaneStBridge,11/19/2016 01:00:00 AM,48,-122,0,0,0
25274,SpokaneStBridge,11/19/2016 02:00:00 AM,48,-122,1,1,2
25275,SpokaneStBridge,11/19/2016 03:00:00 AM,48,-122,0,4,4
25276,SpokaneStBridge,11/19/2016 04:00:00 AM,48,-122,2,2,4
25277,SpokaneStBridge,11/19/2016 05:00:00 AM,48,-122,9,0,9
25278,SpokaneStBridge,11/19/2016 06:00:00 AM,48,-122,4,0,4
25279,SpokaneStBridge,11/19/2016 07:00:00 AM,48,-122,2,0,2
25280,SpokaneStBridge,11/19/2016 08:00:00 AM,48,-122,7,4,11
25281,SpokaneStBridge,11/19/2016 09:00:00 AM,48,-122,7,5,12
25282,SpokaneStBridge,11/19/2016 10:00:00 AM,48,-122,8,7,15
25283,SpokaneStBridge,11/19/2016 11:00:00 AM,48,-122,10,3,13
25284,SpokaneStBridge,11/19/2016 12:00:00 PM,48,-122,7,8,15
25285,SpokaneStBridge,11/19/2016 01:00:00 PM,48,-122,13,11,24
25286,SpokaneStBridge,11/19/2016 02:00:00 PM,48,-122,16,10,26
25287,SpokaneStBridge,11/19/2016 03:00:00 PM,48,-122,16,13,29
25288,SpokaneStBridge,11/19/2016 04:00:00 PM,48,-122,5,11,16
25289,SpokaneStBridge,11/19/2016 05:00:00 PM,48,-122,7,9,16
25290,SpokaneStBridge,11/19/2016 06:00:00 PM,48,-122,5,9,14
25291,SpokaneStBridge,11/19/2016 07:00:00 PM,48,-122,2,1,3
25292,SpokaneStBridge,11/19/2016 08:00:00 PM,48,-122,1,3,4
25293,SpokaneStBridge,11/19/2016 09:00:00 PM,48,-122,1,2,3
25294,SpokaneStBridge,11/19/2016 10:00:00 PM,48,-122,0,4,4
25295,SpokaneStBridge,11/19/2016 11:00:00 PM,48,-122,1,1,2
25296,SpokaneStBridge,11/20/2016 12:00:00 AM,48,-122,1,2,3
25297,SpokaneStBridge,11/20/2016 01:00:00 AM,48,-122,1,0,1
25298,SpokaneStBridge,11/20/2016 02:00:00 AM,48,-122,2,1,3
25299,SpokaneStBridge,11/20/2016 03:00:00 AM,48,-122,0,0,0
25300,SpokaneStBridge,11/20/2016 04:00:00 AM,48,-122,0,2,2
25301,SpokaneStBridge,11/20/2016 05:00:00 AM,48,-122,4,1,5
25302,SpokaneStBridge,11/20/2016 06:00:00 AM,48,-122,2,3,5
25303,SpokaneStBridge,11/20/2016 07:00:00 AM,48,-122,3,0,3
25304,SpokaneStBridge,11/20/2016 08:00:00 AM,48,-122,6,3,9
25305,SpokaneStBridge,11/20/2016 09:00:00 AM,48,-122,10,12,22
25306,SpokaneStBridge,11/20/2016 10:00:00 AM,48,-122,6,4,10
25307,SpokaneStBridge,11/20/2016 11:00:00 AM,48,-122,5,2,7
25308,SpokaneStBridge,11/20/2016 12:00:00 PM,48,-122,11,3,14
25309,SpokaneStBridge,11/20/2016 01:00:00 PM,48,-122,8,4,12
25310,SpokaneStBridge,11/20/2016 02:00:00 PM,48,-122,9,4,13
25311,SpokaneStBridge,11/20/2016 03:00:00 PM,48,-122,4,4,8
25312,SpokaneStBridge,11/20/2016 04:00:00 PM,48,-122,3,7,10
25313,SpokaneStBridge,11/20/2016 05:00:00 PM,48,-122,2,5,7
25314,SpokaneStBridge,11/20/2016 06:00:00 PM,48,-122,0,4,4
25315,SpokaneStBridge,11/20/2016 07:00:00 PM,48,-122,0,1,1
25316,SpokaneStBridge,11/20/2016 08:00:00 PM,48,-122,2,2,4
25317,SpokaneStBridge,11/20/2016 09:00:00 PM,48,-122,1,4,5
25318,SpokaneStBridge,11/20/2016 10:00:00 PM,48,-122,1,1,2
25319,SpokaneStBridge,11/20/2016 11:00:00 PM,48,-122,0,1,1
25320,SpokaneStBridge,11/21/2016 12:00:00 AM,48,-122,1,0,1
25321,SpokaneStBridge,11/21/2016 01:00:00 AM,48,-122,0,2,2
25322,SpokaneStBridge,11/21/2016 02:00:00 AM,48,-122,1,2,3
25323,SpokaneStBridge,11/21/2016 03:00:00 AM,48,-122,2,1,3
25324,SpokaneStBridge,11/21/2016 04:00:00 AM,48,-122,4,0,4
25325,SpokaneStBridge,11/21/2016 05:00:00 AM,48,-122,15,1,16
25326,SpokaneStBridge,11/21/2016 06:00:00 AM,48,-122,41,6,47
25327,SpokaneStBridge,11/21/2016 07:00:00 AM,48,-122,97,9,106
25328,SpokaneStBridge,11/21/2016 08:00:00 AM,48,-122,104,5,109
25329,SpokaneStBridge,11/21/2016 09:00:00 AM,48,-122,47,3,50
25330,SpokaneStBridge,11/21/2016 10:00:00 AM,48,-122,12,5,17
25331,SpokaneStBridge,11/21/2016 11:00:00 AM,48,-122,14,7,21
25332,SpokaneStBridge,11/21/2016 12:00:00 PM,48,-122,9,7,16
25333,SpokaneStBridge,11/21/2016 01:00:00 PM,48,-122,12,6,18
25334,SpokaneStBridge,11/21/2016 02:00:00 PM,48,-122,12,18,30
25335,SpokaneStBridge,11/21/2016 03:00:00 PM,48,-122,7,24,31
25336,SpokaneStBridge,11/21/2016 04:00:00 PM,48,-122,13,56,69
25337,SpokaneStBridge,11/21/2016 05:00:00 PM,48,-122,12,107,119
25338,SpokaneStBridge,11/21/2016 06:00:00 PM,48,-122,11,66,77
25339,SpokaneStBridge,11/21/2016 07:00:00 PM,48,-122,10,29,39
25340,SpokaneStBridge,11/21/2016 08:00:00 PM,48,-122,5,8,13
25341,SpokaneStBridge,11/21/2016 09:00:00 PM,48,-122,1,8,9
25342,SpokaneStBridge,11/21/2016 10:00:00 PM,48,-122,3,3,6
25343,SpokaneStBridge,11/21/2016 11:00:00 PM,48,-122,0,2,2
25344,SpokaneStBridge,11/22/2016 12:00:00 AM,48,-122,0,1,1
25345,SpokaneStBridge,11/22/2016 01:00:00 AM,48,-122,3,1,4
25346,SpokaneStBridge,11/22/2016 02:00:00 AM,48,-122,1,3,4
25347,SpokaneStBridge,11/22/2016 03:00:00 AM,48,-122,3,1,4
25348,SpokaneStBridge,11/22/2016 04:00:00 AM,48,-122,3,0,3
25349,SpokaneStBridge,11/22/2016 05:00:00 AM,48,-122,17,1,18
25350,SpokaneStBridge,11/22/2016 06:00:00 AM,48,-122,30,9,39
25351,SpokaneStBridge,11/22/2016 07:00:00 AM,48,-122,79,3,82
25352,SpokaneStBridge,11/22/2016 08:00:00 AM,48,-122,85,10,95
25353,SpokaneStBridge,11/22/2016 09:00:00 AM,48,-122,34,4,38
25354,SpokaneStBridge,11/22/2016 10:00:00 AM,48,-122,15,0,15
25355,SpokaneStBridge,11/22/2016 11:00:00 AM,48,-122,4,3,7
25356,SpokaneStBridge,11/22/2016 12:00:00 PM,48,-122,3,4,7
25357,SpokaneStBridge,11/22/2016 01:00:00 PM,48,-122,9,6,15
25358,SpokaneStBridge,11/22/2016 02:00:00 PM,48,-122,7,10,17
25359,SpokaneStBridge,11/22/2016 03:00:00 PM,48,-122,8,19,27
25360,SpokaneStBridge,11/22/2016 04:00:00 PM,48,-122,9,33,42
25361,SpokaneStBridge,11/22/2016 05:00:00 PM,48,-122,12,72,84
25362,SpokaneStBridge,11/22/2016 06:00:00 PM,48,-122,4,55,59
25363,SpokaneStBridge,11/22/2016 07:00:00 PM,48,-122,3,22,25
25364,SpokaneStBridge,11/22/2016 08:00:00 PM,48,-122,3,11,14
25365,SpokaneStBridge,11/22/2016 09:00:00 PM,48,-122,1,4,5
25366,SpokaneStBridge,11/22/2016 10:00:00 PM,48,-122,1,5,6
25367,SpokaneStBridge,11/22/2016 11:00:00 PM,48,-122,0,1,1
25368,SpokaneStBridge,11/23/2016 12:00:00 AM,48,-122,0,1,1
25369,SpokaneStBridge,11/23/2016 01:00:00 AM,48,-122,1,0,1
25370,SpokaneStBridge,11/23/2016 02:00:00 AM,48,-122,0,2,2
25371,SpokaneStBridge,11/23/2016 03:00:00 AM,48,-122,1,0,1
25372,SpokaneStBridge,11/23/2016 04:00:00 AM,48,-122,2,2,4
25373,SpokaneStBridge,11/23/2016 05:00:00 AM,48,-122,12,1,13
25374,SpokaneStBridge,11/23/2016 06:00:00 AM,48,-122,23,3,26
25375,SpokaneStBridge,11/23/2016 07:00:00 AM,48,-122,63,9,72
25376,SpokaneStBridge,11/23/2016 08:00:00 AM,48,-122,64,4,68
25377,SpokaneStBridge,11/23/2016 09:00:00 AM,48,-122,29,5,34
25378,SpokaneStBridge,11/23/2016 10:00:00 AM,48,-122,9,2,11
25379,SpokaneStBridge,11/23/2016 11:00:00 AM,48,-122,7,4,11
25380,SpokaneStBridge,11/23/2016 12:00:00 PM,48,-122,7,6,13
25381,SpokaneStBridge,11/23/2016 01:00:00 PM,48,-122,10,15,25
25382,SpokaneStBridge,11/23/2016 02:00:00 PM,48,-122,6,18,24
25383,SpokaneStBridge,11/23/2016 03:00:00 PM,48,-122,12,32,44
25384,SpokaneStBridge,11/23/2016 04:00:00 PM,48,-122,7,51,58
25385,SpokaneStBridge,11/23/2016 05:00:00 PM,48,-122,9,47,56
25386,SpokaneStBridge,11/23/2016 06:00:00 PM,48,-122,5,23,28
25387,SpokaneStBridge,11/23/2016 07:00:00 PM,48,-122,3,7,10
25388,SpokaneStBridge,11/23/2016 08:00:00 PM,48,-122,2,5,7
25389,SpokaneStBridge,11/23/2016 09:00:00 PM,48,-122,0,5,5
25390,SpokaneStBridge,11/23/2016 10:00:00 PM,48,-122,0,3,3
25391,SpokaneStBridge,11/23/2016 11:00:00 PM,48,-122,0,0,0
25392,SpokaneStBridge,11/24/2016 12:00:00 AM,48,-122,0,0,0
25393,SpokaneStBridge,11/24/2016 01:00:00 AM,48,-122,2,2,4
25394,SpokaneStBridge,11/24/2016 02:00:00 AM,48,-122,0,0,0
25395,SpokaneStBridge,11/24/2016 03:00:00 AM,48,-122,1,1,2
25396,SpokaneStBridge,11/24/2016 04:00:00 AM,48,-122,0,0,0
25397,SpokaneStBridge,11/24/2016 05:00:00 AM,48,-122,1,2,3
25398,SpokaneStBridge,11/24/2016 06:00:00 AM,48,-122,3,0,3
25399,SpokaneStBridge,11/24/2016 07:00:00 AM,48,-122,1,0,1
25400,SpokaneStBridge,11/24/2016 08:00:00 AM,48,-122,0,0,0
25401,SpokaneStBridge,11/24/2016 09:00:00 AM,48,-122,2,1,3
25402,SpokaneStBridge,11/24/2016 10:00:00 AM,48,-122,3,4,7
25403,SpokaneStBridge,11/24/2016 11:00:00 AM,48,-122,2,0,2
25404,SpokaneStBridge,11/24/2016 12:00:00 PM,48,-122,2,2,4
25405,SpokaneStBridge,11/24/2016 01:00:00 PM,48,-122,4,2,6
25406,SpokaneStBridge,11/24/2016 02:00:00 PM,48,-122,2,0,2
25407,SpokaneStBridge,11/24/2016 03:00:00 PM,48,-122,0,4,4
25408,SpokaneStBridge,11/24/2016 04:00:00 PM,48,-122,1,2,3
25409,SpokaneStBridge,11/24/2016 05:00:00 PM,48,-122,0,0,0
25410,SpokaneStBridge,11/24/2016 06:00:00 PM,48,-122,2,3,5
25411,SpokaneStBridge,11/24/2016 07:00:00 PM,48,-122,0,1,1
25412,SpokaneStBridge,11/24/2016 08:00:00 PM,48,-122,1,0,1
25413,SpokaneStBridge,11/24/2016 09:00:00 PM,48,-122,0,1,1
25414,SpokaneStBridge,11/24/2016 10:00:00 PM,48,-122,0,0,0
25415,SpokaneStBridge,11/24/2016 11:00:00 PM,48,-122,0,2,2
25416,SpokaneStBridge,11/25/2016 12:00:00 AM,48,-122,0,0,0
25417,SpokaneStBridge,11/25/2016 01:00:00 AM,48,-122,1,1,2
25418,SpokaneStBridge,11/25/2016 02:00:00 AM,48,-122,0,1,1
25419,SpokaneStBridge,11/25/2016 03:00:00 AM,48,-122,0,0,0
25420,SpokaneStBridge,11/25/2016 04:00:00 AM,48,-122,0,0,0
25421,SpokaneStBridge,11/25/2016 05:00:00 AM,48,-122,5,0,5
25422,SpokaneStBridge,11/25/2016 06:00:00 AM,48,-122,6,0,6
25423,SpokaneStBridge,11/25/2016 07:00:00 AM,48,-122,15,2,17
25424,SpokaneStBridge,11/25/2016 08:00:00 AM,48,-122,12,0,12
25425,SpokaneStBridge,11/25/2016 09:00:00 AM,48,-122,10,6,16
25426,SpokaneStBridge,11/25/2016 10:00:00 AM,48,-122,12,6,18
25427,SpokaneStBridge,11/25/2016 11:00:00 AM,48,-122,8,16,24
25428,SpokaneStBridge,11/25/2016 12:00:00 PM,48,-122,8,16,24
25429,SpokaneStBridge,11/25/2016 01:00:00 PM,48,-122,26,22,48
25430,SpokaneStBridge,11/25/2016 02:00:00 PM,48,-122,12,19,31
25431,SpokaneStBridge,11/25/2016 03:00:00 PM,48,-122,14,17,31
25432,SpokaneStBridge,11/25/2016 04:00:00 PM,48,-122,10,12,22
25433,SpokaneStBridge,11/25/2016 05:00:00 PM,48,-122,6,12,18
25434,SpokaneStBridge,11/25/2016 06:00:00 PM,48,-122,2,6,8
25435,SpokaneStBridge,11/25/2016 07:00:00 PM,48,-122,1,2,3
25436,SpokaneStBridge,11/25/2016 08:00:00 PM,48,-122,0,6,6
25437,SpokaneStBridge,11/25/2016 09:00:00 PM,48,-122,0,3,3
25438,SpokaneStBridge,11/25/2016 10:00:00 PM,48,-122,2,1,3
25439,SpokaneStBridge,11/25/2016 11:00:00 PM,48,-122,1,2,3
25440,SpokaneStBridge,11/26/2016 12:00:00 AM,48,-122,0,0,0
25441,SpokaneStBridge,11/26/2016 01:00:00 AM,48,-122,1,0,1
25442,SpokaneStBridge,11/26/2016 02:00:00 AM,48,-122,1,0,1
25443,SpokaneStBridge,11/26/2016 03:00:00 AM,48,-122,0,0,0
25444,SpokaneStBridge,11/26/2016 04:00:00 AM,48,-122,2,2,4
25445,SpokaneStBridge,11/26/2016 05:00:00 AM,48,-122,5,1,6
25446,SpokaneStBridge,11/26/2016 06:00:00 AM,48,-122,2,0,2
25447,SpokaneStBridge,11/26/2016 07:00:00 AM,48,-122,3,2,5
25448,SpokaneStBridge,11/26/2016 08:00:00 AM,48,-122,4,0,4
25449,SpokaneStBridge,11/26/2016 09:00:00 AM,48,-122,1,4,5
25450,SpokaneStBridge,11/26/2016 10:00:00 AM,48,-122,1,0,1
25451,SpokaneStBridge,11/26/2016 11:00:00 AM,48,-122,4,1,5
25452,SpokaneStBridge,11/26/2016 12:00:00 PM,48,-122,3,2,5
25453,SpokaneStBridge,11/26/2016 01:00:00 PM,48,-122,7,10,17
25454,SpokaneStBridge,11/26/2016 02:00:00 PM,48,-122,6,0,6
25455,SpokaneStBridge,11/26/2016 03:00:00 PM,48,-122,7,4,11
25456,SpokaneStBridge,11/26/2016 04:00:00 PM,48,-122,6,7,13
25457,SpokaneStBridge,11/26/2016 05:00:00 PM,48,-122,1,4,5
25458,SpokaneStBridge,11/26/2016 06:00:00 PM,48,-122,3,4,7
25459,SpokaneStBridge,11/26/2016 07:00:00 PM,48,-122,1,3,4
25460,SpokaneStBridge,11/26/2016 08:00:00 PM,48,-122,0,2,2
25461,SpokaneStBridge,11/26/2016 09:00:00 PM,48,-122,0,3,3
25462,SpokaneStBridge,11/26/2016 10:00:00 PM,48,-122,0,0,0
25463,SpokaneStBridge,11/26/2016 11:00:00 PM,48,-122,0,1,1
25464,SpokaneStBridge,11/27/2016 12:00:00 AM,48,-122,1,1,2
25465,SpokaneStBridge,11/27/2016 01:00:00 AM,48,-122,1,0,1
25466,SpokaneStBridge,11/27/2016 02:00:00 AM,48,-122,0,1,1
25467,SpokaneStBridge,11/27/2016 03:00:00 AM,48,-122,0,0,0
25468,SpokaneStBridge,11/27/2016 04:00:00 AM,48,-122,1,3,4
25469,SpokaneStBridge,11/27/2016 05:00:00 AM,48,-122,4,0,4
25470,SpokaneStBridge,11/27/2016 06:00:00 AM,48,-122,3,1,4
25471,SpokaneStBridge,11/27/2016 07:00:00 AM,48,-122,3,0,3
25472,SpokaneStBridge,11/27/2016 08:00:00 AM,48,-122,1,3,4
25473,SpokaneStBridge,11/27/2016 09:00:00 AM,48,-122,6,12,18
25474,SpokaneStBridge,11/27/2016 10:00:00 AM,48,-122,8,7,15
25475,SpokaneStBridge,11/27/2016 11:00:00 AM,48,-122,18,5,23
25476,SpokaneStBridge,11/27/2016 12:00:00 PM,48,-122,7,14,21
25477,SpokaneStBridge,11/27/2016 01:00:00 PM,48,-122,7,4,11
25478,SpokaneStBridge,11/27/2016 02:00:00 PM,48,-122,0,7,7
25479,SpokaneStBridge,11/27/2016 03:00:00 PM,48,-122,1,2,3
25480,SpokaneStBridge,11/27/2016 04:00:00 PM,48,-122,3,3,6
25481,SpokaneStBridge,11/27/2016 05:00:00 PM,48,-122,1,2,3
25482,SpokaneStBridge,11/27/2016 06:00:00 PM,48,-122,0,0,0
25483,SpokaneStBridge,11/27/2016 07:00:00 PM,48,-122,2,1,3
25484,SpokaneStBridge,11/27/2016 08:00:00 PM,48,-122,0,1,1
25485,SpokaneStBridge,11/27/2016 09:00:00 PM,48,-122,0,0,0
25486,SpokaneStBridge,11/27/2016 10:00:00 PM,48,-122,1,1,2
25487,SpokaneStBridge,11/27/2016 11:00:00 PM,48,-122,0,0,0
25488,SpokaneStBridge,11/28/2016 12:00:00 AM,48,-122,0,0,0
25489,SpokaneStBridge,11/28/2016 01:00:00 AM,48,-122,0,0,0
25490,SpokaneStBridge,11/28/2016 02:00:00 AM,48,-122,0,0,0
25491,SpokaneStBridge,11/28/2016 03:00:00 AM,48,-122,0,1,1
25492,SpokaneStBridge,11/28/2016 04:00:00 AM,48,-122,3,0,3
25493,SpokaneStBridge,11/28/2016 05:00:00 AM,48,-122,16,1,17
25494,SpokaneStBridge,11/28/2016 06:00:00 AM,48,-122,51,4,55
25495,SpokaneStBridge,11/28/2016 07:00:00 AM,48,-122,99,7,106
25496,SpokaneStBridge,11/28/2016 08:00:00 AM,48,-122,116,5,121
25497,SpokaneStBridge,11/28/2016 09:00:00 AM,48,-122,41,2,43
25498,SpokaneStBridge,11/28/2016 10:00:00 AM,48,-122,12,6,18
25499,SpokaneStBridge,11/28/2016 11:00:00 AM,48,-122,8,6,14
25500,SpokaneStBridge,11/28/2016 12:00:00 PM,48,-122,7,8,15
25501,SpokaneStBridge,11/28/2016 01:00:00 PM,48,-122,6,7,13
25502,SpokaneStBridge,11/28/2016 02:00:00 PM,48,-122,10,8,18
25503,SpokaneStBridge,11/28/2016 03:00:00 PM,48,-122,12,30,42
25504,SpokaneStBridge,11/28/2016 04:00:00 PM,48,-122,10,59,69
25505,SpokaneStBridge,11/28/2016 05:00:00 PM,48,-122,13,112,125
25506,SpokaneStBridge,11/28/2016 06:00:00 PM,48,-122,9,65,74
25507,SpokaneStBridge,11/28/2016 07:00:00 PM,48,-122,2,22,24
25508,SpokaneStBridge,11/28/2016 08:00:00 PM,48,-122,5,14,19
25509,SpokaneStBridge,11/28/2016 09:00:00 PM,48,-122,0,6,6
25510,SpokaneStBridge,11/28/2016 10:00:00 PM,48,-122,1,8,9
25511,SpokaneStBridge,11/28/2016 11:00:00 PM,48,-122,1,2,3
25512,SpokaneStBridge,11/29/2016 12:00:00 AM,48,-122,0,1,1
25513,SpokaneStBridge,11/29/2016 01:00:00 AM,48,-122,0,0,0
25514,SpokaneStBridge,11/29/2016 02:00:00 AM,48,-122,0,0,0
25515,SpokaneStBridge,11/29/2016 03:00:00 AM,48,-122,2,1,3
25516,SpokaneStBridge,11/29/2016 04:00:00 AM,48,-122,2,3,5
25517,SpokaneStBridge,11/29/2016 05:00:00 AM,48,-122,26,1,27
25518,SpokaneStBridge,11/29/2016 06:00:00 AM,48,-122,48,8,56
25519,SpokaneStBridge,11/29/2016 07:00:00 AM,48,-122,100,14,114
25520,SpokaneStBridge,11/29/2016 08:00:00 AM,48,-122,111,8,119
25521,SpokaneStBridge,11/29/2016 09:00:00 AM,48,-122,61,3,64
25522,SpokaneStBridge,11/29/2016 10:00:00 AM,48,-122,9,13,22
25523,SpokaneStBridge,11/29/2016 11:00:00 AM,48,-122,7,4,11
25524,SpokaneStBridge,11/29/2016 12:00:00 PM,48,-122,21,6,27
25525,SpokaneStBridge,11/29/2016 01:00:00 PM,48,-122,9,5,14
25526,SpokaneStBridge,11/29/2016 02:00:00 PM,48,-122,5,14,19
25527,SpokaneStBridge,11/29/2016 03:00:00 PM,48,-122,8,31,39
25528,SpokaneStBridge,11/29/2016 04:00:00 PM,48,-122,12,41,53
25529,SpokaneStBridge,11/29/2016 05:00:00 PM,48,-122,14,105,119
25530,SpokaneStBridge,11/29/2016 06:00:00 PM,48,-122,12,97,109
25531,SpokaneStBridge,11/29/2016 07:00:00 PM,48,-122,10,25,35
25532,SpokaneStBridge,11/29/2016 08:00:00 PM,48,-122,2,10,12
25533,SpokaneStBridge,11/29/2016 09:00:00 PM,48,-122,5,5,10
25534,SpokaneStBridge,11/29/2016 10:00:00 PM,48,-122,1,6,7
25535,SpokaneStBridge,11/29/2016 11:00:00 PM,48,-122,1,5,6
25536,SpokaneStBridge,11/30/2016 12:00:00 AM,48,-122,0,0,0
25537,SpokaneStBridge,11/30/2016 01:00:00 AM,48,-122,1,1,2
25538,SpokaneStBridge,11/30/2016 02:00:00 AM,48,-122,2,0,2
25539,SpokaneStBridge,11/30/2016 03:00:00 AM,48,-122,1,2,3
25540,SpokaneStBridge,11/30/2016 04:00:00 AM,48,-122,1,0,1
25541,SpokaneStBridge,11/30/2016 05:00:00 AM,48,-122,14,0,14
25542,SpokaneStBridge,11/30/2016 06:00:00 AM,48,-122,46,4,50
25543,SpokaneStBridge,11/30/2016 07:00:00 AM,48,-122,75,11,86
25544,SpokaneStBridge,11/30/2016 08:00:00 AM,48,-122,92,3,95
25545,SpokaneStBridge,11/30/2016 09:00:00 AM,48,-122,36,5,41
25546,SpokaneStBridge,11/30/2016 10:00:00 AM,48,-122,11,0,11
25547,SpokaneStBridge,11/30/2016 11:00:00 AM,48,-122,4,4,8
25548,SpokaneStBridge,11/30/2016 12:00:00 PM,48,-122,5,7,12
25549,SpokaneStBridge,11/30/2016 01:00:00 PM,48,-122,5,5,10
25550,SpokaneStBridge,11/30/2016 02:00:00 PM,48,-122,7,9,16
25551,SpokaneStBridge,11/30/2016 03:00:00 PM,48,-122,3,23,26
25552,SpokaneStBridge,11/30/2016 04:00:00 PM,48,-122,8,49,57
25553,SpokaneStBridge,11/30/2016 05:00:00 PM,48,-122,9,83,92
25554,SpokaneStBridge,11/30/2016 06:00:00 PM,48,-122,8,60,68
25555,SpokaneStBridge,11/30/2016 07:00:00 PM,48,-122,10,23,33
25556,SpokaneStBridge,11/30/2016 08:00:00 PM,48,-122,1,6,7
25557,SpokaneStBridge,11/30/2016 09:00:00 PM,48,-122,0,10,10
25558,SpokaneStBridge,11/30/2016 10:00:00 PM,48,-122,0,3,3
25559,SpokaneStBridge,11/30/2016 11:00:00 PM,48,-122,1,1,2
25560,SpokaneStBridge,12/01/2016 12:00:00 AM,48,-122,0,0,0
25561,SpokaneStBridge,12/01/2016 01:00:00 AM,48,-122,0,0,0
25562,SpokaneStBridge,12/01/2016 02:00:00 AM,48,-122,0,0,0
25563,SpokaneStBridge,12/01/2016 03:00:00 AM,48,-122,3,0,3
25564,SpokaneStBridge,12/01/2016 04:00:00 AM,48,-122,5,1,6
25565,SpokaneStBridge,12/01/2016 05:00:00 AM,48,-122,17,0,17
25566,SpokaneStBridge,12/01/2016 06:00:00 AM,48,-122,50,6,56
25567,SpokaneStBridge,12/01/2016 07:00:00 AM,48,-122,82,11,93
25568,SpokaneStBridge,12/01/2016 08:00:00 AM,48,-122,116,7,123
25569,SpokaneStBridge,12/01/2016 09:00:00 AM,48,-122,52,5,57
25570,SpokaneStBridge,12/01/2016 10:00:00 AM,48,-122,13,7,20
25571,SpokaneStBridge,12/01/2016 11:00:00 AM,48,-122,11,3,14
25572,SpokaneStBridge,12/01/2016 12:00:00 PM,48,-122,6,8,14
25573,SpokaneStBridge,12/01/2016 01:00:00 PM,48,-122,7,13,20
25574,SpokaneStBridge,12/01/2016 02:00:00 PM,48,-122,10,9,19
25575,SpokaneStBridge,12/01/2016 03:00:00 PM,48,-122,9,18,27
25576,SpokaneStBridge,12/01/2016 04:00:00 PM,48,-122,10,58,68
25577,SpokaneStBridge,12/01/2016 05:00:00 PM,48,-122,8,102,110
25578,SpokaneStBridge,12/01/2016 06:00:00 PM,48,-122,11,63,74
25579,SpokaneStBridge,12/01/2016 07:00:00 PM,48,-122,13,33,46
25580,SpokaneStBridge,12/01/2016 08:00:00 PM,48,-122,2,13,15
25581,SpokaneStBridge,12/01/2016 09:00:00 PM,48,-122,1,9,10
25582,SpokaneStBridge,12/01/2016 10:00:00 PM,48,-122,1,3,4
25583,SpokaneStBridge,12/01/2016 11:00:00 PM,48,-122,4,1,5
25584,SpokaneStBridge,12/02/2016 12:00:00 AM,48,-122,1,0,1
25585,SpokaneStBridge,12/02/2016 01:00:00 AM,48,-122,0,0,0
25586,SpokaneStBridge,12/02/2016 02:00:00 AM,48,-122,0,1,1
25587,SpokaneStBridge,12/02/2016 03:00:00 AM,48,-122,1,0,1
25588,SpokaneStBridge,12/02/2016 04:00:00 AM,48,-122,1,0,1
25589,SpokaneStBridge,12/02/2016 05:00:00 AM,48,-122,7,0,7
25590,SpokaneStBridge,12/02/2016 06:00:00 AM,48,-122,36,3,39
25591,SpokaneStBridge,12/02/2016 07:00:00 AM,48,-122,52,4,56
25592,SpokaneStBridge,12/02/2016 08:00:00 AM,48,-122,65,3,68
25593,SpokaneStBridge,12/02/2016 09:00:00 AM,48,-122,28,1,29
25594,SpokaneStBridge,12/02/2016 10:00:00 AM,48,-122,7,1,8
25595,SpokaneStBridge,12/02/2016 11:00:00 AM,48,-122,4,3,7
25596,SpokaneStBridge,12/02/2016 12:00:00 PM,48,-122,7,3,10
25597,SpokaneStBridge,12/02/2016 01:00:00 PM,48,-122,3,2,5
25598,SpokaneStBridge,12/02/2016 02:00:00 PM,48,-122,5,9,14
25599,SpokaneStBridge,12/02/2016 03:00:00 PM,48,-122,2,15,17
25600,SpokaneStBridge,12/02/2016 04:00:00 PM,48,-122,4,34,38
25601,SpokaneStBridge,12/02/2016 05:00:00 PM,48,-122,2,64,66
25602,SpokaneStBridge,12/02/2016 06:00:00 PM,48,-122,4,29,33
25603,SpokaneStBridge,12/02/2016 07:00:00 PM,48,-122,0,6,6
25604,SpokaneStBridge,12/02/2016 08:00:00 PM,48,-122,1,4,5
25605,SpokaneStBridge,12/02/2016 09:00:00 PM,48,-122,1,5,6
25606,SpokaneStBridge,12/02/2016 10:00:00 PM,48,-122,1,2,3
25607,SpokaneStBridge,12/02/2016 11:00:00 PM,48,-122,0,2,2
25608,SpokaneStBridge,12/03/2016 12:00:00 AM,48,-122,0,1,1
25609,SpokaneStBridge,12/03/2016 01:00:00 AM,48,-122,1,0,1
25610,SpokaneStBridge,12/03/2016 02:00:00 AM,48,-122,0,0,0
25611,SpokaneStBridge,12/03/2016 03:00:00 AM,48,-122,1,0,1
25612,SpokaneStBridge,12/03/2016 04:00:00 AM,48,-122,2,2,4
25613,SpokaneStBridge,12/03/2016 05:00:00 AM,48,-122,3,0,3
25614,SpokaneStBridge,12/03/2016 06:00:00 AM,48,-122,9,0,9
25615,SpokaneStBridge,12/03/2016 07:00:00 AM,48,-122,2,2,4
25616,SpokaneStBridge,12/03/2016 08:00:00 AM,48,-122,9,5,14
25617,SpokaneStBridge,12/03/2016 09:00:00 AM,48,-122,3,2,5
25618,SpokaneStBridge,12/03/2016 10:00:00 AM,48,-122,8,13,21
25619,SpokaneStBridge,12/03/2016 11:00:00 AM,48,-122,13,6,19
25620,SpokaneStBridge,12/03/2016 12:00:00 PM,48,-122,9,5,14
25621,SpokaneStBridge,12/03/2016 01:00:00 PM,48,-122,11,14,25
25622,SpokaneStBridge,12/03/2016 02:00:00 PM,48,-122,9,7,16
25623,SpokaneStBridge,12/03/2016 03:00:00 PM,48,-122,9,8,17
25624,SpokaneStBridge,12/03/2016 04:00:00 PM,48,-122,2,11,13
25625,SpokaneStBridge,12/03/2016 05:00:00 PM,48,-122,4,8,12
25626,SpokaneStBridge,12/03/2016 06:00:00 PM,48,-122,1,4,5
25627,SpokaneStBridge,12/03/2016 07:00:00 PM,48,-122,0,7,7
25628,SpokaneStBridge,12/03/2016 08:00:00 PM,48,-122,3,0,3
25629,SpokaneStBridge,12/03/2016 09:00:00 PM,48,-122,0,2,2
25630,SpokaneStBridge,12/03/2016 10:00:00 PM,48,-122,0,0,0
25631,SpokaneStBridge,12/03/2016 11:00:00 PM,48,-122,0,1,1
25632,SpokaneStBridge,12/04/2016 12:00:00 AM,48,-122,1,0,1
25633,SpokaneStBridge,12/04/2016 01:00:00 AM,48,-122,0,0,0
25634,SpokaneStBridge,12/04/2016 02:00:00 AM,48,-122,0,0,0
25635,SpokaneStBridge,12/04/2016 03:00:00 AM,48,-122,0,0,0
25636,SpokaneStBridge,12/04/2016 04:00:00 AM,48,-122,0,3,3
25637,SpokaneStBridge,12/04/2016 05:00:00 AM,48,-122,3,0,3
25638,SpokaneStBridge,12/04/2016 06:00:00 AM,48,-122,1,0,1
25639,SpokaneStBridge,12/04/2016 07:00:00 AM,48,-122,1,2,3
25640,SpokaneStBridge,12/04/2016 08:00:00 AM,48,-122,5,6,11
25641,SpokaneStBridge,12/04/2016 09:00:00 AM,48,-122,1,1,2
25642,SpokaneStBridge,12/04/2016 10:00:00 AM,48,-122,9,3,12
25643,SpokaneStBridge,12/04/2016 11:00:00 AM,48,-122,9,11,20
25644,SpokaneStBridge,12/04/2016 12:00:00 PM,48,-122,23,14,37
25645,SpokaneStBridge,12/04/2016 01:00:00 PM,48,-122,24,22,46
25646,SpokaneStBridge,12/04/2016 02:00:00 PM,48,-122,20,19,39
25647,SpokaneStBridge,12/04/2016 03:00:00 PM,48,-122,14,12,26
25648,SpokaneStBridge,12/04/2016 04:00:00 PM,48,-122,13,13,26
25649,SpokaneStBridge,12/04/2016 05:00:00 PM,48,-122,8,5,13
25650,SpokaneStBridge,12/04/2016 06:00:00 PM,48,-122,2,1,3
25651,SpokaneStBridge,12/04/2016 07:00:00 PM,48,-122,0,0,0
25652,SpokaneStBridge,12/04/2016 08:00:00 PM,48,-122,1,1,2
25653,SpokaneStBridge,12/04/2016 09:00:00 PM,48,-122,1,4,5
25654,SpokaneStBridge,12/04/2016 10:00:00 PM,48,-122,1,0,1
25655,SpokaneStBridge,12/04/2016 11:00:00 PM,48,-122,1,0,1
25656,SpokaneStBridge,12/05/2016 12:00:00 AM,48,-122,1,2,3
25657,SpokaneStBridge,12/05/2016 01:00:00 AM,48,-122,0,1,1
25658,SpokaneStBridge,12/05/2016 02:00:00 AM,48,-122,0,0,0
25659,SpokaneStBridge,12/05/2016 03:00:00 AM,48,-122,3,1,4
25660,SpokaneStBridge,12/05/2016 04:00:00 AM,48,-122,0,0,0
25661,SpokaneStBridge,12/05/2016 05:00:00 AM,48,-122,12,0,12
25662,SpokaneStBridge,12/05/2016 06:00:00 AM,48,-122,26,4,30
25663,SpokaneStBridge,12/05/2016 07:00:00 AM,48,-122,49,5,54
25664,SpokaneStBridge,12/05/2016 08:00:00 AM,48,-122,53,6,59
25665,SpokaneStBridge,12/05/2016 09:00:00 AM,48,-122,23,5,28
25666,SpokaneStBridge,12/05/2016 10:00:00 AM,48,-122,5,0,5
25667,SpokaneStBridge,12/05/2016 11:00:00 AM,48,-122,4,1,5
25668,SpokaneStBridge,12/05/2016 12:00:00 PM,48,-122,2,0,2
25669,SpokaneStBridge,12/05/2016 01:00:00 PM,48,-122,6,4,10
25670,SpokaneStBridge,12/05/2016 02:00:00 PM,48,-122,5,8,13
25671,SpokaneStBridge,12/05/2016 03:00:00 PM,48,-122,0,14,14
25672,SpokaneStBridge,12/05/2016 04:00:00 PM,48,-122,15,31,46
25673,SpokaneStBridge,12/05/2016 05:00:00 PM,48,-122,5,63,68
25674,SpokaneStBridge,12/05/2016 06:00:00 PM,48,-122,3,28,31
25675,SpokaneStBridge,12/05/2016 07:00:00 PM,48,-122,3,15,18
25676,SpokaneStBridge,12/05/2016 08:00:00 PM,48,-122,2,6,8
25677,SpokaneStBridge,12/05/2016 09:00:00 PM,48,-122,1,2,3
25678,SpokaneStBridge,12/05/2016 10:00:00 PM,48,-122,0,3,3
25679,SpokaneStBridge,12/05/2016 11:00:00 PM,48,-122,0,0,0
25680,SpokaneStBridge,12/06/2016 12:00:00 AM,48,-122,0,0,0
25681,SpokaneStBridge,12/06/2016 01:00:00 AM,48,-122,0,1,1
25682,SpokaneStBridge,12/06/2016 02:00:00 AM,48,-122,0,0,0
25683,SpokaneStBridge,12/06/2016 03:00:00 AM,48,-122,1,1,2
25684,SpokaneStBridge,12/06/2016 04:00:00 AM,48,-122,2,0,2
25685,SpokaneStBridge,12/06/2016 05:00:00 AM,48,-122,12,0,12
25686,SpokaneStBridge,12/06/2016 06:00:00 AM,48,-122,15,3,18
25687,SpokaneStBridge,12/06/2016 07:00:00 AM,48,-122,50,5,55
25688,SpokaneStBridge,12/06/2016 08:00:00 AM,48,-122,90,2,92
25689,SpokaneStBridge,12/06/2016 09:00:00 AM,48,-122,30,4,34
25690,SpokaneStBridge,12/06/2016 10:00:00 AM,48,-122,7,2,9
25691,SpokaneStBridge,12/06/2016 11:00:00 AM,48,-122,11,2,13
25692,SpokaneStBridge,12/06/2016 12:00:00 PM,48,-122,1,5,6
25693,SpokaneStBridge,12/06/2016 01:00:00 PM,48,-122,11,5,16
25694,SpokaneStBridge,12/06/2016 02:00:00 PM,48,-122,4,7,11
25695,SpokaneStBridge,12/06/2016 03:00:00 PM,48,-122,9,19,28
25696,SpokaneStBridge,12/06/2016 04:00:00 PM,48,-122,13,33,46
25697,SpokaneStBridge,12/06/2016 05:00:00 PM,48,-122,3,65,68
25698,SpokaneStBridge,12/06/2016 06:00:00 PM,48,-122,6,42,48
25699,SpokaneStBridge,12/06/2016 07:00:00 PM,48,-122,5,15,20
25700,SpokaneStBridge,12/06/2016 08:00:00 PM,48,-122,0,9,9
25701,SpokaneStBridge,12/06/2016 09:00:00 PM,48,-122,1,8,9
25702,SpokaneStBridge,12/06/2016 10:00:00 PM,48,-122,0,2,2
25703,SpokaneStBridge,12/06/2016 11:00:00 PM,48,-122,0,2,2
25704,SpokaneStBridge,12/07/2016 12:00:00 AM,48,-122,0,1,1
25705,SpokaneStBridge,12/07/2016 01:00:00 AM,48,-122,0,0,0
25706,SpokaneStBridge,12/07/2016 02:00:00 AM,48,-122,3,2,5
25707,SpokaneStBridge,12/07/2016 03:00:00 AM,48,-122,1,1,2
25708,SpokaneStBridge,12/07/2016 04:00:00 AM,48,-122,2,0,2
25709,SpokaneStBridge,12/07/2016 05:00:00 AM,48,-122,10,3,13
25710,SpokaneStBridge,12/07/2016 06:00:00 AM,48,-122,24,2,26
25711,SpokaneStBridge,12/07/2016 07:00:00 AM,48,-122,52,10,62
25712,SpokaneStBridge,12/07/2016 08:00:00 AM,48,-122,68,7,75
25713,SpokaneStBridge,12/07/2016 09:00:00 AM,48,-122,23,5,28
25714,SpokaneStBridge,12/07/2016 10:00:00 AM,48,-122,9,2,11
25715,SpokaneStBridge,12/07/2016 11:00:00 AM,48,-122,10,5,15
25716,SpokaneStBridge,12/07/2016 12:00:00 PM,48,-122,9,5,14
25717,SpokaneStBridge,12/07/2016 01:00:00 PM,48,-122,9,3,12
25718,SpokaneStBridge,12/07/2016 02:00:00 PM,48,-122,8,5,13
25719,SpokaneStBridge,12/07/2016 03:00:00 PM,48,-122,7,16,23
25720,SpokaneStBridge,12/07/2016 04:00:00 PM,48,-122,9,34,43
25721,SpokaneStBridge,12/07/2016 05:00:00 PM,48,-122,14,53,67
25722,SpokaneStBridge,12/07/2016 06:00:00 PM,48,-122,4,36,40
25723,SpokaneStBridge,12/07/2016 07:00:00 PM,48,-122,4,24,28
25724,SpokaneStBridge,12/07/2016 08:00:00 PM,48,-122,2,6,8
25725,SpokaneStBridge,12/07/2016 09:00:00 PM,48,-122,2,8,10
25726,SpokaneStBridge,12/07/2016 10:00:00 PM,48,-122,1,4,5
25727,SpokaneStBridge,12/07/2016 11:00:00 PM,48,-122,1,0,1
25728,SpokaneStBridge,12/08/2016 12:00:00 AM,48,-122,0,1,1
25729,SpokaneStBridge,12/08/2016 01:00:00 AM,48,-122,0,0,0
25730,SpokaneStBridge,12/08/2016 02:00:00 AM,48,-122,0,1,1
25731,SpokaneStBridge,12/08/2016 03:00:00 AM,48,-122,1,1,2
25732,SpokaneStBridge,12/08/2016 04:00:00 AM,48,-122,2,0,2
25733,SpokaneStBridge,12/08/2016 05:00:00 AM,48,-122,9,1,10
25734,SpokaneStBridge,12/08/2016 06:00:00 AM,48,-122,23,4,27
25735,SpokaneStBridge,12/08/2016 07:00:00 AM,48,-122,42,3,45
25736,SpokaneStBridge,12/08/2016 08:00:00 AM,48,-122,57,6,63
25737,SpokaneStBridge,12/08/2016 09:00:00 AM,48,-122,24,3,27
25738,SpokaneStBridge,12/08/2016 10:00:00 AM,48,-122,9,0,9
25739,SpokaneStBridge,12/08/2016 11:00:00 AM,48,-122,5,3,8
25740,SpokaneStBridge,12/08/2016 12:00:00 PM,48,-122,3,5,8
25741,SpokaneStBridge,12/08/2016 01:00:00 PM,48,-122,4,4,8
25742,SpokaneStBridge,12/08/2016 02:00:00 PM,48,-122,4,13,17
25743,SpokaneStBridge,12/08/2016 03:00:00 PM,48,-122,9,11,20
25744,SpokaneStBridge,12/08/2016 04:00:00 PM,48,-122,6,34,40
25745,SpokaneStBridge,12/08/2016 05:00:00 PM,48,-122,6,56,62
25746,SpokaneStBridge,12/08/2016 06:00:00 PM,48,-122,3,33,36
25747,SpokaneStBridge,12/08/2016 07:00:00 PM,48,-122,2,11,13
25748,SpokaneStBridge,12/08/2016 08:00:00 PM,48,-122,1,4,5
25749,SpokaneStBridge,12/08/2016 09:00:00 PM,48,-122,0,5,5
25750,SpokaneStBridge,12/08/2016 10:00:00 PM,48,-122,1,1,2
25751,SpokaneStBridge,12/08/2016 11:00:00 PM,48,-122,0,1,1
25752,SpokaneStBridge,12/09/2016 12:00:00 AM,48,-122,0,0,0
25753,SpokaneStBridge,12/09/2016 01:00:00 AM,48,-122,1,2,3
25754,SpokaneStBridge,12/09/2016 02:00:00 AM,48,-122,0,0,0
25755,SpokaneStBridge,12/09/2016 03:00:00 AM,48,-122,0,0,0
25756,SpokaneStBridge,12/09/2016 04:00:00 AM,48,-122,0,0,0
25757,SpokaneStBridge,12/09/2016 05:00:00 AM,48,-122,6,0,6
25758,SpokaneStBridge,12/09/2016 06:00:00 AM,48,-122,6,1,7
25759,SpokaneStBridge,12/09/2016 07:00:00 AM,48,-122,9,0,9
25760,SpokaneStBridge,12/09/2016 08:00:00 AM,48,-122,17,0,17
25761,SpokaneStBridge,12/09/2016 09:00:00 AM,48,-122,14,2,16
25762,SpokaneStBridge,12/09/2016 10:00:00 AM,48,-122,7,0,7
25763,SpokaneStBridge,12/09/2016 11:00:00 AM,48,-122,1,1,2
25764,SpokaneStBridge,12/09/2016 12:00:00 PM,48,-122,1,0,1
25765,SpokaneStBridge,12/09/2016 01:00:00 PM,48,-122,0,1,1
25766,SpokaneStBridge,12/09/2016 02:00:00 PM,48,-122,1,1,2
25767,SpokaneStBridge,12/09/2016 03:00:00 PM,48,-122,2,8,10
25768,SpokaneStBridge,12/09/2016 04:00:00 PM,48,-122,3,14,17
25769,SpokaneStBridge,12/09/2016 05:00:00 PM,48,-122,2,14,16
25770,SpokaneStBridge,12/09/2016 06:00:00 PM,48,-122,2,17,19
25771,SpokaneStBridge,12/09/2016 07:00:00 PM,48,-122,1,4,5
25772,SpokaneStBridge,12/09/2016 08:00:00 PM,48,-122,0,0,0
25773,SpokaneStBridge,12/09/2016 09:00:00 PM,48,-122,0,2,2
25774,SpokaneStBridge,12/09/2016 10:00:00 PM,48,-122,1,1,2
25775,SpokaneStBridge,12/09/2016 11:00:00 PM,48,-122,0,0,0
25776,SpokaneStBridge,12/10/2016 12:00:00 AM,48,-122,0,0,0
25777,SpokaneStBridge,12/10/2016 01:00:00 AM,48,-122,0,0,0
25778,SpokaneStBridge,12/10/2016 02:00:00 AM,48,-122,0,0,0
25779,SpokaneStBridge,12/10/2016 03:00:00 AM,48,-122,0,0,0
25780,SpokaneStBridge,12/10/2016 04:00:00 AM,48,-122,1,0,1
25781,SpokaneStBridge,12/10/2016 05:00:00 AM,48,-122,1,0,1
25782,SpokaneStBridge,12/10/2016 06:00:00 AM,48,-122,2,0,2
25783,SpokaneStBridge,12/10/2016 07:00:00 AM,48,-122,2,1,3
25784,SpokaneStBridge,12/10/2016 08:00:00 AM,48,-122,5,4,9
25785,SpokaneStBridge,12/10/2016 09:00:00 AM,48,-122,6,4,10
25786,SpokaneStBridge,12/10/2016 10:00:00 AM,48,-122,8,4,12
25787,SpokaneStBridge,12/10/2016 11:00:00 AM,48,-122,2,3,5
25788,SpokaneStBridge,12/10/2016 12:00:00 PM,48,-122,4,5,9
25789,SpokaneStBridge,12/10/2016 01:00:00 PM,48,-122,4,3,7
25790,SpokaneStBridge,12/10/2016 02:00:00 PM,48,-122,2,3,5
25791,SpokaneStBridge,12/10/2016 03:00:00 PM,48,-122,2,4,6
25792,SpokaneStBridge,12/10/2016 04:00:00 PM,48,-122,4,7,11
25793,SpokaneStBridge,12/10/2016 05:00:00 PM,48,-122,1,2,3
25794,SpokaneStBridge,12/10/2016 06:00:00 PM,48,-122,4,3,7
25795,SpokaneStBridge,12/10/2016 07:00:00 PM,48,-122,1,2,3
25796,SpokaneStBridge,12/10/2016 08:00:00 PM,48,-122,0,0,0
25797,SpokaneStBridge,12/10/2016 09:00:00 PM,48,-122,1,1,2
25798,SpokaneStBridge,12/10/2016 10:00:00 PM,48,-122,0,3,3
25799,SpokaneStBridge,12/10/2016 11:00:00 PM,48,-122,1,0,1
25800,SpokaneStBridge,12/11/2016 12:00:00 AM,48,-122,2,1,3
25801,SpokaneStBridge,12/11/2016 01:00:00 AM,48,-122,1,0,1
25802,SpokaneStBridge,12/11/2016 02:00:00 AM,48,-122,0,0,0
25803,SpokaneStBridge,12/11/2016 03:00:00 AM,48,-122,0,0,0
25804,SpokaneStBridge,12/11/2016 04:00:00 AM,48,-122,0,1,1
25805,SpokaneStBridge,12/11/2016 05:00:00 AM,48,-122,3,0,3
25806,SpokaneStBridge,12/11/2016 06:00:00 AM,48,-122,1,0,1
25807,SpokaneStBridge,12/11/2016 07:00:00 AM,48,-122,0,1,1
25808,SpokaneStBridge,12/11/2016 08:00:00 AM,48,-122,2,0,2
25809,SpokaneStBridge,12/11/2016 09:00:00 AM,48,-122,1,4,5
25810,SpokaneStBridge,12/11/2016 10:00:00 AM,48,-122,9,9,18
25811,SpokaneStBridge,12/11/2016 11:00:00 AM,48,-122,2,6,8
25812,SpokaneStBridge,12/11/2016 12:00:00 PM,48,-122,12,5,17
25813,SpokaneStBridge,12/11/2016 01:00:00 PM,48,-122,5,2,7
25814,SpokaneStBridge,12/11/2016 02:00:00 PM,48,-122,6,3,9
25815,SpokaneStBridge,12/11/2016 03:00:00 PM,48,-122,3,3,6
25816,SpokaneStBridge,12/11/2016 04:00:00 PM,48,-122,2,4,6
25817,SpokaneStBridge,12/11/2016 05:00:00 PM,48,-122,2,3,5
25818,SpokaneStBridge,12/11/2016 06:00:00 PM,48,-122,1,1,2
25819,SpokaneStBridge,12/11/2016 07:00:00 PM,48,-122,0,1,1
25820,SpokaneStBridge,12/11/2016 08:00:00 PM,48,-122,4,1,5
25821,SpokaneStBridge,12/11/2016 09:00:00 PM,48,-122,2,3,5
25822,SpokaneStBridge,12/11/2016 10:00:00 PM,48,-122,0,0,0
25823,SpokaneStBridge,12/11/2016 11:00:00 PM,48,-122,0,1,1
25824,SpokaneStBridge,12/12/2016 12:00:00 AM,48,-122,0,0,0
25825,SpokaneStBridge,12/12/2016 01:00:00 AM,48,-122,0,0,0
25826,SpokaneStBridge,12/12/2016 02:00:00 AM,48,-122,1,0,1
25827,SpokaneStBridge,12/12/2016 03:00:00 AM,48,-122,1,1,2
25828,SpokaneStBridge,12/12/2016 04:00:00 AM,48,-122,5,0,5
25829,SpokaneStBridge,12/12/2016 05:00:00 AM,48,-122,13,1,14
25830,SpokaneStBridge,12/12/2016 06:00:00 AM,48,-122,32,0,32
25831,SpokaneStBridge,12/12/2016 07:00:00 AM,48,-122,57,5,62
25832,SpokaneStBridge,12/12/2016 08:00:00 AM,48,-122,85,7,92
25833,SpokaneStBridge,12/12/2016 09:00:00 AM,48,-122,30,6,36
25834,SpokaneStBridge,12/12/2016 10:00:00 AM,48,-122,13,3,16
25835,SpokaneStBridge,12/12/2016 11:00:00 AM,48,-122,7,3,10
25836,SpokaneStBridge,12/12/2016 12:00:00 PM,48,-122,3,2,5
25837,SpokaneStBridge,12/12/2016 01:00:00 PM,48,-122,3,5,8
25838,SpokaneStBridge,12/12/2016 02:00:00 PM,48,-122,8,6,14
25839,SpokaneStBridge,12/12/2016 03:00:00 PM,48,-122,2,16,18
25840,SpokaneStBridge,12/12/2016 04:00:00 PM,48,-122,7,42,49
25841,SpokaneStBridge,12/12/2016 05:00:00 PM,48,-122,7,83,90
25842,SpokaneStBridge,12/12/2016 06:00:00 PM,48,-122,4,45,49
25843,SpokaneStBridge,12/12/2016 07:00:00 PM,48,-122,2,18,20
25844,SpokaneStBridge,12/12/2016 08:00:00 PM,48,-122,2,6,8
25845,SpokaneStBridge,12/12/2016 09:00:00 PM,48,-122,0,11,11
25846,SpokaneStBridge,12/12/2016 10:00:00 PM,48,-122,0,2,2
25847,SpokaneStBridge,12/12/2016 11:00:00 PM,48,-122,2,4,6
25848,SpokaneStBridge,12/13/2016 12:00:00 AM,48,-122,1,1,2
25849,SpokaneStBridge,12/13/2016 01:00:00 AM,48,-122,0,0,0
25850,SpokaneStBridge,12/13/2016 02:00:00 AM,48,-122,0,1,1
25851,SpokaneStBridge,12/13/2016 03:00:00 AM,48,-122,2,1,3
25852,SpokaneStBridge,12/13/2016 04:00:00 AM,48,-122,1,0,1
25853,SpokaneStBridge,12/13/2016 05:00:00 AM,48,-122,15,1,16
25854,SpokaneStBridge,12/13/2016 06:00:00 AM,48,-122,37,2,39
25855,SpokaneStBridge,12/13/2016 07:00:00 AM,48,-122,61,7,68
25856,SpokaneStBridge,12/13/2016 08:00:00 AM,48,-122,95,9,104
25857,SpokaneStBridge,12/13/2016 09:00:00 AM,48,-122,35,6,41
25858,SpokaneStBridge,12/13/2016 10:00:00 AM,48,-122,20,6,26
25859,SpokaneStBridge,12/13/2016 11:00:00 AM,48,-122,7,5,12
25860,SpokaneStBridge,12/13/2016 12:00:00 PM,48,-122,5,1,6
25861,SpokaneStBridge,12/13/2016 01:00:00 PM,48,-122,5,3,8
25862,SpokaneStBridge,12/13/2016 02:00:00 PM,48,-122,5,10,15
25863,SpokaneStBridge,12/13/2016 03:00:00 PM,48,-122,10,16,26
25864,SpokaneStBridge,12/13/2016 04:00:00 PM,48,-122,9,43,52
25865,SpokaneStBridge,12/13/2016 05:00:00 PM,48,-122,10,87,97
25866,SpokaneStBridge,12/13/2016 06:00:00 PM,48,-122,7,47,54
25867,SpokaneStBridge,12/13/2016 07:00:00 PM,48,-122,4,22,26
25868,SpokaneStBridge,12/13/2016 08:00:00 PM,48,-122,1,6,7
25869,SpokaneStBridge,12/13/2016 09:00:00 PM,48,-122,2,8,10
25870,SpokaneStBridge,12/13/2016 10:00:00 PM,48,-122,1,1,2
25871,SpokaneStBridge,12/13/2016 11:00:00 PM,48,-122,1,3,4
25872,SpokaneStBridge,12/14/2016 12:00:00 AM,48,-122,0,0,0
25873,SpokaneStBridge,12/14/2016 01:00:00 AM,48,-122,1,1,2
25874,SpokaneStBridge,12/14/2016 02:00:00 AM,48,-122,0,2,2
25875,SpokaneStBridge,12/14/2016 03:00:00 AM,48,-122,1,1,2
25876,SpokaneStBridge,12/14/2016 04:00:00 AM,48,-122,1,1,2
25877,SpokaneStBridge,12/14/2016 05:00:00 AM,48,-122,9,0,9
25878,SpokaneStBridge,12/14/2016 06:00:00 AM,48,-122,29,4,33
25879,SpokaneStBridge,12/14/2016 07:00:00 AM,48,-122,51,4,55
25880,SpokaneStBridge,12/14/2016 08:00:00 AM,48,-122,51,8,59
25881,SpokaneStBridge,12/14/2016 09:00:00 AM,48,-122,41,5,46
25882,SpokaneStBridge,12/14/2016 10:00:00 AM,48,-122,9,3,12
25883,SpokaneStBridge,12/14/2016 11:00:00 AM,48,-122,9,1,10
25884,SpokaneStBridge,12/14/2016 12:00:00 PM,48,-122,7,2,9
25885,SpokaneStBridge,12/14/2016 01:00:00 PM,48,-122,4,6,10
25886,SpokaneStBridge,12/14/2016 02:00:00 PM,48,-122,5,5,10
25887,SpokaneStBridge,12/14/2016 03:00:00 PM,48,-122,5,11,16
25888,SpokaneStBridge,12/14/2016 04:00:00 PM,48,-122,8,30,38
25889,SpokaneStBridge,12/14/2016 05:00:00 PM,48,-122,10,72,82
25890,SpokaneStBridge,12/14/2016 06:00:00 PM,48,-122,4,42,46
25891,SpokaneStBridge,12/14/2016 07:00:00 PM,48,-122,6,11,17
25892,SpokaneStBridge,12/14/2016 08:00:00 PM,48,-122,1,13,14
25893,SpokaneStBridge,12/14/2016 09:00:00 PM,48,-122,0,3,3
25894,SpokaneStBridge,12/14/2016 10:00:00 PM,48,-122,1,3,4
25895,SpokaneStBridge,12/14/2016 11:00:00 PM,48,-122,3,3,6
25896,SpokaneStBridge,12/15/2016 12:00:00 AM,48,-122,0,0,0
25897,SpokaneStBridge,12/15/2016 01:00:00 AM,48,-122,1,1,2
25898,SpokaneStBridge,12/15/2016 02:00:00 AM,48,-122,1,0,1
25899,SpokaneStBridge,12/15/2016 03:00:00 AM,48,-122,1,0,1
25900,SpokaneStBridge,12/15/2016 04:00:00 AM,48,-122,1,0,1
25901,SpokaneStBridge,12/15/2016 05:00:00 AM,48,-122,6,1,7
25902,SpokaneStBridge,12/15/2016 06:00:00 AM,48,-122,25,2,27
25903,SpokaneStBridge,12/15/2016 07:00:00 AM,48,-122,48,6,54
25904,SpokaneStBridge,12/15/2016 08:00:00 AM,48,-122,78,4,82
25905,SpokaneStBridge,12/15/2016 09:00:00 AM,48,-122,34,3,37
25906,SpokaneStBridge,12/15/2016 10:00:00 AM,48,-122,10,1,11
25907,SpokaneStBridge,12/15/2016 11:00:00 AM,48,-122,6,1,7
25908,SpokaneStBridge,12/15/2016 12:00:00 PM,48,-122,10,6,16
25909,SpokaneStBridge,12/15/2016 01:00:00 PM,48,-122,5,6,11
25910,SpokaneStBridge,12/15/2016 02:00:00 PM,48,-122,6,8,14
25911,SpokaneStBridge,12/15/2016 03:00:00 PM,48,-122,10,20,30
25912,SpokaneStBridge,12/15/2016 04:00:00 PM,48,-122,8,35,43
25913,SpokaneStBridge,12/15/2016 05:00:00 PM,48,-122,12,67,79
25914,SpokaneStBridge,12/15/2016 06:00:00 PM,48,-122,12,50,62
25915,SpokaneStBridge,12/15/2016 07:00:00 PM,48,-122,7,12,19
25916,SpokaneStBridge,12/15/2016 08:00:00 PM,48,-122,0,4,4
25917,SpokaneStBridge,12/15/2016 09:00:00 PM,48,-122,2,13,15
25918,SpokaneStBridge,12/15/2016 10:00:00 PM,48,-122,2,1,3
25919,SpokaneStBridge,12/15/2016 11:00:00 PM,48,-122,0,2,2
25920,SpokaneStBridge,12/16/2016 12:00:00 AM,48,-122,0,1,1
25921,SpokaneStBridge,12/16/2016 01:00:00 AM,48,-122,0,1,1
25922,SpokaneStBridge,12/16/2016 02:00:00 AM,48,-122,1,1,2
25923,SpokaneStBridge,12/16/2016 03:00:00 AM,48,-122,1,0,1
25924,SpokaneStBridge,12/16/2016 04:00:00 AM,48,-122,1,0,1
25925,SpokaneStBridge,12/16/2016 05:00:00 AM,48,-122,6,1,7
25926,SpokaneStBridge,12/16/2016 06:00:00 AM,48,-122,14,0,14
25927,SpokaneStBridge,12/16/2016 07:00:00 AM,48,-122,42,4,46
25928,SpokaneStBridge,12/16/2016 08:00:00 AM,48,-122,54,3,57
25929,SpokaneStBridge,12/16/2016 09:00:00 AM,48,-122,22,3,25
25930,SpokaneStBridge,12/16/2016 10:00:00 AM,48,-122,7,6,13
25931,SpokaneStBridge,12/16/2016 11:00:00 AM,48,-122,7,5,12
25932,SpokaneStBridge,12/16/2016 12:00:00 PM,48,-122,5,6,11
25933,SpokaneStBridge,12/16/2016 01:00:00 PM,48,-122,5,6,11
25934,SpokaneStBridge,12/16/2016 02:00:00 PM,48,-122,5,9,14
25935,SpokaneStBridge,12/16/2016 03:00:00 PM,48,-122,6,14,20
25936,SpokaneStBridge,12/16/2016 04:00:00 PM,48,-122,5,26,31
25937,SpokaneStBridge,12/16/2016 05:00:00 PM,48,-122,6,39,45
25938,SpokaneStBridge,12/16/2016 06:00:00 PM,48,-122,7,27,34
25939,SpokaneStBridge,12/16/2016 07:00:00 PM,48,-122,3,9,12
25940,SpokaneStBridge,12/16/2016 08:00:00 PM,48,-122,0,2,2
25941,SpokaneStBridge,12/16/2016 09:00:00 PM,48,-122,0,1,1
25942,SpokaneStBridge,12/16/2016 10:00:00 PM,48,-122,1,2,3
25943,SpokaneStBridge,12/16/2016 11:00:00 PM,48,-122,0,3,3
25944,SpokaneStBridge,12/17/2016 12:00:00 AM,48,-122,0,0,0
25945,SpokaneStBridge,12/17/2016 01:00:00 AM,48,-122,1,1,2
25946,SpokaneStBridge,12/17/2016 02:00:00 AM,48,-122,0,0,0
25947,SpokaneStBridge,12/17/2016 03:00:00 AM,48,-122,0,0,0
25948,SpokaneStBridge,12/17/2016 04:00:00 AM,48,-122,1,0,1
25949,SpokaneStBridge,12/17/2016 05:00:00 AM,48,-122,1,0,1
25950,SpokaneStBridge,12/17/2016 06:00:00 AM,48,-122,3,0,3
25951,SpokaneStBridge,12/17/2016 07:00:00 AM,48,-122,2,0,2
25952,SpokaneStBridge,12/17/2016 08:00:00 AM,48,-122,2,1,3
25953,SpokaneStBridge,12/17/2016 09:00:00 AM,48,-122,9,3,12
25954,SpokaneStBridge,12/17/2016 10:00:00 AM,48,-122,3,6,9
25955,SpokaneStBridge,12/17/2016 11:00:00 AM,48,-122,11,2,13
25956,SpokaneStBridge,12/17/2016 12:00:00 PM,48,-122,8,2,10
25957,SpokaneStBridge,12/17/2016 01:00:00 PM,48,-122,5,4,9
25958,SpokaneStBridge,12/17/2016 02:00:00 PM,48,-122,7,7,14
25959,SpokaneStBridge,12/17/2016 03:00:00 PM,48,-122,4,4,8
25960,SpokaneStBridge,12/17/2016 04:00:00 PM,48,-122,3,9,12
25961,SpokaneStBridge,12/17/2016 05:00:00 PM,48,-122,4,1,5
25962,SpokaneStBridge,12/17/2016 06:00:00 PM,48,-122,4,6,10
25963,SpokaneStBridge,12/17/2016 07:00:00 PM,48,-122,1,1,2
25964,SpokaneStBridge,12/17/2016 08:00:00 PM,48,-122,0,1,1
25965,SpokaneStBridge,12/17/2016 09:00:00 PM,48,-122,0,2,2
25966,SpokaneStBridge,12/17/2016 10:00:00 PM,48,-122,2,3,5
25967,SpokaneStBridge,12/17/2016 11:00:00 PM,48,-122,3,2,5
25968,SpokaneStBridge,12/18/2016 12:00:00 AM,48,-122,0,3,3
25969,SpokaneStBridge,12/18/2016 01:00:00 AM,48,-122,3,2,5
25970,SpokaneStBridge,12/18/2016 02:00:00 AM,48,-122,2,0,2
25971,SpokaneStBridge,12/18/2016 03:00:00 AM,48,-122,1,0,1
25972,SpokaneStBridge,12/18/2016 04:00:00 AM,48,-122,0,1,1
25973,SpokaneStBridge,12/18/2016 05:00:00 AM,48,-122,3,0,3
25974,SpokaneStBridge,12/18/2016 06:00:00 AM,48,-122,0,3,3
25975,SpokaneStBridge,12/18/2016 07:00:00 AM,48,-122,1,1,2
25976,SpokaneStBridge,12/18/2016 08:00:00 AM,48,-122,3,3,6
25977,SpokaneStBridge,12/18/2016 09:00:00 AM,48,-122,5,0,5
25978,SpokaneStBridge,12/18/2016 10:00:00 AM,48,-122,7,4,11
25979,SpokaneStBridge,12/18/2016 11:00:00 AM,48,-122,8,1,9
25980,SpokaneStBridge,12/18/2016 12:00:00 PM,48,-122,2,3,5
25981,SpokaneStBridge,12/18/2016 01:00:00 PM,48,-122,6,6,12
25982,SpokaneStBridge,12/18/2016 02:00:00 PM,48,-122,2,4,6
25983,SpokaneStBridge,12/18/2016 03:00:00 PM,48,-122,8,10,18
25984,SpokaneStBridge,12/18/2016 04:00:00 PM,48,-122,10,11,21
25985,SpokaneStBridge,12/18/2016 05:00:00 PM,48,-122,7,10,17
25986,SpokaneStBridge,12/18/2016 06:00:00 PM,48,-122,1,3,4
25987,SpokaneStBridge,12/18/2016 07:00:00 PM,48,-122,2,1,3
25988,SpokaneStBridge,12/18/2016 08:00:00 PM,48,-122,4,1,5
25989,SpokaneStBridge,12/18/2016 09:00:00 PM,48,-122,1,2,3
25990,SpokaneStBridge,12/18/2016 10:00:00 PM,48,-122,0,1,1
25991,SpokaneStBridge,12/18/2016 11:00:00 PM,48,-122,1,0,1
25992,SpokaneStBridge,12/19/2016 12:00:00 AM,48,-122,1,1,2
25993,SpokaneStBridge,12/19/2016 01:00:00 AM,48,-122,0,1,1
25994,SpokaneStBridge,12/19/2016 02:00:00 AM,48,-122,0,0,0
25995,SpokaneStBridge,12/19/2016 03:00:00 AM,48,-122,1,0,1
25996,SpokaneStBridge,12/19/2016 04:00:00 AM,48,-122,2,1,3
25997,SpokaneStBridge,12/19/2016 05:00:00 AM,48,-122,6,0,6
25998,SpokaneStBridge,12/19/2016 06:00:00 AM,48,-122,21,3,24
25999,SpokaneStBridge,12/19/2016 07:00:00 AM,48,-122,45,5,50
26000,SpokaneStBridge,12/19/2016 08:00:00 AM,48,-122,53,1,54
26001,SpokaneStBridge,12/19/2016 09:00:00 AM,48,-122,25,2,27
26002,SpokaneStBridge,12/19/2016 10:00:00 AM,48,-122,11,1,12
26003,SpokaneStBridge,12/19/2016 11:00:00 AM,48,-122,1,1,2
26004,SpokaneStBridge,12/19/2016 12:00:00 PM,48,-122,3,4,7
26005,SpokaneStBridge,12/19/2016 01:00:00 PM,48,-122,4,2,6
26006,SpokaneStBridge,12/19/2016 02:00:00 PM,48,-122,3,7,10
26007,SpokaneStBridge,12/19/2016 03:00:00 PM,48,-122,4,11,15
26008,SpokaneStBridge,12/19/2016 04:00:00 PM,48,-122,5,22,27
26009,SpokaneStBridge,12/19/2016 05:00:00 PM,48,-122,6,60,66
26010,SpokaneStBridge,12/19/2016 06:00:00 PM,48,-122,6,32,38
26011,SpokaneStBridge,12/19/2016 07:00:00 PM,48,-122,2,13,15
26012,SpokaneStBridge,12/19/2016 08:00:00 PM,48,-122,3,3,6
26013,SpokaneStBridge,12/19/2016 09:00:00 PM,48,-122,1,3,4
26014,SpokaneStBridge,12/19/2016 10:00:00 PM,48,-122,0,0,0
26015,SpokaneStBridge,12/19/2016 11:00:00 PM,48,-122,0,0,0
26016,SpokaneStBridge,12/20/2016 12:00:00 AM,48,-122,0,3,3
26017,SpokaneStBridge,12/20/2016 01:00:00 AM,48,-122,1,0,1
26018,SpokaneStBridge,12/20/2016 02:00:00 AM,48,-122,2,4,6
26019,SpokaneStBridge,12/20/2016 03:00:00 AM,48,-122,1,1,2
26020,SpokaneStBridge,12/20/2016 04:00:00 AM,48,-122,2,0,2
26021,SpokaneStBridge,12/20/2016 05:00:00 AM,48,-122,11,2,13
26022,SpokaneStBridge,12/20/2016 06:00:00 AM,48,-122,26,4,30
26023,SpokaneStBridge,12/20/2016 07:00:00 AM,48,-122,45,8,53
26024,SpokaneStBridge,12/20/2016 08:00:00 AM,48,-122,60,4,64
26025,SpokaneStBridge,12/20/2016 09:00:00 AM,48,-122,23,2,25
26026,SpokaneStBridge,12/20/2016 10:00:00 AM,48,-122,8,4,12
26027,SpokaneStBridge,12/20/2016 11:00:00 AM,48,-122,4,4,8
26028,SpokaneStBridge,12/20/2016 12:00:00 PM,48,-122,5,5,10
26029,SpokaneStBridge,12/20/2016 01:00:00 PM,48,-122,6,7,13
26030,SpokaneStBridge,12/20/2016 02:00:00 PM,48,-122,5,7,12
26031,SpokaneStBridge,12/20/2016 03:00:00 PM,48,-122,9,12,21
26032,SpokaneStBridge,12/20/2016 04:00:00 PM,48,-122,7,34,41
26033,SpokaneStBridge,12/20/2016 05:00:00 PM,48,-122,6,68,74
26034,SpokaneStBridge,12/20/2016 06:00:00 PM,48,-122,5,38,43
26035,SpokaneStBridge,12/20/2016 07:00:00 PM,48,-122,1,7,8
26036,SpokaneStBridge,12/20/2016 08:00:00 PM,48,-122,1,2,3
26037,SpokaneStBridge,12/20/2016 09:00:00 PM,48,-122,2,3,5
26038,SpokaneStBridge,12/20/2016 10:00:00 PM,48,-122,2,1,3
26039,SpokaneStBridge,12/20/2016 11:00:00 PM,48,-122,0,2,2
26040,SpokaneStBridge,12/21/2016 12:00:00 AM,48,-122,0,0,0
26041,SpokaneStBridge,12/21/2016 01:00:00 AM,48,-122,0,1,1
26042,SpokaneStBridge,12/21/2016 02:00:00 AM,48,-122,0,0,0
26043,SpokaneStBridge,12/21/2016 03:00:00 AM,48,-122,2,4,6
26044,SpokaneStBridge,12/21/2016 04:00:00 AM,48,-122,1,1,2
26045,SpokaneStBridge,12/21/2016 05:00:00 AM,48,-122,11,1,12
26046,SpokaneStBridge,12/21/2016 06:00:00 AM,48,-122,35,2,37
26047,SpokaneStBridge,12/21/2016 07:00:00 AM,48,-122,57,7,64
26048,SpokaneStBridge,12/21/2016 08:00:00 AM,48,-122,59,4,63
26049,SpokaneStBridge,12/21/2016 09:00:00 AM,48,-122,32,8,40
26050,SpokaneStBridge,12/21/2016 10:00:00 AM,48,-122,14,2,16
26051,SpokaneStBridge,12/21/2016 11:00:00 AM,48,-122,10,3,13
26052,SpokaneStBridge,12/21/2016 12:00:00 PM,48,-122,7,2,9
26053,SpokaneStBridge,12/21/2016 01:00:00 PM,48,-122,8,10,18
26054,SpokaneStBridge,12/21/2016 02:00:00 PM,48,-122,8,12,20
26055,SpokaneStBridge,12/21/2016 03:00:00 PM,48,-122,6,17,23
26056,SpokaneStBridge,12/21/2016 04:00:00 PM,48,-122,7,43,50
26057,SpokaneStBridge,12/21/2016 05:00:00 PM,48,-122,10,60,70
26058,SpokaneStBridge,12/21/2016 06:00:00 PM,48,-122,13,36,49
26059,SpokaneStBridge,12/21/2016 07:00:00 PM,48,-122,4,7,11
26060,SpokaneStBridge,12/21/2016 08:00:00 PM,48,-122,3,13,16
26061,SpokaneStBridge,12/21/2016 09:00:00 PM,48,-122,1,6,7
26062,SpokaneStBridge,12/21/2016 10:00:00 PM,48,-122,1,3,4
26063,SpokaneStBridge,12/21/2016 11:00:00 PM,48,-122,1,1,2
26064,SpokaneStBridge,12/22/2016 12:00:00 AM,48,-122,1,1,2
26065,SpokaneStBridge,12/22/2016 01:00:00 AM,48,-122,0,1,1
26066,SpokaneStBridge,12/22/2016 02:00:00 AM,48,-122,0,0,0
26067,SpokaneStBridge,12/22/2016 03:00:00 AM,48,-122,0,0,0
26068,SpokaneStBridge,12/22/2016 04:00:00 AM,48,-122,1,0,1
26069,SpokaneStBridge,12/22/2016 05:00:00 AM,48,-122,9,3,12
26070,SpokaneStBridge,12/22/2016 06:00:00 AM,48,-122,26,1,27
26071,SpokaneStBridge,12/22/2016 07:00:00 AM,48,-122,42,7,49
26072,SpokaneStBridge,12/22/2016 08:00:00 AM,48,-122,53,1,54
26073,SpokaneStBridge,12/22/2016 09:00:00 AM,48,-122,27,0,27
26074,SpokaneStBridge,12/22/2016 10:00:00 AM,48,-122,15,2,17
26075,SpokaneStBridge,12/22/2016 11:00:00 AM,48,-122,6,3,9
26076,SpokaneStBridge,12/22/2016 12:00:00 PM,48,-122,3,2,5
26077,SpokaneStBridge,12/22/2016 01:00:00 PM,48,-122,7,3,10
26078,SpokaneStBridge,12/22/2016 02:00:00 PM,48,-122,5,6,11
26079,SpokaneStBridge,12/22/2016 03:00:00 PM,48,-122,5,15,20
26080,SpokaneStBridge,12/22/2016 04:00:00 PM,48,-122,7,36,43
26081,SpokaneStBridge,12/22/2016 05:00:00 PM,48,-122,3,37,40
26082,SpokaneStBridge,12/22/2016 06:00:00 PM,48,-122,5,25,30
26083,SpokaneStBridge,12/22/2016 07:00:00 PM,48,-122,4,11,15
26084,SpokaneStBridge,12/22/2016 08:00:00 PM,48,-122,0,3,3
26085,SpokaneStBridge,12/22/2016 09:00:00 PM,48,-122,1,4,5
26086,SpokaneStBridge,12/22/2016 10:00:00 PM,48,-122,1,2,3
26087,SpokaneStBridge,12/22/2016 11:00:00 PM,48,-122,0,1,1
26088,SpokaneStBridge,12/23/2016 12:00:00 AM,48,-122,0,1,1
26089,SpokaneStBridge,12/23/2016 01:00:00 AM,48,-122,0,0,0
26090,SpokaneStBridge,12/23/2016 02:00:00 AM,48,-122,0,0,0
26091,SpokaneStBridge,12/23/2016 03:00:00 AM,48,-122,1,0,1
26092,SpokaneStBridge,12/23/2016 04:00:00 AM,48,-122,1,0,1
26093,SpokaneStBridge,12/23/2016 05:00:00 AM,48,-122,5,0,5
26094,SpokaneStBridge,12/23/2016 06:00:00 AM,48,-122,10,2,12
26095,SpokaneStBridge,12/23/2016 07:00:00 AM,48,-122,12,2,14
26096,SpokaneStBridge,12/23/2016 08:00:00 AM,48,-122,21,1,22
26097,SpokaneStBridge,12/23/2016 09:00:00 AM,48,-122,5,1,6
26098,SpokaneStBridge,12/23/2016 10:00:00 AM,48,-122,4,1,5
26099,SpokaneStBridge,12/23/2016 11:00:00 AM,48,-122,1,1,2
26100,SpokaneStBridge,12/23/2016 12:00:00 PM,48,-122,1,2,3
26101,SpokaneStBridge,12/23/2016 01:00:00 PM,48,-122,1,4,5
26102,SpokaneStBridge,12/23/2016 02:00:00 PM,48,-122,2,6,8
26103,SpokaneStBridge,12/23/2016 03:00:00 PM,48,-122,2,7,9
26104,SpokaneStBridge,12/23/2016 04:00:00 PM,48,-122,2,10,12
26105,SpokaneStBridge,12/23/2016 05:00:00 PM,48,-122,1,14,15
26106,SpokaneStBridge,12/23/2016 06:00:00 PM,48,-122,0,3,3
26107,SpokaneStBridge,12/23/2016 07:00:00 PM,48,-122,0,2,2
26108,SpokaneStBridge,12/23/2016 08:00:00 PM,48,-122,1,3,4
26109,SpokaneStBridge,12/23/2016 09:00:00 PM,48,-122,0,1,1
26110,SpokaneStBridge,12/23/2016 10:00:00 PM,48,-122,0,0,0
26111,SpokaneStBridge,12/23/2016 11:00:00 PM,48,-122,0,0,0
26112,SpokaneStBridge,12/24/2016 12:00:00 AM,48,-122,2,0,2
26113,SpokaneStBridge,12/24/2016 01:00:00 AM,48,-122,1,0,1
26114,SpokaneStBridge,12/24/2016 02:00:00 AM,48,-122,0,1,1
26115,SpokaneStBridge,12/24/2016 03:00:00 AM,48,-122,0,0,0
26116,SpokaneStBridge,12/24/2016 04:00:00 AM,48,-122,1,0,1
26117,SpokaneStBridge,12/24/2016 05:00:00 AM,48,-122,4,1,5
26118,SpokaneStBridge,12/24/2016 06:00:00 AM,48,-122,1,0,1
26119,SpokaneStBridge,12/24/2016 07:00:00 AM,48,-122,2,0,2
26120,SpokaneStBridge,12/24/2016 08:00:00 AM,48,-122,9,2,11
26121,SpokaneStBridge,12/24/2016 09:00:00 AM,48,-122,6,4,10
26122,SpokaneStBridge,12/24/2016 10:00:00 AM,48,-122,3,3,6
26123,SpokaneStBridge,12/24/2016 11:00:00 AM,48,-122,6,4,10
26124,SpokaneStBridge,12/24/2016 12:00:00 PM,48,-122,9,6,15
26125,SpokaneStBridge,12/24/2016 01:00:00 PM,48,-122,3,5,8
26126,SpokaneStBridge,12/24/2016 02:00:00 PM,48,-122,7,9,16
26127,SpokaneStBridge,12/24/2016 03:00:00 PM,48,-122,5,7,12
26128,SpokaneStBridge,12/24/2016 04:00:00 PM,48,-122,6,7,13
26129,SpokaneStBridge,12/24/2016 05:00:00 PM,48,-122,3,4,7
26130,SpokaneStBridge,12/24/2016 06:00:00 PM,48,-122,3,8,11
26131,SpokaneStBridge,12/24/2016 07:00:00 PM,48,-122,3,0,3
26132,SpokaneStBridge,12/24/2016 08:00:00 PM,48,-122,0,0,0
26133,SpokaneStBridge,12/24/2016 09:00:00 PM,48,-122,0,2,2
26134,SpokaneStBridge,12/24/2016 10:00:00 PM,48,-122,0,0,0
26135,SpokaneStBridge,12/24/2016 11:00:00 PM,48,-122,0,0,0
26136,SpokaneStBridge,12/25/2016 12:00:00 AM,48,-122,0,1,1
26137,SpokaneStBridge,12/25/2016 01:00:00 AM,48,-122,1,0,1
26138,SpokaneStBridge,12/25/2016 02:00:00 AM,48,-122,0,0,0
26139,SpokaneStBridge,12/25/2016 03:00:00 AM,48,-122,0,1,1
26140,SpokaneStBridge,12/25/2016 04:00:00 AM,48,-122,0,0,0
26141,SpokaneStBridge,12/25/2016 05:00:00 AM,48,-122,3,0,3
26142,SpokaneStBridge,12/25/2016 06:00:00 AM,48,-122,0,0,0
26143,SpokaneStBridge,12/25/2016 07:00:00 AM,48,-122,1,0,1
26144,SpokaneStBridge,12/25/2016 08:00:00 AM,48,-122,22,19,41
26145,SpokaneStBridge,12/25/2016 09:00:00 AM,48,-122,5,5,10
26146,SpokaneStBridge,12/25/2016 10:00:00 AM,48,-122,3,0,3
26147,SpokaneStBridge,12/25/2016 11:00:00 AM,48,-122,1,4,5
26148,SpokaneStBridge,12/25/2016 12:00:00 PM,48,-122,8,18,26
26149,SpokaneStBridge,12/25/2016 01:00:00 PM,48,-122,25,10,35
26150,SpokaneStBridge,12/25/2016 02:00:00 PM,48,-122,14,10,24
26151,SpokaneStBridge,12/25/2016 03:00:00 PM,48,-122,7,12,19
26152,SpokaneStBridge,12/25/2016 04:00:00 PM,48,-122,6,2,8
26153,SpokaneStBridge,12/25/2016 05:00:00 PM,48,-122,1,1,2
26154,SpokaneStBridge,12/25/2016 06:00:00 PM,48,-122,0,0,0
26155,SpokaneStBridge,12/25/2016 07:00:00 PM,48,-122,1,0,1
26156,SpokaneStBridge,12/25/2016 08:00:00 PM,48,-122,1,0,1
26157,SpokaneStBridge,12/25/2016 09:00:00 PM,48,-122,2,1,3
26158,SpokaneStBridge,12/25/2016 10:00:00 PM,48,-122,0,0,0
26159,SpokaneStBridge,12/25/2016 11:00:00 PM,48,-122,1,0,1
26160,SpokaneStBridge,12/26/2016 12:00:00 AM,48,-122,0,0,0
26161,SpokaneStBridge,12/26/2016 01:00:00 AM,48,-122,2,0,2
26162,SpokaneStBridge,12/26/2016 02:00:00 AM,48,-122,0,0,0
26163,SpokaneStBridge,12/26/2016 03:00:00 AM,48,-122,0,0,0
26164,SpokaneStBridge,12/26/2016 04:00:00 AM,48,-122,0,1,1
26165,SpokaneStBridge,12/26/2016 05:00:00 AM,48,-122,2,0,2
26166,SpokaneStBridge,12/26/2016 06:00:00 AM,48,-122,3,0,3
26167,SpokaneStBridge,12/26/2016 07:00:00 AM,48,-122,5,2,7
26168,SpokaneStBridge,12/26/2016 08:00:00 AM,48,-122,6,4,10
26169,SpokaneStBridge,12/26/2016 09:00:00 AM,48,-122,10,2,12
26170,SpokaneStBridge,12/26/2016 10:00:00 AM,48,-122,13,5,18
26171,SpokaneStBridge,12/26/2016 11:00:00 AM,48,-122,6,4,10
26172,SpokaneStBridge,12/26/2016 12:00:00 PM,48,-122,2,6,8
26173,SpokaneStBridge,12/26/2016 01:00:00 PM,48,-122,6,7,13
26174,SpokaneStBridge,12/26/2016 02:00:00 PM,48,-122,9,5,14
26175,SpokaneStBridge,12/26/2016 03:00:00 PM,48,-122,8,5,13
26176,SpokaneStBridge,12/26/2016 04:00:00 PM,48,-122,2,9,11
26177,SpokaneStBridge,12/26/2016 05:00:00 PM,48,-122,1,4,5
26178,SpokaneStBridge,12/26/2016 06:00:00 PM,48,-122,3,2,5
26179,SpokaneStBridge,12/26/2016 07:00:00 PM,48,-122,0,0,0
26180,SpokaneStBridge,12/26/2016 08:00:00 PM,48,-122,1,1,2
26181,SpokaneStBridge,12/26/2016 09:00:00 PM,48,-122,1,2,3
26182,SpokaneStBridge,12/26/2016 10:00:00 PM,48,-122,0,0,0
26183,SpokaneStBridge,12/26/2016 11:00:00 PM,48,-122,0,1,1
26184,SpokaneStBridge,12/27/2016 12:00:00 AM,48,-122,0,1,1
26185,SpokaneStBridge,12/27/2016 01:00:00 AM,48,-122,0,0,0
26186,SpokaneStBridge,12/27/2016 02:00:00 AM,48,-122,1,0,1
26187,SpokaneStBridge,12/27/2016 03:00:00 AM,48,-122,0,1,1
26188,SpokaneStBridge,12/27/2016 04:00:00 AM,48,-122,1,0,1
26189,SpokaneStBridge,12/27/2016 05:00:00 AM,48,-122,8,1,9
26190,SpokaneStBridge,12/27/2016 06:00:00 AM,48,-122,10,1,11
26191,SpokaneStBridge,12/27/2016 07:00:00 AM,48,-122,37,3,40
26192,SpokaneStBridge,12/27/2016 08:00:00 AM,48,-122,31,4,35
26193,SpokaneStBridge,12/27/2016 09:00:00 AM,48,-122,23,1,24
26194,SpokaneStBridge,12/27/2016 10:00:00 AM,48,-122,6,3,9
26195,SpokaneStBridge,12/27/2016 11:00:00 AM,48,-122,10,4,14
26196,SpokaneStBridge,12/27/2016 12:00:00 PM,48,-122,4,3,7
26197,SpokaneStBridge,12/27/2016 01:00:00 PM,48,-122,4,3,7
26198,SpokaneStBridge,12/27/2016 02:00:00 PM,48,-122,2,9,11
26199,SpokaneStBridge,12/27/2016 03:00:00 PM,48,-122,6,6,12
26200,SpokaneStBridge,12/27/2016 04:00:00 PM,48,-122,8,27,35
26201,SpokaneStBridge,12/27/2016 05:00:00 PM,48,-122,7,37,44
26202,SpokaneStBridge,12/27/2016 06:00:00 PM,48,-122,6,21,27
26203,SpokaneStBridge,12/27/2016 07:00:00 PM,48,-122,0,4,4
26204,SpokaneStBridge,12/27/2016 08:00:00 PM,48,-122,0,3,3
26205,SpokaneStBridge,12/27/2016 09:00:00 PM,48,-122,1,5,6
26206,SpokaneStBridge,12/27/2016 10:00:00 PM,48,-122,0,1,1
26207,SpokaneStBridge,12/27/2016 11:00:00 PM,48,-122,0,1,1
26208,SpokaneStBridge,12/28/2016 12:00:00 AM,48,-122,0,0,0
26209,SpokaneStBridge,12/28/2016 01:00:00 AM,48,-122,1,1,2
26210,SpokaneStBridge,12/28/2016 02:00:00 AM,48,-122,0,2,2
26211,SpokaneStBridge,12/28/2016 03:00:00 AM,48,-122,0,0,0
26212,SpokaneStBridge,12/28/2016 04:00:00 AM,48,-122,0,1,1
26213,SpokaneStBridge,12/28/2016 05:00:00 AM,48,-122,10,1,11
26214,SpokaneStBridge,12/28/2016 06:00:00 AM,48,-122,26,4,30
26215,SpokaneStBridge,12/28/2016 07:00:00 AM,48,-122,37,3,40
26216,SpokaneStBridge,12/28/2016 08:00:00 AM,48,-122,44,6,50
26217,SpokaneStBridge,12/28/2016 09:00:00 AM,48,-122,30,4,34
26218,SpokaneStBridge,12/28/2016 10:00:00 AM,48,-122,9,7,16
26219,SpokaneStBridge,12/28/2016 11:00:00 AM,48,-122,11,6,17
26220,SpokaneStBridge,12/28/2016 12:00:00 PM,48,-122,10,5,15
26221,SpokaneStBridge,12/28/2016 01:00:00 PM,48,-122,10,8,18
26222,SpokaneStBridge,12/28/2016 02:00:00 PM,48,-122,9,11,20
26223,SpokaneStBridge,12/28/2016 03:00:00 PM,48,-122,6,18,24
26224,SpokaneStBridge,12/28/2016 04:00:00 PM,48,-122,11,25,36
26225,SpokaneStBridge,12/28/2016 05:00:00 PM,48,-122,8,54,62
26226,SpokaneStBridge,12/28/2016 06:00:00 PM,48,-122,4,21,25
26227,SpokaneStBridge,12/28/2016 07:00:00 PM,48,-122,3,8,11
26228,SpokaneStBridge,12/28/2016 08:00:00 PM,48,-122,0,5,5
26229,SpokaneStBridge,12/28/2016 09:00:00 PM,48,-122,0,5,5
26230,SpokaneStBridge,12/28/2016 10:00:00 PM,48,-122,0,1,1
26231,SpokaneStBridge,12/28/2016 11:00:00 PM,48,-122,0,2,2
26232,SpokaneStBridge,12/29/2016 12:00:00 AM,48,-122,0,0,0
26233,SpokaneStBridge,12/29/2016 01:00:00 AM,48,-122,0,0,0
26234,SpokaneStBridge,12/29/2016 02:00:00 AM,48,-122,0,0,0
26235,SpokaneStBridge,12/29/2016 03:00:00 AM,48,-122,2,0,2
26236,SpokaneStBridge,12/29/2016 04:00:00 AM,48,-122,1,1,2
26237,SpokaneStBridge,12/29/2016 05:00:00 AM,48,-122,6,0,6
26238,SpokaneStBridge,12/29/2016 06:00:00 AM,48,-122,21,4,25
26239,SpokaneStBridge,12/29/2016 07:00:00 AM,48,-122,34,5,39
26240,SpokaneStBridge,12/29/2016 08:00:00 AM,48,-122,47,2,49
26241,SpokaneStBridge,12/29/2016 09:00:00 AM,48,-122,26,4,30
26242,SpokaneStBridge,12/29/2016 10:00:00 AM,48,-122,5,1,6
26243,SpokaneStBridge,12/29/2016 11:00:00 AM,48,-122,7,3,10
26244,SpokaneStBridge,12/29/2016 12:00:00 PM,48,-122,3,3,6
26245,SpokaneStBridge,12/29/2016 01:00:00 PM,48,-122,3,7,10
26246,SpokaneStBridge,12/29/2016 02:00:00 PM,48,-122,4,3,7
26247,SpokaneStBridge,12/29/2016 03:00:00 PM,48,-122,4,10,14
26248,SpokaneStBridge,12/29/2016 04:00:00 PM,48,-122,5,30,35
26249,SpokaneStBridge,12/29/2016 05:00:00 PM,48,-122,4,44,48
26250,SpokaneStBridge,12/29/2016 06:00:00 PM,48,-122,4,23,27
26251,SpokaneStBridge,12/29/2016 07:00:00 PM,48,-122,4,27,31
26252,SpokaneStBridge,12/29/2016 08:00:00 PM,48,-122,1,4,5
26253,SpokaneStBridge,12/29/2016 09:00:00 PM,48,-122,2,3,5
26254,SpokaneStBridge,12/29/2016 10:00:00 PM,48,-122,4,1,5
26255,SpokaneStBridge,12/29/2016 11:00:00 PM,48,-122,10,3,13
26256,SpokaneStBridge,12/30/2016 12:00:00 AM,48,-122,11,1,12
26257,SpokaneStBridge,12/30/2016 01:00:00 AM,48,-122,0,0,0
26258,SpokaneStBridge,12/30/2016 02:00:00 AM,48,-122,1,1,2
26259,SpokaneStBridge,12/30/2016 03:00:00 AM,48,-122,0,1,1
26260,SpokaneStBridge,12/30/2016 04:00:00 AM,48,-122,1,0,1
26261,SpokaneStBridge,12/30/2016 05:00:00 AM,48,-122,4,0,4
26262,SpokaneStBridge,12/30/2016 06:00:00 AM,48,-122,6,3,9
26263,SpokaneStBridge,12/30/2016 07:00:00 AM,48,-122,21,4,25
26264,SpokaneStBridge,12/30/2016 08:00:00 AM,48,-122,35,0,35
26265,SpokaneStBridge,12/30/2016 09:00:00 AM,48,-122,13,6,19
26266,SpokaneStBridge,12/30/2016 10:00:00 AM,48,-122,15,3,18
26267,SpokaneStBridge,12/30/2016 11:00:00 AM,48,-122,5,4,9
26268,SpokaneStBridge,12/30/2016 12:00:00 PM,48,-122,10,8,18
26269,SpokaneStBridge,12/30/2016 01:00:00 PM,48,-122,15,4,19
26270,SpokaneStBridge,12/30/2016 02:00:00 PM,48,-122,9,21,30
26271,SpokaneStBridge,12/30/2016 03:00:00 PM,48,-122,10,24,34
26272,SpokaneStBridge,12/30/2016 04:00:00 PM,48,-122,6,21,27
26273,SpokaneStBridge,12/30/2016 05:00:00 PM,48,-122,8,26,34
26274,SpokaneStBridge,12/30/2016 06:00:00 PM,48,-122,2,8,10
26275,SpokaneStBridge,12/30/2016 07:00:00 PM,48,-122,3,6,9
26276,SpokaneStBridge,12/30/2016 08:00:00 PM,48,-122,3,1,4
26277,SpokaneStBridge,12/30/2016 09:00:00 PM,48,-122,0,2,2
26278,SpokaneStBridge,12/30/2016 10:00:00 PM,48,-122,1,1,2
26279,SpokaneStBridge,12/30/2016 11:00:00 PM,48,-122,0,1,1
26280,SpokaneStBridge,12/31/2016 12:00:00 AM,48,-122,0,0,0
26281,SpokaneStBridge,12/31/2016 01:00:00 AM,48,-122,0,0,0
26282,SpokaneStBridge,12/31/2016 02:00:00 AM,48,-122,0,0,0
26283,SpokaneStBridge,12/31/2016 03:00:00 AM,48,-122,1,0,1
26284,SpokaneStBridge,12/31/2016 04:00:00 AM,48,-122,1,1,2
26285,SpokaneStBridge,12/31/2016 05:00:00 AM,48,-122,2,0,2
26286,SpokaneStBridge,12/31/2016 06:00:00 AM,48,-122,3,0,3
26287,SpokaneStBridge,12/31/2016 07:00:00 AM,48,-122,3,1,4
26288,SpokaneStBridge,12/31/2016 08:00:00 AM,48,-122,4,1,5
26289,SpokaneStBridge,12/31/2016 09:00:00 AM,48,-122,2,2,4
26290,SpokaneStBridge,12/31/2016 10:00:00 AM,48,-122,8,4,12
26291,SpokaneStBridge,12/31/2016 11:00:00 AM,48,-122,4,2,6
26292,SpokaneStBridge,12/31/2016 12:00:00 PM,48,-122,5,12,17
26293,SpokaneStBridge,12/31/2016 01:00:00 PM,48,-122,5,5,10
26294,SpokaneStBridge,12/31/2016 02:00:00 PM,48,-122,5,7,12
26295,SpokaneStBridge,12/31/2016 03:00:00 PM,48,-122,2,4,6
26296,SpokaneStBridge,12/31/2016 04:00:00 PM,48,-122,4,4,8
26297,SpokaneStBridge,12/31/2016 05:00:00 PM,48,-122,2,1,3
26298,SpokaneStBridge,12/31/2016 06:00:00 PM,48,-122,1,0,1
26299,SpokaneStBridge,12/31/2016 07:00:00 PM,48,-122,2,3,5
26300,SpokaneStBridge,12/31/2016 08:00:00 PM,48,-122,0,1,1
26301,SpokaneStBridge,12/31/2016 09:00:00 PM,48,-122,1,1,2
26302,SpokaneStBridge,12/31/2016 10:00:00 PM,48,-122,4,1,5
26303,SpokaneStBridge,12/31/2016 11:00:00 PM,48,-122,0,1,1
26304,SpokaneStBridge,01/01/2017 12:00:00 AM,48,-122,2,0,2
26305,SpokaneStBridge,01/01/2017 01:00:00 AM,48,-122,0,0,0
26306,SpokaneStBridge,01/01/2017 02:00:00 AM,48,-122,0,1,1
26307,SpokaneStBridge,01/01/2017 03:00:00 AM,48,-122,0,3,3
26308,SpokaneStBridge,01/01/2017 04:00:00 AM,48,-122,0,0,0
26309,SpokaneStBridge,01/01/2017 05:00:00 AM,48,-122,2,2,4
26310,SpokaneStBridge,01/01/2017 06:00:00 AM,48,-122,1,0,1
26311,SpokaneStBridge,01/01/2017 07:00:00 AM,48,-122,2,1,3
26312,SpokaneStBridge,01/01/2017 08:00:00 AM,48,-122,0,0,0
26313,SpokaneStBridge,01/01/2017 09:00:00 AM,48,-122,1,0,1
26314,SpokaneStBridge,01/01/2017 10:00:00 AM,48,-122,0,4,4
26315,SpokaneStBridge,01/01/2017 11:00:00 AM,48,-122,2,1,3
26316,SpokaneStBridge,01/01/2017 12:00:00 PM,48,-122,1,3,4
26317,SpokaneStBridge,01/01/2017 01:00:00 PM,48,-122,6,3,9
26318,SpokaneStBridge,01/01/2017 02:00:00 PM,48,-122,8,3,11
26319,SpokaneStBridge,01/01/2017 03:00:00 PM,48,-122,4,8,12
26320,SpokaneStBridge,01/01/2017 04:00:00 PM,48,-122,4,4,8
26321,SpokaneStBridge,01/01/2017 05:00:00 PM,48,-122,2,0,2
26322,SpokaneStBridge,01/01/2017 06:00:00 PM,48,-122,1,3,4
26323,SpokaneStBridge,01/01/2017 07:00:00 PM,48,-122,2,1,3
26324,SpokaneStBridge,01/01/2017 08:00:00 PM,48,-122,0,2,2
26325,SpokaneStBridge,01/01/2017 09:00:00 PM,48,-122,1,2,3
26326,SpokaneStBridge,01/01/2017 10:00:00 PM,48,-122,0,0,0
26327,SpokaneStBridge,01/01/2017 11:00:00 PM,48,-122,0,0,0
26328,SpokaneStBridge,01/02/2017 12:00:00 AM,48,-122,0,0,0
26329,SpokaneStBridge,01/02/2017 01:00:00 AM,48,-122,0,0,0
26330,SpokaneStBridge,01/02/2017 02:00:00 AM,48,-122,0,1,1
26331,SpokaneStBridge,01/02/2017 03:00:00 AM,48,-122,0,0,0
26332,SpokaneStBridge,01/02/2017 04:00:00 AM,48,-122,1,2,3
26333,SpokaneStBridge,01/02/2017 05:00:00 AM,48,-122,2,0,2
26334,SpokaneStBridge,01/02/2017 06:00:00 AM,48,-122,1,0,1
26335,SpokaneStBridge,01/02/2017 07:00:00 AM,48,-122,3,1,4
26336,SpokaneStBridge,01/02/2017 08:00:00 AM,48,-122,7,0,7
26337,SpokaneStBridge,01/02/2017 09:00:00 AM,48,-122,7,0,7
26338,SpokaneStBridge,01/02/2017 10:00:00 AM,48,-122,6,4,10
26339,SpokaneStBridge,01/02/2017 11:00:00 AM,48,-122,5,5,10
26340,SpokaneStBridge,01/02/2017 12:00:00 PM,48,-122,2,6,8
26341,SpokaneStBridge,01/02/2017 01:00:00 PM,48,-122,14,6,20
26342,SpokaneStBridge,01/02/2017 02:00:00 PM,48,-122,14,11,25
26343,SpokaneStBridge,01/02/2017 03:00:00 PM,48,-122,5,8,13
26344,SpokaneStBridge,01/02/2017 04:00:00 PM,48,-122,9,8,17
26345,SpokaneStBridge,01/02/2017 05:00:00 PM,48,-122,8,7,15
26346,SpokaneStBridge,01/02/2017 06:00:00 PM,48,-122,0,5,5
26347,SpokaneStBridge,01/02/2017 07:00:00 PM,48,-122,1,2,3
26348,SpokaneStBridge,01/02/2017 08:00:00 PM,48,-122,1,0,1
26349,SpokaneStBridge,01/02/2017 09:00:00 PM,48,-122,0,0,0
26350,SpokaneStBridge,01/02/2017 10:00:00 PM,48,-122,0,0,0
26351,SpokaneStBridge,01/02/2017 11:00:00 PM,48,-122,0,2,2
26352,SpokaneStBridge,01/03/2017 12:00:00 AM,48,-122,1,0,1
26353,SpokaneStBridge,01/03/2017 01:00:00 AM,48,-122,0,1,1
26354,SpokaneStBridge,01/03/2017 02:00:00 AM,48,-122,0,0,0
26355,SpokaneStBridge,01/03/2017 03:00:00 AM,48,-122,1,1,2
26356,SpokaneStBridge,01/03/2017 04:00:00 AM,48,-122,2,1,3
26357,SpokaneStBridge,01/03/2017 05:00:00 AM,48,-122,5,0,5
26358,SpokaneStBridge,01/03/2017 06:00:00 AM,48,-122,23,7,30
26359,SpokaneStBridge,01/03/2017 07:00:00 AM,48,-122,45,5,50
26360,SpokaneStBridge,01/03/2017 08:00:00 AM,48,-122,60,2,62
26361,SpokaneStBridge,01/03/2017 09:00:00 AM,48,-122,21,3,24
26362,SpokaneStBridge,01/03/2017 10:00:00 AM,48,-122,6,3,9
26363,SpokaneStBridge,01/03/2017 11:00:00 AM,48,-122,5,3,8
26364,SpokaneStBridge,01/03/2017 12:00:00 PM,48,-122,3,2,5
26365,SpokaneStBridge,01/03/2017 01:00:00 PM,48,-122,4,7,11
26366,SpokaneStBridge,01/03/2017 02:00:00 PM,48,-122,8,3,11
26367,SpokaneStBridge,01/03/2017 03:00:00 PM,48,-122,4,4,8
26368,SpokaneStBridge,01/03/2017 04:00:00 PM,48,-122,7,25,32
26369,SpokaneStBridge,01/03/2017 05:00:00 PM,48,-122,10,71,81
26370,SpokaneStBridge,01/03/2017 06:00:00 PM,48,-122,7,47,54
26371,SpokaneStBridge,01/03/2017 07:00:00 PM,48,-122,3,7,10
26372,SpokaneStBridge,01/03/2017 08:00:00 PM,48,-122,2,6,8
26373,SpokaneStBridge,01/03/2017 09:00:00 PM,48,-122,0,2,2
26374,SpokaneStBridge,01/03/2017 10:00:00 PM,48,-122,0,4,4
26375,SpokaneStBridge,01/03/2017 11:00:00 PM,48,-122,0,1,1
26376,SpokaneStBridge,01/04/2017 12:00:00 AM,48,-122,0,1,1
26377,SpokaneStBridge,01/04/2017 01:00:00 AM,48,-122,0,1,1
26378,SpokaneStBridge,01/04/2017 02:00:00 AM,48,-122,0,1,1
26379,SpokaneStBridge,01/04/2017 03:00:00 AM,48,-122,0,1,1
26380,SpokaneStBridge,01/04/2017 04:00:00 AM,48,-122,1,0,1
26381,SpokaneStBridge,01/04/2017 05:00:00 AM,48,-122,7,1,8
26382,SpokaneStBridge,01/04/2017 06:00:00 AM,48,-122,30,3,33
26383,SpokaneStBridge,01/04/2017 07:00:00 AM,48,-122,43,7,50
26384,SpokaneStBridge,01/04/2017 08:00:00 AM,48,-122,64,4,68
26385,SpokaneStBridge,01/04/2017 09:00:00 AM,48,-122,30,7,37
26386,SpokaneStBridge,01/04/2017 10:00:00 AM,48,-122,11,3,14
26387,SpokaneStBridge,01/04/2017 11:00:00 AM,48,-122,7,3,10
26388,SpokaneStBridge,01/04/2017 12:00:00 PM,48,-122,5,5,10
26389,SpokaneStBridge,01/04/2017 01:00:00 PM,48,-122,11,2,13
26390,SpokaneStBridge,01/04/2017 02:00:00 PM,48,-122,6,6,12
26391,SpokaneStBridge,01/04/2017 03:00:00 PM,48,-122,2,17,19
26392,SpokaneStBridge,01/04/2017 04:00:00 PM,48,-122,10,24,34
26393,SpokaneStBridge,01/04/2017 05:00:00 PM,48,-122,10,55,65
26394,SpokaneStBridge,01/04/2017 06:00:00 PM,48,-122,5,40,45
26395,SpokaneStBridge,01/04/2017 07:00:00 PM,48,-122,3,16,19
26396,SpokaneStBridge,01/04/2017 08:00:00 PM,48,-122,1,10,11
26397,SpokaneStBridge,01/04/2017 09:00:00 PM,48,-122,0,5,5
26398,SpokaneStBridge,01/04/2017 10:00:00 PM,48,-122,0,3,3
26399,SpokaneStBridge,01/04/2017 11:00:00 PM,48,-122,0,0,0
26400,SpokaneStBridge,01/05/2017 12:00:00 AM,48,-122,0,0,0
26401,SpokaneStBridge,01/05/2017 01:00:00 AM,48,-122,1,0,1
26402,SpokaneStBridge,01/05/2017 02:00:00 AM,48,-122,1,1,2
26403,SpokaneStBridge,01/05/2017 03:00:00 AM,48,-122,0,0,0
26404,SpokaneStBridge,01/05/2017 04:00:00 AM,48,-122,1,1,2
26405,SpokaneStBridge,01/05/2017 05:00:00 AM,48,-122,8,1,9
26406,SpokaneStBridge,01/05/2017 06:00:00 AM,48,-122,20,5,25
26407,SpokaneStBridge,01/05/2017 07:00:00 AM,48,-122,33,2,35
26408,SpokaneStBridge,01/05/2017 08:00:00 AM,48,-122,57,5,62
26409,SpokaneStBridge,01/05/2017 09:00:00 AM,48,-122,25,6,31
26410,SpokaneStBridge,01/05/2017 10:00:00 AM,48,-122,13,4,17
26411,SpokaneStBridge,01/05/2017 11:00:00 AM,48,-122,9,1,10
26412,SpokaneStBridge,01/05/2017 12:00:00 PM,48,-122,5,2,7
26413,SpokaneStBridge,01/05/2017 01:00:00 PM,48,-122,6,6,12
26414,SpokaneStBridge,01/05/2017 02:00:00 PM,48,-122,7,6,13
26415,SpokaneStBridge,01/05/2017 03:00:00 PM,48,-122,9,11,20
26416,SpokaneStBridge,01/05/2017 04:00:00 PM,48,-122,9,28,37
26417,SpokaneStBridge,01/05/2017 05:00:00 PM,48,-122,10,63,73
26418,SpokaneStBridge,01/05/2017 06:00:00 PM,48,-122,6,41,47
26419,SpokaneStBridge,01/05/2017 07:00:00 PM,48,-122,4,12,16
26420,SpokaneStBridge,01/05/2017 08:00:00 PM,48,-122,3,4,7
26421,SpokaneStBridge,01/05/2017 09:00:00 PM,48,-122,2,4,6
26422,SpokaneStBridge,01/05/2017 10:00:00 PM,48,-122,0,3,3
26423,SpokaneStBridge,01/05/2017 11:00:00 PM,48,-122,0,1,1
26424,SpokaneStBridge,01/06/2017 12:00:00 AM,48,-122,0,0,0
26425,SpokaneStBridge,01/06/2017 01:00:00 AM,48,-122,1,0,1
26426,SpokaneStBridge,01/06/2017 02:00:00 AM,48,-122,0,1,1
26427,SpokaneStBridge,01/06/2017 03:00:00 AM,48,-122,0,0,0
26428,SpokaneStBridge,01/06/2017 04:00:00 AM,48,-122,1,0,1
26429,SpokaneStBridge,01/06/2017 05:00:00 AM,48,-122,7,1,8
26430,SpokaneStBridge,01/06/2017 06:00:00 AM,48,-122,19,2,21
26431,SpokaneStBridge,01/06/2017 07:00:00 AM,48,-122,37,7,44
26432,SpokaneStBridge,01/06/2017 08:00:00 AM,48,-122,54,8,62
26433,SpokaneStBridge,01/06/2017 09:00:00 AM,48,-122,25,1,26
26434,SpokaneStBridge,01/06/2017 10:00:00 AM,48,-122,7,1,8
26435,SpokaneStBridge,01/06/2017 11:00:00 AM,48,-122,8,16,24
26436,SpokaneStBridge,01/06/2017 12:00:00 PM,48,-122,17,2,19
26437,SpokaneStBridge,01/06/2017 01:00:00 PM,48,-122,3,4,7
26438,SpokaneStBridge,01/06/2017 02:00:00 PM,48,-122,9,9,18
26439,SpokaneStBridge,01/06/2017 03:00:00 PM,48,-122,9,7,16
26440,SpokaneStBridge,01/06/2017 04:00:00 PM,48,-122,6,36,42
26441,SpokaneStBridge,01/06/2017 05:00:00 PM,48,-122,10,45,55
26442,SpokaneStBridge,01/06/2017 06:00:00 PM,48,-122,5,31,36
26443,SpokaneStBridge,01/06/2017 07:00:00 PM,48,-122,1,15,16
26444,SpokaneStBridge,01/06/2017 08:00:00 PM,48,-122,1,3,4
26445,SpokaneStBridge,01/06/2017 09:00:00 PM,48,-122,3,4,7
26446,SpokaneStBridge,01/06/2017 10:00:00 PM,48,-122,0,0,0
26447,SpokaneStBridge,01/06/2017 11:00:00 PM,48,-122,0,0,0
26448,SpokaneStBridge,01/07/2017 12:00:00 AM,48,-122,2,2,4
26449,SpokaneStBridge,01/07/2017 01:00:00 AM,48,-122,1,0,1
26450,SpokaneStBridge,01/07/2017 02:00:00 AM,48,-122,0,1,1
26451,SpokaneStBridge,01/07/2017 03:00:00 AM,48,-122,0,0,0
26452,SpokaneStBridge,01/07/2017 04:00:00 AM,48,-122,1,0,1
26453,SpokaneStBridge,01/07/2017 05:00:00 AM,48,-122,2,0,2
26454,SpokaneStBridge,01/07/2017 06:00:00 AM,48,-122,4,1,5
26455,SpokaneStBridge,01/07/2017 07:00:00 AM,48,-122,4,0,4
26456,SpokaneStBridge,01/07/2017 08:00:00 AM,48,-122,2,3,5
26457,SpokaneStBridge,01/07/2017 09:00:00 AM,48,-122,4,2,6
26458,SpokaneStBridge,01/07/2017 10:00:00 AM,48,-122,12,7,19
26459,SpokaneStBridge,01/07/2017 11:00:00 AM,48,-122,13,6,19
26460,SpokaneStBridge,01/07/2017 12:00:00 PM,48,-122,10,18,28
26461,SpokaneStBridge,01/07/2017 01:00:00 PM,48,-122,12,11,23
26462,SpokaneStBridge,01/07/2017 02:00:00 PM,48,-122,8,18,26
26463,SpokaneStBridge,01/07/2017 03:00:00 PM,48,-122,10,9,19
26464,SpokaneStBridge,01/07/2017 04:00:00 PM,48,-122,5,5,10
26465,SpokaneStBridge,01/07/2017 05:00:00 PM,48,-122,8,6,14
26466,SpokaneStBridge,01/07/2017 06:00:00 PM,48,-122,2,3,5
26467,SpokaneStBridge,01/07/2017 07:00:00 PM,48,-122,1,0,1
26468,SpokaneStBridge,01/07/2017 08:00:00 PM,48,-122,2,10,12
26469,SpokaneStBridge,01/07/2017 09:00:00 PM,48,-122,1,3,4
26470,SpokaneStBridge,01/07/2017 10:00:00 PM,48,-122,6,1,7
26471,SpokaneStBridge,01/07/2017 11:00:00 PM,48,-122,0,2,2
26472,SpokaneStBridge,01/08/2017 12:00:00 AM,48,-122,0,0,0
26473,SpokaneStBridge,01/08/2017 01:00:00 AM,48,-122,1,2,3
26474,SpokaneStBridge,01/08/2017 02:00:00 AM,48,-122,0,1,1
26475,SpokaneStBridge,01/08/2017 03:00:00 AM,48,-122,0,0,0
26476,SpokaneStBridge,01/08/2017 04:00:00 AM,48,-122,0,1,1
26477,SpokaneStBridge,01/08/2017 05:00:00 AM,48,-122,1,0,1
26478,SpokaneStBridge,01/08/2017 06:00:00 AM,48,-122,1,0,1
26479,SpokaneStBridge,01/08/2017 07:00:00 AM,48,-122,0,1,1
26480,SpokaneStBridge,01/08/2017 08:00:00 AM,48,-122,5,0,5
26481,SpokaneStBridge,01/08/2017 09:00:00 AM,48,-122,1,0,1
26482,SpokaneStBridge,01/08/2017 10:00:00 AM,48,-122,3,11,14
26483,SpokaneStBridge,01/08/2017 11:00:00 AM,48,-122,13,2,15
26484,SpokaneStBridge,01/08/2017 12:00:00 PM,48,-122,2,3,5
26485,SpokaneStBridge,01/08/2017 01:00:00 PM,48,-122,1,2,3
26486,SpokaneStBridge,01/08/2017 02:00:00 PM,48,-122,0,0,0
26487,SpokaneStBridge,01/08/2017 03:00:00 PM,48,-122,1,0,1
26488,SpokaneStBridge,01/08/2017 04:00:00 PM,48,-122,0,2,2
26489,SpokaneStBridge,01/08/2017 05:00:00 PM,48,-122,2,0,2
26490,SpokaneStBridge,01/08/2017 06:00:00 PM,48,-122,0,3,3
26491,SpokaneStBridge,01/08/2017 07:00:00 PM,48,-122,0,0,0
26492,SpokaneStBridge,01/08/2017 08:00:00 PM,48,-122,0,0,0
26493,SpokaneStBridge,01/08/2017 09:00:00 PM,48,-122,1,0,1
26494,SpokaneStBridge,01/08/2017 10:00:00 PM,48,-122,0,1,1
26495,SpokaneStBridge,01/08/2017 11:00:00 PM,48,-122,0,0,0
26496,SpokaneStBridge,01/09/2017 12:00:00 AM,48,-122,1,0,1
26497,SpokaneStBridge,01/09/2017 01:00:00 AM,48,-122,2,0,2
26498,SpokaneStBridge,01/09/2017 02:00:00 AM,48,-122,0,1,1
26499,SpokaneStBridge,01/09/2017 03:00:00 AM,48,-122,0,1,1
26500,SpokaneStBridge,01/09/2017 04:00:00 AM,48,-122,3,0,3
26501,SpokaneStBridge,01/09/2017 05:00:00 AM,48,-122,6,1,7
26502,SpokaneStBridge,01/09/2017 06:00:00 AM,48,-122,27,3,30
26503,SpokaneStBridge,01/09/2017 07:00:00 AM,48,-122,61,5,66
26504,SpokaneStBridge,01/09/2017 08:00:00 AM,48,-122,82,3,85
26505,SpokaneStBridge,01/09/2017 09:00:00 AM,48,-122,28,3,31
26506,SpokaneStBridge,01/09/2017 10:00:00 AM,48,-122,14,3,17
26507,SpokaneStBridge,01/09/2017 11:00:00 AM,48,-122,5,4,9
26508,SpokaneStBridge,01/09/2017 12:00:00 PM,48,-122,10,4,14
26509,SpokaneStBridge,01/09/2017 01:00:00 PM,48,-122,6,2,8
26510,SpokaneStBridge,01/09/2017 02:00:00 PM,48,-122,5,6,11
26511,SpokaneStBridge,01/09/2017 03:00:00 PM,48,-122,3,13,16
26512,SpokaneStBridge,01/09/2017 04:00:00 PM,48,-122,9,40,49
26513,SpokaneStBridge,01/09/2017 05:00:00 PM,48,-122,11,70,81
26514,SpokaneStBridge,01/09/2017 06:00:00 PM,48,-122,5,48,53
26515,SpokaneStBridge,01/09/2017 07:00:00 PM,48,-122,3,16,19
26516,SpokaneStBridge,01/09/2017 08:00:00 PM,48,-122,2,5,7
26517,SpokaneStBridge,01/09/2017 09:00:00 PM,48,-122,1,3,4
26518,SpokaneStBridge,01/09/2017 10:00:00 PM,48,-122,0,1,1
26519,SpokaneStBridge,01/09/2017 11:00:00 PM,48,-122,0,1,1
26520,SpokaneStBridge,01/10/2017 12:00:00 AM,48,-122,0,1,1
26521,SpokaneStBridge,01/10/2017 01:00:00 AM,48,-122,1,1,2
26522,SpokaneStBridge,01/10/2017 02:00:00 AM,48,-122,0,3,3
26523,SpokaneStBridge,01/10/2017 03:00:00 AM,48,-122,0,0,0
26524,SpokaneStBridge,01/10/2017 04:00:00 AM,48,-122,1,1,2
26525,SpokaneStBridge,01/10/2017 05:00:00 AM,48,-122,12,0,12
26526,SpokaneStBridge,01/10/2017 06:00:00 AM,48,-122,25,1,26
26527,SpokaneStBridge,01/10/2017 07:00:00 AM,48,-122,51,8,59
26528,SpokaneStBridge,01/10/2017 08:00:00 AM,48,-122,56,9,65
26529,SpokaneStBridge,01/10/2017 09:00:00 AM,48,-122,23,4,27
26530,SpokaneStBridge,01/10/2017 10:00:00 AM,48,-122,11,2,13
26531,SpokaneStBridge,01/10/2017 11:00:00 AM,48,-122,4,2,6
26532,SpokaneStBridge,01/10/2017 12:00:00 PM,48,-122,2,4,6
26533,SpokaneStBridge,01/10/2017 01:00:00 PM,48,-122,3,4,7
26534,SpokaneStBridge,01/10/2017 02:00:00 PM,48,-122,5,3,8
26535,SpokaneStBridge,01/10/2017 03:00:00 PM,48,-122,1,10,11
26536,SpokaneStBridge,01/10/2017 04:00:00 PM,48,-122,7,36,43
26537,SpokaneStBridge,01/10/2017 05:00:00 PM,48,-122,9,61,70
26538,SpokaneStBridge,01/10/2017 06:00:00 PM,48,-122,6,48,54
26539,SpokaneStBridge,01/10/2017 07:00:00 PM,48,-122,6,16,22
26540,SpokaneStBridge,01/10/2017 08:00:00 PM,48,-122,1,6,7
26541,SpokaneStBridge,01/10/2017 09:00:00 PM,48,-122,3,9,12
26542,SpokaneStBridge,01/10/2017 10:00:00 PM,48,-122,0,1,1
26543,SpokaneStBridge,01/10/2017 11:00:00 PM,48,-122,0,2,2
26544,SpokaneStBridge,01/11/2017 12:00:00 AM,48,-122,1,1,2
26545,SpokaneStBridge,01/11/2017 01:00:00 AM,48,-122,2,0,2
26546,SpokaneStBridge,01/11/2017 02:00:00 AM,48,-122,0,0,0
26547,SpokaneStBridge,01/11/2017 03:00:00 AM,48,-122,0,0,0
26548,SpokaneStBridge,01/11/2017 04:00:00 AM,48,-122,1,0,1
26549,SpokaneStBridge,01/11/2017 05:00:00 AM,48,-122,5,1,6
26550,SpokaneStBridge,01/11/2017 06:00:00 AM,48,-122,23,2,25
26551,SpokaneStBridge,01/11/2017 07:00:00 AM,48,-122,47,5,52
26552,SpokaneStBridge,01/11/2017 08:00:00 AM,48,-122,51,5,56
26553,SpokaneStBridge,01/11/2017 09:00:00 AM,48,-122,42,1,43
26554,SpokaneStBridge,01/11/2017 10:00:00 AM,48,-122,11,2,13
26555,SpokaneStBridge,01/11/2017 11:00:00 AM,48,-122,8,2,10
26556,SpokaneStBridge,01/11/2017 12:00:00 PM,48,-122,4,7,11
26557,SpokaneStBridge,01/11/2017 01:00:00 PM,48,-122,3,1,4
26558,SpokaneStBridge,01/11/2017 02:00:00 PM,48,-122,7,5,12
26559,SpokaneStBridge,01/11/2017 03:00:00 PM,48,-122,5,14,19
26560,SpokaneStBridge,01/11/2017 04:00:00 PM,48,-122,6,20,26
26561,SpokaneStBridge,01/11/2017 05:00:00 PM,48,-122,15,66,81
26562,SpokaneStBridge,01/11/2017 06:00:00 PM,48,-122,6,37,43
26563,SpokaneStBridge,01/11/2017 07:00:00 PM,48,-122,4,13,17
26564,SpokaneStBridge,01/11/2017 08:00:00 PM,48,-122,2,10,12
26565,SpokaneStBridge,01/11/2017 09:00:00 PM,48,-122,2,6,8
26566,SpokaneStBridge,01/11/2017 10:00:00 PM,48,-122,0,3,3
26567,SpokaneStBridge,01/11/2017 11:00:00 PM,48,-122,0,2,2
26568,SpokaneStBridge,01/12/2017 12:00:00 AM,48,-122,1,1,2
26569,SpokaneStBridge,01/12/2017 01:00:00 AM,48,-122,0,1,1
26570,SpokaneStBridge,01/12/2017 02:00:00 AM,48,-122,0,0,0
26571,SpokaneStBridge,01/12/2017 03:00:00 AM,48,-122,1,1,2
26572,SpokaneStBridge,01/12/2017 04:00:00 AM,48,-122,1,0,1
26573,SpokaneStBridge,01/12/2017 05:00:00 AM,48,-122,9,1,10
26574,SpokaneStBridge,01/12/2017 06:00:00 AM,48,-122,21,6,27
26575,SpokaneStBridge,01/12/2017 07:00:00 AM,48,-122,47,4,51
26576,SpokaneStBridge,01/12/2017 08:00:00 AM,48,-122,59,5,64
26577,SpokaneStBridge,01/12/2017 09:00:00 AM,48,-122,31,0,31
26578,SpokaneStBridge,01/12/2017 10:00:00 AM,48,-122,14,2,16
26579,SpokaneStBridge,01/12/2017 11:00:00 AM,48,-122,8,5,13
26580,SpokaneStBridge,01/12/2017 12:00:00 PM,48,-122,11,5,16
26581,SpokaneStBridge,01/12/2017 01:00:00 PM,48,-122,6,3,9
26582,SpokaneStBridge,01/12/2017 02:00:00 PM,48,-122,7,6,13
26583,SpokaneStBridge,01/12/2017 03:00:00 PM,48,-122,6,10,16
26584,SpokaneStBridge,01/12/2017 04:00:00 PM,48,-122,23,31,54
26585,SpokaneStBridge,01/12/2017 05:00:00 PM,48,-122,25,56,81
26586,SpokaneStBridge,01/12/2017 06:00:00 PM,48,-122,7,45,52
26587,SpokaneStBridge,01/12/2017 07:00:00 PM,48,-122,5,24,29
26588,SpokaneStBridge,01/12/2017 08:00:00 PM,48,-122,1,5,6
26589,SpokaneStBridge,01/12/2017 09:00:00 PM,48,-122,1,5,6
26590,SpokaneStBridge,01/12/2017 10:00:00 PM,48,-122,0,4,4
26591,SpokaneStBridge,01/12/2017 11:00:00 PM,48,-122,2,0,2
26592,SpokaneStBridge,01/13/2017 12:00:00 AM,48,-122,0,1,1
26593,SpokaneStBridge,01/13/2017 01:00:00 AM,48,-122,1,0,1
26594,SpokaneStBridge,01/13/2017 02:00:00 AM,48,-122,1,1,2
26595,SpokaneStBridge,01/13/2017 03:00:00 AM,48,-122,2,0,2
26596,SpokaneStBridge,01/13/2017 04:00:00 AM,48,-122,2,0,2
26597,SpokaneStBridge,01/13/2017 05:00:00 AM,48,-122,5,3,8
26598,SpokaneStBridge,01/13/2017 06:00:00 AM,48,-122,22,3,25
26599,SpokaneStBridge,01/13/2017 07:00:00 AM,48,-122,28,6,34
26600,SpokaneStBridge,01/13/2017 08:00:00 AM,48,-122,52,3,55
26601,SpokaneStBridge,01/13/2017 09:00:00 AM,48,-122,16,3,19
26602,SpokaneStBridge,01/13/2017 10:00:00 AM,48,-122,13,2,15
26603,SpokaneStBridge,01/13/2017 11:00:00 AM,48,-122,6,3,9
26604,SpokaneStBridge,01/13/2017 12:00:00 PM,48,-122,6,8,14
26605,SpokaneStBridge,01/13/2017 01:00:00 PM,48,-122,9,4,13
26606,SpokaneStBridge,01/13/2017 02:00:00 PM,48,-122,3,3,6
26607,SpokaneStBridge,01/13/2017 03:00:00 PM,48,-122,7,11,18
26608,SpokaneStBridge,01/13/2017 04:00:00 PM,48,-122,5,33,38
26609,SpokaneStBridge,01/13/2017 05:00:00 PM,48,-122,4,43,47
26610,SpokaneStBridge,01/13/2017 06:00:00 PM,48,-122,4,27,31
26611,SpokaneStBridge,01/13/2017 07:00:00 PM,48,-122,3,10,13
26612,SpokaneStBridge,01/13/2017 08:00:00 PM,48,-122,1,4,5
26613,SpokaneStBridge,01/13/2017 09:00:00 PM,48,-122,1,3,4
26614,SpokaneStBridge,01/13/2017 10:00:00 PM,48,-122,2,2,4
26615,SpokaneStBridge,01/13/2017 11:00:00 PM,48,-122,2,1,3
26616,SpokaneStBridge,01/14/2017 12:00:00 AM,48,-122,0,0,0
26617,SpokaneStBridge,01/14/2017 01:00:00 AM,48,-122,0,0,0
26618,SpokaneStBridge,01/14/2017 02:00:00 AM,48,-122,0,0,0
26619,SpokaneStBridge,01/14/2017 03:00:00 AM,48,-122,0,0,0
26620,SpokaneStBridge,01/14/2017 04:00:00 AM,48,-122,1,0,1
26621,SpokaneStBridge,01/14/2017 05:00:00 AM,48,-122,3,1,4
26622,SpokaneStBridge,01/14/2017 06:00:00 AM,48,-122,3,0,3
26623,SpokaneStBridge,01/14/2017 07:00:00 AM,48,-122,2,1,3
26624,SpokaneStBridge,01/14/2017 08:00:00 AM,48,-122,4,12,16
26625,SpokaneStBridge,01/14/2017 09:00:00 AM,48,-122,3,5,8
26626,SpokaneStBridge,01/14/2017 10:00:00 AM,48,-122,21,14,35
26627,SpokaneStBridge,01/14/2017 11:00:00 AM,48,-122,14,6,20
26628,SpokaneStBridge,01/14/2017 12:00:00 PM,48,-122,19,17,36
26629,SpokaneStBridge,01/14/2017 01:00:00 PM,48,-122,14,25,39
26630,SpokaneStBridge,01/14/2017 02:00:00 PM,48,-122,7,15,22
26631,SpokaneStBridge,01/14/2017 03:00:00 PM,48,-122,12,7,19
26632,SpokaneStBridge,01/14/2017 04:00:00 PM,48,-122,7,9,16
26633,SpokaneStBridge,01/14/2017 05:00:00 PM,48,-122,9,4,13
26634,SpokaneStBridge,01/14/2017 06:00:00 PM,48,-122,0,5,5
26635,SpokaneStBridge,01/14/2017 07:00:00 PM,48,-122,1,1,2
26636,SpokaneStBridge,01/14/2017 08:00:00 PM,48,-122,0,3,3
26637,SpokaneStBridge,01/14/2017 09:00:00 PM,48,-122,0,2,2
26638,SpokaneStBridge,01/14/2017 10:00:00 PM,48,-122,2,0,2
26639,SpokaneStBridge,01/14/2017 11:00:00 PM,48,-122,2,0,2
26640,SpokaneStBridge,01/15/2017 12:00:00 AM,48,-122,0,0,0
26641,SpokaneStBridge,01/15/2017 01:00:00 AM,48,-122,3,0,3
26642,SpokaneStBridge,01/15/2017 02:00:00 AM,48,-122,0,1,1
26643,SpokaneStBridge,01/15/2017 03:00:00 AM,48,-122,1,0,1
26644,SpokaneStBridge,01/15/2017 04:00:00 AM,48,-122,0,1,1
26645,SpokaneStBridge,01/15/2017 05:00:00 AM,48,-122,3,1,4
26646,SpokaneStBridge,01/15/2017 06:00:00 AM,48,-122,2,0,2
26647,SpokaneStBridge,01/15/2017 07:00:00 AM,48,-122,2,0,2
26648,SpokaneStBridge,01/15/2017 08:00:00 AM,48,-122,3,3,6
26649,SpokaneStBridge,01/15/2017 09:00:00 AM,48,-122,2,24,26
26650,SpokaneStBridge,01/15/2017 10:00:00 AM,48,-122,11,5,16
26651,SpokaneStBridge,01/15/2017 11:00:00 AM,48,-122,12,7,19
26652,SpokaneStBridge,01/15/2017 12:00:00 PM,48,-122,16,10,26
26653,SpokaneStBridge,01/15/2017 01:00:00 PM,48,-122,21,27,48
26654,SpokaneStBridge,01/15/2017 02:00:00 PM,48,-122,24,20,44
26655,SpokaneStBridge,01/15/2017 03:00:00 PM,48,-122,14,17,31
26656,SpokaneStBridge,01/15/2017 04:00:00 PM,48,-122,7,13,20
26657,SpokaneStBridge,01/15/2017 05:00:00 PM,48,-122,5,6,11
26658,SpokaneStBridge,01/15/2017 06:00:00 PM,48,-122,1,0,1
26659,SpokaneStBridge,01/15/2017 07:00:00 PM,48,-122,2,4,6
26660,SpokaneStBridge,01/15/2017 08:00:00 PM,48,-122,2,1,3
26661,SpokaneStBridge,01/15/2017 09:00:00 PM,48,-122,0,2,2
26662,SpokaneStBridge,01/15/2017 10:00:00 PM,48,-122,2,1,3
26663,SpokaneStBridge,01/15/2017 11:00:00 PM,48,-122,0,1,1
26664,SpokaneStBridge,01/16/2017 12:00:00 AM,48,-122,0,1,1
26665,SpokaneStBridge,01/16/2017 01:00:00 AM,48,-122,0,1,1
26666,SpokaneStBridge,01/16/2017 02:00:00 AM,48,-122,0,0,0
26667,SpokaneStBridge,01/16/2017 03:00:00 AM,48,-122,0,0,0
26668,SpokaneStBridge,01/16/2017 04:00:00 AM,48,-122,3,0,3
26669,SpokaneStBridge,01/16/2017 05:00:00 AM,48,-122,8,2,10
26670,SpokaneStBridge,01/16/2017 06:00:00 AM,48,-122,14,4,18
26671,SpokaneStBridge,01/16/2017 07:00:00 AM,48,-122,29,5,34
26672,SpokaneStBridge,01/16/2017 08:00:00 AM,48,-122,42,4,46
26673,SpokaneStBridge,01/16/2017 09:00:00 AM,48,-122,17,5,22
26674,SpokaneStBridge,01/16/2017 10:00:00 AM,48,-122,17,3,20
26675,SpokaneStBridge,01/16/2017 11:00:00 AM,48,-122,6,6,12
26676,SpokaneStBridge,01/16/2017 12:00:00 PM,48,-122,7,8,15
26677,SpokaneStBridge,01/16/2017 01:00:00 PM,48,-122,8,8,16
26678,SpokaneStBridge,01/16/2017 02:00:00 PM,48,-122,12,10,22
26679,SpokaneStBridge,01/16/2017 03:00:00 PM,48,-122,12,13,25
26680,SpokaneStBridge,01/16/2017 04:00:00 PM,48,-122,14,25,39
26681,SpokaneStBridge,01/16/2017 05:00:00 PM,48,-122,5,43,48
26682,SpokaneStBridge,01/16/2017 06:00:00 PM,48,-122,12,24,36
26683,SpokaneStBridge,01/16/2017 07:00:00 PM,48,-122,0,6,6
26684,SpokaneStBridge,01/16/2017 08:00:00 PM,48,-122,1,6,7
26685,SpokaneStBridge,01/16/2017 09:00:00 PM,48,-122,3,3,6
26686,SpokaneStBridge,01/16/2017 10:00:00 PM,48,-122,0,1,1
26687,SpokaneStBridge,01/16/2017 11:00:00 PM,48,-122,1,1,2
26688,SpokaneStBridge,01/17/2017 12:00:00 AM,48,-122,0,0,0
26689,SpokaneStBridge,01/17/2017 01:00:00 AM,48,-122,0,0,0
26690,SpokaneStBridge,01/17/2017 02:00:00 AM,48,-122,1,0,1
26691,SpokaneStBridge,01/17/2017 03:00:00 AM,48,-122,0,1,1
26692,SpokaneStBridge,01/17/2017 04:00:00 AM,48,-122,3,1,4
26693,SpokaneStBridge,01/17/2017 05:00:00 AM,48,-122,14,1,15
26694,SpokaneStBridge,01/17/2017 06:00:00 AM,48,-122,24,5,29
26695,SpokaneStBridge,01/17/2017 07:00:00 AM,48,-122,55,7,62
26696,SpokaneStBridge,01/17/2017 08:00:00 AM,48,-122,74,6,80
26697,SpokaneStBridge,01/17/2017 09:00:00 AM,48,-122,39,5,44
26698,SpokaneStBridge,01/17/2017 10:00:00 AM,48,-122,8,1,9
26699,SpokaneStBridge,01/17/2017 11:00:00 AM,48,-122,3,1,4
26700,SpokaneStBridge,01/17/2017 12:00:00 PM,48,-122,16,1,17
26701,SpokaneStBridge,01/17/2017 01:00:00 PM,48,-122,27,22,49
26702,SpokaneStBridge,01/17/2017 02:00:00 PM,48,-122,61,16,77
26703,SpokaneStBridge,01/17/2017 03:00:00 PM,48,-122,3,10,13
26704,SpokaneStBridge,01/17/2017 04:00:00 PM,48,-122,4,35,39
26705,SpokaneStBridge,01/17/2017 05:00:00 PM,48,-122,9,63,72
26706,SpokaneStBridge,01/17/2017 06:00:00 PM,48,-122,5,45,50
26707,SpokaneStBridge,01/17/2017 07:00:00 PM,48,-122,0,13,13
26708,SpokaneStBridge,01/17/2017 08:00:00 PM,48,-122,2,4,6
26709,SpokaneStBridge,01/17/2017 09:00:00 PM,48,-122,1,2,3
26710,SpokaneStBridge,01/17/2017 10:00:00 PM,48,-122,0,0,0
26711,SpokaneStBridge,01/17/2017 11:00:00 PM,48,-122,1,1,2
26712,SpokaneStBridge,01/18/2017 12:00:00 AM,48,-122,0,2,2
26713,SpokaneStBridge,01/18/2017 01:00:00 AM,48,-122,1,2,3
26714,SpokaneStBridge,01/18/2017 02:00:00 AM,48,-122,0,0,0
26715,SpokaneStBridge,01/18/2017 03:00:00 AM,48,-122,0,1,1
26716,SpokaneStBridge,01/18/2017 04:00:00 AM,48,-122,1,0,1
26717,SpokaneStBridge,01/18/2017 05:00:00 AM,48,-122,5,1,6
26718,SpokaneStBridge,01/18/2017 06:00:00 AM,48,-122,21,2,23
26719,SpokaneStBridge,01/18/2017 07:00:00 AM,48,-122,36,6,42
26720,SpokaneStBridge,01/18/2017 08:00:00 AM,48,-122,39,4,43
26721,SpokaneStBridge,01/18/2017 09:00:00 AM,48,-122,28,3,31
26722,SpokaneStBridge,01/18/2017 10:00:00 AM,48,-122,12,1,13
26723,SpokaneStBridge,01/18/2017 11:00:00 AM,48,-122,2,2,4
26724,SpokaneStBridge,01/18/2017 12:00:00 PM,48,-122,3,2,5
26725,SpokaneStBridge,01/18/2017 01:00:00 PM,48,-122,2,2,4
26726,SpokaneStBridge,01/18/2017 02:00:00 PM,48,-122,2,2,4
26727,SpokaneStBridge,01/18/2017 03:00:00 PM,48,-122,0,6,6
26728,SpokaneStBridge,01/18/2017 04:00:00 PM,48,-122,6,27,33
26729,SpokaneStBridge,01/18/2017 05:00:00 PM,48,-122,8,47,55
26730,SpokaneStBridge,01/18/2017 06:00:00 PM,48,-122,1,31,32
26731,SpokaneStBridge,01/18/2017 07:00:00 PM,48,-122,3,12,15
26732,SpokaneStBridge,01/18/2017 08:00:00 PM,48,-122,0,7,7
26733,SpokaneStBridge,01/18/2017 09:00:00 PM,48,-122,1,7,8
26734,SpokaneStBridge,01/18/2017 10:00:00 PM,48,-122,0,1,1
26735,SpokaneStBridge,01/18/2017 11:00:00 PM,48,-122,2,1,3
26736,SpokaneStBridge,01/19/2017 12:00:00 AM,48,-122,1,1,2
26737,SpokaneStBridge,01/19/2017 01:00:00 AM,48,-122,0,2,2
26738,SpokaneStBridge,01/19/2017 02:00:00 AM,48,-122,0,0,0
26739,SpokaneStBridge,01/19/2017 03:00:00 AM,48,-122,0,0,0
26740,SpokaneStBridge,01/19/2017 04:00:00 AM,48,-122,2,1,3
26741,SpokaneStBridge,01/19/2017 05:00:00 AM,48,-122,7,2,9
26742,SpokaneStBridge,01/19/2017 06:00:00 AM,48,-122,22,6,28
26743,SpokaneStBridge,01/19/2017 07:00:00 AM,48,-122,54,3,57
26744,SpokaneStBridge,01/19/2017 08:00:00 AM,48,-122,85,6,91
26745,SpokaneStBridge,01/19/2017 09:00:00 AM,48,-122,30,3,33
26746,SpokaneStBridge,01/19/2017 10:00:00 AM,48,-122,11,4,15
26747,SpokaneStBridge,01/19/2017 11:00:00 AM,48,-122,4,0,4
26748,SpokaneStBridge,01/19/2017 12:00:00 PM,48,-122,3,2,5
26749,SpokaneStBridge,01/19/2017 01:00:00 PM,48,-122,3,5,8
26750,SpokaneStBridge,01/19/2017 02:00:00 PM,48,-122,2,3,5
26751,SpokaneStBridge,01/19/2017 03:00:00 PM,48,-122,5,15,20
26752,SpokaneStBridge,01/19/2017 04:00:00 PM,48,-122,7,32,39
26753,SpokaneStBridge,01/19/2017 05:00:00 PM,48,-122,7,79,86
26754,SpokaneStBridge,01/19/2017 06:00:00 PM,48,-122,10,48,58
26755,SpokaneStBridge,01/19/2017 07:00:00 PM,48,-122,7,28,35
26756,SpokaneStBridge,01/19/2017 08:00:00 PM,48,-122,0,3,3
26757,SpokaneStBridge,01/19/2017 09:00:00 PM,48,-122,3,6,9
26758,SpokaneStBridge,01/19/2017 10:00:00 PM,48,-122,13,3,16
26759,SpokaneStBridge,01/19/2017 11:00:00 PM,48,-122,1,0,1
26760,SpokaneStBridge,01/20/2017 12:00:00 AM,48,-122,0,0,0
26761,SpokaneStBridge,01/20/2017 01:00:00 AM,48,-122,2,1,3
26762,SpokaneStBridge,01/20/2017 02:00:00 AM,48,-122,0,1,1
26763,SpokaneStBridge,01/20/2017 03:00:00 AM,48,-122,0,0,0
26764,SpokaneStBridge,01/20/2017 04:00:00 AM,48,-122,1,0,1
26765,SpokaneStBridge,01/20/2017 05:00:00 AM,48,-122,9,5,14
26766,SpokaneStBridge,01/20/2017 06:00:00 AM,48,-122,23,2,25
26767,SpokaneStBridge,01/20/2017 07:00:00 AM,48,-122,51,5,56
26768,SpokaneStBridge,01/20/2017 08:00:00 AM,48,-122,89,5,94
26769,SpokaneStBridge,01/20/2017 09:00:00 AM,48,-122,32,2,34
26770,SpokaneStBridge,01/20/2017 10:00:00 AM,48,-122,11,10,21
26771,SpokaneStBridge,01/20/2017 11:00:00 AM,48,-122,8,5,13
26772,SpokaneStBridge,01/20/2017 12:00:00 PM,48,-122,5,9,14
26773,SpokaneStBridge,01/20/2017 01:00:00 PM,48,-122,7,14,21
26774,SpokaneStBridge,01/20/2017 02:00:00 PM,48,-122,8,11,19
26775,SpokaneStBridge,01/20/2017 03:00:00 PM,48,-122,11,24,35
26776,SpokaneStBridge,01/20/2017 04:00:00 PM,48,-122,9,40,49
26777,SpokaneStBridge,01/20/2017 05:00:00 PM,48,-122,6,70,76
26778,SpokaneStBridge,01/20/2017 06:00:00 PM,48,-122,7,40,47
26779,SpokaneStBridge,01/20/2017 07:00:00 PM,48,-122,5,13,18
26780,SpokaneStBridge,01/20/2017 08:00:00 PM,48,-122,1,7,8
26781,SpokaneStBridge,01/20/2017 09:00:00 PM,48,-122,2,3,5
26782,SpokaneStBridge,01/20/2017 10:00:00 PM,48,-122,0,1,1
26783,SpokaneStBridge,01/20/2017 11:00:00 PM,48,-122,1,1,2
26784,SpokaneStBridge,01/21/2017 12:00:00 AM,48,-122,0,1,1
26785,SpokaneStBridge,01/21/2017 01:00:00 AM,48,-122,2,2,4
26786,SpokaneStBridge,01/21/2017 02:00:00 AM,48,-122,0,0,0
26787,SpokaneStBridge,01/21/2017 03:00:00 AM,48,-122,1,0,1
26788,SpokaneStBridge,01/21/2017 04:00:00 AM,48,-122,0,1,1
26789,SpokaneStBridge,01/21/2017 05:00:00 AM,48,-122,3,1,4
26790,SpokaneStBridge,01/21/2017 06:00:00 AM,48,-122,2,1,3
26791,SpokaneStBridge,01/21/2017 07:00:00 AM,48,-122,3,0,3
26792,SpokaneStBridge,01/21/2017 08:00:00 AM,48,-122,12,3,15
26793,SpokaneStBridge,01/21/2017 09:00:00 AM,48,-122,20,4,24
26794,SpokaneStBridge,01/21/2017 10:00:00 AM,48,-122,8,4,12
26795,SpokaneStBridge,01/21/2017 11:00:00 AM,48,-122,17,10,27
26796,SpokaneStBridge,01/21/2017 12:00:00 PM,48,-122,23,20,43
26797,SpokaneStBridge,01/21/2017 01:00:00 PM,48,-122,10,16,26
26798,SpokaneStBridge,01/21/2017 02:00:00 PM,48,-122,10,18,28
26799,SpokaneStBridge,01/21/2017 03:00:00 PM,48,-122,6,26,32
26800,SpokaneStBridge,01/21/2017 04:00:00 PM,48,-122,9,16,25
26801,SpokaneStBridge,01/21/2017 05:00:00 PM,48,-122,6,11,17
26802,SpokaneStBridge,01/21/2017 06:00:00 PM,48,-122,1,4,5
26803,SpokaneStBridge,01/21/2017 07:00:00 PM,48,-122,0,1,1
26804,SpokaneStBridge,01/21/2017 08:00:00 PM,48,-122,1,1,2
26805,SpokaneStBridge,01/21/2017 09:00:00 PM,48,-122,1,0,1
26806,SpokaneStBridge,01/21/2017 10:00:00 PM,48,-122,1,2,3
26807,SpokaneStBridge,01/21/2017 11:00:00 PM,48,-122,1,2,3
26808,SpokaneStBridge,01/22/2017 12:00:00 AM,48,-122,0,0,0
26809,SpokaneStBridge,01/22/2017 01:00:00 AM,48,-122,1,0,1
26810,SpokaneStBridge,01/22/2017 02:00:00 AM,48,-122,0,2,2
26811,SpokaneStBridge,01/22/2017 03:00:00 AM,48,-122,1,1,2
26812,SpokaneStBridge,01/22/2017 04:00:00 AM,48,-122,0,0,0
26813,SpokaneStBridge,01/22/2017 05:00:00 AM,48,-122,2,2,4
26814,SpokaneStBridge,01/22/2017 06:00:00 AM,48,-122,1,1,2
26815,SpokaneStBridge,01/22/2017 07:00:00 AM,48,-122,1,1,2
26816,SpokaneStBridge,01/22/2017 08:00:00 AM,48,-122,9,2,11
26817,SpokaneStBridge,01/22/2017 09:00:00 AM,48,-122,2,14,16
26818,SpokaneStBridge,01/22/2017 10:00:00 AM,48,-122,2,6,8
26819,SpokaneStBridge,01/22/2017 11:00:00 AM,48,-122,7,4,11
26820,SpokaneStBridge,01/22/2017 12:00:00 PM,48,-122,4,1,5
26821,SpokaneStBridge,01/22/2017 01:00:00 PM,48,-122,8,5,13
26822,SpokaneStBridge,01/22/2017 02:00:00 PM,48,-122,7,10,17
26823,SpokaneStBridge,01/22/2017 03:00:00 PM,48,-122,7,12,19
26824,SpokaneStBridge,01/22/2017 04:00:00 PM,48,-122,14,6,20
26825,SpokaneStBridge,01/22/2017 05:00:00 PM,48,-122,4,3,7
26826,SpokaneStBridge,01/22/2017 06:00:00 PM,48,-122,3,1,4
26827,SpokaneStBridge,01/22/2017 07:00:00 PM,48,-122,0,1,1
26828,SpokaneStBridge,01/22/2017 08:00:00 PM,48,-122,1,2,3
26829,SpokaneStBridge,01/22/2017 09:00:00 PM,48,-122,0,0,0
26830,SpokaneStBridge,01/22/2017 10:00:00 PM,48,-122,1,0,1
26831,SpokaneStBridge,01/22/2017 11:00:00 PM,48,-122,0,1,1
26832,SpokaneStBridge,01/23/2017 12:00:00 AM,48,-122,0,1,1
26833,SpokaneStBridge,01/23/2017 01:00:00 AM,48,-122,3,0,3
26834,SpokaneStBridge,01/23/2017 02:00:00 AM,48,-122,0,1,1
26835,SpokaneStBridge,01/23/2017 03:00:00 AM,48,-122,0,1,1
26836,SpokaneStBridge,01/23/2017 04:00:00 AM,48,-122,4,0,4
26837,SpokaneStBridge,01/23/2017 05:00:00 AM,48,-122,15,1,16
26838,SpokaneStBridge,01/23/2017 06:00:00 AM,48,-122,43,5,48
26839,SpokaneStBridge,01/23/2017 07:00:00 AM,48,-122,79,3,82
26840,SpokaneStBridge,01/23/2017 08:00:00 AM,48,-122,81,7,88
26841,SpokaneStBridge,01/23/2017 09:00:00 AM,48,-122,38,1,39
26842,SpokaneStBridge,01/23/2017 10:00:00 AM,48,-122,14,5,19
26843,SpokaneStBridge,01/23/2017 11:00:00 AM,48,-122,5,4,9
26844,SpokaneStBridge,01/23/2017 12:00:00 PM,48,-122,7,7,14
26845,SpokaneStBridge,01/23/2017 01:00:00 PM,48,-122,6,7,13
26846,SpokaneStBridge,01/23/2017 02:00:00 PM,48,-122,7,9,16
26847,SpokaneStBridge,01/23/2017 03:00:00 PM,48,-122,10,18,28
26848,SpokaneStBridge,01/23/2017 04:00:00 PM,48,-122,8,62,70
26849,SpokaneStBridge,01/23/2017 05:00:00 PM,48,-122,9,91,100
26850,SpokaneStBridge,01/23/2017 06:00:00 PM,48,-122,5,65,70
26851,SpokaneStBridge,01/23/2017 07:00:00 PM,48,-122,4,19,23
26852,SpokaneStBridge,01/23/2017 08:00:00 PM,48,-122,0,8,8
26853,SpokaneStBridge,01/23/2017 09:00:00 PM,48,-122,2,1,3
26854,SpokaneStBridge,01/23/2017 10:00:00 PM,48,-122,0,2,2
26855,SpokaneStBridge,01/23/2017 11:00:00 PM,48,-122,0,0,0
26856,SpokaneStBridge,01/24/2017 12:00:00 AM,48,-122,1,0,1
26857,SpokaneStBridge,01/24/2017 01:00:00 AM,48,-122,0,1,1
26858,SpokaneStBridge,01/24/2017 02:00:00 AM,48,-122,0,0,0
26859,SpokaneStBridge,01/24/2017 03:00:00 AM,48,-122,3,0,3
26860,SpokaneStBridge,01/24/2017 04:00:00 AM,48,-122,1,2,3
26861,SpokaneStBridge,01/24/2017 05:00:00 AM,48,-122,12,1,13
26862,SpokaneStBridge,01/24/2017 06:00:00 AM,48,-122,41,4,45
26863,SpokaneStBridge,01/24/2017 07:00:00 AM,48,-122,77,7,84
26864,SpokaneStBridge,01/24/2017 08:00:00 AM,48,-122,86,4,90
26865,SpokaneStBridge,01/24/2017 09:00:00 AM,48,-122,40,3,43
26866,SpokaneStBridge,01/24/2017 10:00:00 AM,48,-122,7,2,9
26867,SpokaneStBridge,01/24/2017 11:00:00 AM,48,-122,11,5,16
26868,SpokaneStBridge,01/24/2017 12:00:00 PM,48,-122,8,5,13
26869,SpokaneStBridge,01/24/2017 01:00:00 PM,48,-122,8,11,19
26870,SpokaneStBridge,01/24/2017 02:00:00 PM,48,-122,10,6,16
26871,SpokaneStBridge,01/24/2017 03:00:00 PM,48,-122,14,18,32
26872,SpokaneStBridge,01/24/2017 04:00:00 PM,48,-122,18,54,72
26873,SpokaneStBridge,01/24/2017 05:00:00 PM,48,-122,15,103,118
26874,SpokaneStBridge,01/24/2017 06:00:00 PM,48,-122,8,52,60
26875,SpokaneStBridge,01/24/2017 07:00:00 PM,48,-122,4,22,26
26876,SpokaneStBridge,01/24/2017 08:00:00 PM,48,-122,1,9,10
26877,SpokaneStBridge,01/24/2017 09:00:00 PM,48,-122,3,4,7
26878,SpokaneStBridge,01/24/2017 10:00:00 PM,48,-122,0,4,4
26879,SpokaneStBridge,01/24/2017 11:00:00 PM,48,-122,0,3,3
26880,SpokaneStBridge,01/25/2017 12:00:00 AM,48,-122,1,2,3
26881,SpokaneStBridge,01/25/2017 01:00:00 AM,48,-122,0,1,1
26882,SpokaneStBridge,01/25/2017 02:00:00 AM,48,-122,0,1,1
26883,SpokaneStBridge,01/25/2017 03:00:00 AM,48,-122,2,1,3
26884,SpokaneStBridge,01/25/2017 04:00:00 AM,48,-122,2,1,3
26885,SpokaneStBridge,01/25/2017 05:00:00 AM,48,-122,11,2,13
26886,SpokaneStBridge,01/25/2017 06:00:00 AM,48,-122,32,8,40
26887,SpokaneStBridge,01/25/2017 07:00:00 AM,48,-122,71,5,76
26888,SpokaneStBridge,01/25/2017 08:00:00 AM,48,-122,78,6,84
26889,SpokaneStBridge,01/25/2017 09:00:00 AM,48,-122,42,4,46
26890,SpokaneStBridge,01/25/2017 10:00:00 AM,48,-122,12,3,15
26891,SpokaneStBridge,01/25/2017 11:00:00 AM,48,-122,6,3,9
26892,SpokaneStBridge,01/25/2017 12:00:00 PM,48,-122,11,5,16
26893,SpokaneStBridge,01/25/2017 01:00:00 PM,48,-122,4,3,7
26894,SpokaneStBridge,01/25/2017 02:00:00 PM,48,-122,8,5,13
26895,SpokaneStBridge,01/25/2017 03:00:00 PM,48,-122,8,16,24
26896,SpokaneStBridge,01/25/2017 04:00:00 PM,48,-122,8,49,57
26897,SpokaneStBridge,01/25/2017 05:00:00 PM,48,-122,21,88,109
26898,SpokaneStBridge,01/25/2017 06:00:00 PM,48,-122,13,47,60
26899,SpokaneStBridge,01/25/2017 07:00:00 PM,48,-122,0,16,16
26900,SpokaneStBridge,01/25/2017 08:00:00 PM,48,-122,3,12,15
26901,SpokaneStBridge,01/25/2017 09:00:00 PM,48,-122,1,8,9
26902,SpokaneStBridge,01/25/2017 10:00:00 PM,48,-122,0,1,1
26903,SpokaneStBridge,01/25/2017 11:00:00 PM,48,-122,0,1,1
26904,SpokaneStBridge,01/26/2017 12:00:00 AM,48,-122,1,3,4
26905,SpokaneStBridge,01/26/2017 01:00:00 AM,48,-122,1,1,2
26906,SpokaneStBridge,01/26/2017 02:00:00 AM,48,-122,0,1,1
26907,SpokaneStBridge,01/26/2017 03:00:00 AM,48,-122,3,1,4
26908,SpokaneStBridge,01/26/2017 04:00:00 AM,48,-122,1,1,2
26909,SpokaneStBridge,01/26/2017 05:00:00 AM,48,-122,10,1,11
26910,SpokaneStBridge,01/26/2017 06:00:00 AM,48,-122,37,7,44
26911,SpokaneStBridge,01/26/2017 07:00:00 AM,48,-122,70,7,77
26912,SpokaneStBridge,01/26/2017 08:00:00 AM,48,-122,67,9,76
26913,SpokaneStBridge,01/26/2017 09:00:00 AM,48,-122,43,2,45
26914,SpokaneStBridge,01/26/2017 10:00:00 AM,48,-122,10,3,13
26915,SpokaneStBridge,01/26/2017 11:00:00 AM,48,-122,8,4,12
26916,SpokaneStBridge,01/26/2017 12:00:00 PM,48,-122,8,10,18
26917,SpokaneStBridge,01/26/2017 01:00:00 PM,48,-122,8,10,18
26918,SpokaneStBridge,01/26/2017 02:00:00 PM,48,-122,13,15,28
26919,SpokaneStBridge,01/26/2017 03:00:00 PM,48,-122,11,17,28
26920,SpokaneStBridge,01/26/2017 04:00:00 PM,48,-122,15,38,53
26921,SpokaneStBridge,01/26/2017 05:00:00 PM,48,-122,16,93,109
26922,SpokaneStBridge,01/26/2017 06:00:00 PM,48,-122,7,55,62
26923,SpokaneStBridge,01/26/2017 07:00:00 PM,48,-122,9,19,28
26924,SpokaneStBridge,01/26/2017 08:00:00 PM,48,-122,2,12,14
26925,SpokaneStBridge,01/26/2017 09:00:00 PM,48,-122,2,6,8
26926,SpokaneStBridge,01/26/2017 10:00:00 PM,48,-122,3,1,4
26927,SpokaneStBridge,01/26/2017 11:00:00 PM,48,-122,2,0,2
26928,SpokaneStBridge,01/27/2017 12:00:00 AM,48,-122,1,0,1
26929,SpokaneStBridge,01/27/2017 01:00:00 AM,48,-122,2,3,5
26930,SpokaneStBridge,01/27/2017 02:00:00 AM,48,-122,1,5,6
26931,SpokaneStBridge,01/27/2017 03:00:00 AM,48,-122,1,2,3
26932,SpokaneStBridge,01/27/2017 04:00:00 AM,48,-122,1,0,1
26933,SpokaneStBridge,01/27/2017 05:00:00 AM,48,-122,10,1,11
26934,SpokaneStBridge,01/27/2017 06:00:00 AM,48,-122,26,9,35
26935,SpokaneStBridge,01/27/2017 07:00:00 AM,48,-122,56,5,61
26936,SpokaneStBridge,01/27/2017 08:00:00 AM,48,-122,76,6,82
26937,SpokaneStBridge,01/27/2017 09:00:00 AM,48,-122,25,1,26
26938,SpokaneStBridge,01/27/2017 10:00:00 AM,48,-122,18,5,23
26939,SpokaneStBridge,01/27/2017 11:00:00 AM,48,-122,12,6,18
26940,SpokaneStBridge,01/27/2017 12:00:00 PM,48,-122,14,21,35
26941,SpokaneStBridge,01/27/2017 01:00:00 PM,48,-122,15,12,27
26942,SpokaneStBridge,01/27/2017 02:00:00 PM,48,-122,9,16,25
26943,SpokaneStBridge,01/27/2017 03:00:00 PM,48,-122,15,30,45
26944,SpokaneStBridge,01/27/2017 04:00:00 PM,48,-122,15,49,64
26945,SpokaneStBridge,01/27/2017 05:00:00 PM,48,-122,9,74,83
26946,SpokaneStBridge,01/27/2017 06:00:00 PM,48,-122,7,32,39
26947,SpokaneStBridge,01/27/2017 07:00:00 PM,48,-122,4,12,16
26948,SpokaneStBridge,01/27/2017 08:00:00 PM,48,-122,4,4,8
26949,SpokaneStBridge,01/27/2017 09:00:00 PM,48,-122,0,4,4
26950,SpokaneStBridge,01/27/2017 10:00:00 PM,48,-122,5,4,9
26951,SpokaneStBridge,01/27/2017 11:00:00 PM,48,-122,0,4,4
26952,SpokaneStBridge,01/28/2017 12:00:00 AM,48,-122,0,0,0
26953,SpokaneStBridge,01/28/2017 01:00:00 AM,48,-122,0,0,0
26954,SpokaneStBridge,01/28/2017 02:00:00 AM,48,-122,0,0,0
26955,SpokaneStBridge,01/28/2017 03:00:00 AM,48,-122,1,0,1
26956,SpokaneStBridge,01/28/2017 04:00:00 AM,48,-122,0,1,1
26957,SpokaneStBridge,01/28/2017 05:00:00 AM,48,-122,3,0,3
26958,SpokaneStBridge,01/28/2017 06:00:00 AM,48,-122,4,0,4
26959,SpokaneStBridge,01/28/2017 07:00:00 AM,48,-122,6,1,7
26960,SpokaneStBridge,01/28/2017 08:00:00 AM,48,-122,20,2,22
26961,SpokaneStBridge,01/28/2017 09:00:00 AM,48,-122,13,19,32
26962,SpokaneStBridge,01/28/2017 10:00:00 AM,48,-122,14,13,27
26963,SpokaneStBridge,01/28/2017 11:00:00 AM,48,-122,30,22,52
26964,SpokaneStBridge,01/28/2017 12:00:00 PM,48,-122,30,32,62
26965,SpokaneStBridge,01/28/2017 01:00:00 PM,48,-122,29,23,52
26966,SpokaneStBridge,01/28/2017 02:00:00 PM,48,-122,21,32,53
26967,SpokaneStBridge,01/28/2017 03:00:00 PM,48,-122,20,39,59
26968,SpokaneStBridge,01/28/2017 04:00:00 PM,48,-122,16,19,35
26969,SpokaneStBridge,01/28/2017 05:00:00 PM,48,-122,19,11,30
26970,SpokaneStBridge,01/28/2017 06:00:00 PM,48,-122,3,1,4
26971,SpokaneStBridge,01/28/2017 07:00:00 PM,48,-122,9,2,11
26972,SpokaneStBridge,01/28/2017 08:00:00 PM,48,-122,5,4,9
26973,SpokaneStBridge,01/28/2017 09:00:00 PM,48,-122,3,1,4
26974,SpokaneStBridge,01/28/2017 10:00:00 PM,48,-122,2,0,2
26975,SpokaneStBridge,01/28/2017 11:00:00 PM,48,-122,1,4,5
26976,SpokaneStBridge,01/29/2017 12:00:00 AM,48,-122,1,0,1
26977,SpokaneStBridge,01/29/2017 01:00:00 AM,48,-122,0,1,1
26978,SpokaneStBridge,01/29/2017 02:00:00 AM,48,-122,0,0,0
26979,SpokaneStBridge,01/29/2017 03:00:00 AM,48,-122,1,1,2
26980,SpokaneStBridge,01/29/2017 04:00:00 AM,48,-122,0,0,0
26981,SpokaneStBridge,01/29/2017 05:00:00 AM,48,-122,4,1,5
26982,SpokaneStBridge,01/29/2017 06:00:00 AM,48,-122,2,0,2
26983,SpokaneStBridge,01/29/2017 07:00:00 AM,48,-122,3,1,4
26984,SpokaneStBridge,01/29/2017 08:00:00 AM,48,-122,9,7,16
26985,SpokaneStBridge,01/29/2017 09:00:00 AM,48,-122,7,7,14
26986,SpokaneStBridge,01/29/2017 10:00:00 AM,48,-122,17,9,26
26987,SpokaneStBridge,01/29/2017 11:00:00 AM,48,-122,18,16,34
26988,SpokaneStBridge,01/29/2017 12:00:00 PM,48,-122,13,19,32
26989,SpokaneStBridge,01/29/2017 01:00:00 PM,48,-122,15,19,34
26990,SpokaneStBridge,01/29/2017 02:00:00 PM,48,-122,10,13,23
26991,SpokaneStBridge,01/29/2017 03:00:00 PM,48,-122,5,2,7
26992,SpokaneStBridge,01/29/2017 04:00:00 PM,48,-122,5,4,9
26993,SpokaneStBridge,01/29/2017 05:00:00 PM,48,-122,7,6,13
26994,SpokaneStBridge,01/29/2017 06:00:00 PM,48,-122,4,1,5
26995,SpokaneStBridge,01/29/2017 07:00:00 PM,48,-122,0,7,7
26996,SpokaneStBridge,01/29/2017 08:00:00 PM,48,-122,1,7,8
26997,SpokaneStBridge,01/29/2017 09:00:00 PM,48,-122,0,3,3
26998,SpokaneStBridge,01/29/2017 10:00:00 PM,48,-122,2,0,2
26999,SpokaneStBridge,01/29/2017 11:00:00 PM,48,-122,1,1,2
27000,SpokaneStBridge,01/30/2017 12:00:00 AM,48,-122,2,0,2
27001,SpokaneStBridge,01/30/2017 01:00:00 AM,48,-122,0,0,0
27002,SpokaneStBridge,01/30/2017 02:00:00 AM,48,-122,1,0,1
27003,SpokaneStBridge,01/30/2017 03:00:00 AM,48,-122,0,0,0
27004,SpokaneStBridge,01/30/2017 04:00:00 AM,48,-122,6,0,6
27005,SpokaneStBridge,01/30/2017 05:00:00 AM,48,-122,15,0,15
27006,SpokaneStBridge,01/30/2017 06:00:00 AM,48,-122,38,7,45
27007,SpokaneStBridge,01/30/2017 07:00:00 AM,48,-122,80,11,91
27008,SpokaneStBridge,01/30/2017 08:00:00 AM,48,-122,82,8,90
27009,SpokaneStBridge,01/30/2017 09:00:00 AM,48,-122,36,3,39
27010,SpokaneStBridge,01/30/2017 10:00:00 AM,48,-122,15,4,19
27011,SpokaneStBridge,01/30/2017 11:00:00 AM,48,-122,5,5,10
27012,SpokaneStBridge,01/30/2017 12:00:00 PM,48,-122,8,5,13
27013,SpokaneStBridge,01/30/2017 01:00:00 PM,48,-122,8,5,13
27014,SpokaneStBridge,01/30/2017 02:00:00 PM,48,-122,8,6,14
27015,SpokaneStBridge,01/30/2017 03:00:00 PM,48,-122,11,24,35
27016,SpokaneStBridge,01/30/2017 04:00:00 PM,48,-122,17,53,70
27017,SpokaneStBridge,01/30/2017 05:00:00 PM,48,-122,17,86,103
27018,SpokaneStBridge,01/30/2017 06:00:00 PM,48,-122,4,64,68
27019,SpokaneStBridge,01/30/2017 07:00:00 PM,48,-122,2,25,27
27020,SpokaneStBridge,01/30/2017 08:00:00 PM,48,-122,1,8,9
27021,SpokaneStBridge,01/30/2017 09:00:00 PM,48,-122,0,1,1
27022,SpokaneStBridge,01/30/2017 10:00:00 PM,48,-122,2,3,5
27023,SpokaneStBridge,01/30/2017 11:00:00 PM,48,-122,0,2,2
27024,SpokaneStBridge,01/31/2017 12:00:00 AM,48,-122,0,0,0
27025,SpokaneStBridge,01/31/2017 01:00:00 AM,48,-122,0,0,0
27026,SpokaneStBridge,01/31/2017 02:00:00 AM,48,-122,0,0,0
27027,SpokaneStBridge,01/31/2017 03:00:00 AM,48,-122,1,0,1
27028,SpokaneStBridge,01/31/2017 04:00:00 AM,48,-122,1,1,2
27029,SpokaneStBridge,01/31/2017 05:00:00 AM,48,-122,15,4,19
27030,SpokaneStBridge,01/31/2017 06:00:00 AM,48,-122,41,4,45
27031,SpokaneStBridge,01/31/2017 07:00:00 AM,48,-122,80,5,85
27032,SpokaneStBridge,01/31/2017 08:00:00 AM,48,-122,90,5,95
27033,SpokaneStBridge,01/31/2017 09:00:00 AM,48,-122,34,0,34
27034,SpokaneStBridge,01/31/2017 10:00:00 AM,48,-122,10,2,12
27035,SpokaneStBridge,01/31/2017 11:00:00 AM,48,-122,10,5,15
27036,SpokaneStBridge,01/31/2017 12:00:00 PM,48,-122,7,10,17
27037,SpokaneStBridge,01/31/2017 01:00:00 PM,48,-122,13,11,24
27038,SpokaneStBridge,01/31/2017 02:00:00 PM,48,-122,15,9,24
27039,SpokaneStBridge,01/31/2017 03:00:00 PM,48,-122,12,15,27
27040,SpokaneStBridge,01/31/2017 04:00:00 PM,48,-122,17,57,74
27041,SpokaneStBridge,01/31/2017 05:00:00 PM,48,-122,15,101,116
27042,SpokaneStBridge,01/31/2017 06:00:00 PM,48,-122,8,42,50
27043,SpokaneStBridge,01/31/2017 07:00:00 PM,48,-122,1,18,19
27044,SpokaneStBridge,01/31/2017 08:00:00 PM,48,-122,2,8,10
27045,SpokaneStBridge,01/31/2017 09:00:00 PM,48,-122,0,7,7
27046,SpokaneStBridge,01/31/2017 10:00:00 PM,48,-122,0,4,4
27047,SpokaneStBridge,01/31/2017 11:00:00 PM,48,-122,0,3,3
27048,SpokaneStBridge,02/01/2017 12:00:00 AM,48,-122,2,4,6
27049,SpokaneStBridge,02/01/2017 01:00:00 AM,48,-122,0,0,0
27050,SpokaneStBridge,02/01/2017 02:00:00 AM,48,-122,0,0,0
27051,SpokaneStBridge,02/01/2017 03:00:00 AM,48,-122,1,0,1
27052,SpokaneStBridge,02/01/2017 04:00:00 AM,48,-122,2,1,3
27053,SpokaneStBridge,02/01/2017 05:00:00 AM,48,-122,8,1,9
27054,SpokaneStBridge,02/01/2017 06:00:00 AM,48,-122,28,8,36
27055,SpokaneStBridge,02/01/2017 07:00:00 AM,48,-122,67,6,73
27056,SpokaneStBridge,02/01/2017 08:00:00 AM,48,-122,90,4,94
27057,SpokaneStBridge,02/01/2017 09:00:00 AM,48,-122,39,4,43
27058,SpokaneStBridge,02/01/2017 10:00:00 AM,48,-122,16,3,19
27059,SpokaneStBridge,02/01/2017 11:00:00 AM,48,-122,9,10,19
27060,SpokaneStBridge,02/01/2017 12:00:00 PM,48,-122,17,8,25
27061,SpokaneStBridge,02/01/2017 01:00:00 PM,48,-122,10,15,25
27062,SpokaneStBridge,02/01/2017 02:00:00 PM,48,-122,13,15,28
27063,SpokaneStBridge,02/01/2017 03:00:00 PM,48,-122,4,25,29
27064,SpokaneStBridge,02/01/2017 04:00:00 PM,48,-122,8,40,48
27065,SpokaneStBridge,02/01/2017 05:00:00 PM,48,-122,10,83,93
27066,SpokaneStBridge,02/01/2017 06:00:00 PM,48,-122,9,46,55
27067,SpokaneStBridge,02/01/2017 07:00:00 PM,48,-122,5,19,24
27068,SpokaneStBridge,02/01/2017 08:00:00 PM,48,-122,10,12,22
27069,SpokaneStBridge,02/01/2017 09:00:00 PM,48,-122,0,7,7
27070,SpokaneStBridge,02/01/2017 10:00:00 PM,48,-122,1,1,2
27071,SpokaneStBridge,02/01/2017 11:00:00 PM,48,-122,1,2,3
27072,SpokaneStBridge,02/02/2017 12:00:00 AM,48,-122,2,2,4
27073,SpokaneStBridge,02/02/2017 01:00:00 AM,48,-122,0,0,0
27074,SpokaneStBridge,02/02/2017 02:00:00 AM,48,-122,0,0,0
27075,SpokaneStBridge,02/02/2017 03:00:00 AM,48,-122,0,0,0
27076,SpokaneStBridge,02/02/2017 04:00:00 AM,48,-122,1,1,2
27077,SpokaneStBridge,02/02/2017 05:00:00 AM,48,-122,9,1,10
27078,SpokaneStBridge,02/02/2017 06:00:00 AM,48,-122,29,9,38
27079,SpokaneStBridge,02/02/2017 07:00:00 AM,48,-122,63,12,75
27080,SpokaneStBridge,02/02/2017 08:00:00 AM,48,-122,78,7,85
27081,SpokaneStBridge,02/02/2017 09:00:00 AM,48,-122,25,0,25
27082,SpokaneStBridge,02/02/2017 10:00:00 AM,48,-122,8,2,10
27083,SpokaneStBridge,02/02/2017 11:00:00 AM,48,-122,8,3,11
27084,SpokaneStBridge,02/02/2017 12:00:00 PM,48,-122,8,4,12
27085,SpokaneStBridge,02/02/2017 01:00:00 PM,48,-122,9,7,16
27086,SpokaneStBridge,02/02/2017 02:00:00 PM,48,-122,6,6,12
27087,SpokaneStBridge,02/02/2017 03:00:00 PM,48,-122,12,18,30
27088,SpokaneStBridge,02/02/2017 04:00:00 PM,48,-122,17,41,58
27089,SpokaneStBridge,02/02/2017 05:00:00 PM,48,-122,12,75,87
27090,SpokaneStBridge,02/02/2017 06:00:00 PM,48,-122,10,57,67
27091,SpokaneStBridge,02/02/2017 07:00:00 PM,48,-122,9,18,27
27092,SpokaneStBridge,02/02/2017 08:00:00 PM,48,-122,0,8,8
27093,SpokaneStBridge,02/02/2017 09:00:00 PM,48,-122,1,8,9
27094,SpokaneStBridge,02/02/2017 10:00:00 PM,48,-122,2,2,4
27095,SpokaneStBridge,02/02/2017 11:00:00 PM,48,-122,0,1,1
27096,SpokaneStBridge,02/03/2017 12:00:00 AM,48,-122,0,0,0
27097,SpokaneStBridge,02/03/2017 01:00:00 AM,48,-122,1,0,1
27098,SpokaneStBridge,02/03/2017 02:00:00 AM,48,-122,1,1,2
27099,SpokaneStBridge,02/03/2017 03:00:00 AM,48,-122,1,2,3
27100,SpokaneStBridge,02/03/2017 04:00:00 AM,48,-122,1,0,1
27101,SpokaneStBridge,02/03/2017 05:00:00 AM,48,-122,5,1,6
27102,SpokaneStBridge,02/03/2017 06:00:00 AM,48,-122,13,5,18
27103,SpokaneStBridge,02/03/2017 07:00:00 AM,48,-122,24,4,28
27104,SpokaneStBridge,02/03/2017 08:00:00 AM,48,-122,37,3,40
27105,SpokaneStBridge,02/03/2017 09:00:00 AM,48,-122,16,3,19
27106,SpokaneStBridge,02/03/2017 10:00:00 AM,48,-122,7,1,8
27107,SpokaneStBridge,02/03/2017 11:00:00 AM,48,-122,2,2,4
27108,SpokaneStBridge,02/03/2017 12:00:00 PM,48,-122,4,2,6
27109,SpokaneStBridge,02/03/2017 01:00:00 PM,48,-122,1,0,1
27110,SpokaneStBridge,02/03/2017 02:00:00 PM,48,-122,2,5,7
27111,SpokaneStBridge,02/03/2017 03:00:00 PM,48,-122,2,14,16
27112,SpokaneStBridge,02/03/2017 04:00:00 PM,48,-122,6,22,28
27113,SpokaneStBridge,02/03/2017 05:00:00 PM,48,-122,3,35,38
27114,SpokaneStBridge,02/03/2017 06:00:00 PM,48,-122,6,29,35
27115,SpokaneStBridge,02/03/2017 07:00:00 PM,48,-122,1,4,5
27116,SpokaneStBridge,02/03/2017 08:00:00 PM,48,-122,0,5,5
27117,SpokaneStBridge,02/03/2017 09:00:00 PM,48,-122,1,1,2
27118,SpokaneStBridge,02/03/2017 10:00:00 PM,48,-122,1,0,1
27119,SpokaneStBridge,02/03/2017 11:00:00 PM,48,-122,0,3,3
27120,SpokaneStBridge,02/04/2017 12:00:00 AM,48,-122,2,2,4
27121,SpokaneStBridge,02/04/2017 01:00:00 AM,48,-122,3,1,4
27122,SpokaneStBridge,02/04/2017 02:00:00 AM,48,-122,0,1,1
27123,SpokaneStBridge,02/04/2017 03:00:00 AM,48,-122,0,0,0
27124,SpokaneStBridge,02/04/2017 04:00:00 AM,48,-122,0,0,0
27125,SpokaneStBridge,02/04/2017 05:00:00 AM,48,-122,2,0,2
27126,SpokaneStBridge,02/04/2017 06:00:00 AM,48,-122,3,1,4
27127,SpokaneStBridge,02/04/2017 07:00:00 AM,48,-122,4,0,4
27128,SpokaneStBridge,02/04/2017 08:00:00 AM,48,-122,5,3,8
27129,SpokaneStBridge,02/04/2017 09:00:00 AM,48,-122,3,3,6
27130,SpokaneStBridge,02/04/2017 10:00:00 AM,48,-122,4,3,7
27131,SpokaneStBridge,02/04/2017 11:00:00 AM,48,-122,4,2,6
27132,SpokaneStBridge,02/04/2017 12:00:00 PM,48,-122,2,4,6
27133,SpokaneStBridge,02/04/2017 01:00:00 PM,48,-122,5,4,9
27134,SpokaneStBridge,02/04/2017 02:00:00 PM,48,-122,2,3,5
27135,SpokaneStBridge,02/04/2017 03:00:00 PM,48,-122,1,3,4
27136,SpokaneStBridge,02/04/2017 04:00:00 PM,48,-122,1,5,6
27137,SpokaneStBridge,02/04/2017 05:00:00 PM,48,-122,5,3,8
27138,SpokaneStBridge,02/04/2017 06:00:00 PM,48,-122,0,2,2
27139,SpokaneStBridge,02/04/2017 07:00:00 PM,48,-122,1,1,2
27140,SpokaneStBridge,02/04/2017 08:00:00 PM,48,-122,1,0,1
27141,SpokaneStBridge,02/04/2017 09:00:00 PM,48,-122,0,0,0
27142,SpokaneStBridge,02/04/2017 10:00:00 PM,48,-122,0,3,3
27143,SpokaneStBridge,02/04/2017 11:00:00 PM,48,-122,0,3,3
27144,SpokaneStBridge,02/05/2017 12:00:00 AM,48,-122,2,0,2
27145,SpokaneStBridge,02/05/2017 01:00:00 AM,48,-122,2,1,3
27146,SpokaneStBridge,02/05/2017 02:00:00 AM,48,-122,2,1,3
27147,SpokaneStBridge,02/05/2017 03:00:00 AM,48,-122,0,0,0
27148,SpokaneStBridge,02/05/2017 04:00:00 AM,48,-122,0,1,1
27149,SpokaneStBridge,02/05/2017 05:00:00 AM,48,-122,2,2,4
27150,SpokaneStBridge,02/05/2017 06:00:00 AM,48,-122,0,0,0
27151,SpokaneStBridge,02/05/2017 07:00:00 AM,48,-122,2,0,2
27152,SpokaneStBridge,02/05/2017 08:00:00 AM,48,-122,7,0,7
27153,SpokaneStBridge,02/05/2017 09:00:00 AM,48,-122,3,3,6
27154,SpokaneStBridge,02/05/2017 10:00:00 AM,48,-122,6,5,11
27155,SpokaneStBridge,02/05/2017 11:00:00 AM,48,-122,2,3,5
27156,SpokaneStBridge,02/05/2017 12:00:00 PM,48,-122,3,2,5
27157,SpokaneStBridge,02/05/2017 01:00:00 PM,48,-122,2,3,5
27158,SpokaneStBridge,02/05/2017 02:00:00 PM,48,-122,2,3,5
27159,SpokaneStBridge,02/05/2017 03:00:00 PM,48,-122,1,3,4
27160,SpokaneStBridge,02/05/2017 04:00:00 PM,48,-122,0,1,1
27161,SpokaneStBridge,02/05/2017 05:00:00 PM,48,-122,1,1,2
27162,SpokaneStBridge,02/05/2017 06:00:00 PM,48,-122,1,2,3
27163,SpokaneStBridge,02/05/2017 07:00:00 PM,48,-122,1,0,1
27164,SpokaneStBridge,02/05/2017 08:00:00 PM,48,-122,0,1,1
27165,SpokaneStBridge,02/05/2017 09:00:00 PM,48,-122,0,1,1
27166,SpokaneStBridge,02/05/2017 10:00:00 PM,48,-122,1,0,1
27167,SpokaneStBridge,02/05/2017 11:00:00 PM,48,-122,0,0,0
27168,SpokaneStBridge,02/06/2017 12:00:00 AM,48,-122,2,1,3
27169,SpokaneStBridge,02/06/2017 01:00:00 AM,48,-122,0,0,0
27170,SpokaneStBridge,02/06/2017 02:00:00 AM,48,-122,0,0,0
27171,SpokaneStBridge,02/06/2017 03:00:00 AM,48,-122,0,0,0
27172,SpokaneStBridge,02/06/2017 04:00:00 AM,48,-122,0,1,1
27173,SpokaneStBridge,02/06/2017 05:00:00 AM,48,-122,5,1,6
27174,SpokaneStBridge,02/06/2017 06:00:00 AM,48,-122,4,0,4
27175,SpokaneStBridge,02/06/2017 07:00:00 AM,48,-122,12,2,14
27176,SpokaneStBridge,02/06/2017 08:00:00 AM,48,-122,11,3,14
27177,SpokaneStBridge,02/06/2017 09:00:00 AM,48,-122,3,2,5
27178,SpokaneStBridge,02/06/2017 10:00:00 AM,48,-122,2,0,2
27179,SpokaneStBridge,02/06/2017 11:00:00 AM,48,-122,0,0,0
27180,SpokaneStBridge,02/06/2017 12:00:00 PM,48,-122,1,0,1
27181,SpokaneStBridge,02/06/2017 01:00:00 PM,48,-122,2,1,3
27182,SpokaneStBridge,02/06/2017 02:00:00 PM,48,-122,4,8,12
27183,SpokaneStBridge,02/06/2017 03:00:00 PM,48,-122,0,4,4
27184,SpokaneStBridge,02/06/2017 04:00:00 PM,48,-122,0,9,9
27185,SpokaneStBridge,02/06/2017 05:00:00 PM,48,-122,3,8,11
27186,SpokaneStBridge,02/06/2017 06:00:00 PM,48,-122,1,3,4
27187,SpokaneStBridge,02/06/2017 07:00:00 PM,48,-122,0,2,2
27188,SpokaneStBridge,02/06/2017 08:00:00 PM,48,-122,0,4,4
27189,SpokaneStBridge,02/06/2017 09:00:00 PM,48,-122,0,0,0
27190,SpokaneStBridge,02/06/2017 10:00:00 PM,48,-122,0,1,1
27191,SpokaneStBridge,02/06/2017 11:00:00 PM,48,-122,0,1,1
27192,SpokaneStBridge,02/07/2017 12:00:00 AM,48,-122,0,0,0
27193,SpokaneStBridge,02/07/2017 01:00:00 AM,48,-122,0,0,0
27194,SpokaneStBridge,02/07/2017 02:00:00 AM,48,-122,1,0,1
27195,SpokaneStBridge,02/07/2017 03:00:00 AM,48,-122,0,0,0
27196,SpokaneStBridge,02/07/2017 04:00:00 AM,48,-122,1,1,2
27197,SpokaneStBridge,02/07/2017 05:00:00 AM,48,-122,4,0,4
27198,SpokaneStBridge,02/07/2017 06:00:00 AM,48,-122,8,1,9
27199,SpokaneStBridge,02/07/2017 07:00:00 AM,48,-122,18,1,19
27200,SpokaneStBridge,02/07/2017 08:00:00 AM,48,-122,17,2,19
27201,SpokaneStBridge,02/07/2017 09:00:00 AM,48,-122,7,3,10
27202,SpokaneStBridge,02/07/2017 10:00:00 AM,48,-122,7,0,7
27203,SpokaneStBridge,02/07/2017 11:00:00 AM,48,-122,6,3,9
27204,SpokaneStBridge,02/07/2017 12:00:00 PM,48,-122,4,3,7
27205,SpokaneStBridge,02/07/2017 01:00:00 PM,48,-122,10,4,14
27206,SpokaneStBridge,02/07/2017 02:00:00 PM,48,-122,7,4,11
27207,SpokaneStBridge,02/07/2017 03:00:00 PM,48,-122,1,6,7
27208,SpokaneStBridge,02/07/2017 04:00:00 PM,48,-122,4,12,16
27209,SpokaneStBridge,02/07/2017 05:00:00 PM,48,-122,7,21,28
27210,SpokaneStBridge,02/07/2017 06:00:00 PM,48,-122,2,17,19
27211,SpokaneStBridge,02/07/2017 07:00:00 PM,48,-122,1,8,9
27212,SpokaneStBridge,02/07/2017 08:00:00 PM,48,-122,0,7,7
27213,SpokaneStBridge,02/07/2017 09:00:00 PM,48,-122,1,5,6
27214,SpokaneStBridge,02/07/2017 10:00:00 PM,48,-122,0,1,1
27215,SpokaneStBridge,02/07/2017 11:00:00 PM,48,-122,0,1,1
27216,SpokaneStBridge,02/08/2017 12:00:00 AM,48,-122,1,0,1
27217,SpokaneStBridge,02/08/2017 01:00:00 AM,48,-122,1,0,1
27218,SpokaneStBridge,02/08/2017 02:00:00 AM,48,-122,1,1,2
27219,SpokaneStBridge,02/08/2017 03:00:00 AM,48,-122,1,0,1
27220,SpokaneStBridge,02/08/2017 04:00:00 AM,48,-122,2,1,3
27221,SpokaneStBridge,02/08/2017 05:00:00 AM,48,-122,3,0,3
27222,SpokaneStBridge,02/08/2017 06:00:00 AM,48,-122,18,2,20
27223,SpokaneStBridge,02/08/2017 07:00:00 AM,48,-122,29,2,31
27224,SpokaneStBridge,02/08/2017 08:00:00 AM,48,-122,58,3,61
27225,SpokaneStBridge,02/08/2017 09:00:00 AM,48,-122,21,1,22
27226,SpokaneStBridge,02/08/2017 10:00:00 AM,48,-122,3,1,4
27227,SpokaneStBridge,02/08/2017 11:00:00 AM,48,-122,3,0,3
27228,SpokaneStBridge,02/08/2017 12:00:00 PM,48,-122,3,1,4
27229,SpokaneStBridge,02/08/2017 01:00:00 PM,48,-122,2,2,4
27230,SpokaneStBridge,02/08/2017 02:00:00 PM,48,-122,3,4,7
27231,SpokaneStBridge,02/08/2017 03:00:00 PM,48,-122,4,10,14
27232,SpokaneStBridge,02/08/2017 04:00:00 PM,48,-122,3,24,27
27233,SpokaneStBridge,02/08/2017 05:00:00 PM,48,-122,4,43,47
27234,SpokaneStBridge,02/08/2017 06:00:00 PM,48,-122,2,34,36
27235,SpokaneStBridge,02/08/2017 07:00:00 PM,48,-122,3,11,14
27236,SpokaneStBridge,02/08/2017 08:00:00 PM,48,-122,0,4,4
27237,SpokaneStBridge,02/08/2017 09:00:00 PM,48,-122,0,2,2
27238,SpokaneStBridge,02/08/2017 10:00:00 PM,48,-122,1,2,3
27239,SpokaneStBridge,02/08/2017 11:00:00 PM,48,-122,0,2,2
27240,SpokaneStBridge,02/09/2017 12:00:00 AM,48,-122,1,1,2
27241,SpokaneStBridge,02/09/2017 01:00:00 AM,48,-122,1,0,1
27242,SpokaneStBridge,02/09/2017 02:00:00 AM,48,-122,0,0,0
27243,SpokaneStBridge,02/09/2017 03:00:00 AM,48,-122,0,0,0
27244,SpokaneStBridge,02/09/2017 04:00:00 AM,48,-122,2,1,3
27245,SpokaneStBridge,02/09/2017 05:00:00 AM,48,-122,5,1,6
27246,SpokaneStBridge,02/09/2017 06:00:00 AM,48,-122,20,4,24
27247,SpokaneStBridge,02/09/2017 07:00:00 AM,48,-122,31,3,34
27248,SpokaneStBridge,02/09/2017 08:00:00 AM,48,-122,31,2,33
27249,SpokaneStBridge,02/09/2017 09:00:00 AM,48,-122,19,2,21
27250,SpokaneStBridge,02/09/2017 10:00:00 AM,48,-122,4,2,6
27251,SpokaneStBridge,02/09/2017 11:00:00 AM,48,-122,2,2,4
27252,SpokaneStBridge,02/09/2017 12:00:00 PM,48,-122,8,4,12
27253,SpokaneStBridge,02/09/2017 01:00:00 PM,48,-122,4,3,7
27254,SpokaneStBridge,02/09/2017 02:00:00 PM,48,-122,9,8,17
27255,SpokaneStBridge,02/09/2017 03:00:00 PM,48,-122,1,4,5
27256,SpokaneStBridge,02/09/2017 04:00:00 PM,48,-122,4,14,18
27257,SpokaneStBridge,02/09/2017 05:00:00 PM,48,-122,4,36,40
27258,SpokaneStBridge,02/09/2017 06:00:00 PM,48,-122,3,35,38
27259,SpokaneStBridge,02/09/2017 07:00:00 PM,48,-122,1,12,13
27260,SpokaneStBridge,02/09/2017 08:00:00 PM,48,-122,0,4,4
27261,SpokaneStBridge,02/09/2017 09:00:00 PM,48,-122,1,5,6
27262,SpokaneStBridge,02/09/2017 10:00:00 PM,48,-122,1,2,3
27263,SpokaneStBridge,02/09/2017 11:00:00 PM,48,-122,1,1,2
27264,SpokaneStBridge,02/10/2017 12:00:00 AM,48,-122,0,0,0
27265,SpokaneStBridge,02/10/2017 01:00:00 AM,48,-122,1,1,2
27266,SpokaneStBridge,02/10/2017 02:00:00 AM,48,-122,0,2,2
27267,SpokaneStBridge,02/10/2017 03:00:00 AM,48,-122,0,0,0
27268,SpokaneStBridge,02/10/2017 04:00:00 AM,48,-122,0,0,0
27269,SpokaneStBridge,02/10/2017 05:00:00 AM,48,-122,6,0,6
27270,SpokaneStBridge,02/10/2017 06:00:00 AM,48,-122,17,4,21
27271,SpokaneStBridge,02/10/2017 07:00:00 AM,48,-122,50,4,54
27272,SpokaneStBridge,02/10/2017 08:00:00 AM,48,-122,65,4,69
27273,SpokaneStBridge,02/10/2017 09:00:00 AM,48,-122,20,1,21
27274,SpokaneStBridge,02/10/2017 10:00:00 AM,48,-122,9,0,9
27275,SpokaneStBridge,02/10/2017 11:00:00 AM,48,-122,3,0,3
27276,SpokaneStBridge,02/10/2017 12:00:00 PM,48,-122,2,0,2
27277,SpokaneStBridge,02/10/2017 01:00:00 PM,48,-122,3,4,7
27278,SpokaneStBridge,02/10/2017 02:00:00 PM,48,-122,2,3,5
27279,SpokaneStBridge,02/10/2017 03:00:00 PM,48,-122,3,11,14
27280,SpokaneStBridge,02/10/2017 04:00:00 PM,48,-122,7,31,38
27281,SpokaneStBridge,02/10/2017 05:00:00 PM,48,-122,8,56,64
27282,SpokaneStBridge,02/10/2017 06:00:00 PM,48,-122,5,34,39
27283,SpokaneStBridge,02/10/2017 07:00:00 PM,48,-122,5,8,13
27284,SpokaneStBridge,02/10/2017 08:00:00 PM,48,-122,2,1,3
27285,SpokaneStBridge,02/10/2017 09:00:00 PM,48,-122,0,2,2
27286,SpokaneStBridge,02/10/2017 10:00:00 PM,48,-122,1,0,1
27287,SpokaneStBridge,02/10/2017 11:00:00 PM,48,-122,1,3,4
27288,SpokaneStBridge,02/11/2017 12:00:00 AM,48,-122,0,0,0
27289,SpokaneStBridge,02/11/2017 01:00:00 AM,48,-122,0,0,0
27290,SpokaneStBridge,02/11/2017 02:00:00 AM,48,-122,0,0,0
27291,SpokaneStBridge,02/11/2017 03:00:00 AM,48,-122,1,0,1
27292,SpokaneStBridge,02/11/2017 04:00:00 AM,48,-122,1,0,1
27293,SpokaneStBridge,02/11/2017 05:00:00 AM,48,-122,1,0,1
27294,SpokaneStBridge,02/11/2017 06:00:00 AM,48,-122,0,1,1
27295,SpokaneStBridge,02/11/2017 07:00:00 AM,48,-122,6,3,9
27296,SpokaneStBridge,02/11/2017 08:00:00 AM,48,-122,15,3,18
27297,SpokaneStBridge,02/11/2017 09:00:00 AM,48,-122,4,16,20
27298,SpokaneStBridge,02/11/2017 10:00:00 AM,48,-122,13,14,27
27299,SpokaneStBridge,02/11/2017 11:00:00 AM,48,-122,12,10,22
27300,SpokaneStBridge,02/11/2017 12:00:00 PM,48,-122,24,13,37
27301,SpokaneStBridge,02/11/2017 01:00:00 PM,48,-122,20,28,48
27302,SpokaneStBridge,02/11/2017 02:00:00 PM,48,-122,18,23,41
27303,SpokaneStBridge,02/11/2017 03:00:00 PM,48,-122,19,12,31
27304,SpokaneStBridge,02/11/2017 04:00:00 PM,48,-122,12,18,30
27305,SpokaneStBridge,02/11/2017 05:00:00 PM,48,-122,3,9,12
27306,SpokaneStBridge,02/11/2017 06:00:00 PM,48,-122,2,4,6
27307,SpokaneStBridge,02/11/2017 07:00:00 PM,48,-122,3,4,7
27308,SpokaneStBridge,02/11/2017 08:00:00 PM,48,-122,0,0,0
27309,SpokaneStBridge,02/11/2017 09:00:00 PM,48,-122,1,1,2
27310,SpokaneStBridge,02/11/2017 10:00:00 PM,48,-122,1,1,2
27311,SpokaneStBridge,02/11/2017 11:00:00 PM,48,-122,1,0,1
27312,SpokaneStBridge,02/12/2017 12:00:00 AM,48,-122,0,0,0
27313,SpokaneStBridge,02/12/2017 01:00:00 AM,48,-122,1,0,1
27314,SpokaneStBridge,02/12/2017 02:00:00 AM,48,-122,0,0,0
27315,SpokaneStBridge,02/12/2017 03:00:00 AM,48,-122,0,0,0
27316,SpokaneStBridge,02/12/2017 04:00:00 AM,48,-122,0,2,2
27317,SpokaneStBridge,02/12/2017 05:00:00 AM,48,-122,2,1,3
27318,SpokaneStBridge,02/12/2017 06:00:00 AM,48,-122,0,0,0
27319,SpokaneStBridge,02/12/2017 07:00:00 AM,48,-122,4,3,7
27320,SpokaneStBridge,02/12/2017 08:00:00 AM,48,-122,10,3,13
27321,SpokaneStBridge,02/12/2017 09:00:00 AM,48,-122,15,14,29
27322,SpokaneStBridge,02/12/2017 10:00:00 AM,48,-122,13,18,31
27323,SpokaneStBridge,02/12/2017 11:00:00 AM,48,-122,16,34,50
27324,SpokaneStBridge,02/12/2017 12:00:00 PM,48,-122,22,33,55
27325,SpokaneStBridge,02/12/2017 01:00:00 PM,48,-122,29,30,59
27326,SpokaneStBridge,02/12/2017 02:00:00 PM,48,-122,18,29,47
27327,SpokaneStBridge,02/12/2017 03:00:00 PM,48,-122,32,26,58
27328,SpokaneStBridge,02/12/2017 04:00:00 PM,48,-122,21,23,44
27329,SpokaneStBridge,02/12/2017 05:00:00 PM,48,-122,15,7,22
27330,SpokaneStBridge,02/12/2017 06:00:00 PM,48,-122,10,1,11
27331,SpokaneStBridge,02/12/2017 07:00:00 PM,48,-122,1,1,2
27332,SpokaneStBridge,02/12/2017 08:00:00 PM,48,-122,0,3,3
27333,SpokaneStBridge,02/12/2017 09:00:00 PM,48,-122,0,0,0
27334,SpokaneStBridge,02/12/2017 10:00:00 PM,48,-122,1,1,2
27335,SpokaneStBridge,02/12/2017 11:00:00 PM,48,-122,1,1,2
27336,SpokaneStBridge,02/13/2017 12:00:00 AM,48,-122,1,0,1
27337,SpokaneStBridge,02/13/2017 01:00:00 AM,48,-122,1,1,2
27338,SpokaneStBridge,02/13/2017 02:00:00 AM,48,-122,0,1,1
27339,SpokaneStBridge,02/13/2017 03:00:00 AM,48,-122,1,1,2
27340,SpokaneStBridge,02/13/2017 04:00:00 AM,48,-122,8,2,10
27341,SpokaneStBridge,02/13/2017 05:00:00 AM,48,-122,19,2,21
27342,SpokaneStBridge,02/13/2017 06:00:00 AM,48,-122,41,5,46
27343,SpokaneStBridge,02/13/2017 07:00:00 AM,48,-122,82,8,90
27344,SpokaneStBridge,02/13/2017 08:00:00 AM,48,-122,107,5,112
27345,SpokaneStBridge,02/13/2017 09:00:00 AM,48,-122,36,5,41
27346,SpokaneStBridge,02/13/2017 10:00:00 AM,48,-122,13,6,19
27347,SpokaneStBridge,02/13/2017 11:00:00 AM,48,-122,10,7,17
27348,SpokaneStBridge,02/13/2017 12:00:00 PM,48,-122,7,9,16
27349,SpokaneStBridge,02/13/2017 01:00:00 PM,48,-122,16,12,28
27350,SpokaneStBridge,02/13/2017 02:00:00 PM,48,-122,12,12,24
27351,SpokaneStBridge,02/13/2017 03:00:00 PM,48,-122,9,22,31
27352,SpokaneStBridge,02/13/2017 04:00:00 PM,48,-122,26,80,106
27353,SpokaneStBridge,02/13/2017 05:00:00 PM,48,-122,18,115,133
27354,SpokaneStBridge,02/13/2017 06:00:00 PM,48,-122,10,57,67
27355,SpokaneStBridge,02/13/2017 07:00:00 PM,48,-122,5,24,29
27356,SpokaneStBridge,02/13/2017 08:00:00 PM,48,-122,2,6,8
27357,SpokaneStBridge,02/13/2017 09:00:00 PM,48,-122,2,4,6
27358,SpokaneStBridge,02/13/2017 10:00:00 PM,48,-122,0,0,0
27359,SpokaneStBridge,02/13/2017 11:00:00 PM,48,-122,0,1,1
27360,SpokaneStBridge,02/14/2017 12:00:00 AM,48,-122,0,0,0
27361,SpokaneStBridge,02/14/2017 01:00:00 AM,48,-122,0,0,0
27362,SpokaneStBridge,02/14/2017 02:00:00 AM,48,-122,0,0,0
27363,SpokaneStBridge,02/14/2017 03:00:00 AM,48,-122,1,1,2
27364,SpokaneStBridge,02/14/2017 04:00:00 AM,48,-122,3,0,3
27365,SpokaneStBridge,02/14/2017 05:00:00 AM,48,-122,15,2,17
27366,SpokaneStBridge,02/14/2017 06:00:00 AM,48,-122,40,8,48
27367,SpokaneStBridge,02/14/2017 07:00:00 AM,48,-122,102,11,113
27368,SpokaneStBridge,02/14/2017 08:00:00 AM,48,-122,100,5,105
27369,SpokaneStBridge,02/14/2017 09:00:00 AM,48,-122,38,3,41
27370,SpokaneStBridge,02/14/2017 10:00:00 AM,48,-122,15,3,18
27371,SpokaneStBridge,02/14/2017 11:00:00 AM,48,-122,5,3,8
27372,SpokaneStBridge,02/14/2017 12:00:00 PM,48,-122,11,13,24
27373,SpokaneStBridge,02/14/2017 01:00:00 PM,48,-122,9,11,20
27374,SpokaneStBridge,02/14/2017 02:00:00 PM,48,-122,11,7,18
27375,SpokaneStBridge,02/14/2017 03:00:00 PM,48,-122,8,24,32
27376,SpokaneStBridge,02/14/2017 04:00:00 PM,48,-122,13,71,84
27377,SpokaneStBridge,02/14/2017 05:00:00 PM,48,-122,22,115,137
27378,SpokaneStBridge,02/14/2017 06:00:00 PM,48,-122,8,71,79
27379,SpokaneStBridge,02/14/2017 07:00:00 PM,48,-122,6,11,17
27380,SpokaneStBridge,02/14/2017 08:00:00 PM,48,-122,4,9,13
27381,SpokaneStBridge,02/14/2017 09:00:00 PM,48,-122,2,5,7
27382,SpokaneStBridge,02/14/2017 10:00:00 PM,48,-122,1,2,3
27383,SpokaneStBridge,02/14/2017 11:00:00 PM,48,-122,1,2,3
27384,SpokaneStBridge,02/15/2017 12:00:00 AM,48,-122,0,1,1
27385,SpokaneStBridge,02/15/2017 01:00:00 AM,48,-122,0,1,1
27386,SpokaneStBridge,02/15/2017 02:00:00 AM,48,-122,0,0,0
27387,SpokaneStBridge,02/15/2017 03:00:00 AM,48,-122,0,0,0
27388,SpokaneStBridge,02/15/2017 04:00:00 AM,48,-122,1,1,2
27389,SpokaneStBridge,02/15/2017 05:00:00 AM,48,-122,9,0,9
27390,SpokaneStBridge,02/15/2017 06:00:00 AM,48,-122,23,2,25
27391,SpokaneStBridge,02/15/2017 07:00:00 AM,48,-122,55,4,59
27392,SpokaneStBridge,02/15/2017 08:00:00 AM,48,-122,62,8,70
27393,SpokaneStBridge,02/15/2017 09:00:00 AM,48,-122,17,5,22
27394,SpokaneStBridge,02/15/2017 10:00:00 AM,48,-122,9,6,15
27395,SpokaneStBridge,02/15/2017 11:00:00 AM,48,-122,2,4,6
27396,SpokaneStBridge,02/15/2017 12:00:00 PM,48,-122,3,1,4
27397,SpokaneStBridge,02/15/2017 01:00:00 PM,48,-122,4,3,7
27398,SpokaneStBridge,02/15/2017 02:00:00 PM,48,-122,3,3,6
27399,SpokaneStBridge,02/15/2017 03:00:00 PM,48,-122,2,9,11
27400,SpokaneStBridge,02/15/2017 04:00:00 PM,48,-122,8,29,37
27401,SpokaneStBridge,02/15/2017 05:00:00 PM,48,-122,7,59,66
27402,SpokaneStBridge,02/15/2017 06:00:00 PM,48,-122,5,38,43
27403,SpokaneStBridge,02/15/2017 07:00:00 PM,48,-122,4,14,18
27404,SpokaneStBridge,02/15/2017 08:00:00 PM,48,-122,2,2,4
27405,SpokaneStBridge,02/15/2017 09:00:00 PM,48,-122,0,5,5
27406,SpokaneStBridge,02/15/2017 10:00:00 PM,48,-122,0,4,4
27407,SpokaneStBridge,02/15/2017 11:00:00 PM,48,-122,1,0,1
27408,SpokaneStBridge,02/16/2017 12:00:00 AM,48,-122,1,1,2
27409,SpokaneStBridge,02/16/2017 01:00:00 AM,48,-122,0,1,1
27410,SpokaneStBridge,02/16/2017 02:00:00 AM,48,-122,0,0,0
27411,SpokaneStBridge,02/16/2017 03:00:00 AM,48,-122,1,1,2
27412,SpokaneStBridge,02/16/2017 04:00:00 AM,48,-122,1,0,1
27413,SpokaneStBridge,02/16/2017 05:00:00 AM,48,-122,9,1,10
27414,SpokaneStBridge,02/16/2017 06:00:00 AM,48,-122,25,3,28
27415,SpokaneStBridge,02/16/2017 07:00:00 AM,48,-122,66,9,75
27416,SpokaneStBridge,02/16/2017 08:00:00 AM,48,-122,81,5,86
27417,SpokaneStBridge,02/16/2017 09:00:00 AM,48,-122,33,5,38
27418,SpokaneStBridge,02/16/2017 10:00:00 AM,48,-122,7,1,8
27419,SpokaneStBridge,02/16/2017 11:00:00 AM,48,-122,7,2,9
27420,SpokaneStBridge,02/16/2017 12:00:00 PM,48,-122,9,8,17
27421,SpokaneStBridge,02/16/2017 01:00:00 PM,48,-122,12,6,18
27422,SpokaneStBridge,02/16/2017 02:00:00 PM,48,-122,9,11,20
27423,SpokaneStBridge,02/16/2017 03:00:00 PM,48,-122,7,10,17
27424,SpokaneStBridge,02/16/2017 04:00:00 PM,48,-122,6,39,45
27425,SpokaneStBridge,02/16/2017 05:00:00 PM,48,-122,12,89,101
27426,SpokaneStBridge,02/16/2017 06:00:00 PM,48,-122,5,48,53
27427,SpokaneStBridge,02/16/2017 07:00:00 PM,48,-122,4,17,21
27428,SpokaneStBridge,02/16/2017 08:00:00 PM,48,-122,1,6,7
27429,SpokaneStBridge,02/16/2017 09:00:00 PM,48,-122,3,9,12
27430,SpokaneStBridge,02/16/2017 10:00:00 PM,48,-122,3,4,7
27431,SpokaneStBridge,02/16/2017 11:00:00 PM,48,-122,0,2,2
27432,SpokaneStBridge,02/17/2017 12:00:00 AM,48,-122,0,0,0
27433,SpokaneStBridge,02/17/2017 01:00:00 AM,48,-122,1,0,1
27434,SpokaneStBridge,02/17/2017 02:00:00 AM,48,-122,1,2,3
27435,SpokaneStBridge,02/17/2017 03:00:00 AM,48,-122,2,0,2
27436,SpokaneStBridge,02/17/2017 04:00:00 AM,48,-122,1,0,1
27437,SpokaneStBridge,02/17/2017 05:00:00 AM,48,-122,9,2,11
27438,SpokaneStBridge,02/17/2017 06:00:00 AM,48,-122,34,7,41
27439,SpokaneStBridge,02/17/2017 07:00:00 AM,48,-122,64,13,77
27440,SpokaneStBridge,02/17/2017 08:00:00 AM,48,-122,70,9,79
27441,SpokaneStBridge,02/17/2017 09:00:00 AM,48,-122,38,15,53
27442,SpokaneStBridge,02/17/2017 10:00:00 AM,48,-122,16,2,18
27443,SpokaneStBridge,02/17/2017 11:00:00 AM,48,-122,11,13,24
27444,SpokaneStBridge,02/17/2017 12:00:00 PM,48,-122,16,6,22
27445,SpokaneStBridge,02/17/2017 01:00:00 PM,48,-122,10,22,32
27446,SpokaneStBridge,02/17/2017 02:00:00 PM,48,-122,16,22,38
27447,SpokaneStBridge,02/17/2017 03:00:00 PM,48,-122,9,39,48
27448,SpokaneStBridge,02/17/2017 04:00:00 PM,48,-122,26,58,84
27449,SpokaneStBridge,02/17/2017 05:00:00 PM,48,-122,14,66,80
27450,SpokaneStBridge,02/17/2017 06:00:00 PM,48,-122,6,49,55
27451,SpokaneStBridge,02/17/2017 07:00:00 PM,48,-122,5,18,23
27452,SpokaneStBridge,02/17/2017 08:00:00 PM,48,-122,3,9,12
27453,SpokaneStBridge,02/17/2017 09:00:00 PM,48,-122,1,3,4
27454,SpokaneStBridge,02/17/2017 10:00:00 PM,48,-122,0,4,4
27455,SpokaneStBridge,02/17/2017 11:00:00 PM,48,-122,1,1,2
27456,SpokaneStBridge,02/18/2017 12:00:00 AM,48,-122,0,0,0
27457,SpokaneStBridge,02/18/2017 01:00:00 AM,48,-122,1,0,1
27458,SpokaneStBridge,02/18/2017 02:00:00 AM,48,-122,0,0,0
27459,SpokaneStBridge,02/18/2017 03:00:00 AM,48,-122,2,0,2
27460,SpokaneStBridge,02/18/2017 04:00:00 AM,48,-122,0,0,0
27461,SpokaneStBridge,02/18/2017 05:00:00 AM,48,-122,3,2,5
27462,SpokaneStBridge,02/18/2017 06:00:00 AM,48,-122,0,1,1
27463,SpokaneStBridge,02/18/2017 07:00:00 AM,48,-122,2,2,4
27464,SpokaneStBridge,02/18/2017 08:00:00 AM,48,-122,8,1,9
27465,SpokaneStBridge,02/18/2017 09:00:00 AM,48,-122,2,4,6
27466,SpokaneStBridge,02/18/2017 10:00:00 AM,48,-122,6,8,14
27467,SpokaneStBridge,02/18/2017 11:00:00 AM,48,-122,6,6,12
27468,SpokaneStBridge,02/18/2017 12:00:00 PM,48,-122,5,2,7
27469,SpokaneStBridge,02/18/2017 01:00:00 PM,48,-122,9,3,12
27470,SpokaneStBridge,02/18/2017 02:00:00 PM,48,-122,5,8,13
27471,SpokaneStBridge,02/18/2017 03:00:00 PM,48,-122,3,5,8
27472,SpokaneStBridge,02/18/2017 04:00:00 PM,48,-122,2,8,10
27473,SpokaneStBridge,02/18/2017 05:00:00 PM,48,-122,6,3,9
27474,SpokaneStBridge,02/18/2017 06:00:00 PM,48,-122,2,1,3
27475,SpokaneStBridge,02/18/2017 07:00:00 PM,48,-122,0,0,0
27476,SpokaneStBridge,02/18/2017 08:00:00 PM,48,-122,2,1,3
27477,SpokaneStBridge,02/18/2017 09:00:00 PM,48,-122,0,0,0
27478,SpokaneStBridge,02/18/2017 10:00:00 PM,48,-122,1,4,5
27479,SpokaneStBridge,02/18/2017 11:00:00 PM,48,-122,1,0,1
27480,SpokaneStBridge,02/19/2017 12:00:00 AM,48,-122,0,0,0
27481,SpokaneStBridge,02/19/2017 01:00:00 AM,48,-122,1,0,1
27482,SpokaneStBridge,02/19/2017 02:00:00 AM,48,-122,0,1,1
27483,SpokaneStBridge,02/19/2017 03:00:00 AM,48,-122,0,0,0
27484,SpokaneStBridge,02/19/2017 04:00:00 AM,48,-122,1,2,3
27485,SpokaneStBridge,02/19/2017 05:00:00 AM,48,-122,4,1,5
27486,SpokaneStBridge,02/19/2017 06:00:00 AM,48,-122,0,0,0
27487,SpokaneStBridge,02/19/2017 07:00:00 AM,48,-122,1,0,1
27488,SpokaneStBridge,02/19/2017 08:00:00 AM,48,-122,4,1,5
27489,SpokaneStBridge,02/19/2017 09:00:00 AM,48,-122,4,17,21
27490,SpokaneStBridge,02/19/2017 10:00:00 AM,48,-122,12,4,16
27491,SpokaneStBridge,02/19/2017 11:00:00 AM,48,-122,11,11,22
27492,SpokaneStBridge,02/19/2017 12:00:00 PM,48,-122,8,6,14
27493,SpokaneStBridge,02/19/2017 01:00:00 PM,48,-122,16,10,26
27494,SpokaneStBridge,02/19/2017 02:00:00 PM,48,-122,3,2,5
27495,SpokaneStBridge,02/19/2017 03:00:00 PM,48,-122,7,8,15
27496,SpokaneStBridge,02/19/2017 04:00:00 PM,48,-122,1,3,4
27497,SpokaneStBridge,02/19/2017 05:00:00 PM,48,-122,4,2,6
27498,SpokaneStBridge,02/19/2017 06:00:00 PM,48,-122,3,1,4
27499,SpokaneStBridge,02/19/2017 07:00:00 PM,48,-122,1,3,4
27500,SpokaneStBridge,02/19/2017 08:00:00 PM,48,-122,2,3,5
27501,SpokaneStBridge,02/19/2017 09:00:00 PM,48,-122,1,0,1
27502,SpokaneStBridge,02/19/2017 10:00:00 PM,48,-122,1,0,1
27503,SpokaneStBridge,02/19/2017 11:00:00 PM,48,-122,1,1,2
27504,SpokaneStBridge,02/20/2017 12:00:00 AM,48,-122,1,0,1
27505,SpokaneStBridge,02/20/2017 01:00:00 AM,48,-122,0,0,0
27506,SpokaneStBridge,02/20/2017 02:00:00 AM,48,-122,3,5,8
27507,SpokaneStBridge,02/20/2017 03:00:00 AM,48,-122,0,0,0
27508,SpokaneStBridge,02/20/2017 04:00:00 AM,48,-122,4,1,5
27509,SpokaneStBridge,02/20/2017 05:00:00 AM,48,-122,2,0,2
27510,SpokaneStBridge,02/20/2017 06:00:00 AM,48,-122,9,2,11
27511,SpokaneStBridge,02/20/2017 07:00:00 AM,48,-122,25,4,29
27512,SpokaneStBridge,02/20/2017 08:00:00 AM,48,-122,33,6,39
27513,SpokaneStBridge,02/20/2017 09:00:00 AM,48,-122,14,4,18
27514,SpokaneStBridge,02/20/2017 10:00:00 AM,48,-122,10,5,15
27515,SpokaneStBridge,02/20/2017 11:00:00 AM,48,-122,9,4,13
27516,SpokaneStBridge,02/20/2017 12:00:00 PM,48,-122,7,7,14
27517,SpokaneStBridge,02/20/2017 01:00:00 PM,48,-122,5,4,9
27518,SpokaneStBridge,02/20/2017 02:00:00 PM,48,-122,2,8,10
27519,SpokaneStBridge,02/20/2017 03:00:00 PM,48,-122,2,5,7
27520,SpokaneStBridge,02/20/2017 04:00:00 PM,48,-122,7,13,20
27521,SpokaneStBridge,02/20/2017 05:00:00 PM,48,-122,5,30,35
27522,SpokaneStBridge,02/20/2017 06:00:00 PM,48,-122,3,17,20
27523,SpokaneStBridge,02/20/2017 07:00:00 PM,48,-122,1,13,14
27524,SpokaneStBridge,02/20/2017 08:00:00 PM,48,-122,1,0,1
27525,SpokaneStBridge,02/20/2017 09:00:00 PM,48,-122,0,1,1
27526,SpokaneStBridge,02/20/2017 10:00:00 PM,48,-122,1,1,2
27527,SpokaneStBridge,02/20/2017 11:00:00 PM,48,-122,2,1,3
27528,SpokaneStBridge,02/21/2017 12:00:00 AM,48,-122,0,0,0
27529,SpokaneStBridge,02/21/2017 01:00:00 AM,48,-122,1,0,1
27530,SpokaneStBridge,02/21/2017 02:00:00 AM,48,-122,0,2,2
27531,SpokaneStBridge,02/21/2017 03:00:00 AM,48,-122,1,0,1
27532,SpokaneStBridge,02/21/2017 04:00:00 AM,48,-122,1,1,2
27533,SpokaneStBridge,02/21/2017 05:00:00 AM,48,-122,9,0,9
27534,SpokaneStBridge,02/21/2017 06:00:00 AM,48,-122,35,7,42
27535,SpokaneStBridge,02/21/2017 07:00:00 AM,48,-122,69,4,73
27536,SpokaneStBridge,02/21/2017 08:00:00 AM,48,-122,74,6,80
27537,SpokaneStBridge,02/21/2017 09:00:00 AM,48,-122,24,7,31
27538,SpokaneStBridge,02/21/2017 10:00:00 AM,48,-122,7,1,8
27539,SpokaneStBridge,02/21/2017 11:00:00 AM,48,-122,5,2,7
27540,SpokaneStBridge,02/21/2017 12:00:00 PM,48,-122,4,1,5
27541,SpokaneStBridge,02/21/2017 01:00:00 PM,48,-122,6,5,11
27542,SpokaneStBridge,02/21/2017 02:00:00 PM,48,-122,5,6,11
27543,SpokaneStBridge,02/21/2017 03:00:00 PM,48,-122,6,12,18
27544,SpokaneStBridge,02/21/2017 04:00:00 PM,48,-122,9,42,51
27545,SpokaneStBridge,02/21/2017 05:00:00 PM,48,-122,8,73,81
27546,SpokaneStBridge,02/21/2017 06:00:00 PM,48,-122,7,48,55
27547,SpokaneStBridge,02/21/2017 07:00:00 PM,48,-122,5,14,19
27548,SpokaneStBridge,02/21/2017 08:00:00 PM,48,-122,0,6,6
27549,SpokaneStBridge,02/21/2017 09:00:00 PM,48,-122,1,8,9
27550,SpokaneStBridge,02/21/2017 10:00:00 PM,48,-122,2,2,4
27551,SpokaneStBridge,02/21/2017 11:00:00 PM,48,-122,2,2,4
27552,SpokaneStBridge,02/22/2017 12:00:00 AM,48,-122,0,0,0
27553,SpokaneStBridge,02/22/2017 01:00:00 AM,48,-122,0,0,0
27554,SpokaneStBridge,02/22/2017 02:00:00 AM,48,-122,1,0,1
27555,SpokaneStBridge,02/22/2017 03:00:00 AM,48,-122,0,2,2
27556,SpokaneStBridge,02/22/2017 04:00:00 AM,48,-122,1,0,1
27557,SpokaneStBridge,02/22/2017 05:00:00 AM,48,-122,10,3,13
27558,SpokaneStBridge,02/22/2017 06:00:00 AM,48,-122,33,6,39
27559,SpokaneStBridge,02/22/2017 07:00:00 AM,48,-122,65,9,74
27560,SpokaneStBridge,02/22/2017 08:00:00 AM,48,-122,77,8,85
27561,SpokaneStBridge,02/22/2017 09:00:00 AM,48,-122,24,5,29
27562,SpokaneStBridge,02/22/2017 10:00:00 AM,48,-122,10,4,14
27563,SpokaneStBridge,02/22/2017 11:00:00 AM,48,-122,13,4,17
27564,SpokaneStBridge,02/22/2017 12:00:00 PM,48,-122,5,5,10
27565,SpokaneStBridge,02/22/2017 01:00:00 PM,48,-122,7,5,12
27566,SpokaneStBridge,02/22/2017 02:00:00 PM,48,-122,8,12,20
27567,SpokaneStBridge,02/22/2017 03:00:00 PM,48,-122,8,24,32
27568,SpokaneStBridge,02/22/2017 04:00:00 PM,48,-122,10,42,52
27569,SpokaneStBridge,02/22/2017 05:00:00 PM,48,-122,12,69,81
27570,SpokaneStBridge,02/22/2017 06:00:00 PM,48,-122,9,50,59
27571,SpokaneStBridge,02/22/2017 07:00:00 PM,48,-122,5,18,23
27572,SpokaneStBridge,02/22/2017 08:00:00 PM,48,-122,1,5,6
27573,SpokaneStBridge,02/22/2017 09:00:00 PM,48,-122,1,8,9
27574,SpokaneStBridge,02/22/2017 10:00:00 PM,48,-122,1,3,4
27575,SpokaneStBridge,02/22/2017 11:00:00 PM,48,-122,1,2,3
27576,SpokaneStBridge,02/23/2017 12:00:00 AM,48,-122,1,0,1
27577,SpokaneStBridge,02/23/2017 01:00:00 AM,48,-122,1,1,2
27578,SpokaneStBridge,02/23/2017 02:00:00 AM,48,-122,0,1,1
27579,SpokaneStBridge,02/23/2017 03:00:00 AM,48,-122,0,0,0
27580,SpokaneStBridge,02/23/2017 04:00:00 AM,48,-122,1,1,2
27581,SpokaneStBridge,02/23/2017 05:00:00 AM,48,-122,14,2,16
27582,SpokaneStBridge,02/23/2017 06:00:00 AM,48,-122,28,4,32
27583,SpokaneStBridge,02/23/2017 07:00:00 AM,48,-122,68,7,75
27584,SpokaneStBridge,02/23/2017 08:00:00 AM,48,-122,68,4,72
27585,SpokaneStBridge,02/23/2017 09:00:00 AM,48,-122,26,3,29
27586,SpokaneStBridge,02/23/2017 10:00:00 AM,48,-122,12,4,16
27587,SpokaneStBridge,02/23/2017 11:00:00 AM,48,-122,6,0,6
27588,SpokaneStBridge,02/23/2017 12:00:00 PM,48,-122,1,3,4
27589,SpokaneStBridge,02/23/2017 01:00:00 PM,48,-122,9,5,14
27590,SpokaneStBridge,02/23/2017 02:00:00 PM,48,-122,8,6,14
27591,SpokaneStBridge,02/23/2017 03:00:00 PM,48,-122,9,13,22
27592,SpokaneStBridge,02/23/2017 04:00:00 PM,48,-122,10,51,61
27593,SpokaneStBridge,02/23/2017 05:00:00 PM,48,-122,10,72,82
27594,SpokaneStBridge,02/23/2017 06:00:00 PM,48,-122,6,53,59
27595,SpokaneStBridge,02/23/2017 07:00:00 PM,48,-122,5,9,14
27596,SpokaneStBridge,02/23/2017 08:00:00 PM,48,-122,1,6,7
27597,SpokaneStBridge,02/23/2017 09:00:00 PM,48,-122,3,6,9
27598,SpokaneStBridge,02/23/2017 10:00:00 PM,48,-122,1,2,3
27599,SpokaneStBridge,02/23/2017 11:00:00 PM,48,-122,0,1,1
27600,SpokaneStBridge,02/24/2017 12:00:00 AM,48,-122,0,0,0
27601,SpokaneStBridge,02/24/2017 01:00:00 AM,48,-122,0,1,1
27602,SpokaneStBridge,02/24/2017 02:00:00 AM,48,-122,0,1,1
27603,SpokaneStBridge,02/24/2017 03:00:00 AM,48,-122,0,1,1
27604,SpokaneStBridge,02/24/2017 04:00:00 AM,48,-122,3,0,3
27605,SpokaneStBridge,02/24/2017 05:00:00 AM,48,-122,5,1,6
27606,SpokaneStBridge,02/24/2017 06:00:00 AM,48,-122,25,0,25
27607,SpokaneStBridge,02/24/2017 07:00:00 AM,48,-122,42,3,45
27608,SpokaneStBridge,02/24/2017 08:00:00 AM,48,-122,43,4,47
27609,SpokaneStBridge,02/24/2017 09:00:00 AM,48,-122,16,2,18
27610,SpokaneStBridge,02/24/2017 10:00:00 AM,48,-122,15,1,16
27611,SpokaneStBridge,02/24/2017 11:00:00 AM,48,-122,8,0,8
27612,SpokaneStBridge,02/24/2017 12:00:00 PM,48,-122,8,3,11
27613,SpokaneStBridge,02/24/2017 01:00:00 PM,48,-122,3,5,8
27614,SpokaneStBridge,02/24/2017 02:00:00 PM,48,-122,11,10,21
27615,SpokaneStBridge,02/24/2017 03:00:00 PM,48,-122,5,13,18
27616,SpokaneStBridge,02/24/2017 04:00:00 PM,48,-122,5,32,37
27617,SpokaneStBridge,02/24/2017 05:00:00 PM,48,-122,10,67,77
27618,SpokaneStBridge,02/24/2017 06:00:00 PM,48,-122,7,25,32
27619,SpokaneStBridge,02/24/2017 07:00:00 PM,48,-122,1,4,5
27620,SpokaneStBridge,02/24/2017 08:00:00 PM,48,-122,2,2,4
27621,SpokaneStBridge,02/24/2017 09:00:00 PM,48,-122,1,5,6
27622,SpokaneStBridge,02/24/2017 10:00:00 PM,48,-122,0,2,2
27623,SpokaneStBridge,02/24/2017 11:00:00 PM,48,-122,1,0,1
27624,SpokaneStBridge,02/25/2017 12:00:00 AM,48,-122,1,0,1
27625,SpokaneStBridge,02/25/2017 01:00:00 AM,48,-122,0,0,0
27626,SpokaneStBridge,02/25/2017 02:00:00 AM,48,-122,0,0,0
27627,SpokaneStBridge,02/25/2017 03:00:00 AM,48,-122,2,1,3
27628,SpokaneStBridge,02/25/2017 04:00:00 AM,48,-122,0,0,0
27629,SpokaneStBridge,02/25/2017 05:00:00 AM,48,-122,2,1,3
27630,SpokaneStBridge,02/25/2017 06:00:00 AM,48,-122,5,0,5
27631,SpokaneStBridge,02/25/2017 07:00:00 AM,48,-122,10,1,11
27632,SpokaneStBridge,02/25/2017 08:00:00 AM,48,-122,10,2,12
27633,SpokaneStBridge,02/25/2017 09:00:00 AM,48,-122,11,11,22
27634,SpokaneStBridge,02/25/2017 10:00:00 AM,48,-122,19,22,41
27635,SpokaneStBridge,02/25/2017 11:00:00 AM,48,-122,12,18,30
27636,SpokaneStBridge,02/25/2017 12:00:00 PM,48,-122,19,23,42
27637,SpokaneStBridge,02/25/2017 01:00:00 PM,48,-122,29,22,51
27638,SpokaneStBridge,02/25/2017 02:00:00 PM,48,-122,20,27,47
27639,SpokaneStBridge,02/25/2017 03:00:00 PM,48,-122,14,18,32
27640,SpokaneStBridge,02/25/2017 04:00:00 PM,48,-122,11,10,21
27641,SpokaneStBridge,02/25/2017 05:00:00 PM,48,-122,10,8,18
27642,SpokaneStBridge,02/25/2017 06:00:00 PM,48,-122,1,7,8
27643,SpokaneStBridge,02/25/2017 07:00:00 PM,48,-122,0,4,4
27644,SpokaneStBridge,02/25/2017 08:00:00 PM,48,-122,0,5,5
27645,SpokaneStBridge,02/25/2017 09:00:00 PM,48,-122,0,2,2
27646,SpokaneStBridge,02/25/2017 10:00:00 PM,48,-122,3,1,4
27647,SpokaneStBridge,02/25/2017 11:00:00 PM,48,-122,1,2,3
27648,SpokaneStBridge,02/26/2017 12:00:00 AM,48,-122,0,0,0
27649,SpokaneStBridge,02/26/2017 01:00:00 AM,48,-122,2,1,3
27650,SpokaneStBridge,02/26/2017 02:00:00 AM,48,-122,1,1,2
27651,SpokaneStBridge,02/26/2017 03:00:00 AM,48,-122,1,0,1
27652,SpokaneStBridge,02/26/2017 04:00:00 AM,48,-122,2,2,4
27653,SpokaneStBridge,02/26/2017 05:00:00 AM,48,-122,2,1,3
27654,SpokaneStBridge,02/26/2017 06:00:00 AM,48,-122,5,1,6
27655,SpokaneStBridge,02/26/2017 07:00:00 AM,48,-122,24,1,25
27656,SpokaneStBridge,02/26/2017 08:00:00 AM,48,-122,15,4,19
27657,SpokaneStBridge,02/26/2017 09:00:00 AM,48,-122,8,1,9
27658,SpokaneStBridge,02/26/2017 10:00:00 AM,48,-122,3,2,5
27659,SpokaneStBridge,02/26/2017 11:00:00 AM,48,-122,5,3,8
27660,SpokaneStBridge,02/26/2017 12:00:00 PM,48,-122,3,9,12
27661,SpokaneStBridge,02/26/2017 01:00:00 PM,48,-122,3,12,15
27662,SpokaneStBridge,02/26/2017 02:00:00 PM,48,-122,6,11,17
27663,SpokaneStBridge,02/26/2017 03:00:00 PM,48,-122,5,13,18
27664,SpokaneStBridge,02/26/2017 04:00:00 PM,48,-122,2,7,9
27665,SpokaneStBridge,02/26/2017 05:00:00 PM,48,-122,4,4,8
27666,SpokaneStBridge,02/26/2017 06:00:00 PM,48,-122,3,1,4
27667,SpokaneStBridge,02/26/2017 07:00:00 PM,48,-122,1,0,1
27668,SpokaneStBridge,02/26/2017 08:00:00 PM,48,-122,1,2,3
27669,SpokaneStBridge,02/26/2017 09:00:00 PM,48,-122,0,1,1
27670,SpokaneStBridge,02/26/2017 10:00:00 PM,48,-122,1,2,3
27671,SpokaneStBridge,02/26/2017 11:00:00 PM,48,-122,0,0,0
27672,SpokaneStBridge,02/27/2017 12:00:00 AM,48,-122,2,1,3
27673,SpokaneStBridge,02/27/2017 01:00:00 AM,48,-122,0,0,0
27674,SpokaneStBridge,02/27/2017 02:00:00 AM,48,-122,1,0,1
27675,SpokaneStBridge,02/27/2017 03:00:00 AM,48,-122,0,2,2
27676,SpokaneStBridge,02/27/2017 04:00:00 AM,48,-122,5,1,6
27677,SpokaneStBridge,02/27/2017 05:00:00 AM,48,-122,8,1,9
27678,SpokaneStBridge,02/27/2017 06:00:00 AM,48,-122,20,3,23
27679,SpokaneStBridge,02/27/2017 07:00:00 AM,48,-122,36,2,38
27680,SpokaneStBridge,02/27/2017 08:00:00 AM,48,-122,50,3,53
27681,SpokaneStBridge,02/27/2017 09:00:00 AM,48,-122,26,0,26
27682,SpokaneStBridge,02/27/2017 10:00:00 AM,48,-122,11,1,12
27683,SpokaneStBridge,02/27/2017 11:00:00 AM,48,-122,3,1,4
27684,SpokaneStBridge,02/27/2017 12:00:00 PM,48,-122,1,3,4
27685,SpokaneStBridge,02/27/2017 01:00:00 PM,48,-122,5,4,9
27686,SpokaneStBridge,02/27/2017 02:00:00 PM,48,-122,7,9,16
27687,SpokaneStBridge,02/27/2017 03:00:00 PM,48,-122,7,8,15
27688,SpokaneStBridge,02/27/2017 04:00:00 PM,48,-122,3,36,39
27689,SpokaneStBridge,02/27/2017 05:00:00 PM,48,-122,3,49,52
27690,SpokaneStBridge,02/27/2017 06:00:00 PM,48,-122,8,35,43
27691,SpokaneStBridge,02/27/2017 07:00:00 PM,48,-122,0,9,9
27692,SpokaneStBridge,02/27/2017 08:00:00 PM,48,-122,3,4,7
27693,SpokaneStBridge,02/27/2017 09:00:00 PM,48,-122,1,1,2
27694,SpokaneStBridge,02/27/2017 10:00:00 PM,48,-122,0,0,0
27695,SpokaneStBridge,02/27/2017 11:00:00 PM,48,-122,1,0,1
27696,SpokaneStBridge,02/28/2017 12:00:00 AM,48,-122,0,0,0
27697,SpokaneStBridge,02/28/2017 01:00:00 AM,48,-122,0,1,1
27698,SpokaneStBridge,02/28/2017 02:00:00 AM,48,-122,0,0,0
27699,SpokaneStBridge,02/28/2017 03:00:00 AM,48,-122,0,0,0
27700,SpokaneStBridge,02/28/2017 04:00:00 AM,48,-122,1,1,2
27701,SpokaneStBridge,02/28/2017 05:00:00 AM,48,-122,4,1,5
27702,SpokaneStBridge,02/28/2017 06:00:00 AM,48,-122,26,4,30
27703,SpokaneStBridge,02/28/2017 07:00:00 AM,48,-122,58,0,58
27704,SpokaneStBridge,02/28/2017 08:00:00 AM,48,-122,74,10,84
27705,SpokaneStBridge,02/28/2017 09:00:00 AM,48,-122,25,5,30
27706,SpokaneStBridge,02/28/2017 10:00:00 AM,48,-122,13,7,20
27707,SpokaneStBridge,02/28/2017 11:00:00 AM,48,-122,5,1,6
27708,SpokaneStBridge,02/28/2017 12:00:00 PM,48,-122,9,2,11
27709,SpokaneStBridge,02/28/2017 01:00:00 PM,48,-122,5,4,9
27710,SpokaneStBridge,02/28/2017 02:00:00 PM,48,-122,10,7,17
27711,SpokaneStBridge,02/28/2017 03:00:00 PM,48,-122,7,12,19
27712,SpokaneStBridge,02/28/2017 04:00:00 PM,48,-122,3,45,48
27713,SpokaneStBridge,02/28/2017 05:00:00 PM,48,-122,8,67,75
27714,SpokaneStBridge,02/28/2017 06:00:00 PM,48,-122,6,51,57
27715,SpokaneStBridge,02/28/2017 07:00:00 PM,48,-122,3,21,24
27716,SpokaneStBridge,02/28/2017 08:00:00 PM,48,-122,1,9,10
27717,SpokaneStBridge,02/28/2017 09:00:00 PM,48,-122,2,2,4
27718,SpokaneStBridge,02/28/2017 10:00:00 PM,48,-122,3,4,7
27719,SpokaneStBridge,02/28/2017 11:00:00 PM,48,-122,0,1,1
27720,SpokaneStBridge,03/01/2017 12:00:00 AM,48,-122,1,0,1
27721,SpokaneStBridge,03/01/2017 01:00:00 AM,48,-122,2,1,3
27722,SpokaneStBridge,03/01/2017 02:00:00 AM,48,-122,0,1,1
27723,SpokaneStBridge,03/01/2017 03:00:00 AM,48,-122,0,1,1
27724,SpokaneStBridge,03/01/2017 04:00:00 AM,48,-122,2,1,3
27725,SpokaneStBridge,03/01/2017 05:00:00 AM,48,-122,11,0,11
27726,SpokaneStBridge,03/01/2017 06:00:00 AM,48,-122,40,6,46
27727,SpokaneStBridge,03/01/2017 07:00:00 AM,48,-122,76,9,85
27728,SpokaneStBridge,03/01/2017 08:00:00 AM,48,-122,94,10,104
27729,SpokaneStBridge,03/01/2017 09:00:00 AM,48,-122,31,5,36
27730,SpokaneStBridge,03/01/2017 10:00:00 AM,48,-122,10,4,14
27731,SpokaneStBridge,03/01/2017 11:00:00 AM,48,-122,9,5,14
27732,SpokaneStBridge,03/01/2017 12:00:00 PM,48,-122,4,2,6
27733,SpokaneStBridge,03/01/2017 01:00:00 PM,48,-122,6,10,16
27734,SpokaneStBridge,03/01/2017 02:00:00 PM,48,-122,7,8,15
27735,SpokaneStBridge,03/01/2017 03:00:00 PM,48,-122,8,20,28
27736,SpokaneStBridge,03/01/2017 04:00:00 PM,48,-122,11,43,54
27737,SpokaneStBridge,03/01/2017 05:00:00 PM,48,-122,6,93,99
27738,SpokaneStBridge,03/01/2017 06:00:00 PM,48,-122,14,62,76
27739,SpokaneStBridge,03/01/2017 07:00:00 PM,48,-122,5,24,29
27740,SpokaneStBridge,03/01/2017 08:00:00 PM,48,-122,5,8,13
27741,SpokaneStBridge,03/01/2017 09:00:00 PM,48,-122,3,5,8
27742,SpokaneStBridge,03/01/2017 10:00:00 PM,48,-122,2,2,4
27743,SpokaneStBridge,03/01/2017 11:00:00 PM,48,-122,0,4,4
27744,SpokaneStBridge,03/02/2017 12:00:00 AM,48,-122,1,1,2
27745,SpokaneStBridge,03/02/2017 01:00:00 AM,48,-122,1,2,3
27746,SpokaneStBridge,03/02/2017 02:00:00 AM,48,-122,0,3,3
27747,SpokaneStBridge,03/02/2017 03:00:00 AM,48,-122,1,0,1
27748,SpokaneStBridge,03/02/2017 04:00:00 AM,48,-122,2,0,2
27749,SpokaneStBridge,03/02/2017 05:00:00 AM,48,-122,7,0,7
27750,SpokaneStBridge,03/02/2017 06:00:00 AM,48,-122,30,6,36
27751,SpokaneStBridge,03/02/2017 07:00:00 AM,48,-122,80,5,85
27752,SpokaneStBridge,03/02/2017 08:00:00 AM,48,-122,70,11,81
27753,SpokaneStBridge,03/02/2017 09:00:00 AM,48,-122,33,3,36
27754,SpokaneStBridge,03/02/2017 10:00:00 AM,48,-122,15,2,17
27755,SpokaneStBridge,03/02/2017 11:00:00 AM,48,-122,8,4,12
27756,SpokaneStBridge,03/02/2017 12:00:00 PM,48,-122,2,5,7
27757,SpokaneStBridge,03/02/2017 01:00:00 PM,48,-122,8,4,12
27758,SpokaneStBridge,03/02/2017 02:00:00 PM,48,-122,6,4,10
27759,SpokaneStBridge,03/02/2017 03:00:00 PM,48,-122,5,13,18
27760,SpokaneStBridge,03/02/2017 04:00:00 PM,48,-122,8,41,49
27761,SpokaneStBridge,03/02/2017 05:00:00 PM,48,-122,11,71,82
27762,SpokaneStBridge,03/02/2017 06:00:00 PM,48,-122,3,50,53
27763,SpokaneStBridge,03/02/2017 07:00:00 PM,48,-122,3,7,10
27764,SpokaneStBridge,03/02/2017 08:00:00 PM,48,-122,3,9,12
27765,SpokaneStBridge,03/02/2017 09:00:00 PM,48,-122,3,6,9
27766,SpokaneStBridge,03/02/2017 10:00:00 PM,48,-122,1,4,5
27767,SpokaneStBridge,03/02/2017 11:00:00 PM,48,-122,0,3,3
27768,SpokaneStBridge,03/03/2017 12:00:00 AM,48,-122,1,1,2
27769,SpokaneStBridge,03/03/2017 01:00:00 AM,48,-122,1,1,2
27770,SpokaneStBridge,03/03/2017 02:00:00 AM,48,-122,3,0,3
27771,SpokaneStBridge,03/03/2017 03:00:00 AM,48,-122,1,3,4
27772,SpokaneStBridge,03/03/2017 04:00:00 AM,48,-122,2,2,4
27773,SpokaneStBridge,03/03/2017 05:00:00 AM,48,-122,4,1,5
27774,SpokaneStBridge,03/03/2017 06:00:00 AM,48,-122,22,9,31
27775,SpokaneStBridge,03/03/2017 07:00:00 AM,48,-122,53,9,62
27776,SpokaneStBridge,03/03/2017 08:00:00 AM,48,-122,60,3,63
27777,SpokaneStBridge,03/03/2017 09:00:00 AM,48,-122,29,3,32
27778,SpokaneStBridge,03/03/2017 10:00:00 AM,48,-122,6,4,10
27779,SpokaneStBridge,03/03/2017 11:00:00 AM,48,-122,6,1,7
27780,SpokaneStBridge,03/03/2017 12:00:00 PM,48,-122,3,4,7
27781,SpokaneStBridge,03/03/2017 01:00:00 PM,48,-122,2,1,3
27782,SpokaneStBridge,03/03/2017 02:00:00 PM,48,-122,2,8,10
27783,SpokaneStBridge,03/03/2017 03:00:00 PM,48,-122,0,12,12
27784,SpokaneStBridge,03/03/2017 04:00:00 PM,48,-122,4,36,40
27785,SpokaneStBridge,03/03/2017 05:00:00 PM,48,-122,7,39,46
27786,SpokaneStBridge,03/03/2017 06:00:00 PM,48,-122,6,30,36
27787,SpokaneStBridge,03/03/2017 07:00:00 PM,48,-122,2,11,13
27788,SpokaneStBridge,03/03/2017 08:00:00 PM,48,-122,0,6,6
27789,SpokaneStBridge,03/03/2017 09:00:00 PM,48,-122,0,1,1
27790,SpokaneStBridge,03/03/2017 10:00:00 PM,48,-122,2,1,3
27791,SpokaneStBridge,03/03/2017 11:00:00 PM,48,-122,0,0,0
27792,SpokaneStBridge,03/04/2017 12:00:00 AM,48,-122,1,1,2
27793,SpokaneStBridge,03/04/2017 01:00:00 AM,48,-122,0,2,2
27794,SpokaneStBridge,03/04/2017 02:00:00 AM,48,-122,0,0,0
27795,SpokaneStBridge,03/04/2017 03:00:00 AM,48,-122,0,0,0
27796,SpokaneStBridge,03/04/2017 04:00:00 AM,48,-122,2,0,2
27797,SpokaneStBridge,03/04/2017 05:00:00 AM,48,-122,2,0,2
27798,SpokaneStBridge,03/04/2017 06:00:00 AM,48,-122,3,0,3
27799,SpokaneStBridge,03/04/2017 07:00:00 AM,48,-122,14,3,17
27800,SpokaneStBridge,03/04/2017 08:00:00 AM,48,-122,17,6,23
27801,SpokaneStBridge,03/04/2017 09:00:00 AM,48,-122,13,13,26
27802,SpokaneStBridge,03/04/2017 10:00:00 AM,48,-122,21,19,40
27803,SpokaneStBridge,03/04/2017 11:00:00 AM,48,-122,22,18,40
27804,SpokaneStBridge,03/04/2017 12:00:00 PM,48,-122,18,18,36
27805,SpokaneStBridge,03/04/2017 01:00:00 PM,48,-122,30,33,63
27806,SpokaneStBridge,03/04/2017 02:00:00 PM,48,-122,13,22,35
27807,SpokaneStBridge,03/04/2017 03:00:00 PM,48,-122,11,29,40
27808,SpokaneStBridge,03/04/2017 04:00:00 PM,48,-122,11,9,20
27809,SpokaneStBridge,03/04/2017 05:00:00 PM,48,-122,8,14,22
27810,SpokaneStBridge,03/04/2017 06:00:00 PM,48,-122,3,6,9
27811,SpokaneStBridge,03/04/2017 07:00:00 PM,48,-122,2,6,8
27812,SpokaneStBridge,03/04/2017 08:00:00 PM,48,-122,0,2,2
27813,SpokaneStBridge,03/04/2017 09:00:00 PM,48,-122,0,0,0
27814,SpokaneStBridge,03/04/2017 10:00:00 PM,48,-122,0,0,0
27815,SpokaneStBridge,03/04/2017 11:00:00 PM,48,-122,2,3,5
27816,SpokaneStBridge,03/05/2017 12:00:00 AM,48,-122,0,0,0
27817,SpokaneStBridge,03/05/2017 01:00:00 AM,48,-122,2,1,3
27818,SpokaneStBridge,03/05/2017 02:00:00 AM,48,-122,1,0,1
27819,SpokaneStBridge,03/05/2017 03:00:00 AM,48,-122,3,0,3
27820,SpokaneStBridge,03/05/2017 04:00:00 AM,48,-122,3,1,4
27821,SpokaneStBridge,03/05/2017 05:00:00 AM,48,-122,3,0,3
27822,SpokaneStBridge,03/05/2017 06:00:00 AM,48,-122,1,0,1
27823,SpokaneStBridge,03/05/2017 07:00:00 AM,48,-122,1,2,3
27824,SpokaneStBridge,03/05/2017 08:00:00 AM,48,-122,10,0,10
27825,SpokaneStBridge,03/05/2017 09:00:00 AM,48,-122,3,5,8
27826,SpokaneStBridge,03/05/2017 10:00:00 AM,48,-122,17,5,22
27827,SpokaneStBridge,03/05/2017 11:00:00 AM,48,-122,5,7,12
27828,SpokaneStBridge,03/05/2017 12:00:00 PM,48,-122,10,13,23
27829,SpokaneStBridge,03/05/2017 01:00:00 PM,48,-122,4,8,12
27830,SpokaneStBridge,03/05/2017 02:00:00 PM,48,-122,5,5,10
27831,SpokaneStBridge,03/05/2017 03:00:00 PM,48,-122,2,7,9
27832,SpokaneStBridge,03/05/2017 04:00:00 PM,48,-122,7,1,8
27833,SpokaneStBridge,03/05/2017 05:00:00 PM,48,-122,1,2,3
27834,SpokaneStBridge,03/05/2017 06:00:00 PM,48,-122,1,1,2
27835,SpokaneStBridge,03/05/2017 07:00:00 PM,48,-122,0,1,1
27836,SpokaneStBridge,03/05/2017 08:00:00 PM,48,-122,1,1,2
27837,SpokaneStBridge,03/05/2017 09:00:00 PM,48,-122,1,1,2
27838,SpokaneStBridge,03/05/2017 10:00:00 PM,48,-122,1,0,1
27839,SpokaneStBridge,03/05/2017 11:00:00 PM,48,-122,1,2,3
27840,SpokaneStBridge,03/06/2017 12:00:00 AM,48,-122,0,0,0
27841,SpokaneStBridge,03/06/2017 01:00:00 AM,48,-122,0,1,1
27842,SpokaneStBridge,03/06/2017 02:00:00 AM,48,-122,1,1,2
27843,SpokaneStBridge,03/06/2017 03:00:00 AM,48,-122,0,1,1
27844,SpokaneStBridge,03/06/2017 04:00:00 AM,48,-122,3,1,4
27845,SpokaneStBridge,03/06/2017 05:00:00 AM,48,-122,12,5,17
27846,SpokaneStBridge,03/06/2017 06:00:00 AM,48,-122,32,5,37
27847,SpokaneStBridge,03/06/2017 07:00:00 AM,48,-122,79,7,86
27848,SpokaneStBridge,03/06/2017 08:00:00 AM,48,-122,68,12,80
27849,SpokaneStBridge,03/06/2017 09:00:00 AM,48,-122,36,4,40
27850,SpokaneStBridge,03/06/2017 10:00:00 AM,48,-122,14,5,19
27851,SpokaneStBridge,03/06/2017 11:00:00 AM,48,-122,8,1,9
27852,SpokaneStBridge,03/06/2017 12:00:00 PM,48,-122,9,5,14
27853,SpokaneStBridge,03/06/2017 01:00:00 PM,48,-122,5,5,10
27854,SpokaneStBridge,03/06/2017 02:00:00 PM,48,-122,3,5,8
27855,SpokaneStBridge,03/06/2017 03:00:00 PM,48,-122,9,18,27
27856,SpokaneStBridge,03/06/2017 04:00:00 PM,48,-122,10,48,58
27857,SpokaneStBridge,03/06/2017 05:00:00 PM,48,-122,12,91,103
27858,SpokaneStBridge,03/06/2017 06:00:00 PM,48,-122,10,47,57
27859,SpokaneStBridge,03/06/2017 07:00:00 PM,48,-122,3,15,18
27860,SpokaneStBridge,03/06/2017 08:00:00 PM,48,-122,2,8,10
27861,SpokaneStBridge,03/06/2017 09:00:00 PM,48,-122,0,5,5
27862,SpokaneStBridge,03/06/2017 10:00:00 PM,48,-122,2,2,4
27863,SpokaneStBridge,03/06/2017 11:00:00 PM,48,-122,0,0,0
27864,SpokaneStBridge,03/07/2017 12:00:00 AM,48,-122,0,0,0
27865,SpokaneStBridge,03/07/2017 01:00:00 AM,48,-122,0,0,0
27866,SpokaneStBridge,03/07/2017 02:00:00 AM,48,-122,0,1,1
27867,SpokaneStBridge,03/07/2017 03:00:00 AM,48,-122,1,1,2
27868,SpokaneStBridge,03/07/2017 04:00:00 AM,48,-122,2,1,3
27869,SpokaneStBridge,03/07/2017 05:00:00 AM,48,-122,6,3,9
27870,SpokaneStBridge,03/07/2017 06:00:00 AM,48,-122,26,3,29
27871,SpokaneStBridge,03/07/2017 07:00:00 AM,48,-122,69,7,76
27872,SpokaneStBridge,03/07/2017 08:00:00 AM,48,-122,61,3,64
27873,SpokaneStBridge,03/07/2017 09:00:00 AM,48,-122,23,3,26
27874,SpokaneStBridge,03/07/2017 10:00:00 AM,48,-122,5,0,5
27875,SpokaneStBridge,03/07/2017 11:00:00 AM,48,-122,2,3,5
27876,SpokaneStBridge,03/07/2017 12:00:00 PM,48,-122,3,1,4
27877,SpokaneStBridge,03/07/2017 01:00:00 PM,48,-122,6,3,9
27878,SpokaneStBridge,03/07/2017 02:00:00 PM,48,-122,1,3,4
27879,SpokaneStBridge,03/07/2017 03:00:00 PM,48,-122,4,9,13
27880,SpokaneStBridge,03/07/2017 04:00:00 PM,48,-122,7,37,44
27881,SpokaneStBridge,03/07/2017 05:00:00 PM,48,-122,7,62,69
27882,SpokaneStBridge,03/07/2017 06:00:00 PM,48,-122,5,54,59
27883,SpokaneStBridge,03/07/2017 07:00:00 PM,48,-122,1,14,15
27884,SpokaneStBridge,03/07/2017 08:00:00 PM,48,-122,2,8,10
27885,SpokaneStBridge,03/07/2017 09:00:00 PM,48,-122,0,2,2
27886,SpokaneStBridge,03/07/2017 10:00:00 PM,48,-122,0,2,2
27887,SpokaneStBridge,03/07/2017 11:00:00 PM,48,-122,0,0,0
27888,SpokaneStBridge,03/08/2017 12:00:00 AM,48,-122,2,1,3
27889,SpokaneStBridge,03/08/2017 01:00:00 AM,48,-122,0,2,2
27890,SpokaneStBridge,03/08/2017 02:00:00 AM,48,-122,0,0,0
27891,SpokaneStBridge,03/08/2017 03:00:00 AM,48,-122,1,0,1
27892,SpokaneStBridge,03/08/2017 04:00:00 AM,48,-122,5,2,7
27893,SpokaneStBridge,03/08/2017 05:00:00 AM,48,-122,13,2,15
27894,SpokaneStBridge,03/08/2017 06:00:00 AM,48,-122,30,6,36
27895,SpokaneStBridge,03/08/2017 07:00:00 AM,48,-122,73,10,83
27896,SpokaneStBridge,03/08/2017 08:00:00 AM,48,-122,93,4,97
27897,SpokaneStBridge,03/08/2017 09:00:00 AM,48,-122,27,3,30
27898,SpokaneStBridge,03/08/2017 10:00:00 AM,48,-122,9,3,12
27899,SpokaneStBridge,03/08/2017 11:00:00 AM,48,-122,6,3,9
27900,SpokaneStBridge,03/08/2017 12:00:00 PM,48,-122,1,4,5
27901,SpokaneStBridge,03/08/2017 01:00:00 PM,48,-122,6,6,12
27902,SpokaneStBridge,03/08/2017 02:00:00 PM,48,-122,10,9,19
27903,SpokaneStBridge,03/08/2017 03:00:00 PM,48,-122,7,14,21
27904,SpokaneStBridge,03/08/2017 04:00:00 PM,48,-122,8,35,43
27905,SpokaneStBridge,03/08/2017 05:00:00 PM,48,-122,8,75,83
27906,SpokaneStBridge,03/08/2017 06:00:00 PM,48,-122,8,51,59
27907,SpokaneStBridge,03/08/2017 07:00:00 PM,48,-122,2,19,21
27908,SpokaneStBridge,03/08/2017 08:00:00 PM,48,-122,2,10,12
27909,SpokaneStBridge,03/08/2017 09:00:00 PM,48,-122,3,4,7
27910,SpokaneStBridge,03/08/2017 10:00:00 PM,48,-122,1,1,2
27911,SpokaneStBridge,03/08/2017 11:00:00 PM,48,-122,0,0,0
27912,SpokaneStBridge,03/09/2017 12:00:00 AM,48,-122,1,1,2
27913,SpokaneStBridge,03/09/2017 01:00:00 AM,48,-122,0,0,0
27914,SpokaneStBridge,03/09/2017 02:00:00 AM,48,-122,0,0,0
27915,SpokaneStBridge,03/09/2017 03:00:00 AM,48,-122,1,0,1
27916,SpokaneStBridge,03/09/2017 04:00:00 AM,48,-122,2,0,2
27917,SpokaneStBridge,03/09/2017 05:00:00 AM,48,-122,6,2,8
27918,SpokaneStBridge,03/09/2017 06:00:00 AM,48,-122,29,4,33
27919,SpokaneStBridge,03/09/2017 07:00:00 AM,48,-122,64,5,69
27920,SpokaneStBridge,03/09/2017 08:00:00 AM,48,-122,68,1,69
27921,SpokaneStBridge,03/09/2017 09:00:00 AM,48,-122,19,3,22
27922,SpokaneStBridge,03/09/2017 10:00:00 AM,48,-122,11,1,12
27923,SpokaneStBridge,03/09/2017 11:00:00 AM,48,-122,1,4,5
27924,SpokaneStBridge,03/09/2017 12:00:00 PM,48,-122,3,3,6
27925,SpokaneStBridge,03/09/2017 01:00:00 PM,48,-122,3,3,6
27926,SpokaneStBridge,03/09/2017 02:00:00 PM,48,-122,2,0,2
27927,SpokaneStBridge,03/09/2017 03:00:00 PM,48,-122,3,10,13
27928,SpokaneStBridge,03/09/2017 04:00:00 PM,48,-122,11,44,55
27929,SpokaneStBridge,03/09/2017 05:00:00 PM,48,-122,5,67,72
27930,SpokaneStBridge,03/09/2017 06:00:00 PM,48,-122,5,43,48
27931,SpokaneStBridge,03/09/2017 07:00:00 PM,48,-122,6,19,25
27932,SpokaneStBridge,03/09/2017 08:00:00 PM,48,-122,2,1,3
27933,SpokaneStBridge,03/09/2017 09:00:00 PM,48,-122,0,6,6
27934,SpokaneStBridge,03/09/2017 10:00:00 PM,48,-122,1,2,3
27935,SpokaneStBridge,03/09/2017 11:00:00 PM,48,-122,0,3,3
27936,SpokaneStBridge,03/10/2017 12:00:00 AM,48,-122,1,1,2
27937,SpokaneStBridge,03/10/2017 01:00:00 AM,48,-122,2,0,2
27938,SpokaneStBridge,03/10/2017 02:00:00 AM,48,-122,0,4,4
27939,SpokaneStBridge,03/10/2017 03:00:00 AM,48,-122,0,1,1
27940,SpokaneStBridge,03/10/2017 04:00:00 AM,48,-122,1,0,1
27941,SpokaneStBridge,03/10/2017 05:00:00 AM,48,-122,6,3,9
27942,SpokaneStBridge,03/10/2017 06:00:00 AM,48,-122,22,3,25
27943,SpokaneStBridge,03/10/2017 07:00:00 AM,48,-122,50,7,57
27944,SpokaneStBridge,03/10/2017 08:00:00 AM,48,-122,56,4,60
27945,SpokaneStBridge,03/10/2017 09:00:00 AM,48,-122,18,4,22
27946,SpokaneStBridge,03/10/2017 10:00:00 AM,48,-122,8,2,10
27947,SpokaneStBridge,03/10/2017 11:00:00 AM,48,-122,10,2,12
27948,SpokaneStBridge,03/10/2017 12:00:00 PM,48,-122,5,3,8
27949,SpokaneStBridge,03/10/2017 01:00:00 PM,48,-122,3,7,10
27950,SpokaneStBridge,03/10/2017 02:00:00 PM,48,-122,13,9,22
27951,SpokaneStBridge,03/10/2017 03:00:00 PM,48,-122,9,12,21
27952,SpokaneStBridge,03/10/2017 04:00:00 PM,48,-122,8,35,43
27953,SpokaneStBridge,03/10/2017 05:00:00 PM,48,-122,5,51,56
27954,SpokaneStBridge,03/10/2017 06:00:00 PM,48,-122,3,37,40
27955,SpokaneStBridge,03/10/2017 07:00:00 PM,48,-122,3,21,24
27956,SpokaneStBridge,03/10/2017 08:00:00 PM,48,-122,3,5,8
27957,SpokaneStBridge,03/10/2017 09:00:00 PM,48,-122,2,5,7
27958,SpokaneStBridge,03/10/2017 10:00:00 PM,48,-122,1,0,1
27959,SpokaneStBridge,03/10/2017 11:00:00 PM,48,-122,4,1,5
27960,SpokaneStBridge,03/11/2017 12:00:00 AM,48,-122,2,2,4
27961,SpokaneStBridge,03/11/2017 01:00:00 AM,48,-122,0,0,0
27962,SpokaneStBridge,03/11/2017 02:00:00 AM,48,-122,1,0,1
27963,SpokaneStBridge,03/11/2017 03:00:00 AM,48,-122,1,1,2
27964,SpokaneStBridge,03/11/2017 04:00:00 AM,48,-122,1,0,1
27965,SpokaneStBridge,03/11/2017 05:00:00 AM,48,-122,1,1,2
27966,SpokaneStBridge,03/11/2017 06:00:00 AM,48,-122,4,0,4
27967,SpokaneStBridge,03/11/2017 07:00:00 AM,48,-122,9,3,12
27968,SpokaneStBridge,03/11/2017 08:00:00 AM,48,-122,7,5,12
27969,SpokaneStBridge,03/11/2017 09:00:00 AM,48,-122,2,6,8
27970,SpokaneStBridge,03/11/2017 10:00:00 AM,48,-122,5,1,6
27971,SpokaneStBridge,03/11/2017 11:00:00 AM,48,-122,2,2,4
27972,SpokaneStBridge,03/11/2017 12:00:00 PM,48,-122,1,2,3
27973,SpokaneStBridge,03/11/2017 01:00:00 PM,48,-122,2,1,3
27974,SpokaneStBridge,03/11/2017 02:00:00 PM,48,-122,3,3,6
27975,SpokaneStBridge,03/11/2017 03:00:00 PM,48,-122,3,7,10
27976,SpokaneStBridge,03/11/2017 04:00:00 PM,48,-122,3,8,11
27977,SpokaneStBridge,03/11/2017 05:00:00 PM,48,-122,6,7,13
27978,SpokaneStBridge,03/11/2017 06:00:00 PM,48,-122,3,6,9
27979,SpokaneStBridge,03/11/2017 07:00:00 PM,48,-122,3,2,5
27980,SpokaneStBridge,03/11/2017 08:00:00 PM,48,-122,1,3,4
27981,SpokaneStBridge,03/11/2017 09:00:00 PM,48,-122,0,1,1
27982,SpokaneStBridge,03/11/2017 10:00:00 PM,48,-122,0,1,1
27983,SpokaneStBridge,03/11/2017 11:00:00 PM,48,-122,0,0,0
27984,SpokaneStBridge,03/12/2017 12:00:00 AM,48,-122,0,1,1
27985,SpokaneStBridge,03/12/2017 01:00:00 AM,48,-122,1,0,1
27986,SpokaneStBridge,03/12/2017 02:00:00 AM,48,-122,0,0,0
27987,SpokaneStBridge,03/12/2017 03:00:00 AM,48,-122,0,0,0
27988,SpokaneStBridge,03/12/2017 04:00:00 AM,48,-122,2,0,2
27989,SpokaneStBridge,03/12/2017 05:00:00 AM,48,-122,4,1,5
27990,SpokaneStBridge,03/12/2017 06:00:00 AM,48,-122,2,0,2
27991,SpokaneStBridge,03/12/2017 07:00:00 AM,48,-122,2,1,3
27992,SpokaneStBridge,03/12/2017 08:00:00 AM,48,-122,8,2,10
27993,SpokaneStBridge,03/12/2017 09:00:00 AM,48,-122,1,9,10
27994,SpokaneStBridge,03/12/2017 10:00:00 AM,48,-122,11,10,21
27995,SpokaneStBridge,03/12/2017 11:00:00 AM,48,-122,8,11,19
27996,SpokaneStBridge,03/12/2017 12:00:00 PM,48,-122,9,5,14
27997,SpokaneStBridge,03/12/2017 01:00:00 PM,48,-122,13,6,19
27998,SpokaneStBridge,03/12/2017 02:00:00 PM,48,-122,5,5,10
27999,SpokaneStBridge,03/12/2017 03:00:00 PM,48,-122,6,17,23
28000,SpokaneStBridge,03/12/2017 04:00:00 PM,48,-122,6,6,12
28001,SpokaneStBridge,03/12/2017 05:00:00 PM,48,-122,6,9,15
28002,SpokaneStBridge,03/12/2017 06:00:00 PM,48,-122,12,6,18
28003,SpokaneStBridge,03/12/2017 07:00:00 PM,48,-122,1,2,3
28004,SpokaneStBridge,03/12/2017 08:00:00 PM,48,-122,0,1,1
28005,SpokaneStBridge,03/12/2017 09:00:00 PM,48,-122,0,3,3
28006,SpokaneStBridge,03/12/2017 10:00:00 PM,48,-122,1,2,3
28007,SpokaneStBridge,03/12/2017 11:00:00 PM,48,-122,0,2,2
28008,SpokaneStBridge,03/13/2017 12:00:00 AM,48,-122,0,1,1
28009,SpokaneStBridge,03/13/2017 01:00:00 AM,48,-122,2,0,2
28010,SpokaneStBridge,03/13/2017 02:00:00 AM,48,-122,2,0,2
28011,SpokaneStBridge,03/13/2017 03:00:00 AM,48,-122,0,0,0
28012,SpokaneStBridge,03/13/2017 04:00:00 AM,48,-122,6,1,7
28013,SpokaneStBridge,03/13/2017 05:00:00 AM,48,-122,6,2,8
28014,SpokaneStBridge,03/13/2017 06:00:00 AM,48,-122,19,6,25
28015,SpokaneStBridge,03/13/2017 07:00:00 AM,48,-122,46,10,56
28016,SpokaneStBridge,03/13/2017 08:00:00 AM,48,-122,69,10,79
28017,SpokaneStBridge,03/13/2017 09:00:00 AM,48,-122,32,2,34
28018,SpokaneStBridge,03/13/2017 10:00:00 AM,48,-122,6,2,8
28019,SpokaneStBridge,03/13/2017 11:00:00 AM,48,-122,3,0,3
28020,SpokaneStBridge,03/13/2017 12:00:00 PM,48,-122,4,5,9
28021,SpokaneStBridge,03/13/2017 01:00:00 PM,48,-122,3,4,7
28022,SpokaneStBridge,03/13/2017 02:00:00 PM,48,-122,1,5,6
28023,SpokaneStBridge,03/13/2017 03:00:00 PM,48,-122,7,12,19
28024,SpokaneStBridge,03/13/2017 04:00:00 PM,48,-122,6,32,38
28025,SpokaneStBridge,03/13/2017 05:00:00 PM,48,-122,8,70,78
28026,SpokaneStBridge,03/13/2017 06:00:00 PM,48,-122,4,48,52
28027,SpokaneStBridge,03/13/2017 07:00:00 PM,48,-122,2,19,21
28028,SpokaneStBridge,03/13/2017 08:00:00 PM,48,-122,3,4,7
28029,SpokaneStBridge,03/13/2017 09:00:00 PM,48,-122,0,1,1
28030,SpokaneStBridge,03/13/2017 10:00:00 PM,48,-122,0,1,1
28031,SpokaneStBridge,03/13/2017 11:00:00 PM,48,-122,0,0,0
28032,SpokaneStBridge,03/14/2017 12:00:00 AM,48,-122,0,0,0
28033,SpokaneStBridge,03/14/2017 01:00:00 AM,48,-122,1,1,2
28034,SpokaneStBridge,03/14/2017 02:00:00 AM,48,-122,1,1,2
28035,SpokaneStBridge,03/14/2017 03:00:00 AM,48,-122,0,1,1
28036,SpokaneStBridge,03/14/2017 04:00:00 AM,48,-122,2,0,2
28037,SpokaneStBridge,03/14/2017 05:00:00 AM,48,-122,9,1,10
28038,SpokaneStBridge,03/14/2017 06:00:00 AM,48,-122,25,8,33
28039,SpokaneStBridge,03/14/2017 07:00:00 AM,48,-122,61,7,68
28040,SpokaneStBridge,03/14/2017 08:00:00 AM,48,-122,81,5,86
28041,SpokaneStBridge,03/14/2017 09:00:00 AM,48,-122,42,4,46
28042,SpokaneStBridge,03/14/2017 10:00:00 AM,48,-122,7,1,8
28043,SpokaneStBridge,03/14/2017 11:00:00 AM,48,-122,6,4,10
28044,SpokaneStBridge,03/14/2017 12:00:00 PM,48,-122,3,8,11
28045,SpokaneStBridge,03/14/2017 01:00:00 PM,48,-122,6,2,8
28046,SpokaneStBridge,03/14/2017 02:00:00 PM,48,-122,5,4,9
28047,SpokaneStBridge,03/14/2017 03:00:00 PM,48,-122,8,17,25
28048,SpokaneStBridge,03/14/2017 04:00:00 PM,48,-122,12,39,51
28049,SpokaneStBridge,03/14/2017 05:00:00 PM,48,-122,7,88,95
28050,SpokaneStBridge,03/14/2017 06:00:00 PM,48,-122,5,48,53
28051,SpokaneStBridge,03/14/2017 07:00:00 PM,48,-122,3,24,27
28052,SpokaneStBridge,03/14/2017 08:00:00 PM,48,-122,4,7,11
28053,SpokaneStBridge,03/14/2017 09:00:00 PM,48,-122,2,5,7
28054,SpokaneStBridge,03/14/2017 10:00:00 PM,48,-122,1,3,4
28055,SpokaneStBridge,03/14/2017 11:00:00 PM,48,-122,0,1,1
28056,SpokaneStBridge,03/15/2017 12:00:00 AM,48,-122,3,1,4
28057,SpokaneStBridge,03/15/2017 01:00:00 AM,48,-122,1,0,1
28058,SpokaneStBridge,03/15/2017 02:00:00 AM,48,-122,0,2,2
28059,SpokaneStBridge,03/15/2017 03:00:00 AM,48,-122,0,1,1
28060,SpokaneStBridge,03/15/2017 04:00:00 AM,48,-122,0,2,2
28061,SpokaneStBridge,03/15/2017 05:00:00 AM,48,-122,10,1,11
28062,SpokaneStBridge,03/15/2017 06:00:00 AM,48,-122,24,5,29
28063,SpokaneStBridge,03/15/2017 07:00:00 AM,48,-122,58,10,68
28064,SpokaneStBridge,03/15/2017 08:00:00 AM,48,-122,56,6,62
28065,SpokaneStBridge,03/15/2017 09:00:00 AM,48,-122,20,4,24
28066,SpokaneStBridge,03/15/2017 10:00:00 AM,48,-122,8,3,11
28067,SpokaneStBridge,03/15/2017 11:00:00 AM,48,-122,6,0,6
28068,SpokaneStBridge,03/15/2017 12:00:00 PM,48,-122,2,2,4
28069,SpokaneStBridge,03/15/2017 01:00:00 PM,48,-122,7,1,8
28070,SpokaneStBridge,03/15/2017 02:00:00 PM,48,-122,5,7,12
28071,SpokaneStBridge,03/15/2017 03:00:00 PM,48,-122,3,15,18
28072,SpokaneStBridge,03/15/2017 04:00:00 PM,48,-122,7,34,41
28073,SpokaneStBridge,03/15/2017 05:00:00 PM,48,-122,5,57,62
28074,SpokaneStBridge,03/15/2017 06:00:00 PM,48,-122,5,54,59
28075,SpokaneStBridge,03/15/2017 07:00:00 PM,48,-122,2,16,18
28076,SpokaneStBridge,03/15/2017 08:00:00 PM,48,-122,5,6,11
28077,SpokaneStBridge,03/15/2017 09:00:00 PM,48,-122,0,7,7
28078,SpokaneStBridge,03/15/2017 10:00:00 PM,48,-122,1,0,1
28079,SpokaneStBridge,03/15/2017 11:00:00 PM,48,-122,1,1,2
28080,SpokaneStBridge,03/16/2017 12:00:00 AM,48,-122,1,3,4
28081,SpokaneStBridge,03/16/2017 01:00:00 AM,48,-122,0,1,1
28082,SpokaneStBridge,03/16/2017 02:00:00 AM,48,-122,1,2,3
28083,SpokaneStBridge,03/16/2017 03:00:00 AM,48,-122,2,2,4
28084,SpokaneStBridge,03/16/2017 04:00:00 AM,48,-122,1,0,1
28085,SpokaneStBridge,03/16/2017 05:00:00 AM,48,-122,16,5,21
28086,SpokaneStBridge,03/16/2017 06:00:00 AM,48,-122,33,9,42
28087,SpokaneStBridge,03/16/2017 07:00:00 AM,48,-122,81,9,90
28088,SpokaneStBridge,03/16/2017 08:00:00 AM,48,-122,86,7,93
28089,SpokaneStBridge,03/16/2017 09:00:00 AM,48,-122,39,4,43
28090,SpokaneStBridge,03/16/2017 10:00:00 AM,48,-122,10,5,15
28091,SpokaneStBridge,03/16/2017 11:00:00 AM,48,-122,8,7,15
28092,SpokaneStBridge,03/16/2017 12:00:00 PM,48,-122,12,6,18
28093,SpokaneStBridge,03/16/2017 01:00:00 PM,48,-122,13,9,22
28094,SpokaneStBridge,03/16/2017 02:00:00 PM,48,-122,9,20,29
28095,SpokaneStBridge,03/16/2017 03:00:00 PM,48,-122,12,18,30
28096,SpokaneStBridge,03/16/2017 04:00:00 PM,48,-122,14,63,77
28097,SpokaneStBridge,03/16/2017 05:00:00 PM,48,-122,22,101,123
28098,SpokaneStBridge,03/16/2017 06:00:00 PM,48,-122,8,61,69
28099,SpokaneStBridge,03/16/2017 07:00:00 PM,48,-122,7,21,28
28100,SpokaneStBridge,03/16/2017 08:00:00 PM,48,-122,4,10,14
28101,SpokaneStBridge,03/16/2017 09:00:00 PM,48,-122,6,11,17
28102,SpokaneStBridge,03/16/2017 10:00:00 PM,48,-122,1,0,1
28103,SpokaneStBridge,03/16/2017 11:00:00 PM,48,-122,3,1,4
28104,SpokaneStBridge,03/17/2017 12:00:00 AM,48,-122,0,1,1
28105,SpokaneStBridge,03/17/2017 01:00:00 AM,48,-122,0,0,0
28106,SpokaneStBridge,03/17/2017 02:00:00 AM,48,-122,0,3,3
28107,SpokaneStBridge,03/17/2017 03:00:00 AM,48,-122,1,1,2
28108,SpokaneStBridge,03/17/2017 04:00:00 AM,48,-122,1,0,1
28109,SpokaneStBridge,03/17/2017 05:00:00 AM,48,-122,4,3,7
28110,SpokaneStBridge,03/17/2017 06:00:00 AM,48,-122,32,4,36
28111,SpokaneStBridge,03/17/2017 07:00:00 AM,48,-122,53,5,58
28112,SpokaneStBridge,03/17/2017 08:00:00 AM,48,-122,83,5,88
28113,SpokaneStBridge,03/17/2017 09:00:00 AM,48,-122,28,4,32
28114,SpokaneStBridge,03/17/2017 10:00:00 AM,48,-122,11,1,12
28115,SpokaneStBridge,03/17/2017 11:00:00 AM,48,-122,10,6,16
28116,SpokaneStBridge,03/17/2017 12:00:00 PM,48,-122,4,7,11
28117,SpokaneStBridge,03/17/2017 01:00:00 PM,48,-122,1,3,4
28118,SpokaneStBridge,03/17/2017 02:00:00 PM,48,-122,4,7,11
28119,SpokaneStBridge,03/17/2017 03:00:00 PM,48,-122,0,12,12
28120,SpokaneStBridge,03/17/2017 04:00:00 PM,48,-122,6,45,51
28121,SpokaneStBridge,03/17/2017 05:00:00 PM,48,-122,3,55,58
28122,SpokaneStBridge,03/17/2017 06:00:00 PM,48,-122,2,31,33
28123,SpokaneStBridge,03/17/2017 07:00:00 PM,48,-122,2,6,8
28124,SpokaneStBridge,03/17/2017 08:00:00 PM,48,-122,1,2,3
28125,SpokaneStBridge,03/17/2017 09:00:00 PM,48,-122,0,4,4
28126,SpokaneStBridge,03/17/2017 10:00:00 PM,48,-122,0,0,0
28127,SpokaneStBridge,03/17/2017 11:00:00 PM,48,-122,2,0,2
28128,SpokaneStBridge,03/18/2017 12:00:00 AM,48,-122,1,0,1
28129,SpokaneStBridge,03/18/2017 01:00:00 AM,48,-122,0,0,0
28130,SpokaneStBridge,03/18/2017 02:00:00 AM,48,-122,0,0,0
28131,SpokaneStBridge,03/18/2017 03:00:00 AM,48,-122,1,1,2
28132,SpokaneStBridge,03/18/2017 04:00:00 AM,48,-122,1,0,1
28133,SpokaneStBridge,03/18/2017 05:00:00 AM,48,-122,1,0,1
28134,SpokaneStBridge,03/18/2017 06:00:00 AM,48,-122,1,0,1
28135,SpokaneStBridge,03/18/2017 07:00:00 AM,48,-122,1,1,2
28136,SpokaneStBridge,03/18/2017 08:00:00 AM,48,-122,1,0,1
28137,SpokaneStBridge,03/18/2017 09:00:00 AM,48,-122,1,1,2
28138,SpokaneStBridge,03/18/2017 10:00:00 AM,48,-122,1,2,3
28139,SpokaneStBridge,03/18/2017 11:00:00 AM,48,-122,2,0,2
28140,SpokaneStBridge,03/18/2017 12:00:00 PM,48,-122,1,1,2
28141,SpokaneStBridge,03/18/2017 01:00:00 PM,48,-122,5,4,9
28142,SpokaneStBridge,03/18/2017 02:00:00 PM,48,-122,9,8,17
28143,SpokaneStBridge,03/18/2017 03:00:00 PM,48,-122,10,1,11
28144,SpokaneStBridge,03/18/2017 04:00:00 PM,48,-122,8,12,20
28145,SpokaneStBridge,03/18/2017 05:00:00 PM,48,-122,6,9,15
28146,SpokaneStBridge,03/18/2017 06:00:00 PM,48,-122,3,7,10
28147,SpokaneStBridge,03/18/2017 07:00:00 PM,48,-122,3,0,3
28148,SpokaneStBridge,03/18/2017 08:00:00 PM,48,-122,2,3,5
28149,SpokaneStBridge,03/18/2017 09:00:00 PM,48,-122,1,1,2
28150,SpokaneStBridge,03/18/2017 10:00:00 PM,48,-122,3,3,6
28151,SpokaneStBridge,03/18/2017 11:00:00 PM,48,-122,2,1,3
28152,SpokaneStBridge,03/19/2017 12:00:00 AM,48,-122,0,1,1
28153,SpokaneStBridge,03/19/2017 01:00:00 AM,48,-122,1,0,1
28154,SpokaneStBridge,03/19/2017 02:00:00 AM,48,-122,0,0,0
28155,SpokaneStBridge,03/19/2017 03:00:00 AM,48,-122,1,2,3
28156,SpokaneStBridge,03/19/2017 04:00:00 AM,48,-122,0,2,2
28157,SpokaneStBridge,03/19/2017 05:00:00 AM,48,-122,4,0,4
28158,SpokaneStBridge,03/19/2017 06:00:00 AM,48,-122,2,0,2
28159,SpokaneStBridge,03/19/2017 07:00:00 AM,48,-122,2,0,2
28160,SpokaneStBridge,03/19/2017 08:00:00 AM,48,-122,16,9,25
28161,SpokaneStBridge,03/19/2017 09:00:00 AM,48,-122,16,13,29
28162,SpokaneStBridge,03/19/2017 10:00:00 AM,48,-122,17,19,36
28163,SpokaneStBridge,03/19/2017 11:00:00 AM,48,-122,28,35,63
28164,SpokaneStBridge,03/19/2017 12:00:00 PM,48,-122,48,43,91
28165,SpokaneStBridge,03/19/2017 01:00:00 PM,48,-122,42,48,90
28166,SpokaneStBridge,03/19/2017 02:00:00 PM,48,-122,46,41,87
28167,SpokaneStBridge,03/19/2017 03:00:00 PM,48,-122,29,40,69
28168,SpokaneStBridge,03/19/2017 04:00:00 PM,48,-122,31,36,67
28169,SpokaneStBridge,03/19/2017 05:00:00 PM,48,-122,32,25,57
28170,SpokaneStBridge,03/19/2017 06:00:00 PM,48,-122,16,16,32
28171,SpokaneStBridge,03/19/2017 07:00:00 PM,48,-122,6,4,10
28172,SpokaneStBridge,03/19/2017 08:00:00 PM,48,-122,3,3,6
28173,SpokaneStBridge,03/19/2017 09:00:00 PM,48,-122,0,5,5
28174,SpokaneStBridge,03/19/2017 10:00:00 PM,48,-122,1,0,1
28175,SpokaneStBridge,03/19/2017 11:00:00 PM,48,-122,0,0,0
28176,SpokaneStBridge,03/20/2017 12:00:00 AM,48,-122,4,1,5
28177,SpokaneStBridge,03/20/2017 01:00:00 AM,48,-122,0,2,2
28178,SpokaneStBridge,03/20/2017 02:00:00 AM,48,-122,2,2,4
28179,SpokaneStBridge,03/20/2017 03:00:00 AM,48,-122,1,1,2
28180,SpokaneStBridge,03/20/2017 04:00:00 AM,48,-122,3,2,5
28181,SpokaneStBridge,03/20/2017 05:00:00 AM,48,-122,11,3,14
28182,SpokaneStBridge,03/20/2017 06:00:00 AM,48,-122,22,8,30
28183,SpokaneStBridge,03/20/2017 07:00:00 AM,48,-122,124,7,131
28184,SpokaneStBridge,03/20/2017 08:00:00 AM,48,-122,114,8,122
28185,SpokaneStBridge,03/20/2017 09:00:00 AM,48,-122,42,10,52
28186,SpokaneStBridge,03/20/2017 10:00:00 AM,48,-122,18,8,26
28187,SpokaneStBridge,03/20/2017 11:00:00 AM,48,-122,12,4,16
28188,SpokaneStBridge,03/20/2017 12:00:00 PM,48,-122,15,7,22
28189,SpokaneStBridge,03/20/2017 01:00:00 PM,48,-122,8,9,17
28190,SpokaneStBridge,03/20/2017 02:00:00 PM,48,-122,14,14,28
28191,SpokaneStBridge,03/20/2017 03:00:00 PM,48,-122,8,22,30
28192,SpokaneStBridge,03/20/2017 04:00:00 PM,48,-122,8,73,81
28193,SpokaneStBridge,03/20/2017 05:00:00 PM,48,-122,8,114,122
28194,SpokaneStBridge,03/20/2017 06:00:00 PM,48,-122,11,74,85
28195,SpokaneStBridge,03/20/2017 07:00:00 PM,48,-122,7,20,27
28196,SpokaneStBridge,03/20/2017 08:00:00 PM,48,-122,2,10,12
28197,SpokaneStBridge,03/20/2017 09:00:00 PM,48,-122,0,10,10
28198,SpokaneStBridge,03/20/2017 10:00:00 PM,48,-122,2,3,5
28199,SpokaneStBridge,03/20/2017 11:00:00 PM,48,-122,3,2,5
28200,SpokaneStBridge,03/21/2017 12:00:00 AM,48,-122,0,1,1
28201,SpokaneStBridge,03/21/2017 01:00:00 AM,48,-122,0,0,0
28202,SpokaneStBridge,03/21/2017 02:00:00 AM,48,-122,1,0,1
28203,SpokaneStBridge,03/21/2017 03:00:00 AM,48,-122,1,1,2
28204,SpokaneStBridge,03/21/2017 04:00:00 AM,48,-122,2,1,3
28205,SpokaneStBridge,03/21/2017 05:00:00 AM,48,-122,9,2,11
28206,SpokaneStBridge,03/21/2017 06:00:00 AM,48,-122,24,8,32
28207,SpokaneStBridge,03/21/2017 07:00:00 AM,48,-122,67,10,77
28208,SpokaneStBridge,03/21/2017 08:00:00 AM,48,-122,78,8,86
28209,SpokaneStBridge,03/21/2017 09:00:00 AM,48,-122,28,3,31
28210,SpokaneStBridge,03/21/2017 10:00:00 AM,48,-122,16,2,18
28211,SpokaneStBridge,03/21/2017 11:00:00 AM,48,-122,4,5,9
28212,SpokaneStBridge,03/21/2017 12:00:00 PM,48,-122,6,6,12
28213,SpokaneStBridge,03/21/2017 01:00:00 PM,48,-122,6,6,12
28214,SpokaneStBridge,03/21/2017 02:00:00 PM,48,-122,5,8,13
28215,SpokaneStBridge,03/21/2017 03:00:00 PM,48,-122,7,12,19
28216,SpokaneStBridge,03/21/2017 04:00:00 PM,48,-122,7,39,46
28217,SpokaneStBridge,03/21/2017 05:00:00 PM,48,-122,19,87,106
28218,SpokaneStBridge,03/21/2017 06:00:00 PM,48,-122,5,51,56
28219,SpokaneStBridge,03/21/2017 07:00:00 PM,48,-122,2,25,27
28220,SpokaneStBridge,03/21/2017 08:00:00 PM,48,-122,1,8,9
28221,SpokaneStBridge,03/21/2017 09:00:00 PM,48,-122,5,5,10
28222,SpokaneStBridge,03/21/2017 10:00:00 PM,48,-122,0,1,1
28223,SpokaneStBridge,03/21/2017 11:00:00 PM,48,-122,0,1,1
28224,SpokaneStBridge,03/22/2017 12:00:00 AM,48,-122,1,2,3
28225,SpokaneStBridge,03/22/2017 01:00:00 AM,48,-122,0,0,0
28226,SpokaneStBridge,03/22/2017 02:00:00 AM,48,-122,0,1,1
28227,SpokaneStBridge,03/22/2017 03:00:00 AM,48,-122,1,1,2
28228,SpokaneStBridge,03/22/2017 04:00:00 AM,48,-122,1,2,3
28229,SpokaneStBridge,03/22/2017 05:00:00 AM,48,-122,7,3,10
28230,SpokaneStBridge,03/22/2017 06:00:00 AM,48,-122,33,8,41
28231,SpokaneStBridge,03/22/2017 07:00:00 AM,48,-122,94,7,101
28232,SpokaneStBridge,03/22/2017 08:00:00 AM,48,-122,84,12,96
28233,SpokaneStBridge,03/22/2017 09:00:00 AM,48,-122,33,6,39
28234,SpokaneStBridge,03/22/2017 10:00:00 AM,48,-122,16,2,18
28235,SpokaneStBridge,03/22/2017 11:00:00 AM,48,-122,11,7,18
28236,SpokaneStBridge,03/22/2017 12:00:00 PM,48,-122,2,5,7
28237,SpokaneStBridge,03/22/2017 01:00:00 PM,48,-122,7,4,11
28238,SpokaneStBridge,03/22/2017 02:00:00 PM,48,-122,10,17,27
28239,SpokaneStBridge,03/22/2017 03:00:00 PM,48,-122,7,20,27
28240,SpokaneStBridge,03/22/2017 04:00:00 PM,48,-122,13,45,58
28241,SpokaneStBridge,03/22/2017 05:00:00 PM,48,-122,7,94,101
28242,SpokaneStBridge,03/22/2017 06:00:00 PM,48,-122,7,69,76
28243,SpokaneStBridge,03/22/2017 07:00:00 PM,48,-122,7,21,28
28244,SpokaneStBridge,03/22/2017 08:00:00 PM,48,-122,5,13,18
28245,SpokaneStBridge,03/22/2017 09:00:00 PM,48,-122,1,9,10
28246,SpokaneStBridge,03/22/2017 10:00:00 PM,48,-122,1,2,3
28247,SpokaneStBridge,03/22/2017 11:00:00 PM,48,-122,0,1,1
28248,SpokaneStBridge,03/23/2017 12:00:00 AM,48,-122,2,1,3
28249,SpokaneStBridge,03/23/2017 01:00:00 AM,48,-122,0,0,0
28250,SpokaneStBridge,03/23/2017 02:00:00 AM,48,-122,0,1,1
28251,SpokaneStBridge,03/23/2017 03:00:00 AM,48,-122,3,2,5
28252,SpokaneStBridge,03/23/2017 04:00:00 AM,48,-122,0,0,0
28253,SpokaneStBridge,03/23/2017 05:00:00 AM,48,-122,16,6,22
28254,SpokaneStBridge,03/23/2017 06:00:00 AM,48,-122,43,7,50
28255,SpokaneStBridge,03/23/2017 07:00:00 AM,48,-122,95,8,103
28256,SpokaneStBridge,03/23/2017 08:00:00 AM,48,-122,91,14,105
28257,SpokaneStBridge,03/23/2017 09:00:00 AM,48,-122,35,5,40
28258,SpokaneStBridge,03/23/2017 10:00:00 AM,48,-122,14,7,21
28259,SpokaneStBridge,03/23/2017 11:00:00 AM,48,-122,14,8,22
28260,SpokaneStBridge,03/23/2017 12:00:00 PM,48,-122,8,14,22
28261,SpokaneStBridge,03/23/2017 01:00:00 PM,48,-122,19,9,28
28262,SpokaneStBridge,03/23/2017 02:00:00 PM,48,-122,10,10,20
28263,SpokaneStBridge,03/23/2017 03:00:00 PM,48,-122,10,25,35
28264,SpokaneStBridge,03/23/2017 04:00:00 PM,48,-122,22,63,85
28265,SpokaneStBridge,03/23/2017 05:00:00 PM,48,-122,17,116,133
28266,SpokaneStBridge,03/23/2017 06:00:00 PM,48,-122,9,57,66
28267,SpokaneStBridge,03/23/2017 07:00:00 PM,48,-122,3,16,19
28268,SpokaneStBridge,03/23/2017 08:00:00 PM,48,-122,3,8,11
28269,SpokaneStBridge,03/23/2017 09:00:00 PM,48,-122,2,5,7
28270,SpokaneStBridge,03/23/2017 10:00:00 PM,48,-122,3,3,6
28271,SpokaneStBridge,03/23/2017 11:00:00 PM,48,-122,1,0,1
28272,SpokaneStBridge,03/24/2017 12:00:00 AM,48,-122,1,0,1
28273,SpokaneStBridge,03/24/2017 01:00:00 AM,48,-122,0,0,0
28274,SpokaneStBridge,03/24/2017 02:00:00 AM,48,-122,0,1,1
28275,SpokaneStBridge,03/24/2017 03:00:00 AM,48,-122,2,1,3
28276,SpokaneStBridge,03/24/2017 04:00:00 AM,48,-122,0,1,1
28277,SpokaneStBridge,03/24/2017 05:00:00 AM,48,-122,8,2,10
28278,SpokaneStBridge,03/24/2017 06:00:00 AM,48,-122,20,6,26
28279,SpokaneStBridge,03/24/2017 07:00:00 AM,48,-122,43,7,50
28280,SpokaneStBridge,03/24/2017 08:00:00 AM,48,-122,49,4,53
28281,SpokaneStBridge,03/24/2017 09:00:00 AM,48,-122,25,3,28
28282,SpokaneStBridge,03/24/2017 10:00:00 AM,48,-122,4,2,6
28283,SpokaneStBridge,03/24/2017 11:00:00 AM,48,-122,6,2,8
28284,SpokaneStBridge,03/24/2017 12:00:00 PM,48,-122,2,3,5
28285,SpokaneStBridge,03/24/2017 01:00:00 PM,48,-122,5,5,10
28286,SpokaneStBridge,03/24/2017 02:00:00 PM,48,-122,3,6,9
28287,SpokaneStBridge,03/24/2017 03:00:00 PM,48,-122,7,16,23
28288,SpokaneStBridge,03/24/2017 04:00:00 PM,48,-122,5,33,38
28289,SpokaneStBridge,03/24/2017 05:00:00 PM,48,-122,8,51,59
28290,SpokaneStBridge,03/24/2017 06:00:00 PM,48,-122,10,31,41
28291,SpokaneStBridge,03/24/2017 07:00:00 PM,48,-122,1,11,12
28292,SpokaneStBridge,03/24/2017 08:00:00 PM,48,-122,4,2,6
28293,SpokaneStBridge,03/24/2017 09:00:00 PM,48,-122,2,2,4
28294,SpokaneStBridge,03/24/2017 10:00:00 PM,48,-122,0,2,2
28295,SpokaneStBridge,03/24/2017 11:00:00 PM,48,-122,2,3,5
28296,SpokaneStBridge,03/25/2017 12:00:00 AM,48,-122,0,0,0
28297,SpokaneStBridge,03/25/2017 01:00:00 AM,48,-122,0,1,1
28298,SpokaneStBridge,03/25/2017 02:00:00 AM,48,-122,0,1,1
28299,SpokaneStBridge,03/25/2017 03:00:00 AM,48,-122,1,0,1
28300,SpokaneStBridge,03/25/2017 04:00:00 AM,48,-122,1,1,2
28301,SpokaneStBridge,03/25/2017 05:00:00 AM,48,-122,3,1,4
28302,SpokaneStBridge,03/25/2017 06:00:00 AM,48,-122,4,1,5
28303,SpokaneStBridge,03/25/2017 07:00:00 AM,48,-122,7,3,10
28304,SpokaneStBridge,03/25/2017 08:00:00 AM,48,-122,6,9,15
28305,SpokaneStBridge,03/25/2017 09:00:00 AM,48,-122,12,16,28
28306,SpokaneStBridge,03/25/2017 10:00:00 AM,48,-122,19,19,38
28307,SpokaneStBridge,03/25/2017 11:00:00 AM,48,-122,17,23,40
28308,SpokaneStBridge,03/25/2017 12:00:00 PM,48,-122,34,32,66
28309,SpokaneStBridge,03/25/2017 01:00:00 PM,48,-122,33,22,55
28310,SpokaneStBridge,03/25/2017 02:00:00 PM,48,-122,21,24,45
28311,SpokaneStBridge,03/25/2017 03:00:00 PM,48,-122,30,36,66
28312,SpokaneStBridge,03/25/2017 04:00:00 PM,48,-122,16,23,39
28313,SpokaneStBridge,03/25/2017 05:00:00 PM,48,-122,16,17,33
28314,SpokaneStBridge,03/25/2017 06:00:00 PM,48,-122,11,11,22
28315,SpokaneStBridge,03/25/2017 07:00:00 PM,48,-122,3,10,13
28316,SpokaneStBridge,03/25/2017 08:00:00 PM,48,-122,2,4,6
28317,SpokaneStBridge,03/25/2017 09:00:00 PM,48,-122,1,2,3
28318,SpokaneStBridge,03/25/2017 10:00:00 PM,48,-122,2,1,3
28319,SpokaneStBridge,03/25/2017 11:00:00 PM,48,-122,2,0,2
28320,SpokaneStBridge,03/26/2017 12:00:00 AM,48,-122,0,0,0
28321,SpokaneStBridge,03/26/2017 01:00:00 AM,48,-122,2,1,3
28322,SpokaneStBridge,03/26/2017 02:00:00 AM,48,-122,1,2,3
28323,SpokaneStBridge,03/26/2017 03:00:00 AM,48,-122,1,2,3
28324,SpokaneStBridge,03/26/2017 04:00:00 AM,48,-122,0,1,1
28325,SpokaneStBridge,03/26/2017 05:00:00 AM,48,-122,4,0,4
28326,SpokaneStBridge,03/26/2017 06:00:00 AM,48,-122,2,0,2
28327,SpokaneStBridge,03/26/2017 07:00:00 AM,48,-122,3,0,3
28328,SpokaneStBridge,03/26/2017 08:00:00 AM,48,-122,6,2,8
28329,SpokaneStBridge,03/26/2017 09:00:00 AM,48,-122,5,3,8
28330,SpokaneStBridge,03/26/2017 10:00:00 AM,48,-122,2,6,8
28331,SpokaneStBridge,03/26/2017 11:00:00 AM,48,-122,4,2,6
28332,SpokaneStBridge,03/26/2017 12:00:00 PM,48,-122,2,3,5
28333,SpokaneStBridge,03/26/2017 01:00:00 PM,48,-122,6,4,10
28334,SpokaneStBridge,03/26/2017 02:00:00 PM,48,-122,1,9,10
28335,SpokaneStBridge,03/26/2017 03:00:00 PM,48,-122,8,4,12
28336,SpokaneStBridge,03/26/2017 04:00:00 PM,48,-122,4,4,8
28337,SpokaneStBridge,03/26/2017 05:00:00 PM,48,-122,2,5,7
28338,SpokaneStBridge,03/26/2017 06:00:00 PM,48,-122,2,3,5
28339,SpokaneStBridge,03/26/2017 07:00:00 PM,48,-122,1,2,3
28340,SpokaneStBridge,03/26/2017 08:00:00 PM,48,-122,0,2,2
28341,SpokaneStBridge,03/26/2017 09:00:00 PM,48,-122,2,1,3
28342,SpokaneStBridge,03/26/2017 10:00:00 PM,48,-122,1,1,2
28343,SpokaneStBridge,03/26/2017 11:00:00 PM,48,-122,1,1,2
28344,SpokaneStBridge,03/27/2017 12:00:00 AM,48,-122,1,1,2
28345,SpokaneStBridge,03/27/2017 01:00:00 AM,48,-122,0,0,0
28346,SpokaneStBridge,03/27/2017 02:00:00 AM,48,-122,0,0,0
28347,SpokaneStBridge,03/27/2017 03:00:00 AM,48,-122,0,0,0
28348,SpokaneStBridge,03/27/2017 04:00:00 AM,48,-122,7,0,7
28349,SpokaneStBridge,03/27/2017 05:00:00 AM,48,-122,13,2,15
28350,SpokaneStBridge,03/27/2017 06:00:00 AM,48,-122,32,6,38
28351,SpokaneStBridge,03/27/2017 07:00:00 AM,48,-122,85,8,93
28352,SpokaneStBridge,03/27/2017 08:00:00 AM,48,-122,102,8,110
28353,SpokaneStBridge,03/27/2017 09:00:00 AM,48,-122,33,5,38
28354,SpokaneStBridge,03/27/2017 10:00:00 AM,48,-122,6,2,8
28355,SpokaneStBridge,03/27/2017 11:00:00 AM,48,-122,6,1,7
28356,SpokaneStBridge,03/27/2017 12:00:00 PM,48,-122,6,5,11
28357,SpokaneStBridge,03/27/2017 01:00:00 PM,48,-122,11,7,18
28358,SpokaneStBridge,03/27/2017 02:00:00 PM,48,-122,4,2,6
28359,SpokaneStBridge,03/27/2017 03:00:00 PM,48,-122,4,26,30
28360,SpokaneStBridge,03/27/2017 04:00:00 PM,48,-122,7,50,57
28361,SpokaneStBridge,03/27/2017 05:00:00 PM,48,-122,14,83,97
28362,SpokaneStBridge,03/27/2017 06:00:00 PM,48,-122,9,72,81
28363,SpokaneStBridge,03/27/2017 07:00:00 PM,48,-122,3,20,23
28364,SpokaneStBridge,03/27/2017 08:00:00 PM,48,-122,2,4,6
28365,SpokaneStBridge,03/27/2017 09:00:00 PM,48,-122,0,3,3
28366,SpokaneStBridge,03/27/2017 10:00:00 PM,48,-122,0,1,1
28367,SpokaneStBridge,03/27/2017 11:00:00 PM,48,-122,0,0,0
28368,SpokaneStBridge,03/28/2017 12:00:00 AM,48,-122,0,1,1
28369,SpokaneStBridge,03/28/2017 01:00:00 AM,48,-122,0,0,0
28370,SpokaneStBridge,03/28/2017 02:00:00 AM,48,-122,1,0,1
28371,SpokaneStBridge,03/28/2017 03:00:00 AM,48,-122,1,1,2
28372,SpokaneStBridge,03/28/2017 04:00:00 AM,48,-122,2,0,2
28373,SpokaneStBridge,03/28/2017 05:00:00 AM,48,-122,17,3,20
28374,SpokaneStBridge,03/28/2017 06:00:00 AM,48,-122,32,10,42
28375,SpokaneStBridge,03/28/2017 07:00:00 AM,48,-122,79,9,88
28376,SpokaneStBridge,03/28/2017 08:00:00 AM,48,-122,73,8,81
28377,SpokaneStBridge,03/28/2017 09:00:00 AM,48,-122,29,4,33
28378,SpokaneStBridge,03/28/2017 10:00:00 AM,48,-122,7,2,9
28379,SpokaneStBridge,03/28/2017 11:00:00 AM,48,-122,7,2,9
28380,SpokaneStBridge,03/28/2017 12:00:00 PM,48,-122,2,5,7
28381,SpokaneStBridge,03/28/2017 01:00:00 PM,48,-122,2,2,4
28382,SpokaneStBridge,03/28/2017 02:00:00 PM,48,-122,3,12,15
28383,SpokaneStBridge,03/28/2017 03:00:00 PM,48,-122,10,12,22
28384,SpokaneStBridge,03/28/2017 04:00:00 PM,48,-122,6,44,50
28385,SpokaneStBridge,03/28/2017 05:00:00 PM,48,-122,11,83,94
28386,SpokaneStBridge,03/28/2017 06:00:00 PM,48,-122,9,58,67
28387,SpokaneStBridge,03/28/2017 07:00:00 PM,48,-122,10,23,33
28388,SpokaneStBridge,03/28/2017 08:00:00 PM,48,-122,1,9,10
28389,SpokaneStBridge,03/28/2017 09:00:00 PM,48,-122,1,3,4
28390,SpokaneStBridge,03/28/2017 10:00:00 PM,48,-122,0,3,3
28391,SpokaneStBridge,03/28/2017 11:00:00 PM,48,-122,1,2,3
28392,SpokaneStBridge,03/29/2017 12:00:00 AM,48,-122,3,0,3
28393,SpokaneStBridge,03/29/2017 01:00:00 AM,48,-122,0,3,3
28394,SpokaneStBridge,03/29/2017 02:00:00 AM,48,-122,0,0,0
28395,SpokaneStBridge,03/29/2017 03:00:00 AM,48,-122,1,3,4
28396,SpokaneStBridge,03/29/2017 04:00:00 AM,48,-122,1,2,3
28397,SpokaneStBridge,03/29/2017 05:00:00 AM,48,-122,6,1,7
28398,SpokaneStBridge,03/29/2017 06:00:00 AM,48,-122,27,5,32
28399,SpokaneStBridge,03/29/2017 07:00:00 AM,48,-122,67,6,73
28400,SpokaneStBridge,03/29/2017 08:00:00 AM,48,-122,76,7,83
28401,SpokaneStBridge,03/29/2017 09:00:00 AM,48,-122,27,2,29
28402,SpokaneStBridge,03/29/2017 10:00:00 AM,48,-122,11,0,11
28403,SpokaneStBridge,03/29/2017 11:00:00 AM,48,-122,8,4,12
28404,SpokaneStBridge,03/29/2017 12:00:00 PM,48,-122,2,4,6
28405,SpokaneStBridge,03/29/2017 01:00:00 PM,48,-122,5,1,6
28406,SpokaneStBridge,03/29/2017 02:00:00 PM,48,-122,2,6,8
28407,SpokaneStBridge,03/29/2017 03:00:00 PM,48,-122,6,21,27
28408,SpokaneStBridge,03/29/2017 04:00:00 PM,48,-122,9,36,45
28409,SpokaneStBridge,03/29/2017 05:00:00 PM,48,-122,11,62,73
28410,SpokaneStBridge,03/29/2017 06:00:00 PM,48,-122,8,57,65
28411,SpokaneStBridge,03/29/2017 07:00:00 PM,48,-122,3,33,36
28412,SpokaneStBridge,03/29/2017 08:00:00 PM,48,-122,1,12,13
28413,SpokaneStBridge,03/29/2017 09:00:00 PM,48,-122,0,5,5
28414,SpokaneStBridge,03/29/2017 10:00:00 PM,48,-122,3,4,7
28415,SpokaneStBridge,03/29/2017 11:00:00 PM,48,-122,3,1,4
28416,SpokaneStBridge,03/30/2017 12:00:00 AM,48,-122,1,0,1
28417,SpokaneStBridge,03/30/2017 01:00:00 AM,48,-122,2,2,4
28418,SpokaneStBridge,03/30/2017 02:00:00 AM,48,-122,0,1,1
28419,SpokaneStBridge,03/30/2017 03:00:00 AM,48,-122,0,0,0
28420,SpokaneStBridge,03/30/2017 04:00:00 AM,48,-122,2,0,2
28421,SpokaneStBridge,03/30/2017 05:00:00 AM,48,-122,13,3,16
28422,SpokaneStBridge,03/30/2017 06:00:00 AM,48,-122,48,8,56
28423,SpokaneStBridge,03/30/2017 07:00:00 AM,48,-122,86,10,96
28424,SpokaneStBridge,03/30/2017 08:00:00 AM,48,-122,98,13,111
28425,SpokaneStBridge,03/30/2017 09:00:00 AM,48,-122,48,7,55
28426,SpokaneStBridge,03/30/2017 10:00:00 AM,48,-122,17,11,28
28427,SpokaneStBridge,03/30/2017 11:00:00 AM,48,-122,12,6,18
28428,SpokaneStBridge,03/30/2017 12:00:00 PM,48,-122,10,11,21
28429,SpokaneStBridge,03/30/2017 01:00:00 PM,48,-122,12,9,21
28430,SpokaneStBridge,03/30/2017 02:00:00 PM,48,-122,19,10,29
28431,SpokaneStBridge,03/30/2017 03:00:00 PM,48,-122,14,23,37
28432,SpokaneStBridge,03/30/2017 04:00:00 PM,48,-122,11,62,73
28433,SpokaneStBridge,03/30/2017 05:00:00 PM,48,-122,17,103,120
28434,SpokaneStBridge,03/30/2017 06:00:00 PM,48,-122,8,74,82
28435,SpokaneStBridge,03/30/2017 07:00:00 PM,48,-122,9,25,34
28436,SpokaneStBridge,03/30/2017 08:00:00 PM,48,-122,0,9,9
28437,SpokaneStBridge,03/30/2017 09:00:00 PM,48,-122,4,6,10
28438,SpokaneStBridge,03/30/2017 10:00:00 PM,48,-122,3,0,3
28439,SpokaneStBridge,03/30/2017 11:00:00 PM,48,-122,0,2,2
28440,SpokaneStBridge,03/31/2017 12:00:00 AM,48,-122,3,3,6
28441,SpokaneStBridge,03/31/2017 01:00:00 AM,48,-122,3,2,5
28442,SpokaneStBridge,03/31/2017 02:00:00 AM,48,-122,3,2,5
28443,SpokaneStBridge,03/31/2017 03:00:00 AM,48,-122,0,0,0
28444,SpokaneStBridge,03/31/2017 04:00:00 AM,48,-122,1,2,3
28445,SpokaneStBridge,03/31/2017 05:00:00 AM,48,-122,9,6,15
28446,SpokaneStBridge,03/31/2017 06:00:00 AM,48,-122,36,8,44
28447,SpokaneStBridge,03/31/2017 07:00:00 AM,48,-122,93,14,107
28448,SpokaneStBridge,03/31/2017 08:00:00 AM,48,-122,87,18,105
28449,SpokaneStBridge,03/31/2017 09:00:00 AM,48,-122,43,9,52
28450,SpokaneStBridge,03/31/2017 10:00:00 AM,48,-122,11,8,19
28451,SpokaneStBridge,03/31/2017 11:00:00 AM,48,-122,15,4,19
28452,SpokaneStBridge,03/31/2017 12:00:00 PM,48,-122,12,5,17
28453,SpokaneStBridge,03/31/2017 01:00:00 PM,48,-122,18,12,30
28454,SpokaneStBridge,03/31/2017 02:00:00 PM,48,-122,4,15,19
28455,SpokaneStBridge,03/31/2017 03:00:00 PM,48,-122,12,39,51
28456,SpokaneStBridge,03/31/2017 04:00:00 PM,48,-122,17,67,84
28457,SpokaneStBridge,03/31/2017 05:00:00 PM,48,-122,23,88,111
28458,SpokaneStBridge,03/31/2017 06:00:00 PM,48,-122,10,62,72
28459,SpokaneStBridge,03/31/2017 07:00:00 PM,48,-122,7,15,22
28460,SpokaneStBridge,03/31/2017 08:00:00 PM,48,-122,2,4,6
28461,SpokaneStBridge,03/31/2017 09:00:00 PM,48,-122,5,11,16
28462,SpokaneStBridge,03/31/2017 10:00:00 PM,48,-122,2,7,9
28463,SpokaneStBridge,03/31/2017 11:00:00 PM,48,-122,3,1,4
28464,SpokaneStBridge,04/01/2017 12:00:00 AM,48,-122,0,3,3
28465,SpokaneStBridge,04/01/2017 01:00:00 AM,48,-122,2,1,3
28466,SpokaneStBridge,04/01/2017 02:00:00 AM,48,-122,2,5,7
28467,SpokaneStBridge,04/01/2017 03:00:00 AM,48,-122,1,0,1
28468,SpokaneStBridge,04/01/2017 04:00:00 AM,48,-122,0,1,1
28469,SpokaneStBridge,04/01/2017 05:00:00 AM,48,-122,3,1,4
28470,SpokaneStBridge,04/01/2017 06:00:00 AM,48,-122,5,1,6
28471,SpokaneStBridge,04/01/2017 07:00:00 AM,48,-122,3,0,3
28472,SpokaneStBridge,04/01/2017 08:00:00 AM,48,-122,2,4,6
28473,SpokaneStBridge,04/01/2017 09:00:00 AM,48,-122,6,8,14
28474,SpokaneStBridge,04/01/2017 10:00:00 AM,48,-122,11,3,14
28475,SpokaneStBridge,04/01/2017 11:00:00 AM,48,-122,4,7,11
28476,SpokaneStBridge,04/01/2017 12:00:00 PM,48,-122,9,18,27
28477,SpokaneStBridge,04/01/2017 01:00:00 PM,48,-122,12,12,24
28478,SpokaneStBridge,04/01/2017 02:00:00 PM,48,-122,14,11,25
28479,SpokaneStBridge,04/01/2017 03:00:00 PM,48,-122,9,10,19
28480,SpokaneStBridge,04/01/2017 04:00:00 PM,48,-122,13,22,35
28481,SpokaneStBridge,04/01/2017 05:00:00 PM,48,-122,8,12,20
28482,SpokaneStBridge,04/01/2017 06:00:00 PM,48,-122,3,8,11
28483,SpokaneStBridge,04/01/2017 07:00:00 PM,48,-122,7,4,11
28484,SpokaneStBridge,04/01/2017 08:00:00 PM,48,-122,2,3,5
28485,SpokaneStBridge,04/01/2017 09:00:00 PM,48,-122,2,0,2
28486,SpokaneStBridge,04/01/2017 10:00:00 PM,48,-122,0,2,2
28487,SpokaneStBridge,04/01/2017 11:00:00 PM,48,-122,0,2,2
28488,SpokaneStBridge,04/02/2017 12:00:00 AM,48,-122,0,1,1
28489,SpokaneStBridge,04/02/2017 01:00:00 AM,48,-122,0,1,1
28490,SpokaneStBridge,04/02/2017 02:00:00 AM,48,-122,0,1,1
28491,SpokaneStBridge,04/02/2017 03:00:00 AM,48,-122,0,0,0
28492,SpokaneStBridge,04/02/2017 04:00:00 AM,48,-122,0,1,1
28493,SpokaneStBridge,04/02/2017 05:00:00 AM,48,-122,3,1,4
28494,SpokaneStBridge,04/02/2017 06:00:00 AM,48,-122,2,2,4
28495,SpokaneStBridge,04/02/2017 07:00:00 AM,48,-122,4,3,7
28496,SpokaneStBridge,04/02/2017 08:00:00 AM,48,-122,14,5,19
28497,SpokaneStBridge,04/02/2017 09:00:00 AM,48,-122,21,4,25
28498,SpokaneStBridge,04/02/2017 10:00:00 AM,48,-122,19,18,37
28499,SpokaneStBridge,04/02/2017 11:00:00 AM,48,-122,18,28,46
28500,SpokaneStBridge,04/02/2017 12:00:00 PM,48,-122,19,30,49
28501,SpokaneStBridge,04/02/2017 01:00:00 PM,48,-122,24,28,52
28502,SpokaneStBridge,04/02/2017 02:00:00 PM,48,-122,22,26,48
28503,SpokaneStBridge,04/02/2017 03:00:00 PM,48,-122,13,18,31
28504,SpokaneStBridge,04/02/2017 04:00:00 PM,48,-122,26,14,40
28505,SpokaneStBridge,04/02/2017 05:00:00 PM,48,-122,3,8,11
28506,SpokaneStBridge,04/02/2017 06:00:00 PM,48,-122,9,10,19
28507,SpokaneStBridge,04/02/2017 07:00:00 PM,48,-122,1,5,6
28508,SpokaneStBridge,04/02/2017 08:00:00 PM,48,-122,3,1,4
28509,SpokaneStBridge,04/02/2017 09:00:00 PM,48,-122,0,2,2
28510,SpokaneStBridge,04/02/2017 10:00:00 PM,48,-122,1,2,3
28511,SpokaneStBridge,04/02/2017 11:00:00 PM,48,-122,1,1,2
28512,SpokaneStBridge,04/03/2017 12:00:00 AM,48,-122,0,0,0
28513,SpokaneStBridge,04/03/2017 01:00:00 AM,48,-122,0,0,0
28514,SpokaneStBridge,04/03/2017 02:00:00 AM,48,-122,0,2,2
28515,SpokaneStBridge,04/03/2017 03:00:00 AM,48,-122,0,1,1
28516,SpokaneStBridge,04/03/2017 04:00:00 AM,48,-122,3,1,4
28517,SpokaneStBridge,04/03/2017 05:00:00 AM,48,-122,16,6,22
28518,SpokaneStBridge,04/03/2017 06:00:00 AM,48,-122,49,11,60
28519,SpokaneStBridge,04/03/2017 07:00:00 AM,48,-122,117,13,130
28520,SpokaneStBridge,04/03/2017 08:00:00 AM,48,-122,117,14,131
28521,SpokaneStBridge,04/03/2017 09:00:00 AM,48,-122,34,9,43
28522,SpokaneStBridge,04/03/2017 10:00:00 AM,48,-122,16,6,22
28523,SpokaneStBridge,04/03/2017 11:00:00 AM,48,-122,16,8,24
28524,SpokaneStBridge,04/03/2017 12:00:00 PM,48,-122,13,9,22
28525,SpokaneStBridge,04/03/2017 01:00:00 PM,48,-122,16,19,35
28526,SpokaneStBridge,04/03/2017 02:00:00 PM,48,-122,12,20,32
28527,SpokaneStBridge,04/03/2017 03:00:00 PM,48,-122,12,41,53
28528,SpokaneStBridge,04/03/2017 04:00:00 PM,48,-122,33,67,100
28529,SpokaneStBridge,04/03/2017 05:00:00 PM,48,-122,22,124,146
28530,SpokaneStBridge,04/03/2017 06:00:00 PM,48,-122,12,76,88
28531,SpokaneStBridge,04/03/2017 07:00:00 PM,48,-122,8,35,43
28532,SpokaneStBridge,04/03/2017 08:00:00 PM,48,-122,12,11,23
28533,SpokaneStBridge,04/03/2017 09:00:00 PM,48,-122,0,6,6
28534,SpokaneStBridge,04/03/2017 10:00:00 PM,48,-122,1,3,4
28535,SpokaneStBridge,04/03/2017 11:00:00 PM,48,-122,1,2,3
28536,SpokaneStBridge,04/04/2017 12:00:00 AM,48,-122,0,0,0
28537,SpokaneStBridge,04/04/2017 01:00:00 AM,48,-122,1,0,1
28538,SpokaneStBridge,04/04/2017 02:00:00 AM,48,-122,0,1,1
28539,SpokaneStBridge,04/04/2017 03:00:00 AM,48,-122,0,2,2
28540,SpokaneStBridge,04/04/2017 04:00:00 AM,48,-122,4,3,7
28541,SpokaneStBridge,04/04/2017 05:00:00 AM,48,-122,12,9,21
28542,SpokaneStBridge,04/04/2017 06:00:00 AM,48,-122,50,9,59
28543,SpokaneStBridge,04/04/2017 07:00:00 AM,48,-122,126,9,135
28544,SpokaneStBridge,04/04/2017 08:00:00 AM,48,-122,123,17,140
28545,SpokaneStBridge,04/04/2017 09:00:00 AM,48,-122,33,8,41
28546,SpokaneStBridge,04/04/2017 10:00:00 AM,48,-122,12,6,18
28547,SpokaneStBridge,04/04/2017 11:00:00 AM,48,-122,15,2,17
28548,SpokaneStBridge,04/04/2017 12:00:00 PM,48,-122,16,12,28
28549,SpokaneStBridge,04/04/2017 01:00:00 PM,48,-122,14,5,19
28550,SpokaneStBridge,04/04/2017 02:00:00 PM,48,-122,8,23,31
28551,SpokaneStBridge,04/04/2017 03:00:00 PM,48,-122,9,33,42
28552,SpokaneStBridge,04/04/2017 04:00:00 PM,48,-122,14,76,90
28553,SpokaneStBridge,04/04/2017 05:00:00 PM,48,-122,24,142,166
28554,SpokaneStBridge,04/04/2017 06:00:00 PM,48,-122,15,72,87
28555,SpokaneStBridge,04/04/2017 07:00:00 PM,48,-122,3,20,23
28556,SpokaneStBridge,04/04/2017 08:00:00 PM,48,-122,0,12,12
28557,SpokaneStBridge,04/04/2017 09:00:00 PM,48,-122,2,6,8
28558,SpokaneStBridge,04/04/2017 10:00:00 PM,48,-122,1,3,4
28559,SpokaneStBridge,04/04/2017 11:00:00 PM,48,-122,0,5,5
28560,SpokaneStBridge,04/05/2017 12:00:00 AM,48,-122,1,2,3
28561,SpokaneStBridge,04/05/2017 01:00:00 AM,48,-122,0,0,0
28562,SpokaneStBridge,04/05/2017 02:00:00 AM,48,-122,0,0,0
28563,SpokaneStBridge,04/05/2017 03:00:00 AM,48,-122,0,1,1
28564,SpokaneStBridge,04/05/2017 04:00:00 AM,48,-122,3,1,4
28565,SpokaneStBridge,04/05/2017 05:00:00 AM,48,-122,11,3,14
28566,SpokaneStBridge,04/05/2017 06:00:00 AM,48,-122,28,4,32
28567,SpokaneStBridge,04/05/2017 07:00:00 AM,48,-122,54,9,63
28568,SpokaneStBridge,04/05/2017 08:00:00 AM,48,-122,61,9,70
28569,SpokaneStBridge,04/05/2017 09:00:00 AM,48,-122,14,0,14
28570,SpokaneStBridge,04/05/2017 10:00:00 AM,48,-122,5,2,7
28571,SpokaneStBridge,04/05/2017 11:00:00 AM,48,-122,7,0,7
28572,SpokaneStBridge,04/05/2017 12:00:00 PM,48,-122,4,2,6
28573,SpokaneStBridge,04/05/2017 01:00:00 PM,48,-122,2,2,4
28574,SpokaneStBridge,04/05/2017 02:00:00 PM,48,-122,6,3,9
28575,SpokaneStBridge,04/05/2017 03:00:00 PM,48,-122,2,11,13
28576,SpokaneStBridge,04/05/2017 04:00:00 PM,48,-122,10,38,48
28577,SpokaneStBridge,04/05/2017 05:00:00 PM,48,-122,7,70,77
28578,SpokaneStBridge,04/05/2017 06:00:00 PM,48,-122,5,46,51
28579,SpokaneStBridge,04/05/2017 07:00:00 PM,48,-122,2,17,19
28580,SpokaneStBridge,04/05/2017 08:00:00 PM,48,-122,1,9,10
28581,SpokaneStBridge,04/05/2017 09:00:00 PM,48,-122,0,7,7
28582,SpokaneStBridge,04/05/2017 10:00:00 PM,48,-122,0,4,4
28583,SpokaneStBridge,04/05/2017 11:00:00 PM,48,-122,1,3,4
28584,SpokaneStBridge,04/06/2017 12:00:00 AM,48,-122,1,0,1
28585,SpokaneStBridge,04/06/2017 01:00:00 AM,48,-122,1,2,3
28586,SpokaneStBridge,04/06/2017 02:00:00 AM,48,-122,0,0,0
28587,SpokaneStBridge,04/06/2017 03:00:00 AM,48,-122,1,0,1
28588,SpokaneStBridge,04/06/2017 04:00:00 AM,48,-122,1,0,1
28589,SpokaneStBridge,04/06/2017 05:00:00 AM,48,-122,10,6,16
28590,SpokaneStBridge,04/06/2017 06:00:00 AM,48,-122,26,6,32
28591,SpokaneStBridge,04/06/2017 07:00:00 AM,48,-122,71,6,77
28592,SpokaneStBridge,04/06/2017 08:00:00 AM,48,-122,67,9,76
28593,SpokaneStBridge,04/06/2017 09:00:00 AM,48,-122,21,1,22
28594,SpokaneStBridge,04/06/2017 10:00:00 AM,48,-122,6,2,8
28595,SpokaneStBridge,04/06/2017 11:00:00 AM,48,-122,2,3,5
28596,SpokaneStBridge,04/06/2017 12:00:00 PM,48,-122,6,2,8
28597,SpokaneStBridge,04/06/2017 01:00:00 PM,48,-122,6,8,14
28598,SpokaneStBridge,04/06/2017 02:00:00 PM,48,-122,9,6,15
28599,SpokaneStBridge,04/06/2017 03:00:00 PM,48,-122,12,20,32
28600,SpokaneStBridge,04/06/2017 04:00:00 PM,48,-122,11,58,69
28601,SpokaneStBridge,04/06/2017 05:00:00 PM,48,-122,30,83,113
28602,SpokaneStBridge,04/06/2017 06:00:00 PM,48,-122,8,64,72
28603,SpokaneStBridge,04/06/2017 07:00:00 PM,48,-122,12,17,29
28604,SpokaneStBridge,04/06/2017 08:00:00 PM,48,-122,4,47,51
28605,SpokaneStBridge,04/06/2017 09:00:00 PM,48,-122,12,7,19
28606,SpokaneStBridge,04/06/2017 10:00:00 PM,48,-122,11,7,18
28607,SpokaneStBridge,04/06/2017 11:00:00 PM,48,-122,2,0,2
28608,SpokaneStBridge,04/07/2017 12:00:00 AM,48,-122,3,2,5
28609,SpokaneStBridge,04/07/2017 01:00:00 AM,48,-122,0,0,0
28610,SpokaneStBridge,04/07/2017 02:00:00 AM,48,-122,0,0,0
28611,SpokaneStBridge,04/07/2017 03:00:00 AM,48,-122,0,0,0
28612,SpokaneStBridge,04/07/2017 04:00:00 AM,48,-122,0,0,0
28613,SpokaneStBridge,04/07/2017 05:00:00 AM,48,-122,4,3,7
28614,SpokaneStBridge,04/07/2017 06:00:00 AM,48,-122,24,3,27
28615,SpokaneStBridge,04/07/2017 07:00:00 AM,48,-122,62,11,73
28616,SpokaneStBridge,04/07/2017 08:00:00 AM,48,-122,59,5,64
28617,SpokaneStBridge,04/07/2017 09:00:00 AM,48,-122,18,3,21
28618,SpokaneStBridge,04/07/2017 10:00:00 AM,48,-122,7,3,10
28619,SpokaneStBridge,04/07/2017 11:00:00 AM,48,-122,11,0,11
28620,SpokaneStBridge,04/07/2017 12:00:00 PM,48,-122,0,5,5
28621,SpokaneStBridge,04/07/2017 01:00:00 PM,48,-122,3,6,9
28622,SpokaneStBridge,04/07/2017 02:00:00 PM,48,-122,7,10,17
28623,SpokaneStBridge,04/07/2017 03:00:00 PM,48,-122,6,10,16
28624,SpokaneStBridge,04/07/2017 04:00:00 PM,48,-122,7,34,41
28625,SpokaneStBridge,04/07/2017 05:00:00 PM,48,-122,11,43,54
28626,SpokaneStBridge,04/07/2017 06:00:00 PM,48,-122,5,26,31
28627,SpokaneStBridge,04/07/2017 07:00:00 PM,48,-122,7,5,12
28628,SpokaneStBridge,04/07/2017 08:00:00 PM,48,-122,0,7,7
28629,SpokaneStBridge,04/07/2017 09:00:00 PM,48,-122,2,1,3
28630,SpokaneStBridge,04/07/2017 10:00:00 PM,48,-122,2,0,2
28631,SpokaneStBridge,04/07/2017 11:00:00 PM,48,-122,0,3,3
28632,SpokaneStBridge,04/08/2017 12:00:00 AM,48,-122,0,2,2
28633,SpokaneStBridge,04/08/2017 01:00:00 AM,48,-122,1,3,4
28634,SpokaneStBridge,04/08/2017 02:00:00 AM,48,-122,0,1,1
28635,SpokaneStBridge,04/08/2017 03:00:00 AM,48,-122,0,0,0
28636,SpokaneStBridge,04/08/2017 04:00:00 AM,48,-122,0,1,1
28637,SpokaneStBridge,04/08/2017 05:00:00 AM,48,-122,3,0,3
28638,SpokaneStBridge,04/08/2017 06:00:00 AM,48,-122,3,0,3
28639,SpokaneStBridge,04/08/2017 07:00:00 AM,48,-122,5,3,8
28640,SpokaneStBridge,04/08/2017 08:00:00 AM,48,-122,14,3,17
28641,SpokaneStBridge,04/08/2017 09:00:00 AM,48,-122,9,12,21
28642,SpokaneStBridge,04/08/2017 10:00:00 AM,48,-122,18,16,34
28643,SpokaneStBridge,04/08/2017 11:00:00 AM,48,-122,13,10,23
28644,SpokaneStBridge,04/08/2017 12:00:00 PM,48,-122,10,10,20
28645,SpokaneStBridge,04/08/2017 01:00:00 PM,48,-122,9,14,23
28646,SpokaneStBridge,04/08/2017 02:00:00 PM,48,-122,9,7,16
28647,SpokaneStBridge,04/08/2017 03:00:00 PM,48,-122,11,8,19
28648,SpokaneStBridge,04/08/2017 04:00:00 PM,48,-122,7,17,24
28649,SpokaneStBridge,04/08/2017 05:00:00 PM,48,-122,5,6,11
28650,SpokaneStBridge,04/08/2017 06:00:00 PM,48,-122,4,8,12
28651,SpokaneStBridge,04/08/2017 07:00:00 PM,48,-122,3,2,5
28652,SpokaneStBridge,04/08/2017 08:00:00 PM,48,-122,4,5,9
28653,SpokaneStBridge,04/08/2017 09:00:00 PM,48,-122,0,4,4
28654,SpokaneStBridge,04/08/2017 10:00:00 PM,48,-122,1,1,2
28655,SpokaneStBridge,04/08/2017 11:00:00 PM,48,-122,0,0,0
28656,SpokaneStBridge,04/09/2017 12:00:00 AM,48,-122,2,1,3
28657,SpokaneStBridge,04/09/2017 01:00:00 AM,48,-122,1,2,3
28658,SpokaneStBridge,04/09/2017 02:00:00 AM,48,-122,0,1,1
28659,SpokaneStBridge,04/09/2017 03:00:00 AM,48,-122,0,0,0
28660,SpokaneStBridge,04/09/2017 04:00:00 AM,48,-122,0,1,1
28661,SpokaneStBridge,04/09/2017 05:00:00 AM,48,-122,2,1,3
28662,SpokaneStBridge,04/09/2017 06:00:00 AM,48,-122,4,0,4
28663,SpokaneStBridge,04/09/2017 07:00:00 AM,48,-122,3,2,5
28664,SpokaneStBridge,04/09/2017 08:00:00 AM,48,-122,17,13,30
28665,SpokaneStBridge,04/09/2017 09:00:00 AM,48,-122,20,11,31
28666,SpokaneStBridge,04/09/2017 10:00:00 AM,48,-122,27,32,59
28667,SpokaneStBridge,04/09/2017 11:00:00 AM,48,-122,20,45,65
28668,SpokaneStBridge,04/09/2017 12:00:00 PM,48,-122,37,28,65
28669,SpokaneStBridge,04/09/2017 01:00:00 PM,48,-122,22,60,82
28670,SpokaneStBridge,04/09/2017 02:00:00 PM,48,-122,27,26,53
28671,SpokaneStBridge,04/09/2017 03:00:00 PM,48,-122,43,38,81
28672,SpokaneStBridge,04/09/2017 04:00:00 PM,48,-122,39,22,61
28673,SpokaneStBridge,04/09/2017 05:00:00 PM,48,-122,20,17,37
28674,SpokaneStBridge,04/09/2017 06:00:00 PM,48,-122,12,14,26
28675,SpokaneStBridge,04/09/2017 07:00:00 PM,48,-122,9,7,16
28676,SpokaneStBridge,04/09/2017 08:00:00 PM,48,-122,4,3,7
28677,SpokaneStBridge,04/09/2017 09:00:00 PM,48,-122,1,3,4
28678,SpokaneStBridge,04/09/2017 10:00:00 PM,48,-122,2,1,3
28679,SpokaneStBridge,04/09/2017 11:00:00 PM,48,-122,1,4,5
28680,SpokaneStBridge,04/10/2017 12:00:00 AM,48,-122,0,0,0
28681,SpokaneStBridge,04/10/2017 01:00:00 AM,48,-122,0,0,0
28682,SpokaneStBridge,04/10/2017 02:00:00 AM,48,-122,0,0,0
28683,SpokaneStBridge,04/10/2017 03:00:00 AM,48,-122,0,2,2
28684,SpokaneStBridge,04/10/2017 04:00:00 AM,48,-122,3,0,3
28685,SpokaneStBridge,04/10/2017 05:00:00 AM,48,-122,9,3,12
28686,SpokaneStBridge,04/10/2017 06:00:00 AM,48,-122,27,8,35
28687,SpokaneStBridge,04/10/2017 07:00:00 AM,48,-122,77,8,85
28688,SpokaneStBridge,04/10/2017 08:00:00 AM,48,-122,93,7,100
28689,SpokaneStBridge,04/10/2017 09:00:00 AM,48,-122,34,8,42
28690,SpokaneStBridge,04/10/2017 10:00:00 AM,48,-122,14,7,21
28691,SpokaneStBridge,04/10/2017 11:00:00 AM,48,-122,11,6,17
28692,SpokaneStBridge,04/10/2017 12:00:00 PM,48,-122,5,5,10
28693,SpokaneStBridge,04/10/2017 01:00:00 PM,48,-122,5,4,9
28694,SpokaneStBridge,04/10/2017 02:00:00 PM,48,-122,6,8,14
28695,SpokaneStBridge,04/10/2017 03:00:00 PM,48,-122,11,17,28
28696,SpokaneStBridge,04/10/2017 04:00:00 PM,48,-122,6,41,47
28697,SpokaneStBridge,04/10/2017 05:00:00 PM,48,-122,10,96,106
28698,SpokaneStBridge,04/10/2017 06:00:00 PM,48,-122,5,57,62
28699,SpokaneStBridge,04/10/2017 07:00:00 PM,48,-122,5,19,24
28700,SpokaneStBridge,04/10/2017 08:00:00 PM,48,-122,5,7,12
28701,SpokaneStBridge,04/10/2017 09:00:00 PM,48,-122,1,2,3
28702,SpokaneStBridge,04/10/2017 10:00:00 PM,48,-122,0,0,0
28703,SpokaneStBridge,04/10/2017 11:00:00 PM,48,-122,0,0,0
28704,SpokaneStBridge,04/11/2017 12:00:00 AM,48,-122,0,0,0
28705,SpokaneStBridge,04/11/2017 01:00:00 AM,48,-122,0,2,2
28706,SpokaneStBridge,04/11/2017 02:00:00 AM,48,-122,0,1,1
28707,SpokaneStBridge,04/11/2017 03:00:00 AM,48,-122,0,2,2
28708,SpokaneStBridge,04/11/2017 04:00:00 AM,48,-122,5,1,6
28709,SpokaneStBridge,04/11/2017 05:00:00 AM,48,-122,18,3,21
28710,SpokaneStBridge,04/11/2017 06:00:00 AM,48,-122,51,7,58
28711,SpokaneStBridge,04/11/2017 07:00:00 AM,48,-122,124,9,133
28712,SpokaneStBridge,04/11/2017 08:00:00 AM,48,-122,109,11,120
28713,SpokaneStBridge,04/11/2017 09:00:00 AM,48,-122,53,16,69
28714,SpokaneStBridge,04/11/2017 10:00:00 AM,48,-122,14,11,25
28715,SpokaneStBridge,04/11/2017 11:00:00 AM,48,-122,9,9,18
28716,SpokaneStBridge,04/11/2017 12:00:00 PM,48,-122,12,8,20
28717,SpokaneStBridge,04/11/2017 01:00:00 PM,48,-122,17,18,35
28718,SpokaneStBridge,04/11/2017 02:00:00 PM,48,-122,13,15,28
28719,SpokaneStBridge,04/11/2017 03:00:00 PM,48,-122,13,32,45
28720,SpokaneStBridge,04/11/2017 04:00:00 PM,48,-122,18,60,78
28721,SpokaneStBridge,04/11/2017 05:00:00 PM,48,-122,15,137,152
28722,SpokaneStBridge,04/11/2017 06:00:00 PM,48,-122,14,93,107
28723,SpokaneStBridge,04/11/2017 07:00:00 PM,48,-122,14,25,39
28724,SpokaneStBridge,04/11/2017 08:00:00 PM,48,-122,1,18,19
28725,SpokaneStBridge,04/11/2017 09:00:00 PM,48,-122,2,8,10
28726,SpokaneStBridge,04/11/2017 10:00:00 PM,48,-122,3,3,6
28727,SpokaneStBridge,04/11/2017 11:00:00 PM,48,-122,1,4,5
28728,SpokaneStBridge,04/12/2017 12:00:00 AM,48,-122,1,1,2
28729,SpokaneStBridge,04/12/2017 01:00:00 AM,48,-122,1,0,1
28730,SpokaneStBridge,04/12/2017 02:00:00 AM,48,-122,0,0,0
28731,SpokaneStBridge,04/12/2017 03:00:00 AM,48,-122,0,1,1
28732,SpokaneStBridge,04/12/2017 04:00:00 AM,48,-122,3,0,3
28733,SpokaneStBridge,04/12/2017 05:00:00 AM,48,-122,8,4,12
28734,SpokaneStBridge,04/12/2017 06:00:00 AM,48,-122,16,4,20
28735,SpokaneStBridge,04/12/2017 07:00:00 AM,48,-122,60,6,66
28736,SpokaneStBridge,04/12/2017 08:00:00 AM,48,-122,56,1,57
28737,SpokaneStBridge,04/12/2017 09:00:00 AM,48,-122,20,5,25
28738,SpokaneStBridge,04/12/2017 10:00:00 AM,48,-122,5,1,6
28739,SpokaneStBridge,04/12/2017 11:00:00 AM,48,-122,3,1,4
28740,SpokaneStBridge,04/12/2017 12:00:00 PM,48,-122,4,1,5
28741,SpokaneStBridge,04/12/2017 01:00:00 PM,48,-122,6,1,7
28742,SpokaneStBridge,04/12/2017 02:00:00 PM,48,-122,4,11,15
28743,SpokaneStBridge,04/12/2017 03:00:00 PM,48,-122,3,12,15
28744,SpokaneStBridge,04/12/2017 04:00:00 PM,48,-122,8,25,33
28745,SpokaneStBridge,04/12/2017 05:00:00 PM,48,-122,17,77,94
28746,SpokaneStBridge,04/12/2017 06:00:00 PM,48,-122,9,55,64
28747,SpokaneStBridge,04/12/2017 07:00:00 PM,48,-122,4,15,19
28748,SpokaneStBridge,04/12/2017 08:00:00 PM,48,-122,4,8,12
28749,SpokaneStBridge,04/12/2017 09:00:00 PM,48,-122,0,5,5
28750,SpokaneStBridge,04/12/2017 10:00:00 PM,48,-122,1,2,3
28751,SpokaneStBridge,04/12/2017 11:00:00 PM,48,-122,0,1,1
28752,SpokaneStBridge,04/13/2017 12:00:00 AM,48,-122,0,2,2
28753,SpokaneStBridge,04/13/2017 01:00:00 AM,48,-122,1,0,1
28754,SpokaneStBridge,04/13/2017 02:00:00 AM,48,-122,0,1,1
28755,SpokaneStBridge,04/13/2017 03:00:00 AM,48,-122,0,1,1
28756,SpokaneStBridge,04/13/2017 04:00:00 AM,48,-122,3,0,3
28757,SpokaneStBridge,04/13/2017 05:00:00 AM,48,-122,13,5,18
28758,SpokaneStBridge,04/13/2017 06:00:00 AM,48,-122,28,7,35
28759,SpokaneStBridge,04/13/2017 07:00:00 AM,48,-122,88,11,99
28760,SpokaneStBridge,04/13/2017 08:00:00 AM,48,-122,90,7,97
28761,SpokaneStBridge,04/13/2017 09:00:00 AM,48,-122,36,4,40
28762,SpokaneStBridge,04/13/2017 10:00:00 AM,48,-122,12,3,15
28763,SpokaneStBridge,04/13/2017 11:00:00 AM,48,-122,7,3,10
28764,SpokaneStBridge,04/13/2017 12:00:00 PM,48,-122,5,7,12
28765,SpokaneStBridge,04/13/2017 01:00:00 PM,48,-122,10,5,15
28766,SpokaneStBridge,04/13/2017 02:00:00 PM,48,-122,7,9,16
28767,SpokaneStBridge,04/13/2017 03:00:00 PM,48,-122,6,26,32
28768,SpokaneStBridge,04/13/2017 04:00:00 PM,48,-122,7,37,44
28769,SpokaneStBridge,04/13/2017 05:00:00 PM,48,-122,9,96,105
28770,SpokaneStBridge,04/13/2017 06:00:00 PM,48,-122,6,57,63
28771,SpokaneStBridge,04/13/2017 07:00:00 PM,48,-122,5,22,27
28772,SpokaneStBridge,04/13/2017 08:00:00 PM,48,-122,1,13,14
28773,SpokaneStBridge,04/13/2017 09:00:00 PM,48,-122,5,8,13
28774,SpokaneStBridge,04/13/2017 10:00:00 PM,48,-122,2,3,5
28775,SpokaneStBridge,04/13/2017 11:00:00 PM,48,-122,2,1,3
28776,SpokaneStBridge,04/14/2017 12:00:00 AM,48,-122,0,1,1
28777,SpokaneStBridge,04/14/2017 01:00:00 AM,48,-122,0,0,0
28778,SpokaneStBridge,04/14/2017 02:00:00 AM,48,-122,0,0,0
28779,SpokaneStBridge,04/14/2017 03:00:00 AM,48,-122,0,0,0
28780,SpokaneStBridge,04/14/2017 04:00:00 AM,48,-122,2,0,2
28781,SpokaneStBridge,04/14/2017 05:00:00 AM,48,-122,9,2,11
28782,SpokaneStBridge,04/14/2017 06:00:00 AM,48,-122,23,5,28
28783,SpokaneStBridge,04/14/2017 07:00:00 AM,48,-122,68,8,76
28784,SpokaneStBridge,04/14/2017 08:00:00 AM,48,-122,56,7,63
28785,SpokaneStBridge,04/14/2017 09:00:00 AM,48,-122,23,1,24
28786,SpokaneStBridge,04/14/2017 10:00:00 AM,48,-122,7,2,9
28787,SpokaneStBridge,04/14/2017 11:00:00 AM,48,-122,7,6,13
28788,SpokaneStBridge,04/14/2017 12:00:00 PM,48,-122,14,6,20
28789,SpokaneStBridge,04/14/2017 01:00:00 PM,48,-122,5,8,13
28790,SpokaneStBridge,04/14/2017 02:00:00 PM,48,-122,2,12,14
28791,SpokaneStBridge,04/14/2017 03:00:00 PM,48,-122,15,19,34
28792,SpokaneStBridge,04/14/2017 04:00:00 PM,48,-122,13,36,49
28793,SpokaneStBridge,04/14/2017 05:00:00 PM,48,-122,12,64,76
28794,SpokaneStBridge,04/14/2017 06:00:00 PM,48,-122,4,28,32
28795,SpokaneStBridge,04/14/2017 07:00:00 PM,48,-122,10,14,24
28796,SpokaneStBridge,04/14/2017 08:00:00 PM,48,-122,2,3,5
28797,SpokaneStBridge,04/14/2017 09:00:00 PM,48,-122,2,3,5
28798,SpokaneStBridge,04/14/2017 10:00:00 PM,48,-122,1,1,2
28799,SpokaneStBridge,04/14/2017 11:00:00 PM,48,-122,1,2,3
28800,SpokaneStBridge,04/15/2017 12:00:00 AM,48,-122,0,3,3
28801,SpokaneStBridge,04/15/2017 01:00:00 AM,48,-122,0,0,0
28802,SpokaneStBridge,04/15/2017 02:00:00 AM,48,-122,0,0,0
28803,SpokaneStBridge,04/15/2017 03:00:00 AM,48,-122,0,0,0
28804,SpokaneStBridge,04/15/2017 04:00:00 AM,48,-122,0,1,1
28805,SpokaneStBridge,04/15/2017 05:00:00 AM,48,-122,1,3,4
28806,SpokaneStBridge,04/15/2017 06:00:00 AM,48,-122,3,2,5
28807,SpokaneStBridge,04/15/2017 07:00:00 AM,48,-122,14,7,21
28808,SpokaneStBridge,04/15/2017 08:00:00 AM,48,-122,14,7,21
28809,SpokaneStBridge,04/15/2017 09:00:00 AM,48,-122,12,36,48
28810,SpokaneStBridge,04/15/2017 10:00:00 AM,48,-122,29,15,44
28811,SpokaneStBridge,04/15/2017 11:00:00 AM,48,-122,33,28,61
28812,SpokaneStBridge,04/15/2017 12:00:00 PM,48,-122,21,24,45
28813,SpokaneStBridge,04/15/2017 01:00:00 PM,48,-122,36,23,59
28814,SpokaneStBridge,04/15/2017 02:00:00 PM,48,-122,30,21,51
28815,SpokaneStBridge,04/15/2017 03:00:00 PM,48,-122,16,20,36
28816,SpokaneStBridge,04/15/2017 04:00:00 PM,48,-122,31,35,66
28817,SpokaneStBridge,04/15/2017 05:00:00 PM,48,-122,14,14,28
28818,SpokaneStBridge,04/15/2017 06:00:00 PM,48,-122,14,16,30
28819,SpokaneStBridge,04/15/2017 07:00:00 PM,48,-122,5,3,8
28820,SpokaneStBridge,04/15/2017 08:00:00 PM,48,-122,2,5,7
28821,SpokaneStBridge,04/15/2017 09:00:00 PM,48,-122,3,9,12
28822,SpokaneStBridge,04/15/2017 10:00:00 PM,48,-122,1,3,4
28823,SpokaneStBridge,04/15/2017 11:00:00 PM,48,-122,1,2,3
28824,SpokaneStBridge,04/16/2017 12:00:00 AM,48,-122,1,2,3
28825,SpokaneStBridge,04/16/2017 01:00:00 AM,48,-122,1,0,1
28826,SpokaneStBridge,04/16/2017 02:00:00 AM,48,-122,0,0,0
28827,SpokaneStBridge,04/16/2017 03:00:00 AM,48,-122,0,0,0
28828,SpokaneStBridge,04/16/2017 04:00:00 AM,48,-122,1,1,2
28829,SpokaneStBridge,04/16/2017 05:00:00 AM,48,-122,1,2,3
28830,SpokaneStBridge,04/16/2017 06:00:00 AM,48,-122,7,3,10
28831,SpokaneStBridge,04/16/2017 07:00:00 AM,48,-122,5,2,7
28832,SpokaneStBridge,04/16/2017 08:00:00 AM,48,-122,17,8,25
28833,SpokaneStBridge,04/16/2017 09:00:00 AM,48,-122,28,12,40
28834,SpokaneStBridge,04/16/2017 10:00:00 AM,48,-122,16,19,35
28835,SpokaneStBridge,04/16/2017 11:00:00 AM,48,-122,24,34,58
28836,SpokaneStBridge,04/16/2017 12:00:00 PM,48,-122,20,23,43
28837,SpokaneStBridge,04/16/2017 01:00:00 PM,48,-122,38,26,64
28838,SpokaneStBridge,04/16/2017 02:00:00 PM,48,-122,21,36,57
28839,SpokaneStBridge,04/16/2017 03:00:00 PM,48,-122,27,23,50
28840,SpokaneStBridge,04/16/2017 04:00:00 PM,48,-122,17,29,46
28841,SpokaneStBridge,04/16/2017 05:00:00 PM,48,-122,18,23,41
28842,SpokaneStBridge,04/16/2017 06:00:00 PM,48,-122,13,6,19
28843,SpokaneStBridge,04/16/2017 07:00:00 PM,48,-122,6,4,10
28844,SpokaneStBridge,04/16/2017 08:00:00 PM,48,-122,9,5,14
28845,SpokaneStBridge,04/16/2017 09:00:00 PM,48,-122,0,1,1
28846,SpokaneStBridge,04/16/2017 10:00:00 PM,48,-122,3,0,3
28847,SpokaneStBridge,04/16/2017 11:00:00 PM,48,-122,1,3,4
28848,SpokaneStBridge,04/17/2017 12:00:00 AM,48,-122,1,1,2
28849,SpokaneStBridge,04/17/2017 01:00:00 AM,48,-122,3,1,4
28850,SpokaneStBridge,04/17/2017 02:00:00 AM,48,-122,0,1,1
28851,SpokaneStBridge,04/17/2017 03:00:00 AM,48,-122,0,1,1
28852,SpokaneStBridge,04/17/2017 04:00:00 AM,48,-122,6,1,7
28853,SpokaneStBridge,04/17/2017 05:00:00 AM,48,-122,14,4,18
28854,SpokaneStBridge,04/17/2017 06:00:00 AM,48,-122,39,9,48
28855,SpokaneStBridge,04/17/2017 07:00:00 AM,48,-122,99,12,111
28856,SpokaneStBridge,04/17/2017 08:00:00 AM,48,-122,90,8,98
28857,SpokaneStBridge,04/17/2017 09:00:00 AM,48,-122,37,12,49
28858,SpokaneStBridge,04/17/2017 10:00:00 AM,48,-122,21,8,29
28859,SpokaneStBridge,04/17/2017 11:00:00 AM,48,-122,8,9,17
28860,SpokaneStBridge,04/17/2017 12:00:00 PM,48,-122,10,9,19
28861,SpokaneStBridge,04/17/2017 01:00:00 PM,48,-122,14,6,20
28862,SpokaneStBridge,04/17/2017 02:00:00 PM,48,-122,13,9,22
28863,SpokaneStBridge,04/17/2017 03:00:00 PM,48,-122,11,20,31
28864,SpokaneStBridge,04/17/2017 04:00:00 PM,48,-122,5,51,56
28865,SpokaneStBridge,04/17/2017 05:00:00 PM,48,-122,11,102,113
28866,SpokaneStBridge,04/17/2017 06:00:00 PM,48,-122,4,59,63
28867,SpokaneStBridge,04/17/2017 07:00:00 PM,48,-122,1,18,19
28868,SpokaneStBridge,04/17/2017 08:00:00 PM,48,-122,2,7,9
28869,SpokaneStBridge,04/17/2017 09:00:00 PM,48,-122,0,5,5
28870,SpokaneStBridge,04/17/2017 10:00:00 PM,48,-122,0,5,5
28871,SpokaneStBridge,04/17/2017 11:00:00 PM,48,-122,2,0,2
28872,SpokaneStBridge,04/18/2017 12:00:00 AM,48,-122,1,0,1
28873,SpokaneStBridge,04/18/2017 01:00:00 AM,48,-122,0,1,1
28874,SpokaneStBridge,04/18/2017 02:00:00 AM,48,-122,0,1,1
28875,SpokaneStBridge,04/18/2017 03:00:00 AM,48,-122,0,2,2
28876,SpokaneStBridge,04/18/2017 04:00:00 AM,48,-122,4,1,5
28877,SpokaneStBridge,04/18/2017 05:00:00 AM,48,-122,16,3,19
28878,SpokaneStBridge,04/18/2017 06:00:00 AM,48,-122,40,9,49
28879,SpokaneStBridge,04/18/2017 07:00:00 AM,48,-122,83,14,97
28880,SpokaneStBridge,04/18/2017 08:00:00 AM,48,-122,86,6,92
28881,SpokaneStBridge,04/18/2017 09:00:00 AM,48,-122,31,5,36
28882,SpokaneStBridge,04/18/2017 10:00:00 AM,48,-122,7,3,10
28883,SpokaneStBridge,04/18/2017 11:00:00 AM,48,-122,8,2,10
28884,SpokaneStBridge,04/18/2017 12:00:00 PM,48,-122,7,6,13
28885,SpokaneStBridge,04/18/2017 01:00:00 PM,48,-122,7,6,13
28886,SpokaneStBridge,04/18/2017 02:00:00 PM,48,-122,6,16,22
28887,SpokaneStBridge,04/18/2017 03:00:00 PM,48,-122,7,23,30
28888,SpokaneStBridge,04/18/2017 04:00:00 PM,48,-122,13,55,68
28889,SpokaneStBridge,04/18/2017 05:00:00 PM,48,-122,13,94,107
28890,SpokaneStBridge,04/18/2017 06:00:00 PM,48,-122,10,64,74
28891,SpokaneStBridge,04/18/2017 07:00:00 PM,48,-122,10,31,41
28892,SpokaneStBridge,04/18/2017 08:00:00 PM,48,-122,2,11,13
28893,SpokaneStBridge,04/18/2017 09:00:00 PM,48,-122,3,5,8
28894,SpokaneStBridge,04/18/2017 10:00:00 PM,48,-122,2,6,8
28895,SpokaneStBridge,04/18/2017 11:00:00 PM,48,-122,0,4,4
28896,SpokaneStBridge,04/19/2017 12:00:00 AM,48,-122,1,1,2
28897,SpokaneStBridge,04/19/2017 01:00:00 AM,48,-122,0,1,1
28898,SpokaneStBridge,04/19/2017 02:00:00 AM,48,-122,1,1,2
28899,SpokaneStBridge,04/19/2017 03:00:00 AM,48,-122,1,1,2
28900,SpokaneStBridge,04/19/2017 04:00:00 AM,48,-122,8,1,9
28901,SpokaneStBridge,04/19/2017 05:00:00 AM,48,-122,14,5,19
28902,SpokaneStBridge,04/19/2017 06:00:00 AM,48,-122,47,8,55
28903,SpokaneStBridge,04/19/2017 07:00:00 AM,48,-122,99,15,114
28904,SpokaneStBridge,04/19/2017 08:00:00 AM,48,-122,76,5,81
28905,SpokaneStBridge,04/19/2017 09:00:00 AM,48,-122,43,10,53
28906,SpokaneStBridge,04/19/2017 10:00:00 AM,48,-122,12,5,17
28907,SpokaneStBridge,04/19/2017 11:00:00 AM,48,-122,3,1,4
28908,SpokaneStBridge,04/19/2017 12:00:00 PM,48,-122,4,5,9
28909,SpokaneStBridge,04/19/2017 01:00:00 PM,48,-122,3,4,7
28910,SpokaneStBridge,04/19/2017 02:00:00 PM,48,-122,3,3,6
28911,SpokaneStBridge,04/19/2017 03:00:00 PM,48,-122,3,25,28
28912,SpokaneStBridge,04/19/2017 04:00:00 PM,48,-122,15,61,76
28913,SpokaneStBridge,04/19/2017 05:00:00 PM,48,-122,12,96,108
28914,SpokaneStBridge,04/19/2017 06:00:00 PM,48,-122,9,62,71
28915,SpokaneStBridge,04/19/2017 07:00:00 PM,48,-122,10,29,39
28916,SpokaneStBridge,04/19/2017 08:00:00 PM,48,-122,5,11,16
28917,SpokaneStBridge,04/19/2017 09:00:00 PM,48,-122,2,4,6
28918,SpokaneStBridge,04/19/2017 10:00:00 PM,48,-122,1,1,2
28919,SpokaneStBridge,04/19/2017 11:00:00 PM,48,-122,0,2,2
28920,SpokaneStBridge,04/20/2017 12:00:00 AM,48,-122,1,0,1
28921,SpokaneStBridge,04/20/2017 01:00:00 AM,48,-122,0,0,0
28922,SpokaneStBridge,04/20/2017 02:00:00 AM,48,-122,0,2,2
28923,SpokaneStBridge,04/20/2017 03:00:00 AM,48,-122,0,2,2
28924,SpokaneStBridge,04/20/2017 04:00:00 AM,48,-122,2,0,2
28925,SpokaneStBridge,04/20/2017 05:00:00 AM,48,-122,13,3,16
28926,SpokaneStBridge,04/20/2017 06:00:00 AM,48,-122,47,12,59
28927,SpokaneStBridge,04/20/2017 07:00:00 AM,48,-122,89,19,108
28928,SpokaneStBridge,04/20/2017 08:00:00 AM,48,-122,84,9,93
28929,SpokaneStBridge,04/20/2017 09:00:00 AM,48,-122,33,9,42
28930,SpokaneStBridge,04/20/2017 10:00:00 AM,48,-122,11,6,17
28931,SpokaneStBridge,04/20/2017 11:00:00 AM,48,-122,9,3,12
28932,SpokaneStBridge,04/20/2017 12:00:00 PM,48,-122,5,8,13
28933,SpokaneStBridge,04/20/2017 01:00:00 PM,48,-122,15,5,20
28934,SpokaneStBridge,04/20/2017 02:00:00 PM,48,-122,6,15,21
28935,SpokaneStBridge,04/20/2017 03:00:00 PM,48,-122,13,25,38
28936,SpokaneStBridge,04/20/2017 04:00:00 PM,48,-122,16,51,67
28937,SpokaneStBridge,04/20/2017 05:00:00 PM,48,-122,17,101,118
28938,SpokaneStBridge,04/20/2017 06:00:00 PM,48,-122,15,68,83
28939,SpokaneStBridge,04/20/2017 07:00:00 PM,48,-122,8,57,65
28940,SpokaneStBridge,04/20/2017 08:00:00 PM,48,-122,5,14,19
28941,SpokaneStBridge,04/20/2017 09:00:00 PM,48,-122,9,11,20
28942,SpokaneStBridge,04/20/2017 10:00:00 PM,48,-122,6,7,13
28943,SpokaneStBridge,04/20/2017 11:00:00 PM,48,-122,18,5,23
28944,SpokaneStBridge,04/21/2017 12:00:00 AM,48,-122,2,0,2
28945,SpokaneStBridge,04/21/2017 01:00:00 AM,48,-122,1,1,2
28946,SpokaneStBridge,04/21/2017 02:00:00 AM,48,-122,0,2,2
28947,SpokaneStBridge,04/21/2017 03:00:00 AM,48,-122,0,1,1
28948,SpokaneStBridge,04/21/2017 04:00:00 AM,48,-122,1,0,1
28949,SpokaneStBridge,04/21/2017 05:00:00 AM,48,-122,19,9,28
28950,SpokaneStBridge,04/21/2017 06:00:00 AM,48,-122,53,13,66
28951,SpokaneStBridge,04/21/2017 07:00:00 AM,48,-122,125,18,143
28952,SpokaneStBridge,04/21/2017 08:00:00 AM,48,-122,97,21,118
28953,SpokaneStBridge,04/21/2017 09:00:00 AM,48,-122,51,11,62
28954,SpokaneStBridge,04/21/2017 10:00:00 AM,48,-122,25,13,38
28955,SpokaneStBridge,04/21/2017 11:00:00 AM,48,-122,15,10,25
28956,SpokaneStBridge,04/21/2017 12:00:00 PM,48,-122,26,23,49
28957,SpokaneStBridge,04/21/2017 01:00:00 PM,48,-122,15,17,32
28958,SpokaneStBridge,04/21/2017 02:00:00 PM,48,-122,24,38,62
28959,SpokaneStBridge,04/21/2017 03:00:00 PM,48,-122,26,68,94
28960,SpokaneStBridge,04/21/2017 04:00:00 PM,48,-122,37,123,160
28961,SpokaneStBridge,04/21/2017 05:00:00 PM,48,-122,32,119,151
28962,SpokaneStBridge,04/21/2017 06:00:00 PM,48,-122,16,79,95
28963,SpokaneStBridge,04/21/2017 07:00:00 PM,48,-122,11,21,32
28964,SpokaneStBridge,04/21/2017 08:00:00 PM,48,-122,6,7,13
28965,SpokaneStBridge,04/21/2017 09:00:00 PM,48,-122,3,10,13
28966,SpokaneStBridge,04/21/2017 10:00:00 PM,48,-122,1,0,1
28967,SpokaneStBridge,04/21/2017 11:00:00 PM,48,-122,1,3,4
28968,SpokaneStBridge,04/22/2017 12:00:00 AM,48,-122,1,3,4
28969,SpokaneStBridge,04/22/2017 01:00:00 AM,48,-122,2,2,4
28970,SpokaneStBridge,04/22/2017 02:00:00 AM,48,-122,2,3,5
28971,SpokaneStBridge,04/22/2017 03:00:00 AM,48,-122,1,1,2
28972,SpokaneStBridge,04/22/2017 04:00:00 AM,48,-122,2,2,4
28973,SpokaneStBridge,04/22/2017 05:00:00 AM,48,-122,5,2,7
28974,SpokaneStBridge,04/22/2017 06:00:00 AM,48,-122,14,2,16
28975,SpokaneStBridge,04/22/2017 07:00:00 AM,48,-122,17,9,26
28976,SpokaneStBridge,04/22/2017 08:00:00 AM,48,-122,5,23,28
28977,SpokaneStBridge,04/22/2017 09:00:00 AM,48,-122,14,15,29
28978,SpokaneStBridge,04/22/2017 10:00:00 AM,48,-122,19,24,43
28979,SpokaneStBridge,04/22/2017 11:00:00 AM,48,-122,16,4,20
28980,SpokaneStBridge,04/22/2017 12:00:00 PM,48,-122,7,6,13
28981,SpokaneStBridge,04/22/2017 01:00:00 PM,48,-122,14,7,21
28982,SpokaneStBridge,04/22/2017 02:00:00 PM,48,-122,15,11,26
28983,SpokaneStBridge,04/22/2017 03:00:00 PM,48,-122,5,10,15
28984,SpokaneStBridge,04/22/2017 04:00:00 PM,48,-122,6,12,18
28985,SpokaneStBridge,04/22/2017 05:00:00 PM,48,-122,5,9,14
28986,SpokaneStBridge,04/22/2017 06:00:00 PM,48,-122,3,7,10
28987,SpokaneStBridge,04/22/2017 07:00:00 PM,48,-122,0,2,2
28988,SpokaneStBridge,04/22/2017 08:00:00 PM,48,-122,1,1,2
28989,SpokaneStBridge,04/22/2017 09:00:00 PM,48,-122,2,5,7
28990,SpokaneStBridge,04/22/2017 10:00:00 PM,48,-122,2,3,5
28991,SpokaneStBridge,04/22/2017 11:00:00 PM,48,-122,0,0,0
28992,SpokaneStBridge,04/23/2017 12:00:00 AM,48,-122,0,3,3
28993,SpokaneStBridge,04/23/2017 01:00:00 AM,48,-122,2,1,3
28994,SpokaneStBridge,04/23/2017 02:00:00 AM,48,-122,2,0,2
28995,SpokaneStBridge,04/23/2017 03:00:00 AM,48,-122,0,1,1
28996,SpokaneStBridge,04/23/2017 04:00:00 AM,48,-122,0,1,1
28997,SpokaneStBridge,04/23/2017 05:00:00 AM,48,-122,4,0,4
28998,SpokaneStBridge,04/23/2017 06:00:00 AM,48,-122,2,3,5
28999,SpokaneStBridge,04/23/2017 07:00:00 AM,48,-122,15,5,20
29000,SpokaneStBridge,04/23/2017 08:00:00 AM,48,-122,22,8,30
29001,SpokaneStBridge,04/23/2017 09:00:00 AM,48,-122,13,14,27
29002,SpokaneStBridge,04/23/2017 10:00:00 AM,48,-122,8,16,24
29003,SpokaneStBridge,04/23/2017 11:00:00 AM,48,-122,4,15,19
29004,SpokaneStBridge,04/23/2017 12:00:00 PM,48,-122,5,19,24
29005,SpokaneStBridge,04/23/2017 01:00:00 PM,48,-122,10,7,17
29006,SpokaneStBridge,04/23/2017 02:00:00 PM,48,-122,15,6,21
29007,SpokaneStBridge,04/23/2017 03:00:00 PM,48,-122,5,8,13
29008,SpokaneStBridge,04/23/2017 04:00:00 PM,48,-122,7,4,11
29009,SpokaneStBridge,04/23/2017 05:00:00 PM,48,-122,5,2,7
29010,SpokaneStBridge,04/23/2017 06:00:00 PM,48,-122,3,4,7
29011,SpokaneStBridge,04/23/2017 07:00:00 PM,48,-122,3,2,5
29012,SpokaneStBridge,04/23/2017 08:00:00 PM,48,-122,3,1,4
29013,SpokaneStBridge,04/23/2017 09:00:00 PM,48,-122,0,2,2
29014,SpokaneStBridge,04/23/2017 10:00:00 PM,48,-122,1,2,3
29015,SpokaneStBridge,04/23/2017 11:00:00 PM,48,-122,0,0,0
29016,SpokaneStBridge,04/24/2017 12:00:00 AM,48,-122,1,0,1
29017,SpokaneStBridge,04/24/2017 01:00:00 AM,48,-122,1,0,1
29018,SpokaneStBridge,04/24/2017 02:00:00 AM,48,-122,0,0,0
29019,SpokaneStBridge,04/24/2017 03:00:00 AM,48,-122,0,1,1
29020,SpokaneStBridge,04/24/2017 04:00:00 AM,48,-122,1,1,2
29021,SpokaneStBridge,04/24/2017 05:00:00 AM,48,-122,13,3,16
29022,SpokaneStBridge,04/24/2017 06:00:00 AM,48,-122,28,9,37
29023,SpokaneStBridge,04/24/2017 07:00:00 AM,48,-122,111,12,123
29024,SpokaneStBridge,04/24/2017 08:00:00 AM,48,-122,94,12,106
29025,SpokaneStBridge,04/24/2017 09:00:00 AM,48,-122,28,4,32
29026,SpokaneStBridge,04/24/2017 10:00:00 AM,48,-122,16,4,20
29027,SpokaneStBridge,04/24/2017 11:00:00 AM,48,-122,7,3,10
29028,SpokaneStBridge,04/24/2017 12:00:00 PM,48,-122,13,10,23
29029,SpokaneStBridge,04/24/2017 01:00:00 PM,48,-122,3,4,7
29030,SpokaneStBridge,04/24/2017 02:00:00 PM,48,-122,9,10,19
29031,SpokaneStBridge,04/24/2017 03:00:00 PM,48,-122,10,16,26
29032,SpokaneStBridge,04/24/2017 04:00:00 PM,48,-122,18,68,86
29033,SpokaneStBridge,04/24/2017 05:00:00 PM,48,-122,20,115,135
29034,SpokaneStBridge,04/24/2017 06:00:00 PM,48,-122,15,84,99
29035,SpokaneStBridge,04/24/2017 07:00:00 PM,48,-122,7,22,29
29036,SpokaneStBridge,04/24/2017 08:00:00 PM,48,-122,9,12,21
29037,SpokaneStBridge,04/24/2017 09:00:00 PM,48,-122,4,6,10
29038,SpokaneStBridge,04/24/2017 10:00:00 PM,48,-122,3,1,4
29039,SpokaneStBridge,04/24/2017 11:00:00 PM,48,-122,1,2,3
29040,SpokaneStBridge,04/25/2017 12:00:00 AM,48,-122,0,1,1
29041,SpokaneStBridge,04/25/2017 01:00:00 AM,48,-122,0,0,0
29042,SpokaneStBridge,04/25/2017 02:00:00 AM,48,-122,1,3,4
29043,SpokaneStBridge,04/25/2017 03:00:00 AM,48,-122,0,2,2
29044,SpokaneStBridge,04/25/2017 04:00:00 AM,48,-122,2,1,3
29045,SpokaneStBridge,04/25/2017 05:00:00 AM,48,-122,20,5,25
29046,SpokaneStBridge,04/25/2017 06:00:00 AM,48,-122,66,16,82
29047,SpokaneStBridge,04/25/2017 07:00:00 AM,48,-122,117,18,135
29048,SpokaneStBridge,04/25/2017 08:00:00 AM,48,-122,98,11,109
29049,SpokaneStBridge,04/25/2017 09:00:00 AM,48,-122,40,13,53
29050,SpokaneStBridge,04/25/2017 10:00:00 AM,48,-122,17,4,21
29051,SpokaneStBridge,04/25/2017 11:00:00 AM,48,-122,13,6,19
29052,SpokaneStBridge,04/25/2017 12:00:00 PM,48,-122,14,8,22
29053,SpokaneStBridge,04/25/2017 01:00:00 PM,48,-122,9,9,18
29054,SpokaneStBridge,04/25/2017 02:00:00 PM,48,-122,10,5,15
29055,SpokaneStBridge,04/25/2017 03:00:00 PM,48,-122,10,35,45
29056,SpokaneStBridge,04/25/2017 04:00:00 PM,48,-122,12,75,87
29057,SpokaneStBridge,04/25/2017 05:00:00 PM,48,-122,12,133,145
29058,SpokaneStBridge,04/25/2017 06:00:00 PM,48,-122,11,73,84
29059,SpokaneStBridge,04/25/2017 07:00:00 PM,48,-122,8,32,40
29060,SpokaneStBridge,04/25/2017 08:00:00 PM,48,-122,1,18,19
29061,SpokaneStBridge,04/25/2017 09:00:00 PM,48,-122,5,7,12
29062,SpokaneStBridge,04/25/2017 10:00:00 PM,48,-122,0,1,1
29063,SpokaneStBridge,04/25/2017 11:00:00 PM,48,-122,1,0,1
29064,SpokaneStBridge,04/26/2017 12:00:00 AM,48,-122,1,3,4
29065,SpokaneStBridge,04/26/2017 01:00:00 AM,48,-122,0,0,0
29066,SpokaneStBridge,04/26/2017 02:00:00 AM,48,-122,0,0,0
29067,SpokaneStBridge,04/26/2017 03:00:00 AM,48,-122,0,2,2
29068,SpokaneStBridge,04/26/2017 04:00:00 AM,48,-122,2,0,2
29069,SpokaneStBridge,04/26/2017 05:00:00 AM,48,-122,15,3,18
29070,SpokaneStBridge,04/26/2017 06:00:00 AM,48,-122,55,8,63
29071,SpokaneStBridge,04/26/2017 07:00:00 AM,48,-122,111,15,126
29072,SpokaneStBridge,04/26/2017 08:00:00 AM,48,-122,84,8,92
29073,SpokaneStBridge,04/26/2017 09:00:00 AM,48,-122,28,6,34
29074,SpokaneStBridge,04/26/2017 10:00:00 AM,48,-122,18,1,19
29075,SpokaneStBridge,04/26/2017 11:00:00 AM,48,-122,6,4,10
29076,SpokaneStBridge,04/26/2017 12:00:00 PM,48,-122,9,4,13
29077,SpokaneStBridge,04/26/2017 01:00:00 PM,48,-122,5,5,10
29078,SpokaneStBridge,04/26/2017 02:00:00 PM,48,-122,7,11,18
29079,SpokaneStBridge,04/26/2017 03:00:00 PM,48,-122,8,22,30
29080,SpokaneStBridge,04/26/2017 04:00:00 PM,48,-122,11,60,71
29081,SpokaneStBridge,04/26/2017 05:00:00 PM,48,-122,16,104,120
29082,SpokaneStBridge,04/26/2017 06:00:00 PM,48,-122,7,67,74
29083,SpokaneStBridge,04/26/2017 07:00:00 PM,48,-122,1,18,19
29084,SpokaneStBridge,04/26/2017 08:00:00 PM,48,-122,3,18,21
29085,SpokaneStBridge,04/26/2017 09:00:00 PM,48,-122,1,6,7
29086,SpokaneStBridge,04/26/2017 10:00:00 PM,48,-122,0,5,5
29087,SpokaneStBridge,04/26/2017 11:00:00 PM,48,-122,1,0,1
29088,SpokaneStBridge,04/27/2017 12:00:00 AM,48,-122,1,1,2
29089,SpokaneStBridge,04/27/2017 01:00:00 AM,48,-122,1,1,2
29090,SpokaneStBridge,04/27/2017 02:00:00 AM,48,-122,0,2,2
29091,SpokaneStBridge,04/27/2017 03:00:00 AM,48,-122,0,1,1
29092,SpokaneStBridge,04/27/2017 04:00:00 AM,48,-122,5,1,6
29093,SpokaneStBridge,04/27/2017 05:00:00 AM,48,-122,13,6,19
29094,SpokaneStBridge,04/27/2017 06:00:00 AM,48,-122,46,6,52
29095,SpokaneStBridge,04/27/2017 07:00:00 AM,48,-122,105,15,120
29096,SpokaneStBridge,04/27/2017 08:00:00 AM,48,-122,105,11,116
29097,SpokaneStBridge,04/27/2017 09:00:00 AM,48,-122,29,7,36
29098,SpokaneStBridge,04/27/2017 10:00:00 AM,48,-122,23,7,30
29099,SpokaneStBridge,04/27/2017 11:00:00 AM,48,-122,13,1,14
29100,SpokaneStBridge,04/27/2017 12:00:00 PM,48,-122,10,11,21
29101,SpokaneStBridge,04/27/2017 01:00:00 PM,48,-122,8,5,13
29102,SpokaneStBridge,04/27/2017 02:00:00 PM,48,-122,4,11,15
29103,SpokaneStBridge,04/27/2017 03:00:00 PM,48,-122,13,23,36
29104,SpokaneStBridge,04/27/2017 04:00:00 PM,48,-122,16,69,85
29105,SpokaneStBridge,04/27/2017 05:00:00 PM,48,-122,13,108,121
29106,SpokaneStBridge,04/27/2017 06:00:00 PM,48,-122,10,67,77
29107,SpokaneStBridge,04/27/2017 07:00:00 PM,48,-122,15,31,46
29108,SpokaneStBridge,04/27/2017 08:00:00 PM,48,-122,3,13,16
29109,SpokaneStBridge,04/27/2017 09:00:00 PM,48,-122,0,11,11
29110,SpokaneStBridge,04/27/2017 10:00:00 PM,48,-122,1,1,2
29111,SpokaneStBridge,04/27/2017 11:00:00 PM,48,-122,0,1,1
29112,SpokaneStBridge,04/28/2017 12:00:00 AM,48,-122,1,2,3
29113,SpokaneStBridge,04/28/2017 01:00:00 AM,48,-122,1,1,2
29114,SpokaneStBridge,04/28/2017 02:00:00 AM,48,-122,1,2,3
29115,SpokaneStBridge,04/28/2017 03:00:00 AM,48,-122,1,1,2
29116,SpokaneStBridge,04/28/2017 04:00:00 AM,48,-122,4,1,5
29117,SpokaneStBridge,04/28/2017 05:00:00 AM,48,-122,16,3,19
29118,SpokaneStBridge,04/28/2017 06:00:00 AM,48,-122,45,13,58
29119,SpokaneStBridge,04/28/2017 07:00:00 AM,48,-122,116,19,135
29120,SpokaneStBridge,04/28/2017 08:00:00 AM,48,-122,110,16,126
29121,SpokaneStBridge,04/28/2017 09:00:00 AM,48,-122,26,5,31
29122,SpokaneStBridge,04/28/2017 10:00:00 AM,48,-122,21,5,26
29123,SpokaneStBridge,04/28/2017 11:00:00 AM,48,-122,11,16,27
29124,SpokaneStBridge,04/28/2017 12:00:00 PM,48,-122,10,10,20
29125,SpokaneStBridge,04/28/2017 01:00:00 PM,48,-122,18,18,36
29126,SpokaneStBridge,04/28/2017 02:00:00 PM,48,-122,17,25,42
29127,SpokaneStBridge,04/28/2017 03:00:00 PM,48,-122,22,47,69
29128,SpokaneStBridge,04/28/2017 04:00:00 PM,48,-122,24,96,120
29129,SpokaneStBridge,04/28/2017 05:00:00 PM,48,-122,35,108,143
29130,SpokaneStBridge,04/28/2017 06:00:00 PM,48,-122,17,60,77
29131,SpokaneStBridge,04/28/2017 07:00:00 PM,48,-122,8,28,36
29132,SpokaneStBridge,04/28/2017 08:00:00 PM,48,-122,6,9,15
29133,SpokaneStBridge,04/28/2017 09:00:00 PM,48,-122,2,15,17
29134,SpokaneStBridge,04/28/2017 10:00:00 PM,48,-122,5,3,8
29135,SpokaneStBridge,04/28/2017 11:00:00 PM,48,-122,4,4,8
29136,SpokaneStBridge,04/29/2017 12:00:00 AM,48,-122,3,1,4
29137,SpokaneStBridge,04/29/2017 01:00:00 AM,48,-122,3,4,7
29138,SpokaneStBridge,04/29/2017 02:00:00 AM,48,-122,2,2,4
29139,SpokaneStBridge,04/29/2017 03:00:00 AM,48,-122,0,2,2
29140,SpokaneStBridge,04/29/2017 04:00:00 AM,48,-122,0,1,1
29141,SpokaneStBridge,04/29/2017 05:00:00 AM,48,-122,4,1,5
29142,SpokaneStBridge,04/29/2017 06:00:00 AM,48,-122,14,4,18
29143,SpokaneStBridge,04/29/2017 07:00:00 AM,48,-122,12,7,19
29144,SpokaneStBridge,04/29/2017 08:00:00 AM,48,-122,24,26,50
29145,SpokaneStBridge,04/29/2017 09:00:00 AM,48,-122,21,51,72
29146,SpokaneStBridge,04/29/2017 10:00:00 AM,48,-122,24,15,39
29147,SpokaneStBridge,04/29/2017 11:00:00 AM,48,-122,44,32,76
29148,SpokaneStBridge,04/29/2017 12:00:00 PM,48,-122,26,18,44
29149,SpokaneStBridge,04/29/2017 01:00:00 PM,48,-122,26,20,46
29150,SpokaneStBridge,04/29/2017 02:00:00 PM,48,-122,13,19,32
29151,SpokaneStBridge,04/29/2017 03:00:00 PM,48,-122,39,21,60
29152,SpokaneStBridge,04/29/2017 04:00:00 PM,48,-122,9,14,23
29153,SpokaneStBridge,04/29/2017 05:00:00 PM,48,-122,13,6,19
29154,SpokaneStBridge,04/29/2017 06:00:00 PM,48,-122,9,8,17
29155,SpokaneStBridge,04/29/2017 07:00:00 PM,48,-122,5,9,14
29156,SpokaneStBridge,04/29/2017 08:00:00 PM,48,-122,2,5,7
29157,SpokaneStBridge,04/29/2017 09:00:00 PM,48,-122,3,4,7
29158,SpokaneStBridge,04/29/2017 10:00:00 PM,48,-122,5,2,7
29159,SpokaneStBridge,04/29/2017 11:00:00 PM,48,-122,0,1,1
29160,SpokaneStBridge,04/30/2017 12:00:00 AM,48,-122,0,3,3
29161,SpokaneStBridge,04/30/2017 01:00:00 AM,48,-122,1,1,2
29162,SpokaneStBridge,04/30/2017 02:00:00 AM,48,-122,0,1,1
29163,SpokaneStBridge,04/30/2017 03:00:00 AM,48,-122,0,2,2
29164,SpokaneStBridge,04/30/2017 04:00:00 AM,48,-122,1,2,3
29165,SpokaneStBridge,04/30/2017 05:00:00 AM,48,-122,2,1,3
29166,SpokaneStBridge,04/30/2017 06:00:00 AM,48,-122,0,2,2
29167,SpokaneStBridge,04/30/2017 07:00:00 AM,48,-122,9,4,13
29168,SpokaneStBridge,04/30/2017 08:00:00 AM,48,-122,21,15,36
29169,SpokaneStBridge,04/30/2017 09:00:00 AM,48,-122,9,22,31
29170,SpokaneStBridge,04/30/2017 10:00:00 AM,48,-122,16,19,35
29171,SpokaneStBridge,04/30/2017 11:00:00 AM,48,-122,23,11,34
29172,SpokaneStBridge,04/30/2017 12:00:00 PM,48,-122,20,21,41
29173,SpokaneStBridge,04/30/2017 01:00:00 PM,48,-122,19,36,55
29174,SpokaneStBridge,04/30/2017 02:00:00 PM,48,-122,19,25,44
29175,SpokaneStBridge,04/30/2017 03:00:00 PM,48,-122,23,13,36
29176,SpokaneStBridge,04/30/2017 04:00:00 PM,48,-122,24,22,46
29177,SpokaneStBridge,04/30/2017 05:00:00 PM,48,-122,8,20,28
29178,SpokaneStBridge,04/30/2017 06:00:00 PM,48,-122,7,8,15
29179,SpokaneStBridge,04/30/2017 07:00:00 PM,48,-122,1,4,5
29180,SpokaneStBridge,04/30/2017 08:00:00 PM,48,-122,2,4,6
29181,SpokaneStBridge,04/30/2017 09:00:00 PM,48,-122,1,4,5
29182,SpokaneStBridge,04/30/2017 10:00:00 PM,48,-122,1,0,1
29183,SpokaneStBridge,04/30/2017 11:00:00 PM,48,-122,0,2,2
29184,SpokaneStBridge,05/01/2017 12:00:00 AM,48,-122,1,1,2
29185,SpokaneStBridge,05/01/2017 01:00:00 AM,48,-122,1,1,2
29186,SpokaneStBridge,05/01/2017 02:00:00 AM,48,-122,0,1,1
29187,SpokaneStBridge,05/01/2017 03:00:00 AM,48,-122,0,1,1
29188,SpokaneStBridge,05/01/2017 04:00:00 AM,48,-122,1,0,1
29189,SpokaneStBridge,05/01/2017 05:00:00 AM,48,-122,27,5,32
29190,SpokaneStBridge,05/01/2017 06:00:00 AM,48,-122,68,15,83
29191,SpokaneStBridge,05/01/2017 07:00:00 AM,48,-122,140,13,153
29192,SpokaneStBridge,05/01/2017 08:00:00 AM,48,-122,129,8,137
29193,SpokaneStBridge,05/01/2017 09:00:00 AM,48,-122,46,5,51
29194,SpokaneStBridge,05/01/2017 10:00:00 AM,48,-122,12,5,17
29195,SpokaneStBridge,05/01/2017 11:00:00 AM,48,-122,9,2,11
29196,SpokaneStBridge,05/01/2017 12:00:00 PM,48,-122,4,3,7
29197,SpokaneStBridge,05/01/2017 01:00:00 PM,48,-122,5,8,13
29198,SpokaneStBridge,05/01/2017 02:00:00 PM,48,-122,12,11,23
29199,SpokaneStBridge,05/01/2017 03:00:00 PM,48,-122,10,45,55
29200,SpokaneStBridge,05/01/2017 04:00:00 PM,48,-122,13,91,104
29201,SpokaneStBridge,05/01/2017 05:00:00 PM,48,-122,17,154,171
29202,SpokaneStBridge,05/01/2017 06:00:00 PM,48,-122,8,90,98
29203,SpokaneStBridge,05/01/2017 07:00:00 PM,48,-122,5,31,36
29204,SpokaneStBridge,05/01/2017 08:00:00 PM,48,-122,4,13,17
29205,SpokaneStBridge,05/01/2017 09:00:00 PM,48,-122,0,5,5
29206,SpokaneStBridge,05/01/2017 10:00:00 PM,48,-122,1,4,5
29207,SpokaneStBridge,05/01/2017 11:00:00 PM,48,-122,2,3,5
29208,SpokaneStBridge,05/02/2017 12:00:00 AM,48,-122,0,1,1
29209,SpokaneStBridge,05/02/2017 01:00:00 AM,48,-122,0,0,0
29210,SpokaneStBridge,05/02/2017 02:00:00 AM,48,-122,1,1,2
29211,SpokaneStBridge,05/02/2017 03:00:00 AM,48,-122,0,3,3
29212,SpokaneStBridge,05/02/2017 04:00:00 AM,48,-122,4,0,4
29213,SpokaneStBridge,05/02/2017 05:00:00 AM,48,-122,23,6,29
29214,SpokaneStBridge,05/02/2017 06:00:00 AM,48,-122,67,16,83
29215,SpokaneStBridge,05/02/2017 07:00:00 AM,48,-122,160,14,174
29216,SpokaneStBridge,05/02/2017 08:00:00 AM,48,-122,142,10,152
29217,SpokaneStBridge,05/02/2017 09:00:00 AM,48,-122,44,7,51
29218,SpokaneStBridge,05/02/2017 10:00:00 AM,48,-122,16,8,24
29219,SpokaneStBridge,05/02/2017 11:00:00 AM,48,-122,11,12,23
29220,SpokaneStBridge,05/02/2017 12:00:00 PM,48,-122,11,14,25
29221,SpokaneStBridge,05/02/2017 01:00:00 PM,48,-122,16,12,28
29222,SpokaneStBridge,05/02/2017 02:00:00 PM,48,-122,9,11,20
29223,SpokaneStBridge,05/02/2017 03:00:00 PM,48,-122,18,34,52
29224,SpokaneStBridge,05/02/2017 04:00:00 PM,48,-122,20,81,101
29225,SpokaneStBridge,05/02/2017 05:00:00 PM,48,-122,14,157,171
29226,SpokaneStBridge,05/02/2017 06:00:00 PM,48,-122,13,89,102
29227,SpokaneStBridge,05/02/2017 07:00:00 PM,48,-122,8,41,49
29228,SpokaneStBridge,05/02/2017 08:00:00 PM,48,-122,4,8,12
29229,SpokaneStBridge,05/02/2017 09:00:00 PM,48,-122,3,11,14
29230,SpokaneStBridge,05/02/2017 10:00:00 PM,48,-122,3,1,4
29231,SpokaneStBridge,05/02/2017 11:00:00 PM,48,-122,1,2,3
29232,SpokaneStBridge,05/03/2017 12:00:00 AM,48,-122,1,4,5
29233,SpokaneStBridge,05/03/2017 01:00:00 AM,48,-122,0,2,2
29234,SpokaneStBridge,05/03/2017 02:00:00 AM,48,-122,1,1,2
29235,SpokaneStBridge,05/03/2017 03:00:00 AM,48,-122,0,1,1
29236,SpokaneStBridge,05/03/2017 04:00:00 AM,48,-122,2,2,4
29237,SpokaneStBridge,05/03/2017 05:00:00 AM,48,-122,18,8,26
29238,SpokaneStBridge,05/03/2017 06:00:00 AM,48,-122,82,9,91
29239,SpokaneStBridge,05/03/2017 07:00:00 AM,48,-122,156,16,172
29240,SpokaneStBridge,05/03/2017 08:00:00 AM,48,-122,131,15,146
29241,SpokaneStBridge,05/03/2017 09:00:00 AM,48,-122,47,6,53
29242,SpokaneStBridge,05/03/2017 10:00:00 AM,48,-122,18,10,28
29243,SpokaneStBridge,05/03/2017 11:00:00 AM,48,-122,15,9,24
29244,SpokaneStBridge,05/03/2017 12:00:00 PM,48,-122,17,13,30
29245,SpokaneStBridge,05/03/2017 01:00:00 PM,48,-122,14,7,21
29246,SpokaneStBridge,05/03/2017 02:00:00 PM,48,-122,15,19,34
29247,SpokaneStBridge,05/03/2017 03:00:00 PM,48,-122,21,42,63
29248,SpokaneStBridge,05/03/2017 04:00:00 PM,48,-122,33,125,158
29249,SpokaneStBridge,05/03/2017 05:00:00 PM,48,-122,36,182,218
29250,SpokaneStBridge,05/03/2017 06:00:00 PM,48,-122,46,133,179
29251,SpokaneStBridge,05/03/2017 07:00:00 PM,48,-122,22,54,76
29252,SpokaneStBridge,05/03/2017 08:00:00 PM,48,-122,11,22,33
29253,SpokaneStBridge,05/03/2017 09:00:00 PM,48,-122,0,8,8
29254,SpokaneStBridge,05/03/2017 10:00:00 PM,48,-122,4,8,12
29255,SpokaneStBridge,05/03/2017 11:00:00 PM,48,-122,1,2,3
29256,SpokaneStBridge,05/04/2017 12:00:00 AM,48,-122,2,5,7
29257,SpokaneStBridge,05/04/2017 01:00:00 AM,48,-122,1,1,2
29258,SpokaneStBridge,05/04/2017 02:00:00 AM,48,-122,0,2,2
29259,SpokaneStBridge,05/04/2017 03:00:00 AM,48,-122,0,0,0
29260,SpokaneStBridge,05/04/2017 04:00:00 AM,48,-122,0,0,0
29261,SpokaneStBridge,05/04/2017 05:00:00 AM,48,-122,21,3,24
29262,SpokaneStBridge,05/04/2017 06:00:00 AM,48,-122,67,21,88
29263,SpokaneStBridge,05/04/2017 07:00:00 AM,48,-122,159,14,173
29264,SpokaneStBridge,05/04/2017 08:00:00 AM,48,-122,134,7,141
29265,SpokaneStBridge,05/04/2017 09:00:00 AM,48,-122,46,10,56
29266,SpokaneStBridge,05/04/2017 10:00:00 AM,48,-122,21,5,26
29267,SpokaneStBridge,05/04/2017 11:00:00 AM,48,-122,15,11,26
29268,SpokaneStBridge,05/04/2017 12:00:00 PM,48,-122,22,20,42
29269,SpokaneStBridge,05/04/2017 01:00:00 PM,48,-122,21,22,43
29270,SpokaneStBridge,05/04/2017 02:00:00 PM,48,-122,28,20,48
29271,SpokaneStBridge,05/04/2017 03:00:00 PM,48,-122,25,60,85
29272,SpokaneStBridge,05/04/2017 04:00:00 PM,48,-122,17,101,118
29273,SpokaneStBridge,05/04/2017 05:00:00 PM,48,-122,8,92,100
29274,SpokaneStBridge,05/04/2017 06:00:00 PM,48,-122,11,61,72
29275,SpokaneStBridge,05/04/2017 07:00:00 PM,48,-122,7,25,32
29276,SpokaneStBridge,05/04/2017 08:00:00 PM,48,-122,5,9,14
29277,SpokaneStBridge,05/04/2017 09:00:00 PM,48,-122,4,10,14
29278,SpokaneStBridge,05/04/2017 10:00:00 PM,48,-122,2,1,3
29279,SpokaneStBridge,05/04/2017 11:00:00 PM,48,-122,2,3,5
29280,SpokaneStBridge,05/05/2017 12:00:00 AM,48,-122,2,3,5
29281,SpokaneStBridge,05/05/2017 01:00:00 AM,48,-122,1,0,1
29282,SpokaneStBridge,05/05/2017 02:00:00 AM,48,-122,0,4,4
29283,SpokaneStBridge,05/05/2017 03:00:00 AM,48,-122,2,0,2
29284,SpokaneStBridge,05/05/2017 04:00:00 AM,48,-122,3,2,5
29285,SpokaneStBridge,05/05/2017 05:00:00 AM,48,-122,10,6,16
29286,SpokaneStBridge,05/05/2017 06:00:00 AM,48,-122,46,11,57
29287,SpokaneStBridge,05/05/2017 07:00:00 AM,48,-122,110,8,118
29288,SpokaneStBridge,05/05/2017 08:00:00 AM,48,-122,72,10,82
29289,SpokaneStBridge,05/05/2017 09:00:00 AM,48,-122,39,2,41
29290,SpokaneStBridge,05/05/2017 10:00:00 AM,48,-122,9,5,14
29291,SpokaneStBridge,05/05/2017 11:00:00 AM,48,-122,11,3,14
29292,SpokaneStBridge,05/05/2017 12:00:00 PM,48,-122,7,12,19
29293,SpokaneStBridge,05/05/2017 01:00:00 PM,48,-122,11,9,20
29294,SpokaneStBridge,05/05/2017 02:00:00 PM,48,-122,8,15,23
29295,SpokaneStBridge,05/05/2017 03:00:00 PM,48,-122,13,29,42
29296,SpokaneStBridge,05/05/2017 04:00:00 PM,48,-122,12,76,88
29297,SpokaneStBridge,05/05/2017 05:00:00 PM,48,-122,16,118,134
29298,SpokaneStBridge,05/05/2017 06:00:00 PM,48,-122,7,49,56
29299,SpokaneStBridge,05/05/2017 07:00:00 PM,48,-122,8,17,25
29300,SpokaneStBridge,05/05/2017 08:00:00 PM,48,-122,5,11,16
29301,SpokaneStBridge,05/05/2017 09:00:00 PM,48,-122,1,7,8
29302,SpokaneStBridge,05/05/2017 10:00:00 PM,48,-122,1,3,4
29303,SpokaneStBridge,05/05/2017 11:00:00 PM,48,-122,1,2,3
29304,SpokaneStBridge,05/06/2017 12:00:00 AM,48,-122,3,2,5
29305,SpokaneStBridge,05/06/2017 01:00:00 AM,48,-122,4,0,4
29306,SpokaneStBridge,05/06/2017 02:00:00 AM,48,-122,0,1,1
29307,SpokaneStBridge,05/06/2017 03:00:00 AM,48,-122,1,0,1
29308,SpokaneStBridge,05/06/2017 04:00:00 AM,48,-122,0,1,1
29309,SpokaneStBridge,05/06/2017 05:00:00 AM,48,-122,3,0,3
29310,SpokaneStBridge,05/06/2017 06:00:00 AM,48,-122,11,3,14
29311,SpokaneStBridge,05/06/2017 07:00:00 AM,48,-122,13,10,23
29312,SpokaneStBridge,05/06/2017 08:00:00 AM,48,-122,8,12,20
29313,SpokaneStBridge,05/06/2017 09:00:00 AM,48,-122,21,19,40
29314,SpokaneStBridge,05/06/2017 10:00:00 AM,48,-122,35,76,111
29315,SpokaneStBridge,05/06/2017 11:00:00 AM,48,-122,46,19,65
29316,SpokaneStBridge,05/06/2017 12:00:00 PM,48,-122,22,27,49
29317,SpokaneStBridge,05/06/2017 01:00:00 PM,48,-122,30,22,52
29318,SpokaneStBridge,05/06/2017 02:00:00 PM,48,-122,22,44,66
29319,SpokaneStBridge,05/06/2017 03:00:00 PM,48,-122,26,28,54
29320,SpokaneStBridge,05/06/2017 04:00:00 PM,48,-122,30,29,59
29321,SpokaneStBridge,05/06/2017 05:00:00 PM,48,-122,20,41,61
29322,SpokaneStBridge,05/06/2017 06:00:00 PM,48,-122,20,21,41
29323,SpokaneStBridge,05/06/2017 07:00:00 PM,48,-122,10,11,21
29324,SpokaneStBridge,05/06/2017 08:00:00 PM,48,-122,6,5,11
29325,SpokaneStBridge,05/06/2017 09:00:00 PM,48,-122,3,5,8
29326,SpokaneStBridge,05/06/2017 10:00:00 PM,48,-122,4,2,6
29327,SpokaneStBridge,05/06/2017 11:00:00 PM,48,-122,4,1,5
29328,SpokaneStBridge,05/07/2017 12:00:00 AM,48,-122,0,5,5
29329,SpokaneStBridge,05/07/2017 01:00:00 AM,48,-122,1,0,1
29330,SpokaneStBridge,05/07/2017 02:00:00 AM,48,-122,0,1,1
29331,SpokaneStBridge,05/07/2017 03:00:00 AM,48,-122,0,0,0
29332,SpokaneStBridge,05/07/2017 04:00:00 AM,48,-122,0,1,1
29333,SpokaneStBridge,05/07/2017 05:00:00 AM,48,-122,3,3,6
29334,SpokaneStBridge,05/07/2017 06:00:00 AM,48,-122,9,3,12
29335,SpokaneStBridge,05/07/2017 07:00:00 AM,48,-122,14,6,20
29336,SpokaneStBridge,05/07/2017 08:00:00 AM,48,-122,26,6,32
29337,SpokaneStBridge,05/07/2017 09:00:00 AM,48,-122,32,16,48
29338,SpokaneStBridge,05/07/2017 10:00:00 AM,48,-122,25,21,46
29339,SpokaneStBridge,05/07/2017 11:00:00 AM,48,-122,22,45,67
29340,SpokaneStBridge,05/07/2017 12:00:00 PM,48,-122,26,43,69
29341,SpokaneStBridge,05/07/2017 01:00:00 PM,48,-122,33,30,63
29342,SpokaneStBridge,05/07/2017 02:00:00 PM,48,-122,47,46,93
29343,SpokaneStBridge,05/07/2017 03:00:00 PM,48,-122,32,35,67
29344,SpokaneStBridge,05/07/2017 04:00:00 PM,48,-122,42,40,82
29345,SpokaneStBridge,05/07/2017 05:00:00 PM,48,-122,21,26,47
29346,SpokaneStBridge,05/07/2017 06:00:00 PM,48,-122,12,23,35
29347,SpokaneStBridge,05/07/2017 07:00:00 PM,48,-122,20,11,31
29348,SpokaneStBridge,05/07/2017 08:00:00 PM,48,-122,4,3,7
29349,SpokaneStBridge,05/07/2017 09:00:00 PM,48,-122,4,7,11
29350,SpokaneStBridge,05/07/2017 10:00:00 PM,48,-122,1,0,1
29351,SpokaneStBridge,05/07/2017 11:00:00 PM,48,-122,2,2,4
29352,SpokaneStBridge,05/08/2017 12:00:00 AM,48,-122,1,0,1
29353,SpokaneStBridge,05/08/2017 01:00:00 AM,48,-122,1,1,2
29354,SpokaneStBridge,05/08/2017 02:00:00 AM,48,-122,5,2,7
29355,SpokaneStBridge,05/08/2017 03:00:00 AM,48,-122,2,1,3
29356,SpokaneStBridge,05/08/2017 04:00:00 AM,48,-122,4,1,5
29357,SpokaneStBridge,05/08/2017 05:00:00 AM,48,-122,24,5,29
29358,SpokaneStBridge,05/08/2017 06:00:00 AM,48,-122,91,15,106
29359,SpokaneStBridge,05/08/2017 07:00:00 AM,48,-122,180,14,194
29360,SpokaneStBridge,05/08/2017 08:00:00 AM,48,-122,143,12,155
29361,SpokaneStBridge,05/08/2017 09:00:00 AM,48,-122,42,11,53
29362,SpokaneStBridge,05/08/2017 10:00:00 AM,48,-122,17,2,19
29363,SpokaneStBridge,05/08/2017 11:00:00 AM,48,-122,8,8,16
29364,SpokaneStBridge,05/08/2017 12:00:00 PM,48,-122,14,9,23
29365,SpokaneStBridge,05/08/2017 01:00:00 PM,48,-122,11,9,20
29366,SpokaneStBridge,05/08/2017 02:00:00 PM,48,-122,13,18,31
29367,SpokaneStBridge,05/08/2017 03:00:00 PM,48,-122,12,46,58
29368,SpokaneStBridge,05/08/2017 04:00:00 PM,48,-122,30,132,162
29369,SpokaneStBridge,05/08/2017 05:00:00 PM,48,-122,27,198,225
29370,SpokaneStBridge,05/08/2017 06:00:00 PM,48,-122,26,108,134
29371,SpokaneStBridge,05/08/2017 07:00:00 PM,48,-122,10,44,54
29372,SpokaneStBridge,05/08/2017 08:00:00 PM,48,-122,13,18,31
29373,SpokaneStBridge,05/08/2017 09:00:00 PM,48,-122,3,4,7
29374,SpokaneStBridge,05/08/2017 10:00:00 PM,48,-122,2,7,9
29375,SpokaneStBridge,05/08/2017 11:00:00 PM,48,-122,0,1,1
29376,SpokaneStBridge,05/09/2017 12:00:00 AM,48,-122,0,2,2
29377,SpokaneStBridge,05/09/2017 01:00:00 AM,48,-122,2,1,3
29378,SpokaneStBridge,05/09/2017 02:00:00 AM,48,-122,1,1,2
29379,SpokaneStBridge,05/09/2017 03:00:00 AM,48,-122,0,1,1
29380,SpokaneStBridge,05/09/2017 04:00:00 AM,48,-122,5,2,7
29381,SpokaneStBridge,05/09/2017 05:00:00 AM,48,-122,30,5,35
29382,SpokaneStBridge,05/09/2017 06:00:00 AM,48,-122,98,18,116
29383,SpokaneStBridge,05/09/2017 07:00:00 AM,48,-122,192,19,211
29384,SpokaneStBridge,05/09/2017 08:00:00 AM,48,-122,165,18,183
29385,SpokaneStBridge,05/09/2017 09:00:00 AM,48,-122,54,9,63
29386,SpokaneStBridge,05/09/2017 10:00:00 AM,48,-122,16,15,31
29387,SpokaneStBridge,05/09/2017 11:00:00 AM,48,-122,24,14,38
29388,SpokaneStBridge,05/09/2017 12:00:00 PM,48,-122,19,19,38
29389,SpokaneStBridge,05/09/2017 01:00:00 PM,48,-122,15,20,35
29390,SpokaneStBridge,05/09/2017 02:00:00 PM,48,-122,12,27,39
29391,SpokaneStBridge,05/09/2017 03:00:00 PM,48,-122,20,40,60
29392,SpokaneStBridge,05/09/2017 04:00:00 PM,48,-122,36,128,164
29393,SpokaneStBridge,05/09/2017 05:00:00 PM,48,-122,43,214,257
29394,SpokaneStBridge,05/09/2017 06:00:00 PM,48,-122,28,125,153
29395,SpokaneStBridge,05/09/2017 07:00:00 PM,48,-122,19,48,67
29396,SpokaneStBridge,05/09/2017 08:00:00 PM,48,-122,15,27,42
29397,SpokaneStBridge,05/09/2017 09:00:00 PM,48,-122,7,13,20
29398,SpokaneStBridge,05/09/2017 10:00:00 PM,48,-122,4,10,14
29399,SpokaneStBridge,05/09/2017 11:00:00 PM,48,-122,3,4,7
29400,SpokaneStBridge,05/10/2017 12:00:00 AM,48,-122,2,3,5
29401,SpokaneStBridge,05/10/2017 01:00:00 AM,48,-122,0,1,1
29402,SpokaneStBridge,05/10/2017 02:00:00 AM,48,-122,0,1,1
29403,SpokaneStBridge,05/10/2017 03:00:00 AM,48,-122,1,1,2
29404,SpokaneStBridge,05/10/2017 04:00:00 AM,48,-122,2,1,3
29405,SpokaneStBridge,05/10/2017 05:00:00 AM,48,-122,38,6,44
29406,SpokaneStBridge,05/10/2017 06:00:00 AM,48,-122,91,13,104
29407,SpokaneStBridge,05/10/2017 07:00:00 AM,48,-122,149,25,174
29408,SpokaneStBridge,05/10/2017 08:00:00 AM,48,-122,207,24,231
29409,SpokaneStBridge,05/10/2017 09:00:00 AM,48,-122,64,12,76
29410,SpokaneStBridge,05/10/2017 10:00:00 AM,48,-122,29,13,42
29411,SpokaneStBridge,05/10/2017 11:00:00 AM,48,-122,30,12,42
29412,SpokaneStBridge,05/10/2017 12:00:00 PM,48,-122,19,16,35
29413,SpokaneStBridge,05/10/2017 01:00:00 PM,48,-122,18,10,28
29414,SpokaneStBridge,05/10/2017 02:00:00 PM,48,-122,20,27,47
29415,SpokaneStBridge,05/10/2017 03:00:00 PM,48,-122,22,58,80
29416,SpokaneStBridge,05/10/2017 04:00:00 PM,48,-122,29,127,156
29417,SpokaneStBridge,05/10/2017 05:00:00 PM,48,-122,29,205,234
29418,SpokaneStBridge,05/10/2017 06:00:00 PM,48,-122,26,141,167
29419,SpokaneStBridge,05/10/2017 07:00:00 PM,48,-122,20,59,79
29420,SpokaneStBridge,05/10/2017 08:00:00 PM,48,-122,13,24,37
29421,SpokaneStBridge,05/10/2017 09:00:00 PM,48,-122,6,18,24
29422,SpokaneStBridge,05/10/2017 10:00:00 PM,48,-122,2,2,4
29423,SpokaneStBridge,05/10/2017 11:00:00 PM,48,-122,1,3,4
29424,SpokaneStBridge,05/11/2017 12:00:00 AM,48,-122,3,2,5
29425,SpokaneStBridge,05/11/2017 01:00:00 AM,48,-122,0,2,2
29426,SpokaneStBridge,05/11/2017 02:00:00 AM,48,-122,0,1,1
29427,SpokaneStBridge,05/11/2017 03:00:00 AM,48,-122,0,2,2
29428,SpokaneStBridge,05/11/2017 04:00:00 AM,48,-122,2,0,2
29429,SpokaneStBridge,05/11/2017 05:00:00 AM,48,-122,16,7,23
29430,SpokaneStBridge,05/11/2017 06:00:00 AM,48,-122,46,11,57
29431,SpokaneStBridge,05/11/2017 07:00:00 AM,48,-122,108,11,119
29432,SpokaneStBridge,05/11/2017 08:00:00 AM,48,-122,122,8,130
29433,SpokaneStBridge,05/11/2017 09:00:00 AM,48,-122,41,6,47
29434,SpokaneStBridge,05/11/2017 10:00:00 AM,48,-122,22,0,22
29435,SpokaneStBridge,05/11/2017 11:00:00 AM,48,-122,4,3,7
29436,SpokaneStBridge,05/11/2017 12:00:00 PM,48,-122,3,0,3
29437,SpokaneStBridge,05/11/2017 01:00:00 PM,48,-122,3,4,7
29438,SpokaneStBridge,05/11/2017 02:00:00 PM,48,-122,4,13,17
29439,SpokaneStBridge,05/11/2017 03:00:00 PM,48,-122,11,28,39
29440,SpokaneStBridge,05/11/2017 04:00:00 PM,48,-122,10,60,70
29441,SpokaneStBridge,05/11/2017 05:00:00 PM,48,-122,14,118,132
29442,SpokaneStBridge,05/11/2017 06:00:00 PM,48,-122,3,61,64
29443,SpokaneStBridge,05/11/2017 07:00:00 PM,48,-122,5,30,35
29444,SpokaneStBridge,05/11/2017 08:00:00 PM,48,-122,2,18,20
29445,SpokaneStBridge,05/11/2017 09:00:00 PM,48,-122,1,4,5
29446,SpokaneStBridge,05/11/2017 10:00:00 PM,48,-122,2,2,4
29447,SpokaneStBridge,05/11/2017 11:00:00 PM,48,-122,0,2,2
29448,SpokaneStBridge,05/12/2017 12:00:00 AM,48,-122,0,1,1
29449,SpokaneStBridge,05/12/2017 01:00:00 AM,48,-122,1,1,2
29450,SpokaneStBridge,05/12/2017 02:00:00 AM,48,-122,0,3,3
29451,SpokaneStBridge,05/12/2017 03:00:00 AM,48,-122,0,0,0
29452,SpokaneStBridge,05/12/2017 04:00:00 AM,48,-122,4,2,6
29453,SpokaneStBridge,05/12/2017 05:00:00 AM,48,-122,16,2,18
29454,SpokaneStBridge,05/12/2017 06:00:00 AM,48,-122,49,13,62
29455,SpokaneStBridge,05/12/2017 07:00:00 AM,48,-122,129,14,143
29456,SpokaneStBridge,05/12/2017 08:00:00 AM,48,-122,103,16,119
29457,SpokaneStBridge,05/12/2017 09:00:00 AM,48,-122,40,16,56
29458,SpokaneStBridge,05/12/2017 10:00:00 AM,48,-122,25,11,36
29459,SpokaneStBridge,05/12/2017 11:00:00 AM,48,-122,12,3,15
29460,SpokaneStBridge,05/12/2017 12:00:00 PM,48,-122,3,8,11
29461,SpokaneStBridge,05/12/2017 01:00:00 PM,48,-122,5,11,16
29462,SpokaneStBridge,05/12/2017 02:00:00 PM,48,-122,10,20,30
29463,SpokaneStBridge,05/12/2017 03:00:00 PM,48,-122,9,35,44
29464,SpokaneStBridge,05/12/2017 04:00:00 PM,48,-122,14,94,108
29465,SpokaneStBridge,05/12/2017 05:00:00 PM,48,-122,13,109,122
29466,SpokaneStBridge,05/12/2017 06:00:00 PM,48,-122,8,54,62
29467,SpokaneStBridge,05/12/2017 07:00:00 PM,48,-122,4,20,24
29468,SpokaneStBridge,05/12/2017 08:00:00 PM,48,-122,2,11,13
29469,SpokaneStBridge,05/12/2017 09:00:00 PM,48,-122,0,6,6
29470,SpokaneStBridge,05/12/2017 10:00:00 PM,48,-122,1,1,2
29471,SpokaneStBridge,05/12/2017 11:00:00 PM,48,-122,2,1,3
29472,SpokaneStBridge,05/13/2017 12:00:00 AM,48,-122,0,1,1
29473,SpokaneStBridge,05/13/2017 01:00:00 AM,48,-122,0,0,0
29474,SpokaneStBridge,05/13/2017 02:00:00 AM,48,-122,0,1,1
29475,SpokaneStBridge,05/13/2017 03:00:00 AM,48,-122,0,1,1
29476,SpokaneStBridge,05/13/2017 04:00:00 AM,48,-122,0,1,1
29477,SpokaneStBridge,05/13/2017 05:00:00 AM,48,-122,2,1,3
29478,SpokaneStBridge,05/13/2017 06:00:00 AM,48,-122,12,1,13
29479,SpokaneStBridge,05/13/2017 07:00:00 AM,48,-122,9,10,19
29480,SpokaneStBridge,05/13/2017 08:00:00 AM,48,-122,7,27,34
29481,SpokaneStBridge,05/13/2017 09:00:00 AM,48,-122,12,9,21
29482,SpokaneStBridge,05/13/2017 10:00:00 AM,48,-122,16,15,31
29483,SpokaneStBridge,05/13/2017 11:00:00 AM,48,-122,28,22,50
29484,SpokaneStBridge,05/13/2017 12:00:00 PM,48,-122,19,18,37
29485,SpokaneStBridge,05/13/2017 01:00:00 PM,48,-122,15,15,30
29486,SpokaneStBridge,05/13/2017 02:00:00 PM,48,-122,14,12,26
29487,SpokaneStBridge,05/13/2017 03:00:00 PM,48,-122,15,23,38
29488,SpokaneStBridge,05/13/2017 04:00:00 PM,48,-122,21,14,35
29489,SpokaneStBridge,05/13/2017 05:00:00 PM,48,-122,12,14,26
29490,SpokaneStBridge,05/13/2017 06:00:00 PM,48,-122,6,8,14
29491,SpokaneStBridge,05/13/2017 07:00:00 PM,48,-122,2,6,8
29492,SpokaneStBridge,05/13/2017 08:00:00 PM,48,-122,2,6,8
29493,SpokaneStBridge,05/13/2017 09:00:00 PM,48,-122,1,2,3
29494,SpokaneStBridge,05/13/2017 10:00:00 PM,48,-122,0,1,1
29495,SpokaneStBridge,05/13/2017 11:00:00 PM,48,-122,2,0,2
29496,SpokaneStBridge,05/14/2017 12:00:00 AM,48,-122,0,0,0
29497,SpokaneStBridge,05/14/2017 01:00:00 AM,48,-122,1,0,1
29498,SpokaneStBridge,05/14/2017 02:00:00 AM,48,-122,0,0,0
29499,SpokaneStBridge,05/14/2017 03:00:00 AM,48,-122,0,0,0
29500,SpokaneStBridge,05/14/2017 04:00:00 AM,48,-122,0,0,0
29501,SpokaneStBridge,05/14/2017 05:00:00 AM,48,-122,3,1,4
29502,SpokaneStBridge,05/14/2017 06:00:00 AM,48,-122,1,1,2
29503,SpokaneStBridge,05/14/2017 07:00:00 AM,48,-122,4,0,4
29504,SpokaneStBridge,05/14/2017 08:00:00 AM,48,-122,5,4,9
29505,SpokaneStBridge,05/14/2017 09:00:00 AM,48,-122,12,5,17
29506,SpokaneStBridge,05/14/2017 10:00:00 AM,48,-122,14,22,36
29507,SpokaneStBridge,05/14/2017 11:00:00 AM,48,-122,16,9,25
29508,SpokaneStBridge,05/14/2017 12:00:00 PM,48,-122,15,5,20
29509,SpokaneStBridge,05/14/2017 01:00:00 PM,48,-122,12,13,25
29510,SpokaneStBridge,05/14/2017 02:00:00 PM,48,-122,13,8,21
29511,SpokaneStBridge,05/14/2017 03:00:00 PM,48,-122,10,6,16
29512,SpokaneStBridge,05/14/2017 04:00:00 PM,48,-122,8,21,29
29513,SpokaneStBridge,05/14/2017 05:00:00 PM,48,-122,8,15,23
29514,SpokaneStBridge,05/14/2017 06:00:00 PM,48,-122,18,4,22
29515,SpokaneStBridge,05/14/2017 07:00:00 PM,48,-122,4,3,7
29516,SpokaneStBridge,05/14/2017 08:00:00 PM,48,-122,5,5,10
29517,SpokaneStBridge,05/14/2017 09:00:00 PM,48,-122,1,5,6
29518,SpokaneStBridge,05/14/2017 10:00:00 PM,48,-122,2,3,5
29519,SpokaneStBridge,05/14/2017 11:00:00 PM,48,-122,0,1,1
29520,SpokaneStBridge,05/15/2017 12:00:00 AM,48,-122,1,4,5
29521,SpokaneStBridge,05/15/2017 01:00:00 AM,48,-122,2,1,3
29522,SpokaneStBridge,05/15/2017 02:00:00 AM,48,-122,1,2,3
29523,SpokaneStBridge,05/15/2017 03:00:00 AM,48,-122,1,1,2
29524,SpokaneStBridge,05/15/2017 04:00:00 AM,48,-122,2,0,2
29525,SpokaneStBridge,05/15/2017 05:00:00 AM,48,-122,20,4,24
29526,SpokaneStBridge,05/15/2017 06:00:00 AM,48,-122,64,11,75
29527,SpokaneStBridge,05/15/2017 07:00:00 AM,48,-122,146,15,161
29528,SpokaneStBridge,05/15/2017 08:00:00 AM,48,-122,132,10,142
29529,SpokaneStBridge,05/15/2017 09:00:00 AM,48,-122,30,6,36
29530,SpokaneStBridge,05/15/2017 10:00:00 AM,48,-122,16,3,19
29531,SpokaneStBridge,05/15/2017 11:00:00 AM,48,-122,7,4,11
29532,SpokaneStBridge,05/15/2017 12:00:00 PM,48,-122,12,12,24
29533,SpokaneStBridge,05/15/2017 01:00:00 PM,48,-122,8,7,15
29534,SpokaneStBridge,05/15/2017 02:00:00 PM,48,-122,3,7,10
29535,SpokaneStBridge,05/15/2017 03:00:00 PM,48,-122,4,30,34
29536,SpokaneStBridge,05/15/2017 04:00:00 PM,48,-122,12,66,78
29537,SpokaneStBridge,05/15/2017 05:00:00 PM,48,-122,7,140,147
29538,SpokaneStBridge,05/15/2017 06:00:00 PM,48,-122,9,68,77
29539,SpokaneStBridge,05/15/2017 07:00:00 PM,48,-122,4,22,26
29540,SpokaneStBridge,05/15/2017 08:00:00 PM,48,-122,4,10,14
29541,SpokaneStBridge,05/15/2017 09:00:00 PM,48,-122,0,9,9
29542,SpokaneStBridge,05/15/2017 10:00:00 PM,48,-122,0,0,0
29543,SpokaneStBridge,05/15/2017 11:00:00 PM,48,-122,2,2,4
29544,SpokaneStBridge,05/16/2017 12:00:00 AM,48,-122,0,3,3
29545,SpokaneStBridge,05/16/2017 01:00:00 AM,48,-122,0,0,0
29546,SpokaneStBridge,05/16/2017 02:00:00 AM,48,-122,3,2,5
29547,SpokaneStBridge,05/16/2017 03:00:00 AM,48,-122,0,1,1
29548,SpokaneStBridge,05/16/2017 04:00:00 AM,48,-122,1,1,2
29549,SpokaneStBridge,05/16/2017 05:00:00 AM,48,-122,16,4,20
29550,SpokaneStBridge,05/16/2017 06:00:00 AM,48,-122,30,5,35
29551,SpokaneStBridge,05/16/2017 07:00:00 AM,48,-122,88,11,99
29552,SpokaneStBridge,05/16/2017 08:00:00 AM,48,-122,89,7,96
29553,SpokaneStBridge,05/16/2017 09:00:00 AM,48,-122,37,5,42
29554,SpokaneStBridge,05/16/2017 10:00:00 AM,48,-122,13,1,14
29555,SpokaneStBridge,05/16/2017 11:00:00 AM,48,-122,6,2,8
29556,SpokaneStBridge,05/16/2017 12:00:00 PM,48,-122,6,3,9
29557,SpokaneStBridge,05/16/2017 01:00:00 PM,48,-122,6,7,13
29558,SpokaneStBridge,05/16/2017 02:00:00 PM,48,-122,9,5,14
29559,SpokaneStBridge,05/16/2017 03:00:00 PM,48,-122,9,18,27
29560,SpokaneStBridge,05/16/2017 04:00:00 PM,48,-122,9,61,70
29561,SpokaneStBridge,05/16/2017 05:00:00 PM,48,-122,23,108,131
29562,SpokaneStBridge,05/16/2017 06:00:00 PM,48,-122,7,70,77
29563,SpokaneStBridge,05/16/2017 07:00:00 PM,48,-122,2,38,40
29564,SpokaneStBridge,05/16/2017 08:00:00 PM,48,-122,2,10,12
29565,SpokaneStBridge,05/16/2017 09:00:00 PM,48,-122,1,6,7
29566,SpokaneStBridge,05/16/2017 10:00:00 PM,48,-122,2,3,5
29567,SpokaneStBridge,05/16/2017 11:00:00 PM,48,-122,2,6,8
29568,SpokaneStBridge,05/17/2017 12:00:00 AM,48,-122,1,0,1
29569,SpokaneStBridge,05/17/2017 01:00:00 AM,48,-122,0,0,0
29570,SpokaneStBridge,05/17/2017 02:00:00 AM,48,-122,0,1,1
29571,SpokaneStBridge,05/17/2017 03:00:00 AM,48,-122,0,1,1
29572,SpokaneStBridge,05/17/2017 04:00:00 AM,48,-122,3,1,4
29573,SpokaneStBridge,05/17/2017 05:00:00 AM,48,-122,24,4,28
29574,SpokaneStBridge,05/17/2017 06:00:00 AM,48,-122,87,7,94
29575,SpokaneStBridge,05/17/2017 07:00:00 AM,48,-122,148,17,165
29576,SpokaneStBridge,05/17/2017 08:00:00 AM,48,-122,146,11,157
29577,SpokaneStBridge,05/17/2017 09:00:00 AM,48,-122,59,5,64
29578,SpokaneStBridge,05/17/2017 10:00:00 AM,48,-122,13,8,21
29579,SpokaneStBridge,05/17/2017 11:00:00 AM,48,-122,11,8,19
29580,SpokaneStBridge,05/17/2017 12:00:00 PM,48,-122,8,15,23
29581,SpokaneStBridge,05/17/2017 01:00:00 PM,48,-122,13,8,21
29582,SpokaneStBridge,05/17/2017 02:00:00 PM,48,-122,15,18,33
29583,SpokaneStBridge,05/17/2017 03:00:00 PM,48,-122,14,41,55
29584,SpokaneStBridge,05/17/2017 04:00:00 PM,48,-122,25,101,126
29585,SpokaneStBridge,05/17/2017 05:00:00 PM,48,-122,19,188,207
29586,SpokaneStBridge,05/17/2017 06:00:00 PM,48,-122,16,104,120
29587,SpokaneStBridge,05/17/2017 07:00:00 PM,48,-122,11,44,55
29588,SpokaneStBridge,05/17/2017 08:00:00 PM,48,-122,13,21,34
29589,SpokaneStBridge,05/17/2017 09:00:00 PM,48,-122,5,17,22
29590,SpokaneStBridge,05/17/2017 10:00:00 PM,48,-122,0,6,6
29591,SpokaneStBridge,05/17/2017 11:00:00 PM,48,-122,1,6,7
29592,SpokaneStBridge,05/18/2017 12:00:00 AM,48,-122,1,2,3
29593,SpokaneStBridge,05/18/2017 01:00:00 AM,48,-122,0,0,0
29594,SpokaneStBridge,05/18/2017 02:00:00 AM,48,-122,1,1,2
29595,SpokaneStBridge,05/18/2017 03:00:00 AM,48,-122,0,0,0
29596,SpokaneStBridge,05/18/2017 04:00:00 AM,48,-122,2,1,3
29597,SpokaneStBridge,05/18/2017 05:00:00 AM,48,-122,26,3,29
29598,SpokaneStBridge,05/18/2017 06:00:00 AM,48,-122,76,16,92
29599,SpokaneStBridge,05/18/2017 07:00:00 AM,48,-122,172,14,186
29600,SpokaneStBridge,05/18/2017 08:00:00 AM,48,-122,150,18,168
29601,SpokaneStBridge,05/18/2017 09:00:00 AM,48,-122,48,12,60
29602,SpokaneStBridge,05/18/2017 10:00:00 AM,48,-122,30,4,34
29603,SpokaneStBridge,05/18/2017 11:00:00 AM,48,-122,9,10,19
29604,SpokaneStBridge,05/18/2017 12:00:00 PM,48,-122,10,11,21
29605,SpokaneStBridge,05/18/2017 01:00:00 PM,48,-122,30,9,39
29606,SpokaneStBridge,05/18/2017 02:00:00 PM,48,-122,13,21,34
29607,SpokaneStBridge,05/18/2017 03:00:00 PM,48,-122,17,43,60
29608,SpokaneStBridge,05/18/2017 04:00:00 PM,48,-122,23,112,135
29609,SpokaneStBridge,05/18/2017 05:00:00 PM,48,-122,41,173,214
29610,SpokaneStBridge,05/18/2017 06:00:00 PM,48,-122,25,98,123
29611,SpokaneStBridge,05/18/2017 07:00:00 PM,48,-122,12,51,63
29612,SpokaneStBridge,05/18/2017 08:00:00 PM,48,-122,10,19,29
29613,SpokaneStBridge,05/18/2017 09:00:00 PM,48,-122,7,15,22
29614,SpokaneStBridge,05/18/2017 10:00:00 PM,48,-122,0,7,7
29615,SpokaneStBridge,05/18/2017 11:00:00 PM,48,-122,0,6,6
29616,SpokaneStBridge,05/19/2017 12:00:00 AM,48,-122,1,2,3
29617,SpokaneStBridge,05/19/2017 01:00:00 AM,48,-122,0,0,0
29618,SpokaneStBridge,05/19/2017 02:00:00 AM,48,-122,0,1,1
29619,SpokaneStBridge,05/19/2017 03:00:00 AM,48,-122,0,0,0
29620,SpokaneStBridge,05/19/2017 04:00:00 AM,48,-122,4,1,5
29621,SpokaneStBridge,05/19/2017 05:00:00 AM,48,-122,25,7,32
29622,SpokaneStBridge,05/19/2017 06:00:00 AM,48,-122,89,17,106
29623,SpokaneStBridge,05/19/2017 07:00:00 AM,48,-122,207,31,238
29624,SpokaneStBridge,05/19/2017 08:00:00 AM,48,-122,176,33,209
29625,SpokaneStBridge,05/19/2017 09:00:00 AM,48,-122,64,18,82
29626,SpokaneStBridge,05/19/2017 10:00:00 AM,48,-122,32,15,47
29627,SpokaneStBridge,05/19/2017 11:00:00 AM,48,-122,18,16,34
29628,SpokaneStBridge,05/19/2017 12:00:00 PM,48,-122,16,23,39
29629,SpokaneStBridge,05/19/2017 01:00:00 PM,48,-122,18,17,35
29630,SpokaneStBridge,05/19/2017 02:00:00 PM,48,-122,22,46,68
29631,SpokaneStBridge,05/19/2017 03:00:00 PM,48,-122,32,91,123
29632,SpokaneStBridge,05/19/2017 04:00:00 PM,48,-122,37,140,177
29633,SpokaneStBridge,05/19/2017 05:00:00 PM,48,-122,37,180,217
29634,SpokaneStBridge,05/19/2017 06:00:00 PM,48,-122,23,97,120
29635,SpokaneStBridge,05/19/2017 07:00:00 PM,48,-122,8,50,58
29636,SpokaneStBridge,05/19/2017 08:00:00 PM,48,-122,14,11,25
29637,SpokaneStBridge,05/19/2017 09:00:00 PM,48,-122,6,8,14
29638,SpokaneStBridge,05/19/2017 10:00:00 PM,48,-122,5,7,12
29639,SpokaneStBridge,05/19/2017 11:00:00 PM,48,-122,1,6,7
29640,SpokaneStBridge,05/20/2017 12:00:00 AM,48,-122,2,0,2
29641,SpokaneStBridge,05/20/2017 01:00:00 AM,48,-122,0,0,0
29642,SpokaneStBridge,05/20/2017 02:00:00 AM,48,-122,1,1,2
29643,SpokaneStBridge,05/20/2017 03:00:00 AM,48,-122,1,0,1
29644,SpokaneStBridge,05/20/2017 04:00:00 AM,48,-122,0,1,1
29645,SpokaneStBridge,05/20/2017 05:00:00 AM,48,-122,11,1,12
29646,SpokaneStBridge,05/20/2017 06:00:00 AM,48,-122,11,8,19
29647,SpokaneStBridge,05/20/2017 07:00:00 AM,48,-122,21,8,29
29648,SpokaneStBridge,05/20/2017 08:00:00 AM,48,-122,28,22,50
29649,SpokaneStBridge,05/20/2017 09:00:00 AM,48,-122,27,40,67
29650,SpokaneStBridge,05/20/2017 10:00:00 AM,48,-122,45,36,81
29651,SpokaneStBridge,05/20/2017 11:00:00 AM,48,-122,28,35,63
29652,SpokaneStBridge,05/20/2017 12:00:00 PM,48,-122,49,53,102
29653,SpokaneStBridge,05/20/2017 01:00:00 PM,48,-122,90,42,132
29654,SpokaneStBridge,05/20/2017 02:00:00 PM,48,-122,32,34,66
29655,SpokaneStBridge,05/20/2017 03:00:00 PM,48,-122,50,42,92
29656,SpokaneStBridge,05/20/2017 04:00:00 PM,48,-122,24,67,91
29657,SpokaneStBridge,05/20/2017 05:00:00 PM,48,-122,25,32,57
29658,SpokaneStBridge,05/20/2017 06:00:00 PM,48,-122,23,27,50
29659,SpokaneStBridge,05/20/2017 07:00:00 PM,48,-122,14,13,27
29660,SpokaneStBridge,05/20/2017 08:00:00 PM,48,-122,10,18,28
29661,SpokaneStBridge,05/20/2017 09:00:00 PM,48,-122,9,8,17
29662,SpokaneStBridge,05/20/2017 10:00:00 PM,48,-122,5,6,11
29663,SpokaneStBridge,05/20/2017 11:00:00 PM,48,-122,2,2,4
29664,SpokaneStBridge,05/21/2017 12:00:00 AM,48,-122,0,1,1
29665,SpokaneStBridge,05/21/2017 01:00:00 AM,48,-122,2,1,3
29666,SpokaneStBridge,05/21/2017 02:00:00 AM,48,-122,1,0,1
29667,SpokaneStBridge,05/21/2017 03:00:00 AM,48,-122,1,1,2
29668,SpokaneStBridge,05/21/2017 04:00:00 AM,48,-122,1,1,2
29669,SpokaneStBridge,05/21/2017 05:00:00 AM,48,-122,5,6,11
29670,SpokaneStBridge,05/21/2017 06:00:00 AM,48,-122,6,1,7
29671,SpokaneStBridge,05/21/2017 07:00:00 AM,48,-122,19,4,23
29672,SpokaneStBridge,05/21/2017 08:00:00 AM,48,-122,24,21,45
29673,SpokaneStBridge,05/21/2017 09:00:00 AM,48,-122,28,16,44
29674,SpokaneStBridge,05/21/2017 10:00:00 AM,48,-122,32,43,75
29675,SpokaneStBridge,05/21/2017 11:00:00 AM,48,-122,47,48,95
29676,SpokaneStBridge,05/21/2017 12:00:00 PM,48,-122,39,57,96
29677,SpokaneStBridge,05/21/2017 01:00:00 PM,48,-122,52,55,107
29678,SpokaneStBridge,05/21/2017 02:00:00 PM,48,-122,38,52,90
29679,SpokaneStBridge,05/21/2017 03:00:00 PM,48,-122,33,35,68
29680,SpokaneStBridge,05/21/2017 04:00:00 PM,48,-122,38,29,67
29681,SpokaneStBridge,05/21/2017 05:00:00 PM,48,-122,29,41,70
29682,SpokaneStBridge,05/21/2017 06:00:00 PM,48,-122,12,22,34
29683,SpokaneStBridge,05/21/2017 07:00:00 PM,48,-122,13,20,33
29684,SpokaneStBridge,05/21/2017 08:00:00 PM,48,-122,8,5,13
29685,SpokaneStBridge,05/21/2017 09:00:00 PM,48,-122,10,4,14
29686,SpokaneStBridge,05/21/2017 10:00:00 PM,48,-122,7,6,13
29687,SpokaneStBridge,05/21/2017 11:00:00 PM,48,-122,0,3,3
29688,SpokaneStBridge,05/22/2017 12:00:00 AM,48,-122,0,1,1
29689,SpokaneStBridge,05/22/2017 01:00:00 AM,48,-122,0,0,0
29690,SpokaneStBridge,05/22/2017 02:00:00 AM,48,-122,0,0,0
29691,SpokaneStBridge,05/22/2017 03:00:00 AM,48,-122,0,0,0
29692,SpokaneStBridge,05/22/2017 04:00:00 AM,48,-122,3,4,7
29693,SpokaneStBridge,05/22/2017 05:00:00 AM,48,-122,25,4,29
29694,SpokaneStBridge,05/22/2017 06:00:00 AM,48,-122,84,17,101
29695,SpokaneStBridge,05/22/2017 07:00:00 AM,48,-122,189,15,204
29696,SpokaneStBridge,05/22/2017 08:00:00 AM,48,-122,172,15,187
29697,SpokaneStBridge,05/22/2017 09:00:00 AM,48,-122,49,13,62
29698,SpokaneStBridge,05/22/2017 10:00:00 AM,48,-122,25,7,32
29699,SpokaneStBridge,05/22/2017 11:00:00 AM,48,-122,19,18,37
29700,SpokaneStBridge,05/22/2017 12:00:00 PM,48,-122,17,13,30
29701,SpokaneStBridge,05/22/2017 01:00:00 PM,48,-122,21,16,37
29702,SpokaneStBridge,05/22/2017 02:00:00 PM,48,-122,20,23,43
29703,SpokaneStBridge,05/22/2017 03:00:00 PM,48,-122,20,47,67
29704,SpokaneStBridge,05/22/2017 04:00:00 PM,48,-122,28,145,173
29705,SpokaneStBridge,05/22/2017 05:00:00 PM,48,-122,45,227,272
29706,SpokaneStBridge,05/22/2017 06:00:00 PM,48,-122,23,108,131
29707,SpokaneStBridge,05/22/2017 07:00:00 PM,48,-122,13,60,73
29708,SpokaneStBridge,05/22/2017 08:00:00 PM,48,-122,15,15,30
29709,SpokaneStBridge,05/22/2017 09:00:00 PM,48,-122,15,9,24
29710,SpokaneStBridge,05/22/2017 10:00:00 PM,48,-122,1,4,5
29711,SpokaneStBridge,05/22/2017 11:00:00 PM,48,-122,1,2,3
29712,SpokaneStBridge,05/23/2017 12:00:00 AM,48,-122,2,3,5
29713,SpokaneStBridge,05/23/2017 01:00:00 AM,48,-122,2,0,2
29714,SpokaneStBridge,05/23/2017 02:00:00 AM,48,-122,0,1,1
29715,SpokaneStBridge,05/23/2017 03:00:00 AM,48,-122,1,3,4
29716,SpokaneStBridge,05/23/2017 04:00:00 AM,48,-122,4,2,6
29717,SpokaneStBridge,05/23/2017 05:00:00 AM,48,-122,38,5,43
29718,SpokaneStBridge,05/23/2017 06:00:00 AM,48,-122,93,18,111
29719,SpokaneStBridge,05/23/2017 07:00:00 AM,48,-122,201,22,223
29720,SpokaneStBridge,05/23/2017 08:00:00 AM,48,-122,187,28,215
29721,SpokaneStBridge,05/23/2017 09:00:00 AM,48,-122,59,10,69
29722,SpokaneStBridge,05/23/2017 10:00:00 AM,48,-122,22,18,40
29723,SpokaneStBridge,05/23/2017 11:00:00 AM,48,-122,10,12,22
29724,SpokaneStBridge,05/23/2017 12:00:00 PM,48,-122,19,5,24
29725,SpokaneStBridge,05/23/2017 01:00:00 PM,48,-122,15,21,36
29726,SpokaneStBridge,05/23/2017 02:00:00 PM,48,-122,12,22,34
29727,SpokaneStBridge,05/23/2017 03:00:00 PM,48,-122,29,64,93
29728,SpokaneStBridge,05/23/2017 04:00:00 PM,48,-122,37,117,154
29729,SpokaneStBridge,05/23/2017 05:00:00 PM,48,-122,44,258,302
29730,SpokaneStBridge,05/23/2017 06:00:00 PM,48,-122,27,130,157
29731,SpokaneStBridge,05/23/2017 07:00:00 PM,48,-122,13,40,53
29732,SpokaneStBridge,05/23/2017 08:00:00 PM,48,-122,11,21,32
29733,SpokaneStBridge,05/23/2017 09:00:00 PM,48,-122,4,22,26
29734,SpokaneStBridge,05/23/2017 10:00:00 PM,48,-122,0,7,7
29735,SpokaneStBridge,05/23/2017 11:00:00 PM,48,-122,3,3,6
29736,SpokaneStBridge,05/24/2017 12:00:00 AM,48,-122,2,0,2
29737,SpokaneStBridge,05/24/2017 01:00:00 AM,48,-122,3,0,3
29738,SpokaneStBridge,05/24/2017 02:00:00 AM,48,-122,1,1,2
29739,SpokaneStBridge,05/24/2017 03:00:00 AM,48,-122,1,0,1
29740,SpokaneStBridge,05/24/2017 04:00:00 AM,48,-122,7,2,9
29741,SpokaneStBridge,05/24/2017 05:00:00 AM,48,-122,32,8,40
29742,SpokaneStBridge,05/24/2017 06:00:00 AM,48,-122,77,16,93
29743,SpokaneStBridge,05/24/2017 07:00:00 AM,48,-122,181,22,203
29744,SpokaneStBridge,05/24/2017 08:00:00 AM,48,-122,131,20,151
29745,SpokaneStBridge,05/24/2017 09:00:00 AM,48,-122,48,12,60
29746,SpokaneStBridge,05/24/2017 10:00:00 AM,48,-122,29,11,40
29747,SpokaneStBridge,05/24/2017 11:00:00 AM,48,-122,9,8,17
29748,SpokaneStBridge,05/24/2017 12:00:00 PM,48,-122,19,13,32
29749,SpokaneStBridge,05/24/2017 01:00:00 PM,48,-122,11,13,24
29750,SpokaneStBridge,05/24/2017 02:00:00 PM,48,-122,12,18,30
29751,SpokaneStBridge,05/24/2017 03:00:00 PM,48,-122,19,36,55
29752,SpokaneStBridge,05/24/2017 04:00:00 PM,48,-122,19,96,115
29753,SpokaneStBridge,05/24/2017 05:00:00 PM,48,-122,21,199,220
29754,SpokaneStBridge,05/24/2017 06:00:00 PM,48,-122,16,104,120
29755,SpokaneStBridge,05/24/2017 07:00:00 PM,48,-122,12,39,51
29756,SpokaneStBridge,05/24/2017 08:00:00 PM,48,-122,8,19,27
29757,SpokaneStBridge,05/24/2017 09:00:00 PM,48,-122,6,14,20
29758,SpokaneStBridge,05/24/2017 10:00:00 PM,48,-122,6,5,11
29759,SpokaneStBridge,05/24/2017 11:00:00 PM,48,-122,1,1,2
29760,SpokaneStBridge,05/25/2017 12:00:00 AM,48,-122,2,0,2
29761,SpokaneStBridge,05/25/2017 01:00:00 AM,48,-122,2,1,3
29762,SpokaneStBridge,05/25/2017 02:00:00 AM,48,-122,0,0,0
29763,SpokaneStBridge,05/25/2017 03:00:00 AM,48,-122,0,1,1
29764,SpokaneStBridge,05/25/2017 04:00:00 AM,48,-122,4,3,7
29765,SpokaneStBridge,05/25/2017 05:00:00 AM,48,-122,26,4,30
29766,SpokaneStBridge,05/25/2017 06:00:00 AM,48,-122,76,17,93
29767,SpokaneStBridge,05/25/2017 07:00:00 AM,48,-122,158,25,183
29768,SpokaneStBridge,05/25/2017 08:00:00 AM,48,-122,175,16,191
29769,SpokaneStBridge,05/25/2017 09:00:00 AM,48,-122,59,8,67
29770,SpokaneStBridge,05/25/2017 10:00:00 AM,48,-122,20,9,29
29771,SpokaneStBridge,05/25/2017 11:00:00 AM,48,-122,11,13,24
29772,SpokaneStBridge,05/25/2017 12:00:00 PM,48,-122,11,11,22
29773,SpokaneStBridge,05/25/2017 01:00:00 PM,48,-122,13,17,30
29774,SpokaneStBridge,05/25/2017 02:00:00 PM,48,-122,15,25,40
29775,SpokaneStBridge,05/25/2017 03:00:00 PM,48,-122,17,67,84
29776,SpokaneStBridge,05/25/2017 04:00:00 PM,48,-122,33,101,134
29777,SpokaneStBridge,05/25/2017 05:00:00 PM,48,-122,50,199,249
29778,SpokaneStBridge,05/25/2017 06:00:00 PM,48,-122,15,126,141
29779,SpokaneStBridge,05/25/2017 07:00:00 PM,48,-122,29,64,93
29780,SpokaneStBridge,05/25/2017 08:00:00 PM,48,-122,15,19,34
29781,SpokaneStBridge,05/25/2017 09:00:00 PM,48,-122,6,15,21
29782,SpokaneStBridge,05/25/2017 10:00:00 PM,48,-122,3,5,8
29783,SpokaneStBridge,05/25/2017 11:00:00 PM,48,-122,2,4,6
29784,SpokaneStBridge,05/26/2017 12:00:00 AM,48,-122,0,2,2
29785,SpokaneStBridge,05/26/2017 01:00:00 AM,48,-122,2,4,6
29786,SpokaneStBridge,05/26/2017 02:00:00 AM,48,-122,1,1,2
29787,SpokaneStBridge,05/26/2017 03:00:00 AM,48,-122,0,1,1
29788,SpokaneStBridge,05/26/2017 04:00:00 AM,48,-122,1,1,2
29789,SpokaneStBridge,05/26/2017 05:00:00 AM,48,-122,24,3,27
29790,SpokaneStBridge,05/26/2017 06:00:00 AM,48,-122,61,15,76
29791,SpokaneStBridge,05/26/2017 07:00:00 AM,48,-122,153,15,168
29792,SpokaneStBridge,05/26/2017 08:00:00 AM,48,-122,123,21,144
29793,SpokaneStBridge,05/26/2017 09:00:00 AM,48,-122,52,11,63
29794,SpokaneStBridge,05/26/2017 10:00:00 AM,48,-122,24,14,38
29795,SpokaneStBridge,05/26/2017 11:00:00 AM,48,-122,16,15,31
29796,SpokaneStBridge,05/26/2017 12:00:00 PM,48,-122,26,28,54
29797,SpokaneStBridge,05/26/2017 01:00:00 PM,48,-122,23,34,57
29798,SpokaneStBridge,05/26/2017 02:00:00 PM,48,-122,19,55,74
29799,SpokaneStBridge,05/26/2017 03:00:00 PM,48,-122,27,79,106
29800,SpokaneStBridge,05/26/2017 04:00:00 PM,48,-122,28,111,139
29801,SpokaneStBridge,05/26/2017 05:00:00 PM,48,-122,29,118,147
29802,SpokaneStBridge,05/26/2017 06:00:00 PM,48,-122,13,63,76
29803,SpokaneStBridge,05/26/2017 07:00:00 PM,48,-122,10,29,39
29804,SpokaneStBridge,05/26/2017 08:00:00 PM,48,-122,13,24,37
29805,SpokaneStBridge,05/26/2017 09:00:00 PM,48,-122,9,13,22
29806,SpokaneStBridge,05/26/2017 10:00:00 PM,48,-122,6,8,14
29807,SpokaneStBridge,05/26/2017 11:00:00 PM,48,-122,2,3,5
29808,SpokaneStBridge,05/27/2017 12:00:00 AM,48,-122,2,0,2
29809,SpokaneStBridge,05/27/2017 01:00:00 AM,48,-122,1,0,1
29810,SpokaneStBridge,05/27/2017 02:00:00 AM,48,-122,0,3,3
29811,SpokaneStBridge,05/27/2017 03:00:00 AM,48,-122,0,0,0
29812,SpokaneStBridge,05/27/2017 04:00:00 AM,48,-122,1,0,1
29813,SpokaneStBridge,05/27/2017 05:00:00 AM,48,-122,6,0,6
29814,SpokaneStBridge,05/27/2017 06:00:00 AM,48,-122,5,4,9
29815,SpokaneStBridge,05/27/2017 07:00:00 AM,48,-122,15,8,23
29816,SpokaneStBridge,05/27/2017 08:00:00 AM,48,-122,26,24,50
29817,SpokaneStBridge,05/27/2017 09:00:00 AM,48,-122,39,38,77
29818,SpokaneStBridge,05/27/2017 10:00:00 AM,48,-122,59,26,85
29819,SpokaneStBridge,05/27/2017 11:00:00 AM,48,-122,42,41,83
29820,SpokaneStBridge,05/27/2017 12:00:00 PM,48,-122,28,38,66
29821,SpokaneStBridge,05/27/2017 01:00:00 PM,48,-122,34,29,63
29822,SpokaneStBridge,05/27/2017 02:00:00 PM,48,-122,25,49,74
29823,SpokaneStBridge,05/27/2017 03:00:00 PM,48,-122,34,29,63
29824,SpokaneStBridge,05/27/2017 04:00:00 PM,48,-122,30,40,70
29825,SpokaneStBridge,05/27/2017 05:00:00 PM,48,-122,20,33,53
29826,SpokaneStBridge,05/27/2017 06:00:00 PM,48,-122,10,21,31
29827,SpokaneStBridge,05/27/2017 07:00:00 PM,48,-122,17,23,40
29828,SpokaneStBridge,05/27/2017 08:00:00 PM,48,-122,7,11,18
29829,SpokaneStBridge,05/27/2017 09:00:00 PM,48,-122,9,12,21
29830,SpokaneStBridge,05/27/2017 10:00:00 PM,48,-122,7,4,11
29831,SpokaneStBridge,05/27/2017 11:00:00 PM,48,-122,4,3,7
29832,SpokaneStBridge,05/28/2017 12:00:00 AM,48,-122,4,4,8
29833,SpokaneStBridge,05/28/2017 01:00:00 AM,48,-122,3,2,5
29834,SpokaneStBridge,05/28/2017 02:00:00 AM,48,-122,1,1,2
29835,SpokaneStBridge,05/28/2017 03:00:00 AM,48,-122,2,1,3
29836,SpokaneStBridge,05/28/2017 04:00:00 AM,48,-122,3,1,4
29837,SpokaneStBridge,05/28/2017 05:00:00 AM,48,-122,39,3,42
29838,SpokaneStBridge,05/28/2017 06:00:00 AM,48,-122,97,4,101
29839,SpokaneStBridge,05/28/2017 07:00:00 AM,48,-122,29,5,34
29840,SpokaneStBridge,05/28/2017 08:00:00 AM,48,-122,22,40,62
29841,SpokaneStBridge,05/28/2017 09:00:00 AM,48,-122,21,96,117
29842,SpokaneStBridge,05/28/2017 10:00:00 AM,48,-122,36,88,124
29843,SpokaneStBridge,05/28/2017 11:00:00 AM,48,-122,36,64,100
29844,SpokaneStBridge,05/28/2017 12:00:00 PM,48,-122,49,43,92
29845,SpokaneStBridge,05/28/2017 01:00:00 PM,48,-122,24,34,58
29846,SpokaneStBridge,05/28/2017 02:00:00 PM,48,-122,46,38,84
29847,SpokaneStBridge,05/28/2017 03:00:00 PM,48,-122,43,30,73
29848,SpokaneStBridge,05/28/2017 04:00:00 PM,48,-122,25,27,52
29849,SpokaneStBridge,05/28/2017 05:00:00 PM,48,-122,29,20,49
29850,SpokaneStBridge,05/28/2017 06:00:00 PM,48,-122,24,17,41
29851,SpokaneStBridge,05/28/2017 07:00:00 PM,48,-122,16,20,36
29852,SpokaneStBridge,05/28/2017 08:00:00 PM,48,-122,7,1,8
29853,SpokaneStBridge,05/28/2017 09:00:00 PM,48,-122,3,5,8
29854,SpokaneStBridge,05/28/2017 10:00:00 PM,48,-122,4,4,8
29855,SpokaneStBridge,05/28/2017 11:00:00 PM,48,-122,3,0,3
29856,SpokaneStBridge,05/29/2017 12:00:00 AM,48,-122,5,6,11
29857,SpokaneStBridge,05/29/2017 01:00:00 AM,48,-122,1,0,1
29858,SpokaneStBridge,05/29/2017 02:00:00 AM,48,-122,0,0,0
29859,SpokaneStBridge,05/29/2017 03:00:00 AM,48,-122,1,1,2
29860,SpokaneStBridge,05/29/2017 04:00:00 AM,48,-122,2,1,3
29861,SpokaneStBridge,05/29/2017 05:00:00 AM,48,-122,5,2,7
29862,SpokaneStBridge,05/29/2017 06:00:00 AM,48,-122,5,0,5
29863,SpokaneStBridge,05/29/2017 07:00:00 AM,48,-122,12,5,17
29864,SpokaneStBridge,05/29/2017 08:00:00 AM,48,-122,14,13,27
29865,SpokaneStBridge,05/29/2017 09:00:00 AM,48,-122,24,20,44
29866,SpokaneStBridge,05/29/2017 10:00:00 AM,48,-122,16,33,49
29867,SpokaneStBridge,05/29/2017 11:00:00 AM,48,-122,29,23,52
29868,SpokaneStBridge,05/29/2017 12:00:00 PM,48,-122,31,36,67
29869,SpokaneStBridge,05/29/2017 01:00:00 PM,48,-122,34,56,90
29870,SpokaneStBridge,05/29/2017 02:00:00 PM,48,-122,43,41,84
29871,SpokaneStBridge,05/29/2017 03:00:00 PM,48,-122,35,40,75
29872,SpokaneStBridge,05/29/2017 04:00:00 PM,48,-122,40,35,75
29873,SpokaneStBridge,05/29/2017 05:00:00 PM,48,-122,23,19,42
29874,SpokaneStBridge,05/29/2017 06:00:00 PM,48,-122,25,25,50
29875,SpokaneStBridge,05/29/2017 07:00:00 PM,48,-122,17,18,35
29876,SpokaneStBridge,05/29/2017 08:00:00 PM,48,-122,8,7,15
29877,SpokaneStBridge,05/29/2017 09:00:00 PM,48,-122,7,5,12
29878,SpokaneStBridge,05/29/2017 10:00:00 PM,48,-122,3,4,7
29879,SpokaneStBridge,05/29/2017 11:00:00 PM,48,-122,0,2,2
29880,SpokaneStBridge,05/30/2017 12:00:00 AM,48,-122,1,1,2
29881,SpokaneStBridge,05/30/2017 01:00:00 AM,48,-122,0,1,1
29882,SpokaneStBridge,05/30/2017 02:00:00 AM,48,-122,1,0,1
29883,SpokaneStBridge,05/30/2017 03:00:00 AM,48,-122,0,0,0
29884,SpokaneStBridge,05/30/2017 04:00:00 AM,48,-122,3,3,6
29885,SpokaneStBridge,05/30/2017 05:00:00 AM,48,-122,21,2,23
29886,SpokaneStBridge,05/30/2017 06:00:00 AM,48,-122,63,11,74
29887,SpokaneStBridge,05/30/2017 07:00:00 AM,48,-122,151,7,158
29888,SpokaneStBridge,05/30/2017 08:00:00 AM,48,-122,137,15,152
29889,SpokaneStBridge,05/30/2017 09:00:00 AM,48,-122,47,4,51
29890,SpokaneStBridge,05/30/2017 10:00:00 AM,48,-122,17,3,20
29891,SpokaneStBridge,05/30/2017 11:00:00 AM,48,-122,9,5,14
29892,SpokaneStBridge,05/30/2017 12:00:00 PM,48,-122,9,4,13
29893,SpokaneStBridge,05/30/2017 01:00:00 PM,48,-122,11,9,20
29894,SpokaneStBridge,05/30/2017 02:00:00 PM,48,-122,2,14,16
29895,SpokaneStBridge,05/30/2017 03:00:00 PM,48,-122,3,30,33
29896,SpokaneStBridge,05/30/2017 04:00:00 PM,48,-122,10,73,83
29897,SpokaneStBridge,05/30/2017 05:00:00 PM,48,-122,20,159,179
29898,SpokaneStBridge,05/30/2017 06:00:00 PM,48,-122,8,85,93
29899,SpokaneStBridge,05/30/2017 07:00:00 PM,48,-122,6,37,43
29900,SpokaneStBridge,05/30/2017 08:00:00 PM,48,-122,3,15,18
29901,SpokaneStBridge,05/30/2017 09:00:00 PM,48,-122,3,8,11
29902,SpokaneStBridge,05/30/2017 10:00:00 PM,48,-122,1,4,5
29903,SpokaneStBridge,05/30/2017 11:00:00 PM,48,-122,2,1,3
29904,SpokaneStBridge,05/31/2017 12:00:00 AM,48,-122,2,0,2
29905,SpokaneStBridge,05/31/2017 01:00:00 AM,48,-122,0,1,1
29906,SpokaneStBridge,05/31/2017 02:00:00 AM,48,-122,0,1,1
29907,SpokaneStBridge,05/31/2017 03:00:00 AM,48,-122,0,2,2
29908,SpokaneStBridge,05/31/2017 04:00:00 AM,48,-122,5,2,7
29909,SpokaneStBridge,05/31/2017 05:00:00 AM,48,-122,20,5,25
29910,SpokaneStBridge,05/31/2017 06:00:00 AM,48,-122,76,10,86
29911,SpokaneStBridge,05/31/2017 07:00:00 AM,48,-122,169,23,192
29912,SpokaneStBridge,05/31/2017 08:00:00 AM,48,-122,144,15,159
29913,SpokaneStBridge,05/31/2017 09:00:00 AM,48,-122,54,12,66
29914,SpokaneStBridge,05/31/2017 10:00:00 AM,48,-122,25,5,30
29915,SpokaneStBridge,05/31/2017 11:00:00 AM,48,-122,13,9,22
29916,SpokaneStBridge,05/31/2017 12:00:00 PM,48,-122,13,12,25
29917,SpokaneStBridge,05/31/2017 01:00:00 PM,48,-122,17,11,28
29918,SpokaneStBridge,05/31/2017 02:00:00 PM,48,-122,14,14,28
29919,SpokaneStBridge,05/31/2017 03:00:00 PM,48,-122,13,41,54
29920,SpokaneStBridge,05/31/2017 04:00:00 PM,48,-122,20,117,137
29921,SpokaneStBridge,05/31/2017 05:00:00 PM,48,-122,27,200,227
29922,SpokaneStBridge,05/31/2017 06:00:00 PM,48,-122,21,114,135
29923,SpokaneStBridge,05/31/2017 07:00:00 PM,48,-122,10,39,49
29924,SpokaneStBridge,05/31/2017 08:00:00 PM,48,-122,4,22,26
29925,SpokaneStBridge,05/31/2017 09:00:00 PM,48,-122,1,8,9
29926,SpokaneStBridge,05/31/2017 10:00:00 PM,48,-122,1,9,10
29927,SpokaneStBridge,05/31/2017 11:00:00 PM,48,-122,0,2,2
29928,SpokaneStBridge,06/01/2017 12:00:00 AM,48,-122,1,2,3
29929,SpokaneStBridge,06/01/2017 01:00:00 AM,48,-122,0,1,1
29930,SpokaneStBridge,06/01/2017 02:00:00 AM,48,-122,1,2,3
29931,SpokaneStBridge,06/01/2017 03:00:00 AM,48,-122,1,0,1
29932,SpokaneStBridge,06/01/2017 04:00:00 AM,48,-122,4,0,4
29933,SpokaneStBridge,06/01/2017 05:00:00 AM,48,-122,25,3,28
29934,SpokaneStBridge,06/01/2017 06:00:00 AM,48,-122,68,17,85
29935,SpokaneStBridge,06/01/2017 07:00:00 AM,48,-122,126,14,140
29936,SpokaneStBridge,06/01/2017 08:00:00 AM,48,-122,122,13,135
29937,SpokaneStBridge,06/01/2017 09:00:00 AM,48,-122,47,11,58
29938,SpokaneStBridge,06/01/2017 10:00:00 AM,48,-122,21,10,31
29939,SpokaneStBridge,06/01/2017 11:00:00 AM,48,-122,16,7,23
29940,SpokaneStBridge,06/01/2017 12:00:00 PM,48,-122,18,7,25
29941,SpokaneStBridge,06/01/2017 01:00:00 PM,48,-122,12,9,21
29942,SpokaneStBridge,06/01/2017 02:00:00 PM,48,-122,15,20,35
29943,SpokaneStBridge,06/01/2017 03:00:00 PM,48,-122,14,30,44
29944,SpokaneStBridge,06/01/2017 04:00:00 PM,48,-122,13,85,98
29945,SpokaneStBridge,06/01/2017 05:00:00 PM,48,-122,18,161,179
29946,SpokaneStBridge,06/01/2017 06:00:00 PM,48,-122,11,91,102
29947,SpokaneStBridge,06/01/2017 07:00:00 PM,48,-122,15,87,102
29948,SpokaneStBridge,06/01/2017 08:00:00 PM,48,-122,7,24,31
29949,SpokaneStBridge,06/01/2017 09:00:00 PM,48,-122,4,8,12
29950,SpokaneStBridge,06/01/2017 10:00:00 PM,48,-122,6,10,16
29951,SpokaneStBridge,06/01/2017 11:00:00 PM,48,-122,1,3,4
29952,SpokaneStBridge,06/02/2017 12:00:00 AM,48,-122,2,1,3
29953,SpokaneStBridge,06/02/2017 01:00:00 AM,48,-122,1,3,4
29954,SpokaneStBridge,06/02/2017 02:00:00 AM,48,-122,1,1,2
29955,SpokaneStBridge,06/02/2017 03:00:00 AM,48,-122,0,0,0
29956,SpokaneStBridge,06/02/2017 04:00:00 AM,48,-122,6,1,7
29957,SpokaneStBridge,06/02/2017 05:00:00 AM,48,-122,10,3,13
29958,SpokaneStBridge,06/02/2017 06:00:00 AM,48,-122,59,13,72
29959,SpokaneStBridge,06/02/2017 07:00:00 AM,48,-122,129,15,144
29960,SpokaneStBridge,06/02/2017 08:00:00 AM,48,-122,115,12,127
29961,SpokaneStBridge,06/02/2017 09:00:00 AM,48,-122,49,13,62
29962,SpokaneStBridge,06/02/2017 10:00:00 AM,48,-122,30,9,39
29963,SpokaneStBridge,06/02/2017 11:00:00 AM,48,-122,19,15,34
29964,SpokaneStBridge,06/02/2017 12:00:00 PM,48,-122,11,9,20
29965,SpokaneStBridge,06/02/2017 01:00:00 PM,48,-122,8,15,23
29966,SpokaneStBridge,06/02/2017 02:00:00 PM,48,-122,12,32,44
29967,SpokaneStBridge,06/02/2017 03:00:00 PM,48,-122,31,39,70
29968,SpokaneStBridge,06/02/2017 04:00:00 PM,48,-122,19,116,135
29969,SpokaneStBridge,06/02/2017 05:00:00 PM,48,-122,35,121,156
29970,SpokaneStBridge,06/02/2017 06:00:00 PM,48,-122,27,81,108
29971,SpokaneStBridge,06/02/2017 07:00:00 PM,48,-122,21,23,44
29972,SpokaneStBridge,06/02/2017 08:00:00 PM,48,-122,6,26,32
29973,SpokaneStBridge,06/02/2017 09:00:00 PM,48,-122,2,10,12
29974,SpokaneStBridge,06/02/2017 10:00:00 PM,48,-122,4,7,11
29975,SpokaneStBridge,06/02/2017 11:00:00 PM,48,-122,1,2,3
29976,SpokaneStBridge,06/03/2017 12:00:00 AM,48,-122,3,7,10
29977,SpokaneStBridge,06/03/2017 01:00:00 AM,48,-122,2,0,2
29978,SpokaneStBridge,06/03/2017 02:00:00 AM,48,-122,0,3,3
29979,SpokaneStBridge,06/03/2017 03:00:00 AM,48,-122,0,0,0
29980,SpokaneStBridge,06/03/2017 04:00:00 AM,48,-122,0,0,0
29981,SpokaneStBridge,06/03/2017 05:00:00 AM,48,-122,4,2,6
29982,SpokaneStBridge,06/03/2017 06:00:00 AM,48,-122,10,4,14
29983,SpokaneStBridge,06/03/2017 07:00:00 AM,48,-122,12,7,19
29984,SpokaneStBridge,06/03/2017 08:00:00 AM,48,-122,13,14,27
29985,SpokaneStBridge,06/03/2017 09:00:00 AM,48,-122,23,18,41
29986,SpokaneStBridge,06/03/2017 10:00:00 AM,48,-122,31,29,60
29987,SpokaneStBridge,06/03/2017 11:00:00 AM,48,-122,32,41,73
29988,SpokaneStBridge,06/03/2017 12:00:00 PM,48,-122,28,28,56
29989,SpokaneStBridge,06/03/2017 01:00:00 PM,48,-122,27,33,60
29990,SpokaneStBridge,06/03/2017 02:00:00 PM,48,-122,41,20,61
29991,SpokaneStBridge,06/03/2017 03:00:00 PM,48,-122,24,26,50
29992,SpokaneStBridge,06/03/2017 04:00:00 PM,48,-122,18,25,43
29993,SpokaneStBridge,06/03/2017 05:00:00 PM,48,-122,22,28,50
29994,SpokaneStBridge,06/03/2017 06:00:00 PM,48,-122,13,22,35
29995,SpokaneStBridge,06/03/2017 07:00:00 PM,48,-122,13,10,23
29996,SpokaneStBridge,06/03/2017 08:00:00 PM,48,-122,10,12,22
29997,SpokaneStBridge,06/03/2017 09:00:00 PM,48,-122,3,4,7
29998,SpokaneStBridge,06/03/2017 10:00:00 PM,48,-122,4,10,14
29999,SpokaneStBridge,06/03/2017 11:00:00 PM,48,-122,2,0,2
30000,SpokaneStBridge,06/04/2017 12:00:00 AM,48,-122,1,3,4
30001,SpokaneStBridge,06/04/2017 01:00:00 AM,48,-122,1,0,1
30002,SpokaneStBridge,06/04/2017 02:00:00 AM,48,-122,2,1,3
30003,SpokaneStBridge,06/04/2017 03:00:00 AM,48,-122,0,0,0
30004,SpokaneStBridge,06/04/2017 04:00:00 AM,48,-122,0,1,1
30005,SpokaneStBridge,06/04/2017 05:00:00 AM,48,-122,3,1,4
30006,SpokaneStBridge,06/04/2017 06:00:00 AM,48,-122,7,6,13
30007,SpokaneStBridge,06/04/2017 07:00:00 AM,48,-122,11,5,16
30008,SpokaneStBridge,06/04/2017 08:00:00 AM,48,-122,25,13,38
30009,SpokaneStBridge,06/04/2017 09:00:00 AM,48,-122,18,67,85
30010,SpokaneStBridge,06/04/2017 10:00:00 AM,48,-122,50,45,95
30011,SpokaneStBridge,06/04/2017 11:00:00 AM,48,-122,29,36,65
30012,SpokaneStBridge,06/04/2017 12:00:00 PM,48,-122,36,34,70
30013,SpokaneStBridge,06/04/2017 01:00:00 PM,48,-122,57,35,92
30014,SpokaneStBridge,06/04/2017 02:00:00 PM,48,-122,38,33,71
30015,SpokaneStBridge,06/04/2017 03:00:00 PM,48,-122,49,63,112
30016,SpokaneStBridge,06/04/2017 04:00:00 PM,48,-122,32,43,75
30017,SpokaneStBridge,06/04/2017 05:00:00 PM,48,-122,25,31,56
30018,SpokaneStBridge,06/04/2017 06:00:00 PM,48,-122,10,17,27
30019,SpokaneStBridge,06/04/2017 07:00:00 PM,48,-122,12,17,29
30020,SpokaneStBridge,06/04/2017 08:00:00 PM,48,-122,6,5,11
30021,SpokaneStBridge,06/04/2017 09:00:00 PM,48,-122,9,12,21
30022,SpokaneStBridge,06/04/2017 10:00:00 PM,48,-122,2,2,4
30023,SpokaneStBridge,06/04/2017 11:00:00 PM,48,-122,3,1,4
30024,SpokaneStBridge,06/05/2017 12:00:00 AM,48,-122,2,3,5
30025,SpokaneStBridge,06/05/2017 01:00:00 AM,48,-122,0,1,1
30026,SpokaneStBridge,06/05/2017 02:00:00 AM,48,-122,1,0,1
30027,SpokaneStBridge,06/05/2017 03:00:00 AM,48,-122,1,1,2
30028,SpokaneStBridge,06/05/2017 04:00:00 AM,48,-122,7,2,9
30029,SpokaneStBridge,06/05/2017 05:00:00 AM,48,-122,24,7,31
30030,SpokaneStBridge,06/05/2017 06:00:00 AM,48,-122,70,16,86
30031,SpokaneStBridge,06/05/2017 07:00:00 AM,48,-122,176,20,196
30032,SpokaneStBridge,06/05/2017 08:00:00 AM,48,-122,162,19,181
30033,SpokaneStBridge,06/05/2017 09:00:00 AM,48,-122,68,7,75
30034,SpokaneStBridge,06/05/2017 10:00:00 AM,48,-122,25,10,35
30035,SpokaneStBridge,06/05/2017 11:00:00 AM,48,-122,17,11,28
30036,SpokaneStBridge,06/05/2017 12:00:00 PM,48,-122,17,15,32
30037,SpokaneStBridge,06/05/2017 01:00:00 PM,48,-122,9,10,19
30038,SpokaneStBridge,06/05/2017 02:00:00 PM,48,-122,10,22,32
30039,SpokaneStBridge,06/05/2017 03:00:00 PM,48,-122,15,50,65
30040,SpokaneStBridge,06/05/2017 04:00:00 PM,48,-122,31,127,158
30041,SpokaneStBridge,06/05/2017 05:00:00 PM,48,-122,25,221,246
30042,SpokaneStBridge,06/05/2017 06:00:00 PM,48,-122,31,136,167
30043,SpokaneStBridge,06/05/2017 07:00:00 PM,48,-122,18,41,59
30044,SpokaneStBridge,06/05/2017 08:00:00 PM,48,-122,9,14,23
30045,SpokaneStBridge,06/05/2017 09:00:00 PM,48,-122,11,11,22
30046,SpokaneStBridge,06/05/2017 10:00:00 PM,48,-122,10,1,11
30047,SpokaneStBridge,06/05/2017 11:00:00 PM,48,-122,1,1,2
30048,SpokaneStBridge,06/06/2017 12:00:00 AM,48,-122,1,2,3
30049,SpokaneStBridge,06/06/2017 01:00:00 AM,48,-122,0,0,0
30050,SpokaneStBridge,06/06/2017 02:00:00 AM,48,-122,0,1,1
30051,SpokaneStBridge,06/06/2017 03:00:00 AM,48,-122,2,3,5
30052,SpokaneStBridge,06/06/2017 04:00:00 AM,48,-122,12,3,15
30053,SpokaneStBridge,06/06/2017 05:00:00 AM,48,-122,31,10,41
30054,SpokaneStBridge,06/06/2017 06:00:00 AM,48,-122,79,16,95
30055,SpokaneStBridge,06/06/2017 07:00:00 AM,48,-122,175,21,196
30056,SpokaneStBridge,06/06/2017 08:00:00 AM,48,-122,158,23,181
30057,SpokaneStBridge,06/06/2017 09:00:00 AM,48,-122,58,4,62
30058,SpokaneStBridge,06/06/2017 10:00:00 AM,48,-122,24,8,32
30059,SpokaneStBridge,06/06/2017 11:00:00 AM,48,-122,19,8,27
30060,SpokaneStBridge,06/06/2017 12:00:00 PM,48,-122,4,17,21
30061,SpokaneStBridge,06/06/2017 01:00:00 PM,48,-122,16,23,39
30062,SpokaneStBridge,06/06/2017 02:00:00 PM,48,-122,16,24,40
30063,SpokaneStBridge,06/06/2017 03:00:00 PM,48,-122,33,46,79
30064,SpokaneStBridge,06/06/2017 04:00:00 PM,48,-122,34,113,147
30065,SpokaneStBridge,06/06/2017 05:00:00 PM,48,-122,34,203,237
30066,SpokaneStBridge,06/06/2017 06:00:00 PM,48,-122,24,126,150
30067,SpokaneStBridge,06/06/2017 07:00:00 PM,48,-122,15,61,76
30068,SpokaneStBridge,06/06/2017 08:00:00 PM,48,-122,11,24,35
30069,SpokaneStBridge,06/06/2017 09:00:00 PM,48,-122,6,12,18
30070,SpokaneStBridge,06/06/2017 10:00:00 PM,48,-122,6,7,13
30071,SpokaneStBridge,06/06/2017 11:00:00 PM,48,-122,1,2,3
30072,SpokaneStBridge,06/07/2017 12:00:00 AM,48,-122,2,5,7
30073,SpokaneStBridge,06/07/2017 01:00:00 AM,48,-122,1,2,3
30074,SpokaneStBridge,06/07/2017 02:00:00 AM,48,-122,0,2,2
30075,SpokaneStBridge,06/07/2017 03:00:00 AM,48,-122,0,1,1
30076,SpokaneStBridge,06/07/2017 04:00:00 AM,48,-122,7,3,10
30077,SpokaneStBridge,06/07/2017 05:00:00 AM,48,-122,21,7,28
30078,SpokaneStBridge,06/07/2017 06:00:00 AM,48,-122,79,14,93
30079,SpokaneStBridge,06/07/2017 07:00:00 AM,48,-122,175,24,199
30080,SpokaneStBridge,06/07/2017 08:00:00 AM,48,-122,172,14,186
30081,SpokaneStBridge,06/07/2017 09:00:00 AM,48,-122,59,6,65
30082,SpokaneStBridge,06/07/2017 10:00:00 AM,48,-122,33,14,47
30083,SpokaneStBridge,06/07/2017 11:00:00 AM,48,-122,20,18,38
30084,SpokaneStBridge,06/07/2017 12:00:00 PM,48,-122,31,21,52
30085,SpokaneStBridge,06/07/2017 01:00:00 PM,48,-122,29,22,51
30086,SpokaneStBridge,06/07/2017 02:00:00 PM,48,-122,17,20,37
30087,SpokaneStBridge,06/07/2017 03:00:00 PM,48,-122,11,48,59
30088,SpokaneStBridge,06/07/2017 04:00:00 PM,48,-122,23,118,141
30089,SpokaneStBridge,06/07/2017 05:00:00 PM,48,-122,29,194,223
30090,SpokaneStBridge,06/07/2017 06:00:00 PM,48,-122,31,127,158
30091,SpokaneStBridge,06/07/2017 07:00:00 PM,48,-122,12,53,65
30092,SpokaneStBridge,06/07/2017 08:00:00 PM,48,-122,25,25,50
30093,SpokaneStBridge,06/07/2017 09:00:00 PM,48,-122,6,16,22
30094,SpokaneStBridge,06/07/2017 10:00:00 PM,48,-122,2,8,10
30095,SpokaneStBridge,06/07/2017 11:00:00 PM,48,-122,2,6,8
30096,SpokaneStBridge,06/08/2017 12:00:00 AM,48,-122,1,1,2
30097,SpokaneStBridge,06/08/2017 01:00:00 AM,48,-122,1,0,1
30098,SpokaneStBridge,06/08/2017 02:00:00 AM,48,-122,1,2,3
30099,SpokaneStBridge,06/08/2017 03:00:00 AM,48,-122,3,1,4
30100,SpokaneStBridge,06/08/2017 04:00:00 AM,48,-122,2,4,6
30101,SpokaneStBridge,06/08/2017 05:00:00 AM,48,-122,17,2,19
30102,SpokaneStBridge,06/08/2017 06:00:00 AM,48,-122,33,7,40
30103,SpokaneStBridge,06/08/2017 07:00:00 AM,48,-122,77,8,85
30104,SpokaneStBridge,06/08/2017 08:00:00 AM,48,-122,71,5,76
30105,SpokaneStBridge,06/08/2017 09:00:00 AM,48,-122,35,2,37
30106,SpokaneStBridge,06/08/2017 10:00:00 AM,48,-122,7,2,9
30107,SpokaneStBridge,06/08/2017 11:00:00 AM,48,-122,2,0,2
30108,SpokaneStBridge,06/08/2017 12:00:00 PM,48,-122,3,2,5
30109,SpokaneStBridge,06/08/2017 01:00:00 PM,48,-122,14,3,17
30110,SpokaneStBridge,06/08/2017 02:00:00 PM,48,-122,11,13,24
30111,SpokaneStBridge,06/08/2017 03:00:00 PM,48,-122,10,24,34
30112,SpokaneStBridge,06/08/2017 04:00:00 PM,48,-122,10,63,73
30113,SpokaneStBridge,06/08/2017 05:00:00 PM,48,-122,26,94,120
30114,SpokaneStBridge,06/08/2017 06:00:00 PM,48,-122,8,58,66
30115,SpokaneStBridge,06/08/2017 07:00:00 PM,48,-122,5,16,21
30116,SpokaneStBridge,06/08/2017 08:00:00 PM,48,-122,3,9,12
30117,SpokaneStBridge,06/08/2017 09:00:00 PM,48,-122,4,8,12
30118,SpokaneStBridge,06/08/2017 10:00:00 PM,48,-122,3,5,8
30119,SpokaneStBridge,06/08/2017 11:00:00 PM,48,-122,1,3,4
30120,SpokaneStBridge,06/09/2017 12:00:00 AM,48,-122,2,2,4
30121,SpokaneStBridge,06/09/2017 01:00:00 AM,48,-122,1,0,1
30122,SpokaneStBridge,06/09/2017 02:00:00 AM,48,-122,3,0,3
30123,SpokaneStBridge,06/09/2017 03:00:00 AM,48,-122,1,0,1
30124,SpokaneStBridge,06/09/2017 04:00:00 AM,48,-122,3,2,5
30125,SpokaneStBridge,06/09/2017 05:00:00 AM,48,-122,12,3,15
30126,SpokaneStBridge,06/09/2017 06:00:00 AM,48,-122,44,11,55
30127,SpokaneStBridge,06/09/2017 07:00:00 AM,48,-122,117,17,134
30128,SpokaneStBridge,06/09/2017 08:00:00 AM,48,-122,107,16,123
30129,SpokaneStBridge,06/09/2017 09:00:00 AM,48,-122,40,18,58
30130,SpokaneStBridge,06/09/2017 10:00:00 AM,48,-122,18,5,23
30131,SpokaneStBridge,06/09/2017 11:00:00 AM,48,-122,16,6,22
30132,SpokaneStBridge,06/09/2017 12:00:00 PM,48,-122,9,15,24
30133,SpokaneStBridge,06/09/2017 01:00:00 PM,48,-122,14,14,28
30134,SpokaneStBridge,06/09/2017 02:00:00 PM,48,-122,9,22,31
30135,SpokaneStBridge,06/09/2017 03:00:00 PM,48,-122,13,33,46
30136,SpokaneStBridge,06/09/2017 04:00:00 PM,48,-122,16,84,100
30137,SpokaneStBridge,06/09/2017 05:00:00 PM,48,-122,18,111,129
30138,SpokaneStBridge,06/09/2017 06:00:00 PM,48,-122,9,54,63
30139,SpokaneStBridge,06/09/2017 07:00:00 PM,48,-122,12,22,34
30140,SpokaneStBridge,06/09/2017 08:00:00 PM,48,-122,4,8,12
30141,SpokaneStBridge,06/09/2017 09:00:00 PM,48,-122,1,11,12
30142,SpokaneStBridge,06/09/2017 10:00:00 PM,48,-122,2,5,7
30143,SpokaneStBridge,06/09/2017 11:00:00 PM,48,-122,1,6,7
30144,SpokaneStBridge,06/10/2017 12:00:00 AM,48,-122,3,1,4
30145,SpokaneStBridge,06/10/2017 01:00:00 AM,48,-122,3,1,4
30146,SpokaneStBridge,06/10/2017 02:00:00 AM,48,-122,0,0,0
30147,SpokaneStBridge,06/10/2017 03:00:00 AM,48,-122,1,1,2
30148,SpokaneStBridge,06/10/2017 04:00:00 AM,48,-122,1,1,2
30149,SpokaneStBridge,06/10/2017 05:00:00 AM,48,-122,4,0,4
30150,SpokaneStBridge,06/10/2017 06:00:00 AM,48,-122,8,4,12
30151,SpokaneStBridge,06/10/2017 07:00:00 AM,48,-122,12,9,21
30152,SpokaneStBridge,06/10/2017 08:00:00 AM,48,-122,22,17,39
30153,SpokaneStBridge,06/10/2017 09:00:00 AM,48,-122,21,31,52
30154,SpokaneStBridge,06/10/2017 10:00:00 AM,48,-122,27,31,58
30155,SpokaneStBridge,06/10/2017 11:00:00 AM,48,-122,55,37,92
30156,SpokaneStBridge,06/10/2017 12:00:00 PM,48,-122,46,32,78
30157,SpokaneStBridge,06/10/2017 01:00:00 PM,48,-122,31,33,64
30158,SpokaneStBridge,06/10/2017 02:00:00 PM,48,-122,45,49,94
30159,SpokaneStBridge,06/10/2017 03:00:00 PM,48,-122,39,35,74
30160,SpokaneStBridge,06/10/2017 04:00:00 PM,48,-122,35,37,72
30161,SpokaneStBridge,06/10/2017 05:00:00 PM,48,-122,32,30,62
30162,SpokaneStBridge,06/10/2017 06:00:00 PM,48,-122,17,23,40
30163,SpokaneStBridge,06/10/2017 07:00:00 PM,48,-122,19,24,43
30164,SpokaneStBridge,06/10/2017 08:00:00 PM,48,-122,5,12,17
30165,SpokaneStBridge,06/10/2017 09:00:00 PM,48,-122,1,6,7
30166,SpokaneStBridge,06/10/2017 10:00:00 PM,48,-122,18,10,28
30167,SpokaneStBridge,06/10/2017 11:00:00 PM,48,-122,2,2,4
30168,SpokaneStBridge,06/11/2017 12:00:00 AM,48,-122,0,1,1
30169,SpokaneStBridge,06/11/2017 01:00:00 AM,48,-122,1,1,2
30170,SpokaneStBridge,06/11/2017 02:00:00 AM,48,-122,0,1,1
30171,SpokaneStBridge,06/11/2017 03:00:00 AM,48,-122,1,2,3
30172,SpokaneStBridge,06/11/2017 04:00:00 AM,48,-122,2,0,2
30173,SpokaneStBridge,06/11/2017 05:00:00 AM,48,-122,8,2,10
30174,SpokaneStBridge,06/11/2017 06:00:00 AM,48,-122,7,3,10
30175,SpokaneStBridge,06/11/2017 07:00:00 AM,48,-122,20,5,25
30176,SpokaneStBridge,06/11/2017 08:00:00 AM,48,-122,15,21,36
30177,SpokaneStBridge,06/11/2017 09:00:00 AM,48,-122,22,29,51
30178,SpokaneStBridge,06/11/2017 10:00:00 AM,48,-122,28,36,64
30179,SpokaneStBridge,06/11/2017 11:00:00 AM,48,-122,31,35,66
30180,SpokaneStBridge,06/11/2017 12:00:00 PM,48,-122,40,49,89
30181,SpokaneStBridge,06/11/2017 01:00:00 PM,48,-122,36,48,84
30182,SpokaneStBridge,06/11/2017 02:00:00 PM,48,-122,44,42,86
30183,SpokaneStBridge,06/11/2017 03:00:00 PM,48,-122,51,36,87
30184,SpokaneStBridge,06/11/2017 04:00:00 PM,48,-122,30,42,72
30185,SpokaneStBridge,06/11/2017 05:00:00 PM,48,-122,28,17,45
30186,SpokaneStBridge,06/11/2017 06:00:00 PM,48,-122,17,36,53
30187,SpokaneStBridge,06/11/2017 07:00:00 PM,48,-122,15,12,27
30188,SpokaneStBridge,06/11/2017 08:00:00 PM,48,-122,4,8,12
30189,SpokaneStBridge,06/11/2017 09:00:00 PM,48,-122,3,2,5
30190,SpokaneStBridge,06/11/2017 10:00:00 PM,48,-122,2,4,6
30191,SpokaneStBridge,06/11/2017 11:00:00 PM,48,-122,0,2,2
30192,SpokaneStBridge,06/12/2017 12:00:00 AM,48,-122,0,1,1
30193,SpokaneStBridge,06/12/2017 01:00:00 AM,48,-122,0,1,1
30194,SpokaneStBridge,06/12/2017 02:00:00 AM,48,-122,0,0,0
30195,SpokaneStBridge,06/12/2017 03:00:00 AM,48,-122,0,2,2
30196,SpokaneStBridge,06/12/2017 04:00:00 AM,48,-122,7,3,10
30197,SpokaneStBridge,06/12/2017 05:00:00 AM,48,-122,19,8,27
30198,SpokaneStBridge,06/12/2017 06:00:00 AM,48,-122,70,20,90
30199,SpokaneStBridge,06/12/2017 07:00:00 AM,48,-122,153,11,164
30200,SpokaneStBridge,06/12/2017 08:00:00 AM,48,-122,145,23,168
30201,SpokaneStBridge,06/12/2017 09:00:00 AM,48,-122,43,7,50
30202,SpokaneStBridge,06/12/2017 10:00:00 AM,48,-122,17,5,22
30203,SpokaneStBridge,06/12/2017 11:00:00 AM,48,-122,14,8,22
30204,SpokaneStBridge,06/12/2017 12:00:00 PM,48,-122,14,7,21
30205,SpokaneStBridge,06/12/2017 01:00:00 PM,48,-122,9,12,21
30206,SpokaneStBridge,06/12/2017 02:00:00 PM,48,-122,15,15,30
30207,SpokaneStBridge,06/12/2017 03:00:00 PM,48,-122,10,41,51
30208,SpokaneStBridge,06/12/2017 04:00:00 PM,48,-122,23,112,135
30209,SpokaneStBridge,06/12/2017 05:00:00 PM,48,-122,27,183,210
30210,SpokaneStBridge,06/12/2017 06:00:00 PM,48,-122,10,86,96
30211,SpokaneStBridge,06/12/2017 07:00:00 PM,48,-122,3,27,30
30212,SpokaneStBridge,06/12/2017 08:00:00 PM,48,-122,6,12,18
30213,SpokaneStBridge,06/12/2017 09:00:00 PM,48,-122,7,8,15
30214,SpokaneStBridge,06/12/2017 10:00:00 PM,48,-122,2,4,6
30215,SpokaneStBridge,06/12/2017 11:00:00 PM,48,-122,0,2,2
30216,SpokaneStBridge,06/13/2017 12:00:00 AM,48,-122,0,0,0
30217,SpokaneStBridge,06/13/2017 01:00:00 AM,48,-122,3,2,5
30218,SpokaneStBridge,06/13/2017 02:00:00 AM,48,-122,3,1,4
30219,SpokaneStBridge,06/13/2017 03:00:00 AM,48,-122,0,0,0
30220,SpokaneStBridge,06/13/2017 04:00:00 AM,48,-122,6,3,9
30221,SpokaneStBridge,06/13/2017 05:00:00 AM,48,-122,21,3,24
30222,SpokaneStBridge,06/13/2017 06:00:00 AM,48,-122,56,8,64
30223,SpokaneStBridge,06/13/2017 07:00:00 AM,48,-122,123,12,135
30224,SpokaneStBridge,06/13/2017 08:00:00 AM,48,-122,124,14,138
30225,SpokaneStBridge,06/13/2017 09:00:00 AM,48,-122,41,8,49
30226,SpokaneStBridge,06/13/2017 10:00:00 AM,48,-122,15,3,18
30227,SpokaneStBridge,06/13/2017 11:00:00 AM,48,-122,9,6,15
30228,SpokaneStBridge,06/13/2017 12:00:00 PM,48,-122,10,10,20
30229,SpokaneStBridge,06/13/2017 01:00:00 PM,48,-122,18,10,28
30230,SpokaneStBridge,06/13/2017 02:00:00 PM,48,-122,12,21,33
30231,SpokaneStBridge,06/13/2017 03:00:00 PM,48,-122,12,32,44
30232,SpokaneStBridge,06/13/2017 04:00:00 PM,48,-122,20,71,91
30233,SpokaneStBridge,06/13/2017 05:00:00 PM,48,-122,15,153,168
30234,SpokaneStBridge,06/13/2017 06:00:00 PM,48,-122,16,80,96
30235,SpokaneStBridge,06/13/2017 07:00:00 PM,48,-122,10,46,56
30236,SpokaneStBridge,06/13/2017 08:00:00 PM,48,-122,5,18,23
30237,SpokaneStBridge,06/13/2017 09:00:00 PM,48,-122,1,11,12
30238,SpokaneStBridge,06/13/2017 10:00:00 PM,48,-122,0,5,5
30239,SpokaneStBridge,06/13/2017 11:00:00 PM,48,-122,2,2,4
30240,SpokaneStBridge,06/14/2017 12:00:00 AM,48,-122,1,0,1
30241,SpokaneStBridge,06/14/2017 01:00:00 AM,48,-122,0,1,1
30242,SpokaneStBridge,06/14/2017 02:00:00 AM,48,-122,1,2,3
30243,SpokaneStBridge,06/14/2017 03:00:00 AM,48,-122,0,1,1
30244,SpokaneStBridge,06/14/2017 04:00:00 AM,48,-122,5,2,7
30245,SpokaneStBridge,06/14/2017 05:00:00 AM,48,-122,22,10,32
30246,SpokaneStBridge,06/14/2017 06:00:00 AM,48,-122,85,11,96
30247,SpokaneStBridge,06/14/2017 07:00:00 AM,48,-122,157,17,174
30248,SpokaneStBridge,06/14/2017 08:00:00 AM,48,-122,159,12,171
30249,SpokaneStBridge,06/14/2017 09:00:00 AM,48,-122,45,10,55
30250,SpokaneStBridge,06/14/2017 10:00:00 AM,48,-122,27,6,33
30251,SpokaneStBridge,06/14/2017 11:00:00 AM,48,-122,11,11,22
30252,SpokaneStBridge,06/14/2017 12:00:00 PM,48,-122,12,21,33
30253,SpokaneStBridge,06/14/2017 01:00:00 PM,48,-122,14,16,30
30254,SpokaneStBridge,06/14/2017 02:00:00 PM,48,-122,22,23,45
30255,SpokaneStBridge,06/14/2017 03:00:00 PM,48,-122,13,39,52
30256,SpokaneStBridge,06/14/2017 04:00:00 PM,48,-122,17,101,118
30257,SpokaneStBridge,06/14/2017 05:00:00 PM,48,-122,35,189,224
30258,SpokaneStBridge,06/14/2017 06:00:00 PM,48,-122,20,99,119
30259,SpokaneStBridge,06/14/2017 07:00:00 PM,48,-122,14,49,63
30260,SpokaneStBridge,06/14/2017 08:00:00 PM,48,-122,9,25,34
30261,SpokaneStBridge,06/14/2017 09:00:00 PM,48,-122,4,15,19
30262,SpokaneStBridge,06/14/2017 10:00:00 PM,48,-122,5,5,10
30263,SpokaneStBridge,06/14/2017 11:00:00 PM,48,-122,0,1,1
30264,SpokaneStBridge,06/15/2017 12:00:00 AM,48,-122,0,1,1
30265,SpokaneStBridge,06/15/2017 01:00:00 AM,48,-122,1,3,4
30266,SpokaneStBridge,06/15/2017 02:00:00 AM,48,-122,0,0,0
30267,SpokaneStBridge,06/15/2017 03:00:00 AM,48,-122,0,0,0
30268,SpokaneStBridge,06/15/2017 04:00:00 AM,48,-122,5,3,8
30269,SpokaneStBridge,06/15/2017 05:00:00 AM,48,-122,13,1,14
30270,SpokaneStBridge,06/15/2017 06:00:00 AM,48,-122,37,8,45
30271,SpokaneStBridge,06/15/2017 07:00:00 AM,48,-122,79,7,86
30272,SpokaneStBridge,06/15/2017 08:00:00 AM,48,-122,86,6,92
30273,SpokaneStBridge,06/15/2017 09:00:00 AM,48,-122,18,2,20
30274,SpokaneStBridge,06/15/2017 10:00:00 AM,48,-122,7,1,8
30275,SpokaneStBridge,06/15/2017 11:00:00 AM,48,-122,3,2,5
30276,SpokaneStBridge,06/15/2017 12:00:00 PM,48,-122,6,4,10
30277,SpokaneStBridge,06/15/2017 01:00:00 PM,48,-122,5,1,6
30278,SpokaneStBridge,06/15/2017 02:00:00 PM,48,-122,6,3,9
30279,SpokaneStBridge,06/15/2017 03:00:00 PM,48,-122,2,15,17
30280,SpokaneStBridge,06/15/2017 04:00:00 PM,48,-122,6,42,48
30281,SpokaneStBridge,06/15/2017 05:00:00 PM,48,-122,4,78,82
30282,SpokaneStBridge,06/15/2017 06:00:00 PM,48,-122,5,48,53
30283,SpokaneStBridge,06/15/2017 07:00:00 PM,48,-122,5,14,19
30284,SpokaneStBridge,06/15/2017 08:00:00 PM,48,-122,0,8,8
30285,SpokaneStBridge,06/15/2017 09:00:00 PM,48,-122,2,6,8
30286,SpokaneStBridge,06/15/2017 10:00:00 PM,48,-122,1,0,1
30287,SpokaneStBridge,06/15/2017 11:00:00 PM,48,-122,1,3,4
30288,SpokaneStBridge,06/16/2017 12:00:00 AM,48,-122,1,1,2
30289,SpokaneStBridge,06/16/2017 01:00:00 AM,48,-122,0,1,1
30290,SpokaneStBridge,06/16/2017 02:00:00 AM,48,-122,1,1,2
30291,SpokaneStBridge,06/16/2017 03:00:00 AM,48,-122,0,0,0
30292,SpokaneStBridge,06/16/2017 04:00:00 AM,48,-122,3,3,6
30293,SpokaneStBridge,06/16/2017 05:00:00 AM,48,-122,15,4,19
30294,SpokaneStBridge,06/16/2017 06:00:00 AM,48,-122,42,10,52
30295,SpokaneStBridge,06/16/2017 07:00:00 AM,48,-122,93,17,110
30296,SpokaneStBridge,06/16/2017 08:00:00 AM,48,-122,98,16,114
30297,SpokaneStBridge,06/16/2017 09:00:00 AM,48,-122,42,11,53
30298,SpokaneStBridge,06/16/2017 10:00:00 AM,48,-122,22,6,28
30299,SpokaneStBridge,06/16/2017 11:00:00 AM,48,-122,11,10,21
30300,SpokaneStBridge,06/16/2017 12:00:00 PM,48,-122,7,15,22
30301,SpokaneStBridge,06/16/2017 01:00:00 PM,48,-122,15,13,28
30302,SpokaneStBridge,06/16/2017 02:00:00 PM,48,-122,16,24,40
30303,SpokaneStBridge,06/16/2017 03:00:00 PM,48,-122,15,48,63
30304,SpokaneStBridge,06/16/2017 04:00:00 PM,48,-122,26,85,111
30305,SpokaneStBridge,06/16/2017 05:00:00 PM,48,-122,18,101,119
30306,SpokaneStBridge,06/16/2017 06:00:00 PM,48,-122,10,66,76
30307,SpokaneStBridge,06/16/2017 07:00:00 PM,48,-122,7,20,27
30308,SpokaneStBridge,06/16/2017 08:00:00 PM,48,-122,8,25,33
30309,SpokaneStBridge,06/16/2017 09:00:00 PM,48,-122,6,9,15
30310,SpokaneStBridge,06/16/2017 10:00:00 PM,48,-122,4,1,5
30311,SpokaneStBridge,06/16/2017 11:00:00 PM,48,-122,0,0,0
30312,SpokaneStBridge,06/17/2017 12:00:00 AM,48,-122,0,2,2
30313,SpokaneStBridge,06/17/2017 01:00:00 AM,48,-122,0,3,3
30314,SpokaneStBridge,06/17/2017 02:00:00 AM,48,-122,1,1,2
30315,SpokaneStBridge,06/17/2017 03:00:00 AM,48,-122,2,1,3
30316,SpokaneStBridge,06/17/2017 04:00:00 AM,48,-122,1,1,2
30317,SpokaneStBridge,06/17/2017 05:00:00 AM,48,-122,5,1,6
30318,SpokaneStBridge,06/17/2017 06:00:00 AM,48,-122,6,1,7
30319,SpokaneStBridge,06/17/2017 07:00:00 AM,48,-122,21,13,34
30320,SpokaneStBridge,06/17/2017 08:00:00 AM,48,-122,29,20,49
30321,SpokaneStBridge,06/17/2017 09:00:00 AM,48,-122,15,16,31
30322,SpokaneStBridge,06/17/2017 10:00:00 AM,48,-122,38,27,65
30323,SpokaneStBridge,06/17/2017 11:00:00 AM,48,-122,47,39,86
30324,SpokaneStBridge,06/17/2017 12:00:00 PM,48,-122,39,31,70
30325,SpokaneStBridge,06/17/2017 01:00:00 PM,48,-122,31,37,68
30326,SpokaneStBridge,06/17/2017 02:00:00 PM,48,-122,30,27,57
30327,SpokaneStBridge,06/17/2017 03:00:00 PM,48,-122,20,34,54
30328,SpokaneStBridge,06/17/2017 04:00:00 PM,48,-122,32,30,62
30329,SpokaneStBridge,06/17/2017 05:00:00 PM,48,-122,10,38,48
30330,SpokaneStBridge,06/17/2017 06:00:00 PM,48,-122,9,21,30
30331,SpokaneStBridge,06/17/2017 07:00:00 PM,48,-122,6,5,11
30332,SpokaneStBridge,06/17/2017 08:00:00 PM,48,-122,4,3,7
30333,SpokaneStBridge,06/17/2017 09:00:00 PM,48,-122,2,5,7
30334,SpokaneStBridge,06/17/2017 10:00:00 PM,48,-122,2,5,7
30335,SpokaneStBridge,06/17/2017 11:00:00 PM,48,-122,1,2,3
30336,SpokaneStBridge,06/18/2017 12:00:00 AM,48,-122,0,3,3
30337,SpokaneStBridge,06/18/2017 01:00:00 AM,48,-122,1,1,2
30338,SpokaneStBridge,06/18/2017 02:00:00 AM,48,-122,1,0,1
30339,SpokaneStBridge,06/18/2017 03:00:00 AM,48,-122,0,2,2
30340,SpokaneStBridge,06/18/2017 04:00:00 AM,48,-122,0,0,0
30341,SpokaneStBridge,06/18/2017 05:00:00 AM,48,-122,8,0,8
30342,SpokaneStBridge,06/18/2017 06:00:00 AM,48,-122,10,4,14
30343,SpokaneStBridge,06/18/2017 07:00:00 AM,48,-122,16,4,20
30344,SpokaneStBridge,06/18/2017 08:00:00 AM,48,-122,24,15,39
30345,SpokaneStBridge,06/18/2017 09:00:00 AM,48,-122,6,16,22
30346,SpokaneStBridge,06/18/2017 10:00:00 AM,48,-122,18,14,32
30347,SpokaneStBridge,06/18/2017 11:00:00 AM,48,-122,38,22,60
30348,SpokaneStBridge,06/18/2017 12:00:00 PM,48,-122,33,33,66
30349,SpokaneStBridge,06/18/2017 01:00:00 PM,48,-122,20,18,38
30350,SpokaneStBridge,06/18/2017 02:00:00 PM,48,-122,19,39,58
30351,SpokaneStBridge,06/18/2017 03:00:00 PM,48,-122,22,33,55
30352,SpokaneStBridge,06/18/2017 04:00:00 PM,48,-122,20,22,42
30353,SpokaneStBridge,06/18/2017 05:00:00 PM,48,-122,22,20,42
30354,SpokaneStBridge,06/18/2017 06:00:00 PM,48,-122,15,27,42
30355,SpokaneStBridge,06/18/2017 07:00:00 PM,48,-122,10,12,22
30356,SpokaneStBridge,06/18/2017 08:00:00 PM,48,-122,7,5,12
30357,SpokaneStBridge,06/18/2017 09:00:00 PM,48,-122,6,2,8
30358,SpokaneStBridge,06/18/2017 10:00:00 PM,48,-122,1,1,2
30359,SpokaneStBridge,06/18/2017 11:00:00 PM,48,-122,1,4,5
30360,SpokaneStBridge,06/19/2017 12:00:00 AM,48,-122,3,0,3
30361,SpokaneStBridge,06/19/2017 01:00:00 AM,48,-122,0,2,2
30362,SpokaneStBridge,06/19/2017 02:00:00 AM,48,-122,3,1,4
30363,SpokaneStBridge,06/19/2017 03:00:00 AM,48,-122,0,0,0
30364,SpokaneStBridge,06/19/2017 04:00:00 AM,48,-122,5,1,6
30365,SpokaneStBridge,06/19/2017 05:00:00 AM,48,-122,25,8,33
30366,SpokaneStBridge,06/19/2017 06:00:00 AM,48,-122,61,14,75
30367,SpokaneStBridge,06/19/2017 07:00:00 AM,48,-122,160,23,183
30368,SpokaneStBridge,06/19/2017 08:00:00 AM,48,-122,151,17,168
30369,SpokaneStBridge,06/19/2017 09:00:00 AM,48,-122,40,9,49
30370,SpokaneStBridge,06/19/2017 10:00:00 AM,48,-122,18,10,28
30371,SpokaneStBridge,06/19/2017 11:00:00 AM,48,-122,20,11,31
30372,SpokaneStBridge,06/19/2017 12:00:00 PM,48,-122,9,11,20
30373,SpokaneStBridge,06/19/2017 01:00:00 PM,48,-122,15,11,26
30374,SpokaneStBridge,06/19/2017 02:00:00 PM,48,-122,13,22,35
30375,SpokaneStBridge,06/19/2017 03:00:00 PM,48,-122,20,56,76
30376,SpokaneStBridge,06/19/2017 04:00:00 PM,48,-122,32,107,139
30377,SpokaneStBridge,06/19/2017 05:00:00 PM,48,-122,31,197,228
30378,SpokaneStBridge,06/19/2017 06:00:00 PM,48,-122,15,107,122
30379,SpokaneStBridge,06/19/2017 07:00:00 PM,48,-122,3,37,40
30380,SpokaneStBridge,06/19/2017 08:00:00 PM,48,-122,4,21,25
30381,SpokaneStBridge,06/19/2017 09:00:00 PM,48,-122,2,10,12
30382,SpokaneStBridge,06/19/2017 10:00:00 PM,48,-122,3,6,9
30383,SpokaneStBridge,06/19/2017 11:00:00 PM,48,-122,1,1,2
30384,SpokaneStBridge,06/20/2017 12:00:00 AM,48,-122,1,2,3
30385,SpokaneStBridge,06/20/2017 01:00:00 AM,48,-122,1,3,4
30386,SpokaneStBridge,06/20/2017 02:00:00 AM,48,-122,2,0,2
30387,SpokaneStBridge,06/20/2017 03:00:00 AM,48,-122,0,0,0
30388,SpokaneStBridge,06/20/2017 04:00:00 AM,48,-122,4,2,6
30389,SpokaneStBridge,06/20/2017 05:00:00 AM,48,-122,34,7,41
30390,SpokaneStBridge,06/20/2017 06:00:00 AM,48,-122,63,12,75
30391,SpokaneStBridge,06/20/2017 07:00:00 AM,48,-122,134,13,147
30392,SpokaneStBridge,06/20/2017 08:00:00 AM,48,-122,116,14,130
30393,SpokaneStBridge,06/20/2017 09:00:00 AM,48,-122,50,7,57
30394,SpokaneStBridge,06/20/2017 10:00:00 AM,48,-122,24,6,30
30395,SpokaneStBridge,06/20/2017 11:00:00 AM,48,-122,7,5,12
30396,SpokaneStBridge,06/20/2017 12:00:00 PM,48,-122,9,7,16
30397,SpokaneStBridge,06/20/2017 01:00:00 PM,48,-122,6,7,13
30398,SpokaneStBridge,06/20/2017 02:00:00 PM,48,-122,9,15,24
30399,SpokaneStBridge,06/20/2017 03:00:00 PM,48,-122,20,23,43
30400,SpokaneStBridge,06/20/2017 04:00:00 PM,48,-122,18,81,99
30401,SpokaneStBridge,06/20/2017 05:00:00 PM,48,-122,19,161,180
30402,SpokaneStBridge,06/20/2017 06:00:00 PM,48,-122,10,92,102
30403,SpokaneStBridge,06/20/2017 07:00:00 PM,48,-122,8,40,48
30404,SpokaneStBridge,06/20/2017 08:00:00 PM,48,-122,11,14,25
30405,SpokaneStBridge,06/20/2017 09:00:00 PM,48,-122,5,10,15
30406,SpokaneStBridge,06/20/2017 10:00:00 PM,48,-122,1,11,12
30407,SpokaneStBridge,06/20/2017 11:00:00 PM,48,-122,0,6,6
30408,SpokaneStBridge,06/21/2017 12:00:00 AM,48,-122,2,2,4
30409,SpokaneStBridge,06/21/2017 01:00:00 AM,48,-122,0,0,0
30410,SpokaneStBridge,06/21/2017 02:00:00 AM,48,-122,0,0,0
30411,SpokaneStBridge,06/21/2017 03:00:00 AM,48,-122,0,0,0
30412,SpokaneStBridge,06/21/2017 04:00:00 AM,48,-122,5,2,7
30413,SpokaneStBridge,06/21/2017 05:00:00 AM,48,-122,32,4,36
30414,SpokaneStBridge,06/21/2017 06:00:00 AM,48,-122,87,11,98
30415,SpokaneStBridge,06/21/2017 07:00:00 AM,48,-122,164,14,178
30416,SpokaneStBridge,06/21/2017 08:00:00 AM,48,-122,155,12,167
30417,SpokaneStBridge,06/21/2017 09:00:00 AM,48,-122,52,16,68
30418,SpokaneStBridge,06/21/2017 10:00:00 AM,48,-122,32,6,38
30419,SpokaneStBridge,06/21/2017 11:00:00 AM,48,-122,18,8,26
30420,SpokaneStBridge,06/21/2017 12:00:00 PM,48,-122,10,11,21
30421,SpokaneStBridge,06/21/2017 01:00:00 PM,48,-122,17,21,38
30422,SpokaneStBridge,06/21/2017 02:00:00 PM,48,-122,14,23,37
30423,SpokaneStBridge,06/21/2017 03:00:00 PM,48,-122,17,51,68
30424,SpokaneStBridge,06/21/2017 04:00:00 PM,48,-122,26,113,139
30425,SpokaneStBridge,06/21/2017 05:00:00 PM,48,-122,34,195,229
30426,SpokaneStBridge,06/21/2017 06:00:00 PM,48,-122,27,127,154
30427,SpokaneStBridge,06/21/2017 07:00:00 PM,48,-122,18,53,71
30428,SpokaneStBridge,06/21/2017 08:00:00 PM,48,-122,19,24,43
30429,SpokaneStBridge,06/21/2017 09:00:00 PM,48,-122,10,19,29
30430,SpokaneStBridge,06/21/2017 10:00:00 PM,48,-122,3,23,26
30431,SpokaneStBridge,06/21/2017 11:00:00 PM,48,-122,1,8,9
30432,SpokaneStBridge,06/22/2017 12:00:00 AM,48,-122,2,3,5
30433,SpokaneStBridge,06/22/2017 01:00:00 AM,48,-122,1,1,2
30434,SpokaneStBridge,06/22/2017 02:00:00 AM,48,-122,0,1,1
30435,SpokaneStBridge,06/22/2017 03:00:00 AM,48,-122,2,0,2
30436,SpokaneStBridge,06/22/2017 04:00:00 AM,48,-122,7,2,9
30437,SpokaneStBridge,06/22/2017 05:00:00 AM,48,-122,25,7,32
30438,SpokaneStBridge,06/22/2017 06:00:00 AM,48,-122,76,5,81
30439,SpokaneStBridge,06/22/2017 07:00:00 AM,48,-122,161,19,180
30440,SpokaneStBridge,06/22/2017 08:00:00 AM,48,-122,156,15,171
30441,SpokaneStBridge,06/22/2017 09:00:00 AM,48,-122,59,14,73
30442,SpokaneStBridge,06/22/2017 10:00:00 AM,48,-122,39,8,47
30443,SpokaneStBridge,06/22/2017 11:00:00 AM,48,-122,18,10,28
30444,SpokaneStBridge,06/22/2017 12:00:00 PM,48,-122,16,16,32
30445,SpokaneStBridge,06/22/2017 01:00:00 PM,48,-122,21,21,42
30446,SpokaneStBridge,06/22/2017 02:00:00 PM,48,-122,12,22,34
30447,SpokaneStBridge,06/22/2017 03:00:00 PM,48,-122,15,54,69
30448,SpokaneStBridge,06/22/2017 04:00:00 PM,48,-122,34,102,136
30449,SpokaneStBridge,06/22/2017 05:00:00 PM,48,-122,32,191,223
30450,SpokaneStBridge,06/22/2017 06:00:00 PM,48,-122,24,106,130
30451,SpokaneStBridge,06/22/2017 07:00:00 PM,48,-122,20,95,115
30452,SpokaneStBridge,06/22/2017 08:00:00 PM,48,-122,14,35,49
30453,SpokaneStBridge,06/22/2017 09:00:00 PM,48,-122,7,12,19
30454,SpokaneStBridge,06/22/2017 10:00:00 PM,48,-122,4,13,17
30455,SpokaneStBridge,06/22/2017 11:00:00 PM,48,-122,2,2,4
30456,SpokaneStBridge,06/23/2017 12:00:00 AM,48,-122,1,7,8
30457,SpokaneStBridge,06/23/2017 01:00:00 AM,48,-122,1,3,4
30458,SpokaneStBridge,06/23/2017 02:00:00 AM,48,-122,2,3,5
30459,SpokaneStBridge,06/23/2017 03:00:00 AM,48,-122,2,1,3
30460,SpokaneStBridge,06/23/2017 04:00:00 AM,48,-122,5,3,8
30461,SpokaneStBridge,06/23/2017 05:00:00 AM,48,-122,11,5,16
30462,SpokaneStBridge,06/23/2017 06:00:00 AM,48,-122,72,10,82
30463,SpokaneStBridge,06/23/2017 07:00:00 AM,48,-122,143,22,165
30464,SpokaneStBridge,06/23/2017 08:00:00 AM,48,-122,127,13,140
30465,SpokaneStBridge,06/23/2017 09:00:00 AM,48,-122,60,8,68
30466,SpokaneStBridge,06/23/2017 10:00:00 AM,48,-122,21,12,33
30467,SpokaneStBridge,06/23/2017 11:00:00 AM,48,-122,25,16,41
30468,SpokaneStBridge,06/23/2017 12:00:00 PM,48,-122,16,22,38
30469,SpokaneStBridge,06/23/2017 01:00:00 PM,48,-122,14,34,48
30470,SpokaneStBridge,06/23/2017 02:00:00 PM,48,-122,15,32,47
30471,SpokaneStBridge,06/23/2017 03:00:00 PM,48,-122,24,79,103
30472,SpokaneStBridge,06/23/2017 04:00:00 PM,48,-122,21,113,134
30473,SpokaneStBridge,06/23/2017 05:00:00 PM,48,-122,18,140,158
30474,SpokaneStBridge,06/23/2017 06:00:00 PM,48,-122,27,77,104
30475,SpokaneStBridge,06/23/2017 07:00:00 PM,48,-122,17,36,53
30476,SpokaneStBridge,06/23/2017 08:00:00 PM,48,-122,23,35,58
30477,SpokaneStBridge,06/23/2017 09:00:00 PM,48,-122,5,10,15
30478,SpokaneStBridge,06/23/2017 10:00:00 PM,48,-122,1,12,13
30479,SpokaneStBridge,06/23/2017 11:00:00 PM,48,-122,5,16,21
30480,SpokaneStBridge,06/24/2017 12:00:00 AM,48,-122,0,1,1
30481,SpokaneStBridge,06/24/2017 01:00:00 AM,48,-122,1,2,3
30482,SpokaneStBridge,06/24/2017 02:00:00 AM,48,-122,1,1,2
30483,SpokaneStBridge,06/24/2017 03:00:00 AM,48,-122,1,2,3
30484,SpokaneStBridge,06/24/2017 04:00:00 AM,48,-122,2,5,7
30485,SpokaneStBridge,06/24/2017 05:00:00 AM,48,-122,6,1,7
30486,SpokaneStBridge,06/24/2017 06:00:00 AM,48,-122,15,6,21
30487,SpokaneStBridge,06/24/2017 07:00:00 AM,48,-122,10,22,32
30488,SpokaneStBridge,06/24/2017 08:00:00 AM,48,-122,37,46,83
30489,SpokaneStBridge,06/24/2017 09:00:00 AM,48,-122,37,26,63
30490,SpokaneStBridge,06/24/2017 10:00:00 AM,48,-122,44,29,73
30491,SpokaneStBridge,06/24/2017 11:00:00 AM,48,-122,57,46,103
30492,SpokaneStBridge,06/24/2017 12:00:00 PM,48,-122,39,47,86
30493,SpokaneStBridge,06/24/2017 01:00:00 PM,48,-122,23,35,58
30494,SpokaneStBridge,06/24/2017 02:00:00 PM,48,-122,35,46,81
30495,SpokaneStBridge,06/24/2017 03:00:00 PM,48,-122,48,37,85
30496,SpokaneStBridge,06/24/2017 04:00:00 PM,48,-122,35,44,79
30497,SpokaneStBridge,06/24/2017 05:00:00 PM,48,-122,27,26,53
30498,SpokaneStBridge,06/24/2017 06:00:00 PM,48,-122,14,24,38
30499,SpokaneStBridge,06/24/2017 07:00:00 PM,48,-122,21,14,35
30500,SpokaneStBridge,06/24/2017 08:00:00 PM,48,-122,25,11,36
30501,SpokaneStBridge,06/24/2017 09:00:00 PM,48,-122,11,10,21
30502,SpokaneStBridge,06/24/2017 10:00:00 PM,48,-122,7,12,19
30503,SpokaneStBridge,06/24/2017 11:00:00 PM,48,-122,3,5,8
30504,SpokaneStBridge,06/25/2017 12:00:00 AM,48,-122,1,2,3
30505,SpokaneStBridge,06/25/2017 01:00:00 AM,48,-122,1,2,3
30506,SpokaneStBridge,06/25/2017 02:00:00 AM,48,-122,1,1,2
30507,SpokaneStBridge,06/25/2017 03:00:00 AM,48,-122,0,0,0
30508,SpokaneStBridge,06/25/2017 04:00:00 AM,48,-122,2,0,2
30509,SpokaneStBridge,06/25/2017 05:00:00 AM,48,-122,5,2,7
30510,SpokaneStBridge,06/25/2017 06:00:00 AM,48,-122,4,6,10
30511,SpokaneStBridge,06/25/2017 07:00:00 AM,48,-122,21,9,30
30512,SpokaneStBridge,06/25/2017 08:00:00 AM,48,-122,31,26,57
30513,SpokaneStBridge,06/25/2017 09:00:00 AM,48,-122,33,51,84
30514,SpokaneStBridge,06/25/2017 10:00:00 AM,48,-122,45,38,83
30515,SpokaneStBridge,06/25/2017 11:00:00 AM,48,-122,46,28,74
30516,SpokaneStBridge,06/25/2017 12:00:00 PM,48,-122,44,18,62
30517,SpokaneStBridge,06/25/2017 01:00:00 PM,48,-122,26,30,56
30518,SpokaneStBridge,06/25/2017 02:00:00 PM,48,-122,17,19,36
30519,SpokaneStBridge,06/25/2017 03:00:00 PM,48,-122,29,36,65
30520,SpokaneStBridge,06/25/2017 04:00:00 PM,48,-122,13,32,45
30521,SpokaneStBridge,06/25/2017 05:00:00 PM,48,-122,19,22,41
30522,SpokaneStBridge,06/25/2017 06:00:00 PM,48,-122,10,19,29
30523,SpokaneStBridge,06/25/2017 07:00:00 PM,48,-122,13,10,23
30524,SpokaneStBridge,06/25/2017 08:00:00 PM,48,-122,13,9,22
30525,SpokaneStBridge,06/25/2017 09:00:00 PM,48,-122,9,8,17
30526,SpokaneStBridge,06/25/2017 10:00:00 PM,48,-122,2,3,5
30527,SpokaneStBridge,06/25/2017 11:00:00 PM,48,-122,2,0,2
30528,SpokaneStBridge,06/26/2017 12:00:00 AM,48,-122,4,1,5
30529,SpokaneStBridge,06/26/2017 01:00:00 AM,48,-122,0,1,1
30530,SpokaneStBridge,06/26/2017 02:00:00 AM,48,-122,1,2,3
30531,SpokaneStBridge,06/26/2017 03:00:00 AM,48,-122,0,0,0
30532,SpokaneStBridge,06/26/2017 04:00:00 AM,48,-122,6,1,7
30533,SpokaneStBridge,06/26/2017 05:00:00 AM,48,-122,25,3,28
30534,SpokaneStBridge,06/26/2017 06:00:00 AM,48,-122,73,10,83
30535,SpokaneStBridge,06/26/2017 07:00:00 AM,48,-122,160,15,175
30536,SpokaneStBridge,06/26/2017 08:00:00 AM,48,-122,135,12,147
30537,SpokaneStBridge,06/26/2017 09:00:00 AM,48,-122,51,6,57
30538,SpokaneStBridge,06/26/2017 10:00:00 AM,48,-122,19,6,25
30539,SpokaneStBridge,06/26/2017 11:00:00 AM,48,-122,11,9,20
30540,SpokaneStBridge,06/26/2017 12:00:00 PM,48,-122,16,23,39
30541,SpokaneStBridge,06/26/2017 01:00:00 PM,48,-122,14,11,25
30542,SpokaneStBridge,06/26/2017 02:00:00 PM,48,-122,11,10,21
30543,SpokaneStBridge,06/26/2017 03:00:00 PM,48,-122,16,51,67
30544,SpokaneStBridge,06/26/2017 04:00:00 PM,48,-122,30,116,146
30545,SpokaneStBridge,06/26/2017 05:00:00 PM,48,-122,22,192,214
30546,SpokaneStBridge,06/26/2017 06:00:00 PM,48,-122,20,96,116
30547,SpokaneStBridge,06/26/2017 07:00:00 PM,48,-122,8,41,49
30548,SpokaneStBridge,06/26/2017 08:00:00 PM,48,-122,7,13,20
30549,SpokaneStBridge,06/26/2017 09:00:00 PM,48,-122,7,4,11
30550,SpokaneStBridge,06/26/2017 10:00:00 PM,48,-122,5,7,12
30551,SpokaneStBridge,06/26/2017 11:00:00 PM,48,-122,5,3,8
30552,SpokaneStBridge,06/27/2017 12:00:00 AM,48,-122,0,2,2
30553,SpokaneStBridge,06/27/2017 01:00:00 AM,48,-122,0,0,0
30554,SpokaneStBridge,06/27/2017 02:00:00 AM,48,-122,0,1,1
30555,SpokaneStBridge,06/27/2017 03:00:00 AM,48,-122,0,0,0
30556,SpokaneStBridge,06/27/2017 04:00:00 AM,48,-122,4,1,5
30557,SpokaneStBridge,06/27/2017 05:00:00 AM,48,-122,20,4,24
30558,SpokaneStBridge,06/27/2017 06:00:00 AM,48,-122,78,14,92
30559,SpokaneStBridge,06/27/2017 07:00:00 AM,48,-122,165,18,183
30560,SpokaneStBridge,06/27/2017 08:00:00 AM,48,-122,161,17,178
30561,SpokaneStBridge,06/27/2017 09:00:00 AM,48,-122,51,5,56
30562,SpokaneStBridge,06/27/2017 10:00:00 AM,48,-122,21,10,31
30563,SpokaneStBridge,06/27/2017 11:00:00 AM,48,-122,17,17,34
30564,SpokaneStBridge,06/27/2017 12:00:00 PM,48,-122,14,7,21
30565,SpokaneStBridge,06/27/2017 01:00:00 PM,48,-122,11,15,26
30566,SpokaneStBridge,06/27/2017 02:00:00 PM,48,-122,16,23,39
30567,SpokaneStBridge,06/27/2017 03:00:00 PM,48,-122,32,37,69
30568,SpokaneStBridge,06/27/2017 04:00:00 PM,48,-122,19,112,131
30569,SpokaneStBridge,06/27/2017 05:00:00 PM,48,-122,31,187,218
30570,SpokaneStBridge,06/27/2017 06:00:00 PM,48,-122,26,132,158
30571,SpokaneStBridge,06/27/2017 07:00:00 PM,48,-122,12,50,62
30572,SpokaneStBridge,06/27/2017 08:00:00 PM,48,-122,14,26,40
30573,SpokaneStBridge,06/27/2017 09:00:00 PM,48,-122,10,17,27
30574,SpokaneStBridge,06/27/2017 10:00:00 PM,48,-122,1,8,9
30575,SpokaneStBridge,06/27/2017 11:00:00 PM,48,-122,2,6,8
30576,SpokaneStBridge,06/28/2017 12:00:00 AM,48,-122,0,0,0
30577,SpokaneStBridge,06/28/2017 01:00:00 AM,48,-122,0,2,2
30578,SpokaneStBridge,06/28/2017 02:00:00 AM,48,-122,1,1,2
30579,SpokaneStBridge,06/28/2017 03:00:00 AM,48,-122,0,0,0
30580,SpokaneStBridge,06/28/2017 04:00:00 AM,48,-122,4,2,6
30581,SpokaneStBridge,06/28/2017 05:00:00 AM,48,-122,25,3,28
30582,SpokaneStBridge,06/28/2017 06:00:00 AM,48,-122,82,11,93
30583,SpokaneStBridge,06/28/2017 07:00:00 AM,48,-122,148,21,169
30584,SpokaneStBridge,06/28/2017 08:00:00 AM,48,-122,137,8,145
30585,SpokaneStBridge,06/28/2017 09:00:00 AM,48,-122,57,11,68
30586,SpokaneStBridge,06/28/2017 10:00:00 AM,48,-122,24,5,29
30587,SpokaneStBridge,06/28/2017 11:00:00 AM,48,-122,18,11,29
30588,SpokaneStBridge,06/28/2017 12:00:00 PM,48,-122,25,10,35
30589,SpokaneStBridge,06/28/2017 01:00:00 PM,48,-122,9,12,21
30590,SpokaneStBridge,06/28/2017 02:00:00 PM,48,-122,9,15,24
30591,SpokaneStBridge,06/28/2017 03:00:00 PM,48,-122,18,48,66
30592,SpokaneStBridge,06/28/2017 04:00:00 PM,48,-122,20,100,120
30593,SpokaneStBridge,06/28/2017 05:00:00 PM,48,-122,34,181,215
30594,SpokaneStBridge,06/28/2017 06:00:00 PM,48,-122,28,115,143
30595,SpokaneStBridge,06/28/2017 07:00:00 PM,48,-122,18,58,76
30596,SpokaneStBridge,06/28/2017 08:00:00 PM,48,-122,5,25,30
30597,SpokaneStBridge,06/28/2017 09:00:00 PM,48,-122,14,10,24
30598,SpokaneStBridge,06/28/2017 10:00:00 PM,48,-122,1,4,5
30599,SpokaneStBridge,06/28/2017 11:00:00 PM,48,-122,0,1,1
30600,SpokaneStBridge,06/29/2017 12:00:00 AM,48,-122,1,4,5
30601,SpokaneStBridge,06/29/2017 01:00:00 AM,48,-122,1,0,1
30602,SpokaneStBridge,06/29/2017 02:00:00 AM,48,-122,0,0,0
30603,SpokaneStBridge,06/29/2017 03:00:00 AM,48,-122,0,2,2
30604,SpokaneStBridge,06/29/2017 04:00:00 AM,48,-122,7,5,12
30605,SpokaneStBridge,06/29/2017 05:00:00 AM,48,-122,18,8,26
30606,SpokaneStBridge,06/29/2017 06:00:00 AM,48,-122,70,7,77
30607,SpokaneStBridge,06/29/2017 07:00:00 AM,48,-122,168,15,183
30608,SpokaneStBridge,06/29/2017 08:00:00 AM,48,-122,126,14,140
30609,SpokaneStBridge,06/29/2017 09:00:00 AM,48,-122,78,18,96
30610,SpokaneStBridge,06/29/2017 10:00:00 AM,48,-122,24,10,34
30611,SpokaneStBridge,06/29/2017 11:00:00 AM,48,-122,12,10,22
30612,SpokaneStBridge,06/29/2017 12:00:00 PM,48,-122,15,14,29
30613,SpokaneStBridge,06/29/2017 01:00:00 PM,48,-122,31,18,49
30614,SpokaneStBridge,06/29/2017 02:00:00 PM,48,-122,11,25,36
30615,SpokaneStBridge,06/29/2017 03:00:00 PM,48,-122,24,55,79
30616,SpokaneStBridge,06/29/2017 04:00:00 PM,48,-122,23,96,119
30617,SpokaneStBridge,06/29/2017 05:00:00 PM,48,-122,26,190,216
30618,SpokaneStBridge,06/29/2017 06:00:00 PM,48,-122,15,105,120
30619,SpokaneStBridge,06/29/2017 07:00:00 PM,48,-122,30,52,82
30620,SpokaneStBridge,06/29/2017 08:00:00 PM,48,-122,24,29,53
30621,SpokaneStBridge,06/29/2017 09:00:00 PM,48,-122,18,21,39
30622,SpokaneStBridge,06/29/2017 10:00:00 PM,48,-122,4,5,9
30623,SpokaneStBridge,06/29/2017 11:00:00 PM,48,-122,7,5,12
30624,SpokaneStBridge,06/30/2017 12:00:00 AM,48,-122,0,1,1
30625,SpokaneStBridge,06/30/2017 01:00:00 AM,48,-122,1,1,2
30626,SpokaneStBridge,06/30/2017 02:00:00 AM,48,-122,2,2,4
30627,SpokaneStBridge,06/30/2017 03:00:00 AM,48,-122,1,2,3
30628,SpokaneStBridge,06/30/2017 04:00:00 AM,48,-122,4,4,8
30629,SpokaneStBridge,06/30/2017 05:00:00 AM,48,-122,21,4,25
30630,SpokaneStBridge,06/30/2017 06:00:00 AM,48,-122,50,8,58
30631,SpokaneStBridge,06/30/2017 07:00:00 AM,48,-122,124,16,140
30632,SpokaneStBridge,06/30/2017 08:00:00 AM,48,-122,132,17,149
30633,SpokaneStBridge,06/30/2017 09:00:00 AM,48,-122,40,18,58
30634,SpokaneStBridge,06/30/2017 10:00:00 AM,48,-122,16,12,28
30635,SpokaneStBridge,06/30/2017 11:00:00 AM,48,-122,25,14,39
30636,SpokaneStBridge,06/30/2017 12:00:00 PM,48,-122,18,19,37
30637,SpokaneStBridge,06/30/2017 01:00:00 PM,48,-122,21,21,42
30638,SpokaneStBridge,06/30/2017 02:00:00 PM,48,-122,13,25,38
30639,SpokaneStBridge,06/30/2017 03:00:00 PM,48,-122,25,60,85
30640,SpokaneStBridge,06/30/2017 04:00:00 PM,48,-122,19,108,127
30641,SpokaneStBridge,06/30/2017 05:00:00 PM,48,-122,23,121,144
30642,SpokaneStBridge,06/30/2017 06:00:00 PM,48,-122,25,70,95
30643,SpokaneStBridge,06/30/2017 07:00:00 PM,48,-122,15,32,47
30644,SpokaneStBridge,06/30/2017 08:00:00 PM,48,-122,11,23,34
30645,SpokaneStBridge,06/30/2017 09:00:00 PM,48,-122,9,8,17
30646,SpokaneStBridge,06/30/2017 10:00:00 PM,48,-122,3,4,7
30647,SpokaneStBridge,06/30/2017 11:00:00 PM,48,-122,1,4,5
30648,SpokaneStBridge,07/01/2017 12:00:00 AM,48,-122,0,3,3
30649,SpokaneStBridge,07/01/2017 01:00:00 AM,48,-122,1,0,1
30650,SpokaneStBridge,07/01/2017 02:00:00 AM,48,-122,1,1,2
30651,SpokaneStBridge,07/01/2017 03:00:00 AM,48,-122,2,3,5
30652,SpokaneStBridge,07/01/2017 04:00:00 AM,48,-122,1,1,2
30653,SpokaneStBridge,07/01/2017 05:00:00 AM,48,-122,5,1,6
30654,SpokaneStBridge,07/01/2017 06:00:00 AM,48,-122,13,5,18
30655,SpokaneStBridge,07/01/2017 07:00:00 AM,48,-122,13,9,22
30656,SpokaneStBridge,07/01/2017 08:00:00 AM,48,-122,26,34,60
30657,SpokaneStBridge,07/01/2017 09:00:00 AM,48,-122,18,17,35
30658,SpokaneStBridge,07/01/2017 10:00:00 AM,48,-122,19,37,56
30659,SpokaneStBridge,07/01/2017 11:00:00 AM,48,-122,29,33,62
30660,SpokaneStBridge,07/01/2017 12:00:00 PM,48,-122,40,28,68
30661,SpokaneStBridge,07/01/2017 01:00:00 PM,48,-122,32,29,61
30662,SpokaneStBridge,07/01/2017 02:00:00 PM,48,-122,36,35,71
30663,SpokaneStBridge,07/01/2017 03:00:00 PM,48,-122,32,29,61
30664,SpokaneStBridge,07/01/2017 04:00:00 PM,48,-122,29,27,56
30665,SpokaneStBridge,07/01/2017 05:00:00 PM,48,-122,21,22,43
30666,SpokaneStBridge,07/01/2017 06:00:00 PM,48,-122,17,20,37
30667,SpokaneStBridge,07/01/2017 07:00:00 PM,48,-122,3,14,17
30668,SpokaneStBridge,07/01/2017 08:00:00 PM,48,-122,7,13,20
30669,SpokaneStBridge,07/01/2017 09:00:00 PM,48,-122,6,17,23
30670,SpokaneStBridge,07/01/2017 10:00:00 PM,48,-122,2,3,5
30671,SpokaneStBridge,07/01/2017 11:00:00 PM,48,-122,1,2,3
30672,SpokaneStBridge,07/02/2017 12:00:00 AM,48,-122,0,0,0
30673,SpokaneStBridge,07/02/2017 01:00:00 AM,48,-122,0,5,5
30674,SpokaneStBridge,07/02/2017 02:00:00 AM,48,-122,1,0,1
30675,SpokaneStBridge,07/02/2017 03:00:00 AM,48,-122,0,1,1
30676,SpokaneStBridge,07/02/2017 04:00:00 AM,48,-122,2,1,3
30677,SpokaneStBridge,07/02/2017 05:00:00 AM,48,-122,3,3,6
30678,SpokaneStBridge,07/02/2017 06:00:00 AM,48,-122,11,9,20
30679,SpokaneStBridge,07/02/2017 07:00:00 AM,48,-122,17,7,24
30680,SpokaneStBridge,07/02/2017 08:00:00 AM,48,-122,16,6,22
30681,SpokaneStBridge,07/02/2017 09:00:00 AM,48,-122,20,100,120
30682,SpokaneStBridge,07/02/2017 10:00:00 AM,48,-122,80,94,174
30683,SpokaneStBridge,07/02/2017 11:00:00 AM,48,-122,118,27,145
30684,SpokaneStBridge,07/02/2017 12:00:00 PM,48,-122,55,35,90
30685,SpokaneStBridge,07/02/2017 01:00:00 PM,48,-122,34,36,70
30686,SpokaneStBridge,07/02/2017 02:00:00 PM,48,-122,31,55,86
30687,SpokaneStBridge,07/02/2017 03:00:00 PM,48,-122,37,46,83
30688,SpokaneStBridge,07/02/2017 04:00:00 PM,48,-122,39,34,73
30689,SpokaneStBridge,07/02/2017 05:00:00 PM,48,-122,34,27,61
30690,SpokaneStBridge,07/02/2017 06:00:00 PM,48,-122,18,25,43
30691,SpokaneStBridge,07/02/2017 07:00:00 PM,48,-122,22,9,31
30692,SpokaneStBridge,07/02/2017 08:00:00 PM,48,-122,8,16,24
30693,SpokaneStBridge,07/02/2017 09:00:00 PM,48,-122,10,8,18
30694,SpokaneStBridge,07/02/2017 10:00:00 PM,48,-122,4,3,7
30695,SpokaneStBridge,07/02/2017 11:00:00 PM,48,-122,0,4,4
30696,SpokaneStBridge,07/03/2017 12:00:00 AM,48,-122,3,2,5
30697,SpokaneStBridge,07/03/2017 01:00:00 AM,48,-122,0,1,1
30698,SpokaneStBridge,07/03/2017 02:00:00 AM,48,-122,1,2,3
30699,SpokaneStBridge,07/03/2017 03:00:00 AM,48,-122,1,0,1
30700,SpokaneStBridge,07/03/2017 04:00:00 AM,48,-122,5,1,6
30701,SpokaneStBridge,07/03/2017 05:00:00 AM,48,-122,10,3,13
30702,SpokaneStBridge,07/03/2017 06:00:00 AM,48,-122,28,8,36
30703,SpokaneStBridge,07/03/2017 07:00:00 AM,48,-122,73,10,83
30704,SpokaneStBridge,07/03/2017 08:00:00 AM,48,-122,60,12,72
30705,SpokaneStBridge,07/03/2017 09:00:00 AM,48,-122,36,10,46
30706,SpokaneStBridge,07/03/2017 10:00:00 AM,48,-122,16,13,29
30707,SpokaneStBridge,07/03/2017 11:00:00 AM,48,-122,19,11,30
30708,SpokaneStBridge,07/03/2017 12:00:00 PM,48,-122,20,18,38
30709,SpokaneStBridge,07/03/2017 01:00:00 PM,48,-122,24,24,48
30710,SpokaneStBridge,07/03/2017 02:00:00 PM,48,-122,17,47,64
30711,SpokaneStBridge,07/03/2017 03:00:00 PM,48,-122,19,51,70
30712,SpokaneStBridge,07/03/2017 04:00:00 PM,48,-122,28,72,100
30713,SpokaneStBridge,07/03/2017 05:00:00 PM,48,-122,31,68,99
30714,SpokaneStBridge,07/03/2017 06:00:00 PM,48,-122,16,45,61
30715,SpokaneStBridge,07/03/2017 07:00:00 PM,48,-122,17,21,38
30716,SpokaneStBridge,07/03/2017 08:00:00 PM,48,-122,18,17,35
30717,SpokaneStBridge,07/03/2017 09:00:00 PM,48,-122,2,14,16
30718,SpokaneStBridge,07/03/2017 10:00:00 PM,48,-122,3,4,7
30719,SpokaneStBridge,07/03/2017 11:00:00 PM,48,-122,0,1,1
30720,SpokaneStBridge,07/04/2017 12:00:00 AM,48,-122,0,0,0
30721,SpokaneStBridge,07/04/2017 01:00:00 AM,48,-122,2,1,3
30722,SpokaneStBridge,07/04/2017 02:00:00 AM,48,-122,2,1,3
30723,SpokaneStBridge,07/04/2017 03:00:00 AM,48,-122,1,1,2
30724,SpokaneStBridge,07/04/2017 04:00:00 AM,48,-122,0,2,2
30725,SpokaneStBridge,07/04/2017 05:00:00 AM,48,-122,9,1,10
30726,SpokaneStBridge,07/04/2017 06:00:00 AM,48,-122,9,6,15
30727,SpokaneStBridge,07/04/2017 07:00:00 AM,48,-122,12,9,21
30728,SpokaneStBridge,07/04/2017 08:00:00 AM,48,-122,31,9,40
30729,SpokaneStBridge,07/04/2017 09:00:00 AM,48,-122,25,40,65
30730,SpokaneStBridge,07/04/2017 10:00:00 AM,48,-122,50,53,103
30731,SpokaneStBridge,07/04/2017 11:00:00 AM,48,-122,37,37,74
30732,SpokaneStBridge,07/04/2017 12:00:00 PM,48,-122,54,40,94
30733,SpokaneStBridge,07/04/2017 01:00:00 PM,48,-122,62,46,108
30734,SpokaneStBridge,07/04/2017 02:00:00 PM,48,-122,34,54,88
30735,SpokaneStBridge,07/04/2017 03:00:00 PM,48,-122,37,56,93
30736,SpokaneStBridge,07/04/2017 04:00:00 PM,48,-122,45,23,68
30737,SpokaneStBridge,07/04/2017 05:00:00 PM,48,-122,23,22,45
30738,SpokaneStBridge,07/04/2017 06:00:00 PM,48,-122,12,22,34
30739,SpokaneStBridge,07/04/2017 07:00:00 PM,48,-122,20,15,35
30740,SpokaneStBridge,07/04/2017 08:00:00 PM,48,-122,9,14,23
30741,SpokaneStBridge,07/04/2017 09:00:00 PM,48,-122,5,11,16
30742,SpokaneStBridge,07/04/2017 10:00:00 PM,48,-122,3,4,7
30743,SpokaneStBridge,07/04/2017 11:00:00 PM,48,-122,3,7,10
30744,SpokaneStBridge,07/05/2017 12:00:00 AM,48,-122,1,6,7
30745,SpokaneStBridge,07/05/2017 01:00:00 AM,48,-122,0,2,2
30746,SpokaneStBridge,07/05/2017 02:00:00 AM,48,-122,1,0,1
30747,SpokaneStBridge,07/05/2017 03:00:00 AM,48,-122,1,1,2
30748,SpokaneStBridge,07/05/2017 04:00:00 AM,48,-122,5,4,9
30749,SpokaneStBridge,07/05/2017 05:00:00 AM,48,-122,16,5,21
30750,SpokaneStBridge,07/05/2017 06:00:00 AM,48,-122,71,9,80
30751,SpokaneStBridge,07/05/2017 07:00:00 AM,48,-122,135,10,145
30752,SpokaneStBridge,07/05/2017 08:00:00 AM,48,-122,146,15,161
30753,SpokaneStBridge,07/05/2017 09:00:00 AM,48,-122,59,8,67
30754,SpokaneStBridge,07/05/2017 10:00:00 AM,48,-122,23,6,29
30755,SpokaneStBridge,07/05/2017 11:00:00 AM,48,-122,20,22,42
30756,SpokaneStBridge,07/05/2017 12:00:00 PM,48,-122,17,17,34
30757,SpokaneStBridge,07/05/2017 01:00:00 PM,48,-122,18,23,41
30758,SpokaneStBridge,07/05/2017 02:00:00 PM,48,-122,19,24,43
30759,SpokaneStBridge,07/05/2017 03:00:00 PM,48,-122,28,32,60
30760,SpokaneStBridge,07/05/2017 04:00:00 PM,48,-122,33,91,124
30761,SpokaneStBridge,07/05/2017 05:00:00 PM,48,-122,25,172,197
30762,SpokaneStBridge,07/05/2017 06:00:00 PM,48,-122,12,108,120
30763,SpokaneStBridge,07/05/2017 07:00:00 PM,48,-122,9,47,56
30764,SpokaneStBridge,07/05/2017 08:00:00 PM,48,-122,9,15,24
30765,SpokaneStBridge,07/05/2017 09:00:00 PM,48,-122,9,9,18
30766,SpokaneStBridge,07/05/2017 10:00:00 PM,48,-122,4,5,9
30767,SpokaneStBridge,07/05/2017 11:00:00 PM,48,-122,2,4,6
30768,SpokaneStBridge,07/06/2017 12:00:00 AM,48,-122,2,1,3
30769,SpokaneStBridge,07/06/2017 01:00:00 AM,48,-122,0,2,2
30770,SpokaneStBridge,07/06/2017 02:00:00 AM,48,-122,1,0,1
30771,SpokaneStBridge,07/06/2017 03:00:00 AM,48,-122,0,0,0
30772,SpokaneStBridge,07/06/2017 04:00:00 AM,48,-122,5,5,10
30773,SpokaneStBridge,07/06/2017 05:00:00 AM,48,-122,23,3,26
30774,SpokaneStBridge,07/06/2017 06:00:00 AM,48,-122,83,14,97
30775,SpokaneStBridge,07/06/2017 07:00:00 AM,48,-122,199,12,211
30776,SpokaneStBridge,07/06/2017 08:00:00 AM,48,-122,138,13,151
30777,SpokaneStBridge,07/06/2017 09:00:00 AM,48,-122,70,11,81
30778,SpokaneStBridge,07/06/2017 10:00:00 AM,48,-122,20,13,33
30779,SpokaneStBridge,07/06/2017 11:00:00 AM,48,-122,12,10,22
30780,SpokaneStBridge,07/06/2017 12:00:00 PM,48,-122,13,11,24
30781,SpokaneStBridge,07/06/2017 01:00:00 PM,48,-122,23,18,41
30782,SpokaneStBridge,07/06/2017 02:00:00 PM,48,-122,14,26,40
30783,SpokaneStBridge,07/06/2017 03:00:00 PM,48,-122,34,43,77
30784,SpokaneStBridge,07/06/2017 04:00:00 PM,48,-122,18,111,129
30785,SpokaneStBridge,07/06/2017 05:00:00 PM,48,-122,33,208,241
30786,SpokaneStBridge,07/06/2017 06:00:00 PM,48,-122,22,103,125
30787,SpokaneStBridge,07/06/2017 07:00:00 PM,48,-122,30,53,83
30788,SpokaneStBridge,07/06/2017 08:00:00 PM,48,-122,16,29,45
30789,SpokaneStBridge,07/06/2017 09:00:00 PM,48,-122,7,26,33
30790,SpokaneStBridge,07/06/2017 10:00:00 PM,48,-122,2,12,14
30791,SpokaneStBridge,07/06/2017 11:00:00 PM,48,-122,4,8,12
30792,SpokaneStBridge,07/07/2017 12:00:00 AM,48,-122,2,4,6
30793,SpokaneStBridge,07/07/2017 01:00:00 AM,48,-122,1,1,2
30794,SpokaneStBridge,07/07/2017 02:00:00 AM,48,-122,1,0,1
30795,SpokaneStBridge,07/07/2017 03:00:00 AM,48,-122,2,0,2
30796,SpokaneStBridge,07/07/2017 04:00:00 AM,48,-122,4,3,7
30797,SpokaneStBridge,07/07/2017 05:00:00 AM,48,-122,16,6,22
30798,SpokaneStBridge,07/07/2017 06:00:00 AM,48,-122,66,14,80
30799,SpokaneStBridge,07/07/2017 07:00:00 AM,48,-122,148,13,161
30800,SpokaneStBridge,07/07/2017 08:00:00 AM,48,-122,123,15,138
30801,SpokaneStBridge,07/07/2017 09:00:00 AM,48,-122,51,8,59
30802,SpokaneStBridge,07/07/2017 10:00:00 AM,48,-122,20,8,28
30803,SpokaneStBridge,07/07/2017 11:00:00 AM,48,-122,21,11,32
30804,SpokaneStBridge,07/07/2017 12:00:00 PM,48,-122,9,15,24
30805,SpokaneStBridge,07/07/2017 01:00:00 PM,48,-122,17,32,49
30806,SpokaneStBridge,07/07/2017 02:00:00 PM,48,-122,18,34,52
30807,SpokaneStBridge,07/07/2017 03:00:00 PM,48,-122,26,44,70
30808,SpokaneStBridge,07/07/2017 04:00:00 PM,48,-122,24,122,146
30809,SpokaneStBridge,07/07/2017 05:00:00 PM,48,-122,29,128,157
30810,SpokaneStBridge,07/07/2017 06:00:00 PM,48,-122,18,88,106
30811,SpokaneStBridge,07/07/2017 07:00:00 PM,48,-122,17,43,60
30812,SpokaneStBridge,07/07/2017 08:00:00 PM,48,-122,8,17,25
30813,SpokaneStBridge,07/07/2017 09:00:00 PM,48,-122,6,14,20
30814,SpokaneStBridge,07/07/2017 10:00:00 PM,48,-122,6,13,19
30815,SpokaneStBridge,07/07/2017 11:00:00 PM,48,-122,6,4,10
30816,SpokaneStBridge,07/08/2017 12:00:00 AM,48,-122,0,3,3
30817,SpokaneStBridge,07/08/2017 01:00:00 AM,48,-122,0,1,1
30818,SpokaneStBridge,07/08/2017 02:00:00 AM,48,-122,0,0,0
30819,SpokaneStBridge,07/08/2017 03:00:00 AM,48,-122,0,0,0
30820,SpokaneStBridge,07/08/2017 04:00:00 AM,48,-122,0,1,1
30821,SpokaneStBridge,07/08/2017 05:00:00 AM,48,-122,3,1,4
30822,SpokaneStBridge,07/08/2017 06:00:00 AM,48,-122,15,5,20
30823,SpokaneStBridge,07/08/2017 07:00:00 AM,48,-122,29,5,34
30824,SpokaneStBridge,07/08/2017 08:00:00 AM,48,-122,21,15,36
30825,SpokaneStBridge,07/08/2017 09:00:00 AM,48,-122,28,31,59
30826,SpokaneStBridge,07/08/2017 10:00:00 AM,48,-122,30,32,62
30827,SpokaneStBridge,07/08/2017 11:00:00 AM,48,-122,49,51,100
30828,SpokaneStBridge,07/08/2017 12:00:00 PM,48,-122,39,45,84
30829,SpokaneStBridge,07/08/2017 01:00:00 PM,48,-122,43,52,95
30830,SpokaneStBridge,07/08/2017 02:00:00 PM,48,-122,49,54,103
30831,SpokaneStBridge,07/08/2017 03:00:00 PM,48,-122,39,37,76
30832,SpokaneStBridge,07/08/2017 04:00:00 PM,48,-122,26,41,67
30833,SpokaneStBridge,07/08/2017 05:00:00 PM,48,-122,37,49,86
30834,SpokaneStBridge,07/08/2017 06:00:00 PM,48,-122,25,20,45
30835,SpokaneStBridge,07/08/2017 07:00:00 PM,48,-122,13,30,43
30836,SpokaneStBridge,07/08/2017 08:00:00 PM,48,-122,14,13,27
30837,SpokaneStBridge,07/08/2017 09:00:00 PM,48,-122,10,16,26
30838,SpokaneStBridge,07/08/2017 10:00:00 PM,48,-122,4,14,18
30839,SpokaneStBridge,07/08/2017 11:00:00 PM,48,-122,8,2,10
30840,SpokaneStBridge,07/09/2017 12:00:00 AM,48,-122,6,2,8
30841,SpokaneStBridge,07/09/2017 01:00:00 AM,48,-122,2,2,4
30842,SpokaneStBridge,07/09/2017 02:00:00 AM,48,-122,2,1,3
30843,SpokaneStBridge,07/09/2017 03:00:00 AM,48,-122,3,0,3
30844,SpokaneStBridge,07/09/2017 04:00:00 AM,48,-122,1,1,2
30845,SpokaneStBridge,07/09/2017 05:00:00 AM,48,-122,5,1,6
30846,SpokaneStBridge,07/09/2017 06:00:00 AM,48,-122,4,7,11
30847,SpokaneStBridge,07/09/2017 07:00:00 AM,48,-122,21,6,27
30848,SpokaneStBridge,07/09/2017 08:00:00 AM,48,-122,37,22,59
30849,SpokaneStBridge,07/09/2017 09:00:00 AM,48,-122,33,24,57
30850,SpokaneStBridge,07/09/2017 10:00:00 AM,48,-122,28,38,66
30851,SpokaneStBridge,07/09/2017 11:00:00 AM,48,-122,26,64,90
30852,SpokaneStBridge,07/09/2017 12:00:00 PM,48,-122,43,49,92
30853,SpokaneStBridge,07/09/2017 01:00:00 PM,48,-122,55,45,100
30854,SpokaneStBridge,07/09/2017 02:00:00 PM,48,-122,37,24,61
30855,SpokaneStBridge,07/09/2017 03:00:00 PM,48,-122,34,49,83
30856,SpokaneStBridge,07/09/2017 04:00:00 PM,48,-122,37,31,68
30857,SpokaneStBridge,07/09/2017 05:00:00 PM,48,-122,37,35,72
30858,SpokaneStBridge,07/09/2017 06:00:00 PM,48,-122,22,25,47
30859,SpokaneStBridge,07/09/2017 07:00:00 PM,48,-122,15,12,27
30860,SpokaneStBridge,07/09/2017 08:00:00 PM,48,-122,15,12,27
30861,SpokaneStBridge,07/09/2017 09:00:00 PM,48,-122,12,8,20
30862,SpokaneStBridge,07/09/2017 10:00:00 PM,48,-122,3,9,12
30863,SpokaneStBridge,07/09/2017 11:00:00 PM,48,-122,0,1,1
30864,SpokaneStBridge,07/10/2017 12:00:00 AM,48,-122,6,5,11
30865,SpokaneStBridge,07/10/2017 01:00:00 AM,48,-122,3,1,4
30866,SpokaneStBridge,07/10/2017 02:00:00 AM,48,-122,1,3,4
30867,SpokaneStBridge,07/10/2017 03:00:00 AM,48,-122,0,2,2
30868,SpokaneStBridge,07/10/2017 04:00:00 AM,48,-122,7,2,9
30869,SpokaneStBridge,07/10/2017 05:00:00 AM,48,-122,15,4,19
30870,SpokaneStBridge,07/10/2017 06:00:00 AM,48,-122,79,11,90
30871,SpokaneStBridge,07/10/2017 07:00:00 AM,48,-122,154,21,175
30872,SpokaneStBridge,07/10/2017 08:00:00 AM,48,-122,161,15,176
30873,SpokaneStBridge,07/10/2017 09:00:00 AM,48,-122,49,15,64
30874,SpokaneStBridge,07/10/2017 10:00:00 AM,48,-122,23,8,31
30875,SpokaneStBridge,07/10/2017 11:00:00 AM,48,-122,16,18,34
30876,SpokaneStBridge,07/10/2017 12:00:00 PM,48,-122,21,11,32
30877,SpokaneStBridge,07/10/2017 01:00:00 PM,48,-122,12,16,28
30878,SpokaneStBridge,07/10/2017 02:00:00 PM,48,-122,24,21,45
30879,SpokaneStBridge,07/10/2017 03:00:00 PM,48,-122,15,42,57
30880,SpokaneStBridge,07/10/2017 04:00:00 PM,48,-122,22,101,123
30881,SpokaneStBridge,07/10/2017 05:00:00 PM,48,-122,35,222,257
30882,SpokaneStBridge,07/10/2017 06:00:00 PM,48,-122,20,111,131
30883,SpokaneStBridge,07/10/2017 07:00:00 PM,48,-122,16,37,53
30884,SpokaneStBridge,07/10/2017 08:00:00 PM,48,-122,15,25,40
30885,SpokaneStBridge,07/10/2017 09:00:00 PM,48,-122,5,16,21
30886,SpokaneStBridge,07/10/2017 10:00:00 PM,48,-122,1,2,3
30887,SpokaneStBridge,07/10/2017 11:00:00 PM,48,-122,0,2,2
30888,SpokaneStBridge,07/11/2017 12:00:00 AM,48,-122,2,1,3
30889,SpokaneStBridge,07/11/2017 01:00:00 AM,48,-122,2,0,2
30890,SpokaneStBridge,07/11/2017 02:00:00 AM,48,-122,0,0,0
30891,SpokaneStBridge,07/11/2017 03:00:00 AM,48,-122,0,1,1
30892,SpokaneStBridge,07/11/2017 04:00:00 AM,48,-122,8,4,12
30893,SpokaneStBridge,07/11/2017 05:00:00 AM,48,-122,29,7,36
30894,SpokaneStBridge,07/11/2017 06:00:00 AM,48,-122,78,18,96
30895,SpokaneStBridge,07/11/2017 07:00:00 AM,48,-122,177,16,193
30896,SpokaneStBridge,07/11/2017 08:00:00 AM,48,-122,167,15,182
30897,SpokaneStBridge,07/11/2017 09:00:00 AM,48,-122,54,13,67
30898,SpokaneStBridge,07/11/2017 10:00:00 AM,48,-122,21,6,27
30899,SpokaneStBridge,07/11/2017 11:00:00 AM,48,-122,16,16,32
30900,SpokaneStBridge,07/11/2017 12:00:00 PM,48,-122,12,10,22
30901,SpokaneStBridge,07/11/2017 01:00:00 PM,48,-122,19,18,37
30902,SpokaneStBridge,07/11/2017 02:00:00 PM,48,-122,10,23,33
30903,SpokaneStBridge,07/11/2017 03:00:00 PM,48,-122,17,51,68
30904,SpokaneStBridge,07/11/2017 04:00:00 PM,48,-122,21,101,122
30905,SpokaneStBridge,07/11/2017 05:00:00 PM,48,-122,28,196,224
30906,SpokaneStBridge,07/11/2017 06:00:00 PM,48,-122,29,132,161
30907,SpokaneStBridge,07/11/2017 07:00:00 PM,48,-122,13,49,62
30908,SpokaneStBridge,07/11/2017 08:00:00 PM,48,-122,15,34,49
30909,SpokaneStBridge,07/11/2017 09:00:00 PM,48,-122,10,12,22
30910,SpokaneStBridge,07/11/2017 10:00:00 PM,48,-122,3,6,9
30911,SpokaneStBridge,07/11/2017 11:00:00 PM,48,-122,2,9,11
30912,SpokaneStBridge,07/12/2017 12:00:00 AM,48,-122,1,0,1
30913,SpokaneStBridge,07/12/2017 01:00:00 AM,48,-122,1,0,1
30914,SpokaneStBridge,07/12/2017 02:00:00 AM,48,-122,1,0,1
30915,SpokaneStBridge,07/12/2017 03:00:00 AM,48,-122,0,0,0
30916,SpokaneStBridge,07/12/2017 04:00:00 AM,48,-122,4,2,6
30917,SpokaneStBridge,07/12/2017 05:00:00 AM,48,-122,12,4,16
30918,SpokaneStBridge,07/12/2017 06:00:00 AM,48,-122,95,11,106
30919,SpokaneStBridge,07/12/2017 07:00:00 AM,48,-122,184,21,205
30920,SpokaneStBridge,07/12/2017 08:00:00 AM,48,-122,158,11,169
30921,SpokaneStBridge,07/12/2017 09:00:00 AM,48,-122,68,8,76
30922,SpokaneStBridge,07/12/2017 10:00:00 AM,48,-122,32,4,36
30923,SpokaneStBridge,07/12/2017 11:00:00 AM,48,-122,16,13,29
30924,SpokaneStBridge,07/12/2017 12:00:00 PM,48,-122,16,20,36
30925,SpokaneStBridge,07/12/2017 01:00:00 PM,48,-122,20,16,36
30926,SpokaneStBridge,07/12/2017 02:00:00 PM,48,-122,17,25,42
30927,SpokaneStBridge,07/12/2017 03:00:00 PM,48,-122,20,49,69
30928,SpokaneStBridge,07/12/2017 04:00:00 PM,48,-122,18,114,132
30929,SpokaneStBridge,07/12/2017 05:00:00 PM,48,-122,34,195,229
30930,SpokaneStBridge,07/12/2017 06:00:00 PM,48,-122,22,129,151
30931,SpokaneStBridge,07/12/2017 07:00:00 PM,48,-122,19,47,66
30932,SpokaneStBridge,07/12/2017 08:00:00 PM,48,-122,21,32,53
30933,SpokaneStBridge,07/12/2017 09:00:00 PM,48,-122,11,20,31
30934,SpokaneStBridge,07/12/2017 10:00:00 PM,48,-122,6,3,9
30935,SpokaneStBridge,07/12/2017 11:00:00 PM,48,-122,3,3,6
30936,SpokaneStBridge,07/13/2017 12:00:00 AM,48,-122,1,4,5
30937,SpokaneStBridge,07/13/2017 01:00:00 AM,48,-122,0,5,5
30938,SpokaneStBridge,07/13/2017 02:00:00 AM,48,-122,0,2,2
30939,SpokaneStBridge,07/13/2017 03:00:00 AM,48,-122,3,0,3
30940,SpokaneStBridge,07/13/2017 04:00:00 AM,48,-122,6,4,10
30941,SpokaneStBridge,07/13/2017 05:00:00 AM,48,-122,29,4,33
30942,SpokaneStBridge,07/13/2017 06:00:00 AM,48,-122,69,14,83
30943,SpokaneStBridge,07/13/2017 07:00:00 AM,48,-122,164,13,177
30944,SpokaneStBridge,07/13/2017 08:00:00 AM,48,-122,145,10,155
30945,SpokaneStBridge,07/13/2017 09:00:00 AM,48,-122,45,13,58
30946,SpokaneStBridge,07/13/2017 10:00:00 AM,48,-122,34,6,40
30947,SpokaneStBridge,07/13/2017 11:00:00 AM,48,-122,17,4,21
30948,SpokaneStBridge,07/13/2017 12:00:00 PM,48,-122,15,10,25
30949,SpokaneStBridge,07/13/2017 01:00:00 PM,48,-122,21,11,32
30950,SpokaneStBridge,07/13/2017 02:00:00 PM,48,-122,14,35,49
30951,SpokaneStBridge,07/13/2017 03:00:00 PM,48,-122,14,43,57
30952,SpokaneStBridge,07/13/2017 04:00:00 PM,48,-122,16,98,114
30953,SpokaneStBridge,07/13/2017 05:00:00 PM,48,-122,18,162,180
30954,SpokaneStBridge,07/13/2017 06:00:00 PM,48,-122,19,116,135
30955,SpokaneStBridge,07/13/2017 07:00:00 PM,48,-122,17,59,76
30956,SpokaneStBridge,07/13/2017 08:00:00 PM,48,-122,12,24,36
30957,SpokaneStBridge,07/13/2017 09:00:00 PM,48,-122,9,14,23
30958,SpokaneStBridge,07/13/2017 10:00:00 PM,48,-122,1,7,8
30959,SpokaneStBridge,07/13/2017 11:00:00 PM,48,-122,1,3,4
30960,SpokaneStBridge,07/14/2017 12:00:00 AM,48,-122,1,2,3
30961,SpokaneStBridge,07/14/2017 01:00:00 AM,48,-122,1,3,4
30962,SpokaneStBridge,07/14/2017 02:00:00 AM,48,-122,1,4,5
30963,SpokaneStBridge,07/14/2017 03:00:00 AM,48,-122,1,1,2
30964,SpokaneStBridge,07/14/2017 04:00:00 AM,48,-122,2,2,4
30965,SpokaneStBridge,07/14/2017 05:00:00 AM,48,-122,22,5,27
30966,SpokaneStBridge,07/14/2017 06:00:00 AM,48,-122,56,7,63
30967,SpokaneStBridge,07/14/2017 07:00:00 AM,48,-122,126,13,139
30968,SpokaneStBridge,07/14/2017 08:00:00 AM,48,-122,107,26,133
30969,SpokaneStBridge,07/14/2017 09:00:00 AM,48,-122,53,6,59
30970,SpokaneStBridge,07/14/2017 10:00:00 AM,48,-122,25,18,43
30971,SpokaneStBridge,07/14/2017 11:00:00 AM,48,-122,22,11,33
30972,SpokaneStBridge,07/14/2017 12:00:00 PM,48,-122,17,18,35
30973,SpokaneStBridge,07/14/2017 01:00:00 PM,48,-122,15,30,45
30974,SpokaneStBridge,07/14/2017 02:00:00 PM,48,-122,23,36,59
30975,SpokaneStBridge,07/14/2017 03:00:00 PM,48,-122,21,50,71
30976,SpokaneStBridge,07/14/2017 04:00:00 PM,48,-122,21,106,127
30977,SpokaneStBridge,07/14/2017 05:00:00 PM,48,-122,22,133,155
30978,SpokaneStBridge,07/14/2017 06:00:00 PM,48,-122,22,85,107
30979,SpokaneStBridge,07/14/2017 07:00:00 PM,48,-122,8,33,41
30980,SpokaneStBridge,07/14/2017 08:00:00 PM,48,-122,7,14,21
30981,SpokaneStBridge,07/14/2017 09:00:00 PM,48,-122,9,9,18
30982,SpokaneStBridge,07/14/2017 10:00:00 PM,48,-122,2,6,8
30983,SpokaneStBridge,07/14/2017 11:00:00 PM,48,-122,5,4,9
30984,SpokaneStBridge,07/15/2017 12:00:00 AM,48,-122,1,1,2
30985,SpokaneStBridge,07/15/2017 01:00:00 AM,48,-122,0,1,1
30986,SpokaneStBridge,07/15/2017 02:00:00 AM,48,-122,2,0,2
30987,SpokaneStBridge,07/15/2017 03:00:00 AM,48,-122,2,1,3
30988,SpokaneStBridge,07/15/2017 04:00:00 AM,48,-122,3,1,4
30989,SpokaneStBridge,07/15/2017 05:00:00 AM,48,-122,7,1,8
30990,SpokaneStBridge,07/15/2017 06:00:00 AM,48,-122,12,6,18
30991,SpokaneStBridge,07/15/2017 07:00:00 AM,48,-122,11,12,23
30992,SpokaneStBridge,07/15/2017 08:00:00 AM,48,-122,21,23,44
30993,SpokaneStBridge,07/15/2017 09:00:00 AM,48,-122,25,24,49
30994,SpokaneStBridge,07/15/2017 10:00:00 AM,48,-122,21,16,37
30995,SpokaneStBridge,07/15/2017 11:00:00 AM,48,-122,29,42,71
30996,SpokaneStBridge,07/15/2017 12:00:00 PM,48,-122,45,37,82
30997,SpokaneStBridge,07/15/2017 01:00:00 PM,48,-122,39,39,78
30998,SpokaneStBridge,07/15/2017 02:00:00 PM,48,-122,42,33,75
30999,SpokaneStBridge,07/15/2017 03:00:00 PM,48,-122,34,41,75
31000,SpokaneStBridge,07/15/2017 04:00:00 PM,48,-122,37,37,74
31001,SpokaneStBridge,07/15/2017 05:00:00 PM,48,-122,18,31,49
31002,SpokaneStBridge,07/15/2017 06:00:00 PM,48,-122,19,22,41
31003,SpokaneStBridge,07/15/2017 07:00:00 PM,48,-122,21,24,45
31004,SpokaneStBridge,07/15/2017 08:00:00 PM,48,-122,21,12,33
31005,SpokaneStBridge,07/15/2017 09:00:00 PM,48,-122,3,4,7
31006,SpokaneStBridge,07/15/2017 10:00:00 PM,48,-122,5,7,12
31007,SpokaneStBridge,07/15/2017 11:00:00 PM,48,-122,5,3,8
31008,SpokaneStBridge,07/16/2017 12:00:00 AM,48,-122,6,2,8
31009,SpokaneStBridge,07/16/2017 01:00:00 AM,48,-122,1,2,3
31010,SpokaneStBridge,07/16/2017 02:00:00 AM,48,-122,0,1,1
31011,SpokaneStBridge,07/16/2017 03:00:00 AM,48,-122,2,3,5
31012,SpokaneStBridge,07/16/2017 04:00:00 AM,48,-122,0,1,1
31013,SpokaneStBridge,07/16/2017 05:00:00 AM,48,-122,5,0,5
31014,SpokaneStBridge,07/16/2017 06:00:00 AM,48,-122,7,0,7
31015,SpokaneStBridge,07/16/2017 07:00:00 AM,48,-122,12,8,20
31016,SpokaneStBridge,07/16/2017 08:00:00 AM,48,-122,15,11,26
31017,SpokaneStBridge,07/16/2017 09:00:00 AM,48,-122,20,16,36
31018,SpokaneStBridge,07/16/2017 10:00:00 AM,48,-122,22,26,48
31019,SpokaneStBridge,07/16/2017 11:00:00 AM,48,-122,34,25,59
31020,SpokaneStBridge,07/16/2017 12:00:00 PM,48,-122,25,56,81
31021,SpokaneStBridge,07/16/2017 01:00:00 PM,48,-122,58,25,83
31022,SpokaneStBridge,07/16/2017 02:00:00 PM,48,-122,26,40,66
31023,SpokaneStBridge,07/16/2017 03:00:00 PM,48,-122,27,26,53
31024,SpokaneStBridge,07/16/2017 04:00:00 PM,48,-122,35,34,69
31025,SpokaneStBridge,07/16/2017 05:00:00 PM,48,-122,18,25,43
31026,SpokaneStBridge,07/16/2017 06:00:00 PM,48,-122,13,22,35
31027,SpokaneStBridge,07/16/2017 07:00:00 PM,48,-122,13,15,28
31028,SpokaneStBridge,07/16/2017 08:00:00 PM,48,-122,12,13,25
31029,SpokaneStBridge,07/16/2017 09:00:00 PM,48,-122,8,5,13
31030,SpokaneStBridge,07/16/2017 10:00:00 PM,48,-122,0,2,2
31031,SpokaneStBridge,07/16/2017 11:00:00 PM,48,-122,1,2,3
31032,SpokaneStBridge,07/17/2017 12:00:00 AM,48,-122,0,0,0
31033,SpokaneStBridge,07/17/2017 01:00:00 AM,48,-122,0,0,0
31034,SpokaneStBridge,07/17/2017 02:00:00 AM,48,-122,1,1,2
31035,SpokaneStBridge,07/17/2017 03:00:00 AM,48,-122,3,2,5
31036,SpokaneStBridge,07/17/2017 04:00:00 AM,48,-122,3,1,4
31037,SpokaneStBridge,07/17/2017 05:00:00 AM,48,-122,22,10,32
31038,SpokaneStBridge,07/17/2017 06:00:00 AM,48,-122,74,14,88
31039,SpokaneStBridge,07/17/2017 07:00:00 AM,48,-122,171,13,184
31040,SpokaneStBridge,07/17/2017 08:00:00 AM,48,-122,128,16,144
31041,SpokaneStBridge,07/17/2017 09:00:00 AM,48,-122,51,10,61
31042,SpokaneStBridge,07/17/2017 10:00:00 AM,48,-122,17,10,27
31043,SpokaneStBridge,07/17/2017 11:00:00 AM,48,-122,22,10,32
31044,SpokaneStBridge,07/17/2017 12:00:00 PM,48,-122,19,18,37
31045,SpokaneStBridge,07/17/2017 01:00:00 PM,48,-122,10,11,21
31046,SpokaneStBridge,07/17/2017 02:00:00 PM,48,-122,11,10,21
31047,SpokaneStBridge,07/17/2017 03:00:00 PM,48,-122,27,36,63
31048,SpokaneStBridge,07/17/2017 04:00:00 PM,48,-122,32,103,135
31049,SpokaneStBridge,07/17/2017 05:00:00 PM,48,-122,15,171,186
31050,SpokaneStBridge,07/17/2017 06:00:00 PM,48,-122,11,108,119
31051,SpokaneStBridge,07/17/2017 07:00:00 PM,48,-122,17,39,56
31052,SpokaneStBridge,07/17/2017 08:00:00 PM,48,-122,11,28,39
31053,SpokaneStBridge,07/17/2017 09:00:00 PM,48,-122,11,8,19
31054,SpokaneStBridge,07/17/2017 10:00:00 PM,48,-122,1,4,5
31055,SpokaneStBridge,07/17/2017 11:00:00 PM,48,-122,7,1,8
31056,SpokaneStBridge,07/18/2017 12:00:00 AM,48,-122,0,1,1
31057,SpokaneStBridge,07/18/2017 01:00:00 AM,48,-122,0,2,2
31058,SpokaneStBridge,07/18/2017 02:00:00 AM,48,-122,0,2,2
31059,SpokaneStBridge,07/18/2017 03:00:00 AM,48,-122,4,5,9
31060,SpokaneStBridge,07/18/2017 04:00:00 AM,48,-122,6,4,10
31061,SpokaneStBridge,07/18/2017 05:00:00 AM,48,-122,26,2,28
31062,SpokaneStBridge,07/18/2017 06:00:00 AM,48,-122,73,11,84
31063,SpokaneStBridge,07/18/2017 07:00:00 AM,48,-122,167,25,192
31064,SpokaneStBridge,07/18/2017 08:00:00 AM,48,-122,166,17,183
31065,SpokaneStBridge,07/18/2017 09:00:00 AM,48,-122,69,13,82
31066,SpokaneStBridge,07/18/2017 10:00:00 AM,48,-122,24,15,39
31067,SpokaneStBridge,07/18/2017 11:00:00 AM,48,-122,15,11,26
31068,SpokaneStBridge,07/18/2017 12:00:00 PM,48,-122,15,11,26
31069,SpokaneStBridge,07/18/2017 01:00:00 PM,48,-122,19,28,47
31070,SpokaneStBridge,07/18/2017 02:00:00 PM,48,-122,13,14,27
31071,SpokaneStBridge,07/18/2017 03:00:00 PM,48,-122,19,69,88
31072,SpokaneStBridge,07/18/2017 04:00:00 PM,48,-122,16,127,143
31073,SpokaneStBridge,07/18/2017 05:00:00 PM,48,-122,35,207,242
31074,SpokaneStBridge,07/18/2017 06:00:00 PM,48,-122,32,121,153
31075,SpokaneStBridge,07/18/2017 07:00:00 PM,48,-122,12,53,65
31076,SpokaneStBridge,07/18/2017 08:00:00 PM,48,-122,12,31,43
31077,SpokaneStBridge,07/18/2017 09:00:00 PM,48,-122,10,16,26
31078,SpokaneStBridge,07/18/2017 10:00:00 PM,48,-122,9,13,22
31079,SpokaneStBridge,07/18/2017 11:00:00 PM,48,-122,2,4,6
31080,SpokaneStBridge,07/19/2017 12:00:00 AM,48,-122,0,3,3
31081,SpokaneStBridge,07/19/2017 01:00:00 AM,48,-122,0,0,0
31082,SpokaneStBridge,07/19/2017 02:00:00 AM,48,-122,1,1,2
31083,SpokaneStBridge,07/19/2017 03:00:00 AM,48,-122,0,1,1
31084,SpokaneStBridge,07/19/2017 04:00:00 AM,48,-122,8,4,12
31085,SpokaneStBridge,07/19/2017 05:00:00 AM,48,-122,24,6,30
31086,SpokaneStBridge,07/19/2017 06:00:00 AM,48,-122,76,11,87
31087,SpokaneStBridge,07/19/2017 07:00:00 AM,48,-122,156,13,169
31088,SpokaneStBridge,07/19/2017 08:00:00 AM,48,-122,140,16,156
31089,SpokaneStBridge,07/19/2017 09:00:00 AM,48,-122,61,4,65
31090,SpokaneStBridge,07/19/2017 10:00:00 AM,48,-122,23,9,32
31091,SpokaneStBridge,07/19/2017 11:00:00 AM,48,-122,13,11,24
31092,SpokaneStBridge,07/19/2017 12:00:00 PM,48,-122,17,10,27
31093,SpokaneStBridge,07/19/2017 01:00:00 PM,48,-122,16,17,33
31094,SpokaneStBridge,07/19/2017 02:00:00 PM,48,-122,12,21,33
31095,SpokaneStBridge,07/19/2017 03:00:00 PM,48,-122,21,62,83
31096,SpokaneStBridge,07/19/2017 04:00:00 PM,48,-122,20,109,129
31097,SpokaneStBridge,07/19/2017 05:00:00 PM,48,-122,31,177,208
31098,SpokaneStBridge,07/19/2017 06:00:00 PM,48,-122,26,104,130
31099,SpokaneStBridge,07/19/2017 07:00:00 PM,48,-122,12,57,69
31100,SpokaneStBridge,07/19/2017 08:00:00 PM,48,-122,15,28,43
31101,SpokaneStBridge,07/19/2017 09:00:00 PM,48,-122,11,9,20
31102,SpokaneStBridge,07/19/2017 10:00:00 PM,48,-122,4,10,14
31103,SpokaneStBridge,07/19/2017 11:00:00 PM,48,-122,4,5,9
31104,SpokaneStBridge,07/20/2017 12:00:00 AM,48,-122,2,1,3
31105,SpokaneStBridge,07/20/2017 01:00:00 AM,48,-122,1,2,3
31106,SpokaneStBridge,07/20/2017 02:00:00 AM,48,-122,0,0,0
31107,SpokaneStBridge,07/20/2017 03:00:00 AM,48,-122,1,0,1
31108,SpokaneStBridge,07/20/2017 04:00:00 AM,48,-122,4,3,7
31109,SpokaneStBridge,07/20/2017 05:00:00 AM,48,-122,27,6,33
31110,SpokaneStBridge,07/20/2017 06:00:00 AM,48,-122,61,12,73
31111,SpokaneStBridge,07/20/2017 07:00:00 AM,48,-122,150,14,164
31112,SpokaneStBridge,07/20/2017 08:00:00 AM,48,-122,139,14,153
31113,SpokaneStBridge,07/20/2017 09:00:00 AM,48,-122,51,9,60
31114,SpokaneStBridge,07/20/2017 10:00:00 AM,48,-122,13,4,17
31115,SpokaneStBridge,07/20/2017 11:00:00 AM,48,-122,14,8,22
31116,SpokaneStBridge,07/20/2017 12:00:00 PM,48,-122,21,9,30
31117,SpokaneStBridge,07/20/2017 01:00:00 PM,48,-122,19,13,32
31118,SpokaneStBridge,07/20/2017 02:00:00 PM,48,-122,21,26,47
31119,SpokaneStBridge,07/20/2017 03:00:00 PM,48,-122,12,36,48
31120,SpokaneStBridge,07/20/2017 04:00:00 PM,48,-122,23,92,115
31121,SpokaneStBridge,07/20/2017 05:00:00 PM,48,-122,28,164,192
31122,SpokaneStBridge,07/20/2017 06:00:00 PM,48,-122,17,92,109
31123,SpokaneStBridge,07/20/2017 07:00:00 PM,48,-122,11,54,65
31124,SpokaneStBridge,07/20/2017 08:00:00 PM,48,-122,4,23,27
31125,SpokaneStBridge,07/20/2017 09:00:00 PM,48,-122,5,16,21
31126,SpokaneStBridge,07/20/2017 10:00:00 PM,48,-122,6,19,25
31127,SpokaneStBridge,07/20/2017 11:00:00 PM,48,-122,2,10,12
31128,SpokaneStBridge,07/21/2017 12:00:00 AM,48,-122,3,0,3
31129,SpokaneStBridge,07/21/2017 01:00:00 AM,48,-122,0,3,3
31130,SpokaneStBridge,07/21/2017 02:00:00 AM,48,-122,1,2,3
31131,SpokaneStBridge,07/21/2017 03:00:00 AM,48,-122,0,0,0
31132,SpokaneStBridge,07/21/2017 04:00:00 AM,48,-122,4,3,7
31133,SpokaneStBridge,07/21/2017 05:00:00 AM,48,-122,21,7,28
31134,SpokaneStBridge,07/21/2017 06:00:00 AM,48,-122,47,13,60
31135,SpokaneStBridge,07/21/2017 07:00:00 AM,48,-122,120,18,138
31136,SpokaneStBridge,07/21/2017 08:00:00 AM,48,-122,97,11,108
31137,SpokaneStBridge,07/21/2017 09:00:00 AM,48,-122,54,18,72
31138,SpokaneStBridge,07/21/2017 10:00:00 AM,48,-122,28,17,45
31139,SpokaneStBridge,07/21/2017 11:00:00 AM,48,-122,12,24,36
31140,SpokaneStBridge,07/21/2017 12:00:00 PM,48,-122,28,16,44
31141,SpokaneStBridge,07/21/2017 01:00:00 PM,48,-122,20,15,35
31142,SpokaneStBridge,07/21/2017 02:00:00 PM,48,-122,26,30,56
31143,SpokaneStBridge,07/21/2017 03:00:00 PM,48,-122,29,57,86
31144,SpokaneStBridge,07/21/2017 04:00:00 PM,48,-122,19,87,106
31145,SpokaneStBridge,07/21/2017 05:00:00 PM,48,-122,21,130,151
31146,SpokaneStBridge,07/21/2017 06:00:00 PM,48,-122,19,81,100
31147,SpokaneStBridge,07/21/2017 07:00:00 PM,48,-122,7,37,44
31148,SpokaneStBridge,07/21/2017 08:00:00 PM,48,-122,19,18,37
31149,SpokaneStBridge,07/21/2017 09:00:00 PM,48,-122,3,15,18
31150,SpokaneStBridge,07/21/2017 10:00:00 PM,48,-122,4,6,10
31151,SpokaneStBridge,07/21/2017 11:00:00 PM,48,-122,9,7,16
31152,SpokaneStBridge,07/22/2017 12:00:00 AM,48,-122,4,4,8
31153,SpokaneStBridge,07/22/2017 01:00:00 AM,48,-122,1,4,5
31154,SpokaneStBridge,07/22/2017 02:00:00 AM,48,-122,0,4,4
31155,SpokaneStBridge,07/22/2017 03:00:00 AM,48,-122,1,4,5
31156,SpokaneStBridge,07/22/2017 04:00:00 AM,48,-122,0,3,3
31157,SpokaneStBridge,07/22/2017 05:00:00 AM,48,-122,5,3,8
31158,SpokaneStBridge,07/22/2017 06:00:00 AM,48,-122,15,10,25
31159,SpokaneStBridge,07/22/2017 07:00:00 AM,48,-122,28,12,40
31160,SpokaneStBridge,07/22/2017 08:00:00 AM,48,-122,19,18,37
31161,SpokaneStBridge,07/22/2017 09:00:00 AM,48,-122,25,22,47
31162,SpokaneStBridge,07/22/2017 10:00:00 AM,48,-122,26,43,69
31163,SpokaneStBridge,07/22/2017 11:00:00 AM,48,-122,14,23,37
31164,SpokaneStBridge,07/22/2017 12:00:00 PM,48,-122,53,43,96
31165,SpokaneStBridge,07/22/2017 01:00:00 PM,48,-122,34,29,63
31166,SpokaneStBridge,07/22/2017 02:00:00 PM,48,-122,32,34,66
31167,SpokaneStBridge,07/22/2017 03:00:00 PM,48,-122,29,26,55
31168,SpokaneStBridge,07/22/2017 04:00:00 PM,48,-122,26,25,51
31169,SpokaneStBridge,07/22/2017 05:00:00 PM,48,-122,11,26,37
31170,SpokaneStBridge,07/22/2017 06:00:00 PM,48,-122,29,25,54
31171,SpokaneStBridge,07/22/2017 07:00:00 PM,48,-122,14,15,29
31172,SpokaneStBridge,07/22/2017 08:00:00 PM,48,-122,14,8,22
31173,SpokaneStBridge,07/22/2017 09:00:00 PM,48,-122,6,10,16
31174,SpokaneStBridge,07/22/2017 10:00:00 PM,48,-122,7,7,14
31175,SpokaneStBridge,07/22/2017 11:00:00 PM,48,-122,2,6,8
31176,SpokaneStBridge,07/23/2017 12:00:00 AM,48,-122,2,5,7
31177,SpokaneStBridge,07/23/2017 01:00:00 AM,48,-122,2,3,5
31178,SpokaneStBridge,07/23/2017 02:00:00 AM,48,-122,1,1,2
31179,SpokaneStBridge,07/23/2017 03:00:00 AM,48,-122,0,1,1
31180,SpokaneStBridge,07/23/2017 04:00:00 AM,48,-122,1,1,2
31181,SpokaneStBridge,07/23/2017 05:00:00 AM,48,-122,3,0,3
31182,SpokaneStBridge,07/23/2017 06:00:00 AM,48,-122,6,2,8
31183,SpokaneStBridge,07/23/2017 07:00:00 AM,48,-122,11,6,17
31184,SpokaneStBridge,07/23/2017 08:00:00 AM,48,-122,33,12,45
31185,SpokaneStBridge,07/23/2017 09:00:00 AM,48,-122,27,16,43
31186,SpokaneStBridge,07/23/2017 10:00:00 AM,48,-122,14,36,50
31187,SpokaneStBridge,07/23/2017 11:00:00 AM,48,-122,39,54,93
31188,SpokaneStBridge,07/23/2017 12:00:00 PM,48,-122,27,30,57
31189,SpokaneStBridge,07/23/2017 01:00:00 PM,48,-122,43,52,95
31190,SpokaneStBridge,07/23/2017 02:00:00 PM,48,-122,35,35,70
31191,SpokaneStBridge,07/23/2017 03:00:00 PM,48,-122,27,37,64
31192,SpokaneStBridge,07/23/2017 04:00:00 PM,48,-122,27,27,54
31193,SpokaneStBridge,07/23/2017 05:00:00 PM,48,-122,36,22,58
31194,SpokaneStBridge,07/23/2017 06:00:00 PM,48,-122,25,28,53
31195,SpokaneStBridge,07/23/2017 07:00:00 PM,48,-122,7,8,15
31196,SpokaneStBridge,07/23/2017 08:00:00 PM,48,-122,14,7,21
31197,SpokaneStBridge,07/23/2017 09:00:00 PM,48,-122,7,11,18
31198,SpokaneStBridge,07/23/2017 10:00:00 PM,48,-122,1,11,12
31199,SpokaneStBridge,07/23/2017 11:00:00 PM,48,-122,1,4,5
31200,SpokaneStBridge,07/24/2017 12:00:00 AM,48,-122,4,2,6
31201,SpokaneStBridge,07/24/2017 01:00:00 AM,48,-122,1,1,2
31202,SpokaneStBridge,07/24/2017 02:00:00 AM,48,-122,0,0,0
31203,SpokaneStBridge,07/24/2017 03:00:00 AM,48,-122,0,1,1
31204,SpokaneStBridge,07/24/2017 04:00:00 AM,48,-122,9,2,11
31205,SpokaneStBridge,07/24/2017 05:00:00 AM,48,-122,24,7,31
31206,SpokaneStBridge,07/24/2017 06:00:00 AM,48,-122,72,16,88
31207,SpokaneStBridge,07/24/2017 07:00:00 AM,48,-122,147,23,170
31208,SpokaneStBridge,07/24/2017 08:00:00 AM,48,-122,139,14,153
31209,SpokaneStBridge,07/24/2017 09:00:00 AM,48,-122,57,10,67
31210,SpokaneStBridge,07/24/2017 10:00:00 AM,48,-122,31,4,35
31211,SpokaneStBridge,07/24/2017 11:00:00 AM,48,-122,14,15,29
31212,SpokaneStBridge,07/24/2017 12:00:00 PM,48,-122,13,14,27
31213,SpokaneStBridge,07/24/2017 01:00:00 PM,48,-122,11,20,31
31214,SpokaneStBridge,07/24/2017 02:00:00 PM,48,-122,15,18,33
31215,SpokaneStBridge,07/24/2017 03:00:00 PM,48,-122,20,43,63
31216,SpokaneStBridge,07/24/2017 04:00:00 PM,48,-122,15,107,122
31217,SpokaneStBridge,07/24/2017 05:00:00 PM,48,-122,30,198,228
31218,SpokaneStBridge,07/24/2017 06:00:00 PM,48,-122,22,95,117
31219,SpokaneStBridge,07/24/2017 07:00:00 PM,48,-122,22,42,64
31220,SpokaneStBridge,07/24/2017 08:00:00 PM,48,-122,6,26,32
31221,SpokaneStBridge,07/24/2017 09:00:00 PM,48,-122,4,12,16
31222,SpokaneStBridge,07/24/2017 10:00:00 PM,48,-122,3,3,6
31223,SpokaneStBridge,07/24/2017 11:00:00 PM,48,-122,4,4,8
31224,SpokaneStBridge,07/25/2017 12:00:00 AM,48,-122,0,1,1
31225,SpokaneStBridge,07/25/2017 01:00:00 AM,48,-122,0,0,0
31226,SpokaneStBridge,07/25/2017 02:00:00 AM,48,-122,1,2,3
31227,SpokaneStBridge,07/25/2017 03:00:00 AM,48,-122,1,0,1
31228,SpokaneStBridge,07/25/2017 04:00:00 AM,48,-122,4,2,6
31229,SpokaneStBridge,07/25/2017 05:00:00 AM,48,-122,28,7,35
31230,SpokaneStBridge,07/25/2017 06:00:00 AM,48,-122,81,14,95
31231,SpokaneStBridge,07/25/2017 07:00:00 AM,48,-122,191,22,213
31232,SpokaneStBridge,07/25/2017 08:00:00 AM,48,-122,140,14,154
31233,SpokaneStBridge,07/25/2017 09:00:00 AM,48,-122,62,10,72
31234,SpokaneStBridge,07/25/2017 10:00:00 AM,48,-122,24,12,36
31235,SpokaneStBridge,07/25/2017 11:00:00 AM,48,-122,21,16,37
31236,SpokaneStBridge,07/25/2017 12:00:00 PM,48,-122,21,10,31
31237,SpokaneStBridge,07/25/2017 01:00:00 PM,48,-122,15,5,20
31238,SpokaneStBridge,07/25/2017 02:00:00 PM,48,-122,12,18,30
31239,SpokaneStBridge,07/25/2017 03:00:00 PM,48,-122,24,40,64
31240,SpokaneStBridge,07/25/2017 04:00:00 PM,48,-122,21,116,137
31241,SpokaneStBridge,07/25/2017 05:00:00 PM,48,-122,36,190,226
31242,SpokaneStBridge,07/25/2017 06:00:00 PM,48,-122,36,130,166
31243,SpokaneStBridge,07/25/2017 07:00:00 PM,48,-122,16,42,58
31244,SpokaneStBridge,07/25/2017 08:00:00 PM,48,-122,15,26,41
31245,SpokaneStBridge,07/25/2017 09:00:00 PM,48,-122,8,9,17
31246,SpokaneStBridge,07/25/2017 10:00:00 PM,48,-122,5,8,13
31247,SpokaneStBridge,07/25/2017 11:00:00 PM,48,-122,0,11,11
31248,SpokaneStBridge,07/26/2017 12:00:00 AM,48,-122,1,3,4
31249,SpokaneStBridge,07/26/2017 01:00:00 AM,48,-122,0,0,0
31250,SpokaneStBridge,07/26/2017 02:00:00 AM,48,-122,0,0,0
31251,SpokaneStBridge,07/26/2017 03:00:00 AM,48,-122,0,1,1
31252,SpokaneStBridge,07/26/2017 04:00:00 AM,48,-122,5,1,6
31253,SpokaneStBridge,07/26/2017 05:00:00 AM,48,-122,18,8,26
31254,SpokaneStBridge,07/26/2017 06:00:00 AM,48,-122,68,15,83
31255,SpokaneStBridge,07/26/2017 07:00:00 AM,48,-122,166,22,188
31256,SpokaneStBridge,07/26/2017 08:00:00 AM,48,-122,147,17,164
31257,SpokaneStBridge,07/26/2017 09:00:00 AM,48,-122,60,11,71
31258,SpokaneStBridge,07/26/2017 10:00:00 AM,48,-122,31,9,40
31259,SpokaneStBridge,07/26/2017 11:00:00 AM,48,-122,14,9,23
31260,SpokaneStBridge,07/26/2017 12:00:00 PM,48,-122,14,18,32
31261,SpokaneStBridge,07/26/2017 01:00:00 PM,48,-122,20,20,40
31262,SpokaneStBridge,07/26/2017 02:00:00 PM,48,-122,12,30,42
31263,SpokaneStBridge,07/26/2017 03:00:00 PM,48,-122,17,33,50
31264,SpokaneStBridge,07/26/2017 04:00:00 PM,48,-122,20,98,118
31265,SpokaneStBridge,07/26/2017 05:00:00 PM,48,-122,23,198,221
31266,SpokaneStBridge,07/26/2017 06:00:00 PM,48,-122,25,127,152
31267,SpokaneStBridge,07/26/2017 07:00:00 PM,48,-122,9,42,51
31268,SpokaneStBridge,07/26/2017 08:00:00 PM,48,-122,16,20,36
31269,SpokaneStBridge,07/26/2017 09:00:00 PM,48,-122,4,9,13
31270,SpokaneStBridge,07/26/2017 10:00:00 PM,48,-122,3,5,8
31271,SpokaneStBridge,07/26/2017 11:00:00 PM,48,-122,3,5,8
31272,SpokaneStBridge,07/27/2017 12:00:00 AM,48,-122,2,2,4
31273,SpokaneStBridge,07/27/2017 01:00:00 AM,48,-122,0,1,1
31274,SpokaneStBridge,07/27/2017 02:00:00 AM,48,-122,0,1,1
31275,SpokaneStBridge,07/27/2017 03:00:00 AM,48,-122,0,1,1
31276,SpokaneStBridge,07/27/2017 04:00:00 AM,48,-122,3,2,5
31277,SpokaneStBridge,07/27/2017 05:00:00 AM,48,-122,28,9,37
31278,SpokaneStBridge,07/27/2017 06:00:00 AM,48,-122,66,11,77
31279,SpokaneStBridge,07/27/2017 07:00:00 AM,48,-122,142,10,152
31280,SpokaneStBridge,07/27/2017 08:00:00 AM,48,-122,131,17,148
31281,SpokaneStBridge,07/27/2017 09:00:00 AM,48,-122,46,5,51
31282,SpokaneStBridge,07/27/2017 10:00:00 AM,48,-122,22,5,27
31283,SpokaneStBridge,07/27/2017 11:00:00 AM,48,-122,9,6,15
31284,SpokaneStBridge,07/27/2017 12:00:00 PM,48,-122,16,6,22
31285,SpokaneStBridge,07/27/2017 01:00:00 PM,48,-122,11,9,20
31286,SpokaneStBridge,07/27/2017 02:00:00 PM,48,-122,15,25,40
31287,SpokaneStBridge,07/27/2017 03:00:00 PM,48,-122,15,34,49
31288,SpokaneStBridge,07/27/2017 04:00:00 PM,48,-122,29,99,128
31289,SpokaneStBridge,07/27/2017 05:00:00 PM,48,-122,28,158,186
31290,SpokaneStBridge,07/27/2017 06:00:00 PM,48,-122,28,105,133
31291,SpokaneStBridge,07/27/2017 07:00:00 PM,48,-122,15,47,62
31292,SpokaneStBridge,07/27/2017 08:00:00 PM,48,-122,8,29,37
31293,SpokaneStBridge,07/27/2017 09:00:00 PM,48,-122,6,17,23
31294,SpokaneStBridge,07/27/2017 10:00:00 PM,48,-122,1,8,9
31295,SpokaneStBridge,07/27/2017 11:00:00 PM,48,-122,4,4,8
31296,SpokaneStBridge,07/28/2017 12:00:00 AM,48,-122,1,3,4
31297,SpokaneStBridge,07/28/2017 01:00:00 AM,48,-122,0,1,1
31298,SpokaneStBridge,07/28/2017 02:00:00 AM,48,-122,1,1,2
31299,SpokaneStBridge,07/28/2017 03:00:00 AM,48,-122,0,3,3
31300,SpokaneStBridge,07/28/2017 04:00:00 AM,48,-122,4,2,6
31301,SpokaneStBridge,07/28/2017 05:00:00 AM,48,-122,19,4,23
31302,SpokaneStBridge,07/28/2017 06:00:00 AM,48,-122,41,9,50
31303,SpokaneStBridge,07/28/2017 07:00:00 AM,48,-122,118,15,133
31304,SpokaneStBridge,07/28/2017 08:00:00 AM,48,-122,107,14,121
31305,SpokaneStBridge,07/28/2017 09:00:00 AM,48,-122,51,8,59
31306,SpokaneStBridge,07/28/2017 10:00:00 AM,48,-122,17,7,24
31307,SpokaneStBridge,07/28/2017 11:00:00 AM,48,-122,20,10,30
31308,SpokaneStBridge,07/28/2017 12:00:00 PM,48,-122,16,7,23
31309,SpokaneStBridge,07/28/2017 01:00:00 PM,48,-122,10,20,30
31310,SpokaneStBridge,07/28/2017 02:00:00 PM,48,-122,22,28,50
31311,SpokaneStBridge,07/28/2017 03:00:00 PM,48,-122,20,48,68
31312,SpokaneStBridge,07/28/2017 04:00:00 PM,48,-122,28,101,129
31313,SpokaneStBridge,07/28/2017 05:00:00 PM,48,-122,16,121,137
31314,SpokaneStBridge,07/28/2017 06:00:00 PM,48,-122,16,72,88
31315,SpokaneStBridge,07/28/2017 07:00:00 PM,48,-122,25,49,74
31316,SpokaneStBridge,07/28/2017 08:00:00 PM,48,-122,13,23,36
31317,SpokaneStBridge,07/28/2017 09:00:00 PM,48,-122,20,9,29
31318,SpokaneStBridge,07/28/2017 10:00:00 PM,48,-122,9,8,17
31319,SpokaneStBridge,07/28/2017 11:00:00 PM,48,-122,4,18,22
31320,SpokaneStBridge,07/29/2017 12:00:00 AM,48,-122,2,1,3
31321,SpokaneStBridge,07/29/2017 01:00:00 AM,48,-122,0,2,2
31322,SpokaneStBridge,07/29/2017 02:00:00 AM,48,-122,2,5,7
31323,SpokaneStBridge,07/29/2017 03:00:00 AM,48,-122,2,4,6
31324,SpokaneStBridge,07/29/2017 04:00:00 AM,48,-122,3,3,6
31325,SpokaneStBridge,07/29/2017 05:00:00 AM,48,-122,9,2,11
31326,SpokaneStBridge,07/29/2017 06:00:00 AM,48,-122,12,3,15
31327,SpokaneStBridge,07/29/2017 07:00:00 AM,48,-122,9,6,15
31328,SpokaneStBridge,07/29/2017 08:00:00 AM,48,-122,29,12,41
31329,SpokaneStBridge,07/29/2017 09:00:00 AM,48,-122,22,29,51
31330,SpokaneStBridge,07/29/2017 10:00:00 AM,48,-122,31,57,88
31331,SpokaneStBridge,07/29/2017 11:00:00 AM,48,-122,24,29,53
31332,SpokaneStBridge,07/29/2017 12:00:00 PM,48,-122,54,37,91
31333,SpokaneStBridge,07/29/2017 01:00:00 PM,48,-122,38,44,82
31334,SpokaneStBridge,07/29/2017 02:00:00 PM,48,-122,38,35,73
31335,SpokaneStBridge,07/29/2017 03:00:00 PM,48,-122,33,59,92
31336,SpokaneStBridge,07/29/2017 04:00:00 PM,48,-122,33,49,82
31337,SpokaneStBridge,07/29/2017 05:00:00 PM,48,-122,29,25,54
31338,SpokaneStBridge,07/29/2017 06:00:00 PM,48,-122,22,20,42
31339,SpokaneStBridge,07/29/2017 07:00:00 PM,48,-122,20,6,26
31340,SpokaneStBridge,07/29/2017 08:00:00 PM,48,-122,8,15,23
31341,SpokaneStBridge,07/29/2017 09:00:00 PM,48,-122,3,14,17
31342,SpokaneStBridge,07/29/2017 10:00:00 PM,48,-122,4,5,9
31343,SpokaneStBridge,07/29/2017 11:00:00 PM,48,-122,3,6,9
31344,SpokaneStBridge,07/30/2017 12:00:00 AM,48,-122,3,1,4
31345,SpokaneStBridge,07/30/2017 01:00:00 AM,48,-122,1,1,2
31346,SpokaneStBridge,07/30/2017 02:00:00 AM,48,-122,0,0,0
31347,SpokaneStBridge,07/30/2017 03:00:00 AM,48,-122,1,0,1
31348,SpokaneStBridge,07/30/2017 04:00:00 AM,48,-122,0,1,1
31349,SpokaneStBridge,07/30/2017 05:00:00 AM,48,-122,5,2,7
31350,SpokaneStBridge,07/30/2017 06:00:00 AM,48,-122,4,1,5
31351,SpokaneStBridge,07/30/2017 07:00:00 AM,48,-122,10,4,14
31352,SpokaneStBridge,07/30/2017 08:00:00 AM,48,-122,17,9,26
31353,SpokaneStBridge,07/30/2017 09:00:00 AM,48,-122,12,23,35
31354,SpokaneStBridge,07/30/2017 10:00:00 AM,48,-122,18,43,61
31355,SpokaneStBridge,07/30/2017 11:00:00 AM,48,-122,34,41,75
31356,SpokaneStBridge,07/30/2017 12:00:00 PM,48,-122,26,41,67
31357,SpokaneStBridge,07/30/2017 01:00:00 PM,48,-122,38,41,79
31358,SpokaneStBridge,07/30/2017 02:00:00 PM,48,-122,61,47,108
31359,SpokaneStBridge,07/30/2017 03:00:00 PM,48,-122,32,39,71
31360,SpokaneStBridge,07/30/2017 04:00:00 PM,48,-122,40,33,73
31361,SpokaneStBridge,07/30/2017 05:00:00 PM,48,-122,15,26,41
31362,SpokaneStBridge,07/30/2017 06:00:00 PM,48,-122,12,19,31
31363,SpokaneStBridge,07/30/2017 07:00:00 PM,48,-122,12,17,29
31364,SpokaneStBridge,07/30/2017 08:00:00 PM,48,-122,16,10,26
31365,SpokaneStBridge,07/30/2017 09:00:00 PM,48,-122,7,5,12
31366,SpokaneStBridge,07/30/2017 10:00:00 PM,48,-122,10,8,18
31367,SpokaneStBridge,07/30/2017 11:00:00 PM,48,-122,1,0,1
31368,SpokaneStBridge,07/31/2017 12:00:00 AM,48,-122,3,0,3
31369,SpokaneStBridge,07/31/2017 01:00:00 AM,48,-122,0,1,1
31370,SpokaneStBridge,07/31/2017 02:00:00 AM,48,-122,1,0,1
31371,SpokaneStBridge,07/31/2017 03:00:00 AM,48,-122,0,1,1
31372,SpokaneStBridge,07/31/2017 04:00:00 AM,48,-122,4,2,6
31373,SpokaneStBridge,07/31/2017 05:00:00 AM,48,-122,13,6,19
31374,SpokaneStBridge,07/31/2017 06:00:00 AM,48,-122,69,14,83
31375,SpokaneStBridge,07/31/2017 07:00:00 AM,48,-122,167,14,181
31376,SpokaneStBridge,07/31/2017 08:00:00 AM,48,-122,165,20,185
31377,SpokaneStBridge,07/31/2017 09:00:00 AM,48,-122,50,5,55
31378,SpokaneStBridge,07/31/2017 10:00:00 AM,48,-122,26,7,33
31379,SpokaneStBridge,07/31/2017 11:00:00 AM,48,-122,29,11,40
31380,SpokaneStBridge,07/31/2017 12:00:00 PM,48,-122,15,17,32
31381,SpokaneStBridge,07/31/2017 01:00:00 PM,48,-122,18,9,27
31382,SpokaneStBridge,07/31/2017 02:00:00 PM,48,-122,11,19,30
31383,SpokaneStBridge,07/31/2017 03:00:00 PM,48,-122,25,52,77
31384,SpokaneStBridge,07/31/2017 04:00:00 PM,48,-122,27,99,126
31385,SpokaneStBridge,07/31/2017 05:00:00 PM,48,-122,25,198,223
31386,SpokaneStBridge,07/31/2017 06:00:00 PM,48,-122,26,138,164
31387,SpokaneStBridge,07/31/2017 07:00:00 PM,48,-122,11,54,65
31388,SpokaneStBridge,07/31/2017 08:00:00 PM,48,-122,11,18,29
31389,SpokaneStBridge,07/31/2017 09:00:00 PM,48,-122,4,10,14
31390,SpokaneStBridge,07/31/2017 10:00:00 PM,48,-122,2,6,8
31391,SpokaneStBridge,07/31/2017 11:00:00 PM,48,-122,3,0,3
31392,SpokaneStBridge,08/01/2017 12:00:00 AM,48,-122,0,5,5
31393,SpokaneStBridge,08/01/2017 01:00:00 AM,48,-122,1,2,3
31394,SpokaneStBridge,08/01/2017 02:00:00 AM,48,-122,1,1,2
31395,SpokaneStBridge,08/01/2017 03:00:00 AM,48,-122,0,2,2
31396,SpokaneStBridge,08/01/2017 04:00:00 AM,48,-122,9,2,11
31397,SpokaneStBridge,08/01/2017 05:00:00 AM,48,-122,23,5,28
31398,SpokaneStBridge,08/01/2017 06:00:00 AM,48,-122,92,13,105
31399,SpokaneStBridge,08/01/2017 07:00:00 AM,48,-122,200,19,219
31400,SpokaneStBridge,08/01/2017 08:00:00 AM,48,-122,146,18,164
31401,SpokaneStBridge,08/01/2017 09:00:00 AM,48,-122,61,13,74
31402,SpokaneStBridge,08/01/2017 10:00:00 AM,48,-122,26,8,34
31403,SpokaneStBridge,08/01/2017 11:00:00 AM,48,-122,9,15,24
31404,SpokaneStBridge,08/01/2017 12:00:00 PM,48,-122,17,16,33
31405,SpokaneStBridge,08/01/2017 01:00:00 PM,48,-122,14,11,25
31406,SpokaneStBridge,08/01/2017 02:00:00 PM,48,-122,16,15,31
31407,SpokaneStBridge,08/01/2017 03:00:00 PM,48,-122,16,46,62
31408,SpokaneStBridge,08/01/2017 04:00:00 PM,48,-122,23,130,153
31409,SpokaneStBridge,08/01/2017 05:00:00 PM,48,-122,26,196,222
31410,SpokaneStBridge,08/01/2017 06:00:00 PM,48,-122,20,113,133
31411,SpokaneStBridge,08/01/2017 07:00:00 PM,48,-122,9,48,57
31412,SpokaneStBridge,08/01/2017 08:00:00 PM,48,-122,11,25,36
31413,SpokaneStBridge,08/01/2017 09:00:00 PM,48,-122,6,11,17
31414,SpokaneStBridge,08/01/2017 10:00:00 PM,48,-122,5,8,13
31415,SpokaneStBridge,08/01/2017 11:00:00 PM,48,-122,3,1,4
31416,SpokaneStBridge,08/02/2017 12:00:00 AM,48,-122,0,2,2
31417,SpokaneStBridge,08/02/2017 01:00:00 AM,48,-122,2,4,6
31418,SpokaneStBridge,08/02/2017 02:00:00 AM,48,-122,1,2,3
31419,SpokaneStBridge,08/02/2017 03:00:00 AM,48,-122,0,0,0
31420,SpokaneStBridge,08/02/2017 04:00:00 AM,48,-122,5,2,7
31421,SpokaneStBridge,08/02/2017 05:00:00 AM,48,-122,26,5,31
31422,SpokaneStBridge,08/02/2017 06:00:00 AM,48,-122,80,14,94
31423,SpokaneStBridge,08/02/2017 07:00:00 AM,48,-122,159,17,176
31424,SpokaneStBridge,08/02/2017 08:00:00 AM,48,-122,145,12,157
31425,SpokaneStBridge,08/02/2017 09:00:00 AM,48,-122,58,8,66
31426,SpokaneStBridge,08/02/2017 10:00:00 AM,48,-122,27,7,34
31427,SpokaneStBridge,08/02/2017 11:00:00 AM,48,-122,13,12,25
31428,SpokaneStBridge,08/02/2017 12:00:00 PM,48,-122,13,13,26
31429,SpokaneStBridge,08/02/2017 01:00:00 PM,48,-122,17,15,32
31430,SpokaneStBridge,08/02/2017 02:00:00 PM,48,-122,8,21,29
31431,SpokaneStBridge,08/02/2017 03:00:00 PM,48,-122,16,46,62
31432,SpokaneStBridge,08/02/2017 04:00:00 PM,48,-122,18,101,119
31433,SpokaneStBridge,08/02/2017 05:00:00 PM,48,-122,21,174,195
31434,SpokaneStBridge,08/02/2017 06:00:00 PM,48,-122,11,114,125
31435,SpokaneStBridge,08/02/2017 07:00:00 PM,48,-122,14,42,56
31436,SpokaneStBridge,08/02/2017 08:00:00 PM,48,-122,18,29,47
31437,SpokaneStBridge,08/02/2017 09:00:00 PM,48,-122,8,13,21
31438,SpokaneStBridge,08/02/2017 10:00:00 PM,48,-122,11,8,19
31439,SpokaneStBridge,08/02/2017 11:00:00 PM,48,-122,2,2,4
31440,SpokaneStBridge,08/03/2017 12:00:00 AM,48,-122,1,2,3
31441,SpokaneStBridge,08/03/2017 01:00:00 AM,48,-122,0,0,0
31442,SpokaneStBridge,08/03/2017 02:00:00 AM,48,-122,0,4,4
31443,SpokaneStBridge,08/03/2017 03:00:00 AM,48,-122,0,0,0
31444,SpokaneStBridge,08/03/2017 04:00:00 AM,48,-122,6,1,7
31445,SpokaneStBridge,08/03/2017 05:00:00 AM,48,-122,28,3,31
31446,SpokaneStBridge,08/03/2017 06:00:00 AM,48,-122,62,13,75
31447,SpokaneStBridge,08/03/2017 07:00:00 AM,48,-122,153,11,164
31448,SpokaneStBridge,08/03/2017 08:00:00 AM,48,-122,112,13,125
31449,SpokaneStBridge,08/03/2017 09:00:00 AM,48,-122,48,5,53
31450,SpokaneStBridge,08/03/2017 10:00:00 AM,48,-122,24,6,30
31451,SpokaneStBridge,08/03/2017 11:00:00 AM,48,-122,10,10,20
31452,SpokaneStBridge,08/03/2017 12:00:00 PM,48,-122,11,14,25
31453,SpokaneStBridge,08/03/2017 01:00:00 PM,48,-122,11,8,19
31454,SpokaneStBridge,08/03/2017 02:00:00 PM,48,-122,8,17,25
31455,SpokaneStBridge,08/03/2017 03:00:00 PM,48,-122,17,41,58
31456,SpokaneStBridge,08/03/2017 04:00:00 PM,48,-122,18,73,91
31457,SpokaneStBridge,08/03/2017 05:00:00 PM,48,-122,17,158,175
31458,SpokaneStBridge,08/03/2017 06:00:00 PM,48,-122,15,97,112
31459,SpokaneStBridge,08/03/2017 07:00:00 PM,48,-122,13,38,51
31460,SpokaneStBridge,08/03/2017 08:00:00 PM,48,-122,10,22,32
31461,SpokaneStBridge,08/03/2017 09:00:00 PM,48,-122,7,7,14
31462,SpokaneStBridge,08/03/2017 10:00:00 PM,48,-122,3,11,14
31463,SpokaneStBridge,08/03/2017 11:00:00 PM,48,-122,6,3,9
31464,SpokaneStBridge,08/04/2017 12:00:00 AM,48,-122,2,5,7
31465,SpokaneStBridge,08/04/2017 01:00:00 AM,48,-122,1,3,4
31466,SpokaneStBridge,08/04/2017 02:00:00 AM,48,-122,0,4,4
31467,SpokaneStBridge,08/04/2017 03:00:00 AM,48,-122,2,3,5
31468,SpokaneStBridge,08/04/2017 04:00:00 AM,48,-122,5,4,9
31469,SpokaneStBridge,08/04/2017 05:00:00 AM,48,-122,13,4,17
31470,SpokaneStBridge,08/04/2017 06:00:00 AM,48,-122,44,14,58
31471,SpokaneStBridge,08/04/2017 07:00:00 AM,48,-122,114,21,135
31472,SpokaneStBridge,08/04/2017 08:00:00 AM,48,-122,83,14,97
31473,SpokaneStBridge,08/04/2017 09:00:00 AM,48,-122,37,9,46
31474,SpokaneStBridge,08/04/2017 10:00:00 AM,48,-122,17,7,24
31475,SpokaneStBridge,08/04/2017 11:00:00 AM,48,-122,16,5,21
31476,SpokaneStBridge,08/04/2017 12:00:00 PM,48,-122,17,11,28
31477,SpokaneStBridge,08/04/2017 01:00:00 PM,48,-122,9,27,36
31478,SpokaneStBridge,08/04/2017 02:00:00 PM,48,-122,13,21,34
31479,SpokaneStBridge,08/04/2017 03:00:00 PM,48,-122,20,35,55
31480,SpokaneStBridge,08/04/2017 04:00:00 PM,48,-122,16,75,91
31481,SpokaneStBridge,08/04/2017 05:00:00 PM,48,-122,15,92,107
31482,SpokaneStBridge,08/04/2017 06:00:00 PM,48,-122,15,59,74
31483,SpokaneStBridge,08/04/2017 07:00:00 PM,48,-122,7,25,32
31484,SpokaneStBridge,08/04/2017 08:00:00 PM,48,-122,11,14,25
31485,SpokaneStBridge,08/04/2017 09:00:00 PM,48,-122,3,7,10
31486,SpokaneStBridge,08/04/2017 10:00:00 PM,48,-122,3,4,7
31487,SpokaneStBridge,08/04/2017 11:00:00 PM,48,-122,3,2,5
31488,SpokaneStBridge,08/05/2017 12:00:00 AM,48,-122,1,2,3
31489,SpokaneStBridge,08/05/2017 01:00:00 AM,48,-122,1,1,2
31490,SpokaneStBridge,08/05/2017 02:00:00 AM,48,-122,0,3,3
31491,SpokaneStBridge,08/05/2017 03:00:00 AM,48,-122,0,2,2
31492,SpokaneStBridge,08/05/2017 04:00:00 AM,48,-122,1,1,2
31493,SpokaneStBridge,08/05/2017 05:00:00 AM,48,-122,5,1,6
31494,SpokaneStBridge,08/05/2017 06:00:00 AM,48,-122,6,4,10
31495,SpokaneStBridge,08/05/2017 07:00:00 AM,48,-122,11,6,17
31496,SpokaneStBridge,08/05/2017 08:00:00 AM,48,-122,19,20,39
31497,SpokaneStBridge,08/05/2017 09:00:00 AM,48,-122,23,20,43
31498,SpokaneStBridge,08/05/2017 10:00:00 AM,48,-122,27,17,44
31499,SpokaneStBridge,08/05/2017 11:00:00 AM,48,-122,24,25,49
31500,SpokaneStBridge,08/05/2017 12:00:00 PM,48,-122,49,26,75
31501,SpokaneStBridge,08/05/2017 01:00:00 PM,48,-122,35,24,59
31502,SpokaneStBridge,08/05/2017 02:00:00 PM,48,-122,34,26,60
31503,SpokaneStBridge,08/05/2017 03:00:00 PM,48,-122,36,30,66
31504,SpokaneStBridge,08/05/2017 04:00:00 PM,48,-122,57,22,79
31505,SpokaneStBridge,08/05/2017 05:00:00 PM,48,-122,21,14,35
31506,SpokaneStBridge,08/05/2017 06:00:00 PM,48,-122,15,30,45
31507,SpokaneStBridge,08/05/2017 07:00:00 PM,48,-122,14,13,27
31508,SpokaneStBridge,08/05/2017 08:00:00 PM,48,-122,5,11,16
31509,SpokaneStBridge,08/05/2017 09:00:00 PM,48,-122,6,9,15
31510,SpokaneStBridge,08/05/2017 10:00:00 PM,48,-122,1,9,10
31511,SpokaneStBridge,08/05/2017 11:00:00 PM,48,-122,4,15,19
31512,SpokaneStBridge,08/06/2017 12:00:00 AM,48,-122,2,12,14
31513,SpokaneStBridge,08/06/2017 01:00:00 AM,48,-122,3,19,22
31514,SpokaneStBridge,08/06/2017 02:00:00 AM,48,-122,0,2,2
31515,SpokaneStBridge,08/06/2017 03:00:00 AM,48,-122,1,2,3
31516,SpokaneStBridge,08/06/2017 04:00:00 AM,48,-122,1,1,2
31517,SpokaneStBridge,08/06/2017 05:00:00 AM,48,-122,7,1,8
31518,SpokaneStBridge,08/06/2017 06:00:00 AM,48,-122,5,8,13
31519,SpokaneStBridge,08/06/2017 07:00:00 AM,48,-122,10,4,14
31520,SpokaneStBridge,08/06/2017 08:00:00 AM,48,-122,21,22,43
31521,SpokaneStBridge,08/06/2017 09:00:00 AM,48,-122,17,22,39
31522,SpokaneStBridge,08/06/2017 10:00:00 AM,48,-122,35,32,67
31523,SpokaneStBridge,08/06/2017 11:00:00 AM,48,-122,30,34,64
31524,SpokaneStBridge,08/06/2017 12:00:00 PM,48,-122,44,26,70
31525,SpokaneStBridge,08/06/2017 01:00:00 PM,48,-122,38,37,75
31526,SpokaneStBridge,08/06/2017 02:00:00 PM,48,-122,47,31,78
31527,SpokaneStBridge,08/06/2017 03:00:00 PM,48,-122,26,29,55
31528,SpokaneStBridge,08/06/2017 04:00:00 PM,48,-122,16,22,38
31529,SpokaneStBridge,08/06/2017 05:00:00 PM,48,-122,14,19,33
31530,SpokaneStBridge,08/06/2017 06:00:00 PM,48,-122,12,17,29
31531,SpokaneStBridge,08/06/2017 07:00:00 PM,48,-122,6,12,18
31532,SpokaneStBridge,08/06/2017 08:00:00 PM,48,-122,6,12,18
31533,SpokaneStBridge,08/06/2017 09:00:00 PM,48,-122,4,5,9
31534,SpokaneStBridge,08/06/2017 10:00:00 PM,48,-122,2,3,5
31535,SpokaneStBridge,08/06/2017 11:00:00 PM,48,-122,1,2,3
31536,SpokaneStBridge,08/07/2017 12:00:00 AM,48,-122,4,1,5
31537,SpokaneStBridge,08/07/2017 01:00:00 AM,48,-122,0,5,5
31538,SpokaneStBridge,08/07/2017 02:00:00 AM,48,-122,2,0,2
31539,SpokaneStBridge,08/07/2017 03:00:00 AM,48,-122,1,1,2
31540,SpokaneStBridge,08/07/2017 04:00:00 AM,48,-122,7,1,8
31541,SpokaneStBridge,08/07/2017 05:00:00 AM,48,-122,29,3,32
31542,SpokaneStBridge,08/07/2017 06:00:00 AM,48,-122,73,11,84
31543,SpokaneStBridge,08/07/2017 07:00:00 AM,48,-122,166,16,182
31544,SpokaneStBridge,08/07/2017 08:00:00 AM,48,-122,165,16,181
31545,SpokaneStBridge,08/07/2017 09:00:00 AM,48,-122,56,10,66
31546,SpokaneStBridge,08/07/2017 10:00:00 AM,48,-122,20,4,24
31547,SpokaneStBridge,08/07/2017 11:00:00 AM,48,-122,15,8,23
31548,SpokaneStBridge,08/07/2017 12:00:00 PM,48,-122,18,13,31
31549,SpokaneStBridge,08/07/2017 01:00:00 PM,48,-122,12,13,25
31550,SpokaneStBridge,08/07/2017 02:00:00 PM,48,-122,10,19,29
31551,SpokaneStBridge,08/07/2017 03:00:00 PM,48,-122,17,47,64
31552,SpokaneStBridge,08/07/2017 04:00:00 PM,48,-122,24,115,139
31553,SpokaneStBridge,08/07/2017 05:00:00 PM,48,-122,21,198,219
31554,SpokaneStBridge,08/07/2017 06:00:00 PM,48,-122,19,101,120
31555,SpokaneStBridge,08/07/2017 07:00:00 PM,48,-122,17,46,63
31556,SpokaneStBridge,08/07/2017 08:00:00 PM,48,-122,8,17,25
31557,SpokaneStBridge,08/07/2017 09:00:00 PM,48,-122,1,9,10
31558,SpokaneStBridge,08/07/2017 10:00:00 PM,48,-122,5,3,8
31559,SpokaneStBridge,08/07/2017 11:00:00 PM,48,-122,0,3,3
31560,SpokaneStBridge,08/08/2017 12:00:00 AM,48,-122,2,0,2
31561,SpokaneStBridge,08/08/2017 01:00:00 AM,48,-122,1,1,2
31562,SpokaneStBridge,08/08/2017 02:00:00 AM,48,-122,1,3,4
31563,SpokaneStBridge,08/08/2017 03:00:00 AM,48,-122,1,1,2
31564,SpokaneStBridge,08/08/2017 04:00:00 AM,48,-122,6,3,9
31565,SpokaneStBridge,08/08/2017 05:00:00 AM,48,-122,26,8,34
31566,SpokaneStBridge,08/08/2017 06:00:00 AM,48,-122,80,11,91
31567,SpokaneStBridge,08/08/2017 07:00:00 AM,48,-122,160,30,190
31568,SpokaneStBridge,08/08/2017 08:00:00 AM,48,-122,151,18,169
31569,SpokaneStBridge,08/08/2017 09:00:00 AM,48,-122,56,8,64
31570,SpokaneStBridge,08/08/2017 10:00:00 AM,48,-122,38,20,58
31571,SpokaneStBridge,08/08/2017 11:00:00 AM,48,-122,13,8,21
31572,SpokaneStBridge,08/08/2017 12:00:00 PM,48,-122,20,16,36
31573,SpokaneStBridge,08/08/2017 01:00:00 PM,48,-122,23,16,39
31574,SpokaneStBridge,08/08/2017 02:00:00 PM,48,-122,17,18,35
31575,SpokaneStBridge,08/08/2017 03:00:00 PM,48,-122,16,48,64
31576,SpokaneStBridge,08/08/2017 04:00:00 PM,48,-122,31,107,138
31577,SpokaneStBridge,08/08/2017 05:00:00 PM,48,-122,23,196,219
31578,SpokaneStBridge,08/08/2017 06:00:00 PM,48,-122,22,103,125
31579,SpokaneStBridge,08/08/2017 07:00:00 PM,48,-122,19,51,70
31580,SpokaneStBridge,08/08/2017 08:00:00 PM,48,-122,11,22,33
31581,SpokaneStBridge,08/08/2017 09:00:00 PM,48,-122,10,10,20
31582,SpokaneStBridge,08/08/2017 10:00:00 PM,48,-122,5,6,11
31583,SpokaneStBridge,08/08/2017 11:00:00 PM,48,-122,3,6,9
31584,SpokaneStBridge,08/09/2017 12:00:00 AM,48,-122,0,4,4
31585,SpokaneStBridge,08/09/2017 01:00:00 AM,48,-122,1,1,2
31586,SpokaneStBridge,08/09/2017 02:00:00 AM,48,-122,5,6,11
31587,SpokaneStBridge,08/09/2017 03:00:00 AM,48,-122,4,2,6
31588,SpokaneStBridge,08/09/2017 04:00:00 AM,48,-122,2,1,3
31589,SpokaneStBridge,08/09/2017 05:00:00 AM,48,-122,23,4,27
31590,SpokaneStBridge,08/09/2017 06:00:00 AM,48,-122,73,17,90
31591,SpokaneStBridge,08/09/2017 07:00:00 AM,48,-122,185,16,201
31592,SpokaneStBridge,08/09/2017 08:00:00 AM,48,-122,131,16,147
31593,SpokaneStBridge,08/09/2017 09:00:00 AM,48,-122,61,5,66
31594,SpokaneStBridge,08/09/2017 10:00:00 AM,48,-122,28,11,39
31595,SpokaneStBridge,08/09/2017 11:00:00 AM,48,-122,10,13,23
31596,SpokaneStBridge,08/09/2017 12:00:00 PM,48,-122,19,15,34
31597,SpokaneStBridge,08/09/2017 01:00:00 PM,48,-122,16,12,28
31598,SpokaneStBridge,08/09/2017 02:00:00 PM,48,-122,16,20,36
31599,SpokaneStBridge,08/09/2017 03:00:00 PM,48,-122,13,39,52
31600,SpokaneStBridge,08/09/2017 04:00:00 PM,48,-122,27,94,121
31601,SpokaneStBridge,08/09/2017 05:00:00 PM,48,-122,24,171,195
31602,SpokaneStBridge,08/09/2017 06:00:00 PM,48,-122,26,125,151
31603,SpokaneStBridge,08/09/2017 07:00:00 PM,48,-122,11,56,67
31604,SpokaneStBridge,08/09/2017 08:00:00 PM,48,-122,11,25,36
31605,SpokaneStBridge,08/09/2017 09:00:00 PM,48,-122,13,12,25
31606,SpokaneStBridge,08/09/2017 10:00:00 PM,48,-122,4,10,14
31607,SpokaneStBridge,08/09/2017 11:00:00 PM,48,-122,0,10,10
31608,SpokaneStBridge,08/10/2017 12:00:00 AM,48,-122,2,4,6
31609,SpokaneStBridge,08/10/2017 01:00:00 AM,48,-122,1,1,2
31610,SpokaneStBridge,08/10/2017 02:00:00 AM,48,-122,1,2,3
31611,SpokaneStBridge,08/10/2017 03:00:00 AM,48,-122,1,3,4
31612,SpokaneStBridge,08/10/2017 04:00:00 AM,48,-122,3,5,8
31613,SpokaneStBridge,08/10/2017 05:00:00 AM,48,-122,28,8,36
31614,SpokaneStBridge,08/10/2017 06:00:00 AM,48,-122,57,13,70
31615,SpokaneStBridge,08/10/2017 07:00:00 AM,48,-122,173,16,189
31616,SpokaneStBridge,08/10/2017 08:00:00 AM,48,-122,117,14,131
31617,SpokaneStBridge,08/10/2017 09:00:00 AM,48,-122,50,12,62
31618,SpokaneStBridge,08/10/2017 10:00:00 AM,48,-122,23,5,28
31619,SpokaneStBridge,08/10/2017 11:00:00 AM,48,-122,15,5,20
31620,SpokaneStBridge,08/10/2017 12:00:00 PM,48,-122,18,10,28
31621,SpokaneStBridge,08/10/2017 01:00:00 PM,48,-122,14,16,30
31622,SpokaneStBridge,08/10/2017 02:00:00 PM,48,-122,15,19,34
31623,SpokaneStBridge,08/10/2017 03:00:00 PM,48,-122,22,52,74
31624,SpokaneStBridge,08/10/2017 04:00:00 PM,48,-122,21,94,115
31625,SpokaneStBridge,08/10/2017 05:00:00 PM,48,-122,23,179,202
31626,SpokaneStBridge,08/10/2017 06:00:00 PM,48,-122,21,98,119
31627,SpokaneStBridge,08/10/2017 07:00:00 PM,48,-122,9,47,56
31628,SpokaneStBridge,08/10/2017 08:00:00 PM,48,-122,11,19,30
31629,SpokaneStBridge,08/10/2017 09:00:00 PM,48,-122,9,12,21
31630,SpokaneStBridge,08/10/2017 10:00:00 PM,48,-122,2,13,15
31631,SpokaneStBridge,08/10/2017 11:00:00 PM,48,-122,2,4,6
31632,SpokaneStBridge,08/11/2017 12:00:00 AM,48,-122,1,5,6
31633,SpokaneStBridge,08/11/2017 01:00:00 AM,48,-122,2,2,4
31634,SpokaneStBridge,08/11/2017 02:00:00 AM,48,-122,0,2,2
31635,SpokaneStBridge,08/11/2017 03:00:00 AM,48,-122,4,0,4
31636,SpokaneStBridge,08/11/2017 04:00:00 AM,48,-122,2,4,6
31637,SpokaneStBridge,08/11/2017 05:00:00 AM,48,-122,19,3,22
31638,SpokaneStBridge,08/11/2017 06:00:00 AM,48,-122,48,13,61
31639,SpokaneStBridge,08/11/2017 07:00:00 AM,48,-122,129,16,145
31640,SpokaneStBridge,08/11/2017 08:00:00 AM,48,-122,112,19,131
31641,SpokaneStBridge,08/11/2017 09:00:00 AM,48,-122,40,11,51
31642,SpokaneStBridge,08/11/2017 10:00:00 AM,48,-122,21,15,36
31643,SpokaneStBridge,08/11/2017 11:00:00 AM,48,-122,24,14,38
31644,SpokaneStBridge,08/11/2017 12:00:00 PM,48,-122,13,17,30
31645,SpokaneStBridge,08/11/2017 01:00:00 PM,48,-122,20,26,46
31646,SpokaneStBridge,08/11/2017 02:00:00 PM,48,-122,22,28,50
31647,SpokaneStBridge,08/11/2017 03:00:00 PM,48,-122,23,45,68
31648,SpokaneStBridge,08/11/2017 04:00:00 PM,48,-122,22,93,115
31649,SpokaneStBridge,08/11/2017 05:00:00 PM,48,-122,27,144,171
31650,SpokaneStBridge,08/11/2017 06:00:00 PM,48,-122,14,70,84
31651,SpokaneStBridge,08/11/2017 07:00:00 PM,48,-122,11,40,51
31652,SpokaneStBridge,08/11/2017 08:00:00 PM,48,-122,9,19,28
31653,SpokaneStBridge,08/11/2017 09:00:00 PM,48,-122,10,13,23
31654,SpokaneStBridge,08/11/2017 10:00:00 PM,48,-122,9,9,18
31655,SpokaneStBridge,08/11/2017 11:00:00 PM,48,-122,4,6,10
31656,SpokaneStBridge,08/12/2017 12:00:00 AM,48,-122,6,4,10
31657,SpokaneStBridge,08/12/2017 01:00:00 AM,48,-122,1,4,5
31658,SpokaneStBridge,08/12/2017 02:00:00 AM,48,-122,2,2,4
31659,SpokaneStBridge,08/12/2017 03:00:00 AM,48,-122,2,3,5
31660,SpokaneStBridge,08/12/2017 04:00:00 AM,48,-122,2,2,4
31661,SpokaneStBridge,08/12/2017 05:00:00 AM,48,-122,3,1,4
31662,SpokaneStBridge,08/12/2017 06:00:00 AM,48,-122,7,2,9
31663,SpokaneStBridge,08/12/2017 07:00:00 AM,48,-122,15,6,21
31664,SpokaneStBridge,08/12/2017 08:00:00 AM,48,-122,20,19,39
31665,SpokaneStBridge,08/12/2017 09:00:00 AM,48,-122,16,12,28
31666,SpokaneStBridge,08/12/2017 10:00:00 AM,48,-122,29,30,59
31667,SpokaneStBridge,08/12/2017 11:00:00 AM,48,-122,38,17,55
31668,SpokaneStBridge,08/12/2017 12:00:00 PM,48,-122,33,26,59
31669,SpokaneStBridge,08/12/2017 01:00:00 PM,48,-122,27,32,59
31670,SpokaneStBridge,08/12/2017 02:00:00 PM,48,-122,29,27,56
31671,SpokaneStBridge,08/12/2017 03:00:00 PM,48,-122,22,41,63
31672,SpokaneStBridge,08/12/2017 04:00:00 PM,48,-122,26,26,52
31673,SpokaneStBridge,08/12/2017 05:00:00 PM,48,-122,24,46,70
31674,SpokaneStBridge,08/12/2017 06:00:00 PM,48,-122,19,23,42
31675,SpokaneStBridge,08/12/2017 07:00:00 PM,48,-122,6,12,18
31676,SpokaneStBridge,08/12/2017 08:00:00 PM,48,-122,12,7,19
31677,SpokaneStBridge,08/12/2017 09:00:00 PM,48,-122,6,5,11
31678,SpokaneStBridge,08/12/2017 10:00:00 PM,48,-122,4,2,6
31679,SpokaneStBridge,08/12/2017 11:00:00 PM,48,-122,0,4,4
31680,SpokaneStBridge,08/13/2017 12:00:00 AM,48,-122,1,0,1
31681,SpokaneStBridge,08/13/2017 01:00:00 AM,48,-122,4,2,6
31682,SpokaneStBridge,08/13/2017 02:00:00 AM,48,-122,0,0,0
31683,SpokaneStBridge,08/13/2017 03:00:00 AM,48,-122,1,1,2
31684,SpokaneStBridge,08/13/2017 04:00:00 AM,48,-122,0,1,1
31685,SpokaneStBridge,08/13/2017 05:00:00 AM,48,-122,6,0,6
31686,SpokaneStBridge,08/13/2017 06:00:00 AM,48,-122,3,2,5
31687,SpokaneStBridge,08/13/2017 07:00:00 AM,48,-122,7,3,10
31688,SpokaneStBridge,08/13/2017 08:00:00 AM,48,-122,13,6,19
31689,SpokaneStBridge,08/13/2017 09:00:00 AM,48,-122,18,13,31
31690,SpokaneStBridge,08/13/2017 10:00:00 AM,48,-122,29,34,63
31691,SpokaneStBridge,08/13/2017 11:00:00 AM,48,-122,66,16,82
31692,SpokaneStBridge,08/13/2017 12:00:00 PM,48,-122,77,24,101
31693,SpokaneStBridge,08/13/2017 01:00:00 PM,48,-122,27,26,53
31694,SpokaneStBridge,08/13/2017 02:00:00 PM,48,-122,27,17,44
31695,SpokaneStBridge,08/13/2017 03:00:00 PM,48,-122,23,23,46
31696,SpokaneStBridge,08/13/2017 04:00:00 PM,48,-122,16,28,44
31697,SpokaneStBridge,08/13/2017 05:00:00 PM,48,-122,14,16,30
31698,SpokaneStBridge,08/13/2017 06:00:00 PM,48,-122,14,13,27
31699,SpokaneStBridge,08/13/2017 07:00:00 PM,48,-122,3,8,11
31700,SpokaneStBridge,08/13/2017 08:00:00 PM,48,-122,5,9,14
31701,SpokaneStBridge,08/13/2017 09:00:00 PM,48,-122,6,4,10
31702,SpokaneStBridge,08/13/2017 10:00:00 PM,48,-122,4,5,9
31703,SpokaneStBridge,08/13/2017 11:00:00 PM,48,-122,3,3,6
31704,SpokaneStBridge,08/14/2017 12:00:00 AM,48,-122,3,1,4
31705,SpokaneStBridge,08/14/2017 01:00:00 AM,48,-122,2,0,2
31706,SpokaneStBridge,08/14/2017 02:00:00 AM,48,-122,1,0,1
31707,SpokaneStBridge,08/14/2017 03:00:00 AM,48,-122,2,1,3
31708,SpokaneStBridge,08/14/2017 04:00:00 AM,48,-122,4,3,7
31709,SpokaneStBridge,08/14/2017 05:00:00 AM,48,-122,23,4,27
31710,SpokaneStBridge,08/14/2017 06:00:00 AM,48,-122,66,12,78
31711,SpokaneStBridge,08/14/2017 07:00:00 AM,48,-122,137,21,158
31712,SpokaneStBridge,08/14/2017 08:00:00 AM,48,-122,129,20,149
31713,SpokaneStBridge,08/14/2017 09:00:00 AM,48,-122,66,5,71
31714,SpokaneStBridge,08/14/2017 10:00:00 AM,48,-122,21,12,33
31715,SpokaneStBridge,08/14/2017 11:00:00 AM,48,-122,15,12,27
31716,SpokaneStBridge,08/14/2017 12:00:00 PM,48,-122,9,10,19
31717,SpokaneStBridge,08/14/2017 01:00:00 PM,48,-122,16,17,33
31718,SpokaneStBridge,08/14/2017 02:00:00 PM,48,-122,12,24,36
31719,SpokaneStBridge,08/14/2017 03:00:00 PM,48,-122,15,45,60
31720,SpokaneStBridge,08/14/2017 04:00:00 PM,48,-122,27,107,134
31721,SpokaneStBridge,08/14/2017 05:00:00 PM,48,-122,22,172,194
31722,SpokaneStBridge,08/14/2017 06:00:00 PM,48,-122,21,105,126
31723,SpokaneStBridge,08/14/2017 07:00:00 PM,48,-122,9,38,47
31724,SpokaneStBridge,08/14/2017 08:00:00 PM,48,-122,4,18,22
31725,SpokaneStBridge,08/14/2017 09:00:00 PM,48,-122,8,13,21
31726,SpokaneStBridge,08/14/2017 10:00:00 PM,48,-122,3,4,7
31727,SpokaneStBridge,08/14/2017 11:00:00 PM,48,-122,1,5,6
31728,SpokaneStBridge,08/15/2017 12:00:00 AM,48,-122,1,1,2
31729,SpokaneStBridge,08/15/2017 01:00:00 AM,48,-122,0,1,1
31730,SpokaneStBridge,08/15/2017 02:00:00 AM,48,-122,0,0,0
31731,SpokaneStBridge,08/15/2017 03:00:00 AM,48,-122,1,4,5
31732,SpokaneStBridge,08/15/2017 04:00:00 AM,48,-122,5,1,6
31733,SpokaneStBridge,08/15/2017 05:00:00 AM,48,-122,32,3,35
31734,SpokaneStBridge,08/15/2017 06:00:00 AM,48,-122,74,9,83
31735,SpokaneStBridge,08/15/2017 07:00:00 AM,48,-122,170,23,193
31736,SpokaneStBridge,08/15/2017 08:00:00 AM,48,-122,145,9,154
31737,SpokaneStBridge,08/15/2017 09:00:00 AM,48,-122,56,12,68
31738,SpokaneStBridge,08/15/2017 10:00:00 AM,48,-122,21,8,29
31739,SpokaneStBridge,08/15/2017 11:00:00 AM,48,-122,20,15,35
31740,SpokaneStBridge,08/15/2017 12:00:00 PM,48,-122,16,18,34
31741,SpokaneStBridge,08/15/2017 01:00:00 PM,48,-122,16,8,24
31742,SpokaneStBridge,08/15/2017 02:00:00 PM,48,-122,15,20,35
31743,SpokaneStBridge,08/15/2017 03:00:00 PM,48,-122,23,47,70
31744,SpokaneStBridge,08/15/2017 04:00:00 PM,48,-122,26,98,124
31745,SpokaneStBridge,08/15/2017 05:00:00 PM,48,-122,23,178,201
31746,SpokaneStBridge,08/15/2017 06:00:00 PM,48,-122,21,138,159
31747,SpokaneStBridge,08/15/2017 07:00:00 PM,48,-122,17,52,69
31748,SpokaneStBridge,08/15/2017 08:00:00 PM,48,-122,12,20,32
31749,SpokaneStBridge,08/15/2017 09:00:00 PM,48,-122,4,14,18
31750,SpokaneStBridge,08/15/2017 10:00:00 PM,48,-122,6,12,18
31751,SpokaneStBridge,08/15/2017 11:00:00 PM,48,-122,2,3,5
31752,SpokaneStBridge,08/16/2017 12:00:00 AM,48,-122,0,3,3
31753,SpokaneStBridge,08/16/2017 01:00:00 AM,48,-122,0,1,1
31754,SpokaneStBridge,08/16/2017 02:00:00 AM,48,-122,0,1,1
31755,SpokaneStBridge,08/16/2017 03:00:00 AM,48,-122,1,3,4
31756,SpokaneStBridge,08/16/2017 04:00:00 AM,48,-122,4,2,6
31757,SpokaneStBridge,08/16/2017 05:00:00 AM,48,-122,27,2,29
31758,SpokaneStBridge,08/16/2017 06:00:00 AM,48,-122,76,7,83
31759,SpokaneStBridge,08/16/2017 07:00:00 AM,48,-122,75,17,92
31760,SpokaneStBridge,08/16/2017 08:00:00 AM,48,-122,203,21,224
31761,SpokaneStBridge,08/16/2017 09:00:00 AM,48,-122,56,11,67
31762,SpokaneStBridge,08/16/2017 10:00:00 AM,48,-122,30,6,36
31763,SpokaneStBridge,08/16/2017 11:00:00 AM,48,-122,28,7,35
31764,SpokaneStBridge,08/16/2017 12:00:00 PM,48,-122,11,15,26
31765,SpokaneStBridge,08/16/2017 01:00:00 PM,48,-122,20,20,40
31766,SpokaneStBridge,08/16/2017 02:00:00 PM,48,-122,18,23,41
31767,SpokaneStBridge,08/16/2017 03:00:00 PM,48,-122,15,49,64
31768,SpokaneStBridge,08/16/2017 04:00:00 PM,48,-122,31,107,138
31769,SpokaneStBridge,08/16/2017 05:00:00 PM,48,-122,30,182,212
31770,SpokaneStBridge,08/16/2017 06:00:00 PM,48,-122,23,112,135
31771,SpokaneStBridge,08/16/2017 07:00:00 PM,48,-122,20,57,77
31772,SpokaneStBridge,08/16/2017 08:00:00 PM,48,-122,11,34,45
31773,SpokaneStBridge,08/16/2017 09:00:00 PM,48,-122,13,22,35
31774,SpokaneStBridge,08/16/2017 10:00:00 PM,48,-122,3,1,4
31775,SpokaneStBridge,08/16/2017 11:00:00 PM,48,-122,4,5,9
31776,SpokaneStBridge,08/17/2017 12:00:00 AM,48,-122,2,0,2
31777,SpokaneStBridge,08/17/2017 01:00:00 AM,48,-122,1,3,4
31778,SpokaneStBridge,08/17/2017 02:00:00 AM,48,-122,2,2,4
31779,SpokaneStBridge,08/17/2017 03:00:00 AM,48,-122,1,2,3
31780,SpokaneStBridge,08/17/2017 04:00:00 AM,48,-122,3,1,4
31781,SpokaneStBridge,08/17/2017 05:00:00 AM,48,-122,28,5,33
31782,SpokaneStBridge,08/17/2017 06:00:00 AM,48,-122,79,10,89
31783,SpokaneStBridge,08/17/2017 07:00:00 AM,48,-122,144,17,161
31784,SpokaneStBridge,08/17/2017 08:00:00 AM,48,-122,124,14,138
31785,SpokaneStBridge,08/17/2017 09:00:00 AM,48,-122,50,6,56
31786,SpokaneStBridge,08/17/2017 10:00:00 AM,48,-122,18,6,24
31787,SpokaneStBridge,08/17/2017 11:00:00 AM,48,-122,15,5,20
31788,SpokaneStBridge,08/17/2017 12:00:00 PM,48,-122,12,15,27
31789,SpokaneStBridge,08/17/2017 01:00:00 PM,48,-122,23,17,40
31790,SpokaneStBridge,08/17/2017 02:00:00 PM,48,-122,13,27,40
31791,SpokaneStBridge,08/17/2017 03:00:00 PM,48,-122,18,41,59
31792,SpokaneStBridge,08/17/2017 04:00:00 PM,48,-122,21,100,121
31793,SpokaneStBridge,08/17/2017 05:00:00 PM,48,-122,22,171,193
31794,SpokaneStBridge,08/17/2017 06:00:00 PM,48,-122,15,114,129
31795,SpokaneStBridge,08/17/2017 07:00:00 PM,48,-122,18,40,58
31796,SpokaneStBridge,08/17/2017 08:00:00 PM,48,-122,11,21,32
31797,SpokaneStBridge,08/17/2017 09:00:00 PM,48,-122,6,9,15
31798,SpokaneStBridge,08/17/2017 10:00:00 PM,48,-122,4,5,9
31799,SpokaneStBridge,08/17/2017 11:00:00 PM,48,-122,8,3,11
31800,SpokaneStBridge,08/18/2017 12:00:00 AM,48,-122,2,4,6
31801,SpokaneStBridge,08/18/2017 01:00:00 AM,48,-122,3,2,5
31802,SpokaneStBridge,08/18/2017 02:00:00 AM,48,-122,0,3,3
31803,SpokaneStBridge,08/18/2017 03:00:00 AM,48,-122,0,0,0
31804,SpokaneStBridge,08/18/2017 04:00:00 AM,48,-122,2,1,3
31805,SpokaneStBridge,08/18/2017 05:00:00 AM,48,-122,19,4,23
31806,SpokaneStBridge,08/18/2017 06:00:00 AM,48,-122,50,5,55
31807,SpokaneStBridge,08/18/2017 07:00:00 AM,48,-122,102,14,116
31808,SpokaneStBridge,08/18/2017 08:00:00 AM,48,-122,125,10,135
31809,SpokaneStBridge,08/18/2017 09:00:00 AM,48,-122,38,4,42
31810,SpokaneStBridge,08/18/2017 10:00:00 AM,48,-122,16,10,26
31811,SpokaneStBridge,08/18/2017 11:00:00 AM,48,-122,15,5,20
31812,SpokaneStBridge,08/18/2017 12:00:00 PM,48,-122,15,14,29
31813,SpokaneStBridge,08/18/2017 01:00:00 PM,48,-122,22,18,40
31814,SpokaneStBridge,08/18/2017 02:00:00 PM,48,-122,17,32,49
31815,SpokaneStBridge,08/18/2017 03:00:00 PM,48,-122,23,45,68
31816,SpokaneStBridge,08/18/2017 04:00:00 PM,48,-122,16,90,106
31817,SpokaneStBridge,08/18/2017 05:00:00 PM,48,-122,17,119,136
31818,SpokaneStBridge,08/18/2017 06:00:00 PM,48,-122,11,68,79
31819,SpokaneStBridge,08/18/2017 07:00:00 PM,48,-122,16,28,44
31820,SpokaneStBridge,08/18/2017 08:00:00 PM,48,-122,5,10,15
31821,SpokaneStBridge,08/18/2017 09:00:00 PM,48,-122,3,12,15
31822,SpokaneStBridge,08/18/2017 10:00:00 PM,48,-122,4,9,13
31823,SpokaneStBridge,08/18/2017 11:00:00 PM,48,-122,2,7,9
31824,SpokaneStBridge,08/19/2017 12:00:00 AM,48,-122,1,5,6
31825,SpokaneStBridge,08/19/2017 01:00:00 AM,48,-122,2,1,3
31826,SpokaneStBridge,08/19/2017 02:00:00 AM,48,-122,0,1,1
31827,SpokaneStBridge,08/19/2017 03:00:00 AM,48,-122,1,2,3
31828,SpokaneStBridge,08/19/2017 04:00:00 AM,48,-122,0,1,1
31829,SpokaneStBridge,08/19/2017 05:00:00 AM,48,-122,3,0,3
31830,SpokaneStBridge,08/19/2017 06:00:00 AM,48,-122,6,4,10
31831,SpokaneStBridge,08/19/2017 07:00:00 AM,48,-122,16,6,22
31832,SpokaneStBridge,08/19/2017 08:00:00 AM,48,-122,25,17,42
31833,SpokaneStBridge,08/19/2017 09:00:00 AM,48,-122,16,21,37
31834,SpokaneStBridge,08/19/2017 10:00:00 AM,48,-122,24,20,44
31835,SpokaneStBridge,08/19/2017 11:00:00 AM,48,-122,28,35,63
31836,SpokaneStBridge,08/19/2017 12:00:00 PM,48,-122,21,29,50
31837,SpokaneStBridge,08/19/2017 01:00:00 PM,48,-122,38,24,62
31838,SpokaneStBridge,08/19/2017 02:00:00 PM,48,-122,28,25,53
31839,SpokaneStBridge,08/19/2017 03:00:00 PM,48,-122,14,24,38
31840,SpokaneStBridge,08/19/2017 04:00:00 PM,48,-122,26,23,49
31841,SpokaneStBridge,08/19/2017 05:00:00 PM,48,-122,23,37,60
31842,SpokaneStBridge,08/19/2017 06:00:00 PM,48,-122,11,25,36
31843,SpokaneStBridge,08/19/2017 07:00:00 PM,48,-122,8,19,27
31844,SpokaneStBridge,08/19/2017 08:00:00 PM,48,-122,7,9,16
31845,SpokaneStBridge,08/19/2017 09:00:00 PM,48,-122,11,6,17
31846,SpokaneStBridge,08/19/2017 10:00:00 PM,48,-122,14,4,18
31847,SpokaneStBridge,08/19/2017 11:00:00 PM,48,-122,0,4,4
31848,SpokaneStBridge,08/20/2017 12:00:00 AM,48,-122,2,4,6
31849,SpokaneStBridge,08/20/2017 01:00:00 AM,48,-122,4,4,8
31850,SpokaneStBridge,08/20/2017 02:00:00 AM,48,-122,0,3,3
31851,SpokaneStBridge,08/20/2017 03:00:00 AM,48,-122,1,1,2
31852,SpokaneStBridge,08/20/2017 04:00:00 AM,48,-122,1,3,4
31853,SpokaneStBridge,08/20/2017 05:00:00 AM,48,-122,5,1,6
31854,SpokaneStBridge,08/20/2017 06:00:00 AM,48,-122,5,2,7
31855,SpokaneStBridge,08/20/2017 07:00:00 AM,48,-122,7,3,10
31856,SpokaneStBridge,08/20/2017 08:00:00 AM,48,-122,19,11,30
31857,SpokaneStBridge,08/20/2017 09:00:00 AM,48,-122,18,17,35
31858,SpokaneStBridge,08/20/2017 10:00:00 AM,48,-122,19,16,35
31859,SpokaneStBridge,08/20/2017 11:00:00 AM,48,-122,14,23,37
31860,SpokaneStBridge,08/20/2017 12:00:00 PM,48,-122,22,35,57
31861,SpokaneStBridge,08/20/2017 01:00:00 PM,48,-122,38,37,75
31862,SpokaneStBridge,08/20/2017 02:00:00 PM,48,-122,22,26,48
31863,SpokaneStBridge,08/20/2017 03:00:00 PM,48,-122,18,23,41
31864,SpokaneStBridge,08/20/2017 04:00:00 PM,48,-122,33,29,62
31865,SpokaneStBridge,08/20/2017 05:00:00 PM,48,-122,20,18,38
31866,SpokaneStBridge,08/20/2017 06:00:00 PM,48,-122,22,13,35
31867,SpokaneStBridge,08/20/2017 07:00:00 PM,48,-122,7,12,19
31868,SpokaneStBridge,08/20/2017 08:00:00 PM,48,-122,1,15,16
31869,SpokaneStBridge,08/20/2017 09:00:00 PM,48,-122,4,17,21
31870,SpokaneStBridge,08/20/2017 10:00:00 PM,48,-122,1,4,5
31871,SpokaneStBridge,08/20/2017 11:00:00 PM,48,-122,3,2,5
31872,SpokaneStBridge,08/21/2017 12:00:00 AM,48,-122,4,2,6
31873,SpokaneStBridge,08/21/2017 01:00:00 AM,48,-122,1,0,1
31874,SpokaneStBridge,08/21/2017 02:00:00 AM,48,-122,0,1,1
31875,SpokaneStBridge,08/21/2017 03:00:00 AM,48,-122,1,3,4
31876,SpokaneStBridge,08/21/2017 04:00:00 AM,48,-122,3,2,5
31877,SpokaneStBridge,08/21/2017 05:00:00 AM,48,-122,31,3,34
31878,SpokaneStBridge,08/21/2017 06:00:00 AM,48,-122,56,10,66
31879,SpokaneStBridge,08/21/2017 07:00:00 AM,48,-122,125,12,137
31880,SpokaneStBridge,08/21/2017 08:00:00 AM,48,-122,95,16,111
31881,SpokaneStBridge,08/21/2017 09:00:00 AM,48,-122,40,5,45
31882,SpokaneStBridge,08/21/2017 10:00:00 AM,48,-122,23,9,32
31883,SpokaneStBridge,08/21/2017 11:00:00 AM,48,-122,19,8,27
31884,SpokaneStBridge,08/21/2017 12:00:00 PM,48,-122,13,11,24
31885,SpokaneStBridge,08/21/2017 01:00:00 PM,48,-122,18,12,30
31886,SpokaneStBridge,08/21/2017 02:00:00 PM,48,-122,18,22,40
31887,SpokaneStBridge,08/21/2017 03:00:00 PM,48,-122,15,42,57
31888,SpokaneStBridge,08/21/2017 04:00:00 PM,48,-122,13,82,95
31889,SpokaneStBridge,08/21/2017 05:00:00 PM,48,-122,15,145,160
31890,SpokaneStBridge,08/21/2017 06:00:00 PM,48,-122,12,90,102
31891,SpokaneStBridge,08/21/2017 07:00:00 PM,48,-122,6,28,34
31892,SpokaneStBridge,08/21/2017 08:00:00 PM,48,-122,6,13,19
31893,SpokaneStBridge,08/21/2017 09:00:00 PM,48,-122,0,10,10
31894,SpokaneStBridge,08/21/2017 10:00:00 PM,48,-122,2,3,5
31895,SpokaneStBridge,08/21/2017 11:00:00 PM,48,-122,3,1,4
31896,SpokaneStBridge,08/22/2017 12:00:00 AM,48,-122,0,1,1
31897,SpokaneStBridge,08/22/2017 01:00:00 AM,48,-122,0,4,4
31898,SpokaneStBridge,08/22/2017 02:00:00 AM,48,-122,1,0,1
31899,SpokaneStBridge,08/22/2017 03:00:00 AM,48,-122,1,1,2
31900,SpokaneStBridge,08/22/2017 04:00:00 AM,48,-122,5,1,6
31901,SpokaneStBridge,08/22/2017 05:00:00 AM,48,-122,27,6,33
31902,SpokaneStBridge,08/22/2017 06:00:00 AM,48,-122,47,10,57
31903,SpokaneStBridge,08/22/2017 07:00:00 AM,48,-122,160,17,177
31904,SpokaneStBridge,08/22/2017 08:00:00 AM,48,-122,125,16,141
31905,SpokaneStBridge,08/22/2017 09:00:00 AM,48,-122,64,7,71
31906,SpokaneStBridge,08/22/2017 10:00:00 AM,48,-122,29,6,35
31907,SpokaneStBridge,08/22/2017 11:00:00 AM,48,-122,12,12,24
31908,SpokaneStBridge,08/22/2017 12:00:00 PM,48,-122,15,11,26
31909,SpokaneStBridge,08/22/2017 01:00:00 PM,48,-122,21,21,42
31910,SpokaneStBridge,08/22/2017 02:00:00 PM,48,-122,11,13,24
31911,SpokaneStBridge,08/22/2017 03:00:00 PM,48,-122,18,46,64
31912,SpokaneStBridge,08/22/2017 04:00:00 PM,48,-122,11,111,122
31913,SpokaneStBridge,08/22/2017 05:00:00 PM,48,-122,22,186,208
31914,SpokaneStBridge,08/22/2017 06:00:00 PM,48,-122,13,99,112
31915,SpokaneStBridge,08/22/2017 07:00:00 PM,48,-122,12,38,50
31916,SpokaneStBridge,08/22/2017 08:00:00 PM,48,-122,15,22,37
31917,SpokaneStBridge,08/22/2017 09:00:00 PM,48,-122,1,7,8
31918,SpokaneStBridge,08/22/2017 10:00:00 PM,48,-122,5,3,8
31919,SpokaneStBridge,08/22/2017 11:00:00 PM,48,-122,0,6,6
31920,SpokaneStBridge,08/23/2017 12:00:00 AM,48,-122,1,2,3
31921,SpokaneStBridge,08/23/2017 01:00:00 AM,48,-122,1,0,1
31922,SpokaneStBridge,08/23/2017 02:00:00 AM,48,-122,1,3,4
31923,SpokaneStBridge,08/23/2017 03:00:00 AM,48,-122,1,1,2
31924,SpokaneStBridge,08/23/2017 04:00:00 AM,48,-122,8,2,10
31925,SpokaneStBridge,08/23/2017 05:00:00 AM,48,-122,28,2,30
31926,SpokaneStBridge,08/23/2017 06:00:00 AM,48,-122,77,14,91
31927,SpokaneStBridge,08/23/2017 07:00:00 AM,48,-122,147,20,167
31928,SpokaneStBridge,08/23/2017 08:00:00 AM,48,-122,139,13,152
31929,SpokaneStBridge,08/23/2017 09:00:00 AM,48,-122,57,11,68
31930,SpokaneStBridge,08/23/2017 10:00:00 AM,48,-122,25,6,31
31931,SpokaneStBridge,08/23/2017 11:00:00 AM,48,-122,14,6,20
31932,SpokaneStBridge,08/23/2017 12:00:00 PM,48,-122,14,12,26
31933,SpokaneStBridge,08/23/2017 01:00:00 PM,48,-122,21,20,41
31934,SpokaneStBridge,08/23/2017 02:00:00 PM,48,-122,13,21,34
31935,SpokaneStBridge,08/23/2017 03:00:00 PM,48,-122,18,54,72
31936,SpokaneStBridge,08/23/2017 04:00:00 PM,48,-122,23,99,122
31937,SpokaneStBridge,08/23/2017 05:00:00 PM,48,-122,19,165,184
31938,SpokaneStBridge,08/23/2017 06:00:00 PM,48,-122,25,109,134
31939,SpokaneStBridge,08/23/2017 07:00:00 PM,48,-122,17,42,59
31940,SpokaneStBridge,08/23/2017 08:00:00 PM,48,-122,13,17,30
31941,SpokaneStBridge,08/23/2017 09:00:00 PM,48,-122,2,12,14
31942,SpokaneStBridge,08/23/2017 10:00:00 PM,48,-122,2,3,5
31943,SpokaneStBridge,08/23/2017 11:00:00 PM,48,-122,0,5,5
31944,SpokaneStBridge,08/24/2017 12:00:00 AM,48,-122,4,2,6
31945,SpokaneStBridge,08/24/2017 01:00:00 AM,48,-122,2,2,4
31946,SpokaneStBridge,08/24/2017 02:00:00 AM,48,-122,0,0,0
31947,SpokaneStBridge,08/24/2017 03:00:00 AM,48,-122,2,1,3
31948,SpokaneStBridge,08/24/2017 04:00:00 AM,48,-122,2,3,5
31949,SpokaneStBridge,08/24/2017 05:00:00 AM,48,-122,24,3,27
31950,SpokaneStBridge,08/24/2017 06:00:00 AM,48,-122,50,11,61
31951,SpokaneStBridge,08/24/2017 07:00:00 AM,48,-122,145,13,158
31952,SpokaneStBridge,08/24/2017 08:00:00 AM,48,-122,148,20,168
31953,SpokaneStBridge,08/24/2017 09:00:00 AM,48,-122,47,6,53
31954,SpokaneStBridge,08/24/2017 10:00:00 AM,48,-122,27,5,32
31955,SpokaneStBridge,08/24/2017 11:00:00 AM,48,-122,15,12,27
31956,SpokaneStBridge,08/24/2017 12:00:00 PM,48,-122,21,15,36
31957,SpokaneStBridge,08/24/2017 01:00:00 PM,48,-122,15,17,32
31958,SpokaneStBridge,08/24/2017 02:00:00 PM,48,-122,18,14,32
31959,SpokaneStBridge,08/24/2017 03:00:00 PM,48,-122,13,49,62
31960,SpokaneStBridge,08/24/2017 04:00:00 PM,48,-122,21,96,117
31961,SpokaneStBridge,08/24/2017 05:00:00 PM,48,-122,25,147,172
31962,SpokaneStBridge,08/24/2017 06:00:00 PM,48,-122,16,84,100
31963,SpokaneStBridge,08/24/2017 07:00:00 PM,48,-122,11,48,59
31964,SpokaneStBridge,08/24/2017 08:00:00 PM,48,-122,1,18,19
31965,SpokaneStBridge,08/24/2017 09:00:00 PM,48,-122,2,21,23
31966,SpokaneStBridge,08/24/2017 10:00:00 PM,48,-122,3,5,8
31967,SpokaneStBridge,08/24/2017 11:00:00 PM,48,-122,1,6,7
31968,SpokaneStBridge,08/25/2017 12:00:00 AM,48,-122,2,6,8
31969,SpokaneStBridge,08/25/2017 01:00:00 AM,48,-122,1,3,4
31970,SpokaneStBridge,08/25/2017 02:00:00 AM,48,-122,1,1,2
31971,SpokaneStBridge,08/25/2017 03:00:00 AM,48,-122,3,1,4
31972,SpokaneStBridge,08/25/2017 04:00:00 AM,48,-122,4,1,5
31973,SpokaneStBridge,08/25/2017 05:00:00 AM,48,-122,13,2,15
31974,SpokaneStBridge,08/25/2017 06:00:00 AM,48,-122,53,5,58
31975,SpokaneStBridge,08/25/2017 07:00:00 AM,48,-122,125,7,132
31976,SpokaneStBridge,08/25/2017 08:00:00 AM,48,-122,119,12,131
31977,SpokaneStBridge,08/25/2017 09:00:00 AM,48,-122,47,5,52
31978,SpokaneStBridge,08/25/2017 10:00:00 AM,48,-122,20,9,29
31979,SpokaneStBridge,08/25/2017 11:00:00 AM,48,-122,16,13,29
31980,SpokaneStBridge,08/25/2017 12:00:00 PM,48,-122,14,17,31
31981,SpokaneStBridge,08/25/2017 01:00:00 PM,48,-122,14,17,31
31982,SpokaneStBridge,08/25/2017 02:00:00 PM,48,-122,18,33,51
31983,SpokaneStBridge,08/25/2017 03:00:00 PM,48,-122,25,56,81
31984,SpokaneStBridge,08/25/2017 04:00:00 PM,48,-122,20,109,129
31985,SpokaneStBridge,08/25/2017 05:00:00 PM,48,-122,28,118,146
31986,SpokaneStBridge,08/25/2017 06:00:00 PM,48,-122,8,68,76
31987,SpokaneStBridge,08/25/2017 07:00:00 PM,48,-122,14,33,47
31988,SpokaneStBridge,08/25/2017 08:00:00 PM,48,-122,6,20,26
31989,SpokaneStBridge,08/25/2017 09:00:00 PM,48,-122,6,9,15
31990,SpokaneStBridge,08/25/2017 10:00:00 PM,48,-122,2,10,12
31991,SpokaneStBridge,08/25/2017 11:00:00 PM,48,-122,5,7,12
31992,SpokaneStBridge,08/26/2017 12:00:00 AM,48,-122,1,1,2
31993,SpokaneStBridge,08/26/2017 01:00:00 AM,48,-122,1,1,2
31994,SpokaneStBridge,08/26/2017 02:00:00 AM,48,-122,1,4,5
31995,SpokaneStBridge,08/26/2017 03:00:00 AM,48,-122,2,2,4
31996,SpokaneStBridge,08/26/2017 04:00:00 AM,48,-122,1,0,1
31997,SpokaneStBridge,08/26/2017 05:00:00 AM,48,-122,5,0,5
31998,SpokaneStBridge,08/26/2017 06:00:00 AM,48,-122,10,4,14
31999,SpokaneStBridge,08/26/2017 07:00:00 AM,48,-122,11,7,18
32000,SpokaneStBridge,08/26/2017 08:00:00 AM,48,-122,21,7,28
32001,SpokaneStBridge,08/26/2017 09:00:00 AM,48,-122,22,22,44
32002,SpokaneStBridge,08/26/2017 10:00:00 AM,48,-122,40,21,61
32003,SpokaneStBridge,08/26/2017 11:00:00 AM,48,-122,43,39,82
32004,SpokaneStBridge,08/26/2017 12:00:00 PM,48,-122,45,33,78
32005,SpokaneStBridge,08/26/2017 01:00:00 PM,48,-122,33,39,72
32006,SpokaneStBridge,08/26/2017 02:00:00 PM,48,-122,31,32,63
32007,SpokaneStBridge,08/26/2017 03:00:00 PM,48,-122,31,31,62
32008,SpokaneStBridge,08/26/2017 04:00:00 PM,48,-122,30,34,64
32009,SpokaneStBridge,08/26/2017 05:00:00 PM,48,-122,16,19,35
32010,SpokaneStBridge,08/26/2017 06:00:00 PM,48,-122,21,30,51
32011,SpokaneStBridge,08/26/2017 07:00:00 PM,48,-122,9,19,28
32012,SpokaneStBridge,08/26/2017 08:00:00 PM,48,-122,13,13,26
32013,SpokaneStBridge,08/26/2017 09:00:00 PM,48,-122,1,2,3
32014,SpokaneStBridge,08/26/2017 10:00:00 PM,48,-122,4,8,12
32015,SpokaneStBridge,08/26/2017 11:00:00 PM,48,-122,0,5,5
32016,SpokaneStBridge,08/27/2017 12:00:00 AM,48,-122,2,3,5
32017,SpokaneStBridge,08/27/2017 01:00:00 AM,48,-122,1,3,4
32018,SpokaneStBridge,08/27/2017 02:00:00 AM,48,-122,0,1,1
32019,SpokaneStBridge,08/27/2017 03:00:00 AM,48,-122,1,1,2
32020,SpokaneStBridge,08/27/2017 04:00:00 AM,48,-122,0,1,1
32021,SpokaneStBridge,08/27/2017 05:00:00 AM,48,-122,3,1,4
32022,SpokaneStBridge,08/27/2017 06:00:00 AM,48,-122,4,0,4
32023,SpokaneStBridge,08/27/2017 07:00:00 AM,48,-122,5,3,8
32024,SpokaneStBridge,08/27/2017 08:00:00 AM,48,-122,19,14,33
32025,SpokaneStBridge,08/27/2017 09:00:00 AM,48,-122,23,22,45
32026,SpokaneStBridge,08/27/2017 10:00:00 AM,48,-122,36,32,68
32027,SpokaneStBridge,08/27/2017 11:00:00 AM,48,-122,26,47,73
32028,SpokaneStBridge,08/27/2017 12:00:00 PM,48,-122,37,42,79
32029,SpokaneStBridge,08/27/2017 01:00:00 PM,48,-122,38,30,68
32030,SpokaneStBridge,08/27/2017 02:00:00 PM,48,-122,35,34,69
32031,SpokaneStBridge,08/27/2017 03:00:00 PM,48,-122,34,34,68
32032,SpokaneStBridge,08/27/2017 04:00:00 PM,48,-122,23,31,54
32033,SpokaneStBridge,08/27/2017 05:00:00 PM,48,-122,31,24,55
32034,SpokaneStBridge,08/27/2017 06:00:00 PM,48,-122,22,15,37
32035,SpokaneStBridge,08/27/2017 07:00:00 PM,48,-122,10,13,23
32036,SpokaneStBridge,08/27/2017 08:00:00 PM,48,-122,2,8,10
32037,SpokaneStBridge,08/27/2017 09:00:00 PM,48,-122,3,17,20
32038,SpokaneStBridge,08/27/2017 10:00:00 PM,48,-122,2,2,4
32039,SpokaneStBridge,08/27/2017 11:00:00 PM,48,-122,2,4,6
32040,SpokaneStBridge,08/28/2017 12:00:00 AM,48,-122,1,1,2
32041,SpokaneStBridge,08/28/2017 01:00:00 AM,48,-122,2,2,4
32042,SpokaneStBridge,08/28/2017 02:00:00 AM,48,-122,1,1,2
32043,SpokaneStBridge,08/28/2017 03:00:00 AM,48,-122,1,0,1
32044,SpokaneStBridge,08/28/2017 04:00:00 AM,48,-122,7,3,10
32045,SpokaneStBridge,08/28/2017 05:00:00 AM,48,-122,23,2,25
32046,SpokaneStBridge,08/28/2017 06:00:00 AM,48,-122,62,13,75
32047,SpokaneStBridge,08/28/2017 07:00:00 AM,48,-122,167,14,181
32048,SpokaneStBridge,08/28/2017 08:00:00 AM,48,-122,126,28,154
32049,SpokaneStBridge,08/28/2017 09:00:00 AM,48,-122,48,4,52
32050,SpokaneStBridge,08/28/2017 10:00:00 AM,48,-122,18,7,25
32051,SpokaneStBridge,08/28/2017 11:00:00 AM,48,-122,8,8,16
32052,SpokaneStBridge,08/28/2017 12:00:00 PM,48,-122,10,12,22
32053,SpokaneStBridge,08/28/2017 01:00:00 PM,48,-122,9,12,21
32054,SpokaneStBridge,08/28/2017 02:00:00 PM,48,-122,9,23,32
32055,SpokaneStBridge,08/28/2017 03:00:00 PM,48,-122,21,36,57
32056,SpokaneStBridge,08/28/2017 04:00:00 PM,48,-122,13,92,105
32057,SpokaneStBridge,08/28/2017 05:00:00 PM,48,-122,20,170,190
32058,SpokaneStBridge,08/28/2017 06:00:00 PM,48,-122,14,101,115
32059,SpokaneStBridge,08/28/2017 07:00:00 PM,48,-122,12,53,65
32060,SpokaneStBridge,08/28/2017 08:00:00 PM,48,-122,9,17,26
32061,SpokaneStBridge,08/28/2017 09:00:00 PM,48,-122,7,4,11
32062,SpokaneStBridge,08/28/2017 10:00:00 PM,48,-122,4,2,6
32063,SpokaneStBridge,08/28/2017 11:00:00 PM,48,-122,1,2,3
32064,SpokaneStBridge,08/29/2017 12:00:00 AM,48,-122,1,0,1
32065,SpokaneStBridge,08/29/2017 01:00:00 AM,48,-122,2,3,5
32066,SpokaneStBridge,08/29/2017 02:00:00 AM,48,-122,1,1,2
32067,SpokaneStBridge,08/29/2017 03:00:00 AM,48,-122,0,0,0
32068,SpokaneStBridge,08/29/2017 04:00:00 AM,48,-122,2,3,5
32069,SpokaneStBridge,08/29/2017 05:00:00 AM,48,-122,29,5,34
32070,SpokaneStBridge,08/29/2017 06:00:00 AM,48,-122,68,14,82
32071,SpokaneStBridge,08/29/2017 07:00:00 AM,48,-122,163,15,178
32072,SpokaneStBridge,08/29/2017 08:00:00 AM,48,-122,146,12,158
32073,SpokaneStBridge,08/29/2017 09:00:00 AM,48,-122,40,10,50
32074,SpokaneStBridge,08/29/2017 10:00:00 AM,48,-122,27,9,36
32075,SpokaneStBridge,08/29/2017 11:00:00 AM,48,-122,13,10,23
32076,SpokaneStBridge,08/29/2017 12:00:00 PM,48,-122,11,15,26
32077,SpokaneStBridge,08/29/2017 01:00:00 PM,48,-122,21,14,35
32078,SpokaneStBridge,08/29/2017 02:00:00 PM,48,-122,14,21,35
32079,SpokaneStBridge,08/29/2017 03:00:00 PM,48,-122,25,39,64
32080,SpokaneStBridge,08/29/2017 04:00:00 PM,48,-122,23,112,135
32081,SpokaneStBridge,08/29/2017 05:00:00 PM,48,-122,36,166,202
32082,SpokaneStBridge,08/29/2017 06:00:00 PM,48,-122,20,117,137
32083,SpokaneStBridge,08/29/2017 07:00:00 PM,48,-122,4,53,57
32084,SpokaneStBridge,08/29/2017 08:00:00 PM,48,-122,5,17,22
32085,SpokaneStBridge,08/29/2017 09:00:00 PM,48,-122,4,13,17
32086,SpokaneStBridge,08/29/2017 10:00:00 PM,48,-122,1,8,9
32087,SpokaneStBridge,08/29/2017 11:00:00 PM,48,-122,1,2,3
32088,SpokaneStBridge,08/30/2017 12:00:00 AM,48,-122,3,4,7
32089,SpokaneStBridge,08/30/2017 01:00:00 AM,48,-122,2,1,3
32090,SpokaneStBridge,08/30/2017 02:00:00 AM,48,-122,0,2,2
32091,SpokaneStBridge,08/30/2017 03:00:00 AM,48,-122,0,1,1
32092,SpokaneStBridge,08/30/2017 04:00:00 AM,48,-122,3,1,4
32093,SpokaneStBridge,08/30/2017 05:00:00 AM,48,-122,25,3,28
32094,SpokaneStBridge,08/30/2017 06:00:00 AM,48,-122,65,15,80
32095,SpokaneStBridge,08/30/2017 07:00:00 AM,48,-122,163,25,188
32096,SpokaneStBridge,08/30/2017 08:00:00 AM,48,-122,145,20,165
32097,SpokaneStBridge,08/30/2017 09:00:00 AM,48,-122,47,12,59
32098,SpokaneStBridge,08/30/2017 10:00:00 AM,48,-122,18,4,22
32099,SpokaneStBridge,08/30/2017 11:00:00 AM,48,-122,17,7,24
32100,SpokaneStBridge,08/30/2017 12:00:00 PM,48,-122,11,11,22
32101,SpokaneStBridge,08/30/2017 01:00:00 PM,48,-122,14,9,23
32102,SpokaneStBridge,08/30/2017 02:00:00 PM,48,-122,14,24,38
32103,SpokaneStBridge,08/30/2017 03:00:00 PM,48,-122,24,48,72
32104,SpokaneStBridge,08/30/2017 04:00:00 PM,48,-122,24,97,121
32105,SpokaneStBridge,08/30/2017 05:00:00 PM,48,-122,22,187,209
32106,SpokaneStBridge,08/30/2017 06:00:00 PM,48,-122,24,117,141
32107,SpokaneStBridge,08/30/2017 07:00:00 PM,48,-122,21,48,69
32108,SpokaneStBridge,08/30/2017 08:00:00 PM,48,-122,19,19,38
32109,SpokaneStBridge,08/30/2017 09:00:00 PM,48,-122,3,14,17
32110,SpokaneStBridge,08/30/2017 10:00:00 PM,48,-122,1,7,8
32111,SpokaneStBridge,08/30/2017 11:00:00 PM,48,-122,1,4,5
32112,SpokaneStBridge,08/31/2017 12:00:00 AM,48,-122,1,0,1
32113,SpokaneStBridge,08/31/2017 01:00:00 AM,48,-122,2,1,3
32114,SpokaneStBridge,08/31/2017 02:00:00 AM,48,-122,1,0,1
32115,SpokaneStBridge,08/31/2017 03:00:00 AM,48,-122,2,2,4
32116,SpokaneStBridge,08/31/2017 04:00:00 AM,48,-122,2,2,4
32117,SpokaneStBridge,08/31/2017 05:00:00 AM,48,-122,19,4,23
32118,SpokaneStBridge,08/31/2017 06:00:00 AM,48,-122,52,11,63
32119,SpokaneStBridge,08/31/2017 07:00:00 AM,48,-122,120,20,140
32120,SpokaneStBridge,08/31/2017 08:00:00 AM,48,-122,142,11,153
32121,SpokaneStBridge,08/31/2017 09:00:00 AM,48,-122,41,2,43
32122,SpokaneStBridge,08/31/2017 10:00:00 AM,48,-122,23,5,28
32123,SpokaneStBridge,08/31/2017 11:00:00 AM,48,-122,10,3,13
32124,SpokaneStBridge,08/31/2017 12:00:00 PM,48,-122,7,5,12
32125,SpokaneStBridge,08/31/2017 01:00:00 PM,48,-122,8,9,17
32126,SpokaneStBridge,08/31/2017 02:00:00 PM,48,-122,12,16,28
32127,SpokaneStBridge,08/31/2017 03:00:00 PM,48,-122,19,26,45
32128,SpokaneStBridge,08/31/2017 04:00:00 PM,48,-122,16,86,102
32129,SpokaneStBridge,08/31/2017 05:00:00 PM,48,-122,26,151,177
32130,SpokaneStBridge,08/31/2017 06:00:00 PM,48,-122,22,111,133
32131,SpokaneStBridge,08/31/2017 07:00:00 PM,48,-122,17,49,66
32132,SpokaneStBridge,08/31/2017 08:00:00 PM,48,-122,7,16,23
32133,SpokaneStBridge,08/31/2017 09:00:00 PM,48,-122,11,10,21
32134,SpokaneStBridge,08/31/2017 10:00:00 PM,48,-122,3,8,11
32135,SpokaneStBridge,08/31/2017 11:00:00 PM,48,-122,2,5,7
32136,SpokaneStBridge,09/01/2017 12:00:00 AM,48,-122,4,4,8
32137,SpokaneStBridge,09/01/2017 01:00:00 AM,48,-122,0,2,2
32138,SpokaneStBridge,09/01/2017 02:00:00 AM,48,-122,0,1,1
32139,SpokaneStBridge,09/01/2017 03:00:00 AM,48,-122,3,1,4
32140,SpokaneStBridge,09/01/2017 04:00:00 AM,48,-122,3,1,4
32141,SpokaneStBridge,09/01/2017 05:00:00 AM,48,-122,18,0,18
32142,SpokaneStBridge,09/01/2017 06:00:00 AM,48,-122,42,8,50
32143,SpokaneStBridge,09/01/2017 07:00:00 AM,48,-122,105,14,119
32144,SpokaneStBridge,09/01/2017 08:00:00 AM,48,-122,90,11,101
32145,SpokaneStBridge,09/01/2017 09:00:00 AM,48,-122,48,14,62
32146,SpokaneStBridge,09/01/2017 10:00:00 AM,48,-122,31,16,47
32147,SpokaneStBridge,09/01/2017 11:00:00 AM,48,-122,22,16,38
32148,SpokaneStBridge,09/01/2017 12:00:00 PM,48,-122,24,13,37
32149,SpokaneStBridge,09/01/2017 01:00:00 PM,48,-122,18,26,44
32150,SpokaneStBridge,09/01/2017 02:00:00 PM,48,-122,12,41,53
32151,SpokaneStBridge,09/01/2017 03:00:00 PM,48,-122,23,61,84
32152,SpokaneStBridge,09/01/2017 04:00:00 PM,48,-122,22,85,107
32153,SpokaneStBridge,09/01/2017 05:00:00 PM,48,-122,12,96,108
32154,SpokaneStBridge,09/01/2017 06:00:00 PM,48,-122,12,60,72
32155,SpokaneStBridge,09/01/2017 07:00:00 PM,48,-122,10,25,35
32156,SpokaneStBridge,09/01/2017 08:00:00 PM,48,-122,12,13,25
32157,SpokaneStBridge,09/01/2017 09:00:00 PM,48,-122,9,3,12
32158,SpokaneStBridge,09/01/2017 10:00:00 PM,48,-122,1,10,11
32159,SpokaneStBridge,09/01/2017 11:00:00 PM,48,-122,2,6,8
32160,SpokaneStBridge,09/02/2017 12:00:00 AM,48,-122,4,1,5
32161,SpokaneStBridge,09/02/2017 01:00:00 AM,48,-122,5,4,9
32162,SpokaneStBridge,09/02/2017 02:00:00 AM,48,-122,1,1,2
32163,SpokaneStBridge,09/02/2017 03:00:00 AM,48,-122,2,3,5
32164,SpokaneStBridge,09/02/2017 04:00:00 AM,48,-122,0,1,1
32165,SpokaneStBridge,09/02/2017 05:00:00 AM,48,-122,3,1,4
32166,SpokaneStBridge,09/02/2017 06:00:00 AM,48,-122,5,2,7
32167,SpokaneStBridge,09/02/2017 07:00:00 AM,48,-122,13,7,20
32168,SpokaneStBridge,09/02/2017 08:00:00 AM,48,-122,17,26,43
32169,SpokaneStBridge,09/02/2017 09:00:00 AM,48,-122,19,16,35
32170,SpokaneStBridge,09/02/2017 10:00:00 AM,48,-122,22,19,41
32171,SpokaneStBridge,09/02/2017 11:00:00 AM,48,-122,23,39,62
32172,SpokaneStBridge,09/02/2017 12:00:00 PM,48,-122,30,19,49
32173,SpokaneStBridge,09/02/2017 01:00:00 PM,48,-122,34,35,69
32174,SpokaneStBridge,09/02/2017 02:00:00 PM,48,-122,40,38,78
32175,SpokaneStBridge,09/02/2017 03:00:00 PM,48,-122,19,28,47
32176,SpokaneStBridge,09/02/2017 04:00:00 PM,48,-122,15,29,44
32177,SpokaneStBridge,09/02/2017 05:00:00 PM,48,-122,23,31,54
32178,SpokaneStBridge,09/02/2017 06:00:00 PM,48,-122,12,30,42
32179,SpokaneStBridge,09/02/2017 07:00:00 PM,48,-122,6,11,17
32180,SpokaneStBridge,09/02/2017 08:00:00 PM,48,-122,7,7,14
32181,SpokaneStBridge,09/02/2017 09:00:00 PM,48,-122,4,3,7
32182,SpokaneStBridge,09/02/2017 10:00:00 PM,48,-122,2,6,8
32183,SpokaneStBridge,09/02/2017 11:00:00 PM,48,-122,0,7,7
32184,SpokaneStBridge,09/03/2017 12:00:00 AM,48,-122,2,7,9
32185,SpokaneStBridge,09/03/2017 01:00:00 AM,48,-122,3,1,4
32186,SpokaneStBridge,09/03/2017 02:00:00 AM,48,-122,1,3,4
32187,SpokaneStBridge,09/03/2017 03:00:00 AM,48,-122,1,5,6
32188,SpokaneStBridge,09/03/2017 04:00:00 AM,48,-122,0,0,0
32189,SpokaneStBridge,09/03/2017 05:00:00 AM,48,-122,4,1,5
32190,SpokaneStBridge,09/03/2017 06:00:00 AM,48,-122,5,2,7
32191,SpokaneStBridge,09/03/2017 07:00:00 AM,48,-122,10,5,15
32192,SpokaneStBridge,09/03/2017 08:00:00 AM,48,-122,27,18,45
32193,SpokaneStBridge,09/03/2017 09:00:00 AM,48,-122,25,36,61
32194,SpokaneStBridge,09/03/2017 10:00:00 AM,48,-122,28,33,61
32195,SpokaneStBridge,09/03/2017 11:00:00 AM,48,-122,27,24,51
32196,SpokaneStBridge,09/03/2017 12:00:00 PM,48,-122,32,30,62
32197,SpokaneStBridge,09/03/2017 01:00:00 PM,48,-122,24,13,37
32198,SpokaneStBridge,09/03/2017 02:00:00 PM,48,-122,20,25,45
32199,SpokaneStBridge,09/03/2017 03:00:00 PM,48,-122,17,19,36
32200,SpokaneStBridge,09/03/2017 04:00:00 PM,48,-122,22,25,47
32201,SpokaneStBridge,09/03/2017 05:00:00 PM,48,-122,7,22,29
32202,SpokaneStBridge,09/03/2017 06:00:00 PM,48,-122,12,21,33
32203,SpokaneStBridge,09/03/2017 07:00:00 PM,48,-122,9,14,23
32204,SpokaneStBridge,09/03/2017 08:00:00 PM,48,-122,19,9,28
32205,SpokaneStBridge,09/03/2017 09:00:00 PM,48,-122,4,1,5
32206,SpokaneStBridge,09/03/2017 10:00:00 PM,48,-122,7,1,8
32207,SpokaneStBridge,09/03/2017 11:00:00 PM,48,-122,1,3,4
32208,SpokaneStBridge,09/04/2017 12:00:00 AM,48,-122,2,3,5
32209,SpokaneStBridge,09/04/2017 01:00:00 AM,48,-122,0,0,0
32210,SpokaneStBridge,09/04/2017 02:00:00 AM,48,-122,2,1,3
32211,SpokaneStBridge,09/04/2017 03:00:00 AM,48,-122,1,2,3
32212,SpokaneStBridge,09/04/2017 04:00:00 AM,48,-122,1,0,1
32213,SpokaneStBridge,09/04/2017 05:00:00 AM,48,-122,6,0,6
32214,SpokaneStBridge,09/04/2017 06:00:00 AM,48,-122,8,5,13
32215,SpokaneStBridge,09/04/2017 07:00:00 AM,48,-122,16,7,23
32216,SpokaneStBridge,09/04/2017 08:00:00 AM,48,-122,27,23,50
32217,SpokaneStBridge,09/04/2017 09:00:00 AM,48,-122,20,54,74
32218,SpokaneStBridge,09/04/2017 10:00:00 AM,48,-122,36,33,69
32219,SpokaneStBridge,09/04/2017 11:00:00 AM,48,-122,35,48,83
32220,SpokaneStBridge,09/04/2017 12:00:00 PM,48,-122,41,36,77
32221,SpokaneStBridge,09/04/2017 01:00:00 PM,48,-122,23,22,45
32222,SpokaneStBridge,09/04/2017 02:00:00 PM,48,-122,30,32,62
32223,SpokaneStBridge,09/04/2017 03:00:00 PM,48,-122,35,14,49
32224,SpokaneStBridge,09/04/2017 04:00:00 PM,48,-122,40,23,63
32225,SpokaneStBridge,09/04/2017 05:00:00 PM,48,-122,16,27,43
32226,SpokaneStBridge,09/04/2017 06:00:00 PM,48,-122,9,15,24
32227,SpokaneStBridge,09/04/2017 07:00:00 PM,48,-122,11,15,26
32228,SpokaneStBridge,09/04/2017 08:00:00 PM,48,-122,4,5,9
32229,SpokaneStBridge,09/04/2017 09:00:00 PM,48,-122,2,5,7
32230,SpokaneStBridge,09/04/2017 10:00:00 PM,48,-122,2,9,11
32231,SpokaneStBridge,09/04/2017 11:00:00 PM,48,-122,1,1,2
32232,SpokaneStBridge,09/05/2017 12:00:00 AM,48,-122,1,2,3
32233,SpokaneStBridge,09/05/2017 01:00:00 AM,48,-122,1,2,3
32234,SpokaneStBridge,09/05/2017 02:00:00 AM,48,-122,3,1,4
32235,SpokaneStBridge,09/05/2017 03:00:00 AM,48,-122,2,2,4
32236,SpokaneStBridge,09/05/2017 04:00:00 AM,48,-122,2,3,5
32237,SpokaneStBridge,09/05/2017 05:00:00 AM,48,-122,26,4,30
32238,SpokaneStBridge,09/05/2017 06:00:00 AM,48,-122,57,13,70
32239,SpokaneStBridge,09/05/2017 07:00:00 AM,48,-122,160,15,175
32240,SpokaneStBridge,09/05/2017 08:00:00 AM,48,-122,117,16,133
32241,SpokaneStBridge,09/05/2017 09:00:00 AM,48,-122,29,3,32
32242,SpokaneStBridge,09/05/2017 10:00:00 AM,48,-122,23,11,34
32243,SpokaneStBridge,09/05/2017 11:00:00 AM,48,-122,9,4,13
32244,SpokaneStBridge,09/05/2017 12:00:00 PM,48,-122,12,8,20
32245,SpokaneStBridge,09/05/2017 01:00:00 PM,48,-122,6,4,10
32246,SpokaneStBridge,09/05/2017 02:00:00 PM,48,-122,10,14,24
32247,SpokaneStBridge,09/05/2017 03:00:00 PM,48,-122,10,35,45
32248,SpokaneStBridge,09/05/2017 04:00:00 PM,48,-122,17,83,100
32249,SpokaneStBridge,09/05/2017 05:00:00 PM,48,-122,17,136,153
32250,SpokaneStBridge,09/05/2017 06:00:00 PM,48,-122,8,78,86
32251,SpokaneStBridge,09/05/2017 07:00:00 PM,48,-122,5,35,40
32252,SpokaneStBridge,09/05/2017 08:00:00 PM,48,-122,7,11,18
32253,SpokaneStBridge,09/05/2017 09:00:00 PM,48,-122,2,6,8
32254,SpokaneStBridge,09/05/2017 10:00:00 PM,48,-122,2,8,10
32255,SpokaneStBridge,09/05/2017 11:00:00 PM,48,-122,1,3,4
32256,SpokaneStBridge,09/06/2017 12:00:00 AM,48,-122,0,1,1
32257,SpokaneStBridge,09/06/2017 01:00:00 AM,48,-122,2,2,4
32258,SpokaneStBridge,09/06/2017 02:00:00 AM,48,-122,2,1,3
32259,SpokaneStBridge,09/06/2017 03:00:00 AM,48,-122,1,3,4
32260,SpokaneStBridge,09/06/2017 04:00:00 AM,48,-122,5,2,7
32261,SpokaneStBridge,09/06/2017 05:00:00 AM,48,-122,25,2,27
32262,SpokaneStBridge,09/06/2017 06:00:00 AM,48,-122,45,17,62
32263,SpokaneStBridge,09/06/2017 07:00:00 AM,48,-122,106,18,124
32264,SpokaneStBridge,09/06/2017 08:00:00 AM,48,-122,106,8,114
32265,SpokaneStBridge,09/06/2017 09:00:00 AM,48,-122,44,5,49
32266,SpokaneStBridge,09/06/2017 10:00:00 AM,48,-122,15,7,22
32267,SpokaneStBridge,09/06/2017 11:00:00 AM,48,-122,16,1,17
32268,SpokaneStBridge,09/06/2017 12:00:00 PM,48,-122,13,10,23
32269,SpokaneStBridge,09/06/2017 01:00:00 PM,48,-122,12,12,24
32270,SpokaneStBridge,09/06/2017 02:00:00 PM,48,-122,8,12,20
32271,SpokaneStBridge,09/06/2017 03:00:00 PM,48,-122,10,29,39
32272,SpokaneStBridge,09/06/2017 04:00:00 PM,48,-122,11,67,78
32273,SpokaneStBridge,09/06/2017 05:00:00 PM,48,-122,19,121,140
32274,SpokaneStBridge,09/06/2017 06:00:00 PM,48,-122,13,73,86
32275,SpokaneStBridge,09/06/2017 07:00:00 PM,48,-122,5,36,41
32276,SpokaneStBridge,09/06/2017 08:00:00 PM,48,-122,4,13,17
32277,SpokaneStBridge,09/06/2017 09:00:00 PM,48,-122,2,6,8
32278,SpokaneStBridge,09/06/2017 10:00:00 PM,48,-122,2,5,7
32279,SpokaneStBridge,09/06/2017 11:00:00 PM,48,-122,2,2,4
32280,SpokaneStBridge,09/07/2017 12:00:00 AM,48,-122,1,0,1
32281,SpokaneStBridge,09/07/2017 01:00:00 AM,48,-122,0,1,1
32282,SpokaneStBridge,09/07/2017 02:00:00 AM,48,-122,0,2,2
32283,SpokaneStBridge,09/07/2017 03:00:00 AM,48,-122,1,0,1
32284,SpokaneStBridge,09/07/2017 04:00:00 AM,48,-122,4,1,5
32285,SpokaneStBridge,09/07/2017 05:00:00 AM,48,-122,15,2,17
32286,SpokaneStBridge,09/07/2017 06:00:00 AM,48,-122,63,14,77
32287,SpokaneStBridge,09/07/2017 07:00:00 AM,48,-122,105,15,120
32288,SpokaneStBridge,09/07/2017 08:00:00 AM,48,-122,117,16,133
32289,SpokaneStBridge,09/07/2017 09:00:00 AM,48,-122,49,8,57
32290,SpokaneStBridge,09/07/2017 10:00:00 AM,48,-122,17,4,21
32291,SpokaneStBridge,09/07/2017 11:00:00 AM,48,-122,11,5,16
32292,SpokaneStBridge,09/07/2017 12:00:00 PM,48,-122,7,7,14
32293,SpokaneStBridge,09/07/2017 01:00:00 PM,48,-122,16,18,34
32294,SpokaneStBridge,09/07/2017 02:00:00 PM,48,-122,9,17,26
32295,SpokaneStBridge,09/07/2017 03:00:00 PM,48,-122,20,33,53
32296,SpokaneStBridge,09/07/2017 04:00:00 PM,48,-122,17,83,100
32297,SpokaneStBridge,09/07/2017 05:00:00 PM,48,-122,30,123,153
32298,SpokaneStBridge,09/07/2017 06:00:00 PM,48,-122,20,86,106
32299,SpokaneStBridge,09/07/2017 07:00:00 PM,48,-122,10,70,80
32300,SpokaneStBridge,09/07/2017 08:00:00 PM,48,-122,6,17,23
32301,SpokaneStBridge,09/07/2017 09:00:00 PM,48,-122,13,12,25
32302,SpokaneStBridge,09/07/2017 10:00:00 PM,48,-122,7,7,14
32303,SpokaneStBridge,09/07/2017 11:00:00 PM,48,-122,15,5,20
32304,SpokaneStBridge,09/08/2017 12:00:00 AM,48,-122,2,4,6
32305,SpokaneStBridge,09/08/2017 01:00:00 AM,48,-122,0,4,4
32306,SpokaneStBridge,09/08/2017 02:00:00 AM,48,-122,3,3,6
32307,SpokaneStBridge,09/08/2017 03:00:00 AM,48,-122,2,3,5
32308,SpokaneStBridge,09/08/2017 04:00:00 AM,48,-122,3,3,6
32309,SpokaneStBridge,09/08/2017 05:00:00 AM,48,-122,19,4,23
32310,SpokaneStBridge,09/08/2017 06:00:00 AM,48,-122,45,13,58
32311,SpokaneStBridge,09/08/2017 07:00:00 AM,48,-122,123,18,141
32312,SpokaneStBridge,09/08/2017 08:00:00 AM,48,-122,101,9,110
32313,SpokaneStBridge,09/08/2017 09:00:00 AM,48,-122,43,14,57
32314,SpokaneStBridge,09/08/2017 10:00:00 AM,48,-122,14,5,19
32315,SpokaneStBridge,09/08/2017 11:00:00 AM,48,-122,11,16,27
32316,SpokaneStBridge,09/08/2017 12:00:00 PM,48,-122,12,13,25
32317,SpokaneStBridge,09/08/2017 01:00:00 PM,48,-122,10,6,16
32318,SpokaneStBridge,09/08/2017 02:00:00 PM,48,-122,14,19,33
32319,SpokaneStBridge,09/08/2017 03:00:00 PM,48,-122,21,37,58
32320,SpokaneStBridge,09/08/2017 04:00:00 PM,48,-122,14,74,88
32321,SpokaneStBridge,09/08/2017 05:00:00 PM,48,-122,18,130,148
32322,SpokaneStBridge,09/08/2017 06:00:00 PM,48,-122,12,64,76
32323,SpokaneStBridge,09/08/2017 07:00:00 PM,48,-122,3,14,17
32324,SpokaneStBridge,09/08/2017 08:00:00 PM,48,-122,2,21,23
32325,SpokaneStBridge,09/08/2017 09:00:00 PM,48,-122,4,6,10
32326,SpokaneStBridge,09/08/2017 10:00:00 PM,48,-122,3,5,8
32327,SpokaneStBridge,09/08/2017 11:00:00 PM,48,-122,2,3,5
32328,SpokaneStBridge,09/09/2017 12:00:00 AM,48,-122,2,4,6
32329,SpokaneStBridge,09/09/2017 01:00:00 AM,48,-122,2,1,3
32330,SpokaneStBridge,09/09/2017 02:00:00 AM,48,-122,1,4,5
32331,SpokaneStBridge,09/09/2017 03:00:00 AM,48,-122,2,2,4
32332,SpokaneStBridge,09/09/2017 04:00:00 AM,48,-122,0,0,0
32333,SpokaneStBridge,09/09/2017 05:00:00 AM,48,-122,4,3,7
32334,SpokaneStBridge,09/09/2017 06:00:00 AM,48,-122,9,5,14
32335,SpokaneStBridge,09/09/2017 07:00:00 AM,48,-122,6,3,9
32336,SpokaneStBridge,09/09/2017 08:00:00 AM,48,-122,16,11,27
32337,SpokaneStBridge,09/09/2017 09:00:00 AM,48,-122,11,16,27
32338,SpokaneStBridge,09/09/2017 10:00:00 AM,48,-122,13,15,28
32339,SpokaneStBridge,09/09/2017 11:00:00 AM,48,-122,20,16,36
32340,SpokaneStBridge,09/09/2017 12:00:00 PM,48,-122,26,21,47
32341,SpokaneStBridge,09/09/2017 01:00:00 PM,48,-122,21,12,33
32342,SpokaneStBridge,09/09/2017 02:00:00 PM,48,-122,13,22,35
32343,SpokaneStBridge,09/09/2017 03:00:00 PM,48,-122,14,26,40
32344,SpokaneStBridge,09/09/2017 04:00:00 PM,48,-122,19,23,42
32345,SpokaneStBridge,09/09/2017 05:00:00 PM,48,-122,11,13,24
32346,SpokaneStBridge,09/09/2017 06:00:00 PM,48,-122,9,6,15
32347,SpokaneStBridge,09/09/2017 07:00:00 PM,48,-122,5,9,14
32348,SpokaneStBridge,09/09/2017 08:00:00 PM,48,-122,10,12,22
32349,SpokaneStBridge,09/09/2017 09:00:00 PM,48,-122,4,4,8
32350,SpokaneStBridge,09/09/2017 10:00:00 PM,48,-122,1,7,8
32351,SpokaneStBridge,09/09/2017 11:00:00 PM,48,-122,3,1,4
32352,SpokaneStBridge,09/10/2017 12:00:00 AM,48,-122,3,4,7
32353,SpokaneStBridge,09/10/2017 01:00:00 AM,48,-122,0,3,3
32354,SpokaneStBridge,09/10/2017 02:00:00 AM,48,-122,2,4,6
32355,SpokaneStBridge,09/10/2017 03:00:00 AM,48,-122,1,1,2
32356,SpokaneStBridge,09/10/2017 04:00:00 AM,48,-122,1,0,1
32357,SpokaneStBridge,09/10/2017 05:00:00 AM,48,-122,4,1,5
32358,SpokaneStBridge,09/10/2017 06:00:00 AM,48,-122,2,4,6
32359,SpokaneStBridge,09/10/2017 07:00:00 AM,48,-122,8,2,10
32360,SpokaneStBridge,09/10/2017 08:00:00 AM,48,-122,9,5,14
32361,SpokaneStBridge,09/10/2017 09:00:00 AM,48,-122,15,13,28
32362,SpokaneStBridge,09/10/2017 10:00:00 AM,48,-122,19,26,45
32363,SpokaneStBridge,09/10/2017 11:00:00 AM,48,-122,21,28,49
32364,SpokaneStBridge,09/10/2017 12:00:00 PM,48,-122,37,23,60
32365,SpokaneStBridge,09/10/2017 01:00:00 PM,48,-122,30,25,55
32366,SpokaneStBridge,09/10/2017 02:00:00 PM,48,-122,25,31,56
32367,SpokaneStBridge,09/10/2017 03:00:00 PM,48,-122,20,19,39
32368,SpokaneStBridge,09/10/2017 04:00:00 PM,48,-122,26,25,51
32369,SpokaneStBridge,09/10/2017 05:00:00 PM,48,-122,27,9,36
32370,SpokaneStBridge,09/10/2017 06:00:00 PM,48,-122,13,21,34
32371,SpokaneStBridge,09/10/2017 07:00:00 PM,48,-122,12,10,22
32372,SpokaneStBridge,09/10/2017 08:00:00 PM,48,-122,3,11,14
32373,SpokaneStBridge,09/10/2017 09:00:00 PM,48,-122,2,12,14
32374,SpokaneStBridge,09/10/2017 10:00:00 PM,48,-122,1,5,6
32375,SpokaneStBridge,09/10/2017 11:00:00 PM,48,-122,1,1,2
32376,SpokaneStBridge,09/11/2017 12:00:00 AM,48,-122,2,3,5
32377,SpokaneStBridge,09/11/2017 01:00:00 AM,48,-122,0,2,2
32378,SpokaneStBridge,09/11/2017 02:00:00 AM,48,-122,3,0,3
32379,SpokaneStBridge,09/11/2017 03:00:00 AM,48,-122,2,1,3
32380,SpokaneStBridge,09/11/2017 04:00:00 AM,48,-122,6,2,8
32381,SpokaneStBridge,09/11/2017 05:00:00 AM,48,-122,31,6,37
32382,SpokaneStBridge,09/11/2017 06:00:00 AM,48,-122,58,10,68
32383,SpokaneStBridge,09/11/2017 07:00:00 AM,48,-122,156,14,170
32384,SpokaneStBridge,09/11/2017 08:00:00 AM,48,-122,112,9,121
32385,SpokaneStBridge,09/11/2017 09:00:00 AM,48,-122,70,9,79
32386,SpokaneStBridge,09/11/2017 10:00:00 AM,48,-122,16,7,23
32387,SpokaneStBridge,09/11/2017 11:00:00 AM,48,-122,18,16,34
32388,SpokaneStBridge,09/11/2017 12:00:00 PM,48,-122,11,12,23
32389,SpokaneStBridge,09/11/2017 01:00:00 PM,48,-122,9,14,23
32390,SpokaneStBridge,09/11/2017 02:00:00 PM,48,-122,18,16,34
32391,SpokaneStBridge,09/11/2017 03:00:00 PM,48,-122,14,42,56
32392,SpokaneStBridge,09/11/2017 04:00:00 PM,48,-122,22,112,134
32393,SpokaneStBridge,09/11/2017 05:00:00 PM,48,-122,25,172,197
32394,SpokaneStBridge,09/11/2017 06:00:00 PM,48,-122,19,107,126
32395,SpokaneStBridge,09/11/2017 07:00:00 PM,48,-122,11,36,47
32396,SpokaneStBridge,09/11/2017 08:00:00 PM,48,-122,6,19,25
32397,SpokaneStBridge,09/11/2017 09:00:00 PM,48,-122,1,6,7
32398,SpokaneStBridge,09/11/2017 10:00:00 PM,48,-122,1,1,2
32399,SpokaneStBridge,09/11/2017 11:00:00 PM,48,-122,3,3,6
32400,SpokaneStBridge,09/12/2017 12:00:00 AM,48,-122,0,1,1
32401,SpokaneStBridge,09/12/2017 01:00:00 AM,48,-122,1,0,1
32402,SpokaneStBridge,09/12/2017 02:00:00 AM,48,-122,0,0,0
32403,SpokaneStBridge,09/12/2017 03:00:00 AM,48,-122,1,2,3
32404,SpokaneStBridge,09/12/2017 04:00:00 AM,48,-122,7,1,8
32405,SpokaneStBridge,09/12/2017 05:00:00 AM,48,-122,31,3,34
32406,SpokaneStBridge,09/12/2017 06:00:00 AM,48,-122,67,13,80
32407,SpokaneStBridge,09/12/2017 07:00:00 AM,48,-122,160,19,179
32408,SpokaneStBridge,09/12/2017 08:00:00 AM,48,-122,141,16,157
32409,SpokaneStBridge,09/12/2017 09:00:00 AM,48,-122,57,4,61
32410,SpokaneStBridge,09/12/2017 10:00:00 AM,48,-122,28,4,32
32411,SpokaneStBridge,09/12/2017 11:00:00 AM,48,-122,12,8,20
32412,SpokaneStBridge,09/12/2017 12:00:00 PM,48,-122,13,13,26
32413,SpokaneStBridge,09/12/2017 01:00:00 PM,48,-122,18,22,40
32414,SpokaneStBridge,09/12/2017 02:00:00 PM,48,-122,13,22,35
32415,SpokaneStBridge,09/12/2017 03:00:00 PM,48,-122,21,45,66
32416,SpokaneStBridge,09/12/2017 04:00:00 PM,48,-122,21,117,138
32417,SpokaneStBridge,09/12/2017 05:00:00 PM,48,-122,27,176,203
32418,SpokaneStBridge,09/12/2017 06:00:00 PM,48,-122,12,112,124
32419,SpokaneStBridge,09/12/2017 07:00:00 PM,48,-122,13,41,54
32420,SpokaneStBridge,09/12/2017 08:00:00 PM,48,-122,4,23,27
32421,SpokaneStBridge,09/12/2017 09:00:00 PM,48,-122,4,10,14
32422,SpokaneStBridge,09/12/2017 10:00:00 PM,48,-122,2,10,12
32423,SpokaneStBridge,09/12/2017 11:00:00 PM,48,-122,2,2,4
32424,SpokaneStBridge,09/13/2017 12:00:00 AM,48,-122,1,0,1
32425,SpokaneStBridge,09/13/2017 01:00:00 AM,48,-122,1,2,3
32426,SpokaneStBridge,09/13/2017 02:00:00 AM,48,-122,1,1,2
32427,SpokaneStBridge,09/13/2017 03:00:00 AM,48,-122,1,2,3
32428,SpokaneStBridge,09/13/2017 04:00:00 AM,48,-122,6,1,7
32429,SpokaneStBridge,09/13/2017 05:00:00 AM,48,-122,28,3,31
32430,SpokaneStBridge,09/13/2017 06:00:00 AM,48,-122,55,12,67
32431,SpokaneStBridge,09/13/2017 07:00:00 AM,48,-122,153,22,175
32432,SpokaneStBridge,09/13/2017 08:00:00 AM,48,-122,122,21,143
32433,SpokaneStBridge,09/13/2017 09:00:00 AM,48,-122,64,4,68
32434,SpokaneStBridge,09/13/2017 10:00:00 AM,48,-122,14,9,23
32435,SpokaneStBridge,09/13/2017 11:00:00 AM,48,-122,19,9,28
32436,SpokaneStBridge,09/13/2017 12:00:00 PM,48,-122,23,9,32
32437,SpokaneStBridge,09/13/2017 01:00:00 PM,48,-122,19,23,42
32438,SpokaneStBridge,09/13/2017 02:00:00 PM,48,-122,14,24,38
32439,SpokaneStBridge,09/13/2017 03:00:00 PM,48,-122,17,41,58
32440,SpokaneStBridge,09/13/2017 04:00:00 PM,48,-122,34,92,126
32441,SpokaneStBridge,09/13/2017 05:00:00 PM,48,-122,32,156,188
32442,SpokaneStBridge,09/13/2017 06:00:00 PM,48,-122,20,91,111
32443,SpokaneStBridge,09/13/2017 07:00:00 PM,48,-122,10,41,51
32444,SpokaneStBridge,09/13/2017 08:00:00 PM,48,-122,7,25,32
32445,SpokaneStBridge,09/13/2017 09:00:00 PM,48,-122,3,9,12
32446,SpokaneStBridge,09/13/2017 10:00:00 PM,48,-122,3,7,10
32447,SpokaneStBridge,09/13/2017 11:00:00 PM,48,-122,1,2,3
32448,SpokaneStBridge,09/14/2017 12:00:00 AM,48,-122,1,0,1
32449,SpokaneStBridge,09/14/2017 01:00:00 AM,48,-122,0,0,0
32450,SpokaneStBridge,09/14/2017 02:00:00 AM,48,-122,0,2,2
32451,SpokaneStBridge,09/14/2017 03:00:00 AM,48,-122,1,1,2
32452,SpokaneStBridge,09/14/2017 04:00:00 AM,48,-122,2,2,4
32453,SpokaneStBridge,09/14/2017 05:00:00 AM,48,-122,25,2,27
32454,SpokaneStBridge,09/14/2017 06:00:00 AM,48,-122,55,14,69
32455,SpokaneStBridge,09/14/2017 07:00:00 AM,48,-122,139,15,154
32456,SpokaneStBridge,09/14/2017 08:00:00 AM,48,-122,128,12,140
32457,SpokaneStBridge,09/14/2017 09:00:00 AM,48,-122,46,6,52
32458,SpokaneStBridge,09/14/2017 10:00:00 AM,48,-122,26,11,37
32459,SpokaneStBridge,09/14/2017 11:00:00 AM,48,-122,14,4,18
32460,SpokaneStBridge,09/14/2017 12:00:00 PM,48,-122,13,8,21
32461,SpokaneStBridge,09/14/2017 01:00:00 PM,48,-122,17,11,28
32462,SpokaneStBridge,09/14/2017 02:00:00 PM,48,-122,16,24,40
32463,SpokaneStBridge,09/14/2017 03:00:00 PM,48,-122,22,32,54
32464,SpokaneStBridge,09/14/2017 04:00:00 PM,48,-122,20,113,133
32465,SpokaneStBridge,09/14/2017 05:00:00 PM,48,-122,27,141,168
32466,SpokaneStBridge,09/14/2017 06:00:00 PM,48,-122,17,97,114
32467,SpokaneStBridge,09/14/2017 07:00:00 PM,48,-122,7,45,52
32468,SpokaneStBridge,09/14/2017 08:00:00 PM,48,-122,5,15,20
32469,SpokaneStBridge,09/14/2017 09:00:00 PM,48,-122,5,12,17
32470,SpokaneStBridge,09/14/2017 10:00:00 PM,48,-122,4,4,8
32471,SpokaneStBridge,09/14/2017 11:00:00 PM,48,-122,1,7,8
32472,SpokaneStBridge,09/15/2017 12:00:00 AM,48,-122,0,5,5
32473,SpokaneStBridge,09/15/2017 01:00:00 AM,48,-122,1,1,2
32474,SpokaneStBridge,09/15/2017 02:00:00 AM,48,-122,0,1,1
32475,SpokaneStBridge,09/15/2017 03:00:00 AM,48,-122,1,2,3
32476,SpokaneStBridge,09/15/2017 04:00:00 AM,48,-122,4,2,6
32477,SpokaneStBridge,09/15/2017 05:00:00 AM,48,-122,19,1,20
32478,SpokaneStBridge,09/15/2017 06:00:00 AM,48,-122,57,12,69
32479,SpokaneStBridge,09/15/2017 07:00:00 AM,48,-122,101,14,115
32480,SpokaneStBridge,09/15/2017 08:00:00 AM,48,-122,109,20,129
32481,SpokaneStBridge,09/15/2017 09:00:00 AM,48,-122,58,7,65
32482,SpokaneStBridge,09/15/2017 10:00:00 AM,48,-122,19,8,27
32483,SpokaneStBridge,09/15/2017 11:00:00 AM,48,-122,14,14,28
32484,SpokaneStBridge,09/15/2017 12:00:00 PM,48,-122,14,23,37
32485,SpokaneStBridge,09/15/2017 01:00:00 PM,48,-122,16,23,39
32486,SpokaneStBridge,09/15/2017 02:00:00 PM,48,-122,26,33,59
32487,SpokaneStBridge,09/15/2017 03:00:00 PM,48,-122,24,40,64
32488,SpokaneStBridge,09/15/2017 04:00:00 PM,48,-122,18,93,111
32489,SpokaneStBridge,09/15/2017 05:00:00 PM,48,-122,23,137,160
32490,SpokaneStBridge,09/15/2017 06:00:00 PM,48,-122,19,78,97
32491,SpokaneStBridge,09/15/2017 07:00:00 PM,48,-122,12,27,39
32492,SpokaneStBridge,09/15/2017 08:00:00 PM,48,-122,3,12,15
32493,SpokaneStBridge,09/15/2017 09:00:00 PM,48,-122,4,5,9
32494,SpokaneStBridge,09/15/2017 10:00:00 PM,48,-122,3,2,5
32495,SpokaneStBridge,09/15/2017 11:00:00 PM,48,-122,3,4,7
32496,SpokaneStBridge,09/16/2017 12:00:00 AM,48,-122,0,3,3
32497,SpokaneStBridge,09/16/2017 01:00:00 AM,48,-122,0,3,3
32498,SpokaneStBridge,09/16/2017 02:00:00 AM,48,-122,0,1,1
32499,SpokaneStBridge,09/16/2017 03:00:00 AM,48,-122,0,1,1
32500,SpokaneStBridge,09/16/2017 04:00:00 AM,48,-122,0,3,3
32501,SpokaneStBridge,09/16/2017 05:00:00 AM,48,-122,6,1,7
32502,SpokaneStBridge,09/16/2017 06:00:00 AM,48,-122,4,6,10
32503,SpokaneStBridge,09/16/2017 07:00:00 AM,48,-122,12,4,16
32504,SpokaneStBridge,09/16/2017 08:00:00 AM,48,-122,24,19,43
32505,SpokaneStBridge,09/16/2017 09:00:00 AM,48,-122,19,31,50
32506,SpokaneStBridge,09/16/2017 10:00:00 AM,48,-122,27,21,48
32507,SpokaneStBridge,09/16/2017 11:00:00 AM,48,-122,23,24,47
32508,SpokaneStBridge,09/16/2017 12:00:00 PM,48,-122,16,29,45
32509,SpokaneStBridge,09/16/2017 01:00:00 PM,48,-122,25,15,40
32510,SpokaneStBridge,09/16/2017 02:00:00 PM,48,-122,28,25,53
32511,SpokaneStBridge,09/16/2017 03:00:00 PM,48,-122,29,19,48
32512,SpokaneStBridge,09/16/2017 04:00:00 PM,48,-122,24,34,58
32513,SpokaneStBridge,09/16/2017 05:00:00 PM,48,-122,18,24,42
32514,SpokaneStBridge,09/16/2017 06:00:00 PM,48,-122,18,13,31
32515,SpokaneStBridge,09/16/2017 07:00:00 PM,48,-122,7,7,14
32516,SpokaneStBridge,09/16/2017 08:00:00 PM,48,-122,2,6,8
32517,SpokaneStBridge,09/16/2017 09:00:00 PM,48,-122,1,2,3
32518,SpokaneStBridge,09/16/2017 10:00:00 PM,48,-122,5,1,6
32519,SpokaneStBridge,09/16/2017 11:00:00 PM,48,-122,4,1,5
32520,SpokaneStBridge,09/17/2017 12:00:00 AM,48,-122,1,2,3
32521,SpokaneStBridge,09/17/2017 01:00:00 AM,48,-122,1,3,4
32522,SpokaneStBridge,09/17/2017 02:00:00 AM,48,-122,0,1,1
32523,SpokaneStBridge,09/17/2017 03:00:00 AM,48,-122,0,1,1
32524,SpokaneStBridge,09/17/2017 04:00:00 AM,48,-122,1,3,4
32525,SpokaneStBridge,09/17/2017 05:00:00 AM,48,-122,3,0,3
32526,SpokaneStBridge,09/17/2017 06:00:00 AM,48,-122,5,3,8
32527,SpokaneStBridge,09/17/2017 07:00:00 AM,48,-122,7,4,11
32528,SpokaneStBridge,09/17/2017 08:00:00 AM,48,-122,17,15,32
32529,SpokaneStBridge,09/17/2017 09:00:00 AM,48,-122,10,16,26
32530,SpokaneStBridge,09/17/2017 10:00:00 AM,48,-122,25,14,39
32531,SpokaneStBridge,09/17/2017 11:00:00 AM,48,-122,19,19,38
32532,SpokaneStBridge,09/17/2017 12:00:00 PM,48,-122,24,16,40
32533,SpokaneStBridge,09/17/2017 01:00:00 PM,48,-122,7,12,19
32534,SpokaneStBridge,09/17/2017 02:00:00 PM,48,-122,3,3,6
32535,SpokaneStBridge,09/17/2017 03:00:00 PM,48,-122,6,4,10
32536,SpokaneStBridge,09/17/2017 04:00:00 PM,48,-122,6,8,14
32537,SpokaneStBridge,09/17/2017 05:00:00 PM,48,-122,0,10,10
32538,SpokaneStBridge,09/17/2017 06:00:00 PM,48,-122,2,4,6
32539,SpokaneStBridge,09/17/2017 07:00:00 PM,48,-122,0,4,4
32540,SpokaneStBridge,09/17/2017 08:00:00 PM,48,-122,2,1,3
32541,SpokaneStBridge,09/17/2017 09:00:00 PM,48,-122,2,2,4
32542,SpokaneStBridge,09/17/2017 10:00:00 PM,48,-122,2,0,2
32543,SpokaneStBridge,09/17/2017 11:00:00 PM,48,-122,0,1,1
32544,SpokaneStBridge,09/18/2017 12:00:00 AM,48,-122,3,1,4
32545,SpokaneStBridge,09/18/2017 01:00:00 AM,48,-122,1,1,2
32546,SpokaneStBridge,09/18/2017 02:00:00 AM,48,-122,0,1,1
32547,SpokaneStBridge,09/18/2017 03:00:00 AM,48,-122,0,1,1
32548,SpokaneStBridge,09/18/2017 04:00:00 AM,48,-122,6,2,8
32549,SpokaneStBridge,09/18/2017 05:00:00 AM,48,-122,16,6,22
32550,SpokaneStBridge,09/18/2017 06:00:00 AM,48,-122,47,10,57
32551,SpokaneStBridge,09/18/2017 07:00:00 AM,48,-122,93,13,106
32552,SpokaneStBridge,09/18/2017 08:00:00 AM,48,-122,102,10,112
32553,SpokaneStBridge,09/18/2017 09:00:00 AM,48,-122,37,8,45
32554,SpokaneStBridge,09/18/2017 10:00:00 AM,48,-122,17,0,17
32555,SpokaneStBridge,09/18/2017 11:00:00 AM,48,-122,8,1,9
32556,SpokaneStBridge,09/18/2017 12:00:00 PM,48,-122,8,8,16
32557,SpokaneStBridge,09/18/2017 01:00:00 PM,48,-122,9,7,16
32558,SpokaneStBridge,09/18/2017 02:00:00 PM,48,-122,12,15,27
32559,SpokaneStBridge,09/18/2017 03:00:00 PM,48,-122,9,30,39
32560,SpokaneStBridge,09/18/2017 04:00:00 PM,48,-122,9,54,63
32561,SpokaneStBridge,09/18/2017 05:00:00 PM,48,-122,13,120,133
32562,SpokaneStBridge,09/18/2017 06:00:00 PM,48,-122,4,54,58
32563,SpokaneStBridge,09/18/2017 07:00:00 PM,48,-122,2,16,18
32564,SpokaneStBridge,09/18/2017 08:00:00 PM,48,-122,1,6,7
32565,SpokaneStBridge,09/18/2017 09:00:00 PM,48,-122,2,3,5
32566,SpokaneStBridge,09/18/2017 10:00:00 PM,48,-122,4,4,8
32567,SpokaneStBridge,09/18/2017 11:00:00 PM,48,-122,2,0,2
32568,SpokaneStBridge,09/19/2017 12:00:00 AM,48,-122,1,0,1
32569,SpokaneStBridge,09/19/2017 01:00:00 AM,48,-122,0,1,1
32570,SpokaneStBridge,09/19/2017 02:00:00 AM,48,-122,0,0,0
32571,SpokaneStBridge,09/19/2017 03:00:00 AM,48,-122,0,1,1
32572,SpokaneStBridge,09/19/2017 04:00:00 AM,48,-122,4,1,5
32573,SpokaneStBridge,09/19/2017 05:00:00 AM,48,-122,11,2,13
32574,SpokaneStBridge,09/19/2017 06:00:00 AM,48,-122,30,10,40
32575,SpokaneStBridge,09/19/2017 07:00:00 AM,48,-122,87,12,99
32576,SpokaneStBridge,09/19/2017 08:00:00 AM,48,-122,86,9,95
32577,SpokaneStBridge,09/19/2017 09:00:00 AM,48,-122,41,6,47
32578,SpokaneStBridge,09/19/2017 10:00:00 AM,48,-122,15,0,15
32579,SpokaneStBridge,09/19/2017 11:00:00 AM,48,-122,9,2,11
32580,SpokaneStBridge,09/19/2017 12:00:00 PM,48,-122,4,8,12
32581,SpokaneStBridge,09/19/2017 01:00:00 PM,48,-122,5,4,9
32582,SpokaneStBridge,09/19/2017 02:00:00 PM,48,-122,10,10,20
32583,SpokaneStBridge,09/19/2017 03:00:00 PM,48,-122,8,19,27
32584,SpokaneStBridge,09/19/2017 04:00:00 PM,48,-122,8,50,58
32585,SpokaneStBridge,09/19/2017 05:00:00 PM,48,-122,14,100,114
32586,SpokaneStBridge,09/19/2017 06:00:00 PM,48,-122,5,55,60
32587,SpokaneStBridge,09/19/2017 07:00:00 PM,48,-122,3,22,25
32588,SpokaneStBridge,09/19/2017 08:00:00 PM,48,-122,0,4,4
32589,SpokaneStBridge,09/19/2017 09:00:00 PM,48,-122,2,4,6
32590,SpokaneStBridge,09/19/2017 10:00:00 PM,48,-122,0,3,3
32591,SpokaneStBridge,09/19/2017 11:00:00 PM,48,-122,2,0,2
32592,SpokaneStBridge,09/20/2017 12:00:00 AM,48,-122,1,3,4
32593,SpokaneStBridge,09/20/2017 01:00:00 AM,48,-122,3,2,5
32594,SpokaneStBridge,09/20/2017 02:00:00 AM,48,-122,1,1,2
32595,SpokaneStBridge,09/20/2017 03:00:00 AM,48,-122,1,1,2
32596,SpokaneStBridge,09/20/2017 04:00:00 AM,48,-122,5,1,6
32597,SpokaneStBridge,09/20/2017 05:00:00 AM,48,-122,16,1,17
32598,SpokaneStBridge,09/20/2017 06:00:00 AM,48,-122,53,7,60
32599,SpokaneStBridge,09/20/2017 07:00:00 AM,48,-122,96,19,115
32600,SpokaneStBridge,09/20/2017 08:00:00 AM,48,-122,118,11,129
32601,SpokaneStBridge,09/20/2017 09:00:00 AM,48,-122,32,2,34
32602,SpokaneStBridge,09/20/2017 10:00:00 AM,48,-122,12,1,13
32603,SpokaneStBridge,09/20/2017 11:00:00 AM,48,-122,12,6,18
32604,SpokaneStBridge,09/20/2017 12:00:00 PM,48,-122,6,12,18
32605,SpokaneStBridge,09/20/2017 01:00:00 PM,48,-122,12,16,28
32606,SpokaneStBridge,09/20/2017 02:00:00 PM,48,-122,23,7,30
32607,SpokaneStBridge,09/20/2017 03:00:00 PM,48,-122,14,21,35
32608,SpokaneStBridge,09/20/2017 04:00:00 PM,48,-122,13,73,86
32609,SpokaneStBridge,09/20/2017 05:00:00 PM,48,-122,14,116,130
32610,SpokaneStBridge,09/20/2017 06:00:00 PM,48,-122,12,65,77
32611,SpokaneStBridge,09/20/2017 07:00:00 PM,48,-122,5,31,36
32612,SpokaneStBridge,09/20/2017 08:00:00 PM,48,-122,12,14,26
32613,SpokaneStBridge,09/20/2017 09:00:00 PM,48,-122,2,10,12
32614,SpokaneStBridge,09/20/2017 10:00:00 PM,48,-122,3,5,8
32615,SpokaneStBridge,09/20/2017 11:00:00 PM,48,-122,0,1,1
32616,SpokaneStBridge,09/21/2017 12:00:00 AM,48,-122,2,2,4
32617,SpokaneStBridge,09/21/2017 01:00:00 AM,48,-122,0,3,3
32618,SpokaneStBridge,09/21/2017 02:00:00 AM,48,-122,0,2,2
32619,SpokaneStBridge,09/21/2017 03:00:00 AM,48,-122,0,1,1
32620,SpokaneStBridge,09/21/2017 04:00:00 AM,48,-122,5,1,6
32621,SpokaneStBridge,09/21/2017 05:00:00 AM,48,-122,20,5,25
32622,SpokaneStBridge,09/21/2017 06:00:00 AM,48,-122,46,12,58
32623,SpokaneStBridge,09/21/2017 07:00:00 AM,48,-122,101,11,112
32624,SpokaneStBridge,09/21/2017 08:00:00 AM,48,-122,115,7,122
32625,SpokaneStBridge,09/21/2017 09:00:00 AM,48,-122,31,1,32
32626,SpokaneStBridge,09/21/2017 10:00:00 AM,48,-122,21,7,28
32627,SpokaneStBridge,09/21/2017 11:00:00 AM,48,-122,13,8,21
32628,SpokaneStBridge,09/21/2017 12:00:00 PM,48,-122,14,13,27
32629,SpokaneStBridge,09/21/2017 01:00:00 PM,48,-122,3,8,11
32630,SpokaneStBridge,09/21/2017 02:00:00 PM,48,-122,19,17,36
32631,SpokaneStBridge,09/21/2017 03:00:00 PM,48,-122,7,26,33
32632,SpokaneStBridge,09/21/2017 04:00:00 PM,48,-122,16,85,101
32633,SpokaneStBridge,09/21/2017 05:00:00 PM,48,-122,21,120,141
32634,SpokaneStBridge,09/21/2017 06:00:00 PM,48,-122,9,75,84
32635,SpokaneStBridge,09/21/2017 07:00:00 PM,48,-122,7,28,35
32636,SpokaneStBridge,09/21/2017 08:00:00 PM,48,-122,2,8,10
32637,SpokaneStBridge,09/21/2017 09:00:00 PM,48,-122,4,9,13
32638,SpokaneStBridge,09/21/2017 10:00:00 PM,48,-122,3,6,9
32639,SpokaneStBridge,09/21/2017 11:00:00 PM,48,-122,1,1,2
32640,SpokaneStBridge,09/22/2017 12:00:00 AM,48,-122,0,4,4
32641,SpokaneStBridge,09/22/2017 01:00:00 AM,48,-122,1,1,2
32642,SpokaneStBridge,09/22/2017 02:00:00 AM,48,-122,0,2,2
32643,SpokaneStBridge,09/22/2017 03:00:00 AM,48,-122,2,1,3
32644,SpokaneStBridge,09/22/2017 04:00:00 AM,48,-122,5,1,6
32645,SpokaneStBridge,09/22/2017 05:00:00 AM,48,-122,20,4,24
32646,SpokaneStBridge,09/22/2017 06:00:00 AM,48,-122,50,15,65
32647,SpokaneStBridge,09/22/2017 07:00:00 AM,48,-122,110,12,122
32648,SpokaneStBridge,09/22/2017 08:00:00 AM,48,-122,103,14,117
32649,SpokaneStBridge,09/22/2017 09:00:00 AM,48,-122,30,8,38
32650,SpokaneStBridge,09/22/2017 10:00:00 AM,48,-122,24,8,32
32651,SpokaneStBridge,09/22/2017 11:00:00 AM,48,-122,14,15,29
32652,SpokaneStBridge,09/22/2017 12:00:00 PM,48,-122,15,16,31
32653,SpokaneStBridge,09/22/2017 01:00:00 PM,48,-122,21,16,37
32654,SpokaneStBridge,09/22/2017 02:00:00 PM,48,-122,18,24,42
32655,SpokaneStBridge,09/22/2017 03:00:00 PM,48,-122,16,45,61
32656,SpokaneStBridge,09/22/2017 04:00:00 PM,48,-122,20,96,116
32657,SpokaneStBridge,09/22/2017 05:00:00 PM,48,-122,21,102,123
32658,SpokaneStBridge,09/22/2017 06:00:00 PM,48,-122,13,62,75
32659,SpokaneStBridge,09/22/2017 07:00:00 PM,48,-122,9,28,37
32660,SpokaneStBridge,09/22/2017 08:00:00 PM,48,-122,7,11,18
32661,SpokaneStBridge,09/22/2017 09:00:00 PM,48,-122,5,4,9
32662,SpokaneStBridge,09/22/2017 10:00:00 PM,48,-122,4,3,7
32663,SpokaneStBridge,09/22/2017 11:00:00 PM,48,-122,2,3,5
32664,SpokaneStBridge,09/23/2017 12:00:00 AM,48,-122,1,3,4
32665,SpokaneStBridge,09/23/2017 01:00:00 AM,48,-122,0,3,3
32666,SpokaneStBridge,09/23/2017 02:00:00 AM,48,-122,3,1,4
32667,SpokaneStBridge,09/23/2017 03:00:00 AM,48,-122,0,1,1
32668,SpokaneStBridge,09/23/2017 04:00:00 AM,48,-122,1,2,3
32669,SpokaneStBridge,09/23/2017 05:00:00 AM,48,-122,6,1,7
32670,SpokaneStBridge,09/23/2017 06:00:00 AM,48,-122,7,2,9
32671,SpokaneStBridge,09/23/2017 07:00:00 AM,48,-122,4,4,8
32672,SpokaneStBridge,09/23/2017 08:00:00 AM,48,-122,26,9,35
32673,SpokaneStBridge,09/23/2017 09:00:00 AM,48,-122,29,17,46
32674,SpokaneStBridge,09/23/2017 10:00:00 AM,48,-122,21,32,53
32675,SpokaneStBridge,09/23/2017 11:00:00 AM,48,-122,34,30,64
32676,SpokaneStBridge,09/23/2017 12:00:00 PM,48,-122,41,34,75
32677,SpokaneStBridge,09/23/2017 01:00:00 PM,48,-122,34,36,70
32678,SpokaneStBridge,09/23/2017 02:00:00 PM,48,-122,31,25,56
32679,SpokaneStBridge,09/23/2017 03:00:00 PM,48,-122,26,29,55
32680,SpokaneStBridge,09/23/2017 04:00:00 PM,48,-122,16,31,47
32681,SpokaneStBridge,09/23/2017 05:00:00 PM,48,-122,15,24,39
32682,SpokaneStBridge,09/23/2017 06:00:00 PM,48,-122,8,10,18
32683,SpokaneStBridge,09/23/2017 07:00:00 PM,48,-122,0,5,5
32684,SpokaneStBridge,09/23/2017 08:00:00 PM,48,-122,2,7,9
32685,SpokaneStBridge,09/23/2017 09:00:00 PM,48,-122,1,6,7
32686,SpokaneStBridge,09/23/2017 10:00:00 PM,48,-122,2,3,5
32687,SpokaneStBridge,09/23/2017 11:00:00 PM,48,-122,2,3,5
32688,SpokaneStBridge,09/24/2017 12:00:00 AM,48,-122,0,2,2
32689,SpokaneStBridge,09/24/2017 01:00:00 AM,48,-122,2,2,4
32690,SpokaneStBridge,09/24/2017 02:00:00 AM,48,-122,1,1,2
32691,SpokaneStBridge,09/24/2017 03:00:00 AM,48,-122,2,3,5
32692,SpokaneStBridge,09/24/2017 04:00:00 AM,48,-122,0,2,2
32693,SpokaneStBridge,09/24/2017 05:00:00 AM,48,-122,4,0,4
32694,SpokaneStBridge,09/24/2017 06:00:00 AM,48,-122,5,2,7
32695,SpokaneStBridge,09/24/2017 07:00:00 AM,48,-122,7,2,9
32696,SpokaneStBridge,09/24/2017 08:00:00 AM,48,-122,19,11,30
32697,SpokaneStBridge,09/24/2017 09:00:00 AM,48,-122,15,21,36
32698,SpokaneStBridge,09/24/2017 10:00:00 AM,48,-122,18,4,22
32699,SpokaneStBridge,09/24/2017 11:00:00 AM,48,-122,21,23,44
32700,SpokaneStBridge,09/24/2017 12:00:00 PM,48,-122,16,24,40
32701,SpokaneStBridge,09/24/2017 01:00:00 PM,48,-122,32,28,60
32702,SpokaneStBridge,09/24/2017 02:00:00 PM,48,-122,12,31,43
32703,SpokaneStBridge,09/24/2017 03:00:00 PM,48,-122,20,22,42
32704,SpokaneStBridge,09/24/2017 04:00:00 PM,48,-122,25,17,42
32705,SpokaneStBridge,09/24/2017 05:00:00 PM,48,-122,16,11,27
32706,SpokaneStBridge,09/24/2017 06:00:00 PM,48,-122,12,13,25
32707,SpokaneStBridge,09/24/2017 07:00:00 PM,48,-122,8,7,15
32708,SpokaneStBridge,09/24/2017 08:00:00 PM,48,-122,1,8,9
32709,SpokaneStBridge,09/24/2017 09:00:00 PM,48,-122,0,5,5
32710,SpokaneStBridge,09/24/2017 10:00:00 PM,48,-122,3,2,5
32711,SpokaneStBridge,09/24/2017 11:00:00 PM,48,-122,2,3,5
32712,SpokaneStBridge,09/25/2017 12:00:00 AM,48,-122,2,1,3
32713,SpokaneStBridge,09/25/2017 01:00:00 AM,48,-122,1,3,4
32714,SpokaneStBridge,09/25/2017 02:00:00 AM,48,-122,1,2,3
32715,SpokaneStBridge,09/25/2017 03:00:00 AM,48,-122,1,1,2
32716,SpokaneStBridge,09/25/2017 04:00:00 AM,48,-122,5,0,5
32717,SpokaneStBridge,09/25/2017 05:00:00 AM,48,-122,22,4,26
32718,SpokaneStBridge,09/25/2017 06:00:00 AM,48,-122,52,7,59
32719,SpokaneStBridge,09/25/2017 07:00:00 AM,48,-122,96,10,106
32720,SpokaneStBridge,09/25/2017 08:00:00 AM,48,-122,117,9,126
32721,SpokaneStBridge,09/25/2017 09:00:00 AM,48,-122,42,5,47
32722,SpokaneStBridge,09/25/2017 10:00:00 AM,48,-122,11,4,15
32723,SpokaneStBridge,09/25/2017 11:00:00 AM,48,-122,11,2,13
32724,SpokaneStBridge,09/25/2017 12:00:00 PM,48,-122,2,3,5
32725,SpokaneStBridge,09/25/2017 01:00:00 PM,48,-122,9,7,16
32726,SpokaneStBridge,09/25/2017 02:00:00 PM,48,-122,8,17,25
32727,SpokaneStBridge,09/25/2017 03:00:00 PM,48,-122,11,22,33
32728,SpokaneStBridge,09/25/2017 04:00:00 PM,48,-122,18,77,95
32729,SpokaneStBridge,09/25/2017 05:00:00 PM,48,-122,14,137,151
32730,SpokaneStBridge,09/25/2017 06:00:00 PM,48,-122,7,81,88
32731,SpokaneStBridge,09/25/2017 07:00:00 PM,48,-122,8,24,32
32732,SpokaneStBridge,09/25/2017 08:00:00 PM,48,-122,3,7,10
32733,SpokaneStBridge,09/25/2017 09:00:00 PM,48,-122,2,4,6
32734,SpokaneStBridge,09/25/2017 10:00:00 PM,48,-122,3,1,4
32735,SpokaneStBridge,09/25/2017 11:00:00 PM,48,-122,0,1,1
32736,SpokaneStBridge,09/26/2017 12:00:00 AM,48,-122,0,2,2
32737,SpokaneStBridge,09/26/2017 01:00:00 AM,48,-122,3,4,7
32738,SpokaneStBridge,09/26/2017 02:00:00 AM,48,-122,0,0,0
32739,SpokaneStBridge,09/26/2017 03:00:00 AM,48,-122,0,4,4
32740,SpokaneStBridge,09/26/2017 04:00:00 AM,48,-122,5,1,6
32741,SpokaneStBridge,09/26/2017 05:00:00 AM,48,-122,26,4,30
32742,SpokaneStBridge,09/26/2017 06:00:00 AM,48,-122,71,11,82
32743,SpokaneStBridge,09/26/2017 07:00:00 AM,48,-122,142,14,156
32744,SpokaneStBridge,09/26/2017 08:00:00 AM,48,-122,132,16,148
32745,SpokaneStBridge,09/26/2017 09:00:00 AM,48,-122,44,7,51
32746,SpokaneStBridge,09/26/2017 10:00:00 AM,48,-122,18,2,20
32747,SpokaneStBridge,09/26/2017 11:00:00 AM,48,-122,15,11,26
32748,SpokaneStBridge,09/26/2017 12:00:00 PM,48,-122,11,10,21
32749,SpokaneStBridge,09/26/2017 01:00:00 PM,48,-122,14,13,27
32750,SpokaneStBridge,09/26/2017 02:00:00 PM,48,-122,23,22,45
32751,SpokaneStBridge,09/26/2017 03:00:00 PM,48,-122,15,34,49
32752,SpokaneStBridge,09/26/2017 04:00:00 PM,48,-122,19,115,134
32753,SpokaneStBridge,09/26/2017 05:00:00 PM,48,-122,18,177,195
32754,SpokaneStBridge,09/26/2017 06:00:00 PM,48,-122,15,106,121
32755,SpokaneStBridge,09/26/2017 07:00:00 PM,48,-122,9,30,39
32756,SpokaneStBridge,09/26/2017 08:00:00 PM,48,-122,9,16,25
32757,SpokaneStBridge,09/26/2017 09:00:00 PM,48,-122,0,10,10
32758,SpokaneStBridge,09/26/2017 10:00:00 PM,48,-122,1,8,9
32759,SpokaneStBridge,09/26/2017 11:00:00 PM,48,-122,3,11,14
32760,SpokaneStBridge,09/27/2017 12:00:00 AM,48,-122,1,2,3
32761,SpokaneStBridge,09/27/2017 01:00:00 AM,48,-122,0,2,2
32762,SpokaneStBridge,09/27/2017 02:00:00 AM,48,-122,0,0,0
32763,SpokaneStBridge,09/27/2017 03:00:00 AM,48,-122,1,2,3
32764,SpokaneStBridge,09/27/2017 04:00:00 AM,48,-122,5,1,6
32765,SpokaneStBridge,09/27/2017 05:00:00 AM,48,-122,23,3,26
32766,SpokaneStBridge,09/27/2017 06:00:00 AM,48,-122,64,10,74
32767,SpokaneStBridge,09/27/2017 07:00:00 AM,48,-122,129,18,147
32768,SpokaneStBridge,09/27/2017 08:00:00 AM,48,-122,155,9,164
32769,SpokaneStBridge,09/27/2017 09:00:00 AM,48,-122,56,11,67
32770,SpokaneStBridge,09/27/2017 10:00:00 AM,48,-122,29,6,35
32771,SpokaneStBridge,09/27/2017 11:00:00 AM,48,-122,18,8,26
32772,SpokaneStBridge,09/27/2017 12:00:00 PM,48,-122,18,14,32
32773,SpokaneStBridge,09/27/2017 01:00:00 PM,48,-122,29,13,42
32774,SpokaneStBridge,09/27/2017 02:00:00 PM,48,-122,12,17,29
32775,SpokaneStBridge,09/27/2017 03:00:00 PM,48,-122,21,39,60
32776,SpokaneStBridge,09/27/2017 04:00:00 PM,48,-122,20,96,116
32777,SpokaneStBridge,09/27/2017 05:00:00 PM,48,-122,18,159,177
32778,SpokaneStBridge,09/27/2017 06:00:00 PM,48,-122,20,110,130
32779,SpokaneStBridge,09/27/2017 07:00:00 PM,48,-122,9,29,38
32780,SpokaneStBridge,09/27/2017 08:00:00 PM,48,-122,5,13,18
32781,SpokaneStBridge,09/27/2017 09:00:00 PM,48,-122,1,13,14
32782,SpokaneStBridge,09/27/2017 10:00:00 PM,48,-122,4,9,13
32783,SpokaneStBridge,09/27/2017 11:00:00 PM,48,-122,0,9,9
32784,SpokaneStBridge,09/28/2017 12:00:00 AM,48,-122,1,4,5
32785,SpokaneStBridge,09/28/2017 01:00:00 AM,48,-122,0,3,3
32786,SpokaneStBridge,09/28/2017 02:00:00 AM,48,-122,0,4,4
32787,SpokaneStBridge,09/28/2017 03:00:00 AM,48,-122,2,0,2
32788,SpokaneStBridge,09/28/2017 04:00:00 AM,48,-122,5,2,7
32789,SpokaneStBridge,09/28/2017 05:00:00 AM,48,-122,26,2,28
32790,SpokaneStBridge,09/28/2017 06:00:00 AM,48,-122,72,16,88
32791,SpokaneStBridge,09/28/2017 07:00:00 AM,48,-122,130,16,146
32792,SpokaneStBridge,09/28/2017 08:00:00 AM,48,-122,173,20,193
32793,SpokaneStBridge,09/28/2017 09:00:00 AM,48,-122,50,6,56
32794,SpokaneStBridge,09/28/2017 10:00:00 AM,48,-122,26,10,36
32795,SpokaneStBridge,09/28/2017 11:00:00 AM,48,-122,22,9,31
32796,SpokaneStBridge,09/28/2017 12:00:00 PM,48,-122,11,16,27
32797,SpokaneStBridge,09/28/2017 01:00:00 PM,48,-122,21,22,43
32798,SpokaneStBridge,09/28/2017 02:00:00 PM,48,-122,18,26,44
32799,SpokaneStBridge,09/28/2017 03:00:00 PM,48,-122,23,47,70
32800,SpokaneStBridge,09/28/2017 04:00:00 PM,48,-122,32,122,154
32801,SpokaneStBridge,09/28/2017 05:00:00 PM,48,-122,23,169,192
32802,SpokaneStBridge,09/28/2017 06:00:00 PM,48,-122,21,130,151
32803,SpokaneStBridge,09/28/2017 07:00:00 PM,48,-122,10,34,44
32804,SpokaneStBridge,09/28/2017 08:00:00 PM,48,-122,5,12,17
32805,SpokaneStBridge,09/28/2017 09:00:00 PM,48,-122,7,10,17
32806,SpokaneStBridge,09/28/2017 10:00:00 PM,48,-122,4,5,9
32807,SpokaneStBridge,09/28/2017 11:00:00 PM,48,-122,3,4,7
32808,SpokaneStBridge,09/29/2017 12:00:00 AM,48,-122,0,1,1
32809,SpokaneStBridge,09/29/2017 01:00:00 AM,48,-122,0,3,3
32810,SpokaneStBridge,09/29/2017 02:00:00 AM,48,-122,1,2,3
32811,SpokaneStBridge,09/29/2017 03:00:00 AM,48,-122,0,0,0
32812,SpokaneStBridge,09/29/2017 04:00:00 AM,48,-122,3,2,5
32813,SpokaneStBridge,09/29/2017 05:00:00 AM,48,-122,9,3,12
32814,SpokaneStBridge,09/29/2017 06:00:00 AM,48,-122,35,3,38
32815,SpokaneStBridge,09/29/2017 07:00:00 AM,48,-122,69,18,87
32816,SpokaneStBridge,09/29/2017 08:00:00 AM,48,-122,82,9,91
32817,SpokaneStBridge,09/29/2017 09:00:00 AM,48,-122,30,7,37
32818,SpokaneStBridge,09/29/2017 10:00:00 AM,48,-122,14,6,20
32819,SpokaneStBridge,09/29/2017 11:00:00 AM,48,-122,5,3,8
32820,SpokaneStBridge,09/29/2017 12:00:00 PM,48,-122,10,6,16
32821,SpokaneStBridge,09/29/2017 01:00:00 PM,48,-122,6,5,11
32822,SpokaneStBridge,09/29/2017 02:00:00 PM,48,-122,5,19,24
32823,SpokaneStBridge,09/29/2017 03:00:00 PM,48,-122,12,22,34
32824,SpokaneStBridge,09/29/2017 04:00:00 PM,48,-122,15,59,74
32825,SpokaneStBridge,09/29/2017 05:00:00 PM,48,-122,9,88,97
32826,SpokaneStBridge,09/29/2017 06:00:00 PM,48,-122,14,55,69
32827,SpokaneStBridge,09/29/2017 07:00:00 PM,48,-122,4,26,30
32828,SpokaneStBridge,09/29/2017 08:00:00 PM,48,-122,0,7,7
32829,SpokaneStBridge,09/29/2017 09:00:00 PM,48,-122,2,4,6
32830,SpokaneStBridge,09/29/2017 10:00:00 PM,48,-122,0,4,4
32831,SpokaneStBridge,09/29/2017 11:00:00 PM,48,-122,3,11,14
32832,SpokaneStBridge,09/30/2017 12:00:00 AM,48,-122,2,7,9
32833,SpokaneStBridge,09/30/2017 01:00:00 AM,48,-122,1,1,2
32834,SpokaneStBridge,09/30/2017 02:00:00 AM,48,-122,0,1,1
32835,SpokaneStBridge,09/30/2017 03:00:00 AM,48,-122,1,4,5
32836,SpokaneStBridge,09/30/2017 04:00:00 AM,48,-122,0,2,2
32837,SpokaneStBridge,09/30/2017 05:00:00 AM,48,-122,3,0,3
32838,SpokaneStBridge,09/30/2017 06:00:00 AM,48,-122,6,2,8
32839,SpokaneStBridge,09/30/2017 07:00:00 AM,48,-122,6,2,8
32840,SpokaneStBridge,09/30/2017 08:00:00 AM,48,-122,18,8,26
32841,SpokaneStBridge,09/30/2017 09:00:00 AM,48,-122,11,11,22
32842,SpokaneStBridge,09/30/2017 10:00:00 AM,48,-122,17,8,25
32843,SpokaneStBridge,09/30/2017 11:00:00 AM,48,-122,23,22,45
32844,SpokaneStBridge,09/30/2017 12:00:00 PM,48,-122,22,17,39
32845,SpokaneStBridge,09/30/2017 01:00:00 PM,48,-122,22,13,35
32846,SpokaneStBridge,09/30/2017 02:00:00 PM,48,-122,5,18,23
32847,SpokaneStBridge,09/30/2017 03:00:00 PM,48,-122,11,9,20
32848,SpokaneStBridge,09/30/2017 04:00:00 PM,48,-122,9,16,25
32849,SpokaneStBridge,09/30/2017 05:00:00 PM,48,-122,4,6,10
32850,SpokaneStBridge,09/30/2017 06:00:00 PM,48,-122,5,11,16
32851,SpokaneStBridge,09/30/2017 07:00:00 PM,48,-122,8,5,13
32852,SpokaneStBridge,09/30/2017 08:00:00 PM,48,-122,1,3,4
32853,SpokaneStBridge,09/30/2017 09:00:00 PM,48,-122,0,4,4
32854,SpokaneStBridge,09/30/2017 10:00:00 PM,48,-122,0,3,3
32855,SpokaneStBridge,09/30/2017 11:00:00 PM,48,-122,0,5,5
32856,SpokaneStBridge,10/01/2017 12:00:00 AM,48,-122,1,1,2
32857,SpokaneStBridge,10/01/2017 01:00:00 AM,48,-122,3,1,4
32858,SpokaneStBridge,10/01/2017 02:00:00 AM,48,-122,1,3,4
32859,SpokaneStBridge,10/01/2017 03:00:00 AM,48,-122,2,1,3
32860,SpokaneStBridge,10/01/2017 04:00:00 AM,48,-122,2,2,4
32861,SpokaneStBridge,10/01/2017 05:00:00 AM,48,-122,4,0,4
32862,SpokaneStBridge,10/01/2017 06:00:00 AM,48,-122,4,1,5
32863,SpokaneStBridge,10/01/2017 07:00:00 AM,48,-122,3,1,4
32864,SpokaneStBridge,10/01/2017 08:00:00 AM,48,-122,21,3,24
32865,SpokaneStBridge,10/01/2017 09:00:00 AM,48,-122,10,11,21
32866,SpokaneStBridge,10/01/2017 10:00:00 AM,48,-122,13,14,27
32867,SpokaneStBridge,10/01/2017 11:00:00 AM,48,-122,19,14,33
32868,SpokaneStBridge,10/01/2017 12:00:00 PM,48,-122,23,14,37
32869,SpokaneStBridge,10/01/2017 01:00:00 PM,48,-122,16,16,32
32870,SpokaneStBridge,10/01/2017 02:00:00 PM,48,-122,10,9,19
32871,SpokaneStBridge,10/01/2017 03:00:00 PM,48,-122,15,20,35
32872,SpokaneStBridge,10/01/2017 04:00:00 PM,48,-122,11,13,24
32873,SpokaneStBridge,10/01/2017 05:00:00 PM,48,-122,15,17,32
32874,SpokaneStBridge,10/01/2017 06:00:00 PM,48,-122,7,11,18
32875,SpokaneStBridge,10/01/2017 07:00:00 PM,48,-122,6,6,12
32876,SpokaneStBridge,10/01/2017 08:00:00 PM,48,-122,1,6,7
32877,SpokaneStBridge,10/01/2017 09:00:00 PM,48,-122,4,10,14
32878,SpokaneStBridge,10/01/2017 10:00:00 PM,48,-122,0,5,5
32879,SpokaneStBridge,10/01/2017 11:00:00 PM,48,-122,2,4,6
32880,SpokaneStBridge,10/02/2017 12:00:00 AM,48,-122,2,3,5
32881,SpokaneStBridge,10/02/2017 01:00:00 AM,48,-122,1,2,3
32882,SpokaneStBridge,10/02/2017 02:00:00 AM,48,-122,1,1,2
32883,SpokaneStBridge,10/02/2017 03:00:00 AM,48,-122,0,1,1
32884,SpokaneStBridge,10/02/2017 04:00:00 AM,48,-122,5,1,6
32885,SpokaneStBridge,10/02/2017 05:00:00 AM,48,-122,21,4,25
32886,SpokaneStBridge,10/02/2017 06:00:00 AM,48,-122,50,11,61
32887,SpokaneStBridge,10/02/2017 07:00:00 AM,48,-122,156,12,168
32888,SpokaneStBridge,10/02/2017 08:00:00 AM,48,-122,141,17,158
32889,SpokaneStBridge,10/02/2017 09:00:00 AM,48,-122,56,4,60
32890,SpokaneStBridge,10/02/2017 10:00:00 AM,48,-122,20,7,27
32891,SpokaneStBridge,10/02/2017 11:00:00 AM,48,-122,8,4,12
32892,SpokaneStBridge,10/02/2017 12:00:00 PM,48,-122,4,7,11
32893,SpokaneStBridge,10/02/2017 01:00:00 PM,48,-122,8,15,23
32894,SpokaneStBridge,10/02/2017 02:00:00 PM,48,-122,8,15,23
32895,SpokaneStBridge,10/02/2017 03:00:00 PM,48,-122,8,35,43
32896,SpokaneStBridge,10/02/2017 04:00:00 PM,48,-122,17,94,111
32897,SpokaneStBridge,10/02/2017 05:00:00 PM,48,-122,16,169,185
32898,SpokaneStBridge,10/02/2017 06:00:00 PM,48,-122,13,83,96
32899,SpokaneStBridge,10/02/2017 07:00:00 PM,48,-122,12,32,44
32900,SpokaneStBridge,10/02/2017 08:00:00 PM,48,-122,2,9,11
32901,SpokaneStBridge,10/02/2017 09:00:00 PM,48,-122,1,7,8
32902,SpokaneStBridge,10/02/2017 10:00:00 PM,48,-122,0,5,5
32903,SpokaneStBridge,10/02/2017 11:00:00 PM,48,-122,1,1,2
32904,SpokaneStBridge,10/03/2017 12:00:00 AM,48,-122,0,0,0
32905,SpokaneStBridge,10/03/2017 01:00:00 AM,48,-122,0,0,0
32906,SpokaneStBridge,10/03/2017 02:00:00 AM,48,-122,1,1,2
32907,SpokaneStBridge,10/03/2017 03:00:00 AM,48,-122,1,1,2
32908,SpokaneStBridge,10/03/2017 04:00:00 AM,48,-122,7,1,8
32909,SpokaneStBridge,10/03/2017 05:00:00 AM,48,-122,27,2,29
32910,SpokaneStBridge,10/03/2017 06:00:00 AM,48,-122,54,13,67
32911,SpokaneStBridge,10/03/2017 07:00:00 AM,48,-122,151,13,164
32912,SpokaneStBridge,10/03/2017 08:00:00 AM,48,-122,139,11,150
32913,SpokaneStBridge,10/03/2017 09:00:00 AM,48,-122,64,9,73
32914,SpokaneStBridge,10/03/2017 10:00:00 AM,48,-122,18,7,25
32915,SpokaneStBridge,10/03/2017 11:00:00 AM,48,-122,12,10,22
32916,SpokaneStBridge,10/03/2017 12:00:00 PM,48,-122,11,13,24
32917,SpokaneStBridge,10/03/2017 01:00:00 PM,48,-122,22,16,38
32918,SpokaneStBridge,10/03/2017 02:00:00 PM,48,-122,18,16,34
32919,SpokaneStBridge,10/03/2017 03:00:00 PM,48,-122,17,38,55
32920,SpokaneStBridge,10/03/2017 04:00:00 PM,48,-122,16,81,97
32921,SpokaneStBridge,10/03/2017 05:00:00 PM,48,-122,20,182,202
32922,SpokaneStBridge,10/03/2017 06:00:00 PM,48,-122,16,110,126
32923,SpokaneStBridge,10/03/2017 07:00:00 PM,48,-122,5,37,42
32924,SpokaneStBridge,10/03/2017 08:00:00 PM,48,-122,2,13,15
32925,SpokaneStBridge,10/03/2017 09:00:00 PM,48,-122,2,7,9
32926,SpokaneStBridge,10/03/2017 10:00:00 PM,48,-122,2,3,5
32927,SpokaneStBridge,10/03/2017 11:00:00 PM,48,-122,3,4,7
32928,SpokaneStBridge,10/04/2017 12:00:00 AM,48,-122,1,0,1
32929,SpokaneStBridge,10/04/2017 01:00:00 AM,48,-122,0,1,1
32930,SpokaneStBridge,10/04/2017 02:00:00 AM,48,-122,1,1,2
32931,SpokaneStBridge,10/04/2017 03:00:00 AM,48,-122,1,0,1
32932,SpokaneStBridge,10/04/2017 04:00:00 AM,48,-122,1,1,2
32933,SpokaneStBridge,10/04/2017 05:00:00 AM,48,-122,21,4,25
32934,SpokaneStBridge,10/04/2017 06:00:00 AM,48,-122,58,9,67
32935,SpokaneStBridge,10/04/2017 07:00:00 AM,48,-122,141,16,157
32936,SpokaneStBridge,10/04/2017 08:00:00 AM,48,-122,125,13,138
32937,SpokaneStBridge,10/04/2017 09:00:00 AM,48,-122,48,8,56
32938,SpokaneStBridge,10/04/2017 10:00:00 AM,48,-122,24,7,31
32939,SpokaneStBridge,10/04/2017 11:00:00 AM,48,-122,5,5,10
32940,SpokaneStBridge,10/04/2017 12:00:00 PM,48,-122,14,10,24
32941,SpokaneStBridge,10/04/2017 01:00:00 PM,48,-122,15,5,20
32942,SpokaneStBridge,10/04/2017 02:00:00 PM,48,-122,14,24,38
32943,SpokaneStBridge,10/04/2017 03:00:00 PM,48,-122,16,35,51
32944,SpokaneStBridge,10/04/2017 04:00:00 PM,48,-122,21,102,123
32945,SpokaneStBridge,10/04/2017 05:00:00 PM,48,-122,30,155,185
32946,SpokaneStBridge,10/04/2017 06:00:00 PM,48,-122,10,89,99
32947,SpokaneStBridge,10/04/2017 07:00:00 PM,48,-122,8,25,33
32948,SpokaneStBridge,10/04/2017 08:00:00 PM,48,-122,9,11,20
32949,SpokaneStBridge,10/04/2017 09:00:00 PM,48,-122,3,17,20
32950,SpokaneStBridge,10/04/2017 10:00:00 PM,48,-122,1,3,4
32951,SpokaneStBridge,10/04/2017 11:00:00 PM,48,-122,0,4,4
32952,SpokaneStBridge,10/05/2017 12:00:00 AM,48,-122,2,3,5
32953,SpokaneStBridge,10/05/2017 01:00:00 AM,48,-122,4,4,8
32954,SpokaneStBridge,10/05/2017 02:00:00 AM,48,-122,0,1,1
32955,SpokaneStBridge,10/05/2017 03:00:00 AM,48,-122,2,1,3
32956,SpokaneStBridge,10/05/2017 04:00:00 AM,48,-122,4,1,5
32957,SpokaneStBridge,10/05/2017 05:00:00 AM,48,-122,22,3,25
32958,SpokaneStBridge,10/05/2017 06:00:00 AM,48,-122,58,11,69
32959,SpokaneStBridge,10/05/2017 07:00:00 AM,48,-122,128,14,142
32960,SpokaneStBridge,10/05/2017 08:00:00 AM,48,-122,134,11,145
32961,SpokaneStBridge,10/05/2017 09:00:00 AM,48,-122,46,5,51
32962,SpokaneStBridge,10/05/2017 10:00:00 AM,48,-122,25,9,34
32963,SpokaneStBridge,10/05/2017 11:00:00 AM,48,-122,21,16,37
32964,SpokaneStBridge,10/05/2017 12:00:00 PM,48,-122,9,12,21
32965,SpokaneStBridge,10/05/2017 01:00:00 PM,48,-122,18,13,31
32966,SpokaneStBridge,10/05/2017 02:00:00 PM,48,-122,18,23,41
32967,SpokaneStBridge,10/05/2017 03:00:00 PM,48,-122,18,46,64
32968,SpokaneStBridge,10/05/2017 04:00:00 PM,48,-122,24,73,97
32969,SpokaneStBridge,10/05/2017 05:00:00 PM,48,-122,25,153,178
32970,SpokaneStBridge,10/05/2017 06:00:00 PM,48,-122,20,91,111
32971,SpokaneStBridge,10/05/2017 07:00:00 PM,48,-122,15,60,75
32972,SpokaneStBridge,10/05/2017 08:00:00 PM,48,-122,6,14,20
32973,SpokaneStBridge,10/05/2017 09:00:00 PM,48,-122,10,5,15
32974,SpokaneStBridge,10/05/2017 10:00:00 PM,48,-122,3,5,8
32975,SpokaneStBridge,10/05/2017 11:00:00 PM,48,-122,3,9,12
32976,SpokaneStBridge,10/06/2017 12:00:00 AM,48,-122,5,3,8
32977,SpokaneStBridge,10/06/2017 01:00:00 AM,48,-122,8,0,8
32978,SpokaneStBridge,10/06/2017 02:00:00 AM,48,-122,1,1,2
32979,SpokaneStBridge,10/06/2017 03:00:00 AM,48,-122,0,1,1
32980,SpokaneStBridge,10/06/2017 04:00:00 AM,48,-122,4,2,6
32981,SpokaneStBridge,10/06/2017 05:00:00 AM,48,-122,15,2,17
32982,SpokaneStBridge,10/06/2017 06:00:00 AM,48,-122,40,8,48
32983,SpokaneStBridge,10/06/2017 07:00:00 AM,48,-122,112,10,122
32984,SpokaneStBridge,10/06/2017 08:00:00 AM,48,-122,104,7,111
32985,SpokaneStBridge,10/06/2017 09:00:00 AM,48,-122,43,8,51
32986,SpokaneStBridge,10/06/2017 10:00:00 AM,48,-122,19,4,23
32987,SpokaneStBridge,10/06/2017 11:00:00 AM,48,-122,12,12,24
32988,SpokaneStBridge,10/06/2017 12:00:00 PM,48,-122,14,5,19
32989,SpokaneStBridge,10/06/2017 01:00:00 PM,48,-122,16,13,29
32990,SpokaneStBridge,10/06/2017 02:00:00 PM,48,-122,15,22,37
32991,SpokaneStBridge,10/06/2017 03:00:00 PM,48,-122,14,35,49
32992,SpokaneStBridge,10/06/2017 04:00:00 PM,48,-122,13,75,88
32993,SpokaneStBridge,10/06/2017 05:00:00 PM,48,-122,16,113,129
32994,SpokaneStBridge,10/06/2017 06:00:00 PM,48,-122,13,50,63
32995,SpokaneStBridge,10/06/2017 07:00:00 PM,48,-122,8,14,22
32996,SpokaneStBridge,10/06/2017 08:00:00 PM,48,-122,1,6,7
32997,SpokaneStBridge,10/06/2017 09:00:00 PM,48,-122,1,5,6
32998,SpokaneStBridge,10/06/2017 10:00:00 PM,48,-122,3,1,4
32999,SpokaneStBridge,10/06/2017 11:00:00 PM,48,-122,1,0,1
33000,SpokaneStBridge,10/07/2017 12:00:00 AM,48,-122,0,2,2
33001,SpokaneStBridge,10/07/2017 01:00:00 AM,48,-122,1,1,2
33002,SpokaneStBridge,10/07/2017 02:00:00 AM,48,-122,1,5,6
33003,SpokaneStBridge,10/07/2017 03:00:00 AM,48,-122,0,1,1
33004,SpokaneStBridge,10/07/2017 04:00:00 AM,48,-122,1,5,6
33005,SpokaneStBridge,10/07/2017 05:00:00 AM,48,-122,2,1,3
33006,SpokaneStBridge,10/07/2017 06:00:00 AM,48,-122,1,1,2
33007,SpokaneStBridge,10/07/2017 07:00:00 AM,48,-122,5,1,6
33008,SpokaneStBridge,10/07/2017 08:00:00 AM,48,-122,11,8,19
33009,SpokaneStBridge,10/07/2017 09:00:00 AM,48,-122,15,11,26
33010,SpokaneStBridge,10/07/2017 10:00:00 AM,48,-122,17,13,30
33011,SpokaneStBridge,10/07/2017 11:00:00 AM,48,-122,16,12,28
33012,SpokaneStBridge,10/07/2017 12:00:00 PM,48,-122,11,12,23
33013,SpokaneStBridge,10/07/2017 01:00:00 PM,48,-122,9,16,25
33014,SpokaneStBridge,10/07/2017 02:00:00 PM,48,-122,13,9,22
33015,SpokaneStBridge,10/07/2017 03:00:00 PM,48,-122,8,13,21
33016,SpokaneStBridge,10/07/2017 04:00:00 PM,48,-122,9,14,23
33017,SpokaneStBridge,10/07/2017 05:00:00 PM,48,-122,13,12,25
33018,SpokaneStBridge,10/07/2017 06:00:00 PM,48,-122,11,5,16
33019,SpokaneStBridge,10/07/2017 07:00:00 PM,48,-122,0,2,2
33020,SpokaneStBridge,10/07/2017 08:00:00 PM,48,-122,2,4,6
33021,SpokaneStBridge,10/07/2017 09:00:00 PM,48,-122,2,5,7
33022,SpokaneStBridge,10/07/2017 10:00:00 PM,48,-122,1,1,2
33023,SpokaneStBridge,10/07/2017 11:00:00 PM,48,-122,0,0,0
33024,SpokaneStBridge,10/08/2017 12:00:00 AM,48,-122,0,0,0
33025,SpokaneStBridge,10/08/2017 01:00:00 AM,48,-122,2,3,5
33026,SpokaneStBridge,10/08/2017 02:00:00 AM,48,-122,0,0,0
33027,SpokaneStBridge,10/08/2017 03:00:00 AM,48,-122,0,1,1
33028,SpokaneStBridge,10/08/2017 04:00:00 AM,48,-122,3,1,4
33029,SpokaneStBridge,10/08/2017 05:00:00 AM,48,-122,3,1,4
33030,SpokaneStBridge,10/08/2017 06:00:00 AM,48,-122,4,4,8
33031,SpokaneStBridge,10/08/2017 07:00:00 AM,48,-122,5,2,7
33032,SpokaneStBridge,10/08/2017 08:00:00 AM,48,-122,16,5,21
33033,SpokaneStBridge,10/08/2017 09:00:00 AM,48,-122,7,7,14
33034,SpokaneStBridge,10/08/2017 10:00:00 AM,48,-122,19,10,29
33035,SpokaneStBridge,10/08/2017 11:00:00 AM,48,-122,13,25,38
33036,SpokaneStBridge,10/08/2017 12:00:00 PM,48,-122,23,15,38
33037,SpokaneStBridge,10/08/2017 01:00:00 PM,48,-122,26,18,44
33038,SpokaneStBridge,10/08/2017 02:00:00 PM,48,-122,13,22,35
33039,SpokaneStBridge,10/08/2017 03:00:00 PM,48,-122,27,28,55
33040,SpokaneStBridge,10/08/2017 04:00:00 PM,48,-122,31,24,55
33041,SpokaneStBridge,10/08/2017 05:00:00 PM,48,-122,14,21,35
33042,SpokaneStBridge,10/08/2017 06:00:00 PM,48,-122,9,8,17
33043,SpokaneStBridge,10/08/2017 07:00:00 PM,48,-122,10,9,19
33044,SpokaneStBridge,10/08/2017 08:00:00 PM,48,-122,2,3,5
33045,SpokaneStBridge,10/08/2017 09:00:00 PM,48,-122,0,3,3
33046,SpokaneStBridge,10/08/2017 10:00:00 PM,48,-122,1,1,2
33047,SpokaneStBridge,10/08/2017 11:00:00 PM,48,-122,1,2,3
33048,SpokaneStBridge,10/09/2017 12:00:00 AM,48,-122,0,1,1
33049,SpokaneStBridge,10/09/2017 01:00:00 AM,48,-122,0,4,4
33050,SpokaneStBridge,10/09/2017 02:00:00 AM,48,-122,0,0,0
33051,SpokaneStBridge,10/09/2017 03:00:00 AM,48,-122,0,1,1
33052,SpokaneStBridge,10/09/2017 04:00:00 AM,48,-122,2,0,2
33053,SpokaneStBridge,10/09/2017 05:00:00 AM,48,-122,19,1,20
33054,SpokaneStBridge,10/09/2017 06:00:00 AM,48,-122,51,6,57
33055,SpokaneStBridge,10/09/2017 07:00:00 AM,48,-122,127,11,138
33056,SpokaneStBridge,10/09/2017 08:00:00 AM,48,-122,128,7,135
33057,SpokaneStBridge,10/09/2017 09:00:00 AM,48,-122,46,2,48
33058,SpokaneStBridge,10/09/2017 10:00:00 AM,48,-122,20,7,27
33059,SpokaneStBridge,10/09/2017 11:00:00 AM,48,-122,11,8,19
33060,SpokaneStBridge,10/09/2017 12:00:00 PM,48,-122,15,13,28
33061,SpokaneStBridge,10/09/2017 01:00:00 PM,48,-122,14,10,24
33062,SpokaneStBridge,10/09/2017 02:00:00 PM,48,-122,15,16,31
33063,SpokaneStBridge,10/09/2017 03:00:00 PM,48,-122,15,32,47
33064,SpokaneStBridge,10/09/2017 04:00:00 PM,48,-122,15,101,116
33065,SpokaneStBridge,10/09/2017 05:00:00 PM,48,-122,17,164,181
33066,SpokaneStBridge,10/09/2017 06:00:00 PM,48,-122,18,88,106
33067,SpokaneStBridge,10/09/2017 07:00:00 PM,48,-122,9,24,33
33068,SpokaneStBridge,10/09/2017 08:00:00 PM,48,-122,4,17,21
33069,SpokaneStBridge,10/09/2017 09:00:00 PM,48,-122,4,5,9
33070,SpokaneStBridge,10/09/2017 10:00:00 PM,48,-122,2,1,3
33071,SpokaneStBridge,10/09/2017 11:00:00 PM,48,-122,0,1,1
33072,SpokaneStBridge,10/10/2017 12:00:00 AM,48,-122,1,2,3
33073,SpokaneStBridge,10/10/2017 01:00:00 AM,48,-122,0,2,2
33074,SpokaneStBridge,10/10/2017 02:00:00 AM,48,-122,3,2,5
33075,SpokaneStBridge,10/10/2017 03:00:00 AM,48,-122,0,1,1
33076,SpokaneStBridge,10/10/2017 04:00:00 AM,48,-122,2,1,3
33077,SpokaneStBridge,10/10/2017 05:00:00 AM,48,-122,23,1,24
33078,SpokaneStBridge,10/10/2017 06:00:00 AM,48,-122,44,17,61
33079,SpokaneStBridge,10/10/2017 07:00:00 AM,48,-122,116,13,129
33080,SpokaneStBridge,10/10/2017 08:00:00 AM,48,-122,113,9,122
33081,SpokaneStBridge,10/10/2017 09:00:00 AM,48,-122,41,2,43
33082,SpokaneStBridge,10/10/2017 10:00:00 AM,48,-122,19,2,21
33083,SpokaneStBridge,10/10/2017 11:00:00 AM,48,-122,9,5,14
33084,SpokaneStBridge,10/10/2017 12:00:00 PM,48,-122,4,7,11
33085,SpokaneStBridge,10/10/2017 01:00:00 PM,48,-122,7,5,12
33086,SpokaneStBridge,10/10/2017 02:00:00 PM,48,-122,4,6,10
33087,SpokaneStBridge,10/10/2017 03:00:00 PM,48,-122,7,27,34
33088,SpokaneStBridge,10/10/2017 04:00:00 PM,48,-122,14,79,93
33089,SpokaneStBridge,10/10/2017 05:00:00 PM,48,-122,15,122,137
33090,SpokaneStBridge,10/10/2017 06:00:00 PM,48,-122,13,71,84
33091,SpokaneStBridge,10/10/2017 07:00:00 PM,48,-122,4,15,19
33092,SpokaneStBridge,10/10/2017 08:00:00 PM,48,-122,2,11,13
33093,SpokaneStBridge,10/10/2017 09:00:00 PM,48,-122,1,7,8
33094,SpokaneStBridge,10/10/2017 10:00:00 PM,48,-122,0,6,6
33095,SpokaneStBridge,10/10/2017 11:00:00 PM,48,-122,1,4,5
33096,SpokaneStBridge,10/11/2017 12:00:00 AM,48,-122,2,0,2
33097,SpokaneStBridge,10/11/2017 01:00:00 AM,48,-122,1,0,1
33098,SpokaneStBridge,10/11/2017 02:00:00 AM,48,-122,1,1,2
33099,SpokaneStBridge,10/11/2017 03:00:00 AM,48,-122,0,1,1
33100,SpokaneStBridge,10/11/2017 04:00:00 AM,48,-122,1,1,2
33101,SpokaneStBridge,10/11/2017 05:00:00 AM,48,-122,21,2,23
33102,SpokaneStBridge,10/11/2017 06:00:00 AM,48,-122,56,7,63
33103,SpokaneStBridge,10/11/2017 07:00:00 AM,48,-122,83,8,91
33104,SpokaneStBridge,10/11/2017 08:00:00 AM,48,-122,143,7,150
33105,SpokaneStBridge,10/11/2017 09:00:00 AM,48,-122,43,8,51
33106,SpokaneStBridge,10/11/2017 10:00:00 AM,48,-122,20,4,24
33107,SpokaneStBridge,10/11/2017 11:00:00 AM,48,-122,11,5,16
33108,SpokaneStBridge,10/11/2017 12:00:00 PM,48,-122,9,10,19
33109,SpokaneStBridge,10/11/2017 01:00:00 PM,48,-122,13,9,22
33110,SpokaneStBridge,10/11/2017 02:00:00 PM,48,-122,7,12,19
33111,SpokaneStBridge,10/11/2017 03:00:00 PM,48,-122,14,32,46
33112,SpokaneStBridge,10/11/2017 04:00:00 PM,48,-122,12,69,81
33113,SpokaneStBridge,10/11/2017 05:00:00 PM,48,-122,20,119,139
33114,SpokaneStBridge,10/11/2017 06:00:00 PM,48,-122,13,70,83
33115,SpokaneStBridge,10/11/2017 07:00:00 PM,48,-122,6,19,25
33116,SpokaneStBridge,10/11/2017 08:00:00 PM,48,-122,4,12,16
33117,SpokaneStBridge,10/11/2017 09:00:00 PM,48,-122,1,7,8
33118,SpokaneStBridge,10/11/2017 10:00:00 PM,48,-122,5,6,11
33119,SpokaneStBridge,10/11/2017 11:00:00 PM,48,-122,1,1,2
33120,SpokaneStBridge,10/12/2017 12:00:00 AM,48,-122,0,0,0
33121,SpokaneStBridge,10/12/2017 01:00:00 AM,48,-122,2,0,2
33122,SpokaneStBridge,10/12/2017 02:00:00 AM,48,-122,0,3,3
33123,SpokaneStBridge,10/12/2017 03:00:00 AM,48,-122,0,2,2
33124,SpokaneStBridge,10/12/2017 04:00:00 AM,48,-122,4,1,5
33125,SpokaneStBridge,10/12/2017 05:00:00 AM,48,-122,16,0,16
33126,SpokaneStBridge,10/12/2017 06:00:00 AM,48,-122,39,7,46
33127,SpokaneStBridge,10/12/2017 07:00:00 AM,48,-122,82,10,92
33128,SpokaneStBridge,10/12/2017 08:00:00 AM,48,-122,90,7,97
33129,SpokaneStBridge,10/12/2017 09:00:00 AM,48,-122,34,6,40
33130,SpokaneStBridge,10/12/2017 10:00:00 AM,48,-122,12,6,18
33131,SpokaneStBridge,10/12/2017 11:00:00 AM,48,-122,9,3,12
33132,SpokaneStBridge,10/12/2017 12:00:00 PM,48,-122,4,4,8
33133,SpokaneStBridge,10/12/2017 01:00:00 PM,48,-122,4,2,6
33134,SpokaneStBridge,10/12/2017 02:00:00 PM,48,-122,6,7,13
33135,SpokaneStBridge,10/12/2017 03:00:00 PM,48,-122,4,15,19
33136,SpokaneStBridge,10/12/2017 04:00:00 PM,48,-122,12,54,66
33137,SpokaneStBridge,10/12/2017 05:00:00 PM,48,-122,12,97,109
33138,SpokaneStBridge,10/12/2017 06:00:00 PM,48,-122,9,56,65
33139,SpokaneStBridge,10/12/2017 07:00:00 PM,48,-122,2,19,21
33140,SpokaneStBridge,10/12/2017 08:00:00 PM,48,-122,1,6,7
33141,SpokaneStBridge,10/12/2017 09:00:00 PM,48,-122,2,7,9
33142,SpokaneStBridge,10/12/2017 10:00:00 PM,48,-122,1,3,4
33143,SpokaneStBridge,10/12/2017 11:00:00 PM,48,-122,2,4,6
33144,SpokaneStBridge,10/13/2017 12:00:00 AM,48,-122,0,0,0
33145,SpokaneStBridge,10/13/2017 01:00:00 AM,48,-122,2,1,3
33146,SpokaneStBridge,10/13/2017 02:00:00 AM,48,-122,0,0,0
33147,SpokaneStBridge,10/13/2017 03:00:00 AM,48,-122,0,1,1
33148,SpokaneStBridge,10/13/2017 04:00:00 AM,48,-122,3,1,4
33149,SpokaneStBridge,10/13/2017 05:00:00 AM,48,-122,16,1,17
33150,SpokaneStBridge,10/13/2017 06:00:00 AM,48,-122,28,7,35
33151,SpokaneStBridge,10/13/2017 07:00:00 AM,48,-122,94,12,106
33152,SpokaneStBridge,10/13/2017 08:00:00 AM,48,-122,98,6,104
33153,SpokaneStBridge,10/13/2017 09:00:00 AM,48,-122,35,4,39
33154,SpokaneStBridge,10/13/2017 10:00:00 AM,48,-122,15,4,19
33155,SpokaneStBridge,10/13/2017 11:00:00 AM,48,-122,9,4,13
33156,SpokaneStBridge,10/13/2017 12:00:00 PM,48,-122,12,6,18
33157,SpokaneStBridge,10/13/2017 01:00:00 PM,48,-122,4,8,12
33158,SpokaneStBridge,10/13/2017 02:00:00 PM,48,-122,15,11,26
33159,SpokaneStBridge,10/13/2017 03:00:00 PM,48,-122,10,24,34
33160,SpokaneStBridge,10/13/2017 04:00:00 PM,48,-122,14,69,83
33161,SpokaneStBridge,10/13/2017 05:00:00 PM,48,-122,19,111,130
33162,SpokaneStBridge,10/13/2017 06:00:00 PM,48,-122,14,55,69
33163,SpokaneStBridge,10/13/2017 07:00:00 PM,48,-122,5,19,24
33164,SpokaneStBridge,10/13/2017 08:00:00 PM,48,-122,6,7,13
33165,SpokaneStBridge,10/13/2017 09:00:00 PM,48,-122,3,4,7
33166,SpokaneStBridge,10/13/2017 10:00:00 PM,48,-122,1,3,4
33167,SpokaneStBridge,10/13/2017 11:00:00 PM,48,-122,2,4,6
33168,SpokaneStBridge,10/14/2017 12:00:00 AM,48,-122,1,3,4
33169,SpokaneStBridge,10/14/2017 01:00:00 AM,48,-122,0,2,2
33170,SpokaneStBridge,10/14/2017 02:00:00 AM,48,-122,1,2,3
33171,SpokaneStBridge,10/14/2017 03:00:00 AM,48,-122,0,0,0
33172,SpokaneStBridge,10/14/2017 04:00:00 AM,48,-122,1,4,5
33173,SpokaneStBridge,10/14/2017 05:00:00 AM,48,-122,2,0,2
33174,SpokaneStBridge,10/14/2017 06:00:00 AM,48,-122,3,4,7
33175,SpokaneStBridge,10/14/2017 07:00:00 AM,48,-122,3,3,6
33176,SpokaneStBridge,10/14/2017 08:00:00 AM,48,-122,21,6,27
33177,SpokaneStBridge,10/14/2017 09:00:00 AM,48,-122,12,10,22
33178,SpokaneStBridge,10/14/2017 10:00:00 AM,48,-122,15,11,26
33179,SpokaneStBridge,10/14/2017 11:00:00 AM,48,-122,10,19,29
33180,SpokaneStBridge,10/14/2017 12:00:00 PM,48,-122,27,14,41
33181,SpokaneStBridge,10/14/2017 01:00:00 PM,48,-122,14,11,25
33182,SpokaneStBridge,10/14/2017 02:00:00 PM,48,-122,12,24,36
33183,SpokaneStBridge,10/14/2017 03:00:00 PM,48,-122,24,13,37
33184,SpokaneStBridge,10/14/2017 04:00:00 PM,48,-122,15,24,39
33185,SpokaneStBridge,10/14/2017 05:00:00 PM,48,-122,7,12,19
33186,SpokaneStBridge,10/14/2017 06:00:00 PM,48,-122,9,11,20
33187,SpokaneStBridge,10/14/2017 07:00:00 PM,48,-122,2,4,6
33188,SpokaneStBridge,10/14/2017 08:00:00 PM,48,-122,5,5,10
33189,SpokaneStBridge,10/14/2017 09:00:00 PM,48,-122,1,2,3
33190,SpokaneStBridge,10/14/2017 10:00:00 PM,48,-122,3,3,6
33191,SpokaneStBridge,10/14/2017 11:00:00 PM,48,-122,1,2,3
33192,SpokaneStBridge,10/15/2017 12:00:00 AM,48,-122,0,2,2
33193,SpokaneStBridge,10/15/2017 01:00:00 AM,48,-122,0,4,4
33194,SpokaneStBridge,10/15/2017 02:00:00 AM,48,-122,1,1,2
33195,SpokaneStBridge,10/15/2017 03:00:00 AM,48,-122,1,0,1
33196,SpokaneStBridge,10/15/2017 04:00:00 AM,48,-122,1,1,2
33197,SpokaneStBridge,10/15/2017 05:00:00 AM,48,-122,4,0,4
33198,SpokaneStBridge,10/15/2017 06:00:00 AM,48,-122,6,4,10
33199,SpokaneStBridge,10/15/2017 07:00:00 AM,48,-122,3,3,6
33200,SpokaneStBridge,10/15/2017 08:00:00 AM,48,-122,17,7,24
33201,SpokaneStBridge,10/15/2017 09:00:00 AM,48,-122,10,11,21
33202,SpokaneStBridge,10/15/2017 10:00:00 AM,48,-122,24,15,39
33203,SpokaneStBridge,10/15/2017 11:00:00 AM,48,-122,21,21,42
33204,SpokaneStBridge,10/15/2017 12:00:00 PM,48,-122,24,26,50
33205,SpokaneStBridge,10/15/2017 01:00:00 PM,48,-122,31,37,68
33206,SpokaneStBridge,10/15/2017 02:00:00 PM,48,-122,37,34,71
33207,SpokaneStBridge,10/15/2017 03:00:00 PM,48,-122,42,27,69
33208,SpokaneStBridge,10/15/2017 04:00:00 PM,48,-122,27,29,56
33209,SpokaneStBridge,10/15/2017 05:00:00 PM,48,-122,21,17,38
33210,SpokaneStBridge,10/15/2017 06:00:00 PM,48,-122,8,14,22
33211,SpokaneStBridge,10/15/2017 07:00:00 PM,48,-122,3,10,13
33212,SpokaneStBridge,10/15/2017 08:00:00 PM,48,-122,0,6,6
33213,SpokaneStBridge,10/15/2017 09:00:00 PM,48,-122,4,6,10
33214,SpokaneStBridge,10/15/2017 10:00:00 PM,48,-122,2,0,2
33215,SpokaneStBridge,10/15/2017 11:00:00 PM,48,-122,3,1,4
33216,SpokaneStBridge,10/16/2017 12:00:00 AM,48,-122,0,1,1
33217,SpokaneStBridge,10/16/2017 01:00:00 AM,48,-122,0,4,4
33218,SpokaneStBridge,10/16/2017 02:00:00 AM,48,-122,2,0,2
33219,SpokaneStBridge,10/16/2017 03:00:00 AM,48,-122,4,2,6
33220,SpokaneStBridge,10/16/2017 04:00:00 AM,48,-122,4,1,5
33221,SpokaneStBridge,10/16/2017 05:00:00 AM,48,-122,18,2,20
33222,SpokaneStBridge,10/16/2017 06:00:00 AM,48,-122,62,7,69
33223,SpokaneStBridge,10/16/2017 07:00:00 AM,48,-122,135,11,146
33224,SpokaneStBridge,10/16/2017 08:00:00 AM,48,-122,137,11,148
33225,SpokaneStBridge,10/16/2017 09:00:00 AM,48,-122,45,6,51
33226,SpokaneStBridge,10/16/2017 10:00:00 AM,48,-122,15,7,22
33227,SpokaneStBridge,10/16/2017 11:00:00 AM,48,-122,11,3,14
33228,SpokaneStBridge,10/16/2017 12:00:00 PM,48,-122,10,10,20
33229,SpokaneStBridge,10/16/2017 01:00:00 PM,48,-122,10,6,16
33230,SpokaneStBridge,10/16/2017 02:00:00 PM,48,-122,7,15,22
33231,SpokaneStBridge,10/16/2017 03:00:00 PM,48,-122,14,29,43
33232,SpokaneStBridge,10/16/2017 04:00:00 PM,48,-122,19,96,115
33233,SpokaneStBridge,10/16/2017 05:00:00 PM,48,-122,20,157,177
33234,SpokaneStBridge,10/16/2017 06:00:00 PM,48,-122,10,97,107
33235,SpokaneStBridge,10/16/2017 07:00:00 PM,48,-122,4,14,18
33236,SpokaneStBridge,10/16/2017 08:00:00 PM,48,-122,2,7,9
33237,SpokaneStBridge,10/16/2017 09:00:00 PM,48,-122,1,6,7
33238,SpokaneStBridge,10/16/2017 10:00:00 PM,48,-122,1,2,3
33239,SpokaneStBridge,10/16/2017 11:00:00 PM,48,-122,0,3,3
33240,SpokaneStBridge,10/17/2017 12:00:00 AM,48,-122,2,4,6
33241,SpokaneStBridge,10/17/2017 01:00:00 AM,48,-122,0,0,0
33242,SpokaneStBridge,10/17/2017 02:00:00 AM,48,-122,0,1,1
33243,SpokaneStBridge,10/17/2017 03:00:00 AM,48,-122,1,1,2
33244,SpokaneStBridge,10/17/2017 04:00:00 AM,48,-122,1,3,4
33245,SpokaneStBridge,10/17/2017 05:00:00 AM,48,-122,21,3,24
33246,SpokaneStBridge,10/17/2017 06:00:00 AM,48,-122,45,6,51
33247,SpokaneStBridge,10/17/2017 07:00:00 AM,48,-122,107,8,115
33248,SpokaneStBridge,10/17/2017 08:00:00 AM,48,-122,81,6,87
33249,SpokaneStBridge,10/17/2017 09:00:00 AM,48,-122,37,1,38
33250,SpokaneStBridge,10/17/2017 10:00:00 AM,48,-122,10,4,14
33251,SpokaneStBridge,10/17/2017 11:00:00 AM,48,-122,15,1,16
33252,SpokaneStBridge,10/17/2017 12:00:00 PM,48,-122,2,5,7
33253,SpokaneStBridge,10/17/2017 01:00:00 PM,48,-122,5,5,10
33254,SpokaneStBridge,10/17/2017 02:00:00 PM,48,-122,7,5,12
33255,SpokaneStBridge,10/17/2017 03:00:00 PM,48,-122,12,12,24
33256,SpokaneStBridge,10/17/2017 04:00:00 PM,48,-122,13,72,85
33257,SpokaneStBridge,10/17/2017 05:00:00 PM,48,-122,14,108,122
33258,SpokaneStBridge,10/17/2017 06:00:00 PM,48,-122,12,67,79
33259,SpokaneStBridge,10/17/2017 07:00:00 PM,48,-122,1,16,17
33260,SpokaneStBridge,10/17/2017 08:00:00 PM,48,-122,1,9,10
33261,SpokaneStBridge,10/17/2017 09:00:00 PM,48,-122,4,5,9
33262,SpokaneStBridge,10/17/2017 10:00:00 PM,48,-122,1,4,5
33263,SpokaneStBridge,10/17/2017 11:00:00 PM,48,-122,0,4,4
33264,SpokaneStBridge,10/18/2017 12:00:00 AM,48,-122,2,5,7
33265,SpokaneStBridge,10/18/2017 01:00:00 AM,48,-122,1,2,3
33266,SpokaneStBridge,10/18/2017 02:00:00 AM,48,-122,1,2,3
33267,SpokaneStBridge,10/18/2017 03:00:00 AM,48,-122,1,1,2
33268,SpokaneStBridge,10/18/2017 04:00:00 AM,48,-122,4,1,5
33269,SpokaneStBridge,10/18/2017 05:00:00 AM,48,-122,13,5,18
33270,SpokaneStBridge,10/18/2017 06:00:00 AM,48,-122,45,8,53
33271,SpokaneStBridge,10/18/2017 07:00:00 AM,48,-122,103,10,113
33272,SpokaneStBridge,10/18/2017 08:00:00 AM,48,-122,82,6,88
33273,SpokaneStBridge,10/18/2017 09:00:00 AM,48,-122,27,7,34
33274,SpokaneStBridge,10/18/2017 10:00:00 AM,48,-122,9,1,10
33275,SpokaneStBridge,10/18/2017 11:00:00 AM,48,-122,4,3,7
33276,SpokaneStBridge,10/18/2017 12:00:00 PM,48,-122,2,1,3
33277,SpokaneStBridge,10/18/2017 01:00:00 PM,48,-122,2,4,6
33278,SpokaneStBridge,10/18/2017 02:00:00 PM,48,-122,3,8,11
33279,SpokaneStBridge,10/18/2017 03:00:00 PM,48,-122,10,23,33
33280,SpokaneStBridge,10/18/2017 04:00:00 PM,48,-122,5,43,48
33281,SpokaneStBridge,10/18/2017 05:00:00 PM,48,-122,15,87,102
33282,SpokaneStBridge,10/18/2017 06:00:00 PM,48,-122,2,41,43
33283,SpokaneStBridge,10/18/2017 07:00:00 PM,48,-122,4,14,18
33284,SpokaneStBridge,10/18/2017 08:00:00 PM,48,-122,1,9,10
33285,SpokaneStBridge,10/18/2017 09:00:00 PM,48,-122,0,5,5
33286,SpokaneStBridge,10/18/2017 10:00:00 PM,48,-122,1,1,2
33287,SpokaneStBridge,10/18/2017 11:00:00 PM,48,-122,0,2,2
33288,SpokaneStBridge,10/19/2017 12:00:00 AM,48,-122,1,0,1
33289,SpokaneStBridge,10/19/2017 01:00:00 AM,48,-122,0,1,1
33290,SpokaneStBridge,10/19/2017 02:00:00 AM,48,-122,0,1,1
33291,SpokaneStBridge,10/19/2017 03:00:00 AM,48,-122,0,0,0
33292,SpokaneStBridge,10/19/2017 04:00:00 AM,48,-122,2,0,2
33293,SpokaneStBridge,10/19/2017 05:00:00 AM,48,-122,12,1,13
33294,SpokaneStBridge,10/19/2017 06:00:00 AM,48,-122,28,8,36
33295,SpokaneStBridge,10/19/2017 07:00:00 AM,48,-122,58,4,62
33296,SpokaneStBridge,10/19/2017 08:00:00 AM,48,-122,70,7,77
33297,SpokaneStBridge,10/19/2017 09:00:00 AM,48,-122,24,3,27
33298,SpokaneStBridge,10/19/2017 10:00:00 AM,48,-122,17,6,23
33299,SpokaneStBridge,10/19/2017 11:00:00 AM,48,-122,2,2,4
33300,SpokaneStBridge,10/19/2017 12:00:00 PM,48,-122,3,6,9
33301,SpokaneStBridge,10/19/2017 01:00:00 PM,48,-122,7,3,10
33302,SpokaneStBridge,10/19/2017 02:00:00 PM,48,-122,9,8,17
33303,SpokaneStBridge,10/19/2017 03:00:00 PM,48,-122,2,19,21
33304,SpokaneStBridge,10/19/2017 04:00:00 PM,48,-122,10,29,39
33305,SpokaneStBridge,10/19/2017 05:00:00 PM,48,-122,11,61,72
33306,SpokaneStBridge,10/19/2017 06:00:00 PM,48,-122,5,48,53
33307,SpokaneStBridge,10/19/2017 07:00:00 PM,48,-122,1,16,17
33308,SpokaneStBridge,10/19/2017 08:00:00 PM,48,-122,1,6,7
33309,SpokaneStBridge,10/19/2017 09:00:00 PM,48,-122,2,3,5
33310,SpokaneStBridge,10/19/2017 10:00:00 PM,48,-122,0,3,3
33311,SpokaneStBridge,10/19/2017 11:00:00 PM,48,-122,1,1,2
33312,SpokaneStBridge,10/20/2017 12:00:00 AM,48,-122,0,1,1
33313,SpokaneStBridge,10/20/2017 01:00:00 AM,48,-122,2,0,2
33314,SpokaneStBridge,10/20/2017 02:00:00 AM,48,-122,0,3,3
33315,SpokaneStBridge,10/20/2017 03:00:00 AM,48,-122,1,0,1
33316,SpokaneStBridge,10/20/2017 04:00:00 AM,48,-122,6,1,7
33317,SpokaneStBridge,10/20/2017 05:00:00 AM,48,-122,12,1,13
33318,SpokaneStBridge,10/20/2017 06:00:00 AM,48,-122,29,4,33
33319,SpokaneStBridge,10/20/2017 07:00:00 AM,48,-122,61,8,69
33320,SpokaneStBridge,10/20/2017 08:00:00 AM,48,-122,74,6,80
33321,SpokaneStBridge,10/20/2017 09:00:00 AM,48,-122,26,2,28
33322,SpokaneStBridge,10/20/2017 10:00:00 AM,48,-122,10,4,14
33323,SpokaneStBridge,10/20/2017 11:00:00 AM,48,-122,6,5,11
33324,SpokaneStBridge,10/20/2017 12:00:00 PM,48,-122,7,4,11
33325,SpokaneStBridge,10/20/2017 01:00:00 PM,48,-122,4,3,7
33326,SpokaneStBridge,10/20/2017 02:00:00 PM,48,-122,9,11,20
33327,SpokaneStBridge,10/20/2017 03:00:00 PM,48,-122,7,17,24
33328,SpokaneStBridge,10/20/2017 04:00:00 PM,48,-122,11,48,59
33329,SpokaneStBridge,10/20/2017 05:00:00 PM,48,-122,8,80,88
33330,SpokaneStBridge,10/20/2017 06:00:00 PM,48,-122,6,41,47
33331,SpokaneStBridge,10/20/2017 07:00:00 PM,48,-122,2,12,14
33332,SpokaneStBridge,10/20/2017 08:00:00 PM,48,-122,1,7,8
33333,SpokaneStBridge,10/20/2017 09:00:00 PM,48,-122,1,2,3
33334,SpokaneStBridge,10/20/2017 10:00:00 PM,48,-122,1,2,3
33335,SpokaneStBridge,10/20/2017 11:00:00 PM,48,-122,0,2,2
33336,SpokaneStBridge,10/21/2017 12:00:00 AM,48,-122,1,2,3
33337,SpokaneStBridge,10/21/2017 01:00:00 AM,48,-122,2,2,4
33338,SpokaneStBridge,10/21/2017 02:00:00 AM,48,-122,0,1,1
33339,SpokaneStBridge,10/21/2017 03:00:00 AM,48,-122,0,1,1
33340,SpokaneStBridge,10/21/2017 04:00:00 AM,48,-122,1,1,2
33341,SpokaneStBridge,10/21/2017 05:00:00 AM,48,-122,1,1,2
33342,SpokaneStBridge,10/21/2017 06:00:00 AM,48,-122,1,2,3
33343,SpokaneStBridge,10/21/2017 07:00:00 AM,48,-122,2,2,4
33344,SpokaneStBridge,10/21/2017 08:00:00 AM,48,-122,5,2,7
33345,SpokaneStBridge,10/21/2017 09:00:00 AM,48,-122,5,7,12
33346,SpokaneStBridge,10/21/2017 10:00:00 AM,48,-122,4,3,7
33347,SpokaneStBridge,10/21/2017 11:00:00 AM,48,-122,4,2,6
33348,SpokaneStBridge,10/21/2017 12:00:00 PM,48,-122,3,3,6
33349,SpokaneStBridge,10/21/2017 01:00:00 PM,48,-122,5,6,11
33350,SpokaneStBridge,10/21/2017 02:00:00 PM,48,-122,4,1,5
33351,SpokaneStBridge,10/21/2017 03:00:00 PM,48,-122,3,7,10
33352,SpokaneStBridge,10/21/2017 04:00:00 PM,48,-122,3,2,5
33353,SpokaneStBridge,10/21/2017 05:00:00 PM,48,-122,4,7,11
33354,SpokaneStBridge,10/21/2017 06:00:00 PM,48,-122,5,2,7
33355,SpokaneStBridge,10/21/2017 07:00:00 PM,48,-122,0,5,5
33356,SpokaneStBridge,10/21/2017 08:00:00 PM,48,-122,2,0,2
33357,SpokaneStBridge,10/21/2017 09:00:00 PM,48,-122,0,2,2
33358,SpokaneStBridge,10/21/2017 10:00:00 PM,48,-122,0,0,0
33359,SpokaneStBridge,10/21/2017 11:00:00 PM,48,-122,0,1,1
33360,SpokaneStBridge,10/22/2017 12:00:00 AM,48,-122,0,0,0
33361,SpokaneStBridge,10/22/2017 01:00:00 AM,48,-122,1,0,1
33362,SpokaneStBridge,10/22/2017 02:00:00 AM,48,-122,0,0,0
33363,SpokaneStBridge,10/22/2017 03:00:00 AM,48,-122,0,1,1
33364,SpokaneStBridge,10/22/2017 04:00:00 AM,48,-122,1,0,1
33365,SpokaneStBridge,10/22/2017 05:00:00 AM,48,-122,1,1,2
33366,SpokaneStBridge,10/22/2017 06:00:00 AM,48,-122,5,5,10
33367,SpokaneStBridge,10/22/2017 07:00:00 AM,48,-122,2,0,2
33368,SpokaneStBridge,10/22/2017 08:00:00 AM,48,-122,11,9,20
33369,SpokaneStBridge,10/22/2017 09:00:00 AM,48,-122,8,3,11
33370,SpokaneStBridge,10/22/2017 10:00:00 AM,48,-122,15,30,45
33371,SpokaneStBridge,10/22/2017 11:00:00 AM,48,-122,27,17,44
33372,SpokaneStBridge,10/22/2017 12:00:00 PM,48,-122,16,10,26
33373,SpokaneStBridge,10/22/2017 01:00:00 PM,48,-122,20,20,40
33374,SpokaneStBridge,10/22/2017 02:00:00 PM,48,-122,13,12,25
33375,SpokaneStBridge,10/22/2017 03:00:00 PM,48,-122,19,16,35
33376,SpokaneStBridge,10/22/2017 04:00:00 PM,48,-122,14,15,29
33377,SpokaneStBridge,10/22/2017 05:00:00 PM,48,-122,11,9,20
33378,SpokaneStBridge,10/22/2017 06:00:00 PM,48,-122,6,3,9
33379,SpokaneStBridge,10/22/2017 07:00:00 PM,48,-122,1,2,3
33380,SpokaneStBridge,10/22/2017 08:00:00 PM,48,-122,3,0,3
33381,SpokaneStBridge,10/22/2017 09:00:00 PM,48,-122,2,2,4
33382,SpokaneStBridge,10/22/2017 10:00:00 PM,48,-122,0,4,4
33383,SpokaneStBridge,10/22/2017 11:00:00 PM,48,-122,1,2,3
33384,SpokaneStBridge,10/23/2017 12:00:00 AM,48,-122,2,1,3
33385,SpokaneStBridge,10/23/2017 01:00:00 AM,48,-122,1,2,3
33386,SpokaneStBridge,10/23/2017 02:00:00 AM,48,-122,0,1,1
33387,SpokaneStBridge,10/23/2017 03:00:00 AM,48,-122,0,0,0
33388,SpokaneStBridge,10/23/2017 04:00:00 AM,48,-122,4,0,4
33389,SpokaneStBridge,10/23/2017 05:00:00 AM,48,-122,20,2,22
33390,SpokaneStBridge,10/23/2017 06:00:00 AM,48,-122,65,15,80
33391,SpokaneStBridge,10/23/2017 07:00:00 AM,48,-122,108,9,117
33392,SpokaneStBridge,10/23/2017 08:00:00 AM,48,-122,145,15,160
33393,SpokaneStBridge,10/23/2017 09:00:00 AM,48,-122,57,5,62
33394,SpokaneStBridge,10/23/2017 10:00:00 AM,48,-122,22,12,34
33395,SpokaneStBridge,10/23/2017 11:00:00 AM,48,-122,12,5,17
33396,SpokaneStBridge,10/23/2017 12:00:00 PM,48,-122,14,4,18
33397,SpokaneStBridge,10/23/2017 01:00:00 PM,48,-122,11,12,23
33398,SpokaneStBridge,10/23/2017 02:00:00 PM,48,-122,12,20,32
33399,SpokaneStBridge,10/23/2017 03:00:00 PM,48,-122,20,33,53
33400,SpokaneStBridge,10/23/2017 04:00:00 PM,48,-122,15,95,110
33401,SpokaneStBridge,10/23/2017 05:00:00 PM,48,-122,29,181,210
33402,SpokaneStBridge,10/23/2017 06:00:00 PM,48,-122,19,76,95
33403,SpokaneStBridge,10/23/2017 07:00:00 PM,48,-122,1,20,21
33404,SpokaneStBridge,10/23/2017 08:00:00 PM,48,-122,2,9,11
33405,SpokaneStBridge,10/23/2017 09:00:00 PM,48,-122,1,10,11
33406,SpokaneStBridge,10/23/2017 10:00:00 PM,48,-122,3,2,5
33407,SpokaneStBridge,10/23/2017 11:00:00 PM,48,-122,1,1,2
33408,SpokaneStBridge,10/24/2017 12:00:00 AM,48,-122,2,1,3
33409,SpokaneStBridge,10/24/2017 01:00:00 AM,48,-122,1,1,2
33410,SpokaneStBridge,10/24/2017 02:00:00 AM,48,-122,0,4,4
33411,SpokaneStBridge,10/24/2017 03:00:00 AM,48,-122,0,2,2
33412,SpokaneStBridge,10/24/2017 04:00:00 AM,48,-122,3,1,4
33413,SpokaneStBridge,10/24/2017 05:00:00 AM,48,-122,30,5,35
33414,SpokaneStBridge,10/24/2017 06:00:00 AM,48,-122,58,12,70
33415,SpokaneStBridge,10/24/2017 07:00:00 AM,48,-122,136,19,155
33416,SpokaneStBridge,10/24/2017 08:00:00 AM,48,-122,137,16,153
33417,SpokaneStBridge,10/24/2017 09:00:00 AM,48,-122,57,7,64
33418,SpokaneStBridge,10/24/2017 10:00:00 AM,48,-122,19,5,24
33419,SpokaneStBridge,10/24/2017 11:00:00 AM,48,-122,13,10,23
33420,SpokaneStBridge,10/24/2017 12:00:00 PM,48,-122,11,9,20
33421,SpokaneStBridge,10/24/2017 01:00:00 PM,48,-122,16,16,32
33422,SpokaneStBridge,10/24/2017 02:00:00 PM,48,-122,17,13,30
33423,SpokaneStBridge,10/24/2017 03:00:00 PM,48,-122,14,41,55
33424,SpokaneStBridge,10/24/2017 04:00:00 PM,48,-122,21,92,113
33425,SpokaneStBridge,10/24/2017 05:00:00 PM,48,-122,33,181,214
33426,SpokaneStBridge,10/24/2017 06:00:00 PM,48,-122,15,77,92
33427,SpokaneStBridge,10/24/2017 07:00:00 PM,48,-122,4,25,29
33428,SpokaneStBridge,10/24/2017 08:00:00 PM,48,-122,0,9,9
33429,SpokaneStBridge,10/24/2017 09:00:00 PM,48,-122,2,14,16
33430,SpokaneStBridge,10/24/2017 10:00:00 PM,48,-122,2,4,6
33431,SpokaneStBridge,10/24/2017 11:00:00 PM,48,-122,0,2,2
33432,SpokaneStBridge,10/25/2017 12:00:00 AM,48,-122,0,0,0
33433,SpokaneStBridge,10/25/2017 01:00:00 AM,48,-122,1,5,6
33434,SpokaneStBridge,10/25/2017 02:00:00 AM,48,-122,1,2,3
33435,SpokaneStBridge,10/25/2017 03:00:00 AM,48,-122,1,3,4
33436,SpokaneStBridge,10/25/2017 04:00:00 AM,48,-122,5,3,8
33437,SpokaneStBridge,10/25/2017 05:00:00 AM,48,-122,21,2,23
33438,SpokaneStBridge,10/25/2017 06:00:00 AM,48,-122,48,4,52
33439,SpokaneStBridge,10/25/2017 07:00:00 AM,48,-122,107,19,126
33440,SpokaneStBridge,10/25/2017 08:00:00 AM,48,-122,123,16,139
33441,SpokaneStBridge,10/25/2017 09:00:00 AM,48,-122,42,7,49
33442,SpokaneStBridge,10/25/2017 10:00:00 AM,48,-122,21,2,23
33443,SpokaneStBridge,10/25/2017 11:00:00 AM,48,-122,14,3,17
33444,SpokaneStBridge,10/25/2017 12:00:00 PM,48,-122,8,7,15
33445,SpokaneStBridge,10/25/2017 01:00:00 PM,48,-122,9,10,19
33446,SpokaneStBridge,10/25/2017 02:00:00 PM,48,-122,3,7,10
33447,SpokaneStBridge,10/25/2017 03:00:00 PM,48,-122,18,42,60
33448,SpokaneStBridge,10/25/2017 04:00:00 PM,48,-122,10,64,74
33449,SpokaneStBridge,10/25/2017 05:00:00 PM,48,-122,18,136,154
33450,SpokaneStBridge,10/25/2017 06:00:00 PM,48,-122,6,63,69
33451,SpokaneStBridge,10/25/2017 07:00:00 PM,48,-122,5,27,32
33452,SpokaneStBridge,10/25/2017 08:00:00 PM,48,-122,7,14,21
33453,SpokaneStBridge,10/25/2017 09:00:00 PM,48,-122,1,3,4
33454,SpokaneStBridge,10/25/2017 10:00:00 PM,48,-122,0,6,6
33455,SpokaneStBridge,10/25/2017 11:00:00 PM,48,-122,0,0,0
33456,SpokaneStBridge,10/26/2017 12:00:00 AM,48,-122,1,0,1
33457,SpokaneStBridge,10/26/2017 01:00:00 AM,48,-122,0,1,1
33458,SpokaneStBridge,10/26/2017 02:00:00 AM,48,-122,1,1,2
33459,SpokaneStBridge,10/26/2017 03:00:00 AM,48,-122,1,1,2
33460,SpokaneStBridge,10/26/2017 04:00:00 AM,48,-122,4,1,5
33461,SpokaneStBridge,10/26/2017 05:00:00 AM,48,-122,25,1,26
33462,SpokaneStBridge,10/26/2017 06:00:00 AM,48,-122,62,9,71
33463,SpokaneStBridge,10/26/2017 07:00:00 AM,48,-122,123,15,138
33464,SpokaneStBridge,10/26/2017 08:00:00 AM,48,-122,119,19,138
33465,SpokaneStBridge,10/26/2017 09:00:00 AM,48,-122,51,7,58
33466,SpokaneStBridge,10/26/2017 10:00:00 AM,48,-122,17,2,19
33467,SpokaneStBridge,10/26/2017 11:00:00 AM,48,-122,9,12,21
33468,SpokaneStBridge,10/26/2017 12:00:00 PM,48,-122,10,4,14
33469,SpokaneStBridge,10/26/2017 01:00:00 PM,48,-122,10,12,22
33470,SpokaneStBridge,10/26/2017 02:00:00 PM,48,-122,8,15,23
33471,SpokaneStBridge,10/26/2017 03:00:00 PM,48,-122,17,29,46
33472,SpokaneStBridge,10/26/2017 04:00:00 PM,48,-122,27,97,124
33473,SpokaneStBridge,10/26/2017 05:00:00 PM,48,-122,27,136,163
33474,SpokaneStBridge,10/26/2017 06:00:00 PM,48,-122,18,87,105
33475,SpokaneStBridge,10/26/2017 07:00:00 PM,48,-122,12,33,45
33476,SpokaneStBridge,10/26/2017 08:00:00 PM,48,-122,5,8,13
33477,SpokaneStBridge,10/26/2017 09:00:00 PM,48,-122,5,11,16
33478,SpokaneStBridge,10/26/2017 10:00:00 PM,48,-122,0,1,1
33479,SpokaneStBridge,10/26/2017 11:00:00 PM,48,-122,3,3,6
33480,SpokaneStBridge,10/27/2017 12:00:00 AM,48,-122,0,1,1
33481,SpokaneStBridge,10/27/2017 01:00:00 AM,48,-122,3,1,4
33482,SpokaneStBridge,10/27/2017 02:00:00 AM,48,-122,2,4,6
33483,SpokaneStBridge,10/27/2017 03:00:00 AM,48,-122,0,2,2
33484,SpokaneStBridge,10/27/2017 04:00:00 AM,48,-122,3,0,3
33485,SpokaneStBridge,10/27/2017 05:00:00 AM,48,-122,17,1,18
33486,SpokaneStBridge,10/27/2017 06:00:00 AM,48,-122,45,4,49
33487,SpokaneStBridge,10/27/2017 07:00:00 AM,48,-122,101,10,111
33488,SpokaneStBridge,10/27/2017 08:00:00 AM,48,-122,121,10,131
33489,SpokaneStBridge,10/27/2017 09:00:00 AM,48,-122,49,10,59
33490,SpokaneStBridge,10/27/2017 10:00:00 AM,48,-122,26,3,29
33491,SpokaneStBridge,10/27/2017 11:00:00 AM,48,-122,14,10,24
33492,SpokaneStBridge,10/27/2017 12:00:00 PM,48,-122,18,7,25
33493,SpokaneStBridge,10/27/2017 01:00:00 PM,48,-122,19,18,37
33494,SpokaneStBridge,10/27/2017 02:00:00 PM,48,-122,29,25,54
33495,SpokaneStBridge,10/27/2017 03:00:00 PM,48,-122,16,39,55
33496,SpokaneStBridge,10/27/2017 04:00:00 PM,48,-122,30,98,128
33497,SpokaneStBridge,10/27/2017 05:00:00 PM,48,-122,24,107,131
33498,SpokaneStBridge,10/27/2017 06:00:00 PM,48,-122,20,61,81
33499,SpokaneStBridge,10/27/2017 07:00:00 PM,48,-122,7,26,33
33500,SpokaneStBridge,10/27/2017 08:00:00 PM,48,-122,5,10,15
33501,SpokaneStBridge,10/27/2017 09:00:00 PM,48,-122,6,5,11
33502,SpokaneStBridge,10/27/2017 10:00:00 PM,48,-122,5,3,8
33503,SpokaneStBridge,10/27/2017 11:00:00 PM,48,-122,2,6,8
33504,SpokaneStBridge,10/28/2017 12:00:00 AM,48,-122,1,2,3
33505,SpokaneStBridge,10/28/2017 01:00:00 AM,48,-122,1,6,7
33506,SpokaneStBridge,10/28/2017 02:00:00 AM,48,-122,1,1,2
33507,SpokaneStBridge,10/28/2017 03:00:00 AM,48,-122,1,2,3
33508,SpokaneStBridge,10/28/2017 04:00:00 AM,48,-122,2,2,4
33509,SpokaneStBridge,10/28/2017 05:00:00 AM,48,-122,5,0,5
33510,SpokaneStBridge,10/28/2017 06:00:00 AM,48,-122,7,2,9
33511,SpokaneStBridge,10/28/2017 07:00:00 AM,48,-122,8,4,12
33512,SpokaneStBridge,10/28/2017 08:00:00 AM,48,-122,16,4,20
33513,SpokaneStBridge,10/28/2017 09:00:00 AM,48,-122,14,17,31
33514,SpokaneStBridge,10/28/2017 10:00:00 AM,48,-122,24,15,39
33515,SpokaneStBridge,10/28/2017 11:00:00 AM,48,-122,25,16,41
33516,SpokaneStBridge,10/28/2017 12:00:00 PM,48,-122,21,16,37
33517,SpokaneStBridge,10/28/2017 01:00:00 PM,48,-122,32,30,62
33518,SpokaneStBridge,10/28/2017 02:00:00 PM,48,-122,31,33,64
33519,SpokaneStBridge,10/28/2017 03:00:00 PM,48,-122,21,36,57
33520,SpokaneStBridge,10/28/2017 04:00:00 PM,48,-122,16,25,41
33521,SpokaneStBridge,10/28/2017 05:00:00 PM,48,-122,15,21,36
33522,SpokaneStBridge,10/28/2017 06:00:00 PM,48,-122,4,13,17
33523,SpokaneStBridge,10/28/2017 07:00:00 PM,48,-122,0,4,4
33524,SpokaneStBridge,10/28/2017 08:00:00 PM,48,-122,6,9,15
33525,SpokaneStBridge,10/28/2017 09:00:00 PM,48,-122,1,5,6
33526,SpokaneStBridge,10/28/2017 10:00:00 PM,48,-122,0,2,2
33527,SpokaneStBridge,10/28/2017 11:00:00 PM,48,-122,0,2,2
33528,SpokaneStBridge,10/29/2017 12:00:00 AM,48,-122,0,2,2
33529,SpokaneStBridge,10/29/2017 01:00:00 AM,48,-122,0,1,1
33530,SpokaneStBridge,10/29/2017 02:00:00 AM,48,-122,0,2,2
33531,SpokaneStBridge,10/29/2017 03:00:00 AM,48,-122,2,1,3
33532,SpokaneStBridge,10/29/2017 04:00:00 AM,48,-122,2,2,4
33533,SpokaneStBridge,10/29/2017 05:00:00 AM,48,-122,5,0,5
33534,SpokaneStBridge,10/29/2017 06:00:00 AM,48,-122,2,2,4
33535,SpokaneStBridge,10/29/2017 07:00:00 AM,48,-122,4,1,5
33536,SpokaneStBridge,10/29/2017 08:00:00 AM,48,-122,16,10,26
33537,SpokaneStBridge,10/29/2017 09:00:00 AM,48,-122,10,15,25
33538,SpokaneStBridge,10/29/2017 10:00:00 AM,48,-122,24,8,32
33539,SpokaneStBridge,10/29/2017 11:00:00 AM,48,-122,16,9,25
33540,SpokaneStBridge,10/29/2017 12:00:00 PM,48,-122,22,22,44
33541,SpokaneStBridge,10/29/2017 01:00:00 PM,48,-122,16,14,30
33542,SpokaneStBridge,10/29/2017 02:00:00 PM,48,-122,16,17,33
33543,SpokaneStBridge,10/29/2017 03:00:00 PM,48,-122,15,20,35
33544,SpokaneStBridge,10/29/2017 04:00:00 PM,48,-122,10,15,25
33545,SpokaneStBridge,10/29/2017 05:00:00 PM,48,-122,15,20,35
33546,SpokaneStBridge,10/29/2017 06:00:00 PM,48,-122,7,8,15
33547,SpokaneStBridge,10/29/2017 07:00:00 PM,48,-122,2,5,7
33548,SpokaneStBridge,10/29/2017 08:00:00 PM,48,-122,3,4,7
33549,SpokaneStBridge,10/29/2017 09:00:00 PM,48,-122,0,1,1
33550,SpokaneStBridge,10/29/2017 10:00:00 PM,48,-122,0,0,0
33551,SpokaneStBridge,10/29/2017 11:00:00 PM,48,-122,0,1,1
33552,SpokaneStBridge,10/30/2017 12:00:00 AM,48,-122,0,3,3
33553,SpokaneStBridge,10/30/2017 01:00:00 AM,48,-122,0,1,1
33554,SpokaneStBridge,10/30/2017 02:00:00 AM,48,-122,0,0,0
33555,SpokaneStBridge,10/30/2017 03:00:00 AM,48,-122,1,1,2
33556,SpokaneStBridge,10/30/2017 04:00:00 AM,48,-122,4,0,4
33557,SpokaneStBridge,10/30/2017 05:00:00 AM,48,-122,29,3,32
33558,SpokaneStBridge,10/30/2017 06:00:00 AM,48,-122,53,16,69
33559,SpokaneStBridge,10/30/2017 07:00:00 AM,48,-122,121,8,129
33560,SpokaneStBridge,10/30/2017 08:00:00 AM,48,-122,131,15,146
33561,SpokaneStBridge,10/30/2017 09:00:00 AM,48,-122,46,6,52
33562,SpokaneStBridge,10/30/2017 10:00:00 AM,48,-122,23,3,26
33563,SpokaneStBridge,10/30/2017 11:00:00 AM,48,-122,10,14,24
33564,SpokaneStBridge,10/30/2017 12:00:00 PM,48,-122,9,9,18
33565,SpokaneStBridge,10/30/2017 01:00:00 PM,48,-122,18,11,29
33566,SpokaneStBridge,10/30/2017 02:00:00 PM,48,-122,9,10,19
33567,SpokaneStBridge,10/30/2017 03:00:00 PM,48,-122,10,41,51
33568,SpokaneStBridge,10/30/2017 04:00:00 PM,48,-122,15,86,101
33569,SpokaneStBridge,10/30/2017 05:00:00 PM,48,-122,26,159,185
33570,SpokaneStBridge,10/30/2017 06:00:00 PM,48,-122,12,81,93
33571,SpokaneStBridge,10/30/2017 07:00:00 PM,48,-122,3,25,28
33572,SpokaneStBridge,10/30/2017 08:00:00 PM,48,-122,2,13,15
33573,SpokaneStBridge,10/30/2017 09:00:00 PM,48,-122,3,8,11
33574,SpokaneStBridge,10/30/2017 10:00:00 PM,48,-122,2,4,6
33575,SpokaneStBridge,10/30/2017 11:00:00 PM,48,-122,1,3,4
33576,SpokaneStBridge,10/31/2017 12:00:00 AM,48,-122,1,2,3
33577,SpokaneStBridge,10/31/2017 01:00:00 AM,48,-122,1,1,2
33578,SpokaneStBridge,10/31/2017 02:00:00 AM,48,-122,1,2,3
33579,SpokaneStBridge,10/31/2017 03:00:00 AM,48,-122,1,0,1
33580,SpokaneStBridge,10/31/2017 04:00:00 AM,48,-122,1,2,3
33581,SpokaneStBridge,10/31/2017 05:00:00 AM,48,-122,22,3,25
33582,SpokaneStBridge,10/31/2017 06:00:00 AM,48,-122,57,10,67
33583,SpokaneStBridge,10/31/2017 07:00:00 AM,48,-122,127,7,134
33584,SpokaneStBridge,10/31/2017 08:00:00 AM,48,-122,123,12,135
33585,SpokaneStBridge,10/31/2017 09:00:00 AM,48,-122,40,5,45
33586,SpokaneStBridge,10/31/2017 10:00:00 AM,48,-122,12,7,19
33587,SpokaneStBridge,10/31/2017 11:00:00 AM,48,-122,15,27,42
33588,SpokaneStBridge,10/31/2017 12:00:00 PM,48,-122,40,16,56
33589,SpokaneStBridge,10/31/2017 01:00:00 PM,48,-122,15,13,28
33590,SpokaneStBridge,10/31/2017 02:00:00 PM,48,-122,11,15,26
33591,SpokaneStBridge,10/31/2017 03:00:00 PM,48,-122,9,33,42
33592,SpokaneStBridge,10/31/2017 04:00:00 PM,48,-122,26,117,143
33593,SpokaneStBridge,10/31/2017 05:00:00 PM,48,-122,25,165,190
33594,SpokaneStBridge,10/31/2017 06:00:00 PM,48,-122,4,54,58
33595,SpokaneStBridge,10/31/2017 07:00:00 PM,48,-122,4,10,14
33596,SpokaneStBridge,10/31/2017 08:00:00 PM,48,-122,3,10,13
33597,SpokaneStBridge,10/31/2017 09:00:00 PM,48,-122,6,2,8
33598,SpokaneStBridge,10/31/2017 10:00:00 PM,48,-122,2,3,5
33599,SpokaneStBridge,10/31/2017 11:00:00 PM,48,-122,1,0,1
33600,SpokaneStBridge,11/01/2017 12:00:00 AM,48,-122,0,2,2
33601,SpokaneStBridge,11/01/2017 01:00:00 AM,48,-122,1,2,3
33602,SpokaneStBridge,11/01/2017 02:00:00 AM,48,-122,2,2,4
33603,SpokaneStBridge,11/01/2017 03:00:00 AM,48,-122,0,2,2
33604,SpokaneStBridge,11/01/2017 04:00:00 AM,48,-122,3,3,6
33605,SpokaneStBridge,11/01/2017 05:00:00 AM,48,-122,15,2,17
33606,SpokaneStBridge,11/01/2017 06:00:00 AM,48,-122,54,8,62
33607,SpokaneStBridge,11/01/2017 07:00:00 AM,48,-122,102,15,117
33608,SpokaneStBridge,11/01/2017 08:00:00 AM,48,-122,107,12,119
33609,SpokaneStBridge,11/01/2017 09:00:00 AM,48,-122,58,11,69
33610,SpokaneStBridge,11/01/2017 10:00:00 AM,48,-122,8,4,12
33611,SpokaneStBridge,11/01/2017 11:00:00 AM,48,-122,9,9,18
33612,SpokaneStBridge,11/01/2017 12:00:00 PM,48,-122,11,4,15
33613,SpokaneStBridge,11/01/2017 01:00:00 PM,48,-122,10,10,20
33614,SpokaneStBridge,11/01/2017 02:00:00 PM,48,-122,11,11,22
33615,SpokaneStBridge,11/01/2017 03:00:00 PM,48,-122,11,40,51
33616,SpokaneStBridge,11/01/2017 04:00:00 PM,48,-122,11,68,79
33617,SpokaneStBridge,11/01/2017 05:00:00 PM,48,-122,18,123,141
33618,SpokaneStBridge,11/01/2017 06:00:00 PM,48,-122,16,59,75
33619,SpokaneStBridge,11/01/2017 07:00:00 PM,48,-122,5,28,33
33620,SpokaneStBridge,11/01/2017 08:00:00 PM,48,-122,9,21,30
33621,SpokaneStBridge,11/01/2017 09:00:00 PM,48,-122,3,5,8
33622,SpokaneStBridge,11/01/2017 10:00:00 PM,48,-122,0,10,10
33623,SpokaneStBridge,11/01/2017 11:00:00 PM,48,-122,0,2,2
33624,SpokaneStBridge,11/02/2017 12:00:00 AM,48,-122,1,0,1
33625,SpokaneStBridge,11/02/2017 01:00:00 AM,48,-122,3,1,4
33626,SpokaneStBridge,11/02/2017 02:00:00 AM,48,-122,1,2,3
33627,SpokaneStBridge,11/02/2017 03:00:00 AM,48,-122,4,1,5
33628,SpokaneStBridge,11/02/2017 04:00:00 AM,48,-122,2,1,3
33629,SpokaneStBridge,11/02/2017 05:00:00 AM,48,-122,16,2,18
33630,SpokaneStBridge,11/02/2017 06:00:00 AM,48,-122,41,8,49
33631,SpokaneStBridge,11/02/2017 07:00:00 AM,48,-122,77,9,86
33632,SpokaneStBridge,11/02/2017 08:00:00 AM,48,-122,91,15,106
33633,SpokaneStBridge,11/02/2017 09:00:00 AM,48,-122,38,3,41
33634,SpokaneStBridge,11/02/2017 10:00:00 AM,48,-122,12,5,17
33635,SpokaneStBridge,11/02/2017 11:00:00 AM,48,-122,1,1,2
33636,SpokaneStBridge,11/02/2017 12:00:00 PM,48,-122,3,5,8
33637,SpokaneStBridge,11/02/2017 01:00:00 PM,48,-122,6,3,9
33638,SpokaneStBridge,11/02/2017 02:00:00 PM,48,-122,8,6,14
33639,SpokaneStBridge,11/02/2017 03:00:00 PM,48,-122,10,17,27
33640,SpokaneStBridge,11/02/2017 04:00:00 PM,48,-122,15,45,60
33641,SpokaneStBridge,11/02/2017 05:00:00 PM,48,-122,18,100,118
33642,SpokaneStBridge,11/02/2017 06:00:00 PM,48,-122,8,42,50
33643,SpokaneStBridge,11/02/2017 07:00:00 PM,48,-122,7,15,22
33644,SpokaneStBridge,11/02/2017 08:00:00 PM,48,-122,0,11,11
33645,SpokaneStBridge,11/02/2017 09:00:00 PM,48,-122,1,4,5
33646,SpokaneStBridge,11/02/2017 10:00:00 PM,48,-122,0,8,8
33647,SpokaneStBridge,11/02/2017 11:00:00 PM,48,-122,0,0,0
33648,SpokaneStBridge,11/03/2017 12:00:00 AM,48,-122,0,1,1
33649,SpokaneStBridge,11/03/2017 01:00:00 AM,48,-122,1,0,1
33650,SpokaneStBridge,11/03/2017 02:00:00 AM,48,-122,1,1,2
33651,SpokaneStBridge,11/03/2017 03:00:00 AM,48,-122,0,3,3
33652,SpokaneStBridge,11/03/2017 04:00:00 AM,48,-122,2,1,3
33653,SpokaneStBridge,11/03/2017 05:00:00 AM,48,-122,10,1,11
33654,SpokaneStBridge,11/03/2017 06:00:00 AM,48,-122,16,3,19
33655,SpokaneStBridge,11/03/2017 07:00:00 AM,48,-122,53,4,57
33656,SpokaneStBridge,11/03/2017 08:00:00 AM,48,-122,76,8,84
33657,SpokaneStBridge,11/03/2017 09:00:00 AM,48,-122,20,1,21
33658,SpokaneStBridge,11/03/2017 10:00:00 AM,48,-122,5,4,9
33659,SpokaneStBridge,11/03/2017 11:00:00 AM,48,-122,5,2,7
33660,SpokaneStBridge,11/03/2017 12:00:00 PM,48,-122,6,2,8
33661,SpokaneStBridge,11/03/2017 01:00:00 PM,48,-122,5,4,9
33662,SpokaneStBridge,11/03/2017 02:00:00 PM,48,-122,7,6,13
33663,SpokaneStBridge,11/03/2017 03:00:00 PM,48,-122,5,14,19
33664,SpokaneStBridge,11/03/2017 04:00:00 PM,48,-122,4,41,45
33665,SpokaneStBridge,11/03/2017 05:00:00 PM,48,-122,6,63,69
33666,SpokaneStBridge,11/03/2017 06:00:00 PM,48,-122,3,35,38
33667,SpokaneStBridge,11/03/2017 07:00:00 PM,48,-122,1,6,7
33668,SpokaneStBridge,11/03/2017 08:00:00 PM,48,-122,1,8,9
33669,SpokaneStBridge,11/03/2017 09:00:00 PM,48,-122,1,1,2
33670,SpokaneStBridge,11/03/2017 10:00:00 PM,48,-122,0,2,2
33671,SpokaneStBridge,11/03/2017 11:00:00 PM,48,-122,1,2,3
33672,SpokaneStBridge,11/04/2017 12:00:00 AM,48,-122,0,1,1
33673,SpokaneStBridge,11/04/2017 01:00:00 AM,48,-122,2,1,3
33674,SpokaneStBridge,11/04/2017 02:00:00 AM,48,-122,1,2,3
33675,SpokaneStBridge,11/04/2017 03:00:00 AM,48,-122,1,1,2
33676,SpokaneStBridge,11/04/2017 04:00:00 AM,48,-122,0,2,2
33677,SpokaneStBridge,11/04/2017 05:00:00 AM,48,-122,4,0,4
33678,SpokaneStBridge,11/04/2017 06:00:00 AM,48,-122,4,5,9
33679,SpokaneStBridge,11/04/2017 07:00:00 AM,48,-122,0,0,0
33680,SpokaneStBridge,11/04/2017 08:00:00 AM,48,-122,9,5,14
33681,SpokaneStBridge,11/04/2017 09:00:00 AM,48,-122,9,8,17
33682,SpokaneStBridge,11/04/2017 10:00:00 AM,48,-122,5,12,17
33683,SpokaneStBridge,11/04/2017 11:00:00 AM,48,-122,9,7,16
33684,SpokaneStBridge,11/04/2017 12:00:00 PM,48,-122,15,6,21
33685,SpokaneStBridge,11/04/2017 01:00:00 PM,48,-122,9,1,10
33686,SpokaneStBridge,11/04/2017 02:00:00 PM,48,-122,4,5,9
33687,SpokaneStBridge,11/04/2017 03:00:00 PM,48,-122,4,4,8
33688,SpokaneStBridge,11/04/2017 04:00:00 PM,48,-122,1,8,9
33689,SpokaneStBridge,11/04/2017 05:00:00 PM,48,-122,2,2,4
33690,SpokaneStBridge,11/04/2017 06:00:00 PM,48,-122,2,3,5
33691,SpokaneStBridge,11/04/2017 07:00:00 PM,48,-122,0,2,2
33692,SpokaneStBridge,11/04/2017 08:00:00 PM,48,-122,1,1,2
33693,SpokaneStBridge,11/04/2017 09:00:00 PM,48,-122,0,0,0
33694,SpokaneStBridge,11/04/2017 10:00:00 PM,48,-122,0,0,0
33695,SpokaneStBridge,11/04/2017 11:00:00 PM,48,-122,0,0,0
33696,SpokaneStBridge,11/05/2017 12:00:00 AM,48,-122,2,5,7
33697,SpokaneStBridge,11/05/2017 01:00:00 AM,48,-122,0,5,5
33698,SpokaneStBridge,11/05/2017 02:00:00 AM,48,-122,2,1,3
33699,SpokaneStBridge,11/05/2017 03:00:00 AM,48,-122,1,1,2
33700,SpokaneStBridge,11/05/2017 04:00:00 AM,48,-122,0,0,0
33701,SpokaneStBridge,11/05/2017 05:00:00 AM,48,-122,2,1,3
33702,SpokaneStBridge,11/05/2017 06:00:00 AM,48,-122,3,0,3
33703,SpokaneStBridge,11/05/2017 07:00:00 AM,48,-122,1,1,2
33704,SpokaneStBridge,11/05/2017 08:00:00 AM,48,-122,2,1,3
33705,SpokaneStBridge,11/05/2017 09:00:00 AM,48,-122,3,2,5
33706,SpokaneStBridge,11/05/2017 10:00:00 AM,48,-122,3,3,6
33707,SpokaneStBridge,11/05/2017 11:00:00 AM,48,-122,2,2,4
33708,SpokaneStBridge,11/05/2017 12:00:00 PM,48,-122,6,2,8
33709,SpokaneStBridge,11/05/2017 01:00:00 PM,48,-122,1,3,4
33710,SpokaneStBridge,11/05/2017 02:00:00 PM,48,-122,3,0,3
33711,SpokaneStBridge,11/05/2017 03:00:00 PM,48,-122,2,0,2
33712,SpokaneStBridge,11/05/2017 04:00:00 PM,48,-122,2,4,6
33713,SpokaneStBridge,11/05/2017 05:00:00 PM,48,-122,2,7,9
33714,SpokaneStBridge,11/05/2017 06:00:00 PM,48,-122,1,1,2
33715,SpokaneStBridge,11/05/2017 07:00:00 PM,48,-122,1,4,5
33716,SpokaneStBridge,11/05/2017 08:00:00 PM,48,-122,0,1,1
33717,SpokaneStBridge,11/05/2017 09:00:00 PM,48,-122,1,0,1
33718,SpokaneStBridge,11/05/2017 10:00:00 PM,48,-122,0,1,1
33719,SpokaneStBridge,11/05/2017 11:00:00 PM,48,-122,2,0,2
33720,SpokaneStBridge,11/06/2017 12:00:00 AM,48,-122,0,0,0
33721,SpokaneStBridge,11/06/2017 01:00:00 AM,48,-122,1,1,2
33722,SpokaneStBridge,11/06/2017 02:00:00 AM,48,-122,0,2,2
33723,SpokaneStBridge,11/06/2017 03:00:00 AM,48,-122,0,1,1
33724,SpokaneStBridge,11/06/2017 04:00:00 AM,48,-122,0,0,0
33725,SpokaneStBridge,11/06/2017 05:00:00 AM,48,-122,14,2,16
33726,SpokaneStBridge,11/06/2017 06:00:00 AM,48,-122,39,6,45
33727,SpokaneStBridge,11/06/2017 07:00:00 AM,48,-122,117,7,124
33728,SpokaneStBridge,11/06/2017 08:00:00 AM,48,-122,92,8,100
33729,SpokaneStBridge,11/06/2017 09:00:00 AM,48,-122,36,7,43
33730,SpokaneStBridge,11/06/2017 10:00:00 AM,48,-122,13,2,15
33731,SpokaneStBridge,11/06/2017 11:00:00 AM,48,-122,13,11,24
33732,SpokaneStBridge,11/06/2017 12:00:00 PM,48,-122,16,6,22
33733,SpokaneStBridge,11/06/2017 01:00:00 PM,48,-122,11,12,23
33734,SpokaneStBridge,11/06/2017 02:00:00 PM,48,-122,9,13,22
33735,SpokaneStBridge,11/06/2017 03:00:00 PM,48,-122,11,23,34
33736,SpokaneStBridge,11/06/2017 04:00:00 PM,48,-122,16,72,88
33737,SpokaneStBridge,11/06/2017 05:00:00 PM,48,-122,17,129,146
33738,SpokaneStBridge,11/06/2017 06:00:00 PM,48,-122,6,54,60
33739,SpokaneStBridge,11/06/2017 07:00:00 PM,48,-122,3,15,18
33740,SpokaneStBridge,11/06/2017 08:00:00 PM,48,-122,2,5,7
33741,SpokaneStBridge,11/06/2017 09:00:00 PM,48,-122,3,3,6
33742,SpokaneStBridge,11/06/2017 10:00:00 PM,48,-122,0,5,5
33743,SpokaneStBridge,11/06/2017 11:00:00 PM,48,-122,0,0,0
33744,SpokaneStBridge,11/07/2017 12:00:00 AM,48,-122,1,0,1
33745,SpokaneStBridge,11/07/2017 01:00:00 AM,48,-122,1,0,1
33746,SpokaneStBridge,11/07/2017 02:00:00 AM,48,-122,1,2,3
33747,SpokaneStBridge,11/07/2017 03:00:00 AM,48,-122,0,2,2
33748,SpokaneStBridge,11/07/2017 04:00:00 AM,48,-122,2,2,4
33749,SpokaneStBridge,11/07/2017 05:00:00 AM,48,-122,24,4,28
33750,SpokaneStBridge,11/07/2017 06:00:00 AM,48,-122,49,12,61
33751,SpokaneStBridge,11/07/2017 07:00:00 AM,48,-122,120,12,132
33752,SpokaneStBridge,11/07/2017 08:00:00 AM,48,-122,105,9,114
33753,SpokaneStBridge,11/07/2017 09:00:00 AM,48,-122,35,2,37
33754,SpokaneStBridge,11/07/2017 10:00:00 AM,48,-122,16,1,17
33755,SpokaneStBridge,11/07/2017 11:00:00 AM,48,-122,6,6,12
33756,SpokaneStBridge,11/07/2017 12:00:00 PM,48,-122,8,5,13
33757,SpokaneStBridge,11/07/2017 01:00:00 PM,48,-122,8,11,19
33758,SpokaneStBridge,11/07/2017 02:00:00 PM,48,-122,15,11,26
33759,SpokaneStBridge,11/07/2017 03:00:00 PM,48,-122,8,25,33
33760,SpokaneStBridge,11/07/2017 04:00:00 PM,48,-122,28,81,109
33761,SpokaneStBridge,11/07/2017 05:00:00 PM,48,-122,10,122,132
33762,SpokaneStBridge,11/07/2017 06:00:00 PM,48,-122,14,62,76
33763,SpokaneStBridge,11/07/2017 07:00:00 PM,48,-122,2,24,26
33764,SpokaneStBridge,11/07/2017 08:00:00 PM,48,-122,5,4,9
33765,SpokaneStBridge,11/07/2017 09:00:00 PM,48,-122,2,9,11
33766,SpokaneStBridge,11/07/2017 10:00:00 PM,48,-122,0,2,2
33767,SpokaneStBridge,11/07/2017 11:00:00 PM,48,-122,1,1,2
33768,SpokaneStBridge,11/08/2017 12:00:00 AM,48,-122,2,1,3
33769,SpokaneStBridge,11/08/2017 01:00:00 AM,48,-122,0,0,0
33770,SpokaneStBridge,11/08/2017 02:00:00 AM,48,-122,1,0,1
33771,SpokaneStBridge,11/08/2017 03:00:00 AM,48,-122,0,1,1
33772,SpokaneStBridge,11/08/2017 04:00:00 AM,48,-122,1,2,3
33773,SpokaneStBridge,11/08/2017 05:00:00 AM,48,-122,16,2,18
33774,SpokaneStBridge,11/08/2017 06:00:00 AM,48,-122,33,8,41
33775,SpokaneStBridge,11/08/2017 07:00:00 AM,48,-122,85,6,91
33776,SpokaneStBridge,11/08/2017 08:00:00 AM,48,-122,139,10,149
33777,SpokaneStBridge,11/08/2017 09:00:00 AM,48,-122,41,4,45
33778,SpokaneStBridge,11/08/2017 10:00:00 AM,48,-122,11,0,11
33779,SpokaneStBridge,11/08/2017 11:00:00 AM,48,-122,7,8,15
33780,SpokaneStBridge,11/08/2017 12:00:00 PM,48,-122,6,6,12
33781,SpokaneStBridge,11/08/2017 01:00:00 PM,48,-122,11,6,17
33782,SpokaneStBridge,11/08/2017 02:00:00 PM,48,-122,8,11,19
33783,SpokaneStBridge,11/08/2017 03:00:00 PM,48,-122,3,29,32
33784,SpokaneStBridge,11/08/2017 04:00:00 PM,48,-122,12,68,80
33785,SpokaneStBridge,11/08/2017 05:00:00 PM,48,-122,17,109,126
33786,SpokaneStBridge,11/08/2017 06:00:00 PM,48,-122,4,38,42
33787,SpokaneStBridge,11/08/2017 07:00:00 PM,48,-122,2,21,23
33788,SpokaneStBridge,11/08/2017 08:00:00 PM,48,-122,0,6,6
33789,SpokaneStBridge,11/08/2017 09:00:00 PM,48,-122,2,6,8
33790,SpokaneStBridge,11/08/2017 10:00:00 PM,48,-122,0,5,5
33791,SpokaneStBridge,11/08/2017 11:00:00 PM,48,-122,0,1,1
33792,SpokaneStBridge,11/09/2017 12:00:00 AM,48,-122,1,3,4
33793,SpokaneStBridge,11/09/2017 01:00:00 AM,48,-122,1,0,1
33794,SpokaneStBridge,11/09/2017 02:00:00 AM,48,-122,1,3,4
33795,SpokaneStBridge,11/09/2017 03:00:00 AM,48,-122,1,0,1
33796,SpokaneStBridge,11/09/2017 04:00:00 AM,48,-122,3,3,6
33797,SpokaneStBridge,11/09/2017 05:00:00 AM,48,-122,10,2,12
33798,SpokaneStBridge,11/09/2017 06:00:00 AM,48,-122,35,10,45
33799,SpokaneStBridge,11/09/2017 07:00:00 AM,48,-122,68,7,75
33800,SpokaneStBridge,11/09/2017 08:00:00 AM,48,-122,75,6,81
33801,SpokaneStBridge,11/09/2017 09:00:00 AM,48,-122,37,6,43
33802,SpokaneStBridge,11/09/2017 10:00:00 AM,48,-122,13,3,16
33803,SpokaneStBridge,11/09/2017 11:00:00 AM,48,-122,5,3,8
33804,SpokaneStBridge,11/09/2017 12:00:00 PM,48,-122,4,2,6
33805,SpokaneStBridge,11/09/2017 01:00:00 PM,48,-122,4,5,9
33806,SpokaneStBridge,11/09/2017 02:00:00 PM,48,-122,4,3,7
33807,SpokaneStBridge,11/09/2017 03:00:00 PM,48,-122,4,22,26
33808,SpokaneStBridge,11/09/2017 04:00:00 PM,48,-122,8,41,49
33809,SpokaneStBridge,11/09/2017 05:00:00 PM,48,-122,9,83,92
33810,SpokaneStBridge,11/09/2017 06:00:00 PM,48,-122,8,40,48
33811,SpokaneStBridge,11/09/2017 07:00:00 PM,48,-122,1,16,17
33812,SpokaneStBridge,11/09/2017 08:00:00 PM,48,-122,1,5,6
33813,SpokaneStBridge,11/09/2017 09:00:00 PM,48,-122,2,5,7
33814,SpokaneStBridge,11/09/2017 10:00:00 PM,48,-122,1,1,2
33815,SpokaneStBridge,11/09/2017 11:00:00 PM,48,-122,0,2,2
33816,SpokaneStBridge,11/10/2017 12:00:00 AM,48,-122,1,0,1
33817,SpokaneStBridge,11/10/2017 01:00:00 AM,48,-122,1,1,2
33818,SpokaneStBridge,11/10/2017 02:00:00 AM,48,-122,2,2,4
33819,SpokaneStBridge,11/10/2017 03:00:00 AM,48,-122,0,1,1
33820,SpokaneStBridge,11/10/2017 04:00:00 AM,48,-122,0,1,1
33821,SpokaneStBridge,11/10/2017 05:00:00 AM,48,-122,12,1,13
33822,SpokaneStBridge,11/10/2017 06:00:00 AM,48,-122,20,4,24
33823,SpokaneStBridge,11/10/2017 07:00:00 AM,48,-122,67,10,77
33824,SpokaneStBridge,11/10/2017 08:00:00 AM,48,-122,69,6,75
33825,SpokaneStBridge,11/10/2017 09:00:00 AM,48,-122,37,8,45
33826,SpokaneStBridge,11/10/2017 10:00:00 AM,48,-122,16,3,19
33827,SpokaneStBridge,11/10/2017 11:00:00 AM,48,-122,10,12,22
33828,SpokaneStBridge,11/10/2017 12:00:00 PM,48,-122,21,7,28
33829,SpokaneStBridge,11/10/2017 01:00:00 PM,48,-122,20,14,34
33830,SpokaneStBridge,11/10/2017 02:00:00 PM,48,-122,22,14,36
33831,SpokaneStBridge,11/10/2017 03:00:00 PM,48,-122,12,31,43
33832,SpokaneStBridge,11/10/2017 04:00:00 PM,48,-122,12,61,73
33833,SpokaneStBridge,11/10/2017 05:00:00 PM,48,-122,9,73,82
33834,SpokaneStBridge,11/10/2017 06:00:00 PM,48,-122,12,37,49
33835,SpokaneStBridge,11/10/2017 07:00:00 PM,48,-122,0,10,10
33836,SpokaneStBridge,11/10/2017 08:00:00 PM,48,-122,2,6,8
33837,SpokaneStBridge,11/10/2017 09:00:00 PM,48,-122,1,6,7
33838,SpokaneStBridge,11/10/2017 10:00:00 PM,48,-122,3,1,4
33839,SpokaneStBridge,11/10/2017 11:00:00 PM,48,-122,1,3,4
33840,SpokaneStBridge,11/11/2017 12:00:00 AM,48,-122,2,0,2
33841,SpokaneStBridge,11/11/2017 01:00:00 AM,48,-122,0,1,1
33842,SpokaneStBridge,11/11/2017 02:00:00 AM,48,-122,0,2,2
33843,SpokaneStBridge,11/11/2017 03:00:00 AM,48,-122,0,0,0
33844,SpokaneStBridge,11/11/2017 04:00:00 AM,48,-122,1,2,3
33845,SpokaneStBridge,11/11/2017 05:00:00 AM,48,-122,4,0,4
33846,SpokaneStBridge,11/11/2017 06:00:00 AM,48,-122,3,1,4
33847,SpokaneStBridge,11/11/2017 07:00:00 AM,48,-122,4,3,7
33848,SpokaneStBridge,11/11/2017 08:00:00 AM,48,-122,12,4,16
33849,SpokaneStBridge,11/11/2017 09:00:00 AM,48,-122,8,3,11
33850,SpokaneStBridge,11/11/2017 10:00:00 AM,48,-122,17,16,33
33851,SpokaneStBridge,11/11/2017 11:00:00 AM,48,-122,13,6,19
33852,SpokaneStBridge,11/11/2017 12:00:00 PM,48,-122,6,7,13
33853,SpokaneStBridge,11/11/2017 01:00:00 PM,48,-122,6,4,10
33854,SpokaneStBridge,11/11/2017 02:00:00 PM,48,-122,2,10,12
33855,SpokaneStBridge,11/11/2017 03:00:00 PM,48,-122,4,8,12
33856,SpokaneStBridge,11/11/2017 04:00:00 PM,48,-122,6,10,16
33857,SpokaneStBridge,11/11/2017 05:00:00 PM,48,-122,6,10,16
33858,SpokaneStBridge,11/11/2017 06:00:00 PM,48,-122,1,2,3
33859,SpokaneStBridge,11/11/2017 07:00:00 PM,48,-122,2,1,3
33860,SpokaneStBridge,11/11/2017 08:00:00 PM,48,-122,0,0,0
33861,SpokaneStBridge,11/11/2017 09:00:00 PM,48,-122,0,3,3
33862,SpokaneStBridge,11/11/2017 10:00:00 PM,48,-122,0,2,2
33863,SpokaneStBridge,11/11/2017 11:00:00 PM,48,-122,0,3,3
33864,SpokaneStBridge,11/12/2017 12:00:00 AM,48,-122,1,1,2
33865,SpokaneStBridge,11/12/2017 01:00:00 AM,48,-122,2,4,6
33866,SpokaneStBridge,11/12/2017 02:00:00 AM,48,-122,0,1,1
33867,SpokaneStBridge,11/12/2017 03:00:00 AM,48,-122,0,0,0
33868,SpokaneStBridge,11/12/2017 04:00:00 AM,48,-122,0,1,1
33869,SpokaneStBridge,11/12/2017 05:00:00 AM,48,-122,3,0,3
33870,SpokaneStBridge,11/12/2017 06:00:00 AM,48,-122,0,2,2
33871,SpokaneStBridge,11/12/2017 07:00:00 AM,48,-122,0,0,0
33872,SpokaneStBridge,11/12/2017 08:00:00 AM,48,-122,4,4,8
33873,SpokaneStBridge,11/12/2017 09:00:00 AM,48,-122,7,4,11
33874,SpokaneStBridge,11/12/2017 10:00:00 AM,48,-122,12,3,15
33875,SpokaneStBridge,11/12/2017 11:00:00 AM,48,-122,14,11,25
33876,SpokaneStBridge,11/12/2017 12:00:00 PM,48,-122,15,13,28
33877,SpokaneStBridge,11/12/2017 01:00:00 PM,48,-122,10,10,20
33878,SpokaneStBridge,11/12/2017 02:00:00 PM,48,-122,1,7,8
33879,SpokaneStBridge,11/12/2017 03:00:00 PM,48,-122,6,9,15
33880,SpokaneStBridge,11/12/2017 04:00:00 PM,48,-122,5,6,11
33881,SpokaneStBridge,11/12/2017 05:00:00 PM,48,-122,4,4,8
33882,SpokaneStBridge,11/12/2017 06:00:00 PM,48,-122,4,3,7
33883,SpokaneStBridge,11/12/2017 07:00:00 PM,48,-122,3,4,7
33884,SpokaneStBridge,11/12/2017 08:00:00 PM,48,-122,1,2,3
33885,SpokaneStBridge,11/12/2017 09:00:00 PM,48,-122,1,0,1
33886,SpokaneStBridge,11/12/2017 10:00:00 PM,48,-122,0,1,1
33887,SpokaneStBridge,11/12/2017 11:00:00 PM,48,-122,0,1,1
33888,SpokaneStBridge,11/13/2017 12:00:00 AM,48,-122,0,1,1
33889,SpokaneStBridge,11/13/2017 01:00:00 AM,48,-122,2,1,3
33890,SpokaneStBridge,11/13/2017 02:00:00 AM,48,-122,0,0,0
33891,SpokaneStBridge,11/13/2017 03:00:00 AM,48,-122,0,1,1
33892,SpokaneStBridge,11/13/2017 04:00:00 AM,48,-122,3,1,4
33893,SpokaneStBridge,11/13/2017 05:00:00 AM,48,-122,15,1,16
33894,SpokaneStBridge,11/13/2017 06:00:00 AM,48,-122,23,4,27
33895,SpokaneStBridge,11/13/2017 07:00:00 AM,48,-122,80,3,83
33896,SpokaneStBridge,11/13/2017 08:00:00 AM,48,-122,74,4,78
33897,SpokaneStBridge,11/13/2017 09:00:00 AM,48,-122,26,2,28
33898,SpokaneStBridge,11/13/2017 10:00:00 AM,48,-122,11,2,13
33899,SpokaneStBridge,11/13/2017 11:00:00 AM,48,-122,7,3,10
33900,SpokaneStBridge,11/13/2017 12:00:00 PM,48,-122,6,3,9
33901,SpokaneStBridge,11/13/2017 01:00:00 PM,48,-122,4,4,8
33902,SpokaneStBridge,11/13/2017 02:00:00 PM,48,-122,1,3,4
33903,SpokaneStBridge,11/13/2017 03:00:00 PM,48,-122,5,16,21
33904,SpokaneStBridge,11/13/2017 04:00:00 PM,48,-122,4,34,38
33905,SpokaneStBridge,11/13/2017 05:00:00 PM,48,-122,7,58,65
33906,SpokaneStBridge,11/13/2017 06:00:00 PM,48,-122,1,27,28
33907,SpokaneStBridge,11/13/2017 07:00:00 PM,48,-122,0,7,7
33908,SpokaneStBridge,11/13/2017 08:00:00 PM,48,-122,2,6,8
33909,SpokaneStBridge,11/13/2017 09:00:00 PM,48,-122,2,2,4
33910,SpokaneStBridge,11/13/2017 10:00:00 PM,48,-122,0,3,3
33911,SpokaneStBridge,11/13/2017 11:00:00 PM,48,-122,0,1,1
33912,SpokaneStBridge,11/14/2017 12:00:00 AM,48,-122,0,0,0
33913,SpokaneStBridge,11/14/2017 01:00:00 AM,48,-122,1,0,1
33914,SpokaneStBridge,11/14/2017 02:00:00 AM,48,-122,1,0,1
33915,SpokaneStBridge,11/14/2017 03:00:00 AM,48,-122,0,1,1
33916,SpokaneStBridge,11/14/2017 04:00:00 AM,48,-122,2,2,4
33917,SpokaneStBridge,11/14/2017 05:00:00 AM,48,-122,17,5,22
33918,SpokaneStBridge,11/14/2017 06:00:00 AM,48,-122,28,6,34
33919,SpokaneStBridge,11/14/2017 07:00:00 AM,48,-122,72,9,81
33920,SpokaneStBridge,11/14/2017 08:00:00 AM,48,-122,88,7,95
33921,SpokaneStBridge,11/14/2017 09:00:00 AM,48,-122,28,6,34
33922,SpokaneStBridge,11/14/2017 10:00:00 AM,48,-122,12,2,14
33923,SpokaneStBridge,11/14/2017 11:00:00 AM,48,-122,2,2,4
33924,SpokaneStBridge,11/14/2017 12:00:00 PM,48,-122,3,3,6
33925,SpokaneStBridge,11/14/2017 01:00:00 PM,48,-122,4,7,11
33926,SpokaneStBridge,11/14/2017 02:00:00 PM,48,-122,6,11,17
33927,SpokaneStBridge,11/14/2017 03:00:00 PM,48,-122,7,18,25
33928,SpokaneStBridge,11/14/2017 04:00:00 PM,48,-122,7,42,49
33929,SpokaneStBridge,11/14/2017 05:00:00 PM,48,-122,11,92,103
33930,SpokaneStBridge,11/14/2017 06:00:00 PM,48,-122,5,40,45
33931,SpokaneStBridge,11/14/2017 07:00:00 PM,48,-122,5,24,29
33932,SpokaneStBridge,11/14/2017 08:00:00 PM,48,-122,1,4,5
33933,SpokaneStBridge,11/14/2017 09:00:00 PM,48,-122,3,5,8
33934,SpokaneStBridge,11/14/2017 10:00:00 PM,48,-122,1,1,2
33935,SpokaneStBridge,11/14/2017 11:00:00 PM,48,-122,0,2,2
33936,SpokaneStBridge,11/15/2017 12:00:00 AM,48,-122,1,1,2
33937,SpokaneStBridge,11/15/2017 01:00:00 AM,48,-122,0,0,0
33938,SpokaneStBridge,11/15/2017 02:00:00 AM,48,-122,0,0,0
33939,SpokaneStBridge,11/15/2017 03:00:00 AM,48,-122,0,1,1
33940,SpokaneStBridge,11/15/2017 04:00:00 AM,48,-122,3,1,4
33941,SpokaneStBridge,11/15/2017 05:00:00 AM,48,-122,10,1,11
33942,SpokaneStBridge,11/15/2017 06:00:00 AM,48,-122,23,7,30
33943,SpokaneStBridge,11/15/2017 07:00:00 AM,48,-122,45,6,51
33944,SpokaneStBridge,11/15/2017 08:00:00 AM,48,-122,90,3,93
33945,SpokaneStBridge,11/15/2017 09:00:00 AM,48,-122,23,1,24
33946,SpokaneStBridge,11/15/2017 10:00:00 AM,48,-122,10,2,12
33947,SpokaneStBridge,11/15/2017 11:00:00 AM,48,-122,5,1,6
33948,SpokaneStBridge,11/15/2017 12:00:00 PM,48,-122,3,3,6
33949,SpokaneStBridge,11/15/2017 01:00:00 PM,48,-122,4,4,8
33950,SpokaneStBridge,11/15/2017 02:00:00 PM,48,-122,4,8,12
33951,SpokaneStBridge,11/15/2017 03:00:00 PM,48,-122,4,19,23
33952,SpokaneStBridge,11/15/2017 04:00:00 PM,48,-122,11,30,41
33953,SpokaneStBridge,11/15/2017 05:00:00 PM,48,-122,10,77,87
33954,SpokaneStBridge,11/15/2017 06:00:00 PM,48,-122,6,40,46
33955,SpokaneStBridge,11/15/2017 07:00:00 PM,48,-122,2,19,21
33956,SpokaneStBridge,11/15/2017 08:00:00 PM,48,-122,0,7,7
33957,SpokaneStBridge,11/15/2017 09:00:00 PM,48,-122,2,6,8
33958,SpokaneStBridge,11/15/2017 10:00:00 PM,48,-122,2,2,4
33959,SpokaneStBridge,11/15/2017 11:00:00 PM,48,-122,0,0,0
33960,SpokaneStBridge,11/16/2017 12:00:00 AM,48,-122,0,0,0
33961,SpokaneStBridge,11/16/2017 01:00:00 AM,48,-122,1,3,4
33962,SpokaneStBridge,11/16/2017 02:00:00 AM,48,-122,0,2,2
33963,SpokaneStBridge,11/16/2017 03:00:00 AM,48,-122,0,1,1
33964,SpokaneStBridge,11/16/2017 04:00:00 AM,48,-122,5,2,7
33965,SpokaneStBridge,11/16/2017 05:00:00 AM,48,-122,20,3,23
33966,SpokaneStBridge,11/16/2017 06:00:00 AM,48,-122,27,5,32
33967,SpokaneStBridge,11/16/2017 07:00:00 AM,48,-122,77,9,86
33968,SpokaneStBridge,11/16/2017 08:00:00 AM,48,-122,89,9,98
33969,SpokaneStBridge,11/16/2017 09:00:00 AM,48,-122,26,5,31
33970,SpokaneStBridge,11/16/2017 10:00:00 AM,48,-122,15,11,26
33971,SpokaneStBridge,11/16/2017 11:00:00 AM,48,-122,4,1,5
33972,SpokaneStBridge,11/16/2017 12:00:00 PM,48,-122,1,4,5
33973,SpokaneStBridge,11/16/2017 01:00:00 PM,48,-122,9,4,13
33974,SpokaneStBridge,11/16/2017 02:00:00 PM,48,-122,5,2,7
33975,SpokaneStBridge,11/16/2017 03:00:00 PM,48,-122,13,36,49
33976,SpokaneStBridge,11/16/2017 04:00:00 PM,48,-122,8,46,54
33977,SpokaneStBridge,11/16/2017 05:00:00 PM,48,-122,12,79,91
33978,SpokaneStBridge,11/16/2017 06:00:00 PM,48,-122,12,58,70
33979,SpokaneStBridge,11/16/2017 07:00:00 PM,48,-122,6,19,25
33980,SpokaneStBridge,11/16/2017 08:00:00 PM,48,-122,1,7,8
33981,SpokaneStBridge,11/16/2017 09:00:00 PM,48,-122,2,6,8
33982,SpokaneStBridge,11/16/2017 10:00:00 PM,48,-122,2,2,4
33983,SpokaneStBridge,11/16/2017 11:00:00 PM,48,-122,1,2,3
33984,SpokaneStBridge,11/17/2017 12:00:00 AM,48,-122,0,0,0
33985,SpokaneStBridge,11/17/2017 01:00:00 AM,48,-122,1,0,1
33986,SpokaneStBridge,11/17/2017 02:00:00 AM,48,-122,1,3,4
33987,SpokaneStBridge,11/17/2017 03:00:00 AM,48,-122,1,0,1
33988,SpokaneStBridge,11/17/2017 04:00:00 AM,48,-122,6,1,7
33989,SpokaneStBridge,11/17/2017 05:00:00 AM,48,-122,11,4,15
33990,SpokaneStBridge,11/17/2017 06:00:00 AM,48,-122,40,8,48
33991,SpokaneStBridge,11/17/2017 07:00:00 AM,48,-122,80,14,94
33992,SpokaneStBridge,11/17/2017 08:00:00 AM,48,-122,100,8,108
33993,SpokaneStBridge,11/17/2017 09:00:00 AM,48,-122,39,8,47
33994,SpokaneStBridge,11/17/2017 10:00:00 AM,48,-122,18,4,22
33995,SpokaneStBridge,11/17/2017 11:00:00 AM,48,-122,11,7,18
33996,SpokaneStBridge,11/17/2017 12:00:00 PM,48,-122,11,7,18
33997,SpokaneStBridge,11/17/2017 01:00:00 PM,48,-122,11,13,24
33998,SpokaneStBridge,11/17/2017 02:00:00 PM,48,-122,13,14,27
33999,SpokaneStBridge,11/17/2017 03:00:00 PM,48,-122,16,24,40
34000,SpokaneStBridge,11/17/2017 04:00:00 PM,48,-122,8,57,65
34001,SpokaneStBridge,11/17/2017 05:00:00 PM,48,-122,15,88,103
34002,SpokaneStBridge,11/17/2017 06:00:00 PM,48,-122,11,38,49
34003,SpokaneStBridge,11/17/2017 07:00:00 PM,48,-122,2,22,24
34004,SpokaneStBridge,11/17/2017 08:00:00 PM,48,-122,5,8,13
34005,SpokaneStBridge,11/17/2017 09:00:00 PM,48,-122,2,6,8
34006,SpokaneStBridge,11/17/2017 10:00:00 PM,48,-122,2,4,6
34007,SpokaneStBridge,11/17/2017 11:00:00 PM,48,-122,1,4,5
34008,SpokaneStBridge,11/18/2017 12:00:00 AM,48,-122,1,1,2
34009,SpokaneStBridge,11/18/2017 01:00:00 AM,48,-122,0,0,0
34010,SpokaneStBridge,11/18/2017 02:00:00 AM,48,-122,0,2,2
34011,SpokaneStBridge,11/18/2017 03:00:00 AM,48,-122,0,1,1
34012,SpokaneStBridge,11/18/2017 04:00:00 AM,48,-122,0,2,2
34013,SpokaneStBridge,11/18/2017 05:00:00 AM,48,-122,4,0,4
34014,SpokaneStBridge,11/18/2017 06:00:00 AM,48,-122,6,1,7
34015,SpokaneStBridge,11/18/2017 07:00:00 AM,48,-122,7,0,7
34016,SpokaneStBridge,11/18/2017 08:00:00 AM,48,-122,15,5,20
34017,SpokaneStBridge,11/18/2017 09:00:00 AM,48,-122,15,9,24
34018,SpokaneStBridge,11/18/2017 10:00:00 AM,48,-122,18,10,28
34019,SpokaneStBridge,11/18/2017 11:00:00 AM,48,-122,12,24,36
34020,SpokaneStBridge,11/18/2017 12:00:00 PM,48,-122,30,23,53
34021,SpokaneStBridge,11/18/2017 01:00:00 PM,48,-122,27,17,44
34022,SpokaneStBridge,11/18/2017 02:00:00 PM,48,-122,19,24,43
34023,SpokaneStBridge,11/18/2017 03:00:00 PM,48,-122,21,21,42
34024,SpokaneStBridge,11/18/2017 04:00:00 PM,48,-122,12,15,27
34025,SpokaneStBridge,11/18/2017 05:00:00 PM,48,-122,6,13,19
34026,SpokaneStBridge,11/18/2017 06:00:00 PM,48,-122,2,7,9
34027,SpokaneStBridge,11/18/2017 07:00:00 PM,48,-122,6,2,8
34028,SpokaneStBridge,11/18/2017 08:00:00 PM,48,-122,1,4,5
34029,SpokaneStBridge,11/18/2017 09:00:00 PM,48,-122,0,6,6
34030,SpokaneStBridge,11/18/2017 10:00:00 PM,48,-122,0,1,1
34031,SpokaneStBridge,11/18/2017 11:00:00 PM,48,-122,0,2,2
34032,SpokaneStBridge,11/19/2017 12:00:00 AM,48,-122,0,2,2
34033,SpokaneStBridge,11/19/2017 01:00:00 AM,48,-122,1,2,3
34034,SpokaneStBridge,11/19/2017 02:00:00 AM,48,-122,0,1,1
34035,SpokaneStBridge,11/19/2017 03:00:00 AM,48,-122,0,2,2
34036,SpokaneStBridge,11/19/2017 04:00:00 AM,48,-122,0,1,1
34037,SpokaneStBridge,11/19/2017 05:00:00 AM,48,-122,2,0,2
34038,SpokaneStBridge,11/19/2017 06:00:00 AM,48,-122,2,1,3
34039,SpokaneStBridge,11/19/2017 07:00:00 AM,48,-122,1,0,1
34040,SpokaneStBridge,11/19/2017 08:00:00 AM,48,-122,8,1,9
34041,SpokaneStBridge,11/19/2017 09:00:00 AM,48,-122,7,4,11
34042,SpokaneStBridge,11/19/2017 10:00:00 AM,48,-122,14,12,26
34043,SpokaneStBridge,11/19/2017 11:00:00 AM,48,-122,11,17,28
34044,SpokaneStBridge,11/19/2017 12:00:00 PM,48,-122,12,12,24
34045,SpokaneStBridge,11/19/2017 01:00:00 PM,48,-122,9,6,15
34046,SpokaneStBridge,11/19/2017 02:00:00 PM,48,-122,8,11,19
34047,SpokaneStBridge,11/19/2017 03:00:00 PM,48,-122,2,5,7
34048,SpokaneStBridge,11/19/2017 04:00:00 PM,48,-122,4,1,5
34049,SpokaneStBridge,11/19/2017 05:00:00 PM,48,-122,3,1,4
34050,SpokaneStBridge,11/19/2017 06:00:00 PM,48,-122,0,1,1
34051,SpokaneStBridge,11/19/2017 07:00:00 PM,48,-122,0,2,2
34052,SpokaneStBridge,11/19/2017 08:00:00 PM,48,-122,0,1,1
34053,SpokaneStBridge,11/19/2017 09:00:00 PM,48,-122,0,1,1
34054,SpokaneStBridge,11/19/2017 10:00:00 PM,48,-122,0,0,0
34055,SpokaneStBridge,11/19/2017 11:00:00 PM,48,-122,0,1,1
34056,SpokaneStBridge,11/20/2017 12:00:00 AM,48,-122,1,0,1
34057,SpokaneStBridge,11/20/2017 01:00:00 AM,48,-122,0,3,3
34058,SpokaneStBridge,11/20/2017 02:00:00 AM,48,-122,0,0,0
34059,SpokaneStBridge,11/20/2017 03:00:00 AM,48,-122,0,1,1
34060,SpokaneStBridge,11/20/2017 04:00:00 AM,48,-122,3,1,4
34061,SpokaneStBridge,11/20/2017 05:00:00 AM,48,-122,12,3,15
34062,SpokaneStBridge,11/20/2017 06:00:00 AM,48,-122,34,2,36
34063,SpokaneStBridge,11/20/2017 07:00:00 AM,48,-122,61,7,68
34064,SpokaneStBridge,11/20/2017 08:00:00 AM,48,-122,57,6,63
34065,SpokaneStBridge,11/20/2017 09:00:00 AM,48,-122,26,3,29
34066,SpokaneStBridge,11/20/2017 10:00:00 AM,48,-122,10,1,11
34067,SpokaneStBridge,11/20/2017 11:00:00 AM,48,-122,9,5,14
34068,SpokaneStBridge,11/20/2017 12:00:00 PM,48,-122,9,5,14
34069,SpokaneStBridge,11/20/2017 01:00:00 PM,48,-122,4,7,11
34070,SpokaneStBridge,11/20/2017 02:00:00 PM,48,-122,8,6,14
34071,SpokaneStBridge,11/20/2017 03:00:00 PM,48,-122,2,20,22
34072,SpokaneStBridge,11/20/2017 04:00:00 PM,48,-122,15,39,54
34073,SpokaneStBridge,11/20/2017 05:00:00 PM,48,-122,6,78,84
34074,SpokaneStBridge,11/20/2017 06:00:00 PM,48,-122,12,40,52
34075,SpokaneStBridge,11/20/2017 07:00:00 PM,48,-122,4,13,17
34076,SpokaneStBridge,11/20/2017 08:00:00 PM,48,-122,1,6,7
34077,SpokaneStBridge,11/20/2017 09:00:00 PM,48,-122,1,6,7
34078,SpokaneStBridge,11/20/2017 10:00:00 PM,48,-122,0,2,2
34079,SpokaneStBridge,11/20/2017 11:00:00 PM,48,-122,4,2,6
34080,SpokaneStBridge,11/21/2017 12:00:00 AM,48,-122,0,2,2
34081,SpokaneStBridge,11/21/2017 01:00:00 AM,48,-122,0,2,2
34082,SpokaneStBridge,11/21/2017 02:00:00 AM,48,-122,0,0,0
34083,SpokaneStBridge,11/21/2017 03:00:00 AM,48,-122,0,0,0
34084,SpokaneStBridge,11/21/2017 04:00:00 AM,48,-122,3,2,5
34085,SpokaneStBridge,11/21/2017 05:00:00 AM,48,-122,15,2,17
34086,SpokaneStBridge,11/21/2017 06:00:00 AM,48,-122,22,0,22
34087,SpokaneStBridge,11/21/2017 07:00:00 AM,48,-122,64,6,70
34088,SpokaneStBridge,11/21/2017 08:00:00 AM,48,-122,53,5,58
34089,SpokaneStBridge,11/21/2017 09:00:00 AM,48,-122,22,1,23
34090,SpokaneStBridge,11/21/2017 10:00:00 AM,48,-122,9,0,9
34091,SpokaneStBridge,11/21/2017 11:00:00 AM,48,-122,2,2,4
34092,SpokaneStBridge,11/21/2017 12:00:00 PM,48,-122,4,4,8
34093,SpokaneStBridge,11/21/2017 01:00:00 PM,48,-122,0,5,5
34094,SpokaneStBridge,11/21/2017 02:00:00 PM,48,-122,7,4,11
34095,SpokaneStBridge,11/21/2017 03:00:00 PM,48,-122,1,12,13
34096,SpokaneStBridge,11/21/2017 04:00:00 PM,48,-122,5,29,34
34097,SpokaneStBridge,11/21/2017 05:00:00 PM,48,-122,7,63,70
34098,SpokaneStBridge,11/21/2017 06:00:00 PM,48,-122,6,29,35
34099,SpokaneStBridge,11/21/2017 07:00:00 PM,48,-122,1,12,13
34100,SpokaneStBridge,11/21/2017 08:00:00 PM,48,-122,2,4,6
34101,SpokaneStBridge,11/21/2017 09:00:00 PM,48,-122,0,3,3
34102,SpokaneStBridge,11/21/2017 10:00:00 PM,48,-122,0,2,2
34103,SpokaneStBridge,11/21/2017 11:00:00 PM,48,-122,1,0,1
34104,SpokaneStBridge,11/22/2017 12:00:00 AM,48,-122,1,1,2
34105,SpokaneStBridge,11/22/2017 01:00:00 AM,48,-122,0,1,1
34106,SpokaneStBridge,11/22/2017 02:00:00 AM,48,-122,2,0,2
34107,SpokaneStBridge,11/22/2017 03:00:00 AM,48,-122,0,0,0
34108,SpokaneStBridge,11/22/2017 04:00:00 AM,48,-122,2,3,5
34109,SpokaneStBridge,11/22/2017 05:00:00 AM,48,-122,9,1,10
34110,SpokaneStBridge,11/22/2017 06:00:00 AM,48,-122,23,2,25
34111,SpokaneStBridge,11/22/2017 07:00:00 AM,48,-122,63,7,70
34112,SpokaneStBridge,11/22/2017 08:00:00 AM,48,-122,55,9,64
34113,SpokaneStBridge,11/22/2017 09:00:00 AM,48,-122,25,14,39
34114,SpokaneStBridge,11/22/2017 10:00:00 AM,48,-122,12,6,18
34115,SpokaneStBridge,11/22/2017 11:00:00 AM,48,-122,9,4,13
34116,SpokaneStBridge,11/22/2017 12:00:00 PM,48,-122,15,7,22
34117,SpokaneStBridge,11/22/2017 01:00:00 PM,48,-122,10,11,21
34118,SpokaneStBridge,11/22/2017 02:00:00 PM,48,-122,7,21,28
34119,SpokaneStBridge,11/22/2017 03:00:00 PM,48,-122,9,38,47
34120,SpokaneStBridge,11/22/2017 04:00:00 PM,48,-122,7,48,55
34121,SpokaneStBridge,11/22/2017 05:00:00 PM,48,-122,5,42,47
34122,SpokaneStBridge,11/22/2017 06:00:00 PM,48,-122,3,17,20
34123,SpokaneStBridge,11/22/2017 07:00:00 PM,48,-122,1,9,10
34124,SpokaneStBridge,11/22/2017 08:00:00 PM,48,-122,1,7,8
34125,SpokaneStBridge,11/22/2017 09:00:00 PM,48,-122,2,2,4
34126,SpokaneStBridge,11/22/2017 10:00:00 PM,48,-122,0,1,1
34127,SpokaneStBridge,11/22/2017 11:00:00 PM,48,-122,2,2,4
34128,SpokaneStBridge,11/23/2017 12:00:00 AM,48,-122,0,1,1
34129,SpokaneStBridge,11/23/2017 01:00:00 AM,48,-122,2,0,2
34130,SpokaneStBridge,11/23/2017 02:00:00 AM,48,-122,1,2,3
34131,SpokaneStBridge,11/23/2017 03:00:00 AM,48,-122,0,1,1
34132,SpokaneStBridge,11/23/2017 04:00:00 AM,48,-122,1,0,1
34133,SpokaneStBridge,11/23/2017 05:00:00 AM,48,-122,3,1,4
34134,SpokaneStBridge,11/23/2017 06:00:00 AM,48,-122,1,2,3
34135,SpokaneStBridge,11/23/2017 07:00:00 AM,48,-122,1,2,3
34136,SpokaneStBridge,11/23/2017 08:00:00 AM,48,-122,7,4,11
34137,SpokaneStBridge,11/23/2017 09:00:00 AM,48,-122,5,9,14
34138,SpokaneStBridge,11/23/2017 10:00:00 AM,48,-122,5,1,6
34139,SpokaneStBridge,11/23/2017 11:00:00 AM,48,-122,1,5,6
34140,SpokaneStBridge,11/23/2017 12:00:00 PM,48,-122,3,3,6
34141,SpokaneStBridge,11/23/2017 01:00:00 PM,48,-122,1,3,4
34142,SpokaneStBridge,11/23/2017 02:00:00 PM,48,-122,5,3,8
34143,SpokaneStBridge,11/23/2017 03:00:00 PM,48,-122,4,8,12
34144,SpokaneStBridge,11/23/2017 04:00:00 PM,48,-122,3,3,6
34145,SpokaneStBridge,11/23/2017 05:00:00 PM,48,-122,2,1,3
34146,SpokaneStBridge,11/23/2017 06:00:00 PM,48,-122,1,0,1
34147,SpokaneStBridge,11/23/2017 07:00:00 PM,48,-122,5,1,6
34148,SpokaneStBridge,11/23/2017 08:00:00 PM,48,-122,3,0,3
34149,SpokaneStBridge,11/23/2017 09:00:00 PM,48,-122,4,1,5
34150,SpokaneStBridge,11/23/2017 10:00:00 PM,48,-122,0,2,2
34151,SpokaneStBridge,11/23/2017 11:00:00 PM,48,-122,1,1,2
34152,SpokaneStBridge,11/24/2017 12:00:00 AM,48,-122,0,0,0
34153,SpokaneStBridge,11/24/2017 01:00:00 AM,48,-122,0,0,0
34154,SpokaneStBridge,11/24/2017 02:00:00 AM,48,-122,3,2,5
34155,SpokaneStBridge,11/24/2017 03:00:00 AM,48,-122,1,0,1
34156,SpokaneStBridge,11/24/2017 04:00:00 AM,48,-122,4,2,6
34157,SpokaneStBridge,11/24/2017 05:00:00 AM,48,-122,1,1,2
34158,SpokaneStBridge,11/24/2017 06:00:00 AM,48,-122,4,2,6
34159,SpokaneStBridge,11/24/2017 07:00:00 AM,48,-122,7,3,10
34160,SpokaneStBridge,11/24/2017 08:00:00 AM,48,-122,17,5,22
34161,SpokaneStBridge,11/24/2017 09:00:00 AM,48,-122,7,4,11
34162,SpokaneStBridge,11/24/2017 10:00:00 AM,48,-122,12,12,24
34163,SpokaneStBridge,11/24/2017 11:00:00 AM,48,-122,16,13,29
34164,SpokaneStBridge,11/24/2017 12:00:00 PM,48,-122,13,14,27
34165,SpokaneStBridge,11/24/2017 01:00:00 PM,48,-122,13,13,26
34166,SpokaneStBridge,11/24/2017 02:00:00 PM,48,-122,13,18,31
34167,SpokaneStBridge,11/24/2017 03:00:00 PM,48,-122,8,10,18
34168,SpokaneStBridge,11/24/2017 04:00:00 PM,48,-122,9,12,21
34169,SpokaneStBridge,11/24/2017 05:00:00 PM,48,-122,4,10,14
34170,SpokaneStBridge,11/24/2017 06:00:00 PM,48,-122,2,4,6
34171,SpokaneStBridge,11/24/2017 07:00:00 PM,48,-122,4,4,8
34172,SpokaneStBridge,11/24/2017 08:00:00 PM,48,-122,0,3,3
34173,SpokaneStBridge,11/24/2017 09:00:00 PM,48,-122,2,2,4
34174,SpokaneStBridge,11/24/2017 10:00:00 PM,48,-122,1,2,3
34175,SpokaneStBridge,11/24/2017 11:00:00 PM,48,-122,0,1,1
34176,SpokaneStBridge,11/25/2017 12:00:00 AM,48,-122,1,0,1
34177,SpokaneStBridge,11/25/2017 01:00:00 AM,48,-122,0,1,1
34178,SpokaneStBridge,11/25/2017 02:00:00 AM,48,-122,0,0,0
34179,SpokaneStBridge,11/25/2017 03:00:00 AM,48,-122,0,0,0
34180,SpokaneStBridge,11/25/2017 04:00:00 AM,48,-122,0,1,1
34181,SpokaneStBridge,11/25/2017 05:00:00 AM,48,-122,0,0,0
34182,SpokaneStBridge,11/25/2017 06:00:00 AM,48,-122,2,0,2
34183,SpokaneStBridge,11/25/2017 07:00:00 AM,48,-122,4,0,4
34184,SpokaneStBridge,11/25/2017 08:00:00 AM,48,-122,16,4,20
34185,SpokaneStBridge,11/25/2017 09:00:00 AM,48,-122,11,12,23
34186,SpokaneStBridge,11/25/2017 10:00:00 AM,48,-122,20,16,36
34187,SpokaneStBridge,11/25/2017 11:00:00 AM,48,-122,18,17,35
34188,SpokaneStBridge,11/25/2017 12:00:00 PM,48,-122,23,26,49
34189,SpokaneStBridge,11/25/2017 01:00:00 PM,48,-122,18,9,27
34190,SpokaneStBridge,11/25/2017 02:00:00 PM,48,-122,13,15,28
34191,SpokaneStBridge,11/25/2017 03:00:00 PM,48,-122,3,14,17
34192,SpokaneStBridge,11/25/2017 04:00:00 PM,48,-122,2,5,7
34193,SpokaneStBridge,11/25/2017 05:00:00 PM,48,-122,1,4,5
34194,SpokaneStBridge,11/25/2017 06:00:00 PM,48,-122,0,2,2
34195,SpokaneStBridge,11/25/2017 07:00:00 PM,48,-122,3,1,4
34196,SpokaneStBridge,11/25/2017 08:00:00 PM,48,-122,2,1,3
34197,SpokaneStBridge,11/25/2017 09:00:00 PM,48,-122,1,1,2
34198,SpokaneStBridge,11/25/2017 10:00:00 PM,48,-122,0,0,0
34199,SpokaneStBridge,11/25/2017 11:00:00 PM,48,-122,0,1,1
34200,SpokaneStBridge,11/26/2017 12:00:00 AM,48,-122,1,1,2
34201,SpokaneStBridge,11/26/2017 01:00:00 AM,48,-122,3,1,4
34202,SpokaneStBridge,11/26/2017 02:00:00 AM,48,-122,0,3,3
34203,SpokaneStBridge,11/26/2017 03:00:00 AM,48,-122,1,1,2
34204,SpokaneStBridge,11/26/2017 04:00:00 AM,48,-122,1,2,3
34205,SpokaneStBridge,11/26/2017 05:00:00 AM,48,-122,2,1,3
34206,SpokaneStBridge,11/26/2017 06:00:00 AM,48,-122,1,1,2
34207,SpokaneStBridge,11/26/2017 07:00:00 AM,48,-122,3,1,4
34208,SpokaneStBridge,11/26/2017 08:00:00 AM,48,-122,3,0,3
34209,SpokaneStBridge,11/26/2017 09:00:00 AM,48,-122,5,3,8
34210,SpokaneStBridge,11/26/2017 10:00:00 AM,48,-122,7,13,20
34211,SpokaneStBridge,11/26/2017 11:00:00 AM,48,-122,12,8,20
34212,SpokaneStBridge,11/26/2017 12:00:00 PM,48,-122,6,3,9
34213,SpokaneStBridge,11/26/2017 01:00:00 PM,48,-122,4,6,10
34214,SpokaneStBridge,11/26/2017 02:00:00 PM,48,-122,4,3,7
34215,SpokaneStBridge,11/26/2017 03:00:00 PM,48,-122,1,5,6
34216,SpokaneStBridge,11/26/2017 04:00:00 PM,48,-122,2,2,4
34217,SpokaneStBridge,11/26/2017 05:00:00 PM,48,-122,4,5,9
34218,SpokaneStBridge,11/26/2017 06:00:00 PM,48,-122,1,2,3
34219,SpokaneStBridge,11/26/2017 07:00:00 PM,48,-122,0,4,4
34220,SpokaneStBridge,11/26/2017 08:00:00 PM,48,-122,3,1,4
34221,SpokaneStBridge,11/26/2017 09:00:00 PM,48,-122,1,2,3
34222,SpokaneStBridge,11/26/2017 10:00:00 PM,48,-122,0,0,0
34223,SpokaneStBridge,11/26/2017 11:00:00 PM,48,-122,1,2,3
34224,SpokaneStBridge,11/27/2017 12:00:00 AM,48,-122,0,0,0
34225,SpokaneStBridge,11/27/2017 01:00:00 AM,48,-122,1,1,2
34226,SpokaneStBridge,11/27/2017 02:00:00 AM,48,-122,0,0,0
34227,SpokaneStBridge,11/27/2017 03:00:00 AM,48,-122,0,1,1
34228,SpokaneStBridge,11/27/2017 04:00:00 AM,48,-122,9,1,10
34229,SpokaneStBridge,11/27/2017 05:00:00 AM,48,-122,18,4,22
34230,SpokaneStBridge,11/27/2017 06:00:00 AM,48,-122,42,9,51
34231,SpokaneStBridge,11/27/2017 07:00:00 AM,48,-122,114,12,126
34232,SpokaneStBridge,11/27/2017 08:00:00 AM,48,-122,111,14,125
34233,SpokaneStBridge,11/27/2017 09:00:00 AM,48,-122,40,5,45
34234,SpokaneStBridge,11/27/2017 10:00:00 AM,48,-122,18,5,23
34235,SpokaneStBridge,11/27/2017 11:00:00 AM,48,-122,8,2,10
34236,SpokaneStBridge,11/27/2017 12:00:00 PM,48,-122,7,5,12
34237,SpokaneStBridge,11/27/2017 01:00:00 PM,48,-122,13,7,20
34238,SpokaneStBridge,11/27/2017 02:00:00 PM,48,-122,2,12,14
34239,SpokaneStBridge,11/27/2017 03:00:00 PM,48,-122,18,28,46
34240,SpokaneStBridge,11/27/2017 04:00:00 PM,48,-122,13,77,90
34241,SpokaneStBridge,11/27/2017 05:00:00 PM,48,-122,16,135,151
34242,SpokaneStBridge,11/27/2017 06:00:00 PM,48,-122,10,62,72
34243,SpokaneStBridge,11/27/2017 07:00:00 PM,48,-122,3,22,25
34244,SpokaneStBridge,11/27/2017 08:00:00 PM,48,-122,1,8,9
34245,SpokaneStBridge,11/27/2017 09:00:00 PM,48,-122,1,8,9
34246,SpokaneStBridge,11/27/2017 10:00:00 PM,48,-122,1,4,5
34247,SpokaneStBridge,11/27/2017 11:00:00 PM,48,-122,0,1,1
34248,SpokaneStBridge,11/28/2017 12:00:00 AM,48,-122,2,0,2
34249,SpokaneStBridge,11/28/2017 01:00:00 AM,48,-122,2,1,3
34250,SpokaneStBridge,11/28/2017 02:00:00 AM,48,-122,1,1,2
34251,SpokaneStBridge,11/28/2017 03:00:00 AM,48,-122,0,1,1
34252,SpokaneStBridge,11/28/2017 04:00:00 AM,48,-122,7,1,8
34253,SpokaneStBridge,11/28/2017 05:00:00 AM,48,-122,25,3,28
34254,SpokaneStBridge,11/28/2017 06:00:00 AM,48,-122,28,7,35
34255,SpokaneStBridge,11/28/2017 07:00:00 AM,48,-122,73,9,82
34256,SpokaneStBridge,11/28/2017 08:00:00 AM,48,-122,83,4,87
34257,SpokaneStBridge,11/28/2017 09:00:00 AM,48,-122,29,2,31
34258,SpokaneStBridge,11/28/2017 10:00:00 AM,48,-122,9,0,9
34259,SpokaneStBridge,11/28/2017 11:00:00 AM,48,-122,2,2,4
34260,SpokaneStBridge,11/28/2017 12:00:00 PM,48,-122,2,3,5
34261,SpokaneStBridge,11/28/2017 01:00:00 PM,48,-122,7,2,9
34262,SpokaneStBridge,11/28/2017 02:00:00 PM,48,-122,5,3,8
34263,SpokaneStBridge,11/28/2017 03:00:00 PM,48,-122,2,10,12
34264,SpokaneStBridge,11/28/2017 04:00:00 PM,48,-122,10,47,57
34265,SpokaneStBridge,11/28/2017 05:00:00 PM,48,-122,11,87,98
34266,SpokaneStBridge,11/28/2017 06:00:00 PM,48,-122,6,65,71
34267,SpokaneStBridge,11/28/2017 07:00:00 PM,48,-122,1,17,18
34268,SpokaneStBridge,11/28/2017 08:00:00 PM,48,-122,1,2,3
34269,SpokaneStBridge,11/28/2017 09:00:00 PM,48,-122,2,5,7
34270,SpokaneStBridge,11/28/2017 10:00:00 PM,48,-122,0,3,3
34271,SpokaneStBridge,11/28/2017 11:00:00 PM,48,-122,0,1,1
34272,SpokaneStBridge,11/29/2017 12:00:00 AM,48,-122,1,2,3
34273,SpokaneStBridge,11/29/2017 01:00:00 AM,48,-122,2,0,2
34274,SpokaneStBridge,11/29/2017 02:00:00 AM,48,-122,1,1,2
34275,SpokaneStBridge,11/29/2017 03:00:00 AM,48,-122,0,0,0
34276,SpokaneStBridge,11/29/2017 04:00:00 AM,48,-122,4,3,7
34277,SpokaneStBridge,11/29/2017 05:00:00 AM,48,-122,14,2,16
34278,SpokaneStBridge,11/29/2017 06:00:00 AM,48,-122,53,9,62
34279,SpokaneStBridge,11/29/2017 07:00:00 AM,48,-122,106,12,118
34280,SpokaneStBridge,11/29/2017 08:00:00 AM,48,-122,102,8,110
34281,SpokaneStBridge,11/29/2017 09:00:00 AM,48,-122,56,2,58
34282,SpokaneStBridge,11/29/2017 10:00:00 AM,48,-122,14,5,19
34283,SpokaneStBridge,11/29/2017 11:00:00 AM,48,-122,9,7,16
34284,SpokaneStBridge,11/29/2017 12:00:00 PM,48,-122,11,8,19
34285,SpokaneStBridge,11/29/2017 01:00:00 PM,48,-122,10,8,18
34286,SpokaneStBridge,11/29/2017 02:00:00 PM,48,-122,7,15,22
34287,SpokaneStBridge,11/29/2017 03:00:00 PM,48,-122,8,33,41
34288,SpokaneStBridge,11/29/2017 04:00:00 PM,48,-122,23,68,91
34289,SpokaneStBridge,11/29/2017 05:00:00 PM,48,-122,20,118,138
34290,SpokaneStBridge,11/29/2017 06:00:00 PM,48,-122,7,56,63
34291,SpokaneStBridge,11/29/2017 07:00:00 PM,48,-122,7,24,31
34292,SpokaneStBridge,11/29/2017 08:00:00 PM,48,-122,4,17,21
34293,SpokaneStBridge,11/29/2017 09:00:00 PM,48,-122,0,7,7
34294,SpokaneStBridge,11/29/2017 10:00:00 PM,48,-122,1,6,7
34295,SpokaneStBridge,11/29/2017 11:00:00 PM,48,-122,0,2,2
34296,SpokaneStBridge,11/30/2017 12:00:00 AM,48,-122,1,2,3
34297,SpokaneStBridge,11/30/2017 01:00:00 AM,48,-122,0,3,3
34298,SpokaneStBridge,11/30/2017 02:00:00 AM,48,-122,0,2,2
34299,SpokaneStBridge,11/30/2017 03:00:00 AM,48,-122,1,2,3
34300,SpokaneStBridge,11/30/2017 04:00:00 AM,48,-122,5,0,5
34301,SpokaneStBridge,11/30/2017 05:00:00 AM,48,-122,18,3,21
34302,SpokaneStBridge,11/30/2017 06:00:00 AM,48,-122,34,6,40
34303,SpokaneStBridge,11/30/2017 07:00:00 AM,48,-122,75,8,83
34304,SpokaneStBridge,11/30/2017 08:00:00 AM,48,-122,68,7,75
34305,SpokaneStBridge,11/30/2017 09:00:00 AM,48,-122,28,1,29
34306,SpokaneStBridge,11/30/2017 10:00:00 AM,48,-122,11,2,13
34307,SpokaneStBridge,11/30/2017 11:00:00 AM,48,-122,8,3,11
34308,SpokaneStBridge,11/30/2017 12:00:00 PM,48,-122,4,5,9
34309,SpokaneStBridge,11/30/2017 01:00:00 PM,48,-122,8,4,12
34310,SpokaneStBridge,11/30/2017 02:00:00 PM,48,-122,6,4,10
34311,SpokaneStBridge,11/30/2017 03:00:00 PM,48,-122,7,17,24
34312,SpokaneStBridge,11/30/2017 04:00:00 PM,48,-122,10,33,43
34313,SpokaneStBridge,11/30/2017 05:00:00 PM,48,-122,13,88,101
34314,SpokaneStBridge,11/30/2017 06:00:00 PM,48,-122,12,42,54
34315,SpokaneStBridge,11/30/2017 07:00:00 PM,48,-122,7,17,24
34316,SpokaneStBridge,11/30/2017 08:00:00 PM,48,-122,0,8,8
34317,SpokaneStBridge,11/30/2017 09:00:00 PM,48,-122,4,2,6
34318,SpokaneStBridge,11/30/2017 10:00:00 PM,48,-122,1,11,12
34319,SpokaneStBridge,11/30/2017 11:00:00 PM,48,-122,0,3,3
34320,SpokaneStBridge,12/01/2017 12:00:00 AM,48,-122,1,1,2
34321,SpokaneStBridge,12/01/2017 01:00:00 AM,48,-122,0,0,0
34322,SpokaneStBridge,12/01/2017 02:00:00 AM,48,-122,1,2,3
34323,SpokaneStBridge,12/01/2017 03:00:00 AM,48,-122,2,0,2
34324,SpokaneStBridge,12/01/2017 04:00:00 AM,48,-122,2,3,5
34325,SpokaneStBridge,12/01/2017 05:00:00 AM,48,-122,13,0,13
34326,SpokaneStBridge,12/01/2017 06:00:00 AM,48,-122,24,9,33
34327,SpokaneStBridge,12/01/2017 07:00:00 AM,48,-122,73,14,87
34328,SpokaneStBridge,12/01/2017 08:00:00 AM,48,-122,76,7,83
34329,SpokaneStBridge,12/01/2017 09:00:00 AM,48,-122,31,3,34
34330,SpokaneStBridge,12/01/2017 10:00:00 AM,48,-122,9,2,11
34331,SpokaneStBridge,12/01/2017 11:00:00 AM,48,-122,10,3,13
34332,SpokaneStBridge,12/01/2017 12:00:00 PM,48,-122,4,1,5
34333,SpokaneStBridge,12/01/2017 01:00:00 PM,48,-122,5,4,9
34334,SpokaneStBridge,12/01/2017 02:00:00 PM,48,-122,2,7,9
34335,SpokaneStBridge,12/01/2017 03:00:00 PM,48,-122,7,14,21
34336,SpokaneStBridge,12/01/2017 04:00:00 PM,48,-122,6,48,54
34337,SpokaneStBridge,12/01/2017 05:00:00 PM,48,-122,10,71,81
34338,SpokaneStBridge,12/01/2017 06:00:00 PM,48,-122,9,23,32
34339,SpokaneStBridge,12/01/2017 07:00:00 PM,48,-122,3,15,18
34340,SpokaneStBridge,12/01/2017 08:00:00 PM,48,-122,1,8,9
34341,SpokaneStBridge,12/01/2017 09:00:00 PM,48,-122,1,5,6
34342,SpokaneStBridge,12/01/2017 10:00:00 PM,48,-122,2,5,7
34343,SpokaneStBridge,12/01/2017 11:00:00 PM,48,-122,1,1,2
34344,SpokaneStBridge,12/02/2017 12:00:00 AM,48,-122,1,3,4
34345,SpokaneStBridge,12/02/2017 01:00:00 AM,48,-122,5,2,7
34346,SpokaneStBridge,12/02/2017 02:00:00 AM,48,-122,0,2,2
34347,SpokaneStBridge,12/02/2017 03:00:00 AM,48,-122,2,0,2
34348,SpokaneStBridge,12/02/2017 04:00:00 AM,48,-122,2,4,6
34349,SpokaneStBridge,12/02/2017 05:00:00 AM,48,-122,3,0,3
34350,SpokaneStBridge,12/02/2017 06:00:00 AM,48,-122,4,0,4
34351,SpokaneStBridge,12/02/2017 07:00:00 AM,48,-122,2,0,2
34352,SpokaneStBridge,12/02/2017 08:00:00 AM,48,-122,10,2,12
34353,SpokaneStBridge,12/02/2017 09:00:00 AM,48,-122,5,4,9
34354,SpokaneStBridge,12/02/2017 10:00:00 AM,48,-122,3,2,5
34355,SpokaneStBridge,12/02/2017 11:00:00 AM,48,-122,0,0,0
34356,SpokaneStBridge,12/02/2017 12:00:00 PM,48,-122,2,4,6
34357,SpokaneStBridge,12/02/2017 01:00:00 PM,48,-122,4,2,6
34358,SpokaneStBridge,12/02/2017 02:00:00 PM,48,-122,2,2,4
34359,SpokaneStBridge,12/02/2017 03:00:00 PM,48,-122,2,4,6
34360,SpokaneStBridge,12/02/2017 04:00:00 PM,48,-122,4,2,6
34361,SpokaneStBridge,12/02/2017 05:00:00 PM,48,-122,2,4,6
34362,SpokaneStBridge,12/02/2017 06:00:00 PM,48,-122,4,0,4
34363,SpokaneStBridge,12/02/2017 07:00:00 PM,48,-122,1,1,2
34364,SpokaneStBridge,12/02/2017 08:00:00 PM,48,-122,0,2,2
34365,SpokaneStBridge,12/02/2017 09:00:00 PM,48,-122,1,1,2
34366,SpokaneStBridge,12/02/2017 10:00:00 PM,48,-122,0,1,1
34367,SpokaneStBridge,12/02/2017 11:00:00 PM,48,-122,0,1,1
34368,SpokaneStBridge,12/03/2017 12:00:00 AM,48,-122,0,1,1
34369,SpokaneStBridge,12/03/2017 01:00:00 AM,48,-122,0,1,1
34370,SpokaneStBridge,12/03/2017 02:00:00 AM,48,-122,0,1,1
34371,SpokaneStBridge,12/03/2017 03:00:00 AM,48,-122,0,0,0
34372,SpokaneStBridge,12/03/2017 04:00:00 AM,48,-122,1,0,1
34373,SpokaneStBridge,12/03/2017 05:00:00 AM,48,-122,2,2,4
34374,SpokaneStBridge,12/03/2017 06:00:00 AM,48,-122,3,0,3
34375,SpokaneStBridge,12/03/2017 07:00:00 AM,48,-122,3,2,5
34376,SpokaneStBridge,12/03/2017 08:00:00 AM,48,-122,12,9,21
34377,SpokaneStBridge,12/03/2017 09:00:00 AM,48,-122,24,12,36
34378,SpokaneStBridge,12/03/2017 10:00:00 AM,48,-122,14,20,34
34379,SpokaneStBridge,12/03/2017 11:00:00 AM,48,-122,15,19,34
34380,SpokaneStBridge,12/03/2017 12:00:00 PM,48,-122,10,10,20
34381,SpokaneStBridge,12/03/2017 01:00:00 PM,48,-122,22,8,30
34382,SpokaneStBridge,12/03/2017 02:00:00 PM,48,-122,8,12,20
34383,SpokaneStBridge,12/03/2017 03:00:00 PM,48,-122,15,14,29
34384,SpokaneStBridge,12/03/2017 04:00:00 PM,48,-122,11,9,20
34385,SpokaneStBridge,12/03/2017 05:00:00 PM,48,-122,4,6,10
34386,SpokaneStBridge,12/03/2017 06:00:00 PM,48,-122,2,0,2
34387,SpokaneStBridge,12/03/2017 07:00:00 PM,48,-122,3,7,10
34388,SpokaneStBridge,12/03/2017 08:00:00 PM,48,-122,0,1,1
34389,SpokaneStBridge,12/03/2017 09:00:00 PM,48,-122,2,6,8
34390,SpokaneStBridge,12/03/2017 10:00:00 PM,48,-122,3,0,3
34391,SpokaneStBridge,12/03/2017 11:00:00 PM,48,-122,0,5,5
34392,SpokaneStBridge,12/04/2017 12:00:00 AM,48,-122,0,0,0
34393,SpokaneStBridge,12/04/2017 01:00:00 AM,48,-122,3,2,5
34394,SpokaneStBridge,12/04/2017 02:00:00 AM,48,-122,1,0,1
34395,SpokaneStBridge,12/04/2017 03:00:00 AM,48,-122,0,0,0
34396,SpokaneStBridge,12/04/2017 04:00:00 AM,48,-122,7,0,7
34397,SpokaneStBridge,12/04/2017 05:00:00 AM,48,-122,11,4,15
34398,SpokaneStBridge,12/04/2017 06:00:00 AM,48,-122,48,4,52
34399,SpokaneStBridge,12/04/2017 07:00:00 AM,48,-122,92,8,100
34400,SpokaneStBridge,12/04/2017 08:00:00 AM,48,-122,100,12,112
34401,SpokaneStBridge,12/04/2017 09:00:00 AM,48,-122,27,1,28
34402,SpokaneStBridge,12/04/2017 10:00:00 AM,48,-122,18,3,21
34403,SpokaneStBridge,12/04/2017 11:00:00 AM,48,-122,5,3,8
34404,SpokaneStBridge,12/04/2017 12:00:00 PM,48,-122,8,6,14
34405,SpokaneStBridge,12/04/2017 01:00:00 PM,48,-122,8,7,15
34406,SpokaneStBridge,12/04/2017 02:00:00 PM,48,-122,7,7,14
34407,SpokaneStBridge,12/04/2017 03:00:00 PM,48,-122,11,19,30
34408,SpokaneStBridge,12/04/2017 04:00:00 PM,48,-122,14,65,79
34409,SpokaneStBridge,12/04/2017 05:00:00 PM,48,-122,16,117,133
34410,SpokaneStBridge,12/04/2017 06:00:00 PM,48,-122,9,49,58
34411,SpokaneStBridge,12/04/2017 07:00:00 PM,48,-122,2,26,28
34412,SpokaneStBridge,12/04/2017 08:00:00 PM,48,-122,2,8,10
34413,SpokaneStBridge,12/04/2017 09:00:00 PM,48,-122,0,5,5
34414,SpokaneStBridge,12/04/2017 10:00:00 PM,48,-122,0,3,3
34415,SpokaneStBridge,12/04/2017 11:00:00 PM,48,-122,1,0,1
34416,SpokaneStBridge,12/05/2017 12:00:00 AM,48,-122,0,0,0
34417,SpokaneStBridge,12/05/2017 01:00:00 AM,48,-122,0,1,1
34418,SpokaneStBridge,12/05/2017 02:00:00 AM,48,-122,0,0,0
34419,SpokaneStBridge,12/05/2017 03:00:00 AM,48,-122,1,1,2
34420,SpokaneStBridge,12/05/2017 04:00:00 AM,48,-122,3,1,4
34421,SpokaneStBridge,12/05/2017 05:00:00 AM,48,-122,30,3,33
34422,SpokaneStBridge,12/05/2017 06:00:00 AM,48,-122,34,7,41
34423,SpokaneStBridge,12/05/2017 07:00:00 AM,48,-122,87,8,95
34424,SpokaneStBridge,12/05/2017 08:00:00 AM,48,-122,108,7,115
34425,SpokaneStBridge,12/05/2017 09:00:00 AM,48,-122,30,3,33
34426,SpokaneStBridge,12/05/2017 10:00:00 AM,48,-122,11,0,11
34427,SpokaneStBridge,12/05/2017 11:00:00 AM,48,-122,7,6,13
34428,SpokaneStBridge,12/05/2017 12:00:00 PM,48,-122,12,5,17
34429,SpokaneStBridge,12/05/2017 01:00:00 PM,48,-122,14,7,21
34430,SpokaneStBridge,12/05/2017 02:00:00 PM,48,-122,9,10,19
34431,SpokaneStBridge,12/05/2017 03:00:00 PM,48,-122,11,22,33
34432,SpokaneStBridge,12/05/2017 04:00:00 PM,48,-122,9,61,70
34433,SpokaneStBridge,12/05/2017 05:00:00 PM,48,-122,16,108,124
34434,SpokaneStBridge,12/05/2017 06:00:00 PM,48,-122,8,56,64
34435,SpokaneStBridge,12/05/2017 07:00:00 PM,48,-122,1,19,20
34436,SpokaneStBridge,12/05/2017 08:00:00 PM,48,-122,2,7,9
34437,SpokaneStBridge,12/05/2017 09:00:00 PM,48,-122,3,7,10
34438,SpokaneStBridge,12/05/2017 10:00:00 PM,48,-122,2,8,10
34439,SpokaneStBridge,12/05/2017 11:00:00 PM,48,-122,0,1,1
34440,SpokaneStBridge,12/06/2017 12:00:00 AM,48,-122,2,3,5
34441,SpokaneStBridge,12/06/2017 01:00:00 AM,48,-122,0,2,2
34442,SpokaneStBridge,12/06/2017 02:00:00 AM,48,-122,1,1,2
34443,SpokaneStBridge,12/06/2017 03:00:00 AM,48,-122,0,1,1
34444,SpokaneStBridge,12/06/2017 04:00:00 AM,48,-122,3,0,3
34445,SpokaneStBridge,12/06/2017 05:00:00 AM,48,-122,21,3,24
34446,SpokaneStBridge,12/06/2017 06:00:00 AM,48,-122,49,7,56
34447,SpokaneStBridge,12/06/2017 07:00:00 AM,48,-122,77,15,92
34448,SpokaneStBridge,12/06/2017 08:00:00 AM,48,-122,94,7,101
34449,SpokaneStBridge,12/06/2017 09:00:00 AM,48,-122,45,6,51
34450,SpokaneStBridge,12/06/2017 10:00:00 AM,48,-122,20,4,24
34451,SpokaneStBridge,12/06/2017 11:00:00 AM,48,-122,17,7,24
34452,SpokaneStBridge,12/06/2017 12:00:00 PM,48,-122,11,11,22
34453,SpokaneStBridge,12/06/2017 01:00:00 PM,48,-122,10,8,18
34454,SpokaneStBridge,12/06/2017 02:00:00 PM,48,-122,11,14,25
34455,SpokaneStBridge,12/06/2017 03:00:00 PM,48,-122,18,28,46
34456,SpokaneStBridge,12/06/2017 04:00:00 PM,48,-122,13,58,71
34457,SpokaneStBridge,12/06/2017 05:00:00 PM,48,-122,16,103,119
34458,SpokaneStBridge,12/06/2017 06:00:00 PM,48,-122,4,50,54
34459,SpokaneStBridge,12/06/2017 07:00:00 PM,48,-122,4,23,27
34460,SpokaneStBridge,12/06/2017 08:00:00 PM,48,-122,9,19,28
34461,SpokaneStBridge,12/06/2017 09:00:00 PM,48,-122,0,5,5
34462,SpokaneStBridge,12/06/2017 10:00:00 PM,48,-122,0,6,6
34463,SpokaneStBridge,12/06/2017 11:00:00 PM,48,-122,1,1,2
34464,SpokaneStBridge,12/07/2017 12:00:00 AM,48,-122,0,0,0
34465,SpokaneStBridge,12/07/2017 01:00:00 AM,48,-122,1,1,2
34466,SpokaneStBridge,12/07/2017 02:00:00 AM,48,-122,0,1,1
34467,SpokaneStBridge,12/07/2017 03:00:00 AM,48,-122,1,1,2
34468,SpokaneStBridge,12/07/2017 04:00:00 AM,48,-122,3,1,4
34469,SpokaneStBridge,12/07/2017 05:00:00 AM,48,-122,20,2,22
34470,SpokaneStBridge,12/07/2017 06:00:00 AM,48,-122,37,1,38
34471,SpokaneStBridge,12/07/2017 07:00:00 AM,48,-122,48,10,58
34472,SpokaneStBridge,12/07/2017 08:00:00 AM,48,-122,100,5,105
34473,SpokaneStBridge,12/07/2017 09:00:00 AM,48,-122,39,3,42
34474,SpokaneStBridge,12/07/2017 10:00:00 AM,48,-122,16,5,21
34475,SpokaneStBridge,12/07/2017 11:00:00 AM,48,-122,11,6,17
34476,SpokaneStBridge,12/07/2017 12:00:00 PM,48,-122,12,7,19
34477,SpokaneStBridge,12/07/2017 01:00:00 PM,48,-122,9,5,14
34478,SpokaneStBridge,12/07/2017 02:00:00 PM,48,-122,6,11,17
34479,SpokaneStBridge,12/07/2017 03:00:00 PM,48,-122,13,22,35
34480,SpokaneStBridge,12/07/2017 04:00:00 PM,48,-122,12,57,69
34481,SpokaneStBridge,12/07/2017 05:00:00 PM,48,-122,8,79,87
34482,SpokaneStBridge,12/07/2017 06:00:00 PM,48,-122,9,62,71
34483,SpokaneStBridge,12/07/2017 07:00:00 PM,48,-122,6,24,30
34484,SpokaneStBridge,12/07/2017 08:00:00 PM,48,-122,2,9,11
34485,SpokaneStBridge,12/07/2017 09:00:00 PM,48,-122,3,5,8
34486,SpokaneStBridge,12/07/2017 10:00:00 PM,48,-122,1,9,10
34487,SpokaneStBridge,12/07/2017 11:00:00 PM,48,-122,1,2,3
34488,SpokaneStBridge,12/08/2017 12:00:00 AM,48,-122,0,1,1
34489,SpokaneStBridge,12/08/2017 01:00:00 AM,48,-122,0,0,0
34490,SpokaneStBridge,12/08/2017 02:00:00 AM,48,-122,0,2,2
34491,SpokaneStBridge,12/08/2017 03:00:00 AM,48,-122,0,2,2
34492,SpokaneStBridge,12/08/2017 04:00:00 AM,48,-122,1,1,2
34493,SpokaneStBridge,12/08/2017 05:00:00 AM,48,-122,13,1,14
34494,SpokaneStBridge,12/08/2017 06:00:00 AM,48,-122,24,2,26
34495,SpokaneStBridge,12/08/2017 07:00:00 AM,48,-122,49,10,59
34496,SpokaneStBridge,12/08/2017 08:00:00 AM,48,-122,64,5,69
34497,SpokaneStBridge,12/08/2017 09:00:00 AM,48,-122,28,2,30
34498,SpokaneStBridge,12/08/2017 10:00:00 AM,48,-122,9,3,12
34499,SpokaneStBridge,12/08/2017 11:00:00 AM,48,-122,8,3,11
34500,SpokaneStBridge,12/08/2017 12:00:00 PM,48,-122,5,9,14
34501,SpokaneStBridge,12/08/2017 01:00:00 PM,48,-122,11,8,19
34502,SpokaneStBridge,12/08/2017 02:00:00 PM,48,-122,10,9,19
34503,SpokaneStBridge,12/08/2017 03:00:00 PM,48,-122,9,25,34
34504,SpokaneStBridge,12/08/2017 04:00:00 PM,48,-122,11,42,53
34505,SpokaneStBridge,12/08/2017 05:00:00 PM,48,-122,15,58,73
34506,SpokaneStBridge,12/08/2017 06:00:00 PM,48,-122,7,28,35
34507,SpokaneStBridge,12/08/2017 07:00:00 PM,48,-122,3,19,22
34508,SpokaneStBridge,12/08/2017 08:00:00 PM,48,-122,3,5,8
34509,SpokaneStBridge,12/08/2017 09:00:00 PM,48,-122,1,2,3
34510,SpokaneStBridge,12/08/2017 10:00:00 PM,48,-122,2,3,5
34511,SpokaneStBridge,12/08/2017 11:00:00 PM,48,-122,2,3,5
34512,SpokaneStBridge,12/09/2017 12:00:00 AM,48,-122,0,1,1
34513,SpokaneStBridge,12/09/2017 01:00:00 AM,48,-122,1,1,2
34514,SpokaneStBridge,12/09/2017 02:00:00 AM,48,-122,0,2,2
34515,SpokaneStBridge,12/09/2017 03:00:00 AM,48,-122,0,1,1
34516,SpokaneStBridge,12/09/2017 04:00:00 AM,48,-122,1,1,2
34517,SpokaneStBridge,12/09/2017 05:00:00 AM,48,-122,4,0,4
34518,SpokaneStBridge,12/09/2017 06:00:00 AM,48,-122,3,2,5
34519,SpokaneStBridge,12/09/2017 07:00:00 AM,48,-122,2,0,2
34520,SpokaneStBridge,12/09/2017 08:00:00 AM,48,-122,6,1,7
34521,SpokaneStBridge,12/09/2017 09:00:00 AM,48,-122,6,4,10
34522,SpokaneStBridge,12/09/2017 10:00:00 AM,48,-122,14,7,21
34523,SpokaneStBridge,12/09/2017 11:00:00 AM,48,-122,11,12,23
34524,SpokaneStBridge,12/09/2017 12:00:00 PM,48,-122,10,18,28
34525,SpokaneStBridge,12/09/2017 01:00:00 PM,48,-122,18,15,33
34526,SpokaneStBridge,12/09/2017 02:00:00 PM,48,-122,17,19,36
34527,SpokaneStBridge,12/09/2017 03:00:00 PM,48,-122,9,10,19
34528,SpokaneStBridge,12/09/2017 04:00:00 PM,48,-122,16,6,22
34529,SpokaneStBridge,12/09/2017 05:00:00 PM,48,-122,6,8,14
34530,SpokaneStBridge,12/09/2017 06:00:00 PM,48,-122,1,4,5
34531,SpokaneStBridge,12/09/2017 07:00:00 PM,48,-122,4,6,10
34532,SpokaneStBridge,12/09/2017 08:00:00 PM,48,-122,1,1,2
34533,SpokaneStBridge,12/09/2017 09:00:00 PM,48,-122,1,6,7
34534,SpokaneStBridge,12/09/2017 10:00:00 PM,48,-122,1,5,6
34535,SpokaneStBridge,12/09/2017 11:00:00 PM,48,-122,1,1,2
34536,SpokaneStBridge,12/10/2017 12:00:00 AM,48,-122,1,0,1
34537,SpokaneStBridge,12/10/2017 01:00:00 AM,48,-122,2,2,4
34538,SpokaneStBridge,12/10/2017 02:00:00 AM,48,-122,0,1,1
34539,SpokaneStBridge,12/10/2017 03:00:00 AM,48,-122,1,1,2
34540,SpokaneStBridge,12/10/2017 04:00:00 AM,48,-122,1,1,2
34541,SpokaneStBridge,12/10/2017 05:00:00 AM,48,-122,2,0,2
34542,SpokaneStBridge,12/10/2017 06:00:00 AM,48,-122,3,0,3
34543,SpokaneStBridge,12/10/2017 07:00:00 AM,48,-122,0,1,1
34544,SpokaneStBridge,12/10/2017 08:00:00 AM,48,-122,7,5,12
34545,SpokaneStBridge,12/10/2017 09:00:00 AM,48,-122,9,9,18
34546,SpokaneStBridge,12/10/2017 10:00:00 AM,48,-122,15,7,22
34547,SpokaneStBridge,12/10/2017 11:00:00 AM,48,-122,16,13,29
34548,SpokaneStBridge,12/10/2017 12:00:00 PM,48,-122,16,18,34
34549,SpokaneStBridge,12/10/2017 01:00:00 PM,48,-122,24,19,43
34550,SpokaneStBridge,12/10/2017 02:00:00 PM,48,-122,16,17,33
34551,SpokaneStBridge,12/10/2017 03:00:00 PM,48,-122,16,13,29
34552,SpokaneStBridge,12/10/2017 04:00:00 PM,48,-122,9,8,17
34553,SpokaneStBridge,12/10/2017 05:00:00 PM,48,-122,3,6,9
34554,SpokaneStBridge,12/10/2017 06:00:00 PM,48,-122,1,1,2
34555,SpokaneStBridge,12/10/2017 07:00:00 PM,48,-122,1,2,3
34556,SpokaneStBridge,12/10/2017 08:00:00 PM,48,-122,0,1,1
34557,SpokaneStBridge,12/10/2017 09:00:00 PM,48,-122,0,0,0
34558,SpokaneStBridge,12/10/2017 10:00:00 PM,48,-122,0,2,2
34559,SpokaneStBridge,12/10/2017 11:00:00 PM,48,-122,4,1,5
34560,SpokaneStBridge,12/11/2017 12:00:00 AM,48,-122,0,1,1
34561,SpokaneStBridge,12/11/2017 01:00:00 AM,48,-122,1,1,2
34562,SpokaneStBridge,12/11/2017 02:00:00 AM,48,-122,0,0,0
34563,SpokaneStBridge,12/11/2017 03:00:00 AM,48,-122,0,0,0
34564,SpokaneStBridge,12/11/2017 04:00:00 AM,48,-122,0,0,0
34565,SpokaneStBridge,12/11/2017 05:00:00 AM,48,-122,19,3,22
34566,SpokaneStBridge,12/11/2017 06:00:00 AM,48,-122,31,1,32
34567,SpokaneStBridge,12/11/2017 07:00:00 AM,48,-122,54,5,59
34568,SpokaneStBridge,12/11/2017 08:00:00 AM,48,-122,63,5,68
34569,SpokaneStBridge,12/11/2017 09:00:00 AM,48,-122,34,3,37
34570,SpokaneStBridge,12/11/2017 10:00:00 AM,48,-122,12,1,13
34571,SpokaneStBridge,12/11/2017 11:00:00 AM,48,-122,7,9,16
34572,SpokaneStBridge,12/11/2017 12:00:00 PM,48,-122,5,7,12
34573,SpokaneStBridge,12/11/2017 01:00:00 PM,48,-122,10,3,13
34574,SpokaneStBridge,12/11/2017 02:00:00 PM,48,-122,7,7,14
34575,SpokaneStBridge,12/11/2017 03:00:00 PM,48,-122,7,25,32
34576,SpokaneStBridge,12/11/2017 04:00:00 PM,48,-122,19,52,71
34577,SpokaneStBridge,12/11/2017 05:00:00 PM,48,-122,10,79,89
34578,SpokaneStBridge,12/11/2017 06:00:00 PM,48,-122,6,43,49
34579,SpokaneStBridge,12/11/2017 07:00:00 PM,48,-122,5,14,19
34580,SpokaneStBridge,12/11/2017 08:00:00 PM,48,-122,0,5,5
34581,SpokaneStBridge,12/11/2017 09:00:00 PM,48,-122,1,6,7
34582,SpokaneStBridge,12/11/2017 10:00:00 PM,48,-122,0,1,1
34583,SpokaneStBridge,12/11/2017 11:00:00 PM,48,-122,0,0,0
34584,SpokaneStBridge,12/12/2017 12:00:00 AM,48,-122,0,0,0
34585,SpokaneStBridge,12/12/2017 01:00:00 AM,48,-122,0,0,0
34586,SpokaneStBridge,12/12/2017 02:00:00 AM,48,-122,0,1,1
34587,SpokaneStBridge,12/12/2017 03:00:00 AM,48,-122,0,1,1
34588,SpokaneStBridge,12/12/2017 04:00:00 AM,48,-122,0,1,1
34589,SpokaneStBridge,12/12/2017 05:00:00 AM,48,-122,21,2,23
34590,SpokaneStBridge,12/12/2017 06:00:00 AM,48,-122,51,5,56
34591,SpokaneStBridge,12/12/2017 07:00:00 AM,48,-122,68,7,75
34592,SpokaneStBridge,12/12/2017 08:00:00 AM,48,-122,90,3,93
34593,SpokaneStBridge,12/12/2017 09:00:00 AM,48,-122,37,4,41
34594,SpokaneStBridge,12/12/2017 10:00:00 AM,48,-122,11,2,13
34595,SpokaneStBridge,12/12/2017 11:00:00 AM,48,-122,6,5,11
34596,SpokaneStBridge,12/12/2017 12:00:00 PM,48,-122,6,2,8
34597,SpokaneStBridge,12/12/2017 01:00:00 PM,48,-122,13,6,19
34598,SpokaneStBridge,12/12/2017 02:00:00 PM,48,-122,8,9,17
34599,SpokaneStBridge,12/12/2017 03:00:00 PM,48,-122,6,25,31
34600,SpokaneStBridge,12/12/2017 04:00:00 PM,48,-122,16,58,74
34601,SpokaneStBridge,12/12/2017 05:00:00 PM,48,-122,13,102,115
34602,SpokaneStBridge,12/12/2017 06:00:00 PM,48,-122,7,48,55
34603,SpokaneStBridge,12/12/2017 07:00:00 PM,48,-122,3,20,23
34604,SpokaneStBridge,12/12/2017 08:00:00 PM,48,-122,3,7,10
34605,SpokaneStBridge,12/12/2017 09:00:00 PM,48,-122,0,5,5
34606,SpokaneStBridge,12/12/2017 10:00:00 PM,48,-122,0,6,6
34607,SpokaneStBridge,12/12/2017 11:00:00 PM,48,-122,0,1,1
34608,SpokaneStBridge,12/13/2017 12:00:00 AM,48,-122,0,0,0
34609,SpokaneStBridge,12/13/2017 01:00:00 AM,48,-122,0,0,0
34610,SpokaneStBridge,12/13/2017 02:00:00 AM,48,-122,0,1,1
34611,SpokaneStBridge,12/13/2017 03:00:00 AM,48,-122,0,1,1
34612,SpokaneStBridge,12/13/2017 04:00:00 AM,48,-122,1,1,2
34613,SpokaneStBridge,12/13/2017 05:00:00 AM,48,-122,23,3,26
34614,SpokaneStBridge,12/13/2017 06:00:00 AM,48,-122,51,1,52
34615,SpokaneStBridge,12/13/2017 07:00:00 AM,48,-122,63,6,69
34616,SpokaneStBridge,12/13/2017 08:00:00 AM,48,-122,104,7,111
34617,SpokaneStBridge,12/13/2017 09:00:00 AM,48,-122,34,4,38
34618,SpokaneStBridge,12/13/2017 10:00:00 AM,48,-122,15,4,19
34619,SpokaneStBridge,12/13/2017 11:00:00 AM,48,-122,10,4,14
34620,SpokaneStBridge,12/13/2017 12:00:00 PM,48,-122,12,6,18
34621,SpokaneStBridge,12/13/2017 01:00:00 PM,48,-122,6,7,13
34622,SpokaneStBridge,12/13/2017 02:00:00 PM,48,-122,15,18,33
34623,SpokaneStBridge,12/13/2017 03:00:00 PM,48,-122,7,29,36
34624,SpokaneStBridge,12/13/2017 04:00:00 PM,48,-122,12,60,72
34625,SpokaneStBridge,12/13/2017 05:00:00 PM,48,-122,10,91,101
34626,SpokaneStBridge,12/13/2017 06:00:00 PM,48,-122,12,58,70
34627,SpokaneStBridge,12/13/2017 07:00:00 PM,48,-122,7,21,28
34628,SpokaneStBridge,12/13/2017 08:00:00 PM,48,-122,3,7,10
34629,SpokaneStBridge,12/13/2017 09:00:00 PM,48,-122,3,4,7
34630,SpokaneStBridge,12/13/2017 10:00:00 PM,48,-122,2,7,9
34631,SpokaneStBridge,12/13/2017 11:00:00 PM,48,-122,1,4,5
34632,SpokaneStBridge,12/14/2017 12:00:00 AM,48,-122,0,0,0
34633,SpokaneStBridge,12/14/2017 01:00:00 AM,48,-122,1,0,1
34634,SpokaneStBridge,12/14/2017 02:00:00 AM,48,-122,0,2,2
34635,SpokaneStBridge,12/14/2017 03:00:00 AM,48,-122,1,3,4
34636,SpokaneStBridge,12/14/2017 04:00:00 AM,48,-122,2,3,5
34637,SpokaneStBridge,12/14/2017 05:00:00 AM,48,-122,22,1,23
34638,SpokaneStBridge,12/14/2017 06:00:00 AM,48,-122,31,6,37
34639,SpokaneStBridge,12/14/2017 07:00:00 AM,48,-122,69,8,77
34640,SpokaneStBridge,12/14/2017 08:00:00 AM,48,-122,89,4,93
34641,SpokaneStBridge,12/14/2017 09:00:00 AM,48,-122,35,1,36
34642,SpokaneStBridge,12/14/2017 10:00:00 AM,48,-122,15,3,18
34643,SpokaneStBridge,12/14/2017 11:00:00 AM,48,-122,9,4,13
34644,SpokaneStBridge,12/14/2017 12:00:00 PM,48,-122,10,7,17
34645,SpokaneStBridge,12/14/2017 01:00:00 PM,48,-122,3,9,12
34646,SpokaneStBridge,12/14/2017 02:00:00 PM,48,-122,14,13,27
34647,SpokaneStBridge,12/14/2017 03:00:00 PM,48,-122,7,27,34
34648,SpokaneStBridge,12/14/2017 04:00:00 PM,48,-122,7,49,56
34649,SpokaneStBridge,12/14/2017 05:00:00 PM,48,-122,13,83,96
34650,SpokaneStBridge,12/14/2017 06:00:00 PM,48,-122,7,44,51
34651,SpokaneStBridge,12/14/2017 07:00:00 PM,48,-122,4,20,24
34652,SpokaneStBridge,12/14/2017 08:00:00 PM,48,-122,1,8,9
34653,SpokaneStBridge,12/14/2017 09:00:00 PM,48,-122,3,2,5
34654,SpokaneStBridge,12/14/2017 10:00:00 PM,48,-122,6,3,9
34655,SpokaneStBridge,12/14/2017 11:00:00 PM,48,-122,0,3,3
34656,SpokaneStBridge,12/15/2017 12:00:00 AM,48,-122,2,3,5
34657,SpokaneStBridge,12/15/2017 01:00:00 AM,48,-122,1,1,2
34658,SpokaneStBridge,12/15/2017 02:00:00 AM,48,-122,0,1,1
34659,SpokaneStBridge,12/15/2017 03:00:00 AM,48,-122,1,1,2
34660,SpokaneStBridge,12/15/2017 04:00:00 AM,48,-122,4,2,6
34661,SpokaneStBridge,12/15/2017 05:00:00 AM,48,-122,17,3,20
34662,SpokaneStBridge,12/15/2017 06:00:00 AM,48,-122,20,0,20
34663,SpokaneStBridge,12/15/2017 07:00:00 AM,48,-122,49,3,52
34664,SpokaneStBridge,12/15/2017 08:00:00 AM,48,-122,57,6,63
34665,SpokaneStBridge,12/15/2017 09:00:00 AM,48,-122,22,3,25
34666,SpokaneStBridge,12/15/2017 10:00:00 AM,48,-122,14,2,16
34667,SpokaneStBridge,12/15/2017 11:00:00 AM,48,-122,8,3,11
34668,SpokaneStBridge,12/15/2017 12:00:00 PM,48,-122,5,6,11
34669,SpokaneStBridge,12/15/2017 01:00:00 PM,48,-122,5,8,13
34670,SpokaneStBridge,12/15/2017 02:00:00 PM,48,-122,10,8,18
34671,SpokaneStBridge,12/15/2017 03:00:00 PM,48,-122,7,19,26
34672,SpokaneStBridge,12/15/2017 04:00:00 PM,48,-122,9,38,47
34673,SpokaneStBridge,12/15/2017 05:00:00 PM,48,-122,8,51,59
34674,SpokaneStBridge,12/15/2017 06:00:00 PM,48,-122,2,21,23
34675,SpokaneStBridge,12/15/2017 07:00:00 PM,48,-122,2,18,20
34676,SpokaneStBridge,12/15/2017 08:00:00 PM,48,-122,0,8,8
34677,SpokaneStBridge,12/15/2017 09:00:00 PM,48,-122,1,5,6
34678,SpokaneStBridge,12/15/2017 10:00:00 PM,48,-122,2,3,5
34679,SpokaneStBridge,12/15/2017 11:00:00 PM,48,-122,1,0,1
34680,SpokaneStBridge,12/16/2017 12:00:00 AM,48,-122,0,0,0
34681,SpokaneStBridge,12/16/2017 01:00:00 AM,48,-122,1,3,4
34682,SpokaneStBridge,12/16/2017 02:00:00 AM,48,-122,1,1,2
34683,SpokaneStBridge,12/16/2017 03:00:00 AM,48,-122,1,4,5
34684,SpokaneStBridge,12/16/2017 04:00:00 AM,48,-122,0,2,2
34685,SpokaneStBridge,12/16/2017 05:00:00 AM,48,-122,2,0,2
34686,SpokaneStBridge,12/16/2017 06:00:00 AM,48,-122,4,7,11
34687,SpokaneStBridge,12/16/2017 07:00:00 AM,48,-122,4,1,5
34688,SpokaneStBridge,12/16/2017 08:00:00 AM,48,-122,10,5,15
34689,SpokaneStBridge,12/16/2017 09:00:00 AM,48,-122,12,4,16
34690,SpokaneStBridge,12/16/2017 10:00:00 AM,48,-122,12,2,14
34691,SpokaneStBridge,12/16/2017 11:00:00 AM,48,-122,4,16,20
34692,SpokaneStBridge,12/16/2017 12:00:00 PM,48,-122,16,12,28
34693,SpokaneStBridge,12/16/2017 01:00:00 PM,48,-122,10,13,23
34694,SpokaneStBridge,12/16/2017 02:00:00 PM,48,-122,15,8,23
34695,SpokaneStBridge,12/16/2017 03:00:00 PM,48,-122,10,22,32
34696,SpokaneStBridge,12/16/2017 04:00:00 PM,48,-122,6,6,12
34697,SpokaneStBridge,12/16/2017 05:00:00 PM,48,-122,5,5,10
34698,SpokaneStBridge,12/16/2017 06:00:00 PM,48,-122,3,8,11
34699,SpokaneStBridge,12/16/2017 07:00:00 PM,48,-122,5,3,8
34700,SpokaneStBridge,12/16/2017 08:00:00 PM,48,-122,5,1,6
34701,SpokaneStBridge,12/16/2017 09:00:00 PM,48,-122,1,3,4
34702,SpokaneStBridge,12/16/2017 10:00:00 PM,48,-122,0,1,1
34703,SpokaneStBridge,12/16/2017 11:00:00 PM,48,-122,1,1,2
34704,SpokaneStBridge,12/17/2017 12:00:00 AM,48,-122,0,1,1
34705,SpokaneStBridge,12/17/2017 01:00:00 AM,48,-122,3,1,4
34706,SpokaneStBridge,12/17/2017 02:00:00 AM,48,-122,0,2,2
34707,SpokaneStBridge,12/17/2017 03:00:00 AM,48,-122,0,2,2
34708,SpokaneStBridge,12/17/2017 04:00:00 AM,48,-122,0,0,0
34709,SpokaneStBridge,12/17/2017 05:00:00 AM,48,-122,1,0,1
34710,SpokaneStBridge,12/17/2017 06:00:00 AM,48,-122,3,2,5
34711,SpokaneStBridge,12/17/2017 07:00:00 AM,48,-122,1,0,1
34712,SpokaneStBridge,12/17/2017 08:00:00 AM,48,-122,5,6,11
34713,SpokaneStBridge,12/17/2017 09:00:00 AM,48,-122,3,1,4
34714,SpokaneStBridge,12/17/2017 10:00:00 AM,48,-122,3,7,10
34715,SpokaneStBridge,12/17/2017 11:00:00 AM,48,-122,5,3,8
34716,SpokaneStBridge,12/17/2017 12:00:00 PM,48,-122,3,2,5
34717,SpokaneStBridge,12/17/2017 01:00:00 PM,48,-122,3,6,9
34718,SpokaneStBridge,12/17/2017 02:00:00 PM,48,-122,4,1,5
34719,SpokaneStBridge,12/17/2017 03:00:00 PM,48,-122,8,7,15
34720,SpokaneStBridge,12/17/2017 04:00:00 PM,48,-122,5,13,18
34721,SpokaneStBridge,12/17/2017 05:00:00 PM,48,-122,6,5,11
34722,SpokaneStBridge,12/17/2017 06:00:00 PM,48,-122,1,2,3
34723,SpokaneStBridge,12/17/2017 07:00:00 PM,48,-122,0,1,1
34724,SpokaneStBridge,12/17/2017 08:00:00 PM,48,-122,1,6,7
34725,SpokaneStBridge,12/17/2017 09:00:00 PM,48,-122,0,4,4
34726,SpokaneStBridge,12/17/2017 10:00:00 PM,48,-122,2,1,3
34727,SpokaneStBridge,12/17/2017 11:00:00 PM,48,-122,1,1,2
34728,SpokaneStBridge,12/18/2017 12:00:00 AM,48,-122,2,1,3
34729,SpokaneStBridge,12/18/2017 01:00:00 AM,48,-122,1,0,1
34730,SpokaneStBridge,12/18/2017 02:00:00 AM,48,-122,0,1,1
34731,SpokaneStBridge,12/18/2017 03:00:00 AM,48,-122,1,0,1
34732,SpokaneStBridge,12/18/2017 04:00:00 AM,48,-122,1,0,1
34733,SpokaneStBridge,12/18/2017 05:00:00 AM,48,-122,16,3,19
34734,SpokaneStBridge,12/18/2017 06:00:00 AM,48,-122,26,5,31
34735,SpokaneStBridge,12/18/2017 07:00:00 AM,48,-122,54,8,62
34736,SpokaneStBridge,12/18/2017 08:00:00 AM,48,-122,60,4,64
34737,SpokaneStBridge,12/18/2017 09:00:00 AM,48,-122,24,3,27
34738,SpokaneStBridge,12/18/2017 10:00:00 AM,48,-122,12,1,13
34739,SpokaneStBridge,12/18/2017 11:00:00 AM,48,-122,5,2,7
34740,SpokaneStBridge,12/18/2017 12:00:00 PM,48,-122,2,1,3
34741,SpokaneStBridge,12/18/2017 01:00:00 PM,48,-122,4,7,11
34742,SpokaneStBridge,12/18/2017 02:00:00 PM,48,-122,8,8,16
34743,SpokaneStBridge,12/18/2017 03:00:00 PM,48,-122,4,14,18
34744,SpokaneStBridge,12/18/2017 04:00:00 PM,48,-122,6,38,44
34745,SpokaneStBridge,12/18/2017 05:00:00 PM,48,-122,11,68,79
34746,SpokaneStBridge,12/18/2017 06:00:00 PM,48,-122,3,33,36
34747,SpokaneStBridge,12/18/2017 07:00:00 PM,48,-122,1,12,13
34748,SpokaneStBridge,12/18/2017 08:00:00 PM,48,-122,2,7,9
34749,SpokaneStBridge,12/18/2017 09:00:00 PM,48,-122,1,0,1
34750,SpokaneStBridge,12/18/2017 10:00:00 PM,48,-122,0,1,1
34751,SpokaneStBridge,12/18/2017 11:00:00 PM,48,-122,0,1,1
34752,SpokaneStBridge,12/19/2017 12:00:00 AM,48,-122,0,1,1
34753,SpokaneStBridge,12/19/2017 01:00:00 AM,48,-122,0,0,0
34754,SpokaneStBridge,12/19/2017 02:00:00 AM,48,-122,0,0,0
34755,SpokaneStBridge,12/19/2017 03:00:00 AM,48,-122,1,0,1
34756,SpokaneStBridge,12/19/2017 04:00:00 AM,48,-122,2,1,3
34757,SpokaneStBridge,12/19/2017 05:00:00 AM,48,-122,14,0,14
34758,SpokaneStBridge,12/19/2017 06:00:00 AM,48,-122,22,5,27
34759,SpokaneStBridge,12/19/2017 07:00:00 AM,48,-122,37,6,43
34760,SpokaneStBridge,12/19/2017 08:00:00 AM,48,-122,38,4,42
34761,SpokaneStBridge,12/19/2017 09:00:00 AM,48,-122,11,1,12
34762,SpokaneStBridge,12/19/2017 10:00:00 AM,48,-122,10,0,10
34763,SpokaneStBridge,12/19/2017 11:00:00 AM,48,-122,6,2,8
34764,SpokaneStBridge,12/19/2017 12:00:00 PM,48,-122,1,0,1
34765,SpokaneStBridge,12/19/2017 01:00:00 PM,48,-122,4,0,4
34766,SpokaneStBridge,12/19/2017 02:00:00 PM,48,-122,3,0,3
34767,SpokaneStBridge,12/19/2017 03:00:00 PM,48,-122,3,9,12
34768,SpokaneStBridge,12/19/2017 04:00:00 PM,48,-122,11,32,43
34769,SpokaneStBridge,12/19/2017 05:00:00 PM,48,-122,6,40,46
34770,SpokaneStBridge,12/19/2017 06:00:00 PM,48,-122,7,30,37
34771,SpokaneStBridge,12/19/2017 07:00:00 PM,48,-122,2,10,12
34772,SpokaneStBridge,12/19/2017 08:00:00 PM,48,-122,1,7,8
34773,SpokaneStBridge,12/19/2017 09:00:00 PM,48,-122,1,4,5
34774,SpokaneStBridge,12/19/2017 10:00:00 PM,48,-122,3,3,6
34775,SpokaneStBridge,12/19/2017 11:00:00 PM,48,-122,0,1,1
34776,SpokaneStBridge,12/20/2017 12:00:00 AM,48,-122,0,0,0
34777,SpokaneStBridge,12/20/2017 01:00:00 AM,48,-122,0,0,0
34778,SpokaneStBridge,12/20/2017 02:00:00 AM,48,-122,0,0,0
34779,SpokaneStBridge,12/20/2017 03:00:00 AM,48,-122,2,3,5
34780,SpokaneStBridge,12/20/2017 04:00:00 AM,48,-122,0,1,1
34781,SpokaneStBridge,12/20/2017 05:00:00 AM,48,-122,12,3,15
34782,SpokaneStBridge,12/20/2017 06:00:00 AM,48,-122,30,4,34
34783,SpokaneStBridge,12/20/2017 07:00:00 AM,48,-122,63,7,70
34784,SpokaneStBridge,12/20/2017 08:00:00 AM,48,-122,75,3,78
34785,SpokaneStBridge,12/20/2017 09:00:00 AM,48,-122,20,6,26
34786,SpokaneStBridge,12/20/2017 10:00:00 AM,48,-122,16,4,20
34787,SpokaneStBridge,12/20/2017 11:00:00 AM,48,-122,18,9,27
34788,SpokaneStBridge,12/20/2017 12:00:00 PM,48,-122,9,7,16
34789,SpokaneStBridge,12/20/2017 01:00:00 PM,48,-122,14,4,18
34790,SpokaneStBridge,12/20/2017 02:00:00 PM,48,-122,14,10,24
34791,SpokaneStBridge,12/20/2017 03:00:00 PM,48,-122,7,31,38
34792,SpokaneStBridge,12/20/2017 04:00:00 PM,48,-122,14,45,59
34793,SpokaneStBridge,12/20/2017 05:00:00 PM,48,-122,12,70,82
34794,SpokaneStBridge,12/20/2017 06:00:00 PM,48,-122,10,38,48
34795,SpokaneStBridge,12/20/2017 07:00:00 PM,48,-122,4,17,21
34796,SpokaneStBridge,12/20/2017 08:00:00 PM,48,-122,4,10,14
34797,SpokaneStBridge,12/20/2017 09:00:00 PM,48,-122,0,4,4
34798,SpokaneStBridge,12/20/2017 10:00:00 PM,48,-122,0,4,4
34799,SpokaneStBridge,12/20/2017 11:00:00 PM,48,-122,0,1,1
34800,SpokaneStBridge,12/21/2017 12:00:00 AM,48,-122,1,0,1
34801,SpokaneStBridge,12/21/2017 01:00:00 AM,48,-122,0,0,0
34802,SpokaneStBridge,12/21/2017 02:00:00 AM,48,-122,0,0,0
34803,SpokaneStBridge,12/21/2017 03:00:00 AM,48,-122,0,4,4
34804,SpokaneStBridge,12/21/2017 04:00:00 AM,48,-122,0,1,1
34805,SpokaneStBridge,12/21/2017 05:00:00 AM,48,-122,15,1,16
34806,SpokaneStBridge,12/21/2017 06:00:00 AM,48,-122,23,5,28
34807,SpokaneStBridge,12/21/2017 07:00:00 AM,48,-122,34,4,38
34808,SpokaneStBridge,12/21/2017 08:00:00 AM,48,-122,46,3,49
34809,SpokaneStBridge,12/21/2017 09:00:00 AM,48,-122,22,4,26
34810,SpokaneStBridge,12/21/2017 10:00:00 AM,48,-122,10,4,14
34811,SpokaneStBridge,12/21/2017 11:00:00 AM,48,-122,12,1,13
34812,SpokaneStBridge,12/21/2017 12:00:00 PM,48,-122,12,7,19
34813,SpokaneStBridge,12/21/2017 01:00:00 PM,48,-122,3,3,6
34814,SpokaneStBridge,12/21/2017 02:00:00 PM,48,-122,6,8,14
34815,SpokaneStBridge,12/21/2017 03:00:00 PM,48,-122,5,27,32
34816,SpokaneStBridge,12/21/2017 04:00:00 PM,48,-122,10,36,46
34817,SpokaneStBridge,12/21/2017 05:00:00 PM,48,-122,7,49,56
34818,SpokaneStBridge,12/21/2017 06:00:00 PM,48,-122,6,24,30
34819,SpokaneStBridge,12/21/2017 07:00:00 PM,48,-122,3,6,9
34820,SpokaneStBridge,12/21/2017 08:00:00 PM,48,-122,2,10,12
34821,SpokaneStBridge,12/21/2017 09:00:00 PM,48,-122,7,7,14
34822,SpokaneStBridge,12/21/2017 10:00:00 PM,48,-122,2,8,10
34823,SpokaneStBridge,12/21/2017 11:00:00 PM,48,-122,0,0,0
34824,SpokaneStBridge,12/22/2017 12:00:00 AM,48,-122,1,0,1
34825,SpokaneStBridge,12/22/2017 01:00:00 AM,48,-122,1,1,2
34826,SpokaneStBridge,12/22/2017 02:00:00 AM,48,-122,0,1,1
34827,SpokaneStBridge,12/22/2017 03:00:00 AM,48,-122,0,1,1
34828,SpokaneStBridge,12/22/2017 04:00:00 AM,48,-122,0,1,1
34829,SpokaneStBridge,12/22/2017 05:00:00 AM,48,-122,8,2,10
34830,SpokaneStBridge,12/22/2017 06:00:00 AM,48,-122,16,3,19
34831,SpokaneStBridge,12/22/2017 07:00:00 AM,48,-122,13,6,19
34832,SpokaneStBridge,12/22/2017 08:00:00 AM,48,-122,39,3,42
34833,SpokaneStBridge,12/22/2017 09:00:00 AM,48,-122,9,1,10
34834,SpokaneStBridge,12/22/2017 10:00:00 AM,48,-122,6,4,10
34835,SpokaneStBridge,12/22/2017 11:00:00 AM,48,-122,7,8,15
34836,SpokaneStBridge,12/22/2017 12:00:00 PM,48,-122,4,1,5
34837,SpokaneStBridge,12/22/2017 01:00:00 PM,48,-122,8,12,20
34838,SpokaneStBridge,12/22/2017 02:00:00 PM,48,-122,3,13,16
34839,SpokaneStBridge,12/22/2017 03:00:00 PM,48,-122,8,19,27
34840,SpokaneStBridge,12/22/2017 04:00:00 PM,48,-122,17,27,44
34841,SpokaneStBridge,12/22/2017 05:00:00 PM,48,-122,4,15,19
34842,SpokaneStBridge,12/22/2017 06:00:00 PM,48,-122,2,8,10
34843,SpokaneStBridge,12/22/2017 07:00:00 PM,48,-122,1,5,6
34844,SpokaneStBridge,12/22/2017 08:00:00 PM,48,-122,2,3,5
34845,SpokaneStBridge,12/22/2017 09:00:00 PM,48,-122,1,5,6
34846,SpokaneStBridge,12/22/2017 10:00:00 PM,48,-122,0,1,1
34847,SpokaneStBridge,12/22/2017 11:00:00 PM,48,-122,1,0,1
34848,SpokaneStBridge,12/23/2017 12:00:00 AM,48,-122,0,1,1
34849,SpokaneStBridge,12/23/2017 01:00:00 AM,48,-122,1,1,2
34850,SpokaneStBridge,12/23/2017 02:00:00 AM,48,-122,0,0,0
34851,SpokaneStBridge,12/23/2017 03:00:00 AM,48,-122,0,1,1
34852,SpokaneStBridge,12/23/2017 04:00:00 AM,48,-122,0,4,4
34853,SpokaneStBridge,12/23/2017 05:00:00 AM,48,-122,2,0,2
34854,SpokaneStBridge,12/23/2017 06:00:00 AM,48,-122,2,2,4
34855,SpokaneStBridge,12/23/2017 07:00:00 AM,48,-122,1,2,3
34856,SpokaneStBridge,12/23/2017 08:00:00 AM,48,-122,9,5,14
34857,SpokaneStBridge,12/23/2017 09:00:00 AM,48,-122,6,3,9
34858,SpokaneStBridge,12/23/2017 10:00:00 AM,48,-122,9,5,14
34859,SpokaneStBridge,12/23/2017 11:00:00 AM,48,-122,10,12,22
34860,SpokaneStBridge,12/23/2017 12:00:00 PM,48,-122,13,9,22
34861,SpokaneStBridge,12/23/2017 01:00:00 PM,48,-122,7,16,23
34862,SpokaneStBridge,12/23/2017 02:00:00 PM,48,-122,11,16,27
34863,SpokaneStBridge,12/23/2017 03:00:00 PM,48,-122,11,10,21
34864,SpokaneStBridge,12/23/2017 04:00:00 PM,48,-122,10,8,18
34865,SpokaneStBridge,12/23/2017 05:00:00 PM,48,-122,7,2,9
34866,SpokaneStBridge,12/23/2017 06:00:00 PM,48,-122,1,6,7
34867,SpokaneStBridge,12/23/2017 07:00:00 PM,48,-122,0,2,2
34868,SpokaneStBridge,12/23/2017 08:00:00 PM,48,-122,0,0,0
34869,SpokaneStBridge,12/23/2017 09:00:00 PM,48,-122,1,0,1
34870,SpokaneStBridge,12/23/2017 10:00:00 PM,48,-122,0,2,2
34871,SpokaneStBridge,12/23/2017 11:00:00 PM,48,-122,0,0,0
34872,SpokaneStBridge,12/24/2017 12:00:00 AM,48,-122,0,1,1
34873,SpokaneStBridge,12/24/2017 01:00:00 AM,48,-122,0,1,1
34874,SpokaneStBridge,12/24/2017 02:00:00 AM,48,-122,0,0,0
34875,SpokaneStBridge,12/24/2017 03:00:00 AM,48,-122,0,1,1
34876,SpokaneStBridge,12/24/2017 04:00:00 AM,48,-122,0,0,0
34877,SpokaneStBridge,12/24/2017 05:00:00 AM,48,-122,0,0,0
34878,SpokaneStBridge,12/24/2017 06:00:00 AM,48,-122,4,0,4
34879,SpokaneStBridge,12/24/2017 07:00:00 AM,48,-122,0,0,0
34880,SpokaneStBridge,12/24/2017 08:00:00 AM,48,-122,2,0,2
34881,SpokaneStBridge,12/24/2017 09:00:00 AM,48,-122,1,2,3
34882,SpokaneStBridge,12/24/2017 10:00:00 AM,48,-122,7,1,8
34883,SpokaneStBridge,12/24/2017 11:00:00 AM,48,-122,3,7,10
34884,SpokaneStBridge,12/24/2017 12:00:00 PM,48,-122,4,5,9
34885,SpokaneStBridge,12/24/2017 01:00:00 PM,48,-122,2,4,6
34886,SpokaneStBridge,12/24/2017 02:00:00 PM,48,-122,5,2,7
34887,SpokaneStBridge,12/24/2017 03:00:00 PM,48,-122,3,4,7
34888,SpokaneStBridge,12/24/2017 04:00:00 PM,48,-122,1,4,5
34889,SpokaneStBridge,12/24/2017 05:00:00 PM,48,-122,1,0,1
34890,SpokaneStBridge,12/24/2017 06:00:00 PM,48,-122,2,2,4
34891,SpokaneStBridge,12/24/2017 07:00:00 PM,48,-122,0,1,1
34892,SpokaneStBridge,12/24/2017 08:00:00 PM,48,-122,0,0,0
34893,SpokaneStBridge,12/24/2017 09:00:00 PM,48,-122,1,1,2
34894,SpokaneStBridge,12/24/2017 10:00:00 PM,48,-122,1,0,1
34895,SpokaneStBridge,12/24/2017 11:00:00 PM,48,-122,1,0,1
34896,SpokaneStBridge,12/25/2017 12:00:00 AM,48,-122,0,0,0
34897,SpokaneStBridge,12/25/2017 01:00:00 AM,48,-122,1,0,1
34898,SpokaneStBridge,12/25/2017 02:00:00 AM,48,-122,0,0,0
34899,SpokaneStBridge,12/25/2017 03:00:00 AM,48,-122,0,1,1
34900,SpokaneStBridge,12/25/2017 04:00:00 AM,48,-122,0,0,0
34901,SpokaneStBridge,12/25/2017 05:00:00 AM,48,-122,0,0,0
34902,SpokaneStBridge,12/25/2017 06:00:00 AM,48,-122,0,0,0
34903,SpokaneStBridge,12/25/2017 07:00:00 AM,48,-122,0,0,0
34904,SpokaneStBridge,12/25/2017 08:00:00 AM,48,-122,0,0,0
34905,SpokaneStBridge,12/25/2017 09:00:00 AM,48,-122,1,1,2
34906,SpokaneStBridge,12/25/2017 10:00:00 AM,48,-122,0,0,0
34907,SpokaneStBridge,12/25/2017 11:00:00 AM,48,-122,0,0,0
34908,SpokaneStBridge,12/25/2017 12:00:00 PM,48,-122,0,0,0
34909,SpokaneStBridge,12/25/2017 01:00:00 PM,48,-122,1,0,1
34910,SpokaneStBridge,12/25/2017 02:00:00 PM,48,-122,2,1,3
34911,SpokaneStBridge,12/25/2017 03:00:00 PM,48,-122,0,2,2
34912,SpokaneStBridge,12/25/2017 04:00:00 PM,48,-122,1,0,1
34913,SpokaneStBridge,12/25/2017 05:00:00 PM,48,-122,1,2,3
34914,SpokaneStBridge,12/25/2017 06:00:00 PM,48,-122,0,0,0
34915,SpokaneStBridge,12/25/2017 07:00:00 PM,48,-122,0,1,1
34916,SpokaneStBridge,12/25/2017 08:00:00 PM,48,-122,0,0,0
34917,SpokaneStBridge,12/25/2017 09:00:00 PM,48,-122,1,0,1
34918,SpokaneStBridge,12/25/2017 10:00:00 PM,48,-122,0,1,1
34919,SpokaneStBridge,12/25/2017 11:00:00 PM,48,-122,0,0,0
34920,SpokaneStBridge,12/26/2017 12:00:00 AM,48,-122,2,0,2
34921,SpokaneStBridge,12/26/2017 01:00:00 AM,48,-122,0,1,1
34922,SpokaneStBridge,12/26/2017 02:00:00 AM,48,-122,0,1,1
34923,SpokaneStBridge,12/26/2017 03:00:00 AM,48,-122,0,0,0
34924,SpokaneStBridge,12/26/2017 04:00:00 AM,48,-122,1,0,1
34925,SpokaneStBridge,12/26/2017 05:00:00 AM,48,-122,5,0,5
34926,SpokaneStBridge,12/26/2017 06:00:00 AM,48,-122,4,2,6
34927,SpokaneStBridge,12/26/2017 07:00:00 AM,48,-122,8,0,8
34928,SpokaneStBridge,12/26/2017 08:00:00 AM,48,-122,11,1,12
34929,SpokaneStBridge,12/26/2017 09:00:00 AM,48,-122,4,3,7
34930,SpokaneStBridge,12/26/2017 10:00:00 AM,48,-122,12,3,15
34931,SpokaneStBridge,12/26/2017 11:00:00 AM,48,-122,5,2,7
34932,SpokaneStBridge,12/26/2017 12:00:00 PM,48,-122,3,5,8
34933,SpokaneStBridge,12/26/2017 01:00:00 PM,48,-122,3,5,8
34934,SpokaneStBridge,12/26/2017 02:00:00 PM,48,-122,4,8,12
34935,SpokaneStBridge,12/26/2017 03:00:00 PM,48,-122,6,3,9
34936,SpokaneStBridge,12/26/2017 04:00:00 PM,48,-122,5,12,17
34937,SpokaneStBridge,12/26/2017 05:00:00 PM,48,-122,8,13,21
34938,SpokaneStBridge,12/26/2017 06:00:00 PM,48,-122,1,3,4
34939,SpokaneStBridge,12/26/2017 07:00:00 PM,48,-122,0,3,3
34940,SpokaneStBridge,12/26/2017 08:00:00 PM,48,-122,0,4,4
34941,SpokaneStBridge,12/26/2017 09:00:00 PM,48,-122,0,2,2
34942,SpokaneStBridge,12/26/2017 10:00:00 PM,48,-122,2,6,8
34943,SpokaneStBridge,12/26/2017 11:00:00 PM,48,-122,1,1,2
34944,SpokaneStBridge,12/27/2017 12:00:00 AM,48,-122,0,1,1
34945,SpokaneStBridge,12/27/2017 01:00:00 AM,48,-122,1,0,1
34946,SpokaneStBridge,12/27/2017 02:00:00 AM,48,-122,0,0,0
34947,SpokaneStBridge,12/27/2017 03:00:00 AM,48,-122,0,1,1
34948,SpokaneStBridge,12/27/2017 04:00:00 AM,48,-122,0,0,0
34949,SpokaneStBridge,12/27/2017 05:00:00 AM,48,-122,6,2,8
34950,SpokaneStBridge,12/27/2017 06:00:00 AM,48,-122,11,2,13
34951,SpokaneStBridge,12/27/2017 07:00:00 AM,48,-122,14,4,18
34952,SpokaneStBridge,12/27/2017 08:00:00 AM,48,-122,24,5,29
34953,SpokaneStBridge,12/27/2017 09:00:00 AM,48,-122,16,0,16
34954,SpokaneStBridge,12/27/2017 10:00:00 AM,48,-122,9,2,11
34955,SpokaneStBridge,12/27/2017 11:00:00 AM,48,-122,7,13,20
34956,SpokaneStBridge,12/27/2017 12:00:00 PM,48,-122,17,6,23
34957,SpokaneStBridge,12/27/2017 01:00:00 PM,48,-122,1,5,6
34958,SpokaneStBridge,12/27/2017 02:00:00 PM,48,-122,8,7,15
34959,SpokaneStBridge,12/27/2017 03:00:00 PM,48,-122,1,16,17
34960,SpokaneStBridge,12/27/2017 04:00:00 PM,48,-122,6,30,36
34961,SpokaneStBridge,12/27/2017 05:00:00 PM,48,-122,6,19,25
34962,SpokaneStBridge,12/27/2017 06:00:00 PM,48,-122,10,9,19
34963,SpokaneStBridge,12/27/2017 07:00:00 PM,48,-122,2,6,8
34964,SpokaneStBridge,12/27/2017 08:00:00 PM,48,-122,4,9,13
34965,SpokaneStBridge,12/27/2017 09:00:00 PM,48,-122,0,2,2
34966,SpokaneStBridge,12/27/2017 10:00:00 PM,48,-122,0,2,2
34967,SpokaneStBridge,12/27/2017 11:00:00 PM,48,-122,0,0,0
34968,SpokaneStBridge,12/28/2017 12:00:00 AM,48,-122,1,1,2
34969,SpokaneStBridge,12/28/2017 01:00:00 AM,48,-122,1,0,1
34970,SpokaneStBridge,12/28/2017 02:00:00 AM,48,-122,1,1,2
34971,SpokaneStBridge,12/28/2017 03:00:00 AM,48,-122,0,2,2
34972,SpokaneStBridge,12/28/2017 04:00:00 AM,48,-122,0,1,1
34973,SpokaneStBridge,12/28/2017 05:00:00 AM,48,-122,8,3,11
34974,SpokaneStBridge,12/28/2017 06:00:00 AM,48,-122,11,4,15
34975,SpokaneStBridge,12/28/2017 07:00:00 AM,48,-122,20,3,23
34976,SpokaneStBridge,12/28/2017 08:00:00 AM,48,-122,28,5,33
34977,SpokaneStBridge,12/28/2017 09:00:00 AM,48,-122,14,9,23
34978,SpokaneStBridge,12/28/2017 10:00:00 AM,48,-122,11,3,14
34979,SpokaneStBridge,12/28/2017 11:00:00 AM,48,-122,5,3,8
34980,SpokaneStBridge,12/28/2017 12:00:00 PM,48,-122,4,3,7
34981,SpokaneStBridge,12/28/2017 01:00:00 PM,48,-122,7,2,9
34982,SpokaneStBridge,12/28/2017 02:00:00 PM,48,-122,4,7,11
34983,SpokaneStBridge,12/28/2017 03:00:00 PM,48,-122,1,11,12
34984,SpokaneStBridge,12/28/2017 04:00:00 PM,48,-122,5,21,26
34985,SpokaneStBridge,12/28/2017 05:00:00 PM,48,-122,5,26,31
34986,SpokaneStBridge,12/28/2017 06:00:00 PM,48,-122,5,15,20
34987,SpokaneStBridge,12/28/2017 07:00:00 PM,48,-122,3,5,8
34988,SpokaneStBridge,12/28/2017 08:00:00 PM,48,-122,0,2,2
34989,SpokaneStBridge,12/28/2017 09:00:00 PM,48,-122,0,3,3
34990,SpokaneStBridge,12/28/2017 10:00:00 PM,48,-122,1,1,2
34991,SpokaneStBridge,12/28/2017 11:00:00 PM,48,-122,0,0,0
34992,SpokaneStBridge,12/29/2017 12:00:00 AM,48,-122,0,0,0
34993,SpokaneStBridge,12/29/2017 01:00:00 AM,48,-122,0,0,0
34994,SpokaneStBridge,12/29/2017 02:00:00 AM,48,-122,0,1,1
34995,SpokaneStBridge,12/29/2017 03:00:00 AM,48,-122,0,1,1
34996,SpokaneStBridge,12/29/2017 04:00:00 AM,48,-122,0,1,1
34997,SpokaneStBridge,12/29/2017 05:00:00 AM,48,-122,6,1,7
34998,SpokaneStBridge,12/29/2017 06:00:00 AM,48,-122,8,0,8
34999,SpokaneStBridge,12/29/2017 07:00:00 AM,48,-122,11,3,14
35000,SpokaneStBridge,12/29/2017 08:00:00 AM,48,-122,12,3,15
35001,SpokaneStBridge,12/29/2017 09:00:00 AM,48,-122,3,2,5
35002,SpokaneStBridge,12/29/2017 10:00:00 AM,48,-122,3,0,3
35003,SpokaneStBridge,12/29/2017 11:00:00 AM,48,-122,1,0,1
35004,SpokaneStBridge,12/29/2017 12:00:00 PM,48,-122,3,1,4
35005,SpokaneStBridge,12/29/2017 01:00:00 PM,48,-122,4,4,8
35006,SpokaneStBridge,12/29/2017 02:00:00 PM,48,-122,3,2,5
35007,SpokaneStBridge,12/29/2017 03:00:00 PM,48,-122,1,12,13
35008,SpokaneStBridge,12/29/2017 04:00:00 PM,48,-122,3,12,15
35009,SpokaneStBridge,12/29/2017 05:00:00 PM,48,-122,6,9,15
35010,SpokaneStBridge,12/29/2017 06:00:00 PM,48,-122,2,3,5
35011,SpokaneStBridge,12/29/2017 07:00:00 PM,48,-122,1,5,6
35012,SpokaneStBridge,12/29/2017 08:00:00 PM,48,-122,0,1,1
35013,SpokaneStBridge,12/29/2017 09:00:00 PM,48,-122,0,0,0
35014,SpokaneStBridge,12/29/2017 10:00:00 PM,48,-122,1,2,3
35015,SpokaneStBridge,12/29/2017 11:00:00 PM,48,-122,0,0,0
35016,SpokaneStBridge,12/30/2017 12:00:00 AM,48,-122,0,0,0
35017,SpokaneStBridge,12/30/2017 01:00:00 AM,48,-122,0,1,1
35018,SpokaneStBridge,12/30/2017 02:00:00 AM,48,-122,2,0,2
35019,SpokaneStBridge,12/30/2017 03:00:00 AM,48,-122,0,2,2
35020,SpokaneStBridge,12/30/2017 04:00:00 AM,48,-122,0,1,1
35021,SpokaneStBridge,12/30/2017 05:00:00 AM,48,-122,0,0,0
35022,SpokaneStBridge,12/30/2017 06:00:00 AM,48,-122,3,1,4
35023,SpokaneStBridge,12/30/2017 07:00:00 AM,48,-122,1,1,2
35024,SpokaneStBridge,12/30/2017 08:00:00 AM,48,-122,7,2,9
35025,SpokaneStBridge,12/30/2017 09:00:00 AM,48,-122,12,12,24
35026,SpokaneStBridge,12/30/2017 10:00:00 AM,48,-122,12,7,19
35027,SpokaneStBridge,12/30/2017 11:00:00 AM,48,-122,17,8,25
35028,SpokaneStBridge,12/30/2017 12:00:00 PM,48,-122,30,19,49
35029,SpokaneStBridge,12/30/2017 01:00:00 PM,48,-122,9,22,31
35030,SpokaneStBridge,12/30/2017 02:00:00 PM,48,-122,8,18,26
35031,SpokaneStBridge,12/30/2017 03:00:00 PM,48,-122,13,5,18
35032,SpokaneStBridge,12/30/2017 04:00:00 PM,48,-122,5,9,14
35033,SpokaneStBridge,12/30/2017 05:00:00 PM,48,-122,6,5,11
35034,SpokaneStBridge,12/30/2017 06:00:00 PM,48,-122,3,5,8
35035,SpokaneStBridge,12/30/2017 07:00:00 PM,48,-122,1,1,2
35036,SpokaneStBridge,12/30/2017 08:00:00 PM,48,-122,1,3,4
35037,SpokaneStBridge,12/30/2017 09:00:00 PM,48,-122,1,3,4
35038,SpokaneStBridge,12/30/2017 10:00:00 PM,48,-122,0,3,3
35039,SpokaneStBridge,12/30/2017 11:00:00 PM,48,-122,1,1,2
35040,SpokaneStBridge,12/31/2017 12:00:00 AM,48,-122,3,2,5
35041,SpokaneStBridge,12/31/2017 01:00:00 AM,48,-122,0,0,0
35042,SpokaneStBridge,12/31/2017 02:00:00 AM,48,-122,4,1,5
35043,SpokaneStBridge,12/31/2017 03:00:00 AM,48,-122,1,0,1
35044,SpokaneStBridge,12/31/2017 04:00:00 AM,48,-122,2,0,2
35045,SpokaneStBridge,12/31/2017 05:00:00 AM,48,-122,2,0,2
35046,SpokaneStBridge,12/31/2017 06:00:00 AM,48,-122,2,2,4
35047,SpokaneStBridge,12/31/2017 07:00:00 AM,48,-122,2,2,4
35048,SpokaneStBridge,12/31/2017 08:00:00 AM,48,-122,11,2,13
35049,SpokaneStBridge,12/31/2017 09:00:00 AM,48,-122,10,2,12
35050,SpokaneStBridge,12/31/2017 10:00:00 AM,48,-122,10,15,25
35051,SpokaneStBridge,12/31/2017 11:00:00 AM,48,-122,17,6,23
35052,SpokaneStBridge,12/31/2017 12:00:00 PM,48,-122,14,15,29
35053,SpokaneStBridge,12/31/2017 01:00:00 PM,48,-122,13,36,49
35054,SpokaneStBridge,12/31/2017 02:00:00 PM,48,-122,11,19,30
35055,SpokaneStBridge,12/31/2017 03:00:00 PM,48,-122,7,11,18
35056,SpokaneStBridge,12/31/2017 04:00:00 PM,48,-122,11,4,15
35057,SpokaneStBridge,12/31/2017 05:00:00 PM,48,-122,3,8,11
35058,SpokaneStBridge,12/31/2017 06:00:00 PM,48,-122,5,3,8
35059,SpokaneStBridge,12/31/2017 07:00:00 PM,48,-122,4,1,5
35060,SpokaneStBridge,12/31/2017 08:00:00 PM,48,-122,4,0,4
35061,SpokaneStBridge,12/31/2017 09:00:00 PM,48,-122,0,2,2
35062,SpokaneStBridge,12/31/2017 10:00:00 PM,48,-122,4,1,5
35063,SpokaneStBridge,12/31/2017 11:00:00 PM,48,-122,0,1,1
